"data_size","cache_size","unique_size","reads","writes","data","ins","avg_step","avg_reuse_dist","sum_sqrt_count","sum_count","lis","lds","belady","lru","pivot","ld","mru"
48921,2,43,46620,2301,47655,1266,9.93718e+13,40.7963,1003.3,48921,43,42,30256,24817,23568,25187,18280
36694,2050,2442,19121,17573,0,36694,4.99527e+18,1416.74,6951.5,36694,583,403,34252,34252,29781,29206,32887
29754,1131,1343,10470,19284,0,29754,3.85109e+13,1057.82,4886.62,29754,420,344,27957,24768,22274,22099,25336
49205,1403,2057,0,49205,17322,31883,9.83313e+15,1320.93,7260.92,49205,611,404,46494,41695,31486,25287,37419
5377,676,1454,0,5377,0,5377,2.43967e+18,261.19,2316.38,5377,236,204,3923,3689,2391,2344,2440
6676,503,1321,0,6676,2328,4348,9.37045e+15,155.841,2265.62,6676,228,163,5355,5200,3264,3279,3098
25511,32,43,24383,1128,24686,825,9.67418e+13,37.4527,719.937,25511,40,37,25409,25339,23675,23696,21312
20347,7,46,19217,1130,20228,119,1.01678e+14,38.8724,694.264,20347,41,41,18297,16991,13916,13908,9087
19298,1593,1943,9999,9299,9999,9299,5.00401e+18,1154.15,4792.81,19298,369,321,17251,15377,13698,13080,15231
36484,15,352,0,36484,34536,1948,2.64282e+16,298.135,2474.85,36484,142,151,30526,27297,21417,18835,10993
1458,458,577,1254,204,858,600,6.52965e+17,27.5604,792.019,1458,111,76,881,881,820,816,769
45976,2422,2490,24206,21770,0,45976,5.01534e+18,1488.53,7767.19,45976,615,433,43486,43486,43313,43030,43475
4065,463,557,3979,86,4065,0,4.66561e+18,178.04,1205.28,4065,145,97,3508,3490,3443,3460,3460
22446,1522,2025,0,22446,0,22446,2.47861e+18,1214.05,5260.15,22446,405,337,20156,17832,15085,13977,17421
41798,5045,6039,23997,17801,22838,18960,4.49826e+18,956.133,11544.2,41798,906,508,35759,35759,28644,27331,27404
41605,1177,2365,0,41605,0,41605,2.43644e+18,1453.81,7269.41,41605,591,417,37134,32919,21368,19120,23684
4266,1018,1106,0,4266,0,4266,2.2211e+18,88.7436,1741.59,4266,177,121,3160,3160,3160,3160,3147
17961,139,1720,8593,9368,8593,9368,5.0456e+18,1154.76,4508.13,17961,343,317,12150,8362,3358,3477,1858
37246,1745,2148,29880,7366,17719,19527,8.34061e+17,1670.9,7370.76,37246,516,432,34284,28128,29979,28617,32194
34482,1362,1724,0,34482,0,34482,2.54135e+18,1371.67,6214.39,34482,489,412,31697,27376,22589,20979,27533
24923,797,925,24907,16,24923,0,4.64097e+18,464.37,3432.74,24923,248,212,23998,23964,22998,22919,22411
6326,1005,1589,3177,3149,0,6326,5.01779e+18,297.01,2583.94,6326,255,213,4737,4608,3672,3613,3626
39494,838,2455,0,39494,0,39494,2.43419e+18,1432.14,7212.79,39494,599,408,33711,30135,15133,15899,16043
2312,5,30,2181,131,2299,13,1.07501e+14,19.2574,188.918,2312,21,21,1986,1778,1486,1518,1023
26863,404,591,26606,257,26863,0,4.74469e+18,478.849,3088.63,26863,222,219,25854,25039,21660,21637,19569
19591,267,348,0,19591,18614,977,2.58718e+16,260.155,1781.39,19591,105,114,19133,18798,17716,16841,16649
37912,361,2085,37912,0,30285,7627,3.06997e+18,1676.75,7370.65,37912,516,457,27084,23151,10575,8886,5786
23686,670,2178,12420,11266,12420,11266,4.91497e+18,1196.48,5437.21,23686,461,333,19578,17405,9052,9832,7906
28499,11,42,26870,1629,28242,257,1.06362e+14,38.8823,762.918,28499,40,39,27150,26198,21266,20641,14079
41891,134,880,40834,1057,41891,0,4.58395e+18,596.752,4145.62,41891,311,241,36023,29133,16826,15079,7944
28566,323,849,27933,633,28566,0,4.56418e+18,495.42,3404.26,28566,284,210,26978,25821,15525,14810,14252
28065,677,2165,0,28065,0,28065,2.45715e+18,1285.36,5835.62,28065,477,362,23431,20951,11959,11486,10585
25087,2,43,23689,1398,24832,255,1.06668e+14,40.1615,733.9,25087,41,38,14677,11674,10960,11716,8941
37612,2285,3102,31498,6114,19860,17752,7.20807e+17,1650.96,8028.68,37612,597,425,34510,33665,30457,30179,31667
32279,1374,2173,0,32279,0,32279,2.50689e+18,1342.27,6458.86,32279,454,407,29195,25809,18774,16532,23330
28123,1262,1857,13849,14274,13849,14274,5.0149e+18,1358.36,5783.86,28123,457,375,25134,21876,16685,15168,18970
2398,642,681,843,1555,0,2398,3.84461e+13,94.1897,1061.21,2398,147,125,1717,1717,1693,1696,1652
38178,199,2121,30540,7638,18113,20065,8.41253e+17,1680.23,7432.43,38178,525,440,24976,18024,10608,11397,4113
18690,34,2058,9487,9203,0,18690,4.9169e+18,1166.18,4811.71,18690,431,318,9439,6085,3399,2473,249
41961,653,2727,35156,6805,22333,19628,7.14048e+17,1703.54,8071,41961,605,436,33413,28842,20027,20147,12420
33685,206,743,33264,421,33685,0,4.74498e+18,570.179,3706.48,33685,269,229,30427,27182,14103,14080,10941
1063,69,291,390,673,0,1063,3.91913e+13,82.3603,481.107,1063,76,76,700,563,297,194,238
48196,2082,2691,39802,8394,24728,23468,7.61886e+17,1750.5,8745.09,48196,621,464,45505,41943,40379,39580,43109
4624,369,1147,0,4624,0,4624,2.48994e+18,192.505,1866.97,4624,240,183,3477,3283,2324,2254,1091
600,63,75,0,600,575,25,2.65413e+16,22.23,173.859,600,26,24,525,525,518,520,508
22731,1878,1952,0,22731,0,22731,2.49048e+18,1239.96,5274.61,22731,419,348,20779,20779,20673,20123,20499
47482,13,43,45312,2170,46126,1356,9.81804e+13,40.6341,987.205,47482,43,41,46047,45124,36857,36440,24975
24016,110,1620,0,24016,8532,15484,9.51332e+15,947.84,4508.49,24016,420,301,18710,16401,8243,5037,4555
38039,91,356,0,38039,36238,1801,2.55505e+16,296.294,2489.97,38039,136,150,36480,35796,28538,24569,18770
20796,1173,1682,9784,11012,0,20796,5.08414e+18,1186.21,4791.77,20796,385,332,18228,16102,12290,10981,15453
30609,1029,1719,0,30609,10857,19752,9.54551e+15,1071.15,5223.41,30609,503,334,27933,25526,19284,14334,22178
3108,253,419,2908,200,3108,0,3.94875e+18,147.395,895.903,3108,117,78,2689,2611,2366,2338,2138
22472,1174,1513,0,22472,7932,14540,9.66303e+15,956.813,4349.56,22472,391,302,20662,18818,16661,13985,19213
26067,1049,2375,26067,0,21305,4762,2.99169e+18,1573.65,6351.02,26067,449,381,21301,18355,15489,14553,12528
37574,1898,2171,0,37574,0,37574,2.49361e+18,1441.27,6913.54,37574,525,421,35403,35304,31906,30677,34130
48510,515,2296,0,48510,0,48510,2.46323e+18,1471.98,7855.52,48510,592,446,39640,34907,13967,13734,12909
44109,210,2891,36680,7429,22884,21225,7.35374e+17,1754.67,8492.25,44109,636,449,30459,23868,14237,16044,5117
41665,380,383,0,41665,39421,2244,2.72839e+16,325.745,2766.43,41665,149,160,41282,41278,41257,41272,41188
29588,757,1703,0,29588,10497,19091,9.53876e+15,1054.67,5123.56,29588,490,334,26246,24178,16311,11203,14336
48958,918,2138,48958,0,39124,9834,3.06561e+18,1738.32,8413.86,48958,549,485,40188,33774,24717,23255,24680
32186,779,2254,16909,15277,0,32186,5.01118e+18,1369.37,6377.17,32186,525,383,27222,24253,13467,12910,13690
35833,26,43,34139,1694,34938,895,9.9612e+13,40.7682,865.082,35833,42,40,35582,35421,31560,31636,26024
44598,1424,2373,0,44598,0,44598,2.49731e+18,1607.57,7867.47,44598,692,450,40606,35012,25881,21763,34195
31633,20,43,30172,1461,30741,892,9.83604e+13,39.4999,805.475,31633,41,39,31237,30939,26770,26489,21375
17624,142,350,0,17624,16877,747,2.44295e+16,197.715,1636.85,17624,105,112,17056,16807,14800,13403,11406
39622,31,392,0,39622,37539,2083,2.7254e+16,313.32,2710.9,39622,148,160,35763,33522,24923,21021,13185
3904,180,963,0,3904,0,3904,2.22386e+18,82.4529,1548.79,3904,172,118,2905,2761,1536,1395,1240
42545,104,350,0,42545,40267,2278,2.67094e+16,305.482,2687.75,42545,149,159,40757,39913,31545,27541,20396
23370,29,43,22281,1089,22737,633,9.88116e+13,38.7677,694.602,23370,40,36,23240,23165,21192,21183,18735
40690,1678,1823,14417,26273,0,40690,3.69509e+13,1150.79,6053.45,40690,592,358,38867,38866,37165,37122,38503
17900,1862,2287,14440,3460,8610,9290,8.22928e+17,1260.05,5253.75,17900,366,334,15587,13821,14249,13904,14628
9366,943,2108,7548,1818,4460,4906,8.19013e+17,721.695,3662.86,9366,285,249,7174,6432,5032,5071,4397
45113,1908,2489,23804,21309,0,45113,5.00819e+18,1452.01,7673.15,45113,638,433,42624,42441,33871,32199,39634
34241,393,2384,0,34241,0,34241,2.42397e+18,1399.44,6696.78,34241,541,393,27177,24242,9987,7023,8440
47540,2092,2384,47540,0,38723,8817,3.07615e+18,1812.27,8575.65,47540,596,483,45156,44744,44100,44268,44534
9992,91,1806,0,9992,0,9992,2.53243e+18,624.826,3358.87,9992,279,256,6390,4759,2570,1157,642
42820,345,359,0,42820,40725,2095,2.55972e+16,306.404,2662.16,42820,147,157,42450,41894,42214,41617,41795
14716,658,1408,5209,9507,0,14716,3.8335e+13,795.756,3485.58,14716,340,273,12713,11664,7676,7533,8184
49667,196,2612,25922,23745,0,49667,4.99858e+18,1502.67,8164.79,49667,660,448,36819,30242,12980,9185,6367
503,32,69,0,503,481,22,2.63591e+16,20.9364,155.615,503,24,22,429,410,368,360,284
49676,907,1404,17579,32097,0,49676,3.86692e+13,1154.34,6393.17,49676,513,407,45834,40881,30068,26300,35487
47104,461,1642,0,47104,16727,30377,9.76042e+15,1137.94,6430.17,47104,515,395,40662,37047,21043,14322,16986
48119,13,43,45554,2565,47347,772,1.03625e+14,40.8304,1005.39,48119,43,43,46445,45363,36567,36058,26308
2411,562,734,1384,1027,0,2411,5.51111e+18,75.4923,1142.91,2411,129,117,1677,1677,1670,1671,1039
42585,70,923,41234,1351,42585,0,4.51653e+18,621.749,4202,42585,299,237,31576,22389,13547,12454,4235
37551,1767,2412,19805,17746,19805,17746,4.8758e+18,1436.97,6975.84,37551,602,402,35131,30561,26301,25090,30691
12027,592,1394,0,12027,4267,7760,9.85997e+15,689.105,3147.03,12027,274,249,10141,9445,6025,4905,5919
4481,4,36,4285,196,4356,125,1.00379e+14,19.5017,282.077,4481,24,27,3676,3273,2953,2841,1827
26399,317,353,0,26399,25143,1256,2.56798e+16,280.512,2086.32,26399,123,128,25988,25469,25145,24076,24308
39995,49,1785,0,39995,0,39995,2.5494e+18,1455.16,6815.46,39995,511,432,20237,11712,5362,3675,1163
16761,219,350,0,16761,16034,727,2.47071e+16,202.006,1607.64,16761,104,112,16287,16060,14947,14150,13047
14489,31,1774,7095,7394,0,14489,5.0743e+18,946.822,4083.56,14489,350,281,6589,3765,1876,1537,320
21158,1968,2493,17508,3650,10806,10352,7.46721e+17,1390.16,5733.57,21158,462,336,18665,16101,16384,15979,17087
36061,336,353,0,36061,34365,1696,2.54793e+16,290.969,2416.89,36061,132,144,35682,34973,35415,35258,34761
2869,786,792,0,2869,0,2869,2.2993e+18,59.5389,1241.2,2869,146,105,2077,2077,2077,2070,2076
19597,330,358,0,19597,18749,848,2.46873e+16,219.757,1741.66,19597,107,114,19219,18949,18812,18603,18598
22328,978,2416,18718,3610,11827,10501,7.14542e+17,1429.48,5771.29,22328,461,340,18066,16065,13158,12789,8718
2084,127,437,2082,2,2084,0,4.47615e+18,140.336,816.564,2084,122,77,1568,1225,864,881,833
32514,1454,2082,0,32514,0,32514,2.47127e+18,1418.38,6298.64,32514,495,376,29626,26033,21075,19425,23234
14423,562,1865,7315,7108,0,14423,5.05288e+18,951.137,4118.68,14423,330,293,11499,10334,5327,4760,4592
49923,333,2119,49923,0,39827,10096,2.97669e+18,1768.15,8518.48,49923,549,486,35039,29306,13309,11379,9261
25241,1555,1743,8960,16281,0,25241,3.71422e+13,972.219,4726.23,25241,435,310,23498,23496,22555,22844,23349
37723,1452,1511,13395,24328,0,37723,3.85699e+13,1100.67,5667.68,37723,467,383,36212,36211,36102,36157,36123
28592,535,810,27896,696,28592,0,4.62541e+18,526.514,3384.64,28592,256,209,27640,26878,24362,24082,20822
20668,1894,2479,17466,3202,11190,9478,6.89989e+17,1301.9,5508.36,20668,442,319,18077,15879,15741,15574,15654
33141,857,1750,15698,17443,0,33141,5.10915e+18,1368.84,6131.71,33141,467,401,28298,24903,14884,12603,18356
29547,37,43,28193,1354,28716,831,9.80169e+13,39.2874,782.314,29547,41,39,29476,29430,28200,28206,26869
20676,574,1609,0,20676,7379,13297,9.6154e+15,940.088,4229.21,20676,391,292,17824,16424,10371,6843,7976
20692,21,42,19661,1031,20242,450,1.01969e+14,37.8796,646.573,20692,38,36,20449,20263,17450,17311,14427
25062,225,1447,0,25062,8818,16244,9.65045e+15,995.848,4562.7,25062,393,319,20482,18864,8298,6209,5494
30221,1386,1809,0,30221,10720,19501,9.46795e+15,1043.53,5225.05,30221,513,321,28394,25827,23388,19152,26546
3329,19,43,3137,192,3323,6,1.10341e+14,29.6843,279.116,3329,29,29,3232,3180,2702,2651,2089
14832,1253,1774,7205,7627,7205,7627,4.93436e+18,962.918,4124.97,14832,358,288,12707,11486,9429,9198,10760
28382,378,859,27486,896,28382,0,4.50069e+18,493.106,3368.85,28382,265,204,26978,26035,18497,17823,15729
41099,2113,2418,21392,19707,0,41099,4.98947e+18,1478.22,7321.26,41099,593,422,38681,38680,35839,35605,37541
38430,127,891,37390,1040,38430,0,4.50342e+18,553.688,3964.01,38430,275,227,32770,26162,13886,12514,6755
31393,2428,2640,26272,5121,16603,14790,7.18987e+17,1614.06,6975.05,31393,568,387,28753,28753,28213,28088,28143
12193,1254,1524,0,12193,4278,7915,9.38048e+15,676.981,3233.5,12193,322,219,10669,10004,9386,9173,9987
756,40,270,234,522,0,756,3.79841e+13,59.8479,410.769,756,87,74,381,276,181,132,103
38097,717,2123,18219,19878,18219,19878,5.01895e+18,1420.49,6946.75,38097,506,426,31649,27345,12515,12405,16162
20468,484,1585,7318,13150,0,20468,3.76403e+13,900.576,4145.59,20468,375,285,17549,16197,10263,9586,6363
15800,475,731,15626,174,15800,0,4.72661e+18,441.854,2546.68,15800,229,182,14941,14604,12877,12857,12212
13787,1852,2354,5264,8523,0,13787,3.71788e+13,420.726,4200.93,13787,726,234,11433,11430,9907,10042,9589
3717,36,477,3698,19,3717,0,4.82427e+18,191.376,1089.14,3717,97,100,1933,935,744,683,320
22127,441,661,21730,397,22127,0,4.6073e+18,488.036,2879.99,22127,214,202,21216,20588,17180,17079,16143
20774,666,2122,10935,9839,10935,9839,4.87612e+18,1157.47,5060.66,20774,445,316,17001,15283,8315,8933,6704
44056,84,353,0,44056,41746,2310,2.65343e+16,299.285,2723.08,44056,148,161,42007,41042,31752,27513,20575
18271,1994,2409,15391,2880,9863,8408,6.99113e+17,1197.42,5155.1,18271,427,302,15862,14005,14460,14094,14148
28724,2087,2681,28724,0,24111,4613,3.35822e+18,1552.62,6715.16,28724,596,395,26040,22330,25226,25170,24035
23375,620,1644,0,23375,8273,15102,9.52743e+15,968.596,4504.81,23375,438,298,20239,18927,12634,8456,10064
23151,219,1733,0,23151,0,23151,2.52727e+18,1284.66,5148.5,23151,416,351,16659,14201,4534,2848,2178
21109,644,2210,11274,9835,11274,9835,4.94644e+18,1106.34,5138,21109,448,323,17293,15505,8063,8467,6210
45533,21,890,44267,1266,45533,0,4.55255e+18,610.763,4320.25,45533,315,245,22177,6835,9189,8142,1550
30254,86,355,0,30254,28851,1403,2.53372e+16,277.609,2206.55,30254,129,133,28979,28416,22972,20166,15328
12499,680,1683,5958,6541,0,12499,5.08968e+18,904.611,3712.82,12499,304,279,10000,8911,4825,3963,5264
44184,2798,2957,36058,8126,21181,23003,7.82854e+17,1826.09,8919.25,44184,656,465,41227,41227,41106,41016,41166
27833,812,6147,15933,11900,14935,12898,4.29001e+18,615.02,10052.5,27833,872,452,21352,19202,7565,9038,2600
27191,13,42,25665,1526,26908,283,1.06675e+14,39.681,750.979,27191,40,38,26225,25604,20734,19873,14394
26030,92,353,0,26030,24790,1240,2.55953e+16,279.945,2074.98,26030,119,124,24932,24450,19627,16877,12731
2269,164,566,0,2269,794,1475,1.03541e+16,91.1829,936.784,2269,103,126,1703,1602,777,712,750
12131,55,345,0,12131,11555,576,2.56963e+16,172.668,1384.55,12131,91,98,11445,11071,8662,7307,5302
43641,17,43,41650,1991,42388,1253,9.84305e+13,40.8966,951.783,43641,43,41,42841,42201,35669,35380,27654
27888,689,2501,27888,0,23370,4518,3.29057e+18,1560.3,6490.36,27888,512,381,22069,19015,13985,12140,8290
6116,135,1853,5029,1087,3084,3032,7.57237e+17,237.764,2790.52,6116,240,182,3849,2936,1837,1864,456
29932,165,1353,0,29932,10593,19339,9.84352e+15,1047.3,4919.38,29932,421,351,23615,21423,8501,7022,5601
33477,14,353,0,33477,31877,1600,2.53775e+16,288.978,2328.06,33477,129,137,28254,25441,20413,18133,10704
40431,329,355,0,40431,38618,1813,2.4914e+16,282.219,2533.39,40431,137,151,40013,39212,39085,38795,38325
41929,1011,1552,0,41929,14876,27053,9.75264e+15,1124.85,5950.55,41929,507,379,38942,35225,27115,20204,31155
12927,2028,2311,12927,0,10691,2236,3.28554e+18,1030.71,4401.53,12927,384,293,10616,9592,10418,10485,10195
5437,193,1382,3025,2412,3025,2412,4.78649e+18,161.388,2177.22,5437,244,182,4001,3723,2076,2268,550
42127,335,353,0,42127,39873,2254,2.6699e+16,304.282,2678.63,42127,150,157,41725,40751,41334,40696,41024
34430,710,726,33810,620,34430,0,4.62941e+18,510.761,3618.81,34430,249,226,33704,33704,33661,33666,33701
1986,485,556,753,1233,0,1986,4.28941e+18,108.4,897.727,1986,114,110,1430,1429,1344,1323,1316
49638,437,2009,17633,32005,0,49638,3.72462e+13,1175.79,6823.56,49638,659,386,42712,39234,20961,16373,15456
1854,277,422,709,1145,0,1854,4.03226e+13,26.7028,672.791,1854,111,88,1432,1432,1424,1420,543
38709,793,1586,0,38709,13796,24913,9.75951e+15,1133.64,5772.8,38709,488,376,34942,31789,21695,15678,23508
14229,324,347,0,14229,13590,639,2.44295e+16,186.821,1471.68,14229,90,93,13882,13719,13736,13662,13624
5674,1502,1526,2640,3034,0,5674,5.11789e+18,282.718,2450.13,5674,228,204,4148,4148,4141,4142,4133
41758,487,2153,21029,20729,0,41758,5.07008e+18,1468.93,7259.53,41758,546,425,33829,29656,12428,12904,12077
41336,257,2772,34478,6858,21675,19661,7.26051e+17,1722.82,8103.1,41336,640,436,29347,24805,13756,15463,4943
3578,258,1044,0,3578,0,3578,2.26372e+18,100.812,1623,3578,151,125,2534,2401,1229,1150,885
36822,1635,2766,30515,6307,18990,17832,7.45428e+17,1684.34,7701.73,36822,626,424,32933,27877,26582,26593,24767
41719,1644,2410,0,41719,0,41719,2.4521e+18,1432.17,7319.53,41719,589,424,39130,33959,27778,25516,32231
6260,52,331,0,6260,5938,322,2.61987e+16,69.0663,1006.46,6260,73,69,5848,5667,4423,3819,2472
13339,2108,2151,10863,2476,6630,6709,7.92663e+17,1057.92,4391.02,13339,343,300,11188,11186,11130,11135,11188
20935,118,2387,17601,3334,11210,9725,7.00298e+17,1367.21,5514.67,20935,458,332,13357,9686,6590,6949,1064
3465,1175,1385,3465,0,2727,738,3.15813e+18,166.732,1930.8,3465,161,155,2080,2065,2074,2075,2032
11337,483,1852,5696,5641,0,11337,5.03415e+18,761.415,3622.29,11337,311,272,8840,8005,3716,3071,3231
36520,1153,2156,36520,0,29219,7301,2.92914e+18,1673.5,7309.33,36520,489,442,30844,25907,23303,21380,21347
14681,30,348,0,14681,14015,666,2.52136e+16,199.925,1520.19,14681,99,102,13455,12729,9813,8554,5208
6732,978,1301,2402,4330,0,6732,3.76989e+13,215.993,2286.46,6732,233,193,5431,5386,4985,5005,4951
32789,1036,1713,11624,21165,0,32789,3.73626e+13,1089.82,5375.73,32789,496,344,30064,27439,20822,19240,25189
5927,227,1090,2094,3833,0,5927,3.82145e+13,164.503,1934.65,5927,244,159,4831,4592,2895,3216,1553
6066,821,1204,2164,3902,0,6066,3.77558e+13,162.899,2089.56,6066,197,148,4862,4809,4208,4438,3382
26537,1670,2213,26537,0,21569,4968,3.00907e+18,1570.5,6268.7,26537,470,399,23654,19993,22448,22039,20241
5083,425,494,4877,206,5083,0,4.41362e+18,201.92,1230.94,5083,108,101,4589,4578,4541,4554,4219
23365,1062,1473,8237,15128,0,23365,3.74179e+13,968.103,4394.16,23365,402,299,21400,19569,15921,15645,16615
9531,12,43,9022,509,9402,129,1.04221e+14,34.2948,447.899,9531,36,32,9138,8872,7288,7144,5238
49090,1725,2083,0,49090,0,49090,2.51012e+18,1448.28,7760.59,49090,579,459,47007,46029,38990,36823,45508
11495,498,699,11224,271,11495,0,4.64135e+18,348.041,2087.84,11495,195,149,10796,10588,9951,9907,9375
26568,1212,2550,22306,4262,14177,12391,7.08329e+17,1447.49,6324.35,26568,507,353,22519,19650,17472,17364,15967
28398,26,352,0,28398,27087,1311,2.49607e+16,265.376,2110.66,28398,121,130,25764,24259,18810,16341,9960
35095,482,2388,0,35095,0,35095,2.43202e+18,1465.01,6768.11,35095,535,404,28366,25242,10395,10247,7385
41297,2,42,38967,2330,40911,386,1.06948e+14,40.2861,925.416,41297,42,41,24068,19124,17908,19230,13989
37703,1044,1825,0,37703,13360,24343,9.50814e+15,1118.73,5865.41,37703,561,360,34696,31557,23033,17237,27448
49181,562,1376,0,49181,17436,31745,9.93244e+15,1140.97,6309.65,49181,492,410,43064,38966,22668,17142,22824
29873,141,591,29559,314,29873,0,4.7606e+18,489.483,3258.65,29873,228,225,25819,20668,11572,11312,7321
35191,169,2492,0,35191,0,35191,2.47136e+18,1431.41,7086.45,35191,565,401,24841,19256,7767,4207,3825
4208,1014,1073,2497,1711,2497,1711,5.04704e+18,189.67,1711.6,4208,224,168,3135,3135,3132,3130,3081
38281,38,43,36501,1780,37226,1055,9.88669e+13,40.5194,889.878,38281,42,40,38210,38163,37676,37672,35660
8687,1098,1846,0,8687,0,8687,2.43401e+18,421.655,3138.04,8687,284,250,6841,6575,4915,4889,5166
34996,629,2999,34996,0,29012,5984,2.92504e+18,1790.6,7957.64,34996,567,428,26980,22608,13214,11514,7903
15476,1368,2241,15476,0,12847,2629,3.20892e+18,1120.5,4751.2,15476,371,324,12689,11346,11437,10726,9365
43712,18,43,41471,2241,42932,780,1.02282e+14,40.876,962.13,43712,43,42,42920,42324,35491,35215,26691
26477,1841,1922,13343,13134,0,26477,5.05361e+18,1285.89,5592.21,26477,463,363,24555,24528,24244,23974,24344
4310,470,1242,2100,2210,2100,2210,5.12112e+18,178.942,1969.72,4310,200,180,3068,2871,1975,2014,1758
8648,451,1513,3106,5542,0,8648,3.72583e+13,372.644,2733.88,8648,276,195,7106,6601,4052,4437,2742
20637,1590,1757,0,20637,7307,13330,9.45893e+15,941.595,4401.14,20637,422,286,18880,18880,17438,16532,18670
38015,1346,3009,38015,0,31639,6376,3.19977e+18,1684.73,8064.41,38015,591,443,32621,28103,25999,24683,20580
44826,1127,1811,21335,23491,21335,23491,5.02011e+18,1443.87,7210.39,44826,526,448,40043,34755,24379,22218,29811
36516,103,2779,30408,6108,19034,17482,7.31227e+17,1668.88,7658.78,36516,610,416,21866,14817,10338,10865,2054
2629,28,629,888,1741,0,2629,3.42674e+13,73.2313,1074.16,2629,122,111,1613,1228,650,373,234
37549,774,1632,13341,24208,0,37549,3.84115e+13,1080.56,5782.44,37549,458,382,33832,31122,19305,19453,22213
48106,1121,1654,17084,31022,0,48106,3.81484e+13,1152.02,6530.69,48106,517,394,45402,40463,31573,34626,38339
6508,159,329,0,6508,6203,305,2.54439e+16,67.9521,1009.96,6508,72,72,6179,6131,5643,5396,4797
47764,1156,1951,16965,30799,0,47764,3.71812e+13,1176.31,6654.22,47764,631,383,44714,40396,30397,32544,36730
28552,1725,2112,22846,5706,13534,15018,8.45323e+17,1582.54,6428.66,28552,474,401,25765,21431,22468,21407,23542
41502,205,354,0,41502,39468,2034,2.58146e+16,304.086,2614.37,41502,139,158,40499,39671,35808,32693,28842
15576,1828,1911,7827,7749,0,15576,5.08644e+18,987.342,4309.49,15576,344,300,13665,13665,13388,13336,13657
31034,328,2484,31034,0,25630,5404,3.07475e+18,1595.52,6893.65,31034,519,394,22544,19171,10420,8548,4982
11617,481,575,11500,117,11617,0,4.69557e+18,371.955,2025.07,11617,152,153,11016,10802,10340,10374,9839
40052,273,2692,33119,6933,20514,19538,7.53459e+17,1731.32,7975.33,40052,604,437,28445,24009,13416,15173,6200
32879,953,1888,0,32879,0,32879,2.50541e+18,1384.46,6254.03,32879,470,407,28405,25135,15480,12867,18654
28556,24,43,27206,1350,27832,724,9.92203e+13,39.8912,771.87,28556,41,39,28304,28117,24942,24899,20016
46024,220,1757,16279,29745,0,46024,3.75944e+13,1144.67,6424.91,46024,533,379,37751,34546,15009,9307,9765
31882,1038,2110,0,31882,0,31882,2.43775e+18,1358.61,6266.47,31882,509,386,27923,24795,15203,13525,17212
23184,151,667,22777,407,23184,0,4.63646e+18,490.049,2950.51,23184,214,206,20272,16935,8838,9008,6075
14053,777,1525,4953,9100,0,14053,3.68924e+13,722.457,3419.39,14053,328,224,12098,11397,8536,8021,9247
47139,363,662,46506,633,47139,0,4.68897e+18,524.19,4152.83,47139,260,251,45323,43729,33558,33639,29414
43140,169,352,0,43140,40820,2320,2.68237e+16,304.115,2701.9,43140,149,162,41842,40850,35610,30864,27947
19066,1466,1642,0,19066,6724,12342,9.42182e+15,864.159,4086.99,19066,375,278,17424,17401,17146,16388,17303
41938,1430,2406,21221,20717,21221,20717,4.95962e+18,1656.35,7640.29,41938,565,431,38032,33277,23041,21687,28221
1939,9,29,1846,93,1881,58,1.11923e+14,15.7065,173.891,1939,20,18,1838,1772,1462,1419,1037
19440,1402,2034,15568,3872,9265,10175,8.39562e+17,1405,5247.59,19440,395,337,16357,14082,13531,13240,13428
4890,1026,1299,2696,2194,0,4890,5.29755e+18,183.393,2076.44,4890,187,153,3591,3590,3545,3540,2761
15264,35,43,14580,684,14797,467,9.69233e+13,34.3938,560.326,15264,36,35,15205,15174,14487,14489,13754
22767,425,1844,8168,14599,0,22767,3.83736e+13,877.039,4779.36,22767,446,307,19266,17562,9164,8055,7621
38580,2014,2235,0,38580,0,38580,2.44839e+18,1489.36,6884.31,38580,578,407,36345,35981,33542,32552,36220
9791,274,373,0,9791,9251,540,2.71275e+16,174.969,1333.23,9791,95,88,9418,9303,8808,8485,8071
31431,1300,2034,0,31431,0,31431,2.48478e+18,1337.26,6146.39,31431,471,392,28311,24856,18916,16720,22283
4525,234,457,4516,9,4525,0,4.73169e+18,179.464,1171.72,4525,105,110,4068,3924,2844,2896,2655
10030,1122,1671,4919,5111,4919,5111,5.1919e+18,737.61,3315.7,10030,254,263,8359,7580,6052,5789,6625
1974,558,697,996,978,0,1974,5.41422e+18,111.005,1047.26,1974,102,106,1277,1277,1272,1271,1198
44405,26,354,0,44405,42399,2006,2.49237e+16,293.237,2650.16,44405,141,154,40340,38040,29450,25643,15668
21213,661,810,20543,670,21213,0,4.55844e+18,436.228,2879.14,21213,244,187,20403,20149,19931,19962,19068
37120,2425,2615,30678,6442,19125,17995,7.55245e+17,1648.21,7594.34,37120,572,428,34505,34504,33718,33561,34014
40436,292,1830,14383,26053,0,40436,3.73259e+13,1114.17,6035.84,40436,567,366,34011,31360,15205,13017,11462
42047,1382,2844,42047,0,35021,7026,3.30083e+18,1766.55,8277.96,42047,670,444,36676,31344,33236,30781,22963
25462,50,856,24824,638,25462,0,4.52215e+18,469.171,3218.36,25462,249,198,16952,10617,6909,6297,1820
26726,773,2490,22258,4468,13996,12730,7.31244e+17,1535.49,6372.27,26726,518,376,21318,18301,13779,13595,9727
7737,1564,1817,0,7737,0,7737,2.44549e+18,271.474,2973.54,7737,245,184,5920,5877,5864,5848,5365
29857,933,2189,0,29857,0,29857,2.43912e+18,1298.69,6051.5,29857,527,372,25668,23147,14089,13904,15630
7015,134,332,0,7015,6694,321,2.49814e+16,71.9033,1041.59,7015,75,71,6683,6644,6053,5754,4344
2816,824,910,1430,1386,0,2816,5.10246e+18,221.267,1410.22,2816,181,139,1906,1896,1851,1845,1839
3632,208,428,3545,87,3632,0,4.69648e+18,163.03,1020.39,3632,88,90,3177,3034,2371,2377,2132
9645,3,43,9109,536,9526,119,1.07191e+14,37.0633,460.808,9645,36,34,6750,5592,4986,5173,3573
36208,1585,2236,18265,17943,0,36208,5.04628e+18,1410.2,6833.25,36208,512,406,33683,29092,23362,21404,28454
1437,84,219,1281,156,1437,0,3.41995e+18,29.247,408.136,1437,83,36,1218,1180,756,682,166
5104,5,42,4824,280,5040,64,1.06656e+14,27.4967,329.774,5104,30,27,4270,3837,3204,3226,2030
28002,2215,2488,23397,4605,14762,13240,7.18955e+17,1542.61,6477.15,28002,512,365,25514,25364,23844,23453,24835
2917,539,979,1474,1443,1474,1443,5.45811e+18,115.625,1477.15,2917,158,141,1938,1918,1660,1622,1307
25932,481,1587,0,25932,9151,16781,9.45916e+15,1023.82,4697.57,25932,472,308,22279,20504,12160,7802,9998
30567,329,355,0,30567,29120,1447,2.55044e+16,282.974,2237.26,30567,127,139,30162,29561,29477,29268,28748
35057,1705,1714,12501,22556,0,35057,3.75077e+13,1082.33,5517.33,35057,495,352,33343,33343,33324,33337,33325
24006,1074,2184,19497,4509,11817,12189,7.95386e+17,1516.24,5949.85,24006,463,365,19773,16920,14148,13703,12190
38323,1509,1783,18260,20063,0,38323,5.15355e+18,1413.46,6652.72,38323,497,430,35986,30607,27503,26075,33382
20516,306,711,19889,627,20516,0,4.5891e+18,462.484,2771.89,20516,215,186,19278,18400,14589,14637,10854
18087,1236,2064,14588,3499,8690,9397,8.30999e+17,1400.27,5110.7,18087,380,334,14821,12796,11407,11187,10723
704,207,246,663,41,704,0,4.87576e+18,59.6094,379.596,704,47,42,458,450,456,456,411
38132,2288,2528,18025,20107,18025,20107,4.94656e+18,1576.01,7506.4,38132,552,421,35604,35587,31606,31201,35328
47497,75,2548,24888,22609,24888,22609,4.91629e+18,1518.9,7963.49,47497,656,437,29479,21160,11448,10572,2109
23737,797,1851,11365,12372,0,23737,5.04668e+18,1261.26,5298.47,23737,415,361,19855,17672,9942,8579,12315
19571,89,2718,107,19464,12568,7003,1.56666e+16,172.468,5117.08,19571,811,278,15904,14621,9919,8323,4327
30112,1020,1350,10659,19453,0,30112,3.88707e+13,1051.78,4931.01,30112,410,353,27973,25008,20421,17469,23643
45788,470,2500,0,45788,0,45788,2.44634e+18,1484.25,7766.28,45788,636,439,37202,32914,13406,12754,8775
34735,514,2376,0,34735,0,34735,2.42296e+18,1420.78,6745.66,34735,557,389,28182,24884,10368,9689,8743
39625,1307,1349,13978,25647,0,39625,3.86611e+13,1102.12,5633.3,39625,456,379,38276,38276,38063,38165,38041
20325,832,2481,20325,0,16966,3359,3.34495e+18,1357.62,5563.17,20325,478,344,16093,13900,10816,10276,8705
44837,852,2075,21118,23719,0,44837,5.14792e+18,1383.89,7379.42,44837,528,432,38527,33851,16808,14489,20745
37093,1637,2310,0,37093,0,37093,2.44749e+18,1442.41,6891.41,37093,563,413,34551,30007,24432,21238,29792
13047,19,44,12312,735,12919,128,1.06899e+14,34.4799,519.688,13047,36,34,12823,12661,10744,10665,9290
35681,1459,2391,35681,0,29219,6462,3.0729e+18,1659.49,7369.7,35681,527,433,31331,26622,27516,24687,23890
22554,171,816,21998,556,22554,0,4.57568e+18,501.295,3021.61,22554,251,193,20081,17718,9841,8910,5875
11887,527,620,11807,80,11887,0,4.72279e+18,352.233,2084.02,11887,175,158,11267,11125,10932,10924,10478
5518,684,1416,2671,2847,2671,2847,5.14631e+18,240.053,2310.72,5518,233,196,4102,3862,2932,2915,2788
2601,16,39,2472,129,2547,54,1.06703e+14,21.0742,240.368,2601,26,25,2520,2478,2163,2156,1871
19810,575,1457,0,19810,7026,12784,9.69129e+15,932.915,4087.2,19810,343,295,17001,15721,9605,7263,8941
10472,110,2148,8796,1676,5649,4823,7.05769e+17,727.049,3773.43,10472,281,261,6417,4461,3082,3264,746
38118,40,43,36296,1822,37191,927,1.00685e+14,39.0788,888.114,38118,42,41,38060,38028,37931,37929,36094
10532,799,1866,5490,5042,5490,5042,4.98669e+18,650.404,3477.88,10532,295,267,8566,7866,5157,5422,5316
39236,248,1750,0,39236,0,39236,2.53437e+18,1414.99,6664.84,39236,499,425,29147,24783,8000,5173,6771
3433,179,458,3378,55,3433,0,4.60415e+18,176.47,1048.58,3433,101,95,2924,2599,1758,1782,1383
7921,164,351,0,7921,7468,453,2.75914e+16,125.322,1152.91,7921,80,83,7560,7426,6617,6174,5548
39340,1472,1826,0,39340,13939,25401,9.50553e+15,1115.67,5974.27,39340,572,359,37514,37459,31780,28080,36603
40199,10,43,38309,1890,39132,1067,9.92192e+13,39.9504,909.154,40199,42,40,38261,36885,30354,29763,20987
36374,775,1919,0,36374,0,36374,2.48835e+18,1424.25,6609.82,36374,521,416,30727,27151,14692,12875,17994
24366,1459,1641,0,24366,8644,15722,9.5569e+15,989.003,4593.2,24366,429,309,22725,22669,20832,20085,22488
45522,164,365,0,45522,43169,2353,2.63937e+16,311.34,2809.3,45522,153,166,44092,43074,37277,32022,28580
47654,1673,1735,0,47654,16726,30928,9.83123e+15,1282.82,6762.75,47654,587,402,45919,45919,45633,45493,45786
39740,66,883,38685,1055,39740,0,4.59755e+18,591.674,4042.01,39740,318,238,28653,19493,12244,10967,3848
17015,41,43,16232,783,16559,456,9.98358e+13,35.8387,590.286,17015,38,35,16970,16960,16931,16930,16771
11830,1032,1950,5873,5957,5873,5957,4.80927e+18,829.88,3789.82,11830,342,254,9712,8840,6165,5654,6207
11455,169,2202,9717,1738,6259,5196,6.73971e+17,822.296,3954.63,11455,335,265,7682,5993,3787,4080,893
31447,1560,2252,0,31447,0,31447,2.43752e+18,1362.94,6304.54,31447,518,372,28869,25259,20189,18499,23596
33294,1355,2683,33294,0,28005,5289,3.29269e+18,1580.71,7199.06,33294,597,417,28733,25008,26027,24213,20733
24982,1083,2379,24982,0,20409,4573,3.0224e+18,1529.22,6209.63,24982,468,389,20566,17598,14664,13845,13486
9094,69,348,0,9094,8685,409,2.48645e+16,108.59,1181.84,9094,83,82,8626,8463,6831,5756,4641
49799,1038,1948,17708,32091,0,49799,3.73012e+13,1157.07,6769.35,49799,632,383,46239,41934,30379,33222,37326
41508,464,3003,34561,6947,21636,19872,7.34538e+17,1710.33,8324.82,41508,622,440,31576,27361,16446,17994,7667
20708,650,809,20159,549,20708,0,4.61538e+18,485.745,2897.01,20708,218,179,19899,19545,19190,19204,18157
44581,28,42,42432,2149,43495,1086,1.00017e+14,39.7501,943.037,44581,42,41,44357,44204,39919,39961,34487
34193,32,43,32442,1751,33574,619,1.03122e+14,40.6252,847.313,34193,42,40,34054,33946,31400,31454,28611
21907,373,1904,11150,10757,0,21907,5.08472e+18,1224.37,5110.79,21907,391,338,17137,15336,6230,6048,4538
27682,1551,2224,14746,12936,14746,12936,4.8628e+18,1238.47,5819.08,27682,532,356,25216,22334,18410,17767,20983
36473,424,1806,12987,23486,0,36473,3.73247e+13,1131.44,5744.9,36473,537,355,31215,28668,14684,11433,8549
47803,2732,2983,47803,0,39925,7878,3.34828e+18,1805.28,8910.91,47803,705,466,44820,44820,44625,44642,44268
14288,474,1808,7099,7189,0,14288,5.06672e+18,975.676,4077.62,14288,328,295,11238,10005,4864,4415,4429
22936,1339,2478,19135,3801,12014,10922,7.25076e+17,1459.42,5910.07,22936,474,360,19245,16954,15601,15335,13805
19782,1045,1894,0,19782,0,19782,2.47156e+18,1119.49,4795.52,19782,399,325,17019,15384,10643,9074,11087
26324,1306,2146,0,26324,0,26324,2.48315e+18,1290.3,5855.56,26324,483,365,23478,20447,15515,13932,17648
21664,240,737,21283,381,21664,0,4.63827e+18,446.744,2893.21,21664,226,197,20048,18717,11030,10924,9211
26659,16,1654,0,26659,9467,17192,9.56493e+15,1054.29,4792.97,26659,469,315,14095,10492,6604,3122,1026
17246,1255,2170,17246,0,13899,3347,3.05494e+18,1363.2,5067.37,17246,374,337,14272,12229,11370,10702,9936
26136,498,936,25738,398,26136,0,4.74822e+18,591.05,3456.79,26136,292,213,24898,24172,19937,19687,18225
49743,24,43,47045,2698,49045,698,1.04537e+14,41.3175,1024.79,49743,43,43,49284,48911,42667,42611,33886
46538,412,2616,46538,0,37836,8702,2.98767e+18,1813.47,8795.94,46538,584,484,34090,28261,14752,11748,9502
49426,1563,2326,39907,9519,24014,25412,8.12672e+17,1765.67,8638.23,49426,616,482,44785,37263,36345,35629,37545
3814,124,218,0,3814,3621,193,2.71681e+16,49.9402,666.314,3814,58,53,3596,3576,3300,3307,2627
41187,1345,2053,0,41187,0,41187,2.48544e+18,1480.79,7084.49,41187,532,431,37690,32659,25302,22411,30456
13894,215,709,13729,165,13894,0,4.75708e+18,419.641,2377.63,13894,209,169,12480,11223,6445,6485,5026
23499,278,359,0,23499,22465,1034,2.48779e+16,264.871,1943,23499,113,122,23009,22647,21587,20660,20616
20045,1547,3415,7019,13026,0,20045,3.28833e+13,429.359,5894.58,20045,789,329,16630,16317,10637,10476,8988
44187,1272,1796,0,44187,15609,28578,9.55065e+15,1148.21,6302.96,44187,562,373,42028,37491,31179,24865,37477
1452,36,526,0,1452,0,1452,2.31285e+18,27.7293,751.922,1452,103,76,898,676,466,430,373
14827,1800,3370,6698,8129,0,14827,4.47112e+18,408,5463.26,14827,857,278,11457,11326,9648,9178,8845
5646,821,1324,3010,2636,0,5646,4.99718e+18,213.427,2188.28,5646,267,202,4322,4245,3256,3173,3303
5899,386,1857,5899,0,4819,1080,3.06175e+18,290.712,2822.74,5899,214,178,3982,3542,1922,1376,884
36969,288,1557,13039,23930,0,36969,3.78006e+13,1091.8,5630.75,36969,479,366,30869,28261,13111,9437,9564
3343,236,1093,1437,1906,0,3343,4.53545e+18,194.87,1639.2,3343,203,124,2190,1895,726,614,619
47014,23,356,0,47014,44326,2688,2.73094e+16,312.825,2857.62,47014,160,168,41019,37227,27855,23936,14031
35159,846,2603,0,35159,0,35159,2.51632e+18,1531.04,7303.35,35159,582,411,29024,25741,9947,10651,13211
20253,331,2136,10347,9906,0,20253,4.95218e+18,1177.66,5057.35,20253,452,323,15591,13938,5279,4695,3043
43785,1537,2457,35907,7878,22036,21749,7.72451e+17,1724.38,8202.34,43785,572,455,39201,32775,31555,31439,30353
36442,1819,1868,0,36442,12843,23599,9.81449e+15,1199.39,6103.21,36442,520,370,34574,34574,34524,34543,34568
17673,1136,2124,14234,3439,8494,9179,8.26882e+17,1372.95,5081.37,17673,401,329,14399,12371,10624,10497,9868
31676,655,1709,0,31676,11245,20431,9.51425e+15,1051.27,5259.51,31676,486,339,27851,25754,16935,11386,18261
41717,1200,1599,0,41717,14782,26935,9.72615e+15,1115.8,6015.48,41717,476,379,39665,35188,30015,24184,33914
16837,1135,2113,0,16837,0,16837,2.44643e+18,1022.67,4590.88,16837,394,303,14213,13024,8858,8643,9540
19072,20,43,18177,895,18571,501,9.97238e+13,39.5168,634.797,19072,39,36,18807,18617,16020,15846,12864
12699,283,348,0,12699,12033,666,2.63174e+16,218.159,1454.27,12699,94,96,12310,12138,11600,11192,10873
47966,409,1969,17052,30914,0,47966,3.72945e+13,1140.02,6689.85,47966,593,384,41183,37887,19387,15865,18721
4447,265,473,4421,26,4447,0,4.85351e+18,205.128,1181.24,4447,110,109,3974,3844,3131,3144,2906
5897,1044,1173,2128,3769,0,5897,3.68332e+13,190.097,2028.2,5897,216,169,4724,4691,4619,4631,4619
49798,788,1964,24511,25287,0,49798,5.11102e+18,1480.27,7732.84,49798,573,454,42507,37449,19320,17051,21738
27853,694,1475,9864,17989,0,27853,3.79628e+13,1043.28,4841.22,27853,400,332,24590,22557,14826,14690,13989
29507,372,2369,29507,0,23732,5775,2.97883e+18,1616.1,6803.8,29507,473,420,20919,17593,8770,6948,6045
46237,1341,2124,0,46237,0,46237,2.49147e+18,1467.4,7591.6,46237,550,442,42521,36729,26991,23517,34174
29553,868,2371,24240,5313,14931,14622,7.77193e+17,1615.58,6697.04,29553,515,396,23843,20247,16116,15152,10979
43554,114,355,0,43554,41465,2089,2.55083e+16,310.104,2679.16,43554,144,153,41984,41176,33883,29047,22726
33340,1383,1589,0,33340,11842,21498,9.65717e+15,1102.12,5356.33,33340,494,344,31751,29291,27674,25241,30200
47218,226,2135,23889,23329,0,47218,5.0828e+18,1459.48,7628.53,47218,559,448,35266,30435,11610,9402,7119
18947,137,2495,18947,0,15697,3250,3.27826e+18,1315.7,5438.31,18947,461,327,12018,8018,5158,3864,1297
38485,483,1649,0,38485,13648,24837,9.62735e+15,1143.96,5810.23,38485,496,359,33166,30228,17076,11685,13626
42526,1182,3374,42526,0,35562,6964,3.16676e+18,1693.8,8755.13,42526,624,478,36013,30754,25268,23767,18448
18025,332,1891,9174,8851,9174,8851,5.05353e+18,1084.73,4622.66,18025,343,320,13894,12451,4756,4574,3159
30603,309,2242,15932,14671,0,30603,5.0064e+18,1369.29,6238.97,30603,520,378,23709,20936,8405,7453,4720
24967,1103,2039,13249,11718,13249,11718,4.98184e+18,1250.99,5467.67,24967,437,346,21751,19586,13954,13522,14153
30567,591,1759,0,30567,10822,19745,9.49624e+15,1046.65,5223.73,30567,488,327,26555,24661,15866,10359,12347
32932,1356,2313,16603,16329,0,32932,5.07549e+18,1442.37,6692.56,32932,529,396,29443,25995,18372,16448,23071
10325,994,1309,3614,6711,0,10325,3.78563e+13,607.9,2837.74,10325,272,211,9016,8382,7239,7201,8063
40748,1,44,38566,2182,40277,471,1.06717e+14,40.9093,922.98,40748,43,41,13455,13455,13455,13455,13455
20023,866,2030,0,20023,0,20023,2.46637e+18,1089.38,4827.72,20023,392,316,16969,15457,10336,9713,9884
9901,320,674,9742,159,9901,0,4.63601e+18,329.397,1941.45,9901,171,141,9130,8781,6813,6926,5418
20452,228,354,0,20452,19478,974,2.56881e+16,250.913,1822.03,20452,108,119,19910,19578,18074,16882,15609
35518,83,2077,0,35518,0,35518,2.49303e+18,1395.76,6653.45,35518,488,412,21836,15460,7748,3870,2041
8971,1003,1727,4204,4767,4204,4767,4.90864e+18,634.767,3173.9,8971,277,222,7244,6596,4830,4815,5623
35096,1466,2321,18192,16904,0,35096,4.98579e+18,1430.26,6726.93,35096,562,400,32050,28026,20862,18821,24840
48607,152,793,47754,853,48607,0,4.66202e+18,558.274,4369.02,48607,273,253,42740,35725,18860,19083,11415
14306,609,640,14100,206,14306,0,4.67426e+18,383.403,2283.81,14306,180,171,13666,13661,13641,13625,13646
31454,874,2680,26335,5119,16650,14804,7.15832e+17,1612.27,7014.4,31454,576,389,25457,21910,17572,16723,10292
28448,1225,1680,10111,18337,0,28448,3.74436e+13,1014.15,4937.09,28448,466,325,26470,24123,20703,19944,24531
30415,346,1760,10817,19598,0,30415,3.72291e+13,1048.44,5205.87,30415,486,329,25707,23605,12651,9960,8223
37257,293,372,0,37257,35368,1889,2.62589e+16,309.088,2557.45,37257,138,146,36638,35892,33582,31497,31226
14342,1848,1904,7646,6696,7646,6696,4.9003e+18,891.231,4028.9,14342,380,290,12438,12438,12381,12320,11764
34806,59,599,34484,322,34806,0,4.75671e+18,498.189,3518.73,34806,238,235,23137,13000,8378,8153,3678
2420,155,180,0,2420,2318,102,2.7513e+16,38.3376,504.032,2420,41,45,2240,2240,2224,2231,2128
22654,452,857,21978,676,22654,0,4.49555e+18,460.321,3039.35,22654,233,193,21578,20974,16731,16551,13372
26255,864,2548,22042,4213,14028,12227,7.07578e+17,1455.87,6289.28,26255,507,351,21311,18382,14619,13784,11638
2503,27,36,2378,125,2443,60,1.12005e+14,22.3492,216.167,2503,24,21,2464,2455,2372,2374,2328
4859,120,254,0,4859,4622,237,2.48547e+16,63.4184,775.57,4859,61,54,4605,4584,4203,4121,3052
37625,89,352,0,37625,35624,2001,2.64828e+16,300.706,2521.37,37625,138,152,35913,35163,27084,23592,16392
39623,164,1568,0,39623,14012,25611,9.77228e+15,1121.17,5891.07,39623,492,376,31389,28427,11475,8882,6698
23310,46,346,0,23310,22048,1262,2.67705e+16,273.753,1988.28,23310,119,124,21688,20667,15412,13226,8573
30595,1557,5441,14106,16489,14106,16489,4.42343e+18,832.35,9297.91,30595,921,525,25154,23796,12810,11334,10715
46686,447,1888,16577,30109,0,46686,3.72403e+13,1157.49,6540.48,46686,618,381,40261,36911,19497,16950,15944
6175,1345,1842,4901,1274,2914,3261,8.46762e+17,278.524,2824.18,6175,213,199,4333,4318,3869,3757,3405
12643,1132,2305,12643,0,10487,2156,3.02583e+18,981.556,4338.35,12643,344,288,9960,8806,8375,7920,7155
25560,215,2221,0,25560,0,25560,2.42506e+18,1317.18,5695.79,25560,489,348,18963,16228,7063,2803,3600
31050,435,1752,0,31050,10960,20090,9.89647e+15,1085.44,5448.25,31050,457,358,26208,23696,11815,8942,11175
15262,30,348,0,15262,14556,706,2.525e+16,206.949,1557.81,15262,100,106,13975,13218,10222,9130,5968
47352,225,2493,24866,22486,0,47352,5.0118e+18,1495.34,7877.98,47352,653,437,35673,31019,12924,10590,6665
1055,206,225,1055,0,1055,0,5.05387e+18,97.8237,442.955,1055,57,60,830,829,812,812,801
30243,34,351,0,30243,28503,1740,2.72858e+16,296.574,2285.82,30243,135,143,27447,25689,18502,15918,9840
9870,101,1457,3533,6337,0,9870,3.78102e+13,332.505,2744.08,9870,252,180,7760,6831,3735,2018,894
21374,1996,2053,11356,10018,11356,10018,4.94341e+18,1132.46,5044.08,21374,440,322,19321,19321,19267,19183,18669
15462,1812,2362,15462,0,12918,2544,3.31693e+18,1114.95,4808.67,15462,380,284,12987,11635,12553,12377,10875
31446,1151,1653,0,31446,11155,20291,9.6796e+15,1063.92,5279.84,31446,454,338,29279,26385,20983,16759,24546
5122,17,588,5082,40,5122,0,4.97096e+18,219.356,1377.41,5122,147,116,1902,697,570,511,149
49302,160,370,0,49302,47000,2302,2.54078e+16,309.048,2872.73,49302,150,161,47906,46936,40910,35641,29558
42869,2429,2827,35880,6989,22763,20106,7.15459e+17,1702.46,8241.11,42869,648,435,40042,40042,38171,37788,38769
6009,1281,1760,5090,919,3252,2757,7.07341e+17,176.23,2645.23,6009,250,171,4249,4196,3989,3936,3786
14885,39,43,14205,680,14463,422,9.78973e+13,35.7129,554.3,14885,37,35,14837,14826,14726,14723,13950
35676,1860,2127,18298,17378,18298,17378,4.9627e+18,1406.19,6681.25,35676,506,408,33549,33436,30383,29788,32294
27730,1361,2084,0,27730,0,27730,2.43523e+18,1296.85,5770.1,27730,510,357,24938,22030,17094,15530,18631
34901,222,359,0,34901,33339,1562,2.49552e+16,273.043,2363.81,34901,132,140,34142,33483,30900,28528,27784
7958,630,1949,3770,4188,3770,4188,4.92934e+18,377.254,3196.43,7958,294,224,6009,5376,3096,2782,2837
45723,29,43,43599,2124,44458,1265,9.82146e+13,40.1298,967.593,45723,43,40,45500,45340,41458,41421,37967
30579,26,43,29181,1398,29739,840,9.85106e+13,39.7706,792.515,30579,42,38,30375,30247,27114,27166,24285
30336,1000,1707,10745,19591,0,30336,3.70848e+13,1065.45,5173.54,30336,495,331,27574,25321,19513,17934,22176
3004,88,1069,3004,0,2533,471,2.99903e+18,130.137,1581.53,3004,121,136,1571,917,862,658,200
48568,1045,2504,25265,23303,0,48568,4.97234e+18,1498.68,7986.06,48568,679,444,42893,37961,21542,20605,24639
13260,1277,1474,0,13260,4714,8546,9.55826e+15,627.109,3217.47,13260,345,241,11786,11160,10608,8749,11030
31927,30,43,30447,1480,31072,855,9.90856e+13,40.5772,810.49,31927,41,39,31776,31688,29149,29071,26371
33716,1762,2395,27192,6524,16068,17648,8.20863e+17,1780.55,7323.1,33716,524,421,30518,25375,24811,24232,25702
8226,1141,1295,0,8226,2912,5314,1.00966e+16,419.162,2514.79,8226,236,212,6931,6661,6467,5996,6562
30741,825,1943,0,30741,0,30741,2.46906e+18,1334.53,6054.87,30741,475,385,26161,23203,13108,11982,15165
5937,388,1290,0,5937,2109,3828,9.62576e+15,162.541,2173.82,5937,217,167,4647,4460,2897,2267,2168
46452,1539,1794,0,46452,16452,30000,9.55429e+15,1209.72,6456.94,46452,581,384,44658,44611,40426,38296,43554
5423,164,1409,2557,2866,0,5423,5.1056e+18,198.081,2276.68,5423,233,201,3784,2887,1258,1003,901
14801,1438,2156,12101,2700,7355,7446,7.80184e+17,1147.6,4638.53,14801,356,297,12162,10810,10224,10219,9522
36035,305,348,0,36035,34163,1872,2.62915e+16,295.756,2450.54,36035,137,146,35533,34714,33730,31754,33124
32522,283,361,0,32522,30782,1740,2.67652e+16,295.772,2376.6,32522,137,143,31923,31209,29379,27379,28768
44250,773,1636,15715,28535,0,44250,3.77622e+13,1145.37,6180.73,44250,496,382,39816,36358,24229,24109,28110
6106,654,1166,0,6106,2201,3905,9.92671e+15,193.076,2039.81,6106,240,161,4940,4877,4154,3142,2944
27185,305,1345,9593,17592,0,27185,3.87536e+13,1010.94,4663.68,27185,391,341,22629,20688,10103,6360,8144
30559,304,356,0,30559,29153,1406,2.51433e+16,276.309,2210.21,30559,126,131,30103,29538,28797,27537,28003
43302,557,2444,0,43302,0,43302,2.43827e+18,1483.71,7527.58,43302,616,431,35570,31527,13341,14122,14141
15284,328,348,0,15284,14587,697,2.52419e+16,206.083,1555.07,15284,102,101,14928,14731,14759,14785,14417
21995,37,1650,7764,14231,0,21995,3.67422e+13,945.519,4361.71,21995,430,287,14314,11470,6396,2481,3066
45197,132,2652,37106,8091,22766,22431,7.74329e+17,1751.06,8475.01,45197,618,461,28283,18511,12905,13236,3424
47847,202,356,0,47847,45161,2686,2.73325e+16,314.605,2870.6,47847,158,172,46539,45388,40181,35667,33354
41868,1352,2160,0,41868,0,41868,2.47195e+18,1419.38,7184.83,41868,561,429,38492,33492,25095,21561,30436
37544,185,966,36518,1026,37544,0,4.55343e+18,564.428,3988.74,37544,308,224,33914,30325,17098,16468,10029
17329,1783,1987,8857,8472,0,17329,4.93338e+18,1025.58,4530.62,17329,422,309,15342,14011,13703,13478,14526
11834,80,2224,11834,0,9896,1938,3.17508e+18,821.241,4063.29,11834,290,246,7003,4923,3658,3628,337
2964,515,765,1022,1942,0,2964,3.54253e+13,90.3846,1245.7,2964,161,117,2199,2198,1926,1948,1885
15530,546,705,15108,422,15530,0,4.62814e+18,428.964,2433.32,15530,199,164,14770,14463,14155,14084,13544
16259,12,43,15481,778,15833,426,9.92843e+13,38.4826,580.72,16259,37,33,15663,15251,12535,12298,8497
10282,1546,1988,8144,2138,4898,5384,8.72127e+17,841.358,3707.12,10282,277,241,8294,7467,7137,6885,7287
49591,963,965,48275,1316,49591,0,4.5892e+18,619.382,4564.52,49591,300,249,48626,48626,48626,48624,48623
30643,1065,1806,0,30643,10907,19736,9.49158e+15,1047.04,5245.24,30643,507,325,28093,25679,19912,15210,24408
32334,302,680,31715,619,32334,0,4.60522e+18,524.299,3480.16,32334,235,222,30550,29113,18455,18157,16348
34809,1020,2297,18455,16354,18455,16354,4.91612e+18,1363.67,6614.88,34809,566,380,30498,27180,16934,17623,18191
38534,227,349,0,38534,36673,1861,2.57889e+16,285.891,2502.56,38534,139,151,37722,36951,33866,31180,29245
20405,296,358,0,20405,19454,951,2.52847e+16,249.732,1829.13,20405,114,120,19991,19635,18854,18110,17569
39918,2684,2753,39918,0,33207,6711,3.28467e+18,1745.76,7988.7,39918,631,439,37165,37165,37145,37141,37155
18864,1107,1588,6728,12136,0,18864,3.76247e+13,806.921,3954.35,18864,360,284,17065,15882,13379,12865,15212
9685,123,1792,4742,4943,4742,4943,4.76277e+18,575.837,3275.13,9685,322,237,6693,5100,2374,2477,889
28652,1561,2289,0,28652,0,28652,2.40617e+18,1304.94,6014.92,28652,533,363,26074,23020,19031,17176,21839
41757,521,889,40846,911,41757,0,4.53779e+18,534.645,4132.25,41757,305,236,40620,39373,32773,32627,30171
47136,1196,2884,39366,7770,24721,22415,7.24511e+17,1764.3,8720.03,47136,678,451,40273,34813,31096,30463,23093
23864,2,43,22580,1284,23524,340,1.04008e+14,38.7791,705.925,23864,40,38,14227,11445,10818,11536,8751
43970,461,773,43066,904,43970,0,4.60921e+18,576.317,4146.23,43970,271,244,42540,41196,34924,34927,29239
10806,903,1394,0,10806,3833,6973,9.79026e+15,603.402,2966.92,10806,271,241,9412,8749,6634,6624,7385
34805,744,2524,0,34805,0,34805,2.46145e+18,1421.16,7041.27,34805,569,393,28968,25263,11753,12059,12728
14840,240,2025,7841,6999,0,14840,4.97345e+18,908.182,4208.84,14840,382,292,11190,9868,4781,4365,2299
35379,1609,1740,16897,18482,0,35379,5.16262e+18,1398.85,6335.03,35379,476,418,33545,28603,30301,29907,32578
23900,1,43,22625,1275,23539,361,1.0404e+14,37.6862,703.339,23900,40,38,8108,8108,8108,8108,8108
13949,902,1398,0,13949,4933,9016,9.80859e+15,737.731,3375.25,13949,304,265,12190,11399,8832,7569,9387
39905,987,1790,0,39905,0,39905,2.54126e+18,1452.73,6812.24,39905,512,435,34762,30324,19848,15676,24134
8530,376,665,8311,219,8530,0,4.67781e+18,270.394,1780.49,8530,146,134,7865,7665,6801,6713,5727
30695,775,1706,0,30695,10888,19807,9.54227e+15,1070.13,5218.28,30695,486,340,27270,25107,17100,11834,19204
47016,379,2910,47016,0,39312,7704,3.31724e+18,1752.51,8725.34,47016,690,475,35093,30825,18282,14841,9193
1722,560,849,1722,0,1459,263,2.60126e+18,109.199,1113.64,1722,149,113,873,867,711,699,648
46480,10,43,44327,2153,45214,1266,9.88072e+13,40.9913,978.824,46480,43,41,44236,42644,35163,34459,23119
29816,2029,2249,0,29816,0,29816,2.42607e+18,1327.4,6123.95,29816,518,364,27567,27567,26260,25537,27190
19595,1974,2058,10512,9083,10512,9083,4.95249e+18,1094.56,4827.06,19595,409,305,17537,17534,17419,17294,16883
46686,288,355,0,46686,44519,2167,2.52988e+16,301.443,2748.79,46686,146,154,46049,45113,43045,40588,41573
27521,1069,1686,9772,17749,0,27521,3.74504e+13,1048.31,4945.81,27521,445,327,25261,22991,17489,17066,18175
25635,2650,4163,12496,13139,0,25635,4.65678e+18,678.486,7532.74,25635,488,462,21472,21393,18569,17645,17533
16580,1050,2249,13714,2866,8476,8104,7.61531e+17,1278.37,4962.8,16580,383,331,13404,11662,9959,9715,7617
10567,883,2159,10567,0,8710,1857,3.16645e+18,770.283,3835.34,10567,323,239,8177,7250,5709,5373,4889
13976,1198,2216,11456,2520,7021,6955,7.8311e+17,1079.47,4540.42,13976,350,312,11088,9994,8689,8529,7843
4891,113,560,4808,83,4891,0,4.63381e+18,246.35,1340.57,4891,135,106,3772,2649,1799,1910,1295
2973,474,944,1357,1616,1357,1616,4.75849e+18,125.805,1447.63,2973,163,134,2029,1987,1566,1530,1532
18090,1064,2026,18090,0,14511,3579,3.03217e+18,1366.97,5058.65,18090,360,332,14551,12583,10525,9933,10016
28906,1587,1604,0,28906,10213,18693,9.63638e+15,1073.03,5016.52,28906,459,335,27302,27302,27265,27250,27299
10928,176,1666,5178,5750,0,10928,5.14656e+18,813.948,3459.94,10928,295,269,7675,6005,2231,1754,1706
34932,76,354,0,34932,33275,1657,2.56138e+16,294,2391.05,34932,132,144,33328,32593,25682,22140,15566
18409,491,722,18031,378,18409,0,4.59395e+18,452.35,2677.49,18409,197,184,17609,17138,15864,15883,14744
15284,884,1523,0,15284,5435,9849,9.52303e+15,798.817,3583.81,15284,358,264,13271,12537,9841,8171,10047
16656,65,1999,8766,7890,8766,7890,4.91495e+18,1022.99,4461.08,16656,395,295,10067,7284,3994,3781,730
10410,292,353,0,10410,9965,445,2.45177e+16,142.1,1270.55,10410,87,85,10057,9981,9676,9567,9014
15429,731,2176,7802,7627,0,15429,5.00215e+18,975.099,4530.37,15429,407,301,12414,11105,6279,5197,5804
39652,2516,2773,39652,0,33108,6544,3.2785e+18,1718.98,7968.33,39652,669,446,36879,36879,36587,36636,36313
16423,1528,1581,5794,10629,0,16423,3.72937e+13,796.924,3740.88,16423,385,269,14842,14840,14789,14827,14834
8835,868,1775,4320,4515,0,8835,5.19332e+18,586.228,3204.3,8835,261,233,7060,6423,4202,3873,4838
49121,150,944,47664,1457,49121,0,4.57263e+18,608.533,4501.31,49121,305,248,43277,36574,20934,19659,9474
43054,21,43,40604,2450,42607,447,1.07003e+14,40.6747,962.906,43054,43,41,42486,42014,35421,35103,28139
22264,82,358,0,22264,21221,1043,2.51477e+16,255.739,1905.29,22264,114,122,21256,20810,16666,14502,11221
38047,774,1710,13481,24566,0,38047,3.73939e+13,1116.79,5753.01,38047,551,355,34067,31405,21386,19353,19693
5142,1622,1710,5142,0,4052,1090,3.19263e+18,220.378,2496.3,5142,204,196,3432,3432,3431,3431,3376
29933,1535,1655,0,29933,10597,19336,9.51441e+15,1047.39,5074.91,29933,483,326,28278,28278,27149,26718,27981
21849,2015,2115,0,21849,0,21849,2.42783e+18,1203.73,5180.21,21849,449,328,19734,19734,19585,19538,19734
21049,922,1687,9981,11068,0,21049,5.18605e+18,1229.61,4846.02,21049,370,344,17958,15803,10466,8560,10891
30276,23,42,28571,1705,29958,318,1.06692e+14,38.8929,783.833,30276,40,38,29984,29745,25546,25412,22019
9584,816,1818,4784,4800,4784,4800,4.77156e+18,553.203,3279.13,9584,325,229,7766,7211,4753,4360,4162
27379,926,2243,12909,14470,0,27379,5.08096e+18,1499.04,6190.81,27379,523,370,22785,20356,10236,9059,12857
14758,23,43,14096,662,14340,418,9.82247e+13,36.3713,548.519,14758,37,33,14618,14509,12838,12825,10871
6464,320,2044,6464,0,5197,1267,3.03909e+18,333.645,3068.68,6464,241,215,4212,3575,1713,1812,1219
37484,1281,1553,13334,24150,0,37484,3.82503e+13,1088.17,5655.98,37484,453,373,35828,31835,29988,30265,33867
7662,1127,1372,0,7662,2716,4946,9.53337e+15,249.365,2459.03,7662,260,162,6290,6244,5955,6015,4992
44029,2510,2534,23166,20863,0,44029,5.01615e+18,1497.67,7654.94,44029,636,439,41495,41495,41484,41346,41461
16520,2296,2349,16520,0,13869,2651,3.02212e+18,1169.32,4955.06,16520,388,322,14171,14132,14135,14137,14135
25401,198,353,0,25401,24206,1195,2.54462e+16,275.647,2038.43,25401,118,126,24706,24258,21976,20265,17692
19821,1616,2368,19821,0,16570,3251,3.31929e+18,1300.6,5369.4,19821,454,337,17072,14948,16105,15368,13667
46792,312,844,45437,1355,46792,0,4.59923e+18,609.797,4331.64,46792,313,246,44219,42070,27634,25437,18491
40380,284,359,0,40380,38382,1998,2.58966e+16,308.851,2626.79,40380,144,152,39758,38886,36700,34501,34104
1215,255,393,502,713,0,1215,4.41995e+18,73.7095,622.238,1215,84,84,822,819,598,633,649
35223,59,352,0,35223,33479,1744,2.60098e+16,288.946,2412.28,35223,135,146,33312,32310,24537,21005,14188
20207,687,2061,10774,9433,10774,9433,4.93179e+18,1103.32,4906.1,20207,434,309,16718,14908,8485,9033,7593
41628,952,1812,19707,21921,19707,21921,4.97494e+18,1425.41,6936.14,41628,519,435,36323,31662,19992,18545,24502
39218,242,1761,18658,20560,18658,20560,5.02516e+18,1414.07,6693.23,39218,511,427,28976,24473,8018,7845,6882
8748,225,1994,7125,1623,4345,4403,7.91441e+17,638.144,3457.3,8748,292,246,5812,4749,2803,3171,1245
30179,1638,2340,30179,0,24442,5737,2.95433e+18,1594.34,6789.58,30179,484,404,26910,22628,24860,23959,22378
33786,1796,1875,16472,17314,0,33786,5.09963e+18,1390.72,6327.87,33786,482,409,31911,31911,31472,30873,31822
22894,1108,2212,22894,0,18655,4239,3.06095e+18,1507.38,5828.9,22894,439,374,18946,16141,14444,13457,12209
17290,1282,2401,14637,2653,9417,7873,6.8339e+17,1094.95,5000.17,17290,406,302,14245,12864,11622,11604,10190
7787,294,1824,0,7787,0,7787,2.48656e+18,403.518,3041.19,7787,273,221,5729,5046,2052,1220,1035
3570,510,941,0,3570,0,3570,2.52486e+18,163.991,1470.33,3570,216,154,2629,2520,2217,2259,1095
9395,21,350,0,9395,8901,494,2.62537e+16,147.895,1244.57,9395,85,87,8195,7495,5823,5058,3197
22466,537,2214,12010,10456,0,22466,5.01429e+18,1132.02,5288.01,22466,457,325,18258,16440,7774,7239,6782
22885,1225,1495,8175,14710,0,22885,3.81349e+13,942.54,4373.42,22885,363,299,21222,19241,17699,17588,19505
41928,620,2486,21869,20059,0,41928,5.01066e+18,1464.15,7451.37,41928,608,421,34704,30660,13170,14166,11693
26753,6,42,25437,1316,26106,647,1.00594e+14,38.137,729.334,26753,38,36,23908,22024,18271,18481,11971
29244,1034,1957,14647,14597,0,29244,5.07829e+18,1328.3,5932.76,29244,454,387,25447,22594,14601,12666,17243
7299,1371,1615,3883,3416,0,7299,5.07253e+18,260.48,2716.32,7299,289,214,5684,5681,5280,5255,5274
9084,91,350,0,9084,8603,481,2.67956e+16,168.351,1246.44,9084,91,82,8580,8423,6766,5887,4406
11947,957,2318,11947,0,10041,1906,3.29615e+18,889.751,4209.21,11947,374,269,9234,8346,7126,6679,4646
45324,1301,2912,45324,0,37886,7438,3.31097e+18,1748.78,8590.44,45324,666,464,39129,33760,34245,32268,22920
6684,910,1872,6684,0,5581,1103,3.20573e+18,245.671,2889.28,6684,229,187,4812,4640,4188,3889,2358
34998,1349,2969,34998,0,29324,5674,3.3296e+18,1677.75,7658.75,34998,604,401,30048,25949,26707,24543,17617
23495,38,43,22406,1089,22862,633,9.87532e+13,39.1519,697.709,23495,40,37,23438,23411,23075,23072,21738
26330,511,665,25921,409,26330,0,4.63524e+18,496.428,3132.46,26330,243,211,25523,24803,23046,23095,22607
41429,268,369,0,41429,39517,1912,2.49069e+16,304.688,2610.88,41429,141,149,40722,39947,37377,35093,35472
47600,1993,2326,0,47600,0,47600,2.45546e+18,1488.95,7836.56,47600,607,449,45274,45273,42639,41409,44714
11720,1065,1754,5779,5941,5779,5941,4.9287e+18,809.823,3626.38,11720,318,275,9773,8957,6776,6215,7304
20331,1641,2055,0,20331,0,20331,2.44893e+18,1104.23,4915.76,20331,434,309,18265,16378,14696,13257,15067
9110,17,44,8580,530,9039,71,1.06195e+14,28.9647,427.606,9110,35,31,8905,8743,7335,7281,6018
35084,273,1805,0,35084,0,35084,2.52356e+18,1392.22,6394.34,35084,472,410,26402,22640,7772,4861,5036
25945,405,2561,25052,893,24866,1079,6.4602e+17,86.4589,4184.1,25945,744,190,23384,22817,21554,20729,20075
3771,31,37,3538,233,3763,8,1.11068e+14,25.0385,266.52,3771,28,25,3732,3724,3579,3589,3455
21453,841,2531,17821,3632,11116,10337,7.40938e+17,1388.35,5752.88,21453,510,340,16992,14745,11554,11206,9069
45394,278,2266,23074,22320,0,45394,5.04329e+18,1472.43,7589.01,45394,584,443,34798,30219,11792,10436,8746
25293,11,42,23978,1315,24894,399,1.03529e+14,39.0812,720.353,25293,38,37,24164,23387,19015,18441,13150
48929,2366,2563,25676,23253,25676,23253,4.8866e+18,1500.6,8034.95,48929,697,444,46366,46366,45091,44956,45569
11243,1130,1982,5642,5601,5642,5601,4.80227e+18,740.587,3700.57,11243,336,250,9261,8513,6189,6033,6526
39437,1029,2364,32232,7205,19734,19703,7.80013e+17,1688.48,7701.88,39437,558,436,32919,28068,23566,22480,19524
30480,88,1771,0,30480,0,30480,2.54088e+18,1332.76,5903.42,30480,452,397,18335,12111,5315,3159,2295
37244,9,354,0,37244,35455,1789,2.55851e+16,300.526,2473.87,37244,136,146,29487,25651,21319,19064,11810
12813,763,1311,4530,8283,0,12813,3.8711e+13,732.597,3192.15,12813,292,260,11001,10303,7355,6824,7737
5431,226,554,5279,152,5431,0,4.3981e+18,220.697,1370.5,5431,132,112,4817,4496,3221,3183,2351
9562,27,43,9071,491,9365,197,1.03647e+14,28.7125,438.646,9562,33,32,9489,9457,8649,8673,7700
847,13,101,0,847,794,53,2.62879e+16,25.8855,232.608,847,32,31,660,578,455,463,340
23592,142,836,22959,633,23592,0,4.60946e+18,487.318,3092.15,23592,279,199,20446,16882,9890,9375,5363
1063,7,27,1002,61,1063,0,9.42666e+13,17.6566,120.715,1063,18,19,961,903,764,772,568
46676,209,1793,22240,24436,22240,24436,5.03756e+18,1459.15,7337.84,46676,542,454,33766,28148,9082,9188,6825
44532,2120,2183,22430,22102,22430,22102,4.97806e+18,1443.81,7448.36,44532,572,436,42349,42349,42191,42062,41800
8338,922,1816,0,8338,0,8338,2.42968e+18,393.808,3065.63,8338,308,214,6522,6275,4486,4369,3512
34249,117,2335,34249,0,27843,6406,3.07752e+18,1674.46,7235.47,34249,512,434,20097,12706,7599,6082,2302
31238,1425,1749,0,31238,11051,20187,9.81297e+15,1044.14,5390.91,31238,466,350,29489,28728,24180,21557,28276
49363,1267,2895,41221,8142,25971,23392,7.23419e+17,1781.88,8911.14,49363,667,460,42827,36653,33423,32905,28374
32698,589,2247,0,32698,0,32698,2.43791e+18,1393.99,6434.88,32698,527,383,26895,23784,10645,10829,9804
33938,1358,1822,16278,17660,16278,17660,5.00624e+18,1341.46,6280.9,33938,498,404,31169,26825,22778,21470,26848
23380,553,1637,8277,15103,0,23380,3.71966e+13,973.791,4499.37,23380,442,301,20132,18637,11812,10518,9222
29335,250,879,28491,844,29335,0,4.53963e+18,495.276,3449.1,29335,268,209,27267,25496,15143,14907,10778
15277,40,43,14398,879,15128,149,1.07527e+14,34.2216,554.255,15277,38,35,15231,15221,15190,15189,15055
33122,8,43,31555,1567,32278,844,9.92839e+13,39.4698,824.307,33122,41,39,30817,29349,24076,23812,15194
43003,26,43,40731,2272,42330,673,1.03838e+14,41.0819,952.679,43003,43,42,42683,42479,37360,37483,32046
41187,243,1993,20539,20648,0,41187,5.06824e+18,1489.88,7079.02,41187,536,427,30691,26363,10042,7951,6588
34936,697,2281,18361,16575,0,34936,4.96705e+18,1381.42,6626.08,34936,574,389,29261,25916,12956,13179,13191
2020,10,160,0,2020,1888,132,2.70038e+16,41.8579,424.849,2020,43,44,1537,1276,1034,871,621
21148,1311,1829,0,21148,7449,13699,9.75256e+15,984.224,4665.1,21148,454,306,19273,17514,14096,11785,16233
3838,432,1304,3218,620,2004,1834,7.08077e+17,212.034,1933.27,3838,172,170,2534,2364,1349,1489,957
28046,38,43,26776,1270,27208,838,9.74617e+13,37.5623,751.133,28046,40,37,27989,27956,27619,27615,25994
675,249,266,296,379,0,675,4.8719e+18,57.4667,395.244,675,67,75,409,409,407,407,404
25821,565,1415,0,25821,9144,16677,9.8342e+15,1013.73,4616.47,25821,390,326,22415,20495,12364,9353,11728
49704,587,1643,17570,32134,0,49704,3.77923e+13,1155.49,6593.17,49704,515,396,43766,39752,23596,18364,24126
16900,662,1522,6011,10889,0,16900,3.7283e+13,782.293,3715.95,16900,350,257,14682,13728,9952,9482,10028
22848,191,2424,19005,3843,11890,10958,7.3502e+17,1476.59,5880.09,22848,456,348,15481,11992,7283,8128,1834
12693,1222,1992,12693,0,10109,2584,3.01521e+18,1113.29,4221,12693,307,275,10034,8859,8490,8232,7199
11519,984,1880,6302,5217,0,11519,5.15645e+18,643.082,3585.35,11519,284,269,9627,8832,6694,6251,6290
32239,170,372,0,32239,30786,1453,2.485e+16,271.362,2316.02,32239,129,140,31340,30715,27338,23641,20508
25147,4021,6276,0,25147,0,25147,1.72346e+18,640.445,9523,25147,1222,308,18871,18810,17581,16079,13803
39872,280,1978,20328,19544,0,39872,5.09784e+18,1459.37,6910.96,39872,516,426,30598,26814,10817,8883,7495
27180,14,43,25694,1486,27048,132,1.04419e+14,39.7788,763.315,27180,42,39,26259,25596,21320,20455,14900
25693,34,43,24441,1252,25085,608,1.00274e+14,36.6842,722.322,25693,40,38,25611,25548,24251,24274,22983
11347,1972,2746,5060,6287,5060,6287,4.47752e+18,441.266,4399.57,11347,799,250,8601,8498,6250,6161,6146
19221,838,2020,9874,9347,0,19221,5.10276e+18,1184.69,4878.22,19221,372,325,15954,14402,8458,7757,8551
18982,1368,1591,0,18982,6808,12174,9.65189e+15,806.407,3957.09,18982,373,276,17391,16179,15737,13268,16579
40841,2108,2496,21919,18922,21919,18922,4.92104e+18,1404.94,7285.2,40841,603,410,38345,38344,34676,34237,36193
46309,102,358,0,46309,43949,2360,2.63092e+16,310.867,2810.67,46309,157,163,44365,43423,34555,29568,23161
36443,323,1986,17231,19212,0,36443,5.12576e+18,1363.89,6623.01,36443,511,403,28037,24154,7645,6433,5689
15508,1249,1790,0,15508,0,15508,2.55288e+18,1015.13,4251.82,15508,334,304,13348,11961,9099,8227,10408
9418,1075,1937,0,9418,0,9418,2.37046e+18,554.877,3366.51,9418,321,225,7481,7062,5408,5362,5011
41978,689,893,41045,933,41978,0,4.52615e+18,562.364,4207.51,41978,270,237,41085,40857,37379,37427,36625
40223,811,2453,21083,19140,21083,19140,4.91303e+18,1475.23,7290.66,40223,583,417,34200,30473,15446,18231,15314
17185,89,1312,6052,11133,0,17185,3.86502e+13,853.289,3660.04,17185,320,282,12639,10250,4531,1935,1800
12725,109,1528,4473,8252,0,12725,3.67919e+13,714.162,3315.19,12725,325,229,9646,8273,3756,1469,1970
27939,857,1960,13933,14006,13933,14006,4.96302e+18,1324.03,5814.15,27939,427,371,23626,21069,12123,12182,13929
48361,131,354,0,48361,45786,2575,2.66188e+16,314.665,2880.47,48361,154,168,46593,45623,37616,32491,25071
38011,23,775,37251,760,38011,0,4.60111e+18,532.125,3850.42,38011,267,233,18317,6402,6693,5780,1397
10038,1616,1854,5406,4632,0,10038,5.11505e+18,550.756,3346.03,10038,271,258,8184,7875,7502,7434,7388
10712,64,2278,8765,1947,5273,5439,7.82857e+17,815.972,3992.46,10712,325,269,5657,3639,2367,2517,269
37498,182,600,37114,384,37498,0,4.73877e+18,514.638,3669.58,37498,247,244,33862,29831,15925,16161,12283
20348,2109,2132,10529,9819,0,20348,4.9733e+18,1197.79,5029.2,20348,468,316,18216,18216,18168,18005,18216
11969,1054,1458,0,11969,4297,7672,9.83019e+15,575.007,3077.8,11969,282,241,10511,9922,8548,7573,9194
19306,646,3042,11373,7933,11199,8107,2.68202e+18,297.575,5427,19306,260,399,16193,15608,10845,9807,5991
14983,277,352,0,14983,14325,658,2.48978e+16,202.086,1531.35,14983,95,102,14588,14411,13801,13411,13357
48324,22,634,47875,449,48324,0,4.74811e+18,507.768,4167.43,48324,270,260,21119,8262,6733,6035,1940
28656,119,828,27753,903,28656,0,4.51536e+18,525.663,3376.73,28656,256,208,24128,18949,11221,9812,5785
24033,296,1330,0,24033,8452,15581,9.85035e+15,995.955,4379.55,24033,387,321,19896,18162,8321,6682,5581
30412,79,343,0,30412,28683,1729,2.74493e+16,286.641,2268.73,30412,138,144,28796,28033,21164,18442,13461
33546,529,1553,11894,21652,0,33546,3.78348e+13,1089.8,5379.25,33546,454,351,28992,26497,15705,13357,13903
32876,41,43,31334,1542,32032,844,9.93076e+13,39.8402,823.914,32876,41,40,32825,32803,32746,32745,32086
15029,320,349,0,15029,14316,713,2.53106e+16,214.401,1552.81,15029,102,109,14658,14455,14366,14116,13897
22043,324,2317,0,22043,0,22043,2.42318e+18,1155.27,5335.54,22043,450,318,17108,15212,6876,4737,3463
34573,119,357,0,34573,32914,1659,2.55567e+16,298.747,2385.62,34573,133,140,33337,32713,27219,23399,18488
36354,387,1461,12824,23530,0,36354,3.81492e+13,1096.9,5506.77,36354,475,363,30886,28177,14556,10632,12632
11463,194,347,0,11463,10930,533,2.51445e+16,157.171,1327.23,11463,90,93,11077,10937,10085,9639,9100
5811,730,1818,5811,0,4865,946,3.41506e+18,266.932,2721.19,5811,260,185,3993,3732,3220,2949,2213
43525,475,856,42464,1061,43525,0,4.59191e+18,597.914,4208.81,43525,314,241,42003,40625,35115,35032,27923
34184,2594,2653,28751,5433,18365,15819,7.03913e+17,1616.71,7221.82,34184,564,394,31531,31530,31392,31342,31527
47094,286,371,0,47094,44686,2408,2.62119e+16,306.667,2849.91,47094,152,163,46400,45338,42453,39426,40310
31123,39,618,30804,319,31123,0,4.73965e+18,487.682,3360.6,31123,231,226,17547,8647,6510,5869,2068
34864,151,1613,12410,22454,0,34864,3.76624e+13,1097.51,5426.01,34864,482,351,27925,25002,11585,9613,5067
6669,225,1184,0,6669,2366,4303,9.867e+15,179.39,2125.85,6669,259,170,5474,5172,3069,1660,1660
15651,1097,1600,0,15651,5539,10112,9.4794e+15,749.896,3655.9,15651,373,262,13819,12993,11156,9659,12113
2369,736,760,0,2369,0,2369,2.30537e+18,66.7927,1163.82,2369,126,102,1609,1609,1606,1582,1578
19768,100,687,19471,297,19768,0,4.65763e+18,470.964,2751.84,19768,206,193,15558,11117,6239,5874,3467
41395,213,353,0,41395,39067,2328,2.73609e+16,305.521,2675.44,41395,150,167,40334,39340,35260,31635,29224
24074,132,1323,0,24074,8536,15538,9.88738e+15,1001.71,4382.73,24074,385,323,18533,16166,6674,5297,3914
25519,626,852,24885,634,25519,0,4.5706e+18,513.6,3243.83,25519,286,202,24667,24089,23418,23419,21653
44313,606,1883,0,44313,15766,28547,9.51968e+15,1143.73,6329.61,44313,605,378,39013,35929,22560,14731,23356
13260,682,1992,7188,6072,0,13260,5.08901e+18,784.366,3947.83,13260,314,277,10684,9746,5954,5281,4314
30650,773,1799,10905,19745,0,30650,3.70679e+13,1049.59,5240.28,30650,498,328,27206,25144,17212,16165,18555
25919,233,347,0,25919,24535,1384,2.6539e+16,283.846,2093.53,25919,122,129,25254,24765,22592,20904,19322
8902,312,347,0,8902,8409,493,2.65664e+16,146.201,1210.96,8902,83,87,8555,8474,8375,8317,8319
33041,4721,5434,10448,22593,112,32929,1.63121e+17,554.473,9484.07,33041,951,428,27607,27607,27407,26814,26055
5101,1488,1757,5101,0,4039,1062,3.05993e+18,267.654,2588.59,5101,202,184,3344,3290,3317,3321,3159
32061,1020,2070,0,32061,0,32061,2.49173e+18,1342.3,6273.88,32061,474,390,28046,24781,15767,13616,17073
27109,1505,2288,27109,0,22022,5087,3.03397e+18,1556.4,6389.27,27109,486,397,23605,20057,19835,18845,17995
22766,425,2102,0,22766,0,22766,2.45076e+18,1227.91,5283.57,22766,448,332,18149,16158,7421,5691,5507
708,52,287,326,382,326,382,5.19105e+18,69.6568,415.213,708,68,64,330,234,105,145,124
23286,314,1336,8247,15039,0,23286,3.8962e+13,986.58,4328.36,23286,363,322,19328,17616,8916,6387,6746
34207,107,1777,16316,17891,16316,17891,5.02993e+18,1421.72,6305.55,34207,480,409,21560,14477,6080,6234,2731
14280,263,1524,5078,9202,0,14280,3.69462e+13,740.853,3442.93,14280,349,258,11753,10899,6046,5161,3140
27155,150,1932,13337,13818,0,27155,5.06949e+18,1321.75,5724.65,27155,435,374,18965,13833,5882,4467,2246
2401,308,623,919,1482,0,2401,4.13302e+13,67.8026,1030.08,2401,133,103,1778,1777,1561,1682,968
23565,2073,2138,0,23565,0,23565,2.44167e+18,1229.2,5395.41,23565,469,337,21427,21427,21333,21211,21425
6190,624,625,6140,50,6190,0,4.94797e+18,234.224,1535.34,6190,149,122,5565,5565,5565,5565,5565
48628,1468,1622,0,48628,17211,31417,9.72139e+15,1150.64,6500.54,48628,518,395,47006,47004,44754,43667,46449
11564,1068,1808,6114,5450,0,11564,5.16096e+18,744.569,3609.36,11564,292,272,9691,8888,6829,6354,7237
44399,1465,2985,44399,0,37113,7286,3.33628e+18,1763.4,8563.51,44399,690,458,39202,33371,36266,32927,27194
24130,70,844,23493,637,24130,0,4.60111e+18,471.483,3124.44,24130,249,193,17690,12297,7609,7054,2479
18041,27,43,17185,856,17618,423,1.00196e+14,38.1016,612.779,18041,38,36,17914,17844,16156,16166,14282
33105,1125,2261,17311,15794,0,33105,5.04168e+18,1390.79,6476.04,33105,531,391,29166,25986,16832,15243,18635
17306,363,376,0,17306,16449,857,2.64315e+16,244.579,1740.46,17306,107,108,16930,16758,16857,16877,16573
38083,1578,2309,19756,18327,19756,18327,4.94213e+18,1415.39,7018.43,38083,541,409,35435,30784,25200,23717,31056
5052,340,590,4911,141,5052,0,4.35349e+18,180.649,1346.62,5052,129,100,4462,4333,3903,3881,3685
14255,33,1498,0,14255,5036,9219,9.68405e+15,738.293,3557.22,14255,323,262,8521,6398,3324,2162,783
5781,189,1531,2894,2887,0,5781,5.09092e+18,198.155,2460.21,5781,214,162,4100,3286,1735,1454,852
47246,19,43,45065,2181,45945,1301,9.88734e+13,40.0985,986.709,47246,43,41,46577,46062,39403,39063,31155
30374,811,1536,0,30374,10724,19650,9.69247e+15,1052.11,5097.79,30374,426,340,27358,24896,17248,12929,18073
46034,768,968,44777,1257,46034,0,4.58333e+18,608.458,4400.71,46034,294,244,45066,44852,42846,42892,42051
45599,1277,2778,38030,7569,23978,21621,7.25616e+17,1746.64,8469.03,45599,643,445,39405,34101,31127,30532,26132
11060,12,43,10511,549,10847,213,1.02003e+14,37.739,486.786,11060,36,32,10619,10314,8470,8314,6027
20644,153,1726,0,20644,0,20644,2.52853e+18,1227.66,4851.09,20644,385,338,14238,10368,3915,2335,2660
49807,1254,1908,0,49807,17743,32064,9.57146e+15,1163.51,6731.63,49807,588,389,47316,42410,34187,24979,41354
15403,580,2367,12881,2522,8159,7244,7.20327e+17,1107.7,4761.89,15403,389,285,11721,10317,6826,7053,4096
22568,63,2491,22568,0,18843,3725,3.32817e+18,1421.82,5871.27,22568,534,348,12214,7924,5343,4639,699
36931,683,2101,36931,0,29543,7388,3.03509e+18,1714.37,7325.25,36931,507,450,28767,23658,14656,12925,12819
28081,1071,1759,0,28081,0,28081,2.56184e+18,1337.53,5690.24,28081,429,384,24645,21512,15359,12327,17162
36818,418,1768,0,36818,0,36818,2.53865e+18,1436.17,6520.99,36818,503,412,29018,24974,9228,7469,9724
33035,239,353,0,33035,31493,1542,2.55098e+16,290.149,2319.09,33035,131,136,32363,31750,29393,27434,26353
39241,164,358,0,39241,37418,1823,2.51902e+16,293.45,2518.07,39241,137,150,38142,37372,33058,28296,24849
13817,1553,2166,7409,6408,0,13817,4.91663e+18,834.37,4199.77,13817,358,269,11651,10727,9333,8989,9240
21494,2158,2443,18002,3492,11477,10017,7.09464e+17,1324.09,5605.6,21494,467,337,19051,18692,17878,17722,17784
38101,633,911,37047,1054,38101,0,4.54283e+18,587.539,3971.9,38101,261,227,37104,36265,33724,33654,30281
47226,2204,2503,0,47226,0,47226,2.43339e+18,1491.86,7873.96,47226,643,437,44723,44722,41048,40036,43446
37275,1975,2300,0,37275,0,37275,2.44473e+18,1394.79,6848.82,37275,578,399,34975,34864,31584,29275,33080
32501,878,2068,32030,471,31340,1161,4.28527e+18,468.609,5244.42,32501,309,273,30433,30398,29957,29918,28292
26508,131,1715,0,26508,0,26508,2.53992e+18,1314.51,5464.74,26508,415,374,17693,12279,4948,2863,2527
28963,1209,1565,10271,18692,0,28963,3.77818e+13,1024.45,4992.2,28963,437,331,27180,24423,20412,19960,22795
32623,85,1714,0,32623,11589,21034,9.53637e+15,1054.66,5324.79,32623,491,340,24680,21008,10683,5498,2049
19078,890,1334,0,19078,6744,12334,9.90219e+15,916.132,3910.64,19078,339,293,17012,15584,11674,9703,13650
35409,1318,3999,35409,0,30699,4710,2.48678e+18,1116.61,8853.17,35409,534,506,31371,27473,22480,19542,18437
33235,1720,2134,16694,16541,16694,16541,4.98949e+18,1370.7,6495.91,33235,465,415,31083,28162,24643,23612,28653
35425,2148,2603,29531,5894,18553,16872,7.2855e+17,1658.85,7402.51,35425,544,397,32822,32610,29858,29004,31485
16637,13,716,16184,453,16637,0,4.57057e+18,421.199,2523.24,16637,217,176,5953,1687,1609,1879,257
44070,598,1885,15683,28387,0,44070,3.74166e+13,1138.87,6314.19,44070,587,377,38811,35688,22619,19724,17599
40252,183,2420,0,40252,0,40252,2.43973e+18,1401.83,7194.88,40252,579,409,29836,24491,11170,4821,4310
28695,30,43,27427,1268,27793,902,9.69643e+13,39.355,765.463,28695,40,37,28558,28480,26312,26307,24151
31260,1468,1688,14764,16496,0,31260,5.15368e+18,1351.36,5900.83,31260,465,397,29027,24851,22531,21511,26238
36838,1366,1872,18222,18616,18222,18616,5.01332e+18,1397.8,6582.71,36838,513,416,33860,29376,23315,21560,28650
8301,491,1818,4319,3982,4319,3982,4.99257e+18,424.315,3097.74,8301,243,242,6410,5786,3019,3182,2403
43204,1068,2437,23004,20200,23004,20200,4.93213e+18,1443.42,7449.4,43204,606,419,38283,33928,20679,22132,23519
49257,202,2029,23929,25328,0,49257,5.09995e+18,1493.7,7789.02,49257,547,465,35682,29183,10292,7686,7059
8052,1030,2148,6682,1370,4191,3861,7.42564e+17,403.116,3363.71,8052,272,199,5904,5529,4523,4583,3837
10336,36,2050,0,10336,0,10336,2.48281e+18,717.132,3697.72,10336,342,236,4433,2352,1144,817,269
22344,1555,2081,22344,0,17894,4450,3.02767e+18,1509.73,5699.55,22344,411,382,19456,16357,18449,18033,15863
3962,1148,1402,3111,851,1826,2136,8.97822e+17,177.203,1989.61,3962,188,134,2560,2549,2364,2260,2236
9935,849,2014,7895,2040,4592,5343,8.59901e+17,901.094,3739.22,9935,307,279,7378,6459,4692,4647,4188
22996,5,42,21895,1101,22405,591,9.94395e+13,35.9601,674.016,22996,38,36,19764,17769,15454,15597,9538
5245,1200,1211,0,5245,0,5245,2.62958e+18,207.097,2019.9,5245,213,150,4034,4034,4034,4034,4032
39621,1998,2647,32484,7137,18916,20705,7.73134e+17,1931.72,8295.95,39621,622,440,36066,29739,30704,29369,31715
44742,1497,2488,0,44742,0,44742,2.45302e+18,1475.13,7661.51,44742,612,433,41419,36029,26695,22689,30584
38820,339,353,0,38820,37017,1803,2.53093e+16,292.495,2493.24,38820,137,149,38444,37749,38198,37967,37801
36374,54,1821,0,36374,12907,23467,9.53151e+15,1114.42,5775.93,36374,542,357,25205,20325,10422,5588,2298
27160,1793,2121,14494,12666,0,27160,5.01572e+18,1297.78,5747.46,27160,474,341,25039,22342,21240,20404,22597
11559,1097,1522,0,11559,4070,7489,9.35871e+15,634.813,3147.44,11559,320,208,10037,9442,8211,6606,8134
47832,361,2540,0,47832,0,47832,2.44133e+18,1493.65,7930.46,47832,651,435,38089,34060,14380,10205,10000
16591,5,43,15793,798,16167,424,9.94861e+13,37.9316,585.618,16591,37,34,14182,12766,10994,11098,7015
47006,310,1608,0,47006,16691,30315,9.76021e+15,1139.47,6375.5,47006,505,396,39500,36043,17246,11765,12282
19435,3,43,18293,1142,19239,196,1.06855e+14,38.5582,641.678,19435,39,37,13719,11450,10255,10546,7096
32732,95,351,0,32732,31206,1526,2.52264e+16,289.001,2288.88,32732,127,135,31429,30874,25150,21591,16193
32476,963,2614,27200,5276,17159,15317,7.1389e+17,1628.62,7090.78,32476,533,393,26792,23263,18961,18372,14844
23227,42,350,0,23227,22147,1080,2.52406e+16,256.872,1931.07,23227,116,125,21725,20785,16108,14175,10154
40325,898,1474,0,40325,14251,26074,9.79898e+15,1108.84,5817.92,40325,504,378,36958,33377,24229,18706,26937
23506,829,2072,23506,0,18899,4607,2.95436e+18,1505.63,5809.72,23506,408,376,18539,15409,11086,10396,10787
13517,262,352,0,13517,12797,720,2.66598e+16,222.362,1521.23,13517,101,100,13080,12898,12112,11605,11595
45982,956,2500,24200,21782,24200,21782,4.91449e+18,1491.76,7779.44,45982,645,423,39860,35448,19094,22229,22327
9701,191,348,0,9701,9217,484,2.57079e+16,141.412,1237.18,9701,78,86,9349,9217,8493,8078,7655
12615,504,1725,5966,6649,0,12615,5.08097e+18,912.459,3770.41,12615,305,279,9875,8774,4036,3186,3611
37630,1802,2623,31364,6266,19789,17841,7.25865e+17,1674.79,7590.77,37630,584,412,34392,29120,28880,28407,30949
29636,221,347,0,29636,28085,1551,2.63615e+16,283.922,2222.56,29636,128,135,28908,28293,25808,23535,23351
10927,2022,2240,8915,2012,5479,5448,8.01339e+17,854.253,4019.25,10927,305,257,8687,7997,8242,8206,8452
25285,681,836,24439,846,25285,0,4.48586e+18,500.942,3173.92,25285,252,192,24448,24193,23455,23484,22023
16403,1116,1811,8125,8278,0,16403,5.12108e+18,1075.76,4380.58,16403,334,308,14048,12588,8719,7729,9907
23387,645,2533,23387,0,19582,3805,3.34277e+18,1434.39,5982.73,23387,547,346,18241,15992,11637,10875,6928
37868,169,2097,37868,0,30261,7607,3.00834e+18,1688.94,7381.26,37868,503,448,23947,15500,7781,6520,3384
42535,909,2249,0,42535,0,42535,2.47868e+18,1438.82,7370.05,42535,584,433,36725,32580,18476,16750,20783
3039,423,924,1510,1529,1510,1529,5.14467e+18,143.365,1415.37,3039,146,146,2115,2073,1026,974,1162
36638,394,2082,36638,0,29377,7261,3.0117e+18,1686.32,7255.69,36638,498,441,26457,22500,11241,9166,8306
3614,28,42,3407,207,3595,19,1.03665e+14,27.4322,280.007,3614,30,26,3564,3548,3281,3247,3165
40291,303,865,39235,1056,40291,0,4.57632e+18,598.571,4059.4,40291,311,237,37913,35983,24253,23315,15210
9039,408,677,8816,223,9039,0,4.52395e+18,272.193,1829.46,9039,211,134,8362,8198,7497,7438,6257
14757,21,355,0,14757,14109,648,2.46541e+16,199.178,1508.86,14757,96,98,13182,12225,9739,8525,5093
14593,17,651,14441,152,14593,0,4.75614e+18,392.805,2340.03,14593,179,167,5583,1992,1631,1519,494
5672,16,262,0,5672,5420,252,2.36678e+16,66.4885,831.96,5672,63,63,4941,4527,3606,3295,2096
33897,233,596,33567,330,33897,0,4.73645e+18,493.441,3469.22,33897,233,231,31533,29350,16861,17189,14366
847,246,329,0,847,0,847,2.02577e+18,54.5348,465.495,847,60,60,518,512,499,484,474
26214,1960,2065,20990,5224,12433,13781,8.36951e+17,1559.15,6119.83,26214,454,380,24122,21856,23515,23166,23906
23497,973,1338,0,23497,8326,15171,9.97363e+15,987.991,4348.91,23497,360,324,21515,19408,15479,12738,17773
18248,1406,2375,15193,3055,9621,8627,7.35931e+17,1249.58,5173.66,18248,413,326,15339,13614,12659,12518,11598
25918,14,43,24496,1422,25537,381,1.04921e+14,39.6211,737.834,25918,42,38,25131,24551,20021,19498,14361
6060,1274,1512,3311,2749,0,6060,5.19877e+18,242.087,2447.34,6060,256,169,4548,4528,4426,4442,3693
14605,84,1540,5193,9412,0,14605,3.70976e+13,722.388,3503.38,14605,321,258,10903,9184,4694,1594,1158
36383,729,888,35641,742,36383,0,4.623e+18,527.922,3868.5,36383,278,231,35495,35469,34558,34630,34411
20997,1367,2511,17624,3373,11212,9785,7.13332e+17,1296.74,5630.69,20997,456,335,17775,15652,14452,14252,11199
9864,31,43,9374,490,9641,223,9.93327e+13,29.873,445.785,9864,35,31,9806,9786,9378,9390,9042
19523,2303,2515,16231,3292,10073,9450,7.41241e+17,1313.25,5495.12,19523,457,327,17008,17004,16589,16551,16422
47772,926,1590,16883,30889,0,47772,3.79772e+13,1134.4,6391.41,47772,525,397,44030,39775,28624,25173,32984
46237,1003,1946,0,46237,16375,29862,9.50999e+15,1150.25,6544.36,46237,608,378,42537,38752,27824,21483,33178
28474,1679,2084,14961,13513,0,28474,5.07741e+18,1292.61,5861.02,28474,464,364,26388,23117,21504,20656,24400
49477,77,360,0,49477,47152,2325,2.52261e+16,310.196,2843.64,49477,149,160,47296,46292,36634,31692,21406
23548,1729,1732,11271,12277,11271,12277,5.00806e+18,1254.95,5149.16,23548,393,352,21816,21816,21805,21795,21816
48235,1918,2500,0,48235,0,48235,2.44104e+18,1472.53,7909.93,48235,642,436,45735,45444,36607,35046,42434
20926,1759,2461,20926,0,17713,3213,3.33701e+18,1388.11,5604.13,20926,493,332,18135,15917,17502,16782,14869
46704,137,737,45945,759,46704,0,4.63217e+18,541.624,4212.64,46704,260,250,40311,32375,16733,16907,10363
17543,355,1707,8353,9190,0,17543,5.07698e+18,1129.12,4427.44,17543,355,315,13459,11919,4066,3374,3473
21858,118,355,0,21858,20780,1078,2.58159e+16,261.628,1898.46,21858,113,122,21008,20622,17099,14875,11659
28626,513,2105,28626,0,22904,5722,3.02243e+18,1588.03,6435.14,28626,433,395,21439,17946,9112,8081,7343
4659,508,528,4592,67,4659,0,4.73523e+18,192.226,1254.32,4659,125,103,4131,4131,4128,4130,4086
47193,2125,2562,0,47193,0,47193,2.43334e+18,1498.18,7907.76,47193,667,442,44631,44631,39674,38028,43139
38854,2046,2425,20562,18292,20562,18292,4.91065e+18,1441.8,7090.81,38854,588,405,36429,36429,32816,32462,35122
38348,1539,1899,18709,19639,0,38348,5.05872e+18,1425.56,6752.94,38348,517,418,35998,30783,26713,24958,32808
1895,188,577,0,1895,672,1223,9.88742e+15,54.7763,904.276,1895,122,94,1318,1275,747,751,532
43923,117,370,0,43923,41684,2239,2.62767e+16,306.072,2750.07,43923,150,161,42264,41352,33587,28775,24683
48384,31,43,46106,2278,47109,1275,9.89214e+13,40.252,996.216,48384,43,41,48191,48060,44378,44268,40323
571,28,51,571,0,480,91,1.96409e+17,24.0806,141.114,571,34,28,520,515,497,501,307
40907,147,1829,19715,21192,0,40907,5.09005e+18,1426.89,6900.05,40907,520,438,28412,20477,8216,6358,4303
14141,1555,1752,6896,7245,0,14141,5.08514e+18,968.133,4026.15,14141,318,284,12340,11102,10463,10208,11535
29601,236,911,28763,838,29601,0,4.61633e+18,515.403,3505.17,29601,289,211,27312,25380,15397,14728,10505
38870,672,2493,38870,0,31991,6879,3.02646e+18,1701.92,7741.06,38870,554,453,30662,26076,15986,12063,12776
37387,2254,2830,37387,0,31262,6125,3.26464e+18,1644.57,7759.46,37387,596,422,34557,34395,33656,33757,32017
14972,464,705,14551,421,14972,0,4.53678e+18,380.957,2359.04,14972,231,163,14205,13904,12826,12876,11548
47383,878,2162,37897,9486,22391,24992,8.45843e+17,1769.39,8336.34,47383,572,477,38468,32100,25240,23656,21442
44336,39,43,41818,2518,43881,455,1.06595e+14,41.1187,973.068,44336,43,42,44263,44212,43669,43666,41751
26419,1451,2667,22067,4352,13859,12560,7.26663e+17,1524.08,6468.93,26419,510,377,22695,19676,18174,18026,14285
13941,786,1921,7181,6760,7181,6760,4.92464e+18,917.825,4058.12,13941,337,288,11333,10326,6459,6521,6600
22603,845,2389,0,22603,0,22603,2.44602e+18,1161.36,5483.32,22603,463,329,18930,17110,9404,8905,9137
5587,468,1113,1927,3660,0,5587,3.75622e+13,179.115,1939.61,5587,191,161,4474,4324,2756,2524,2616
31027,353,4699,30287,740,25235,5792,2.59218e+18,1031.93,9058.77,31027,920,447,22122,18679,9769,3564,3223
41834,580,887,40773,1061,41834,0,4.60729e+18,597.474,4156.42,41834,314,239,40769,39517,36273,36339,31627
12329,169,347,0,12329,11802,527,2.44187e+16,150.227,1356.36,12329,85,90,11919,11765,10755,10142,8993
6780,557,1336,0,6780,2378,4402,9.65168e+15,171.891,2316.57,6780,204,171,5444,5291,3320,3242,3057
29773,70,354,0,29773,28089,1684,2.73753e+16,287.832,2257.69,29773,133,145,28079,27332,20286,17736,12489
35514,2194,2746,29670,5844,18689,16825,7.23732e+17,1632.97,7483.69,35514,601,407,32768,32558,29489,28868,31835
21159,1129,2149,10959,10200,10959,10200,4.93504e+18,1159.12,5152.51,21159,442,325,18244,16451,11173,11618,12444
34757,2085,2736,28814,5943,17903,16854,7.44228e+17,1671.22,7462.58,34757,608,410,32021,27217,27834,27228,29677
30434,2124,2560,25425,5009,15950,14484,7.32258e+17,1614.98,6893.57,30434,539,391,27823,24725,25396,24757,26178
23895,1477,2182,12531,11364,0,23895,5.00786e+18,1209.2,5472.9,23895,471,339,21398,19027,15787,14549,16783
31880,15,43,30421,1459,30976,904,9.8287e+13,39.7967,809.095,31880,41,38,31146,30610,25273,24664,18563
47936,1870,2185,23931,24005,0,47936,5.07097e+18,1474.5,7776.25,47936,573,447,45751,45750,40646,39827,44712
28149,1814,2077,13381,14768,0,28149,5.1926e+18,1319.9,6009.87,28149,483,375,26072,25260,20593,19943,24053
9504,640,1678,4430,5074,0,9504,5.10887e+18,738.171,3262.17,9504,288,222,7404,6603,3519,2996,3341
46502,1709,1912,0,46502,16525,29977,9.54336e+15,1165.5,6555.76,46502,606,381,44590,44590,42732,41816,44215
1775,22,36,1660,115,1770,5,1.02124e+14,21.7972,194.022,1775,25,24,1730,1705,1494,1485,1341
19113,695,1406,6814,12299,0,19113,3.85825e+13,892.905,3958.39,19113,327,292,16714,15466,10506,10277,9796
13734,1638,1701,6538,7196,6538,7196,5.04959e+18,1007.23,3942.35,13734,312,290,12033,10859,11818,11732,11874
32375,451,2622,32375,0,26942,5433,3.32632e+18,1624.65,7110.41,32375,542,411,24542,21432,13521,11038,7185
2589,177,604,0,2589,954,1635,1.02445e+16,56.0212,1016.84,2589,127,98,1985,1926,1493,682,697
20956,134,2035,16669,4287,9824,11132,8.50829e+17,1417.35,5426.41,20956,416,347,12662,7617,5487,5197,1644
19426,195,683,19147,279,19426,0,4.6822e+18,465.927,2721.45,19426,216,188,17553,15634,8277,8510,6446
47635,509,602,47125,510,47635,0,4.73242e+18,522.066,4124.41,47635,262,259,46795,45442,43365,43410,41921
17168,41,43,16345,823,16713,455,9.92084e+13,35.6022,590.881,17168,37,35,17123,17114,17088,17087,16806
14670,35,43,14014,656,14191,479,9.75476e+13,37.0028,552.121,14670,37,34,14611,14580,14056,14123,13545
46715,2782,2895,38994,7721,24534,22181,7.25315e+17,1764.46,8688.38,46715,667,449,43820,43820,43601,43580,43403
25471,1163,1507,0,25471,8975,16496,9.64964e+15,1016.18,4666.74,25471,402,320,23657,21231,18373,15770,20403
7648,1189,2124,7648,0,6394,1254,3.31312e+18,284.452,3270.37,7648,253,198,5524,5452,5304,5130,3228
16676,1631,2391,16676,0,14032,2644,3.32566e+18,1143.91,4958.67,16676,432,321,13973,12485,13437,12947,10754
29636,180,2667,29636,0,24828,4808,3.35077e+18,1580.02,6818.06,29636,564,390,20119,15457,9218,7924,3939
41726,1151,1656,0,41726,14789,26937,9.69802e+15,1166.79,6079.48,41726,536,371,39267,35075,27869,20787,33486
2565,345,610,0,2565,840,1725,8.59733e+15,87.5684,1031.24,2565,109,114,1955,1939,1349,1427,1165
12759,10,42,12038,721,12637,122,1.07084e+14,34.295,512.848,12759,36,33,12044,11536,9406,9087,6460
39668,711,1778,18876,20792,18876,20792,5.01404e+18,1415.04,6739.75,39668,509,428,33295,28658,14662,14121,16094
33515,386,1780,0,33515,0,33515,2.54745e+18,1410.16,6237.66,33515,481,411,26152,22721,7850,6271,7762
34011,282,1780,16095,17916,16095,17916,4.99965e+18,1396.26,6267.13,34011,484,412,25588,22161,7227,7396,7491
11039,452,1391,0,11039,3957,7082,9.96275e+15,569.366,2948.32,11039,267,242,9263,8642,5632,3909,4527
21269,338,353,0,21269,20157,1112,2.63005e+16,264.797,1894.85,21269,115,120,20899,20511,20746,20644,20511
35959,306,717,35448,511,35959,0,4.67504e+18,523.008,3699.86,35959,259,232,34066,32510,20793,20733,18125
6383,721,1265,2289,4094,0,6383,3.75108e+13,209.555,2205.12,6383,235,187,5118,5007,3974,4055,3796
14698,571,1538,0,14698,5240,9458,9.57427e+15,728.047,3492.79,14698,368,250,12568,11713,7809,4845,5207
19037,143,355,0,19037,18200,837,2.48268e+16,212.796,1714.33,19037,107,113,18419,18148,15912,14173,12926
5382,1196,1446,2530,2852,0,5382,5.12614e+18,287.44,2328.06,5382,216,207,3936,3882,3606,3603,3628
40102,905,1983,14181,25921,0,40102,3.75016e+13,1126.63,6257.3,40102,579,360,36399,33264,21762,21552,24670
47302,31,42,45114,2188,46006,1296,9.90241e+13,40.1188,965.336,47302,42,40,47145,47019,43534,43443,40258
25925,1515,2046,0,25925,0,25925,2.46914e+18,1278.58,5612.69,25925,451,339,23574,20748,17233,16324,18902
48183,26,357,0,48183,45983,2200,2.5102e+16,298.54,2782.54,48183,147,159,43672,41134,31711,27861,18118
9616,596,1831,4985,4631,4985,4631,4.97318e+18,575.624,3307.38,9616,281,259,7610,6895,4112,4250,3575
3724,11,39,3607,117,3524,200,8.63929e+13,21.2637,269.865,3724,24,25,3583,3483,2854,2813,2186
6585,1601,1666,3231,3354,0,6585,4.97428e+18,242.592,2702.23,6585,231,178,4919,4918,4919,4919,4589
14594,136,453,13191,1403,13678,916,9.27808e+13,36.3414,1138,14594,214,83,14141,14047,10721,10198,5292
9929,1290,1891,4834,5095,0,9929,5.12428e+18,660.081,3492.66,9929,288,237,8038,7590,6074,5850,6570
5451,497,510,5388,63,5451,0,4.82457e+18,211.823,1343.15,5451,113,110,4941,4941,4934,4939,4929
30906,980,1730,14668,16238,0,30906,5.10441e+18,1348.46,5893.32,30906,462,391,26806,23572,15293,12625,19029
20182,1265,1878,10032,10150,10032,10150,4.94699e+18,1180.53,4896.87,20182,387,327,17628,15669,11860,10876,13360
2654,196,229,0,2654,2491,163,2.7042e+16,53.2095,586.06,2654,55,54,2425,2421,2418,2420,2354
17172,571,634,16926,246,17172,0,4.61841e+18,437.831,2511.17,17172,190,178,16538,16291,16180,16160,16084
44482,221,1914,0,44482,15778,28704,9.53751e+15,1184.1,6459.3,44482,567,385,36491,33531,14927,9696,8525
39914,410,801,39462,452,39914,0,4.80048e+18,560.05,4068.09,39914,303,243,38268,36812,29406,28619,25592
42824,153,1858,15150,27674,0,42824,3.77867e+13,1214.33,6425.87,42824,605,376,33774,30011,13463,8109,6632
48879,212,370,0,48879,46630,2249,2.5091e+16,301.897,2827.51,48879,149,161,47832,46878,42823,39155,35859
41100,252,896,40663,437,41100,0,4.75928e+18,616.82,4275.05,41100,294,245,37803,34598,19729,18957,15855
35302,1,43,33655,1647,34382,920,9.94837e+13,39.5558,852.338,35302,41,40,12738,12738,12738,12738,12738
31455,1701,2224,31455,0,25394,6061,3.00682e+18,1642.88,6845.89,31455,478,406,28391,23773,27253,27552,24559
49844,320,2561,26435,23409,0,49844,5.01526e+18,1491.36,8105.11,49844,655,444,39116,34514,14269,13582,7475
12105,325,349,0,12105,11511,594,2.57098e+16,195.966,1416.14,12105,99,96,11756,11595,11584,11601,11278
40854,117,356,0,40854,38942,1912,2.53986e+16,294.232,2569.17,40854,138,152,39456,38736,32134,27818,23420
1554,208,722,713,841,0,1554,4.8941e+18,82.379,960.653,1554,151,107,832,668,415,362,463
15965,753,1714,7556,8409,0,15965,5.16473e+18,1115.65,4261.42,15965,324,298,13014,11559,6652,5616,7270
1527,540,558,1239,288,786,741,8.43951e+17,122.105,822.438,1527,102,93,969,969,964,961,954
35545,1287,1765,0,35545,12665,22880,9.61814e+15,1070.31,5604.25,35545,524,350,33576,30279,26030,20888,32153
1321,447,469,522,799,522,799,4.2481e+18,63.975,692.868,1321,81,83,852,852,852,852,843
47983,1458,1775,22763,25220,22763,25220,5.02125e+18,1457.68,7398.27,47983,537,457,45233,38346,33541,31849,40968
31321,199,1335,0,31321,11037,20284,9.87409e+15,1057.07,4997.19,31321,427,352,25217,22877,9253,7546,4479
46635,607,1795,0,46635,0,46635,2.55075e+18,1466.67,7336.61,46635,539,450,38437,33087,15747,13389,18886
13822,1431,1456,0,13822,4897,8925,9.53444e+15,657.568,3287.26,13822,327,255,12366,12061,12318,11896,12286
10395,326,351,0,10395,9872,523,2.5981e+16,183.929,1320.51,10395,91,87,10044,9935,9916,9902,9636
562,60,197,0,562,197,365,8.33498e+15,31.4306,303.114,562,63,60,357,317,168,194,123
49760,284,2539,0,49760,0,49760,2.42981e+18,1477.74,8063.45,49760,677,443,38688,34283,13858,7203,6953
42365,1593,2352,22175,20190,22175,20190,4.88484e+18,1475.08,7348.97,42365,614,417,39582,34249,27277,26171,32581
7780,207,1721,0,7780,0,7780,2.46746e+18,444.312,2963.28,7780,269,188,5542,4630,1844,1136,1000
21106,24,42,19914,1192,20861,245,1.0709e+14,38.212,660.935,21106,38,36,20914,20768,18130,18120,15287
7496,20,43,7143,353,7294,202,9.83063e+13,25.8627,393.498,7496,32,31,7385,7313,6482,6443,5671
16962,1693,2037,8590,8372,0,16962,5.19424e+18,1030.88,4652.06,16962,336,308,14925,13526,12888,12585,13986
3879,1093,1101,1947,1932,1947,1932,5.15788e+18,205.525,1744.94,3879,155,152,2778,2778,2778,2778,2778
42879,1622,1904,21139,21740,21139,21740,5.00944e+18,1439.19,7131.76,42879,541,441,40825,34985,33246,32615,39316
47751,135,930,46352,1399,47751,0,4.56967e+18,624.366,4447.18,47751,330,243,41253,33773,18949,17899,8796
3779,237,1106,1963,1816,0,3779,5.51622e+18,202.022,1735.88,3779,195,146,2626,2332,1167,970,999
48369,1351,2308,48369,0,39311,9058,3.05171e+18,1759.69,8538.74,48369,623,484,42445,35765,33175,31268,31714
34634,50,2534,16624,18010,0,34634,5.06702e+18,1481.49,7179.54,34634,570,419,17205,10084,5108,3723,933
16512,1864,2220,16512,0,13560,2952,3.06889e+18,1247.04,4919.14,16512,389,323,14228,12460,13770,13776,12812
48862,1229,2506,25608,23254,25608,23254,4.93232e+18,1501.15,8003.78,48862,664,438,44029,38756,24763,26075,30485
3302,31,266,0,3302,3105,197,2.71471e+16,42.2913,687.198,3302,59,54,2927,2741,2066,1864,1170
49495,660,1890,17609,31886,0,49495,3.73709e+13,1165.83,6697.33,49495,611,392,44024,40340,25422,22234,26727
46364,1205,1748,21998,24366,0,46364,5.12222e+18,1451.26,7240.99,46364,529,449,42129,36165,27022,23199,34054
21466,427,2034,11477,9989,11477,9989,4.91854e+18,1163.03,5015.6,21466,453,317,17236,15488,8040,8003,5236
2482,560,738,882,1600,0,2482,3.7259e+13,88.1636,1130.63,2482,171,117,1744,1742,1434,1582,1464
43984,1527,1610,0,43984,15590,28394,9.63056e+15,1158.16,6147.69,43984,508,380,42374,42374,41796,41540,42070
30687,2513,2665,25696,4991,16218,14469,7.16305e+17,1587.13,6914.33,30687,559,389,28022,28022,27745,27671,27410
46299,9,44,43676,2623,45851,448,1.06598e+14,41.4531,986.749,46299,44,43,43165,41111,32789,32675,21750
16221,1472,1878,7962,8259,7962,8259,4.91909e+18,1066.01,4392.64,16221,360,308,14190,12681,10792,10348,12649
23286,158,393,0,23286,21946,1340,2.70828e+16,249.703,2061.77,23286,120,130,22453,21983,18749,16311,13949
43761,141,353,0,43761,41321,2440,2.73257e+16,311.58,2755.14,43761,157,162,42154,41210,34162,29715,25097
49772,161,781,48757,1015,49772,0,4.60071e+18,584.69,4416.42,49772,280,257,44186,38208,19721,19617,12413
40950,1172,2427,0,40950,0,40950,2.44791e+18,1478.45,7286.36,40950,597,415,36458,32336,20666,18984,23979
21480,1323,2081,11436,10044,11436,10044,4.94832e+18,1135.87,5080.37,21480,425,320,19045,16974,13343,12640,14494
39036,1288,2313,20476,18560,0,39036,5.00593e+18,1459.45,7049,39036,566,414,35111,30931,21705,19894,25001
19185,1005,1985,15297,3888,9103,10082,8.47643e+17,1365.06,5150.8,19185,379,348,15466,13246,11003,10543,9639
44554,1550,1831,15798,28756,0,44554,3.73354e+13,1145.76,6326.77,44554,589,381,42723,42723,38725,39092,42089
48995,876,2308,25046,23949,25046,23949,4.94153e+18,1472.34,7902.36,48995,609,446,42273,37450,19598,21988,24772
37297,481,1804,17690,19607,0,37297,5.1004e+18,1413.2,6564.42,37297,505,421,29879,25938,10097,8666,9815
32381,946,2022,16127,16254,0,32381,5.04173e+18,1373.49,6305.28,32381,485,384,27907,24661,15003,13182,16775
17826,1796,2033,9455,8371,9455,8371,4.96769e+18,1070.22,4619.79,17826,383,307,15793,14400,14400,14132,14630
8533,23,43,8170,363,8227,306,9.40452e+13,23.1166,411.36,8533,32,32,8448,8393,7544,7535,6429
38642,1196,2128,30926,7716,18351,20291,8.4158e+17,1681.29,7488.27,38642,534,442,32812,27901,24690,23976,23104
1801,27,31,1697,104,1801,0,1.01431e+14,20.985,168.646,1801,22,21,1770,1770,1751,1750,1681
37975,91,349,0,37975,36011,1964,2.64569e+16,300.608,2533.98,37975,139,151,36278,35519,27813,23772,18251
19321,927,1548,0,19321,6906,12415,9.61122e+15,855.101,3964.49,19321,363,283,17302,16139,12717,9959,13614
47002,196,349,0,47002,44647,2355,2.6067e+16,310.118,2796.91,47002,149,161,45811,44822,40106,36205,31186
11908,1855,2204,11908,0,10082,1826,3.26519e+18,752.991,4004.18,11908,308,265,9704,9078,9524,9493,8955
43594,2608,2860,22757,20837,0,43594,4.97306e+18,1419.66,7921.67,43594,620,427,40734,40734,39957,39752,40028
33365,417,2692,27746,5619,17265,16100,7.36593e+17,1665.86,7288.02,33365,579,404,25002,21914,12898,13982,7512
19212,133,2101,19212,0,15388,3824,3.02556e+18,1435.64,5308.8,19212,365,352,11318,6769,3696,3315,1559
1105,388,424,669,436,669,436,5.73658e+18,44.7385,597.734,1105,83,70,681,680,681,681,674
25667,781,2167,0,25667,0,25667,2.42863e+18,1232.29,5610.72,25667,481,340,21672,19374,11190,11054,11278
24892,1290,2148,13292,11600,0,24892,5.01889e+18,1308.64,5540.46,24892,470,333,21881,19626,14405,13317,16549
43306,1875,2837,43306,0,36283,7023,3.30219e+18,1721.91,8321.91,43306,676,453,39993,33680,37626,36116,34182
12361,1176,1698,5870,6491,0,12361,5.12663e+18,929.545,3743.79,12361,311,265,10291,9322,7091,6498,8176
35277,1211,2413,28736,6541,17530,17747,7.88862e+17,1632.42,7341.97,35277,538,418,29935,25678,23025,22505,19999
38976,638,2298,20131,18845,0,38976,5.01163e+18,1465.36,7080.85,38976,607,411,32346,28512,13654,13885,12584
1934,141,891,1934,0,1525,409,3.81059e+18,94.8956,1188.26,1934,160,107,1043,783,353,482,262
15648,184,345,0,15648,14868,780,2.62296e+16,227.528,1598.96,15648,102,101,15141,14866,13422,12452,10881
1835,332,349,1794,41,1835,0,4.35636e+18,113.986,699.697,1835,71,67,1486,1486,1476,1479,1472
14894,942,1779,7284,7610,0,14894,5.09078e+18,1035.5,4163.48,14894,355,294,12434,11162,7626,6997,8481
13703,132,678,13440,263,13703,0,4.67336e+18,383.413,2278.02,13703,172,162,11656,9296,5439,5313,3286
6522,132,341,0,6522,6172,350,2.57428e+16,76.4473,1028.98,6522,75,79,6181,6097,5262,4912,4072
36032,925,3281,27580,8452,23595,12437,4.32025e+18,409.926,7565.4,36032,430,338,32751,32222,26964,6670,5708
19952,304,2137,0,19952,0,19952,2.4229e+18,1037.15,4878.65,19952,440,297,15627,14093,6562,3924,3371
1142,338,515,0,1142,0,1142,2.76225e+18,61.225,715.429,1142,87,95,627,626,604,602,485
28560,14,43,27087,1473,28034,526,1.02745e+14,39.6882,777.692,28560,41,40,27718,27095,22324,21695,16844
40507,1663,1748,19418,21089,19418,21089,5.02231e+18,1427.38,6773.11,40507,511,432,38759,38627,37722,37382,38349
22842,364,818,22250,592,22842,0,4.5309e+18,447.637,3028.77,22842,225,199,21623,20886,15598,15185,13285
31421,1155,2314,25857,5564,15952,15469,7.6907e+17,1647.81,6867.32,31421,501,406,26560,22693,19908,19475,17515
36208,845,2334,19325,16883,0,36208,5.06565e+18,1370.28,6776.97,36208,542,400,31016,27834,15798,16252,16559
34822,85,598,34442,380,34822,0,4.73937e+18,506.202,3528.67,34822,237,234,26045,17640,9904,9691,5429
35713,857,2646,35713,0,29907,5806,3.29544e+18,1664.8,7438.46,35713,619,422,29109,24799,19430,18091,15886
49703,2079,2577,26257,23446,26257,23446,4.92641e+18,1502.39,8105.36,49703,686,443,47126,47126,40949,40183,45318
40549,40,43,38710,1839,39338,1211,9.77103e+13,39.8269,912.706,40549,42,40,40491,40460,40364,40362,38444
48220,982,2347,48220,0,39023,9197,3.03343e+18,1777.7,8581.91,48220,579,481,39994,33694,24525,22181,24364
48264,820,1798,22832,25432,22832,25432,4.97935e+18,1478.85,7465,48264,544,457,41291,36037,20048,18987,24915
33769,1834,2078,16979,16790,16979,16790,4.98342e+18,1379,6486.24,33769,466,400,31691,31639,28378,28161,30864
26315,1680,2128,13846,12469,0,26315,5.05309e+18,1292.21,5688.83,26315,462,361,24134,21246,18985,18024,20927
19228,306,349,0,19228,18361,867,2.50748e+16,228.295,1725.68,19228,108,115,18839,18553,18157,17585,17581
44290,963,1782,0,44290,0,44290,2.5469e+18,1445.3,7140.19,44290,529,452,38611,33787,21578,17818,27079
1265,42,684,1066,199,616,649,6.59763e+17,64.2988,872.689,1265,113,96,465,253,174,153,55
18269,104,2128,0,18269,0,18269,2.45714e+18,1056.91,4772.17,18269,413,310,12003,8561,4306,1753,131
13093,999,1697,0,13093,0,13093,2.53555e+18,956.873,3838.75,13093,296,280,10777,9830,7119,6348,8183
11232,1234,2093,5716,5516,0,11232,4.96531e+18,732.998,3846.07,11232,344,245,9139,8406,6186,5838,6585
45910,1566,1595,0,45910,16263,29647,9.69707e+15,1162.06,6318.72,45910,513,388,44315,44315,44240,44097,44248
24678,197,2461,20675,4003,13032,11646,7.13595e+17,1503.51,6106.45,24678,463,362,16843,13094,7841,8863,2419
35384,2239,2300,18789,16595,0,35384,5.0171e+18,1384.2,6679.31,35384,563,385,33084,33084,33023,32751,32418
23624,23,43,22542,1082,22957,667,9.83092e+13,36.9582,697.297,23624,39,37,23404,23213,20481,20427,16100
20114,629,2058,0,20114,0,20114,2.47343e+18,1203.53,4973.93,20114,415,323,16339,14575,7487,6656,6094
23883,26,43,22703,1180,23388,495,1.01486e+14,39.5475,705.971,23883,40,38,23706,23591,20984,21053,17850
49160,786,1645,0,49160,17456,31704,9.96965e+15,1167.27,6644.66,49160,501,430,45159,42493,25397,21254,28962
29385,37,353,0,29385,27992,1393,2.54514e+16,286.218,2186.53,29385,126,132,27273,25926,19944,17276,11615
15038,288,1270,5311,9727,0,15038,3.91986e+13,794.857,3384.62,15038,295,277,12391,11377,5584,4361,4550
21663,310,2094,0,21663,0,21663,2.42781e+18,1184.11,5093.95,21663,494,320,16910,15108,7163,4347,3739
1031,387,449,563,468,0,1031,5.39667e+18,93.1775,633.552,1031,91,81,582,582,560,557,568
47307,130,2585,25059,22248,0,47307,4.99359e+18,1496.14,7928.08,47307,671,432,33342,25210,12459,8743,3693
20242,61,1545,0,20242,7170,13072,9.45706e+15,887.065,4064.41,20242,428,268,14808,12479,6450,3142,1365
48230,262,359,0,48230,46007,2223,2.51313e+16,300.314,2790.24,48230,148,159,47455,46543,43301,40795,38768
2012,437,883,1636,376,781,1231,1.04424e+18,110.1,1172.37,2012,210,141,1129,1070,831,816,644
2529,128,154,0,2529,2414,115,2.5045e+16,31.1997,467.94,2529,45,40,2375,2375,2329,2360,2089
25053,2341,2682,25053,0,20949,4104,3.36169e+18,1500.91,6341,25053,522,355,22371,22281,22081,22103,21207
30922,202,593,30603,319,30922,0,4.73753e+18,486.384,3310.32,30922,229,229,28318,25656,14415,14749,11543
6543,57,1942,5353,1190,3332,3211,7.80503e+17,296.755,2954.99,6543,259,201,3196,1903,1201,1276,214
11102,97,1298,3970,7132,0,11102,3.97327e+13,653.145,2948.92,11102,256,246,8225,6700,3157,1306,1394
16390,1284,1517,0,16390,5830,10560,9.77241e+15,835.277,3767.3,16390,363,278,14838,13575,13319,12185,14186
38361,1167,1989,13444,24917,0,38361,3.81588e+13,1255.26,6409.15,38361,556,380,34942,31512,22998,20768,28913
12905,26,43,12238,667,12679,226,1.0271e+14,36.0181,519.131,12905,36,32,12801,12746,11361,11382,10237
34184,233,952,34103,81,34184,0,4.61275e+18,491.646,3919.91,34184,242,245,31858,29508,15805,15255,11381
48085,820,2006,17076,31009,0,48085,3.71527e+13,1154.26,6701.19,48085,654,381,43358,39685,26136,23858,31696
8112,1076,2071,6631,1481,4040,4072,7.7611e+17,495.438,3361.72,8112,273,221,6041,5675,4741,4773,3600
49076,955,2303,25719,23357,0,49076,5.0683e+18,1465.59,7835.26,49076,599,444,43039,38172,21806,20622,25438
19060,457,1959,10119,8941,10119,8941,4.97386e+18,1110.59,4716.32,19060,375,310,15265,13627,7161,6991,5175
48335,227,358,0,48335,45595,2740,2.73368e+16,314.674,2903.69,48335,160,172,47190,45991,41443,37130,36574
16552,262,352,0,16552,15682,870,2.63469e+16,232.919,1670,16552,107,115,16114,15824,14710,14167,13466
21749,273,580,21557,192,21749,0,4.75728e+18,448.154,2759.49,21749,205,200,20440,19391,12416,12298,10548
41331,165,386,0,41331,39167,2164,2.72307e+16,318.695,2762.8,41331,152,161,40016,39076,33421,28930,24938
13390,545,577,13262,128,13390,0,4.76087e+18,385.777,2173.16,13390,170,164,12813,12599,12594,12625,12495
3370,519,1102,3370,0,2984,386,3.49499e+18,121.625,1559.59,3370,185,113,2268,2204,2120,2070,1681
32826,1924,2840,26690,6136,15614,17212,7.98289e+17,1722.77,7647.95,32826,582,431,29661,24583,23305,23310,24608
6454,20,1239,2288,4166,0,6454,3.80579e+13,175.744,2192.99,6454,195,185,3528,2561,1488,1073,222
38883,1992,2561,19265,19618,19265,19618,4.92759e+18,1495.06,7501.16,38883,621,413,36322,35698,28837,27890,33782
7829,191,346,0,7829,7468,361,2.53017e+16,90.3244,1116.42,7829,84,75,7483,7437,6972,6823,5868
39694,2022,2905,33338,6356,21111,18583,7.14904e+17,1716.65,8019.45,39694,623,426,36665,31011,30796,30357,32010
5919,1604,1844,5919,0,4708,1211,2.99196e+18,265.018,2782.93,5919,205,206,4075,4074,4063,4059,3909
14689,768,1746,6999,7690,6999,7690,5.06577e+18,1034.91,4119.91,14689,316,293,12017,10680,6315,5642,6561
16020,789,1888,0,16020,0,16020,2.48416e+18,1012.18,4340.56,16020,344,304,13293,11976,7195,6658,7712
47549,436,2591,39130,8419,24214,23335,7.62492e+17,1737.62,8582.65,47549,630,458,35872,30917,18578,19381,10813
40792,513,1769,0,40792,0,40792,2.53516e+18,1418.26,6805.7,40792,509,433,33033,28768,12496,10126,14296
31025,595,1705,0,31025,11011,20014,9.53374e+15,1058.06,5231.76,31025,497,334,27124,25030,15495,9952,10896
1552,269,424,0,1552,504,1048,9.86803e+15,83.6682,686.834,1552,110,99,1128,1124,838,798,878
34774,1743,2106,27769,7005,16412,18362,8.45985e+17,1658.71,7086.5,34774,512,417,31860,26204,28043,26820,29573
6577,1056,1659,3120,3457,3120,3457,5.00211e+18,275.123,2696.61,6577,256,207,4918,4854,3731,3886,3735
15692,103,350,0,15692,14940,752,2.54719e+16,218.076,1583.28,15692,101,101,15049,14795,12262,11112,8046
36440,459,1774,17128,19312,0,36440,5.11427e+18,1412.92,6473.86,36440,502,409,29047,25225,9897,8520,10999
38363,553,1775,0,38363,13624,24739,9.55407e+15,1125.03,5857.64,38363,544,356,33498,30647,18230,11556,12621
44563,875,1886,0,44563,15877,28686,9.59957e+15,1142.33,6388.56,44563,570,375,40651,37094,25206,18853,22604
9994,337,1456,0,9994,3597,6397,9.72485e+15,429.087,2808.04,9994,274,234,8292,7730,4904,2991,2996
39374,942,1862,0,39374,13855,25519,9.80205e+15,1269.87,6341.1,39374,581,387,35303,31989,20952,17272,26730
36848,630,856,36078,770,36848,0,4.599e+18,518.035,3843.78,36848,282,227,35992,35890,33069,33206,32453
31973,2388,2616,26597,5376,16649,15324,7.33219e+17,1618.49,7046.23,31973,557,387,29357,29357,28134,27937,28696
46198,37,43,44096,2102,44858,1340,9.77653e+13,40.4722,974.926,46198,43,41,46109,46037,44058,44066,41661
6623,582,2037,5393,1230,3221,3402,7.89139e+17,345.235,3085.68,6623,258,193,4586,4072,2867,2823,1878
36706,1346,2395,17311,19395,0,36706,5.0284e+18,1651.62,7312.12,36706,634,416,32243,28242,17994,15014,23644
3253,199,1297,2678,575,1529,1724,7.85989e+17,255.04,1829.34,3253,226,133,1781,1188,849,811,522
41921,7,43,39844,2077,41044,877,1.01811e+14,40.8765,936.943,41921,43,41,38112,35619,29183,29162,18621
4315,56,267,0,4315,4102,213,2.59007e+16,58.7511,777.839,4315,66,61,4003,3889,3065,2951,2228
44277,296,1944,21550,22727,0,44277,5.07188e+18,1478.54,7308.46,44277,576,433,33859,29454,10184,8867,7122
31227,1442,1801,11075,20152,0,31227,3.70457e+13,1054.08,5297.91,31227,503,329,29426,27946,25773,26160,28451
9164,1162,1751,4777,4387,0,9164,5.18898e+18,600.027,3211.87,9164,272,248,7413,6916,5904,5647,5854
49335,1572,2570,26070,23265,0,49335,5.00766e+18,1500.54,8069.21,49335,679,443,46147,40032,29921,27125,38146
1334,650,689,1050,284,621,713,8.77251e+17,32.6649,880.313,1334,110,96,645,645,642,645,638
41444,221,1827,14752,26692,0,41444,3.74298e+13,1133.69,6104.94,41444,553,371,34155,31474,14764,10973,7742
13784,1777,2156,7148,6636,7148,6636,5.01721e+18,516.319,4265.02,13784,400,249,11628,11622,11071,10946,10887
41483,40,43,39273,2210,40815,668,1.03965e+14,40.4678,935.307,41483,43,42,41422,41380,41261,41259,38947
17233,42,43,16471,762,16698,535,9.74459e+13,33.9257,591.09,17233,37,35,17189,17182,17154,17153,17003
14672,273,355,0,14672,13875,797,2.68547e+16,219.556,1582.03,14672,101,107,14242,14014,13261,12630,12616
2770,264,453,2769,1,2770,0,4.78358e+18,159.057,932.439,2770,109,80,2317,2200,1969,1904,1582
25789,642,1639,9137,16652,0,25789,3.69648e+13,978.138,4674.41,25789,442,303,22700,20974,14019,12753,14714
41006,142,363,0,41006,39045,1961,2.53712e+16,297.656,2591.16,41006,143,154,39691,38963,33239,29251,25251
22241,40,43,21139,1102,21701,540,1.00081e+14,37.2646,666.517,22241,38,36,22194,22181,22120,22118,21293
27456,1051,2068,27456,0,21953,5503,3.04463e+18,1581.22,6278.33,27456,445,408,22706,19055,15363,14340,15314
21617,788,869,20986,631,21617,0,4.51119e+18,441.305,2970.07,21617,246,191,20748,20747,20530,20492,20172
44775,2697,2884,44775,0,37395,7380,3.29923e+18,1752.94,8520.07,44775,692,455,41891,41891,41806,41822,41873
13244,1648,1959,6687,6557,6687,6557,4.95348e+18,897.4,4013.88,13244,329,286,11285,10354,9482,9176,10761
24351,2049,2294,12836,11515,12836,11515,4.9032e+18,1254.14,5620.83,24351,484,343,22057,22056,20495,20514,21269
36961,252,879,35910,1051,36961,0,4.47942e+18,591.485,3898.71,36961,307,225,34365,32050,17960,17765,11263
43063,413,1348,15178,27885,0,43063,3.87116e+13,1112.8,5872.1,43063,484,387,36732,33293,16872,12338,15096
12835,1605,2334,10765,2070,6745,6090,7.10496e+17,906.358,4320.67,12835,352,290,10501,9436,8901,8954,8546
34903,4130,6070,5612,29291,5611,29292,2.96721e+18,682.116,11033.4,34903,875,536,28833,28833,21664,19120,18471
4547,24,43,4278,269,4541,6,1.05174e+14,28.6512,318.587,4547,30,30,4476,4437,3843,3840,3338
41569,1718,1771,19637,21932,19637,21932,4.99905e+18,1435.54,6907.18,41569,526,433,39798,39798,39583,39398,39697
23274,1065,2062,0,23274,0,23274,2.44246e+18,1260.71,5319.93,23274,456,329,19967,18109,12139,10890,12428
36706,144,356,0,36706,35041,1665,2.51788e+16,284.284,2422.63,36706,133,147,35599,34976,30180,26479,21513
37645,754,2375,19807,17838,0,37645,4.99891e+18,1433.9,6969.81,37645,565,401,31693,27961,14267,14653,14777
9908,1912,2187,8483,1425,5557,4351,6.4875e+17,500.236,3626.08,9908,307,241,7721,7416,7521,7408,6942
49197,344,2852,40205,8992,23494,25703,7.85654e+17,1919.94,9338.34,49197,662,483,34580,27594,15801,16999,8700
14132,1203,2308,11645,2487,7150,6982,7.55421e+17,1093.38,4595.38,14132,357,280,11237,10136,8885,8849,6953
42605,2921,2968,42605,0,35590,7015,3.31836e+18,1758.22,8399.46,42605,659,450,39637,39637,39637,39637,39637
30701,2383,2626,30701,0,25672,5029,3.33131e+18,1597.26,6933.24,30701,533,390,28075,28075,27678,27739,27380
14421,4,42,13674,747,14248,173,1.06571e+14,36.1065,540.697,14421,35,33,11480,10100,8920,8622,5283
44693,2708,2843,44693,0,37079,7614,3.29636e+18,1791.54,8537.81,44693,699,460,41850,41850,41774,41765,41835
18672,996,2025,9856,8816,0,18672,5.07617e+18,1076,4729.39,18672,400,316,15986,14384,9605,8908,10496
47377,36,43,45153,2224,46094,1283,9.9111e+13,39.4038,977.042,47377,42,41,47285,47213,45111,45117,42537
48046,607,2511,0,48046,0,48046,2.4552e+18,1502.45,7955.46,48046,643,443,39928,35109,15498,16721,14368
36597,239,795,35827,770,36597,0,4.64521e+18,558.224,3807.89,36597,293,233,33963,31614,17691,17884,14231
46183,561,809,45013,1170,46183,0,4.5122e+18,602.581,4269.79,46183,299,245,45093,43693,39046,38703,37939
1488,14,288,1353,135,1488,0,3.5898e+18,87.6411,520.268,1488,74,56,677,158,230,350,57
26382,870,1647,9326,17056,0,26382,3.69131e+13,976.191,4745.09,26382,469,302,23767,21931,16134,15992,17442
43298,40,910,41962,1336,43298,0,4.53793e+18,620.635,4212.58,43298,274,235,27442,17420,11362,10173,2486
30735,580,1557,10836,19899,0,30735,3.74082e+13,1048.07,5114.62,30735,453,336,26903,24688,15178,12953,14458
18050,1759,1864,0,18050,0,18050,2.50532e+18,1067.12,4550.78,18050,349,317,16186,16153,15636,15314,15873
44376,22,43,41837,2539,43934,442,1.07551e+14,40.7595,958.562,44376,42,42,43887,43428,36982,36831,29633
33786,646,1741,16117,17669,16117,17669,5.01926e+18,1372.91,6189.14,33786,485,409,27944,24160,12400,11639,14471
16899,323,2323,13656,3243,8004,8895,8.08456e+17,1339.45,5161.15,16899,372,318,11634,9515,5081,5549,2549
46746,362,610,46276,470,46746,0,4.72283e+18,516.426,4087.23,46746,257,259,44979,43394,32154,32529,29958
36455,522,2479,29329,7126,17367,19088,8.28567e+17,1637.31,7586.58,36455,575,433,27477,22871,14451,14789,11352
12737,697,770,12324,413,12737,0,4.45106e+18,372.74,2255.34,12737,215,154,11967,11967,11943,11955,11961
23686,4,43,22486,1200,23223,463,1.01427e+14,39.6438,703.406,23686,40,38,18907,16652,14720,14514,9943
20223,551,1446,7128,13095,0,20223,3.77111e+13,927.642,4095.98,20223,357,291,17314,16030,9388,8418,9748
20018,328,350,0,20018,18873,1145,2.73357e+16,266.953,1857.6,20018,113,123,19633,19210,19253,19192,19126
29458,1757,2175,15101,14357,0,29458,5.03088e+18,1328.48,6100.61,29458,489,380,27283,24249,21938,20707,24717
23920,246,818,23287,633,23920,0,4.51152e+18,489.191,3093.57,23920,261,199,22126,20661,12877,12451,9585
18400,389,2017,9611,8789,9611,8789,4.96491e+18,1083.54,4706.45,18400,406,317,14512,13060,6143,5937,5110
37739,1764,1953,0,37739,0,37739,2.48513e+18,1458.93,6766.93,37739,524,416,35786,35578,32445,30927,34902
30665,1216,1713,10884,19781,0,30665,3.71416e+13,1040.82,5181.73,30665,485,340,28652,25947,21716,21552,21925
38339,319,608,37955,384,38339,0,4.71721e+18,508.967,3712.45,38339,246,245,36551,35005,24382,24478,21187
2659,411,789,2659,0,2416,243,3.4728e+18,100.276,1134.9,2659,165,103,1870,1844,1789,1803,1342
28916,613,895,28164,752,28916,0,4.62127e+18,523.338,3468.21,28916,258,206,27988,27316,26019,25984,24093
11534,40,343,0,11534,11019,515,2.48148e+16,150.533,1325.61,11534,87,89,10785,10354,8117,7320,5379
39898,137,357,0,39898,38030,1868,2.5375e+16,293.711,2543.13,39898,137,152,38648,37938,32357,28308,24043
38425,1729,1826,13655,24770,0,38425,3.7231e+13,1124.15,5903.93,38425,553,354,36599,36599,36433,36483,36532
41620,108,356,0,41620,39661,1959,2.55232e+16,304.098,2615.22,41620,143,150,40073,39319,32304,27805,21166
26350,1448,1488,9297,17053,0,26350,3.78421e+13,1012.87,4698.68,26350,409,326,24862,24861,24800,24847,24831
33064,37,43,31584,1480,32063,1001,9.77981e+13,38.5085,823.844,33064,41,39,32993,32952,31609,31612,29773
45556,2477,2937,45556,0,37950,7606,3.32754e+18,1747.46,8619.44,45556,668,463,42619,42619,42032,42159,41055
3947,20,43,3723,224,3909,38,1.06686e+14,27.5523,298.236,3947,29,29,3855,3805,3304,3260,2786
18980,446,646,18610,370,18980,0,4.59909e+18,446.114,2632.54,18980,198,188,18161,17692,15755,15603,14597
47796,1379,2011,0,47796,16866,30930,9.6735e+15,1263.88,6973.23,47796,629,392,45476,40627,32552,26002,40072
2548,7,215,0,2548,2401,147,2.72338e+16,37.4788,552.965,2548,49,50,1817,1482,1295,995,701
5684,38,43,5363,321,5620,64,1.08005e+14,28.7871,350.444,5684,31,30,5641,5633,5604,5601,5459
2865,720,958,1418,1447,0,2865,5.53353e+18,147.987,1445.06,2865,181,152,1907,1872,1787,1782,1706
5783,30,43,5481,302,5703,80,1.03673e+14,25.6004,345.803,5783,30,29,5734,5720,5335,5301,4962
38262,622,2131,30692,7570,18231,20031,8.36956e+17,1686.86,7460.33,38262,520,446,29566,24646,16665,16585,11382
19557,1348,2383,16194,3363,10057,9500,7.53854e+17,1334.2,5437.16,19557,425,334,16474,14337,13059,12981,11906
40455,1274,2079,32335,8120,19156,21299,8.44423e+17,1707.26,7601.01,40455,532,448,35022,29425,27053,26373,25988
8626,238,1927,4150,4476,4150,4476,5.00435e+18,464.188,3283.58,8626,267,252,6111,5190,1922,1912,1584
11238,1256,1686,0,11238,0,11238,2.51903e+18,827.767,3525.3,11238,302,278,9462,8538,7056,6802,8119
15456,163,1644,5491,9965,0,15456,3.70407e+13,724.716,3663.29,15456,377,241,12390,11360,5712,4846,2144
16399,39,43,15637,762,15976,423,1.00205e+14,38.9105,585.142,16399,38,36,16348,16336,16231,16232,15811
34474,248,691,33929,545,34474,0,4.64576e+18,518.483,3595.67,34474,237,229,32167,30140,16760,17217,13877
30370,3729,4401,10542,19828,0,30370,3.40955e+13,535.856,7943.57,30370,867,430,25969,25963,24163,24636,23600
38346,1087,2158,18278,20068,18278,20068,5.02542e+18,1403.76,7018.7,38346,543,431,33723,29488,17290,17519,21184
27971,294,1340,0,27971,9865,18106,9.86765e+15,1036.88,4724.84,27971,398,337,23192,21106,9917,7573,8723
49232,895,1910,0,49232,17434,31798,9.74053e+15,1300.57,6987.09,49232,583,403,44519,40697,26798,19105,30909
17915,1286,1996,9377,8538,0,17915,5.04247e+18,1057.83,4613.51,17915,390,309,15547,14068,10602,9890,12216
16673,35,43,15838,835,16305,368,1.02154e+14,34.2577,582.432,16673,37,35,16614,16580,15803,15871,15184
26007,1619,1704,0,26007,9194,16813,9.47488e+15,1031.94,4821.46,26007,463,310,24303,24303,24180,24124,24290
8813,276,345,0,8813,8380,433,2.56327e+16,121.76,1177.47,8813,75,81,8468,8418,8193,8079,7874
7763,907,1473,0,7763,2757,5006,9.5532e+15,199.72,2538.11,7763,251,216,6290,6242,5032,5057,5181
34123,122,1764,12134,21989,0,34123,3.72226e+13,1066.64,5491.74,34123,514,337,26850,23763,11569,7993,2861
29744,218,2291,15919,13825,15919,13825,4.94e+18,1326.15,6131.49,29744,496,365,22365,19245,8146,9076,1786
17002,974,1938,0,17002,0,17002,2.49263e+18,1055.43,4486.42,17002,351,308,14381,12968,8734,7641,8741
775,50,274,249,526,0,775,3.94153e+13,55.9419,421.945,775,84,70,434,320,216,124,80
48016,617,2273,24269,23747,24269,23747,4.96591e+18,1435.44,7844.4,48016,612,466,39879,34913,16587,17686,16540
19777,143,2326,19777,0,16335,3442,2.98379e+18,1395.36,5478.23,19777,382,337,12416,8128,5554,4598,397
42739,14,355,0,42739,40770,1969,2.53152e+16,302.181,2629.99,42739,142,152,36248,32759,26392,23754,14469
48606,958,2568,25455,23151,0,48606,5.00386e+18,1546.75,8090.39,48606,636,442,42245,37381,20231,20417,22302
27461,324,349,0,27461,26116,1345,2.57756e+16,269.377,2110.75,27461,123,130,27074,26524,26419,26444,26535
29463,244,765,28868,595,29463,0,4.59201e+18,501.95,3384.73,29463,244,218,27394,25595,13926,13895,11242
44269,72,358,0,44269,42188,2081,2.54169e+16,308.503,2690.65,44269,143,153,42200,41284,32386,27835,19275
4038,488,536,3984,54,4038,0,4.54587e+18,200.746,1200.28,4038,122,102,3502,3501,3465,3469,3443
8520,878,1998,7029,1491,4446,4074,7.64781e+17,552.696,3364.47,8520,235,213,6522,5825,4922,4852,3705
33107,1198,1613,11708,21399,0,33107,3.7483e+13,1078.99,5353.94,33107,470,340,31094,27890,23828,24967,27858
29494,629,2185,15701,13793,15701,13793,4.95825e+18,1299.8,6021.82,29494,505,363,24480,21696,12121,12716,11153
42043,556,2421,22385,19658,0,42043,5.02965e+18,1418.18,7337.83,42043,589,424,34761,30850,14886,15636,12557
6496,35,43,6187,309,6345,151,9.98338e+13,23.9597,366.745,6496,30,29,6452,6441,6171,6169,6024
42859,607,1756,20278,22581,20278,22581,4.99923e+18,1453.83,6993.06,42859,523,436,35249,30331,14329,13672,15176
41973,13,43,40026,1947,40804,1169,9.83653e+13,39.0754,925.824,41973,42,40,40704,39892,32666,32293,23442
34293,1170,1815,0,34293,12052,22241,9.58309e+15,1229.91,5791.72,34293,515,355,31674,28603,22136,16778,24033
17294,1779,2293,0,17294,0,17294,2.47456e+18,877.013,4756.15,17294,418,299,15001,14189,12727,11856,13330
16924,24,43,16223,701,16293,631,9.44518e+13,34.5322,576.67,16924,36,33,16797,16706,15195,15188,13142
49325,2302,2504,49325,0,40519,8806,3.04774e+18,1816.12,8749.34,49325,664,483,46821,46819,46541,46560,46718
35381,31,43,33614,1767,34587,794,1.01266e+14,40.0387,852.856,35381,43,39,35237,35130,32271,32184,29615
25394,1032,1701,9005,16389,0,25394,3.70455e+13,1023.27,4757.81,25394,457,310,23020,21089,16363,16029,15718
28026,1558,2267,14696,13330,14696,13330,4.8714e+18,1313.47,5961.48,28026,526,363,25511,22453,18507,17784,21163
29511,192,356,0,29511,28082,1429,2.55698e+16,287.236,2197.35,29511,127,134,28697,28136,25291,23019,20353
25890,413,1865,12778,13112,0,25890,5.10791e+18,1275.76,5533.82,25890,416,369,20475,18025,7576,6840,7565
33347,934,2363,17290,16057,0,33347,4.97765e+18,1384.84,6594.46,33347,536,387,28762,25592,14674,14093,15541
8996,436,1847,4960,4036,4960,4036,4.95467e+18,361.782,3139.04,8996,273,178,7040,6504,3471,3381,2440
16943,2328,3450,474,16469,0,16943,1.92295e+18,475.849,5934.81,16943,390,359,13493,13470,12941,12927,12021
41056,3677,7706,5390,35666,0,41056,1.38986e+18,626.3,13158.5,41056,805,621,33350,33210,23449,23345,17321
16556,664,2143,16556,0,13357,3199,2.96162e+18,1259.28,4930.14,16556,363,323,12503,10682,7062,6363,6364
35256,747,1857,12336,22920,0,35256,3.78311e+13,1257.91,6012.15,35256,542,369,30598,28166,15623,15828,19684
31178,83,343,0,31178,29389,1789,2.74775e+16,289.351,2289.77,31178,138,147,29581,28847,21762,18945,14411
35169,2021,2684,29187,5982,18114,17055,7.42256e+17,1721.4,7487.08,35169,596,411,32418,27158,27782,27161,27680
42043,810,2310,22305,19738,0,42043,5.0402e+18,1465.73,7276.33,42043,561,429,36023,32177,17410,18006,17807
34493,1620,1736,0,34493,0,34493,2.54107e+18,1374.3,6229.5,34493,478,410,32689,28009,29871,27691,31640
29488,1070,2591,29488,0,23871,5617,2.96273e+18,1649.02,7037.22,29488,534,398,24143,20558,16307,15086,14967
19690,1624,2002,10545,9145,10545,9145,4.93511e+18,1126.13,4806.28,19690,428,302,17616,15820,14403,13923,15365
20156,19,1669,0,20156,7086,13070,9.82854e+15,1015.92,4427.2,20156,390,314,9743,6343,3627,2541,935
19412,2082,2492,16182,3230,10070,9342,7.31574e+17,1335.99,5500.94,19412,446,333,16920,14790,15318,14970,15977
22451,879,2496,22451,0,18715,3736,3.32574e+18,1443.53,5867.95,22451,488,352,17929,15411,12330,11422,9700
34189,239,1712,12101,22088,0,34189,3.69985e+13,1067.77,5443.49,34189,518,342,28419,26298,12232,9157,9562
8836,280,683,8526,310,8836,0,4.54832e+18,268.617,1815.5,8836,162,129,8075,7717,5910,5805,4631
40291,1097,2749,33557,6734,21162,19129,7.30056e+17,1696.66,7962.78,40291,634,436,34032,29306,25512,24593,21299
43394,369,2473,43394,0,35406,7988,3.12961e+18,1736.58,8199.52,43394,561,471,31563,27305,13690,11348,7855
1681,185,352,1631,50,1681,0,4.92555e+18,110.407,677.527,1681,66,66,1329,1236,1095,1121,974
39140,136,353,0,39140,37296,1844,2.53252e+16,294.98,2513.41,39140,136,147,37901,37223,31841,27705,22186
9607,32,643,9602,5,9607,0,4.59843e+18,280.065,1899.46,9607,168,146,5131,2468,1655,1594,606
45126,1731,1760,0,45126,0,45126,2.529e+18,1451.7,7156.91,45126,538,445,43366,43366,43280,43047,43311
10401,478,1320,3652,6749,0,10401,3.82694e+13,577.338,2847.55,10401,270,233,8661,8090,4525,3956,4822
44115,1233,2501,23186,20929,23186,20929,4.899e+18,1468.82,7618.13,44115,639,416,39686,34916,22512,23167,26205
1182,377,385,476,706,476,706,4.26692e+18,83.1311,609.201,1182,96,86,797,797,796,790,792
3987,713,1511,3987,0,3154,833,3.37712e+18,210.144,2142.14,3987,190,175,2476,2339,2078,2065,1644
27913,1289,2549,23388,4525,14829,13084,7.11686e+17,1505.38,6497.26,27913,526,371,23950,20819,18863,18720,16986
1281,284,408,0,1281,427,854,8.10118e+15,49.662,605.037,1281,106,68,873,868,820,818,824
16418,272,1919,8377,8041,8377,8041,4.97188e+18,1076.69,4436.57,16418,353,303,12345,10686,4110,4198,2157
8234,239,348,0,8234,7874,360,2.46085e+16,72.73,1129.43,8234,79,82,7886,7856,7479,7467,6632
5566,1097,1137,0,5566,1969,3597,9.25222e+15,140.409,1933.07,5566,210,133,4429,4429,4420,4399,4396
44808,717,2591,44808,0,36810,7998,3.14952e+18,1731.78,8362.58,44808,596,463,35798,30249,19130,17252,14618
1570,112,451,0,1570,607,963,1.07194e+16,35.4376,706.987,1570,100,88,1119,1061,798,320,265
48233,54,1395,17001,31232,0,48233,3.85455e+13,1134.8,6268.86,48233,501,400,32224,24935,11579,3923,3713
33286,1009,2194,17187,16099,0,33286,5.05473e+18,1400.6,6468.85,33286,515,399,29023,25767,15200,14130,17227
49412,1151,2418,23606,25806,23606,25806,4.98304e+18,1623.73,8365.84,49412,629,462,43489,38556,21302,21550,29434
23801,1355,1465,8476,15325,0,23801,3.83404e+13,968.671,4451.48,23801,374,315,22336,21266,21165,21133,21986
6714,92,1465,0,6714,0,6714,2.52002e+18,259.794,2493.17,6714,278,198,4424,3331,1942,766,486
4216,763,1455,3380,836,1977,2239,8.06518e+17,205.961,2158.51,4216,177,155,2761,2587,2181,2191,1829
28697,1035,1787,10219,18478,0,28697,3.74415e+13,1023.67,5116.61,28697,455,322,26296,23939,17978,17832,17526
39701,191,712,39091,610,39701,0,4.66285e+18,526.058,3871.43,39701,271,238,36083,32136,16707,17397,13157
4985,20,43,4764,221,4828,157,9.88695e+13,27.8656,325.011,4985,30,26,4902,4862,4341,4307,3730
34379,648,2814,28747,5632,18100,16279,7.23641e+17,1645.92,7449.11,34379,614,411,27028,23404,16078,16250,8017
8078,218,1403,2866,5212,0,8078,3.73088e+13,286.538,2532.78,8078,274,168,6483,6063,3160,2645,1745
22352,7,42,21253,1099,21868,484,1.01826e+14,36.4536,667.925,22352,38,36,20418,19144,15763,15742,10250
39335,1304,1884,13978,25357,0,39335,3.72071e+13,1133.95,6033.05,39335,555,358,37202,33385,28076,28215,33999
13985,977,1996,7546,6439,0,13985,5.08599e+18,862.362,4074.85,13985,363,279,11567,10708,7705,7139,6880
16627,31,43,15843,784,16177,450,9.83735e+13,38.9997,587.589,16627,37,35,16538,16496,15251,15249,13607
48096,134,630,47639,457,48096,0,4.74115e+18,512.258,4161.51,48096,267,260,41250,32500,17346,17493,10547
48633,1182,2884,48633,0,40549,8084,3.31626e+18,1786.62,8861.76,48633,725,480,41693,35697,33505,32029,27291
35366,719,1330,0,35366,12532,22834,9.94187e+15,1082.72,5299.47,35366,430,373,31663,28758,19517,14329,20258
9345,1243,1518,3340,6005,0,9345,3.66935e+13,451.647,2830.15,9345,293,199,7827,7586,7109,7105,7272
4653,222,506,4602,51,4653,0,4.64303e+18,204.588,1251.05,4653,114,103,4103,3823,2624,2568,2199
28163,296,352,0,28163,26890,1273,2.48645e+16,260.212,2098.11,28163,121,128,27713,27216,26364,25152,25872
16164,21,43,15361,803,15762,402,9.99201e+13,38.4524,576.394,16164,37,33,15970,15819,13516,13436,10754
41039,1661,1825,0,41039,14517,26522,9.4667e+15,1130.95,6106.15,41039,586,369,39214,39214,37502,37061,38866
7852,47,2153,7852,0,6568,1284,3.29973e+18,302.386,3329.02,7852,280,211,3895,2541,1712,1796,793
19577,1593,2060,0,19577,0,19577,2.51043e+18,1284.17,5099.8,19577,422,337,17262,15178,12599,11769,14675
39843,299,1349,0,39843,14135,25708,9.95334e+15,1110.75,5652.31,39843,466,385,33229,30168,14424,10474,11398
24574,85,359,0,24574,23381,1193,2.54053e+16,269.037,2013.96,24574,117,124,23497,23041,18563,16383,12099
10551,41,43,9959,592,10436,115,1.07004e+14,32.7501,470.348,10551,35,33,10507,10502,10484,10482,10367
19508,452,2068,10322,9186,10322,9186,4.84639e+18,1056.35,4800.61,19508,450,311,15675,14180,6220,7009,4622
46857,1309,1788,22324,24533,0,46857,5.164e+18,1484.81,7368.95,46857,544,454,43052,36937,28716,25416,35191
11684,1945,1966,6020,5664,6020,5664,4.77709e+18,719.628,3712.33,11684,340,239,9718,9718,9705,9697,9718
41227,239,858,40171,1056,41227,0,4.61134e+18,610.379,4101.09,41227,287,234,38145,35448,20309,18618,12033
17311,1271,1402,0,17311,6164,11147,9.84178e+15,848.618,3746.42,17311,325,283,15856,14519,14435,13122,15196
17011,19,355,0,17011,16037,974,2.73642e+16,250.35,1709.76,17011,108,117,14446,12975,9862,8492,4852
23577,1638,2102,11257,12320,11257,12320,4.99834e+18,1360.33,5603.63,23577,442,362,21061,18509,15556,14414,18608
25742,41,43,24507,1235,25100,642,9.91212e+13,37.663,723.582,25742,40,37,25695,25679,25636,25635,25042
7175,992,1739,0,7175,0,7175,2.46088e+18,277.421,2802.91,7175,279,194,5436,5359,4345,4336,3368
32186,1856,2255,16786,15400,16786,15400,4.89729e+18,1365.2,6378.75,32186,523,382,29931,29803,24701,23995,27428
2142,445,715,1091,1051,1091,1051,5.26987e+18,128.099,1093.14,2142,103,103,1427,1400,1335,1318,1232
19594,54,2315,16126,3468,9943,9651,7.63374e+17,1358.26,5411.95,19594,406,338,9841,5990,3847,4143,377
8479,1798,2130,7096,1383,4458,4021,7.14474e+17,522.413,3450.32,8479,273,227,6349,6175,6017,5896,5752
45173,2031,2114,22277,22896,22277,22896,4.93892e+18,1472.45,7502.23,45173,562,444,43059,43059,42920,42807,42888
42847,399,619,42400,447,42847,0,4.74153e+18,486.247,3892.48,42847,256,249,41472,40137,34151,33993,30211
6144,40,42,5850,294,6003,141,1.01843e+14,24.2941,353.327,6144,29,29,6102,6101,6089,6090,6075
30719,1012,2605,30719,0,25669,5050,3.06567e+18,1612.77,6936.12,30719,507,391,25217,22082,16613,15878,11366
43818,247,2673,43818,0,36046,7772,3.05405e+18,1683.3,8369.23,43818,606,478,30329,25385,13479,11836,4682
49164,1001,2170,24468,24696,24468,24696,4.9746e+18,1467.24,7852.49,49164,568,461,43149,37882,22099,22812,26991
3850,271,1086,0,3850,0,3850,2.53244e+18,157.785,1686.07,3850,168,153,2764,2443,1233,1050,1064
23603,4875,5220,11872,11731,10014,13589,3.68521e+18,545.053,8608.25,23603,975,334,18383,18383,18337,16348,17175
6847,959,1277,0,6847,2453,4394,9.71052e+15,193.441,2249.31,6847,243,146,5570,5547,5297,4162,3879
8125,34,43,7741,384,7899,226,9.84559e+13,29.45,406.243,8125,32,31,8076,8057,7754,7778,7506
44760,742,1360,0,44760,15824,28936,9.87756e+15,1122.44,5991.25,44760,481,395,40252,36532,24677,18203,27616
49149,109,3256,49149,0,41343,7806,3.19136e+18,1725.9,9213.8,49149,677,515,30329,21253,14551,12440,2108
41459,42,43,39589,1870,40205,1254,9.75549e+13,39.6958,920.541,41459,43,40,41411,41387,41306,41305,40815
39478,1673,2814,39478,0,33058,6420,3.27865e+18,1660.34,7935.83,39478,652,444,35443,30265,33171,30701,28451
8987,295,1459,0,8987,3201,5786,9.42362e+15,202.384,2602.5,8987,235,172,7467,7092,4253,3214,3504
15297,53,843,14897,400,15297,0,4.50392e+18,420.082,2576.09,15297,251,174,10222,6493,4046,3870,1527
12387,680,2130,12387,0,10009,2378,3.09502e+18,1027.07,4243.06,12387,336,301,9283,8118,5384,5058,4757
15668,299,347,0,15668,14948,720,2.51568e+16,207.355,1573.29,15668,103,111,15277,15073,14656,14221,13829
49513,2669,2907,49513,0,41146,8367,3.29588e+18,1803.82,8977.08,49513,713,469,46606,46606,46338,46349,46036
45232,1029,2445,45232,0,36855,8377,3.1287e+18,1730.23,8323.59,45232,587,475,37852,32143,24351,22984,23302
7588,253,2080,7588,0,6017,1571,2.93852e+18,539.673,3324.49,7588,248,206,4929,4088,1945,1668,1351
20668,223,351,0,20668,19625,1043,2.59461e+16,268.55,1853.38,20668,108,114,20082,19728,18072,16826,15034
19167,398,2059,19167,0,15329,3838,2.96467e+18,1387.78,5241.76,19167,377,341,13755,11773,5756,4851,4524
22457,475,854,21824,633,22457,0,4.53799e+18,452.847,3017.07,22457,231,189,21454,20870,17616,17629,15991
18173,728,2457,18173,0,15461,2712,3.35045e+18,1136.21,5159.26,18173,430,328,14354,12686,9778,8498,6695
3888,70,1377,3047,841,1777,2111,9.09728e+17,174.851,1954.05,3888,179,138,1798,979,614,623,262
5076,1236,1567,3966,1110,2342,2734,9.07832e+17,207.46,2351.62,5076,187,168,3509,3488,3257,3140,3050
13296,1349,2245,13296,0,10801,2495,2.93318e+18,1071.75,4460.88,13296,335,315,10633,9526,9651,9324,7904
34242,646,1707,12186,22056,0,34242,3.75122e+13,1095.1,5471.98,34242,497,352,30224,27831,18029,15872,15041
33850,118,348,0,33850,32139,1711,2.62026e+16,292.319,2366.52,33850,132,146,32593,31964,26246,22612,17681
22651,1519,2068,22651,0,18111,4540,3.00307e+18,1476.35,5688.85,22651,411,360,19737,16694,18858,18377,17264
8233,886,1344,2896,5337,0,8233,3.7425e+13,400.59,2557.79,8233,262,174,6889,6620,5494,5811,5204
31131,773,1450,0,31131,11075,20056,9.89535e+15,1067.37,5096.04,31131,450,347,27963,25492,17537,13096,19070
17027,249,655,16889,138,17027,0,4.78138e+18,427.328,2519.48,17027,182,180,15801,14810,9117,8992,7439
38479,163,1347,13594,24885,0,38479,3.86676e+13,1092.35,5545.5,38479,466,381,30466,27577,10847,7049,7493
32971,2151,2361,17110,15861,0,32971,4.98056e+18,1391.44,6555.18,32971,536,386,30610,30610,29722,29558,30077
18868,2,43,17900,968,18492,376,1.02891e+14,36.0979,622.9,18868,38,36,11383,9213,8739,9297,6750
35409,302,353,0,35409,33800,1609,2.50185e+16,280.398,2376.78,35409,131,141,34928,34239,33220,31633,31506
29093,519,2215,15487,13606,0,29093,5.04584e+18,1318.58,6023.27,29093,479,363,23711,21153,9848,10499,7789
12052,185,573,11925,127,12052,0,4.74798e+18,368.785,2057.39,12052,163,162,10816,9626,5790,5874,4421
48515,153,1897,23475,25040,0,48515,5.13117e+18,1497.14,7609.25,48515,565,461,33732,24350,9633,7258,5023
44501,1336,1805,15761,28740,0,44501,3.75564e+13,1140.54,6332.87,44501,566,382,42612,38023,32539,31434,40770
28674,2127,2317,0,28674,0,28674,2.40305e+18,1307.4,6041.95,28674,501,360,26357,26354,25598,25510,25573
34045,777,1737,16141,17904,16141,17904,5.00682e+18,1404.42,6223.4,34045,471,404,28710,25183,13982,12820,15644
20239,576,829,19723,516,20239,0,4.5658e+18,434.192,2886.72,20239,268,190,19410,19017,17595,17495,16614
40975,20,43,39072,1903,39843,1132,9.85767e+13,39.8308,914.475,40975,42,40,40466,40075,34595,34241,26628
21608,14,43,20358,1250,21414,194,1.06517e+14,39.4504,680.013,21608,41,38,20901,20375,16624,16017,11929
9600,1270,1837,5047,4553,5047,4553,5.02066e+18,567.639,3293.44,9600,287,258,7763,7338,6263,5909,6566
10319,1066,1834,0,10319,0,10319,2.39411e+18,665.492,3425.38,10319,344,230,8485,7853,5949,5471,5236
49951,1049,2645,0,49951,0,49951,2.47658e+18,1431.4,8287.26,49951,585,453,44149,39577,21714,21494,27328
16364,1052,2356,13704,2660,8608,7756,7.11893e+17,1183.08,4939.95,16364,397,307,13135,11651,9641,9540,8078
44622,3639,8408,29328,15294,10572,34050,2.84202e+18,770.101,14699.6,44622,848,631,36214,36182,21673,20900,15879
24844,139,1902,12503,12341,0,24844,5.09719e+18,1303.98,5438.18,24844,412,352,17158,12718,5734,4560,2457
42467,1179,2117,21104,21363,0,42467,5.05949e+18,1450.55,7284.74,42467,549,439,37981,33174,22288,19356,26300
1421,379,440,928,493,0,1421,5.5998e+18,34.955,652.94,1421,88,73,981,981,980,980,452
33906,1557,2004,0,33906,0,33906,2.50031e+18,1389.31,6420.92,33906,482,409,31600,27223,23459,21618,27738
42379,21,43,40096,2283,41743,636,1.04118e+14,40.1239,943.548,42379,43,42,41842,41394,35232,34970,29434
27281,880,1720,12919,14362,0,27281,5.10692e+18,1327.7,5546.91,27281,438,377,23301,20464,12606,10807,15522
15445,820,1871,7852,7593,7852,7593,4.96366e+18,987.46,4244.74,15445,339,303,12771,11556,6895,7136,7460
17635,3,43,16796,839,17212,423,1.00683e+14,38.241,607.129,17635,39,36,12889,11062,10230,10156,6957
21983,722,1678,0,21983,7847,14136,9.47345e+15,943.623,4376.66,21983,432,295,19244,17855,12481,8950,13022
41031,404,2375,21649,19382,21649,19382,4.94133e+18,1453.52,7253.15,41031,593,420,32886,29288,12597,13380,9264
20088,875,1439,0,20088,7105,12983,9.68484e+15,911.882,4082.85,20088,364,298,17880,16522,12326,9852,13299
21155,1378,1552,7506,13649,0,21155,3.68776e+13,927.077,4173.47,21155,431,282,19582,18044,17383,17184,18572
14332,741,1713,6935,7397,6935,7397,5.05869e+18,991.886,4013.3,14332,321,293,11746,10430,6044,6089,7309
6034,1334,1584,2859,3175,0,6034,4.99148e+18,265.519,2535.87,6034,215,176,4450,4433,4058,4041,4025
18845,147,354,0,18845,17934,911,2.57718e+16,229.616,1748.83,18845,108,113,18183,17884,15499,14040,11843
1887,291,723,0,1887,0,1887,2.53715e+18,115.487,1031.09,1887,131,117,1164,1050,442,358,553
23854,524,2209,23854,0,19518,4336,3.10289e+18,1469.49,5922.06,23854,458,377,18052,15487,9246,8314,6681
37988,328,578,37603,385,37988,0,4.73866e+18,496.998,3654.22,37988,241,241,36268,34884,25295,25504,23195
21580,341,356,0,21580,20573,1007,2.53839e+16,247.374,1869.83,21580,112,120,21213,20869,21050,20972,20879
21750,34,1907,0,21750,0,21750,2.47269e+18,1197.69,5077.78,21750,436,332,10597,6514,3518,2346,617
15132,1135,1524,5371,9761,0,15132,3.7312e+13,788.527,3588.81,15132,328,258,13402,12517,10883,11159,11763
22821,472,591,22613,208,22821,0,4.75774e+18,461.969,2840.13,22821,208,202,22069,21503,19920,19942,18739
18933,258,1915,9473,9460,9473,9460,4.92885e+18,1136.72,4741.3,18933,385,315,14278,12378,4859,5077,3575
33676,988,2109,26953,6723,15967,17709,8.40905e+17,1659.68,6981.32,33676,506,415,27750,23271,19001,18071,17103
17457,635,2345,14493,2964,9130,8327,7.40848e+17,1228.05,5061.74,17457,400,324,13495,11840,8520,8334,5520
21209,148,2424,17787,3422,11353,9856,7.11715e+17,1324.24,5580.75,21209,449,329,14072,9932,6730,7346,1847
24573,220,351,0,24573,23453,1120,2.50867e+16,257.089,1978.27,24573,119,127,23970,23547,21700,20244,18475
12754,1509,1999,0,12754,0,12754,2.39715e+18,787.676,3884.44,12754,346,242,10755,9932,8850,8849,9131
14221,1023,1702,6809,7412,0,14221,5.20711e+18,1040.92,4029.18,14221,310,284,11925,10680,7985,6904,8401
30181,92,355,0,30181,28799,1382,2.51454e+16,276.724,2209.43,30181,128,133,28948,28437,23057,20140,15915
11882,4,42,11284,598,11618,264,1.01248e+14,33.3904,484.527,11882,33,31,9519,8372,7459,7405,5024
27728,437,2809,23157,4571,14377,13351,7.24714e+17,1598.21,6820.5,27728,525,393,20777,17876,10476,11395,4722
14865,280,1524,0,14865,5292,9573,9.6145e+15,732.368,3521.3,14865,360,250,12307,11422,6083,3544,3528
31493,7,42,29690,1803,31173,320,1.06788e+14,39.3986,805.537,31493,41,40,28407,26370,21412,21401,13549
26449,609,2637,21670,4779,12659,13790,7.70487e+17,1656.21,6755.64,26449,551,387,19937,16333,10458,10990,8228
4736,1366,1665,4736,0,3807,929,3.27579e+18,225.394,2412.54,4736,194,189,3071,3064,3049,3050,2695
24175,253,802,23541,634,24175,0,4.60584e+18,510.192,3105.82,24175,280,197,22418,20960,13201,12930,10151
17478,291,2213,8788,8690,8788,8690,4.95251e+18,1117.06,4870.21,17478,423,308,13062,11191,4082,4177,1851
16362,942,2051,7937,8425,7937,8425,5.03748e+18,1076.84,4618.93,16362,398,307,13488,12339,7116,7019,8586
27859,2061,2108,13297,14562,0,27859,5.08477e+18,1433.21,6063.5,27859,473,379,25751,25751,25661,25460,25727
24181,1517,2150,12776,11405,0,24181,5.03672e+18,1227.37,5470.69,24181,468,339,21726,19291,15936,14693,17765
38835,1524,1676,0,38835,13760,25075,9.6659e+15,1115.81,5851.4,38835,497,365,37159,37159,36002,35495,36870
30777,7,43,29324,1453,29935,842,9.86908e+13,39.4331,788.238,30777,41,37,28274,26626,22085,22063,13958
24771,1108,1702,8800,15971,0,24771,3.71987e+13,1009.86,4705.45,24771,452,308,22555,20712,16395,16435,18467
34523,1017,2763,28751,5772,18023,16500,7.34577e+17,1647.2,7449.82,34523,604,414,28585,24763,21075,20093,13874
7443,312,614,7289,154,7443,0,4.52653e+18,246.713,1641.66,7443,152,126,6825,6596,5438,5403,4643
47126,1976,3059,39426,7700,24946,22180,7.1573e+17,1706.72,8789.87,47126,629,444,43953,36941,35984,35922,38683
47071,1011,1942,0,47071,16698,30373,9.53517e+15,1158.13,6598.08,47071,619,379,43395,39465,28310,21924,34034
4723,991,1114,1632,3091,0,4723,3.60898e+13,148.77,1830.11,4723,220,144,3609,3609,3462,3517,3435
27862,856,2344,22917,4945,14133,13729,7.65552e+17,1600.37,6471.03,27862,489,389,22333,19049,15026,14362,10799
42534,671,1828,15134,27400,0,42534,3.73115e+13,1137.41,6169.02,42534,565,367,37773,34657,22267,19829,23112
19903,1018,2347,16074,3829,9633,10270,8.31826e+17,1386.62,5527.63,19903,394,352,16327,13981,11173,10821,10502
9015,111,679,8739,276,9015,0,4.43996e+18,297.732,1836.99,9015,159,130,7377,5706,3406,3161,1979
17566,339,583,17396,170,17566,0,4.70063e+18,427.914,2489.75,17566,188,184,16644,16091,12587,12583,11073
11442,39,43,10834,608,11271,171,1.03911e+14,33.6468,484.767,11442,36,32,11396,11391,11345,11346,11142
15996,71,2230,13339,2657,8385,7611,7.26035e+17,1161.89,4804.07,15996,355,309,8767,5759,3866,4028,510
12960,234,378,0,12960,12250,710,2.74665e+16,206.445,1532.68,12960,102,96,12505,12319,11309,10602,10101
42624,68,1878,0,42624,15151,27473,9.58141e+15,1157.04,6246.79,42624,606,381,30959,25810,12965,6519,2105
2233,158,504,836,1397,0,2233,3.99082e+13,35.3036,830.961,2233,125,94,1729,1719,1398,1521,403
31061,638,2243,16302,14759,16302,14759,4.91513e+18,1366.82,6261.09,31061,532,386,25673,22727,12146,13213,10931
3730,166,815,1357,2373,0,3730,4.15857e+13,134.659,1409.36,3730,134,139,2881,2669,1491,1413,1095
40877,1580,2897,40877,0,34131,6746,3.28352e+18,1732.35,8203.43,40877,639,447,36303,30763,33421,30605,26282
47885,27,42,45748,2137,46449,1436,9.75187e+13,39.9706,966.8,47885,41,40,47644,47502,42983,43019,37658
28003,144,909,27168,835,28003,0,4.56612e+18,516.555,3421.76,28003,278,203,24378,20400,11738,11321,5809
26828,413,2153,0,26828,0,26828,2.47547e+18,1290.09,5760.03,26828,484,361,21423,19078,8987,6105,7116
6863,925,1311,0,6863,2473,4390,9.74042e+15,212.102,2291.57,6863,254,161,5552,5540,4885,4983,3678
25914,2285,2763,21299,4615,12164,13750,7.60987e+17,1731.3,6875.64,25914,563,368,23122,19283,20599,19800,21926
37462,271,353,0,37462,35697,1765,2.53074e+16,295.302,2466.78,37462,136,145,36812,36100,33799,32140,31037
5671,29,326,0,5671,5346,325,2.74584e+16,84.681,960.349,5671,72,68,5041,4705,3489,2917,1739
46230,221,2235,23388,22842,0,46230,5.04005e+18,1495.87,7657.04,46230,575,444,34315,29464,11099,9388,6894
15004,15,43,14176,828,14823,181,1.07195e+14,37.8498,570.793,15004,38,35,14563,14268,11552,11183,9303
49392,37,388,0,49392,46759,2633,2.72317e+16,329.895,3011.45,49392,160,169,45259,42682,31306,26454,16443
46002,508,610,45550,452,46002,0,4.7237e+18,516.901,4058.48,46002,259,256,45143,43846,41346,41506,40030
41434,707,1705,14582,26852,0,41434,3.87703e+13,1260.41,6299.56,41434,526,396,36362,33400,19493,17964,21175
44683,263,355,0,44683,42581,2102,2.54346e+16,308.727,2702.1,44683,143,155,43934,43070,40080,37691,36416
47357,2501,2925,47357,0,39574,7783,3.32416e+18,1769.02,8795.85,47357,724,472,44432,44432,43794,43961,43657
17666,620,654,17527,139,17666,0,4.77208e+18,411.76,2555.49,17666,216,185,17012,17011,16879,16899,16874
46578,11,43,44151,2427,45805,773,1.03391e+14,41.1082,983.593,46578,43,42,44495,42981,35232,34110,24258
11205,897,1517,3943,7262,0,11205,3.68713e+13,609.778,3088.09,11205,327,230,9688,9056,6882,7057,6802
44295,174,356,0,44295,42264,2031,2.5145e+16,299.345,2676.16,44295,146,154,43115,42235,37670,33330,29267
16180,39,43,15428,752,15744,436,9.93342e+13,33.4181,571.385,16180,37,35,16132,16117,15978,15976,15418
22714,108,1594,0,22714,8062,14652,9.55227e+15,994.645,4436.97,22714,420,300,17431,15052,7159,4292,3679
15600,50,2359,15600,0,13031,2569,3.28936e+18,1124.61,4835.01,15600,394,316,7857,5061,2980,2865,250
45091,913,1885,16025,29066,0,45091,3.73184e+13,1148.33,6419.64,45091,582,376,41230,37701,26062,26012,24683
38182,14,43,36215,1967,37470,712,1.03731e+14,41.2092,897.303,38182,43,41,37058,36222,29818,28868,20406
19624,912,1731,9352,10272,9352,10272,5.01507e+18,1182.99,4728.23,19624,368,334,16474,14657,9206,8664,10265
34070,184,352,0,34070,32239,1831,2.678e+16,296.663,2410.35,34070,139,144,33069,32347,28541,25437,23742
35161,30,43,33344,1817,34478,683,1.02428e+14,40.7957,852.003,35161,43,40,34991,34898,31521,31565,29069
36240,14,44,34266,1974,35774,466,1.06175e+14,41.174,881.482,36240,44,41,35130,34313,27551,26911,20570
46998,2070,2907,46998,0,39230,7768,3.30064e+18,1774.75,8745.8,46998,716,471,44053,36878,42114,41418,40104
29590,1700,1704,10510,19080,0,29590,3.73011e+13,1053.31,5124.24,29590,468,339,27886,27886,27872,27881,27884
28423,1116,2280,13416,15007,13416,15007,4.95003e+18,1488.55,6338.46,28423,532,370,24210,21586,12092,12482,16205
10110,469,1383,0,10110,3542,6568,9.43136e+15,469.929,2797.89,10110,293,192,8502,7979,5050,3810,4852
17308,1604,2064,8949,8359,8949,8359,4.8909e+18,1109.26,4634.26,17308,413,307,15157,13661,11815,11536,12987
43464,737,2152,21793,21671,21793,21671,4.94748e+18,1443.05,7350.82,43464,584,439,36792,32102,15984,17330,18367
25585,632,889,24816,769,25585,0,4.53493e+18,470.889,3236.58,25585,258,197,24696,24206,23385,23503,21607
42948,33,355,0,42948,40901,2047,2.54974e+16,308.394,2656.52,42948,143,153,39549,37411,28447,24591,15663
8834,75,1452,3151,5683,0,8834,3.69385e+13,208.726,2592.13,8834,231,174,6674,5788,3391,1809,2179
12353,564,1373,4407,7946,0,12353,3.87417e+13,705.768,3163.13,12353,283,250,10436,9719,6183,6039,5525
48572,962,2196,0,48572,0,48572,2.48572e+18,1473.9,7762.51,48572,585,447,42514,37565,21811,20302,25879
15981,808,2034,0,15981,0,15981,2.42975e+18,960.193,4359.72,15981,385,294,13133,12080,7698,7467,7303
21847,1596,2174,0,21847,0,21847,2.45718e+18,1156.88,5214.48,21847,431,320,19617,17470,14772,14095,15950
32888,246,356,0,32888,31024,1864,2.73328e+16,300.964,2400.29,32888,141,150,32103,31365,28601,26192,25581
15805,1135,2013,8288,7517,0,15805,5.00745e+18,976.293,4363.03,15805,375,292,13282,12246,8828,8044,9228
10273,40,43,9763,510,10062,211,1.01433e+14,33.0162,460.47,10273,35,32,10229,10226,10205,10202,10077
31844,196,357,0,31844,30292,1552,2.57669e+16,286.008,2295.17,31844,129,141,31010,30376,27345,24780,22869
7376,993,1280,0,7376,2590,4786,9.78986e+15,291.492,2371.74,7376,238,180,6096,5958,5478,5417,5460
34184,1267,2446,34184,0,27782,6402,3.01934e+18,1650.96,7312.99,34184,537,445,29085,24826,24367,23652,19346
38763,1462,1825,13755,25008,0,38763,3.72224e+13,1116.74,5932.68,38763,561,366,36938,36852,31857,32507,36056
17692,1317,1636,6304,11388,0,17692,3.68169e+13,726.495,3800.21,17692,394,257,16030,15056,13887,14075,14670
849,60,535,732,117,431,418,5.68827e+17,36.1684,638.819,849,89,83,313,154,81,74,16
17960,15,42,17031,929,17640,320,1.02905e+14,38.3185,605.386,17960,38,35,17505,17168,14221,13858,10971
5802,1357,1499,2725,3077,2725,3077,4.85798e+18,270.584,2414.74,5802,212,172,4303,4291,4244,4233,4169
11073,1693,2084,9047,2026,5507,5566,7.70129e+17,906.961,3943.2,11073,320,280,8989,8102,8045,7823,7814
12439,133,1861,0,12439,0,12439,2.54285e+18,866.201,3860.69,12439,307,282,8237,5710,2497,1455,1403
40263,640,2071,20397,19866,20397,19866,4.94857e+18,1451.27,7027.02,40263,545,415,33464,29278,14062,15415,14702
38165,494,1629,13489,24676,0,38165,3.78007e+13,1102.23,5743.36,38165,486,369,33020,30237,17589,12772,14508
11943,1209,1984,0,11943,0,11943,2.35522e+18,704.826,3746.07,11943,341,239,9959,9202,7316,6849,7255
7535,1592,1986,6072,1463,3662,3873,8.4112e+17,578.099,3240.71,7535,243,225,5549,5265,5049,4870,4713
14318,1056,1519,5100,9218,0,14318,3.74089e+13,705.174,3443.12,14318,328,249,12714,11875,10190,10073,9052
30218,54,352,0,30218,28773,1445,2.53364e+16,278.172,2210.13,30218,123,136,28581,27679,21364,18280,12206
19078,1441,1982,9790,9288,0,19078,5.03599e+18,1145.2,4785.04,19078,400,317,16856,15087,11944,10909,14108
23042,55,382,0,23042,21769,1273,2.72195e+16,273.748,2043.02,23042,128,131,21516,20655,15094,12814,8522
29199,1425,1548,10359,18840,0,29199,3.76937e+13,1046.22,4965.74,29199,498,326,27651,27606,26306,26205,27332
7050,231,340,0,7050,6727,323,2.51742e+16,76.6535,1055.37,7050,71,72,6710,6687,6446,6355,5915
38776,869,2133,0,38776,0,38776,2.48271e+18,1431.08,6955.08,38776,523,418,33353,29507,16365,15184,17999
21348,1993,2465,17719,3629,11015,10333,7.44673e+17,1451.15,5713.65,21348,463,341,18844,16267,16679,16206,16775
22148,418,1334,0,22148,7873,14275,9.96768e+15,980.117,4231.88,22148,357,310,18714,17008,9204,6970,8154
24383,642,1799,0,24383,0,24383,2.5075e+18,1257.29,5314.83,24383,413,346,20026,17513,8959,7987,9151
920,119,127,0,920,858,62,2.56902e+16,26.5315,279.788,920,30,31,793,793,792,793,769
23227,8,43,22138,1089,22594,633,9.87292e+13,38.4844,692.943,23227,39,37,21619,20592,16906,16688,11231
28986,3558,4187,28986,0,23014,5972,3.00264e+18,1146.41,8445.73,28986,444,501,24799,24779,24754,24776,23578
39717,33,43,37873,1844,38601,1116,9.84035e+13,41.484,903.891,39717,42,40,39587,39485,37006,37051,33562
43285,2081,2455,0,43285,0,43285,2.43305e+18,1484.74,7540.94,43285,617,431,40830,40829,36560,36270,39638
14006,101,350,0,14006,13364,642,2.4803e+16,187.241,1470.75,14006,91,92,13447,13241,11161,9962,7658
15609,33,43,14860,749,15198,411,9.95417e+13,36.6778,566.814,15609,37,33,15542,15508,14578,14599,13775
40042,101,356,0,40042,38234,1808,2.48699e+16,283.656,2525.76,40042,137,150,38564,37874,31147,26787,21497
3634,10,39,3524,110,3422,212,8.68285e+13,20.6646,256.403,3634,22,22,3494,3400,2816,2794,2457
44404,966,1898,0,44404,15757,28647,9.48708e+15,1155.45,6391.39,44404,604,375,40765,37149,26581,19943,32966
33376,589,2670,27982,5394,17798,15578,7.13383e+17,1579.09,7171.81,33376,578,391,26181,22796,15169,15579,9966
27057,91,356,0,27057,25760,1297,2.56278e+16,270.909,2109.44,27057,123,133,25901,25433,20273,17666,12087
18507,106,351,0,18507,17678,829,2.50394e+16,221.091,1702.96,18507,108,116,17798,17497,14723,12627,10512
19926,1259,2358,16750,3176,10741,9185,7.03509e+17,1313.19,5361.12,19926,442,326,16772,14728,13250,13153,12038
43365,667,2491,23287,20078,0,43365,5.02773e+18,1427.77,7480.5,43365,615,430,36450,32320,16495,17515,14834
7001,108,338,0,7001,6675,326,2.51137e+16,64.9,1045.13,7001,72,76,6663,6578,5661,5273,4511
37806,217,2642,0,37806,0,37806,2.42942e+18,1372.39,7223.02,37806,595,432,28310,24399,10383,5118,3530
20422,1340,1399,0,20422,7235,13187,9.81557e+15,946.06,4106.67,20422,373,298,19023,18184,18824,18173,18742
7732,1145,1443,0,7732,2731,5001,9.42404e+15,210.915,2494.54,7732,270,214,6289,6279,5657,5584,5602
18478,614,672,18133,345,18478,0,4.59136e+18,453.391,2627.91,18478,219,183,17806,17760,17244,17264,17094
48919,1312,1778,0,48919,0,48919,2.55239e+18,1467.87,7467.61,48919,538,458,45209,38722,30257,26983,36312
6608,20,39,6308,300,6398,210,9.43081e+13,28.7551,356.385,6608,31,29,6516,6461,5846,5826,5317
22797,333,2478,18995,3802,11949,10848,7.27061e+17,1435.9,5876.79,22797,502,358,16597,14354,8388,9137,3898
40988,1112,2316,0,40988,0,40988,2.42267e+18,1476.45,7220.89,40988,601,417,36349,32237,19837,18148,22870
12486,1330,1427,0,12486,4375,8111,9.59891e+15,679.461,3210.72,12486,301,228,11059,10398,10718,10276,10932
10488,1458,1792,5379,5109,5379,5109,5.07308e+18,687.494,3444.33,10488,292,268,8696,8171,7470,7074,8029
39315,1637,2328,39315,0,32019,7296,3.02749e+18,1764.19,7839.07,39315,527,445,35282,30240,32796,31399,29183
12694,36,348,0,12694,12012,682,2.68159e+16,211.301,1461.04,12694,101,100,11620,10965,8104,6885,4144
14418,182,349,0,14418,13743,675,2.55086e+16,208.993,1519.34,14418,100,101,13924,13708,12373,11508,9644
13976,8,43,13295,681,13646,330,9.98136e+13,35.2051,540.794,13976,36,35,12976,12350,10172,10090,6777
26962,1658,2175,14427,12535,14427,12535,4.96358e+18,1240.28,5740.74,26962,475,359,24747,21879,19454,18647,21647
31411,1774,2620,26245,5166,16515,14896,7.22294e+17,1607.18,6996.54,31411,570,390,28177,24099,23592,23330,22729
34257,362,2365,17898,16359,17898,16359,4.92622e+18,1386.35,6669.32,34257,538,396,27063,24300,9178,10070,4692
23931,155,2517,19584,4347,11531,12400,7.81245e+17,1578.78,6329.51,23931,473,378,14374,8864,6066,5995,2051
28829,144,1822,10304,18525,0,28829,3.75921e+13,1077.56,5175.29,28829,482,322,22833,20294,9707,6726,2100
24338,6,43,23154,1184,23749,589,1.01312e+14,37.3155,707.93,24338,39,38,21637,19903,16473,16659,10798
27291,1792,2244,0,27291,0,27291,2.40106e+18,1330.13,5883.35,27291,512,353,25047,22212,20840,20197,22354
30510,163,917,29668,842,30510,0,4.59946e+18,510.622,3562.46,30510,259,210,27123,23699,12675,12643,7350
867,142,254,311,556,0,867,3.99339e+13,75.7601,413.815,867,71,61,613,537,432,434,425
16944,34,43,16149,795,16505,439,9.93903e+13,39.257,595.284,16944,37,35,16873,16827,15944,15945,14655
11598,29,42,11025,573,11348,250,1.01737e+14,30.9674,472.727,11598,34,31,11534,11505,10792,10798,10066
33093,252,353,0,33093,31528,1565,2.53627e+16,286.811,2304.7,33093,131,134,32464,31864,29685,27891,27826
42051,1119,1716,14915,27136,0,42051,3.78147e+13,1122.05,6133.6,42051,504,382,39489,35447,27928,30379,33925
10126,115,1702,4939,5187,4939,5187,5.08772e+18,739.244,3351.55,10126,267,263,6427,4127,2011,1879,1056
41867,250,354,0,41867,39925,1942,2.53933e+16,304.253,2601.48,41867,143,152,41119,40324,37322,34929,32522
11178,660,685,10762,416,11178,0,4.43931e+18,333.942,2021.99,11178,206,142,10493,10493,10487,10485,10211
7886,819,1736,4007,3879,0,7886,5.1194e+18,414.252,2982.39,7886,252,240,6150,5759,3682,3402,3743
42665,383,2181,15080,27585,0,42665,3.78284e+13,1168.09,6764.18,42665,593,378,36079,32744,15421,14132,14734
32129,772,1814,11422,20707,0,32129,3.69519e+13,1094.81,5424.38,32129,520,331,28478,26285,17765,17188,13910
29419,157,1854,0,29419,0,29419,2.51255e+18,1335.57,5878.73,29419,466,388,20785,14988,6270,3315,3721
15581,1261,2351,13006,2575,8184,7397,7.25049e+17,1139.71,4808.1,15581,384,290,12559,11350,10163,10068,7632
26756,65,2194,0,26756,0,26756,2.40767e+18,1326.28,5810.05,26756,497,352,16192,11582,6216,2711,1339
24578,759,1644,8764,15814,0,24578,3.74798e+13,981.295,4615.51,24578,451,300,21723,20079,14259,13308,15262
33288,569,924,32690,598,33288,0,4.60376e+18,528.294,3807.09,33288,303,226,32226,31516,28240,27950,25028
40045,281,1876,14142,25903,0,40045,3.77761e+13,1265.17,6297.23,40045,592,369,33174,30025,12665,13041,8470
28895,29,46,27337,1558,28597,298,1.05275e+14,39.3691,808.491,28895,40,38,28751,28644,25522,25414,23382
49752,1415,2177,39839,9913,23652,26100,8.35457e+17,1752.13,8525.83,49752,576,480,44263,36518,35406,34377,34758
49895,623,2929,49895,0,41585,8310,3.28026e+18,1772.66,8988.49,49895,714,468,39493,34032,23278,20534,14958
41226,1444,2500,0,41226,0,41226,2.4291e+18,1417.89,7324.97,41226,613,411,37760,33173,24320,22409,28248
22308,960,1528,0,22308,7896,14412,9.73372e+15,950.502,4385.63,22308,369,305,20093,18371,13680,11681,15668
16802,255,2402,16802,0,14043,2759,3.29006e+18,1208.22,5021.79,16802,417,326,11762,10004,5780,4492,2308
43896,2552,2771,36718,7178,23256,20640,7.18844e+17,1733.37,8302.27,43896,628,439,41125,41125,40110,40006,40460
8891,399,1711,4524,4367,0,8891,5.21723e+18,622.165,3162.39,8891,264,249,6746,5967,3016,2619,2413
48059,1299,1775,22902,25157,0,48059,5.12153e+18,1460.38,7388.33,48059,543,453,44288,38026,29349,25898,37919
27840,456,2025,0,27840,0,27840,2.46761e+18,1313.56,5822.67,27840,459,366,22297,19782,8348,6500,6663
5875,946,1207,0,5875,2059,3816,9.46415e+15,156.899,2083.62,5875,224,186,4668,4664,4396,4347,4214
12702,61,348,0,12702,12158,544,2.49553e+16,171.371,1403.4,12702,97,92,12049,11782,9393,8547,6832
34344,1150,1471,12172,22172,0,34344,3.83159e+13,1091.66,5376.52,34344,455,359,32293,28788,24427,25068,28534
24300,12,594,24048,252,24300,0,4.75097e+18,470.631,2937.97,24300,209,207,7755,2296,2026,1954,669
22625,1404,2501,22625,0,18923,3702,3.34575e+18,1424.72,5892.62,22625,508,351,19095,16730,17675,16816,14971
16584,21,43,15654,930,16401,183,1.06911e+14,39.4144,603.036,16584,39,37,16342,16157,13709,13587,11547
47931,1547,1750,0,47931,16995,30936,9.67105e+15,1187,6561.3,47931,580,386,46181,46149,42933,41316,45477
23118,1001,2064,12167,10951,12167,10951,4.92553e+18,1259.41,5305.91,23118,452,330,19697,17879,11666,12240,11553
48031,1756,1919,0,48031,16993,31038,9.7575e+15,1194.38,6850.31,48031,628,397,46112,46108,45139,44623,45929
21798,1495,2220,0,21798,0,21798,2.4623e+18,1118.63,5218.64,21798,442,322,19424,17391,14110,12804,14749
26735,102,1953,13748,12987,13748,12987,4.97304e+18,1290.75,5629.59,26735,429,361,17579,12763,6350,6124,2049
20913,1,42,19719,1194,20712,201,1.06639e+14,36.6119,652.425,20913,38,36,6841,6841,6841,6841,6841
6318,298,1306,0,6318,2226,4092,9.51343e+15,169.192,2225.85,6318,220,163,5012,4756,2748,2091,1796
43873,546,754,43215,658,43873,0,4.61897e+18,539.619,4159.32,43873,291,248,42917,41640,36470,36199,34628
1870,420,533,718,1152,0,1870,4.23691e+18,99.8118,861.161,1870,111,110,1337,1336,1110,1132,1134
32837,897,2720,32837,0,27669,5168,3.30372e+18,1573.63,7156.26,32837,605,411,26848,23218,18643,17707,14416
38788,552,1699,13728,25060,0,38788,3.85441e+13,1131.87,5964.64,38788,461,386,33884,30743,16523,11998,17267
43613,627,2894,36529,7084,23156,20457,7.16697e+17,1702.95,8341.94,43613,674,434,34603,30031,20201,20590,14607
47937,2109,2624,25165,22772,0,47937,5.02778e+18,1502.93,8055.8,47937,623,443,45313,45255,39239,38413,44422
14071,597,2226,11742,2329,7451,6620,7.18859e+17,1007.63,4429.87,14071,359,294,10775,9638,6638,6757,4024
40106,1561,1930,0,40106,0,40106,2.50062e+18,1441.45,6947.85,40106,537,424,37790,32231,28674,27275,35102
31817,614,652,31556,261,31817,0,4.72581e+18,494.9,3423.53,31817,229,227,31165,31125,30882,30920,30939
5441,164,1125,1863,3578,0,5441,3.62198e+13,138.001,1934.69,5441,192,154,4244,3951,1857,1241,917
45294,2210,2899,37984,7310,24119,21175,7.09453e+17,1720.74,8492.76,45294,670,438,42395,42143,37759,36979,40615
22320,1320,2000,11525,10795,11525,10795,4.94054e+18,1244.88,5219.15,22320,420,325,19629,17518,13559,13082,14702
44175,1565,2485,23223,20952,0,44175,4.9896e+18,1472.53,7611.66,44175,619,419,41138,35653,27483,25095,31986
31239,48,353,0,31239,29817,1422,2.51057e+16,277.791,2239,31239,128,135,29454,28393,22032,19483,13417
1261,36,37,1189,72,1252,9,1.04912e+14,18.4528,166.364,1261,21,22,1224,1224,1221,1221,1219
10555,20,43,9930,625,10483,72,1.0563e+14,36.2513,474.65,10555,36,33,10380,10252,8689,8588,6872
40133,643,844,39076,1057,40133,0,4.58371e+18,591.339,4028.94,40133,313,236,39256,38243,37203,37228,35480
41359,17,43,39133,2226,40731,628,1.04188e+14,41.5536,936.387,41359,43,42,40490,39788,32860,32528,22630
7073,30,43,6744,329,6891,182,9.941e+13,30.7034,382.158,7073,30,30,7022,7005,6569,6546,5831
5177,88,1492,5177,0,4341,836,3.27921e+18,216.942,2285.6,5177,216,162,3226,2530,1543,1269,275
15432,975,1858,7637,7795,7637,7795,4.92207e+18,1003.84,4276.24,15432,347,296,12912,11742,7883,7454,8426
48631,630,1892,17203,31428,0,48631,3.70273e+13,1169.22,6671.48,48631,643,383,42982,39534,23759,18194,19527
21047,1694,1754,10300,10747,0,21047,5.14975e+18,1191.11,4904.16,21047,384,343,19293,19278,19156,18777,19263
43929,2323,2428,35576,8353,21485,22444,8.04244e+17,1715.45,8200.5,43929,594,458,41501,41501,40889,40674,41106
33131,1543,2602,0,33131,0,33131,2.43113e+18,1346.67,6756.78,33131,596,410,30148,26495,19335,17536,21890
48556,420,844,47595,961,48556,0,4.54535e+18,651.984,4521.92,48556,315,253,46582,44819,29322,28886,28036
18787,131,1608,8839,9948,0,18787,5.16758e+18,1134.94,4474.87,18787,362,325,12637,9025,3096,2387,1920
30466,2168,2633,30466,0,25432,5034,3.31412e+18,1598.64,6914.02,30466,575,395,27833,27671,27224,27313,26048
47191,896,2504,0,47191,0,47191,2.43872e+18,1483.41,7863.65,47191,641,437,40711,36300,18845,20078,22574
27976,1631,1673,0,27976,9946,18030,9.51284e+15,1009.16,4886.77,27976,481,313,26303,26303,26172,26167,26192
24945,1547,2178,13329,11616,0,24945,5.03545e+18,1263.16,5556.67,24945,451,338,22491,19973,16508,15037,17299
31609,1706,2243,0,31609,0,31609,2.42969e+18,1363.65,6310.57,31609,524,378,29311,25609,22641,20440,26397
34479,480,618,34158,321,34479,0,4.74687e+18,493.573,3519.64,34479,241,232,33587,32641,30630,30670,28334
28371,1250,2230,0,28371,0,28371,2.45824e+18,1315.29,5980.83,28371,486,365,25231,22345,15804,14344,16909
28289,847,1749,0,28289,0,28289,2.53094e+18,1330.45,5682.07,28289,441,381,24118,21111,12569,10259,15668
44513,127,1011,0,44513,42134,2379,2.56079e+16,242.307,4066.16,44513,173,185,42781,41923,32600,28468,19469
1014,254,301,0,1014,349,665,1.00924e+16,77.925,487.201,1014,91,85,713,704,679,649,685
4000,34,43,3824,176,3873,127,9.71092e+13,23.0732,292.177,4000,30,26,3955,3950,3880,3879,3792
17505,1001,1938,0,17505,0,17505,2.46417e+18,1114.95,4593.52,17505,385,310,14896,13301,8565,7930,9719
20418,270,2155,11215,9203,0,20418,5.03603e+18,1068.25,4945.06,20418,408,307,15801,13993,6850,6504,3338
39147,1794,1988,19858,19289,0,39147,5.11425e+18,1420.41,6856.12,39147,513,430,37159,36961,33915,33469,36417
13172,1,42,12527,645,12872,300,1.00179e+14,33.1685,506.434,13172,34,31,4688,4688,4688,4688,4688
23531,1138,2152,12591,10940,12591,10940,4.89456e+18,1266.61,5379.45,23531,467,326,20301,18420,12836,12478,14228
20691,419,2073,0,20691,0,20691,2.42141e+18,1224.42,5053.17,20691,448,326,16349,14597,6169,3892,4644
12150,1571,1734,0,12150,0,12150,2.52143e+18,833.687,3674.9,12150,286,275,10416,9572,9426,9198,10117
34129,149,348,0,34129,32319,1810,2.65142e+16,295.96,2398.71,34129,134,147,32981,32282,27440,23974,20681
3131,425,995,1660,1471,0,3131,5.13141e+18,172.502,1515.37,3131,185,165,2136,1965,1410,1369,952
48146,2344,2605,25177,22969,25177,22969,4.91209e+18,1502.21,8050.31,48146,640,441,45541,45541,43586,43468,44355
13016,31,42,12376,640,12712,304,1.01445e+14,31.6721,501.967,13016,35,32,12957,12927,12206,12186,11542
28635,1614,2172,15279,13356,15279,13356,4.94666e+18,1289.95,5913.67,28635,492,361,26352,23169,20130,19282,23401
28570,1890,2616,28570,0,23882,4688,3.34733e+18,1569.13,6680.68,28570,579,393,25696,21958,24541,23910,21721
3874,1117,1198,1741,2133,1741,2133,4.58473e+18,197.753,1830.81,3874,194,143,2676,2675,2655,2634,2633
16811,1480,2035,8791,8020,8791,8020,4.86505e+18,1032.57,4506.7,16811,422,301,14617,13242,10947,10692,11997
25336,1136,1323,8972,16364,0,25336,3.88323e+13,994.452,4484.01,25336,371,335,23684,21150,19276,18568,21726
28729,548,2123,28729,0,22965,5764,2.92974e+18,1585.86,6460.93,28729,437,397,21684,18198,9876,8564,8006
10132,2,43,9715,417,9756,376,9.43439e+13,26.1397,447.109,10132,33,32,6377,5269,5139,5355,4200
37556,35,1553,13339,24217,0,37556,3.80646e+13,1099.91,5666.41,37556,456,367,23294,17860,9499,3452,1875
26262,275,596,26006,256,26262,0,4.7209e+18,476.786,3060.71,26262,218,217,24698,23465,14712,14834,13322
17878,595,2495,17878,0,14837,3041,3.27187e+18,1272.27,5281.8,17878,442,304,13535,11814,7763,7222,3950
45328,1059,2152,22392,22936,0,45328,5.04067e+18,1466.31,7540.34,45328,562,440,40123,35205,21446,18669,26540
7535,229,1855,0,7535,3013,4522,9.12311e+15,262.321,2922.51,7535,706,177,5513,5046,2520,2332,1536
10280,1085,1479,3643,6637,0,10280,3.75307e+13,554.402,2955.78,10280,285,221,8801,8346,7008,6997,7643
30541,5,43,29017,1524,29918,623,1.02301e+14,39.8468,798.271,30541,41,39,25976,23317,19965,20206,13017
13041,989,1420,0,13041,4631,8410,9.58823e+15,688.022,3250.73,13041,307,257,11480,10733,9055,7814,9853
21346,40,43,20393,953,20718,628,9.80801e+13,37.8801,657.039,21346,39,36,21297,21284,21239,21238,20574
20614,1194,1351,7279,13335,0,20614,3.87008e+13,938.911,4073.33,20614,350,308,19121,17161,16525,16014,17931
40908,34,43,39048,1860,39691,1217,9.79331e+13,39.143,912.441,40908,42,40,40799,40697,38520,38543,34587
49965,554,612,49461,504,49965,0,4.7188e+18,524.443,4236.46,49965,270,258,49303,48223,47187,47237,47066
17266,1117,1946,8549,8717,8549,8717,4.85521e+18,1102.37,4568.11,17266,383,316,14767,13283,9493,9121,10535
11267,106,1791,0,11267,0,11267,2.4817e+18,748.031,3552.28,11267,310,259,7471,5590,2820,1266,940
19304,2084,2157,19304,0,15811,3493,3.0943e+18,1378.01,5306.56,19304,399,337,17147,16677,17075,17084,17115
39544,762,2261,0,39544,0,39544,2.46376e+18,1420.98,7045.1,39544,552,416,33588,29831,15469,15264,14612
2416,258,752,0,2416,844,1572,8.93393e+15,78.0981,1129.95,2416,182,104,1664,1610,1154,1029,1007
27683,631,1738,9766,17917,0,27683,3.67487e+13,1052.08,4989.79,27683,500,320,24119,22319,14077,12872,12728
40895,28,354,0,40895,38949,1946,2.5426e+16,296.212,2571.52,40895,138,150,37223,35070,26794,23332,14399
44268,8,42,42079,2189,43281,987,1.00985e+14,40.2568,940.335,44268,42,40,41181,39242,31945,31786,19815
2933,221,393,2808,125,2933,0,4.56226e+18,113.731,876.895,2933,100,80,2540,2461,2187,2266,1784
19675,406,1937,0,19675,0,19675,2.45359e+18,1159.77,4841.95,19675,403,323,15467,13792,5628,3968,4030
9683,1046,1429,3428,6255,0,9683,3.67947e+13,430.948,2752.17,9683,287,174,8254,7958,7002,7288,7082
9325,110,1392,0,9325,3273,6052,9.47919e+15,446.184,2724.73,9325,287,180,7142,6308,2990,2025,1103
40927,1349,2243,0,40927,0,40927,2.51845e+18,1556.46,7442.67,40927,567,438,36812,32285,23328,19375,29356
48798,92,913,47455,1343,48798,0,4.59407e+18,645.17,4486.4,48798,327,248,38507,28656,16843,15852,6571
25389,489,867,24750,639,25389,0,4.62773e+18,469.072,3218.84,25389,255,198,24377,23676,21135,21184,16798
35812,173,353,0,35812,34170,1642,2.5089e+16,282.943,2383.84,35812,132,143,34857,34166,30618,27447,25420
24297,2025,2448,24297,0,20364,3933,3.31153e+18,1494.06,6051.92,24297,503,367,21784,18758,21207,21201,19177
24331,1476,1704,0,24331,8649,15682,9.50103e+15,997.844,4676.56,24331,453,308,22627,22577,20798,20324,22295
26292,1272,2183,13477,12815,0,26292,4.93514e+18,1330.38,5768.48,26292,497,353,23264,20601,15150,13829,16403
26748,1642,2628,26748,0,22242,4506,3.33998e+18,1539.46,6518.34,26748,516,372,23437,19998,22579,20856,17460
25448,127,2066,13055,12393,13055,12393,4.85406e+18,1297.88,5550.66,25448,488,349,17781,13491,6438,6547,2190
11875,47,1679,5622,6253,5622,6253,4.96823e+18,843.772,3600.95,11875,295,279,5874,3399,1573,1997,417
1771,518,724,787,984,0,1771,4.74836e+18,84.4224,999.697,1771,116,92,1047,1035,1018,1015,961
43695,2024,2284,43695,0,35325,8370,3.04358e+18,1750.77,8114.86,43695,580,466,41410,38513,40314,40352,39815
29550,1226,1321,0,29550,10395,19155,9.87551e+15,1030.6,4830.7,29550,413,351,28117,24911,26054,24718,27294
19165,277,348,0,19165,18155,1010,2.64394e+16,252.126,1788.43,19165,110,115,18716,18368,17350,16493,16556
38005,94,2390,19952,18053,0,38005,4.98102e+18,1410.25,7003.52,38005,579,401,24920,18429,9638,6589,2984
12565,674,1692,5965,6600,0,12565,5.10913e+18,915.938,3761.3,12565,314,284,9974,8896,5343,4810,5847
24426,398,2291,19936,4490,12188,12238,7.91242e+17,1494.47,6034.52,24426,454,376,17891,15591,9224,9722,5617
46438,112,1889,16468,29970,0,46438,3.72088e+13,1166.62,6521.57,46438,608,376,36130,31491,15013,7241,5763
23034,764,2175,12140,10894,0,23034,5.02534e+18,1171.19,5361.97,23034,452,335,19160,17271,9959,9594,8408
28040,183,362,0,28040,26587,1453,2.62713e+16,292.08,2203.58,28040,125,137,27170,26591,23572,20911,17980
6630,251,333,0,6630,6316,314,2.55626e+16,74.9821,1023.4,6630,68,71,6297,6291,6126,6091,5808
11455,388,1517,4103,7352,0,11455,3.80688e+13,628.805,3142.61,11455,304,243,9435,8757,4775,4598,3206
32457,444,2374,32457,0,26099,6358,2.98391e+18,1608.61,7119.04,32457,484,421,23812,19904,10498,8713,8117
45463,513,1942,22100,23363,22100,23363,4.96271e+18,1459.88,7382.31,45463,558,441,36978,32286,13067,13230,13784
18329,311,780,17776,553,18329,0,4.52957e+18,433.152,2676.39,18329,250,176,17156,16413,11201,11076,9103
12665,1153,1460,4497,8168,0,12665,3.6957e+13,597.608,3141.49,12665,330,241,11205,10608,9362,9631,10083
1146,131,614,1146,0,878,268,3.21661e+18,42.0244,775.793,1146,88,82,532,471,224,281,109
36975,853,1796,13120,23855,0,36975,3.737e+13,1095.53,5756.04,36975,510,353,33411,30635,20942,19443,23933
15273,206,359,0,15273,14556,717,2.53073e+16,211.265,1580.81,15273,102,107,14777,14568,13475,12663,11401
49219,898,2859,41084,8135,25919,23300,7.25105e+17,1774.22,8856.83,49219,662,460,40651,34537,28343,26957,19255
20034,699,1610,0,20034,7085,12949,9.4703e+15,936.774,4171.81,20034,409,285,17441,16187,10684,7742,9440
42142,2783,4224,20191,21951,19926,22216,4.72145e+18,1187.26,9474.7,42142,1078,456,37918,37896,27027,21723,19666
42219,254,360,0,42219,40041,2178,2.62978e+16,305.22,2690.01,42219,148,155,41394,40522,37313,34505,34664
44254,37,43,42122,2132,43126,1128,9.99546e+13,40.9638,959.401,44254,43,41,44165,44102,42172,42179,40253
45425,1129,1897,16141,29284,0,45425,3.72547e+13,1156.05,6462.78,45425,589,377,42584,38391,28785,29017,34911
18019,36,43,17196,823,17566,453,9.8975e+13,37.0992,606.246,18019,37,35,17963,17942,17349,17375,17099
4678,1032,1333,4678,0,4012,666,3.20289e+18,196.177,2015.84,4678,190,158,3345,3319,3330,3246,3064
1794,12,25,1747,47,1691,103,9.05305e+13,14.524,156.288,1794,19,19,1748,1722,1484,1474,1276
22840,245,2422,19045,3795,12018,10822,7.28239e+17,1482.17,5848.37,22840,481,341,16038,13598,7633,8581,2908
16331,659,1479,5849,10482,0,16331,3.80891e+13,774.346,3670.68,16331,314,257,14205,13198,9241,8800,9292
41506,583,3070,33976,7530,19484,22022,7.78545e+17,1896.11,8859.91,41506,649,446,31137,25041,15061,16350,12217
27454,562,2607,22471,4983,13007,14447,7.73299e+17,1747.89,6890.66,27454,588,385,20446,16605,9979,10625,7799
43214,1568,2136,21778,21436,0,43214,5.06129e+18,1460.95,7331.25,43214,546,436,40676,34863,28209,25634,35117
18534,31,378,0,18534,17552,982,2.71373e+16,251.578,1829.47,18534,117,120,16722,15668,11555,10046,6367
47471,451,1570,0,47471,16843,30628,9.72293e+15,1157.79,6366.1,47471,519,393,40901,37295,20841,14391,17128
45890,1883,2521,0,45890,0,45890,2.48623e+18,1499.56,8007.29,45890,662,453,43344,42297,34300,31454,38326
27016,378,1660,9625,17391,0,27016,3.73545e+13,1000.2,4803.55,27016,464,314,23018,21176,12323,11247,8133
22665,1489,2051,11764,10901,11764,10901,4.93206e+18,1222.65,5251.17,22665,436,337,20256,18041,14874,14189,16581
31315,1569,2270,16565,14750,0,31315,5.00811e+18,1356.12,6282.62,31315,514,372,28761,25227,20174,18548,22935
1429,569,577,696,733,696,733,5.34888e+18,84.2379,832,1429,94,98,852,852,852,852,844
18173,1307,2025,9571,8602,9571,8602,4.94509e+18,1061.7,4653.75,18173,407,308,15799,14317,10939,10873,12404
13611,1400,2082,11010,2601,6688,6923,8.099e+17,1096.03,4418.4,13611,350,306,11027,9817,9184,9003,8825
35693,331,348,0,35693,33947,1746,2.58611e+16,289.605,2421.98,35693,137,145,35304,34550,34954,35172,34172
48764,1489,2479,25592,23172,0,48764,5.02974e+18,1499.65,7969.94,48764,648,446,45287,39324,28929,25979,37605
20219,1105,1328,7173,13046,0,20219,3.89136e+13,927.161,4017.97,20219,353,307,18560,16778,15138,13219,16839
45301,1433,1715,0,45301,0,45301,2.54142e+18,1412.31,7089.78,45301,527,445,42637,36265,31729,31139,39405
39690,523,2415,0,39690,0,39690,2.44196e+18,1411.53,7143.48,39690,579,410,32563,29054,12604,11542,10760
1723,48,142,0,1723,1612,111,2.71837e+16,42.2943,376.898,1723,43,42,1566,1513,1203,1111,895
9835,1775,2210,9835,0,8433,1402,3.36722e+18,493.588,3641.89,9835,304,222,7625,7347,7489,7433,6497
11377,135,1961,5787,5590,0,11377,4.84552e+18,727.942,3687.11,11377,340,238,7894,6227,2992,2609,1137
30597,636,1559,0,30597,10868,19729,9.69517e+15,1038.64,5087.32,30597,430,338,26968,24794,16113,11141,16879
34964,199,781,34531,433,34964,0,4.80579e+18,544.465,3800.23,34964,261,237,31501,27933,15734,15759,11186
11036,680,2200,11036,0,9343,1693,3.28916e+18,679.295,3851.57,11036,338,228,8481,7647,6090,5056,4371
14723,578,1723,7043,7680,0,14723,5.19265e+18,1068.86,4115.89,14723,322,292,11645,10130,5055,4315,5035
8709,835,1449,0,8709,3102,5607,9.4388e+15,206.122,2581.09,8709,235,171,7260,7118,5858,4476,5625
49207,2024,2961,41167,8040,26049,23158,7.18338e+17,1771.54,8910.87,49207,672,456,46160,38556,38384,37720,40060
36625,290,382,0,36625,34595,2030,2.73042e+16,315.574,2595.97,36625,146,152,35961,35136,32375,30116,29728
27810,2250,2617,27810,0,23115,4695,3.33309e+18,1596.85,6620.03,27810,555,373,25193,25026,24778,24842,24428
26610,913,1435,9398,17212,0,26610,3.81171e+13,1003.2,4694.57,26610,432,328,24113,22007,16553,14724,18396
16121,280,1411,0,16121,5779,10342,9.86862e+15,801.177,3624.99,16121,300,276,13341,12322,6675,4241,4423
41472,44,370,0,41472,39502,1970,2.52981e+16,300.643,2646.72,41472,136,151,38879,37228,28464,24539,15854
8015,1291,1816,4184,3831,4184,3831,4.89441e+18,337.087,3021.9,8015,297,219,6199,6103,4992,5227,4846
39878,1743,1886,19527,20351,19527,20351,5.00214e+18,1431.95,6881.91,39878,519,428,37992,37871,35467,35363,37600
3456,359,842,1247,2209,0,3456,4.16224e+13,125.295,1408.12,3456,182,135,2614,2510,2006,2210,1561
46790,1057,1775,0,46790,16448,30342,9.82564e+15,1293.16,6750.51,46790,582,406,42847,38617,27603,22262,31652
9344,1254,1824,4885,4459,0,9344,4.96778e+18,556.934,3242.76,9344,290,205,7520,7120,6000,5837,5555
15981,28,43,15240,741,15527,454,9.83166e+13,37.3226,573.019,15981,37,33,15877,15830,14459,14475,12463
24394,1206,2075,12325,12069,0,24394,5.01366e+18,1283.23,5502.89,24394,448,353,21411,18976,13584,12270,15735
27962,247,1353,0,27962,9886,18076,9.91322e+15,1032.84,4747.86,27962,405,340,22890,20972,9085,7150,7320
8382,462,1374,0,8382,2981,5401,9.67344e+15,267.419,2528.47,8382,234,174,7008,6641,4502,3297,3917
41915,328,2081,21006,20909,0,41915,5.04288e+18,1507.24,7226.49,41915,545,437,32544,28828,10675,9555,6870
12074,20,43,11450,624,11843,231,1.01713e+14,36.073,506.752,12074,36,35,11887,11758,10114,9989,8308
34382,712,1595,0,34382,12148,22234,9.95805e+15,1046.7,5510.81,34382,481,373,30642,27828,16849,12410,16726
21809,1230,2042,11661,10148,11661,10148,4.98683e+18,1147.39,5084.88,21809,433,321,19192,17275,13196,12939,13953
48492,1677,2629,25487,23005,0,48492,4.9738e+18,1522.55,8082.82,48492,693,444,45632,39423,30727,28173,37368
41620,335,1767,19897,21723,0,41620,5.16217e+18,1416.47,6868.7,41620,511,432,32238,28297,9206,7801,8549
49148,1225,2110,49148,0,39366,9782,3.02123e+18,1757.75,8416.1,49148,552,489,42381,35570,31619,29561,30221
14381,1266,1676,6914,7467,0,14381,5.14924e+18,984.538,3967.87,14381,320,298,12365,11167,9068,8312,10320
32932,1730,2444,16433,16499,16433,16499,4.90124e+18,1416.88,6818.3,32932,598,391,30329,26384,22001,20762,26261
37484,179,1605,13288,24196,0,37484,3.81446e+13,1098.83,5720.32,37484,469,370,30098,27357,12028,9279,6965
24656,2058,2106,13253,11403,13253,11403,4.93346e+18,1223.49,5449.84,24656,449,338,22550,22550,22442,22379,22549
13297,1648,2309,13297,0,10992,2305,3.30949e+18,1061.99,4488.31,13297,391,295,10982,9684,10455,10016,8749
19720,94,1731,9389,10331,9389,10331,5.01415e+18,1189.5,4741.73,19720,368,336,12036,7986,3442,3551,1430
47562,235,2493,25096,22466,25096,22466,4.92279e+18,1530.43,7895.75,47562,614,430,36110,31452,13107,14443,6596
42006,80,1350,0,42006,14846,27160,9.86552e+15,1111.87,5797.19,42006,490,387,30291,24699,10596,7809,4599
7728,1823,1826,4064,3664,0,7728,5.00184e+18,296.156,2969.25,7728,272,237,5902,5902,5902,5902,5902
7825,413,1288,2740,5085,0,7825,3.7666e+13,356.157,2449.76,7825,248,185,6453,6051,3679,2985,3419
12735,984,1348,0,12735,4498,8237,9.86885e+15,728.77,3216.8,12735,289,260,11123,10386,8614,7682,9731
37982,1317,2888,37982,0,31363,6619,3.2413e+18,1652.62,8077.41,37982,551,432,32475,28147,27610,26084,19210
19546,1161,2000,10604,8942,0,19546,5.0825e+18,1100.36,4777.32,19546,380,314,17008,15373,11774,10790,11980
33269,242,2132,16738,16531,0,33269,5.0141e+18,1385.8,6446.47,33269,504,392,24851,21498,7994,6323,3971
4508,787,1360,2084,2424,2084,2424,4.68373e+18,200.802,2080.51,4508,226,144,3148,3055,2326,2213,2446
11741,529,2295,11741,0,9664,2077,3.3578e+18,973.92,4204.33,11741,382,272,8584,7454,4853,4042,3018
36662,294,1792,0,36662,0,36662,2.52708e+18,1414.49,6512.46,36662,505,416,27698,23944,7433,5237,5464
20301,1186,2059,0,20301,0,20301,2.46847e+18,1078.56,4897.42,20301,404,317,17784,16037,12308,10661,12205
10841,568,670,10479,362,10841,0,4.35287e+18,321.74,1987.17,10841,168,137,10171,10055,9801,9787,9202
19881,1220,1528,7092,12789,0,19881,3.76685e+13,882.424,4020.22,19881,389,284,18181,16802,15225,15655,16660
27814,89,618,27496,318,27814,0,4.71891e+18,486.539,3173.04,27814,219,220,21087,14444,7847,7950,4319
35402,1472,2230,17555,17847,0,35402,5.11226e+18,1407.32,6856.63,35402,503,414,32420,28221,21904,19302,27607
48118,592,817,47595,523,48118,0,4.71101e+18,663.51,4568.77,48118,312,262,46874,45531,40960,40781,38318
29647,1779,1863,0,29647,0,29647,2.51158e+18,1342.49,5918.95,29647,468,390,27784,27784,27268,26177,27668
9785,172,1941,0,9785,0,9785,2.37865e+18,560.699,3429.29,9785,320,231,7020,5810,2695,1384,1409
24885,180,348,0,24885,23534,1351,2.66427e+16,281.009,2052.44,24885,121,127,24078,23565,20709,18516,15689
15768,1854,1866,7808,7960,0,15768,4.99549e+18,1024.7,4322.21,15768,355,297,13902,13902,13889,13888,13852
1227,66,211,1227,0,1198,29,3.40569e+18,24.1777,362.962,1227,79,31,1016,995,955,950,931
33785,1062,1968,16984,16801,0,33785,5.10678e+18,1358.68,6363.35,33785,481,400,29716,26423,17708,15221,20473
46405,4166,4655,15335,31070,0,46405,1.57873e+17,888.713,9879.5,46405,917,541,41750,41750,41502,36624,37021
8445,873,1746,4349,4096,0,8445,5.17685e+18,496.733,3083.66,8445,230,250,6699,6222,4308,3956,4180
30666,767,2112,15010,15656,0,30666,5.00908e+18,1325.34,6211.67,30666,471,386,25735,22839,12037,10964,14824
49678,1441,2072,17530,32148,0,49678,3.77891e+13,1257.68,7174.86,49678,640,393,47409,43907,34456,35968,43248
23320,148,2063,12231,11089,0,23320,5.00534e+18,1253.96,5324.66,23320,436,335,16735,12750,6334,4469,2140
48175,633,1375,0,48175,17007,31168,9.89008e+15,1138.68,6227.96,48175,495,398,42669,38800,23445,17838,24966
46475,173,2500,24413,22062,24413,22062,4.91643e+18,1489.77,7812.01,46475,641,431,34009,27629,12211,13316,4843
26696,1807,2364,13800,12896,13800,12896,4.85518e+18,1262.33,5938.49,26696,489,361,24332,21702,19846,19368,21551
16776,42,43,15925,851,16437,339,1.03574e+14,34.699,589.152,16776,37,35,16732,16724,16697,16696,16545
26376,544,1737,0,26376,9269,17107,9.60811e+15,1064.27,5051.28,26376,495,327,22581,20588,11455,8796,11927
4890,406,1309,4890,0,4243,647,3.13829e+18,207.388,2060.1,4890,141,152,3581,3383,2582,2248,1299
9767,877,1821,4920,4847,4920,4847,4.76691e+18,576.245,3302.29,9767,331,229,7946,7390,5126,4710,4242
20561,600,2492,20561,0,17102,3459,3.34615e+18,1367.89,5627.38,20561,475,343,15779,13746,9262,8035,6316
9490,946,2123,9490,0,7687,1803,3.08343e+18,757.651,3700.63,9490,283,252,7255,6404,5174,4866,4390
26317,796,1330,9280,17037,0,26317,3.84008e+13,1013.99,4578.57,26317,379,333,23579,21482,15429,15604,17279
20190,38,43,19148,1042,19851,339,1.03487e+14,38.6022,651.512,20190,40,37,20134,20110,19706,19707,19104
37664,2332,2366,19765,17899,0,37664,5.00232e+18,1432.05,6961.37,37664,567,400,35298,35298,35265,35251,35298
27802,1724,3881,0,27802,0,27802,2.35075e+18,812.092,7633.68,27802,406,489,23921,23592,16547,15211,15558
5283,65,1453,0,5283,0,5283,2.5092e+18,198.27,2290.2,5283,204,160,2931,1961,1083,562,162
10488,2169,2178,10488,0,8802,1686,3.04281e+18,756.303,3846.41,10488,288,250,8310,8310,8310,8310,8308
29267,3,43,27836,1431,28599,668,1.0059e+14,39.4279,780.041,29267,41,39,21193,18047,16615,16722,11985
46619,1133,2881,38890,7729,24457,22162,7.2665e+17,1756.33,8667.26,46619,685,450,39442,34106,29839,29055,21389
17360,1199,1667,6167,11193,0,17360,3.83754e+13,868.509,4084.98,17360,360,294,15392,14315,11777,12676,12773
11334,506,623,11187,147,11334,0,4.78981e+18,366.427,2045.24,11334,174,157,10711,10519,10278,10246,9917
14412,549,1310,0,14412,5057,9355,9.77068e+15,795.216,3369.42,14412,306,268,12332,11324,6908,5703,7317
39111,345,365,0,39111,37207,1904,2.58488e+16,308.2,2587.37,39111,145,150,38701,37899,38200,37855,38072
40786,1325,1877,14406,26380,0,40786,3.78556e+13,1265.07,6346.82,40786,589,368,38502,34364,27674,28662,33943
23636,142,348,0,23636,22472,1164,2.62001e+16,252.796,1969.07,23636,120,129,22830,22412,19285,17004,14863
35916,27,43,34047,1869,35281,635,1.03089e+14,39.9147,866.316,35916,42,41,35674,35524,31640,31701,27895
2593,282,962,2156,437,1376,1217,7.20148e+17,111.46,1407.21,2593,142,141,1631,1505,938,953,806
2858,863,1039,2372,486,1484,1374,7.20628e+17,128.013,1522.99,2858,153,148,1819,1817,1787,1790,1554
17713,259,588,17534,179,17713,0,4.70585e+18,437.542,2511.3,17713,181,185,16486,15598,10242,10257,8531
42262,1348,1724,19861,22401,0,42262,5.13095e+18,1417.19,6882.24,42262,517,436,39253,33483,27282,25005,33874
39978,262,354,0,39978,38138,1840,2.51891e+16,296.133,2532.5,39978,134,149,39295,38574,36027,33977,33706
9209,513,1320,0,9209,3288,5921,9.91143e+15,495.786,2683.69,9209,245,228,7734,7168,4597,4073,4516
36720,1558,1760,0,36720,0,36720,2.54422e+18,1369.45,6433.71,36720,488,429,34855,29693,28949,28349,33215
45795,455,2882,38182,7613,24051,21744,7.29759e+17,1742.08,8582.27,45795,685,454,35012,30511,18754,19926,10302
37852,152,354,0,37852,36111,1741,2.5039e+16,286.912,2456.55,37852,132,142,36750,36104,31467,27442,24200
48520,34,357,0,48520,46255,2265,2.53866e+16,307.343,2812.95,48520,149,159,44841,42483,32435,27937,17083
30390,1119,1842,0,30390,10804,19586,9.58227e+15,1035.29,5319.11,30390,483,336,28046,25493,20496,15580,20348
13769,1290,1742,0,13769,0,13769,2.50626e+18,977.655,3987.38,13769,316,297,11705,10619,8470,7961,9364
37034,1733,2321,19431,17603,19431,17603,4.92581e+18,1437.25,6880.63,37034,563,412,34671,30103,25953,24774,30392
37028,46,348,0,37028,35114,1914,2.6433e+16,299.551,2498.06,37028,137,149,34576,33015,24650,21192,13905
4580,24,1156,2574,2006,0,4580,5.39724e+18,226.061,1904.75,4580,221,165,2015,1253,770,549,129
3493,718,878,2141,1352,0,3493,5.30648e+18,93.8036,1405.36,3493,180,128,2615,2615,2599,2596,1432
33784,1798,2085,17563,16221,17563,16221,4.98992e+18,1412.64,6434.02,33784,498,401,31699,31108,25743,25095,30188
3198,36,229,0,3198,3005,193,2.69259e+16,50.7846,625.784,3198,53,52,2882,2674,2086,1749,1101
7463,116,1495,0,7463,2621,4842,9.87838e+15,252.823,2592.42,7463,275,183,5464,4661,2035,1588,914
19975,1629,2352,16787,3188,10738,9237,7.06925e+17,1307.49,5370.58,19975,412,329,17258,15133,14770,14594,14536
2061,178,326,1869,192,2061,0,3.84888e+18,101.661,616.893,2061,72,61,1735,1681,1653,1662,1235
22603,1127,2016,11699,10904,11699,10904,4.9216e+18,1251.16,5229.83,22603,458,337,19492,17650,11889,12463,12209
48184,1939,1955,17116,31068,0,48184,3.72428e+13,1136.21,6661.66,48184,623,380,46229,46229,46207,46221,46217
21066,543,1298,0,21066,7431,13635,1.00095e+16,929.423,4048.74,21066,350,311,18198,16635,9797,8328,10273
25658,627,1704,9090,16568,0,25658,3.69386e+13,1015.07,4783.99,25658,455,310,22374,20682,13264,10933,10513
44506,1186,1992,22354,22152,22354,22152,4.98395e+18,1491.33,7331.83,44506,544,444,40020,34870,24805,22790,29503
12340,131,1465,0,12340,4379,7961,9.53209e+15,566.83,3091.11,12340,327,232,9813,8890,4570,2468,1699
6902,726,1243,0,6902,2415,4487,9.78851e+15,283.32,2273.11,6902,226,171,5659,5492,4291,3825,4314
42814,1114,2457,22158,20656,0,42814,4.9745e+18,1486.16,7506.89,42814,614,426,37900,33573,20170,18657,24013
48101,1425,1963,0,48101,17077,31024,9.51163e+15,1187.93,6692.1,48101,600,382,46138,43400,36267,30168,43519
19699,483,797,0,19699,18639,1060,2.4062e+16,142.792,2573.14,19699,128,119,18902,18883,17878,17153,15399
46104,34,2487,0,46104,0,46104,2.44258e+18,1491.33,7772.32,46104,629,440,23785,15769,9106,4839,1054
37808,1568,2739,31361,6447,19587,18221,7.46109e+17,1668.2,7777.16,37808,598,424,33470,28456,26873,27050,24120
16188,599,1367,0,16188,5746,10442,9.89649e+15,829.872,3614.27,16188,308,279,13979,12906,8144,7136,8125
7738,1351,1391,0,7738,2742,4996,9.46321e+15,205.335,2463.76,7738,234,172,6347,6347,6347,6347,5353
32973,1157,2708,32973,0,27441,5532,3.36183e+18,1663.24,7276.07,32973,592,409,27707,23886,22187,21010,15428
31132,1534,1763,0,31132,11035,20097,9.53223e+15,1058.62,5276.11,31132,492,329,29369,29369,27980,27462,29061
2165,26,849,0,2165,0,2165,2.28809e+18,107.425,1198.04,2165,155,98,862,431,200,161,53
31594,380,1520,0,31594,11160,20434,9.60692e+15,1066.4,5148.7,31594,452,340,26837,24666,13261,8785,11724
29741,97,2024,15172,14569,15172,14569,4.98622e+18,1310.39,6027.76,29741,481,382,19260,13887,6853,6489,1452
10535,1475,1787,0,10535,0,10535,2.42721e+18,759.787,3490.24,10535,305,247,8748,8078,7306,7294,8026
8177,1179,1475,2901,5276,0,8177,3.70983e+13,261.49,2591.48,8177,261,205,6702,6648,6115,6367,6251
1334,176,586,492,842,492,842,3.93866e+18,71.6934,779.644,1334,151,82,748,668,398,434,391
12915,3505,3510,2588,10327,0,12915,9.75696e+17,181.916,5502.68,12915,737,376,9405,9405,9405,9405,9404
8204,873,1663,3745,4459,3745,4459,4.83123e+18,501.425,2973.14,8204,276,222,6541,6090,4183,3694,4479
11317,1726,1796,5898,5419,5898,5419,4.99105e+18,750.803,3561.97,11317,315,261,9521,8971,9444,9371,8974
23099,277,356,0,23099,21916,1183,2.60761e+16,271.425,1984.15,23099,120,124,22597,22148,20808,19644,18697
28912,357,359,0,28912,27542,1370,2.54839e+16,284.164,2176.45,28912,125,137,28553,28553,28532,28504,28463
37194,1010,2767,30236,6958,17723,19471,7.96969e+17,1782.6,8055.31,37194,600,441,30195,25912,19103,18696,16279
20315,127,2345,17004,3311,10829,9486,7.25291e+17,1339.89,5457.83,20315,401,333,12809,8634,6116,6407,1438
37193,1785,2162,0,37193,0,37193,2.4669e+18,1431.08,6821.78,37193,543,412,35031,33906,28246,25737,32343
44863,2,42,42658,2205,43813,1050,1.00637e+14,38.93,944.28,44863,42,41,27408,22297,21226,22638,16636
45620,1156,1384,16133,29487,0,45620,3.87537e+13,1137.11,6103.89,45620,494,399,43482,38233,34032,32290,38482
26918,921,1762,0,26918,0,26918,2.5358e+18,1326.57,5569.01,26918,436,378,23004,20232,12880,10741,15555
31203,1699,2253,0,31203,0,31203,2.44061e+18,1360.04,6283.89,31203,508,377,28888,25263,21766,20329,24902
10679,408,1524,0,10679,3727,6952,9.19865e+15,552.827,3019.38,10679,316,202,8775,8225,4943,3438,3976
9669,41,42,9155,514,9542,127,1.06605e+14,33.2358,447.371,9669,33,31,9627,9623,9603,9602,9537
33526,613,906,32584,942,33526,0,4.56671e+18,537.563,3714.68,33526,286,219,32567,31783,29563,29626,26965
33709,441,1770,0,33709,11955,21754,9.47478e+15,1108.71,5522.01,33709,521,338,28801,26484,14581,9737,12323
993,256,492,0,993,0,993,2.29426e+18,29.5065,634.736,993,75,86,501,501,265,276,230
34008,2325,2364,17522,16486,0,34008,4.95399e+18,1402.83,6662.53,34008,547,389,31644,31644,31617,31626,31644
7378,585,647,7167,211,7378,0,4.55602e+18,244.517,1649.51,7378,167,127,6731,6710,6694,6688,6685
37523,41,43,35704,1819,36624,899,1.00234e+14,39.5308,880.726,37523,42,40,37470,37441,37365,37364,36414
26894,1127,1331,0,26894,9473,17421,9.82873e+15,1013.55,4626.52,26894,393,339,25132,22410,20204,17704,23007
16979,876,1549,6020,10959,0,16979,3.72248e+13,844.552,3771.22,16979,363,272,14906,13958,10267,9618,11142
44498,1836,2430,0,44498,0,44498,2.47673e+18,1519.19,7821.74,44498,661,421,42052,37926,32877,29937,37499
45573,28,1914,16153,29420,0,45573,3.71674e+13,1155.48,6484.59,45573,619,374,27435,20907,12216,3983,5223
15231,182,339,0,15231,14366,865,2.74776e+16,228.358,1590.26,15231,104,114,14676,14389,12764,11585,10875
13644,489,1929,10854,2790,6452,7192,8.54211e+17,1155.07,4294.5,13644,339,308,10019,8447,5325,5450,3637
26157,1756,2136,12574,13583,12574,13583,5.00587e+18,1418.41,5912.42,26157,465,374,23808,20693,17958,17095,22281
43113,472,1894,0,43113,15308,27805,9.54619e+15,1159.26,6318.2,43113,593,375,37122,33998,18049,12349,12051
39160,2062,2418,20677,18483,0,39160,5.00433e+18,1403.25,7118.26,39160,578,410,36742,36742,33195,32739,34943
3767,31,253,0,3767,3554,213,2.80618e+16,59.279,706.819,3767,59,56,3355,3131,2439,2083,1299
5663,196,1572,2664,2999,0,5663,5.03422e+18,215.28,2475.34,5663,231,174,3943,3093,1452,1179,859
20619,807,1345,7321,13298,0,20619,3.86923e+13,919.19,4063.83,20619,343,302,18347,16885,12243,11024,13353
12152,686,1809,0,12152,0,12152,2.47016e+18,858.928,3759.89,12152,318,279,9677,8679,5000,4382,5075
27959,7,43,26756,1203,26991,968,9.57113e+13,38.5192,749.481,27959,40,37,25770,24329,20204,20145,13397
28092,155,359,0,28092,26621,1471,2.64099e+16,288.47,2205.31,28092,130,140,27112,26528,22798,19749,17092
47194,1850,2491,0,47194,0,47194,2.44246e+18,1493.97,7861.41,47194,656,436,44703,44447,35067,32653,41445
45437,1485,1943,22519,22918,22519,22918,4.9758e+18,1465.01,7366.86,45437,563,440,42639,36545,30566,28783,38145
15027,1538,2061,7964,7063,7964,7063,4.92456e+18,939.476,4302.66,15027,376,282,12942,11786,10000,9669,10767
38148,746,2313,0,38148,0,38148,2.53674e+18,1550.84,7306.23,38148,551,425,31507,26969,11571,10840,14275
10718,1410,1861,5601,5117,5601,5117,4.81987e+18,635.796,3463.22,10718,333,227,8857,8322,7242,7053,7187
47485,373,2165,47485,0,38043,9442,2.98043e+18,1764.28,8363.42,47485,557,488,34003,28958,13940,11054,7382
12179,83,2221,12179,0,10199,1980,3.08713e+18,886.943,4167.23,12179,291,271,6720,4340,3117,2675,21
1896,15,35,1800,96,1895,1,1.10156e+14,20.9378,189.864,1896,22,22,1829,1797,1590,1597,1213
4820,545,1546,3779,1041,2234,2586,9.07857e+17,229.555,2312.38,4820,181,166,3274,3065,2160,2146,1494
16044,1593,1924,0,16044,0,16044,2.4621e+18,987.387,4348.92,16044,384,296,14076,12732,12145,11859,12438
43289,625,1547,15250,28039,7,43282,3.879e+13,1075.1,6059.76,43289,502,395,38231,34813,20954,17616,22549
37554,255,2126,13464,24090,0,37554,3.8585e+13,694.737,5961.18,37554,488,337,31328,28196,12337,11485,13136
12138,1239,2008,5880,6258,0,12138,5.14011e+18,869.282,3953.82,12138,336,277,10059,9167,6941,6488,7950
41399,84,1397,14661,26738,0,41399,3.88947e+13,1109.21,5806.23,41399,463,395,30094,24406,10502,4551,4478
11322,347,2123,5368,5954,5368,5954,4.89156e+18,796.716,3913.08,11322,376,246,8325,6982,2662,2751,2799
12922,121,349,0,12922,12335,587,2.50546e+16,192.03,1433.16,12922,99,95,12398,12199,10511,9276,7953
4710,886,1603,4710,0,3683,1027,3.27924e+18,193.176,2324.84,4710,198,192,3107,3028,2713,2631,2190
30657,1822,2074,15445,15212,0,30657,5.03223e+18,1368.46,6156.38,30657,480,390,28583,28466,25940,25314,27358
16872,1435,1816,8108,8764,8108,8764,4.91065e+18,1103.06,4462.18,16872,373,309,14854,13177,11478,11189,13518
34145,597,601,33823,322,34145,0,4.74673e+18,505.151,3496.94,34145,237,236,33544,33544,33544,33543,33543
10479,186,1833,5255,5224,0,10479,4.86895e+18,672.569,3437.66,10479,349,235,7612,6414,2637,2034,1016
13139,96,662,12806,333,13139,0,4.52478e+18,366.783,2190.46,13139,178,161,10386,7601,4384,4330,2610
30795,720,2317,0,30795,0,30795,2.42115e+18,1338.89,6262.18,30795,543,367,25661,22887,11874,12179,10736
30798,924,1484,10927,19871,0,30798,3.79663e+13,1072.16,5087.34,30798,424,337,28095,25464,19325,20092,22138
37269,1690,1768,0,37269,13242,24027,9.58317e+15,1093.59,5747.38,37269,537,351,35501,35501,35143,34936,35401
2171,373,732,0,2171,0,2171,2.3244e+18,51.895,1099.8,2171,112,97,1439,1429,911,934,773
44211,185,383,0,44211,41844,2367,2.68047e+16,300.827,2800.29,44211,149,163,42965,42014,36895,32282,29574
31246,925,1735,14837,16409,0,31246,5.10911e+18,1348.93,5932.68,31246,456,396,26892,23706,14721,12245,18295
43062,1443,2193,22013,21049,0,43062,5.06607e+18,1446.57,7339.56,43062,554,430,39891,34563,26023,23271,30645
42124,94,2834,42124,0,35101,7023,3.274e+18,1759.62,8270.27,42124,672,447,24497,16658,10354,7880,2116
49104,195,2149,0,49104,0,49104,2.49236e+18,1475.8,7827.1,49104,580,450,35708,28770,11238,5551,6264
10608,461,2283,8771,1837,5416,5192,7.62183e+17,795.884,3960.73,10608,341,244,7680,6817,4244,4621,2393
24649,1113,2114,13184,11465,13184,11465,4.9283e+18,1260.04,5469.1,24649,458,339,21351,19346,13541,12920,12929
11633,53,351,0,11633,11168,465,2.39842e+16,135.651,1313.81,11633,84,85,11038,10760,8801,7880,6433
35290,244,355,0,35290,33598,1692,2.56031e+16,298.765,2406.98,35290,134,144,34564,33920,31231,29075,27046
18984,744,2078,18984,0,15216,3768,2.99003e+18,1425.35,5252.93,18984,372,341,14552,12115,8046,7160,7047
25293,518,2632,25293,0,20991,4302,3.33327e+18,1518.97,6349.61,25293,515,365,19211,16490,10599,8729,6225
26944,1682,1929,0,26944,0,26944,2.47092e+18,1286.53,5622.06,26944,452,359,25003,21897,21054,20609,23153
32591,1634,2640,32591,0,27207,5384,3.2857e+18,1631.12,7145.9,32591,604,403,28892,24628,27356,25504,24127
16671,86,1798,0,16671,0,16671,2.48888e+18,1092.73,4404.51,16671,340,316,10155,6979,3264,1784,1165
11122,41,43,10613,509,10770,352,9.62717e+13,26.7427,466.177,11122,33,32,11079,11076,11066,11065,11025
4163,195,494,4024,139,4163,0,4.43105e+18,178.844,1157.74,4163,104,95,3631,3328,2547,2536,1630
14754,1132,2137,14754,0,11868,2886,3.03386e+18,1181.44,4652.03,14754,338,302,11831,10375,9100,8504,8178
5693,372,579,5674,19,5693,0,4.89992e+18,225.47,1430.02,5693,123,114,5114,5024,4578,4562,4176
40128,204,353,0,40128,37839,2289,2.72713e+16,311.859,2636.75,40128,154,163,38993,38031,33736,30142,27392
20454,22,42,19333,1121,20187,267,1.05206e+14,37.1493,643.544,20454,38,36,20234,20034,17188,17131,14638
24368,585,592,24114,254,24368,0,4.76717e+18,473.441,2944.33,24368,209,211,23776,23776,23748,23751,23746
26916,784,1704,9516,17400,0,26916,3.70583e+13,1034.87,4900.01,26916,479,317,23922,21973,14908,15418,13850
42016,644,2707,34864,7152,21773,20243,7.4365e+17,1717.45,8126.88,42016,613,435,33214,28613,19472,19638,13145
25531,9,43,24263,1268,24971,560,1.00944e+14,39.5433,729.111,25531,41,38,23987,22973,18734,18735,12284
29726,1187,2472,29726,0,24356,5370,3.20224e+18,1585.16,6799.91,29726,511,397,24934,21494,20143,19083,15261
24706,872,1319,0,24706,8742,15964,9.94081e+15,987.735,4419.67,24706,388,323,22309,20284,15209,12398,16552
34661,1624,2316,0,34661,0,34661,2.43425e+18,1433.08,6682.52,34661,561,400,32098,27892,22335,20965,27380
36778,74,357,0,36778,35079,1699,2.50531e+16,286.026,2423.44,36778,133,144,35123,34364,27267,23540,16760
18721,1075,1763,8826,9895,8826,9895,4.98408e+18,1158.68,4646.33,18721,370,319,15943,14242,9886,8903,11738
1671,6,28,1559,112,1662,9,1.06459e+14,18.9078,156.146,1671,21,20,1489,1365,1113,1142,875
44383,1315,2524,0,44383,0,44383,2.50466e+18,1602.32,7991.05,44383,619,448,39869,34691,20511,17984,26525
6853,232,1977,5827,1026,3674,3179,6.76945e+17,342.572,3013.51,6853,259,184,4569,3846,2407,2597,787
49617,535,2968,49617,0,41331,8286,3.29511e+18,1823.73,9056.49,49617,728,475,38390,32968,21086,17302,12987
25468,230,352,0,25468,24307,1161,2.51755e+16,254.249,2007.33,25468,117,128,24887,24467,22705,21237,20073
39381,510,1865,13810,25571,0,39381,3.81822e+13,1287.37,6347.59,39381,615,383,33298,29872,15031,12733,15413
40013,71,832,38957,1056,40013,0,4.59296e+18,570.417,4002.36,40013,304,236,29448,20416,12575,11288,4546
14094,260,1531,0,14094,5006,9088,9.53684e+15,745.422,3469.11,14094,318,258,11517,10739,5261,3673,3158
37238,556,1762,17652,19586,0,37238,5.10813e+18,1397.02,6510.08,37238,504,420,30364,26346,11595,9703,12980
14273,895,1879,7610,6663,7610,6663,4.94146e+18,871.516,4006,14273,376,282,11847,10977,7465,7707,7108
10151,1767,2135,10151,0,8162,1989,2.9998e+18,854.539,3860.31,10151,284,275,8016,7267,7864,7887,7395
48440,1144,2169,38845,9595,23040,25400,8.39073e+17,1782.99,8441.17,48440,568,473,41108,34320,29895,29037,26468
46698,2198,2558,24701,21997,0,46698,4.99369e+18,1495.01,7852.48,46698,670,429,44140,44140,40930,40459,42604
19706,44,351,0,19706,18770,936,2.57976e+16,247.263,1792.99,19706,109,117,18448,17624,13643,11699,7818
32290,2261,2651,26837,5453,16776,15514,7.37005e+17,1642.58,7125.81,32290,578,395,29639,29435,27500,27064,28308
25131,77,2463,25131,0,21037,4094,3.32886e+18,1495.6,6138.42,25131,493,378,14367,9932,6530,5285,2302
40170,987,2400,21255,18915,0,40170,5.02761e+18,1429.18,7199.34,40170,583,409,34974,31141,18264,17327,20399
42802,1106,2086,21173,21629,0,42802,5.04766e+18,1442.22,7266.22,42802,548,435,38019,33393,21028,18621,26748
43705,1271,5489,0,43705,15102,28603,8.92479e+15,635.925,10147.1,43705,992,515,38216,36567,21760,20072,16536
30536,223,354,0,30536,29096,1440,2.55209e+16,282.025,2223.48,30536,127,139,29818,29248,26833,24779,22998
41790,1980,2429,0,41790,0,41790,2.4243e+18,1452.03,7376.86,41790,632,412,39361,39249,33159,31137,36889
4864,120,1343,2222,2642,0,4864,4.80505e+18,189.252,2093.94,4864,205,166,3174,2130,752,534,323
14804,462,2822,6602,8202,6602,8202,4.62823e+18,468.291,4858.84,14804,305,334,11699,10636,4113,3930,2647
48371,753,809,47523,848,48371,0,4.67252e+18,554.023,4367.5,48371,265,252,47562,47554,47250,47223,46756
5650,9,40,5343,307,5590,60,1.06911e+14,25.014,336.221,5650,29,28,5279,5042,4130,4044,2504
12458,153,349,0,12458,11807,651,2.62249e+16,218.662,1450.02,12458,96,94,11941,11756,10329,9139,7308
6967,1115,1358,0,6967,2464,4503,9.74418e+15,186.285,2374.98,6967,204,174,5609,5601,5104,4893,5050
30991,468,850,30147,844,30991,0,4.54515e+18,526.42,3547.18,30991,242,215,29740,28840,25762,25680,21516
49022,913,1631,17407,31615,0,49022,3.78617e+13,1180.9,6517.96,49022,539,396,44974,40708,29200,25982,33514
11906,1580,1711,5712,6194,0,11906,5.18698e+18,915.921,3680.59,11906,282,271,10195,9192,9297,9226,9843
6883,336,1688,3475,3408,3475,3408,4.9366e+18,301.493,2763.26,6883,258,218,5102,4651,2548,2604,1584
28288,2063,2317,0,28288,9810,18478,9.48846e+15,913.365,5812.81,28288,497,352,25971,25971,25607,25523,25302
23959,323,352,0,23959,22876,1083,2.49566e+16,251.813,1948.38,23959,115,126,23564,23159,23030,22573,22331
29171,37,43,27766,1405,28461,710,1.00081e+14,40.1162,779.273,29171,41,39,29100,29062,27804,27810,26471
2532,308,694,0,2532,930,1602,1.05016e+16,103.174,1128.17,2532,159,134,1838,1752,1341,1243,1074
32080,12,43,30268,1812,31760,320,1.06703e+14,39.965,826.372,32080,42,40,30704,29735,23838,23245,16339
22585,1764,2057,0,22585,0,22585,2.45245e+18,1241.56,5234.54,22585,432,324,20528,18324,17244,16562,18953
37972,747,1524,13496,24476,0,37972,3.837e+13,1081.68,5663.47,37972,466,374,34200,31141,21013,18933,22373
49259,1405,2265,39976,9283,24268,24991,8.01431e+17,1784.75,8562.05,49259,603,481,43627,36496,34717,34121,32907
47499,12,43,45329,2170,46143,1356,9.81512e+13,40.6798,987.27,47499,43,41,45846,44692,36671,35987,26332
5592,430,1189,1974,3618,0,5592,3.81071e+13,147.575,2049.77,5592,205,182,4403,4263,2738,2657,2263
8039,555,659,7813,226,8039,0,4.60181e+18,264.65,1739.12,8039,133,125,7380,7341,7178,7172,6752
39257,1645,2751,32007,7250,19453,19804,7.96438e+17,1664.38,8066.24,39257,561,456,35335,29476,28373,28380,29186
9181,250,1824,0,9181,0,9181,2.47989e+18,507.253,3219.71,9181,301,238,6837,6011,2923,2362,1567
29288,2528,2557,23650,5638,13939,15349,8.1308e+17,1590.98,6976.32,29288,558,397,26731,26730,26709,26722,26729
33932,93,2252,0,33932,0,33932,2.4599e+18,1392.77,6540.96,33932,546,399,21959,15986,8285,3349,1796
30555,100,355,0,30555,29125,1430,2.5222e+16,280.572,2221.34,30555,127,135,29355,28828,23487,20332,16166
18593,31,42,17693,900,18142,451,9.95831e+13,37.2749,607.018,18593,38,35,18514,18462,17216,17200,16200
32652,793,2396,0,32652,0,32652,2.43514e+18,1378.15,6517.56,32652,541,375,27601,24773,12028,12828,11199
5062,142,238,0,5062,4848,214,2.33455e+16,59.7493,747.219,5062,55,54,4824,4819,4572,4565,3795
29512,404,860,28668,844,29512,0,4.54321e+18,535.838,3471.09,29512,289,212,28090,27159,21059,20713,18100
3065,678,1217,3065,0,2456,609,3.16463e+18,133.789,1718.49,3065,172,150,1848,1816,1650,1634,1508
8074,250,1291,2923,5151,0,8074,3.97638e+13,436.616,2508.75,8074,206,231,6447,5981,3044,2511,2331
1215,3,291,0,1215,0,1215,2.63518e+18,30.8988,470.178,1215,76,52,174,6,22,37,3
32648,814,2316,17004,15644,0,32648,4.98952e+18,1412.06,6501.88,32648,549,391,27672,24686,13192,12886,12809
2857,10,43,2686,171,2851,6,1.09359e+14,28.0105,262.29,2857,29,28,2661,2534,2016,2001,1385
24695,822,2031,12493,12202,0,24695,5.05409e+18,1261.92,5497.69,24695,431,355,20809,18584,10371,9362,11339
27209,341,351,0,27209,26010,1199,2.48464e+16,257.13,2058.19,27209,120,130,26852,26506,26739,26713,26270
6993,84,590,6884,109,6993,0,4.72755e+18,236.386,1581.66,6993,142,130,5210,3647,2273,2292,1499
34465,160,382,0,34465,32532,1933,2.72885e+16,302.328,2502.2,34465,142,147,33243,32455,27574,24001,22091
14404,8,44,13580,824,14274,130,1.06403e+14,35.2827,548.015,14404,38,35,13241,12500,10042,9935,7080
9446,1525,1539,0,9446,3336,6110,9.28556e+15,432.065,2845.79,9446,301,196,7907,7907,7897,7904,7907
20492,1235,1321,7260,13232,0,20492,3.89927e+13,929.496,4033.47,20492,349,306,19100,17155,18188,17968,18586
2663,28,40,2569,94,2542,121,8.68845e+13,16.7199,231.157,2663,23,25,2623,2614,2469,2494,2345
34468,712,892,33622,846,34468,0,4.63891e+18,567.229,3777.16,34468,281,220,33576,33429,32085,32101,30533
39445,1377,1745,18809,20636,0,39445,5.13807e+18,1420.34,6682.54,39445,499,426,36437,31267,25953,23791,32326
29397,118,564,29086,311,29397,0,4.83289e+18,475.966,3194.06,29397,227,218,24372,18082,10196,10581,6856
45064,614,2314,23507,21557,0,45064,5.0172e+18,1565.91,7620.04,45064,625,428,37337,32848,15558,16169,15160
22832,1432,1645,8133,14699,0,22832,3.72691e+13,959.494,4450.5,22832,426,303,21187,20252,19392,19610,20756
27599,2201,2536,27599,0,23215,4384,3.31809e+18,1526.29,6440.92,27599,527,380,25063,24885,24514,24624,23788
47314,875,1943,16830,30484,0,47314,3.73231e+13,1160.44,6620.01,47314,626,377,42953,39353,26344,24337,31737
12935,595,1308,4588,8347,0,12935,3.88788e+13,740.721,3206.44,12935,286,263,10952,10221,6488,5844,6407
13405,1421,2085,7246,6159,0,13405,4.87123e+18,764.408,3978.56,13405,376,244,11320,10477,8678,8499,8690
9101,616,2127,9101,0,7496,1605,3.07037e+18,688.634,3629.57,9101,282,245,6638,5854,3427,3339,2694
30732,1291,1706,10921,19811,0,30732,3.7326e+13,1058.94,5210.91,30732,488,333,28873,26075,22429,22984,26296
12589,89,356,0,12589,11903,686,2.66045e+16,220.3,1473.62,12589,94,100,11942,11717,9262,8036,5907
49659,1236,2898,49659,0,41464,8195,3.28582e+18,1793.93,8963.04,49659,744,478,42910,36609,35548,34027,28830
39018,256,1638,0,39018,13896,25122,9.7047e+15,1095.33,5805.08,39018,482,372,32474,29971,14286,9214,8819
12235,94,1690,0,12235,0,12235,2.56257e+18,921.144,3700.02,12235,289,273,7416,4951,2133,1361,850
23160,249,1740,10989,12171,10989,12171,5.02566e+18,1279.88,5156.12,23160,387,353,17046,14515,4950,4894,4445
28938,1356,2254,0,28938,0,28938,2.44413e+18,1305.14,6089.74,28938,485,372,25898,22739,16434,14780,19513
47949,144,2505,25392,22557,25392,22557,4.93006e+18,1485.81,7915.06,47949,646,436,34429,26296,12819,13261,3443
48211,317,3007,40125,8086,25101,23110,7.33208e+17,1776.95,8927.81,48211,701,458,35174,29785,16875,18943,7864
45586,563,1267,0,45586,43189,2397,2.49782e+16,221.142,4545.55,45586,166,191,44319,44215,40356,37806,30858
3705,747,897,1264,2441,0,3705,3.67753e+13,95.1973,1475.81,3705,176,128,2808,2807,2577,2681,2560
29085,1468,2027,14814,14271,14814,14271,4.95695e+18,1331.99,5944.91,29085,464,377,26496,23227,18863,17802,21878
45259,206,357,0,45259,43146,2113,2.5337e+16,301.829,2713.46,45259,144,159,44218,43343,39330,35956,31091
38851,678,872,37801,1050,38851,0,4.5705e+18,591.542,3990.88,38851,293,228,37970,37781,35527,35554,33669
40176,37,40,38038,2138,39585,591,1.04517e+14,38.0606,898.843,40176,40,39,40116,40064,39950,39948,38245
8535,585,615,8261,274,8535,0,4.3488e+18,267.448,1733.37,8535,144,126,7920,7882,7905,7907,7819
10638,465,1447,0,10638,3742,6896,9.37682e+15,453.338,2868.01,10638,314,183,8983,8447,5676,3960,5173
4421,1328,1492,3553,868,2169,2252,8.22654e+17,216.846,2197.03,4421,211,174,2929,2929,2912,2908,2830
1378,91,288,1333,45,1031,347,2.81479e+17,52.7329,466.146,1378,67,48,1090,1043,968,968,82
48499,133,357,0,48499,46229,2270,2.53574e+16,310.717,2819.27,48499,147,162,46938,46082,39131,33876,27164
9453,1022,1747,4925,4528,4925,4528,5.00981e+18,546.224,3198.77,9453,278,262,7706,7246,5051,5010,5597
47179,560,1653,0,47179,16653,30526,9.69154e+15,1144.92,6440.74,47179,516,386,41166,37529,21516,15828,23428
34199,167,349,0,34199,32370,1829,2.65737e+16,291.219,2405.91,34199,137,149,33128,32354,28230,24381,21534
5996,524,1140,2120,3876,0,5996,3.91345e+13,170.622,2037.23,5996,237,171,4856,4724,3609,3813,2797
18086,1203,1698,0,18086,0,18086,2.55931e+18,1148.19,4497.51,18086,341,316,15726,13892,10950,9917,13445
36049,892,2370,0,36049,0,36049,2.42143e+18,1409.1,6819.66,36049,560,386,30877,27632,15663,15688,16534
21225,32,351,0,21225,20298,927,2.498e+16,225.132,1808.13,21225,112,113,19639,18658,14816,12508,8392
17681,560,1593,0,17681,6262,11419,9.43023e+15,850.622,3895.29,17681,388,268,15209,14073,8788,5688,6115
27886,246,678,27501,385,27886,0,4.65339e+18,500.73,3233.27,27886,235,215,25932,24307,13379,13716,10666
34492,112,356,0,34492,32718,1774,2.63563e+16,301.376,2432.54,34492,136,148,33097,32414,26391,22846,17512
23896,1566,1819,11941,11955,11941,11955,5.04497e+18,1250.42,5267.54,23896,414,353,21935,19122,18058,17736,20669
31646,248,2258,31646,0,25513,6133,3.11263e+18,1588.41,6880.6,31646,528,416,21557,17717,8086,6749,4824
22843,36,44,21629,1214,22554,289,1.06476e+14,37.4911,691.898,22843,39,36,22779,22751,21439,21440,19841
11919,1566,2874,9475,2444,5212,6707,8.92018e+17,371.125,4622.86,11919,261,348,9045,8995,7955,7713,6306
31081,958,1702,11024,20057,0,31081,3.72284e+13,1061.85,5233.41,31081,493,333,28350,25954,19103,18498,17664
12082,347,357,0,12082,11563,519,2.43871e+16,157.379,1364.11,12082,85,86,11725,11650,11697,11704,11519
26729,24,1830,13152,13577,0,26729,5.11317e+18,1298.69,5580.57,26729,423,373,11225,6123,3270,2695,504
5644,779,1170,1998,3646,0,5644,3.97518e+13,167.299,2034.21,5644,236,174,4474,4469,3634,3736,3558
21949,1025,2495,21949,0,18307,3642,3.32085e+18,1433.14,5805.59,21949,489,350,17799,15534,13413,12698,10519
29994,885,2128,15772,14222,0,29994,4.99892e+18,1336.37,6037.29,29994,511,371,25646,23115,13821,13409,14011
35866,40,42,34078,1788,35177,689,1.02699e+14,39.849,857.779,35866,41,41,35815,35791,35709,35708,35140
45688,611,724,44914,774,45688,0,4.60593e+18,538.474,4154.5,45688,266,250,44962,44516,42813,42811,42201
14984,1990,2013,7875,7109,0,14984,5.00991e+18,946.086,4250.01,14984,368,287,12971,12971,12961,12880,12968
11826,188,559,11699,127,11826,0,4.77039e+18,364.942,2018.28,11826,158,157,10641,9562,5957,6052,4884
49301,628,2294,39714,9587,23930,25371,8.24438e+17,1735.04,8574.39,49301,584,485,38532,32282,22302,22117,14787
3117,842,1038,0,3117,0,3117,2.45923e+18,131.313,1520.85,3117,187,145,2079,2065,1695,1684,1794
13085,2207,2339,13085,0,10787,2298,3.26463e+18,1064.27,4460.44,13085,404,296,10746,10746,10725,10740,10743
24801,928,1713,11757,13044,11757,13044,5.00991e+18,1303.35,5294.69,24801,418,362,21117,18596,12062,10874,12723
8299,668,1813,0,8299,0,8299,2.46556e+18,360.465,3060.72,8299,269,180,6486,6040,4006,3278,2767
20484,577,1886,10199,10285,10199,10285,4.93798e+18,1171.31,4931.22,20484,392,336,16541,14713,8018,7978,7887
23374,1863,2487,23374,0,19520,3854,3.29766e+18,1456.78,5975.3,23374,537,348,20685,17899,19947,19660,19237
36590,665,1985,18058,18532,18058,18532,4.97097e+18,1451.58,6718.94,36590,494,416,30264,26315,13028,13197,12815
2871,6,367,2870,1,2871,0,4.80369e+18,156.426,862.505,2871,87,90,589,97,102,114,51
25157,3446,3772,25157,0,20456,4701,2.95064e+18,1187.59,7528.74,25157,679,414,21385,21370,21376,21379,20890
49954,1696,2466,23894,26060,0,49954,5.10572e+18,1601.8,8401.76,49954,627,461,46861,39832,30612,26910,41312
33948,134,353,0,33948,32401,1547,2.48874e+16,278.69,2320.47,33948,130,141,32870,32298,27713,24393,20712
20540,1507,1930,10202,10338,0,20540,5.05819e+18,1190.7,4995.81,20540,391,337,18384,16186,14171,13426,16793
48287,156,753,47597,690,48287,0,4.66905e+18,535.423,4299.66,48287,282,257,42658,36121,17948,18088,12379
49714,146,1693,0,49714,17614,32100,9.69254e+15,1140.62,6601.31,49714,557,390,39443,34928,15640,10961,7890
3005,258,386,2970,35,3005,0,4.91632e+18,156.354,907.37,3005,84,89,2619,2584,2501,2503,2410
27389,1653,2562,27389,0,23017,4372,3.28722e+18,1468.14,6440.12,27389,560,374,24194,20906,23046,21828,20345
21163,2577,2681,17798,3365,11290,9873,7.12412e+17,1296.7,5838.97,21163,453,372,18482,18482,18411,18438,18064
5621,1119,1448,2711,2910,0,5621,5.2338e+18,238.955,2353.05,5621,233,198,4173,4172,3653,3556,3477
32288,175,2289,17050,15238,17050,15238,4.91997e+18,1364.48,6382.84,32288,539,386,23749,19250,8685,9451,3594
32150,1077,2416,16909,15241,0,32150,5.01241e+18,1358.56,6544.71,32150,537,385,27926,24984,15424,14258,17119
2301,476,858,0,2301,0,2301,2.78602e+18,112.98,1247.28,2301,171,133,1443,1397,1212,1219,973
41816,616,2141,20943,20873,20943,20873,4.96322e+18,1453.59,7265.87,41816,520,440,34547,30092,13272,14789,13813
7877,70,572,7732,145,7877,0,4.63951e+18,279.75,1646.28,7877,142,136,5625,3712,2186,2149,1131
18437,982,1485,6504,11933,0,18437,3.72572e+13,897.859,3932.27,18437,373,280,16589,15207,11943,12736,13667
37972,427,2082,30341,7631,18035,19937,8.45009e+17,1684.3,7359.79,37972,522,446,27911,23704,13866,14373,6885
9074,1212,1796,4718,4356,0,9074,5.16032e+18,515.564,3218.21,9074,237,256,7278,6872,5881,5601,5583
45602,3694,5381,21782,23820,21782,23820,4.67549e+18,1097.46,10836,45602,1036,549,40221,40102,36823,37059,37143
18315,2,43,17417,898,17859,456,9.98651e+13,34.6228,606.309,18315,37,35,11271,9203,8787,9335,6764
46937,1077,2143,23470,23467,0,46937,5.06981e+18,1487.07,7684.17,46937,561,451,41587,36520,21965,19404,26335
18945,375,2050,9600,9345,9600,9345,4.85107e+18,1168.01,4832.51,18945,436,322,14789,13216,5552,5901,3936
16124,9,43,15355,769,15702,422,9.95919e+13,35.858,575.576,16124,37,35,15190,14572,11889,11898,7775
38669,349,1627,0,38669,13664,25005,9.5955e+15,1113.62,5796.69,38669,501,362,32742,29987,14828,9814,11237
4555,337,1544,4555,0,3610,945,2.99017e+18,224.378,2280.35,4555,179,183,2975,2575,1175,1093,584
27490,1826,2272,27490,0,22338,5152,3.03537e+18,1564.48,6452.36,27490,486,389,24867,20830,23705,23607,22339
30485,1128,2355,14437,16048,0,30485,5.0584e+18,1466.24,6589.06,30485,547,399,26070,23412,13039,11373,17857
34006,600,2203,16961,17045,0,34006,5.11648e+18,1403.42,6676.29,34006,493,401,27755,24153,10046,9967,9420
45404,214,1376,16057,29347,0,45404,3.87646e+13,1125.47,6075.84,45404,487,395,36940,33539,14000,6902,9685
833,128,314,389,444,0,833,5.34131e+18,108.172,469.657,833,79,70,489,359,174,130,241
17326,139,350,0,17326,16536,790,2.5041e+16,226.429,1654.65,17326,107,113,16719,16448,14304,12809,10678
15010,1584,2532,12274,2736,7077,7933,7.7418e+17,1224.89,5068.36,15010,381,311,12013,10795,9620,9781,9061
6997,729,2045,5783,1214,3557,3440,7.49238e+17,346.069,3129.27,6997,269,195,4952,4509,3432,3499,2151
518,14,193,177,341,0,518,3.85884e+13,48.473,290.83,518,60,57,186,100,59,38,49
2219,369,758,1148,1071,1148,1071,5.43344e+18,93.9572,1157.72,2219,114,110,1461,1461,1342,1245,943
48496,2192,2716,48496,0,39865,8631,3.14094e+18,1747.35,8794.65,48496,620,476,45780,45541,44027,43315,43966
31185,943,1873,0,31185,0,31185,2.52284e+18,1372.6,6088.93,31185,454,405,26875,23682,14161,12737,17916
35580,936,2076,28408,7172,16934,18646,8.48413e+17,1657.82,7106.63,35580,509,435,29104,24627,19753,18618,17340
39628,2000,2084,19992,19636,0,39628,5.11655e+18,1422.65,7000.78,39628,511,425,37544,37544,37109,36885,37104
14163,459,1759,0,14163,0,14163,2.50887e+18,963.426,4020.99,14163,321,302,11106,9909,4669,3841,4479
8636,1728,1811,4451,4185,0,8636,4.94905e+18,422.846,3119.75,8636,293,209,6825,6669,6717,6709,6704
2683,127,996,2168,515,1384,1299,8.77482e+17,146.902,1420.38,2683,151,130,1474,668,739,738,61
7725,514,1817,4112,3613,0,7725,4.98168e+18,300.117,2953.39,7725,265,231,5908,5451,3053,2765,1907
39016,231,351,0,39016,36887,2129,2.67557e+16,305.25,2579.81,39016,147,156,38107,37257,33771,30651,29418
12789,85,1463,0,12789,4540,8249,9.63397e+15,631.907,3177.08,12789,325,243,9650,8231,4337,2191,1249
42401,309,2454,0,42401,0,42401,2.45832e+18,1461.36,7457.04,42401,580,432,33091,29211,12026,7772,7786
6043,46,1117,0,6043,2212,3831,9.97651e+15,201.147,1981.55,6043,223,142,4121,3385,2167,859,381
37048,440,2368,19415,17633,0,37048,4.98638e+18,1419.44,6903.78,37048,563,396,29829,26490,11983,12435,9024
44878,2138,2501,23800,21078,0,44878,5.03159e+18,1472.41,7686.05,44878,602,436,42377,42376,38898,38377,40434
10728,916,1388,0,10728,3847,6881,1.00329e+16,585.598,2931.11,10728,259,242,9340,8737,6959,6544,7685
45212,1515,1832,37450,7762,44341,871,3.84076e+18,400.585,5807.91,45212,459,232,43380,43380,42326,42250,32365
16037,101,350,0,16037,15315,722,2.4843e+16,203.084,1584.61,16037,103,111,15397,15144,12611,10810,8957
14205,494,684,13930,275,14205,0,4.61632e+18,373.674,2316.85,14205,191,160,13477,13216,12351,12414,11887
19285,1914,2091,10449,8836,10449,8836,4.91231e+18,1036.52,4785.05,19285,424,297,17194,17188,16275,16253,16427
7195,686,1631,0,7195,0,7195,2.56147e+18,395.761,2777.88,7195,228,241,5564,5071,2709,2508,2953
37092,2989,3643,18067,19025,0,37092,4.94689e+18,1157.7,8335.9,37092,531,432,33449,33449,32278,32052,31952
40780,1407,2578,40780,0,33553,7227,3.17883e+18,1710.79,7992.55,40780,587,460,35869,30350,30493,28606,25981
2195,4,35,2126,69,2051,144,8.09164e+13,12.0301,196.456,2195,18,22,1818,1605,1578,1574,1317
48623,2096,8229,42084,6539,23579,25044,5.64139e+17,681.099,13807.6,48623,1334,978,40394,39815,22809,18135,8915
34070,1009,1538,0,34070,12077,21993,9.75581e+15,1081.51,5396.38,34070,433,354,31522,28471,21994,17046,23735
4677,819,1022,1639,3038,0,4677,3.85812e+13,130.343,1756.09,4677,199,175,3655,3655,3341,3365,3126
4936,316,1404,2244,2692,0,4936,4.78666e+18,207.782,2171.48,4936,238,160,3532,3121,1282,967,1024
4588,217,1337,2168,2420,0,4588,4.99341e+18,208.749,2058.52,4588,207,156,3157,2590,1094,852,731
21382,96,2365,21382,0,17804,3578,3.27269e+18,1425.2,5646.17,21382,458,344,12560,8540,5508,4733,1057
14523,168,1462,5125,9398,0,14523,3.73557e+13,701.013,3396.83,14523,367,254,11763,10883,5224,4927,2697
46501,3,43,44966,1535,46484,17,1.04301e+14,29.9353,945.901,46501,36,33,36143,31634,29583,29892,20383
31151,112,1975,15099,16052,15099,16052,4.94128e+18,1363.18,6189.65,31151,470,393,20254,13836,6226,6366,2393
5996,787,1522,3205,2791,0,5996,4.93891e+18,295.41,2444.01,5996,252,198,4474,4247,3125,2963,3101
44422,215,356,0,44422,41897,2525,2.73603e+16,312.086,2773.84,44422,157,165,43263,42199,37723,33728,32442
12410,821,1455,4417,7993,0,12410,3.7716e+13,591.111,3106.19,12410,316,240,10872,10208,8137,7910,8561
22617,1795,2088,11659,10958,0,22617,5.01014e+18,1266.11,5300.88,22617,448,338,20529,18334,17651,17055,18901
19384,724,2116,9935,9449,9935,9449,4.85131e+18,1147.97,4924.39,19384,441,318,15898,14108,7921,8099,7721
42264,454,815,41451,813,42264,0,4.60545e+18,528.079,4078.3,42264,257,246,40896,39667,32523,32526,28069
43648,18,44,41217,2431,43229,419,1.06643e+14,39.8741,948.494,43648,43,42,42864,42244,34909,34628,25498
41890,27,1781,19729,22161,0,41890,5.112e+18,1453.47,6956.31,41890,529,435,17262,8404,3938,3687,726
14052,1027,1448,0,14052,4984,9068,9.64976e+15,745.943,3413.16,14052,309,245,12341,11566,9305,7991,10296
46411,2102,2589,38463,7948,23930,22481,7.49141e+17,1850.23,8512.86,46411,649,457,43626,36711,38685,37249,41376
45376,213,367,0,45376,42880,2496,2.70757e+16,303.904,2823.52,45376,151,162,44228,43160,38518,34460,32537
20905,871,1742,0,20905,0,20905,2.53674e+18,1176.89,4846.55,20905,377,340,17709,15658,9235,7931,10881
31291,290,604,30972,319,31291,0,4.76571e+18,485.593,3341.52,31291,228,226,29615,28221,19261,19232,16597
17691,233,343,0,17691,16756,935,2.6402e+16,251.89,1714.41,17691,108,108,17194,16888,15517,14655,13242
15420,1096,2345,15420,0,12603,2817,3.11575e+18,1131.86,4927.05,15420,351,300,12281,10852,9183,8583,7657
10800,934,1394,3783,7017,0,10800,3.71835e+13,599.279,2967.01,10800,281,222,9406,8741,7052,7097,7563
38652,117,1826,13726,24926,0,38652,3.72491e+13,1125.63,5919.01,38652,551,353,30169,26350,12609,9226,4571
48373,96,2094,38706,9667,23030,25343,8.40139e+17,1762.61,8323.84,48373,573,473,26056,15378,10403,9745,2930
22721,1102,1584,0,22721,8052,14669,9.54619e+15,979.6,4413.38,22721,418,301,20663,19016,15660,11324,15259
12372,596,1504,0,12372,4367,8005,9.33841e+15,578.399,3151.41,12372,323,201,10533,9967,6817,5364,6808
9970,299,349,0,9970,9407,563,2.72981e+16,188.506,1308.44,9970,98,96,9621,9472,9207,8950,8790
20402,1890,2063,20402,0,16303,4099,3.06616e+18,1459.67,5425.02,20402,381,363,18233,15296,17928,17944,17715
19339,1331,1875,9647,9692,0,19339,5.10762e+18,1125.58,4775.7,19339,361,325,17144,15186,12119,11099,14345
9280,14,43,8837,443,9069,211,9.84862e+13,29.829,433.851,9280,35,31,9013,8823,7411,7251,6013
7223,207,344,0,7223,6863,360,2.59779e+16,84.4133,1083.68,7223,72,68,6879,6842,6350,6219,5046
25013,796,2218,12836,12177,0,25013,4.99451e+18,1275.45,5659.95,25013,468,355,20970,18769,10018,9642,9884
39337,86,2148,20232,19105,0,39337,5.06738e+18,1472.17,7002.41,39337,522,424,24757,17855,9098,6702,2272
15443,847,1985,8114,7329,0,15443,5.02283e+18,927.469,4290.22,15443,349,293,12689,11773,7922,7069,6104
3580,6,43,3358,222,3574,6,1.06379e+14,25.7631,284.553,3580,29,28,3093,2816,2263,2284,1518
41835,29,42,39652,2183,41154,681,1.02841e+14,38.3596,917.881,41835,42,41,41648,41515,37532,37563,33818
15289,428,1679,5357,9932,0,15289,3.80399e+13,884.094,3883.96,15289,375,280,12494,11353,5293,5312,5266
14409,289,721,14117,292,14409,0,4.73357e+18,422.024,2378.5,14409,207,157,13341,12662,9137,9162,6839
8836,1526,1842,4938,3898,0,8836,5.03752e+18,293.042,3081.97,8836,248,191,6994,6894,6677,6633,6128
15685,1266,2382,13150,2535,8326,7359,7.12909e+17,1102.72,4821.71,15685,392,288,12656,11503,10332,10171,7462
39798,446,2179,20487,19311,20487,19311,4.90675e+18,1531.68,7070.3,39798,573,421,31963,28165,11395,12443,11075
10980,247,351,0,10980,10371,609,2.73203e+16,183.182,1363.36,10980,86,92,10590,10440,9764,9341,9257
49241,650,869,48703,538,49241,0,4.71843e+18,590.376,4565.19,49241,308,258,48326,47740,45769,45912,45570
16584,33,1325,0,16584,5850,10734,9.81411e+15,853.576,3629.28,16584,331,277,9779,7147,3508,2559,1115
2466,30,35,2315,151,2461,5,1.03185e+14,23.0507,218.324,2466,27,24,2431,2424,2305,2304,2323
38227,33,838,37395,832,38227,0,4.55548e+18,545.097,3914.55,38227,281,236,21660,12177,8423,7541,2131
3366,120,1110,2832,534,1833,1533,6.95222e+17,129.839,1664.1,3366,164,154,1995,1150,945,1124,444
2305,194,538,807,1498,0,2305,4.00587e+13,93.7531,907.575,2305,104,111,1767,1702,916,1133,976
33664,2221,2254,17382,16282,17382,16282,4.87455e+18,1399.62,6526.02,33664,571,389,31410,31410,31367,31324,30920
24880,244,1673,0,24880,8874,16006,9.58255e+15,1003.87,4662.46,24880,436,313,20556,18960,9318,5820,5505
21398,1150,1395,7590,13808,0,21398,3.83241e+13,944.018,4182.1,21398,373,299,19707,17890,16108,16044,18025
24010,173,357,0,24010,22918,1092,2.51317e+16,258.856,1974.06,24010,117,129,23297,22842,20480,18290,16088
36893,444,2067,29432,7461,17464,19429,8.48055e+17,1655.9,7226.58,36893,519,439,27387,23127,14035,14316,8543
30537,545,696,30038,499,30537,0,4.61791e+18,506.033,3384.27,30537,243,218,29753,28950,26851,26877,26869
29621,1719,2622,24822,4799,15739,13882,7.17612e+17,1568.35,6786.13,29621,555,387,26421,22626,21865,21802,21120
40252,343,1940,19816,20436,19816,20436,4.97563e+18,1460.62,6969.89,40252,545,418,31268,27616,9760,10210,8698
49415,23,43,47082,2333,48125,1290,9.92328e+13,42.0518,1015.01,49415,43,41,48958,48599,42507,42364,34153
37282,1188,2356,0,37282,0,37282,2.43564e+18,1391.17,6861.82,37282,595,398,33317,29600,19822,17730,21914
47219,235,357,0,47219,45029,2190,2.51506e+16,305.225,2757.09,47219,144,158,46315,45442,41801,38637,35217
41736,171,358,0,41736,39846,1890,2.49723e+16,291.8,2583.3,41736,139,153,40624,39795,35510,31047,27340
34536,782,1823,12216,22320,0,34536,3.70133e+13,1099.52,5633.56,34536,533,350,30861,28257,18685,18263,17475
47623,2441,2859,38852,8771,22836,24787,7.841e+17,1866.7,9141.79,47623,669,474,44764,44681,41132,40269,44213
43327,109,2349,22964,20363,22964,20363,4.93791e+18,1467.86,7397.62,43327,591,422,29446,22109,11322,11099,3001
46304,31,43,43968,2336,45374,930,1.0207e+14,41.855,987.081,46304,43,42,46097,45957,41997,41929,38291
45469,1658,2445,41368,4101,40784,4685,4.31411e+18,460.168,6667.05,45469,406,370,43024,43024,41435,36859,16374
38722,1582,1778,0,38722,13745,24977,9.55016e+15,1122.68,5874.52,38722,539,361,36944,36944,34675,33524,36493
42015,1705,2086,20956,21059,20956,21059,4.96686e+18,1441.16,7202.49,42015,544,432,39929,34621,32432,31502,37846
38653,29,43,36828,1825,37621,1032,9.91461e+13,38.8929,892.429,38653,42,40,38456,38328,34759,34722,30403
47580,1878,7965,41103,6477,21031,26549,6.21293e+17,1251.04,14240.4,47580,771,812,39615,37326,23221,20882,16084
32459,692,2093,16692,15767,0,32459,5.08906e+18,1349.37,6310.83,32459,477,402,27128,23863,12971,12202,13438
26917,301,2159,21779,5138,13167,13750,8.10006e+17,1569.44,6282.99,26917,454,386,18931,15748,8650,9629,4902
13188,172,2265,10770,2418,6523,6665,7.86617e+17,1058.94,4444.97,13188,329,270,8619,5846,3920,4317,1185
22396,1648,2321,22396,0,18522,3874,3.22393e+18,1432.68,5737.65,22396,452,346,19478,16986,18630,17807,16697
28418,359,2383,23310,5108,14305,14113,7.75167e+17,1627.14,6584.52,28418,491,391,20689,17690,9983,10857,4419
39071,230,2580,20549,18522,20549,18522,4.90639e+18,1426.39,7314.34,39071,634,411,29354,25617,10926,11817,5406
45765,38,43,43392,2373,44930,835,1.02725e+14,40.9428,984.157,45765,43,42,45683,45632,44936,45000,42296
34529,45,2414,34529,0,28259,6270,2.99209e+18,1652.09,7309.56,34529,507,424,15503,8869,6343,6369,1028
39149,214,351,0,39149,36962,2187,2.73366e+16,304.054,2600.69,39149,148,156,38128,37192,33351,29893,27749
21947,229,360,0,21947,20832,1115,2.65944e+16,252.984,1943.43,21947,121,126,21346,20938,19132,17739,16729
33189,1005,1731,0,33189,11754,21435,9.49304e+15,1089.68,5412.6,33189,529,337,30426,27798,20956,15025,23295
40027,331,2782,33468,6559,21093,18934,7.16856e+17,1706.4,7981.25,40027,629,424,29325,25341,14583,16150,5990
37630,720,1825,0,37630,13352,24278,9.51992e+15,1107.53,5859.13,37630,549,366,33415,30717,19862,13213,17194
7443,201,1428,2631,4812,0,7443,3.68232e+13,176.199,2444,7443,249,189,5943,5527,2975,2419,1251
6746,637,1186,2357,4389,0,6746,3.72895e+13,163.982,2125.82,6746,266,179,5560,5502,4282,4413,3157
24238,1018,2096,12979,11259,0,24238,5.00623e+18,1223.91,5402.73,24238,448,339,20778,18841,12743,11595,12938
23377,557,766,23081,296,23377,0,4.74931e+18,479.704,3084.29,23377,252,208,22599,22198,21468,21458,21329
24174,73,1333,0,24174,8582,15592,1.00134e+16,996.55,4398.15,24174,365,330,17015,13666,6130,4510,2438
8646,1753,2146,7334,1312,4768,3878,6.83525e+17,347.903,3405.24,8646,297,236,6500,6369,6330,6276,5677
21330,916,2317,17592,3738,10946,10384,7.58989e+17,1415.31,5601.12,21330,422,347,17075,15040,12045,11406,9952
3116,351,838,0,3116,1052,2064,8.58048e+15,101.514,1329.76,3116,173,120,2278,2228,1497,1486,1227
46620,1094,2243,0,46620,0,46620,2.46651e+18,1482.61,7670.14,46620,590,443,41518,36515,22274,19119,27801
31261,2052,2441,31261,0,25905,5356,3.06888e+18,1652.75,6886.08,31261,505,400,28727,24457,27719,27882,26853
14724,2289,2337,12362,2362,7839,6885,7.10481e+17,1038.3,4640.88,14724,366,273,12387,12387,12331,12347,11893
24398,735,1491,0,24398,8587,15811,9.68129e+15,996.099,4543.23,24398,385,312,21594,19781,13066,9968,13554
40223,221,354,0,40223,38312,1911,2.53384e+16,302.371,2550.17,40223,137,149,39362,38551,35245,32443,29134
46175,206,1368,0,46175,16363,29812,9.94395e+15,1134.02,6098.29,46175,491,399,37362,33748,14053,11108,9685
39614,1581,2118,19887,19727,19887,19727,4.98926e+18,1432.77,7026.86,39614,531,434,37207,31907,26902,25403,32876
31351,1195,2531,25269,6082,15252,16099,8.20761e+17,1526.68,7069.52,31351,496,418,26611,22706,18466,17516,15604
1523,496,640,0,1523,0,1523,2.59829e+18,86.7623,891.951,1523,123,108,883,883,732,730,760
44821,1113,2504,36460,8361,22151,22670,7.94905e+17,1727.65,8334.87,44821,591,465,38015,32173,27964,26983,23361
33029,102,839,32407,622,33029,0,4.59572e+18,508.392,3642.1,33029,287,217,26525,19453,10797,9720,5600
34512,42,43,32857,1655,33587,925,9.90858e+13,40.5647,848.353,34512,42,39,34465,34441,34373,34372,33914
38897,29,43,37105,1792,37805,1092,9.80827e+13,39.6142,894.809,38897,42,40,38699,38567,35052,35016,29980
20608,61,386,0,20608,19449,1159,2.70706e+16,281.503,1962.17,20608,123,124,19259,18608,13488,11506,7764
31060,1590,2226,25048,6012,15059,16001,8.24326e+17,1634.99,6801.35,31060,509,407,27662,23227,22472,22002,23241
33627,1770,2392,33627,0,27397,6230,3.15435e+18,1646.3,7181.6,33627,537,434,30634,25565,28708,27675,26816
3190,151,177,0,3190,3055,135,2.41699e+16,30.8257,546.277,3190,47,45,3013,3013,2967,2998,2705
41161,137,798,40104,1057,41161,0,4.49885e+18,572.447,4013.25,41161,274,235,35754,29204,15333,13929,8539
26346,322,1643,9382,16964,0,26346,3.74227e+13,983.574,4739.53,26346,454,315,22253,20525,11330,8992,6613
12259,190,693,11839,420,12259,0,4.4472e+18,359.445,2123.39,12259,185,152,11019,9946,6106,6046,4270
2292,260,860,0,2292,0,2292,2.33822e+18,104.231,1242.01,2292,130,103,1432,1308,762,766,747
48872,903,1890,17386,31486,0,48872,3.74007e+13,1170.53,6670.97,48872,610,389,44652,40883,28252,26045,33758
42373,112,2043,21288,21085,0,42373,5.07291e+18,1485.57,7199.16,42373,564,431,28071,19976,9433,6897,1691
27882,2042,2553,23376,4506,14830,13052,7.08705e+17,1508.26,6499.91,27882,520,369,25329,21693,22537,22002,23260
22140,653,2515,22140,0,18595,3545,3.12789e+18,1338.49,5766.15,22140,425,342,17342,15224,10917,9618,6582
11560,1636,1690,5593,5967,5593,5967,4.96157e+18,812.862,3571.31,11560,302,280,9870,9142,9753,9646,9728
7103,411,647,6892,211,7103,0,4.37542e+18,252.528,1627.83,7103,193,122,6456,6350,5877,5854,5504
46586,750,2141,37259,9327,22217,24369,8.40734e+17,1714.27,8187.48,46586,562,468,37122,30658,23147,22210,19155
36596,539,1947,17895,18701,0,36596,5.07295e+18,1450.18,6658.95,36596,524,425,29678,25943,11248,10340,12129
36971,780,2817,36971,0,30682,6289,3.13081e+18,1761.86,7957.05,36971,595,441,29373,24602,16543,14081,12794
27944,251,837,27101,843,27944,0,4.50558e+18,512.447,3340.26,27944,261,207,25953,24271,13909,13649,10383
13647,15,43,13037,610,13225,422,9.84248e+13,36.9069,534.295,13647,37,35,13328,13108,10916,10617,7990
12218,269,691,11745,473,12218,0,4.37514e+18,345.358,2097.96,12218,208,148,11305,10726,7498,7224,5941
33527,124,792,33166,361,33527,0,4.78125e+18,572.878,3769.85,33527,282,232,27577,20765,11985,11333,6227
4080,28,43,3895,185,3961,119,9.94134e+13,23.6091,303.168,4080,29,28,4027,4011,3721,3714,3512
26790,332,373,0,26790,25474,1316,2.59128e+16,273.564,2147.29,26790,121,129,26392,25870,25805,25322,25526
27981,1936,2854,27981,0,22980,5001,2.88641e+18,1769.07,7195.63,27981,585,398,24521,20590,22610,22500,20801
11372,519,1842,0,11372,0,11372,2.45466e+18,756.904,3632.2,11372,309,269,8905,8099,4047,3686,4358
787,167,281,763,24,787,0,4.99825e+18,70.8348,432.31,787,45,51,506,468,446,444,374
40913,78,2873,34025,6888,21271,19642,7.35979e+17,1731.26,8163.82,40913,636,435,23042,15389,10364,10813,1668
48835,15,43,46668,2167,47309,1526,9.67687e+13,39.2457,997.048,48835,43,41,47745,46941,39008,38042,28276
42817,81,705,42175,642,42817,0,4.65263e+18,530.531,4015.52,42817,261,246,31863,21684,11833,11932,5865
19682,3247,3319,6941,12741,0,19682,3.33895e+13,445.783,5704.24,19682,830,375,16363,16363,16346,16339,16238
40498,183,359,0,40498,38644,1854,2.49991e+16,294.592,2553.53,40498,138,147,39483,38733,34864,31469,27811
39993,1574,2436,21224,18769,21224,18769,4.92024e+18,1448.92,7204.13,39993,607,417,37051,32270,24922,23992,29121
22582,206,2495,0,22582,0,22582,2.46238e+18,1188.22,5828.05,22582,443,355,16039,13019,5214,3018,3126
2861,241,794,0,2861,998,1863,9.39529e+15,89.1681,1245.47,2861,169,111,2067,1994,1249,1028,1012
27599,1555,2287,0,27599,0,27599,2.4204e+18,1237.09,5897.96,27599,491,356,25118,22112,17763,15872,19642
2137,150,457,1477,660,1477,660,5.35173e+18,78.3154,731.704,2137,129,78,1680,1611,1151,1022,213
39055,2439,2534,0,39055,0,39055,2.48172e+18,1567.51,7501.4,39055,543,432,36521,36521,36166,35755,36488
8173,370,2133,8173,0,6828,1345,3.25112e+18,434.659,3390.92,8173,286,227,5802,5153,3044,2903,1340
24276,901,2111,24276,0,19457,4819,3.05693e+18,1582.01,5985.78,24276,436,393,19241,16222,11545,10993,10070
11422,37,43,10894,528,11096,326,9.75382e+13,36.9472,492.303,11422,36,34,11369,11354,10972,10976,10380
30527,389,1706,10842,19685,0,30527,3.73461e+13,1056.18,5193.08,30527,493,330,25976,23886,12205,9945,6729
28343,643,901,27509,834,28343,0,4.60682e+18,513.387,3423.46,28343,288,206,27435,26886,25460,25517,24239
13707,710,1603,4885,8822,0,13707,3.67457e+13,653.361,3403.05,13707,343,219,11767,11042,7944,7736,8354
26445,524,786,25817,628,26445,0,4.54735e+18,493.43,3235.89,26445,241,207,25572,24846,22046,21834,21331
24953,1228,1553,0,24953,8801,16152,9.50243e+15,994.033,4581.58,24953,463,308,23235,21056,18627,15366,19048
48971,2326,2816,40058,8913,24487,24484,7.8639e+17,1756.32,9036.27,48971,599,488,46155,46122,43293,42282,45064
3106,487,746,0,3106,1057,2049,8.87488e+15,87.9977,1264.93,3106,120,115,2360,2339,1869,1959,1830
14605,35,43,13871,734,14278,327,1.0068e+14,35.7677,552.623,14605,36,35,14545,14509,13727,13732,12478
40166,1762,2467,0,40166,0,40166,2.42425e+18,1446.74,7281.17,40166,612,410,37698,32755,27695,24216,33029
872,31,86,0,872,323,549,8.80721e+15,15.0413,178.908,872,50,31,786,782,603,391,30
5741,296,1250,2008,3733,0,5741,3.6727e+13,178.298,2094.23,5741,221,158,4491,4234,2243,1778,1732
16440,260,350,0,16440,15672,768,2.56761e+16,221.615,1621.07,16440,104,101,16006,15799,14955,14363,14359
9173,31,43,8783,390,8860,313,9.63517e+13,25.8212,427.323,9173,33,32,9118,9099,8588,8567,7883
9472,567,774,9209,263,9472,0,4.4002e+18,319.457,1971.55,9472,220,134,8698,8614,8192,8236,7372
6232,385,615,6093,139,6232,0,4.80758e+18,199.733,1507.15,6232,171,118,5617,5530,5045,5062,4029
22790,77,671,22338,452,22790,0,4.62003e+18,486.721,2922.85,22790,208,197,16818,11332,6541,5754,2946
41873,42,43,39788,2085,40969,904,1.01027e+14,40.5478,931.003,41873,43,41,41824,41788,41702,41701,41184
34040,2370,2741,28422,5618,17783,16257,7.26224e+17,1685.28,7375.31,34040,593,405,31299,31080,29619,29354,30493
22177,72,1328,7849,14328,0,22177,3.8778e+13,970.432,4222.88,22177,373,300,15680,12723,5549,2329,1797
5687,1091,1513,0,5687,0,5687,2.53036e+18,284.826,2437.06,5687,216,209,4174,4085,3535,3384,3392
20224,422,1632,7223,13001,0,20224,3.76834e+13,892.551,4196.77,20224,401,289,17168,15862,8880,8530,5312
45139,2110,2460,23386,21753,23386,21753,4.90669e+18,1500.77,7708.94,45139,628,441,42679,42679,38754,38406,41383
29085,215,848,28355,730,29085,0,4.582e+18,524.413,3435.79,29085,266,209,26647,24435,13358,13432,10374
26368,1641,2487,26368,0,22078,4290,3.27368e+18,1513.34,6307.61,26368,512,374,23171,19950,22169,20842,19303
38774,38,44,36589,2185,38390,384,1.06503e+14,42.1634,905.863,38774,43,42,38691,38629,36835,36905,36179
46493,761,866,45638,855,46493,0,4.62069e+18,528.888,4318.5,46493,267,247,45627,45627,44945,44888,44631
45502,800,2901,45502,0,37995,7507,3.31667e+18,1744.02,8600.62,45502,695,461,36841,31415,23337,22075,15459
38247,465,913,37255,992,38247,0,4.49781e+18,531.792,3967.47,38247,306,232,36863,35725,26706,26546,26569
31554,4,43,30017,1537,30804,750,1.00935e+14,38.2912,805.475,31554,41,40,25266,22229,19771,19534,12776
3523,365,416,3465,58,3523,0,4.86148e+18,175.78,1011.29,3523,92,95,3107,3095,3083,3081,3019
20531,1121,1580,7283,13248,0,20531,3.70107e+13,873.793,4132.05,20531,421,283,18736,17295,14218,15016,16006
36641,685,2134,0,36641,0,36641,2.47335e+18,1400.12,6737.11,36641,514,405,30633,26824,13027,12647,13120
30374,264,381,0,30374,28672,1702,2.72204e+16,307.296,2356.3,30374,138,141,29697,29025,26411,24382,23114
13370,757,782,12933,437,13370,0,4.4184e+18,387.649,2319.21,13370,224,155,12588,12588,12576,12579,12581
42484,1017,2744,42484,0,34994,7490,3.08095e+18,1769.19,8289.2,42484,599,451,35232,30231,22229,21126,18150
42704,1587,2133,21557,21147,0,42704,5.08197e+18,1450.54,7275.36,42704,551,433,40302,34560,28857,26789,35660
47336,1117,1794,0,47336,0,47336,2.54339e+18,1473.96,7398.11,47336,540,456,42451,36610,26115,21131,30876
48199,600,1891,17046,31153,0,48199,3.71255e+13,1167.92,6648.02,48199,631,383,42446,38918,23233,18824,21752
41249,2540,2647,20820,20429,20820,20429,4.89023e+18,1462.16,7721.66,41249,657,426,38602,38602,38225,38148,37839
9712,1317,1745,4978,4734,4978,4734,5.00481e+18,678.925,3303.17,9712,281,233,7967,7401,6497,6128,6485
24540,883,1910,12281,12259,12281,12259,4.9842e+18,1266.33,5400.6,24540,398,355,20858,18515,11292,11080,12414
6634,331,1655,3538,3096,3538,3096,4.88313e+18,304.219,2669,6634,260,209,4887,4416,2406,2692,1354
7337,1767,2802,3478,3859,692,6645,3.45812e+18,186.571,3873.83,7337,706,226,4535,4514,4294,4059,3887
43698,179,359,0,43698,41680,2018,2.52692e+16,296.19,2661.3,43698,140,158,42562,41707,37190,33122,28718
9865,28,43,9393,472,9653,212,1.00378e+14,34.5546,452.984,9865,35,32,9790,9762,8949,8957,7623
6154,470,1266,0,6154,2188,3966,9.59722e+15,163.454,2172.71,6154,212,163,4888,4725,3272,2523,2479
16961,80,1403,5978,10983,0,16961,3.77181e+13,848.611,3729.86,16961,362,282,12323,10194,4541,1866,1555
7464,1227,1644,3518,3946,3518,3946,4.95415e+18,516.086,2860.62,7464,253,185,5820,5514,4812,4667,4908
30214,1987,2303,0,30214,0,30214,2.43474e+18,1319.04,6186.29,30214,521,371,27911,27783,24872,24453,25493
19894,4,44,18964,930,19337,557,9.88292e+13,37.721,638.917,19894,39,35,15998,14070,12713,12570,8509
12038,523,2207,10224,1814,6671,5367,6.79123e+17,813.018,4043.63,12038,335,268,9100,8170,5616,5679,3080
13024,727,1280,0,13024,4619,8405,1.00013e+16,736.549,3180.23,13024,290,262,11223,10493,7468,6623,7636
38328,597,2435,20324,18004,20324,18004,4.89999e+18,1437.82,7064.72,38328,605,400,31634,28104,12605,15299,10402
18570,904,2401,18570,0,15591,2979,3.26475e+18,1220.24,5230.15,18570,421,327,14941,13098,10699,9918,7118
21055,1610,1995,10549,10506,0,21055,5.04787e+18,1175.11,5087.79,21055,391,338,19031,16775,15168,14531,17096
13278,416,641,12985,293,13278,0,4.57131e+18,374.772,2195.31,13278,177,159,12537,12262,10531,10637,9540
19762,39,380,0,19762,18833,929,2.49406e+16,230.758,1843.2,19762,111,117,18419,17625,13586,12154,8466
49743,274,890,48665,1078,49743,0,4.57269e+18,557.45,4492.18,49743,320,251,46755,44067,24374,24088,19702
19785,1586,2136,0,19785,0,19785,2.40316e+18,1145.87,4993.15,19785,444,323,17587,15640,13256,12824,15016
19441,70,350,0,19441,18491,950,2.58861e+16,255.643,1783.06,19441,106,116,18458,18055,14141,12106,8767
27490,162,1795,0,27490,0,27490,2.52475e+18,1307.62,5637.58,27490,437,381,19332,14362,5810,2986,3034
20635,1420,2357,17317,3318,11053,9582,7.08931e+17,1362.54,5464.36,20635,448,327,17649,15432,14497,14416,13609
43277,1159,1701,0,43277,15207,28070,9.89552e+15,1264.5,6422.48,43277,569,401,40202,35932,27741,21913,33949
8023,306,1716,4005,4018,0,8023,5.18526e+18,504.933,3015.8,8023,229,248,5922,5252,2311,1975,1748
38485,2700,2774,38485,0,32120,6365,3.30064e+18,1709.54,7857.09,38485,645,441,35711,35711,35710,35707,35697
25847,1523,2069,13431,12416,13431,12416,4.98158e+18,1265.22,5600.33,25847,450,363,23495,20716,17530,16582,21136
12307,322,646,12111,196,12307,0,4.59129e+18,351.574,2127.13,12307,181,151,11498,11112,8237,8313,7187
31642,2853,4385,10788,20854,0,31642,2.45647e+13,394.443,7578.57,31642,1384,267,27257,26829,19952,22658,21011
36001,1350,1555,12735,23266,0,36001,3.79725e+13,1089.75,5550.27,36001,457,366,34446,32442,30945,31057,33626
32744,390,821,32644,100,32744,0,4.69208e+18,423.765,3605.28,32744,276,233,31661,30386,22402,21949,20627
28703,501,1723,0,28703,10131,18572,9.46379e+15,1053.42,5063.04,28703,502,322,24606,22652,13344,9034,13409
49971,494,1945,0,49971,17699,32272,9.48871e+15,1187.36,6810.86,49971,651,385,43259,39606,21554,14705,19637
27404,233,829,26761,643,27404,0,4.5627e+18,526.294,3335.95,27404,265,209,25252,23386,13701,12618,9625
27761,1513,2027,0,27761,0,27761,2.46964e+18,1315.28,5814.18,27761,457,371,25439,22201,18723,17097,21598
44768,1498,1940,0,44768,15951,28817,9.55893e+15,1141.97,6424.29,44768,587,376,42828,42731,35294,29896,41379
16906,670,2010,8864,8042,8864,8042,4.93249e+18,1037.76,4506.26,16906,421,306,13857,12389,7624,7569,6771
26206,827,1631,0,26206,9281,16925,9.46776e+15,977.737,4707.26,26206,451,302,23515,21683,15601,11289,17175
44349,7,43,42285,2064,43120,1229,9.8541e+13,39.4696,952.189,44349,42,41,40665,38234,31693,31601,19915
47654,1099,2093,38168,9486,22760,24894,8.35274e+17,1732.04,8239.18,47654,561,470,40396,33789,29153,27988,26093
22886,5,42,21693,1193,22460,426,1.02894e+14,37.1692,675.236,22886,38,36,19525,17559,14944,15129,9575
13463,946,2335,11362,2101,7306,6157,7.03561e+17,956.158,4410.66,13463,335,279,10556,9613,7900,7725,5402
44308,1122,1369,0,44308,15660,28648,9.90263e+15,1131.34,5982.61,44308,489,388,42061,37036,32446,26787,37514
28114,1136,1557,9994,18120,0,28114,3.79165e+13,1026.27,4903.56,28114,420,326,26185,23619,19528,19451,22288
22781,38,351,0,22781,21725,1056,2.52349e+16,255.283,1908.93,22781,115,119,21211,20202,15720,13574,8706
43718,2469,2868,43718,0,36598,7120,3.32846e+18,1739.94,8412.33,43718,683,456,40850,40850,40310,40358,39719
46112,242,361,0,46112,43631,2481,2.67857e+16,313.204,2836.09,46112,152,164,45114,44111,40135,36603,36638
42770,444,3032,42770,0,35740,7030,3.27959e+18,1755.17,8476.1,42770,654,452,32298,28156,16997,13204,9256
2252,578,692,0,2252,808,1444,9.74383e+15,84.8899,1065.39,2252,164,110,1560,1560,1444,1317,1410
29193,38,40,27653,1540,29184,9,1.02339e+14,36.7417,762.479,29193,38,38,29152,29144,29144,29143,29025
47425,40,1524,16766,30659,0,47425,3.83281e+13,1135.16,6348.23,47425,516,399,29789,22631,11552,3649,2972
43598,10,43,41547,2051,42483,1115,9.9412e+13,41.1055,951.743,43598,43,41,41448,39928,32840,32232,21425
6183,177,1237,0,6183,2166,4017,9.18572e+15,130.917,2084.88,6183,225,141,4885,4570,2645,2792,1850
45937,647,2444,23918,22019,23918,22019,4.92806e+18,1479.7,7772.35,45937,591,439,38373,33660,15264,18059,14239
42752,408,1869,0,42752,15123,27629,9.49027e+15,1153.44,6272.67,42752,584,371,36479,33571,17240,11441,14353
40321,672,2079,14328,25993,0,40321,3.71074e+13,1111.95,6284.82,40321,576,361,35530,32857,20111,18873,21850
7801,184,605,7760,41,7801,0,4.57708e+18,252.305,1691.4,7801,149,139,6928,6075,3974,3868,2528
34115,447,1353,12036,22079,0,34115,3.86214e+13,1083.5,5232.95,34115,441,360,29199,26467,14220,10567,13533
44295,384,1400,15698,28597,0,44295,3.89405e+13,1138.28,6038.42,44295,482,396,37536,34053,17256,11611,16263
18476,1959,2058,9468,9008,0,18476,5.11368e+18,1132.86,4859.82,18476,360,319,16418,16418,15950,15601,15968
26348,922,2239,13552,12796,0,26348,4.96434e+18,1294.44,5804.09,26348,501,362,22496,20104,11880,10926,12209
34547,1646,1885,0,34547,0,34547,2.49047e+18,1414.4,6411.37,34547,502,402,32539,28054,26255,25725,30606
32588,500,917,31695,893,32588,0,4.58819e+18,529.109,3676.03,32588,265,218,31410,30478,25700,25394,20457
43830,146,1751,0,43830,0,43830,2.54379e+18,1440.6,7045.26,43830,514,443,30130,21192,8137,4518,4972
1933,22,790,0,1933,0,1933,2.40961e+18,89.3306,1094.69,1933,149,113,664,313,184,160,85
44494,31,2464,0,44494,0,44494,2.45923e+18,1462.62,7611.15,44494,595,436,22483,14956,8702,4666,917
14536,306,1514,5171,9365,0,14536,3.75452e+13,713.968,3459.22,14536,355,246,12100,11241,5902,5409,3069
12390,878,1983,0,12390,0,12390,2.37896e+18,761.037,3817.4,12390,341,242,10128,9273,6378,6087,6595
32725,2230,2249,15551,17174,15551,17174,4.95366e+18,1493.63,6701.48,32725,559,396,30476,30476,30424,30374,30472
26818,1802,2565,26818,0,22303,4515,3.2799e+18,1576.74,6490.61,26818,540,369,23827,20393,22916,22118,18915
38917,45,353,0,38917,37107,1810,2.54259e+16,293.411,2507.59,38917,137,143,36571,35053,27089,23378,15384
25688,1305,1727,9137,16551,0,25688,3.70546e+13,1022.72,4804.52,25688,467,316,23838,21674,18922,18706,21787
2821,591,740,998,1823,0,2821,3.90662e+13,102.486,1192.86,2821,151,128,2081,2067,1776,1863,1795
22814,2062,2140,12061,10753,0,22814,4.99893e+18,1213.45,5295.36,22814,458,339,20674,20674,20596,20557,20623
14850,1892,2019,7806,7044,7806,7044,4.8509e+18,891.772,4206.94,14850,378,285,12831,12831,12239,12192,12827
45601,341,374,0,45601,43148,2453,2.72676e+16,321.965,2861.2,45601,155,167,45129,44125,43548,41766,43246
5799,1077,1441,3184,2615,0,5799,5.09196e+18,172.395,2303.4,5799,202,162,4358,4354,4198,4199,3102
23858,48,352,0,23858,22775,1083,2.502e+16,253.024,1945.68,23858,116,126,22482,21670,16820,14776,10232
36575,272,354,0,36575,34827,1748,2.55566e+16,289.695,2440.69,36575,133,147,35948,35229,33013,31082,30416
34972,444,2427,34972,0,28473,6499,2.97901e+18,1652.31,7386.45,34972,524,438,25912,22129,12472,10940,7973
35206,1141,2707,35206,0,29233,5973,3.32121e+18,1718.07,7511.14,35206,631,434,29573,25255,23423,22041,18790
38926,62,2767,38926,0,32493,6433,3.31576e+18,1708.27,7892.67,38926,666,450,20797,13423,8900,8378,823
33249,133,353,0,33249,31655,1594,2.53933e+16,290.845,2329.21,33249,130,140,32144,31574,26866,23432,19431
13157,48,1711,6272,6885,0,13157,5.11658e+18,952.867,3870.28,13157,305,284,6569,3805,1785,1413,483
40374,1547,2316,0,40374,0,40374,2.4314e+18,1470.84,7166.11,40374,593,415,37481,32524,25289,21152,30519
35140,1847,2298,18660,16480,18660,16480,4.92846e+18,1378.85,6654.18,35140,562,384,32842,32711,27167,26256,30340
3244,604,1102,1445,1799,0,3244,4.44052e+18,101.743,1629.02,3244,156,121,2142,2119,1509,1524,1443
35638,1945,2396,18542,17096,18542,17096,4.93058e+18,1412.42,6837.48,35638,552,406,33242,33120,27892,26928,30664
35383,116,356,0,35383,33382,2001,2.73971e+16,304.084,2492.3,35383,144,156,33875,33043,26428,22711,18641
8774,32,43,8343,431,8563,211,9.97709e+13,29.3758,423.679,8774,33,31,8719,8696,8328,8339,8215
15456,755,2337,12484,2972,7400,8056,8.22242e+17,1239.6,4952.55,15456,378,332,11882,9949,6738,7016,5264
44846,316,1385,15793,29053,0,44846,3.87362e+13,1094.89,5987.62,44846,478,394,37663,34120,16342,9879,13035
37784,742,1556,0,37784,13317,24467,9.91969e+15,1160.11,5767.14,37784,475,376,33785,30760,19287,14772,20803
9757,789,1426,3442,6315,0,9757,3.74656e+13,529.605,2840.84,9757,278,212,8331,7775,5738,6023,5788
20168,163,2249,10148,10020,10148,10020,4.96847e+18,1170.88,5235.1,20168,393,332,14052,10627,4706,4790,2232
17126,1217,1525,0,17126,6056,11070,9.56973e+15,855.566,3783.46,17126,354,274,15427,14290,12658,10840,14400
17590,37,43,16756,834,17131,459,9.87166e+13,35.4462,597.054,17590,37,35,17537,17514,16977,16980,16189
39247,1865,1874,0,39247,13953,25294,9.50422e+15,1127,5979.8,39247,571,358,37373,37373,37363,37372,37373
27536,179,1788,0,27536,9710,17826,9.52692e+15,1125.84,5137.47,27536,441,333,21925,19699,8698,5992,4394
38198,1993,2026,19107,19091,19107,19091,4.97508e+18,1423.54,6825.48,38198,499,416,36172,36172,36090,36023,36168
25696,483,2094,13000,12696,0,25696,4.95472e+18,1315.64,5646.59,25696,468,356,20605,18310,7939,8185,7372
23347,188,1670,8300,15047,0,23347,3.71651e+13,946.358,4519.18,23347,452,299,18932,17347,8087,6445,3190
22113,330,350,0,22113,21088,1025,2.52934e+16,252.493,1878.31,22113,110,121,21748,21363,21521,21569,21224
2282,668,1054,1870,412,1056,1226,7.5474e+17,100.808,1408.4,2282,127,126,1228,1196,1013,994,781
27476,1006,1712,9760,17716,0,27476,3.73889e+13,1052.66,4964.69,27476,433,326,25060,22828,16866,16676,16997
24207,316,351,0,24207,23035,1172,2.53975e+16,264.472,1977.44,24207,115,123,23799,23365,23042,22078,22557
16332,1204,1700,7916,8416,0,16332,5.1931e+18,1085.59,4263.97,16332,325,308,14203,12568,9469,8384,11145
32193,111,2619,26878,5315,16942,15251,7.2574e+17,1623.04,7069.36,32193,551,394,19789,13740,9568,9972,2593
15202,206,686,14927,275,15202,0,4.66418e+18,421.425,2409.8,15202,182,172,13776,12513,7618,7153,5327
47414,1641,1669,16793,30621,0,47414,3.79462e+13,1143.35,6472.13,47414,518,393,45745,45745,45720,45737,45745
49016,283,937,47658,1358,49016,0,4.61817e+18,709.184,4553.21,49016,316,253,45944,43219,26685,25699,18631
5631,329,1479,2609,3022,0,5631,4.95023e+18,230.062,2366.05,5631,204,178,4142,3800,1751,1432,1369
26054,393,861,25375,679,26054,0,4.4934e+18,530.227,3276.29,26054,290,207,24718,23851,16589,16484,13241
1321,343,483,1321,0,1005,316,2.61939e+18,137.454,723.329,1321,89,89,838,838,748,724,721
589,167,303,400,189,182,407,1.12413e+18,32.1392,381.554,589,63,56,286,281,217,195,186
32355,88,2329,17037,15318,0,32355,4.97401e+18,1376.61,6443.13,32355,511,383,20974,15687,8182,5407,1622
32737,2659,2679,32737,0,27315,5422,3.31026e+18,1657.82,7190.15,32737,579,411,30058,30058,30040,30038,30054
19172,302,1935,0,19172,0,19172,2.4707e+18,1147.37,4817.05,19172,379,327,14538,12685,4406,2837,2709
12893,40,42,12219,674,12661,232,1.02347e+14,34.5063,511.942,12893,36,33,12849,12842,12814,12813,12659
47177,2246,2686,47177,0,38930,8247,3.11029e+18,1772.03,8643.65,47177,706,472,44491,44324,43448,43550,43321
42434,546,932,41373,1061,42434,0,4.62701e+18,629.279,4224.19,42434,314,237,41216,39957,35419,35119,29674
11654,227,346,0,11654,11102,552,2.55362e+16,165.164,1349,11654,90,94,11285,11144,10482,10024,9927
33998,1138,2811,33998,0,28225,5773,3.27473e+18,1659.23,7473.62,33998,589,423,28542,24445,21726,20509,16067
23574,525,2104,23574,0,18905,4669,2.9292e+18,1501.77,5847.69,23574,428,371,17600,14788,8043,6950,6252
35925,9,43,33894,2031,35550,375,1.06933e+14,41.2364,881.554,35925,43,41,33408,31764,25338,25319,16375
1744,43,518,0,1744,0,1744,2.5918e+18,128.706,837.518,1744,86,93,754,444,211,183,158
45724,659,2527,37343,8381,22808,22916,7.85184e+17,1734.78,8443.48,45724,603,467,35957,30340,21048,21020,13438
24285,353,670,23985,300,24285,0,4.81951e+18,481.468,3046.41,24285,224,210,23049,22144,18067,17634,14820
9047,41,351,0,9047,8534,513,2.73831e+16,160.156,1235.28,9047,87,89,8313,7886,5667,5002,3404
21208,36,43,20158,1050,20740,468,1.01041e+14,38.8976,666.124,21208,39,37,21141,21099,20180,20188,18795
29376,1166,2425,29376,0,23831,5545,2.95498e+18,1598.42,6873.23,29376,466,400,24440,21008,18407,16947,15975
35766,22,43,34177,1589,34646,1120,9.69497e+13,39.6485,855.516,35766,42,39,35419,35103,30433,30332,26081
47014,328,825,46257,757,47014,0,4.64371e+18,529.817,4300.04,47014,296,244,44794,42867,26543,25924,24353
29764,599,1704,10582,19182,0,29764,3.73245e+13,1037.18,5118.36,29764,482,331,25996,23979,15262,12198,11267
33600,579,933,32636,964,33600,0,4.61056e+18,545.394,3744.41,33600,298,218,32575,31662,28973,28830,26676
33357,1012,2390,26874,6483,15966,17391,8.21917e+17,1698.49,7258.63,33357,508,428,27217,23415,18183,17377,16291
7000,271,1725,3716,3284,3716,3284,4.89513e+18,300.486,2779.04,7000,269,218,5121,4546,2420,2612,1221
22790,12,797,22158,632,22790,0,4.5547e+18,502.492,3010.11,22790,249,196,7778,1936,1930,2430,419
28626,2085,2246,14669,13957,14669,13957,4.87221e+18,1329.91,6046.79,28626,516,374,26380,26379,25170,25046,25669
21314,706,2367,21314,0,17755,3559,3.30612e+18,1386.13,5580.48,21314,447,345,16775,14600,10725,9599,6567
34020,89,355,0,34020,32497,1523,2.49872e+16,271.405,2319.31,34020,129,141,32678,32078,26040,22669,17568
34426,3,42,32520,1906,34052,374,1.06643e+14,39.7628,841.737,34426,41,40,24336,20251,18192,18714,12035
3099,35,36,2987,112,2944,155,9.30987e+13,23.1813,232.88,3099,24,22,3063,3063,3063,3062,3062
46182,348,356,0,46182,43561,2621,2.72756e+16,318.008,2831.88,46182,154,171,45798,44798,45631,44894,45364
25183,1540,2136,13155,12028,13155,12028,4.94996e+18,1266.53,5575.3,25183,474,349,22786,20170,16717,15868,19283
12006,12,43,11328,678,11879,127,1.07025e+14,36.7516,503.918,12006,36,33,11494,11142,9012,8836,6641
7922,1258,1639,3816,4106,0,7922,5.15948e+18,495.795,2904.71,7922,235,248,6283,6008,5088,4907,5270
30459,34,43,29276,1183,29212,1247,9.20418e+13,38.2165,777.458,30459,40,37,30372,30303,28945,28956,27129
46741,19,43,44420,2321,45660,1081,1.00562e+14,41.3123,986.713,46741,43,41,46036,45493,38454,38193,30112
41862,1214,2444,21811,20051,21811,20051,4.90464e+18,1484.02,7413.65,41862,604,424,37464,32954,21305,22270,25460
3121,82,400,3097,24,3121,0,4.93898e+18,179.088,937.27,3121,91,91,2216,1434,961,962,660
49963,247,1953,0,49963,17680,32283,9.43624e+15,1179.97,6806.98,49963,678,384,41585,38291,17244,11052,9862
31690,10,43,30206,1484,30846,844,9.8894e+13,41.1,810.94,31690,42,38,30133,29036,23933,23415,15397
35070,299,1669,12398,22672,0,35070,3.74956e+13,1129.55,5584.6,35070,501,352,29275,26874,12230,10187,10819
668,108,330,229,439,229,439,3.91476e+18,33.1856,420.915,668,48,53,338,313,120,185,119
2595,616,834,1378,1217,0,2595,4.98283e+18,69.1869,1267.2,2595,144,112,1761,1758,1624,1526,1328
38870,400,888,38085,785,38870,0,4.60564e+18,529.073,3975.59,38870,276,232,37278,35993,26167,26004,21374
30544,28,42,29122,1422,29707,837,9.86787e+13,38.0213,776.779,30544,40,38,30389,30291,27426,27479,24310
40339,1643,2479,33266,7073,20653,19686,7.58374e+17,1748.08,7825.38,40339,582,434,36441,30739,29461,29198,28978
40295,640,874,39240,1055,40295,0,4.59049e+18,563.736,4040.72,40295,290,236,39402,38447,36357,36489,34352
1942,4,30,1850,92,1882,60,1.05662e+14,15.8893,176.842,1942,21,20,1569,1381,1211,1213,970
40647,1317,4471,33525,7122,20625,20022,7.6783e+17,1309.76,9717.85,40647,514,472,34457,30863,25218,25365,19718
42121,43,2171,21214,20907,0,42121,5.03577e+18,1454.85,7251.95,42121,553,431,21903,14060,7470,6093,1010
5702,30,36,5409,293,5620,82,1.05985e+14,23.5686,319.027,5702,29,27,5662,5654,5401,5400,5348
26695,1051,2396,26695,0,22007,4688,3.18259e+18,1550.62,6381.11,26695,505,390,21974,18976,15262,14554,12968
48546,2317,2515,0,48546,0,48546,2.45196e+18,1503.11,7997.26,48546,647,446,46031,46031,44966,44344,45990
21594,455,595,21393,201,21594,0,4.7649e+18,455.215,2777.12,21594,197,204,20815,20279,18907,18840,17490
19555,245,351,0,19555,18731,824,2.44676e+16,221.228,1730.9,19555,108,114,19105,18831,17713,17118,15669
23992,1699,1806,11869,12123,0,23992,5.11059e+18,1258.05,5276.46,23992,411,342,22186,21200,21086,20904,22058
25012,8,43,23906,1106,24239,773,9.66125e+13,35.0694,708.902,25012,38,36,23407,22384,18414,18316,12606
38599,132,689,37972,627,38599,0,4.62034e+18,543.695,3819.28,38599,249,238,32906,25976,13433,13787,8798
41348,917,2878,34409,6939,21483,19865,7.34619e+17,1724.58,8212.42,41348,637,435,34007,29234,23529,22761,15915
2073,576,651,1309,764,0,2073,5.5341e+18,63.6044,964.324,2073,136,111,1422,1422,1422,1421,1039
19046,950,2274,15643,3403,9699,9347,7.74498e+17,1361.64,5299.25,19046,395,340,15259,13430,10954,10509,8096
13172,21,43,12534,638,12848,324,1.00179e+14,32.9226,516.609,13172,36,33,13016,12902,11084,11043,8736
48679,165,3028,48679,0,40519,8160,3.29844e+18,1795.24,9012.62,48679,702,464,32367,23037,14007,10863,4065
39161,2130,2165,39161,0,31394,7767,3.01703e+18,1728.1,7616.28,39161,514,465,36996,36996,36950,36950,36978
36970,348,1730,13121,23849,0,36970,3.76213e+13,1123.52,5767.64,36970,545,357,31249,28649,14580,12179,10480
24625,141,809,23840,785,24625,0,4.56436e+18,484.446,3118.2,24625,257,192,21462,17976,10726,10026,4969
10732,534,1891,5833,4899,5833,4899,4.85646e+18,586.704,3451.12,10732,338,216,8534,7836,4339,4326,3426
44447,445,2645,22227,22220,0,44447,5.037e+18,1476.1,7928.84,44447,643,438,35507,30928,11850,12106,10144
41632,237,1780,19627,22005,19627,22005,4.9778e+18,1440,6924,41632,527,437,30677,26026,8108,8430,5352
4394,694,822,1603,2791,0,4394,3.97587e+13,116.551,1458.26,4394,167,120,3572,3569,3569,3566,2536
24613,1396,1942,0,24613,0,24613,2.45752e+18,1265.69,5446.5,24613,428,358,22162,19384,15722,14929,18946
42862,959,1957,15099,27763,0,42862,3.84373e+13,1244.22,6659.7,42862,654,397,38786,35039,22543,23389,28080
23728,172,778,23048,680,23728,0,4.56191e+18,491.112,3058.08,23728,225,191,21176,18777,11330,10182,6882
40432,246,2332,0,40432,0,40432,2.43545e+18,1480.02,7187.67,40432,586,417,30638,26799,10991,4821,4959
6638,1320,1410,0,6638,2343,4295,9.80296e+15,223.764,2411.61,6638,275,176,5228,5223,5180,5142,5020
36398,1943,2760,29375,7023,17152,19246,8.17108e+17,1696.97,7929.27,36398,626,433,33364,27617,30122,29673,31592
36036,1515,2346,18906,17130,0,36036,4.96711e+18,1413.48,6795.48,36036,578,396,33121,28948,22593,20556,26523
10879,1059,2020,0,10879,0,10879,2.45571e+18,667.428,3653.21,10879,311,262,8859,8189,5593,5377,5600
31434,42,43,30005,1429,30530,904,9.8007e+13,40.0566,803.101,31434,41,38,31388,31370,31315,31314,31002
23819,569,1319,0,23819,8413,15406,9.92381e+15,971.815,4336.66,23819,375,318,20646,18882,11547,9210,11610
23907,301,351,0,23907,22561,1346,2.72865e+16,272.876,2022.59,23907,125,132,23463,22917,22186,20896,22113
44046,673,1886,15617,28429,0,44046,3.71934e+13,1161.53,6385.33,44046,587,376,38933,35779,21982,17058,18876
21580,731,1641,7632,13948,0,21580,3.69269e+13,929.101,4317.7,21580,424,285,18882,17546,12126,11165,13281
21118,57,366,0,21118,20166,952,2.48882e+16,234.15,1858,21118,109,117,20043,19479,15398,13011,8669
8300,250,1696,4125,4175,0,8300,5.12191e+18,474.812,3015.03,8300,253,258,6140,5419,2254,1968,1778
31893,975,2185,16873,15020,16873,15020,4.91023e+18,1428.58,6298.41,31893,553,370,27502,24680,15152,15813,14947
13221,218,2000,0,13221,0,13221,2.38365e+18,800.844,3947.61,13221,345,253,9775,8490,3909,2450,2169
24950,250,591,24694,256,24950,0,4.72635e+18,480.205,2984.12,24950,217,213,23248,21806,13057,13158,11684
15520,161,1994,0,15520,0,15520,2.43887e+18,953.484,4314.06,15520,396,290,11187,8798,4208,1701,1617
2304,22,31,2247,57,2302,2,1.06897e+14,18.4961,200.524,2304,20,21,2271,2267,2165,2160,1840
21073,1558,1707,9984,11089,0,21073,5.11787e+18,1238.24,4876.57,21073,370,332,19228,16626,16605,16525,18711
46517,1726,2112,46517,0,37265,9252,3.02314e+18,1735.22,8177.94,46517,530,477,43099,35393,41574,41340,39431
2911,54,431,2830,81,2911,0,4.64164e+18,156.333,947.936,2911,107,89,1808,1018,774,755,500
39063,1264,1808,0,39063,13881,25182,9.52502e+15,1128.99,5915.86,39063,567,357,36896,33214,27306,20269,32390
26033,2001,2490,26033,0,21868,4165,3.3118e+18,1508.69,6247.71,26033,514,374,23450,20159,22673,22655,20791
36485,12,48,34601,1884,35999,486,1.09497e+14,40.9209,880.672,36485,43,41,34962,33902,27474,26794,19297
27998,18,43,26727,1271,27156,842,9.77093e+13,39.1756,756.021,27998,40,37,27551,27226,23116,22979,18556
45220,1832,2534,23992,21228,23992,21228,4.92334e+18,1471.26,7707.94,45220,637,440,42686,40852,32104,30929,38606
7930,1685,1982,7930,0,6529,1401,3.05855e+18,555.237,3294.01,7930,232,237,5948,5738,5871,5871,5287
5068,1116,1168,1794,3274,0,5068,3.81601e+13,165.24,1934.13,5068,202,146,3900,3900,3899,3897,3848
12723,25,2016,10179,2544,6057,6666,8.42e+17,1099.91,4232.63,12723,313,287,4171,1654,898,1038,153
48099,381,1901,17093,31006,0,48099,3.725e+13,1152.36,6616.29,48099,607,381,41134,37761,19376,14736,16448
30142,384,1745,0,30142,10740,19402,9.55489e+15,1048.87,5170.3,30142,499,328,25660,23562,11928,7483,6094
29213,1,43,27879,1334,28386,827,9.79331e+13,39.326,777.61,29213,41,39,10742,10742,10742,10742,10742
1298,212,419,523,775,523,775,4.37715e+18,72.2149,656.635,1298,83,89,879,858,482,618,468
20130,1270,1322,7101,13029,0,20130,3.84983e+13,934.223,4005.34,20130,349,306,18796,17030,18572,18289,18474
39066,45,353,0,39066,37243,1823,2.51998e+16,290.468,2508.86,39066,137,150,36712,35180,27236,23578,16062
17862,1662,1993,9654,8208,0,17862,5.06188e+18,1038.93,4565.46,17862,365,302,15844,14368,13414,13061,13977
13610,685,1694,6487,7123,6487,7123,5.06479e+18,1006.74,3921.24,13610,306,284,10990,9644,5406,4742,5071
35014,1277,1850,0,35014,12415,22599,9.53839e+15,1109.16,5704.12,35014,512,350,32928,29567,24012,19277,29464
36862,1799,1914,0,36862,13015,23847,9.68931e+15,1223.7,6097.24,36862,569,363,34948,34791,33762,33244,34776
39380,2516,3112,39380,0,33554,5826,3.40766e+18,1732.6,8052.38,39380,744,417,36268,36059,35362,35468,33795
12713,325,2160,10576,2137,6686,6027,7.36262e+17,986.128,4218.77,12713,331,279,9111,7796,4433,4892,2444
24940,1260,1442,8825,16115,0,24940,3.84282e+13,1009.64,4572.37,24940,383,331,23419,20990,20297,20308,22612
44866,170,365,0,44866,42761,2105,2.54305e+16,303.413,2727.46,44866,145,158,43628,42704,37803,32571,28140
41246,824,2376,33015,8231,19684,21562,8.40822e+17,1642.44,7919.71,41246,587,458,33261,27462,21388,20443,18907
40147,14,43,37908,2239,39740,407,1.06779e+14,38.6734,905.104,40147,41,39,38942,38047,31154,29946,23609
39083,1211,2758,39083,0,32093,6990,3.01878e+18,1696.6,8095.45,39083,543,456,33290,28229,23392,21734,19196
23542,1947,2090,23542,0,18798,4744,3.04167e+18,1495.13,5818.35,23542,405,369,21410,18071,21136,21157,20803
33953,13,356,0,33953,32270,1683,2.58388e+16,289.146,2365.56,33953,136,141,28147,25015,20004,17811,10426
20920,298,779,20288,632,20920,0,4.6136e+18,465.962,2856.72,20920,231,185,19576,18643,13457,13318,9720
22675,41,43,21589,1086,22105,570,9.973e+13,38.4995,685.075,22675,39,37,22628,22612,22575,22574,22097
38239,1290,1831,13580,24659,0,38239,3.71804e+13,1121.71,5892.83,38239,549,359,36154,32472,27575,29151,32721
39353,9,43,37553,1800,38236,1117,9.82694e+13,39.4206,898.366,39353,42,40,37112,35629,29135,29127,18652
29127,2456,5142,13385,15742,13385,15742,4.3864e+18,643.309,8873.54,29127,879,440,23985,23573,14617,13439,12151
37140,128,354,0,37140,35412,1728,2.51814e+16,286.113,2433.19,37140,134,142,35939,35323,29931,26282,21291
31193,1898,2252,16373,14820,16373,14820,4.91193e+18,1360.02,6281.44,31193,513,372,28941,28819,24652,23997,26443
15379,934,1775,7499,7880,0,15379,5.08686e+18,1051.73,4217.02,15379,360,297,12915,11543,7708,7161,8784
42152,779,1859,14997,27155,0,42152,3.7206e+13,1119,6152.94,42152,586,367,37957,34814,23824,21629,26430
8531,229,345,0,8531,8134,397,2.49681e+16,116.948,1156.8,8531,78,76,8186,8120,7731,7514,7196
36009,204,358,0,36009,33961,2048,2.72991e+16,305.252,2498.68,36009,144,154,34970,34119,30186,26824,24760
20112,867,2178,9611,10501,0,20112,5.12155e+18,1267.58,5254.51,20112,457,337,16521,14796,7966,7026,9202
16568,1740,2082,16568,0,13279,3289,2.95895e+18,1302.94,4882.89,16568,341,312,14258,12219,13917,13995,13228
2609,176,1080,2154,455,1285,1324,8.07407e+17,134.158,1479.9,2609,157,117,1509,703,696,865,387
31500,602,698,30977,523,31500,0,4.71016e+18,531.498,3469.94,31500,245,223,30779,30578,29912,29887,29181
32531,59,381,0,32531,30810,1721,2.71742e+16,310.321,2433.45,32531,140,148,30492,29521,21541,18209,12884
48519,1571,2164,24610,23909,0,48519,5.04492e+18,1551.85,7825.16,48519,600,446,45620,39075,32201,29404,39477
21941,133,2124,11503,10438,11503,10438,4.90433e+18,1200.72,5203.51,21941,449,328,15397,11907,5793,6111,1859
32402,11,43,30772,1630,31833,569,1.03679e+14,41.0271,828.218,32402,41,40,30935,29833,24426,23736,16644
20536,748,2079,10676,9860,10676,9860,4.86515e+18,1190.93,5021.33,20536,442,323,16944,15133,8644,8747,8418
27697,721,1725,13220,14477,0,27697,5.17395e+18,1343.44,5610.26,27697,423,382,23019,19945,11002,8968,11146
37711,723,2152,37711,0,30153,7558,3.05041e+18,1688.95,7432.55,37711,506,448,29655,24495,15152,13723,15084
26917,1666,2486,22587,4330,14335,12582,7.0759e+17,1506.76,6335.13,26917,506,352,23759,20529,19894,19871,18618
38858,382,601,38471,387,38858,0,4.74128e+18,505.918,3722.33,38858,246,238,37434,36220,29763,29348,26639
42938,61,355,0,42938,40944,1994,2.5302e+16,307.348,2642.23,42938,143,152,40772,39681,30727,26392,17593
14981,361,793,14529,452,14981,0,4.5405e+18,401.977,2453.25,14981,226,163,14009,13488,10639,10624,8858
30560,1378,1602,10905,19655,0,30560,3.78292e+13,1078.38,5142.25,30560,475,335,28958,26944,25602,26051,27917
13163,312,354,0,13163,12472,691,2.66378e+16,214.46,1499.12,13163,98,102,12783,12589,12325,11893,11819
5085,1052,1404,4372,713,2963,2122,6.48175e+17,220.889,2165.81,5085,220,166,3681,3641,3471,3439,2380
37985,453,856,37199,786,37985,0,4.57339e+18,530.677,3914.06,37985,263,234,36638,35469,27881,28220,23789
34186,782,1585,0,34186,12097,22089,9.7215e+15,1085.11,5465.28,34186,437,364,30594,27969,18385,13902,19417
39644,2392,2397,20976,18668,0,39644,5.01208e+18,1442.72,7147.64,39644,598,410,37247,37247,37234,37245,37247
46665,333,354,0,46665,44502,2163,2.52932e+16,302.592,2747.47,46665,148,156,46253,45294,45720,45848,45061
2744,266,1087,2233,511,1347,1397,8.60446e+17,137.757,1515.39,2744,154,129,1657,1428,979,1043,599
26211,1580,1706,9312,16899,0,26211,3.74159e+13,1025.5,4837.73,26211,468,312,24505,24505,23848,23945,24444
42416,1726,2241,0,42416,0,42416,2.48087e+18,1438.48,7328.58,42416,535,437,40175,34948,30877,28625,36748
14079,589,1955,7401,6678,7401,6678,4.98097e+18,896.068,4085.66,14079,369,283,11220,10176,5781,5332,4108
15552,582,792,15100,452,15552,0,4.56899e+18,409.137,2496.08,15552,227,164,14760,14458,13901,13947,13202
22113,87,351,0,22113,21107,1006,2.50653e+16,240.354,1861.71,22113,112,118,21215,20857,16992,14590,10988
3708,251,480,3706,2,3708,0,4.87434e+18,174.474,1090.15,3708,124,105,3228,3077,2247,2292,2296
7965,256,352,0,7965,7546,419,2.65162e+16,111.796,1154.98,7965,74,80,7613,7572,7287,7130,6788
18715,959,2101,9545,9170,0,18715,4.94488e+18,1098.74,4821.62,18715,428,320,15857,14235,9079,8333,9186
44284,1484,1798,21038,23246,0,44284,5.11282e+18,1434.3,7137.63,44284,530,447,41720,35490,30903,29057,39232
20885,844,1706,0,20885,0,20885,2.54576e+18,1197.84,4832.08,20885,378,339,17613,15550,9211,7739,10890
46702,971,1766,22259,24443,0,46702,5.15607e+18,1474.88,7310.01,46702,539,454,40962,35540,23391,18747,26637
34851,2610,6459,9387,25464,5483,29368,2.52619e+18,483.467,11153.4,34851,809,521,28392,28372,18906,20075,13798
9863,640,1780,4866,4997,4866,4997,4.93213e+18,678.598,3358.47,9863,292,258,7752,7008,3633,3415,3803
19002,1104,2059,0,19002,0,19002,2.4658e+18,1068.88,4771.02,19002,414,316,16402,14844,10605,9329,11105
18114,1152,1322,0,18114,6427,11687,9.96986e+15,906.431,3797.49,18114,318,293,16662,14987,13841,12534,15182
34882,2205,2827,29502,5380,18924,15958,6.9425e+17,1595.5,7412.43,34882,595,396,32055,31852,28684,28079,29950
35133,1109,1351,12388,22745,0,35133,3.84278e+13,1080.19,5301.72,35133,442,369,33104,29310,25740,23894,29875
894,103,346,332,562,0,894,4.30515e+18,53.9228,490.87,894,62,63,548,478,145,149,187
5619,21,38,5383,236,5410,209,9.22724e+13,26.8489,319.85,5619,26,27,5555,5511,5136,5125,4868
552,73,195,191,361,0,552,3.44176e+13,22.7699,288.762,552,46,46,357,351,209,249,232
16292,459,1688,7883,8409,7883,8409,5.09901e+18,1091.45,4262.86,16292,320,309,12746,11296,5484,4846,5655
35960,307,366,0,35960,34200,1760,2.56851e+16,292.042,2475.59,35960,135,145,35445,34676,33620,31658,32017
14588,268,685,14289,299,14588,0,4.62677e+18,388.505,2342.78,14588,194,170,13545,12827,9341,9165,7314
8751,33,43,8337,414,8539,212,9.92612e+13,35.2354,431.266,8751,31,29,8698,8675,8172,8180,7715
21732,38,43,20669,1063,21229,503,1.00806e+14,38.0929,671.522,21732,39,36,21675,21653,21348,21347,20219
45163,933,2211,0,45163,0,45163,2.52428e+18,1644.13,7821.12,45163,597,444,38343,34325,17088,15400,21076
3008,945,957,1304,1704,0,3008,4.67284e+18,139.244,1445.75,3008,168,127,2051,2051,2049,2048,2045
35297,17,43,33536,1761,34512,785,1.01555e+14,40.6293,859.306,35297,42,41,34607,34054,28472,28240,22041
45740,269,2676,45740,0,37377,8363,2.96981e+18,1973.7,8918.67,45740,624,474,30468,24134,11434,8960,6361
40601,1583,2749,40601,0,33588,7013,3.23623e+18,1737.7,8087.12,40601,611,448,36197,30459,33196,30674,26227
9388,327,566,9323,65,9388,0,4.77458e+18,303.423,1788.29,9388,151,142,8758,8521,6818,6828,6219
46207,277,358,0,46207,44058,2149,2.5285e+16,300.506,2744.78,46207,146,156,45510,44605,41932,39952,38710
33696,1536,1897,16677,17019,0,33696,5.09132e+18,1378.69,6317.54,33696,504,398,31467,27117,24520,23313,29026
40427,950,1368,14294,26133,0,40427,3.8726e+13,1106.53,5710.82,40427,475,383,37443,33606,25283,24568,28732
20907,1965,2561,17099,3808,9913,10994,7.80411e+17,1521.6,5991.33,20907,474,351,18151,15404,15710,15065,15891
46772,112,1917,16588,30184,0,46772,3.7253e+13,1178.18,6590.53,46772,594,383,36363,31636,14404,9593,4337
41504,1007,2363,22137,19367,22137,19367,4.94515e+18,1438.5,7253.31,41504,590,416,36354,32394,19535,21231,20184
47848,440,1046,47638,210,47848,0,4.54586e+18,543.909,4706.4,47848,268,264,46413,45356,31606,31209,23807
24359,1044,1324,0,24359,8632,15727,9.89155e+15,996.395,4401.08,24359,382,326,22537,20241,17137,14752,19734
27106,35,43,25740,1366,26550,556,1.01392e+14,39.3037,751.727,27106,41,40,27021,26951,25454,25462,24363
39335,1034,2424,20583,18752,20583,18752,4.90073e+18,1417.8,7159.24,39335,584,410,34399,30656,18277,19321,19528
27966,36,43,26688,1278,27184,782,9.8747e+13,37.6918,753.755,27966,40,38,27897,27849,26741,26774,25404
44599,1179,1920,15791,28808,0,44599,3.70608e+13,1164.31,6434.24,44599,608,376,41914,37743,28723,28778,31592
14171,1004,1489,0,14171,5019,9152,9.60925e+15,741.782,3466.4,14171,316,259,12436,11653,9399,7289,9210
49164,215,2341,39749,9415,23949,25215,8.11934e+17,1779.26,8632.07,49164,621,481,32991,24947,14577,16141,6171
25359,1038,2472,21280,4079,13491,11868,7.08502e+17,1497.02,6170.76,25359,465,365,20980,18282,15423,14994,12163
43912,40,352,0,43912,41906,2006,2.51937e+16,289.873,2644.15,43912,142,152,41091,39232,30524,26088,17060
2494,20,23,2454,40,2289,205,7.88901e+13,14.2951,169.855,2494,18,17,2471,2470,2405,2404,2438
23353,723,2503,23353,0,19501,3852,3.31195e+18,1461.69,5989.73,23353,534,350,18360,15841,11679,10802,7526
34865,820,2375,0,34865,0,34865,2.43535e+18,1396.85,6733.44,34865,554,396,29545,26468,13404,13241,14165
20187,18,43,19211,976,19748,439,1.00142e+14,37.9037,644.059,20187,38,35,19855,19603,16528,16501,13181
26766,839,2466,22307,4459,13999,12767,7.27051e+17,1492.92,6344.59,26766,491,360,21599,18525,13928,13784,10727
6672,236,1299,0,6672,2361,4311,9.57022e+15,185.495,2273.03,6672,198,170,5352,5006,2354,2314,1549
32463,160,202,31,32432,31677,786,2.21259e+16,56.0658,1872.42,32463,85,78,32261,32261,31800,31802,31687
14630,1316,1543,5199,9431,0,14630,3.71792e+13,695.881,3481.1,14630,338,250,13087,12296,11789,11906,12564
44173,1004,1626,15568,28605,0,44173,3.78716e+13,1116.87,6198.77,44173,486,386,41163,37023,27422,25669,31798
42674,3425,3559,0,42674,14526,28148,6.74574e+15,801.758,8332.4,42674,948,551,39115,39115,39115,39115,39093
18540,24,43,17503,1037,18349,191,1.06624e+14,38.9331,630.19,18540,39,36,18349,18202,15897,15862,13447
23633,1528,2122,12440,11193,12440,11193,4.93821e+18,1223.58,5397,23633,464,333,21235,18906,15553,14869,17526
47686,220,2405,0,47686,0,47686,2.45473e+18,1501.92,7885.97,47686,614,445,35546,30479,12273,5608,6679
12099,38,43,11415,684,11971,128,1.06783e+14,36.2963,509.724,12099,37,34,12049,12031,11914,11911,11640
31319,552,903,30618,701,31319,0,4.5982e+18,499.05,3628.85,31319,278,219,30356,29585,26433,26225,24481
18644,1107,2138,18644,0,14950,3694,2.97434e+18,1334.73,5206.25,18644,363,353,15161,13148,11603,10934,10447
17226,730,2179,13933,3293,8382,8844,8.13147e+17,1319.13,5032.57,17226,392,329,13302,11332,8323,8352,6899
36485,1908,2587,30494,5991,19256,17229,7.27095e+17,1717.31,7501.51,36485,608,420,33480,28254,28263,27567,28179
14049,1294,1936,7685,6364,7685,6364,4.9597e+18,832.946,3988.85,14049,394,275,12073,11083,9275,8866,9531
30178,53,682,29549,629,30178,0,4.57012e+18,528.009,3372.51,30178,225,216,19889,11917,7637,6919,2812
42515,1335,2020,0,42515,0,42515,2.48223e+18,1493.81,7186.23,42515,550,431,38784,33802,25768,23055,31935
10532,408,1966,0,10532,0,10532,2.44994e+18,621.642,3537.76,10532,322,263,8127,7411,3292,2957,2066
25130,17,42,23738,1392,24875,255,1.06374e+14,38.8086,718.384,25130,39,37,24606,24182,19931,19764,15315
49254,12,43,46920,2334,47984,1270,9.91057e+13,40.2631,1004.75,49254,43,41,47490,46260,38021,37285,25829
47526,1176,2618,39182,8344,24326,23200,7.57183e+17,1739.79,8590.07,47526,636,457,40815,34759,30920,30263,25805
33758,133,2404,17724,16034,0,33758,5.03103e+18,1333.16,6626.36,33758,514,394,23695,17360,8662,6612,2542
18853,1149,1708,8971,9882,0,18853,5.14519e+18,1182.87,4612.41,18853,362,325,16269,14413,10953,9624,12329
27067,1309,1354,9571,17496,0,27067,3.85846e+13,1023.54,4664.79,27067,400,337,25713,25700,25531,25623,25506
48101,2143,2696,25710,22391,0,48101,4.9921e+18,1436.05,8033.21,48101,666,438,45405,45404,39772,38786,42085
24177,241,352,0,24177,22981,1196,2.59536e+16,262.671,1989.76,24177,117,129,23621,23199,21481,20216,20028
5651,1662,1814,5651,0,4628,1023,3.01737e+18,274.8,2741.23,5651,195,172,3837,3837,3829,3831,3603
5341,565,1150,0,5341,1857,3484,9.13575e+15,126.325,1934.94,5341,220,138,4191,4120,3089,3065,3063
21166,2389,2602,21166,0,17885,3281,3.3569e+18,1273.65,5707.49,21166,477,331,18564,18562,18445,18391,17983
10084,634,2069,4836,5248,0,10084,5.06835e+18,652.511,3656.49,10084,301,247,7752,6812,3153,2556,3302
30112,18,43,28360,1752,29851,261,1.06591e+14,40.4932,803.863,30112,42,40,29510,29064,24014,23808,17781
27693,1576,2540,27693,0,23273,4420,3.32458e+18,1529.39,6455.02,27693,528,381,24263,20997,22879,21039,17906
19731,322,349,0,19731,18746,985,2.56736e+16,251.778,1808.71,19731,114,121,19357,18980,18892,18549,18454
4023,307,1339,4023,0,3159,864,2.89055e+18,176.153,1994.02,4023,169,164,2684,2366,1327,1259,916
45210,2163,2492,23781,21429,0,45210,4.98773e+18,1476.68,7695.93,45210,643,422,42718,42718,39547,38799,41533
15479,288,2367,12986,2493,8237,7242,7.13269e+17,1089.72,4777.25,15479,384,285,11123,9560,5636,6127,2251
22612,1744,1988,10896,11716,0,22612,5.15708e+18,1303.25,5365.52,22612,400,360,20540,18017,17325,16961,19719
47466,1768,1814,0,47466,16731,30735,9.79431e+15,1157.6,6693.37,47466,592,398,45652,45601,45634,45550,45598
5899,380,1791,4872,1027,3020,2879,7.61001e+17,212.966,2725.66,5899,193,178,4102,3785,2488,2579,1178
25984,601,1714,12413,13571,12413,13571,5.01572e+18,1299.69,5403.64,25984,424,374,21211,18403,9209,8640,10412
18774,275,2395,18774,0,15911,2863,3.32952e+18,1233.78,5200.8,18774,479,328,13522,11744,7444,5714,2382
24097,697,1641,8592,15505,0,24097,3.75322e+13,988.171,4583.61,24097,426,300,21126,19554,12957,12204,13699
44588,4,43,42251,2337,43823,765,1.03511e+14,39.6007,955.253,44588,43,41,35559,31265,27563,27217,17759
7311,330,658,7152,159,7311,0,4.55221e+18,239.81,1669.45,7311,169,125,6653,6431,4877,5043,4625
2961,242,478,2954,7,2961,0,4.86312e+18,169.766,991.372,2961,114,90,2483,2326,2092,2082,1895
29862,543,2246,0,29862,0,29862,2.42109e+18,1330.39,6132.53,29862,520,367,24339,21759,9522,8987,8455
23302,1243,2174,12229,11073,0,23302,5.00694e+18,1181.02,5389.89,23302,474,336,20351,18357,12759,11997,13386
40664,1764,2431,40664,0,33202,7462,3.13692e+18,1686.97,7888.19,40664,573,451,37446,31149,34753,33332,34141
11105,261,625,10841,264,11105,0,4.56706e+18,349.928,2000.51,11105,161,150,10238,9697,6695,6599,5629
47074,1389,2487,38511,8563,23668,23406,7.81377e+17,1738,8507.44,47074,587,474,41489,35002,33245,32619,28725
10763,1554,1829,5355,5408,5355,5408,4.90591e+18,733.232,3533.09,10763,306,250,8934,8306,7593,7384,8403
46363,1132,1571,16458,29905,0,46363,3.79779e+13,1154.72,6261.01,46363,507,390,43812,39141,31901,34312,37729
38070,735,1778,18187,19883,18187,19883,5.02559e+18,1412.7,6620.82,38070,498,425,31904,27752,14765,13768,17789
26276,6,348,0,26276,25112,1164,2.49334e+16,247.713,2007.52,26276,118,128,19701,16548,14679,12811,8378
46406,208,351,0,46406,43751,2655,2.73101e+16,315.829,2832.35,46406,155,167,45175,44046,39067,35406,31923
22568,2174,2275,10624,11944,10624,11944,4.91471e+18,1353.85,5669.22,22568,460,366,20293,20293,20195,20093,20269
17979,1073,1925,9047,8932,0,17979,5.03841e+18,1124.15,4634.7,17979,371,314,15441,13827,9272,8551,10885
17228,1214,1929,0,17228,0,17228,2.43955e+18,1072.87,4544.84,17228,382,316,14892,13329,10217,9579,11571
3947,948,1006,2257,1690,0,3947,5.03054e+18,120.495,1604.03,3947,208,143,2941,2941,2916,2884,2882
29951,398,773,29603,348,29951,0,4.70649e+18,548.792,3529.31,29951,262,228,28527,27387,20967,20411,17956
27064,121,354,0,27064,25768,1296,2.56292e+16,269.551,2096.24,27064,121,133,26084,25630,21331,18832,14044
22692,2143,2680,18986,3706,11960,10732,7.24853e+17,1364.02,6041.11,22692,488,363,20012,18626,18560,18307,18939
19346,1852,2550,19346,0,16223,3123,2.84671e+18,1190.3,5548.43,19346,418,323,16796,15544,16077,16341,14471
39387,461,2449,0,39387,0,39387,2.43685e+18,1402.56,7151.26,39387,560,413,31962,28452,11673,9555,9228
29834,2088,2362,29834,0,24134,5700,3.10215e+18,1663.34,6879.14,29834,497,420,27392,24882,26973,27028,26426
21114,1378,2089,11391,9723,11391,9723,4.95375e+18,1116.36,5011.64,21114,433,318,18753,16764,13889,12964,14346
9101,274,1746,4602,4499,4602,4499,4.99028e+18,534.788,3170.5,9101,269,262,6848,6048,2698,2604,2212
19572,124,724,19050,522,19572,0,4.49487e+18,454.715,2730.07,19572,203,183,16585,13208,7204,6675,3964
6796,255,1511,3667,3129,0,6796,5.06077e+18,246.464,2541.76,6796,283,209,5194,4716,2599,2171,1206
17709,607,747,17304,405,17709,0,4.56684e+18,426.865,2626.59,17709,187,177,16962,16656,16131,16160,15142
18624,14,43,17713,911,18183,441,1.01034e+14,38.7264,625.875,18624,39,36,18093,17719,14797,14358,11624
6963,207,348,0,6963,6573,390,2.74343e+16,106.069,1091.24,6963,79,79,6615,6554,5989,5827,4935
40815,1287,1383,0,40815,14435,26380,9.9209e+15,1124.17,5776.41,40815,476,386,39399,34953,37603,35870,38484
38600,124,878,37545,1055,38600,0,4.59095e+18,584.842,3974.28,38600,279,231,32718,25931,15256,13407,7476
30535,308,1713,0,30535,10795,19740,9.49204e+15,1061.91,5191.37,30535,490,330,25617,23693,11747,8384,8691
37426,1563,2763,31321,6105,19718,17708,7.17468e+17,1684.95,7717.25,37426,615,413,33224,28177,26718,26882,25971
12227,1133,1297,4327,7900,0,12227,3.88861e+13,679.085,3084.8,12227,291,252,10885,10070,9507,8590,10310
18530,332,365,0,18530,17665,865,2.55877e+16,250.165,1783.75,18530,109,107,18149,17857,17820,17442,17612
17592,136,594,17400,192,17592,0,4.76788e+18,458.543,2527.46,17592,181,190,14937,11824,6673,6686,4526
44026,154,2068,0,44026,0,44026,2.4888e+18,1451.88,7342.08,44026,566,434,31136,23500,10044,5046,3690
29058,1445,1532,10327,18731,0,29058,3.81518e+13,1043.58,4993.13,29058,413,342,27526,27526,27032,27148,27414
37146,1825,2793,31049,6097,19654,17492,7.2063e+17,1624.75,7676.05,37146,606,415,33898,28734,28028,27850,27453
6488,83,359,0,6488,6111,377,2.64775e+16,74.6082,1086.94,6488,78,77,6109,5978,4864,4155,2895
628,61,335,504,124,271,357,8.00771e+17,43.7516,433.448,628,73,62,274,174,130,110,84
2973,176,499,2968,5,2973,0,4.78285e+18,155.553,1010.89,2973,130,91,2450,2124,1673,1613,1463
758,217,257,758,0,700,58,3.83228e+18,30.1662,379.388,758,56,50,501,501,492,492,192
38064,29,43,36295,1769,37010,1054,9.82474e+13,39.5173,882.19,38064,42,39,37876,37744,34596,34553,31980
7481,316,661,7297,184,7481,0,4.56746e+18,213.731,1670.76,7481,159,121,6820,6602,4921,5004,4476
25050,1080,2330,20495,4555,12507,12543,7.88471e+17,1568.81,6161.84,25050,500,379,20695,17806,15218,14814,11827
34053,130,355,0,34053,32448,1605,2.53206e+16,287.994,2343.41,34053,132,136,32931,32370,27400,24333,19997
24834,2367,2541,20921,3913,13367,11467,6.97801e+17,1386.99,6108.98,24834,498,350,22293,22293,21984,21927,21808
43056,26,356,0,43056,41072,1984,2.52109e+16,297.877,2639.49,43056,142,153,38986,36699,28226,25020,15930
35218,5260,5937,16347,18871,16347,18871,4.5165e+18,853.945,10269.7,35218,960,550,29281,29281,28016,27605,27574
32840,1267,1346,11630,21210,0,32840,3.87967e+13,1076.97,5138.26,32840,430,363,31451,27895,30402,30602,30671
8192,508,2148,6764,1428,4224,3968,7.56154e+17,383.003,3388.55,8192,290,226,6021,5416,3321,3634,1336
26575,275,794,26027,548,26575,0,4.55028e+18,524.951,3265.82,26575,267,207,24817,23396,13118,13063,11914
11144,232,2189,9306,1838,5865,5279,7.2275e+17,841.302,3959.86,11144,294,260,7670,6159,3519,4083,1639
8252,377,669,8026,226,8252,0,4.40173e+18,264.521,1752.38,8252,202,131,7583,7404,6800,6730,5605
38937,2059,2393,0,38937,0,38937,2.43799e+18,1421.25,7092.19,38937,579,410,36544,36544,32866,31483,35277
4387,910,1301,0,4387,0,4387,2.34449e+18,158.363,1988.64,4387,227,163,3086,3066,2373,2332,2443
40571,11,43,38558,2013,39733,838,1.01265e+14,41.2863,926.061,40571,43,41,38772,37441,30715,30084,20940
37500,938,3117,37500,0,30311,7189,3.05928e+18,1478.26,8258.83,37500,516,473,30652,26687,16754,15427,16037
30828,2016,2070,15909,14919,15909,14919,4.94517e+18,1317.49,6119.48,30828,463,376,28758,28758,28696,28610,28403
19685,1069,1985,10640,9045,10640,9045,4.99096e+18,1083.05,4770.39,19685,394,317,17082,15439,11033,11292,11935
32968,1264,1351,0,32968,11668,21300,9.92397e+15,1077.92,5152.02,32968,441,357,31549,27968,30306,28539,30671
11108,1145,1847,5690,5418,5690,5418,4.7979e+18,732.988,3551.98,11108,340,237,9261,8516,6620,5935,6353
48127,227,833,47242,885,48127,0,4.62483e+18,541.497,4364.36,48127,285,247,44527,41184,22034,22022,17009
15002,1000,1835,0,15002,0,15002,2.46022e+18,987.618,4184.66,15002,353,297,12547,11423,7633,7256,8443
47252,1011,1893,16761,30491,0,47252,3.7253e+13,1164.89,6586,47252,621,382,43682,39642,28746,30132,28991
10550,665,2056,10550,0,8414,2136,3.00005e+18,912.36,3861.79,10550,276,278,7751,6718,4272,3983,3916
20327,398,1955,10062,10265,10062,10265,4.93144e+18,1166.81,4960.85,20327,392,338,15968,14198,5618,5926,5164
7790,1479,1702,0,7790,0,7790,2.53057e+18,427.19,2941.92,7790,262,226,6088,5965,5737,5670,5823
45694,1768,2876,38229,7465,24093,21601,7.20027e+17,1751.79,8578.26,45694,671,445,41858,35222,34283,33953,33305
40750,245,355,0,40750,38838,1912,2.53467e+16,291.85,2556.81,40750,138,151,39994,39258,36351,34039,32372
10125,979,1614,4967,5158,4967,5158,5.16369e+18,753.827,3277.11,10125,276,264,8354,7618,5654,5327,6344
23797,1161,1627,8449,15348,0,23797,3.71956e+13,953.394,4504.74,23797,420,302,21777,20026,16734,17441,18834
5770,623,1538,2978,2792,2978,2792,4.71292e+18,178.608,2423.55,5770,241,153,4232,4072,2509,2544,2450
8920,44,559,8824,96,8920,0,4.69274e+18,323.781,1757.62,8920,137,132,5338,2754,1904,1774,830
9044,35,43,8683,361,8678,366,9.19995e+13,23.4778,420.596,9044,32,32,8997,8982,8646,8648,8217
44786,40,603,44338,448,44786,0,4.73855e+18,512.419,3995.26,44786,259,253,25622,12781,9324,8249,3429
23898,209,1870,0,23898,0,23898,2.51367e+18,1278.4,5311.61,23898,393,351,17486,14568,5994,3470,3502
20291,792,1869,0,20291,0,20291,2.50178e+18,1153.57,4900.95,20291,377,327,16811,15205,8828,7685,9191
34854,347,1763,16535,18319,0,34854,5.14496e+18,1411.22,6340.42,34854,478,409,26820,23420,7946,6788,7874
4755,857,1419,0,4755,0,4755,2.31236e+18,200.605,2160.53,4755,245,162,3336,3262,2413,2286,2657
16996,1726,2386,14176,2820,8918,8078,7.26973e+17,1221.22,5027.87,16996,427,301,14394,12750,12534,12533,11217
1059,266,434,807,252,509,550,9.49723e+17,92.2238,624.112,1059,93,82,625,620,500,458,473
12186,1180,1961,6147,6039,6147,6039,4.81055e+18,854.805,3845.97,12186,344,248,10151,9233,6852,6249,7196
3608,53,270,0,3608,3419,189,2.61829e+16,43.747,730.623,3608,56,55,3325,3232,2607,2271,1587
33301,5366,5817,14951,18350,0,33301,4.38963e+18,720.149,9902.34,33301,987,440,27484,27484,26312,25873,25611
16252,674,1486,0,16252,5771,10481,9.78446e+15,827.463,3727.01,16252,317,276,14136,13057,8523,6408,7345
21950,858,1520,0,21950,7785,14165,9.65324e+15,929.538,4282.47,21950,380,301,19544,18173,13394,10758,14918
19833,1311,2689,16237,3596,9384,10449,7.78319e+17,1519.34,5947.68,19833,526,359,15987,13975,11499,11546,10798
35861,1015,1364,0,35861,12654,23207,9.90902e+15,1080.02,5371.91,35861,449,369,33447,29885,23627,19090,27402
18636,2214,3778,8446,10190,8446,10190,4.56661e+18,631.111,6392.68,18636,890,322,14858,14802,9365,8220,7775
2272,34,798,2272,0,1809,463,2.65707e+18,142.096,1173.05,2272,115,115,723,323,210,224,61
3434,13,245,0,3434,3240,194,2.72367e+16,54.726,665.799,3434,61,55,2772,2436,1983,1716,1074
3282,7,169,0,3282,3190,92,2.16042e+16,32.5003,518.875,3282,39,44,2703,2421,2102,1932,1303
17267,344,1318,0,17267,6141,11126,1.0004e+16,883.339,3701.31,17267,315,283,14328,13130,6908,5142,5975
9750,1513,1663,4588,5162,0,9750,5.05327e+18,702.187,3247.63,9750,283,243,8087,7492,7181,7147,7767
811,64,452,811,0,646,165,2.67131e+18,84.942,573.303,811,78,92,288,156,91,102,105
39783,780,2783,32780,7003,20326,19457,7.66791e+17,1648.76,8062.49,39783,573,427,31923,27096,20163,19903,15213
16563,1385,2423,16563,0,13835,2728,3.36067e+18,1261.69,5045.94,16563,450,295,13516,12087,12560,11613,9363
20281,520,1614,0,20281,7177,13104,9.49707e+15,950.074,4201.16,20281,410,284,17270,15995,9476,6800,7381
6363,739,1565,3358,3005,3358,3005,4.97187e+18,187.942,2554.02,6363,217,165,4798,4651,3539,3012,2219
43857,1185,2822,36706,7151,23289,20568,7.15314e+17,1707,8323.35,43857,649,439,37519,32476,28951,28292,24756
9632,765,2197,9632,0,8077,1555,3.01377e+18,627.341,3691.06,9632,290,244,7369,6505,5073,4894,3696
42783,898,915,41525,1258,42783,0,4.50723e+18,592.707,4197.65,42783,263,235,41868,41868,41859,41856,41685
48676,597,2642,0,48676,0,48676,2.42155e+18,1523.51,8108.94,48676,696,444,40277,35658,15517,17643,12766
42918,33,2386,22646,20272,0,42918,4.97288e+18,1451.8,7396.34,42918,607,418,22420,14945,8797,6065,721
26234,1313,2061,26234,0,21009,5225,3.00298e+18,1561.4,6128.93,26234,440,387,22286,18971,19584,18717,16612
14388,105,1981,7287,7101,7287,7101,4.90265e+18,962.32,4194.03,14388,352,293,9388,6738,3363,3326,894
12722,1851,2038,6479,6243,6479,6243,4.87764e+18,832.513,3967.56,12722,339,272,10684,10037,9898,9678,10631
7721,578,669,7510,211,7721,0,4.49096e+18,244.629,1699.78,7721,154,125,7052,7042,6990,6984,6381
43412,27,1884,0,43412,15404,28008,9.54104e+15,1162.41,6339.56,43412,582,370,25683,19471,11372,5882,1431
41499,1639,2490,21539,19960,21539,19960,4.8795e+18,1440.6,7416.27,41499,623,413,38866,33591,26168,25218,31556
36446,416,2308,19220,17226,0,36446,5.00756e+18,1388.05,6775.99,36446,578,391,29325,26114,11469,11928,8494
28718,95,2244,15105,13613,15105,13613,4.87482e+18,1316.34,6010.05,28718,502,361,18932,14194,7455,7349,2246
43086,209,880,41899,1187,43086,0,4.53853e+18,591.459,4182.73,43086,274,235,39470,36033,20344,19473,13153
20444,42,351,0,20444,19486,958,2.53669e+16,254.891,1821.13,20444,115,119,19086,18268,14108,12291,8584
10650,630,704,10433,217,10650,0,4.69803e+18,366.044,2045.04,10650,191,140,9946,9830,9898,9902,9741
1505,373,691,1272,233,783,722,7.48475e+17,115.95,932.982,1505,105,103,814,797,574,583,492
5309,1364,1470,5309,0,4514,795,3.14542e+18,219.552,2258.5,5309,190,164,3839,3839,3837,3839,3713
49092,730,1389,17372,31720,0,49092,3.88112e+13,1142.34,6332.62,49092,503,405,44164,39988,26542,22503,27931
38247,1691,1780,13572,24675,0,38247,3.7301e+13,1139.44,5870.41,38247,544,361,36467,36467,35995,36060,36325
11087,991,1952,5760,5327,5760,5327,4.97826e+18,716.492,3658.16,11087,314,266,9131,8332,5496,5866,5860
33184,992,1707,11785,21399,0,33184,3.74395e+13,1103.04,5411.69,33184,496,347,30326,27697,20626,19124,24142
36510,124,383,0,36510,34599,1911,2.72876e+16,313.781,2609.5,36510,149,151,35105,34311,27934,24022,19172
32447,1565,1707,11481,20966,0,32447,3.70191e+13,1084.88,5350.37,32447,511,334,30740,30739,28862,28846,30398
3649,118,445,3448,201,3649,0,4.0528e+18,151.021,1006.25,3649,129,77,3067,2608,1845,1848,920
19876,17,43,19018,858,19208,668,9.57041e+13,33.5907,627.266,19876,37,35,19547,19286,16471,16362,12690
43701,2674,2788,43701,0,36569,7132,3.30451e+18,1748.47,8320.36,43701,667,458,40913,40913,40791,40776,40549
38259,224,2087,19423,18836,0,38259,5.03765e+18,1433.91,6847.19,38259,521,414,28490,24651,9374,7343,4597
3907,683,922,2399,1508,2399,1508,5.22405e+18,109.438,1515.61,3907,182,130,2985,2970,2956,2958,1772
13715,536,1514,0,13715,4917,8798,9.71652e+15,676.263,3362.73,13715,344,250,11684,10892,7225,4477,4903
36920,1304,2073,29593,7327,17672,19248,8.37829e+17,1675.79,7255.98,36920,514,441,31945,26907,24896,24289,23882
14390,925,1417,5074,9316,0,14390,3.78067e+13,768.493,3438.59,14390,308,253,12637,11813,9300,9383,8807
3285,370,943,1768,1517,0,3285,5.42526e+18,123.791,1501.72,3285,132,129,2342,2304,1680,1559,1303
5248,522,535,5234,14,5248,0,4.71126e+18,203.757,1335.49,5248,147,116,4713,4713,4706,4706,4698
14934,1528,1993,7893,7041,7893,7041,4.92464e+18,944.044,4226.17,14934,376,282,12905,11753,10219,9809,10891
31646,66,734,31054,592,31646,0,4.60948e+18,500.875,3475.13,31646,237,219,22329,14319,8652,8062,3531
37232,856,3758,16617,20615,16617,20615,3.60635e+18,453.147,7388.39,37232,938,268,33474,33325,15120,17153,19894
45497,155,359,0,45497,43379,2118,2.5233e+16,301.772,2721.44,45497,147,156,44179,43317,37621,32552,29061
9613,1,42,9092,521,9486,127,1.06465e+14,33.0946,447.285,9613,33,31,3110,3110,3110,3110,3110
22534,699,1738,10550,11984,10550,11984,4.94698e+18,1254.96,5061.01,22534,397,355,18565,16123,8791,8060,10773
39508,30,43,37507,2001,38700,808,1.02387e+14,40.7013,911.051,39508,43,40,39309,39205,35564,35578,33122
49285,222,609,48826,459,49285,0,4.76555e+18,516.556,4189.76,49285,266,263,45734,42183,24227,24568,19543
31696,800,2258,0,31696,0,31696,2.43905e+18,1339.34,6310.51,31696,520,376,26799,24159,13509,12759,13420
26064,698,2508,26064,0,21322,4742,2.92276e+18,1660.75,6623.5,26064,474,388,19944,16234,10546,8478,8853
9977,1744,1834,0,9977,0,9977,2.49838e+18,617.99,3357.46,9977,295,264,8143,7770,7881,7826,7937
21662,375,1646,7656,14006,0,21662,3.6807e+13,923.463,4324.72,21662,442,286,18240,16922,8991,7472,8531
40080,360,1809,14199,25881,0,40080,3.73444e+13,1130.92,6000.24,40080,567,365,34031,31274,16534,13138,10498
23130,1973,2329,18883,4247,11465,11665,7.92257e+17,1471.94,5941.16,23130,467,363,20775,17564,18787,18293,19570
38671,592,908,37616,1055,38671,0,4.60578e+18,568.424,3991.27,38671,286,232,37654,36591,33022,33083,29527
43462,2434,2637,22783,20679,22783,20679,4.93604e+18,1457.14,7708.21,43462,577,437,40825,40825,39987,39752,40038
21018,616,656,20803,215,21018,0,4.76999e+18,446.579,2797.82,21018,197,195,20362,20314,20242,20230,20040
18629,10,43,17719,910,18199,430,1.00207e+14,34.313,613.16,18629,38,35,17694,17036,14036,13768,9160
36005,4,44,33929,2076,35678,327,1.06539e+14,41.0198,872.119,36005,44,41,28343,24858,21293,21319,13937
34706,5,43,33083,1623,33793,913,9.92538e+13,39.5198,842.518,34706,41,40,29799,26819,23258,23523,14406
7021,1020,1350,2505,4516,0,7021,3.665e+13,175.027,2305.01,7021,263,187,5671,5665,5485,5463,5302
47231,527,2494,24719,22512,24719,22512,4.90586e+18,1498.43,7874.55,47231,660,440,38722,34372,14276,16887,11093
6709,288,636,6508,201,6709,0,4.48793e+18,191.058,1554.33,6709,183,118,6072,5859,4129,4151,3761
38012,534,2110,30403,7609,18113,19899,8.39809e+17,1671.84,7391.05,38012,517,440,28865,24113,15489,15646,10500
47334,923,1851,0,47334,0,47334,2.53199e+18,1471.14,7456.89,47334,547,455,41162,35743,21350,17923,27180
4121,851,1445,3311,810,1936,2185,8.05673e+17,197.751,2131.63,4121,173,156,2676,2532,2234,2201,1920
45623,787,2500,0,45623,0,45623,2.46038e+18,1480.58,7787.62,45623,601,436,38800,34564,16868,17878,17045
34409,1137,2808,28492,5917,17199,17210,7.44629e+17,1853.29,7725.61,34409,564,393,28650,24670,19841,19379,16175
6209,760,1900,5204,1005,2900,3309,7.88669e+17,289.648,2882.56,6209,228,188,4309,4047,3456,3253,2280
29267,1436,1899,14437,14830,0,29267,5.10653e+18,1361.26,5927.93,29267,470,390,26684,23238,19184,17543,23295
33631,17,43,31958,1673,32927,704,1.01497e+14,40.6785,841.154,33631,42,41,32957,32412,27103,26870,20195
15149,291,2046,12083,3066,7181,7968,8.53488e+17,1252.7,4633.6,15149,361,321,10345,8476,4774,5183,2897
1250,124,177,0,1250,462,788,9.63209e+15,18.7216,333.125,1250,69,38,1073,1073,1015,994,1003
17829,1567,1946,9407,8422,9407,8422,4.93904e+18,1079.68,4558.37,17829,377,297,15765,14158,12931,12446,13657
31695,154,355,0,31695,30224,1471,2.51105e+16,281.853,2252.59,31695,128,134,30749,30200,26558,23192,20718
49727,743,1388,17581,32146,0,49727,3.86495e+13,1144.82,6362.15,49727,505,402,44762,40535,26671,25860,30387
37315,320,353,0,37315,35198,2117,2.73343e+16,300.532,2529.96,37315,141,156,36845,35884,35357,34164,35319
31287,1352,2627,31287,0,26110,5177,3.2806e+18,1603.76,7002.67,31287,574,408,26781,23350,24330,22802,16481
44894,1870,2922,44894,0,37598,7296,3.20962e+18,1772.38,8570.8,44894,655,454,41405,34818,39516,38304,33462
2223,277,536,0,2223,778,1445,9.09444e+15,41.4363,906.373,2223,108,93,1687,1676,1172,1327,1047
22156,32,349,0,22156,21139,1017,2.52313e+16,248.241,1865.63,22156,113,118,20413,19374,14786,12779,8131
24455,316,2114,12967,11488,12967,11488,4.9561e+18,1253.86,5477.34,24455,450,339,19011,16872,7400,7758,3789
41440,1087,1493,14620,26820,0,41440,3.80184e+13,1130.05,5915.98,41440,488,380,38985,34708,27957,27152,31822
39805,67,350,0,39805,37811,1994,2.61222e+16,298.401,2564.52,39805,141,153,37765,36831,28192,24154,16346
33694,994,1846,16601,17093,0,33694,5.10444e+18,1371.23,6278.95,33694,492,402,29319,25952,16836,14400,18632
13662,448,743,13316,346,13662,0,4.54196e+18,399.659,2331.37,13662,195,162,12837,12515,11324,11315,10060
36696,23,43,34800,1896,36061,635,1.02976e+14,40.4638,876.46,36696,42,41,36328,36035,31197,31079,24572
5010,57,553,4892,118,5010,0,4.56435e+18,217.349,1331.05,5010,131,111,3376,2088,1342,1270,531
17949,1113,1585,6329,11620,0,17949,3.64204e+13,886.092,3946.01,17949,403,277,16083,14886,12717,12255,12106
40163,294,377,0,40163,38260,1903,2.5753e+16,293.696,2624.09,40163,141,154,39562,38786,36445,34768,34351
10175,584,682,9868,307,10175,0,4.59489e+18,323.357,1948.46,10175,196,140,9493,9384,9215,9231,9070
23742,1100,1710,0,23742,0,23742,2.52772e+18,1264.31,5162.24,23742,413,353,20768,18257,13133,11169,14984
47537,133,2558,25158,22379,0,47537,4.99421e+18,1487.35,7923.98,47537,659,443,33733,25387,12619,9126,2983
48457,157,358,0,48457,46177,2280,2.53675e+16,304.466,2810.58,48457,147,160,47085,46155,40285,34814,31721
40439,377,2037,20296,20143,0,40439,5.04897e+18,1481.19,7042.97,40439,545,422,31878,28186,10517,10553,8148
38367,1034,2444,31292,7075,19054,19313,7.90262e+17,1677.3,7683.22,38367,551,438,31992,27269,23082,22043,18985
35851,2082,2873,35851,0,29999,5852,3.1281e+18,1586.34,7604.93,35851,580,430,32978,28230,31631,32039,29252
40896,224,691,40243,653,40896,0,4.61631e+18,537.316,3920.03,40896,265,241,37811,34854,18733,19479,15375
28308,1493,2266,14902,13406,14902,13406,4.88637e+18,1332.67,5991.58,28308,510,355,25623,22533,18009,17257,20363
42495,1875,2582,42495,0,35009,7486,3.14738e+18,1708.96,8140.95,42495,592,465,39486,32906,36554,34905,35002
4557,72,1660,3662,895,2090,2467,8.50813e+17,218.486,2387.17,4557,234,171,2195,1297,845,852,128
18875,519,595,18683,192,18875,0,4.76058e+18,434.048,2593.4,18875,192,197,18250,17831,17592,17625,17176
8332,1426,1804,0,8332,0,8332,2.4679e+18,431.984,3083.96,8332,283,233,6528,6377,5961,5836,5946
775,22,96,0,775,727,48,2.85442e+16,23.0981,222.105,775,34,25,655,610,514,443,371
41366,1553,2343,21808,19558,0,41366,4.99147e+18,1459.25,7249.67,41366,585,416,38437,33417,26284,23867,30907
35036,1020,2364,16612,18424,0,35036,5.03969e+18,1610.03,7089.23,35036,571,408,29668,26464,13063,11454,17652
5298,742,1175,1901,3397,0,5298,3.78579e+13,201.92,1998.78,5298,204,185,4123,4039,3291,3296,3135
27786,1492,2170,14919,12867,14919,12867,4.91697e+18,1293.53,5817.54,27786,504,340,25188,22348,18029,17245,18903
11068,292,689,10657,411,11068,0,4.48282e+18,334.559,2021.18,11068,203,140,10225,9775,7508,7513,5756
16369,48,1521,5801,10568,0,16369,3.88745e+13,880.328,3829.33,16369,320,268,10514,7979,3893,1529,789
12610,927,2202,10303,2307,6281,6329,7.87013e+17,1016.35,4294.85,12610,319,265,9753,8749,6938,6963,5367
13331,300,1575,0,13331,4709,8622,9.3829e+15,642.253,3345.47,13331,332,211,11013,10273,5538,4356,4120
21472,347,584,21222,250,21472,0,4.76222e+18,468.676,2763.42,21472,207,203,20400,19703,15263,15428,13339
16290,550,1559,5761,10529,0,16290,3.68726e+13,787.796,3711.86,16290,348,258,14000,12960,8694,7548,6804
23343,1321,1727,11218,12125,11218,12125,5.06487e+18,1269.26,5152.33,23343,390,355,20974,18286,15089,14090,17751
43006,1700,1797,0,43006,15146,27860,9.80511e+15,1111.83,6356.06,43006,549,388,41209,41209,41182,41159,41209
21872,411,826,21248,624,21872,0,4.5199e+18,479.551,2969.31,21872,243,186,20738,20097,15769,16072,14029
14973,454,784,14555,418,14973,0,4.54954e+18,371.356,2431.07,14973,216,157,14118,13781,12069,12326,9969
34388,146,359,0,34388,32828,1560,2.49734e+16,272.368,2335.98,34388,129,141,33362,32788,28473,25069,22367
10575,36,657,10420,155,10575,0,4.62474e+18,363.78,2002.85,10575,173,144,5945,3071,2272,1984,652
26515,1834,2118,13476,13039,0,26515,5.05729e+18,1294.6,5763.21,26515,446,363,24397,24336,21375,20627,23196
9202,1086,1439,3268,5934,0,9202,3.72041e+13,319.253,2674.5,9202,292,172,7763,7623,6919,7209,6765
7666,400,1730,3812,3854,3812,3854,4.94289e+18,384.938,2938.52,7666,282,208,5805,5275,2669,2524,2135
17812,1127,2055,0,17812,0,17812,2.44767e+18,1128.61,4689.55,17812,397,306,15165,13770,9152,8032,9724
22795,1632,1747,0,22795,0,22795,2.53072e+18,1249.27,5099.63,22795,399,346,21003,18289,19183,18273,20454
16891,174,351,0,16891,16162,729,2.46706e+16,201.201,1618.96,16891,105,112,16370,16103,14641,13520,11477
18364,332,771,17981,383,18364,0,4.52786e+18,441.998,2702.33,18364,244,181,17230,16513,10901,10551,10463
46130,1095,2476,24106,22024,24106,22024,4.91502e+18,1490.9,7779.19,46130,636,442,40710,36237,21901,22694,23977
4398,1178,1528,4398,0,3469,929,3.19951e+18,179.794,2206.54,4398,202,186,2870,2851,2834,2826,2386
34127,454,2545,34127,0,28118,6009,3.00596e+18,1653.13,7325.63,34127,537,438,25544,21987,13259,11492,7477
22942,2433,2518,22942,0,19090,3852,3.31767e+18,1415.71,5958.24,22942,501,366,20424,20424,20370,20339,20161
10992,20,348,0,10992,10373,619,2.71528e+16,184.873,1358.85,10992,88,93,9442,8518,6511,5585,3098
7999,1166,1654,0,7999,0,7999,2.60156e+18,603.514,2987.22,7999,244,238,6345,5878,5059,4683,5121
28276,508,1744,9906,18370,0,28276,3.80354e+13,1186.45,5303.32,28276,543,344,23761,21392,11161,10055,11366
48942,1022,2218,0,48942,17385,31557,9.28978e+15,1166.74,6814.68,48942,786,370,45158,41603,29621,20027,32332
47754,1401,2614,0,47754,0,47754,2.45433e+18,1628.04,8292.88,47754,658,450,43316,37922,24261,20582,27462
49129,10,43,46929,2200,47661,1468,9.76907e+13,40.0383,1002.55,49129,43,41,46820,45172,37285,36572,26075
11459,1347,1876,6295,5164,6295,5164,4.99991e+18,671.805,3559.25,11459,315,259,9583,8961,7936,7449,7710
27170,631,1636,9671,17499,0,27170,3.69826e+13,1019.53,4765.4,27170,479,302,23899,22176,14986,13640,15352
31575,91,2633,31575,0,26328,5247,3.29654e+18,1618.03,7028.57,31575,605,399,18430,12731,7820,6485,1535
25092,603,805,24396,696,25092,0,4.6103e+18,517.659,3163.95,25092,281,199,24249,23636,22805,22818,20957
29992,287,693,29711,281,29992,0,4.74574e+18,509.697,3382.62,29992,240,226,28260,26760,17229,17122,14797
39716,1034,1620,0,39716,14045,25671,9.57949e+15,1108.36,5839.25,39716,502,363,36939,33392,25212,18770,29763
8114,1114,1362,2887,5227,0,8114,3.79576e+13,293.513,2520.33,8114,227,176,6752,6626,6407,6472,6191
10966,124,583,10783,183,10966,0,4.67634e+18,350.993,1961.8,10966,163,153,9184,7101,4385,4228,2610
15146,726,1460,0,15146,5389,9757,9.74963e+15,804.146,3584.42,15146,315,269,13112,12167,8427,6782,7729
48457,423,2942,48457,0,40460,7997,3.28087e+18,1794.17,8911.65,48457,716,470,36545,31882,18907,15086,8037
2491,827,916,0,2491,0,2491,2.56248e+18,105.717,1334.62,2491,147,134,1575,1569,1571,1568,1442
45553,610,2916,45553,0,38096,7457,3.34612e+18,1769.43,8625.77,45553,683,460,35823,30769,20763,17931,11530
35824,341,2423,19054,16770,0,35824,5.04034e+18,1373.38,6835.03,35824,544,400,28218,25377,9951,9220,4252
6151,1429,1572,3043,3108,3043,3108,4.93923e+18,287.208,2561.16,6151,245,213,4579,4576,4500,4499,4535
32161,222,1352,11383,20778,0,32161,3.87659e+13,1068.06,5101.71,32161,443,357,26166,23858,10088,7868,7582
26170,1616,1701,0,26170,9268,16902,9.4847e+15,1022.95,4823.32,26170,463,314,24469,24469,24336,24299,24469
19548,519,2033,0,19548,0,19548,2.49781e+18,1153.11,4976.33,19548,386,354,15529,13794,7072,6231,6757
38894,387,2023,18844,20050,0,38894,5.19413e+18,1452.86,6986.91,38894,516,430,30532,26223,8466,7922,7541
12525,68,684,12103,422,12525,0,4.54959e+18,373.91,2150.89,12525,203,149,9271,6612,4223,3833,1693
6330,12,39,6054,276,6123,207,9.87166e+13,23.852,342.111,6330,29,27,6132,6004,5063,5004,3773
14368,1535,2329,12016,2352,7556,6812,7.2017e+17,1009.89,4582.53,14368,355,273,11876,10654,10106,10215,8634
39460,689,2267,0,39460,0,39460,2.45991e+18,1397.69,7012.14,39460,544,407,33257,29332,14750,14823,14733
5943,1725,1858,4732,1211,2782,3161,8.66736e+17,294.645,2796.97,5943,212,201,4085,4078,4048,4027,3996
48311,474,1891,17146,31165,0,48311,3.72031e+13,1153.5,6620.17,48311,612,382,41889,38364,21085,17228,21111
43909,1333,1696,0,43909,15576,28333,9.68466e+15,1120.35,6235.05,43909,523,380,42190,38384,34617,29637,40249
34309,47,356,0,34309,32682,1627,2.55686e+16,296.222,2375.36,34309,133,138,32210,30939,23610,20389,13550
34894,2538,2765,34894,0,28994,5900,3.29547e+18,1665.98,7510.01,34894,584,411,32129,32129,31973,32002,31881
27093,31,43,25901,1192,26253,840,9.69525e+13,38.7336,745.729,27093,40,37,26973,26901,24930,24878,22247
21064,1291,1563,0,21064,7438,13626,9.70311e+15,920.278,4332.12,21064,391,326,19480,18003,16616,14451,18804
47926,1138,1874,0,47926,0,47926,2.52641e+18,1416.11,7484.4,47926,525,447,43289,37438,25284,20788,30999
44009,1036,2375,0,44009,0,44009,2.45195e+18,1463.76,7483.9,44009,601,428,38773,34461,20899,19419,23370
34144,342,2298,0,34144,0,34144,2.42065e+18,1379.15,6530.61,34144,543,385,27006,24275,10454,6150,6710
19229,579,593,19037,192,19229,0,4.73305e+18,447.272,2618.24,19229,189,190,18636,18618,18564,18569,18575
23492,299,350,0,23492,22403,1089,2.52779e+16,262.727,1937.65,23492,113,122,23052,22649,22004,21012,21568
777,21,87,0,777,734,43,2.40193e+16,27.166,210.876,777,31,30,651,594,530,437,364
30384,1407,2240,15835,14549,0,30384,5.00286e+18,1344.22,6201.67,30384,523,382,27409,24166,18398,16844,20927
26287,22,43,25072,1215,25552,735,9.85439e+13,37.3349,729.695,26287,39,37,26030,25797,22497,22443,18878
26641,70,353,0,26641,25393,1248,2.54384e+16,283.471,2083.2,26641,120,127,25334,24813,19520,16716,11749
17541,1233,1704,0,17541,0,17541,2.54677e+18,1120.08,4439.79,17541,347,309,15341,13497,10743,9885,12439
20620,1536,1717,7282,13338,0,20620,3.60879e+13,892.272,4195.85,20620,516,270,18903,18409,17407,17583,18624
34713,2056,2077,17839,16874,17839,16874,4.97858e+18,1403,6522.99,34713,488,407,32636,32636,32600,32562,32632
2736,28,30,2689,47,2531,205,8.02454e+13,16.6385,193.139,2736,19,17,2706,2706,2706,2705,2698
27658,179,871,26959,699,27658,0,4.63162e+18,523.544,3380.32,27658,280,207,24774,22041,11799,11466,7661
20519,2131,2483,17109,3410,10763,9756,7.28298e+17,1337.32,5568.54,20519,481,334,18036,16061,16828,16619,17327
42227,1377,2826,34554,7673,21126,21101,7.84674e+17,1677.21,8408.08,42227,590,481,36683,31077,29300,28783,26237
15415,1709,2179,15415,0,12543,2872,3.06517e+18,1202.92,4753.74,15415,346,321,13017,11464,12660,12713,11480
40130,2302,2755,33499,6631,21037,19093,7.23347e+17,1731.34,7991.57,40130,601,428,37375,37132,34553,33877,35925
13748,904,2242,13748,0,11450,2298,3.29366e+18,1026.22,4414.26,13748,366,271,10765,9606,8014,7523,6465
44647,603,1995,15787,28860,0,44647,3.7175e+13,1163.27,6563.41,44647,601,399,39048,35894,20969,16203,20557
3922,397,1344,3077,845,1843,2079,9.0887e+17,174.752,1932.01,3922,172,139,2578,2447,1663,1733,1253
39486,2267,2369,20701,18785,0,39486,5.0172e+18,1444.47,7126.74,39486,589,408,37117,37117,36632,36430,36544
24046,1887,1910,12014,12032,0,24046,5.06783e+18,1270.02,5371.86,24046,414,340,22136,22136,22091,21954,22128
38947,1187,1772,13809,25138,0,38947,3.71874e+13,1130.82,5895.26,38947,539,359,36612,32954,26551,26320,27584
10488,17,45,9922,566,10360,128,1.06707e+14,35.5771,473.761,10488,36,33,10255,10082,8400,8329,6639
13203,927,1807,6436,6767,6436,6767,4.95414e+18,959.092,3952.9,13203,332,284,10760,9760,6339,6075,6551
36686,58,2127,36686,0,29421,7265,3.05495e+18,1685.74,7314.17,36686,498,447,16653,8338,5289,5411,1106
35017,1514,2388,35017,0,28756,6261,3.0523e+18,1719.29,7331.6,35017,562,436,30839,26009,28438,27283,25302
15378,79,347,0,15378,14593,785,2.59311e+16,228.283,1593.19,15378,103,109,14612,14273,11334,9578,6885
40441,649,2780,33676,6765,21059,19382,7.39686e+17,1783.24,8095.34,40441,594,444,31816,27278,18376,18791,9733
28859,42,387,0,28859,27338,1521,2.7271e+16,298.247,2299.04,28859,136,141,26614,25316,18456,15877,9990
37295,1364,2349,19573,17722,0,37295,4.9996e+18,1418.57,6910.7,37295,580,396,33871,29622,22005,19851,25814
35466,832,2353,19121,16345,0,35466,5.03122e+18,1352.14,6687.74,35466,553,397,30415,27292,15389,15507,14789
6163,518,1849,6163,0,5200,963,3.43868e+18,325.877,2792.3,6163,284,191,4314,3844,2810,2729,1243
3970,480,887,0,3970,1372,2598,9.72105e+15,115.22,1476.31,3970,160,137,3083,3053,2067,2091,2096
32891,1043,2096,0,32891,0,32891,2.45746e+18,1367.98,6366.36,32891,500,388,28843,25504,16043,14679,19175
13788,1175,2293,11301,2487,6863,6925,7.68971e+17,1108.01,4552.45,13788,357,278,10893,9808,8516,8456,6818
35162,5,43,33576,1586,34113,1049,9.77345e+13,38.1915,843.332,35162,41,39,30223,27140,23680,23900,15230
36358,1316,2255,36358,0,29560,6798,2.98341e+18,1694.22,7381.85,36358,539,446,31444,26667,27012,26077,22835
45712,1616,1952,0,45712,16176,29536,9.49547e+15,1146.84,6512.2,45712,623,369,43760,43759,39436,37155,43070
33177,339,357,0,33177,31305,1872,2.72923e+16,300.304,2406.3,33177,140,150,32773,31956,32432,32218,31883
36979,2019,2713,36979,0,30641,6338,3.31284e+18,1729.54,7705.18,36979,616,443,34188,28670,32929,32559,30826
19412,2107,2607,19412,0,15828,3584,2.96501e+18,1465.11,5827.71,19412,432,346,16751,14301,15987,16116,15247
32404,1348,2280,17321,15083,17321,15083,4.93149e+18,1321.06,6368.56,32404,520,376,29130,25799,19318,18723,20930
46579,1418,1693,16538,30041,0,46579,3.77299e+13,1148.17,6397.31,46579,522,382,44886,44807,38932,39248,43801
31222,2241,2686,31222,0,26150,5072,3.35793e+18,1600.97,7009.17,31222,570,401,28536,28367,28053,28177,27729
30265,2249,2613,25185,5080,15792,14473,7.35413e+17,1584.1,6870,30265,525,393,27652,27520,25587,25190,26794
15701,10,43,14970,731,15279,422,9.89405e+13,36.3338,568.806,15701,37,35,14934,14392,11852,11663,8281
26441,11,43,25270,1171,25619,822,9.67351e+13,38.8874,737.081,26441,40,37,25365,24576,20365,19861,14400
2570,214,945,2101,469,1298,1272,7.77776e+17,141.328,1374.14,2570,137,127,1616,1073,731,886,759
35584,874,2231,18886,16698,0,35584,5.02988e+18,1404.67,6629.89,35584,536,398,30607,27364,15854,15023,16632
41213,218,2121,19713,21500,19713,21500,5.00504e+18,1560.64,7327.72,41213,567,438,29691,25026,7863,8313,3740
19538,2064,3361,9042,10496,9042,10496,4.45787e+18,501.745,6024.46,19538,350,343,16177,16068,11741,11186,10830
20481,29,42,19360,1121,20266,215,1.06606e+14,38.9316,646.026,20481,38,36,20364,20299,18435,18334,16199
28854,561,2098,14970,13884,14970,13884,4.91911e+18,1402.57,5992.53,28854,511,368,23493,20763,9778,10958,9247
15796,428,2145,12863,2933,7867,7929,7.89548e+17,1221.96,4775.66,15796,363,325,11555,10046,6117,6299,3978
42557,1261,2557,34952,7605,21578,20979,7.70148e+17,1703.42,8112.97,42557,610,450,36630,31502,28583,28115,25762
37421,238,358,0,37421,35428,1993,2.65463e+16,292.21,2528.12,37421,141,152,36605,35815,32649,29898,29823
8613,246,2157,8613,0,7153,1460,3.22515e+18,496.646,3477.36,8613,289,237,5931,5088,2690,2246,1303
7856,450,2167,6580,1276,4130,3726,7.19339e+17,274.091,3329.16,7856,288,216,5689,5151,3393,3418,2154
45650,401,1620,0,45650,16159,29491,9.7052e+15,1129.89,6298.15,45650,518,383,38997,35619,18878,12962,15336
45194,2306,2437,23845,21349,0,45194,5.00822e+18,1454.6,7623.25,45194,642,431,42757,42757,41992,41973,42101
48933,987,2228,24850,24083,0,48933,5.04558e+18,1566.44,7909.44,48933,573,455,42728,37657,21075,18879,24943
8562,1272,1663,4116,4446,0,8562,5.23431e+18,619.715,3066.6,8562,240,255,6899,6437,5692,5434,5839
30972,626,2257,0,30972,0,30972,2.44094e+18,1347.47,6259.18,30972,526,368,25549,22747,10554,10801,9010
42386,339,358,0,42386,39995,2391,2.7391e+16,310.706,2727.53,42386,152,166,41957,40880,41462,41729,40377
41480,708,2342,0,41480,0,41480,2.45819e+18,1457.54,7273.28,41480,594,422,34945,30773,15536,15610,16672
34964,949,2760,34964,0,29114,5850,3.32889e+18,1721.53,7517.73,34964,635,432,28624,24765,19988,19190,15105
23428,13,43,22347,1081,22778,650,9.84709e+13,36.7905,694.949,23428,39,37,22704,22243,18319,18115,13699
45030,495,2047,45030,0,35822,9208,3.00876e+18,1708.29,7976.51,45030,542,474,33898,28071,14742,12647,12712
44658,1206,2020,21999,22659,0,44658,5.03041e+18,1506.61,7395.87,44658,558,444,40259,34928,24606,21301,30471
8608,1875,1957,0,8608,0,8608,2.43706e+18,404.419,3226.76,8608,297,222,6651,6651,6569,6594,6651
25178,182,1991,12861,12317,12861,12317,4.9213e+18,1227.11,5470.47,25178,451,350,18424,15081,6466,6992,3025
36273,1753,1763,12879,23394,0,36273,3.73523e+13,1092.48,5663.46,36273,523,351,34510,34510,34486,34501,34500
43695,1427,1672,15477,28218,0,43695,3.77071e+13,1127.53,6186.23,43695,523,377,42023,42018,36647,36851,41181
17026,1081,2097,8132,8894,0,17026,5.05027e+18,1112.28,4727.73,17026,426,304,14297,12808,8041,7283,10254
28980,1588,2041,14756,14224,14756,14224,4.95189e+18,1328.2,5945.82,28980,464,372,26751,23316,20440,19458,23288
7848,6,43,7480,368,7637,211,9.90258e+13,29.2827,400.714,7848,33,30,7010,6479,5397,5460,4045
34424,1744,2387,17950,16474,0,34424,5.01245e+18,1394.09,6711.86,34424,544,396,32019,27894,23276,21421,28032
36532,1494,2503,36532,0,30393,6139,3.10882e+18,1742.54,7458.86,36532,572,434,32228,27465,28500,26599,26030
48841,160,2553,0,48841,0,48841,2.44776e+18,1473.7,8013.02,48841,643,444,35544,27820,13236,5214,4526
42516,545,2449,42516,0,34637,7879,3.12767e+18,1717.49,8089.82,42516,581,462,32667,27750,15045,14390,9532
42440,1232,1719,0,42440,15054,27386,9.71855e+15,1111.48,6180.67,42440,508,399,40388,35941,29624,23183,37934
14491,697,1430,0,14491,5133,9358,9.73775e+15,756.536,3462.88,14491,302,264,12461,11649,7807,6568,8160
14802,1183,2348,12456,2346,7854,6948,7.0498e+17,1086.43,4683.83,14802,372,299,11822,10615,9214,9235,8037
2044,139,965,1593,451,919,1125,9.30956e+17,102.356,1267.91,2044,137,110,1057,804,411,471,181
15336,230,2360,15336,0,12810,2526,3.28146e+18,1101.76,4787.84,15336,446,287,10613,8755,5136,3864,1613
46267,29,43,43977,2290,45316,951,1.01829e+14,40.1572,983.968,46267,43,41,46031,45855,41712,41359,36476
3225,184,225,0,3225,3057,168,2.54939e+16,42.2474,630.443,3225,54,57,3000,3000,2973,2981,2865
29864,135,2337,15733,14131,15733,14131,4.89978e+18,1302.39,6201.22,29864,526,367,21151,16003,7866,7983,1716
25620,404,1328,9071,16549,0,25620,3.88297e+13,1006.21,4529.91,25620,402,327,21693,19817,10406,10052,8881
47781,219,381,0,47781,45539,2242,2.52378e+16,306.406,2859.58,47781,149,162,46773,45805,41661,37867,33458
4257,467,548,4251,6,4257,0,4.74216e+18,184.781,1231.5,4257,147,97,3709,3694,3559,3564,3412
1077,285,316,0,1077,364,713,1.00378e+16,81.2916,510.975,1077,95,92,761,761,733,739,736
26976,188,821,26078,898,26976,0,4.52553e+18,510.651,3267.3,26976,261,202,24374,21904,13029,12035,7530
40868,12,43,38673,2195,40226,642,1.04324e+14,40.0252,928.381,40868,43,42,39223,38074,30805,30089,20306
19150,773,1403,0,19150,6755,12395,9.84455e+15,882.832,3982.33,19150,352,302,16853,15572,10814,9008,11635
30083,20,44,28478,1605,29735,348,1.06825e+14,40.4741,797.193,30083,41,39,29654,29312,24748,24467,19413
34145,224,2739,18173,15972,18173,15972,4.91577e+18,1351.69,6978.71,34145,546,394,25500,21870,9181,10316,3959
21389,1214,1645,7608,13781,0,21389,3.7414e+13,930.634,4341.32,21389,425,297,19619,17894,15212,15436,17526
47845,1907,1995,0,47845,16964,30881,9.49389e+15,1163.84,6716.75,47845,617,381,45850,45850,45818,45795,45850
35371,132,1760,12601,22770,0,35371,3.75488e+13,1069.93,5587.7,35371,513,348,28088,24869,12030,9635,3822
48212,55,355,0,48212,45970,2242,2.51616e+16,301.929,2789.47,48212,148,161,45657,44272,34137,29396,20553
4380,1089,1191,2292,2088,2292,2088,4.72182e+18,165.756,1882.27,4380,174,125,3189,3189,3174,3176,3140
14729,1669,2249,14729,0,12386,2343,3.26844e+18,1038.61,4536.72,14729,377,279,12432,11191,11904,11525,10796
7089,805,1379,0,7089,2502,4587,9.43489e+15,172.919,2358.1,7089,253,187,5710,5683,4582,4773,4416
7857,245,351,0,7857,7486,371,2.55875e+16,80.3262,1121.68,7857,80,81,7506,7475,7076,7087,6156
19452,463,657,19203,249,19452,0,4.72378e+18,439.308,2684.74,19452,206,191,18660,18194,16968,16997,15727
41982,30,43,39821,2161,41220,762,1.03064e+14,40.6855,938.377,41982,43,42,41766,41647,37571,37585,34097
14417,518,608,0,14417,13700,717,2.3966e+16,128.501,1980.9,14417,101,98,13809,13801,13582,13513,13063
36673,1301,2750,36673,0,30786,5887,3.29933e+18,1705.97,7631.31,36673,643,421,31528,27272,27751,25796,17879
34222,643,924,33376,846,34222,0,4.61608e+18,577.523,3798.23,34222,257,217,33237,32514,30323,30306,28234
38818,446,2811,32381,6437,20370,18448,7.26249e+17,1669.36,7883.46,38818,618,416,29556,25760,15380,16764,8163
22890,553,2502,22890,0,19073,3817,3.28399e+18,1403.32,5909.55,22890,523,361,17570,15429,10083,8173,6488
7898,692,1419,0,7898,2810,5088,9.48584e+15,266.992,2534.49,7898,273,186,6479,6323,4737,3553,3281
43993,2513,2526,36264,7729,22406,21587,7.63453e+17,1785.55,8273.13,43993,616,449,41467,41467,41460,41466,41464
30382,508,2085,24375,6007,14523,15859,8.33735e+17,1614.4,6603.15,30382,478,401,22803,19015,12040,12059,8837
9496,3,44,8943,553,9422,74,1.06443e+14,38.1699,456.74,9496,36,35,6674,5542,4969,5137,3435
3246,959,1126,3246,0,2748,498,3.22435e+18,169.326,1631.88,3246,153,148,2120,2111,2119,2120,2038
44543,59,2353,0,44543,0,44543,2.4567e+18,1453.51,7543.45,44543,583,430,26180,17856,9944,4854,1419
39255,1721,1732,13984,25271,0,39255,3.75395e+13,1159.81,5930.75,39255,515,364,37523,37523,37511,37522,37523
16005,369,747,15570,435,16005,0,4.6175e+18,419.129,2502.45,16005,232,163,15049,14532,11770,11897,9646
43380,1265,1575,15384,27996,0,43380,3.78248e+13,1146.21,6081.1,43380,512,379,41514,36870,32468,32504,38415
21613,413,586,21381,232,21613,0,4.74908e+18,458.609,2766.13,21613,203,202,20752,20133,17444,17451,16185
30313,685,871,29466,847,30313,0,4.56296e+18,508.473,3517.59,30313,257,207,29442,29366,28013,27987,26633
6250,1511,1815,6250,0,5344,906,3.31183e+18,277.165,2742.9,6250,248,170,4435,4424,4428,4401,3654
17005,710,744,16852,153,17005,0,4.76118e+18,438.371,2632.03,17005,208,181,16261,16259,16221,16230,16125
14471,42,43,13829,642,14049,422,9.77803e+13,35.6904,547.927,14471,37,35,14427,14420,14398,14397,14264
22321,162,973,21519,802,22321,0,4.47042e+18,532.297,3102.59,22321,292,176,19744,17325,9185,9074,5305
8393,50,1844,4575,3818,0,8393,5.02534e+18,282.293,3053.99,8393,246,189,4931,3543,2154,1464,190
19398,117,2059,0,19398,0,19398,2.40638e+18,1191.9,4898.93,19398,435,323,13070,9516,4559,1849,1129
26437,57,352,0,26437,25209,1228,2.52476e+16,271.559,2060.75,26437,120,128,25037,24311,18763,16246,11341
36288,2138,2671,30495,5793,19341,16947,7.08876e+17,1678.05,7515.31,36288,563,419,33617,31528,29690,28995,31947
22975,32,43,21765,1210,22588,387,1.03782e+14,37.7133,690.178,22975,39,37,22874,22801,21175,21193,20079
17728,493,753,17297,431,17728,0,4.61812e+18,413.879,2614.9,17728,215,177,16893,16496,15370,15401,14098
12648,42,43,11970,678,12442,206,1.04864e+14,36.2411,519.662,12648,37,35,12604,12597,12577,12576,12441
3140,516,1017,0,3140,0,3140,2.57928e+18,167.261,1527.78,3140,155,139,2123,2075,1074,834,1004
49652,485,2657,0,49652,0,49652,2.43786e+18,1508.8,8170.48,49652,702,437,40671,36152,15439,17155,11265
28939,1417,2574,28939,0,23943,4996,3.30615e+18,1621.15,6753.92,28939,544,395,24887,21490,22919,21759,16840
20198,215,1953,0,20198,0,20198,2.45949e+18,1168.21,4920.25,20198,403,323,14862,12817,5307,3157,2506
41783,1749,1754,0,41783,0,41783,2.52867e+18,1440.33,6893.55,41783,518,433,40029,40029,40021,40010,40027
49347,735,2018,24346,25001,24346,25001,4.977e+18,1478.14,7753.17,49347,575,454,41742,36305,18355,19079,21749
3822,3,38,3579,243,3817,5,1.0907e+14,24.477,271.531,3822,28,26,2746,2308,2074,2080,1435
21045,97,1584,0,21045,7478,13567,9.50009e+15,898.377,4202.18,21045,421,291,16173,14058,6986,3770,2159
46905,597,903,45639,1266,46905,0,4.5635e+18,619.879,4396.31,46905,299,248,45821,44438,41126,41116,38052
10781,507,2230,10781,0,9170,1611,3.32525e+18,629.113,3816.04,10781,319,254,8103,7295,5285,4768,2407
3601,211,216,0,3601,3409,192,2.65139e+16,52.3335,646.437,3601,57,53,3385,3385,3384,3382,3371
48329,302,350,0,48329,45844,2485,2.63785e+16,304.298,2845.66,48329,154,163,47747,46618,45125,42498,43976
24848,1594,1892,11955,12893,0,24848,5.03434e+18,1297.64,5466.81,24848,430,363,22809,19772,18390,17616,21673
11645,1326,2282,9671,1974,5990,5655,7.47716e+17,923.755,4166.89,11645,346,254,9336,8354,7371,7483,6401
20807,36,43,19891,916,20158,649,9.69953e+13,34.5328,643.412,20807,38,35,20749,20717,19984,20014,19193
45761,869,1941,16263,29498,0,45761,3.72179e+13,1150.57,6501.56,45761,606,373,41478,37984,25696,23933,30836
1819,12,352,1738,81,1819,0,4.53737e+18,93.9016,686.852,1819,73,68,623,139,135,227,90
46166,1370,2912,46166,0,38530,7636,3.3183e+18,1757.79,8672.1,46166,706,470,40197,34592,36347,33803,29888
35069,336,1356,12422,22647,0,35069,3.8959e+13,1085.56,5319.58,35069,438,380,29409,26831,13417,9098,10629
39246,1490,2061,20162,19084,0,39246,5.07717e+18,1468.06,6915.81,39246,528,424,36345,31531,25555,23253,31560
47337,877,1941,16801,30536,0,47337,3.71269e+13,1165.69,6614.28,47337,627,382,42971,39352,26616,26067,29949
20527,544,1728,9663,10864,9663,10864,4.97504e+18,1215.05,4832.73,20527,380,336,16406,14404,6616,6068,7347
28784,323,349,0,28784,27257,1527,2.67738e+16,285.578,2205.56,28784,131,142,28373,27723,27567,27125,26879
24949,415,764,24688,261,24949,0,4.7425e+18,493.709,3194.01,24949,261,208,23802,22957,17668,17527,16186
20326,3,43,19382,944,19800,526,1.00011e+14,36.8301,644.873,20326,38,36,14907,12815,11886,11784,7851
36084,3,43,34208,1876,35442,642,1.03194e+14,39.9534,873.236,36084,42,41,25943,21944,19972,20259,13648
3452,403,836,0,3452,1200,2252,9.61386e+15,94.022,1381.39,3452,157,125,2616,2595,1806,1706,1720
18074,241,2352,14878,3196,9205,8869,7.59909e+17,1273.54,5173.14,18074,415,316,12623,10616,5913,6676,1697
35553,2030,2657,29523,6030,18445,17108,7.4112e+17,1703.24,7475.99,35553,575,419,32850,27598,28060,27410,29607
9900,1061,1864,5340,4560,5340,4560,4.86494e+18,547.393,3310.65,9900,310,203,8036,7553,5990,5415,5224
27634,1457,2594,23206,4428,14710,12924,7.11447e+17,1553.09,6526.1,27634,491,377,23978,20796,19640,19409,17850
21192,131,815,20694,498,21192,0,4.61152e+18,477.818,2927.69,21192,275,183,18058,14492,8379,7991,3959
39199,1517,1744,0,39199,0,39199,2.52193e+18,1409.1,6652.31,39199,507,430,36950,31369,28555,28385,33793
32973,38,43,31505,1468,31938,1035,9.71033e+13,37.5634,819.54,32973,41,39,32909,32873,32442,32438,31068
20777,34,377,0,20777,19775,1002,2.55083e+16,247.031,1876.88,20777,111,116,19136,18108,14063,11808,7428
22314,363,2544,18751,3563,11876,10438,7.07169e+17,1365.68,5855.77,22314,467,340,16442,14482,8185,9009,2296
35782,2515,3723,35782,0,28445,7337,2.95994e+18,1421.03,8689.14,35782,612,501,32059,31999,31034,31318,23851
35064,1455,2091,17729,17335,0,35064,5.02997e+18,1389.89,6559.63,35064,512,404,32290,28041,22026,19756,27297
36359,268,354,0,36359,34684,1675,2.52071e+16,286.701,2417.53,36359,137,144,35747,35071,32857,31140,29963
34068,2395,2462,0,34068,0,34068,2.48281e+18,1358,6838.96,34068,573,387,31606,31606,31573,31490,30833
8452,207,661,8241,211,8452,0,4.59275e+18,273.348,1769.76,8452,149,128,7575,6944,4971,4834,3442
31321,364,2673,26225,5096,16578,14743,7.16711e+17,1606.81,6992.38,31321,574,388,23219,20417,11661,12890,5727
33085,257,2244,0,33085,0,33085,2.45874e+18,1385.97,6452.59,33085,538,397,25240,22078,9564,5381,5460
12043,370,2295,12043,0,9913,2130,3.26078e+18,961.115,4248.52,12043,383,275,8589,7536,4174,3248,2350
43518,238,354,0,43518,41522,1996,2.50376e+16,290.728,2633.95,43518,142,152,42704,41917,38714,36008,35514
21222,232,2231,21222,0,17297,3925,3.0632e+18,1398.63,5635.49,21222,418,369,14297,11468,5653,4613,2101
32227,1264,1825,0,32227,11461,20766,9.56049e+15,1080.48,5450.02,32227,477,337,30107,27182,22852,18075,27784
25131,303,2608,20936,4195,13066,12065,7.34614e+17,1509.89,6300.09,25131,502,372,18001,15182,8609,9758,3460
4079,42,775,1516,2563,0,4079,4.01373e+13,98.9078,1364.81,4079,186,120,2907,2438,1538,1546,298
17056,208,1938,17056,0,13605,3451,3.03082e+18,1289.57,4816.25,17056,342,320,11188,8193,3981,3347,2448
17741,1018,1431,0,17741,6248,11493,9.5081e+15,826.816,3769.92,17741,369,270,16000,14797,12045,9546,13418
1553,51,551,1174,379,615,938,9.14808e+17,104.122,825.12,1553,101,105,768,442,332,302,147
12631,1363,2033,10100,2531,5971,6660,8.45639e+17,1084.01,4236.65,12631,328,304,10077,8968,8299,8115,7807
28675,1686,2489,28675,0,23994,4681,3.30082e+18,1565.77,6564.35,28675,509,382,25542,21931,24194,22874,21530
8002,151,1647,0,8002,0,8002,2.60291e+18,577.302,2963.99,8002,220,247,5384,3919,1618,1094,1053
7055,19,43,6693,362,6913,142,1.00701e+14,29.9563,381.856,7055,35,31,6930,6848,6012,5993,5275
34531,698,2320,18283,16248,0,34531,5.03511e+18,1391.86,6628.27,34531,554,398,28954,25594,13609,13834,13382
10160,1648,1886,5754,4406,0,10160,5.08996e+18,433.628,3307.05,10160,274,196,8274,8016,8029,7975,7229
4754,423,568,4664,90,4754,0,4.86405e+18,187.136,1297.93,4754,150,101,4186,4166,4004,4019,3581
35403,840,2514,17241,18162,17241,18162,4.94852e+18,1452.53,7166.59,35403,596,404,29659,26404,12216,13304,17270
25139,1967,2318,25139,0,20151,4988,2.98594e+18,1529.14,6221.45,25139,431,382,22778,19299,22226,22293,21828
49616,25,43,47303,2313,48253,1363,9.84054e+13,40.216,1005.94,49616,43,41,49274,49012,43906,43978,36975
823,147,396,614,209,374,449,9.63035e+17,96.2369,532.942,823,71,68,426,290,178,208,213
2741,77,986,2214,527,1367,1374,8.37099e+17,154.476,1414.82,2741,129,119,1182,566,494,475,6
11176,244,347,0,11176,10617,559,2.6061e+16,165.783,1336.36,11176,85,91,10829,10682,10086,9771,9615
6220,66,624,6109,111,6220,0,4.58655e+18,203.989,1518.89,6220,152,119,4323,2791,1798,1609,967
13662,1215,2013,7267,6395,0,13662,4.9484e+18,824.083,4011.28,13662,355,247,11540,10602,8174,7734,8434
16606,1273,1541,5880,10726,0,16606,3.69588e+13,808.412,3728.38,16606,382,259,15060,13936,12996,12601,11994
15607,586,1548,0,15607,5546,10061,9.48996e+15,786.527,3625.34,15607,379,252,13368,12442,8286,5184,5680
28696,1928,2241,28696,0,23294,5402,3.06848e+18,1581.18,6555.15,28696,476,397,26335,22108,25499,25538,24892
41043,1067,1655,0,41043,14612,26431,9.71564e+15,1152.87,5976.01,41043,513,380,38191,34550,26612,19810,31642
17930,1262,1420,0,17930,6362,11568,9.7108e+15,855.351,3842.76,17930,351,284,16473,15046,14437,13332,15661
24653,14,42,23315,1338,24349,304,1.05954e+14,38.1103,706.848,24653,38,37,23920,23403,19114,18626,14663
46084,18,42,43692,2392,45277,807,1.03052e+14,40.407,965.956,46084,42,42,45298,44688,37137,36822,28834
13165,1245,1606,6239,6926,6239,6926,5.06159e+18,948.479,3747.04,13165,306,284,11249,10207,8355,7872,9388
19462,979,1907,9931,9531,9931,9531,4.94871e+18,1110.11,4763.75,19462,399,318,16627,14985,9913,9985,10125
19596,1108,1468,0,19596,6905,12691,9.65201e+15,912.532,4065.41,19596,350,292,17858,16257,13696,11607,15305
6760,1158,1980,6760,0,5454,1306,3.06273e+18,396.64,3084.9,6760,221,213,4780,4514,4067,3910,3066
46836,1819,2951,39184,7652,24753,22083,7.17976e+17,1767.04,8707.72,46836,686,448,43113,36303,35358,35028,36515
6100,723,1830,6100,0,5055,1045,3.13736e+18,341.279,2811.54,6100,215,209,4270,3869,3080,2795,2380
27034,674,924,26346,688,27034,0,4.60271e+18,508.258,3383.3,27034,262,208,26110,26049,24518,24613,23554
45092,3638,5071,15722,29370,0,45092,3.54103e+13,727.242,9956.28,45092,991,511,40021,40010,35648,36949,34282
49862,2321,2470,23649,26213,23649,26213,4.93363e+18,1731.36,8510.03,49862,722,458,47392,47392,45804,45594,47315
2148,7,444,2146,2,2148,0,4.44194e+18,143.3,835.063,2148,120,79,470,83,102,109,48
48769,246,1945,17340,31429,0,48769,3.74593e+13,1172.34,6725.43,48769,628,391,40485,37314,17172,12587,9948
16698,437,2370,16698,0,14027,2671,3.29627e+18,1177.67,4973.4,16698,423,322,12459,11012,7020,5270,4033
38476,1141,2372,0,38476,0,38476,2.47521e+18,1551.2,7299.96,38476,609,412,33715,30043,17970,15901,22255
22629,544,2416,18925,3704,11951,10678,7.22353e+17,1480.73,5822.46,22629,478,340,17348,15085,9614,10110,4137
24367,1630,2044,0,24367,0,24367,2.50129e+18,1230.9,5463.39,24367,405,345,22274,19594,17830,16325,19715
26527,35,43,25170,1357,26045,482,1.01971e+14,38.862,743.855,26527,41,39,26450,26385,25032,25046,24321
27265,615,1518,9637,17628,0,27265,3.77761e+13,1006.09,4773.34,27265,428,320,23855,22074,14131,12453,12359
12391,1328,2276,10616,1775,6980,5411,6.49709e+17,800.128,4068.13,12391,365,262,10115,9287,8363,8433,7993
33638,842,894,32589,1049,33638,0,4.5722e+18,539.357,3708.67,33638,310,218,32744,32743,32559,32554,32038
32144,2136,2256,16862,15282,16862,15282,4.9369e+18,1370.61,6374.75,32144,526,380,29888,29888,29368,29304,29886
21045,153,703,20682,363,21045,0,4.66158e+18,453.816,2827.97,21045,216,197,18465,15501,8656,8151,5648
17058,20,43,16252,806,16635,423,1.00756e+14,38.7051,596.854,17058,39,36,16821,16655,14344,14226,11347
19274,5,43,18302,972,18971,303,1.03498e+14,38.6838,631.908,19274,38,35,16379,14715,12592,12773,7931
43809,2698,2845,43809,0,36385,7424,3.26241e+18,1769.54,8439.81,43809,676,450,40964,40964,40913,40927,40944
31829,535,601,31510,319,31829,0,4.73052e+18,492.665,3372.93,31829,229,228,31177,30345,29944,29917,29118
12673,308,2437,12673,0,10211,2462,2.92948e+18,994.8,4552.55,12673,348,304,8577,6904,3491,2600,1905
26478,240,1475,0,26478,9427,17051,9.83921e+15,1029.3,4728.36,26478,387,332,21726,19921,8934,6177,5251
18226,1028,2466,15074,3152,9282,8944,7.4869e+17,1282.19,5302.7,18226,443,320,14759,12874,10785,10454,7911
48649,1518,2497,0,48649,0,48649,2.43389e+18,1502.33,7973.02,48649,644,438,45281,39237,28991,25614,35357
8478,179,1338,2945,5533,0,8478,3.69085e+13,396.834,2575.35,8478,272,186,6727,6166,2649,1954,1663
14485,1125,1945,7831,6654,7831,6654,4.91739e+18,845.196,4038.36,14485,379,284,12283,11398,8649,8583,8640
40466,1663,2189,0,40466,0,40466,2.48141e+18,1459.33,7135.47,40466,528,429,38133,32866,26850,23994,33575
37895,1782,2265,37895,0,30734,7161,3.02674e+18,1699.18,7549.3,37895,567,441,34895,28915,32955,32352,31296
12753,1305,2066,7006,5747,0,12753,5.09725e+18,732.272,3951.2,12753,315,273,10687,9867,7681,7438,8248
23576,7,43,22365,1211,23284,292,1.0418e+14,36.9386,702.949,23576,39,38,21438,20121,16449,16482,10388
17641,189,1402,6255,11386,0,17641,3.80277e+13,860.352,3807.08,17641,359,277,14148,12894,5979,4482,3479
11103,20,354,0,11103,10548,555,2.58365e+16,158.637,1339.85,11103,90,94,9680,8868,6937,5957,3458
30941,22,43,29388,1553,30326,615,1.02416e+14,39.8857,807.223,30941,42,40,30599,30285,25950,25850,21474
41879,1065,1644,14841,27038,0,41879,3.87955e+13,1159.13,6203.24,41879,485,391,38987,34964,27259,26892,31910
20848,552,658,20479,369,20848,0,4.60394e+18,451.829,2766.76,20848,218,191,20176,19760,18939,19015,18857
45962,2619,2879,45962,0,38292,7670,3.3222e+18,1764.59,8632.5,45962,687,462,43083,43083,42811,42876,42443
27402,2144,2232,14753,12649,14753,12649,4.97132e+18,1242.01,5839.13,27402,474,364,25170,25170,25094,25018,24503
28264,420,2201,0,28264,0,28264,2.44662e+18,1350.42,5985.12,28264,501,363,22514,20006,8413,5617,7669
25021,326,352,0,25021,23872,1149,2.51098e+16,266.996,1997.71,25021,119,121,24632,24181,24156,24127,23936
37499,1815,2877,37499,0,31027,6472,3.0597e+18,1628.56,7883.23,37499,579,445,34123,28684,32186,32327,27879
40639,647,1551,0,40639,14440,26199,9.79333e+15,1112.14,5909.6,40639,452,382,36021,32860,19636,14279,18492
557,70,302,261,296,0,557,5.92466e+18,31.1418,379.518,557,59,65,255,179,116,102,50
28494,339,2252,0,28494,0,28494,2.41719e+18,1346.02,6023.79,28494,526,367,22293,20070,8247,4804,5980
34743,1310,1506,12314,22429,0,34743,3.87699e+13,1107.59,5456.69,34743,433,376,33211,32314,29580,30156,31609
30256,578,2092,15297,14959,15297,14959,4.91545e+18,1349.67,6138.05,30256,460,383,24776,21836,10297,11241,11016
39685,328,2699,20319,19366,0,39685,5.03906e+18,1435.57,7621.83,39685,624,430,30838,27040,10216,8904,6463
19614,220,351,0,19614,18671,943,2.57129e+16,263.034,1795.29,19614,113,115,19066,18724,17220,16066,14308
1644,227,727,1644,0,1391,253,3.32238e+18,117.883,991.899,1644,133,108,917,671,393,306,385
19106,37,43,18266,840,18475,631,9.66294e+13,37.4049,620.866,19106,38,35,19050,19024,18386,18389,17600
11814,1317,1472,0,11814,4209,7605,9.64539e+15,518.996,3020.29,11814,299,242,10342,9909,9572,9222,9902
5617,1504,1729,4744,873,3005,2612,6.9006e+17,185.692,2559.14,5617,240,170,3888,3888,3811,3800,3768
30499,191,875,29677,822,30499,0,4.59128e+18,504.497,3521.46,30499,259,209,27649,24831,14588,13675,8403
6002,1368,1618,2859,3143,0,6002,4.86449e+18,210.74,2543.37,6002,245,174,4384,4382,3850,3800,3939
26502,210,2561,26502,0,21938,4564,3.33777e+18,1582.67,6451.84,26502,546,382,18063,14267,8126,5945,2754
34849,789,1764,12415,22434,0,34849,3.76584e+13,1087.41,5574.32,34849,524,349,31314,28681,19433,17701,21520
31497,756,2676,26379,5118,16686,14811,7.1622e+17,1595.29,7015.66,31497,584,391,25160,21772,15914,15705,11243
11151,381,684,10877,274,11151,0,4.71218e+18,335.224,2037.1,11151,176,148,10414,10135,8937,8971,7441
46388,2552,2905,46388,0,38684,7704,3.28801e+18,1768.45,8699.31,46388,694,471,43483,43482,42901,43033,42600
43691,218,680,32,43659,42575,1116,2.19022e+16,280.854,3690.71,43691,221,149,42792,42141,37963,33914,26764
6285,420,653,6053,232,6285,0,4.18936e+18,217.092,1534.29,6285,155,111,5632,5584,5088,5121,4884
41573,713,2152,19879,21694,19879,21694,5.01336e+18,1420.9,7282.57,41573,515,434,34712,29819,11767,12917,13937
38344,1962,2796,31924,6420,19992,18352,7.31758e+17,1679.46,7851.66,38344,628,424,35427,29767,29698,29392,29518
12632,948,1484,4500,8132,0,12632,3.72655e+13,580.637,3141.9,12632,316,237,11148,10510,9017,8728,9565
1898,31,320,1884,14,1898,0,4.5249e+18,123.537,677.73,1898,69,71,1015,491,380,309,169
2008,231,366,1912,96,2008,0,4.48192e+18,94.2829,722.315,2008,73,70,1642,1604,1492,1517,1175
2890,315,824,1661,1229,1661,1229,5.34217e+18,85.4647,1313.76,2890,133,124,2066,2065,1752,1499,956
36675,2355,2694,30372,6303,18895,17780,7.49084e+17,1714.79,7631.89,36675,597,422,33981,33981,32295,31879,33294
34589,898,2376,17915,16674,0,34589,4.99156e+18,1396.1,6711.17,34589,554,395,29617,26450,14269,13691,15321
13409,570,637,13215,194,13409,0,4.65896e+18,391.197,2218.72,13409,176,159,12772,12573,12380,12391,12015
48134,1336,2492,0,48134,0,48134,2.43175e+18,1489.53,7932.68,48134,670,441,43920,38307,25782,22893,31499
5380,91,1110,1902,3478,0,5380,3.84582e+13,162.908,1929.13,5380,176,163,3928,3197,1537,822,571
16676,434,1591,5860,10816,0,16676,3.73675e+13,823.336,3870.47,16676,350,268,14029,12931,7476,5923,6605
19174,1045,2175,9925,9249,0,19174,5.04404e+18,1069.66,4965.07,19174,397,304,16391,14672,9806,8867,10601
964,291,471,374,590,0,964,3.86416e+18,42.1266,616.716,964,117,74,493,490,470,477,455
7071,481,1722,3588,3483,0,7071,5.05404e+18,290.175,2814.79,7071,246,228,5349,4905,2584,2369,2006
27060,25,42,25705,1355,26506,554,1.01325e+14,38.7408,738.219,27060,40,38,26861,26708,23683,23618,19757
32613,130,353,0,32613,31077,1536,2.53892e+16,287.546,2299.45,32613,126,138,31523,30975,26265,22747,18123
41991,1869,2455,34290,7701,20997,20994,7.857e+17,1694.55,8018.08,41991,616,448,39201,32344,33768,32747,35682
46833,2040,2501,24592,22241,24592,22241,4.92085e+18,1489.83,7846.89,46833,636,431,44332,44331,39215,38683,42479
18030,907,1871,9423,8607,9423,8607,5.02614e+18,1081.64,4561.38,18030,341,314,15284,13751,9234,8978,9556
16069,509,1570,5714,10355,0,16069,3.69848e+13,823.375,3731.29,16069,379,268,13627,12622,7792,7902,5266
30789,2086,2267,16181,14608,0,30789,4.99724e+18,1335.2,6246.59,30789,503,379,28522,28522,27961,27813,27873
41096,2265,2428,21686,19410,21686,19410,4.90408e+18,1431.52,7289.36,41096,596,410,38668,38668,37862,37848,38014
11304,1082,1459,0,11304,4028,7276,9.78996e+15,565.195,3013.92,11304,279,241,9845,9303,8164,7527,8741
36115,1332,1432,0,36115,12797,23318,9.86339e+15,1107.42,5505.69,36115,464,369,34683,33534,33294,31706,33714
38769,10,42,37053,1716,37559,1210,9.70779e+13,39.0796,865.728,38769,40,39,37096,35915,30022,29135,20897
12851,538,665,12673,178,12851,0,4.70042e+18,389.425,2200.66,12851,185,154,12186,11940,11512,11562,10941
13367,168,359,0,13367,12610,757,2.72663e+16,228.78,1533.25,13367,101,103,12822,12540,10966,9789,8186
9615,39,1748,4853,4762,4853,4762,5.0017e+18,647.743,3288.85,9615,288,256,4604,2824,1481,1732,235
41793,1,44,39571,2222,41299,494,1.06709e+14,40.8441,935.5,41793,43,41,13835,13835,13835,13835,13835
43218,522,2490,22370,20848,22370,20848,4.89141e+18,1472.47,7564.18,43218,626,425,35294,31368,13257,15190,14089
26192,282,353,0,26192,24882,1310,2.59322e+16,283.669,2079.39,26192,120,132,25693,25188,23865,22504,22891
12373,1373,1841,0,12373,0,12373,2.44541e+18,861.661,3814.02,12373,321,264,10528,9535,8021,7749,9124
41682,420,2105,0,41682,0,41682,2.53898e+18,1465.75,7247.76,41682,527,445,33117,28645,9893,8514,11626
46312,133,357,0,46312,44164,2148,2.52635e+16,300.384,2741.13,46312,148,156,44854,44049,37406,32969,27184
3336,873,938,1710,1626,1710,1626,5.41793e+18,211.192,1512.05,3336,125,147,2398,2398,2395,2396,2350
30901,2835,5452,14281,16620,0,30901,4.35157e+18,818.287,9375.27,30901,884,473,25449,25079,17031,14936,14845
41419,957,2605,0,41419,0,41419,2.42242e+18,1424.08,7503.99,41419,656,436,35994,32094,17283,17025,18607
7826,1004,1755,0,7826,0,7826,2.50942e+18,435.88,3008.23,7826,269,187,6071,5765,4487,3997,3844
15633,1825,2245,12624,3009,7535,8098,8.23997e+17,1274.24,4886.3,15633,361,325,13297,12101,11692,11158,11999
26318,575,1842,12876,13442,12876,13442,4.97355e+18,1329.08,5574.12,26318,456,369,21403,18661,9065,8909,9071
17925,131,2130,0,17925,0,17925,2.43637e+18,1076.12,4751.55,17925,419,307,12389,9036,4558,1848,1635
41994,1014,2832,41994,0,35403,6591,3.32166e+18,1717.9,8159.5,41994,684,459,35138,30481,25874,24694,20053
20636,1406,2474,17009,3627,10464,10172,7.64209e+17,1372.24,5669.74,20636,460,341,17410,15162,13971,14066,12256
6172,232,632,5949,223,6172,0,4.49358e+18,223.218,1503,6172,157,111,5490,5161,3951,4046,2916
42629,1355,1829,0,42629,15098,27531,9.48572e+15,1123.46,6182.28,42629,599,367,40727,36493,31709,25928,37463
3157,737,1083,1544,1613,0,3157,4.87464e+18,183.011,1603.99,3157,221,126,2074,1933,1513,1478,1545
38501,2295,2696,38501,0,31848,6653,3.23665e+18,1695.44,7834.38,38501,568,440,35805,35646,35075,35223,34719
14011,1797,2195,11467,2544,7023,6988,7.84855e+17,1090.2,4543.71,14011,345,303,11715,10390,10485,10175,10496
32463,1556,1984,0,32463,0,32463,2.48389e+18,1410.07,6246.86,32463,472,390,30062,26111,22591,19839,26112
5083,490,1237,2771,2312,0,5083,5.03525e+18,203.099,2019.48,5083,253,194,3846,3661,2598,2595,1476
11345,461,1967,0,11345,0,11345,2.37275e+18,777.595,3709.28,11345,351,240,8718,7921,3656,2493,2829
9320,249,346,0,9320,8791,529,2.75474e+16,157.005,1239.4,9320,85,90,8974,8850,8397,8042,8024
29515,1508,2365,29515,0,24320,5195,3.08585e+18,1569.92,6670.88,29515,499,412,25818,22007,21823,20681,19847
29462,38,43,28102,1360,28641,821,9.78698e+13,37.0972,776.038,29462,39,38,29402,29370,29092,29092,27996
23041,1732,2065,12104,10937,12104,10937,4.90299e+18,1232.47,5288.97,23041,439,338,20953,18587,17552,17135,19268
24908,550,821,24274,634,24908,0,4.60608e+18,536.891,3190.61,24908,259,202,23950,23302,21364,21496,18667
9533,1289,1641,4494,5039,0,9533,5.16558e+18,749.172,3220.94,9533,267,254,7892,7206,6383,6116,6922
24804,2050,2140,12991,11813,0,24804,5.02239e+18,1247.92,5527.02,24804,475,348,22664,22664,22362,22316,22662
26542,317,1549,0,26542,9399,17143,9.71089e+15,1051.72,4816.8,26542,418,323,22100,20228,9868,7167,7451
38143,293,2235,18019,20124,18019,20124,4.98956e+18,1414.08,7094.48,38143,561,424,28672,24687,8327,8384,7708
42054,261,361,0,42054,39907,2147,2.61183e+16,309.445,2690.71,42054,148,154,41243,40380,37367,34841,33840
19714,941,1356,0,19714,6967,12747,9.83174e+15,916.47,3996.63,19714,344,294,17686,16210,12548,10465,14652
15716,923,1722,7511,8205,7511,8205,5.00175e+18,1069.37,4210.07,15716,332,303,13207,11733,7496,7333,9313
9874,421,1824,5162,4712,5162,4712,4.9904e+18,583.813,3329.48,9874,298,263,7682,6991,3790,3669,3178
44481,9,43,41961,2520,44041,440,1.06848e+14,40.8535,976.463,44481,43,42,41456,39502,31662,31363,20352
37947,127,2430,19997,17950,19997,17950,4.92115e+18,1413.02,7037.21,37947,566,409,26446,19897,9965,9783,3122
35187,9,43,33605,1582,34135,1052,9.7529e+13,39.5778,850.997,35187,42,39,33181,31850,25987,26017,18602
19652,131,593,19460,192,19652,0,4.79075e+18,442.942,2645.95,19652,195,196,16706,13062,7420,7501,5010
23319,15,42,22266,1053,22593,726,9.64326e+13,36.1578,670.379,23319,36,34,22824,22464,18870,18342,14757
34136,6,44,32368,1768,33486,650,1.02321e+14,40.7878,844.271,34136,43,41,30219,27650,22714,23089,15082
25524,924,1959,12532,12992,0,25524,5.01364e+18,1280.58,5557.86,25524,427,368,21747,19353,11431,9988,13640
10918,659,690,10691,227,10918,0,4.69616e+18,377.095,2050.24,10918,182,142,10228,10121,10179,10156,10149
41430,23,44,39098,2332,40992,438,1.06618e+14,41.8243,937.226,41430,44,42,40990,40569,34245,34096,28291
4341,897,1283,0,4341,0,4341,2.31629e+18,147.326,1953.79,4341,224,155,3058,3053,2433,2385,2478
9812,327,1295,0,9812,3490,6322,1.00031e+16,566.104,2765.77,9812,263,235,8005,7384,3903,3184,3403
26413,28,42,24926,1487,26134,279,1.06652e+14,39.2212,733.012,26413,41,37,26257,26158,23363,23394,20365
15894,471,1690,0,15894,0,15894,2.58029e+18,1078.99,4215.88,15894,320,306,12447,10995,5405,4270,5418
1566,101,492,0,1566,602,964,1.10899e+16,51.447,776.307,1566,100,94,1069,938,663,403,385
9357,1813,2126,9357,0,7855,1502,3.24408e+18,619.641,3610.34,9357,270,223,7231,6844,7081,7041,6547
31437,1641,1704,11136,20301,0,31437,3.72054e+13,1068.09,5263.84,31437,498,334,29733,29733,29552,29518,29564
38923,803,1746,18548,20375,18548,20375,5.01767e+18,1416.88,6637.34,38923,505,424,33073,29017,16132,14926,16951
24218,34,43,22830,1388,23971,247,1.07497e+14,37.7436,707.643,24218,40,38,24139,24084,22608,22624,21086
9745,409,1827,0,9745,0,9745,2.47267e+18,560.886,3308.5,9745,300,262,7571,6901,3702,3377,3040
31313,6,43,29868,1445,30454,859,9.81161e+13,39.1233,801.838,31313,41,37,28054,25955,21444,21714,13866
26533,581,2458,26533,0,21874,4659,3.06875e+18,1576.53,6381.8,26533,432,387,20442,17685,10754,9872,7991
42109,14,43,39710,2399,41723,386,1.06457e+14,41.3232,950.161,42109,43,42,40742,39702,32323,31235,23192
16233,641,687,15811,422,16233,0,4.68082e+18,439.702,2473.38,16233,201,171,15546,15289,15445,15456,15289
29718,1,43,28379,1339,28816,902,9.70835e+13,38.6835,774.33,29718,41,37,11025,11025,11025,11025,11025
33612,18,43,32002,1610,32762,850,9.98966e+13,41.4971,840.402,33612,42,40,33043,32628,27485,27306,20800
44737,2006,2443,0,44737,0,44737,2.43597e+18,1462.88,7602.22,44737,641,424,42294,42293,36414,35847,40291
42994,747,2129,21922,21072,21922,21072,4.94878e+18,1444.65,7268.18,42994,563,428,36402,32013,16771,18554,18814
28457,87,384,0,28457,26887,1570,2.72689e+16,305.671,2291.8,28457,132,139,27026,26333,20114,17175,12325
1695,818,848,1306,389,695,1000,9.1919e+17,81.305,1080.83,1695,143,105,847,847,845,844,845
31177,482,2214,25324,5853,15405,15772,7.99355e+17,1600.98,6773.84,31177,518,408,23515,20117,12465,12655,7149
43028,27,43,41056,1972,41784,1244,9.80927e+13,40.9526,944.339,43028,43,40,42771,42615,38339,38403,31767
7541,1491,2025,7541,0,6313,1228,3.19803e+18,289.831,3159.34,7541,254,194,5516,5508,5429,5440,4777
42250,41,43,39995,2255,41615,635,1.04389e+14,41.338,947.447,42250,43,42,42194,42156,42056,42055,40743
48079,2379,2642,38867,9212,23233,24846,8.11213e+17,1765.2,8892.91,48079,587,485,45437,45382,44070,43681,44952
39771,366,611,39334,437,39771,0,4.76605e+18,507.144,3777.83,39771,246,244,38220,36882,28493,28445,25286
46720,1161,2100,16599,30121,0,46720,3.72491e+13,1159.59,6790.87,46720,626,388,43841,39353,29784,28725,31335
19223,225,662,18991,232,19223,0,4.77054e+18,450.432,2698.3,19223,206,197,17649,16297,9692,9700,7813
12517,226,1457,0,12517,4465,8052,9.75708e+15,577.347,3116.24,12517,299,242,10322,9696,5368,2696,2753
28565,1216,1740,13515,15050,13515,15050,4.97962e+18,1335.12,5696.56,28565,437,386,25554,22154,16996,15848,21790
33371,292,363,0,33371,31715,1656,2.59655e+16,299.091,2383.96,33371,134,142,32833,32120,30584,28588,29425
37477,192,2347,19686,17791,19686,17791,4.89829e+18,1423.03,6923.51,37477,566,405,27770,23164,10113,11261,4461
3630,19,35,3454,176,3547,83,1.05224e+14,23.0355,253.399,3630,24,23,3573,3543,3226,3235,2875
46110,186,834,45208,902,46110,0,4.60453e+18,540.918,4278.66,46110,264,249,41786,37212,18618,17889,13073
1942,161,278,1935,7,1942,0,4.98578e+18,142.75,646.388,1942,72,76,1645,1482,1273,1277,1144
31971,189,2028,16031,15940,16031,15940,5.00559e+18,1353.76,6267.81,31971,459,402,23124,18380,7261,7412,3584
2413,649,807,2105,308,1452,961,5.9618e+17,51.9855,1124.99,2413,118,99,1606,1606,1565,1554,1507
4479,185,1247,4479,0,3906,573,3.16345e+18,143.294,1919.33,4479,140,153,3185,2464,1889,1268,729
32106,5,44,30289,1817,31788,318,1.06651e+14,40.2902,822.551,32106,42,42,26961,24236,20076,20364,12790
32423,1664,1874,16054,16369,16054,16369,4.97044e+18,1371.18,6189.2,32423,504,390,30516,27422,26123,26131,29931
7015,1876,1987,7015,0,5593,1422,2.97113e+18,456.373,3139.75,7015,230,189,5028,4857,5022,5026,4849
27394,1428,1919,13809,13585,13809,13585,4.94479e+18,1329.42,5703,27394,462,377,24914,21776,17797,16869,21421
14754,485,2602,14754,0,12096,2658,2.90004e+18,1229.07,5123.98,14754,447,318,10471,8447,5141,3753,2812
33275,422,1530,0,33275,11795,21480,9.77554e+15,1081.23,5324.98,33275,440,355,28404,25919,14310,9628,10414
12268,745,1959,0,12268,0,12268,2.48218e+18,845.206,3860.39,12268,336,280,9787,8847,5100,4628,4780
22216,416,687,21815,401,22216,0,4.59671e+18,476.995,2898.25,22216,224,201,21229,20617,15842,15998,14771
5298,186,513,5237,61,5298,0,4.72498e+18,226.82,1327.58,5298,112,115,4638,4142,2753,2808,2476
16014,296,755,15699,315,16014,0,4.62275e+18,416.509,2518.86,16014,210,176,14906,14202,9704,9674,7194
47736,750,2868,39717,8019,24944,22792,7.34961e+17,1773.71,8752.04,47736,689,459,38483,32913,23978,23668,13777
46416,438,1799,0,46416,16412,30004,9.5609e+15,1153.82,6457.4,46416,583,384,39947,36664,19234,12922,14768
28319,591,2378,28319,0,23542,4777,3.07855e+18,1631.71,6548.76,28319,515,387,21875,18774,11337,10334,6162
43208,1054,1473,0,43208,15317,27891,9.81235e+15,1124.14,6013.88,43208,491,383,40529,36217,28949,22088,34053
41933,731,2767,34309,7624,19925,22008,7.77384e+17,1891.99,8602.75,41933,636,447,32614,26328,17803,18258,12551
35579,108,354,0,35579,33866,1713,2.56523e+16,299.786,2415.84,35579,133,141,34225,33599,27431,23732,18190
1989,197,761,1989,0,1615,374,2.6558e+18,132.261,1089.77,1989,111,111,1228,737,463,327,424
9230,624,1836,0,9230,0,9230,2.51163e+18,554.382,3257.41,9230,266,256,7277,6563,3909,3586,3427
18491,1812,2539,18491,0,15552,2939,3.04506e+18,1254.22,5315.28,18491,413,310,15822,14072,15013,15331,13822
26216,281,2224,0,26216,0,26216,2.43123e+18,1313.85,5768.96,26216,496,353,20076,17668,7531,3734,4925
4414,507,938,0,4414,1518,2896,8.5976e+15,73.2336,1556.54,4414,174,119,3476,3460,2801,2901,2696
1598,300,433,0,1598,543,1055,8.81807e+15,23.1126,680.047,1598,100,77,1165,1165,1000,1072,953
44445,1201,1367,15715,28730,0,44445,3.86959e+13,1125.3,5979.61,44445,486,395,42668,37370,35812,35732,39815
28272,389,1959,14130,14142,0,28272,5.0777e+18,1336.16,5853.17,28272,445,381,22225,19640,8166,7772,7196
40336,1231,1751,19048,21288,0,40336,5.1061e+18,1421.88,6761.37,40336,513,431,36583,31458,23888,20728,31204
25316,1153,2256,20559,4757,12516,12800,8.07395e+17,1519.55,6134.35,25316,469,389,21126,18195,16072,15654,13892
32044,1957,2667,26711,5333,16752,15292,7.30974e+17,1634.73,7107.34,32044,576,395,29233,24753,24872,24165,25449
8961,688,1678,4215,4746,4215,4746,5.01661e+18,694.546,3176.98,8961,275,213,7003,6198,3719,3084,3502
38631,893,1953,18968,19663,18968,19663,4.96056e+18,1425.53,6821,38631,518,422,33252,29247,17002,16877,19831
17974,622,2404,15098,2876,9613,8361,7.09711e+17,1229.11,5136.54,17974,413,301,13906,12218,8148,8562,5867
41141,289,1521,0,41141,14589,26552,9.83568e+15,1118.26,5936.17,41141,479,384,34321,31301,14221,10064,8812
47317,1524,2988,47317,0,39613,7704,3.34806e+18,1772.96,8815.65,47317,713,463,41979,35811,39927,37376,29876
30083,19,349,0,30083,28496,1587,2.64225e+16,283.689,2241.79,30083,132,137,25941,23549,18138,15817,9140
4465,1211,1275,2073,2392,0,4465,4.92462e+18,161.289,1982.76,4465,202,168,3190,3190,3170,3160,3134
39985,15,42,37728,2257,39596,389,1.06466e+14,40.5602,908.083,39985,42,40,38902,38099,31193,30014,21395
42391,874,1652,0,42391,15033,27358,9.68126e+15,1155.47,6095.08,42391,497,376,38530,35075,23994,18414,29661
9514,1344,1431,0,9514,3359,6155,9.4429e+15,379.146,2716.8,9514,287,173,8083,7899,8012,7953,7804
29658,905,2252,15752,13906,0,29658,5.03729e+18,1328.28,6123.78,29658,500,368,25292,22794,13450,12862,13273
24985,822,2549,20728,4257,12916,12069,7.39056e+17,1448.63,6200.21,24985,505,358,20070,17264,12970,12976,9921
3917,986,1245,0,3917,0,3917,2.29611e+18,147.28,1860.23,3917,226,145,2672,2662,2376,2347,2407
39842,935,2431,20773,19069,20773,19069,4.89797e+18,1425.47,7203.18,39842,607,410,34513,30772,16469,19376,18487
6089,1241,1402,0,6089,0,6089,2.46057e+18,215.908,2335.45,6089,266,203,4687,4687,4508,4540,4382
24329,316,1979,12572,11757,12572,11757,5.00334e+18,1216.22,5377.93,24329,411,350,18890,16757,7403,7370,4927
46213,615,947,45256,957,46213,0,4.66932e+18,580.38,4445.1,46213,316,252,45189,44209,39833,39959,36992
27562,411,1861,13577,13985,0,27562,5.09324e+18,1336.22,5731.23,27562,416,382,21774,19119,7749,7204,7508
5581,246,583,5376,205,5581,0,4.48748e+18,217.464,1380.64,5581,136,103,4975,4717,3910,3924,2028
33035,152,1736,15653,17382,0,33035,5.12058e+18,1372.73,6115.66,33035,461,403,22937,16474,6280,4488,3838
17301,222,711,16886,415,17301,0,4.62688e+18,409.903,2563.09,17301,207,178,15868,14670,8944,8797,6928
41510,1114,2413,21288,20222,0,41510,5.06979e+18,1525.51,7506.34,41510,630,413,36582,32686,19689,17425,23975
25749,125,1787,20974,4775,19621,6128,1.47044e+17,63.6495,3466.3,25749,363,172,23785,23090,21200,15356,8271
27073,303,351,0,27073,25768,1305,2.56233e+16,286.512,2103.07,27073,122,128,26638,26085,25349,23977,24024
33359,163,358,0,33359,31681,1678,2.60505e+16,298.983,2379.81,33359,138,143,32312,31613,27707,23644,20823
6832,533,643,6622,210,6832,0,4.42026e+18,243.514,1583.49,6832,152,111,6189,6173,6040,6030,5296
9106,1264,1472,0,9106,3190,5916,9.53353e+15,379.668,2720.96,9106,301,208,7634,7447,7157,6842,7449
23199,25,43,22036,1163,22699,500,1.01166e+14,40.2107,697.365,23199,40,36,23007,22875,20243,20242,16807
34111,1,43,32163,1948,33788,323,1.06637e+14,41.774,858.078,34111,43,40,11106,11106,11106,11106,11106
19009,1378,1604,6797,12212,0,19009,3.74345e+13,802.481,3964.06,19009,390,281,17405,16202,15693,15669,16533
17436,301,731,16975,461,17436,0,4.69938e+18,442.513,2587.17,17436,221,172,16282,15525,12055,11665,8770
14807,1450,1993,0,14807,0,14807,2.40742e+18,890.44,4182.51,14807,349,285,12729,11655,9620,9350,10629
25336,161,362,0,25336,24156,1180,2.5173e+16,265.902,2043.82,25336,117,124,24567,24124,21330,18843,17601
3773,755,1155,3773,0,3207,566,2.98665e+18,189.506,1781.43,3773,137,132,2618,2522,2563,2551,1870
48146,1215,2634,48146,0,39729,8417,3.15607e+18,1754.47,8692.27,48146,654,477,41426,35247,33140,31761,24690
31508,1198,1393,0,31508,11154,20354,9.88072e+15,1065.67,5094.04,31508,431,346,29857,26409,24451,21806,27808
16889,17,42,15955,934,16715,174,1.06447e+14,35.4028,584.521,16889,37,35,16541,16262,13460,13398,10879
14086,41,48,13359,727,13913,173,1.1474e+14,33.45,546.979,14086,35,34,14038,14031,14000,13996,13697
23240,860,1846,11246,11994,0,23240,5.02037e+18,1276.26,5260.31,23240,421,356,19624,17416,10394,9097,12179
40956,41,44,38798,2158,40355,601,1.05467e+14,40.3477,925.297,40956,43,42,40903,40871,40763,40762,39484
21507,39,42,20497,1010,20933,574,9.9165e+13,36.7096,654.796,21507,38,36,21459,21443,21391,21389,20939
33978,375,2037,0,33978,0,33978,2.48498e+18,1357.44,6451.21,33978,473,407,26756,23733,9064,6824,8656
35745,171,2179,0,35745,0,35745,2.47317e+18,1381,6668.15,35745,531,402,25879,20666,8641,4500,3768
43518,763,906,42263,1255,43518,0,4.55985e+18,575.044,4207.12,43518,304,235,42612,42484,41469,41459,40778
42555,114,2520,0,42555,0,42555,2.43254e+18,1487.55,7515.24,42555,631,426,29012,21347,10954,4031,3061
5466,482,1178,1928,3538,0,5466,3.72614e+13,157.248,1981.99,5466,196,158,4288,4162,2773,2428,2561
25403,596,2149,13493,11910,0,25403,4.98221e+18,1300.73,5573.45,25403,475,340,20879,18578,9000,9333,7808
4889,577,1351,2317,2572,2317,2572,4.88392e+18,198.89,2132.13,4889,217,167,3538,3404,2004,1861,2107
12027,46,2283,9905,2122,6115,5912,7.66503e+17,948.327,4222.32,12027,351,253,5453,3244,2001,2186,364
1756,381,711,0,1756,0,1756,2.30057e+18,69.3451,1009.99,1756,135,102,1045,1033,538,523,431
2303,386,614,0,2303,785,1518,9.41905e+15,75.3938,1016.39,2303,125,107,1689,1683,1195,1241,1062
11502,2026,2166,9354,2148,5632,5870,8.03866e+17,943.565,4085.08,11502,319,272,9336,8534,9167,9039,9255
9417,280,348,0,9417,9044,373,2.36137e+16,76.1922,1170.45,9417,82,83,9069,9044,8771,8801,8135
39111,1338,2021,0,39111,0,39111,2.51689e+18,1395.4,6882.04,39111,500,430,35906,31201,24027,20965,29291
27494,20,42,26044,1450,27030,464,1.03196e+14,38.3519,743.842,27494,40,38,27130,26852,22867,22552,17700
14349,912,1313,5076,9273,0,14349,3.91188e+13,777.524,3360.79,14349,302,268,12678,11720,9233,8408,9951
39253,630,925,38198,1055,39253,0,4.61151e+18,571.75,4038.55,39253,306,233,38290,37305,34545,34363,32397
21473,492,881,20842,631,21473,0,4.62376e+18,446.282,2972.95,21473,249,191,20503,19957,17613,17524,13599
34154,887,2270,18058,16096,0,34154,5.04738e+18,1396.88,6557.09,34154,544,404,29403,26232,15068,14513,16623
33812,22,905,33391,421,33812,0,4.69887e+18,602.134,3937.81,33812,288,237,14395,5542,4585,4170,972
29077,186,384,0,29077,27505,1572,2.71707e+16,309.288,2311.8,29077,136,139,28138,27552,24015,20754,18551
45470,147,355,0,45470,43184,2286,2.58676e+16,308.381,2745.5,45470,147,158,44018,43151,36752,32283,28226
21668,2176,2469,18140,3528,11433,10235,7.21613e+17,1387.67,5712.99,21668,453,339,19199,19105,18070,17825,18391
33645,1874,2725,27528,6117,16184,17461,7.84688e+17,1775.9,7656.36,33645,562,422,30092,25283,24451,24294,25461
38554,223,2382,19473,19081,19473,19081,4.92249e+18,1388.66,7135.75,38554,532,412,28547,24613,9420,10228,5807
5211,320,1005,0,5211,1865,3346,9.78521e+15,141.282,1781.59,5211,227,167,4206,4058,2922,1914,1589
3984,666,1358,3984,0,3287,697,3.16012e+18,201.127,2002.33,3984,169,161,2626,2468,2317,2286,1492
36226,343,355,0,36226,34506,1720,2.55204e+16,292.283,2428.07,36226,132,145,35866,35353,35719,35493,35276
17555,168,730,17132,423,17555,0,4.5998e+18,477.703,2625.34,17555,214,173,15503,13571,7990,7773,5269
33382,1430,2471,27581,5801,17150,16232,7.59633e+17,1723.33,7153.3,33382,571,415,29073,24862,23277,23110,19804
38785,1221,2107,38785,0,31014,7771,3.03073e+18,1706.21,7498.87,38785,500,458,33028,27859,25236,23635,24164
18692,9,43,17789,903,18264,428,1.00772e+14,40.6206,630.389,18692,39,37,17540,16784,13579,13628,9023
10829,3,43,10237,592,10683,146,1.04569e+14,33.5672,471.325,10829,35,32,7803,6613,6006,6058,3999
35296,260,378,0,35296,33340,1956,2.71911e+16,307.159,2519.65,35296,139,152,34533,33788,30700,28123,27363
23297,301,1338,8254,15043,0,23297,3.88469e+13,981.32,4327.74,23297,377,319,19314,17595,8630,5540,6897
47972,103,2920,40188,7784,25482,22490,7.1588e+17,1731.96,8773.99,47972,686,454,29322,20485,14453,14972,4150
26870,27,42,25350,1520,26612,258,1.06808e+14,39.5761,744.712,26870,41,38,26687,26590,23519,23572,21076
31231,681,2863,31231,0,26124,5107,3.09511e+18,1541.33,7150.2,31231,515,415,24622,21271,15259,13423,9386
25588,986,1671,12113,13475,12113,13475,5.03845e+18,1279.12,5310.8,25588,412,369,22089,19534,13031,11752,14340
7495,21,1726,0,7495,0,7495,2.45434e+18,299.334,2839.71,7495,271,224,3460,1271,1488,824,139
550,222,344,286,264,0,550,5.85528e+18,17.9964,414.639,550,63,60,206,205,198,198,170
42894,1193,1353,0,42894,15178,27716,9.91578e+15,1120.11,5859.52,42894,469,393,41129,36019,34273,31333,38926
18402,837,1572,0,18402,6483,11919,9.31759e+15,849.611,3915.92,18402,420,272,16393,15187,11193,7942,9352
5953,431,637,5727,226,5953,0,4.24173e+18,233.76,1481.77,5953,194,108,5316,5273,5033,5048,4785
1617,87,659,1617,0,1344,273,2.79613e+18,125.115,930.016,1617,102,109,711,302,240,161,262
2754,16,43,2600,154,2752,2,1.09565e+14,24.8635,253.816,2754,25,26,2655,2589,2200,2174,1799
856,398,497,714,142,443,413,6.80903e+17,62.7033,625.05,856,84,84,359,359,347,348,338
7727,234,346,0,7727,7372,355,2.53093e+16,85.4191,1110.29,7727,73,71,7381,7357,7103,7014,6524
44526,1035,2207,0,44526,0,44526,2.46235e+18,1451.87,7459.25,44526,569,434,39255,34687,20339,18756,24821
37053,239,1748,13144,23909,0,37053,3.7557e+13,1097.32,5753.4,37053,499,361,30650,28243,12985,9162,8083
18464,513,2003,0,18464,0,18464,2.47617e+18,1094.31,4687.92,18464,384,316,14835,13337,7568,6748,6163
14774,1779,2509,14774,0,12105,2669,2.96956e+18,1109.67,4986.36,14774,424,287,12146,10784,11637,11784,10497
9587,57,347,0,9587,9126,461,2.5525e+16,152.354,1243.5,9587,84,84,9019,8752,6779,5837,4355
18580,720,2170,15172,3408,9301,9279,7.76606e+17,1325.36,5174.51,18580,379,333,14460,12382,8816,8849,6590
21602,199,756,20970,632,21602,0,4.64822e+18,466.276,2878.8,21602,223,187,19657,17823,11280,11121,7400
40969,1222,1784,19541,21428,19541,21428,5.02853e+18,1423.25,6859.92,40969,513,435,37148,31964,23838,21454,28634
19587,993,2060,9959,9628,9959,9628,4.83559e+18,1195.93,4924.22,19587,439,323,16596,14902,9621,9329,9817
19109,43,44,18116,993,18858,251,1.05732e+14,38.4602,636.92,19109,38,35,19064,19054,19009,19008,18763
31928,141,348,0,31928,30315,1613,2.61753e+16,292.278,2306.1,31928,133,138,30841,30245,25830,22411,18198
4549,484,1605,4549,0,3616,933,3.29315e+18,194.187,2304,4549,191,187,2944,2748,1867,1676,1358
10402,1003,2060,10402,0,8274,2128,3.02277e+18,952.271,3864.33,10402,288,275,7917,6887,5528,5330,5369
16470,4,42,15548,922,16280,190,1.07019e+14,36.1958,576.745,16470,36,34,13025,11431,9878,9836,6334
9751,1261,1931,0,9751,0,9751,2.41151e+18,618.393,3420.96,9751,319,232,7820,7344,5806,5817,5790
36349,246,351,0,36349,34424,1925,2.65898e+16,293.081,2476.64,36349,140,153,35597,34853,31906,29568,28847
32969,828,1357,0,32969,11707,21262,9.97492e+15,1075.51,5170.97,32969,425,364,29829,26965,19540,14895,22595
5854,399,1644,5854,0,4921,933,3.05704e+18,283.23,2589.58,5854,190,176,4201,3795,2555,2268,1440
24347,218,867,23702,645,24347,0,4.63129e+18,464.437,3153.16,24347,249,197,22277,20429,12484,12169,8434
14753,774,2300,12230,2523,7626,7127,7.44607e+17,1121.61,4669.89,14753,384,314,11375,9941,7284,7370,4979
39340,203,358,0,39340,37530,1810,2.51763e+16,288.807,2517.17,39340,137,151,38416,37679,34207,31342,27940
20084,435,1638,7097,12987,0,20084,3.71395e+13,908.663,4205.29,20084,426,284,16946,15747,8999,7255,7307
23326,222,1643,0,23326,8277,15049,9.53195e+15,975.954,4505.76,23326,430,306,19109,17614,8590,5290,4232
37826,1655,2472,19995,17831,19995,17831,4.92897e+18,1399.03,7065.97,37826,533,412,35228,30633,24797,23682,29540
17727,333,580,17593,134,17727,0,4.76539e+18,416.347,2483.22,17727,187,185,16803,16259,12613,12671,11480
28060,429,835,27478,582,28060,0,4.5385e+18,485.732,3357.03,28060,221,212,26875,26047,19290,19569,17303
4358,839,1377,4358,0,3737,621,3.42401e+18,192.419,2061.55,4358,202,141,2981,2874,2893,2839,1852
17651,1436,2027,9043,8608,9043,8608,4.92676e+18,1079.47,4651.95,17651,407,313,15420,13847,11035,10568,12535
29812,256,1817,0,29812,0,29812,2.53321e+18,1369.37,5925.39,29812,442,395,22197,19000,7088,4719,5408
44630,223,2692,44630,0,36848,7782,3.03816e+18,1742.4,8477.3,44630,596,472,30471,23747,13644,12096,4570
47685,335,356,0,47685,45463,2222,2.52826e+16,305.594,2785.2,47685,148,156,47279,46277,46666,46216,45783
13948,864,1565,0,13948,4919,9029,9.64903e+15,615.069,3507.35,13948,299,253,12279,11637,8019,6699,8968
8309,998,1679,4076,4233,0,8309,5.216e+18,533.185,3008.16,8309,250,234,6630,6179,4203,4042,4906
11583,212,2218,9810,1773,6332,5251,6.83681e+17,715.23,3933.89,11583,338,265,8193,6922,4459,4804,2428
46743,52,360,0,46743,44110,2633,2.73367e+16,318.861,2866.41,46743,160,168,43547,41747,30055,25934,17097
46956,22,42,44492,2464,46188,768,1.03111e+14,40.4655,975.189,46956,42,42,46476,46015,39082,38927,31089
39615,51,921,38498,1117,39615,0,4.49833e+18,589.134,4058.37,39615,261,231,26644,17044,11234,10007,2675
9249,1443,1501,0,9249,3275,5974,9.61138e+15,456.425,2829.92,9249,288,210,7748,7748,7710,7716,7741
8323,567,1987,8323,0,6683,1640,2.98321e+18,708.718,3405.3,8323,238,242,5903,5135,3181,2746,2706
7033,1245,1997,5897,1136,3714,3319,7.17113e+17,336.159,3075.27,7033,245,189,5036,4872,4323,4289,3991
47221,344,353,0,47221,45009,2212,2.53219e+16,301.654,2761.07,47221,146,159,46860,46299,46689,46572,46112
6216,1557,1700,6216,0,5237,979,3.2091e+18,241.429,2650.84,6216,216,173,4516,4515,4513,4516,4386
10864,691,1875,6029,4835,6029,4835,4.98702e+18,614.304,3468.09,10864,305,239,8819,8004,5191,5122,4582
46574,513,924,45306,1268,46574,0,4.59771e+18,620.208,4394.56,46574,290,239,45162,43783,37344,36556,30278
3348,238,261,0,3348,3152,196,2.79364e+16,43.5851,683.135,3348,59,52,3087,3087,3085,3087,3009
20420,1333,2612,20420,0,17195,3225,3.04098e+18,1299.25,5679,20420,421,336,17112,15008,15286,14634,10085
36330,318,1790,17243,19087,17243,19087,4.98193e+18,1410.62,6466.35,36330,490,417,27751,23937,7410,8070,5583
25777,255,2550,25777,0,21742,4035,3.31546e+18,1436.89,6245.26,25777,548,374,18349,15670,9378,7315,2753
19016,1203,2419,15873,3143,9923,9093,7.32523e+17,1372.32,5392.79,19016,425,340,15714,13733,12117,11951,9182
9952,790,1461,3546,6406,0,9952,3.7005e+13,272.469,2701.62,9952,262,175,8491,8234,6835,7156,6702
6087,478,1562,3256,2831,0,6087,4.87406e+18,174.077,2467.15,6087,239,157,4525,4336,2327,2172,2115
8309,1655,1936,0,8309,0,8309,2.39928e+18,385.825,3186.53,8309,297,222,6373,6257,5992,6054,6017
16669,1299,1974,8836,7833,0,16669,5.08422e+18,996.854,4444.9,16669,351,295,14353,13023,10425,9560,10821
44562,545,2108,15776,28786,0,44562,3.70471e+13,1136.13,6657.48,44562,617,377,38686,35508,19644,16738,21389
43443,269,806,42199,1244,43443,0,4.41729e+18,638.97,4178.65,43443,286,238,40585,37935,20912,20038,17340
42799,241,1617,0,42799,15197,27602,9.74864e+15,1160.14,6130.32,42799,528,382,35287,32374,14217,9720,9894
12874,973,1389,0,12874,4576,8298,9.74331e+15,721.068,3243.18,12874,298,255,11282,10504,8597,7405,9586
16088,775,1526,5693,10395,0,16088,3.72564e+13,826.427,3677.89,16088,366,268,13948,13079,9544,8906,9810
48956,568,2493,0,48956,0,48956,2.43332e+18,1505.89,8001.08,48956,659,438,40448,35733,15077,15532,13846
23346,1610,2214,19083,4263,11685,11661,7.78648e+17,1481.38,5858.84,23346,428,373,20443,17490,17253,17083,17535
21216,77,350,0,21216,20238,978,2.50891e+16,239.916,1820.09,21216,109,117,20278,19852,16023,14202,10372
45401,613,919,44269,1132,45401,0,4.63397e+18,608.657,4348.67,45401,289,239,44353,43091,38756,38672,35072
8155,261,1660,3827,4328,3827,4328,5.02205e+18,624.427,3016.97,8155,257,203,5818,5061,1814,1932,1322
28824,81,1675,0,28824,10226,18598,9.47805e+15,1018.9,4966.51,28824,503,318,21731,18567,9393,4718,2459
26741,87,824,25979,762,26741,0,4.59829e+18,503.962,3267.37,26741,263,200,20714,15318,9428,8242,3447
34734,422,603,34354,380,34734,0,4.73156e+18,508.62,3530.18,34734,238,232,33586,32513,27868,27863,25740
15557,1545,2207,12801,2756,7909,7648,7.61969e+17,1199.65,4767.44,15557,368,315,12980,11404,10929,11013,10863
22783,2062,2503,18931,3852,11810,10973,7.36736e+17,1430.17,5929.56,22783,497,347,20280,17473,18269,17892,18731
37133,846,1776,0,37133,13197,23936,9.56676e+15,1119.8,5774.21,37133,524,355,33499,30622,21122,14808,19646
35518,793,2246,0,35518,0,35518,2.44515e+18,1403.91,6648.05,35518,542,392,30211,27060,14779,14231,14904
49386,1711,2546,0,49386,0,49386,2.43158e+18,1477.24,8039.8,49386,659,445,46738,40368,32763,28955,39781
34553,663,1743,0,34553,12325,22228,9.5544e+15,1076.98,5487.75,34553,507,345,30657,28237,18935,12170,19343
9792,752,1696,4529,5263,0,9792,5.01622e+18,761.632,3316.68,9792,295,231,7713,7042,4162,3593,4478
1924,462,492,683,1241,0,1924,4.05301e+13,95.6731,817.272,1924,102,120,1432,1432,1423,1427,1398
5952,572,1928,4842,1110,2743,3209,8.15088e+17,291.907,2876.23,5952,243,202,4024,3505,2407,2479,1457
9489,1082,1425,3320,6169,0,9489,3.66993e+13,464.801,2789.78,9489,281,200,8064,7710,6968,6676,6713
10931,142,1379,0,10931,3908,7023,9.87003e+15,545.026,2911.86,10931,272,240,8639,7668,3866,2144,1824
42388,1035,2369,34636,7752,21234,21154,7.84758e+17,1756.3,8000.19,42388,576,456,35334,30298,25772,24475,20291
23534,53,2225,12451,11083,12451,11083,4.90715e+18,1187.66,5437.27,23534,471,326,13693,9550,5488,5373,824
26860,6,43,25535,1325,26277,583,1.01472e+14,39.4957,752.172,26860,41,39,23765,21805,17987,18188,11691
43009,1198,1562,0,43009,15248,27761,9.73876e+15,1149.25,6084.38,43009,492,382,40884,36264,30716,24096,36548
13251,312,667,13003,248,13251,0,4.65991e+18,382.054,2237.9,13251,176,158,12369,11881,8519,8565,7183
46638,198,360,0,46638,44325,2313,2.5915e+16,307.042,2803.03,46638,149,160,45470,44519,39810,35920,34253
47902,393,1763,22815,25087,0,47902,5.15484e+18,1473.7,7389.96,47902,540,459,37736,32657,11981,10376,13041
17546,872,2071,17546,0,13965,3581,3.08839e+18,1345.17,5027.84,17546,359,336,13695,11583,8291,7735,7529
33066,309,390,0,33066,31303,1763,2.63467e+16,302.087,2466.04,33066,135,150,32518,31927,30315,28185,28698
14061,103,348,0,14061,13318,743,2.6556e+16,224.662,1539.71,14061,106,109,13422,13153,10606,8831,6898
42434,32,1800,0,42434,0,42434,2.55329e+18,1437.65,7003.97,42434,523,442,18357,9569,4251,3899,1062
30161,62,2332,30161,0,24898,5263,3.12438e+18,1611.61,6714.69,30161,486,410,15587,9587,6870,6942,1968
48510,591,1712,0,48510,17255,31255,9.73188e+15,1148.9,6545.34,48510,536,394,42758,38988,23359,15680,18210
31721,36,43,29892,1829,31434,287,1.06437e+14,40.3204,826.148,31721,42,40,31633,31563,29829,29841,27274
33142,725,1788,0,33142,11730,21412,9.52175e+15,1078.5,5443.48,33142,531,339,29450,27093,17777,13054,18960
34481,1911,2260,18048,16433,0,34481,4.96101e+18,1390.19,6570.89,34481,555,383,32221,32064,27352,26459,30360
25590,288,357,0,25590,24374,1216,2.55314e+16,274.682,2045.56,25590,118,127,25118,24645,23590,22300,23201
15023,529,2347,15023,0,12515,2508,3.29046e+18,1120.02,4722.06,15023,397,279,11301,9861,6704,6118,3783
2364,413,574,0,2364,789,1575,8.67311e+15,83.8921,976.535,2364,115,108,1790,1789,1407,1487,1361
43816,684,1885,0,43816,15597,28219,9.5757e+15,1142.52,6340.03,43816,584,380,38971,35705,22606,14572,17306
41299,1228,2365,0,41299,0,41299,2.46205e+18,1450.27,7276.38,41299,584,429,37122,32715,21766,18876,26220
25124,1394,2251,0,25124,0,25124,2.50254e+18,1199.36,5814.17,25124,435,371,22350,19726,14878,12876,16176
10569,1124,1327,0,10569,3754,6815,9.86602e+15,644.847,2922.33,10569,276,221,9242,8562,7958,7223,8583
1458,419,486,0,1458,0,1458,2.5942e+18,108.909,750.404,1458,96,96,972,972,936,927,928
21476,32,42,20388,1088,21035,441,1.01418e+14,38.0116,656.023,21476,38,36,21393,21335,19746,19779,17782
27820,1934,2572,23175,4645,14506,13314,7.32094e+17,1587.62,6573.79,27820,516,372,25063,21347,21570,21175,22202
44651,2364,2784,23925,20726,0,44651,5.00475e+18,1422.49,7887.4,44651,660,446,41867,41867,38135,37200,38978
20279,222,1320,0,20279,7152,13127,9.81876e+15,931.051,4009.96,20279,334,301,16429,15070,6556,5224,4618
44998,1308,2192,0,44998,0,44998,2.46583e+18,1460.13,7498.59,44998,581,441,41083,35602,25511,22052,31700
27417,359,1805,0,27417,0,27417,2.50821e+18,1311.68,5655.99,27417,441,384,21249,18742,6656,5297,7536
21069,1368,1468,0,21069,7456,13613,9.71448e+15,938.496,4206.73,21069,379,300,19601,18720,18944,18386,19355
5588,94,1446,2998,2590,2998,2590,4.71074e+18,166.661,2282.27,5588,226,144,3692,2960,1769,1994,1213
48143,706,1902,17063,31080,0,48143,3.71397e+13,1166.9,6643.64,48143,616,383,42992,39335,25113,22414,29357
27781,2002,2592,27781,0,23206,4575,3.30727e+18,1580.42,6610.62,27781,566,375,25101,21416,24265,24344,22659
28947,149,352,0,28947,27661,1286,2.4893e+16,263.197,2132.29,28947,122,131,28074,27609,24042,21703,17291
24222,986,2461,20370,3852,13009,11213,7.05818e+17,1424.59,5990.84,24222,469,348,19739,17522,14728,14300,11947
5244,49,320,0,5244,4989,255,2.38269e+16,68.9375,896.706,5244,64,62,4823,4583,3458,3149,2148
2845,47,236,0,2845,2683,162,2.80126e+16,40.2014,604.491,2845,52,47,2595,2486,1939,1792,1237
9716,411,1406,3417,6299,0,9716,3.62635e+13,475.238,2775.47,9716,299,197,8065,7590,4771,4027,3907
33084,846,2267,17427,15657,17427,15657,4.93203e+18,1366.65,6445.32,33084,533,389,28324,25323,14319,15892,14801
2212,476,808,2212,0,1652,560,3.12878e+18,103.144,1171.17,2212,111,132,1404,1390,1364,1378,1079
43795,100,354,0,43795,41836,1959,2.49204e+16,291.171,2629.62,43795,141,154,42204,41461,34117,29390,23577
799,132,532,362,437,362,437,4.74069e+18,37.1827,621.72,799,128,88,267,204,83,78,27
49744,118,2639,0,49744,0,49744,2.45467e+18,1471.72,8170.49,49744,622,443,34346,25694,13245,5232,3382
44252,2897,2908,44252,0,36701,7551,3.30985e+18,1768.21,8534.58,44252,661,463,41344,41344,41344,41344,41344
22681,373,1607,8033,14648,0,22681,3.73433e+13,947.78,4427.01,22681,411,303,19198,17670,9882,7710,6742
24963,1071,1666,8796,16167,0,24963,3.82563e+13,1047.87,4845.49,24963,412,331,22695,20574,15686,15330,18641
12218,237,352,0,12218,11525,693,2.74419e+16,208.055,1451.67,12218,101,97,11777,11593,10739,10156,10079
21647,558,2031,11515,10132,0,21647,4.99023e+18,1163.49,5031.61,21647,456,322,17710,15935,9062,8640,6642
6441,1677,1948,5134,1307,3046,3395,8.41717e+17,291.764,2972.25,6441,248,206,4493,4482,4363,4294,4266
26228,1846,2242,0,26228,0,26228,2.43575e+18,1320.59,5785.82,26228,499,352,23986,23851,19862,18986,22656
24559,281,593,24350,209,24559,0,4.77127e+18,464.475,2946.98,24559,209,210,23135,22060,14515,14546,13345
3331,41,43,3150,181,3279,52,1.04275e+14,25.8586,280.372,3331,29,28,3288,3286,3285,3284,3272
5062,11,40,4806,256,4970,92,1.04817e+14,24.8876,308.818,5062,28,27,4840,4676,3940,3823,2745
22790,184,2064,12066,10724,0,22790,5.0409e+18,1227.32,5259.75,22790,429,332,16857,13719,6436,4145,2905
45767,323,359,0,45767,43603,2164,2.53722e+16,304.545,2733.51,45767,147,156,45296,44302,43870,41965,43002
13386,1591,2262,13386,0,10892,2494,3.22233e+18,1073.26,4464.11,13386,382,309,10977,9733,10482,10028,9024
35623,38,43,33712,1911,35057,566,1.03897e+14,39.7473,862.81,35623,42,41,35552,35505,34993,34990,32283
2957,666,917,2614,343,1807,1150,5.58709e+17,63.1803,1322.57,2957,125,119,2040,2039,1939,1930,1773
14176,350,2162,14176,0,11565,2611,3.12424e+18,1124.67,4562.66,14176,339,316,10098,8668,4560,3797,2295
21384,567,826,20755,629,21384,0,4.59094e+18,466.065,2935.72,21384,237,193,20510,20017,18823,18964,16772
18812,26,43,17834,978,18461,351,1.03092e+14,39.0626,631.604,18812,39,38,18654,18570,16477,16511,14738
14989,250,1476,5310,9679,0,14989,3.72934e+13,710.876,3449.97,14989,377,255,12486,11618,6272,6096,3358
34969,1829,3052,34969,0,29695,5274,3.16723e+18,1538.89,7561.75,34969,580,417,31600,27129,29623,29885,23778
41350,916,1705,14659,26691,0,41350,3.76358e+13,1125.47,6071.86,41350,499,371,37835,34337,23625,23669,26038
21903,484,623,21688,215,21903,0,4.76268e+18,444.054,2815,21903,206,200,21160,20695,18927,18896,17574
25756,227,350,0,25756,24397,1359,2.6595e+16,275.527,2076.67,25756,123,134,25091,24590,22380,20607,19142
8493,1178,1960,8493,0,6819,1674,3.03031e+18,722.102,3407.37,8493,246,244,6533,5812,5403,5223,4579
15639,1215,2351,13062,2577,8203,7436,7.23786e+17,1121.11,4821.67,15639,395,302,12578,11321,10014,10077,8912
20694,177,1431,0,20694,7331,13363,9.78924e+15,954.128,4169.15,20694,362,308,16433,14908,6285,4873,4090
39861,296,354,0,39861,37997,1864,2.53317e+16,296.523,2540.19,39861,139,151,39313,38503,36984,34923,35172
40622,1186,1448,0,40622,14375,26247,9.8043e+15,1122.66,5831.59,40622,477,383,38672,34124,30130,25575,34400
33555,18,43,32043,1512,32526,1029,9.72394e+13,39.5189,828.738,33555,42,39,33022,32634,27726,27556,21188
26797,729,936,26110,687,26797,0,4.52277e+18,490.806,3368.12,26797,231,204,25861,25803,24646,24639,23219
47319,1519,2242,0,47319,0,47319,2.4724e+18,1459.99,7703.27,47319,584,442,44387,38211,30170,26030,36374
34595,1066,1550,12234,22361,0,34595,3.89152e+13,1066.16,5502.71,34595,450,363,32177,28810,23309,22336,26000
39884,297,2344,20883,19001,20883,19001,4.92175e+18,1442.98,7128.35,39884,589,410,31061,27455,11419,12122,7340
2427,590,844,1235,1192,0,2427,5.15268e+18,125.511,1245.09,2427,139,131,1583,1576,1159,1128,1214
40529,652,2428,21417,19112,0,40529,4.99618e+18,1422.45,7240.83,40529,592,411,33851,29910,13744,15177,13945
36223,302,2369,36223,0,29810,6413,3.01225e+18,1709.07,7426.08,36223,549,447,25756,21576,11856,10189,6172
14888,5,44,14067,821,14698,190,1.06782e+14,38.0049,560.728,14888,38,35,12497,11225,9331,9437,6096
15113,747,1525,5377,9736,0,15113,3.73503e+13,754.159,3566.28,15113,366,256,13089,12308,8871,8832,6666
10376,213,348,0,10376,9828,548,2.66328e+16,173.429,1322.99,10376,94,91,9978,9821,9016,8491,8042
15692,663,2203,12881,2811,7965,7727,7.7359e+17,1179.79,4762.39,15692,371,318,12064,10519,7674,7627,5365
38305,457,2313,20180,18125,0,38305,5.00723e+18,1410.91,6962.44,38305,594,402,31067,27622,12423,13030,10352
46615,587,1347,0,46615,16440,30175,9.91646e+15,1116.57,6099.77,46615,495,396,41071,37354,21952,16812,23565
10786,1724,2208,10786,0,9100,1686,3.33257e+18,673.716,3837.03,10786,300,231,8578,8033,8284,8153,7336
7639,874,1286,2672,4967,0,7639,3.78834e+13,318.708,2409.82,7639,249,187,6353,6152,5210,5293,5282
31092,695,1708,0,31092,11028,20064,9.52942e+15,1063.36,5239.91,31092,491,333,27565,25336,16837,10907,13620
35048,1308,2833,35048,0,29480,5568,3.22516e+18,1565.72,7452.36,35048,627,417,30261,26223,26914,25455,21140
34351,147,358,0,34351,32742,1609,2.5166e+16,275.247,2345.78,34351,130,142,33300,32717,28342,24833,21846
7011,446,598,6881,130,7011,0,4.73599e+18,242,1590.28,7011,136,116,6413,6375,6179,6193,5528
40598,37,43,38344,2254,40156,442,1.06848e+14,40.5901,931.504,40598,43,41,40508,40433,38321,38325,36619
34457,1044,2251,18396,16061,18396,16061,4.95002e+18,1375.74,6540.27,34457,536,395,30238,26961,17293,18042,18350
23982,1025,2143,0,23982,0,23982,2.45767e+18,1245.61,5463.18,23982,468,340,20547,18474,12143,11323,13185
30101,388,1784,0,30101,0,30101,2.54045e+18,1354,5909.86,30101,437,401,23612,20639,8388,6477,8120
48820,34,42,46372,2448,47737,1083,1.0137e+14,39.716,987.063,48820,42,41,48709,48602,45933,45999,42966
36582,321,348,0,36582,34669,1913,2.6509e+16,291.571,2471.91,36582,137,151,36149,35313,35041,34284,34437
11374,346,1440,3982,7392,0,11374,3.61642e+13,511.912,2955.54,11374,318,198,9495,8936,4947,4285,4683
3991,43,1189,0,3991,0,3991,2.79432e+18,204.949,1850.6,3991,165,147,1818,1038,482,386,99
8826,455,1800,0,8826,0,8826,2.50535e+18,495.945,3156.52,8826,276,252,6830,6168,3326,3046,2555
7027,1217,1348,2456,4571,0,7027,3.62786e+13,143.277,2307.86,7027,230,163,5679,5677,5535,5571,5436
18645,178,2061,14993,3652,8880,9765,8.3212e+17,1398.71,5179.38,18645,384,345,11808,8096,4955,5153,2013
34192,1878,4603,15463,18729,15463,18729,3.48678e+18,1042.08,9169.57,34192,720,546,29589,28405,14811,16064,10807
39735,1311,2447,20744,18991,0,39735,4.98489e+18,1429.51,7219.55,39735,608,410,35873,31446,21023,19273,24554
29476,1335,1340,0,29476,10435,19041,9.92489e+15,1040.64,4843.63,29476,405,346,28136,28136,28123,28135,28135
829,347,379,829,0,712,117,2.92784e+18,94.3402,525.607,829,81,85,450,450,442,436,445
3738,266,943,0,3738,1353,2385,1.03816e+16,137.031,1543.71,3738,133,139,2795,2683,1277,1073,853
20897,77,2080,20897,0,16725,4172,2.98247e+18,1433.86,5473.38,20897,381,358,10383,5714,3481,3216,1129
49011,628,724,48338,673,49011,0,4.66552e+18,532.08,4300.75,49011,267,257,48287,48215,46503,46547,45908
20127,516,2227,20127,0,16546,3581,3.08984e+18,1370.13,5420.91,20127,373,341,15233,13148,8160,7492,5467
43478,1532,2013,0,43478,15363,28115,9.46442e+15,1153.91,6488.53,43478,607,375,41465,41439,33595,29535,40287
14297,2025,2349,11984,2313,7629,6668,7.16368e+17,1026.11,4574.38,14297,376,284,11948,10819,11061,10879,11120
11975,13,354,0,11975,11374,601,2.58626e+16,182.549,1397.24,11975,94,95,9891,8776,6982,6178,3747
40789,9,43,38907,1882,39624,1165,9.81912e+13,40.6005,917.065,40789,43,40,38457,36922,30179,30211,20480
3315,523,1210,3315,0,2651,664,3.23061e+18,106.82,1745.3,3315,177,137,2105,2046,1579,1559,1044
34005,1163,1745,0,34005,0,34005,2.52818e+18,1391.88,6208.78,34005,484,411,30382,26337,19254,16379,23533
41142,431,920,40087,1055,41142,0,4.59964e+18,573.694,4116.88,41142,307,234,39543,38203,30745,30419,24927
1343,23,450,680,663,0,1343,5.14369e+18,107.182,692.676,1343,94,100,425,211,99,116,39
29822,700,1914,14930,14892,0,29822,5.10047e+18,1374.75,5968.39,29822,447,386,24859,21608,11597,10414,12334
23705,124,352,0,23705,22601,1104,2.53851e+16,250.447,1950.2,23705,117,129,22867,22462,18992,16730,13974
31210,30,43,29570,1640,30696,514,1.0349e+14,41.18,815.062,31210,42,40,31037,30931,27858,27895,25506
22879,786,2069,11477,11402,11477,11402,4.9006e+18,1241.05,5368.14,22879,427,343,19067,17100,9460,9757,9753
17934,1117,1577,6378,11556,0,17934,3.69943e+13,789.96,3825.9,17934,394,258,16096,15115,12883,13503,13470
18772,720,2432,18772,0,15538,3234,3.31894e+18,1379.75,5384.5,18772,472,339,14470,12574,9166,8329,6479
27555,1154,1337,9803,17752,0,27555,3.89689e+13,1034.18,4697.96,27555,389,343,25847,22971,21062,21265,23857
48239,659,966,46969,1270,48239,0,4.59886e+18,617.563,4505.47,48239,299,246,47201,46142,43085,43012,39443
5571,1732,1798,5571,0,4416,1155,2.93739e+18,247.644,2669.06,5571,203,205,3773,3773,3772,3772,3742
26436,40,352,0,26436,25162,1274,2.57201e+16,280.54,2086.84,26436,122,125,24607,23472,17996,15518,10187
44557,6558,7053,2000,42557,1228,43329,2.03888e+18,864.845,12555,44557,974,603,37504,37504,37356,36773,35917
38134,1901,2485,31336,6798,19336,18798,7.6699e+17,1671.35,7661.8,38134,575,427,35467,29431,30371,29212,31574
33655,147,354,0,33655,32059,1596,2.55708e+16,294.93,2351.62,33655,132,138,32590,31991,27713,23997,19622
9739,655,1767,4712,5027,4712,5027,4.80435e+18,641.911,3312,9739,317,235,7735,6995,4044,3886,4089
18626,1135,1946,9476,9150,0,18626,4.97494e+18,1108.5,4707.92,18626,394,317,16145,14414,10489,9530,11486
26583,1668,1719,0,26583,0,26583,2.54073e+18,1304.23,5468.85,26583,425,376,24864,24804,24617,23504,24752
6812,528,1720,0,6812,0,6812,2.47817e+18,291.127,2787.5,6812,233,237,5092,4666,2339,2126,2016
7006,1290,1298,0,7006,2480,4526,9.9671e+15,261.976,2334.18,7006,208,222,5708,5638,5706,5654,5692
7368,405,1765,3895,3473,0,7368,5.02997e+18,256.84,2853.89,7368,279,179,5603,5151,2922,2308,1642
1054,10,26,991,63,1054,0,9.29351e+13,17.3501,119.49,1054,18,18,985,948,839,854,733
29541,945,2242,15536,14005,0,29541,4.99877e+18,1348.88,6106.29,29541,506,365,25307,22635,13950,13105,13827
32982,462,2250,32982,0,26973,6009,2.99957e+18,1661.04,6987.74,32982,513,416,24791,21222,11356,9724,7137
2158,68,718,0,2158,0,2158,2.72274e+18,106.084,1099.39,2158,106,113,1129,689,455,282,237
48600,1622,1897,17190,31410,0,48600,3.69844e+13,1166.99,6673.7,48600,644,382,46703,46703,42366,42837,46077
35307,5,43,33601,1706,34452,855,1.00099e+14,40.3149,853.671,35307,42,40,30231,27223,23447,23696,14346
21853,25,43,20712,1141,21477,376,1.03211e+14,39.9625,679.881,21853,40,37,21664,21534,18993,19036,15768
24235,185,352,0,24235,23057,1178,2.56625e+16,269.738,1985.3,24235,114,127,23534,23096,20641,18700,15682
27581,72,353,0,27581,26233,1348,2.57209e+16,286.506,2128.88,27581,119,130,26233,25649,20068,17176,12054
5245,48,244,0,5245,5026,219,2.38224e+16,63.3071,782.106,5245,60,60,4946,4793,4012,3416,2305
8102,629,1817,0,8102,0,8102,2.44692e+18,338.025,3039.73,8102,290,179,6285,5847,3903,3633,2601
9280,372,1658,4268,5012,0,9280,4.9691e+18,698.205,3177.03,9280,295,226,6976,6264,2210,1900,1721
10274,252,687,9870,404,10274,0,4.45159e+18,310.138,1938.7,10274,142,131,9402,8874,6479,6287,5006
6722,61,641,6511,211,6722,0,4.55238e+18,255.093,1583.22,6722,184,118,4732,3221,2059,1912,730
39545,1137,2437,32250,7295,19653,19892,7.89465e+17,1700.89,7791.36,39545,572,442,33430,28398,24786,24109,22625
11488,1688,2011,9243,2245,5574,5914,8.34434e+17,1021.71,4013.6,11488,321,274,9477,8325,8605,8308,8634
12519,791,1301,0,12519,4443,8076,9.92697e+15,726.689,3143.51,12519,275,251,10782,10102,7609,6597,7991
48334,1049,2493,48334,0,39346,8988,3.13807e+18,1780.69,8682.24,48334,614,490,40380,34184,26789,26209,25444
37603,26,43,35877,1726,36548,1055,9.87258e+13,40.5463,882.368,37603,42,40,37346,37183,33338,33418,29367
40957,822,1635,14496,26461,0,40957,3.79614e+13,1129.95,6028.75,40957,486,376,36951,33648,22031,22224,24349
28119,718,832,27277,842,28119,0,4.54787e+18,515.004,3345.82,28119,253,207,27287,27190,26597,26594,26257
39056,1588,1824,13849,25207,0,39056,3.72208e+13,1115.24,5955.66,39056,562,360,37232,37232,34614,34537,36681
10105,1928,2028,10105,0,8204,1901,3.151e+18,816.127,3757.9,10105,279,231,8077,7437,7982,7991,7960
9958,210,625,9817,141,9958,0,4.67762e+18,304.252,1881.75,9958,148,144,9053,8373,5217,5279,3434
26062,802,1621,8753,17309,0,26062,2.81068e+13,302.873,4228.67,26062,594,211,24441,24438,17608,20142,19031
3343,421,436,3333,10,3343,0,4.63402e+18,183.375,1012.88,3343,91,97,2907,2900,2898,2896,2892
28979,6,43,27464,1515,28438,541,1.03221e+14,37.9143,778.197,28979,41,40,25547,23341,19185,19433,12447
47629,32,42,44967,2662,47119,510,1.07274e+14,40.2859,991.529,47629,42,42,47463,47301,43170,43255,40037
25735,171,896,24906,829,25735,0,4.50585e+18,475.416,3246.51,25735,258,199,23006,20382,11288,11358,6867
32451,2255,2788,27064,5387,17058,15393,7.25396e+17,1550.82,7194.5,32451,540,386,29663,29631,27308,26869,27756
39868,1178,1354,14069,25799,0,39868,3.86618e+13,1104.02,5647.68,39868,466,379,38016,33470,30948,30857,35128
7635,389,1378,0,7635,2713,4922,9.5719e+15,214.019,2450.02,7635,268,163,6257,5927,4127,2487,2324
20971,1325,2051,10824,10147,0,20971,5.02439e+18,1197.75,5085.62,20971,416,327,18479,16367,12741,11593,14025
32673,77,348,0,32673,31057,1616,2.58343e+16,278.751,2306.95,32673,130,142,31151,30454,24001,20668,15450
46375,1439,1888,16450,29925,0,46375,3.72351e+13,1166.9,6518.9,46375,609,379,44487,42031,36871,37909,42659
31349,310,595,31029,320,31349,0,4.75462e+18,490.497,3342.71,31349,232,230,29781,28526,20428,20412,17536
25828,318,1955,12729,13099,12729,13099,4.92956e+18,1297.26,5598.58,25828,435,366,19811,17318,6122,6584,3935
25185,9,43,24073,1112,24439,746,9.69658e+13,36.7204,713.938,25185,38,36,23835,22939,18892,18660,12670
25176,34,43,24008,1168,24496,680,9.88676e+13,40.0055,725.144,25176,40,37,25089,25021,23676,23678,21714
12152,958,2212,10306,1846,6606,5546,6.78945e+17,871.702,4092.93,12152,340,272,9607,8648,6917,6940,5857
7919,1698,2134,7919,0,6612,1307,3.24743e+18,379.778,3331.56,7919,288,218,5785,5728,5741,5759,5380
20132,255,795,19956,176,20132,0,4.79018e+18,505.074,2936.37,20132,244,193,18411,16908,9955,9904,8588
2452,373,796,0,2452,0,2452,2.23464e+18,103.883,1208.1,2452,122,119,1656,1615,734,804,635
11337,755,2013,9086,2251,5448,5889,8.3584e+17,1007.06,3972.49,11337,297,265,8473,7307,5313,5390,4568
11009,230,671,10672,337,11009,0,4.53664e+18,328.565,2007.9,11009,188,135,10044,9411,6254,6006,4956
3777,598,1162,1733,2044,0,3777,4.88089e+18,149.636,1726.15,3777,204,151,2615,2581,1516,1306,1569
32135,220,905,31246,889,32135,0,4.5815e+18,522.8,3639.72,32135,303,218,29516,27155,16579,16158,10657
31602,1107,1771,15044,16558,0,31602,5.15194e+18,1359.47,6029.65,31602,473,398,27841,24408,17272,14395,19994
3528,989,1048,1819,1709,1819,1709,5.38583e+18,202.393,1648.71,3528,128,149,2480,2480,2480,2479,2448
16085,653,1319,5632,10453,0,16085,3.79685e+13,844.878,3560.93,16085,318,279,13976,12845,8531,7490,9374
12838,1488,1521,4498,8340,0,12838,3.6731e+13,722.738,3325.4,12838,347,238,11317,11317,11268,11302,11313
5655,592,1189,2007,3648,0,5655,3.88025e+13,198.146,2067.28,5655,191,197,4466,4340,2906,2880,2767
47594,901,2044,0,47594,16909,30685,9.51975e+15,1152.63,6752.57,47594,617,383,43337,39717,26474,19769,25391
5733,614,1158,2000,3733,0,5733,3.81283e+13,151.368,2006.58,5733,221,180,4575,4532,3229,3308,3108
28004,216,1941,13984,14020,0,28004,5.08358e+18,1309.3,5799.33,28004,439,367,20619,17718,6664,4848,2834
49830,614,2619,25819,24011,0,49830,4.97282e+18,1509.94,8195.05,49830,663,445,41336,36407,15881,17438,18441
28674,2207,2621,28674,0,24067,4607,3.32341e+18,1527.77,6643.74,28674,562,393,26053,25948,25487,25560,25175
21343,991,2106,0,21343,0,21343,2.52655e+18,1346.63,5370.73,21343,427,351,17718,15976,9515,8304,10859
35029,864,882,34175,854,35029,0,4.60312e+18,561.243,3796.02,35029,294,225,34147,34132,34106,34102,33976
49705,615,2557,40675,9030,25019,24686,7.8438e+17,1779.84,8798.1,49705,587,481,38993,33141,22197,22425,14533
12317,265,2171,10111,2206,6228,6089,7.80816e+17,1015.58,4205.48,12317,340,293,8482,7225,4134,4506,1603
15741,697,2345,13148,2593,8283,7458,7.22435e+17,1143.93,4831.01,15741,377,313,12168,10640,7746,7761,5157
21349,238,346,0,21349,20249,1100,2.63302e+16,259.948,1886.45,21349,114,121,20797,20421,18837,17590,17714
41156,332,356,0,41156,39272,1884,2.51106e+16,294.399,2574.79,41156,139,151,40748,39914,39957,39999,39101
36172,74,355,0,36172,34503,1669,2.50923e+16,283.361,2405.09,36172,131,144,34555,33812,26827,23448,17141
43933,178,2971,43933,0,36891,7042,3.32509e+18,1745.71,8495.84,43933,683,462,29746,22036,13637,9510,913
49426,274,896,48743,683,49426,0,4.71647e+18,582.456,4605.09,49426,297,256,46235,43208,24922,25288,18362
39412,23,42,37224,2188,39090,322,1.0605e+14,39.7187,902.243,39412,42,41,39020,38663,33389,33321,28509
40327,307,352,0,40327,38355,1972,2.5793e+16,292.464,2570.29,40327,142,152,39816,38922,37975,35742,37535
40581,208,2867,33834,6747,21261,19320,7.25592e+17,1705.74,8112.43,40581,610,435,27995,22036,12766,15045,4263
15776,35,42,14992,784,15447,329,1.00647e+14,34.6742,558.781,15776,36,34,15723,15706,15123,15127,14890
1295,13,26,1280,15,1188,107,7.34664e+13,8.5027,130.063,1295,14,14,1267,1260,1224,1222,1200
26384,2025,2062,26384,0,21125,5259,3.0271e+18,1561.65,6145.71,26384,431,390,24322,24285,24296,24298,24296
3731,917,1213,1621,2110,1621,2110,4.46835e+18,183.192,1814.59,3731,213,137,2518,2474,2282,2272,2257
49160,166,349,0,49160,46658,2502,2.6195e+16,310.529,2862.88,49160,149,163,47739,46646,40873,35286,30416
14605,253,1845,7602,7003,0,14605,5.03063e+18,918.796,4065.7,14605,349,294,11127,9888,4398,3547,2472
44346,1986,2579,36474,7872,22584,21762,7.64779e+17,1725.32,8289.78,44346,594,455,41697,34570,35720,34763,38674
10353,632,1458,0,10353,3673,6680,9.48548e+15,411.188,2816.47,10353,291,180,8895,8399,6272,4596,6170
34647,1475,2138,34647,0,27612,7035,2.96429e+18,1653.11,7111.02,34647,479,440,30622,25434,28955,27802,25346
19674,626,1632,0,19674,7000,12674,9.64727e+15,853.452,4139.36,19674,378,287,17115,15942,10542,7769,10871
39829,1627,2053,19786,20043,19786,20043,4.92433e+18,1475.84,6999.72,39829,533,427,37550,32163,28444,27059,34734
20656,1101,1638,7368,13288,0,20656,3.74811e+13,910.717,4250.75,20656,418,292,18783,17247,13858,13826,15831
6772,1873,1929,5682,1090,3660,3112,7.15924e+17,273.361,2921.83,6772,273,199,4843,4843,4833,4836,4819
20909,8,44,19806,1103,20649,260,1.06497e+14,39.0739,662.123,20909,39,36,19291,18255,14757,14670,9654
12961,1337,2509,12961,0,10584,2377,2.8747e+18,1020.75,4673.46,12961,323,329,10201,9270,8254,7885,7656
40640,1398,2898,40640,0,33834,6806,3.28535e+18,1730.77,8180.22,40640,640,446,35344,30306,32197,29377,22174
16483,1505,2012,8790,7693,0,16483,5.03031e+18,984.598,4437.94,16483,363,293,14332,13034,11696,11044,11557
34834,870,1605,0,34834,12293,22541,9.62471e+15,1090.84,5484.67,34834,470,351,31512,28869,19973,15394,23198
9881,166,1859,5545,4336,5545,4336,4.9755e+18,447.683,3259.94,9881,296,192,7290,6120,3373,3506,1908
22937,359,2158,12060,10877,0,22937,5.0225e+18,1151.2,5324.61,22937,447,338,18099,16420,7047,6833,4986
38358,69,352,0,38358,36573,1785,2.52685e+16,290.869,2484.63,38358,135,145,36564,35780,27986,24112,16508
4328,46,1014,2610,1718,0,4328,5.33354e+18,124.165,1681.81,4328,186,135,2575,1963,1292,795,211
27347,1275,1330,0,27347,9685,17662,9.92937e+15,1015.6,4657.27,27347,396,341,26008,23415,25694,24121,25538
2413,21,610,0,2413,818,1595,9.13881e+15,109.818,1040.96,2413,104,106,1218,853,478,292,99
18247,43,44,17381,866,17749,498,9.79697e+13,37.5637,613.434,18247,37,35,18202,18197,18155,18154,17977
12840,297,1958,0,12840,0,12840,2.39977e+18,794.995,3873.96,12840,345,244,9811,8859,4284,2996,1924
30652,259,353,0,30652,29248,1404,2.51798e+16,279.505,2213.26,30652,127,133,30045,29533,27610,26141,25628
29928,956,1870,10606,19322,0,29928,3.78657e+13,1109.52,5437.5,29928,507,340,26997,24752,16665,16868,17461
17620,1060,1989,0,17620,0,17620,2.4644e+18,1058.28,4577.89,17620,380,310,15039,13644,9232,8436,10094
11791,84,1968,6026,5765,0,11791,4.88684e+18,782.67,3761.34,11791,341,242,7454,5686,2889,1920,940
1270,80,126,0,1270,1190,80,2.63266e+16,33.0591,307.591,1270,36,35,1144,1140,1048,1034,950
34259,143,626,33740,519,34259,0,4.66029e+18,485.717,3498.73,34259,244,228,29855,24457,13141,12958,8542
44348,1108,2003,0,44348,15740,28608,9.46484e+15,1168.78,6497.01,44348,609,375,41281,37381,27108,20173,27429
39117,518,1774,18596,20521,0,39117,5.13762e+18,1415.94,6695.05,39117,513,426,31677,27475,12112,10507,13689
3868,553,914,1366,2502,0,3868,3.97727e+13,117.542,1511.88,3868,182,146,2954,2940,2457,2505,2220
6217,18,40,5956,261,5995,222,9.53948e+13,29.6635,340.932,6217,28,27,6114,6056,5240,5255,4714
9471,401,619,9231,240,9471,0,4.57593e+18,328.803,1848.87,9471,170,141,8826,8614,7453,7568,6944
29372,1264,2367,23931,5441,14582,14790,7.92938e+17,1588.39,6698.02,29372,490,401,24937,21458,19394,18994,16769
5427,555,1700,5427,0,4552,875,3.40766e+18,183.127,2516.53,5427,255,179,3727,3525,2686,2520,1978
37106,375,2159,0,37106,0,37106,2.47243e+18,1426.63,6820.34,37106,522,414,29309,25964,10039,6779,6667
48242,1521,3358,39701,8541,22889,25353,7.56421e+17,1947.21,9769.73,48242,713,473,41443,35315,31039,31787,31112
12496,1293,1957,6391,6105,0,12496,5.06131e+18,853.812,3887.06,12496,338,279,10539,9553,7482,7154,8167
45443,1149,1891,0,45443,16086,29357,9.49062e+15,1158.06,6452.35,45443,607,371,42558,38407,29089,21326,35268
15333,200,337,0,15333,14484,849,2.7511e+16,223.571,1580.73,15333,106,115,14834,14545,13131,12036,11103
20498,517,1336,7250,13248,0,20498,3.86237e+13,956.459,4065.49,20498,345,299,17588,15958,9370,7762,9726
8540,594,1904,8540,0,6954,1586,3.0001e+18,367.823,3290.56,8540,235,247,6518,6230,4212,3671,2708
40154,1232,2834,40154,0,33449,6705,3.29836e+18,1695.41,8062.61,40154,620,441,34338,29560,28662,27364,19704
48377,25,43,46196,2181,46948,1429,9.75568e+13,40.0384,995.303,48377,43,41,48032,47774,42753,42819,35252
4626,235,1049,0,4626,1616,3010,9.06715e+15,131.327,1749.81,4626,210,127,3575,3369,1728,1899,1297
42957,3,43,40671,2286,42241,716,1.04086e+14,40.6577,951.562,42957,43,42,30658,25815,23391,23880,15806
19225,147,354,0,19225,18321,904,2.54273e+16,227.61,1755.1,19225,108,114,18558,18267,15909,14410,12211
38331,155,1909,0,38331,0,38331,2.52641e+18,1441.84,6781.2,38331,498,436,26896,19522,8094,4185,3827
5526,162,326,0,5526,5198,328,2.78529e+16,67.9247,938.42,5526,72,67,5200,5158,4643,4396,3548
8300,403,1411,2959,5341,0,8300,3.73288e+13,269.179,2558.05,8300,239,171,6889,6482,4149,3845,3508
2449,91,164,0,2449,2364,85,2.24795e+16,24.4173,467.119,2449,41,44,2285,2274,2137,2039,1847
45279,1871,2912,45279,0,37926,7353,3.3228e+18,1761.24,8593.16,45279,665,464,41794,35107,39179,37061,34036
29697,2025,2637,29697,0,24877,4820,3.34296e+18,1596.99,6841.47,29697,592,401,26998,22990,26050,25911,24472
11380,1825,2184,9285,2095,5660,5720,7.96444e+17,915.495,4059.15,11380,332,288,9196,8315,8440,8314,8553
21296,961,2385,17280,4016,10207,11089,8.0392e+17,1447.2,5848.55,21296,432,354,16870,14625,11279,10991,9842
42653,2141,2749,22784,19869,0,42653,5.02089e+18,1378.97,7681.79,42653,598,416,39904,39894,34780,33930,36738
44706,1923,2382,23669,21037,0,44706,5.02634e+18,1473.5,7553.89,44706,603,428,42324,42085,35293,34153,39258
31267,883,1756,0,31267,0,31267,2.5592e+18,1387.1,6003.54,31267,445,401,26603,23404,14386,11433,17077
8284,1343,1440,0,8284,2936,5348,9.4575e+15,204.719,2539.82,8284,230,174,6844,6817,6831,6835,6684
32862,1856,2037,16565,16297,16565,16297,5.0108e+18,1360.23,6360.77,32862,459,401,30825,30825,29255,29008,30075
48490,477,1827,0,48490,17206,31284,9.55254e+15,1156.34,6601.53,48490,582,386,42041,38513,21303,14548,20730
42452,1324,1480,0,42452,15027,27425,9.8272e+15,1139.74,5998.45,42452,483,386,40972,38897,37491,36038,40035
16862,833,1391,5936,10926,0,16862,3.77221e+13,874.576,3721.89,16862,328,280,15000,13716,10198,10375,11136
13369,1681,1810,6605,6764,0,13369,5.0271e+18,914.74,3950.38,13369,326,293,11559,10521,11336,11040,11252
22559,753,2020,11725,10834,11725,10834,4.94745e+18,1184.23,5204.88,22559,434,338,18772,16844,9719,9809,9938
19243,31,360,0,19243,18167,1076,2.72459e+16,265.66,1840.31,19243,117,124,17310,16134,11773,10067,6016
34472,3046,4012,15546,18926,15546,18926,4.73462e+18,1067.48,8515.52,34472,1049,420,30460,30452,23519,20074,20753
814,23,24,776,38,801,13,1.0443e+14,13.4459,106.787,814,15,16,790,790,786,786,785
4579,1593,1594,3667,912,2157,2422,8.36116e+17,231.713,2303.48,4579,202,168,2985,2985,2985,2985,2985
22189,334,349,0,22189,21183,1006,2.51321e+16,242.735,1857.55,22189,112,120,21829,21482,21660,21583,21536
46975,1510,2496,0,46975,0,46975,2.44068e+18,1489.41,7855.63,46975,642,444,43626,37899,28539,24187,34113
40174,923,2323,20942,19232,20942,19232,4.89798e+18,1458.46,7151.39,40174,590,414,34780,31051,17417,19355,18258
34879,533,1945,17129,17750,17129,17750,5.02029e+18,1374.74,6490.57,34879,479,409,28300,24771,10481,10732,9494
30708,660,2035,15637,15071,15637,15071,4.96488e+18,1336.23,6094.5,30708,474,392,25541,22511,11685,12401,11792
27648,1336,1711,0,27648,9861,17787,9.63071e+15,1035.92,4966.92,27648,443,324,25877,23417,20738,17373,24149
20135,253,351,0,20135,19254,881,2.46145e+16,226.734,1768.84,20135,109,116,19693,19397,18180,17580,16433
31769,20,43,29954,1815,31449,320,1.06977e+14,39.8687,823.267,31769,42,40,31294,30922,26062,25709,19554
568,305,319,406,162,256,312,1.07891e+18,47.537,400.669,568,69,59,249,248,242,240,245
43696,1675,1896,0,43696,15467,28229,9.50707e+15,1159.24,6359.63,43696,601,372,41800,41800,39937,39028,41457
11559,693,737,11346,213,11559,0,4.73683e+18,357.799,2138.51,11559,201,144,10822,10815,10793,10743,10773
5765,11,43,5497,268,5617,148,9.66246e+13,24.4394,350.943,5765,29,30,5504,5324,4532,4446,3599
16629,1133,2358,16629,0,13793,2836,3.28187e+18,1183.17,4960.59,16629,400,315,13485,11894,10900,10337,8529
18701,606,2042,18701,0,14928,3773,3.04292e+18,1367.47,5149.75,18701,372,349,14135,12076,7363,6395,6754
42115,1,45,40166,1949,40877,1238,9.74923e+13,40.0614,926.832,42115,42,41,15537,15537,15537,15537,15537
32700,1051,1482,0,32700,11525,21175,9.92157e+15,1046.37,5228.48,32700,418,365,30596,27618,21672,18623,25876
28700,220,353,0,28700,27336,1364,2.54889e+16,285.324,2163.6,28700,127,133,27986,27451,25167,23212,21591
33483,667,2136,33483,0,26851,6632,2.95366e+18,1652.05,6996.79,33483,469,433,26004,21523,13410,12066,11679
11908,77,1307,0,11908,4206,7702,9.90071e+15,672.348,3055,11908,288,250,8508,6904,3087,2256,1082
8102,1135,1377,2888,5214,0,8102,3.82915e+13,282.448,2527.68,8102,206,180,6725,6599,6208,6342,6169
28003,24,43,26571,1432,27492,511,1.02899e+14,39.7658,765.675,28003,41,40,27748,27550,24200,24158,19371
2305,441,450,2304,1,2305,0,4.89929e+18,142.25,867.91,2305,119,73,1855,1855,1853,1853,1855
4198,297,475,3989,209,4198,0,4.49013e+18,192.734,1110.98,4198,104,90,3723,3624,3465,3503,2595
2355,213,765,1894,461,1222,1133,8.36662e+17,159.706,1167,2355,117,117,1578,1042,788,955,754
9094,1371,1848,5082,4012,0,9094,5.0444e+18,331.315,3133.12,9094,249,180,7246,7084,6463,6403,5596
15109,886,2342,15109,0,12541,2568,3.29197e+18,1142.64,4776.52,15109,410,316,11730,10295,8244,7858,6433
2711,599,973,0,2711,0,2711,2.2933e+18,122.122,1416.6,2711,193,122,1738,1699,1498,1479,1583
9616,513,2286,8017,1599,4952,4664,7.4317e+17,691.757,3796.43,9616,334,240,6940,6104,3753,4014,1787
12758,721,2316,10632,2126,6674,6084,7.33145e+17,916.614,4292.98,12758,362,287,9751,8630,6087,6152,5051
43739,213,357,0,43739,41664,2075,2.55141e+16,309.26,2686.87,43739,147,155,42732,41866,38068,34791,31973
19677,1024,1636,0,19677,6949,12728,9.51023e+15,908.779,4164.38,19677,424,282,17728,16261,12512,11062,12818
10730,290,607,10654,76,10730,0,4.71998e+18,343.237,1967.17,10730,169,146,9945,9517,7174,7268,6331
20247,286,2435,16617,3630,10034,10213,7.62409e+17,1355.9,5690.37,20247,411,340,14027,11602,6281,6988,3381
12964,79,628,12846,118,12964,0,4.74189e+18,364.026,2176.1,12964,167,160,9464,6331,3516,3519,1951
4792,1091,1696,3889,903,2256,2536,7.9084e+17,205.041,2478.16,4792,212,171,3096,3058,2665,2538,2283
11326,1194,1688,5550,5776,0,11326,5.12307e+18,810.609,3537.96,11326,294,277,9550,8664,6990,6393,7845
9292,18,42,8794,498,9128,164,1.01631e+14,28.1621,423.045,9292,32,30,9131,9011,7833,7794,6823
27954,2381,2578,27954,0,23184,4770,3.29383e+18,1598.54,6632.29,27954,554,377,25376,25376,25226,25260,25352
26255,1850,2093,13916,12339,13916,12339,4.94319e+18,1326.52,5663.66,26255,459,350,24162,23615,21247,20940,22880
33974,533,1522,11997,21977,0,33974,3.88436e+13,1061.28,5409.65,33974,447,368,29477,26759,14581,12632,14231
49309,918,1023,47953,1356,49309,0,4.56106e+18,615.788,4603.43,49309,323,252,48286,48210,47582,47591,46700
13505,573,1605,0,13505,4801,8704,9.37685e+15,631.829,3371.53,13505,340,208,11451,10744,7304,5494,7039
42295,2060,2825,35295,7000,22137,20158,7.2921e+17,1754.61,8265.85,42295,654,451,39435,32988,33219,32576,36105
32558,1576,1768,11577,20981,0,32558,3.71173e+13,1102.29,5429.12,32558,513,334,30790,30790,29356,29362,30535
47164,9,43,44941,2223,45897,1267,9.89379e+13,40.9303,986.155,47164,43,41,44437,42633,34733,34767,23010
13809,2082,2323,11396,2413,7086,6723,7.61375e+17,1029.49,4510.16,13809,380,296,11486,10442,10856,10741,10767
4673,33,40,4393,280,4662,11,1.05832e+14,26.1603,304.783,4673,28,27,4633,4622,4402,4399,4366
18800,668,1721,8934,9866,8934,9866,5.00938e+18,1156.32,4616.58,18800,351,328,15254,13454,7346,6629,8429
9909,115,2330,9909,0,8285,1624,3.24397e+18,672.689,3838.06,9909,367,229,6029,4250,2911,2471,693
38070,307,2695,38070,0,31925,6145,3.10822e+18,1737.37,7715.79,38070,581,428,27871,23829,14881,13000,5017
32075,1389,2241,17159,14916,0,32075,5.00205e+18,1329.37,6303.43,32075,526,382,28923,25584,19296,17744,21723
36252,202,1619,12826,23426,0,36252,3.75472e+13,1113.19,5595.79,36252,475,357,29558,26973,12188,7671,7951
20542,1579,1710,0,20542,0,20542,2.52991e+18,1235.05,4821.3,20542,369,329,18738,16215,16593,16021,18257
32703,1075,1710,0,32703,11611,21092,9.56353e+15,1090.6,5368.29,32703,495,344,30097,27398,21232,16345,25963
4294,996,1290,4294,0,3677,617,3.0385e+18,193.443,1972.44,4294,159,139,3004,2996,2947,2927,2121
8729,118,1640,4149,4580,0,8729,5.24616e+18,677.835,3093.65,8729,255,249,5541,3961,1703,1318,907
14300,5,42,13504,796,14171,129,1.06921e+14,37.0028,543.465,14300,37,35,12034,10828,9012,9132,5885
12175,316,1686,5749,6426,0,12175,5.12308e+18,918.2,3697.02,12175,311,265,9079,7951,2851,2357,2123
17839,1577,2352,15130,2709,9734,8105,6.76775e+17,1206.25,5061.88,17839,408,310,15078,13378,12857,13030,12298
2397,107,372,2260,137,2397,0,4.11771e+18,83.0505,759.644,2397,78,65,1971,1710,1435,1457,1132
12224,31,43,11674,550,11844,380,9.70567e+13,35.2957,507.599,12224,36,35,12147,12112,11277,11277,10147
33148,42,1937,11768,21380,0,33148,3.7162e+13,1071.39,5613.38,33148,570,363,22092,17723,9666,3842,1775
48807,125,2323,48807,0,39529,9278,3.03916e+18,1766.02,8593.66,48807,585,485,29189,18283,10946,8441,3523
30523,209,352,0,30523,29134,1389,2.52461e+16,276.776,2215.88,30523,125,133,29780,29247,26779,24791,22590
43841,4424,5250,36008,7833,22201,21640,9.71812e+17,1463.07,11159.1,43841,952,544,38591,38587,38135,37769,36518
17821,622,1714,8510,9311,0,17821,5.14614e+18,1114.23,4466.02,17821,343,311,14435,12694,6461,5445,7412
11424,345,368,0,11424,10836,588,2.68324e+16,168.92,1396.92,11424,97,93,11056,10948,10933,10847,10828
5814,598,1580,2755,3059,2755,3059,5.02778e+18,245.68,2477.39,5814,231,172,4234,3956,2396,2008,2057
27436,29,43,26190,1246,26594,842,9.76691e+13,39.0133,746.044,27436,40,37,27291,27197,24968,24912,22675
48626,18,43,46186,2440,47595,1031,1.01213e+14,41.073,1007.95,48626,43,43,47775,47142,39507,39225,29589
6632,1552,1645,3509,3123,0,6632,4.87246e+18,210.301,2620.6,6632,277,214,4987,4987,4982,4985,4985
30305,263,380,0,30305,28860,1445,2.54729e+16,278.945,2288.08,30305,129,141,29676,29158,27013,25247,23527
24628,40,351,0,24628,23229,1399,2.7304e+16,283.87,2064.76,24628,126,134,22621,21372,15246,13463,8972
8094,304,1650,3701,4393,0,8094,4.96048e+18,497.512,2939.04,8094,275,220,6036,5397,2193,1789,2229
12042,478,2283,9882,2160,6000,6042,7.74271e+17,936.408,4220.83,12042,343,264,8820,7848,4993,5256,3260
860,55,377,860,0,681,179,2.59408e+18,96.8186,531.844,860,73,78,312,143,129,124,130
7696,460,1426,0,7696,2729,4967,9.56122e+15,271.789,2542.38,7696,257,188,6270,5935,3607,2757,2686
39313,8,43,37436,1877,38321,992,9.99231e+13,38.9502,901.14,39313,42,40,36582,34844,28443,28243,18945
16564,1035,2020,7778,8786,0,16564,5.05857e+18,1110.75,4627.32,16564,391,317,13784,12554,7929,6998,9527
17752,179,1872,9006,8746,9006,8746,4.98376e+18,1100.1,4580.62,17752,353,305,12714,10308,4540,4692,2249
33297,37,43,31713,1584,32443,854,9.92186e+13,40.7166,832.981,33297,42,39,33222,33169,31685,31691,30184
17837,1830,1847,8866,8971,0,17837,5.0916e+18,1125.71,4577.92,17837,357,318,15990,15990,15949,15761,15990
42456,834,4132,14965,27491,0,42456,3.568e+13,815.556,8728.79,42456,963,487,37383,34727,20935,20377,18524
5781,724,1212,2071,3710,0,5781,3.80083e+13,165.674,2085.94,5781,203,160,4569,4511,3596,3859,3193
32927,364,800,31969,958,32927,0,4.41904e+18,608.451,3642.42,32927,251,221,31181,29965,18671,18093,16032
39297,185,2715,39297,0,32072,7225,2.87419e+18,1842.91,8279.57,39297,602,455,24360,16983,9254,6762,3823
44598,268,2473,23643,20955,23643,20955,4.9378e+18,1458.82,7622.63,44598,602,439,34343,30082,12748,13419,7063
37416,14,43,35551,1865,36704,712,1.03078e+14,40.8947,889.048,37416,42,40,36349,35561,29457,28573,20453
41944,1763,2186,0,41944,0,41944,2.5497e+18,1480.22,7350.59,41944,525,463,39687,36798,30002,28313,36727
44629,807,1614,0,44629,15792,28837,9.6423e+15,1142.44,6187.95,44629,534,382,40505,36842,24207,17720,23930
44954,2396,2577,44954,0,37072,7882,3.09956e+18,1801.32,8371.86,44954,621,456,42377,42374,42015,42007,41747
45348,872,1750,21598,23750,21598,23750,5.02177e+18,1442.52,7159.06,45348,535,447,39137,34232,20266,18542,22310
24286,83,352,0,24286,23175,1111,2.5303e+16,254.061,1975.72,24286,117,128,23240,22766,18472,16053,12699
4395,1165,1271,0,4395,0,4395,2.69485e+18,231.519,1988.53,4395,200,160,3124,3122,3034,3034,3016
27200,28,43,25882,1318,26557,643,1.00462e+14,39.0341,748.311,27200,40,38,27040,26957,24444,24480,21556
3056,453,1045,1386,1670,1386,1670,4.62231e+18,130.502,1551.35,3056,193,125,2011,1952,1477,1441,1503
28776,1524,1707,10232,18544,0,28776,3.74559e+13,1061.34,5081.01,28776,466,331,27069,27068,25054,25092,26782
42694,292,1376,0,42694,15091,27603,9.90298e+15,1117.08,5891.72,42694,491,390,35572,32274,15028,11165,11965
23832,1324,2173,12396,11436,12396,11436,4.89114e+18,1194.33,5442,23832,489,341,21048,18804,13790,13841,14782
40467,51,350,0,40467,38307,2160,2.66493e+16,305.054,2617.09,40467,144,159,37891,36480,26841,23108,14994
10872,658,1754,0,10872,0,10872,2.47331e+18,784.999,3539.35,10872,298,233,8549,7663,4396,3980,4056
41058,1116,2498,21379,19679,21379,19679,4.89921e+18,1462.85,7389.9,41058,614,415,36311,32167,19289,21140,22853
16234,1998,2042,8483,7751,0,16234,5.01615e+18,981.694,4431.99,16234,369,295,14192,14192,14139,14061,14187
19579,71,2087,10112,9467,10112,9467,4.88162e+18,1184.35,4914.85,19579,435,314,11879,8424,4487,4327,920
6844,520,629,6742,102,6844,0,4.67947e+18,235.259,1605.37,6844,144,123,6215,6204,6091,6096,5805
34812,1126,1353,0,34812,12377,22435,9.9974e+15,1089.18,5307.48,34812,431,375,32829,29061,25843,21359,29515
24311,125,1611,0,24311,8629,15682,9.50154e+15,991.984,4554.75,24311,444,300,19151,16926,8321,4736,3046
21051,241,356,0,21051,20062,989,2.52105e+16,245.584,1836.23,21051,109,121,20530,20207,18826,17693,16752
35837,495,884,34871,966,35837,0,4.58641e+18,560.821,3838.16,35837,295,224,34575,33455,28571,28340,24195
18618,1837,2339,18618,0,15348,3270,2.98139e+18,1379.63,5344.75,18618,432,331,16113,13952,15401,15624,14022
38009,81,2377,31037,6972,18978,19031,7.83848e+17,1680.33,7588.27,38009,538,439,20348,12358,8488,8643,1766
18415,922,2238,0,18415,0,18415,2.48076e+18,1048.59,4911.11,18415,406,308,15440,14076,9245,7973,7853
5283,198,259,0,5283,5069,214,2.44421e+16,55.2544,817.898,5283,60,59,5024,5016,4975,4979,4757
38573,655,2129,30916,7657,18339,20234,8.41398e+17,1706.49,7496.49,38573,524,446,29963,24930,17268,16993,12369
23347,429,2511,23347,0,19482,3865,3.28265e+18,1433.36,5993.58,23347,539,367,17452,15356,9398,7738,5787
20041,122,345,0,20041,19031,1010,2.62904e+16,254.842,1829.1,20041,115,121,19245,18885,15876,13683,11928
27302,2100,2124,27302,0,21858,5444,3.07653e+18,1577.52,6322.43,27302,453,408,25178,25178,25154,25156,25171
27694,212,1358,9772,17922,0,27694,3.86561e+13,1031.05,4734.56,27694,404,335,22385,20336,8624,4134,6450
7464,482,1273,0,7464,2624,4840,9.9256e+15,335.513,2376.8,7464,220,220,6191,5796,3414,3475,3531
14760,260,374,0,14760,13982,778,2.72999e+16,227.917,1629,14760,113,107,14287,14097,13110,12378,11963
44327,40,2256,35878,8449,21702,22625,8.0703e+17,1739.24,8122.38,44327,591,461,18518,9594,5678,5868,1146
959,127,345,370,589,0,959,4.28545e+13,51.1606,529.246,959,76,80,614,544,464,488,357
37281,331,2466,37281,0,30523,6758,3.03067e+18,1744.73,7628.51,37281,556,438,26774,22811,11801,10303,6189
4599,934,1644,4599,0,3627,972,3.21333e+18,204.457,2391.14,4599,191,170,2955,2875,2672,2573,1814
11722,708,2301,11722,0,9659,2063,3.31992e+18,916.214,4191.15,11722,360,275,8774,7783,5477,5261,4073
21719,2,42,20624,1095,21255,464,1.01502e+14,37.8707,659.333,21719,38,36,13288,10838,10206,10964,8023
37659,182,2593,37659,0,31189,6470,3.19079e+18,1750.44,7695.93,37659,607,442,25178,18896,11465,9500,4273
2505,228,373,0,2505,0,2505,2.43512e+18,81.4639,659.036,2505,138,60,2132,2109,1976,1996,687
36390,2152,2469,19079,17311,19079,17311,4.88171e+18,1406.64,6944.36,36390,549,399,33921,33921,32126,31900,33225
27557,15,43,26220,1337,26918,639,9.98653e+13,40.6766,760.738,27557,41,39,26867,26362,21733,21108,15584
30095,210,1583,0,30095,10682,19413,9.65568e+15,1055.08,5070.52,30095,439,338,24623,22548,10255,6932,6071
45677,2147,2465,22359,23318,0,45677,5.13659e+18,1143.36,7845.38,45677,650,439,43212,43212,40945,40630,42994
28873,36,2225,15014,13859,15014,13859,4.92781e+18,1349.44,6053.14,28873,500,369,14762,9818,5506,5931,742
7573,96,347,0,7573,7135,438,2.7727e+16,135.884,1143.61,7573,86,78,7145,7007,5585,5093,3818
21542,1099,1729,10169,11373,10169,11373,4.99628e+18,1251.88,4964.73,21542,388,331,18742,16435,12009,10528,13632
24045,1771,1846,0,24045,0,24045,2.48174e+18,1260.73,5324.14,24045,413,361,22199,22195,21982,21254,22138
48697,190,2131,0,48697,0,48697,2.4899e+18,1463.43,7770.95,48697,571,452,35484,28456,11083,5829,5285
38814,219,1740,18469,20345,0,38814,5.13462e+18,1404.74,6614.89,38814,498,426,28356,24113,7651,5713,6219
1678,15,40,0,1678,1666,12,1.58889e+16,8.79321,173.153,1678,20,19,1622,1597,1548,1540,1520
35931,327,1337,0,35931,12714,23217,9.91085e+15,1088.05,5357.32,35931,440,373,30132,27402,13772,9938,11077
18839,1377,1943,9462,9377,0,18839,4.97492e+18,1157.48,4755.46,18839,392,323,16611,14819,11968,11029,13483
37605,1669,2303,19753,17852,0,37605,5.01482e+18,1431.75,6907.4,37605,563,413,35121,30564,25563,23543,30291
25623,190,1702,9097,16526,0,25623,3.7088e+13,1026.81,4793.18,25623,462,315,20618,18796,8668,3460,4629
1681,136,625,0,1681,0,1681,2.66682e+18,102.002,924.48,1681,100,96,1015,681,434,386,328
28832,1902,2169,15485,13347,15485,13347,4.93064e+18,1325.12,5926.54,28832,485,362,26663,26535,23777,23385,25351
19319,794,1685,0,19319,6779,12540,9.87961e+15,1016.08,4350.68,19319,416,302,16692,15407,9933,8065,11120
29176,1704,1743,13883,15293,13883,15293,4.992e+18,1337.25,5744.02,29176,437,389,27433,27433,27289,27162,27370
35656,38,908,34655,1001,35656,0,4.51952e+18,554.83,3831.78,35656,300,222,21944,13490,8612,7716,2186
38743,1683,1796,0,38743,0,38743,2.54107e+18,1438.7,6708.49,38743,509,421,36945,36794,34943,32587,36548
12807,1569,1822,6396,6411,6396,6411,4.94975e+18,919.105,3880.15,12807,323,279,10985,9984,9462,9391,10180
19500,335,347,0,19500,18416,1084,2.73191e+16,255.539,1815.04,19500,117,124,19138,18760,19041,18811,18837
25267,158,2586,25267,0,20654,4613,2.96914e+18,1634.39,6588.68,25267,485,393,15021,9596,5642,4230,2103
22583,35,43,21280,1303,22378,205,1.06256e+14,38.8843,690.226,22583,40,38,22507,22440,21143,21153,20063
24534,709,1338,0,24534,8652,15882,9.86643e+15,1001.04,4435.62,24534,386,326,21624,19793,13185,10412,15203
43860,697,1892,15522,28338,0,43860,3.69793e+13,1152.49,6352.06,43860,601,370,38920,35728,22730,19899,26529
38020,1137,2299,20312,17708,0,38020,5.02091e+18,1422.15,6892.12,38020,579,406,33771,30199,19947,18631,22614
15073,368,687,14672,401,15073,0,4.42099e+18,390.671,2362.03,15073,223,155,14190,13772,9710,9773,9677
7440,317,351,0,7440,7011,429,2.71476e+16,132.664,1134.37,7440,79,83,7089,7046,6974,6902,6620
40600,553,1586,0,40600,14471,26129,9.76842e+15,1130.75,5892.65,40600,493,379,35519,32399,19269,12850,14588
48344,1022,1946,0,48344,17134,31210,9.54795e+15,1165.11,6691.3,48344,638,381,44711,40558,28858,22488,35338
32298,42,43,30439,1859,31975,323,1.06758e+14,40.6072,831.123,32298,43,40,32250,32227,32145,32145,31773
37280,249,1762,0,37280,13216,24064,9.54461e+15,1093.55,5739.49,37280,546,352,31054,28694,13635,8214,7239
37387,38,352,0,37387,35653,1734,2.50787e+16,287.25,2437.59,37387,132,142,34847,33151,25725,22013,14116
9833,2,43,9400,433,9500,333,9.61249e+13,32.7958,445.461,9833,33,32,6152,5057,4816,5164,3834
3459,652,1100,1736,1723,0,3459,5.24833e+18,201.271,1670.18,3459,154,142,2359,2270,1594,1425,1607
23834,86,359,0,23834,22498,1336,2.72643e+16,286.404,2044.24,23834,128,132,22566,22023,16751,14511,10617
31940,55,358,0,31940,30341,1599,2.6152e+16,285.975,2323.56,31940,133,140,30064,29049,22008,18769,12528
1065,248,379,570,495,0,1065,5.18475e+18,107.773,579.054,1065,100,91,686,677,488,455,538
19303,728,874,18845,458,19303,0,4.62624e+18,447.513,2848.58,19303,250,178,18429,18424,18099,18090,17813
17164,1747,2346,14251,2913,8964,8200,7.42162e+17,1210.06,5017.92,17164,404,324,14624,12969,12758,12575,13055
14458,1635,2025,11546,2912,6872,7586,8.52818e+17,1225.53,4517.06,14458,358,319,12130,10575,10658,10160,10454
786,22,322,354,432,354,432,5.06012e+18,79.3499,457.774,786,63,76,290,135,72,112,46
1339,1,29,1253,86,1330,9,1.15407e+14,16.8678,142.475,1339,18,20,436,436,436,436,436
45567,1404,1899,16178,29389,0,45567,3.71417e+13,1161.67,6471.53,45567,607,383,43668,40941,35384,36512,41235
31879,2336,2628,31879,0,26607,5272,3.29697e+18,1631.5,7069.45,31879,609,407,29251,29089,28883,28950,28619
19167,451,1970,9686,9481,9686,9481,4.89047e+18,1182.23,4830.54,19167,412,322,15126,13424,5749,5910,4763
30988,2121,2187,24876,6112,14885,16103,8.37891e+17,1597.27,6768.82,30988,480,414,28801,28800,28685,28698,28642
10968,1028,2263,10968,0,8900,2068,2.79391e+18,781.788,4096.74,10968,269,264,8616,7493,6155,5868,5911
47648,1734,2031,23420,24228,0,47648,5.09631e+18,1489.28,7656.86,47648,577,462,45617,44125,38684,37257,44376
6386,619,1715,2975,3411,2975,3411,4.85159e+18,285.627,2708.12,6386,245,182,4671,4336,2286,2211,2258
36672,1440,1930,18183,18489,0,36672,5.10771e+18,1450.9,6678.35,36672,490,415,33776,29126,23795,21556,28520
30528,987,1568,10814,19714,0,30528,3.75235e+13,1074.62,5109.32,30528,475,337,27978,25429,19477,19635,19910
44480,65,854,43537,943,44480,0,4.56621e+18,534.667,4215.76,44480,309,242,31580,20744,12110,11093,4178
22087,17,39,20840,1247,21837,250,1.07381e+14,34.85,660.511,22087,36,35,21654,21285,17709,17577,14116
32513,807,848,31730,783,32513,0,4.57755e+18,489.161,3604.64,32513,252,224,31665,31665,31618,31627,31437
32551,491,2214,16487,16064,0,32551,5.03328e+18,1353.68,6462.21,32551,490,397,26246,23184,9599,9929,10631
40953,9,43,38824,2129,40222,731,1.02857e+14,40.5838,929.012,40953,43,42,38312,36563,29456,29483,18842
10785,361,1953,5486,5299,5486,5299,4.87179e+18,721.328,3609.27,10785,329,243,8167,7409,3321,3435,2766
30236,1919,2125,30236,0,24249,5987,2.95831e+18,1601.3,6632.61,30236,455,413,28039,23151,27399,27442,27397
36242,1252,1360,0,36242,12819,23423,9.92816e+15,1078.18,5388.55,36242,444,372,34801,30755,32376,30187,33629
35397,467,2082,35397,0,28267,7130,3.03045e+18,1683.95,7142.78,35397,499,447,26191,21973,11477,9438,7332
31343,25,42,29739,1604,30747,596,1.02351e+14,37.9468,787.046,31343,40,38,31127,30954,27619,27569,23921
43771,574,621,43324,447,43771,0,4.75016e+18,502.71,3960.94,43771,253,253,43150,43118,42290,42299,42106
37436,4038,7876,37436,0,33685,3751,2.89713e+18,787.648,12530,37436,1742,154,29560,29048,28213,28033,20077
22699,536,1476,8019,14680,0,22699,3.74862e+13,967.241,4343.88,22699,384,302,19648,18018,11191,9227,9553
2711,583,982,1258,1453,1258,1453,4.76382e+18,115.193,1409.22,2711,187,124,1729,1716,1246,1138,1233
15968,1146,1581,0,15968,5684,10284,9.60252e+15,787.001,3699.26,15968,370,265,14198,13296,11537,10087,12701
848,164,221,848,0,848,0,5.03188e+18,100.474,398.491,848,51,51,627,565,509,526,533
19989,87,1524,0,19989,7120,12869,9.58196e+15,907.879,4040.69,19989,393,282,15122,12964,6564,3310,1917
26628,364,2238,13818,12810,13818,12810,4.86539e+18,1329.55,5825.24,26628,496,356,20924,18783,8035,8542,6114
36015,224,354,0,36015,33972,2043,2.73846e+16,301.052,2491.13,36015,142,156,35095,34234,30896,27845,26766
29823,2,43,28363,1460,29123,700,1.00743e+14,39.7554,788.457,29823,41,39,18292,14941,14122,15132,11144
35774,870,1850,12616,23158,0,35774,3.7192e+13,1126.03,5815.25,35774,594,346,32324,29652,20347,19218,22170
38153,717,893,37040,1113,38153,0,4.58128e+18,602.976,3956.08,38153,279,225,37255,37073,35359,35410,34216
40350,356,374,0,40350,38531,1819,2.49622e+16,286.172,2596.91,40350,140,151,39976,39916,39771,39720,39684
40316,253,357,0,40316,38467,1849,2.51477e+16,296.805,2548.3,40316,139,151,39590,38868,36055,34064,31601
656,127,150,580,76,656,0,3.29565e+18,25.3841,256.873,656,49,29,506,506,500,502,280
4229,352,451,4024,205,4229,0,4.52121e+18,168.601,1085.91,4229,119,94,3778,3758,3729,3736,3116
31950,2003,2292,16902,15048,0,31950,4.99541e+18,1367.49,6360.69,31950,550,387,29658,29540,27539,26987,28804
46168,533,923,44906,1262,46168,0,4.61692e+18,622.153,4375.95,46168,304,241,44855,43503,37909,37564,31923
46685,1692,1901,0,46685,16590,30095,9.53759e+15,1168.29,6557.12,46685,608,375,44784,44784,42434,41302,44400
23153,133,350,0,23153,22073,1080,2.53119e+16,257.171,1924.36,23153,115,126,22350,21968,18773,16523,13669
22765,262,2025,10872,11893,10872,11893,4.99551e+18,1245.96,5371.75,22765,400,346,16795,14039,4651,4687,3401
18436,92,1494,6501,11935,0,18436,3.69325e+13,828.978,3863.97,18436,376,269,14092,12186,6151,2594,3160
39701,1537,2276,0,39701,0,39701,2.44235e+18,1469.73,7140.4,39701,555,419,36804,31862,24783,22318,30067
21268,7,43,20313,955,20642,626,9.83339e+13,38.3671,664.989,21268,39,37,19461,18286,15171,15124,10099
10139,119,2161,8454,1685,5305,4834,7.27782e+17,701.536,3744.55,10139,330,259,6327,4520,3244,3318,1090
26169,1614,2490,21775,4394,13721,12448,7.34371e+17,1501.31,6293.35,26169,521,376,22976,19773,19075,18922,19284
24459,761,2192,24459,0,19713,4746,3.0485e+18,1533.22,6041.16,24459,426,386,19124,16006,10710,10029,9478
22903,588,2502,22903,0,19151,3752,3.29734e+18,1442.08,5927.22,22903,527,351,17653,15341,10340,8650,5609
47630,108,2533,38898,8732,23760,23870,7.83566e+17,1725.71,8601.39,47630,600,470,27862,17626,12370,12337,3106
25718,1342,1537,9084,16634,0,25718,3.80323e+13,1012.7,4706.94,25718,396,325,24181,22277,21464,21517,23402
22417,88,352,0,22417,21405,1012,2.50275e+16,250.856,1888.8,22417,113,118,21491,21097,17325,15320,11448
49729,359,1757,0,49729,0,49729,2.52769e+18,1461.73,7500.3,49729,546,460,38841,34113,11416,8879,13059
33295,1954,2032,0,33295,0,33295,2.54132e+18,1397.33,6451.93,33295,488,410,31263,31256,31018,30398,31239
29789,735,2709,29789,0,24940,4849,3.16084e+18,1584.84,6868.32,29789,564,389,23602,20412,14920,13946,11630
5703,1419,1497,3006,2697,0,5703,4.86532e+18,183.07,2345.59,5703,225,149,4206,4206,4181,4173,4145
530,225,262,0,530,0,530,2.40207e+18,68.0453,351.683,530,62,66,268,268,250,247,252
42400,633,851,41262,1138,42400,0,4.62045e+18,570.168,4124.43,42400,289,237,41515,40420,38064,38236,35890
22496,15,43,21468,1028,21867,629,9.86342e+13,37.2699,678.571,22496,39,36,21980,21596,17890,17449,12796
13751,877,1968,7495,6256,7495,6256,4.99337e+18,850.014,4028.17,13751,363,274,11312,10520,7486,7505,6807
44226,1997,2160,0,44226,0,44226,2.48111e+18,1452.36,7435.31,44226,559,440,42066,42066,41067,40784,41413
16906,440,2227,16906,0,13693,3213,3.09196e+18,1305.31,5045.8,16906,364,340,12315,10653,5970,5273,3592
39262,12,42,37166,2096,38708,554,1.04498e+14,39.4604,894.746,39262,42,40,37745,36680,29704,28949,20362
48170,1335,2420,0,48170,0,48170,2.44501e+18,1495.14,7923.03,48170,642,446,44049,38181,26699,23569,34024
25639,1259,1623,8997,16642,0,25639,3.83132e+13,1000.19,4809.55,25639,407,332,23946,21539,18173,18525,21354
5764,948,1222,2064,3700,0,5764,3.90458e+13,198.099,2082.47,5764,214,160,4542,4522,4179,4121,4048
24113,1326,1659,8555,15558,0,24113,3.72568e+13,982.02,4571.88,24113,453,303,22385,20414,18927,19187,21520
47679,156,2578,0,47679,0,47679,2.44528e+18,1502.89,7997.55,47679,658,437,34325,26439,12332,4679,2450
33574,1643,2640,33574,0,28157,5417,3.29928e+18,1620.63,7195.78,33574,604,414,29847,25530,28045,26170,24259
4733,777,1103,0,4733,1674,3059,9.66114e+15,158.79,1814.21,4733,197,141,3630,3607,2932,2745,2967
40217,288,378,0,40217,38026,2191,2.71339e+16,323.986,2722.14,40217,153,159,39494,38645,35610,33683,32727
6411,123,595,6270,141,6411,0,4.62052e+18,234.169,1510,6411,136,116,5290,4122,2446,2226,1437
858,20,27,794,64,858,0,1.08588e+14,15.0862,110.531,858,18,16,829,821,790,791,776
14496,315,1971,7288,7208,0,14496,5.01734e+18,998.977,4226.38,14496,363,294,10995,9695,3716,3266,2326
12172,605,702,11767,405,12172,0,4.53628e+18,329.777,2112.98,12172,213,148,11470,11343,11233,11233,10856
3767,19,274,0,3767,3542,225,2.75644e+16,65.9198,745.25,3767,61,63,3171,2832,2124,2032,1160
14138,1079,1315,0,14138,5007,9131,9.9829e+15,794.868,3348.06,14138,297,270,12630,11610,10168,9035,10697
16937,539,816,16377,560,16937,0,4.48672e+18,403.879,2604.8,16937,240,164,16106,15766,14513,14508,13079
32184,973,2248,0,32184,0,32184,2.44478e+18,1351.81,6343.27,32184,529,382,27770,24903,15493,14229,16547
22678,2053,2098,11722,10956,11722,10956,4.91335e+18,1252.79,5308.42,22678,448,339,20580,20580,20485,20425,20579
44096,1461,2069,21856,22240,21856,22240,4.98317e+18,1483.96,7400.87,44096,564,442,40947,35245,27822,25791,34930
29201,1001,2210,14928,14273,14928,14273,4.89916e+18,1368.92,6098.28,29201,510,377,25086,22469,13720,13840,14722
5808,23,1544,2920,2888,2920,2888,4.73084e+18,189.487,2433.74,5808,241,160,2553,1560,886,1141,280
28800,19,43,27396,1404,28140,660,1.00676e+14,40.1702,776.196,28800,41,39,28356,28022,23816,23562,17906
22686,503,1917,11617,11069,11617,11069,4.99272e+18,1251.94,5197.92,22686,398,338,18230,16192,7562,7645,6321
10884,948,1522,3824,7060,0,10884,3.67559e+13,573.887,3052.18,10884,313,212,9362,8805,7040,7191,6746
843,21,319,335,508,0,843,4.30766e+13,51.7094,483.149,843,72,79,347,204,167,104,57
49507,1700,1761,17609,31898,0,49507,3.89717e+13,1193.48,6753.28,49507,496,423,47746,47746,47607,47688,47671
3012,75,852,1540,1472,0,3012,4.62677e+18,82.0299,1344.28,3012,146,114,1999,1576,919,783,625
19590,23,43,18625,965,19158,432,1.01182e+14,37.708,635.033,19590,39,36,19399,19252,16961,16910,14213
21215,654,824,0,21215,20052,1163,2.30116e+16,151.096,2748.5,21215,136,129,20391,20389,19892,19668,18788
8263,480,633,8135,128,8263,0,4.61052e+18,307.494,1757.49,8263,165,127,7630,7525,7263,7287,6634
16018,273,708,15758,260,16018,0,4.71262e+18,418.139,2481.67,16018,221,176,14879,14090,9937,9536,7164
40173,2424,2688,40173,0,33552,6621,3.26075e+18,1707.37,7937.15,40173,652,457,37485,37456,37080,37131,36782
30265,696,752,29679,586,30265,0,4.56336e+18,494.704,3404.63,30265,260,220,29513,29477,29054,29018,28952
10906,603,1389,0,10906,3908,6998,9.8994e+15,523.984,2904.48,10906,251,240,9348,8774,6186,5041,5305
1217,308,511,0,1217,0,1217,2.71333e+18,73.373,725.242,1217,85,89,706,705,684,686,585
10131,1419,1715,0,10131,0,10131,2.55773e+18,669.358,3332.78,10131,264,271,8416,7861,7340,7122,7761
32028,1071,2641,32028,0,26625,5403,3.30991e+18,1619.84,7081.4,32028,558,402,26653,23050,20101,18985,16041
27929,263,2665,27929,0,23410,4519,3.13305e+18,1486.77,6601.87,27929,466,384,19856,17020,10521,8716,3642
44065,1278,1925,0,44065,0,44065,2.51044e+18,1465.03,7225.61,44065,538,442,40237,34774,26080,23001,32248
2870,317,1185,2305,565,1333,1537,8.64477e+17,129.599,1638.35,2870,153,124,1685,1454,1026,945,675
17973,1577,1737,8494,9479,8494,9479,4.98807e+18,1187.72,4551.57,17973,366,319,16153,14101,13887,13950,15383
41086,199,882,40242,844,41086,0,4.56185e+18,549.422,4097.61,41086,310,239,37457,33631,17323,16698,12685
11147,244,2290,11147,0,9176,1971,3.34967e+18,881.998,4090.8,11147,365,270,7551,6305,3411,2931,1654
30857,1193,2602,25838,5019,16430,14427,7.12867e+17,1547.92,6842.83,30857,549,378,26087,22943,20477,20030,17756
7552,888,1328,2710,4842,0,7552,3.8952e+13,335.674,2447.69,7552,213,224,6224,6025,4917,4748,4983
32738,1608,1942,0,32738,11596,21142,9.72448e+15,1188.93,5767.3,32738,503,348,30796,30621,26431,23859,29675
23808,1033,2215,0,23808,0,23808,2.43806e+18,1192.9,5473.23,23808,431,344,20399,18404,11909,11100,12965
10022,19,42,9451,571,9955,67,1.05462e+14,35.0904,457.692,10022,35,32,9841,9711,8211,8084,6542
32864,694,1734,0,32864,11628,21236,9.57356e+15,1088.03,5437.16,32864,487,345,29082,26653,16820,11707,14745
37903,40,42,35751,2152,37520,383,1.06581e+14,39.5214,881.068,37903,41,40,37851,37823,37732,37731,36531
27080,309,1696,0,27080,9657,17423,9.65564e+15,1037.56,4909.06,27080,443,324,22656,20846,10096,6306,5716
45798,506,2318,23590,22208,0,45798,5.05441e+18,1461.37,7634.49,45798,592,438,37475,32971,14118,14736,13094
31034,707,876,30190,844,31034,0,4.54977e+18,522.523,3567.47,31034,267,214,30158,30096,29037,29071,28582
48507,1625,2107,38886,9621,23221,25286,8.33389e+17,1723.29,8324.59,48507,566,472,44616,36677,37790,36024,39447
18430,2237,2407,18430,0,15424,3006,3.31037e+18,1256.35,5237.64,18430,429,322,16023,16023,15907,15923,15930
27880,1679,1703,9860,18020,0,27880,3.71753e+13,1042.16,4978.61,27880,484,322,26177,26177,26140,26164,26174
39700,1057,2151,31786,7914,18795,20905,8.43558e+17,1698.29,7615.5,39700,520,449,33072,27881,23622,22678,21625
36379,671,2619,30446,5933,19317,17062,7.17513e+17,1661.84,7457.08,36379,570,408,28899,25031,17632,17617,11464
39412,702,2389,20691,18721,20691,18721,4.92546e+18,1445.74,7139.46,39412,579,412,33125,29079,15249,17173,15379
36459,46,685,0,36459,34597,1862,2.56162e+16,249.222,3039.08,36459,136,153,34036,32534,23890,21209,13630
12842,283,365,0,12842,12217,625,2.55249e+16,221.947,1492.71,12842,95,96,12447,12260,11651,11346,10855
36281,412,917,35152,1129,36281,0,4.54299e+18,560.136,3858.09,36281,283,224,34728,33559,26195,26040,20545
8374,252,1705,4035,4339,0,8374,4.96449e+18,493.5,3030.73,8374,291,222,6186,5470,2273,1904,1765
29234,1464,2382,23995,5239,14787,14447,7.70856e+17,1574.96,6640.95,29234,493,386,25393,21790,20771,20701,18984
27434,582,1788,0,27434,9662,17772,9.79958e+15,1081.18,5230.89,27434,458,331,23427,21359,12209,9895,12259
38786,615,2135,31087,7699,18400,20386,8.42618e+17,1714.24,7534.39,38786,539,442,29863,24942,16829,16621,13060
28739,951,2244,0,28739,0,28739,2.42738e+18,1347.36,6061.14,28739,525,371,24530,21907,12838,12079,14942
15804,370,373,0,15804,15045,759,2.60528e+16,202.043,1649.99,15804,108,105,15431,15378,15413,15423,15369
14774,239,1866,7469,7305,7469,7305,4.9505e+18,977.247,4170.74,14774,349,284,10956,9548,3796,3944,2467
13414,770,1986,7001,6413,0,13414,4.91324e+18,852.701,3997.4,13414,345,261,10834,9928,5881,5146,6008
18498,1324,2131,9506,8992,0,18498,4.96808e+18,1105.83,4824.06,18498,429,310,16045,14344,10897,10135,12224
14344,1803,2007,0,14344,0,14344,2.38934e+18,854.678,4102.04,14344,353,274,12337,11507,11508,11345,11586
20772,1196,1443,7310,13462,0,20772,3.83065e+13,908.463,4150.09,20772,352,309,19209,17357,15763,16128,17655
6842,561,562,6617,225,6842,0,4.50975e+18,216.179,1496.24,6842,146,113,6280,6280,6280,6280,6280
40364,31,43,38551,1813,39148,1216,9.74189e+13,38.5648,907.703,40364,42,40,40201,40095,37011,36914,33603
673,110,126,0,673,0,673,2.34505e+18,20.2214,223.33,673,53,32,547,547,547,546,546
49245,322,357,0,49245,47018,2227,2.50275e+16,295.583,2810.99,49245,148,162,48771,47749,47254,45719,46025
32667,1325,1764,11601,21066,0,32667,3.74074e+13,1076.24,5408.01,32667,520,335,30807,27748,24420,25349,29661
4517,231,1189,2320,2197,2320,2197,4.90725e+18,185.205,1922.73,4517,233,194,3284,2987,1653,1799,787
36741,34,44,34660,2081,36353,388,1.06688e+14,40.7596,878.541,36741,43,41,36623,36509,33969,34031,32431
37266,1075,2464,30688,6578,19025,18241,7.65424e+17,1663.8,7532.43,37266,543,430,31297,26793,23146,22205,18458
33868,1400,1584,0,33868,12033,21835,9.7777e+15,1087.52,5420.75,33868,449,358,32284,31793,28601,27271,31671
36686,138,345,0,36686,34612,2074,2.73119e+16,297.889,2493.56,36686,146,154,35334,34551,28568,25145,20542
28427,1622,1851,14021,14406,0,28427,5.14198e+18,1358.91,5809.35,28427,458,376,26506,22888,21779,21296,24740
34282,946,1745,0,34282,12155,22127,9.48385e+15,1080.04,5464.48,34282,526,342,31238,28735,21269,15253,23535
30074,1940,2250,15892,14182,15892,14182,4.92889e+18,1342.07,6162.51,30074,509,369,27824,27697,25224,24815,25926
43146,19,43,40841,2305,42493,653,1.04022e+14,41.2366,954.076,43146,43,40,42436,41865,35236,34991,27657
45201,26,355,0,45201,43086,2115,2.53265e+16,301.666,2698.3,45201,146,156,40951,38559,29658,25801,15689
47574,351,2380,0,47574,0,47574,2.42783e+18,1596.41,7789.09,47574,692,427,37770,33872,15395,9250,9433
46905,616,2564,24904,22001,24904,22001,4.917e+18,1492.06,7882.3,46905,641,432,39071,34481,15349,18562,12428
28398,235,727,27890,508,28398,0,4.61794e+18,489.117,3289.92,28398,256,215,26341,24533,13367,13117,10630
5629,21,43,5375,254,5484,145,9.68589e+13,23.5164,346.827,5629,29,30,5543,5491,4899,4868,4383
21984,1177,2099,0,21984,0,21984,2.43173e+18,1271.35,5243.29,21984,458,333,18965,17072,11513,10041,12283
3424,408,1111,0,3424,0,3424,2.352e+18,132.596,1671.04,3424,204,135,2313,2241,1463,1375,1423
25700,498,1643,9178,16522,0,25700,3.74654e+13,967.48,4681.73,25700,451,300,22254,20488,12976,11421,11980
13537,25,43,12808,729,13328,209,1.04194e+14,34.3336,534.459,13537,37,35,13415,13333,11782,11799,10305
40328,2038,2853,40328,0,33802,6526,3.33636e+18,1723.64,8067.38,40328,640,443,37409,31512,35803,35079,32964
33711,306,866,33362,349,33711,0,4.75427e+18,593.115,3872.16,33711,294,236,31452,29299,18633,17817,13865
49461,10,43,46816,2645,48704,757,1.04632e+14,40.312,1011.82,49461,43,43,46826,44943,36670,35658,23545
12608,592,1876,0,12608,0,12608,2.43002e+18,779.993,3749.61,12608,348,266,10143,9212,5428,5123,4003
20009,21,41,19066,943,19412,597,9.66294e+13,36.6592,627.698,20009,38,35,19797,19627,17038,16973,14117
38448,654,2600,38448,0,31420,7028,2.90914e+18,1905.4,8127.3,38448,559,451,29483,23663,14990,12331,11799
19442,2332,2560,15957,3485,9592,9850,7.7548e+17,1348.42,5658.91,19442,444,339,16882,16811,16519,16422,16556
35929,1988,2469,29542,6387,18233,17696,7.70936e+17,1666.04,7425.33,35929,604,425,33368,27881,30198,29500,31638
15234,8,43,14511,723,14820,414,9.83336e+13,34.5794,560.563,15234,36,35,14180,13505,11089,10978,6997
15224,1042,1577,5362,9862,0,15224,3.69762e+13,737.185,3601.58,15224,367,262,13384,12607,10511,9910,11263
2139,146,176,0,2139,2004,135,2.69501e+16,47.5802,464.039,2139,45,50,1963,1963,1900,1862,1804
29018,99,353,0,29018,27687,1331,2.51475e+16,272.641,2152.12,29018,123,130,27902,27397,22492,19500,15606
37124,437,2779,37124,0,30814,6310,3.29309e+18,1683.87,7731.42,37124,616,434,27974,24438,14539,11558,8000
44471,1833,2875,44471,0,37073,7398,3.30572e+18,1768.55,8511.61,44471,694,459,40870,34283,38651,36857,34450
2320,583,906,0,2320,0,2320,2.45713e+18,107.51,1281.19,2320,177,120,1414,1407,950,872,987
1533,45,556,836,697,0,1533,5.43419e+18,109.941,827.768,1533,106,104,604,336,194,169,160
6836,1634,1970,5819,1017,3710,3126,6.84149e+17,201.238,2959.91,6836,260,176,4866,4861,4675,4673,4489
36052,2625,2723,36052,0,30019,6033,3.2958e+18,1715.2,7601.14,36052,633,436,33329,33328,33328,33315,33077
5243,438,1531,2446,2797,2446,2797,4.68147e+18,205.712,2357.91,5243,247,162,3712,3465,1449,1550,1258
27017,1677,2560,22376,4641,13972,13045,7.49763e+17,1562.31,6477.32,27017,550,386,23800,20454,19482,19334,19274
38404,610,2696,38404,0,32036,6368,3.27638e+18,1733.86,7779.86,38404,631,428,30103,25980,17682,15774,10414
39261,267,353,0,39261,37485,1776,2.51205e+16,291.598,2504.38,39261,137,146,38607,37891,35432,33552,31957
16597,129,1932,8800,7797,8800,7797,4.9918e+18,1025.01,4389.52,16597,357,299,11601,8849,4490,4395,1379
1593,462,477,1017,576,0,1593,5.61364e+18,60.2323,710.03,1593,110,82,1116,1116,1114,1115,1114
29288,835,2250,29288,0,23659,5629,2.97432e+18,1654.84,6668.67,29288,464,404,23318,19334,13706,13225,11501
22493,1057,2527,22493,0,18641,3852,3.29491e+18,1438.75,5943.3,22493,508,363,18223,15953,13917,13175,11277
27407,422,936,26772,635,27407,0,4.56811e+18,494.634,3416.57,27407,248,206,26101,25220,18140,18296,14885
5618,217,518,5588,30,5618,0,4.85659e+18,215.305,1364.2,5618,121,117,5039,4747,3360,3332,2873
26072,1002,2596,21125,4947,12397,13675,8.08012e+17,1508.56,6595.39,26072,492,391,20925,17948,13041,12702,10766
27453,26,42,26022,1431,26975,478,1.02725e+14,38.941,745.138,27453,40,38,27269,27155,24071,24191,20387
29139,842,2378,29139,0,23801,5338,3.11212e+18,1595.79,6701.44,29139,480,395,23366,19505,13591,12759,10951
9495,84,346,0,9495,9034,461,2.53322e+16,141.075,1222.59,9495,86,82,9036,8882,7327,6626,5066
1656,358,531,0,1656,0,1656,2.06679e+18,108.508,819.342,1656,104,100,1125,1105,858,886,839
18268,1325,2067,9942,8326,9942,8326,4.97123e+18,1013.1,4665.73,18268,363,295,15885,14388,11543,10832,11125
7131,958,1380,2498,4633,0,7131,3.65987e+13,137.18,2336.98,7131,238,167,5751,5749,4819,4900,4808
42799,952,2534,0,42799,0,42799,2.49123e+18,1512.11,7701.56,42799,664,426,37049,33078,17646,17135,20035
37741,877,2402,19609,18132,19609,18132,4.90242e+18,1415.03,7020.66,37741,572,410,32264,28887,15524,17478,16635
14162,38,1851,7388,6774,7388,6774,4.93611e+18,872.751,3993.16,14162,352,290,7534,5046,2863,3014,504
46881,212,894,45615,1266,46881,0,4.56092e+18,610.646,4383.23,46881,321,246,42964,39278,22401,20907,14478
10758,1255,1532,3802,6956,0,10758,3.65715e+13,542.695,3024.42,10758,317,206,9226,8834,8211,8168,8743
42237,10,47,39978,2259,42066,171,9.70374e+13,40.9104,1051.91,42237,43,43,39523,37659,30672,29805,21088
43078,23,43,41009,2069,42012,1066,9.99652e+13,40.5049,941.913,43078,43,41,42684,42329,37218,37104,30554
23275,275,2134,12228,11047,12228,11047,4.92198e+18,1196.54,5361.17,23275,466,338,17896,15716,6550,7013,3397
14215,289,1990,7433,6782,7433,6782,4.88473e+18,893.879,4108.95,14215,371,284,10861,9702,4676,4960,2660
31972,38,43,30435,1537,31128,844,9.91575e+13,39.1319,805.703,31972,41,39,31910,31870,31487,31483,29575
27439,347,353,0,27439,26120,1319,2.55389e+16,277.126,2119.87,27439,126,132,27085,26896,27017,26961,26837
29636,963,2181,15755,13881,15755,13881,4.96523e+18,1305.84,6031.67,29636,507,364,25602,22995,14681,15508,15318
42092,2098,2112,42092,0,33622,8470,3.02481e+18,1726.71,7800.96,42092,507,463,39980,39980,39980,39979,39973
19420,7,42,18346,1074,19290,130,1.04923e+14,36.7821,628.838,19420,37,36,17561,16405,13388,13384,8640
34867,1958,2192,18148,16719,0,34867,5.0302e+18,1380.06,6571.28,34867,540,388,32675,32675,30469,29769,31514
30818,1133,1726,10881,19937,0,30818,3.87757e+13,1111.15,5425.98,30818,449,359,28418,25483,19220,17471,23338
40822,1046,1744,0,40822,0,40822,2.53351e+18,1442.98,6812.73,40822,507,431,36156,31429,21811,17164,25639
29910,442,1613,0,29910,10606,19304,9.62386e+15,1052.11,5088.14,29910,430,339,25650,23547,13852,8953,10651
30902,26,43,29521,1381,30014,888,9.74809e+13,39.0776,790.17,30902,39,37,30721,30599,27588,27714,23399
41305,1361,1907,0,41305,14673,26632,9.53575e+15,1147.22,6203.46,41305,572,363,39334,35263,29623,23891,36972
33074,506,2462,0,33074,0,33074,2.49432e+18,1473.92,6849.19,33074,585,390,26576,23039,9319,8671,8284
43585,188,354,0,43585,41594,1991,2.51066e+16,293.932,2639.4,43585,142,153,42529,41713,37604,34092,30898
44504,1571,2095,35643,8861,21226,23278,8.37919e+17,1722.07,7979.72,44504,551,464,40295,33370,33530,32200,32973
48688,730,1896,17331,31357,0,48688,3.7215e+13,1227.26,6667.36,48688,646,380,43349,39845,25603,23677,27690
17709,90,1996,0,17709,0,17709,2.45834e+18,1029.39,4545.72,17709,358,300,11675,8847,4848,1753,997
29370,1650,2202,15073,14297,0,29370,4.98532e+18,1368.87,6100.21,29370,517,376,27063,23675,20228,19080,23530
38558,17,357,0,38558,36811,1747,2.51001e+16,289.376,2483.59,38558,135,149,33541,30703,24377,21631,13136
45505,376,594,45004,501,45505,0,4.73884e+18,506.996,4010.93,45505,255,253,43872,42349,33814,33359,30027
31773,1521,1965,16004,15769,16004,15769,4.94616e+18,1342.65,6149.45,31773,485,382,29436,25535,21794,20662,25675
4129,179,1473,4129,0,3235,894,3.13993e+18,189.977,2148.11,4129,185,159,2470,2038,1018,1115,532
20210,2025,2239,0,20210,0,20210,2.40878e+18,1203.78,5076.92,20210,497,312,17971,17868,16608,15986,16716
36541,704,735,36174,367,36541,0,4.70475e+18,566.65,3824.91,36541,274,242,35806,35654,35409,35407,35626
40903,693,2294,33059,7844,19982,20921,8.1143e+17,1688.67,7818.82,40903,554,449,32325,27103,19301,19035,13427
36837,230,905,35791,1046,36837,0,4.52276e+18,564.986,3900.38,36837,250,221,33951,31455,16970,15829,12089
31076,731,1957,14752,16324,0,31076,5.1278e+18,1386.28,6171.37,31076,473,395,25831,22456,11603,9605,11681
33224,151,1634,11729,21495,0,33224,3.75966e+13,1074.15,5393.22,33224,458,349,26299,23398,10277,5345,5841
6459,1168,1626,3035,3424,0,6459,5.16446e+18,279.449,2650.09,6459,243,210,4833,4784,3973,3931,3826
47659,178,360,0,47659,45134,2525,2.66178e+16,314.312,2873.54,47659,154,165,46263,45152,39453,34189,29679
33904,1926,2361,27837,6067,17023,16881,7.78006e+17,1706.28,7194.76,33904,521,414,31240,25980,27522,26398,28776
41338,1207,2487,0,41338,0,41338,2.47107e+18,1370.17,7419.44,41338,529,425,37131,33233,20735,18697,24742
27616,1891,2528,22826,4790,14132,13484,7.5758e+17,1559.71,6546.66,27616,509,386,24915,21115,21249,20853,22004
3764,443,1085,1918,1846,0,3764,5.42861e+18,206.623,1719.32,3764,142,152,2679,2523,1524,1257,1312
46364,1661,1922,16496,29868,0,46364,3.72381e+13,1162.57,6525.32,46364,609,379,44442,44442,41108,41430,43649
35398,250,358,0,35398,33406,1992,2.72675e+16,311.368,2502.06,35398,144,153,34581,33764,30723,28365,26790
4578,815,973,0,4578,1568,3010,9.44535e+15,115.301,1651.12,4578,179,151,3605,3601,3270,3247,3319
25333,27,42,23978,1355,24941,392,1.03644e+14,37.6788,715.373,25333,40,38,25174,25086,22181,22236,18919
8406,16,44,8000,406,8200,206,9.83793e+13,29.0177,411.637,8406,33,30,8219,8079,6878,6807,5740
25695,1573,2602,21379,4316,13374,12321,7.3391e+17,1466.34,6312.28,25695,525,361,22349,19319,18282,18367,16058
24715,356,2090,0,24715,0,24715,2.44739e+18,1242.01,5549.58,24715,442,360,19263,17196,6706,5216,5943
6160,204,605,6003,157,6160,0,4.57035e+18,188.936,1479.3,6160,143,118,5471,5058,3193,3184,2653
17823,18,44,16830,993,17631,192,1.06854e+14,39.8837,616.645,17823,40,37,17460,17203,14206,14066,11227
6829,654,1657,3508,3321,3508,3321,4.87023e+18,228.122,2703.45,6829,219,180,5172,4946,2840,2850,2659
39392,40,357,0,39392,37544,1848,2.53351e+16,295.265,2524.97,39392,137,148,36773,35080,27065,23308,14862
19052,55,358,0,19052,17962,1090,2.73299e+16,259.37,1824.6,19052,116,119,17785,17126,12496,10853,7049
35804,318,2336,19216,16588,0,35804,5.04599e+18,1362.24,6720.05,35804,538,398,28200,25092,11059,9939,6923
48452,693,1951,0,48452,17217,31235,9.52233e+15,1137.19,6673.1,48452,620,381,43197,39664,25431,16952,28702
41818,2168,2486,21795,20023,0,41818,5.00365e+18,1464.24,7442.38,41818,609,421,39332,39332,36210,35430,38365
2970,571,1032,0,2970,0,2970,2.19281e+18,122.278,1497.51,2970,207,121,1938,1897,1662,1639,1682
42515,1796,2294,0,42515,0,42515,2.43154e+18,1542.04,7362.12,42515,606,419,40178,37080,30999,28607,36209
9680,396,2156,7961,1719,4877,4803,7.6261e+17,677.556,3691.73,9680,307,251,7010,6230,3647,3883,1873
1437,106,318,1050,387,1050,387,5.21397e+18,24.7035,511.549,1437,87,49,1119,1108,953,933,928
28350,990,1739,0,28350,10030,18320,9.47483e+15,1054.23,5050.83,28350,481,328,25767,23594,17238,13056,17145
505,7,218,0,505,179,326,1.02043e+16,34.6356,310.251,505,64,52,137,36,48,47,16
41601,2062,2423,21932,19669,0,41601,5.0208e+18,1471,7339.06,41601,615,425,39178,39178,35054,34423,37585
5871,1233,1575,2728,3143,0,5871,4.88464e+18,257.035,2489.71,5871,241,175,4296,4273,3589,3505,3642
7426,295,349,0,7426,7061,365,2.59373e+16,78.9422,1106.02,7426,79,83,7077,7065,6882,6913,6438
8292,1358,1659,4019,4273,4019,4273,5.05967e+18,519.326,2983.34,8292,245,253,6633,6337,5572,5283,5884
46473,802,2428,23062,23411,0,46473,5.08589e+18,1497.04,7973.82,46473,612,449,39419,34819,17369,16002,19467
43614,3018,3042,43614,0,35885,7729,3.07664e+18,1713.47,8762.93,43614,638,452,40572,40572,40572,40572,40572
7792,324,595,7727,65,7792,0,4.70022e+18,298.076,1684.14,7792,153,133,7151,6924,5763,5724,5037
41718,19,43,39688,2030,40741,977,1.00107e+14,40.8003,917.131,41718,42,41,41119,40662,34478,34115,25761
27504,1146,2109,27504,0,22035,5469,2.98094e+18,1593.19,6338.41,27504,459,413,22993,19325,17627,16306,15899
49903,305,350,0,49903,47234,2669,2.668e+16,306.08,2903.99,49903,154,168,49312,48086,46608,44083,45123
11216,1422,2239,9021,2195,5304,5912,8.30936e+17,892.014,4129.59,11216,306,278,8977,8087,7181,7194,7311
15515,819,1879,7888,7627,7888,7627,5.01286e+18,1020.67,4287.79,15515,336,300,12829,11566,7068,6849,7010
23604,1750,1947,0,23604,0,23604,2.49151e+18,1226.57,5286.13,23604,408,338,21657,21212,19383,18600,20398
14068,573,1524,5013,9055,0,14068,3.70928e+13,734.97,3415.13,14068,336,256,11949,11165,7492,7105,7346
13292,979,1524,4664,8628,0,13292,3.6874e+13,732.35,3381.24,13292,327,247,11567,10846,8278,8749,8757
24376,626,1431,0,24376,8692,15684,9.88372e+15,975.654,4467.9,24376,373,316,21391,19692,12788,9739,12166
45933,1515,1705,0,45933,16330,29603,9.60574e+15,1149.6,6313.09,45933,560,380,44228,44225,41462,39739,43386
40224,371,892,39133,1091,40224,0,4.56345e+18,588.202,4068.45,40224,273,228,38328,36804,26657,24965,20946
23365,1746,2278,23365,0,19201,4164,3.18487e+18,1510.44,5903.36,23365,446,372,20624,17631,19624,18858,17086
49214,953,1812,23478,25736,23478,25736,5.02931e+18,1465.7,7555.62,49214,548,460,42973,37497,23523,22443,27727
30020,1868,2574,30020,0,24208,5812,3.12456e+18,1604.75,7074.7,30020,522,398,27102,22594,26361,26051,25370
42252,1207,1820,0,42252,14941,27311,9.45086e+15,1153.82,6157.41,42252,614,365,39803,35816,28732,21301,33827
19763,1130,1816,9770,9993,0,19763,5.07707e+18,1143.82,4791.29,19763,382,321,17051,15288,10773,9526,12907
20956,78,350,0,20956,19943,1013,2.57683e+16,257.656,1844.57,20956,110,120,19967,19549,15539,13385,9540
35657,42,1544,0,35657,12616,23041,9.73089e+15,1087.47,5514.8,35657,454,364,22910,17592,9195,5553,1950
44717,144,1963,15882,28835,0,44717,3.69321e+13,1141.44,6430.76,44717,619,366,35715,32003,15348,12687,5002
34601,1082,2302,0,34601,0,34601,2.43314e+18,1434.3,6664.85,34601,561,400,30364,26975,16552,15636,19014
47522,3341,8038,3955,43567,1229,46293,1.79679e+18,776.978,13920.8,47522,985,630,39484,39060,26442,21592,21442
33979,1708,2551,0,33979,0,33979,2.42691e+18,1396.02,6851.62,33979,559,408,31378,27335,21627,19840,26356
8471,268,2147,8471,0,7097,1374,3.31593e+18,511.53,3475.46,8471,301,218,5767,5002,2992,2750,1019
33970,19,1714,0,33970,12101,21869,9.58986e+15,1085.74,5448.13,33970,495,353,18879,14110,8701,4128,1326
46305,1031,2703,38541,7764,24058,22247,7.4193e+17,1847.99,8582.24,46305,665,459,38539,33244,28213,27156,23701
14982,9,44,14140,842,14809,173,1.07127e+14,34.7837,557.679,14982,37,35,13991,13338,10685,10623,6991
49215,645,647,48745,470,49215,0,4.76736e+18,489.285,4185.47,49215,266,256,48568,48568,48567,48567,48559
12680,1201,1699,6038,6642,6038,6642,5.01857e+18,940.139,3782.41,12680,308,287,10599,9609,7602,7211,8617
42013,1703,2482,22092,19921,22092,19921,4.90491e+18,1482.01,7436.32,42013,613,425,39409,34146,27624,26207,33524
32237,809,2660,32237,0,27118,5119,3.23085e+18,1707.75,7123.99,32237,522,391,25862,22340,16945,16152,8692
28184,3,43,26898,1286,27376,808,9.80731e+13,37.2409,755.975,28184,40,38,20732,17874,16652,16552,11269
10788,961,1881,0,10788,0,10788,2.47919e+18,547.348,3415.9,10788,283,249,8907,8314,6415,5784,5654
2288,554,589,822,1466,0,2288,4.05399e+13,92.8772,971.789,2288,101,110,1699,1699,1698,1697,1665
10750,1409,1429,0,10750,3797,6953,9.61024e+15,584.924,2968.53,10750,284,240,9321,9321,9286,9309,9319
9146,825,1347,3219,5927,0,9146,3.73658e+13,500.521,2697.31,9146,259,205,7799,7295,5634,5838,6300
47981,408,938,46613,1368,47981,0,4.58938e+18,606.271,4465.54,47981,325,245,45998,44332,33418,33583,27450
14177,703,1687,0,14177,0,14177,2.49588e+18,1010.68,3979.3,14177,313,288,11569,10106,5924,5052,6778
11069,542,1837,5658,5411,5658,5411,4.79893e+18,733.174,3535.15,11069,340,237,8700,7970,4219,4206,3464
7973,907,1713,0,7973,0,7973,2.54417e+18,456.404,2987.98,7973,236,252,6260,5869,3913,3636,3952
41533,249,358,0,41533,39456,2077,2.60174e+16,301.828,2644.15,41533,146,157,40699,39873,36727,33840,33525
41755,222,356,0,41755,39757,1998,2.53095e+16,295.28,2609.75,41755,143,153,40854,40011,36655,33607,31470
14279,336,2307,11740,2539,7169,7110,7.66693e+17,1145.48,4651.63,14279,359,292,10154,8734,4860,5354,2099
25058,1854,2197,25058,0,20387,4671,3.09237e+18,1587.09,6118.19,25058,472,384,22582,18938,21785,21886,20086
34039,131,2795,28360,5679,17689,16350,7.29412e+17,1642.27,7401.07,34039,612,401,21893,15099,10709,11205,2064
24835,872,1353,8752,16083,0,24835,3.86069e+13,995.586,4473.62,24835,384,322,22381,20299,14984,14662,17496
23899,141,2175,0,23899,0,23899,2.42723e+18,1196.29,5451.57,23899,490,340,17017,12923,6257,2438,2195
36260,71,2313,0,36260,0,36260,2.4661e+18,1377.42,6767.76,36260,549,399,22417,16238,9013,3288,1788
29206,56,1959,14679,14527,14679,14527,4.93221e+18,1367.23,5935.57,29206,476,380,16383,10617,5678,5785,1022
17657,438,1615,6308,11349,0,17657,3.74545e+13,788.984,3860.3,17657,363,271,15060,13949,8434,7778,8065
41706,94,2028,14747,26959,0,41706,3.68978e+13,1111.34,6348.71,41706,638,373,31870,27340,12889,3857,3596
37739,510,2918,37739,0,31504,6235,3.21897e+18,1644.25,7897.22,37739,551,442,29061,25176,15788,13054,9226
37289,1202,2711,37289,0,31127,6162,3.31483e+18,1653.1,7642.29,37289,578,428,31737,27513,26115,24966,20535
13496,22,43,12817,679,13209,287,1.00944e+14,35.3276,531.676,13496,36,35,13337,13198,11414,11382,9677
22072,623,1672,0,22072,7791,14281,9.44004e+15,947.135,4408.24,22072,460,292,19048,17759,11263,8359,12286
37338,368,1546,13246,24092,0,37338,3.87666e+13,1095.6,5704.9,37338,508,380,31377,28422,14549,11502,12564
686,7,16,682,4,610,76,6.81125e+13,7.19242,81.2057,686,13,11,655,633,566,560,484
27551,1947,2292,13044,14507,0,27551,5.0359e+18,1494.83,6238.74,27551,510,376,25199,21801,20355,19356,24426
46775,246,1893,16598,30177,0,46775,3.72657e+13,1170.56,6549.9,46775,615,384,38843,35785,16570,14288,9202
34882,1936,2640,34882,0,29259,5623,3.30344e+18,1650.24,7350.06,34882,608,423,32017,27121,30513,29864,28162
19910,669,2174,10188,9722,0,19910,4.93525e+18,1155.16,5030.04,19910,456,323,16209,14436,7766,7194,7467
47990,364,2204,38363,9627,22639,25351,8.471e+17,1757.11,8419.73,47990,578,477,34424,29330,15899,17043,8580
34978,391,807,34343,635,34978,0,4.61575e+18,507.453,3720.79,34978,254,223,33489,32380,24388,25029,20649
803,8,81,0,803,771,32,2.75489e+16,23.2877,204.932,803,31,29,604,510,431,359,191
17816,1299,1584,0,17816,6325,11491,9.44781e+15,883.639,3929.39,17816,396,270,16136,14895,13880,11786,15219
7895,77,353,0,7895,7463,432,2.68243e+16,141.165,1169.69,7895,84,82,7403,7221,5627,4681,3449
9543,795,1833,4933,4610,4933,4610,4.98203e+18,583.465,3304.53,9543,280,264,7710,7053,4451,4590,4934
48615,1582,1972,17244,31371,0,48615,3.7355e+13,1167.85,6756.86,48615,589,381,46643,46643,40047,40937,45574
35650,9,43,34015,1635,34597,1053,9.77388e+13,39.4398,856.608,35650,42,39,33616,32262,26288,26334,18569
12241,77,736,11997,244,12241,0,4.60309e+18,391.769,2238.24,12241,175,151,8924,5995,3637,3359,1446
37148,356,1977,13196,23952,0,37148,3.74725e+13,1129.17,5994.88,37148,526,358,31431,28721,13954,11409,9200
26405,333,2515,26405,0,22147,4258,3.10321e+18,1504.85,6321.66,26405,489,378,19343,16865,10636,9192,4277
29693,449,1515,0,29693,10520,19173,9.6866e+15,1077.14,5036.1,29693,428,337,25345,23091,12689,8981,10162
20120,1724,1903,10025,10095,10025,10095,4.96933e+18,1137.26,4895.2,20120,370,337,18217,17884,16868,16690,17662
18641,340,351,0,18641,17609,1032,2.72522e+16,257.792,1794.56,18641,113,119,18279,17923,18179,18225,17965
46032,94,2469,24247,21785,24247,21785,4.91981e+18,1488.34,7746.77,46032,638,424,30215,22382,11472,10806,2509
45983,1655,2168,45983,0,36765,9218,2.96328e+18,1735.54,8197.35,45983,521,472,42107,34596,40237,41103,37187
13048,1275,1815,6612,6436,6612,6436,5.01619e+18,914.318,3914.92,13048,303,281,11006,10016,8053,7814,8874
41643,1693,1883,0,41643,14745,26898,9.50939e+15,1152.96,6200.81,41643,589,365,39760,39760,38954,38339,39478
12748,1103,2151,12748,0,10298,2450,3.00184e+18,1049,4304.55,12748,337,304,9977,8841,7717,7270,7097
21931,276,363,0,21931,20860,1071,2.56019e+16,261.34,1919.93,21931,119,124,21421,21057,19805,18942,18197
48135,1192,2268,0,48135,0,48135,2.45561e+18,1581.19,7823.29,48135,637,443,43128,37866,24611,21337,28437
2187,101,194,0,2187,2056,131,2.82696e+16,38.5597,492.589,2187,46,42,1993,1987,1828,1780,1517
48641,651,1884,0,48641,17223,31418,9.55901e+15,1185.22,6707.92,48641,567,392,43004,39377,24082,16296,21656
39332,1255,2230,19099,20233,19099,20233,5.01261e+18,1526.25,7277,39332,510,427,35161,30836,19853,18527,25090
11531,1169,2103,11531,0,9559,1972,3.11676e+18,871.247,4001.26,11531,285,266,9236,8289,7803,7488,7007
26999,1896,2339,22203,4796,13667,13332,7.73588e+17,1594.73,6384.84,26999,482,383,24400,20590,21488,20701,22482
24021,1023,1671,8522,15499,0,24021,3.70601e+13,952.132,4562.1,24021,460,300,21687,20073,15608,16292,17220
8047,422,667,7799,248,8047,0,4.49941e+18,230.458,1723.54,8047,159,122,7380,7266,6462,6534,6160
33579,827,2254,17865,15714,0,33579,5.03358e+18,1371.21,6471.57,33579,533,391,28712,25662,14522,13950,14574
38627,406,1767,0,38627,0,38627,2.54369e+18,1434.13,6667.4,38627,507,426,30425,26318,9901,7848,10956
8640,922,2077,8640,0,7052,1588,3.05733e+18,617.308,3499.71,8640,264,236,6563,5881,4879,4669,3858
5250,528,1094,1839,3411,0,5250,3.89552e+13,145.9,1893.82,5250,216,173,4156,4084,3030,3031,2696
9470,42,45,8939,531,9421,49,9.761e+13,33.2835,470.354,9470,33,36,9425,9422,9408,9406,9319
48658,1634,2632,40088,8570,24884,23774,7.60967e+17,1755.59,8710.92,48658,635,463,44395,37203,35916,35502,36903
45961,97,358,0,45961,43796,2165,2.54737e+16,304.514,2744.94,45961,147,158,44163,43326,34852,29946,23514
15721,541,2349,13103,2618,8242,7479,7.29338e+17,1144.28,4825.14,15721,406,311,11904,10458,6910,7129,3496
8841,385,1300,0,8841,3073,5768,9.4634e+15,490.218,2614.19,8841,261,198,7237,6746,3624,3052,3758
8338,276,2143,8338,0,6864,1474,3.33547e+18,443.677,3416.22,8338,264,216,5838,4999,3109,2516,1261
10642,1290,1861,5793,4849,5793,4849,4.86336e+18,569.671,3415.91,10642,312,212,8781,8305,7017,6421,6553
19817,2550,4018,8834,10983,8834,10983,4.29776e+18,571.41,6627.59,19817,843,431,15799,15630,13617,13425,13209
18417,1855,2101,9803,8614,0,18417,4.96425e+18,1076.25,4740.87,18417,471,297,16316,15028,14951,14421,14941
23830,997,1672,0,23830,8422,15408,9.99162e+15,1082.74,4806.06,23830,408,331,21202,19451,14177,11381,16317
28811,569,1468,10197,18614,0,28811,3.82092e+13,1054.49,4937.46,28811,418,336,25077,22793,13312,13198,12361
20898,328,2307,10928,9970,10928,9970,4.83638e+18,1111.24,5217.91,20898,468,323,16152,14442,6052,6777,3708
32198,1551,2005,16435,15763,16435,15763,4.98169e+18,1357.98,6220.45,32198,460,394,29889,25939,22586,21324,25762
25879,979,1754,12291,13588,0,25879,5.12281e+18,1311.04,5441.1,25879,422,368,22181,19602,12959,10959,15153
31026,1303,1703,0,31026,11006,20020,9.53459e+15,1061.79,5229.02,31026,494,329,29197,26357,23091,17854,26664
12238,1423,2035,6241,5997,0,12238,4.90009e+18,837.525,3901.26,12238,355,244,10203,9338,7779,7537,8226
31266,1825,2242,16434,14832,16434,14832,4.92166e+18,1366.46,6278.08,31266,532,386,29024,28481,24505,23951,27245
8565,165,1861,4661,3904,0,8565,5.03945e+18,315.5,3098.74,8565,254,193,6200,5122,2829,2622,1112
29883,58,1556,0,29883,10581,19302,9.67349e+15,1039.64,5044.08,29883,425,338,20972,17019,8570,5136,3555
47823,1369,1657,16895,30928,0,47823,3.79129e+13,1147.42,6498.03,47823,513,395,46166,46110,39421,40013,45077
2497,313,824,1430,1067,1430,1067,5.34457e+18,152.211,1229.44,2497,178,143,1673,1551,1192,1157,567
47367,423,860,46552,815,47367,0,4.69853e+18,532.219,4374.12,47367,282,256,45741,44271,36362,36189,28594
1586,65,745,784,802,784,802,4.77964e+18,95.2112,992.932,1586,152,108,659,405,247,248,176
28567,1581,1647,10159,18408,0,28567,3.74251e+13,1029.67,4943.15,28567,457,324,26920,26920,26733,26665,26729
36551,1087,2369,19232,17319,19232,17319,4.89512e+18,1417.35,6864.82,36551,562,393,32092,28633,18337,18798,20406
7071,18,43,6724,347,6910,161,9.88808e+13,25.3717,382.466,7071,32,32,6938,6850,5819,5745,4082
8830,1165,1403,0,8830,3097,5733,9.42318e+15,403.379,2651.75,8830,283,174,7427,7216,6946,6779,5858
16498,15,43,15743,755,16025,473,9.79314e+13,36.3415,581.906,16498,37,35,16110,15837,13224,12833,9918
20701,852,1634,7342,13359,0,20701,3.68358e+13,901.798,4210.75,20701,418,281,18408,17013,12552,12575,14113
20587,186,2194,9830,10757,9830,10757,4.98632e+18,1318.15,5344.02,20587,434,338,14091,10782,3863,3948,2102
29092,1605,2579,24446,4646,15652,13440,7.05879e+17,1511.85,6617.81,29092,535,377,25786,22159,21322,21279,21209
921,40,107,0,921,861,60,2.69923e+16,25.5798,254.461,921,35,29,814,787,662,621,479
635,177,349,0,635,251,384,1.0498e+16,18.4425,441.867,635,68,64,286,284,255,206,193
23331,30,349,0,23331,22250,1081,2.52825e+16,262.854,1927.22,23331,115,120,21362,20199,15378,13368,8274
10416,126,350,0,10416,9805,611,2.69317e+16,198.567,1339.7,10416,92,90,9888,9723,8164,7335,5741
7506,122,1372,2669,4837,0,7506,3.7395e+13,187.416,2417.26,7506,270,185,5866,5265,2699,2566,847
18308,505,2425,18308,0,15226,3082,3.30037e+18,1350.79,5301.65,18308,454,308,13703,11929,7214,5984,3165
3227,36,38,3045,182,3165,62,1.10078e+14,24.3852,250.296,3227,25,24,3189,3189,3189,3188,3171
48566,687,797,47624,942,48566,0,4.61058e+18,588.405,4374.66,48566,275,254,47769,47473,45829,45823,45203
6190,1329,1523,3385,2805,0,6190,5.09949e+18,183.228,2434.74,6190,224,162,4667,4667,4650,4641,3629
27828,322,2140,14799,13029,14799,13029,4.86556e+18,1337.01,5803.52,27828,517,354,21877,19467,8667,9314,5451
18645,857,1579,6589,12056,0,18645,3.90137e+13,971.613,4156.19,18645,358,299,16390,15128,10650,9965,11470
3844,733,1139,1750,2094,0,3844,4.80306e+18,160.94,1763.91,3844,186,145,2705,2684,2190,2124,2220
9545,37,42,9061,484,9381,164,1.02033e+14,32.7678,436.918,9545,34,32,9500,9493,9382,9447,9168
32565,362,1365,0,32565,11523,21042,9.94141e+15,1081.18,5158.37,32565,443,357,27393,24948,12306,9204,9995
15038,438,2328,12470,2568,7740,7298,7.43058e+17,1142.95,4749.52,15038,384,300,11066,9777,5851,6156,3261
15385,1336,2291,15385,0,12490,2895,2.96868e+18,1231,4927.71,15385,341,333,12496,10983,10635,10296,8558
6947,595,647,6736,211,6947,0,4.59932e+18,259.653,1614.32,6947,155,121,6300,6276,6251,6247,6219
35010,1273,2645,28871,6139,17865,17145,7.59792e+17,1638.46,7444.36,35010,538,419,29978,25827,23435,22953,19039
30749,806,2222,30749,0,24841,5908,3.01578e+18,1619.5,6760.02,30749,479,407,24538,20509,13699,12664,12616
46220,1807,2500,24275,21945,0,46220,5.00458e+18,1493.62,7796.14,46220,646,427,43720,38458,33040,30951,39467
533,101,127,525,8,407,126,1.86618e+17,19.4296,209.123,533,29,45,406,406,397,396,158
35269,2605,2913,35269,0,29341,5928,3.20218e+18,1650.41,7638.96,35269,623,425,32356,32353,32062,32179,31632
43184,2026,2161,43184,0,34600,8584,3.03457e+18,1768.29,7993.16,43184,531,475,41023,40767,40452,40506,40607
25669,698,2185,13806,11863,13806,11863,4.9558e+18,1229.53,5607.14,25669,476,348,21477,19052,10472,11478,10156
15792,787,1464,0,15792,5609,10183,9.82972e+15,832.492,3671.49,15792,329,270,13786,12755,9001,7739,8874
43616,325,355,0,43616,41644,1972,2.49037e+16,291.566,2624.72,43616,141,152,43180,42311,42018,41179,41092
15913,685,766,15493,420,15913,0,4.58736e+18,406.223,2496.46,15913,224,162,15147,15142,14978,14921,14556
46909,1369,1796,16641,30268,0,46909,3.75487e+13,1166.19,6490.12,46909,566,388,45092,40428,36087,37259,42496
23882,942,2489,23882,0,19905,3977,3.29055e+18,1468.07,6039.56,23882,538,349,19342,16955,13954,13226,10144
38574,545,1491,13650,24924,0,38574,3.83798e+13,1116.56,5712.91,38574,481,377,33567,30484,17690,16611,17853
39545,1616,2406,32556,6989,20167,19378,7.62308e+17,1726.89,7731.17,39545,547,440,35661,30068,29241,28814,29722
1048,23,105,0,1048,988,60,2.57153e+16,28.3111,264.564,1048,36,32,903,808,648,633,428
21109,1087,1470,0,21109,7470,13639,9.6382e+15,947.407,4192.36,21109,379,298,19178,17590,14968,12122,16936
10285,570,1329,0,10285,3663,6622,1.00237e+16,554.906,2814.04,10285,254,237,8737,8156,5364,4538,5307
3963,728,1189,3456,507,2276,1687,5.8318e+17,134.114,1778.18,3963,145,137,2774,2739,2457,2419,2026
44756,1044,1354,0,44756,15832,28924,9.91301e+15,1122.83,5990.6,44756,496,396,42070,37404,30510,25206,33857
39522,483,879,38075,1447,39522,0,4.4454e+18,607.406,3999.56,39522,299,226,38025,36798,31819,31268,25510
34442,171,751,33840,602,34442,0,4.64266e+18,493.298,3627.02,34442,236,232,30902,27182,14956,14840,9766
2129,71,574,1364,765,0,2129,4.78474e+18,26.9657,860.662,2129,129,77,1555,1452,1107,1101,1005
12248,1433,1982,12248,0,9718,2530,2.98277e+18,1043.13,4116.72,12248,299,274,9915,8816,9479,9223,8127
22517,1849,2599,18955,3562,12086,10431,6.99925e+17,1340.59,5904.94,22517,486,356,19836,17254,17158,16855,17533
6001,312,336,0,6001,5664,337,2.75215e+16,85.0877,1010.33,6001,73,69,5665,5664,5657,5664,5594
44881,502,2529,23464,21417,23464,21417,4.88052e+18,1508.36,7716.76,44881,664,430,36568,32358,13540,15324,11224
31152,407,9744,0,31152,0,31152,1.63055e+18,718.869,13906.7,31152,1549,484,19946,16752,9081,6647,3629
13213,1584,1692,0,13213,0,13213,2.5572e+18,983.341,3864.71,13213,309,285,11498,10264,10820,10302,11262
14564,359,1993,0,14564,0,14564,2.42985e+18,919.122,4174.46,14564,350,263,11303,10270,4797,3363,2543
12017,414,2047,12017,0,9591,2426,3.04659e+18,1065.35,4156.5,12017,306,273,8457,7305,3840,3614,3115
38925,732,864,37870,1055,38925,0,4.58324e+18,566.305,3971.82,38925,309,233,38061,37955,37274,37281,36481
12076,1353,1451,0,12076,4263,7813,9.60829e+15,649.415,3164.65,12076,288,246,10625,10034,10121,9706,10580
29164,1513,1704,13798,15366,13798,15366,5.00554e+18,1341.22,5715.35,29164,452,381,27136,23209,21989,21902,25329
22757,268,2418,22757,0,18979,3778,3.32379e+18,1457.59,5854.26,22757,480,363,16137,13766,7895,6226,2670
9688,822,1571,3451,6237,0,9688,3.72557e+13,278.505,2847.54,9688,245,196,8117,7864,6475,6137,6238
48472,1242,2674,48472,0,39937,8535,3.17934e+18,1765.9,8760.81,48472,622,480,41845,35653,31312,29559,28702
47483,9,43,45319,2164,46108,1375,9.77516e+13,39.3267,986.476,47483,43,41,44795,43016,35267,35285,24335
46488,47,888,45339,1149,46488,0,4.59893e+18,579.45,4352.03,46488,282,245,30207,18715,12411,11366,3223
24678,420,1711,11828,12850,11828,12850,5.04749e+18,1278.99,5273.87,24678,397,357,19406,16867,6713,5939,6640
38408,10,47,36429,1979,37979,429,9.68618e+13,40.1868,978.789,38408,44,40,36173,34664,28205,27513,19253
16685,1271,2487,16685,0,13934,2751,3.38076e+18,1198.04,5097.8,16685,437,291,13526,12050,11890,11257,7969
12633,995,1542,4474,8159,0,12633,3.71823e+13,690.359,3299.88,12633,338,244,11032,10299,8134,8155,8266
31801,573,903,30956,845,31801,0,4.60802e+18,528.771,3626.9,31801,291,214,30825,29955,27316,27249,24093
7499,496,1354,0,7499,2645,4854,9.65857e+15,270.002,2443.58,7499,264,174,6145,5815,3771,2799,2648
23248,398,2086,0,23248,0,23248,2.45627e+18,1240.11,5340.34,23248,440,341,18424,16530,6812,4804,4343
22032,33,43,20932,1100,21573,459,1.01401e+14,38.1326,673.907,22032,39,37,21946,21885,20619,20662,19876
22873,975,2047,12026,10847,0,22873,5.01659e+18,1222.99,5236.34,22873,458,332,19498,17736,11506,10991,11414
47183,2082,2549,24700,22483,24700,22483,4.90367e+18,1490.6,7921.76,47183,631,438,44634,44634,37452,36710,41513
10688,1070,1949,5476,5212,0,10688,5.01348e+18,689.119,3585.48,10688,327,264,8739,8039,5558,5367,5957
42813,2060,2201,21913,20900,21913,20900,4.97515e+18,1432.25,7318.85,42813,543,432,40612,40612,39394,39241,39943
26459,252,2102,26459,0,21018,5441,3.0816e+18,1543.29,6178.88,26459,428,387,17708,14380,6178,5476,4282
25636,1037,2342,20976,4660,12803,12833,7.86162e+17,1523.44,6250.62,25636,462,377,21007,18039,15075,14552,13260
35712,273,354,0,35712,34116,1596,2.48768e+16,277.115,2365.57,35712,131,141,35143,34512,32503,30908,30458
20085,529,1636,0,20085,7164,12921,9.61841e+15,930.052,4219.84,20085,418,292,17156,15766,9512,6386,7138
22575,15,43,21516,1059,21942,633,9.89124e+13,38.8767,684.16,22575,39,37,22042,21659,17959,17473,14063
7243,1471,1550,3931,3312,3931,3312,5.02335e+18,261.476,2643.56,7243,291,212,5693,5693,5654,5590,5541
12626,754,1987,6866,5760,6866,5760,5.01803e+18,741.307,3855.66,12626,300,273,10229,9339,5942,5914,4956
17187,631,1563,6090,11097,0,17187,3.74621e+13,866.013,3837.76,17187,374,271,14863,13803,8989,8856,7255
44109,583,923,42968,1141,44109,0,4.63244e+18,647.433,4295.67,44109,304,241,42936,41642,37273,36909,32503
40195,1088,2976,40195,0,33583,6612,3.30859e+18,1701.58,8196.86,40195,630,442,33649,28908,25413,24051,16707
14572,286,1876,0,14572,0,14572,2.4342e+18,902.886,4055.43,14572,376,289,11267,10198,4732,2878,3073
30618,363,2408,30618,0,25090,5528,3.18023e+18,1589.4,6819.2,30618,509,404,22417,19566,11001,8516,6140
11395,124,352,0,11395,10809,586,2.64771e+16,197.044,1382.51,11395,99,96,10889,10696,9089,7932,6672
4556,334,544,4554,2,4556,0,4.85835e+18,186.39,1257.91,4556,149,110,4012,3921,3211,3234,3290
42132,1154,2591,34630,7502,21292,20840,7.68477e+17,1714.71,8150.22,42132,594,448,35718,30484,26567,25981,22995
5309,508,1756,5309,0,4209,1100,3.09148e+18,213.332,2608.4,5309,205,179,3553,3256,2237,2315,1684
18358,1896,1987,9746,8612,9746,8612,4.99241e+18,1074.19,4645.93,18358,380,315,16371,16339,15942,15930,16371
46865,2046,2525,0,46865,0,46865,2.43993e+18,1488.7,7859.51,46865,629,433,44340,44340,38897,37786,42551
44207,332,371,0,44207,42032,2175,2.57118e+16,305.38,2752.35,44207,149,156,43759,42760,42570,41734,41920
45042,1487,2468,23365,21677,0,45042,5.00595e+18,1485.21,7693.99,45042,626,436,41735,36175,26408,23883,33214
4998,303,557,4920,78,4998,0,4.58866e+18,223.036,1352.31,4998,126,110,4441,4256,3389,3395,3064
39609,503,2307,0,39609,0,39609,2.44763e+18,1444.5,7071.89,39609,578,415,32368,28741,12557,9248,10156
7603,762,1764,4005,3598,0,7603,4.98017e+18,232.478,2890.88,7603,248,179,5839,5624,4106,3801,2900
34422,351,374,0,34422,32800,1622,2.52732e+16,285.156,2413.03,34422,131,142,34048,33807,33827,33501,33848
7166,1038,1987,5735,1431,3337,3829,8.43098e+17,462.573,3157.95,7166,261,213,5179,4835,3990,4039,3515
19132,1079,2055,19132,0,15293,3839,2.96312e+18,1407.16,5242.71,19132,375,354,15377,13201,11334,10616,9546
7966,311,666,7755,211,7966,0,4.57362e+18,259.36,1726.75,7966,155,127,7275,6992,5208,5247,4459
12997,2050,2061,10430,2567,6182,6815,8.38298e+17,1127.02,4334.3,12997,337,303,10936,10928,10935,10936,10936
25935,872,1699,12322,13613,0,25935,5.14304e+18,1301.84,5388.65,25935,413,371,22006,19459,12132,9985,13064
5770,277,1800,4697,1073,2867,2903,7.96735e+17,212.906,2699.94,5770,219,179,3874,3415,2141,2273,883
26199,618,1341,9270,16929,0,26199,3.88686e+13,1018.16,4589.27,26199,392,338,22863,20971,12831,11061,12851
21234,885,2423,17484,3750,10789,10445,7.6436e+17,1453.69,5699.24,21234,455,347,16840,14594,11783,11247,8939
19658,1259,1990,10273,9385,10273,9385,4.9362e+18,1109.86,4819.88,19658,413,314,17281,15437,11979,11232,12936
29878,241,353,0,29878,28450,1428,2.54993e+16,280.759,2203.63,29878,122,135,29219,28710,26449,24815,22664
1937,77,509,655,1282,0,1937,3.61135e+13,76.9102,840.064,1937,104,91,1379,1197,582,514,416
41971,1,43,40135,1836,40653,1318,9.61904e+13,39.266,927.194,41971,43,40,15739,15739,15739,15739,15739
29742,1001,1823,0,29742,0,29742,2.51221e+18,1349.03,5898.11,29742,454,394,25969,22777,15086,13243,18718
26884,837,2577,22368,4516,14015,12869,7.3462e+17,1502.61,6441.32,26884,526,369,21614,18602,14384,13888,11453
19455,350,2123,9889,9566,0,19455,4.93771e+18,1153.47,4948.51,19455,442,322,15058,13482,5236,4959,3368
34643,1516,1768,0,34643,0,34643,2.5154e+18,1379.15,6295.81,34643,485,409,32405,27607,25135,24875,30791
22818,254,1830,11342,11476,0,22818,5.10413e+18,1251.18,5176.37,22818,405,344,17036,14662,5199,3932,3386
33400,633,2539,33400,0,27787,5613,3.26673e+18,1621.4,7148.2,33400,600,417,26271,22682,15660,13992,9942
766,208,298,0,766,256,510,9.36108e+15,22.4817,431.126,766,75,65,468,468,353,387,340
36050,90,2268,29271,6779,17797,18253,7.97481e+17,1644.31,7324.03,36050,525,433,19778,12429,8312,8075,1935
8329,1233,1687,3904,4425,3904,4425,4.9473e+18,588.082,3037.61,8329,273,221,6642,6200,5119,5198,5709
41935,224,2396,34159,7776,20763,21172,7.9087e+17,1717.2,8006.67,41935,601,453,28426,21827,12768,14231,4293
1137,98,230,1137,0,1137,0,4.76873e+18,102.546,460.535,1137,60,61,831,562,466,458,445
39390,627,886,38261,1129,39390,0,4.53988e+18,578.858,4016.67,39390,314,234,38445,37411,35545,35595,32168
26885,1,43,25349,1536,26622,263,1.07083e+14,39.0889,756.655,26885,41,39,8752,8752,8752,8752,8752
45450,1693,2491,23859,21591,0,45450,5.00118e+18,1485.91,7719.9,45450,623,426,42824,37035,30278,28058,35927
22053,25,43,21044,1009,21437,616,9.83947e+13,36.9493,671.897,22053,39,36,21889,21774,19543,19571,16984
12852,1780,2197,10558,2294,6486,6366,7.62841e+17,1020.73,4314.29,12852,348,306,10655,9502,9526,9459,9471
4973,278,1350,2556,2417,0,4973,5.25218e+18,192.53,2152.13,4973,184,160,3576,3210,1726,1493,1061
39900,899,2083,31747,8153,18909,20991,8.51422e+17,1621.43,7488.54,39900,527,446,32777,27690,22003,20727,19695
27536,2012,2035,14020,13516,0,27536,5.04093e+18,1317.96,5796.6,27536,458,366,25501,25501,25479,25455,25501
47588,57,359,0,47588,44876,2712,2.7239e+16,321.088,2876.93,47588,161,170,44525,42887,30794,26707,18102
6107,232,1537,3204,2903,0,6107,5.07566e+18,188.199,2485.58,6107,209,161,4459,3970,2039,1696,902
12169,286,743,11656,513,12169,0,4.41825e+18,344.173,2131.92,12169,219,149,11246,10671,7976,7962,5628
40735,1980,2423,0,40735,0,40735,2.44455e+18,1408.92,7234.54,40735,584,409,38312,38161,33395,31043,36311
42256,19,43,40375,1881,40946,1310,9.68672e+13,40.285,929.086,42256,43,40,41668,41219,35318,34972,27655
44244,1983,2559,0,44244,0,44244,2.41786e+18,1488.6,7692.52,44244,660,424,41685,41474,33825,32425,37948
32285,2572,2640,32285,0,26919,5366,3.32128e+18,1640.3,7125.3,32285,596,411,29645,29645,29619,29588,29640
9328,192,1350,3354,5974,0,9328,3.91273e+13,470.246,2726.33,9328,227,239,7389,6803,3469,2694,1995
2972,981,1194,2346,626,1284,1688,8.81217e+17,130.11,1667.62,2972,196,133,1778,1776,1688,1665,1670
33683,1,43,31829,1854,33272,411,1.0541e+14,40.9325,845.271,33683,43,40,11185,11185,11185,11185,11185
12899,1033,1370,0,12899,4579,8320,9.88637e+15,687.329,3210.49,12899,297,246,11415,10668,9110,7976,9829
42452,493,945,41196,1256,42452,0,4.59033e+18,592.878,4197.16,42452,300,233,41061,39733,33868,33470,29213
1778,117,282,1615,163,1778,0,3.6815e+18,42.3256,528.412,1778,54,54,1496,1430,1392,1390,1240
42959,15,43,40994,1965,41716,1243,9.77326e+13,40.5053,942.013,42959,43,40,41958,41224,34156,33247,25562
42389,530,901,41157,1232,42389,0,4.6015e+18,572.077,4150.3,42389,290,233,41168,39966,35109,34695,30807
40033,648,2458,20866,19167,20866,19167,4.89286e+18,1435.24,7257.16,40033,609,411,33297,29428,13154,15995,12102
47692,990,1542,16830,30862,0,47692,3.80081e+13,1145.01,6370.03,47692,535,399,44290,39861,30063,26144,34451
28825,837,841,27928,897,28825,0,4.53626e+18,530.931,3421.55,28825,261,208,27984,27984,27984,27984,27984
20011,1362,2004,0,20011,0,20011,2.45304e+18,1139.74,4844.67,20011,415,307,17672,15808,13018,11962,14278
38979,304,362,0,38979,37153,1826,2.52985e+16,290.535,2523.81,38979,136,149,38455,37668,36499,34402,34621
43073,498,1617,15209,27864,0,43073,3.8019e+13,1120.4,6111.5,43073,500,380,37347,34011,19659,14427,16904
29251,1675,2732,24244,5007,14657,14594,7.42998e+17,1664.5,7089.68,29251,547,395,25657,21962,20223,20393,19666
23855,21,41,22738,1117,23250,605,1.00236e+14,35.9481,684.234,23855,38,36,23607,23403,20258,20198,16993
34277,727,2983,21686,12591,15199,19078,2.12638e+14,285.745,6025.35,34277,804,311,31196,30096,23186,22195,21164
9908,1848,2224,8143,1765,4988,4920,7.72159e+17,775.831,3810.37,9908,315,242,7684,7149,7033,6875,7113
5501,544,1156,0,5501,1948,3553,9.55032e+15,151.371,2007.51,5501,216,181,4345,4276,2975,3247,2554
39485,902,2420,0,39485,0,39485,2.43896e+18,1412.74,7163.31,39485,584,408,34027,30451,16277,16346,17473
42470,23,43,40486,1984,41341,1129,9.89639e+13,39.2313,931.623,42470,42,40,42095,41751,36860,36779,31007
41824,37,373,0,41824,39903,1921,2.49852e+16,303.405,2633.31,41824,141,154,38892,37070,28538,24838,16654
45324,1381,1764,0,45324,0,45324,2.53138e+18,1451.59,7175.03,45324,530,442,42089,35969,29522,26937,37023
48550,1260,2564,25611,22939,25611,22939,4.91162e+18,1502.97,8001.97,48550,677,433,43788,38571,24776,25772,31212
42721,1016,1811,20185,22536,0,42721,5.10133e+18,1439.91,7037.36,42721,524,439,37594,32838,21363,17567,27677
15690,16,43,14852,838,15439,251,1.03459e+14,35.1769,569.053,15690,37,35,15323,15034,12417,12344,9867
31857,840,2258,16751,15106,0,31857,5.01424e+18,1364.92,6348.99,31857,521,383,27074,24259,13935,13493,14240
46009,176,2434,24817,21192,0,46009,5.01124e+18,1514.82,7665.39,46009,654,432,34165,27982,13202,9688,5144
28331,835,2256,14856,13475,0,28331,4.94812e+18,1338.81,5986.3,28331,515,359,23937,21473,12484,11642,12808
11063,1204,2240,11063,0,9394,1669,3.20824e+18,752.543,3915.02,11063,277,235,8823,7958,7740,7666,6258
16348,172,1462,0,16348,5778,10570,9.56426e+15,791.757,3656.12,16348,336,265,13160,12111,5524,3845,3171
20604,672,1672,7274,13330,0,20604,3.6518e+13,885.809,4213.56,20604,430,278,17943,16732,11470,10683,12256
44327,237,358,0,44327,42301,2026,2.52098e+16,296.921,2678.06,44327,148,155,43469,42650,39291,36426,34495
43697,1588,1872,15551,28146,0,43697,3.73396e+13,1139.99,6313,43697,577,381,41825,41825,37860,38030,41187
17778,290,353,0,17778,16781,997,2.71727e+16,260.332,1760.66,17778,115,118,17328,16964,16167,15351,15071
33723,2159,2491,33723,0,27176,6547,2.95748e+18,1611.97,7320.84,33723,518,427,31232,30329,30788,30851,30358
4946,265,492,4821,125,4946,0,4.58325e+18,207.914,1244.55,4946,115,105,4454,4277,3682,3739,3120
37991,1536,2781,37991,0,31637,6354,3.26176e+18,1679.06,7806.71,37991,627,436,33550,28655,30962,28419,25511
24631,31,1649,8711,15920,0,24631,3.72503e+13,999.923,4633.77,24631,433,310,15115,11736,6692,3038,1023
43050,664,2757,36093,6957,22930,20120,7.1329e+17,1707.19,8196.56,43050,610,440,34328,29712,20835,20858,13120
20150,573,803,19519,631,20150,0,4.54186e+18,443.811,2816.43,20150,216,186,19347,18880,18074,18131,16940
7216,49,352,0,7216,6815,401,2.72513e+16,121.887,1122.53,7216,84,82,6655,6388,4700,4014,2331
20384,2297,2353,17128,3256,10970,9414,7.06137e+17,1330.81,5419.89,20384,442,327,18031,17959,17905,17889,18022
11723,276,1691,5557,6166,5557,6166,4.9847e+18,898.925,3630.51,11723,302,253,8597,7461,2518,2699,1730
36289,2093,2296,36289,0,29337,6952,3.03236e+18,1694.08,7424.21,36289,517,432,33993,33793,33544,33571,33406
1129,35,65,0,1129,1116,13,2.02324e+16,17.5598,196.199,1129,23,22,1064,1061,1046,1045,1017
37121,2321,2698,30781,6340,19141,17980,7.44688e+17,1731.79,7694.71,37121,595,423,34423,34187,32251,31829,33332
48937,1854,1956,17424,31513,0,48937,3.73742e+13,1150.95,6722.74,48937,625,386,46981,46981,46488,46417,46883
34532,38,353,0,34532,32895,1637,2.54994e+16,293.698,2369.96,34532,131,140,32099,30488,23586,20196,12804
42476,253,1901,0,42476,15032,27444,9.46374e+15,1147.93,6261.12,42476,590,365,35257,32461,14540,9789,11305
8248,1778,2156,8248,0,6904,1344,3.32204e+18,428.668,3424.94,8248,265,209,6092,5940,6022,5992,4621
21729,107,803,21240,489,21729,0,4.66636e+18,481.566,2950.36,21729,277,185,17651,13252,7698,7278,3476
4364,647,997,1571,2793,0,4364,3.84429e+13,191.474,1720.68,4364,181,173,3367,3295,2629,2576,2455
49948,1959,2492,49948,0,40680,9268,3.10025e+18,1755.85,8779.81,49948,638,480,47352,43143,42953,41456,42948
13749,480,1533,0,13749,4896,8853,9.43829e+15,669.605,3365.01,13749,342,253,11604,10860,7152,5471,5036
38766,124,356,0,38766,36773,1993,2.57888e+16,299.87,2527.44,38766,138,146,37392,36702,30543,26894,21566
41351,756,939,40274,1077,41351,0,4.57796e+18,565.134,4146.01,41351,276,230,40412,40350,38965,38998,37009
38611,700,833,37577,1034,38611,0,4.59574e+18,569.759,3935.78,38611,290,227,37778,37682,36988,36959,36218
41329,261,2089,0,41329,0,41329,2.48631e+18,1431.35,7086.58,41329,529,424,31539,27401,10978,6505,6959
1523,406,643,688,835,688,835,4.78854e+18,74.2738,882.367,1523,106,93,880,868,808,790,755
16832,1607,2249,16832,0,13951,2881,3.04322e+18,1170.42,4942.8,16832,376,326,14285,12619,13129,12810,11979
39724,179,2397,20721,19003,20721,19003,4.91674e+18,1470.81,7228.26,39724,582,414,29012,23519,10406,11390,4719
20687,615,2000,10929,9758,0,20687,4.99031e+18,1153.68,4921.98,20687,445,319,16974,15199,8449,8208,7353
27705,1805,2551,23133,4572,14608,13097,7.19857e+17,1486.56,6468.18,27705,512,367,24833,21267,20988,20675,20919
14329,1149,2269,11898,2431,7399,6930,7.48293e+17,1092.22,4617.65,14329,361,296,11361,10252,8954,8848,6734
33961,19,43,32495,1466,32846,1115,9.6624e+13,37.8226,829.279,33961,41,39,33506,33161,28593,28378,23056
4159,241,828,0,4159,1532,2627,1.03716e+16,126.633,1459.78,4159,168,125,3331,3219,2212,1131,1439
3339,66,1054,0,3339,0,3339,2.43112e+18,132.492,1615.15,3339,181,137,1777,1077,556,442,297
31279,1793,1849,0,31279,0,31279,2.49821e+18,1380.92,6073.6,31279,484,384,29430,29430,29200,28253,29388
4374,30,491,4176,198,4374,0,4.28038e+18,158.829,1145.86,4374,102,88,2758,1857,1293,1099,249
42943,73,2732,35431,7512,21920,21023,7.58443e+17,1686.01,8313.17,42943,589,446,22948,14528,9832,10011,1766
49853,2624,2904,49853,0,41551,8302,3.28882e+18,1781.04,8966.89,49853,695,475,46949,46949,46456,46556,46255
26128,1743,2481,21789,4339,13704,12424,7.27148e+17,1526.29,6293.58,26128,473,374,23183,19909,19700,19598,20133
24490,1631,2272,19872,4618,12016,12474,8.03256e+17,1534.04,6067.01,24490,460,376,21546,18288,18003,17713,17914
11140,406,1688,5196,5944,5196,5944,4.96223e+18,857.606,3535.69,11140,302,271,8474,7450,3218,3235,3279
32183,226,833,32183,0,32183,0,4.65448e+18,367.107,3530.86,32183,255,228,30046,27246,14246,14045,11626
15697,217,351,0,15697,14974,723,2.51332e+16,207.29,1585.81,15697,104,111,15219,14996,13878,13076,11704
36848,494,1294,12947,23901,0,36848,3.89201e+13,1039.48,5313.79,36848,451,366,31994,29061,16651,14952,15874
33137,1133,2748,33137,0,27562,5575,3.32282e+18,1639.72,7314.49,33137,584,408,27813,23962,21964,20701,15493
29310,1090,1647,10384,18926,0,29310,3.73411e+13,1032.2,5011.92,29310,485,321,27074,24684,20033,18427,23397
49365,328,1623,17429,31936,0,49365,3.8567e+13,1257.35,6698.77,49365,539,403,41509,37088,16740,11788,12923
32963,1075,1637,11643,21320,0,32963,3.74759e+13,1078.38,5376.16,32963,467,348,30601,27591,21655,22914,25504
31548,86,766,30748,800,31548,0,4.60293e+18,536.639,3506.2,31548,249,222,24267,17577,9878,9440,4304
38135,280,2147,19468,18667,19468,18667,4.94209e+18,1402.36,6869.1,38135,518,409,29253,25641,9834,10421,5755
49524,77,382,0,49524,46998,2526,2.65612e+16,330.636,3002.15,49524,157,170,47082,45901,35256,30171,20636
29695,588,2339,24485,5210,15135,14560,7.62614e+17,1635.36,6681.38,29695,508,395,22952,19702,13471,13293,8814
20911,1707,2193,11323,9588,11323,9588,4.96709e+18,1078.96,5084.34,20911,426,322,18718,16855,15188,14416,15752
43674,383,1835,15514,28160,0,43674,3.72369e+13,1133.28,6262.95,43674,597,375,37344,34270,18154,16764,12801
1548,515,572,1212,336,752,796,9.07196e+17,116.737,839.8,1548,110,92,976,976,947,945,943
12819,708,1460,4618,8201,0,12819,3.8445e+13,599.36,3168.57,12819,303,240,11143,10512,7923,7870,6564
47172,202,354,0,47172,44955,2217,2.53024e+16,305.525,2764.24,47172,145,160,46098,45183,40796,37240,32266
29306,556,1706,10422,18884,0,29306,3.74707e+13,1044.37,5079.74,29306,465,325,25448,23377,14672,13346,9761
19956,1652,1958,0,19956,0,19956,2.44449e+18,1138.42,4876.4,19956,401,323,17998,15958,15186,14841,16973
12391,1666,1783,6266,6125,0,12391,5.02028e+18,840.984,3728.02,12391,327,277,10608,9778,9874,9878,10078
39148,2088,2190,18726,20422,0,39148,5.11338e+18,1604.02,7273.52,39148,558,431,36958,36958,36572,35819,36902
22961,401,595,22755,206,22961,0,4.76385e+18,457.727,2853.23,22961,210,204,22042,21399,18090,18033,16617
3753,370,435,3672,81,3753,0,4.70388e+18,168.187,1043.49,3753,92,94,3318,3315,3310,3311,3082
19340,1824,2345,16326,3014,10498,8842,6.93403e+17,1258.19,5256.51,19340,419,326,16822,14880,15089,14775,15364
18464,961,1703,0,18464,6502,11962,9.29986e+15,856.059,4087.57,18464,413,278,16383,15204,11695,8655,10745
42697,904,2008,21067,21630,0,42697,5.10982e+18,1430.85,7220.52,42697,541,438,37007,32490,18388,15981,21873
31657,858,2231,0,31657,0,31657,2.43067e+18,1365.42,6306.79,31657,520,377,27004,24236,14233,13399,13333
44423,42,2023,21781,22642,21781,22642,4.95964e+18,1501.35,7410.05,44423,566,450,22054,13386,6689,8022,1556
12359,1981,2126,10054,2305,6075,6284,7.9471e+17,1029.58,4232.71,12359,302,265,10233,9211,9846,9719,10067
10598,614,3322,10598,0,8915,1683,2.83787e+18,416.058,4940.24,10598,689,285,7276,6053,3908,3746,2299
11681,356,635,11520,161,11681,0,4.63156e+18,341.038,2053.48,11681,193,151,10956,10653,8443,8425,7629
42679,533,2837,42679,0,35770,6909,3.27771e+18,1691.53,8244.21,42679,680,451,33226,28769,18957,15685,10630
32634,1892,2263,16732,15902,0,32634,5.04682e+18,1364.99,6491.15,32634,499,394,30371,30282,25606,24674,28496
2060,59,357,1914,146,2060,0,4.43056e+18,72.8301,681.283,2060,91,62,1543,1251,874,798,320
24563,985,2126,12916,11647,12916,11647,4.92465e+18,1255.71,5504.23,24563,461,346,21046,18922,11930,12558,12892
24370,122,2435,24370,0,20200,4170,3.27851e+18,1520.35,6065.97,24370,481,357,15282,10573,6608,5527,1510
49867,991,2720,26183,23684,26183,23684,4.89404e+18,1515.11,8260.81,49867,685,446,43615,38599,20001,24292,23463
705,223,370,705,0,540,165,3.19969e+18,44.6766,476.38,705,73,71,335,325,281,300,226
36913,826,829,35860,1053,36913,0,4.58878e+18,544.543,3820.24,36913,304,230,36084,36084,36079,36080,36072
36365,37,43,34711,1654,35316,1049,9.83946e+13,38.4964,859.491,36365,41,40,36291,36240,34800,34869,33347
36825,2276,2358,19165,17660,19165,17660,4.92105e+18,1464.22,6912.45,36825,583,413,34467,34467,34155,34084,34364
7369,28,43,7031,338,7158,211,9.9122e+13,29.9251,392.665,7369,32,30,7304,7281,6783,6780,6390
31464,1673,2338,16382,15082,16382,15082,4.90947e+18,1297.76,6354.77,31464,533,375,29126,25521,21366,20557,24270
28366,1161,2719,0,28366,10404,17962,6.84857e+15,756.476,6451.02,28366,538,445,25647,24735,19720,16652,16321
38689,961,963,37634,1055,38689,0,4.59508e+18,572.925,4040.71,38689,289,229,37726,37726,37726,37724,37724
39125,616,1833,13886,25239,0,39125,3.7263e+13,1126.87,5958.96,39125,566,363,34297,31662,19558,17739,20029
21886,1267,2138,11543,10343,0,21886,4.96431e+18,1168.6,5187.37,21886,461,326,19143,17175,12427,11441,13818
9618,672,1683,0,9618,0,9618,2.54244e+18,679.489,3228.61,9618,279,259,7602,6829,3480,3220,4442
27622,661,2027,14166,13456,0,27622,5.07503e+18,1292.68,5781.15,27622,438,368,22871,20216,10661,9998,10004
10004,240,1715,4817,5187,0,10004,5.09392e+18,701.46,3327.83,10004,283,267,7307,6324,2425,1888,2096
1551,294,334,1550,1,1551,0,4.56894e+18,115.382,635.744,1551,70,72,1217,1211,1195,1194,1181
28146,1569,1719,13298,14848,0,28146,5.08954e+18,1336.19,5634.77,28146,450,372,26239,22447,22259,22083,25444
2626,115,166,0,2626,2546,80,2.10741e+16,20.7677,463.718,2626,40,43,2460,2455,2395,2349,2199
45512,848,2373,23515,21997,23515,21997,4.93149e+18,1476.76,7651.5,45512,605,430,38983,34703,17727,20681,19873
6477,794,1931,6477,0,5461,1016,3.43532e+18,208.974,2894.41,6477,269,192,4546,4357,3795,3463,2687
19994,41,43,19099,895,19380,614,9.65189e+13,33.8173,630.601,19994,38,35,19949,19939,19912,19911,19565
6919,650,1670,0,6919,0,6919,2.41202e+18,300.942,2712.75,6919,274,214,5249,4897,3387,3218,2390
18692,32,43,17835,857,18158,534,9.79865e+13,34.208,613.378,18692,37,35,18613,18565,17494,17497,16446
37037,719,1432,20100,16937,20100,16937,4.57389e+18,596.459,5431.01,37037,428,331,35605,35601,22070,19942,25421
42721,484,2134,21430,21291,21430,21291,4.9609e+18,1450.18,7326.7,42721,546,434,34601,30293,12955,13775,13119
10251,1790,1992,5317,4934,0,10251,4.9777e+18,638.723,3544.44,10251,320,241,8259,7894,7861,7700,8091
27896,1534,1702,0,27896,0,27896,2.50746e+18,1313.45,5577.01,27896,439,379,25918,22214,21332,21279,24741
40956,70,1320,14459,26497,0,40956,3.90062e+13,1089.7,5671.05,40956,467,387,28825,23305,9838,3559,1966
47003,1544,2180,22368,24635,22368,24635,5.00303e+18,1475.25,7813.29,47003,548,459,44192,37556,28367,25386,38230
25490,704,1448,9029,16461,0,25490,3.81073e+13,994.784,4615.71,25490,396,320,22524,20688,13605,12433,14341
23907,995,2255,12647,11260,0,23907,4.98945e+18,1214.38,5525.73,23907,482,339,20349,18450,11557,10972,11232
36143,1018,2684,29918,6225,18587,17556,7.50519e+17,1705.98,7564.41,36143,594,420,29885,25916,21895,21069,15168
15592,408,558,15455,137,15592,0,4.75636e+18,395.282,2304.95,15592,178,181,14895,14525,12957,13039,11884
34066,120,2690,34066,0,28346,5720,3.33808e+18,1693.42,7373.54,34066,592,414,21140,14343,9039,7830,2281
14287,1410,2223,11736,2551,7249,7038,7.72798e+17,1082.14,4573.14,14287,352,306,11586,10410,9581,9448,8943
6536,1150,1301,0,6536,2303,4233,9.91205e+15,216.952,2277.63,6536,215,203,5235,5218,5028,4842,4945
23132,1344,2428,23132,0,19343,3789,3.29709e+18,1484.9,5915.23,23132,475,341,19404,17211,17659,16355,11515
27119,484,755,26493,626,27119,0,4.60201e+18,488.144,3225.36,27119,240,207,26189,25482,22636,22525,20407
46226,1594,1640,0,46226,16395,29831,9.75726e+15,1139.22,6373.14,46226,503,391,44586,44586,44506,44505,44553
32872,234,2301,17166,15706,0,32872,5.00268e+18,1420,6511.15,32872,544,394,24640,21318,8583,6948,4219
38958,301,354,0,38958,36945,2013,2.64608e+16,300.154,2584.18,38958,143,155,38412,37505,36228,34387,35463
8884,14,43,8450,434,8664,220,1.00278e+14,29.0527,425.241,8884,33,31,8638,8470,7111,6992,5757
33347,1801,2137,15903,17444,15903,17444,5.00117e+18,1522.69,6635.26,33347,502,403,31042,28269,24856,24162,29341
47552,1409,2749,39854,7698,25160,22392,7.16474e+17,1896.48,8665.18,47552,731,455,41597,35763,33449,32942,28195
25224,41,43,23894,1330,24818,406,1.03969e+14,40.1393,733.637,25224,41,40,25174,25152,25096,25095,24442
17251,251,348,0,17251,16419,832,2.5413e+16,232.337,1658.96,17251,101,109,16811,16555,15581,14844,14556
20426,42,43,19428,998,19956,470,1.01106e+14,38.7537,649.449,20426,39,36,20381,20370,20335,20334,20130
18570,207,1006,13890,4680,18426,144,3.30997e+18,247.268,3202.74,18570,236,163,17099,15926,11559,11276,3812
3783,357,753,1290,2493,0,3783,3.43104e+13,66.4589,1314.69,3783,149,116,3030,3013,2003,1993,1909
20124,664,777,19493,631,20124,0,4.53686e+18,452.876,2789.48,20124,266,185,19347,19147,18845,18891,18290
45156,1090,1759,21487,23669,21487,23669,5.01528e+18,1457.97,7169.22,45156,529,444,40146,34916,24305,21598,28050
5796,241,272,0,5796,5539,257,2.39447e+16,68.9134,851.759,5796,64,58,5524,5524,5504,5501,5428
41088,1131,2501,21603,19485,0,41088,4.98529e+18,1446.17,7360.73,41088,626,412,36418,32400,19853,18765,21212
49601,71,357,0,49601,47288,2313,2.5333e+16,311.01,2842.71,49601,150,161,47286,46278,36279,31227,21724
41801,472,2004,14884,26917,0,41801,3.73528e+13,1107.01,6323.23,41801,568,399,36140,33129,17917,15243,14152
28168,529,2246,14529,13639,0,28168,5.02367e+18,1340.19,6010.56,28168,504,369,22811,20273,8662,8894,8444
35694,1563,1798,16968,18726,16968,18726,4.98781e+18,1410.4,6437.08,35694,488,417,33506,28496,26363,25970,31168
23012,16,43,21949,1063,22373,639,9.89789e+13,38.2345,688.964,23012,39,37,22533,22159,18442,18423,13959
28063,1273,1711,0,28063,0,28063,2.54972e+18,1306.75,5594.19,28063,437,382,25296,22104,17186,15390,20434
37128,1054,2716,37128,0,31135,5993,3.31861e+18,1689.3,7633.21,37128,630,421,30963,26976,23610,22276,15358
18841,259,683,18423,418,18841,0,4.50282e+18,452.095,2664.71,18841,210,181,17482,16412,9934,9692,8810
6887,206,347,0,6887,6493,394,2.72139e+16,109.534,1079.51,6887,75,73,6540,6473,5884,5735,4796
6804,421,1673,3664,3140,3664,3140,4.97605e+18,273.352,2681.7,6804,270,188,5131,4704,2451,2383,1008
17798,1121,2540,14877,2921,9314,8484,7.26616e+17,1245.23,5274.55,17798,419,325,14445,12668,11032,10754,7631
47570,952,2108,37956,9614,22464,25106,8.48238e+17,1746.78,8260.96,47570,571,473,39282,33118,26654,25002,24104
4592,265,1586,3689,903,2190,2402,8.37307e+17,237.344,2299.37,4592,195,169,2912,2410,1329,1452,718
49795,1867,2723,26155,23640,0,49795,5.05745e+18,1475.79,8349.15,49795,719,437,47030,43865,36343,34166,41275
47036,50,353,0,47036,44351,2685,2.73212e+16,314.012,2844.29,47036,159,167,43815,42009,30137,26259,16857
44857,497,917,43599,1258,44857,0,4.56415e+18,633.487,4318.51,44857,332,239,43376,41924,36156,35662,29668
3779,95,1145,1873,1906,1873,1906,4.87659e+18,222.295,1768.14,3779,204,168,2087,1366,619,684,350
38436,340,2651,31096,7340,18361,20075,8.10801e+17,1812.55,8013.88,38436,638,455,27078,22260,11594,13098,5692
8272,466,2066,8272,0,6672,1600,2.98817e+18,589.291,3430.91,8272,266,250,5852,5127,2870,2810,2453
33197,1957,2091,16689,16508,16689,16508,4.9148e+18,1408.48,6417.81,33197,510,396,31106,31106,30525,30393,30710
17632,36,43,16663,969,17431,201,1.05059e+14,39.2704,616.103,17632,39,38,17565,17527,16659,16665,15475
46317,31,47,43727,2590,45822,495,1.06727e+14,41.2897,1001.54,46317,44,43,46090,45937,41105,41155,36910
45205,11,383,0,45205,42772,2433,2.71765e+16,325.133,2871.46,45205,156,166,35636,30470,24509,21682,12497
21213,2639,2709,17509,3704,10589,10624,7.57068e+17,1378.49,6036.63,21213,437,345,18504,18504,18482,18492,18484
43639,920,1749,0,43639,0,43639,2.54915e+18,1451.79,7058.24,43639,523,442,37779,32856,20400,16237,22935
24586,1608,2222,12892,11694,0,24586,4.97394e+18,1207.59,5541.75,24586,507,339,22318,19735,16332,15160,18321
49857,2076,2560,26332,23525,26332,23525,4.93367e+18,1515.71,8106.24,49857,678,446,47297,47297,40482,39836,44875
10310,31,351,0,10310,9835,475,2.507e+16,153.963,1271.05,10310,84,87,9454,8952,6807,6179,4241
4583,969,1523,3729,854,2307,2276,8.07352e+17,237.568,2265.42,4583,221,175,3060,3019,2696,2784,2479
24099,1895,2053,12473,11626,0,24099,5.04063e+18,1243.02,5410.75,24099,443,350,22046,21981,20828,20588,21481
41849,1677,2442,21195,20654,0,41849,5.02137e+18,1564.26,7582.66,41849,568,435,39033,33870,26170,23283,32320
49812,236,355,0,49812,47321,2491,2.59505e+16,308.657,2899.8,49812,154,167,48808,47787,43685,39971,37656
36780,107,359,0,36780,35066,1714,2.5183e+16,288.563,2428.75,36780,134,144,35438,34793,28678,25015,20083
28577,1013,2231,15320,13257,0,28577,5.0161e+18,1289.05,5936.14,28577,511,355,24846,22279,14446,13461,15167
8560,46,418,0,8560,8193,367,2.37218e+16,99.516,1274.81,8560,84,86,7859,7388,5657,5063,3315
48906,722,1889,17289,31617,0,48906,3.69803e+13,1174.51,6693.1,48906,637,384,43763,40051,25197,21128,22330
7175,1651,1729,3605,3570,0,7175,5.05405e+18,324.95,2853.32,7175,260,196,5446,5400,5431,5406,5347
26264,2083,2240,21425,4839,13032,13232,7.84919e+17,1589.94,6259.58,26264,466,382,24024,23868,23289,22991,23919
45082,9,43,42561,2521,44634,448,1.0661e+14,40.8705,978.11,45082,43,43,41936,39845,31748,31769,20258
26943,1384,2117,14348,12595,0,26943,5.05259e+18,1280.61,5717.93,26943,464,361,24199,21406,17081,15522,18724
18552,296,2602,18552,0,15471,3081,3.3434e+18,1294.71,5436.38,18552,461,317,13106,11093,6594,4849,2842
2872,17,190,0,2872,2743,129,2.43622e+16,39.898,547.721,2872,48,53,2488,2265,1812,1727,1197
33983,252,2120,0,33983,0,33983,2.47618e+18,1357.01,6530.52,33983,491,396,25449,22046,7967,5291,4137
29429,46,363,0,29429,27839,1590,2.68114e+16,285.583,2262.41,29429,133,140,27368,26122,19163,16604,10870
4615,21,36,4450,165,4395,220,8.84988e+13,20.5519,276.406,4615,23,23,4571,4548,4354,4359,3949
46388,488,1846,0,46388,16501,29887,9.4667e+15,1201.77,6428.38,46388,631,375,40170,36954,21045,14130,16165
8426,25,42,7989,437,8278,148,1.00885e+14,28.4572,407.696,8426,32,30,8353,8311,7622,7598,7240
28926,1966,2225,15160,13766,15160,13766,4.93214e+18,1336.44,6040.21,28926,501,368,26701,26588,24901,24680,25764
11167,210,1429,3992,7175,0,11167,3.81072e+13,512.837,2938.2,11167,265,242,9108,8517,4701,4361,2279
3300,150,250,0,3300,3100,200,2.65522e+16,60.1861,669.11,3300,60,56,3050,3030,2829,2740,2472
1257,23,28,1185,72,1257,0,9.38252e+13,17.0302,135.967,1257,20,20,1229,1225,1168,1169,1141
35896,1189,1764,0,35896,12771,23125,9.56325e+15,1086.52,5630.15,35896,522,351,33629,30410,24697,18354,30195
12111,2199,2316,10103,2008,6322,5789,7.29909e+17,858.341,4186.12,12111,370,283,9795,9795,9766,9757,9795
36561,554,1929,18483,18078,18483,18078,4.99651e+18,1433.97,6604.61,36561,491,409,29915,26240,12036,12581,11414
3934,1043,1234,1761,2173,1761,2173,5.03297e+18,179.548,1893.09,3934,232,182,2700,2694,2493,2521,2335
2942,12,1158,2368,574,1394,1548,8.59835e+17,130.953,1603.87,2942,152,122,596,136,101,83,34
25079,457,1729,8822,16257,0,25079,3.76048e+13,1009.82,4860.33,25079,425,316,21261,19438,10656,8407,10288
23769,582,1643,8425,15344,0,23769,3.72568e+13,982.451,4542.61,23769,429,308,20560,19067,12134,10808,9782
1645,504,508,0,1645,0,1645,2.56826e+18,119.368,800.479,1645,101,110,1137,1137,1137,1137,1137
11594,785,1953,6053,5541,6053,5541,5.03159e+18,755.006,3726.11,11594,314,273,9325,8570,5394,5512,5076
25280,2338,2582,25280,0,20922,4358,3.29345e+18,1443.62,6257.41,25280,496,374,22698,22688,22457,22442,21711
44477,253,352,0,44477,42192,2285,2.62847e+16,308.6,2735.41,44477,150,161,43666,42712,39284,36533,35215
10110,1064,1866,0,10110,0,10110,2.48204e+18,499.023,3325.24,10110,266,255,8244,7793,6197,5744,5799
49670,591,1542,17522,32148,0,49670,3.81998e+13,1156.52,6517.51,49670,543,396,43672,39692,22928,22788,23672
13554,322,2275,11349,2205,7214,6340,7.27739e+17,996.921,4430.97,13554,359,287,9731,8318,4820,5401,1948
18499,1833,2032,10190,8309,0,18499,5.06746e+18,1046.38,4636.86,18499,398,299,16467,15884,15469,15105,15458
43952,21,355,0,43952,41948,2004,2.51576e+16,292.95,2655.59,43952,141,157,39058,36049,28345,24987,14487
38176,330,2754,38176,0,31841,6335,3.30158e+18,1701.83,7795.93,38176,656,435,27892,23925,14402,11519,6051
33543,1237,2452,33543,0,27625,5918,3.17615e+18,1593.27,7144.33,33543,534,426,28738,24665,22559,21379,19345
18300,1809,1951,8981,9319,0,18300,4.97515e+18,1159,4747.88,18300,379,323,16349,16293,15937,15568,16136
42911,50,345,0,42911,40456,2455,2.74656e+16,305.494,2705.53,42911,155,164,39935,38261,27369,23927,15682
4198,11,31,4051,147,3993,205,9.01152e+13,19.691,252.601,4198,22,22,4073,3984,3421,3387,2509
27531,130,353,0,27531,26204,1327,2.55897e+16,282.955,2123.36,27531,127,131,26567,26088,22176,19395,16095
19645,1151,1611,6920,12725,0,19645,3.66583e+13,941.033,4139.26,19645,420,285,17780,16352,13827,13368,13600
15635,1042,1328,0,15635,5519,10116,9.951e+15,835.279,3529.81,15635,313,276,14063,12868,10776,9696,11892
40607,1394,2622,21226,19381,0,40607,5.03263e+18,1449.3,7471.64,40607,641,420,36902,32434,21420,19562,24958
25499,217,351,0,25499,24070,1429,2.73548e+16,282.171,2098.51,25499,130,132,24759,24196,21869,19745,19438
9311,893,1738,4783,4528,4783,4528,5.06686e+18,580.234,3207.4,9311,245,260,7573,6935,4940,4588,4906
755,37,432,656,99,362,393,5.29806e+17,43.2424,527.66,755,63,63,269,121,71,66,16
2824,6,37,2697,127,2715,109,1.0366e+14,20.676,229.206,2824,22,22,2522,2308,1946,1957,1205
40232,271,351,0,40232,38065,2167,2.67011e+16,302.143,2613.28,40232,143,154,39519,38621,35860,33468,34883
5624,1076,1204,0,5624,2015,3609,9.97551e+15,187.282,2042.71,5624,213,160,4420,4410,4344,4243,4215
31409,730,2255,0,31409,0,31409,2.44662e+18,1368.15,6308.89,31409,539,383,26316,23279,13391,12797,12918
8375,1080,1295,3034,5341,0,8375,4.01827e+13,453.113,2560.84,8375,211,232,7080,6771,6369,6517,6440
47485,39,46,45267,2218,46210,1275,9.85477e+13,40.6086,1000.59,47485,43,41,47408,47365,45263,45275,44199
29007,1733,2759,24206,4801,15072,13935,7.35355e+17,1610.44,6867.55,29007,538,384,25720,21960,21077,21085,19587
25578,1588,2360,20909,4669,12775,12803,7.88112e+17,1561.62,6270.2,25578,458,389,22441,18997,18363,18196,17788
35916,1398,1999,17812,18104,17812,18104,4.94683e+18,1406.82,6602.38,35916,500,413,32892,28552,22279,20733,27095
5299,60,1540,2426,2873,0,5299,4.80417e+18,213.661,2357.94,5299,248,164,2788,1655,733,496,90
20237,95,351,0,20237,19222,1015,2.58863e+16,249.653,1822.57,20237,110,118,19360,18989,15351,13606,10557
28595,1390,2216,0,28595,0,28595,2.42252e+18,1358.28,6023.93,28595,517,365,25731,22506,16933,15515,19875
34185,119,353,0,34185,32583,1602,2.52945e+16,283.786,2341.45,34185,128,140,33003,32437,27201,23774,18929
41103,302,375,0,41103,39093,2010,2.58074e+16,295.497,2681.62,41103,143,156,40553,39643,38056,35862,35904
35540,880,2337,18012,17528,18012,17528,4.96207e+18,1378.06,6912.62,35540,500,407,30337,27087,14171,15612,15798
45954,24,608,45506,448,45954,0,4.76105e+18,516.56,4050.07,45954,265,258,20885,8224,6923,6043,2017
21980,438,1335,7824,14156,0,21980,3.91896e+13,963.018,4198.99,21980,352,321,18616,17022,9664,7229,8679
42429,195,358,0,42429,40355,2074,2.57634e+16,305.15,2664.12,42429,150,157,41320,40433,36261,32658,29619
15782,3,43,14885,897,15596,186,1.07564e+14,37.2199,584.425,15782,38,35,11025,9127,8135,8440,5999
779,108,323,0,779,0,779,2.02483e+18,41.9281,449.297,779,57,56,456,432,220,218,249
33921,216,1982,0,33921,0,33921,2.46771e+18,1411.48,6362.88,33921,513,388,25237,21915,8834,5460,4677
36683,1279,2234,36683,0,29707,6976,3.01889e+18,1684.81,7385.23,36683,518,439,31709,26851,23925,22503,21980
43147,904,2324,43147,0,34943,8204,3.06075e+18,1755.45,8101.89,43147,540,461,35303,29853,21681,20705,18010
35093,1389,1833,12433,22660,0,35093,3.71839e+13,1100.78,5670.63,35093,546,349,33257,30083,26424,27410,32161
24077,1788,2361,19784,4293,12154,11923,7.77542e+17,1522.69,6061.03,24077,459,379,21328,18191,17881,17462,17943
24409,2,43,23259,1150,23776,633,9.88492e+13,38.0528,706.455,24409,39,37,15084,12359,11808,12561,9273
26831,119,2157,0,26831,0,26831,2.42952e+18,1275.42,5718.99,26831,480,345,18656,14235,7413,3561,1174
7899,1015,1816,4148,3751,4148,3751,4.94762e+18,292.253,2999.16,7899,290,219,6083,6008,4668,4900,4625
4637,481,521,4634,3,4637,0,4.65137e+18,189.21,1248.14,4637,146,111,4116,4109,4016,4019,3991
9504,1045,2028,9504,0,7545,1959,2.97836e+18,825.688,3649.78,9504,261,257,7313,6394,5640,5395,5114
4488,1121,1176,2136,2352,2136,2352,4.92415e+18,166.901,1892.63,4488,183,164,3312,3312,3284,3268,3277
15828,1229,2028,8382,7446,0,15828,4.99798e+18,983.316,4363.73,15828,386,294,13370,12307,9440,8814,9992
11802,389,1434,4170,7632,0,11802,3.71886e+13,592.979,3093.69,11802,292,225,9818,9218,5440,4312,4127
25748,1333,4864,4294,21454,6146,19602,1.49108e+18,366.349,8453.8,25748,816,461,20884,20674,11436,10922,6534
43984,915,2486,23058,20926,0,43984,5.02097e+18,1470.16,7606.02,43984,616,433,38007,33889,17494,17868,19653
39917,64,859,39114,803,39917,0,4.58761e+18,536.071,4018.12,39917,273,233,28036,18082,10638,10073,3828
32753,427,2280,17292,15461,0,32753,5.03712e+18,1371.38,6444.85,32753,527,385,26295,23330,10293,10660,7658
42979,533,2306,22270,20709,22270,20709,4.90485e+18,1512.68,7406.45,42979,583,428,35229,31288,14097,15474,14582
41091,293,861,40030,1061,41091,0,4.57141e+18,574.378,4082.13,41091,315,232,38668,36632,24306,23919,18111
23594,75,2309,23594,0,19196,4398,3.02406e+18,1511.9,5995.64,23594,433,361,12345,7511,5039,4932,1067
13271,1648,2941,1168,12103,0,13271,1.54795e+18,259.816,5062.14,13271,352,333,10330,10301,9063,8998,7289
1601,107,138,0,1601,1496,105,2.71398e+16,41.4166,359.448,1601,43,40,1463,1460,1403,1389,1363
11909,748,1686,5645,6264,0,11909,5.13344e+18,850.596,3622.03,11909,292,282,9574,8762,5243,4463,5903
12133,1149,2257,12133,0,9953,2180,3.27595e+18,1006.94,4259.61,12133,366,285,9514,8378,7899,7456,6748
7299,424,1351,0,7299,2595,4704,9.72073e+15,233.844,2417.65,7299,252,186,5948,5662,3310,2491,2387
28974,348,353,0,28974,27667,1307,2.51931e+16,271.203,2145.91,28974,125,132,28621,28619,28577,28522,28562
43884,1324,1748,0,43884,0,43884,2.54401e+18,1450.07,7057.27,43884,521,448,40439,34692,27625,24830,34952
29628,206,815,28872,756,29628,0,4.60578e+18,513.684,3449.91,29628,245,210,26996,24499,14710,14097,9781
4383,534,1115,2319,2064,0,4383,4.84314e+18,108.125,1779.23,4383,207,142,3268,3251,2040,2043,1803
9166,101,1456,3246,5920,0,9166,3.75792e+13,385.093,2713.57,9166,281,231,7030,5910,2888,2744,1335
48651,623,2700,25110,23541,0,48651,5.04991e+18,1526.86,8307.96,48651,682,448,40386,35221,15016,16784,14801
13058,65,745,12833,225,13058,0,4.76334e+18,367.953,2269.27,13058,192,153,9149,5964,3797,3554,1528
25124,945,1827,0,25124,0,25124,2.52021e+18,1294.26,5414.48,25124,398,362,21523,19134,12406,10827,14400
30504,34,1354,0,30504,10771,19733,9.91288e+15,1047.43,4958.99,30504,427,353,17960,13201,6696,4716,2141
45653,1431,1891,16193,29460,0,45653,3.72039e+13,1167.75,6492.5,45653,602,376,43762,41278,35085,36500,42408
28174,657,1943,13491,14683,0,28174,5.14792e+18,1298.14,5851.79,28174,433,385,23255,20145,9656,8120,10518
4274,188,257,0,4274,4071,203,2.62504e+16,58.3547,765.475,4274,62,61,4017,3995,3900,3891,3623
10950,166,350,0,10950,10315,635,2.7586e+16,192.156,1362.29,10950,95,96,10470,10277,8985,8242,6852
39888,208,1824,0,39888,14131,25757,9.49146e+15,1119.87,6019.97,39888,564,367,32668,29949,13660,8678,7125
28110,832,2261,0,28110,0,28110,2.45941e+18,1340.52,5980.27,28110,478,365,23739,21353,12249,11659,11470
47685,1203,2912,47685,0,39952,7733,3.32015e+18,1748.28,8768.09,47685,695,475,40807,35200,33425,32081,26958
10403,143,2086,10403,0,8595,1808,3.23779e+18,862.609,3842.21,10403,276,242,6445,4509,2788,2476,812
23171,1021,2159,18758,4413,11348,11823,8.12644e+17,1488.25,5827.54,23171,431,374,18964,16245,13637,13073,11932
9762,1003,2163,9762,0,7957,1805,3.20577e+18,780.355,3781.55,9762,299,242,7531,6649,5683,5412,4482
33047,97,1343,11644,21403,0,33047,3.86214e+13,1070.11,5141.55,33047,446,360,24659,20432,8579,3400,3623
40213,2132,2352,0,40213,0,40213,2.45142e+18,1452.14,7218.15,40213,566,419,37861,37861,35978,35119,37296
48243,305,1774,22861,25382,0,48243,5.10987e+18,1467.33,7416.65,48243,537,457,36821,31832,10210,8555,10975
12764,602,2175,12764,0,10349,2415,3.08087e+18,1046.21,4313.2,12764,345,303,9506,8348,5117,4217,3689
3262,461,1128,1359,1903,0,3262,4.55073e+18,153.636,1649.72,3262,190,126,2134,2029,1246,1095,1015
36513,422,2249,19387,17126,0,36513,5.02534e+18,1411.05,6734.3,36513,543,407,29428,26180,12342,12529,9386
12971,40,43,12338,633,12666,305,1.01167e+14,32.8669,513.667,12971,36,33,12925,12921,12896,12896,12686
35590,932,1751,12695,22895,0,35590,3.73893e+13,1088.17,5571.85,35590,511,350,32493,29859,22193,20802,25164
22080,323,352,0,22080,21082,998,2.52007e+16,251.564,1872.6,22080,114,120,21705,21327,21203,20791,20496
39261,14,43,37430,1831,38197,1064,9.87865e+13,39.7926,899.406,39261,42,40,38214,37432,31024,30197,23460
44478,784,1922,0,44478,15678,28800,9.83003e+15,1210.12,6739.05,44478,627,396,39529,35819,22487,17667,26125
27181,1886,2199,22045,5136,13346,13835,8.02653e+17,1580.38,6343.74,27181,470,390,24806,20727,21982,21236,22341
40657,39,43,38661,1996,39790,867,1.01106e+14,39.7172,919.635,40657,42,40,40594,40559,40157,40155,38884
6376,1432,1434,3435,2941,0,6376,4.99753e+18,217.866,2393.56,6376,276,211,4942,4942,4942,4942,4942
24362,209,357,0,24362,23148,1214,2.58896e+16,277.248,2014.82,24362,119,128,23711,23248,21074,19504,17179
28395,886,1740,10135,18260,0,28395,3.74536e+13,1038.24,5035.21,28395,458,328,25649,23525,16745,16294,14622
36638,995,2195,0,36638,0,36638,2.46451e+18,1409.46,6767.68,36638,536,410,31866,28399,17560,16736,19177
6176,430,1246,0,6176,2185,3991,9.9183e+15,191.544,2175.23,6176,221,168,4930,4699,2813,2435,2460
47636,2621,2900,47636,0,39704,7932,3.30082e+18,1774.91,8797.22,47636,698,460,44736,44736,44379,44413,44104
4579,169,1213,0,4579,0,4579,2.56059e+18,182.378,1944.24,4579,213,178,3245,2569,1486,972,809
26378,847,2029,0,26378,0,26378,2.48929e+18,1298.82,5679.41,26378,438,367,22294,19956,11266,10427,12592
36526,35,43,34849,1677,35499,1027,9.80919e+13,40.1438,869.688,36526,42,40,36428,36327,34370,34385,32144
1081,213,442,831,250,448,633,8.80927e+17,73.8751,636.514,1081,96,69,639,614,490,444,388
44923,98,348,0,44923,42377,2546,2.73792e+16,310.622,2770.44,44923,158,167,42821,41855,32368,28165,22148
21195,150,384,0,21195,20099,1096,2.64093e+16,239.957,1936.81,21195,119,124,20431,20033,17092,15282,13233
14153,10,42,13430,723,13893,260,1.03517e+14,33.8052,534.329,14153,37,33,13426,12914,10701,10368,7719
12947,1673,2066,6942,6005,6942,6005,4.97301e+18,793.256,3981.35,12947,355,277,10881,10160,9184,8940,9861
23919,408,1938,11862,12057,11862,12057,4.93165e+18,1311.51,5401.09,23919,418,352,18760,16510,6701,6871,6797
18347,1434,2153,9412,8935,9412,8935,4.87966e+18,1103.03,4820.73,18347,405,310,15983,14360,11256,11227,12536
6902,135,335,0,6902,6565,337,2.56932e+16,76.8395,1048.23,6902,70,73,6567,6519,5776,5462,4056
49343,361,364,0,49343,46724,2619,2.66907e+16,308.59,2936,49343,158,171,48979,48979,48959,48973,48971
4984,216,232,0,4984,4792,192,2.33928e+16,62.5157,737.957,4984,58,58,4752,4752,4745,4744,4714
25590,825,2085,13543,12047,13543,12047,4.91359e+18,1307.77,5563.62,25590,483,343,21700,19459,11846,11983,11749
20808,208,1639,7396,13412,0,20808,3.74373e+13,927.599,4276.47,20808,422,292,16852,15460,7277,5174,4021
29212,21,41,27707,1505,28691,521,1.03313e+14,38.7989,768.234,29212,40,38,28881,28607,24570,24468,19808
35912,2136,2689,29724,6188,18474,17438,7.48694e+17,1697.96,7539.95,35912,594,417,33223,30914,29395,28697,31723
8425,64,1787,4536,3889,0,8425,5.09098e+18,353.625,3048.55,8425,245,181,5152,3760,2244,1905,945
10509,25,1870,5874,4635,5874,4635,5.04839e+18,555.171,3393.88,10509,267,250,5403,3782,2383,2424,165
2922,54,390,2849,73,2922,0,4.39546e+18,138.043,897.322,2922,84,79,2005,1277,937,938,635
43246,1869,2589,43246,0,35606,7640,3.16992e+18,1726.83,8224.44,43246,587,461,40205,33472,37061,35229,34546
37187,26,43,35433,1754,36237,950,9.95274e+13,40.057,876.261,37187,42,40,36937,36779,32794,32880,28505
30175,1542,1727,14382,15793,0,30175,5.15701e+18,1339.44,5825.97,30175,437,397,28201,24110,23107,22852,26442
16735,1455,2014,8870,7865,8870,7865,4.92414e+18,1008.09,4473.71,16735,396,295,14531,13209,11458,11040,11429
13091,512,740,12871,220,13091,0,4.67206e+18,365.872,2267.52,13091,206,153,12351,12118,11422,11458,10238
8197,39,348,0,8197,7810,387,2.49833e+16,98.6558,1138.02,8197,76,74,7628,7289,5829,4950,3283
1305,99,653,621,684,0,1305,4.99726e+18,74.3341,850.167,1305,133,96,636,464,314,263,220
43047,31,43,40604,2443,42601,446,1.06844e+14,40.6465,954.93,43047,43,41,42845,42720,38860,38789,35481
1024,19,27,955,69,1024,0,1.08852e+14,14.8604,120.891,1024,16,17,993,984,945,926,900
8019,157,675,7795,224,8019,0,4.57874e+18,251.813,1739.9,8019,158,124,6996,6014,3613,3666,2370
23529,81,1474,0,23529,8293,15236,9.62223e+15,970.622,4451.91,23529,408,316,17208,14313,6462,4390,2441
22030,395,1589,0,22030,7831,14199,9.54961e+15,949.857,4337.63,22030,400,298,18670,17256,10035,6204,7210
30126,658,2518,24897,5229,15469,14657,7.52606e+17,1574.32,6814.94,30126,520,390,23638,20359,13961,14117,7579
35277,792,888,34346,931,35277,0,4.61383e+18,574.222,3816.56,35277,273,222,34389,34351,33665,33644,32951
8657,274,1751,4296,4361,4296,4361,4.86112e+18,456.289,3089.34,8657,302,220,6519,5810,2621,2745,1922
28887,916,2238,15018,13869,15018,13869,4.93366e+18,1335.24,6058.91,28887,505,369,24647,22128,12794,13637,13248
11939,1341,1800,0,11939,0,11939,2.58203e+18,873.132,3754.08,11939,281,271,10034,9083,7794,7293,8892
19094,188,355,0,19094,18008,1086,2.73075e+16,260.732,1821.23,19094,115,121,18421,18024,15926,14254,13139
20081,268,819,19647,434,20081,0,4.64493e+18,456.72,2859.62,20081,234,181,18621,17468,11777,11257,8697
12852,1907,2095,10371,2481,6287,6565,8.21916e+17,996.558,4279.19,12852,346,291,10757,9615,10305,10133,10621
9999,389,1825,0,9999,0,9999,2.47443e+18,598.733,3350.19,9999,300,265,7749,7075,3729,3268,3011
1436,9,165,0,1436,1348,88,2.71471e+16,26.7813,376.815,1436,41,35,1051,879,743,683,405
23820,1302,2293,19309,4511,11635,12185,8.01961e+17,1488.6,5987.52,23820,460,370,20233,17341,15888,15546,14575
12831,285,358,0,12831,12221,610,2.57771e+16,203.117,1463.99,12831,99,98,12449,12280,11735,11450,11207
11370,888,1425,3976,7394,0,11370,3.70779e+13,622.961,3056.1,11370,292,238,9869,9219,7016,7151,7584
48765,35,43,46237,2528,47938,827,1.02876e+14,40.2618,1007.04,48765,43,42,48656,48569,45670,45688,42388
39786,531,2853,39786,0,33300,6486,3.32479e+18,1711.21,8004.52,39786,676,442,30836,26670,17155,14500,9307
43351,284,355,0,43351,41401,1950,2.48249e+16,291.96,2626.44,43351,140,151,42751,41914,39721,37748,37136
35340,1829,2693,35340,0,29319,6021,3.30298e+18,1703.22,7506.95,35340,615,418,32069,27115,30642,29354,26297
32778,846,2394,32778,0,26769,6009,3.1387e+18,1641.24,7096.23,32778,513,433,26310,22068,15370,14381,13825
22113,1212,2116,11643,10470,0,22113,4.98498e+18,1208.38,5223.28,22113,449,323,19209,17272,12338,11426,13515
30003,1552,1741,10700,19303,0,30003,3.74122e+13,1043.48,5155.43,30003,486,332,28262,28262,26137,26169,27841
9973,1247,2076,8213,1760,5000,4973,7.61738e+17,851.212,3769.77,9973,304,267,7897,6970,6092,6125,5931
33436,2340,2734,27899,5537,17471,15965,7.26786e+17,1685.36,7303.36,33436,594,404,30702,30463,28772,28484,29598
17857,14,42,16989,868,17426,431,9.94789e+13,34.0909,589.315,17857,36,34,17395,17065,14221,13988,10860
43396,1377,2381,22986,20410,22986,20410,4.92659e+18,1470.47,7444.56,43396,605,419,39708,34598,24717,24562,29390
6871,1438,1701,0,6871,0,6871,2.46362e+18,302.887,2769.19,6871,253,219,5170,5146,4850,4766,4920
6123,772,1592,3073,3050,0,6123,4.84088e+18,189.64,2516.92,6123,244,167,4531,4398,2852,2706,2978
26548,440,697,25920,628,26548,0,4.49557e+18,515.893,3170.42,26548,232,207,25459,24701,19891,19836,18980
12706,1479,1865,6509,6197,0,12706,5.01329e+18,855.478,3842.24,12706,331,245,10841,9922,8879,8617,9506
13035,1140,1523,0,13035,4642,8393,9.41624e+15,676.07,3282.26,13035,324,207,11512,10778,9397,7896,10409
26830,405,2038,26830,0,21372,5458,2.97659e+18,1525.95,6143.39,26830,428,390,19457,16489,7703,6749,6361
21741,1081,2293,17749,3992,10795,10946,7.90255e+17,1438.18,5737.46,21741,439,367,17713,15400,13268,12699,10777
12291,664,1902,6037,6254,6037,6254,4.84489e+18,827.351,3815.04,12291,331,282,9751,8896,4767,4688,5417
31577,444,2670,26443,5134,16705,14872,7.1659e+17,1619.71,7021.54,31577,555,386,23947,20963,12526,13679,7177
47452,388,2513,0,47452,0,47452,2.4393e+18,1472.25,7879.31,47452,637,441,37991,33992,13710,7933,8644
26959,1532,1639,9597,17362,0,26959,3.786e+13,1034.46,4868.49,26959,437,326,25320,25319,24752,24730,25225
9915,136,1310,3474,6441,0,9915,3.84703e+13,565.166,2768.87,9915,269,230,7646,6641,2840,1468,1727
10570,671,1378,0,10570,3704,6866,9.675e+15,582.908,2904.55,10570,275,236,8988,8434,5479,4742,5763
32689,610,2264,16800,15889,0,32689,5.00023e+18,1398.64,6466.1,32689,520,393,26906,23686,10858,10830,9917
22353,730,2176,11903,10450,0,22353,4.9817e+18,1201.14,5271.3,22353,464,323,18482,16528,9383,8902,8701
26837,909,2606,22220,4617,13731,13106,7.46259e+17,1549.52,6501.86,26837,523,374,21686,18777,15087,14687,10835
28562,1853,2291,14796,13766,14796,13766,4.88841e+18,1324.88,6058.3,28562,520,371,26271,26176,21351,20800,24143
6650,74,558,6513,137,6650,0,4.55746e+18,198.787,1491.83,6650,141,116,4917,3432,2347,2281,1344
19819,353,2351,16710,3109,10723,9096,6.94934e+17,1289.23,5335.02,19819,428,326,14702,12963,7623,8237,3412
1060,165,307,0,1060,341,719,7.88706e+15,46.0179,475.961,1060,56,56,753,744,463,541,535
45252,2045,2080,21533,23719,21533,23719,4.98419e+18,1442.25,7498.61,45252,530,447,43172,43172,43129,43074,43171
4371,206,1071,2359,2012,2359,2012,4.74041e+18,103.134,1725.14,4371,208,138,3294,3122,1783,2043,495
6667,1076,1797,6667,0,5568,1099,3.16506e+18,246.335,2803.23,6667,228,186,4870,4794,4586,4277,3730
39134,719,1820,0,39134,13890,25244,9.52519e+15,1115.65,5933.57,39134,544,361,34752,31967,20866,14660,24028
47692,2099,2468,24942,22750,0,47692,5.02354e+18,1491.6,7878.67,47692,647,437,45224,45192,40072,38973,43173
49008,1160,2553,0,49008,0,49008,2.44638e+18,1474.22,8024.12,49008,643,444,43791,38805,24390,22954,28044
21258,482,588,21008,250,21258,0,4.73508e+18,467.073,2752.8,21258,199,202,20540,19985,18730,18826,18297
19869,25,43,18921,948,19373,496,1.00101e+14,39.2942,646.626,19869,39,37,19697,19583,17426,17450,14200
23930,14,42,22621,1309,23660,270,1.06415e+14,39.1823,704.777,23930,40,37,23201,22680,18484,17901,13120
35107,49,2363,18309,16798,0,35107,4.95788e+18,1440.41,6745.05,35107,590,392,19925,13711,7763,5055,1329
42285,39,356,0,42285,40418,1867,2.47912e+16,284.7,2579.06,42285,137,151,39572,37842,29662,25475,16330
28180,758,1707,9976,18204,0,28180,3.68753e+13,1031.25,4977.11,28180,487,317,24995,23059,16149,14570,17967
37260,1669,2443,19677,17583,19677,17583,4.87838e+18,1415.74,6969.02,37260,592,395,34702,30229,24615,23605,29763
47967,1815,2546,25451,22516,0,47967,5.01513e+18,1465.05,7941.45,47967,640,442,45421,42058,33965,31617,39972
5247,76,1598,5247,0,4432,815,3.34013e+18,209.428,2388.38,5247,225,165,3196,2405,1518,1160,202
26515,673,2635,22225,4290,14130,12385,7.11829e+17,1422.2,6391.93,26515,488,373,20928,18226,12843,13081,8246
5021,526,1451,2446,2575,0,5021,4.95187e+18,246.616,2264.78,5021,222,196,3570,3294,1877,1798,1548
22381,345,1039,22363,18,22381,0,4.57876e+18,412.106,3329.89,22381,216,215,21110,20413,13016,12974,10607
29162,2448,2627,24401,4761,15453,13709,7.19254e+17,1544,6713.19,29162,550,386,26535,26535,26222,26158,26098
42774,1010,1888,20692,22082,20692,22082,4.99798e+18,1467.94,7149.47,42774,536,439,37617,32894,20276,19979,25026
6161,117,1639,6161,0,5285,876,3.20075e+18,252.709,2563.8,6161,201,174,3984,2851,2219,1700,485
38679,1641,2872,38679,0,32268,6411,3.2864e+18,1697.13,7950.52,38679,637,446,34518,29246,31997,29651,24470
23277,1799,2286,19107,4170,11828,11449,7.70966e+17,1455.69,5858.15,23277,437,373,20693,17741,17906,17465,18380
39107,382,703,38431,676,39107,0,4.68775e+18,527.995,3829.94,39107,251,239,37558,36281,27608,27635,23909
547,138,425,547,0,479,68,2.77113e+18,14.128,470.66,547,56,63,122,113,91,88,57
42534,178,358,0,42534,40526,2008,2.55643e+16,305.146,2645.05,42534,146,154,41396,40528,36098,32203,28419
44359,18,42,41867,2492,43866,493,1.06577e+14,39.8312,955.26,44359,42,41,43570,42944,35592,35329,27717
49256,1709,3036,41003,8253,25696,23560,7.32622e+17,1780.37,9043.03,49256,714,461,44795,37750,35975,35624,34435
3693,1285,1326,3693,0,2975,718,2.66469e+18,175.435,1894.05,3693,160,142,2367,2367,2364,2364,2355
31594,281,351,0,31594,29835,1759,2.72298e+16,295.378,2332.1,31594,139,145,30980,30267,28450,26937,26771
43037,1262,2457,22615,20422,22615,20422,4.87111e+18,1488.27,7484.79,43037,639,419,38801,34101,22641,22692,25536
19087,1926,2032,10101,8986,0,19087,5.06878e+18,1114.39,4779.8,19087,405,317,17055,17029,16552,16544,17054
24734,23,43,23647,1087,23930,804,9.59344e+13,35.8861,706.655,24734,39,37,24514,24323,21589,21537,17390
1014,18,360,0,1014,0,1014,2.16537e+18,66.7564,547.477,1014,79,79,387,182,75,68,63
676,248,259,235,441,235,441,4.16079e+18,50.1361,369.551,676,58,59,417,417,417,413,416
16999,1172,1438,0,16999,6012,10987,9.64286e+15,861.401,3765.32,16999,334,281,15405,14104,12622,11219,14164
40334,422,801,39658,676,40334,0,4.64697e+18,520.708,3976.23,40334,272,231,38887,37651,29139,28256,26448
31127,1233,1462,0,31127,11007,20120,9.76455e+15,1077.57,5124.13,31127,447,339,29473,26157,24254,21700,26982
4216,346,1265,4216,0,3562,654,3.09078e+18,232.252,1966.02,4216,137,158,2932,2708,1842,1463,1141
11485,296,350,0,11485,10995,490,2.42995e+16,143.708,1320.47,11485,86,88,11135,11039,10770,10628,10229
30089,86,372,0,30089,28550,1539,2.64173e+16,289.775,2295.94,30089,129,139,28699,28073,21998,18714,13823
34837,41,43,33052,1785,34178,659,1.02533e+14,40.5657,853.606,34837,42,40,34784,34755,34677,34676,33730
32991,46,353,0,32991,31454,1537,2.53363e+16,273.346,2292.43,32991,129,142,31037,29802,23130,19810,13361
48157,938,1940,17097,31060,0,48157,3.71612e+13,1169.85,6669.22,48157,652,383,44116,40352,28126,29819,31930
49180,1359,1891,0,49180,17379,31801,9.48746e+15,1175.16,6711.09,49180,645,384,47215,42142,35689,28336,43449
38926,38,2282,38926,0,31606,7320,3.06957e+18,1715.82,7653.1,38926,543,447,16336,8758,5475,5915,879
41508,345,631,41114,394,41508,0,4.74787e+18,509.133,3879.53,41508,250,245,39773,38334,28853,28850,25240
43079,1321,2088,0,43079,0,43079,2.48848e+18,1440.68,7290.25,43079,544,437,39342,34203,25053,21922,31145
10499,329,348,0,10499,9971,528,2.56344e+16,162.177,1296.93,10499,86,90,10151,10055,10112,10036,10022
37741,1830,2414,31205,6536,19480,18261,7.56557e+17,1709.62,7542.11,37741,565,429,34616,29080,29518,28738,31225
33734,37,1785,0,33734,12011,21723,9.5704e+15,1103.18,5516.95,33734,511,349,21831,17378,9629,4721,1803
21348,946,1320,0,21348,7505,13843,9.75746e+15,941.593,4106.83,21348,366,312,19373,17614,13834,11595,15928
12348,139,726,12010,338,12348,0,4.4591e+18,386.394,2198.52,12348,170,147,10556,8766,5337,5142,3292
26142,84,354,0,26142,24825,1317,2.62078e+16,273,2097.68,26142,124,133,24909,24368,19255,16816,12157
19578,602,729,19302,276,19578,0,4.699e+18,437.157,2748.66,19578,211,190,18849,18512,17904,17921,17989
1790,205,468,687,1103,0,1790,4.16029e+13,38.048,755.813,1790,108,95,1322,1320,1195,1207,446
35319,1320,1889,17200,18119,0,35319,5.07756e+18,1433.93,6496.09,35319,507,413,32114,27820,21677,19065,26955
30903,1047,2356,30903,0,24900,6003,2.9739e+18,1628.06,6942.33,30903,484,425,25425,21567,15890,14800,14529
22106,1630,1709,10591,11515,10591,11515,5.078e+18,1239.81,4986.49,22106,376,349,20378,17761,19715,19526,20031
17719,608,1923,9216,8503,0,17719,5.07243e+18,1105.76,4583.54,17719,369,301,14371,12685,6841,6470,6439
23030,1078,1722,10853,12177,10853,12177,4.96792e+18,1289.44,5113.55,23030,411,352,20067,17578,12506,10926,14442
45835,866,1785,21734,24101,21734,24101,4.98942e+18,1450.99,7247.28,45835,524,450,39490,34477,20333,18625,25350
10848,2720,3281,9041,1807,4846,6002,7.69422e+17,371.225,4864.97,10848,481,260,7567,7567,7146,7108,6784
5833,1346,1850,5833,0,4633,1200,3.07647e+18,343.37,2801.98,5833,200,208,3983,3857,3869,3863,3310
33100,1184,1769,11672,21428,0,33100,3.84149e+13,1095.48,5660.13,33100,505,367,30809,27451,24253,24902,27955
10954,628,2417,9029,1925,5219,5735,7.47574e+17,917.57,4269.27,10954,393,278,7913,6585,3715,4312,3293
32657,1917,2677,27307,5350,17187,15470,7.19292e+17,1617.96,7143.83,32657,576,388,29772,25266,25183,24698,26110
2987,270,1172,2321,666,1280,1707,9.3023e+17,119.697,1654.16,2987,152,151,1815,1650,999,979,319
26956,1642,1714,0,26956,0,26956,2.54493e+18,1309.05,5501.06,26956,436,377,25220,22775,24723,23197,24955
30933,1139,1538,0,30933,10956,19977,9.68059e+15,1043,5107.18,30933,433,334,28907,26015,21731,16752,25158
42651,613,2371,0,42651,0,42651,2.44373e+18,1468.98,7375.09,42651,592,416,35484,31271,14335,15400,13052
29317,995,1851,10371,18946,0,29317,3.68137e+13,1019.07,5224.14,29317,500,328,26659,24411,18213,17270,19857
16202,1387,1726,7645,8557,0,16202,5.14809e+18,1115.39,4307.13,16202,327,297,14229,12531,10933,10316,12178
7483,153,661,7304,179,7483,0,4.7449e+18,234.613,1682.97,7483,158,121,6446,5466,3479,3541,2423
38875,1414,1670,0,38875,13795,25080,9.83453e+15,1108.53,5952.73,38875,504,380,37205,36327,33769,31452,36500
36914,1159,2126,36914,0,29558,7356,3.07348e+18,1675.49,7329.2,36914,498,445,31174,26203,23112,21603,20851
16363,674,774,15898,465,16363,0,4.55775e+18,412.519,2543.29,16363,216,168,15589,15535,15379,15327,14906
8496,162,1449,0,8496,3019,5477,9.47173e+15,203.861,2565.26,8496,230,172,6791,6313,3463,2726,2301
46342,1033,2480,24258,22084,24258,22084,4.91686e+18,1490.42,7795.14,46342,636,441,40589,36069,20975,22510,24208
646,12,321,508,138,317,329,9.2264e+17,88.9505,431.07,646,79,77,126,24,22,17,25
35206,165,388,0,35206,33273,1933,2.7322e+16,300.996,2545.21,35206,139,149,34030,33224,28384,24824,21402
43549,1668,1678,15427,28122,0,43549,3.77238e+13,1127.1,6181.06,43549,513,380,41871,41871,41850,41863,41843
19671,365,588,19447,224,19671,0,4.73864e+18,460.606,2654.07,19671,194,194,18712,18126,14495,14294,13287
30421,185,1677,0,30421,10778,19643,9.50523e+15,1038.44,5108.96,30421,509,325,24812,22869,10814,6281,5055
45282,215,363,0,45282,43147,2135,2.52876e+16,309.763,2746.05,45282,146,155,44225,43324,39465,36099,34396
17777,145,723,17301,476,17777,0,4.71492e+18,451.882,2613.11,17777,212,176,15450,12851,7686,7448,4489
15687,75,744,15262,425,15687,0,4.59501e+18,401.334,2474.55,15687,191,161,11701,8258,5229,4989,2451
30587,1397,1455,0,30587,10805,19782,9.74488e+15,1058.57,5060.88,30587,416,350,29132,29132,29016,28783,29037
47232,2154,2183,0,47232,0,47232,2.49058e+18,1484.98,7684.26,47232,575,452,45049,45049,45013,44939,45004
10751,1315,1792,0,10751,0,10751,2.51585e+18,682.772,3451.64,10751,285,272,8959,8324,7165,6706,7807
1439,290,308,1439,0,1439,0,4.69321e+18,118.382,594.153,1439,60,61,1131,1130,1124,1123,1115
40877,1138,2146,32751,8126,19497,21380,8.39817e+17,1690.84,7699.87,40877,541,452,34722,29123,25440,24710,22821
48617,227,354,0,48617,46354,2263,2.52099e+16,306.725,2801.08,48617,145,159,47670,46705,42875,39499,35144
18196,401,1884,0,18196,0,18196,2.44108e+18,1125.11,4630.95,18196,386,316,14261,12715,5340,3997,4126
43606,1068,1595,0,43606,15477,28129,9.77245e+15,1144.25,6140.72,43606,502,377,40757,36626,28437,21776,34304
44618,735,895,43770,848,44618,0,4.59078e+18,540.127,4265.15,44618,288,244,43723,43713,42375,42442,41316
37883,469,605,37499,384,37883,0,4.74628e+18,505.258,3677.3,37883,244,238,36907,35856,32943,32919,30835
16057,66,1800,8091,7966,8091,7966,5.03631e+18,1041.74,4295.37,16057,328,307,9321,6270,3273,3094,927
46792,1451,2296,46792,0,37946,8846,3.04893e+18,1767.22,8400.93,46792,562,481,41512,34713,34498,32188,30616
18484,1293,2039,18484,0,14769,3715,3.05123e+18,1375.41,5133.3,18484,373,338,15288,13213,12880,12431,11309
12141,1492,2203,10140,2001,6437,5704,7.10243e+17,816.883,4059.76,12141,338,277,9938,9051,8360,8391,7672
23612,661,2488,23612,0,19726,3886,3.27918e+18,1471.73,6010.78,23612,485,354,18442,15987,11422,10548,7002
44900,614,2468,23209,21691,23209,21691,4.90591e+18,1504.59,7696.76,44900,621,437,37168,32720,14513,17150,15240
48838,1477,2615,26263,22575,0,48838,4.99675e+18,1453.81,8012.54,48838,667,442,45134,39523,28287,26056,33331
40619,761,1741,0,40619,0,40619,2.52166e+18,1420.44,6775.88,40619,506,431,34395,30120,16415,12385,18912
49515,1368,2327,49515,0,40219,9296,3.03035e+18,1766.85,8645.13,49515,594,480,43608,36662,33961,31799,31617
6757,241,1969,5348,1409,3174,3583,8.68854e+17,386.107,3051.42,6757,218,199,4399,3694,2118,2257,1095
40956,698,921,39807,1149,40956,0,4.52106e+18,602.091,4126.59,40956,296,237,39966,39634,37109,37024,34393
35896,1220,2341,19355,16541,19355,16541,4.95062e+18,1356.3,6716.56,35896,549,400,32167,28592,19944,20405,21429
41562,474,2424,22188,19374,0,41562,5.03052e+18,1421.79,7306.4,41562,584,418,33873,30056,13808,14558,10149
38280,1790,2417,20113,18167,20113,18167,4.91849e+18,1416.03,7052.96,38280,568,409,35863,31533,27087,25972,31877
35716,2100,2381,18535,17181,18535,17181,4.93363e+18,1416.42,6833.39,35716,554,407,33335,33335,30776,30358,32099
32384,285,352,0,32384,30893,1491,2.5186e+16,284.875,2276.25,32384,130,132,31851,31255,29802,28231,28797
43654,323,358,0,43654,41599,2055,2.53029e+16,294.722,2670.77,43654,141,158,43185,42265,41719,39934,40890
48681,320,1717,22871,25810,0,48681,5.14061e+18,1440.9,7370.32,48681,540,461,37411,32202,10746,9334,10986
46087,295,373,0,46087,43778,2309,2.63187e+16,311.72,2841.76,46087,149,161,45422,44441,41843,39098,40679
27240,769,854,26402,838,27240,0,4.51237e+18,480.96,3304,27240,262,204,26386,26353,26187,26130,25919
33022,606,1731,11710,21312,0,33022,3.71036e+13,1071.35,5391.75,33022,513,336,28994,26637,17050,14853,17835
26898,1061,2192,0,26898,0,26898,2.41998e+18,1357.09,5846.78,26898,498,357,23314,20687,13458,12194,14271
36446,754,2217,29609,6837,18085,18361,7.98871e+17,1677.62,7311.05,36446,533,436,29097,24434,18479,17943,14358
23688,813,1975,12077,11611,0,23688,5.09618e+18,1238.9,5373.28,23688,413,338,19957,17779,10605,9469,9991
9142,1441,1458,3259,5883,0,9142,3.73261e+13,258.821,2643.88,9142,235,180,7684,7635,7681,7678,7654
2720,783,914,0,2720,0,2720,2.74017e+18,99.9809,1380.16,2720,159,129,1806,1806,1799,1799,1723
2229,398,544,753,1476,0,2229,3.49823e+13,80.3715,919.049,2229,118,101,1685,1674,1585,1568,1504
1907,247,366,1865,42,1907,0,5.06149e+18,129.595,731.871,1907,70,72,1541,1508,1461,1454,1364
8418,589,2177,8418,0,7134,1284,3.32427e+18,284.472,3386.94,8418,259,215,6241,5751,4288,3384,2506
4261,445,855,0,4261,1565,2696,1.05036e+16,143.305,1518.62,4261,179,121,3406,3336,2876,1866,2063
46754,1589,1861,22282,24472,0,46754,5.12241e+18,1458.07,7402.64,46754,543,451,44597,37746,33776,32199,39599
3492,169,469,3367,125,3492,0,4.55034e+18,177.066,1051.94,3492,92,90,2957,2628,1897,1972,1290
49096,1346,2555,40081,9015,24488,24608,7.84572e+17,1739.3,8750,49096,616,477,42960,36384,34142,33546,30202
43915,747,893,42854,1061,43915,0,4.61628e+18,597.613,4251.47,43915,322,242,43022,42878,41636,41612,40033
41524,1708,2742,34782,6742,22030,19494,7.17001e+17,1713.38,8051.77,41524,617,424,37591,31952,30889,30570,29574
9561,90,1697,4590,4971,4590,4971,5.00933e+18,680.265,3239.61,9561,274,257,5720,3754,1653,1736,781
46873,849,2090,23432,23441,23432,23441,4.97477e+18,1461.86,7585.46,46873,560,445,40286,35545,19135,20687,21989
36537,1279,2239,18910,17627,18910,17627,4.91374e+18,1419.83,6784.94,36537,552,404,32816,28835,19929,19243,23078
39247,988,2767,39247,0,32776,6471,3.32964e+18,1714.33,7921.9,39247,662,455,32450,28125,22953,22210,18233
27833,2548,2606,27833,0,23421,4412,3.33692e+18,1492.99,6503.67,27833,545,380,25227,25227,25224,25186,24650
8649,298,2126,7213,1436,4572,4077,7.22612e+17,498.37,3450.65,8649,273,217,6137,5266,3118,3402,1411
21173,65,2598,21173,0,17633,3540,3.16914e+18,1400.55,5858.01,21173,416,334,10956,6994,4937,4271,661
11595,125,351,0,11595,10963,632,2.73316e+16,201.349,1414.22,11595,100,98,11055,10838,9114,7954,6919
31939,17,43,30429,1510,31093,846,9.93304e+13,39.2215,810.129,31939,41,39,31353,30880,26044,25829,19579
6458,1435,1742,0,6458,0,6458,2.44111e+18,280.341,2747.35,6458,245,179,4716,4689,4419,4328,4288
29199,1819,2420,15133,14066,0,29199,4.99651e+18,1323.17,6289.99,29199,547,406,26779,24788,21280,20057,23633
21977,1332,1622,0,21977,7752,14225,9.45132e+15,945.287,4348.96,21977,420,290,20291,18541,17078,14963,19159
41179,49,353,0,41179,38972,2207,2.67135e+16,305.662,2659.68,41179,147,158,38459,36910,27020,23476,14875
44516,387,973,43452,1064,44516,0,4.57305e+18,622.216,4384.6,44516,305,244,42546,40873,28597,27155,21478
15979,554,734,15500,479,15979,0,4.3929e+18,438.191,2485.58,15979,240,168,15183,14889,13850,13749,12862
1702,35,38,1600,102,1701,1,1.15269e+14,20.9783,185.898,1702,24,23,1664,1660,1656,1656,1624
23719,8,44,22627,1092,23041,678,9.79511e+13,35.965,694.576,23719,39,37,22134,21125,17380,17276,11560
49640,9,43,47082,2558,48715,925,1.02741e+14,40.9697,1025.81,49640,43,43,46502,44448,35957,35900,23247
42453,207,354,0,42453,40504,1949,2.51192e+16,297.199,2609.77,42453,139,152,41504,40703,37063,33991,31047
5415,681,1290,3100,2315,0,5415,5.15773e+18,212.874,2096.26,5415,243,180,4125,3980,3463,3481,2345
36776,5,43,35055,1721,35792,984,9.90248e+13,39.3757,867.67,36776,42,40,31538,28359,24596,24855,16457
30545,1381,2248,16137,14408,0,30545,5.0218e+18,1349.38,6216.77,30545,504,369,27497,24222,17819,16055,19791
17954,350,2512,14913,3041,9291,8663,7.38285e+17,1261.31,5270.82,17954,451,321,12982,11144,6418,7155,3344
44517,791,2082,22247,22270,0,44517,5.09492e+18,1442.72,7392.09,44517,546,450,37964,33565,17477,16066,20378
18520,740,1868,0,18520,0,18520,2.50152e+18,1103.2,4621.07,18520,362,316,15351,13696,8608,7427,8108
45760,775,1719,16293,29467,0,45760,3.78971e+13,1139.09,6376.71,45760,523,381,41246,37624,25079,22833,28416
25495,16,43,24137,1358,25110,385,1.04752e+14,39.616,736.723,25495,41,40,24881,24406,19892,19719,15060
11766,1028,2286,9624,2142,5918,5848,7.8452e+17,915.025,4157.37,11766,340,248,9161,8191,6841,6719,5349
21993,121,719,21558,435,21993,0,4.61746e+18,472.223,2904.33,21993,223,195,18397,14108,7839,7080,4463
5819,1348,1698,5819,0,5005,814,3.3832e+18,209.977,2565.96,5819,211,157,4121,4120,4092,4029,2700
24572,2509,2527,24572,0,20365,4207,3.25024e+18,1505.33,6206.94,24572,491,357,22045,22045,22045,22045,22045
25254,1164,2183,13063,12191,0,25254,4.97503e+18,1314.53,5650.18,25254,478,348,22018,19658,13659,12746,14891
5634,101,1699,5634,0,4746,888,3.36104e+18,195.69,2544.64,5634,219,160,3290,2245,1633,1352,313
9416,833,2162,9416,0,7763,1653,3.09199e+18,712.948,3705.76,9416,299,238,7112,6192,4661,4492,3683
18399,722,2031,9371,9028,9371,9028,4.89743e+18,1157.37,4770.2,18399,387,316,15036,13371,7113,7207,6882
23306,1551,2328,19164,4142,11766,11540,7.75532e+17,1478.31,5945.22,23306,428,369,20137,17252,16705,16351,15920
10510,589,675,10422,88,10510,0,4.81915e+18,318.406,2004.71,10510,186,149,9835,9775,9665,9630,9486
21802,522,1640,7755,14047,0,21802,3.70998e+13,940.985,4341.75,21802,431,287,18698,17244,10922,9779,10408
37166,7,44,35086,2080,36782,384,1.0643e+14,41.5941,889.562,37166,43,42,33441,30971,25071,25117,15439
37757,33,356,0,37757,35995,1762,2.51096e+16,291.872,2465.21,37757,133,142,34862,33068,25256,21898,13607
39868,2080,2374,21114,18754,0,39868,5.00441e+18,1465.86,7155.32,39868,601,415,37494,37493,34559,33741,36138
47363,429,1956,0,47363,0,47363,2.52081e+18,1431.45,7509.84,47363,605,450,37906,32963,12888,10425,13866
11626,1652,1951,5771,5855,5771,5855,4.78831e+18,787.873,3743.93,11626,339,255,9675,9006,8453,8354,8872
27653,89,378,0,27653,26139,1514,2.71366e+16,304.634,2250.48,27653,131,135,26288,25634,19828,16892,12492
38426,83,1357,0,38426,13594,24832,9.91624e+15,1101.12,5557.37,38426,458,382,27812,22634,9772,7336,4296
7364,615,1409,0,7364,2625,4739,9.46901e+15,220.269,2432.46,7364,254,193,5955,5794,4098,4247,3986
36406,1176,1661,0,36406,12953,23453,9.98229e+15,1139.79,5766.53,36406,465,391,34217,31471,23745,19194,28906
41649,213,351,0,41649,39406,2243,2.67632e+16,304.705,2656.39,41649,148,157,40644,39689,35753,32196,30815
38830,1660,2323,20391,18439,20391,18439,4.91574e+18,1454.51,7040.2,38830,566,413,36308,31538,26142,24776,30934
11918,130,644,11730,188,11918,0,4.63307e+18,343.829,2094.03,11918,161,154,10068,7934,4529,4380,3354
3835,139,185,0,3835,3723,112,2.21717e+16,46.3413,583.373,3835,45,47,3650,3649,3589,3599,3386
9178,337,681,8833,345,9178,0,4.38656e+18,258.92,1826.56,9178,162,125,8482,8227,6324,6447,5652
16865,213,2158,0,16865,0,16865,2.51105e+18,1057.49,4759.34,16865,416,312,11929,9714,3349,2203,2283
13757,765,1521,4917,8840,0,13757,3.76554e+13,696.16,3365.52,13757,338,244,11900,11193,8275,8155,6692
1938,15,34,1860,78,1860,78,1.05009e+14,15.531,185.143,1938,19,19,1893,1880,1685,1682,1511
26128,2001,2138,21208,4920,12910,13218,7.99001e+17,1517.34,6141.11,26128,437,377,23990,22663,23097,23006,23843
4295,29,237,0,4295,4091,204,2.58536e+16,45.6703,725.396,4295,57,55,3900,3682,3006,2399,1408
17801,521,745,17378,423,17801,0,4.63478e+18,476.724,2652.79,17801,223,177,16957,16541,15721,15789,13476
47864,587,2895,39945,7919,25139,22725,7.27177e+17,1767.59,8787.15,47864,688,454,37646,32414,21307,21928,13053
32100,12,43,30654,1446,31129,971,9.72889e+13,37.7017,809.089,32100,41,39,30996,30230,24993,24527,17381
35314,193,2025,18028,17286,0,35314,5.04624e+18,1455.61,6556.03,35314,521,398,25779,21141,8748,7065,4262
45178,224,1763,21479,23699,0,45178,5.11639e+18,1451.64,7166.19,45178,522,450,33150,28178,9057,6785,7569
44440,2794,2841,44440,0,37105,7335,3.28078e+18,1741.39,8440.57,44440,677,459,41599,41599,41597,41578,41243
4613,250,962,0,4613,1603,3010,8.67979e+15,76.8628,1598.7,4613,179,118,3651,3531,2206,2493,1760
41041,4,43,39145,1896,39893,1148,9.87405e+13,39.3746,916.779,41041,42,40,33107,29185,26339,25835,16979
8336,2134,2148,6981,1355,4437,3899,7.17243e+17,433.171,3410.31,8336,296,214,6188,6130,6185,6188,6171
8787,916,1820,4661,4126,4661,4126,4.93688e+18,457.876,3151.07,8787,295,187,6967,6569,4956,4324,4248
2347,446,693,0,2347,0,2347,2.26056e+18,34.2356,1020.23,2347,129,86,1654,1653,1410,1404,1371
29896,1831,2237,15808,14088,15808,14088,4.93172e+18,1308.19,6119.47,29896,505,369,27659,27533,22902,22194,25177
39678,758,1961,0,39678,14051,25627,9.50535e+15,1118.99,6164.93,39678,555,384,35463,32516,20701,14256,17711
47307,62,358,0,47307,44601,2706,2.72865e+16,320.754,2887.5,47307,158,171,44387,42903,30897,26814,18514
41515,36,43,39605,1910,40320,1195,9.78165e+13,40.4644,925.336,41515,43,40,41421,41341,39515,39528,36992
37287,707,2524,30620,6667,18897,18390,7.69902e+17,1663.42,7585.21,37287,566,424,29637,25070,17815,17571,13035
9721,998,1734,3269,6452,0,9721,3.4837e+13,224.602,3124.15,9721,237,243,7987,7937,6361,6948,5755
36727,3290,3448,13582,23145,1229,35498,7.60312e+16,794.702,7742.53,36727,815,483,33279,33279,33222,32190,31479
32759,735,2550,16046,16713,16046,16713,4.94755e+18,1469.38,6987.4,32759,562,398,26866,23057,9772,11663,12729
43761,331,2822,43761,0,36710,7051,3.32367e+18,1739.17,8316.79,43761,684,458,32349,28120,17272,13037,8132
5334,14,43,5026,308,5319,15,1.08495e+14,27.5047,338.565,5334,30,28,5151,5017,4178,4067,3047
28616,1736,3245,27065,1551,26928,1688,7.07818e+17,94.3987,5050.83,28616,871,277,25371,25280,25221,25039,24200
34687,35,42,32905,1782,34053,634,1.02692e+14,39.1398,834.509,34687,40,39,34606,34561,32686,32724,31668
11998,971,2050,11998,0,9729,2269,2.96292e+18,1068.13,4164.92,11998,284,283,9156,8109,6548,6171,5844
35287,1625,2254,0,35287,0,35287,2.4596e+18,1385.45,6624.08,35287,537,403,32808,28662,24318,22384,27682
13893,1834,1987,6949,6944,6949,6944,4.88397e+18,938.49,4126.98,13893,368,293,11906,11538,11175,11079,11891
6783,39,1682,3241,3542,0,6783,5.1234e+18,339.873,2751.65,6783,244,213,3106,1722,760,657,218
40662,611,1352,0,40662,14313,26349,9.83892e+15,1103.7,5695.15,40662,477,381,35896,32657,20155,15176,22845
2886,17,43,2714,172,2881,5,1.0943e+14,24.9501,260.755,2886,28,27,2794,2733,2362,2334,1856
22937,100,354,0,22937,21826,1111,2.55031e+16,256.257,1940.69,22937,116,125,21992,21594,17610,15352,12529
7406,1029,1969,7406,0,5979,1427,2.90974e+18,473.319,3171.59,7406,223,227,5437,4967,4445,4084,3648
40213,318,1874,0,40213,14282,25931,9.52052e+15,1132.8,6051.16,40213,572,360,33941,31231,15264,9831,10583
7944,748,1816,0,7944,0,7944,2.44218e+18,290.803,2998.96,7944,245,184,6128,5801,4035,3839,2981
4863,236,496,4778,85,4863,0,4.71253e+18,214.44,1261.67,4863,118,109,4334,4078,3377,3366,2955
43880,12,42,41728,2152,42879,1001,1.00685e+14,39.7489,934.494,43880,42,40,42339,41268,33807,32971,23494
40433,581,2136,0,40433,0,40433,2.47001e+18,1419.3,7056.54,40433,551,417,33386,29306,13172,13036,12643
17976,667,1707,0,17976,0,17976,2.53388e+18,1181.93,4517.06,17976,359,318,14546,12605,6600,5535,6904
34677,392,2458,28554,6123,17615,17062,7.62507e+17,1677.42,7298.66,34677,546,413,25548,22188,12664,13618,6323
46336,5312,6369,22368,23968,22368,23968,4.60034e+18,1014.32,11834.2,46336,1040,565,39967,39944,37451,36823,36874
20154,721,808,19568,586,20154,0,4.56024e+18,461.322,2845.78,20154,216,174,19346,19331,19300,19305,19180
49352,2327,2496,0,49352,0,49352,2.43138e+18,1493.9,8011.57,49352,654,437,46856,46856,45270,44282,45698
23269,298,1645,0,23269,8255,15014,9.52902e+15,960.205,4500.92,23269,446,300,19424,17974,8616,6472,7323
20877,667,2389,12798,8079,8405,12472,2.86424e+14,225.948,4553.98,20877,778,255,18488,17862,13944,13373,13159
44218,364,1475,0,44218,15568,28650,9.79104e+15,1121.76,6070.12,44218,512,382,37511,34162,17269,12299,14095
4394,769,941,1512,2882,0,4394,3.3577e+13,73.2572,1556.97,4394,177,119,3453,3453,3367,3367,3418
22685,1825,2460,12511,10174,12511,10174,4.91477e+18,1108.02,5438.25,22685,460,325,20225,18349,16170,15622,16766
22779,450,1312,8034,14745,0,22779,3.86369e+13,970.341,4250.79,22779,373,318,19370,17618,9612,7336,8743
13474,1661,2022,7419,6055,7419,6055,5.00435e+18,778.905,3984.82,13474,315,277,11452,10687,9920,9671,10114
8467,967,1812,4315,4152,0,8467,4.91709e+18,396.531,3077.2,8467,315,221,6655,6423,4727,4523,3934
39308,816,2064,0,39308,0,39308,2.46745e+18,1488.56,6946.63,39308,540,421,33441,29675,16004,15662,17097
17070,117,350,0,17070,16279,791,2.51801e+16,227.222,1646.56,17070,107,112,16421,16139,13688,11767,9708
17158,42,720,16638,520,17158,0,4.66922e+18,452.384,2563.98,17158,213,172,10894,6875,4769,4332,1343
28411,1775,1787,0,28411,10074,18337,9.39764e+15,1016.36,5034.3,28411,489,316,26624,26624,26615,26622,26624
48523,578,1894,0,48523,17231,31292,9.53216e+15,1149.37,6630.28,48523,611,381,42700,39183,23624,15487,24870
23272,1000,2567,23272,0,18945,4327,2.93884e+18,1537.49,6288.89,23272,440,350,18551,16026,11360,10446,10235
33407,1512,2121,16825,16582,16825,16582,4.95207e+18,1370.97,6443.04,33407,483,398,30869,26765,21181,19922,26326
46989,2282,2555,38975,8014,24348,22641,7.45434e+17,1801.87,8492.21,46989,610,456,44434,44424,42130,41665,43620
2384,16,40,2234,150,2378,6,1.05553e+14,24.5193,226.25,2384,28,24,2295,2245,1818,1808,1381
4214,1170,1195,2004,2210,0,4214,4.96457e+18,155.292,1869.27,4214,180,153,3019,3019,3011,3012,3013
27094,32,43,25716,1378,26648,446,1.04138e+14,38.195,752.71,27094,40,39,26994,26920,25008,24968,22334
46864,1819,2687,24021,22843,0,46864,5.10089e+18,1385.83,8096.58,46864,571,450,44177,44015,29946,26950,33647
43901,739,867,42760,1141,43901,0,4.59258e+18,643.349,4239.42,43901,294,239,43016,42821,41453,41399,39485
24704,2168,2668,24704,0,20566,4138,3.07861e+18,1541.08,6409.43,24704,506,380,22036,21224,20943,21144,18955
8754,1047,1394,0,8754,3066,5688,9.39408e+15,346.715,2613.82,8754,296,184,7360,7186,6479,6479,5477
44071,40,43,42008,2063,42874,1197,9.88752e+13,39.2838,947.118,44071,42,41,44014,43983,43871,43870,42200
42426,775,2170,42426,0,34218,8208,3.00482e+18,1710.72,7869.75,42426,536,467,33988,28215,18539,16951,17826
13858,1291,1995,0,13858,0,13858,2.43699e+18,960.026,4151.01,13858,377,286,11628,10602,7748,7537,8682
29498,84,885,28654,844,29498,0,4.56262e+18,491.708,3456.67,29498,261,209,22797,16858,9999,9234,4060
1085,5,34,1028,57,1084,1,1.04808e+14,18.2018,145.718,1085,22,21,871,781,650,641,403
33234,1183,1753,0,33234,0,33234,2.54155e+18,1367.66,6147.57,33234,474,404,29716,25823,19042,16488,22603
32632,1245,2085,16680,15952,0,32632,5.06376e+18,1368.7,6354.29,32632,491,388,29306,25640,18702,16239,21790
42601,1,42,40231,2370,42155,446,1.06813e+14,39.9154,936.573,42601,42,41,13872,13872,13872,13872,13872
23039,114,2644,19322,3717,12201,10838,7.13088e+17,1380.75,6010.59,23039,475,357,14392,10090,6962,7553,1017
11298,14,43,10812,486,10905,393,9.49963e+13,26.7747,469.827,11298,33,32,11025,10831,9137,8934,7100
42882,181,349,0,42882,40743,2139,2.58962e+16,300.708,2659.53,42882,146,154,41726,40810,36252,32405,28907
46291,993,2159,37107,9184,22054,24237,8.40321e+17,1743.89,8217.02,46291,564,470,38390,32170,26725,25115,23895
23744,346,2049,23744,0,18915,4829,3.02624e+18,1519.63,5820.98,23744,422,385,16729,14066,6803,5816,4967
18818,3003,3291,8553,10265,0,18818,4.52398e+18,508.439,5864.89,18818,364,335,15527,15527,14774,14535,14490
13028,1160,1954,6539,6489,0,13028,4.92477e+18,908.874,3972.39,13028,360,274,10825,9916,6995,6642,7541
26874,74,1554,0,26874,9535,17339,9.61821e+15,1007.19,4769.15,26874,422,318,19702,16490,7977,4620,2315
40847,856,2436,40847,0,33787,7060,3.10247e+18,1773.56,7888.25,40847,577,452,33243,27924,21049,20001,17966
9889,201,654,9678,211,9889,0,4.6872e+18,303.219,1895.43,9889,156,140,8914,8152,5551,5568,3970
35984,361,373,0,35984,34282,1702,2.54878e+16,287.716,2453.65,35984,133,149,35611,35611,35489,35428,35170
35231,1311,1364,12426,22805,0,35231,3.84642e+13,1085.64,5348.9,35231,459,367,33867,33858,33556,33692,33552
10880,1745,1948,0,10880,0,10880,2.40715e+18,720.076,3625.81,10880,324,243,8932,8420,8417,8265,8687
24415,1541,1613,8636,15779,0,24415,3.69861e+13,999.3,4570.03,24415,454,301,22802,22801,22608,22464,22591
32518,2152,2268,17441,15077,17441,15077,4.92965e+18,1339.99,6368.01,32518,494,382,30250,30248,29637,29508,29305
895,324,353,0,895,0,895,2.57688e+18,94.781,521.129,895,88,81,542,542,531,532,536
41437,1355,1358,14662,26775,0,41437,3.88591e+13,1110.36,5759.55,41437,467,391,40079,40079,40069,40077,40077
42336,826,1912,15014,27322,0,42336,3.6987e+13,1151.58,6251.33,42336,597,366,38246,34888,23423,23500,21746
35568,2664,2909,35568,0,29521,6047,3.21179e+18,1605.06,7661.5,35568,593,415,32659,32659,32483,32527,32092
32707,467,2442,16924,15783,0,32707,5.04079e+18,1356.34,6624.05,32707,559,392,26423,23267,10041,10640,8313
42433,31,43,40426,2007,41368,1065,9.97732e+13,40.5488,934.85,42433,42,41,42261,42145,38879,38672,33580
17302,1067,1926,9029,8273,9029,8273,4.99732e+18,1020.47,4506.24,17302,342,308,14807,13402,9600,9334,9651
23908,777,1641,0,23908,8479,15429,9.54258e+15,978.576,4549.56,23908,451,303,21095,19564,13582,10358,14654
21812,1206,2144,11334,10478,0,21812,5.01148e+18,1149.6,5206.78,21812,443,337,19002,17083,12293,11347,13544
4551,164,1452,3584,967,2124,2427,8.9078e+17,188.505,2175.83,4551,178,148,2962,1815,1457,1535,501
42060,1420,2364,33811,8249,20057,22003,8.27241e+17,1739.79,8042.82,42060,548,453,37077,30865,27868,27326,27616
36802,613,854,35748,1054,36802,0,4.55191e+18,536.276,3834.84,36802,281,232,35916,34982,32932,33160,31132
33663,663,836,33067,596,33663,0,4.53282e+18,485.032,3690.91,33663,243,222,32827,32789,31090,31085,29365
20300,1501,1575,0,20300,7253,13047,9.66401e+15,923.409,4153.25,20300,380,287,18725,18708,18484,18276,18557
11118,333,356,0,11118,10498,620,2.702e+16,207.24,1392.81,11118,92,97,10762,10601,10586,10540,10497
42646,1824,2443,21620,21026,0,42646,5.05255e+18,1453.77,7641.07,42646,670,425,40166,35568,30769,28949,36062
43906,57,362,0,43906,41872,2034,2.52529e+16,301.465,2688.3,43906,146,154,41589,40364,31111,26956,19318
45099,42,43,42846,2253,44223,876,1.02619e+14,40.9959,973.928,45099,43,43,45050,45020,44924,44923,44333
32378,2,39,30878,1500,31447,931,9.81662e+13,36.1268,785.522,32378,38,36,20104,16497,15737,16798,12244
13800,1769,2060,7351,6449,7351,6449,4.93487e+18,788.749,4068.72,13800,368,283,11740,10946,10841,10461,10818
9723,930,2008,7913,1810,4881,4842,7.82205e+17,816.204,3656.83,9723,301,263,7480,6640,5031,5057,4701
37783,224,374,0,37783,36027,1756,2.4976e+16,287.834,2517.43,37783,137,143,36953,36261,33282,30647,29363
28657,1652,1709,10111,18546,0,28657,3.69733e+13,1058.7,5058.01,28657,486,325,26948,26948,26869,26928,26927
44535,842,865,43269,1266,44535,0,4.59589e+18,605.98,4259.53,44535,313,245,43670,43650,43564,43584,43400
11754,724,2105,11754,0,9543,2211,3.09803e+18,962.154,4086.99,11754,294,263,8867,7724,5606,5020,4135
6295,325,625,6084,211,6295,0,4.2801e+18,248.236,1517.34,6295,152,118,5670,5466,4626,4605,3606
44209,326,1859,0,44209,15688,28521,9.57202e+15,1130.31,6338.55,44209,592,366,37392,34253,16774,11160,13408
23547,1173,1467,8339,15208,0,23547,3.83112e+13,971.887,4434.09,23547,373,315,21811,19703,17271,15528,19848
5673,175,1470,3015,2658,3015,2658,4.84927e+18,228.744,2335.89,5673,223,165,4008,3547,1853,2030,547
2775,772,988,2775,0,2261,514,2.74282e+18,144.037,1448.16,2775,124,123,1787,1783,1775,1775,1649
27563,206,2629,27563,0,22853,4710,3.29676e+18,1553.22,6609.87,27563,528,376,18878,14602,8289,6436,2984
9775,1568,1630,4614,5161,4614,5161,5.00501e+18,707.124,3203.32,9775,280,259,8145,7574,7980,7886,7989
27524,1660,1731,9647,17877,0,27524,3.81135e+13,1099.4,5154,27524,495,331,25793,25793,25700,25750,25781
8040,581,2310,8040,0,6584,1456,2.93811e+18,472.949,3604.48,8040,267,208,5680,4726,3050,2841,2338
19643,419,1329,6955,12688,0,19643,3.88076e+13,925.266,3965.58,19643,350,299,16588,15150,7865,6972,7026
13234,30,43,12635,599,12813,421,9.73702e+13,34.0008,519.229,13234,34,33,13158,13127,12297,12278,11593
24220,1135,2182,19854,4366,12277,11943,7.72789e+17,1492.08,5921.79,24220,428,372,20264,17426,15076,14778,13660
2763,257,382,2762,1,2763,0,4.78704e+18,150.784,869.771,2763,87,86,2381,2339,2023,2026,1793
43275,2295,2477,22727,20548,22727,20548,4.88263e+18,1459.82,7518.79,43275,615,419,40798,40798,40478,40327,40783
30534,1003,1351,10791,19743,0,30534,3.86424e+13,1046.49,4959.31,30534,433,352,28299,25380,20415,17484,24100
28357,1946,2598,13362,14995,13362,14995,4.91315e+18,1382.33,6566.61,28357,569,380,25759,23516,17587,15750,23503
10213,142,2010,0,10213,0,10213,2.43693e+18,649.434,3581.42,10213,340,241,6994,5026,2563,1318,1110
30149,1537,1615,0,30149,10703,19446,9.65262e+15,1074.87,5125.76,30149,479,340,28534,28534,28286,28125,28519
3326,404,835,1214,2112,0,3326,4.01602e+13,148.93,1362.16,3326,145,134,2491,2409,1550,1828,1559
32918,831,871,31931,987,32918,0,4.50568e+18,522.404,3657.15,32918,271,215,32047,32047,31912,31875,31699
49593,1891,2121,49593,0,39598,9995,3.04372e+18,1764.79,8469.84,49593,555,490,47096,38149,45800,45934,44789
31186,9,31,30259,927,31179,7,9.53476e+13,29.2234,764.992,31186,31,31,29608,28644,23349,22584,17072
40368,41,43,38120,2248,40009,359,1.06509e+14,41.2775,932.599,40368,43,42,40313,40285,40190,40189,38580
20867,18,43,19938,929,20191,676,9.64737e+13,37.2379,647.225,20867,38,35,20545,20316,17381,17289,13610
18958,1238,1524,6770,12188,0,18958,3.7572e+13,848.368,3918.67,18958,353,283,17283,16010,14579,14986,15828
39437,2105,2156,20209,19228,20209,19228,4.96781e+18,1417.12,6989.5,39437,519,415,37281,37281,37223,37141,36946
21482,831,2376,17689,3793,10929,10553,7.61625e+17,1397.12,5710.69,21482,431,361,16971,14533,11150,11026,8798
21329,2011,2314,21329,0,17539,3790,3.11777e+18,1380.94,5636.21,21329,448,356,19015,16468,18582,18617,18307
45653,40,43,43541,2112,44387,1266,9.84515e+13,40.8795,970.194,45653,43,40,45592,45553,45449,45447,43944
4327,274,301,0,4327,4068,259,2.77773e+16,57.8655,812.75,4327,62,60,4026,4023,3985,3985,3869
15904,695,706,15616,288,15904,0,4.7065e+18,427.161,2480.8,15904,220,175,15198,15190,15166,15169,15143
38759,24,43,36934,1825,37702,1057,9.88096e+13,39.3623,892.871,38759,42,40,38444,38196,33965,33915,27136
40684,405,2732,34167,6517,21738,18946,7.11199e+17,1692.84,7958.03,40684,603,423,30776,27130,15954,17391,8728
40097,768,1656,14221,25876,0,40097,3.78319e+13,1115.81,5964.39,40097,487,365,35952,32725,21371,19508,24865
24284,1491,2199,11564,12720,0,24284,5.1421e+18,1375.71,5792.51,24284,450,352,21422,18835,14580,12961,17130
36289,225,1683,17054,19235,0,36289,5.14765e+18,1389.32,6339.57,36289,490,411,26444,22488,7196,5484,6003
39113,1057,1469,0,39113,13782,25331,9.7811e+15,1115.27,5725.83,39113,491,365,36573,32713,25811,19481,30587
40879,34,47,39585,1294,40864,15,1.10534e+14,29.4866,884.488,40879,33,37,40832,40824,40655,40683,36494
47701,543,916,46387,1314,47701,0,4.54749e+18,631.515,4447.34,47701,302,245,46431,44974,39492,38827,34972
45462,225,2026,22907,22555,0,45462,5.08481e+18,1517.85,7469.76,45462,541,445,33626,28885,11358,9288,6296
25010,2,42,23640,1370,24710,300,1.06276e+14,37.8515,712.672,25010,38,36,14695,11710,10989,11744,8636
18153,442,1430,6433,11720,0,18153,3.77158e+13,856.385,3855.6,18153,354,282,15413,14184,8151,7109,7445
41178,1209,2713,34663,6515,22018,19160,7.09438e+17,1826.49,8039.71,41178,611,428,35040,30391,27152,26699,23420
32426,1615,2053,0,32426,0,32426,2.49493e+18,1380.16,6330.52,32426,470,395,30216,26079,22979,21529,26681
14959,597,1982,7684,7275,7684,7275,4.91842e+18,970.059,4266.29,14959,362,292,11947,10758,5562,5694,4708
12903,1896,2159,10598,2305,6597,6306,7.69943e+17,1006.35,4297.37,12903,337,276,10744,9615,10038,9849,10043
17801,28,43,16874,927,17473,328,1.03018e+14,35.8933,605.649,17801,38,35,17684,17625,16027,16043,14485
17948,90,2415,17948,0,14864,3084,3.34286e+18,1343.01,5239.44,17948,450,320,10261,7051,4251,3307,854
27422,2389,2485,23068,4354,14716,12706,7.03181e+17,1503.72,6385.69,27422,488,374,24937,24937,24604,24550,24589
11124,1118,1802,3781,7343,0,11124,3.63004e+13,244.011,3274.52,11124,256,258,9322,9307,7194,7058,6904
40523,490,1779,0,40523,14346,26177,9.57079e+15,1134.11,6097.5,40523,537,369,34927,31924,17348,12320,17883
47624,13,43,45240,2384,46679,945,1.02149e+14,40.4137,998.623,47624,43,42,46072,45085,36721,36221,26363
43704,112,356,0,43704,41275,2429,2.73399e+16,310.201,2757.5,43704,152,164,41835,40847,32400,27867,22371
36029,1537,2385,18944,17085,18944,17085,4.89009e+18,1421.66,6830.67,36029,575,387,33163,28900,22641,21582,25531
48058,12,43,45363,2695,47552,506,1.06785e+14,40.7723,1011.89,48058,43,42,46072,44691,35935,35232,24800
533,110,235,235,298,235,298,4.55489e+18,48.5966,334.56,533,62,67,298,217,227,205,125
11623,1284,1868,6518,5105,0,11623,5.11963e+18,595.203,3524.32,11623,295,269,9755,9207,7955,7601,7651
30338,1613,1707,0,30338,10750,19588,9.52387e+15,1075.7,5200.68,30338,486,339,28631,28631,28125,27738,28516
29197,553,835,28302,895,29197,0,4.53003e+18,535.523,3436.39,29197,268,208,28190,27413,24927,25058,23003
12150,16,43,11605,545,11785,365,9.66053e+13,28.0043,487.054,12150,35,32,11913,11724,9968,9920,7798
42292,379,2454,34552,7740,21112,21180,7.82318e+17,1710.89,8068.29,42292,586,453,31023,26909,15209,16272,6749
36032,1620,2092,36032,0,28844,7188,3.03683e+18,1689.74,7215.15,36032,501,444,32605,26935,31310,31386,28552
24778,10,43,23683,1095,24014,764,9.72863e+13,36.2554,711.384,24778,39,37,23618,22793,18818,18465,13263
40191,1667,2149,32162,8029,19016,21175,8.42514e+17,1697.93,7656.87,40191,530,447,36666,30214,31166,29683,33425
25517,1873,2239,0,25517,0,25517,2.43202e+18,1233.01,5673.2,25517,457,340,23278,23243,20317,19701,21462
42605,650,982,41903,702,42605,0,4.59533e+18,528.633,4368.37,42605,272,252,41623,41414,37542,37326,35035
42087,1587,2368,22430,19657,22430,19657,4.94063e+18,1458.81,7319.21,42087,591,416,39259,34170,27171,26027,30685
24750,2187,2546,20818,3932,13314,11436,7.04394e+17,1385.25,6105.15,24750,497,347,22204,22156,20999,20632,21469
8394,628,1405,0,8394,2989,5405,9.59939e+15,240.843,2542.48,8394,219,178,6989,6746,5176,4016,4790
11936,984,1907,0,11936,0,11936,2.45863e+18,716.809,3638.94,11936,312,258,9994,9150,7092,6485,6536
39664,2641,2752,39664,0,33028,6636,3.28364e+18,1713.91,7936.14,39664,647,446,36912,36912,36908,36888,36579
2398,58,354,2398,0,2398,0,4.72828e+18,148.517,790.162,2398,79,82,1499,855,613,602,384
5273,757,1253,0,5273,0,5273,2.5002e+18,216.028,2048.84,5273,240,180,4020,3896,3482,3458,2483
14039,1171,1392,4977,9062,0,14039,3.787e+13,722.062,3348.9,14039,317,260,12570,11698,10852,9987,11783
40165,1800,2162,20474,19691,0,40165,5.02582e+18,1414.21,7050.5,40165,560,410,38003,37877,31949,30733,36660
27278,1439,2904,0,27278,9317,17961,9.37463e+15,565.094,6163.21,27278,360,402,24374,24235,19217,19036,17934
12238,1167,1496,0,12238,4282,7956,9.38407e+15,665.999,3220.64,12238,333,232,10742,10064,9046,8766,9101
45216,218,1787,21558,23658,21558,23658,5.01489e+18,1446.44,7205.73,45216,525,451,32960,28031,8624,8809,5108
12867,245,1877,7045,5822,7045,5822,5.02052e+18,772.015,3781.72,12867,339,273,9821,8732,4414,4185,2334
8889,261,1354,3187,5702,0,8889,3.93639e+13,491.802,2680.59,8889,232,239,7100,6612,3443,2601,2655
7058,41,43,6735,323,6847,211,9.97409e+13,29.5793,384.909,7058,32,29,7015,7013,7010,7009,6991
47068,363,2902,47068,0,39278,7790,3.28044e+18,1776.12,8756.37,47068,702,467,34856,30304,17860,13685,7375
34558,14,356,0,34558,33016,1542,2.49214e+16,277.164,2337.25,34558,131,141,29405,26615,21451,19229,11819
10974,451,602,10774,200,10974,0,4.65051e+18,346.161,1965.99,10974,166,152,10370,10187,9348,9373,8717
2055,125,375,0,2055,791,1264,1.03304e+16,60.2925,632.108,2055,120,69,1680,1643,1235,479,253
42184,654,2444,21827,20357,21827,20357,4.88243e+18,1485.18,7443.13,42184,605,425,35086,30952,14382,16960,16295
43286,16,43,41096,2190,42437,849,1.02587e+14,40.4507,953,43286,43,42,42305,41532,33968,33791,25495
8065,590,673,7839,226,8065,0,4.60448e+18,262.191,1738.48,8065,193,116,7392,7376,7266,7277,7048
40285,989,1371,0,40285,14241,26044,9.95854e+15,1108.33,5713.78,40285,482,383,37475,33553,26032,20403,29302
49849,1146,2564,26771,23078,26771,23078,4.92726e+18,1492.91,8065.04,49849,672,439,44473,39582,24470,26095,28686
19376,1453,2481,19376,0,16226,3150,3.19544e+18,1363.37,5480.57,19376,404,325,16347,14328,14291,13716,10208
8665,1453,1940,0,8665,0,8665,2.41459e+18,445.952,3246.99,8665,306,224,6725,6524,5658,5692,5733
38241,561,1771,0,38241,0,38241,2.54115e+18,1423.16,6633.8,38241,508,423,31167,26886,12360,10269,14079
40378,133,3131,34084,6294,21700,18678,6.92708e+17,1704.7,8180.61,40378,730,417,26625,18764,13355,14380,2428
48833,29,42,46227,2606,48062,771,1.04018e+14,40.2145,995.282,48833,42,42,48597,48427,43179,43219,38637
48548,231,359,0,48548,46365,2183,2.4992e+16,305.127,2779.49,48548,147,156,47606,46715,43186,39831,38767
5487,1238,1520,0,5487,0,5487,2.52335e+18,245.369,2414.63,5487,206,179,3967,3912,3557,3527,3449
20556,753,2059,0,20556,0,20556,2.45578e+18,1116.21,4945.4,20556,415,316,17139,15303,9502,9073,7954
35713,527,1775,0,35713,12709,23004,9.54571e+15,1073.13,5600.4,35713,528,343,31113,28560,17769,11766,17781
30993,270,355,0,30993,29552,1441,2.52957e+16,281.11,2235.3,30993,127,135,30417,29865,27953,26515,25276
9395,373,2152,7684,1711,4172,5223,8.46028e+17,414.889,3666.77,9395,256,246,6839,5730,4156,3098,1240
16129,1170,1544,5729,10400,0,16129,3.711e+13,768.257,3667.94,16129,358,258,14431,13493,12092,12272,12500
36203,1755,2423,29837,6366,18465,17738,7.60754e+17,1729.69,7423.81,36203,555,424,32867,27659,27400,26923,29061
29420,238,1530,10454,18966,0,29420,3.80507e+13,1039.85,5008.03,29420,415,339,24175,22180,10346,6883,6776
23534,2103,2474,23534,0,19652,3882,3.1538e+18,1458.66,5989.47,23534,447,374,21060,18326,20618,20642,19107
21945,1751,2134,0,21945,0,21945,2.4218e+18,1179.69,5215.09,21945,463,330,19811,17626,16394,15965,18243
36621,284,890,35644,977,36621,0,4.58038e+18,567.996,3879.48,36621,281,224,34324,32439,21444,19548,14877
30227,1232,1343,0,30227,10653,19574,9.86907e+15,1054.87,4922.95,30227,421,344,28746,25386,26233,23997,27485
964,269,478,964,0,703,261,2.72778e+18,41.2573,617.704,964,65,70,486,486,463,466,406
13193,1,43,12593,600,12773,420,9.6222e+13,33.4168,511.726,13193,34,32,4925,4925,4925,4925,4925
48533,748,1881,0,48533,17232,31301,9.59541e+15,1134.7,6623.19,48533,606,383,43680,39973,26111,18415,28920
46464,225,846,45117,1347,46464,0,4.58063e+18,606.646,4317.05,46464,312,243,42812,39500,23380,21524,15676
8262,445,1681,3959,4303,0,8262,5.23709e+18,630.669,3060.3,8262,257,231,6195,5455,2553,2235,2425
4478,717,1646,4478,0,3586,892,3.30304e+18,218.91,2359.07,4478,211,179,2832,2665,2229,2080,1629
47182,145,358,0,47182,45004,2178,2.52971e+16,300.015,2766.38,47182,146,158,45779,44925,38652,33399,28863
9454,109,1825,4854,4600,4854,4600,4.86046e+18,607.971,3288.16,9454,304,209,6248,4716,2333,2404,681
19595,3,43,18592,1003,19222,373,1.02808e+14,36.8011,637.611,19595,39,36,14125,11976,10914,11045,7582
3677,819,1076,1879,1798,0,3677,5.60975e+18,198.918,1692.9,3677,149,147,2601,2595,2547,2538,2325
615,99,325,516,99,316,299,7.9666e+17,81.1317,427.306,615,74,74,250,102,139,170,148
39261,565,2481,20762,18499,20762,18499,4.91322e+18,1401.55,7166.43,39261,593,411,32392,28856,13268,15391,13192
48960,1824,2997,48960,0,40968,7992,3.33162e+18,1781.15,8955,48960,702,462,45091,37978,43041,39943,39183
40157,16,43,38324,1833,39003,1154,9.82295e+13,39.0476,906.762,40157,42,40,39346,38703,32138,32043,25284
1628,2,15,1621,7,1445,183,6.15515e+13,14.0682,117.219,1628,14,13,1168,1020,1105,1067,889
38848,39,42,36785,2063,38218,630,1.03539e+14,39.1307,882.691,38848,42,40,38791,38761,38651,38650,37860
45032,988,2004,0,45032,0,45032,2.49054e+18,1498.96,7400.93,45032,556,444,39455,34604,20554,18099,25534
26258,20,42,24755,1503,25993,265,1.0725e+14,39.5501,737.49,26258,40,38,25875,25577,21501,21189,16665
18694,643,2398,18694,0,15622,3072,3.2981e+18,1231.82,5241.72,18694,410,330,14523,12777,9235,7770,6207
37372,26,43,35358,2014,36809,563,1.04013e+14,39.7639,888.695,37372,42,41,37102,36921,32607,32682,28268
27359,794,1841,13462,13897,0,27359,5.10206e+18,1327.98,5674.08,27359,458,379,22987,20433,11410,9995,12611
47859,1316,2562,25239,22620,25239,22620,4.89514e+18,1497.77,7954.62,47859,669,444,43454,38069,25736,26570,30071
21495,795,1672,10213,11282,10213,11282,5.06819e+18,1229.86,4881.7,21495,369,340,17984,15861,9546,8603,10177
13556,7,43,12934,622,13186,370,9.93346e+13,34.1881,523.148,13556,35,33,12429,11685,9700,9692,6023
47966,431,1694,0,47966,16978,30988,9.63412e+15,1185.8,6493.77,47966,552,383,41099,37671,19357,13810,16901
15986,1805,2087,6987,8999,0,15986,3.60423e+18,400.412,4115.44,15986,531,236,13899,13896,12852,12609,13622
8734,79,2273,8734,0,7290,1444,3.40466e+18,547.527,3628.08,8734,355,210,4746,3210,2079,1969,444
42336,893,916,41275,1061,42336,0,4.60652e+18,616.234,4202.77,42336,323,237,41420,41402,41385,41384,41146
13309,327,1489,4748,8561,0,13309,3.73673e+13,689.134,3308.75,13309,326,256,11067,10180,5858,5240,3754
32519,139,2234,16916,15603,16916,15603,4.89663e+18,1358.46,6380.15,32519,528,379,23183,17574,8606,8933,3010
37011,35,1740,13137,23874,0,37011,3.75765e+13,1105.45,5753.89,37011,501,359,23471,18398,10254,2924,2050
2426,44,958,2426,0,1991,435,3.02221e+18,132.128,1367.61,2426,115,121,901,425,310,297,145
26452,214,1323,0,26452,9340,17112,9.8336e+15,1006.12,4571.18,26452,396,329,21458,19559,8243,6574,6344
5905,253,1283,0,5905,2052,3853,9.40939e+15,173.456,2144.22,5905,232,163,4622,4322,1794,1938,1411
28446,1264,2232,14818,13628,0,28446,4.96754e+18,1343.47,6008.54,28446,506,362,25257,22316,15739,14504,17456
18605,1328,1518,0,18605,6653,11952,9.65178e+15,846.684,3884.86,18605,383,272,17029,15800,15319,14002,16122
10727,1702,2294,10727,0,8903,1824,3.30493e+18,805.018,3998.98,10727,359,257,8433,7805,8269,7964,7230
48237,1407,2023,23756,24481,0,48237,5.1067e+18,1491.58,7693.64,48237,564,458,44761,38425,29770,26411,35390
9244,86,1351,0,9244,3281,5963,9.95155e+15,469.784,2702.03,9244,239,234,6732,5412,2595,1865,1468
13047,348,1970,0,13047,0,13047,2.46767e+18,843.678,3948.68,13047,326,280,10043,9119,4084,2509,3079
34699,547,2499,34699,0,28409,6290,3.12179e+18,1643.98,7330.62,34699,543,429,26677,22852,12794,11141,9275
26921,649,806,26210,711,26921,0,4.56648e+18,480.425,3249.37,26921,244,207,26115,26075,25291,25195,24326
23633,631,694,23344,289,23633,0,4.69739e+18,450.019,2974.23,23633,220,202,22939,22922,22654,22646,22681
47285,24,43,44849,2436,46397,888,1.02637e+14,40.6718,994.863,47285,43,42,46863,46535,40974,40919,34450
26281,637,1460,0,26281,9338,16943,9.80447e+15,1021.43,4718.6,26281,397,329,22965,21069,13237,9980,13547
6399,324,341,0,6399,6064,335,2.56746e+16,70.6123,1023.89,6399,74,77,6058,6058,6055,6058,5986
34995,46,353,0,34995,33331,1664,2.55348e+16,299.043,2396.35,34995,133,139,32852,31467,24193,20786,14127
38152,1290,2579,38152,0,31319,6833,3.1418e+18,1694.89,7748.94,38152,557,445,32859,28092,25651,24371,21417
6346,1428,1587,3253,3093,3253,3093,5.12185e+18,227.771,2617.48,6346,212,168,4759,4758,4747,4750,4352
12502,46,347,0,12502,11922,580,2.57753e+16,180.635,1405.79,12502,91,97,11730,11243,8889,7558,5269
7909,2,44,7464,445,7835,74,1.06127e+14,35.4191,413.207,7909,33,30,4593,3636,3419,3658,2726
7443,928,1322,0,7443,2660,4783,9.66867e+15,219.348,2387.32,7443,263,166,6121,6079,5522,4044,4192
9008,1209,1665,4252,4756,0,9008,5.19688e+18,701.791,3160.37,9008,260,249,7343,6704,5793,5503,6098
18430,214,1999,9927,8503,9927,8503,4.91082e+18,1062.45,4631.24,18430,404,296,13809,12093,5631,6136,3150
21677,2174,2472,21677,0,17922,3755,3.26463e+18,1478.47,5802.59,21677,489,358,19205,18744,18883,18946,18549
17748,945,2099,0,17748,0,17748,2.47929e+18,1061.18,4719.1,17748,375,311,14947,13423,8148,7573,8889
26561,6,43,25124,1437,26178,383,1.04596e+14,39.3951,749.809,26561,41,40,23312,21250,17372,17630,11851
48460,714,1916,0,48460,17191,31269,9.50877e+15,1166.51,6675,48460,629,382,43345,39598,25426,16860,29767
15822,24,2037,15822,0,12648,3174,2.93361e+18,1259.96,4719.08,15822,333,306,5019,1951,1408,1627,275
16960,367,1547,0,16960,6070,10890,9.62523e+15,853.436,3780.42,16960,342,271,14233,13119,7626,5630,5078
44577,1174,1981,22056,22521,0,44577,5.04125e+18,1489.27,7329.2,44577,563,442,40128,34923,24152,20863,29010
11635,1300,1669,5613,6022,5613,6022,5.09197e+18,854.272,3580.26,11635,287,268,9872,8965,7701,7396,8653
12265,950,1701,5849,6416,5849,6416,5.04317e+18,892.132,3703.38,12265,309,274,10019,9194,6211,6149,7243
17365,7,42,16435,930,17190,175,1.05799e+14,36.3677,594.902,17365,36,34,15698,14602,11835,11919,7770
17822,261,348,0,17822,16991,831,2.53144e+16,237.956,1686.87,17822,108,115,17392,17118,16064,15567,14438
3489,644,777,1272,2217,44,3445,2.32329e+13,129.716,1357.71,3489,138,211,2712,2711,2643,2708,2603
4671,1153,1389,0,4671,0,4671,2.49415e+18,201.479,2146.02,4671,204,147,3282,3280,3003,2936,3001
27565,1217,1580,9832,17733,0,27565,3.88173e+13,968.728,4948.52,27565,383,345,25815,23284,19706,19428,21727
44453,1490,2386,44453,0,36212,8241,3.0212e+18,1803.48,8275.5,44453,568,462,39468,32931,37351,35969,30385
48117,23,43,45392,2725,47606,511,1.0663e+14,41.1824,1014.94,48117,43,42,47601,47184,40201,40029,33387
13114,113,350,0,13114,12454,660,2.61109e+16,218.571,1477.73,13114,99,103,12533,12313,10229,8840,7276
39556,1046,1773,18700,20856,18700,20856,4.99136e+18,1414.36,6725.46,39556,510,431,34871,30544,20840,19309,26271
34925,1495,1850,0,34925,12370,22555,9.46899e+15,1101.1,5669.84,34925,546,348,33075,33030,28959,26481,32293
47816,989,1518,16890,30926,0,47816,3.8142e+13,1142.04,6351.22,47816,536,399,44427,40042,30410,26305,34403
16809,42,161,0,16809,15998,811,2.34491e+16,129.955,1216.79,16809,93,95,15580,14735,11956,10719,8345
23627,1030,1661,8385,15242,0,23627,3.71297e+13,963.235,4527.13,23627,460,292,21294,19711,15254,15839,17070
36222,1897,2381,17358,18864,0,36222,5.11015e+18,1528.16,7163.08,36222,555,421,33788,29930,26620,25444,33204
8319,1294,2129,6903,1416,4341,3978,7.38839e+17,451.95,3392.75,8319,272,200,6190,5914,5181,5196,4666
35617,1188,2756,29861,5756,18910,16707,7.13151e+17,1645.35,7501.97,35617,600,409,30322,26285,23447,22849,17320
1018,120,240,1018,0,1018,0,4.74306e+18,97.0796,447.835,1018,55,56,760,542,487,491,418
39237,623,852,38375,862,39237,0,4.65405e+18,549.554,3978.56,39237,264,234,38341,37637,35297,35439,33863
38133,1602,2083,19291,18842,19291,18842,4.93426e+18,1434.06,6836.9,38133,527,415,35821,30835,26638,25433,31418
28821,792,1861,0,28821,0,28821,2.48146e+18,1327.79,5830.2,28821,459,377,24375,21642,11831,10232,13319
8044,285,353,0,8044,7567,477,2.73576e+16,134,1163.98,8044,75,84,7691,7623,7370,7213,7065
28963,456,2601,24045,4918,14971,13992,7.39759e+17,1556.75,6783.51,28963,459,383,21981,18812,11363,11990,6778
34386,1223,1594,12164,22222,0,34386,3.78035e+13,1078.64,5447.28,34386,459,356,32549,29017,24770,25918,29428
42464,3,43,40147,2317,41849,615,1.04221e+14,40.2245,944.366,42464,43,42,30329,25525,23088,23544,15960
19689,830,2096,10229,9460,10229,9460,4.84478e+18,1147.44,4920.47,19689,439,316,16401,14846,9170,9067,8977
25566,2239,2489,25566,0,21387,4179,3.32604e+18,1508.61,6224.68,25566,507,374,23077,22949,22756,22789,22429
17590,30,43,16741,849,17166,424,1.00717e+14,38.6791,606.715,17590,39,36,17488,17435,16004,16018,14509
35806,648,2345,0,35806,0,35806,2.4224e+18,1394.02,6759.69,35806,552,389,29779,26363,12403,12188,12835
21655,756,1637,7730,13925,0,21655,3.72801e+13,946.487,4309.74,21655,444,292,19087,17678,12496,12211,9722
8798,1133,1342,0,8798,3076,5722,9.40798e+15,395.808,2615.88,8798,281,194,7456,7199,6691,6675,6471
42831,1238,2899,42831,0,35623,7208,3.27456e+18,1747.36,8389.66,42831,643,452,36723,31405,30406,28993,21974
10840,779,2195,10840,0,9171,1669,3.29361e+18,669.977,3814.3,10840,313,257,8418,7525,6132,5618,3599
12788,271,347,0,12788,12066,722,2.75373e+16,209.396,1470.52,12788,103,112,12376,12180,11394,10950,10469
3559,883,1051,3117,442,2141,1418,5.81781e+17,103.549,1606.08,3559,179,143,2508,2506,2450,2448,1526
3461,255,1291,2865,596,1726,1735,7.78642e+17,221.218,1843.98,3461,170,156,2095,1714,900,1086,173
28221,19,42,26851,1370,27519,702,9.94406e+13,37.881,746.912,28221,38,36,27824,27522,23622,23406,19626
11871,1431,1874,0,11871,0,11871,2.45421e+18,738.412,3624.54,11871,321,260,9997,9317,8339,7145,8210
10531,1372,1461,0,10531,3788,6743,9.74217e+15,478.468,2889.37,10531,261,237,9070,8743,8757,8362,8804
10049,1278,1325,0,10049,3601,6448,1.01008e+16,575.952,2821.99,10049,242,240,8724,8253,8648,8409,8641
31711,1565,2623,26384,5327,16539,15172,7.33622e+17,1615.86,7028.28,31711,575,391,27841,23893,22753,22985,19783
5133,35,42,4847,286,5069,64,1.08302e+14,28.021,329.226,5133,31,29,5090,5084,5062,5065,4959
16866,1520,2296,13978,2888,8686,8180,7.58227e+17,1281.23,5016.24,16866,383,333,14113,12385,11666,11621,10685
2635,1061,1176,2635,0,2108,527,2.76503e+18,117.879,1573.97,2635,183,133,1459,1458,1458,1459,1418
27282,2219,2544,0,27282,0,27282,2.47847e+18,1324.48,6285.01,27282,543,359,24738,24686,22925,21778,23655
14867,111,1443,5258,9609,0,14867,3.77199e+13,771.887,3517.68,14867,332,263,11415,9875,4720,1765,1963
44299,1116,2862,44299,0,36905,7394,3.28178e+18,1773.79,8489.68,44299,692,455,37330,32063,29022,27294,19775
32619,1167,1819,11578,21041,0,32619,3.72898e+13,1083.86,5476.14,32619,517,335,30233,27453,21424,21459,25197
37196,805,1570,0,37196,13178,24018,9.71387e+15,1098.31,5657.19,37196,455,360,33600,30527,20988,15652,24540
26833,1043,2605,22377,4456,13992,12841,7.31452e+17,1545.34,6501.36,26833,492,382,22089,19216,16396,15847,11141
8685,512,664,8470,215,8685,0,4.60777e+18,286.487,1802.03,8685,155,130,8021,7951,7762,7795,6640
26659,366,775,26142,517,26659,0,4.67904e+18,476.143,3237.39,26659,239,211,25358,24474,19447,18969,15623
11266,21,43,10808,458,10855,411,9.44916e+13,33.415,479.364,11266,34,32,11130,11032,9752,9685,8685
23061,1032,1812,8185,14876,0,23061,3.70822e+13,942.567,4651.04,23061,441,298,20728,19116,15124,14178,17661
44156,1129,1953,0,44156,15728,28428,9.58199e+15,1134.26,6366.48,44156,619,379,41243,37505,28062,21469,35559
30631,1036,1522,0,30631,10861,19770,9.78647e+15,1045.28,5100.62,30631,415,347,28293,25604,20156,15814,23844
49770,208,785,48881,889,49770,0,4.59308e+18,563.546,4416.66,49770,278,260,45689,41360,21156,21909,16407
18394,1165,2040,10079,8315,0,18394,5.08659e+18,1006.12,4644.57,18394,368,301,15880,14476,11413,10292,10773
24787,1330,2102,13245,11542,0,24787,5.04588e+18,1243.14,5481.17,24787,450,338,21965,19595,15093,13651,15741
20563,487,816,19932,631,20563,0,4.51689e+18,440.685,2850.63,20563,272,187,19671,19143,16687,16796,15032
31922,309,351,0,31922,30185,1737,2.68417e+16,288.587,2326.67,31922,132,143,31466,30714,30012,28393,29235
31298,1308,2232,25237,6061,15171,16127,8.13338e+17,1609.33,6808.86,31298,498,406,26995,22902,21034,20650,19722
11967,1301,1904,0,11967,0,11967,2.44515e+18,808.273,3780.51,11967,325,241,10063,9116,7471,7306,7972
37680,40,43,35942,1738,36627,1053,9.81356e+13,39.984,878.107,37680,42,39,37624,37595,37508,37506,36424
27656,193,1594,0,27656,9800,17856,9.56926e+15,1009.39,4840.29,27656,456,318,22534,20690,9903,6162,4978
40369,2472,2636,32960,7409,19685,20684,8.12326e+17,1824.89,8175.82,40369,555,471,37733,37698,37335,37288,37612
37310,695,2365,19580,17730,0,37310,4.99955e+18,1430.24,6933.36,37310,582,397,31195,27482,13762,14363,13335
12729,320,1969,0,12729,0,12729,2.40177e+18,856.109,3915.29,12729,345,256,9657,8532,3517,2221,2310
24049,1434,2327,19727,4322,12114,11935,7.76163e+17,1549.61,6018.94,24049,475,374,20596,17696,16483,16514,15249
41599,1524,1623,14707,26892,0,41599,3.78942e+13,1111.81,6015.74,41599,489,371,39976,39976,39371,39456,39803
12267,1364,1524,0,12267,4348,7919,9.56184e+15,663.808,3230.78,12267,327,244,10743,10153,9915,9243,10519
41531,354,1587,14696,26835,0,41531,3.79935e+13,1117.93,5995.73,41531,501,380,35149,32071,15829,12219,10867
19809,551,2005,10616,9193,0,19809,5.099e+18,1101.65,4821.39,19809,398,320,16130,14497,8517,7797,7118
33948,1099,2669,28480,5468,18084,15864,7.12218e+17,1596.22,7236.85,33948,579,391,28627,24797,21558,20981,18556
3443,971,1128,1577,1866,0,3443,4.47223e+18,104.027,1683.85,3443,183,124,2315,2315,2290,2286,2303
27869,10,42,26530,1339,27201,668,1.0007e+14,39.4231,747.516,27869,40,38,26537,25601,21162,20555,13553
13701,1118,1462,4849,8852,0,13701,3.71928e+13,658.204,3284.97,13701,348,253,12239,11476,10029,9754,11284
9945,2117,2163,8323,1622,5243,4702,7.22435e+17,677.702,3710.96,9945,328,255,7782,7442,7719,7713,7440
12585,908,1476,4491,8094,0,12585,3.73375e+13,579.405,3126.84,12585,331,237,11109,10466,8821,8562,9308
13370,1204,1968,0,13370,0,13370,2.41767e+18,932.434,4032.39,13370,374,282,11152,10210,7211,6821,7822
12515,578,1896,6800,5715,6800,5715,4.90441e+18,738.918,3727.03,12515,351,248,10085,9228,5404,5688,4503
9015,26,42,8518,497,8928,87,1.03411e+14,28.7984,421.263,9015,32,31,8945,8905,8195,8183,7776
31136,213,2239,16313,14823,16313,14823,4.91121e+18,1353.34,6263.26,31136,514,373,23319,19966,8651,9406,4189
37312,24,378,0,37312,35357,1955,2.68652e+16,310.95,2611.58,37312,143,153,32898,30336,23012,19490,11494
49711,2077,2924,49711,0,41438,8273,3.26794e+18,1791.46,9007.68,49711,728,473,46753,39155,44689,43912,42693
1898,144,601,687,1211,0,1898,3.89343e+13,84.8714,926.31,1898,135,107,1297,1101,598,393,430
8573,797,1714,4406,4167,0,8573,5.08625e+18,450.248,3032.28,8573,271,256,6859,6392,3891,3557,4299
24886,2599,2859,12490,12396,12490,12396,4.84028e+18,1057.52,6288.33,24886,437,356,22027,22027,21666,21605,21479
38049,40,43,36156,1893,37247,802,1.01793e+14,39.87,892.926,38049,43,40,37991,37956,37859,37857,36353
6420,273,1510,3814,2606,0,6420,5.17184e+18,223.328,2433.65,6420,261,156,4831,4377,2299,1367,638
48548,26,43,46250,2298,47282,1266,9.89931e+13,40.3252,997.362,48548,43,41,48236,48039,43042,43154,37251
3882,872,1104,1835,2047,1835,2047,4.80404e+18,139.745,1738.67,3882,185,145,2778,2777,2470,2413,2407
32609,1772,2315,17209,15400,0,32609,5.00442e+18,1370.09,6440.43,32609,549,382,30294,26564,23499,22385,26672
7590,267,348,0,7590,7191,399,2.75225e+16,98.2029,1117.44,7590,83,85,7242,7207,6868,6914,6316
30010,20,1349,0,30010,10612,19398,9.89584e+15,1042.95,4917.05,30010,427,349,15006,9941,5484,4031,1345
9804,153,1813,4552,5252,4552,5252,4.85415e+18,631.186,3375.24,9804,301,242,6628,5046,1786,2077,897
37610,474,857,36647,963,37610,0,4.59441e+18,565.337,3905.08,37610,276,225,36237,35097,29490,28989,24093
14020,901,1528,0,14020,4996,9024,9.4769e+15,731.985,3413.18,14020,337,256,12234,11516,9444,7639,10125
43187,190,2430,23074,20113,0,43187,4.98782e+18,1457.2,7427.82,43187,626,418,32242,27024,12185,9260,3103
42354,1644,1958,0,42354,0,42354,2.49859e+18,1447.02,7142.11,42354,558,435,40276,35894,32748,30900,38839
18267,66,2039,18267,0,14684,3583,3.0297e+18,1350.24,5088.47,18267,355,331,8626,4607,2880,2778,824
47294,1730,2506,0,47294,0,47294,2.44412e+18,1492.16,7883.4,47294,642,435,44723,38629,31583,28558,38050
47688,7093,9653,36521,11167,19725,27963,1.09466e+18,1027.95,15895.2,47688,1092,824,38035,38031,34857,34109,32348
11088,332,582,11020,68,11088,0,4.79508e+18,334.001,1962.48,11088,157,150,10381,10103,8067,8066,7215
23935,116,350,0,23935,22815,1120,2.53128e+16,262.431,1953.47,23935,119,120,23062,22678,19044,16815,13124
15593,29,43,14698,895,15440,153,1.06774e+14,39.9567,581.203,15593,38,36,15473,15406,13692,13711,11998
47469,42,44,45202,2267,46274,1195,9.95178e+13,41.7643,986.356,47469,43,42,47417,47386,47279,47277,46175
39543,65,351,0,39543,37466,2077,2.66397e+16,302.258,2578.05,39543,141,159,37372,36385,27137,23525,15926
43455,336,788,42588,867,43455,0,4.57837e+18,543.182,4110.85,43455,282,245,41449,39809,23827,23167,22453
38606,727,850,37551,1055,38606,0,4.56293e+18,583.602,3952.59,38606,264,231,37756,37660,36730,36763,36230
26240,1576,1621,0,26240,9272,16968,9.46643e+15,992.4,4713.83,26240,467,303,24619,24619,24476,24474,24505
37786,1299,2157,37786,0,30189,7597,2.94858e+18,1692.33,7437.16,37786,489,445,32507,27390,27190,26348,24710
16685,1580,1986,0,16685,0,16685,2.43231e+18,952.214,4395.87,16685,348,293,14608,13345,12314,11905,12712
47029,906,2142,23509,23520,0,47029,5.0506e+18,1453.65,7637.1,47029,564,445,40715,35868,19881,17667,25499
6383,1165,1681,0,6383,0,6383,2.49722e+18,289.726,2678.16,6383,226,177,4702,4641,3701,3489,3596
24847,1878,2118,0,24847,0,24847,2.46012e+18,1266.85,5516.28,24847,455,345,22729,22630,20314,19757,21741
12652,709,1798,6317,6335,6317,6335,4.89619e+18,861.82,3803.35,12652,319,274,10149,9176,5004,4865,5553
42087,198,1685,14949,27138,0,42087,3.76863e+13,1128.05,6083.83,42087,519,377,34207,31191,14108,10140,8026
2240,356,766,1162,1078,0,2240,5.53144e+18,92.2656,1167.76,2240,115,111,1474,1474,1325,1332,920
17212,194,2095,9488,7724,0,17212,4.99387e+18,938.348,4518.6,17212,389,293,12900,10993,5625,4779,2907
5661,540,1329,3209,2452,3209,2452,5.0234e+18,215.657,2189.9,5661,246,186,4332,4149,3384,3323,2152
12184,741,2012,9766,2418,5794,6390,8.39994e+17,1095.63,4146.15,12184,317,301,9130,7743,5536,5502,4254
41482,1374,2435,34252,7230,21289,20193,7.58146e+17,1741.79,7917.5,41482,560,439,36386,30961,29219,28632,26547
2153,311,525,763,1390,0,2153,3.66179e+13,43.7157,838.722,2153,129,87,1628,1628,1363,1322,1274
22979,562,2008,0,22979,0,22979,2.45855e+18,1198.77,5225.85,22979,418,333,18756,16830,8113,8109,6873
1817,59,629,1817,0,1469,348,2.72601e+18,155.833,954.794,1817,99,99,706,358,272,232,225
41347,640,2380,21999,19348,21999,19348,4.9444e+18,1441.6,7264.19,41347,590,417,34554,30467,14475,17317,12667
31959,27,44,30299,1660,31391,568,1.02633e+14,41.2648,817.228,31959,43,40,31745,31622,28036,28119,23717
48253,1996,6158,22408,25845,22408,25845,4.64358e+18,1137.99,12013.4,48253,1079,618,42095,41093,26736,25849,26345
36196,1029,1587,12877,23319,0,36196,3.82727e+13,1102.06,5621.82,36196,457,368,33452,30277,22898,24711,27082
31614,1522,1882,15592,16022,0,31614,5.05742e+18,1385.94,6135.3,31614,498,390,29279,25191,22240,20945,27020
21530,66,2082,11731,9799,0,21530,5.03369e+18,1157.88,5038.06,21530,447,316,13510,10007,5736,3995,1041
48748,38,43,46441,2307,47476,1272,9.91355e+13,41.8834,1006.64,48748,43,41,48666,48604,47914,47911,45717
42457,1023,2427,0,42457,0,42457,2.4486e+18,1438.49,7390.16,42457,598,419,37368,33155,19961,19291,21936
27613,163,355,0,27613,26271,1342,2.56781e+16,286.35,2127.8,27613,120,131,26744,26227,23009,20076,16576
29400,1055,2627,29400,0,24464,4936,3.31947e+18,1582.29,6812.72,29400,553,391,24234,21148,18396,17519,12632
22289,311,640,21900,389,22289,0,4.62244e+18,474.943,2862.82,22289,205,202,21029,20105,13622,13608,11956
13385,1289,1876,0,13385,0,13385,2.4378e+18,821.146,3864.1,13385,366,276,11506,10521,8833,8058,9258
29023,799,2248,14849,14174,0,29023,4.98586e+18,1343,6096.59,29023,515,379,24347,21949,11609,10961,12042
46973,463,618,46467,506,46973,0,4.72686e+18,517.39,4110.46,46973,262,259,45853,44483,40009,40233,37423
49212,285,2427,0,49212,0,49212,2.47498e+18,1462.35,7988,49212,588,451,38075,33527,12770,7410,4460
9705,7,43,9235,470,9455,250,9.95969e+13,29.368,442.2,9705,32,31,8931,8414,6938,6932,4966
47405,248,2514,24973,22432,0,47405,5.01135e+18,1491.68,7902.22,47405,637,441,36057,31562,12995,10351,5792
15038,90,349,0,15038,14260,778,2.62921e+16,213.157,1582.37,15038,108,111,14322,14033,11125,9473,7191
3311,338,849,1195,2116,0,3311,3.91095e+13,125.879,1370.4,3311,155,133,2462,2390,1223,938,1102
36624,938,1711,0,36624,12998,23626,9.50891e+15,1102.2,5640.08,36624,537,350,33499,30670,22586,16795,26855
22465,923,2514,18898,3567,11932,10533,7.05553e+17,1442.14,5850.82,22465,471,348,18056,15806,12648,12189,9548
5502,19,246,0,5502,5278,224,2.3574e+16,67.2177,786.654,5502,60,58,4912,4532,3615,3335,2109
6323,20,42,5964,359,6259,64,1.06616e+14,28.0777,361.197,6323,34,30,6222,6160,5451,5417,4675
41872,297,2401,21677,20195,21677,20195,4.87595e+18,1493.35,7386.67,41872,613,418,32414,28595,11456,12407,5904
27094,12,43,25883,1211,26255,839,9.76138e+13,38.2604,739.844,27094,40,37,26175,25543,21037,20650,15757
45522,2181,2983,37943,7579,23830,21692,7.27426e+17,1690.05,8649.31,45522,641,447,42539,42389,35947,35406,39441
28648,989,2292,0,28648,0,28648,2.40457e+18,1304.79,6017.44,28648,533,363,24733,22121,13854,12859,16010
47330,2040,2249,24073,23257,0,47330,5.07268e+18,1533.61,7809.38,47330,590,450,45081,45081,41565,41079,44665
17568,89,1460,6273,11295,0,17568,3.84667e+13,834.621,3822.86,17568,311,285,13127,10996,5346,3690,1588
32634,937,1616,11537,21097,0,32634,3.76766e+13,1088.55,5347.25,32634,456,342,29824,27035,19521,19387,20688
5703,259,318,0,5703,5393,310,2.7734e+16,86.6754,961.456,5703,69,66,5385,5378,5231,5219,4910
11828,15,43,11294,534,11476,352,9.65937e+13,28.0194,481.953,11828,35,32,11564,11376,9574,9464,7273
31704,856,2530,14932,16772,14932,16772,4.92646e+18,1559.97,6945.21,31704,588,393,26043,22737,9859,11494,13526
5886,1273,1802,5886,0,4848,1038,3.15463e+18,233.021,2752.36,5886,240,188,4084,4053,4009,3992,3134
18648,38,43,17779,869,18130,518,9.83535e+13,37.3932,623.027,18648,37,35,18595,18574,18337,18333,17281
24605,281,688,24098,507,24605,0,4.57712e+18,487.281,3047.82,24605,224,204,23034,21841,13600,13493,11434
10881,524,659,10713,168,10881,0,4.64011e+18,374.251,2059.56,10881,191,152,10222,10056,9416,9443,9233
30291,692,1716,0,30291,10707,19584,9.48646e+15,1060.41,5169.99,30291,491,329,26594,24620,16000,11636,17568
36303,272,1638,12859,23444,0,36303,3.79817e+13,1098.27,5687.27,36303,488,364,30142,27695,12982,8321,6416
14480,1252,2252,12101,2379,7713,6767,7.1676e+17,1023.66,4492.31,14480,363,298,11777,10701,9593,9463,8314
41814,1591,2569,34462,7352,21324,20490,7.66871e+17,1775.56,8055.39,41814,630,448,37564,31607,30257,30172,28690
5215,124,1521,2544,2671,2544,2671,5.14064e+18,243.565,2345.77,5215,229,176,3229,2155,1019,897,511
17453,1347,1879,8892,8561,8892,8561,5.00213e+18,1070.01,4518.72,17453,352,317,15296,13752,11202,10619,12811
13362,438,1523,0,13362,4709,8653,9.47392e+15,730.213,3387.19,13362,338,252,11101,10376,6195,4497,5224
37559,826,2093,18690,18869,0,37559,5.08731e+18,1399.85,6819.31,37559,514,423,32038,28342,15179,14053,18076
47303,1237,1742,16769,30534,0,47303,3.75953e+13,1201.39,6488.23,47303,567,388,44806,39994,33045,31699,41647
6730,18,42,6361,369,6629,101,1.02385e+14,25.8629,368.265,6730,31,30,6599,6510,5587,5533,4451
43280,306,356,0,43280,41319,1961,2.50521e+16,289.69,2627.56,43280,140,151,42768,41889,40759,38533,40197
2194,621,842,973,1221,973,1221,4.69256e+18,107.797,1197.56,2194,144,103,1352,1333,1264,1274,1223
3995,128,279,0,3995,3769,226,2.83722e+16,65.2758,776.476,3995,64,65,3716,3675,3280,3127,2617
10034,467,591,9967,67,10034,0,4.76303e+18,324.573,1884.05,10034,164,147,9443,9285,8951,8966,8625
17009,1053,2005,0,17009,0,17009,2.44936e+18,1030.95,4509.43,17009,391,304,14401,13116,8876,8322,10014
29261,1069,2188,14938,14323,0,29261,5.04446e+18,1297.08,6094.1,29261,480,383,25400,22721,14332,13027,15643
15580,24,734,15158,422,15580,0,4.56988e+18,422.161,2459.21,15580,225,166,8126,4586,3304,2869,611
21538,14,43,20559,979,20907,631,9.7258e+13,37.5846,660.808,21538,39,35,20966,20554,17099,16689,12808
37491,380,1807,0,37491,13313,24178,9.53313e+15,1130.31,5816.02,37491,544,356,31897,29276,14896,9750,11881
29309,1359,2255,0,29309,0,29309,2.42426e+18,1337.47,6105.96,29309,525,371,26274,23116,16551,15404,19606
49115,1951,2014,17507,31608,0,49115,3.72843e+13,1207.08,6820.04,49115,643,383,47101,47101,46947,46984,47074
40171,447,1753,14266,25905,0,40171,3.7669e+13,1134.74,5994.58,40171,519,373,34527,31668,18070,13042,13314
34862,295,357,0,34862,32888,1974,2.72671e+16,311.013,2484.81,34862,141,150,34257,33394,31773,29181,29719
47924,1805,1895,0,47924,16993,30931,9.51957e+15,1173.59,6637.49,47924,621,383,46029,46029,45502,45076,45789
41138,1702,2001,0,41138,0,41138,2.49532e+18,1434.37,7071.03,41138,538,432,39137,36539,32647,31041,37850
33873,1220,1894,0,33873,0,33873,2.50515e+18,1419.23,6356.86,33873,459,409,30255,26412,19575,16651,23297
48011,3811,5621,22323,25688,22323,25688,4.69824e+18,1116.17,11335.4,48011,1077,563,42390,42258,38637,38790,38987
28670,1095,2035,22817,5853,13516,15154,8.50353e+17,1546.79,6344,28670,471,392,23938,20180,17320,16731,15872
30886,1811,2164,14729,16157,0,30886,5.1147e+18,1452.66,6404.96,30886,501,391,28678,26098,22757,21835,27804
33604,754,1998,16037,17567,16037,17567,5.0105e+18,1385.88,6428.23,33604,484,406,28140,24767,12309,11986,15137
9191,140,1978,0,9191,0,9191,2.22602e+18,348.361,3380.36,9191,244,244,6329,5101,1886,1522,720
15715,1016,1521,0,15715,5597,10118,9.66504e+15,808.778,3657.6,15715,349,267,13830,12981,10609,8722,11307
49446,226,1422,17428,32018,0,49446,3.85135e+13,1142.39,6385.19,49446,505,401,40332,36972,15230,6840,10485
5040,862,981,0,5040,1810,3230,9.78166e+15,154.753,1699.1,5040,221,153,4059,4059,3993,3915,3915
1608,141,326,1543,65,1174,434,2.88636e+17,30.4248,529.799,1608,100,58,1282,1262,1156,1184,162
39008,2045,2443,20459,18549,0,39008,4.99243e+18,1463.22,7169.09,39008,598,408,36565,36560,32875,31959,35340
29657,779,1739,10528,19129,0,29657,3.72026e+13,1072.49,5167.93,29657,488,341,26322,24236,16380,15689,14584
43687,3886,5886,0,43687,15149,28538,8.83171e+15,564.483,10487.9,43687,889,542,37801,37768,30431,28168,27747
11590,707,1449,4072,7518,0,11590,3.61821e+13,552.998,3009.03,11590,327,200,10003,9415,7019,6634,7661
36023,1357,2636,36023,0,30120,5903,3.29697e+18,1672.33,7461.16,36023,619,422,31353,27032,28186,26143,23364
22372,338,346,0,22372,21253,1119,2.59507e+16,259.156,1912.29,22372,114,122,22020,21682,21952,21856,21830
46948,1767,2139,37627,9321,22253,24695,8.39717e+17,1776.13,8286.78,46948,557,471,43647,35486,38271,36552,39384
48480,2367,2758,48480,0,40753,7727,3.26706e+18,1902.67,8744.44,48480,749,465,45722,45000,44810,45140,45363
17901,40,43,17047,854,17437,464,1.00068e+14,35.7031,601.477,17901,38,35,17855,17841,17809,17807,17321
14536,149,2026,14536,0,11551,2985,3.04569e+18,1179.27,4519.52,14536,327,303,8998,5765,2888,2683,1596
34135,2011,2318,0,34135,0,34135,2.42018e+18,1389.51,6582.76,34135,583,381,31817,31698,29097,28578,30212
21100,1668,1719,0,21100,7423,13677,9.39003e+15,860.241,4300.11,21100,409,287,19381,19381,19353,19368,19373
34332,1556,2752,28389,5943,17302,17030,7.49949e+17,1724.41,7634.6,34332,565,424,30115,25682,23836,23710,22516
28903,548,1734,0,28903,0,28903,2.52382e+18,1322.66,5705.1,28903,437,386,23434,20412,9326,7473,10990
13994,447,2307,6510,7484,0,13994,4.98863e+18,1037.97,4552.29,13994,481,281,10459,8677,3309,3152,3539
31202,2054,2243,16392,14810,0,31202,5.00824e+18,1358.32,6272.23,31202,536,384,28959,28959,27972,27927,28258
33234,1384,1714,11724,21510,0,33234,3.69725e+13,1084.51,5418.43,33234,530,342,31510,28535,25938,26691,30304
25602,2059,2162,0,25602,0,25602,2.44702e+18,1269.45,5622.44,25602,474,352,23440,23440,22944,22751,22942
49691,340,1744,17609,32082,0,49691,3.79377e+13,1160.36,6712.36,49691,527,397,41981,38348,18356,13562,15759
41014,984,2202,20548,20466,0,41014,5.05582e+18,1436.63,7228.53,41014,555,434,35754,31583,18110,15997,22022
30240,1138,1620,10726,19514,0,30240,3.74754e+13,1078.14,5154.58,30240,430,332,28005,25289,20550,20121,23770
43257,1996,2173,0,43257,0,43257,2.47657e+18,1445.75,7343.41,43257,562,428,41084,41084,40044,39122,40424
46606,118,2569,24776,21830,24776,21830,4.92019e+18,1494.88,7862.98,46606,654,439,32172,23997,12443,12172,3438
13776,90,755,13453,323,13776,0,4.60581e+18,372.355,2326.85,13776,214,150,10712,7912,4763,4580,2408
12960,291,1695,6144,6816,6144,6816,5.00139e+18,943.34,3814.29,12960,310,277,9671,8472,3130,3018,2971
22167,288,1681,10403,11764,0,22167,5.10288e+18,1242.51,4966.36,22167,406,335,16701,14570,4819,3951,2927
13551,502,705,13313,238,13551,0,4.72479e+18,414.87,2299.87,13551,187,155,12785,12494,11968,11974,10116
24621,20,1310,8705,15916,0,24621,3.88503e+13,996.806,4419.34,24621,380,329,12314,8183,4519,1997,1167
7109,161,564,6886,223,7109,0,4.4428e+18,224.161,1530.35,7109,162,115,6304,5649,3536,3466,2573
30600,1272,2242,16045,14555,16045,14555,4.90322e+18,1339.6,6201.71,30600,530,374,27158,24181,16633,16239,18720
14034,460,796,13612,422,14034,0,4.58837e+18,356.18,2358.63,14034,196,152,13193,12891,11582,11574,9252
29012,343,603,28693,319,29012,0,4.73823e+18,488.255,3226.68,29012,221,228,27684,26664,19849,19805,17376
26279,229,352,0,26279,25051,1228,2.52322e+16,254.784,2035.69,26279,118,130,25693,25224,23339,21636,21569
48845,1887,2409,25388,23457,0,48845,5.00147e+18,1468.16,7915.13,48845,632,445,46436,46237,37457,35698,43015
19737,106,1404,6998,12739,0,19737,3.84101e+13,931.269,4046.84,19737,344,303,14881,12578,5448,3122,2835
40024,837,2965,33559,6465,21112,18912,7.15046e+17,1708.9,8133.59,40024,647,427,32429,27737,21697,20725,11903
41560,2345,2451,0,41560,0,41560,2.44483e+18,1457.51,7350.16,41560,614,426,39109,39109,38660,38705,39101
37533,1393,2125,18309,19224,0,37533,5.15841e+18,1201.98,6876.9,37533,534,411,34692,31321,23187,21044,28714
48576,1,43,46281,2295,47310,1266,9.89013e+13,40.3458,998.267,48576,43,41,17633,17633,17633,17633,17633
36504,1620,2574,19596,16908,0,36504,5.04039e+18,1363.25,7025.16,36504,576,409,33754,29499,24026,22430,29481
24704,184,353,0,24704,23459,1245,2.60358e+16,273.66,2027.6,24704,123,128,23956,23472,20940,18863,16805
31630,334,2724,0,31630,10989,20641,9.35777e+15,816.281,6358.96,31630,422,395,26666,24774,11475,8294,7846
1274,295,502,561,713,561,713,4.2176e+18,64.7637,728.694,1274,90,92,772,769,487,496,438
43582,2210,3010,43582,0,36517,7065,3.29461e+18,1783.02,8507.11,43582,727,443,40572,40187,39304,39221,38581
24754,12,42,23374,1380,24507,247,1.06477e+14,38.5157,715.381,24754,40,38,23742,23029,18599,18152,12978
17838,2021,2050,9729,8109,0,17838,5.05627e+18,984.103,4589.65,17838,372,300,15788,15788,15788,15788,15320
48326,1025,1376,0,48326,17073,31253,9.90544e+15,1132.92,6228.66,48326,493,399,45439,40364,31904,25411,37012
30701,324,2241,0,30701,0,30701,2.44294e+18,1360.38,6240,30701,525,383,23937,21216,8401,4658,4420
8020,38,42,7581,439,7956,64,1.04904e+14,30.4519,404.339,8020,31,32,7978,7971,7959,7961,7799
44210,6,43,41897,2313,43440,770,1.03683e+14,40.3061,956.988,44210,43,41,39085,35704,29353,29810,19946
12957,192,1401,0,12957,4604,8353,9.6864e+15,724.061,3258.27,12957,298,260,10310,9420,4536,3390,2677
14860,1811,2045,11896,2964,7125,7735,8.43261e+17,1180.71,4562.67,14860,328,317,12706,11039,11773,11575,12255
43599,1294,1361,0,43599,15419,28180,9.87692e+15,1125.69,5920.32,43599,494,393,42238,42169,41700,41672,41629
18562,13,347,0,18562,17593,969,2.63938e+16,256.034,1770.18,18562,114,119,15206,13433,10688,9569,5730
2215,336,416,2213,2,2215,0,4.70648e+18,146.054,823.315,2215,103,77,1799,1778,1699,1687,1635
38758,592,932,37703,1055,38758,0,4.58748e+18,587.587,4021.1,38758,260,226,37695,36647,33169,32923,28810
15943,1519,1523,0,15943,5634,10309,9.45486e+15,791.865,3658.11,15943,374,258,14420,14420,14409,14417,14419
34375,785,1757,16335,18040,16335,18040,5.02496e+18,1411.28,6282.67,34375,471,406,29039,25392,14132,12990,14646
4945,350,1503,4216,729,2708,2237,6.82354e+17,117.762,2199.18,4945,239,159,3442,3190,2543,2477,1733
44762,844,6629,0,44762,0,44762,1.86548e+18,1164.84,12883.4,44762,694,818,36857,32733,16155,10269,8348
37727,1135,1776,13375,24352,0,37727,3.72554e+13,1140.02,5834.24,37727,541,361,35103,31740,24919,24768,25759
39949,2329,2836,39949,0,33290,6659,3.3396e+18,1744.49,8069.87,39949,661,437,37113,36805,36397,36591,35841
31334,223,351,0,31334,29755,1579,2.61978e+16,291.355,2287.91,31334,130,135,30591,29937,27284,25148,22668
34539,1765,1806,16561,17978,16561,17978,4.99159e+18,1397.03,6334.69,34539,487,412,32733,32733,32584,32468,32565
31136,814,899,30232,904,31136,0,4.54478e+18,517.67,3577.71,31136,260,211,30237,30237,29851,29780,29318
5827,35,283,0,5827,5570,257,2.47819e+16,50.2233,868.731,5827,63,64,5405,5142,4190,3471,2330
38721,243,2126,38721,0,31025,7696,2.98595e+18,1725.52,7529.52,38721,522,456,25862,21137,9146,7725,4095
14138,72,348,0,14138,13483,655,2.47294e+16,192.93,1485.71,14138,90,94,13474,13200,10697,9387,6334
12203,780,1510,0,12203,4373,7830,9.75671e+15,646.364,3208.5,12203,308,245,10522,9835,7187,5549,6264
3041,13,42,2869,172,3039,2,1.03205e+14,24.3305,260.096,3041,25,27,2904,2815,2352,2273,1600
24479,330,361,0,24479,23312,1167,2.52301e+16,270.472,2014.18,24479,120,122,24082,23628,23559,23491,23253
39976,4,43,37976,2000,39137,839,1.01934e+14,39.5154,907.571,39976,42,41,31964,28138,24887,24613,15691
43625,463,2372,23090,20535,23090,20535,4.93002e+18,1472.38,7451.63,43625,597,422,35487,31419,14137,15245,11045
15811,237,345,0,15811,15002,809,2.60413e+16,228.234,1609.27,15811,100,105,15361,15112,14072,13232,13254
11464,228,1953,0,11464,0,11464,2.37305e+18,791.076,3728.34,11464,336,250,8343,7174,2858,1469,1564
4387,21,38,4193,194,4234,153,9.81027e+13,26.034,290.645,4387,26,25,4324,4293,3897,3867,3200
7847,192,349,0,7847,7484,363,2.51335e+16,77.7566,1116.26,7847,79,80,7498,7438,6923,6654,5815
42610,92,375,0,42610,40567,2043,2.58248e+16,315.816,2715.3,42610,144,156,40860,40011,31838,27174,20761
48664,506,839,47775,889,48664,0,4.62361e+18,547.113,4390.39,48664,304,251,47444,45979,38625,37506,34665
2316,287,672,0,2316,0,2316,2.66897e+18,49.2655,1037.24,2316,128,111,1644,1643,1548,1572,483
31732,171,354,0,31732,30257,1475,2.51153e+16,275.443,2256.94,31732,127,139,30850,30230,27004,24014,20970
24095,1165,2277,19845,4250,12163,11932,7.68028e+17,1527.04,6010.82,24095,441,354,20150,17290,15162,14936,13925
44016,752,2424,23631,20385,23631,20385,4.94253e+18,1455.4,7491.18,44016,618,426,37424,33132,17458,20341,17689
34417,1301,2115,0,34417,0,34417,2.46592e+18,1388.92,6526.58,34417,514,396,31138,27100,19993,17504,22786
5601,1049,1207,1957,3644,0,5601,3.62121e+13,178.317,2028.54,5601,226,160,4394,4389,4173,4203,4078
40384,5,43,38506,1878,39273,1111,9.87995e+13,40.8964,912.132,40384,43,40,34597,31112,27002,27263,16977
37825,1030,2700,37825,0,31657,6168,3.29857e+18,1705.31,7719.74,37825,636,430,31402,27281,23313,22129,14954
40672,213,350,0,40672,38606,2066,2.61341e+16,305.112,2601.44,40672,140,153,39695,38838,35077,31938,28618
10698,1038,1762,5289,5409,5289,5409,4.9501e+18,756.636,3498.83,10698,309,252,8847,8048,6142,5425,6478
31680,1587,2708,31680,0,26540,5140,3.16045e+18,1639.57,7081.51,31680,574,393,27761,23848,26700,25788,22544
6112,651,1169,0,6112,2220,3892,9.86981e+15,169.93,2032.66,6112,221,146,4943,4855,3945,2533,2709
23935,690,1587,0,23935,8481,15454,9.48662e+15,999.561,4516.9,23935,431,303,21107,19446,13280,8712,10109
4961,212,270,0,4961,4743,218,2.46923e+16,53.4676,813.761,4961,64,62,4691,4676,4585,4564,4410
26594,1371,1713,12737,13857,0,26594,5.14654e+18,1306.39,5466.31,26594,429,378,24115,20985,17851,16592,21261
44100,160,2161,44100,0,35330,8770,3.01659e+18,1759.28,8060.71,44100,535,477,27534,17195,9272,7389,4185
45742,1560,1882,16242,29500,0,45742,3.72089e+13,1162.58,6465.17,45742,602,376,43860,43860,39166,39724,43070
39675,1151,2140,31742,7933,18789,20886,8.44602e+17,1709.61,7605.58,39675,536,449,33553,28181,24757,24109,22888
7372,1372,1773,0,7372,0,7372,2.43771e+18,296.872,2876.41,7372,262,225,5599,5520,4931,4950,5153
25592,316,573,25340,252,25592,0,4.77904e+18,457.316,2972.8,25592,215,210,24343,23365,17563,17673,15394
6035,321,1614,3040,2995,0,6035,5.15246e+18,238.716,2581.48,6035,233,185,4386,3899,1948,1684,1336
33307,967,1705,15881,17426,0,33307,5.16517e+18,1382.81,6105.85,33307,468,404,28993,25375,16875,13799,18385
39318,626,2278,39318,0,31713,7605,3.02309e+18,1700.41,7690.09,39318,561,452,30578,25741,14621,12539,12024
32445,1510,2340,0,32445,0,32445,2.48817e+18,1308.17,6523.41,32445,491,383,29709,26098,20216,17961,23236
1073,245,384,401,672,401,672,4.13582e+18,55.466,562.22,1073,73,65,689,679,404,502,451
27071,625,1717,0,27071,0,27071,2.54093e+18,1336.69,5541.43,27071,425,372,22098,19158,9848,7957,9054
17751,168,1323,0,17751,6279,11472,9.8834e+15,903.045,3769.08,17751,333,290,13916,12611,5074,4312,3474
12041,152,658,11725,316,12041,0,4.59196e+18,365.131,2102.46,12041,172,153,10525,8905,5207,5183,3530
9636,1432,1540,3436,6200,0,9636,3.70462e+13,470.998,2892.95,9636,293,204,8096,7949,7912,7919,8079
31426,183,359,0,31426,29794,1632,2.62725e+16,293.001,2319.92,31426,133,141,30478,29823,26314,23429,20306
35001,12,43,33456,1545,33895,1106,9.69295e+13,39.8222,845.557,35001,42,39,33810,32982,27102,26620,19439
9867,1424,2260,9867,0,8553,1314,3.40345e+18,356.076,3598.48,9867,308,219,7607,7382,7290,7143,5573
10354,565,600,0,10354,3570,6784,9.00686e+15,373.671,2078.95,10354,245,184,9754,9753,9698,9664,9705
24292,1345,2176,24292,0,19771,4521,3.03641e+18,1506.59,5989.67,24292,432,371,20813,17732,17110,16250,15391
40422,1579,1762,19329,21093,19329,21093,5.02058e+18,1429.28,6778.85,40422,511,432,38397,32547,31652,31685,36423
2883,219,984,2466,417,1578,1305,6.42627e+17,81.7496,1435.18,2883,130,129,1899,1817,1328,1333,878
39068,34,42,36837,2231,38683,385,1.06724e+14,39.7857,895.526,39068,42,40,38964,38869,36527,36533,34926
10761,1028,2225,10761,0,8788,1973,2.79964e+18,669.411,3995.66,10761,265,257,8536,7459,6133,5602,5388
33445,149,353,0,33445,31889,1556,2.51604e+16,287.273,2318.97,33445,131,135,32418,31847,27615,24683,20976
45986,196,374,0,45986,43668,2318,2.59315e+16,314.016,2815.49,45986,153,161,44771,43788,38960,34708,33071
47867,282,1838,0,47867,16953,30914,9.64127e+15,1167.16,6625.74,47867,568,389,39988,36744,15737,10988,8604
36514,210,349,0,36514,34541,1973,2.65999e+16,295.4,2477.18,36514,137,150,35582,34789,31277,28336,27553
19964,195,356,0,19964,18835,1129,2.73483e+16,268.874,1870.8,19964,113,124,19294,18859,16659,15055,13256
43025,511,2684,23083,19942,23083,19942,4.8968e+18,1461.68,7602.42,43025,668,414,35318,31558,14969,16708,12382
17909,200,1705,0,17909,0,17909,2.57423e+18,1173.75,4508.4,17909,339,310,12709,10170,3547,2316,1743
8536,1779,2148,7104,1432,4429,4107,7.28607e+17,463.417,3444.18,8536,298,220,6388,6199,5971,5944,4868
28156,1109,2405,23231,4925,14407,13749,7.60907e+17,1601.28,6552.19,28156,503,388,23360,20078,17222,16781,14729
18312,170,758,17824,488,18312,0,4.54246e+18,446.893,2679.76,18312,180,172,16278,14371,8363,7898,5151
44253,928,2490,23640,20613,0,44253,5.01024e+18,1455.96,7561.7,44253,631,426,38467,34302,18840,18957,21170
30785,904,1416,0,30785,10889,19896,9.80161e+15,1053.59,5038.46,30785,442,343,28190,25431,19017,14958,22705
28039,1879,2776,28039,0,23205,4834,3.17923e+18,1565.01,6930.68,28039,501,394,24963,21366,23711,22553,20300
43248,663,2637,35618,7630,22050,21198,7.60142e+17,1710.98,8246.27,43248,590,448,34206,29126,20260,19883,11850
22760,1086,2699,19153,3607,12119,10641,7.10163e+17,1365.09,6069.48,22760,481,369,18530,16437,14101,13789,9429
6451,496,536,6258,193,6451,0,4.48759e+18,223.62,1447.28,6451,145,113,5915,5914,5871,5879,5820
41953,20,43,39884,2069,41029,924,1.01814e+14,40.7779,930.097,41953,42,41,41409,41000,35093,34654,27820
32547,89,354,0,32547,31011,1536,2.52547e+16,286.752,2293.96,32547,129,134,31195,30606,24576,21679,15474
3605,502,1118,3078,527,2043,1562,6.54451e+17,119.387,1694.2,3605,175,153,2487,2455,1867,1915,1387
5658,654,1545,2689,2969,0,5658,5.11532e+18,283.864,2467.76,5658,208,207,4113,3798,1951,1687,1994
13819,1233,2188,11302,2517,6905,6914,7.85884e+17,1113.37,4514.17,13819,352,289,10954,9877,8761,8689,7483
16129,332,353,0,16129,15224,905,2.72836e+16,254.014,1678.67,16129,113,116,15755,15431,15521,15563,15058
22464,1429,2342,18426,4038,11358,11106,7.75681e+17,1424.32,5815.15,22464,458,360,19117,16615,15460,15294,13450
31933,771,1707,11361,20572,0,31933,3.74562e+13,1086.05,5311.49,31933,491,340,28422,26148,18039,16710,19813
33856,281,719,33312,544,33856,0,4.62627e+18,530.258,3602.04,33856,266,223,31854,30239,16809,17179,16035
8221,1723,1764,4101,4120,4101,4120,4.96323e+18,447.677,3050.43,8221,258,257,6457,6281,6417,6359,6353
2082,126,574,0,2082,797,1285,1.12488e+16,74.5557,940.985,2082,132,108,1508,1355,903,608,477
46681,2770,2865,24583,22098,24583,22098,4.91487e+18,1415.84,8149.8,46681,668,429,43816,43816,43532,43421,43118
13617,740,2294,11141,2476,6759,6858,7.76711e+17,1100.49,4530.42,13617,357,284,10316,9082,6649,6830,5181
41831,2454,2767,34857,6974,21920,19911,7.28742e+17,1726.98,8148.78,41831,642,440,39064,39064,37678,37301,38318
19981,262,592,19756,225,19981,0,4.69851e+18,454.396,2675.6,19981,195,196,18650,17622,11025,10946,9732
39758,277,1941,19012,20746,19012,20746,5.02155e+18,1411.01,6920.73,39758,514,425,29954,25539,7935,8378,5718
7807,81,2158,7807,0,6513,1294,3.28253e+18,351.519,3330.66,7807,288,223,4381,2992,1720,1655,313
18120,290,673,17817,303,18120,0,4.67779e+18,436.858,2611.57,18120,196,183,16950,16170,11497,11411,9372
29462,709,2617,24363,5099,15152,14310,7.46755e+17,1506.82,6827.66,29462,483,382,23368,20020,14470,14248,9811
42593,2041,2090,15072,27521,0,42593,3.70278e+13,1145.45,6522.77,42593,604,373,40503,40503,40457,40493,40503
18312,312,2166,9576,8736,0,18312,5.01854e+18,1053.45,4794.81,18312,426,308,14122,12492,4922,3952,2444
47548,573,2802,47548,0,38443,9105,2.97099e+18,1743.83,8976.15,47548,571,492,36367,30346,16687,12832,11433
6411,1514,1614,0,6411,0,6411,2.3643e+18,212.486,2564.28,6411,273,210,4797,4797,4762,4753,4781
22030,1222,1286,7717,14313,0,22030,3.86351e+13,939.632,4120.17,22030,355,309,20692,18571,20308,20470,20196
10936,98,637,10654,282,10936,0,4.55652e+18,355.864,2001.3,10936,176,151,8665,6401,3798,3610,1921
44189,539,6773,20483,23706,20483,23706,4.4482e+18,875.471,11918.4,44189,1018,584,35910,32266,11891,11742,6096
39278,655,1670,13918,25360,0,39278,3.78046e+13,1129.78,5863,39278,591,368,34782,31886,19904,17398,18884
45272,169,357,0,45272,43086,2186,2.57054e+16,303.85,2754.83,45272,150,155,43996,43044,38077,33191,29957
49800,1851,2465,23671,26129,0,49800,5.08957e+18,1634.27,8455.2,49800,630,462,47281,40069,34385,31867,45042
10417,985,1296,3699,6718,0,10417,3.91435e+13,623.506,2847.47,10417,253,239,9121,8442,7312,6800,7886
22574,1662,2036,22574,0,17999,4575,3.01241e+18,1452.55,5627.33,22574,410,356,20002,16923,19497,19570,17414
7111,38,1289,2530,4581,0,7111,3.96458e+13,327.967,2366.43,7111,204,178,4343,3229,1599,645,464
11640,957,1685,5582,6058,5582,6058,5.07038e+18,860.903,3592.12,11640,288,271,9516,8698,6022,5906,7168
18324,428,2331,15117,3207,9330,8994,7.6688e+17,1356.02,5245.71,18324,419,332,13477,11821,7267,7620,4472
46309,204,1501,16381,29928,0,46309,3.8395e+13,1144.09,6257.1,46309,534,393,37631,34089,14367,10243,7766
22951,1584,2228,18695,4256,11439,11512,7.93507e+17,1447.38,5802.47,22951,429,373,19995,17201,16664,16383,16837
20251,41,43,19256,995,19818,433,1.01159e+14,38.8042,648.011,20251,39,36,20204,20191,20146,20145,19597
15169,967,2345,15169,0,12652,2517,3.30577e+18,1125.28,4745.3,15169,398,282,11923,10636,9043,8512,7248
29969,1467,2751,29969,0,24540,5429,2.93034e+18,1796.37,7359.34,29969,569,405,25064,21750,22743,21408,18533
2976,758,986,1421,1555,0,2976,4.90615e+18,125.463,1463.36,2976,161,128,1990,1988,1686,1654,1672
12341,1816,2059,6003,6338,0,12341,5.20971e+18,876.269,4038.7,12341,322,279,10282,9493,8963,8778,9760
22335,728,766,21706,629,22335,0,4.60865e+18,502.393,2961.46,22335,224,189,21569,21520,21446,21410,21279
17793,1665,1997,9295,8498,0,17793,5.05101e+18,1075.73,4613.55,17793,382,310,15796,14226,13089,12746,14053
9981,29,43,9500,481,9736,245,1.00283e+14,29.637,449.281,9981,33,32,9916,9886,9245,9186,8549
34595,37,43,32616,1979,34269,326,1.06488e+14,40.9127,865.148,34595,43,40,34512,34449,32596,32600,31518
47074,1439,1927,0,47074,16712,30362,9.51088e+15,1160.31,6589.96,47074,633,378,45147,42629,35789,28929,43658
18686,394,1567,6595,12091,0,18686,3.68007e+13,822.829,3926.74,18686,414,266,15849,14762,8420,7060,7660
45033,121,2493,45033,0,36716,8317,3.11186e+18,1754.44,8377.8,45033,587,474,26999,17208,10555,7979,3336
11168,26,349,0,11168,10558,610,2.74282e+16,185.223,1369.16,11168,96,100,9895,9185,6876,5708,3386
8464,423,2158,8464,0,7121,1343,3.38289e+18,408.114,3431.84,8464,291,216,6128,5575,3633,3179,2320
23917,200,2142,12578,11339,12578,11339,4.92689e+18,1238.42,5440.34,23917,462,344,17716,14636,6439,6968,3349
4523,116,219,0,4523,4345,178,2.38334e+16,60.9341,695.299,4523,57,54,4304,4290,4035,3908,3661
9271,426,559,9144,127,9271,0,4.72212e+18,350.067,1807.8,9271,148,146,8693,8488,7833,7874,7281
18339,2305,2346,15384,2955,9818,8521,7.06939e+17,1240.36,5143.74,18339,403,324,15993,15953,15976,15946,15988
48147,327,353,0,48147,45428,2719,2.73103e+16,309.478,2883.75,48147,157,170,47670,46412,46177,45484,45581
42289,32,43,40202,2087,41486,803,9.99998e+13,39.6199,940.107,42289,42,41,42143,42013,39338,39410,35999
31181,715,2042,16147,15034,0,31181,5.08342e+18,1344.2,6146.83,31181,467,381,26182,22976,12592,11695,11974
36827,514,2161,36827,0,29588,7239,3.01381e+18,1698.81,7384.01,36827,515,456,27686,22985,12351,10393,8811
23439,205,1896,11753,11686,11753,11686,5.00768e+18,1252.27,5285.72,23439,387,358,17091,14102,5839,5759,3362
44082,71,378,0,44082,41711,2371,2.71316e+16,320.188,2819.72,44082,153,161,41698,40522,30203,25695,18332
13904,512,2220,13904,0,11418,2486,3.11653e+18,1055.79,4512.25,13904,362,313,10346,9047,5984,5133,3541
789,103,284,758,31,789,0,5.00348e+18,69.2966,434.657,789,47,50,505,373,346,370,263
45498,2560,2677,37157,8341,21730,23768,7.85154e+17,1937.68,8856.34,45498,663,470,42821,42821,42497,42491,42758
3511,42,43,3312,199,3497,14,1.10634e+14,28.5426,285.663,3511,29,29,3468,3467,3464,3463,3462
34416,1567,1879,12161,22255,0,34416,3.76065e+13,1157.42,5845.52,34416,548,351,32537,31921,28569,29142,31390
1945,370,650,1416,529,733,1212,9.98763e+17,106.349,984.667,1945,121,114,1295,1258,1050,942,921
26029,1,43,24765,1264,25422,607,1.01186e+14,39.4071,734.826,26029,41,38,9162,9162,9162,9162,9162
48236,2215,2623,0,48236,0,48236,2.4421e+18,1501.95,8077.69,48236,641,438,45613,45613,41360,40611,44351
40608,692,2525,33448,7160,20730,19878,7.58288e+17,1679.48,7888.7,40608,579,434,32315,27400,19394,19222,13430
30194,332,856,29571,623,30194,0,4.57153e+18,519.765,3547.98,30194,262,221,28534,27200,16228,15779,12571
11545,620,1997,5339,6206,5339,6206,4.78379e+18,591.227,3800.33,11545,312,253,9180,8415,4327,3767,4283
10170,33,43,9634,536,10000,170,1.02571e+14,30.4897,451.102,10170,35,31,10119,10102,9697,9708,9450
20477,352,2175,20477,0,16466,4011,3.03902e+18,1450.33,5522.65,20477,412,350,14467,12200,5861,5260,4266
37177,33,43,35384,1793,36277,900,1.00296e+14,40.7015,879.476,37177,42,40,37051,36955,34310,34361,30982
34375,369,1950,17124,17251,0,34375,5.0584e+18,1426.39,6436.43,34375,494,398,26957,23901,9107,8404,6787
9222,32,43,8675,547,9156,66,1.0579e+14,34.2914,443.176,9222,36,32,9160,9129,8481,8467,8066
35826,1065,1738,16829,18997,16829,18997,5.02337e+18,1361.42,6327.28,35826,487,409,31784,27628,19389,17217,22863
32779,1934,2471,32779,0,27382,5397,3.11191e+18,1670.59,7047.4,32779,500,424,30032,25451,28557,28822,26784
26929,32,43,25552,1377,26421,508,1.03208e+14,40.1598,754.422,26929,41,40,26808,26711,24735,24783,23447
3325,381,470,3321,4,3325,0,5.07814e+18,167.64,1018.41,3325,136,92,2855,2841,2580,2589,2444
36916,2508,2994,36916,0,30110,6806,2.9869e+18,1764.76,8258.21,36916,567,481,33922,33862,33187,33324,33231
29040,613,2243,14959,14081,0,29040,4.95123e+18,1360.9,6075.83,29040,536,369,23810,21205,10099,9845,10148
47911,2190,2908,47911,0,39553,8358,2.98454e+18,1983.73,9219.87,47911,665,474,44735,39864,42064,42725,41010
4146,351,533,4144,2,4146,0,4.82981e+18,182.288,1204.19,4146,143,99,3613,3543,3250,3286,3053
34870,888,1318,0,34870,12284,22586,9.98001e+15,1046.62,5206.32,34870,420,366,32140,28786,21336,17029,24486
29048,439,2182,14944,14104,0,29048,4.9858e+18,1361.08,6062.54,29048,484,375,23166,20576,8253,8539,6463
44737,996,2029,21519,23218,21519,23218,5.03496e+18,1479.17,7459.93,44737,531,452,39098,34439,20848,19807,24566
34320,566,2084,27400,6920,16279,18041,8.4521e+17,1655.9,7001.4,34320,506,430,26176,21861,14392,14472,9855
15025,797,2170,12216,2809,7421,7604,7.99306e+17,1157.56,4683.64,15025,372,317,11703,10022,7799,7663,6114
7174,336,634,7004,170,7174,0,4.63696e+18,214.858,1612.18,7174,164,116,6540,6378,5414,5344,4662
20059,1123,2065,10221,9838,10221,9838,4.86464e+18,1223.37,4995.94,20059,444,323,17219,15485,10500,9953,10836
15306,1365,1615,7191,8115,0,15306,5.19249e+18,1060.14,4053.9,15306,316,297,13498,11933,10757,10379,11903
10995,433,565,10908,87,10995,0,4.71885e+18,346.701,1948.54,10995,147,146,10402,10205,9595,9572,8957
4132,546,927,1420,2712,0,4132,3.62105e+13,141.312,1593.66,4132,177,129,3205,3128,2481,2481,2404
13783,121,352,0,13783,13159,624,2.52513e+16,190.601,1474.13,13783,98,94,13261,13057,11327,10038,8947
46065,151,350,0,46065,43595,2470,2.67067e+16,307.068,2793.05,46065,149,163,44554,43603,36940,32000,28188
24960,703,1347,0,24960,8831,16129,9.91737e+15,1000.42,4488.83,24960,388,328,21984,20166,13523,10457,13936
31208,15,43,29765,1443,30344,864,9.84823e+13,38.3017,801.254,31208,41,39,30477,29941,24858,24220,18991
49081,1330,1741,17421,31660,0,49081,3.88057e+13,1201.39,6731.39,49081,493,432,47047,43746,34950,37017,42574
22395,105,365,0,22395,21249,1146,2.61557e+16,266.921,1970.19,22395,123,127,21422,20972,16937,14507,11329
46276,500,1871,16401,29875,0,46276,3.72084e+13,1161.7,6479.75,46276,592,384,40163,36917,21631,16395,16138
40030,2266,2726,40030,0,32784,7246,3.07621e+18,1983.1,8451.43,40030,695,464,37103,30481,36016,36266,35633
25020,1748,1755,0,25020,8894,16126,9.53487e+15,954.727,4757.26,25020,426,310,23265,23265,23248,23225,23263
4249,441,909,0,4249,1440,2809,9.38779e+15,112.956,1547.23,4249,167,140,3340,3312,2350,2316,2184
5060,259,1247,2877,2183,0,5060,5.15065e+18,214.263,2019.81,5060,237,181,3771,3455,2236,2069,1183
777,344,370,679,98,374,403,4.90497e+17,55.4891,485.418,777,91,51,407,407,406,404,407
16528,351,1282,0,16528,5842,10686,1.00022e+16,854.64,3580.08,16528,305,283,13731,12609,6795,5117,5601
794,26,33,736,58,790,4,1.02097e+14,15.1839,126.291,794,18,19,761,760,700,713,721
42135,1231,1374,0,42135,14895,27240,9.90184e+15,1119.09,5840.1,42135,477,386,40499,35486,35132,32100,38020
20772,882,2035,10978,9794,0,20772,5.00592e+18,1136.96,4944.76,20772,456,316,17605,15970,10206,9527,9761
7564,1065,1779,3872,3692,0,7564,5.037e+18,289.276,2936.06,7564,289,215,5785,5720,4558,4429,3825
2159,246,531,750,1409,0,2159,3.52094e+13,39.0093,888.665,2159,109,89,1628,1615,1119,1070,983
39666,1643,1664,14072,25594,0,39666,3.77994e+13,1152.56,5920.18,39666,505,366,38002,38002,37970,37994,37997
27719,198,1647,9821,17898,0,27719,3.73912e+13,1009,4900.05,27719,440,315,22530,20627,9535,4975,6121
10723,177,347,0,10723,10153,570,2.67722e+16,185.161,1338.8,10723,90,96,10284,10104,9010,8459,7251
1089,80,529,0,1089,432,657,9.06495e+15,47.3627,692.043,1089,143,82,543,477,355,272,210
43735,712,2347,0,43735,0,43735,2.53093e+18,1528.87,7760.39,43735,575,450,36326,30982,13753,13332,17975
31103,2024,2051,24812,6291,14699,16404,8.53392e+17,1616.86,6649.63,31103,482,413,29052,29041,29003,29008,29021
49138,892,918,47855,1283,49138,0,4.60042e+18,616.039,4504.86,49138,292,249,48220,48220,48186,48190,48177
896,87,407,628,268,336,560,1.04561e+18,53.9487,549.028,896,85,58,489,380,191,208,77
10835,77,348,0,10835,10399,436,2.39217e+16,107.682,1244.46,10835,84,84,10386,10205,8657,7660,6334
15512,741,761,15090,422,15512,0,4.59849e+18,411.67,2472.77,15512,206,169,14751,14751,14737,14734,14739
14011,1072,1476,0,14011,4963,9048,9.57566e+15,672.194,3330.58,14011,354,245,12490,11706,10134,8587,11072
4319,783,1331,1953,2366,0,4319,4.7497e+18,197.897,2018.66,4319,234,141,2988,2906,2239,2144,2440
43038,19,43,41037,2001,41892,1146,9.91882e+13,39.8136,939.4,43038,42,41,42433,41964,35722,35417,26221
44023,36,44,41675,2348,43501,522,1.06297e+14,40.6613,966.24,44023,43,42,43926,43845,41597,41605,39794
10335,918,1876,5804,4531,0,10335,5.0953e+18,529.511,3370.48,10335,299,219,8459,7888,5922,5551,5345
32105,29,43,30516,1589,31387,718,1.01333e+14,37.8744,808.396,32105,41,39,31943,31843,28933,28991,26914
964,321,353,0,964,0,964,2.49778e+18,99.8714,533.648,964,85,87,611,611,587,581,600
28694,1743,1837,10176,18518,0,28694,3.67296e+13,1018.93,5103.26,28694,498,317,26857,26857,26797,26819,26857
16217,1027,2018,8669,7548,0,16217,5.00835e+18,939.821,4388.51,16217,363,293,13588,12511,9070,8271,8329
13513,1464,1890,0,13513,0,13513,2.45012e+18,903.494,3991.95,13513,338,276,11589,10516,9011,8709,9987
38224,689,2099,0,38224,0,38224,2.48482e+18,1390.19,6829.22,38224,512,421,32095,28158,14448,13756,15934
8746,1582,1747,4517,4229,0,8746,5.10409e+18,510.195,3116.35,8746,275,242,6999,6758,6552,6468,6895
35131,279,891,34081,1050,35131,0,4.54573e+18,537.824,3772.34,35131,284,223,32956,31085,20746,19364,14352
43698,1483,2436,21768,21930,0,43698,5.08648e+18,1675.42,7863.34,43698,618,440,39931,34576,24592,21126,29887
44541,342,2611,0,44541,0,44541,2.48517e+18,1469.56,7862.88,44541,684,429,35099,30949,12143,6763,7767
20041,334,352,0,20041,19080,961,2.57259e+16,262.462,1823.99,20041,115,119,19677,19328,19493,19465,19038
31821,9,43,30374,1447,30917,904,9.81862e+13,39.6524,807.824,31821,41,39,30011,28814,23547,23539,16023
19044,723,2025,10067,8977,0,19044,5.09035e+18,1088.99,4775.83,19044,410,317,15772,14064,8807,8185,8404
44769,18,43,42240,2529,44321,448,1.06544e+14,41.246,980.021,44769,43,42,43902,43267,35679,35438,26734
46431,46,653,45983,448,46431,0,4.75037e+18,506.754,4111.05,46431,266,257,28139,14785,10217,9368,3959
35559,1337,4464,33493,2066,29473,6086,3.42624e+18,444.656,8539.72,35559,915,380,31095,30647,28624,28680,24026
22820,1036,1332,0,22820,8033,14787,9.82764e+15,967.526,4255.84,22820,362,318,20998,18927,15844,13973,18472
34587,43,834,33818,769,34587,0,4.57774e+18,516.051,3719.4,34587,269,226,21508,12716,8432,7623,2076
46032,105,4129,45477,555,39531,6501,2.10587e+18,966.566,9425.73,46032,837,411,30793,23897,18750,13135,12693
18371,429,584,18181,190,18371,0,4.73413e+18,440.618,2552.54,18371,189,194,17590,17175,15517,15622,13863
42413,863,925,41355,1058,42413,0,4.6276e+18,624.093,4215.54,42413,298,236,41488,41415,41166,41170,40569
42538,85,2516,0,42538,0,42538,2.46488e+18,1418.05,7616.19,42538,567,458,26663,19317,9501,4185,2138
33142,1857,2129,0,33142,0,33142,2.49285e+18,1375.5,6434.04,33142,480,402,31013,30945,27245,26162,30078
33329,651,1765,11879,21450,0,33329,3.73997e+13,1053.03,5430.98,33329,509,344,29456,27138,17669,15959,18086
4804,457,578,4802,2,4804,0,4.66274e+18,227.346,1340.07,4804,203,112,4226,4135,3784,3775,3908
21189,552,777,20557,632,21189,0,4.62026e+18,466.665,2870.35,21189,231,186,20373,19877,18687,18775,17743
21086,80,1838,0,21086,0,21086,2.5508e+18,1181.56,4989.84,21086,378,340,12183,7743,3608,2095,1623
40796,612,1589,14460,26336,0,40796,3.80535e+13,1108.77,5936.98,40796,474,377,35937,32882,19927,18169,19312
10328,958,1447,3611,6717,0,10328,3.60635e+13,471.837,2864.42,10328,324,197,8881,8527,6949,7242,6147
27838,273,349,0,27838,26356,1482,2.6568e+16,280.965,2161.69,27838,128,134,27281,26711,25030,23510,24222
10765,142,650,10598,167,10765,0,4.5851e+18,360.43,2010.27,10765,155,147,9210,7590,4425,4266,2932
42716,35,43,40690,2026,41649,1067,9.98107e+13,41.6288,944.841,42716,43,41,42605,42483,40090,40108,37163
37694,61,352,0,37694,35851,1843,2.57652e+16,297.006,2494.45,37694,137,147,35687,34681,26429,22885,15549
29206,553,2180,15395,13811,0,29206,5.00582e+18,1292.16,5978.82,29206,523,371,23979,21413,11000,10958,9018
29883,677,2214,15327,14556,15327,14556,4.91458e+18,1397.39,6181.77,29883,521,377,24666,21765,10863,11695,10816
4838,802,1374,2259,2579,0,4838,5.11323e+18,281.29,2181.53,4838,209,197,3464,3285,2333,2184,2235
21924,1467,2084,17496,4428,10373,11551,8.42063e+17,1435.95,5589.68,21924,413,366,18949,16065,15348,15191,16155
3573,70,462,3538,35,3573,0,4.94073e+18,189.605,1056.29,3573,95,95,2385,1407,906,846,459
7108,185,342,0,7108,6741,367,2.64692e+16,85.5225,1081.84,7108,81,75,6766,6728,6229,6076,5245
48328,34,42,45922,2406,47263,1065,1.01354e+14,39.2581,980.766,48328,42,41,48222,48120,45518,45529,43430
24373,326,1336,8622,15751,0,24373,3.87603e+13,1004.76,4435.11,24373,383,321,20306,18501,9026,6143,6295
48573,488,1891,0,48573,17189,31384,9.474e+15,1168.71,6665.65,48573,643,382,42079,38539,20908,14140,18768
27071,699,2320,22371,4700,13908,13163,7.51926e+17,1528.87,6326.78,27071,470,375,21344,18303,13166,12951,9156
41991,1573,2429,0,41991,0,41991,2.42436e+18,1428.63,7361.39,41991,628,411,39146,33957,26396,23565,31812
40747,1721,2785,40747,0,34286,6461,3.33966e+18,1685.47,7990.14,40747,660,453,36855,31496,34905,32529,28783
14484,323,2183,11656,2828,6987,7497,8.20446e+17,1165.63,4642.55,14484,365,307,10131,8505,4629,5177,2811
7996,607,1475,2831,5165,0,7996,3.69872e+13,237.33,2563.19,7996,267,194,6521,6329,4514,4656,3353
47298,1232,2067,22538,24760,22538,24760,5.01241e+18,1550.12,7703.5,47298,556,455,42756,37086,25018,23033,31210
35721,1430,2433,29442,6279,18235,17486,7.62153e+17,1664.99,7366.13,35721,535,419,31227,26701,25207,25102,22686
10907,94,349,0,10907,10368,539,2.61422e+16,190.747,1346.17,10907,94,90,10376,10174,8296,7093,5566
5732,21,262,0,5732,5485,247,2.34829e+16,67.1692,828.609,5732,64,56,5141,4804,3835,3282,2374
33869,3620,6738,8516,25353,8516,25353,3.33122e+18,523.427,11554.8,33869,843,521,27131,27131,19711,19651,15509
36416,227,1761,17321,19095,0,36416,5.14867e+18,1401.75,6458.96,36416,489,422,26645,22716,7357,5670,6270
20801,284,384,0,20801,19619,1182,2.701e+16,261.568,1970.81,20801,114,125,20296,19870,18351,17188,16473
3465,48,1322,2703,762,1497,1968,9.21497e+17,172.147,1866.47,3465,177,152,1479,767,433,468,52
39229,196,1755,13899,25330,0,39229,3.7261e+13,1127.88,5893.83,39229,551,357,31991,29256,13395,9442,7098
1579,497,577,0,1579,0,1579,2.59412e+18,48.5079,818.926,1579,127,89,1002,1002,975,978,945
43178,31,43,41091,2087,42117,1061,9.96424e+13,41.394,944.955,43178,43,41,43001,42870,39305,39213,35565
7051,73,1709,3679,3372,3679,3372,4.92106e+18,247.884,2780.5,7051,236,203,4372,3167,1663,1639,278
26872,1290,2177,14075,12797,0,26872,4.95203e+18,1253.21,5745.07,26872,516,355,23956,21263,15404,14171,17162
36028,208,2741,30134,5894,18940,17088,7.18833e+17,1657.1,7549.81,36028,595,404,25012,20104,12053,13550,3100
26700,1209,1463,9454,17246,0,26700,3.82624e+13,1004.29,4738.82,26700,403,326,25043,22395,20781,18406,23789
38994,946,1826,0,38994,13821,25173,9.52426e+15,1128.97,5945.9,38994,556,363,35487,32514,23423,17799,27023
46137,77,1807,0,46137,0,46137,2.53291e+18,1464.11,7317.04,46137,534,456,26720,17211,7634,4392,2361
36545,2150,2683,30455,6090,19208,17337,7.25268e+17,1641.58,7527.31,36545,591,408,33862,33696,30183,29426,31464
10613,379,1732,5438,5175,0,10613,5.22797e+18,706.005,3421.67,10613,270,272,8215,7396,3754,3169,3128
39665,345,352,0,39665,37540,2125,2.67231e+16,303.642,2598.45,39665,145,157,39307,38979,39192,38742,39081
23287,21,43,22206,1081,22654,633,9.8777e+13,38.4575,692.211,23287,39,37,23015,22804,19779,19636,16280
11843,255,347,0,11843,11172,671,2.76293e+16,204.34,1425.46,11843,99,98,11427,11265,10538,10103,10075
26209,1206,1719,12508,13701,12508,13701,5.02173e+18,1308.46,5445.86,26209,427,376,23217,20277,15498,14066,18029
43093,355,2824,35809,7284,22369,20724,7.39261e+17,1755.1,8330.97,43093,666,447,31818,27390,15847,17556,8282
49772,1406,2115,24995,24777,24995,24777,4.96571e+18,1534.52,7867.95,49772,578,463,46073,39733,29895,27975,37617
49618,8,359,0,49618,47299,2319,2.53142e+16,310.873,2848.21,49618,150,160,38851,33698,28528,24784,15249
20885,905,1050,20879,6,20885,0,4.56697e+18,434.602,3297.41,20885,276,191,19835,19826,19520,19510,19250
30945,346,354,0,30945,29529,1416,2.51859e+16,276.798,2221.05,30945,128,132,30590,30381,30519,30465,30312
18992,755,2051,15196,3796,8994,9998,8.41287e+17,1414.37,5214.3,18992,389,352,14635,12235,8985,8784,7516
35033,101,354,0,35033,33418,1615,2.49887e+16,284.194,2363.36,35033,130,140,33732,33128,27157,23234,18752
34063,2831,4496,10305,23758,0,34063,3.1958e+17,648.525,8813.2,34063,839,501,29567,29567,19883,20430,14449
2503,23,30,2350,153,2493,10,1.04471e+14,19.7231,195.525,2503,21,23,2470,2456,2344,2351,2305
15345,347,1427,5422,9923,0,15345,3.74171e+13,786.947,3540.43,15345,343,266,12801,11863,6167,4729,4362
35262,1454,1865,12474,22788,0,35262,3.77068e+13,1119.77,5865.4,35262,531,355,33308,31212,27414,28181,30804
48389,5893,8761,4282,44107,0,48389,1.64783e+18,722.337,14803.9,48389,966,665,39628,39628,35437,35612,30579
14709,721,2021,7845,6864,7845,6864,4.92641e+18,847.288,4175.71,14709,353,289,11989,10942,6811,6593,5051
19734,1277,1986,0,19734,0,19734,2.48696e+18,1141.87,4850.32,19734,379,321,17282,15485,11777,10706,12920
20377,2154,2434,20377,0,16842,3535,3.31026e+18,1414.65,5596.64,20377,458,338,17943,17079,17669,17725,17339
42685,1853,2362,0,42685,0,42685,2.45691e+18,1450.78,7353.29,42685,593,423,40323,40075,32685,30156,36882
48691,700,2493,0,48691,0,48691,2.43462e+18,1507.54,7991.24,48691,660,437,40996,36002,16376,18166,17844
37458,370,684,37104,354,37458,0,4.78634e+18,497.202,3735.62,37458,251,236,35971,34692,28176,27863,23832
24440,1375,1488,0,24440,8717,15723,9.73714e+15,981.495,4490.21,24440,383,319,22952,21713,21896,20918,22426
3295,357,713,1134,2161,0,3295,3.61006e+13,80.2522,1240.97,3295,162,114,2582,2570,1705,1572,1420
15139,1694,2040,0,15139,0,15139,2.4046e+18,889.504,4245.86,15139,375,285,13099,12036,11037,10862,12042
34709,684,1361,0,34709,12282,22427,9.92947e+15,1090.19,5306.08,34709,452,364,30863,27999,18132,13650,19146
40776,470,2262,33075,7701,20045,20731,8.05273e+17,1720.91,7807.54,40776,564,458,30715,26035,15838,16257,7717
13574,140,350,0,13574,12989,585,2.47961e+16,169.454,1437.23,13574,92,97,13090,12928,11307,10382,8155
12560,1310,1786,5978,6582,5978,6582,5.03574e+18,912.376,3837.84,12560,301,272,10546,9588,8100,7779,9386
23274,843,1557,8286,14988,0,23274,3.91517e+13,969.536,4548.18,23274,368,324,20846,18994,13479,12184,14805
22559,1939,2204,11960,10599,0,22559,5.03428e+18,1139.43,5323.23,22559,412,332,20355,20342,19133,18788,18554
39974,813,1832,0,39974,14194,25780,9.50362e+15,1113.31,5972.05,39974,559,362,35948,33022,22445,15848,25601
46526,1642,2247,23855,22671,0,46526,5.05829e+18,1460.9,7650.03,46526,563,441,44157,37854,32173,29799,38287
40845,2096,2314,0,40845,0,40845,2.43499e+18,1482.81,7215.78,40845,597,416,38531,38531,36012,35002,37382
10670,216,1851,0,10670,0,10670,2.38636e+18,626.669,3435.21,10670,337,227,7937,6985,3184,1776,1591
24136,1195,1587,8534,15602,0,24136,3.70575e+13,1001.4,4538.17,24136,438,301,22286,20304,17599,17313,17001
15082,788,1865,0,15082,0,15082,2.46741e+18,975.043,4202.99,15082,357,284,12387,11320,6842,6316,6432
44873,2344,2427,23577,21296,0,44873,5.00306e+18,1453.63,7586.83,44873,643,430,42446,42446,42196,41939,41790
47175,885,1631,16713,30462,0,47175,3.82781e+13,1135.54,6410.89,47175,560,396,43290,39163,27855,27286,31345
7735,665,1948,7735,0,6134,1601,3.08556e+18,548.518,3228.63,7735,245,203,5666,4998,3365,3199,3128
4640,1261,1290,2202,2438,0,4640,4.9665e+18,168.113,2018.59,4640,202,174,3350,3350,3344,3336,3335
16318,1526,2032,13112,3206,7836,8482,8.28075e+17,1296.81,4800.64,16318,357,320,13885,11919,11839,11484,11865
16877,351,1841,8581,8296,8581,8296,5.02652e+18,1067.41,4424.92,16877,337,315,13089,11769,5449,5015,4272
47141,228,809,46282,859,47141,0,4.60702e+18,537.091,4305.09,47141,268,252,43613,40308,22174,21902,16306
15167,1341,2188,15167,0,12343,2824,3.11746e+18,1180.75,4737.93,15167,363,322,12415,10959,10830,10321,8904
44194,47,348,0,44194,41888,2306,2.64661e+16,304.553,2722.53,44194,148,157,41310,39480,29288,25278,15743
18121,45,2415,18121,0,15350,2771,3.31178e+18,1174.3,5151.14,18121,421,327,9282,6279,3727,3505,409
16164,38,42,15228,936,16030,134,1.06433e+14,38.133,580.871,16164,38,35,16114,16097,15971,15971,15270
46242,1059,2499,24278,21964,0,46242,4.99803e+18,1473.45,7788.2,46242,631,437,40699,36206,20916,20176,23806
42809,29,43,40536,2273,42128,681,1.0371e+14,40.2731,948.918,42809,43,42,42570,42421,38102,38122,34291
38988,634,868,37919,1069,38988,0,4.54817e+18,585.681,3985.77,38988,294,230,38058,37073,35466,35515,32755
12181,16,43,11625,556,11843,338,9.92941e+13,36.637,508.845,12181,36,35,11902,11699,9790,9778,7804
5622,58,1114,0,5622,1988,3634,9.66581e+15,209.731,1985.36,5622,208,186,3921,3250,1596,1005,461
40340,528,2882,33685,6655,21205,19135,7.22418e+17,1688.5,8058.77,40340,655,419,31346,27140,17022,18162,10609
3601,315,430,3587,14,3601,0,4.88271e+18,192.261,1028.73,3601,95,95,3171,3130,2850,2847,2727
14598,1279,1475,5190,9408,0,14598,3.77424e+13,698.478,3404.75,14598,366,246,13123,12317,11810,11230,12787
2469,24,37,2377,92,2346,123,9.51934e+13,16.3908,215.138,2469,20,21,2432,2427,2331,2330,2291
20792,742,1796,0,20792,0,20792,2.50184e+18,1177.48,4901.07,20792,395,326,17227,15362,8544,7565,8763
19894,357,1582,7111,12783,0,19894,3.78055e+13,937.519,4142.61,19894,377,288,16684,15346,7766,6541,4195
43155,115,2575,35481,7674,21930,21225,7.66635e+17,1711.11,8189.51,43155,610,453,26087,17135,12026,12131,2114
17439,151,1592,6190,11249,0,17439,3.73166e+13,868.782,3877.98,17439,382,270,13800,12319,5714,2872,1106
4098,726,1075,0,4098,0,4098,2.55509e+18,171.885,1712.64,4098,221,166,3023,2946,2679,2710,1806
28490,21,43,27083,1407,27895,595,1.01466e+14,39.1504,774.046,28490,41,40,28138,27849,23905,23730,19614
30213,4,43,28501,1712,29898,315,1.06915e+14,37.9868,783.936,30213,40,39,23861,20924,18085,18038,11469
1739,294,506,0,1739,607,1132,1.01949e+16,89.6906,801.349,1739,104,110,1233,1221,815,756,827
25087,8,43,23994,1093,24266,821,9.66602e+13,35.8542,712.516,25087,39,37,23432,22360,18454,18273,12482
42364,473,2636,0,42364,0,42364,2.45003e+18,1385.07,7541.46,42364,586,424,34544,30699,13497,12218,10540
38764,705,749,37987,777,38764,0,4.66057e+18,548.246,3874.62,38764,261,236,38015,38014,37742,37774,37641
22729,29,43,21690,1039,22051,678,9.69791e+13,37.9328,680.149,22729,38,35,22605,22529,20805,20752,18789
8318,988,1312,2901,5417,0,8318,3.79535e+13,426.279,2552.72,8318,252,193,7006,6682,5880,5618,6196
29748,1747,2665,29748,0,25016,4732,3.29447e+18,1565.46,6825.58,29748,537,382,26566,22798,24999,23687,20632
16334,1071,1529,0,16334,5835,10499,9.63885e+15,833.084,3713.04,16334,332,257,14489,13492,11149,9092,12005
33349,2348,2737,27700,5649,17290,16059,7.38736e+17,1649.59,7305.85,33349,594,402,30612,30611,28670,28193,29888
22161,308,1899,10956,11205,10956,11205,4.97524e+18,1221.33,5152.35,22161,395,344,16955,14890,5878,5897,4819
48016,185,2564,25356,22660,25356,22660,4.91051e+18,1502.45,7963.2,48016,676,432,35575,29062,12917,14256,5430
36616,428,2579,0,36616,0,36616,2.43981e+18,1473.1,7141.6,36616,565,402,29380,25706,10234,6684,8392
31804,201,354,0,31804,30359,1445,2.50517e+16,272.739,2246.59,31804,127,139,31019,30458,27678,25527,22635
26549,741,916,25870,679,26549,0,4.58842e+18,498.85,3345.92,26549,234,203,25633,25594,24700,24683,23718
41004,228,357,0,41004,39074,1930,2.53707e+16,301.298,2583.2,41004,139,151,40160,39349,36071,33196,30324
25859,15,42,24471,1388,25502,357,1.05073e+14,37.38,720.129,25859,40,38,25211,24728,20440,19869,14703
14536,803,2007,0,14536,0,14536,2.4174e+18,884.929,4160.77,14536,365,278,11821,10913,6497,6192,6485
38228,1881,2038,30585,7643,18202,20026,8.37083e+17,1673.33,7333.78,38228,522,445,35994,29524,33893,33358,34666
47085,103,643,46578,507,47085,0,4.75425e+18,519.327,4143.4,47085,259,263,37426,26480,14822,14993,8340
26070,206,1637,9254,16816,0,26070,3.72466e+13,981.486,4702.9,26070,442,302,21384,19683,9499,5138,6665
48537,36,2491,39260,9277,23271,25266,8.12628e+17,1897.94,8877.6,48537,598,484,18364,8271,4876,5022,971
18615,942,1543,6608,12007,0,18615,3.68282e+13,833.835,3877.86,18615,401,259,16626,15558,12452,12261,12799
20455,572,2432,20455,0,16914,3541,3.29684e+18,1415.82,5606.23,20455,462,337,15608,13588,8757,7618,6207
36750,704,2132,36750,0,29410,7340,2.94024e+18,1677.89,7308.2,36750,488,442,28816,23804,14682,13532,13146
26471,430,2539,26471,0,22172,4299,3.266e+18,1488.22,6357.72,26471,559,374,19925,17542,10970,9085,5228
34901,553,1940,0,34901,12409,22492,9.56515e+15,1152.73,5815.37,34901,607,352,30337,27762,16359,10449,12249
10259,326,348,0,10259,9768,491,2.6206e+16,173.182,1298.68,10259,91,82,9911,9821,9875,9878,9637
34707,412,2030,27819,6888,16606,18101,8.31828e+17,1642.3,6980.09,34707,503,429,25393,21635,12607,13022,8231
11419,1624,1755,5796,5623,5796,5623,5.02639e+18,803.671,3593.63,11419,282,273,9664,8915,9030,9021,9172
12268,618,1483,4387,7881,0,12268,3.73729e+13,570.689,3089.27,12268,304,236,10551,9944,7144,6966,7247
27998,1738,1995,14137,13861,0,27998,5.05816e+18,1320.34,5830.67,27998,452,380,26003,25589,23092,22624,25124
8237,1112,1933,4260,3977,4260,3977,4.86893e+18,364.85,3167.81,8237,292,219,6304,6157,4809,4936,4013
5737,118,1263,1997,3740,0,5737,3.66054e+13,163.062,2093.11,5737,230,165,4280,3603,1500,734,445
17646,738,1584,6269,11377,0,17646,3.74366e+13,894.768,3921.3,17646,376,271,15405,14230,9695,9618,8003
34895,1605,2209,28179,6716,16940,17955,8.16099e+17,1653.79,7182.3,34895,525,424,31322,26213,26265,25531,26826
28052,1242,2437,23077,4975,14261,13791,7.70625e+17,1564.11,6585.48,28052,482,391,23577,20450,18407,18096,15327
48149,1991,2338,24665,23484,0,48149,4.98621e+18,1540.15,7896.11,48149,637,445,45811,45810,38637,37499,44067
872,21,27,808,64,872,0,1.133e+14,18.3773,113.107,872,18,16,841,833,787,789,744
1877,34,150,0,1877,1752,125,2.68729e+16,42.1401,400.592,1877,41,40,1671,1538,1235,1156,856
27369,1185,2560,27369,0,22851,4518,3.21056e+18,1460.73,6468.07,27369,554,382,23114,20076,18574,17683,15423
18671,345,2136,18671,0,15161,3510,3.07755e+18,1354.11,5223.05,18671,379,339,13227,11242,5755,5002,3283
22390,377,2452,18721,3669,11904,10486,7.1652e+17,1354.7,5739.48,22390,472,347,16743,14879,8784,9389,4321
42125,274,1870,20395,21730,0,42125,5.13913e+18,1439.3,7067.08,42125,513,440,31748,27111,9168,7589,7477
18438,785,2434,18438,0,15215,3223,3.36617e+18,1352.39,5340.02,18438,459,341,14347,12462,9283,8914,6820
35137,169,1831,12512,22625,0,35137,3.75138e+13,1110.33,5697.1,35137,526,355,28107,25683,11537,8352,4907
12989,1687,2049,10415,2574,6179,6810,8.40038e+17,1128.75,4314.51,12989,326,306,10707,9447,9624,9377,9444
35965,38,43,33922,2043,35626,339,1.06713e+14,41.5401,882.479,35965,43,41,35887,35829,35229,35226,33274
12804,1426,1459,0,12804,4570,8234,9.6705e+15,637.563,3175.56,12804,318,242,11345,10970,11277,10795,11267
15406,28,43,14616,790,15100,306,1.02242e+14,38.8486,569.771,15406,37,35,15292,15241,13687,13713,12029
6710,14,337,0,6710,6365,345,2.59881e+16,64.2334,1029.56,6710,75,72,5605,5012,3999,3602,2086
30692,31,43,29245,1447,29852,840,9.85973e+13,38.8622,795.543,30692,41,39,30557,30474,28096,28082,25175
1154,340,510,588,566,0,1154,5.70931e+18,65.1464,714.685,1154,85,89,644,643,626,631,551
26060,435,2295,0,26060,0,26060,2.45914e+18,1336.24,5953.98,26060,522,356,20630,17962,7392,5111,6602
24991,834,2168,20092,4899,11991,13000,8.32635e+17,1499.37,6071.55,24991,449,376,19730,16584,12778,12312,10003
35799,810,925,35177,622,35799,0,4.66911e+18,535.573,3929.9,35799,303,230,34874,34844,34239,34219,33613
38957,170,351,0,38957,36810,2147,2.69276e+16,304.281,2581.38,38957,143,153,37741,36829,32005,27690,24245
4461,910,1292,2300,2161,0,4461,5.52233e+18,227.787,2035.24,4461,172,152,3169,3128,2944,2948,2693
11222,1714,1870,0,11222,0,11222,2.39317e+18,606.134,3492.33,11222,330,226,9352,8887,8972,8914,8550
27909,2102,2614,27909,0,23315,4594,3.24359e+18,1552.54,6594.14,27909,544,384,25295,21919,24654,24808,23264
6127,392,1257,2171,3956,0,6127,3.84789e+13,162.365,2163.44,6127,184,167,4870,4708,2992,2565,2244
20391,139,846,19938,453,20391,0,4.65852e+18,453.369,2902.09,20391,238,181,17543,14314,8055,7728,4706
39531,1339,2978,35,39496,14567,24964,9.69395e+15,905.568,7378.88,39531,843,410,36553,36237,18890,16968,13377
44883,222,772,44005,878,44883,0,4.58635e+18,548.277,4183.39,44883,257,245,41390,38048,19781,19073,15738
20146,52,351,0,20146,19166,980,2.59603e+16,255.55,1819.23,20146,110,117,18978,18313,14081,12041,7835
29240,85,346,0,29240,27731,1509,2.6413e+16,284.292,2208.39,29240,129,133,27876,27295,21300,18603,12984
15814,1626,1983,8407,7407,8407,7407,4.92504e+18,949.55,4319.93,15814,348,293,13801,12584,11627,11317,12372
32278,333,1562,0,32278,11413,20865,9.93183e+15,1059.43,5314.39,32278,424,359,27034,24550,12023,8834,10553
8438,34,43,8057,381,8212,226,9.84065e+13,34.979,421.053,8438,31,29,8388,8367,8001,7999,7788
26367,2051,2573,26367,0,21949,4418,3.11662e+18,1494.4,6393.12,26367,508,368,23794,20448,23167,23247,22445
35660,22,43,34004,1656,34716,944,9.92664e+13,39.2875,855.594,35660,41,40,35305,34980,30259,30171,23939
6033,52,1081,0,6033,2130,3903,9.45572e+15,162.923,1933.58,6033,251,181,4412,3680,1924,972,494
38771,373,929,37718,1053,38771,0,4.60903e+18,565.376,4017,38771,306,228,36921,35488,24579,24603,20653
24891,1011,1715,0,24891,0,24891,2.52816e+18,1292.05,5300.63,24891,412,360,21436,18986,13056,10240,14698
32250,259,352,0,32250,30581,1669,2.64078e+16,297.523,2348.94,32250,137,143,31589,30930,28568,27149,25653
16747,1751,2370,16747,0,13918,2829,3.28433e+18,1224.14,5009.32,16747,420,324,14187,12518,13644,13265,11364
37127,2036,2733,37127,0,31049,6078,3.29598e+18,1653.97,7615.25,37127,614,428,34329,29113,32986,32560,30280
37966,11,43,35929,2037,37370,596,1.0355e+14,41.3466,896.888,37966,43,41,36182,34853,28483,27632,18506
37998,1378,1826,13506,24492,0,37998,3.73422e+13,1106.23,5874.83,37998,545,358,36154,32626,28730,29949,34529
13758,1456,1464,4861,8897,0,13758,3.78133e+13,747.416,3408.33,13758,308,249,12294,12294,12279,12292,12293
40538,1592,1769,0,40538,0,40538,2.5103e+18,1432.33,6805.09,40538,507,433,38532,32615,32000,30462,37198
38449,1558,2332,20070,18379,0,38449,5.00653e+18,1456.34,7028.63,38449,583,414,35577,30925,24502,22357,29298
47333,329,2112,37925,9408,22609,24724,8.40704e+17,1743.09,8240.9,47333,567,481,33527,28021,15612,16926,6993
3619,263,1034,0,3619,0,3619,2.52618e+18,177.088,1605.04,3619,206,168,2585,2380,1696,1672,809
28811,569,1733,13706,15105,13706,15105,5.00358e+18,1331.46,5696.41,28811,439,387,23390,20373,9197,8524,10594
31141,1158,1541,0,31141,11054,20087,9.7119e+15,1065.05,5152.85,31141,447,340,29127,26150,21997,16928,25567
10844,385,1374,0,10844,3896,6948,1.00022e+16,556.632,2923.66,10844,248,241,9024,8411,5134,3454,4095
8560,245,1825,4401,4159,0,8560,4.93068e+18,385.921,3090.22,8560,316,218,6404,5698,2748,2247,1545
21596,1556,1641,0,21596,7700,13896,9.59312e+15,925.286,4333.88,21596,407,286,19955,19955,19464,19244,19837
34902,1483,2297,18393,16509,18393,16509,4.87886e+18,1359.06,6614.74,34902,574,387,32005,28084,21676,20829,25066
5248,706,1073,1904,3344,0,5248,3.99104e+13,190.5,1876.68,5248,219,147,4175,4137,3709,3876,2980
23577,93,1496,0,23577,8350,15227,9.76011e+15,983.408,4477.45,23577,379,313,17562,14554,6697,4285,1019
47666,39,357,0,47666,45450,2216,2.54332e+16,307.115,2790.98,47666,147,161,44423,42378,32612,28089,17811
35812,399,1910,17513,18299,17513,18299,4.99386e+18,1425.2,6546.02,35812,509,421,28283,24716,9399,9216,9612
15807,2280,2388,15807,0,13239,2568,3.34173e+18,1131.2,4859.71,15807,379,288,13419,13415,13348,13297,12811
6850,102,590,6732,118,6850,0,4.6083e+18,241.04,1562.23,6850,129,121,5404,3940,2253,2229,1292
23110,413,765,22656,454,23110,0,4.52696e+18,500.912,3034.66,23110,238,203,21996,21292,15447,15757,14531
38534,26,42,36502,2032,37907,627,1.03696e+14,40.0351,887.138,38534,42,41,38272,38113,33568,33736,27945
12294,2,43,11722,572,11986,308,1.00373e+14,32.2539,493.399,12294,35,32,7566,6173,5887,6245,4452
9806,871,1674,0,9806,3445,6361,9.77419e+15,496.081,3107.59,9806,322,223,8132,7730,5186,5251,5726
13156,1124,1416,4665,8491,0,13156,3.7811e+13,721.607,3289.61,13156,307,231,11678,10859,9551,9719,10531
11538,26,43,10980,558,11272,266,1.02022e+14,30.7963,479.056,11538,35,32,11455,11408,10412,10425,9276
45039,80,2687,45039,0,37955,7084,3.27683e+18,1841.95,8338.25,45039,717,457,26326,18432,11644,10595,1634
26388,1872,2563,26388,0,22090,4298,3.32286e+18,1522.53,6379.78,26388,553,369,23619,20280,22675,22117,21476
2206,491,540,764,1442,0,2206,3.56062e+13,42.1111,911.561,2206,107,94,1666,1666,1656,1653,1599
23281,2424,2710,23281,0,19220,4061,2.92726e+18,1454.66,6380.17,23281,435,340,20571,20560,20226,20248,20013
11422,1226,1688,0,11422,0,11422,2.57054e+18,853.704,3562.51,11422,280,272,9570,8657,7164,6698,8322
42147,37,43,40172,1975,41002,1145,9.86738e+13,39.0879,928.023,42147,42,40,42067,42004,40297,40303,38780
16167,1843,2361,16167,0,13454,2713,3.27353e+18,1178.23,4911.82,16167,385,306,13718,12137,13291,13196,12054
29533,1220,1560,10443,19090,0,29533,3.77057e+13,1039.09,5021.33,29533,436,327,27759,24937,21783,21360,25394
43532,85,2807,36446,7086,23147,20385,7.16587e+17,1701.66,8278.7,43532,645,438,25361,17317,12037,12353,1957
36610,1220,1484,0,36610,12931,23679,9.67727e+15,1102.06,5541.97,36610,452,369,34768,30827,27825,24213,32103
15006,188,673,14757,249,15006,0,4.74119e+18,393.568,2366.4,15006,197,172,13528,12050,7080,7235,5202
45693,1272,3001,45693,0,37505,8188,3.02779e+18,1805.88,9074.08,45693,648,473,38838,33280,27351,24434,24689
27962,99,1677,0,27962,9950,18012,9.56278e+15,1004.44,4893.21,27962,473,321,21668,18564,9495,4624,2855
19743,200,2361,19743,0,16377,3366,3.26387e+18,1311.97,5401.03,19743,410,342,13471,10754,6165,5204,1751
41828,208,356,0,41828,39977,1851,2.47382e+16,285.589,2566.99,41828,140,151,40926,40157,36725,33851,30292
14701,1484,2393,14701,0,12351,2350,3.34541e+18,1035.37,4657.75,14701,389,299,12033,10900,11555,10992,7900
28582,443,1727,10193,18389,0,28582,3.747e+13,1011.73,5004.67,28582,482,321,24553,22648,13155,12549,8017
32818,2323,3404,11162,21656,2,32816,2.85159e+13,658.864,7854.28,32818,366,568,29414,29342,26240,25718,23754
34441,2341,2378,0,34441,0,34441,2.43186e+18,1400.13,6706.46,34441,549,393,32063,32063,32031,31855,32060
28626,1655,1957,14216,14410,14216,14410,4.94539e+18,1354.02,5897.63,28626,443,385,26606,23023,21630,20848,24817
19563,1288,2430,19563,0,16150,3413,3.30278e+18,1434.77,5503.39,19563,475,345,16256,14072,14119,13243,10254
48264,736,1964,23672,24592,0,48264,5.11493e+18,1496.26,7640.94,48264,577,458,40817,35377,18010,15844,18855
31117,1205,2053,15647,15470,0,31117,5.05797e+18,1360.62,6172.94,31117,500,398,27720,24364,17173,15368,20338
9513,1069,1324,0,9513,3353,6160,9.76822e+15,531.499,2736.13,9513,254,208,8189,7725,6909,6761,7509
27371,1062,2145,13992,13379,0,27371,5.03602e+18,1329.07,5854.94,27371,484,368,23769,21214,13499,12527,15715
25851,133,1999,13013,12838,13013,12838,4.91787e+18,1326.21,5616.07,25851,447,362,17907,12894,6053,6353,2296
29192,1311,2243,0,29192,0,29192,2.44973e+18,1437.17,6123.31,29192,501,371,26005,22920,16433,14833,18430
14340,72,1517,5018,9322,0,14340,3.85845e+13,804.992,3589.19,14340,322,270,9925,8048,3579,1356,937
6873,441,605,6746,127,6873,0,4.60113e+18,234.512,1576.65,6873,141,124,6268,6217,5953,5970,5672
45978,315,939,44721,1257,45978,0,4.58486e+18,628.559,4385.97,45978,295,241,43447,41346,26239,25574,20262
15501,1417,2030,8197,7304,0,15501,4.9971e+18,959.159,4322.88,15501,385,295,13293,12129,10421,9866,11303
19458,1295,1899,9626,9832,0,19458,5.00766e+18,1155.26,4791.96,19458,390,330,17134,15191,11797,10716,14328
44794,1460,3039,44794,0,37364,7430,3.0334e+18,1511.84,8808.31,44794,603,424,40118,35559,30931,29112,24687
47967,422,2880,40007,7960,25158,22809,7.28644e+17,1771.64,8780.15,47967,669,454,36315,31837,18886,20392,9249
32000,1309,2312,0,32000,0,32000,2.4418e+18,1402.02,6436.73,32000,541,386,28541,25173,17853,16054,20087
18910,1706,2127,15368,3542,9335,9575,7.96338e+17,1366.07,5232.86,18910,378,330,16562,14157,14491,13979,15048
46668,363,962,45312,1356,46668,0,4.57548e+18,607.799,4401.78,46668,310,244,44514,42762,30832,30326,23505
21172,1202,1637,7512,13660,0,21172,3.69337e+13,917.195,4268.33,21172,422,284,19344,17747,15103,15535,17116
5404,750,1112,0,5404,1946,3458,9.28934e+15,165.133,1889.03,5404,202,146,4292,4219,3937,3826,3819
45823,350,352,0,45823,43414,2409,2.64845e+16,309.704,2784.4,45823,151,161,45471,45471,45462,45470,45457
2679,16,42,2515,164,2677,2,1.04542e+14,22.8055,239.099,2679,26,26,2591,2526,2132,2097,1513
40970,182,942,39853,1117,40970,0,4.54104e+18,579.587,4136.41,40970,265,235,36935,32994,17382,17213,10761
36093,242,2828,23034,13059,16635,19458,2.06759e+14,297.126,5883.27,36093,831,325,32146,30824,22106,20951,18264
7001,730,1683,0,7001,0,7001,2.49571e+18,271.579,2744.28,7001,274,195,5318,5028,3500,3410,2390
31567,766,1538,11157,20410,0,31567,3.77011e+13,1075.32,5206,31567,446,340,28243,25730,17439,17143,19857
31629,775,1760,11211,20418,0,31629,3.72866e+13,1064.75,5314.15,31629,510,334,28129,25926,17241,16242,19115
25967,1515,1709,12264,13703,0,25967,5.14661e+18,1310.18,5419.1,25967,418,372,23947,20576,19472,19089,23005
43852,1128,1568,43835,17,43852,0,4.61993e+18,573.129,5402.86,43852,297,265,42284,42239,34294,33802,25825
9179,2119,2120,9179,0,7405,1774,3.03885e+18,668.37,3621.21,9179,258,232,7059,7059,7059,7059,7059
27142,1016,1985,13776,13366,0,27142,5.04133e+18,1271.44,5682.8,27142,460,368,23563,21053,13649,12173,15069
20878,695,2552,20878,0,17342,3536,3.26368e+18,1396.96,5737.14,20878,481,341,16155,13988,9828,9255,6147
15077,417,745,14656,421,15077,0,4.63793e+18,410.176,2423.34,15077,224,162,14180,13832,11901,11930,9309
42066,472,936,40781,1285,42066,0,4.43911e+18,586.059,4161.2,42066,282,238,40587,39321,29835,30150,27438
2306,115,911,1898,408,1194,1112,7.30788e+17,103.922,1308.8,2306,133,137,1243,759,511,560,359
31073,1227,2645,31073,0,25926,5147,3.15449e+18,1613.73,6988.47,31073,574,408,26155,22737,22567,20953,18503
42304,693,2350,22177,20127,22177,20127,4.97938e+18,1421.58,7347.48,42304,573,432,35594,31330,16118,18023,16425
10496,403,1513,3731,6765,0,10496,3.77253e+13,520.403,2971.24,10496,299,242,8667,8117,4512,4695,3395
25683,574,916,25048,635,25683,0,4.60102e+18,504.582,3304.62,25683,257,201,24735,24048,21586,21540,19087
17605,623,1701,0,17605,0,17605,2.52967e+18,1131.25,4432.15,17605,361,318,14201,12386,6262,5430,6848
28749,32,43,27244,1505,28253,496,1.03234e+14,39.2389,774.9,28749,41,40,28625,28535,26400,26455,24596
3258,361,1043,1547,1711,1547,1711,4.93587e+18,141.877,1548.93,3258,182,146,2215,2162,876,821,790
32498,1909,2279,0,32498,0,32498,2.43677e+18,1360.45,6408.25,32498,531,378,30219,30092,26451,26214,28276
23461,758,1508,0,23461,8321,15140,9.80516e+15,983.582,4482.95,23461,385,301,20854,19104,12505,10036,12218
26249,671,790,25673,576,26249,0,4.62714e+18,487.816,3231.11,26249,244,207,25459,25412,25020,25022,24528
39619,1002,1734,0,39619,0,39619,2.5478e+18,1439.75,6711.09,39619,509,431,34728,30375,20594,15917,23450
14604,158,348,0,14604,13965,639,2.48383e+16,197.628,1509.28,14604,100,100,14096,13897,12564,11266,10176
40744,35,43,38644,2100,40000,744,1.0326e+14,41.0766,927.443,40744,43,42,40633,40508,38154,38236,35371
21861,41,43,20672,1189,21585,276,1.04963e+14,38.9208,679.005,21861,40,38,21813,21797,21757,21756,21254
31557,20,43,30094,1463,30712,845,9.93376e+13,40.8966,810.573,31557,41,39,31147,30844,26424,26174,20221
28725,1562,2233,28725,0,23411,5314,3.07269e+18,1636.89,6584.35,28725,512,416,25306,21339,22598,21347,19534
13743,2279,2319,11526,2217,7267,6476,7.21253e+17,1037.59,4511.75,13743,350,293,11424,11422,11384,11394,11099
44194,2275,2369,23386,20808,23386,20808,4.93455e+18,1470.63,7495.81,44194,598,425,41825,41825,41345,41240,41323
31485,525,1458,11181,20304,0,31485,3.8505e+13,1061.77,5134.64,31485,417,352,27281,24819,14375,14077,12459
1390,71,497,1390,0,1153,237,2.67393e+18,127.24,744.802,1390,93,99,576,227,248,135,225
31183,230,360,0,31183,29706,1477,2.53056e+16,287.758,2274.21,31183,127,135,30465,29902,27502,25462,23204
2301,43,385,853,1448,0,2301,3.84291e+13,41.7314,643.409,2301,131,65,1893,1731,1239,1533,90
8652,1543,1993,4536,4116,4536,4116,4.94443e+18,281.019,3282.38,8652,262,222,6659,6625,6169,6063,5157
6318,1183,1819,6318,0,5355,963,3.30585e+18,194.751,2740.79,6318,221,175,4499,4479,4410,4359,2624
24954,11,43,23761,1193,24332,622,1.00661e+14,38.0651,714.562,24954,39,38,23902,23115,19085,18544,13486
22642,815,2491,22642,0,18997,3645,3.32585e+18,1452.53,5896.34,22642,491,355,17923,15483,11778,10870,8587
8963,132,1862,4505,4458,0,8963,5.14643e+18,469.721,3275.72,8963,284,248,5916,3955,1998,1477,1060
8628,355,1469,3067,5561,0,8628,3.7363e+13,254.485,2615.71,8628,239,180,7123,6736,3990,3330,3193
43634,1578,2595,35935,7699,22239,21395,7.61723e+17,1717.42,8247.51,43634,613,452,39141,33050,31595,31419,29832
45043,1646,2898,45043,0,37514,7529,3.32408e+18,1753.61,8557.44,45043,673,456,40639,34236,39000,35779,31144
8451,490,614,8283,168,8451,0,4.65179e+18,307.534,1758.23,8451,158,141,7837,7736,7282,7295,7145
42066,155,352,0,42066,39644,2422,2.72927e+16,313.392,2700.99,42066,152,163,40591,39607,33367,28653,23720
12385,1209,1876,6710,5675,6710,5675,4.96664e+18,776.5,3710.27,12385,335,266,10509,9638,8070,7505,8040
21341,634,2151,0,21341,0,21341,2.40996e+18,1174.14,5153.5,21341,467,326,17386,15558,7716,6405,7401
44447,1788,1902,0,44447,15826,28621,9.58816e+15,1141.66,6392.9,44447,569,380,42545,42545,41941,41700,42387
25423,725,2126,13437,11986,0,25423,5.04795e+18,1272.07,5580.67,25423,457,348,21275,18799,10547,10205,9916
48432,1513,2175,0,48432,0,48432,2.50949e+18,1532.88,7878.47,48432,555,459,45471,38636,29769,27104,39120
36926,2024,2351,36926,0,29966,6960,3.03564e+18,1682.35,7500.16,36926,511,442,34575,32918,33570,33612,33549
40621,168,352,0,40621,38285,2336,2.7311e+16,308.671,2641.26,40621,146,158,39266,38286,32964,28399,26251
24458,771,2064,0,24458,0,24458,2.4317e+18,1299.46,5457.5,24458,458,341,20551,18312,10728,10264,10497
33841,532,1810,0,33841,11947,21894,9.46765e+15,1091.18,5597.69,33841,558,366,29336,26919,15204,10551,13995
49261,353,2487,49261,0,40217,9044,3.12992e+18,1767.87,8723.48,49261,594,484,35744,30396,15760,12751,9625
47542,1383,1580,16876,30666,0,47542,3.9008e+13,1140.71,6452.2,47542,506,399,45962,45061,39015,38541,43719
7564,270,1793,0,7564,0,7564,2.43072e+18,237.702,2913.78,7564,250,187,5639,5043,2432,2045,1561
13804,1082,1315,4911,8893,0,13804,3.92658e+13,787.382,3330.21,13804,292,255,12298,11292,10289,10205,11111
44941,2253,2421,44941,0,36814,8127,2.98262e+18,1801.88,8335.7,44941,587,473,42520,42518,42104,42121,42375
3179,28,37,3094,85,2959,220,8.13705e+13,17.5505,228.929,3179,20,20,3142,3139,3090,3090,3075
11656,549,2193,11656,0,9709,1947,3.25108e+18,798.933,3984.24,11656,351,244,8767,7933,5571,4395,3766
16193,311,1320,5743,10450,0,16193,3.89224e+13,854.185,3600.37,16193,317,276,13367,12183,6094,4904,5080
42795,5049,7738,35038,7757,19579,23216,8.20501e+17,1060.22,13116,42795,955,608,35057,35000,31138,30648,26333
4712,936,1030,0,4712,1652,3060,9.55869e+15,126.76,1732.11,4712,181,156,3682,3679,3583,3502,3525
35002,694,1339,0,35002,12390,22612,9.90524e+15,1084.73,5294.44,35002,443,371,31239,28324,18865,14031,20120
1748,170,772,1748,0,1438,310,3.30141e+18,42.4302,1043.41,1748,113,89,976,943,581,634,405
26771,601,2122,0,26771,0,26771,2.43187e+18,1277.76,5691.29,26771,483,341,22062,19704,9720,9964,8228
35391,1422,2064,0,35391,0,35391,2.47802e+18,1382.44,6614.02,35391,500,407,32472,28139,21815,19725,27249
25404,1507,1691,0,25404,8986,16418,9.43596e+15,1004.74,4755.01,25404,460,313,23713,23701,22463,22073,23466
2945,718,873,2623,322,1858,1087,5.42811e+17,60.5015,1260.37,2945,121,115,2072,2072,2028,2027,1950
28218,33,43,26939,1279,27375,843,9.76258e+13,38.7784,760.368,28218,40,37,28121,28040,26256,26287,24606
32045,973,3029,32045,0,26889,5156,3.17648e+18,1538.38,7394.35,32045,546,441,26136,22890,16739,15428,13436
18220,144,355,0,18220,17302,918,2.61575e+16,236.774,1746.38,18220,111,115,17549,17248,14923,13201,11848
33261,36,43,31671,1590,32410,851,9.9089e+13,38.8971,823.822,33261,41,39,33183,33122,31819,31832,30088
29125,252,352,0,29125,27523,1602,2.69032e+16,298.665,2246.2,29125,136,137,28456,27819,25486,23643,22581
30390,1368,1707,10780,19610,0,30390,3.73148e+13,1077.74,5205.27,30390,503,334,28655,25861,24113,24672,27106
36964,161,351,0,36964,34902,2062,2.72878e+16,300.66,2522.11,36964,144,153,35706,34863,29854,25635,23451
44598,999,1917,0,44598,15770,28828,9.48375e+15,1150.5,6414.21,44598,618,367,41049,37318,26324,20110,31274
5843,29,42,5559,284,5724,119,1.01694e+14,23.871,343.462,5843,29,28,5794,5781,5431,5403,4881
30353,1166,1988,15365,14988,15365,14988,4.96369e+18,1387.69,6066.04,30353,494,389,26835,23720,16560,15415,19212
15121,102,654,14854,267,15121,0,4.61421e+18,399.163,2364.98,15121,184,169,12112,8860,4915,4916,2931
4101,436,1098,2313,1788,2313,1788,5.30336e+18,151.069,1773.66,4101,200,153,3003,2898,2366,2090,1612
20801,1405,2283,20801,0,16987,3814,3.02155e+18,1405.86,5590.84,20801,423,350,17521,15193,16059,15422,13478
16551,1307,1373,5796,10755,0,16551,3.81499e+13,823.283,3645.4,16551,331,281,15178,14925,15061,15121,15145
28847,2050,2321,28847,0,23717,5130,3.12011e+18,1629.53,6583.51,28847,515,401,26449,22694,25914,26045,25665
10281,168,1849,0,10281,0,10281,2.50614e+18,646.326,3417.24,10281,307,270,7392,5892,2860,1405,1382
11926,104,380,0,11926,11272,654,2.68449e+16,200.123,1478.46,11926,102,97,11318,11062,8849,7585,5806
22393,665,797,21733,660,22393,0,4.48569e+18,471.674,2964.6,22393,226,188,21596,21229,20768,20809,20207
4049,1,40,3839,210,3964,85,1.04832e+14,24.6883,278.982,4049,25,26,1340,1340,1340,1340,1340
30718,637,2251,16194,14524,0,30718,5.01707e+18,1341.11,6237.23,30718,501,373,25412,22608,11174,11466,10891
6063,63,1504,3412,2651,3412,2651,5.09941e+18,249.974,2418.86,6063,250,170,3561,2642,1630,1363,280
10776,862,1473,3881,6895,0,10776,3.77535e+13,418.618,2878.55,10776,287,219,9303,8897,7635,7555,7595
16118,28,42,15207,911,16051,67,1.04589e+14,34.5518,566.742,16118,36,35,16024,15970,14366,14387,12973
40487,812,2734,21444,19043,0,40487,5.02427e+18,1368.88,7524.65,40487,578,415,34426,30776,15860,16045,14783
13254,211,1817,6590,6664,0,13254,5.03539e+18,903.099,3933.77,13254,325,293,9676,8287,3421,2599,2199
3933,348,895,1413,2520,0,3933,3.9437e+13,122.29,1544.82,3933,182,159,3038,2933,1999,1981,1591
30728,970,1716,14538,16190,0,30728,5.09046e+18,1334.97,5851.99,30728,452,395,26665,23502,15212,12776,19094
44359,97,1915,21594,22765,21594,22765,5.03118e+18,1452.1,7307.65,44359,536,449,27536,18695,8396,8291,2618
10534,1633,2167,10534,0,8660,1874,2.94666e+18,822.852,3898.93,10534,290,265,8367,7681,8004,8161,7267
23314,1082,1735,11120,12194,0,23314,5.0667e+18,1254.36,5149.29,23314,403,355,20404,17941,12696,11017,15780
31949,254,352,0,31949,30429,1520,2.53507e+16,289.477,2278.29,31949,127,133,31324,30754,28651,27033,26037
33236,839,1738,11822,21414,0,33236,3.72698e+13,1109.11,5467.18,33236,513,337,29848,27324,19381,19557,18243
14662,1317,2049,14662,0,11741,2921,2.90652e+18,1171.99,4545.73,14662,324,313,12012,10488,10649,10227,8950
34568,156,360,0,34568,32928,1640,2.54249e+16,293.694,2371.33,34568,131,140,33510,32882,28660,25160,22160
47597,52,1944,23535,24062,0,47597,5.08855e+18,1465.5,7540.69,47597,568,449,25588,15851,8335,5912,2254
35069,85,2634,35069,0,29447,5622,3.32509e+18,1638.98,7347.2,35069,603,415,20421,13947,9248,6644,1094
9649,298,347,0,9649,9179,470,2.6175e+16,163.587,1253.31,9649,91,80,9302,9213,9073,8924,8745
47247,346,624,46740,507,47247,0,4.75009e+18,519.984,4133.61,47247,256,260,45323,43639,31969,32087,27728
39151,498,2772,39151,0,32653,6498,3.23599e+18,1707.83,7902.88,39151,650,434,30096,25925,16746,14800,8884
20654,358,1488,0,20654,7280,13374,9.59575e+15,933.324,4156.68,20654,375,292,17319,15986,8274,6022,7427
7055,1541,1791,3472,3583,0,7055,5.02444e+18,290.599,2889.4,7055,245,183,5264,5222,5179,5165,4959
36716,740,2307,0,36716,0,36716,2.47203e+18,1368.6,6898.02,36716,519,403,30827,27028,13397,13827,14457
15554,623,1997,8156,7398,0,15554,5.01005e+18,945.483,4319.45,15554,382,294,12545,11395,6770,6271,5532
9520,701,1905,4855,4665,4855,4665,4.89648e+18,602.478,3375.82,9520,308,234,7522,6761,3916,3728,3500
45958,944,1785,21732,24226,21732,24226,5.04189e+18,1401.44,7193.02,45958,531,448,40381,35157,21360,20697,25945
28908,568,1355,10203,18705,0,28908,3.83865e+13,1037.79,4822.4,28908,409,349,25148,22849,13589,10132,14168
40468,2324,2432,20331,20137,20331,20137,4.97781e+18,1491.15,7486.17,40468,664,420,38036,38036,37626,37589,38034
37891,1151,2089,0,37891,0,37891,2.48038e+18,1383.93,6786.14,37891,538,413,33845,29860,20429,16305,22963
42306,217,2745,35185,7121,21954,20352,7.35524e+17,1810.78,8227.98,42306,631,438,29276,23350,13573,15935,5095
1366,21,35,1297,69,1365,1,1.16217e+14,18.0659,162.252,1366,21,21,1326,1316,1219,1221,1034
38432,1260,1827,0,38432,13663,24769,9.53409e+15,1122.9,5897.95,38432,551,354,36225,32588,26795,20489,32167
41786,1818,2216,0,41786,0,41786,2.53685e+18,1429.79,7368.48,41786,630,434,39570,38156,32524,31351,37854
9149,109,1403,3206,5943,0,9149,3.64342e+13,395.27,2681.87,9149,301,192,7081,6190,2980,1230,1054
29284,572,2340,29284,0,23837,5447,3.02286e+18,1568.95,6652.61,29284,475,409,22499,19221,11752,10417,8623
3186,813,959,0,3186,0,3186,2.72448e+18,126.842,1495.64,3186,142,127,2227,2227,2212,2214,2105
38300,2807,2930,38300,0,31979,6321,3.03994e+18,1697.07,7972.16,38300,596,439,35370,35370,35338,35348,35365
18464,267,1542,0,18464,6509,11955,9.41111e+15,847.198,3919.59,18464,415,271,15326,14223,6851,4844,5513
11464,1254,1699,5375,6089,0,11464,5.04142e+18,795.628,3538.41,11464,294,276,9705,8789,7196,6710,8918
26341,198,352,0,26341,25174,1167,2.48172e+16,255.508,2034.48,26341,121,129,25686,25224,23014,21378,19093
18315,54,1587,6485,11830,0,18315,3.70914e+13,910.045,3989.13,18315,395,277,12598,10146,5242,1598,1364
21838,1201,2164,11492,10346,0,21838,5.02543e+18,1126.17,5208.1,21838,442,325,19052,17134,12435,11521,13343
15080,324,1993,0,15080,0,15080,2.43722e+18,951.797,4242.77,15080,375,296,11621,10353,4990,3822,3081
1478,359,517,0,1478,0,1478,2.19075e+18,66.1441,775.111,1478,85,85,961,961,880,875,834
11663,831,1705,5610,6053,0,11663,5.22584e+18,870.518,3619.15,11663,283,271,9362,8575,5452,4776,6193
25014,544,1725,0,25014,0,25014,2.54996e+18,1310.42,5335.04,25014,398,361,20079,17462,8140,6593,8830
47511,1664,2011,16890,30621,0,47511,3.71684e+13,1166.94,6721.14,47511,613,380,45500,45500,41743,42190,44799
12655,1138,1396,0,12655,4487,8168,9.65843e+15,706.997,3216.04,12655,298,258,11242,10403,9468,8347,10304
14607,530,2124,11845,2762,7203,7404,8.02933e+17,1175.91,4591.36,14607,339,317,10864,9441,6213,6384,4413
45584,256,863,44348,1236,45584,0,4.54523e+18,635.293,4312.27,45584,295,242,42527,39672,22428,22548,17201
46309,631,841,45385,924,46309,0,4.59623e+18,549.7,4291.43,46309,270,248,45468,45323,42178,42089,40127
21971,1944,2170,0,21971,0,21971,2.4576e+18,1133.05,5216.18,21971,441,325,19801,19800,18826,18685,18165
17911,667,1522,6302,11609,0,17911,3.68675e+13,858.659,3867.64,17911,413,268,15647,14479,10005,9219,10836
27135,1864,2154,0,27135,0,27135,2.47603e+18,1280.98,5777.88,27135,485,361,24981,24921,22569,22143,24701
27066,1908,2548,27066,0,22698,4368,3.22429e+18,1607.68,6469.25,27066,520,373,24244,20796,23343,23506,22648
36145,30,43,34464,1681,35150,995,9.87365e+13,38.8324,857.715,36145,41,40,35988,35888,32761,32761,28987
15778,276,349,0,15778,15057,721,2.50636e+16,205.903,1579.68,15778,104,111,15361,15162,14386,14008,13175
18618,870,1537,0,18618,6626,11992,9.68148e+15,902.758,3960.82,18618,373,280,16565,15348,11266,9550,12414
15401,1218,2010,8101,7300,0,15401,5.01167e+18,961.503,4307.9,15401,376,290,12987,11943,9323,8521,9740
24199,610,2247,12603,11596,12603,11596,4.89468e+18,1250.78,5584.14,24199,482,344,19734,17551,8384,9339,6696
31807,1456,2309,16812,14995,16812,14995,4.90792e+18,1366.03,6362.41,31807,546,378,28805,25481,19330,18763,22463
40532,2,43,38703,1829,39280,1252,9.71193e+13,38.6076,909.413,40532,42,40,25246,20774,19955,21119,16040
6332,196,348,0,6332,5974,358,2.71981e+16,84.6189,1043.95,6332,70,75,5984,5931,5500,5226,4713
16586,8,642,16221,365,16586,0,4.57152e+18,434.76,2469.24,16586,200,177,4249,755,813,921,143
49586,1285,1363,0,49586,17511,32075,9.89724e+15,1121.85,6285.32,49586,500,404,48223,48181,47221,46993,47476
10443,616,1765,3574,6869,22,10421,3.78581e+13,539.998,3297.68,10443,325,222,8535,7919,4612,4486,4568
14133,6,43,13501,632,13711,422,9.87048e+13,36.7951,541.983,14133,37,35,12639,11701,9738,9824,6268
43706,8,43,41244,2462,43271,435,1.06502e+14,41.2499,970.595,43706,43,42,40120,37870,30323,30091,19755
4237,987,1176,4237,0,3719,518,3.23835e+18,131.581,1799.67,4237,140,155,3061,3060,3059,3046,2667
34050,1690,2482,27816,6234,17027,17023,7.85305e+17,1633.71,7299.74,34050,519,420,30646,25705,25097,24567,25119
28793,16,43,27411,1382,28051,742,9.95963e+13,38.6953,768.79,28793,41,38,28199,27717,22906,22775,18189
4308,950,1010,1519,2789,0,4308,3.93371e+13,184.04,1729.16,4308,219,163,3298,3298,3297,3296,3255
32448,44,2244,0,32448,0,32448,2.45529e+18,1386.23,6392.3,32448,531,389,17865,12268,7057,3415,917
27171,944,1522,9586,17585,0,27171,3.78331e+13,1014.4,4809.39,27171,412,323,24624,22460,16510,16224,19312
45387,1918,2133,45387,0,36351,9036,3.02917e+18,1750.84,8126.04,45387,533,477,43021,35107,42033,42134,41342
26835,239,350,0,26835,25472,1363,2.6291e+16,276.942,2130.05,26835,125,132,26182,25678,23586,21871,20728
1055,122,291,0,1055,383,672,1.02456e+16,81.709,482.557,1055,67,75,764,639,382,355,431
23098,727,2384,18950,4148,11628,11470,7.81993e+17,1476.09,5967.19,23098,464,375,18049,15309,10945,10949,7543
26207,1649,2586,26207,0,21794,4413,3.36024e+18,1568.53,6415.99,26207,555,378,22897,19643,21779,20439,16910
41614,614,877,40549,1065,41614,0,4.60286e+18,570.926,4106.63,41614,313,237,40672,39575,37551,37540,35460
11013,424,619,10869,144,11013,0,4.65623e+18,331.666,1974.91,11013,168,147,10383,10172,8921,8892,8065
35391,376,902,34187,1204,35391,0,4.42081e+18,565.088,3802.16,35391,279,217,33641,32367,21190,20668,19691
14294,13,43,13507,787,14093,201,1.05036e+14,36.7495,548.701,14294,37,34,13787,13462,10867,10652,7843
32788,167,2226,0,32788,0,32788,2.44675e+18,1341.76,6353.36,32788,525,383,24130,19570,9418,4165,2153
8645,376,1660,0,8645,0,8645,2.59706e+18,631.416,3081.66,8645,240,256,6464,5818,2846,2274,2580
49582,1650,2237,0,49582,0,49582,2.47748e+18,1486.1,7915.49,49582,581,446,47240,40434,34145,31459,41920
42089,1049,1943,0,42089,14948,27141,9.51229e+15,1155.54,6287.73,42089,586,364,38850,35274,24897,19663,29647
32532,1115,2028,0,32532,0,32532,2.49872e+18,1364.46,6318.52,32532,463,404,28718,25291,16697,13832,20871
9315,63,346,0,9315,8837,478,2.6603e+16,125.118,1226.62,9315,82,86,8786,8535,6751,5816,4307
47647,1025,2562,39469,8178,24708,22939,7.50546e+17,1834.22,8563.79,47647,633,462,40004,34300,29157,27756,22132
20492,1360,1525,7268,13224,0,20492,3.73009e+13,900.327,4089.46,20492,415,278,18937,17450,16981,16913,18013
28030,28,1652,9981,18049,0,28030,3.76251e+13,1007.54,4889.23,28030,438,325,17100,13189,7799,3157,906
37693,204,2337,19951,17742,19951,17742,4.93879e+18,1430.98,6933.03,37693,560,413,28131,23578,10362,11235,4854
24747,1959,2541,24747,0,20471,4276,3.17805e+18,1501.12,6215.85,24747,487,355,22161,18991,21105,20356,19862
34495,184,3039,0,34495,12036,22459,7.1451e+15,747.477,7507.96,34495,604,446,27289,23573,14302,10434,4937
39399,1640,2854,32984,6415,20858,18541,7.17426e+17,1669.67,7943.05,39399,642,425,35248,30057,28627,28509,26272
29090,506,2226,0,29090,0,29090,2.44822e+18,1336,6056.19,29090,501,368,23579,20960,9140,8136,8658
43083,1750,2424,22901,20182,22901,20182,4.94471e+18,1441.57,7436.7,43083,599,429,40646,35258,30914,29604,35322
43816,314,2108,34901,8915,20668,23148,8.52533e+17,1698.83,7918.67,43816,552,461,30728,25045,13986,14944,8120
8239,1294,1831,4331,3908,4331,3908,4.91513e+18,372.638,3063.95,8239,277,237,6408,6245,5427,5221,5492
9374,829,2198,7589,1785,4531,4843,7.96875e+17,637.862,3736.92,9374,276,229,7163,6081,4376,4543,4100
49803,931,2565,26464,23339,0,49803,4.98429e+18,1505.39,8083.49,49803,669,438,43390,38576,20165,20837,24829
5870,28,43,5627,243,5659,211,9.80131e+13,28.84,353.959,5870,31,27,5810,5793,5429,5432,5238
42744,28,354,0,42744,40852,1892,2.48116e+16,287.741,2594.73,42744,140,152,39123,37009,28594,25059,16362
41804,109,883,40747,1057,41804,0,4.61792e+18,596.82,4149.66,41804,303,234,34276,25886,15292,13630,6773
18289,20,43,17319,970,17977,312,1.02393e+14,39.4497,621.508,18289,39,37,18018,17822,15181,14984,11785
20404,1569,2270,20404,0,16834,3570,3.02449e+18,1408.82,5494.42,20404,400,343,17540,15126,16093,15596,13251
37311,1595,2324,19853,17458,19853,17458,4.93624e+18,1428.44,6869.37,37311,569,413,34610,30230,24203,23213,27770
13353,304,355,0,13353,12624,729,2.73434e+16,215.799,1520.23,13353,105,112,12953,12741,12347,11937,11616
25323,196,1738,0,25323,0,25323,2.5327e+18,1292.36,5364.88,25323,414,364,18135,14256,4870,2776,2307
12266,1350,1477,4392,7874,0,12266,3.81125e+13,569.769,3115.92,12266,297,242,10789,10278,10151,10162,10354
26365,1997,2230,26365,0,21450,4915,3.15594e+18,1566.69,6284.47,26365,486,401,24128,20568,23703,23768,23496
44526,171,1371,0,44526,15770,28756,9.95275e+15,1119.95,6006.63,44526,474,396,35375,32062,12679,10075,8366
14461,1258,1988,7563,6898,0,14461,4.9964e+18,872.051,4150.35,14461,350,292,12270,11267,8958,8649,9024
8990,1882,2150,7441,1549,4576,4414,7.43091e+17,539.775,3547.21,8990,297,229,6840,6554,6416,6382,5605
9689,38,42,9191,498,9513,176,1.0377e+14,27.0777,434.438,9689,32,31,9647,9644,9588,9586,9451
23878,1630,2104,0,23878,0,23878,2.54613e+18,1389.9,5655.41,23878,441,368,21331,18706,15792,14039,18325
11013,1811,2288,11013,0,9168,1845,3.26487e+18,834.446,4047.21,11013,363,262,8725,8099,8525,8596,7833
1702,343,737,742,960,0,1702,5.15053e+18,45.0875,990.852,1702,144,94,965,964,637,636,541
23653,28,43,22514,1139,23077,576,1.00569e+14,37.0536,696.402,23653,39,38,23507,23435,21220,21243,19482
21529,971,2230,21529,0,17406,4123,2.98465e+18,1491.02,5723.68,21529,422,352,17311,14713,11596,10925,10522
5532,543,596,5399,133,5532,0,4.64209e+18,185.569,1406.74,5532,154,102,4936,4935,4883,4880,4786
43894,295,2231,22225,21669,22225,21669,4.98026e+18,1415.99,7445.61,43894,580,442,33867,29770,11245,11876,6078
38487,88,381,0,38487,36347,2140,2.71459e+16,297.908,2643.97,38487,148,154,36635,35769,27040,23658,17265
33663,6,43,32054,1609,32813,850,9.98623e+13,41.5416,840.092,33663,42,40,30015,27732,22974,23212,14070
34469,434,876,33524,945,34469,0,4.54916e+18,527.775,3749.21,34469,260,221,33084,31997,27437,26730,21640
29328,524,2005,14428,14900,0,29328,5.05015e+18,1330.6,5989.5,29328,455,382,23681,20853,9044,8612,9425
14587,1565,1575,0,14587,5139,9448,9.32117e+15,714.061,3484.5,14587,374,238,13012,13012,12997,12903,13012
13165,1484,1876,7111,6054,0,13165,5.07174e+18,821.752,3830.03,13165,322,274,11289,10401,9612,9298,9993
1378,94,201,505,873,0,1378,3.71967e+13,18.6132,356.045,1378,81,38,1177,1168,954,1067,175
24772,195,1701,0,24772,8792,15980,9.55739e+15,1002.43,4710.75,24772,441,309,20030,18258,8210,5197,2476
23180,265,1670,0,23180,8231,14949,9.51133e+15,941.83,4497.95,23180,449,293,19272,17843,8239,4936,2714
35792,2079,2848,35792,0,29911,5881,3.32468e+18,1684.54,7659.69,35792,617,418,32915,27817,31594,31161,29642
48546,1030,2313,23126,25420,23126,25420,4.99103e+18,1583.18,8112.2,48546,619,462,42208,37156,20929,21552,28516
25771,1432,2262,13569,12202,13569,12202,4.9198e+18,1279.33,5739.83,25771,483,351,23013,20465,15107,14940,16647
1478,385,670,712,766,0,1478,5.0101e+18,81.6475,904.449,1478,129,104,808,803,586,564,582
21184,483,1505,0,21184,7521,13663,9.66707e+15,932.381,4225.88,21184,369,294,18131,16620,9935,6749,7465
13284,117,351,0,13284,12687,597,2.48275e+16,190.573,1448.37,13284,99,96,12744,12550,10761,9477,8085
29585,261,2610,29585,0,24740,4845,3.33691e+18,1599.95,6794.25,29585,573,396,20860,17712,10110,8132,3473
47304,302,2646,38443,8861,23062,24242,7.98754e+17,1794.36,8826.29,47304,641,472,33174,27017,15045,16546,7903
43814,1061,2558,22913,20901,22913,20901,4.87982e+18,1488.21,7648.1,43814,661,419,38516,34106,19670,21329,22669
19351,1481,2065,9856,9495,0,19351,4.94283e+18,1200.78,4899.06,19351,441,318,17062,15195,12798,11914,13912
9051,950,1827,4721,4330,4721,4330,5.00238e+18,523.398,3215.61,9051,280,257,7224,6740,4709,4712,4906
40771,1146,1811,14491,26280,0,40771,3.73266e+13,1102.79,6022.78,40771,560,366,38115,34585,27223,28767,31795
38768,125,2755,38768,0,32350,6418,3.30713e+18,1719.15,7866.24,38768,646,444,24432,16835,10548,7856,2415
2273,163,189,0,2273,2144,129,2.68196e+16,42.9344,502.044,2273,48,53,2084,2084,2062,2057,2007
27325,1568,2226,14805,12520,0,27325,5.05192e+18,1241.19,5788.85,27325,486,351,24887,22095,18798,17545,19798
30141,7,42,28689,1452,29389,752,1.00082e+14,39.5905,773.486,30141,40,37,27636,25991,21435,21417,13633
44990,575,1885,15976,29014,0,44990,3.72864e+13,1146.7,6415.77,44990,599,380,39428,36135,21392,16807,15768
11184,1052,1457,0,11184,4032,7152,9.69236e+15,481.995,2935.6,11184,269,238,9727,9297,8270,6839,8632
38060,383,1377,0,38060,13483,24577,9.9224e+15,1108.77,5575.41,38060,464,383,32237,29210,15204,11385,13104
20382,955,1977,10517,9865,10517,9865,5.00066e+18,1152.58,4960.08,20382,380,321,17258,15569,10024,10433,10459
34168,1852,2029,17005,17163,17005,17163,4.94925e+18,1371.93,6454.17,34168,490,398,32139,32139,30238,30006,31648
2756,417,827,1507,1249,1507,1249,5.36e+18,98.7939,1309.6,2756,124,120,1929,1919,1781,1649,1224
34573,1304,2451,34573,0,27896,6677,2.98253e+18,1636.76,7458.88,34573,505,425,29474,25184,24386,23189,20970
24830,278,356,0,24830,23612,1218,2.57615e+16,264.711,2034.9,24830,123,132,24324,23873,22518,21735,20877
20769,202,1411,0,20769,7370,13399,9.81293e+15,928.84,4141.55,20769,354,300,16801,15264,6833,5137,4555
34318,1475,1604,0,34318,12106,22212,9.59932e+15,1093.36,5452.2,34318,464,352,32714,32713,31293,30789,32480
2641,333,968,2203,438,1414,1227,7.11004e+17,109.831,1419.64,2641,144,143,1673,1663,1070,1100,895
16226,279,1880,8259,7967,8259,7967,4.98546e+18,1019.11,4353.22,16226,343,307,12365,10891,4696,4556,3358
17143,321,2017,8971,8172,8971,8172,4.98201e+18,1049.43,4549.55,17143,382,303,13227,11723,5323,5484,3380
3488,831,1108,1601,1887,0,3488,5.1453e+18,167.923,1697.41,3488,200,180,2380,2352,2000,1918,1822
44198,153,1947,21757,22441,21757,22441,4.98785e+18,1480.95,7295.81,44198,564,434,31021,23097,9393,9903,4585
48277,553,910,47521,756,48277,0,4.70571e+18,581.999,4534.1,48277,311,255,47110,45745,40243,39399,37002
7169,159,1654,0,7169,0,7169,2.5785e+18,437.644,2825.93,7169,218,214,4873,3605,1452,979,834
13146,646,1312,4650,8496,0,13146,3.8662e+13,736.484,3223,13146,293,262,11208,10464,6719,6155,6901
14657,615,1520,5229,9428,0,14657,3.73884e+13,752.604,3498.15,14657,356,250,12551,11749,8052,8137,5794
21226,1524,2240,0,21226,0,21226,2.49153e+18,1246.71,5384.36,21226,470,334,18692,16632,12961,11601,15404
32373,1601,1725,15398,16975,0,32373,5.12908e+18,1367.87,6034.07,32373,473,400,30552,26160,27526,27309,29755
7902,2,43,7437,465,7838,64,1.06684e+14,29.0424,402.71,7902,33,31,4632,3686,3488,3722,2901
2813,73,397,2598,215,2813,0,4.07124e+18,139.495,815.415,2813,81,74,2253,1919,1283,1154,425
33384,2050,2283,0,33384,0,33384,2.45526e+18,1360.5,6485.92,33384,529,386,31101,31101,29946,28527,30715
6080,788,1756,6080,0,5133,947,3.21165e+18,196.893,2643.59,6080,212,168,4324,4149,3737,3613,1801
23503,958,1619,0,23503,8357,15146,9.5308e+15,969.292,4483.56,23503,433,299,21221,19610,15317,10637,13366
37182,536,1826,13174,24008,0,37182,3.72221e+13,1128.6,5856.46,37182,555,365,32191,29464,17314,13057,15928
39472,1465,2423,20632,18840,0,39472,4.99647e+18,1419.59,7163.24,39472,601,409,36267,31673,23129,20917,27433
10695,86,625,10381,314,10695,0,4.48595e+18,360.093,1957.03,10695,168,143,8226,6029,3531,3400,1831
31102,1382,1952,0,31102,0,31102,2.53873e+18,1391.09,6172.79,31102,464,390,28251,25248,19062,16985,22085
21182,1610,3215,9158,12024,0,21182,3.42577e+18,898.764,6319.84,21182,536,466,17967,17264,13476,12422,11982
49449,268,353,0,49449,47000,2449,2.59486e+16,303.942,2854.33,49449,150,163,48668,47629,44365,41504,41433
14113,1466,1531,0,14113,5044,9069,9.61119e+15,703.962,3402.06,14113,349,245,12582,12180,12382,12161,12496
7544,32,1389,0,7544,2683,4861,9.53463e+15,204.776,2443.45,7544,277,181,4683,3714,2119,1025,364
37973,87,1770,13491,24482,0,37973,3.72888e+13,1112.41,5808.72,37973,524,358,28642,24248,12192,3548,3097
29230,537,1748,13743,15487,13743,15487,4.96987e+18,1360.3,5790.4,29230,462,381,23501,20470,8974,8427,7787
5527,395,530,5472,55,5527,0,4.6587e+18,215.615,1376.52,5527,115,114,4997,4960,4616,4603,4173
35324,730,873,34205,1119,35324,0,4.498e+18,538.818,3779.17,35324,271,223,34451,34415,33207,33219,31935
26072,27,43,24893,1179,25243,829,9.70461e+13,38.6091,729.083,26072,40,37,25907,25814,23344,23412,19552
34912,139,1469,0,34912,12319,22593,9.75056e+15,1080.11,5400.89,34912,468,355,27438,24048,10526,7473,4935
24649,572,1402,13184,11465,0,24649,4.61875e+18,597.568,4469.31,24649,423,286,22630,17527,12944,11087,15921
31812,34,43,30283,1529,31059,753,1.00683e+14,40.664,815.633,31812,41,40,31712,31621,29982,29981,27412
16564,40,43,15779,785,16108,456,9.85607e+13,38.4705,584.77,16564,37,33,16516,16504,16468,16468,16026
28481,214,351,0,28481,27163,1318,2.54445e+16,285.217,2129.87,28481,121,129,27783,27283,25006,23239,20966
49774,326,758,48848,926,49774,0,4.67575e+18,570.906,4399.09,49774,292,260,47393,45368,29667,29566,23715
20881,902,1969,16649,4232,9812,11069,8.48918e+17,1446.2,5377.79,20881,410,342,16738,14261,11049,10531,9745
1171,305,407,1080,91,745,426,3.88362e+17,34.2126,576.546,1171,78,68,764,764,720,722,273
20586,1329,2051,10880,9706,0,20586,5.00198e+18,1100.66,4945.79,20586,417,321,18218,16296,12709,11691,13767
19102,667,1815,0,19102,0,19102,2.52467e+18,1170.49,4731.82,19102,381,324,15529,13669,7454,6345,8115
16160,1718,1722,7697,8463,0,16160,5.12924e+18,1076.2,4259.99,16160,337,304,14438,14438,14426,14347,14438
12437,92,632,12287,150,12437,0,4.79564e+18,366.627,2150.94,12437,171,162,9462,6524,3825,3779,2388
23668,579,886,22977,691,23668,0,4.4843e+18,471.845,3127.15,23668,267,191,22743,22203,20110,19806,18314
34688,726,2431,34688,0,28216,6472,3.05436e+18,1652.77,7374.01,34688,491,429,27345,22806,14982,13583,11344
32503,3128,3263,32503,0,26956,5547,2.98619e+18,1685.45,7912.06,32503,720,413,29240,29240,29231,29234,29214
9430,1155,1834,5038,4392,5038,4392,4.87026e+18,510.505,3237.2,9430,299,195,7596,7228,5939,5368,5075
18633,2138,2504,15144,3489,8897,9736,8.01404e+17,1381.63,5558.83,18633,490,355,16122,13960,14908,14602,15718
46579,126,2901,46579,0,38875,7704,3.28028e+18,1764.79,8701.99,46579,710,467,29445,20209,13197,10428,4069
9728,301,350,0,9728,9183,545,2.73105e+16,156.52,1268.04,9728,91,93,9378,9265,9060,8834,8862
2608,38,42,2449,159,2606,2,1.05877e+14,22.5226,237.992,2608,25,24,2566,2565,2555,2555,2508
15380,14,43,14512,868,15212,168,1.06844e+14,34.8748,567.323,15380,37,35,14895,14536,11896,11557,9233
45105,193,2444,23357,21748,23357,21748,4.9163e+18,1506.02,7692.38,45105,627,440,33239,27320,11631,12572,4261
29519,1062,2025,15027,14492,0,29519,5.06045e+18,1331.44,5982.79,29519,467,387,25724,22964,14958,13186,16798
29505,639,2100,0,29505,0,29505,2.47777e+18,1329.84,6051.52,29505,465,375,24383,21422,10088,9983,10014
6517,395,1215,0,6517,2323,4194,9.56642e+15,163.567,2140.2,6517,203,149,5302,5079,3653,2243,2184
9346,451,1823,0,9346,0,9346,2.45979e+18,514.971,3234.26,9346,301,255,7271,6686,3790,3510,3131
27995,997,2059,22338,5657,13190,14805,8.50131e+17,1577.27,6311.53,27995,485,394,23000,19503,16062,15215,14554
38433,283,2236,20141,18292,0,38433,5.0165e+18,1472.22,6939.99,38433,570,405,29754,26339,11027,9639,5247
888,9,35,825,63,884,4,1.02384e+14,16.7624,135.163,888,21,20,805,765,571,606,446
19685,265,585,19489,196,19685,0,4.73491e+18,448.216,2640.43,19685,190,197,18396,17414,11127,11308,10149
39582,255,2488,20931,18651,0,39582,4.99359e+18,1412.74,7203.95,39582,617,408,30334,26604,10683,8482,4827
3792,449,866,0,3792,1272,2520,9.14147e+15,139.687,1469.36,3792,175,133,2926,2860,2104,2009,2094
29744,754,2245,0,29744,0,29744,2.45239e+18,1335.48,6126.4,29744,502,369,24906,22133,11664,11413,10724
46122,708,1890,0,46122,16343,29779,9.51496e+15,1155.78,6494.1,46122,603,373,40993,37686,23909,16758,27555
8430,73,343,0,8430,8030,400,2.55151e+16,106.466,1143.79,8430,77,77,8013,7854,6392,5540,4037
8740,749,2140,8740,0,7232,1508,3.29829e+18,524.694,3493.79,8740,291,208,6600,5893,4559,4328,2669
33140,784,913,32236,904,33140,0,4.62013e+18,528.946,3704.19,33140,279,217,32227,32215,31535,31536,30967
25969,2167,2178,13876,12093,0,25969,4.99718e+18,1232.42,5639.1,25969,480,339,23791,23791,23781,23783,23750
42350,287,356,0,42350,40327,2023,2.55597e+16,304.977,2636.39,42350,141,149,41752,40872,38827,36521,37303
13064,883,1872,0,13064,0,13064,2.43913e+18,805.184,3808.24,13064,362,271,10828,9987,6742,6186,6725
48912,2109,3126,48912,0,40673,8239,3.20875e+18,1757.81,9112.82,48912,709,462,45750,38890,43877,43756,41309
46570,284,355,0,46570,44408,2162,2.5286e+16,302.685,2745.63,46570,144,160,45920,44988,42620,40088,40752
13199,192,699,12963,236,13199,0,4.64752e+18,364.904,2248.38,13199,192,153,11868,10643,6650,6381,4583
12984,549,645,12766,218,12984,0,4.61859e+18,391.355,2201.54,12984,186,166,12339,12116,11881,11889,11382
38931,421,2743,38931,0,32462,6469,3.32111e+18,1706.83,7859,38931,656,434,29311,25626,15649,13529,7233
41652,594,1703,0,41652,14721,26931,9.76621e+15,1128.11,6186.58,41652,530,379,36513,33225,19179,14579,20851
20461,21,43,19461,1000,19999,462,1.01621e+14,38.8559,654.213,20461,39,38,20199,20001,17224,17091,13518
39019,426,2338,0,39019,13808,25211,9.67925e+15,1022.15,6616.2,39019,573,362,33367,30394,15233,10564,10100
48094,55,2145,38402,9692,22675,25419,8.44568e+17,1746.36,8362.36,48094,557,478,21894,10910,6638,6898,1051
3895,5,36,3750,145,3686,209,9.02602e+13,24.2711,258.215,3895,25,22,3421,3054,2758,2780,1878
8950,312,628,8787,163,8950,0,4.69868e+18,269.651,1787.55,8950,165,136,8285,8027,6760,6754,5496
49728,784,1768,0,49728,0,49728,2.53777e+18,1464.38,7515.88,49728,536,461,42294,37102,20313,15944,24625
9303,2068,2230,9303,0,7928,1375,3.15402e+18,424.158,3572.83,9303,273,223,7073,6914,6976,6934,6248
42643,1513,1749,20465,22178,20465,22178,5.04555e+18,1447.25,6963.62,42643,521,447,40272,34089,31132,30434,36595
36904,1082,1547,13051,23853,0,36904,3.89789e+13,1155.2,5697.06,36904,445,385,34490,30768,23590,20927,28172
43905,394,1645,0,43905,15526,28379,9.69532e+15,1129.04,6203.32,43905,503,380,37409,34162,17652,12309,15444
31926,1194,1788,11315,20611,0,31926,3.72484e+13,1067.11,5366.44,31926,521,334,29647,26920,21937,20658,27269
12473,170,1954,0,12473,0,12473,2.40888e+18,881.004,3894.58,12473,351,256,8818,7068,2917,1458,1044
35274,1091,2725,29526,5748,18731,16543,7.15333e+17,1610.66,7395.31,35274,598,394,29774,25865,22444,21789,19286
11979,1826,2303,11979,0,9907,2072,3.31206e+18,957.801,4254.26,11979,379,269,9676,8795,9479,9488,8712
23772,256,1722,0,23772,0,23772,2.52065e+18,1269.96,5179.23,23772,410,357,17626,15046,5083,3476,4696
14288,409,1525,5100,9188,0,14288,3.76647e+13,705.539,3444.92,14288,318,250,12046,11182,6691,5547,3686
34928,1419,2460,0,34928,0,34928,2.46054e+18,1324.37,6765.63,34928,514,403,31776,27851,20736,18259,24129
13442,304,2225,11316,2126,7301,6141,7.00688e+17,951.312,4308.85,13442,345,277,9764,8401,4799,5381,2278
6920,145,1883,3366,3554,0,6920,5.15116e+18,338.038,3014.78,6920,295,214,4311,3277,1377,1231,799
16017,1862,2169,16017,0,12931,3086,3.14106e+18,1223.79,4834.53,16017,360,326,13780,11984,13373,13374,12316
36021,11,43,34355,1666,35015,1006,9.8381e+13,38.8847,858.179,36021,41,40,34561,33478,27761,27096,18397
32864,18,1597,11692,21172,0,32864,3.80899e+13,1082.45,5329.4,32864,448,352,16992,12020,7276,2384,553
37514,2731,2754,37514,0,31305,6209,3.28583e+18,1693,7734.92,37514,636,436,34760,34760,34760,34760,34760
46805,1959,2136,0,46805,0,46805,2.47958e+18,1471.91,7638.63,46805,572,445,44669,44668,42883,41720,44121
44705,1354,1884,15842,28863,0,44705,3.72496e+13,1169.78,6438.03,44705,587,382,42749,38137,32418,33420,40382
20524,325,1314,7232,13292,0,20524,3.83495e+13,918.931,4021.1,20524,350,302,17117,15704,8067,5004,7295
14068,1390,1496,0,14068,4959,9109,9.92492e+15,731.1,3523,14068,297,258,12572,12514,12170,11818,12324
43234,365,775,42439,795,43234,0,4.71118e+18,558.11,4113.81,43234,294,247,41369,39865,30433,29922,24225
11513,1424,1470,0,11513,4103,7410,9.79691e+15,559.057,3036.59,11513,281,241,10043,9610,9966,9388,9873
34191,2133,2292,18286,15905,18286,15905,4.94158e+18,1380.95,6541.82,34191,549,395,31899,31899,30722,30579,30732
833,222,389,0,833,328,505,1.03802e+16,33.485,522.548,833,71,80,444,440,418,369,342
28156,550,1647,0,28156,10025,18131,9.57221e+15,1020.9,4900.32,28156,456,321,24470,22546,14588,9858,11273
33073,481,895,32215,858,33073,0,4.622e+18,528.842,3685.39,33073,246,218,31859,30845,26815,26682,22908
14630,20,43,13962,668,14208,422,9.91226e+13,36.9366,551.564,14630,37,35,14428,14287,12495,12357,10311
18581,944,1998,10100,8481,10100,8481,4.99887e+18,1061.61,4650.11,18581,365,301,15831,14336,9970,9904,9559
27047,1587,1766,12863,14184,0,27047,5.13171e+18,1322.47,5581.67,27047,429,382,25104,21531,20831,20563,23581
37495,482,2362,19664,17831,0,37495,5.00162e+18,1431.41,6947.93,37495,585,397,30444,26946,12066,12982,10052
36818,732,2085,29450,7368,17424,19394,8.37634e+17,1684.14,7266.87,36818,521,431,29041,23838,17314,16751,12805
27291,1375,2127,14678,12613,0,27291,5.05361e+18,1273.28,5747.16,27291,460,360,24513,21727,17493,15898,18875
4663,593,1234,2099,2564,0,4663,4.52213e+18,189.866,1948.93,4663,172,185,3429,3319,2096,1924,2004
21166,20,43,19952,1214,20956,210,1.07186e+14,39.6144,677.009,21166,40,38,20824,20570,17274,17030,12778
1225,154,277,1225,0,1225,0,4.41745e+18,108.342,529.478,1225,58,58,944,812,640,666,654
24045,381,2101,12719,11326,12719,11326,4.93264e+18,1269.73,5429.95,24045,434,339,18998,17093,6958,7625,4624
26836,829,850,26003,833,26836,0,4.56477e+18,499.974,3287.3,26836,255,202,25986,25986,25976,25972,25708
7688,136,1699,3886,3802,3886,3802,4.99966e+18,391.733,2909.82,7688,251,242,5304,3714,1753,1828,934
34448,1110,1788,0,34448,12227,22221,9.57915e+15,1094.28,5555.66,34448,536,350,31913,29040,22615,17600,27446
28187,226,1706,0,28187,9996,18191,9.44797e+15,1034.54,4977.16,28187,485,319,23192,21457,10060,7166,7052
46897,279,357,0,46897,44735,2162,2.52019e+16,298.589,2753.79,46897,146,158,46212,45286,42634,40109,40015
30987,1670,2244,0,30987,0,30987,2.44185e+18,1346.96,6249.09,30987,519,378,28656,25076,21666,19922,25247
38552,2089,2313,20232,18320,20232,18320,4.91233e+18,1440.59,6999.68,38552,580,416,36239,36239,34097,34030,35087
28623,2,43,27173,1450,28053,570,1.02145e+14,39.2928,773.309,28623,41,39,17336,14066,13285,14240,10405
46627,39,43,44461,2166,45361,1266,9.87915e+13,40.7332,980.279,46627,43,41,46559,46516,46064,46061,44123
2197,226,765,2197,0,1611,586,3.16151e+18,116.954,1125.31,2197,114,131,1427,1293,713,821,471
44041,1584,2397,23645,20396,0,44041,5.04339e+18,1456.95,7475.62,44041,609,425,41171,35853,28686,26123,34450
49468,293,1946,17587,31881,0,49468,3.72748e+13,1150.65,6744.33,49468,631,381,41695,38358,18063,15370,14845
16508,284,359,0,16508,15719,789,2.54263e+16,220.746,1650.47,16508,107,113,16089,15851,15035,14522,13851
27432,301,1603,0,27432,9744,17688,9.63127e+15,1040.72,4905.97,27432,424,325,22898,21022,10389,7131,7643
910,157,429,910,0,663,247,2.77819e+18,42.8022,570.421,910,62,74,481,468,408,402,292
38070,1024,2091,30417,7653,18073,19997,8.394e+17,1668.86,7370.28,38070,532,439,31542,26561,22171,21037,19282
1316,56,131,0,1316,1238,78,2.40923e+16,34.9772,317.592,1316,37,35,1185,1144,1057,1001,882
22283,1196,2488,22283,0,18589,3694,3.3504e+18,1409.75,5829.7,22283,483,348,18414,16267,15481,14839,12233
26733,397,1293,0,26733,9463,17270,9.95132e+15,996.662,4553.8,26733,385,341,22682,20653,10904,8450,9934
25607,516,2380,21074,4533,13010,12597,7.65181e+17,1488.57,6207.05,25607,479,372,19489,16872,10655,10883,7079
24749,877,2739,24749,0,20211,4538,2.90656e+18,1561.75,6559.1,24749,541,363,19797,16543,10222,9972,11005
10812,371,1865,5807,5005,0,10812,5.06536e+18,675.344,3502.82,10812,301,236,8336,7548,3793,3743,2165
16457,32,43,15546,911,16226,231,1.04333e+14,34.8315,582.846,16457,37,35,16378,16330,15272,15276,14449
9566,908,1517,3400,6166,0,9566,3.75675e+13,466.993,2870.86,9566,293,207,8049,7704,5903,5915,5379
49807,1217,2350,40475,9332,24599,25208,7.96267e+17,1776.66,8679.97,49807,624,472,43011,36320,32525,31615,29129
6072,1008,1529,2900,3172,2900,3172,4.93875e+18,281.935,2495.36,6072,210,175,4543,4472,3550,3239,3408
18320,875,1650,0,18320,6475,11845,9.36701e+15,862.399,4019.16,18320,408,278,16210,15014,11211,8222,10305
2842,722,917,2432,410,1596,1246,6.56602e+17,59.417,1353.04,2842,133,130,1925,1925,1812,1806,1657
4463,532,850,0,4463,1612,2851,1.01338e+16,128.409,1502.74,4463,221,126,3613,3597,3304,2255,1939
23388,717,2634,0,23388,0,23388,2.52812e+18,944.76,5886.57,23388,418,330,19774,17254,7502,6958,5750
23631,447,1565,8367,15264,0,23631,3.87048e+13,1046.68,4621.58,23631,373,327,20029,18203,10041,7669,8338
13404,1006,1602,4826,8578,0,13404,3.68761e+13,466.37,3150.68,13404,394,233,11802,11397,10100,9981,10252
9624,902,2225,7883,1741,4823,4801,7.81193e+17,732.474,3759.51,9624,301,240,7338,6416,4884,5019,3729
39188,1212,1637,0,39188,13935,25253,9.69296e+15,1096.97,5815.45,39188,484,374,37110,33211,28324,21706,33102
6884,1691,1978,5605,1279,3324,3560,7.78761e+17,363.783,3093.7,6884,252,201,4906,4894,4705,4639,4603
39109,747,2591,20629,18480,20629,18480,4.91469e+18,1405.65,7318.22,39109,587,425,32878,29058,14221,16894,13358
14230,1,43,13595,635,13784,446,9.70429e+13,31.3082,532.463,14230,35,33,5319,5319,5319,5319,5319
24851,617,2057,19888,4963,11878,12973,8.45249e+17,1543.03,5950.43,24851,440,382,18955,15959,10769,10743,7854
44946,1275,2532,44946,0,36631,8315,3.12592e+18,1734.76,8389.77,44946,572,466,38962,32975,29710,28475,26232
48744,350,359,0,48744,45955,2789,2.73705e+16,321.995,2927.76,48744,163,170,48364,47897,48176,48045,47879
11674,1321,1955,5885,5789,5885,5789,4.88216e+18,783.127,3740.58,11674,329,269,9719,8906,6871,7001,7752
28173,2059,2245,14551,13622,0,28173,4.96249e+18,1344.19,5986.6,28173,521,365,25928,25928,25092,24614,25896
1939,71,187,0,1939,1836,103,2.75001e+16,44.459,469.986,1939,52,46,1752,1709,1543,1452,1146
34794,1652,1999,17521,17273,17521,17273,4.9702e+18,1368.71,6470.56,34794,499,405,32768,28303,26357,25538,30864
26483,10,43,25171,1312,25873,610,1.01184e+14,39.9542,744.167,26483,41,38,25155,24212,19814,19347,14237
37355,27,43,35561,1794,36440,915,9.99463e+13,40.3798,881.208,37355,42,40,37119,36974,33095,33158,27535
30663,128,353,0,30663,29270,1393,2.51261e+16,276.762,2213.04,30663,125,130,29649,29172,25024,21949,18417
26258,627,2100,26258,0,21069,5189,2.99477e+18,1585.72,6193.02,26258,445,397,20066,16744,9678,8074,7599
18743,1453,2369,18743,0,15416,3327,3.07997e+18,1383.29,5347.25,18743,423,337,15844,13715,14181,13288,11172
19856,1004,2282,19856,0,16315,3541,3.06963e+18,1333.03,5444.05,19856,405,332,15951,14028,11737,11111,9016
43983,1133,1378,15578,28405,0,43983,3.87081e+13,1131.73,5985.42,43983,494,396,41831,36783,32453,33207,37437
18235,1082,2047,9844,8391,0,18235,5.06108e+18,1001.32,4638.76,18235,386,304,15624,14254,10419,9580,9924
37431,1341,2307,19808,17623,19808,17623,4.94042e+18,1443.05,6895.66,37431,556,411,33902,29709,21340,21434,23879
30732,2181,2219,16151,14581,0,30732,5.00014e+18,1329.77,6195.64,30732,512,377,28513,28513,28513,28513,27909
5319,881,1067,0,5319,1948,3371,1.01893e+16,165.162,1863.06,5319,198,145,4252,4250,4164,4090,3226
20755,39,43,19761,994,20232,523,1.001e+14,36.5396,650.619,20755,39,36,20703,20690,20536,20537,19948
41974,1498,2363,0,41974,0,41974,2.45937e+18,1465.81,7335.91,41974,598,425,38821,33793,25944,22681,32037
33505,13,43,31876,1629,32661,844,9.96528e+13,38.3159,814.312,33505,40,38,32504,31863,26311,25479,18056
14709,235,355,0,14709,13964,745,2.59837e+16,221.265,1574.65,14709,102,100,14242,14028,13074,12257,12119
14949,1721,1877,0,14949,0,14949,2.46108e+18,903.864,4099.84,14949,386,288,13072,12020,12005,12048,12414
17258,809,2311,17258,0,14102,3156,2.95529e+18,1280.8,5126.27,17258,381,311,13413,11483,8060,7656,6321
15962,121,1986,8354,7608,8354,7608,4.90793e+18,984.668,4364.35,15962,399,284,11005,8212,4170,4128,1263
30520,886,1704,0,30520,10853,19667,9.54861e+15,1064.23,5187.6,30520,487,329,27605,25334,18375,13082,16067
8046,1612,1716,4051,3995,0,8046,5.15578e+18,463.988,3005.78,8046,259,235,6330,6154,6129,6110,6238
18837,980,1890,9285,9552,0,18837,5.07833e+18,1129.85,4734.05,18837,365,320,15971,14344,9043,8274,11080
23582,4,43,22499,1083,22918,664,9.85082e+13,37.0053,696.629,23582,39,37,19019,16764,15147,14849,9469
36530,8,45,34485,2045,36124,406,1.06981e+14,41.2726,880.891,36530,43,42,33553,31642,25388,25053,16735
17032,298,350,0,17032,16108,924,2.73813e+16,249.859,1716.85,17032,115,118,16630,16283,15714,15116,14820
10454,123,1517,0,10454,3715,6739,9.65853e+15,544.574,2989.59,10454,302,230,8022,6904,3323,1928,595
33006,333,366,0,33006,31429,1577,2.55453e+16,294.953,2346.35,33006,131,139,32591,31923,31745,31223,31479
35571,2359,2997,30039,5532,19223,16348,6.98468e+17,1611.75,7679.56,35571,595,405,32574,32412,29758,29114,30498
26650,130,352,0,26650,25473,1177,2.48701e+16,255.423,2040.49,26650,121,129,25791,25366,21896,19431,16010
41764,279,1005,40382,1382,41764,0,4.46697e+18,638.049,4250.44,41764,325,228,39047,36647,20763,20161,15625
31764,1564,2341,16651,15113,0,31764,5.0134e+18,1369.92,6425.17,31764,517,379,29111,25479,20227,18481,22815
17178,37,1466,6035,11143,0,17178,3.84359e+13,859.351,3857.06,17178,345,323,10397,7802,3952,1538,784
24888,2080,2303,20221,4667,12291,12597,8.06077e+17,1497.89,6122.47,24888,453,385,22585,22522,21561,21311,22060
20739,767,2474,20739,0,17553,3186,3.26719e+18,1269.45,5531.69,20739,434,331,16462,14487,11329,10522,6901
9784,90,2074,7793,1991,4524,5260,8.54464e+17,837.011,3753.27,9784,323,275,5266,3363,2129,2128,398
8951,422,1394,0,8951,3134,5817,9.37649e+15,361.084,2639.16,8951,298,186,7479,7043,4447,3079,3348
14163,213,354,0,14163,13480,683,2.56117e+16,207.782,1531.46,14163,99,103,13686,13486,12467,11735,10936
37553,34,348,0,37553,35546,2007,2.6595e+16,299.697,2519.91,37553,141,151,34323,32245,23809,20398,12419
41815,2069,2203,0,41815,0,41815,2.4625e+18,1437.43,7235.35,41815,566,418,39612,39612,38921,38233,39202
45626,21,44,43106,2520,45137,489,1.06517e+14,41.8551,980.375,45626,44,43,45052,44555,37604,37144,30335
25304,591,828,24555,749,25304,0,4.47488e+18,494.871,3178.31,25304,238,201,24450,23857,21241,21332,20099
19835,1086,1579,0,19835,7082,12753,9.59457e+15,872.5,4064.76,19835,393,282,18005,16611,13810,10884,15891
3092,737,928,2753,339,1945,1147,5.10799e+17,89.7209,1365.88,3092,168,125,2164,2163,2072,2076,962
40581,1646,1777,0,40581,0,40581,2.54446e+18,1416.18,6795.98,40581,510,433,38786,35108,36314,33952,38366
4626,184,1580,3615,1011,2066,2560,8.61776e+17,210.453,2330.13,4626,175,166,2826,2259,1209,1188,639
43676,787,2462,43676,0,35631,8045,3.10986e+18,1721.13,8200.82,43676,559,468,35148,29348,19542,17775,17478
31477,357,2639,31477,0,26255,5222,3.30701e+18,1617.64,7027.4,31477,572,393,23180,19927,11849,9888,5468
38563,1441,2552,0,38563,0,38563,2.43983e+18,1427.49,7179.05,38563,621,398,35270,30893,22385,20788,25573
10672,1438,1668,0,10672,0,10672,2.51263e+18,829.206,3436.75,10672,299,267,9004,8146,7470,7384,8204
3304,249,437,3097,207,3304,0,4.04609e+18,178.458,944,3304,114,80,2867,2732,2426,2461,1672
6482,293,1681,3163,3319,3163,3319,4.85001e+18,229.524,2692.65,6482,236,179,4735,4243,2066,1784,1034
26107,844,2266,26107,0,21433,4674,3.04985e+18,1558.29,6251.85,26107,432,389,20822,17602,13276,12469,10678
17435,871,1526,6156,11279,0,17435,3.7042e+13,850.026,3829.63,17435,401,261,15460,14340,10934,10691,9874
19975,225,348,0,19975,19008,967,2.58975e+16,243.467,1804.91,19975,113,119,19439,19096,17639,16482,15524
29137,1712,2210,29137,0,23456,5681,2.98708e+18,1508.06,6515.66,29137,446,408,26403,22230,25361,25627,24028
29943,514,705,29467,476,29943,0,4.65805e+18,498.467,3356.45,29943,249,219,29080,28299,25878,25928,24966
30161,902,1731,10730,19431,0,30161,3.72395e+13,1041.99,5162.92,30161,479,337,27268,25141,18224,18271,16640
29527,691,1543,0,29527,10468,19059,9.71305e+15,1050.04,5030.33,29527,443,332,26114,23953,15482,11100,13625
19458,135,350,0,19458,18365,1093,2.7404e+16,259.593,1832.95,19458,116,122,18658,18281,15213,13506,11627
38826,573,1354,0,38826,13716,25110,9.89297e+15,1099.62,5579.97,38826,466,380,33981,30781,18069,13937,18173
33737,101,354,0,33737,32273,1464,2.46586e+16,266.07,2287.28,33737,128,139,32532,31988,26558,22889,18487
19365,31,42,18477,888,18797,568,9.81132e+13,36.6463,617.786,19365,36,33,19284,19232,17872,17838,16559
30649,271,347,0,30649,29171,1478,2.58076e+16,276.706,2227.48,30649,127,140,30089,29525,27708,26647,25618
25647,41,43,24442,1205,24966,681,9.94664e+13,37.492,722.917,25647,39,37,25600,25583,25539,25538,24926
40128,356,2424,21330,18798,0,40128,5.01462e+18,1406.72,7195.03,40128,578,410,31843,28661,11707,11475,7161
41972,369,1723,19766,22206,19766,22206,5.03893e+18,1422.54,6864.44,41972,508,444,32775,28556,10263,10051,10980
42831,855,902,41730,1101,42831,0,4.59917e+18,620.246,4219.35,42831,325,237,41929,41861,41760,41758,41255
7060,1292,1295,2521,4539,0,7060,3.78237e+13,213.375,2292.03,7060,265,170,5765,5765,5765,5765,5765
20076,13,43,19093,983,19613,463,1.00681e+14,37.5646,640.567,20076,39,36,19444,19044,15666,15415,11023
22858,22,43,21533,1325,22661,197,1.06591e+14,38.7672,696.906,22858,40,38,22577,22322,19023,18937,15642
12102,1662,2306,12102,0,9999,2103,3.34322e+18,966.583,4249.84,12102,397,273,9796,8768,9291,9052,8122
21554,659,1833,10539,11015,10539,11015,5.01639e+18,1223.8,5040.5,21554,382,346,17677,15420,8310,7967,9376
39069,415,1777,0,39069,0,39069,2.54185e+18,1420.44,6705.96,39069,510,426,30913,26699,9717,7780,8217
4420,892,1354,2027,2393,0,4420,4.81849e+18,204.345,2063.48,4420,210,143,3066,2975,2433,2352,2568
34081,458,1596,12128,21953,0,34081,3.79731e+13,1076.88,5405.29,34081,450,352,29386,26828,15268,13762,10717
18157,402,2371,15121,3036,9486,8671,7.29508e+17,1245.9,5169.39,18157,435,312,13494,11944,6989,7476,3627
42781,56,2272,21229,21552,21229,21552,4.94216e+18,1409.35,7428.3,42781,550,434,23696,14940,7866,8182,1840
42038,194,2955,35141,6897,22092,19946,7.24241e+17,1736.48,8311.9,42038,653,439,28857,22298,13482,15234,4060
18026,1574,2030,9313,8713,9313,8713,4.85387e+18,1077.27,4655.81,18026,443,304,15935,14313,12602,12255,13195
14469,1574,1624,0,14469,5127,9342,9.78754e+15,699.429,3633.64,14469,318,255,12845,12845,12844,12845,12796
27365,23,345,0,27365,25959,1406,2.63242e+16,276.68,2137.45,27365,124,132,24182,22167,16891,14704,8709
32002,71,353,0,32002,30381,1621,2.62116e+16,296.763,2330.77,32002,135,141,30326,29608,22667,19446,13780
20512,1765,2048,16463,4049,9794,10718,8.29537e+17,1451.16,5408.81,20512,386,356,18118,15323,16442,15858,16632
8570,105,355,0,8570,8206,364,2.40641e+16,69.5123,1152.47,8570,81,82,8199,8091,7021,6173,5148
24014,31,43,22786,1228,23530,484,1.01671e+14,39.0432,713.712,24014,40,37,23893,23821,21791,21794,19534
10532,83,1281,0,10532,3739,6793,1.00856e+16,637.223,2855.51,10532,255,241,7523,6145,2705,2002,1287
17333,1234,1429,0,17333,6180,11153,9.92682e+15,859.209,3787.01,17333,317,285,15840,14443,13737,12568,15382
5727,638,1674,4952,775,3274,2453,6.42518e+17,259.731,2524.45,5727,258,187,4053,3794,2777,2825,1535
32793,1668,2358,26780,6013,16345,16448,7.83691e+17,1629.87,7047.39,32793,509,409,29568,24806,24500,23926,25071
6122,553,1553,0,6122,0,6122,2.40658e+18,284.368,2485.43,6122,258,205,4569,4232,2758,2652,1789
40392,1114,2303,21108,19284,21108,19284,4.90953e+18,1479.73,7161.93,40392,581,416,35773,31797,19995,20167,21544
43514,1566,2067,21897,21617,0,43514,5.10402e+18,1440.04,7295.37,43514,537,434,41033,35118,29980,27893,36291
16967,190,1593,0,16967,6010,10957,9.62116e+15,823.215,3823.86,16967,389,270,13674,12483,5785,3667,3214
18639,992,2397,15584,3055,9810,8829,7.28424e+17,1253.89,5243.75,18639,425,315,15165,13361,11157,10889,9590
35377,276,1761,12562,22815,0,35377,3.7447e+13,1067.03,5581.29,35377,522,350,29689,27432,13609,12224,7814
35532,12,43,33508,2024,35177,355,1.06793e+14,39.5579,866.335,35532,42,40,34028,32965,26537,25928,17605
8687,674,1298,3069,5618,0,8687,3.91457e+13,477.34,2591,8687,242,221,7389,6878,4549,4621,5078
19415,367,1658,9092,10323,9092,10323,4.98141e+18,1174.12,4625.06,19415,352,329,15008,13157,4948,4771,4545
20631,424,2001,11003,9628,11003,9628,4.90261e+18,1155.85,4919.52,20631,443,313,16486,14804,7331,7525,4136
45693,387,2337,45693,0,36963,8730,3.03754e+18,1753.86,8337.39,45693,589,475,33269,28594,14871,12392,9957
28984,167,2049,0,28984,0,28984,2.48124e+18,1317.88,5974.44,28984,442,385,20779,16341,6949,3648,2354
6866,262,1244,0,6866,2426,4440,9.47382e+15,171.079,2196.21,6866,260,184,5622,5351,3277,1956,1522
43894,562,867,42548,1346,43894,0,4.51798e+18,598.503,4196.25,43894,300,240,42776,41499,38072,38149,33884
20591,379,787,20105,486,20591,0,4.49813e+18,449.651,2855.27,20591,196,184,19477,18853,13978,14177,12907
31136,863,2303,0,31136,0,31136,2.43819e+18,1346.86,6292.74,31136,523,371,26474,23919,13551,13322,12586
37070,318,1737,0,37070,0,37070,2.55327e+18,1410.65,6478.64,37070,484,421,28409,24485,8345,5927,8307
43801,1088,2840,36732,7069,23294,20507,7.12403e+17,1718.1,8350.7,43801,611,441,36971,32027,27842,26738,19464
7998,99,347,0,7998,7567,431,2.71005e+16,139.285,1169.29,7998,84,81,7564,7441,6033,5496,3954
25830,490,790,25195,635,25830,0,4.60832e+18,519.346,3222,25830,230,203,24754,23999,22432,22594,18454
25826,1081,1651,9209,16617,0,25826,3.73915e+13,973.896,4703.08,25826,455,301,23612,21705,17580,18040,19279
20391,1110,1731,9577,10814,9577,10814,4.97445e+18,1190.82,4805.47,20391,388,334,17646,15634,11416,10675,14011
23530,107,355,0,23530,22177,1353,2.73042e+16,270.835,2008.18,23530,124,130,22466,21992,17471,15257,11969
11937,1761,2139,11937,0,9897,2040,3.16946e+18,929.948,4082.45,11937,289,266,9798,8871,9455,9401,9006
27302,103,354,0,27302,25885,1417,2.62767e+16,287.206,2164.21,27302,129,133,26128,25597,20516,17729,13887
25592,469,2065,13139,12453,0,25592,4.93849e+18,1312.01,5573.2,25592,488,349,20590,18392,7833,8315,6905
6269,510,1189,0,6269,2268,4001,9.81838e+15,170.292,2065.41,6269,222,146,5080,4926,3608,2115,2091
47040,41,43,44668,2372,46097,943,1.02047e+14,40.8581,984.27,47040,43,42,46983,46944,46845,46843,45632
13899,526,1679,6583,7316,6583,7316,5.00458e+18,975.167,3910.04,13899,315,291,10997,9738,4554,4342,5149
24562,1645,2118,12942,11620,0,24562,5.04809e+18,1274.23,5500.11,24562,453,344,22355,19755,17310,16338,18938
25701,1734,2222,13883,11818,0,25701,4.99027e+18,1206.03,5619.42,25701,489,339,23479,20872,19250,18284,20856
3346,518,1151,3346,0,2766,580,3.0013e+18,229.76,1717.1,3346,139,127,2195,2037,1712,1586,1421
45759,6976,7385,39679,6080,23074,22685,6.03437e+17,1310.29,14164.7,45759,1306,702,38374,38374,38235,38019,37570
29694,2319,2637,29694,0,24919,4775,3.30086e+18,1588.78,6825.14,29694,535,382,27057,26901,26549,26645,25829
32077,813,1010,0,32077,30540,1537,2.39983e+16,199.811,3525.09,32077,145,143,31067,31067,30064,29775,27960
38009,1838,2015,18436,19573,0,38009,5.17236e+18,1499.33,6903.54,38009,504,437,35981,34474,32570,31836,35563
21399,20,43,20276,1123,21027,372,1.03099e+14,38.378,670.253,21399,39,38,21090,20860,17874,17667,14170
18175,595,2054,9839,8336,0,18175,5.01804e+18,1007.97,4639.07,18175,403,295,14827,13373,7122,7222,5587
29070,30,43,27432,1638,28756,314,1.06781e+14,37.1526,768.444,29070,40,38,28937,28857,26027,26060,24397
28497,1745,2364,0,28497,0,28497,2.45216e+18,1307.28,6185.04,28497,519,367,26133,23308,19468,18291,23104
20810,269,1637,7429,13381,0,20810,3.75627e+13,882.657,4239.92,20810,413,292,17292,16020,7634,6239,3592
46255,40,43,43959,2296,45340,915,1.02616e+14,40.441,985.682,46255,43,42,46194,46157,46024,46022,44449
19300,2082,2511,19300,0,16016,3284,3.29182e+18,1303.57,5473.83,19300,455,321,16789,14748,16446,16495,15807
7865,882,1814,4124,3741,0,7865,5.01803e+18,317.651,2990.29,7865,279,224,6051,5811,4165,4019,4049
48870,728,2573,25872,22998,0,48870,5.00644e+18,1503.49,8042.27,48870,678,438,41394,36398,18149,19384,19741
27749,331,792,26847,902,27749,0,4.53252e+18,516.934,3294.95,27749,238,205,26205,25018,18706,18230,13464
13105,134,347,0,13105,12438,667,2.63763e+16,218.338,1476.47,13105,96,98,12566,12362,10541,9443,7230
35168,244,985,33949,1219,35168,0,4.47127e+18,576.69,3863.89,35168,306,219,32548,30366,17556,17351,11439
24232,313,2181,12692,11540,12692,11540,4.91732e+18,1280.76,5529.46,24232,464,342,18725,16428,6796,7090,3149
22367,1283,2331,10539,11828,0,22367,5.03236e+18,1293.65,5656.1,22367,491,352,19080,17137,11092,9572,13746
34388,2,43,32845,1543,33335,1053,9.74541e+13,39.6969,838.767,34388,42,39,21368,17552,16852,17820,13078
12192,687,1751,0,12192,0,12192,2.50285e+18,912.047,3751.32,12192,323,276,9706,8604,5011,4471,5073
15804,1944,2006,8242,7562,8242,7562,4.91708e+18,978.394,4355.83,15804,383,294,13798,13798,13723,13630,13795
9678,994,1308,0,9678,3371,6307,9.65409e+15,564.603,2751.27,9678,272,201,8370,7800,6711,6186,7440
31403,4,43,29941,1462,30522,881,9.84444e+13,38.5884,803.504,31403,41,39,25340,22353,20218,19763,12621
8758,349,683,8694,64,8758,0,4.77153e+18,298.196,1869.63,8758,176,149,8048,7745,6133,6141,5600
49255,2,42,46564,2691,48715,540,1.06567e+14,40.3187,1000.65,49255,42,41,29179,23387,21744,23429,17523
1244,311,495,671,573,671,573,5.55406e+18,114.651,717.531,1244,91,108,749,654,497,488,555
9692,596,2006,9692,0,7832,1860,2.94207e+18,818.919,3649.91,9692,250,259,7071,6158,3639,3571,3365
6902,199,1682,3391,3511,0,6902,5.13194e+18,318.99,2782.24,6902,238,233,4860,3930,1655,1355,1080
37168,945,2680,30851,6317,19192,17976,7.39084e+17,1720.79,7665.35,37168,593,419,30452,26548,21499,20753,14421
31027,300,1749,0,31027,0,31027,2.53979e+18,1383.53,5967.1,31027,471,391,23416,20153,6618,4594,6192
40770,1224,2781,40770,0,33994,6776,3.28206e+18,1720.11,8068.7,40770,663,440,34920,29997,28751,27591,23463
10234,895,1836,5216,5018,0,10234,4.91539e+18,666.803,3411.52,10234,342,227,8380,7654,5378,4837,5219
22114,877,2443,22114,0,18530,3584,3.31038e+18,1440.33,5778.97,22114,480,340,17606,15342,12397,11786,7276
32371,3040,4546,26210,6161,15516,16855,8.2122e+17,1100.94,9129.42,32371,468,448,27825,27762,26177,25933,24219
37755,767,2040,0,37755,0,37755,2.49243e+18,1414.08,6793.98,37755,506,423,31915,28251,14515,13509,16479
24644,40,43,23391,1253,24157,487,1.02521e+14,39.5678,723.242,24644,40,38,24592,24570,24506,24504,23511
31976,27,43,30410,1566,31220,756,1.00272e+14,40.5846,818.027,31976,42,38,31766,31643,28241,28275,24342
24936,673,1752,0,24936,0,24936,2.54571e+18,1314.98,5360.22,24936,401,362,20340,17643,9143,7838,10464
1300,56,140,0,1300,1229,71,2.8158e+16,31.07,341.157,1300,35,41,1160,1129,982,917,759
3304,349,706,1138,2166,0,3304,3.54495e+13,77.4597,1221.59,3304,161,114,2598,2585,1708,1593,1441
17801,470,2032,9810,7991,9810,7991,4.9537e+18,991.109,4545.34,17801,364,294,14339,13061,7120,7029,5097
28262,245,1694,9960,18302,0,28262,3.69866e+13,1054.71,5015.25,28262,473,329,23303,21514,9621,6775,5877
22839,1172,2116,0,22839,0,22839,2.47313e+18,1239.89,5423.27,22839,402,335,19705,17703,12060,10909,12750
24815,23,43,23719,1096,24049,766,9.69938e+13,37.4912,711.827,24815,40,37,24592,24423,21594,21540,17788
31904,1059,2361,31904,0,26169,5735,3.0309e+18,1604.05,6954.32,31904,498,418,26547,22702,19645,18432,16160
37592,337,348,0,37592,35461,2131,2.74395e+16,300.416,2536.28,37592,147,158,37206,36329,37046,36794,36732
30071,88,1739,10645,19426,0,30071,3.83643e+13,1098.18,5372.83,30071,553,342,21908,18210,8534,3046,2098
21186,30,43,20136,1050,20749,437,1.0193e+14,39.0102,659.013,21186,40,37,21077,21012,19117,19144,17501
22082,37,43,21030,1052,21524,558,1.00012e+14,38.5192,678.839,22082,39,37,22020,21984,21151,21155,20455
17735,1505,2012,9263,8472,9263,8472,4.94974e+18,1060.68,4618.14,17735,396,310,15585,14083,11979,11434,13771
36627,1462,1695,0,36627,13002,23625,9.578e+15,1100.64,5626.25,36627,516,354,34932,34828,31755,29198,34233
33446,2290,2375,0,33446,0,33446,2.44215e+18,1387.34,6613.83,33446,540,390,31071,31071,30863,30862,31069
38048,253,2534,31351,6697,19478,18570,7.60064e+17,1657.98,7646.14,38048,570,424,26671,22487,12744,14054,5395
2562,184,974,1977,585,1067,1495,9.46376e+17,127.672,1392.62,2562,137,134,1517,1384,813,781,232
6282,342,1992,6282,0,5031,1251,2.97495e+18,300.732,2986.7,6282,212,208,4197,3607,1995,1541,935
14552,1623,2379,12259,2293,7834,6718,7.04739e+17,1028.45,4617.93,14552,387,284,12063,10837,10329,10284,9812
49592,1462,2622,25866,23726,0,49592,4.99656e+18,1507.97,8176.58,49592,661,446,45815,39780,27100,24449,34263
12543,328,1354,0,12543,4468,8075,9.911e+15,705.863,3191.38,12543,288,248,10335,9491,5051,3708,3628
45830,1871,2492,0,45830,0,45830,2.43766e+18,1481.84,7751.33,45830,645,434,43338,43094,34490,32517,40973
17395,493,699,16973,422,17395,0,4.69165e+18,462.501,2576.08,17395,209,175,16561,16134,15411,15437,13179
30310,42,354,0,30310,28848,1462,2.56208e+16,284.306,2224.04,30310,126,138,28320,27061,20704,17862,11852
34921,976,2865,34921,0,28806,6115,3.01263e+18,1609.62,7672.29,34921,517,452,28587,24677,17298,15966,14686
15697,275,2367,15697,0,13121,2576,3.32253e+18,1131.56,4855.96,15697,389,325,11108,9460,5601,4327,1805
39768,138,1919,14110,25658,0,39768,3.74426e+13,1092.08,6125.52,39768,535,370,31559,28103,13123,4777,7385
43903,13,43,41445,2458,43473,430,1.06639e+14,40.9411,965.388,43903,43,42,42274,41207,32970,32404,23068
14062,23,43,13404,658,13695,367,9.93833e+13,37.2572,537.249,14062,36,33,13918,13813,12261,12227,10484
43338,1925,2079,21737,21601,0,43338,5.09778e+18,1443.63,7307.21,43338,539,434,41259,41259,39487,39423,40757
6005,1157,1789,5050,955,3164,2841,7.06885e+17,330.36,2731.22,6005,237,179,4216,4043,3684,3583,3429
16418,275,349,0,16418,15539,879,2.69394e+16,238.058,1666.2,16418,109,115,16001,15702,14736,14107,13750
22260,295,354,0,22260,21197,1063,2.52817e+16,248.603,1891.03,22260,111,116,21820,21459,20812,19860,20380
26468,475,2224,13838,12630,0,26468,4.95546e+18,1254.62,5745.3,26468,527,352,21379,19098,8036,8699,6421
8319,60,353,0,8319,7946,373,2.53185e+16,82.3967,1151.2,8319,81,84,7860,7666,6123,5574,4445
43450,703,781,42973,477,43450,0,4.72344e+18,560.799,4193.38,43450,293,252,42669,42625,41587,41597,40626
36205,118,1745,0,36205,0,36205,2.55519e+18,1348.63,6358.27,36205,477,427,23692,16399,6179,3855,3429
42010,958,1834,0,42010,14863,27147,9.46764e+15,1119.79,6147.3,42010,595,367,38591,35213,25112,18428,28829
35725,539,2270,19131,16594,0,35725,5.05672e+18,1386.03,6659.42,35725,554,406,29450,26240,13338,13454,11366
38593,340,1772,18380,20213,18380,20213,5.00224e+18,1425.43,6660.51,38593,511,427,29760,26130,8294,8545,7580
15651,1723,2064,12574,3077,7440,8211,8.28109e+17,1324.52,4755.48,15651,359,309,13364,11407,12091,11539,11855
28268,1643,5196,0,28268,0,28268,2.17556e+18,666.976,8730.09,28268,923,395,23072,22210,13072,11027,10634
9379,256,1520,0,9379,3299,6080,9.27507e+15,432.596,2828.57,9379,299,193,7525,7052,3735,2449,2536
18543,540,2442,18543,0,15387,3156,3.01754e+18,1354.47,5345.55,18543,390,312,13948,12178,7816,7006,3579
24723,427,660,24504,219,24723,0,4.70837e+18,452.592,3016.36,24723,221,209,23803,23168,18588,18538,17848
26963,193,1627,0,26963,9537,17426,9.57428e+15,1043.47,4863.31,26963,465,322,21815,19941,9119,6036,4934
14223,1129,1380,0,14223,5008,9215,9.78172e+15,775.052,3415.11,14223,295,269,12669,11729,10672,9526,11491
28049,590,2388,0,28049,0,28049,2.42761e+18,1258.2,6083.4,28049,531,374,22950,20531,9548,10320,7728
16391,1421,1954,0,16391,0,16391,2.49381e+18,1046.03,4431.17,16391,351,303,14211,12868,10592,10104,11327
33073,19,43,31555,1518,32130,943,9.85629e+13,38.5465,822.137,33073,41,39,32610,32258,27682,27402,20512
12077,229,1521,4235,7842,0,12077,3.6726e+13,668.129,3220.53,12077,335,222,9723,8984,4098,3364,2805
4757,12,39,4464,293,4726,31,1.09999e+14,26.5567,323.799,4757,29,30,4511,4337,3356,3351,2381
41305,56,2797,34513,6792,21775,19530,7.23216e+17,1684.45,8082.63,41305,633,425,21813,14204,9553,10045,2659
12034,447,1672,4229,7805,0,12034,3.79543e+13,675.866,3405.3,12034,332,249,9772,8939,4463,4320,4806
23286,1678,2271,19151,4135,11845,11441,7.66211e+17,1500.7,5856.76,23286,456,349,20433,17523,17502,17194,17176
32863,42,44,31005,1858,32543,320,1.06584e+14,41.3343,836.419,32863,43,41,32812,32783,32711,32710,31797
40658,1449,2770,33868,6790,21291,19367,7.28597e+17,1715.79,8037.1,40658,641,435,35756,30569,28822,28626,27555
6782,1250,2085,5498,1284,3261,3521,7.9871e+17,312.343,3155.25,6782,243,236,4697,4555,3842,3970,3080
31110,762,1324,0,31110,11015,20095,9.9524e+15,1053.45,4980.17,31110,421,356,27848,25320,17702,13561,18780
15881,1312,2004,8465,7416,0,15881,5.00818e+18,928.124,4337.28,15881,361,293,13551,12448,9791,9229,10122
22686,1376,2126,11887,10799,11887,10799,4.91327e+18,1231.08,5296.98,22686,454,335,20039,17817,14034,13258,15701
43356,98,1888,0,43356,15356,28000,9.53175e+15,1158.5,6326.01,43356,599,372,33092,28021,13682,7552,3873
24687,523,2005,12641,12046,12641,12046,4.91335e+18,1283.22,5479.37,24687,444,340,19943,17746,8019,8456,7234
19049,9,351,0,19049,18114,935,2.57341e+16,260.135,1774.37,19049,106,108,15021,13045,10870,9626,5656
33633,316,2290,17916,15717,0,33633,4.99145e+18,1352.32,6490.37,33633,538,379,26359,23349,9829,8929,5746
20635,494,2014,0,20635,0,20635,2.42763e+18,1139.19,4902.69,20635,447,316,16741,15014,7686,6473,5016
41211,2713,3071,41211,0,34350,6861,3.1908e+18,1710.02,8419,41211,607,443,38140,38139,37738,37818,37099
19285,784,1451,6847,12438,0,19285,3.82017e+13,884.16,4007.46,19285,347,296,17039,15706,11188,10153,12183
3311,694,1059,0,3311,0,3311,2.22609e+18,105.516,1608.08,3311,138,121,2252,2237,1754,1859,1770
17148,1520,2467,8506,8642,0,17148,5.02418e+18,840.747,4948.13,17148,447,311,14681,13957,9358,9024,11852
49104,98,2195,0,49104,0,49104,2.47344e+18,1471.58,7800.74,49104,593,446,31941,23027,11251,5115,3526
4325,413,1108,2461,1864,0,4325,5.09794e+18,175.836,1752.4,4325,232,169,3217,3071,2501,2495,1189
2393,527,931,2130,263,1421,972,5.37139e+17,139.99,1302.64,2393,143,115,1462,1383,1191,1211,669
46864,481,2880,38395,8469,22236,24628,7.71683e+17,1982.65,9209.48,46864,688,472,34546,27717,15514,16865,9098
40378,1501,2545,40378,0,33305,7073,3.16471e+18,1681.49,7889.98,40378,597,449,35991,30357,32306,30107,28878
12301,48,347,0,12301,11749,552,2.51186e+16,170.888,1397.11,12301,97,93,11561,11178,8852,8004,6227
18480,17,43,17610,870,18027,453,9.98874e+13,37.9508,616.596,18480,38,36,18127,17846,15083,15017,11365
6450,108,1292,0,6450,2274,4176,9.8935e+15,187.935,2251.56,6450,217,163,4845,4086,1786,1521,966
24991,1148,1833,12366,12625,12366,12625,4.99732e+18,1288.32,5406.85,24991,424,362,22040,19441,13992,13274,16508
34021,595,712,33518,503,34021,0,4.66338e+18,509.474,3589.64,34021,253,229,33295,32851,31591,31573,30896
35687,17,595,35365,322,35687,0,4.7664e+18,498.18,3556.01,35687,237,237,13731,4936,4026,3690,1170
13687,176,349,0,13687,12975,712,2.67657e+16,220.351,1514.7,13687,99,104,13173,12947,11567,10604,8740
12987,349,353,0,12987,12249,738,2.74205e+16,214.739,1495.49,12987,96,103,12634,12624,12609,12460,12620
5415,689,1047,1971,3444,0,5415,3.84231e+13,160.676,1814.69,5415,198,142,4368,4305,3890,4041,2544
21681,532,2504,21681,0,18156,3525,3.30133e+18,1409.68,5750.82,21681,493,348,16534,14505,9480,7993,6001
15261,1099,1702,0,15261,0,15261,2.5531e+18,1092.74,4164.28,15261,320,292,13041,11517,8790,7351,9698
44349,2108,2781,44349,0,37034,7315,3.32086e+18,1763.49,8391.99,44349,646,458,41568,35329,39892,39644,37377
37408,1680,1742,17760,19648,17760,19648,4.98553e+18,1414.55,6506.06,37408,504,420,35666,35560,35151,34860,35448
16551,62,1995,0,16551,0,16551,2.4118e+18,1007.98,4438.46,16551,419,298,9943,7023,3754,1566,705
16415,5,43,15499,916,16224,191,1.07257e+14,37.6248,594.31,16415,38,35,13731,12336,10186,10303,6499
22886,2008,2062,12039,10847,0,22886,5.00967e+18,1258.42,5271.78,22886,437,326,20824,20824,20685,20447,20819
8556,36,43,8162,394,8345,211,1.01458e+14,33.1313,422.672,8556,35,32,8509,8495,8316,8343,8097
1776,51,145,0,1776,1695,81,2.79954e+16,35.6543,393.502,1776,37,40,1629,1606,1420,1386,1232
9507,30,43,9133,374,9109,398,9.29075e+13,24.1124,430.505,9507,32,32,9450,9432,8885,8822,8177
25526,1622,2344,25526,0,21009,4517,3.09866e+18,1507.02,6172.56,25526,458,388,22469,19235,21311,21829,18239
1435,335,543,0,1435,0,1435,2.655e+18,99.6697,798.298,1435,105,94,892,885,595,579,667
14123,695,736,13796,327,14123,0,4.65413e+18,378.48,2336.57,14123,217,153,13387,13387,13332,13292,13310
30241,951,1746,14321,15920,0,30241,5.14361e+18,1350.74,5875.33,30241,465,393,26082,22922,14834,12248,16356
3562,829,1115,1612,1950,1612,1950,4.6149e+18,134.084,1693.1,3562,196,138,2447,2446,2113,2070,2153
28586,22,43,27293,1293,27744,842,9.75605e+13,39.1157,764.19,28586,40,37,28302,28048,24431,24364,21382
38221,522,794,37600,621,38221,0,4.62856e+18,510.994,3866.15,38221,250,234,37243,36166,31448,31374,28563
14808,2180,2303,12344,2464,7733,7075,7.32807e+17,1097.58,4683.09,14808,373,303,12505,12502,12216,12121,12030
26892,886,2540,22470,4422,14177,12715,7.21736e+17,1542.04,6419.1,26892,486,377,21810,18701,15516,14597,11071
47993,1,43,45722,2271,46726,1267,9.94693e+13,41.6242,997.045,47993,43,42,17359,17359,17359,17359,17359
3547,457,1023,0,3547,0,3547,2.78786e+18,189.299,1624.35,3547,151,129,2524,2396,1728,1643,1637
1806,362,522,915,891,915,891,5.11549e+18,126.963,843.94,1806,97,110,1284,1284,992,955,1049
48885,455,2422,39681,9204,24144,24741,8.01463e+17,1742.95,8623.66,48885,607,475,36860,31349,19167,19745,11719
20605,1238,1870,0,20605,0,20605,2.48203e+18,1175.33,4925.65,20605,386,330,17993,16057,11863,10897,13681
42605,1513,2376,22577,20028,22577,20028,4.92139e+18,1458.66,7374.63,42605,601,417,39469,34402,26215,25250,29837
7629,651,1383,0,7629,2703,4926,9.56054e+15,221.23,2430.12,7629,262,191,6246,6081,4499,4702,3313
30491,1407,1799,0,30491,10844,19647,9.48334e+15,1045.5,5225.65,30491,509,326,28692,26550,24261,20979,27411
22964,1976,2169,12044,10920,0,22964,5.01045e+18,1157.52,5330.8,22964,464,335,20795,20792,19242,19041,19928
45428,140,1909,0,45428,16074,29354,9.69158e+15,1281.33,6692.94,45428,580,397,35404,30850,13874,8566,3710
19144,332,357,0,19144,18063,1081,2.73454e+16,264.083,1821.64,19144,115,123,18755,18351,18342,18342,18160
45302,235,358,0,45302,42787,2515,2.69036e+16,317.945,2806.29,45302,154,165,44252,43211,39030,35146,33706
42126,297,356,0,42126,40190,1936,2.51927e+16,302.303,2597.7,42126,145,146,41562,40719,39307,37122,38411
14149,1468,1868,7259,6890,0,14149,5.0756e+18,932.478,4079.13,14149,342,287,12176,11089,9610,9097,10290
35288,1763,2892,35288,0,29107,6181,3.2543e+18,1632.91,7825.35,35288,618,428,31660,26818,29812,27752,25607
14621,822,2377,12321,2300,7789,6832,7.02178e+17,1047.13,4644.22,14621,373,298,11344,10073,7613,7604,5897
18741,27,43,17852,889,18287,454,1.00344e+14,40.2326,628.069,18741,39,36,18603,18532,16659,16646,14370
28147,404,2231,14946,13201,0,28147,5.04774e+18,1308.66,5958.77,28147,485,366,22424,20064,8315,7604,4461
17652,564,2072,9152,8500,9152,8500,4.85478e+18,1045.27,4644.41,17652,429,307,14230,12843,6441,7017,6029
33597,104,922,32557,1040,33597,0,4.52612e+18,537.507,3723.2,33597,268,216,27426,20985,12193,11224,4572
754,5,92,0,754,716,38,2.68544e+16,23.9111,214.208,754,32,29,495,390,351,296,219
7588,41,44,7183,405,7501,87,1.06573e+14,27.2952,397.436,7588,32,30,7544,7542,7526,7524,7356
42857,1744,2265,21210,21647,0,42857,5.05529e+18,1461.65,7474.76,42857,536,453,40592,38981,29268,27019,37620
1972,226,652,716,1256,0,1972,3.56848e+13,71.1876,961.04,1972,167,91,1320,1261,977,884,828
39353,36,43,37503,1850,38298,1055,9.9142e+13,40.1,900.685,39353,42,40,39264,39187,37533,37549,35262
36743,1130,1651,0,36743,13044,23699,9.67765e+15,1107.1,5684.52,36743,466,367,34304,30928,25000,18933,26710
42726,61,354,0,42726,40756,1970,2.50177e+16,289.505,2609.34,42726,139,152,40635,39555,30948,26461,18225
30341,1196,2687,30341,0,25228,5113,3.30018e+18,1625.01,6969.51,30341,587,403,25392,22023,20814,19938,16465
47940,283,358,0,47940,45736,2204,2.52608e+16,298.372,2787.65,47940,146,162,47273,46337,43780,41779,40691
42982,1704,2965,42982,0,35927,7055,3.30893e+18,1750.2,8428.97,42982,668,453,38800,32894,36364,33243,29306
23507,1314,2181,12359,11148,12359,11148,4.90498e+18,1185.58,5426.97,23507,456,338,20684,18516,14250,13921,14922
25737,999,2441,21566,4171,13678,12059,7.17166e+17,1503.8,6172.45,25737,498,349,21299,18556,15623,15221,13094
2852,82,749,969,1883,0,2852,3.60784e+13,87.8815,1216.61,2852,150,109,1992,1630,808,574,486
37178,1089,1893,18279,18899,0,37178,5.08402e+18,1418.75,6637.59,37178,520,414,33048,28928,19587,16634,23687
26183,886,2143,13728,12455,0,26183,5.05721e+18,1280.27,5685.19,26183,477,359,22350,20014,12160,11561,12727
27829,250,358,0,27829,26516,1313,2.5225e+16,272.595,2144.03,27829,128,131,27203,26704,24736,23386,21875
47559,1377,2583,25221,22338,25221,22338,4.90802e+18,1486.26,7939.04,47559,666,442,43389,37930,25896,26608,30847
26871,1700,2217,14117,12754,14117,12754,4.94356e+18,1317.55,5825.56,26871,493,356,24590,21704,18673,17707,22022
45184,2369,2591,37060,8124,22735,22449,7.82336e+17,1751.36,8459.05,45184,589,469,42593,42592,41596,41400,42183
8552,1565,1787,4225,4327,0,8552,5.07407e+18,554.863,3157.77,8552,281,230,6765,6484,6052,6005,6332
46317,1746,1924,0,46317,0,46317,2.51082e+18,1480.34,7449.13,46317,563,443,44393,44309,40809,38923,43919
12282,36,1462,4375,7907,0,12282,3.78e+13,588.196,3099.94,12282,315,242,8062,6506,3760,2067,370
14104,568,2104,11426,2678,6867,7237,8.10376e+17,1144.63,4520.95,14104,344,293,10537,9094,5975,6182,4674
32934,552,1751,11684,21250,0,32934,3.71774e+13,1043.94,5376.7,32934,506,335,28785,26426,16646,14318,16677
32352,585,1760,15388,16964,15388,16964,5.00465e+18,1374,6081.48,32352,477,402,26410,22807,11260,10620,12916
3093,257,1037,2446,647,1474,1619,8.39984e+17,95.86,1544.54,3093,157,141,2056,1912,1340,1317,633
49031,2141,2906,49031,0,40727,8304,3.2734e+18,1790.16,8929.14,49031,680,475,46125,42245,44156,43733,42668
27057,874,897,26414,643,27057,0,4.56708e+18,511.868,3365.2,27057,266,207,26160,26160,26140,26141,26155
563,19,70,0,563,0,563,2.21343e+18,21.9005,155.549,563,43,26,418,66,354,194,163
5904,31,43,5560,344,5882,22,1.07746e+14,28.7683,357.65,5904,32,31,5850,5834,5384,5396,4748
10638,1843,1848,0,10638,0,10638,2.39268e+18,612.873,3425.48,10638,329,225,8790,8790,8779,8773,8788
13307,1243,1477,4731,8576,0,13307,3.76167e+13,633.995,3233.52,13307,326,245,11830,11174,10527,10615,11127
24893,649,1330,8795,16098,0,24893,3.85734e+13,1005.5,4461.22,24893,387,322,21767,19954,12769,10986,13181
37133,1036,4671,30297,6836,18547,18586,1.05668e+18,1223.91,9925.08,37133,870,493,29929,25863,18234,18462,5034
38125,230,377,0,38125,36048,2077,2.7296e+16,309.572,2638.99,38125,149,157,37207,36379,32683,29497,27946
37410,354,1315,0,37410,13186,24224,9.94577e+15,1069.95,5422.1,37410,444,376,31612,28790,14648,10708,13328
34503,1650,2202,34503,0,27763,6740,3.03557e+18,1592.41,7119.99,34503,507,430,31268,26184,30335,30498,27410
14423,228,2168,14423,0,11568,2855,3.00105e+18,1191.14,4651.35,14423,312,318,9381,7398,3388,2801,1327
37104,35,43,35405,1699,36051,1053,9.78004e+13,39.7841,870.899,37104,42,39,37013,36919,35143,35222,33130
7793,1339,1802,4108,3685,4108,3685,4.91749e+18,302.868,2963.61,7793,284,221,5991,5925,5342,5360,5394
42731,473,2161,21496,21235,21496,21235,4.9574e+18,1458.55,7343.38,42731,531,440,34476,30165,11853,12685,13308
17415,21,750,16988,427,17415,0,4.56912e+18,425.695,2599.44,17415,230,175,8259,2668,2972,2832,585
13050,1531,2261,10620,2430,6402,6648,8.05772e+17,1050.77,4432.04,13050,328,286,10644,9460,8906,8911,8562
29721,7,43,28374,1347,28831,890,9.84943e+13,40.3548,782.488,29721,41,38,27263,25642,21226,21152,12999
24003,1235,1912,11780,12223,0,24003,5.03183e+18,1269.23,5362.43,24003,412,355,21255,18650,14136,12721,17128
40387,102,683,39888,499,40387,0,4.69532e+18,497.115,3859.4,40387,253,241,32257,23215,13188,13111,7061
31080,56,1774,14683,16397,14683,16397,4.97395e+18,1364.37,5976.81,31080,465,396,16361,9553,4553,5334,953
22611,527,2487,19006,3605,12124,10487,7.03767e+17,1346.29,5792.8,22611,442,341,17506,15317,9694,10386,5590
38371,101,357,0,38371,36647,1724,2.50421e+16,290.667,2479.43,38371,136,146,36934,36280,29850,25827,21112
42147,370,382,0,42147,39793,2354,2.70283e+16,319.039,2765.77,42147,153,162,41759,41618,41633,41691,41406
42475,55,355,0,42475,40506,1969,2.53301e+16,305.827,2627.55,42475,144,150,40208,38987,30140,25868,17380
15561,1217,1993,8163,7398,8163,7398,4.91339e+18,955.713,4318.35,15561,398,293,13152,12149,8950,9251,8810
9439,2011,2015,0,9439,0,9439,2.21248e+18,257.286,3336.09,9439,205,320,7424,7424,7424,7424,7419
48490,270,908,47571,919,48490,0,4.60628e+18,541.061,4437.2,48490,286,253,45586,43003,23965,24241,19523
4786,291,1340,0,4786,0,4786,2.60001e+18,189.616,2137.29,4786,218,190,3434,3157,1549,1336,1255
46617,138,914,45482,1135,46617,0,4.53772e+18,564.597,4362.85,46617,283,250,40450,33054,17213,15719,9982
5324,8,43,5054,270,5225,99,9.94999e+13,26.3704,339.598,5324,29,30,4898,4648,3753,3778,2765
37145,1001,1766,0,37145,13219,23926,9.6006e+15,1097.08,5735,37145,535,353,34180,31174,23329,17560,27180
37071,5,43,34989,2082,36689,382,1.06558e+14,40.1881,888.929,37071,43,40,31139,27977,23163,23483,15020
11568,231,1873,6298,5270,6298,5270,4.95691e+18,715.175,3581.89,11568,312,252,8649,7688,3811,4016,1550
42697,2118,2495,22222,20475,22222,20475,4.8663e+18,1498.74,7515.08,42697,638,420,40202,40202,36779,36527,38897
25849,1254,2291,13647,12202,0,25849,5.00249e+18,1286.28,5778.34,25849,489,349,22690,20260,13526,12504,14964
24555,133,1642,0,24555,8726,15829,9.50277e+15,931.566,4562.03,24555,446,301,19523,17455,8815,5544,5315
12409,330,353,0,12409,11785,624,2.61659e+16,214.572,1439.57,12409,93,95,12056,11894,11885,11864,11778
40192,2627,2878,33124,7068,19960,20232,7.64211e+17,1752.74,8411.98,40192,573,446,37314,37285,36198,36045,36611
32395,184,1762,11537,20858,0,32395,3.74608e+13,1072.51,5382.34,32395,510,340,26183,23987,11228,9011,5647
3588,135,436,3476,112,3588,0,4.28257e+18,144.91,1022.13,3588,113,86,3016,2632,1827,1818,1372
40580,2118,2131,21115,19465,0,40580,5.09969e+18,1435.92,7075.82,40580,538,425,38449,38449,38429,38275,38447
28977,80,352,0,28977,27407,1570,2.68119e+16,284.124,2220.3,28977,130,138,27518,26815,20697,18208,13355
1052,261,300,0,1052,335,717,8.04986e+15,40.7433,471.483,1052,63,57,752,752,728,722,725
25614,1118,2064,0,25614,0,25614,2.41488e+18,1303.58,5572.29,25614,491,349,22403,20114,13415,11981,14150
12726,212,2210,12726,0,10706,2020,3.3004e+18,924.478,4192.6,12726,359,263,8814,7212,4588,3655,1473
6001,1114,1222,2124,3877,0,6001,3.84182e+13,207.879,2137.56,6001,207,196,4779,4779,4714,4745,4619
34669,24,42,32732,1937,34287,382,1.06594e+14,39.8157,845.597,34669,41,40,34361,34108,29732,29638,24991
30664,1671,2254,16159,14505,16159,14505,4.92533e+18,1348.06,6231.83,30664,514,366,28321,24811,20769,19520,23574
7263,27,43,6918,345,7085,178,1.0053e+14,29.1559,391.018,7263,32,30,7196,7171,6758,6755,6260
7507,179,2131,7507,0,6223,1284,3.27566e+18,313.09,3278.19,7507,259,212,4852,3675,2218,1973,1017
22590,468,2144,11694,10896,0,22590,4.98746e+18,1212.71,5320.82,22590,462,338,18057,16098,6716,6448,5633
33167,142,797,32209,958,33167,0,4.45321e+18,556.169,3615.51,33167,248,219,28935,23916,12628,11740,7187
5365,504,1481,0,5365,0,5365,2.45523e+18,215.259,2335.05,5365,227,175,3884,3658,2228,1993,2040
27237,1231,2046,21601,5636,12708,14529,8.61846e+17,1523.58,6193.42,27237,470,382,23196,19714,17871,17459,17276
4800,1076,1389,4101,699,2735,2065,6.43964e+17,228.68,2110.98,4800,205,147,3411,3369,3196,3163,3063
23575,456,2120,0,23575,0,23575,2.43476e+18,1270.96,5416.6,23575,462,337,18821,16845,7115,6323,4563
47093,552,1512,0,47093,16657,30436,9.79862e+15,1149.53,6317.14,47093,525,395,41258,37402,21712,15662,21204
3580,621,1058,0,3580,0,3580,2.49443e+18,172.016,1661.15,3580,204,176,2522,2416,1735,1749,1759
40933,514,628,40547,386,40933,0,4.74645e+18,502.548,3837.08,40933,253,247,40150,39045,37229,37352,35643
38238,2339,2801,31822,6416,19918,18320,7.32734e+17,1679.2,7848.41,38238,627,424,35437,35296,32983,32394,34296
15122,398,1982,7812,7310,0,15122,5.00981e+18,975.878,4279.24,15122,349,294,11783,10638,4570,4267,3204
787,146,241,273,514,0,787,4.00641e+13,68.6811,389.379,787,67,74,546,500,410,463,444
48592,944,1823,0,48592,0,48592,2.53877e+18,1473.42,7525.67,48592,551,456,42383,36847,22781,18556,25964
24906,214,2486,24906,0,20983,3923,3.30913e+18,1454.34,6113.16,24906,512,374,17377,14042,8742,6245,1959
38706,744,1808,18246,20460,0,38706,5.14593e+18,1376,6641.43,38706,499,428,32681,28587,15407,12824,17778
7589,21,43,7238,351,7378,211,9.88448e+13,29.559,397.759,7589,32,30,7486,7418,6670,6623,5540
41680,416,2481,21736,19944,21736,19944,4.90727e+18,1466.23,7426.79,41680,611,420,33366,29622,11575,12750,7511
35297,21,42,33321,1976,34923,374,1.06874e+14,39.5663,854.268,35297,41,40,34860,34483,29088,28849,24244
2470,355,364,2443,27,2470,0,5.01346e+18,146.468,816.079,2470,80,82,2106,2106,2104,2105,2101
13741,19,350,0,13741,13047,694,2.62462e+16,212.542,1519.55,13741,98,102,11865,10786,8349,7233,4415
33407,42,43,31869,1538,32477,930,9.83021e+13,40.3157,832.303,33407,42,39,33360,33339,33272,33271,32822
33544,811,1760,11956,21588,0,33544,3.74581e+13,1047.47,5439.54,33544,508,335,30150,27711,19530,18296,21833
8775,1677,2141,8775,0,7243,1532,3.33086e+18,537.804,3504.23,8775,270,222,6634,6352,6462,6406,5096
9772,530,626,9685,87,9772,0,4.76924e+18,297.419,1888.68,9772,165,144,9146,9099,8823,8814,8654
11241,1372,1837,0,11241,0,11241,2.58969e+18,828.983,3682.73,11241,276,266,9404,8494,7070,6481,7847
48516,906,2524,25234,23282,0,48516,4.97381e+18,1518.36,8004.12,48516,635,439,42073,37420,19674,19334,21419
13302,21,2053,10593,2709,6270,7032,8.48034e+17,1104.91,4343.14,13302,339,296,4054,1564,833,906,162
20743,1296,2120,0,20743,0,20743,2.40164e+18,1138.64,5031.36,20743,443,322,18227,16276,12286,10804,13574
40718,302,932,39612,1106,40718,0,4.64096e+18,579.52,4115.42,40718,304,233,38375,36416,25094,24654,17703
37107,1436,1767,13213,23894,0,37107,3.74837e+13,1115.74,5751.51,37107,519,354,35340,33330,29719,30372,34311
17028,329,393,17028,0,17028,0,4.23036e+18,287.29,2032.37,17028,165,141,16620,16178,14446,14541,15009
46302,1222,2335,22204,24098,22204,24098,5.01984e+18,1583.45,7958.33,46302,612,459,41372,36203,23484,21394,29740
29602,506,2243,15451,14151,15451,14151,4.88319e+18,1330.8,6109.6,29602,526,371,24004,21391,8995,10298,8220
7559,1883,1978,5985,1574,3567,3992,8.68054e+17,507.739,3201.23,7559,224,208,5581,5379,5449,5391,5392
12894,577,579,12760,134,12894,0,4.7514e+18,389.042,2136.3,12894,164,158,12315,12315,12314,12315,12314
9499,7,43,9038,461,9271,228,9.96529e+13,34.8962,440.635,9499,32,30,8668,8131,6703,6684,4176
46318,381,1795,21979,24339,0,46318,5.13868e+18,1465.86,7308.53,46318,541,449,36307,31653,11007,9540,12198
33747,466,2617,27977,5770,17429,16318,7.44987e+17,1662.6,7252.36,33747,593,399,25698,22316,13434,14333,6929
31873,760,1373,0,31873,11269,20604,9.91204e+15,1065.24,5098.39,31873,433,354,28445,25928,17694,13559,19828
17674,1053,1420,6214,11460,0,17674,3.75108e+13,891.172,3824.36,17674,348,283,15986,14615,12269,12201,13296
37360,1947,2072,18657,18703,18657,18703,4.9502e+18,1470.51,6840.13,37360,525,422,35288,35271,34699,34490,35182
43217,36,2093,21476,21741,21476,21741,4.95433e+18,1461.2,7314.06,43217,540,435,21012,12908,6660,7679,769
16682,1127,1488,5915,10767,0,16682,3.81472e+13,819.862,3743.94,16682,337,275,15018,13854,11945,10785,13555
2096,260,831,0,2096,0,2096,2.46896e+18,109.932,1174.95,2096,155,116,1265,1107,404,393,347
26979,574,1745,9529,17450,0,26979,3.66746e+13,1038.69,4923.68,26979,489,312,23331,21504,13586,12026,14184
10461,657,1299,3751,6710,0,10461,4.02296e+13,608.934,2855.8,10461,244,241,8872,8333,5752,5657,6137
14439,31,43,13781,658,14021,418,9.82115e+13,35.3432,538.889,14439,37,33,14365,14334,13377,13366,12110
14444,1500,1987,7615,6829,0,14444,5.02254e+18,854.461,4134.43,14444,343,289,12457,11409,10030,9533,10100
46950,6,42,44561,2389,45955,995,1.01469e+14,40.2513,973.784,46950,42,41,41815,38463,31765,32270,21306
26867,379,2190,13902,12965,13902,12965,4.89854e+18,1330.46,5817.4,26867,494,356,21175,18980,7853,8281,6591
49037,5,43,46736,2301,47770,1267,9.92229e+13,41.2051,1007.03,49037,43,42,42006,37791,32730,33061,20758
15310,986,1847,7649,7661,0,15310,5.05235e+18,1030.73,4255.73,15310,337,294,12818,11565,8124,7301,8398
40026,37,2712,40026,0,32834,7192,3.03721e+18,1840.03,8327.68,40026,634,466,15799,7793,5246,5853,844
31530,796,2019,25078,6452,14855,16675,8.58197e+17,1595.9,6644.72,31530,498,415,25079,20788,16122,15264,14189
33643,1089,1822,0,33643,11934,21709,9.55135e+15,1083.48,5516.68,33643,538,339,31002,28206,21700,17385,26023
23223,1642,2550,23223,0,19537,3686,3.33632e+18,1446.6,5983.44,23223,542,351,20080,17379,19052,18022,16766
17701,27,43,16783,918,17360,341,1.029e+14,35.9171,603.663,17701,38,35,17575,17507,15835,15872,14194
46984,107,355,0,46984,44313,2671,2.7333e+16,314.542,2858.33,46984,159,168,44909,43872,34369,29943,23332
25346,1080,2470,21346,4000,13608,11738,6.99599e+17,1477.93,6146.5,25346,463,362,21059,18424,15764,15304,12448
31340,452,753,30605,735,31340,0,4.5282e+18,523.681,3482.19,31340,242,216,30139,29235,24242,24346,21642
22733,1670,1728,10641,12092,10641,12092,4.97204e+18,1274.11,5096.36,22733,413,347,21005,20945,20710,20504,20874
11335,477,1331,0,11335,4020,7315,9.89257e+15,668.935,3013.27,11335,278,252,9441,8712,4791,4256,4662
2593,115,131,0,2593,2516,77,2.32875e+16,52.0266,421.99,2593,41,41,2462,2461,2456,2458,2419
8147,1798,1830,4279,3868,0,8147,5.00494e+18,366.501,3050.81,8147,277,236,6317,6245,6284,6263,6273
19242,1253,1646,0,19242,6791,12451,9.37513e+15,890.401,4113.89,19242,416,278,17511,16049,14488,12772,15921
34768,1861,2630,34768,0,29191,5577,3.29457e+18,1630.45,7310.27,34768,623,416,31710,27008,30280,29275,27855
3801,302,958,1312,2489,0,3801,3.66974e+13,109.161,1528.34,3801,196,136,2843,2755,1672,1305,1436
7902,82,669,7677,225,7902,0,4.60632e+18,248.004,1722.47,7902,190,124,5996,4419,2882,2510,1271
20862,1077,2011,20862,0,16580,4282,3.07262e+18,1414.64,5398.85,20862,404,358,17157,14681,12413,11730,11932
23905,514,1304,0,23905,8430,15475,9.93476e+15,952.518,4300.44,23905,371,318,20630,18844,10808,9247,10646
33544,344,352,0,33544,31928,1616,2.5548e+16,295.394,2344.32,33544,129,136,33187,32799,33096,33023,32874
27635,34,43,26322,1313,26959,676,1.00541e+14,38.764,754.232,27635,40,38,27549,27478,26088,26089,23786
18165,699,1322,0,18165,6458,11707,1.00053e+16,913.733,3813.36,18165,322,290,15808,14580,9867,8047,10240
22975,117,2051,11896,11079,0,22975,5.03269e+18,1227.8,5290.17,22975,434,344,15580,11392,5748,3990,1805
10676,1454,1835,0,10676,0,10676,2.50588e+18,620.155,3453.76,10676,280,271,8841,8357,7649,7417,7897
2012,233,437,2012,0,1899,113,3.65165e+18,91.0984,696.692,2012,108,68,1575,1535,1477,1410,362
29375,29,43,27989,1386,28627,748,9.95299e+13,38.9551,778.327,29375,41,38,29220,29119,26528,26564,23862
10326,384,2320,10326,0,8619,1707,3.32202e+18,730.929,3929.78,10326,357,252,7356,6555,3555,2661,1348
14574,33,42,13778,796,14359,215,1.04737e+14,37.7817,544.173,14574,35,33,14507,14474,13559,13571,12906
9357,652,1396,0,9357,3291,6066,9.59676e+15,509.728,2764.04,9357,273,204,7910,7354,5015,4117,5168
43163,2330,2484,22621,20542,22621,20542,4.8814e+18,1483.18,7519.22,43163,628,420,40679,40679,40488,40424,40665
5851,32,43,5511,340,5810,41,1.09685e+14,26.7477,352.615,5851,31,30,5804,5790,5470,5450,5232
10280,138,375,0,10280,9726,554,2.74212e+16,154.358,1350.4,10280,85,91,9817,9664,8275,7524,6116
26323,1244,1357,0,26323,9333,16990,9.95688e+15,1022.48,4630.43,26323,401,329,24863,22138,22681,21076,23838
37512,2153,2319,19648,17864,19648,17864,4.91991e+18,1435.66,6922.37,37512,563,414,35193,35192,33888,33790,34137
20084,605,793,19461,623,20084,0,4.43456e+18,467.35,2825.41,20084,250,174,19290,18855,18019,18128,16908
12845,1128,1307,0,12845,4537,8308,9.90223e+15,723.682,3189.94,12845,293,260,11404,10553,9562,8679,10090
21783,58,691,21377,406,21783,0,4.70293e+18,471.902,2870.16,21783,228,197,14783,8965,5894,5493,2590
41451,63,2199,0,41451,0,41451,2.48278e+18,1425.15,7198.26,41451,530,435,24228,16595,8884,4295,1861
5789,897,1719,4903,886,3135,2654,7.02006e+17,177.349,2572.16,5789,248,170,4070,3957,3496,3475,3102
33085,914,2681,33085,0,27594,5491,3.30917e+18,1634.31,7208.49,33085,566,398,27156,23479,18728,17809,11701
14540,482,1693,6762,7778,0,14540,5.04207e+18,989.223,4013.68,14540,332,297,11450,10179,4787,4006,5395
39777,1057,1616,0,39777,14154,25623,9.80083e+15,1134.89,5912.72,39777,479,381,37047,33296,25281,19090,29061
25574,1756,2283,20926,4648,12887,12687,7.76376e+17,1488.66,6154.92,25574,446,375,22925,19441,19885,19122,21039
14931,23,43,14270,661,14483,448,9.79727e+13,34.5736,549.1,14931,36,33,14795,14684,13030,13016,10756
10969,12,348,0,10969,10386,583,2.629e+16,200.486,1357.08,10969,90,88,8894,7816,6278,5621,3282
49881,305,950,48410,1471,49881,0,4.5817e+18,638.459,4556.87,49881,315,249,47089,44717,29024,28275,20437
13282,603,2040,13282,0,10658,2624,2.98021e+18,1139.83,4360.05,13282,291,295,9880,8419,5236,4661,4703
38154,142,2617,31635,6519,19770,18384,7.46841e+17,1703.99,7725.62,38154,597,427,24781,16933,11487,12265,2530
48535,2192,2715,48535,0,39114,9421,2.88764e+18,1850.92,9033.62,48535,579,496,45812,43809,43784,44205,43320
3255,164,1190,3255,0,2694,561,2.60643e+18,219.465,1717.21,3255,136,144,1886,874,713,453,93
46674,92,355,0,46674,44020,2654,2.72366e+16,311.732,2839.99,46674,159,166,44434,43427,33123,29136,21563
24399,8,43,23261,1138,23765,634,9.99626e+13,40.1438,713.226,24399,40,38,22694,21609,17741,17538,11582
40026,591,2385,20968,19058,20968,19058,4.92584e+18,1440.88,7179.92,40026,589,413,33108,29275,13871,15672,12547
3304,289,724,1190,2114,0,3304,3.80039e+13,94.4386,1248.84,3304,165,123,2580,2510,1835,1746,1031
43117,8,43,41096,2021,41969,1148,9.91697e+13,39.8179,937.372,43117,42,41,40205,38348,31489,31229,20237
24251,1786,1946,12151,12100,0,24251,5.1115e+18,1259.85,5412.32,24251,408,356,22305,22260,20385,20117,21704
23834,1983,2071,12422,11412,0,23834,4.98131e+18,1268.25,5384.99,23834,468,339,21763,21659,21117,20808,21501
1545,265,700,1545,0,1370,175,3.51664e+18,53.466,942.241,1545,84,108,845,829,765,757,242
33298,1246,2130,16907,16391,0,33298,5.02322e+18,1372.65,6456.04,33298,499,390,29896,26152,18694,16643,21743
26708,1045,2080,13476,13232,13476,13232,4.95071e+18,1320.4,5766.37,26708,430,368,23117,20554,12708,13375,15358
8989,20,43,8609,380,8686,303,9.67896e+13,25.6774,423.84,8989,33,32,8874,8800,7851,7781,6977
6026,122,299,0,6026,5731,295,2.5506e+16,66.9811,925.514,6026,69,70,5727,5688,5103,4938,3765
18146,1654,1723,8553,9593,0,18146,5.10742e+18,1140.52,4534.9,18146,363,325,16423,15530,16280,16020,16368
22448,836,2174,11906,10542,11906,10542,4.94852e+18,1164.94,5294.74,22448,450,321,18806,17082,10095,10729,9113
48372,669,1951,17153,31219,0,48372,3.73157e+13,1164.02,6696.94,48372,631,383,42971,39349,24363,20447,21706
17158,976,2021,13711,3447,8170,8988,8.4993e+17,1285.74,4884.05,17158,363,328,13743,11907,9778,9435,8940
26207,1338,1659,0,26207,9308,16899,9.51011e+15,978.091,4712.08,26207,458,301,24484,22350,20523,16688,22443
12586,195,2150,10325,2261,6378,6208,7.76184e+17,1024.8,4269.07,12586,342,284,8283,6088,3787,4195,1438
14900,1593,2381,14900,0,12425,2475,3.26834e+18,1029.84,4680.43,14900,433,309,12347,11091,11719,11202,10023
3143,21,255,0,3143,2952,191,2.59527e+16,51.4426,636.492,3143,59,53,2653,2362,1682,1538,1032
12429,805,2330,12429,0,10459,1970,3.34363e+18,915.238,4290.54,12429,378,272,9469,8381,6608,6289,4034
30581,1329,1526,0,30581,10844,19737,9.73283e+15,1058.38,5113.39,30581,425,342,29047,26179,25407,23236,27813
37582,634,2822,37582,0,31432,6150,3.31066e+18,1651.7,7777.26,37582,592,425,29578,25591,17658,16041,8489
32304,381,803,31674,630,32304,0,4.67394e+18,527.465,3588.36,32304,256,218,30815,29759,23774,22653,17724
32153,663,1768,0,32153,11443,20710,9.57812e+15,1062.78,5367.91,32153,508,336,28312,26081,16731,11618,17358
33853,1101,1709,12073,21780,0,33853,3.74487e+13,1073.77,5425.38,33853,492,345,31330,28640,22749,24277,25701
49516,7164,9919,45223,4293,37796,11720,3.08206e+18,1131,16620.6,49516,872,626,39597,39594,35714,36125,34003
38129,26,43,35943,2186,37710,419,1.05617e+14,41.0022,898.973,38129,43,41,37828,37626,32788,32836,27564
4838,432,969,1771,3067,0,4838,3.91345e+13,151.529,1669.22,4838,170,139,3869,3744,2809,3111,1690
35689,990,2366,18596,17093,0,35689,4.97224e+18,1411.46,6798.12,35689,559,393,30953,27496,16241,15382,19155
31736,5,43,30293,1443,30809,927,9.75888e+13,37.7639,805.84,31736,41,39,27250,24494,21391,21577,13857
17632,865,2115,0,17632,0,17632,2.41879e+18,1071.71,4697.63,17632,420,307,14734,13240,8048,7650,7656
11061,882,1297,0,11061,3852,7209,9.67834e+15,626.709,2914.06,11061,275,237,9638,8977,6927,6433,8223
14119,1053,2364,14119,0,11704,2415,3.32708e+18,1034.1,4576.71,14119,395,305,11115,9952,8750,8304,7311
27134,974,1989,0,27134,0,27134,2.48514e+18,1306.29,5754.85,27134,428,382,23308,20813,12678,11777,15138
8291,993,1836,4337,3954,4337,3954,4.97892e+18,380.471,3092.58,8291,250,197,6455,6164,4740,4315,4624
25405,626,860,24727,678,25405,0,4.62316e+18,486.074,3206.43,25405,260,197,24545,24019,22918,22938,21739
38084,2180,2792,31367,6717,18971,19113,7.60326e+17,1742.85,8090.91,38084,636,440,35292,31450,31456,30775,32900
44093,18,352,0,44093,41822,2271,2.6226e+16,302.852,2714.49,44093,145,157,37932,34426,26601,23389,13974
5348,495,1678,5348,0,4347,1001,3.19786e+18,227.203,2532.22,5348,203,182,3670,3371,2414,2448,1276
2932,11,146,0,2932,2840,92,2.38636e+16,46.7517,471.672,2932,47,38,2495,2245,1908,1713,1210
46644,83,1759,22279,24365,0,46644,5.13618e+18,1469.68,7287.31,46644,540,449,27586,18250,7798,5223,2932
39905,13,43,38086,1819,38774,1131,9.8476e+13,41.3777,907.91,39905,42,40,38691,37914,31015,30679,21194
42516,201,2105,0,42516,0,42516,2.49125e+18,1435.82,7253.67,42516,551,427,31098,25115,9671,5156,5977
7012,21,43,6705,307,6782,230,9.56183e+13,25.0006,383.12,7012,30,31,6917,6857,6158,6125,5523
19973,309,349,0,19973,18889,1084,2.66758e+16,260.645,1843.61,19973,112,122,19558,19167,18767,17804,17980
40289,1770,2604,21108,19181,21108,19181,4.9185e+18,1433.68,7408.05,40289,572,416,37672,32828,26728,25475,33557
34419,1545,1651,0,34419,12165,22254,9.59741e+15,1087.51,5482.64,34419,478,344,32768,32768,32256,31813,32525
12788,2013,2069,0,12788,0,12788,2.47082e+18,713.965,3926.73,12788,349,274,10719,10719,10711,10711,10016
46073,352,1713,0,46073,16310,29763,9.65218e+15,1152.36,6393.34,46073,537,385,39021,35659,16817,11786,11539
47533,340,349,0,47533,45017,2516,2.64822e+16,309.556,2829.88,47533,149,161,47169,46340,47014,46567,46559
21941,1779,2069,21941,0,17510,4431,2.97441e+18,1487.99,5619.51,21941,406,358,19510,16403,19039,19174,18295
13285,31,576,13157,128,13285,0,4.75923e+18,385.807,2162.33,13285,172,161,6782,3059,2409,2186,876
5296,730,1136,1897,3399,0,5296,4.01307e+13,165.424,1942.15,5296,184,146,4160,4128,3529,3760,3284
37189,1095,3282,22135,15054,15677,21512,5.96404e+13,255.24,6506.69,37189,358,356,33907,33524,23692,22958,14064
11172,1193,2213,9328,1844,5907,5265,7.31144e+17,816.729,3968.92,11172,304,242,8959,8056,7122,7017,6553
32172,100,357,0,32172,30733,1439,2.49443e+16,279.306,2267.25,32172,126,136,30969,30454,25260,21379,16294
35436,395,685,35087,349,35436,0,4.76891e+18,490.64,3642.57,35436,239,234,34126,33030,28089,27391,23058
9150,419,1824,4820,4330,0,9150,5.09365e+18,514.382,3213.82,9150,299,235,7091,6411,3518,3118,2613
21222,1201,2013,10740,10482,0,21222,5.0146e+18,1225.85,5090.99,21222,401,340,18409,16507,11861,10813,13527
14687,1485,1993,7689,6998,7689,6998,4.90168e+18,933.872,4185.05,14687,367,289,12669,11559,9871,9647,10643
15338,148,2304,12516,2822,7396,7942,7.95132e+17,1280.4,4940.46,15338,355,336,9093,5727,3947,3794,601
36579,74,2387,0,36579,0,36579,2.43144e+18,1419.28,6913.3,36579,576,401,22423,15853,8340,3249,1254
14047,258,351,0,14047,13396,651,2.5259e+16,197.14,1490.02,14047,97,101,13640,13471,12724,12292,11399
38134,33,356,0,38134,36331,1803,2.55284e+16,296.399,2498.24,38134,136,150,35136,33262,25326,22002,14453
23880,301,2124,0,23880,0,23880,2.45117e+18,1254.59,5444.17,23880,454,338,18423,16295,6846,4541,3517
35625,1335,2243,18714,16911,0,35625,5.07452e+18,1434.23,6748.81,35625,535,407,32199,28159,20640,18327,23254
23350,188,1557,0,23350,8277,15073,9.89142e+15,988.38,4543.9,23350,414,327,18614,16587,6960,5542,5035
47280,1400,2490,24903,22377,0,47280,5.01434e+18,1490.02,7860.96,47280,645,436,43303,37700,26215,23722,31410
48760,763,1950,17275,31485,0,48760,3.70422e+13,1176.89,6723.67,48760,659,383,43863,40054,26108,23613,22930
2994,140,942,0,2994,0,2994,2.54491e+18,143.453,1423.45,2994,148,142,1964,1107,607,475,543
29327,49,353,0,29327,27901,1426,2.56565e+16,288.484,2189.74,29327,123,134,27595,26594,20456,17503,11437
2714,523,552,0,2714,1019,1695,1.01187e+16,36.5424,940.027,2714,139,93,2162,2162,2162,2162,2102
37546,1932,2655,37546,0,31346,6200,3.26989e+18,1683.8,7610.77,37546,622,434,34664,29291,33026,32235,30706
17337,38,43,16556,781,16799,538,9.72023e+13,37.4708,596.181,17337,37,35,17285,17267,17042,17038,16017
33006,807,2180,17395,15611,17395,15611,4.97174e+18,1328.79,6362.38,33006,501,390,28227,25228,14284,15317,13848
33365,195,351,0,33365,31756,1609,2.56117e+16,293.105,2332.3,33365,132,140,32500,31848,28712,26283,23088
2972,448,815,1029,1943,0,2972,3.40985e+13,86.9714,1278.09,2972,191,112,2157,2135,1886,1844,1758
14792,186,634,14538,254,14792,0,4.60095e+18,410.714,2324.05,14792,194,167,13306,11858,6474,6549,5182
44881,20,43,42339,2542,44433,448,1.06561e+14,41.1621,982.922,44881,43,41,44205,43682,36927,36466,29104
16605,1751,2064,0,16605,0,16605,2.41115e+18,1068.31,4542.09,16605,412,301,14541,13132,12552,12321,13396
49188,2587,2907,41079,8109,25901,23287,7.22396e+17,1768.35,8898.78,49188,698,459,46281,46281,44886,44536,45391
46652,725,1788,22169,24483,22169,24483,5.02108e+18,1476.79,7342.29,46652,545,456,39234,33665,17435,16587,19351
32309,680,2568,27098,5211,17120,15189,7.16172e+17,1602.93,7050.92,32309,552,391,25576,22128,15427,15361,10691
35860,330,356,0,35860,34217,1643,2.52865e+16,288.309,2402.99,35860,132,146,35458,34748,34634,34470,34335
23519,1322,1646,8358,15161,0,23519,3.73355e+13,971.161,4521.27,23519,427,303,21787,19885,17905,18375,20179
12746,357,1540,0,12746,4471,8275,9.83784e+15,721.071,3396.18,12746,329,264,10454,9426,4823,3856,4387
3813,783,917,1304,2509,0,3813,3.59547e+13,98.0435,1510.19,3813,189,135,2896,2896,2740,2799,2688
39358,288,355,0,39358,37538,1820,2.53552e+16,290.528,2522.56,39358,137,151,38776,38016,36151,34522,33915
36009,6,43,34307,1702,35098,911,9.94221e+13,40.64,867.033,36009,42,40,32124,29680,24646,24916,15651
38330,149,2708,38330,0,32030,6300,3.28325e+18,1725.63,7786.28,38330,631,429,25187,17662,11474,8838,2883
32610,733,876,31623,987,32610,0,4.54607e+18,533.58,3642.28,32610,319,214,31734,31620,30839,30862,30232
42138,282,2052,21241,20897,0,42138,5.06509e+18,1498.45,7183.28,42138,551,439,32239,28175,10985,8785,8206
40167,3322,4389,3274,36893,12912,27255,7.02154e+17,704.977,9382.63,40167,823,524,35778,35778,28602,28062,20854
10927,1546,2178,8980,1947,5527,5400,7.68366e+17,872.693,3935.08,10927,344,275,8749,7928,7434,7292,6703
46836,591,1475,16606,30230,0,46836,3.85691e+13,1138.49,6294.81,46836,497,396,41200,37354,22136,18378,23534
9094,1126,2945,7396,1698,3981,5113,8.28774e+17,338.515,4291.8,9094,703,226,6149,5879,4120,4247,3435
22706,1753,2134,0,22706,0,22706,2.43532e+18,1219.32,5297.8,22706,454,335,20572,18303,17515,17036,19041
7291,561,2103,7291,0,6045,1246,3.08043e+18,291.412,3231.76,7291,230,192,5188,4741,2973,2874,1275
47288,73,348,0,47288,44584,2704,2.74255e+16,312.935,2844.37,47288,158,171,44640,43413,31898,27660,18941
45524,2172,2209,23475,22049,23475,22049,4.94974e+18,1540.94,7571.89,45524,582,432,43315,43315,43274,43260,43315
19398,642,1601,6850,12548,0,19398,3.67262e+13,902.348,4084.33,19398,413,278,16800,15630,10492,9708,11380
16903,548,2111,0,16903,0,16903,2.43633e+18,1044.11,4608.93,16903,401,305,13495,12052,5727,5575,4184
24501,181,1726,0,24501,8649,15852,9.87684e+15,1048.67,4876.34,24501,426,326,19204,17266,7058,5221,4614
24456,349,1665,8667,15789,0,24456,3.7051e+13,980.887,4603.28,24456,437,304,20657,19099,9065,7311,3738
41929,205,353,0,41929,39948,1981,2.54331e+16,297.921,2602.74,41929,139,151,40957,40171,36537,33523,32020
26153,243,1997,13164,12989,13164,12989,4.9333e+18,1323.41,5641,26153,433,360,19613,16959,6597,6806,4367
24491,1673,2001,12355,12136,0,24491,5.02333e+18,1285.81,5457.07,24491,434,353,22457,19654,18400,17781,20885
1374,217,712,1374,0,1054,320,3.83706e+18,73.2031,900.483,1374,122,86,662,567,516,514,430
33701,481,1742,11932,21769,0,33701,3.70453e+13,1068.11,5450.09,33701,525,338,29096,26733,15614,12840,15260
49243,7669,8772,0,49243,17323,31920,8.20199e+15,512.265,13886.4,49243,897,758,40471,40471,39842,36224,36588
19809,402,2054,10668,9141,10668,9141,4.97265e+18,1078.57,4841.89,19809,408,315,15793,14197,7051,7086,4739
43341,147,1581,0,43341,15394,27947,9.75312e+15,1155.85,6121.85,43341,494,381,34243,30216,13438,9050,6655
38222,52,352,0,38222,36430,1792,2.52189e+16,293.977,2482.37,38222,136,146,36100,34903,26827,23523,16678
39356,59,749,39034,322,39356,0,4.72665e+18,515.514,3895.94,39356,270,246,25980,14597,9471,8997,3776
31605,673,956,30741,864,31605,0,4.51086e+18,510.868,3649.87,31605,300,213,30649,30558,28594,28457,26642
4703,50,294,0,4703,4426,277,2.82685e+16,65.593,835.81,4703,67,63,4349,4163,3142,2755,1753
29480,382,2081,23553,5927,13955,15525,8.48593e+17,1602.52,6491.87,29480,490,407,21214,18146,10302,10723,5814
7196,133,1729,3608,3588,0,7196,5.0521e+18,309.678,2854.35,7196,255,225,4865,3585,1770,1354,752
8976,223,355,0,8976,8502,474,2.71742e+16,144.938,1233.84,8976,84,86,8621,8481,7885,7566,7017
33042,437,2245,0,33042,0,33042,2.43124e+18,1387.59,6458.27,33042,541,384,26581,23549,9725,6220,7202
17995,328,350,0,17995,16933,1062,2.72254e+16,261.221,1763.92,17995,109,118,17617,17236,17305,17265,16995
1961,850,946,1541,420,857,1104,8.88538e+17,105.242,1231.5,1961,153,110,1015,1009,980,977,972
8255,317,1457,0,8255,2972,5283,9.68215e+15,286.445,2611,8255,235,199,6740,6303,3535,3286,2724
6551,1461,1661,3279,3272,0,6551,5.01195e+18,306.139,2691.43,6551,256,214,4890,4877,4716,4707,4808
42377,21,43,40420,1957,41149,1228,9.78261e+13,38.6935,928.66,42377,42,40,41920,41544,35917,35683,30638
4026,301,1025,0,4026,0,4026,2.45664e+18,182.413,1612.66,4026,226,164,3001,2816,2059,1978,663
16386,222,1504,0,16386,5824,10562,9.70045e+15,770.877,3685.17,16386,328,258,13419,12412,6121,4421,4175
26788,17,42,25436,1352,26308,480,1.03184e+14,39.2478,743.408,26788,40,38,26269,25848,21558,21335,16597
42893,1844,2447,0,42893,0,42893,2.44389e+18,1486.42,7503.56,42893,611,431,40446,40198,30830,27563,37332
16160,1234,1403,0,16160,5675,10485,9.60396e+15,830.291,3637.13,16160,345,266,14705,13451,12972,12228,13875
8788,41,43,8392,396,8521,267,9.92917e+13,26.0835,419.029,8788,32,32,8745,8741,8732,8731,8691
19334,1375,2504,19334,0,15961,3373,3.3014e+18,1345.38,5507.28,19334,471,338,16258,14119,14674,13670,10908
18638,1367,1428,0,18638,6630,12008,9.75799e+15,879.398,3884.28,18638,345,284,17210,16363,17001,16330,16959
24923,2426,2531,20978,3945,13350,11573,6.98911e+17,1426.73,6142.7,24923,499,355,22392,22392,22209,22216,22033
13875,37,1977,7118,6757,7118,6757,4.91792e+18,893.523,4092.88,13875,344,290,7001,4579,2564,2812,340
4329,642,917,1499,2830,0,4329,3.7685e+13,112.849,1571.07,4329,166,139,3412,3398,2741,2950,2778
14892,30,43,14039,853,14755,137,1.06735e+14,35.1215,557.622,14892,37,35,14800,14762,13477,13487,12683
2096,421,768,1203,893,1203,893,5.48009e+18,116.518,1098.01,2096,162,140,1328,1254,1117,1119,720
39499,1571,1659,13955,25544,0,39499,3.74115e+13,1109.61,5883.04,39499,512,368,37840,37840,37358,37351,37723
13159,1025,1874,7119,6040,0,13159,5.07179e+18,819.191,3833.78,13159,342,273,11035,10194,7459,7065,7892
31648,630,2253,16524,15124,16524,15124,4.89605e+18,1369.81,6326.45,31648,525,381,26204,23167,11284,12722,11615
47518,880,1946,0,47518,16904,30614,9.56605e+15,1155.04,6636.01,47518,623,381,43189,39541,26607,20030,32792
38543,5,44,36366,2177,38159,384,1.06681e+14,41.806,901.944,38543,44,41,32355,29088,24065,24416,14650
44001,274,2104,0,44001,0,44001,2.56553e+18,1559.15,7586.38,44001,553,451,32879,27281,8995,5669,5038
31705,884,1451,11226,20479,0,31705,3.80297e+13,1061.75,5134.35,31705,469,346,28909,26201,19656,17563,22071
36832,41,43,35061,1771,35918,914,9.99594e+13,40.3149,873.26,36832,42,40,36779,36752,36672,36673,35667
31081,1767,2210,16062,15019,16062,15019,4.96436e+18,1347.87,6288.98,31081,477,382,28871,25909,23150,22303,25852
19134,92,358,0,19134,18282,852,2.47649e+16,220.688,1746.57,19134,106,113,18371,18075,15015,13286,10171
21694,161,1725,10124,11570,10124,11570,4.92051e+18,1222.27,4947.53,21694,397,347,15120,11392,3975,4344,1954
21219,68,353,0,21219,20284,935,2.48683e+16,232.838,1812.49,21219,110,118,20244,19834,15852,13477,9352
38682,1166,2737,32329,6353,20341,18341,7.22606e+17,1708.51,7823.86,38682,601,423,32669,28219,25073,24465,20136
2244,848,855,1136,1108,1136,1108,5.14822e+18,93.381,1209.33,2244,148,127,1389,1389,1389,1389,1389
45797,672,1365,16155,29642,0,45797,3.85188e+13,1124.33,6063.79,45797,494,399,40853,37059,23907,21384,24922
49483,635,1557,17534,31949,0,49483,3.81819e+13,1159.77,6512.66,49483,505,398,43928,39976,24090,22145,23995
33402,2125,2383,0,33402,0,33402,2.44012e+18,1386.15,6617.47,33402,534,390,31019,31018,29243,28844,29953
25585,1768,1944,12916,12669,12916,12669,5.01232e+18,1273.9,5554.32,25585,406,365,23641,23583,22168,21922,22897
23289,1483,1634,0,23289,8271,15018,9.61345e+15,983.999,4525.43,23289,414,301,21655,21653,21351,21338,21494
9764,961,2093,5022,4742,0,9764,4.87228e+18,530.078,3560.44,9764,353,229,7671,7238,4968,4567,4104
7071,1826,2015,5784,1287,3550,3521,7.76926e+17,362.101,3139.85,7071,232,196,5056,5026,4974,4927,4825
43729,46,358,0,43729,41723,2006,2.50799e+16,296.178,2653.23,43729,140,154,41153,39541,30707,26783,17879
48223,101,618,47774,449,48223,0,4.74458e+18,504.356,4142.4,48223,259,256,38289,27289,15249,14400,8883
5301,921,1373,0,5301,0,5301,2.43438e+18,216.699,2203.55,5301,199,179,3928,3888,2970,2837,2981
2866,466,766,1749,1117,1749,1117,5.29666e+18,68.8493,1217.69,2866,147,116,2100,2100,2061,2057,910
37482,717,2244,19878,17604,0,37482,5.03977e+18,1416.77,6824.67,37482,554,406,31604,27867,15573,15419,15403
8829,1085,1847,4608,4221,4608,4221,4.9353e+18,428.55,3158.17,8829,278,252,6982,6684,4783,4863,5183
34605,486,901,33990,615,34605,0,4.64533e+18,524.188,3848.71,34605,298,228,33361,32404,25155,24593,22759
27984,28,43,26759,1225,27082,902,9.66618e+13,39.4041,755.105,27984,40,37,27822,27736,25352,25370,22441
39490,704,2582,39490,0,32479,7011,3.03267e+18,1697.56,7905.46,39490,559,452,31213,26277,18061,16431,13148
34437,591,2124,17014,17423,17014,17423,4.95952e+18,1399.73,6601.29,34437,493,410,28142,24591,10771,11657,11553
21097,1685,2094,0,21097,0,21097,2.42694e+18,1109.94,5011.27,21097,452,317,19003,17064,15374,15066,15970
21625,488,651,21432,193,21625,0,4.73313e+18,461.647,2831.2,21625,211,197,20872,20410,18585,18665,17972
2502,21,43,2343,159,2495,7,1.09913e+14,27.2366,242.743,2502,29,26,2436,2405,2035,2021,1645
16614,1510,2067,8700,7914,8700,7914,4.90974e+18,1083.03,4548.53,16614,394,300,14362,13046,10862,10587,11613
3609,29,31,3440,169,3501,108,9.55411e+13,19.2621,238.811,3609,22,24,3578,3575,3553,3553,3460
48804,452,2940,40932,7872,25975,22829,7.12829e+17,1742.05,8861.96,48804,693,454,37413,32641,19751,21226,11102
19159,1,44,18231,928,18717,442,1.00784e+14,37.3533,628.09,19159,39,35,6788,6788,6788,6788,6788
20038,1003,1385,7075,12963,0,20038,3.84306e+13,920.036,4053.2,20038,357,298,18153,16614,13765,13517,15138
42057,116,2111,14905,27152,0,42057,3.71387e+13,1280.92,6522.87,42057,642,369,32574,28410,13398,3911,4619
43363,154,349,0,43363,41168,2195,2.62488e+16,294.903,2687.71,43363,144,160,42028,41135,35533,30579,27194
32759,2042,2330,26905,5854,16595,16164,7.74198e+17,1660.19,7021.44,32759,503,408,30382,26454,28602,28069,29536
23471,1901,2556,23471,0,19598,3873,3.25324e+18,1416.37,6030.25,23471,474,358,20855,17958,20082,19981,17992
4032,523,1261,4032,0,3412,620,3.19395e+18,205.874,1921.46,4032,157,140,2771,2600,2151,2022,1401
33801,53,3337,12074,21727,62,33739,2.63466e+13,774.25,7532.51,33801,951,538,21404,17292,10509,3617,1810
31938,2393,2612,26616,5322,16745,15193,7.29557e+17,1616.14,7033.38,31938,544,398,29326,29326,28403,28260,28733
40233,271,2253,21144,19089,0,40233,5.05523e+18,1434.09,7097.41,40233,551,416,30948,27068,11289,9767,5976
29431,150,1719,13878,15553,13878,15553,4.9952e+18,1352.39,5768.84,29431,459,380,20235,14739,5383,5744,3008
45591,300,350,0,45591,43219,2372,2.6507e+16,305.836,2768.42,45591,150,164,45025,43928,42421,39845,41420
39241,1426,2645,39241,0,32467,6774,3.23137e+18,1715.76,7859.67,39241,621,451,34334,29372,31445,28980,25498
43724,1493,1939,15516,28208,0,43724,3.70236e+13,1133.76,6351.1,43724,592,365,41785,41714,35083,35892,40760
28077,1280,2219,22652,5425,13684,14393,8.178e+17,1561.5,6455.76,28077,472,394,23866,20428,18498,18108,16767
46199,1610,2419,46199,0,37896,8303,3.08037e+18,1780.83,8382.13,46199,562,467,41837,35111,37769,35725,33467
9711,37,42,9157,554,9634,77,1.06521e+14,30.2625,437.461,9711,34,31,9668,9660,9594,9597,9401
6291,1003,1247,5253,1038,3198,3093,7.78186e+17,629.099,2443.81,6291,230,195,5044,4385,4388,4292,4500
10076,2056,2206,8436,1640,5301,4775,7.24953e+17,686.513,3761.12,10076,331,257,7870,7428,7691,7637,7152
15780,5,43,14837,943,15651,129,1.07078e+14,37.2317,575.919,15780,39,36,13197,11860,9755,9952,6532
43755,118,2118,21959,21796,21959,21796,4.97611e+18,1444.75,7370.15,43755,542,441,29323,21016,9877,10047,2505
18075,521,656,17848,227,18075,0,4.67201e+18,420.654,2576.77,18075,209,179,17391,16983,16119,16158,15939
44675,2145,2426,44675,0,36593,8082,2.96518e+18,1795.71,8307.71,44675,572,465,42249,41838,41308,41409,41861
19404,4,43,18396,1008,19033,371,1.02355e+14,37.1317,628.846,19404,38,35,15475,13598,12026,11929,7716
31088,1012,1705,0,31088,11031,20057,9.51906e+15,1072.06,5235.67,31088,491,334,28306,25959,19412,14867,22074
49731,592,2410,25822,23909,0,49731,5.02174e+18,1485.68,8002.01,49731,642,445,41284,36383,15656,17484,13915
32905,31,43,31337,1568,32056,849,9.93057e+13,40.5283,827.219,32905,42,38,32762,32670,30049,29985,28031
45118,111,2190,23368,21750,23368,21750,4.92766e+18,1546.08,7496.63,45118,614,435,30427,22343,11054,11133,3332
5147,24,43,4885,262,5059,88,1.01172e+14,25.5345,333.807,5147,29,30,5076,5041,4470,4457,3992
7631,515,1719,3700,3931,0,7631,4.98952e+18,372.451,2920.72,7631,283,220,5912,5392,2774,2426,2131
36001,2078,2303,19079,16922,0,36001,5.02028e+18,1386.27,6733.81,36001,555,393,33698,33698,32340,31750,32980
7257,1084,1890,0,7257,0,7257,2.54725e+18,315.067,3035.54,7257,274,211,5367,5267,3897,3762,3819
47667,1229,2550,0,47667,0,47667,2.44415e+18,1518.74,7977.08,47667,658,437,42793,37658,23514,20596,26696
28687,130,592,28373,314,28687,0,4.73547e+18,487.828,3196.3,28687,224,224,24325,18891,10720,10533,7068
8027,308,1756,3463,4564,3463,4564,4.38557e+18,290.475,2954.5,8027,244,205,6125,5527,2393,2383,1744
39652,4738,6577,0,39652,0,39652,2.25025e+18,833.404,11304.9,39652,977,581,33075,33051,27202,25809,25832
38824,834,895,37768,1056,38824,0,4.59378e+18,576.816,3994.17,38824,279,227,37929,37896,37534,37526,37231
46930,858,981,45664,1266,46930,0,4.55814e+18,614.713,4464.85,46930,314,248,45949,45891,45338,45312,44430
49729,2558,2666,26100,23629,26100,23629,4.8909e+18,1554.67,8236.24,49729,647,436,47063,47063,46914,46801,47043
22385,69,2277,18482,3903,11481,10904,7.57909e+17,1451.9,5751.93,22385,423,349,11918,7636,5134,5313,1726
4335,705,1235,0,4335,0,4335,2.52578e+18,204.103,1922.39,4335,178,156,3100,2992,2144,1921,2048
40455,705,2534,21058,19397,21058,19397,4.88434e+18,1442.28,7373.53,40455,612,411,33872,29814,13358,16444,12514
31130,326,357,0,31130,29691,1439,2.5101e+16,278.383,2231.11,31130,128,132,30724,30141,29965,29456,29648
40619,2081,2378,19133,21486,19133,21486,4.93698e+18,1692.98,7659.17,40619,621,427,38241,37823,32550,31895,37966
41171,2257,2333,0,41171,0,41171,2.48799e+18,1416.17,7303.35,41171,538,432,38838,38838,38748,38386,38463
41569,139,354,0,41569,39175,2394,2.73192e+16,314.822,2686.73,41569,152,163,39988,39072,32177,28095,22268
42814,256,505,51,42763,41394,1420,2.46212e+16,221.395,3126.15,42814,199,145,42295,41991,40881,37274,36379
27699,475,613,27442,257,27699,0,4.71285e+18,486.861,3160.3,27699,224,216,26851,26119,24084,24024,22755
40106,1056,2453,21215,18891,0,40106,4.99883e+18,1444.06,7223.08,40106,609,410,35111,31313,18718,17607,21651
8044,40,1343,2835,5209,0,8044,3.82522e+13,338.149,2509.75,8044,240,212,5095,3936,2145,1231,530
17428,880,1306,6163,11265,0,17428,3.89272e+13,871.126,3699.61,17428,316,284,15571,14223,10984,9891,11963
27073,1131,1663,0,27073,9645,17428,9.55725e+15,1002.29,4804.28,27073,448,311,24945,22877,18676,13948,20982
32962,102,847,31942,1020,32962,0,4.50733e+18,522.382,3629.36,32962,252,212,26768,20390,12450,11085,5820
40953,1674,2459,0,40953,0,40953,2.43825e+18,1479.75,7355.89,40953,590,420,38314,33161,26533,24219,32300
29468,288,1333,0,29468,10457,19011,1.00059e+16,1041.28,4846.89,29468,401,348,24442,22290,10477,7604,7715
28611,639,2201,15324,13287,15324,13287,4.98283e+18,1298.64,5956.29,28611,475,362,23706,21099,10782,12114,9737
27575,565,1771,0,27575,0,27575,2.54831e+18,1343.33,5662.29,27575,430,372,22240,19286,8860,7279,7998
43347,2254,2898,36021,7326,22455,20892,7.39198e+17,1746.44,8420.97,43347,652,448,40449,40197,35871,35129,37787
1389,55,459,487,902,0,1389,3.57722e+13,32.1073,693.474,1389,89,82,928,817,409,335,247
681,42,62,681,0,573,108,1.97801e+17,23.8781,162.222,681,38,27,619,619,605,608,540
867,203,318,384,483,0,867,4.63057e+18,66.925,483.925,867,75,76,549,540,452,450,429
35175,4253,5468,8738,26437,0,35175,6.67466e+17,560.492,10132,35175,831,518,29707,29707,26671,25100,19871
21944,454,2078,21944,0,17659,4285,3.03303e+18,1514.35,5661.13,21944,393,378,15934,13410,6983,5594,4465
18178,1434,1882,9358,8820,9358,8820,4.99056e+18,1102.3,4617.43,18178,366,306,16056,14352,12491,11838,13874
11486,252,606,11257,229,11486,0,4.64529e+18,364.967,2025.63,11486,157,155,10580,9948,6944,6776,5572
9588,1466,1676,0,9588,0,9588,2.56885e+18,649.428,3217.82,9588,263,269,7912,7455,7084,6852,7393
46030,249,1893,38724,7306,45160,870,3.85799e+18,447.481,5892.72,46030,426,232,42517,40180,23136,8700,5591
21151,337,799,20524,627,21151,0,4.5986e+18,497.552,2902.21,21151,275,189,19894,19088,13924,14061,9738
49016,2118,2811,49016,0,39675,9341,3.04095e+18,1814.86,9220.73,49016,664,478,46046,42453,45128,45365,44315
49645,262,1889,17678,31967,0,49645,3.71361e+13,1194.4,6676.72,49645,664,385,41621,38462,17922,15183,14505
44852,351,355,0,44852,42667,2185,2.55477e+16,302.76,2711.89,44852,147,159,44497,44447,44438,44360,44301
5673,760,1727,5673,0,4551,1122,2.99708e+18,276.673,2648.57,5673,201,170,3946,3631,3072,2998,2524
30669,875,2664,25592,5077,16091,14578,7.27783e+17,1594.36,6934.55,30669,539,393,24812,21377,17120,16456,13477
16533,91,1767,0,16533,5820,10713,9.67665e+15,947.341,4126.28,16533,392,284,11540,9442,4231,2948,1816
1853,167,823,1853,0,1523,330,3.52621e+18,54.1581,1091.27,1853,131,90,1030,980,680,730,259
34324,943,1592,12175,22149,0,34324,3.76138e+13,1077.5,5425.03,34324,471,348,31466,28613,21228,19312,25253
42879,215,1762,0,42879,15260,27619,9.67895e+15,1128.59,6155.76,42879,535,376,35356,32553,15266,9128,8390
2955,328,1233,2955,0,2398,557,3.26882e+18,159.608,1719.7,2955,157,145,1722,1524,1068,1106,655
33589,264,391,0,33589,31698,1891,2.70498e+16,302.738,2507.52,33589,139,153,32847,32071,28953,26215,24518
10175,550,1108,5250,4925,5250,4925,5.08127e+18,656.86,2816.56,10175,268,233,8429,7312,4618,4243,5805
43509,1872,2880,36099,7410,22491,21018,7.41569e+17,1742.49,8412.67,43509,647,446,40134,33609,32763,32367,33382
7412,1000,1670,3478,3934,0,7412,5.05801e+18,410.658,2857.37,7412,257,201,5742,5483,4139,3924,4369
37176,179,348,0,37176,35216,1960,2.64848e+16,301.16,2507.92,37176,139,150,36085,35277,31056,27611,23576
20302,797,2404,20302,0,17204,3098,3.31629e+18,1308.88,5431.15,20302,480,328,16169,14198,11349,10435,6793
8390,1089,1780,4199,4191,0,8390,4.95587e+18,443.592,3073.13,8390,305,225,6610,6356,5036,4838,4598
45035,1393,1876,15916,29119,0,45035,3.81099e+13,1147.86,6591.53,45035,499,381,43077,40015,33108,34517,39519
22917,509,1641,0,22917,8139,14778,9.52131e+15,960.972,4465.89,22917,432,294,19739,18077,11114,7009,7042
21193,56,352,0,21193,20171,1022,2.5878e+16,262.406,1868.01,21193,110,121,20017,19382,14864,12771,8684
14267,1217,1465,0,14267,5061,9206,9.51237e+15,704.639,3374.96,14267,350,259,12802,11941,10899,9266,12047
34431,599,4037,33864,567,30417,4014,1.73873e+18,601.753,7790.43,34431,817,342,28776,26287,20439,17067,15691
22539,687,2505,22539,0,18864,3675,3.33983e+18,1439.81,5881.98,22539,526,348,17602,15193,10880,9550,6473
39956,37,44,37815,2141,39446,510,1.0617e+14,41.587,918.664,39956,43,41,39875,39828,37404,37405,36367
4511,30,43,4330,181,4328,183,9.30974e+13,21.4023,310.189,4511,29,28,4460,4446,4232,4227,4051
35550,543,2017,17743,17807,17743,17807,4.97426e+18,1402.6,6590.8,35550,494,407,29005,25354,10753,11581,10478
37152,38,43,35410,1742,36136,1016,9.88408e+13,39.6159,872.254,37152,42,40,37083,37042,36499,36592,34381
23533,154,347,0,23533,22242,1291,2.68169e+16,280.512,2006.41,23533,121,125,22661,22189,19063,16509,14139
21556,33,354,0,21556,20310,1246,2.72974e+16,276.947,1937.59,21556,122,127,19487,18233,13170,11292,6971
10665,2000,2303,10665,0,8822,1843,3.35501e+18,820.608,3997.05,10665,370,258,8362,7788,8272,8328,7987
30514,366,379,0,30514,28855,1659,2.70293e+16,303.398,2358.49,30514,133,143,30133,29846,29961,29834,29752
34458,33,43,32813,1645,33608,850,9.98047e+13,41.5701,850.898,34458,42,40,34335,34225,31812,31855,29240
7837,458,1826,0,7837,0,7837,2.44022e+18,317.915,2989.41,7837,278,230,6011,5515,3325,3204,2127
7187,1627,1801,0,7187,0,7187,2.40804e+18,299.688,2879.51,7187,307,220,5386,5386,5221,5180,5300
26351,193,1704,9332,17019,0,26351,3.6779e+13,1034,4850.77,26351,469,314,21270,19388,8696,6525,4810
2420,285,638,0,2420,880,1540,1.05119e+16,86.8624,1046.01,2420,101,102,1782,1767,1318,1034,1146
41206,1592,1814,0,41206,14595,26611,9.56638e+15,1112.07,6100.41,41206,537,370,39392,39391,36666,34230,38873
42983,2202,2452,22655,20328,0,42983,5.03919e+18,1461.82,7485.81,42983,601,433,40531,40531,38785,38436,39709
24396,1406,2476,24396,0,20461,3935,3.30119e+18,1533,6099.29,24396,512,369,20696,18131,19173,18037,13611
29903,276,1603,0,29903,10627,19276,9.58039e+15,1086.02,5071.73,29903,486,334,24913,22955,11568,7006,6382
37019,1196,2119,0,37019,0,37019,2.4765e+18,1400.13,6756.49,37019,517,413,33074,29091,20084,16998,23628
17289,326,818,16836,453,17289,0,4.52685e+18,473.073,2671.11,17289,250,174,16116,15388,10507,10394,7395
48184,443,1578,0,48184,17055,31129,9.71071e+15,1172.17,6436.97,48184,521,390,41362,37630,20095,14269,19064
44840,19,358,0,44840,42816,2024,2.4976e+16,294.12,2669.34,44840,141,153,39499,36390,28688,25430,15252
22376,595,1324,0,22376,7898,14478,9.86145e+15,965.64,4224.91,22376,377,308,19460,17843,11071,8550,11186
36000,1100,2421,29590,6410,18257,17743,7.68029e+17,1672.32,7389.3,36000,549,421,30119,25992,22619,21840,17091
40657,410,2571,33478,7179,20682,19975,7.6224e+17,1699.47,7944.36,40657,588,437,30372,26403,15377,16453,8064
4059,193,287,0,4059,3814,245,2.7339e+16,55.0204,770.995,4059,60,57,3772,3764,3535,3473,3065
20042,1480,1527,7148,12894,0,20042,3.73797e+13,894.569,4048.23,20042,397,279,18515,18473,18376,18444,18398
36223,536,1373,0,36223,12804,23419,9.93925e+15,1087.5,5418.53,36223,445,371,31441,28573,15999,12654,16677
35247,891,1867,17452,17795,17452,17795,5.01636e+18,1402.7,6450.02,35247,500,407,30389,26763,16015,15456,17420
42070,1779,1995,0,42070,14877,27193,9.62823e+15,1189.41,6523.82,42070,610,379,40075,40066,38002,36890,39589
48628,173,359,0,48628,46350,2278,2.54769e+16,310.651,2827.69,48628,150,163,47327,46313,41101,35906,30328
24110,1333,2074,12658,11452,12658,11452,4.92365e+18,1288.94,5429.63,24110,452,340,21309,18972,14757,14141,15330
48525,318,349,0,48525,45831,2694,2.73218e+16,307.128,2871.94,48525,158,168,48008,46724,46327,45287,46191
37109,1325,2213,29891,7218,18041,19068,8.25928e+17,1593.16,7383.72,37109,573,440,32348,27252,25614,25032,23854
32424,592,859,31492,932,32424,0,4.55426e+18,526.273,3624.22,32424,260,216,31499,30617,29598,29714,26531
30107,1422,1590,10706,19401,0,30107,3.7875e+13,1038.93,5084.02,30107,438,336,28517,28507,26769,27049,28213
30452,684,1703,0,30452,10819,19633,9.56285e+15,1054.74,5184.61,30452,491,324,26887,24809,16190,10519,12015
33257,331,1730,15925,17332,0,33257,5.13806e+18,1370.05,6119.55,33257,479,407,25596,22568,7850,6591,7968
32776,212,2021,16316,16460,0,32776,5.04954e+18,1380.5,6343.54,32776,486,393,23990,20460,7697,6199,3077
46797,824,2034,0,46797,16613,30184,9.48927e+15,1173.9,6669.02,46797,666,374,42106,38572,25281,17924,29785
47602,265,882,46656,946,47602,0,4.57973e+18,549.857,4379.44,47602,263,250,44668,42042,23788,23290,19219
18737,359,2004,9828,8909,0,18737,4.94562e+18,1075.5,4694.88,18737,434,306,14745,13364,5708,5250,3761
5201,284,608,5121,80,5201,0,4.52875e+18,249.728,1434.18,5201,142,111,4563,4262,3204,3144,2941
31378,1540,1690,11112,20266,0,31378,3.71587e+13,1060.69,5239.63,31378,485,340,29688,29688,27954,28071,29337
8996,798,1390,3230,5766,0,8996,3.86792e+13,444.679,2687.85,8996,239,233,7606,7206,5511,5363,5683
47960,1840,2881,39931,8029,24995,22965,7.3048e+17,1767.12,8785.05,47960,692,451,44327,37145,36192,35873,35185
32493,73,1698,0,32493,0,32493,2.54986e+18,1351.55,6013.91,32493,477,405,18638,12040,5049,3217,2110
38604,1836,1870,0,38604,13659,24945,9.7002e+15,1255.19,6179.71,38604,555,366,36734,36734,36643,36683,36694
41114,32,43,39171,1943,40056,1058,9.95716e+13,41.9284,927.186,41114,43,41,40956,40822,37842,37916,35013
16439,1335,2397,16439,0,13871,2568,3.33971e+18,1098.01,4904.17,16439,430,321,13425,12200,12283,11647,8955
47459,400,2502,0,47459,0,47459,2.44185e+18,1496.01,7893.81,47459,653,437,38034,33866,14718,9772,11338
15494,769,2190,15494,0,12566,2928,3.05353e+18,1258.09,4806.45,15494,382,317,11906,10205,6884,6526,5433
9389,452,691,8998,391,9389,0,4.32689e+18,262.443,1846.37,9389,183,126,8698,8565,7681,7806,7159
23753,738,2894,11119,12634,11119,12634,4.9336e+18,1021.36,6215.58,23753,794,356,19218,17040,5314,6826,4688
13269,805,2358,10921,2348,6693,6576,7.70741e+17,1070.33,4496.06,13269,402,293,10059,8851,6498,6585,5174
41217,114,352,0,41217,39191,2026,2.59091e+16,296.434,2608.43,41217,148,154,39713,38942,31981,27083,22502
12362,515,1615,0,12362,4382,7980,9.69526e+15,601.696,3336.98,12362,346,247,10387,9618,5990,4072,5634
24222,921,2127,12693,11529,0,24222,5.02659e+18,1253.46,5463.31,24222,465,344,20612,18552,11806,11090,12137
9350,290,352,0,9350,8873,477,2.54938e+16,148.582,1235.38,9350,82,80,8998,8918,8633,8474,7975
46951,676,1897,16640,30311,0,46951,3.71591e+13,1161.74,6573.24,46951,603,382,41747,38264,24038,20587,20443
38300,892,938,37171,1129,38300,0,4.59872e+18,581.904,3994.95,38300,306,231,37362,37346,37131,37188,36578
24720,258,351,0,24720,23470,1250,2.6051e+16,278.388,2032.38,24720,121,126,24183,23714,22140,20843,20660
1768,8,334,1755,13,1768,0,5.10174e+18,130.501,674.418,1768,70,67,430,92,71,103,54
10323,1247,1386,0,10323,3680,6643,9.75291e+15,523.712,2880.11,10323,274,207,8937,8519,8441,7821,8522
37455,1606,2360,37455,0,30394,7061,2.97816e+18,1649.1,7558.91,37455,551,441,33811,28218,30839,30179,27450
7212,1105,2048,7212,0,6075,1137,3.33639e+18,347.42,3148.64,7212,283,216,5164,4907,4697,4496,3711
11725,1242,1896,6490,5235,6490,5235,4.98808e+18,675.978,3588.06,11725,327,258,9829,9172,7944,7341,7479
44606,1565,1871,15889,28717,0,44606,3.75126e+13,1140.81,6372.03,44606,565,375,42735,42735,38227,38420,41810
27370,1796,2143,13850,13520,0,27370,4.98847e+18,1307.98,5844.61,27370,479,373,25227,24618,20985,20375,23757
34981,1841,2374,18316,16665,0,34981,4.94801e+18,1392.52,6727.07,34981,555,386,32607,32441,26329,25434,30654
49042,2070,2494,26071,22971,26071,22971,4.93885e+18,1487.99,7974.16,49042,648,438,46548,46547,40755,40007,43561
46463,24,47,44108,2355,45911,552,9.50692e+13,41.6141,1095.68,46463,44,43,45984,45556,39058,38883,32952
23484,762,763,22890,594,23484,0,4.55989e+18,488.303,3025.93,23484,240,195,22721,22721,22721,22721,22704
30324,1024,1610,10745,19579,0,30324,3.74237e+13,1079.56,5111.69,30324,481,341,27705,25313,19497,20985,22018
2922,192,593,0,2922,1061,1861,9.67013e+15,86.5719,990.447,2922,174,104,2329,2263,1809,1105,653
5271,252,516,5211,60,5271,0,4.78137e+18,225.966,1324.46,5271,113,116,4721,4508,3551,3576,3133
5325,1193,1696,5325,0,4302,1023,2.96171e+18,240.12,2566.67,5325,199,174,3629,3608,3572,3565,3147
44880,2502,2772,36754,8126,21366,23514,7.74013e+17,1971.88,8912.92,44880,679,465,42108,41824,40111,39526,41788
37502,503,2264,19396,18106,0,37502,5.02614e+18,1421.89,6890.67,37502,536,412,30547,26980,12696,12760,10996
31707,39,43,30210,1497,30859,848,9.88765e+13,40.7812,810.565,31707,42,39,31648,31617,31273,31270,29844
32303,701,1715,0,32303,11475,20828,9.55812e+15,1085.35,5340.56,32303,494,341,28579,26314,17126,12436,18316
4358,853,986,0,4358,1518,2840,8.972e+15,126.806,1643.9,4358,202,123,3372,3362,3280,3246,3253
22746,150,353,0,22746,21708,1038,2.51217e+16,256.284,1908.77,22746,115,121,22009,21636,18966,16977,14919
24676,161,1867,11991,12685,0,24676,5.12735e+18,1265.04,5407.47,24676,401,369,17320,12724,5154,4108,3157
45858,291,2880,38341,7517,24172,21686,7.22491e+17,1754.67,8595.02,45858,675,450,33214,28161,15725,17873,7027
44968,609,786,44202,766,44968,0,4.62744e+18,536.021,4180.54,44968,267,243,44182,44068,40929,41058,39944
36460,1328,1599,12918,23542,0,36460,3.76882e+13,1096.89,5598.17,36460,487,355,34829,31229,28635,28013,33444
17287,2177,2422,17287,0,14448,2839,3.26463e+18,1201.7,5089.84,17287,420,320,14865,14097,14641,14632,14212
31421,266,352,0,31421,29942,1479,2.53295e+16,283.165,2255.11,31421,126,133,30837,30278,28387,26861,26465
17645,1981,2495,14665,2980,9097,8548,7.37991e+17,1251.37,5220.56,17645,438,320,15150,13303,13426,13125,13652
25987,916,1700,9217,16770,0,25987,3.7056e+13,1018.06,4817.48,25987,463,312,23391,21542,15845,15831,14872
6998,436,562,6927,71,6998,0,4.76087e+18,252.078,1559.94,6998,138,134,6436,6381,5990,5998,5506
17366,40,43,16575,791,16834,532,9.74938e+13,37.4892,597.512,17366,37,35,17319,17305,17272,17270,16481
37754,640,2305,0,37754,0,37754,2.44451e+18,1399.82,6896.67,37754,587,402,31495,27851,14035,14357,13985
2620,592,637,879,1741,0,2620,3.43831e+13,79.3748,1075.18,2620,119,112,1983,1983,1971,1961,1916
3088,556,694,0,3088,1115,1973,1.06301e+16,150.251,1194.42,3088,113,134,2394,2344,2332,2239,2253
14850,1675,2269,14850,0,12227,2623,3.04776e+18,1149.61,4715.71,14850,346,306,12332,10987,12001,12097,10812
31360,1689,2864,26278,5082,16628,14732,7.15146e+17,1522.18,7131.06,31360,520,403,27808,23918,22652,22853,22840
8280,784,1768,4214,4066,4214,4066,5.0459e+18,496.442,3084.86,8280,240,250,6512,6014,3844,3586,3820
44049,1172,2091,21717,22332,0,44049,5.02817e+18,1443.93,7364.32,44049,557,441,39579,34520,23068,20316,29243
11871,50,360,0,11871,11206,665,2.75156e+16,201.232,1436.07,11871,100,101,11035,10587,7713,6607,4094
48325,212,2086,38647,9678,22950,25375,8.38264e+17,1739.84,8299.35,48325,568,470,31978,23598,13613,14789,5927
31818,865,1738,0,31818,11293,20525,9.51144e+15,1034.09,5283.91,31818,503,336,28632,26405,18903,13465,20654
17420,297,1700,8341,9079,0,17420,5.1522e+18,1116.92,4395.13,17420,342,311,13137,11443,4055,3200,4037
46948,1089,1673,16664,30284,0,46948,3.79129e+13,1137.2,6384.84,46948,528,394,44087,39619,30929,27621,37883
12429,1200,1602,0,12429,4416,8013,1.00308e+16,721.914,3430.53,12429,311,256,10827,10070,8572,7370,9250
42735,12,43,40797,1938,41475,1260,9.79024e+13,39.8459,932.93,42735,43,40,41260,40239,33101,32463,23801
24313,750,2253,19934,4379,12228,12085,7.7052e+17,1491.4,5993.24,24313,440,364,19176,16165,11689,11647,9247
3333,986,1118,3333,0,2723,610,2.97186e+18,239.667,1680.74,3333,140,133,2215,2208,2206,2204,2129
39989,35,44,38142,1847,38893,1096,9.86774e+13,37.5069,896.32,39989,41,41,39903,39853,37689,37700,35307
23524,406,1641,8352,15172,0,23524,3.72263e+13,957.958,4511.76,23524,447,300,19988,18480,10371,8428,9610
37803,481,781,37149,654,37803,0,4.66037e+18,514.972,3830.99,37803,275,230,36697,35613,31198,31201,28531
11722,1377,2212,9916,1806,6460,5262,6.78547e+17,787.413,3970.43,11722,341,269,9510,8689,7949,8060,7333
30179,5,43,28674,1505,29551,628,1.01337e+14,38.6395,789.508,30179,41,39,25747,23148,19653,19869,13153
2946,980,1008,1303,1643,1303,1643,4.61303e+18,127.798,1495.13,2946,193,129,1938,1938,1936,1925,1926
9079,3,43,8691,388,8778,301,9.64192e+13,29.9727,430.475,9079,33,32,6690,5781,5418,5425,3690
13364,502,698,13052,312,13364,0,4.61418e+18,398.848,2263.18,13364,193,150,12619,12326,11896,11881,10282
23873,1617,2512,20010,3863,12676,11197,7.13131e+17,1405.61,6009.7,23873,497,347,20691,17992,17218,17390,16778
41327,1478,2439,21878,19449,0,41327,5.0274e+18,1451.21,7312.03,41327,606,423,38049,33281,24772,22862,29809
16523,1384,1850,7988,8535,7988,8535,4.90394e+18,1073.95,4432.5,16523,356,320,14418,12892,10809,10543,12678
48546,651,3124,48546,0,40032,8514,2.95514e+18,1826.52,9445.83,48546,643,487,37715,31282,19045,15219,14564
2823,225,755,1695,1128,1695,1128,4.75406e+18,45.4878,1181.61,2823,139,98,2068,2042,1417,1537,1230
41283,164,348,0,41283,39139,2144,2.64734e+16,299.631,2628.76,41283,145,155,40035,39126,34223,29496,27637
30738,720,1344,10892,19846,0,30738,3.86427e+13,1056.75,4962.95,30738,420,349,27356,24913,16947,14558,17622
5118,30,317,0,5118,4847,271,2.65395e+16,61.0274,907.077,5118,67,69,4594,4300,3260,3041,1995
20902,1629,3724,18065,2837,8318,12584,6.17055e+17,1071.37,7030.25,20902,500,599,17178,15604,13309,12729,10581
43482,101,2359,35420,8062,21556,21926,7.91967e+17,1782.6,8122.97,43482,597,459,24910,16037,10950,10860,2503
11928,1156,1541,0,11928,4195,7733,9.43183e+15,630.382,3196.42,11928,337,232,10387,9788,8496,8385,8588
43500,2285,2393,0,43500,0,43500,2.51434e+18,1539.73,7834.05,43500,593,437,41107,41107,40932,40210,40875
1938,529,750,1938,0,1560,378,2.67964e+18,124.848,1081.22,1938,105,102,1188,1187,1176,1178,1105
40742,527,909,39686,1056,40742,0,4.61379e+18,611.371,4117.08,40742,316,235,39476,38277,34595,34017,28318
41358,3,43,39542,1816,40040,1318,9.66225e+13,38.3301,916.332,41358,42,40,30463,26316,24601,24531,17151
43905,1605,1880,0,43905,15610,28295,9.52196e+15,1139.97,6299.36,43905,602,378,42025,42024,38791,36282,41300
41082,1012,2488,21732,19350,21732,19350,4.89942e+18,1444.67,7332.46,41082,618,412,35920,31930,18473,20104,21046
839,29,33,794,45,822,17,1.05344e+14,13.795,129.441,839,17,18,806,803,804,803,776
25693,2179,2558,25693,0,21691,4002,3.33414e+18,1429.27,6247.04,25693,551,374,23135,23066,22682,22760,22350
16255,473,632,16055,200,16255,0,4.6611e+18,441.812,2446.85,16255,185,171,15523,15153,14159,14156,12919
28908,838,2231,0,28908,0,28908,2.44992e+18,1317.41,6027.39,28908,495,368,24475,22052,12675,11560,11924
49098,1432,2001,0,49098,17477,31621,9.51526e+15,1144.96,6746.7,49098,653,382,47097,44444,36828,29895,44305
20425,279,1670,7192,13233,0,20425,3.80738e+13,934.657,4403.29,20425,414,305,16608,15087,6894,4437,5170
39485,772,1387,13963,25522,0,39485,3.86872e+13,1110.88,5672.56,39485,475,385,35526,32200,21946,18422,23626
47147,30,43,44929,2218,45880,1267,9.88721e+13,41.243,986.05,47147,43,41,46933,46796,42562,42609,37239
41294,449,2931,41294,0,34287,7007,3.01804e+18,1863.53,8509.62,41294,632,439,30835,26002,13398,12042,5468
26526,840,4087,0,26526,0,26526,1.82387e+18,982.877,8340.02,26526,565,521,21768,20047,12650,9675,6130
2001,492,609,1314,687,1314,687,5.41258e+18,41.9505,904.659,2001,120,104,1392,1392,1391,1392,587
4487,29,39,4323,164,4277,210,9.02079e+13,26.5313,294.332,4487,25,25,4443,4430,4303,4299,4257
29742,1240,2241,15526,14216,0,29742,4.97415e+18,1331.63,6122.33,29742,526,372,26326,23441,15776,14526,18240
10496,376,573,10418,78,10496,0,4.79681e+18,339.696,1904.99,10496,156,149,9854,9626,8367,8360,7731
14469,700,761,14047,422,14469,0,4.50612e+18,403.869,2389.25,14469,252,162,13708,13708,13666,13672,13682
9016,556,1388,3254,5762,0,9016,3.87352e+13,363.841,2653.11,9016,231,203,7628,7159,5217,5038,4808
16812,1338,2003,8823,7989,8823,7989,4.95455e+18,1047.13,4494.92,16812,394,303,14479,13138,10550,10403,11553
48080,87,2187,48080,0,38550,9530,2.96207e+18,1740.28,8408.11,48080,559,485,25004,14429,8589,7617,2742
46986,16,42,44633,2353,45976,1010,1.01721e+14,39.7643,969.105,46986,42,41,46016,45267,37522,36690,28886
8823,995,1408,3095,5728,0,8823,3.64395e+13,387.071,2652.67,8823,283,174,7415,7193,6238,6469,5320
17153,171,572,16963,190,17153,0,4.72929e+18,424.068,2453.19,17153,185,189,15299,13381,7638,7605,5719
34132,121,792,33497,635,34132,0,4.60355e+18,517.518,3667.1,34132,252,224,28554,21801,12124,10951,7229
36398,1400,1609,0,36398,12892,23506,9.96776e+15,1127.43,5760.84,36398,458,368,34749,32915,29161,26286,33068
18647,1255,1448,0,18647,6625,12022,9.7375e+15,880.493,3923.21,18647,356,281,17111,15660,14775,13084,16005
9569,713,1734,4698,4871,4698,4871,4.86908e+18,634.843,3270.09,9569,300,227,7630,6878,3976,3857,4495
3887,240,427,3672,215,3887,0,4.44499e+18,145.71,1008.66,3887,117,89,3460,3376,3184,3193,2284
9269,1535,1974,9269,0,7472,1797,3.10566e+18,871.003,3602.48,9269,247,242,7295,6484,6937,6937,6219
18694,24,43,17789,905,18253,441,1.01078e+14,40.4491,630.129,18694,39,37,18514,18390,16270,16242,13280
2823,315,997,2823,0,2437,386,3.40601e+18,108.502,1394.85,2823,150,109,1826,1748,1499,1470,436
43811,1272,2501,0,43811,0,43811,2.44664e+18,1439.96,7534.39,43811,622,431,39626,34925,23864,21942,28022
35606,1567,1768,12633,22973,0,35606,3.73239e+13,1130.11,5669.78,35606,525,349,33838,33838,31573,31777,33481
35917,1646,2249,0,35917,0,35917,2.43906e+18,1408.33,6685.03,35917,553,392,33497,29188,24571,22661,27850
15473,824,2362,15473,0,12925,2548,3.28491e+18,1135.62,4811.08,15473,397,308,12021,10516,8115,7441,6077
27996,728,880,27217,779,27996,0,4.57812e+18,489.83,3373.47,27996,233,208,27116,27115,25784,25821,24951
13698,381,1460,4859,8839,0,13698,3.76634e+13,672.434,3289.37,13698,342,245,11510,10753,6914,6092,4001
655,68,315,584,71,352,303,4.38611e+17,36.6351,417.552,655,59,55,340,225,164,162,59
49016,20,44,46261,2755,48504,512,1.06708e+14,42.496,1022.66,49016,44,43,48288,47728,39798,39293,32447
42410,6,44,40026,2384,41971,439,1.0675e+14,42.129,950.809,42410,44,43,37069,33591,27344,27836,18401
18675,1435,1998,9858,8817,9858,8817,4.98205e+18,1098.44,4708.56,18675,386,316,16440,14794,12500,11856,13862
37519,1540,1869,0,37519,0,37519,2.50242e+18,1410.83,6651.4,37519,523,408,35250,30176,26781,25592,32524
4512,1020,1131,0,4512,0,4512,2.4945e+18,191.827,1845.49,4512,236,182,3381,3379,3313,3322,3192
27569,1980,2240,14371,13198,0,27569,4.95708e+18,1311.63,5912.01,27569,517,362,25329,25244,23525,23255,24313
43665,495,1744,20697,22968,0,43665,5.12765e+18,1423.56,7017.11,43665,523,441,35307,30747,13212,11323,14702
12248,912,2647,12248,0,10195,2053,2.99797e+18,804.099,4598.62,12248,393,281,9215,8110,6398,6017,5616
33535,189,1776,11903,21632,0,33535,3.73499e+13,1108.65,5516.01,33535,509,341,27116,24752,10977,3679,1819
40696,21,43,38523,2173,40033,663,1.0381e+14,40.962,926.234,40696,43,42,40184,39761,33793,33529,27252
15251,88,577,15061,190,15251,0,4.69401e+18,431.436,2333.71,15251,174,180,11499,7918,4622,4674,2705
1851,218,643,1851,0,1460,391,2.66372e+18,124.529,958.165,1851,103,112,1208,897,534,534,671
28807,502,1530,0,28807,10247,18560,9.76676e+15,1047.21,4978.16,28807,416,335,24811,22687,13171,9587,12130
25447,1964,4794,11724,13723,0,25447,4.56448e+18,653.892,8183.53,25447,844,404,20653,20124,11317,10271,9263
31980,700,2250,0,31980,0,31980,2.42948e+18,1370.67,6357.02,31980,531,380,26765,23619,12050,12770,12410
45883,45,3159,45883,0,38414,7469,3.25015e+18,1730.96,8890.99,45883,655,471,22644,14609,9472,9047,807
20870,1333,1640,7407,13463,0,20870,3.74871e+13,921.082,4346.57,20870,384,325,19223,17521,15869,15835,17835
46230,2321,2437,23865,22365,23865,22365,4.92423e+18,1493.96,7806.64,46230,580,445,43793,43793,43457,43342,43246
6448,420,1606,0,6448,0,6448,2.43071e+18,245.326,2616.56,6448,222,172,4842,4462,1938,1755,1559
38105,1751,1774,0,38105,13512,24593,9.6222e+15,1120.36,5891.84,38105,506,362,36331,36331,36303,36325,36326
1121,266,444,1121,0,894,227,3.30151e+18,81.7547,651.741,1121,92,81,677,664,611,613,495
14345,35,350,0,14345,13690,655,2.50608e+16,196.193,1499.41,14345,97,101,13302,12620,9827,8421,5454
7307,873,2050,6191,1116,3925,3382,6.90667e+17,291.479,3156.39,7307,277,209,5257,4953,4024,4002,2285
2609,656,994,2010,599,1133,1476,9.05428e+17,107.333,1429.55,2609,146,136,1615,1609,1327,1258,1050
18142,2044,2144,18142,0,14627,3515,3.02333e+18,1355.52,5172.19,18142,366,329,15998,15761,15942,15939,15938
8282,832,2000,8282,0,6638,1644,3.04025e+18,749.81,3427.02,8282,238,226,6107,5204,4036,3784,3231
1096,313,448,0,1096,405,691,9.89558e+15,62.0173,631.23,1096,123,95,648,647,449,461,498
46863,102,1940,16636,30227,0,46863,3.71718e+13,1170.28,6593.94,46863,648,382,36110,31001,15179,4454,3840
29560,5,43,28190,1370,28717,843,9.77643e+13,38.6314,777.462,29560,40,37,25351,22777,19789,19982,13289
12293,150,2175,10425,1868,6814,5479,6.77847e+17,812.58,4044.03,12293,317,264,8320,5791,4059,4467,979
41907,1617,1755,0,41907,14820,27087,9.61072e+15,1141.37,6164.91,41907,518,371,40152,40152,39377,38867,39884
17498,37,43,16754,744,16897,601,9.55197e+13,32.4916,593.215,17498,37,35,17445,17422,16822,16826,15864
2745,393,1038,2098,647,1137,1608,9.48966e+17,130.111,1479.45,2745,151,135,1707,1601,1269,1154,1065
49862,2091,2506,40815,9047,25048,24814,7.77845e+17,1745.83,8755.43,49862,608,477,47356,47097,42784,41798,45760
48702,1627,2128,24301,24401,24301,24401,4.9696e+18,1477.57,7776.55,48702,580,448,46387,39489,33410,31582,41300
7950,183,349,0,7950,7579,371,2.53245e+16,99.8736,1126.37,7950,74,73,7601,7537,7024,6789,6132
28437,64,1683,10102,18335,0,28437,3.70122e+13,1034.43,4982.45,28437,487,316,20680,17437,8709,3891,1868
38115,980,2086,38115,0,30495,7620,3.02859e+18,1696.58,7403.48,38115,494,445,31261,26380,19759,18368,18952
2848,99,566,1079,1769,0,2848,4.01395e+13,91.685,957.206,2848,167,105,2263,2106,1430,1767,316
5380,1504,1670,4308,1072,2565,2815,8.32018e+17,245.851,2549.01,5380,209,181,3710,3709,3699,3694,3588
47905,129,2116,23812,24093,23812,24093,4.94013e+18,1518.52,7739.83,47905,567,454,32742,23508,10602,10971,4371
37501,139,356,0,37501,35698,1803,2.57384e+16,300.921,2488.08,37501,136,150,36283,35599,30173,26507,22284
6317,407,577,6253,64,6317,0,4.79196e+18,239.687,1508.44,6317,136,123,5740,5662,5240,5258,4918
38176,745,1505,0,38176,13495,24681,9.78045e+15,1110.58,5692.78,38176,480,371,34189,31095,20142,15101,22695
16978,611,1609,0,16978,5993,10985,9.56182e+15,818.579,3838.36,16978,365,271,14644,13610,8837,7046,7414
36382,142,343,0,36382,34348,2034,2.7241e+16,300.855,2478.74,36382,143,153,35048,34277,28543,24703,20923
37726,619,1710,0,37726,13388,24338,9.57503e+15,1110.91,5728.02,37726,546,356,33174,30725,19705,12797,16206
41259,9,43,39305,1954,40202,1057,9.95764e+13,40.9642,924.556,41259,43,41,38856,37272,30428,30449,20080
5872,312,1177,0,5872,2108,3764,1.00825e+16,168.784,2057.92,5872,203,151,4695,4459,2782,1846,1695
47002,175,895,45664,1338,47002,0,4.56147e+18,659.381,4403.22,47002,303,248,42214,37515,21122,19157,11596
6838,652,1637,3251,3587,3251,3587,5.00156e+18,341.118,2727.28,6838,243,190,5201,4775,2948,2635,2790
24992,704,2117,13284,11708,13284,11708,4.95514e+18,1269.56,5528.9,24992,455,346,20849,18418,10015,10791,9016
39565,245,364,0,39565,37657,1908,2.56123e+16,306.155,2562.05,39565,138,151,38777,37988,34880,32240,29693
40877,1065,1660,0,40877,14492,26385,9.66168e+15,1097.37,5970.97,40877,509,376,38228,34451,26559,20208,32418
13740,1117,1698,6590,7150,6590,7150,5.04685e+18,1005.25,3934.25,13740,318,290,11523,10426,7705,7379,8607
45437,632,2522,23865,21572,0,45437,4.99036e+18,1492,7747.46,45437,631,432,37765,33390,16491,17463,15199
6700,341,1335,2353,4347,0,6700,3.74588e+13,170.003,2313.15,6700,242,185,5365,5113,2990,3299,2116
46648,1065,1976,0,46648,16541,30107,9.51123e+15,1147.9,6575.8,46648,640,371,43232,39253,28228,21317,33800
9638,1310,2163,8031,1607,5052,4586,7.2033e+17,670.122,3675.09,9638,279,258,7475,6884,6163,6219,5798
29254,1100,2101,23518,5736,14012,15242,8.32164e+17,1603.56,6505.16,29254,457,400,24322,20514,17598,16945,16258
44490,27,44,41961,2529,44082,408,1.0651e+14,41.9617,969.59,44490,44,43,44176,43980,38268,38524,32785
45422,1090,2852,0,45422,0,45422,2.43216e+18,1401.95,7981.45,45422,669,435,40105,35714,20404,20456,22615
1712,8,35,1648,64,1608,104,8.40154e+13,11.5648,175.899,1712,17,20,1615,1563,1344,1344,1179
4212,303,1506,3428,784,2025,2187,8.00581e+17,219.954,2172.94,4212,200,164,2660,2230,1238,1449,754
11491,37,43,10907,584,11263,228,1.02341e+14,33.8395,485.03,11491,35,32,11443,11433,11089,11114,10847
19895,1758,1831,0,19895,0,19895,2.51818e+18,1178.86,4828.13,19895,381,320,18064,17990,17692,16822,17801
14764,41,43,14114,650,14344,420,9.74222e+13,35.3952,548.687,14764,34,33,14720,14714,14703,14701,14674
46825,709,2433,24397,22428,24397,22428,4.93799e+18,1495.76,7800.95,46825,620,435,39514,34575,16515,19416,15804
38354,3193,6351,7785,30569,1228,37126,1.0911e+18,515.941,11401,38354,786,545,32003,31995,22710,24445,16087
27285,537,2455,22420,4865,13789,13496,7.75743e+17,1583.07,6491.58,27285,506,386,20829,18029,11880,12024,8092
34626,1283,1762,0,34626,12301,22325,9.61212e+15,1085.98,5553.18,34626,523,349,32643,29380,25101,20495,31006
2361,101,201,0,2361,2231,130,2.70407e+16,35.792,518.8,2361,48,47,2160,2153,1925,1820,1569
1118,135,552,0,1118,0,1118,2.28531e+18,30.0948,712.283,1118,89,89,566,549,238,239,157
20987,45,1486,0,20987,7408,13579,9.91649e+15,931.411,4237.6,20987,352,306,13131,9955,5076,3707,1135
21893,1038,2134,11241,10652,0,21893,4.98283e+18,1200.13,5236.9,21893,463,332,18635,16811,10661,9668,11801
16750,497,1343,0,16750,5918,10832,9.8307e+15,876.439,3677.82,16750,328,279,14202,12960,7277,5947,7539
45919,3377,4174,16370,29549,45,45874,2.67724e+13,1076.09,9546.8,45919,897,565,41745,41652,41382,41577,39892
38657,1491,1560,0,38657,13688,24969,9.70187e+15,1097.97,5751.24,38657,483,362,37097,37097,36675,36277,36912
36717,235,683,36312,405,36717,0,4.73248e+18,507.698,3726.44,36717,273,238,34056,31552,17629,17673,13882
19334,682,813,18658,676,19334,0,4.50719e+18,438.127,2759.92,19334,240,178,18521,18502,18257,18190,17601
30871,1493,2290,16435,14436,0,30871,5.01473e+18,1358.59,6259.25,30871,527,368,28133,24737,19302,17429,21762
29989,2247,2507,29989,0,25003,4986,3.25708e+18,1576.6,6729.33,29989,512,386,27482,27317,27020,27103,26826
23288,960,2333,19094,4194,11732,11556,7.78104e+17,1519.97,5932.87,23288,465,371,18877,16389,13360,12647,9857
35443,476,1933,17582,17861,0,35443,5.09452e+18,1416.23,6536.88,35443,501,407,28494,25027,10188,10103,8165
36063,687,2351,19439,16624,19439,16624,4.94732e+18,1356.57,6737.17,36063,559,399,30352,26934,14532,16265,13673
44446,192,969,43182,1264,44446,0,4.58903e+18,578.371,4305.15,44446,297,242,40378,36289,21099,20460,11866
33892,1450,1758,0,33892,0,33892,2.54311e+18,1362.33,6205.11,33892,481,411,31446,27015,23371,22121,28695
36695,31,43,34787,1908,36075,620,1.02657e+14,39.5158,878.256,36695,42,40,36539,36438,33441,33377,30667
11998,164,756,11761,237,11998,0,4.53972e+18,346.001,2179.18,11998,215,144,10542,9154,5156,4684,3513
13282,560,758,13041,241,13282,0,4.77444e+18,385.984,2301.47,13282,212,152,12524,12301,11695,11748,10498
34090,886,2324,34090,0,27858,6232,3.12693e+18,1636.26,7154.77,34090,514,424,27659,23430,17151,16049,15331
38834,936,2347,0,38834,0,38834,2.44539e+18,1439,7049.27,38834,584,405,33485,29919,16981,16003,17691
20981,603,777,20350,631,20981,0,4.58056e+18,462.769,2853.78,20981,235,185,20204,19750,19131,19119,18113
34316,1694,2240,34316,0,27896,6420,3.05228e+18,1656.83,7147.54,34316,506,431,31050,26094,28977,28128,27813
47865,830,1603,0,47865,16960,30905,9.70856e+15,1169.55,6416.5,47865,529,396,43494,39536,27159,19675,29589
44762,1514,1944,0,44762,15882,28880,9.49975e+15,1144.83,6444.84,44762,605,365,42818,42791,36602,32529,41784
12588,972,2326,12588,0,10370,2218,3.2862e+18,1012.96,4365.69,12588,394,287,9692,8730,7422,7003,5242
707,11,20,693,14,671,36,1.05504e+14,11.3112,95.8288,707,15,15,675,652,558,548,493
14550,735,1524,5143,9407,0,14550,3.70446e+13,753.973,3489.11,14550,332,233,12479,11750,8460,8003,8837
47047,677,2444,47047,0,38494,8553,3.03605e+18,1814.42,8509.09,47047,573,471,37154,31407,18808,16814,16659
4666,79,557,4578,88,4666,0,4.90387e+18,193.65,1279.44,4666,145,99,3339,2292,1588,1480,962
18783,1185,1316,6659,12124,0,18783,3.90336e+13,895.169,3858.24,18783,318,295,17369,15619,15112,14373,16509
12730,138,344,0,12730,12088,642,2.5574e+16,182.893,1411.49,12730,94,96,12247,12071,10506,9679,7993
44374,81,355,0,44374,42348,2026,2.51879e+16,296.399,2674.81,44374,147,154,42478,41579,33277,28818,21354
35374,475,841,34639,735,35374,0,4.59111e+18,513.831,3758.1,35374,263,223,34204,33205,27875,27831,24190
49730,109,2001,0,49730,17619,32111,9.52827e+15,1171.76,6811.53,49730,669,384,38702,33370,16209,8877,5692
14416,1733,1978,7362,7054,0,14416,4.97793e+18,934.915,4181.07,14416,340,293,12438,11373,11169,10953,12054
28295,533,1707,10031,18264,0,28295,3.73861e+13,1065.53,5038.27,28295,483,327,24358,22340,13324,10351,9723
41404,36,43,39517,1887,40187,1217,9.8004e+13,38.9317,918.21,41404,42,40,41315,41237,39496,39512,37248
35274,932,1715,12540,22734,0,35274,3.72969e+13,1093.25,5546.5,35274,516,350,32231,29518,21859,20462,25743
14869,435,1517,5308,9561,0,14869,3.76413e+13,717.936,3513.4,14869,330,250,12605,11748,7537,6565,4915
30497,538,1715,0,30497,10821,19676,9.51214e+15,1067.55,5199.17,30497,491,326,26333,24298,14819,10399,14182
43902,20,2020,15347,28555,0,43902,3.79242e+13,1280.09,6850.73,43902,591,391,21171,13711,8056,3004,1415
13084,23,43,12347,737,12956,128,1.06833e+14,36.3173,528.454,13084,38,35,12930,12823,11192,11149,9676
4831,881,1021,1704,3127,0,4831,3.79922e+13,140.491,1773.35,4831,204,177,3810,3802,3479,3496,3418
13441,1787,1876,7288,6153,0,13441,5.09239e+18,844.937,3878.8,13441,347,275,11565,10799,11428,11277,10816
1489,462,583,597,892,597,892,4.31148e+18,81.6655,813.715,1489,123,81,906,895,834,835,881
48021,460,1727,0,48021,17034,30987,9.799e+15,1150.6,6605.97,48021,520,400,41302,37470,20064,14498,16860
18028,1393,1581,6410,11618,0,18028,3.76662e+13,845.833,3917.93,18028,398,276,16447,15227,15206,15409,16113
47597,1972,2503,25006,22591,25006,22591,4.92038e+18,1497.31,7907.49,47597,652,437,45094,44860,37874,36841,42878
1276,277,542,484,792,0,1276,3.9989e+18,52.6442,734.756,1276,110,68,734,729,693,677,611
12151,1930,2244,10195,1956,6492,5659,7.13174e+17,793.018,4093.28,12151,342,276,9907,9132,9361,9250,9205
8739,1775,1823,4523,4216,4523,4216,4.94411e+18,442.343,3136.08,8739,281,256,6916,6757,6874,6810,6820
1859,494,566,642,1217,0,1859,3.81575e+13,50.3093,899.088,1859,108,95,1293,1290,1267,1285,1091
8835,586,1981,7218,1617,4547,4288,7.82289e+17,603.056,3412.66,8835,235,225,6594,5941,4284,4353,3031
30418,187,2498,25368,5050,16063,14355,7.23789e+17,1574.76,6754.07,30418,526,380,20891,16045,9913,11177,3202
27664,380,1850,0,27664,0,27664,2.52788e+18,1273.66,5700.21,27664,427,374,21696,18997,6170,5104,4880
40240,1675,1718,14222,26018,0,40240,3.75346e+13,1110,5965.06,40240,522,369,38522,38522,38415,38459,38466
46346,381,1825,0,46346,0,46346,2.54796e+18,1461.13,7348.66,46346,540,449,36332,31559,10471,8728,10819
34000,498,2433,27910,6090,17188,16812,7.70701e+17,1670.92,7201.08,34000,518,419,25871,22077,13886,14281,9089
6098,252,337,0,6098,5754,344,2.72491e+16,77.2614,1008.65,6098,70,74,5761,5758,5555,5500,5156
7391,24,42,6998,393,7264,127,1.0473e+14,28.1909,386.514,7391,32,29,7315,7268,6496,6513,5575
23668,1,43,22301,1367,23474,194,1.06428e+14,39.8972,713.665,23668,41,38,7742,7742,7742,7742,7742
37897,2013,2739,31570,6327,19878,18019,7.33233e+17,1675.86,7728.05,37897,597,422,35079,29506,29871,29071,31404
23994,127,2000,12171,11823,0,23994,5.04746e+18,1271.73,5405.72,23994,424,351,16398,11869,5639,4573,2148
1813,50,386,1737,76,1319,494,2.94121e+17,39.3933,611.499,1813,105,61,1408,1273,904,1036,35
18724,447,1577,0,18724,6631,12093,9.47695e+15,810.661,3934.62,18724,404,261,15987,14880,9148,6253,8294
25920,13,43,24685,1235,25232,688,9.89292e+13,38.8465,733.888,25920,40,37,25097,24570,20073,19840,14232
23183,917,2644,23183,0,18996,4187,2.91971e+18,1652.5,6412.28,23183,474,365,17948,14860,11514,10403,10162
6519,1439,1662,0,6519,0,6519,2.53987e+18,280.8,2696.91,6519,218,197,4857,4848,4535,4472,4469
9489,311,632,9350,139,9489,0,4.72871e+18,307.113,1867.43,9489,169,148,8758,8452,6537,6582,5724
25706,799,1591,0,25706,9076,16630,9.46668e+15,1022.6,4680.31,25706,471,303,23005,21084,14937,10478,16172
32204,278,2656,32204,0,26858,5346,3.29788e+18,1621.54,7117.46,32204,572,397,23028,19568,10979,8965,4121
15223,387,2023,0,15223,0,15223,2.44282e+18,952.209,4288.37,15223,387,290,11890,10717,5551,4017,3455
11692,779,1532,4121,7571,0,11692,3.6768e+13,630.725,3171.85,11692,310,226,9987,9353,6629,6833,6563
17384,1240,1458,0,17384,6202,11182,9.83356e+15,862.072,3789.84,17384,322,283,15829,14550,13427,12258,14863
874,333,357,398,476,398,476,5.11119e+18,69.9027,513.984,874,75,71,517,517,517,517,514
32454,1180,1356,0,32454,11472,20982,9.92107e+15,1071.56,5126.11,32454,417,366,30707,27155,25195,22934,28521
39491,276,357,0,39491,37658,1833,2.51712e+16,296.605,2526.26,39491,137,147,38864,38102,35779,33800,33009
3226,405,1108,1369,1857,0,3226,4.53638e+18,168.055,1622.54,3226,186,126,2118,1971,1182,1060,997
15471,205,352,0,15471,14755,716,2.50486e+16,211.584,1568.8,15471,99,96,14983,14797,13665,12939,12221
1074,188,375,0,1074,0,1074,2.49956e+18,106.83,577.575,1074,97,95,699,540,434,367,523
31961,1112,2164,0,31961,0,31961,2.43438e+18,1424.87,6313.78,31961,503,376,27990,25057,16444,15332,17778
24071,881,2189,19472,4599,11709,12362,8.10159e+17,1505.71,5973.65,24071,445,369,19235,16316,12665,12111,10951
39376,1370,2412,18844,20532,18844,20532,5.0219e+18,1493.36,7434.7,39376,570,437,35595,30900,22323,20190,29064
11271,191,1792,0,11271,0,11271,2.49053e+18,787.931,3589.89,11271,299,273,8075,6341,2523,1608,1669
34929,547,1714,0,34929,0,34929,2.56902e+18,1374.52,6259.11,34929,479,419,28359,24591,11581,9277,13179
26804,613,1336,0,26804,9467,17337,9.92895e+15,1016.08,4621.77,26804,395,336,23474,21458,13318,10538,13731
41001,291,1746,19372,21629,19372,21629,4.95909e+18,1435.47,6820.58,41001,513,434,31152,26978,8579,8769,7254
1088,242,386,1087,1,1088,0,5.20311e+18,96.9007,582.819,1088,104,57,702,624,557,573,559
8939,1125,2168,7406,1533,4580,4359,7.42181e+17,527.243,3540.1,8939,306,231,6771,6366,5368,5520,3737
47895,1008,1754,0,47895,17070,30825,9.68749e+15,1153.17,6533.82,47895,548,395,44405,40114,30461,22585,36037
39385,35,44,37169,2216,38978,407,1.06465e+14,41.4288,912.005,39385,43,42,39271,39160,36760,36798,35308
29104,155,1705,10355,18749,0,29104,3.73392e+13,1031.17,5058.64,29104,478,326,23259,20941,10048,3397,4250
30567,229,2310,16226,14341,16226,14341,4.90152e+18,1356.32,6243.66,30567,532,370,22993,20085,8732,9625,3966
19500,775,2152,9928,9572,9928,9572,4.82889e+18,1134.56,4970.6,19500,437,323,16072,14451,8128,8251,8757
13238,810,1907,7246,5992,7246,5992,5.0606e+18,799.537,3861.94,13238,345,275,10889,10110,7237,7151,6307
5369,381,1771,4315,1054,2604,2765,8.41022e+17,276.335,2617.26,5369,240,193,3553,3146,1778,1969,885
22976,5,42,21731,1245,22627,349,1.03704e+14,36.6141,679.016,22976,38,36,19535,17575,14821,15047,9671
48726,1047,2267,0,48726,0,48726,2.46063e+18,1483.38,7849.31,48726,600,445,43029,38047,22394,19386,27578
27500,12,43,26063,1437,26998,502,1.0303e+14,38.8733,759.127,27500,41,39,26417,25667,20928,20475,14592
1498,341,506,614,884,0,1498,4.32748e+18,98.1475,770.004,1498,101,90,992,977,782,757,684
5291,1485,1494,4450,841,2886,2405,6.79989e+17,237.648,2311.56,5291,206,160,3797,3797,3797,3797,3794
664,283,288,309,355,0,664,5.32682e+18,76.0286,404.85,664,49,60,376,376,376,376,376
3186,643,931,1683,1503,1683,1503,5.32345e+18,129.076,1479.41,3186,127,128,2255,2248,2203,2202,1823
32531,1121,1337,11548,20983,0,32531,3.89137e+13,1066.28,5102.13,32531,444,358,30575,27174,24457,20731,27762
19990,1354,2054,10699,9291,0,19990,5.03892e+18,1103.71,4873.74,19990,412,308,17639,15790,12903,11881,13549
30780,40,47,29236,1544,30702,78,9.42643e+13,40.2074,902.914,30780,39,42,30723,30708,29386,29407,28887
10161,365,1871,0,10161,0,10161,2.39336e+18,545.659,3337.9,10161,314,205,7878,7228,3594,2456,2499
24300,40,42,22906,1394,24079,221,1.07111e+14,38.2237,707.869,24300,40,37,24252,24235,24167,24167,23433
40121,2656,2771,40121,0,33497,6624,3.32913e+18,1743.89,7984.52,40121,648,430,37350,37350,37208,37204,37019
26477,463,897,25838,639,26477,0,4.57173e+18,515.487,3333.81,26477,266,205,25319,24517,20039,19950,16466
25600,1637,1953,0,25600,0,25600,2.48173e+18,1284.53,5511.81,25600,417,353,23584,20629,19152,18701,21092
40675,5,43,38388,2287,40240,435,1.07089e+14,40.0703,930.735,40675,43,41,34184,30705,25423,25768,16796
34949,219,2117,34949,0,27909,7040,3.06415e+18,1661.72,7124.88,34949,487,438,23073,17284,7538,6662,4447
28393,753,3151,23549,4844,14080,14313,7.67493e+17,1487.68,7267.35,28393,634,387,22467,18719,13281,13459,8044
26965,69,743,26123,842,26965,0,4.56985e+18,515.85,3220.84,26965,233,205,19870,13968,8679,7825,2864
21913,1129,1803,0,21913,0,21913,2.51104e+18,1246.29,5065.98,21913,394,330,19074,16874,12477,10197,14020
17341,936,1841,8461,8880,8461,8880,4.9657e+18,1086.69,4500.02,17341,373,312,14644,13091,8234,8163,10288
35082,110,1735,16581,18501,16581,18501,4.97545e+18,1399.67,6298.89,35082,494,404,22526,15304,6166,6462,1660
36851,664,1818,13040,23811,0,36851,3.69685e+13,1143.24,5800.42,36851,563,350,32372,29807,18828,16562,18602
23274,973,1646,8256,15018,0,23274,3.72327e+13,964.166,4501.66,23274,426,292,20843,19329,14341,15594,17022
23824,60,799,23190,634,23824,0,4.57304e+18,510.054,3079.98,23824,250,195,16729,10990,6999,6167,2357
13244,21,756,12825,419,13244,0,4.51651e+18,401.272,2295.35,13244,194,154,6588,1998,2900,2599,475
34801,6,43,33167,1634,33883,918,9.94681e+13,41.0974,853.98,34801,42,40,31064,28728,23853,24091,15158
43834,187,360,0,43834,41600,2234,2.61262e+16,309.206,2728.09,43834,148,161,42639,41679,36954,32706,28984
38982,41,2498,31935,7047,19667,19315,7.77132e+17,1671.47,7730.27,38982,551,431,17756,10358,6596,6905,1479
13594,31,347,0,13594,12924,670,2.59099e+16,204.013,1492.65,13594,96,94,12411,11710,8895,7761,4565
16088,170,394,26,16062,15257,831,2.71784e+16,231.38,1734.08,16088,106,113,15497,15181,13283,11974,10175
18341,788,1377,0,18341,6483,11858,9.83125e+15,874.079,3841.05,18341,344,286,16244,14994,10966,8862,11594
44465,143,2235,35956,8509,21634,22831,8.10941e+17,1763.47,8139.65,44465,583,465,27609,17716,11917,11920,3306
20950,334,1902,0,20950,0,20950,2.48602e+18,1208.26,5012.97,20950,388,330,16171,14513,5572,3839,3530
18515,115,1867,0,18515,0,18515,2.48065e+18,1182.83,4715.21,18515,371,322,12121,8657,3936,2292,986
36025,1587,1609,12812,23213,0,36025,3.75887e+13,1126.54,5561.77,36025,496,357,34416,34416,34386,34409,34416
2691,64,414,2687,4,2691,0,4.70739e+18,148.584,899.862,2691,89,88,1804,1142,722,741,578
19164,433,848,18740,424,19164,0,4.69903e+18,440.24,2810.62,19164,238,177,18153,17596,15019,14724,11235
26554,169,585,26291,263,26554,0,4.74675e+18,474.075,3056.79,26554,219,215,23771,20709,11177,11040,8653
16259,912,2133,0,16259,0,16259,2.42788e+18,986.051,4525.58,16259,397,296,13409,12360,8062,7495,7179
7521,123,2090,6283,1238,3956,3565,7.18319e+17,239.982,3209.1,7521,276,221,4748,3241,2268,2417,279
20464,3018,4063,6639,13825,0,20464,2.16422e+17,404.033,6800.71,20464,822,421,16401,16401,14984,13776,11388
13660,21,350,0,13660,12965,695,2.62014e+16,222.739,1510.15,13660,99,106,11964,10944,8491,7626,4823
3304,706,937,0,3304,0,3304,2.71647e+18,213.218,1506.52,3304,126,147,2367,2282,2288,2285,2144
14268,421,2185,14268,0,11647,2621,3.01941e+18,1146.35,4595.07,14268,333,315,10292,8961,4889,4228,2731
9293,25,43,8894,399,8979,314,9.58951e+13,30.6743,435.232,9293,33,32,9208,9162,8321,8321,7032
38761,2107,2210,0,38761,0,38761,2.46045e+18,1401.52,6942.53,38761,542,413,36551,36551,36022,35318,36012
30361,1764,2945,30361,0,25439,4922,3.15975e+18,1519.44,7159.33,30361,512,409,27032,23036,25677,25406,21019
15485,1634,1893,8136,7349,0,15485,5.0763e+18,927.868,4233.17,15485,335,293,13592,12337,11966,11780,12387
7506,806,2086,7506,0,6202,1304,3.13951e+18,392.367,3266.1,7506,240,223,5420,4926,3993,3646,2651
34604,1760,2323,17859,16745,17859,16745,4.87648e+18,1446.19,6700.62,34604,575,394,32278,28011,25294,24238,28618
47560,18,43,45139,2421,46677,883,1.02748e+14,41.0094,1000.68,47560,43,43,46706,46073,38524,38239,30825
46056,1551,1818,21868,24188,21868,24188,5.01445e+18,1453.3,7312.88,46056,542,447,43751,36984,33924,33225,40959
3099,862,918,1625,1474,0,3099,5.45619e+18,122.977,1453.01,3099,125,129,2181,2181,2181,2181,1999
39591,1652,2093,39591,0,31644,7947,3.02512e+18,1697.15,7541.03,39591,503,451,36057,29790,34949,35332,32046
46658,868,2407,22247,24411,0,46658,5.11052e+18,1546.68,8047.83,46658,622,463,39523,34820,17710,15638,23528
13552,1201,1475,0,13552,4810,8742,9.55436e+15,635.945,3255.6,13552,352,248,12077,11396,10392,8702,11231
42658,1165,1756,20380,22278,0,42658,5.1546e+18,1450.04,6965.69,42658,521,450,38466,33151,23919,20448,28903
12258,684,1368,4324,7934,0,12258,3.77785e+13,679.234,3153.67,12258,302,258,10456,9820,6823,6455,6772
30261,8,43,28743,1518,29629,632,1.01378e+14,41.0303,797.713,30261,42,40,27981,26529,21530,21309,13110
36178,948,2228,29303,6875,17781,18397,8.08947e+17,1699.34,7313.35,36178,535,436,29772,25276,20408,19287,16634
30636,274,348,0,30636,29161,1475,2.5741e+16,269.255,2227.69,30636,126,140,30085,29513,27795,26765,25557
25251,1015,2411,25251,0,20886,4365,2.99645e+18,1496.48,6195.86,25251,462,368,20791,17988,14347,13511,11789
9084,591,1743,4615,4469,4615,4469,4.98769e+18,527.87,3153.53,9084,275,260,7200,6577,3907,4137,3915
5991,1176,1725,5991,0,5053,938,3.33473e+18,191.182,2602.62,5991,214,166,4266,4258,4201,4176,2700
28242,202,352,0,28242,26998,1244,2.47847e+16,260.177,2100.91,28242,121,129,27558,27095,24833,23043,20518
30992,776,2620,25861,5131,16277,14715,7.26651e+17,1591.58,6943.79,30992,570,390,24782,21352,15790,15602,11421
32929,811,2312,16441,16488,0,32929,5.07109e+18,1580.44,6735.1,32929,530,394,27601,24419,12406,11534,12752
38861,1094,2526,20619,18242,0,38861,5.00558e+18,1409.49,7168.91,38861,580,408,34159,30582,18456,17730,19485
12843,656,1458,4582,8261,0,12843,3.75952e+13,626.365,3169.59,12843,323,243,11056,10430,7559,7341,7690
49754,1809,2490,26124,23630,26124,23630,4.94358e+18,1507.87,8057.9,49754,657,448,47264,42357,35792,34539,42765
11807,715,1311,4209,7598,0,11807,3.93388e+13,706.831,3070.59,11807,268,246,10050,9433,6652,6523,6893
3248,461,604,1203,2045,0,3248,3.93134e+13,58.3063,1053.95,3248,168,98,2644,2644,2631,2633,1342
13234,41,43,12653,581,12783,451,9.58175e+13,34.5296,518.284,13234,34,33,13191,13185,13166,13165,13086
35207,1434,2272,18774,16433,18774,16433,4.94205e+18,1391.12,6628.69,35207,537,397,32140,28303,21839,21009,25665
42733,48,1755,20341,22392,0,42733,5.14519e+18,1439.76,6962.04,42733,509,443,21473,12405,5650,4427,1840
45642,133,1898,16220,29422,0,45642,3.72719e+13,1155.56,6478.15,45642,590,378,36054,31876,15210,4502,5861
1137,2,30,1094,43,1090,47,1.12145e+14,12.8259,139.298,1137,18,17,672,524,488,513,421
47369,1501,1623,0,47369,43414,3955,2.41986e+16,263.758,4803.7,47369,311,255,45746,45746,43439,40977,39201
46500,1613,1791,21971,24529,0,46500,5.11714e+18,1468.74,7323.09,46500,541,454,44505,37610,36998,36653,42526
37975,100,579,37591,384,37975,0,4.78703e+18,495.251,3658.76,37975,243,243,29920,20956,12119,12362,7378
21236,32,356,0,21236,20180,1056,2.59443e+16,257.821,1892.77,21236,119,121,19409,18350,13851,11869,7490
9302,96,1359,3366,5936,0,9302,3.89804e+13,440.435,2699.03,9302,216,234,7026,6010,3151,1820,1152
28172,1079,1743,9989,18183,0,28172,3.6721e+13,1038.34,5005.2,28172,497,320,25812,23570,18506,19629,21035
39883,194,374,0,39883,38053,1830,2.49582e+16,294.287,2583.03,39883,138,142,38903,38177,34408,31187,29037
34945,40,2195,18185,16760,0,34945,5.02715e+18,1360.55,6570.78,34945,549,390,18786,12626,7139,4935,865
27855,823,1905,13727,14128,0,27855,5.101e+18,1353.37,5805.66,27855,443,385,23410,20767,11594,10166,13302
38806,820,2160,19598,19208,19598,19208,4.93682e+18,1430.85,6959.83,38806,528,417,33151,29365,15772,16854,17600
43289,1476,2431,0,43289,0,43289,2.43585e+18,1446.2,7466.56,43289,631,416,40007,34879,25846,21866,29851
38883,2496,3088,38883,0,32538,6345,3.23499e+18,1653.65,8141.76,38883,600,444,35795,35780,35137,35170,33711
18041,1188,2013,9536,8505,9536,8505,4.98555e+18,1050.54,4632.37,18041,392,313,15577,14097,10669,10188,11235
37795,137,2753,37795,0,31523,6272,3.33176e+18,1682.44,7747.7,37795,647,434,24480,16926,10969,9211,2765
4377,7,43,4147,230,4313,64,1.09259e+14,27.9326,315.843,4377,30,26,3913,3618,2941,2896,1949
8055,1382,1645,3700,4355,3700,4355,4.84966e+18,492.067,2932.58,8055,276,220,6410,6092,5596,5631,6052
38324,9,349,0,38324,36274,2050,2.67049e+16,295.037,2538.99,38324,141,155,29400,24976,20359,18089,10624
40297,2577,2610,33230,7067,20461,19836,7.59936e+17,1710.1,7992.88,40297,566,428,37687,37687,37678,37677,37683
40637,166,352,0,40637,38701,1936,2.53994e+16,297.741,2564.28,40637,139,150,39506,38701,34292,29790,27741
23381,1723,1799,8282,15099,0,23381,3.76507e+13,975.754,4740.1,23381,429,313,21582,21582,21371,21409,21571
13354,27,42,12721,633,13040,314,1.00879e+14,34.8523,519.415,13354,36,33,13259,13214,12002,12017,10930
29343,1160,1727,10399,18944,0,29343,3.7116e+13,1072.95,5130.96,29343,504,336,27159,24638,19914,19268,20712
7402,570,1690,0,7402,0,7402,2.48606e+18,445.187,2880.34,7402,269,215,5672,5106,2662,2433,2713
662,7,288,256,406,256,406,4.09277e+18,44.2039,394.097,662,63,50,162,24,26,58,8
16648,2327,2360,16648,0,14057,2591,3.31415e+18,1125.77,4913.38,16648,450,324,14288,14246,14244,14240,14279
1178,164,385,0,1178,0,1178,2.58401e+18,105.668,607.122,1178,71,82,793,586,346,355,467
29830,3180,3553,14451,15379,14451,15379,4.75354e+18,922.673,7497.17,29830,441,477,26277,26277,25788,25626,25267
6230,1036,1629,2969,3261,0,6230,5.10453e+18,239.236,2620.26,6230,242,208,4601,4583,3552,3390,3432
32771,1952,2681,27243,5528,17001,15770,7.36765e+17,1669.89,7214.14,32771,577,403,29903,25249,25401,24722,25953
22680,189,1583,8052,14628,0,22680,3.73763e+13,969.264,4388.85,22680,419,293,18361,16800,7988,5900,3749
48620,191,2523,25493,23127,25493,23127,4.92636e+18,1512.26,8005.61,48620,656,438,35978,29564,12596,13826,2135
14281,1291,2307,11792,2489,7268,7013,7.54007e+17,1099.47,4621.27,14281,355,285,11459,10347,9327,9309,7586
20790,241,1327,7315,13475,0,20790,3.82648e+13,943.386,4069.39,20790,355,306,16943,15546,6802,3899,5431
28894,673,1702,0,28894,10263,18631,9.57946e+15,1063.71,5081.39,28894,483,331,25341,23371,15027,10268,12910
13613,555,707,13192,421,13613,0,4.51274e+18,370.027,2252.13,13613,186,156,12906,12685,12182,12225,11820
40941,69,1826,14583,26358,0,40941,3.74769e+13,1138.71,6079.24,40941,552,370,29813,24921,12398,4529,3147
45788,221,2052,0,45788,0,45788,2.53954e+18,1430.85,7513.35,45788,549,447,33439,28304,8976,5334,6983
22312,1803,2557,22312,0,18623,3689,3.27971e+18,1366.97,5869.05,22312,471,337,19610,16994,18671,18135,16095
32462,897,1341,11441,21021,0,32462,3.85723e+13,1062.66,5087.86,32462,431,358,29643,26688,20041,18864,22804
11309,1047,1977,0,11309,0,11309,2.4284e+18,735.415,3691.85,11309,346,268,9328,8518,5759,5519,6264
43176,269,2492,0,43176,0,43176,2.42447e+18,1467.55,7544.64,43176,633,416,33098,28930,11826,5836,6000
3000,350,1161,3000,0,2491,509,3.15971e+18,122.367,1657.77,3000,123,147,1839,1800,1405,1286,919
49448,2837,3123,49448,0,41090,8358,3.13172e+18,1774.35,9156.07,49448,717,467,46325,46325,46108,46165,45740
34091,346,2311,17557,16534,17557,16534,4.86119e+18,1425.49,6637.14,34091,573,391,26734,23944,9413,10317,5877
5815,577,1556,2857,2958,2857,2958,5.12478e+18,245.977,2503.06,5815,229,193,4259,3959,2247,2035,2063
10858,534,1784,5659,5199,5659,5199,5.03156e+18,715.887,3482.26,10858,290,265,8555,7729,4655,4354,3620
45833,293,358,0,45833,43693,2140,2.52618e+16,302.752,2729.97,45833,147,156,45214,44271,42324,39770,39844
14005,1311,1812,0,14005,0,14005,2.48058e+18,968.073,4046.27,14005,326,292,11873,10811,8828,8401,10133
10723,157,347,0,10723,10282,441,2.40708e+16,133.245,1265.97,10723,82,84,10339,10199,9332,8452,7589
19894,7,42,18772,1122,19700,194,1.06682e+14,38.8467,641.28,19894,38,35,17946,16666,13513,13528,8861
39359,303,2434,20856,18503,20856,18503,4.91036e+18,1439.68,7141.64,39359,598,407,30701,27128,11801,12449,6914
14584,288,2342,14584,0,12249,2335,3.28764e+18,1048.73,4632.89,14584,382,297,10356,8898,5536,3975,2012
8972,292,562,8890,82,8972,0,4.75431e+18,313.101,1763.64,8972,131,134,8299,7993,6191,6269,5276
8409,1106,1666,3868,4541,3868,4541,4.81662e+18,549.524,3014.1,8409,280,219,6743,6325,4848,4752,5460
36055,1434,2306,18574,17481,0,36055,4.97488e+18,1456.62,6816.42,36055,580,402,32924,28718,21487,19587,25437
41782,190,359,0,41782,39810,1972,2.52294e+16,302.601,2608.12,41782,135,151,40738,39933,35871,32369,28252
21756,834,875,21127,629,21756,0,4.56639e+18,456.502,2990.23,21756,231,189,20881,20879,20839,20844,20511
35874,1250,1641,12708,23166,0,35874,3.79975e+13,1043.5,5587.3,35874,471,365,34123,30436,26033,27186,30560
11083,619,1799,5349,5734,5349,5734,4.86855e+18,789.036,3609.27,11083,297,239,8674,7734,4078,3839,4154
29649,329,600,29338,311,29649,0,4.74918e+18,495.488,3270.11,29649,225,224,28201,27137,20989,21053,17479
1703,100,305,1285,418,1285,418,5.19259e+18,34.7463,513.905,1703,96,56,1398,1373,1234,1215,1217
5873,1145,1196,1966,3907,0,5873,3.5687e+13,142.555,2098.95,5873,149,188,4677,4677,4676,4674,4633
32733,413,603,32412,321,32733,0,4.72897e+18,499.07,3425.78,32733,236,232,31591,30644,26410,26343,23889
16900,217,1814,8565,8335,0,16900,5.09727e+18,1106.74,4425.14,16900,339,302,12305,10625,4401,3778,2469
10153,230,2167,10153,0,8436,1717,3.19058e+18,717.565,3777.58,10153,308,257,6991,5492,3106,2456,1695
24572,172,1670,0,24572,8701,15871,9.48559e+15,971.513,4655.47,24572,425,304,19770,18160,8088,5298,4038
12699,1492,2202,10590,2109,6667,6032,7.37008e+17,992.861,4284.4,12699,341,288,10374,9273,8661,8666,8318
7544,88,532,7541,3,7544,0,4.81128e+18,255.835,1586.74,7544,150,129,5638,3814,2286,2404,1540
31974,1950,2195,16401,15573,0,31974,5.01721e+18,1407.21,6361.1,31974,519,396,29779,29779,27674,27201,29279
45176,1114,2436,45176,0,36747,8429,3.0491e+18,1703.97,8332.62,45176,575,472,38251,32315,26423,22832,23712
17736,369,2061,14169,3567,8400,9336,8.53469e+17,1341.35,5021.02,17736,384,333,12596,10827,6124,6414,2767
37093,1567,1828,0,37093,13127,23966,9.51879e+15,1065.55,5786.38,37093,543,353,35265,35259,32509,31424,34818
24699,229,2499,24699,0,20595,4104,3.26343e+18,1488.98,6146.37,24699,490,356,17243,13800,7785,5887,3190
4440,141,854,1599,2841,0,4440,3.75718e+13,141.329,1511.37,4440,221,160,3524,3301,1938,2053,694
2270,69,145,0,2270,2172,98,2.5871e+16,30.6551,435.229,2270,44,38,2125,2097,1929,1913,1314
40967,955,1382,0,40967,14464,26503,9.90354e+15,1110.57,5774.81,40967,479,386,37962,34069,25971,20827,30679
40153,196,354,0,40153,38265,1888,2.54059e+16,296.356,2550.24,40153,139,148,39189,38404,34655,31533,29301
39441,1106,1691,0,39441,13939,25502,9.60689e+15,1108.01,5896.06,39441,520,367,36938,33249,25812,18991,30701
12377,91,1696,5843,6534,0,12377,5.13667e+18,937.678,3739.71,12377,307,281,7448,5074,2090,1457,855
36811,215,2568,36811,0,30417,6394,3.09598e+18,1675.02,7565.52,36811,596,434,25211,19772,10950,8139,4200
6335,425,1328,2232,4103,0,6335,3.70385e+13,197.06,2264.87,6335,230,166,5007,4770,2743,2289,2286
4615,1495,1629,4615,0,3712,903,3.12424e+18,211.593,2377.1,4615,190,182,2986,2983,2986,2986,2908
23683,2089,2270,23683,0,19349,4334,3.12868e+18,1453.19,5930.8,23683,465,374,21413,21372,21145,21105,21154
41397,15,352,0,41397,39475,1922,2.51246e+16,294.354,2575.59,41397,139,152,35405,32160,25773,23068,14325
42072,1037,1985,0,42072,0,42072,2.50589e+18,1438.07,7152.61,42072,547,436,37046,32517,20044,16474,24408
48805,959,2539,0,48805,0,48805,2.42327e+18,1500.55,8038.31,48805,659,440,42598,37760,19835,19794,23109
44386,1687,2544,0,44386,0,44386,2.41825e+18,1491.91,7669.21,44386,642,426,41671,36089,29164,25442,35191
7158,56,1469,2498,4660,0,7158,3.81676e+13,223.485,2536.15,7158,279,200,4647,3622,1749,1421,804
40619,782,1886,14432,26187,0,40619,3.71571e+13,1144.71,6141.04,40619,574,362,36402,33282,21823,20519,18904
6209,589,1958,6209,0,4955,1254,2.94258e+18,341.102,2936.47,6209,202,191,4251,3753,2441,2162,1767
9317,158,1862,4683,4634,4683,4634,4.94844e+18,607.493,3339.74,9317,292,238,6429,4742,2252,2356,1177
9468,512,657,9456,12,9468,0,4.56945e+18,270.602,1900.79,9468,154,159,8811,8786,8447,8456,7905
14692,580,2335,14692,0,12147,2545,3.28373e+18,1124.31,4709.88,14692,415,314,11070,9679,6414,5315,4131
27451,1068,1645,9691,17760,0,27451,3.68549e+13,997.365,4833.57,27451,485,313,25220,23078,18156,18645,20488
9749,1657,2066,9749,0,7800,1949,3.08624e+18,824.45,3748.45,9749,277,242,7683,6878,7393,7412,7168
13836,1247,1320,0,13836,4910,8926,1.00105e+16,780.097,3327.98,13836,295,264,12485,11491,12200,11205,12115
16447,181,384,0,16447,15531,916,2.70058e+16,244.702,1731.2,16447,110,105,15868,15512,13629,12132,11072
22555,3,43,21495,1060,21931,624,9.85259e+13,37.6332,682.357,22555,39,37,16492,14159,13163,13168,9006
20456,35,43,19456,1000,19994,462,1.01398e+14,37.9517,649.308,20456,39,36,20389,20338,19345,19354,18425
38931,911,2427,31744,7187,19291,19640,7.87849e+17,1690.31,7730.61,38931,563,436,31764,27227,21482,20177,16954
29080,312,2100,29080,0,23355,5725,2.95291e+18,1582.28,6478.17,29080,455,404,20287,16651,7750,6281,5296
16923,1326,2015,16923,0,13467,3456,3.05529e+18,1324.89,4882.17,16923,352,332,14169,12124,12599,12009,10788
40894,3,42,38688,2206,40267,627,1.04368e+14,39.5457,911.805,40894,42,41,29308,24655,22379,22817,15586
17422,514,1751,8381,9041,0,17422,5.21672e+18,1136.18,4479.29,17422,333,310,13747,12066,5527,4777,5973
7825,369,1403,0,7825,2785,5040,9.53283e+15,234.264,2489.44,7825,274,170,6422,6029,3631,2281,1969
12639,1647,2222,10253,2386,6213,6426,8.10101e+17,1017.77,4309.22,12639,345,283,10417,9261,8882,8884,8824
2057,472,880,664,1393,664,1393,2.75051e+18,105.224,1193.42,2057,141,213,1177,1147,1059,1002,972
45919,532,1891,0,45919,16314,29605,9.52718e+15,1165.71,6486.73,45919,608,380,39921,36555,21538,14715,17391
1243,185,520,903,340,486,757,1.01305e+18,65.6806,720.256,1243,91,77,723,671,425,392,223
16826,468,1581,5969,10857,0,16826,3.75547e+13,813.601,3795.32,16826,390,270,14306,13230,8374,7596,5915
23029,1260,1727,11105,11924,11105,11924,5.08427e+18,1256.02,5113.37,23029,384,350,20557,17907,14282,13138,16675
14223,257,1962,0,14223,0,14223,2.42577e+18,893.104,4104.69,14223,345,285,10721,9433,3908,2559,2299
32254,200,778,31636,618,32254,0,4.59637e+18,517.28,3557.32,32254,268,216,29410,26517,13495,12978,11275
46943,34,43,44624,2319,45904,1039,1.01047e+14,41.6062,990.697,46943,43,42,46800,46661,43896,43898,39628
14971,13,45,14186,785,14800,171,1.06265e+14,36.7831,574.886,14971,39,36,14420,14074,11414,11233,8168
7913,55,2164,7913,0,6487,1426,3.03232e+18,589.071,3472.17,7913,299,236,3528,1881,1264,1257,330
3571,63,163,0,3571,3476,95,2.08849e+16,42.5265,514.005,3571,40,42,3408,3377,3201,3121,2991
3134,706,896,2842,292,2019,1115,4.84328e+17,97.2234,1288.12,3134,140,86,2238,2234,2158,2135,2080
22551,1153,1640,8028,14523,0,22551,3.72593e+13,947.545,4429.25,22551,428,294,20707,18928,15657,15567,17822
34691,1710,2656,17927,16764,0,34691,4.95852e+18,1371.4,7000.2,34691,575,391,32035,27897,22915,21381,26848
23738,1105,1490,8348,15390,0,23738,3.73984e+13,982.467,4487.6,23738,400,315,21840,19767,16678,16103,18191
48897,211,2524,25779,23118,25779,23118,4.90577e+18,1488.95,8002.23,48897,654,443,36610,31395,13210,14767,4908
8351,161,1667,0,8351,0,8351,2.42678e+18,551.391,3000.67,8351,278,221,5769,4470,1511,1018,797
8455,877,1383,3003,5452,0,8455,3.81903e+13,365.313,2594.16,8455,236,228,7072,6822,5224,5120,5472
33175,46,2278,0,33175,0,33175,2.45208e+18,1379.33,6489.78,33175,539,388,18179,12378,7065,3376,618
6814,1198,1390,0,6814,2398,4416,9.49778e+15,196.825,2379.82,6814,228,173,5424,5405,5317,5112,5121
10374,419,643,10245,129,10374,0,4.62729e+18,330.645,1953.3,10374,163,143,9727,9508,8332,8314,7629
49410,719,2198,25165,24245,25165,24245,4.94345e+18,1547.68,7886.85,49410,607,445,41570,36322,17681,19292,18714
12513,47,2058,5908,6605,5908,6605,4.98986e+18,903.078,4064.46,12513,382,276,6074,3560,1738,1888,518
22514,262,1444,7960,14554,0,22514,3.79997e+13,966.645,4341.6,22514,394,302,18522,17037,7827,4672,5476
41353,1903,2138,20594,20759,0,41353,5.04623e+18,1433.71,7199.52,41353,544,424,39215,39215,36014,35528,38296
40460,530,2778,40460,0,33947,6513,3.34728e+18,1705.82,8016.82,40460,645,457,31383,27111,17782,14895,10818
40802,311,608,40412,390,40802,0,4.72789e+18,505.671,3824.91,40802,251,247,38856,37173,25980,26095,23014
793,224,307,344,449,344,449,4.73502e+18,62.3304,455.605,793,73,77,486,484,426,429,421
14888,804,1935,7680,7208,0,14888,5.02644e+18,953.775,4200.35,14888,349,301,12151,11123,6960,6597,6518
43486,1183,2136,43486,0,34626,8860,2.98908e+18,1711.12,7950.54,43486,529,471,37016,30990,27959,25987,25636
43921,6,43,41855,2066,42789,1132,9.91552e+13,41.0668,955.521,43921,43,41,39203,36230,30095,30435,19051
29553,758,1715,14180,15373,0,29553,5.20579e+18,1336.8,5768.77,29553,432,395,24730,21883,12418,10500,14202
42488,1097,2206,21662,20826,21662,20826,4.94712e+18,1444.05,7301.7,42488,565,420,37604,33288,20832,20839,25936
16793,1541,2001,8636,8157,0,16793,4.94928e+18,1020.32,4478.29,16793,420,298,14700,13285,11223,10564,12693
16353,259,678,16083,270,16353,0,4.62272e+18,415.051,2476.79,16353,178,170,15186,14267,9067,9187,7755
594,110,215,193,401,0,594,3.95777e+13,58.8165,331.605,594,75,58,379,308,232,252,220
41257,418,1768,0,41257,14572,26685,9.47517e+15,1143.62,6054.18,41257,586,363,35355,32527,16799,11059,13597
38393,166,354,0,38393,36610,1783,2.51573e+16,291.771,2487.35,38393,133,142,37327,36590,32501,28397,25707
32254,110,2362,26577,5677,16464,15790,7.60618e+17,1622.68,6961.25,32254,504,407,19199,12396,8685,8856,2113
7765,1866,2012,3640,4125,3640,4125,4.9018e+18,358.415,3219.78,7765,339,198,5753,5718,5701,5634,5488
43339,922,2118,34752,8587,20663,22676,8.35827e+17,1716.92,7909.58,43339,545,456,35427,29943,23860,22404,21468
7653,1543,1736,3874,3779,3874,3779,4.93789e+18,348.587,2925.76,7653,265,201,5917,5827,5643,5643,5656
8692,1581,1882,4637,4055,0,8692,4.94629e+18,415.685,3171.85,8692,318,221,6810,6654,6109,6072,6045
46494,1396,1579,0,46494,16527,29967,9.79713e+15,1156.38,6322.95,46494,511,394,44915,44863,40769,38954,43849
2676,164,228,0,2676,2513,163,2.68197e+16,38.725,578.474,2676,54,53,2448,2448,2328,2331,2123
26421,557,2030,13230,13191,13230,13191,4.9097e+18,1294.05,5685.92,26421,457,367,21453,18989,8425,9192,8871
46443,1109,1935,22556,23887,0,46443,5.10056e+18,1481.57,7470.28,46443,568,445,41361,36095,24479,20395,29352
49520,270,373,0,49520,47172,2348,2.54109e+16,305.926,2895.48,49520,152,166,48738,47719,44348,41953,39871
30634,240,385,0,30634,29067,1567,2.62319e+16,295.502,2346.24,30634,138,138,29890,29332,26732,24611,23429
26490,2127,2163,14024,12466,14024,12466,4.96159e+18,1261.43,5710.42,26490,476,361,24327,24327,24316,24283,24156
5018,240,324,0,5018,4718,300,2.78581e+16,65.9408,899.26,5018,65,64,4694,4685,4454,4445,3948
30661,7,42,28923,1738,30381,280,1.06298e+14,39.634,796.617,30661,41,40,27650,25697,20836,20854,12925
47345,485,846,46573,772,47345,0,4.70109e+18,525.022,4345.86,47345,273,255,46104,44655,40551,40372,36072
21338,108,353,0,21338,20250,1088,2.61918e+16,259.211,1898.41,21338,115,118,20447,20055,16367,14437,11063
33922,34,1561,0,33922,12027,21895,9.7102e+15,1079.46,5399.78,33922,454,356,20805,15862,8326,5021,1881
47741,13,43,45282,2459,46853,888,1.02589e+14,40.6751,999.461,47741,43,42,46114,45066,36538,36016,26498
19399,1111,1910,9617,9782,0,19399,4.99321e+18,1157.32,4792.63,19399,395,328,16716,15027,10180,9302,12269
24732,46,1786,0,24732,0,24732,2.50346e+18,1260.39,5334.77,24732,414,355,12818,7812,3847,2460,845
49182,2247,2588,26008,23174,0,49182,5.0089e+18,1499.5,8072.2,49182,677,443,46594,46594,43070,42526,45239
34995,1043,2239,0,34995,0,34995,2.44501e+18,1396.76,6656.3,34995,524,389,30587,27157,17144,14505,19203
30599,1336,1342,0,30599,10741,19858,9.81857e+15,1055.18,4937.73,30599,423,354,29257,29257,29243,29256,29252
5738,714,1339,0,5738,0,5738,2.4149e+18,212.901,2214.39,5738,269,205,4399,4246,3169,3072,2302
49779,277,1757,0,49779,0,49779,2.52756e+18,1464.45,7505.48,49779,554,457,37680,32323,10401,7097,9703
20016,103,776,19461,555,20016,0,4.49479e+18,472.134,2830.02,20016,212,175,16209,12409,7772,7333,3324
30208,287,2254,15900,14308,0,30208,5.00317e+18,1354.19,6185.49,30208,515,368,23278,20523,8563,6683,4874
34539,2023,2614,28959,5580,18374,16165,7.12348e+17,1633.65,7273.2,34539,546,405,31867,26967,27852,27091,28844
9600,1330,2059,7920,1680,4934,4666,7.49716e+17,714.35,3635.66,9600,291,260,7541,6860,6280,6201,5808
17957,673,725,17529,428,17957,0,4.65998e+18,449.123,2632.46,17957,228,173,17232,17227,16998,17022,16938
10125,38,1945,5367,4758,5367,4758,4.94458e+18,566.432,3489.37,10125,328,253,5158,3437,1933,2054,233
25502,322,1510,0,25502,9055,16447,9.76774e+15,999.587,4694.39,25502,401,318,21298,19366,9917,7238,6449
34913,17,43,33093,1820,34278,635,1.02906e+14,40.2494,857.029,34913,42,41,34203,33629,28023,27778,20576
14354,205,356,0,14354,13545,809,2.71936e+16,237.107,1583.04,14354,104,102,13844,13552,12218,11306,10494
9003,409,1648,4177,4826,4177,4826,4.94983e+18,680.476,3134.61,9003,286,218,6786,6084,2468,2420,1907
31305,1200,1776,0,31305,11113,20192,9.52449e+15,1045.74,5291.16,31305,474,339,29086,26380,21450,16592,24967
7380,1526,2053,6179,1201,3911,3469,7.15938e+17,350.245,3161.99,7380,264,190,5327,5230,5029,4961,4834
47209,9,43,45015,2194,45942,1267,9.91775e+13,41.6035,990.329,47209,43,42,44477,42673,34826,34839,22895
28594,593,1343,0,28594,10096,18498,9.88704e+15,1039.24,4778.43,28594,402,342,24955,22746,13584,10689,14365
27585,60,353,0,27585,26347,1238,2.46488e+16,254.225,2063.59,27585,118,128,26254,25564,20282,17460,12159
14017,289,1686,6675,7342,0,14017,5.16333e+18,991.79,3944.86,14017,311,291,10487,9130,3405,2755,3196
28320,666,2177,0,28320,0,28320,2.47768e+18,1258.18,5879.06,28320,485,361,23617,21059,12350,11602,11236
20535,732,1530,0,20535,7289,13246,9.6372e+15,944.674,4207.33,20535,378,285,17924,16565,11545,8826,12327
45786,198,1571,0,45786,16274,29512,9.75436e+15,1148.24,6219.99,45786,507,389,37314,33998,15314,10077,8784
43634,1695,1951,15453,28181,0,43634,3.69484e+13,1131.21,6358.13,43634,594,366,41683,41683,39788,39791,41330
31795,13,43,30161,1634,31287,508,1.03481e+14,39.5383,816.662,31795,41,40,30703,29997,24358,23950,17044
23407,482,573,23209,198,23407,0,4.78081e+18,457.445,2866.34,23407,211,204,22694,22099,21358,21372,20481
37358,935,1909,0,37358,0,37358,2.50013e+18,1421.92,6683.74,37358,527,409,32444,28494,17338,14030,19740
1759,475,596,628,1131,0,1759,3.86505e+13,84.996,895.822,1759,149,104,1163,1163,987,1079,1008
10118,23,43,9550,568,10052,66,1.05435e+14,35.9452,466.022,10118,36,33,9989,9884,8480,8458,7370
7392,1284,1458,0,7392,0,7392,1.59862e+18,397.17,2719.32,7392,193,263,5934,5934,5797,5766,5662
3832,1002,1494,3832,0,3045,787,3.20872e+18,142.194,2100.98,3832,194,165,2338,2334,2239,2253,1786
11472,1606,1726,5524,5948,0,11472,5.18431e+18,871.15,3612.55,11472,293,270,9746,8830,8913,8841,9371
38266,1275,2737,31925,6341,20084,18182,7.27561e+17,1686.87,7772.06,38266,597,420,32746,28438,25838,25459,22708
37968,1057,1511,13401,24567,0,37968,3.79468e+13,1121.64,5692.39,37968,487,372,35416,31760,24944,24623,28138
13014,751,1460,0,13014,4630,8384,9.4454e+15,646.959,3203.34,13014,329,246,11289,10621,7959,6501,8206
46865,251,2363,46865,0,38170,8695,3.05768e+18,1766.73,8452.98,46865,592,479,32264,26782,12036,10230,6355
8526,1640,1806,4355,4171,4355,4171,4.83478e+18,426.706,3085.99,8526,315,221,6720,6554,6214,6280,6258
29838,2075,2305,29838,0,24302,5536,3.11518e+18,1581.23,6691.33,29838,523,406,27533,27420,27070,27104,27134
5542,1495,1677,4668,874,2992,2550,7.06258e+17,269.549,2523.02,5542,239,189,3865,3857,3781,3728,3695
10330,37,349,0,10330,9780,550,2.69118e+16,161.058,1302.11,10330,85,88,9491,8994,6766,5671,3698
5788,1356,1421,0,5788,0,5788,2.48486e+18,164.119,2278.03,5788,202,160,4367,4367,4367,4367,3445
1204,191,333,398,806,0,1204,3.81148e+13,82.8646,548.574,1204,100,88,871,861,571,731,647
5730,1026,1487,3030,2700,0,5730,5.23719e+18,248.803,2400.26,5730,242,170,4243,4196,3864,3870,3235
9113,4,350,0,9113,8675,438,2.55243e+16,145.635,1218.05,9113,81,81,5895,4660,4479,4045,2689
1970,312,748,950,1020,950,1020,5.44231e+18,91.0858,1089.65,1970,125,112,1222,1220,1026,935,755
36295,366,1534,12859,23436,0,36295,3.85668e+13,1080.49,5590.17,36295,446,370,30719,28013,12957,11623,8693
43951,640,1680,0,43951,15601,28350,9.67865e+15,1170.99,6229.1,43951,560,385,38775,35606,21909,14454,17544
34604,1642,1774,0,34604,0,34604,2.53795e+18,1399.62,6323.43,34604,483,406,32803,28185,29747,27827,32165
16599,1759,1998,8890,7709,0,16599,5.04e+18,986.802,4425.1,16599,354,293,14601,13282,13196,12945,13441
36933,208,344,0,36933,34798,2135,2.74316e+16,296.89,2499.35,36933,144,156,35934,35087,31344,28163,27446
19453,188,1482,0,19453,6865,12588,9.60086e+15,919.338,4043.15,19453,363,292,15645,14287,6342,4631,3473
26837,212,1710,0,26837,9490,17347,9.50276e+15,1040.49,4904.65,26837,464,319,21839,20050,9062,5939,5289
33736,1092,2538,33736,0,27836,5900,3.08151e+18,1748.7,7291.61,33736,554,428,28060,24037,21236,19978,17452
4146,5,42,3893,253,4144,2,1.07879e+14,25.3951,291.711,4146,29,26,3497,3165,2590,2661,1629
21500,982,2346,21500,0,17651,3849,3.13713e+18,1399.8,5707.23,21500,463,362,17293,15086,12252,11739,10455
17998,29,348,0,17998,17134,864,2.57435e+16,249.656,1708.53,17998,106,105,16367,15436,11730,10333,6163
7707,767,1659,3551,4156,0,7707,5.01141e+18,453.211,2889.02,7707,266,210,6048,5621,3709,3349,3706
26619,1285,1998,13390,13229,13390,13229,4.95336e+18,1294.09,5678.76,26619,436,363,23862,20923,15612,15070,19068
35164,29,359,0,35164,33532,1632,2.52522e+16,289.142,2392.91,35164,133,143,32116,30338,23118,20595,13414
2606,163,382,2573,33,2606,0,4.56601e+18,149.711,852.469,2606,84,80,2181,1957,1242,1250,1099
25343,1388,1848,12471,12872,12471,12872,5.00906e+18,1276.87,5456.85,25343,420,370,22985,20026,16336,15224,19778
24810,1437,1713,11788,13022,0,24810,5.11715e+18,1288.49,5292.15,24810,421,365,22643,19549,17371,16397,20608
17927,364,2154,0,17927,0,17927,2.44993e+18,1053.17,4838.7,17927,380,306,13864,12247,4704,3427,3465
10217,150,698,10044,173,10217,0,4.70638e+18,322.645,1984.67,10217,162,140,8843,7357,4434,4391,2895
1229,22,235,1229,0,1229,0,5.08941e+18,120.113,486.893,1229,59,61,520,196,166,124,108
20860,465,1571,7410,13450,0,20860,3.74255e+13,880.626,4159.5,20860,408,286,17874,16588,10629,8860,7318
7579,177,348,0,7579,7219,360,2.54803e+16,75.5403,1108.47,7579,79,82,7231,7153,6605,6286,5285
10145,700,2030,10145,0,8272,1873,3.03035e+18,848.746,3767.41,10145,247,266,7547,6583,4771,4333,3760
28472,33,43,27115,1357,27759,713,1.00037e+14,38.954,765.099,28472,41,38,28373,28294,26449,26459,24107
19562,156,337,0,19562,18437,1125,2.75457e+16,255.622,1797.61,19562,112,119,18837,18430,15716,13863,11658
43236,410,2505,34995,8241,20778,22458,8.09254e+17,1828.61,8355.14,43236,579,461,31699,26200,14642,15758,9400
40980,90,356,0,40980,39045,1935,2.53662e+16,297.872,2577.93,40980,138,149,39314,38587,30941,27146,20189
47902,496,1940,17025,30877,0,47902,3.72062e+13,1177.81,6649.11,47902,644,385,41554,38041,21867,18550,16391
974,287,450,0,974,366,608,1.00987e+16,46.8778,610.76,974,128,83,524,523,389,388,330
46930,1099,1759,16608,30322,0,46930,3.76784e+13,1144.96,6483.25,46930,537,380,44062,39543,29567,29496,36420
26522,190,803,25916,606,26522,0,4.59122e+18,491.399,3245.55,26522,240,204,23985,21424,11556,11172,6987
40000,779,1323,13961,26039,0,40000,3.85133e+13,1057.72,5569.4,40000,464,370,36459,32874,23079,22675,26793
7867,1200,1722,4071,3796,4071,3796,5.02829e+18,385.241,2953.05,7867,221,218,6145,5952,4960,4653,4966
39174,38,42,37014,2160,38744,430,1.07017e+14,40.0056,897.076,39174,42,42,39108,39066,38603,38600,36550
37437,1257,2804,31394,6043,19848,17589,7.11945e+17,1672.86,7708.08,37437,631,413,32065,27690,25130,24737,23154
11013,1270,2185,11013,0,8944,2069,3.03936e+18,899.268,4002.14,11013,324,276,8765,7783,7560,7140,6382
28495,161,353,0,28495,26855,1640,2.72932e+16,293.177,2219.04,28495,131,140,27462,26822,22847,19847,16574
30628,959,1762,0,30628,10849,19779,9.50556e+15,1045.64,5232.48,30628,508,324,27701,25507,18391,14372,21575
43208,298,890,41944,1264,43208,0,4.56643e+18,577.611,4188.32,43208,297,240,40719,38636,24069,23209,18289
22249,142,1738,0,22249,0,22249,2.53562e+18,1244.56,5024.56,22249,387,346,15164,10416,4200,2587,2556
21974,161,352,0,21974,20904,1070,2.55649e+16,257.681,1883.4,21974,114,122,21263,20875,18367,16063,13162
46474,1192,2366,37854,8620,23024,23450,7.97622e+17,1771.84,8423.41,46474,606,468,39706,33635,29743,29172,27931
18950,48,350,0,18950,18127,823,2.46518e+16,223.063,1712.38,18950,108,114,17880,17281,13610,12068,8959
11563,182,1306,0,11563,4034,7529,9.6851e+15,649.515,2981.84,11563,278,247,9208,8358,3323,3037,2405
29839,1620,1950,0,29839,0,29839,2.50816e+18,1340.73,5986.69,29839,444,385,27784,24030,22202,21337,25409
47394,6268,7356,39090,8304,22620,24774,7.93347e+17,1224.99,13396.2,47394,1042,597,40038,40026,38799,38577,37411
38998,1686,1839,0,38998,13829,25169,9.52331e+15,1120.5,5944.04,38998,580,357,37159,37159,36316,36039,37035
19998,946,2091,9916,10082,0,19998,5.08326e+18,1132.06,5065.24,19998,374,323,16869,15302,8796,7848,10456
30607,11,43,29177,1430,29772,835,9.87331e+13,38.6595,793.106,30607,41,38,29351,28421,23511,22921,14815
25460,18,42,24046,1414,25190,270,1.06653e+14,37.6552,718.402,25460,40,37,25007,24654,20511,20337,15522
38207,605,2160,38207,0,30569,7638,2.96572e+18,1710.11,7506.7,38207,509,452,29339,24367,14110,12322,12621
38466,888,1787,0,38466,13652,24814,9.54437e+15,1145.23,5884,38466,555,361,34803,31939,22251,15933,24656
15260,246,585,15131,129,15260,0,4.72912e+18,404.804,2316.36,15260,187,174,14139,13328,8334,8424,7531
4122,33,43,3917,205,4046,76,1.05024e+14,26.4512,307.292,4122,29,29,4074,4059,3871,3872,3720
13903,1225,1877,0,13903,0,13903,2.47171e+18,858.688,3956.36,13903,356,276,11881,10942,9006,8302,9322
35933,358,832,35083,850,35933,0,4.60891e+18,550.787,3797.51,35933,287,225,34163,32820,25397,24735,19632
13790,21,43,13008,782,13662,128,1.06487e+14,37.4429,544.325,13790,38,36,13589,13436,11392,11305,8558
847,17,342,450,397,450,397,5.42447e+18,81.2621,497.204,847,79,82,234,81,58,76,14
33053,700,2967,27848,5205,17767,15286,7.01103e+17,1480.68,7381.01,33053,556,419,26328,22904,16037,16249,10876
4984,246,1330,0,4984,0,4984,2.50408e+18,212.839,2138.24,4984,190,173,3589,3109,1400,1263,1060
38227,1186,2268,0,38227,0,38227,2.45693e+18,1426.09,6956.72,38227,545,415,34047,30133,20230,17742,23644
49016,1468,2539,25168,23848,0,49016,4.989e+18,1485.23,8062.39,49016,659,443,45489,39395,28341,25590,36307
14232,19,679,14034,198,14232,0,4.75082e+18,415.43,2357.91,14232,174,172,5828,2121,1812,1725,445
18098,417,2221,14941,3157,9192,8906,7.57387e+17,1332.46,5166.64,18098,380,323,13230,11499,6764,7103,3746
11142,345,756,10915,227,11142,0,4.68984e+18,337.119,2107.68,11142,205,142,10305,9933,7378,7334,5175
45555,1040,2755,37534,8021,23211,22344,7.63171e+17,1722.38,8552.68,45555,677,456,38129,32650,27619,26473,22034
7747,1360,1455,2744,5003,0,7747,3.71406e+13,214.281,2516.15,7747,266,203,6292,6292,6255,6282,6183
35729,917,2371,18787,16942,18787,16942,4.87446e+18,1399.35,6788.42,35729,578,390,30703,27506,16113,17495,16814
10593,30,43,10159,434,10182,411,9.42505e+13,30.7207,458.919,10593,34,32,10530,10503,9876,9811,8957
3359,114,398,3197,162,3359,0,4.56496e+18,110.087,924.904,3359,104,82,2805,2292,1722,1580,1156
38031,1230,2450,19993,18038,0,38031,4.96697e+18,1421.48,7046.99,38031,603,400,33900,30069,19307,17598,22448
42028,382,612,41644,384,42028,0,4.73011e+18,497.081,3863.99,42028,246,247,40539,39229,32138,31836,28138
8287,296,347,0,8287,7848,439,2.6851e+16,143.344,1184.08,8287,86,80,7940,7878,7745,7628,7450
3310,407,1039,1630,1680,0,3310,5.19448e+18,156.871,1589.59,3310,194,169,2271,2129,1599,1592,1148
47220,658,2898,47220,0,39432,7788,3.27333e+18,1778.18,8756.58,47220,715,467,37469,32149,22543,20721,14118
40302,609,1802,14347,25955,0,40302,3.71805e+13,1171.52,6005.88,40302,609,362,35496,32649,19404,17627,14146
18517,891,2135,9645,8872,9645,8872,4.94128e+18,1085.2,4822.28,18517,413,310,15510,13997,8372,8772,8544
41664,528,4307,0,41664,14674,26990,9.25203e+15,861.531,8966.61,41664,994,465,35223,32177,15453,13011,12354
40074,278,1594,14203,25871,0,40074,3.8135e+13,1114.02,5891.04,40074,477,379,33377,30555,14314,11404,8610
21737,84,1637,7723,14014,0,21737,3.73206e+13,914.96,4347.48,21737,425,292,16259,13647,7031,2332,1823
39103,1363,2594,32413,6690,20127,18976,7.5125e+17,1772.94,7849.34,39103,598,427,33849,29003,26979,26432,23065
7937,1604,1789,0,7937,0,7937,2.49653e+18,402.125,3024.7,7937,274,223,6148,6071,5958,5952,6036
41316,1105,1829,0,41316,14710,26606,9.59685e+15,1138,6106.24,41316,554,373,38446,34858,26397,19979,33614
32993,239,843,32149,844,32993,0,4.59369e+18,572.874,3669.98,32993,255,220,30454,28314,16286,14482,8502
30881,23,43,29442,1439,30047,834,9.86957e+13,38.8478,798.102,30881,41,39,30595,30341,26668,26597,21283
31665,1633,2667,26522,5143,16781,14884,7.1648e+17,1612.39,7025.33,31665,581,394,27965,23955,23174,23253,23072
29100,724,1521,0,29100,10295,18805,9.74038e+15,1035.23,4974.51,29100,417,335,25833,23674,15303,12001,16558
47234,13,44,44703,2531,46711,523,1.06616e+14,42.1705,1001.2,47234,44,44,45598,44557,35969,34903,24380
32587,1129,2737,26867,5720,16358,16229,7.61023e+17,1773.93,7428.75,32587,537,410,27133,23490,19226,18529,16552
27259,1023,1349,9635,17624,0,27259,3.86012e+13,1034.37,4695.22,27259,404,335,25119,22588,18329,16821,20806
36382,1427,1708,12914,23468,0,36382,3.72288e+13,1098.22,5616.93,36382,536,350,34674,32876,30153,30190,33401
19472,1914,2504,19472,0,16284,3188,3.27535e+18,1286.85,5480.61,19472,446,325,16951,14851,16409,16154,15047
4032,440,462,4013,19,4032,0,4.83068e+18,189.507,1117.22,4032,98,99,3570,3570,3568,3569,3562
39132,1854,3497,39132,0,32943,6189,3.06253e+18,1826.7,8563.92,39132,700,421,35084,30022,32526,33350,25776
9574,1316,1520,0,9574,3407,6167,9.40218e+15,468.181,2860.88,9574,301,201,8054,7815,7560,7326,7702
16559,218,801,16024,535,16559,0,4.53042e+18,391.349,2560.88,16559,201,162,15091,13947,8456,8432,6049
12844,7,350,0,12844,12258,586,2.53975e+16,178.23,1424.71,12844,100,97,9808,8353,7210,6322,4136
39010,114,846,38575,435,39010,0,4.70978e+18,571.439,4088.8,39010,292,246,31517,22946,12854,12159,6825
43648,858,903,42822,826,43648,0,4.61047e+18,537.987,4242.17,43648,296,252,42745,42745,42716,42721,42706
48653,591,608,48203,450,48653,0,4.73401e+18,516.022,4162.94,48653,268,255,48045,48045,47852,47895,48000
18890,234,2057,0,18890,0,18890,2.45839e+18,1159.32,4825.3,18890,406,314,14103,12148,4803,2091,2480
21826,1438,1464,7743,14083,0,21826,3.79776e+13,964.696,4300.45,21826,382,305,20362,20362,20306,20330,20282
35076,5,42,33262,1814,34642,434,1.06416e+14,39.2583,843.479,35076,41,40,29722,26656,22671,22858,14709
36130,756,1560,12814,23316,0,36130,3.81021e+13,1083.14,5559.13,36130,455,359,32351,29574,19787,17419,22999
38220,1019,1760,0,38220,13530,24690,9.54082e+15,1101.82,5809.19,38220,559,352,35190,32131,23950,18607,28196
19870,187,1677,0,19870,0,19870,2.53236e+18,1173.11,4691,19870,381,323,14173,11006,3863,2563,2904
45820,707,1954,22288,23532,22288,23532,4.9592e+18,1469.71,7418.26,45820,564,447,38447,33380,16509,16667,20762
49721,1605,2951,26667,23054,26667,23054,4.92528e+18,1430.87,8421.02,49721,681,465,46492,40309,28632,28549,34353
15986,1502,1825,0,15986,0,15986,2.47898e+18,1087.92,4340.86,15986,340,306,14018,12499,10959,10700,12659
24009,33,2081,19219,4790,11393,12616,8.35822e+17,1491.56,5865.84,24009,432,367,8898,3936,2267,2255,270
17813,764,1652,6337,11476,0,17813,3.66302e+13,715.122,3821.7,17813,406,257,15588,14705,11133,10604,11573
13344,234,1862,0,13344,0,13344,2.49084e+18,854.171,3930.9,13344,311,280,9930,8720,3725,2201,2086
30075,434,3058,26064,4011,17160,12915,6.20775e+17,1402.36,6940.01,30075,618,346,23347,20791,13368,14377,7696
27260,1556,1708,9620,17640,0,27260,3.69315e+13,1044.99,4938.04,27260,486,321,25552,25552,24994,25192,25422
18285,157,1700,0,18285,0,18285,2.52133e+18,1119.22,4502.55,18285,358,324,12765,9114,3629,2245,2116
30479,273,364,0,30479,28674,1805,2.72897e+16,294.233,2317.78,30479,137,147,29840,29127,26853,24895,24048
49879,455,2186,49879,0,39965,9914,3.03294e+18,1816.17,8619.89,49879,560,491,36755,30563,15398,12663,11849
38736,2,43,36748,1988,38045,691,1.03126e+14,41.2942,901.315,38736,43,42,23249,18781,17685,18943,13796
33051,25,1538,11722,21329,0,33051,3.80569e+13,1085.3,5306.7,33051,456,351,18683,13575,7779,2794,851
26396,1773,2103,0,26396,0,26396,2.47369e+18,1294.99,5678.08,26396,466,361,24293,21573,20781,19962,21998
40345,242,1829,0,40345,14301,26044,9.54826e+15,1134.55,6045.82,40345,559,363,33438,30859,14294,8956,7762
26816,104,354,0,26816,25437,1379,2.62424e+16,279.28,2133.49,26816,127,134,25669,25155,20313,17520,14545
40162,640,937,39183,979,40162,0,4.60257e+18,535.219,4073.98,40162,304,232,39212,38626,35938,35750,34534
48844,2323,2450,39737,9107,24199,24645,7.96203e+17,1759.99,8679.71,48844,594,471,46394,46381,46175,46021,46089
17476,681,1582,0,17476,6179,11297,9.43782e+15,870.818,3888.21,17476,395,270,15187,14080,9516,6678,8140
43574,728,1852,15501,28073,0,43574,3.7261e+13,1133.49,6236.41,43574,583,371,39030,35834,23704,21232,25273
16189,775,1985,8585,7604,0,16189,5.01874e+18,993.424,4372.47,16189,383,301,13337,12136,7696,7147,6997
47111,1484,2514,0,47111,0,47111,2.43796e+18,1468.55,7850.27,47111,636,442,43569,37971,27956,24343,33590
24477,586,1718,11538,12939,11538,12939,4.99073e+18,1295.73,5266.92,24477,416,362,19794,17199,8486,7972,9342
49796,1750,2444,40325,9471,24385,25411,8.05837e+17,1721.43,8734.07,49796,597,475,46298,38090,38120,37045,41939
47312,11,43,45119,2193,46023,1289,9.89556e+13,41.0464,988.161,47312,43,41,45363,43926,36249,35370,25700
8425,1013,1834,0,8425,0,8425,2.42652e+18,389.932,3091.57,8425,311,207,6591,6384,4834,4676,3916
20621,57,2568,17056,3565,10418,10203,7.60546e+17,1443.03,5741.72,20621,494,339,10402,6412,4208,4526,455
10933,478,714,10720,213,10933,0,4.64337e+18,371.121,2078.32,10933,193,143,10219,9970,9515,9485,7789
7127,206,2021,5952,1175,3725,3402,7.16763e+17,357.869,3109.35,7127,259,192,4698,3861,2370,2522,820
7313,1660,1792,3713,3600,3713,3600,4.91963e+18,279.608,2907.97,7313,244,179,5521,5493,5516,5514,5304
4109,453,990,2496,1613,2496,1613,5.32223e+18,124.525,1617.82,4109,197,144,3119,3073,2754,2571,1321
35856,1128,1908,17689,18167,0,35856,5.0653e+18,1419.5,6539.84,35856,496,409,31854,27960,19579,16775,22603
8612,26,43,8247,365,8310,302,9.58299e+13,24.9627,418.213,8612,33,32,8544,8514,7775,7771,7000
4780,1471,1576,4780,0,3949,831,3.37443e+18,182.742,2304.97,4780,249,168,3204,3204,3204,3204,3149
27338,325,356,0,27338,26025,1313,2.58731e+16,272.762,2119.05,27338,125,133,26929,26382,26166,25452,25877
31761,1296,2352,31761,0,25963,5798,3.13997e+18,1619.85,6944.24,31761,507,426,27375,23291,22210,21254,19698
42283,48,756,41485,798,42283,0,4.66606e+18,564.608,4047.08,42283,287,238,27141,15967,10469,9223,3440
26593,265,1730,9450,17143,0,26593,3.75563e+13,972.805,4849.57,26593,427,314,22160,20505,10393,8513,5377
46046,1421,1748,16352,29694,0,46046,3.77114e+13,1137.22,6384.79,46046,537,379,44298,44198,37641,38557,43142
28415,432,2493,23699,4716,14966,13449,7.28083e+17,1488.27,6522.3,28415,507,376,21552,18949,11399,12066,5728
35242,313,921,34193,1049,35242,0,4.55767e+18,539.712,3809.01,35242,278,222,33268,31679,21853,21182,15609
17776,1096,2044,14246,3530,8406,9370,8.35722e+17,1396.88,5046.46,17776,381,340,14323,12208,10195,9951,9093
47714,3,351,0,47714,45227,2487,2.63863e+16,306.381,2837.02,47714,153,165,26859,20567,19421,17639,12830
20780,1180,2159,11297,9483,0,20780,5.0279e+18,1102.41,5016.07,20780,416,308,18151,16379,12420,11135,11978
11198,1608,2311,9248,1950,5637,5561,7.53825e+17,860.086,4087.1,11198,352,277,8887,8068,7659,7503,6958
42728,1829,2954,35706,7022,22396,20332,7.24096e+17,1747.46,8379.22,42728,656,440,39093,32902,31804,31427,32050
6421,477,1920,5270,1151,3244,3177,7.7374e+17,228.491,2911.47,6421,232,182,4501,4163,2884,2903,1516
19135,1425,2038,0,19135,0,19135,2.43473e+18,1045.33,4745.95,19135,422,297,16878,15235,12545,11465,12554
15164,373,1368,0,15164,5318,9846,9.65004e+15,781.834,3495.81,15164,340,266,12679,11724,6491,4849,5859
15797,1537,2172,15797,0,12920,2877,3.08931e+18,1197.84,4793.93,15797,325,301,13242,11609,12464,12070,11042
11920,683,1297,4245,7675,0,11920,3.90017e+13,720.761,3063.6,11920,267,249,10120,9481,6643,6536,6847
19573,2949,5382,13826,5747,12116,7457,3.68632e+18,350.887,8416.56,19573,795,401,14191,14191,9129,9505,8095
35970,1550,1768,12756,23214,0,35970,3.72593e+13,1121.19,5692.89,35970,524,350,34202,34202,31666,32039,33772
49584,1286,2528,26033,23551,26033,23551,4.94515e+18,1500.97,8082.18,49584,643,446,45040,39406,25978,26881,31917
48464,10,43,46094,2370,47365,1099,1.01244e+14,41.3415,1007.16,48464,43,42,45980,44206,36150,35422,24393
20516,900,2432,20516,0,16948,3568,3.29438e+18,1417.4,5614.44,20516,463,341,16300,14213,11209,10706,7585
39524,93,886,38465,1059,39524,0,4.59005e+18,575.558,4022.19,39524,297,232,31179,23112,13858,12328,5296
41775,135,2068,41775,0,33176,8599,3.01353e+18,1630.87,7647.62,41775,517,460,25164,15451,8391,7070,3511
30987,362,739,30679,308,30987,0,4.76957e+18,506.319,3490.34,30987,250,224,29549,28418,21362,21282,18870
16824,1789,1873,8376,8448,8376,8448,4.88801e+18,1065.64,4442.29,16824,388,303,14951,14949,14687,14585,14610
25256,25,43,24145,1111,24449,807,9.66487e+13,35.8811,714.328,25256,39,37,25077,24952,22490,22523,19167
31956,1594,1815,15121,16835,0,31956,5.14188e+18,1324.35,6084.97,31956,470,434,30112,27085,25829,25378,29603
39381,246,361,0,39381,37340,2041,2.62772e+16,311.54,2615.07,39381,146,156,38543,37709,34521,31840,29958
9394,229,343,0,9394,8935,459,2.56966e+16,149.505,1219.13,9394,80,79,9051,8947,8298,8136,7261
32654,922,2026,16085,16569,16085,16569,4.92333e+18,1362.76,6322.67,32654,477,396,28052,24852,14303,14358,17397
34542,29,43,32987,1555,33489,1053,9.76308e+13,39.5869,839.505,34542,42,39,34366,34251,31304,31262,28438
19557,587,755,18967,590,19557,0,4.54356e+18,433.129,2737.24,19557,236,182,18782,18378,17839,17863,16822
47888,1268,1887,16962,30926,0,47888,3.71551e+13,1158.79,6613.82,47888,627,377,45610,40790,32793,33196,41133
16789,349,351,0,16789,16005,784,2.5769e+16,234.118,1655.68,16789,103,105,16438,16438,16429,16426,16422
43769,478,935,42512,1257,43769,0,4.51216e+18,614.396,4280.81,43769,307,236,42229,40844,32940,32547,28837
2421,657,770,1226,1195,1226,1195,5.32201e+18,130.129,1193.84,2421,107,115,1651,1650,1646,1646,1554
22009,524,1835,10608,11401,0,22009,5.04352e+18,1220,5087.41,22009,407,345,17661,15618,7278,6394,8408
20878,271,1413,0,20878,7355,13523,9.72381e+15,930.488,4142.67,20878,348,300,17283,15857,7406,5381,5142
49520,30,43,47196,2324,48208,1312,9.90793e+13,41.9182,1014.71,49520,43,41,49285,49136,44618,44641,39344
35434,95,918,34584,850,35434,0,4.64117e+18,567.448,3846.47,35434,290,223,27946,20559,12198,11484,4717
38690,5147,5486,0,38690,13277,25413,8.90902e+15,548.705,9630.08,38690,885,528,33204,33204,32870,32373,32190
5383,680,1351,3107,2276,0,5383,5.23472e+18,178.14,2165.18,5383,205,152,4032,3918,3052,2857,1845
40568,235,354,0,40568,38577,1991,2.59098e+16,300.168,2596.31,40568,147,154,39708,38896,35643,32829,31170
28549,301,352,0,28549,27255,1294,2.49649e+16,263.561,2119.5,28549,123,129,28110,27598,26828,25586,26403
17823,1181,1323,6328,11495,0,17823,3.85538e+13,901.388,3771.19,17823,331,291,16397,14774,14208,14081,15527
17354,1432,1583,6167,11187,0,17354,3.74095e+13,883.095,3889.36,17354,375,273,15771,15042,14640,14794,15595
23234,803,851,22604,630,23234,0,4.58954e+18,460.841,3076.87,23234,242,189,22383,22382,22339,22351,21995
42108,1522,2535,42108,0,34472,7636,3.12721e+18,1738.78,8105.16,42108,603,457,37498,31528,33453,31071,27886
9523,1062,1819,4830,4693,0,9523,4.93857e+18,575.65,3290.3,9523,321,219,7704,7234,5602,5116,4781
2294,208,747,957,1337,957,1337,4.42778e+18,107.676,1137.04,2294,120,116,1546,1412,474,695,261
47052,266,2135,37682,9370,22343,24709,8.38247e+17,1759.25,8269.05,47052,556,470,32135,26312,13999,15504,5188
2155,78,167,0,2155,2017,138,2.60478e+16,40.3323,449.257,2155,44,45,1988,1960,1728,1697,1387
27527,1445,1692,0,27527,9736,17791,9.50933e+15,1039.59,4947.02,27527,463,324,25835,24633,23024,21794,25395
9091,1949,2057,9091,0,7404,1687,2.9709e+18,697.329,3569.98,9091,267,253,7034,6637,6984,6975,6777
10226,1105,1832,0,10226,0,10226,2.52229e+18,657.74,3420.74,10226,285,272,8394,7757,5817,5338,6416
9371,1060,1324,3320,6051,0,9371,3.82423e+13,477.103,2709.79,9371,254,187,8047,7633,6944,6949,7209
18434,1779,2291,18434,0,15178,3256,3.21116e+18,1223.01,5170.95,18434,379,335,15992,13955,15419,15153,14048
32277,1868,2288,0,32277,0,32277,2.49064e+18,1560.39,6739.3,32277,562,390,29822,25569,22627,20525,28187
8828,1811,1821,0,8828,0,8828,2.42121e+18,517.246,3176.68,8828,298,203,7007,6822,6998,6977,6998
30692,442,2195,16186,14506,0,30692,5.01779e+18,1326.62,6163.78,30692,536,379,24768,22065,10301,10220,8388
9590,146,346,0,9590,9215,375,2.36536e+16,84.6953,1173.19,9590,82,81,9244,9136,8316,7629,6592
40157,86,1872,0,40157,14248,25909,9.49796e+15,1135.22,6048.73,40157,595,363,30259,25630,12739,6616,3489
2808,24,29,2739,69,2609,199,8.28992e+13,14.797,197.044,2808,20,19,2779,2779,2708,2709,2569
8425,147,685,8184,241,8425,0,4.51624e+18,256.14,1777.39,8425,194,128,7308,6183,3708,3653,2718
18961,1961,2053,10202,8759,10202,8759,4.95009e+18,1077.62,4747.82,18961,406,301,16908,16904,16748,16637,16251
31844,2209,2498,16744,15100,0,31844,5.00451e+18,1295.68,6553.94,31844,506,389,29346,29343,28811,28433,28544
12800,20,43,12127,673,12583,217,1.02211e+14,37.2423,521.777,12800,36,35,12604,12465,10617,10504,7503
26699,86,347,0,26699,25331,1368,2.63466e+16,271.765,2105.34,26699,124,130,25484,24952,19670,17079,12235
10482,30,42,9906,576,10357,125,1.0548e+14,32.2157,459.054,10482,35,32,10420,10389,9681,9686,9023
47725,236,351,0,47725,45000,2725,2.73042e+16,313.418,2860.15,47725,158,167,46654,45537,41187,37332,37455
23158,80,2194,0,23158,0,23158,2.43956e+18,1183.94,5399.19,23158,448,338,14574,10549,5634,2041,759
6421,1293,2011,5145,1276,3000,3421,8.3207e+17,321.718,3022.32,6421,228,221,4410,4330,3701,3774,3274
2301,200,483,874,1427,0,2301,3.91595e+13,31.3994,795.532,2301,129,88,1818,1816,1675,1631,409
18881,346,800,18457,424,18881,0,4.56153e+18,452.36,2766.64,18881,237,177,17708,17008,11866,11045,10054
38742,758,2424,0,38742,0,38742,2.44002e+18,1410.12,7103.17,38742,593,409,32717,28946,13980,15104,13892
49003,84,2047,0,49003,17394,31609,9.51374e+15,1174.46,6838.04,49003,649,382,36630,30872,15448,7924,4680
21064,194,349,0,21064,19976,1088,2.63922e+16,258.451,1878.92,21064,117,120,20417,20025,18030,16637,15624
17914,1907,2170,9331,8583,9331,8583,4.90456e+18,1083.11,4792.18,17914,390,307,15744,15734,14456,14292,15028
15631,2261,2434,15631,0,13129,2502,3.10194e+18,1140.17,4871.89,15631,425,311,13197,13197,13160,13196,13182
6367,1527,1872,6367,0,5356,1011,3.41534e+18,338.261,2850.47,6367,283,201,4495,4414,4468,4483,4345
30015,1349,1526,0,30015,10631,19384,9.70164e+15,1046.37,5051.38,30015,419,335,28489,27035,25655,24253,27866
3402,607,826,1173,2229,0,3402,3.64502e+13,95.0288,1375.35,3402,160,130,2576,2576,2293,2255,2241
30955,38,43,29568,1387,30052,903,9.78232e+13,40.0711,796.919,30955,41,38,30891,30859,30440,30504,29200
18863,330,597,18671,192,18863,0,4.76809e+18,435.277,2585.77,18863,187,189,17864,17222,12660,12803,10989
18042,27,43,17106,936,17696,346,1.02453e+14,35.7832,609.086,18042,38,35,17915,17845,16167,16204,14159
4069,393,1435,3263,806,1899,2170,8.06749e+17,195.809,2115.41,4069,173,154,2634,2401,1596,1606,1180
16697,939,2000,0,16697,0,16697,2.4449e+18,983.419,4437.73,16697,362,294,13976,12796,8919,8060,8590
16846,1309,1996,0,16846,0,16846,2.4161e+18,1031.9,4483.51,16846,420,298,14529,13159,10324,9650,10866
41114,23,43,39308,1806,39801,1313,9.64908e+13,38.3388,912.661,41114,42,40,40760,40441,35794,35699,28219
28596,467,706,28064,532,28596,0,4.73949e+18,512.774,3297.03,28596,237,217,27598,26829,23888,23925,21443
40253,15,43,38377,1876,39198,1055,9.87505e+13,39.8776,909.57,40253,42,40,39308,38608,32001,31208,24076
11195,481,1824,5436,5759,5436,5759,4.84922e+18,829.258,3623.53,11195,326,246,8662,7730,3598,3500,2946
22983,75,1672,8179,14804,0,22983,3.70736e+13,961.334,4468.78,22983,437,301,17014,14472,7233,3244,1613
27920,359,672,27520,400,27920,0,4.65003e+18,502.568,3232.92,27920,234,216,26610,25676,19160,19097,16041
3381,804,889,0,3381,1195,2186,9.51684e+15,107.846,1396.95,3381,182,134,2492,2492,2422,2303,2337
10052,1199,1864,5629,4423,5629,4423,5.04685e+18,465.206,3308.62,10052,261,218,8188,7813,6773,6282,6113
37073,890,2158,37073,0,29694,7379,2.96112e+18,1673.79,7373.02,37073,497,442,29910,25329,17601,17176,16625
37732,320,895,36604,1128,37732,0,4.56214e+18,543.897,3910.44,37732,284,231,35695,34070,23923,22085,18067
14646,1528,2021,7870,6776,7870,6776,4.97134e+18,869.69,4168.68,14646,353,280,12625,11557,10247,9879,10417
13059,1569,1685,6235,6824,0,13059,5.13543e+18,946.213,3815.38,13059,310,289,11341,10197,10684,10550,11016
48571,1733,2748,0,48571,0,48571,2.43477e+18,1485.34,8204.38,48571,704,442,45786,39613,30812,27316,38064
48356,1673,2933,40410,7946,25374,22982,7.24393e+17,1814.9,8911.36,48356,675,466,43713,36961,35318,35449,31842
36711,324,349,0,36711,34730,1981,2.66632e+16,302.225,2494.01,36711,139,150,36281,35373,35294,35112,34865
14863,393,671,14563,300,14863,0,4.57352e+18,407.433,2360.96,14863,175,162,14037,13634,11212,11330,10401
15779,426,1999,0,15779,0,15779,2.45086e+18,968.974,4351.1,15779,390,296,12487,11202,6041,4294,4174
48106,354,2542,0,48106,0,48106,2.43895e+18,1463.25,7939.21,48106,636,441,38227,34376,13964,8631,8176
17094,2094,2121,8827,8267,0,17094,4.96736e+18,1051.33,4638.39,17094,414,304,14973,14973,14948,14931,14973
1775,465,652,778,997,778,997,4.56536e+18,79.9685,959.308,1775,106,101,1123,1121,938,880,706
22441,1831,2031,0,22441,8021,14420,9.90983e+15,733.11,4844.47,22441,437,308,20410,20410,19648,19210,20286
14597,1912,2036,14597,0,11623,2974,3.02946e+18,1256.16,4561.56,14597,331,310,12527,10828,12431,12433,12251
11307,1288,2117,9375,1932,5864,5443,7.37905e+17,896.443,3962.33,11307,328,276,9160,8167,7345,7312,6984
1962,192,360,0,1962,735,1227,9.92059e+15,25.1865,602.154,1962,106,64,1602,1600,1546,676,462
23590,1981,1988,12003,11587,0,23590,5.0823e+18,1243.09,5350.91,23590,413,347,21602,21602,21587,21451,21602
12911,399,634,12711,200,12911,0,4.67521e+18,382.398,2184.97,12911,181,163,12156,11835,10188,10049,9050
30949,584,2305,16446,14503,16446,14503,4.90735e+18,1358.39,6279.01,30949,542,368,25411,22615,10546,12409,9314
46568,17,43,44173,2395,45702,866,1.02791e+14,40.5635,985.211,46568,43,42,45642,44890,37361,37040,27713
46297,27,356,0,46297,44122,2175,2.52748e+16,304.264,2741.24,46297,145,159,42037,39629,30304,26403,16493
16473,783,1295,0,16473,5830,10643,9.91517e+15,841.047,3590.24,16473,327,285,14576,13381,9935,8183,10854
29263,2343,2454,24131,5132,14975,14288,7.62727e+17,1556.58,6696.88,29263,490,389,26809,26809,26471,26408,26371
13392,1367,1962,0,13392,0,13392,2.42057e+18,911.719,4031.5,13392,348,285,11359,10313,8225,8069,9141
4932,779,933,0,4932,1781,3151,1.00177e+16,146.032,1632.35,4932,225,137,3999,3999,3858,3891,3755
23295,33,43,22097,1198,22871,424,1.04011e+14,38.1561,697.893,23295,40,38,23202,23139,21536,21566,20444
9550,184,652,9276,274,9550,0,4.55128e+18,302.797,1866.71,9550,177,139,8511,7683,4500,4499,3444
22570,262,348,0,22570,21418,1152,2.61509e+16,255.729,1932.21,22570,121,129,22061,21648,20165,19306,18400
22080,1126,2219,22080,0,18149,3931,3.1107e+18,1465.45,5716.69,22080,433,374,18145,15689,14155,13439,12098
40153,40,43,38177,1976,39205,948,1.00588e+14,40.9924,914.305,40153,43,41,40092,40060,39958,39958,38945
49117,1536,2777,25667,23450,25667,23450,4.97997e+18,1397.16,8288.26,49117,603,445,45887,39822,29037,27518,33890
39568,720,2230,20039,19529,20039,19529,4.93223e+18,1442.91,7120.52,39568,533,423,33189,28934,14115,15430,15330
12213,1093,1963,6208,6005,0,12213,4.90902e+18,828.092,3832.38,12213,344,247,10124,9242,6704,6238,6878
16078,1419,2108,8417,7661,8417,7661,4.88411e+18,958.989,4502.48,16078,393,294,13775,12576,10688,10526,10732
5935,1242,1569,2945,2990,2945,2990,4.88981e+18,198.395,2492.79,5935,215,176,4366,4363,3744,3731,3772
5867,318,568,5742,125,5867,0,4.59515e+18,220.858,1431.82,5867,130,113,5299,5157,4296,4319,3716
28675,1270,1709,10211,18464,0,28675,3.73723e+13,1035.71,5035.64,28675,476,328,26776,24252,20828,20711,24125
26406,14,42,24920,1486,26107,299,1.0716e+14,39.3531,738.229,26406,40,38,25597,25012,20346,19800,14826
29200,389,3818,14130,15070,6641,22559,1.11863e+17,330.492,7000.01,29200,546,344,25063,23926,15059,10090,6328
30927,1880,2227,0,30927,0,30927,2.44539e+18,1341.75,6226.2,30927,510,371,28700,28578,25157,24617,26757
35184,382,1778,0,35184,12508,22676,9.51497e+15,1155.44,5616.42,35184,546,344,29851,27444,13238,8896,7039
39416,529,604,39032,384,39416,0,4.71407e+18,503.961,3749.6,39416,251,248,38715,37662,36849,36982,35986
41243,1145,2489,21438,19805,21438,19805,4.90054e+18,1460.3,7396.75,41243,615,415,36620,32411,19691,21392,23681
42086,331,1857,0,42086,0,42086,2.50482e+18,1419.85,7015.84,42086,522,436,32638,28791,9397,6818,6852
25941,159,1347,9206,16735,0,25941,3.88483e+13,1017.54,4579.91,25941,389,332,20390,18297,7307,4081,3549
10136,448,1933,5108,5028,5108,5028,4.82628e+18,646.402,3491.01,10136,321,229,7783,7012,3560,3681,3199
19300,210,353,0,19300,18211,1089,2.72961e+16,258.736,1823.14,19300,113,122,18675,18298,16441,15006,13748
33130,7,660,32811,319,33130,0,4.76639e+18,496.331,3495.92,33130,240,234,7603,1416,1432,1723,415
37575,331,1542,0,37575,13298,24277,9.73188e+15,1122.55,5664.02,37575,473,366,31581,28822,13770,9749,9383
49026,61,348,0,49026,46219,2807,2.73042e+16,311.457,2883.46,49026,154,171,46089,44541,32213,27768,18687
44992,523,2650,0,44992,0,44992,2.44287e+18,1447.07,7849.62,44992,624,453,36876,32768,15006,15291,12934
31433,1693,2303,16657,14776,0,31433,4.98899e+18,1344.2,6319.1,31433,539,384,29054,25509,21931,20600,23934
45969,69,626,45475,494,45969,0,4.75291e+18,521.005,4080.4,45969,260,254,32186,19707,11966,11751,4950
957,260,378,449,508,0,957,5.24666e+18,82.2874,552.182,957,75,74,579,552,513,517,510
41679,1683,2139,14599,27080,0,41679,3.78031e+13,1249.67,6816.16,41679,639,382,39540,39512,31941,33376,38604
6640,1278,1292,2369,4271,0,6640,3.68882e+13,176.331,2226.18,6640,227,167,5348,5348,5348,5348,5343
34909,1127,2058,17550,17359,17550,17359,4.95016e+18,1368.85,6554.17,34909,527,407,30860,27308,17765,17200,21589
49619,271,613,49142,477,49619,0,4.74557e+18,518.441,4213.34,49619,264,263,46837,44285,28618,28486,23698
37429,330,2158,0,37429,0,37429,2.47075e+18,1414.28,6886.13,37429,518,417,29046,25877,9591,6660,8428
21329,74,1889,0,21329,0,21329,2.48514e+18,1216.53,5038.45,21329,397,338,12747,8716,4456,2311,1193
3882,256,464,3872,10,3882,0,4.78879e+18,183.337,1091.43,3882,115,97,3418,3284,2318,2357,2414
15848,1596,1949,0,15848,0,15848,2.47044e+18,989.018,4334.66,15848,345,294,13841,12530,11519,11204,12154
20108,2423,2425,20108,0,16636,3472,3.28185e+18,1413.41,5550.27,20108,465,337,17683,17683,17683,17683,17683
39074,584,4143,18469,20605,514,38560,4.86438e+18,1104.08,9024.66,39074,901,426,31141,27064,7066,8348,532
38054,987,2087,30475,7579,18103,19951,8.39157e+17,1697.93,7385.34,38054,523,438,31272,26324,21532,20259,17582
47561,4,374,0,47561,45153,2408,2.60636e+16,311.239,2897.5,47561,152,162,30300,23821,22270,20021,13425
17888,306,350,0,17888,16975,913,2.60468e+16,254.924,1721.29,17888,104,106,17499,17162,16825,16075,16451
1012,288,404,823,189,458,554,7.61532e+17,91.3083,595.832,1012,88,80,608,592,558,546,534
30629,194,356,0,30629,29098,1531,2.59633e+16,286.159,2276.63,30629,133,142,29785,29127,26093,23488,20709
41179,1027,1628,14583,26596,0,41179,3.8021e+13,1126.7,6006.12,41179,495,375,38372,34498,25660,25819,28246
5085,631,1431,2583,2502,2583,2502,4.83789e+18,204.642,2233.07,5085,217,184,3654,3510,2170,2475,2113
15130,1562,2015,0,15130,0,15130,2.4609e+18,889.375,4216.58,15130,385,277,13115,12076,10833,10455,11248
25451,1490,2594,21202,4249,13266,12185,7.30587e+17,1549.17,6310.91,25451,542,371,21815,18950,17615,17682,14415
23572,15,43,22220,1352,23361,211,1.06276e+14,40.2805,713.274,23572,41,39,22890,22415,18328,17683,13655
27862,1602,1970,14508,13354,0,27862,5.07391e+18,1317.54,5741.17,27862,452,361,25715,22521,20413,19466,23945
35844,160,594,35466,378,35844,0,4.76656e+18,499.163,3565.02,35844,238,237,31788,27251,14814,14835,10512
1611,645,665,1611,0,1236,375,3.0294e+18,71.4153,935.155,1611,103,96,946,946,946,946,946
5685,43,1558,2773,2912,0,5685,5.26179e+18,251.503,2478.74,5685,227,186,2654,1517,722,588,185
48527,1069,2177,24242,24285,24242,24285,4.96515e+18,1476.51,7819.15,48527,558,453,42920,37825,23139,23849,29244
36277,32,43,34465,1812,35507,770,1.01737e+14,40.1661,869.036,36277,42,41,36130,36017,33289,33358,30532
14112,1287,2359,14112,0,11840,2272,3.33405e+18,1016.52,4572.27,14112,397,294,11346,10214,10151,9423,8500
35977,1057,1807,12739,23238,0,35977,3.71076e+13,1133.79,5714.11,35977,544,347,33187,30095,22425,22444,22994
34741,638,798,34307,434,34741,0,4.70984e+18,555.411,3818.13,34741,265,239,33942,33093,31706,31901,31039
24358,727,1648,8695,15663,0,24358,3.75115e+13,996.398,4610.99,24358,426,313,21440,19812,13365,12376,14104
44384,1540,1888,15811,28573,0,44384,3.75037e+13,1140.25,6377.6,44384,584,381,42496,42496,37712,38345,41550
948,378,492,487,461,487,461,5.96743e+18,41.5738,629.13,948,83,95,456,456,449,449,373
5754,62,309,0,5754,5482,272,2.6023e+16,75.987,946.802,5754,66,67,5379,5252,4212,3946,2782
19644,1333,1580,0,19644,6999,12645,9.67318e+15,854.705,4054.6,19644,397,284,18059,16630,15816,14029,17405
3526,26,42,3326,200,3515,11,1.11281e+14,27.4336,281.69,3526,29,27,3470,3454,3082,3083,2724
12833,315,2318,12833,0,10631,2202,3.32212e+18,989.187,4374.08,12833,381,286,9042,7669,4487,3216,2277
26625,185,1679,0,26625,9329,17296,9.77784e+15,1019.11,4978.11,26625,464,338,21106,18868,7667,6296,4439
21159,888,1343,7457,13702,0,21159,3.83951e+13,948.307,4129.42,21159,358,307,19016,17283,13166,12903,15065
31482,1701,1999,15901,15581,15901,15581,4.97965e+18,1398.04,6209.54,31482,476,390,29440,25707,24441,23797,27970
10234,1,43,9828,406,9831,403,9.37336e+13,26.1224,447.981,10234,33,32,3945,3945,3945,3945,3945
12519,159,1914,6676,5843,6676,5843,5.04345e+18,808.136,3836.08,12519,308,276,8936,6687,3371,3413,1349
19899,372,770,19272,627,19899,0,4.51796e+18,446.786,2765.11,19899,261,184,18823,18223,13618,13791,11766
21316,682,834,20653,663,21316,0,4.49766e+18,445.536,2920.14,21316,242,189,20482,20478,19805,19870,18800
7531,212,658,7320,211,7531,0,4.64083e+18,251.224,1674.41,7531,178,123,6731,6193,4055,3893,2891
48101,1337,2561,25435,22666,25435,22666,4.91843e+18,1509.33,7977.22,48101,673,431,43720,38241,25416,25986,31834
4222,1260,1316,1896,2326,1896,2326,4.60187e+18,204.342,1989.66,4222,234,140,2906,2906,2886,2859,2878
2829,475,665,0,2829,1025,1804,1.04952e+16,131.484,1127.88,2829,112,114,2164,2121,2044,1828,1954
5613,42,43,5399,214,5387,226,9.543e+13,26.517,341.622,5613,30,27,5570,5569,5570,5569,5565
11016,1176,2121,9204,1812,5740,5276,7.1739e+17,857.848,3917.96,11016,321,271,8822,7835,6721,6785,6350
18636,492,1946,0,18636,0,18636,2.43151e+18,1109.38,4709.87,18636,395,316,14864,13278,6115,5381,5475
21375,1751,1797,0,21375,0,21375,2.51468e+18,1212.56,4981.53,21375,379,348,19578,19572,19504,19282,19548
34043,1287,1338,11987,22056,0,34043,3.87445e+13,1061.72,5196.36,34043,444,362,32705,32704,32403,32537,32395
29422,3046,4362,10192,19230,0,29422,3.35257e+13,459.219,7691.94,29422,829,366,25060,25034,20063,20837,18788
32496,926,2315,17206,15290,0,32496,5.00261e+18,1374.62,6437.59,32496,540,385,27898,25015,15004,14167,15549
2556,481,846,1032,1524,1032,1524,4.1226e+18,121.001,1266.26,2556,127,114,1710,1682,1190,1368,1243
33493,1984,2101,0,33493,0,33493,2.45819e+18,1365.54,6429.09,33493,494,396,31392,31392,30847,30255,31362
9960,937,1811,0,9960,0,9960,2.51263e+18,662.191,3408.26,9960,296,229,8149,7410,4888,4480,5516
21401,386,840,20849,552,21401,0,4.60478e+18,453.638,2956.6,21401,242,186,20227,19538,16181,15880,11343
6467,1190,1656,3070,3397,3070,3397,5.01753e+18,307.493,2679.33,6467,243,189,4811,4732,4135,4212,4161
44966,586,703,44251,715,44966,0,4.62618e+18,555.218,4130.16,44966,279,253,44218,43534,41583,41608,40718
8536,400,1736,0,8536,0,8536,2.56442e+18,550.286,3112.52,8536,238,257,6455,5802,2904,2412,2353
29808,36,43,28437,1371,28965,843,9.78008e+13,38.76,778.736,29808,41,37,29736,29685,28585,28594,27175
30974,1661,1846,15236,15738,0,30974,5.16088e+18,1365.04,6044.32,30974,464,398,29099,25763,25420,24966,28109
17787,15,43,16937,850,17364,423,1.00551e+14,38.169,609.236,17787,39,36,17351,17037,14161,13827,10131
11625,430,2283,9599,2026,5876,5749,7.62991e+17,894.029,4148.27,11625,330,251,8430,7521,4710,4988,2971
40313,518,1677,0,40313,14235,26078,9.6074e+15,1120.76,5954.35,40313,498,365,34940,31972,18267,13172,16650
28066,229,352,0,28066,26475,1591,2.72919e+16,290.441,2198.2,28066,133,143,27335,26681,24114,21880,20898
32328,774,1713,0,32328,11518,20810,9.59313e+15,1087.06,5339.82,32328,493,344,28819,26506,18252,13309,20103
9879,1560,2253,9879,0,8211,1668,3.27913e+18,731.469,3831.29,9879,339,242,7626,7039,7315,7075,6315
35206,793,2768,35206,0,29026,6180,3.00107e+18,1622.96,7701.36,35206,525,432,28021,23555,15235,13221,10462
28106,988,1995,13940,14166,0,28106,5.06963e+18,1312.93,5866.3,28106,451,374,24147,21550,13248,12154,15374
6740,1252,1952,5409,1331,3222,3518,8.30944e+17,409.449,3049.24,6740,227,220,4788,4583,3984,3981,3569
25696,1158,4897,4851,20845,5706,19990,1.73055e+18,369.993,8507.76,25696,809,457,20799,20457,11155,8141,6345
9065,1056,1862,4969,4096,0,9065,5.06224e+18,371.316,3168.32,9065,255,198,7203,6916,5534,5235,5279
13321,831,1894,0,13321,0,13321,2.50975e+18,807.362,3869.74,13321,345,275,10992,10199,7349,6777,6479
1670,491,664,1670,0,1286,384,3.04346e+18,75.1545,951.252,1670,105,97,1006,1006,984,992,931
32626,915,2530,32626,0,26668,5958,2.93038e+18,1806.19,7408.76,32626,551,412,26002,22017,14443,12813,12704
38173,34,882,37170,1003,38173,0,4.52636e+18,577.865,3957.14,38173,259,222,22468,13380,9248,8113,1920
25448,37,43,24231,1217,24815,633,9.92377e+13,38.0771,721.917,25448,40,37,25385,25349,24469,24477,23570
35911,277,889,35006,905,35911,0,4.58981e+18,571.145,3852.44,35911,317,225,33577,31564,20537,18616,14440
40093,1190,2230,18951,21142,0,40093,5.10879e+18,1517.16,7329.28,40093,557,423,35585,31028,19585,16102,24001
5711,444,1148,0,5711,2050,3661,9.33909e+15,176.686,1967.46,5711,210,153,4563,4409,2958,3248,2653
13176,721,2389,10861,2315,6646,6530,7.67002e+17,1004.13,4479.15,13176,395,268,9955,8914,6461,6620,4931
17603,702,1841,0,17603,0,17603,2.51175e+18,1089.06,4529.81,17603,343,315,14412,12732,7594,6675,7388
17172,6,42,16270,902,16936,236,1.0702e+14,37.3923,595.913,17172,36,34,15082,13686,11310,11489,7176
22375,1295,1390,7853,14522,0,22375,3.7644e+13,958.435,4275.52,22375,382,315,20985,19602,19692,19767,20690
22872,342,798,22239,633,22872,0,4.62542e+18,484.014,3017.15,22872,235,192,21553,20699,16740,16683,12432
4673,527,1052,1615,3058,0,4673,3.70489e+13,177.393,1790.55,4673,189,156,3621,3483,2526,2520,2436
35399,1173,2122,35399,0,28326,7073,2.92956e+18,1662.28,7160.86,35399,476,435,30032,25130,22807,20938,20876
20853,656,1344,0,20853,7366,13487,9.88352e+15,948.398,4099.86,20853,354,307,18262,16706,10865,8534,11508
37684,37,43,35885,1799,36744,940,9.97012e+13,40.2298,883.47,37684,42,40,37604,37544,35867,35874,34321
3418,348,1128,1587,1831,0,3418,4.80105e+18,128.652,1687.41,3418,204,129,2290,2179,1249,1127,1184
2091,126,381,2084,7,2091,0,4.58749e+18,152.136,775.489,2091,80,78,1624,1312,907,854,632
42678,641,935,41420,1258,42678,0,4.53942e+18,596.141,4209.99,42678,265,234,41664,40693,37916,37870,34766
22049,446,1558,7833,14216,0,22049,3.76781e+13,949.999,4363.97,22049,378,300,18744,17244,10100,8234,9162
45209,37,43,42916,2293,44326,883,1.02731e+14,39.9724,968.955,45209,43,42,45119,45060,42940,42944,40512
48884,2689,2794,24443,24441,24443,24441,4.97558e+18,1467.43,8493.82,48884,613,458,46090,46090,45847,45735,46058
4423,735,937,0,4423,1555,2868,9.92253e+15,146.626,1617.85,4423,161,147,3486,3470,3054,2910,3081
14509,501,1888,7793,6716,7793,6716,4.93453e+18,866.819,4016.49,14509,384,283,11675,10665,6491,6143,4846
31663,1326,1969,15431,16232,15431,16232,5.04274e+18,1380.47,6251.32,31663,456,387,28712,25783,19024,17623,22023
22413,192,369,0,22413,21246,1167,2.67038e+16,269.934,1980.43,22413,117,124,21737,21312,18987,17163,14443
29609,219,1706,10534,19075,0,29609,3.73725e+13,1053.59,5115.81,29609,476,324,24301,22346,10109,8290,4254
18034,858,2041,9487,8547,0,18034,5.02313e+18,1046.3,4645.67,18034,421,309,15202,13728,8478,8084,8751
8516,6,43,8145,371,8269,247,9.70094e+13,31.2666,414.625,8516,32,30,7633,7072,5918,5986,3956
36857,2110,2413,19680,17177,0,36857,5.0479e+18,1384.19,6914.09,36857,538,402,34444,34444,32101,31529,32518
26129,1972,2118,13769,12360,13769,12360,4.96245e+18,1289.67,5658.67,26129,460,360,24011,23928,22998,22817,23108
39031,976,1579,13866,25165,0,39031,3.83025e+13,1100.78,5808.41,39031,467,379,36091,32558,24455,21768,28082
16907,901,2107,13746,3161,8380,8527,7.94312e+17,1287.31,4927.26,16907,351,327,13393,11662,9259,8870,8069
30781,644,841,29879,902,30781,0,4.55105e+18,521.747,3523.9,30781,263,214,29940,29253,28718,28842,27515
23954,18,43,22822,1132,23327,627,9.80947e+13,36.5181,686.33,23954,38,36,23595,23305,20070,19911,16608
24404,41,43,23250,1154,23770,634,9.99767e+13,40.0738,713.267,24404,41,38,24355,24338,24295,24293,23966
11169,1013,2057,5256,5913,5256,5913,4.98798e+18,811.667,3861.23,11169,368,261,8979,8179,5381,5027,5806
19253,365,1933,9773,9480,9773,9480,4.90555e+18,1144.37,4782.29,19253,399,321,15006,13427,5346,5942,3732
40973,24,1356,14488,26485,0,40973,3.87116e+13,1115.29,5737.22,40973,474,384,21438,14522,8035,2557,1503
21911,232,2125,11321,10590,11321,10590,4.94505e+18,1140.54,5234.63,21911,404,336,16408,14278,6015,6296,3281
1787,88,146,0,1787,1676,111,2.77021e+16,37.1763,397.637,1787,44,38,1641,1639,1509,1552,1286
27153,573,869,26473,680,27153,0,4.59143e+18,517.638,3346.61,27153,288,210,26211,25493,23840,23929,21252
7132,142,1693,0,7132,0,7132,2.42147e+18,305.118,2757.3,7132,274,214,4975,4065,1962,814,694
14733,195,1872,7481,7252,7481,7252,4.96423e+18,962.304,4171.51,14733,333,288,10694,8776,3825,4061,1356
23988,3,43,22855,1133,23374,614,1.00279e+14,38.1081,704.407,23988,40,38,17403,14864,13702,13821,9723
6445,28,43,6180,265,6219,226,9.73046e+13,28.4529,367.72,6445,30,29,6383,6362,5995,5992,5770
48570,1676,2506,24281,24289,0,48570,5.07163e+18,1609.45,8242.02,48570,603,457,45613,39263,29772,26415,38298
22536,1665,1951,11406,11130,0,22536,5.05863e+18,1209.12,5178.29,22536,413,342,20585,18114,17249,16877,19151
29675,1945,1952,14811,14864,0,29675,5.08461e+18,1331.11,5969.98,29675,454,391,27723,27723,27708,27622,27723
41618,194,354,0,41618,39619,1999,2.56076e+16,293.898,2608.13,41618,146,154,40578,39744,35663,32375,29002
9437,904,1328,3284,6153,0,9437,3.66768e+13,503.28,2719.01,9437,277,202,8109,7656,6234,6375,6493
12364,923,1956,6211,6153,6211,6153,4.82928e+18,876.055,3877.79,12364,349,255,10030,9123,5968,5465,6599
36792,2175,2250,19517,17275,0,36792,5.02785e+18,1414.17,6767.02,36792,543,406,34542,34542,34313,34067,34462
16466,1114,1941,0,16466,0,16466,2.43036e+18,1011.4,4407.18,16466,404,301,14009,12807,9204,8648,9540
8043,12,43,7669,374,7843,200,1.0009e+14,29.8473,409.675,8043,33,32,7737,7531,6263,6138,4783
10504,2114,2300,8687,1817,5319,5185,7.54081e+17,775.695,3955.44,10504,342,247,8204,7759,8039,8001,8088
45953,484,2236,23561,22392,0,45953,5.03949e+18,1448.93,7587.7,45953,561,441,37405,32878,13396,14122,11576
40632,1557,1596,0,40632,14395,26237,9.73492e+15,1110.61,5928.3,40632,476,375,39036,39036,38948,38820,38932
23550,31,42,22358,1192,23077,473,1.02287e+14,39.6619,691.011,23550,40,37,23447,23379,21460,21431,19808
46544,287,354,0,46544,43885,2659,2.73251e+16,316.719,2834.6,46544,157,169,45806,44626,41988,38609,40130
43390,2478,2838,36047,7343,22543,20847,7.37665e+17,1765.79,8379.26,43390,666,451,40552,40552,38745,38479,39822
35568,801,2260,0,35568,0,35568,2.43933e+18,1412.31,6732.31,35568,535,399,30052,26856,14031,13636,15783
4233,604,1065,4233,0,3797,436,3.26504e+18,79.399,1649.87,4233,177,131,3168,3168,3054,3037,1209
5836,1029,1760,5836,0,4641,1195,2.97127e+18,323.252,2707.17,5836,199,205,4076,3907,3547,3473,2842
38635,220,1824,0,38635,13712,24923,9.52136e+15,1118.01,5924.95,38635,550,359,31762,29217,13270,8268,7485
46125,12,356,0,46125,43989,2136,2.52909e+16,302.432,2734.92,46125,147,157,38316,34154,27704,24998,14801
23707,679,870,23073,634,23707,0,4.56192e+18,504.973,3143.24,23707,266,196,22837,22768,21827,21886,21286
27233,82,358,0,27233,25709,1524,2.73408e+16,286.198,2182.19,27233,134,142,25792,25120,19160,16387,11807
37299,1014,1823,0,37299,13218,24081,9.50686e+15,1108.12,5808.58,37299,548,345,34242,31200,22827,17452,26284
29487,153,378,0,29487,27826,1661,2.71912e+16,297.998,2312.34,29487,137,139,28397,27743,23214,20471,15836
6444,15,38,6177,267,6220,224,9.30391e+13,27.5694,341.098,6444,28,28,6300,6209,5380,5256,4360
49881,38,43,47620,2261,48406,1475,9.78544e+13,40.437,1010.41,49881,43,41,49803,49743,49056,49052,46386
40210,174,2437,20957,19253,20957,19253,4.89456e+18,1436.24,7249.4,40210,613,410,29411,23920,10481,11564,4325
12340,327,1959,0,12340,0,12340,2.42736e+18,809.602,3848.17,12340,329,272,9407,8499,3578,2424,2849
26298,196,590,26041,257,26298,0,4.7376e+18,480.48,3064.51,26298,221,219,23920,21432,12557,12744,9623
13893,691,1785,6794,7099,6794,7099,4.96116e+18,950.261,4011.4,13893,308,291,11211,10009,5838,5412,5546
10885,20,43,10348,537,10672,213,1.01419e+14,36.4509,478.41,10885,36,32,10727,10621,9115,9020,7113
41707,223,1573,14814,26893,0,41707,3.80316e+13,1140.91,5996.95,41707,483,382,34192,31397,13947,8490,8684
12597,1383,1936,6531,6066,6531,6066,4.87576e+18,803.275,3844.2,12597,335,244,10661,9783,8157,7789,8715
14519,1090,2214,14519,0,11930,2589,3.17173e+18,1136.39,4618.35,14519,371,294,11481,10148,9017,8572,7361
2731,621,783,0,2731,961,1770,9.47344e+15,96.7393,1207.84,2731,180,123,1948,1941,1670,1586,1685
22640,211,592,22358,282,22640,0,4.72865e+18,452.509,2831.15,22640,202,202,20754,18992,10852,10930,8460
27453,1432,1708,9786,17667,0,27453,3.76202e+13,1049.92,4962.9,27453,469,323,25745,24245,22279,22756,25254
43957,2,43,41582,2375,43311,646,1.04395e+14,41.9699,969.277,43957,43,43,26138,21021,19760,21160,15706
31166,1676,1708,0,31166,11055,20111,9.55419e+15,1056.68,5245.92,31166,483,340,29458,29458,29388,29382,29378
14478,1232,2120,11698,2780,7036,7442,8.12209e+17,1205.92,4585.29,14478,358,286,11677,10355,9117,9104,7863
16755,512,1426,5939,10816,0,16755,3.80731e+13,833.993,3712.78,16755,330,261,14315,13178,8368,6807,7628
23042,371,1854,11274,11768,11274,11768,4.90939e+18,1252.99,5203.57,23042,419,341,18011,15980,6220,6274,4980
45217,93,707,44585,632,45217,0,4.65654e+18,525.641,4109.89,45217,280,247,35182,24722,13164,13260,7154
26969,1958,2494,26969,0,22627,4342,3.30728e+18,1520.17,6368.53,26969,513,380,24340,20901,23414,23267,21186
4579,226,1627,3647,932,2073,2506,8.55719e+17,268.662,2378.47,4579,181,176,2745,2281,1210,1313,520
13286,1796,1963,0,13286,0,13286,2.44405e+18,903.037,4028.6,13286,330,291,11323,10477,10506,10278,11248
27845,1704,2466,27845,0,22684,5161,3.04493e+18,1614.75,6742.57,27845,504,397,24613,20917,23392,22658,20167
33535,772,1709,11853,21682,0,33535,3.70775e+13,1080.84,5422.49,33535,524,341,30081,27566,18730,18688,21236
19795,757,802,0,19795,18744,1051,2.38215e+16,142.143,2591.26,19795,128,121,18993,18993,18952,18974,18596
38514,2325,2475,20152,18362,0,38514,4.99283e+18,1427.96,7134.49,38514,601,410,36039,36039,35436,35407,35823
44829,74,355,0,44829,42764,2065,2.52489e+16,295.635,2680.95,44829,142,155,42825,41911,33204,28416,20033
38384,354,390,0,38384,36488,1896,2.59516e+16,301.715,2597.2,38384,144,147,37994,37670,36988,36655,36985
41097,268,732,40353,744,41097,0,4.61304e+18,551.547,3974.27,41097,289,244,38563,36386,20173,20557,18322
1436,26,28,1351,85,1436,0,9.36946e+13,21.1922,143.131,1436,20,20,1408,1405,1402,1401,1399
45735,864,1736,21673,24062,21673,24062,5.03219e+18,1427.86,7164.7,45735,531,448,39537,34360,20266,19044,24450
16775,15,43,16000,775,16322,453,9.82942e+13,38.4835,590.272,16775,37,34,16368,16069,13296,12947,9646
13630,1440,2149,11114,2516,6792,6838,7.86908e+17,1099.61,4454.07,13630,347,285,11030,9883,9347,9368,8619
17165,446,1923,0,17165,0,17165,2.47229e+18,988.993,4428.87,17165,342,292,13755,12444,6595,4318,4860
15381,191,755,15312,69,15381,0,4.487e+18,345.019,2498.35,15381,194,173,13949,12622,7564,7086,5176
30680,1760,2113,0,30680,0,30680,2.46228e+18,1392.38,6166.46,30680,483,383,28491,25002,23471,20988,25453
28226,1139,2513,0,28226,0,28226,2.47367e+18,1315.8,6382.55,28226,526,369,24397,21697,13119,12382,16481
25892,1738,2333,13405,12487,0,25892,4.96259e+18,1299.29,5878.57,25892,471,352,23523,20744,18838,17978,21394
13133,1609,2193,10798,2335,6645,6488,7.66977e+17,1021.73,4367.74,13133,318,276,10882,9689,9300,9275,8847
33432,35,42,31724,1708,32814,618,1.02851e+14,39.1811,817.594,33432,40,38,33352,33310,31525,31564,30181
24486,744,1529,0,24486,8759,15727,9.75573e+15,958.731,4511.13,24486,387,308,21810,20095,14170,10368,15088
12120,22,673,11700,420,12120,0,4.63333e+18,370.51,2097.07,12120,194,146,6334,1843,2799,2463,561
31231,291,359,0,31231,29670,1561,2.62427e+16,284.857,2308.58,31231,134,143,30696,30050,28588,26937,26752
46815,1078,1384,0,46815,16592,30223,9.96103e+15,1135.57,6173.75,46815,496,401,44240,39115,32812,27288,38210
15616,812,1366,5501,10115,0,15616,3.82085e+13,821.655,3557.41,15616,322,275,13779,12691,9224,8927,9982
18454,1250,2032,9725,8729,0,18454,4.96412e+18,1055.62,4676.11,18454,433,302,16033,14518,10977,10302,10759
11405,148,647,11253,152,11405,0,4.60543e+18,361.605,2061.16,11405,170,147,9848,8214,4647,4567,3285
48896,1865,2776,40301,8595,25017,23879,7.62693e+17,1725.71,8853.81,48896,648,471,45633,37840,37285,36792,37694
43949,660,1941,15563,28386,0,43949,3.70581e+13,1161.27,6410.73,43949,607,368,38782,35691,21795,19296,18160
24323,492,2654,24323,0,19812,4511,2.89255e+18,1661.47,6534.13,24323,506,352,17653,14375,7955,5831,5757
13799,96,1506,4860,8939,0,13799,3.69172e+13,700.947,3386.54,13799,340,239,10477,8994,4615,2212,2352
4998,28,573,4934,64,4998,0,4.64398e+18,230.397,1359.71,4998,125,115,2409,1028,873,762,375
7680,360,1304,2679,5001,0,7680,3.76451e+13,320.4,2441.21,7680,256,184,6293,5912,3382,2786,3037
26704,1487,1681,0,26704,9455,17249,9.63484e+15,995.238,4944.55,26704,458,322,25023,25021,23428,22516,24631
30689,2103,2632,25576,5113,16061,14628,7.35052e+17,1567.15,6940.47,30689,516,393,28057,24283,24814,24104,26160
9995,1101,2004,9995,0,8005,1990,2.98354e+18,843.753,3709.37,9995,267,268,7810,6882,6140,5842,5894
24047,331,784,23430,617,24047,0,4.52225e+18,467.247,3072.95,24047,244,203,22722,21818,13736,13397,13086
44275,17,43,41959,2316,43522,753,1.03137e+14,40.162,960.644,44275,43,42,43380,42647,35500,35198,26035
33285,633,1980,17037,16248,0,33285,5.11432e+18,1414.8,6345.18,33285,472,401,27496,24182,12190,11689,11122
29910,744,1561,10600,19310,0,29910,3.77576e+13,1043.88,5052.07,29910,435,334,26652,24455,16775,16729,18690
46733,1938,6001,0,46733,20005,26728,1.04904e+16,560.519,11140.1,46733,961,587,40732,40068,26480,23107,20925
24214,182,355,0,24214,22941,1273,2.68394e+16,281.041,2054.8,24214,129,131,23412,22871,20223,17926,15938
44024,136,2493,0,44024,0,44024,2.42471e+18,1500.14,7617.66,44024,647,428,31139,23324,11263,4353,3022
42788,1813,2485,0,42788,0,42788,2.47787e+18,1410.69,7569.15,42788,535,437,40303,38468,30098,27996,35280
13897,717,1992,11077,2820,6518,7379,8.44141e+17,1166.92,4391.19,13897,351,286,10639,9009,6601,6653,5827
21434,576,1644,7580,13854,0,21434,3.69551e+13,926.396,4309.35,21434,424,285,18446,17143,10950,9029,10663
32167,4320,7332,32167,0,30258,1909,2.02421e+18,470.09,10225.7,32167,965,599,24835,24746,22976,21531,15686
41560,1052,2155,33266,8294,19764,21796,8.45685e+17,1733.35,7795.03,41560,544,459,34665,28986,24757,23758,21824
38857,1460,2696,31655,7202,18895,19962,7.92497e+17,1731.73,8096.47,38857,610,445,33902,28704,25493,25301,22517
42258,34,42,39883,2375,41812,446,1.06881e+14,39.8838,929.687,42258,42,41,42148,42050,39481,39547,36938
17310,835,1433,6092,11218,0,17310,3.71621e+13,855.933,3766.92,17310,369,276,15428,14192,10537,10392,10642
40109,246,356,0,40109,38263,1846,2.51176e+16,295.777,2534.21,40109,138,146,39359,38643,35847,33538,33063
22563,1705,2107,22563,0,18108,4455,3.07477e+18,1525.58,5758.37,22563,414,376,19937,16646,19134,19261,17427
36251,2314,2737,30191,6060,18905,17346,7.31488e+17,1722.12,7600.82,36251,593,420,33514,33248,30907,30344,32061
43708,287,357,0,43708,41731,1977,2.48908e+16,291.215,2628.54,43708,142,153,43115,42291,40218,38023,38460
36817,78,795,35624,1193,36817,0,4.40068e+18,565.094,3786.73,36817,255,225,28125,20541,11712,10827,4270
6178,521,526,6043,135,6178,0,4.58292e+18,206.087,1421.63,6178,135,114,5652,5652,5649,5652,5646
17253,79,2196,17253,0,13974,3279,2.9957e+18,1327.8,5084.51,17253,367,320,8906,5151,3354,3208,824
12918,258,1976,0,12918,0,12918,2.41015e+18,900.9,3971.47,12918,358,274,9543,8348,3158,1761,1736
14216,802,1862,0,14216,0,14216,2.49692e+18,968.853,4118.74,14216,325,291,11521,10460,6005,5454,6346
38586,40,43,36393,2193,38202,384,1.0673e+14,40.3774,905.391,38586,43,41,38525,38483,38367,38365,36806
19013,24,43,18080,933,18581,432,1.00196e+14,37.8106,621.472,19013,38,36,18852,18722,16695,16696,14371
18504,460,804,17891,613,18504,0,4.44031e+18,425.616,2699.64,18504,212,177,17595,17127,14777,14936,13226
37832,867,1993,18892,18940,18892,18940,4.93589e+18,1450.5,6758.81,37832,545,411,32527,28733,16259,16564,19584
39699,2559,2704,33053,6646,20745,18954,7.32506e+17,1738.24,7904.99,39699,614,424,36995,36995,36469,36323,36356
28622,526,882,27814,808,28622,0,4.51644e+18,511.83,3413.13,28622,262,209,27617,26870,22244,22125,20011
27830,11,43,26513,1317,27099,731,9.93004e+13,39.8831,756.179,27830,41,38,26694,25857,21426,20975,14370
24501,2024,2075,12781,11720,12781,11720,4.89432e+18,1303.12,5471.87,24501,456,340,22426,22426,22294,22195,22421
20293,1146,2430,20293,0,17024,3269,3.25152e+18,1305.75,5478.39,20293,417,340,16828,14712,13925,13056,10713
23890,1497,2175,12655,11235,12655,11235,4.9179e+18,1220.17,5446.58,23890,483,330,21361,19087,15125,14615,16994
37022,34,43,35211,1811,36191,831,1.01218e+14,40.279,876.988,37022,42,41,36907,36801,34625,34624,31191
42929,1628,2660,22528,20401,22528,20401,4.8554e+18,1475.11,7666.28,42929,665,418,39985,34719,26438,26014,31687
18376,86,350,0,18376,17488,888,2.55708e+16,239.73,1715.48,18376,103,110,17570,17243,13822,12284,9085
19330,896,2084,10571,8759,0,19330,5.07751e+18,1027.59,4777.28,19330,403,305,16470,14915,10019,9236,8967
30013,74,353,0,30013,28631,1382,2.5315e+16,276.526,2199.11,30013,127,132,28628,28004,22276,19559,14106
20882,42,372,0,20882,19864,1018,2.61012e+16,254.378,1895.6,20882,111,122,19426,18537,14170,11998,7930
43652,929,1944,15436,28216,0,43652,3.69393e+13,1167.8,6402.81,43652,624,372,39842,36402,24820,25910,24678
5803,615,1642,2765,3038,2765,3038,5.04932e+18,209.184,2568.57,5803,220,164,4161,3967,2440,2016,2051
1768,555,768,1412,356,863,905,8.15968e+17,109.059,1066.15,1768,111,110,1000,1000,960,961,890
28642,409,880,27958,684,28642,0,4.64384e+18,519.777,3440.46,28642,251,207,27273,26369,21858,21439,16623
38639,600,752,38041,598,38639,0,4.72897e+18,509.605,3848.35,38639,259,238,37887,37718,36173,36098,34158
3541,747,994,0,3541,0,3541,2.72499e+18,125.729,1594.85,3541,159,138,2547,2543,2485,2478,1989
3417,15,42,3228,189,3415,2,1.08406e+14,26.1882,270.978,3417,26,27,3304,3230,2697,2636,1841
37317,1548,1849,13296,24021,0,37317,3.7292e+13,1092.39,5834.08,37317,551,358,35468,35468,31902,32393,34806
13373,472,1879,0,13373,0,13373,2.42621e+18,822.686,3858.84,13373,365,278,10668,9679,5466,4858,3751
31060,1015,1741,0,31060,10915,20145,9.84915e+15,1169.61,5525.7,31060,472,350,28042,25487,18019,14803,20473
23957,249,350,0,23957,22615,1342,2.72536e+16,274.243,2028.21,23957,123,131,23353,22879,21007,19550,19781
850,20,21,823,27,815,35,1.07954e+14,11.4376,102.364,850,15,15,829,829,828,828,813
970,77,344,588,382,588,382,5.6778e+18,34.2649,496.768,970,70,64,626,522,368,285,50
13332,725,1878,7116,6216,7116,6216,4.9377e+18,823.207,3862.38,13332,360,274,10885,9894,6466,6562,5095
27024,1310,1623,0,27024,9539,17485,9.4252e+15,995.288,4769.78,27024,469,309,25312,23011,20577,17321,23304
20481,33,43,19481,1000,20018,463,1.00669e+14,38.7616,650.647,20481,39,36,20399,20342,19048,19070,17354
33208,380,2489,27049,6159,15820,17388,7.84221e+17,1828.56,7428.42,33208,560,417,23664,19317,10676,11586,6584
41576,455,2799,41576,0,34867,6709,3.31783e+18,1745.52,8116.94,41576,672,452,31739,27666,17629,13730,9258
27861,1150,2274,22393,5468,13302,14559,8.32322e+17,1499.47,6495.97,27861,482,396,23276,19822,17075,16583,14958
46418,284,2710,38614,7804,24133,22285,7.39633e+17,1840.68,8571.46,46418,639,458,33377,28229,15589,17750,4018
47530,754,2648,0,47530,0,47530,2.44693e+18,1458.99,8009.66,47530,622,437,40335,35403,16691,18246,17369
27888,718,1666,0,27888,9847,18041,9.94992e+15,1127.37,5164.08,27888,436,349,24291,22442,13618,10760,14844
4355,37,39,4089,266,4344,11,1.10716e+14,25.7876,292.195,4355,29,27,4316,4316,4306,4305,4219
16965,50,2123,0,16965,0,16965,2.44482e+18,1045.29,4630.59,16965,395,304,9379,6395,3678,1717,550
21455,99,829,20961,494,21455,0,4.54929e+18,471.09,2967.08,21455,244,190,17033,12566,7171,6387,3308
19556,2277,2300,9293,10263,0,19556,5.09486e+18,1292.27,5296.37,19556,462,327,17256,17256,17200,17099,17256
4881,179,1335,2358,2523,0,4881,5.21164e+18,185.992,2133.67,4881,219,190,3413,2640,1208,939,881
22827,1647,2425,22827,0,18456,4371,2.9406e+18,1539.33,6091.35,22827,454,349,19667,16834,18698,18694,16034
12904,563,1663,6120,6784,0,12904,5.14441e+18,920.921,3759.38,12904,317,287,10226,9105,4853,4210,5153
40892,16,42,38653,2239,40425,467,1.06651e+14,39.1761,905.104,40892,41,40,39980,39261,32242,31535,24054
42851,186,369,0,42851,40652,2199,2.61891e+16,313.325,2723.71,42851,151,160,41659,40725,36015,31594,27866
6475,1065,1868,5408,1067,3380,3095,7.21891e+17,213.432,2868.46,6475,247,201,4607,4556,3819,3943,2625
12347,2016,2270,10154,2193,6208,6139,7.74945e+17,985.744,4278.21,12347,361,293,10077,9132,9582,9537,9515
18804,157,350,0,18804,17911,893,2.56824e+16,255.103,1753.45,18804,108,109,18148,17834,15737,13921,11391
44703,833,1520,15899,28804,0,44703,3.84133e+13,1157.94,6183.96,44703,479,393,40713,36843,25820,23086,29237
34388,1945,1952,16562,17826,16562,17826,5.03841e+18,1387.63,6462.43,34388,453,424,32436,32436,32418,32400,32434
11686,1320,1389,4161,7525,0,11686,3.77734e+13,661.235,3087.13,11686,294,228,10297,9759,10191,10228,10169
9772,54,1534,3489,6283,0,9772,3.70347e+13,486.557,2904.8,9772,298,204,6614,5393,2818,970,808
45304,1914,2480,23841,21463,23841,21463,4.92741e+18,1464.72,7694.16,45304,616,439,42824,42582,35027,33966,38903
36889,1014,1361,13068,23821,0,36889,3.88264e+13,1089.59,5465.44,36889,457,381,34427,30716,24693,21009,28860
8516,901,1339,0,8516,3022,5494,1.00446e+16,456.331,2611.34,8516,241,213,7177,6794,5220,5266,5669
9583,173,382,0,9583,9060,523,2.62951e+16,165.245,1351.92,9583,87,89,9136,8985,7842,7178,5760
31556,140,1710,0,31556,11181,20375,9.54118e+15,1085.6,5281.89,31556,498,338,25001,22118,10383,6049,4562
38008,3020,6958,23098,14910,6096,31912,3.42557e+18,748.599,12335.7,38008,874,561,31050,31030,15717,15292,10075
48161,26,2299,25321,22840,0,48161,5.01255e+18,1567.56,7796.37,48161,656,435,22973,14598,8823,5970,947
28973,127,1646,0,28973,10284,18689,9.57217e+15,1029.42,4976.91,28973,462,325,22903,20305,9774,5394,3924
22696,356,1641,8030,14666,0,22696,3.70647e+13,946.26,4425.21,22696,424,292,19095,17702,8830,7128,7433
37602,133,2519,31144,6458,19345,18257,7.52842e+17,1752.69,7644.3,37602,567,422,23782,15824,11110,11670,2592
5470,1692,1763,5470,0,4452,1018,3.24922e+18,312.781,2654.06,5470,199,188,3707,3707,3707,3707,3684
20426,1097,1722,0,20426,0,20426,2.54922e+18,1192.85,4803.98,20426,373,333,17653,15668,11182,9428,12592
5546,7,43,5206,340,5528,18,1.07292e+14,28.4308,344.334,5546,32,31,4980,4626,3726,3756,2147
37737,1671,2420,19929,17808,0,37737,5.02325e+18,1411.11,7010.2,37737,558,406,35225,30627,24815,22847,29184
6869,1872,1959,6869,0,5838,1031,3.29667e+18,292.793,2973.87,6869,262,176,4910,4909,4905,4906,4838
22837,126,1707,10766,12071,0,22837,5.10242e+18,1262.74,5075.11,22837,415,342,15154,10735,4195,3057,1862
13336,1211,1435,4751,8585,0,13336,3.8272e+13,695.051,3308.92,13336,291,246,11901,11094,10480,9918,11132
18163,1326,2109,0,18163,0,18163,2.50178e+18,1195.93,4912.67,18163,369,320,15545,14041,10005,8543,11810
48186,1915,2098,48186,0,38541,9645,3.01594e+18,1768.5,8332.27,48186,557,484,45860,37491,44846,45051,44260
21770,133,671,21485,285,21770,0,4.70581e+18,468.745,2854.03,21770,211,194,18534,14558,7802,7815,5047
28217,109,2001,22447,5770,13303,14914,8.59028e+17,1534.56,6249.13,28217,464,396,16010,9759,6488,6225,1868
16169,192,1992,0,16169,0,16169,2.43053e+18,1000.63,4397.93,16169,410,298,11882,9914,4462,1907,2130
38933,2227,2393,20418,18515,0,38933,4.99809e+18,1466.33,7106.84,38933,603,416,36540,36540,35267,34961,35628
20716,1657,2051,0,20716,0,20716,2.45774e+18,1117.17,4957.42,20716,420,318,18665,16707,15309,13869,15391
31746,1012,1827,0,31746,11266,20480,9.49997e+15,1072.39,5412.96,31746,497,332,28884,26443,19565,15515,21443
33952,1581,1856,0,33952,0,33952,2.52348e+18,1376.13,6328.6,33952,481,407,31914,27304,25449,24944,30018
41719,2035,2368,41719,0,34202,7517,3.04139e+18,1755.3,7943.76,41719,573,454,39213,33117,38026,38180,38007
6338,700,1260,0,6338,2240,4098,9.58581e+15,163.443,2183.72,6338,198,164,5078,5018,3903,3127,3247
46044,1688,2257,23333,22711,23333,22711,4.92829e+18,1526.82,7705.27,46044,591,442,43579,37341,31585,29922,38418
29323,2349,4753,14120,15203,14120,15203,4.54524e+18,804.547,8504.14,29323,954,489,24570,24173,19129,17747,17670
30023,48,2401,24845,5178,15450,14573,7.52788e+17,1635.86,6737.25,30023,496,396,14424,8805,5538,5888,901
3822,1121,1177,1701,2121,0,3822,4.75868e+18,209.865,1804.43,3822,191,139,2645,2645,2631,2618,2618
41589,747,2444,21618,19971,21618,19971,4.89792e+18,1486.06,7393.04,41589,598,424,35049,30797,14926,17376,15146
5626,213,1320,3130,2496,0,5626,5.10701e+18,206.544,2192.14,5626,257,197,4212,3849,2099,1997,998
26026,1315,1638,0,26026,9249,16777,9.64241e+15,1027.22,4754.29,26026,454,320,24301,21994,20125,18259,22909
38880,100,361,0,38880,37058,1822,2.52406e+16,290.28,2517.37,38880,135,149,37398,36719,29916,25570,20586
2384,16,589,803,1581,0,2384,3.51314e+13,67.7693,1002.64,2384,115,107,1274,962,544,354,231
48091,668,803,47238,853,48091,0,4.60019e+18,557.921,4346.58,48091,266,252,47288,47223,44945,44958,44148
14327,126,2342,14327,0,12037,2290,3.3135e+18,1014.47,4580.05,14327,387,297,9114,6221,4258,3452,867
40169,2266,2424,20928,19241,0,40169,4.98878e+18,1416.07,7221.1,40169,607,409,37745,37745,36670,36606,37087
1933,487,569,1762,171,1315,618,4.98463e+17,25.8815,813.18,1933,104,76,1364,1364,1341,1341,1318
31598,8,42,30008,1590,30942,656,1.02175e+14,39.2811,796.015,31598,40,38,29322,27886,22579,22493,14640
11163,444,572,11071,92,11163,0,4.69802e+18,349.641,1970.42,11163,150,149,10570,10372,9699,9722,9188
48621,1902,2180,0,48621,17292,31329,9.57429e+15,1145.41,6983.56,48621,651,388,46441,46441,44138,42903,46088
18974,690,1323,0,18974,6709,12265,9.91677e+15,913.248,3886.42,18974,336,298,16514,15242,10223,8281,10432
7946,1788,1833,4245,3701,4245,3701,4.89417e+18,300.426,3000.36,7946,289,220,6113,6113,6113,6113,6091
38765,327,357,0,38765,36957,1808,2.52839e+16,295,2507.99,38765,134,150,38337,37541,37296,36352,37003
5360,801,1449,2661,2699,2661,2699,4.842e+18,199.147,2307.99,5360,241,205,3911,3838,2777,2934,2702
29595,1487,2090,29595,0,23690,5905,3.05722e+18,1640.44,6565.49,29595,475,428,26076,21534,24495,23512,20652
46614,211,749,45588,1026,46614,0,4.55503e+18,559.001,4221.26,46614,286,249,42885,39267,20097,19468,15401
36642,542,1727,0,36642,12998,23644,9.59553e+15,1095.18,5709.2,36642,494,367,31881,29212,17546,11604,14226
8820,1402,2022,7060,1760,4175,4645,8.3412e+17,668.058,3495.25,8820,278,241,6798,6259,5877,5734,5597
30015,240,2024,0,30015,0,30015,2.48581e+18,1336.12,6030.17,30015,463,381,22524,19601,7948,4771,3972
25576,249,346,0,25576,24281,1295,2.6261e+16,266.841,2056.78,25576,121,132,25004,24542,22761,21320,21078
23695,444,2130,0,23695,0,23695,2.43099e+18,1277.25,5439.51,23695,463,341,18858,16887,7061,5411,4475
14921,728,2227,12412,2509,7881,7040,7.29741e+17,1060.87,4570.67,14921,360,302,11614,10315,7771,7697,5230
7754,1576,1815,0,7754,0,7754,2.44133e+18,300.652,2972.83,7754,279,221,5939,5937,5722,5723,5857
20275,1723,2159,10764,9511,0,20275,5.05765e+18,1108.32,5032.27,20275,421,322,18116,16241,14796,13969,15935
29315,870,1789,0,29315,10382,18933,9.66532e+15,1109.7,5324.49,29315,486,334,26111,24067,16785,12987,18530
4931,1289,1335,2270,2661,0,4931,4.85201e+18,172.666,2094.89,4931,209,169,3596,3596,3588,3580,3574
21134,36,43,20120,1014,20635,499,1.00502e+14,38.0766,662.418,21134,39,36,21070,21030,20040,20046,19216
26162,2042,2377,26162,0,21067,5095,2.93509e+18,1553.48,6423.26,26162,433,391,23785,22328,22957,23053,22383
26403,2033,2567,22203,4200,14209,12194,7.05306e+17,1489.62,6295.81,26403,481,373,23836,20644,20845,20487,20885
40591,1819,1829,14412,26179,0,40591,3.71591e+13,1127.77,6030.86,40591,568,362,38762,38762,38746,38757,38694
48307,10,370,0,48307,46046,2261,2.53329e+16,306.139,2840.82,48307,153,166,38990,34178,27868,25312,15311
37207,541,2863,37207,0,30953,6254,3.25512e+18,1676.32,7832.94,37207,612,428,28670,24761,15806,12623,9902
18849,2258,2382,18849,0,15793,3056,3.28391e+18,1297.02,5276.45,18849,485,324,16467,16430,16373,16360,16463
16863,613,2025,16863,0,13486,3377,3.06544e+18,1364.08,4906.85,16863,357,339,12608,10623,6338,5360,5093
41085,95,359,0,41085,38762,2323,2.73674e+16,308.028,2674,41085,151,164,39132,38221,29161,25420,19168
12939,1326,2330,10855,2084,6802,6137,7.09361e+17,927.789,4339.74,12939,369,291,10458,9422,8458,8443,8119
1503,269,544,1503,0,1185,318,2.63071e+18,136.114,814.977,1503,92,92,959,849,724,706,672
29646,95,2256,0,29646,0,29646,2.51812e+18,1443.58,6407.38,29646,484,395,17586,11870,5175,2988,1682
15720,143,762,15268,452,15720,0,4.51418e+18,418.185,2487.81,15720,232,170,13616,11358,6375,6226,3978
48138,568,2244,39017,9121,23619,24519,8.06498e+17,1762.98,8436.44,48138,582,472,37268,31361,20788,21026,15605
1867,107,172,0,1867,1739,128,2.63993e+16,47.0445,432.755,1867,45,49,1695,1684,1505,1450,1345
44873,1886,2480,0,44873,0,44873,2.42879e+18,1479.34,7666.24,44873,633,430,42393,42153,33211,30684,39213
14694,1388,1710,0,14694,0,14694,2.47213e+18,1009.49,4049.93,14694,337,296,12755,11382,9923,9576,11870
11382,116,1375,4041,7341,0,11382,3.77931e+13,600.765,3001.45,11382,296,245,8766,7721,3615,2139,1594
36298,238,363,0,36298,34501,1797,2.5978e+16,294.515,2487.14,36298,139,149,35505,34799,31816,29322,27343
32310,20,43,30746,1564,31537,773,1.00586e+14,39.9155,821.869,32310,42,40,31876,31550,27062,26748,20964
16462,738,769,16237,225,16462,0,4.7108e+18,475.444,2658.86,16462,249,184,15693,15678,15631,15579,15558
10543,42,43,9955,588,10409,134,1.04816e+14,33.7174,471.402,10543,35,32,10500,10496,10482,10481,10429
24059,671,2277,12871,11188,0,24059,5.00414e+18,1184.15,5524.41,24059,499,329,19896,17809,9090,9343,7048
37037,384,864,35982,1055,37037,0,4.56926e+18,542.667,3852.34,37037,293,227,35389,34110,26250,25577,21114
40343,2032,2362,21536,18807,0,40343,5.01492e+18,1424.55,7152.97,40343,583,416,37981,37980,34423,33654,36325
44390,15,44,42294,2096,43196,1194,9.8989e+13,41.4385,952.102,44390,43,41,43362,42616,35247,34230,26523
35116,31,43,33495,1621,34150,966,9.85117e+13,38.3905,844.221,35116,41,39,34978,34889,32444,32405,29837
9391,1912,2163,9391,0,7796,1595,3.27603e+18,622.403,3638.91,9391,297,225,7228,6876,7178,7109,5816
34319,12,43,32395,1924,33940,379,1.07131e+14,40.2278,855.11,34319,43,40,32876,31859,25586,25004,17010
9547,1069,1340,3428,6119,0,9547,3.94089e+13,499.849,2746.49,9547,224,236,8207,7813,7169,7073,7381
28388,650,691,27958,430,28388,0,4.65681e+18,471.694,3247.23,28388,224,217,27697,27697,27466,27482,27395
15192,205,2327,12706,2486,8013,7179,7.19664e+17,1092.28,4720.23,15192,370,301,10446,8165,4939,5653,353
45261,1141,1544,15941,29320,0,45261,3.78815e+13,1156.41,6227.47,45261,522,388,42863,37957,30962,29709,36006
39396,1345,1796,0,39396,13983,25413,9.52407e+15,1127.03,5926.1,39396,559,362,37487,33706,29631,23649,35304
43895,1452,1901,15556,28339,0,43895,3.69693e+13,1141.3,6337.87,43895,597,370,41994,40655,34765,35706,40637
10300,482,1689,5050,5250,5050,5250,5.16776e+18,780.986,3388.61,10300,256,265,7898,7061,3337,2826,3254
17365,1104,3121,7194,10171,7194,10171,3.38413e+18,601.494,5608.94,17365,437,324,14244,13127,8285,7789,8116
43108,1033,1801,0,43108,0,43108,2.54867e+18,1469.21,7085.66,43108,516,446,37890,33042,22040,17342,25492
20550,1259,1583,0,20550,7342,13208,9.63938e+15,929.434,4185.91,20550,388,292,18831,17273,15347,12634,17059
6284,7,301,0,6284,6006,278,2.46538e+16,50.4258,923.368,6284,69,67,4906,4242,3711,3213,2017
35549,675,1369,12532,23017,0,35549,3.86392e+13,1083.31,5357.85,35549,450,364,31561,28694,18217,18154,20028
26609,30,43,25344,1265,25939,670,1.00218e+14,41.0626,749.608,26609,41,39,26465,26381,24031,24029,21222
17029,850,2425,17029,0,14253,2776,3.31374e+18,1305.4,5131.47,17029,451,298,13368,11483,9061,8585,5401
11648,1532,1703,5487,6161,0,11648,5.05345e+18,832.142,3586.47,11648,302,273,9945,9035,8513,8439,9732
47301,913,2693,38736,8565,23725,23576,7.76937e+17,1722.36,8702.07,47301,597,465,38812,33131,26365,24948,19390
15057,609,1326,0,15057,5387,9670,1.00698e+16,823.875,3477.63,15057,296,278,12964,11930,7560,6141,7825
37966,324,2051,18825,19141,18825,19141,4.92636e+18,1397.93,6810.94,37966,528,410,29476,25990,9286,10120,6172
10776,906,1829,5636,5140,0,10776,5.13161e+18,679.749,3487.55,10776,299,268,8928,8187,5474,5304,5942
34288,1293,1860,16617,17671,16617,17671,4.96731e+18,1391.9,6361.09,34288,486,408,31101,27053,20995,19486,26676
36349,1617,1709,0,36349,12894,23455,9.52238e+15,1099.86,5616.08,36349,539,349,34640,34640,33888,33375,34395
36177,1457,1906,17858,18319,0,36177,5.11623e+18,1367.81,6534.55,36177,507,415,33596,29017,24148,22346,29830
43922,398,816,43106,816,43922,0,4.60521e+18,534.014,4159.82,43922,260,243,42237,40778,28969,28700,26687
692,112,289,0,692,0,692,2.266e+18,54.6199,417.96,692,74,72,403,290,241,228,124
32613,84,385,0,32613,31180,1433,2.49937e+16,279.874,2319.95,32613,126,136,31273,30663,24953,21358,14905
32516,30,43,30965,1551,31670,846,9.9126e+13,41.2709,819.77,32516,42,38,32360,32264,29428,29430,26901
8838,583,1833,4528,4310,0,8838,4.90595e+18,455.032,3164.78,8838,304,209,6972,6377,4135,3777,3081
12097,674,1409,0,12097,4289,7808,9.68393e+15,673.26,3158.1,12097,297,229,10306,9619,6709,5546,6864
47747,7,358,0,47747,45549,2198,2.51486e+16,306.654,2779.2,47747,145,158,36593,31185,27034,23600,14862
45345,1554,2241,23123,22222,23123,22222,4.96218e+18,1474.44,7573.83,45345,584,436,42543,36587,29047,27192,35343
21409,1369,1645,7541,13868,0,21409,3.67421e+13,923.505,4312.46,21409,444,286,19764,18116,17337,17661,18960
4869,50,1410,2198,2671,0,4869,4.99498e+18,189.886,2201.08,4869,226,199,2600,1511,664,563,175
24877,242,840,24231,646,24877,0,4.64695e+18,494.373,3170.9,24877,229,195,22984,21418,12838,13029,9214
11861,331,1799,6344,5517,0,11861,5.11216e+18,757.911,3586.14,11861,299,265,9206,8351,4569,4151,2532
31315,316,2068,25061,6254,14886,16429,8.41555e+17,1629.5,6687.93,31315,487,407,21928,18129,10066,10854,4578
4981,190,259,0,4981,4774,207,2.45642e+16,52.167,796.835,4981,63,61,4722,4700,4599,4590,4304
39685,252,355,0,39685,37874,1811,2.51753e+16,287.823,2523.76,39685,137,150,38959,38255,35518,33783,31195
1110,17,135,0,1110,1043,67,2.62265e+16,28.1757,309.939,1110,36,35,902,800,593,568,295
6040,361,1204,2173,3867,0,6040,3.87788e+13,197.592,2111.24,6040,230,160,4836,4561,2775,3078,1833
5188,24,39,4965,223,4979,209,9.26679e+13,27.4215,314.073,5188,26,26,5133,5108,4837,4825,4518
44916,386,2038,21304,23612,21304,23612,5.00478e+18,1563.2,7522.19,44916,547,440,35141,30202,10033,10467,10722
39370,1178,2831,32948,6422,20711,18659,7.20599e+17,1717.14,7969.7,39370,627,428,33259,28954,25723,25052,17923
2976,60,969,1262,1714,0,2976,4.76209e+18,100.222,1453.04,2976,154,126,1749,1041,386,294,128
24221,1576,1736,11397,12824,11397,12824,4.99932e+18,1296.14,5269.33,24221,418,358,22353,19234,19112,19286,21413
2634,369,643,0,2634,859,1775,8.64576e+15,88.9715,1075.08,2634,109,115,1991,1972,1392,1491,1276
37927,1871,2062,30247,7680,17882,20045,8.53536e+17,1674.98,7348.7,37927,524,453,35637,29038,33368,32732,33751
4283,790,1255,4283,0,3707,576,3.19507e+18,181.807,1893.42,4283,162,157,3028,2952,2891,2839,1537
6052,292,293,0,6052,5811,241,2.43606e+16,57.2107,913.348,6052,66,65,5759,5759,5759,5759,5747
37166,1931,2464,0,37166,0,37166,2.48179e+18,1513.01,7241.28,37166,613,411,34702,32664,27280,24543,32503
19969,182,2069,10242,9727,0,19969,4.98595e+18,1191.49,4964.14,19969,429,317,14565,11552,5024,3286,2291
27645,59,353,0,27645,26050,1595,2.73217e+16,289.365,2190.46,27645,128,138,25913,25026,18085,15594,10482
38553,1134,1748,18357,20196,0,38553,5.13139e+18,1421.9,6623.94,38553,502,426,34336,29841,21593,18580,25083
18961,18,43,18161,800,18289,672,9.58838e+13,33.7238,614.104,18961,37,35,18683,18484,15820,15742,12083
4392,847,1072,2621,1771,0,4392,5.2875e+18,176.937,1748.34,4392,229,163,3320,3304,3219,3222,2739
46159,441,1978,16340,29819,0,46159,3.694e+13,1150.66,6546.49,46159,649,372,39660,36569,18716,15584,18723
2492,858,934,2492,0,1883,609,3.09346e+18,120.801,1341.58,2492,129,133,1558,1558,1550,1553,1527
4547,325,501,4332,215,4547,0,4.23214e+18,187.178,1178.78,4547,138,96,4046,3975,3653,3657,2932
46274,642,2469,0,46274,0,46274,2.44277e+18,1482.49,7757.69,46274,622,433,38626,34063,16145,16703,15731
18939,74,1525,0,18939,6787,12152,9.6509e+15,850.919,3921.85,18939,352,280,14121,11947,6224,3018,1439
26353,1196,2363,13775,12578,0,26353,5.06878e+18,1276.81,5960.65,26353,474,346,23033,20655,14271,12647,15687
1961,13,38,1839,122,1959,2,1.11385e+14,21.1601,199.492,1961,24,24,1875,1827,1569,1526,1247
40274,2130,2767,40274,0,33216,7058,3.20037e+18,1752.25,8289.03,40274,659,455,37389,32610,35943,35989,34264
41580,545,1891,0,41580,14750,26830,9.52985e+15,1150.8,6207.65,41580,587,366,36143,33073,19014,12665,13664
7360,427,1705,3830,3530,3830,3530,4.98167e+18,258.516,2838.61,7360,278,218,5655,5206,3023,2796,1985
40157,225,1370,0,40157,14157,26000,9.87095e+15,1100.28,5699.28,40157,477,381,32781,30097,12642,9976,9876
49799,337,911,48336,1463,49799,0,4.53465e+18,628.413,4522.41,49799,312,247,47300,45246,31200,28312,23792
28051,334,735,27423,628,28051,0,4.54227e+18,507.388,3286.38,28051,221,214,26571,25509,17290,17204,16004
39491,536,2214,0,39491,0,39491,2.45325e+18,1462.82,7040,39491,550,418,32335,28566,12417,11146,10793
1085,178,372,488,597,0,1085,5.18209e+18,113.088,571.92,1085,83,83,713,508,306,250,391
20152,298,823,19675,477,20152,0,4.56648e+18,439.563,2875.9,20152,229,188,18848,17846,11704,11569,9734
24168,223,386,0,24168,22891,1277,2.74301e+16,287.91,2120.48,24168,127,126,23471,23031,20727,19002,17975
22163,138,347,0,22163,21002,1161,2.64068e+16,262.69,1925.08,22163,115,122,21335,20947,17681,15773,13601
14315,4,43,13678,637,13895,420,9.78628e+13,34.9633,537.074,14315,36,32,11553,10192,9249,9163,5732
7316,277,2476,1015,6301,2224,5092,8.72306e+17,109.171,3551.1,7316,667,285,4840,4566,2513,2878,533
19568,312,1756,6934,12634,0,19568,3.62699e+13,935.132,4249.26,19568,459,278,16162,14921,7874,6789,4927
29730,206,1664,0,29730,10539,19191,9.94303e+15,1051.8,5251.58,29730,468,349,23785,21295,8951,6932,6513
6994,66,1746,3622,3372,3622,3372,4.7638e+18,202.849,2800.93,6994,251,204,4143,2948,1722,1886,878
33908,254,1862,16780,17128,0,33908,5.09831e+18,1384.46,6317.81,33908,499,400,25463,21927,8258,6609,5836
32116,1267,1687,0,32116,0,32116,2.55853e+18,1367.56,5987.34,32116,465,399,29083,25189,19852,18835,23945
38432,2007,2739,38432,0,32024,6408,3.2888e+18,1712.3,7828.62,38432,658,447,35579,29917,34076,33580,31741
44219,855,2558,23085,21134,0,44219,4.98497e+18,1476.68,7679.29,44219,646,427,37859,33849,16517,17072,18312
35336,1745,2693,35336,0,29561,5775,3.2741e+18,1637.08,7427.31,35336,597,423,31909,27189,29962,28614,26703
43657,283,1889,15440,28217,0,43657,3.70832e+13,1162.92,6362.38,43657,602,371,36478,33564,14980,13018,13355
41325,1373,1917,0,41325,0,41325,2.50188e+18,1457.41,7007.39,41325,530,432,38033,32939,26039,23458,32239
34341,2213,2753,28486,5855,17695,16646,7.42675e+17,1667.91,7440.11,34341,603,408,31588,31426,28326,27816,29789
35211,1365,2112,28237,6974,16854,18357,8.37296e+17,1640.61,7110.9,35211,505,432,30806,25808,24623,23984,23184
40209,586,1790,14286,25923,0,40209,3.70711e+13,1160.24,5962.64,40209,608,365,35217,32425,20165,17924,21469
29552,1508,2300,15847,13705,15847,13705,4.93879e+18,1313.09,6118.96,29552,510,368,26848,23706,18501,17918,20355
14012,729,752,13719,293,14012,0,4.52577e+18,376.536,2349.88,14012,218,155,13260,13260,13231,13230,13218
4501,49,547,4419,82,4501,0,4.62699e+18,191.164,1257.96,4501,140,101,2873,1714,1307,1252,720
46371,154,1969,0,46371,16493,29878,9.575e+15,1136.58,6583.93,46371,687,384,37108,33301,15223,9020,6434
29537,1173,1501,0,29537,10449,19088,9.6805e+15,1049.27,4994.16,29537,414,340,27636,24759,21604,17857,24677
33201,72,352,0,33201,31308,1893,2.71728e+16,298.313,2388.03,33201,138,147,31326,30504,22677,19755,13542
25970,1018,2552,25970,0,21639,4331,3.32427e+18,1550.64,6370.25,25970,536,359,21313,18484,15554,14680,10123
937,7,27,876,61,937,0,1.07844e+14,15.3447,115.642,937,17,17,851,800,649,659,577
33995,2188,2679,33995,0,28480,5515,3.29616e+18,1652.65,7285.02,33995,631,414,31316,31105,30487,30639,29951
39970,1132,1372,14101,25869,0,39970,3.8605e+13,1099.67,5691.5,39970,474,381,37898,33463,29394,28100,34129
2710,419,777,1604,1106,1604,1106,5.36283e+18,85.5085,1216.81,2710,153,124,1933,1933,1803,1753,790
43277,102,348,0,43277,41219,2058,2.54401e+16,290.261,2623.39,43277,142,153,41662,40899,33338,29206,21949
33684,50,390,0,33684,31808,1876,2.69907e+16,292.323,2487.43,33684,141,151,31390,30115,21758,18764,11974
20717,13,821,20254,463,20717,0,4.56028e+18,484.893,2909.02,20717,258,183,7339,2101,1996,2275,536
42250,2124,2471,0,42250,0,42250,2.44401e+18,1447.91,7405.02,42250,614,430,39779,39778,36463,36186,38196
38244,523,2415,31130,7114,18970,19274,7.9478e+17,1688.23,7641.56,38244,562,441,29225,24901,15881,16163,10447
13945,1205,2409,13945,0,11945,2000,3.36702e+18,937.772,4519.51,13945,393,275,11200,10173,9722,9261,6059
11013,257,1839,5651,5362,5651,5362,4.79712e+18,678.452,3502.77,11013,340,235,8302,7433,3172,3659,1849
25059,1720,2566,25059,0,20858,4201,3.30984e+18,1473.94,6253.28,25059,502,377,22047,18977,20897,19979,16546
29629,703,1643,10481,19148,0,29629,3.71528e+13,1032.29,5030.93,29629,491,326,26209,24289,16246,14635,17114
49955,2181,2353,40004,9951,23699,26256,8.34967e+17,1753.71,8705.6,49955,584,494,47602,47504,45141,44599,46675
16481,1118,1707,7786,8695,7786,8695,5.0116e+18,1111.47,4313.65,16481,342,300,14214,12525,9524,8455,10589
13348,1262,1742,0,13348,0,13348,2.51277e+18,961.531,3917.6,13348,324,281,11260,10222,8229,7793,9415
7529,1217,1416,2665,4864,0,7529,3.72432e+13,214.711,2474.11,7529,230,174,6113,6069,6028,5998,5753
33447,341,1313,0,33447,11766,21681,9.8616e+15,1048.24,5118.94,33447,438,364,28155,25715,12846,9806,12191
19021,704,1799,6630,12391,0,19021,3.75097e+13,978.501,4419.19,19021,459,318,16159,14933,8594,8370,10336
45544,2579,2629,21514,24030,21514,24030,4.94448e+18,1631.52,8255.22,45544,671,445,42915,42915,42873,42817,42909
45745,1538,2495,24012,21733,0,45745,4.99143e+18,1471.17,7732.33,45745,638,431,42593,36940,27397,24990,33745
10373,790,1528,0,10373,3599,6774,9.50413e+15,517.759,3036.74,10373,303,209,8845,8250,5824,5131,6397
43139,510,2445,0,43139,0,43139,2.44663e+18,1491.43,7524.31,43139,612,434,35177,31051,12788,11424,10456
5035,100,523,4824,211,5035,0,4.4372e+18,197.531,1266.61,5035,108,99,4091,3262,2027,1945,1112
15787,737,1997,0,15787,0,15787,2.43326e+18,981.499,4353.11,15787,380,291,12894,11625,7109,6671,5541
28900,409,2267,15358,13542,15358,13542,4.89029e+18,1313.29,6025.53,28900,531,364,23109,20674,9188,9928,6620
28808,1119,2612,24128,4680,15172,13636,7.14218e+17,1565.09,6692.88,28808,536,374,24009,20877,17947,17478,14947
17945,1530,2421,17945,0,14964,2981,3.15841e+18,1232.85,5179.71,17945,405,309,15133,13394,14569,14063,11952
4352,154,249,0,4352,4160,192,2.54653e+16,52.585,761.905,4352,59,59,4103,4084,3889,3791,3571
8624,483,2160,7259,1365,4566,4058,6.97853e+17,476.176,3485.02,8624,263,243,6277,5652,3763,3822,2628
44104,1286,2334,35302,8802,20976,23128,8.40084e+17,1712.79,8161.84,44104,556,468,38268,32263,28443,27673,28212
14169,939,2350,11903,2266,7591,6578,7.11825e+17,1016.52,4555.41,14169,373,284,11058,10064,8128,7835,5293
39647,41,43,37396,2251,39263,384,1.06351e+14,40.398,921.525,39647,43,41,39592,39557,39464,39463,38362
11459,1487,1749,5715,5744,0,11459,5.13895e+18,806.181,3605.63,11459,300,265,9710,8871,8404,8114,8840
24397,442,1682,8661,15736,0,24397,3.68979e+13,1000.89,4640.11,24397,451,304,20767,19192,10589,8392,6319
5543,826,1513,0,5543,0,5543,2.35826e+18,186.265,2381.07,5543,234,154,4030,3934,2976,2715,2911
9763,217,1828,5071,4692,0,9763,5.04081e+18,560.04,3309.05,9763,286,263,7287,6185,2820,1915,1757
13411,24,43,12813,598,13016,395,9.8058e+13,34.9545,529.754,13411,36,35,13283,13198,11818,11798,9822
34795,201,1708,12306,22489,0,34795,3.70095e+13,1077.15,5487.26,34795,533,342,28519,26217,12268,4929,8248
8784,5,43,8424,360,8452,332,9.27679e+13,23.2931,415.848,8784,32,32,7612,6836,6126,6171,4201
38721,769,834,37950,771,38721,0,4.57567e+18,532.336,3931.83,38721,249,233,37887,37887,37601,37607,37599
39104,980,1967,19098,20006,19098,20006,4.984e+18,1417.17,6876.16,39104,529,418,34058,29934,18235,17842,21908
34816,5338,6256,13558,21258,3098,31718,6.03881e+17,507.31,10517.1,34816,1122,405,28560,28560,28288,27361,26101
17434,69,360,0,17434,16632,802,2.51793e+16,240.067,1686.93,17434,109,112,16545,16190,12779,10804,7728
36273,1335,1755,0,36273,12921,23352,9.64663e+15,1077.3,5649.82,36273,521,350,34461,31018,27776,22547,33331
18041,2296,2528,15219,2822,9558,8483,7.12534e+17,1339.71,5324.01,18041,453,333,15513,15406,14966,14801,14865
32630,311,367,0,32630,30843,1787,2.71337e+16,300.462,2393.07,32630,131,144,32108,31421,30115,28259,29583
38725,214,1679,13719,25006,0,38725,3.75557e+13,1109.82,5850.97,38725,495,366,31667,29026,12715,8112,8276
27100,686,843,26215,885,27100,0,4.56685e+18,489.011,3282.17,27100,261,202,26257,26230,25684,25708,25447
6247,225,336,0,6247,5886,361,2.75797e+16,75.3626,1011.35,6247,73,71,5911,5900,5541,5453,4827
43425,2253,2884,36077,7348,22478,20947,7.40738e+17,1752.56,8419.69,43425,653,448,40541,40289,35976,35201,37945
30107,176,361,0,30107,28501,1606,2.6648e+16,300.213,2295.25,30107,136,144,29108,28428,24886,21747,18666
35307,925,2613,29613,5694,18845,16462,7.11398e+17,1632.41,7336.36,35307,546,408,29109,25412,20875,19946,14759
13889,1564,2146,13889,0,11331,2558,3.13687e+18,1103.26,4506.13,13889,345,281,11392,10219,10863,10317,9191
10314,328,666,10082,232,10314,0,4.56461e+18,320.449,1958.95,10314,170,134,9563,9270,7438,7450,6092
37751,139,358,0,37751,35625,2126,2.72801e+16,309.761,2563.79,37751,146,161,36300,35492,29126,25572,19477
4685,1081,1356,2073,2612,0,4685,4.72491e+18,163.335,2074.81,4685,238,168,3329,3316,2816,2734,2895
19774,1322,1682,7055,12719,0,19774,3.7175e+13,841.312,4154.08,19774,437,260,18075,16727,15412,14957,16675
47095,901,1892,16715,30380,0,47095,3.7207e+13,1153.29,6556.08,47095,602,383,42929,39380,26943,26717,30672
45899,237,369,0,45899,43580,2319,2.61219e+16,313.559,2815.91,45899,151,160,44933,43947,40016,36440,34367
3591,105,272,0,3591,3372,219,2.62867e+16,56.1593,718.653,3591,61,61,3319,3278,2813,2617,2168
14223,989,1443,5028,9195,0,14223,3.77061e+13,744.355,3429.88,14223,309,249,12458,11701,9177,9267,10210
38996,205,1372,0,38996,13779,25217,9.92922e+15,1098.92,5619.93,38996,465,382,31534,28539,11944,9483,8252
14421,857,1421,5105,9316,0,14421,3.78427e+13,745.565,3435.4,14421,328,253,12599,11854,9246,9014,8331
3946,311,743,1373,2573,0,3946,3.53208e+13,79.1579,1307.27,3946,188,115,3203,3169,2200,1992,1884
9400,1019,1452,3295,6105,0,9400,3.74352e+13,412.136,2810.35,9400,278,178,7948,7615,6402,6807,6744
42946,1972,2850,42946,0,35929,7017,3.32973e+18,1720.36,8292.3,42946,654,451,39933,33583,37989,36916,35413
26447,1370,1540,9379,17068,0,26447,3.77674e+13,1041.53,4753.66,26447,420,323,24907,23473,22564,22557,24511
42984,1411,2296,23247,19737,0,42984,4.98524e+18,1533.64,7305.31,42984,632,412,39279,34451,25927,23833,29946
32220,22,43,30470,1750,31765,455,1.05304e+14,40.6476,828.706,32220,42,41,31847,31501,26844,26735,22088
23467,1206,2114,12331,11136,0,23467,5.02819e+18,1219.64,5364.01,23467,458,338,20463,18459,13792,12717,15193
39827,1671,2377,32104,7723,19107,20720,8.1751e+17,1683.21,7874.23,39827,564,440,36171,30124,30690,29616,32230
43897,2422,2808,36925,6972,23468,20429,7.03148e+17,1747.53,8305.39,43897,643,430,41089,41089,38491,37989,39898
33255,854,2707,33255,0,27756,5499,3.10804e+18,1636.32,7265.89,33255,567,419,26984,22959,17224,16175,13617
1737,1,39,1643,94,1720,17,1.03386e+14,20.8774,199.002,1737,23,24,574,574,574,574,574
23013,899,2078,12412,10601,12412,10601,4.92171e+18,1191.56,5208.98,23013,484,327,19574,17858,11640,12207,10900
8237,511,668,8025,212,8237,0,4.72006e+18,273.719,1754.13,8237,189,124,7569,7521,7301,7333,6456
16478,1176,1580,5846,10632,0,16478,3.73824e+13,794.791,3747.54,16478,372,268,14737,13751,11562,12380,12966
14989,4,43,14290,699,14567,422,9.76875e+13,34.3564,548.403,14989,36,33,12061,10626,9584,9500,6218
18434,700,1786,9064,9370,9064,9370,5.04819e+18,1159.31,4626.25,18434,350,319,15057,13190,7657,7216,8309
28078,1485,2025,14321,13757,0,28078,5.07308e+18,1349.36,5874.73,28078,442,367,25626,22339,17970,16511,20775
46022,290,2979,46022,0,38920,7102,3.25814e+18,1827.86,8737.69,46022,717,457,33386,28521,16882,12436,3917
48359,101,361,0,48359,46199,2160,2.49645e+16,303.801,2793.44,48359,148,156,46600,45777,37817,32908,25356
19496,88,350,0,19496,18591,905,2.51478e+16,221.215,1747.57,19496,107,115,18692,18375,14906,13282,9709
24232,186,1917,11841,12391,11841,12391,4.90848e+18,1289.59,5401.51,24232,429,352,17405,14008,5407,5848,2267
9641,1264,1748,4794,4847,4794,4847,5.00505e+18,637.132,3280.63,9641,283,263,7893,7347,5832,5688,6531
3286,642,1299,2576,710,1430,1856,8.94025e+17,184.861,1821.83,3286,191,153,1987,1887,1509,1401,1329
10019,2112,2360,3778,6241,0,10019,3.22126e+13,219.526,3755.71,10019,732,264,7659,7653,7473,7553,7212
39022,35,2362,0,39022,0,39022,2.44283e+18,1445.09,7083.75,39022,590,404,20251,13407,7740,4384,985
12288,241,349,0,12288,11757,531,2.46467e+16,161.327,1365.87,12288,85,86,11939,11796,11236,10938,10465
45881,199,356,0,45881,43748,2133,2.51773e+16,297.123,2716.83,45881,143,154,44815,43976,39717,36337,34265
41408,314,915,40353,1055,41408,0,4.63767e+18,609.01,4151.2,41408,324,237,39086,37198,24717,24077,14846
32297,731,1735,0,32297,11463,20834,9.53435e+15,1053.32,5337.09,32297,506,335,28711,26450,18015,12066,20117
26027,64,1719,0,26027,0,26027,2.53262e+18,1315.12,5434.01,26027,423,374,14302,8909,4094,2483,1483
25059,732,1641,0,25059,8870,16189,9.56159e+15,1003.09,4659.75,25059,464,305,22153,20442,13762,10872,12403
47965,211,1688,17054,30911,0,47965,3.82404e+13,1145.96,6547.17,47965,507,395,39162,35769,15690,5846,9956
15272,1479,1526,0,15272,5414,9858,9.51875e+15,787.63,3572.73,15272,352,264,13746,13702,13685,13733,13746
4146,19,244,0,4146,3948,198,2.62787e+16,46.3389,723.945,4146,57,57,3599,3334,2649,2152,1265
37720,338,355,0,37720,35930,1790,2.5417e+16,300.737,2482.22,37720,137,145,37335,36614,37066,36707,36603
21977,271,352,0,21977,20979,998,2.52335e+16,249.418,1865.63,21977,114,120,21509,21166,20004,19237,18762
16718,796,2012,8736,7982,8736,7982,4.94752e+18,1019.4,4486.29,16718,383,297,13859,12573,7396,7575,7375
43942,260,2417,35269,8673,20842,23100,8.31063e+17,1731.95,8269.69,43942,563,454,29870,24256,12952,14260,6433
7116,4,350,0,7116,6712,404,2.73204e+16,101.79,1098.77,7116,85,77,4300,3292,3023,2614,1747
25966,1142,1545,9180,16786,0,25966,3.76919e+13,1013.86,4701.29,25966,410,317,24057,21738,17837,17990,21217
22124,2285,2657,18703,3421,11987,10137,6.94976e+17,1296.79,5852.08,22124,472,340,19467,19456,18566,18231,18084
41583,1315,2763,41583,0,34834,6749,3.29517e+18,1716.44,8097.61,41583,669,458,36053,31064,31885,29771,25108
28757,743,2013,0,28757,0,28757,2.54621e+18,1356.28,6011.08,28757,438,379,23883,20844,10339,9200,10791
30520,1179,2240,16049,14471,16049,14471,4.91471e+18,1327.64,6193.45,30520,512,381,26890,24054,16437,16613,17924
9897,24,43,9402,495,9675,222,9.98262e+13,35.4979,457.895,9897,33,33,9790,9725,8594,8587,6807
8272,571,1847,0,8272,0,8272,2.42792e+18,259.666,3038.09,8272,250,183,6425,6024,3741,2796,2873
30061,2448,2960,0,30061,19448,10613,1.69549e+16,234.416,6357.87,30061,387,352,27101,27101,23244,22315,18016
46137,644,2911,46137,0,38441,7696,3.05337e+18,1757.9,8724.14,46137,644,465,36396,31164,21331,18821,15107
8532,153,349,0,8532,8117,415,2.53706e+16,127.497,1171.68,8532,80,79,8172,8065,7199,6691,5222
38012,1693,2005,18703,19309,18703,19309,4.98419e+18,1399.7,6801.87,38012,520,424,36007,33418,30382,29673,34071
37640,8,42,35675,1965,37011,629,1.03228e+14,38.4438,866.292,37640,41,40,34885,33150,26806,26732,17968
27549,496,2180,14685,12864,0,27549,5.02171e+18,1276.72,5816.13,27549,491,349,22414,19887,9828,9858,7161
43021,26,43,41040,1981,41759,1262,9.80301e+13,40.0038,935.728,43021,43,40,42745,42566,38305,38399,32742
44488,831,1688,15751,28737,0,44488,3.7728e+13,1138.03,6249.25,44488,526,383,40325,36780,24658,22381,28073
48275,18,42,46047,2228,46896,1379,9.81944e+13,40.3134,972.878,48275,42,40,47562,47010,39463,39204,30300
36921,1844,2365,0,36921,0,36921,2.44071e+18,1395.71,6845.08,36921,569,402,34556,33751,28537,27261,30908
46947,39,42,44561,2386,46060,887,1.02441e+14,39.7927,971.024,46947,42,41,46886,46848,46720,46718,44756
43009,241,2372,22800,20209,22800,20209,4.93012e+18,1470.39,7403.45,43009,592,418,32685,28651,12158,13306,5916
19828,279,352,0,19828,18852,976,2.59042e+16,259.086,1808.83,19828,109,118,19389,19048,18086,17238,17375
41891,1851,2395,22248,19643,22248,19643,4.89911e+18,1471.36,7314.6,41891,608,418,39496,39226,31041,29889,35952
22648,478,1970,10996,11652,0,22648,5.1524e+18,1254.98,5292.65,22648,382,338,18063,15596,6205,5257,6562
11763,411,700,11345,418,11763,0,4.53089e+18,347.392,2083.71,11763,175,147,11027,10739,9374,9445,8120
8234,1077,1263,0,8234,2907,5327,1.00212e+16,423.874,2483.74,8234,220,230,6971,6690,6147,5762,6461
37437,1080,2250,19751,17686,19751,17686,4.91943e+18,1408.14,6804.34,37437,566,405,33025,29557,18837,19707,20883
2394,133,157,0,2394,2271,123,2.84138e+16,37.5952,473.587,2394,48,41,2237,2237,2181,2213,1964
12854,359,1952,6379,6475,0,12854,4.92133e+18,851.158,3924.59,12854,351,285,9883,9026,3755,3528,3077
24759,2071,2817,24759,0,20678,4081,3.03997e+18,1484.43,6490.2,24759,478,364,21942,18967,20996,21212,18984
43491,1259,2507,0,43491,0,43491,2.43535e+18,1471.3,7523.93,43491,617,418,39159,34671,22988,20651,25224
27323,1417,2624,27323,0,22747,4576,3.33286e+18,1591.33,6578.94,27323,564,378,23492,20245,21476,19949,15250
36015,855,2297,19022,16993,19022,16993,4.92046e+18,1387.05,6728.54,36015,573,386,30865,27642,15433,17164,15072
13455,1662,3070,13455,0,10722,2733,2.89317e+18,549.093,5092.75,13455,293,331,10385,10106,9515,8931,6701
3362,655,1053,1551,1811,1551,1811,4.71542e+18,134.613,1612.42,3362,178,135,2309,2297,1869,1778,1850
8841,217,347,0,8841,8467,374,2.48262e+16,82.4162,1162.82,8841,79,82,8494,8438,7988,7817,7110
1954,186,568,750,1204,0,1954,4.32893e+13,68.1387,911.914,1954,116,99,1386,1338,994,1145,730
9101,682,1755,4681,4420,4681,4420,5.04036e+18,538.04,3182.85,9101,277,247,7312,6581,4257,4466,4274
2226,306,829,2226,0,1682,544,3.10396e+18,96.6002,1193.68,2226,115,132,1397,1328,1029,1093,819
15422,495,1707,0,15422,0,15422,2.47262e+18,1058.83,4164.92,15422,344,305,12118,10768,4782,4059,5275
27417,545,1501,9730,17687,0,27417,3.80788e+13,1021.16,4825.37,27417,403,327,23783,21718,13108,12769,10908
16953,1506,1969,8357,8596,8357,8596,4.84027e+18,1050.9,4545.12,16953,378,315,14861,13267,11534,11335,13016
33283,20,346,0,33283,31501,1782,2.67291e+16,288.649,2363.81,33283,135,143,28861,26167,20089,17574,10001
44353,2023,2509,23180,21173,0,44353,4.9913e+18,1493.57,7652.46,44353,647,432,41844,41635,35900,34559,40274
2025,432,644,732,1293,0,2025,3.82972e+13,88.6627,984.651,2025,157,110,1381,1377,1007,1036,1027
39179,261,905,38120,1059,39179,0,4.61777e+18,573.222,4019.3,39179,303,229,36563,34196,21827,21404,14796
47180,1,43,44972,2208,45914,1266,9.92563e+13,41.2324,988.341,47180,43,42,17102,17102,17102,17102,17102
3798,342,1078,0,3798,0,3798,2.55033e+18,184.119,1700.31,3798,203,173,2720,2525,1788,1723,942
16660,292,1838,8426,8234,0,16660,5.111e+18,1076.03,4411.54,16660,345,307,12660,11130,4137,3639,2336
4112,4,31,3935,177,3966,146,9.46695e+13,20.9025,254.821,4112,24,26,3354,2973,2679,2698,1863
29730,1856,2238,15563,14167,0,29730,4.98558e+18,1339.78,6118.19,29730,528,373,27492,27364,23790,23245,26483
17745,501,1967,14090,3655,8315,9430,8.61196e+17,1339.08,4941.25,17745,371,335,13113,11106,7079,7022,3660
18771,1901,2815,9412,9359,0,18771,5.00454e+18,877.676,5480.01,18771,718,302,15956,15953,11082,10558,11680
15185,1143,1243,5342,9843,0,15185,3.93569e+13,787.201,3356.42,15185,293,274,13866,12644,12541,12152,13194
36416,150,355,0,36416,34358,2058,2.73086e+16,298.751,2506.18,36416,143,156,35122,34325,28793,25173,22615
35315,19,43,33716,1599,34268,1047,9.76139e+13,37.6743,845.157,35315,41,39,34838,34466,29677,29458,24505
12336,6,43,11780,556,11967,369,9.77727e+13,28.6369,489.974,12336,35,32,11103,10284,8605,8733,5339
36761,2571,2784,36761,0,30728,6033,3.32934e+18,1716.75,7687.87,36761,648,437,33977,33977,33832,33782,33353
10776,607,1830,5217,5559,5217,5559,4.8239e+18,772.568,3554.26,10776,319,245,8452,7553,4189,3981,4266
34610,10,43,32956,1654,33742,868,1.00017e+14,40.0082,843.345,34610,41,40,32922,31732,26177,25675,16521
6401,324,1897,5352,1049,3413,2988,7.34564e+17,283.131,2855.85,6401,267,200,4402,3812,2252,2541,807
39033,1912,2762,39033,0,32541,6492,3.30374e+18,1714.76,7894.56,39033,645,446,35951,30306,34128,32823,30421
29094,1196,2506,24107,4987,15067,14027,7.46813e+17,1554.71,6662.95,29094,521,384,24476,21315,18839,18560,16331
18457,786,2391,15135,3322,9252,9205,7.77789e+17,1322.16,5308.64,18457,428,332,14433,12390,9146,9214,7216
7943,1142,2162,7943,0,6653,1290,3.24675e+18,386.454,3377.76,7943,292,197,5781,5579,5134,4793,3146
31927,15,791,31575,352,31927,0,4.7197e+18,587.3,3706.28,31927,280,228,11277,3657,3134,3024,695
39034,416,1883,0,39034,13843,25191,9.50618e+15,1123.11,6000.73,39034,554,358,33359,30684,15656,10113,9709
15794,1460,2086,12681,3113,7570,8224,8.32931e+17,1241.62,4762.52,15794,361,322,13248,11450,10918,10771,11156
18108,407,1884,9339,8769,9339,8769,4.98007e+18,1114.01,4604.91,18108,360,304,14273,12630,5979,5865,4464
1974,139,732,795,1179,795,1179,4.20605e+18,85.7508,1057.3,1974,153,94,1242,995,469,639,378
33976,34,43,32358,1618,33126,850,9.97625e+13,41.6935,844.251,33976,42,40,33866,33769,31846,31848,29386
21676,996,1823,10444,11232,0,21676,5.04727e+18,1214.01,5038.14,21676,407,343,18617,16542,10998,9902,13427
11029,968,1298,3906,7123,0,11029,3.9115e+13,643.479,2935.03,11029,263,242,9661,8979,7530,7000,8147
4239,221,302,0,4239,4000,239,2.7895e+16,64.5973,821.877,4239,67,68,3937,3923,3788,3753,3501
7982,276,356,0,7982,7522,460,2.72722e+16,154.232,1185.66,7982,89,83,7626,7532,7210,7016,6687
47243,1817,2494,0,47243,0,47243,2.44286e+18,1486.18,7851.87,47243,637,435,44749,43086,34090,31557,40350
6945,519,1970,5888,1057,3742,3203,6.8148e+17,350.145,3009.26,6945,257,185,4975,4446,3281,3263,1445
35442,298,1713,0,35442,12567,22875,9.49158e+15,1086.94,5551.47,35442,536,341,29861,27583,13515,9090,10033
25699,78,351,0,25699,24507,1192,2.53642e+16,263.22,2020.8,25699,118,128,24561,24045,19394,17017,12516
42047,356,2385,22034,20013,22034,20013,4.95579e+18,1462.93,7364.32,42047,598,431,33304,29802,12702,12593,8931
39342,1064,1805,0,39342,0,39342,2.52213e+18,1415.67,6731.93,39342,496,433,34794,30393,20402,16662,26055
3565,468,960,1972,1593,1972,1593,5.33801e+18,154.271,1564.61,3565,142,127,2605,2516,2107,1787,1620
36230,918,2753,36230,0,30078,6152,3.08128e+18,1684.54,7669.96,36230,572,440,29499,25427,19804,19022,15474
3509,113,837,0,3509,1275,2234,1.03609e+16,120.244,1403.78,3509,174,139,2579,2187,1090,717,791
17665,1445,1720,0,17665,0,17665,2.5461e+18,1133.08,4476.07,17665,351,315,15751,13805,12451,11854,14444
24044,783,1989,12510,11534,0,24044,5.09369e+18,1216.4,5358.43,24044,410,346,20284,18165,10647,9626,10349
9719,1364,1429,0,9719,3392,6327,9.28395e+15,487.646,2824.53,9719,290,201,8290,8286,8272,8281,8290
29802,258,1763,0,29802,0,29802,2.53337e+18,1353.72,5853.98,29802,465,385,22148,18900,6128,4190,5450
21288,857,1904,0,21288,0,21288,2.48647e+18,1182.18,5032.9,21288,400,331,17823,16126,10119,8929,10556
37080,19,43,35186,1894,36685,395,1.05303e+14,40.238,887.915,37080,43,42,36449,35917,30775,30514,24043
19883,259,777,19252,631,19883,0,4.55063e+18,457.915,2776.36,19883,255,181,18455,17309,11426,11111,8400
45578,1114,1887,16202,29376,0,45578,3.73025e+13,1154.92,6461.83,45578,600,381,42682,38538,29011,29314,34410
42768,292,2220,22414,20354,22414,20354,4.9566e+18,1530.69,7332.86,42768,590,432,33110,29131,11931,12193,4882
2661,19,37,2511,150,2660,1,1.09692e+14,23.779,228.25,2661,24,24,2596,2563,2225,2223,1916
17341,82,2469,14521,2820,9152,8189,7.21712e+17,1229.91,5133.21,17341,469,302,10006,7003,4800,4872,1131
20815,1452,1721,9979,10836,0,20815,5.13904e+18,1200.8,4836.97,20815,378,338,18736,16416,14716,13937,17186
21406,1257,2573,17466,3940,10111,11295,7.83481e+17,1594.9,6073.93,21406,512,352,17200,15105,12499,12472,11444
11868,414,1509,0,11868,4187,7681,9.53103e+15,645.742,3164.6,11868,304,241,9797,9189,5085,3807,3852
35975,2234,2694,35975,0,30063,5912,3.28827e+18,1638.35,7491.26,35975,586,431,33281,33121,32575,32752,31984
37084,737,923,36058,1026,37084,0,4.63243e+18,571.366,3924.26,37084,295,225,36161,35978,34621,34587,33227
32108,778,1708,0,32108,11383,20725,9.55451e+15,1084.39,5314.54,32108,494,339,28630,26372,17789,13397,19475
12222,32,43,11609,613,11977,245,1.01932e+14,37.3137,511.875,12222,36,35,12149,12106,11260,11283,10077
35115,169,353,0,35115,33530,1585,2.50022e+16,278.95,2362.76,35115,131,141,34157,33500,29939,26418,23150
39024,190,2412,0,39024,0,39024,2.43775e+18,1410.51,7112.41,39024,593,406,28899,23855,10298,3877,4499
4426,985,1204,0,4426,0,4426,2.5261e+18,187.793,1951.92,4426,224,187,3222,3220,3027,2954,2797
4934,705,1218,0,4934,0,4934,2.22721e+18,95.3486,1897.47,4934,217,137,3716,3707,3062,3162,2895
18776,1315,2347,15633,3143,9819,8957,7.30187e+17,1318.16,5269.68,18776,405,329,15794,13856,12687,12479,11587
44329,2196,2488,23282,21047,23282,21047,4.89352e+18,1472.35,7619.52,44329,622,426,41841,41841,39518,39268,40656
46491,2243,2700,23297,23194,23297,23194,5.00913e+18,1106.16,7952.68,46491,541,437,43791,43785,37625,36449,41028
29430,1705,2032,0,29430,0,29430,2.47221e+18,1328.02,5982.76,29430,459,371,27398,24032,22670,20739,25603
39064,93,356,0,39064,37240,1824,2.52841e+16,292.88,2514.84,39064,137,148,37512,36828,29613,25884,20477
42211,194,367,0,42211,40194,2017,2.53315e+16,300.186,2653.81,42211,143,151,41145,40334,36284,32776,30794
30303,989,2435,30303,0,25090,5213,3.02577e+18,1586.44,6819.66,30303,506,415,24908,21485,17448,16617,14545
31084,139,1446,0,31084,10998,20086,9.81518e+15,1058.54,5092.44,31084,439,350,24324,21251,9007,6682,4870
32704,498,2303,0,32704,0,32704,2.43608e+18,1377.35,6438.47,32704,551,387,26597,23702,11304,9878,9137
10857,1274,2095,10857,0,9056,1801,3.13567e+18,790.053,3846.63,10857,282,260,8762,7885,7707,7581,6606
656,8,16,651,5,588,68,7.42309e+13,7.71189,82.0557,656,13,11,627,610,540,537,450
38439,1391,2390,0,38439,0,38439,2.43814e+18,1431.94,7051.57,38439,580,403,34913,30499,21918,19882,25495
9340,515,1343,3380,5960,0,9340,3.93333e+13,468.076,2714.93,9340,231,233,7869,7310,4988,4813,4771
40383,381,2310,21571,18812,0,40383,4.99682e+18,1521.24,7141.34,40383,622,410,32330,29010,12974,12711,7953
30235,1829,2024,15415,14820,15415,14820,4.9612e+18,1338.06,6050.76,30235,475,387,28211,28127,26306,26282,27786
31982,206,353,0,31982,30159,1823,2.7305e+16,296.216,2343.25,31982,138,146,31063,30324,27055,24329,23196
13675,1293,1543,4816,8859,0,13675,3.68708e+13,750.563,3438.31,13675,332,249,12132,11285,10543,10750,11501
7347,23,43,6992,355,7136,211,9.84993e+13,32.198,385.982,7347,30,28,7266,7220,6506,6505,5471
19802,1969,2084,15880,3922,9388,10414,8.37338e+17,1447.2,5364.37,19802,380,344,17704,15013,17344,17056,17502
18580,361,1581,0,18580,6635,11945,9.63559e+15,822.022,3938.65,18580,378,284,15697,14532,8755,5166,5387
41565,2413,2901,41565,0,34848,6717,3.33386e+18,1759.88,8246.26,41565,683,441,38664,38664,38018,38219,37833
40190,1085,1766,19109,21081,0,40190,5.14625e+18,1439.52,6791.4,40190,514,430,35631,31008,21394,17796,24844
34254,243,397,0,34254,32577,1677,2.59588e+16,290.022,2474.62,34254,141,144,33503,32836,30030,27631,25634
32164,345,357,0,32164,30643,1521,2.5403e+16,283.701,2295.29,32164,129,136,31806,31428,31664,31543,31360
31978,82,354,0,31978,30534,1444,2.49379e+16,272.859,2252.23,31978,126,138,30629,30013,24183,20796,15581
25945,570,2548,21754,4191,13800,12145,7.13307e+17,1444.56,6263.57,25945,507,348,20191,17575,11623,12113,8185
31413,60,2393,26008,5405,16208,15205,7.46052e+17,1606.16,6872.54,31413,502,393,16212,9996,6622,7013,979
44457,64,2497,0,44457,0,44457,2.45008e+18,1458.82,7616.38,44457,610,430,26938,19370,10915,4262,1813
20145,1275,1508,0,20145,7178,12967,9.65936e+15,916.059,4121.7,20145,375,294,18571,16953,16007,14577,17559
28740,423,852,27967,773,28740,0,4.53141e+18,504.45,3414.31,28740,247,206,27444,26568,20888,20698,18671
13263,254,347,0,13263,12668,595,2.47799e+16,174.781,1421.32,13263,87,91,12905,12750,12156,11841,11766
9307,839,1325,3254,6053,0,9307,3.74468e+13,445.706,2685.78,9307,264,190,7982,7552,6025,6159,6428
45814,942,1778,0,45814,16224,29590,9.68157e+15,1142.15,6456.24,45814,526,380,42154,38106,25965,20768,26878
4444,1123,1144,0,4444,0,4444,2.49948e+18,195.378,1807.28,4444,232,173,3300,3300,3300,3300,3300
29223,1029,1971,14524,14699,0,29223,5.07072e+18,1353.4,5950.69,29223,455,388,25363,22471,14072,12246,16104
22536,603,2428,18708,3828,11680,10856,7.4309e+17,1457.49,5840.8,22536,454,348,17428,15167,10169,10435,6630
23528,41,43,22244,1284,23192,336,1.0529e+14,39.1888,706.457,23528,40,37,23479,23461,23408,23407,22709
26524,1582,1648,9428,17096,0,26524,3.72352e+13,991.983,4756.72,26524,451,302,24876,24876,24691,24613,24704
41027,68,2293,19563,21464,19563,21464,4.97025e+18,1637.08,7570.68,41027,592,438,22066,13877,6553,6786,1517
3858,383,819,0,3858,1415,2443,9.84506e+15,139.476,1395.46,3858,202,148,3039,2942,2429,2368,1503
15734,286,1876,8000,7734,0,15734,5.07618e+18,1003.07,4287.95,15734,339,298,12006,10605,4656,4014,3297
24017,61,350,0,24017,22884,1133,2.52654e+16,262.557,1966.56,24017,115,120,22796,22195,17275,14837,9957
3303,257,1124,1517,1786,0,3303,4.75154e+18,130.337,1649.5,3303,202,128,2179,1923,843,700,804
25782,2002,2297,13399,12383,0,25782,4.95485e+18,1278.8,5774.54,25782,512,348,23485,23417,21532,21082,22096
13474,334,1687,6459,7015,6459,7015,5.02156e+18,967.489,3876.8,13474,314,292,10184,9063,3700,3460,3494
36410,209,1637,12897,23513,0,36410,3.78019e+13,1081.97,5633.77,36410,472,364,29773,27234,11825,9055,6874
20869,434,839,20432,437,20869,0,4.68814e+18,451.663,2921.26,20869,240,183,19825,19244,16004,15666,12825
22123,1302,2591,22123,0,18604,3519,3.27748e+18,1369.89,5837.63,22123,507,342,18535,16286,15109,14391,13252
6060,104,1579,0,6060,0,6060,2.35974e+18,169.837,2463.04,6060,246,155,4097,3219,1737,961,210
49684,167,2953,41387,8297,26000,23684,7.34818e+17,1795.12,9004.56,49684,681,472,33406,23502,15716,17143,4169
44309,743,1786,0,44309,15713,28596,9.58451e+15,1157.56,6310.37,44309,558,378,39572,36232,23461,17018,25908
12496,544,1707,5986,6510,5986,6510,5.04009e+18,924.57,3769.05,12496,304,272,9784,8670,4170,3729,4213
12385,1589,2345,10369,2016,6518,5867,7.19059e+17,873.899,4240.37,12385,359,284,10040,9072,8600,8441,8197
12452,706,2131,12452,0,10037,2415,3.09444e+18,1043.08,4247.39,12452,305,302,9337,8139,5464,4959,4429
40455,557,1899,19671,20784,19671,20784,4.99456e+18,1430.29,6947.96,40455,513,434,33007,28702,12981,13072,14621
44107,1553,2234,22862,21245,0,44107,5.04286e+18,1530.66,7471.02,44107,572,441,41099,35588,28075,25314,34768
9794,1336,1533,3478,6316,0,9794,3.73259e+13,465.096,2888.06,9794,308,214,8261,8000,7762,7599,8094
1050,7,33,994,56,1049,1,1.18756e+14,17.3619,144.692,1050,18,20,945,893,733,724,426
7731,687,1306,2706,5025,0,7731,3.76332e+13,323.62,2448.99,7731,253,185,6425,6176,4494,4807,4518
34831,786,1935,0,34831,12356,22475,9.5254e+15,1107.9,5808.38,34831,538,370,31064,28414,18019,13089,16003
18357,706,1580,6570,11787,0,18357,3.76133e+13,803.682,3905.48,18357,372,276,16148,14989,10776,10191,10988
30542,1237,2595,25406,5136,15874,14668,7.34548e+17,1620.65,6909.32,30542,569,390,25731,22330,19989,19841,16852
12788,1032,2148,10619,2169,6626,6162,7.30783e+17,1028.86,4234.57,12788,348,289,10121,8985,7258,7291,6283
11799,506,1420,0,11799,4220,7579,9.69368e+15,609.377,3058.01,11799,291,240,9964,9289,6353,4705,4826
9887,335,713,9518,369,9887,0,4.38849e+18,302.165,1932.1,9887,179,141,9114,8791,6643,6879,5662
11225,360,1790,0,11225,0,11225,2.46786e+18,792.199,3621.48,11225,300,233,8520,7609,3319,2613,2285
8102,176,1798,4143,3959,0,8102,5.11788e+18,403.447,3056.16,8102,243,220,5769,4706,2249,1945,914
37529,295,354,0,37529,35817,1712,2.52084e+16,289.552,2461.5,37529,138,144,36997,36264,34892,33370,33012
28486,1122,2172,0,28486,0,28486,2.43994e+18,1318.45,5894.84,28486,490,353,25105,22453,15509,14317,16024
15747,1749,2056,15747,0,12544,3203,3.07108e+18,1278.84,4745.78,15747,337,327,13491,11594,13163,13200,12697
33533,1365,2936,152,33381,12132,21401,2.68527e+16,835.912,6806.98,33533,820,393,30597,30418,15867,19667,11540
24600,32,43,23299,1301,24186,414,1.03208e+14,40.9786,721.532,24600,41,39,24488,24403,22435,22449,20031
48926,2000,2460,25332,23594,0,48926,4.99894e+18,1498.61,8024.71,48926,631,442,46466,46465,38606,37150,43880
12115,3,43,11487,628,11892,223,1.02762e+14,34.2357,498.37,12115,36,32,8825,7533,6923,6867,4688
43763,1327,1813,20854,22909,20854,22909,5.02106e+18,1482.94,7161.59,43763,524,447,40187,34431,26749,24419,31368
48256,1436,2910,48256,0,40149,8107,3.30066e+18,1782.22,8864.03,48256,674,471,42533,36314,39130,35937,27450
17738,162,1638,6283,11455,0,17738,3.69571e+13,861.818,3966.15,17738,404,276,14020,12687,5941,2319,2956
7437,1047,1279,0,7437,2753,4684,6.77318e+15,259.787,2498.55,7437,332,213,6158,6154,6037,6152,5414
12935,1368,1439,0,12935,4539,8396,9.63043e+15,688.04,3278.64,12935,299,240,11496,11496,11319,11210,11459
5325,1031,1140,0,5325,1881,3444,9.67637e+15,143.657,1963,5325,204,182,4185,4185,4175,4159,4056
37481,353,1632,13259,24222,0,37481,3.77809e+13,1101.19,5700.54,37481,488,364,31743,29085,15365,11901,10573
36055,599,1502,0,36055,12708,23347,9.78889e+15,1078.05,5512.83,36055,483,369,31511,28750,17374,13309,18539
43749,2227,2510,23134,20615,23134,20615,4.8785e+18,1460.89,7559.69,43749,628,420,41239,41239,39222,39163,39989
22931,683,1345,0,22931,8112,14819,9.95283e+15,974.728,4294.43,22931,356,322,20155,18443,12147,9412,12651
5119,508,1147,0,5119,1840,3279,9.70666e+15,198.381,1948.02,5119,198,181,3972,3810,2507,2712,2397
47705,1426,2489,0,47705,0,47705,2.44433e+18,1494.45,7893.57,47705,652,433,43883,38303,26945,23379,35074
3093,670,1257,2486,607,1438,1655,8.48976e+17,130.855,1725.33,3093,182,121,1836,1805,1443,1509,1223
32633,34,42,30988,1645,32013,620,1.02359e+14,38.1039,809.811,32633,40,38,32553,32494,30740,30806,29166
9969,48,349,0,9969,9447,522,2.63612e+16,184.018,1297.94,9969,91,85,9272,8892,6738,5862,3775
18232,192,691,0,18232,17395,837,2.31564e+16,163.463,2354.55,18232,125,117,17512,17264,15000,12523,9972
15400,468,2363,15400,0,12843,2557,3.28798e+18,1142.65,4800.6,15400,398,287,11449,10052,6494,5927,3496
8415,1064,1824,0,8415,0,8415,2.46223e+18,388.173,3079.15,8415,280,248,6591,6338,4555,4383,4873
14196,84,702,13775,421,14196,0,4.55794e+18,379.387,2296.07,14196,214,162,10948,8108,5032,4875,2314
7192,822,1353,0,7192,2548,4644,9.72987e+15,207.406,2406.48,7192,241,169,5839,5764,4740,3701,4008
34694,9,358,0,34694,32703,1991,2.7287e+16,309.325,2461.37,34694,144,150,26086,21838,17698,15610,9176
12471,271,702,12095,376,12471,0,4.46026e+18,375.198,2182.44,12471,223,162,11508,10876,7250,7098,5597
10738,44,739,10526,212,10738,0,4.51505e+18,327.408,2056.19,10738,202,146,6666,3998,2614,2266,807
16277,164,1307,0,16277,5816,10461,1.00702e+16,845.636,3576.92,16277,307,282,12819,11676,4864,3673,3384
40569,389,799,40057,512,40569,0,4.70452e+18,564.834,4102.42,40569,279,244,38782,37136,26168,25896,23371
37681,13,823,36894,787,37681,0,4.68951e+18,543.015,3926.1,37681,266,230,13128,3791,3659,4117,746
2085,361,551,0,2085,749,1336,1.0421e+16,85.9645,906.14,2085,93,91,1534,1525,1473,1333,1339
2705,268,872,1377,1328,0,2705,5.50867e+18,123.534,1344.45,2705,117,121,1833,1719,1035,895,910
7533,7,43,7090,443,7469,64,1.06567e+14,28.6466,393.706,7533,33,31,6790,6296,5122,5117,3495
9496,20,43,9114,382,9137,359,9.34597e+13,28.5213,436.157,9496,33,32,9374,9294,8220,8167,6908
6812,1231,1470,3480,3332,0,6812,5.34465e+18,373.94,2597.71,6812,232,207,5342,5316,5200,5228,5087
14517,347,354,0,14517,13683,834,2.73102e+16,244.894,1594.01,14517,105,106,14157,13958,14121,14101,13950
20409,216,1507,7268,13141,0,20409,3.81052e+13,938.007,4168.34,20409,352,293,16609,15278,7198,4656,4386
19932,600,656,19638,294,19932,0,4.73989e+18,437.291,2715.56,19932,213,190,19276,19113,19044,19039,18943
37669,283,355,0,37669,35933,1736,2.53481e+16,289.478,2466,37669,138,144,37089,36388,34481,33024,32539
40717,1416,2315,20235,20482,20235,20482,4.98197e+18,1522.69,7449.05,40717,551,431,37100,32187,23868,22269,30608
40487,803,2422,40487,0,33165,7322,3.03615e+18,1780.58,7891.28,40487,577,452,32501,27276,18244,16315,16360
5309,1591,1768,4319,990,2560,2749,7.86632e+17,231.874,2617.93,5309,210,190,3541,3540,3520,3514,3311
19499,115,1932,10093,9406,0,19499,5.0006e+18,1120.92,4761.34,19499,399,314,13384,10153,4983,3706,1440
8760,402,2070,7183,1577,4437,4323,7.75762e+17,633.007,3488.76,8760,297,250,6214,5492,3229,3307,2004
23379,28,43,22168,1211,22962,417,1.03409e+14,37.3795,694.858,23379,39,38,23235,23156,20889,20911,18885
23409,1259,2583,0,23409,0,23409,2.43919e+18,1366.8,6018.53,23409,673,348,19722,17589,10319,9344,15677
25172,27,42,23764,1408,24916,256,1.06878e+14,38.8561,719.773,25172,40,38,25000,24908,22096,22136,19629
45600,484,2097,22975,22625,22975,22625,4.99863e+18,1452.23,7494.85,45600,549,444,36959,32399,13830,14167,13580
6751,647,1955,5628,1123,3546,3205,7.32499e+17,213.402,2948.22,6751,256,180,4796,4548,3452,3446,2380
22889,1821,2049,0,22889,0,22889,2.4497e+18,1180.81,5231.36,22889,461,336,20840,20534,19016,18970,19325
23767,1320,1415,0,23767,8391,15376,9.73652e+15,984.209,4438.12,23767,414,304,22352,20927,21407,19878,21581
30145,2078,2198,15908,14237,15908,14237,4.91958e+18,1297.76,6082.7,30145,531,376,27947,27947,27209,27233,27278
2955,13,37,2786,169,2954,1,1.11066e+14,24.1658,241.384,2955,25,24,2837,2776,2405,2328,1675
6296,408,1226,0,6296,2217,4079,9.71285e+15,182.208,2169.49,6296,197,193,5070,4879,2737,2812,2340
46877,23,43,44708,2169,45578,1299,9.8709e+13,39.8873,981.669,46877,43,41,46458,46078,40484,40367,32955
8327,80,350,0,8327,7956,371,2.53635e+16,83.4881,1148.69,8327,81,84,7911,7770,6433,5693,4694
37599,321,2749,37599,0,31376,6223,3.32831e+18,1682.6,7726.11,37599,644,432,27475,23441,14080,11614,5709
7620,1636,1729,3825,3795,0,7620,5.10354e+18,386.212,2933.35,7620,254,234,5891,5787,5768,5760,5737
41393,1992,2150,33143,8250,19556,21837,8.38859e+17,1719.45,7784.52,41393,537,449,39235,39067,38144,37557,38821
47800,11,43,45568,2232,46517,1283,9.90112e+13,41.501,994.419,47800,43,41,45820,44359,36537,35663,25978
19277,1561,1897,9556,9721,0,19277,5.02049e+18,1183.72,4807.07,19277,386,325,17257,15197,13746,13159,16012
23706,1359,1678,8411,15295,0,23706,3.70773e+13,962.804,4554.98,23706,461,300,22010,20068,18702,19070,20660
20779,742,2084,11234,9545,11234,9545,5.01702e+18,1093.26,4991.09,20779,412,318,17318,15533,9922,10010,8816
20156,2104,2482,16657,3499,10322,9834,7.55466e+17,1331.1,5566.49,20156,454,335,17674,15577,16208,15873,16949
15106,16,43,14406,700,14673,433,9.78812e+13,34.6339,557.89,15106,37,35,14783,14536,12294,12229,9830
33397,587,2306,17611,15786,17611,15786,4.91911e+18,1376.37,6504.37,33397,554,389,27542,24558,12038,13759,11556
29947,1207,3808,13840,16107,0,29947,4.82146e+18,891.19,7841.03,29947,429,484,25767,23556,14033,12177,14037
8488,90,652,8214,274,8488,0,4.54085e+18,255.977,1757.65,8488,158,127,6636,4998,2980,2831,1773
22330,1048,2421,18608,3722,11748,10582,7.2599e+17,1366.07,5742.66,22330,466,349,18281,16208,13688,13336,10693
22851,69,1949,11637,11214,0,22851,5.05432e+18,1258.95,5233.68,22851,427,342,13623,9573,4937,3540,1052
13706,36,43,13061,645,13338,368,9.9336e+13,33.5068,526.424,13706,36,33,13655,13635,13188,13194,12712
1733,37,39,1653,80,1691,42,1.01188e+14,19.1027,196.719,1733,23,23,1694,1694,1694,1693,1679
44543,362,1890,0,44543,15755,28788,9.48977e+15,1161.77,6408.03,44543,602,371,37793,34635,16764,11648,16066
33571,236,2022,0,33571,0,33571,2.47803e+18,1433.65,6396.09,33571,485,403,25065,21663,8427,5042,5534
18303,1026,1532,0,18303,6385,11918,9.78638e+15,944.58,4055.46,18303,359,300,16348,15038,11637,9710,12968
1424,50,607,1424,0,1193,231,2.78141e+18,122.963,848.738,1424,98,105,460,220,169,123,106
892,120,233,340,552,0,892,4.2767e+13,39.1491,378.91,892,73,43,659,652,564,593,311
1282,303,480,1074,208,692,590,7.77517e+17,120.95,709.09,1282,89,90,802,790,664,655,665
38941,865,2341,38941,0,31282,7659,3.07772e+18,1696.6,7731.31,38941,524,455,31366,26059,17844,16686,14871
34131,2332,2677,28382,5749,17721,16410,7.3859e+17,1689.38,7347.93,34131,578,410,31454,31230,29676,29302,30694
49700,852,884,48303,1397,49700,0,4.57582e+18,597.913,4485.43,49700,320,252,48816,48809,48777,48777,48681
29139,529,1353,10282,18857,0,29139,3.84972e+13,1042.39,4849.48,29139,423,343,25230,22898,13196,10790,14172
28548,230,345,0,28548,26960,1588,2.73889e+16,279.535,2187.11,28548,132,141,27858,27240,24722,22652,22602
19668,284,656,19266,402,19668,0,4.65141e+18,435.188,2674.67,19668,201,186,18466,17650,12647,12651,9715
23947,16,44,22614,1333,23703,244,1.06492e+14,40.7949,717.625,23947,42,39,23368,22918,18659,18319,13936
12355,7,43,11819,536,11946,409,9.70984e+13,35.6163,510.425,12355,37,34,11321,10667,8856,8829,6190
26174,110,2071,0,26174,0,26174,2.47385e+18,1340.22,5670.96,26174,452,356,17386,12429,6294,2704,301
45087,369,970,43981,1106,45087,0,4.62305e+18,609.719,4373.18,45087,294,241,42959,41255,26686,26753,22534
27100,2007,2494,22684,4416,14380,12720,7.17271e+17,1522.25,6391.95,27100,475,377,24564,21031,21875,21245,22734
1306,3,30,1224,82,1293,13,1.13797e+14,14.7695,144.583,1306,19,18,934,785,692,708,540
1187,403,422,0,1187,411,776,9.89538e+15,30.6057,625.035,1187,99,79,765,765,763,756,748
40926,411,910,40064,862,40926,0,4.63569e+18,541.127,4163.01,40926,290,240,39253,37910,27468,27971,24387
48972,720,916,47672,1300,48972,0,4.48314e+18,565.742,4463.29,48972,294,250,48056,47937,44494,44217,43684
33138,46,2147,26528,6610,15703,17435,8.43512e+17,1646.21,6971.37,33138,510,427,13900,6815,3878,4148,1054
4116,19,535,4105,11,4116,0,4.87837e+18,193.072,1208.75,4116,134,100,1647,657,511,459,177
20639,1527,2355,17293,3346,10978,9661,7.0945e+17,1354.54,5467.41,20639,452,331,17815,15517,14833,14993,14757
9548,493,653,9271,277,9548,0,4.49189e+18,314.992,1871.8,9548,164,138,8895,8768,8164,8217,7713
21037,435,1642,7442,13595,0,21037,3.69033e+13,913.767,4256.17,21037,430,282,17840,16557,9813,7840,8679
9578,32,348,0,9578,9209,369,2.33372e+16,74.8653,1169.65,9578,81,82,8926,8544,6899,6352,4493
46262,182,1946,16425,29837,0,46262,3.70009e+13,1164.37,6542.09,46262,632,383,37560,34469,16098,12404,7227
7108,1485,1843,5980,1128,3883,3225,6.94062e+17,293.206,2916.43,7108,253,199,5265,5263,4967,4920,4655
41050,1151,2377,0,41050,0,41050,2.45204e+18,1451.66,7269.69,41050,604,416,36511,32433,20488,19374,23983
35675,328,354,0,35675,33633,2042,2.72476e+16,308.155,2482.56,35675,142,154,35226,34294,34152,33939,33978
22288,390,2135,0,22288,0,22288,2.46851e+18,1176.54,5284.67,22288,423,325,17617,15771,6359,4955,3541
14102,94,1432,0,14102,4996,9106,9.67938e+15,772.609,3428.39,14102,303,257,10520,8860,4148,2955,1868
13893,950,1847,6960,6933,6960,6933,4.97091e+18,937.503,4067.22,13893,349,283,11402,10473,7163,7200,7385
26148,1726,2621,21991,4157,14045,12103,7.0628e+17,1458.27,6298.38,26148,479,351,23083,20083,19235,19254,18014
38719,257,1795,0,38719,13786,24933,9.47566e+15,1167.94,5855.82,38719,584,351,32288,29738,14422,8528,8299
24290,1527,2441,20333,3957,12867,11423,7.18918e+17,1503.22,6042.15,24290,472,348,20894,18198,17492,17502,15928
15691,230,1520,5558,10133,0,15691,3.70956e+13,779.898,3625.07,15691,386,260,12854,11934,5684,3901,3250
35087,709,2156,35087,0,28076,7011,2.9371e+18,1663.74,7171.6,35087,463,436,27436,22731,14120,12982,12267
30071,45,354,0,30071,28394,1677,2.73293e+16,287.833,2270.35,30071,134,143,27865,26446,19196,16476,10570
3692,88,221,0,3692,3509,183,2.70314e+16,53.7194,660.886,3692,53,51,3471,3440,3055,2912,1986
28047,307,2561,23197,4850,14386,13661,7.50713e+17,1582.09,6605.07,28047,560,384,20277,17152,9928,10866,4625
32675,1818,2263,17194,15481,17194,15481,4.9377e+18,1373.73,6432.87,32675,532,385,30412,28770,25608,24757,27888
5917,393,530,5853,64,5917,0,4.73235e+18,209.656,1416.74,5917,120,119,5387,5352,5102,5143,4764
12523,854,3286,5537,6986,5537,6986,4.34551e+18,494.69,5051.14,12523,822,250,9237,8349,4218,4433,3962
25604,622,2626,25604,0,20685,4919,2.91869e+18,1499.32,6567.96,25604,468,378,19441,16027,9651,7902,7972
33202,264,858,32211,991,33202,0,4.51101e+18,534.085,3662.87,33202,243,217,30954,29013,18302,17220,12352
26254,803,2182,14023,12231,0,26254,5.01492e+18,1244.65,5678.55,26254,481,340,22212,20018,11898,11324,11187
4107,1265,1475,4107,0,3346,761,3.40512e+18,187.075,2122.99,4107,230,164,2632,2580,2630,2630,2571
31053,321,356,0,31053,29634,1419,2.49707e+16,280.294,2231.12,31053,129,134,30624,30038,29743,28486,29006
18794,272,350,0,18794,17941,853,2.49292e+16,219.966,1706.78,18794,105,113,18373,18102,17229,16589,16633
30069,906,2218,0,30069,0,30069,2.44671e+18,1382.96,6190.7,30069,520,377,25537,22893,13447,12249,15227
23011,899,2192,18696,4315,11457,11554,8.00105e+17,1435.24,5780.34,23011,429,376,18605,16044,12970,12265,10890
35345,77,809,34606,739,35345,0,4.60732e+18,539.698,3752.73,35345,264,229,26183,17814,10851,9987,3947
28694,1629,1979,14629,14065,14629,14065,4.95868e+18,1363.48,5892.61,28694,458,368,26548,23097,20751,19827,24240
41757,12,43,39737,2020,40805,952,1.01395e+14,40.5172,932.193,41757,43,40,40218,39145,31972,31092,23206
35349,1282,2356,0,35349,0,35349,2.42733e+18,1444.74,6761.62,35349,581,401,31696,27889,19075,16426,22328
39703,559,919,38648,1055,39703,0,4.59977e+18,574.832,4052.79,39703,297,232,38616,37475,34290,33982,31361
5104,26,1100,1766,3338,0,5104,3.54677e+13,128.82,1854.67,5104,213,133,3065,2382,1405,1031,757
10022,2,43,9471,551,9896,126,1.0754e+14,34.6704,462.301,10022,34,32,5837,4641,4353,4641,3375
45851,1821,2139,22750,23101,0,45851,5.07688e+18,1453.58,7557.4,45851,556,453,43712,43712,37515,36373,42365
16400,1262,2029,8620,7780,8620,7780,4.90148e+18,991.791,4439.85,16400,412,284,13998,12827,10058,9987,9949
41595,155,354,0,41595,39710,1885,2.505e+16,295.648,2579.92,41595,139,152,40414,39647,34738,29817,26237
3601,641,981,0,3601,0,3601,2.70007e+18,191.587,1607.32,3601,137,129,2620,2521,2436,2438,2017
37311,1115,2011,18710,18601,0,37311,5.09058e+18,1418.46,6740.88,37311,496,415,33137,29058,19918,17155,22959
34987,1065,1629,12359,22628,0,34987,3.76293e+13,1087.4,5524.46,34987,472,356,32435,29329,22463,24014,27068
2838,678,761,1716,1122,1716,1122,4.77211e+18,44.7061,1180.68,2838,141,94,2077,2077,2068,2052,1977
36883,634,2366,19415,17468,0,36883,4.99714e+18,1425.19,6902.05,36883,581,395,30576,27003,12413,13518,10850
22308,184,353,0,22308,21243,1065,2.53113e+16,260.021,1902.83,22308,115,122,21634,21242,19126,17462,15159
43342,859,899,41988,1354,43342,0,4.45396e+18,579.217,4191.2,43342,282,234,42443,42434,42276,42281,42235
40551,23,43,38719,1832,39340,1211,9.75319e+13,40.2123,910.447,40551,42,40,40202,39930,35404,35315,30760
9316,1354,1674,0,9316,0,9316,2.5201e+18,563.124,3139.77,9316,270,264,7642,7270,6307,6141,6782
43939,2020,2499,23272,20667,23272,20667,4.9418e+18,1458.33,7593.29,43939,606,430,41440,41440,34277,33449,38640
47076,235,1939,16717,30359,0,47076,3.71415e+13,1159.67,6590.09,47076,637,377,39078,36063,16088,11216,4401
4803,206,1087,0,4803,1662,3141,9.05574e+15,135.581,1819.55,4803,215,132,3685,3411,1729,1879,1214
7272,520,681,7189,83,7272,0,4.63116e+18,251.137,1718.09,7272,182,128,6591,6565,6113,6108,5964
7064,111,1716,3760,3304,0,7064,5.02277e+18,252.243,2740.31,7064,276,181,4722,3576,1876,1400,402
14238,1305,1400,5033,9205,0,14238,3.78837e+13,760.908,3418.13,14238,305,252,12838,11904,12200,12181,12585
1746,284,643,1341,405,738,1008,9.22317e+17,91.8144,954.943,1746,110,91,1103,1059,854,763,636
38180,512,884,37202,978,38180,0,4.59763e+18,574.171,3965.54,38180,301,226,36931,35818,31619,31731,25687
40996,379,2247,20726,20270,20726,20270,4.94438e+18,1427.27,7234.18,40996,575,432,32500,28904,11300,11905,10677
14308,1494,1996,7541,6767,0,14308,4.99927e+18,911.527,4130.8,14308,360,282,12312,11248,9706,9304,10108
3974,51,1115,1917,2057,1917,2057,4.96288e+18,162.894,1732.5,3974,169,153,1925,1116,498,690,111
16041,1598,1919,8317,7724,0,16041,5.10434e+18,1036.84,4354.65,16041,352,299,14091,12731,11601,11317,12315
37470,1149,2486,0,37470,0,37470,2.44754e+18,1395.72,7009.97,37470,573,403,33196,29618,18421,16958,19118
19136,23,43,18227,909,18675,461,1.00082e+14,37.5695,625.171,19136,38,36,18954,18794,16628,16584,13199
10727,14,43,10221,506,10432,295,9.83473e+13,33.8439,475.472,10727,33,33,10419,10196,8476,8277,6709
13999,340,1877,0,13999,0,13999,2.47258e+18,859.918,3966.33,13999,359,276,10997,9965,5107,3492,3142
39459,667,1366,13914,25545,0,39459,3.88842e+13,1084.07,5634.94,39459,468,379,35180,31875,19777,18087,20735
26446,900,2553,26446,0,22093,4353,3.25637e+18,1516.29,6372.42,26446,572,368,21492,18524,14911,13961,10761
3444,300,902,0,3444,1202,2242,9.10227e+15,99.9837,1449.7,3444,201,127,2542,2471,1657,1542,1477
5405,699,1056,0,5405,1988,3417,1.00678e+16,159.527,1833.49,5405,196,142,4349,4302,3948,2549,2614
32816,2051,2071,16919,15897,0,32816,5.10351e+18,1356.89,6321.81,32816,468,395,30745,30745,30698,30606,30745
17393,1487,2167,14306,3087,8866,8527,7.63082e+17,1279.39,5013.03,17393,368,325,14760,12776,12358,12305,12005
49489,57,607,48979,510,49489,0,4.74309e+18,514.454,4197.21,49489,263,264,32533,18217,11892,11153,5028
42443,1059,2490,0,42443,0,42443,2.42807e+18,1481.49,7513.38,42443,635,415,37308,32948,19299,17993,21478
6132,699,1798,6132,0,5183,949,3.34001e+18,195.643,2695.29,6132,219,172,4334,4134,3373,3270,1464
7917,551,1322,0,7917,2773,5144,9.55372e+15,329.799,2475.28,7917,269,186,6595,6245,4061,3336,3712
49639,1441,1794,23544,26095,23544,26095,5.00929e+18,1465.28,7555.26,49639,543,461,46699,39632,33644,31670,41911
21443,178,357,0,21443,20219,1224,2.73102e+16,279.822,1942.76,21443,120,129,20669,20164,17583,15290,12867
40844,584,600,40451,393,40844,0,4.74399e+18,498.54,3799.82,40844,252,249,40244,40244,40051,40083,40067
47831,1162,2483,0,47831,0,47831,2.46133e+18,1449.79,7980.78,47831,586,444,42860,37495,22498,21520,27086
30720,1162,1555,0,30720,10865,19855,9.61879e+15,1049.17,5090.71,30720,434,335,28680,25856,21938,16920,24875
30377,2439,2554,30377,0,25374,5003,3.29072e+18,1588.24,6820.81,30377,513,385,27823,27822,27684,27670,27409
1778,229,564,0,1778,633,1145,9.86909e+15,51.0664,869.336,1778,116,91,1214,1193,783,809,573
24744,143,857,24061,683,24744,0,4.62387e+18,490.901,3178.69,24744,252,199,21482,17708,10224,9669,5533
5515,539,1835,5515,0,4485,1030,3.02779e+18,308.067,2740.08,5515,201,197,3680,3287,1915,1665,1231
20572,36,358,0,20572,19556,1016,2.5864e+16,256.138,1858.84,20572,112,123,18993,17997,13626,11751,7429
29344,13,43,27910,1434,28666,678,1.00633e+14,40.0192,782.378,29344,41,39,28397,27788,22640,22373,15245
34912,1558,2296,0,34912,0,34912,2.46828e+18,1389.09,6659.87,34912,542,399,32240,28175,22825,21064,27256
22023,106,739,21398,625,22023,0,4.59927e+18,495.596,2920.98,22023,224,187,17933,13575,8388,7641,3971
24698,562,1522,8734,15964,0,24698,3.76379e+13,1023.19,4586.08,24698,400,317,21342,19592,11633,11381,10138
11622,433,1805,0,11622,0,11622,2.49233e+18,777.279,3627.78,11622,311,264,9081,8119,4399,3956,3275
25683,1381,1538,0,25683,9140,16543,9.73971e+15,1038.77,4707.94,25683,394,326,24145,22736,21887,20846,23757
42267,528,2365,22435,19832,22435,19832,4.9273e+18,1464.8,7336.48,42267,591,416,34726,30828,13654,16154,10640
7096,724,1362,0,7096,2498,4598,9.41019e+15,175.827,2356.14,7096,228,168,5734,5631,4242,4124,4360
35646,267,2330,18771,16875,0,35646,4.97614e+18,1387.54,6735.47,35646,578,390,27403,24180,10162,8284,4755
8442,817,2150,8442,0,7078,1364,3.32475e+18,445.208,3456.93,8442,263,208,6292,5715,4827,4568,2587
49998,801,1539,0,49998,17644,32354,9.75682e+15,1154.71,6528.82,49998,546,396,45489,41046,27544,20730,31818
12009,47,750,11780,229,12009,0,4.70534e+18,357.962,2190.33,12009,220,146,7614,4543,3156,2852,1034
29478,1662,2221,0,29478,0,29478,2.44415e+18,1345.21,6106.63,29478,501,373,27153,23784,20352,18464,24313
19352,14,42,18462,890,18817,535,9.91391e+13,36.9581,618.029,19352,36,33,18854,18515,15375,15081,11695
42294,107,1328,0,42294,14948,27346,9.99508e+15,1106.87,5785.51,42294,465,396,31927,26944,10936,8643,5334
42711,73,682,42327,384,42711,0,4.75719e+18,492.379,4001.35,42711,262,248,30491,18843,11645,11367,5555
17191,607,1529,0,17191,6120,11071,9.51929e+15,766.36,3723.7,17191,345,257,14892,13937,9789,6831,9685
34175,1982,2234,18329,15846,0,34175,5.04817e+18,1380.94,6506.12,34175,528,391,31941,31807,29348,29042,30729
27936,298,353,0,27936,26576,1360,2.57242e+16,287.712,2142.09,27936,121,133,27468,26909,25972,24566,24918
15971,1,42,15077,894,15814,157,1.06609e+14,33.8554,565.753,15971,37,34,5228,5228,5228,5228,5228
18441,240,571,18249,192,18441,0,4.77002e+18,431.43,2535.23,18441,187,193,17116,16061,10713,10620,8719
24114,218,1644,0,24114,8566,15548,9.5806e+15,979.228,4573.15,24114,451,303,19787,18226,8799,5646,5014
16412,1621,1995,0,16412,0,16412,2.43504e+18,991.84,4428.58,16412,406,285,14403,13046,11691,10180,12759
3589,122,1094,0,3589,0,3589,2.34906e+18,197.46,1688.07,3589,183,134,2261,1727,615,467,330
44965,69,352,0,44965,42418,2547,2.72847e+16,310.57,2789.2,44965,157,166,42409,41277,30415,26316,19119
14752,1169,1314,5200,9552,0,14752,3.84795e+13,810.631,3411.42,14752,304,270,13329,12177,11522,11023,12322
7649,1854,1996,6157,1492,3694,3955,8.36221e+17,552.884,3252.15,7649,232,216,5653,5432,5550,5542,5567
25755,320,353,0,25755,24621,1134,2.47691e+16,248.723,2001.99,25755,118,128,25352,24923,24693,24119,23815
24497,1299,1959,12456,12041,12456,12041,5.0133e+18,1248,5416.5,24497,422,358,21874,19219,15019,14024,17125
43732,665,2707,36116,7616,22469,21263,7.54073e+17,1677.37,8304.41,43732,604,451,34712,29766,20704,20847,15128
36169,93,355,0,36169,34439,1730,2.56403e+16,298.528,2434.81,36169,133,146,34685,34045,27207,23557,17218
14692,167,670,14387,305,14692,0,4.57773e+18,413.044,2347.12,14692,202,163,13030,11405,6134,6399,4624
40582,24,43,38250,2332,40196,386,1.06842e+14,41.5546,933.492,40582,43,42,40180,39855,34536,34441,27990
23515,191,1871,8323,15192,0,23515,3.74415e+13,985.436,4825.25,23515,456,306,18802,16900,7478,3232,4224
36218,1984,2261,18768,17450,0,36218,5.02564e+18,1408.37,6775.98,36218,556,397,33957,33957,31538,31013,33058
33805,40,42,31980,1825,33290,515,1.04272e+14,38.6912,825.348,33805,41,39,33756,33734,33648,33647,32859
10634,1277,2190,8685,1949,5249,5385,7.86959e+17,851.623,3934.93,10634,333,279,8444,7548,6543,6614,6065
35080,1147,1725,0,35080,0,35080,2.53773e+18,1405.13,6300.75,35080,471,408,31423,27145,20212,16685,23649
10078,835,1832,5520,4558,0,10078,5.12406e+18,536.236,3318.08,10078,262,258,8246,7614,5478,4902,4894
39962,123,1373,14118,25844,0,39962,3.86933e+13,1118.63,5704.19,39962,455,382,30672,26390,10739,4229,4810
27453,1193,2370,0,27453,0,27453,2.4514e+18,1229.24,5977.37,27453,473,352,24199,21617,15326,13033,15715
20174,598,2117,10451,9723,0,20174,4.94732e+18,1151.93,4998.71,20174,443,322,16342,14574,7105,6640,6662
39663,251,887,38523,1140,39663,0,4.54915e+18,567.712,4026.4,39663,296,230,36874,34459,21577,19377,14055
49080,234,919,47742,1338,49080,0,4.61708e+18,645.263,4498.19,49080,300,252,45496,42201,25344,24099,16155
21845,76,352,0,21845,20764,1081,2.60259e+16,271.294,1901.81,21845,116,126,20764,20295,15863,13587,9958
46953,908,2913,46953,0,39199,7754,3.3217e+18,1773.04,8745.21,46953,685,461,38603,33071,25854,24180,18231
28490,1191,1728,10086,18404,0,28490,3.68297e+13,1055.86,5038.81,28490,458,325,26351,23943,19701,20574,22673
39422,65,356,0,39422,37392,2030,2.63413e+16,299.08,2598.7,39422,145,153,37287,36296,27233,23884,16314
4249,29,250,0,4249,4013,236,2.80328e+16,61.9096,750.199,4249,60,63,3815,3563,2619,2263,1363
17751,479,1472,6332,11419,0,17751,3.80157e+13,833.663,3816.93,17751,346,278,15192,13972,8832,8136,8494
26883,82,2781,22381,4502,14013,12870,7.35744e+17,1495.61,6600.76,26883,532,381,15230,10151,6995,7251,1203
33633,1374,1829,0,33633,11931,21702,9.52945e+15,1093.57,5567.84,33633,524,343,31783,28651,24902,20890,30283
14521,571,2023,11647,2874,6977,7544,8.45342e+17,1223.73,4523.31,14521,353,318,10761,9147,5960,6121,4196
41027,1063,1765,0,41027,0,41027,2.53907e+18,1418.49,6819.65,41027,515,434,36424,31763,21634,17721,25250
25978,94,714,25496,482,25978,0,4.60068e+18,502.704,3146.53,25978,252,206,20299,14555,7838,6901,4243
19016,1634,2081,9003,10013,9003,10013,5.01149e+18,1221.63,5029.44,19016,406,328,16764,14805,12859,12099,14701
38653,1873,2759,32252,6401,20283,18370,7.2555e+17,1696.21,7830.21,38653,628,424,35486,29928,29708,29391,30622
35159,382,772,34497,662,35159,0,4.62695e+18,523.909,3705.08,35159,263,230,33659,32533,23528,23750,20178
17807,407,586,17624,183,17807,0,4.7049e+18,438.672,2520.98,17807,181,185,16991,16524,14297,14227,13118
46334,386,2501,0,46334,0,46334,2.44021e+18,1478.72,7795.2,46334,655,435,37068,33081,13195,9578,7265
49737,490,2489,26416,23321,0,49737,5.02481e+18,1487.56,8015.2,49737,653,440,40751,36119,16611,17541,13234
41504,782,1786,19641,21863,19641,21863,5.00824e+18,1458.76,6946.38,41504,515,435,35101,30719,16522,15905,17793
6708,1431,1968,6708,0,5460,1248,3.09841e+18,251.77,3024.53,6708,227,203,4740,4719,4677,4685,3724
21964,1721,1815,10699,11265,0,21964,5.03765e+18,1225.58,5056.63,21964,416,334,20149,19368,19248,18747,19801
20573,2068,2409,17328,3245,11012,9561,7.05701e+17,1380.44,5529.7,20573,436,339,18164,15852,16527,16161,16966
31469,1989,2295,16492,14977,0,31469,5.014e+18,1361.89,6349.45,31469,520,378,29174,29076,26596,26290,27996
31577,4,353,0,31577,30119,1458,2.52569e+16,283.611,2258.2,31577,127,137,20725,16539,15964,14251,9642
30065,189,347,0,30065,28516,1549,2.63689e+16,284.723,2243.25,30065,129,140,29213,28585,25466,22870,20390
41523,413,2415,21944,19579,21944,19579,4.94268e+18,1436.96,7316.05,41523,589,424,33382,29718,13371,13677,9819
36960,1290,1822,13152,23808,0,36960,3.74616e+13,1098.1,5795.76,36960,533,352,34937,31420,26451,26738,31614
3692,210,433,3576,116,3692,0,4.25011e+18,147.299,1032.93,3692,93,86,3238,3042,2233,2204,2148
16113,1259,1874,8025,8088,8025,8088,4.87707e+18,1011.97,4336.5,16113,375,304,13877,12542,10010,9740,10939
31238,569,1339,10999,20239,0,31238,3.84121e+13,1045.11,4980,31238,412,357,27212,24760,14755,11752,16215
21842,461,2101,11389,10453,11389,10453,4.86775e+18,1192.08,5168.04,21842,448,327,17470,15679,6616,7334,5172
36394,86,2281,19409,16985,19409,16985,4.96398e+18,1380.12,6744.67,36394,547,400,23467,17488,9349,8543,1899
34723,270,356,0,34723,33088,1635,2.52596e+16,290.905,2359.69,34723,132,139,34141,33472,31451,29663,30427
2785,218,1131,2293,492,1403,1382,7.57708e+17,141.169,1588.32,2785,155,137,1654,1156,671,674,598
34907,119,900,33861,1046,34907,0,4.50775e+18,524.653,3774.16,34907,265,223,29420,23059,13713,12907,6266
27802,798,1508,0,27802,9842,17960,9.65486e+15,1015.62,4811.67,27802,429,323,24869,22894,15975,12292,17236
17150,1031,1546,6102,11048,0,17150,3.84751e+13,780.002,3904.57,17150,331,284,15342,14273,11108,11193,11508
48772,672,1356,0,48772,17238,31534,9.90802e+15,1129.2,6241.92,48772,493,408,43556,39510,25319,18710,26143
27703,234,686,27453,250,27703,0,4.72537e+18,479.734,3228.67,27703,228,216,25658,23809,13458,13687,11241
15069,1940,2001,0,15069,0,15069,2.43351e+18,963.675,4255,15069,368,290,13068,13053,13010,12983,13068
46034,2677,2687,46034,0,37359,8675,3.00657e+18,1712.96,8705.05,46034,610,509,43347,43347,43347,43347,43344
29297,1830,2182,0,29297,0,29297,2.44795e+18,1294.28,5996.35,29297,515,363,27115,26791,23713,22942,25482
31650,29,43,29952,1698,31180,470,1.04186e+14,39.7983,816.191,31650,42,40,31467,31358,28159,28181,25130
35128,967,1348,0,35128,12433,22695,9.91165e+15,1085.16,5325.79,35128,454,366,32540,29188,22600,18073,26523
9746,1354,2204,8367,1379,5462,4284,6.39362e+17,508.464,3631.12,9746,288,244,7542,7134,6470,6613,5832
4525,348,871,1607,2918,0,4525,3.68648e+13,145.863,1556.41,4525,221,166,3654,3522,2343,2392,1543
15976,43,801,15523,453,15976,0,4.51221e+18,402.255,2536.57,15976,265,167,10222,6443,4129,3719,879
1198,351,525,598,600,0,1198,5.60613e+18,62.399,737.487,1198,87,96,673,673,648,643,537
20920,1724,2131,0,20920,0,20920,2.41304e+18,1157.83,5088.98,20920,449,323,18789,16757,15685,15231,17256
34832,20,42,32872,1960,34511,321,1.06248e+14,39.4928,847.719,34832,41,40,34338,33961,28664,28300,22673
9164,1558,1822,0,9164,0,9164,2.43009e+18,579.392,3240.62,9164,303,207,7342,7003,6874,6890,6104
28325,1548,1644,0,28325,10060,18265,9.5546e+15,1015.81,4919.07,28325,482,314,26681,26681,26010,25595,26558
32588,1900,2306,0,32588,0,32588,2.47694e+18,1403.16,6624.76,32588,475,394,30173,28013,25640,23936,28701
25624,656,2515,25624,0,21420,4204,3.28018e+18,1441.44,6209.78,25624,504,375,20182,17524,12741,11124,9237
16205,632,1534,0,16205,5673,10532,9.93272e+15,870.65,3817.37,16205,329,278,13844,12960,7837,6792,8063
26950,763,2141,14298,12652,14298,12652,4.87283e+18,1292.31,5715.77,26950,506,343,22706,20296,11571,12186,11105
15683,1053,2028,0,15683,0,15683,2.43119e+18,948.003,4341.53,15683,365,288,13068,12077,8308,7232,8952
4075,720,928,1486,2589,0,4075,4.02411e+13,146.261,1564.33,4075,142,139,3147,3128,3079,3083,2501
909,4,37,847,62,908,1,1.09308e+14,14.0902,134.361,909,20,19,711,622,530,517,359
11006,1144,1747,5527,5479,0,11006,5.10536e+18,783.163,3514.05,11006,291,267,9237,8377,6687,6129,7279
6939,566,1356,0,6939,2441,4498,9.38416e+15,178.899,2339.7,6939,230,168,5583,5402,3633,3591,3501
6340,33,305,0,6340,6034,306,2.57658e+16,75.1284,963.845,6340,71,68,5830,5552,4349,3786,2454
48547,1602,2962,48547,0,40742,7805,3.30437e+18,1738.4,8878.29,48547,726,475,43633,36936,40922,37278,31467
4867,481,1244,0,4867,0,4867,2.52851e+18,187.981,2043.17,4867,224,189,3623,3441,2559,2584,1673
25262,66,805,24723,539,25262,0,4.56501e+18,497.507,3180.41,25262,249,204,17995,11925,7057,6408,2952
14314,2270,2358,14314,0,11886,2428,3.34345e+18,1064.58,4638.85,14314,397,312,11956,11956,11902,11865,11710
35079,247,353,0,35079,33478,1601,2.49847e+16,281.359,2366.86,35079,130,140,34424,33793,31294,29676,27769
34998,640,1767,0,34998,12456,22542,9.58417e+15,1071.67,5560.75,34998,516,346,30920,28496,18493,12223,18810
31507,34,43,30043,1464,30663,844,9.8718e+13,39.3676,805.07,31507,41,39,31411,31327,29735,29759,27885
35503,2108,2393,35503,0,28609,6894,2.91193e+18,1675.06,7453.53,35503,493,442,33083,32072,32331,32380,31834
12832,1331,1972,6501,6331,6501,6331,4.82605e+18,885.843,3950.76,12832,345,263,10832,9803,7608,7382,8435
36904,1895,2843,30748,6156,19244,17660,7.33854e+17,1719.17,7740.34,36904,620,415,33673,28463,27423,27497,26734
11253,1160,1462,0,11253,3979,7274,9.45687e+15,481.13,2951.31,11253,310,183,9791,9380,8498,7051,8851
8798,1184,1402,0,8798,3094,5704,9.41671e+15,346.26,2628.12,8798,292,184,7396,7235,6848,6815,5969
46172,288,1951,22788,23384,0,46172,5.11907e+18,1477.89,7446.06,46172,566,445,35368,30732,11113,9170,8784
33365,279,1738,15837,17528,15837,17528,5.01222e+18,1396.12,6156.75,33365,468,402,25051,21617,6811,7091,4342
30417,1130,1465,10743,19674,0,30417,3.79693e+13,1067.71,5058.23,30417,468,335,28428,25448,21225,21611,24357
45021,2447,2619,45021,0,36947,8074,3.14555e+18,1758.25,8432.84,45021,615,466,42402,42402,42267,42232,42080
48007,25,43,45804,2203,46650,1357,9.81269e+13,41.5001,994.134,48007,43,41,47661,47402,42360,42440,34633
5351,1109,1467,2464,2887,2464,2887,4.97378e+18,291.127,2346.71,5351,220,202,3884,3809,3360,3261,3273
9488,97,350,0,9488,9089,399,2.42648e+16,102.681,1200.34,9488,83,83,9085,8943,7716,6570,5686
12815,840,1375,0,12815,4523,8292,9.73993e+15,717.881,3234.31,12815,294,252,11090,10423,7679,6448,8416
33847,42,2612,28196,5651,17751,16096,7.31134e+17,1646.38,7240.64,33847,546,409,15938,10102,6349,6562,631
34329,490,1825,12171,22158,0,34329,3.72609e+13,1098.32,5615.87,34329,533,346,29518,27092,14951,13627,10428
32215,220,853,31239,976,32215,0,4.50665e+18,516.292,3599.49,32215,261,210,29576,27256,15350,14658,10809
24920,1047,1318,0,24920,8806,16114,9.95524e+15,996.618,4442.57,24920,384,325,23035,20701,17526,14971,19083
44362,996,1959,22148,22214,22148,22214,4.99837e+18,1470.27,7279.13,44362,550,450,39070,34285,21256,21140,25327
34335,124,1805,0,34335,12221,22114,9.5876e+15,1093.94,5564.67,34335,534,350,26975,23723,11363,6240,3511
21751,1641,4460,9946,11805,9946,11805,4.28847e+18,624.773,7378.22,21751,839,381,17291,16613,9220,9045,8765
29746,785,879,28903,843,29746,0,4.57081e+18,536.458,3496.69,29746,261,210,28867,28818,28332,28326,27939
44081,1609,1884,0,44081,15598,28483,9.50414e+15,1160.43,6383.22,44081,592,373,42197,42197,38518,36491,41516
44751,158,361,0,44751,42213,2538,2.73008e+16,318.178,2806.02,44751,159,165,43188,42121,35497,30574,26772
19666,1432,1497,0,19666,7006,12660,9.64347e+15,931.169,4083.75,19666,371,280,18169,18127,18048,18032,18067
13914,277,1690,6667,7247,0,13914,5.20506e+18,1026.74,3962.81,13914,309,289,10251,8871,3067,2502,2705
44100,1915,2314,23803,20297,0,44100,4.98751e+18,1536.45,7410.17,44100,671,414,41786,41268,34126,32758,40903
2225,1,34,2161,64,2096,129,9.26024e+13,15.5429,189.634,2225,19,19,863,863,863,863,863
3073,987,990,1437,1636,1437,1636,4.80833e+18,127.694,1507.7,3073,165,124,2083,2083,2083,2083,2083
26738,635,2407,26738,0,22016,4722,3.17432e+18,1538.02,6381.91,26738,498,394,20774,17804,11266,9936,8548
25400,443,844,24767,633,25400,0,4.62992e+18,512.067,3225.43,25400,252,200,24220,23476,20550,20434,15029
3300,275,716,0,3300,1226,2074,1.03741e+16,72.4276,1226.12,3300,152,106,2584,2584,2119,1197,1141
14517,2101,2330,14517,0,11970,2547,3.28618e+18,1142.73,4697.69,14517,415,315,12187,10979,12057,12086,11509
45742,22,43,43662,2080,44387,1355,9.74046e+13,40.2762,966.598,45742,43,40,45302,44894,38913,38784,31765
7143,708,1732,3753,3390,3753,3390,4.84855e+18,192.729,2767.08,7143,251,184,5411,5244,3174,3235,3049
12340,486,2015,9951,2389,5932,6408,8.2515e+17,1079.13,4178.4,12340,332,296,8942,7634,4628,4856,2735
3421,50,417,3265,156,3421,0,4.27809e+18,117.047,951.658,3421,97,78,2470,1836,1529,1509,885
8588,42,1722,4278,4310,0,8588,5.10764e+18,499.95,3071.66,8588,254,262,4224,2605,1321,1085,217
2967,75,741,1097,1870,0,2967,4.21257e+13,86.9663,1228.88,2967,133,111,2064,1611,897,598,416
5310,205,251,0,5310,5095,215,2.43857e+16,48.7196,792.79,5310,60,55,5059,5058,4951,4996,4510
18246,787,2054,18246,0,14577,3669,2.98887e+18,1415.27,5131.5,18246,366,341,14068,11681,8097,7437,6870
29966,427,1801,10661,19305,0,29966,3.70217e+13,1039.94,5186.27,29966,509,319,25579,23623,13422,11440,11742
34083,3051,5920,15528,18555,0,34083,4.57497e+18,831.548,10151.2,34083,985,527,28163,27667,20200,18863,19214
43810,1467,2579,36050,7760,22285,21525,7.64433e+17,1725.23,8246.91,43810,610,450,38773,32841,31217,31060,28543
30495,199,856,29660,835,30495,0,4.56645e+18,522.771,3518.58,30495,287,215,27742,25002,14883,13896,8854
14668,1156,1985,7551,7117,0,14668,4.97416e+18,922.519,4206.03,14668,343,295,12302,11346,8253,7854,8189
30232,329,1770,10686,19546,0,30232,3.6989e+13,1036.03,5202.77,30232,466,330,25465,23493,11264,9208,10310
15249,35,44,14441,808,14999,250,1.03461e+14,39.1035,566.693,15249,37,34,15185,15146,14295,14297,13894
16098,1136,1961,8080,8018,0,16098,5.04594e+18,1049.9,4450.89,16098,355,305,13639,12324,8796,8121,9700
17747,115,587,17579,168,17747,0,4.80658e+18,437.36,2506.84,17747,191,186,14550,10569,6106,6130,4028
4250,737,778,1474,2776,0,4250,3.47817e+13,75.3388,1366.29,4250,180,118,3472,3472,3472,3472,3442
48438,1326,1598,17174,31264,0,48438,3.80272e+13,1173.64,6466.58,48438,528,396,46811,42284,38335,38917,45456
10336,33,44,9776,560,10186,150,1.06861e+14,33.7524,468.901,10336,35,31,10277,10248,9578,9604,9094
34327,1973,2452,34327,0,28115,6212,3.13343e+18,1680.31,7273.76,34327,542,438,31789,26511,30443,29960,29176
15417,1125,1526,0,15417,5465,9952,9.51566e+15,755.918,3596.17,15417,328,259,13736,12849,11365,8571,10111
45700,769,2609,37437,8263,22862,22838,7.79117e+17,1733.01,8521.33,45700,585,458,36628,30679,22610,22012,15881
4694,770,1035,0,4694,1678,3016,1.03553e+16,164.122,1759.44,4694,192,154,3659,3659,3310,3377,3184
6017,649,1556,0,6017,0,6017,2.46525e+18,300.277,2518.82,6017,237,203,4461,4130,2504,2396,2605
43986,25,43,41979,2007,42739,1247,9.82855e+13,39.5717,947.614,43986,42,41,43678,43443,38920,38991,31433
33136,864,2101,0,33136,0,33136,2.45681e+18,1415.38,6426.27,33136,482,400,28235,25098,13288,13272,15389
1288,49,139,0,1288,1204,84,2.76371e+16,28.5272,323.91,1288,39,34,1149,1116,868,846,685
38649,1642,2208,0,38649,0,38649,2.47349e+18,1399.35,6962.19,38649,537,417,36343,31444,26508,23908,31483
22038,1029,2675,18321,3717,11451,10587,7.46468e+17,1372.25,5979.33,22038,497,356,17774,15630,13173,13005,10977
26664,1169,1744,9427,17237,0,26664,3.69444e+13,1041.65,4910.09,26664,479,318,24511,22343,17793,18350,20691
3135,694,754,0,3135,1099,2036,9.8042e+15,103.591,1242.42,3135,149,128,2381,2379,2351,2310,2302
18909,812,1832,9402,9507,0,18909,5.07639e+18,1167,4715.06,18909,378,325,15713,14045,8511,7316,8369
43350,1546,1755,20600,22750,20600,22750,5.00376e+18,1456.78,7025.25,43350,529,438,41159,34772,32819,32598,38541
9376,961,1937,4710,4666,4710,4666,4.79917e+18,549.496,3355.69,9376,319,227,7439,6988,4994,4743,4540
25424,27,43,24227,1197,24789,635,9.94864e+13,40.2494,728.355,25424,40,38,25269,25184,22691,22710,20039
27384,2183,2209,14065,13319,14065,13319,4.85758e+18,1345.03,5903.85,27384,500,362,25175,25175,25160,25119,25173
32212,513,2248,0,32212,0,32212,2.52344e+18,1491.43,6651.75,32212,504,405,25615,21765,7552,6907,7933
11083,110,1857,6031,5052,0,11083,5.11643e+18,634.731,3502.65,11083,297,270,7533,5557,3158,2625,976
17538,407,2411,17538,0,14801,2737,3.28535e+18,1134.11,5058.22,17538,412,325,13143,11696,7537,6095,4358
21672,1212,2221,11560,10112,0,21672,5.0526e+18,1148.76,5232.03,21672,405,320,18839,16938,11755,11283,11846
24841,44,352,0,24841,23656,1185,2.5373e+16,271.354,2007.85,24841,115,124,23274,22268,17170,14731,9667
24398,62,2471,20321,4077,12773,11625,7.28788e+17,1491.21,6084.59,24398,465,369,12933,8321,5631,5929,890
35519,20,43,33704,1815,34892,627,1.02997e+14,39.8154,862.724,35519,42,41,35042,34676,29618,29275,23356
3720,702,898,0,3720,1359,2361,1.04122e+16,144.744,1490.64,3720,132,141,2822,2818,2729,2575,2583
27674,590,833,26929,745,27674,0,4.49695e+18,516.113,3341.18,27674,261,215,26807,26116,24903,24912,23306
1231,69,548,0,1231,0,1231,2.8248e+18,60.8286,762.336,1231,91,100,614,412,304,231,148
2137,265,724,1144,993,0,2137,5.55383e+18,82.5686,1105.18,2137,119,111,1413,1331,1169,1157,655
47082,725,2017,23005,24077,23005,24077,4.98714e+18,1460.53,7565.36,47082,561,457,39660,34411,17139,17573,21118
39962,1835,2313,39962,0,32625,7337,3.08286e+18,1747.5,7762.1,39962,564,453,36936,30691,35485,35664,32750
38821,136,1641,0,38821,13693,25128,9.64702e+15,1082.81,5815.21,38821,467,362,30617,27073,12012,8815,6011
25498,22,43,24328,1170,24747,751,9.74093e+13,40.6632,724.743,25498,40,37,25238,25001,21518,21453,16777
27507,50,2341,27507,0,22419,5088,3.03766e+18,1549.09,6476.16,27507,479,410,12778,7277,5136,5284,606
30764,20,45,28992,1772,30451,313,1.0726e+14,40.5628,814.852,30764,42,41,30273,29903,25191,24832,20468
10209,704,1861,0,10209,0,10209,2.40733e+18,585.435,3375.7,10209,319,211,8229,7463,4868,3847,4380
34648,958,2056,17277,17371,0,34648,5.06116e+18,1444.05,6574.84,34648,516,403,29818,26318,15673,13920,17447
3681,457,1080,3259,422,2192,1489,5.51033e+17,95.2334,1608.23,3681,142,129,2601,2575,2262,2265,1812
48277,4595,5636,16779,31498,55,48222,3.47879e+13,659.341,10751.3,48277,958,541,42641,42624,39344,39920,37717
1726,61,76,0,1726,1696,30,2.02063e+16,15.5527,258.253,1726,33,28,1650,1650,1625,1639,1432
43570,1357,2892,43570,0,36206,7364,3.28376e+18,1766,8456.1,43570,669,460,37899,32463,34085,31477,23887
46996,300,2152,37664,9332,22390,24606,8.3867e+17,1744.94,8272.76,46996,568,472,32835,26787,14795,15994,8117
10866,327,1983,5588,5278,0,10866,4.99526e+18,692.505,3631.18,10866,319,260,8206,7398,3013,2402,1968
33042,1276,2106,16991,16051,16991,16051,4.96576e+18,1355.68,6374.42,33042,478,395,29798,26056,19557,18278,22551
13127,27,43,12465,662,12886,241,1.02581e+14,36.2429,522.083,13127,35,33,13029,12981,11680,11684,9635
16005,751,1525,5667,10338,0,16005,3.73001e+13,776.573,3659.87,16005,382,258,13952,13040,9709,9344,7534
5880,951,1189,2127,3753,0,5880,3.65332e+13,206.64,2040.09,5880,233,177,4691,4656,4554,4548,4550
23834,242,583,23580,254,23834,0,4.76514e+18,471.729,2902.37,23834,210,206,22144,20774,12917,12831,10496
37850,1890,2433,0,37850,0,37850,2.4356e+18,1412.67,7045.16,37850,578,409,35417,35262,28764,27419,32396
10876,14,42,10276,600,10747,129,1.04298e+14,34.2846,467.508,10876,35,32,10546,10313,8463,8284,6275
21757,299,667,21497,260,21757,0,4.69835e+18,461.493,2846.97,21757,216,200,20485,19542,13265,13386,11505
46868,18,43,44581,2287,45779,1089,1.00866e+14,40.7332,983.203,46868,43,41,46087,45494,38145,37850,29699
14524,207,383,0,14524,13776,748,2.68009e+16,219.844,1621.23,14524,105,104,14001,13806,12430,11471,10592
2197,48,141,0,2197,2123,74,2.42051e+16,37.3204,413.883,2197,36,40,2053,2030,1830,1806,1516
21605,31,43,20348,1257,21407,198,1.06675e+14,40.8104,685.267,21605,41,37,21479,21409,19381,19357,17892
1125,357,440,0,1125,0,1125,2.85365e+18,39.7636,624.152,1125,78,80,685,685,681,682,430
10580,587,659,10264,316,10580,0,4.52763e+18,312.508,1958.01,10580,180,134,9921,9829,9811,9796,9297
42705,2150,2751,35681,7024,22540,20165,7.21191e+17,1715.01,8166.19,42705,628,425,39954,39643,34863,34044,37146
21028,188,1673,7414,13614,0,21028,3.66915e+13,921.797,4296.91,21028,450,285,16946,15533,7305,5238,5103
22014,325,351,0,22014,20996,1018,2.50242e+16,247.541,1867.01,22014,110,117,21643,21275,21164,20891,20890
37379,1102,2714,37379,0,31426,5953,3.27927e+18,1685.77,7630.44,37379,639,420,31445,27357,24742,23298,16918
4322,143,1267,4322,0,3656,666,3.39531e+18,125.14,1909.95,4322,206,131,2960,2542,1592,1832,208
45749,1490,2312,0,45749,0,45749,2.42548e+18,1566.77,7558.46,45749,664,418,42321,37004,28293,26096,32376
38720,2212,2905,38720,0,32440,6280,3.3389e+18,1647.45,7924.04,38720,623,437,35815,35634,34787,34809,33060
44060,284,2482,35571,8489,21204,22856,8.28386e+17,1801.31,8353.06,44060,578,486,30529,24198,13881,15038,7093
10915,1803,1832,0,10915,0,10915,2.52449e+18,709.812,3524.56,10915,298,269,9083,8607,9053,8880,9026
38666,2576,2584,38666,0,31722,6944,3.05903e+18,1710.14,7828.65,38666,563,442,36082,36082,36082,36082,36079
24292,858,1773,8626,15666,0,24292,3.72483e+13,978.384,4741,24292,458,332,21518,19920,14242,12336,15863
2132,25,139,0,2132,2041,91,2.56191e+16,28.5408,413.491,2132,43,38,1930,1841,1468,1195,849
513,65,182,510,3,513,0,5.04235e+18,46.5146,280.725,513,42,44,331,246,196,185,170
17194,444,1850,0,17194,0,17194,2.49479e+18,1098.69,4495.91,17194,351,303,13545,11891,5430,4076,4585
15951,565,1929,7694,8257,0,15951,5.13599e+18,1036,4439.8,15951,342,290,12809,11141,5296,4505,5776
40787,401,1832,0,40787,14506,26281,9.54481e+15,1108.45,6054.3,40787,566,366,34976,32200,17087,11205,15022
36132,28,43,34145,1987,35878,254,1.04903e+14,38.8348,872.956,36132,42,42,35915,35783,31932,31972,29045
11234,663,1960,8923,2311,5304,5930,8.64122e+17,949.146,3890.77,11234,277,258,8400,7308,5390,5428,4652
4274,195,1302,1984,2290,1984,2290,4.76246e+18,201.017,1997.23,4274,192,141,2843,2355,796,1045,338
23965,911,1990,12360,11605,0,23965,5.05336e+18,1220.71,5352.49,23965,418,339,20510,18302,11694,10506,12207
49472,118,357,0,49472,47235,2237,2.50728e+16,294.311,2810.05,49472,147,160,47854,47006,39301,33847,28162
8300,126,1426,0,8300,2953,5347,9.59895e+15,370.967,2629.74,8300,272,195,6323,5538,2639,1791,1335
12045,370,659,11872,173,12045,0,4.68063e+18,359.267,2119.49,12045,174,150,11274,10974,9237,9151,8062
9010,1072,1828,0,9010,0,9010,2.47368e+18,484.785,3191.73,9010,288,253,7182,6823,4897,4700,5270
26806,134,2042,21411,5395,12669,14137,8.43086e+17,1545.31,6153.19,26806,463,383,16109,9668,6860,6470,1716
6286,290,634,6079,207,6286,0,4.53617e+18,228.705,1509.64,6286,142,109,5652,5392,4069,4169,2969
32319,198,361,0,32319,30663,1656,2.63938e+16,292.228,2363.64,32319,135,143,31416,30742,27517,24755,23477
26515,1038,1709,0,26515,9358,17157,9.41293e+15,1036.49,4870.89,26515,474,313,24152,22048,17238,12579,19165
703,4,237,0,703,248,455,1.05072e+16,52.303,376.288,703,66,67,147,43,51,45,27
858,92,99,0,858,795,63,2.96461e+16,35.6667,234.221,858,33,29,759,759,756,757,744
34154,318,835,33369,785,34154,0,4.55265e+18,528.68,3711.06,34154,275,224,32294,30821,18401,18185,15691
39061,2123,2311,20504,18557,0,39061,5.01252e+18,1453.22,7051.25,39061,582,414,36750,36750,35050,34857,35602
12956,742,1519,0,12956,4587,8369,9.35133e+15,619.523,3224.97,12956,328,208,11216,10539,7898,6131,8896
31666,519,1357,0,31666,11164,20502,9.89614e+15,1057.28,5053.87,31666,429,355,27330,24893,13662,10979,13693
28744,624,1948,14438,14306,0,28744,5.06821e+18,1363.89,5902.71,28744,451,373,23643,20743,10236,9600,9869
13008,124,1942,0,13008,0,13008,2.52244e+18,915.187,4062.74,13008,313,281,8595,6060,2771,1463,1108
6998,276,345,0,6998,6641,357,2.61645e+16,77.7446,1074.14,6998,78,80,6653,6636,6416,6412,5943
2788,199,904,0,2788,0,2788,1.51538e+18,133.551,1391.96,2788,119,150,1846,1586,940,808,694
18567,23,44,17499,1068,18394,173,1.06666e+14,38.1885,626.72,18567,39,37,18361,18167,15436,15368,12756
32833,1715,2351,17067,15766,0,32833,4.98834e+18,1381.62,6526.98,32833,528,387,30442,26585,22588,21035,26305
26973,850,1584,0,26973,9587,17386,9.66728e+15,1005.55,4771.61,26973,433,320,24361,22338,16423,12006,18002
8960,835,1404,3173,5787,0,8960,3.71072e+13,433.936,2679.14,8960,286,173,7556,7201,5880,5968,4873
44232,1695,2104,0,44232,0,44232,2.47281e+18,1504.88,7427.25,44232,574,444,41996,36443,32411,30412,39128
22843,733,2491,19075,3768,11993,10850,7.2399e+17,1415.8,5896.99,22843,474,354,17958,15696,11649,11357,7820
34273,22,43,32524,1749,33615,658,1.02191e+14,39.6053,849.421,34273,42,40,33901,33554,28865,28763,24829
18124,211,2005,0,18124,0,18124,2.4173e+18,1064.59,4630.64,18124,422,297,13495,11701,5166,2532,2406
31014,1732,2057,31014,0,24827,6187,3.05902e+18,1603.44,6643.22,31014,471,409,28354,23448,27492,27712,25915
12318,2173,2325,12318,0,10381,1937,3.30791e+18,906.499,4271.39,12318,381,273,9993,9993,9899,9857,9746
13691,1074,2100,0,13691,0,13691,2.51589e+18,841.039,4250.19,13691,376,289,11338,10395,7266,6723,7610
17688,104,593,17549,139,17688,0,4.80227e+18,411.785,2492.64,17688,191,188,14106,9991,5569,5677,3636
33763,451,2105,33763,0,26946,6817,2.97206e+18,1642.64,6986.62,33763,471,428,24908,21028,10992,9366,9045
40533,885,1941,19900,20633,19900,20633,4.97857e+18,1444,6987.64,40533,520,436,34816,30748,17807,18052,21938
37389,839,1477,13260,24129,0,37389,3.85798e+13,1112.61,5618.83,37389,470,377,34008,30711,21334,20291,23002
42837,487,1785,20301,22536,20301,22536,4.99863e+18,1445.24,7022.05,42837,527,436,34459,29750,11943,11475,12454
40822,1995,2082,40822,0,32619,8203,3.07211e+18,1709.49,7652.94,40822,523,460,38740,38615,38311,38355,38474
20269,470,1730,9611,10658,0,20269,5.13606e+18,1203.69,4799.91,20269,373,334,15992,14037,5991,5103,6556
3396,21,203,0,3396,3242,154,2.48256e+16,40.8492,605.494,3396,50,55,3024,2754,2167,2263,1543
35738,769,1641,12692,23046,0,35738,3.77415e+13,1098.97,5539.55,35738,485,357,32049,29437,20219,18029,18823
33547,606,1643,0,33547,11827,21720,9.50981e+15,1069.42,5368.04,33547,497,344,29478,27164,17070,11824,18397
43117,976,2614,22462,20655,22462,20655,4.90133e+18,1467.87,7694.89,43117,621,429,37410,33194,17815,20113,18693
2559,447,633,0,2559,867,1692,8.82828e+15,85.4287,1043.31,2559,126,106,1926,1918,1807,1785,1690
4200,304,1019,0,4200,1428,2772,8.97391e+15,129,1664.2,4200,213,134,3181,3056,1748,1661,1572
7094,364,1730,3624,3470,0,7094,5.03319e+18,286.519,2829.26,7094,234,235,5297,4847,2287,2080,1487
16120,15,42,15246,874,15866,254,1.0393e+14,37.1563,575.617,16120,35,34,15693,15381,12718,12307,9229
18689,1663,2409,15526,3163,9689,9000,7.4681e+17,1350.87,5324.94,18689,430,336,15923,13973,13220,13134,12570
39700,945,2283,21249,18451,21249,18451,4.90848e+18,1533.53,7064.93,39700,618,403,34259,30706,18320,19697,19659
11465,346,605,11357,108,11465,0,4.84871e+18,347.682,2014.82,11465,167,151,10740,10455,8459,8441,7168
20140,466,2158,20140,0,16372,3768,3.12254e+18,1363.78,5386.96,20140,410,339,15060,13023,7416,6675,5141
44079,122,357,0,44079,41932,2147,2.57161e+16,302.408,2702.22,44079,146,159,42538,41729,34706,29902,25517
34839,15,43,33178,1661,33993,846,9.9707e+13,41.1731,853.19,34839,42,40,33991,33359,27545,26764,20549
22303,356,740,21876,427,22303,0,4.66087e+18,445.325,2921.56,22303,224,197,21179,20480,14838,15062,12487
17868,1921,1970,0,17868,0,17868,2.49366e+18,993.265,4594.61,17868,346,315,15898,15898,15885,15742,15245
25438,1816,2016,13178,12260,13178,12260,4.97379e+18,1226.61,5528.66,25438,505,348,23422,22630,22463,22395,22230
18862,334,350,0,18862,17953,909,2.56569e+16,260.56,1761.92,18862,108,109,18498,18180,18385,18454,18016
31526,1200,2626,15014,16512,15014,16512,4.95266e+18,1443.02,6940.02,31526,561,424,27103,24298,12744,14170,19007
35083,984,2666,35083,0,29464,5619,3.28864e+18,1640.57,7357.89,35083,635,417,29131,25381,21169,20042,14383
21050,1145,1705,10091,10959,0,21050,5.19455e+18,1238.03,4873.15,21050,366,339,18383,16135,12341,10930,14016
10656,1256,1919,5641,5015,0,10656,4.91292e+18,639.957,3488.64,10656,348,221,8737,8223,6710,6320,5589
44303,786,1930,0,44303,15684,28619,9.58161e+15,1206.07,6561.37,44303,633,384,39595,36322,23217,16919,26870
34518,23,43,32897,1621,33591,927,9.89789e+13,38.7325,838.817,34518,41,39,34213,33974,29961,29902,25100
40118,1590,2270,19157,20961,0,40118,5.1436e+18,1489.11,7375.91,40118,573,431,37327,32003,24635,21304,30526
20463,565,1580,7283,13180,0,20463,3.76357e+13,879.61,4134.64,20463,398,286,17718,16437,11186,9703,8183
20230,925,2032,11069,9161,0,20230,5.08459e+18,1098.71,4854.24,20230,391,317,17267,15693,10640,9934,11012
33072,1515,2283,17705,15367,17705,15367,4.9209e+18,1331.92,6426.03,33072,526,379,30301,26685,21464,20583,24192
17916,477,2004,0,17916,0,17916,2.41962e+18,1059.19,4595.42,17916,404,296,14351,12871,5975,4870,5035
7124,23,335,0,7124,6783,341,2.51555e+16,73.9128,1056.07,7124,75,72,6374,5907,4654,4153,2495
48867,5,44,46411,2456,47828,1039,1.01526e+14,39.1773,988.662,48867,42,42,41798,37570,32234,32636,20378
21657,1515,1637,7716,13941,0,21657,3.73937e+13,909.152,4325.09,21657,422,293,20020,20020,19362,19357,19820
27285,1384,2226,14726,12559,0,27285,5.01077e+18,1265.05,5795.91,27285,497,346,24473,21686,16997,15604,18488
13769,17,359,0,13769,13121,648,2.53765e+16,201.369,1502.06,13769,97,103,11912,10899,8510,7568,4478
11821,565,1428,4127,7694,0,11821,3.7436e+13,665.84,3142.69,11821,300,230,9912,9272,5746,5100,6000
28689,655,921,28282,407,28689,0,4.72553e+18,532.236,3543.92,28689,274,213,27755,27228,25205,25194,24324
16425,1804,2391,16425,0,13683,2742,3.29008e+18,1178.57,4958.48,16425,403,292,13903,12361,13541,13113,11409
30803,211,1672,0,30803,10892,19911,9.61505e+15,1072.9,5254.17,30803,465,340,25195,23061,10274,7073,6027
9605,766,1816,5008,4597,5008,4597,4.95511e+18,544.298,3267.4,9605,303,261,7789,7116,4578,4892,4522
48084,187,355,0,48084,45850,2234,2.51537e+16,306.992,2783.02,48084,144,159,46904,45998,41204,37308,31256
37877,395,2373,37877,0,31109,6768,3.09283e+18,1737.34,7618.89,37877,550,454,27787,24086,12728,11328,7839
45726,4599,7690,17554,28172,40,45686,2.37544e+13,686.233,13613,45726,2999,511,38036,38002,34572,34252,30759
49190,2449,5140,0,49190,17830,31360,7.41337e+15,803.111,10920.9,49190,827,593,44050,43950,29779,28121,22985
30194,1338,2500,0,30194,0,30194,2.47588e+18,1373.96,6595.31,30194,576,385,26669,23577,15494,13662,19476
17267,1837,2407,17267,0,13914,3353,3.04604e+18,1371.29,5299.64,17267,362,332,14604,12691,14056,13958,13511
22616,625,822,21983,633,22616,0,4.56978e+18,445.175,2988.11,22616,226,193,21794,21384,20759,20837,19570
29978,1785,2231,15614,14364,15614,14364,4.89329e+18,1345.68,6147.41,29978,521,368,27747,24524,22414,21476,25217
37352,148,350,0,37352,35498,1854,2.59741e+16,293.22,2481.65,37352,138,151,36166,35436,30440,26411,22675
32124,670,2251,16750,15374,16750,15374,4.90111e+18,1386.49,6382.53,32124,534,379,26726,23569,11863,13083,11071
38790,295,354,0,38790,36981,1809,2.53642e+16,297.311,2504.81,38790,136,149,38234,37464,35924,34275,33755
25833,662,1708,0,25833,9181,16652,9.5652e+15,1023.03,4820.32,25833,444,312,22634,20839,13247,9027,9957
22735,1694,2195,11916,10819,11916,10819,4.90837e+18,1182.12,5337.88,22735,454,336,20540,18276,16468,16048,17533
33057,707,886,32098,959,33057,0,4.47166e+18,587.066,3707.34,33057,273,218,32171,32028,30713,30765,30094
20641,797,2178,11109,9532,0,20641,5.0592e+18,1081.08,5060.53,20641,418,323,17222,15689,9354,8751,8152
26960,1494,1662,0,26960,9533,17427,9.43299e+15,983.203,4777.04,26960,481,303,25298,25247,23131,22088,24908
27795,807,1764,13232,14563,0,27795,5.17922e+18,1352.46,5678.58,27795,424,382,23392,20520,11818,9667,12121
39268,1271,1814,13927,25341,0,39268,3.73173e+13,1112.32,5962.15,39268,557,366,37208,33407,28163,28091,29513
33256,862,2009,26368,6888,15553,17703,8.52593e+17,1568.54,6765.64,33256,500,410,27060,22798,17637,16902,15939
37051,1037,2059,0,37051,0,37051,2.53864e+18,1475.09,6863.07,37051,506,419,32432,28514,17604,15092,22892
30045,503,1672,10631,19414,0,30045,3.70791e+13,1031.88,5066.82,30045,503,327,26003,24045,15008,12234,10737
4041,530,1028,2035,2006,0,4041,5.09378e+18,269.884,1731.44,4041,172,171,3013,2718,1819,1622,2073
25853,2410,2667,21208,4645,12174,13679,7.67531e+17,1717.12,6769.81,25853,508,372,23186,23050,22186,21669,23055
8444,1044,1809,0,8444,0,8444,2.40899e+18,420.393,3080.14,8444,312,223,6635,6401,4983,4717,4206
20682,949,2133,10630,10052,10630,10052,4.86509e+18,1177.53,5095.12,20682,458,324,17406,15648,9724,9450,10877
10476,10,42,9849,627,10401,75,1.06695e+14,33.9558,461.545,10476,35,32,9881,9466,7764,7473,5257
32046,648,856,31198,848,32046,0,4.5678e+18,535.105,3608.06,32046,301,214,31190,30493,29604,29582,27990
37526,2256,2428,0,37526,0,37526,2.4478e+18,1406.07,6999.3,37526,561,403,35098,35098,34216,34216,34429
43249,1021,2258,21847,21402,21847,21402,4.94815e+18,1468.22,7473.75,43249,542,431,37763,33325,19159,20485,23326
18709,21,43,17871,838,18128,581,9.64532e+13,36.8519,621.273,18709,37,35,18486,18314,15868,15762,12952
48333,1198,2472,25336,22997,25336,22997,4.91226e+18,1501.33,7930.39,48333,638,437,43434,38244,23765,24661,27189
34607,415,2362,34607,0,28385,6222,3.055e+18,1721.12,7262.65,34607,531,440,25567,22032,11707,10501,7581
35433,1,43,33611,1822,34789,644,1.02842e+14,39.8022,862.083,35433,42,41,12192,12192,12192,12192,12192
41576,858,1827,14736,26840,0,41576,3.70642e+13,1115.49,6107.52,41576,573,367,37760,34503,23822,23605,27075
37077,510,2164,18440,18637,0,37077,5.05365e+18,1415.52,6864.18,37077,507,417,29957,26282,10261,10243,10227
38866,1354,1740,0,38866,0,38866,2.53903e+18,1418.25,6636.32,38866,502,431,35805,30727,25107,22332,30788
18910,185,348,0,18910,17942,968,2.63615e+16,239.282,1773.17,18910,109,117,18313,17989,16147,14654,13584
37511,524,638,37062,449,37511,0,4.68557e+18,509.038,3686.86,37511,248,233,36736,35751,33845,33898,32601
21560,1372,2064,11205,10355,11205,10355,4.96439e+18,1168.24,5141.33,21560,405,327,19094,17029,13309,12811,14680
24741,659,767,24479,262,24741,0,4.69371e+18,554.095,3234.24,24741,242,208,23946,23406,23019,22994,22100
42720,454,879,41922,798,42720,0,4.67876e+18,553.451,4190.39,42720,311,246,41230,39932,34040,34207,31252
20627,1049,1547,7309,13318,0,20627,3.72879e+13,880.721,4142.06,20627,378,291,18804,17265,13989,14248,16381
12615,37,44,11907,708,12487,128,1.06811e+14,36.3039,517.646,12615,38,35,12561,12539,12106,12110,11712
28235,480,2604,23358,4877,14484,13751,7.50423e+17,1556.11,6650.71,28235,517,384,21465,18694,11530,12475,7225
48289,562,1684,0,48289,17111,31178,9.65783e+15,1143.98,6482.28,48289,538,392,42360,38781,23077,16059,20128
704,160,288,327,377,0,704,5.4643e+18,69.5582,416.857,704,68,64,416,311,301,297,336
8774,1019,1747,0,8774,0,8774,2.42031e+18,483.381,3116.86,8774,298,224,7027,6681,5019,4519,4762
3010,981,989,1259,1751,1259,1751,4.61813e+18,101.753,1475.08,3010,156,126,2021,2021,2021,2021,2020
47794,326,1398,16918,30876,0,47794,3.89054e+13,1129.54,6244.22,47794,504,401,40174,36517,17596,14925,13653
10099,1478,1538,3573,6526,0,10099,3.88984e+13,553.347,3041.28,10099,302,214,8561,8207,8478,8495,8426
9094,27,668,8789,305,9094,0,4.62557e+18,299.845,1842.42,9094,185,136,5071,3045,2193,1961,490
36091,399,913,34894,1197,36091,0,4.47147e+18,568.706,3845.55,36091,280,227,34467,33292,22971,22040,19870
43756,81,2209,22280,21476,22280,21476,4.95801e+18,1448.11,7407.13,43756,558,434,27118,19058,9659,9306,2282
34988,428,2686,29122,5866,18240,16748,7.34619e+17,1695.73,7450.08,34988,571,421,26321,22979,13567,14774,4923
28455,12,43,27165,1290,27620,835,9.84646e+13,39.802,769.278,28455,41,39,27457,26764,21914,21537,16035
15478,181,2101,12544,2934,7670,7808,8.06175e+17,1163.53,4693.45,15478,366,317,10147,7126,4440,4833,2013
35750,2040,2316,18382,17368,18382,17368,4.87742e+18,1434.74,6781.68,35750,573,403,33434,33433,30884,30434,32658
10043,540,601,9973,70,10043,0,4.77977e+18,336.886,1897.36,10043,159,144,9442,9322,9321,9315,9220
5252,573,1422,2774,2478,2774,2478,4.77964e+18,166.97,2202.75,5252,213,146,3830,3696,2414,2680,2185
44483,447,637,44035,448,44483,0,4.74542e+18,512.629,4018.83,44483,261,254,43269,42012,37360,37630,33895
39584,1283,1579,14078,25506,0,39584,3.83152e+13,1103.97,5841.09,39584,470,380,37889,33605,31288,29807,36638
34767,268,359,7,34760,33077,1690,2.58763e+16,289.364,2408.8,34767,139,144,34133,33456,31199,29789,28586
5970,310,336,0,5970,5632,338,2.73747e+16,67.165,996.651,5970,74,70,5634,5634,5597,5620,5366
47820,981,1959,16972,30848,0,47820,3.71077e+13,1181.11,6699.02,47820,629,385,43904,39975,27927,27189,27475
41941,9,43,39778,2163,41160,781,1.02454e+14,40.8975,932.916,41941,43,41,39361,37692,30531,30447,19875
28326,725,2399,23233,5093,14208,14118,7.80316e+17,1633.8,6611.89,28326,504,396,22229,18920,13692,13397,10163
23146,190,352,0,23146,22000,1146,2.59609e+16,267.429,1952.18,23146,120,128,22475,22012,19747,17979,15853
23422,160,2198,18826,4596,11301,12121,8.29487e+17,1476.79,5875.86,23422,447,371,14937,9427,6357,6726,2296
20784,1356,1481,0,20784,7361,13423,9.70368e+15,925.722,4192.68,20784,368,301,19303,18395,18414,17719,18968
27022,37,42,25645,1377,26535,487,1.02895e+14,37.6096,736.39,27022,40,37,26964,26929,26497,26498,25315
19376,1331,2036,10518,8858,10518,8858,4.99179e+18,1031.47,4765.16,19376,393,315,17031,15373,12662,11889,12836
3838,179,280,0,3838,3591,247,2.70733e+16,54.432,742.899,3838,60,61,3558,3544,3266,3181,2748
34408,1381,2309,0,34408,0,34408,2.45219e+18,1369.87,6592.82,34408,538,386,31182,27378,20754,18596,23244
5703,845,1424,2821,2882,2821,2882,4.95087e+18,202.887,2339.19,5703,245,211,4279,4218,3166,3358,2915
31778,21,43,30196,1582,31087,691,1.01322e+14,40.1524,815.876,31778,42,40,31390,31072,26459,26265,21346
17626,61,2390,17626,0,14730,2896,3.29468e+18,1250.88,5128.53,17626,425,326,9471,6230,4003,4040,1521
48962,573,1778,17430,31532,0,48962,3.74383e+13,1191.27,6549.88,48962,597,392,43076,39459,24082,21147,24111
39175,2601,2862,32773,6402,20727,18448,7.18947e+17,1675.66,7926.62,39175,630,418,36313,36313,35655,35496,35700
1964,578,631,707,1257,0,1964,3.84121e+13,88.6222,962.299,1964,154,107,1333,1333,1300,1317,1272
7256,66,1750,3891,3365,3891,3365,4.89349e+18,294.814,2828.33,7256,273,218,4425,3231,1800,1669,306
14305,301,666,14057,248,14305,0,4.63542e+18,393.095,2311.21,14305,207,166,13357,12774,8759,8742,7760
3710,12,43,3479,231,3704,6,1.04852e+14,24.2771,281.588,3710,28,28,3524,3396,2802,2744,2221
11115,1238,1301,3963,7152,0,11115,3.92813e+13,660.269,2946.96,11115,258,248,9814,9123,9635,9628,9589
12378,380,754,12133,245,12378,0,4.64348e+18,370.273,2227.77,12378,217,149,11516,11160,9660,9463,8150
18233,1523,1918,9317,8916,9317,8916,5.02675e+18,1130.38,4657.46,18233,355,319,16155,14430,12749,11973,14223
36559,1131,2422,0,36559,0,36559,2.44592e+18,1384.07,6898.99,36559,558,411,32321,28790,18183,17186,20358
19167,521,587,18975,192,19167,0,4.79991e+18,443.083,2612.06,19167,188,188,18546,18131,17938,17891,17201
38024,1871,2811,38024,0,31660,6364,3.28863e+18,1670.64,7840.17,38024,620,443,34849,29407,33023,31583,27595
32963,521,2379,17207,15756,0,32963,5.0024e+18,1383.93,6569.6,32963,525,389,26764,23787,10069,10769,7653
28701,1346,2094,13821,14880,0,28701,5.14146e+18,1395.39,6120.75,28701,448,400,25561,22610,16685,14404,20013
35064,1629,2479,28881,6183,17911,17153,7.60277e+17,1611.27,7309.61,35064,521,410,31560,26745,25984,25715,26724
40301,320,834,39827,474,40301,0,4.78475e+18,537.687,4101.45,40301,276,245,38140,36095,24213,23938,20398
6282,1116,1951,6282,0,5008,1274,3.06147e+18,337.678,2958.56,6282,205,212,4331,4081,3756,3637,2848
5846,160,1813,5846,0,4937,909,3.50228e+18,248.898,2690.58,5846,283,185,3743,3093,1883,1731,449
31899,1399,1822,11349,20550,0,31899,3.72267e+13,1063.54,5377.93,31899,522,333,30065,27380,24613,25343,28452
1569,245,370,0,1569,560,1009,1.03342e+16,89.4978,638.682,1569,81,88,1199,1199,935,872,958
7209,283,635,7040,169,7209,0,4.50729e+18,211.524,1615.16,7209,159,118,6568,6306,4584,4625,4085
31575,20,43,29989,1586,30943,632,1.02187e+14,41.4996,817.128,31575,42,40,31131,30798,26232,25909,20297
7857,1251,1818,4224,3633,0,7857,5.02496e+18,290.983,2975.57,7857,305,206,6039,5987,5131,5009,4128
27832,107,1999,0,27832,0,27832,2.48183e+18,1307.6,5842.04,27832,484,379,18235,12950,6183,3036,2422
14277,1106,2051,14277,0,11413,2864,3.02376e+18,1214.64,4526.03,14277,304,323,11402,9825,8903,8387,7653
22797,1,43,21524,1273,22550,247,1.06728e+14,40.2327,702.1,22797,41,39,7387,7387,7387,7387,7387
35310,226,1549,12519,22791,0,35310,3.8066e+13,1082.53,5488.07,35310,465,358,28986,26594,12069,10141,7779
44456,1236,1893,15765,28691,0,44456,3.71923e+13,1169.62,6419.31,44456,608,377,42041,37572,29858,29684,33070
39512,12,43,37706,1806,38379,1133,9.8394e+13,39.1124,900.137,39512,42,40,38131,37170,30715,30128,21645
16347,211,2357,16347,0,13597,2750,3.27129e+18,1179.82,4925.9,16347,444,304,11227,8806,5113,3706,1906
17558,1275,1314,0,17558,6220,11338,1.00063e+16,877.08,3727.58,17558,319,284,16244,14801,16106,15450,16050
22116,1516,2171,18030,4086,10973,11143,7.8738e+17,1469.62,5716.42,22116,401,362,19089,16190,15800,15663,15944
20871,31,352,0,20871,19916,955,2.52725e+16,242.999,1821.7,20871,108,119,19164,18151,13920,11992,7615
8733,462,1820,4603,4130,4603,4130,4.95708e+18,457.256,3147.15,8733,293,233,6786,6160,3619,3418,2720
28071,17,43,26542,1529,27664,407,1.04484e+14,40.888,772.358,28071,41,40,27468,26989,22364,22175,16711
3463,628,1202,1478,1985,1478,1985,4.52174e+18,174.622,1751.79,3463,189,128,2261,2161,1487,1674,1566
36209,1270,1825,0,36209,12850,23359,9.48751e+15,1097.54,5725.32,36209,546,339,34070,30695,25648,19190,30101
34636,258,352,0,34636,32753,1883,2.68584e+16,296.2,2433.01,34636,139,145,33941,33209,30659,28552,28959
27201,1584,2004,13612,13589,0,27201,5.02056e+18,1325.26,5747.5,27201,457,364,25040,21769,19119,18080,22851
46180,647,2235,0,46180,0,46180,2.48224e+18,1441.15,7604.54,46180,562,444,38644,33831,15874,15695,16667
30324,1118,1345,10714,19610,0,30324,3.85855e+13,1058.25,4934.84,30324,421,345,28496,25236,22485,22230,25619
38304,2001,2352,19966,18338,19966,18338,4.91153e+18,1449.12,7033.73,38304,583,414,35952,35797,31800,31253,34337
37905,126,351,0,37905,36171,1734,2.5196e+16,289.46,2465.73,37905,135,145,36662,36018,30479,26813,20742
22718,136,351,0,22718,21670,1048,2.53398e+16,253.796,1905,22718,117,120,21959,21595,18650,16592,14339
38551,10,43,36750,1801,37524,1027,9.90872e+13,39.5765,891.545,38551,42,40,36674,35342,29124,28565,20074
25092,99,716,24697,395,25092,0,4.63541e+18,487.996,3092.86,25092,252,205,19842,14208,7807,7495,4464
42423,2235,2774,42423,0,35340,7083,3.30542e+18,1787.05,8222.77,42423,668,453,39649,39300,38564,38687,37865
9041,834,2075,9041,0,7436,1605,3.00276e+18,689.433,3567.45,9041,261,250,6839,5949,4757,4400,4044
40830,296,2557,19370,21460,0,40830,5.09946e+18,1596.44,7796.81,40830,620,442,30262,25336,8218,7304,7384
46263,178,354,0,46263,44112,2151,2.53074e+16,299.774,2733.13,46263,144,160,45074,44146,39358,35343,29448
26429,676,1702,0,26429,9329,17100,9.419e+15,1033.07,4853.97,26429,473,312,23170,21353,14110,9678,13740
37978,1502,2312,0,37978,0,37978,2.43761e+18,1430.79,6943.53,37978,570,415,35008,30557,23665,20225,27475
9266,1804,2146,7668,1598,4820,4446,7.4926e+17,590.724,3579.03,9266,294,209,7120,6813,6712,6562,6799
7171,125,1672,3396,3775,0,7171,5.24298e+18,460.108,2849.39,7171,215,189,4651,3303,1359,1009,614
28419,581,1721,0,28419,10095,18324,9.45704e+15,1055.97,5020.44,28419,460,316,24651,22815,14423,9773,14113
12692,249,682,12429,263,12692,0,4.64514e+18,383.303,2210.16,12692,192,161,11630,10861,7641,7531,5517
34057,1482,1746,12040,22017,0,34057,3.69393e+13,1068.16,5475.58,34057,538,338,32311,32258,28601,28859,31696
21856,215,349,0,21856,20603,1253,2.74074e+16,272.092,1928.32,21856,119,129,21198,20706,18712,16914,16137
22319,649,2000,22319,0,17732,4587,3.04903e+18,1486.37,5604.85,22319,417,384,17047,14284,8564,7424,6183
21290,455,1941,10874,10416,10874,10416,4.91803e+18,1172.58,5022.03,21290,405,330,17031,15176,6338,6623,5157
41913,13,42,39805,2108,41026,887,1.01434e+14,39.6222,918.668,41913,42,41,40592,39734,32785,31549,25032
40027,4,42,37768,2259,39643,384,1.06783e+14,39.2629,903.455,40027,42,41,31612,27726,23937,23863,15480
18153,123,356,0,18153,17243,910,2.59326e+16,232.962,1728.59,18153,108,113,17440,17141,14337,13085,10385
44220,423,1887,15658,28562,0,44220,3.71457e+13,1162.11,6386.67,44220,609,373,37823,34804,17976,12933,15324
40044,1140,2421,21386,18658,0,40044,5.00549e+18,1391.83,7166.13,40044,579,409,35449,31726,20349,18799,22200
30820,1322,1333,0,30820,10920,19900,9.94573e+15,1060.08,4960.47,30820,411,355,29487,29487,29461,29480,29458
26869,431,1758,12720,14149,0,26869,5.12193e+18,1332.79,5565.3,26869,432,381,21145,18402,7162,5958,7186
18869,968,1853,9177,9692,0,18869,5.00912e+18,1142.88,4702.16,18869,374,329,15953,14366,8941,7961,10730
2588,102,323,2579,9,2588,0,4.97292e+18,150.637,780.392,2588,84,88,1995,1375,926,950,709
13213,101,345,0,13213,12613,600,2.47319e+16,177.427,1415.37,13213,88,91,12684,12494,10578,9433,7571
18789,442,1788,9324,9465,9324,9465,5.01769e+18,1138.99,4655.01,18789,341,326,14844,13166,5836,5343,5326
22223,134,1995,0,22223,0,22223,2.46659e+18,1199.46,5174.21,22223,405,341,15626,11607,5660,2403,1858
36425,1707,2632,30393,6032,19192,17233,7.21485e+17,1664.89,7479.07,36425,582,405,32910,28014,27197,26998,27843
43554,1099,2528,43554,0,35229,8325,2.97977e+18,1721.96,8353.34,43554,572,482,36699,30871,24047,22326,21906
41040,119,1375,14507,26533,0,41040,3.86686e+13,1113.87,5767.45,41040,481,387,31438,26829,11098,4267,5957
33425,5,43,31842,1583,32514,911,9.83755e+13,38.9932,825.363,33425,41,39,28709,25827,22421,22645,14388
27545,608,776,27028,517,27545,0,4.59242e+18,481.274,3279.25,27545,220,207,26769,26212,24966,24978,24192
8915,606,633,8677,238,8915,0,4.48509e+18,294.508,1794.37,8915,143,128,8282,8240,8255,8263,8085
27701,1519,1587,9814,17887,0,27701,3.69744e+13,1023.01,4800.69,27701,476,314,26114,26114,25877,25775,25945
23449,618,2090,18770,4679,11033,12416,8.41125e+17,1538.16,5843.3,23449,441,369,17805,14903,9773,9763,6253
49447,30,355,0,49447,47139,2308,2.52837e+16,307.066,2833.35,49447,148,162,45293,42790,32445,28496,18447
19835,18,43,18864,971,19381,454,1.00315e+14,39.1599,642.247,19835,39,36,19491,19237,16236,16126,12315
38287,625,2707,38287,0,32054,6233,3.2979e+18,1715.9,7784.67,38287,636,431,30115,26037,17988,16072,11304
19358,196,375,0,19358,18292,1066,2.70952e+16,258.58,1865.91,19358,118,122,18695,18319,16279,14687,13227
27289,281,2140,14776,12513,14776,12513,4.96275e+18,1259.55,5721.84,27289,468,360,21253,19021,8745,9020,4691
21062,283,2149,17081,3981,10383,10679,8.0242e+17,1422.62,5534.61,21062,434,354,14778,12345,6951,7680,3398
46755,1153,2502,24613,22142,24613,22142,4.91516e+18,1484.3,7833.43,46755,642,437,41556,36908,22373,23521,25664
18116,75,2352,15310,2806,9832,8284,6.9082e+17,1220.85,5106.35,18116,420,305,10540,7439,5062,5348,504
12134,1095,1433,0,12134,4245,7889,9.54758e+15,681.846,3175.98,12134,303,232,10701,9943,8757,7488,9201
32029,2132,2277,0,32029,0,32029,2.4333e+18,1312.08,6324.98,32029,520,376,29752,29752,29279,28968,29103
33306,1569,2300,17389,15917,0,33306,4.95673e+18,1375.2,6495.7,33306,558,384,30692,26845,21256,19452,24366
22488,179,2382,12009,10479,0,22488,4.97116e+18,1182.12,5488.17,22488,473,328,16312,13620,6231,5045,2312
7746,496,660,7537,209,7746,0,4.54638e+18,238.305,1698.76,7746,162,123,7086,7023,6632,6645,6362
28956,428,2205,0,28956,0,28956,2.43116e+18,1365.97,6059.57,28956,520,369,23088,20518,8212,5333,6230
44556,1786,2366,23105,21451,0,44556,5.02327e+18,1467.74,7574.01,44556,582,430,42190,39345,32376,30449,38670
49854,900,1375,0,49854,17594,32260,9.9004e+15,1137.87,6336.79,49854,512,402,46052,41125,30316,23468,36162
7970,629,2153,7970,0,6669,1301,3.30632e+18,374.997,3370.07,7970,293,197,5817,5316,3744,3628,1549
29175,21,1768,10324,18851,0,29175,3.69589e+13,1031.41,5114.52,29175,493,320,16669,12653,7636,3242,889
43932,4430,5979,43932,0,35451,8481,2.93894e+18,1891.44,12003.3,43932,1092,574,37953,37275,37253,37209,34389
2990,121,191,0,2990,2854,136,2.3232e+16,35.4187,549.412,2990,49,52,2799,2788,2617,2574,2336
41495,466,2527,34289,7206,21269,20226,7.56181e+17,1786.46,8016.83,41495,571,450,31484,27076,16371,17435,7016
41280,435,2970,34516,6764,21824,19456,7.16714e+17,1643.76,8200.26,41280,610,429,31380,27463,16490,18006,8656
20536,151,349,0,20536,19491,1045,2.60848e+16,258.686,1848.32,20536,114,121,19810,19435,16807,14709,12892
49539,1149,2173,24465,25074,24465,25074,4.97557e+18,1483.15,7942.09,49539,575,460,44364,38648,24539,24719,30911
42585,823,2455,0,42585,0,42585,2.50402e+18,1639.18,7841.61,42585,645,436,35448,31287,13387,13990,18374
16469,3,43,15739,730,15938,531,9.67023e+13,33.2795,575.586,16469,37,34,12137,10480,9802,9785,6999
22574,573,1718,0,22574,0,22574,2.54895e+18,1266.9,5064.12,22574,383,344,18181,15740,7725,6325,8252
2786,228,407,2586,200,2786,0,3.93875e+18,126.696,824.411,2786,106,69,2379,2299,2063,2053,1784
18134,1203,1548,0,18134,6396,11738,9.53603e+15,880.747,3970.13,18134,384,283,16460,15089,13434,11928,13796
7913,862,1663,3663,4250,3663,4250,4.86392e+18,504.231,2938.74,7913,267,210,6250,5804,4046,3493,4178
33384,140,356,0,33384,31795,1589,2.55518e+16,283.176,2342.83,33384,132,142,32296,31703,27123,23965,20117
20890,14,43,19809,1081,20516,374,1.02485e+14,37.6294,665.041,20890,39,38,20271,19815,16390,15879,10737
40576,51,2439,19347,21229,19347,21229,4.96779e+18,1571.6,7642.84,40576,578,436,20023,11455,5753,6373,1403
2839,678,790,0,2839,986,1853,8.70659e+15,87.8242,1240.54,2839,194,112,2049,2049,2008,2011,1928
13097,992,1989,7154,5943,7154,5943,5.05009e+18,772.365,3917.23,13097,309,274,10873,10058,7355,7556,6498
25736,137,824,24944,792,25736,0,4.50372e+18,487.148,3202.32,25736,256,197,22256,18296,10461,9273,5862
21222,161,701,20802,420,21222,0,4.69832e+18,448.491,2835.45,21222,224,195,18777,16295,9258,9064,5979
16419,934,1323,0,16419,5792,10627,9.86236e+15,835.867,3591.02,16419,313,280,14764,13497,10401,9194,12036
15589,561,1450,0,15589,5537,10052,9.77297e+15,833.428,3630.62,15589,317,270,13339,12253,7422,5751,6293
41170,2500,2792,41170,0,34282,6888,3.24932e+18,1727.02,8117.8,41170,658,441,38378,38378,38067,38112,37681
8338,181,689,8250,88,8338,0,4.73843e+18,305.39,1844.39,8338,164,131,7198,6262,4111,3941,3005
19175,1348,1512,6784,12391,0,19175,3.73507e+13,885.922,4024.92,19175,374,278,17663,16604,16315,16267,17174
3746,616,937,0,3746,0,3746,2.58604e+18,154.218,1494.11,3746,223,146,2809,2758,2614,2611,1320
43114,379,2435,22744,20370,0,43114,4.99725e+18,1439.42,7454.41,43114,632,411,34469,30875,13156,13478,8599
33593,466,1562,11851,21742,0,33593,3.77739e+13,1073.99,5380.45,33593,447,356,28805,26312,14518,10743,13528
16412,308,1996,8502,7910,8502,7910,4.8819e+18,1008.26,4434.29,16412,395,296,12650,11272,5003,5271,3241
33244,2230,2478,33244,0,27355,5889,3.16443e+18,1629.67,7153.83,33244,530,426,30766,30766,30425,30407,30318
38644,1168,1631,0,38644,13740,24904,9.71372e+15,1099,5775.95,38644,476,364,36390,32636,26817,20309,31839
26410,1545,2472,26410,0,21052,5358,2.9338e+18,1389.21,6454.26,26410,409,392,23198,19718,20412,19388,17047
1881,130,722,1436,445,766,1115,9.12973e+17,115.217,1038.73,1881,112,117,1065,763,561,501,90
41383,16,43,39427,1956,40315,1068,9.92712e+13,39.533,919.037,41383,42,40,40537,39855,32921,32831,25046
46389,92,1944,22650,23739,22650,23739,4.97691e+18,1463.01,7450.99,46389,553,453,28930,19925,9051,9017,2752
42009,2844,3082,35045,6964,21979,20030,7.26717e+17,1708.9,8455.58,42009,603,442,38927,38926,38226,37993,38435
32750,1722,2668,27608,5142,17658,15092,6.98376e+17,1576.01,7081.4,32750,539,393,29266,25248,24448,24281,23993
48976,75,640,48466,510,48976,0,4.71846e+18,512.383,4210.5,48976,265,263,35301,22402,12862,12956,6931
3666,204,811,1341,2325,0,3666,3.91634e+13,128.905,1413.74,3666,185,152,2852,2690,1791,1772,937
26082,156,2320,13241,12841,0,26082,5.0949e+18,1275.98,5958.5,26082,434,361,18222,13810,6145,4463,2640
28343,174,358,0,28343,26759,1584,2.73582e+16,289.771,2227.8,28343,133,144,27388,26707,23271,20159,18259
3935,349,825,1447,2488,0,3935,4.07445e+13,106.025,1438.26,3935,170,121,3110,3062,2508,2712,1547
15875,488,2381,13287,2588,8394,7481,7.16879e+17,1111.95,4854.25,15875,396,300,11942,10579,6582,6942,3145
18670,174,347,0,18670,17733,937,2.59516e+16,237.082,1740.73,18670,108,116,18059,17720,15803,14443,12377
30129,996,1425,0,30129,10684,19445,9.88471e+15,1063.75,4991.74,30129,435,352,27784,25095,19587,15303,22792
28656,571,1677,0,28656,10190,18466,9.52479e+15,1024.86,4958,28656,481,318,24979,23053,15104,10203,11578
12060,18,43,11508,552,11717,343,9.71862e+13,29.2885,487.624,12060,35,32,11870,11731,10044,9992,7652
48587,394,1894,17292,31295,0,48587,3.74316e+13,1180.81,6673.07,48587,610,392,41536,38086,19892,17030,14600
13190,56,743,12828,362,13190,0,4.61341e+18,376.463,2268.95,13190,203,150,9117,5977,4210,3937,1539
9012,25,42,8557,455,8798,214,1.00728e+14,28.4505,416.642,9012,32,30,8938,8889,8115,8081,7559
33165,62,1742,0,33165,11819,21346,9.57814e+15,1101.13,5421.44,33165,508,349,23853,19808,10224,5165,2479
27514,101,349,0,27514,25988,1526,2.7279e+16,287.272,2177.29,27514,132,141,26234,25643,20076,17112,13195
2844,17,27,2778,66,2639,205,8.31364e+13,14.6874,193.748,2844,19,19,2816,2804,2671,2663,2261
11918,879,2154,9928,1990,6305,5613,7.35026e+17,880.289,4073.37,11918,324,275,9251,8211,6743,6437,5094
18044,390,2375,18044,0,15201,2843,3.35352e+18,1228.86,5120.89,18044,448,328,13407,11913,7549,6634,3198
44866,375,1900,0,44866,15899,28967,9.52015e+15,1170.95,6464.92,44866,601,376,38133,34891,16830,11580,13052
4073,46,1271,4073,0,3581,492,3.38466e+18,191.639,1883.92,4073,189,150,2327,1730,1022,928,91
40603,300,354,0,40603,38540,2063,2.60791e+16,300.152,2608.05,40603,144,156,40042,39111,37724,35378,37058
23691,490,2060,23691,0,18958,4733,3.05119e+18,1547.85,5849.2,23691,438,383,17450,14614,7774,6633,5998
3551,166,1304,3551,0,2836,715,2.69747e+18,162.426,1839.07,3551,194,138,2157,1133,844,655,471
19114,67,1428,6802,12312,0,19114,3.8624e+13,911.683,4002.32,19114,344,287,13428,10920,5281,1636,917
36284,1130,2362,19076,17208,0,36284,4.97996e+18,1411.82,6830.91,36284,580,394,32059,28561,18269,16670,20923
34212,1384,2072,17178,17034,0,34212,5.09607e+18,1369.29,6525.78,34212,482,408,31263,27181,20961,18562,24588
44066,1774,2383,23346,20720,0,44066,5.02223e+18,1476.43,7502.24,44066,600,427,41683,36309,31963,29933,35988
1356,108,384,1354,2,1356,0,5.21961e+18,108.427,636.804,1356,104,65,930,736,538,528,472
26666,543,1746,0,26666,0,26666,2.52589e+18,1323.91,5519.54,26666,431,375,21456,18694,8353,6946,9142
17524,2160,2243,17524,0,14492,3032,3.07757e+18,1238.06,5071.72,17524,387,328,15281,15225,15202,15183,15275
14717,30,357,0,14717,13993,724,2.5764e+16,211.768,1575.53,14717,102,106,13388,12612,9439,8147,4764
45654,2212,2469,23983,21671,23983,21671,4.91853e+18,1482.2,7710.44,45654,620,429,43185,43185,41465,41403,42053
10332,17,42,9803,529,10129,203,1.00745e+14,28.5149,445.747,10332,34,31,10141,9988,8569,8521,6859
32202,1036,2303,0,32202,0,32202,2.44481e+18,1406.52,6449.28,32202,541,386,27931,24900,15372,13824,16060
17898,700,2031,9326,8572,9326,8572,4.8783e+18,1082.98,4644.01,17898,433,297,14726,13114,7558,7430,6695
13276,9,42,12618,658,12957,319,9.98607e+13,33.3347,511.964,13276,33,32,12507,12007,9728,9653,7482
33153,1089,1819,0,33153,11757,21396,9.49027e+15,1087.92,5509.65,33153,515,337,30534,27787,21374,16671,21704
10432,30,344,0,10432,9923,509,2.57714e+16,151.989,1280.72,10432,83,90,9519,8962,6980,5945,3738
27285,15,43,26000,1285,26564,721,9.92413e+13,36.7017,740.996,27285,40,37,26650,26191,21655,21202,16315
2082,218,581,0,2082,728,1354,1.00729e+16,94.4308,919.625,2082,110,120,1501,1433,725,670,793
19984,803,2117,0,19984,0,19984,2.39959e+18,1071.23,4895.16,19984,451,313,16761,15249,9235,8526,8739
46037,550,2475,23265,22772,0,46037,5.03694e+18,1651.77,8016.08,46037,639,453,37534,32681,13901,13822,14483
10147,899,2138,10147,0,8285,1862,3.28406e+18,759.143,3770.02,10147,314,232,7858,6952,5714,5534,4406
28583,741,2323,23448,5135,14445,14138,7.73954e+17,1582.7,6548.93,28583,487,390,22583,19252,13908,13780,9940
4471,551,1316,0,4471,0,4471,2.49642e+18,205.556,2016.68,4471,204,156,3155,3001,1695,1470,1454
37707,2495,2695,31547,6160,19911,17796,7.19369e+17,1699.24,7684.55,37707,578,420,35012,35012,34267,34089,34311
2884,24,39,2756,128,2773,111,9.10601e+13,18.8405,244.141,2884,25,26,2836,2821,2587,2578,2452
12952,99,1985,0,12952,0,12952,2.38045e+18,782.608,3890.19,12952,345,245,8666,6697,3642,2181,1403
35529,416,2799,29672,5857,18614,16915,7.24182e+17,1664.79,7542.45,35529,623,409,26746,23495,13641,14913,7363
44506,14,362,0,44506,42347,2159,2.57236e+16,313.843,2726.56,44506,148,157,37406,33602,26462,23998,14482
33631,1177,2487,27466,6165,16745,16886,7.89401e+17,1645.42,7278.13,33631,511,411,28428,24944,20526,20341,18659
48375,1347,2857,48375,0,39978,8397,2.99641e+18,1797.21,8953.85,48375,612,477,42224,35808,32108,30157,26351
49845,1252,2502,26168,23677,26168,23677,4.94571e+18,1510.07,8081.28,49845,661,447,45137,39549,25610,26976,31739
31994,668,1555,0,31994,11288,20706,9.92188e+15,1082.74,5307.77,31994,446,351,28114,25697,15524,11990,16419
21833,297,351,0,21833,20758,1075,2.59115e+16,269.32,1897.19,21833,115,124,21387,20997,20233,19422,19035
42885,3003,6993,25186,17699,6902,35983,3.51735e+18,842.189,13058.8,42885,866,612,35892,35880,16401,16595,11095
12242,613,669,12074,168,12242,0,4.66138e+18,359.378,2139.96,12242,187,151,11573,11480,11325,11329,11345
20603,989,2214,10235,10368,0,20603,5.11057e+18,1042.04,5258.62,20603,376,338,17777,16442,10441,9436,12633
5310,512,1090,0,5310,1888,3422,9.22312e+15,136.357,1849.69,5310,193,131,4220,4112,3187,3149,2963
38636,892,1753,0,38636,0,38636,2.5367e+18,1420.97,6631.83,38636,501,419,33192,29096,17587,13765,20100
39031,1103,2020,19238,19793,0,39031,5.0964e+18,1397.13,6886.27,39031,511,426,34723,30452,19440,16720,24701
11667,175,1749,5849,5818,5849,5818,5.04044e+18,836.872,3640.94,11667,289,274,8219,6434,2877,2654,1628
44676,55,355,0,44676,42556,2120,2.54902e+16,304.295,2699.35,44676,143,159,42284,40953,31422,27017,18486
3909,1023,1076,3909,0,3445,464,3.24217e+18,103.443,1649.38,3909,115,132,2833,2833,2833,2833,2809
34881,1987,2233,28431,6450,17414,17467,7.91443e+17,1653.62,7166.22,34881,538,425,32603,29381,30374,29965,31994
44804,515,967,43625,1179,44804,0,4.55434e+18,578.323,4340.96,44804,285,248,43486,42170,36197,36081,32081
34004,1228,2304,0,34004,0,34004,2.43435e+18,1426.13,6610.05,34004,555,397,30263,26733,17917,15923,20741
46469,1588,1927,0,46469,0,46469,2.50441e+18,1467.29,7446.32,46469,553,457,44225,37586,33425,30929,41420
33490,2188,2670,0,33490,0,33490,2.43864e+18,1324.08,6860.57,33490,525,395,30820,30817,28363,27821,28820
45219,864,2760,37775,7444,23843,21376,7.21127e+17,1744.99,8417.3,45219,638,441,37046,31706,25742,24162,17329
11035,1915,1956,0,11035,0,11035,2.46027e+18,704.655,3636.62,11035,311,269,9079,9079,9034,8922,9077
29648,1865,2208,14127,15521,0,29648,5.10822e+18,1459.49,6376.19,29648,486,390,27433,23711,21889,21012,26557
33842,1401,1864,11883,21959,0,33842,3.80766e+13,1136.44,5802.04,33842,566,369,31865,30280,27979,28557,31019
25168,989,1650,0,25168,8986,16182,9.62609e+15,996.192,4670.45,25168,426,315,22768,20956,15998,12803,19053
28139,1282,1727,0,28139,0,28139,2.53267e+18,1333.56,5636.29,28139,431,385,25345,22061,17192,16028,20765
31458,1163,2247,0,31458,0,31458,2.45044e+18,1366.34,6311.65,31458,530,382,27636,24706,16468,13897,19309
8467,15,43,8104,363,8169,298,9.42132e+13,23.2428,410.429,8467,32,32,8273,8139,6960,6846,5623
13905,103,349,0,13905,13285,620,2.49365e+16,175.523,1455.77,13905,94,97,13374,13176,11075,9639,7124
23800,23,43,22718,1082,23103,697,9.76177e+13,36.2693,698.086,23800,39,37,23583,23416,20657,20603,16991
14857,959,1522,0,14857,5270,9587,9.5128e+15,775.783,3545,14857,327,254,12967,12201,9526,7810,10367
11482,698,1460,0,11482,4121,7361,9.6354e+15,525.881,2982.93,11482,306,234,9963,9346,7240,5341,7305
21946,1550,2446,21946,0,18411,3535,3.31195e+18,1402.94,5730.24,21946,483,345,18910,16459,18059,16815,13029
49798,1259,2508,0,49798,0,49798,2.45811e+18,1507.5,8088.24,49798,657,452,45128,39522,25859,22468,31178
40682,1069,1872,14467,26215,0,40682,3.72352e+13,1122.44,6071.58,40682,570,363,37599,34233,25428,24960,29372
48898,213,355,0,48898,46412,2486,2.61497e+16,309.953,2870.94,48898,158,166,47746,46690,42253,38263,35899
39247,680,2044,19758,19489,0,39247,5.01917e+18,1483.99,6925.48,39247,540,414,32751,28654,14319,13371,15101
31279,185,357,0,31279,29760,1519,2.58315e+16,285.319,2281.3,31279,130,141,30395,29773,26620,23885,21631
19024,488,585,18832,192,19024,0,4.71576e+18,439.341,2594.68,19024,191,198,18340,17915,17158,17206,16610
28406,1156,1699,13365,15041,13365,15041,4.96696e+18,1325.24,5626.18,28406,450,376,25319,21993,16148,14472,19780
10907,400,1351,3873,7034,0,10907,3.85865e+13,621.838,2945.91,10907,259,242,9025,8385,5260,4360,3968
37142,1012,2062,37142,0,29497,7645,2.99407e+18,1609.24,7220.17,37142,497,449,30877,26027,20839,19527,20091
12740,1162,2320,10449,2291,6364,6376,7.79025e+17,1009.5,4370.39,12740,358,278,10053,8975,7822,7827,6236
28422,1816,2020,13639,14783,0,28422,5.1516e+18,1386.08,6013.15,28422,446,380,26402,24816,22853,22433,25673
14006,919,2177,14006,0,11450,2556,3.03905e+18,1085.16,4542.76,14006,329,303,10835,9713,7299,6915,5847
15438,1898,1999,0,15438,0,15438,2.43688e+18,952.186,4300.38,15438,390,291,13439,13438,12950,12845,12828
2476,100,117,0,2476,2416,60,2.32529e+16,38.2658,390.432,2476,44,34,2359,2359,2339,2347,2241
43770,49,2286,43770,0,35508,8262,3.02158e+18,1737.53,8106.79,43770,600,468,19596,10601,6568,6845,1265
48137,36,43,45788,2349,46972,1165,1.00025e+14,41.1985,992.855,48137,43,41,48033,47948,45802,45814,44245
8204,426,2134,8204,0,6835,1369,3.26446e+18,438.054,3395.08,8204,289,217,5952,5239,3289,3172,1844
22349,885,2645,22349,0,18552,3797,3.09267e+18,1451.85,6098.78,22349,428,342,17635,14963,11670,11273,7010
49828,1112,1370,0,49828,17645,32183,9.93949e+15,1141.94,6335.27,49828,494,410,47451,41666,36523,30408,42538
21408,415,2002,11253,10155,11253,10155,4.90649e+18,1168.35,5005.83,21408,450,325,17119,15377,7706,7696,5247
14450,1098,2013,7629,6821,0,14450,4.99947e+18,927.547,4174.88,14450,355,282,12053,11073,8246,7648,8417
11342,1384,2233,11342,0,9291,2051,3.02803e+18,903.546,4096.15,11342,326,269,9109,8125,7818,7133,6778
21878,1139,2418,18298,3580,11517,10361,7.20575e+17,1417,5722.09,21878,442,340,18027,15901,13960,13685,10308
11457,6,42,10890,567,11229,228,1.02694e+14,31.346,473.92,11457,34,32,10251,9416,7885,8001,5181
1719,45,285,1565,154,1719,0,3.65737e+18,42.0791,526.45,1719,61,53,1379,1217,1164,1186,763
26872,219,1734,12731,14141,0,26872,5.09901e+18,1321.46,5527.03,26872,415,374,19483,16573,5208,3854,3305
6826,207,348,0,6826,6467,359,2.68449e+16,82.8062,1078.05,6826,78,82,6478,6428,5977,5789,5094
35649,706,1613,12691,22958,0,35649,3.89095e+13,1102.7,5666.73,35649,450,378,31825,29007,17484,17759,18655
28800,450,2035,14661,14139,14661,14139,4.95464e+18,1327.32,5921.43,28800,444,371,23084,20346,8498,8760,7480
22040,707,1955,11232,10808,0,22040,5.04773e+18,1242.69,5149.89,22040,408,335,18153,16055,8585,7603,8484
11162,16,42,10598,564,10916,246,1.02206e+14,32.4274,467.297,11162,33,31,10930,10762,8994,8901,7018
17000,275,1524,0,17000,6025,10975,9.50918e+15,846.22,3782.15,17000,388,260,14044,12969,6232,4303,4237
23599,457,1723,11331,12268,11331,12268,5.06969e+18,1261.84,5171.32,23599,394,353,18698,16285,7282,6323,7909
38857,18,43,37055,1802,37798,1059,9.87922e+13,39.6316,895.523,38857,42,40,38225,37757,32016,31808,25129
7930,616,1814,4168,3762,0,7930,5.01548e+18,319.918,2995.47,7930,280,196,6116,5685,3699,3383,2386
6796,480,1649,3432,3364,0,6796,5.02408e+18,211.313,2696.78,6796,215,183,5147,4871,3035,2779,1937
972,17,37,908,64,968,4,1.0425e+14,18.6965,142.547,972,22,20,922,906,757,736,604
41852,1845,2199,21382,20470,0,41852,5.08432e+18,1437.02,7267.65,41852,534,435,39653,39561,34807,33761,37735
26967,11,43,25661,1306,26332,635,1.00286e+14,39.8046,747.273,26967,41,38,25826,24986,20630,20137,14302
33694,729,2315,0,33694,0,33694,2.43703e+18,1423.53,6596.52,33694,554,397,28196,24850,12322,12935,11639
46324,1778,2160,23854,22470,0,46324,5.05162e+18,1527.51,7568.35,46324,595,439,44125,41827,35970,34626,42689
33311,203,1643,0,33311,11823,21488,9.67334e+15,1096.32,5376.55,33311,473,355,27151,24868,11609,7144,5924
42959,2238,2489,22279,20680,22279,20680,4.90111e+18,1467.41,7536.59,42959,622,423,40470,40470,38108,37862,39713
10676,1827,2076,8596,2080,5135,5541,8.267e+17,924.539,3903.29,10676,305,268,8600,7713,7945,7833,8228
41629,1115,1738,0,41629,0,41629,2.54269e+18,1415.58,6840.48,41629,517,439,37358,32381,22791,18854,26890
20305,919,2159,9611,10694,9611,10694,4.97429e+18,1296.1,5262.4,20305,446,334,16710,15040,7918,8192,9791
22269,366,386,0,22269,21109,1160,2.72453e+16,277.572,2029.14,22269,126,129,21869,21472,21603,21386,21193
15463,165,354,0,15463,14679,784,2.60495e+16,225.832,1601.09,15463,100,105,14911,14637,13003,11740,11034
42868,317,352,0,42868,40613,2255,2.64039e+16,307.117,2693.12,42868,144,160,42370,41327,40779,38736,39821
38902,1283,1370,0,38902,13745,25157,9.90234e+15,1105.82,5607.49,38902,459,376,37514,33372,36082,34107,36730
40096,282,726,39661,435,40096,0,4.76091e+18,528.697,3937.14,40096,257,239,37812,35760,21186,20856,18830
38827,70,2312,20381,18446,0,38827,5.00703e+18,1455.74,7029.37,38827,573,414,23856,17235,9317,6298,1757
9616,22,43,9092,524,9498,118,1.07485e+14,33.4567,456.748,9616,34,33,9488,9388,8077,8040,6942
43800,188,384,0,43800,41397,2403,2.72224e+16,328.409,2829.63,43800,155,162,42478,41538,36152,31384,29416
5506,681,1168,0,5506,1917,3589,9.52919e+15,140.922,2004.24,5506,193,146,4338,4278,3470,3291,3322
22886,1099,2114,0,22886,0,22886,2.44597e+18,1222.41,5303.54,22886,454,340,19691,17837,12271,11325,12578
46575,6,43,44421,2154,45219,1356,9.7953e+13,40.8432,977.898,46575,43,40,41761,38711,32200,32529,20683
40560,1713,2885,40560,0,33943,6617,3.18347e+18,1896.56,8304.71,40560,612,436,36203,31031,34378,33149,27606
25697,126,829,24924,773,25697,0,4.54548e+18,499.316,3199.11,25697,243,196,21902,17644,10400,9821,4989
38456,1290,1799,13648,24808,0,38456,3.72379e+13,1121.41,5841.02,38456,562,356,36355,32847,27834,29371,33881
21958,184,351,0,21958,20935,1023,2.51405e+16,252.94,1870.4,21958,113,120,21300,20933,18869,17282,15184
919,11,332,427,492,427,492,5.20573e+18,104.938,507.213,919,75,67,242,59,54,70,23
44728,1747,2494,23193,21535,23193,21535,4.89313e+18,1486.66,7688.19,44728,642,427,42221,36400,30052,28881,36818
32241,1902,2643,32241,0,26950,5291,3.28761e+18,1645.97,7133.43,32241,597,412,29351,24886,27979,27197,24967
27807,1487,2148,14419,13388,0,27807,4.98779e+18,1310.01,5873,27807,493,367,25243,22184,17908,16403,21140
45452,859,6361,0,45452,0,45452,2.29074e+18,988.492,11792.6,45452,1045,569,38000,34525,14831,11243,8864
41103,1545,1914,0,41103,0,41103,2.49831e+18,1439.59,7004.93,41103,540,431,38712,33016,28305,26641,34120
31876,31,43,30386,1490,31023,853,9.90676e+13,39.2823,808.774,31876,41,39,31738,31651,29238,29201,27097
1525,408,543,603,922,603,922,4.21821e+18,89.1895,808.507,1525,100,92,982,980,842,865,817
8509,142,571,8445,64,8509,0,4.80722e+18,281.103,1712.7,8509,148,136,7323,5940,3483,3550,2281
44381,185,355,0,44381,42310,2071,2.51969e+16,298.333,2667.4,44381,141,154,43266,42436,38103,34407,31231
25422,1925,2132,12886,12536,0,25422,5.03473e+18,1266.41,5664.56,25422,424,357,23290,23286,21787,21675,22943
36641,1656,2302,0,36641,0,36641,2.44977e+18,1392.6,6789.74,36641,554,400,34233,29840,25428,22642,29751
32075,1554,1834,11346,20729,0,32075,3.7715e+13,1072.98,5551.46,32075,564,347,30241,29690,27519,27682,29162
41966,1638,1776,0,41966,0,41966,2.52731e+18,1442.35,6921.56,41966,516,435,40121,34259,36022,33568,39356
17722,1176,1549,6288,11434,0,17722,3.74514e+13,873.94,3860.3,17722,382,271,15949,14808,13050,11996,14584
45576,332,2561,24341,21235,24341,21235,4.93016e+18,1480.38,7761.79,45576,639,435,35937,32210,12967,14057,4569
4192,180,271,0,4192,3971,221,2.73655e+16,66.9781,791.154,4192,64,62,3921,3894,3715,3641,3349
41279,1724,2408,21989,19290,0,41279,5.01509e+18,1416.14,7264.03,41279,589,410,38844,33738,29076,27041,33918
27567,1958,2111,0,27567,0,27567,2.45294e+18,1287.19,5825.52,27567,460,361,25456,25453,24816,24573,24965
1994,502,679,1095,899,0,1994,5.5682e+18,63.0777,1027.08,1994,115,110,1315,1315,1306,1306,844
25673,12,43,24218,1455,25417,256,1.06821e+14,40.3553,741.063,25673,42,38,24602,23859,19161,18746,12629
15744,1225,2539,15744,0,12838,2906,3.05023e+18,1277.81,5206.53,15744,410,314,12272,10966,10077,9315,7822
12130,85,345,0,12130,11590,540,2.46589e+16,158.572,1343.44,12130,85,86,11614,11419,9584,8586,6542
6855,1262,1948,6855,0,5719,1136,3.02677e+18,217.337,2955.67,6855,237,203,4907,4817,4709,4671,4085
6137,514,1273,2171,3966,0,6137,3.88277e+13,205.403,2186.31,6137,220,156,4864,4662,3072,3050,2732
32684,514,1305,0,32684,11585,21099,9.97491e+15,1051.78,5058.56,32684,422,363,28370,25683,14432,11471,14437
48812,404,847,47453,1359,48812,0,4.55028e+18,656.967,4443.58,48812,311,249,46778,45137,32248,30984,24758
6473,264,326,0,6473,6170,303,2.46798e+16,59.2527,984.511,6473,71,73,6147,6144,6003,5987,5684
17059,66,353,0,17059,16120,939,2.72873e+16,244.75,1711.54,17059,112,116,16036,15604,11677,10158,6947
48144,20,42,45391,2753,47691,453,1.0705e+14,40.4889,996.297,48144,42,42,47452,46909,39323,38745,30769
22434,105,2172,0,22434,0,22434,2.42907e+18,1149.86,5283.49,22434,452,338,15021,11019,5600,2202,1370
24652,906,1513,8783,15869,0,24652,3.79885e+13,976.794,4534.59,24652,393,314,22304,20465,15678,14476,17798
7062,678,1632,0,7062,0,7062,2.50395e+18,416.812,2773.61,7062,261,214,5430,4920,2967,2705,3060
36431,1941,2272,0,36431,0,36431,2.51405e+18,1456.29,7010.01,36431,600,424,34159,32273,29016,27155,33964
23626,26,378,0,23626,22397,1229,2.72298e+16,273.916,2068.27,23626,125,131,20972,19533,14608,12571,7769
29327,319,1356,0,29327,10327,19000,9.81436e+15,1051.13,4862.72,29327,416,341,24465,22188,10534,8091,8668
30386,1489,1711,10803,19583,0,30386,3.72693e+13,1064.12,5182.49,30386,485,329,28675,28634,26497,26315,28139
528,6,267,235,293,235,293,4.58075e+18,47.6515,345.16,528,61,68,101,10,16,19,8
34677,1475,2360,0,34677,0,34677,2.4441e+18,1366.17,6633.59,34677,555,385,31671,27944,21675,19035,22715
24486,1096,2133,12862,11624,0,24486,5.01788e+18,1243.83,5489.26,24486,468,346,21204,19120,12808,11637,14606
10122,884,1384,0,10122,3609,6513,9.8862e+15,513.929,2823.61,10122,264,234,8738,8268,6250,6295,7062
48980,402,1405,17319,31661,0,48980,3.86531e+13,1145.76,6338.79,48980,510,404,41761,37868,19568,14912,16660
11122,884,1783,0,11122,0,11122,2.55124e+18,785.586,3578.86,11122,282,277,9024,8284,5499,5059,5938
32791,1308,2305,17158,15633,17158,15633,4.91561e+18,1419.85,6508.5,32791,544,394,29280,25780,18090,18334,20920
29350,34,43,27990,1360,28553,797,9.80418e+13,39.0827,779.294,29350,41,39,29255,29174,27574,27574,25611
4910,781,1549,4910,0,3950,960,2.84223e+18,237.454,2360.65,4910,187,168,3361,3193,2628,2568,2064
22492,334,2084,12068,10424,0,22492,5.05976e+18,1148.25,5179.57,22492,458,322,17759,16016,7143,6343,4468
31894,1759,2035,0,31894,0,31894,2.49492e+18,1374.93,6241.52,31894,473,386,29859,28189,25409,24706,28136
23150,820,1581,0,23150,8224,14926,9.59016e+15,969.183,4456.46,23150,412,293,20609,19009,13793,9549,11744
9716,502,656,9505,211,9716,0,4.76257e+18,298.369,1876.02,9716,176,136,9060,8952,8678,8661,8214
3336,1072,1109,1564,1772,1564,1772,5.09243e+18,171.95,1659.1,3336,186,165,2227,2227,2226,2226,2199
32485,572,2754,32485,0,27045,5440,3.23667e+18,1603.97,7299.95,32485,605,412,25211,21434,13948,11640,8221
10384,1012,1297,0,10384,3675,6709,9.84432e+15,590.228,2837.32,10384,276,245,9087,8471,7269,6730,8014
38458,48,353,0,38458,36672,1786,2.52927e+16,294.604,2489.81,38458,138,145,36214,34899,26972,23268,15432
15230,979,1416,5392,9838,0,15230,3.81239e+13,792.958,3533.11,15230,315,273,13476,12496,9902,9139,11035
47555,939,2891,39605,7950,24859,22696,7.31503e+17,1776.44,8765.63,47555,693,455,39394,34040,27909,26421,20538
31467,508,1576,0,31467,11138,20329,9.77464e+15,1044.27,5260.52,31467,426,350,27171,24803,13586,10526,10593
33252,1080,2148,17225,16027,0,33252,4.98907e+18,1401.81,6394.23,33252,536,383,29308,26090,16453,15054,16801
42824,287,2839,42824,0,35581,7243,3.30972e+18,1769.91,8344.4,42824,675,448,30680,25906,14625,11373,5890
29019,731,832,28177,842,29019,0,4.58447e+18,510.217,3391.89,29019,289,211,28187,28101,27617,27554,26920
34602,1712,1733,12330,22272,0,34602,3.73585e+13,1078.39,5478.2,34602,518,347,32869,32869,32815,32848,32821
46365,3017,3335,46365,0,38830,7535,3.28917e+18,1805.47,9211.87,46365,795,473,43030,43030,42814,42774,42237
14868,45,1514,5289,9579,0,14868,3.8928e+13,813.646,3640.62,14868,311,267,9422,7170,3711,1201,1125
12844,392,2139,10673,2171,6698,6146,7.39346e+17,976.725,4240.44,12844,331,284,9408,8391,4968,5170,2952
40647,1943,2360,0,40647,0,40647,2.44961e+18,1435.02,7179.6,40647,554,413,38287,38056,32602,31737,35476
3139,88,466,3138,1,3139,0,4.96263e+18,161.532,993.922,3139,125,90,2246,1507,1030,906,756
49144,1851,2517,25522,23622,25522,23622,4.87792e+18,1509.55,8054.68,49144,684,445,46627,46361,35546,34415,42463
4999,1055,1734,4999,0,4050,949,3.30915e+18,214.683,2526.4,4999,224,184,3265,3152,2974,2885,2597
14856,1654,1994,7784,7072,7784,7072,4.91066e+18,937.729,4208.14,14856,373,290,12862,11797,10990,10797,11373
8272,767,2036,8272,0,6628,1644,2.88582e+18,681.352,3428.97,8272,240,237,6078,5180,3764,3728,3348
5122,626,1691,4225,897,2563,2559,7.7912e+17,198.474,2497.6,5122,243,171,3431,3245,2458,2429,1768
12775,2185,2210,10550,2225,6530,6245,7.58731e+17,995.845,4303.45,12775,347,292,10565,10563,10549,10560,10560
2683,154,384,2605,78,2683,0,4.3451e+18,133.523,853.973,2683,82,73,2250,2020,1387,1370,1238
4881,284,461,4624,257,4881,0,4.40235e+18,149.538,1138.73,4881,122,93,4420,4379,4237,4282,3222
8846,106,614,8719,127,8846,0,4.66397e+18,281.159,1770.59,8846,177,136,7104,5145,3088,3009,1970
27989,655,2332,14355,13634,0,27989,4.96657e+18,1278.97,6031.08,27989,512,371,23021,20508,9654,9711,10967
40785,37,43,38964,1821,39539,1246,9.74555e+13,38.6892,912.013,40785,42,40,40705,40643,38924,38931,37170
4539,36,39,4343,196,4386,153,9.82282e+13,23.9606,301.582,4539,27,25,4500,4496,4484,4486,4416
25760,1343,1647,9128,16632,0,25760,3.70558e+13,977.778,4689.58,25760,457,301,24070,21905,20460,20774,22199
26600,950,1856,13033,13567,13033,13567,4.98174e+18,1314.36,5615.77,26600,427,371,22711,20218,13121,12783,15401
47584,190,2898,39725,7859,25011,22573,7.26481e+17,1762.28,8761.43,47584,687,453,32647,25167,15085,17250,5153
44698,645,2555,36581,8117,22365,22333,7.77979e+17,1718.9,8367.79,44698,595,454,35089,29672,20399,20269,13677
5749,136,320,0,5749,5426,323,2.76875e+16,79.2393,953.906,5749,73,72,5429,5347,4738,4406,3422
26286,1318,2391,12520,13766,0,26286,5.07848e+18,1426.7,6169.65,26286,507,367,22760,20169,12420,10721,16217
6083,70,1923,4956,1127,2980,3103,7.92662e+17,306.122,2885.71,6083,266,197,2833,1601,1039,1001,259
12352,132,1917,0,12352,0,12352,2.47376e+18,629.982,3637.68,12352,323,268,9044,7114,4016,1614,1065
3500,342,1044,2894,606,1866,1634,7.27947e+17,86.4789,1584.72,3500,155,138,2456,2359,1909,1784,1202
7053,95,342,0,7053,6677,376,2.60932e+16,89.9033,1076.28,7053,72,78,6678,6567,5359,4938,3959
18633,616,831,18628,5,18633,0,4.66981e+18,431.263,2894.03,18633,237,189,17802,17598,16067,16050,15541
19239,1081,1576,6824,12415,0,19239,3.73216e+13,930.915,4072.21,19239,392,284,17353,15943,12605,12242,12823
33092,785,2632,27604,5488,17368,15724,7.23772e+17,1634,7176.54,33092,581,402,26630,22743,16820,16734,11393
7969,1039,1491,3876,4093,3876,4093,4.87854e+18,422.176,2809.02,7969,248,214,6478,6455,4778,4609,5286
49045,282,350,0,49045,46369,2676,2.6825e+16,313.605,2890.83,49045,152,166,48322,47121,44274,40972,41940
11794,1096,1867,0,11794,0,11794,2.49685e+18,656.375,3585.56,11794,297,270,9927,9206,7293,6804,7126
46421,2025,2119,16512,29909,0,46421,3.73072e+13,1142.21,6762.72,46421,603,383,44302,44302,43927,43742,44156
4488,45,1461,4488,0,3832,656,2.94195e+18,195.997,2178.11,4488,161,148,1943,1233,1007,861,119
32779,221,353,0,32779,31226,1553,2.53837e+16,286.297,2303.45,32779,128,135,32048,31413,28862,26584,25499
11531,22,43,10891,640,11403,128,1.06624e+14,35.2862,491.488,11531,36,33,11385,11269,9687,9649,8501
31237,844,1729,14846,16391,14846,16391,4.98413e+18,1347.36,5923.7,31237,459,395,26578,23419,13797,12608,16979
25841,1286,2178,13728,12113,0,25841,4.98702e+18,1233.36,5635.03,25841,485,341,22911,20432,15090,13933,16364
41589,1432,2479,34659,6930,21869,19720,7.31946e+17,1769.03,7913.1,41589,607,438,36667,31299,29643,29562,27667
34224,1602,1770,0,34224,12170,22054,9.52509e+15,1069.1,5506.99,34224,517,339,32454,32454,31196,30653,32115
32765,10,42,31136,1629,32097,668,1.02161e+14,40.2386,815.366,32765,41,40,31130,29971,24685,23943,16155
4029,624,874,0,4029,1461,2568,9.95434e+15,135.682,1527.27,4029,197,157,3155,3133,2695,2794,2620
48424,981,1363,17098,31326,0,48424,3.86383e+13,1120,6228.64,48424,496,403,45418,40375,31677,32965,37405
21461,1237,2093,0,21461,0,21461,2.4171e+18,1204.59,5136.38,21461,447,327,18688,16772,11836,10247,12808
15449,1797,1850,0,15449,0,15449,2.48878e+18,990.496,4244.49,15449,336,304,13599,13590,13532,13317,13599
40084,573,1893,0,40084,0,40084,2.52885e+18,1455.83,6926.45,40084,514,438,32834,28584,13232,11472,14708
34576,425,610,34254,322,34576,0,4.72072e+18,504.634,3524.44,34576,239,231,33453,32391,27943,28036,26071
28164,966,2122,14913,13251,14913,13251,4.9183e+18,1314.34,5842.77,28164,499,351,24339,21816,13786,14417,13650
23993,1121,1957,12211,11782,0,23993,5.0677e+18,1233.48,5340.57,23993,424,351,20980,18759,12908,11483,14363
24976,1239,2322,13025,11951,0,24976,4.95164e+18,1249.31,5713.91,24976,501,347,21811,19546,13479,12638,14290
21828,77,2098,21828,0,17535,4293,2.97792e+18,1484.1,5628.68,21828,391,352,10779,5923,3576,3276,1160
19297,95,375,0,19297,18244,1053,2.71547e+16,256.559,1855.75,19297,113,122,18356,17946,13961,12051,8447
23699,852,1738,11165,12534,11165,12534,4.98174e+18,1296.54,5218.98,23699,414,357,19907,17565,10645,9610,11053
27605,777,2032,22119,5486,13111,14494,8.31213e+17,1591.61,6255.79,27605,461,386,21766,17993,13231,12824,9451
41481,537,1553,3318,38163,39596,1885,3.43389e+17,233.944,5052.04,41481,255,179,39928,39787,36179,33561,25676
21837,1654,2468,21837,0,18055,3782,3.27818e+18,1496.6,5828.55,21837,497,360,18855,16237,17984,16967,14194
18417,930,1538,6481,11936,0,18417,3.67411e+13,864.236,3919.79,18417,419,274,16489,15297,11785,12179,12570
19187,755,2389,19187,0,16001,3186,3.2177e+18,1295.31,5352.67,19187,424,324,15082,13072,9921,9426,7135
43736,205,874,42475,1261,43736,0,4.56914e+18,590.647,4203.23,43736,308,241,39974,36295,20702,19577,13354
32966,1155,2302,32966,0,26991,5975,3.05008e+18,1675.5,7060.49,32966,515,427,27722,23634,21749,20313,18686
44963,360,1501,0,44963,15926,29037,9.82282e+15,1142.41,6163.94,44963,492,392,38096,34719,17998,12253,13938
47049,197,355,0,47049,44415,2634,2.72815e+16,315.22,2861.25,47049,157,167,45731,44582,39172,34447,31617
20692,686,2423,20692,0,16865,3827,2.98631e+18,1569.38,5864.56,20692,458,352,15631,12687,8227,6564,6765
47105,877,924,45751,1354,47105,0,4.57706e+18,652.984,4423.32,47105,305,244,46181,46063,45749,45780,45032
13288,1024,1582,0,13288,4752,8536,9.42679e+15,647.54,3354.28,13288,325,239,11706,10923,9139,7689,10132
2265,434,735,2265,0,1815,450,2.59889e+18,157.121,1118.03,2265,108,115,1530,1507,1286,1220,1151
38711,1611,2808,20197,18514,20197,18514,4.98157e+18,1206.48,7553.11,38711,538,422,35770,32515,24316,24421,24801
4910,33,42,4625,285,4877,33,1.08233e+14,26.1236,318.303,4910,29,28,4865,4859,4589,4589,4425
5178,34,43,4955,223,4990,188,9.37166e+13,22.247,329.701,5178,29,27,5131,5120,4956,4951,4931
2119,258,430,2041,78,1558,561,2.90521e+17,30.8249,673.672,2119,117,65,1689,1687,1579,1594,231
3719,41,422,3540,179,3719,0,4.06462e+18,117.761,988.296,3719,103,78,2622,1908,1268,1209,774
7533,1290,1757,0,7533,0,7533,2.4688e+18,331.762,2922.71,7533,273,199,5776,5678,5057,4993,4534
41716,1050,1675,0,41716,14807,26909,9.68764e+15,1127.63,6061.01,41716,499,378,38898,35049,26532,20432,29626
16008,21,44,15150,858,15834,174,1.05887e+14,36.0553,578.66,16008,38,35,15804,15635,13604,13506,11469
2244,220,515,0,2244,771,1473,9.98787e+15,104.167,876.11,2244,108,112,1729,1700,983,870,1073
7236,737,1352,2568,4668,0,7236,3.73126e+13,218.487,2356.6,7236,267,151,5884,5780,4573,4956,3333
799,19,241,0,799,285,514,9.96591e+15,72.8373,387.951,799,71,59,381,247,138,114,85
8203,26,43,7807,396,7976,227,9.87893e+13,31.5565,408.965,8203,32,30,8131,8099,7451,7443,6786
7158,28,1978,5771,1387,3463,3695,8.29147e+17,443.988,3134.95,7158,218,197,2390,976,523,555,199
32452,477,2377,0,32452,0,32452,2.44417e+18,1371.16,6516.07,32452,525,385,26185,23178,9737,8661,6944
15500,1630,1865,0,15500,0,15500,2.50082e+18,999.513,4279.94,15500,325,293,13632,12218,12018,11848,12660
20927,30,347,0,20927,19684,1243,2.74568e+16,266.142,1887.88,20927,115,125,18773,17482,12623,10889,6333
599,141,258,258,341,0,599,4.63802e+18,51.596,370.743,599,65,70,341,298,280,263,201
44213,76,380,0,44213,41728,2485,2.72973e+16,306.784,2809.66,44213,154,164,41835,40703,30439,26476,19284
27643,2286,2685,22569,5074,13696,13947,7.9139e+17,1525.41,6765.73,27643,460,394,24958,24641,23683,23409,24275
13381,3,43,12805,576,12965,416,9.72471e+13,33.7434,515.836,13381,36,33,9900,8576,8028,7940,5228
27497,255,352,0,27497,26237,1260,2.50893e+16,263.273,2085.11,27497,120,128,26965,26497,24860,23539,23787
28170,586,865,27285,885,28170,0,4.49973e+18,476.69,3349.49,28170,271,204,27286,26605,24984,25098,23816
14692,843,2336,14692,0,12184,2508,3.25379e+18,1086.52,4680.55,14692,400,311,11373,10009,7736,7386,6166
9814,362,2167,8212,1602,5208,4606,7.08816e+17,661.433,3691.18,9814,280,258,7052,6281,3905,4044,1817
35670,38,43,34048,1622,34624,1046,9.77787e+13,40.4108,858.865,35670,42,39,35601,35557,35093,35089,33534
46719,1664,1886,16574,30145,0,46719,3.7214e+13,1161.73,6539.89,46719,601,378,44833,44833,41917,42208,44222
49943,313,1662,17749,32194,0,49943,3.81657e+13,1190.44,6661.84,49943,567,400,41943,38156,18517,15846,13051
32228,392,2642,32228,0,26915,5313,3.3374e+18,1645.46,7127.23,32228,595,411,23909,20945,12424,10497,5843
16853,68,1711,0,16853,0,16853,2.53086e+18,1093.26,4334.93,16853,344,306,9366,5921,2659,1729,871
17966,164,781,17406,560,17966,0,4.52578e+18,438.528,2654.48,17966,222,174,15931,14031,7782,7325,4709
31734,1267,2271,16752,14982,16752,14982,4.92344e+18,1362.42,6331.33,31734,537,383,28211,25095,17446,17070,19406
26195,277,356,0,26195,24970,1225,2.53681e+16,278.372,2065.65,26195,121,125,25696,25236,23962,22694,22319
9850,38,1740,4959,4891,0,9850,5.05327e+18,637.809,3315.62,9850,293,222,5075,3281,1738,1601,218
6815,341,1350,0,6815,2411,4404,9.76573e+15,221.024,2357.16,6815,200,173,5465,5136,2784,2177,2182
10162,81,1996,8111,2051,4888,5274,8.56361e+17,848.937,3714.2,10162,272,245,5101,2811,1934,1980,583
1077,363,366,594,483,594,483,5.24483e+18,103.222,571.24,1077,88,90,711,711,711,709,711
42539,735,2792,42539,0,35548,6991,3.29732e+18,1713.65,8222.56,42539,676,451,34179,29174,21391,19867,14433
13700,357,1807,0,13700,0,13700,2.49267e+18,940.569,4010.42,13700,316,293,10527,9462,3906,2813,2810
31382,101,351,0,31382,29905,1477,2.52875e+16,282.353,2245.07,31382,128,132,30164,29644,24304,21415,15958
26907,862,2330,0,26907,0,26907,2.46642e+18,1311.31,6017.5,26907,467,365,22657,20368,10706,10330,11850
9880,1018,1458,0,9880,3567,6313,9.77129e+15,417.995,2800.12,9880,248,233,8422,8109,7025,6180,7355
46804,127,2498,24647,22157,24647,22157,4.91632e+18,1477.3,7824.99,46804,635,441,32751,24721,12356,12284,3043
47968,150,1813,22815,25153,22815,25153,5.00611e+18,1455.9,7440.39,47968,543,456,33181,23521,8891,9250,5816
562,84,252,551,11,562,0,5.13942e+18,49.5943,349.175,562,43,44,310,211,204,226,139
46937,1563,1719,22354,24583,22354,24583,5.04871e+18,1432.63,7229.62,46937,533,452,44959,38079,38091,38310,43324
18295,478,1576,0,18295,6499,11796,9.48645e+15,809.8,3887.36,18295,392,260,15660,14526,9316,6179,8591
16993,173,584,16859,134,16993,0,4.70336e+18,421.618,2450.77,16993,191,184,15193,13299,7271,7357,5669
45357,2130,2501,23795,21562,0,45357,4.99709e+18,1486.44,7725.83,45357,643,426,42856,42854,39326,38832,40880
49236,7,43,46896,2340,47944,1292,9.92563e+13,41.7034,1011.62,49236,43,41,44996,42231,34845,34757,23086
35672,573,807,34901,771,35672,0,4.57914e+18,526.745,3751.33,35672,275,220,34799,33842,31035,30875,29759
44061,598,822,43242,819,44061,0,4.62981e+18,533.882,4154.74,44061,274,244,43217,42359,39528,39652,37196
31976,115,1752,15180,16796,15180,16796,5.01283e+18,1363.42,6034.99,31976,467,401,20716,13909,5847,5951,1772
31737,453,1983,15698,16039,15698,16039,4.95912e+18,1365.43,6194.36,31737,463,401,25394,22389,8754,8925,8809
10216,21,43,9619,597,10146,70,1.05361e+14,37.3087,473.068,10216,36,35,10052,9935,8379,8298,6316
40089,34,47,37984,2105,39917,172,9.71885e+13,42.0029,1021.22,40089,44,43,39973,39876,36619,36695,34331
3196,59,202,0,3196,3024,172,2.6582e+16,48.8504,593.689,3196,56,51,2983,2901,2392,2033,1574
3916,95,419,3905,11,3916,0,4.83746e+18,180.355,1053.21,3916,100,102,2997,2145,1346,1311,1036
12657,1699,1871,6989,5668,0,12657,5.17586e+18,728.885,3739.19,12657,298,273,10786,10125,10121,10101,10106
12129,2178,2296,10059,2070,6221,5908,7.4664e+17,968.26,4261.01,12129,347,270,9833,9833,9579,9529,9807
2398,156,1092,2398,0,1876,522,3.37711e+18,112.783,1443.76,2398,157,131,1306,907,357,486,203
21389,485,2040,17042,4347,10126,11263,8.5292e+17,1461.24,5494.67,21389,417,366,15843,13342,8280,8535,5970
13589,280,1897,0,13589,0,13589,2.45148e+18,816.441,3891.62,13589,368,274,10510,9502,4806,3547,2417
10300,339,666,10023,277,10300,0,4.61276e+18,330.293,1956.04,10300,176,139,9547,9245,7588,7644,6044
32647,1103,2267,17149,15498,17149,15498,4.95234e+18,1382.09,6436.57,32647,527,386,28632,25541,16563,16809,18107
20894,174,351,0,20894,19858,1036,2.57551e+16,268.722,1858.01,20894,108,115,20212,19837,17687,16041,13457
2740,94,437,2678,62,2740,0,4.64035e+18,165.93,932.514,2740,90,88,2009,1388,985,1015,747
9728,934,1784,5125,4603,5125,4603,4.9149e+18,543.436,3269.18,9728,279,211,7944,7345,5473,4878,5689
45050,887,1354,0,45050,15925,29125,9.89951e+15,1126.08,6009.19,45050,484,397,41399,37114,27373,21294,31150
32353,590,1799,11410,20943,0,32353,3.76033e+13,1110.85,5585.99,32353,519,350,28121,25688,14742,12472,14847
35764,1708,1742,17123,18641,17123,18641,5.0318e+18,1399.09,6362.92,35764,482,418,34022,34022,33866,33731,33958
47415,1962,2881,39498,7917,24754,22661,7.29964e+17,1769.74,8738.36,47415,671,450,44293,36977,36749,36234,38627
32207,40,44,30437,1770,31854,353,1.05941e+14,41.7633,826.407,32207,42,39,32147,32119,31702,31699,30181
4426,494,939,0,4426,1598,2828,9.9652e+15,132.871,1639.48,4426,199,160,3487,3415,2696,2698,2123
30961,1011,1747,14791,16170,14791,16170,5.03432e+18,1370.66,5954.24,30961,440,403,26870,23711,16196,15031,19392
1561,537,579,0,1561,571,990,9.04845e+15,61.3696,824.969,1561,153,91,982,982,959,941,949
12499,267,2248,12499,0,10233,2266,3.19339e+18,986.626,4296.24,12499,352,289,8685,7285,3859,3138,1982
42367,1458,2889,35356,7011,22171,20196,7.29057e+17,1738.45,8321.84,42367,624,447,37339,31823,29689,29373,24603
26783,481,590,26527,256,26783,0,4.76394e+18,475.224,3079.75,26783,214,215,25995,25300,24060,24115,22871
10586,374,2228,8818,1768,5532,5054,7.35062e+17,744.629,3869.92,10586,338,265,7678,6805,4006,4271,2152
5913,406,1141,2122,3791,0,5913,3.83998e+13,207.413,1973.26,5913,242,145,4772,4542,3181,3547,1882
11723,410,2051,5900,5823,5900,5823,4.90111e+18,736.611,3859.55,11723,316,265,9006,7876,3219,3352,3044
43365,860,2496,22503,20862,22503,20862,4.90468e+18,1467.24,7576.53,43365,621,426,37140,33160,16399,19618,18318
22484,455,2068,11881,10603,11881,10603,4.93465e+18,1239.02,5222.82,22484,432,327,18009,16072,7156,7524,5601
41775,877,1583,14796,26979,0,41775,3.80479e+13,1107.01,5981.94,41775,563,378,38256,34700,24951,23709,25013
49092,796,847,48203,889,49092,0,4.6285e+18,547.191,4420.55,49092,302,250,48245,48243,48041,48041,47913
48677,1570,2896,40250,8427,24882,23795,7.6061e+17,1806.19,9055,48677,638,465,43718,38026,34198,34298,33093
9429,424,670,9216,213,9429,0,4.51212e+18,306.316,1878.65,9429,169,134,8759,8587,7169,7206,5936
34320,609,1714,12200,22120,0,34320,3.72345e+13,1086.97,5468.27,34320,511,341,30168,27780,17904,15611,17657
20329,945,2001,10954,9375,10954,9375,4.97447e+18,1131.62,4874.34,20329,409,317,17335,15721,10643,10857,11330
20942,1266,1318,7424,13518,0,20942,3.89076e+13,941.27,4071.15,20942,351,312,19608,17696,19376,19489,19165
31756,1211,1673,0,31756,11270,20486,9.76999e+15,1067.32,5334.98,31756,476,352,29737,26709,21755,17158,25920
24051,7,43,22910,1141,23442,609,1.00274e+14,38.0622,705.141,24051,40,38,21927,20530,16904,16835,10928
44650,805,827,44128,522,44650,0,4.72496e+18,660.939,4443.49,44650,326,254,43823,43749,43664,43696,43599
15017,14,713,14697,320,15017,0,4.58738e+18,401.888,2403.06,15017,217,173,5515,1623,1628,1737,377
1519,359,563,0,1519,564,955,9.58299e+15,69.6722,817.305,1519,145,98,956,951,658,682,680
41341,1932,2052,41341,0,33012,8329,3.01922e+18,1700.98,7665.54,41341,533,464,39223,34530,38582,38649,38615
49567,132,729,48739,828,49567,0,4.63958e+18,541.851,4333.66,49567,270,259,42496,33711,17448,17617,10593
41097,370,2463,21006,20091,21006,20091,4.93524e+18,1483.19,7511.64,41097,662,414,32509,28353,11148,11866,8659
5308,19,43,5012,296,5244,64,1.09292e+14,28.7102,340.306,5308,32,29,5204,5135,4469,4423,3845
19472,111,349,0,19472,18536,936,2.56636e+16,258.566,1775.56,19472,106,109,18687,18366,15232,13366,10172
48304,1428,2568,25167,23137,0,48304,4.98953e+18,1522.79,8041.06,48304,667,444,44413,38632,26881,24233,32908
26783,669,2700,22430,4353,14031,12752,7.23934e+17,1581.76,6552.63,26783,559,374,20959,18117,12364,12652,8290
19999,2316,2392,16854,3145,10823,9176,6.93629e+17,1331.66,5375.2,19999,449,322,17607,17540,17421,17384,17595
44617,14,42,42408,2209,43757,860,1.02062e+14,38.2108,947.632,44617,41,41,43420,42562,35231,34235,24803
10105,143,2270,10105,0,8393,1712,2.97102e+18,755.182,3899.1,10105,277,261,6270,3945,2636,2285,548
22116,78,351,0,22116,21042,1074,2.55441e+16,259.292,1895.12,22116,114,125,21070,20611,16259,14162,10864
27002,209,1872,0,27002,0,27002,2.52218e+18,1334.6,5688.08,27002,415,369,19721,16481,6424,3666,4031
20814,629,1445,0,20814,7376,13438,9.74169e+15,930.153,4163.79,20814,355,292,18015,16700,10418,8427,10661
39447,349,2317,0,39447,0,39447,2.43639e+18,1464.48,7091.04,39447,568,418,31126,27934,11581,6512,8477
34741,131,372,0,34741,33121,1620,2.53253e+16,293.167,2422.02,34741,134,141,33585,33001,27937,24338,19378
7578,381,1745,0,7578,0,7578,2.46625e+18,393.498,2952.38,7578,278,222,5691,5185,2315,2051,1476
43776,373,2288,43776,0,35293,8483,3.00696e+18,1752.8,8124.14,43776,538,467,31654,27224,13428,10681,9353
28031,213,349,0,28031,26435,1596,2.74956e+16,283.157,2178.65,28031,131,144,27256,26621,23888,21554,20320
21797,941,2411,18260,3537,11572,10225,7.15778e+17,1423.93,5686.3,21797,457,339,17549,15574,12635,12335,8065
42507,7,42,40282,2225,41805,702,1.03698e+14,40.141,928.826,42507,42,41,38659,36142,29591,29592,18264
27834,183,2544,27834,0,23362,4472,3.30605e+18,1519.56,6508.39,27834,508,376,18950,14221,9091,6648,2044
42321,2315,2405,0,42321,0,42321,2.45318e+18,1473.24,7380.88,42321,612,426,39916,39916,39520,38870,39569
18637,1225,1633,6562,12075,0,18637,3.66621e+13,882.361,4054.19,18637,412,278,16893,15503,13865,13644,13748
40315,158,2211,0,40315,0,40315,2.46264e+18,1506.26,7087.56,40315,591,419,29125,22583,10622,4413,3977
39972,1716,2337,21427,18545,21427,18545,4.91353e+18,1535.2,7155.09,39972,639,409,37342,32570,27234,25649,31387
3987,202,1202,1893,2094,0,3987,5.01046e+18,180.561,1824.23,3987,195,152,2727,2077,1038,839,748
3674,1254,1291,2931,743,1778,1896,8.84583e+17,167.367,1852.75,3674,172,147,2383,2383,2380,2380,2379
1878,607,949,1878,0,1466,412,3.64367e+18,86.6006,1208.93,1878,144,105,929,909,910,923,879
4613,613,1029,2769,1844,2769,1844,5.2967e+18,171.412,1753.65,4613,184,147,3584,3472,3292,3072,2196
16174,97,350,0,16174,15280,894,2.7377e+16,228.051,1651.73,16174,109,114,15401,15109,11981,10563,7962
21535,1779,2301,21535,0,17743,3792,3.17462e+18,1429.53,5676.76,21535,424,357,18926,16335,18108,17318,16230
21350,536,864,20893,457,21350,0,4.57654e+18,461.614,2986.28,21350,247,190,20445,19924,17221,17102,15528
41310,854,2904,33907,7403,20338,20972,8.02763e+17,1758.72,8412.61,41310,565,445,34580,28664,20958,20546,15391
36934,838,1372,13076,23858,0,36934,3.87334e+13,1096.96,5482.62,36934,457,377,33588,30262,22050,19293,24804
12779,980,1962,0,12779,0,12779,2.4544e+18,877.568,3943.81,12779,343,280,10459,9601,6262,5792,6568
43254,629,1488,15310,27944,0,43254,3.82173e+13,1123.83,6025.24,43254,498,382,38306,34938,21547,18040,22063
615,39,274,311,304,0,615,5.11164e+18,82.5415,384.971,615,66,70,230,125,51,73,93
9828,858,1838,5188,4640,5188,4640,4.86156e+18,581.559,3319.92,9828,304,208,7990,7345,5344,4786,4839
44520,61,371,0,44520,42306,2214,2.60263e+16,304.851,2781.54,44520,152,158,42105,40878,30963,27004,18572
13583,1451,1878,0,13583,0,13583,2.47765e+18,850.791,3902.74,13583,351,275,11705,10770,9920,9503,10209
36287,599,1585,0,36287,12895,23392,9.71579e+15,1115.38,5597.21,36287,454,362,31890,29173,17992,12029,15789
44761,1422,2629,23183,21578,23183,21578,4.89659e+18,1467.94,7809.28,44761,611,434,41015,35628,24531,24389,30586
47485,1204,1774,22449,25036,22449,25036,4.99779e+18,1458.57,7359.67,47485,540,454,43184,37005,27334,24226,33475
18344,9,42,17586,758,17667,677,9.43982e+13,31.556,590.81,18344,36,33,17442,16845,13882,13748,10005
42618,715,831,41479,1139,42618,0,4.54443e+18,590.198,4128.78,42618,286,241,41787,41516,40576,40452,40264
10976,528,666,10559,417,10976,0,4.33949e+18,341.238,1988.41,10976,166,139,10310,10155,9706,9712,9276
21514,360,1480,0,21514,7579,13935,9.80142e+15,933.398,4275.16,21514,361,309,18021,16588,8893,6231,6665
41466,1729,1749,19822,21644,19822,21644,5.03472e+18,1428.35,6849.3,41466,514,442,39717,39717,39654,39608,39695
21006,1272,2385,17699,3307,11330,9676,6.97141e+17,1356.08,5508.44,21006,460,327,17723,15603,14127,14004,12828
41147,1488,1548,14531,26616,0,41147,3.86026e+13,1132.9,5963.2,41147,491,382,39599,39562,39421,39510,39407
45665,534,875,44309,1356,45665,0,4.52938e+18,651.418,4322.65,45665,311,245,44338,43006,38288,37568,34600
18078,382,713,17706,372,18078,0,4.59493e+18,447.598,2645.94,18078,203,179,17078,16573,13354,13225,11420
3821,1104,1181,3298,523,2236,1585,6.06188e+17,171.35,1730.45,3821,184,137,2640,2637,2618,2613,2567
29320,1880,1967,0,29320,0,29320,2.53129e+18,1330.37,5991.96,29320,428,399,27353,27214,26782,25498,27124
48304,845,2893,40307,7997,25372,22932,7.26452e+17,1779.18,8817.91,48304,673,458,39533,33516,26393,24938,20221
33406,1243,1731,15888,17518,15888,17518,5.01802e+18,1374.44,6136.22,33406,474,402,30169,26222,19986,18339,24021
38596,601,2827,32269,6327,20434,18162,7.21067e+17,1665.87,7830.22,38596,646,424,30372,26433,17860,18273,12689
46324,1996,2575,24559,21765,0,46324,4.98615e+18,1485.09,7837.24,46324,662,428,43749,43507,36012,34650,40362
11937,265,350,0,11937,11335,602,2.58845e+16,209.115,1410.3,11937,94,87,11549,11387,10775,10426,9792
21207,1789,2017,0,21207,0,21207,2.44082e+18,1185.36,5056.95,21207,411,324,19190,19115,17155,16474,18136
49792,1540,1764,23782,26010,23782,26010,5.03375e+18,1479.6,7536.64,49792,546,460,47446,39954,37085,36575,43771
15919,1898,2020,8484,7435,8484,7435,4.91596e+18,921.805,4349.69,15919,349,292,13899,13899,13641,13543,13235
17069,84,353,0,17069,16335,734,2.4388e+16,194.675,1615.15,17069,106,111,16360,16070,13231,11411,8809
42272,399,1738,20053,22219,0,42272,5.10479e+18,1418.34,6891.33,42272,519,437,33449,29069,10475,8841,11205
31675,1535,1709,0,31675,11253,20422,9.53956e+15,1061.04,5264.66,31675,487,340,29966,29966,28077,27280,29674
19980,2043,2059,15994,3986,9513,10467,8.43231e+17,1416.92,5346.58,19980,409,362,17921,17921,17918,17918,17921
44787,1853,2809,44787,0,37150,7637,3.19681e+18,1731.44,8528.65,44787,616,458,41417,34644,39502,37750,37111
35168,1573,2769,35168,0,29276,5892,3.34585e+18,1715.59,7540.82,35168,628,433,31056,26398,29489,27073,21303
27434,527,590,27178,256,27434,0,4.75604e+18,467.18,3110.2,27434,223,216,26791,26152,25699,25751,25275
14743,1760,1986,0,14743,0,14743,2.42911e+18,886.936,4184.27,14743,353,294,12757,11756,11814,11188,12117
16567,908,1700,0,16567,0,16567,2.5217e+18,1083.32,4281.12,16567,339,305,13939,12416,7732,6688,9914
25971,1121,2186,13858,12113,13858,12113,4.89631e+18,1229,5645.09,25971,480,340,22692,20457,13999,13706,14773
46232,1344,1942,16406,29826,0,46232,3.71918e+13,1181.84,6579.9,46232,626,383,44168,39428,32999,33147,36505
24093,309,829,23459,634,24093,0,4.58297e+18,479.251,3118.71,24093,256,194,22615,21547,15040,13407,11278
22538,278,1600,8000,14538,0,22538,3.73611e+13,997.264,4431.57,22538,420,301,18651,17207,8098,6873,6714
6979,327,335,0,6979,6657,322,2.50587e+16,64.805,1044.32,6979,71,76,6644,6644,6643,6644,6611
21727,46,847,21094,633,21727,0,4.5749e+18,483.127,2982.82,21727,251,187,14186,9047,6076,5414,1788
24462,560,1801,12034,12428,0,24462,5.13746e+18,1262.25,5323.6,24462,399,361,19811,17432,8882,7968,9293
43149,842,1810,20377,22772,0,43149,5.13312e+18,1418.21,7043.49,43149,516,449,36969,32362,18696,15507,23474
16505,142,1669,5891,10614,0,16505,3.70488e+13,807.722,3848.03,16505,382,263,12933,11472,5518,3902,1384
21438,1644,2081,10970,10468,10970,10468,4.85955e+18,1231.9,5145.99,21438,449,331,19274,17141,14974,14401,16801
17688,1049,2176,17688,0,14512,3176,3.17525e+18,1324.78,5083,17688,403,333,14344,12397,10413,9812,8862
12627,107,2205,12627,0,10613,2014,3.31892e+18,910.676,4167.55,12627,351,262,7823,5668,3839,3297,828
22542,644,1451,0,22542,7936,14606,9.62482e+15,957.039,4322.52,22542,370,302,19828,18225,11689,8680,10499
1513,92,606,616,897,616,897,4.20546e+18,66.2531,849.512,1513,121,81,899,707,251,421,115
5164,39,43,4842,322,5150,14,1.06289e+14,28.0351,330.234,5164,31,29,5121,5118,5104,5102,5024
17797,969,2410,14732,3065,9046,8751,7.46593e+17,1302.16,5208.71,17797,420,316,14264,12606,10245,9951,7178
9622,475,2126,9622,0,7800,1822,3.07652e+18,766.057,3725.3,9622,284,255,6889,6027,3312,2780,2556
8570,1742,1858,0,8570,0,8570,2.40047e+18,447.883,3161.92,8570,311,223,6712,6545,6574,6454,6525
46823,2067,2666,0,46823,0,46823,2.44132e+18,1474.87,8022.89,46823,667,440,44157,44149,34665,32521,39711
4621,780,1000,0,4621,1629,2992,9.62974e+15,143.35,1722.83,4621,204,176,3621,3599,3093,3151,2924
14939,1808,2030,11982,2957,7155,7784,8.32704e+17,1214.5,4583.94,14939,328,317,12804,11094,11890,11552,11910
40212,2055,2149,20651,19561,20651,19561,4.98095e+18,1411.77,7043.18,40212,522,428,38063,38063,37901,37798,37729
26233,420,2515,21853,4380,13712,12521,7.30126e+17,1531.43,6344.57,26233,486,376,19635,17274,10150,11135,5543
9427,1223,1703,0,9427,0,9427,2.5305e+18,595.139,3203.24,9427,264,266,7724,7258,5826,5465,6246
5089,445,1413,0,5089,0,5089,2.51599e+18,184.847,2214.99,5089,203,159,3676,3473,1934,1813,1193
10988,1566,1789,0,10988,0,10988,2.47825e+18,766.091,3538.86,10988,300,269,9199,8488,7800,7602,8687
38383,565,1370,0,38383,13572,24811,9.91408e+15,1099.84,5585.08,38383,451,380,33499,30356,17896,13782,19865
563,3,29,528,35,561,2,1.03991e+14,14.4494,101.683,563,19,18,374,304,267,290,215
17347,20,43,16529,818,16924,423,1.00099e+14,38.252,600.161,17347,38,36,17107,16936,14535,14414,11474
22592,249,1337,0,22592,8006,14586,9.9187e+15,977.449,4263.85,22592,369,316,18448,16881,7561,5937,5786
32306,1202,2212,16864,15442,0,32306,4.99388e+18,1392.87,6383.59,32306,511,383,28641,25454,17142,15751,18577
13262,1430,1461,4701,8561,0,13262,3.73206e+13,635.343,3222.65,13262,343,249,11801,11495,11734,11767,11717
43051,361,808,42364,687,43051,0,4.6809e+18,501.121,4090.61,43051,272,244,41277,39797,28768,28520,24433
16201,692,1902,8002,8199,0,16201,4.97217e+18,1032.44,4400.81,16201,358,309,13206,11746,6643,6041,6498
1273,166,347,0,1273,421,852,9.99269e+15,84.0778,571.831,1273,101,89,926,888,550,462,679
19721,56,351,0,19721,18836,885,2.48426e+16,225.907,1740.8,19721,109,114,18702,18156,14464,12330,8641
18110,44,590,17919,191,18110,0,4.77221e+18,439.783,2537.26,18110,197,191,10756,5541,3976,3640,1651
3512,585,1270,3512,0,2893,619,2.54787e+18,225.026,1851.8,3512,224,143,2242,1994,1474,1419,1293
19953,1504,2136,0,19953,0,19953,2.40604e+18,1147.36,5012.34,19953,448,324,17672,15730,12934,12332,14817
12164,1524,1785,6023,6141,6023,6141,4.92263e+18,847.328,3744.28,12164,310,281,10379,9470,8844,8859,9648
40375,508,639,39991,384,40375,0,4.75118e+18,494.075,3815.09,40375,254,245,39556,38472,36214,36331,34806
4693,365,478,4691,2,4693,0,4.78525e+18,184.868,1214.21,4693,124,108,4215,4187,3851,3835,3688
1093,343,374,0,1093,440,653,1.15386e+16,33.5489,561.162,1093,78,87,719,719,719,719,582
44274,898,2452,22977,21297,22977,21297,4.92686e+18,1495.14,7630.85,44274,616,440,38120,33972,17997,20635,19558
5852,543,1236,0,5852,2032,3820,9.70988e+15,154.938,2099.81,5852,200,168,4616,4506,2706,2737,2482
35951,597,2740,30268,5683,19361,16590,7.01428e+17,1599.18,7460.89,35951,598,408,28388,24773,16802,17065,9884
25399,1842,2614,21103,4296,13107,12292,7.36742e+17,1494.53,6329.42,25399,505,369,22533,19293,18859,18594,19330
13064,28,43,12324,740,12935,129,1.06566e+14,37.8516,528.446,13064,37,35,12958,12912,11440,11470,9763
34557,928,1743,16525,18032,16525,18032,5.02899e+18,1390,6256.37,34557,482,408,29965,26168,16231,15271,19376
28083,282,356,0,28083,26805,1278,2.51226e+16,259.225,2107.2,28083,122,129,27602,27105,25747,24468,25428
38171,2027,2292,19685,18486,19685,18486,4.92628e+18,1412.76,6973.01,38171,557,412,35879,35877,33016,32644,34433
29687,1027,1434,10543,19144,0,29687,3.84384e+13,1034.19,4958.05,29687,421,348,27437,24828,19948,21084,22854
7676,21,43,7298,378,7469,207,9.88246e+13,26.0099,396.581,7676,32,32,7574,7506,6504,6463,5191
40768,25,43,38849,1919,39723,1045,9.88908e+13,39.3369,904.367,40768,41,41,40500,40287,36118,36080,31553
2132,349,725,0,2132,0,2132,2.7345e+18,82.8063,1104.29,2132,117,111,1407,1407,1312,1336,759
40404,748,1574,14277,26127,0,40404,3.78131e+13,1131.96,5889.37,40404,485,371,36141,32991,21409,19519,25831
43000,116,358,0,43000,40989,2011,2.54062e+16,305.667,2652.16,43000,140,153,41502,40740,33654,28826,22053
46695,2192,2461,24039,22656,0,46695,5.05478e+18,1470.54,7893.83,46695,585,439,44234,44234,40836,40494,43389
36026,513,1680,0,36026,12817,23209,9.58358e+15,1089.7,5586.98,36026,503,355,31269,28734,17618,11777,13623
49378,1233,2446,49378,0,40581,8797,3.05287e+18,1816.27,8676.18,49378,589,474,42534,36300,31384,29680,29718
21648,2055,2381,21648,0,17759,3889,3.00617e+18,1404.86,5782.48,21648,395,346,19267,16685,18618,18659,18263
39052,104,884,37981,1071,39052,0,4.57716e+18,568.151,3990.25,39052,301,230,31771,24022,14209,12515,5587
8874,313,352,0,8874,8476,398,2.56839e+16,124.785,1196.76,8874,84,79,8522,8484,8407,8363,8234
6000,1421,1549,0,6000,0,6000,2.40015e+18,176.264,2456.86,6000,227,160,4451,4450,4358,4326,4328
5242,894,1479,0,5242,0,5242,2.47589e+18,213.617,2320.47,5242,217,164,3763,3723,2790,2485,2597
48096,2439,2928,48096,0,40098,7998,3.33075e+18,1787.77,8858.71,48096,689,469,45168,45168,44482,44639,43807
9843,401,1664,4649,5194,4649,5194,5.01687e+18,762.544,3297.36,9843,282,252,7456,6540,2945,2792,2948
17920,302,1282,6345,11575,0,17920,3.90599e+13,896.53,3734.16,17920,314,290,14795,13476,6534,4478,5005
40487,138,785,39729,758,40487,0,4.61539e+18,516.692,3960.41,40487,256,244,35053,28414,14839,14112,8550
29546,1073,2059,15225,14321,15225,14321,4.95076e+18,1299.22,5989.87,29546,457,374,25762,23110,15345,14793,16829
15210,35,350,0,15210,14446,764,2.60517e+16,227.9,1597.81,15210,101,107,13970,13195,9990,8512,5383
10610,625,1676,5008,5602,5008,5602,4.93503e+18,753.75,3387.21,10610,283,264,8377,7570,3910,3685,4829
15911,1040,2362,15911,0,13256,2655,3.27985e+18,1155.04,4869.62,15911,400,287,12661,11259,9954,9242,6928
39259,1653,2391,0,39259,0,39259,2.44455e+18,1431.34,7122.49,39259,583,409,36713,31842,25974,23285,31521
13719,1153,1698,0,13719,0,13719,2.53081e+18,1000.02,3928.81,13719,318,291,11552,10401,7823,7132,9131
13893,766,1877,0,13893,0,13893,2.45758e+18,848.755,3943.48,13893,367,276,11409,10445,7179,6500,6382
40627,2869,2920,40627,0,33507,7120,3.19533e+18,1785.26,8404.78,40627,607,448,37707,37707,37707,37706,37691
42928,460,1502,0,42928,15236,27692,9.80008e+15,1119.82,6007.43,42928,506,386,37061,33693,19011,13362,16761
38163,2211,2710,38163,0,31868,6295,3.27642e+18,1728.12,7769.16,38163,631,428,35453,35133,34445,34605,33837
3744,459,1210,1732,2012,1732,2012,4.71563e+18,144.529,1803.25,3744,224,141,2534,2438,1505,1377,1585
46886,1683,1964,23171,23715,23171,23715,4.9826e+18,1479.34,7520.12,46886,569,444,44884,41341,36881,36372,43988
40156,149,354,0,40156,37876,2280,2.72271e+16,309.611,2643.63,40156,151,158,38693,37804,31781,27852,24116
20112,40,43,19008,1104,19981,131,1.0512e+14,38.296,657.402,20112,40,38,20063,20051,20010,20010,19620
29537,85,2557,29537,0,24458,5079,3.05088e+18,1619.42,6814.97,29537,539,407,16552,10896,7740,7399,2367
12126,370,2211,12126,0,9913,2213,3.03425e+18,1003.29,4238.05,12126,353,290,8564,7513,3811,3198,2180
8841,1995,2206,8841,0,7557,1284,3.34758e+18,277.248,3439.48,8841,292,216,6635,6603,6600,6548,6149
15417,257,358,0,15417,14711,706,2.50335e+16,205.859,1591.97,15417,98,95,14977,14808,14037,13505,13418
19816,2028,2052,10727,9089,10727,9089,4.99025e+18,1047.83,4833.19,19816,405,317,17764,17764,17764,17764,17406
10296,1489,2085,8359,1937,5066,5230,8.10045e+17,837.11,3807.99,10296,289,253,8211,7390,6952,6924,6712
8785,235,1536,3149,5636,0,8785,3.89016e+13,371.549,2819.04,8785,237,234,6974,6290,3013,2565,2248
46120,1906,2266,23226,22894,23226,22894,4.92726e+18,1463.11,7654.36,46120,575,440,43854,43854,38529,37819,42023
6922,704,1289,2481,4441,0,6922,3.80687e+13,208.221,2291.4,6922,252,166,5633,5559,4489,4749,3034
14798,66,1992,7842,6956,0,14798,5.04627e+18,907.08,4189.6,14798,379,282,8925,6427,3591,2552,268
34243,1578,2675,28752,5491,18244,15999,7.06596e+17,1615.63,7289.74,34243,579,391,30348,25913,24646,24913,22900
18261,1333,1771,0,18261,0,18261,2.54135e+18,1154.03,4595.75,18261,347,328,16158,14225,11488,10839,14040
26466,435,1977,0,26466,0,26466,2.49041e+18,1348.88,5666.28,26466,436,369,21026,18561,7483,5458,6871
22565,128,2175,12034,10531,12034,10531,4.904e+18,1202.21,5295.12,22565,469,323,15829,12126,6014,5908,1572
13362,192,721,13133,229,13362,0,4.70197e+18,385.539,2282.52,13362,172,154,12004,10744,6573,6334,4361
24078,262,370,0,24078,22881,1197,2.62668e+16,269.161,2044.75,24078,118,131,23526,23146,21454,20203,19471
10453,1224,1467,3711,6742,0,10453,3.79209e+13,522.486,2922.9,10453,304,236,8986,8582,8017,7745,8629
6396,1052,1628,3273,3123,3273,3123,4.75809e+18,189.2,2582.43,6396,249,168,4768,4702,3627,3522,3847
9109,582,2057,9109,0,7515,1594,3.14681e+18,667.424,3549.54,9109,258,242,6663,5902,4007,3367,2592
24906,205,2623,24906,0,20696,4210,3.34076e+18,1495.59,6293.04,24906,507,365,16977,13269,7721,5503,2620
5586,280,1244,1994,3592,0,5586,3.81488e+13,164.978,2088.65,5586,209,165,4342,4115,2362,1853,1740
39748,1271,1749,18818,20930,18818,20930,4.9912e+18,1411.48,6700.24,39748,508,428,36222,31335,24020,22130,31020
46241,164,784,45470,771,46241,0,4.61165e+18,554.864,4258.68,46241,273,250,41194,35641,17560,17458,11941
27023,786,2236,0,27023,0,27023,2.44299e+18,1272.5,5815.74,27023,486,348,22792,20348,11524,10787,11375
19588,17,43,18464,1124,19395,193,1.07314e+14,40.1537,646.821,19588,40,38,19128,18775,15396,15299,11787
30558,2284,2304,0,30558,0,30558,2.44656e+18,1347.95,6240.65,30558,504,365,28254,28254,28217,28152,28249
44765,1290,2763,36094,8671,21515,23250,8.31629e+17,1742.45,8666.83,44765,574,479,38985,33597,27856,27746,28796
14268,1876,1995,0,14268,0,14268,2.41813e+18,940.941,4164.92,14268,378,285,12273,12273,11756,11466,12269
7919,394,1727,3938,3981,0,7919,5.12169e+18,437.419,2986.06,7919,252,238,5976,5429,2707,2356,2466
44320,172,358,0,44320,42250,2070,2.53779e+16,308.207,2692.52,44320,147,155,43112,42201,37503,32792,29127
19990,255,2359,16840,3150,10705,9285,6.96065e+17,1336.62,5386.68,19990,444,323,14197,12169,7048,7864,2511
