"data_size","cache_size","unique_size","reads","writes","avg_step","avg_reuse_dist","sum_sqrt_count","sum_count","lis","lds","belady","lru","pivot","ld","mru"
45065,256,394,32171,12894,2.81939e+13,172.486,2629.2,45065,197,191,44671,44550,31459,27177,41434
17300,40,206,12354,4946,2.8111e+13,169.314,1499.91,17300,148,135,12669,9947,3624,3859,4772
24732,126,218,17670,7062,2.7981e+13,170.802,1799.17,24732,161,148,22393,18566,15191,15387,18182
7907,129,188,5652,2255,2.78854e+13,164.279,1006.72,7907,123,112,7130,5920,4928,4372,5937
24541,2,218,17532,7009,2.80095e+13,170.752,1792.25,24541,161,148,3286,624,535,1288,271
85807,102,329,61286,24521,2.80048e+13,173.086,3424.11,85807,272,175,74258,62651,38653,35896,52633
57771,37,279,41258,16513,2.80253e+13,172.583,2787.34,57771,221,175,41552,32693,11921,9654,14834
48955,142,263,34963,13992,2.80304e+13,172.357,2558.16,48955,205,175,45821,36966,35806,39586,40227
41082,107,248,29347,11735,2.79938e+13,172.01,2335.81,41082,191,175,35888,30133,19850,18408,26172
81973,400,468,58524,23449,2.8114e+13,173.203,3533.12,81973,264,192,81505,81505,77786,79668,81437
21070,85,212,15046,6024,2.79861e+13,170.208,1657.99,21070,155,142,17542,14688,7640,7111,10671
77940,179,800,55759,22181,2.713e+13,217.865,4218.63,77940,798,180,76555,76205,67084,71164,75019
17917,22,206,12797,5120,2.79366e+13,169.429,1525.46,17917,149,136,11196,7959,3046,3060,3191
82761,570,800,59202,23559,2.7154e+13,224.243,4317.18,82761,790,180,81855,81455,78334,79912,81271
86420,283,331,61731,24689,2.80066e+13,173.132,3437.88,86420,274,175,86089,86089,83581,84838,86041
42116,232,250,30084,12032,2.79952e+13,172.115,2366.23,42116,193,175,41866,41866,41357,41587,41848
55503,159,274,39646,15857,2.79933e+13,172.615,2729.38,55503,217,175,53661,42406,48482,51956,50499
73891,22,308,52780,21111,2.80184e+13,172.948,3167.78,73891,251,175,46218,32872,12576,9086,9364
96674,98,349,69055,27619,2.79925e+13,173.216,3645.06,96674,292,175,82942,70065,41967,41118,57181
90130,244,337,64376,25754,2.80082e+13,173.137,3513.48,90130,280,175,89793,89793,84179,87037,89700
51384,169,267,36703,14681,2.79931e+13,172.48,2622.75,51384,210,175,50571,39716,45249,43880,49745
1741,63,177,1246,495,2.78195e+13,127.14,467.288,1741,76,73,1331,1126,539,466,692
90996,48,339,64993,26003,2.80187e+13,173.107,3531.4,90996,281,175,69073,55609,21089,17320,28934
56624,155,800,40538,16086,2.67653e+13,212.683,3739.04,56624,780,180,53325,42369,46085,48819,48172
50380,379,800,36073,14307,2.66199e+13,222.562,3581.6,50380,798,175,49249,48696,42895,45821,48317
72746,179,306,51958,20788,2.802e+13,172.917,3142.08,72746,249,175,72440,72440,64526,68568,72313
95931,230,347,68519,27412,2.79995e+13,173.156,3629.51,95931,290,175,95584,95584,88340,92037,95467
99902,112,355,71364,28538,2.79985e+13,173.221,3708.47,99902,298,175,88236,73850,51682,46829,66400
18963,138,209,13546,5417,2.80365e+13,169.917,1571.87,18963,152,138,17533,14254,13228,13679,15183
16272,184,203,11627,4645,2.80093e+13,169.057,1452.4,16272,146,133,16069,16069,15493,15757,16050
17272,201,206,12338,4934,2.80096e+13,169.631,1498.83,17272,149,135,17066,17066,17040,17047,17061
79793,469,800,57083,22710,2.71317e+13,218.08,4256.87,79793,798,180,78758,78452,73044,75767,78000
50824,244,266,36302,14522,2.80024e+13,172.388,2607.94,50824,209,175,50558,50558,49762,50141,50536
95658,322,944,68393,27265,2.73728e+13,246.967,4756.54,95658,814,192,94257,93748,83116,78276,86888
74448,618,800,53269,21179,2.70636e+13,234.571,4144.92,74448,798,175,73519,73119,65312,69459,73102
63503,275,800,45450,18053,2.6899e+13,234.21,3902.37,63503,797,175,62241,61795,53937,57666,61016
93886,395,484,67047,26839,2.80919e+13,173.326,3773.35,93886,286,192,93402,93402,88885,87499,92696
4799,64,183,3433,1366,2.78421e+13,157.719,781.889,4799,107,100,3754,3144,1376,1210,1914
8048,240,800,5835,2213,1.93319e+13,258.062,1950.6,8048,724,103,6850,6440,5259,5456,5568
19431,86,209,13880,5551,2.79843e+13,169.963,1590.58,19431,152,139,16202,13532,7182,7018,10202
31980,53,232,22838,9142,2.80277e+13,171.408,2053.66,31980,174,161,24678,20294,7857,9223,11244
36911,84,240,26367,10544,2.79988e+13,171.834,2210.13,36911,183,170,30698,25679,13149,17624,19310
2330,16,178,1666,664,2.77366e+13,140.522,542.801,2330,85,77,1282,905,383,317,238
48525,22,262,34661,13864,2.80205e+13,172.386,2546.35,48525,205,175,30346,21589,8266,5101,7763
50773,157,266,36261,14512,2.80167e+13,172.504,2606.95,50773,209,175,48887,38603,44333,45967,45639
54848,151,273,39182,15666,2.7999e+13,172.604,2712.84,54848,216,175,52247,41513,43272,46420,47784
6789,118,187,4846,1943,2.82678e+13,161.981,932.23,6789,118,109,5975,5003,3756,4101,4738
81111,316,321,57934,23177,2.80136e+13,173.061,3325.55,81111,264,175,80790,80790,80754,80765,80785
34948,135,237,24962,9986,2.79882e+13,171.759,2149.31,34948,180,167,32242,26313,23353,21764,27394
32487,123,233,23201,9286,2.8028e+13,171.623,2070.77,32487,176,162,29290,24275,19467,18701,23619
76491,167,312,54645,21846,2.79974e+13,173.04,3224.8,76491,256,175,75083,59002,67100,71752,72829
53699,220,271,38356,15343,2.80266e+13,172.483,2683.19,53699,214,175,53428,53428,50702,52070,53377
67405,229,296,48146,19259,2.80073e+13,172.825,3019.37,67405,239,175,67109,67109,63264,65211,67042
62064,159,431,44304,17760,2.81465e+13,172.961,3080.24,62064,231,192,59883,47437,42844,39190,52536
75089,183,310,53632,21457,2.8012e+13,172.93,3193.98,75089,253,175,74779,74779,66858,70903,74652
3055,18,180,2178,877,2.82527e+13,146.852,621.97,3055,94,89,1768,1264,532,340,427
11720,32,195,8371,3349,2.79794e+13,167.239,1229.02,11720,135,125,8092,6136,2148,1528,2429
37094,106,241,26497,10597,2.80049e+13,171.853,2216.44,37094,184,171,32301,27205,17758,20393,23722
40794,12,248,29144,11650,2.80052e+13,172.152,2328.24,40794,191,175,20129,12762,6050,4584,3238
88720,184,334,63375,25345,2.79963e+13,173.081,3484.05,88720,277,175,88386,88386,78893,83749,88236
4445,18,182,3172,1273,2.80013e+13,156.46,751.984,4445,104,99,2569,1827,751,509,661
68810,77,381,49130,19680,2.80799e+13,172.025,3155.93,68810,244,175,56427,47055,23141,31802,33382
95655,127,347,68321,27334,2.80081e+13,173.189,3624.67,95655,290,175,87100,71916,59136,51228,72009
49072,452,800,35139,13933,2.66121e+13,209.708,3547.88,49072,792,175,48046,47389,44082,45937,47228
93133,141,343,66527,26606,2.80076e+13,173.203,3574.94,93133,286,175,87112,70345,67143,75020,76682
38875,191,800,27863,11012,2.61604e+13,209.67,3262.7,38875,791,170,37584,37212,33323,34767,36158
65994,219,293,47137,18857,2.80002e+13,172.793,2985.91,65994,236,175,65701,65701,61388,63574,65627
87329,344,800,62463,24866,2.72153e+13,238.454,4407.99,87329,798,175,86111,85578,76198,80862,85049
3631,152,181,2589,1042,2.82684e+13,152.987,679.635,3631,98,93,3335,2701,2847,3026,3063
33204,70,234,23712,9492,2.80079e+13,171.632,2093.54,33204,177,164,26779,22075,9961,10134,14252
29229,106,227,20874,8355,2.79825e+13,171.382,1960.98,29229,170,157,25434,21420,13962,13630,18310
17594,64,206,12564,5030,2.80254e+13,169.281,1512.21,17594,148,135,13978,11605,4874,5662,7257
54039,181,271,38594,15445,2.80066e+13,172.445,2691.2,54039,214,175,53768,53768,48357,51111,53678
5197,88,184,3703,1494,2.82847e+13,158.624,814.217,5197,109,103,4305,3602,2003,2144,2872
3859,28,181,2756,1103,2.79117e+13,153.626,700.542,3859,101,92,2568,1927,681,706,632
31774,148,231,22698,9076,2.79789e+13,171.53,2046.34,31774,174,161,30055,24034,24242,25208,26987
16147,115,203,11530,4617,2.79992e+13,169.1,1446.96,16147,146,133,14292,11935,8505,7697,10949
15455,20,202,11038,4417,2.80049e+13,168.85,1415.35,15455,145,132,9351,6618,2637,2180,2486
25658,36,221,18330,7328,2.79972e+13,171.141,1834.93,25658,164,150,18288,14497,5020,4976,6349
94843,257,345,67751,27092,2.7994e+13,173.177,3608.02,94843,289,175,94498,94498,89208,91899,94410
43613,195,253,31150,12463,2.80093e+13,172.225,2409.72,43613,196,175,43360,43360,40130,41760,43302
66057,235,294,47180,18877,2.80118e+13,172.86,2988.38,66057,237,175,65763,65763,62503,64149,65704
27532,710,800,19753,7779,2.54473e+13,211.229,2894.48,27532,777,149,26732,26543,24441,25479,26463
55273,34,274,39479,15794,2.80105e+13,172.59,2723.79,55273,217,175,38851,31064,10424,7799,12811
6970,73,186,4978,1992,2.77759e+13,162.603,943.581,6970,118,108,5604,4630,2275,2188,3092
30698,179,230,21928,8770,2.80423e+13,171.497,2011.53,30698,173,159,30468,30468,27737,29110,30417
79766,28,318,56975,22791,2.80129e+13,173.011,3296.1,79766,261,175,53496,40093,13584,14587,13653
53505,202,270,38218,15287,2.79992e+13,172.494,2677.52,53505,213,175,53235,53235,49313,51302,53167
42537,52,251,30386,12151,2.80029e+13,172.185,2378.85,42537,194,175,32720,26516,10551,12172,14696
88961,152,335,63541,25420,2.80075e+13,173.142,3489.8,88961,278,175,84969,67360,71341,76471,78262
14083,78,199,10062,4021,2.79137e+13,168.531,1349.57,14083,143,130,11512,9627,4735,4841,6789
80126,308,319,57231,22895,2.801e+13,172.992,3304.06,80126,262,175,79807,79807,79638,79712,79796
24839,103,219,17740,7099,2.80249e+13,170.695,1803.53,24839,162,148,21496,18209,11272,10700,15361
63958,77,290,45677,18281,2.80176e+13,172.715,2938.34,63958,232,175,52456,43703,21553,29619,31284
78069,185,316,55765,22304,2.80086e+13,173.016,3260.3,78069,259,175,77753,77753,69601,73763,77622
63797,181,794,45629,18168,2.73091e+13,227.025,3689.87,63797,408,175,62898,62728,55817,58811,61866
62002,177,286,44287,17715,2.80204e+13,172.685,2890.86,62002,229,175,61716,61716,55051,58448,61607
70229,72,301,50163,20066,2.80078e+13,172.876,3084.5,70229,244,175,56961,46841,21896,21633,30981
70215,109,301,50155,20060,2.80074e+13,172.895,3084.23,70215,244,175,61646,51638,34536,28993,45247
51741,161,268,36955,14786,2.80232e+13,172.477,2632.56,51741,211,175,50185,39534,45199,48418,47443
94491,21,345,67496,26995,2.80075e+13,173.201,3601.73,94491,288,175,58244,41513,16061,9908,10904
83256,205,800,59562,23694,2.71633e+13,220.809,4327.26,83256,798,180,81914,81512,73552,77098,80447
6250,76,185,4467,1783,2.78442e+13,161.525,893.064,6250,113,106,5056,4225,2117,2012,2813
46428,53,258,33165,13263,2.79972e+13,172.3,2488.66,46428,201,175,35840,29448,11363,13363,16138
57586,248,278,41131,16455,2.80028e+13,172.646,2782.13,57586,221,175,57308,57308,55982,56632,57278
40037,106,246,28598,11439,2.79966e+13,172.002,2304.9,40037,189,175,34896,29360,19143,18662,25471
3804,139,181,2713,1091,2.81303e+13,152.272,694.93,3804,101,93,3426,2832,2677,2728,2991
33982,229,236,24269,9713,2.80131e+13,171.803,2119.39,33982,179,165,33746,33746,33690,33710,33739
14083,57,200,10054,4029,2.80839e+13,168.229,1350.26,14083,142,129,10979,9006,3613,4340,5232
56849,150,277,40602,16247,2.80166e+13,172.547,2763.89,56849,219,175,54047,43036,44144,48019,48914
89192,86,335,63711,25481,2.79997e+13,173.136,3494.11,89192,279,175,74600,62228,32918,27958,46743
73912,280,308,52796,21116,2.80104e+13,172.971,3168.3,73912,251,175,73604,73604,72432,73003,73576
82793,8,324,59136,23657,2.80125e+13,173.033,3361.1,82793,267,175,34439,15728,9583,5238,3821
67147,31,941,48040,19107,2.70726e+13,213.472,4167.49,67147,800,193,45709,34881,11902,6431,12910
83872,283,326,59914,23958,2.79979e+13,173.065,3384.07,83872,269,175,83546,83546,81379,82461,83503
50015,138,264,35727,14288,2.79908e+13,172.425,2585.87,50015,207,175,46480,37677,34951,32010,40291
47706,207,260,34078,13628,2.79909e+13,172.382,2523.76,47706,203,175,47446,47446,44544,46008,47393
43256,188,253,30897,12359,2.80126e+13,172.228,2400.14,43256,196,175,43003,43003,39339,41191,42938
39687,207,246,28349,11338,2.8027e+13,172.031,2295.31,39687,189,175,39441,39441,37526,38479,39402
28174,204,225,20121,8053,2.80208e+13,171.179,1924.08,28174,168,154,27949,27949,27231,27569,27928
46497,95,258,33210,13287,2.80101e+13,172.311,2490.36,46497,201,175,39625,32592,19199,16373,26627
57719,243,278,41231,16488,2.79895e+13,172.609,2785.11,57719,221,175,57441,57441,55771,56599,57406
40858,241,248,29182,11676,2.8013e+13,172.139,2330.02,40858,191,175,40610,40610,40539,40566,40603
34945,230,237,24957,9988,2.80389e+13,171.671,2149.25,34945,180,167,34708,34708,34640,34665,34701
19647,174,209,14027,5620,2.79994e+13,169.852,1599.23,19647,152,139,19405,15547,17772,18597,19292
23420,179,216,16725,6695,2.80156e+13,170.59,1750.02,23420,159,146,23204,23204,21410,22302,23167
57619,195,279,41150,16469,2.80356e+13,172.539,2783.75,57619,221,175,57340,57340,52370,54893,57256
12185,178,196,8700,3485,2.80211e+13,167.468,1253.8,12185,137,126,11989,11989,11517,11728,11971
78401,312,316,55996,22405,2.80175e+13,172.914,3266.66,78401,258,175,78085,78085,78062,78068,78081
20606,125,211,14723,5883,2.79739e+13,170.141,1638.72,20606,154,141,18620,15464,12573,10859,15062
79812,61,319,57006,22806,2.80285e+13,172.987,3297.81,79812,262,175,63130,51654,21535,19948,31131
39965,44,246,28548,11417,2.80048e+13,172.038,2303.07,39965,189,175,29883,23613,9003,10707,12290
67621,38,297,48305,19316,2.80011e+13,172.899,3025.29,67621,240,175,48994,38372,13225,9676,16452
75695,33,311,54062,21633,2.80146e+13,172.942,3207.32,75695,254,175,52807,40376,13977,10561,17036
49030,213,263,35019,14011,2.79989e+13,172.447,2560.13,49030,206,175,48767,48767,46119,47450,48717
51518,83,267,36798,14720,2.79969e+13,172.479,2626.09,51518,210,175,42792,35839,18220,17004,25480
10084,70,192,7202,2882,2.79809e+13,166.12,1138.48,10084,129,120,8088,6690,3088,2672,4317
2342,47,178,1671,671,2.76551e+13,140.581,543.503,2342,85,81,1731,1402,540,614,717
3847,20,181,2745,1102,2.81083e+13,153.444,698.749,3847,100,93,2317,1646,648,395,534
91816,126,340,65580,26236,2.80076e+13,173.127,3547.66,91816,283,175,83401,69030,56424,48376,68532
85432,250,328,61018,24414,2.80091e+13,173.031,3415.87,85432,271,175,85104,85104,80515,82845,85026
52779,187,269,37696,15083,2.80163e+13,172.435,2658.75,52779,212,175,52510,52510,47656,50122,52428
52582,252,269,37557,15025,2.80087e+13,172.496,2654.04,52582,212,175,52313,52313,51867,52065,52296
59099,183,281,42210,16889,2.80125e+13,172.699,2820.19,59099,224,175,58818,58818,52876,55903,58720
67106,265,296,47928,19178,2.80355e+13,172.786,3012.98,67106,238,175,66810,66810,65437,66112,66779
98588,145,353,70415,28173,2.80232e+13,173.173,3683.1,98588,295,175,92925,74480,73939,81918,82503
33266,797,800,23853,9413,2.59241e+13,211.472,3089.43,33266,787,159,32466,32309,32144,32222,32458
27955,32,224,19975,7980,2.79632e+13,171.203,1916,27955,168,155,19336,14648,5115,3638,5855
23535,44,217,16806,6729,2.80461e+13,170.757,1755.3,23535,160,146,17572,13901,5314,3868,6622
77554,224,314,55398,22156,2.80022e+13,172.998,3248,77554,258,175,77240,77240,71821,74580,77150
65687,100,293,46926,18761,2.79938e+13,172.836,2979.28,65687,236,175,56566,47714,29340,28901,39066
24421,94,219,17441,6980,2.80317e+13,170.745,1788.84,24421,161,148,20719,17067,9887,12290,14012
17005,61,205,12149,4856,2.80191e+13,169.568,1486.51,17005,148,134,13401,10984,4581,4290,6639
89928,385,478,64215,25713,2.80977e+13,173.264,3694.11,89928,278,193,89450,89450,84001,86776,89357
7772,16,189,5549,2223,2.80618e+13,163.556,998.605,7772,121,112,4306,3035,1291,762,760
22071,93,214,15767,6304,2.80182e+13,170.43,1697.87,22071,157,143,18698,15409,8801,8506,12493
15470,40,202,11050,4420,2.79959e+13,168.702,1416.08,15470,145,132,11330,8888,3240,3980,4335
88169,310,334,62974,25195,2.80083e+13,173.147,3473.88,88169,277,175,87835,87835,86955,87376,87811
96392,283,495,68829,27563,2.80963e+13,173.304,3830.59,96392,290,193,95897,95777,75624,68398,89245
53593,410,800,38370,15223,2.66817e+13,223.124,3663.88,53593,741,180,52561,51903,50889,51562,51623
42826,60,252,30594,12232,2.80145e+13,172.218,2387.72,42826,195,175,33745,27551,11476,8550,15812
21481,122,213,15342,6139,2.80143e+13,170.198,1674.74,21481,155,142,19288,16008,12455,13211,15532
20940,81,212,14958,5982,2.79646e+13,170.324,1653.09,20940,155,142,17260,14555,7351,7914,10742
78754,180,800,56345,22409,2.71214e+13,231.848,4235.53,78754,798,175,77368,77018,67879,71974,75836
75484,313,800,54009,21475,2.70782e+13,231.812,4167,75484,763,180,74345,73754,71859,72529,73211
72014,149,304,51437,20577,2.80057e+13,172.882,3124.78,72014,247,175,68382,54527,55533,57746,62214
89893,122,337,64207,25686,2.80147e+13,173.066,3508.92,89893,279,175,81023,67103,52164,55279,64379
51240,41,267,36595,14645,2.80169e+13,172.343,2619.03,51240,209,175,37778,29748,10783,13272,14508
88433,60,334,63166,25267,2.80075e+13,173.117,3478.91,88433,277,175,69759,56909,23711,20975,33437
99580,85,354,71128,28452,2.8007e+13,173.191,3701.7,99580,297,175,83121,69488,35896,38206,53215
6221,101,186,4442,1779,2.82913e+13,160.836,891.99,6221,115,107,5295,4504,2825,3284,3822
61535,200,285,43950,17585,2.79927e+13,172.686,2879.26,61535,228,175,61250,61250,56185,58760,61165
42702,656,950,30568,12134,2.65558e+13,210.696,3564.2,42702,771,183,41751,41518,39660,40243,40870
97262,684,942,69540,27722,2.73803e+13,230.659,4783.36,97262,799,197,96320,96084,92473,93991,95546
50844,252,266,36315,14529,2.79941e+13,172.482,2608.49,50844,209,175,50578,50578,50331,50436,50564
76788,570,800,54943,21845,2.70841e+13,219.949,4194.49,76788,798,175,75838,75453,69305,72441,75298
90082,44,800,64435,25647,2.72213e+13,221.446,4461.72,90082,798,180,66822,53014,19998,13782,24857
44239,644,800,31686,12553,2.64162e+13,208.969,3416.73,44239,791,175,43406,43225,40034,41650,42972
1726,80,177,1236,490,2.77351e+13,128.753,466.551,1726,75,70,1361,1174,621,545,783
15355,113,201,10970,4385,2.79029e+13,168.86,1409.99,15355,145,132,13504,11351,8006,7705,10369
51734,234,268,36959,14775,2.80215e+13,172.537,2632.58,51734,211,175,51466,51466,49891,50669,51432
54407,8,272,38863,15544,2.79956e+13,172.515,2701.06,54407,215,175,22617,10324,6295,3435,2380
27193,79,223,19421,7772,2.79806e+13,171.135,1889.39,27193,166,153,22362,18659,9248,8799,13061
92849,450,800,66410,26439,2.72471e+13,252.597,4514.88,92849,743,180,91857,91088,90286,90863,90999
65809,357,800,47093,18716,2.69685e+13,233.37,3955.5,65809,798,175,64628,64096,56373,60231,63644
34157,183,235,24403,9754,2.79726e+13,171.725,2123.63,34157,179,166,33922,33922,31086,32515,33870
77925,163,315,55658,22267,2.80116e+13,173.004,3256.39,77925,258,175,75942,59697,68197,69684,73050
95924,26,347,68520,27404,2.79986e+13,173.173,3629.46,95924,290,175,63292,46482,16312,10925,16746
7708,55,188,5507,2201,2.8021e+13,163.669,993.717,7708,121,112,5948,4888,1971,2124,2662
2123,39,177,1518,605,2.76565e+13,136.229,517.363,2123,84,76,1521,1205,456,556,589
29597,89,227,21146,8451,2.79675e+13,171.34,1972.96,29597,171,158,24860,20636,11522,10975,16042
85070,795,946,60829,24241,2.72825e+13,242.829,4553.38,85070,753,180,84124,83981,82888,83384,83672
85936,96,329,61386,24550,2.79988e+13,173.082,3426.6,85936,272,175,73427,60269,35774,33787,49931
88885,36,800,63575,25310,2.72141e+13,244.162,4438.6,88885,798,175,62961,50119,17674,19557,22097
3737,73,181,2667,1070,2.81072e+13,152.762,688.658,3737,100,93,2972,2474,1208,1003,1650
26366,82,362,18805,7561,2.83882e+13,171.243,2035.74,26366,172,159,21800,18390,8988,10975,12748
87437,767,800,62540,24897,2.72171e+13,252.368,4410.3,87437,726,178,86637,86500,86197,86310,86539
23738,76,217,16957,6781,2.79961e+13,170.782,1762.61,23738,160,146,19383,16108,7901,6743,11114
31986,101,232,22852,9134,2.80049e+13,171.586,2054.04,31986,175,161,27591,23272,14344,12070,19190
55919,48,800,40032,15887,2.67276e+13,210.386,3721.78,55919,793,175,41822,33870,12664,13718,16717
61173,105,285,43691,17482,2.80203e+13,172.718,2871.22,61173,228,175,53258,44877,28664,27150,38733
57378,33,278,40984,16394,2.80111e+13,172.676,2777.41,57378,221,175,40019,30597,10596,10720,13489
66566,279,800,47639,18927,2.696e+13,217.674,3972.57,66566,782,180,65377,64852,61739,62983,64157
72595,144,305,51851,20744,2.80046e+13,172.918,3137.91,72595,248,175,68268,54832,53900,53265,60520
48498,194,262,34639,13859,2.80216e+13,172.435,2545.85,48498,205,175,48236,48236,44345,46315,48168
15449,20,202,11033,4416,2.80249e+13,168.953,1415.34,15449,145,132,9349,6621,2644,1575,2254
16991,77,205,12137,4854,2.80005e+13,169.512,1485.77,16991,148,135,13876,11585,5742,5809,8163
61833,644,800,44264,17569,2.68627e+13,213.317,3864.07,61833,789,180,61003,60822,57813,59353,60566
55042,221,273,39315,15727,2.79797e+13,172.551,2717.3,55042,216,175,54769,54769,51936,53364,54717
83401,93,325,59567,23834,2.80092e+13,172.996,3373.89,83401,267,175,70808,58354,33256,41794,47413
44248,55,254,31605,12643,2.80019e+13,172.193,2427.58,44248,197,175,34382,28151,11080,8675,15050
87259,217,332,62331,24928,2.80116e+13,173.097,3454.7,87259,275,175,86927,86927,79849,83457,86812
18910,67,208,13507,5403,2.79662e+13,169.828,1568.62,18910,151,138,15124,12492,5522,5614,7801
98893,208,494,70614,28279,2.81047e+13,173.314,3873.51,98893,295,192,98399,98275,68237,44091,85300
28591,8,225,20427,8164,2.79766e+13,171.241,1938.05,28591,168,155,11874,5421,3303,2736,1319
54549,64,272,38968,15581,2.79744e+13,172.573,2704.64,54549,216,175,43434,35980,14995,15799,21625
94395,317,800,67515,26880,2.72767e+13,225.26,4544.26,94395,798,180,93178,92631,85129,88730,92022
49945,63,265,35673,14272,2.80216e+13,172.439,2585.13,49945,208,175,39676,32762,13669,11142,19650
27722,72,224,19800,7922,2.80359e+13,171.028,1908.05,27722,167,154,22453,18486,8690,12489,12743
87314,127,332,62370,24944,2.80004e+13,173.122,3455.75,87314,275,175,79453,65637,53985,46774,64963
61723,374,800,44180,17543,2.68695e+13,218.33,3861.17,61723,773,180,60638,60018,57747,58774,59645
26072,37,221,18621,7451,2.79848e+13,170.99,1849,26072,164,151,18734,14741,5189,5961,6522
48640,66,405,34721,13919,2.81886e+13,172.681,2734.42,48640,220,183,38889,32236,13382,12947,19467
39023,31,244,27879,11144,2.79735e+13,171.964,2274.59,39023,188,175,26793,20310,7007,5014,7993
53170,83,270,37979,15191,2.79929e+13,172.527,2669.41,53170,213,175,44167,36989,18802,17550,26244
78202,757,800,55946,22256,2.71184e+13,228.292,4223.96,78202,775,180,77402,77241,75349,76288,77274
13903,78,199,9932,3971,2.79916e+13,168.426,1341.2,13903,142,128,11372,9499,4659,4102,6644
43895,798,800,31445,12450,2.63924e+13,208.753,3407.19,43895,776,175,43095,42951,42923,42952,43089
17360,193,205,12407,4953,2.7965e+13,169.609,1501.61,17360,149,135,17155,17155,16955,17041,17143
39002,125,244,27864,11138,2.79777e+13,172.057,2274.19,39002,188,175,35300,29296,23782,19632,28453
86829,360,431,62012,24817,2.8066e+13,172.414,3574.87,86829,273,188,86398,86398,82444,84450,86327
21410,119,213,15289,6121,2.80283e+13,169.982,1671.46,21410,155,142,19118,15888,11862,12995,15024
71119,93,302,50803,20316,2.79839e+13,172.885,3104.22,71119,246,175,60364,49751,28332,29366,39984
21465,158,213,15337,6128,2.80023e+13,170.223,1673.81,21465,156,143,20623,16373,18682,19099,19393
4172,57,182,2978,1194,2.82812e+13,155.656,728.992,4172,103,97,3205,2654,1074,823,1377
94035,130,344,67167,26868,2.801e+13,173.151,3592.33,94035,287,175,86086,70866,59175,59848,71507
46884,80,259,33488,13396,2.80102e+13,172.307,2501.42,46884,202,175,38692,32527,16067,16227,23144
93277,84,343,66628,26649,2.80188e+13,173.174,3577.54,93277,286,175,77701,64905,33091,32941,48741
71016,36,303,50726,20290,2.80265e+13,172.898,3103.08,71016,246,175,50694,40186,14393,10440,16794
47246,107,259,33750,13496,2.79892e+13,172.344,2510.8,47246,203,175,41266,34653,22813,21138,30186
47914,147,261,34217,13697,2.80223e+13,172.297,2529.82,47914,203,175,45273,36264,36423,39939,40526
31156,177,231,22255,8901,2.80459e+13,171.478,2026.96,31156,174,160,30925,30925,27995,29468,30871
50045,99,264,35750,14295,2.79937e+13,172.467,2586.72,50045,208,175,42987,36254,21736,20491,29861
90213,128,337,64442,25771,2.80043e+13,173.136,3515.05,90213,281,175,82268,67823,56110,56434,67824
17915,194,206,12793,5122,2.80185e+13,169.452,1525.68,17915,149,136,17709,17709,17513,17599,17697
9217,114,190,6590,2627,2.78936e+13,165.54,1087.36,9217,127,117,8078,6797,4849,4395,6164
32485,33,232,23207,9278,2.79517e+13,171.594,2069.52,32485,176,163,22650,17311,5984,7178,7867
11006,185,193,7864,3142,2.79654e+13,166.559,1189.68,11006,133,124,10813,10813,10719,10757,10805
45398,81,256,32424,12974,2.80059e+13,172.289,2459.86,45398,199,175,37536,31581,15874,16226,23027
82130,230,322,58662,23468,2.80055e+13,173.018,3346.33,82130,265,175,81808,81808,76266,79086,81716
99615,266,800,71249,28366,2.72961e+13,245.2,4641.76,99615,774,180,98365,97841,92179,94656,97052
1556,43,177,1111,445,2.82322e+13,123.652,442.084,1556,72,69,1117,911,345,280,376
77422,371,800,55384,22038,2.71188e+13,219.186,4207.92,77422,798,180,76309,75688,71730,73615,75335
77691,59,314,55495,22196,2.7989e+13,172.974,3250.69,77691,257,175,61116,49852,20682,21802,28669
75755,64,311,54111,21644,2.80073e+13,172.962,3208.65,75755,254,175,60351,49981,20824,20735,30028
9887,20,341,7038,2849,2.88366e+13,167.6,1304.08,9887,144,134,5948,4217,1728,843,1430
4076,64,181,2912,1164,2.79106e+13,155.024,719.622,4076,102,95,3183,2663,1155,1271,1619
13724,177,199,9808,3916,2.8008e+13,168.39,1332.48,13724,142,128,13525,13525,12745,13114,13503
83264,51,467,59456,23808,2.81025e+13,173.192,3557.17,83264,266,194,63884,51671,19519,14489,25495
19553,160,209,13963,5590,2.79538e+13,169.976,1595.44,19553,152,139,18849,14914,17021,16313,17762
71362,233,303,50972,20390,2.8011e+13,172.857,3110.25,71362,246,175,71059,71059,66992,69054,70989
12055,112,196,8610,3445,2.8043e+13,167.426,1247.06,12055,137,125,10559,8878,6232,5784,7972
62834,109,288,44883,17951,2.80235e+13,172.759,2911.57,62834,231,175,55143,46203,30899,28326,40952
50063,23,265,35756,14307,2.80231e+13,172.335,2587.94,50063,207,175,31769,23176,8536,5455,6506
73050,197,306,52183,20867,2.80017e+13,172.925,3148.4,73050,250,175,72744,72744,66025,69452,72635
21777,184,213,15552,6225,2.80345e+13,170.283,1685.82,21777,156,143,21564,21564,20314,20926,21535
28664,173,226,20473,8191,2.80183e+13,171.289,1941.52,28664,169,155,28338,22489,25560,27011,28091
73532,80,307,52526,21006,2.80058e+13,172.939,3159.33,73532,250,175,60707,51024,25137,25434,36403
74063,282,449,52885,21178,2.81034e+13,173.072,3354.61,74063,250,193,73614,73494,60551,57850,69027
66459,357,437,47449,19010,2.81198e+13,173.022,3183.24,66459,252,179,66022,66022,64613,63556,65091
65656,106,293,46892,18764,2.80221e+13,172.733,2978.48,65656,235,175,57273,48174,31401,36115,41788
97713,223,494,69779,27934,2.80911e+13,173.369,3853.31,97713,293,194,97219,97097,68841,44670,85218
51584,72,267,36842,14742,2.80184e+13,172.412,2627.78,51584,210,175,41829,34410,16099,23243,23624
78443,259,413,56003,22440,2.80904e+13,172.156,3395.97,78443,263,175,78030,78030,74888,76409,77750
54856,154,274,39186,15670,2.80078e+13,172.618,2713.97,54856,217,175,52524,41513,46231,48094,48381
77578,387,800,55497,22081,2.71133e+13,232.821,4210.84,77578,765,180,76512,75844,74031,75111,75539
67607,202,296,48290,19317,2.79985e+13,172.805,3023.67,67607,239,175,67311,67311,61633,64523,67217
96088,46,347,68638,27450,2.79977e+13,173.175,3632.41,96088,291,175,72419,58019,21729,24144,30893
33137,59,234,23669,9468,2.80094e+13,171.639,2091.65,33137,177,164,26032,21252,8780,7812,12366
92237,598,944,65955,26282,2.73348e+13,224.613,4691.66,92237,804,180,91203,90803,86863,88748,90320
33332,154,235,23805,9527,2.80567e+13,171.541,2098.38,33332,177,164,31858,25215,28046,29180,29307
3190,163,180,2277,913,2.82478e+13,149.913,636.488,3190,93,91,2962,2394,2785,2884,2825
33866,24,235,24186,9680,2.80051e+13,171.653,2114.63,33866,178,165,21781,15974,5760,3672,5736
55584,21,275,39702,15882,2.8021e+13,172.589,2732.26,55584,218,175,34259,24421,9462,6147,8718
45011,351,404,32126,12885,2.81902e+13,172.51,2638.77,45011,206,192,44607,44607,42020,43333,44338
65180,510,974,46620,18560,2.70514e+13,221.906,4174.83,65180,771,213,64061,63693,61674,62091,62814
29262,101,227,20905,8357,2.80087e+13,171.346,1962.01,29262,170,156,25236,21286,13124,12204,17806
97098,314,350,69362,27736,2.79979e+13,173.218,3653.69,97098,293,175,96748,96748,95058,95894,96712
16997,76,205,12142,4855,2.80239e+13,169.546,1486.19,16997,148,134,13852,11522,5646,4512,7988
29756,135,228,21251,8505,2.80264e+13,171.429,1979.47,29756,171,158,27448,22391,19864,20108,23270
77645,775,944,55525,22120,2.71986e+13,220.68,4399.42,77645,792,197,76701,76527,73420,74961,76194
70769,290,302,50548,20221,2.8005e+13,172.867,3096.83,70769,245,175,70467,70467,70269,70355,70455
90464,7,338,64616,25848,2.80153e+13,173.134,3520.65,90464,281,175,35009,14077,9817,5559,3245
15646,50,202,11175,4471,2.79689e+13,168.966,1423.94,15646,145,132,11923,9655,3752,3397,5030
92853,43,342,66324,26529,2.80072e+13,173.149,3568.71,92853,285,175,69141,54729,20635,14801,25556
54564,236,418,38945,15619,2.81705e+13,172.733,2892.4,54564,214,192,54146,54024,41391,32520,49431
45128,670,800,32327,12801,2.64481e+13,222.483,3441.55,45128,673,175,44328,44222,44058,44089,43939
63817,241,289,45579,18238,2.80199e+13,172.711,2934.16,63817,232,175,63528,63528,60986,62263,63480
50203,149,265,35858,14345,2.80206e+13,172.429,2591.44,50203,208,175,47624,37995,38698,42028,43481
31272,142,230,22340,8932,2.79553e+13,171.473,2029.59,31272,173,160,29244,23599,22846,22804,25473
11539,10,195,8242,3297,2.80402e+13,167.328,1220.01,11539,135,124,5269,2857,1588,940,510
93797,290,344,67004,26793,2.80135e+13,173.184,3588.12,93797,287,175,93453,93453,90525,91997,93399
40056,162,246,28617,11439,2.79868e+13,172.088,2305.74,40056,190,175,38900,30661,35026,37476,37065
39081,51,245,27909,11172,2.80258e+13,171.936,2277.08,39081,188,174,29957,24236,9617,7385,12540
54964,234,273,39262,15702,2.79861e+13,172.536,2715.35,54964,216,175,54691,54691,52749,53717,54652
9530,44,191,6808,2722,2.79234e+13,165.596,1106.18,9530,127,118,7098,5624,2152,2372,2770
1371,82,176,980,391,2.71124e+13,116.038,413.984,1371,69,62,1071,933,540,493,682
75114,79,310,53652,21462,2.79914e+13,172.981,3194.64,75114,253,175,61864,51588,25460,24212,35448
98204,255,352,70138,28066,2.80167e+13,173.151,3675.19,98204,294,175,97852,97852,91971,94966,97755
39994,161,246,28565,11429,2.79915e+13,171.991,2303.75,39994,189,175,38764,30554,34928,33450,37048
91194,643,800,65231,25963,2.72337e+13,245.045,4483.01,91194,798,175,90263,90083,80296,85318,89924
65165,125,800,46635,18530,2.69541e+13,228.29,3940.94,65165,753,180,58143,48309,38486,38871,46175
88875,627,800,63571,25304,2.72171e+13,251.24,4438.31,88875,735,180,88062,87891,87150,87530,87556
46468,177,258,33194,13274,2.80034e+13,172.332,2489.84,46468,201,175,46210,46210,41435,43860,46129
27826,221,225,19869,7957,2.80728e+13,171.067,1912.55,27826,167,154,27601,27601,27578,27584,27597
34666,22,237,24764,9902,2.8029e+13,171.8,2141.07,34666,180,166,21670,15416,5906,4264,4263
62883,266,288,44922,17961,2.79904e+13,172.767,2912.54,62883,231,175,62595,62595,61855,62202,62573
6883,172,186,4920,1963,2.78405e+13,162.565,937.788,6883,116,108,6667,5350,6433,6552,6570
44747,74,255,31962,12785,2.802e+13,172.206,2441.65,44747,198,175,36432,29920,14527,12755,20878
11089,70,194,7923,3166,2.79718e+13,166.895,1195.22,11089,135,123,8900,7357,3356,2817,4772
33962,235,236,24258,9704,2.8042e+13,171.71,2118.76,33962,179,165,33726,33726,33726,33726,33725
22537,230,359,16070,6467,2.84382e+13,168.966,1895.18,22537,157,161,22178,22104,14422,11600,15881
56855,732,800,40692,16163,2.67928e+13,215.774,3744.83,56855,772,180,56055,55886,54177,55014,55852
31050,209,230,22182,8868,2.80055e+13,171.411,2022.3,31050,173,160,30820,30820,30108,30442,30799
80242,491,800,57403,22839,2.71449e+13,234.328,4266.27,80242,767,180,79279,78900,77044,77959,78515
52163,266,411,37235,14928,2.81715e+13,172.672,2827.5,52163,210,192,51752,51632,40498,35733,48476
3183,137,180,2275,908,2.83099e+13,149.815,635.654,3183,93,91,2837,2354,2128,2138,2427
2285,32,178,1632,653,2.84686e+13,138.343,537.346,2285,85,81,1563,1197,449,448,462
84797,202,328,60560,24237,2.8023e+13,173.029,3403.87,84797,270,175,84469,84469,76634,80634,84343
75702,56,311,54070,21632,2.80139e+13,172.915,3207.56,75702,253,175,59043,48450,19079,22335,27776
57080,11,278,40773,16307,2.80092e+13,172.654,2770.38,57080,221,175,27145,16724,8361,4754,5779
73464,101,307,52473,20991,2.79991e+13,172.957,3157.93,73464,250,175,63410,53498,32958,32459,44203
58125,360,420,41491,16634,2.81693e+13,172.891,2978.31,58125,230,176,57705,57705,57434,57251,57481
91421,34,800,65392,26029,2.72446e+13,228.544,4487.92,91421,794,180,63811,51228,17056,15933,21066
61470,166,285,43904,17566,2.80017e+13,172.725,2877.95,61470,228,175,60204,47415,53922,57640,58323
3930,63,181,2806,1124,2.81595e+13,154.034,706.696,3930,100,95,3066,2559,1116,1375,1608
94924,96,346,67804,27120,2.80176e+13,173.186,3610.48,94924,289,175,81124,66567,39490,37297,55922
47203,97,259,33723,13480,2.79849e+13,172.392,2509.94,47203,203,175,40379,34191,19911,19069,27539
58415,43,279,41726,16689,2.80031e+13,172.621,2802.32,58415,222,175,43487,34424,12689,15948,17585
25721,14,220,18378,7343,2.79724e+13,170.921,1835.79,25721,164,150,13577,9251,3904,2285,3030
40151,128,246,28674,11477,2.80083e+13,171.952,2308.11,40151,189,175,36574,30171,24973,25143,29944
87781,455,800,62785,24996,2.72243e+13,229.157,4416.99,87781,786,180,86764,86029,83207,84807,85946
93180,81,492,66531,26649,2.80962e+13,173.282,3768.82,93180,284,195,77096,64879,29747,22954,42075
70771,159,442,50538,20233,2.81134e+13,173.063,3279.49,70771,244,193,68316,54098,34136,19520,55521
49276,31,375,35172,14104,2.81447e+13,170.849,2711.87,49276,211,175,33856,25653,8861,6576,10018
15525,114,202,11093,4432,2.79874e+13,168.924,1418.67,15525,146,132,13687,11477,8140,9064,10536
20131,412,800,14472,5659,2.45563e+13,217.985,2606.97,20131,772,136,19085,18501,16353,17607,18167
79061,774,941,56546,22515,2.72279e+13,222.478,4424.63,79061,789,198,78120,77949,75067,76475,77620
97557,426,800,69770,27787,2.72918e+13,232.208,4603.53,97557,798,175,96428,95787,87107,91734,95593
57077,57,426,40739,16338,2.81611e+13,172.767,2960.36,57077,234,185,44638,36586,14257,14331,20227
18220,93,207,13014,5206,2.80361e+13,169.582,1539.14,18220,150,136,15421,12723,7277,7026,10241
71978,120,800,51504,20474,2.7024e+13,216.778,4091.78,71978,793,180,63712,52819,39107,36737,49072
85434,32,329,61017,24417,2.802e+13,173.09,3417.06,85434,272,175,59145,44797,15619,11623,18475
20597,48,212,14708,5889,2.80956e+13,170.009,1639.64,20597,154,141,15603,12586,4809,5770,6644
5291,143,184,3779,1512,2.8261e+13,159.324,821.928,5291,110,103,4851,3953,3860,4249,4294
11624,73,195,8305,3319,2.79926e+13,167.238,1224.15,11624,135,124,9399,7737,3707,3329,5259
1598,164,177,1146,452,2.80193e+13,124.335,448.595,1598,70,73,1410,1178,1371,1389,1358
44580,247,255,31845,12735,2.80303e+13,172.253,2437.46,44580,198,175,44325,44325,44243,44272,44317
82540,214,323,58950,23590,2.80199e+13,173.02,3355.25,82540,266,175,82217,82217,75540,78945,82108
43871,71,253,31332,12539,2.8018e+13,172.143,2416.54,43871,196,175,35489,29178,13463,19689,19913
11883,18,195,8487,3396,2.79157e+13,167.194,1237.17,11883,135,125,6882,4887,2000,1349,1825
94528,144,345,67517,27011,2.80069e+13,173.178,3602.29,94528,288,175,88944,71410,70207,77862,79195
81669,527,800,58428,23241,2.71446e+13,223.553,4295.07,81669,790,180,80720,80325,77053,78722,80050
83484,704,945,59702,23782,2.72712e+13,234.766,4518.86,83484,771,197,82539,82357,80612,81184,81816
27795,187,224,19853,7942,2.79976e+13,171.113,1910.4,27795,167,154,27571,27571,25765,26663,27534
76532,117,312,54662,21870,2.80137e+13,172.944,3225.33,76532,255,175,68277,56708,41650,46102,53053
95983,8,347,68561,27422,2.79931e+13,173.175,3630.56,95983,290,175,39907,18213,11108,7636,4239
91264,113,339,65188,26076,2.80058e+13,173.114,3536.45,91264,282,175,80769,67635,47564,53140,61533
83786,256,325,59848,23938,2.79998e+13,173.038,3381.3,83786,268,175,83461,83461,79480,81497,83392
34040,412,800,24399,9641,2.59634e+13,215.145,3113.88,34040,795,160,32971,32385,28648,30721,32076
64420,53,290,46012,18408,2.79871e+13,172.752,2948.51,64420,233,175,49755,40871,15747,17143,21892
23490,37,216,16783,6707,2.79678e+13,170.727,1752.6,23490,160,147,16875,13279,4697,4416,5974
54360,125,272,38830,15530,2.79888e+13,172.543,2699.94,54360,215,175,49260,40855,33169,28563,39495
28629,45,226,20441,8188,2.80427e+13,171.098,1940.01,28629,168,155,21478,17084,6393,5676,8595
87441,148,800,62551,24890,2.71997e+13,242.832,4410.57,87441,798,175,81898,65517,65128,67505,72742
92910,196,342,66365,26545,2.80052e+13,173.166,3569.82,92910,285,175,92568,92568,83377,88075,92422
16527,78,204,11809,4718,2.8003e+13,169.285,1464.6,16527,147,133,13539,11293,5538,5683,8033
14354,190,200,10258,4096,2.80048e+13,168.59,1363.2,14354,143,130,14154,14154,14022,14076,14144
42812,12,251,30582,12230,2.79874e+13,172.096,2385.97,42812,194,175,21125,13384,6347,4425,5064
89983,539,800,64361,25622,2.72325e+13,226.252,4459.99,89983,797,180,89039,88639,84958,86829,88400
53513,47,947,38292,15221,2.68557e+13,227.575,3850.33,53513,797,184,39875,32147,11938,9529,14635
27127,363,800,19467,7660,2.54379e+13,210.401,2880.25,27127,769,148,26035,25484,23445,24379,25016
94322,182,345,67370,26952,2.80174e+13,173.158,3598.47,94322,288,175,93977,93977,83615,88917,93814
63108,4,288,45077,18031,2.80045e+13,172.77,2917.65,63108,231,175,16545,5017,3650,3537,1341
34881,173,237,24915,9966,2.80096e+13,171.733,2147.21,34881,180,167,34522,27381,31012,32851,34255
97660,309,350,69760,27900,2.80041e+13,173.16,3663.46,97660,293,175,97310,97310,95232,96270,97269
41733,148,250,29807,11926,2.8016e+13,172.186,2356.01,41733,193,175,39485,31571,31864,34846,35664
43120,44,252,30804,12316,2.80095e+13,172.208,2395.44,43120,195,175,32239,25481,9716,10694,12544
87401,266,332,62431,24970,2.80064e+13,173.097,3457.32,87401,275,175,87069,87069,83297,85206,87003
35583,110,238,25411,10172,2.8019e+13,171.704,2169.12,35583,181,168,31254,26224,17947,20549,23344
23247,773,800,16697,6550,2.49775e+13,213.09,2734.74,23247,753,142,22447,22302,21459,21846,22367
62929,10,288,44944,17985,2.8017e+13,172.794,2913.73,62929,231,175,28782,15588,8647,5119,5981
2462,166,179,1757,705,2.85945e+13,142.088,557.892,2462,88,83,2256,1850,2178,2226,2215
62711,267,287,44790,17921,2.80201e+13,172.701,2907.65,62711,230,175,62424,62424,61786,62083,62404
86719,241,331,61941,24778,2.80091e+13,173.102,3443.5,86719,274,175,86388,86388,80990,83736,86298
66732,227,295,47667,19065,2.80175e+13,172.839,3004.07,66732,238,175,66437,66437,62550,64518,66369
83191,126,325,59425,23766,2.80071e+13,173.1,3370.06,83191,268,175,75565,62533,51117,43798,62133
49051,201,263,35033,14018,2.80214e+13,172.351,2560.5,49051,206,175,48788,48788,45287,47057,48726
70605,88,302,50433,20172,2.80142e+13,172.858,3093.32,70605,245,175,59320,49254,27092,26473,38051
11184,51,194,7994,3190,2.79356e+13,167.146,1200.75,11184,134,123,8535,6915,2759,3181,3762
26916,100,223,19230,7686,2.79807e+13,171.091,1879.92,26916,166,153,23121,19533,12035,11199,16181
43489,204,253,31063,12426,2.8018e+13,172.223,2406.42,43489,196,175,43236,43236,40628,41938,43187
68849,210,298,49177,19672,2.80006e+13,172.842,3052.22,68849,241,175,68551,68551,63279,65961,68463
97153,790,800,69490,27663,2.72792e+13,237.957,4595.85,97153,782,180,96353,96192,95387,95853,96324
84322,255,327,60227,24095,2.80172e+13,173.066,3393.83,84322,270,175,83995,83995,79832,81942,83923
7453,74,188,5317,2136,2.81674e+13,163.516,977.325,7453,121,111,6012,4964,2414,1969,3320
44584,121,255,31844,12740,2.80246e+13,172.201,2437.39,44584,198,175,40063,33181,25325,27177,31878
87771,355,479,62670,25101,2.81048e+13,173.291,3655.2,87771,275,194,87292,87292,82557,79856,84873
41142,22,249,29393,11749,2.80009e+13,172.192,2338.84,41142,192,175,25721,18290,6991,6014,5625
47681,43,800,34108,13573,2.7108e+13,212.353,3294.53,47681,549,175,35147,27962,10080,6575,394
42108,201,250,30080,12028,2.80039e+13,172.09,2365.93,42108,193,175,41858,41858,39242,40556,41809
17437,12,205,12452,4985,2.80194e+13,169.292,1504.41,17437,148,135,8600,5461,2580,1518,2000
80401,55,320,57433,22968,2.80053e+13,173.069,3310.59,80401,263,175,62503,51152,20066,19209,28378
66542,273,294,47532,19010,2.79981e+13,172.801,2998.8,66542,237,175,66248,66248,65530,65868,66227
50110,202,407,35767,14343,2.81624e+13,172.662,2772.69,50110,206,194,49703,49577,33013,19736,43100
28016,219,225,20011,8005,2.80281e+13,171.25,1919.03,28016,168,154,27791,27791,27739,27757,27785
55384,650,800,39648,15736,2.67544e+13,215.126,3708.76,55384,798,175,54533,54350,49543,51995,54135
72678,191,305,51911,20767,2.80172e+13,172.873,3139.53,72678,248,175,72373,72373,65343,68930,72259
31199,210,231,22286,8913,2.79982e+13,171.573,2028.34,31199,174,160,30968,30968,30292,30608,30947
43652,236,253,31178,12474,2.80069e+13,172.214,2410.72,43652,196,175,43399,43399,42967,43157,43382
43539,22,253,31099,12440,2.80117e+13,172.275,2407.87,43539,196,175,27220,19367,7406,4576,6592
7253,39,187,5183,2070,2.79539e+13,163.015,963.148,7253,119,110,5265,4136,1554,1058,1792
68019,55,297,48585,19434,2.8007e+13,172.85,3033.63,68019,240,175,52879,43281,16986,19815,24480
17748,145,356,12647,5101,2.85116e+13,170.164,1701.92,17748,164,153,16514,13390,9407,7161,12950
98893,163,353,70638,28255,2.79966e+13,173.224,3688.55,98893,296,175,96416,75772,86553,88454,91721
45770,127,257,32684,13086,2.80244e+13,172.184,2470.31,45770,199,175,41625,34399,28288,28579,34015
20013,19,229,14296,5717,2.80007e+13,169.549,1632.13,20013,153,139,11855,8459,3400,2968,3216
39724,200,246,28369,11355,2.80258e+13,172.088,2296.58,39724,189,175,39478,39478,37083,38283,39432
38878,86,244,27765,11113,2.80237e+13,171.897,2270.55,38878,187,174,32492,27122,14398,18727,20847
1421,8,176,1021,400,2.69491e+13,118.123,421.356,1421,68,65,580,257,160,86,59
36911,181,241,26367,10544,2.80102e+13,171.853,2211.01,36911,184,170,36670,36670,33309,35005,36610
67080,75,295,47923,19157,2.79939e+13,172.872,3011.63,67080,239,175,54752,45218,22191,19199,31221
64621,196,291,46157,18464,2.80133e+13,172.718,2953.79,64621,234,175,64330,64330,58580,61508,64235
89986,32,337,64278,25708,2.80124e+13,173.138,3510.78,89986,280,175,62292,47185,16461,11733,18923
33821,186,236,24155,9666,2.80257e+13,171.647,2114.26,33821,178,165,33585,33585,30937,32268,33535
82102,149,322,58650,23452,2.79944e+13,173.07,3345.87,82102,266,175,77972,62163,63319,65841,70770
47222,21,260,33734,13488,2.80035e+13,172.422,2511.27,47222,203,175,29098,20736,8013,6563,6176
5558,133,184,3967,1591,2.79925e+13,159.896,841.846,5558,110,104,5005,4151,3563,3604,4225
83693,564,800,59874,23819,2.7156e+13,221.243,4335.84,83693,798,180,82771,82371,78523,80461,82185
88994,333,335,63572,25422,2.80098e+13,173.114,3490.27,88994,278,175,88659,88659,88655,88655,88657
14374,538,800,10347,4027,2.32642e+13,198.636,2330.86,14374,741,125,13574,13335,11685,8995,1704
32850,92,234,23462,9388,2.80569e+13,171.589,2082.7,32850,177,163,27788,22903,12914,12876,18504
61835,111,286,44170,17665,2.79821e+13,172.775,2887.28,61835,229,175,54459,45581,31643,29887,40659
96825,89,800,69252,27573,2.72843e+13,225.169,4590.09,96825,798,180,80730,67042,36984,34836,51590
76840,56,313,54889,21951,2.80058e+13,172.985,3232.66,76840,256,175,59928,49171,19328,22662,28091
32427,160,232,23164,9263,2.79669e+13,171.566,2067.64,32427,175,162,31351,24760,28289,27102,29614
85327,160,328,60957,24370,2.79974e+13,173.138,3414.22,85327,272,175,82704,65211,74586,79942,78692
19216,46,209,13722,5494,2.80338e+13,169.838,1581.95,19216,152,138,14451,11600,4362,3269,5489
86455,211,330,61751,24704,2.80034e+13,173.052,3437.26,86455,273,175,86125,86125,78743,82511,86006
22929,62,800,16469,6460,2.49433e+13,213.072,2721.38,22929,747,141,17462,14487,5907,8781,8396
39745,119,246,28387,11358,2.8011e+13,172.062,2297.03,39745,189,175,35568,29499,21970,19299,27678
6713,101,186,4793,1920,2.79583e+13,162.316,926.188,6713,116,108,5724,4857,3027,2851,3977
33920,579,800,24319,9601,2.5914e+13,208.45,3110.11,33920,775,161,33038,32662,30618,31632,32457
40474,712,800,28999,11475,2.6268e+13,218.561,3309.9,40474,729,177,39674,39509,39085,39272,39411
89515,204,336,63938,25577,2.80087e+13,173.131,3501.04,89515,279,175,89179,89179,80917,85137,89047
33539,109,235,23954,9585,2.80179e+13,171.698,2104.98,33539,178,164,29404,24646,16484,15446,21665
18840,119,208,13458,5382,2.79953e+13,169.807,1565.71,18840,151,138,16817,13965,10420,9171,13153
27476,90,224,19625,7851,2.80306e+13,171.151,1899.98,27476,167,154,23129,19149,10723,10385,15112
48281,272,331,34470,13811,2.80891e+13,171.412,2625.03,48281,207,175,47950,47950,47924,47917,47853
33017,28,233,23589,9428,2.7949e+13,171.615,2086.88,33017,177,164,22127,16582,5606,5542,5150
14265,476,800,10280,3985,2.31258e+13,227.73,2333.01,14265,756,125,13292,13042,11379,12184,12493
57621,366,423,41130,16491,2.81592e+13,172.879,2970.64,57621,220,192,57198,57198,54222,55723,57141
26696,648,771,19116,7580,2.6645e+13,165.929,2562.48,26696,475,150,25925,25925,22826,24429,15661
4319,56,181,3087,1232,2.78732e+13,155.187,740.405,4319,105,95,3323,2749,1128,1777,1627
41024,154,249,29303,11721,2.80197e+13,172.117,2335.46,41024,192,175,39242,31034,34546,35938,36171
22792,173,215,16278,6514,2.804e+13,170.564,1726.03,22792,158,145,22499,17875,20456,21516,22281
92856,227,342,66330,26526,2.80108e+13,173.142,3568.72,92856,285,175,92514,92514,85431,89044,92399
93944,159,485,67077,26867,2.81105e+13,173.244,3775.23,93944,285,193,90781,71833,44892,25734,71634
41129,34,248,29386,11743,2.79755e+13,172.153,2337.59,41129,192,175,28903,23107,7771,7356,9735
7346,74,187,5243,2103,2.80798e+13,162.979,969.757,7346,119,110,5935,4902,2422,3350,3470
11593,173,195,8279,3314,2.8031e+13,167.38,1222.72,11593,135,125,11360,9061,10628,10995,11272
89832,279,336,64166,25666,2.8004e+13,173.109,3506.8,89832,279,175,89496,89496,86335,87930,89439
69756,68,300,49826,19930,2.79999e+13,172.874,3073.58,69756,243,175,56071,46272,20415,22218,30259
40205,38,247,28718,11487,2.80302e+13,172.096,2310.9,40205,190,175,29118,22813,8181,7645,10366
30796,155,229,21991,8805,2.80172e+13,171.222,2013.09,30796,172,159,29488,23414,26082,27726,27311
27854,127,224,19895,7959,2.79636e+13,171.111,1912.39,27854,167,154,25298,20918,17221,14969,20527
3715,56,181,2651,1064,2.80466e+13,153.167,687.54,3715,100,93,2846,2360,941,938,1252
81450,194,321,58175,23275,2.80024e+13,173.014,3331.91,81450,264,175,81129,81129,73203,77251,81002
99777,237,495,71251,28526,2.80928e+13,173.335,3890.23,99777,297,192,99282,99161,84776,77758,93915
75932,630,800,54323,21609,2.70928e+13,220.131,4176.62,75932,798,175,75042,74873,68724,71891,74622
33158,71,234,23684,9474,2.80171e+13,171.552,2091.96,33158,177,163,26807,22052,10153,7664,14200
63866,48,290,45612,18254,2.8027e+13,172.777,2936.36,63866,233,175,48461,39023,14801,11013,19434
78408,131,462,55975,22433,2.81335e+13,173.114,3456.09,78408,257,194,71843,59099,39656,32105,54467
29923,205,369,21356,8567,2.83073e+13,171.852,2163.28,29923,181,173,29554,29430,21687,15437,26151
21242,52,213,15165,6077,2.80776e+13,170.279,1665.53,21242,156,142,16317,13241,5180,4070,6874
19720,197,210,14079,5641,2.80384e+13,170.13,1603.54,19720,153,139,19510,19510,19287,19383,19497
48513,243,261,34650,13863,2.79984e+13,172.288,2545.01,48513,204,175,48252,48252,47733,47969,48234
75317,452,454,53772,21545,2.81253e+13,173.144,3387.06,75317,253,193,74863,74863,74859,74859,74861
91114,51,484,65051,26063,2.81121e+13,173.225,3723.11,91114,280,193,69916,56543,21198,15038,27881
99975,656,800,71501,28474,2.73035e+13,228.164,4648.18,99975,798,180,99088,98902,91241,95162,98744
93544,51,800,66903,26641,2.726e+13,226.853,4527.87,93544,798,175,71149,57707,22673,28486,32095
49379,239,264,35267,14112,2.80463e+13,172.341,2569.86,49379,206,175,49115,49115,48152,48615,49090
39136,56,245,27954,11182,2.80152e+13,172.067,2279.18,39136,188,174,30491,25031,9859,11558,14301
97481,217,350,69631,27850,2.8002e+13,173.212,3660.57,97481,293,175,97131,97131,88789,93053,96998
5157,160,183,3687,1470,2.78483e+13,158.627,809.743,5157,107,102,4862,3904,4432,4704,4567
27821,175,224,19867,7954,2.80172e+13,171.08,1911.55,27821,167,154,27597,27597,24992,26301,27548
38037,8,242,27174,10863,2.79657e+13,171.958,2244.6,38037,186,173,15808,7206,4395,3019,2174
94479,57,345,67486,26993,2.80081e+13,173.187,3601.39,94479,288,175,73921,60463,25108,22931,34226
55518,209,275,39646,15872,2.8034e+13,172.558,2730.56,55518,217,175,55243,55243,51488,53388,55177
42287,111,251,30208,12079,2.79886e+13,172.224,2372.2,42287,194,175,37221,31156,21628,19732,27536
40756,16,247,29122,11634,2.7969e+13,172.158,2326.2,40756,191,175,22607,15900,6693,4848,3490
99639,318,354,71172,28467,2.7999e+13,173.216,3702.79,99639,297,175,99285,99285,97559,98416,99249
18776,115,208,13413,5363,2.80307e+13,169.763,1563.05,18776,151,138,16614,13884,9886,9126,12680
8707,49,190,6218,2489,2.80402e+13,164.953,1057.19,8707,125,115,6593,5360,2052,1542,2651
95176,79,346,67986,27190,2.8016e+13,173.161,3614.94,95176,289,175,78421,65381,32234,40472,47373
91087,319,483,65042,26045,2.8091e+13,173.266,3721.62,91087,280,193,90604,90591,84580,78056,86422
87454,157,481,62439,25015,2.81101e+13,173.244,3651.56,87454,274,195,84178,66546,55761,46084,71623
85264,23,328,60906,24358,2.80032e+13,173.103,3412.88,85264,271,175,54098,39457,14500,13421,15506
47398,91,260,33862,13536,2.79915e+13,172.345,2515.6,47398,203,175,40025,33062,18574,18059,26260
54203,239,272,38718,15485,2.80023e+13,172.581,2696.41,54203,215,175,53931,53931,52424,53167,53898
52393,171,477,37439,14954,2.77819e+13,171.121,2902.42,52393,211,175,51544,40477,45992,48859,50929
18685,91,208,13344,5341,2.80467e+13,169.903,1559.67,18685,151,138,15738,13009,7323,7147,10365
11465,118,195,8193,3272,2.80369e+13,167.161,1216.02,11465,135,125,10156,8463,6304,5578,7931
47253,189,260,33753,13500,2.80388e+13,172.347,2511.98,47253,203,175,46993,46993,42902,44975,46922
81463,270,322,58189,23274,2.80118e+13,173.07,3333.31,81463,265,175,81141,81141,78357,79758,81089
59090,279,800,42292,16798,2.68516e+13,216.42,3799.06,59090,775,180,57908,57389,54761,55759,56701
73295,614,800,52439,20856,2.70514e+13,217.232,4120.4,73295,798,175,72399,71999,66711,69573,71937
6459,52,185,4618,1841,2.79026e+13,161.591,908.029,6459,116,106,4933,4018,1584,2020,2304
39625,123,245,28306,11319,2.79892e+13,172.002,2292.57,39625,188,175,35730,29628,23764,20695,28612
80668,52,458,57603,23065,2.81045e+13,173.202,3496.92,80668,262,192,62102,50350,18573,14412,25501
85270,107,469,60890,24380,2.81118e+13,173.229,3597.23,85270,270,193,74535,62588,33300,25988,49926
19041,196,208,13604,5437,2.79585e+13,169.981,1574.21,19041,152,139,18833,18833,18633,18720,18821
57312,211,277,40946,16366,2.79818e+13,172.612,2774.67,57312,221,175,57035,57035,53240,55162,56969
58364,56,280,41683,16681,2.80203e+13,172.582,2802.01,58364,222,175,45513,37357,14731,17666,21429
7994,158,189,5714,2280,2.80753e+13,164.453,1013.2,7994,123,112,7584,6059,6886,7358,7150
21333,91,213,15237,6096,2.807e+13,170.348,1669.12,21333,156,142,17972,14860,8349,7106,11629
67491,402,800,48304,19187,2.69493e+13,214.895,3993.19,67491,793,180,66415,65776,62253,64214,65497
70906,141,303,50650,20256,2.80084e+13,172.923,3100.83,70906,246,175,66285,53548,51109,57098,58521
33774,221,800,24215,9559,2.58886e+13,209.619,3105.29,33774,760,160,32545,32120,30077,30655,31215
86709,252,330,61941,24768,2.79879e+13,173.12,3442.36,86709,274,175,86379,86379,81767,84109,86301
83729,226,325,59809,23920,2.79969e+13,173.029,3380.2,83729,268,175,83404,83404,77380,80450,83305
73418,200,306,52446,20972,2.79937e+13,172.927,3155.93,73418,250,175,73112,73112,66605,69924,73006
7255,60,187,5183,2072,2.7985e+13,163.122,963.529,7255,121,110,5667,4652,1951,1518,2627
95742,583,800,68474,27268,2.72856e+13,226.344,4569.64,95742,798,179,94788,94388,87152,90860,94291
28941,124,226,20680,8261,2.79787e+13,171.363,1950.71,28941,170,156,26126,21624,17599,16682,21110
25537,14,220,18242,7295,2.79866e+13,170.961,1829.64,25537,163,149,13471,9182,3876,2256,1723
33000,28,234,23565,9435,2.80318e+13,171.519,2087.18,33000,176,163,22122,16584,5637,4146,6251
86969,255,332,62121,24848,2.80176e+13,173.089,3449.22,86969,275,175,86637,86637,82151,84427,86560
73492,237,307,52492,21000,2.80114e+13,172.939,3158.46,73492,250,175,73185,73185,69160,71200,73115
72402,139,305,51711,20691,2.80112e+13,172.87,3133.92,72402,247,175,67441,54558,51677,52469,58383
1771,106,178,1265,506,2.81429e+13,130.985,473.644,1771,75,73,1455,1263,853,842,1057
84157,600,800,60207,23950,2.71669e+13,232.802,4345.44,84157,775,180,83296,82896,80919,81909,82757
1373,7,177,988,385,2.85095e+13,118.522,416.382,1373,63,68,533,213,147,110,55
9188,79,191,6566,2622,2.81199e+13,165.786,1087.09,9188,127,117,7500,6279,3116,2745,4382
9508,97,191,6796,2712,2.79583e+13,165.897,1105.51,9508,128,117,8080,6858,4016,3874,5530
5650,80,185,4038,1612,2.80597e+13,160.386,849.81,5650,113,104,4596,3896,1966,2024,2771
46590,243,258,33276,13314,2.79996e+13,172.277,2492.75,46590,201,175,46332,46332,46009,46149,46317
22034,155,214,15741,6293,2.80205e+13,170.522,1696.6,22034,157,143,21060,16728,18631,19797,19587
34397,23,236,24570,9827,2.79902e+13,171.709,2131.74,34397,179,166,21814,15917,5856,3670,5440
68658,183,298,49040,19618,2.79965e+13,172.86,3048.28,68658,241,175,68360,68360,61262,64884,68245
73333,52,306,52384,20949,2.80012e+13,172.886,3154.03,73333,249,175,56452,45741,17790,24007,26175
89112,253,335,63653,25459,2.80027e+13,173.121,3492.52,89112,278,175,88777,88777,83911,86384,88695
50721,68,265,36229,14492,2.79843e+13,172.413,2604.35,50721,209,175,40752,33642,14876,17642,22737
62928,257,800,45045,17883,2.6883e+13,234.806,3889.42,62928,796,175,61648,61221,53323,57025,60369
78876,155,317,56337,22539,2.80184e+13,172.965,3277.19,78876,260,175,75739,60010,66938,71187,70125
68679,100,298,49055,19624,2.80187e+13,172.825,3048.74,68679,241,175,59162,49892,30693,36028,41730
52009,122,268,37151,14858,2.80006e+13,172.471,2639.09,52009,212,175,46833,38808,30215,31977,37401
45053,82,255,32179,12874,2.79797e+13,172.18,2449.61,45053,198,175,37332,31349,15872,14799,22067
91123,661,800,65184,25939,2.72333e+13,226.032,4482.03,91123,798,175,90246,90055,82734,86470,89907
58952,137,281,42106,16846,2.80083e+13,172.729,2816.79,58952,224,175,54681,44405,40149,40052,46847
33548,146,235,23956,9592,2.80314e+13,171.546,2104.79,33548,177,164,31602,25383,25310,27878,28175
92645,168,342,66176,26469,2.80017e+13,173.196,3565.03,92645,285,175,91141,71477,81298,86938,88859
23605,59,217,16856,6749,2.80286e+13,170.723,1757.96,23605,160,146,18525,15139,6247,5989,8979
59340,271,282,42389,16951,2.80126e+13,172.729,2826.63,59340,225,175,59058,59058,58912,58974,59047
85424,35,328,61017,24407,2.79969e+13,173.062,3415.72,85424,271,175,60529,48193,16218,19155,22924
90687,235,338,64780,25907,2.8007e+13,173.139,3524.81,90687,281,175,90349,90349,84080,87275,90246
43238,11,253,30880,12358,2.80308e+13,172.141,2399.66,43238,195,175,20566,12674,6343,3605,4227
1078,89,176,772,306,2.79512e+13,102.838,368.526,1078,59,61,818,716,424,404,509
9918,159,192,7083,2835,2.80235e+13,166.318,1129.64,9918,129,120,9470,7538,8575,9167,8880
60338,234,283,43101,17237,2.80043e+13,172.677,2850.22,60338,226,175,60055,60055,57445,58757,60006
67623,82,296,48301,19322,2.7994e+13,172.812,3024.01,67623,239,175,56065,47056,23782,22179,33041
92036,116,340,65738,26298,2.80126e+13,173.106,3551.61,92036,283,175,81963,68205,48613,55277,63515
56371,231,276,40263,16108,2.80094e+13,172.567,2751.67,56371,218,175,56095,56095,53737,54921,56050
93296,192,343,66638,26658,2.80131e+13,173.143,3577.77,93296,286,175,92953,92953,83400,88285,92802
80811,145,320,57723,23088,2.80026e+13,173.037,3318.6,80811,263,175,76171,61042,60591,67133,68118
79891,545,800,57153,22738,2.71302e+13,221.003,4258.91,79891,795,180,78955,78555,75017,76823,78326
34637,144,237,24741,9896,2.80159e+13,171.851,2140.4,34637,180,166,32509,26130,25688,28476,28935
90602,117,337,64720,25882,2.79928e+13,173.151,3522.34,90602,281,175,80821,67135,49314,45915,62964
79695,119,318,56927,22768,2.80025e+13,172.99,3294.45,79695,261,175,71398,59196,44112,38685,55939
78374,208,316,55978,22396,2.80146e+13,173.032,3266.49,78374,259,175,78058,78058,71447,74817,77950
85222,340,478,60847,24375,2.81078e+13,173.25,3606.23,85222,270,192,84744,84744,81117,76892,82006
76134,298,311,54387,21747,2.79826e+13,172.967,3216.4,76134,255,175,75823,75823,75584,75686,75810
84291,66,800,60293,23998,2.72006e+13,250.803,4333.85,84291,766,175,66850,55376,23796,15724,698
69218,163,299,49445,19773,2.79999e+13,172.869,3061.18,69218,242,175,67443,53025,60572,64852,64808
31078,169,230,22195,8883,2.8012e+13,171.458,2023.29,31078,173,160,30524,24004,27462,29182,29878
41108,231,248,29365,11743,2.8007e+13,172.089,2336.65,41108,191,175,40860,40860,40426,40618,40843
35298,97,238,25219,10079,2.79978e+13,171.778,2160.65,35298,181,168,30171,25562,14890,14992,20640
87013,285,331,62159,24854,2.79986e+13,173.119,3449.12,87013,275,175,86682,86682,84248,85469,86636
77923,264,315,55660,22263,2.80069e+13,172.987,3256.32,77923,258,175,77608,77608,74858,76240,77557
78857,239,317,56324,22533,2.80144e+13,172.981,3276.9,78857,260,175,78540,78540,73955,76281,78462
82849,306,324,59183,23666,2.80088e+13,173.03,3362.23,82849,267,175,82525,82525,82046,82258,82507
47386,258,800,33932,13454,2.65279e+13,215.865,3502.92,47386,798,175,46147,45707,40558,42843,44900
65909,68,293,47080,18829,2.79999e+13,172.798,2984.04,65909,236,175,52972,43719,19319,16842,27541
68366,451,800,48919,19447,2.69772e+13,222.119,4012.75,68366,798,175,67294,66649,60252,63699,66519
94726,845,950,67723,27003,2.73478e+13,232.369,4744.36,94726,800,195,93776,93776,85303,89471,93462
55262,233,274,39474,15788,2.8011e+13,172.583,2723.56,55262,217,175,54988,54988,52916,53950,54947
27717,82,224,19801,7916,2.80104e+13,171.12,1907.81,27717,167,153,22947,19267,9732,9714,14091
46631,106,258,33308,13323,2.80051e+13,172.261,2493.75,46631,201,175,40656,34205,22296,20802,29549
16348,42,204,11676,4672,2.80427e+13,169.217,1456.93,16348,147,133,12084,9565,3519,2611,4393
12620,115,197,9010,3610,2.8037e+13,167.689,1276.49,12620,139,126,11126,9320,6667,7494,8630
79522,295,318,56803,22719,2.80174e+13,173.002,3291.09,79522,261,175,79204,79204,78377,78770,79181
92877,58,342,66343,26534,2.80091e+13,173.156,3569.11,92877,285,175,72869,59609,24357,27899,35335
39237,228,244,28029,11208,2.79933e+13,171.98,2280.74,39237,188,175,38993,38993,38596,38769,38977
73251,74,307,52320,20931,2.80248e+13,172.924,3153.47,73251,250,175,59685,48989,23715,19643,33149
87495,264,332,62503,24992,2.79956e+13,173.143,3459.32,87495,276,175,87163,87163,83237,85227,87095
99558,97,354,71107,28451,2.80118e+13,173.204,3701.3,99558,297,175,85275,72161,41971,35701,57431
52199,38,268,37282,14917,2.7985e+13,172.482,2643.7,52199,211,175,37822,29631,10933,12000,13586
51798,196,268,37002,14796,2.80249e+13,172.515,2634.08,51798,211,175,51530,51530,47371,49479,51458
82151,156,323,58681,23470,2.8012e+13,173.063,3347.81,82151,266,175,79035,62493,70025,74302,74045
56466,125,276,40332,16134,2.80021e+13,172.61,2753.89,56466,219,175,51180,42438,34445,28427,41229
78703,175,316,56210,22493,2.80174e+13,172.948,3272.91,78703,259,175,78387,78387,69532,74057,78246
84499,161,327,60354,24145,2.80085e+13,173.048,3397.01,84499,270,175,82058,64593,73874,79164,77582
86614,68,331,61867,24747,2.80105e+13,173.107,3441.55,86614,274,175,69635,57454,25332,27591,37223
64452,143,431,46016,18436,2.81369e+13,172.969,3132.47,64452,247,187,60416,48697,41479,39707,50879
42175,339,800,30218,11957,2.6337e+13,218.394,3358.68,42175,733,179,41075,40506,39485,39803,39992
77283,95,314,55211,22072,2.79928e+13,173.023,3242.54,77283,257,175,65871,54196,31879,32184,44065
94881,480,491,67754,27127,2.80941e+13,173.329,3798.78,94881,288,194,94390,94390,94234,94302,94379
47654,153,260,34035,13619,2.80392e+13,172.253,2522.13,47654,203,175,45524,36068,39118,41260,42102
44752,104,255,31966,12786,2.80075e+13,172.194,2441.98,44752,198,175,38831,32826,20689,24286,27938
85479,219,329,61054,24425,2.80168e+13,173.122,3418.05,85479,272,175,85150,85150,78405,81845,85040
46313,82,258,33077,13236,2.80181e+13,172.275,2485.67,46313,201,175,38389,32216,16287,16624,23380
37318,58,800,26742,10576,2.61389e+13,208.544,3216.08,37318,772,167,28579,23572,9202,7844,12423
27304,207,223,19504,7800,2.79802e+13,171.158,1893.19,27304,167,153,27081,27081,26692,26863,27065
5504,113,184,3932,1572,2.80114e+13,160.026,838.055,5504,110,103,4771,4038,2865,2759,3599
81541,50,321,58244,23297,2.79919e+13,173.022,3333.81,81541,264,175,62329,50413,20348,21247,26290
55171,167,274,39409,15762,2.80061e+13,172.61,2721.49,55171,217,175,54113,42548,48433,51739,52497
20825,191,212,14879,5946,2.80583e+13,170.331,1648.62,20825,155,141,20613,20613,19922,20245,20592
68495,194,298,48922,19573,2.80138e+13,172.799,3044.77,68495,240,175,68197,68197,61827,65076,68093
74697,285,309,53355,21342,2.80063e+13,172.945,3185.11,74697,252,175,74388,74388,73472,73911,74364
42560,247,251,30397,12163,2.80142e+13,172.15,2379.35,42560,194,175,42309,42309,42286,42292,42305
77572,290,314,55413,22159,2.79957e+13,172.993,3248.23,77572,257,175,77258,77258,76341,76781,77234
16386,104,204,11703,4683,2.80807e+13,169.298,1458.74,16386,147,133,14160,11989,7545,6644,10014
12749,88,197,9107,3642,2.80294e+13,167.637,1283.01,12749,140,127,10644,8884,4924,6185,6898
3565,124,181,2540,1025,2.83578e+13,152.064,673.571,3565,98,93,3129,2624,2144,2216,2575
32196,147,232,22994,9202,2.80014e+13,171.535,2060.35,32196,175,162,30396,24356,24442,25486,27296
8958,166,190,6401,2557,2.79147e+13,165.227,1072.15,8958,125,116,8642,6871,7969,8359,8291
21213,145,212,15148,6065,2.80232e+13,170.118,1663.33,21213,155,142,19892,15999,15869,17563,17786
92477,107,342,66051,26426,2.80115e+13,173.164,3561.78,92477,285,175,80847,67859,44672,51004,59475
48505,780,800,34741,13764,2.65545e+13,212.016,3532.4,48505,771,175,47705,47551,46039,46777,47646
86607,185,331,61861,24746,2.80128e+13,173.137,3441.49,86607,274,175,86276,86276,77081,81781,86130
36060,137,240,25751,10309,2.8027e+13,171.827,2185.14,36060,183,169,33388,27148,24554,25977,28760
15254,201,202,10898,4356,2.80786e+13,168.96,1406.49,15254,145,131,15052,15052,15052,15052,15051
95368,396,800,68211,27157,2.72701e+13,223.78,4562.72,95368,798,180,94253,93602,87857,90959,93332
33323,184,234,23807,9516,2.79882e+13,171.737,2097.5,33323,178,164,33089,33089,30389,31748,33039
83191,269,470,59396,23795,2.81187e+13,173.19,3559.08,83191,277,192,82721,82601,75294,73287,78942
41011,560,800,29382,11629,2.63018e+13,219.494,3325.09,41011,797,173,40075,39741,35174,37474,39491
47110,175,260,33647,13463,2.80432e+13,172.235,2508.25,47110,202,175,46850,46850,41813,44371,46765
46936,10,259,33524,13412,2.80182e+13,172.347,2502.98,46936,202,175,21465,11626,6453,3821,4367
15095,4,201,10784,4311,2.79731e+13,168.908,1398.44,15095,144,131,3945,1193,869,1063,896
68180,271,297,48703,19477,2.79987e+13,172.873,3037.24,68180,240,175,67883,67883,66817,67336,67857
99065,182,353,70759,28306,2.8002e+13,173.208,3691.7,99065,296,175,98712,98712,87817,93392,98541
81427,318,321,58169,23258,2.79965e+13,173.072,3331.79,81427,265,175,81106,81106,81092,81095,81103
2578,90,179,1839,739,2.82367e+13,143.206,570.743,2578,90,83,2101,1766,1026,1019,1361
19933,114,210,14236,5697,2.80284e+13,169.975,1611.45,19933,153,140,17590,14745,10424,11645,13467
18247,202,207,13035,5212,2.80023e+13,169.619,1540.54,18247,150,137,18040,18040,18008,18015,18035
93571,227,343,66841,26730,2.79969e+13,173.184,3582.97,93571,287,175,93228,93228,86036,89705,93112
39643,56,246,28311,11332,2.80227e+13,171.906,2293.87,39643,188,175,30899,25376,10020,11999,14506
93897,157,344,67069,26828,2.80122e+13,173.183,3589.83,93897,287,175,90529,71438,82070,85110,85010
1964,141,178,1402,562,2.86046e+13,134.18,498.332,1964,75,78,1718,1439,1375,1502,1482
72267,125,305,51619,20648,2.80148e+13,172.936,3131.2,72267,248,175,65512,54320,44078,44825,53563
53954,315,800,38609,15345,2.69755e+13,219.676,3559.29,53954,512,175,53140,52696,52285,51945,52127
1480,130,176,1063,417,2.67321e+13,121.095,430.335,1480,70,65,1246,1076,939,879,1058
50203,196,265,35862,14341,2.80038e+13,172.465,2591.67,50203,208,175,49938,49938,45965,47976,49869
24770,176,219,17688,7082,2.8029e+13,170.921,1801.61,24770,162,149,24551,24551,22362,23457,24508
15886,179,203,11350,4536,2.80074e+13,169.228,1435.88,15886,146,132,15683,15683,14773,15210,15659
50404,248,265,36006,14398,2.80207e+13,172.441,2596.57,50404,208,175,50139,50139,49720,49903,50122
57797,284,421,41267,16530,2.81465e+13,172.866,2972.72,57797,237,177,57376,57256,55449,54746,56001
35869,75,238,25628,10241,2.79799e+13,171.829,2177.66,35869,182,169,29243,24175,11882,14988,17069
27428,15,224,19592,7836,2.80489e+13,171.221,1898.52,27428,167,153,14871,10270,4325,3482,3739
63831,161,289,45593,18238,2.80116e+13,172.703,2934.5,63831,232,175,61952,48789,55791,59772,58856
80030,429,460,57143,22887,2.8135e+13,173.136,3485.81,80030,261,193,79570,79570,78377,78957,79539
78888,126,317,56346,22542,2.80195e+13,173.041,3277.65,78888,260,175,71662,59295,48455,42536,58588
50853,28,266,36323,14530,2.8003e+13,172.457,2608.76,50853,209,175,34095,25559,8659,9301,10796
86290,672,800,61721,24569,2.72069e+13,222.087,4387.9,86290,798,180,85470,85269,81127,83238,85107
46932,154,259,33523,13409,2.80146e+13,172.371,2502.85,46932,202,175,44930,35516,39541,41139,41377
82776,384,462,59109,23667,2.81015e+13,173.187,3542.12,82776,265,193,82314,82314,77971,80187,81868
55806,225,275,39860,15946,2.80104e+13,172.538,2737.33,55806,217,175,55531,55531,52833,54192,55481
64099,5,290,45785,18314,2.80064e+13,172.806,2941.6,64099,233,175,19932,7071,4292,4755,5064
27915,100,225,19939,7976,2.80084e+13,171.317,1915.62,27915,168,154,23991,20251,12464,10230,16626
77497,743,800,55445,22052,2.71089e+13,223.365,4209.5,77497,798,175,76697,76461,70079,73402,76527
51302,208,267,36642,14660,2.80187e+13,172.508,2620.9,51302,210,175,51035,51035,47745,49407,50976
54271,24,272,38768,15503,2.80061e+13,172.579,2697.99,54271,216,175,34916,25603,9226,6301,9413
95593,94,800,68377,27216,2.72648e+13,237.931,4566.65,95593,798,175,80556,66359,37909,38609,53146
85908,327,800,61457,24451,2.71951e+13,232.193,4380.13,85908,778,180,84771,84159,81480,82578,83661
2166,148,178,1544,622,2.76911e+13,138.724,523.194,2166,81,78,1911,1593,1591,1572,1738
30535,176,367,21826,8709,2.77078e+13,169.979,2172.01,30535,172,159,30168,30168,27257,28622,29983
24495,7,218,17496,6999,2.80219e+13,170.774,1790.74,24495,161,148,9473,3812,2659,1511,1058
39363,231,245,28122,11241,2.79931e+13,172.059,2285.38,39363,188,174,39118,39118,38838,38961,39104
80424,53,320,57439,22985,2.80236e+13,172.99,3310.96,80424,262,175,62126,51040,19676,18809,28070
94794,130,492,67686,27108,2.80961e+13,173.284,3798.69,94794,303,177,86718,71457,57774,57158,70979
77580,725,800,55507,22073,2.70835e+13,221.075,4210.84,77580,798,175,76780,76544,70368,73540,76556
92475,154,341,66049,26426,2.80075e+13,173.15,3560.82,92475,284,175,88656,70023,77981,74512,82098
71691,496,800,51300,20391,2.70281e+13,238.662,4085.82,71691,733,179,70748,70365,69507,69918,69979
87485,313,332,62491,24994,2.80004e+13,173.101,3459.03,87485,275,175,87153,87153,86567,86838,87134
20676,149,212,14769,5907,2.80699e+13,170.202,1642.79,20676,155,141,19528,15619,15905,17255,17656
4280,101,182,3056,1224,2.78961e+13,155.747,737.511,4280,103,96,3603,3082,1945,1837,2520
89766,133,942,64181,25585,2.73406e+13,233.226,4640.57,89766,783,198,81670,66986,47435,33470,60837
82292,208,323,58780,23512,2.79965e+13,173.06,3350.45,82292,266,175,81969,81969,74901,78507,81854
31718,180,231,22655,9063,2.79839e+13,171.572,2044.74,31718,174,161,31487,31487,28721,30115,31436
5162,77,184,3678,1484,2.83401e+13,158.224,811.483,5162,109,103,4178,3514,1768,2409,2508
45609,718,800,32670,12939,2.64656e+13,208.705,3454.74,45609,784,175,44809,44613,42086,43355,44564
88302,129,800,63165,25137,2.72088e+13,226.749,4427.36,88302,798,175,79781,65864,53941,53828,65549
61500,793,800,44021,17479,2.68571e+13,218.223,3856.01,61500,772,180,60700,60551,60210,60442,60680
55930,182,275,39948,15982,2.80037e+13,172.597,2740.31,55930,218,175,55655,55655,50043,52900,55562
37169,232,242,26552,10617,2.80127e+13,171.942,2219.63,37169,185,171,36927,36927,36808,36857,36917
28847,24,226,20608,8239,2.80064e+13,171.226,1947.28,28847,169,156,18559,13613,4921,3136,4812
90498,297,338,64645,25853,2.80172e+13,173.15,3521.38,90498,281,175,90160,90160,88109,89132,90119
9274,87,191,6630,2644,2.79045e+13,165.747,1091.71,9274,127,117,7693,6449,3531,3398,4804
23537,76,217,16808,6729,2.80557e+13,170.729,1755.19,23537,160,146,19210,15978,7835,5719,10595
71084,273,303,50770,20314,2.80195e+13,172.812,3104.3,71084,245,175,70781,70781,69457,70106,70751
39069,74,245,27905,11164,2.80236e+13,171.994,2276.88,39069,188,174,31808,26117,12650,9590,17653
27058,183,223,19333,7725,2.80161e+13,171.133,1884.7,27058,166,153,26835,26835,24852,25840,26795
86957,50,331,62106,24851,2.80167e+13,173.081,3448.01,86957,274,175,66472,53768,20784,25338,29699
40040,165,247,28591,11449,2.80473e+13,172.014,2306.08,40040,190,175,39083,30725,35089,37493,37680
17992,618,800,12942,5050,2.41342e+13,219.982,2513.15,17992,767,132,17156,16763,15306,16187,16646
97580,162,350,69701,27879,2.79952e+13,173.174,3662.1,97580,293,175,94966,74776,85361,81682,90283
57000,259,277,40717,16283,2.80091e+13,172.629,2767.41,57000,220,175,56723,56723,56221,56448,56705
35670,192,238,25486,10184,2.79702e+13,171.843,2171.9,35670,182,169,35432,35432,33004,34223,35386
91224,269,339,65157,26067,2.80073e+13,173.143,3535.79,91224,282,175,90885,90885,86839,88889,90815
84518,254,327,60375,24143,2.80105e+13,173.048,3397.4,84518,270,175,84191,84191,79972,82109,84118
63639,179,289,45456,18183,2.80031e+13,172.786,2930.42,63639,232,175,63350,63350,56585,60035,63240
50889,114,267,36346,14543,2.80137e+13,172.393,2610.52,50889,209,175,45071,37697,26605,29725,34343
86293,12,330,61637,24656,2.8007e+13,173.068,3434.31,86293,273,175,42593,26992,12795,7180,5560
27781,103,224,19836,7945,2.80372e+13,171.116,1910.24,27781,167,154,24034,20360,12602,15037,17329
61917,226,286,44230,17687,2.79996e+13,172.744,2888.97,61917,229,175,61631,61631,58303,59984,61571
20341,177,211,14519,5822,2.80545e+13,169.938,1628.26,20341,153,140,20130,20130,18528,19321,20096
58477,272,279,41765,16712,2.80047e+13,172.559,2803.62,58477,222,175,58198,58198,58127,58154,58191
27649,172,224,19750,7899,2.80029e+13,171.204,1905.74,27649,167,153,27281,21643,24612,26033,27028
35242,61,238,25171,10071,2.80183e+13,171.726,2158.89,35242,181,167,27844,22803,9510,7692,13407
51051,68,266,36473,14578,2.79882e+13,172.497,2613.69,51051,210,175,41011,33857,14923,13881,21909
1001,117,176,713,288,2.84142e+13,96.6543,354.153,1001,60,61,791,703,522,543,626
22202,6,214,15866,6336,2.79733e+13,170.565,1703.2,22202,157,143,7821,2963,1964,1645,667
62871,103,287,44911,17960,2.79756e+13,172.741,2911.31,62871,231,175,54479,46128,28458,28245,38618
91328,200,489,65211,26117,2.81002e+13,173.256,3731.91,91328,281,192,90839,90701,74361,67919,85704
23757,64,217,16968,6789,2.80033e+13,170.627,1763.06,23757,160,147,18886,15661,6573,6917,9417
83988,227,325,59998,23990,2.79961e+13,173.051,3385.37,83988,269,175,83663,83663,77692,80734,83565
32931,2,234,23520,9411,2.80307e+13,171.626,2085.26,32931,177,163,4409,837,717,1729,371
27464,3,224,19613,7851,2.80429e+13,171.248,1899.62,27464,167,153,5760,1291,1195,1489,463
31281,201,231,22339,8942,2.80373e+13,171.561,2030.97,31281,174,160,31050,31050,29745,30385,31020
91495,254,340,65360,26135,2.80058e+13,173.182,3541.8,91495,283,175,91155,91155,86060,88650,91069
82224,24,323,58733,23491,2.80077e+13,173.059,3349.2,82224,266,175,52913,38804,13990,8922,13949
82610,227,323,59007,23603,2.7991e+13,173.016,3356.55,82610,266,175,82287,82287,76470,79432,82191
3655,61,181,2609,1046,2.80441e+13,153.369,681.983,3655,98,92,2827,2338,1000,1123,1403
27575,121,224,19697,7878,2.80066e+13,171.146,1903.19,27575,167,153,24754,20505,15644,14628,19697
23513,94,216,16803,6710,2.79525e+13,170.681,1753.24,23513,159,146,19948,16431,9507,9787,13412
33078,212,234,23624,9454,2.80125e+13,171.466,2089.59,33078,176,163,32844,32844,32050,32429,32822
15632,73,202,11165,4467,2.7976e+13,168.883,1423.14,15632,145,132,12660,10409,4993,5212,7181
75253,693,800,53850,21403,2.70622e+13,223.439,4162.13,75253,798,175,74417,74197,67571,70958,74133
8125,79,189,5804,2321,2.79862e+13,164.622,1021.03,8125,123,113,6620,5552,2773,2832,3941
8134,100,189,5808,2326,2.80768e+13,164.116,1021.05,8134,123,113,6932,5883,3655,3450,4870
69293,209,299,49494,19799,2.80102e+13,172.869,3062.71,69293,242,175,68994,68994,63596,66343,68904
44136,154,253,31528,12608,2.79932e+13,172.18,2423.69,44136,197,175,42248,33401,37173,38683,38977
19454,172,209,13900,5554,2.7973e+13,170.035,1591.79,19454,153,138,19146,15205,17441,18344,18931
82451,145,323,58895,23556,2.80023e+13,173.079,3353.74,82451,266,175,77718,62276,61813,68489,69435
9585,101,192,6845,2740,2.81158e+13,165.78,1110.54,9585,129,118,8209,6951,4316,4105,5813
71122,188,302,50797,20325,2.80085e+13,172.831,3104.15,71122,245,175,70820,70820,63778,67371,70706
30555,38,229,21829,8726,2.79892e+13,171.467,2005.99,30555,172,158,22122,17335,5996,7692,8320
76631,208,800,54784,21847,2.75053e+13,231.052,3929.81,76631,505,175,75777,75623,65939,48600,1094
24610,131,219,17574,7036,2.80682e+13,170.81,1795.64,24610,162,148,22499,18513,15570,15714,18954
73978,117,308,52843,21135,2.80121e+13,172.923,3169.33,73978,251,175,66014,54810,40268,37482,51922
53521,191,271,38221,15300,2.8025e+13,172.462,2678.63,53521,213,175,53250,53250,48520,50923,53170
60173,436,800,43069,17104,2.68339e+13,213.724,3824.72,60173,798,175,59110,58471,53630,56271,58281
62954,259,288,44963,17991,2.80171e+13,172.718,2914.02,62954,231,175,62666,62666,61404,62022,62637
70848,175,302,50605,20243,2.80095e+13,172.876,3098.47,70848,245,175,70546,70546,62620,66668,70419
31802,76,232,22713,9089,2.80341e+13,171.514,2048.31,31802,175,161,25985,21601,10601,10794,15135
15083,176,201,10772,4311,2.79581e+13,168.611,1397.19,15083,144,131,14882,14882,13898,14372,14857
90931,148,338,64956,25975,2.79953e+13,173.161,3529.45,90931,282,175,86207,68852,69483,72277,78028
11711,69,195,8360,3351,2.79891e+13,167.236,1228.95,11711,135,125,9386,7754,3504,4145,5309
84044,102,326,60030,24014,2.80076e+13,173.041,3387.4,84044,269,175,72709,61370,37896,45140,51948
3504,149,181,2503,1001,2.82486e+13,151.708,667.367,3504,98,90,3193,2608,2641,2845,2935
60203,75,283,43006,17197,2.8018e+13,172.687,2847.24,60203,226,175,49146,40585,19947,18992,28393
31217,64,231,22292,8925,2.80408e+13,171.393,2028.79,31217,173,160,24840,20592,8606,10037,12890
43116,122,252,30799,12317,2.79926e+13,172.166,2395.34,43116,195,175,38794,32163,25010,22429,30932
85907,97,800,61459,24448,2.71806e+13,222.754,4379.93,85907,798,180,72740,61671,35501,39532,49338
86567,15,331,61838,24729,2.80144e+13,173.11,3440.62,86567,274,175,46959,32406,13632,8458,11156
13968,74,199,9982,3986,2.79621e+13,168.472,1344.29,13968,142,128,11325,9318,4522,4676,6400
91556,36,340,65393,26163,2.80056e+13,173.186,3542.96,91556,283,175,65361,51799,17905,16890,22571
51062,208,800,36558,14504,2.66421e+13,209.709,3599.52,51062,793,175,49782,49376,45266,46862,48384
91575,325,339,65405,26170,2.80106e+13,173.087,3542.11,91575,282,175,91236,91236,90961,91081,91222
1250,127,177,888,362,2.94e+13,107.603,395.623,1250,65,68,1025,902,755,801,887
42740,219,251,30525,12215,2.80182e+13,172.092,2384.3,42740,194,175,42489,42489,41041,41755,42457
28218,112,225,20156,8062,2.8012e+13,171.181,1925.61,28218,168,155,24872,20836,14593,13280,18688
76549,311,313,54681,21868,2.80222e+13,172.976,3226.78,76549,256,175,76236,76236,76233,76232,76234
6039,12,184,4316,1723,2.79314e+13,160.472,877.076,6039,114,106,2970,1880,900,626,763
49152,156,263,35109,14043,2.79924e+13,172.464,2563.35,49152,206,175,47225,37368,41838,41062,44178
84658,84,327,60470,24188,2.80074e+13,173.073,3400.17,84658,270,175,70508,58913,30035,24232,42897
4784,161,183,3410,1374,2.81365e+13,156.925,780.573,4784,106,100,4503,3617,4099,4349,4266
3325,28,180,2377,948,2.80328e+13,150.438,649.468,3325,95,88,2208,1662,583,532,556
99905,305,355,71356,28549,2.80118e+13,173.17,3708.4,99905,297,175,99550,99550,96862,98214,99500
95108,251,346,67933,27175,2.80079e+13,173.157,3613.79,95108,289,175,94762,94762,89035,91950,94667
86659,308,331,61902,24757,2.80155e+13,173.124,3442.49,86659,274,175,86328,86328,85500,85894,86305
50648,212,266,36180,14468,2.79968e+13,172.516,2603.73,50648,209,175,50382,50382,47465,48933,50328
53526,41,271,38236,15290,2.80014e+13,172.511,2678.88,53526,214,175,39458,31056,11267,8936,14527
41779,757,800,29932,11847,2.63271e+13,215.46,3347.68,41779,747,175,40979,40835,40120,40443,40851
24939,136,219,17814,7125,2.80028e+13,170.892,1807.51,24939,162,148,23028,18763,16891,17908,19752
71848,291,304,51320,20528,2.80096e+13,172.887,3121.45,71848,247,175,71544,71544,71309,71410,71531
55401,256,344,39560,15841,2.80626e+13,171.757,2812.99,55401,220,175,55057,55057,54575,54770,54928
19129,184,209,13656,5473,2.80362e+13,169.607,1578.18,19129,151,138,18920,18920,17935,18410,18895
85984,147,329,61423,24561,2.7993e+13,173.061,3427.41,85984,272,175,81369,65114,65401,68184,72705
80358,251,320,57388,22970,2.80256e+13,172.984,3309.61,80358,262,175,80038,80038,76081,78086,79969
11435,36,194,8165,3270,2.79876e+13,166.838,1213.39,11435,133,124,8143,6469,2331,2411,2416
23144,125,216,16535,6609,2.80331e+13,170.535,1739.7,23144,159,146,20907,17371,14116,11692,16938
80550,275,320,57534,23016,2.80164e+13,173.024,3313.33,80550,263,175,80230,80230,77892,79064,80185
98564,375,951,70462,28102,2.73872e+13,247.211,4817.41,98564,814,196,97207,96643,85950,71908,84822
73754,142,307,52681,21073,2.80094e+13,172.915,3163.88,73754,250,175,69097,55710,53974,59680,60621
93465,147,343,66762,26703,2.80046e+13,173.132,3580.88,93465,286,175,88432,70778,71103,77990,79249
93895,162,343,67075,26820,2.79978e+13,173.174,3588.84,93895,287,175,91374,71943,82142,88004,87207
62330,217,287,44515,17815,2.80197e+13,172.697,2899.15,62330,229,175,62043,62043,57997,60047,61973
91811,11,340,65582,26229,2.80092e+13,173.137,3547.53,91811,283,175,43659,26893,13448,9310,7776
68171,208,298,48690,19481,2.80354e+13,172.796,3037.85,68171,240,175,67873,67873,62494,65228,67783
53944,26,271,38526,15418,2.80063e+13,172.48,2689,53944,214,175,35589,26140,9197,9674,8501
8006,56,189,5719,2287,2.81387e+13,164.315,1013.77,8006,123,113,6192,5109,2034,1525,2660
7427,19,188,5299,2128,2.81903e+13,163.439,975.759,7427,121,111,4392,3144,1273,742,719
30182,47,229,21562,8620,2.80039e+13,171.511,1994.12,30182,172,158,22792,18256,6975,8305,9605
10163,56,192,7256,2907,2.78744e+13,166.317,1143.07,10163,129,120,7881,6486,2583,2797,3674
27800,93,224,19859,7941,2.79824e+13,171.108,1910.53,27800,167,154,23560,19431,11102,10977,15621
3586,104,181,2565,1021,2.81131e+13,152.467,675.438,3586,98,90,3032,2594,1659,1567,2149
20548,70,211,14679,5869,2.7998e+13,170.264,1636.98,20548,154,140,16544,13650,6146,5691,9026
88572,231,334,63267,25305,2.80033e+13,173.107,3481.36,88572,277,175,88238,88238,81945,85152,88135
55680,768,800,39856,15824,2.67487e+13,232.647,3716.16,55680,790,175,54880,54669,48441,46346,50493
25322,62,220,18087,7235,2.80241e+13,170.937,1821.88,25322,163,149,20042,16420,6872,6551,10089
47712,42,260,34078,13634,2.80051e+13,172.333,2523.59,47712,203,175,35340,27939,10275,7246,12960
32039,90,232,22886,9153,2.79893e+13,171.548,2055.64,32039,175,162,26976,22342,12531,11459,17119
34105,114,235,24363,9742,2.7945e+13,171.678,2122.01,34105,179,166,30183,25253,17889,17117,22836
42151,218,250,30109,12042,2.80021e+13,172.162,2367.31,42151,193,175,41901,41901,40427,41156,41869
12738,92,197,9099,3639,2.79873e+13,167.864,1282.74,12738,140,126,10737,8862,5014,4234,6919
68944,358,438,49223,19721,2.81458e+13,173.036,3236.71,68944,241,193,68506,68506,63988,66281,68426
40930,160,248,29232,11698,2.80084e+13,172.073,2331.78,40930,191,175,39602,31264,35728,38274,37625
28686,126,226,20486,8200,2.80214e+13,171.317,1942.38,28686,169,156,25999,21534,17607,14525,21038
68264,133,298,48759,19505,2.80323e+13,172.847,3039.84,68264,241,175,62842,51431,44175,46639,53258
37197,139,241,26571,10626,2.79841e+13,171.836,2219.24,37197,184,171,34600,28013,26521,26333,29848
37271,65,241,26629,10642,2.79776e+13,171.954,2221.79,37271,185,171,29720,24573,10298,11665,15348
44304,100,254,31648,12656,2.80047e+13,172.238,2429.06,44304,197,175,38150,32173,19795,16240,26307
49727,92,264,35518,14209,2.80114e+13,172.414,2578.76,49727,207,175,42111,34684,19544,19047,27792
19602,73,209,14006,5596,2.797e+13,169.945,1597.46,19602,152,139,15882,13059,6286,5575,9033
49093,169,263,35068,14025,2.80031e+13,172.386,2561.72,49093,206,175,48308,37943,43237,46093,47410
2179,86,178,1555,624,2.80436e+13,137.142,524.52,2179,85,77,1745,1495,827,837,1080
45258,297,406,32302,12956,2.82231e+13,172.539,2647.18,45258,214,180,44852,44734,42349,41618,43675
88367,119,334,63121,25246,2.79934e+13,173.128,3477.55,88367,277,175,79148,65636,48896,45414,61715
1400,122,177,1003,397,2.86633e+13,118.878,420.376,1400,63,69,1168,1002,788,765,938
68123,109,355,48660,19463,2.80386e+13,172.471,3107.42,68123,240,178,59777,50087,26704,27007,23369
23418,2,216,16729,6689,2.79698e+13,170.575,1749.63,23418,159,146,3132,592,509,1226,262
45826,29,257,32740,13086,2.80055e+13,172.31,2472.08,45826,200,175,30968,23358,7786,9783,9562
31874,205,231,22759,9115,2.80193e+13,171.4,2049.2,31874,174,161,31643,31643,30585,31098,31617
23694,103,217,16918,6776,2.80302e+13,170.597,1760.57,23694,160,146,20495,17366,10748,10671,14791
24058,211,218,17186,6872,2.79864e+13,170.927,1775.33,24058,161,148,23840,23840,23785,23804,23833
49556,131,264,35401,14155,2.80285e+13,172.436,2574.38,49556,207,175,45420,37323,31321,29574,38202
45341,14,256,32386,12955,2.80101e+13,172.231,2458.34,45341,199,175,23930,16312,6888,4355,5504
85401,44,473,60978,24423,2.81066e+13,173.222,3604.7,85401,270,192,63916,50508,18994,12564,22956
2914,176,179,2087,827,2.78788e+13,148.171,607.835,2914,93,84,2735,2735,2720,2723,2732
33835,195,235,24168,9667,2.80058e+13,171.644,2113.79,33835,178,165,33600,33600,31590,32593,33560
45212,217,256,32293,12919,2.80246e+13,172.295,2455.08,45212,199,175,44956,44956,43039,43994,44917
76747,22,800,54910,21837,2.70986e+13,219.258,4193.78,76747,798,175,47707,34268,12884,8333,12533
23795,58,217,17001,6794,2.80119e+13,170.698,1764.49,23795,160,147,18630,15255,6093,9039,9118
29547,328,800,21194,8353,2.56371e+13,219.593,2965.38,29547,789,153,28395,27900,24053,25849,27330
75964,178,312,54263,21701,2.80081e+13,173.012,3214.1,75964,255,175,75652,75652,67298,71564,75518
76152,215,454,54373,21779,2.81145e+13,173.125,3403.89,76152,253,192,75698,75575,58670,44429,67814
24004,334,800,17233,6771,2.5105e+13,215.488,2763.93,24004,778,143,22874,22367,19626,20863,21806
83948,258,325,59962,23986,2.80045e+13,173.014,3384.47,83948,268,175,83623,83623,79769,81723,83556
46355,17,258,33117,13238,2.80018e+13,172.296,2486.7,46355,201,175,26311,18683,7795,6698,4630
42444,128,250,30318,12126,2.79946e+13,172.085,2375.26,42444,193,175,38657,31894,26394,26569,31692
96495,329,497,68904,27591,2.80911e+13,173.337,3834.54,96495,291,195,95998,95998,85572,90920,94986
68771,708,800,49214,19557,2.69944e+13,237.714,4021.73,68771,798,175,67933,67698,60063,63998,67696
54624,162,273,39019,15605,2.80056e+13,172.547,2707.3,54624,216,175,53090,41832,47774,48814,50838
88479,206,483,63181,25298,2.80836e+13,173.254,3672.83,88479,276,196,87996,87868,68978,56293,80325
63384,183,289,45272,18112,2.80136e+13,172.804,2925.01,63384,232,175,63095,63095,56620,59920,62989
50221,399,800,35963,14258,2.6592e+13,213.702,3577.61,50221,798,175,49125,48537,43818,46395,48218
48545,168,262,34668,13877,2.80176e+13,172.442,2547.18,48545,205,175,47681,37429,42695,45548,46319
1798,45,177,1283,515,2.78787e+13,130.253,475.623,1798,80,75,1314,1058,416,427,558
85189,353,477,60819,24370,2.81055e+13,173.184,3604.46,85189,269,196,84712,84712,79663,78120,82606
65269,99,292,46621,18648,2.80092e+13,172.781,2969.12,65269,235,175,56114,47298,28349,26745,38912
46225,36,258,33018,13207,2.80349e+13,172.333,2483.58,46225,201,175,32985,26148,8969,8971,11393
80716,371,465,57626,23090,2.81244e+13,173.193,3505.72,80716,262,192,80251,80251,76306,75109,79259
93924,294,484,67073,26851,2.80895e+13,173.3,3774.05,93924,286,192,93440,93325,85307,80246,87378
23705,715,800,17019,6686,2.51246e+13,212.247,2752.26,23705,763,142,22905,22727,21410,22062,22651
18556,173,208,13251,5305,2.80672e+13,169.848,1554.27,18556,151,137,18284,14535,16707,17522,18119
99639,185,354,71170,28469,2.8006e+13,173.193,3702.63,99639,297,175,99285,99285,88508,94023,99116
27223,5,224,19445,7778,2.80169e+13,171.148,1891.26,27223,167,153,8472,3007,1827,2029,2017
15036,4,201,10738,4298,2.80831e+13,168.603,1395.38,15036,144,131,3947,1203,872,1038,355
44530,6,255,31803,12727,2.8027e+13,172.23,2436.06,44530,198,175,15701,5970,3947,2655,1308
73017,586,800,52247,20770,2.70444e+13,219.883,4114.72,73017,787,180,72130,71730,68894,70322,71575
91132,210,339,65092,26040,2.80093e+13,173.147,3534.13,91132,282,175,90793,90793,82748,86857,90664
16436,44,204,11740,4696,2.80638e+13,169.344,1461.01,16436,147,134,12259,9705,3744,4096,4952
70790,279,302,50565,20225,2.80086e+13,172.865,3097.39,70790,245,175,70488,70488,69616,70033,70465
31175,173,230,22271,8904,2.79745e+13,171.491,2026.6,31175,173,160,30837,24465,27775,29379,30567
75336,90,800,53896,21440,2.70903e+13,220.474,4164.03,75336,798,175,62781,52041,28718,27449,40451
87125,247,331,62239,24886,2.79933e+13,173.099,3451.16,87125,275,175,86794,86794,81775,84327,86710
74716,600,800,53459,21257,2.70796e+13,235.864,4150.98,74716,751,180,73870,73470,72490,72960,73316
49469,535,800,35425,14044,2.65949e+13,211.653,3558.09,49469,774,175,48544,48183,46021,47091,47874
20868,187,212,14897,5971,2.80478e+13,170.005,1649.84,20868,154,141,20656,20656,19666,20144,20631
60269,162,283,43052,17217,2.80037e+13,172.689,2848.82,60269,226,175,58595,46164,52694,56438,55590
47541,108,260,33958,13583,2.79992e+13,172.348,2519.46,47541,203,175,41591,34869,23230,26393,30589
64389,634,800,46084,18305,2.69182e+13,233.606,3923.14,64389,798,175,63486,63314,56005,59765,63092
58192,220,279,41569,16623,2.79991e+13,172.662,2797.27,58192,222,175,57913,57913,54603,56277,57854
57463,5,278,41047,16416,2.80039e+13,172.615,2779.27,57463,221,175,17871,6336,3846,3327,1592
9343,150,191,6669,2674,2.80453e+13,165.814,1096,9343,127,118,8768,7035,7190,7811,7983
83218,747,949,59507,23711,2.72755e+13,232.629,4517.75,83218,775,200,82269,82106,80155,80892,81663
30851,74,230,22039,8812,2.79854e+13,171.522,2016.05,30851,173,160,25091,20613,10020,9623,13922
71082,32,303,50773,20309,2.80243e+13,172.907,3104.45,71082,246,175,49205,37272,13016,9277,14930
4083,138,181,2919,1164,2.80015e+13,154.397,719.423,4083,101,95,3686,3041,2827,2774,3168
80128,287,319,57227,22901,2.80146e+13,172.993,3303.92,80128,262,175,79809,79809,78343,79066,79777
27546,161,224,19671,7875,2.80258e+13,171.057,1902.02,27546,167,153,26650,21029,24028,25713,25212
54931,247,419,39213,15718,2.81617e+13,172.817,2902.54,54931,231,187,54512,54391,48185,44548,51546
47789,88,260,34136,13653,2.79894e+13,172.361,2525.71,47789,203,175,40109,33332,18327,17596,25771
5715,90,184,4083,1632,2.80861e+13,160.12,853.554,5715,111,104,4764,3962,2274,2812,3132
51514,28,267,36797,14717,2.80045e+13,172.489,2626.11,51514,210,175,34539,25886,8766,9154,10567
70666,257,301,50475,20191,2.8e+13,172.848,3093.75,70666,244,175,70365,70365,68075,69224,70321
93761,202,343,66977,26784,2.79943e+13,173.163,3586.3,93761,286,175,93418,93418,84532,89076,93277
64861,27,291,46336,18525,2.79965e+13,172.821,2959.31,64861,235,175,43136,32129,11034,11378,14069
23931,67,217,17096,6835,2.7982e+13,170.775,1769.56,23931,160,146,19148,15813,6935,7587,10344
70435,5,301,50317,20118,2.79958e+13,172.906,3088.97,70435,245,175,21898,7756,4710,4965,2474
54521,226,273,38939,15582,2.80198e+13,172.641,2705.15,54521,216,175,54248,54248,51785,53020,54201
58642,620,800,41981,16661,2.68215e+13,228.856,3788.37,58642,734,180,57822,57422,56927,57318,57302
7703,12,187,5505,2198,2.79296e+13,163.37,992.403,7703,121,112,3792,2401,1145,719,909
59558,19,282,42533,17025,2.80165e+13,172.593,2831.4,59558,224,175,35318,25204,10134,6048,6566
1747,132,177,1247,500,2.86932e+13,126.365,468.569,1747,73,77,1484,1280,1119,1142,1299
4441,99,182,3173,1268,2.79631e+13,156.408,751.577,4441,104,99,3734,3185,1944,1868,2533
86566,53,331,61832,24734,2.80049e+13,173.134,3440.64,86566,274,175,66865,54916,21152,24897,30193
3299,82,180,2352,947,2.80826e+13,150.443,646.994,3299,95,89,2659,2266,1173,948,1561
20818,170,212,14868,5950,2.80408e+13,170.218,1648.08,20818,155,141,20426,16101,18508,19564,19997
53423,41,271,38163,15260,2.8e+13,172.584,2676.55,53423,214,175,39374,30984,11229,8876,14597
11550,148,195,8248,3302,2.80134e+13,167.251,1220.43,11550,135,124,10835,8707,8781,9578,9830
68137,174,297,48674,19463,2.79977e+13,172.867,3036.21,68137,240,175,67719,54026,60178,64092,67391
16429,87,203,11737,4692,2.78957e+13,169.252,1459.5,16429,147,134,13702,11448,6281,5683,8530
61795,103,285,44141,17654,2.79911e+13,172.712,2885.2,61795,229,175,53548,45338,27984,27768,38340
79150,310,317,56540,22610,2.79997e+13,173.021,3282.77,79150,260,175,78833,78833,78762,78789,78826
97278,311,350,69485,27793,2.80141e+13,173.191,3656.77,97278,293,175,96928,96928,95011,95966,96889
72705,27,305,51930,20775,2.80107e+13,172.859,3140.07,72705,248,175,48372,36017,12375,15132,15792
67744,47,297,48390,19354,2.80063e+13,172.87,3027.77,67744,240,175,51220,41014,15575,18628,21989
57370,79,277,40982,16388,2.79781e+13,172.645,2776.12,57370,221,175,47226,39404,19458,18497,27579
77430,52,314,55308,22122,2.8007e+13,172.966,3245.46,77430,257,175,59600,48295,19219,16556,25659
48953,546,800,35056,13897,2.65761e+13,212.422,3544.63,48953,771,175,48042,47668,45753,46684,47391
56582,230,276,40418,16164,2.7992e+13,172.601,2756.67,56582,219,175,56306,56306,53887,55101,56260
59183,354,427,42248,16935,2.81487e+13,172.927,3009.98,59183,238,184,58756,58756,56741,56133,58063
53097,20,270,37923,15174,2.80049e+13,172.52,2667.62,53097,213,175,32152,22748,9031,8552,6718
56628,205,276,40455,16173,2.79892e+13,172.64,2757.89,56628,220,175,56352,56352,52217,54314,56281
15522,118,202,11085,4437,2.79839e+13,168.929,1418.67,15522,145,132,13802,11469,8527,7948,10700
19603,191,210,14003,5600,2.80621e+13,170.011,1598.65,19603,153,139,19393,19393,18844,19092,19374
5671,108,185,4046,1625,2.83537e+13,159.57,851.211,5671,112,105,4883,4130,2804,3155,3667
42416,168,251,30291,12125,2.8023e+13,172.096,2375.33,42416,193,175,41640,32707,37304,39785,40617
61234,329,800,43830,17404,2.68496e+13,213.997,3849.69,61234,798,175,60063,59530,54343,56799,59003
47940,4,261,34244,13696,2.801e+13,172.42,2530.74,47940,204,175,12569,3817,2777,3389,1653
10237,23,193,7309,2928,2.80857e+13,166.267,1148.25,10237,131,121,6482,4736,1756,1187,1748
9624,170,191,6878,2746,2.79284e+13,165.773,1111.76,9624,128,118,9358,7414,8743,9076,9164
33885,56,235,24203,9682,2.79811e+13,171.661,2115.29,33885,178,165,26400,21674,8545,9282,12146
18064,199,206,12904,5160,2.79118e+13,169.659,1531.98,18064,150,137,17858,17858,17785,17813,17851
16811,164,205,12000,4811,2.80829e+13,169.127,1478.06,16811,147,134,16287,12843,14718,15672,15646
54437,102,272,38882,15555,2.80165e+13,172.493,2701.75,54437,215,175,47085,39740,24563,29256,33722
85286,567,800,61017,24269,2.71705e+13,234.791,4367.76,85286,798,175,84298,83936,75389,79737,83787
83493,215,325,59635,23858,2.8007e+13,173.018,3375.64,83493,268,175,83168,83168,76389,79848,83058
64735,56,291,46236,18499,2.80053e+13,172.81,2956.58,64735,234,175,50477,41421,16298,19092,23737
84587,228,327,60419,24168,2.80093e+13,173.062,3398.87,84587,270,175,84260,84260,78261,81316,84161
31158,165,230,22257,8901,2.79853e+13,171.429,2025.85,31158,173,160,30388,23902,27354,29176,29233
52348,861,944,37449,14899,2.70525e+13,218.201,3723.72,52348,532,193,51404,51404,51334,51277,51404
52383,103,268,37414,14969,2.80077e+13,172.412,2648.16,52383,211,175,45389,38434,23746,28343,32791
38986,24,244,27852,11134,2.79784e+13,171.936,2273.45,38986,187,174,25081,18389,6627,5292,7145
70703,417,447,50484,20219,2.81126e+13,173.074,3283.67,70703,255,192,70256,70256,69081,69655,70226
9170,48,190,6557,2613,2.78677e+13,165.354,1084.52,9170,127,117,6921,5590,2168,1759,2918
67141,71,295,47964,19177,2.79894e+13,172.871,3012.98,67141,239,175,54319,44652,20526,21984,29839
9345,28,191,6677,2668,2.7964e+13,165.528,1095.8,9345,127,117,6248,4693,1598,1568,1445
89266,93,335,63760,25506,2.80081e+13,173.078,3495.33,89266,278,175,75806,62448,35569,44726,50801
37000,138,241,26427,10573,2.80076e+13,171.77,2213.65,37000,184,171,34334,27864,25866,26734,29528
85443,114,328,61029,24414,2.80138e+13,173.026,3416.03,85443,271,175,75784,63318,44661,49923,57989
39676,189,246,28341,11335,2.79922e+13,172.013,2294.78,39676,189,175,39430,39430,36306,37882,39373
67763,151,297,48396,19367,2.80214e+13,172.789,3028.05,67763,239,175,64562,51304,53482,57373,58685
8555,163,189,6107,2448,2.78799e+13,164.71,1046.93,8555,123,114,8210,6518,7486,7166,7849
3034,58,180,2175,859,2.82159e+13,148.966,621.184,3034,93,88,2319,1926,797,773,1066
59092,47,281,42206,16886,2.80111e+13,172.599,2819.8,59092,223,175,44685,35795,13579,11136,18458
86533,126,330,61813,24720,2.79928e+13,173.105,3439,86533,274,175,78611,65056,53179,43688,63674
47973,4,260,34270,13703,2.79672e+13,172.368,2530.42,47973,204,175,12568,3807,2771,3381,2916
25779,143,220,18416,7363,2.80025e+13,170.825,1837.64,25779,163,150,24125,19451,19024,21046,21254
72399,277,305,51709,20690,2.80143e+13,172.86,3133.81,72399,247,175,72094,72094,70892,71481,72066
9115,85,190,6510,2605,2.79744e+13,165.307,1081.29,9115,125,116,7549,6337,3357,3549,4855
6889,131,187,4913,1976,2.81642e+13,162.156,939.031,6889,118,109,6218,5156,4355,4413,5223
57745,56,279,41240,16505,2.80306e+13,172.598,2786.87,57745,221,175,45026,36956,14564,15812,20990
20096,46,211,14362,5734,2.79761e+13,170.316,1619.47,20096,154,140,15102,12108,4558,4227,6042
84949,146,328,60681,24268,2.80192e+13,173.111,3406.88,84949,271,175,80213,64313,64153,70727,72046
65705,257,293,46929,18776,2.8014e+13,172.795,2979.63,65705,236,175,65412,65412,63678,64538,65376
42208,213,251,30147,12061,2.80277e+13,172.146,2369.8,42208,194,175,41957,41957,40123,41034,41919
20345,175,211,14537,5808,2.7952e+13,170.227,1628.87,20345,154,141,20134,20134,18439,19279,20098
28083,20,225,20057,8026,2.80414e+13,171.259,1921.31,28083,168,155,16999,12036,4798,2855,4151
69632,17,300,49734,19898,2.79931e+13,172.873,3070.86,69632,243,175,39524,28067,11705,8436,10892
85971,260,329,61412,24559,2.79973e+13,173.112,3427.37,85971,273,175,85642,85642,81643,83670,85573
28064,178,225,20041,8023,2.80303e+13,171.132,1920.3,28064,168,154,27839,27839,25358,26603,27792
20547,106,211,14676,5871,2.79994e+13,170.215,1636.92,20547,154,140,17875,15051,9801,9159,12870
89736,32,336,64094,25642,2.80057e+13,173.128,3505.16,89736,279,175,62121,47049,16409,14456,21582
60021,28,283,42867,17154,2.80256e+13,172.685,2843.16,60021,226,175,40242,30168,10222,7186,11350
82833,636,800,59248,23585,2.71729e+13,239.182,4318.73,82833,757,180,82020,81847,80544,81215,81542
75727,57,311,54093,21634,2.80121e+13,172.936,3208.01,75727,254,175,59239,48463,19226,16469,26696
51876,165,268,37056,14820,2.80235e+13,172.458,2635.77,51876,211,175,50688,39822,45480,48614,48767
7688,179,188,5493,2195,2.79285e+13,164.111,992.645,7688,121,111,7500,7500,7405,7443,7491
94874,196,346,67771,27103,2.80131e+13,173.186,3609.56,94874,289,175,94528,94528,85076,89908,94378
3146,165,180,2243,903,2.82857e+13,149.487,632.611,3146,93,90,2926,2366,2796,2872,2835
70628,126,302,50448,20180,2.8015e+13,172.913,3094.08,70628,245,175,64152,53083,43380,38095,52455
68053,41,297,48609,19444,2.80054e+13,172.833,3034.27,68053,240,175,50174,39491,14304,11321,18570
34733,212,237,24815,9918,2.79992e+13,171.667,2142.72,34733,180,167,34496,34496,33546,34002,34471
48729,80,263,34805,13924,2.80216e+13,172.37,2552.56,48729,205,175,40201,33820,16701,22818,24441
92065,34,340,65756,26309,2.80099e+13,173.1,3552.14,92065,283,175,64741,51779,17372,17829,18572
46934,227,259,33522,13412,2.80134e+13,172.299,2502.8,46934,202,175,46675,46675,45206,45932,46643
59756,44,282,42682,17074,2.79991e+13,172.688,2836.23,59756,225,175,44695,35319,13467,14830,17389
17087,200,205,12207,4880,2.80081e+13,169.343,1489.68,17087,148,134,16882,16882,16846,16857,16877
33206,200,234,23723,9483,2.8002e+13,171.642,2093.75,33206,178,164,32972,32972,31359,32159,32938
17165,105,205,12261,4904,2.80121e+13,169.33,1493.25,17165,148,135,14860,12571,8083,9405,10825
5887,33,185,4202,1685,2.8198e+13,161.172,867.579,5887,113,105,4080,3133,1106,1126,1346
13942,224,340,9938,4004,2.86602e+13,169.284,1514.64,13942,147,138,13602,13480,12281,11586,12978
36981,302,386,26397,10584,2.82045e+13,172.218,2397.42,36981,191,171,36595,36481,36284,35975,36266
16161,63,353,11515,4646,2.8567e+13,169.765,1630.18,16161,153,140,12790,10660,4417,3091,5883
39850,41,246,28468,11382,2.79973e+13,172.029,2299.93,39850,189,175,29367,23117,8369,9532,10886
32264,89,232,23047,9217,2.80167e+13,171.562,2062.63,32264,175,162,27126,22491,12580,15706,17673
49564,8,263,35404,14160,2.79757e+13,172.4,2573.64,49564,206,175,20593,9399,5731,3845,2787
20261,184,211,14466,5795,2.80611e+13,169.897,1625.15,20261,153,140,20050,20050,18929,19474,20023
84638,236,800,60552,24086,2.71689e+13,223.168,4354.83,84638,798,175,83344,82892,75435,78830,81966
26300,175,222,18782,7518,2.80474e+13,170.939,1857.69,26300,164,151,26078,26078,23604,24846,26031
37625,7,242,26874,10751,2.80101e+13,171.912,2232.69,37625,185,172,14559,5851,4079,2791,2900
39616,175,246,28303,11313,2.79955e+13,172.088,2293.38,39616,189,175,39370,39370,35297,37360,39299
59633,175,282,42591,17042,2.79883e+13,172.703,2833.22,59633,225,175,59351,59351,52827,56153,59244
40197,16,247,28711,11486,2.80148e+13,172.019,2310.39,40197,190,175,22310,15709,6628,3790,5251
13645,153,199,9751,3894,2.79944e+13,168.384,1328.58,13645,142,129,12940,10290,11135,11304,11894
8153,178,189,5819,2334,2.80804e+13,164.15,1022.16,8153,123,113,7964,7964,7797,7870,7953
51262,13,267,36619,14643,2.80049e+13,172.518,2619.96,51262,210,175,26219,17699,7694,6312,4622
49585,728,800,35512,14073,2.65838e+13,217.031,3560.89,49585,798,175,48785,48573,43949,46306,48570
54490,61,273,38923,15567,2.79969e+13,172.636,2704.3,54490,216,175,43066,35246,14704,16650,21645
45842,245,257,32745,13097,2.79926e+13,172.34,2472.54,45842,200,175,45585,45585,45412,45486,45573
46035,239,257,32883,13152,2.79946e+13,172.257,2477.34,46035,200,175,45778,45778,45265,45497,45760
7924,57,189,5655,2269,2.82167e+13,163.726,1008.29,7924,122,113,6152,5066,2062,2459,2953
66092,171,294,47212,18880,2.80141e+13,172.841,2989.18,66092,237,175,65326,51214,58206,62087,64459
6290,89,185,4488,1802,2.81155e+13,160.803,895.611,6290,114,107,5243,4372,2488,3087,3453
48555,79,404,34661,13894,2.81886e+13,172.565,2730.6,48555,213,177,39951,33403,16090,21258,23664
58320,278,280,41650,16670,2.80246e+13,172.605,2801.1,58320,222,175,58040,58040,58036,58036,58038
42717,146,251,30506,12211,2.80234e+13,172.138,2383.7,42717,194,175,40266,32322,32236,35530,36019
83089,570,946,59419,23670,2.72551e+13,218.791,4513.69,83089,800,197,82012,81598,76651,78935,81015
88318,297,334,63086,25232,2.80089e+13,173.14,3476.74,88318,277,175,87984,87984,86190,87082,87947
55339,240,274,39529,15810,2.80025e+13,172.583,2725.37,55339,217,175,55065,55065,53464,54256,55031
46115,29,257,32942,13173,2.79857e+13,172.356,2479.83,46115,201,175,31160,23502,7850,7754,9472
46852,9,259,33471,13381,2.80023e+13,172.318,2500.65,46852,202,175,20503,9910,5849,3048,2193
75846,153,800,54259,21587,2.70994e+13,236.75,4174.55,75846,798,175,71551,56742,60450,63559,64345
31284,229,231,22344,8940,2.80346e+13,171.595,2031.2,31284,174,160,31053,31053,31049,31049,31051
78919,288,316,56374,22545,2.79852e+13,173.007,3277.23,78919,260,175,78603,78603,77400,77989,78575
92667,79,342,66191,26476,2.80209e+13,173.159,3565.35,92667,285,175,76351,63647,31351,27197,45037
77665,152,315,55476,22189,2.80238e+13,172.989,3251.13,77665,258,175,74153,58799,62277,66747,68141
98802,287,352,70565,28237,2.8011e+13,173.139,3685.74,98802,295,175,98450,98450,94740,96618,98385
47952,36,261,34249,13703,2.80177e+13,172.259,2530.69,47952,203,175,34231,27145,9724,7922,12003
8873,128,190,6342,2531,2.79598e+13,165.292,1067.53,8873,127,116,7993,6633,5507,5548,6623
65842,233,293,47036,18806,2.80178e+13,172.803,2982.73,65842,236,175,65549,65549,62213,63895,65489
15271,47,351,10885,4386,2.85262e+13,169.749,1588.34,15271,159,148,11525,9253,3484,2671,4372
64630,108,291,46166,18464,2.80116e+13,172.798,2954.17,64630,234,175,56624,47411,31542,26569,41305
40549,78,248,28962,11587,2.8025e+13,172.07,2321.25,40549,191,175,33294,27763,13598,11846,19381
43184,197,252,30848,12336,2.79909e+13,172.19,2397.21,43184,195,175,42932,42932,39918,41437,42877
70100,189,300,50070,20030,2.80031e+13,172.838,3080.84,70100,243,175,69800,69800,62954,66448,69689
59322,9,282,42370,16952,2.80401e+13,172.619,2826.11,59322,224,175,25961,12568,7409,4732,5327
23509,162,216,16790,6719,2.79872e+13,170.573,1753,23509,159,146,22768,17984,20526,19665,21720
47277,179,259,33773,13504,2.79858e+13,172.352,2511.62,47277,203,175,47018,47018,42271,44683,46938
73461,221,307,52469,20992,2.80099e+13,172.955,3157.97,73461,250,175,73154,73154,68034,70638,73068
36287,187,388,25899,10388,2.82239e+13,172.198,2379.44,36287,192,168,35889,35751,31472,31577,34879
87201,174,332,62289,24912,2.80077e+13,173.126,3453.74,87201,275,175,86713,69161,76852,81977,86295
36369,47,240,25977,10392,2.80134e+13,171.777,2194.23,36369,183,169,27486,22029,8368,6276,10351
21561,147,213,15404,6157,2.80082e+13,170.361,1677.76,21561,156,143,20304,16292,16344,16016,18074
47817,68,261,34149,13668,2.80291e+13,172.298,2527.34,47817,203,175,38429,31719,14039,16638,21108
72350,111,800,51764,20586,2.70485e+13,222.358,4100.17,72350,780,180,62901,52711,36029,33745,46823
78977,255,317,56413,22564,2.80164e+13,172.999,3279.3,78977,260,175,78660,78660,75181,76939,78598
59564,205,281,42550,17014,2.799e+13,172.682,2830.74,59564,224,175,59283,59283,54817,57086,59207
31464,32,231,22469,8995,2.80219e+13,171.445,2036.34,31464,174,160,21764,16495,5762,4291,6924
67822,6,297,48442,19380,2.80178e+13,172.8,3029.27,67822,240,175,23922,9090,6015,4047,2226
66702,109,295,47646,19056,2.80196e+13,172.843,3003.46,66702,238,175,58539,49049,32798,30063,42976
31362,8,231,22399,8963,2.80233e+13,171.6,2033.62,31362,174,160,13044,5956,3627,1983,1244
17029,149,205,12164,4865,2.80375e+13,169.506,1487.46,17029,148,134,16070,12858,13090,14202,14603
34444,4,237,24600,9844,2.80625e+13,171.61,2134.12,34444,179,166,9039,2750,1998,1934,796
11865,145,195,8479,3386,2.79104e+13,167.546,1236.89,11865,137,126,11080,8925,8826,9293,9886
62672,94,288,44758,17914,2.80353e+13,172.71,2907.86,62672,230,175,53312,43840,25312,31526,36117
43422,198,252,31015,12407,2.80061e+13,172.148,2403.59,43422,195,175,43170,43170,40212,41702,43116
33132,180,234,23664,9468,2.80178e+13,171.673,2091.59,33132,177,164,32898,32898,29959,31439,32844
71525,416,448,51065,20460,2.81262e+13,173.061,3302.29,71525,245,193,71077,71077,69801,70427,71045
33941,5,235,24243,9698,2.79888e+13,171.652,2116.76,33941,178,165,10549,3739,2270,1958,855
22791,364,365,16256,6535,2.84114e+13,171.137,1912.04,22791,171,162,22426,22426,22426,22426,22425
93175,111,342,66552,26623,2.79935e+13,173.139,3574.55,93175,285,175,82142,68713,47685,45043,60964
65127,123,292,46516,18611,2.8014e+13,172.84,2966.34,65127,235,175,58800,48708,39058,34769,46801
69702,242,300,49791,19911,2.80014e+13,172.886,3072.5,69702,244,175,69402,69402,66159,67798,69344
10443,26,193,7455,2988,2.80304e+13,166.081,1159.32,10443,131,121,6878,5058,1799,1285,1940
96325,298,348,68799,27526,2.80019e+13,173.163,3637.72,96325,291,175,95977,95977,93306,94650,95927
48074,125,260,34342,13732,2.79963e+13,172.311,2532.92,48074,204,175,43523,36128,29335,29818,35273
68376,62,438,48815,19561,2.81304e+13,172.975,3224.41,68376,239,192,54221,44457,17177,13541,24490
12287,55,196,8782,3505,2.79718e+13,167.74,1259.16,12287,138,125,9506,7800,3081,3582,4460
92140,289,340,65812,26328,2.80085e+13,173.097,3553.5,92140,283,175,91800,91800,89042,90430,91749
7254,175,188,5179,2075,2.81052e+13,162.976,964.338,7254,120,110,7066,7066,6860,6949,7053
53666,228,271,38330,15336,2.80149e+13,172.532,2682.4,53666,214,175,53395,53395,51213,52301,53352
83414,71,324,59585,23829,2.79946e+13,173.061,3373.22,83414,268,175,67504,55489,25531,29440,38162
7206,67,187,5149,2057,2.798e+13,163.156,960.285,7206,119,110,5725,4741,2118,2162,3047
72484,206,305,51773,20711,2.80086e+13,172.897,3135.59,72484,248,175,72179,72179,66157,69225,72080
22788,106,215,16280,6508,2.79769e+13,170.574,1725.92,22788,158,144,19834,16694,10877,10166,14301
16259,128,204,11606,4653,2.80664e+13,168.947,1453.02,16259,146,133,14739,12192,10087,10194,12129
33356,51,234,23827,9529,2.8007e+13,171.669,2098.2,33356,177,164,25562,20670,8204,10435,11707
98646,768,800,70531,28115,2.752e+13,259.871,4445.94,98646,440,175,97846,97846,97825,97813,97846
57936,316,942,41446,16490,2.6961e+13,232.369,3954.06,57936,806,177,56581,56084,48797,50885,54378
18651,131,208,13320,5331,2.80375e+13,169.716,1557.96,18651,151,137,17025,14025,11805,11915,14318
95407,246,346,68144,27263,2.80116e+13,173.118,3618.99,95407,289,175,95061,95061,88977,92076,94961
20546,87,211,14681,5865,2.7987e+13,170.272,1636.86,20546,155,141,17166,14312,7808,6363,10786
89070,777,947,63683,25387,2.73298e+13,231.564,4633.76,89070,799,182,88123,87956,85551,83523,85912
65767,185,293,46982,18785,2.80112e+13,172.804,2980.99,65767,236,175,65474,65474,58867,62235,65366
47524,220,260,33944,13580,2.80093e+13,172.369,2518.96,47524,203,175,47264,47264,45266,46263,47224
67924,116,297,48516,19408,2.80171e+13,172.854,3031.6,67924,240,175,60468,50320,35863,32349,46721
39542,126,245,28249,11293,2.79838e+13,171.974,2290.13,39542,188,175,35870,29710,24316,20000,29205
3206,172,180,2292,914,2.81507e+13,149.402,637.816,3206,93,91,3014,2458,2956,2983,2968
55141,121,800,39478,15663,2.67293e+13,230.02,3702.8,55141,675,175,48696,40395,30197,27910,37577
62272,291,800,44565,17707,2.68769e+13,226.339,3874.18,62272,751,180,61117,60566,58996,59461,59941
23733,92,216,16956,6777,2.79782e+13,170.703,1761.54,23733,160,147,20037,16546,9374,11800,13371
23428,71,216,16741,6687,2.79818e+13,170.732,1750.29,23428,160,146,18906,15568,7176,6523,10409
30688,209,229,21919,8769,2.80056e+13,171.359,2009.99,30688,172,159,30459,30459,29814,30114,30439
65655,164,292,46899,18756,2.79817e+13,172.792,2977.55,65655,236,175,64084,50295,57513,61536,61390
87015,591,974,62210,24805,2.73167e+13,246.382,4637.35,87015,748,213,85989,85537,84644,84780,84892
99957,198,800,71486,28471,2.73225e+13,226.444,4648.02,99957,798,180,98570,98182,87661,92509,97051
22823,77,215,16307,6516,2.79771e+13,170.626,1727.26,22823,158,144,18669,15571,7678,7789,10890
79980,243,318,57125,22855,2.80066e+13,172.937,3300,79980,261,175,79662,79662,75273,77500,79587
35452,106,238,25322,10130,2.80112e+13,171.772,2165.22,35452,181,167,30903,25992,16932,15805,22493
37465,110,242,26759,10706,2.79981e+13,171.921,2228.03,37465,185,172,32897,27603,18912,17257,24423
29909,61,229,21361,8548,2.80194e+13,171.372,1985.18,29909,171,158,23614,19346,8101,9421,11766
86870,65,800,62141,24729,2.72116e+13,221.043,4399.43,86870,798,180,68674,56900,23617,19118,33847
23240,41,216,16602,6638,2.79962e+13,170.678,1743.51,23240,159,146,17109,13477,4879,5571,6456
56368,40,276,40261,16107,2.79983e+13,172.62,2751.6,56368,219,175,41349,32396,11724,11516,16555
86737,247,800,62039,24698,2.72095e+13,238.291,4396.7,86737,798,175,85423,84986,75486,79976,84070
45425,161,256,32443,12982,2.79985e+13,172.28,2460.57,45425,199,175,44049,34702,39692,42500,41778
12799,123,197,9139,3660,2.80852e+13,167.612,1285.57,12799,139,127,11461,9545,7652,7901,9169
91425,221,478,65283,26142,2.81042e+13,173.252,3721.91,91425,281,192,90947,90825,76194,68414,85486
9869,169,192,7048,2821,2.80199e+13,165.981,1126.42,9869,129,119,9581,7589,8880,9267,9384
49467,141,263,35332,14135,2.7985e+13,172.38,2571.05,49467,206,175,46223,37354,35651,35751,40441
67006,270,295,47857,19149,2.80143e+13,172.834,3009.84,67006,238,175,66711,66711,65746,66211,66686
8806,80,190,6286,2520,2.80287e+13,164.669,1063.12,8806,125,115,7206,6104,3077,4126,4394
97267,236,350,69475,27792,2.80101e+13,173.192,3656.59,97267,293,175,96917,96917,89881,93470,96803
3933,106,181,2806,1127,2.80664e+13,153.835,706.54,3933,100,94,3344,2852,1886,1785,2430
36195,142,239,25857,10338,2.79846e+13,171.845,2188.29,36195,182,169,33867,27319,26447,28011,29834
28184,121,225,20132,8052,2.79959e+13,171.206,1924.68,28184,168,154,25294,20962,16038,17183,20221
45245,143,256,32319,12926,2.80073e+13,172.321,2456.15,45245,199,175,42429,34155,33392,35277,37545
75107,122,453,53628,21479,2.81327e+13,173.148,3381.79,75107,252,192,67586,56066,27051,15844,46088
83598,172,464,59701,23897,2.80997e+13,173.194,3559.43,83598,267,193,82676,65542,43623,27833,70129
47488,109,260,33918,13570,2.80097e+13,172.306,2517.97,47488,203,175,41660,34922,23395,26892,31030
74403,145,309,53146,21257,2.79996e+13,172.993,3179.28,74403,252,175,70104,56190,55760,58713,62594
68479,232,441,48886,19593,2.81436e+13,172.96,3230.94,68479,239,192,68038,67916,54465,43355,61981
31672,131,231,22618,9054,2.80513e+13,171.394,2043,31672,174,161,28977,23844,20046,20238,24335
96867,333,350,69191,27676,2.8008e+13,173.206,3649.5,96867,293,175,96517,96517,96117,96289,96500
4680,39,183,3348,1332,2.81298e+13,157.673,772.829,4680,107,99,3380,2657,963,827,1185
96510,325,800,69026,27484,2.72815e+13,224.049,4584.03,96510,798,180,95320,94742,88530,91471,94185
9730,136,191,6945,2785,2.80297e+13,165.486,1117.51,9730,127,119,8916,7303,6597,6981,7599
77563,271,315,55400,22163,2.8028e+13,172.946,3249.09,77563,257,175,77248,77248,74993,76121,77204
44621,195,255,31873,12748,2.80108e+13,172.273,2438.5,44621,198,175,44366,44366,41036,42717,44306
65666,167,292,46907,18759,2.79985e+13,172.775,2977.91,65666,235,175,64444,50659,57648,61606,62528
19154,224,289,13673,5481,2.82273e+13,167.561,1679.5,19154,151,147,18865,18865,14597,15926,15819
58474,92,280,41766,16708,2.79989e+13,172.663,2804.57,58474,223,175,49508,40789,22981,22376,32599
53586,206,271,38279,15307,2.80121e+13,172.537,2680.36,53586,214,175,53315,53315,49611,51485,53250
42838,243,252,30603,12235,2.80263e+13,172.217,2388.07,42838,195,175,42586,42586,42484,42523,42577
88130,197,333,62951,25179,2.8e+13,173.097,3472.06,88130,276,175,87797,87797,79256,83622,87661
29667,108,228,21191,8476,2.80439e+13,171.426,1976.32,29667,171,157,25941,21738,14464,12207,18940
45272,28,256,32341,12931,2.80154e+13,172.207,2456.45,45272,199,175,30361,22757,7725,6076,9342
55863,692,951,39968,15895,2.68979e+13,218.233,3913.1,55863,765,201,54912,54722,53220,53629,54135
2609,177,179,1863,746,2.83862e+13,144.235,575.102,2609,86,85,2430,2430,2427,2426,2428
40270,686,800,28854,11416,2.62577e+13,214.685,3303.85,40270,798,172,39468,39255,35400,37358,39129
25683,62,221,18339,7344,2.80414e+13,170.852,1835.54,25683,163,150,20335,16661,7010,8170,10296
10905,130,193,7786,3119,2.8005e+13,166.354,1184.12,10905,132,123,9900,8191,6874,6965,8210
1958,76,177,1406,552,2.74681e+13,134.107,496.259,1958,79,74,1528,1310,684,696,945
8370,51,189,5983,2387,2.79578e+13,164.402,1035.58,8370,123,114,6381,5178,2066,1594,2690
85308,59,471,60914,24394,2.81141e+13,173.192,3600.27,85308,270,192,67109,54823,21930,16922,29856
28129,37,225,20099,8030,2.80156e+13,171.196,1922.65,28129,168,155,20216,15909,5595,6416,7247
71525,181,304,51088,20437,2.80279e+13,172.883,3114.69,71525,247,175,71221,71221,63594,67487,71098
12827,99,197,9160,3667,2.79469e+13,167.876,1286.97,12827,139,127,10969,9269,5588,5647,7665
69190,297,300,49419,19771,2.80173e+13,172.852,3061.57,69190,242,175,68890,68890,68882,68884,68887
38765,194,244,27697,11068,2.79854e+13,172.03,2267.57,38765,187,173,38521,38521,35825,37182,38471
10017,91,192,7159,2858,2.8112e+13,166.028,1134.98,10017,129,120,8403,6971,3966,4932,5593
58353,118,279,41681,16672,2.79894e+13,172.612,2800.76,58353,222,175,52148,43232,32076,29714,40573
15177,55,201,10836,4341,2.79427e+13,168.62,1401.46,15177,144,131,11766,9645,3822,4144,5349
63206,79,289,45149,18057,2.80257e+13,172.744,2920.77,63206,232,175,52063,43409,21424,22324,30907
27520,147,223,19660,7860,2.79858e+13,171.111,1900.44,27520,166,153,25955,20811,20898,22908,23247
66465,286,294,47472,18993,2.79966e+13,172.811,2997.24,66465,237,175,66171,66171,66079,66116,66163
73812,29,308,52727,21085,2.80044e+13,172.978,3166.15,73812,251,175,49891,37628,12569,12409,15797
46358,239,258,33108,13250,2.80152e+13,172.346,2487.1,46358,201,175,46100,46100,45541,45796,46081
34470,148,237,24620,9850,2.80495e+13,171.679,2135,34470,180,166,32586,26073,26312,28766,29356
40221,327,387,28711,11510,2.82008e+13,172.391,2490.99,40221,197,176,39834,39834,39526,39365,39580
37486,11,242,26776,10710,2.80163e+13,171.829,2228.6,37486,185,171,17825,10989,5493,3196,3967
71630,153,304,51169,20461,2.80123e+13,172.923,3116.92,71630,247,175,68510,54225,58853,62070,63385
75493,413,453,53908,21585,2.81119e+13,173.138,3389.23,75493,257,192,75040,75040,73194,74115,75000
92458,310,341,66037,26421,2.80188e+13,173.121,3560.47,92458,284,175,92117,92117,90744,91419,92086
75257,303,310,53759,21498,2.80037e+13,172.958,3197.6,75257,253,175,74947,74947,74876,74903,74940
56901,113,277,40647,16254,2.80157e+13,172.577,2764.99,56901,220,175,50326,42154,29634,27326,38034
91164,234,339,65120,26044,2.80133e+13,173.142,3534.66,91164,282,175,90825,90825,84422,87685,90720
87429,174,800,62538,24891,2.72051e+13,241.721,4409.95,87429,759,180,85866,68561,75093,79917,83970
11982,24,195,8558,3424,2.78964e+13,167.333,1242.51,11982,136,125,7692,5641,2037,1626,2368
46291,236,258,33058,13233,2.80223e+13,172.232,2485,46291,200,175,46033,46033,45251,45621,46011
46044,91,257,32893,13151,2.79921e+13,172.366,2477.97,46044,201,175,38884,32109,18011,14187,24852
70223,209,301,50162,20061,2.80082e+13,172.886,3084.45,70223,244,175,69922,69922,64403,67211,69830
26957,67,222,19258,7699,2.79382e+13,171.109,1880.42,26957,166,153,21573,17821,7845,7972,11217
98281,256,352,70199,28082,2.80061e+13,173.226,3676.68,98281,295,175,97929,97929,92151,95092,97833
24409,124,218,17431,6978,2.79764e+13,170.798,1787.73,24409,161,148,22013,18231,14833,12815,17712
29784,286,706,21308,8476,2.70828e+13,166.268,2556.19,29784,408,156,29078,29055,25277,18690,505
56490,151,425,40321,16169,2.81422e+13,172.852,2951.24,56490,219,194,53676,42783,25824,13378,41588
74916,71,310,53505,21411,2.80185e+13,172.883,3190.47,74916,252,175,60639,49842,22966,33622,33968
44382,109,398,31679,12703,2.82027e+13,172.431,2614.56,44382,211,187,38868,32653,18890,15995,26378
23493,38,216,16785,6708,2.79643e+13,170.616,1752.47,23493,160,146,17006,13328,4904,3353,5757
4477,455,800,3290,1187,1.22645e+13,292.709,1614.17,4477,695,75,3549,2928,2505,2681,2318
71234,691,800,50972,20262,2.70216e+13,216.822,4075.59,71234,792,180,70434,70229,67067,68664,70108
47553,166,260,33966,13587,2.8007e+13,172.335,2519.68,47553,203,175,46537,36669,41745,40544,44980
46920,258,259,33512,13408,2.80127e+13,172.362,2502.66,46920,202,175,46661,46661,46661,46661,46660
38701,243,244,27646,11055,2.80026e+13,171.985,2265.58,38701,187,174,38457,38457,38457,38457,38456
42048,56,250,30034,12014,2.80104e+13,172.106,2364.43,42048,193,175,32770,26899,10600,13568,15731
90423,332,338,64589,25834,2.80156e+13,173.136,3520,90423,281,175,90085,90085,90039,90051,90079
66548,122,294,47535,19013,2.79977e+13,172.814,2998.99,66548,237,175,59967,49664,38634,32667,47739
40368,191,247,28834,11534,2.80077e+13,172.064,2315.28,40368,190,175,40121,40121,37035,38592,40065
75987,104,461,54251,21736,2.81163e+13,173.13,3407.07,75987,254,196,65973,55772,28636,21601,42732
91798,265,340,65570,26228,2.8007e+13,173.158,3547.34,91798,283,175,91458,91458,87080,89302,91383
68650,278,800,49126,19524,2.7001e+13,237.884,4019.35,68650,798,175,67382,66932,58499,62528,66156
7755,84,188,5538,2217,2.796e+13,164.147,997.298,7755,121,111,6397,5367,2767,2188,3797
51333,168,267,36670,14663,2.80182e+13,172.49,2621.62,51333,210,175,50429,39584,45142,48168,49089
71440,69,304,51022,20418,2.80218e+13,172.878,3112.89,71440,246,175,57562,47396,21207,23542,31453
93835,60,800,67109,26726,2.72624e+13,235.122,4533.63,93835,798,175,73355,60016,24757,27760,35556
2432,134,178,1737,695,2.77307e+13,141.519,553.706,2432,85,79,2134,1797,1577,1526,1794
92049,327,340,65746,26303,2.80163e+13,173.107,3551.85,92049,283,175,91709,91709,91480,91580,91696
4878,65,183,3481,1397,2.80849e+13,158.239,789.139,4878,107,102,3833,3196,1416,1556,1945
96477,122,349,68916,27561,2.8003e+13,173.234,3641.62,96477,292,175,86958,72004,55989,55288,69550
69180,12,300,49413,19767,2.80112e+13,172.85,3061.38,69180,242,175,34147,21646,10261,5885,7199
75461,253,311,53897,21564,2.80213e+13,172.959,3202.89,75461,254,175,75150,75150,71939,73559,75092
30016,114,229,21438,8578,2.80604e+13,171.277,1988.49,30016,171,158,26554,22220,15746,17548,20389
30211,81,229,21578,8633,2.80284e+13,171.402,1994.72,30211,172,158,24960,20998,10565,10526,15077
34090,143,376,24326,9764,2.82712e+13,171.948,2300.94,34090,191,182,31842,25750,18925,16356,24879
41133,104,394,29355,11778,2.82294e+13,172.365,2523.32,41133,200,176,35648,30181,18263,17198,24951
43165,250,252,30832,12333,2.80097e+13,172.181,2396.57,43165,195,175,42913,42913,42909,42909,42911
70803,103,302,50574,20229,2.80094e+13,172.863,3097.54,70803,245,175,61358,51951,32070,38287,44313
53902,217,272,38498,15404,2.80307e+13,172.546,2689,53902,215,175,53630,53630,50625,52140,53575
41710,162,249,29790,11920,2.8018e+13,172.052,2354.14,41710,192,175,40501,31940,36462,39024,38670
72413,666,938,51793,20620,2.71747e+13,220.836,4280.92,72413,810,178,71419,71224,64981,65542,69205
74969,134,310,53547,21422,2.80212e+13,172.943,3191.67,74969,253,175,69165,56491,49585,52171,58989
37370,166,242,26689,10681,2.80204e+13,171.758,2225.18,37370,184,171,36534,28814,32790,35004,35303
74467,224,309,53188,21279,2.80096e+13,172.984,3180.66,74467,252,175,74158,74158,69106,71675,74073
73335,73,800,52468,20867,2.70616e+13,221.501,4121.17,73335,782,180,58895,48485,22911,32026,32975
51466,149,267,36760,14706,2.8006e+13,172.453,2624.82,51466,210,175,48818,38953,39670,39043,44360
72949,250,306,52106,20843,2.80038e+13,172.944,3146.36,72949,249,175,72643,72643,69548,71109,72587
62795,94,288,44850,17945,2.80005e+13,172.808,2910.7,62795,231,175,53403,43908,25558,24345,35661
72168,277,304,51548,20620,2.80025e+13,172.887,3127.95,72168,247,175,71864,71864,70740,71287,71837
35080,180,237,25055,10025,2.80234e+13,171.656,2153.09,35080,180,167,34843,34843,31689,33281,34786
47242,195,259,33744,13498,2.80036e+13,172.298,2510.48,47242,202,175,46983,46983,43346,45186,46919
77168,147,314,55125,22043,2.80163e+13,173.025,3240.39,77168,257,175,72990,58417,58685,64373,65698
82735,46,324,59094,23641,2.80185e+13,172.997,3359.92,82735,266,175,62353,49973,18723,16496,25373
60999,63,429,43546,17453,2.81439e+13,172.899,3053.9,60999,226,193,48471,40088,15575,11895,21700
86473,41,330,61771,24702,2.79992e+13,173.097,3437.86,86473,274,175,63764,50175,18314,22365,25465
97697,3,351,69785,27912,2.80108e+13,173.223,3665.5,97697,294,175,20493,4596,4244,6539,1557
44546,224,255,31814,12732,2.80296e+13,172.131,2436.28,44546,197,175,44291,44291,42899,43583,44260
97902,112,351,69928,27974,2.80082e+13,173.181,3668.95,97902,294,175,86473,72374,50633,48212,65742
33707,108,235,24078,9629,2.79994e+13,171.677,2109.99,33707,178,165,29465,24710,16474,16133,21640
83344,148,324,59540,23804,2.79894e+13,173.087,3371.97,83344,268,175,78992,63102,63685,62187,70482
72615,690,951,51928,20687,2.71591e+13,217.329,4299.94,72615,800,196,71644,71403,65960,68413,70881
85990,263,475,61393,24597,2.81007e+13,173.228,3618.4,85990,271,193,85515,85394,67093,59889,78616
87763,72,333,62685,25078,2.8016e+13,173.121,3465.36,87763,276,175,71196,58539,27318,24491,39311
56275,121,275,40196,16079,2.80047e+13,172.543,2748.42,56275,218,175,50581,41896,31950,34299,40174
65796,61,293,46998,18798,2.80095e+13,172.761,2981.48,65796,236,175,52036,42585,17751,13128,24595
69566,93,300,49685,19881,2.80116e+13,172.86,3069.49,69566,243,175,59073,48653,27717,27340,39151
93075,325,342,66477,26598,2.79994e+13,173.127,3572.59,93075,285,175,92733,92733,92292,92487,92716
37164,167,800,26639,10525,2.61488e+13,214.474,3211.65,37164,744,167,35347,27911,30674,32527,32838
99758,286,355,71257,28501,2.80206e+13,173.219,3705.95,99758,298,175,99403,99403,95448,97451,99334
24461,31,218,17473,6988,2.79859e+13,170.652,1789,24461,161,148,16792,12725,4383,4620,5533
84647,204,327,60456,24191,2.80044e+13,173.086,3400,84647,270,175,84320,84320,76689,80584,84197
54998,234,273,39289,15709,2.79892e+13,172.607,2716.35,54998,217,175,54725,54725,52772,53747,54686
97555,89,496,69658,27897,2.80991e+13,173.314,3852.71,97555,292,193,82106,68119,32470,26776,46356
99902,40,354,71360,28542,2.79901e+13,173.209,3707.44,99902,298,175,73315,57437,20765,23486,27176
74716,42,309,53365,21351,2.80086e+13,172.947,3185.53,74716,252,175,55358,43763,16096,19603,21652
78267,189,315,55908,22359,2.79899e+13,172.983,3263.21,78267,258,175,77952,77952,70086,74105,77826
9885,166,192,7061,2824,2.78888e+13,166.148,1127.58,9885,129,119,9549,7580,8780,8352,9331
77009,73,313,55007,22002,2.80029e+13,172.988,3236.06,77009,256,175,62600,51362,24521,25511,35995
38374,232,243,27413,10961,2.7977e+13,171.905,2255.08,38374,186,173,38131,38131,37962,38036,38120
89259,298,335,63754,25505,2.80102e+13,173.092,3495.19,89259,278,175,88924,88924,87130,88022,88887
38692,134,244,27638,11054,2.80054e+13,171.982,2265.26,38692,187,173,35660,29134,25592,26909,30265
55611,311,419,39701,15910,2.8149e+13,172.789,2919.1,55611,228,192,55192,55179,52512,50488,53303
87535,31,333,62520,25015,2.8015e+13,173.128,3460.88,87535,276,175,60119,45581,15688,11740,18394
88433,229,333,63171,25262,2.7998e+13,173.115,3477.93,88433,277,175,88100,88100,81720,84972,87996
96687,521,800,69150,27537,2.73015e+13,231.617,4587.48,96687,798,175,95655,95315,86788,91134,95050
23366,148,216,16693,6673,2.79837e+13,170.583,1747.81,23366,159,146,22070,17665,17812,18518,19805
4887,136,182,3495,1392,2.78022e+13,158.034,788.068,4887,107,100,4407,3643,3298,3055,3769
44695,55,255,31924,12771,2.80086e+13,172.281,2440.62,44695,198,175,34727,28430,11174,13039,16133
1126,89,176,804,322,2.82594e+13,102.884,375.725,1126,58,64,865,770,481,556,577
98120,417,500,70058,28062,2.80937e+13,173.319,3866.59,98120,293,195,97620,97620,92885,95290,97537
5443,102,183,3885,1558,2.79634e+13,158.775,832.07,5443,110,103,4628,3954,2509,2937,3331
97325,184,945,69582,27743,2.73872e+13,232.513,4787.13,97325,804,191,95760,95265,76781,74957,90555
17328,177,205,12383,4945,2.79679e+13,169.544,1500.13,17328,149,135,17123,17123,15912,16504,17095
45753,40,256,32679,13074,2.8001e+13,172.215,2469.18,45753,199,175,33563,26305,9527,12093,12972
55016,140,273,39300,15716,2.79903e+13,172.549,2716.59,55016,217,175,51332,41449,39441,39451,44540
88147,184,334,62959,25188,2.80233e+13,173.105,3473.42,88147,277,175,87813,87813,78348,83188,87663
47960,167,261,34264,13696,2.79806e+13,172.412,2531.18,47960,204,175,47019,36976,42155,44984,45400
82383,383,951,58914,23469,2.72528e+13,243.556,4504.3,82383,814,196,81051,80491,70938,62648,72324
23534,172,217,16806,6728,2.80532e+13,170.72,1755.09,23534,160,146,23194,18409,21004,22167,22917
92248,222,341,65894,26354,2.80138e+13,173.153,3556.61,92248,284,175,91907,91907,84552,88305,91788
87576,14,332,62556,25020,2.80002e+13,173.047,3460.42,87576,275,175,46238,31511,13301,9356,11060
51480,220,408,36750,14730,2.81842e+13,172.679,2806.98,51480,220,191,51072,50949,43292,36914,47331
67264,608,947,48107,19157,2.7103e+13,232.401,4177.47,67264,798,192,66187,65800,58436,61966,65300
44655,717,800,31991,12664,2.64224e+13,217.45,3428.27,44655,798,175,43855,43632,39240,41467,43607
28926,132,226,20662,8264,2.79884e+13,171.295,1950.11,28926,169,156,26541,21774,18504,17010,22191
98456,445,800,70415,28041,2.73e+13,251.694,4620.4,98456,798,175,97313,96684,85851,91583,96533
43692,236,253,31210,12482,2.80038e+13,172.205,2411.88,43692,197,175,43439,43439,42984,43188,43422
29004,179,226,20722,8282,2.7981e+13,171.256,1952.61,29004,169,156,28778,28778,26284,27538,28731
76192,291,312,54418,21774,2.80149e+13,172.913,3218.47,76192,254,175,75880,75880,75162,75500,75859
10675,5,193,7626,3049,2.79092e+13,166.547,1171.86,10675,131,122,3317,1178,715,614,307
25814,177,221,18441,7373,2.80354e+13,171.019,1840.22,25814,164,151,25593,25593,23346,24468,25549
86594,294,480,61824,24770,2.8108e+13,173.264,3634.34,86594,273,195,86114,85994,67427,66387,83585
72918,220,305,52086,20832,2.80003e+13,172.902,3144.67,72918,249,175,72613,72613,67532,70117,72528
32619,147,233,23300,9319,2.79966e+13,171.641,2074.54,32619,176,163,30769,24668,24776,25828,27511
67717,220,296,48369,19348,2.80072e+13,172.784,3026.07,67717,239,175,67421,67421,62969,65228,67345
53312,189,271,38083,15229,2.80028e+13,172.583,2673.91,53312,214,175,53041,53041,48217,50668,52959
9832,51,192,7017,2815,2.80539e+13,165.556,1124.37,9832,129,119,7508,6099,2448,2905,3319
55279,27,274,39483,15796,2.80074e+13,172.537,2723.96,55279,217,175,36769,27386,9418,7319,10696
24398,96,218,17422,6976,2.8012e+13,170.774,1787.18,24398,161,148,20793,17094,10168,10294,14387
37340,105,241,26666,10674,2.8009e+13,171.799,2223.46,37340,184,171,32473,27385,17539,20477,23426
73821,144,307,52735,21086,2.79915e+13,172.934,3165.19,73821,250,175,69446,55761,54810,54153,61316
18191,28,207,12992,5199,2.80344e+13,169.506,1538.14,18191,149,136,12189,9141,3116,2292,3436
41926,393,394,29922,12004,2.82228e+13,172.302,2545.45,41926,206,185,41532,41532,41532,41532,41531
80160,50,319,57253,22907,2.80105e+13,172.985,3304.66,80160,261,175,61275,49566,19164,15675,26160
62112,29,287,44368,17744,2.80024e+13,172.809,2894.58,62112,230,175,41975,31659,10566,7638,11719
27452,154,223,19609,7843,2.79988e+13,171.016,1898.04,27452,166,153,26227,20764,23086,24020,24188
65238,182,438,46573,18665,2.81497e+13,172.981,3157.19,65238,234,192,64786,64644,37241,23825,55775
41041,61,248,29325,11716,2.79807e+13,172.168,2335.15,41041,192,175,32422,26542,11056,10268,16142
13574,144,198,9701,3873,2.79231e+13,168.063,1323.96,13574,141,128,12681,10225,10037,9658,11202
95667,284,800,68421,27246,2.72643e+13,232.133,4568.04,95667,791,180,94461,93901,89962,91591,93209
58276,119,951,41692,16584,2.69584e+13,230.77,3972.23,58276,813,192,51236,42639,26612,21931,36547
98454,319,352,70324,28130,2.80056e+13,173.186,3679.73,98454,295,175,98102,98102,96582,97332,98069
75385,660,800,53935,21450,2.70858e+13,245.338,4164.94,75385,704,175,74585,74420,74124,74251,74166
10866,84,193,7760,3106,2.80019e+13,166.355,1182.1,10866,131,122,8996,7549,3926,5207,5667
63997,275,431,45683,18314,2.81676e+13,172.912,3122.36,63997,231,192,63566,63446,53794,51566,59527
70276,301,442,50172,20104,2.81372e+13,173.03,3268.95,70276,257,184,69834,69726,67881,65573,67624
70261,150,800,50271,19990,2.70271e+13,220.848,4054.74,70261,780,180,65830,52506,52846,57252,58442
10305,16,193,7357,2948,2.80779e+13,166.024,1151.39,10305,130,121,5712,4031,1697,827,903
4602,42,183,3282,1320,2.81474e+13,157.27,765.546,4602,107,98,3371,2681,998,752,1227
66525,729,800,47610,18915,2.6966e+13,222.789,3971.71,66525,798,175,65725,65491,59438,62564,65513
65348,156,292,46675,18673,2.80076e+13,172.788,2970.88,65348,235,175,62852,49709,55686,59084,58396
56509,273,276,40367,16142,2.79983e+13,172.553,2754.73,56509,219,175,56233,56233,56221,56223,56230
40424,155,247,28872,11552,2.80037e+13,172.097,2316.96,40424,190,175,38757,30729,34256,36426,36099
41040,265,800,29407,11633,2.63209e+13,208.842,3326.47,41040,775,174,39844,39372,36702,37711,38629
41577,229,249,29696,11881,2.79958e+13,172.101,2350.53,41577,192,175,41328,41328,40682,40982,41308
11146,67,194,7965,3181,2.79676e+13,167.094,1198.41,11146,135,124,8880,7354,3241,2384,4478
68762,285,442,49093,19669,2.81302e+13,173.073,3238.2,68762,240,192,68320,68200,60179,57572,64460
94894,209,345,67783,27111,2.79939e+13,173.167,3608.89,94894,288,175,94549,94549,86003,90372,94413
28892,138,226,20636,8256,2.80068e+13,171.274,1948.98,28892,169,156,26786,21745,20189,20360,23188
99950,178,355,71398,28552,2.79921e+13,173.234,3709.38,99950,298,175,99595,99595,88318,94089,99418
48824,124,262,34879,13945,2.7993e+13,172.456,2554.15,48824,206,175,44139,36508,29717,26142,35687
60566,89,283,43265,17301,2.79895e+13,172.731,2855.62,60566,227,175,50953,42249,23556,22389,32976
45494,202,256,32495,12999,2.79902e+13,172.23,2462.22,45494,199,175,45238,45238,42281,43771,45184
67653,33,297,48322,19331,2.80253e+13,172.831,3025.82,67653,240,175,47196,36089,12513,9446,15178
3553,91,180,2536,1017,2.77395e+13,151.714,670.67,3553,95,91,2936,2456,1452,1394,1931
62868,98,288,44906,17962,2.80195e+13,172.759,2912.32,62868,231,175,53920,45550,27162,25624,37193
68790,76,299,49129,19661,2.80267e+13,172.803,3052.1,68790,241,175,56299,46762,22931,31742,32914
15938,161,202,11385,4553,2.7969e+13,168.913,1437,15938,146,132,15364,12149,13886,14832,14606
68548,219,298,48962,19586,2.80045e+13,172.831,3045.87,68548,241,175,68250,68250,63616,65968,68171
61166,191,428,43663,17503,2.81684e+13,172.857,3057.15,61166,226,193,60730,60595,36533,21983,52266
53436,46,271,38166,15270,2.80011e+13,172.58,2676.8,53436,214,175,40249,32244,12115,11113,16161
63613,128,289,45439,18174,2.80057e+13,172.747,2929.78,63613,232,175,57977,47814,39544,34221,47653
77962,298,315,55684,22278,2.80091e+13,173.001,3257.13,77962,258,175,77647,77647,77201,77399,77630
58666,251,280,41906,16760,2.80033e+13,172.677,2809.19,58666,224,175,58386,58386,57112,57737,58357
44677,62,395,31890,12787,2.8215e+13,172.573,2619.64,44677,197,193,35396,29066,10216,6745,15592
38119,109,243,27232,10887,2.80201e+13,171.912,2247.82,38119,186,173,33414,28019,18755,17566,24726
41744,88,250,29813,11931,2.80457e+13,172.105,2356.05,41744,193,175,35044,29109,16013,15365,22558
97016,352,495,69269,27747,2.8097e+13,173.304,3841.03,97016,291,194,96521,96521,88783,87318,95324
40116,133,247,28652,11464,2.80292e+13,172.027,2308.25,40116,190,175,36887,30210,25942,27406,31317
71086,257,302,50781,20305,2.7991e+13,172.87,3103.43,71086,245,175,70784,70784,68426,69610,70739
57724,113,423,41208,16516,2.81528e+13,172.851,2972.85,57724,234,177,51010,42781,28691,25218,37726
94777,217,800,67791,26986,2.72619e+13,225.451,4551.31,94777,798,180,93439,93013,84516,88363,91988
68924,27,299,49230,19694,2.80192e+13,172.874,3054.93,68924,242,175,45840,34146,11746,8122,13567
17312,38,205,12363,4949,2.79937e+13,169.372,1499.09,17312,148,135,12523,9819,3608,2476,4241
44594,373,398,31820,12774,2.82329e+13,172.406,2621.15,44594,206,175,44196,44196,44006,43982,44144
49361,371,800,35350,14011,2.6579e+13,209.793,3555.14,49361,797,175,48249,47679,43715,45652,47274
62278,715,800,44550,17728,2.72405e+13,226.001,3687.19,62278,437,175,61478,61478,61404,61394,61478
38083,68,242,27205,10878,2.798e+13,171.988,2245.99,38083,186,173,30573,25250,11167,13246,16766
45230,219,647,32306,12924,2.78731e+13,170.765,2939.06,45230,199,191,44583,44460,34694,26351,40071
94118,328,800,67316,26802,2.72688e+13,240.989,4539.04,94118,798,175,92876,92354,82395,87312,91754
4314,133,182,3077,1237,2.81011e+13,155.452,740.483,4314,104,97,3865,3215,2794,2938,3322
80586,204,320,57566,23020,2.80004e+13,173.019,3313.99,80586,263,175,80266,80266,73130,76771,80150
68976,281,800,49354,19622,2.69795e+13,236.492,4026.23,68976,731,179,67812,67258,66087,66301,66599
83201,308,325,59435,23766,2.80088e+13,173.094,3370.25,83201,268,175,82876,82876,82470,82646,82859
57442,25,278,41031,16411,2.80166e+13,172.642,2778.77,57442,221,175,37480,27320,9782,6347,9692
4350,24,182,3106,1244,2.79982e+13,156.493,744.574,4350,104,98,2777,2043,752,593,563
70344,187,301,50242,20102,2.8002e+13,172.891,3087.04,70344,244,175,70043,70043,63001,66594,69929
74181,295,309,52986,21195,2.80113e+13,172.966,3174.69,74181,252,175,73872,73872,73630,73732,73858
90883,262,338,64915,25968,2.80039e+13,173.123,3528.39,90883,281,175,90545,90545,86095,88352,90469
8366,137,189,5974,2392,2.80217e+13,164.383,1035.48,8366,123,113,7659,6274,5674,5677,6632
49459,43,264,35332,14127,2.80322e+13,172.417,2572,49459,207,175,36807,29143,11022,7904,13701
37273,515,684,26653,10620,2.73416e+13,167.743,2749.31,37273,379,169,36589,36589,32114,34435,16976
50546,98,265,36107,14439,2.7992e+13,172.446,2600.12,50546,208,175,43338,36621,21867,20620,29982
27091,197,223,19351,7740,2.80132e+13,171.067,1885.93,27091,166,153,26868,26868,25828,26332,26842
82787,557,800,59221,23566,2.71505e+13,218.914,4317.77,82787,798,180,81841,81441,76445,78982,81258
88855,3,335,63466,25389,2.80124e+13,173.112,3487.62,88855,278,175,18645,4182,3864,4821,1513
59467,239,282,42479,16988,2.80191e+13,172.731,2829.74,59467,225,175,59185,59185,56998,58091,59142
92668,310,342,66196,26472,2.8013e+13,173.165,3565.38,92668,285,175,92326,92326,90897,91599,92294
81811,185,322,58433,23378,2.79993e+13,173.06,3340.09,81811,265,175,81489,81489,72925,77301,81352
25890,166,221,18488,7402,2.80347e+13,170.858,1842.43,25890,164,150,25264,19947,22754,24235,24356
40321,92,247,28798,11523,2.79844e+13,172.114,2313.91,40321,190,175,34109,28117,15863,15791,22515
33697,47,235,24070,9627,2.79993e+13,171.552,2109.56,33697,178,165,25464,20404,7789,9575,10734
61060,13,285,43622,17438,2.80029e+13,172.779,2868.85,61060,228,175,31236,21081,9161,6947,4965
6275,137,185,4485,1790,2.80478e+13,161.494,895.049,6275,114,106,5716,4691,4263,4502,4872
22440,50,214,16034,6406,2.79588e+13,170.591,1711.93,22440,158,145,17113,13848,5383,4662,7072
70133,62,301,50096,20037,2.8014e+13,172.906,3082.52,70133,244,175,55613,45509,19036,18059,27993
68236,110,800,48828,19408,2.69853e+13,237.984,4009.86,68236,721,177,59181,49680,33456,30357,43032
17735,19,206,12666,5069,2.79851e+13,169.564,1518.32,17735,149,135,10506,7501,3024,2476,2143
29318,3,227,20943,8375,2.80128e+13,171.269,1963.81,29318,170,157,6149,1378,1271,1961,877
2938,123,179,2098,840,2.76519e+13,146.807,609.103,2938,90,85,2555,2163,1749,1585,2039
75817,238,800,54242,21575,2.70856e+13,242.371,4174.3,75817,729,179,74554,74086,69360,71307,73199
72019,124,305,51437,20582,2.80292e+13,172.852,3125.96,72019,247,175,65135,53879,43841,44547,52427
33041,161,234,23602,9439,2.80097e+13,171.663,2088.61,33041,177,164,31995,25221,28853,29477,30524
30843,61,230,22033,8810,2.80292e+13,171.507,2016.11,30843,173,160,24355,19941,8350,9449,12306
71326,163,303,50949,20377,2.80074e+13,172.881,3109.56,71326,246,175,69489,54640,62426,66835,66625
18424,3,208,13150,5274,2.80926e+13,169.551,1548.71,18424,150,137,3868,874,805,1003,270
93610,147,343,66861,26749,2.80033e+13,173.159,3583.52,93610,286,175,88573,70888,71198,69704,80187
53238,477,800,38111,15127,2.67089e+13,210.492,3654.94,53238,798,175,52231,51945,47899,49924,51469
95332,344,346,68095,27237,2.79996e+13,173.184,3617.85,95332,290,175,94986,94986,94982,94982,94984
44736,248,255,31951,12785,2.80049e+13,172.296,2441.65,44736,198,175,44481,44481,44410,44437,44474
98200,202,352,70139,28061,2.80164e+13,173.192,3675.25,98200,295,175,97848,97848,88377,93221,97698
16389,162,204,11708,4681,2.80584e+13,169.292,1458.98,16389,147,134,15821,12513,14304,15256,15043
69594,154,299,49718,19876,2.79963e+13,172.868,3069.2,69594,243,175,66687,52688,58667,61050,61519
52921,199,270,37802,15119,2.80103e+13,172.569,2663.52,52921,213,175,52651,52651,48546,50627,52580
82324,66,322,58801,23523,2.80062e+13,172.986,3350,82324,266,175,65893,54476,23674,36172,35643
96129,73,800,68751,27378,2.72739e+13,262.486,4576.79,96129,689,175,77446,63689,30134,33750,44464
50117,528,800,35887,14230,2.66304e+13,229.415,3575.06,50117,791,175,49132,48835,42677,45786,46976
72913,119,306,52076,20837,2.80138e+13,172.856,3145.45,72913,248,175,65298,54161,40347,44177,51178
56497,236,276,40360,16137,2.79967e+13,172.643,2754.78,56497,220,175,56221,56221,54199,55209,56181
32699,82,233,23358,9341,2.80013e+13,171.632,2077.13,32699,176,162,27076,22733,11479,9873,16412
89733,36,477,64073,25660,2.8107e+13,173.229,3689.64,89733,292,180,64099,50762,17552,15433,21900
18704,101,208,13358,5346,2.80108e+13,169.511,1560.06,18704,150,137,16084,13608,8434,9864,11411
29125,87,227,20807,8318,2.80341e+13,171.351,1957.78,29125,170,156,24371,20297,11042,10623,15502
49980,212,265,35693,14287,2.80218e+13,172.334,2585.89,49980,207,175,49715,49715,46837,48286,49662
80855,307,320,57757,23098,2.79978e+13,173.039,3319.54,80855,263,175,80535,80535,80301,80401,80522
6786,179,187,4843,1943,2.82596e+13,161.909,932.061,6786,118,109,6599,6599,6517,6546,6591
60356,203,283,43114,17242,2.80053e+13,172.669,2850.64,60356,226,175,60073,60073,55349,57748,59993
24475,29,218,17482,6993,2.79988e+13,170.795,1789.96,24475,161,148,16529,12466,4171,4393,4264
99194,583,800,70940,28254,2.7307e+13,225.21,4634.03,99194,798,180,98261,97861,92070,95023,97743
34689,18,380,24753,9936,2.82293e+13,172.057,2324.24,34689,194,173,20099,14272,5866,4009,3102
24296,199,218,17353,6943,2.80137e+13,170.836,1783.67,24296,161,148,24078,24078,23508,23769,24059
75820,95,311,54159,21661,2.8e+13,172.971,3210.05,75820,255,175,64643,53170,31288,30194,43564
57510,136,278,41079,16431,2.80031e+13,172.589,2780.38,57510,221,175,53228,43327,38972,41344,45464
58725,683,800,42039,16686,2.68195e+13,230.622,3790.51,58725,798,175,57880,57669,51110,54463,57575
21213,188,213,15144,6069,2.80696e+13,170.119,1664.53,21213,155,142,21000,21000,20033,20498,20975
65422,31,800,46819,18603,2.69322e+13,212.952,3946.4,65422,798,175,44503,33997,11555,15025,15013
8883,156,190,6347,2536,2.79917e+13,165.21,1068.05,8883,126,115,8423,6717,7480,7923,7881
15663,196,203,11183,4480,2.81274e+13,168.802,1425.65,15663,145,132,15460,15460,15391,15417,15453
47595,119,260,33997,13598,2.8e+13,172.312,2520.61,47595,203,175,42603,35340,26334,23134,33325
30059,69,800,21566,8493,2.56782e+13,214.519,2982.82,30059,788,153,23474,19500,8489,7420,11947
12689,128,197,9064,3625,2.79734e+13,167.831,1280.2,12689,139,127,11471,9502,7874,6860,9437
23468,176,216,16762,6706,2.79641e+13,170.607,1751.47,23468,159,146,23252,23252,21244,22246,23212
53222,151,270,38015,15207,2.79973e+13,172.549,2670.77,53222,213,175,50696,40283,41984,43421,46585
74579,24,309,53272,21307,2.79902e+13,172.967,3182.82,74579,252,175,47988,35183,12680,10114,14717
40167,114,247,28688,11479,2.80111e+13,172.134,2309.77,40167,190,175,35568,29736,21063,18983,27233
1998,20,178,1425,573,2.83297e+13,134.671,501.886,1998,83,77,1192,860,360,233,281
16571,120,204,11835,4736,2.80136e+13,169.237,1466.45,16571,147,133,14801,12277,9250,9383,11785
84786,789,800,60647,24139,2.71863e+13,222.756,4357.9,84786,798,180,83986,83807,82454,83246,83954
26823,55,223,19160,7663,2.80044e+13,171.218,1876.76,26823,166,152,20814,17047,6710,7817,9772
63844,26,800,45689,18155,2.69164e+13,230.532,3910.38,63844,741,180,41744,30963,10687,6992,10876
46744,49,258,33395,13349,2.79796e+13,172.327,2496.84,46744,201,175,35586,28804,10998,12085,15073
79801,83,318,57005,22796,2.80006e+13,173.036,3296.75,79801,262,175,66305,55529,28154,24147,40492
6743,166,186,4814,1929,2.80639e+13,162.515,928.55,6743,116,108,6465,5157,6023,6032,6241
8309,187,189,5935,2374,2.80275e+13,164.205,1032.23,8309,124,114,8120,8120,8114,8115,8118
9482,100,191,6776,2706,2.7931e+13,165.69,1103.67,9482,129,118,8104,6863,4251,4006,5669
37629,193,242,26882,10747,2.79996e+13,171.909,2232.88,37629,185,171,37387,37387,34765,36083,37338
91442,25,340,65322,26120,2.80036e+13,173.188,3540.89,91442,283,175,59669,43476,15536,11734,13946
85220,531,800,60958,24262,2.7175e+13,250.563,4366.36,85220,723,177,84314,83914,83314,83597,83613
5482,141,184,3922,1560,2.79181e+13,159.9,836.723,5482,111,103,4998,4097,3918,4338,4328
58949,49,280,42105,16844,2.80074e+13,172.602,2815.56,58949,223,175,44893,36349,13884,17052,19786
62418,153,287,44582,17836,2.79892e+13,172.766,2901.18,62418,230,175,59681,47247,51252,50152,54797
75350,246,310,53820,21530,2.80028e+13,172.926,3199.34,75350,253,175,75040,75040,71398,73241,74976
50494,382,800,36154,14340,2.66128e+13,217.496,3584.65,50494,754,180,49429,48810,47354,47990,48440
53022,246,270,37872,15150,2.801e+13,172.459,2665.81,53022,212,175,52752,52752,51822,52271,52728
7136,46,187,5095,2041,2.80178e+13,163.101,956.054,7136,119,110,5339,4290,1645,1385,2064
84593,297,800,60508,24085,2.71917e+13,220.28,4354.3,84593,798,180,83376,82846,76653,79532,82178
51580,57,267,36840,14740,2.79905e+13,172.434,2627.44,51580,210,175,40337,33005,13049,14303,18488
78260,179,316,55893,22367,2.80212e+13,172.971,3263.98,78260,258,175,77944,77944,69350,73742,77807
71713,29,304,51224,20489,2.80211e+13,172.938,3118.66,71713,247,175,48478,36566,12223,14169,16080
36174,50,240,25840,10334,2.80048e+13,171.907,2188.71,36174,183,169,27617,22345,8643,8197,11670
36362,167,240,25966,10396,2.80304e+13,171.714,2193.83,36362,182,169,35610,28035,31958,34082,34617
25801,100,221,18425,7376,2.80058e+13,171.102,1839.71,25801,164,151,22169,18713,11512,10728,15479
83945,152,800,60044,23901,2.71853e+13,223.79,4341.06,83945,793,180,79161,62874,65523,70013,71314
96685,75,800,69151,27534,2.72889e+13,257.599,4587.49,96685,738,180,78229,64735,31457,23202,43186
85848,17,800,61408,24440,2.71977e+13,238.588,4378.94,85848,798,175,48576,34855,14267,8601,11517
17769,198,206,12684,5085,2.80108e+13,169.578,1519.6,17769,149,136,17563,17563,17475,17510,17555
19838,50,210,14170,5668,2.80278e+13,169.868,1607.54,19838,153,139,15136,12265,4747,3506,6190
28682,203,226,20489,8193,2.79811e+13,171.294,1942.13,28682,169,156,28456,28456,27642,28028,28433
84585,305,800,60497,24088,2.72825e+13,249.039,4288.03,84585,565,175,83690,83165,82181,82070,82519
31755,355,376,22663,9092,2.82527e+13,171.956,2229.89,31755,189,178,31379,31379,30830,31083,31358
88116,203,334,62939,25177,2.80236e+13,173.097,3472.84,88116,277,175,87782,87782,79611,83784,87651
2746,163,179,1961,785,2.79958e+13,145.327,589.909,2746,88,87,2523,2057,2390,2282,2411
48240,192,261,34455,13785,2.79905e+13,172.35,2538.07,48240,204,175,47979,47979,44009,46020,47910
67493,235,296,48208,19285,2.80041e+13,172.856,3021.47,67493,239,175,67197,67197,63763,65498,67136
95344,185,346,68104,27240,2.79976e+13,173.183,3618.07,95344,289,175,94998,94998,84752,89996,94837
72790,82,306,51988,20802,2.80186e+13,172.925,3142.94,72790,249,175,60365,50642,25560,22687,36553
42798,140,251,30567,12231,2.79801e+13,172.158,2385.77,42798,194,175,39900,32233,30685,30696,34793
65423,192,800,46821,18602,2.69296e+13,223.352,3946.47,65423,766,180,64088,63712,57081,59917,62615
19915,10,210,14227,5688,2.79971e+13,170.129,1611.08,19915,153,139,9105,4932,2734,1330,879
93412,35,343,66720,26692,2.79963e+13,173.179,3579.89,93412,286,175,66184,52687,17739,18246,24558
88762,182,334,63401,25361,2.80053e+13,173.105,3484.94,88762,277,175,88428,88428,78806,83726,88276
62637,24,368,44727,17910,2.80689e+13,171.891,3007.96,62637,233,175,40305,29552,10682,10879,9172
65264,147,292,46619,18645,2.80048e+13,172.798,2969.03,65264,235,175,61724,49407,49630,54437,55674
34119,705,800,24462,9657,2.59404e+13,219.585,3116.35,34119,794,161,33319,33105,29363,31255,33035
26712,28,223,19075,7637,2.80364e+13,171.142,1872.93,26712,166,152,17892,13423,4560,3359,5253
26947,789,951,19318,7629,2.5733e+13,211.092,3060.79,26947,757,166,25996,25854,24702,25220,25511
1977,28,178,1408,569,2.83459e+13,134.146,499.383,1977,83,77,1301,990,361,277,342
58748,42,280,41972,16776,2.79881e+13,172.727,2811.25,58748,224,175,43513,34395,12649,11796,16311
85687,224,329,61205,24482,2.80063e+13,173.065,3421.92,85687,272,175,85358,85358,78918,82202,85253
81098,383,462,57905,23193,2.81204e+13,173.204,3509.27,81098,263,192,80636,80636,76188,78446,80557
88354,282,334,63106,25248,2.80151e+13,173.058,3477.22,88354,276,175,88020,88020,85194,86617,87968
21947,55,214,15673,6274,2.80418e+13,170.563,1693.68,21947,157,143,17020,13952,5495,5273,7678
81257,107,321,58044,23213,2.80014e+13,173.033,3328.36,81257,264,175,71043,59625,39245,44823,52452
83484,193,325,59631,23853,2.80066e+13,173.008,3375.54,83484,268,175,83159,83159,74876,79108,83027
55417,171,414,39563,15854,2.81764e+13,172.694,2907.73,55417,229,184,54600,42944,41676,40236,50920
82326,265,800,58889,23437,2.71641e+13,244.334,4308.36,82326,798,175,81025,80584,70751,75469,79735
12770,67,197,9125,3645,2.79504e+13,167.886,1284.16,12770,139,127,10195,8427,3730,3799,5219
89641,54,336,64031,25610,2.80055e+13,173.12,3503.4,89641,280,175,69486,56881,22076,17369,30012
97400,112,499,69540,27860,2.8099e+13,173.278,3852.64,97400,291,195,85996,72024,37060,28578,57053
81957,45,463,58520,23437,2.81005e+13,173.2,3527.08,81957,264,193,61555,48912,18218,10557,22013
94111,10,344,67224,26887,2.80009e+13,173.183,3593.82,94111,287,175,43041,23305,12933,6290,4431
45477,510,800,32572,12905,2.64805e+13,209.341,3451.02,45477,778,175,44523,44198,41654,42911,43807
91095,206,339,65068,26027,2.80114e+13,173.157,3533.46,91095,282,175,90756,90756,82434,86686,90623
22857,141,215,16324,6533,2.79909e+13,170.434,1727.93,22857,158,145,21311,17244,16453,16168,18535
58798,216,280,42004,16794,2.79931e+13,172.691,2812.31,58798,224,175,58518,58518,54867,56716,58454
63193,56,800,45225,17968,2.6904e+13,213.817,3895.57,63193,798,175,48623,40073,15553,11996,20671
9296,103,190,6646,2650,2.78081e+13,165.705,1092.27,9296,127,117,7967,6791,4243,4209,5764
14041,154,200,10026,4015,2.81177e+13,168.387,1348.44,14041,143,129,13337,10592,11761,12226,12296
75571,365,455,53957,21614,2.81108e+13,173.141,3392.89,75571,262,177,75116,75116,74597,74154,74645
88802,368,800,63522,25280,2.72189e+13,221.135,4436.97,88802,798,180,87659,87048,81218,84066,86666
63207,729,800,45237,17970,2.69048e+13,213.789,3895.96,63207,790,180,62407,62220,59275,60760,62195
37422,24,242,26729,10693,2.80191e+13,171.94,2226.96,37422,185,171,24069,17655,6376,4073,6183
80194,51,319,57282,22912,2.80073e+13,173.018,3305.4,80194,262,175,61513,49721,19739,15106,26269
41417,81,388,29562,11855,2.81922e+13,172.305,2524.21,41417,190,181,34228,28863,12249,9725,17745
71990,456,800,51513,20477,2.70293e+13,224.258,4092.31,71990,775,180,70985,70266,68196,69418,70158
74817,22,309,53438,21379,2.80084e+13,172.949,3187.55,74817,252,175,46791,33275,12727,8540,9955
78288,254,316,55917,22371,2.8004e+13,173.041,3264.67,78288,259,175,77972,77972,74508,76259,77910
32701,97,233,23358,9343,2.79952e+13,171.674,2077.38,32701,176,162,27955,23678,13775,11272,18874
19167,42,208,13693,5474,2.7907e+13,169.906,1579.12,19167,152,139,14177,11211,4130,4639,5324
63184,219,288,45126,18058,2.80265e+13,172.69,2919.16,63184,231,175,62896,62896,58939,60944,62827
54017,99,272,38580,15437,2.80206e+13,172.615,2692.01,54017,215,175,46430,39126,23434,19582,31919
94043,360,485,67154,26889,2.81004e+13,173.326,3777.3,94043,286,193,93558,93558,87437,86289,92021
32209,32,232,23003,9206,2.80032e+13,171.535,2060.72,32209,175,162,22280,16882,5896,4185,6876
73178,151,800,52363,20815,2.70465e+13,215.821,4117.88,73178,798,180,68744,54714,56000,59845,61783
77727,95,315,55516,22211,2.80178e+13,172.98,3252.43,77727,258,175,66292,54508,32063,30965,44676
57028,240,277,40735,16293,2.8025e+13,172.563,2768.06,57028,220,175,56751,56751,54981,55858,56714
36981,393,800,26504,10477,2.61068e+13,214.466,3205.31,36981,798,166,35890,35321,31318,33522,34960
48072,223,261,34338,13734,2.80033e+13,172.385,2533.98,48072,204,175,47811,47811,45938,46870,47773
97268,13,951,69539,27729,2.73757e+13,224.238,4793.35,97268,800,196,49711,33901,14523,6135,10144
12475,162,196,8909,3566,2.79565e+13,167.362,1268.01,12475,137,126,12016,9530,10877,10433,11532
96731,272,800,69183,27548,2.72745e+13,240.377,4587.97,96731,777,180,95499,94963,90086,92169,94209
67144,181,295,47962,19182,2.79945e+13,172.829,3012.85,67144,239,175,66849,66849,59798,63397,66735
56008,712,800,40090,15918,2.67631e+13,230.942,3724.19,56008,704,175,55208,55047,54852,54944,54945
42916,337,396,30634,12282,2.81884e+13,172.492,2575.08,42916,193,193,42520,42520,39382,40968,42461
36039,134,239,25738,10301,2.79965e+13,171.797,2183.78,36039,182,169,33187,27134,23832,22387,28077
34654,219,800,24835,9819,2.5999e+13,211.81,3133.43,34654,790,162,33397,32998,29221,30693,32055
12532,114,197,8946,3586,2.80767e+13,167.522,1271.97,12532,139,126,11037,9259,6582,7334,8452
23644,76,217,16892,6752,2.8024e+13,170.662,1759.06,23644,160,147,19305,16052,7891,8043,11185
28810,328,800,20670,8140,2.5594e+13,215.736,2939.87,28810,724,155,27700,27164,26220,26487,26594
69397,135,300,49572,19825,2.80067e+13,172.902,3066.01,69397,243,175,64137,52284,46397,46899,55218
66889,777,800,47872,19017,2.69477e+13,213.487,3979.54,66889,798,175,66089,65900,62122,64076,66021
53288,19,270,38065,15223,2.79996e+13,172.502,2672.13,53288,213,175,31595,22541,9065,7425,6453
78349,211,316,55963,22386,2.80164e+13,172.964,3265.69,78349,259,175,78033,78033,71609,74883,77928
18895,128,208,13500,5395,2.79884e+13,169.923,1568.25,18895,151,137,17169,14172,11722,10409,14178
23791,30,217,16994,6797,2.80047e+13,170.706,1764.35,23791,160,147,16195,12255,4111,3313,4931
95784,245,347,68415,27369,2.79984e+13,173.176,3627,95784,290,175,95437,95437,89226,92390,95335
22661,135,215,16186,6475,2.80156e+13,170.561,1721.04,22661,158,144,20886,17046,15149,16034,17871
48378,152,261,34554,13824,2.79863e+13,172.305,2541.45,48378,204,175,46155,36622,38764,38773,42086
22066,6,214,15763,6303,2.80245e+13,170.453,1697.69,22066,157,143,7778,2952,1957,1675,875
41703,189,250,29786,11917,2.80429e+13,172.126,2355.05,41703,193,175,41453,41453,38042,39765,41392
19888,97,210,14207,5681,2.79998e+13,170.053,1609.89,19888,153,139,16983,14386,8554,8058,11570
90270,25,337,64481,25789,2.80006e+13,173.141,3516.2,90270,280,175,58904,42921,15357,13213,13414
31241,192,230,22321,8920,2.7974e+13,171.418,2028.42,31241,173,160,31011,31011,29129,30068,30973
25340,154,220,18097,7243,2.80209e+13,170.763,1822.58,25340,162,149,24196,19161,21300,22162,22317
14737,186,200,10519,4218,2.80414e+13,168.289,1380.26,14737,143,130,14537,14537,14261,14382,14523
73597,203,307,52572,21025,2.80194e+13,172.9,3160.67,73597,250,175,73290,73290,66961,70184,73186
35018,233,237,25013,10005,2.79764e+13,171.737,2151.32,35018,180,167,34781,34781,34758,34764,34777
98507,186,352,70360,28147,2.80134e+13,173.206,3680.7,98507,295,175,98155,98155,87602,93002,97989
46011,111,257,32862,13149,2.80276e+13,172.23,2476.87,46011,200,175,40512,33913,23534,26641,30390
73585,155,307,52561,21024,2.80048e+13,172.918,3160.39,73585,250,175,70646,55977,62443,66406,65427
49113,254,263,35076,14037,2.80147e+13,172.321,2562.24,49113,205,175,48850,48850,48735,48782,48841
58951,633,800,42196,16755,2.68218e+13,226.209,3795.55,58951,744,180,58141,57970,57047,57510,57651
79970,271,318,57123,22847,2.7989e+13,173.011,3299.99,79970,261,175,79652,79652,77158,78412,79605
87405,444,800,62519,24886,2.7219e+13,223.382,4409.87,87405,798,180,86360,85653,81614,83846,85537
99298,100,353,70933,28365,2.79972e+13,173.209,3695.76,99298,297,175,85561,72152,44373,41168,59872
44303,266,800,31731,12572,2.64481e+13,218.959,3418.67,44303,738,180,43128,42629,41307,41608,41901
56681,128,277,40481,16200,2.80276e+13,172.579,2759.95,56681,219,175,51657,42600,35225,35480,42427
2301,115,178,1643,658,2.77809e+13,140.01,539.075,2301,85,79,1946,1669,1211,1205,1498
40496,155,247,28920,11576,2.802e+13,172.051,2319.04,40496,190,175,38815,30784,34317,36492,35972
86486,400,475,61753,24733,2.81024e+13,173.248,3627.31,86486,281,177,86011,86011,85444,84890,85566
68593,237,439,48970,19623,2.8142e+13,173,3230.1,68593,253,190,68154,68033,60004,54774,64586
47754,148,260,34112,13642,2.79923e+13,172.291,2524.51,47754,203,175,45225,36149,36470,37924,40932
9172,158,191,6547,2625,2.80923e+13,165.801,1086.23,9172,127,117,8726,6961,7914,8464,8226
98623,12,352,70450,28173,2.7999e+13,173.229,3682.94,98623,296,175,48676,30841,14618,8560,6616
23171,69,216,16550,6621,2.80067e+13,170.691,1740.96,23171,159,145,18628,15346,6871,7450,10017
2148,33,178,1536,612,2.80553e+13,138.137,521.173,2148,83,78,1469,1132,409,423,496
23628,162,217,16874,6754,2.80192e+13,170.736,1758.68,23628,160,146,22878,18069,20626,22047,21919
41706,106,249,29790,11916,2.80106e+13,172.033,2354.04,41706,192,175,36357,30589,19939,22942,26351
12373,41,196,8834,3539,2.80622e+13,167.371,1263.16,12373,137,126,9100,7174,2626,3343,3556
18688,84,207,13353,5335,2.79216e+13,169.826,1558.64,18688,151,138,15494,12991,6693,7163,9791
76017,11,311,54297,21720,2.8009e+13,172.911,3213.88,76017,254,175,36146,22273,11136,6468,5516
73271,193,449,52317,20954,2.81362e+13,173.09,3340.02,73271,248,192,72816,72680,44017,26066,62577
94941,454,800,67899,27042,2.72741e+13,238.64,4554.59,94941,778,180,93931,93176,90911,92231,93103
61825,526,800,44248,17577,2.69027e+13,221.015,3863.86,61825,769,180,60896,60516,58702,59599,60203
87670,402,481,62592,25078,2.81051e+13,173.24,3655.64,87670,290,180,87189,87189,85692,84859,86407
34820,231,237,24870,9950,2.80061e+13,171.673,2145.54,34820,180,167,34583,34583,34529,34548,34577
35899,631,800,25730,10169,2.60662e+13,207.953,3172.26,35899,774,164,35070,34901,32826,33893,34592
69799,108,300,49860,19939,2.80068e+13,172.904,3074.54,69799,244,175,61124,51208,34091,31951,45290
99845,143,355,71314,28531,2.80173e+13,173.191,3707.33,99845,297,175,93762,75433,73799,81713,82621
32997,225,234,23572,9425,2.80173e+13,171.687,2087.51,32997,177,163,32763,32763,32648,32696,32754
79856,303,319,57031,22825,2.80272e+13,173.005,3298.72,79856,261,175,79537,79537,79177,79332,79521
73916,118,308,52796,21120,2.80012e+13,172.969,3168.16,73916,251,175,66064,54762,40636,35724,51614
76941,227,314,54956,21985,2.80185e+13,172.965,3235.59,76941,256,175,76627,76627,71464,74089,76540
66804,440,800,47817,18987,2.69441e+13,224.178,3977.97,66804,769,180,65790,65090,63370,64410,64924
91302,90,800,65312,25990,2.72246e+13,229.531,4485.21,91302,791,180,76244,63199,34978,35530,48345
35295,97,238,25208,10087,2.79762e+13,171.819,2160.59,35295,181,168,30165,25557,14892,14986,20434
35714,200,238,25509,10205,2.80068e+13,171.756,2172.91,35714,181,168,35476,35476,33602,34535,35438
10749,137,194,7681,3068,2.80183e+13,167.023,1177.4,10749,133,122,9871,8056,7307,7712,8510
59828,116,282,42733,17095,2.80266e+13,172.653,2837.82,59828,225,175,53238,44322,31597,35927,41053
35084,750,800,25151,9933,2.60255e+13,208.386,3146.89,35084,772,163,34284,34125,32447,33263,34135
76471,93,312,54623,21848,2.79937e+13,172.961,3224.12,76471,255,175,64927,53489,30460,27843,42233
90714,258,339,64795,25919,2.8011e+13,173.118,3526.38,90714,281,175,90375,90375,85624,88036,90294
82266,587,800,58848,23418,2.71548e+13,224.246,4307.21,82266,789,180,81378,80978,77976,79499,80827
98660,159,352,70469,28191,2.79971e+13,173.179,3683.32,98660,295,175,95492,75428,86250,92453,89888
15523,156,202,11087,4436,2.80182e+13,169.018,1418.56,15523,145,131,14827,11770,13151,13938,13833
22203,5,215,15856,6347,2.80354e+13,170.422,1703.79,22203,157,144,6909,2455,1489,1285,610
66935,439,443,47792,19143,2.81049e+13,173.013,3199.34,66935,237,195,66492,66492,66467,66474,66488
1779,153,177,1270,509,2.80979e+13,129.67,473.711,1779,75,75,1560,1303,1372,1403,1423
58380,180,280,41702,16678,2.80029e+13,172.709,2802.59,58380,223,175,58100,58100,52052,55133,58000
65813,47,293,47005,18808,2.80044e+13,172.808,2982.04,65813,236,175,49764,39852,15138,16809,20264
95088,130,346,67918,27170,2.80078e+13,173.155,3613.33,95088,289,175,87087,71666,59842,60532,72622
21429,9,212,15311,6118,2.79244e+13,170.323,1671.68,21429,156,143,9365,4516,2668,1744,2093
12518,160,346,8914,3604,2.8636e+13,168.724,1450.74,12518,142,132,11868,9537,9531,9600,10633
68987,193,800,49371,19616,2.69854e+13,219.194,4026.54,68987,782,180,67647,67269,60222,63273,66170
31623,153,231,22584,9039,2.80458e+13,171.359,2041.49,31623,174,161,30161,23922,25929,27347,27751
50974,94,266,36413,14561,2.80001e+13,172.501,2611.84,50974,209,175,43345,35640,20568,17747,28813
56071,137,276,40043,16028,2.80362e+13,172.574,2744.58,56071,218,175,51995,42239,38195,40428,44762
75268,251,310,53762,21506,2.79959e+13,172.954,3197.84,75268,253,175,74958,74958,71671,73330,74899
62283,178,286,44480,17803,2.80115e+13,172.667,2897.01,62283,229,175,61997,61997,55363,58746,61889
75945,128,312,54239,21706,2.80318e+13,172.924,3213.47,75945,254,175,69241,57089,47211,47530,56865
18501,64,207,13220,5281,2.7945e+13,169.862,1551.22,18501,151,138,14683,12185,5097,5749,7606
83054,580,800,59419,23635,2.71531e+13,218.959,4323.08,83054,798,180,82124,81724,76302,79076,81594
67288,301,800,48152,19136,2.69637e+13,219.103,3988.62,67288,798,175,66073,65573,59217,62215,64919
28782,569,941,20637,8145,2.58534e+13,217.398,3115.98,28782,794,168,27735,27394,24202,22817,25120
16488,4,204,11782,4706,2.80094e+13,169.115,1462.82,16488,147,134,4322,1305,952,1164,444
42722,578,800,30604,12118,2.63755e+13,221.977,3374.56,42722,714,176,41864,41464,41085,41261,41256
73103,587,800,52312,20791,2.70261e+13,220.658,4116.1,73103,798,175,72168,71775,65539,68727,71664
61613,143,285,44006,17607,2.79915e+13,172.714,2881.12,61613,228,175,57819,46532,45525,45088,51028
59766,40,283,42687,17079,2.80179e+13,172.63,2837.19,59766,225,175,43848,34362,12460,15360,16588
34829,207,237,24876,9953,2.80069e+13,171.609,2145.59,34829,180,167,34592,34592,33245,33907,34562
97375,31,350,69555,27820,2.80065e+13,173.192,3658.58,97375,294,175,66887,50702,17443,12525,19965
30143,64,228,21538,8605,2.7956e+13,171.406,1991.67,30143,172,159,23970,19870,8311,7431,12126
29970,203,228,21409,8561,2.79813e+13,171.388,1986.03,29970,171,158,29742,29742,28764,29235,29717
21229,138,212,15165,6064,2.79687e+13,170.183,1663.9,21229,155,142,19677,15974,14819,14522,16904
87634,53,333,62592,25042,2.80139e+13,173.146,3462.84,87634,276,175,67688,55598,21405,20469,29727
48736,153,262,34813,13923,2.80003e+13,172.384,2551.75,48736,206,175,46572,36884,40010,42193,42897
20214,73,211,14435,5779,2.80568e+13,170.105,1623.69,20214,154,140,16385,13464,6453,6732,9116
75680,39,311,54055,21625,2.80091e+13,172.915,3207.18,75680,253,175,55261,43244,16029,17674,20324
42187,605,800,30228,11959,2.63528e+13,208.414,3359.18,42187,783,175,41323,40923,38409,39683,40802
96307,308,349,68788,27519,2.80159e+13,173.168,3638.31,96307,291,175,95958,95958,93922,94938,95917
94964,281,346,67831,27133,2.80118e+13,173.191,3611.28,94964,289,175,94618,94618,90931,92796,94553
21858,37,214,15614,6244,2.80076e+13,170.566,1690.15,21858,157,144,15695,12351,4381,4106,5529
95975,131,347,68560,27415,2.79954e+13,173.185,3630.41,95975,291,175,88058,72332,60733,56229,73152
13359,37,198,9544,3815,2.79932e+13,168.175,1313.95,13359,141,127,9581,7549,2658,3350,3625
34589,112,236,24713,9876,2.79732e+13,171.751,2137.64,34589,180,167,30489,25546,17903,16230,22919
95163,608,800,68064,27099,2.72726e+13,261.011,4558.54,95163,673,175,94363,93990,93916,93862,93789
86256,73,330,61611,24645,2.80044e+13,173.1,3433.72,86256,273,175,70130,57526,27465,28585,39779
2463,20,178,1758,705,2.81838e+13,140.541,556.739,2463,88,83,1485,1057,434,384,437
52599,259,270,37568,15031,2.80211e+13,172.482,2655.49,52599,212,175,52329,52329,52183,52245,52318
68034,35,297,48597,19437,2.80112e+13,172.861,3034.01,68034,240,175,48195,38371,13057,15253,14719
21447,118,357,15290,6157,2.84589e+13,170.756,1853.1,21447,170,160,19041,15889,8898,7467,13250
45966,336,800,32923,13043,2.64959e+13,208.956,3464.61,45966,786,175,44830,44289,41025,42508,43774
17081,109,205,12201,4880,2.79603e+13,169.359,1489.49,17081,148,135,14916,12537,8419,8233,10949
89599,176,800,64091,25508,2.7214e+13,221.363,4452.35,89599,798,180,88187,87844,77117,82021,86623
26932,220,223,19236,7696,2.80374e+13,171.188,1880.57,26932,166,152,26709,26709,26697,26699,26706
61034,278,284,43596,17438,2.79987e+13,172.724,2867.18,61034,227,175,60750,60750,60698,60716,60744
10025,58,192,7163,2862,2.79771e+13,166.111,1135.34,10025,131,120,7813,6418,2645,2039,3619
78440,109,800,56109,22331,2.71366e+13,221.511,4229.03,78440,798,175,68002,57074,37671,43000,49576
53926,133,272,38515,15411,2.80209e+13,172.524,2689.62,53926,215,175,49622,40623,34887,36851,42104
26458,12,222,18896,7562,2.7965e+13,171.083,1863.2,26458,165,152,13051,8263,3921,2437,1859
14205,22,199,10151,4054,2.78722e+13,168.603,1355.39,14205,143,130,8863,6304,2409,1741,2507
70712,11,302,50504,20208,2.80156e+13,172.853,3095.53,70712,245,175,33627,20719,10360,6406,7720
60103,42,283,42921,17182,2.80201e+13,172.587,2844.75,60103,225,175,44535,35216,12973,16222,17469
84338,86,326,60239,24099,2.79901e+13,173.043,3392.98,84338,269,175,70543,58850,31161,28722,43120
34453,368,382,24585,9868,2.82634e+13,172.075,2318.13,34453,193,182,34071,34071,33837,33944,34057
18750,191,208,13398,5352,2.80095e+13,169.833,1562.17,18750,151,138,18542,18542,18127,18306,18525
50692,282,800,36299,14393,2.66227e+13,213.976,3590.08,50692,769,179,49519,49007,46756,47577,48338
16566,11,204,11835,4731,2.80051e+13,169.252,1466.52,16566,147,134,7873,4848,2424,1343,1676
2686,112,179,1924,762,2.77829e+13,144.884,583.129,2686,88,82,2269,1949,1389,1359,1702
66126,75,294,47234,18892,2.80188e+13,172.833,2989.95,66126,237,175,53990,44574,21880,18938,30744
59901,742,945,42855,17046,2.69627e+13,222.055,4003.73,59901,760,197,58956,58800,57505,57886,58347
4041,73,181,2889,1152,2.78387e+13,153.733,715.323,4041,100,95,3227,2683,1343,1146,1814
85530,214,800,61180,24350,2.72001e+13,225.233,4372.79,85530,798,175,84199,83781,75903,79446,82756
49725,16,413,35493,14232,2.81454e+13,172.645,2769.04,49725,218,177,27557,19371,8224,4501,6864
34624,203,237,24736,9888,2.79815e+13,171.803,2139.74,34624,180,167,34387,34387,32831,33598,34353
23596,213,217,16859,6737,2.79853e+13,170.776,1757.35,23596,160,147,23379,23379,23363,23367,23375
56294,284,800,40301,15993,2.67546e+13,224.395,3730.92,56294,798,175,55060,54599,48051,51126,53874
9401,15,315,6700,2701,2.898e+13,156.81,1250.31,9401,125,127,5069,3502,1536,660,378
32246,111,233,23035,9211,2.79972e+13,171.737,2063.4,32246,176,162,28363,23744,16483,15162,21148
54558,356,415,38951,15607,2.8158e+13,172.78,2889.39,54558,229,182,54143,54143,52489,51998,53719
19679,47,210,14052,5627,2.80467e+13,170.153,1601.91,19679,153,139,14843,11901,4534,3378,5858
51073,166,267,36475,14598,2.80258e+13,172.374,2615.07,51073,209,175,49987,39393,44781,47864,48320
90344,63,338,64531,25813,2.80167e+13,173.125,3518.41,90344,281,175,71820,59284,24694,19313,35192
98211,108,800,70242,27969,2.73007e+13,238.272,4615.63,98211,783,180,85196,71452,47039,45749,62062
60481,3,283,43201,17280,2.79986e+13,172.712,2853.66,60481,226,175,12679,2838,2621,3278,1039
40202,194,247,28720,11482,2.80253e+13,172.118,2310.93,40202,190,175,39955,39955,37088,38531,39902
14268,29,200,10194,4074,2.7986e+13,168.607,1358.82,14268,143,130,9623,7259,2419,3046,3067
84863,180,941,60679,24184,2.73291e+13,249.821,4516.36,84863,766,192,83512,83057,54278,37439,1166
98765,267,352,70554,28211,2.79929e+13,173.186,3685.24,98765,296,175,98413,98413,93327,95913,98328
60626,197,284,43309,17317,2.80223e+13,172.743,2858,60626,227,175,60342,60342,55163,57796,60255
30303,86,228,21644,8659,2.79898e+13,171.302,1996.75,30303,171,158,25298,21137,11253,14583,16128
45325,243,256,32376,12949,2.80137e+13,172.251,2457.85,45325,199,175,45069,45069,44848,44944,45056
45596,251,257,32571,13025,2.79985e+13,172.357,2466.22,45596,200,175,45339,45339,45300,45312,45333
30753,222,230,21964,8789,2.80289e+13,171.457,2013.2,30753,173,159,30523,30523,30431,30468,30515
44379,232,254,31699,12680,2.80082e+13,172.22,2431.09,44379,197,175,44125,44125,43357,43721,44103
10711,183,193,7652,3059,2.79467e+13,166.46,1173.77,10711,131,122,10518,10518,10376,10437,10508
49891,118,265,35632,14259,2.80153e+13,172.465,2583.78,49891,208,175,44553,36951,27446,30125,34802
84636,29,327,60452,24184,2.80097e+13,173.049,3399.71,84636,270,175,57222,43154,14412,12256,19146
15055,20,201,10753,4302,2.79447e+13,168.856,1396.4,15055,144,131,9099,6444,2568,1801,2465
7742,28,188,5530,2212,2.8007e+13,163.696,995.971,7742,123,111,5169,3885,1326,935,1417
11623,81,195,8302,3321,2.7995e+13,167.209,1224.14,11623,135,125,9565,8070,4109,3831,5567
84578,195,327,60413,24165,2.80089e+13,173.064,3398.66,84578,270,175,84251,84251,76004,80218,84119
16457,102,204,11755,4702,2.80536e+13,169.36,1461.92,16457,147,134,14165,11979,7404,6917,10028
54692,103,273,39066,15626,2.80094e+13,172.565,2708.92,54692,216,175,47415,40118,24756,23480,33569
90372,63,338,64550,25822,2.80236e+13,173.122,3518.95,90372,281,175,71844,59303,25190,18334,34798
26482,115,222,18916,7566,2.80087e+13,170.993,1863.96,26482,165,151,23487,19597,13946,13346,18225
68346,183,297,48827,19519,2.79821e+13,172.825,3040.56,68346,241,175,68049,68049,60993,64592,67935
28720,220,225,20516,8204,2.79833e+13,171.152,1942.28,28720,169,156,28495,28495,28457,28469,28490
83099,148,324,59354,23745,2.80042e+13,173.039,3367.01,83099,267,175,78779,62925,63501,66046,70876
57378,248,800,41073,16305,2.68087e+13,214.1,3757.49,57378,777,180,56163,55681,52843,53880,54868
63642,60,289,45461,18181,2.79996e+13,172.756,2930.38,63642,232,175,50189,40950,17056,15102,24048
92764,114,342,66256,26508,2.80128e+13,173.124,3566.97,92764,285,175,82290,68745,48516,54204,63087
87374,626,800,62503,24871,2.7198e+13,228.354,4408.93,87374,798,175,86456,86284,78460,82498,86052
14473,115,200,10337,4136,2.80957e+13,168.314,1368.48,14473,143,130,12775,10699,7623,8595,9863
48217,164,261,34437,13780,2.80038e+13,172.368,2537.53,48217,204,175,47021,36925,42237,45162,45205
5738,36,184,4100,1638,2.78503e+13,160.421,855.418,5738,112,104,4068,3232,1159,878,1409
10828,109,194,7737,3091,2.8074e+13,167.005,1181.58,10828,133,123,9422,7925,5312,5341,7034
80248,87,800,57408,22840,2.71463e+13,238.545,4266.36,80248,755,180,66510,55472,29821,23945,41019
36388,25,240,25990,10398,2.80104e+13,171.864,2194.97,36388,183,169,23733,17301,6209,5874,7150
62137,689,800,44471,17666,2.68854e+13,219.401,3871.15,62137,798,175,61312,61096,55500,58355,61005
99013,8,354,70720,28293,2.8011e+13,173.175,3691.62,99013,296,175,41179,18806,11462,7710,4392
1832,161,178,1313,519,2.80508e+13,132.738,481.404,1832,75,73,1626,1345,1528,1581,1543
22243,95,214,15893,6350,2.79913e+13,170.518,1704.47,22243,158,144,18908,15579,9187,8708,12719
59418,238,800,42530,16888,2.68337e+13,218.495,3806.62,59418,770,180,58185,57717,54984,55909,56860
93788,205,344,66987,26801,2.80162e+13,173.156,3587.74,93788,287,175,93444,93444,84714,89176,93305
41222,204,249,29442,11780,2.80354e+13,172.122,2341.02,41222,192,175,40973,40973,38655,39813,40928
58348,97,280,41672,16676,2.80232e+13,172.585,2801.66,58348,222,175,49951,42282,24641,30084,34557
76862,58,313,54901,21961,2.8007e+13,172.956,3233.05,76862,256,175,60294,49330,19588,16860,27544
99200,221,800,70942,28258,2.73053e+13,230.891,4633.96,99200,798,180,97861,97427,88607,92630,96413
98088,434,496,70039,28049,2.80913e+13,173.329,3862.16,98088,293,193,97592,97592,94269,95947,97530
17603,122,206,12572,5031,2.8027e+13,169.43,1512.48,17603,149,135,15785,13112,10250,10841,12673
88101,61,333,62925,25176,2.80172e+13,173.067,3471.56,88101,276,175,69698,57029,23801,37773,36117
18715,58,208,13364,5351,2.80169e+13,169.907,1561.07,18715,151,138,14637,11994,4785,5640,7027
11879,194,196,8483,3396,2.81147e+13,167.388,1238.23,11879,137,125,11683,11683,11679,11679,11681
46570,161,259,33265,13305,2.80116e+13,172.345,2493.38,46570,202,175,45149,35570,40682,43567,42771
51246,720,800,36697,14549,2.66371e+13,213.001,3604.25,51246,773,177,50446,50263,48503,49384,50207
43434,128,397,30999,12435,2.81991e+13,172.443,2589.77,43434,210,184,39513,32655,23173,18492,30213
63779,43,289,45562,18217,2.79946e+13,172.822,2933.67,63779,233,175,47473,37575,14198,13506,18013
9851,162,192,7033,2818,2.80284e+13,165.507,1125.39,9851,128,119,9451,7514,8559,9117,8979
81715,772,800,58450,23265,2.71604e+13,225.185,4296.07,81715,798,175,80915,80682,74004,77489,80832
67223,59,295,48017,19206,2.79867e+13,172.818,3014.55,67223,238,175,52871,43131,17786,18862,24699
13455,5,198,9617,3838,2.79399e+13,168.309,1318.72,13455,142,128,4172,1470,896,967,429
33650,29,235,24040,9610,2.80092e+13,171.683,2108.24,33650,178,164,22735,17150,5730,5362,5810
85438,304,328,61032,24406,2.79989e+13,173.115,3416.24,85438,272,175,85110,85110,84171,84623,85086
43895,17,254,31354,12541,2.80411e+13,172.193,2418.16,43895,197,175,24914,17706,7393,4543,6012
23983,90,217,17132,6851,2.79859e+13,170.53,1770.85,23983,160,147,20188,16722,9397,9102,13174
59497,138,282,42492,17005,2.80192e+13,172.592,2830.02,59497,224,175,55293,44830,41619,43012,47498
41131,116,248,29379,11752,2.79913e+13,172.12,2337.48,41131,191,175,36581,30456,21717,19588,28284
27770,52,224,19840,7930,2.79822e+13,171.274,1910.07,27770,168,154,21335,17300,6878,4995,9023
4172,11,182,2975,1197,2.82817e+13,154.926,728.415,4172,104,97,1976,1229,618,283,236
59216,160,281,42297,16919,2.80095e+13,172.656,2822.7,59216,224,175,57360,45252,51736,55437,54482
53917,133,272,38515,15402,2.80203e+13,172.579,2689.57,53917,215,175,49613,40610,34874,36819,42017
6137,20,185,4387,1750,2.79211e+13,161.518,885.835,6137,115,105,3700,2613,1041,605,674
70613,54,302,50438,20175,2.8009e+13,172.891,3093.62,70613,245,175,54726,44794,17413,15967,24582
46580,173,258,33272,13308,2.79965e+13,172.284,2492.52,46580,201,175,46158,36585,41260,43835,45740
90820,427,800,64956,25864,2.72466e+13,247.449,4476.11,90820,753,180,89800,89062,87822,88621,88901
9466,163,191,6760,2706,2.79782e+13,165.875,1103.09,9466,128,117,9095,7207,8269,8774,8707
19118,194,208,13656,5462,2.7927e+13,169.799,1576.98,19118,151,138,18910,18910,18632,18753,18896
9657,133,192,6893,2764,2.8125e+13,165.817,1115,9657,129,119,8793,7237,6232,6592,7530
59402,181,800,42515,16887,2.68386e+13,225.377,3806.26,59402,798,175,58053,57701,50661,53699,56559
37163,172,242,26538,10625,2.80514e+13,171.755,2219.31,37163,184,171,36723,29117,32916,34947,36328
38939,114,244,27817,11122,2.79869e+13,171.973,2272.25,38939,187,174,34488,28835,20424,18425,26233
52038,33,269,37167,14871,2.80228e+13,172.459,2640.79,52038,211,175,36301,27754,9612,8116,12255
88861,390,800,63566,25295,2.72119e+13,250.638,4438.27,88861,798,175,87672,87107,76629,82164,86745
77216,398,463,55129,22087,2.81046e+13,173.122,3433.26,77216,255,195,76753,76753,73225,75008,76688
19856,144,210,14190,5666,2.79881e+13,170.166,1608.83,19856,153,140,18567,14960,14711,16283,16450
84099,642,800,60146,23953,2.73497e+13,247.21,4225.29,84099,503,175,83299,83299,83152,83105,83242
56701,155,276,40501,16200,2.79805e+13,172.594,2759.47,56701,219,175,54424,43127,48085,47385,50177
80011,295,463,57124,22887,2.81382e+13,173.129,3488.32,80011,268,192,79548,79431,76073,71681,75989
29496,20,228,21068,8428,2.80347e+13,171.314,1970.63,29496,171,157,17858,12648,5038,3214,4625
9411,157,191,6723,2688,2.80071e+13,165.803,1099.62,9411,127,117,8948,7119,8132,8418,8392
62696,150,288,44777,17919,2.80358e+13,172.714,2908.32,62696,230,175,59608,47461,48691,52965,54152
4217,133,182,3011,1206,2.81468e+13,155.356,732.251,4217,104,97,3783,3140,2718,2875,3247
98724,115,352,70523,28201,2.79932e+13,173.204,3684.6,98724,295,175,87745,73160,51948,49669,66661
89250,307,336,63748,25502,2.80241e+13,173.11,3496.05,89250,279,175,88914,88914,87679,88282,88885
49011,406,800,35094,13917,2.6582e+13,223.578,3545.95,49011,726,178,47979,47329,46560,47108,47029
86080,144,329,61489,24591,2.79864e+13,173.102,3429.39,86080,273,175,80979,65023,63917,63157,71811
67868,695,800,48568,19300,2.6978e+13,225.746,4001.96,67868,767,180,67068,66887,65412,66136,66754
55887,87,275,39920,15967,2.80127e+13,172.561,2739.37,55887,218,175,46818,38990,21274,26990,30019
55007,55,274,39286,15721,2.80256e+13,172.593,2717.55,55007,217,175,42752,34996,13749,10781,18839
67975,248,800,48638,19337,2.69895e+13,221.117,4003.86,67975,798,175,66702,66259,59454,62558,65387
17055,56,204,12181,4874,2.79947e+13,169.149,1487.28,17055,147,134,13267,10906,4336,5490,6496
96795,316,349,69140,27655,2.80056e+13,173.192,3647.2,96795,292,175,96446,96446,94904,95668,96413
4504,131,182,3221,1283,2.79782e+13,156.134,756.355,4504,104,99,4021,3360,2838,2651,3323
10496,181,193,7498,2998,2.80095e+13,166.515,1162.19,10496,131,121,10303,10303,10107,10193,10291
19738,21,210,14100,5638,2.80129e+13,170.14,1604.26,19738,153,139,12153,8665,3363,2830,2582
97440,248,351,69601,27839,2.80123e+13,173.202,3660.69,97440,294,175,97089,97089,90837,94023,96986
24206,248,367,17265,6941,2.83153e+13,171.293,1966.06,24206,176,165,23839,23718,20161,17806,22572
45961,207,257,32824,13137,2.80213e+13,172.24,2475.5,45961,200,175,45704,45704,43054,44385,45654
94725,645,800,67755,26970,2.72679e+13,226.175,4550.53,94725,798,178,93833,93652,86418,90121,93461
91246,235,339,65176,26070,2.80067e+13,173.124,3536.16,91246,282,175,90907,90907,84568,87798,90803
61431,435,800,43963,17468,2.68781e+13,216.715,3854.29,61431,777,180,60403,59726,57378,58741,59536
34101,173,236,24358,9743,2.80309e+13,171.72,2123.01,34101,179,166,33745,26763,30328,32116,33406
60011,235,283,42870,17141,2.80185e+13,172.723,2843.09,60011,226,175,59728,59728,57205,58469,59680
49995,21,264,35716,14279,2.79879e+13,172.492,2585.59,49995,208,175,30807,21957,8501,6058,8391
21029,421,800,15111,5918,2.4733e+13,214.852,2645.18,21029,763,137,19998,19397,17701,18728,19092
29747,44,228,21249,8498,2.79968e+13,171.394,1978.68,29747,171,158,22229,17567,6725,6158,8629
2834,7,179,2021,813,2.76735e+13,146.023,598.92,2834,90,85,1081,434,304,238,150
41326,152,248,29523,11803,2.79989e+13,172.083,2342.79,41326,191,175,39405,31271,33107,35471,36042
79268,112,318,56620,22648,2.80219e+13,173.003,3286.1,79268,261,175,70004,58590,41015,46010,53031
13684,138,199,9768,3916,2.80796e+13,167.835,1330.05,13684,141,128,12634,10286,9551,9880,10861
40543,799,800,29051,11492,2.62858e+13,210.815,3311.97,40543,794,172,39743,39583,39649,39649,39740
50956,175,267,36391,14565,2.80238e+13,172.443,2612.24,50956,209,175,50689,50689,45183,47984,50597
53181,21,270,37989,15192,2.80003e+13,172.525,2669.61,53181,213,175,32780,23367,9043,5481,7745
56249,106,416,40160,16089,2.81526e+13,172.745,2929.85,56249,228,175,48997,41294,26571,25752,35276
28858,218,226,20610,8248,2.80447e+13,171.203,1947.81,28858,169,156,28632,28632,28546,28579,28624
19692,5,300,14076,5616,2.77278e+13,168.756,1711.07,19692,153,139,6153,2169,1347,1127,511
1582,145,177,1128,454,2.8213e+13,123.125,445.407,1582,72,69,1364,1157,1130,1228,1242
5841,22,185,4177,1664,2.81791e+13,160.682,863.899,5841,113,105,3644,2600,1013,838,1070
42410,131,396,30273,12137,2.81861e+13,172.489,2560.98,42410,207,176,38786,31951,25074,23060,31173
98161,176,352,70110,28051,2.80175e+13,173.178,3674.51,98161,294,175,97809,97809,86563,92320,97633
47120,69,259,33653,13467,2.80103e+13,172.326,2507.46,47120,202,175,37942,31248,13979,15107,20652
4527,125,182,3232,1295,2.78365e+13,156.628,758.778,4527,104,99,4002,3365,2732,2432,3210
38148,203,243,27249,10899,2.79988e+13,171.947,2248.8,38148,186,173,37905,37905,35911,36905,37865
58520,182,280,41794,16726,2.80154e+13,172.589,2805.6,58520,222,175,58240,58240,52286,55319,58142
79463,356,800,56851,22612,2.71239e+13,226.387,4249.97,79463,781,180,78353,77726,74923,76165,77331
28366,159,225,20264,8102,2.798e+13,171.097,1930.31,28366,168,155,27357,21658,24722,25275,25798
81029,79,320,57881,23148,2.80002e+13,173.006,3322.7,81029,263,175,66755,55661,27454,34463,40327
51326,137,266,36661,14665,2.79974e+13,172.409,2620.36,51326,209,175,47591,38668,34984,37005,40801
18832,91,800,13535,5297,2.4583e+13,195.708,2509.81,18832,711,134,15228,12674,6792,5050,355
8418,164,189,6011,2407,2.79324e+13,164.763,1038.92,8418,123,114,8086,6410,7397,7074,7763
8852,171,190,6322,2530,2.80102e+13,165.193,1066.03,8852,125,115,8606,6816,8107,8366,8541
67826,228,297,48446,19380,2.80161e+13,172.858,3029.62,67826,240,175,67529,67529,63579,65577,67460
25996,30,221,18568,7428,2.8007e+13,170.97,1846.36,25996,164,151,17701,13390,4485,4701,4332
34640,179,236,24737,9903,2.80175e+13,171.575,2138.81,34640,179,166,34404,34404,31238,32836,34347
61175,173,800,43781,17394,2.68571e+13,233.458,3848.48,61175,709,176,59601,47288,52039,55239,57662
90870,78,338,64904,25966,2.80048e+13,173.131,3528.17,90870,281,175,74705,62251,30449,33744,44719
49159,6,263,35116,14043,2.80057e+13,172.386,2563.35,49159,206,175,17342,6584,4360,2930,1604
93122,312,342,66524,26598,2.80004e+13,173.2,3573.77,93122,286,175,92780,92780,91432,92094,92750
16088,105,203,11488,4600,2.79969e+13,169.079,1444.33,16088,146,133,13953,11775,7547,7170,10047
98546,346,800,70476,28070,2.73036e+13,224.954,4621.86,98546,798,180,97372,96774,90288,93416,96296
3243,75,180,2318,925,2.80906e+13,150.076,641.357,3243,95,90,2579,2158,1063,973,1436
67012,216,295,47868,19144,2.79992e+13,172.84,3010.11,67012,238,175,66717,66717,62055,64423,66638
25052,118,219,17897,7155,2.79776e+13,170.934,1811.65,25052,162,149,22342,18534,13747,12117,17310
25116,25,220,17940,7176,2.80577e+13,170.841,1814.61,25116,163,149,16378,11950,4304,2973,4654
81547,92,800,58342,23205,2.71455e+13,250.077,4292.79,81547,692,175,68283,56387,31410,39305,44552
35918,84,239,25651,10267,2.79888e+13,171.834,2180.09,35918,182,169,29866,24981,12799,13750,18858
86837,151,331,62028,24809,2.80034e+13,173.083,3445.69,86837,274,175,82786,65755,68553,73552,76172
67596,65,296,48282,19314,2.79989e+13,172.802,3023.43,67596,239,175,53966,44601,18705,16918,27284
96880,239,349,69196,27684,2.80028e+13,173.184,3648.61,96880,292,175,96531,96531,89773,93220,96421
25548,740,800,18340,7208,2.52134e+13,214.321,2821.94,25548,733,149,24748,24602,24169,24346,24569
48092,92,261,34351,13741,2.80063e+13,172.362,2534.48,48092,204,175,40727,33540,18901,18825,26737
39982,253,800,28649,11333,2.62496e+13,212.197,3295.42,39982,757,172,38786,38316,36448,37009,37537
97665,43,354,69766,27899,2.79968e+13,173.216,3668.13,97665,294,175,72718,57546,21743,15539,27027
4723,72,183,3369,1354,2.82019e+13,156.38,775.271,4723,106,100,3778,3141,1532,2139,2186
52595,79,269,37571,15024,2.79991e+13,172.48,2654.31,52595,212,175,43308,36115,17831,18130,25865
72308,35,305,51649,20659,2.80145e+13,172.932,3132.11,72308,248,175,51229,40780,14260,17818,18818
97323,808,944,69581,27742,2.73863e+13,235.374,4787.66,97323,800,193,96379,96379,87364,91776,95972
63570,287,289,45407,18163,2.80091e+13,172.74,2928.9,63570,232,175,63281,63281,63275,63276,63279
53078,517,800,38003,15075,2.67125e+13,228.647,3651.16,53078,796,175,52075,51785,45440,48659,51429
41155,47,249,29389,11766,2.80332e+13,172.019,2339.06,41155,191,175,31108,24928,9487,11358,13153
93224,356,800,66679,26545,2.72584e+13,229.601,4522.09,93224,798,175,92032,91462,83054,87224,90996
26567,96,222,18972,7595,2.79987e+13,171.053,1867.05,26567,165,152,22652,18616,11066,11209,15264
43785,219,253,31276,12509,2.79989e+13,172.202,2414.2,43785,196,175,43532,43532,41935,42725,43498
77913,77,315,55651,22262,2.80105e+13,172.969,3256.1,77913,258,175,63909,53235,26226,27238,37007
83834,9,325,59880,23954,2.80039e+13,173.016,3382.26,83834,268,175,36679,17741,10459,6672,8077
80441,287,319,57462,22979,2.79948e+13,173.013,3310.23,80441,263,175,80122,80122,78647,79376,80090
92117,77,340,65797,26320,2.80032e+13,173.109,3553.03,92117,283,175,75567,62948,31017,33878,45115
2427,25,179,1726,701,2.84279e+13,140.036,554.272,2427,89,83,1575,1155,445,321,460
36281,91,240,25915,10366,2.80309e+13,171.856,2191.85,36281,183,169,30636,25291,14205,13822,20248
46709,26,401,33334,13375,2.81933e+13,172.568,2680.45,46709,215,177,30810,22621,8000,6056,9631
49665,236,264,35474,14191,2.79868e+13,172.434,2577.05,49665,207,175,49401,49401,48249,48810,49373
95280,245,346,68056,27224,2.80031e+13,173.177,3616.87,95280,289,175,94934,94934,88788,91920,94833
72359,119,800,51774,20585,2.70588e+13,215.985,4100.42,72359,798,175,63918,53100,38955,42322,49223
92233,131,341,65878,26355,2.80138e+13,173.176,3556.43,92233,284,175,84630,69502,58342,55042,71099
89173,246,800,63785,25388,2.7213e+13,239.631,4444.03,89173,798,175,87854,87419,77595,82253,86495
49541,155,263,35383,14158,2.80057e+13,172.337,2572.91,49541,206,175,47524,37678,42006,44672,44041
1067,166,176,759,308,2.82393e+13,101.199,366.281,1067,63,62,891,775,866,879,869
69506,316,800,49738,19768,2.69905e+13,232.94,4037.97,69506,747,180,68378,67787,66413,66825,67254
15087,136,201,10773,4314,2.79972e+13,168.707,1397.48,15087,144,131,13898,11341,10195,10122,11796
50610,120,266,36149,14461,2.80207e+13,172.445,2602.75,50610,209,175,45394,37575,28306,30771,35912
25630,212,220,18303,7327,2.8028e+13,170.806,1832.58,25630,163,150,25410,25410,25318,25355,25402
5491,61,184,3921,1570,2.80265e+13,159.989,837.115,5491,110,104,4288,3531,1491,1701,2115
53825,99,271,38447,15378,2.79923e+13,172.514,2686.09,53825,214,175,46261,38999,23399,23507,32282
81975,282,323,58549,23426,2.80292e+13,172.993,3344.29,81975,265,175,81652,81652,79605,80624,81611
16353,140,203,11681,4672,2.79135e+13,169.088,1456.02,16353,146,133,15182,12295,11693,11714,13240
93294,30,343,66635,26659,2.80137e+13,173.166,3577.9,93294,286,175,63583,48076,16053,16058,20004
80993,26,321,57846,23147,2.80214e+13,172.989,3323.04,80993,263,175,53445,39250,13799,10577,15141
94799,416,800,67804,26995,2.72689e+13,224.8,4551.94,94799,798,180,93715,93034,88109,90792,92847
70620,98,800,50528,20092,2.70333e+13,238.868,4062.69,70620,798,175,59767,50584,29902,35238,40749
81109,134,465,57911,23198,2.81236e+13,173.182,3511.88,81109,263,192,74753,61132,40504,30880,56300
70396,31,301,50283,20113,2.79933e+13,172.867,3088,70396,244,175,48348,36650,12619,11462,17049
56128,20,276,40088,16040,2.80203e+13,172.495,2745.77,56128,218,175,33998,24061,9564,7229,9342
35304,38,238,25215,10089,2.8013e+13,171.741,2160.76,35304,181,167,25568,20041,7097,5319,8838
10182,54,193,7272,2910,2.80298e+13,166.724,1145.62,10182,131,120,7836,6439,2517,1892,3358
2849,78,179,2028,821,2.81695e+13,146.836,600.501,2849,90,87,2284,1927,990,1113,1407
46551,76,258,33249,13302,2.79898e+13,172.334,2491.97,46551,201,175,38072,31624,15518,14777,21673
34769,11,237,24835,9934,2.80148e+13,171.805,2144.13,34769,180,166,16524,10181,5089,2957,1955
60770,312,944,43476,17294,2.70012e+13,219.932,4025.09,60770,798,192,59424,58924,52602,50594,57071
28767,18,226,20548,8219,2.80061e+13,171.297,1944.9,28767,169,156,16682,11855,4848,3283,4401
1577,151,177,1128,449,2.81247e+13,125.109,445.923,1577,72,72,1369,1151,1177,1241,1262
55617,171,275,39730,15887,2.80195e+13,172.609,2733.01,55617,218,175,54946,43090,49040,52256,54536
12296,60,197,8777,3519,2.81576e+13,167.194,1260.24,12296,138,126,9659,7911,3346,3880,4800
43976,484,800,31502,12474,2.64142e+13,221.74,3409.58,43976,797,175,42958,42700,37421,40085,42228
80125,160,319,57234,22891,2.79999e+13,173.007,3304.01,80125,262,175,77661,61244,70048,75061,73357
93319,309,493,66623,26696,2.81057e+13,172.832,3772.82,93319,293,175,92826,92763,91234,91805,92385
25583,94,220,18282,7301,2.79693e+13,171.048,1831.35,25583,164,150,21710,17871,10415,8915,14369
84538,858,944,60452,24086,2.72793e+13,248.504,4540.65,84538,733,196,83594,83594,83018,83179,83337
60742,754,800,43474,17268,2.68839e+13,214.036,3838.39,60742,798,175,59942,59743,55366,57613,59805
92228,242,341,65880,26348,2.8e+13,173.161,3556.13,92228,284,175,91887,91887,85907,88953,91788
13858,28,199,9900,3958,2.79606e+13,168.495,1339.23,13858,142,128,9271,6954,2368,1654,2517
23554,40,217,16825,6729,2.80054e+13,170.782,1755.85,23554,160,147,17251,13527,4970,4594,6375
55503,228,278,39649,15854,2.80009e+13,172.647,2733.38,55503,218,175,55225,55225,52788,54010,55179
56046,389,425,40006,16040,2.81566e+13,172.846,2935.26,56046,217,192,55621,55621,54059,54831,55585
62460,111,287,44612,17848,2.80155e+13,172.765,2902.18,62460,230,175,55045,46042,31948,29179,41352
5642,137,184,4034,1608,2.79251e+13,160.37,848.484,5642,112,103,5125,4212,3804,3592,4437
69968,132,301,49980,19988,2.80217e+13,172.898,3079.11,69968,244,175,64292,52714,44754,45529,54355
4566,140,182,3266,1300,2.78759e+13,157.155,762.626,4566,106,98,4146,3402,3213,3417,3607
45688,206,257,32634,13054,2.80223e+13,172.358,2468.64,45688,200,175,45431,45431,42698,44073,45380
45174,183,256,32267,12907,2.80326e+13,172.283,2454.09,45174,199,175,44918,44918,40691,42834,44845
35652,142,238,25463,10189,2.79805e+13,171.724,2171,35652,181,168,33351,26914,26063,26014,29234
37547,54,241,26822,10725,2.79895e+13,171.819,2229.48,37547,185,172,29082,23821,9278,11200,13712
85983,202,329,61424,24559,2.79901e+13,173.097,3427.54,85983,272,175,85654,85654,77722,81774,85527
98927,308,353,70661,28266,2.80083e+13,173.184,3689.15,98927,296,175,98574,98574,96221,97402,98529
52436,241,269,37450,14986,2.80196e+13,172.448,2650.43,52436,212,175,52167,52167,50973,51556,52139
4458,164,182,3182,1276,2.80459e+13,156.299,752.674,4458,104,98,4206,3373,3930,4090,4071
11892,145,195,8493,3399,2.793e+13,167.117,1237.56,11892,135,125,11110,8955,8869,8721,9920
41460,362,391,29595,11865,2.81731e+13,172.42,2529.96,41460,199,192,41069,41069,39967,40504,41040
52027,19,268,37159,14868,2.80071e+13,172.482,2639.6,52027,211,175,30847,22010,8850,8309,8146
94330,292,345,67375,26955,2.80075e+13,173.211,3598.76,94330,288,175,93985,93985,91131,92567,93932
15958,58,203,11399,4559,2.79604e+13,169.15,1438.88,15958,146,133,12471,10217,4227,4468,5794
20674,50,211,14770,5904,2.79772e+13,169.944,1641.12,20674,154,141,15778,12781,4975,3879,6656
58961,17,942,42184,16777,2.69819e+13,211.539,3979.01,58961,796,193,33286,23987,9785,3775,4472
45099,177,256,32217,12882,2.79886e+13,172.326,2452.16,45099,199,175,44843,44843,40230,42572,44765
36362,165,240,25973,10389,2.80265e+13,171.837,2194.11,36362,183,170,35482,27898,31899,34052,34223
87632,42,800,62690,24942,2.72063e+13,252.253,4414.23,87632,724,178,64368,51092,18612,22927,25119
89339,58,335,63811,25528,2.80072e+13,173.077,3496.67,89339,278,175,70102,57344,23469,37632,34484
75701,113,311,54077,21624,2.80106e+13,172.95,3207.53,75701,254,175,66983,56090,39421,37825,50876
76757,78,455,54806,21951,2.81057e+13,173.107,3416.68,76757,254,192,63080,52644,21570,16682,32761
10941,130,194,7816,3125,2.79639e+13,166.877,1186.98,10941,133,123,9912,8208,6879,6295,8238
55294,38,274,39497,15797,2.80024e+13,172.58,2724.28,55294,217,175,40061,31389,11231,10503,14184
95476,141,346,68206,27270,2.79928e+13,173.165,3620.34,95476,290,175,89315,72131,68840,67636,77712
85019,303,328,60727,24292,2.80127e+13,173.049,3407.92,85019,271,175,84691,84691,83707,84181,84666
31661,174,232,22610,9051,2.80566e+13,171.384,2043.67,31661,174,161,31373,25082,28224,29842,31217
27726,170,366,19785,7941,2.82752e+13,171.572,2088.41,27726,177,154,27107,21458,23961,22681,26214
33207,734,800,23811,9396,2.58811e+13,209.072,3087.63,33207,778,160,32407,32233,30142,31185,32210
88984,400,800,63653,25331,2.72091e+13,247.222,4440.63,88984,798,175,87809,87230,77046,82437,86912
23843,27,217,17033,6810,2.79967e+13,170.659,1766.09,23843,160,147,15849,11809,4066,2766,4335
77156,107,313,55112,22044,2.80061e+13,172.964,3238.95,77156,256,175,67453,56613,37285,42574,49277
29100,176,227,20789,8311,2.80436e+13,171.403,1956.98,29100,170,156,28873,28873,26142,27515,28822
45083,181,800,32293,12790,2.64527e+13,208.812,3440.26,45083,789,175,43760,43408,38496,40417,42292
95088,256,346,67919,27169,2.80078e+13,173.191,3613.43,95088,289,175,94742,94742,89337,92087,94652
34274,202,236,24479,9795,2.80086e+13,171.679,2128.14,34274,179,165,34038,34038,32428,33227,34004
98161,218,351,70121,28040,2.79945e+13,173.202,3673.58,98161,295,175,97810,97810,89464,93729,97677
65720,260,800,47029,18691,2.69536e+13,234.975,3953.27,65720,798,175,64440,64008,55938,59736,63166
96392,281,348,68852,27540,2.80043e+13,173.195,3639,96392,291,175,96044,96044,92190,94144,95977
17050,63,205,12182,4868,2.80523e+13,169.343,1488.21,17050,148,135,13502,11169,4714,4160,6722
53531,39,270,38245,15286,2.79935e+13,172.546,2678.25,53531,214,175,39073,30576,10762,14026,14838
93459,323,489,66735,26724,2.81057e+13,173.304,3771.21,93459,285,192,92970,92970,87058,80997,88594
93136,18,800,66617,26519,2.7263e+13,256.96,4520.42,93136,798,175,53872,38613,15504,8863,12594
55451,219,274,39611,15840,2.79891e+13,172.554,2727.88,55451,217,175,55177,55177,52153,53677,55122
45919,224,257,32804,13115,2.80009e+13,172.303,2474.6,45919,201,175,45662,45662,44118,44882,45629
4123,142,181,2942,1181,2.77637e+13,154.103,722.584,4123,100,95,3750,3084,2970,2979,3275
56735,67,276,40520,16215,2.80084e+13,172.539,2760.14,56735,219,175,45501,37541,16473,25033,24508
73341,277,307,52382,20959,2.80116e+13,172.853,3155.16,73341,249,175,73034,73034,71706,72358,73004
87731,280,476,62643,25088,2.81064e+13,173.229,3650.01,87731,274,194,87255,87135,66956,63852,82339
50396,69,265,35998,14398,2.80251e+13,172.384,2596.38,50396,208,175,40591,33431,14971,22415,22272
88244,41,476,63007,25237,2.80962e+13,173.225,3661.31,88244,275,194,65097,51221,18516,14726,21470
35375,201,238,25266,10109,2.80045e+13,171.664,2162.95,35375,181,168,35137,35137,33314,34221,35100
58481,39,280,41768,16713,2.80172e+13,172.622,2804.64,58481,223,175,42691,33416,12376,8915,14900
31871,131,231,22766,9105,2.79866e+13,171.484,2049.28,31871,174,161,29179,23996,20177,18994,24332
60642,261,284,43308,17334,2.80219e+13,172.641,2858.02,60642,226,175,60358,60358,59509,59914,60335
97852,409,800,69976,27876,2.73059e+13,225.726,4609.28,97852,798,180,96730,96081,89021,92808,95843
7391,61,187,5281,2110,2.79271e+13,162.76,971.724,7391,119,110,5798,4771,2042,1804,2809
42652,191,252,30465,12187,2.80198e+13,172.131,2382.8,42652,194,175,42400,42400,39004,40720,42339
83905,106,326,59923,23982,2.80171e+13,173.007,3384.56,83905,268,175,73210,61575,40101,46150,53389
58843,221,280,42033,16810,2.79956e+13,172.64,2813.04,58843,223,175,58563,58563,55261,56929,58504
3801,73,181,2712,1089,2.80785e+13,153.547,695.535,3801,98,95,3021,2511,1234,1308,1703
29436,87,228,21021,8415,2.8068e+13,171.156,1968.58,29436,170,157,24632,20534,11223,14236,15865
60847,139,800,43558,17289,2.68375e+13,216.256,3840.68,60847,777,180,55713,45164,41859,40581,46817
8532,117,190,6098,2434,2.81532e+13,164.778,1046.8,8532,125,115,7530,6287,4636,4345,5900
52208,149,411,37264,14944,2.81769e+13,172.686,2828.98,52208,211,193,49408,39532,22201,12330,36925
84203,297,326,60146,24057,2.79982e+13,173.088,3390.6,84203,269,175,83877,83877,82609,83231,83848
30319,56,229,21652,8667,2.80214e+13,171.358,1998.08,30319,172,158,23617,19396,7638,6003,10486
93578,227,344,66839,26739,2.80219e+13,173.126,3583.92,93578,286,175,93234,93234,86028,89704,93117
57034,104,278,40741,16293,2.80121e+13,172.649,2769.38,57034,221,175,49514,41839,26331,30933,35763
50970,125,266,36409,14561,2.80244e+13,172.428,2611.67,50970,209,175,46160,38301,31086,31629,37295
42786,83,251,30565,12221,2.79879e+13,172.146,2385.46,42786,194,175,35521,29763,15114,15063,21812
15153,52,201,10825,4328,2.79964e+13,168.643,1400.73,15153,144,131,11633,9445,3702,4768,5407
33028,201,234,23591,9437,2.80378e+13,171.69,2088.41,33028,177,164,32794,32794,31287,32030,32761
32777,187,233,23408,9369,2.80034e+13,171.599,2079.49,32777,176,163,32544,32544,30138,31345,32498
21743,189,213,15531,6212,2.79616e+13,170.371,1684.53,21743,156,143,21530,21530,20612,21052,21506
43914,128,253,31364,12550,2.79969e+13,172.17,2417.53,43914,196,175,40004,32998,27307,23639,33081
88502,290,334,63217,25285,2.80032e+13,173.115,3480.07,88502,277,175,88168,88168,85898,87034,88124
67696,290,296,48351,19345,2.7995e+13,172.811,3025.58,67696,239,175,67400,67400,67348,67366,67394
61769,256,285,44124,17645,2.79733e+13,172.743,2884.78,61769,229,175,61484,61484,60208,60833,61455
69057,583,800,49411,19646,2.70009e+13,214.774,4027.95,69057,797,180,68157,67757,64203,66008,67606
60024,278,283,42869,17155,2.80265e+13,172.686,2843.23,60024,226,175,59741,59741,59705,59716,59736
78461,22,316,56041,22420,2.80105e+13,173.014,3268.13,78461,259,175,49073,34895,13349,9657,13290
84758,281,470,60516,24242,2.81155e+13,173.231,3589.59,84758,285,177,84288,84168,80823,80789,82612
73018,212,306,52156,20862,2.80024e+13,172.948,3147.81,73018,249,175,72712,72712,67034,69924,72618
75410,96,310,53867,21543,2.79954e+13,172.953,3200.72,75410,253,175,64426,52883,31394,29657,43814
75594,351,460,53968,21626,2.81116e+13,173.093,3397.95,75594,252,196,75134,75134,68610,71936,75025
5794,179,184,4137,1657,2.77999e+13,159.901,858.91,5794,110,104,5610,5610,5574,5585,5605
86456,37,331,61751,24705,2.80291e+13,173.063,3438.43,86456,273,175,62198,48931,17838,13648,21437
76928,312,313,54953,21975,2.79976e+13,173.008,3234.54,76928,256,175,76615,76615,76615,76615,76614
62858,201,288,44902,17956,2.80015e+13,172.775,2912,62858,231,175,62570,62570,57406,60032,62483
9688,135,191,6922,2766,2.79475e+13,165.725,1115.12,9688,127,118,8864,7267,6477,6050,7554
44759,23,947,32038,12721,2.66377e+13,209.171,3618.29,44759,800,179,28069,20792,7485,5578,7205
51624,70,268,36865,14759,2.80376e+13,172.438,2629.67,51624,210,175,41678,34342,15475,17127,23039
55438,683,800,39688,15750,2.67588e+13,213.958,3710.07,55438,798,175,54623,54412,49879,52205,54288
89786,221,336,64135,25651,2.80026e+13,173.111,3505.99,89786,279,175,89450,89450,82349,85970,89335
75768,103,311,54121,21647,2.80063e+13,172.943,3208.96,75768,254,175,65691,55591,34279,32553,46786
76318,13,312,54514,21804,2.80055e+13,172.968,3221.11,76318,255,175,39042,26354,11450,6482,5339
7461,88,187,5335,2126,2.78726e+13,163.701,977.18,7461,121,111,6191,5181,2871,2784,3961
61530,147,285,43947,17583,2.79973e+13,172.72,2879.3,61530,228,175,58176,46582,46776,45804,52312
84636,19,327,60456,24180,2.80064e+13,173.077,3399.78,84636,270,175,50184,35811,14406,8586,13187
36492,169,240,26065,10427,2.8e+13,171.764,2197.92,36492,183,170,35868,28194,32173,34250,35006
94074,447,946,67262,26812,2.73473e+13,253.763,4728.16,94074,813,193,92789,92166,81364,68346,80879
34549,197,237,24680,9869,2.79893e+13,171.84,2137.65,34549,180,167,34312,34312,32351,33328,34273
74026,699,800,52961,21065,2.70486e+13,218.95,4135.85,74026,798,175,73208,72982,67197,70146,72924
33511,84,234,23931,9580,2.80119e+13,171.535,2102.81,33511,177,164,27875,23312,11957,16018,17471
98375,812,945,70335,28040,2.73811e+13,232.06,4808.45,98375,798,197,97430,97430,93792,95516,97032
43646,126,253,31181,12465,2.80075e+13,172.188,2410.51,43646,196,175,39593,32792,26810,23023,31961
77733,224,315,55528,22205,2.79956e+13,173.029,3252.65,77733,258,175,77418,77418,71989,74750,77327
95996,454,800,68660,27336,2.72853e+13,224.048,4574.41,95996,798,180,94927,94229,87905,91313,94158
62495,520,800,44726,17769,2.69026e+13,213.467,3879.48,62495,798,175,61519,61185,56518,58874,60855
33859,195,235,24190,9669,2.7986e+13,171.655,2114.44,33859,178,165,33624,33624,31620,32619,33584
65439,586,800,46836,18603,2.69187e+13,214.849,3947.15,65439,798,175,64523,64124,59318,61769,63997
58113,22,279,41506,16607,2.80178e+13,172.625,2795.32,58113,222,175,36348,25848,9893,9578,10723
64489,478,800,46155,18334,2.69157e+13,226.5,3925.37,64489,757,180,63519,63176,61626,62380,62723
86810,229,476,61989,24821,2.80915e+13,173.237,3633.75,86810,273,194,86334,86212,66297,49459,77013
59036,234,281,42162,16874,2.8021e+13,172.582,2818.47,59036,223,175,58755,58755,56269,57517,58708
18411,126,207,13149,5262,2.79746e+13,169.73,1547.32,18411,150,137,16667,13813,11304,9334,13492
32963,93,234,23545,9418,2.80162e+13,171.683,2086.39,32963,177,164,27938,23034,13140,12685,18517
73161,171,306,52268,20893,2.79938e+13,172.967,3150.79,73161,250,175,72335,56696,64390,68722,71255
10228,64,193,7298,2930,2.81241e+13,166.377,1147.83,10228,131,121,8095,6731,2835,2335,4071
71482,222,303,51068,20414,2.79915e+13,172.943,3113,71482,247,175,71179,71179,66366,68811,71098
8249,101,189,5892,2357,2.79926e+13,164.163,1028.73,8249,124,114,7038,5984,3752,4354,5014
56468,84,276,40332,16136,2.80036e+13,172.6,2753.87,56468,219,175,47010,39283,20043,19969,29133
15726,163,202,11238,4488,2.7943e+13,168.865,1427.23,15726,145,132,15212,12017,13771,14660,14583
69663,45,800,49854,19809,2.69883e+13,214.57,4041.29,69663,798,175,51718,41305,15247,12891,19643
45036,4,255,32169,12867,2.79841e+13,172.193,2449.19,45036,198,175,11801,3580,2606,2523,1030
57125,86,277,40806,16319,2.79971e+13,172.65,2770.53,57125,220,175,47756,39843,21088,20489,29995
92289,251,341,65926,26363,2.80014e+13,173.169,3557.43,92289,284,175,91948,91948,86586,89312,91858
16814,37,205,12013,4801,2.80106e+13,169.568,1478.39,16814,148,134,12062,9495,3358,3297,4257
18324,185,350,13069,5255,2.84989e+13,170.342,1721.33,18324,158,149,17961,17824,15720,14919,17036
55283,83,274,39487,15796,2.80054e+13,172.611,2724.1,55283,217,175,45924,38450,19499,19443,28357
44915,18,800,32175,12740,2.64105e+13,222.444,3435.41,44915,796,175,25867,18710,7366,5820,6385
70582,64,301,50416,20166,2.79854e+13,172.882,3091.95,70582,244,175,56223,46564,19393,20445,28100
92709,28,342,66219,26490,2.80143e+13,173.157,3566.06,92709,285,175,62172,46600,15789,11077,17805
16038,162,203,11455,4583,2.80052e+13,169.108,1442.32,16038,146,132,15484,12251,13994,14928,14728
11638,48,195,8310,3328,2.80437e+13,167.208,1225.08,11638,135,125,8798,7095,2720,3325,3817
25795,11,221,18425,7370,2.80178e+13,171.001,1839.52,25795,164,151,12265,7553,3785,2146,2562
66914,134,295,47796,19118,2.80066e+13,172.818,3007.9,66914,238,175,61710,50416,44262,41525,52241
95467,43,347,68189,27278,2.80117e+13,173.204,3621.47,95467,290,175,71079,56265,21248,14700,25677
62291,40,287,44492,17799,2.80192e+13,172.76,2898.4,62291,230,175,45694,35806,12970,9611,16280
78444,483,800,56123,22321,2.71101e+13,221.147,4228.97,78444,791,180,77450,77106,73604,75361,76693
82771,321,323,59119,23652,2.7991e+13,173.025,3359.73,82771,266,175,82448,82448,82444,82444,82446
36775,15,240,26273,10502,2.79874e+13,171.92,2206.3,36775,184,171,19940,13757,5789,3388,4500
7506,79,188,5363,2143,2.81373e+13,163.745,981.095,7506,121,111,6115,5126,2555,2247,3561
91771,404,800,65637,26134,2.72343e+13,229.52,4494.26,91771,791,180,90698,90012,86619,88520,89783
6831,139,187,4876,1955,2.81143e+13,163.057,935.4,6831,119,108,6248,5100,4835,4905,5456
23106,100,216,16501,6605,2.80245e+13,170.508,1738.06,23106,159,145,19856,16767,10341,9730,13895
14970,5,201,10694,4276,2.79904e+13,168.681,1392.42,14970,144,130,4654,1649,1004,1081,399
91376,21,339,65268,26108,2.80007e+13,173.12,3538.46,91376,282,175,56332,40146,15546,9420,14038
74961,64,309,53543,21418,2.80035e+13,172.928,3190.41,74961,252,175,59726,49463,20587,29558,31128
79418,136,317,56725,22693,2.79973e+13,173.002,3288.06,79418,260,175,73571,59848,53831,49571,62979
3375,154,180,2413,962,2.79509e+13,150.224,653.669,3375,95,91,3095,2520,2750,2800,2862
2765,89,179,1975,790,2.79561e+13,146.08,591.84,2765,91,83,2246,1904,1109,1348,1496
66968,184,295,47836,19132,2.80029e+13,172.814,3008.98,66968,238,175,66673,66673,59841,63325,66562
15855,111,203,11324,4531,2.7982e+13,169.159,1434.12,15855,146,133,13889,11658,8121,7431,10400
59429,160,282,42444,16985,2.80252e+13,172.608,2828.49,59429,224,175,57557,45420,51907,55630,54224
22418,44,214,16019,6399,2.79612e+13,170.52,1711.02,22418,158,145,16742,13239,5068,3532,6224
72339,42,305,51667,20672,2.80122e+13,172.897,3132.55,72339,248,175,53597,42378,15569,11407,19661
47442,82,259,33891,13551,2.79775e+13,172.347,2515.85,47442,203,175,39300,33009,16696,17969,24342
20972,159,212,14978,5994,2.80228e+13,170.306,1654.13,20972,155,141,20184,15994,18246,19539,19073
1599,147,177,1140,459,2.79131e+13,126.309,449.865,1599,72,69,1374,1164,1159,1239,1233
90877,118,338,64916,25961,2.80011e+13,173.103,3528.16,90877,281,175,81269,67345,49969,44767,63143
15062,31,201,10758,4304,2.79504e+13,168.861,1396.7,15062,144,131,10321,7834,2699,2853,3471
12688,117,197,9060,3628,2.79978e+13,167.701,1280.03,12688,139,127,11234,9372,6909,6474,8655
72842,228,800,52104,20738,2.71384e+13,239.56,4063.27,72842,726,175,71740,71401,62107,45842,1200
75464,121,311,53905,21559,2.80034e+13,173,3202.9,75464,254,175,67863,56178,42839,43108,54590
91028,248,481,64999,26029,2.80953e+13,173.273,3718.11,91028,295,177,90547,90426,83141,83589,88780
83289,194,324,59487,23802,2.8008e+13,172.988,3370.64,83289,267,175,82965,82965,74838,78989,82835
15340,168,202,10958,4382,2.80221e+13,169.055,1410.49,15340,145,131,14956,11792,13618,14379,14560
38902,239,245,27786,11116,2.80425e+13,171.947,2272.18,38902,188,174,38657,38657,38611,38623,38651
59295,215,281,42352,16943,2.80316e+13,172.625,2824.51,59295,224,175,59014,59014,55263,57161,58948
65168,135,437,46526,18642,2.81583e+13,172.998,3155.07,65168,234,192,60144,49111,35409,30511,47098
97693,584,800,69872,27821,2.72869e+13,232.162,4605.99,97693,798,175,96722,96322,87869,92212,96245
2865,133,179,2046,819,2.84555e+13,145.26,601.725,2865,91,89,2520,2122,1845,1947,2166
48483,153,261,34634,13849,2.79925e+13,172.364,2544.33,48483,204,175,46337,36695,39797,39554,42656
62345,113,432,44512,17833,2.81325e+13,172.921,3087.1,62345,244,184,55108,46207,29624,25165,40088
7426,40,187,5308,2118,2.78713e+13,163.49,974.806,7426,120,110,5418,4255,1559,1081,1848
51759,65,267,36979,14780,2.79861e+13,172.539,2632.2,51759,211,175,41293,34135,14333,12934,20932
94578,480,800,67641,26937,2.72776e+13,237.11,4547.84,94578,781,180,93591,93210,90422,91809,92818
94082,45,344,67205,26877,2.8005e+13,173.15,3593.01,94082,287,175,70651,56130,20969,18067,27532
24173,28,218,17266,6907,2.8034e+13,170.712,1778.97,24173,161,147,16194,12149,4141,3039,4820
28828,133,226,20584,8244,2.80054e+13,171.281,1946.84,28828,169,156,26470,21695,18645,17855,22574
15870,7,203,11335,4535,2.79822e+13,169.206,1434.83,15870,146,133,6138,2463,1721,1210,1184
69395,176,300,49562,19833,2.80198e+13,172.843,3065.9,69395,243,175,69095,69095,61389,65323,68971
57581,96,423,41108,16473,2.81298e+13,172.877,2968.76,57581,235,184,49126,40423,22698,19031,30926
94120,474,800,67317,26803,2.72682e+13,260.503,4539.11,94120,704,175,93159,92759,92135,92423,92344
87573,276,332,62555,25018,2.79996e+13,173.082,3460.43,87573,275,175,87241,87241,84143,85706,87185
94934,290,345,67811,27123,2.79969e+13,173.162,3609.62,94934,288,175,94589,94589,91551,93085,94534
66132,633,800,47328,18804,2.69432e+13,226.497,3962.81,66132,798,175,65236,65065,58293,61782,64832
56909,69,277,40651,16258,2.80069e+13,172.606,2765.35,56909,220,175,45837,37745,16900,17116,24107
7621,148,188,5443,2178,2.80454e+13,163.961,988.972,7621,121,111,7105,5727,5761,6292,6405
45750,298,800,32763,12987,2.65133e+13,220.809,3458.75,45750,734,180,44608,44073,42927,43205,43444
56556,97,277,40394,16162,2.80373e+13,172.556,2757.06,56556,219,175,48401,40979,24384,29163,33215
6482,128,186,4626,1856,2.80645e+13,162.068,910.83,6482,116,107,5810,4833,3991,3597,4787
48242,29,261,34451,13791,2.80244e+13,172.326,2538.22,48242,204,175,32612,24595,8237,8926,8347
59158,117,281,42253,16905,2.80084e+13,172.655,2821.38,59158,224,175,52756,43823,32204,28528,40864
27257,132,223,19465,7792,2.80287e+13,171.006,1891.63,27257,166,153,24975,20513,17443,17760,20830
23615,100,217,16863,6752,2.80286e+13,170.453,1757.72,23615,159,146,20291,17142,10598,12405,14341
13902,189,199,9928,3974,2.79735e+13,168.37,1341.04,13902,142,129,13703,13703,13567,13623,13693
41136,204,248,29385,11751,2.79913e+13,172.118,2337.62,41136,191,175,40888,40888,38598,39747,40844
65369,48,292,46692,18677,2.80029e+13,172.786,2971.29,65369,235,175,49605,39939,15156,13835,20326
22398,159,214,16006,6392,2.79548e+13,170.484,1710.15,22398,157,144,21576,17091,19506,20886,20266
94286,240,485,67329,26957,2.80937e+13,173.307,3781.67,94286,294,177,93801,93680,86581,88660,92812
36316,58,239,25945,10371,2.79807e+13,171.83,2191.87,36316,182,169,28463,23293,9547,15276,13988
8335,90,189,5958,2377,2.79402e+13,164.759,1034.2,8335,124,113,6970,5785,3253,2746,4418
63138,8,288,45101,18037,2.80001e+13,172.754,2918.27,63138,231,175,26246,11977,7307,5017,3247
3541,3,180,2534,1007,2.77537e+13,151.706,670.003,3541,97,91,735,163,151,189,57
91633,858,942,65518,26115,2.73382e+13,222.665,4676.7,91633,811,192,90691,90619,85733,80695,86884
43065,180,395,30733,12332,2.82283e+13,172.416,2578.09,43065,193,184,42651,42512,27220,20448,37657
75408,85,310,53866,21542,2.80018e+13,173.011,3200.83,75408,254,175,62916,52603,27142,23505,39145
62059,379,800,44415,17644,2.6892e+13,229.714,3869.34,62059,798,175,60908,60353,53217,56827,59996
61372,155,285,43836,17536,2.80074e+13,172.752,2875.8,61372,228,175,58907,46679,52059,52833,55041
14296,61,200,10213,4083,2.802e+13,168.604,1360.4,14296,143,129,11258,9237,3844,3609,5456
58249,180,279,41605,16644,2.79959e+13,172.63,2798.37,58249,222,175,57970,57970,51954,55018,57871
36249,144,240,25889,10360,2.80401e+13,171.869,2190.81,36249,183,169,34025,27352,26889,29801,30295
56566,44,276,40403,16163,2.79925e+13,172.586,2756.18,56566,219,175,42310,33440,12739,14034,16680
73957,289,307,52825,21132,2.8001e+13,172.899,3168.07,73957,250,175,73650,73650,73128,73367,73632
50935,18,266,36386,14549,2.79994e+13,172.461,2610.77,50935,210,175,29552,20995,8571,5351,7385
38833,68,244,27735,11098,2.79908e+13,171.972,2269.18,38833,187,174,31191,25748,11394,13531,17069
27110,68,223,19365,7745,2.80247e+13,171.108,1886.54,27110,166,153,21754,17969,7960,9452,11907
15762,157,203,11252,4510,2.8067e+13,168.878,1429.93,15762,145,132,15073,11961,13674,14178,14047
97017,79,349,69294,27723,2.8001e+13,173.178,3651.08,97017,292,175,79935,66644,32869,36195,48674
48204,92,262,34428,13776,2.80377e+13,172.267,2538.12,48204,204,175,40804,33634,18990,23991,27145
46678,252,258,33346,13332,2.7986e+13,172.386,2495.4,46678,202,175,46420,46420,46366,46385,46414
76840,78,313,54887,21953,2.80058e+13,172.97,3232.65,76840,256,175,63164,52639,25740,26293,37145
94393,444,800,67520,26873,2.72579e+13,229.467,4544.38,94393,796,180,93355,92629,89052,91047,92525
26739,23,223,19100,7639,2.80345e+13,171.059,1873.88,26739,166,152,16955,12383,4572,3062,4676
63367,233,289,45265,18102,2.80189e+13,172.767,2924.41,63367,232,175,63078,63078,60016,61558,63022
7625,173,187,5452,2173,2.78642e+13,163.844,987.615,7625,121,111,7416,5940,7158,6996,7349
16147,173,203,11529,4618,2.80079e+13,169.153,1447.05,16147,146,133,15890,12646,14618,15271,15758
98313,72,351,70227,28086,2.79884e+13,173.228,3676.39,98313,295,175,79745,65577,30628,30248,43395
44255,330,397,31590,12665,2.8201e+13,172.572,2612.39,44255,197,192,43858,43858,40201,42052,43791
50545,224,409,36080,14465,2.81707e+13,172.688,2786.18,50545,223,184,50136,50014,44554,40390,47482
34231,38,236,24454,9777,2.80068e+13,171.788,2127.01,34231,179,165,24782,19416,6965,6505,8785
42139,186,250,30094,12045,2.80134e+13,172.136,2366.87,42139,193,175,41889,41889,38247,40090,41825
22539,124,215,16098,6441,2.80299e+13,170.627,1716.66,22539,158,144,20324,16829,13685,12092,16360
83112,305,325,59357,23755,2.80236e+13,173.011,3368.3,83112,267,175,82787,82787,82162,82452,82767
32266,327,800,23142,9124,2.58374e+13,206.251,3050.38,32266,635,158,31341,30803,30264,30115,30070
28095,199,225,20066,8029,2.80244e+13,171.166,1921.4,28095,168,154,27870,27870,26817,27327,27844
40612,8,248,29001,11611,2.80336e+13,171.959,2322.86,40612,190,175,16888,7723,4704,3099,1800
83376,273,324,59559,23817,2.80007e+13,173.047,3372.53,83376,267,175,83052,83052,80286,81680,83001
30199,108,228,21564,8635,2.80209e+13,171.25,1993.22,30199,171,158,26409,22144,14789,16793,19806
75254,451,800,53840,21414,2.70899e+13,236.233,4162.2,75254,751,180,74259,73524,72445,73160,73407
54235,44,272,38741,15494,2.80014e+13,172.562,2697.09,54235,215,175,40561,32055,12228,14523,16353
53749,74,373,38387,15362,2.81104e+13,171.331,2817.9,53749,214,184,43762,35992,12972,10654,9499
33216,75,235,23723,9493,2.8019e+13,171.621,2095.06,33216,177,164,27081,22387,11027,15187,15775
90275,14,478,64467,25808,2.81082e+13,173.239,3700.48,90275,288,176,47636,32461,13769,9563,11580
96849,44,349,69181,27668,2.8003e+13,173.206,3648.1,96849,292,175,72465,57247,21803,24003,28165
5190,5,183,3703,1487,2.77799e+13,158.824,812.772,5190,107,102,1608,572,347,295,151
16210,169,203,11582,4628,2.79426e+13,169.161,1449.8,16210,146,133,15845,12497,14461,15233,15428
79092,86,317,56493,22599,2.80042e+13,172.981,3281.58,79092,260,175,66151,55186,29221,30498,42571
27551,217,223,19678,7873,2.80055e+13,171.015,1901.32,27551,166,153,27328,27328,27276,27294,27322
7813,62,188,5586,2227,2.79147e+13,164.26,1000.97,7813,122,111,6136,5047,2120,2041,3030
64680,52,800,46272,18408,2.71975e+13,229.014,3782.46,64680,477,175,49325,40098,15518,11947,20723
17455,39,206,12468,4987,2.80549e+13,169.643,1506.73,17455,149,135,12712,9961,3530,2555,4273
80872,173,320,57768,23104,2.80024e+13,173.052,3319.81,80872,263,175,80264,63554,71261,76016,79563
25466,258,358,18168,7298,2.83464e+13,171.185,2001.22,25466,168,165,25108,24987,17503,15944,23220
38186,214,387,27250,10936,2.82473e+13,172.363,2434.54,38186,201,185,37799,37676,31696,26710,34894
80509,451,468,57481,23028,2.81163e+13,173.178,3504.65,80509,261,195,80041,80041,79718,79866,80024
28718,21,226,20511,8207,2.80146e+13,171.357,1943.41,28718,169,156,17688,12612,4895,3487,4800
47480,615,800,34003,13477,2.65258e+13,210.537,3505.23,47480,774,175,46635,46235,44331,45464,46125
46335,162,258,33095,13240,2.80291e+13,172.339,2486.36,46335,201,175,45011,35474,40513,43363,42878
5408,172,184,3862,1546,2.80923e+13,159.576,831.141,5408,110,103,5200,4188,5041,5125,5169
36197,28,239,25853,10344,2.79831e+13,171.779,2188.12,36197,182,169,24264,18186,6159,6020,7614
7256,5,187,5182,2074,2.79811e+13,163.357,963.878,7256,120,109,2254,795,483,419,179
22759,212,216,16259,6500,2.80063e+13,170.607,1725.76,22759,159,145,22543,22543,22528,22531,22539
18582,44,208,13268,5314,2.80507e+13,169.527,1554.88,18582,150,137,13880,10990,4198,3230,5314
60890,184,284,43494,17396,2.80025e+13,172.692,2863.78,60890,227,175,60606,60606,54522,57621,60506
8213,24,189,5863,2350,2.80466e+13,164.236,1025.91,8213,123,113,5268,3872,1417,967,1468
34703,224,236,24791,9912,2.79747e+13,171.765,2141.14,34703,180,167,34467,34467,34267,34354,34455
51629,234,267,36876,14753,2.79912e+13,172.444,2628.63,51629,210,175,51362,51362,49833,50588,51329
78786,273,316,56281,22505,2.79932e+13,173.021,3274.63,78786,260,175,78470,78470,76241,77356,78427
17225,62,205,12297,4928,2.80289e+13,169.49,1495.69,17225,148,135,13616,11161,4705,5838,7025
46597,104,258,33285,13312,2.80166e+13,172.292,2493.19,46597,201,175,40452,34174,21517,25296,29091
28837,65,226,20600,8237,2.79918e+13,171.288,1947.19,28837,170,156,22982,19013,7979,6280,11276
10915,168,194,7794,3121,2.80438e+13,167.001,1186.27,10915,133,123,10595,8376,9749,10228,10410
50183,123,265,35845,14338,2.8029e+13,172.439,2591.06,50183,208,175,45278,37527,30088,24721,36175
42343,166,251,30246,12097,2.80047e+13,172.214,2373.54,42343,194,175,41417,32638,37179,39688,40025
10688,13,193,7632,3056,2.79411e+13,166.418,1172.45,10688,131,122,5460,3685,1605,944,917
62180,339,800,44504,17676,2.68713e+13,214.401,3871.95,62180,798,175,61018,60474,55276,57760,59987
3896,82,181,2782,1114,2.79718e+13,153.798,703.609,3896,102,93,3163,2687,1392,1383,1939
30490,165,229,21783,8707,2.80027e+13,171.506,2003.88,30490,173,159,29731,23378,26750,28539,28668
24200,13,218,17286,6914,2.79793e+13,170.753,1779.84,24200,161,148,12380,8350,3631,2552,2939
4000,33,181,2856,1144,2.79484e+13,154.01,712.362,4000,100,95,2767,2131,759,646,883
81349,20,321,58110,23239,2.79991e+13,173.065,3330.27,81349,264,175,49261,34846,13824,8236,8964
35362,81,238,25256,10106,2.80148e+13,171.699,2162.58,35362,180,167,29226,24602,12385,13331,18135
14344,9,200,10242,4102,2.7975e+13,168.585,1362.52,14344,143,130,6271,3029,1790,1168,879
47377,110,442,33853,13524,2.7799e+13,171.029,2736.24,47377,202,175,41475,34832,23835,27113,30908
88868,327,800,63565,25303,2.72351e+13,239.822,4438.53,88868,770,180,87739,87113,84984,85789,86623
69403,78,299,49568,19835,2.79962e+13,172.83,3064.94,69403,242,175,57042,47545,23278,25786,34070
5429,179,184,3882,1547,2.80869e+13,159.676,832.436,5429,110,104,5245,5245,5209,5220,5240
87971,131,333,62830,25141,2.80058e+13,173.115,3469.11,87971,276,175,80699,66291,55664,52368,67349
97100,4,350,69362,27738,2.79973e+13,173.209,3653.67,97100,293,175,25454,7716,5613,6671,5757
77615,300,314,55439,22176,2.80037e+13,173.005,3249.25,77615,257,175,77301,77301,77021,77144,77287
4791,101,183,3419,1372,2.80956e+13,157.987,782.093,4791,107,100,4051,3450,2144,1853,2804
95207,125,346,67999,27208,2.80068e+13,173.171,3615.49,95207,289,175,86356,71583,58090,48076,69499
3504,58,180,2508,996,2.78058e+13,152.263,667.13,3504,98,91,2689,2223,928,1050,1283
54162,263,271,38690,15472,2.79949e+13,172.533,2694.35,54162,215,175,53891,53891,53796,53834,53883
19873,141,210,14195,5678,2.80067e+13,169.942,1609.36,19873,153,140,18488,14980,14293,15951,16131
63831,260,290,45587,18244,2.80292e+13,172.721,2935.62,63831,232,175,63541,63541,62234,62874,63511
7764,127,188,5545,2219,2.79639e+13,163.944,997.605,7764,122,111,6965,5800,4784,4835,5743
30095,45,229,21495,8600,2.80522e+13,171.363,1991,30095,172,158,22572,17954,6722,4994,8658
14693,164,200,10495,4198,2.79144e+13,168.573,1378.68,14693,143,130,14229,11224,12909,13708,13581
83515,202,325,59655,23860,2.80063e+13,173.046,3376.26,83515,268,175,83190,83190,75518,79435,83067
91404,182,339,65287,26117,2.79983e+13,173.127,3539,91404,282,175,91065,91065,81105,86199,90908
54968,143,273,39265,15703,2.79917e+13,172.524,2715.42,54968,216,175,51586,41515,40602,39131,45341
51003,191,266,36423,14580,2.80256e+13,172.41,2612.39,51003,209,175,50737,50737,46372,48587,50662
40034,56,246,28599,11435,2.79881e+13,172.024,2305,40034,189,175,31195,25604,10090,9207,14038
49727,175,264,35516,14211,2.80114e+13,172.359,2578.67,49727,206,175,49463,49463,44113,46837,49374
52521,42,269,37513,15008,2.80011e+13,172.5,2652.67,52521,212,175,38903,30758,11314,12746,14898
52264,185,269,37334,14930,2.79986e+13,172.568,2646.55,52264,212,175,51995,51995,47039,49556,51911
48695,26,262,34777,13918,2.79978e+13,172.401,2550.83,48695,205,175,32119,23588,8288,8017,7118
93454,427,946,66815,26639,2.73464e+13,223.004,4716.45,93454,800,198,92211,91547,84869,87849,90805
24849,186,800,17841,7008,2.5305e+13,199.848,2768.73,24849,608,145,23782,23453,21475,21683,22288
42472,105,251,30339,12133,2.80159e+13,172.21,2377.07,42472,194,175,36957,31142,19881,16717,26349
28594,4,226,20421,8173,2.80278e+13,171.179,1938.91,28594,169,155,7506,2283,1661,1603,651
47324,733,800,33898,13426,2.65419e+13,227.091,3501.17,47324,793,175,46524,46301,40996,43715,46324
37474,162,242,26762,10712,2.8029e+13,171.968,2228.58,37474,185,172,36374,28681,32758,35048,34616
57811,165,279,41290,16521,2.80229e+13,172.621,2788.29,57811,222,175,56502,44385,50644,54170,54237
18124,94,207,12950,5174,2.79437e+13,169.77,1535.53,18124,150,137,15346,12659,7337,7546,10260
73735,63,308,52673,21062,2.79993e+13,173.006,3164.66,73735,251,175,58593,48371,20148,17356,29588
37485,261,800,26862,10623,2.61503e+13,210.945,3221.16,37485,757,167,36297,35824,33949,34539,35068
97242,44,350,69457,27785,2.80129e+13,173.208,3656.18,97242,293,175,72756,57485,21914,16710,27599
30322,124,229,21655,8667,2.80186e+13,171.456,1998.59,30322,172,159,27386,22655,18433,15880,21957
71711,246,443,51204,20507,2.81259e+13,173.032,3299.44,71711,245,193,71268,71147,51059,38822,64731
6779,142,186,4843,1936,2.80604e+13,162.341,931.065,6779,117,108,6236,5080,4920,5421,5472
44162,142,254,31541,12621,2.80182e+13,172.262,2425.35,44162,197,175,41334,33336,32275,34192,36246
10312,21,193,7367,2945,2.80451e+13,166.586,1152.57,10312,131,121,6345,4527,1769,1253,1709
81737,375,800,58469,23268,2.7172e+13,224.536,4296.68,81737,789,180,80637,79995,76674,78226,79662
80735,161,320,57667,23068,2.8008e+13,173.02,3317.03,80735,263,175,78399,61711,70587,75636,74760
51569,608,800,36933,14636,2.66313e+13,221.216,3612.66,51569,798,175,50668,50279,45051,47707,50193
48487,137,262,34629,13858,2.80221e+13,172.321,2545.26,48487,204,175,44957,36526,33036,34952,38713
27966,130,225,19968,7998,2.8038e+13,170.998,1917.03,27966,167,154,25536,21054,17606,17813,21121
21619,150,213,15440,6179,2.80309e+13,170.277,1679.86,21619,156,143,20458,16338,16754,18206,18646
25310,127,800,18170,7140,2.52447e+13,213.223,2813.51,25310,776,145,22042,18322,14375,14224,17083
43567,100,253,31123,12444,2.80034e+13,172.241,2408.52,43567,196,175,37525,31634,19452,16427,26097
9817,127,191,7012,2805,2.79678e+13,165.625,1122.71,9817,128,118,8846,7351,6064,6135,7218
10396,151,193,7427,2969,2.78995e+13,166.556,1156.81,10396,131,121,9789,7831,8138,8017,8865
86378,575,800,61787,24591,2.71954e+13,222.501,4389.58,86378,798,180,85463,85063,81033,83080,84903
64670,98,291,46187,18483,2.79964e+13,172.807,2955.02,64670,234,175,55457,46857,28088,27533,38858
10779,190,194,7697,3082,2.81103e+13,166.577,1178.71,10779,133,123,10585,10585,10562,10568,10581
75408,73,311,53862,21546,2.80167e+13,172.997,3201.71,75408,254,175,61298,50289,23995,17636,33035
20741,198,211,14815,5926,2.79955e+13,170.187,1644.23,20741,154,141,20530,20530,20298,20398,20517
20997,38,212,14998,5999,2.80028e+13,170.336,1655.25,20997,155,142,15188,11908,4143,3997,5450
26380,131,221,18844,7536,2.7989e+13,170.926,1859.77,26380,164,151,24132,19856,16708,16849,20026
96670,58,349,69045,27625,2.80127e+13,173.148,3644.86,96670,291,175,75852,62050,25392,29749,36460
58497,124,280,41783,16714,2.80144e+13,172.624,2805.17,58497,223,175,52913,43757,35635,36188,42739
19015,207,208,13585,5430,2.79969e+13,169.784,1572.64,19015,151,138,18807,18807,18807,18807,18806
8327,163,189,5948,2379,2.80515e+13,164.408,1033.33,8327,123,114,7979,6341,7277,6976,7652
31873,201,232,22763,9110,2.8029e+13,171.54,2050.34,31873,175,161,31641,31641,30255,30937,31610
87470,126,471,62460,25010,2.81114e+13,173.246,3640.95,87470,275,192,79386,65776,33651,18384,55425
10497,158,193,7496,3001,2.80203e+13,166.561,1162.48,10497,131,121,10015,7983,9076,9709,9442
32437,55,232,23173,9264,2.79757e+13,171.544,2067.95,32437,175,162,25196,20629,8109,12135,12081
35514,80,238,25368,10146,2.79861e+13,171.736,2167,35514,181,168,29289,24636,12188,11540,16952
78022,164,315,55734,22288,2.80002e+13,172.998,3258.39,78022,258,175,76178,59775,68317,73131,72878
96203,285,348,68717,27486,2.80067e+13,173.183,3635.57,96203,291,175,95855,95855,92299,94098,95792
58106,262,421,41484,16622,2.8164e+13,172.812,2978.32,58106,221,193,57685,57565,38681,34765,53082
60374,72,283,43129,17245,2.79946e+13,172.741,2851.33,60374,226,175,48950,40257,18783,16626,27118
3450,135,181,2461,989,2.84868e+13,150.122,662.15,3450,97,93,3069,2561,2285,2419,2658
31537,182,231,22530,9007,2.80017e+13,171.526,2039.04,31537,175,161,31306,31306,28673,29998,31257
84142,50,326,60105,24037,2.80051e+13,173.038,3389.11,84142,269,175,64319,52026,20107,15695,27053
63635,87,289,45454,18181,2.80026e+13,172.755,2930.19,63635,232,175,53332,44387,24163,23188,33981
96030,171,347,68586,27444,2.80102e+13,173.122,3631.23,96030,290,175,94996,74458,84438,90200,93752
62692,133,287,44788,17904,2.79949e+13,172.808,2907.49,62692,231,175,57703,47226,40557,38977,49092
88978,99,478,63530,25448,2.81129e+13,173.209,3677.72,88978,276,192,76499,64524,30196,20250,45226
22304,165,214,15927,6377,2.80412e+13,170.275,1706.66,22304,157,144,21701,17100,19600,20865,20984
45277,96,255,32348,12929,2.79906e+13,172.279,2455.8,45277,199,175,38634,31746,18868,23245,26597
21069,154,212,15051,6018,2.80476e+13,170.179,1658.03,21069,155,142,20086,15921,17689,18404,18535
2849,78,180,2038,811,2.80703e+13,146.899,601.87,2849,93,84,2272,1928,995,1020,1322
24958,683,800,17919,7039,2.51438e+13,214.049,2799.84,24958,778,144,24158,23966,21731,22868,23808
90216,298,800,64529,25687,2.72152e+13,221.878,4464.32,90216,798,180,88994,88460,81833,84938,87790
51632,307,800,36970,14662,2.66561e+13,209.987,3614.45,51632,794,175,50459,49945,46065,47797,49349
49902,49,265,35639,14263,2.8043e+13,172.354,2584.03,49902,207,175,37996,30767,11775,14021,16296
2731,44,179,1948,783,2.80465e+13,145.437,588.135,2731,90,85,2007,1594,643,524,767
91960,682,800,65774,26186,2.72442e+13,235.305,4497.76,91960,779,180,91160,90966,88662,89813,90807
64236,219,290,45885,18351,2.80037e+13,172.806,2944.68,64236,233,175,63946,63946,59820,61914,63875
16332,140,203,11665,4667,2.79149e+13,169.167,1455.28,16332,146,133,15163,12277,11680,11697,13203
29109,599,800,20884,8225,2.55874e+13,210.581,2950.32,29109,778,151,28244,27860,25614,26755,27706
50403,198,265,35996,14407,2.80156e+13,172.462,2596.54,50403,208,175,50138,50138,46317,48252,50071
54947,108,274,39246,15701,2.80101e+13,172.614,2715.96,54947,217,175,48107,40301,26830,25163,35398
17384,158,205,12420,4964,2.79507e+13,169.474,1502.47,17384,148,135,16686,13252,15112,15448,15722
36116,157,380,25779,10337,2.82523e+13,172.095,2365.35,36116,189,169,34606,27466,29615,29919,31477
16221,25,203,11583,4638,2.8028e+13,169.025,1450.41,16221,146,133,10573,7711,2786,2865,2450
68289,96,944,48848,19441,2.71003e+13,222.521,4197.78,68289,800,193,57508,47419,26671,14629,32248
23851,151,217,17039,6812,2.79814e+13,170.731,1766.63,23851,161,147,22640,18028,18775,20128,20751
70065,16,300,50043,20022,2.80111e+13,172.769,3079.82,70065,243,175,38892,27371,11542,7744,10371
7116,92,187,5083,2033,2.8057e+13,162.548,953.899,7116,119,109,5956,4941,2827,2829,3916
91482,38,340,65337,26145,2.80191e+13,173.092,3541.39,91482,282,175,66311,51940,19056,23029,24550
12607,53,197,9007,3600,2.79765e+13,167.886,1275.81,12607,139,127,9693,7974,3118,3374,4291
1053,171,176,750,303,2.83475e+13,97.188,363.005,1053,58,57,877,770,863,870,876
3472,71,180,2481,991,2.78186e+13,150.495,662.607,3472,95,91,2752,2296,1140,975,1524
30965,14,230,22120,8845,2.80052e+13,171.467,2019.88,30965,173,160,16344,11142,4712,3307,2543
88210,355,943,63085,25125,2.73041e+13,251.993,4608.03,88210,641,193,87166,86496,79886,78276,84581
76882,253,313,54916,21966,2.8007e+13,172.98,3233.43,76882,256,175,76569,76569,73205,74904,76509
18188,83,207,12992,5196,2.80389e+13,169.668,1538,18188,150,137,15067,12636,6444,6440,9280
57836,184,278,41313,16523,2.79767e+13,172.644,2788,57836,221,175,57558,57558,51868,54767,57464
10126,83,192,7231,2895,2.79067e+13,166.143,1140.86,10126,129,120,8357,7026,3633,3378,4980
2345,176,178,1675,670,2.79188e+13,140.14,543.637,2345,83,79,2167,2167,2163,2163,2165
65570,138,442,46807,18763,2.8121e+13,172.964,3168.47,65570,234,194,60868,49423,35068,27617,46641
30957,226,230,22111,8846,2.80078e+13,171.474,2019.6,30957,173,160,30727,30727,30704,30710,30723
84125,149,326,60088,24037,2.80041e+13,173.055,3388.83,84125,269,175,79899,63702,64882,67463,72524
44154,103,800,31624,12530,2.64034e+13,212.5,3414.33,44154,761,175,37428,31767,19199,18735,25701
89800,124,336,64141,25659,2.7992e+13,173.094,3506.2,89800,279,175,81273,67195,54715,46994,64912
74718,206,309,53369,21349,2.8006e+13,172.947,3185.66,74718,252,175,74409,74409,68112,71323,74306
67925,249,297,48521,19404,2.80167e+13,172.824,3031.6,67925,240,175,67628,67628,65105,66369,67580
46867,494,800,33571,13296,2.64942e+13,210.001,3489.05,46867,797,175,45879,45586,41724,43664,45149
90653,332,338,64748,25905,2.80128e+13,173.09,3524.09,90653,280,175,90315,90315,90263,90281,90309
80362,169,319,57395,22967,2.80172e+13,172.97,3308.73,80362,262,175,79179,62154,70613,75442,78067
44863,49,255,32047,12816,2.79978e+13,172.195,2444.65,44863,198,175,34155,27652,10585,8312,14167
94823,119,345,67728,27095,2.80104e+13,173.129,3607.5,94823,288,175,84964,70442,52482,57454,66459
73390,43,452,52398,20992,2.81347e+13,173.119,3345.01,73390,260,192,54654,43270,16313,10492,19286
17494,16,206,12489,5005,2.80729e+13,169.247,1507.65,17494,148,135,9706,6842,2882,1660,2222
53605,225,271,38292,15313,2.79995e+13,172.532,2681.03,53605,214,175,53334,53334,50963,52150,53288
45098,315,947,32282,12816,2.66622e+13,209,3627.82,45098,784,191,43798,43264,39563,38375,41578
80106,179,319,57213,22893,2.801e+13,172.948,3303.53,80106,261,175,79787,79787,70969,75478,79647
39996,63,246,28574,11422,2.79865e+13,172.103,2304.09,39996,190,175,31753,26231,11135,10146,15892
99807,315,355,71287,28520,2.80167e+13,173.204,3706.82,99807,298,175,99452,99452,97460,98454,99412
42139,678,800,30192,11947,2.63026e+13,217.01,3357.66,42139,741,178,41339,41169,40479,40803,40974
55845,282,715,39940,15905,2.73554e+13,219.486,3367.84,55845,329,175,55130,54948,54715,54457,54640
69928,220,300,49953,19975,2.79914e+13,172.844,3077.06,69928,243,175,69628,69628,64895,67301,69548
35127,79,237,25095,10032,2.79817e+13,171.803,2154.74,35127,181,168,28887,24114,11900,12100,17185
18798,73,208,13426,5372,2.79979e+13,169.879,1564.14,18798,151,138,15232,12518,6008,6807,8793
94613,200,345,67584,27029,2.80026e+13,173.189,3603.94,94613,288,175,94268,94268,85110,89794,94123
93470,215,343,66764,26706,2.80091e+13,173.152,3580.95,93470,286,175,93127,93127,85145,89222,92999
18493,182,207,13207,5286,2.79496e+13,169.69,1550.54,18493,150,137,18286,18286,17296,17774,18261
44341,39,254,31672,12669,2.80258e+13,172.189,2430.12,44341,197,175,32363,25330,9404,10362,10602
46234,161,258,33021,13213,2.8002e+13,172.369,2483.71,46234,201,175,44828,35311,40406,43262,42571
60726,219,284,43371,17355,2.80132e+13,172.744,2860.43,60726,227,175,60442,60442,56755,58620,60377
75028,199,452,53573,21455,2.81116e+13,173.168,3379.25,75028,252,192,74576,74447,56574,44881,67466
26864,129,223,19185,7679,2.80298e+13,170.938,1877.93,26864,165,152,24479,20223,16790,16871,20228
54764,29,273,39120,15644,2.80034e+13,172.571,2710.63,54764,216,175,37012,27923,9329,6741,10606
6426,218,329,4566,1860,2.96444e+13,157.099,1069.23,6426,113,124,6097,6015,3992,3180,4563
59104,186,281,42215,16889,2.80102e+13,172.642,2820.15,59104,224,175,58823,58823,53073,56001,58728
91463,229,800,65417,26046,2.72444e+13,227.854,4488.63,91463,798,175,90149,89704,81374,85200,88736
39483,85,246,28201,11282,2.80435e+13,171.995,2289.56,39483,189,175,32918,27531,14254,14103,20671
19784,158,210,14127,5657,2.80189e+13,169.978,1605.62,19784,153,139,18996,15090,17205,18422,17792
50019,73,265,35730,14289,2.79998e+13,172.501,2587.13,50019,208,175,40629,33346,15923,16571,23363
44486,238,255,31771,12715,2.80325e+13,172.254,2434.91,44486,198,175,44231,44231,43810,43995,44214
95195,318,346,67998,27197,2.8e+13,173.188,3615.45,95195,289,175,94849,94849,93647,94236,94821
16793,782,800,12069,4724,2.4608e+13,186.05,2346.16,16793,513,131,15993,15993,15986,15947,15993
80813,179,320,57721,23092,2.80194e+13,172.993,3318.59,80813,263,175,80493,80493,71647,76165,80352
63698,166,289,45497,18201,2.79971e+13,172.765,2931.66,63698,232,175,62392,49137,55871,54295,60291
54299,156,272,38785,15514,2.80047e+13,172.514,2698.36,54299,215,175,52203,41298,46245,46829,48673
57021,69,277,40731,16290,2.80012e+13,172.59,2767.82,57021,220,175,45928,37820,16780,14691,24243
87338,506,800,62478,24860,2.71979e+13,231.336,4408.42,87338,798,175,86294,85984,77550,81848,85656
72809,105,450,51983,20826,2.81155e+13,173.064,3330.73,72809,262,177,63339,53443,32850,30044,44530
37660,160,243,26893,10767,2.80214e+13,171.864,2234.58,37660,185,172,36412,28760,32858,35200,34366
47415,82,260,33868,13547,2.80231e+13,172.378,2516.2,47415,203,175,39292,32978,16636,16598,24062
75641,732,800,54111,21530,2.70928e+13,220.507,4170.28,75641,788,180,74841,74656,71859,73266,74638
4050,64,182,2894,1156,2.80898e+13,155.135,717.928,4050,103,94,3158,2649,1151,863,1543
82229,214,473,58707,23522,2.81189e+13,173.198,3543.22,82229,274,192,81756,81633,69519,64226,77655
14712,98,201,10505,4207,2.80412e+13,168.405,1380.45,14712,143,130,12560,10640,6425,7618,8751
11163,112,194,7975,3188,2.80891e+13,166.926,1199.21,11163,133,124,9778,8218,5762,6492,7383
15192,111,202,10848,4344,2.80356e+13,169.023,1403.76,15192,145,131,13314,11166,7770,7536,10018
28815,82,226,20585,8230,2.80083e+13,171.205,1946.2,28815,169,155,23859,20034,10128,8715,14439
68962,138,299,49256,19706,2.8016e+13,172.828,3055.58,68962,242,175,64112,51964,48218,49846,55155
16177,535,800,11645,4532,2.37001e+13,224.174,2428.93,16177,763,128,15259,14951,13221,14062,14582
99210,212,800,70958,28252,2.73011e+13,242.104,4634.13,99210,778,180,97853,97437,88004,92320,96378
22577,97,215,16122,6455,2.80388e+13,170.316,1717.55,22577,157,144,19282,16350,9757,11661,13322
33030,184,233,23601,9429,2.79551e+13,171.694,2087.49,33030,177,164,32797,32797,30157,31484,32748
43076,136,252,30768,12308,2.80055e+13,172.135,2394.3,43076,195,175,39859,32445,29180,30965,33985
12489,598,800,9012,3477,2.23785e+13,231.477,2236.72,12489,731,120,11648,11270,10740,10969,11083
34443,34,236,24594,9849,2.80429e+13,171.604,2133.05,34443,179,166,24212,19365,6525,8447,8950
25911,205,221,18504,7407,2.80228e+13,170.817,1843.39,25911,163,150,25690,25690,25302,25473,25674
98376,138,496,70245,28131,2.81064e+13,173.342,3867.71,98376,295,193,91383,74155,41263,22277,67821
14368,164,200,10262,4106,2.79971e+13,168.637,1363.76,14368,143,129,13904,10967,12602,13389,13440
52157,179,269,37262,14895,2.79994e+13,172.579,2644.01,52157,212,175,51888,51888,46525,49252,51798
11668,160,195,8333,3335,2.80076e+13,167.196,1226.46,11668,135,125,11184,8881,10116,9716,10571
1953,9,178,1398,555,2.76825e+13,136.105,497.518,1953,76,75,845,401,241,122,105
39023,203,245,27877,11146,2.80313e+13,172.011,2275.65,39023,188,174,38778,38778,36664,37717,38736
82701,229,324,59069,23632,2.80113e+13,173.048,3359.43,82701,267,175,82377,82377,76642,79561,82282
15507,105,202,11078,4429,2.79836e+13,169.044,1418.04,15507,145,131,13442,11348,7274,6898,9693
76523,73,312,54663,21860,2.79967e+13,173.012,3225.4,76523,256,175,62196,51031,24354,25339,34853
46689,239,259,33348,13341,2.80065e+13,172.372,2496.51,46689,202,175,46430,46430,45822,46103,46410
61345,230,285,43815,17530,2.80106e+13,172.658,2875.09,61345,228,175,61060,61060,58021,59555,61005
72780,333,800,52074,20706,2.70474e+13,229.223,4109.32,72780,798,175,71575,71055,63253,67079,70507
33956,208,235,24257,9699,2.79847e+13,171.655,2117.29,33956,178,165,33721,33721,32595,33143,33694
86985,266,481,62108,24877,2.80982e+13,173.229,3642.66,86985,273,196,86504,86383,58672,47048,79793
87082,249,331,62205,24877,2.79909e+13,173.112,3450.42,87082,275,175,86751,86751,81871,84350,86669
35791,203,239,25561,10230,2.80292e+13,171.674,2176.15,35791,181,168,35552,35552,33814,34677,35516
79823,225,318,57014,22809,2.80106e+13,172.987,3297.08,79823,261,175,79505,79505,73903,76755,79412
38808,89,244,27724,11084,2.80015e+13,172.001,2268.58,38808,188,174,32629,27061,15098,13708,21114
70987,391,446,50686,20301,2.81331e+13,173.048,3287.44,70987,259,184,70541,70541,68664,68098,70228
67084,212,295,47924,19160,2.79922e+13,172.858,3011.65,67084,239,175,66789,66789,61841,64355,66706
15891,135,800,11442,4449,2.35771e+13,221.82,2414.32,15891,751,128,13678,11270,9207,7959,10397
53974,177,272,38556,15418,2.80246e+13,172.586,2690.89,53974,215,175,53702,53702,47977,50892,53607
99608,322,354,71147,28461,2.80006e+13,173.209,3702.25,99608,297,175,99254,99254,97800,98517,99222
99270,458,800,70997,28273,2.73017e+13,225.21,4635.29,99270,798,180,98213,97894,91728,94848,97444
50725,16,265,36230,14495,2.80016e+13,172.363,2604.42,50725,208,175,28146,19803,8353,5598,7606
4940,35,183,3527,1413,2.80743e+13,157.345,792.472,4940,107,100,3476,2786,969,729,1141
1310,59,177,936,374,2.91277e+13,114.197,406.14,1310,67,68,974,823,374,317,484
55355,264,274,39538,15817,2.80174e+13,172.528,2725.71,55355,217,175,55081,55081,54959,55008,55071
79857,127,318,57044,22813,2.79915e+13,173.044,3297.91,79857,262,175,72686,60031,49362,43186,59128
71956,181,447,51373,20583,2.81103e+13,173.106,3310.02,71956,246,192,71492,71353,51524,44676,65784
10556,106,193,7540,3016,2.80103e+13,166.555,1165.57,10556,132,121,9139,7717,5045,4815,6632
87572,468,471,62524,25048,2.81044e+13,173.23,3642.97,87572,274,193,87101,87101,87089,87091,87098
95161,258,674,68013,27148,2.76889e+13,257.146,4139.94,95161,288,175,94401,94275,88914,91303,93904
36290,3,240,25913,10377,2.80395e+13,171.686,2191.66,36290,182,169,7619,1712,1580,1970,621
29798,9,228,21282,8516,2.79726e+13,171.412,1980.39,29798,171,158,13034,6292,3715,2424,2944
15068,94,201,10761,4307,2.79671e+13,168.675,1396.72,15068,144,131,12766,10519,6120,5908,8497
13158,2,197,9399,3759,2.79929e+13,167.774,1303.04,13158,140,127,1759,332,284,689,200
68770,192,298,49117,19653,2.80124e+13,172.805,3050.61,68770,241,175,68472,68472,61989,65293,68366
7138,183,187,5098,2040,2.80099e+13,162.615,955.652,7138,120,109,6951,6951,6928,6934,6947
4362,107,182,3110,1252,2.81147e+13,155.139,744.808,4362,105,97,3721,3175,2138,2422,2795
81454,102,321,58180,23274,2.80028e+13,173.015,3332,81454,264,175,70484,59476,36714,34093,49871
83672,235,325,59770,23902,2.79975e+13,173.017,3379.05,83672,268,175,83347,83347,77937,80690,83257
55013,29,273,39299,15714,2.79893e+13,172.557,2716.56,55013,217,175,37183,28048,9358,6762,10547
34670,150,237,24763,9907,2.80379e+13,171.748,2141.07,34670,180,167,32908,26224,26884,29243,30060
13646,117,199,9745,3901,2.79718e+13,168.408,1328.56,13646,142,129,12084,10077,7429,6601,9440
97287,599,800,69572,27715,2.73024e+13,237.661,4598.74,97287,798,175,96320,95920,86777,91454,95884
28250,145,225,20179,8071,2.80002e+13,171.195,1926.63,28250,168,155,26555,21316,21135,22245,23605
70665,131,302,50479,20186,2.80064e+13,172.917,3094.77,70665,245,175,64819,53244,44700,45102,54690
92200,30,341,65858,26342,2.80055e+13,173.165,3555.76,92200,284,175,62830,47512,15862,11514,18120
52337,28,268,37386,14951,2.79784e+13,172.48,2647.15,52337,211,175,35090,26295,8904,7477,11534
68677,28,298,49058,19619,2.7999e+13,172.809,3048.48,68677,241,175,46062,34518,11700,8210,13710
89257,27,336,63748,25509,2.80219e+13,173.078,3496.22,89257,278,175,59390,44227,15207,11820,17305
28434,201,226,20310,8124,2.80171e+13,171.378,1934.19,28434,169,155,28208,28208,27258,27714,28183
99586,27,504,71108,28478,2.80986e+13,173.353,3896.31,99586,296,195,66247,49318,16991,7510,17542
11757,60,195,8397,3360,2.79632e+13,167.127,1230.81,11757,135,125,9226,7555,3188,2829,4358
71273,484,800,51002,20271,2.70128e+13,216.229,4076.66,71273,798,175,70250,69948,64367,67199,69525
44581,219,255,31841,12740,2.80265e+13,172.267,2437.45,44581,198,175,44326,44326,42602,43457,44290
62216,47,800,44533,17683,2.68829e+13,235.199,3872.82,62216,692,175,46442,37392,14008,16941,19334
42861,87,252,30609,12252,2.8031e+13,172.172,2388.57,42861,195,175,35910,29888,16265,15859,22615
66603,45,295,47567,19036,2.80253e+13,172.77,3001.12,66603,237,175,50009,39742,14852,18107,20638
57852,523,800,41406,16446,2.6808e+13,211.629,3769.23,57852,794,175,56895,56550,53013,54787,56221
21775,100,213,15555,6220,2.80046e+13,170.322,1685.59,21775,156,143,18714,15797,9744,9620,13236
33689,107,235,24059,9630,2.80269e+13,171.556,2109.28,33689,177,164,29401,24707,16307,18595,21605
34550,63,237,24673,9877,2.80376e+13,171.598,2137.23,34550,179,166,27440,22669,9493,11719,14377
54792,64,274,39134,15658,2.80174e+13,172.504,2712.18,54792,216,175,43636,36152,15080,23875,23090
91354,297,339,65260,26094,2.79982e+13,173.165,3538.25,91354,283,175,91015,91015,88860,89939,90973
14803,43,200,10573,4230,2.79925e+13,168.465,1383.75,14803,143,130,10998,8720,3240,4054,4445
14769,82,200,10554,4215,2.7971e+13,168.662,1382.32,14769,143,130,12188,10261,5235,6997,7561
35760,102,239,25546,10214,2.8018e+13,171.854,2175.59,35760,182,169,30891,26083,16100,14974,21856
18061,111,207,12905,5156,2.80568e+13,169.777,1533.06,18061,150,136,15842,13281,9223,8454,11909
14599,92,200,10423,4176,2.79784e+13,168.41,1373.97,14599,143,130,12315,10168,5786,6019,8408
99797,249,355,71286,28511,2.8004e+13,173.247,3706.7,99797,298,175,99442,99442,92990,96277,99336
90970,255,800,65069,25901,2.72388e+13,245.091,4479,90970,759,180,89714,89212,83812,86137,88383
67516,164,296,48227,19289,2.80029e+13,172.826,3021.77,67516,239,175,65900,51722,59127,60386,63659
55772,142,275,39845,15927,2.80123e+13,172.57,2736.5,55772,218,175,52223,42116,40801,40699,45733
59062,167,281,42189,16873,2.80134e+13,172.704,2819.25,59062,224,175,57941,45554,51843,55393,56620
35661,97,238,25479,10182,2.79734e+13,171.748,2171.37,35661,181,168,30490,25833,15048,15154,20820
30822,153,230,22013,8809,2.80209e+13,171.41,2015.21,30822,173,159,29404,23313,25285,26647,27000
48204,146,261,34427,13777,2.80055e+13,172.374,2537.24,48204,204,175,45478,36484,36366,38111,40756
39751,4,246,28395,11356,2.80103e+13,172.054,2297.11,39751,189,175,10422,3165,2303,2228,965
58309,71,452,41621,16688,2.81553e+13,172.876,3032.51,58309,221,200,47149,38855,16560,11810,22692
68438,206,297,48888,19550,2.79836e+13,172.877,3042.66,68438,241,175,68141,68141,62645,65442,68050
92921,13,342,66372,26549,2.80094e+13,173.147,3569.92,92921,285,175,47545,32091,13947,10595,12370
82895,257,324,59218,23677,2.80001e+13,173.075,3363.27,82895,267,175,82571,82571,78773,80694,82504
65616,702,946,46930,18686,2.70777e+13,216.907,4139.52,65616,813,191,64663,64434,59115,56070,60752
94434,263,345,67453,26981,2.80125e+13,173.184,3600.62,94434,288,175,94089,94089,89241,91705,94007
51495,296,409,36763,14732,2.81404e+13,172.699,2809.08,51495,210,194,51086,50971,44177,44097,50178
71366,538,800,51073,20293,2.70091e+13,214.889,4078.63,71366,798,176,70408,70041,65433,67754,69780
44512,52,254,31798,12714,2.79876e+13,172.324,2434.82,44512,198,175,34230,27742,11050,12710,15467
2359,42,179,1685,674,2.84112e+13,140.471,546.679,2359,86,80,1714,1372,533,391,598
40765,258,389,29105,11660,2.82113e+13,172.427,2507.93,40765,201,175,40376,40255,40059,39940,39955
20958,126,212,14971,5987,2.8008e+13,170.252,1653.63,20958,155,141,18970,15727,12853,12177,15519
67609,569,942,48352,19257,2.7123e+13,217.85,4179.87,67609,791,181,66568,66168,63524,64205,65324
68745,273,299,49094,19651,2.80287e+13,172.818,3051.11,68745,241,175,68446,68446,67413,67913,68420
16181,310,346,11535,4646,2.85492e+13,169.909,1625.15,16181,160,151,15835,15822,14584,14168,15695
91338,414,800,65331,26007,2.72277e+13,228.263,4485.86,91338,793,180,90273,89580,86082,88036,89380
55527,2,274,39668,15859,2.79913e+13,172.623,2729.98,55527,218,175,7424,1401,1204,2909,610
10372,25,193,7402,2970,2.80866e+13,165.931,1155.16,10372,130,121,6760,4932,1781,1258,1747
43976,637,800,31501,12475,2.64142e+13,214.877,3409.61,43976,798,175,43121,42947,38713,40889,42688
88859,288,335,63471,25388,2.80079e+13,173.13,3487.8,88859,278,175,88524,88524,86078,87304,88477
66633,171,295,47589,19044,2.80191e+13,172.737,3001.65,66633,237,175,65862,51652,58650,62580,64883
32268,246,374,23028,9240,2.82747e+13,171.929,2242.71,32268,189,178,31894,31773,26070,22702,29937
41517,33,249,29653,11864,2.80261e+13,172.079,2348.91,41517,192,175,28955,22140,7684,6767,10220
35300,122,238,25209,10091,2.80202e+13,171.68,2160.69,35300,180,167,31764,26332,20501,21718,25571
10612,77,193,7576,3036,2.80351e+13,166.737,1168.86,10612,131,122,8651,7230,3595,4081,5194
43449,222,253,31038,12411,2.79951e+13,172.264,2405.39,43449,196,175,43196,43196,41844,42506,43165
88107,253,334,62929,25178,2.80137e+13,173.128,3472.6,88107,277,175,87773,87773,83015,85431,87692
92343,411,800,66055,26288,2.7244e+13,248.976,4505.67,92343,753,180,91307,90582,89316,90130,90376
25145,184,295,17945,7200,2.81708e+13,168.969,1905.28,25145,166,148,24850,24847,23107,23938,24688
88783,41,334,63411,25372,2.80034e+13,173.103,3485.24,88783,277,175,65471,51525,18627,16853,26347
99641,427,495,71149,28492,2.80958e+13,173.344,3887.72,99641,296,192,99146,99146,95418,97305,99078
74249,145,800,53124,21125,2.70603e+13,243.696,4140.54,74249,795,175,68994,55408,54032,59603,60205
10081,109,193,7198,2883,2.81432e+13,165.862,1139.26,10081,130,120,8766,7389,5001,5713,6585
55831,652,800,39936,15895,2.71959e+13,221.253,3518.89,55831,563,175,55031,54933,48242,40265,12221
79099,157,317,56501,22598,2.80052e+13,173.012,3281.82,79099,260,175,76244,60173,69119,71678,71374
72790,185,306,51994,20796,2.80224e+13,172.955,3143.08,72790,249,175,72484,72484,64993,68816,72363
12555,48,197,8967,3588,2.80138e+13,167.985,1273.49,12555,139,127,9486,7644,2926,2294,3831
22951,68,216,16389,6562,2.80482e+13,170.456,1732.6,22951,158,145,18412,15217,6765,7557,9955
38653,86,243,27612,11041,2.799e+13,171.88,2263.08,38653,187,174,32285,26968,14326,18596,20735
9511,142,191,6796,2715,2.79495e+13,165.911,1105.81,9511,128,117,8808,7148,6899,7308,7714
26189,124,222,18705,7484,2.80695e+13,170.962,1854.05,26189,165,151,23621,19566,15926,16208,19202
43666,165,253,31187,12479,2.79979e+13,172.241,2411,43666,196,175,42641,33508,38297,36610,41118
65827,288,293,47022,18805,2.80027e+13,172.8,2982.35,65827,237,175,65534,65534,65498,65509,65529
98622,208,800,70530,28092,2.73012e+13,233.434,4623.26,98622,798,175,97256,96850,87170,91615,95772
62316,296,436,44488,17828,2.81275e+13,172.932,3090.58,62316,228,196,61880,61762,50043,49468,59668
16911,162,205,12076,4835,2.80416e+13,169.409,1482.35,16911,148,134,16329,12919,14738,15740,15550
98652,305,353,70459,28193,2.80208e+13,173.165,3684.31,98652,295,175,98299,98299,95764,97038,98251
21734,138,213,15527,6207,2.79796e+13,170.421,1684.44,21734,156,142,20138,16349,15156,14794,17379
57813,103,279,41291,16522,2.80219e+13,172.536,2788.17,57813,221,175,50112,42418,26206,31275,35921
27966,182,224,19982,7984,2.79573e+13,171.222,1916.31,27966,167,154,27742,27742,25588,26667,27700
98319,4,352,70224,28095,2.80083e+13,173.148,3677.33,98319,294,175,25776,7828,5692,5512,2145
82547,415,465,58941,23606,2.81095e+13,173.187,3540.41,82547,265,192,82082,82082,79580,80836,82032
96876,134,349,69200,27676,2.80039e+13,173.199,3648.62,96876,293,175,89398,73008,64108,67405,76205
83616,514,589,59756,23860,2.77485e+13,240.19,3765.65,83616,267,175,83027,82952,82964,82963,83027
94217,91,345,67289,26928,2.80247e+13,173.141,3596.53,94217,287,175,79676,65744,36884,46370,52801
61991,265,286,44280,17711,2.80094e+13,172.726,2890.55,61991,229,175,61705,61705,60987,61325,61684
12086,133,195,8637,3449,2.79245e+13,167.332,1248.1,12086,137,126,11028,9076,7828,8235,9211
49948,55,265,35678,14270,2.80256e+13,172.419,2585.17,49948,208,175,38815,31775,12492,9244,16940
76011,100,311,54296,21715,2.79926e+13,172.991,3213.98,76011,255,175,65479,55220,33957,31521,45731
79823,117,800,57107,22716,2.71374e+13,239.7,4257.52,79823,798,175,70342,58505,42353,37240,53639
67597,237,438,48263,19334,2.81359e+13,172.98,3207.62,67597,238,193,67159,67038,44478,32545,61092
3243,66,180,2318,925,2.80472e+13,150.205,641.341,3243,95,90,2533,2122,944,906,1299
80780,72,800,57785,22995,2.71523e+13,238.998,4277.25,80780,755,180,64812,53447,24669,18172,33480
28470,4,225,20333,8137,2.79866e+13,171.185,1933.94,28470,168,155,7461,2270,1649,1957,669
59136,39,281,42237,16899,2.80021e+13,172.65,2820.9,59136,224,175,43172,33782,11883,13813,15507
38188,131,243,27276,10912,2.80027e+13,171.977,2249.94,38188,186,173,34997,28754,24145,23204,29313
96016,205,348,68583,27433,2.80114e+13,173.18,3632.13,96016,291,175,95668,95668,86666,91267,95525
28794,386,800,20652,8142,2.5579e+13,209.039,2938.77,28794,769,151,27725,27149,25122,26107,26752
71497,94,411,51084,20413,2.79167e+13,172.423,3246.57,71497,246,175,60724,49967,29099,35830,41013
15177,197,201,10836,4341,2.79704e+13,168.771,1401.77,15177,144,131,14976,14976,14953,14959,14972
11620,65,195,8299,3321,2.80143e+13,167.204,1223.91,11620,135,125,9227,7645,3275,2934,4650
23714,23,217,16933,6781,2.80244e+13,170.611,1761.29,23714,160,146,15033,10978,4046,2713,4136
62220,126,287,44446,17774,2.8024e+13,172.773,2896.92,62220,230,175,56494,46758,38227,38699,46512
10446,118,193,7457,2989,2.80628e+13,166.222,1159.11,10446,131,121,9246,7713,5788,6325,7330
25344,23,220,18101,7243,2.79664e+13,170.963,1822.59,25344,163,150,16063,11716,4305,3971,3132
78528,223,316,56091,22437,2.80063e+13,172.987,3269.38,78528,259,175,78212,78212,72629,75468,78119
52856,159,269,37761,15095,2.79807e+13,172.526,2660.75,52856,213,175,51099,40386,46165,49468,48033
12695,86,197,9066,3629,2.80378e+13,167.56,1280.35,12695,140,126,10560,8848,4732,6113,6728
73553,220,307,52537,21016,2.80055e+13,172.937,3159.72,73553,250,175,73246,73246,68046,70690,73159
4529,34,182,3233,1296,2.82284e+13,156.24,759.033,4529,105,99,3163,2542,883,949,908
36383,125,240,25988,10395,2.80104e+13,171.811,2194.62,36383,183,169,32943,27332,22198,22580,26746
60293,365,429,43042,17251,2.81536e+13,172.937,3037.87,60293,241,184,59864,59864,57891,57536,59356
18334,116,207,13089,5245,2.80307e+13,169.741,1544.08,18334,150,137,16247,13553,9685,9310,12571
44789,180,255,31993,12796,2.80032e+13,172.183,2442.9,44789,198,175,44534,44534,40129,42364,44459
21614,78,359,15420,6194,2.83755e+13,170.907,1861.1,21614,171,161,17691,14848,6433,4925,9264
60189,55,283,42988,17201,2.80129e+13,172.647,2847.03,60189,225,175,46788,38304,15059,18092,21730
9684,38,191,6924,2760,2.79152e+13,166.27,1115.7,9684,129,119,6985,5478,1970,1758,2430
94094,167,344,67206,26888,2.80029e+13,173.167,3593.36,94094,287,175,92406,72606,82520,88278,89884
96372,279,348,68844,27528,2.79984e+13,173.206,3638.71,96372,291,175,96024,96024,92034,94058,95955
93360,134,343,66685,26675,2.80105e+13,173.179,3579.11,93360,286,175,86170,70357,61733,62109,72795
56984,190,277,40708,16276,2.8012e+13,172.615,2767.08,56984,220,175,56707,56707,51538,54165,56620
15346,150,202,10960,4386,2.80204e+13,169.04,1410.75,15346,145,131,14494,11581,11870,12895,13239
17045,42,204,12178,4867,2.79118e+13,169.496,1487.23,17045,148,135,12601,9963,3667,4939,5246
49448,254,263,35318,14130,2.79929e+13,172.385,2570.59,49448,206,175,49185,49185,49070,49118,49176
53654,4,413,38300,15354,2.81522e+13,172.734,2866.2,53654,212,192,14050,4280,3117,3005,1256
98052,326,351,70039,28013,2.80012e+13,173.163,3671.47,98052,294,175,97701,97701,96711,97189,97676
84490,259,327,60344,24146,2.80181e+13,173.007,3396.76,84490,269,175,84163,84163,80249,82232,84095
5189,114,183,3710,1479,2.79755e+13,158.663,812.56,5189,107,102,4525,3811,2713,3040,3445
82473,250,323,58909,23564,2.80017e+13,173.052,3354,82473,266,175,82150,82150,77897,80054,82077
65233,140,292,46594,18639,2.80052e+13,172.756,2968.29,65233,235,175,60881,49155,46783,47389,53456
57247,50,421,40865,16382,2.81784e+13,172.797,2959.95,57247,235,177,43762,35427,13567,15123,18945
84754,5,327,60539,24215,2.80006e+13,173.044,3401.87,84754,270,175,26361,9349,5670,4901,2424
81062,216,470,57878,23184,2.81051e+13,173.159,3517.04,81062,262,192,80592,80469,65757,55610,74494
16166,68,203,11556,4610,2.7949e+13,169.382,1448.43,16166,147,133,12935,10698,4739,4412,6874
72101,320,800,51587,20514,2.70228e+13,221.475,4094.68,72101,798,175,70898,70377,63633,66872,69791
55777,411,419,39820,15957,2.81535e+13,172.879,2923.52,55777,233,189,55358,55358,55283,55313,55350
6199,96,185,4428,1771,2.79823e+13,161.25,889.333,6199,113,106,5232,4320,2608,2505,3510
91633,126,340,65449,26184,2.80144e+13,173.17,3544.49,91633,283,175,83257,68883,56298,49413,68105
13685,123,199,9771,3914,2.80466e+13,168.486,1331.08,13685,142,128,12264,10196,8173,7881,9843
53503,183,271,38224,15279,2.79949e+13,172.547,2678.29,53503,214,175,53232,53232,48000,50661,53144
52541,71,269,37530,15011,2.80038e+13,172.506,2653.1,52541,212,175,42505,34937,16068,17227,23650
86326,220,330,61667,24659,2.79996e+13,173.115,3435.16,86326,273,175,85996,85996,79218,82677,85886
2392,126,178,1710,682,2.78414e+13,141.76,549.989,2392,85,79,2070,1758,1448,1242,1658
7119,40,187,5087,2032,2.80056e+13,163.004,954.427,7119,119,109,5188,4083,1508,1531,1973
64696,235,291,46211,18485,2.80091e+13,172.803,2955.65,64696,234,175,64405,64405,61319,62875,64349
98519,73,352,70372,28147,2.80057e+13,173.214,3681.03,98519,295,175,80103,65715,31356,27835,44775
74070,207,800,52993,21077,2.7063e+13,225.678,4136.78,74070,798,175,72744,72343,64653,68101,71297
31569,10,231,22548,9021,2.80134e+13,171.522,2039.74,31569,174,160,14434,7813,4334,2793,1919
18630,280,690,13354,5276,2.62475e+13,178.451,2163.7,18630,304,136,17940,17850,17624,17441,17552
81519,601,800,58319,23200,2.7148e+13,235.155,4292.06,81519,798,175,80567,80175,71892,76122,80122
93085,21,342,66489,26596,2.80055e+13,173.126,3572.8,93085,285,175,57391,40901,15833,9597,14037
90011,109,336,64293,25718,2.80046e+13,173.096,3510.27,90011,279,175,79016,66219,44295,50961,58543
21017,126,212,15013,6004,2.80097e+13,170.292,1655.92,21017,155,142,19026,15770,12890,10656,15280
73107,12,946,52287,20820,2.71555e+13,243.235,4305.52,73107,694,193,36065,23262,10739,4556,7966
86600,134,330,61865,24735,2.79906e+13,173.07,3440.13,86600,274,175,79914,65267,57294,51217,67400
32432,127,233,23163,9269,2.80191e+13,171.664,2069.15,32432,176,162,29463,24348,20017,17387,24352
16753,105,204,11967,4786,2.79698e+13,169.386,1474.72,16753,147,133,14525,12262,7853,7449,10471
48124,38,261,34376,13748,2.80024e+13,172.377,2535.28,48124,204,175,34866,27307,10085,11073,12688
70263,308,444,50161,20102,2.81384e+13,173.03,3271.67,70263,243,192,69819,69806,64428,60332,66426
32277,55,233,23059,9218,2.79922e+13,171.706,2064.29,32277,176,162,25053,20518,8058,7721,11327
96803,272,349,69143,27660,2.80091e+13,173.171,3647.24,96803,292,175,96454,96454,91955,94238,96377
91389,96,800,65361,26028,2.72511e+13,253.853,4486.95,91389,798,175,77301,63587,37360,45678,52210
48806,163,800,34952,13854,2.65783e+13,213.824,3540.85,48806,767,177,46468,36656,40678,43362,43128
24861,58,219,17759,7102,2.8017e+13,170.819,1804.55,24861,162,148,19466,15947,6533,7484,9507
43906,130,253,31365,12541,2.79827e+13,172.214,2417.54,43906,196,175,40163,33070,27617,25260,33112
87110,30,472,62199,24911,2.81015e+13,173.232,3635.24,87110,273,192,59378,44873,15011,14002,18390
12407,107,197,8864,3543,2.80418e+13,167.874,1266.44,12407,139,126,10769,9068,5982,5558,7778
36608,237,241,26145,10463,2.80421e+13,171.752,2202.22,36608,183,170,36367,36367,36349,36353,36363
57188,68,277,40856,16332,2.79908e+13,172.679,2772.08,57188,221,175,45946,37924,16719,18203,24564
53150,129,270,37970,15180,2.79981e+13,172.529,2668.95,53150,214,175,48520,40038,33245,33343,40215
54601,365,800,39092,15509,2.67177e+13,217.147,3689.42,54601,798,175,53461,52909,47425,50141,52496
57382,14,278,40985,16397,2.8014e+13,172.587,2777.23,57382,221,175,30291,20648,8720,5510,6888
97846,181,351,69890,27956,2.80084e+13,173.218,3668,97846,294,175,97495,97495,86657,92204,97325
63008,758,800,45093,17915,2.68824e+13,214.402,3891.01,63008,785,180,62208,62037,59497,60767,62083
17995,50,206,12852,5143,2.79407e+13,169.576,1528.98,17995,149,136,13722,11115,4302,5085,5946
7940,178,188,5670,2270,2.79644e+13,163.716,1007.67,7940,121,112,7752,7752,7610,7671,7742
95833,151,347,68454,27379,2.80002e+13,173.154,3627.71,95833,290,175,91382,72575,75668,81179,83801
28587,179,225,20415,8172,2.80003e+13,171.136,1937.88,28587,168,155,28362,28362,25943,27157,28316
19129,129,208,13671,5458,2.79329e+13,169.862,1577.46,19129,152,139,17397,14387,11967,10749,14375
81816,603,800,58529,23287,2.71664e+13,220.474,4298.31,81816,798,175,80900,80500,74567,77602,80425
35323,236,238,25232,10091,2.80218e+13,171.773,2161.44,35323,181,168,35085,35085,35081,35081,35083
74527,444,800,53320,21207,2.7067e+13,221.845,4146.66,74527,798,175,73446,72799,66239,69774,72659
99812,603,942,71361,28451,2.73946e+13,226.887,4830.25,99812,798,192,98735,98295,90974,94483,97853
72608,12,305,51860,20748,2.79957e+13,172.886,3138.03,72608,248,175,35835,22712,10764,6695,5098
11058,107,194,7899,3159,2.8012e+13,166.771,1193.61,11058,133,124,9591,8082,5350,5005,6995
94320,58,345,67378,26942,2.8015e+13,173.203,3598.64,94320,288,175,73995,60526,24731,23573,35743
43745,95,254,31245,12500,2.80213e+13,172.173,2414.16,43745,196,175,37251,30675,18088,22310,25461
76967,127,800,55076,21891,2.7076e+13,216.913,4198.09,76967,798,180,69125,57186,46312,39896,54935
33186,110,234,23706,9480,2.80019e+13,171.678,2093.23,33186,177,163,29152,24446,16729,15334,21759
46291,226,258,33066,13225,2.8001e+13,172.324,2485.16,46291,201,175,46033,46033,44607,45308,46001
98975,321,800,70782,28193,2.73119e+13,233.948,4630.08,98975,798,175,97737,97202,88000,92496,96584
40177,221,246,28701,11476,2.79831e+13,172.036,2309.02,40177,189,175,39931,39931,38936,39417,39906
21350,21,213,15251,6099,2.80542e+13,170.33,1669.79,21350,156,142,13154,9383,3647,2784,2699
96684,216,349,69064,27620,2.80013e+13,173.21,3645.19,96684,292,175,96335,96335,88041,92277,96202
80462,11,320,57471,22991,2.80261e+13,173.029,3311.66,80462,263,175,38275,23586,11791,6706,7890
85263,240,328,60907,24356,2.79986e+13,173.1,3412.87,85263,272,175,84935,84935,79652,82341,84847
64984,218,291,46424,18560,2.7989e+13,172.817,2962.05,64984,235,175,64693,64693,60427,62592,64620
90446,128,479,64586,25860,2.8094e+13,173.242,3704.58,90446,279,193,82433,68019,46520,35119,62274
88839,421,800,63546,25293,2.72155e+13,224.063,4437.64,88839,798,180,87772,87085,83003,85258,86902
44001,116,253,31436,12565,2.79831e+13,172.219,2420.01,44001,197,175,39127,32587,23242,20961,30123
33713,219,235,24083,9630,2.8011e+13,171.705,2110.1,33713,178,165,33478,33478,33120,33275,33462
71417,47,303,51013,20404,2.80032e+13,172.899,3111.46,71417,246,175,54005,43249,16413,19646,23317
12162,115,196,8689,3473,2.80046e+13,167.334,1252.79,12162,137,126,10707,8984,6413,7212,8175
3073,205,318,2186,887,3.02835e+13,128.679,767.01,3073,99,93,2755,2726,2547,2517,2484
7108,92,187,5075,2033,2.80488e+13,162.697,953.345,7108,119,109,5945,4933,2826,2749,3902
54465,202,273,38907,15558,2.80046e+13,172.621,2703.69,54465,216,175,54192,54192,50117,52182,54121
29004,90,226,20722,8282,2.79713e+13,171.345,1952.81,29004,170,157,24412,20217,11329,10949,15964
88502,562,945,63281,25221,2.73095e+13,242.656,4620.42,88502,814,192,87351,87002,77485,72595,80840
73827,261,308,52736,21091,2.79988e+13,172.987,3166.5,73827,251,175,73519,73519,71079,72301,73472
94291,26,345,67346,26945,2.80161e+13,173.163,3598.01,94291,288,175,62216,45696,16052,11288,17316
55072,266,274,39341,15731,2.80207e+13,172.624,2719.14,55072,217,175,54798,54798,54710,54745,54790
2909,41,179,2080,829,2.7782e+13,146.824,605.869,2909,90,85,2112,1676,609,690,789
49831,63,265,35586,14245,2.80207e+13,172.383,2582.17,49831,207,175,39589,32694,13665,16867,20575
17424,168,206,12441,4983,2.80564e+13,169.47,1505.27,17424,149,135,17008,13404,15438,16331,16500
19980,186,210,14269,5711,2.80047e+13,170.079,1613.47,19980,153,139,19770,19770,18848,19291,19746
47211,119,800,33808,13403,2.65308e+13,220.408,3498.19,47211,738,180,41379,34412,25047,27095,31539
60483,74,283,43200,17283,2.79861e+13,172.707,2853.67,60483,226,175,49263,40447,19616,18854,27428
43648,209,253,31182,12466,2.79997e+13,172.208,2410.76,43648,196,175,43395,43395,41160,42277,43351
25900,217,221,18495,7405,2.80184e+13,170.889,1842.82,25900,164,150,25679,25679,25656,25662,25675
30608,10,229,21865,8743,2.79821e+13,171.464,2007.6,30608,173,159,13990,7567,4201,3042,3194
39578,414,421,28285,11293,2.77485e+13,170.525,2504.35,39578,188,175,39157,39157,39157,39157,39154
14144,141,200,10100,4044,2.80822e+13,168.485,1353.44,14144,143,129,13128,10644,10160,11330,11567
33855,21,235,24188,9667,2.79892e+13,171.619,2114.15,33855,178,165,20862,14869,5748,5696,4543
40820,56,248,29152,11668,2.80149e+13,172.067,2328.7,40820,191,175,31812,26116,10270,7642,14359
97291,335,350,69495,27796,2.80046e+13,173.202,3657.09,97291,293,175,96941,96941,96623,96762,96926
39813,23,800,28523,11290,2.62586e+13,221.577,3290.21,39813,794,171,24951,18519,6613,6223,5219
10941,154,194,7809,3132,2.80929e+13,166.354,1186.77,10941,132,123,10369,8256,9143,9507,9521
14391,49,200,10277,4114,2.79915e+13,168.49,1364.7,14391,143,130,10925,8858,3410,3750,4580
83743,294,325,59813,23930,2.80125e+13,173.02,3380.5,83743,268,175,83418,83418,82032,82714,83387
35687,255,378,25477,10210,2.82408e+13,172.049,2350.24,35687,180,177,35309,35188,25019,21855,32763
59333,35,281,42375,16958,2.80231e+13,172.624,2825.47,59333,224,175,42039,33466,11416,14625,15048
88662,209,732,63378,25284,2.7589e+13,250.037,4112.93,88662,346,175,87808,87672,79751,83347,87002
18103,60,207,12922,5181,2.8054e+13,169.403,1534.24,18103,149,136,14243,11652,4900,5692,7010
42812,185,251,30584,12228,2.79874e+13,172.173,2386.23,42812,194,175,42561,42561,38775,40694,42495
61503,72,285,43929,17574,2.79958e+13,172.735,2878.71,61503,228,175,49875,41014,19167,20290,27565
35071,233,237,25055,10016,2.79823e+13,171.839,2153.22,35071,181,168,34834,34834,34809,34816,34830
82899,165,324,59218,23681,2.80055e+13,173.071,3363.33,82899,267,175,81095,63661,72617,77724,78195
96077,265,348,68622,27455,2.80141e+13,173.202,3633.39,96077,291,175,95729,95729,90818,93313,95646
76609,67,312,54716,21893,2.80131e+13,172.894,3226.72,76609,255,175,61458,50697,22321,33816,33226
12539,190,197,8949,3590,2.80722e+13,167.412,1272.42,12539,138,126,12342,12342,12271,12298,12335
23294,100,216,16643,6651,2.79917e+13,170.694,1745.57,23294,159,145,20023,16899,10389,8554,13790
41624,318,800,29825,11799,2.631e+13,218.261,3342.98,41624,734,179,40502,39955,38863,39168,39378
25148,348,362,17943,7205,2.83408e+13,171.468,1994.96,25148,176,166,24786,24786,24548,24657,24772
97531,493,800,69752,27779,2.72947e+13,249.12,4603.13,97531,798,175,96440,96158,85379,90887,95806
55302,145,274,39501,15801,2.8006e+13,172.573,2724.48,55302,217,175,52088,41761,41449,45915,46536
10573,144,193,7547,3026,2.7992e+13,166.615,1166.57,10573,131,122,9833,7948,7808,7731,8753
32448,166,233,23183,9265,2.79791e+13,171.567,2069.27,32448,176,163,31702,25000,28525,29040,30864
7841,191,329,5583,2258,2.92325e+13,165.434,1166.42,7841,132,129,7507,7373,5418,4302,6603
16325,126,203,11653,4672,2.79699e+13,169.03,1454.58,16325,146,133,14760,12247,10029,8658,12103
3989,97,182,2850,1139,2.80605e+13,154.803,712.901,3989,103,94,3339,2858,1702,1639,2306
51931,36,268,37090,14841,2.80101e+13,172.44,2637.19,51931,210,175,37069,29387,10521,7347,11989
89941,197,337,64249,25692,2.80013e+13,173.142,3510,89941,280,175,89604,89604,80841,85318,89464
81505,268,800,58308,23197,2.71509e+13,218.635,4291.85,81505,798,180,80272,79764,74369,76766,78993
56478,88,297,40343,16135,2.79912e+13,172.487,2780.41,56478,219,175,47394,39396,21671,27353,30565
95859,280,347,68474,27385,2.79999e+13,173.213,3628.48,95859,291,175,95512,95512,91648,93605,95445
71995,218,304,51431,20564,2.79955e+13,172.962,3124.74,71995,248,175,71691,71691,66542,69162,71605
41507,37,249,29649,11858,2.80125e+13,172.073,2348.75,41507,192,175,29846,23487,8566,6558,10285
52546,79,269,37532,15014,2.80065e+13,172.45,2653.22,52546,212,175,43263,36098,17830,24509,26221
24053,162,218,17182,6871,2.79805e+13,170.917,1775.16,24053,161,147,23289,18385,21014,22451,22133
84394,22,327,60283,24111,2.80032e+13,173.099,3395.12,84394,270,175,52784,37530,14349,8849,13331
69614,78,300,49721,19893,2.80125e+13,172.824,3070.5,69614,242,175,57223,47693,23337,24465,34085
74009,198,308,52866,21143,2.80099e+13,172.971,3170.12,74009,251,175,73701,73701,66943,70390,73591
21507,165,212,15363,6144,2.79804e+13,170.236,1674.69,21507,156,143,20928,16485,18907,20118,20251
12012,165,196,8576,3436,2.80614e+13,167.552,1245.42,12012,137,125,11616,9182,10575,11196,11245
84376,34,326,60274,24102,2.79942e+13,173.092,3393.84,84376,270,175,59324,47430,15910,11440,18736
9160,694,800,6632,2528,2.04281e+13,248.765,2030.65,9160,728,108,8360,8194,7722,7931,8043
44232,133,254,31599,12633,2.80025e+13,172.238,2427.21,44232,197,175,40702,33313,28615,30210,34654
39539,623,800,28332,11207,2.62375e+13,212.436,3282.5,39539,797,170,38679,38279,34822,36745,38208
73216,5,307,52296,20920,2.80267e+13,172.916,3152.74,73216,250,175,22782,8083,4902,4238,2080
27836,714,800,19976,7860,2.54323e+13,209.459,2905.33,27836,771,150,27036,26854,25218,26034,26779
43571,114,252,31130,12441,2.79846e+13,172.212,2407.6,43571,196,175,38583,32267,22772,23971,29415
65717,493,800,47035,18682,2.69291e+13,213.232,3952.99,65717,798,176,64724,64402,60305,62358,63996
71584,265,304,51136,20448,2.80067e+13,172.95,3115.96,71584,247,175,71280,71280,69380,70326,71241
19269,596,800,13850,5419,2.4391e+13,217.851,2569.97,19269,769,134,18410,18038,16421,17214,17857
68188,143,297,48707,19481,2.79974e+13,172.8,3037.09,68188,240,175,64015,51507,50379,49890,56344
28284,149,225,20204,8080,2.80413e+13,171.158,1927.93,28284,168,155,26765,21387,21778,23644,24172
18655,25,208,13316,5339,2.80541e+13,169.532,1557.95,18655,150,137,12166,8871,3186,2248,3150
28819,88,226,20586,8233,2.79995e+13,171.338,1946.73,28819,169,155,24167,20082,11049,9388,15412
37832,49,242,27025,10807,2.7987e+13,171.843,2238.5,37832,185,172,28796,23321,8929,7001,11984
52321,112,269,37367,14954,2.80193e+13,172.433,2647.58,52321,211,175,46193,38667,27092,30387,35006
8486,118,189,6059,2427,2.79241e+13,164.457,1042.64,8486,123,114,7509,6259,4656,4372,5952
17940,69,207,12815,5125,2.80185e+13,169.872,1528.04,17940,150,136,14395,11873,5277,4929,7727
94817,315,345,67728,27089,2.79988e+13,173.158,3607.43,94817,288,175,94472,94472,93134,93793,94442
74668,249,309,53334,21334,2.80059e+13,172.932,3184.57,74668,252,175,74359,74359,70977,72687,74299
79819,397,800,57103,22716,2.71335e+13,247.23,4257.57,79819,797,175,78649,78081,68451,73553,77760
71103,442,800,50875,20228,2.70318e+13,231.384,4073.29,71103,757,180,70096,69380,68086,68905,69229
57844,270,278,41325,16519,2.79801e+13,172.623,2788.06,57844,222,175,57566,57566,57472,57510,57558
80089,166,319,57208,22881,2.80072e+13,173.035,3303.39,80089,262,175,78483,61788,70195,75104,75821
82454,314,465,58878,23576,2.809e+13,173.19,3539.93,82454,265,193,81989,81976,74477,72173,79467
12248,8,196,8741,3507,2.79804e+13,167.61,1257.3,12248,137,126,5087,2329,1420,978,843
39407,234,246,28149,11258,2.80118e+13,172.099,2287.55,39407,189,175,39161,39161,38988,39062,39149
58700,107,280,41930,16770,2.79966e+13,172.652,2809.88,58700,223,175,51309,43059,28355,26265,37551
34747,67,237,24821,9926,2.80163e+13,171.686,2143.26,34747,180,167,27836,22977,10148,8837,14390
8435,3,189,6034,2401,2.78593e+13,165.012,1040.45,8435,125,114,1765,391,364,561,131
42318,22,251,30230,12088,2.7998e+13,172.229,2373.02,42318,194,175,26458,18813,7202,4822,7333
58997,38,281,42142,16855,2.80228e+13,172.694,2817.78,58997,224,175,42745,33486,11968,14855,16471
15689,486,800,11287,4402,2.3881e+13,196.082,2374.14,15689,716,128,14889,14676,12620,9595,1532
3927,69,181,2804,1123,2.81818e+13,153.345,706.097,3927,101,94,3111,2591,1231,1747,1717
20444,5,211,14605,5839,2.80027e+13,170.194,1632.76,20444,154,140,6358,2256,1368,1523,872
58296,410,866,41666,16630,2.75142e+13,221.172,3625.28,58296,337,192,57430,57239,56892,56640,56869
51542,156,268,36811,14731,2.80193e+13,172.499,2627.66,51542,211,175,49526,39190,43894,46565,45986
50731,279,800,36325,14406,2.66188e+13,213.916,3590.87,50731,769,180,49555,49046,46799,47608,48364
74198,283,308,52998,21200,2.79992e+13,172.942,3173.93,74198,251,175,73890,73890,72912,73384,73865
33980,59,235,24268,9712,2.8019e+13,171.579,2118.07,33980,178,165,26709,21806,9021,14379,13513
25381,204,220,18135,7246,2.79811e+13,170.97,1824.06,25381,163,150,25161,25161,24825,24967,25145
32724,28,234,23366,9358,2.80401e+13,171.565,2078.72,32724,176,163,21937,16449,5587,4114,6262
25503,207,220,18221,7282,2.79908e+13,170.939,1828.33,25503,164,150,25283,25283,25044,25146,25270
89623,386,800,64099,25524,2.72351e+13,224.348,4452.89,89623,798,175,88477,87867,80639,84268,87537
29850,193,228,21321,8529,2.79994e+13,171.319,1982.11,29850,171,157,29622,29622,27947,28778,29587
38450,4,244,27467,10983,2.80243e+13,172.019,2258.5,38450,187,173,10081,3053,2225,2153,834
94033,301,344,67166,26867,2.80046e+13,173.181,3592.34,94033,287,175,93689,93689,91479,92584,93646
90828,520,800,64970,25858,2.72365e+13,227.126,4476.51,90828,797,180,89865,89467,85716,87625,89188
22040,26,214,15743,6297,2.80256e+13,170.519,1696.9,22040,157,143,14522,10676,3769,3601,4439
34820,136,237,24871,9949,2.7998e+13,171.745,2145.63,34820,180,167,32170,26212,23592,25018,27407
86137,415,800,61613,24524,2.72094e+13,226.804,4384.56,86137,798,175,85012,84388,76709,80811,84166
84318,22,327,60222,24096,2.80202e+13,173.018,3393.52,84318,269,175,52746,37515,14362,10398,14027
54324,96,800,38868,15456,2.70847e+13,219.749,3522.61,54324,465,175,45823,37736,22190,26988,30730
11557,5,195,8262,3295,2.79477e+13,167.377,1220.99,11557,135,125,3587,1267,772,816,275
82135,788,800,58759,23376,2.71535e+13,235.357,4304.59,82135,767,180,81335,81187,80702,80928,81300
96254,313,800,68841,27413,2.72809e+13,226.299,4579.5,96254,798,180,95031,94486,86855,90511,93859
51182,176,266,36566,14616,2.79825e+13,172.47,2616.85,51182,210,175,50916,50916,45492,48251,50826
86982,206,331,62134,24848,2.79988e+13,173.105,3448.52,86982,275,175,86651,86651,78844,82831,86526
79191,172,317,56569,22622,2.80012e+13,173.029,3283.66,79191,260,175,78451,62091,69728,74410,78163
84328,17,326,60235,24093,2.79968e+13,173.042,3392.76,84328,269,175,47872,33992,14179,7926,7818
21767,138,214,15539,6228,2.80732e+13,170.256,1686.59,21767,156,143,20147,16371,15199,15726,17378
80819,16,320,57732,23087,2.80033e+13,173.051,3318.81,80819,264,175,44854,31562,13302,8044,10826
16564,143,204,11836,4728,2.79998e+13,169.366,1466.35,16564,147,134,15438,12472,12202,13484,13613
16061,66,203,11474,4587,2.80089e+13,169.133,1443.32,16061,146,133,12805,10608,4632,5238,6859
20100,61,211,14364,5736,2.79846e+13,170.318,1619.6,20100,154,140,15839,12984,5415,5149,7839
86163,469,800,61627,24536,2.72159e+13,250.942,4385.3,86163,798,175,85055,84810,74400,79708,84370
98153,248,793,70173,27980,2.75521e+13,258.771,4397.75,98153,407,175,97260,97025,90517,93343,96372
25574,153,221,18264,7310,2.80232e+13,170.994,1831.66,25574,164,150,24363,19329,20960,22090,22384
84635,310,327,60455,24180,2.80034e+13,173.068,3399.69,84635,270,175,84308,84308,83874,84065,84291
38704,27,244,27644,11060,2.80113e+13,171.956,2265.5,38704,187,173,25738,19173,6605,6376,7939
8372,9,189,5981,2391,2.79511e+13,164.619,1035.98,8372,123,114,3660,1768,1040,667,713
88509,433,477,63192,25317,2.81139e+13,173.272,3668.09,88509,276,192,88032,88032,85947,86989,87988
57332,66,277,40948,16384,2.80041e+13,172.559,2775.15,57332,220,175,45876,37936,16489,25193,24554
12686,115,197,9061,3625,2.79911e+13,167.88,1280.13,12686,139,126,11191,9365,6662,6042,8530
65418,118,292,46737,18681,2.79927e+13,172.847,2972.6,65418,236,175,58462,48459,35939,34063,45766
35762,183,239,25540,10222,2.80283e+13,171.708,2175.29,35762,181,168,35523,35523,32430,33990,35467
45429,155,800,32542,12887,2.64651e+13,218.862,3449.51,45429,798,175,42560,33851,36568,38697,38159
4901,150,183,3501,1400,2.80967e+13,158.086,790.174,4901,107,101,4534,3671,3744,4051,4139
83449,760,800,59687,23762,2.71883e+13,230.907,4331.28,83449,798,175,82649,82402,74877,78803,82530
56994,10,277,40711,16283,2.80071e+13,172.626,2767.26,56994,220,175,26074,14122,7836,4645,5382
37633,135,242,26884,10749,2.79929e+13,171.966,2233.15,37633,185,171,34751,28336,25161,26646,29593
54860,19,274,39185,15675,2.8016e+13,172.58,2713.95,54860,217,175,32525,23209,9328,4673,5499
51538,531,800,36897,14641,2.66583e+13,214.462,3611.37,51538,798,175,50571,50249,45449,47874,49931
91908,302,490,65621,26287,2.81006e+13,173.269,3743.63,91908,282,196,91418,91303,80103,79143,87537
32003,127,232,22861,9142,2.80295e+13,171.466,2054.31,32003,175,162,29063,24037,19778,16603,23727
32858,134,233,23473,9385,2.79814e+13,171.648,2082.13,32858,177,164,30259,24736,21705,21833,25580
58310,26,279,41650,16660,2.79883e+13,172.636,2799.78,58310,222,175,38464,28244,9920,8966,12440
7558,101,188,5397,2161,2.79434e+13,163.936,984.09,7558,121,111,6439,5467,3392,3191,4479
60602,45,284,43290,17312,2.80241e+13,172.725,2857.41,60602,227,175,45489,36149,13503,13174,17945
33003,201,233,23574,9429,2.79609e+13,171.607,2086.48,33003,176,163,32770,32770,31296,32025,32738
76957,261,800,55059,21898,2.70832e+13,220.118,4197.84,76957,798,175,75697,75225,68426,71553,74406
40185,27,247,28706,11479,2.80301e+13,172.086,2310.34,40185,190,175,26720,19911,6862,6627,8277
46070,67,257,32910,13160,2.79916e+13,172.237,2478.18,46070,200,175,36930,30478,13439,12217,19085
82533,57,323,58949,23584,2.79967e+13,173.025,3355.05,82533,266,175,64574,52817,20855,22873,29679
36931,175,241,26380,10551,2.80218e+13,171.915,2211.74,36931,184,170,36690,36690,32924,34831,36624
14921,182,201,10658,4263,2.79692e+13,168.682,1390.19,14921,144,131,14720,14720,14178,14424,14701
15679,4,203,11198,4481,2.80178e+13,169.127,1426.27,15679,146,132,4114,1244,909,1120,924
32405,187,232,23156,9249,2.79642e+13,171.593,2066.95,32405,176,163,32173,32173,29811,30996,32128
32332,99,233,23101,9231,2.79881e+13,171.693,2066.05,32332,176,162,27740,23404,14040,13241,19196
15344,134,202,10963,4381,2.80055e+13,168.907,1410.4,15344,145,132,14062,11527,10118,9085,11828
65744,213,293,46956,18788,2.80081e+13,172.749,2980.53,65744,235,175,65451,65451,60713,63122,65371
17165,22,205,12263,4902,2.80039e+13,169.43,1493.21,17165,148,134,10721,7629,2926,1804,2658
17990,197,206,12855,5135,2.79405e+13,169.675,1528.94,17990,150,137,17784,17784,17667,17715,17775
60924,159,284,43522,17402,2.79961e+13,172.714,2864.54,60924,227,175,58912,46561,53223,57038,55361
58904,56,280,42073,16831,2.79857e+13,172.653,2814.57,58904,223,175,45928,37687,14826,16106,21186
85820,326,330,61296,24524,2.8022e+13,173.044,3425.35,85820,272,175,85490,85490,85472,85476,85486
86666,309,331,61899,24767,2.80148e+13,173.05,3442.32,86666,273,175,86335,86335,85551,85923,86313
48199,210,261,34433,13766,2.79938e+13,172.412,2537.33,48199,204,175,47938,47938,45172,46566,47887
2290,55,179,1633,657,2.8405e+13,138.984,538.271,2290,85,79,1727,1445,619,684,838
17917,47,207,12790,5127,2.80625e+13,169.36,1526.63,17917,149,136,13527,10850,4171,5133,5705
47332,134,259,33804,13528,2.80069e+13,172.26,2512.89,47332,202,175,43635,35657,31321,32939,36768
54293,237,272,38779,15514,2.8e+13,172.536,2698.31,54293,215,175,54021,54021,52353,53180,53986
28200,16,225,20144,8056,2.8e+13,171.208,1925.13,28200,168,154,15648,11013,4643,3783,2947
65485,278,292,46772,18713,2.80136e+13,172.76,2973.82,65485,235,175,65193,65193,64923,65041,65179
29858,153,228,21327,8531,2.8006e+13,171.348,1982.5,29858,171,157,28486,22581,24489,25813,26112
62972,125,288,44974,17998,2.80158e+13,172.725,2914.41,62972,231,175,57084,47336,38439,39074,46430
44053,189,253,31462,12591,2.80013e+13,172.128,2421.36,44053,196,175,43800,43800,40158,42001,43736
70497,166,302,50351,20146,2.80212e+13,172.84,3091.1,70497,244,175,69061,54391,61785,66095,66599
80718,74,320,57656,23062,2.80104e+13,172.993,3316.56,80718,263,175,65775,53992,26136,19756,36532
55908,258,275,39935,15973,2.80071e+13,172.608,2739.84,55908,218,175,55633,55633,55179,55383,55616
2749,65,179,1967,782,2.8016e+13,145.493,590.219,2749,91,83,2134,1794,809,1183,1142
72124,273,304,51515,20609,2.80138e+13,172.875,3127.09,72124,247,175,71820,71820,70434,71115,71789
37313,67,241,26657,10656,2.79801e+13,171.835,2222.66,37313,184,171,29894,24678,10894,9492,15475
82048,69,322,58608,23440,2.79991e+13,173.05,3344.77,82048,265,175,66106,54424,24071,26280,36093
43334,33,253,30953,12381,2.80434e+13,172.167,2402.15,43334,196,175,30223,23115,8022,5760,9283
51765,166,268,36981,14784,2.79965e+13,172.534,2633.29,51765,211,175,50669,39911,45431,48533,49096
37783,135,242,26982,10801,2.80197e+13,171.849,2237.31,37783,185,172,34864,28453,25261,26764,29547
83315,514,800,59600,23715,2.71677e+13,224.962,4328.3,83315,789,180,82354,81968,78725,80358,81657
25074,78,219,17909,7165,2.79924e+13,170.715,1811.85,25074,162,149,20569,17166,8446,8628,12207
18631,35,208,13306,5325,2.79919e+13,169.922,1557.27,18631,151,138,13173,10490,3681,2561,4246
89920,158,336,64238,25682,2.79906e+13,173.139,3508.57,89920,280,175,86861,68736,78600,84256,81380
83838,231,800,59969,23869,2.71679e+13,240.128,4338.98,83838,757,180,82547,82093,75908,78592,81157
66822,171,295,47730,19092,2.80135e+13,172.834,3005.94,66822,238,175,66051,51784,58853,62777,65068
75116,403,454,53629,21487,2.81274e+13,173.046,3382.21,75116,251,192,74662,74662,72082,73378,74611
56546,47,277,40386,16160,2.80373e+13,172.545,2756.78,56546,219,175,42756,34252,13039,16093,18022
43650,61,253,31183,12467,2.79984e+13,172.254,2410.78,43650,196,175,34494,28232,11798,18674,17435
70766,134,302,50549,20217,2.80081e+13,172.877,3096.84,70766,245,175,65285,53323,46815,49240,55699
41419,663,800,29664,11755,2.6454e+13,212.67,3298.4,41419,735,174,40619,40549,35722,33015,12296
32420,155,233,23156,9264,2.80208e+13,171.674,2068.8,32420,176,162,31047,24629,27457,29186,28961
61011,488,543,43592,17419,2.77855e+13,171.214,3180.77,61011,286,175,60468,60468,57528,59010,60413
29940,124,228,21385,8555,2.80045e+13,171.388,1985.09,29940,171,158,27054,22374,18223,14819,21677
9547,429,800,6909,2638,2.06174e+13,246.985,2056.58,9547,738,109,8534,7936,6956,7613,7634
48587,41,262,34701,13886,2.80166e+13,172.335,2547.8,48587,205,175,35817,28198,10195,7587,12839
32906,232,233,23507,9399,2.79791e+13,171.535,2083.31,32906,176,163,32673,32673,32673,32673,32672
81090,310,321,57925,23165,2.79982e+13,173.061,3325.07,81090,264,175,80769,80769,80624,80685,80758
41801,123,250,29855,11946,2.80278e+13,172.137,2357.74,41801,193,175,37703,31254,25086,25789,30396
99626,136,495,71138,28488,2.80972e+13,173.345,3887.65,99626,296,193,92241,75097,49163,35260,71283
88553,280,334,63253,25300,2.8003e+13,173.121,3481.09,88553,277,175,88219,88219,85252,86748,88165
27858,7,224,19898,7960,2.7995e+13,171.108,1912.54,27858,167,154,10779,4337,3025,2065,1062
88459,337,800,63275,25184,2.72321e+13,221.468,4430.49,88459,798,180,87291,86705,81236,83822,86206
13204,85,198,9436,3768,2.80658e+13,168.054,1306.38,13204,141,128,10959,9190,4783,4769,6864
26266,120,221,18765,7501,2.79763e+13,171.173,1856.06,26266,165,152,23502,19476,14665,12786,18509
53568,83,271,38260,15308,2.80163e+13,172.474,2679.99,53568,213,175,44499,37277,18948,25489,28116
22306,178,215,15926,6380,2.80954e+13,170.324,1707.62,22306,157,144,22091,22091,20310,21195,22054
84253,24,800,60274,23979,2.71845e+13,248.726,4347.26,84253,729,179,53894,39828,14174,8881,13685
99968,173,354,71403,28565,2.80054e+13,173.167,3708.56,99968,297,175,99257,78590,88009,93954,98445
37700,185,242,26926,10774,2.7988e+13,171.928,2234.97,37700,185,172,37458,37458,34306,35896,37401
61528,134,285,43942,17586,2.80257e+13,172.668,2879.18,61528,228,175,56735,46357,40705,42824,47937
37293,145,385,26612,10681,2.8229e+13,172.256,2406.59,37293,183,178,34975,28165,18110,12103,27091
28277,74,225,20198,8079,2.79934e+13,171.18,1927.49,28277,168,155,22999,18897,9173,9451,13136
26049,164,221,18603,7446,2.79986e+13,171.029,1848.3,26049,164,151,25333,19924,22833,24355,24348
50539,702,800,36186,14353,2.66225e+13,211.619,3586.16,50539,798,175,49739,49523,45642,47604,49446
19270,62,208,13772,5498,2.79697e+13,169.889,1583.3,19270,152,139,15238,12491,5269,8260,7782
45614,58,257,32578,13036,2.80277e+13,172.212,2466.47,45614,199,175,35766,29273,12002,14060,17241
6928,109,187,4943,1985,2.81275e+13,161.838,941.273,6928,118,109,6015,5071,3445,3940,4509
28598,754,800,20517,8081,2.55424e+13,213.904,2932.1,28598,735,155,27798,27658,27190,27393,27661
26851,62,223,19178,7673,2.80329e+13,171.073,1877.72,26851,166,152,21259,17412,7299,5961,10344
35841,76,239,25604,10237,2.80214e+13,171.814,2177.81,35841,182,169,29300,24345,11950,12169,16976
48044,115,261,34320,13724,2.79962e+13,172.35,2533.19,48044,204,175,42644,35585,25294,24192,32516
46392,101,258,33140,13252,2.79946e+13,172.348,2487.82,46392,201,175,39999,33772,20829,20509,28263
36673,156,241,26195,10478,2.8027e+13,171.832,2204.13,36673,184,170,35197,27874,31206,33097,32701
10262,55,192,7332,2930,2.7976e+13,165.989,1148.34,10262,129,120,7943,6525,2591,4248,3843
59634,17,282,42593,17041,2.80115e+13,172.667,2833.22,59634,225,175,33851,24050,10036,5720,8150
48452,256,262,34608,13844,2.8022e+13,172.398,2544.72,48452,205,175,48190,48190,48139,48156,48184
67899,86,297,48501,19398,2.80171e+13,172.868,3031.16,67899,240,175,56784,47364,25051,24375,35949
48476,168,262,34624,13852,2.80169e+13,172.396,2545.17,48476,205,175,47612,37382,42615,45475,46432
53649,220,271,38320,15329,2.80054e+13,172.551,2681.98,53649,214,175,53378,53378,50624,52009,53327
40058,148,246,28611,11447,2.80171e+13,171.948,2305.5,40058,189,175,37897,30316,30588,33456,34224
73888,734,800,52871,21017,2.70553e+13,218.971,4133.08,73888,791,180,73088,72902,69932,71421,72891
38392,32,244,27427,10965,2.79932e+13,172.037,2256.92,38392,187,173,26561,20118,7024,8404,9476
90305,227,337,64495,25810,2.80179e+13,173.096,3516.72,90305,280,175,89968,89968,83221,86661,89858
78074,15,315,55763,22311,2.80014e+13,172.976,3259.4,78074,258,175,42344,29220,12288,7628,8216
70734,156,302,50524,20210,2.80089e+13,172.877,3096.23,70734,245,175,68038,53807,60274,63956,63149
41454,28,249,29607,11847,2.80144e+13,172.089,2347.2,41454,192,175,27786,20836,7074,5183,8278
6991,13,187,4994,1997,2.80552e+13,162.608,945.824,6991,119,109,3569,2418,1058,596,474
43741,112,800,31330,12411,2.64209e+13,210.073,3403.19,43741,794,175,37746,31681,21616,22254,27869
51609,47,267,36863,14746,2.79911e+13,172.503,2628.46,51609,210,175,39012,31244,11894,14184,16419
9341,81,191,6666,2675,2.80662e+13,165.367,1095.06,9341,127,117,7663,6475,3285,2705,4623
44007,28,253,31434,12573,2.79761e+13,172.213,2420.24,44007,196,175,29502,22107,7485,7316,9276
51483,161,267,36773,14710,2.79968e+13,172.459,2625.29,51483,210,175,49942,39337,44996,48187,47382
82728,66,323,59088,23640,2.8009e+13,172.997,3358.87,82728,266,175,66221,54745,23792,36348,35291
33222,181,234,23734,9488,2.79843e+13,171.667,2094.31,33222,177,163,32988,32988,30089,31550,32935
91415,300,339,65298,26117,2.7998e+13,173.142,3539.21,91415,282,175,91076,91076,89138,90103,91037
80916,103,320,57797,23119,2.80063e+13,173,3320.45,80916,263,175,70163,59376,36623,34163,50021
58731,41,280,41951,16780,2.80058e+13,172.633,2810.52,58731,223,175,43299,34082,12347,11580,16236
89822,387,486,64132,25690,2.81026e+13,173.257,3701.09,89822,278,196,89336,89336,83486,86466,89237
57964,122,800,41492,16472,2.6783e+13,214.141,3771.65,57964,798,175,51322,42598,32453,28831,39803
16146,38,203,11539,4607,2.79575e+13,169.253,1447.34,16146,146,132,11672,9150,3352,3219,4138
77735,772,800,55617,22118,2.71056e+13,219.463,4214.18,77735,796,180,76935,76755,73552,75198,76852
90008,168,337,64283,25725,2.80196e+13,173.076,3511.05,90008,279,175,88544,69457,78959,84452,86298
79387,67,462,56676,22711,2.81146e+13,173.15,3476.16,79387,274,187,63674,52591,22319,22021,32343
42263,587,800,30276,11987,2.63554e+13,209.728,3361.5,42263,792,175,41372,40990,37772,39396,40824
26673,168,223,19054,7619,2.8014e+13,171.114,1871.65,26673,166,152,26121,20541,23533,25012,25324
4191,20,181,2994,1197,2.7649e+13,155.295,729.396,4191,102,95,2517,1774,710,493,705
51010,199,266,36432,14578,2.80052e+13,172.463,2612.62,51010,209,175,50744,50744,46912,48852,50677
65053,265,292,46459,18594,2.80178e+13,172.722,2964.37,65053,234,175,64761,64761,63639,64184,64734
59237,74,281,42316,16921,2.79972e+13,172.708,2823.43,59237,224,175,48241,39611,19177,13439,26062
98197,123,351,70141,28056,2.79943e+13,173.19,3674.19,98197,294,175,88690,73479,58933,51189,70455
90830,123,339,64879,25951,2.80109e+13,173.166,3528.49,90830,282,175,82015,67954,54543,55995,66312
98635,207,492,70435,28200,2.80954e+13,173.302,3866.07,98635,294,192,98143,98019,76893,64019,89874
64428,203,800,46110,18318,2.69193e+13,220.098,3923.98,64428,773,180,63116,62718,56957,59366,61677
5934,180,185,4242,1692,2.80695e+13,160.815,870.707,5934,113,105,5749,5749,5718,5725,5744
30674,126,230,21911,8763,2.80551e+13,171.461,2010.57,30674,173,159,27798,23030,18844,19077,22762
29395,212,227,20999,8396,2.80017e+13,171.29,1966.4,29395,170,156,29168,29168,28845,28985,29153
59872,197,282,42769,17103,2.79918e+13,172.658,2838.63,59872,225,175,59590,59590,54526,57100,59505
2339,93,178,1672,667,2.78104e+13,141.23,543.849,2339,85,78,1915,1606,944,837,1218
45912,20,257,32791,13121,2.80052e+13,172.261,2474.31,45912,200,175,27801,19674,7815,5905,8315
7563,116,188,5406,2157,2.81299e+13,163.795,984.78,7563,121,111,6642,5566,3976,3627,5030
96079,313,348,68631,27448,2.80091e+13,173.217,3633.41,96079,291,175,95731,95731,94073,94895,95696
41434,46,249,29598,11836,2.80075e+13,172.122,2346.78,41434,192,175,31201,25009,9405,11334,12982
4090,97,181,2929,1161,2.77807e+13,155.252,721.098,4090,103,95,3424,2930,1757,1677,2279
51112,224,267,36506,14606,2.80319e+13,172.463,2616.08,51112,210,175,50845,50845,48656,49751,50802
3870,114,181,2764,1106,2.80142e+13,153.283,701.162,3870,103,93,3329,2838,2055,2267,2612
43982,230,253,31414,12568,2.80016e+13,172.172,2419.32,43982,196,175,43729,43729,42875,43283,43706
32742,171,233,23390,9352,2.79946e+13,171.559,2078.24,32742,176,163,32281,25349,29030,30795,31772
1820,31,177,1301,519,2.76951e+13,129.903,478.045,1820,74,73,1227,941,337,225,366
82231,412,463,58712,23519,2.812e+13,173.155,3532.29,82231,264,192,81768,81768,79194,80488,81717
55375,185,274,39552,15823,2.80173e+13,172.58,2726.16,55375,217,175,55101,55101,49784,52489,55012
88109,234,333,62938,25171,2.80003e+13,173.116,3471.77,88109,276,175,87776,87776,81746,84820,87677
69354,114,300,49537,19817,2.80282e+13,172.871,3065.06,69354,243,175,61490,51381,36263,40514,47117
7460,14,187,5332,2128,2.79141e+13,163.401,976.736,7460,120,110,3934,2680,1131,666,877
21130,105,212,15089,6041,2.80065e+13,170.249,1660.14,21130,155,142,18349,15478,9912,9407,13229
99577,222,354,71126,28451,2.80065e+13,173.193,3701.66,99577,297,175,99223,99223,90940,95172,99091
4711,48,183,3360,1351,2.81841e+13,156.358,774.283,4711,106,100,3541,2879,1130,1345,1508
73712,60,307,52650,21062,2.79985e+13,172.932,3162.94,73712,250,175,58142,47432,19760,24571,29836
52792,72,270,37702,15090,2.80254e+13,172.461,2660.16,52792,212,175,42817,35209,16469,17898,24037
4128,6,182,2950,1178,2.80366e+13,155.759,724.826,4128,103,95,1451,545,364,311,323
63781,80,290,45557,18224,2.80291e+13,172.749,2934.51,63781,233,175,52656,44264,21853,22645,31487
86354,280,330,61686,24668,2.80019e+13,173.114,3435.63,86354,274,175,86024,86024,83322,84682,85974
40463,740,743,28958,11505,2.70337e+13,204.198,3004.73,40463,357,175,39720,39720,39720,39720,39720
4109,105,181,2937,1172,2.7755e+13,154.835,722.225,4109,102,95,3499,2984,1942,1859,2462
42792,30,251,30565,12227,2.79939e+13,172.151,2385.42,42792,194,175,29146,22036,7336,9210,9257
98412,11,352,70290,28122,2.80032e+13,173.216,3679.05,98412,295,175,46797,28824,14418,8366,8247
56098,163,276,40072,16026,2.80302e+13,172.607,2745.31,56098,219,175,54622,42960,49078,52531,52292
84427,122,326,60316,24111,2.79856e+13,173.084,3394.77,84427,270,175,76075,63014,48996,43849,60090
81350,173,321,58106,23244,2.79988e+13,173.029,3330.14,81350,264,175,80739,63938,71697,76471,79930
39612,13,245,28295,11317,2.80055e+13,171.887,2292.01,39612,188,175,20268,13684,5952,4159,2907
36454,26,240,26042,10412,2.80138e+13,171.85,2196.68,36454,183,169,24043,17661,6217,6009,7517
21103,176,212,15079,6024,2.79823e+13,170.337,1659.12,21103,155,142,20891,20891,19165,20022,20855
4190,21,182,2997,1193,2.79238e+13,155.993,730.499,4190,103,96,2564,1828,719,431,661
38658,166,244,27618,11040,2.799e+13,172.033,2264.37,38658,187,174,37800,29795,33959,34599,36483
26310,25,221,18793,7517,2.80099e+13,170.888,1857.12,26310,164,151,17161,12508,4490,4622,3964
95765,168,348,68400,27365,2.80186e+13,173.135,3627.57,95765,290,175,94213,73899,83998,89853,91528
3873,22,181,2767,1106,2.79925e+13,153.482,701.519,3873,98,95,2409,1716,660,686,676
26981,212,222,19278,7703,2.79499e+13,171.167,1881.34,26981,166,153,26759,26759,26614,26676,26749
81713,293,322,58361,23352,2.80157e+13,172.972,3338.06,81713,264,175,81391,81391,80129,80747,81362
65798,38,293,46998,18800,2.80065e+13,172.828,2981.75,65798,236,175,47677,37339,12882,10000,16972
62768,106,287,44837,17931,2.79924e+13,172.726,2908.98,62768,230,175,54736,46052,29993,27966,39762
55327,770,800,39612,15715,2.67616e+13,222.37,3707.62,55327,798,175,54527,54314,49026,51763,54438
5368,91,183,3838,1530,2.76454e+13,159.59,826.804,5368,110,103,4456,3726,2141,1962,2860
47020,235,259,33587,13433,2.801e+13,172.269,2504.95,47020,202,175,46761,46761,45822,46274,46737
68386,57,298,48850,19536,2.80214e+13,172.863,3042.55,68386,241,175,53490,43756,17279,20296,25429
27488,207,223,19630,7858,2.80133e+13,170.862,1898.86,27488,166,153,27265,27265,26885,27050,27249
33367,39,235,23834,9533,2.80442e+13,171.64,2099.63,33367,178,164,24342,19058,7067,5095,8483
3278,106,180,2340,938,2.80053e+13,150.335,645.204,3278,95,91,2761,2368,1556,1516,1978
39373,596,947,28191,11182,2.64409e+13,208.309,3463.52,39373,784,170,38364,37964,36051,35395,36601
37403,221,242,26713,10690,2.80145e+13,171.737,2226.07,37403,184,171,37161,37161,36444,36781,37140
43036,128,252,30736,12300,2.80119e+13,172.078,2393.18,43036,194,175,39198,32340,26759,26936,32088
37313,130,242,26648,10665,2.8033e+13,171.876,2223.91,37313,185,171,34101,28092,23463,23765,28511
56032,776,800,40109,15923,2.67666e+13,224.556,3724.92,56032,744,180,55232,55091,54502,54760,55161
59283,227,281,42349,16934,2.79921e+13,172.717,2824.49,59283,225,175,59002,59002,56026,57526,58948
40924,115,248,29232,11692,2.80056e+13,172.077,2331.73,40924,191,175,36320,30307,21568,24278,28135
36483,124,240,26059,10424,2.80031e+13,171.793,2197.75,36483,183,170,32942,27275,22190,22557,26607
84338,644,800,60330,24008,2.71788e+13,223.324,4348.89,84338,798,175,83452,83271,76499,79960,83071
99282,78,354,70911,28371,2.80174e+13,173.204,3696.52,99282,297,175,81635,68019,33249,28955,47435
76998,204,313,55000,21998,2.80032e+13,172.99,3235.85,76998,257,175,76685,76685,69974,73398,76576
9339,61,191,6671,2668,2.8012e+13,165.468,1095.24,9339,127,117,7336,6037,2547,1895,3455
49340,83,264,35246,14094,2.80056e+13,172.449,2569.05,49340,207,175,40967,34322,17420,15558,25039
49128,157,263,35096,14032,2.80204e+13,172.432,2562.74,49128,206,175,47299,37352,42885,43855,44314
73302,302,307,52355,20947,2.80207e+13,172.892,3154.43,73302,249,175,72995,72995,72959,72970,72990
27941,90,225,19953,7988,2.80379e+13,170.99,1916.23,27941,167,154,23532,19486,10941,13711,15469
80540,549,800,57623,22917,2.71458e+13,218.434,4272.13,80540,798,180,79580,79198,73779,76517,78987
82700,108,324,59068,23632,2.80201e+13,173.061,3359.39,82700,267,175,72460,60676,40370,37877,53304
81512,105,321,58224,23288,2.80001e+13,173.039,3333.28,81512,265,175,70964,59809,38187,36141,51341
48246,148,261,34464,13782,2.79957e+13,172.316,2538.13,48246,204,175,45690,36519,36848,38314,41400
78664,276,316,56193,22471,2.79954e+13,173.035,3272.28,78664,260,175,78348,78348,76326,77336,78308
71936,200,304,51386,20550,2.80028e+13,172.889,3123.16,71936,247,175,71632,71632,65282,68519,71528
56108,676,930,40091,16017,2.7606e+13,170.228,3570.61,56108,448,192,55178,55178,48687,38099,44012
63145,45,288,45100,18045,2.7997e+13,172.747,2918.45,63145,231,175,47406,37669,14050,18880,19966
29985,182,370,21397,8588,2.82676e+13,171.698,2166.73,29985,184,173,29600,29461,23359,21222,27628
58241,69,279,41611,16630,2.799e+13,172.737,2798.6,58241,223,175,46893,38623,17083,15609,25182
67219,374,441,47988,19231,2.81517e+13,172.969,3202.98,67219,237,194,66778,66778,63131,64976,66711
56660,94,277,40465,16195,2.80305e+13,172.617,2759.47,56660,220,175,48202,39621,22859,22382,32243
56151,217,275,40104,16047,2.80013e+13,172.573,2745.37,56151,218,175,55876,55876,52642,54275,55818
74493,291,309,53208,21285,2.80074e+13,172.989,3181.02,74493,252,175,74184,74184,73710,73921,74166
93233,80,800,66689,26544,2.72482e+13,222.775,4522.3,93233,798,180,76238,64210,31337,25483,44776
46546,38,258,33251,13295,2.79897e+13,172.359,2491.91,46546,201,175,33716,26410,9094,8841,11964
42186,122,251,30134,12052,2.8029e+13,172.114,2369.17,42186,194,175,37960,31468,24488,25935,30354
69884,37,301,49917,19967,2.80292e+13,172.856,3077.2,69884,244,175,50268,39547,14417,10401,17203
9669,142,191,6905,2764,2.8061e+13,165.434,1113.91,9669,127,119,8952,7274,7040,7756,7865
47400,773,800,33949,13451,2.65201e+13,218.862,3503.34,47400,746,180,46600,46459,45831,46111,46520
33550,199,235,23960,9590,2.80339e+13,171.75,2105.3,33550,178,164,33315,33315,31602,32452,33279
32423,172,232,23160,9263,2.7953e+13,171.528,2067.43,32423,176,162,32023,25393,28824,30531,31577
35853,150,239,25614,10239,2.8016e+13,171.725,2178,35853,182,169,34039,27126,27816,28776,30926
11096,112,194,7929,3167,2.79668e+13,166.972,1195.77,11096,135,124,9719,8172,5761,6432,7430
11907,49,195,8502,3405,2.80133e+13,167.168,1238.77,11907,135,125,9039,7336,2821,3445,3977
39880,190,246,28490,11390,2.80291e+13,171.992,2300.72,39880,189,175,39634,39634,36564,38111,39578
34116,21,236,24371,9745,2.79978e+13,171.728,2123.25,34116,179,166,21026,14985,5806,3516,5129
83012,247,946,59367,23645,2.72634e+13,227.692,4511.89,83012,813,193,81573,81003,64013,57506,73841
6517,41,185,4663,1854,2.7827e+13,162.12,912.119,6517,116,107,4772,3766,1375,1671,1881
75663,54,311,54048,21615,2.80153e+13,172.959,3206.79,75663,254,175,58645,48003,18651,17119,26067
50747,199,800,36337,14410,2.66105e+13,209.695,3591.18,50747,784,175,49450,49062,44700,46381,48026
86248,141,800,61699,24549,2.71907e+13,242.053,4387.16,86248,798,175,79704,64461,60612,67452,69379
32607,94,233,23290,9317,2.80112e+13,171.562,2074.32,32607,176,163,27705,22794,13179,12700,18407
59078,128,280,42202,16876,2.79867e+13,172.679,2818.66,59078,224,175,53828,44401,36740,31769,44356
81985,221,800,58646,23339,2.71551e+13,223.022,4301.27,81985,798,175,80676,80244,72769,76137,79260
52575,233,269,37556,15019,2.80044e+13,172.506,2653.87,52575,212,175,52306,52306,50580,51437,52270
46595,18,259,33284,13311,2.80116e+13,172.402,2494.15,46595,202,175,27030,19210,7839,4553,6353
12829,103,197,9160,3669,2.80193e+13,167.871,1287.23,12829,139,127,11056,9380,5836,5825,7904
93749,187,343,66958,26791,2.80069e+13,173.125,3586.04,93749,286,175,93406,93406,83512,88572,93250
56342,118,276,40242,16100,2.80088e+13,172.553,2751.05,56342,218,175,50337,41740,30984,34028,39519
94046,203,344,67173,26873,2.80098e+13,173.149,3592.53,94046,287,175,93702,93702,84864,89380,93561
16218,78,204,11583,4635,2.80504e+13,169.165,1451.16,16218,147,133,13275,11088,5459,4762,7733
37123,78,241,26519,10604,2.80019e+13,171.907,2217.33,37123,184,170,30476,25419,12445,9581,17496
27376,114,800,19642,7734,2.54586e+13,209.975,2888.81,27376,770,148,23383,19621,13301,11769,16861
69609,285,448,49689,19920,2.81358e+13,172.97,3261.48,69609,241,195,69161,69041,54136,50574,65513
54069,214,800,38715,15354,2.6702e+13,224.527,3676.14,54069,798,175,52767,52378,45844,48725,51375
37700,198,242,26926,10774,2.7988e+13,171.918,2234.97,37700,185,172,37458,37458,35194,36328,37414
8690,126,189,6212,2478,2.78193e+13,165.094,1055.47,8690,125,115,7792,6496,5326,4620,6373
3191,122,180,2275,916,2.81511e+13,149.228,635.942,3191,95,89,2775,2347,1882,1976,2253
57580,167,278,41128,16452,2.80033e+13,172.639,2782.05,57580,221,175,56486,44411,50550,54007,55191
72922,172,306,52084,20838,2.80103e+13,172.874,3145.7,72922,248,175,72226,57178,64220,68516,71310
99083,247,353,70772,28311,2.80026e+13,173.207,3691.94,99083,296,175,98730,98730,92236,95546,98624
10075,765,800,7266,2809,2.24162e+13,182.261,1998.18,10075,622,113,9275,9261,8319,8805,7879
35434,129,238,25307,10127,2.80135e+13,171.787,2164.69,35434,181,168,32338,26679,22157,19933,26659
69828,215,445,49851,19977,2.81342e+13,173.053,3263.39,69828,242,193,69383,69260,55231,43574,62878
37978,131,243,27133,10845,2.79906e+13,171.982,2243.88,37978,186,173,34774,28592,24019,22246,28869
90006,669,800,64380,25626,2.72287e+13,230.8,4460.27,90006,798,175,89125,88927,80835,84981,88814
46303,66,408,33039,13264,2.82156e+13,172.515,2676.72,46303,215,182,37023,30696,12842,12551,18297
1661,117,177,1186,475,2.79733e+13,126.37,457.898,1661,70,75,1370,1194,892,895,1093
12735,42,197,9097,3638,2.80049e+13,167.761,1282.45,12735,139,127,9407,7449,2749,3716,3919
41321,38,248,29512,11809,2.80024e+13,171.995,2342.5,41321,191,175,29939,23460,8611,10776,11292
91588,149,340,65423,26165,2.80128e+13,173.16,3543.59,91588,283,175,86984,69348,70653,76752,78888
59077,547,800,42262,16815,2.7184e+13,222.841,3612.54,59077,438,175,58277,58169,58035,57819,58127
87623,229,333,62583,25040,2.80077e+13,173.141,3462.59,87623,276,175,87290,87290,80969,84190,87186
60171,94,800,43066,17105,2.68418e+13,223.353,3824.44,60171,755,180,50386,41567,23626,22397,32780
35521,204,238,25373,10148,2.80243e+13,171.785,2167.6,35521,181,168,35283,35283,33704,34484,35249
2161,49,365,1554,607,2.38474e+13,107.079,712.065,2161,161,77,1507,1281,475,335,56
45592,149,397,32542,13050,2.82016e+13,172.533,2646.13,45592,199,191,43146,34527,25634,21208,34469
63095,287,288,45068,18027,2.80058e+13,172.768,2917.3,63095,231,175,62807,62807,62807,62807,62806
49595,159,264,35422,14173,2.8015e+13,172.311,2575.22,49595,206,175,47923,37897,43293,46402,45107
64376,212,290,45985,18391,2.79931e+13,172.737,2947.47,64376,233,175,64086,64086,59491,61825,64008
64331,204,290,45951,18380,2.79973e+13,172.765,2946.6,64331,233,175,64041,64041,58903,61516,63955
10542,290,336,7511,3031,2.86611e+13,167.667,1334.97,10542,144,135,10206,10088,9306,9265,10065
55560,167,800,39776,15784,2.67457e+13,229.653,3713.2,55560,716,176,53446,42121,46761,49787,50383
52459,134,269,37467,14992,2.79858e+13,172.553,2651.1,52459,212,175,48351,39511,34695,32543,40846
29681,74,228,21193,8488,2.8026e+13,171.143,1976.32,29681,170,157,24152,19852,9672,13494,13900
8001,95,188,5719,2282,2.7892e+13,164.143,1012.13,8001,123,112,6748,5589,3329,3185,4521
16524,29,204,11804,4720,2.80252e+13,169.32,1464.64,16524,147,133,11150,8423,2841,2976,3773
35821,51,239,25582,10239,2.80214e+13,171.794,2177.16,35821,182,168,27452,22209,8809,6382,11436
46973,68,259,33549,13424,2.80081e+13,172.292,2503.73,46973,202,175,37742,31158,13742,10995,19729
86323,187,330,61661,24662,2.80022e+13,173.119,3435.12,86323,273,175,85993,85993,76971,81585,85850
99253,612,800,70986,28267,2.72992e+13,253.485,4634.89,99253,798,175,98274,97877,87087,92610,97889
9850,115,192,7035,2815,2.80168e+13,165.795,1125.28,9850,129,119,8665,7269,5230,5855,6737
8454,23,189,6043,2411,2.79132e+13,164.953,1041.54,8454,125,114,5346,3901,1436,1427,1470
62575,191,287,44697,17878,2.80045e+13,172.729,2904.59,62575,230,175,62288,62288,56475,59435,62192
52134,268,269,37238,14896,2.80334e+13,172.469,2643.19,52134,212,175,51865,51865,51865,51865,51864
38797,231,244,27716,11081,2.7995e+13,172.024,2268.34,38797,188,174,38553,38553,38316,38418,38540
3188,113,180,2272,916,2.81338e+13,147.979,635.661,3188,95,89,2734,2334,1676,1874,2141
90552,95,485,64649,25903,2.81109e+13,173.222,3712.5,90552,286,177,77179,63557,37031,45017,52057
22158,7,214,15829,6329,2.79971e+13,170.414,1701.11,22158,157,144,8571,3446,2404,1359,824
73195,73,306,52278,20917,2.80136e+13,172.875,3151.28,73195,249,175,59510,48827,23345,33108,34111
38936,231,245,27809,11127,2.80469e+13,171.953,2273.07,38936,188,174,38691,38691,38431,38543,38677
65146,102,292,46532,18614,2.80124e+13,172.81,2966.57,65146,235,175,56368,47554,29324,27258,40232
7056,168,187,5040,2016,2.80961e+13,162.991,950.632,7056,119,109,6792,5396,6377,6609,6666
71580,198,303,51132,20448,2.79925e+13,172.904,3114.89,71580,246,175,71277,71277,64839,68123,71172
13803,11,199,9857,3946,2.80108e+13,168.398,1336.23,13803,142,129,6551,4036,2019,945,815
98086,120,352,70062,28024,2.80231e+13,173.189,3673.18,98086,295,175,88054,72863,54824,59602,69714
27557,138,224,19684,7873,2.80197e+13,171.083,1902.56,27557,167,154,25549,20740,19242,18858,21967
32843,182,233,23458,9385,2.80158e+13,171.531,2081.49,32843,176,163,32610,32610,29864,31245,32559
79577,206,370,56852,22725,2.79538e+13,172.83,3357.73,79577,261,175,79207,79207,72327,75799,79048
90718,76,338,64803,25915,2.80021e+13,173.143,3525.45,90718,282,175,74248,61657,30199,28728,42224
10793,73,193,7708,3085,2.7904e+13,166.525,1178.11,10793,131,122,8721,7187,3478,3389,4835
42631,130,251,30449,12182,2.80071e+13,172.148,2381.16,42631,194,175,39000,32108,26817,24443,32248
6609,28,186,4721,1888,2.79511e+13,161.56,919.257,6609,118,108,4420,3315,1139,962,1375
64728,594,944,46256,18472,2.75754e+13,213.438,3846.73,64728,510,175,63784,63727,55918,45317,13038
85050,120,327,60752,24298,2.79892e+13,173.068,3407.69,85050,271,175,76328,63177,47530,43874,60600
30361,112,229,21686,8675,2.80104e+13,171.403,1999.77,30361,172,158,26764,22422,15728,17633,20300
42471,127,250,30339,12132,2.79701e+13,172.141,2375.98,42471,194,175,38591,31911,26254,22774,31922
3923,101,181,2804,1119,2.79948e+13,154.004,705.872,3923,100,94,3304,2826,1766,1521,2281
42180,214,250,30129,12051,2.79995e+13,172.164,2368.19,42180,193,175,41930,41930,40184,41053,41894
46610,75,258,33294,13316,2.79996e+13,172.248,2493.19,46610,201,175,38038,31419,15445,15646,21876
24460,11,218,17468,6992,2.79985e+13,170.756,1789.21,24460,161,148,11626,7159,3577,2031,2355
3418,45,180,2443,975,2.78878e+13,151.213,658.686,3418,95,90,2527,2023,798,937,1015
76311,603,800,54590,21721,2.71059e+13,217.345,4184.59,76311,798,175,75408,75008,69944,72530,74920
33854,182,235,24178,9676,2.80442e+13,171.608,2114.38,33854,178,165,33619,33619,30751,32195,33566
11690,150,195,8352,3338,2.80032e+13,167.174,1227.48,11690,135,124,11015,8820,9038,9807,10087
25429,136,220,18167,7262,2.80003e+13,170.932,1825.71,25429,163,149,23493,19135,17203,17213,20013
89991,115,337,64284,25707,2.80014e+13,173.128,3510.79,89991,280,175,79960,66683,47371,43491,61031
70083,180,301,50063,20020,2.80079e+13,172.887,3081.47,70083,244,175,69782,69782,62304,66120,69661
34917,57,237,24945,9972,2.79928e+13,171.805,2148.64,34917,180,166,27280,22329,8812,8684,12975
98955,303,353,70679,28276,2.80032e+13,173.221,3689.64,98955,296,175,98602,98602,95954,97285,98552
52790,621,800,37795,14995,2.66928e+13,218.459,3643.55,52790,798,175,51905,51505,46485,49202,51453
50198,79,265,35855,14343,2.80179e+13,172.47,2591.48,50198,208,175,41336,34458,16983,14762,24461
33977,217,236,24273,9704,2.80089e+13,171.789,2119.36,33977,179,165,33741,33741,33199,33445,33722
27510,17,224,19648,7862,2.80369e+13,171.214,1901.2,27510,167,154,15612,11093,4640,3092,3925
55143,155,274,39386,15757,2.80152e+13,172.556,2720.57,55143,217,175,52909,41939,46771,49731,48912
95886,432,491,68472,27414,2.80918e+13,173.297,3816.19,95886,290,193,95395,95395,92251,93837,95336
12515,121,196,8941,3574,2.78897e+13,167.681,1270.44,12515,138,126,11171,9288,7093,6519,8841
85434,224,329,61021,24413,2.80151e+13,173.016,3416.87,85434,271,175,85105,85105,78683,81955,85000
94559,73,800,67629,26930,2.72711e+13,231.789,4547.15,94559,790,180,76173,62653,29665,41635,42912
17779,198,206,12700,5079,2.79634e+13,169.619,1520.14,17779,149,136,17573,17573,17481,17518,17565
29829,12,228,21308,8521,2.79955e+13,171.38,1981.55,29829,171,157,14716,9326,4427,2588,2122
72758,175,306,51967,20791,2.80212e+13,172.859,3142.18,72758,248,175,72452,72452,64260,68444,72321
45532,149,256,32525,13007,2.80101e+13,172.286,2463.38,45532,199,175,43176,34457,35094,38117,38980
51308,218,267,36643,14665,2.80182e+13,172.522,2621.07,51308,210,175,51041,51041,48443,49748,50992
69494,534,800,49725,19769,2.69871e+13,225.047,4037.77,69494,798,175,68499,68172,61294,64795,67896
39589,229,245,28278,11311,2.79684e+13,172.011,2291.6,39589,188,175,39344,39344,38956,39127,39328
43580,70,392,31105,12475,2.81822e+13,172.394,2587.12,43580,194,183,35163,29069,11491,8765,16549
66302,92,294,47353,18949,2.80145e+13,172.79,2993.48,66302,237,175,56178,46251,26062,25940,37015
5770,18,184,4125,1645,2.78178e+13,160.754,858.084,5770,113,105,3335,2361,968,655,862
14895,77,201,10640,4255,2.80085e+13,168.785,1389.17,14895,144,130,12165,10155,5008,3608,6695
38898,161,244,27785,11113,2.7991e+13,172.008,2271.19,38898,187,174,37702,29706,33986,36380,35759
34986,14,237,24988,9998,2.80101e+13,171.748,2150.39,34986,180,167,18458,12582,5317,3427,3113
70605,231,301,50429,20176,2.80082e+13,172.815,3092.29,70605,244,175,70304,70304,66254,68307,70234
15412,32,201,11016,4396,2.79642e+13,168.905,1412.63,15412,145,132,10649,8067,2823,2923,2890
64158,144,290,45827,18331,2.80048e+13,172.778,2942.79,64158,233,175,60334,48456,47617,50510,53657
80713,31,320,57654,23059,2.80069e+13,173.014,3316.59,80713,263,175,55441,42026,14454,15181,14709
34616,276,800,24809,9807,2.59747e+13,220.808,3132.39,34616,793,162,33403,32960,28395,30430,32231
96941,302,349,69242,27699,2.80026e+13,173.187,3649.74,96941,292,175,96592,96592,94118,95360,96545
28554,356,364,20375,8179,2.82887e+13,171.614,2113.1,28554,181,172,28190,28190,28100,28138,28182
44860,227,255,32043,12817,2.80248e+13,172.2,2444.83,44860,198,175,44605,44605,43442,44006,44577
43878,64,253,31343,12535,2.79909e+13,172.204,2416.75,43878,196,175,34928,28939,12073,10819,17477
2819,115,179,2012,807,2.79701e+13,146.492,597.875,2819,90,84,2404,2051,1477,1470,1826
28787,147,226,20562,8225,2.79964e+13,171.32,1945.68,28787,169,155,27161,21769,21848,23957,24467
71637,39,303,51176,20461,2.79899e+13,172.898,3116.05,71637,247,175,52303,40927,15178,10374,17870
95581,12,800,68357,27224,2.72962e+13,238.13,4566.73,95581,798,175,47203,30338,14050,6561,6002
1068,159,176,761,307,2.82129e+13,102.727,366.964,1068,60,62,882,769,832,861,838
85943,169,469,61369,24574,2.81063e+13,173.221,3609.75,85943,272,193,84547,66466,41613,23767,69412
47848,48,261,34182,13666,2.7999e+13,172.436,2528.36,47848,204,175,36289,29216,11100,13322,15498
41484,34,800,29725,11759,2.62936e+13,219.251,3339.06,41484,798,175,28679,23140,7612,5840,9311
12915,51,197,9226,3689,2.79743e+13,167.583,1290.77,12915,139,127,9875,8003,3201,2450,4185
60329,121,283,43092,17237,2.80062e+13,172.698,2850.16,60329,226,175,54225,44907,34237,31257,42897
53838,309,800,38549,15289,2.66831e+13,219.064,3670.12,53838,798,175,52639,52148,46327,49080,51533
4648,173,182,3324,1324,2.78688e+13,156.491,767.744,4648,104,99,4454,3609,4353,4402,4433
46574,72,258,33273,13301,2.80001e+13,172.369,2492.61,46574,202,175,37740,31054,14481,10820,19927
85332,290,328,60952,24380,2.79974e+13,173.064,3413.98,85332,271,175,85004,85004,83136,84065,84966
25928,110,221,18517,7411,2.80261e+13,171.011,1844.07,25928,164,151,22749,19088,13081,11965,16865
41158,236,248,29407,11751,2.79832e+13,172.176,2338.41,41158,192,175,40910,40910,40710,40796,40898
94478,8,800,67574,26904,2.72557e+13,223.12,4545.74,94478,798,180,39502,18556,10884,7821,4245
46271,268,946,33116,13155,2.66893e+13,210.511,3659.38,46271,798,178,44910,44329,37958,38041,41691
6473,8,186,4625,1848,2.80379e+13,161.891,909.757,6473,116,107,2690,1224,750,508,490
43070,23,252,30766,12304,2.80191e+13,172.169,2394.06,43070,195,175,27324,19942,7340,4605,6865
74358,295,451,53090,21268,2.81225e+13,173.108,3363.42,74358,265,178,73907,73792,72246,70098,71901
13335,187,198,9528,3807,2.80014e+13,168.076,1312.6,13335,141,127,13137,13137,12968,13042,13126
64257,168,291,45891,18366,2.80208e+13,172.776,2945.91,64257,233,175,63161,49565,56422,60283,61584
87281,399,478,62314,24967,2.81142e+13,173.189,3644.7,87281,273,194,86803,86803,82375,84632,86342
98055,219,352,70034,28021,2.80118e+13,173.216,3672.59,98055,295,175,97703,97703,89411,93647,97570
41315,195,800,29602,11713,2.63058e+13,209.16,3334.04,41315,772,174,40027,39647,36160,37383,38608
1029,173,176,732,297,2.83232e+13,98.6997,359.35,1029,58,62,853,750,845,847,847
39363,130,245,28117,11246,2.80073e+13,172.001,2285.15,39363,188,175,36008,29642,24762,22575,29781
20322,4,211,14514,5808,2.80323e+13,170.105,1627.8,20322,154,140,5335,1624,1183,1138,466
28810,98,226,20580,8230,2.79985e+13,171.231,1946.13,28810,169,156,24683,20859,12477,11779,17026
90771,326,946,64900,25871,2.73217e+13,229.744,4665.22,90771,790,198,89477,88869,79860,78015,86653
9014,14,190,6440,2574,2.79597e+13,165.299,1075.63,9014,127,115,4750,3237,1367,815,789
41351,6,248,29533,11818,2.79991e+13,172.024,2343.43,41351,191,175,14573,5530,3664,3073,1928
35940,92,239,25672,10268,2.80109e+13,171.847,2180.74,35940,182,169,30419,25050,14127,13767,20134
60202,617,800,43082,17120,2.68632e+13,222.96,3825.59,60202,798,175,59300,58900,53005,56168,58853
7438,50,188,5306,2132,2.81677e+13,162.984,976.239,7438,120,111,5649,4597,1798,1490,2419
44728,119,255,31952,12776,2.80068e+13,172.257,2441.23,44728,198,175,40048,33202,24732,23392,31643
6364,141,186,4550,1814,2.79867e+13,162.159,902.56,6364,116,106,5838,4762,4537,4806,5104
69013,655,800,49384,19629,2.70017e+13,217.227,4027.34,69013,798,175,68158,67973,62602,65350,67779
94495,745,800,67587,26908,2.7303e+13,257.71,4513.04,94495,604,175,93695,93695,93651,93549,93645
56796,260,277,40559,16237,2.80229e+13,172.532,2762.53,56796,219,175,56519,56519,56073,56271,56502
12369,63,196,8843,3526,2.7957e+13,167.838,1263.32,12369,139,126,9770,8097,3384,3230,4975
65850,153,293,47039,18811,2.80015e+13,172.791,2982.78,65850,236,175,62983,49856,54092,54921,58108
33759,76,235,24111,9648,2.80063e+13,171.685,2111.5,33759,178,165,27591,22924,11236,11449,16006
40387,147,247,28851,11536,2.7998e+13,172.061,2315.9,40387,190,175,38152,30558,30685,33650,34506
89705,115,951,64135,25570,2.73184e+13,244.374,4649.27,89705,757,201,78801,65851,33477,20347,50953
84395,255,466,60272,24123,2.81029e+13,173.229,3576.81,84395,283,184,83929,83808,76474,75920,81205
19654,12,209,14045,5609,2.79461e+13,170.048,1599.66,19654,153,140,9695,6135,2910,1634,1979
95550,149,347,68245,27305,2.80154e+13,173.113,3622.57,95550,289,175,90757,72363,73727,80086,81894
22390,64,214,15998,6392,2.79647e+13,170.419,1709.79,22390,157,144,17792,14759,6192,5747,8899
39200,225,244,28003,11197,2.79874e+13,171.927,2279.63,39200,188,175,38956,38956,38357,38634,38937
42140,51,250,30105,12035,2.79994e+13,172.169,2367.06,42140,193,175,32298,26118,10365,11972,14494
60500,281,283,43214,17286,2.79852e+13,172.659,2853.9,60500,226,175,60217,60217,60213,60213,60215
53892,158,800,38579,15313,2.66956e+13,221.778,3671.5,53892,798,175,50970,40466,45027,42963,46828
48848,314,800,34979,13869,2.65554e+13,228.323,3541.8,48848,793,175,47647,47166,40930,43922,46563
65885,690,800,47154,18731,2.69373e+13,214.112,3957.24,65885,798,175,65078,64861,60448,62684,64756
3361,16,180,2398,963,2.79418e+13,151,653.107,3361,95,91,1852,1305,558,374,471
31606,5,231,22581,9025,2.79895e+13,171.546,2041.12,31606,175,161,9829,3479,2112,2299,2023
20503,94,356,14620,5883,2.84574e+13,170.882,1815.64,20503,169,158,17349,14357,7246,5296,10267
59542,234,282,42535,17007,2.79979e+13,172.702,2831.21,59542,225,175,59260,59260,56752,58009,59212
91276,313,339,65200,26076,2.80021e+13,173.161,3536.81,91276,282,175,90937,90937,89877,90392,90911
63863,70,289,45617,18246,2.7993e+13,172.736,2935.23,63863,232,175,51555,42480,19135,16673,27426
99137,294,353,70811,28326,2.80029e+13,173.195,3692.81,99137,296,175,98784,98784,95482,97150,98725
11922,46,195,8521,3401,2.7895e+13,167.353,1239.53,11922,137,126,8949,7185,2729,2016,3474
78370,49,800,56065,22305,2.71267e+13,224.326,4227.44,78370,798,175,59083,48011,18146,21966,25420
28834,687,797,20642,8192,2.66861e+13,166.621,2675.88,28834,500,153,28037,28037,24690,26419,19287
27468,61,223,19618,7850,2.79618e+13,171.091,1898.59,27468,166,153,21688,17761,7434,9213,11257
54007,76,272,38577,15430,2.80179e+13,172.503,2691.43,54007,215,175,44189,36698,17995,18694,25381
37355,208,242,26677,10678,2.80392e+13,171.966,2225.19,37355,185,171,37113,37113,35534,36314,37079
18959,107,208,13547,5412,2.7968e+13,169.721,1570.41,18959,151,138,16521,13887,9186,8525,12062
24813,35,219,17723,7090,2.79633e+13,170.894,1802.93,24813,162,149,17561,13986,4755,5573,6272
52013,305,800,37239,14774,2.66829e+13,227.636,3623.99,52013,714,176,50882,50325,49454,49599,49728
52411,29,427,37445,14966,2.78691e+13,171.396,2842.86,52411,236,175,35379,26723,8906,5785,311
93021,281,342,66446,26575,2.7999e+13,173.146,3571.74,93021,285,175,92679,92679,89242,90979,92618
91756,171,340,65543,26213,2.80075e+13,173.14,3546.54,91756,283,175,90760,71129,80657,86169,89436
89301,240,336,63784,25517,2.8016e+13,173.126,3497.14,89301,279,175,88965,88965,83170,86120,88869
75586,425,461,53963,21623,2.81369e+13,173.096,3398.7,75586,269,179,75125,75125,73852,73545,74985
30630,31,229,21879,8751,2.7985e+13,171.421,2007.98,30630,172,159,21021,15933,5470,6650,6713
99452,260,800,71128,28324,2.72956e+13,257.2,4638.52,99452,746,180,98191,97679,91605,94286,96860
56501,163,276,40361,16140,2.80022e+13,172.559,2754.54,56501,219,175,55025,43280,49449,52921,52759
44614,82,254,31870,12744,2.79899e+13,172.221,2437.25,44614,197,175,36960,31040,15701,16915,22967
62310,22,286,44512,17798,2.79767e+13,172.735,2897.83,62310,230,175,38968,27704,10587,8771,7411
24905,121,219,17788,7117,2.80071e+13,170.852,1806.16,24905,162,149,22341,18516,14133,12217,17703
98940,313,353,70673,28267,2.80061e+13,173.212,3689.47,98940,296,175,98587,98587,96587,97583,98547
49108,60,263,35076,14032,2.80176e+13,172.444,2562.22,49108,206,175,38712,31593,13146,12211,18617
47036,237,259,33599,13437,2.80005e+13,172.35,2505.55,47036,202,175,46777,46777,45985,46362,46755
98489,210,352,70348,28141,2.80171e+13,173.17,3680.42,98489,295,175,98137,98137,89224,93777,97995
38499,116,244,27496,11003,2.80215e+13,172.032,2260.1,38499,187,173,34243,28497,20316,18693,26301
9378,120,191,6697,2681,2.80607e+13,165.482,1097.39,9378,127,117,8323,6935,5245,4985,6627
18202,162,207,12999,5203,2.80174e+13,169.76,1538.84,18202,150,137,17592,13905,15891,16208,16836
14763,54,201,10543,4220,2.80301e+13,168.926,1383.38,14763,144,130,11395,9350,3643,2737,4875
62114,163,800,44458,17656,2.68636e+13,228.11,3870.46,62114,798,175,59464,46860,52358,55861,55564
39954,23,800,28627,11327,2.62716e+13,208.65,3294.81,39954,785,172,25030,18579,6635,4001,6238
69160,282,447,49380,19780,2.81067e+13,173.075,3251.28,69160,249,177,68713,68593,67676,67499,67891
62059,203,286,44322,17737,2.80036e+13,172.723,2892.08,62059,229,175,61773,61773,56839,59347,61690
7133,24,187,5092,2041,2.80493e+13,162.618,955.43,7133,119,109,4573,3359,1222,786,1202
34560,67,237,24689,9871,2.80008e+13,171.834,2137.92,34560,180,166,27678,22842,10004,10941,14526
40050,125,247,28601,11449,2.80333e+13,171.965,2306.44,40050,189,175,36253,30089,24407,24855,29311
61835,251,286,44170,17665,2.8014e+13,172.688,2887.09,61835,229,175,61549,61549,59912,60720,61514
30701,117,229,21934,8767,2.79753e+13,171.485,2010.53,30701,173,160,27327,22724,16700,14786,21183
18849,102,208,13462,5387,2.80118e+13,169.776,1566.1,18849,151,137,16265,13734,8508,7918,11594
82211,262,323,58720,23491,2.80087e+13,173.077,3349.05,82211,266,175,81888,81888,78465,80194,81827
9716,113,191,6948,2768,2.78667e+13,165.873,1116.92,9716,129,119,8513,7169,5063,4705,6441
17049,135,205,12174,4875,2.80376e+13,169.19,1488.03,17049,147,134,15674,12821,11393,12065,13388
64960,723,944,46465,18495,2.7065e+13,216.812,4123.03,64960,800,193,64016,63784,58433,60883,63353
4856,61,182,3472,1384,2.78932e+13,157.44,785.704,4856,107,99,3790,3124,1356,2057,1922
18765,169,208,13401,5364,2.80172e+13,169.758,1562.7,18765,151,137,18365,14475,16665,17617,17952
78473,783,796,56108,22365,2.74517e+13,241.181,4015.24,78473,410,175,77677,77677,77676,77676,77677
64406,146,290,46008,18398,2.79909e+13,172.751,2948.23,64406,233,175,60809,48762,48629,50939,54617
56554,32,276,40390,16164,2.80159e+13,172.567,2756.16,56554,219,175,39152,29656,10355,10768,10784
6091,111,185,4353,1738,2.79702e+13,161.135,882.244,6091,116,106,5276,4461,3142,3527,4047
92867,673,800,66426,26441,2.72661e+13,223.538,4515.5,92867,798,180,92036,91834,86900,89412,91687
77415,369,460,55272,22143,2.81251e+13,173.111,3434.08,77415,256,194,76955,76955,71948,70953,76465
54393,36,273,38842,15551,2.80391e+13,172.504,2701.74,54393,215,175,38829,30783,11036,8508,13178
30579,101,229,21845,8734,2.79811e+13,171.398,2006.38,30579,172,159,26363,22253,13740,13557,18459
76185,796,800,54507,21678,2.70823e+13,222.816,4181.71,76185,783,180,75385,75227,74982,75128,75374
97381,250,800,69650,27731,2.72876e+13,264.501,4600.46,97381,794,175,96031,95611,83337,89271,94667
53929,110,272,38523,15406,2.79983e+13,172.616,2689.86,53929,215,175,47397,39744,27201,24783,35295
18835,9,208,13455,5380,2.80027e+13,169.739,1565.58,18835,152,138,8234,3982,2351,1225,907
31116,52,231,22223,8893,2.80276e+13,171.572,2025.69,31116,174,160,23916,19388,7559,5597,10009
18690,111,208,13347,5343,2.80242e+13,169.709,1559.49,18690,151,137,16403,13756,9589,10827,12346
29335,70,227,20958,8377,2.79966e+13,171.342,1964.59,29335,170,156,23648,19502,8766,6408,12237
85898,233,329,61354,24544,2.79949e+13,173.067,3425.77,85898,272,175,85569,85569,79756,82716,85473
56954,251,277,40681,16273,2.8007e+13,172.586,2766.37,56954,220,175,56677,56677,55666,56153,56651
26473,119,221,18911,7562,2.79864e+13,170.968,1862.86,26473,165,152,23636,19642,14651,16038,18556
3832,52,181,2735,1097,2.8035e+13,152.579,697.621,3832,101,93,2906,2386,968,1108,1323
57102,241,277,40791,16311,2.79985e+13,172.643,2769.87,57102,221,175,56825,56825,55078,55947,56789
7675,29,188,5480,2195,2.80681e+13,163.819,991.954,7675,121,112,5173,3912,1330,1055,1603
84676,301,327,60489,24187,2.79998e+13,173.107,3400.69,84676,270,175,84349,84349,83283,83802,84323
54226,159,272,38731,15495,2.80112e+13,172.55,2696.7,54226,215,175,52418,41433,47355,50751,49570
5279,24,183,3766,1513,2.80055e+13,158.476,819.596,5279,108,102,3384,2488,925,931,759
99605,4,355,71144,28461,2.80127e+13,173.203,3703.18,99605,297,175,26121,7929,5767,5586,2184
14734,5,201,10518,4216,2.80471e+13,168.415,1381.45,14734,143,130,4586,1638,988,851,407
33066,143,234,23614,9452,2.80184e+13,171.612,2089.27,33066,177,163,30976,24953,24404,27003,27532
24011,198,218,17143,6868,2.80648e+13,170.748,1773.43,24011,161,147,23793,23793,23166,23456,23773
6633,60,186,4737,1896,2.79984e+13,162.379,920.993,6633,116,107,5178,4254,1779,1721,2519
72186,564,800,51649,20537,2.70378e+13,232.091,4096.52,72186,755,180,71302,70902,69659,70272,70678
42839,190,251,30601,12238,2.79829e+13,172.133,2386.75,42839,194,175,42588,42588,39150,40888,42527
93579,525,800,66933,26646,2.72648e+13,234.268,4529.09,93579,798,175,92546,92213,83353,87870,91954
93356,523,800,66769,26587,2.72757e+13,233.726,4524.79,93356,786,180,92407,92007,89032,90525,91725
15363,112,202,10972,4391,2.80444e+13,169.059,1411.51,15363,145,131,13487,11321,7930,7666,10216
87246,172,332,62317,24929,2.80093e+13,173.095,3454.42,87246,275,175,86446,68418,76760,81958,85237
50799,153,266,36285,14514,2.80079e+13,172.406,2607.17,50799,209,175,48553,38451,41717,43987,44838
28928,31,226,20662,8266,2.79816e+13,171.256,1950.13,28928,169,156,19854,15055,5187,3699,5993
50127,83,265,35803,14324,2.80126e+13,172.404,2589.55,50127,208,175,41649,34867,17710,17623,25265
62029,113,286,44308,17721,2.80172e+13,172.727,2891.51,62029,229,175,54868,45951,32295,33573,41535
63830,67,290,45585,18245,2.8023e+13,172.707,2935.5,63830,232,175,51201,42233,18600,25534,27764
25300,105,220,18061,7239,2.8054e+13,170.704,1820.81,25300,162,149,21975,18548,11912,13884,16033
98400,342,352,70282,28118,2.80009e+13,173.215,3678.78,98400,295,175,98048,98048,97929,97978,98038
91522,5,340,65374,26148,2.80145e+13,173.16,3542.33,91522,283,175,28463,10090,6121,5293,2438
90304,84,337,64503,25801,2.8001e+13,173.144,3516.82,90304,280,175,75209,62839,32022,31891,46854
52447,147,269,37462,14985,2.8011e+13,172.509,2650.85,52447,212,175,49574,39697,39864,43725,44662
48430,107,262,34589,13841,2.8026e+13,172.275,2543.8,48430,204,175,42317,35527,23423,26724,31040
80372,134,319,57404,22968,2.80137e+13,172.985,3308.88,80372,262,175,74151,60569,53172,55942,62699
37921,54,242,27094,10827,2.7977e+13,171.96,2241.32,37921,186,173,29359,24045,9362,8577,13061
17633,183,206,12593,5040,2.80113e+13,169.42,1513.92,17633,149,135,17427,17427,16569,16980,17404
28082,158,225,20055,8027,2.80324e+13,171.131,1921.09,28082,168,154,27024,21437,24464,26209,25277
87008,29,481,62122,24886,2.81037e+13,173.229,3643.17,87008,273,192,58828,44341,14850,9463,17140
46321,223,258,33095,13226,2.79858e+13,172.361,2485.96,46321,201,175,46063,46063,44436,45241,46028
50686,246,266,36198,14488,2.80203e+13,172.382,2604.45,50686,208,175,50420,50420,49774,50074,50400
11696,177,195,8356,3340,2.79647e+13,167.269,1227.89,11696,135,125,11501,11501,10992,11222,11483
31802,104,231,22721,9081,2.79764e+13,171.55,2047.25,31802,175,162,27571,23313,14691,13785,19763
82124,504,800,58750,23374,2.7152e+13,219.557,4304.41,82124,798,180,81135,80779,76281,78549,80436
85383,127,473,60966,24417,2.81059e+13,173.227,3604.35,85383,279,176,77643,64205,52011,52074,63366
47017,210,259,33583,13434,2.80058e+13,172.299,2504.91,47017,202,175,46758,46758,44124,45449,46709
61305,240,285,43787,17518,2.80151e+13,172.683,2874.11,61305,228,175,61020,61020,58670,59848,60975
58977,110,280,42126,16851,2.7994e+13,172.663,2816.3,58977,223,175,51849,43479,29752,28421,38801
74766,332,451,53384,21382,2.81273e+13,173.127,3371.18,74766,266,179,74315,74315,72856,71390,72870
38174,124,243,27264,10910,2.80093e+13,171.918,2249.44,38174,186,172,34490,28543,23262,23613,28003
21629,92,213,15447,6182,2.79983e+13,170.382,1680.28,21629,156,143,18277,15066,8525,8304,12114
41801,85,249,29854,11947,2.80075e+13,172.037,2356.6,41801,192,175,34860,29157,15122,20047,21958
35091,230,238,25061,10030,2.80386e+13,171.783,2154.61,35091,181,167,34853,34853,34765,34800,34845
45254,722,732,32377,12877,2.71772e+13,209.365,3121.87,45254,346,175,44522,44522,44522,44522,44522
52808,28,270,37714,15094,2.80302e+13,172.527,2660.72,52808,213,175,35405,26544,9004,6625,10281
84473,276,800,60427,24046,2.71753e+13,252.828,4351.66,84473,675,175,83311,82767,79685,80803,82015
74863,37,800,53561,21302,2.70772e+13,216.578,4154.05,74863,798,176,53338,42179,14970,11394,17842
76377,186,312,54559,21818,2.80189e+13,172.954,3222.3,76377,255,175,76065,76065,68235,72232,75939
32378,28,233,23122,9256,2.80398e+13,171.476,2066.98,32378,175,162,21705,16277,5537,3896,6173
55777,594,800,39925,15852,2.67704e+13,222.54,3718.35,55777,798,175,54856,54480,48781,51681,54359
52250,406,411,37303,14947,2.8165e+13,172.773,2830.27,52250,212,193,51839,51839,51801,51813,51834
78079,263,315,55768,22311,2.80213e+13,172.961,3259.45,78079,258,175,77764,77764,74963,76373,77712
90949,140,338,64964,25985,2.79959e+13,173.117,3529.56,90949,281,175,84917,68544,65253,65266,73862
10075,100,193,7194,2881,2.8146e+13,165.878,1139.03,10075,130,120,8607,7293,4522,5288,6127
89960,218,337,64252,25708,2.80173e+13,173.148,3510.49,89960,280,175,89623,89623,82264,86019,89504
91558,391,484,65372,26186,2.80911e+13,173.284,3731.54,91558,281,193,91074,91074,86383,85502,90340
55051,193,273,39326,15725,2.79828e+13,172.564,2717.5,55051,216,175,54778,54778,50040,52449,54698
76996,165,313,55002,21994,2.79966e+13,173.021,3235.94,76996,257,175,75313,59118,67452,72185,72502
75968,453,455,54241,21727,2.8127e+13,173.124,3401.15,75968,253,193,75513,75513,75510,75509,75511
13351,168,198,9539,3812,2.79783e+13,168.145,1313.57,13351,142,128,12999,10256,11877,12512,12643
31889,369,374,22752,9137,2.82664e+13,171.912,2231.58,31889,186,169,31515,31515,31479,31490,31510
12361,64,196,8825,3536,2.79297e+13,167.543,1262.5,12361,137,126,9799,8142,3442,3618,4865
44277,21,800,31714,12563,2.64477e+13,215.346,3418.17,44277,798,175,27018,19604,7371,4630,6782
86014,69,329,61438,24576,2.79964e+13,173.039,3427.92,86014,272,175,69316,57072,25263,30069,38441
2438,98,178,1746,692,2.76047e+13,142.765,555.405,2438,86,80,2010,1731,1061,1027,1350
57622,21,278,41160,16462,2.7995e+13,172.62,2782.89,57622,221,175,35516,25312,9795,5939,8543
24226,114,218,17304,6922,2.80249e+13,170.796,1780.99,24226,161,147,21428,17919,12710,11683,16370
61767,374,800,44213,17554,2.68663e+13,226.735,3862.04,61767,798,175,60615,60062,53174,56640,59689
92850,145,342,66317,26533,2.80096e+13,173.117,3568.64,92850,284,175,87521,70145,69630,77149,77569
85610,267,329,61150,24460,2.80117e+13,173.097,3420.43,85610,272,175,85281,85281,81787,83554,85219
22450,112,215,16038,6412,2.80028e+13,170.625,1713.23,22450,158,145,19755,16561,11605,10532,14935
55524,794,800,39750,15774,2.67453e+13,230.811,3712.33,55524,795,175,54724,54509,53240,53889,54707
69817,163,946,49934,19883,2.71304e+13,218.038,4233.64,69817,810,184,66846,52784,52679,52563,60134
18200,58,207,12997,5203,2.80283e+13,169.48,1538.52,18200,149,136,14238,11672,4814,5609,6873
76385,169,800,54652,21733,2.70722e+13,216.565,4185.89,76385,798,179,74202,58331,65121,66246,71525
20580,29,211,14699,5881,2.80641e+13,170.028,1637.93,20580,154,141,13906,10493,3535,4415,4703
65751,403,800,47059,18692,2.6928e+13,214.082,3954.14,65751,798,175,64655,64039,59071,61782,63760
98222,13,946,70228,27994,2.73721e+13,232.97,4806.15,98222,795,197,50193,34228,14649,7074,6876
69550,243,300,49679,19871,2.80059e+13,172.896,3069.31,69550,243,175,69250,69250,66095,67686,69193
30395,182,229,21709,8686,2.80069e+13,171.465,2000.76,30395,172,159,30166,30166,27692,28933,30119
10465,27,193,7475,2990,2.80253e+13,166.685,1160.84,10465,131,122,6938,5179,1800,1733,2012
74009,131,308,52869,21140,2.80117e+13,172.908,3170.01,74009,251,175,67876,55769,46829,43382,56595
73857,456,800,52844,21013,2.7059e+13,230.573,4132.49,73857,763,180,72861,72130,70647,71561,72025
10755,94,193,7686,3069,2.79108e+13,166.636,1176.29,10755,133,122,9082,7503,4408,4221,6049
16647,44,204,11888,4759,2.79956e+13,169.331,1470,16647,147,134,12420,9830,3772,3441,4885
93649,136,344,66893,26756,2.80172e+13,173.157,3585.23,93649,287,175,86753,70574,63484,67359,74800
46836,120,258,33458,13378,2.79908e+13,172.306,2499.22,46836,201,175,41995,34775,26171,24188,33189
98994,207,353,70712,28282,2.80064e+13,173.201,3690.34,98994,296,175,98641,98641,89423,94136,98495
71105,348,445,50764,20341,2.81201e+13,173.049,3290.4,71105,260,177,70660,70660,69684,68840,69859
80830,609,800,57822,23008,2.71495e+13,236.057,4278.12,80830,763,180,79987,79587,78215,78890,79457
48784,116,263,34842,13942,2.80334e+13,172.316,2553.89,48784,205,175,43388,36136,25796,29282,33694
91200,202,339,65149,26051,2.80084e+13,173.146,3535.3,91200,282,175,90861,90861,82282,86665,90724
26895,210,223,19209,7686,2.80342e+13,171,1879.09,26895,166,152,26672,26672,26441,26541,26659
44183,100,254,31557,12626,2.80113e+13,172.232,2425.96,44183,197,175,38043,32080,19717,18362,26523
64956,268,291,46403,18553,2.7988e+13,172.796,2961.38,64956,235,175,64665,64665,63802,64216,64642
46955,179,258,33546,13409,2.79918e+13,172.343,2502.5,46955,202,175,46697,46697,42017,44394,46618
69855,280,443,49874,19981,2.81294e+13,173.071,3262.5,69855,242,192,69412,69292,55394,53360,64803
44226,235,254,31592,12634,2.80031e+13,172.195,2427.01,44226,197,175,43972,43972,43439,43680,43953
69534,203,300,49658,19876,2.80204e+13,172.807,3068.71,69534,242,175,69234,69234,63348,66346,69137
63993,9,439,45685,18308,2.81275e+13,172.971,3131.07,63993,231,196,27951,13522,8011,3630,5342
48937,693,800,35032,13905,2.67489e+13,218.517,3485.9,48937,712,175,48137,48053,42301,45276,22172
1732,105,177,1240,492,2.78016e+13,127.706,466.264,1732,76,73,1417,1237,832,831,1040
8206,158,189,5860,2346,2.80363e+13,164.415,1025.92,8206,123,113,7796,6233,7069,7556,7348
83483,190,324,59632,23851,2.80019e+13,173.015,3374.51,83483,268,175,83159,83159,74740,79042,83025
90791,342,800,64936,25855,2.72445e+13,222.137,4475.47,90791,798,180,89626,89033,83415,86089,88551
71748,295,800,51334,20414,2.70538e+13,231.841,4087.22,71748,798,175,70502,70024,61973,65839,69321
58679,152,800,41995,16684,2.68309e+13,216.501,3788.99,58679,798,175,54996,43736,45238,48255,48995
99317,173,354,70940,28377,2.80075e+13,173.235,3697.21,99317,297,175,98607,78062,87409,93325,97751
73986,296,308,52852,21134,2.79919e+13,172.959,3169.6,73986,251,175,73678,73678,73503,73579,73666
41177,192,248,29416,11761,2.79908e+13,172.127,2338.74,41177,192,175,40929,40929,37814,39386,40873
11988,46,196,8559,3429,2.80354e+13,167.009,1243.59,11988,136,125,9006,7245,2753,3295,3666
10155,179,192,7257,2898,2.79239e+13,166.182,1142.58,10155,130,120,9963,9963,9729,9829,9950
52176,144,269,37269,14907,2.80297e+13,172.488,2644.26,52176,212,175,49024,39394,38726,42929,43386
92371,261,800,66063,26308,2.72601e+13,234.037,4505.99,92371,798,175,91075,90610,81393,85766,89754
52082,227,411,37172,14910,2.81531e+13,172.75,2825.57,52082,218,176,51671,51549,48948,49064,50896
26551,386,546,18984,7567,2.73315e+13,166.72,2250.59,26551,314,150,26005,26005,22813,21870,10779
79494,361,461,56758,22736,2.81051e+13,173.15,3477.81,79494,259,193,79033,79033,73922,72957,78230
60276,107,283,43054,17222,2.80051e+13,172.679,2848.95,60276,226,175,52659,44220,29121,28717,38991
88791,225,334,63417,25374,2.80088e+13,173.059,3485.36,88791,277,175,88457,88457,81760,85175,88348
94280,441,800,67434,26846,2.72637e+13,246.398,4542.16,94280,798,175,93143,92516,82303,87712,92359
74774,294,455,53388,21386,2.81243e+13,173.125,3376.1,74774,251,192,74319,74201,66326,63795,70357
34333,198,236,24524,9809,2.79973e+13,171.735,2129.93,34333,179,166,34097,34097,32228,33158,34059
41891,191,249,29927,11964,2.79675e+13,172.12,2359.16,41891,193,175,41642,41642,38391,40033,41584
58643,257,281,41884,16759,2.80142e+13,172.626,2809.57,58643,223,175,58362,58362,57486,57903,58338
96574,292,800,69075,27499,2.7278e+13,231.437,4585.37,96574,798,175,95313,94806,85909,90184,94078
4166,93,182,2975,1191,2.83222e+13,155.37,728.491,4166,103,98,3458,2883,1663,1446,2239
19388,103,209,13846,5542,2.80247e+13,169.926,1588.88,19388,152,138,16765,14201,8781,7590,11779
4142,164,181,2955,1187,2.81807e+13,153.629,724.207,4142,102,97,3895,3140,3660,3797,3751
67945,617,800,48620,19325,2.69806e+13,217.833,4003.55,67945,798,175,67050,66650,61252,64181,66596
27047,162,223,19316,7731,2.80223e+13,171.005,1884.11,27047,166,152,26213,20696,23620,25258,25009
73850,277,308,52755,21095,2.80168e+13,172.977,3166.95,73850,251,175,73542,73542,72171,72844,73511
88161,356,482,62947,25214,2.81018e+13,173.251,3665.95,88161,275,194,87679,87679,83042,79522,85301
98900,231,353,70638,28262,2.7996e+13,173.217,3688.63,98900,296,175,98547,98547,91003,94854,98425
72766,191,800,52062,20704,2.70391e+13,219.659,4109.1,72766,786,180,71415,71041,63420,66760,69925
88144,297,334,62960,25184,2.80131e+13,173.142,3473.42,88144,277,175,87810,87810,86044,86920,87773
71365,222,303,50980,20385,2.80039e+13,172.899,3110.37,71365,246,175,71062,71062,66264,68702,70981
26720,151,222,19082,7638,2.80281e+13,170.969,1872.3,26720,165,152,25376,20207,21042,22570,23099
34541,179,236,24675,9866,2.79917e+13,171.708,2136.1,34541,179,166,34305,34305,31131,32735,34248
36994,748,800,26518,10476,2.609e+13,208.645,3206.14,36994,770,166,36194,36035,34458,35224,36039
91689,314,588,65444,26245,2.81246e+13,173.338,3847.31,91689,281,202,91101,90997,69318,55130,76321
70925,153,303,50656,20269,2.80347e+13,172.839,3101.1,70925,245,175,67828,53696,58264,61454,62208
69784,329,800,49939,19845,2.70182e+13,220.155,4044.28,69784,798,175,68594,68064,61599,64715,67519
35090,719,800,25153,9937,2.6001e+13,209.806,3147.13,35090,782,163,34290,34232,30252,32307,20634
50043,164,264,35751,14292,2.79864e+13,172.509,2586.82,50043,208,175,48801,38314,43838,46877,46900
92616,80,341,66157,26459,2.79968e+13,173.132,3563.33,92616,284,175,76466,64292,31702,32039,46003
63444,14,289,45325,18119,2.79893e+13,172.818,2926.13,63444,232,175,33483,22817,9628,6183,4635
98231,33,800,70255,27976,2.72951e+13,252.334,4616.11,98231,757,180,68078,52293,17943,12662,20881
79677,275,318,56915,22762,2.80071e+13,173.013,3294.14,79677,261,175,79359,79359,77157,78259,79316
9132,98,190,6525,2607,2.79532e+13,165.229,1082.16,9132,125,116,7773,6592,4002,4392,5477
63722,401,800,45603,18119,2.69171e+13,214.988,3907.63,63722,798,175,62620,62013,56774,59615,61725
50807,264,266,36290,14517,2.80173e+13,172.456,2607.55,50807,209,175,50541,50541,50537,50537,50539
63889,215,289,45636,18253,2.80037e+13,172.745,2935.75,63889,232,175,63600,63600,59278,61471,63526
86387,180,331,61702,24685,2.80222e+13,173.05,3437.1,86387,273,175,86056,86056,76538,81404,85905
54237,132,273,38737,15500,2.80185e+13,172.518,2698.05,54237,215,175,49793,40855,34720,35301,41549
22726,114,215,16227,6499,2.79974e+13,170.566,1723.4,22726,158,145,20082,16809,11876,11438,15350
6957,7,186,4971,1986,2.78075e+13,162.572,942.723,6957,118,108,2679,1069,753,511,252
42922,37,251,30661,12261,2.80076e+13,172.074,2388.94,42922,194,175,30866,24291,8854,11108,11381
61397,210,285,43855,17542,2.80075e+13,172.716,2876.32,61397,228,175,61112,61112,56714,58948,61037
19202,136,209,13709,5493,2.80469e+13,169.591,1581.12,19202,151,138,17706,14448,13010,13802,15052
98104,31,352,70081,28023,2.80021e+13,173.241,3673.65,98104,295,175,67383,51075,17573,19705,22944
68526,179,298,48949,19577,2.80032e+13,172.888,3045.57,68526,241,175,68228,68228,60850,64615,68109
82452,59,800,58982,23470,2.71669e+13,219.354,4311.1,82452,798,180,64196,52543,21413,16955,29623
75587,134,311,53989,21598,2.80156e+13,172.97,3205.25,75587,254,175,69741,56955,50005,52599,59412
61270,94,428,43741,17529,2.81642e+13,172.953,3059.04,61270,237,192,52086,42890,23041,17048,31995
91155,316,339,65105,26050,2.80099e+13,173.109,3534.43,91155,281,175,90816,90816,89961,90370,90793
93819,263,343,67017,26802,2.79875e+13,173.164,3587.37,93819,287,175,93476,93476,88736,91145,93396
62462,110,287,44614,17848,2.80078e+13,172.732,2902.17,62462,230,175,54936,46050,31525,30082,41683
84109,160,326,60079,24030,2.80061e+13,173.052,3388.54,84109,269,175,81533,64294,73522,75175,77394
8424,9,189,6019,2405,2.79289e+13,164.535,1039,8424,123,114,3685,1783,1052,545,427
97996,204,351,70003,27993,2.80014e+13,173.177,3670.45,97996,294,175,97645,97645,88365,93109,97498
46407,69,258,33148,13259,2.80038e+13,172.311,2488.2,46407,201,175,37366,30783,13758,10030,19299
53203,166,270,37998,15205,2.80099e+13,172.518,2670.1,53203,213,175,52087,41033,46686,49882,50441
85793,629,800,61363,24430,2.71938e+13,229.887,4377.61,85793,781,180,84955,84785,82211,83533,84480
45171,62,255,32267,12904,2.79658e+13,172.29,2453.01,45171,199,175,35793,29298,12296,12922,17603
67885,281,297,48488,19397,2.80084e+13,172.871,3030.86,67885,240,175,67588,67588,67218,67379,67572
91142,299,339,65104,26038,2.79954e+13,173.152,3534.22,91142,282,175,90803,90803,88835,89816,90763
2062,170,178,1473,589,2.82699e+13,136.595,511.015,2062,78,78,1874,1544,1830,1854,1858
42178,238,251,30130,12048,2.80075e+13,172.229,2369.13,42178,194,175,41927,41927,41724,41810,41914
99481,218,354,71055,28426,2.80108e+13,173.22,3700.01,99481,297,175,99127,99127,90614,94964,98991
17506,69,206,12504,5002,2.80456e+13,169.355,1508.29,17506,149,135,14059,11602,5229,5295,7640
21454,413,800,15413,6041,2.47746e+13,204.971,2662.6,21454,649,138,20573,19960,19599,19773,19495
68107,208,297,48652,19455,2.79997e+13,172.873,3035.6,68107,241,175,67810,67810,62456,65181,67721
79533,86,460,56792,22741,2.81002e+13,173.168,3477.49,79533,259,193,66504,55534,24174,17007,36339
32870,187,233,23483,9387,2.79798e+13,171.681,2082.54,32870,177,164,32637,32637,30208,31428,32591
31011,107,230,22153,8858,2.79954e+13,171.459,2021.23,31011,173,160,27072,22730,14983,13907,19694
31937,170,231,22817,9120,2.79507e+13,171.545,2051.45,31937,175,162,31431,24721,28284,30021,31015
18918,161,208,13513,5405,2.79766e+13,169.778,1568.79,18918,151,138,18262,14428,16491,17625,17417
30999,173,230,22143,8856,2.80062e+13,171.404,2020.87,30999,173,160,30661,24328,27591,29198,30394
59322,369,425,42349,16973,2.81634e+13,172.814,3010.21,59322,235,191,58897,58897,56340,55848,58488
35603,96,239,25432,10171,2.80269e+13,171.83,2170.83,35603,182,168,30373,24948,14819,14001,20566
57145,273,277,40820,16325,2.79971e+13,172.644,2770.95,57145,220,175,56868,56868,56845,56851,56864
53400,367,800,38231,15169,2.67017e+13,228.29,3659.18,53400,796,175,52247,51710,45230,48476,51301
23255,55,216,16615,6640,2.79902e+13,170.658,1744,23255,160,146,18041,14780,5818,4563,7926
50525,82,266,36088,14437,2.80399e+13,172.403,2600.45,50525,209,175,41885,35153,17767,18129,25441
96836,491,499,69143,27693,2.80808e+13,173.332,3842.62,96836,291,196,96337,96337,96263,96292,96329
39281,15,245,28058,11223,2.80013e+13,172.009,2282.85,39281,188,175,21300,14699,6182,3622,4619
40304,532,800,28873,11431,2.62881e+13,208.386,3304.73,40304,786,172,39364,39035,36031,37526,38700
22570,69,215,16124,6446,2.801e+13,170.573,1717.73,22570,158,144,18140,14957,6636,5147,9364
54451,77,272,38898,15553,2.79885e+13,172.526,2702.15,54451,215,175,44633,37201,18350,18557,26203
39105,178,245,27930,11175,2.80266e+13,172.019,2278.11,39105,188,174,38860,38860,35033,36972,38793
63814,218,289,45586,18228,2.79903e+13,172.799,2934.39,63814,233,175,63525,63525,59391,61487,63454
22820,78,215,16306,6514,2.79808e+13,170.716,1727.19,22820,159,145,18701,15608,7649,6688,10940
2604,25,179,1864,740,2.77905e+13,143.831,573.596,2604,86,81,1685,1228,458,293,477
67002,45,295,47852,19150,2.80055e+13,172.827,3009.74,67002,238,175,50302,39970,14948,14542,20671
75449,270,311,53895,21554,2.80071e+13,173.011,3202.63,75449,254,175,75138,75138,73100,74116,75097
73750,54,951,52740,21010,2.71593e+13,232.773,4323.68,73750,755,201,56524,46485,17648,10582,21172
11857,161,195,8470,3387,2.79294e+13,167.066,1235.78,11857,135,125,11396,9034,10320,11001,10748
66625,119,295,47582,19043,2.80245e+13,172.834,3001.69,66625,238,175,59666,49475,36897,40378,47119
11340,21,195,8096,3244,2.80855e+13,166.847,1209.26,11340,134,124,6980,4987,1949,1210,1714
82579,89,323,58981,23598,2.80169e+13,173.003,3356.04,82579,266,175,69528,57626,32147,40199,45339
92059,250,484,65733,26326,2.81034e+13,173.296,3741.21,92059,283,192,91575,91454,71643,59625,82835
88178,403,944,63048,25130,2.73188e+13,248.031,4613.25,88178,746,197,86994,86282,81992,83650,85479
16513,63,204,11791,4722,2.80097e+13,168.949,1463.92,16513,146,133,13085,10828,4577,6479,6822
21310,195,212,15220,6090,2.79483e+13,170.28,1667.13,21310,155,142,21098,21098,20650,20850,21081
71515,572,800,51168,20347,2.70356e+13,233.221,4081.94,71515,751,180,70641,70241,69158,69680,70031
47933,135,260,34240,13693,2.797e+13,172.366,2529.4,47933,204,175,44264,36105,32053,29826,37507
74874,101,309,53483,21391,2.80059e+13,172.929,3188.64,74874,252,175,64649,54532,33609,33088,45621
5402,11,184,3861,1541,2.81752e+13,159.824,830.532,5402,110,104,2567,1585,797,453,530
67651,295,296,48328,19323,2.79949e+13,172.895,3024.96,67651,240,175,67355,67355,67353,67353,67354
25087,59,220,17920,7167,2.80677e+13,170.826,1813.56,25087,163,149,19698,16090,6648,5347,9359
80438,295,607,57485,22953,2.77211e+13,240.851,3733.31,80438,261,175,79831,79712,78806,78999,79639
89214,101,335,63731,25483,2.79991e+13,173.142,3494.48,89214,279,175,77033,64980,40011,33590,53644
71860,262,304,51323,20537,2.79991e+13,172.924,3121.65,71860,247,175,71556,71556,69451,70502,71514
68236,657,950,48800,19436,2.71069e+13,214.178,4202.3,68236,798,192,67257,67007,63152,64765,66407
69419,218,300,49588,19831,2.80121e+13,172.893,3066.46,69419,243,175,69119,69119,64293,66744,69037
30192,159,228,21573,8619,2.79712e+13,171.396,1993.16,30192,172,159,29123,23046,26323,26911,27499
60529,279,283,43230,17299,2.79951e+13,172.653,2854.49,60529,226,175,60246,60246,60223,60229,60242
20855,66,212,14892,5963,2.80315e+13,170.21,1649.66,20855,155,141,16647,13784,6003,5808,8614
39920,97,246,28517,11403,2.79939e+13,172.014,2301.71,39920,189,175,34147,28915,17216,16159,23302
46806,95,258,33425,13381,2.80178e+13,172.233,2498.27,46806,201,175,39881,32823,19375,23891,27195
91303,285,340,65214,26089,2.80154e+13,173.129,3538.2,91303,282,175,90963,90963,87976,89481,90908
40984,77,248,29274,11710,2.79887e+13,172.084,2333.38,40984,191,175,33588,27988,13831,13087,18772
88670,306,478,63311,25359,2.81025e+13,173.27,3672.05,88670,283,192,88192,88086,85174,80084,84336
78305,304,316,55929,22376,2.80213e+13,172.941,3264.82,78305,258,175,77989,77989,77793,77879,77977
63680,246,289,45486,18194,2.8005e+13,172.759,2931.26,63680,232,175,63391,63391,61177,62285,63348
43656,95,253,31183,12473,2.80043e+13,172.093,2410.7,43656,196,175,37175,30619,18074,22272,25304
84001,98,326,59996,24005,2.80136e+13,173.045,3386.42,84001,269,175,72098,60883,36335,34832,49727
7730,79,188,5521,2209,2.79958e+13,163.715,995.32,7730,121,112,6296,5295,2672,3604,3835
14906,26,201,10647,4259,2.80162e+13,168.745,1389.32,14906,144,130,9822,7220,2553,2469,3042
37044,235,241,26460,10584,2.80047e+13,171.801,2215,37044,184,171,36803,36803,36749,36768,36797
93333,325,343,66667,26666,2.8011e+13,173.151,3578.4,93333,286,175,92990,92990,92482,92711,92972
62166,88,429,44385,17781,2.81478e+13,172.929,3080.5,62166,228,193,52196,43404,19974,15466,29332
70638,261,301,50460,20178,2.79991e+13,172.872,3093.21,70638,244,175,70337,70337,68319,69328,70297
63531,344,432,45355,18176,2.81392e+13,173.014,3114.41,63531,241,192,63099,63099,60337,59012,62012
96099,125,800,68736,27363,2.72722e+13,224.268,4576.14,96099,798,180,86247,71584,57389,49138,68674
88112,145,800,63030,25082,2.72195e+13,227.924,4423.58,88112,790,180,82078,65879,64424,67580,72254
97352,796,800,69630,27722,2.7287e+13,231.583,4599.95,97352,798,175,96552,96310,95232,95712,96541
9667,138,191,6909,2758,2.78915e+13,166.031,1114.48,9667,129,119,8896,7249,6713,6555,7643
94541,296,800,67620,26921,2.72808e+13,247.073,4547.18,94541,798,175,93258,92776,82142,87339,92039
18466,520,800,13273,5193,2.42543e+13,219.034,2534.25,18466,767,132,17532,17236,15369,16283,16826
60218,59,282,43019,17199,2.79947e+13,172.679,2846.72,60218,226,175,47356,38641,15939,25453,23441
48445,136,404,34581,13864,2.81712e+13,172.608,2728.21,48445,203,192,44757,36511,22436,14415,32215
27315,155,223,19510,7805,2.79587e+13,171.038,1893.29,27315,166,153,26151,20757,23111,22775,24102
92730,132,342,66232,26498,2.80125e+13,173.095,3566.34,92730,284,175,85250,69890,59366,60377,71333
73876,137,308,52767,21109,2.80184e+13,172.946,3167.47,73876,251,175,68552,55661,50344,53273,59220
90716,910,946,64861,25855,2.7329e+13,234.978,4664.05,90716,779,188,89770,89692,87515,88568,89663
12310,49,197,8790,3520,2.81256e+13,167.441,1261.06,12310,138,126,9341,7579,2918,2300,3824
21060,107,212,15043,6017,2.80127e+13,170.236,1657.39,21060,155,141,18369,15429,10173,8545,13262
28263,43,225,20194,8069,2.79874e+13,171.315,1927.53,28263,168,154,21014,16642,6279,5989,7983
59614,239,282,42581,17033,2.80091e+13,172.651,2832.74,59614,225,175,59332,59332,57119,58226,59289
60857,108,284,43474,17383,2.79992e+13,172.728,2863.23,60857,228,175,53287,44646,29728,33784,39442
40936,155,248,29242,11694,2.80043e+13,172.041,2331.94,40936,192,175,39248,31122,34697,36889,36295
15654,89,202,11189,4465,2.79546e+13,169.14,1424.54,15654,146,132,13114,10896,6090,5152,8422
29309,454,800,21027,8282,2.55714e+13,210.438,2956.79,29309,754,152,28316,27663,26425,27217,27471
91529,278,340,65372,26157,2.80186e+13,173.074,3542.18,91529,282,175,91189,91189,87689,89458,91127
61706,26,285,44073,17633,2.79904e+13,172.704,2883.27,61706,228,175,40707,29892,10504,9157,13150
28585,38,226,20417,8168,2.80366e+13,171.279,1938.81,28585,169,155,20692,16215,5810,4328,7263
20528,155,211,14667,5861,2.80528e+13,170.105,1636.02,20528,154,141,19603,15584,17341,18435,18165
41534,208,395,29641,11893,2.82247e+13,172.422,2535.99,41534,193,184,41139,41015,31255,22905,36722
95857,328,347,68469,27388,2.80064e+13,173.177,3628.22,95857,290,175,95510,95510,94940,95201,95491
86776,215,331,61981,24795,2.80118e+13,173.058,3444.37,86776,274,175,86445,86445,79267,82930,86329
29944,190,228,21393,8551,2.79961e+13,171.456,1985.36,29944,172,158,29716,29716,27830,28770,29678
64597,212,431,46124,18473,2.81435e+13,172.991,3135.05,64597,233,192,64166,64043,52245,43824,59026
48088,345,800,34431,13657,2.65799e+13,211.119,3521.84,48088,798,175,46947,46407,42214,44204,45923
62762,649,800,44920,17842,2.68981e+13,216.924,3885.55,62762,778,180,61947,61765,59477,60632,61510
36864,140,241,26335,10529,2.79885e+13,171.924,2209.79,36864,184,171,34342,27752,26418,25686,29840
69910,81,300,49940,19970,2.79946e+13,172.905,3076.93,69910,244,175,57823,48643,24408,24305,35003
99712,362,504,71196,28516,2.80899e+13,173.34,3898.88,99712,296,192,99208,99208,95027,90152,96279
49588,44,264,35423,14165,2.7999e+13,172.451,2575.16,49588,207,175,37079,29299,11187,8071,14289
65946,45,443,47074,18872,2.814e+13,173.022,3178.02,65946,251,177,49518,39348,14682,10479,18959
36321,13,240,25941,10380,2.80272e+13,171.792,2192.74,36321,183,169,18583,12548,5461,3432,4376
48408,92,262,34579,13829,2.80009e+13,172.438,2543.54,48408,205,175,40974,33756,19017,18510,27027
11366,28,342,8100,3266,2.8714e+13,166.928,1385.82,11366,134,145,7607,5681,1984,880,1962
69334,104,299,49528,19806,2.79916e+13,172.867,3063.68,69334,242,175,60228,50870,31987,30016,43064
34640,187,237,24741,9899,2.80257e+13,171.827,2140.41,34640,180,166,34403,34403,31736,33076,34353
47697,30,261,34065,13632,2.80435e+13,172.267,2524.27,47697,203,175,32505,24583,8255,8228,10703
6491,50,186,4637,1854,2.81119e+13,161.978,911.193,6491,116,108,4919,3987,1579,1413,2040
17824,80,206,12727,5097,2.8043e+13,169.562,1522.26,17824,149,136,14671,12355,6150,8361,8971
78084,377,460,55749,22335,2.80987e+13,173.173,3448.59,78084,273,186,77624,77624,75541,74548,76639
20971,125,212,14979,5992,2.80174e+13,170.357,1654.29,20971,155,142,18946,15733,12767,11290,15212
81511,229,321,58224,23287,2.79987e+13,173.042,3333.28,81511,264,175,81190,81190,75636,78465,81098
53664,82,407,38312,15352,2.81733e+13,172.623,2857.9,53664,212,189,44475,37400,15942,14470,23933
46996,140,259,33568,13428,2.80034e+13,172.328,2504.42,46996,202,175,43800,35394,33699,34125,38133
19318,15,209,13800,5518,2.79878e+13,169.737,1586.05,19318,152,139,10469,7227,3045,1902,1778
25421,31,793,18203,7218,2.65082e+13,165.702,2554.13,25421,496,147,17216,13205,4370,2791,199
74079,57,308,52913,21166,2.80062e+13,172.9,3171.52,74079,251,175,57950,47411,19722,22650,27592
26704,148,223,19073,7631,2.80237e+13,171.113,1872.62,26704,166,152,25212,20185,20360,22262,22764
10289,49,193,7348,2941,2.80669e+13,166.387,1151.18,10289,131,121,7794,6332,2436,1828,3157
6998,123,187,4998,2000,2.80875e+13,162.47,946.198,6998,119,109,6231,5203,4190,4318,5036
48294,257,262,34498,13796,2.80087e+13,172.447,2540.67,48294,205,175,48032,48032,48005,48013,48027
93281,202,343,66623,26658,2.8013e+13,173.124,3577.42,93281,285,175,92938,92938,84065,88600,92797
40023,105,247,28582,11441,2.80346e+13,171.941,2305.74,40023,189,175,34806,29351,18781,21954,25157
67814,70,943,48509,19305,2.70825e+13,228.13,4185.21,67814,813,192,54030,44761,18352,16150,27146
90348,125,800,64622,25726,2.72362e+13,227.498,4467.02,90348,798,175,81031,67253,53886,54493,64842
85265,84,329,60896,24369,2.80194e+13,173.069,3413.71,85265,271,175,71013,59340,30276,40713,44740
47538,117,260,33958,13580,2.80128e+13,172.328,2519.16,47538,203,175,42374,35209,25872,23190,32779
8531,95,190,6093,2438,2.8173e+13,164.685,1046.56,8531,125,115,7206,5957,3538,3430,4865
93989,67,800,67219,26770,2.72762e+13,247.343,4536.78,93989,798,175,74712,61776,26939,29829,39102
5028,8,183,3586,1442,2.81152e+13,158.033,800.047,5028,108,101,2089,960,587,399,296
4512,114,182,3222,1290,2.82727e+13,155.434,757.143,4512,105,100,3904,3317,2369,2650,2999
79394,285,318,56707,22687,2.80058e+13,173.06,3288.68,79394,261,175,79076,79076,77583,78319,79043
71567,165,303,51115,20452,2.79937e+13,172.868,3114.43,71567,246,175,69994,54961,62725,67101,67056
73121,73,306,52226,20895,2.79996e+13,172.928,3149.79,73121,249,175,59440,48768,23300,22667,32810
5739,100,184,4105,1634,2.7919e+13,161.018,855.871,5739,113,104,4862,4133,2561,2129,3361
59294,201,281,42355,16939,2.80011e+13,172.707,2824.65,59294,224,175,59013,59013,54275,56684,58933
38122,146,243,27227,10895,2.80179e+13,171.919,2247.94,38122,186,173,35936,28842,28760,30126,32291
90174,231,337,64408,25766,2.80102e+13,173.126,3514.26,90174,280,175,89837,89837,83339,86652,89731
88684,568,941,63416,25268,2.73265e+13,221.415,4618.36,88684,800,193,87596,87187,81322,84085,86624
5375,112,184,3840,1535,2.81597e+13,159.712,828.5,5375,110,104,4653,3933,2768,2548,3489
72212,10,800,51672,20540,2.70339e+13,241.303,4096.97,72212,673,175,33135,18431,9817,6178,3899
70558,163,302,50393,20165,2.80169e+13,172.818,3092.32,70558,244,175,68744,54058,61720,66098,65576
12812,126,198,9145,3667,2.81005e+13,167.774,1287.17,12812,140,127,11536,9594,7851,7971,9344
84310,143,800,60311,23999,2.71761e+13,221.222,4348.51,84310,798,180,78200,63003,60698,66936,68123
74844,4,310,53460,21384,2.80247e+13,172.939,3189.15,74844,253,175,19634,5961,4336,5152,1657
17886,144,333,12758,5128,2.84727e+13,164.932,1686.05,17886,148,147,16653,13509,6448,5911,5033
56658,150,277,40473,16185,2.80066e+13,172.671,2759.48,56658,220,175,53856,42877,43996,47852,49331
52090,211,268,37205,14885,2.79922e+13,172.492,2641.13,52090,211,175,51822,51822,48671,50260,51765
36321,9,240,25947,10374,2.79999e+13,171.88,2192.85,36321,183,170,15897,7680,4531,2894,3214
22658,33,215,16181,6477,2.80193e+13,170.56,1720.96,22658,158,144,15788,12074,4187,4248,5213
92699,434,800,66300,26399,2.72533e+13,252.078,4512.08,92699,798,175,91549,90938,80288,85916,90747
17042,16,204,12181,4861,2.79251e+13,169.372,1486.94,17042,148,135,9445,6642,2793,2467,1836
97967,123,351,69982,27985,2.80011e+13,173.217,3670.23,97967,294,175,88493,73302,58785,52275,71357
35368,6,238,25261,10107,2.80021e+13,171.719,2162.72,35368,181,167,12469,4735,3138,2107,1204
93414,411,492,66697,26717,2.80936e+13,173.253,3772.79,93414,298,191,92922,92922,90391,89625,92041
30905,111,229,22076,8829,2.79867e+13,171.355,2016.92,30905,173,160,27172,22773,15825,17894,20426
66458,99,294,47464,18994,2.80102e+13,172.822,2997.15,66458,237,175,57128,48153,28874,29027,39786
26103,100,221,18644,7459,2.79786e+13,170.961,1849.93,26103,164,151,22451,18943,11668,11532,15550
67084,167,295,47922,19162,2.79943e+13,172.774,3011.36,67084,238,175,65837,51754,58882,60066,64362
18523,72,208,13226,5297,2.80489e+13,169.735,1553.03,18523,151,137,14976,12340,5791,4972,8244
8641,48,190,6170,2471,2.80752e+13,164.935,1053.46,8641,125,115,6519,5267,2010,1525,2544
82278,510,800,58859,23419,2.71474e+13,244.403,4307.29,82278,798,175,81222,80933,71416,76258,80608
53187,56,270,37994,15193,2.79998e+13,172.458,2669.56,53187,213,175,41468,34038,13407,11006,18357
64410,21,290,46002,18408,2.80111e+13,172.718,2948.23,64410,233,175,39709,28306,10962,10493,8370
49774,388,403,35534,14240,2.81686e+13,172.622,2758.93,49774,205,192,49371,49371,49104,49228,49356
61910,20,428,44196,17714,2.81483e+13,172.859,3073.72,61910,228,193,37475,26529,10567,4497,6157
4972,93,183,3552,1420,2.80351e+13,157.861,795.613,4972,107,100,4141,3453,1998,1743,2713
35227,148,237,25165,10062,2.79503e+13,171.796,2157.75,35227,181,168,33317,26648,26876,26266,30030
46204,138,258,33008,13196,2.80232e+13,172.374,2483.13,46204,201,175,42912,34791,32298,33383,37124
47713,120,261,34076,13637,2.804e+13,172.293,2524.66,47713,203,175,42777,35429,26681,28996,33984
60662,127,800,43414,17248,2.68567e+13,212.105,3836.37,60662,793,175,54267,44916,36214,31196,43192
45043,13,255,32177,12866,2.7989e+13,172.269,2449.62,45043,198,175,23041,15549,6759,3912,4707
11854,15,195,8469,3385,2.78889e+13,167.279,1235.93,11854,135,125,6416,4425,1867,1089,1495
87861,113,333,62755,25106,2.80136e+13,173.083,3466.9,87861,276,175,77784,65105,45781,47531,59922
92224,42,341,65875,26349,2.80028e+13,173.157,3556.09,92224,284,175,68338,54013,19877,15536,25559
15198,107,201,10861,4337,2.79317e+13,168.738,1402.7,15198,144,131,13218,11128,7351,6977,9649
38451,235,244,27469,10982,2.80199e+13,171.99,2258.42,38451,187,173,38207,38207,38109,38148,38198
93126,55,485,66496,26630,2.80959e+13,173.274,3761.65,93126,300,178,72424,59311,23021,17601,31093
73638,23,307,52603,21035,2.79999e+13,172.955,3161.58,73638,250,175,46720,34075,12525,11594,14102
36972,107,800,26503,10469,2.61055e+13,209.874,3205.88,36972,767,166,31430,26485,16935,15710,21995
60887,178,284,43488,17399,2.80016e+13,172.734,2863.88,60887,227,175,60603,60603,54109,57419,60497
45350,179,256,32393,12957,2.80076e+13,172.26,2458.56,45350,199,175,45094,45094,40574,42868,45017
34407,100,237,24572,9835,2.80477e+13,171.615,2133.12,34407,179,166,29595,24980,15411,18051,20751
72353,200,444,51660,20693,2.81468e+13,173.086,3314.54,72353,261,182,71909,71784,61972,60642,69408
16008,88,203,11436,4572,2.79698e+13,169.099,1440.99,16008,146,133,13380,11152,6172,5579,8361
95434,98,489,68139,27295,2.81098e+13,173.277,3806.81,95434,288,193,81870,69201,31523,20950,47073
27301,45,223,19496,7805,2.80299e+13,170.973,1892.88,27301,166,153,20482,16288,6117,7642,8494
7808,143,188,5581,2227,2.79506e+13,164.162,1000.62,7808,122,111,7217,5859,5723,6313,6398
8951,50,190,6392,2559,2.79677e+13,165.161,1071.64,8951,125,116,6802,5518,2163,1836,2823
21007,51,212,15006,6001,2.79895e+13,170.267,1655.57,21007,155,142,16081,13008,5179,3968,6751
27468,29,224,19614,7854,2.80388e+13,171.017,1899.41,27468,166,153,18560,14002,4696,3406,5344
37282,220,242,26623,10659,2.80412e+13,171.894,2222.89,37282,185,171,37040,37040,36279,36639,37018
42011,156,250,30012,11999,2.80049e+13,172.156,2363.55,42011,193,175,40355,31939,35763,37935,37497
12611,162,197,9008,3603,2.79229e+13,167.827,1276.12,12611,139,127,12141,9620,11007,11717,11520
90915,671,945,64997,25918,2.74318e+13,253.855,4597.93,90915,563,193,89970,89961,89709,89340,89392
78514,39,800,56173,22341,2.7111e+13,220.364,4230.71,78514,798,175,56779,44651,15706,19252,21470
54299,559,800,38875,15424,2.67367e+13,214.913,3681.91,54299,772,180,53400,53004,51083,52038,52776
96023,216,491,68566,27457,2.80899e+13,173.294,3820.32,96023,289,193,95532,95409,62452,41117,84833
2308,81,178,1646,662,2.81847e+13,140.237,539.769,2308,85,81,1851,1582,845,1025,1168
57995,45,279,41420,16575,2.80189e+13,172.605,2792.44,57995,222,175,43539,34603,12906,9574,16624
83512,459,800,59739,23773,2.71745e+13,225.619,4332.1,83512,787,180,82498,82165,78866,80516,81689
78434,84,316,56025,22409,2.79913e+13,173.03,3267.59,78434,259,175,65301,54582,27851,26129,39463
33576,628,800,24075,9501,2.59238e+13,208.345,3099.16,33576,774,160,32745,32575,30525,31582,32260
18447,57,208,13169,5278,2.80653e+13,169.462,1549.65,18447,150,137,14398,11808,4733,5682,6934
2904,177,180,2073,831,2.85094e+13,145.7,606.834,2904,91,89,2724,2724,2712,2714,2721
3635,114,181,2592,1043,2.82764e+13,151.099,678.937,3635,99,93,3145,2663,1928,2135,2440
71095,408,444,50756,20339,2.81557e+13,173.005,3288.23,71095,244,193,70651,70651,69116,69872,70615
83644,36,325,59755,23889,2.79934e+13,173.092,3378.83,83644,269,175,59713,47319,16922,16191,20620
57383,109,278,40985,16398,2.80184e+13,172.671,2777.54,57383,221,175,50366,42193,28216,27527,37473
4773,178,183,3407,1366,2.81718e+13,157.556,779.548,4773,107,100,4590,4590,4554,4565,4585
75442,119,310,53888,21554,2.79947e+13,172.964,3201.37,75442,253,175,67577,56034,41751,36600,53071
72781,52,306,51989,20792,2.8022e+13,172.953,3142.89,72781,249,175,56013,45384,18043,16868,24215
98648,347,353,70468,28180,2.80062e+13,173.249,3684.38,98648,296,175,98295,98295,98256,98268,98289
14336,168,200,10239,4097,2.80301e+13,168.551,1362.07,14336,143,129,13968,11019,12745,13439,13711
61658,98,286,44043,17615,2.80145e+13,172.748,2883.31,61658,229,175,52886,44673,26756,22226,36009
34463,18,236,24610,9853,2.80348e+13,171.597,2133.8,34463,179,166,20000,14221,5821,4267,5618
84130,264,471,60074,24056,2.81011e+13,173.203,3577.65,84130,268,194,83659,83538,64942,57713,77367
80375,16,319,57413,22962,2.80109e+13,173.021,3308.99,80375,262,175,44605,31391,13230,11488,7752
61177,70,427,43673,17504,2.81334e+13,172.904,3055.84,61177,226,194,49382,40765,16328,11993,23441
59272,170,281,42333,16939,2.79997e+13,172.668,2823.98,59272,224,175,58466,45934,52201,55672,57176
50757,51,266,36253,14504,2.802e+13,172.508,2606.45,50757,209,175,38913,31460,12478,11606,16606
33478,49,234,23912,9566,2.7968e+13,171.621,2101.98,33478,177,164,25477,20630,7882,8667,10643
39921,306,499,28525,11396,2.769e+13,169.803,2606.18,39921,284,175,39422,39422,34561,32256,14216
30345,86,229,21672,8673,2.80067e+13,171.472,1999.28,30345,172,159,25348,21144,11192,10918,16079
55616,109,275,39722,15894,2.80226e+13,172.61,2733.04,55616,218,175,48807,40891,27359,25596,36189
63406,219,289,45292,18114,2.80238e+13,172.769,2925.26,63406,232,175,63117,63117,59094,61132,63047
63301,88,288,45220,18081,2.79902e+13,172.723,2921.79,63301,231,175,53154,44165,24303,23307,33972
41317,193,800,29599,11718,2.63114e+13,210.004,3334.19,41317,769,174,40025,39649,36019,37311,38600
71097,543,800,50869,20228,2.70282e+13,217.072,4073.1,71097,794,180,70160,69771,66320,68068,69526
38936,134,244,27814,11122,2.79854e+13,171.91,2271.99,38936,187,174,35890,29327,25753,23046,30252
19928,18,210,14233,5695,2.80001e+13,170.035,1611.43,19928,153,139,11550,8211,3358,2097,2858
56359,89,276,40258,16101,2.80153e+13,172.578,2751.34,56359,219,175,47426,39316,21926,20860,30595
33753,190,235,24106,9647,2.79988e+13,171.699,2111.5,33753,178,165,33518,33518,31191,32356,33473
9791,19,192,6992,2799,2.80707e+13,165.837,1121.92,9791,129,119,5799,4150,1682,988,1429
82450,100,323,58896,23554,2.80009e+13,173.034,3353.48,82450,266,175,71055,59903,36846,34200,49522
17274,141,350,12311,4963,2.85197e+13,169.978,1676.6,17274,159,149,15958,13035,10434,10241,12899
22546,196,215,16099,6447,2.80336e+13,170.626,1716.94,22546,158,145,22331,22331,21774,22029,22312
38244,3,243,27320,10924,2.79985e+13,171.969,2251.51,38244,186,172,8015,1795,1660,2555,805
33114,196,234,23651,9463,2.79777e+13,171.665,2090.75,33114,177,164,32880,32880,31048,31959,32842
51161,156,266,36546,14615,2.79803e+13,172.443,2616.31,51161,209,175,49185,38909,43567,44119,45680
4333,128,181,3098,1235,2.7783e+13,155.61,741.946,4333,105,96,3843,3221,2686,2712,3169
1562,97,177,1116,446,2.74016e+13,124.408,442.967,1562,70,69,1243,1098,673,711,916
59265,250,282,42336,16929,2.80077e+13,172.713,2825.01,59265,225,175,58983,58983,57564,58261,58951
6907,92,187,4927,1980,2.81723e+13,162.292,940.273,6907,118,109,5789,4797,2756,3454,3883
89781,471,477,64105,25676,2.81045e+13,173.26,3690.5,89781,278,193,89304,89304,89252,89270,89298
47488,250,260,33918,13570,2.7986e+13,172.385,2517.98,47488,203,175,47228,47228,47109,47158,47218
26090,47,221,18637,7453,2.80464e+13,170.998,1849.72,26090,164,151,19701,15791,6009,7413,8422
81220,16,321,58013,23207,2.80124e+13,172.993,3327.4,81220,264,175,45081,31726,13377,8086,10850
44857,713,800,32124,12733,2.64478e+13,223.957,3433.75,44857,689,175,44057,43897,43773,43799,43797
37531,104,242,26810,10721,2.80239e+13,171.842,2229.92,37531,185,172,32560,27520,17325,16280,23333
14548,621,800,10485,4063,2.31891e+13,227.209,2347.76,14548,757,125,13719,13325,12119,12868,13211
79045,94,317,56464,22581,2.80012e+13,173.029,3280.66,79045,260,175,67233,55293,32196,32771,45857
50589,182,265,36133,14456,2.79794e+13,172.416,2601.11,50589,208,175,50324,50324,45389,47898,50241
16366,202,203,11691,4675,2.7986e+13,168.983,1456.27,16366,146,133,16163,16163,16163,16163,16162
7360,136,187,5253,2107,2.80455e+13,163.002,970.564,7360,119,110,6709,5511,4965,5274,5739
53444,241,270,38184,15260,2.79785e+13,172.538,2675.95,53444,214,175,53174,53174,51895,52522,53145
74373,275,800,53211,21162,2.70681e+13,220.673,4143.41,74373,786,180,73176,72645,69265,70628,71930
52307,22,269,37359,14948,2.80268e+13,172.411,2647.19,52307,211,175,32719,23272,8909,5506,8428
30505,18,229,21793,8712,2.80352e+13,171.394,2004.33,30505,172,159,17697,12581,5143,4532,3632
50822,183,266,36301,14521,2.79923e+13,172.469,2607.9,50822,209,175,50556,50556,45664,48150,50473
47496,191,260,33930,13566,2.80168e+13,172.304,2518.07,47496,203,175,47236,47236,43281,45284,47167
21177,49,212,15135,6042,2.79775e+13,170.428,1662.27,21177,156,142,16088,13037,4989,4882,6926
46561,166,259,33252,13309,2.80443e+13,172.207,2493.03,46561,201,175,45555,35909,40835,43627,44000
57261,218,278,40897,16364,2.80216e+13,172.625,2774.63,57261,221,175,56983,56983,53636,55326,56923
89925,709,800,64323,25602,2.7225e+13,241.269,4458.73,89925,767,180,89125,88944,87465,88198,88853
73650,266,307,52607,21043,2.80202e+13,172.904,3161.75,73650,250,175,73343,73343,71292,72315,73302
61449,308,800,43981,17468,2.6845e+13,212.922,3854.69,61449,798,175,60261,59745,54760,57064,59139
48744,24,262,34821,13923,2.79957e+13,172.422,2551.92,48744,205,175,31353,22992,8278,7741,6314
59527,43,282,42524,17003,2.8024e+13,172.719,2830.97,59527,225,175,44304,35078,12944,12956,17629
44919,164,255,32085,12834,2.79973e+13,172.233,2446.22,44919,198,175,43795,34395,39351,40160,42293
93024,176,342,66451,26573,2.80011e+13,173.146,3571.69,93024,285,175,92682,92682,82110,87519,92516
88069,608,800,62996,25073,2.722e+13,253.681,4422.83,88069,659,175,87269,86975,86944,86785,86695
71653,42,304,51182,20471,2.80033e+13,172.954,3117.47,71653,247,175,53079,41958,15453,14375,20207
77743,557,800,55622,22121,2.71082e+13,222.398,4214.42,77743,798,175,76773,76406,69784,73148,76214
10155,48,192,7255,2900,2.79516e+13,165.835,1142.05,10155,129,120,7677,6200,2383,1872,3164
99089,332,941,70847,28242,2.74026e+13,234.159,4815.75,99089,812,192,97721,97176,87935,82960,90741
70282,241,301,50206,20076,2.80007e+13,172.883,3085.7,70282,244,175,69981,69981,66611,68314,69921
20179,156,211,14406,5773,2.80705e+13,169.981,1622.24,20179,153,140,19303,15320,17118,18152,17958
10525,23,193,7518,3007,2.80259e+13,166.562,1163.89,10525,131,122,6667,4868,1809,1325,1838
71939,260,304,51383,20556,2.80114e+13,172.873,3123.31,71939,247,175,71635,71635,69393,70514,71591
32733,190,233,23380,9353,2.79894e+13,171.616,2078.27,32733,176,162,32500,32500,30285,31394,32457
67571,581,800,48354,19217,2.698e+13,220.422,3995.03,67571,777,180,66689,66289,64085,65204,66114
20513,205,211,14650,5863,2.80046e+13,170.188,1635.52,20513,154,140,20302,20302,20250,20268,20296
5294,104,183,3789,1505,2.77656e+13,159.209,820.859,5294,110,103,4511,3853,2465,2321,3173
47448,126,259,33895,13553,2.79799e+13,172.345,2516.04,47448,203,175,43042,35654,29156,25012,35040
46718,217,259,33370,13348,2.80072e+13,172.385,2497.17,46718,202,175,46459,46459,44355,45406,46417
20080,42,210,14342,5738,2.79914e+13,169.959,1617.11,20080,153,140,14856,11754,4336,3056,5292
95042,215,346,67889,27153,2.79947e+13,173.187,3612.6,95042,289,175,94696,94696,86544,90706,94565
90466,169,338,64616,25850,2.80147e+13,173.165,3520.83,90466,281,175,89156,69961,79422,84910,87115
8450,74,189,6034,2416,2.79265e+13,164.649,1040.76,8450,123,114,6831,5629,2762,3114,4001
61965,258,286,44260,17705,2.80121e+13,172.714,2890.15,61965,229,175,61679,61679,60525,61086,61651
63294,9,289,45207,18087,2.80111e+13,172.821,2922.78,63294,232,175,27693,13384,7898,5034,5386
12127,7,196,8661,3466,2.80158e+13,167.58,1251.24,12127,137,126,4693,1888,1316,742,481
40437,244,247,28887,11550,2.80016e+13,172.07,2317.26,40437,191,175,40190,40190,40176,40179,40187
10337,60,306,7367,2970,2.87806e+13,159.207,1290.83,10337,129,133,8119,6702,2240,1926,1806
15393,82,202,10999,4394,2.80261e+13,168.691,1412.35,15393,145,132,12707,10698,5441,5434,7818
57696,234,418,41193,16503,2.81567e+13,172.813,2965.51,57696,220,192,57278,57157,41108,31163,52120
62751,279,287,44828,17923,2.79843e+13,172.735,2908.61,62751,230,175,62464,62464,62372,62409,62456
1445,73,177,1037,408,2.75728e+13,121.163,426.286,1445,66,69,1099,935,493,499,680
37124,231,241,26523,10601,2.8005e+13,171.932,2217.49,37124,185,171,36883,36883,36738,36800,36873
48377,77,262,34557,13820,2.80363e+13,172.423,2542.77,48377,205,175,39658,33038,16271,12210,22588
38894,58,245,27783,11111,2.80084e+13,172.082,2272.13,38894,188,174,30469,24946,10208,7489,13828
7918,115,314,5632,2286,2.88595e+13,153.708,1151.82,7918,126,109,6896,5865,4005,3698,4992
66190,12,293,47273,18917,2.80109e+13,172.704,2989.96,66190,236,175,32673,20711,9822,6116,5200
16306,54,204,11647,4659,2.80026e+13,169.401,1455.07,16306,147,133,12591,10324,4034,3952,5716
36209,192,239,25861,10348,2.79816e+13,171.758,2188.46,36209,182,169,35970,35970,33485,34732,35923
87298,391,800,62443,24855,2.71927e+13,237.838,4407.47,87298,798,175,86128,85547,76322,81212,85207
54172,39,272,38696,15476,2.8008e+13,172.542,2695.55,54172,215,175,39544,30947,11461,12659,14460
13914,50,199,9941,3973,2.79897e+13,168.282,1341.4,13914,142,128,10601,8589,3340,3937,4636
6341,242,245,4517,1824,2.84433e+13,156.654,964.773,6341,118,105,6096,6096,6096,6096,6095
39931,196,800,28570,11361,2.69955e+13,196.243,3049.86,39931,522,173,39115,38956,33739,24904,765
50182,170,265,35840,14342,2.80212e+13,172.454,2591.11,50182,208,175,49472,38879,44214,47126,48485
46940,453,800,33620,13320,2.6513e+13,210.672,3490.62,46940,798,175,45908,45262,41442,43563,45099
73038,472,800,52266,20772,2.70366e+13,215.604,4114.74,73038,798,180,72020,71710,67247,69492,71254
55462,134,274,39614,15848,2.79937e+13,172.565,2728.19,55462,217,175,51140,41785,36687,34428,43311
44275,64,800,31710,12565,2.64457e+13,210.395,3417.93,44275,772,175,34567,28799,11829,13412,17167
32666,32,233,23335,9331,2.79994e+13,171.564,2075.95,32666,176,163,22599,17121,5987,4254,6938
29818,12,228,21305,8513,2.79916e+13,171.459,1981.31,29818,171,158,14706,9319,4413,3064,1802
59462,203,282,42474,16988,2.80049e+13,172.734,2829.49,59462,225,175,59180,59180,54560,56906,59101
93275,152,343,66627,26648,2.80163e+13,173.172,3577.51,93275,286,175,89091,70626,74821,80189,82226
38797,142,244,27712,11085,2.80022e+13,171.956,2268.19,38797,187,173,36309,29289,28353,30032,31961
2843,12,179,2037,806,2.77837e+13,147.216,600.724,2843,92,83,1390,877,421,292,197
57882,28,279,41343,16539,2.80201e+13,172.611,2789.89,57882,222,175,38812,29094,9860,6931,10804
75882,42,311,54205,21677,2.80031e+13,172.983,3211.32,75882,254,175,56220,44444,16335,16352,22060
38488,191,243,27490,10998,2.79856e+13,171.92,2258.42,38488,186,173,38245,38245,35416,36842,38193
17484,108,205,12488,4996,2.80165e+13,169.221,1506.33,17484,148,135,15257,12810,8575,9733,11324
76742,404,800,54902,21840,2.71169e+13,218.307,4193.63,76742,798,180,75659,75009,70931,73178,74754
51479,162,267,36772,14707,2.80071e+13,172.448,2624.99,51479,210,175,50029,39427,45012,48191,47924
31204,735,800,22377,8827,2.57647e+13,208.964,3021.4,31204,769,155,30404,30241,28776,29481,30210
87925,125,483,62778,25147,2.81148e+13,173.273,3662.2,87925,284,192,79655,66103,47820,39101,61902
71695,168,304,51211,20484,2.80223e+13,172.935,3118.29,71695,247,175,70495,55304,62948,67272,69190
81688,305,321,58347,23341,2.80036e+13,172.999,3336.75,81688,264,175,81367,81367,80979,81150,81351
85333,21,328,60952,24381,2.8002e+13,173.099,3414.22,85333,271,175,52600,37482,14504,10334,13630
60769,72,283,43410,17359,2.79957e+13,172.688,2860.23,60769,227,175,49271,40534,18955,27348,27806
90609,428,800,64810,25799,2.72277e+13,234.131,4471.95,90609,780,180,89571,88852,86314,87773,88693
52981,132,270,37845,15136,2.79864e+13,172.528,2664.73,52981,213,175,48645,39908,33917,32206,40591
73896,179,308,52782,21114,2.80127e+13,172.972,3168,73896,251,175,73588,73588,65549,69654,73459
43356,215,253,30971,12385,2.80292e+13,172.206,2402.81,43356,196,175,43103,43103,41266,42178,43065
99136,53,494,70787,28349,2.80884e+13,173.332,3877.81,99136,295,192,76595,62950,23096,25050,33329
36667,164,240,26189,10478,2.79969e+13,171.842,2202.96,36667,183,170,35722,28072,32125,30724,34463
55862,274,275,39901,15961,2.80075e+13,172.592,2738.71,55862,218,175,55587,55587,55587,55587,55586
17870,171,206,12764,5106,2.79706e+13,169.564,1523.85,17870,149,136,17544,13813,16014,16839,17280
90492,242,338,64635,25857,2.80129e+13,173.157,3521.38,90492,281,175,90154,90154,84354,87308,90058
65335,29,800,46756,18579,2.69422e+13,213.55,3945.02,65335,798,175,43753,33277,10974,7745,11873
44823,77,800,32112,12711,2.64239e+13,223.177,3433.26,44823,786,175,35997,30138,14588,14414,20333
22375,213,215,15982,6393,2.80717e+13,170.525,1710.39,22375,158,144,22160,22160,22156,22156,22158
84540,146,327,60388,24152,2.79948e+13,173.091,3397.9,84540,270,175,79816,64006,63839,62328,71412
53865,216,271,38481,15384,2.79977e+13,172.612,2687.31,53865,215,175,53594,53594,50546,52083,53539
57263,74,420,40883,16380,2.81581e+13,172.881,2958.78,57263,220,192,46617,38365,17024,12155,24197
89189,286,800,63796,25393,2.7216e+13,221.438,4444.5,89189,798,180,87963,87434,81373,84151,86723
17535,19,205,12524,5011,2.79752e+13,169.319,1508.9,17535,148,135,10391,7414,2991,2808,2163
73124,166,307,52231,20893,2.80138e+13,172.941,3150.83,73124,250,175,71638,56409,64096,68565,69048
87302,183,332,62360,24942,2.80107e+13,173.112,3455.49,87302,275,175,86970,86970,77555,82368,86821
24694,100,219,17644,7050,2.7984e+13,170.902,1798.76,24694,162,149,21206,17913,11044,10265,14820
97277,11,350,69481,27796,2.7997e+13,173.211,3656.74,97277,293,175,46254,28483,14241,8258,7152
30054,78,228,21467,8587,2.79686e+13,171.333,1988.61,30054,171,158,24666,20577,10121,9663,14024
42002,190,250,29997,12005,2.80176e+13,172.063,2363.11,42002,192,175,41752,41752,38374,40083,41692
2643,114,178,1893,750,2.7328e+13,144.634,577.586,2643,88,82,2237,1922,1387,1353,1769
54489,50,272,38921,15568,2.80053e+13,172.516,2703.09,54489,215,175,41639,33692,13021,16940,18847
71689,106,303,51203,20486,2.80129e+13,172.825,3116.93,71689,246,175,62539,52607,34281,39440,46156
51065,341,800,36563,14502,2.66405e+13,218.678,3599.72,51065,753,180,49959,49379,47845,48422,48888
12763,167,197,9116,3647,2.79766e+13,167.896,1283.93,12763,139,126,12398,9805,11332,11945,11993
90332,386,480,64501,25831,2.81029e+13,173.263,3705.12,90332,279,192,89852,89852,84385,87167,89758
51217,312,409,36561,14656,2.81778e+13,172.709,2802.9,51217,208,192,50808,50795,46928,45072,49832
21319,64,213,15230,6089,2.80488e+13,170.368,1668.65,21319,156,142,16935,14048,5872,5592,8646
77047,104,313,55027,22020,2.80184e+13,172.927,3236.8,77047,256,175,66936,56535,35580,41827,48986
94284,38,344,67346,26938,2.80062e+13,173.158,3596.81,94284,287,175,68337,53524,19612,24549,25640
8033,97,188,5737,2296,2.79917e+13,164.001,1014.2,8033,121,112,6815,5795,3438,4148,4765
61959,219,286,44261,17698,2.80034e+13,172.718,2889.91,61959,229,175,61673,61673,57827,59775,61606
91518,245,482,65349,26169,2.80957e+13,173.298,3729.01,91518,296,191,91036,90915,80596,77833,87404
29763,154,228,21263,8500,2.80244e+13,171.35,1979.34,29763,171,158,28443,22507,25022,25514,26258
30914,182,230,22086,8828,2.8024e+13,171.376,2017.98,30914,173,160,30684,30684,28157,29425,30636
65810,136,438,46992,18818,2.81104e+13,173.011,3169.49,65810,235,194,60852,49599,31956,21301,45971
80446,292,319,57465,22981,2.79949e+13,173.001,3310.33,80446,262,175,80127,80127,78993,79547,80100
32706,164,233,23361,9345,2.80297e+13,171.598,2077.24,32706,176,163,31842,25029,28656,27409,30607
36882,124,241,26345,10537,2.80284e+13,171.926,2210.43,36882,184,170,33323,27566,22430,19762,26646
85236,33,328,60880,24356,2.80041e+13,173.083,3412.21,85236,271,175,59469,45455,15728,11862,19380
77762,28,800,55630,22132,2.7107e+13,225.305,4214.78,77762,780,180,51749,39064,13077,11440,16440
55806,51,800,39949,15857,2.6759e+13,212.977,3719.05,55806,798,175,42174,34290,13394,15628,18495
18580,65,207,13273,5307,2.80007e+13,169.637,1553.95,18580,150,137,14799,12249,5176,8122,7773
48506,258,261,34649,13857,2.79734e+13,172.366,2544.96,48506,205,175,48245,48245,48233,48235,48242
42215,84,250,30154,12061,2.79896e+13,172.114,2368.96,42215,193,175,35124,29365,14998,14943,21781
60292,310,800,43161,17131,2.68253e+13,211.639,3827.47,60292,796,175,59121,58590,54630,56399,58006
33916,49,235,24232,9684,2.79845e+13,171.749,2116.42,33916,179,165,25802,20889,7985,7615,10750
55191,328,944,39467,15724,2.72892e+13,218.946,3708.83,55191,445,192,54247,53925,48773,47370,52682
62711,217,288,44787,17924,2.80201e+13,172.69,2908.74,62711,230,175,62423,62423,58320,60399,62352
60093,152,283,42918,17175,2.80154e+13,172.583,2844.56,60093,225,175,57349,45498,48174,51631,52480
23940,76,217,17100,6840,2.80069e+13,170.735,1769.73,23940,160,147,19551,16251,7989,8806,11637
74672,113,309,53334,21338,2.80081e+13,172.95,3184.62,74672,252,175,66102,55323,38879,35135,49418
59346,185,282,42380,16966,2.80312e+13,172.627,2826.72,59346,224,175,59064,59064,53203,56188,58967
4558,163,183,3256,1302,2.79864e+13,157.328,762.465,4558,107,98,4291,3439,3968,4160,4137
70804,36,302,50575,20229,2.8005e+13,172.905,3097.69,70804,245,175,50545,40064,13712,16036,18093
77160,252,314,55118,22042,2.80193e+13,173.003,3240.18,77160,257,175,76846,76846,73371,75125,76784
28760,217,226,20544,8216,2.80031e+13,171.295,1944.75,28760,169,155,28534,28534,28419,28466,28525
12086,131,196,8632,3454,2.8041e+13,167.555,1248.92,12086,137,125,10987,9073,7614,7214,9251
35130,497,944,25160,9970,2.62638e+13,210.127,3331.78,35130,763,181,34032,33727,31904,32326,32845
97642,10,351,69745,27897,2.80048e+13,173.229,3664.37,97642,294,175,44666,24180,13419,7941,9162
46254,92,257,33041,13213,2.79777e+13,172.298,2483.17,46254,200,175,39147,32264,18200,18949,25886
29135,56,226,20813,8322,2.79567e+13,171.281,1956.86,29135,170,156,22688,18627,7344,9388,10913
34150,213,236,24391,9759,2.80155e+13,171.691,2124.31,34150,179,165,33914,33914,33064,33469,33891
67749,324,951,48458,19291,2.71126e+13,224.123,4192.8,67749,772,192,66466,65870,62434,59000,63189
74618,306,309,53304,21314,2.8002e+13,172.976,3183.67,74618,252,175,74309,74309,74302,74303,74306
36331,57,240,25954,10377,2.79922e+13,171.845,2193.13,36331,183,170,28384,23236,9240,8098,12789
13986,156,199,9985,4001,2.80473e+13,168.18,1344.97,13986,142,129,13335,10606,11839,12548,12421
77548,20,800,55471,22077,2.71165e+13,222.362,4210.27,77548,787,180,46721,33406,13011,8161,10589
42627,48,251,30444,12183,2.80032e+13,172.188,2381.28,42627,194,175,32329,26037,9901,11881,13801
45799,57,257,32717,13082,2.80158e+13,172.298,2471.41,45799,200,175,35803,29294,11644,10620,16561
74306,202,309,53081,21225,2.8004e+13,172.999,3177.28,74306,252,175,73997,73997,67473,70799,73890
8429,35,189,6030,2399,2.78624e+13,165.034,1040.04,8429,125,114,5942,4731,1648,1546,1985
75265,609,800,53844,21421,2.70804e+13,224.288,4162.1,75265,798,175,74343,73943,67191,70634,73892
37216,222,241,26591,10625,2.79887e+13,171.965,2220.11,37216,185,171,36975,36975,36381,36656,36956
41554,442,800,29766,11788,2.63409e+13,210.774,3340.97,41554,795,174,40515,39885,36287,38294,39680
49715,174,264,35508,14207,2.80097e+13,172.43,2578.5,49715,207,175,49363,39404,44064,46804,49184
78807,143,316,56297,22510,2.79911e+13,173.008,3274.94,78807,259,175,74002,59529,58227,57671,65008
84593,785,800,60514,24079,2.71934e+13,221.923,4354.24,84593,798,175,83793,83574,80224,81573,83749
24740,656,800,17764,6976,2.51321e+13,213.388,2791.6,24740,776,144,23934,23748,21612,22697,23509
89541,100,336,63954,25587,2.80085e+13,173.106,3501.47,89541,279,175,77173,65063,40012,37615,54096
8876,86,190,6345,2531,2.80616e+13,165.055,1067.5,8876,125,115,7357,6174,3330,4271,4706
37220,146,242,26582,10638,2.80501e+13,171.802,2220.94,37220,184,171,35064,28161,28082,30939,31357
43528,112,253,31089,12439,2.80187e+13,172.174,2407.26,43528,196,175,38423,32157,22528,25271,29038
27675,201,224,19770,7905,2.79969e+13,171.121,1906.63,27675,168,154,27451,27451,26582,26997,27428
22081,201,214,15772,6309,2.80055e+13,170.348,1698.23,22081,157,144,21867,21867,21654,21743,21854
43522,425,800,31178,12344,2.64212e+13,214.497,3396.95,43522,798,175,42456,41850,37517,39897,41597
76924,506,800,55042,21882,2.70802e+13,225.461,4197.12,76924,798,175,75896,75589,68243,71981,75242
1720,6,178,1227,493,2.84864e+13,127.258,466.117,1720,74,73,607,238,157,133,115
59821,116,282,42730,17091,2.80016e+13,172.662,2837.55,59821,225,175,53265,44318,31580,28490,40733
45219,218,256,32298,12921,2.80265e+13,172.303,2455.31,45219,199,175,44963,44963,43115,44034,44925
10969,35,194,7832,3137,2.80341e+13,167.004,1189.24,10969,133,124,7748,6171,2115,2001,2618
59077,194,281,42196,16881,2.80134e+13,172.632,2819.44,59077,224,175,58796,58796,53590,56238,58709
6921,63,186,4947,1974,2.78705e+13,162.306,939.992,6921,119,108,5443,4522,1949,1705,2713
92975,466,487,66386,26589,2.81036e+13,173.262,3760.56,92975,293,176,92488,92488,92269,92209,92431
94094,79,800,67303,26791,2.72592e+13,244.418,4538.72,94094,798,175,76771,64147,31321,31505,45001
65711,139,293,46939,18772,2.79986e+13,172.849,2979.84,65711,236,175,61192,49503,46883,46541,52680
98889,189,498,70617,28272,2.80831e+13,173.334,3878.07,98889,295,192,98384,98245,70980,60601,90154
69474,139,442,49594,19880,2.815e+13,173.003,3253.08,69474,257,181,64617,52366,45544,43755,54091
66135,342,800,47328,18807,2.69505e+13,214.013,3962.66,66135,795,180,64996,64422,60575,62351,63961
89833,260,337,64169,25664,2.80084e+13,173.176,3508.1,89833,280,175,89496,89496,85010,87286,89419
34387,85,236,24566,9821,2.79943e+13,171.615,2131.21,34387,179,166,28666,23979,12413,12321,17948
78914,97,316,56371,22543,2.79817e+13,173.012,3277.13,78914,260,175,67551,57193,33276,33431,46275
21052,126,212,15043,6009,2.79832e+13,170.33,1657.41,21052,156,142,19041,15795,12935,13091,15519
32798,107,234,23428,9370,2.80456e+13,171.572,2081.09,32798,177,163,28620,24047,15857,18090,21132
30186,126,229,21556,8630,2.80329e+13,171.377,1993.95,30186,172,158,27360,22666,18558,18797,22522
54060,233,272,38615,15445,2.80191e+13,172.566,2692.92,54060,215,175,53788,53788,51865,52824,53749
10578,143,193,7553,3025,2.79123e+13,166.525,1166.79,10578,131,122,9827,7957,7762,7708,8627
17876,97,206,12774,5102,2.79691e+13,169.779,1524.41,17876,150,136,15240,12926,7545,6435,10220
17381,55,205,12414,4967,2.79556e+13,169.323,1502.03,17381,148,135,13480,11047,4367,4740,6062
52281,86,268,37350,14931,2.79841e+13,172.513,2645.8,52281,211,175,43696,36469,19317,17813,26572
22552,779,800,16197,6355,2.4892e+13,215.215,2706.77,22552,774,139,21752,21594,19866,20727,21690
62920,345,437,44919,18001,2.81552e+13,172.966,3105.29,62920,230,195,62483,62483,57377,56308,61979
95634,335,800,68392,27242,2.72855e+13,240.93,4567.71,95634,776,180,94507,93867,91331,92362,93403
36452,112,240,26035,10417,2.80153e+13,171.876,2196.91,36452,183,170,32149,26918,18857,17133,24086
13661,5,199,9758,3903,2.80546e+13,168.331,1329.61,13661,142,129,4248,1504,914,790,387
74574,478,800,53355,21219,2.70594e+13,227.227,4147.49,74574,798,175,73516,73243,65657,69502,72808
96134,199,800,68752,27382,2.72813e+13,246.65,4576.94,96134,765,180,94757,94367,84439,88985,93249
87967,157,473,62815,25152,2.81126e+13,173.242,3651.93,87967,275,193,84684,66939,49898,36800,69672
88680,138,475,63322,25358,2.81057e+13,173.25,3667.84,88680,276,192,82409,66851,52800,45462,67415
84881,126,472,60612,24269,2.81112e+13,173.226,3592.25,84881,271,192,77018,63821,33065,17829,51374
82719,156,323,59082,23637,2.79984e+13,173.033,3358.76,82719,266,175,79592,62935,70493,69172,74443
59787,275,431,42682,17105,2.81398e+13,172.884,3028.4,59787,238,191,59356,59236,52894,51365,56720
49375,446,800,35359,14016,2.65856e+13,219.001,3555.68,49375,749,180,48376,47692,46641,47333,47513
64413,232,291,46004,18409,2.80273e+13,172.738,2949.36,64413,233,175,64122,64122,60832,62494,64063
43186,197,253,30847,12339,2.80156e+13,172.162,2398.25,43186,195,175,42933,42933,39884,41420,42877
45702,182,256,32641,13061,2.80138e+13,172.156,2467.61,45702,199,175,45446,45446,41124,43317,45372
20357,138,211,14536,5821,2.80256e+13,170.225,1629.69,20357,154,141,18850,15304,14194,13862,16201
1805,120,178,1289,516,2.85508e+13,130.272,477.662,1805,75,74,1517,1305,1027,1093,1220
87051,362,475,62159,24892,2.81043e+13,173.212,3636.62,87051,273,192,86576,86576,81474,79919,85298
89583,141,336,63988,25595,2.80063e+13,173.144,3502.29,89583,279,175,83779,67666,64597,72170,73066
5557,85,184,3970,1587,2.79469e+13,159.593,841.672,5557,110,104,4572,3853,2032,2083,2865
71166,747,800,50921,20245,2.70178e+13,229.299,4074.39,71166,798,175,70366,70125,63208,66805,70208
15279,14,202,10911,4368,2.80603e+13,168.68,1407.2,15279,145,131,8059,5501,2328,1160,1141
80407,178,319,57438,22969,2.79997e+13,172.973,3309.35,80407,262,175,80088,80088,71210,75748,79947
60723,20,283,43380,17343,2.79891e+13,172.719,2859.18,60723,227,175,36766,26010,10314,9769,7553
17385,126,205,12421,4964,2.79572e+13,169.369,1502.43,17385,148,135,15723,13043,10685,8830,12801
47569,67,260,33978,13591,2.80123e+13,172.353,2520.05,47569,203,175,38131,31457,13873,12080,19750
9229,42,190,6590,2639,2.798e+13,165.094,1088.05,9229,126,116,6813,5401,2003,2496,2709
47878,246,261,34203,13675,2.80257e+13,172.419,2529.19,47878,204,175,47617,47617,47312,47444,47602
54839,31,273,39173,15666,2.79959e+13,172.607,2712.64,54839,217,175,37653,28549,9813,7039,10938
71626,237,304,51155,20471,2.80179e+13,172.814,3116.58,71626,246,175,71322,71322,67482,69426,71255
62762,58,287,44825,17937,2.80108e+13,172.678,2908.72,62762,230,175,49234,40285,15990,26437,24610
10137,13,192,7242,2895,2.79735e+13,166.399,1141.89,10137,130,120,5176,3489,1524,877,1112
59786,357,800,42793,16993,2.68475e+13,216.789,3815.67,59786,798,175,58636,58084,52476,55226,57657
31456,34,230,22478,8978,2.79753e+13,171.585,2035.58,31456,174,161,22096,17672,5936,6472,6353
8796,49,190,6281,2515,2.80126e+13,165.065,1062.57,8796,125,115,6659,5412,2071,2004,2729
21243,151,298,15157,6086,2.82153e+13,167.473,1768.02,21243,159,141,20082,16075,16550,17769,18212
1321,57,176,946,375,2.69659e+13,113.007,405.805,1321,67,62,984,831,371,390,484
1777,62,177,1269,508,2.87631e+13,128.371,472.8,1777,76,77,1358,1142,542,772,726
99913,294,499,71347,28566,2.80855e+13,173.302,3897.35,99913,296,193,99414,99296,88327,83188,92982
17204,174,205,12289,4915,2.79732e+13,169.395,1494.91,17204,148,134,16970,13597,15596,16287,16893
44330,132,254,31660,12670,2.80073e+13,172.218,2429.65,44330,197,175,40722,33390,28353,28373,34125
46177,184,258,32977,13200,2.80336e+13,172.245,2482.07,46177,200,175,45919,45919,41609,43796,45845
98689,52,494,70470,28219,2.81072e+13,173.279,3869.54,98689,294,193,75994,61614,21497,14871,29477
97262,9,350,69471,27791,2.80072e+13,173.216,3656.62,97262,293,175,42549,20572,12130,8623,9749
93513,158,800,66891,26622,2.72509e+13,257.486,4527.84,93513,643,175,89455,70811,79934,81354,83002
81498,296,321,58221,23277,2.79911e+13,173.068,3333.2,81498,265,175,81177,81177,80173,80657,81152
54018,166,271,38586,15432,2.79913e+13,172.535,2690.82,54018,214,175,52891,41664,47407,45306,51143
16174,21,204,11557,4617,2.80221e+13,169.363,1449.58,16174,147,133,9953,7103,2754,1674,2445
70864,65,302,50619,20245,2.80012e+13,172.912,3098.98,70864,245,175,56572,46752,19566,15412,28030
40849,208,248,29179,11670,2.80088e+13,172.098,2329.56,40849,191,175,40601,40601,38596,39596,40561
10875,23,193,7773,3102,2.79138e+13,166.75,1182.93,10875,132,122,6883,5016,1859,1807,1519
13211,176,198,9432,3779,2.80403e+13,168.109,1306.72,13211,141,128,13013,13013,12252,12612,12991
32509,129,232,23225,9284,2.79613e+13,171.602,2070.22,32509,176,163,29626,24473,20330,17902,24489
20147,55,210,14396,5751,2.79612e+13,170.01,1619.82,20147,153,140,15630,12805,5060,5490,7149
51010,237,266,36433,14577,2.79997e+13,172.463,2612.53,51010,209,175,50744,50744,49494,50106,50715
11583,57,195,8276,3307,2.80309e+13,167.257,1221.95,11583,135,124,9014,7401,3072,3450,4296
90281,103,337,64485,25796,2.80004e+13,173.131,3516.33,90281,280,175,78291,66246,40816,38084,55803
22803,45,215,16294,6509,2.79954e+13,170.688,1726.49,22803,159,145,17085,13588,5090,3774,6534
70421,56,302,50298,20123,2.80114e+13,172.928,3089.55,70421,245,175,54909,45055,17712,13152,24432
9571,86,191,6834,2737,2.79947e+13,165.613,1108.34,9571,127,118,7947,6655,3567,3490,4996
10171,122,192,7262,2909,2.78939e+13,166.3,1143.53,10171,129,120,9092,7557,5901,5332,7226
17833,41,206,12743,5090,2.79497e+13,169.795,1522.79,17833,150,136,13116,10328,3753,2659,4564
93301,111,342,66648,26653,2.79874e+13,173.165,3576.96,93301,286,175,82233,68802,47745,45085,61639
11716,126,195,8368,3348,2.7965e+13,167.247,1228.88,11716,135,125,10561,8776,7193,5964,8544
58042,78,417,41437,16605,2.81635e+13,172.736,2972.95,58042,221,192,47692,39830,15612,10392,22104
60897,248,800,43591,17306,2.68756e+13,212.778,3841.95,60897,798,175,59652,59193,54311,56414,58349
33175,124,234,23697,9478,2.80027e+13,171.628,2092.69,33175,177,163,29980,24797,20185,17774,23960
6235,551,800,4532,1703,1.872e+13,179.305,1718.6,6235,527,96,5435,5315,5203,4908,5069
49988,146,264,35711,14277,2.79834e+13,172.47,2585.4,49988,208,175,47155,37831,37716,39514,42359
68422,259,297,48870,19552,2.80067e+13,172.778,3042.13,68422,240,175,68125,68125,66248,67184,68087
17600,15,206,12571,5029,2.80318e+13,169.637,1512.66,17600,149,135,9538,6590,2776,2077,2370
89036,158,335,63598,25438,2.8006e+13,173.114,3491.08,89036,278,175,85998,68060,77820,83421,80885
89659,104,800,64141,25518,2.72084e+13,227.608,4453.59,89659,793,180,77063,65174,40531,39299,53700
56896,49,276,40648,16248,2.79934e+13,172.623,2764.12,56896,220,175,43320,35065,13390,16439,19116
25857,77,221,18471,7386,2.80106e+13,171.056,1841.76,25857,164,150,21166,17641,8689,6176,11750
58558,146,280,41825,16733,2.80116e+13,172.672,2806.74,58558,223,175,55262,44324,44190,46309,49508
93301,294,343,66643,26658,2.80176e+13,173.168,3577.98,93301,286,175,92958,92958,90367,91666,92909
27195,72,223,19419,7776,2.80096e+13,171.121,1889.36,27195,166,153,22019,18120,8479,8986,12290
20696,100,212,14783,5913,2.80087e+13,170.314,1643.58,20696,155,141,17764,15008,9233,7591,12262
94805,185,345,67716,27089,2.80098e+13,173.125,3607.17,94805,288,175,94460,94460,84296,89495,94300
77623,116,314,55444,22179,2.7999e+13,172.958,3249.22,77623,257,175,69118,57517,40997,39218,53754
77309,261,800,55307,22002,2.7102e+13,237.184,4205.28,77309,751,180,76090,75576,72310,73547,74802
46619,157,258,33295,13324,2.80185e+13,172.25,2493.7,46619,201,175,44870,35450,40685,42197,41982
12354,103,196,8821,3533,2.79113e+13,167.548,1262.25,12354,137,126,10652,9037,5626,5605,7519
6297,58,186,4491,1806,2.82407e+13,160.99,897.649,6297,115,107,4893,4039,1704,1981,2394
18558,189,208,13255,5303,2.80034e+13,169.992,1554.53,18558,151,137,18350,18350,17809,18055,18331
14920,78,201,10657,4263,2.79899e+13,168.687,1390.24,14920,144,131,12211,10204,5042,4820,7110
97264,53,350,69480,27784,2.79979e+13,173.216,3656.6,97264,293,175,75136,61711,23767,32014,35618
46020,187,258,32867,13153,2.80374e+13,172.217,2478.12,46020,200,175,45762,45762,41676,43744,45691
12175,186,196,8699,3476,2.79864e+13,167.534,1253.31,12175,137,125,11979,11979,11837,11898,11969
41490,12,250,29634,11856,2.80104e+13,172.068,2349.19,41490,192,175,20474,12979,6160,3613,3065
77264,238,314,55192,22072,2.80125e+13,173,3242.19,77264,257,175,76950,76950,72527,74769,76874
83478,63,325,59626,23852,2.80086e+13,173.068,3375.48,83478,268,175,66360,54768,22842,20408,33243
98508,229,800,70458,28050,2.72841e+13,225.205,4621,98508,798,180,97187,96737,88604,92288,95765
20598,26,211,14718,5880,2.79847e+13,170.251,1638.81,20598,155,141,13572,9973,3506,2353,3604
80196,33,469,57252,22944,2.81189e+13,173.109,3499.06,80196,276,185,55978,42766,14830,11379,18345
55803,139,275,39858,15945,2.80094e+13,172.621,2737.42,55803,218,175,51964,42037,39791,38121,45087
19074,116,209,13625,5449,2.80579e+13,169.992,1576.58,19074,152,138,16910,14098,10059,9267,12977
79339,7507,8089,47289,32050,2.62835e+13,499.773,15522,79339,2447,458,71250,71250,70768,70746,68233
29149,99,226,20821,8328,2.79965e+13,171.214,1957.51,29149,169,156,25011,21109,12698,15193,17553
94379,444,487,67391,26988,2.80898e+13,173.31,3786.71,94379,290,192,93892,93892,91843,92868,93849
67511,295,296,48221,19290,2.80071e+13,172.84,3021.79,67511,239,175,67215,67215,67215,67215,67214
55623,67,275,39735,15888,2.80241e+13,172.63,2733.24,55623,218,175,44595,36788,16109,14928,23536
99031,480,800,70823,28208,2.73107e+13,252.637,4630.85,99031,757,180,98062,97662,96103,96874,97271
99159,67,353,70822,28337,2.79996e+13,173.18,3693.11,99159,296,175,79556,65612,28861,29274,40942
49428,70,264,35309,14119,2.80042e+13,172.484,2571.29,49428,207,175,39882,32865,14764,11741,21095
12888,134,198,9210,3678,2.79782e+13,168.258,1291.52,12888,141,127,11788,9666,8506,8922,10023
94397,384,480,67416,26981,2.80905e+13,173.308,3777.86,94397,287,192,93917,93917,88254,91138,93821
29936,46,228,21385,8551,2.79942e+13,171.414,1985.04,29936,171,157,22528,18063,6785,5053,8802
32108,29,232,22939,9169,2.80256e+13,171.53,2057.83,32108,175,162,21694,16369,5477,5928,5624
39403,13,951,28211,11192,2.64279e+13,207.967,3468.48,39403,778,179,20098,13908,5833,2307,3792
88253,162,333,63041,25212,2.79897e+13,173.11,3474.45,88253,276,175,85879,67622,77215,82713,81548
43512,9,253,31080,12432,2.80225e+13,172.235,2407.13,43512,196,175,19038,9206,5428,3463,3878
27420,147,224,19589,7831,2.79902e+13,171.24,1898.11,27420,167,154,25852,20727,20802,21687,23259
75340,240,450,53795,21545,2.81297e+13,173.08,3381.39,75340,252,192,74890,74769,61398,51587,68489
10654,93,194,7609,3045,2.80832e+13,166.624,1171.94,10654,133,122,8984,7428,4271,4426,6091
19214,85,209,13720,5494,2.80367e+13,169.814,1581.65,19214,152,138,15979,13382,6962,6883,9877
64890,277,291,46357,18533,2.79927e+13,172.759,2959.72,64890,234,175,64599,64599,64323,64444,64585
73416,303,307,52433,20983,2.80175e+13,172.867,3156.69,73416,249,175,73109,73109,73086,73092,73105
93328,222,342,66667,26661,2.79959e+13,173.173,3577.46,93328,286,175,92986,92986,85525,89335,92866
85267,199,328,60902,24365,2.79973e+13,173.081,3412.83,85267,271,175,84939,84939,76889,81001,84810
18817,51,208,13441,5376,2.80071e+13,169.874,1564.88,18817,151,137,14396,11656,4631,5357,6460
81986,184,322,58557,23429,2.8022e+13,172.997,3343.45,81986,265,175,81664,81664,73015,77435,81526
8052,91,188,5755,2297,2.78205e+13,164.106,1015.32,8052,122,112,6738,5601,3190,3279,4423
58406,108,280,41710,16696,2.80171e+13,172.587,2803.03,58406,222,175,51149,42851,28556,32444,37879
80728,783,800,57759,22969,2.71262e+13,222.132,4275.81,80728,798,175,79928,79706,75177,77056,79878
70073,762,800,50139,19934,2.70233e+13,224.659,4050.44,70073,771,180,69273,69116,67541,68313,69160
55364,53,274,39544,15820,2.80026e+13,172.59,2725.95,55364,217,175,42749,35125,13545,15929,19455
19842,187,210,14176,5666,2.79796e+13,170.003,1608.02,19842,153,140,19632,19632,18817,19204,19609
20386,171,211,14560,5826,2.80203e+13,170.03,1630.3,20386,154,140,20035,15768,18188,19185,19732
32976,53,234,23552,9424,2.80308e+13,171.62,2086.49,32976,177,163,25445,20913,8084,6006,10975
16848,173,205,12040,4808,2.79791e+13,169.607,1480.07,16848,148,134,16585,13184,15227,15924,16439
33379,97,234,23843,9536,2.7996e+13,171.502,2098.61,33379,177,164,28543,24180,14098,13546,19445
5492,168,184,3924,1568,2.79189e+13,158.932,836.854,5492,111,104,5252,4196,4986,5130,5084
89155,510,800,63769,25386,2.72217e+13,240.288,4443.65,89155,798,175,88099,87798,78289,83132,87485
26190,101,221,18702,7488,2.80255e+13,170.917,1853.1,26190,164,151,22570,19056,11776,13798,16040
33262,110,380,23737,9525,2.82679e+13,171.943,2280.12,33262,189,169,29150,24528,15614,16683,20856
43889,39,253,31353,12536,2.79935e+13,172.227,2417.12,43889,197,175,32029,25062,8982,11116,12480
89913,159,336,64229,25684,2.79944e+13,173.109,3508.4,89913,280,175,87013,68731,78592,80369,82138
85431,53,329,61017,24414,2.8021e+13,173.049,3416.9,85431,271,175,66000,54214,20903,22754,29643
57174,242,277,40838,16336,2.79952e+13,172.63,2771.54,57174,220,175,56897,56897,55219,56053,56862
74588,455,951,53341,21247,2.71826e+13,228.303,4341.71,74588,773,197,73436,72710,70783,71313,72127
12252,358,800,8840,3412,2.22826e+13,232.889,2223.54,12252,729,120,11171,10636,9666,10048,10126
98789,283,353,70561,28228,2.80147e+13,173.223,3686.76,98789,296,175,98436,98436,94398,96445,98366
40267,90,247,28762,11505,2.8008e+13,172.102,2312.69,40267,190,175,33950,28067,15705,15192,21998
16743,149,205,11962,4781,2.80032e+13,169.443,1475.2,16743,148,134,15784,12636,12862,13950,14391
8731,123,190,6232,2499,2.80759e+13,164.73,1058.47,8731,125,115,7791,6501,5236,5397,6314
57227,266,277,40875,16352,2.79865e+13,172.588,2772.63,57227,220,175,56950,56950,56781,56855,56939
15026,56,201,10734,4292,2.79986e+13,168.837,1395.22,15026,144,130,11672,9599,3789,3644,5292
61147,15,284,43676,17471,2.79861e+13,172.693,2869.64,61147,227,175,33154,22871,9613,7185,8791
20479,128,211,14631,5848,2.80237e+13,170.194,1634.21,20479,154,141,18582,15361,12723,12814,15259
11070,47,194,7906,3164,2.79817e+13,167.091,1194.61,11070,133,123,8329,6689,2542,1900,3263
76098,903,942,54424,21674,2.7202e+13,244.575,4364.49,76098,675,193,75156,75156,75065,74998,75040
13809,103,199,9864,3945,2.80191e+13,168.239,1336.57,13809,142,129,11906,10100,6269,5894,8478
21553,212,213,15392,6161,2.80121e+13,170.422,1677.55,21553,156,142,21340,21340,21340,21340,21339
72888,247,306,52064,20824,2.80176e+13,172.939,3145.05,72888,249,175,72582,72582,69307,70960,72523
31543,509,800,22616,8927,2.57914e+13,208.795,3032.46,31543,777,156,30589,30290,27786,29027,29870
47381,147,260,33843,13538,2.80046e+13,172.379,2515.3,47381,203,175,44769,35854,36004,37537,40274
5863,179,184,4195,1668,2.78086e+13,160.932,864.685,5863,113,105,5679,5679,5640,5652,5674
93353,177,343,66677,26676,2.80141e+13,173.104,3578.68,93353,285,175,93010,93010,82432,87845,92844
67179,124,295,47990,19189,2.79925e+13,172.801,3013.52,67179,238,175,60770,50260,40929,33228,49044
31815,79,232,22721,9094,2.80315e+13,171.42,2048.5,31815,174,161,26172,21844,10812,14854,15832
42040,638,800,30115,11925,2.63446e+13,208.323,3354.75,42040,776,175,41216,41041,38849,39960,40755
2294,128,178,1640,654,2.7742e+13,139.967,538.491,2294,83,79,1978,1685,1406,1242,1599
94269,281,344,67329,26940,2.79987e+13,173.148,3596.42,94269,287,175,93925,93925,90351,92159,93862
64817,106,441,46272,18545,2.81457e+13,172.941,3151.12,64817,234,192,56483,47569,26801,21760,37761
22317,118,214,15941,6376,2.7949e+13,170.473,1707.14,22317,157,144,19894,16508,12268,11390,15500
80677,101,320,57626,23051,2.80055e+13,172.975,3315.86,80677,263,175,69645,58769,36232,42472,49292
44461,191,254,31762,12699,2.79849e+13,172.27,2433.38,44461,198,175,44207,44207,40618,42433,44144
7841,107,188,5602,2239,2.79585e+13,163.911,1002.01,7841,121,112,6782,5720,3801,3554,4886
88906,373,477,63484,25422,2.80944e+13,173.272,3674.81,88906,277,194,88429,88429,82315,85441,87823
66596,142,294,47570,19026,2.80071e+13,172.782,2999.99,66596,237,175,62381,50301,48731,53874,54673
15361,83,202,10978,4383,2.80114e+13,169.089,1411.41,15361,145,131,12702,10652,5431,4696,7772
46547,95,800,33332,13215,2.65131e+13,214.841,3479.87,46547,755,179,38862,32122,18561,22484,25647
36419,220,240,26008,10411,2.80175e+13,171.896,2195.95,36419,183,170,36179,36179,35552,35842,36159
53973,394,414,38528,15445,2.81606e+13,172.756,2875.18,53973,229,180,53559,53559,53079,53296,53539
63335,274,289,45241,18094,2.80241e+13,172.806,2923.8,63335,232,175,63046,63046,62741,62873,63031
16606,60,204,11858,4748,2.80139e+13,169.195,1468.15,16606,147,134,13055,10671,4477,5560,6706
63497,489,800,45448,18049,2.69104e+13,233.541,3902.75,63497,798,175,62450,62185,54660,58486,61764
76421,484,800,54680,21741,2.70687e+13,219.761,4186.7,76421,792,180,75428,75087,71580,73337,74673
91877,865,943,65696,26181,2.7333e+13,222.054,4682.78,91877,813,192,90934,90889,87834,84694,88648
34218,94,236,24443,9775,2.79803e+13,171.742,2126.36,34218,179,166,29052,23923,13836,14209,19549
15119,70,202,10791,4328,2.81151e+13,168.675,1400.22,15119,144,131,12161,10048,4581,5043,6724
4035,8,182,2886,1149,2.7915e+13,155.856,717.882,4035,103,94,1676,756,462,254,164
84267,140,326,60194,24073,2.7992e+13,173.044,3391.6,84267,269,175,78677,63507,60449,60462,68101
38441,174,244,27452,10989,2.80382e+13,171.973,2258.2,38441,187,173,38129,30455,34170,36210,37909
72805,429,445,51983,20822,2.8119e+13,173.026,3324.04,72805,251,192,72360,72360,72064,72202,72344
63335,198,289,45241,18094,2.80041e+13,172.81,2923.71,63335,232,175,63046,63046,57610,60376,62955
48299,133,261,34497,13802,2.79854e+13,172.359,2539.62,48299,204,175,44446,36383,31268,29886,37184
52708,85,270,37638,15070,2.8038e+13,172.431,2658.07,52708,212,175,43978,36776,19036,25290,27769
93388,70,343,66706,26682,2.80096e+13,173.166,3579.48,93388,286,175,75428,62122,27880,25712,41244
39896,88,246,28491,11405,2.80073e+13,172.026,2301.08,39896,189,175,33485,27815,15312,14691,21458
47065,232,259,33620,13445,2.80072e+13,172.307,2506.03,47065,202,175,46806,46806,45688,46230,46779
30965,43,230,22118,8847,2.80097e+13,171.501,2019.83,30965,173,159,23028,18239,6897,8244,9343
15447,195,202,11032,4415,2.80194e+13,168.822,1414.98,15447,145,131,15245,15245,15174,15201,15238
62862,89,800,44944,17918,2.74377e+13,208.499,3609.5,62862,491,175,52532,43597,24030,17505,640
18979,164,208,13560,5419,2.79831e+13,169.968,1571.71,18979,152,138,18415,14500,16638,17719,17765
77095,86,313,55072,22023,2.79917e+13,173.003,3237.86,77095,257,175,64470,53784,28454,27638,40724
60198,273,283,43003,17195,2.80133e+13,172.662,2847.08,60198,226,175,59915,59915,59788,59837,59905
5090,88,183,3630,1460,2.78557e+13,158.316,805.15,5090,107,102,4219,3528,1986,2050,2773
21080,80,212,15056,6024,2.79994e+13,170.247,1658.13,21080,155,142,17357,14608,7220,7331,10445
94244,213,494,67294,26950,2.81032e+13,173.283,3790.72,94244,286,192,93750,93627,77144,67999,87668
22586,82,215,16128,6458,2.80276e+13,170.367,1718.06,22586,157,144,18691,15704,7965,8581,11678
59740,112,282,42671,17069,2.80042e+13,172.71,2835.87,59740,225,175,52739,44142,30890,29438,39389
87916,43,333,62798,25118,2.80057e+13,173.108,3468.06,87916,276,175,65463,51807,19579,14954,25003
75621,257,311,54011,21610,2.80142e+13,172.904,3205.81,75621,253,175,75310,75310,72349,73841,75256
72481,164,305,51770,20711,2.8002e+13,172.929,3135.65,72481,248,175,70757,55526,63469,67931,67768
29967,122,228,21403,8564,2.80311e+13,171.409,1985.97,29967,171,158,26936,22336,17370,18435,21435
37237,57,242,26596,10641,2.80448e+13,171.842,2221.53,37237,185,171,29104,23822,9909,7778,13451
27969,145,225,19974,7995,2.804e+13,171.048,1917.25,27969,167,154,26274,21103,20932,23173,23288
54152,240,272,38680,15472,2.79975e+13,172.559,2695.06,54152,215,175,53880,53880,52451,53153,53848
7205,62,187,5150,2055,2.80037e+13,163.083,960.319,7205,119,109,5661,4656,1999,2821,2940
73832,688,800,52826,21006,2.70567e+13,226.459,4131.91,73832,798,175,72986,72771,65855,69391,72697
15396,98,202,10999,4397,2.80391e+13,169.066,1412.8,15396,145,131,13142,11124,6650,6302,9095
79503,84,318,56791,22712,2.80152e+13,173.002,3290.75,79503,261,175,66205,55325,28212,28092,40968
20147,153,210,14395,5752,2.79682e+13,170.007,1619.98,20147,153,140,19189,15228,16492,16744,17634
26988,59,222,19284,7704,2.79636e+13,171.111,1881.49,26988,166,153,21192,17302,7161,10285,10467
99774,340,354,71272,28502,2.79949e+13,173.236,3705.31,99774,298,175,99420,99420,99136,99260,99406
7931,124,189,5656,2275,2.82097e+13,163.733,1008.66,7931,122,113,7079,5896,4799,4923,5752
45833,169,257,32742,13091,2.79889e+13,172.327,2472.32,45833,200,175,45090,35418,40394,38527,44180
18789,100,208,13418,5371,2.80114e+13,169.916,1563.88,18789,151,137,16139,13622,8398,6914,11118
52160,320,410,37237,14923,2.81731e+13,172.737,2825.6,52160,216,192,51750,51750,48768,47865,50584
74876,44,309,53487,21389,2.79939e+13,172.94,3188.8,74876,252,175,56018,44259,16875,12856,21709
52983,570,800,37944,15039,2.66673e+13,220.307,3648.81,52983,798,175,52044,51691,46274,49022,51493
11210,9,194,8010,3200,2.79212e+13,166.86,1201.34,11210,133,124,4901,2367,1401,889,545
6554,79,186,4679,1875,2.80781e+13,162.138,915.426,6554,116,107,5328,4475,2231,1750,3078
33150,211,234,23682,9468,2.79941e+13,171.658,2091.97,33150,177,163,32916,32916,32063,32470,32893
29706,21,228,21220,8486,2.80308e+13,171.377,1977.58,29706,171,158,18304,13051,5070,3608,4975
63214,63,289,45150,18064,2.80177e+13,172.773,2920.95,63214,232,175,50233,41471,17290,14093,24897
49592,151,264,35419,14173,2.80252e+13,172.483,2575.44,49592,207,175,47216,37524,39121,41967,43345
62859,330,800,44988,17871,2.69058e+13,221.262,3887.89,62859,770,180,61733,61151,59014,59867,60649
12258,103,197,8750,3508,2.8107e+13,167.463,1258.54,12258,138,126,10549,8965,5600,6632,7528
31537,25,231,22526,9011,2.80017e+13,171.552,2039.05,31537,174,160,20562,14990,5373,4043,4443
18293,190,207,13062,5231,2.80244e+13,169.637,1542.45,18293,150,137,18086,18086,17680,17856,18069
20255,2,210,14470,5785,2.79303e+13,170.11,1624.33,20255,153,140,2704,509,438,1058,231
41721,130,249,29806,11915,2.79835e+13,172.064,2354.48,41721,192,175,38159,31426,26256,24022,31685
39773,145,246,28410,11363,2.79912e+13,172.056,2297.7,39773,189,175,37405,30017,29791,29228,33335
45955,226,257,32826,13129,2.80035e+13,172.31,2475.48,45955,200,175,45698,45698,44292,44986,45667
39958,231,246,28542,11416,2.7992e+13,172.046,2302.82,39958,189,175,39712,39712,39395,39534,39697
99605,671,941,71208,28397,2.74049e+13,225.486,4825.13,99605,810,182,98629,98429,93272,94359,97103
89070,330,335,63619,25451,2.80032e+13,173.131,3491.79,89070,278,175,88735,88735,88699,88710,88730
98397,114,352,70280,28117,2.80075e+13,173.206,3678.79,98397,295,175,87305,72913,51594,50551,66453
74241,227,308,53028,21213,2.79944e+13,172.942,3174.82,74241,251,175,73933,73933,69147,71578,73852
87486,53,475,62468,25018,2.81095e+13,173.196,3646.2,87486,274,192,67599,55567,19706,13643,27414
51959,182,268,37119,14840,2.80058e+13,172.512,2637.98,51959,211,175,51691,51691,46596,49186,51605
84144,68,326,60107,24037,2.80011e+13,173.088,3389.38,84144,270,175,67641,55819,24610,17987,34509
16627,30,204,11882,4745,2.79785e+13,169.363,1469.25,16627,148,134,11304,8559,2873,2176,3404
6696,130,187,4781,1915,2.81133e+13,162.018,926.017,6696,118,108,6014,5005,4209,4258,5041
63913,24,289,45654,18259,2.79844e+13,172.761,2936.42,63913,232,175,41121,30153,10854,10155,8301
89453,155,336,63894,25559,2.80156e+13,173.147,3499.98,89453,279,175,85917,68050,75921,80754,80289
61981,61,286,44266,17715,2.80117e+13,172.695,2890.31,61981,229,175,49014,40110,16753,26561,25325
44352,26,254,31679,12673,2.80315e+13,172.192,2430.38,44352,197,175,29260,21493,7556,8436,9361
57060,121,800,40851,16209,2.67681e+13,213.775,3749.74,57060,798,175,50403,41828,31243,33254,38731
57597,39,279,41142,16455,2.80121e+13,172.672,2783.49,57597,222,175,42041,32896,12182,8359,14228
14686,126,200,10494,4192,2.79277e+13,168.62,1378.34,14686,143,130,13261,11010,9020,7777,10713
22614,197,215,16149,6465,2.80303e+13,170.393,1718.92,22614,158,144,22399,22399,21885,22118,22381
41393,297,389,29551,11842,2.81915e+13,172.385,2525.32,41393,205,187,41004,40890,38790,37537,39448
58262,28,279,41618,16644,2.80041e+13,172.644,2798.72,58262,222,175,39064,29275,9921,10331,9914
23788,224,800,17079,6709,2.51081e+13,212.243,2755.53,23788,757,142,22563,22151,20207,20748,21256
36003,100,379,25700,10303,2.82354e+13,172.094,2361.34,36003,190,169,30937,26175,15766,18153,21393
49528,221,264,35374,14154,2.80245e+13,172.412,2573.69,49528,207,175,49264,49264,47062,48164,49221
26581,185,222,18987,7594,2.79998e+13,170.991,1867.37,26581,165,152,26359,26359,24565,25457,26322
17058,138,205,12181,4877,2.80393e+13,169.223,1488.27,17058,148,134,15773,12828,11898,12311,13600
11920,17,195,8520,3400,2.78997e+13,167.402,1239.49,11920,137,126,6756,4796,1999,961,1107
98280,701,800,70292,27988,2.72887e+13,224.633,4616.84,98280,798,180,97465,97237,91523,94435,97184
6981,75,186,4993,1988,2.78326e+13,162.66,944.294,6981,119,109,5628,4691,2340,2234,3255
32753,170,233,23401,9352,2.80024e+13,171.707,2078.96,32753,177,163,32231,25347,28964,30770,31652
93914,388,488,67052,26862,2.81105e+13,173.278,3779.09,93914,285,193,93426,93426,87589,90572,92833
81776,177,322,58409,23367,2.79976e+13,173.048,3339.43,81776,265,175,81454,81454,72344,77000,81309
36304,51,240,25931,10373,2.80209e+13,171.878,2192.69,36304,183,169,27815,22505,8930,6474,11493
22728,80,215,16231,6497,2.80073e+13,170.504,1723.46,22728,158,145,18721,15760,7815,8562,11469
29407,128,227,21003,8404,2.80478e+13,171.185,1966.69,29407,170,157,26738,22085,18275,18417,22030
61916,217,286,44228,17688,2.80024e+13,172.732,2888.97,61916,229,175,61630,61630,57685,59682,61561
48865,64,262,34909,13956,2.79868e+13,172.451,2555.24,48865,206,175,38898,32223,13798,15207,19942
11663,71,195,8332,3331,2.79834e+13,167.284,1226.26,11663,137,124,9382,7739,3583,2818,5100
54904,788,800,39306,15598,2.67293e+13,221.632,3696.64,54904,798,175,54104,53897,51757,52853,54069
8371,161,189,5985,2386,2.79544e+13,164.863,1036.43,8371,125,114,7987,6351,7249,7719,7603
88068,210,333,62898,25170,2.80197e+13,173.085,3470.88,88068,276,175,87735,87735,80106,84001,87612
95328,253,346,68091,27237,2.79979e+13,173.148,3617.67,95328,289,175,94982,94982,89367,92226,94889
24821,209,219,17726,7095,2.80225e+13,170.702,1803.2,24821,161,148,24602,24602,24460,24521,24592
1880,40,177,1346,534,2.74101e+13,133.377,487.258,1880,76,74,1343,1060,416,357,506
88598,306,334,63289,25309,2.80014e+13,173.08,3481.69,88598,277,175,88264,88264,87076,87655,88236
39449,96,246,28178,11271,2.80391e+13,171.995,2288.64,39449,189,175,33670,27649,16429,15876,23080
70177,240,301,50126,20051,2.80085e+13,172.866,3083.44,70177,244,175,69876,69876,66435,68176,69815
43400,235,253,31002,12398,2.80267e+13,172.238,2404.17,43400,196,175,43147,43147,42665,42878,43129
77558,31,314,55398,22160,2.79989e+13,172.995,3247.98,77558,257,175,53266,40383,13897,13472,18463
93966,69,839,67144,26822,2.77443e+13,254.975,4341.75,93966,314,192,75405,62217,25221,20617,36465
55289,229,274,39491,15798,2.80074e+13,172.592,2724.15,55289,217,175,55015,55015,52665,53843,54970
1825,55,177,1303,522,2.74656e+13,130.628,478.91,1825,78,75,1370,1145,484,521,638
19540,87,209,13963,5577,2.79651e+13,169.822,1594.67,19540,152,139,16329,13619,7459,7277,10384
40865,200,800,29287,11578,2.62785e+13,208.856,3321.23,40865,789,173,39588,39198,35480,36864,38186
15867,193,202,11332,4535,2.79343e+13,168.965,1433.73,15867,145,132,15665,15665,15550,15597,15656
65812,33,293,47010,18802,2.80049e+13,172.796,2982.01,65812,236,175,45910,35102,12160,9184,14821
3173,31,180,2266,907,2.82224e+13,149.777,635.041,3173,93,90,2159,1647,596,645,708
2099,31,178,1499,600,2.81738e+13,137.522,516.298,2099,78,78,1420,1087,401,351,450
14642,53,200,10464,4178,2.79442e+13,168.742,1376.6,14642,144,131,11263,9270,3610,3304,5026
88037,245,333,62879,25158,2.80072e+13,173.099,3470.43,88037,276,175,87704,87704,82452,85123,87616
8110,107,189,5790,2320,2.80206e+13,164.751,1020.05,8110,123,113,6999,5911,3911,3657,5072
24853,20,219,17750,7103,2.80147e+13,170.836,1804.34,24853,162,148,15044,10651,4219,2522,3548
72931,257,446,52075,20856,2.81245e+13,173.104,3327.98,72931,248,193,72485,72364,53741,47649,66429
24579,156,219,17561,7018,2.80061e+13,170.937,1794.7,24579,162,148,23543,18658,20881,22141,22013
79672,89,318,56912,22760,2.79982e+13,173.037,3294.3,79672,261,175,67069,55581,30971,23953,42072
95112,191,346,67938,27174,2.80067e+13,173.17,3613.87,95112,289,175,94766,94766,84979,89984,94611
44474,216,254,31773,12701,2.79862e+13,172.187,2433.36,44474,197,175,44220,44220,42346,43279,44182
2536,138,179,1805,731,2.83159e+13,141.077,565.588,2536,89,83,2246,1877,1745,1806,1974
58193,48,279,41567,16626,2.79986e+13,172.591,2796.91,58193,222,175,44159,35564,13506,10663,18087
59732,471,800,42763,16969,2.6827e+13,221.463,3814.57,59732,798,175,58687,58427,52204,55355,57945
60329,102,284,43092,17237,2.80132e+13,172.684,2851.18,60329,226,175,52161,44044,27211,32401,37387
20696,97,211,14788,5908,2.79611e+13,170.151,1642.28,20696,154,141,17668,14978,8749,8819,12002
74390,18,309,53131,21259,2.80197e+13,172.875,3178.75,74390,251,175,43176,30677,12529,7419,7667
53621,601,800,38392,15229,2.67019e+13,230.88,3664.97,53621,794,175,52699,52327,46129,49274,52224
23606,74,216,16864,6742,2.79796e+13,170.659,1756.67,23606,159,146,19185,15774,7669,8582,11212
43870,441,800,31423,12447,2.64234e+13,224.392,3406.45,43870,794,175,42806,42197,36941,39803,41992
95672,311,800,68424,27248,2.72821e+13,224.802,4568.35,95672,798,180,94479,93905,88427,90947,93303
86528,315,330,61803,24725,2.80107e+13,173.039,3438.69,86528,273,175,86198,86198,85877,86017,86183
28631,221,226,20452,8179,2.80309e+13,171.306,1940.51,28631,169,156,28405,28405,28369,28380,28400
76620,101,313,54724,21896,2.80183e+13,172.972,3228.23,76620,256,175,66169,55800,34370,32613,46692
80015,406,462,57131,22884,2.8128e+13,173.183,3487.69,80015,276,181,79553,79553,78016,77735,79155
40250,125,247,28747,11503,2.80233e+13,171.991,2311.89,40250,190,175,36453,30241,24554,24978,29674
43126,24,252,30803,12323,2.80122e+13,172.159,2395.58,43126,195,175,27744,20349,7353,5004,7825
93608,329,343,66862,26746,2.80115e+13,173.142,3583.6,93608,286,175,93265,93265,92999,93115,93251
58830,227,280,42025,16805,2.79922e+13,172.666,2812.95,58830,223,175,58550,58550,55648,57112,58497
8878,627,800,6432,2446,2.01572e+13,253.134,2011.47,8878,739,106,8062,7894,6986,7458,7558
58256,77,280,41611,16645,2.80239e+13,172.638,2799.6,58256,223,175,47768,39796,19608,16581,27612
73721,45,308,52654,21067,2.80104e+13,172.954,3164.08,73721,251,175,55346,43976,16418,12163,21396
4384,37,182,3129,1255,2.80699e+13,156.698,747.411,4384,104,99,3119,2463,902,838,1075
49333,26,263,35238,14095,2.80039e+13,172.438,2567.95,49333,206,175,32536,23898,8388,8583,9573
10142,68,193,7248,2894,2.8029e+13,166.481,1142.86,10142,131,120,8087,6708,2979,2200,4141
72193,100,448,51544,20649,2.81214e+13,173.079,3316.47,72193,262,184,62163,52476,30207,26365,41383
15869,72,203,11332,4537,2.80462e+13,169.24,1435.18,15869,146,132,12813,10563,4948,4468,7109
45473,83,256,32488,12985,2.79814e+13,172.33,2462.07,45473,200,175,37750,31630,16054,12950,22860
41163,69,249,29401,11762,2.80414e+13,172.091,2339.21,41163,192,175,33141,27297,12096,9715,17520
61268,435,800,43847,17421,2.68738e+13,227.795,3850.64,61268,798,175,60176,59564,52817,56440,59373
81806,377,466,58407,23399,2.81077e+13,173.243,3528.55,81806,264,193,81340,81340,76212,78820,81251
17405,122,206,12425,4980,2.80709e+13,169.35,1504.27,17405,148,135,15609,12962,10102,10720,12599
88164,57,333,62977,25187,2.79956e+13,173.137,3472.89,88164,277,175,68969,56415,22264,26140,32804
22156,151,214,15830,6326,2.79869e+13,170.546,1701.4,22156,157,143,21030,16743,17439,18694,19211
4359,153,182,3111,1248,2.80372e+13,156.354,745.257,4359,104,99,4035,3258,3501,3553,3728
20218,164,211,14445,5773,2.80303e+13,170.174,1623.95,20218,154,140,19622,15450,17728,18881,18947
28927,40,227,20658,8269,2.80654e+13,171.191,1951.02,28927,169,156,21208,16631,6043,4537,7365
91686,51,800,65575,26111,2.72473e+13,226.614,4492.88,91686,798,180,69706,56534,22194,15834,28752
93491,54,800,66868,26623,2.72453e+13,239.663,4527.02,93491,774,180,71835,58973,22690,24373,31454
98146,4,352,70102,28044,2.80131e+13,173.229,3674.4,98146,295,175,25732,7805,5679,5500,2040
54724,22,273,39088,15636,2.80136e+13,172.551,2709.62,54724,216,175,34226,24340,9306,7727,9318
44667,367,404,31877,12790,2.81962e+13,171.674,2629.31,44667,206,175,44263,44263,44191,44184,44220
39217,76,244,28014,11203,2.79932e+13,171.895,2280.03,39217,188,175,32057,26656,13094,18082,18860
82642,175,800,59121,23521,2.71573e+13,233.276,4314.95,82642,772,180,81239,80899,70928,75438,79685
36302,51,240,25931,10371,2.80186e+13,171.813,2192.28,36302,183,169,27824,22506,8927,6470,11515
90735,5,484,64785,25950,2.81054e+13,173.288,3716,90735,280,192,28199,10022,6092,4772,2577
56599,139,276,40426,16173,2.79886e+13,172.595,2757.03,56599,219,175,52707,42642,40387,40092,45499
9091,184,190,6491,2600,2.80641e+13,164.935,1079.67,9091,125,117,8901,8901,8849,8867,8895
60110,59,283,42932,17178,2.80192e+13,172.706,2845.35,60110,226,175,47268,38575,15987,15166,23024
75456,216,310,53904,21552,2.79951e+13,173.009,3201.85,75456,254,175,75146,75146,69446,72348,75052
21600,63,213,15428,6172,2.80098e+13,170.334,1679.2,21600,156,143,17127,14159,5940,7346,8941
22372,59,215,15983,6389,2.80061e+13,170.63,1710.29,22372,158,144,17547,14340,5909,5646,8519
9845,72,192,7032,2813,2.80454e+13,165.787,1125.03,9845,129,119,7929,6555,3112,3063,4462
45905,98,257,32790,13115,2.80095e+13,172.249,2474.21,45905,200,175,39335,33258,19899,23746,27202
56480,255,421,40319,16161,2.81646e+13,172.877,2941.8,56480,231,191,56059,55938,48652,44501,52780
2429,108,178,1729,700,2.82307e+13,140.035,553.04,2429,88,83,2051,1756,1205,1376,1573
82076,834,947,58699,23377,2.72432e+13,243.961,4493.23,82076,743,199,81129,81129,80334,80618,80791
15304,36,800,11019,4285,2.34787e+13,223.16,2385.64,15304,747,127,10403,8473,2871,2497,3367
93008,174,342,66431,26577,2.80105e+13,173.167,3571.59,93008,285,175,92500,73777,81975,87445,92056
9422,131,276,6718,2704,2.8422e+13,159.737,1198.08,9422,131,116,8501,7081,5825,5430,6865
60871,119,284,43480,17391,2.80043e+13,172.699,2863.36,60871,227,175,54523,45203,33679,29541,42631
30474,359,800,21852,8622,2.57397e+13,213.382,2996.89,30474,741,156,29391,28825,27659,28116,28351
81087,200,321,57921,23166,2.80149e+13,173.047,3325.08,81087,264,175,80766,80766,73282,77099,80645
99301,44,354,70930,28371,2.80177e+13,173.225,3696.88,99301,297,175,74296,58703,22375,21392,28854
31124,23,230,22229,8895,2.79887e+13,171.465,2024.88,31124,173,160,19736,14398,5294,3317,5080
71079,96,448,50748,20331,2.81343e+13,173.078,3292.83,71079,245,193,60684,49890,25263,18454,36851
12940,234,800,9330,3610,2.2643e+13,231.231,2262.14,12940,709,125,11738,11323,10289,10391,10442
83668,242,326,59765,23903,2.80208e+13,173.049,3380.12,83668,269,175,83342,83342,78377,80899,83258
63815,155,289,45586,18229,2.7992e+13,172.758,2934.24,63815,232,175,61266,48541,54137,54946,57039
23199,163,216,16569,6630,2.80032e+13,170.658,1741.92,23199,159,146,22503,17741,20297,21662,21468
18553,130,208,13253,5300,2.79957e+13,169.964,1554.3,18553,151,138,16899,13941,11655,10468,14107
32487,218,233,23201,9286,2.80237e+13,171.542,2070.48,32487,176,162,32254,32254,31932,32072,32239
56299,125,276,40214,16085,2.80102e+13,172.627,2750.08,56299,219,175,51023,42310,34326,30267,41604
89546,209,336,63962,25584,2.80038e+13,173.134,3501.68,89546,279,175,89210,89210,81285,85332,89083
18792,177,208,13422,5370,2.80069e+13,169.8,1563.81,18792,151,138,18584,18584,17213,17886,18553
77833,12,314,55596,22237,2.80031e+13,172.945,3253.53,77833,257,175,38410,24341,11549,8029,9954
34061,215,235,24328,9733,2.79646e+13,171.619,2120.63,34061,178,165,33826,33826,33171,33477,33806
35241,96,238,25171,10070,2.80311e+13,171.726,2158.84,35241,181,167,30089,24694,14676,14179,20378
82161,284,323,58682,23479,2.80189e+13,173.037,3347.89,82161,266,175,81838,81838,79908,80870,81799
69442,34,299,49600,19842,2.80069e+13,172.837,3065.83,69442,242,175,48823,39049,13099,14315,14012
66290,208,800,47440,18850,2.69469e+13,220.085,3965.95,66290,798,175,64980,64577,57896,60829,63552
8219,24,189,5868,2351,2.80434e+13,164.556,1027.13,8219,123,114,5277,3877,1416,1056,1497
35206,228,238,25146,10060,2.8027e+13,171.768,2157.93,35206,181,167,34968,34968,34828,34888,34958
93430,61,343,66733,26697,2.80105e+13,173.145,3580.18,93430,286,175,73908,60468,25227,22347,35609
12248,49,196,8751,3497,2.79919e+13,167.665,1257.14,12248,138,125,9289,7536,2886,3445,4075
2844,21,179,2028,816,2.79712e+13,146.36,599.919,2844,90,85,1738,1241,484,340,465
64322,282,290,45943,18379,2.80056e+13,172.752,2946.26,64322,233,175,64032,64032,63940,63977,64024
19337,32,355,13784,5553,2.84697e+13,170.262,1767.02,19337,166,156,13396,10124,3575,3104,4128
43914,89,254,31369,12545,2.80386e+13,172.221,2418.73,43914,197,175,36939,30623,17062,14333,23509
13726,33,199,9799,3927,2.80654e+13,168.412,1332.6,13726,142,129,9556,7316,2551,2045,3095
78190,434,465,55821,22369,2.81128e+13,173.161,3455.49,78190,273,182,77725,77725,76593,77154,77583
82241,213,946,58808,23433,2.72657e+13,251.786,4496.6,82241,810,193,80735,80231,54082,35436,68593
61081,17,284,43628,17453,2.79933e+13,172.686,2868.08,61081,227,175,34670,24622,10276,5966,8886
52090,80,268,37205,14885,2.79949e+13,172.497,2641.2,52090,211,175,42984,36140,17817,18035,25903
25101,66,800,18019,7082,2.52306e+13,214.366,2805.19,25101,673,145,19359,16180,6805,5189,9191
21696,117,214,15498,6198,2.80156e+13,170.469,1683.87,21696,157,143,19278,16044,11845,13049,14995
90299,252,337,64497,25802,2.80041e+13,173.115,3516.5,90299,280,175,89962,89962,84892,87470,89877
34338,151,236,24526,9812,2.80056e+13,171.694,2129.89,34338,179,166,32662,25978,27062,27981,29979
69251,172,299,49469,19782,2.79967e+13,172.84,3061.78,69251,242,175,68583,54296,61038,65084,67784
94757,311,495,67656,27101,2.80967e+13,173.289,3800.8,94757,287,196,94262,94155,87215,78753,89370
84017,19,326,60012,24005,2.80066e+13,173.04,3386.79,84017,269,175,49825,35547,14290,12461,13242
62344,236,287,44533,17811,2.80112e+13,172.788,2899.68,62344,230,175,62057,62057,59311,60693,62006
84485,243,326,60350,24135,2.79881e+13,173.073,3395.86,84485,270,175,84159,84159,79208,81725,84076
59401,23,281,42428,16973,2.7991e+13,172.632,2826.81,59401,224,175,37687,27486,10097,10973,10883
83284,105,462,59473,23811,2.81296e+13,173.166,3550.44,83284,281,189,72475,61143,36133,38965,50350
54600,96,316,39002,15598,2.80489e+13,172.308,2757,54600,216,177,46613,38265,19634,18197,18743
34123,146,236,24374,9749,2.80335e+13,171.751,2123.68,34123,179,166,32147,25807,25716,26953,28840
6493,14,186,4634,1859,2.80386e+13,161.109,910.845,6493,115,107,3417,2335,998,602,566
88796,324,335,63428,25368,2.80088e+13,173.147,3486.75,88796,278,175,88461,88461,88313,88375,88450
42708,59,251,30511,12197,2.79962e+13,172.189,2383.4,42708,195,175,33561,27400,11370,8374,15466
40239,192,800,28834,11405,2.62569e+13,212.415,3303.05,40239,756,171,38947,38573,35002,36263,37521
73375,253,307,52415,20960,2.80023e+13,172.945,3156.01,73375,250,175,73068,73068,70149,71619,73014
62746,256,288,44814,17932,2.80225e+13,172.707,2909.5,62746,230,175,62458,62458,61004,61721,62426
11014,184,194,7866,3148,2.80345e+13,166.972,1191.55,11014,133,124,10820,10820,10684,10740,10810
49843,192,264,35603,14240,2.79998e+13,172.436,2581.59,49843,208,175,49579,49579,45381,47511,49507
31613,70,231,22584,9029,2.79967e+13,171.577,2041.43,31613,175,161,25482,21014,9455,7520,13662
29031,97,227,20730,8301,2.8057e+13,171.211,1954.44,29031,169,156,24811,21022,12265,14978,17162
45352,184,256,32395,12957,2.80033e+13,172.279,2458.75,45352,199,175,45096,45096,40937,43045,45024
68110,30,297,48652,19458,2.80006e+13,172.791,3035.36,68110,240,175,46418,35093,11731,8637,14249
1165,2,176,835,330,2.7555e+13,107.085,382.79,1165,60,61,155,28,24,60,11
47765,631,800,34209,13556,2.65149e+13,227.446,3513.07,47765,788,175,46903,46734,41031,39429,41316
27736,220,225,19807,7929,2.80471e+13,171.007,1909.46,27736,167,154,27511,27511,27482,27490,27506
85514,44,329,61081,24433,2.80152e+13,173.055,3418.45,85514,272,175,63984,50565,19267,13496,23214
7348,153,187,5251,2097,2.78991e+13,163.493,969.995,7348,120,109,6909,5525,5964,6274,6322
10945,52,194,7817,3128,2.80953e+13,166.944,1187.65,10945,133,124,8379,6808,2740,2586,3788
56377,22,420,40246,16131,2.81711e+13,172.88,2937.04,56377,233,178,35241,25075,9631,7157,7181
21523,169,213,15374,6149,2.80119e+13,170.301,1676.37,21523,156,142,21088,16609,19072,20203,20597
15279,185,201,10914,4365,2.79681e+13,168.776,1406.36,15279,144,131,15078,15078,14695,14863,15062
22118,101,214,15799,6319,2.80032e+13,170.443,1699.8,22118,157,143,19045,16089,9932,9790,13520
38898,220,245,27779,11119,2.80562e+13,171.915,2272.01,38898,187,174,38653,38653,37688,38153,38628
58871,95,281,42050,16821,2.8011e+13,172.726,2814.97,58871,224,175,50171,41268,24272,20684,33368
20608,332,800,14808,5800,2.46439e+13,215.281,2627.59,20608,763,136,19488,18977,17056,17860,18404
33913,15,382,24199,9714,2.82484e+13,172.049,2302.53,33913,192,183,18358,12656,5386,2317,3675
21846,101,213,15601,6245,2.79458e+13,170.365,1688.45,21846,156,143,18806,15890,9819,9698,13273
67582,97,296,48275,19307,2.79964e+13,172.819,3023.21,67582,239,175,57861,48976,28519,27315,39583
28566,154,225,20407,8159,2.79961e+13,171.192,1937.26,28566,168,155,27297,21605,24023,24999,25193
40373,213,247,28838,11535,2.80077e+13,171.994,2315.45,40373,190,175,40126,40126,38507,39309,40092
77135,124,313,55094,22041,2.80028e+13,172.969,3238.46,77135,256,175,69791,57709,46985,40375,56271
90807,129,338,64860,25947,2.80149e+13,173.145,3527.13,90807,281,175,82977,68428,56797,56995,68262
60571,207,428,43246,17325,2.81336e+13,172.9,3043.38,60571,225,193,60143,60019,43382,29778,52920
97931,329,496,69926,28005,2.8099e+13,173.318,3859.21,97931,293,192,97435,97435,92773,87196,93096
15363,66,202,10971,4392,2.80444e+13,169.005,1411.42,15363,145,131,12245,10141,4410,4111,6371
9506,56,191,6787,2719,2.81273e+13,165.484,1105.07,9506,127,118,7373,6073,2438,3970,3609
84084,208,326,60062,24022,2.80077e+13,173.075,3388.19,84084,269,175,83758,83758,76436,80175,83640
35114,180,238,25078,10036,2.80283e+13,171.595,2154.95,35114,180,167,34876,34876,31648,33277,34818
25155,81,219,17966,7189,2.79918e+13,170.847,1814.91,25155,162,149,20769,17488,8831,9517,12764
98801,251,352,70577,28224,2.79899e+13,173.207,3686,98801,296,175,98449,98449,92275,95421,98348
93433,48,343,66736,26697,2.80082e+13,173.165,3580.33,93433,286,175,70920,57084,21651,18591,28605
5916,54,184,4226,1690,2.78929e+13,160.673,868.256,5916,112,104,4540,3733,1480,1898,2154
45516,229,256,32513,13003,2.79859e+13,172.273,2462.91,45516,199,175,45260,45260,44138,44683,45233
63075,122,288,45050,18025,2.80124e+13,172.713,2916.71,63075,231,175,56800,47072,36605,38785,45348
11593,166,195,8276,3317,2.8031e+13,167.016,1222.49,11593,135,124,11227,8906,10241,10821,10841
50150,258,265,35828,14322,2.79912e+13,172.452,2590.22,50150,208,175,49885,49885,49830,49849,49878
67208,467,800,48096,19112,2.69665e+13,226.627,3986.95,67208,798,175,66145,65890,58651,62326,65409
78802,105,317,56287,22515,2.80125e+13,173.052,3275.94,78802,260,175,68602,57811,36907,30957,49020
5184,126,184,3700,1484,2.8274e+13,158.591,813.28,5184,110,103,4608,3859,3169,3229,3842
36635,209,240,26171,10464,2.79906e+13,171.922,2202.27,36635,184,170,36395,36395,34980,35677,36364
90215,251,337,64439,25776,2.80084e+13,173.099,3514.96,90215,280,175,89878,89878,84740,87353,89792
95112,319,346,67936,27176,2.80082e+13,173.148,3613.85,95112,289,175,94766,94766,93628,94183,94739
15268,112,202,10902,4366,2.80158e+13,169.132,1407.21,15268,145,132,13400,11246,7890,7170,10100
84480,63,327,60344,24136,2.80047e+13,173.071,3396.73,84480,270,175,67151,55429,23127,20506,33221
24504,155,219,17498,7006,2.80748e+13,170.676,1791.95,24504,161,148,23425,18610,20729,22030,21725
77745,186,315,55528,22217,2.80167e+13,173.037,3252.96,77745,258,175,77430,77430,69392,73497,77301
31747,29,231,22681,9066,2.79761e+13,171.512,2045.51,31747,174,161,21450,16179,5412,3901,6072
43706,59,800,31302,12404,2.64324e+13,211.762,3402.18,43706,798,175,33686,27673,11098,8086,15043
74587,119,800,53356,21231,2.70887e+13,225.81,4148.25,74587,798,175,65918,54750,40168,43682,51019
79460,78,317,56755,22705,2.80038e+13,172.968,3288.89,79460,260,175,65317,54443,26639,36944,39147
3517,92,180,2508,1009,2.77034e+13,151.593,667.352,3517,95,91,2913,2430,1434,1319,1903
85250,452,940,60971,24279,2.72843e+13,220.746,4550.22,85250,804,192,84048,83363,77574,69565,76438
66723,319,436,47641,19082,2.81246e+13,173.003,3186.85,66723,237,193,66287,66287,59227,62838,65568
3942,11,181,2813,1129,2.82891e+13,153.133,707.417,3942,101,97,1872,1160,576,345,425
41823,169,250,29871,11952,2.80365e+13,172.15,2358.42,41823,193,175,41129,32316,36851,39259,40135
63305,110,288,45216,18089,2.80018e+13,172.75,2921.89,63305,231,175,55672,46671,31946,30511,41662
42113,9,250,30085,12028,2.79972e+13,172.147,2366.26,42113,194,175,18427,8905,5247,3361,3576
54199,286,800,38806,15393,2.67029e+13,218.765,3679.05,54199,759,180,53036,52508,50681,51284,51857
46744,24,259,33389,13355,2.80308e+13,172.335,2497.88,46744,202,175,30074,22064,7963,5086,7752
19403,19,209,13862,5541,2.80539e+13,169.83,1589.66,19403,152,139,11505,8214,3311,3103,2398
40962,214,248,29259,11703,2.80106e+13,172.091,2332.73,40962,191,175,40714,40714,39139,39917,40680
86653,340,472,61873,24780,2.81246e+13,173.214,3626.56,86653,273,193,86181,86181,80283,78480,83914
75789,168,311,54137,21652,2.80078e+13,172.979,3209.44,75789,254,175,74533,58468,66527,71114,72680
92331,182,341,65948,26383,2.801e+13,173.136,3558.14,92331,284,175,91990,91990,81880,87054,91831
30102,221,229,21504,8598,2.80129e+13,171.479,1991.53,30102,172,158,29873,29873,29796,29825,29865
97812,103,494,69838,27974,2.80987e+13,173.277,3855.36,97812,307,191,84783,71804,41737,45957,58637
80989,145,320,57849,23140,2.79932e+13,173.008,3321.92,80989,263,175,76330,61181,60724,59569,67987
53694,204,271,38349,15345,2.80029e+13,172.554,2683.09,53694,214,175,53423,53423,49581,51526,53356
33567,96,374,23960,9607,2.82459e+13,171.986,2282.49,33567,177,173,28606,23576,10959,7533,16619
84089,220,327,60063,24026,2.80144e+13,173.054,3389.31,84089,269,175,83762,83762,77244,80565,83655
83785,199,466,59830,23955,2.81076e+13,173.206,3565.53,83785,277,176,83319,83193,74790,78177,82581
3171,37,179,2266,905,2.7751e+13,149.072,633.065,3171,94,87,2253,1783,660,624,857
24086,194,218,17210,6876,2.80417e+13,170.845,1776.22,24086,161,147,23868,23868,22973,23401,23844
31966,125,232,22837,9129,2.80267e+13,171.491,2053.26,31966,175,162,28913,24007,19504,16122,23391
19432,146,209,13882,5550,2.79974e+13,169.809,1590.39,19432,152,139,18266,14688,14628,15315,16385
3212,55,180,2294,918,2.80988e+13,149.879,639.089,3212,95,90,2445,2029,824,964,1132
41212,89,248,29435,11777,2.80184e+13,171.95,2339.33,41212,191,175,34666,28751,16082,20073,22922
17601,91,206,12577,5024,2.80142e+13,169.581,1512.62,17601,149,135,14822,12249,6891,5865,9489
52438,51,268,37454,14984,2.80051e+13,172.419,2649.54,52438,211,175,40213,32522,12934,15374,18383
3969,64,182,2837,1132,2.79891e+13,154.673,711.283,3969,103,94,3095,2595,1115,918,1571
21367,211,212,15264,6103,2.79396e+13,170.293,1669.37,21367,155,142,21155,21155,21155,21155,21154
41991,229,250,29990,12001,2.79914e+13,172.187,2362.94,41991,193,175,41741,41741,41063,41379,41720
5325,93,184,3799,1526,2.81862e+13,159.582,824.54,5325,110,103,4442,3692,2123,1839,2931
62880,33,288,44915,17965,2.80142e+13,172.762,2912.48,62880,231,175,43859,33538,11623,8323,13684
64662,192,800,46266,18396,2.71289e+13,230.265,3823.96,64662,519,175,63623,63371,56974,59574,62331
72095,3,304,51504,20591,2.79898e+13,172.95,3126.79,72095,248,175,15114,3383,3126,3909,1234
62466,156,287,44622,17844,2.80128e+13,172.719,2902.18,62466,230,175,60070,47512,53220,56469,55929
14975,90,201,10698,4277,2.79999e+13,168.751,1392.54,14975,144,131,12582,10420,5863,5696,8143
15186,132,201,10849,4337,2.79723e+13,168.79,1402.19,15186,144,131,13880,11413,9708,8932,11584
46759,248,258,33399,13360,2.79797e+13,172.292,2497.22,46759,201,175,46501,46501,46359,46420,46491
70002,109,300,50002,20000,2.80041e+13,172.826,3078.54,70002,243,175,61443,51493,34457,33613,45734
33886,224,236,24200,9686,2.80509e+13,171.552,2116.23,33886,178,165,33650,33650,33460,33543,33638
60147,194,283,42960,17187,2.80137e+13,172.67,2845.87,60147,226,175,59864,59864,54527,57242,59775
96216,57,348,68724,27492,2.80043e+13,173.18,3635.78,96216,291,175,75282,61575,24395,32351,37028
34342,181,236,24532,9810,2.79982e+13,171.685,2130.02,34342,179,166,34106,34106,31082,32606,34051
49629,140,264,35445,14184,2.80185e+13,172.472,2576.48,49629,207,175,46285,37376,35571,37812,40517
43880,8,254,31342,12538,2.80378e+13,172.178,2417.76,43880,197,175,18257,8342,5084,3423,2374
27151,55,223,19391,7760,2.80031e+13,171.117,1887.93,27151,166,153,21077,17267,6799,7917,9806
81438,552,800,58262,23176,2.71369e+13,232.328,4290.22,81438,772,180,80533,80133,78227,79186,79894
20929,136,211,14952,5977,2.79728e+13,170.172,1651.67,20929,155,142,19294,15743,14170,15028,16470
12686,168,197,9067,3619,2.80132e+13,167.908,1280,12686,139,127,12342,9745,11323,11901,12042
93483,119,343,66772,26711,2.80112e+13,173.146,3581.24,93483,286,175,83741,69442,51726,48071,65964
79968,311,319,57118,22850,2.80072e+13,173.057,3300.97,79968,262,175,79649,79649,79574,79603,79641
68357,293,298,48823,19534,2.8023e+13,172.873,3041.95,68357,241,175,68059,68059,68023,68034,68054
87903,579,800,62878,25025,2.72266e+13,256.83,4419.67,87903,794,175,86897,86547,76030,81403,86440
8256,76,189,5899,2357,2.79688e+13,164.321,1029.02,8256,124,113,6695,5591,2758,2646,3797
14836,158,201,10594,4242,2.80346e+13,168.808,1386.71,14836,144,131,14210,11299,12881,13784,13281
92048,134,341,65754,26294,2.80058e+13,173.184,3552.97,92048,284,175,84942,69361,60885,58234,72663
86748,477,800,62048,24700,2.71898e+13,228.024,4396.59,86748,798,175,85682,85395,77342,81433,84979
37233,31,241,26594,10639,2.79911e+13,171.931,2220.63,37233,184,171,25558,19379,6691,6396,8167
21167,105,212,15120,6047,2.79908e+13,170.21,1661.47,21167,155,142,18380,15509,9934,9431,13250
77527,109,464,55352,22175,2.81226e+13,173.114,3440.95,77527,265,177,67996,57041,37421,33844,49618
42808,162,252,30576,12232,2.80427e+13,172.171,2387.08,42808,195,175,41568,32770,37412,40045,39658
19739,88,209,14097,5642,2.80186e+13,169.681,1602.5,19739,152,139,16535,13767,7632,9595,10738
8257,183,189,5895,2362,2.79825e+13,164.573,1029.2,8257,123,113,8068,8068,8016,8034,8062
31543,108,231,22529,9014,2.80142e+13,171.454,2039.08,31543,174,161,27570,23124,15418,15117,20537
45401,494,800,32516,12885,2.64379e+13,209.382,3448.82,45401,775,175,44434,44123,41714,42910,43683
64311,55,290,45936,18375,2.79929e+13,172.752,2946.05,64311,233,175,49997,40921,16073,17473,22736
61263,143,285,43755,17508,2.80113e+13,172.641,2873.25,61263,227,175,57490,46272,45265,50104,50422
78885,148,316,56349,22536,2.79955e+13,172.996,3276.52,78885,259,175,74769,59730,60281,58879,67535
58244,34,279,41599,16645,2.7991e+13,172.629,2798.26,58244,222,175,40946,32752,10971,12971,14035
16837,137,204,12026,4811,2.79473e+13,169.261,1477.86,16837,147,134,15542,12659,11468,10556,13348
75823,115,311,54162,21661,2.80082e+13,172.942,3209.93,75823,254,175,67397,56181,39892,38141,51850
99990,435,501,71391,28599,2.81048e+13,173.332,3900.51,99990,313,189,99489,99489,97189,96766,99022
48620,231,406,34703,13917,2.81828e+13,172.601,2734.22,48620,218,184,48214,48092,42730,38241,45444
40140,74,247,28667,11473,2.80265e+13,172.054,2308.93,40140,190,175,32683,26830,12993,10860,18383
43897,169,253,31357,12540,2.79948e+13,172.116,2416.91,43897,196,175,43182,33931,38690,41219,42473
70693,10,302,50493,20200,2.80112e+13,172.892,3095.24,70693,245,175,32342,17521,9708,4724,3887
91289,200,339,65201,26088,2.80089e+13,173.116,3536.84,91289,282,175,90950,90950,82249,86695,90811
37610,22,242,26863,10747,2.80025e+13,171.937,2232.33,37610,185,172,23512,16725,6406,3947,5951
66573,491,800,47638,18935,2.69614e+13,213.722,3972.82,66573,798,175,65575,65256,60968,63115,64846
1527,164,177,1088,439,2.83076e+13,121.454,437.15,1527,72,69,1339,1126,1287,1314,1300
49791,68,264,35567,14224,2.80065e+13,172.439,2580.35,49791,207,175,40003,33022,14565,10658,20370
13215,39,198,9434,3781,2.80426e+13,167.759,1306.79,13215,140,127,9627,7552,2750,2581,3499
4438,154,182,3170,1268,2.79821e+13,156.108,751.32,4438,106,97,4116,3322,3652,3789,3859
37453,207,241,26749,10704,2.80072e+13,171.772,2226.66,37453,184,171,37212,37212,35607,36403,37178
31819,69,231,22722,9097,2.80058e+13,171.426,2047.7,31819,174,161,25609,21106,9483,14154,14087
50479,248,265,36063,14416,2.79929e+13,172.549,2598.79,50479,209,175,50214,50214,49750,49957,50197
94049,191,345,67178,26871,2.80103e+13,173.157,3593.61,94049,287,175,93704,93704,83990,88956,93550
66145,231,294,47248,18897,2.80193e+13,172.862,2990.39,66145,237,175,65851,65851,62302,64097,65788
24458,39,218,17476,6982,2.79721e+13,170.875,1789.73,24458,161,147,17830,13960,5015,4731,6521
97251,794,944,69532,27719,2.73761e+13,223.871,4785.52,97251,800,197,96307,96099,90198,93149,95858
80926,416,441,57783,23143,2.80897e+13,172.014,3476.61,80926,268,175,80485,80485,80483,80483,80471
10811,56,194,7721,3090,2.8105e+13,166.93,1180.59,10811,133,123,8379,6904,2731,2053,3698
65550,225,292,46815,18735,2.80137e+13,172.708,2975.06,65550,235,175,65258,65258,61417,63362,65191
73462,105,800,52560,20902,2.70589e+13,215.988,4123.92,73462,798,175,63122,53287,33571,38899,44511
74829,138,309,53450,21379,2.80002e+13,172.928,3187.78,74829,252,175,69597,56391,52322,47904,60326
65756,41,293,46971,18785,2.80073e+13,172.788,2980.72,65756,236,175,48479,38161,13811,10254,17581
64319,26,291,45932,18387,2.80289e+13,172.726,2947.28,64319,233,175,42443,31171,10970,9572,12764
29803,201,228,21285,8518,2.80105e+13,171.425,1980.77,29803,171,158,29575,29575,28461,29003,29548
63691,162,289,45492,18199,2.79979e+13,172.752,2931.57,63691,232,175,61931,48789,55699,53311,58865
31365,171,231,22405,8960,2.80072e+13,171.599,2033.7,31365,174,160,30914,24278,27798,29490,30455
33582,140,235,23984,9598,2.80239e+13,171.513,2105.91,33582,177,164,31282,25288,24079,24386,27220
68505,71,298,48929,19576,2.80077e+13,172.887,3045.12,68505,241,175,55434,45566,20954,15040,29195
79373,157,318,56697,22676,2.80008e+13,173.056,3288.32,79373,261,175,76499,60374,69365,71927,71620
41506,241,249,29648,11858,2.8003e+13,172.05,2348.59,41506,192,175,41257,41257,41163,41201,41249
31381,198,231,22412,8969,2.80153e+13,171.479,2033.95,31381,174,160,31150,31150,29620,30375,31117
99406,69,354,71003,28403,2.80136e+13,173.19,3698.51,99406,297,175,80115,65954,29152,23414,42620
98119,636,800,70172,27947,2.72991e+13,225.122,4614.06,98119,798,180,97228,97055,90437,93835,96828
74696,292,309,53353,21343,2.80086e+13,172.949,3185.04,74696,252,175,74387,74387,73941,74139,74370
96786,323,800,69219,27567,2.72925e+13,227.426,4589.14,96786,798,180,95615,95017,90253,92425,94473
20815,132,212,14872,5943,2.79837e+13,170.306,1648.19,20815,155,142,19041,15651,13312,12229,15924
89228,173,335,63731,25497,2.79978e+13,173.096,3494.51,89228,278,175,88575,70134,78595,83866,87769
32658,2,233,23327,9331,2.80019e+13,171.561,2075.75,32658,176,162,4369,826,708,1712,368
97659,312,350,69759,27900,2.79913e+13,173.186,3663.6,97659,294,175,97309,97309,95427,96366,97271
50574,83,265,36124,14450,2.79877e+13,172.413,2600.64,50574,208,175,42002,35189,17900,16695,25521
28630,224,226,20447,8183,2.8027e+13,171.159,1940.19,28630,169,155,28404,28404,28400,28400,28402
67410,557,945,48213,19197,2.70965e+13,234.032,4179.47,67410,813,193,66283,65948,58378,48417,57336
49588,262,264,35416,14172,2.80275e+13,172.474,2575.27,49588,207,175,49324,49324,49320,49320,49322
23358,13,216,16693,6665,2.79572e+13,170.774,1747.97,23358,160,146,11940,8056,3497,2868,2088
71088,137,452,50748,20340,2.81367e+13,173.066,3296.95,71088,244,196,65867,53574,30785,16844,48186
63576,124,289,45411,18165,2.80109e+13,172.794,2929,63576,232,175,57513,47554,38704,31430,46133
33550,79,234,23964,9586,2.79667e+13,171.636,2104.21,33550,177,164,27594,23034,11407,12546,16881
17470,121,206,12477,4993,2.80147e+13,169.677,1507.33,17470,149,136,15630,12971,9901,8555,12316
11815,92,195,8440,3375,2.7957e+13,167.495,1234.33,11815,136,125,9942,8217,4671,4553,6572
72544,186,305,51822,20722,2.7999e+13,172.96,3137.07,72544,249,175,72239,72239,64845,68620,72120
63505,236,288,45366,18139,2.79912e+13,172.764,2926.38,63505,232,175,63217,63217,60374,61806,63165
6477,146,186,4625,1852,2.8086e+13,162.373,910.566,6477,116,107,5999,4858,4830,5303,5379
98735,409,800,70615,28120,2.7297e+13,227.59,4625.38,98735,798,180,97603,96963,89183,93341,96716
91352,267,340,65245,26107,2.80251e+13,173.079,3539,91352,282,175,91012,91012,86790,88928,90939
11113,172,194,7939,3174,2.79369e+13,166.947,1196.52,11113,133,124,10865,8670,10160,10522,10708
90171,89,337,64411,25760,2.80111e+13,173.112,3514.27,90171,280,175,75908,62920,35100,43869,49429
91099,100,339,65066,26033,2.80148e+13,173.064,3533.27,91099,281,175,78510,66202,40747,47799,54981
9985,27,192,7130,2855,2.80329e+13,165.853,1132.84,9985,129,120,6633,4942,1707,1937,2092
65094,84,291,46505,18589,2.79828e+13,172.832,2964.48,65094,235,175,54178,45295,23122,21689,32424
4974,98,183,3552,1422,2.80238e+13,158.547,796.05,4974,107,100,4182,3568,2181,2163,2948
94206,534,944,67360,26846,2.73523e+13,253.847,4729.23,94206,743,197,93154,92703,91754,91982,92032
78162,252,315,55826,22336,2.79969e+13,172.974,3260.97,78162,258,175,77847,77847,74278,76083,77784
80257,298,319,57324,22933,2.80135e+13,172.967,3306.55,80257,262,175,79938,79938,79260,79576,79917
47881,120,261,34196,13685,2.80239e+13,172.432,2529.25,47881,204,175,42945,35538,26728,23755,33791
53589,219,271,38282,15307,2.80157e+13,172.514,2680.46,53589,214,175,53318,53318,50519,51927,53266
11894,103,196,8493,3401,2.80794e+13,167.335,1239.18,11894,137,125,10246,8700,5401,6446,7366
5582,148,184,3989,1593,2.79982e+13,159.75,843.44,5582,110,104,5164,4191,4201,4362,4627
55098,230,274,39352,15746,2.80202e+13,172.613,2719.74,55098,217,175,54824,54824,52567,53697,54780
51832,193,267,37022,14810,2.79957e+13,172.435,2633.88,51832,210,175,51565,51565,47238,49434,51491
84606,144,327,60433,24173,2.80063e+13,173.075,3399.18,84606,270,175,79598,63912,62806,66625,70666
70800,120,302,50574,20226,2.80046e+13,172.891,3097.57,70800,245,175,63538,52580,39560,36551,50014
57881,205,278,41340,16541,2.80036e+13,172.579,2788.96,57881,221,175,57603,57603,53349,55507,57530
72479,724,800,51855,20624,2.70529e+13,225.18,4103,72479,774,180,71679,71507,69641,70574,71452
54612,264,272,39007,15605,2.80015e+13,172.464,2705.96,54612,215,175,54340,54340,54248,54285,54332
71928,117,800,51471,20457,2.70409e+13,237.073,4091.03,71928,798,175,63291,52649,38047,36039,48636
38507,187,244,27499,11008,2.8023e+13,171.861,2259.93,38507,186,173,38263,38263,35101,36696,38206
65074,56,291,46486,18588,2.79958e+13,172.784,2964.01,65074,234,175,50747,41638,16381,27154,24770
53501,85,271,38214,15287,2.7996e+13,172.538,2678.24,53501,214,175,44618,37318,19284,19122,27899
30683,116,229,21913,8770,2.8024e+13,171.266,2009.62,30683,172,159,27268,22720,16219,18439,21256
37473,135,242,26765,10708,2.80147e+13,171.851,2228.28,37473,185,171,34591,28219,25047,26534,29457
9010,73,190,6438,2572,2.78941e+13,165.212,1075.08,9010,125,116,7268,5992,2908,2821,3975
54070,230,416,38602,15468,2.81466e+13,172.749,2878.97,54070,213,193,53654,53532,36684,25078,48285
46800,175,259,33426,13374,2.80274e+13,172.341,2499.31,46800,202,175,46541,46541,41551,44088,46457
80644,132,800,57690,22954,2.71335e+13,233.503,4274.14,80644,798,175,73192,60097,50304,47504,60801
2232,170,178,1594,638,2.80082e+13,138.47,530.825,2232,83,79,2042,1682,1996,2024,2002
72752,112,306,51963,20789,2.80216e+13,172.956,3142.3,72752,249,175,64256,53762,37600,34757,48255
84406,707,946,60355,24051,2.72836e+13,232.765,4540.28,84406,800,193,83416,83178,74946,78869,82743
1793,148,177,1286,507,2.76406e+13,131.515,475.775,1793,75,70,1564,1310,1313,1400,1386
87848,174,800,62841,25007,2.71987e+13,234.519,4418.37,87848,798,175,86283,68880,75438,80300,84565
17593,7,206,12568,5025,2.79227e+13,169.699,1512.45,17593,149,136,6798,2723,1904,1076,718
5888,60,185,4206,1682,2.80497e+13,161.022,867.615,5888,113,105,4584,3766,1608,1799,2264
88677,95,334,63336,25341,2.80147e+13,173.081,3483.31,88677,277,175,75625,62196,36615,45236,51551
36161,185,239,25827,10334,2.79721e+13,171.756,2187.02,36161,182,169,35922,35922,32961,34453,35868
72124,34,305,51517,20607,2.80254e+13,172.919,3128.21,72124,248,175,50705,40551,13611,10206,16433
86713,317,331,61941,24772,2.80142e+13,173.089,3443.31,86713,274,175,86382,86382,86124,86234,86368
22888,206,216,16349,6539,2.807e+13,170.526,1730.3,22888,159,145,22672,22672,22546,22595,22662
3747,82,181,2675,1072,2.81451e+13,153.516,690.976,3747,98,94,3032,2575,1322,1355,1773
64478,89,291,46056,18422,2.80209e+13,172.81,2950.97,64478,234,175,54272,44973,25065,21034,34682
88892,23,335,63498,25394,2.80118e+13,173.111,3488.39,88892,278,175,56409,41151,15128,9491,14221
42346,69,251,30250,12096,2.80095e+13,172.22,2373.79,42346,194,175,34088,28070,12543,13572,18311
77377,45,800,55358,22019,2.70891e+13,218.224,4206.62,77377,798,175,57511,45903,16925,22354,23659
51816,233,267,37010,14806,2.79826e+13,172.469,2633.44,51816,210,175,51549,51549,49939,50738,51515
73540,256,307,52527,21013,2.80066e+13,172.929,3159.44,73540,250,175,73233,73233,70476,71863,73182
54591,206,273,38990,15601,2.80174e+13,172.472,2706.4,54591,215,175,54318,54318,50473,52420,54251
78956,241,467,56376,22580,2.81111e+13,173.198,3472.49,78956,259,195,78489,78368,60678,46076,70843
8541,154,189,6101,2440,2.78761e+13,164.67,1045.97,8541,123,114,8069,6433,7103,6814,7458
81845,177,322,58461,23384,2.80066e+13,173.05,3340.79,81845,265,175,81523,81523,72379,77053,81378
36623,707,800,26253,10370,2.60813e+13,213.767,3194.79,36623,796,166,35823,35614,32257,33946,35545
10203,160,193,7289,2914,2.81377e+13,166.34,1146.26,10203,131,121,9755,7755,8826,9429,9269
60870,187,284,43478,17392,2.80025e+13,172.719,2863.42,60870,227,175,60586,60586,54705,57700,60489
91505,25,339,65357,26148,2.79966e+13,173.119,3540.8,91505,282,175,59716,43510,15561,11748,17742
14106,86,199,10075,4031,2.79481e+13,168.204,1350.04,14106,142,129,11744,9828,5256,4852,7262
12979,176,197,9275,3704,2.79231e+13,168.104,1294.63,12979,141,128,12782,12782,12052,12397,12761
82929,426,800,59321,23608,2.71821e+13,235.289,4320.79,82929,798,175,81801,81185,72581,77166,80993
84259,490,800,60281,23978,2.71708e+13,237.823,4347.43,84259,765,180,83296,82910,81131,82016,82529
24335,14,218,17382,6953,2.80093e+13,170.657,1784.95,24335,161,148,12842,8752,3698,2167,2772
26540,209,222,18956,7584,2.80059e+13,171.03,1866.13,26540,165,152,26318,26318,26095,26191,26305
31024,200,230,22159,8865,2.79837e+13,171.453,2021.79,31024,173,160,30794,30794,29482,30126,30764
58193,210,279,41563,16630,2.79962e+13,172.637,2797.18,58193,222,175,57914,57914,53944,55956,57845
20139,72,211,14388,5751,2.79934e+13,170.337,1620.96,20139,154,140,16275,13404,6270,5570,9002
6647,67,186,4748,1899,2.8003e+13,162.3,921.839,6647,116,108,5276,4370,1975,1817,2817
87598,373,800,62664,24934,2.72137e+13,232.294,4413.52,87598,780,180,86505,85846,83138,84358,85517
28141,34,225,20095,8046,2.80236e+13,171.135,1922.86,28141,168,154,19767,15824,5318,3992,6497
27564,706,800,19768,7796,2.55251e+13,212.146,2895.77,27564,779,149,26764,26572,24352,25488,26483
47817,222,260,34151,13666,2.79848e+13,172.339,2526.32,47817,203,175,47557,47557,45683,46616,47519
21056,87,212,15039,6017,2.8018e+13,170.26,1657.28,21056,155,141,17607,14666,8013,6803,11103
63518,273,289,45367,18151,2.80121e+13,172.705,2927.66,63518,231,175,63229,63229,62841,63012,63213
19326,43,209,13799,5527,2.80344e+13,169.78,1586.27,19326,151,138,14368,11387,4316,3308,5415
25819,156,221,18442,7377,2.80463e+13,171.006,1840.4,25819,164,150,24743,19608,21941,23267,23092
44754,70,255,31964,12790,2.80125e+13,172.219,2441.91,44754,198,175,36118,29764,13380,10640,19317
31831,34,231,22733,9098,2.8004e+13,171.483,2047.87,31831,174,161,22363,17893,5995,6578,7979
9987,39,192,7134,2853,2.79849e+13,166.187,1133.44,9987,129,119,7260,5693,2034,2342,2711
70579,290,302,50412,20167,2.80145e+13,172.891,3092.86,70579,245,175,70277,70277,70081,70167,70265
8896,143,190,6355,2541,2.79824e+13,165.026,1068.36,8896,127,115,8241,6685,6527,7208,7381
6956,123,186,4975,1981,2.78517e+13,162.756,942.707,6956,119,109,6184,5169,4165,3460,4931
64036,29,430,45717,18319,2.8157e+13,172.893,3121.51,64036,231,193,43308,32646,10956,6464,11881
24477,125,218,17479,6998,2.80311e+13,170.686,1790.23,24477,161,148,22115,18372,14924,15207,17874
56155,31,416,40088,16067,2.81596e+13,172.806,2928,56155,231,178,38583,29226,10099,6644,11059
44771,221,394,31954,12817,2.82219e+13,172.428,2621.47,44771,210,178,44377,44255,40317,37491,42431
29580,146,228,21129,8451,2.80598e+13,171.409,1973.5,29580,171,157,27844,22361,22298,24566,25065
68870,268,441,49168,19702,2.81535e+13,172.967,3239.17,68870,240,193,68429,68309,54481,49633,63474
27905,146,225,19933,7972,2.80437e+13,171.233,1915.45,27905,168,154,26259,21094,21031,23164,23560
8133,149,189,5807,2326,2.80802e+13,164.601,1021.62,8133,123,113,7606,6115,6212,6727,6904
36225,197,239,25874,10351,2.79887e+13,171.775,2189,36225,182,169,35986,35986,33840,34913,35944
66278,233,294,47344,18934,2.80204e+13,172.79,2993.04,66278,237,175,65984,65984,62573,64296,65923
87087,140,332,62207,24880,2.80006e+13,173.139,3451.61,87087,275,175,81295,65622,62456,66379,70822
41400,202,249,29574,11826,2.79794e+13,172.14,2345.74,41400,192,175,41151,41151,38707,39933,41104
40402,293,387,28835,11567,2.82384e+13,172.338,2495.3,40402,202,176,40015,39900,38960,38456,39234
51531,36,267,36805,14726,2.79953e+13,172.478,2626.42,51531,210,175,36780,29153,9976,11679,13159
31771,12,232,22694,9077,2.80392e+13,171.521,2047.25,31771,175,161,15688,9951,4714,2238,1984
79901,43,319,57067,22834,2.80149e+13,172.941,3299.44,79901,261,175,59499,47106,17388,21850,23834
57026,136,277,40730,16296,2.80086e+13,172.622,2768.06,57026,220,175,52810,42964,38630,38652,45080
32092,197,232,22924,9168,2.80088e+13,171.497,2057.2,32092,175,162,31860,31860,30233,31038,31825
97462,228,351,69612,27850,2.80133e+13,173.211,3661.07,97462,294,175,97111,97111,89498,93384,96988
39221,32,245,28015,11206,2.80083e+13,171.968,2281.25,39221,188,174,27140,20559,7178,5130,8273
7409,177,188,5299,2110,2.79543e+13,163.886,974.913,7409,121,110,7221,7221,7076,7138,7210
26916,48,222,19217,7699,2.80227e+13,170.854,1878.55,26916,165,152,20411,16453,6271,7713,8829
52680,185,269,37626,15054,2.79994e+13,172.501,2656.49,52680,212,175,52411,52411,47421,49958,52327
7124,175,187,5089,2035,2.80844e+13,163.106,955.036,7124,119,110,6937,6937,6747,6830,6925
12514,302,337,8918,3596,2.86677e+13,168.608,1441.16,12514,150,140,12177,12070,11481,11283,12054
80881,143,320,57772,23109,2.79992e+13,173,3319.78,80881,263,175,75949,61101,59769,59187,66858
59144,565,800,42330,16814,2.68056e+13,227.545,3800.06,59144,738,180,58268,57868,57104,57467,57639
66321,95,436,47348,18973,2.81358e+13,173.043,3178.09,66321,248,177,56499,46543,26619,24677,37522
19186,88,209,13707,5479,2.80409e+13,169.958,1580.93,19186,152,139,16053,13363,7358,7098,10344
54494,198,413,38898,15596,2.81809e+13,172.743,2885.4,54494,228,186,54081,53953,44956,40811,50872
63616,112,289,45442,18174,2.80044e+13,172.779,2929.91,63616,232,175,56169,47010,32893,31346,42337
3342,147,180,2387,955,2.79743e+13,149.705,650.847,3342,97,90,3027,2494,2492,2697,2775
4143,122,181,2966,1177,2.76631e+13,155.283,725.437,4143,103,96,3641,3056,2395,2065,2878
36597,190,240,26146,10451,2.79889e+13,171.916,2201.2,36597,183,169,36357,36357,33659,35018,36307
16118,39,203,11511,4607,2.79972e+13,169.142,1445.84,16118,146,133,11740,9199,3320,3126,4223
26433,65,222,18876,7557,2.80234e+13,171.115,1862.78,26433,165,152,21064,17421,7575,8296,10892
43140,154,252,30814,12326,2.80031e+13,172.14,2396.08,43140,195,175,41279,32643,36330,37798,37975
18134,12,207,12958,5176,2.80525e+13,169.63,1535.81,18134,150,137,8958,5676,2696,1552,1939
34472,127,237,24620,9852,2.80601e+13,171.676,2135.03,34472,180,166,31307,25891,21279,21514,25824
95131,252,800,68046,27085,2.72625e+13,235.168,4558.11,95131,785,180,93862,93366,87256,89943,92515
94478,167,345,67488,26990,2.79949e+13,173.189,3601.36,94478,288,175,92781,72896,82863,84588,89850
9201,98,190,6573,2628,2.78352e+13,165.499,1086.6,9201,126,116,7817,6642,4009,3853,5439
61502,220,285,43929,17573,2.80261e+13,172.663,2878.63,61502,228,175,61217,61217,57534,59397,61152
49175,755,800,35209,13966,2.65792e+13,212.996,3550.09,49175,769,177,48375,48220,46735,47474,48241
59863,5,283,42757,17106,2.80125e+13,172.714,2839.51,59863,226,175,18622,6606,4008,4224,1678
41158,80,248,29397,11761,2.80209e+13,172.008,2337.95,41158,191,175,33956,28559,14125,19302,20749
8007,165,189,5714,2293,2.81706e+13,163.836,1013.36,8007,122,113,7688,6110,7046,7427,7433
35150,92,237,25104,10046,2.80116e+13,171.624,2155.14,35150,180,167,29743,24519,13880,17501,19897
40091,91,247,28631,11460,2.80327e+13,171.98,2307.53,40091,189,175,33868,27960,15717,19739,22351
35018,226,237,25014,10004,2.79925e+13,171.801,2151.57,35018,180,167,34781,34781,34612,34686,34770
22957,189,216,16397,6560,2.80653e+13,170.62,1732.93,22957,159,145,22741,22741,21640,22175,22714
52238,130,268,37311,14927,2.80099e+13,172.41,2644.6,52238,211,175,47791,39357,32882,33260,39517
77751,125,315,55535,22216,2.80163e+13,172.992,3252.97,77751,258,175,70486,58444,47440,48236,57363
81950,226,322,58540,23410,2.80017e+13,173.059,3342.87,81950,266,175,81628,81628,75793,78765,81532
55976,62,275,39982,15994,2.80008e+13,172.612,2741.54,55976,218,175,44375,36317,15189,17219,22313
82243,103,323,58736,23507,2.80166e+13,172.986,3349.38,82243,265,175,71314,60355,37254,44494,51045
66880,255,295,47771,19109,2.8004e+13,172.829,3007.22,66880,238,175,66585,66585,64593,65587,66545
32723,177,233,23374,9349,2.7998e+13,171.606,2077.92,32723,176,162,32490,32490,29390,30955,32434
37553,339,800,26915,10638,2.61253e+13,207.864,3222.92,37553,777,167,36429,35892,33228,34415,35370
97567,244,351,69690,27877,2.80091e+13,173.218,3662.99,97567,294,175,97216,97216,90692,94018,97109
4370,133,182,3120,1250,2.81915e+13,156.246,745.68,4370,103,99,3901,3250,2797,2590,3294
93492,67,343,66781,26711,2.80085e+13,173.161,3581.34,93492,286,175,75002,61851,27213,23711,38840
38447,10,244,27457,10990,2.80302e+13,171.949,2258.3,38447,187,173,17579,9532,5289,2569,2030
3016,173,179,2153,863,2.80581e+13,146.575,617.097,3016,93,87,2831,2326,2787,2805,2806
24085,169,217,17203,6882,2.79376e+13,170.664,1774.91,24085,160,147,23622,18594,21358,22627,23194
7243,136,187,5174,2069,2.81097e+13,162.741,962.813,7243,119,109,6593,5422,4891,5181,5644
9364,99,190,6690,2674,2.79523e+13,165.381,1095.9,9364,127,118,7966,6763,4114,4882,5660
56255,223,276,40184,16071,2.80096e+13,172.657,2749.12,56255,219,175,55979,55979,53097,54549,55926
91685,303,340,65491,26194,2.80108e+13,173.138,3545.2,91685,283,175,91345,91345,89545,90439,91308
12466,69,197,8901,3565,2.80899e+13,167.515,1268.75,12466,138,126,9997,8254,3755,4149,5406
30432,190,229,21738,8694,2.80145e+13,171.437,2001.84,30432,172,158,30203,30203,28261,29229,30164
11551,43,195,8247,3304,2.80233e+13,166.906,1220.42,11551,135,124,8573,6806,2540,3084,3410
34413,502,800,24673,9740,2.59807e+13,216.847,3126.04,34413,726,165,33477,33154,32360,32712,32719
25845,13,221,18455,7390,2.80345e+13,170.83,1840.89,25845,163,150,13217,8928,3883,1911,1807
52196,45,269,37275,14921,2.80271e+13,172.424,2644.73,52196,211,175,39183,31147,11654,14200,15764
21070,218,236,15055,6015,2.80662e+13,169.733,1685.33,21070,155,141,20834,20834,20404,20595,20816
79895,247,319,57066,22829,2.80082e+13,173.065,3299.53,79895,262,175,79576,79576,75432,77533,79504
38223,18,243,27305,10918,2.80323e+13,171.895,2250.95,38223,186,173,22180,15762,6440,5678,4561
74953,23,800,53627,21326,2.70785e+13,234.295,4155.7,74953,798,175,47249,34773,12573,12450,13886
48225,581,800,34547,13678,2.65218e+13,208.832,3525.17,48225,786,175,47335,46942,44158,45560,46768
76097,243,311,54358,21739,2.80018e+13,172.935,3215.48,76097,254,175,75786,75786,71872,73855,75718
51137,253,266,36524,14613,2.80128e+13,172.381,2615.58,51137,209,175,50871,50871,50640,50740,50858
68632,25,441,49000,19632,2.81383e+13,173.054,3234.54,68632,240,192,44782,32629,11730,7885,12276
58283,234,279,41630,16653,2.79964e+13,172.648,2799.25,58283,222,175,58004,58004,55646,56830,57959
39579,363,800,28359,11220,2.62394e+13,208.269,3283.56,39579,783,170,38473,37914,34883,36323,37468
97138,12,349,69387,27751,2.80038e+13,173.176,3653.31,97138,292,175,47939,30380,14402,10009,5917
72844,284,306,52028,20816,2.80152e+13,172.942,3144.23,72844,249,175,72538,72538,71770,72134,72516
45508,228,256,32508,13000,2.79877e+13,172.289,2462.68,45508,199,175,45252,45252,44062,44642,45224
73027,330,800,52248,20779,2.70581e+13,234.776,4114.84,73027,798,175,71811,71301,62972,67069,70733
30429,161,229,21735,8694,2.80033e+13,171.434,2001.87,30429,172,158,29458,23228,26557,28424,27960
3618,77,181,2583,1035,2.82923e+13,152.439,678.465,3618,98,93,2898,2443,1219,1095,1624
92617,238,341,66162,26455,2.79949e+13,173.13,3563.3,92617,284,175,92276,92276,85974,89188,92173
83907,212,326,59933,23974,2.80097e+13,173.101,3384.88,83907,269,175,83581,83581,76551,80138,83467
62970,104,288,44981,17989,2.79965e+13,172.741,2914.51,62970,231,175,54681,46196,29055,28407,38721
32524,47,348,23222,9302,2.82601e+13,169.14,2221.3,32524,175,171,24603,19737,6499,4963,4190
75799,216,311,54146,21653,2.80004e+13,172.969,3209.63,75799,254,175,75488,75488,69756,72675,75393
9449,96,191,6749,2700,2.80882e+13,165.558,1101.61,9449,127,118,8002,6607,3959,4017,5606
68896,80,299,49214,19682,2.80204e+13,172.877,3054.38,68896,242,175,56872,47808,23559,21221,34061
15194,59,201,10856,4338,2.79668e+13,168.763,1402.52,15194,144,131,11903,9731,4048,3591,5618
94819,289,346,67722,27097,2.8019e+13,173.146,3608.51,94819,288,175,94473,94473,91319,92911,94416
69346,724,800,49620,19726,2.70061e+13,218.185,4034.5,69346,798,175,68546,68320,62806,65656,68319
12626,94,196,9022,3604,2.78897e+13,167.901,1276.27,12626,139,127,10659,8813,5138,5272,7272
27478,170,224,19632,7846,2.79977e+13,171.192,1899.9,27478,167,154,27014,21257,24368,25830,26536
28235,44,225,20171,8064,2.79902e+13,171.198,1926.35,28235,169,155,21101,16681,6371,4467,7649
62044,279,287,44310,17734,2.80309e+13,172.648,2892.73,62044,229,175,61757,61757,61675,61704,61749
18104,166,207,12932,5172,2.80602e+13,169.728,1534.7,18104,150,137,17618,13926,15961,16937,17074
18765,1696,1961,11012,7753,2.84209e+13,318.113,4379.21,18765,624,207,16804,16804,16578,16687,16152
59504,42,281,42511,16993,2.79827e+13,172.653,2829.28,59504,225,175,44085,34846,12837,10027,16525
81446,768,800,58264,23182,2.71533e+13,227.21,4290.78,81446,798,175,80646,80408,73435,77060,80551
95178,445,800,68066,27112,2.72816e+13,231.211,4559.04,95178,798,175,94071,93412,85022,89493,93297
49211,87,263,35149,14062,2.80104e+13,172.377,2564.68,49211,206,175,41231,34326,18710,18194,26183
60807,267,284,43434,17373,2.80129e+13,172.697,2861.9,60807,227,175,60523,60523,60102,60287,60506
29364,143,227,20973,8391,2.80266e+13,171.244,1965.36,29364,170,157,27475,22154,21681,23972,24313
5635,93,184,4024,1611,2.80851e+13,160.221,847.788,5635,110,104,4720,3918,2279,2621,3177
93312,786,800,66736,26576,2.72629e+13,223.365,4524,93312,798,180,92512,92298,89836,90839,92471
53894,132,271,38493,15401,2.80166e+13,172.465,2687.68,53894,214,175,49497,40606,34496,35093,41488
19733,24,209,14089,5644,2.80271e+13,169.688,1602.28,19733,152,139,12696,9311,3376,3163,3852
36400,208,240,25995,10405,2.80244e+13,171.829,2195.11,36400,183,169,36160,36160,34698,35418,36128
46002,232,257,32854,13148,2.79963e+13,172.258,2476.7,46002,200,175,45745,45745,44774,45243,45720
42453,51,251,30325,12128,2.79919e+13,172.158,2376.27,42453,194,175,32540,26307,10466,9310,14003
40847,140,248,29175,11672,2.80171e+13,172.064,2329.49,40847,191,175,38079,30763,29276,29655,33207
66143,136,294,47241,18902,2.80223e+13,172.742,2990.02,66143,236,175,61247,49840,44829,47568,52381
12996,86,197,9281,3715,2.79409e+13,167.756,1294.86,12996,139,127,10814,9052,4848,4475,6658
31338,45,230,22389,8949,2.79819e+13,171.473,2031.71,31338,173,160,23508,18686,6975,8716,9800
44714,76,255,31931,12783,2.80218e+13,172.2,2440.7,44714,198,175,36575,30378,14887,12661,20931
94443,660,800,67550,26893,2.72584e+13,238.322,4545.25,94443,798,175,93537,93347,84159,88875,93224
11268,110,194,8048,3220,2.79148e+13,167.005,1204.46,11268,133,124,9843,8276,5699,5467,7320
36561,754,800,26204,10357,2.60948e+13,215.098,3193.18,36561,798,165,35761,35577,32203,33913,35624
22396,135,215,15990,6406,2.80517e+13,170.377,1710.97,22396,157,144,20621,16852,14958,15850,17616
56736,237,800,40614,16122,2.67819e+13,219.246,3742.27,56736,798,175,55463,55039,48996,51681,54135
30209,144,229,21578,8631,2.80209e+13,171.335,1994.58,30209,172,158,28337,22796,22395,24817,25109
61099,134,285,43635,17464,2.80266e+13,172.709,2869.53,61099,228,175,56345,46029,40415,42515,48078
97570,19,351,69691,27879,2.80241e+13,173.183,3662.94,97570,294,175,57862,41297,16609,9897,15302
51685,185,267,36925,14760,2.79827e+13,172.444,2630.09,51685,210,175,51418,51418,46547,49023,51336
48467,209,261,34617,13850,2.80076e+13,172.252,2543.71,48467,204,175,48206,48206,45380,46803,48154
53172,46,270,37982,15190,2.79998e+13,172.545,2669.53,53172,214,175,40049,32098,12030,8959,15613
2994,34,180,2138,856,2.80751e+13,149.204,617.288,2994,93,86,2069,1665,585,418,589
95781,550,800,68503,27278,2.72833e+13,233.245,4570.36,95781,790,180,94855,94455,91266,92887,94231
65968,216,293,47125,18843,2.79941e+13,172.843,2985.56,65968,237,175,65675,65675,61135,63439,65598
46556,253,258,33250,13306,2.80079e+13,172.319,2492.15,46556,201,175,46298,46298,46262,46273,46293
77538,146,314,55385,22153,2.79952e+13,172.964,3247.54,77538,257,175,73215,58713,58542,57159,64825
59832,304,422,42720,17112,2.81564e+13,172.865,3018.8,59832,232,192,59410,59397,56598,54064,57274
43545,169,253,31102,12443,2.80207e+13,172.266,2408.04,43545,196,175,42830,33647,38367,40879,41772
91346,202,339,65251,26095,2.79991e+13,173.141,3537.96,91346,282,175,91007,91007,82413,86804,90870
18512,649,800,13318,5194,2.42092e+13,217.403,2536.61,18512,753,133,17712,17532,16430,16984,17260
78088,125,315,55781,22307,2.80018e+13,173.007,3259.71,78088,258,175,70806,58702,47633,45190,57705
16596,193,204,11854,4742,2.80053e+13,169.323,1467.72,16596,147,134,16392,16392,16245,16307,16381
99579,290,354,71128,28451,2.8013e+13,173.205,3701.71,99579,297,175,99225,99225,95612,97438,99161
44341,292,800,31759,12582,2.64508e+13,211.545,3419.86,44341,798,175,43148,42667,38401,40310,42007
18329,191,208,13090,5239,2.80306e+13,169.729,1544.89,18329,150,137,18121,18121,17721,17893,18104
66260,142,294,47328,18932,2.80068e+13,172.746,2992.66,66260,236,175,62068,50049,48487,53602,54248
58412,153,280,41719,16693,2.80238e+13,172.593,2803.06,58412,222,175,55844,44222,47973,50594,51319
85870,18,800,61424,24446,2.71874e+13,252.916,4379.23,85870,795,175,49646,35608,14273,9513,13296
58865,59,280,42051,16814,2.79899e+13,172.657,2813.6,58865,223,175,46293,37766,15570,16521,22144
88860,303,335,63467,25393,2.8014e+13,173.094,3487.68,88860,278,175,88525,88525,87064,87784,88493
64304,99,290,45932,18372,2.7996e+13,172.8,2946.17,64304,233,175,55276,46594,27910,26323,38246
8198,38,189,5851,2347,2.80636e+13,164.704,1025.97,8198,123,114,5909,4637,1648,1574,2101
14925,39,201,10660,4265,2.80087e+13,168.84,1390.37,14925,144,131,10869,8510,3144,3496,3943
99154,97,353,70825,28329,2.79967e+13,173.199,3693.14,99154,296,175,84919,71870,41813,42011,57508
2161,97,178,1546,615,2.79511e+13,136.882,521.887,2161,83,77,1762,1539,943,911,1178
86488,91,330,61775,24713,2.7996e+13,173.083,3438.01,86488,273,175,73123,60345,33886,34768,47890
44082,94,254,31485,12597,2.8018e+13,172.187,2423.01,44082,197,175,37490,30819,17806,17415,25257
71213,74,303,50868,20345,2.80123e+13,172.881,3107.07,71213,246,175,58021,47627,23052,17439,32214
30587,93,229,21851,8736,2.79784e+13,171.459,2006.8,30587,172,159,25927,21377,12209,12659,17131
64936,140,291,46389,18547,2.79967e+13,172.842,2961.12,64936,235,175,60585,48920,46564,49481,53307
68976,350,800,49357,19619,2.69856e+13,222.862,4026.23,68976,773,180,67867,67258,64940,65927,66826
22132,162,214,15809,6323,2.80236e+13,170.465,1700.3,22132,157,144,21419,16919,19322,18515,20458
95141,221,346,67957,27184,2.801e+13,173.15,3614.29,95141,289,175,94795,94795,87047,91003,94670
99099,319,494,70760,28339,2.80975e+13,173.284,3877.1,99099,294,193,98605,98605,92714,87369,93436
13528,23,199,9665,3863,2.79868e+13,168.399,1323.24,13528,142,128,8566,6255,2309,2128,2495
77870,174,800,55712,22158,2.71002e+13,228.937,4217.12,77870,773,180,76341,60956,66699,70934,74483
82544,179,323,58959,23585,2.80031e+13,173.031,3355.29,82544,266,175,82221,82221,73139,77782,82077
13706,142,199,9792,3914,2.79829e+13,168.232,1331.34,13706,142,129,12739,10318,9990,9701,11165
24386,121,218,17422,6964,2.79911e+13,170.757,1786.8,24386,162,148,21855,18133,13863,14850,17406
48984,680,800,35082,13902,2.65679e+13,210.155,3545.47,48984,797,175,48181,47972,44443,46229,47825
60750,41,800,43483,17267,2.68781e+13,212.288,3838.58,60750,797,175,44231,35042,12516,9091,15465
67783,189,297,48421,19362,2.80214e+13,172.856,3028.6,67783,240,175,67486,67486,60885,64248,67378
63648,560,800,45549,18099,2.69085e+13,213.299,3906.26,63648,798,175,62715,62336,58052,60205,62128
16418,82,204,11727,4691,2.79915e+13,169.379,1460.04,16418,147,134,13546,11398,5776,5775,8297
60654,693,800,43416,17238,2.68556e+13,213.464,3836.44,60654,798,175,59851,59631,55296,57489,59534
33307,88,234,23790,9517,2.79931e+13,171.612,2096.64,33307,177,164,27940,23221,12805,12289,17804
51294,109,267,36637,14657,2.8023e+13,172.503,2620.69,51294,210,175,45001,37708,25216,23135,33214
9330,23,191,6667,2663,2.8024e+13,165.756,1094.91,9330,127,117,5903,4314,1600,1475,1689
21470,15,213,15334,6136,2.80155e+13,170.233,1674.02,21470,156,142,11640,8039,3385,1988,2716
91529,337,339,65375,26154,2.80109e+13,173.075,3541.18,91529,282,175,91190,91190,91186,91186,91188
74800,28,800,53516,21284,2.7068e+13,221.602,4152.22,74800,798,175,49775,37578,12570,14139,16147
24398,131,218,17428,6970,2.79659e+13,170.785,1787.26,24398,161,148,22308,18358,15431,14547,18493
73553,115,307,52538,21015,2.80074e+13,172.935,3159.7,73553,250,175,65371,54493,38699,34880,49449
9126,178,190,6524,2602,2.78787e+13,165.449,1082.16,9126,127,117,8936,8936,8736,8823,8924
84559,189,327,60400,24159,2.80052e+13,173.044,3398.26,84559,270,175,84232,84232,75553,79989,84094
55144,6,274,39391,15753,2.80071e+13,172.571,2720.71,55144,217,175,19441,7372,4884,3287,1789
99250,309,354,70896,28354,2.80008e+13,173.242,3696.06,99250,297,175,98896,98896,96593,97745,98851
43379,143,253,30982,12397,2.80436e+13,172.194,2403.38,43379,196,175,40662,32743,32023,35450,35839
4690,129,183,3352,1338,2.82798e+13,157.651,773.423,4690,107,100,4185,3488,2930,2949,3483
17769,106,206,12695,5074,2.7987e+13,169.556,1519.58,17769,150,135,15446,13014,8497,8087,11169
3537,36,180,2523,1014,2.77059e+13,151.617,669.276,3537,95,91,2500,1993,688,820,901
19932,75,210,14237,5695,2.80015e+13,169.943,1611.52,19932,153,140,16231,13429,6626,6872,9384
32513,4,232,23219,9294,2.80013e+13,171.483,2070.27,32513,175,162,8518,2585,1875,2234,1975
14048,176,199,10037,4011,2.79431e+13,168.206,1347.53,14048,142,129,13849,13849,12990,13401,13826
34329,203,236,24523,9806,2.79965e+13,171.705,2129.71,34329,179,166,34093,34093,32571,33322,34060
56818,69,277,40580,16238,2.8017e+13,172.597,2763.17,56818,220,175,45769,37691,16871,17094,24753
26387,38,222,18847,7540,2.80296e+13,171.092,1861.07,26387,165,151,19098,14965,5319,5391,7062
43427,379,722,31023,12404,2.77465e+13,187.517,2992.97,43427,194,193,42705,42684,42264,42220,42384
11972,175,195,8554,3418,2.79434e+13,167.281,1242,11972,136,125,11777,11777,11124,11430,11757
67050,255,296,47894,19156,2.80064e+13,172.859,3011.84,67050,239,175,66754,66754,64722,65734,66713
68686,248,298,49062,19624,2.80015e+13,172.841,3048.78,68686,241,175,68388,68388,65698,67051,68338
58507,216,280,41792,16715,2.79831e+13,172.719,2805.58,58507,223,175,58227,58227,54631,56448,58163
76479,148,312,54625,21854,2.80054e+13,172.953,3224.19,76479,255,175,72495,57910,58439,60781,65269
16420,48,204,11725,4695,2.80484e+13,169.412,1460.46,16420,147,133,12421,10015,3816,3681,5118
61804,136,286,44147,17657,2.80053e+13,172.737,2886.45,61804,229,175,57218,46561,41876,41548,48648
64719,379,800,46314,18405,2.69376e+13,233.266,3930.52,64719,798,175,63561,63008,55377,59244,62644
89796,183,337,64141,25655,2.8023e+13,173.119,3507.27,89796,280,175,89459,89459,79724,84702,89305
84090,170,412,60061,24029,2.80659e+13,172.499,3502.36,84090,269,181,82928,65176,51921,42043,43480
8636,21,190,6173,2463,2.81239e+13,165.113,1053.13,8636,125,115,5310,3793,1485,1215,1522
40984,66,800,29366,11618,2.62606e+13,215.375,3324.54,40984,798,173,32071,26682,11385,11294,15664
55266,19,274,39474,15792,2.80089e+13,172.596,2723.66,55266,217,175,32762,23377,9403,5498,7720
2906,154,180,2077,829,2.81009e+13,147.416,607.134,2906,93,85,2642,2153,2361,2440,2481
2207,142,178,1576,631,2.80067e+13,138.279,528.391,2207,83,81,1933,1624,1559,1576,1696
2502,67,178,1781,721,2.81945e+13,140.328,560.512,2502,88,83,1958,1649,786,1116,1086
57431,184,277,41027,16404,2.79876e+13,172.669,2777.62,57431,221,175,57154,57154,51522,54389,57061
59481,282,422,42468,17013,2.81473e+13,172.839,3011.44,59481,231,192,59059,58939,53389,51658,56314
59564,225,282,42545,17019,2.80184e+13,172.718,2831.93,59564,225,175,59282,59282,56139,57724,59225
75415,79,311,53863,21552,2.80272e+13,172.932,3201.73,75415,253,175,62139,51800,25552,26638,37161
83384,224,325,59558,23826,2.80182e+13,173.074,3373.69,83384,268,175,83059,83059,76926,80051,82958
31186,13,531,22288,8898,2.75088e+13,168.115,2385.8,31186,308,159,15944,10860,4608,2288,177
89063,290,335,63617,25446,2.8007e+13,173.108,3491.55,89063,279,175,88728,88728,86369,87553,88683
81550,578,800,58338,23212,2.71532e+13,237.194,4292.64,81550,798,175,80572,80206,71645,76012,80084
85384,25,328,60987,24397,2.79952e+13,173.066,3415.01,85384,271,175,55719,40595,14521,11741,17215
87815,12,332,62731,25084,2.79882e+13,173.126,3465.24,87815,276,175,43338,27456,13012,9046,11181
61118,188,285,43656,17462,2.80132e+13,172.781,2870.09,61118,228,175,60833,60833,54987,57963,60736
13071,156,197,9344,3727,2.78667e+13,168.045,1298.99,13071,141,128,12470,9907,11059,11195,11573
13680,48,199,9768,3912,2.80363e+13,168.15,1330.15,13680,142,128,10349,8354,3183,2537,4157
97805,332,494,69833,27972,2.8105e+13,173.314,3854.64,97805,293,194,97311,97311,87258,92411,96316
83781,791,800,59933,23848,2.71712e+13,247.368,4337.8,83781,735,180,82981,82850,82801,82880,82955
33264,731,800,23859,9405,2.58621e+13,208.138,3088.8,33264,776,160,32464,32292,30337,31299,32258
46066,103,257,32908,13158,2.7991e+13,172.22,2478.11,46066,200,175,39914,33790,20875,19484,28401
50816,12,266,36299,14517,2.80124e+13,172.471,2607.76,50816,209,175,25077,15896,7538,3580,3352
47945,110,260,34255,13690,2.79806e+13,172.43,2529.74,47945,204,175,42119,35334,24189,23083,31353
26891,153,222,19209,7682,2.7986e+13,171.028,1878.05,26891,165,152,25642,20336,22043,23240,23571
83226,395,800,59541,23685,2.71646e+13,251.591,4326.71,83226,795,175,82046,81482,71330,76697,81145
82829,130,324,59165,23664,2.80037e+13,173.049,3361.82,82829,267,175,75828,62417,52118,47652,62869
83879,17,326,59914,23965,2.80073e+13,173.093,3384.35,83879,269,175,47612,33819,14102,8654,8980
60156,52,283,42960,17196,2.80212e+13,172.627,2846,60156,225,175,46301,37525,14610,13412,20384
32276,195,232,23053,9223,2.79975e+13,171.517,2062.88,32276,175,162,32044,32044,30244,31138,32007
54233,53,272,38738,15495,2.79973e+13,172.538,2697.04,54233,215,175,41876,34408,13273,14455,18201
89436,17,336,63880,25556,2.80115e+13,173.101,3499.46,89436,279,175,50770,36067,15044,9231,12254
38743,181,244,27670,11073,2.80049e+13,172.011,2266.78,38743,187,174,38499,38499,34930,36735,38436
89876,156,337,64195,25681,2.80138e+13,173.13,3508.82,89876,280,175,86480,68378,76612,81297,80281
48032,216,261,34305,13727,2.80062e+13,172.402,2533.05,48032,204,175,47771,47771,45438,46607,47726
53684,116,271,38339,15345,2.80003e+13,172.566,2682.92,53684,214,175,47765,39760,28349,27142,36648
52094,223,268,37211,14883,2.799e+13,172.478,2641.16,52094,211,175,51826,51826,49488,50659,51781
45537,53,257,32534,13003,2.79946e+13,172.395,2464.78,45537,200,175,35141,28875,11111,10308,15594
44468,59,255,31753,12715,2.80344e+13,172.212,2434.45,44468,197,175,34959,28532,11770,11776,16855
76083,120,312,54342,21741,2.80087e+13,173.018,3216.45,76083,255,175,68284,56501,42499,37031,53569
32587,68,233,23277,9310,2.80025e+13,171.641,2073.75,32587,176,162,26160,21603,9544,8882,13892
44016,684,800,31530,12486,2.64222e+13,219.181,3410.65,44016,735,180,43216,43048,42456,42741,42869
25809,172,221,18436,7373,2.803e+13,170.867,1839.69,25809,164,150,25453,20202,22984,24296,25169
67212,282,296,48014,19198,2.80207e+13,172.853,3015.38,67212,239,175,66916,66916,66658,66768,66902
33543,211,235,23960,9583,2.80188e+13,171.718,2105.24,33543,178,164,33308,33308,32405,32839,33284
67520,184,440,48207,19313,2.81221e+13,172.171,3208.77,67520,244,175,67080,67006,59957,63373,66587
35452,41,238,25326,10126,2.80311e+13,171.738,2165.36,35452,181,168,26122,20569,7462,9497,10273
57190,138,277,40852,16338,2.79898e+13,172.566,2771.77,57190,220,175,53167,43093,39985,39168,45620
21187,65,213,15130,6057,2.80973e+13,170.185,1663.46,21187,155,142,16875,13973,5909,6859,8815
73359,119,307,52399,20960,2.80162e+13,172.94,3155.82,73359,250,175,65705,54481,40574,35580,51161
77375,156,800,55356,22019,2.70898e+13,226.402,4206.55,77375,798,175,73436,58169,63984,63672,66551
81090,284,320,57923,23167,2.79983e+13,173.022,3323.98,81090,263,175,80770,80770,79029,79895,80734
39272,187,245,28050,11222,2.80113e+13,171.976,2282.59,39272,188,175,39027,39027,35835,37446,38969
94278,80,345,67345,26933,2.80155e+13,173.187,3597.81,94278,288,175,77846,65433,32223,26477,46536
42280,213,251,30196,12084,2.80333e+13,172.133,2371.95,42280,194,175,42029,42029,40178,41098,41991
55940,226,275,39961,15979,2.80037e+13,172.552,2740.37,55940,218,175,55665,55665,53049,54363,55616
10623,21,194,7585,3038,2.81387e+13,166.312,1170.16,10623,132,122,6545,4674,1830,1190,1575
11071,347,658,7933,3138,2.57283e+13,152.838,1727.38,11071,357,121,10413,10404,8993,6709,425
62241,699,800,44550,17691,2.68812e+13,236.29,3873.29,62241,794,175,61402,61176,54002,57697,61139
16888,180,205,12065,4823,2.79795e+13,169.611,1481.62,16888,148,135,16683,16683,15739,16191,16658
62910,122,288,44940,17970,2.80098e+13,172.756,2913.2,62910,231,175,56664,46943,36514,30876,45146
64464,351,431,46022,18442,2.8171e+13,172.89,3132,64464,232,192,64033,64033,60111,59374,63416
51438,194,267,36741,14697,2.80021e+13,172.447,2624.13,51438,210,175,51171,51171,46935,49084,51098
17431,55,205,12454,4977,2.79561e+13,169.353,1504.16,17431,148,135,13513,11079,4390,3583,6144
52408,154,269,37432,14976,2.80131e+13,172.468,2649.78,52408,212,175,50186,39669,44168,45946,46273
1615,98,177,1151,464,2.80729e+13,122.934,450.771,1615,74,68,1297,1146,758,847,938
74414,113,308,53159,21255,2.79936e+13,172.943,3178.38,74414,252,175,65839,55136,38762,35026,49858
56920,82,277,40661,16259,2.80014e+13,172.642,2765.7,56920,220,175,47186,39590,19972,19903,28850
16986,176,205,12125,4861,2.80504e+13,169.2,1485.25,16986,147,134,16781,16781,15523,16138,16752
8393,55,189,5992,2401,2.79987e+13,164.562,1037.27,8393,123,114,6481,5325,2128,2458,3035
99876,132,498,71315,28561,2.81002e+13,173.356,3895.52,99876,297,194,91737,75284,47048,34683,68405
50633,377,409,36144,14489,2.81663e+13,172.693,2788.11,50633,207,192,50224,50224,48922,49563,50192
50080,47,265,35773,14307,2.80022e+13,172.487,2588.55,50080,208,175,37850,30313,11538,11949,16143
85456,107,800,61131,24325,2.71857e+13,220.051,4371.28,85456,798,180,73872,62092,40370,45756,53528
87499,201,332,62498,25001,2.80024e+13,173.114,3459.3,87499,275,175,87167,87167,78966,83157,87036
55532,161,275,39668,15864,2.80294e+13,172.584,2730.93,55532,218,175,53871,42426,48523,51976,51289
33919,82,235,24234,9685,2.79862e+13,171.792,2116.72,33919,179,165,28072,23582,11908,10236,17048
47318,122,259,33804,13514,2.79794e+13,172.336,2512.62,47318,203,175,42595,35302,27467,23223,33954
80544,453,460,57509,23035,2.81373e+13,173.123,3495.53,80544,261,192,80084,80084,80017,80041,80077
64540,194,291,46091,18449,2.80201e+13,172.706,2952.06,64540,233,175,64249,64249,58363,61361,64152
65317,65,292,46660,18657,2.79994e+13,172.801,2970.27,65317,236,175,52141,43091,18041,14795,26278
34861,220,237,24897,9964,2.80095e+13,171.73,2146.59,34861,180,167,34624,34624,34183,34378,34607
47817,661,800,34244,13573,2.65391e+13,220.129,3514.49,47817,798,175,46974,46783,41839,44361,46601
69008,730,800,49378,19630,2.7018e+13,220.22,4027.18,69008,780,180,68208,68031,65778,66911,67999
93563,333,343,66829,26734,2.80189e+13,173.131,3582.67,93563,286,175,93220,93220,93088,93142,93210
55419,260,274,39592,15827,2.79951e+13,172.619,2727.39,55419,218,175,55145,55145,54865,54988,55131
78085,252,315,55777,22308,2.79957e+13,172.99,3259.53,78085,258,175,77770,77770,74208,76009,77707
88178,329,333,62987,25191,2.79943e+13,173.072,3472.86,88178,276,175,87845,87845,87822,87828,87841
34291,224,236,24494,9797,2.80029e+13,171.693,2128.6,34291,179,166,34055,34055,33859,33945,34043
34016,61,235,24295,9721,2.79727e+13,171.635,2119.2,34016,178,165,26874,22003,9215,9694,12931
36906,631,800,26446,10460,2.61447e+13,215.885,3203.3,36906,798,166,36051,35882,32050,34023,35599
86071,264,467,61461,24610,2.81037e+13,173.219,3609.85,86071,285,184,85604,85484,78607,77580,82530
20064,55,211,14335,5729,2.79856e+13,170.28,1618.16,20064,154,140,15547,12749,5016,3727,6763
29087,56,227,20778,8309,2.80417e+13,171.293,1956.45,29087,170,156,22650,18602,7333,8596,10831
51174,27,267,36547,14627,2.8031e+13,172.423,2617.48,51174,209,175,34033,25354,8719,5946,9499
92465,20,341,66049,26416,2.80029e+13,173.137,3560.5,92465,284,175,56007,39625,15730,9368,13841
17119,189,205,12227,4892,2.80134e+13,169.501,1491.3,17119,148,135,16914,16914,16544,16704,16898
4568,83,182,3258,1310,2.79256e+13,156.649,761.978,4568,104,99,3738,3153,1669,1793,2398
77043,139,453,55011,22032,2.8122e+13,173.096,3418.95,77043,256,193,71692,58078,35523,22940,53365
59307,72,282,42360,16947,2.8033e+13,172.613,2825.8,59307,224,175,48098,39562,18518,26722,27190
66005,210,293,47148,18857,2.80019e+13,172.794,2986.12,66005,236,175,65712,65712,60790,63291,65629
13261,98,198,9471,3790,2.80195e+13,168.073,1309.09,13261,141,128,11315,9580,5763,5566,7735
77767,28,315,55553,22214,2.79978e+13,173.01,3253.26,77767,258,175,52149,39085,13231,9283,14449
31792,103,232,22703,9089,2.80473e+13,171.561,2047.88,31792,175,161,27513,23300,14388,13667,19778
67750,290,296,48399,19351,2.79935e+13,172.837,3026.86,67750,240,175,67454,67454,67402,67420,67448
43648,81,800,31269,12379,2.63836e+13,208.458,3400.21,43648,778,175,35334,29863,14719,14344,20653
15820,99,203,11298,4522,2.8053e+13,169.1,1432.97,15820,146,132,13531,11434,6871,6509,9297
54735,238,273,39096,15639,2.80106e+13,172.553,2710,54735,216,175,54462,54462,52810,53629,54427
2549,104,178,1829,720,2.73968e+13,143.842,567.09,2549,86,80,2125,1836,1193,1196,1547
7328,30,187,5245,2083,2.78216e+13,163.722,968.932,7328,121,110,4966,3759,1253,1173,1284
75625,59,311,54015,21610,2.80127e+13,172.945,3206.01,75625,254,175,59489,48535,19988,16042,28165
28614,195,226,20442,8172,2.79835e+13,171.235,1939.59,28614,169,156,28388,28388,27032,27698,28357
62446,191,287,44600,17846,2.8015e+13,172.685,2901.79,62446,229,175,62159,62159,56333,59302,62063
91367,338,800,65354,26013,2.72206e+13,225.493,4486.54,91367,798,180,90218,89609,85339,87295,89131
14962,172,201,10691,4271,2.7996e+13,168.746,1392.01,14962,144,130,14686,11688,13511,14127,14630
6477,109,185,4626,1851,2.78899e+13,161.863,909.082,6477,115,106,5599,4734,3199,3151,4185
73016,231,306,52152,20864,2.80128e+13,172.912,3147.67,73016,249,175,72710,72710,68352,70560,72635
4300,149,182,3072,1228,2.81923e+13,155.77,739.645,4300,103,99,3959,3214,3242,3374,3581
84987,219,474,60681,24306,2.81159e+13,173.216,3596.87,84987,285,184,84513,84390,74125,71764,81630
11115,97,194,7942,3173,2.7957e+13,167.157,1197.11,11115,134,123,9455,8025,4680,3861,6386
77552,116,314,55398,22154,2.80047e+13,173.031,3248.03,77552,258,175,69037,57454,40960,39130,53988
37477,65,242,26770,10707,2.80117e+13,171.948,2228.61,37477,185,171,29891,24715,10350,7833,14652
27508,63,224,19652,7856,2.80134e+13,171.27,1901.23,27508,167,153,21822,18029,7514,7010,11102
64117,131,290,45796,18321,2.8003e+13,172.745,2941.86,64117,233,175,58787,48309,40574,38176,48731
58897,51,280,42072,16825,2.79819e+13,172.652,2814.48,58897,223,175,45167,36515,14493,15457,19353
89201,224,335,63717,25484,2.8e+13,173.085,3494.04,89201,278,175,88866,88866,82028,85516,88755
79704,148,458,56914,22790,2.81282e+13,173.135,3477.1,79704,274,185,75446,60370,54986,53412,65616
40676,118,247,29060,11616,2.79756e+13,172.082,2323.8,40676,190,175,36316,30122,22358,20702,28100
19684,148,210,14054,5630,2.80254e+13,169.762,1601.49,19684,152,139,18556,14879,15008,16394,16724
45617,52,257,32579,13038,2.80289e+13,172.215,2466.53,45617,199,175,35098,28454,11342,13484,15744
78918,30,317,56369,22549,2.80088e+13,173.026,3278.3,78918,260,175,53776,40663,13569,12717,14070
57971,75,278,41407,16564,2.80014e+13,172.588,2791.01,57971,221,175,47318,39089,19226,26521,27654
45784,100,257,32700,13084,2.8022e+13,172.267,2470.78,45784,200,175,39439,33250,20449,19236,27373
29614,9,227,21159,8455,2.79752e+13,171.464,1973.77,29614,171,158,12950,6250,3692,2355,2503
53419,120,271,38159,15260,2.79915e+13,172.586,2676.5,53419,214,175,47905,39659,29850,26013,37817
15727,397,741,11273,4454,2.58734e+13,160.123,2088.68,15727,445,130,14986,14901,12930,9641,726
56107,199,276,40073,16034,2.80107e+13,172.665,2745.57,56107,219,175,55831,55831,51346,53622,55754
10549,127,193,7536,3013,2.79889e+13,166.401,1164.96,10549,131,122,9510,7899,6513,5514,7772
90536,27,338,64665,25871,2.80164e+13,173.154,3522.08,90536,281,175,60227,44855,15418,14914,18646
42752,97,252,30538,12214,2.80168e+13,172.227,2385.55,42752,195,175,36567,30963,18026,17255,24786
31331,143,231,22376,8955,2.80241e+13,171.451,2032.27,31331,174,160,29340,23644,23112,25580,25868
45343,308,402,32368,12975,2.82136e+13,172.558,2644.94,45343,213,176,44941,44835,43848,42598,44129
50210,167,265,35865,14345,2.80112e+13,172.477,2591.79,50210,208,175,49233,38718,44094,47085,48106
41752,281,388,29798,11954,2.82156e+13,172.36,2534.16,41752,199,176,41364,41244,40714,40560,40855
57211,121,277,40871,16340,2.79845e+13,172.578,2772.27,57211,220,175,51436,42594,32484,28511,40692
4214,149,182,3008,1206,2.81334e+13,154.888,731.813,4214,104,97,3876,3154,3194,3444,3551
31041,220,230,22173,8868,2.80364e+13,171.394,2022.3,31041,173,160,30811,30811,30679,30733,30801
93803,131,344,66998,26805,2.80148e+13,173.163,3588.02,93803,287,175,86067,70693,59361,59882,72503
20477,62,211,14626,5851,2.80126e+13,170.063,1634.05,20477,154,141,16192,13283,5607,6495,8151
42056,91,250,30041,12015,2.79984e+13,172.168,2364.87,42056,193,175,35525,29324,16456,13199,22891
71866,662,800,51421,20445,2.70387e+13,230.306,4089.77,71866,761,180,71066,70885,69542,70207,70653
91622,481,483,65422,26200,2.81176e+13,173.257,3731.63,91622,298,177,91139,91139,91136,91135,91137
75493,51,800,54010,21483,2.70974e+13,243.291,4160.97,75493,775,175,57335,46515,18235,11664,587
78314,52,315,55932,22382,2.80091e+13,172.946,3264.04,78314,258,175,60291,48852,19014,24640,28052
24741,227,890,17740,7001,2.58081e+13,193.17,2812.38,24741,539,160,23722,23392,17201,18562,18036
83458,201,325,59616,23842,2.80069e+13,173.05,3375.07,83458,268,175,83133,83133,75442,79366,83009
49627,281,409,35416,14211,2.82096e+13,172.62,2762.96,49627,205,193,49218,49098,38950,37389,46137
64671,83,435,46179,18492,2.81156e+13,173.013,3142.21,64671,233,192,53701,45041,20720,16159,28313
73492,203,451,52476,21016,2.81071e+13,173.066,3346.03,73492,249,193,73041,72916,46732,26297,62959
72360,206,305,51681,20679,2.80158e+13,172.941,3133.11,72360,248,175,72055,72055,66058,69113,71956
42616,9,252,30438,12178,2.80203e+13,172.104,2381.82,42616,194,175,18646,9020,5320,3324,1919
22717,345,364,16198,6519,2.83988e+13,171.125,1908.23,22717,173,162,22353,22353,21938,22127,22298
95426,202,347,68162,27264,2.80089e+13,173.216,3620.65,95426,290,175,95079,95079,85969,90625,94934
55675,234,275,39767,15908,2.80207e+13,172.615,2734.44,55675,218,175,55400,55400,53354,54372,55359
24432,48,218,17446,6986,2.80075e+13,170.791,1788.35,24432,161,148,18513,14917,5691,5437,7985
34970,44,379,24955,10015,2.82642e+13,172.107,2330.46,34970,192,170,26162,20688,7757,6453,9915
55891,215,276,39918,15973,2.80207e+13,172.545,2740.3,55891,218,175,55615,55615,52220,53935,55554
70920,592,800,50753,20167,2.70122e+13,224.661,4069,70920,798,175,69983,69595,62953,66337,69496
39472,95,245,28191,11281,2.79835e+13,172,2288.18,39472,188,175,33618,27669,16314,14618,22181
62946,17,288,44955,17991,2.80139e+13,172.691,2913.87,62946,230,175,35730,25383,10588,6046,8376
61013,98,800,43667,17346,2.68684e+13,212.839,3844.88,61013,790,178,51534,43609,25634,23862,34517
33092,186,234,23638,9454,2.80092e+13,171.618,2090.14,33092,177,163,32858,32858,30310,31589,32810
15775,163,203,11262,4513,2.80706e+13,169.082,1430.87,15775,146,132,15248,12044,13782,14687,14656
80960,639,800,57921,23039,2.71528e+13,218.519,4280.75,80960,798,180,80092,79916,74688,77377,79678
4885,63,183,3486,1399,2.80733e+13,158.12,788.914,4885,107,100,3821,3190,1348,1032,1792
76075,423,800,54433,21642,2.70808e+13,235.889,4179.56,76075,798,175,74948,74344,65966,70429,74142
48109,177,261,34363,13746,2.80081e+13,172.348,2534.82,48109,204,175,47848,47848,42841,45387,47764
51228,46,800,36684,14544,2.66464e+13,221.736,3602.07,51228,640,175,38033,30661,11312,8225,14172
82463,20,323,58905,23558,2.80033e+13,173.047,3353.79,82463,267,175,49939,35340,14016,8353,12023
95707,283,348,68360,27347,2.8012e+13,173.171,3626.6,95707,290,175,95359,95359,91695,93547,95294
4130,62,182,2950,1180,2.82621e+13,155.259,725.455,4130,103,97,3213,2663,1148,866,1487
5778,88,184,4128,1650,2.78041e+13,160.044,857.919,5778,110,104,4791,4012,2247,2216,3040
84652,211,327,60462,24190,2.80044e+13,173.088,3400.13,84652,270,175,84325,84325,77151,80811,84209
10529,10,800,7603,2926,2.1463e+13,201.148,2117.72,10529,734,113,4930,3171,1344,784,73
75890,103,311,54205,21685,2.79965e+13,172.97,3211.41,75890,254,175,65800,55679,34343,34087,47001
40251,109,247,28753,11498,2.80086e+13,172.077,2312.12,40251,190,175,35315,29584,19788,18512,26016
20194,65,211,14420,5774,2.80497e+13,170.083,1623.03,20194,154,140,16080,13312,5603,4605,8068
6158,28,186,4396,1762,2.81001e+13,160.957,887.506,6158,115,106,4116,3094,1068,845,1243
82940,90,324,59243,23697,2.80053e+13,173.011,3364.04,82940,267,175,69959,57881,32393,40653,45901
35027,77,237,25024,10003,2.79853e+13,171.818,2151.91,35027,181,167,28684,23913,11787,11931,16921
35854,175,239,25608,10246,2.80152e+13,171.815,2178.13,35854,182,168,35615,35615,31978,33818,35551
61863,481,800,44283,17580,2.68702e+13,237.666,3864.95,61863,793,175,60805,60554,52792,56734,60105
4266,143,182,3040,1226,2.81863e+13,154.923,736.303,4266,103,97,3892,3188,3115,3416,3474
65448,159,293,46746,18702,2.80315e+13,172.786,2974.11,65448,235,175,63283,50016,57172,61277,59552
21013,45,212,15010,6003,2.80016e+13,170.156,1655.78,21013,155,142,15751,12528,4715,5859,6514
98166,293,351,70121,28045,2.80002e+13,173.234,3673.78,98166,295,175,97815,97815,94563,96205,97757
14670,24,201,10479,4191,2.80638e+13,168.726,1378.97,14670,144,130,9427,6927,2513,2211,2151
39437,230,245,28170,11267,2.79941e+13,172.054,2287.45,39437,188,175,39192,39192,38865,39007,39177
4123,127,181,2940,1183,2.77975e+13,154.591,723.102,4123,100,95,3660,3065,2543,2267,3010
23109,94,215,16510,6599,2.79476e+13,170.615,1737.62,23109,159,146,19594,16151,9444,9612,13406
11987,160,196,8564,3423,2.80495e+13,167.614,1244.36,11987,137,125,11491,9118,10395,11109,10908
63614,592,800,45521,18093,2.68964e+13,235.003,3904.93,63614,796,175,62668,62303,55009,58711,62190
92372,152,341,65981,26391,2.80067e+13,173.134,3558.95,92372,284,175,88216,69944,74091,79406,80411
23859,66,218,17040,6819,2.80251e+13,170.719,1767.82,23859,160,147,19048,15768,6866,7518,10084
50771,194,266,36259,14512,2.80233e+13,172.353,2606.39,50771,208,175,50505,50505,46319,48442,50433
34846,174,237,24890,9956,2.80054e+13,171.774,2146.29,34846,180,166,34548,27603,31039,32844,34464
52201,77,269,37284,14917,2.80351e+13,172.491,2644.86,52201,212,175,42804,35657,17572,18257,24804
9011,157,191,6427,2584,2.8188e+13,164.824,1076,9011,125,117,8550,6819,7769,8055,7978
98939,132,491,70649,28290,2.80974e+13,173.275,3871.07,98939,295,192,90898,74592,39669,21176,62944
27082,132,368,19325,7757,2.83029e+13,171.641,2068.46,27082,181,171,24731,20393,13174,9773,18451
15348,100,202,10960,4388,2.80443e+13,169.041,1411.09,15348,145,131,13148,11113,6841,6404,9146
1595,12,177,1138,457,2.82485e+13,125.196,449.072,1595,74,73,778,495,238,137,154
80951,26,320,57823,23128,2.79976e+13,172.987,3321.15,80951,263,175,53418,39225,13783,9228,15406
92602,221,484,66126,26476,2.80952e+13,173.309,3751.27,92602,283,192,92118,91995,67549,46544,81414
66335,22,294,47388,18947,2.80005e+13,172.842,2994.35,66335,237,175,41486,29494,11275,10900,9011
78712,115,317,56221,22491,2.80303e+13,172.972,3274.02,78712,259,175,69935,58324,41444,46695,53953
81190,71,321,57988,23202,2.80123e+13,173.026,3326.9,81190,264,175,65717,54010,24839,19427,35587
29328,59,228,20948,8380,2.80224e+13,171.271,1965.34,29328,170,157,23031,18814,7788,9130,11265
28049,192,225,20036,8013,2.80403e+13,171.291,1920.33,28049,168,155,27824,27824,26317,27060,27791
86852,342,480,62011,24841,2.81136e+13,173.262,3639.33,86852,273,195,86372,86372,77897,82227,86234
24222,118,218,17304,6918,2.79539e+13,170.859,1781.1,24222,161,148,21566,17917,13314,12338,16808
66010,292,293,47150,18860,2.79976e+13,172.833,2986.43,66010,236,175,65717,65717,65717,65717,65716
73581,291,307,52559,21022,2.80082e+13,172.92,3160.37,73581,250,175,73274,73274,72877,73050,73258
91905,592,800,65739,26166,2.72406e+13,222.614,4496.78,91905,798,180,90974,90574,84306,87512,90481
99506,93,354,71078,28428,2.80038e+13,173.224,3700.47,99506,297,175,84510,69603,39605,32981,55521
97574,455,491,69678,27896,2.8095e+13,173.29,3846.65,97574,292,192,97083,97083,95523,96294,97047
73772,281,307,52693,21079,2.7991e+13,172.914,3164.1,73772,250,175,73465,73465,72408,72920,73439
51274,57,267,36622,14652,2.80203e+13,172.52,2620.25,51274,210,175,40089,32804,13630,15230,19261
66162,68,293,47267,18895,2.79844e+13,172.828,2989.62,66162,237,175,53171,43885,19378,19631,27776
20768,210,212,14833,5935,2.80473e+13,170.212,1646.3,20768,155,141,20556,20556,20552,20552,20554
75663,164,311,54050,21613,2.80023e+13,172.965,3206.76,75663,254,175,73867,57964,66269,70926,71039
28263,537,800,20280,7983,2.55263e+13,214.511,2920.64,28263,734,155,27360,27015,26242,26589,26674
66317,115,293,47372,18945,2.79976e+13,172.804,2993.1,66317,237,175,58891,49133,34912,39328,45098
86399,99,331,61710,24689,2.80248e+13,173.038,3437.3,86399,273,175,74288,62622,37546,45016,51819
65527,134,293,46805,18722,2.80085e+13,172.854,2975.81,65527,236,175,60437,49364,43334,43578,51733
16911,24,204,12074,4837,2.8025e+13,169.106,1481.01,16911,147,134,10875,7979,2890,3166,3294
70700,574,800,50593,20107,2.70106e+13,217.022,4064.61,70700,793,180,69795,69395,66116,67772,69222
62227,270,286,44447,17780,2.79846e+13,172.738,2895.99,62227,229,175,61941,61941,61559,61726,61925
26576,50,222,18976,7600,2.79998e+13,171.046,1867.32,26576,165,152,20282,16418,6370,6957,8612
88074,43,333,62908,25166,2.7997e+13,173.086,3470.93,88074,276,175,65583,51913,19592,21513,25098
24575,138,219,17554,7021,2.80509e+13,170.819,1794.55,24575,162,148,22765,18486,17165,17734,19747
94016,356,800,67249,26767,2.72609e+13,226.245,4537.41,94016,798,176,92835,92252,84659,88398,91796
52889,52,270,37771,15118,2.80166e+13,172.432,2662.47,52889,212,175,40702,32997,12861,15613,18154
93997,315,344,67141,26856,2.80109e+13,173.16,3591.63,93997,287,175,93653,93653,92410,93019,93624
16455,121,800,11842,4613,2.38388e+13,220.474,2441.68,16455,744,129,13822,11576,8189,8522,9969
79001,556,800,56522,22479,2.71221e+13,225.781,4240.76,79001,782,180,78089,77689,75098,76408,77469
85109,31,328,60786,24323,2.80145e+13,173.054,3409.64,85109,271,175,58457,44321,15258,11402,18434
85798,77,329,61288,24510,2.79996e+13,173.045,3423.78,85798,272,175,70379,58627,28888,27367,41422
3140,41,179,2252,888,2.74868e+13,149.173,630.056,3140,93,86,2284,1801,661,738,854
78318,673,800,56029,22289,2.71231e+13,219.021,4226.57,78318,798,180,77503,77301,73463,75414,77138
32552,66,233,23255,9297,2.79894e+13,171.579,2072.51,32552,176,163,26015,21522,9371,9567,13192
61077,243,284,43630,17447,2.79905e+13,172.739,2868.21,61077,228,175,60793,60793,58700,59745,60752
56504,419,800,40452,16052,2.67748e+13,221.069,3736.69,56504,798,175,55410,54808,48955,52116,54561
1124,87,176,802,322,2.79341e+13,103.955,375.745,1124,63,62,861,752,437,468,545
79533,218,318,56812,22721,2.80082e+13,173.026,3291.39,79533,261,175,79215,79215,73131,76230,79115
61491,99,285,43919,17572,2.80105e+13,172.726,2878.55,61491,228,175,52854,44551,26719,26862,36944
71447,241,304,51034,20413,2.80131e+13,172.916,3113.08,71447,247,175,71143,71143,67611,69397,71080
8673,110,190,6200,2473,2.79061e+13,165.043,1055.22,8673,125,115,7534,6361,4385,4026,5609
2430,132,178,1743,687,2.76956e+13,142.463,554.108,2430,86,79,2126,1789,1532,1531,1763
68099,32,297,48644,19455,2.8003e+13,172.873,3035.51,68099,240,175,47136,35699,12449,12585,15377
61557,137,286,43967,17590,2.80353e+13,172.685,2880.92,61557,228,175,57091,46374,41940,44384,48947
57746,80,279,41240,16506,2.80301e+13,172.643,2786.86,57746,222,175,47673,40071,19782,20510,28472
62079,249,286,44342,17737,2.79969e+13,172.744,2892.61,62079,229,175,61793,61793,59999,60891,61756
97052,179,350,69324,27728,2.80097e+13,173.229,3652.87,97052,293,175,96702,96702,85824,91390,96531
52516,26,269,37513,15003,2.80037e+13,172.505,2652.61,52516,212,175,34642,25443,8947,9401,8364
3218,149,180,2299,919,2.80464e+13,150.15,639.608,3218,95,90,2930,2395,2421,2611,2613
48022,173,260,34305,13717,2.79855e+13,172.369,2531.62,48022,204,175,47594,37716,42542,45198,47186
76962,112,313,54975,21987,2.80017e+13,173.006,3235.18,76962,256,175,67982,56882,39790,37864,51088
63849,103,290,45613,18236,2.80058e+13,172.823,2936.03,63849,233,175,55335,46835,28873,24845,38953
14625,74,200,10447,4178,2.79286e+13,168.486,1375.36,14625,143,130,11865,9771,4781,4598,6653
12293,163,196,8783,3510,2.7981e+13,167.757,1259.54,12293,138,125,11857,9375,10750,11430,11403
5560,30,184,3968,1592,2.80584e+13,159.899,841.849,5560,110,103,3765,2856,975,1028,1190
54551,78,800,39056,15495,2.67319e+13,215.002,3688.4,54551,773,180,44076,36884,17791,18280,25140
49631,188,264,35458,14173,2.79917e+13,172.454,2576.19,49631,207,175,49367,49367,44952,47192,49291
86287,87,330,61632,24655,2.80122e+13,173.081,3434.29,86287,273,175,72325,60206,32811,33605,46810
63271,32,289,45191,18080,2.8028e+13,172.739,2922.15,63271,232,175,43795,33185,11586,8610,14032
51942,149,268,37100,14842,2.80123e+13,172.504,2637.43,51942,211,175,49282,39312,40048,43490,44863
74865,795,800,53565,21300,2.70784e+13,224.036,4153.96,74865,779,180,74065,73911,73640,73803,74051
44488,185,254,31782,12706,2.79837e+13,172.269,2434.05,44488,198,175,44234,44234,40235,42262,44165
56306,125,276,40215,16091,2.80092e+13,172.516,2750.1,56306,218,175,51011,42324,34364,34939,41169
73393,91,306,52421,20972,2.80052e+13,172.875,3155.36,73393,249,175,62041,51214,28779,36116,41198
37383,88,242,26700,10683,2.80219e+13,171.862,2225.75,37383,185,171,31379,26063,14353,14035,20199
59756,25,282,42686,17070,2.80061e+13,172.702,2836.14,59756,225,175,38986,28413,10177,8763,12111
2138,120,178,1527,611,2.75267e+13,137.966,519.561,2138,81,77,1803,1549,1191,1137,1453
77897,127,315,55636,22261,2.8009e+13,172.941,3255.72,77897,257,175,70902,58567,48158,48611,58082
17151,82,205,12251,4900,2.80021e+13,169.455,1492.48,17151,148,135,14175,11906,6029,6041,8638
45259,75,800,32423,12836,2.64431e+13,217.614,3445.26,45259,747,180,36194,30048,14446,14325,19979
29851,109,228,21326,8525,2.80032e+13,171.394,1982.27,29851,171,157,26174,21929,14675,13472,19204
77724,525,800,55607,22117,2.71022e+13,221.26,4214.16,77724,790,180,76773,76387,73102,74752,76099
45212,212,256,32293,12919,2.80215e+13,172.218,2454.77,45212,199,175,44956,44956,42680,43819,44912
9859,161,191,7041,2818,2.79771e+13,165.714,1124.99,9859,128,119,9446,7501,8564,9128,8986
1973,76,178,1410,563,2.79012e+13,135.59,499.3,1973,76,75,1536,1311,663,686,921
97716,291,350,69798,27918,2.8001e+13,173.171,3664.7,97716,293,175,97366,97366,94058,95730,97307
15143,91,348,10789,4354,2.86558e+13,169.562,1582.86,15143,151,142,12696,10600,5581,4497,7738
74220,29,308,53012,21208,2.80194e+13,172.909,3174.4,74220,251,175,50181,37848,12655,13308,12741
41168,170,249,29410,11758,2.80107e+13,172.168,2339.58,41168,192,175,40554,31878,36332,38668,39777
53721,4,271,38375,15346,2.79967e+13,172.482,2683.47,53721,214,175,14086,4275,3111,3010,1243
16673,54,204,11907,4766,2.79774e+13,169.22,1471.07,16673,147,134,12883,10570,4137,4503,5820
95179,68,800,68070,27109,2.72784e+13,235.426,4559.08,95179,798,175,75837,62735,27466,32204,40974
92461,220,341,66048,26413,2.80026e+13,173.166,3560.58,92461,284,175,92120,92120,84594,88438,91999
43555,54,253,31107,12448,2.80111e+13,172.178,2408.04,43555,196,175,33741,27631,10732,8071,14453
75552,266,311,53962,21590,2.80137e+13,173,3204.83,75552,254,175,75241,75241,72914,74079,75196
8280,90,189,5914,2366,2.79727e+13,164.472,1030.71,8280,123,113,6906,5760,3282,4056,4571
31710,125,231,22657,9053,2.79732e+13,171.58,2044.49,31710,175,161,28692,23812,19325,18341,23365
44206,648,946,31637,12569,2.66301e+13,215.631,3602.23,44206,753,185,43260,43059,41905,42112,42366
84740,112,327,60530,24210,2.80036e+13,173.076,3401.78,84740,271,175,74855,62638,43820,42152,56776
52092,317,412,37189,14903,2.81855e+13,172.725,2827.41,52092,211,193,51680,51667,46151,48971,51098
45333,157,256,32378,12955,2.80119e+13,172.276,2458.2,45333,199,175,43637,34467,39565,41027,41031
58843,644,800,42117,16726,2.68231e+13,219.406,3793.2,58843,798,175,57975,57794,52242,55084,57576
77597,466,800,55518,22079,2.70939e+13,224.062,4211.39,77597,783,180,76594,76260,73291,74773,75795
1902,53,177,1360,542,2.76849e+13,132.522,488.828,1902,76,73,1419,1183,491,395,637
29755,166,228,21248,8507,2.8032e+13,171.274,1978.86,29755,171,157,29059,22931,26136,27862,28002
68835,239,298,49174,19661,2.79899e+13,172.881,3052.13,68835,242,175,68537,68537,65223,66898,68478
69822,455,800,49963,19859,2.70156e+13,228.066,4045.11,69822,798,175,68743,68102,60970,64792,67987
20404,187,211,14573,5831,2.80024e+13,170.265,1631.44,20404,154,140,20193,20193,19275,19715,20169
46987,100,259,33560,13427,2.80117e+13,172.312,2504.04,46987,202,175,40472,34121,20994,19493,28580
78741,313,317,56233,22508,2.80271e+13,172.978,3274.56,78741,259,175,78424,78424,78401,78407,78420
59182,692,800,42359,16823,2.68361e+13,216.928,3801.34,59182,798,175,58367,58148,53031,55627,58059
52137,63,268,37248,14889,2.79939e+13,172.542,2642.39,52137,212,175,41414,34198,14243,13511,21083
20616,148,211,14728,5888,2.79808e+13,170.257,1639.64,20616,154,140,19460,15578,15702,17169,17455
95047,225,346,67892,27155,2.80095e+13,173.185,3612.67,95047,289,175,94701,94701,87195,91027,94580
34407,211,236,24586,9821,2.79821e+13,171.839,2132.43,34407,180,166,34171,34171,33170,33655,34146
1121,71,176,803,318,2.78833e+13,104.802,376.352,1121,60,60,842,722,392,381,459
84798,203,327,60574,24224,2.7996e+13,173.079,3402.93,84798,270,175,84471,84471,76743,80690,84347
48280,257,262,34489,13791,2.80198e+13,172.372,2540.21,48280,205,175,48018,48018,47989,47997,48013
16200,142,203,11581,4619,2.79511e+13,169.389,1449.82,16200,147,133,15077,12197,11818,13037,13299
75632,106,455,53996,21636,2.81254e+13,173.081,3393.93,75632,252,192,65946,55517,31554,30799,44648
65195,26,292,46565,18630,2.80086e+13,172.831,2967.69,65195,235,175,43005,31585,11097,8492,11933
70383,101,301,50279,20104,2.79945e+13,172.909,3087.94,70383,244,175,60762,51255,31564,29311,42734
94680,331,345,67624,27056,2.80066e+13,173.161,3604.91,94680,288,175,94335,94335,94059,94180,94321
80574,104,319,57553,23021,2.79994e+13,172.987,3312.95,80574,262,175,70002,59128,37201,43723,50330
38144,69,243,27245,10899,2.80055e+13,171.989,2248.73,38144,186,172,30702,25292,11302,10462,16568
82226,123,469,58707,23519,2.81302e+13,173.183,3538.51,82226,265,192,74178,61531,40945,36021,55267
12284,151,196,8773,3511,2.79443e+13,167.708,1258.97,12284,137,126,11598,9265,9623,9490,10599
31765,30,374,22663,9102,2.82792e+13,171.894,2228.16,31765,189,171,21649,16350,5518,3514,6136
13259,80,198,9475,3784,2.80025e+13,168.158,1309.09,13259,141,128,10882,9184,4578,6203,6592
95626,262,347,68300,27326,2.80137e+13,173.14,3624.04,95626,289,175,95279,95279,90201,92785,95194
97090,90,349,69356,27734,2.79929e+13,173.18,3652.42,97090,293,175,81908,67749,37901,36579,53182
11475,149,195,8193,3282,2.80495e+13,166.626,1216.05,11475,134,124,10786,8661,8807,9543,9681
89267,175,336,63762,25505,2.80235e+13,173.118,3496.35,89267,279,175,88931,88931,78720,83943,88770
31761,82,232,22681,9080,2.80525e+13,171.526,2046.91,31761,175,161,26295,22085,11177,11416,16028
47553,147,260,33967,13586,2.8007e+13,172.328,2519.68,47553,203,175,44937,35989,36150,39638,40201
86282,127,330,61626,24656,2.80057e+13,173.094,3434.18,86282,273,175,78533,64863,53342,46243,63724
79549,14,318,56816,22733,2.80132e+13,173.039,3291.82,79549,261,175,41994,28624,12090,7045,6218
14885,110,201,10632,4253,2.80179e+13,168.666,1388.73,14885,144,130,13020,10951,7532,8588,9794
94573,235,345,67554,27019,2.80055e+13,173.143,3603.02,94573,288,175,94228,94228,87477,90921,94118
23315,84,216,16656,6659,2.80087e+13,170.557,1745.8,23315,159,146,19371,16204,8306,8282,12054
58807,177,280,42008,16799,2.79984e+13,172.683,2812.46,58807,223,175,58527,58527,52225,55439,58424
87059,268,331,62183,24876,2.80097e+13,173.046,3449.8,87059,274,175,86728,86728,83160,84964,86665
98074,325,492,70026,28048,2.80968e+13,173.317,3856.86,98074,293,193,97582,97582,87108,92468,96986
16695,30,204,11927,4768,2.79742e+13,169.394,1472.32,16695,147,133,11354,8593,2906,2585,2957
95254,179,346,68042,27212,2.80004e+13,173.2,3616.54,95254,290,175,94908,94908,84251,89706,94741
49633,51,263,35456,14177,2.79708e+13,172.439,2575.41,49633,207,175,38047,30762,12206,13013,16343
25380,139,220,18134,7246,2.80044e+13,170.915,1823.96,25380,163,150,23562,19095,18074,17956,20309
74788,261,309,53421,21367,2.80005e+13,172.925,3186.91,74788,252,175,74479,74479,71925,73208,74431
97068,55,349,69338,27730,2.79964e+13,173.169,3651.96,97068,292,175,75484,61769,24263,18983,33256
62744,288,800,44909,17835,2.68923e+13,213.643,3885.11,62744,789,180,61557,61037,57477,58981,60372
45571,84,256,32552,13019,2.80016e+13,172.244,2464.23,45571,199,175,37925,31701,16225,17440,23963
64552,61,291,46117,18435,2.79931e+13,172.791,2952.39,64552,234,175,51038,41764,17437,17299,24887
77463,82,314,55330,22133,2.80096e+13,172.964,3246.09,77463,257,175,64228,53910,27215,27767,39475
50650,118,266,36175,14475,2.8018e+13,172.44,2603.63,50650,209,175,45254,37516,27854,30600,35543
73296,85,306,52362,20934,2.79922e+13,172.933,3153.46,73296,250,175,61153,51137,26419,26166,38373
18964,25,208,13537,5427,2.80574e+13,169.696,1570.84,18964,151,138,12371,9019,3256,3115,3794
66992,222,295,47849,19143,2.80013e+13,172.832,3009.53,66992,238,175,66697,66697,62447,64602,66624
40128,18,247,28657,11471,2.80279e+13,171.968,2308.43,40128,189,175,23282,16551,6758,3939,5533
37063,235,241,26474,10589,2.80017e+13,171.859,2215.49,37063,184,170,36822,36822,36770,36788,36816
19317,47,209,13798,5519,2.80111e+13,169.896,1586.21,19317,152,138,14578,11692,4446,3341,5505
22793,181,215,16278,6515,2.80387e+13,170.559,1726.1,22793,158,145,22578,22578,20999,21779,22544
94595,112,345,67571,27024,2.80035e+13,173.18,3603.52,94595,288,175,83562,69922,48911,46583,62414
28518,94,225,20376,8142,2.79691e+13,171.247,1935.64,28518,169,156,24202,19934,11532,11096,16182
19132,69,209,13658,5474,2.80612e+13,169.618,1578.23,19132,151,138,15374,12691,5738,6708,8552
86301,687,800,61733,24568,2.71838e+13,223.132,4387.7,86301,798,180,85501,85289,81644,83484,85163
73258,214,306,52331,20927,2.79952e+13,172.925,3152.63,73258,250,175,72952,72952,67397,70226,72860
49467,161,263,35339,14128,2.79878e+13,172.455,2571.3,49467,207,175,47980,37787,43235,46297,45496
30042,226,228,21456,8586,2.79704e+13,171.354,1988.29,30042,171,158,29814,29814,29810,29810,29812
5848,63,185,4172,1676,2.81697e+13,159.733,863.765,5848,112,105,4600,3832,1643,1893,2398
24972,160,219,17840,7132,2.79996e+13,170.804,1808.56,24972,162,148,24108,19060,21772,23300,22734
91455,175,339,65321,26134,2.80135e+13,173.121,3540,91455,282,175,91116,91116,80686,86023,90952
65997,12,294,47146,18851,2.80031e+13,172.874,2987.22,65997,237,175,32576,20641,9776,4652,4094
26572,67,222,18978,7594,2.80145e+13,170.942,1867.03,26572,165,152,21275,17574,7774,11720,11511
84211,170,465,60135,24076,2.81075e+13,173.174,3572.13,84211,268,192,82984,65277,50376,39540,72559
41225,188,249,29446,11779,2.80334e+13,172.137,2341.05,41225,192,175,40976,40976,37563,39288,40915
93640,271,343,66892,26748,2.79958e+13,173.128,3583.94,93640,286,175,93297,93297,89112,91234,93225
20820,618,800,14944,5876,2.52924e+13,192.196,2531.57,20820,645,138,20020,19878,17598,13325,1561
36400,231,240,26003,10397,2.79701e+13,171.896,2195.33,36400,183,170,36160,36160,36065,36103,36151
62555,200,288,44673,17882,2.80202e+13,172.706,2905.14,62555,230,175,62267,62267,57033,59694,62179
68541,253,298,48959,19582,2.79991e+13,172.863,3045.78,68541,241,175,68243,68243,65933,67089,68198
78257,163,316,55895,22362,2.80169e+13,172.997,3264.07,78257,259,175,76261,59955,68459,73323,72541
73571,128,800,52633,20938,2.70724e+13,242.559,4126.33,73571,796,175,66168,54637,44450,44487,53250
67635,786,951,48381,19254,2.70813e+13,213.826,4190.19,67635,800,196,66684,66493,62023,64235,66190
23544,11,217,16815,6729,2.80414e+13,170.644,1755.34,23544,160,146,11190,6902,3453,2145,2482
74038,204,308,52881,21157,2.80046e+13,172.978,3170.82,74038,251,175,73730,73730,67372,70612,73626
63385,15,289,45271,18114,2.80198e+13,172.759,2924.68,63385,232,175,34375,23732,9985,6206,8123
55581,7,275,39700,15881,2.80326e+13,172.611,2732.1,55581,218,175,21520,8654,6034,3418,2039
44061,53,254,31473,12588,2.80153e+13,172.23,2422.63,44061,197,175,34008,27945,10801,10283,15570
26886,108,223,19208,7678,2.79858e+13,171.165,1879.02,26886,166,153,23479,19700,13137,12088,17212
24473,161,218,17479,6994,2.79836e+13,170.696,1789.68,24473,161,148,23667,18678,21353,21808,22555
11088,97,194,7921,3167,2.7987e+13,167.079,1195.52,11088,133,123,9431,8003,4781,4519,6434
75054,46,309,53614,21440,2.79988e+13,172.948,3192.45,75054,252,175,56557,45315,16974,20479,23929
63131,272,288,45097,18034,2.80032e+13,172.722,2917.93,63131,231,175,62843,62843,62467,62630,62827
59909,112,282,42795,17114,2.79933e+13,172.71,2839.72,59909,225,175,52893,44270,30977,28084,39964
33985,387,800,24367,9618,2.59309e+13,208.83,3112.06,33985,765,161,32920,32331,30501,31581,31946
14652,188,201,10472,4180,2.79828e+13,168.932,1378.27,14652,144,130,14451,14451,14245,14334,14438
36678,6,240,26200,10478,2.79809e+13,171.847,2203.26,36678,183,170,12933,4908,3255,2719,1111
40656,259,393,29012,11644,2.82524e+13,172.254,2509.7,40656,200,176,40263,40142,38539,37623,39345
59504,199,282,42506,16998,2.8023e+13,172.691,2830.36,59504,225,175,59222,59222,54316,56808,59139
40181,469,800,28793,11388,2.62598e+13,211.166,3301.06,40181,795,172,39169,38912,35023,36976,38388
78384,167,316,55986,22398,2.80128e+13,173.007,3266.59,78384,259,175,76948,60476,68748,73525,74549
26146,244,371,18648,7498,2.83361e+13,171.378,2038.64,26146,175,166,25775,25654,18136,13201,23766
3934,90,182,2801,1133,2.82029e+13,153.405,707.29,3934,101,94,3242,2728,1585,1948,2166
51525,96,267,36799,14726,2.80012e+13,172.479,2626.23,51525,210,175,44005,36118,21453,20280,29934
35705,283,381,25478,10227,2.82463e+13,172.094,2355.14,35705,192,184,35324,35204,30338,28637,33673
92297,144,341,65928,26369,2.80004e+13,173.17,3557.53,92297,284,175,86818,69717,68549,67723,76960
5963,171,185,4258,1705,2.81454e+13,161.089,872.933,5963,113,106,5742,4569,5541,5647,5659
17594,63,206,12572,5022,2.80094e+13,169.6,1512.36,17594,149,135,13937,11527,4808,4497,7049
12977,167,198,9267,3710,2.81229e+13,167.928,1295.18,12977,141,127,12603,9969,11497,12136,12241
64447,412,800,46125,18322,2.6918e+13,215.404,3924.4,64447,785,180,63388,62737,59737,61432,62483
65981,341,434,47109,18872,2.81336e+13,172.951,3168.94,65981,235,193,65547,65547,60091,62867,65454
62470,14,287,44619,17851,2.8011e+13,172.726,2902.27,62470,230,175,32981,22477,9492,7808,8028
84556,118,800,60484,24072,2.71653e+13,220.543,4353.19,84556,798,177,74728,62016,45386,41753,57004
50418,81,265,36008,14410,2.80045e+13,172.449,2596.89,50418,208,175,41694,35069,17605,17553,25275
98032,329,352,70026,28006,2.80069e+13,173.233,3672.35,98032,295,175,97680,97680,96872,97254,97657
71862,470,800,51423,20439,2.70324e+13,216.075,4089.32,71862,798,175,70826,70536,64983,67789,70072
71620,142,303,51158,20462,2.80005e+13,172.884,3115.56,71620,246,175,67100,54097,52409,55508,58901
96444,28,800,68986,27458,2.72739e+13,223.889,4582.65,96444,798,180,64282,48451,16246,17154,16086
1149,53,176,814,335,2.76947e+13,107.021,380.679,1149,62,64,835,709,307,337,377
23644,210,217,16888,6756,2.803e+13,170.741,1759.34,23644,160,146,23427,23427,23358,23383,23420
6398,137,186,4571,1827,2.81465e+13,162.055,905.014,6398,116,107,5832,4775,4334,4578,5013
72448,195,305,51747,20701,2.80089e+13,172.918,3134.87,72448,248,175,72143,72143,65373,68826,72033
52372,32,269,37409,14963,2.80189e+13,172.515,2648.95,52372,212,175,36241,27461,9590,6932,11722
74329,234,308,53097,21232,2.79934e+13,172.981,3176.82,74329,252,175,74021,74021,69687,71887,73947
31471,189,231,22476,8995,2.80202e+13,171.553,2036.94,31471,174,161,31240,31240,29106,30173,31198
47281,74,260,33768,13513,2.80252e+13,172.325,2512.76,47281,203,175,38509,31613,15327,15776,21599
98981,254,353,70700,28281,2.80044e+13,173.203,3690.15,98981,296,175,98628,98628,92652,95694,98529
16635,172,204,11887,4748,2.79566e+13,169.398,1469.77,16635,147,133,16347,12995,14971,15696,16150
3296,40,180,2355,941,2.80658e+13,150.266,646.226,3296,95,90,2381,1887,705,722,902
15854,19,202,11330,4524,2.78773e+13,169.017,1433.23,15854,146,133,9388,6692,2685,2342,1738
21407,122,213,15289,6118,2.80322e+13,170.262,1671.64,21407,156,142,19218,15952,12453,13170,15376
65886,76,293,47064,18822,2.80033e+13,172.76,2983.44,65886,236,175,53912,44778,21948,22332,31367
24215,173,218,17297,6918,2.80144e+13,170.826,1780.78,24215,161,147,23913,18992,21666,22835,23842
69059,181,299,49330,19729,2.80133e+13,172.862,3057.77,69059,242,175,68760,68760,61471,65191,68642
81097,213,321,57918,23179,2.8015e+13,172.994,3325.1,81097,263,175,80776,80776,74146,77526,80668
23024,444,800,16535,6489,2.49505e+13,212.911,2725.58,23024,769,140,22013,21389,19549,20649,21156
62440,240,432,44578,17862,2.81438e+13,172.989,3089.65,62440,238,176,62008,61887,59067,59599,61340
78894,87,317,56351,22543,2.8012e+13,173.036,3277.83,78894,260,175,66141,55031,29946,22583,40939
51150,70,266,36537,14613,2.79753e+13,172.422,2616,51150,209,175,41285,34021,15328,15572,21965
85434,264,329,61021,24413,2.80184e+13,173.045,3416.96,85434,271,175,85105,85105,81407,83279,85040
33026,52,233,23590,9436,2.79884e+13,171.542,2087.22,33026,176,163,25400,20593,8029,10382,11797
6243,82,185,4460,1783,2.7988e+13,161.063,892.209,6243,113,106,5116,4322,2237,2234,3139
45865,156,257,32761,13104,2.80063e+13,172.269,2473.14,45865,200,175,44069,34874,39049,41426,40916
18296,128,207,13069,5227,2.8012e+13,169.75,1542.6,18296,150,136,16611,13722,11388,11448,13717
80178,287,319,57268,22910,2.80059e+13,172.992,3305.04,80178,262,175,79859,79859,78384,79113,79827
50029,542,800,35824,14205,2.66096e+13,213.33,3572.78,50029,770,178,49115,48742,46900,47804,48455
8131,111,189,5806,2325,2.79656e+13,164.655,1021.2,8131,123,113,7072,5957,4170,3832,5227
66614,208,295,47580,19034,2.80291e+13,172.826,3001.4,66614,238,175,66319,66319,61140,63773,66232
34248,218,236,24468,9780,2.79928e+13,171.779,2127.45,34248,179,166,34012,34012,33544,33751,33994
70028,150,301,50013,20015,2.80238e+13,172.813,3080.11,70028,243,175,66602,53021,54389,59165,60412
75687,316,457,54035,21652,2.81329e+13,173.113,3396.39,75687,253,194,75230,75217,68225,66084,73486
30110,100,228,21506,8604,2.80102e+13,171.256,1990.39,30110,171,158,25906,21861,13481,15795,18347
10747,303,336,7657,3090,2.87958e+13,167.877,1347.85,10747,148,137,10411,10303,9770,9656,10296
22289,25,215,15925,6364,2.80093e+13,170.611,1707.25,22289,158,144,14526,10589,3792,2464,3803
26842,103,223,19172,7670,2.80528e+13,171.11,1877.59,26842,166,152,23211,19667,12135,10470,16378
4292,60,182,3063,1229,2.81795e+13,155.28,738.247,4292,104,97,3332,2752,1168,888,1582
64060,204,800,45850,18210,2.69047e+13,227.581,3915.52,64060,798,175,62735,62351,54906,58225,61296
79161,718,800,56634,22527,2.71278e+13,232.214,4244.04,79161,770,180,78361,78179,76606,77380,78116
91451,291,339,65320,26131,2.79978e+13,173.113,3539.82,91451,282,175,91112,91112,88564,89843,91064
49947,226,265,35677,14270,2.80233e+13,172.412,2585.12,49947,208,175,49682,49682,47780,48726,49643
21699,42,214,15496,6203,2.80508e+13,170.266,1683.79,21699,156,143,16057,12705,4697,3685,5958
6850,10,187,4893,1957,2.7995e+13,163.113,937.089,6850,119,108,3125,1687,940,613,625
46058,12,257,32900,13158,2.79867e+13,172.318,2478.27,46058,200,175,22725,14395,6832,3910,4895
96526,202,491,68926,27600,2.80923e+13,173.295,3829.15,96526,306,184,96035,95910,82691,81953,93070
35301,76,237,25221,10080,2.79795e+13,171.748,2159.97,35301,181,168,28847,23986,11776,16265,16961
53968,231,272,38547,15421,2.80016e+13,172.609,2690.69,53968,215,175,53696,53696,51660,52676,53655
58714,127,280,41936,16778,2.79924e+13,172.66,2810.23,58714,223,175,53407,44128,36280,31482,43728
81102,546,800,58024,23078,2.71348e+13,249.172,4283.62,81102,785,175,80184,79869,70005,55518,32565
3710,57,180,2653,1057,2.75522e+13,152.972,685.586,3710,98,92,2846,2352,973,1034,1352
24578,86,219,17551,7027,2.80532e+13,170.84,1794.66,24578,162,148,20507,17125,9078,9064,12836
86359,24,800,61770,24589,2.72079e+13,246.541,4389.1,86359,798,175,55250,40821,14529,9272,14107
7579,128,187,5416,2163,2.77732e+13,163.679,984.562,7579,121,111,6809,5662,4701,4113,5569
2978,33,179,2124,854,2.76585e+13,146.925,613.005,2978,90,87,2057,1574,547,669,683
51172,134,267,36547,14625,2.80211e+13,172.382,2617.45,51172,209,175,47174,38551,33848,35604,39923
21596,153,360,15397,6199,2.84971e+13,171.078,1867.54,21596,171,160,20430,16341,12484,10287,16839
90021,256,337,64303,25718,2.8014e+13,173.116,3511.43,90021,280,175,89684,89684,84917,87336,89603
63169,166,288,45123,18046,2.80019e+13,172.774,2918.97,63169,231,175,61873,48723,55401,59234,60204
72380,36,305,51696,20684,2.801e+13,172.93,3133.63,72380,248,175,51670,40948,14663,11264,18024
22960,187,215,16402,6558,2.79942e+13,170.536,1731.97,22960,158,145,22745,22745,21555,22135,22717
16657,13,204,11901,4756,2.79957e+13,169.26,1470.32,16657,148,134,8515,5747,2502,1576,1979
23585,65,217,16845,6740,2.80164e+13,170.789,1757.05,23585,160,147,18783,15535,6542,7390,9879
1496,77,177,1067,429,2.83298e+13,120.055,432.572,1496,72,69,1161,997,515,473,683
57222,12,277,40870,16352,2.79914e+13,172.584,2772.5,57222,220,175,28240,17898,8485,4963,5064
96402,29,348,68865,27537,2.79985e+13,173.21,3639.2,96402,292,175,65171,49147,16402,17788,22198
81076,48,321,57909,23167,2.80153e+13,173.053,3324.93,81076,264,175,61526,49538,18779,13966,24723
11209,30,194,8010,3199,2.79361e+13,166.973,1201.2,11209,133,124,7619,5760,1915,2411,2380
91695,269,340,65494,26201,2.80123e+13,173.125,3545.27,91695,283,175,91355,91355,87242,89327,91284
77073,92,800,55139,21934,2.71028e+13,223.778,4200.59,77073,798,175,64522,53249,29609,28507,41559
19735,163,210,14093,5642,2.80314e+13,169.767,1603.56,19735,152,139,19117,15090,17237,18401,18240
14976,184,201,10699,4277,2.79792e+13,168.898,1393.17,14976,144,130,14775,14775,14321,14525,14758
34965,104,238,24969,9996,2.8039e+13,171.753,2150.78,34965,180,167,30325,25637,16170,18972,22061
26411,74,221,18862,7549,2.79935e+13,170.793,1860.46,26411,164,151,21483,17665,8602,12005,12381
3514,137,180,2513,1001,2.78869e+13,150.446,666.392,3514,95,91,3149,2619,2371,2357,2691
94699,15,345,67641,27058,2.79965e+13,173.15,3605.24,94699,288,175,51360,35439,14903,10277,12821
50456,134,265,36045,14411,2.79945e+13,172.439,2597.7,50456,208,175,46523,38008,33368,31299,39153
11312,617,800,8173,3139,2.17696e+13,237.22,2168.66,11312,692,119,10495,10096,9939,10160,9963
88771,322,335,63400,25371,2.80199e+13,173.125,3486.13,88771,278,175,88436,88436,88213,88309,88423
77068,225,314,55038,22030,2.80308e+13,172.948,3238.16,77068,256,175,76754,76754,71437,74142,76665
49244,195,263,35168,14076,2.80059e+13,172.398,2565.49,49244,206,175,48981,48981,45092,47062,48913
16889,177,205,12065,4824,2.80698e+13,169.434,1481.52,16889,148,134,16684,16684,15523,16086,16656
79653,745,950,56961,22692,2.72306e+13,245.201,4447.21,79653,730,198,78703,78559,78004,78011,78088
99766,107,354,71255,28511,2.80141e+13,173.175,3704.96,99766,297,175,87241,73218,48197,55055,64688
69106,212,299,49365,19741,2.80004e+13,172.88,3058.75,69106,242,175,68807,68807,63643,66269,68720
30496,8,229,21788,8708,2.7988e+13,171.474,2004.03,30496,173,159,12681,5785,3527,1927,1312
98268,263,352,70185,28083,2.80156e+13,173.156,3676.35,98268,294,175,97916,97916,92576,95293,97827
55013,57,273,39299,15714,2.79867e+13,172.6,2716.72,55013,217,175,43014,35188,13915,12732,19957
74144,521,685,52933,21211,2.80976e+13,173.565,3660.74,74144,312,225,73459,73339,71769,69517,73223
74101,214,308,52930,21171,2.80055e+13,172.931,3171.98,74101,251,175,73793,73793,68150,71022,73699
44225,22,254,31589,12636,2.80133e+13,172.213,2426.91,44225,197,175,27658,19674,7527,5839,5699
32613,166,233,23296,9317,2.80147e+13,171.495,2074.14,32613,176,162,31867,25139,28649,30550,30881
68425,162,298,48867,19558,2.80219e+13,172.773,3043.11,68425,240,175,66541,52425,59823,64089,63309
70073,679,800,50144,19929,2.70072e+13,233.519,4050.45,70073,798,175,69210,69002,61461,65321,68911
36339,102,240,25954,10385,2.80172e+13,171.929,2193.68,36339,183,169,31417,26508,16355,14491,22101
90326,137,337,64516,25810,2.8002e+13,173.098,3516.96,90326,280,175,83861,68079,61552,61068,71563
10000,5,192,7147,2853,2.79487e+13,166.278,1134.33,10000,130,119,3105,1099,668,721,247
26262,183,221,18764,7498,2.79645e+13,171.011,1855.57,26262,165,151,26041,26041,24158,25097,26003
9109,124,190,6511,2598,2.78998e+13,165.518,1081.31,9109,127,117,8155,6780,5520,4524,6504
65718,250,293,46942,18776,2.80149e+13,172.817,2980.01,65718,236,175,65425,65425,63236,64331,65382
50975,168,409,36390,14585,2.81845e+13,172.726,2796.05,50975,208,192,49928,39314,28611,20734,42650
39610,342,394,28267,11343,2.82093e+13,172.336,2481.4,39610,198,174,39216,39216,39061,39031,39108
74366,181,309,53121,21245,2.80079e+13,172.98,3178.47,74366,252,175,74057,74057,66106,70166,73929
65281,147,438,46600,18681,2.81527e+13,172.9,3158.02,65281,233,192,61630,49439,31956,21499,47368
41750,186,250,29819,11931,2.80451e+13,172.147,2356.35,41750,193,175,41500,41500,37883,39713,41436
82069,9,465,58593,23476,2.81171e+13,173.178,3532.3,82069,264,193,35873,17363,10272,4791,7392
67747,84,296,48396,19351,2.79905e+13,172.846,3026.84,67747,240,175,56398,47142,24044,23932,34945
83594,170,326,59707,23887,2.80186e+13,173.024,3378.7,83594,268,175,82518,64800,73447,78477,80765
45676,189,256,32633,13043,2.7971e+13,172.232,2467.03,45676,200,175,45420,45420,41560,43514,45353
67761,153,297,48394,19367,2.80264e+13,172.816,3028.02,67761,239,175,64802,51302,55665,58710,59579
69233,95,800,49544,19689,2.70014e+13,214.58,4031.97,69233,798,176,58242,48023,27862,26585,38413
29736,198,228,21240,8496,2.80168e+13,171.41,1978.57,29736,171,157,29508,29508,28195,28839,29478
76028,24,452,54289,21739,2.81141e+13,172.655,3397.91,76028,262,175,48922,35865,12958,13154,14191
78254,6,316,55890,22364,2.80198e+13,173.004,3264.03,78254,259,175,27602,10483,6938,4670,2685
68252,134,298,48755,19497,2.80207e+13,172.856,3039.61,68252,241,175,62952,51421,45159,47486,53674
72848,72,306,52038,20810,2.80078e+13,172.922,3144.15,72848,249,175,59083,48583,22704,24009,33116
58270,110,419,41606,16664,2.815e+13,172.857,2980.09,58270,221,193,51193,42978,20671,13938,32713
4669,44,183,3329,1340,2.8287e+13,156.465,771.188,4669,106,100,3462,2758,1077,1200,1432
21655,155,213,15469,6186,2.79972e+13,170.331,1681.24,21655,156,142,20702,16446,18318,19461,19083
26221,8,221,18732,7489,2.79814e+13,171.003,1854.18,26221,164,151,10895,4972,3032,1991,2061
62960,252,288,44967,17993,2.80122e+13,172.779,2914.49,62960,231,175,62672,62672,60957,61807,62636
5187,181,184,3705,1482,2.82576e+13,158.687,813.499,5187,110,103,5003,5003,4991,4993,5000
6008,158,185,4290,1718,2.80285e+13,160.984,875.923,6008,113,105,5668,4549,5144,5493,5324
4677,166,183,3335,1342,2.82386e+13,156.553,771.815,4677,106,100,4431,3568,4176,4321,4262
29582,393,800,21224,8358,2.564e+13,209.47,2966.47,29582,774,152,28515,27935,25575,26933,27561
21797,105,800,15661,6136,2.47853e+13,213.656,2676.53,21797,759,138,18104,15347,9352,8779,12024
33738,50,235,24099,9639,2.8007e+13,171.66,2110.86,33738,178,165,25762,20847,8079,8815,10914
75919,121,311,54219,21700,2.80248e+13,172.918,3211.93,75919,254,175,68264,56526,43097,46286,54477
62177,224,287,44413,17764,2.80252e+13,172.728,2895.81,62177,230,175,61890,61890,58349,60137,61827
78838,5,317,56311,22527,2.80194e+13,173.049,3276.75,78838,260,175,24528,8701,5277,4563,1987
6420,77,186,4581,1839,2.81161e+13,161.196,905.826,6420,115,107,5206,4373,2210,2985,3100
88743,267,334,63395,25348,2.79938e+13,173.135,3484.7,88743,278,175,88409,88409,84552,86507,88342
96674,336,800,69145,27529,2.72745e+13,239.387,4587.11,96674,798,175,95441,94906,85013,89912,94338
39329,211,245,28095,11234,2.79993e+13,171.96,2284.04,39329,188,175,39084,39084,37494,38281,39050
3016,70,180,2153,863,2.85239e+13,147.947,618.416,3016,93,89,2372,1986,929,758,1287
32013,181,232,22864,9149,2.80164e+13,171.443,2054.78,32013,174,161,31781,31781,29015,30409,31730
39076,207,245,27914,11162,2.80329e+13,172.011,2277.22,39076,188,174,38831,38831,36984,37902,38793
74814,21,309,53441,21373,2.79964e+13,172.965,3187.68,74814,252,175,46115,32860,12728,9068,12527
7741,109,188,5530,2211,2.80106e+13,163.863,995.835,7741,121,112,6708,5659,3814,3766,4952
61381,92,285,43843,17538,2.80079e+13,172.737,2875.95,61381,228,175,51997,42809,24114,23482,34396
22173,87,214,15836,6337,2.8029e+13,170.363,1701.74,22173,157,144,18529,15459,8464,10721,12016
57231,417,800,40965,16266,2.6784e+13,213.971,3754.08,57231,778,180,56184,55534,53072,54487,55282
99996,305,355,71428,28568,2.79947e+13,173.235,3710.15,99996,298,175,99641,99641,96997,98324,99591
26468,84,222,18902,7566,2.80236e+13,171.107,1863.76,26468,165,152,22004,18396,9402,9393,13609
21532,19,213,15380,6152,2.80068e+13,170.323,1676.72,21532,156,142,12755,9100,3667,2305,3159
50080,55,265,35769,14311,2.80276e+13,172.43,2588.49,50080,208,175,38921,31860,12523,10277,17502
2824,127,179,2020,804,2.79704e+13,145.871,597.544,2824,90,84,2457,2087,1725,1559,2004
49310,581,800,35309,14001,2.65893e+13,208.844,3553.55,49310,789,175,48416,48025,44984,46525,47853
55052,147,274,39319,15733,2.80232e+13,172.573,2718.61,55052,217,175,52034,41666,41851,45906,46741
88449,286,334,63183,25266,2.80025e+13,173.127,3479.16,88449,277,175,88115,88115,85607,86864,88067
85090,640,800,60868,24222,2.71818e+13,226.914,4363.75,85090,798,175,84190,84013,76524,80376,83811
62036,702,800,44402,17634,2.68724e+13,223.875,3868.63,62036,759,180,61236,61059,59868,60436,60943
63721,216,290,45514,18207,2.80312e+13,172.714,2933.16,63721,232,175,63431,63431,59143,61315,63357
92254,217,340,65903,26351,2.79967e+13,173.147,3555.81,92254,284,175,91914,91914,84248,88163,91791
7851,94,188,5608,2243,2.81744e+13,163.626,1002.6,7851,121,113,6612,5478,3228,3962,4540
6135,149,185,4386,1749,2.79531e+13,161.155,885.222,6135,116,106,5698,4605,4677,5050,5202
71638,439,800,51260,20378,2.70285e+13,222.855,4084.59,71638,798,175,70551,69915,63259,66837,69755
44374,41,254,31696,12678,2.80017e+13,172.208,2430.82,44374,197,175,32704,25747,9334,6591,11560
85338,106,328,60960,24378,2.79971e+13,173.045,3413.99,85338,271,175,74465,62624,40770,38796,53993
61983,78,286,44272,17711,2.80062e+13,172.723,2890.44,61983,229,175,50934,42458,20765,16296,29573
21023,329,800,15109,5914,2.47334e+13,215.877,2644.8,21023,770,137,19896,19391,17191,18133,18810
97908,547,800,70027,27881,2.73032e+13,241.409,4610.32,97908,778,180,96991,96591,94239,95424,96349
69728,179,300,49809,19919,2.8001e+13,172.901,3073.14,69728,243,175,69428,69428,61902,65746,69307
17623,132,206,12593,5030,2.80191e+13,169.436,1513.32,17623,149,136,16110,13251,11266,10538,13491
85823,264,329,61302,24521,2.7998e+13,173.079,3424.42,85823,272,175,85494,85494,81796,83667,85429
16300,198,203,11643,4657,2.79265e+13,169.092,1453.77,16300,146,133,16097,16097,16061,16072,16092
39345,235,245,28096,11249,2.80023e+13,172.011,2284.78,39345,188,175,39100,39100,38964,39020,39090
34407,80,236,24583,9824,2.79903e+13,171.656,2131.81,34407,179,166,28373,23868,11804,11181,16577
49454,103,263,35330,14124,2.79895e+13,172.36,2570.64,49454,206,175,42854,36279,22388,22246,30199
76746,277,313,54820,21926,2.80144e+13,172.97,3230.73,76746,256,175,76433,76433,74726,75570,76397
5794,146,185,4133,1661,2.81648e+13,160.63,860.72,5794,113,105,5348,4343,4321,4740,4834
62950,203,288,44959,17991,2.80144e+13,172.7,2913.99,62950,230,175,62662,62662,57591,60170,62577
4307,82,182,3073,1234,2.81794e+13,155.632,739.717,4307,104,97,3498,2967,1527,1216,2085
89333,38,336,63808,25525,2.80185e+13,173.154,3497.77,89333,279,175,64739,50709,17475,12789,21523
83245,458,942,59529,23716,2.72785e+13,218.879,4511.97,83245,800,198,82056,81757,76133,78422,80777
78365,20,316,55977,22388,2.8016e+13,172.999,3266.19,78365,259,175,47463,33583,13336,7938,11708
90602,278,475,64701,25901,2.80938e+13,173.228,3702.98,90602,280,192,90127,90007,79463,76413,83615
75775,35,311,54125,21650,2.80055e+13,172.956,3209.08,75775,254,175,53685,42746,14401,10842,17699
82304,302,323,58786,23518,2.80113e+13,173.046,3350.66,82304,266,175,81981,81981,81268,81603,81960
37941,62,243,27099,10842,2.80106e+13,172.013,2243,37941,186,173,30051,24602,10308,11669,15088
97251,243,492,69445,27806,2.80884e+13,173.351,3843.02,97251,292,194,96759,96638,80939,73483,90010
11818,133,195,8440,3378,2.79739e+13,167.177,1233.95,11818,135,125,10791,8875,7640,7328,9088
48815,112,262,34877,13938,2.79838e+13,172.454,2553.95,48815,206,175,43080,36063,25230,24274,32444
12032,55,196,8599,3433,2.80029e+13,167.432,1246.07,12032,137,126,9308,7637,3043,2648,4046
64360,333,436,45944,18416,2.81399e+13,172.964,3136.59,64360,248,178,63924,63924,62526,61275,62806
34510,202,237,24643,9867,2.80496e+13,171.736,2136.27,34510,180,166,34273,34273,32628,33443,34238
74021,44,308,52870,21151,2.80148e+13,172.95,3170.36,74021,251,175,55375,43754,16685,19841,22942
80235,205,319,57308,22927,2.80071e+13,173.022,3306.26,80235,262,175,79916,79916,72873,76467,79802
87921,331,482,62773,25148,2.81113e+13,173.22,3661.37,87921,291,184,87439,87439,85412,82747,85078
93144,366,482,66517,26627,2.80965e+13,173.273,3757.13,93144,286,193,92662,92662,85639,89223,92546
23690,70,217,16922,6768,2.80112e+13,170.677,1760.69,23690,160,146,19090,15741,7104,6554,10315
37512,116,242,26793,10719,2.80119e+13,171.903,2229.51,37512,185,171,33376,27773,19798,19419,25766
28412,68,226,20285,8127,2.80686e+13,171.145,1933.03,28412,168,155,22806,18844,8360,9347,12317
48316,78,261,34511,13805,2.79843e+13,172.356,2540,48316,204,175,39687,33092,16212,15513,22993
36281,146,240,25918,10363,2.80348e+13,171.857,2191.74,36281,183,169,34185,27442,27360,30153,30666
64293,206,290,45927,18366,2.79986e+13,172.805,2945.83,64293,233,175,64003,64003,58993,61542,63919
20588,117,211,14710,5878,2.79846e+13,170.243,1638.38,20588,155,141,18295,15225,11201,10432,14348
95114,101,346,67938,27176,2.80076e+13,173.162,3613.86,95114,289,175,82119,69283,42694,50055,58393
20139,398,800,14434,5705,2.58751e+13,179.95,2394.65,20139,528,137,19339,19154,16602,12368,1026
59118,243,426,42199,16919,2.8163e+13,172.868,3008.11,59118,223,193,58692,58571,38845,27932,53639
24927,124,219,17807,7120,2.80162e+13,170.816,1807.07,24927,162,149,22465,18622,15166,15410,18301
88421,729,800,63239,25182,2.72311e+13,247.637,4429.85,88421,798,175,87575,87335,77846,82793,87409
31051,61,230,22183,8868,2.80046e+13,171.407,2022.32,31051,173,160,24523,20085,8400,7446,11865
68372,280,298,48841,19531,2.8021e+13,172.884,3042.26,68372,241,175,68074,68074,67587,67805,68056
90580,115,338,64702,25878,2.80136e+13,173.143,3522.84,90580,281,175,80499,67118,47671,42962,61933
14222,37,200,10159,4063,2.8037e+13,168.582,1356.97,14222,143,129,10198,8032,2938,2035,3365
6692,181,186,4779,1913,2.80039e+13,162.198,924.614,6692,116,108,6506,6506,6470,6481,6501
20439,136,211,14599,5840,2.80234e+13,170.144,1632.68,20439,154,141,18853,15369,13826,13731,16012
92574,258,341,66124,26450,2.79943e+13,173.123,3562.48,92574,284,175,92233,92233,87300,89807,92150
2718,8,179,1942,776,2.81798e+13,144.525,586.257,2718,88,85,1135,520,321,224,230
46554,182,258,33252,13302,2.80061e+13,172.276,2491.88,46554,201,175,46296,46296,41838,44101,46220
24509,12,219,17503,7006,2.80287e+13,170.886,1792.11,24509,162,148,12099,7669,3636,2091,2635
1476,160,176,1057,419,2.76641e+13,119.045,429.694,1476,72,64,1286,1089,1198,1249,1214
72572,20,305,51839,20733,2.79999e+13,172.901,3137.37,72572,248,175,43951,31096,12338,7348,10261
99650,147,354,71175,28475,2.79987e+13,173.221,3703.02,99650,297,175,94297,75461,75791,74199,84922
39944,112,246,28528,11416,2.80407e+13,171.952,2302.35,39944,189,175,35227,29510,20654,23208,26627
84443,11,327,60316,24127,2.80187e+13,173.08,3396.11,84443,270,175,40161,24739,12375,7029,8348
79489,142,318,56769,22720,2.80184e+13,172.956,3290.35,79489,260,175,74485,60048,58169,64325,65206
78606,405,800,56237,22369,2.71205e+13,237.263,4232.53,78606,755,180,77563,76870,75488,76359,76621
42311,60,251,30215,12096,2.80294e+13,172.099,2372.52,42311,193,175,33355,27222,11348,11976,16179
18142,70,206,12957,5185,2.80015e+13,169.427,1535.02,18142,149,136,14606,12063,5497,8103,8151
96740,446,489,69080,27660,2.81116e+13,173.308,3829.29,96740,299,192,96251,96251,94239,95245,96107
31407,3399,7219,20097,11310,2.4256e+13,391.659,10501.2,31407,4413,286,24188,23924,23393,20592,5490
98759,268,353,70539,28220,2.80118e+13,173.206,3686.19,98759,296,175,98406,98406,93351,95920,98321
94968,125,346,67840,27128,2.79943e+13,173.206,3611.24,94968,289,175,86096,71394,57945,49837,69534
90075,87,483,64317,25758,2.81002e+13,173.291,3702.65,90075,279,192,75482,62881,30794,25375,43840
59315,737,800,42459,16856,2.68352e+13,229.302,3804.49,59315,798,175,58515,58280,51987,55235,58327
10662,81,193,7621,3041,2.79563e+13,166.703,1171.3,10662,133,121,8760,7395,3727,3343,5262
3400,174,180,2430,970,2.78282e+13,150.881,656.666,3400,95,91,3216,2638,3168,3186,3201
18318,160,207,13083,5235,2.8063e+13,169.542,1543.53,18318,150,137,17637,13970,15937,17049,16678
74179,592,800,53072,21107,2.70611e+13,222.023,4139.42,74179,783,180,73302,72902,70353,71649,72755
4607,90,183,3288,1319,2.80863e+13,157.715,766.341,4607,107,98,3811,3180,1791,1599,2451
86294,86,331,61638,24656,2.801e+13,173.072,3435.46,86294,273,175,72168,60218,31877,41511,45820
71363,228,304,50969,20394,2.80126e+13,172.871,3111.28,71363,246,175,71059,71059,66647,68884,70983
65995,164,294,47143,18852,2.80104e+13,172.845,2987,65995,237,175,64403,50544,57781,61839,61926
80244,20,319,57320,22924,2.80022e+13,173.023,3306.43,80244,263,175,48594,34383,13645,8714,12345
24487,171,218,17489,6998,2.8008e+13,170.778,1790.27,24487,161,148,24101,18952,21813,20713,23810
49926,473,800,35746,14180,2.66222e+13,209.427,3569.92,49926,787,175,48926,48639,45330,46980,48145
13067,186,198,9338,3729,2.808e+13,168.178,1299.94,13067,141,127,12869,12869,12681,12762,12857
26406,75,222,18858,7548,2.80254e+13,170.968,1861.42,26406,165,151,21530,17791,8763,8875,12152
81925,222,944,58584,23341,2.72574e+13,218.166,4487.66,81925,810,180,80477,79918,72991,75302,78493
10990,9,194,7852,3138,2.80699e+13,166.606,1189.61,10990,133,124,4812,2329,1376,860,535
12915,69,198,9225,3690,2.81053e+13,167.882,1292.19,12915,141,127,10350,8550,3815,3075,5507
36548,10,241,26103,10445,2.80187e+13,171.841,2200.59,36548,183,170,16716,9055,5028,2911,3388
51614,216,267,36871,14743,2.79966e+13,172.523,2628.61,51614,211,175,51347,51347,48572,49969,51296
41524,186,249,29663,11861,2.80282e+13,172.071,2349.2,41524,192,175,41275,41275,37733,39521,41212
10789,121,193,7712,3077,2.79533e+13,167.1,1178.72,10789,133,123,9610,7992,6113,5282,7570
86479,79,331,61771,24708,2.80038e+13,173.137,3439.06,86479,274,175,71232,59390,29254,25372,41964
65293,152,292,46637,18656,2.80097e+13,172.792,2969.64,65293,235,175,62333,49431,52355,56104,57395
78879,23,317,56340,22539,2.80066e+13,173.05,3277.43,78879,260,175,50043,36503,13415,8418,13201
20203,22,211,14427,5776,2.80581e+13,170.114,1623.43,20203,154,140,12627,8993,3461,2289,3374
14137,102,800,10150,3987,2.48692e+13,172.742,2133.9,14137,530,126,11678,9931,5801,4207,365
75575,191,800,54068,21507,2.70755e+13,222.076,4169,75575,784,180,74219,73845,65884,69399,72724
68960,118,800,49344,19616,2.70164e+13,226.564,4026.12,68960,798,175,60741,50459,36806,40146,46170
33762,86,235,24119,9643,2.79955e+13,171.699,2111.72,33762,178,165,28205,23542,12474,11526,17106
83455,65,325,59608,23847,2.79995e+13,173.081,3375.04,83455,268,175,66638,55057,23065,24329,33884
60229,33,283,43025,17204,2.80083e+13,172.698,2847.82,60229,226,175,42013,32120,11125,11576,14685
83807,131,326,59863,23944,2.80196e+13,173.088,3382.93,83807,269,175,76881,63149,53002,50007,64748
11964,66,196,8545,3419,2.80563e+13,167.531,1242.77,11964,137,125,9521,7895,3454,2546,4751
93987,424,800,67223,26764,2.72663e+13,247.407,4536.79,93987,798,175,92832,92223,81923,87376,91997
76890,282,313,54920,21970,2.80059e+13,172.978,3233.62,76890,256,175,76577,76577,75183,75868,76546
72799,624,800,52088,20711,2.70384e+13,217.595,4109.69,72799,798,175,71911,71511,66105,69013,71471
13016,29,197,9304,3712,2.78979e+13,167.97,1296.21,13016,140,127,8779,6620,2201,2780,2711
61248,122,284,43747,17501,2.79998e+13,172.671,2871.98,61248,227,175,55169,45710,35545,37664,43917
17322,32,205,12373,4949,2.79695e+13,169.43,1499.8,17322,148,135,11971,9076,3179,2252,3672
36438,208,240,26024,10414,2.80106e+13,171.744,2196.32,36438,182,169,36198,36198,34724,35453,36166
76101,251,311,54365,21736,2.79965e+13,173,3215.81,76101,255,175,75790,75790,72402,74114,75730
58892,107,800,42153,16739,2.68247e+13,214.762,3794.15,58892,778,180,50636,42589,27545,25737,36187
36343,542,800,26055,10288,2.60653e+13,215.124,3186.18,36343,798,165,35401,35081,31247,33176,34769
33533,168,235,23949,9584,2.80313e+13,171.556,2104.41,33533,177,164,32885,25850,29527,31447,32076
45624,83,256,32591,13033,2.79721e+13,172.236,2465.75,45624,199,175,37884,31745,16150,15059,22544
89865,10,337,64183,25682,2.80235e+13,173.099,3508.49,89865,279,175,41110,22274,12356,7320,8488
39006,85,800,27948,11058,2.62098e+13,221.542,3266.73,39006,689,172,31766,26681,13496,13051,19205
78914,454,800,56460,22454,2.71145e+13,247.7,4238.48,78914,704,175,77933,77178,76870,77180,77076
70322,176,800,50313,20009,2.70237e+13,225.237,4055.97,70322,771,180,68944,68601,60198,63903,67414
97190,536,800,69517,27673,2.72847e+13,235.345,4596.8,97190,788,180,96253,95853,92804,94335,95598
93982,491,800,67223,26759,2.72528e+13,223.735,4536.27,93982,798,180,92971,92616,87454,90069,92255
82207,179,323,58718,23489,2.80135e+13,173.048,3348.78,82207,266,175,81884,81884,72814,77451,81740
45603,92,257,32571,13032,2.80375e+13,172.279,2466.23,45603,200,175,38622,31802,17912,17848,25423
97627,84,351,69728,27899,2.80193e+13,173.18,3663.97,97627,293,175,81336,67938,34656,35360,50934
51797,212,267,36994,14803,2.80146e+13,172.376,2632.7,51797,210,175,51530,51530,48500,50028,51475
13219,52,198,9445,3774,2.80128e+13,168.107,1307.12,13219,141,127,10136,8230,3218,3799,4615
58818,135,280,42012,16806,2.80027e+13,172.676,2812.67,58818,223,175,54365,44312,39313,39745,46526
83759,247,800,59915,23844,2.71767e+13,228.529,4337.44,83759,782,180,82500,82014,76949,79089,81158
35708,31,239,25508,10200,2.79877e+13,171.913,2174.08,35708,182,169,24505,18579,6399,4569,7410
79083,113,317,56489,22594,2.80056e+13,172.987,3281.51,79083,260,175,69964,58598,41202,46042,53312
94443,305,344,67458,26985,2.80053e+13,173.126,3599.67,94443,287,175,94099,94099,92149,93123,94060
91503,773,800,65447,26056,2.72464e+13,226.107,4489.28,91503,798,175,90703,90467,83564,87172,90623
79104,143,317,56504,22600,2.8007e+13,173.01,3281.86,79104,260,175,74256,59747,58450,57896,65561
35049,94,237,25031,10018,2.80241e+13,171.691,2152.29,35049,180,167,29789,24505,14193,17639,20203
75285,53,310,53779,21506,2.80008e+13,172.977,3198.13,75285,253,175,58150,47760,18401,20041,25243
32188,503,800,23079,9109,2.58213e+13,208.148,3053.78,32188,774,157,31231,30934,28606,29769,30497
67133,287,295,47956,19177,2.80075e+13,172.805,3012.51,67133,238,175,66838,66838,66746,66783,66830
81817,611,800,58536,23281,2.71368e+13,237.749,4298.18,81817,798,175,80871,80473,71938,76305,80450
8795,6,190,6285,2510,2.80317e+13,165.1,1062.42,8795,125,115,3103,1178,780,635,277
5548,128,184,3965,1583,2.79161e+13,159.881,841.476,5548,112,103,4950,4134,3457,3474,4112
90327,96,800,64612,25715,2.7216e+13,222.707,4466.43,90327,798,180,76364,62834,36886,36891,51745
18170,11,206,12980,5190,2.79661e+13,169.588,1536.48,18170,150,137,8629,5315,2658,1549,1348
1947,12,177,1386,561,2.82767e+13,130.793,493.39,1947,81,77,957,617,295,198,232
61098,268,424,43617,17481,2.81583e+13,172.89,3049.77,61098,226,192,60674,60554,49499,47716,56637
89068,214,477,63601,25467,2.80844e+13,173.254,3678.28,89068,277,193,88591,88468,59848,37993,77160
83523,135,325,59660,23863,2.8007e+13,173.032,3376.34,83523,268,175,77203,62941,55867,59163,65533
84551,171,327,60393,24158,2.80062e+13,173.044,3398.12,84551,270,175,83620,65545,74344,79404,82221
25687,91,220,18351,7336,2.79711e+13,171.011,1834.85,25687,164,151,21656,17901,10073,9792,14290
93407,317,343,66718,26689,2.80054e+13,173.179,3579.95,93407,286,175,93064,93064,92010,92520,93038
97364,179,350,69546,27818,2.80125e+13,173.184,3658.33,97364,293,175,97014,97014,86128,91696,96843
33562,137,235,23971,9591,2.80322e+13,171.662,2105.43,33562,178,164,31085,25267,22861,24179,26885
15922,95,202,11372,4550,2.79971e+13,168.798,1436.09,15922,145,132,13512,11158,6632,8135,9251
9474,181,191,6772,2702,2.79843e+13,165.839,1103.52,9474,129,118,9283,9283,9138,9200,9273
92093,74,340,65787,26306,2.79937e+13,173.157,3552.77,92093,283,175,75037,61593,29846,28668,40929
99293,22,353,70930,28363,2.79958e+13,173.212,3695.67,99293,297,175,62111,44160,16877,10416,15327
5534,44,184,3952,1582,2.80122e+13,159.787,840.068,5534,110,103,4102,3261,1275,1491,1634
92733,715,800,66330,26403,2.72478e+13,242.731,4512.84,92733,769,180,91933,91752,90196,90967,91679
11400,5,195,8140,3260,2.80858e+13,166.97,1212.4,11400,135,124,3551,1272,768,660,302
98304,94,495,70194,28110,2.81084e+13,173.323,3864.55,98304,308,184,83636,68811,38479,35692,54184
22673,213,215,16195,6478,2.8007e+13,170.515,1721.45,22673,158,145,22458,22458,22455,22454,22456
4549,112,182,3255,1294,2.78564e+13,156.377,759.831,4549,104,99,3933,3330,2355,2277,2921
28307,65,226,20215,8092,2.80384e+13,171.188,1929.47,28307,168,155,22562,18663,7855,8872,11792
73676,154,307,52624,21052,2.80065e+13,172.917,3162.16,73676,250,175,70618,55786,62125,63317,65724
63025,36,288,45018,18007,2.80056e+13,172.698,2915.74,63025,231,175,44997,35664,12776,13240,16073
10218,108,192,7295,2923,2.80139e+13,165.989,1145.81,10218,129,120,8888,7471,5016,5693,6562
96488,36,349,68918,27570,2.80202e+13,173.186,3641.59,96488,292,175,68889,54606,18699,14170,23381
94717,857,947,67719,26998,2.73727e+13,246.107,4741.09,94717,765,199,93770,93770,92308,92923,93501
3537,3,180,2523,1014,2.77059e+13,151.615,669.221,3537,95,91,739,165,153,236,196
87442,164,333,62456,24986,2.80126e+13,173.096,3459.14,87442,275,175,85382,66995,76541,81962,82154
81221,26,321,58015,23206,2.80103e+13,173.001,3327.48,81221,264,175,53588,39356,13819,9710,14929
39405,215,245,28143,11262,2.80241e+13,171.952,2286.58,39405,188,175,39160,39160,37853,38493,39130
76560,305,312,54686,21874,2.80016e+13,172.966,3225.88,76560,255,175,76248,76248,76177,76204,76241
88767,829,947,63473,25294,2.73263e+13,237.482,4627.09,88767,774,197,87820,87820,85880,86744,87467
81544,794,800,58332,23212,2.71534e+13,243.331,4292.69,81544,798,175,80744,80490,78637,79558,80727
86060,77,329,61472,24588,2.8001e+13,173.076,3428.9,86060,272,175,70589,58805,28970,32732,42137
18141,203,207,12961,5180,2.79874e+13,169.74,1535.94,18141,150,137,17934,17934,17916,17920,17930
65411,254,292,46727,18684,2.79957e+13,172.852,2972.46,65411,236,175,65119,65119,63233,64173,65081
12379,51,196,8845,3534,2.80029e+13,167.507,1263.58,12379,137,126,9462,7667,3054,3869,4349
71621,389,941,51227,20394,2.71606e+13,220.895,4266.59,71621,812,192,70348,69758,63193,60471,65506
85303,210,471,60909,24394,2.81125e+13,173.222,3600.34,85303,270,194,84832,84708,65410,50067,76230
63412,590,800,45378,18034,2.6911e+13,212.941,3900.5,63412,798,175,62509,62109,57903,60041,61982
64288,55,290,45928,18360,2.7992e+13,172.814,2945.81,64288,234,175,49968,40899,16039,14789,23215
92327,218,800,66034,26293,2.7267e+13,232.441,4505.16,92327,787,180,90994,90566,82385,86071,89549
80195,276,319,57279,22916,2.80088e+13,173.015,3305.42,80195,262,175,79876,79876,77654,78768,79833
65666,148,293,46900,18766,2.80114e+13,172.721,2978.72,65666,235,175,62214,49720,50179,54896,56059
29129,23,226,20810,8319,2.79819e+13,171.291,1956.74,29129,169,156,18468,13467,4955,4581,4189
54231,187,272,38733,15498,2.80034e+13,172.573,2697.01,54231,215,175,53959,53959,48893,51468,53874
70924,765,800,50756,20168,2.69968e+13,241.933,4069.02,70924,692,175,70124,69990,69932,69922,70020
32528,172,232,23238,9290,2.79536e+13,171.617,2070.91,32528,176,163,32127,25467,28918,30629,31884
13509,116,198,9650,3859,2.79637e+13,168.111,1320.96,13509,141,128,11957,9982,7146,6468,9263
13488,165,198,9634,3854,2.79029e+13,167.983,1319.81,13488,141,128,13070,10325,11893,12592,12492
81943,69,322,58528,23415,2.80007e+13,173.036,3342.72,81943,265,175,66028,54363,24068,28652,36462
74303,799,944,53133,21170,2.71978e+13,217.666,4329.59,74303,799,182,73359,73198,72617,71566,72275
36938,182,240,26389,10549,2.79898e+13,171.819,2210.92,36938,184,170,36698,36698,33455,35094,36640
62061,138,287,44332,17729,2.80118e+13,172.76,2893.21,62061,230,175,57667,46752,43386,44846,49921
56972,227,277,40695,16277,2.80105e+13,172.566,2766.75,56972,220,175,56695,56695,53988,55350,56645
87802,198,800,62810,24992,2.72114e+13,224.122,4417.81,87802,798,175,86436,86049,77035,81107,84940
37237,143,242,26595,10642,2.80183e+13,171.974,2221.54,37237,185,171,34883,28096,27487,30411,30996
92553,17,341,66105,26448,2.79945e+13,173.133,3562.13,92553,284,175,52536,37309,15561,12550,13514
85891,245,800,61440,24451,2.71857e+13,221.277,4379.63,85891,798,180,84625,84143,78703,81035,83274
16888,20,204,12068,4820,2.79378e+13,169.169,1479.98,16888,148,134,10219,7229,2869,1837,2657
32092,107,232,22919,9173,2.79957e+13,171.574,2057.4,32092,175,162,28006,23521,15494,15322,20140
34912,101,237,24930,9982,2.80009e+13,171.737,2148.24,34912,180,167,30098,25406,15673,15468,21254
91165,270,338,65120,26045,2.79976e+13,173.117,3533.72,91165,282,175,90827,90827,86901,88891,90759
92505,214,950,66135,26370,2.73484e+13,226.981,4702.09,92505,800,195,91014,90473,72504,35288,79658
40813,9,248,29154,11659,2.80128e+13,172.112,2328.86,40813,191,175,17849,8634,5091,2654,2047
6991,91,187,4997,1994,2.80953e+13,162.994,946.614,6991,119,109,5834,4846,2753,2699,3763
82918,519,800,59319,23599,2.71653e+13,250.788,4320.7,82918,707,176,82001,81601,81077,81309,81275
80755,417,800,57773,22982,2.71345e+13,220.113,4276.28,80755,798,175,79652,79016,72693,76093,78806
62550,244,287,44685,17865,2.79977e+13,172.779,2904.33,62550,230,175,62263,62263,60041,61155,62220
1263,19,176,900,363,2.74243e+13,110.628,396.773,1263,67,62,735,533,210,162,121
12963,148,197,9264,3699,2.7925e+13,168.124,1293.95,12963,141,127,12176,9776,9849,10757,11041
36862,133,241,26334,10528,2.79977e+13,171.931,2209.7,36862,184,171,33881,27750,23833,21726,28340
14405,99,201,10289,4116,2.80424e+13,168.472,1366.62,14405,143,130,12304,10414,6313,7501,8618
10004,125,192,7146,2858,2.79655e+13,166.184,1134.29,10004,129,119,8979,7486,6082,5802,7268
70937,247,302,50671,20266,2.79982e+13,172.851,3100.25,70937,245,175,70635,70635,67606,69133,70580
15440,87,202,11026,4414,2.80411e+13,168.901,1414.63,15440,145,132,12889,10751,5869,5683,8200
57653,221,278,41179,16474,2.8002e+13,172.64,2783.72,57653,221,175,57375,57375,54208,55807,57318
72970,363,418,52090,20880,2.81153e+13,171.753,3293.95,72970,253,175,72552,72552,72530,72524,72458
96549,9,800,69052,27497,2.72836e+13,225.494,4584.68,96549,798,180,42399,20988,11973,9189,9315
10564,129,193,7548,3016,2.80024e+13,166.612,1166.11,10564,132,121,9561,7924,6608,6623,7950
29242,6,227,20886,8356,2.80182e+13,171.335,1961.6,29242,170,157,10303,3910,2588,1743,1008
97621,497,941,69801,27820,2.73661e+13,227.62,4788.14,97621,800,197,96485,96109,91524,93310,95302
88092,169,333,62918,25174,2.79977e+13,173.077,3471.19,88092,276,175,86817,68136,77374,82696,84554
61936,111,429,44218,17718,2.81615e+13,172.956,3075.38,61936,228,193,54522,45679,22051,14025,35460
70120,217,301,50089,20031,2.80092e+13,172.907,3082.32,70120,244,175,69819,69819,64829,67365,69735
95443,135,346,68171,27272,2.8004e+13,173.125,3619.7,95443,289,175,88261,71938,63850,67635,74722
37211,67,241,26578,10633,2.79925e+13,171.895,2219.85,37211,184,171,29814,24604,10834,11799,15984
5806,39,184,4145,1661,2.77912e+13,160.139,859.956,5806,111,104,4213,3310,1216,1366,1504
63089,212,288,45066,18023,2.8004e+13,172.757,2917.18,63089,232,175,62801,62801,58334,60603,62725
74276,184,309,53043,21233,2.80248e+13,172.897,3176.51,74276,251,175,73967,73967,66200,70165,73842
57710,163,421,41198,16512,2.81596e+13,172.859,2970.3,57710,220,194,56066,44210,33666,24662,46858
86634,256,331,61873,24761,2.80154e+13,173.052,3441.8,86634,273,175,86303,86303,81917,84142,86228
42692,179,251,30492,12200,2.80101e+13,172.156,2383.02,42692,194,175,42441,42441,38278,40388,42369
73786,22,457,52677,21109,2.81288e+13,173.064,3357.9,73786,249,196,46140,32822,12607,7633,8503
45114,375,800,32313,12801,2.64594e+13,211.92,3441.07,45114,798,175,44002,43439,39235,41313,43039
58401,41,279,41717,16684,2.79857e+13,172.644,2802,58401,222,175,43056,33889,12240,16705,17618
17153,176,205,12255,4898,2.79907e+13,169.458,1492.67,17153,148,134,16948,16948,15687,16304,16919
7357,112,187,5257,2100,2.79993e+13,163.377,970.16,7357,119,110,6421,5405,3790,4003,4889
11827,3,195,8444,3383,2.79645e+13,167.167,1234.32,11827,135,125,2480,558,514,644,265
86725,220,331,61948,24777,2.80104e+13,173.12,3443.6,86725,274,175,86394,86394,79568,83050,86283
63266,264,289,45188,18078,2.80302e+13,172.744,2922.04,63266,232,175,62977,62977,62014,62477,62952
91885,60,490,65603,26282,2.80984e+13,173.242,3743.44,91885,281,196,72485,59205,23240,17253,31733
40939,15,248,29243,11696,2.80022e+13,172.089,2332.03,40939,191,175,22200,15323,6450,3779,4742
38748,158,244,27676,11072,2.80049e+13,171.949,2266.75,38748,187,173,37348,29594,33811,36227,35123
95018,16,495,67844,27174,2.81069e+13,173.319,3805.72,95018,288,192,52716,37090,15675,7526,11014
24365,66,218,17404,6961,2.80153e+13,170.69,1785.96,24365,161,148,19456,16112,7023,7906,10261
44881,201,255,32060,12821,2.79928e+13,172.3,2445.53,44881,198,175,44626,44626,41656,43155,44572
99579,5,355,71126,28453,2.8013e+13,173.193,3702.71,99579,297,175,30973,10989,6666,5763,2477
33380,736,800,23928,9452,2.58778e+13,213.185,3092.71,33380,744,161,32580,32428,31764,32066,32389
25765,177,220,18411,7354,2.7952e+13,170.927,1837.31,25765,164,151,25545,25545,23319,24434,25502
68681,285,298,49062,19619,2.80015e+13,172.879,3048.83,68681,241,175,68383,68383,68148,68249,68370
68454,609,800,48981,19473,2.69919e+13,215.983,4014.79,68454,798,175,67556,67156,62053,64669,67081
24459,24,218,17471,6988,2.80113e+13,170.764,1789.45,24459,161,148,15732,11534,4171,3950,3673
27950,81,225,19969,7981,2.80288e+13,171.24,1916.83,27950,168,154,23075,19427,9753,8347,13899
50444,223,265,36028,14416,2.80012e+13,172.438,2597.63,50444,208,175,50179,50179,48051,49115,50137
13181,148,198,9418,3763,2.80721e+13,167.961,1305.12,13181,141,128,12385,9944,10018,10415,11193
1789,44,177,1280,509,2.7703e+13,131.513,475.278,1789,74,72,1295,1038,408,392,511
59278,6,281,42343,16935,2.79992e+13,172.69,2824.32,59278,224,175,20889,7924,5252,3534,1616
3727,65,180,2668,1059,2.75775e+13,153.536,687.546,3727,98,92,2907,2434,1083,1101,1491
32410,118,375,23134,9276,2.82551e+13,172.045,2249.49,32410,191,180,28863,24006,14299,11661,20527
64707,284,291,46219,18488,2.80066e+13,172.772,2955.88,64707,234,175,64416,64416,64353,64373,64409
63215,149,289,45150,18065,2.80194e+13,172.788,2920.94,63215,232,175,59988,47848,48748,52944,54432
20750,160,212,14818,5932,2.80513e+13,170.182,1645.61,20750,155,141,19998,15828,18052,19327,18855
36106,132,240,25786,10320,2.80576e+13,171.751,2186.62,36106,182,169,33114,27183,23103,23509,27760
30208,58,229,21577,8631,2.80218e+13,171.525,1995.01,30208,172,158,23656,19371,7918,7416,11342
95153,260,346,67969,27184,2.80124e+13,173.172,3614.57,95153,289,175,94807,94807,89701,92294,94721
87539,77,332,62527,25012,2.79992e+13,173.115,3460.06,87539,275,175,71799,59809,29445,29791,42040
94830,107,417,67732,27098,2.80469e+13,172.76,3701.22,94830,288,180,82905,69586,33646,35907,24045
33289,108,800,23871,9418,2.59019e+13,219.013,3089.88,33289,795,160,28252,23785,15336,13836,19773
55097,29,290,39350,15747,2.80029e+13,172.404,2738.81,55097,216,175,37242,28086,9401,6800,4396
91448,49,339,65322,26126,2.79987e+13,173.131,3539.76,91448,282,175,69659,56378,21512,23648,29228
15263,184,201,10897,4366,2.80344e+13,168.538,1405.5,15263,144,131,15062,15062,14620,14815,15045
83572,117,325,59697,23875,2.80041e+13,173.061,3377.27,83572,269,175,74569,61924,45489,42335,58699
5564,32,184,3977,1587,2.79876e+13,159.805,842.206,5564,110,104,3829,2911,1032,806,1272
26776,24,800,19218,7558,2.54033e+13,212.599,2867.22,26776,673,148,16887,12690,4395,3923,4756
62190,169,286,44416,17774,2.79922e+13,172.728,2895.02,62190,229,175,61244,48085,54708,58390,59925
91029,323,431,65014,26015,2.80672e+13,172.535,3652.97,91029,281,183,90598,90598,84142,87433,90490
11596,108,195,8285,3311,2.80116e+13,167.33,1222.71,11596,135,124,10081,8474,5659,4802,7363
87250,208,332,62314,24936,2.80194e+13,173.045,3454.33,87250,274,175,86918,86918,79196,83139,86794
60817,23,284,43440,17377,2.80106e+13,172.704,2862.17,60817,227,175,38587,28147,10341,9030,10693
59663,188,282,42619,17044,2.79979e+13,172.668,2833.96,59663,225,175,59381,59381,53738,56610,59287
98153,277,497,70078,28075,2.81043e+13,173.318,3864.17,98153,303,192,97656,97536,89696,88506,93681
19963,50,210,14257,5706,2.79722e+13,170.052,1612.91,19963,153,140,15226,12328,4987,5228,6456
21999,185,214,15715,6284,2.80009e+13,170.445,1695.16,21999,157,144,21785,21785,20563,21159,21756
6582,102,186,4706,1876,2.80228e+13,162.099,917.3,6582,116,108,5604,4770,2971,2994,3951
8110,17,189,5794,2316,2.80731e+13,164.138,1019.67,8110,123,113,4594,3272,1379,847,1091
65638,27,438,46855,18783,2.81413e+13,172.954,3165.5,65638,234,192,43666,32496,11231,8233,12832
35216,11,418,25166,10050,2.77311e+13,169.981,2375.64,35216,247,167,16750,10378,5116,2414,199
37992,179,243,27139,10853,2.80062e+13,171.97,2244.21,37992,186,173,37749,37749,34149,35970,37685
43385,70,252,30989,12396,2.79845e+13,172.15,2402.42,43385,195,175,35008,28857,13022,13225,18812
44047,51,254,31456,12591,2.80242e+13,172.271,2422.41,44047,197,175,33760,27300,10840,10079,14490
57258,217,277,40904,16354,2.79861e+13,172.574,2773.31,57258,221,175,56981,56981,53602,55311,56921
9736,89,191,6950,2786,2.80124e+13,165.499,1117.88,9736,127,118,8139,6778,3853,4752,5359
82770,147,324,59124,23646,2.80186e+13,173.063,3360.84,82770,267,175,78302,62668,62936,69054,70589
44189,142,254,31567,12622,2.79915e+13,172.277,2426.06,44189,197,175,41335,33353,32317,32244,36412
26552,540,946,19027,7525,2.57341e+13,210.592,3041.51,26552,778,155,25491,25162,23280,23119,23915
81443,144,322,58172,23271,2.80256e+13,173,3332.93,81443,264,175,76595,61517,60484,67069,67436
80085,230,319,57206,22879,2.80173e+13,173.012,3303.25,80085,262,175,79766,79766,74455,77154,79677
25522,107,220,18228,7294,2.8003e+13,170.853,1828.6,25522,163,150,22270,18703,12331,11449,16186
93634,31,343,66879,26755,2.80051e+13,173.132,3583.82,93634,286,175,64320,48755,16785,12026,19240
18949,71,208,13530,5419,2.80722e+13,169.624,1570.05,18949,151,138,15297,12601,5858,8519,8577
3376,129,180,2409,967,2.81094e+13,150.506,654.285,3376,95,91,2971,2503,2091,1908,2479
53337,145,271,38093,15244,2.80294e+13,172.55,2674.46,53337,214,175,50216,40270,39967,44277,44593
81342,155,467,58070,23272,2.81192e+13,173.105,3519.02,81342,262,192,77994,61905,55093,49848,67338
62828,183,288,44876,17952,2.80082e+13,172.795,2911.5,62828,231,175,62540,62540,56150,59406,62435
55343,179,274,39527,15816,2.8003e+13,172.606,2725.52,55343,217,175,55069,55069,49323,52248,54974
74800,252,800,53520,21280,2.70737e+13,219.16,4152.69,74800,792,180,73567,73071,69140,70730,72256
61653,77,285,44034,17619,2.79871e+13,172.692,2881.99,61653,228,175,50552,42124,20786,19671,28478
78709,70,316,56226,22483,2.79991e+13,173.042,3273.15,78709,260,175,63548,52352,23499,21666,34763
38022,679,800,27253,10769,2.61475e+13,209.095,3237.06,38022,769,168,37222,37038,35420,36221,36860
75779,535,800,54221,21558,2.7101e+13,216.832,4173.43,75779,798,180,74815,74445,69664,72077,74184
67074,403,800,48000,19074,2.69762e+13,216.415,3983.89,67074,798,175,65969,65359,59810,62815,65083
26768,50,222,19121,7647,2.79829e+13,171.062,1873.87,26768,165,152,20429,16532,6412,5806,8584
80435,198,320,57450,22985,2.8025e+13,173.017,3311.11,80435,263,175,80115,80115,72554,76414,79993
57405,246,278,40998,16407,2.80224e+13,172.667,2777.99,57405,221,175,57127,57127,55686,56396,57095
65288,16,292,46627,18661,2.80032e+13,172.801,2969.61,65288,235,175,36231,25493,10751,7796,9206
30740,208,378,21931,8809,2.82603e+13,171.847,2199.24,30740,187,177,30362,30237,23367,17436,27268
3057,114,180,2180,877,2.83262e+13,147.997,622.581,3057,95,89,2631,2234,1616,1807,2050
14573,146,200,10411,4162,2.7951e+13,168.471,1373.07,14573,143,130,13673,11006,10950,11470,12190
36189,182,240,25843,10346,2.80439e+13,171.74,2189.03,36189,182,169,35949,35949,32733,34357,35891
50343,124,265,35954,14389,2.80071e+13,172.426,2595.02,50343,208,175,45493,37649,30643,31135,36560
31824,115,232,22726,9098,2.80412e+13,171.43,2048.72,31824,174,161,28231,23561,16775,18889,21832
25471,35,220,18195,7276,2.79983e+13,170.913,1827.15,25471,163,149,18026,14358,4898,3564,6071
63746,30,289,45532,18214,2.79959e+13,172.733,2932.52,63746,232,175,43439,32840,10948,13724,13658
87020,98,331,62156,24864,2.80044e+13,173.081,3449.06,87020,274,175,74679,63069,37795,37032,52131
75379,20,311,53849,21530,2.79976e+13,173.022,3201.27,75379,254,175,45643,32289,12802,8310,9460
20583,144,351,14679,5904,2.84495e+13,170.806,1812.42,20583,167,158,19167,15535,10480,7752,14925
85886,385,939,61423,24463,2.72806e+13,221.281,4560.86,85886,800,192,84610,84000,77296,80243,83119
69449,183,300,49609,19840,2.79979e+13,172.924,3067.18,69449,243,175,69149,69149,61949,65621,69032
61292,54,285,43777,17515,2.80118e+13,172.65,2873.92,61292,227,175,47503,38895,15120,18305,21836
58536,71,280,41815,16721,2.80197e+13,172.629,2806.04,58536,223,175,47360,38933,17959,15497,25757
97845,566,800,69979,27866,2.73064e+13,236.917,4609.1,97845,786,180,96939,96539,93693,95130,96343
73396,154,307,52425,20971,2.80155e+13,172.955,3156.63,73396,250,175,70338,55562,61888,64395,65387
51718,70,267,36939,14779,2.79812e+13,172.466,2631.01,51718,210,175,41742,34399,15497,15756,22378
70585,206,800,50505,20080,2.70267e+13,218.127,4061.89,70585,798,175,69265,68863,62393,65192,67825
23087,175,243,16499,6588,2.7901e+13,170.251,1770.76,23087,159,146,22844,22844,20805,21805,22782
58348,176,279,41674,16674,2.80087e+13,172.603,2800.74,58348,222,175,58069,58069,51780,54985,57966
59436,16,281,42452,16984,2.80101e+13,172.604,2827.63,59436,224,175,32988,23218,9786,7101,8824
56692,85,277,40491,16201,2.80072e+13,172.664,2760.27,56692,220,175,47290,39535,20419,20238,29978
32643,225,233,23316,9327,2.80105e+13,171.525,2075.37,32643,176,163,32410,32410,32316,32354,32402
89406,326,476,63843,25563,2.80979e+13,173.208,3682.15,89406,277,192,88930,88930,84542,80060,85470
30458,125,229,21754,8704,2.80321e+13,171.403,2002.63,30458,172,159,27537,22870,18560,16030,22311
39199,35,245,28003,11196,2.80024e+13,172.052,2280.65,39199,188,174,27752,22100,7715,7174,9492
62198,707,800,44515,17683,2.68862e+13,234.519,3872.45,62198,796,175,61369,61135,54116,57723,61120
1732,41,177,1233,499,2.76404e+13,128.446,467.266,1732,78,75,1247,992,364,439,481
37747,188,242,26961,10786,2.79904e+13,171.922,2236.25,37747,185,172,37505,37505,34555,36042,37451
63159,97,943,45177,17982,2.70633e+13,222.564,4078.98,63159,767,197,53237,45209,22710,19129,31959
61688,73,285,44063,17625,2.79803e+13,172.715,2882.89,61688,228,175,50132,41143,19683,19114,27479
48596,86,262,34711,13885,2.80085e+13,172.369,2548.12,48596,205,175,40631,33891,17954,14817,25082
50649,231,266,36181,14468,2.80046e+13,172.514,2603.71,50649,209,175,50383,50383,48755,49561,50348
47207,41,259,33719,13488,2.80035e+13,172.299,2509.63,47207,202,175,34795,27395,9916,9402,13929
79161,167,318,56542,22619,2.80135e+13,173.002,3283.93,79161,260,175,77707,61074,69418,74249,75515
11053,189,194,7894,3159,2.8012e+13,166.838,1193.12,11053,133,123,10859,10859,10823,10834,10854
57931,246,279,41377,16554,2.80183e+13,172.679,2791.24,57931,222,175,57652,57652,56130,56882,57619
24287,132,217,17352,6935,2.79835e+13,170.745,1782.46,24287,161,148,22228,18272,15558,15801,18545
65207,289,292,46572,18635,2.80099e+13,172.776,2967.79,65207,235,175,64915,64915,64903,64905,64912
67340,137,358,48089,19251,2.80363e+13,172.292,3091.67,67340,241,175,62450,50743,45796,45438,53230
25241,701,800,18125,7116,2.52245e+13,211.414,2810.88,25241,757,145,24441,24266,23149,23682,24145
98879,236,353,70630,28249,2.79977e+13,173.234,3688.29,98879,296,175,98526,98526,91322,94998,98409
27428,4,224,19591,7837,2.80335e+13,171.254,1898.46,27428,167,153,7194,2184,1591,1935,558
18528,102,207,13242,5286,2.79423e+13,169.661,1551.91,18528,150,137,15967,13508,8363,7977,11288
23879,37,217,17054,6825,2.80313e+13,170.735,1767.54,23879,160,147,17155,13499,4929,5975,6385
43930,224,397,31355,12575,2.82205e+13,172.439,2603.15,43930,196,192,43533,43411,28792,18956,38866
5164,159,183,3691,1473,2.79741e+13,158.089,810.074,5164,107,102,4861,3911,4417,4508,4597
56085,55,276,40064,16021,2.80192e+13,172.612,2745.02,56085,219,175,43587,35683,14018,10380,19144
59907,146,283,42794,17113,2.80107e+13,172.722,2840.53,59907,226,175,56521,45340,45226,49843,50922
36953,21,241,26394,10559,2.80089e+13,171.743,2212.23,36953,183,170,22776,16235,6300,4828,6387
98213,239,352,70151,28062,2.80141e+13,173.206,3675.47,98213,295,175,97861,97861,90899,94451,97748
71346,43,449,50936,20410,2.81257e+13,173.106,3299.14,71346,245,192,53132,42048,15407,8050,17812
91294,311,800,65298,25996,2.72378e+13,226.517,4484.92,91294,798,175,90065,89536,81581,85411,88897
6258,18,185,4480,1778,2.78761e+13,162.121,894.507,6258,116,106,3616,2568,1049,857,693
35834,148,238,25601,10233,2.79601e+13,171.875,2176.78,35834,182,169,33879,27103,27347,26715,30607
24104,146,217,17216,6888,2.80033e+13,170.569,1775.57,24104,160,147,22674,18227,18170,20013,20266
49432,251,264,35312,14120,2.80048e+13,172.488,2571.38,49432,207,175,49168,49168,48962,49051,49155
15904,111,202,11364,4540,2.79047e+13,169.045,1435.37,15904,146,133,13933,11702,8141,7718,10503
8002,165,189,5711,2291,2.81354e+13,164.057,1013.47,8002,123,113,7683,6101,7056,7425,7402
37132,234,242,26521,10611,2.80179e+13,171.902,2218.55,37132,185,171,36890,36890,36816,36844,36882
55088,243,274,39346,15742,2.80074e+13,172.652,2719.54,55088,217,175,54814,54814,53456,54122,54783
1096,26,285,773,323,3.30128e+13,42.2318,455.529,1096,54,73,698,501,230,131,185
79127,225,317,56521,22606,2.80042e+13,172.997,3282.22,79127,260,175,78810,78810,73270,76089,78718
99737,212,355,71239,28498,2.80237e+13,173.199,3705.5,99737,297,175,99382,99382,90395,94988,99239
33449,27,235,23889,9560,2.80344e+13,171.648,2102.26,33449,178,164,22239,16572,5704,4084,6408
37809,87,243,27008,10801,2.80302e+13,171.909,2238.98,37809,186,172,31651,26363,14371,13780,20218
2675,101,178,1914,761,2.76324e+13,144.779,580.92,2675,90,82,2215,1917,1229,1221,1627
74567,251,309,53261,21306,2.80117e+13,172.964,3182.58,74567,252,175,74258,74258,71036,72663,74200
30915,38,230,22085,8830,2.80049e+13,171.515,2018.36,30915,173,159,22379,17540,6424,6166,7944
48901,47,262,34927,13974,2.80037e+13,172.358,2555.7,48901,205,175,36969,29613,11232,12470,16175
27459,107,224,19611,7848,2.80173e+13,171.241,1899.63,27459,167,153,23952,20119,13240,12299,17297
12334,14,196,8809,3525,2.80137e+13,167.665,1261.28,12334,137,126,6498,4434,1877,1215,1074
72184,44,447,51542,20642,2.81152e+13,173.132,3315.36,72184,248,193,54012,42685,14896,8007,19576
14442,197,200,10315,4127,2.80586e+13,168.303,1366.96,14442,143,130,14242,14242,14233,14234,14239
3014,90,179,2157,857,2.76085e+13,147.958,617.417,3014,90,85,2473,2079,1208,1254,1621
89190,19,336,63710,25480,2.80066e+13,173.152,3495.01,89190,279,175,52886,37739,15159,8875,12479
98868,127,494,70597,28271,2.81047e+13,173.274,3872.91,98868,294,192,89939,74357,50128,42054,68467
36858,162,240,26330,10528,2.79817e+13,171.823,2208.52,36858,183,170,35780,28219,32216,31356,34149
17105,50,205,12217,4888,2.79785e+13,169.471,1490.55,17105,148,135,13036,10554,4100,5336,5911
18602,68,208,13280,5322,2.80508e+13,169.593,1555.94,18602,150,137,14910,12338,5501,6124,8077
40399,665,800,28945,11454,2.63063e+13,217.889,3307.94,40399,734,176,39599,39429,38830,39121,39195
21746,50,214,15528,6218,2.80354e+13,170.477,1685.6,21746,157,143,16583,13429,5426,3842,6829
33862,54,235,24184,9678,2.80084e+13,171.675,2114.69,33862,178,165,26221,21477,8352,10822,12459
48033,176,261,34309,13724,2.80056e+13,172.385,2532.96,48033,204,175,47772,47772,42707,45282,47687
52008,113,268,37147,14861,2.80092e+13,172.468,2639.04,52008,211,175,46001,38525,27098,30280,35325
83319,157,324,59514,23805,2.79877e+13,173.052,3371.39,83319,268,175,80326,63388,72807,69674,74997
11242,141,194,8036,3206,2.79292e+13,167.197,1203.49,11242,135,124,10416,8454,8053,8978,9225
55121,745,800,39455,15666,2.67492e+13,213.744,3702.4,55121,777,180,54321,54152,52145,53127,54157
60797,152,284,43423,17374,2.80129e+13,172.7,2861.73,60797,227,175,58029,46022,48740,50052,53130
58488,211,800,41871,16617,2.6803e+13,213.83,3784.51,58488,798,175,57200,56789,51397,53673,55793
18216,172,207,13012,5204,2.79959e+13,169.445,1539.1,18216,150,137,17916,14245,16337,17171,17716
36815,16,241,26289,10526,2.80259e+13,171.688,2207.95,36815,183,170,20434,14387,6074,3550,3573
9668,93,192,6911,2757,2.7976e+13,166.252,1115.7,9668,129,118,8131,6731,3864,3740,5348
67534,68,296,48242,19292,2.79975e+13,172.834,3022.25,67534,240,175,54279,44799,19761,15782,28386
36839,128,241,26311,10528,2.80306e+13,171.752,2208.77,36839,183,170,33543,27678,22896,23060,27617
79961,220,318,57114,22847,2.79886e+13,172.984,3299.76,79961,261,175,79643,79643,73684,76720,79545
68863,147,299,49192,19671,2.80031e+13,172.909,3053.75,68863,242,175,65120,52126,52353,57432,58716
96207,85,348,68718,27489,2.80055e+13,173.183,3635.6,96207,291,175,80305,67131,34686,32232,48707
77217,290,314,55153,22064,2.80095e+13,173.026,3241.29,77217,257,175,76903,76903,76021,76442,76879
85929,166,329,61379,24550,2.79978e+13,173.045,3426.32,85929,272,175,84223,66306,75335,76916,81971
3647,82,180,2613,1034,2.7603e+13,152.278,679.48,3647,98,92,2949,2520,1327,1348,1824
95083,245,492,67893,27190,2.80922e+13,173.281,3802.64,95083,302,181,94591,94470,85468,84830,92131
51578,285,411,36816,14762,2.81716e+13,172.653,2813.81,51578,209,192,51167,51047,44270,42432,48680
94857,263,345,67762,27095,2.79944e+13,173.171,3608.24,94857,289,175,94512,94512,89636,92115,94430
44781,64,255,31983,12798,2.8005e+13,172.287,2442.71,44781,198,175,35648,29530,12309,15253,18738
73396,144,800,52513,20883,2.70429e+13,219.603,4122.54,73396,787,180,68055,54754,52867,52016,59147
46083,84,800,33008,13075,2.64958e+13,209.991,3467.77,46083,795,175,37599,31539,15811,13852,22415
69862,278,308,49905,19957,2.79977e+13,172.778,3083.37,69862,243,175,69554,69554,68763,69137,69524
31520,70,231,22515,9005,2.80034e+13,171.495,2038.39,31520,174,160,25417,20954,9454,7958,13568
90049,540,800,64421,25628,2.72203e+13,228.613,4461.41,90049,798,175,89044,88690,80733,84779,88469
40719,213,392,29062,11657,2.82017e+13,172.411,2510.79,40719,199,190,40327,40204,31794,24973,36544
64850,209,432,46299,18551,2.81444e+13,172.982,3142.05,64850,233,192,64418,64294,51660,42510,58880
98444,138,352,70320,28124,2.80056e+13,173.212,3679.68,98444,295,175,91578,74191,68862,71165,79435
4348,179,181,3107,1241,2.78168e+13,155.502,742.998,4348,105,96,4167,4167,4161,4162,4165
2795,137,179,1999,796,2.79078e+13,145.745,594.809,2795,90,84,2468,2069,1871,1883,2133
95067,315,800,67998,27069,2.72616e+13,224.198,4556.97,95067,798,180,93879,93302,87884,90386,92716
31596,13,231,22574,9022,2.79939e+13,171.567,2040.92,31596,175,161,16159,10910,4746,2978,3763
9520,69,800,6894,2626,2.0617e+13,245.803,2055.11,9520,728,108,6912,5878,2450,3111,3098
4265,125,182,3042,1223,2.81929e+13,154.633,736.273,4265,103,97,3773,3171,2585,2662,3095
87739,238,333,62669,25070,2.80157e+13,173.107,3464.67,87739,276,175,87406,87406,81668,84590,87311
19681,133,210,14054,5627,2.80368e+13,169.982,1601.58,19681,153,139,18043,14800,12728,13438,15288
93695,232,949,66988,26707,2.73497e+13,222.727,4722.68,93695,813,192,92241,91663,76348,66999,85014
71329,119,303,50949,20380,2.80003e+13,172.883,3109.58,71329,246,175,63868,52978,39474,36687,50485
58652,194,280,41894,16758,2.80027e+13,172.686,2808.91,58652,223,175,58372,58372,53238,55848,58286
88136,204,333,62961,25175,2.79981e+13,173.129,3472.3,88136,277,175,87803,87803,79724,83851,87674
26039,125,221,18603,7436,2.79824e+13,171.023,1848.06,26039,164,150,23558,19548,15868,14006,19178
69417,168,300,49579,19838,2.8021e+13,172.808,3066.29,69417,242,175,68249,53558,60931,65121,66394
57511,75,278,41080,16431,2.80075e+13,172.642,2780.39,57511,221,175,46946,38764,19023,19271,26967
85332,97,329,60957,24375,2.7999e+13,173.133,3415.29,85332,272,175,73054,61838,35954,29350,49329
26437,178,221,18885,7552,2.79552e+13,171.012,1861.62,26437,165,152,26216,26216,23985,25102,26173
30858,674,800,22131,8727,2.57753e+13,210.576,3009.97,30858,757,155,30058,29880,28692,29280,29681
10956,46,194,7822,3134,2.80416e+13,166.459,1188.12,10956,133,123,8227,6616,2508,3113,3366
85894,89,329,61355,24539,2.80011e+13,173.11,3425.93,85894,272,175,72305,59923,33399,31728,46928
49317,19,263,35224,14093,2.80073e+13,172.386,2567.35,49317,206,175,29240,20861,8386,5794,7634
32661,123,233,23330,9331,2.80123e+13,171.571,2075.79,32661,176,163,29441,24413,19589,16126,23593
52176,114,269,37275,14901,2.79999e+13,172.577,2644.39,52176,212,175,46234,38637,27346,26134,35293
29455,12,227,21045,8410,2.79828e+13,171.473,1968.7,29455,171,157,14533,9209,4359,2512,2975
96599,289,349,69001,27598,2.80114e+13,173.172,3643.55,96599,292,175,96250,96250,92886,94585,96190
55106,35,274,39359,15747,2.80213e+13,172.577,2719.73,55106,217,175,39029,31079,10579,7908,13066
57031,100,277,40744,16287,2.79939e+13,172.659,2768.35,57031,220,175,49122,41424,25462,20873,33990
56409,241,276,40293,16116,2.80055e+13,172.594,2752.58,56409,219,175,56133,56133,54490,55303,56098
10537,130,193,7526,3011,2.79807e+13,166.69,1164.89,10537,131,121,9552,7904,6611,6280,7875
27322,146,223,19513,7809,2.80238e+13,171.038,1893.6,27322,166,153,25710,20664,20597,22698,22998
48323,425,800,34604,13719,2.65671e+13,222.712,3527.88,48323,798,175,47240,46642,41114,44108,46398
9288,129,191,6636,2652,2.79685e+13,165.632,1092.25,9288,127,117,8379,6961,5805,5234,6948
99781,362,505,71243,28538,2.80959e+13,173.331,3900.75,99781,296,195,99276,99276,92168,89985,97500
23122,41,216,16513,6609,2.80173e+13,170.526,1738.78,23122,159,145,17026,13418,4859,3626,6123
82843,114,800,59257,23586,2.71696e+13,219.301,4318.93,82843,798,180,72599,60748,42278,46956,54480
77318,200,314,55227,22091,2.79947e+13,172.999,3243.18,77318,257,175,77004,77004,70004,73575,76890
87956,731,800,62911,25045,2.72006e+13,253.698,4420.21,87956,714,176,87156,87009,86771,86864,86950
68398,48,297,48855,19543,2.79938e+13,172.843,3041.76,68398,240,175,51906,41792,15841,20920,23348
17208,11,205,12287,4921,2.79831e+13,169.452,1495.14,17208,148,135,8177,5039,2530,1468,1901
5351,45,184,3820,1531,2.80758e+13,158.887,825.689,5351,110,103,3983,3192,1200,921,1544
14920,106,201,10655,4265,2.79993e+13,168.724,1390.25,14920,144,131,12938,10916,7139,6984,9451
77575,151,315,55406,22169,2.80145e+13,173.015,3249.34,77575,258,175,73924,58729,61236,65692,67371
64507,258,290,46078,18429,2.80017e+13,172.756,2950.55,64507,233,175,64217,64217,62750,63474,64185
39001,8,245,27862,11139,2.80183e+13,172.027,2275.05,39001,188,174,16220,7401,4513,3034,3175
1456,81,177,1039,417,2.84315e+13,121.042,428.878,1456,72,69,1129,984,517,437,638
47931,233,261,34233,13698,2.8027e+13,172.415,2530.38,47931,204,175,47670,47670,46501,47071,47642
49285,37,263,35205,14080,2.80083e+13,172.372,2566.46,49285,206,175,35441,27887,9818,12321,13470
46837,258,259,33460,13377,2.80021e+13,172.351,2500.22,46837,202,175,46578,46578,46578,46578,46577
56139,205,276,40094,16045,2.80323e+13,172.635,2746.29,56139,219,175,55863,55863,51770,53845,55792
55117,42,274,39371,15746,2.80259e+13,172.613,2720.13,55117,217,175,40821,32280,11877,11900,16032
53083,206,270,37916,15167,2.80096e+13,172.518,2667.27,53083,213,175,52813,52813,49169,51014,52749
35380,165,238,25273,10107,2.80006e+13,171.69,2163.19,35380,181,168,34522,27145,31015,33120,33155
35328,26,238,25232,10096,2.80099e+13,171.722,2161.65,35328,181,167,23297,17113,6017,4036,6224
31180,190,230,22278,8902,2.79791e+13,171.537,2026.88,31180,174,160,30950,30950,28923,29935,30910
37322,146,242,26659,10663,2.80187e+13,171.934,2224.15,37322,185,171,35166,28231,28158,31021,31534
39789,19,246,28426,11363,2.80012e+13,172.057,2298.27,39789,189,175,23584,16827,6759,6328,4917
31124,34,230,22233,8891,2.79797e+13,171.492,2025.02,31124,173,160,21866,17493,5888,5577,7341
78545,5,316,56106,22439,2.80038e+13,172.989,3269.71,78545,260,175,24427,8662,5255,4542,2085
75101,50,310,53639,21462,2.80113e+13,172.878,3194.29,75101,252,175,57411,46447,17964,21886,25191
56920,218,276,40659,16261,2.79965e+13,172.587,2764.61,56920,220,175,56644,56644,53393,55035,56586
1019,160,176,726,293,2.84647e+13,98.0137,357.45,1019,60,61,843,734,794,815,809
72960,110,306,52114,20846,2.80054e+13,172.907,3146.49,72960,249,175,64159,53794,36814,35147,47326
61087,350,800,43722,17365,2.68635e+13,220.571,3846.33,61087,769,180,59983,59383,57379,58213,58937
57994,218,279,41419,16575,2.80146e+13,172.613,2792.41,57994,222,175,57715,57715,54277,56015,57654
68718,260,298,49084,19634,2.79966e+13,172.856,3049.6,68718,241,175,68420,68420,66541,67477,68382
60451,271,284,43172,17279,2.80312e+13,172.659,2853.92,60451,226,175,60167,60167,59946,60042,60154
5904,179,185,4217,1687,2.79978e+13,161.155,869.099,5904,113,105,5719,5719,5667,5685,5713
90146,311,337,64391,25755,2.80048e+13,173.137,3513.76,90146,280,175,89809,89809,88763,89270,89783
16046,84,203,11462,4584,2.8e+13,169.146,1442.74,16046,146,133,13314,11136,5700,5708,8240
33392,230,234,23854,9538,2.79936e+13,171.559,2098.99,33392,177,164,33158,33158,33135,33141,33154
65336,16,292,46667,18669,2.79998e+13,172.795,2970.6,65336,235,175,36258,25512,10748,6141,7932
85454,25,474,61015,24439,2.81056e+13,173.187,3605.85,85454,270,194,55770,40624,14587,6664,13847
27410,166,224,19580,7830,2.80108e+13,171.236,1897.91,27410,167,153,26754,21109,24107,25671,25783
23529,196,285,16801,6728,2.81309e+13,168.989,1837.19,23529,163,145,23244,23244,22546,22852,23116
15989,143,203,11416,4573,2.80206e+13,168.879,1440.13,15989,145,132,14913,12047,11779,13017,13140
10884,128,194,7777,3107,2.80203e+13,166.977,1184.72,10884,133,123,9830,8141,6734,6014,8174
39191,240,245,27990,11201,2.80082e+13,172.041,2280.52,39191,188,175,38946,38946,38910,38921,38941
49176,210,263,35125,14051,2.80103e+13,172.451,2563.97,49176,206,175,48913,48913,46031,47483,48860
62199,331,800,44518,17681,2.6879e+13,214.12,3872.53,62199,798,175,61030,60493,55346,57783,59974
74841,215,309,53456,21385,2.80013e+13,172.926,3188.02,74841,252,175,74532,74532,68857,71745,74438
54484,255,273,38921,15563,2.80156e+13,172.59,2704.06,54484,216,175,54211,54211,53737,53948,54193
4619,169,182,3296,1323,2.77696e+13,156.725,766.085,4619,104,99,4401,3528,4257,4339,4283
32142,107,232,22954,9188,2.79872e+13,171.554,2058.97,32142,175,162,28048,23559,15529,15348,20441
83279,404,468,59462,23817,2.81059e+13,173.199,3557.44,83279,266,193,82811,82811,79340,81096,82747
53930,87,800,38611,15319,2.67108e+13,210.504,3672.52,53930,787,175,44406,37112,19871,17721,26748
42206,318,497,30101,12105,2.82455e+13,172.536,2664.15,42206,215,179,41709,41609,38484,36506,39398
23459,28,216,16753,6706,2.79749e+13,170.577,1751.19,23459,159,146,15718,11780,4005,3363,5310
9258,43,190,6617,2641,2.78159e+13,165.56,1089.88,9258,127,117,6860,5438,2009,2262,2671
28444,116,226,20323,8121,2.80023e+13,171.367,1934.3,28444,169,155,25262,21043,15017,14707,19662
18210,31,207,13009,5201,2.79974e+13,169.731,1539.12,18210,150,136,12486,9475,3266,2339,3633
5452,121,184,3891,1561,2.81237e+13,158.982,833.989,5452,111,103,4802,4028,3106,3328,3901
51506,184,267,36790,14716,2.79952e+13,172.469,2625.78,51506,210,175,51239,51239,46317,48819,51156
22895,213,215,16348,6547,2.80246e+13,170.411,1729.52,22895,158,145,22680,22680,22676,22676,22678
20710,43,212,14790,5920,2.80443e+13,170.02,1643.79,20710,154,141,15396,12205,4542,5689,6155
40254,339,390,28726,11528,2.82022e+13,172.346,2495.93,40254,197,189,39864,39864,37388,38641,39596
28131,141,363,20081,8050,2.82786e+13,171.599,2097.83,28131,180,171,26162,21245,15883,13255,20640
32147,13,232,22963,9184,2.80003e+13,171.588,2059.04,32147,175,161,16436,11095,4828,2787,3504
39925,164,246,28514,11411,2.7987e+13,172.047,2301.96,39925,189,175,38909,30567,34976,33451,37361
4502,61,182,3218,1284,2.79286e+13,156.66,756.588,4502,104,99,3507,2891,1247,1317,1690
52895,207,270,37777,15118,2.8024e+13,172.443,2662.54,52895,212,175,52625,52625,49056,50861,52562
27902,111,225,19923,7979,2.80518e+13,171.085,1915.15,27902,167,154,24541,20554,14291,16165,18482
26152,742,800,18764,7388,2.5358e+13,215.829,2844.73,26152,783,147,25352,25176,22740,23950,25179
60718,231,284,43374,17344,2.7989e+13,172.733,2860,60718,227,175,60434,60434,57582,59018,60381
77005,26,313,55007,21998,2.79988e+13,172.953,3235.78,77005,256,175,50813,37310,13097,11423,14807
59630,189,282,42586,17044,2.80134e+13,172.618,2833.1,59630,224,175,59348,59348,53734,56592,59255
7121,12,186,5087,2034,2.79385e+13,162.474,953.633,7121,119,110,3507,2224,1060,667,846
48585,129,262,34701,13884,2.80149e+13,172.407,2548.12,48585,205,175,44361,36591,30380,27345,36599
45437,15,256,32459,12978,2.80004e+13,172.318,2461.03,45437,200,175,24637,17005,7151,4445,5821
54938,135,274,39239,15699,2.80121e+13,172.617,2715.78,54938,217,175,50744,41379,36741,38903,43502
71881,196,304,51343,20538,2.80066e+13,172.876,3122.15,71881,247,175,71577,71577,64931,68321,71469
10681,13,194,7623,3058,2.81704e+13,166.399,1173.32,10681,132,123,5466,3695,1612,919,1133
90646,322,338,64748,25898,2.80088e+13,173.118,3523.96,90646,281,175,90308,90308,89928,90093,90292
14784,49,201,10565,4219,2.80093e+13,168.681,1383.95,14784,144,131,11223,9092,3510,2971,4584
71670,243,303,51185,20485,2.80065e+13,172.841,3116.6,71670,246,175,71367,71367,67997,69700,71307
45812,37,257,32721,13091,2.79894e+13,172.297,2471.57,45812,200,175,32943,25915,9432,10444,11569
65668,79,293,46902,18766,2.80148e+13,172.744,2978.73,65668,235,175,54102,45106,22258,23198,32390
77069,82,800,55140,21929,2.70896e+13,228.471,4200.21,77069,773,180,63141,53134,26540,35330,38317
38248,38,244,27317,10931,2.80287e+13,171.926,2252.48,38248,186,173,27705,21706,8022,5768,9282
10453,29,193,7464,2989,2.80439e+13,166.567,1160.01,10453,131,122,7049,5324,1800,1298,2036
27008,55,223,19292,7716,2.8021e+13,171.021,1883.02,27008,166,153,20966,17175,6788,5305,9154
19141,118,209,13667,5474,2.80333e+13,169.684,1578.85,19141,151,138,17045,14159,10523,11576,13353
65763,124,293,46973,18790,2.79957e+13,172.817,2980.99,65763,236,175,59466,49191,40052,34411,47924
99643,154,354,71177,28466,2.80035e+13,173.23,3702.93,99643,298,175,95538,75451,84046,87453,88336
1633,55,177,1168,465,2.8022e+13,126.823,453.995,1633,72,72,1215,1027,414,418,539
36282,42,240,25917,10365,2.80146e+13,171.892,2191.94,36282,183,170,26858,21238,7847,7616,10578
49216,237,263,35154,14062,2.80076e+13,172.391,2564.85,49216,206,175,48953,48953,47887,48406,48927
76674,55,313,54762,21912,2.80151e+13,173.007,3229.44,76674,256,175,59609,48787,19148,18343,27056
11336,115,194,8101,3235,2.79335e+13,166.96,1207.98,11336,135,124,9994,8371,5974,5415,7641
53082,184,410,37904,15178,2.814e+13,172.743,2848.28,53082,226,177,52660,52523,44397,44208,50906
19525,167,209,13947,5578,2.79579e+13,169.948,1594.3,19525,152,139,19052,15030,17264,18297,18394
77393,101,460,55254,22139,2.8124e+13,173.178,3434.49,77393,257,192,66790,56383,31330,24833,43798
97471,310,351,69621,27850,2.80165e+13,173.195,3661.29,97471,294,175,97120,97120,95082,96098,97079
64181,226,290,45843,18338,2.80035e+13,172.783,2943.35,64181,233,175,63891,63891,60274,62104,63827
78264,56,315,55900,22364,2.80072e+13,172.952,3263.07,78264,258,175,61048,50095,19706,26181,29654
93943,326,344,67098,26845,2.8009e+13,173.176,3590.75,93943,287,175,93599,93599,93108,93328,93581
99781,403,800,71359,28422,2.73086e+13,227.525,4644.62,99781,798,180,98644,98007,90274,94408,97736
3348,137,180,2392,956,2.79242e+13,149.876,651.159,3348,95,91,2983,2489,2246,2245,2549
44906,91,256,32076,12830,2.8018e+13,172.256,2446.87,44906,199,175,37930,31320,17590,17412,24967
17915,38,206,12794,5121,2.79397e+13,169.562,1525.55,17915,149,136,12962,10165,3741,4126,4642
82769,433,473,59095,23674,2.81192e+13,173.19,3553.6,82769,272,192,82296,82296,80498,81391,82256
73853,155,307,52748,21105,2.80061e+13,172.908,3165.7,73853,250,175,70913,56186,62661,61745,65983
95857,5,486,68449,27408,2.81003e+13,173.298,3811.05,95857,289,193,29798,10592,6439,5194,2381
5294,74,183,3787,1507,2.77922e+13,159.64,821.308,5294,110,103,4238,3514,1731,1777,2397
73365,542,800,52498,20867,2.70466e+13,216.945,4121.89,73365,798,180,72424,72036,68322,70197,71791
99464,250,354,71047,28417,2.79987e+13,173.223,3699.73,99464,297,175,99110,99110,92788,96009,99006
68581,207,298,48989,19592,2.80033e+13,172.855,3046.7,68581,242,175,68283,68283,62795,65589,68192
54046,30,272,38600,15446,2.8016e+13,172.462,2692.28,54046,214,175,36828,27851,9320,6769,10962
21430,188,358,15287,6143,2.83893e+13,171.057,1853.8,21430,171,160,21062,20926,17190,15388,19541
2837,89,179,2025,812,2.83395e+13,145.269,599.445,2837,91,87,2318,1962,1149,1390,1547
78759,199,317,56257,22502,2.80099e+13,173.06,3275.15,78759,260,175,78442,78442,71168,74879,78324
98732,216,800,70610,28122,2.72964e+13,230.532,4625.34,98732,798,180,97384,96960,87891,92030,95922
67817,649,800,48527,19290,2.69776e+13,224.501,4000.52,67817,798,175,66939,66757,60173,63543,66565
24677,105,219,17630,7047,2.79919e+13,170.941,1798.2,24677,162,149,21415,18076,11564,10957,15459
61439,366,429,43865,17574,2.81464e+13,172.931,3062.64,61439,236,176,61010,61010,60725,60491,60771
38616,212,244,27587,11029,2.79694e+13,172.025,2263.15,38616,187,174,38372,38372,36949,37649,38340
9185,122,191,6560,2625,2.80833e+13,165.84,1086.89,9185,127,117,8186,6811,5305,4906,6538
62767,65,288,44837,17930,2.80265e+13,172.763,2910.04,62767,231,175,50106,41409,17952,13091,24778
26629,653,916,19101,7528,2.57073e+13,207.677,3010.03,26629,773,157,25707,25523,23495,24204,24924
34884,132,237,24915,9969,2.80072e+13,171.73,2147.29,34884,180,167,32021,26267,22318,21252,26739
56913,202,277,40652,16261,2.80074e+13,172.64,2765.5,56913,220,175,56636,56636,52260,54480,56561
67374,250,296,48121,19253,2.8016e+13,172.776,3018.78,67374,238,175,67078,67078,64652,65871,67032
97751,290,351,69822,27929,2.80068e+13,173.217,3666.34,97751,294,175,97400,97400,93974,95705,97339
81885,189,322,58491,23394,2.8005e+13,173.02,3341.45,81885,265,175,81563,81563,73241,77493,81430
67848,201,800,48553,19295,2.69653e+13,234.253,4001.21,67848,798,175,66508,66132,57898,61616,65053
36546,55,240,26106,10440,2.79933e+13,171.933,2199.81,36546,183,169,28379,23241,9119,6767,12345
97289,389,800,69583,27706,2.73004e+13,257.986,4598.76,97289,738,180,96237,95519,94572,95219,95256
36135,203,240,25814,10321,2.80116e+13,171.898,2187.49,36135,183,169,35895,35895,34131,35007,35858
79515,18,317,56801,22714,2.79915e+13,173.022,3290.03,79515,261,175,46139,32768,13368,9061,9054
86418,8,330,61734,24684,2.79975e+13,173.124,3436.9,86418,274,175,35937,16397,9994,7347,5269
2580,152,179,1844,736,2.83235e+13,143.971,571.994,2580,86,85,2332,1908,1987,2038,2142
14026,188,199,10019,4007,2.79669e+13,168.17,1346.09,14026,142,129,13827,13827,13658,13732,13816
82950,171,800,59345,23605,2.716e+13,226.507,4321.38,82950,786,180,80966,63548,70957,75605,78224
30331,124,229,21660,8671,2.80288e+13,171.463,1998.67,30331,172,159,27386,22662,18448,15023,21965
38761,43,244,27689,11072,2.80319e+13,171.951,2267.28,38761,187,174,28840,22835,8440,10588,11650
90858,222,800,64992,25866,2.72368e+13,249.086,4476.99,90858,749,180,89536,89100,81390,84841,88106
87761,111,333,62688,25073,2.80054e+13,173.117,3465.08,87761,276,175,77346,64711,44925,40983,57770
33301,127,234,23792,9509,2.79855e+13,171.64,2096.45,33301,177,164,30257,25012,20584,17874,24483
62627,212,287,44726,17901,2.80218e+13,172.721,2905.9,62627,230,175,62340,62340,57974,60189,62265
75767,25,311,54118,21649,2.80066e+13,172.975,3208.93,75767,254,175,49439,36023,12879,12330,10644
78397,79,315,55996,22401,2.80064e+13,172.939,3265.74,78397,258,175,64582,53861,26576,36594,39105
4463,93,182,3188,1275,2.80145e+13,156.441,753.139,4463,104,98,3714,3089,1813,1762,2446
83898,154,800,60022,23876,2.71669e+13,219.983,4339.94,83898,798,180,79427,62843,68818,69958,72310
20920,65,212,14942,5978,2.8005e+13,170.227,1652.15,20920,155,141,16662,13787,5799,5538,8596
66084,12,294,47204,18880,2.80003e+13,172.871,2989.1,66084,237,175,32611,20661,9797,6806,7622
11956,22,196,8543,3413,2.80868e+13,167.692,1242.6,11956,137,125,7462,5315,2047,1761,2104
97040,105,350,69317,27723,2.80161e+13,173.21,3652.66,97040,293,175,84503,71203,45452,43009,61298
51724,176,267,36941,14783,2.80052e+13,172.415,2631.12,51724,210,175,51457,51457,45983,48768,51366
54071,101,271,38619,15452,2.80004e+13,172.476,2692.06,54071,214,175,46655,39380,24290,28468,33167
46307,79,258,33080,13227,2.80065e+13,172.317,2485.58,46307,201,175,38113,31793,15688,15955,22680
51981,55,268,37130,14851,2.80075e+13,172.518,2638.45,51981,211,175,40398,33060,13005,11862,18306
54598,148,273,38999,15599,2.80138e+13,172.617,2706.86,54598,216,175,51706,41320,41699,45618,46720
6168,103,185,4404,1764,2.79863e+13,161.144,887.458,6168,113,105,5273,4493,2806,2644,3779
51327,29,267,36659,14668,2.80133e+13,172.497,2621.61,51327,210,175,34692,26170,8753,8184,10335
46734,21,258,33387,13347,2.79886e+13,172.371,2496.76,46734,202,175,28801,20524,7953,4819,7251
74032,59,308,52881,21151,2.80107e+13,172.903,3170.44,74032,251,175,58239,47510,19559,15691,27425
40839,93,248,29165,11674,2.80191e+13,172.124,2329.42,40839,191,175,34644,28548,16265,15718,23075
58927,81,280,42090,16837,2.7982e+13,172.645,2815.09,58927,223,175,48734,41007,20628,19229,28538
81053,321,800,57978,23075,2.71425e+13,218.462,4282.55,81053,798,180,79867,79313,73658,76316,78748
4239,65,182,3024,1215,2.81003e+13,154.22,733.884,4239,103,97,3336,2794,1239,1471,1799
43244,53,252,30888,12356,2.80009e+13,172.168,2398.77,43244,195,175,33382,27430,10597,12446,15190
81077,302,800,58000,23077,2.71431e+13,240.423,4283,81077,798,175,79819,79337,69985,74541,78643
65143,9,292,46534,18609,2.79942e+13,172.822,2966.38,65143,235,175,28503,13772,8132,5178,2761
86848,883,946,62105,24743,2.72962e+13,221.975,4588.46,86848,809,180,85902,85901,85803,85724,85771
16496,99,204,11777,4719,2.80301e+13,169.02,1463.17,16496,146,133,14117,11938,7210,8614,9916
78517,140,316,56083,22434,2.80102e+13,172.978,3269.15,78517,259,175,73293,59169,56311,57037,63711
36705,230,240,26213,10492,2.79795e+13,171.836,2204.05,36705,183,170,36465,36465,36324,36384,36455
36807,64,241,26297,10510,2.80282e+13,171.946,2208.33,36807,184,170,29287,24267,10111,9620,14979
62181,102,286,44413,17768,2.79917e+13,172.688,2894.74,62181,229,175,53789,45400,28030,27846,37691
74191,18,308,52993,21198,2.8e+13,172.944,3173.81,74191,251,175,43048,30582,12482,9791,7271
62980,139,288,44984,17996,2.80077e+13,172.737,2914.75,62980,231,175,58660,47453,44932,45639,50732
84706,270,327,60506,24200,2.80181e+13,173.065,3401.12,84706,270,175,84379,84379,81238,82823,84322
2633,144,179,1882,751,2.81279e+13,143.87,576.886,2633,90,83,2359,1950,1902,2078,2091
68853,189,299,49185,19668,2.80031e+13,172.914,3053.56,68853,242,175,68554,68554,61827,65257,68444
15464,195,202,11047,4417,2.80068e+13,168.803,1415.73,15464,145,131,15262,15262,15191,15218,15255
14909,109,201,10650,4259,2.80011e+13,168.603,1389.78,14909,144,131,13007,10941,7370,8443,9703
29843,165,228,21314,8529,2.80107e+13,171.333,1982,29843,171,158,29095,22887,26198,26688,28215
1372,57,177,983,389,2.76039e+13,119.641,416.59,1372,63,68,1008,851,365,401,507
90021,398,800,64385,25636,2.72351e+13,225.115,4460.84,90021,798,175,88885,88264,80960,84871,87979
98403,336,496,70263,28140,2.80958e+13,173.365,3866.41,98403,309,178,97907,97907,96655,94542,96081
52054,88,268,37184,14870,2.80007e+13,172.486,2640.21,52054,211,175,43703,36309,19967,16146,27678
66149,739,800,47343,18806,2.69427e+13,214.698,3962.99,66149,791,180,65349,65165,62166,63676,65167
42194,31,250,30137,12057,2.79902e+13,172.161,2368.55,42194,193,175,28970,21964,7576,6861,9307
15278,39,201,10915,4363,2.78961e+13,168.769,1406.31,15278,145,131,11133,8720,3064,3563,4005
46782,242,259,33411,13371,2.80262e+13,172.311,2498.79,46782,202,175,46523,46523,46089,46281,46506
50887,113,800,36438,14449,2.66452e+13,225.336,3595.3,50887,724,178,44145,37049,25472,24512,32409
9957,102,192,7112,2845,2.79985e+13,165.985,1131.6,9957,129,120,8541,7239,4503,4233,6021
82784,639,800,59217,23567,2.71668e+13,218.928,4317.75,82784,798,180,81917,81741,76577,79217,81502
18548,65,208,13243,5305,2.80718e+13,169.586,1553.71,18548,150,137,14769,12231,5183,6015,7730
21403,179,213,15289,6114,2.80505e+13,170.387,1671.85,21403,156,143,21190,21190,19615,20393,21156
93079,166,800,66572,26507,2.72555e+13,223.195,4519.46,93079,798,180,90190,71096,79543,84972,85529
43097,140,252,30786,12311,2.80114e+13,172.18,2394.72,43097,195,175,40185,32457,30881,32816,35287
60817,218,947,43507,17310,2.69873e+13,230.087,4028.61,60817,804,194,59360,58845,39948,24796,49815
59942,280,282,42821,17121,2.79897e+13,172.692,2840.42,59942,225,175,59660,59660,59656,59656,59658
27232,526,800,19538,7694,2.55312e+13,202.809,2864.88,27232,753,149,26432,26184,22892,17218,1770
50584,122,265,36133,14451,2.80072e+13,172.403,2600.91,50584,208,175,45555,37742,29356,31109,36201
68125,162,297,48658,19467,2.79965e+13,172.848,3035.91,68125,240,175,66253,52190,59578,57022,62981
62082,256,286,44341,17741,2.80046e+13,172.712,2892.56,62082,229,175,61796,61796,60466,61119,61766
32232,101,233,23018,9214,2.80532e+13,171.475,2062.51,32232,175,162,27781,23460,14488,16972,19815
70402,92,800,50373,20029,2.7019e+13,215.226,4057.68,70402,798,180,58866,48599,27020,26554,37927
75191,189,310,53712,21479,2.80058e+13,172.963,3196.27,75191,253,175,74881,74881,67369,71203,74760
62634,160,287,44737,17897,2.80006e+13,172.757,2906.1,62634,230,175,60682,47863,54734,58648,57385
22257,180,214,15901,6356,2.79737e+13,170.388,1704.78,22257,157,144,22043,22043,20442,21234,22009
49135,118,405,35078,14057,2.81682e+13,171.104,2747.07,49135,205,187,43821,36408,12579,13713,17136
48919,217,262,34941,13978,2.80107e+13,172.331,2556.24,48919,205,175,48657,48657,46312,47487,48612
1077,46,176,772,305,2.77158e+13,101.205,368.386,1077,58,63,770,633,251,285,293
64283,194,290,45917,18366,2.80095e+13,172.774,2945.61,64283,233,175,63993,63993,58193,61147,63897
1098,64,176,784,314,2.80819e+13,103.678,371.257,1098,60,62,813,701,342,349,425
16070,55,203,11472,4598,2.80284e+13,169.081,1443.63,16070,146,133,12456,10211,4048,5145,6001
41280,38,249,29484,11796,2.80096e+13,172.177,2342.55,41280,192,175,29896,23418,8094,6639,10410
78825,73,316,56309,22516,2.79918e+13,172.981,3275.25,78825,260,175,64072,52578,25140,21851,36204
54039,121,416,38576,15463,2.81549e+13,172.739,2878.3,54039,214,193,48520,40247,19186,10728,31152
27703,16,224,19790,7913,2.79991e+13,171.118,1907.33,27703,167,154,15368,10816,4557,2821,3827
98041,283,351,70030,28011,2.79986e+13,173.19,3671.37,98041,294,175,97690,97690,93784,95761,97622
89426,154,336,63875,25551,2.8013e+13,173.149,3499.44,89426,279,175,85730,67710,75424,78480,79702
73662,77,307,52615,21047,2.80022e+13,172.921,3161.89,73662,250,175,60412,50327,24804,25095,35392
49774,662,800,35648,14126,2.65818e+13,218.038,3566.08,49774,753,180,48974,48798,47736,48281,48561
91580,236,339,65413,26167,2.80076e+13,173.087,3542.17,91580,282,175,91241,91241,84948,88155,91138
40637,26,248,29021,11616,2.80302e+13,172.034,2323.76,40637,191,175,26801,19689,6927,4653,7302
12972,133,197,9261,3711,2.79708e+13,167.955,1293.96,12972,139,127,11859,9741,8393,8044,9990
93660,290,800,66987,26673,2.72653e+13,224.792,4530.36,93660,798,180,92453,91897,86836,89093,91218
28834,119,226,20591,8243,2.7985e+13,171.258,1947.03,28834,169,156,25771,21395,15946,14864,20110
63544,176,289,45386,18158,2.80162e+13,172.711,2928.2,63544,231,175,63255,63255,56273,59837,63142
55285,36,417,39465,15820,2.81775e+13,172.723,2909.12,55285,231,183,39491,31267,11194,7004,12482
87010,223,800,62241,24769,2.71953e+13,253.795,4401.72,87010,795,175,85652,85260,74321,79495,84229
53086,249,270,37918,15168,2.8008e+13,172.533,2667.33,53086,213,175,52816,52816,52121,52446,52795
95996,67,347,68567,27429,2.79922e+13,173.155,3630.76,95996,290,175,77016,63519,27803,33195,41944
81843,278,800,58545,23298,2.71644e+13,221.901,4298.93,81843,798,175,80596,80101,73104,76365,79345
28146,352,370,20075,8071,2.83187e+13,169.797,2105.38,28146,166,173,27776,27776,27402,27574,27758
62520,294,435,44635,17885,2.81146e+13,172.957,3094.32,62520,229,192,62085,61965,54290,52161,59113
22879,146,216,16338,6541,2.8081e+13,170.516,1730.03,22879,159,145,21503,17290,17240,18984,19250
6768,3,186,4833,1935,2.78561e+13,162.119,929.699,6768,116,108,1416,318,296,366,120
13023,142,198,9299,3724,2.80669e+13,167.913,1297.47,13023,141,127,12099,9803,9475,10467,10629
88378,787,800,63218,25160,2.72252e+13,225.837,4428.95,88378,797,180,87578,87401,86120,86702,87540
33914,340,385,24198,9716,2.82476e+13,172.031,2305.31,33914,192,182,33529,33529,31452,32501,33295
59609,128,282,42578,17031,2.79854e+13,172.711,2832.77,59609,225,175,54316,44797,37080,32057,44344
81538,32,800,58330,23208,2.71485e+13,242.516,4292.6,81538,798,175,56002,42681,14716,10298,16888
20974,31,212,14980,5994,2.80201e+13,170.265,1654.1,20974,155,141,14389,10913,3764,3853,4690
12395,455,800,8942,3453,2.23893e+13,234.523,2231.55,12395,752,119,11401,10779,9375,10245,10559
78343,478,943,56033,22310,2.72241e+13,229.292,4412.16,78343,813,192,77137,76863,68860,66079,72142
14292,105,200,10211,4081,2.80769e+13,168.426,1359.99,14292,143,130,12367,10456,6710,6380,8953
55885,168,275,39920,15965,2.8001e+13,172.605,2739.35,55885,218,175,54917,43101,49107,52434,53545
44112,100,254,31501,12611,2.8034e+13,172.104,2423.74,44112,196,175,37983,32042,19742,23155,26872
41890,64,250,29920,11970,2.80152e+13,172.113,2360.09,41890,193,175,33348,27631,11506,9433,16596
39127,72,245,27948,11179,2.80287e+13,171.995,2278.55,39127,188,175,31708,26082,12192,12912,17772
73543,256,307,52531,21012,2.80074e+13,172.93,3159.48,73543,250,175,73236,73236,70490,71872,73185
11440,182,195,8174,3266,2.80123e+13,167.338,1215.06,11440,135,124,11245,11245,11018,11118,11232
79829,212,318,57018,22811,2.79961e+13,172.993,3297.05,79829,261,175,79511,79511,73018,76328,79405
22052,45,214,15748,6304,2.80168e+13,170.282,1697.12,22052,156,143,16537,13155,4928,3855,6394
50194,51,264,35856,14338,2.79779e+13,172.446,2590.44,50194,208,175,38483,31111,12359,15709,17578
22738,16,215,16240,6498,2.7995e+13,170.479,1723.64,22738,158,145,12615,8879,3741,2138,2781
22423,250,355,16003,6420,2.83503e+13,170.85,1887.79,22423,158,161,22068,21952,14614,10865,19673
21565,125,213,15404,6161,2.79965e+13,170.316,1677.88,21565,156,143,19462,16182,13142,11364,15945
81271,158,321,58049,23222,2.80035e+13,173.056,3328.49,81271,264,175,78475,62116,71009,67967,74025
36352,219,239,25968,10384,2.79645e+13,171.839,2192.88,36352,183,170,36113,36113,35452,35762,36093
49657,136,263,35474,14183,2.79771e+13,172.413,2575.93,49657,207,175,45945,37405,33646,30990,39327
77266,234,314,55190,22076,2.80136e+13,173.002,3242.3,77266,257,175,76952,76952,72245,74635,76872
46406,35,258,33145,13261,2.80135e+13,172.241,2487.88,46406,201,175,32868,26180,8915,6652,10999
74839,40,454,53431,21408,2.81224e+13,173.132,3376.88,74839,262,175,54926,43027,15571,15144,19981
93592,130,344,66848,26744,2.80147e+13,173.177,3584.19,93592,287,175,85688,70528,58885,59571,71621
26300,79,222,18788,7512,2.80473e+13,171.06,1857.94,26300,165,151,21613,18041,8905,7757,12807
5197,139,183,3716,1481,2.79866e+13,158.57,813.058,5197,107,102,4733,3881,3673,3736,4050
59868,647,800,42855,17013,2.68343e+13,212.955,3817.32,59868,784,180,59045,58863,56144,57535,58610
74111,120,308,52936,21175,2.80036e+13,172.938,3172.14,74111,251,175,66528,55043,41404,36093,51911
89029,60,335,63591,25438,2.80066e+13,173.145,3490.94,89029,278,175,70229,57287,23856,30607,35285
49193,16,263,35140,14053,2.79977e+13,172.431,2564.2,49193,206,175,27296,19202,8087,6575,5072
93296,70,342,66644,26652,2.7998e+13,173.155,3576.81,93296,285,175,75349,62065,27900,33940,41990
43452,279,366,31026,12426,2.81843e+13,170.52,2550.28,43452,195,188,43086,43086,38208,40697,40851
55216,148,273,39447,15769,2.79858e+13,172.584,2721.43,55216,217,175,52285,41793,42176,43863,46960
39953,620,800,28631,11322,2.62123e+13,220.484,3294.49,39953,707,176,39138,38738,38526,38766,38613
3762,19,181,2683,1079,2.81451e+13,153.625,692.385,3762,98,95,2220,1588,651,452,567
48585,342,401,34688,13897,2.81567e+13,172.57,2726.85,48585,217,177,48184,48184,47275,47019,47806
39572,286,800,28345,11227,2.63616e+13,212.331,3259.14,39572,752,171,38562,38139,33036,24491,1125
40932,207,248,29239,11693,2.8007e+13,172.114,2331.94,40932,191,175,40684,40684,38646,39662,40643
36528,158,240,26094,10434,2.80032e+13,171.855,2199.02,36528,183,169,35200,27894,31860,34140,33085
99260,585,950,70970,28290,2.73682e+13,246.508,4829.3,99260,814,195,98114,97736,87414,80606,90493
99994,876,946,71491,28503,2.7394e+13,227.745,4839.02,99994,814,193,99048,98972,93903,89968,95532
82733,308,324,59092,23641,2.80158e+13,173.059,3360.05,82733,267,175,82409,82409,82039,82200,82393
29494,201,227,21070,8424,2.79793e+13,171.354,1969.74,29494,170,157,29267,29267,28203,28720,29241
66899,161,295,47786,19113,2.80044e+13,172.773,3007.49,66899,238,175,64929,51129,58468,62648,61502
64872,157,292,46340,18532,2.80026e+13,172.879,2960.77,64872,235,175,62492,49328,56666,58759,58739
30693,139,230,21925,8768,2.80055e+13,171.504,2011.24,30693,173,159,28519,23099,21867,20949,25055
90146,588,800,64475,25671,2.72411e+13,224.716,4463.16,90146,798,175,89201,88801,81858,85395,88710
47004,51,259,33574,13430,2.80076e+13,172.335,2504.59,47004,202,175,36035,29132,11568,8857,15050
22153,680,800,15918,6235,2.48827e+13,217.809,2691.2,22153,776,139,21353,21161,19022,20098,20994
71878,202,304,51340,20538,2.80038e+13,172.913,3122.09,71878,247,175,71574,71574,65388,68539,71472
26377,77,222,18846,7531,2.7992e+13,171.051,1860.41,26377,165,152,21578,18007,8899,9000,12662
63287,39,288,45210,18077,2.7992e+13,172.793,2921.68,63287,232,175,46199,36146,12954,10283,16454
44871,185,255,32055,12816,2.79991e+13,172.26,2445.07,44871,199,175,44616,44616,40549,42611,44546
89352,479,800,63910,25442,2.72247e+13,252.64,4447.67,89352,729,179,88392,87994,87125,87543,87589
61397,264,428,43837,17560,2.81518e+13,172.189,3062.31,61397,235,175,60969,60903,60207,60407,60550
27995,28,224,19997,7998,2.80089e+13,171.025,1917.08,27995,167,154,18765,14068,4784,5127,4783
93587,87,343,66840,26747,2.80163e+13,173.14,3583.16,93587,286,175,78466,65305,35586,45205,50336
14818,150,201,10580,4238,2.80305e+13,168.622,1385.34,14818,144,130,13992,11187,11457,12444,12775
14262,176,199,10189,4073,2.78891e+13,168.66,1358.02,14262,143,130,14063,14063,13191,13608,14040
7432,115,188,5306,2126,2.80006e+13,163.853,976.197,7432,121,110,6519,5467,3904,3834,4969
63667,227,290,45474,18193,2.80129e+13,172.758,2931.95,63667,232,175,63377,63377,59849,61631,63314
11027,55,194,7877,3150,2.80142e+13,167.052,1191.98,11027,133,123,8525,7005,2757,2660,3821
31564,128,231,22548,9016,2.80001e+13,171.547,2039.89,31564,174,160,28742,23704,19612,17381,23836
37187,80,800,26652,10535,2.61402e+13,208.396,3212.27,37187,780,166,29928,25289,12194,10716,17076
18020,116,207,12867,5153,2.80505e+13,169.62,1531.1,18020,150,136,15974,13322,9526,10826,12517
53510,246,271,38217,15293,2.80229e+13,172.408,2678.36,53510,213,175,53239,53239,52249,52727,53214
95052,333,491,67867,27185,2.81058e+13,173.297,3802.51,95052,288,193,94561,94561,88764,84365,90557
31797,185,232,22705,9092,2.80429e+13,171.555,2048.2,31797,175,161,31565,31565,29102,30337,31518
71000,517,800,50802,20198,2.70234e+13,215.179,4070.76,71000,798,180,70027,69675,65411,67556,69351
80103,66,319,57220,22883,2.80111e+13,173.042,3303.6,80103,262,175,64108,52990,22988,21202,33814
80242,195,319,57309,22933,2.80152e+13,173.002,3306.28,80242,262,175,79923,79923,72241,76162,79799
42878,187,251,30632,12246,2.79804e+13,172.105,2387.77,42878,195,175,42627,42627,38977,40826,42563
75861,109,311,54182,21679,2.80072e+13,172.958,3210.96,75861,254,175,66582,55795,37333,36428,49529
95178,235,346,67981,27197,2.80021e+13,173.163,3615.04,95178,289,175,94832,94832,88014,91492,94721
38469,77,244,27474,10995,2.80288e+13,171.931,2258.91,38469,187,173,31529,26273,12954,10068,18118
83455,241,325,59616,23839,2.80129e+13,173.043,3374.96,83455,268,175,83130,83130,78155,80683,83046
61725,204,800,44179,17546,2.68732e+13,212.637,3861.27,61725,792,176,60420,60020,54634,56855,58989
32590,90,233,23282,9308,2.80129e+13,171.57,2073.66,32590,176,163,27449,22726,12732,13072,17679
54012,159,272,38580,15432,2.8018e+13,172.563,2691.69,54012,215,175,52204,41268,47158,50544,49178
47961,48,261,34257,13704,2.80241e+13,172.337,2530.93,47961,204,175,36385,29309,11125,8280,14600
4084,129,182,2918,1166,2.79938e+13,155.732,721.619,4084,103,95,3626,3030,2528,2263,3010
58654,139,280,41901,16753,2.8021e+13,172.653,2808.9,58654,223,175,54600,44185,41859,42498,47290
21198,32,213,15133,6065,2.80894e+13,170.177,1663.79,21198,155,142,14665,11118,3898,3109,4655
20235,144,211,14456,5779,2.80484e+13,170.268,1624.75,20235,154,140,18939,15245,14983,16597,16825
70868,300,302,50613,20255,2.80036e+13,172.891,3099.05,70868,245,175,70566,70566,70562,70562,70564
14249,45,199,10182,4067,2.79542e+13,168.41,1357.07,14249,143,129,10669,8487,3184,3947,4440
42243,48,250,30175,12068,2.79744e+13,172.081,2369.61,42243,193,175,32046,25811,9799,10854,13230
50431,98,265,36018,14413,2.80029e+13,172.413,2597.27,50431,208,175,43246,36535,21904,21497,30285
65988,223,293,47137,18851,2.80006e+13,172.83,2985.93,65988,237,175,65695,65695,61628,63690,65625
19331,179,209,13806,5525,2.80126e+13,169.874,1586.54,19331,152,138,19122,19122,17791,18445,19092
82217,244,323,58720,23497,2.80152e+13,173.002,3348.97,82217,265,175,81894,81894,77236,79601,81815
47957,153,260,34259,13698,2.79736e+13,172.39,2530.07,47957,204,175,45830,36293,39357,38523,42246
75890,94,311,54207,21683,2.8002e+13,172.95,3211.35,75890,254,175,64569,53082,30647,29445,43112
70361,53,301,50254,20107,2.79993e+13,172.87,3087.27,70361,244,175,54348,44640,17199,22303,25797
76130,107,312,54372,21758,2.80192e+13,172.925,3217.19,76130,254,175,66560,55862,36810,42007,48876
6972,57,187,4975,1997,2.81721e+13,162.03,944.159,6972,118,109,5411,4462,1812,2165,2590
91185,109,339,65136,26049,2.80084e+13,173.144,3535.03,91185,282,175,80045,67072,44851,43739,58854
69643,604,800,49835,19808,2.70062e+13,236.133,4041.38,69643,738,180,68806,68406,67793,68089,68255
19173,169,209,13701,5472,2.79495e+13,169.915,1580.27,19173,152,139,18766,14782,17050,18013,18462
49906,305,409,35618,14288,2.81873e+13,172.595,2769.83,49906,205,193,49497,49389,44444,43492,48710
32529,225,233,23230,9299,2.80221e+13,171.473,2071.71,32529,175,162,32296,32296,32204,32241,32288
72207,219,305,51573,20634,2.80205e+13,172.883,3129.78,72207,247,175,71902,71902,66776,69382,71816
5049,3,183,3601,1448,2.79423e+13,158.685,802.333,5049,107,102,1054,237,219,270,87
98115,226,800,70170,27945,2.72973e+13,224.699,4613.95,98115,798,180,96788,96344,88010,91793,95357
64556,179,290,46117,18439,2.79804e+13,172.813,2951.67,64556,234,175,64266,64266,57410,60907,64155
95685,275,800,68430,27255,2.72872e+13,246.278,4568.67,95685,767,180,94460,93918,89334,91271,93180
98653,747,800,70558,28095,2.72868e+13,239.336,4623.93,98653,782,180,97853,97681,95342,96503,97695
20521,185,211,14659,5862,2.79731e+13,170.168,1635.77,20521,154,140,20310,20310,19253,19765,20284
79822,22,318,57015,22807,2.79932e+13,173.009,3297,79822,261,175,49925,35498,13568,11683,13874
90268,119,337,64479,25789,2.79982e+13,173.107,3515.94,90268,280,175,80880,67055,49949,46403,62988
54673,176,273,39049,15624,2.8014e+13,172.575,2708.63,54673,216,175,54400,54400,48533,51522,54303
56544,431,800,40478,16066,2.67807e+13,211.346,3737.42,56544,798,175,55488,54848,50846,53061,54637
9440,83,191,6743,2697,2.79807e+13,165.467,1100.96,9440,127,118,7793,6546,3368,3376,4823
13631,183,198,9738,3893,2.79097e+13,168.226,1326.97,13631,141,128,13433,13433,13106,13248,13418
15847,15,203,11317,4530,2.80408e+13,168.963,1433.69,15847,146,132,8589,5936,2503,1562,2028
22017,60,213,15725,6292,2.7991e+13,170.299,1694.92,22017,156,143,17332,14158,5938,9340,8849
71270,197,444,50890,20380,2.8136e+13,173.085,3291.96,71270,253,192,70826,70697,58072,53061,66730
72461,278,305,51758,20703,2.8002e+13,172.944,3135.32,72461,248,175,72156,72156,71028,71578,72129
81336,65,470,58071,23265,2.81056e+13,173.2,3522.72,81336,263,195,64932,53719,20932,13566,29798
60267,220,283,43050,17217,2.8007e+13,172.684,2848.73,60267,226,175,59984,59984,56443,58231,59921
62241,350,431,44438,17803,2.81343e+13,172.949,3084.15,62241,229,193,61810,61810,57167,59526,61729
37618,56,242,26872,10746,2.80041e+13,171.896,2232.58,37618,185,172,29312,24063,9498,10314,13555
18469,141,207,13194,5275,2.7963e+13,169.712,1549.42,18469,150,137,17196,13923,13276,13322,14916
23609,203,217,16865,6744,2.80119e+13,170.78,1758.01,23609,160,146,23392,23392,23123,23240,23378
8300,104,189,5926,2374,2.80071e+13,164.617,1031.82,8300,123,114,7131,6053,3838,3797,5075
5105,162,184,3648,1457,2.8049e+13,158.957,807.403,5105,110,101,4817,3860,4417,4663,4639
99162,100,354,70824,28338,2.80257e+13,173.179,3694.31,99162,296,175,85458,72052,44323,52018,60275
39471,133,245,28195,11276,2.79842e+13,171.96,2288.13,39471,188,175,36315,29729,25531,23281,30391
70181,127,301,50132,20049,2.80069e+13,172.87,3083.47,70181,244,175,63880,52755,43403,43789,52460
55711,178,274,39796,15915,2.79924e+13,172.577,2734.12,55711,217,175,55437,55437,49611,52580,55341
93405,171,343,66715,26690,2.80105e+13,173.181,3579.89,93405,286,175,92394,72404,82122,87726,90807
74141,292,449,52939,21202,2.81251e+13,173.107,3356.53,74141,250,193,73692,73575,63968,61134,71684
22855,206,215,16330,6525,2.79749e+13,170.626,1728.38,22855,159,144,22640,22640,22525,22572,22631
61740,254,286,44105,17635,2.79978e+13,172.764,2885.07,61740,229,175,61454,61454,60032,60731,61422
53880,115,271,38490,15390,2.79846e+13,172.472,2687.35,53880,214,175,47856,39919,28368,25590,36587
87182,421,800,62365,24817,2.7203e+13,230.866,4405.17,87182,798,175,86054,85431,77140,81564,85223
13613,33,199,9729,3884,2.80605e+13,168.364,1327.5,13613,142,128,9474,7256,2533,2394,3130
2505,16,178,1788,717,2.75414e+13,142.003,561.657,2505,85,81,1377,968,418,237,351
67789,210,297,48419,19370,2.8021e+13,172.856,3028.83,67789,240,175,67492,67492,62308,64944,67405
76635,216,800,54828,21807,2.71015e+13,232.051,4191.24,76635,798,175,75306,74903,66430,70308,73879
82527,47,323,58956,23571,2.79936e+13,173.084,3355.2,82527,267,175,62408,49966,18952,17472,25482
66702,37,295,47643,19059,2.80154e+13,172.814,3003.27,66702,238,175,47974,37745,13757,9931,16462
21139,75,212,15102,6037,2.79879e+13,170.335,1660.89,21139,155,141,17213,14230,6990,7106,9859
40860,53,248,29187,11673,2.80012e+13,172.119,2330,40860,191,175,31534,25920,9967,8828,14317
64588,39,291,46135,18453,2.80124e+13,172.816,2953.35,64588,234,175,47148,36888,13215,16384,18284
99063,112,353,70761,28302,2.8004e+13,173.214,3691.61,99063,296,175,87530,73230,51224,47314,66022
5644,13,184,4037,1607,2.7915e+13,159.485,847.512,5644,110,104,2883,1947,844,640,434
11830,69,196,8452,3378,2.80646e+13,167.417,1235.82,11830,137,125,9473,7829,3490,2609,4880
47936,132,260,34238,13698,2.80006e+13,172.295,2529.46,47936,203,175,44023,36112,30694,31216,36787
48338,108,262,34531,13807,2.80065e+13,172.47,2541.84,48338,205,175,42305,35445,23581,20205,30861
26442,172,222,18886,7556,2.80298e+13,171.054,1862.77,26442,165,152,26082,20693,23567,24905,25768
1849,125,177,1323,526,2.74135e+13,130.831,481.626,1849,78,73,1574,1354,1122,1029,1245
46433,6,258,33167,13266,2.80063e+13,172.318,2488.87,46433,201,175,16366,6213,4117,3782,3886
61813,168,286,44153,17660,2.80149e+13,172.717,2886.65,61813,229,175,60757,47680,54316,58002,59177
89591,172,479,63968,25623,2.81122e+13,173.279,3689.69,89591,278,194,88615,70242,58961,49383,79656
41188,729,800,29511,11677,2.63083e+13,210.783,3330.58,41188,766,173,40388,40224,38818,39522,40176
67415,16,296,48152,19263,2.80073e+13,172.851,3019.76,67415,239,175,37411,26325,11101,6338,8609
52777,127,269,37695,15082,2.80093e+13,172.436,2658.73,52777,212,175,47999,39669,32623,32944,39243
20815,169,212,14861,5954,2.80583e+13,170.002,1647.66,20815,154,141,20387,16068,18445,19534,19947
86468,186,800,61850,24618,2.72013e+13,243.333,4391.31,86468,798,175,85080,84718,74592,79233,83552
81232,127,321,58019,23213,2.80065e+13,173.059,3327.9,81232,264,175,73951,61063,50218,43943,61016
17553,107,206,12533,5020,2.80427e+13,169.432,1510.26,17553,149,135,15271,12854,8494,9002,11322
2439,44,178,1746,693,2.79986e+13,141.33,554.334,2439,87,81,1788,1432,555,667,750
31782,170,231,22699,9083,2.80163e+13,171.396,2046.37,31782,174,161,31274,24615,28143,29872,30734
56221,156,276,40162,16059,2.79989e+13,172.634,2748.17,56221,219,175,54045,42751,47882,48491,50384
4545,120,182,3244,1301,2.82841e+13,155.688,759.706,4545,105,100,3979,3347,2548,2778,3155
23049,213,215,16460,6589,2.80084e+13,170.402,1735.13,23049,158,145,22834,22834,22830,22830,22832
10421,52,193,7442,2979,2.80491e+13,166.568,1158.39,10421,131,121,7980,6480,2542,3011,3606
66441,16,294,47456,18985,2.80046e+13,172.825,2996.68,66441,237,175,36872,25945,10937,6242,8501
14065,91,200,10044,4021,2.81197e+13,168.422,1349.51,14065,143,129,11829,9788,5518,5482,7719
34001,63,236,24280,9721,2.80348e+13,171.635,2119.83,34001,179,165,26999,22302,9331,9813,13583
13831,63,199,9881,3950,2.79948e+13,168.367,1337.5,13831,142,128,10943,9056,3856,4295,5511
23295,145,216,16643,6652,2.79965e+13,170.558,1745.08,23295,159,146,21876,17572,17426,17390,19394
2441,9,318,1727,714,3.14906e+13,113.847,689.401,2441,79,93,1033,520,338,146,157
41540,194,249,29673,11867,2.80038e+13,172.113,2349.61,41540,192,175,41291,41291,38253,39787,41236
92403,66,341,66006,26397,2.80156e+13,173.145,3559.51,92403,284,175,73966,61136,26548,40590,39386
82619,310,800,59104,23515,2.71665e+13,221.244,4314.47,82619,798,180,81443,80876,76635,78522,80287
71098,275,303,50781,20317,2.8018e+13,172.828,3104.63,71098,245,175,70795,70795,69607,70186,70767
91034,424,800,65115,25919,2.72382e+13,228.066,4480.26,91034,794,180,89978,89276,85759,87724,89106
3997,25,181,2860,1137,2.78987e+13,154.655,712.54,3997,103,94,2587,1893,690,448,677
34687,38,236,24778,9909,2.79592e+13,171.732,2140.59,34687,180,167,25122,19685,6779,7028,9994
41543,153,249,29677,11866,2.80323e+13,172.058,2349.68,41543,192,175,39672,31434,34088,35955,36427
6310,138,185,4506,1804,2.78027e+13,161.38,897.138,6310,113,106,5765,4720,4387,4426,4945
46361,105,258,33115,13246,2.80134e+13,172.333,2487.09,46361,201,175,40345,33998,21702,20578,28970
58260,198,279,41620,16640,2.79954e+13,172.676,2798.83,58260,223,175,57981,57981,53166,55613,57900
81650,303,322,58319,23331,2.80115e+13,173.072,3337.16,81650,265,175,81328,81328,80764,81023,81309
3827,14,181,2732,1095,2.78507e+13,153.946,697.447,3827,98,92,2011,1369,591,348,496
37441,239,241,26746,10695,2.79597e+13,171.911,2226.49,37441,185,172,37200,37200,37194,37195,37198
15646,169,202,11173,4473,2.8005e+13,169.034,1423.92,15646,145,132,15288,12063,13966,13250,14980
31569,214,231,22550,9019,2.8009e+13,171.515,2039.89,31569,174,160,31338,31338,30892,31090,31321
77074,267,314,55054,22020,2.80176e+13,173.004,3238.36,77074,257,175,76760,76760,74314,75540,76713
58832,30,280,42032,16800,2.79936e+13,172.73,2813.09,58832,224,175,40080,30305,10124,12670,13488
51990,114,418,37107,14883,2.81813e+13,172.697,2830.32,51990,214,192,46028,38525,22158,19986,31967
7263,62,187,5184,2079,2.78769e+13,163.126,964.052,7263,119,110,5709,4693,2022,2121,2810
3010,161,180,2144,866,2.83945e+13,147.948,618.468,3010,93,89,2774,2254,2551,2683,2646
75584,68,310,53987,21597,2.79887e+13,172.939,3204.21,75584,253,175,60759,50142,22137,26274,33402
35330,33,238,25235,10095,2.80123e+13,171.772,2161.61,35330,181,167,24634,18835,6522,6273,8152
15518,85,345,11061,4457,2.85986e+13,169.864,1594.69,15518,153,143,12871,10841,5273,4323,7410
1008,6,176,723,285,2.73759e+13,99.3204,355.297,1008,55,59,350,129,91,58,16
43339,217,252,30955,12384,2.79979e+13,172.172,2401.24,43339,195,175,43087,43087,41423,42247,43052
31153,95,230,22252,8901,2.79763e+13,171.416,2025.65,31153,173,160,26523,21832,12880,13006,18031
8435,72,189,6024,2411,2.79428e+13,164.767,1039.84,8435,123,114,6788,5602,2660,3058,3882
54625,174,273,39011,15614,2.80257e+13,172.464,2707.13,54625,215,175,54255,43314,48332,51400,53994
8511,39,189,6081,2430,2.78752e+13,164.565,1044.32,8511,123,114,6188,4855,1703,1986,2236
19876,53,210,14198,5678,2.80096e+13,170.14,1609.43,19876,153,139,15312,12602,4857,4665,6707
52011,194,268,37156,14855,2.80158e+13,172.482,2639.18,52011,211,175,51743,51743,47456,49628,51669
99626,121,800,71254,28372,2.72903e+13,228.806,4641.64,99626,798,177,88730,73541,55409,50282,69090
85267,200,800,60996,24271,2.71667e+13,232.361,4367.3,85267,798,175,83910,83520,74545,78631,82427
37362,158,242,26683,10679,2.80339e+13,171.945,2225.35,37362,185,171,35998,28527,32588,34918,33886
93691,81,343,66926,26765,2.79956e+13,173.187,3585.17,93691,287,175,77518,65198,32705,32557,47061
67554,181,296,48246,19308,2.80122e+13,172.854,3022.72,67554,239,175,67258,67258,60171,63786,67143
79260,112,318,56610,22650,2.80301e+13,172.967,3285.82,79260,260,175,69996,58591,41019,46024,53047
99400,247,354,70997,28403,2.80139e+13,173.229,3698.66,99400,297,175,99046,99046,92493,95834,98939
92799,325,342,66279,26520,2.80129e+13,173.185,3567.9,92799,285,175,92457,92457,92034,92219,92440
77182,71,314,55127,22055,2.80058e+13,173.033,3240.56,77182,257,175,62459,51328,23585,25279,34338
93995,42,344,67139,26856,2.80055e+13,173.152,3591.59,93995,287,175,69655,55056,20256,25326,27722
29129,193,226,20813,8316,2.79721e+13,171.326,1956.71,29129,170,157,28903,28903,27350,28117,28870
46191,543,800,33082,13109,2.64979e+13,211.306,3470.57,46191,798,175,45248,44911,40984,42964,44620
17166,231,350,12236,4930,2.84201e+13,170.029,1671.25,17166,156,146,16816,16694,15052,13979,16072
91755,103,340,65545,26210,2.80109e+13,173.142,3546.46,91755,283,175,79560,67328,41506,41207,56641
73982,298,458,52811,21171,2.8138e+13,173.092,3362.86,73982,250,192,73524,73406,68284,64877,70060
4618,21,183,3296,1322,2.82023e+13,157.679,767.405,4618,107,98,2828,2028,801,486,662
79558,64,318,56825,22733,2.801e+13,172.962,3291.81,79558,260,175,63390,52501,21855,25490,32861
95137,156,800,68043,27094,2.72712e+13,223.541,4558.1,95137,798,180,90543,71692,79147,83805,82992
97379,210,351,69554,27825,2.80097e+13,173.19,3659.65,97379,293,175,97028,97028,88196,92708,96887
38442,229,800,27549,10893,2.61878e+13,208.201,3249.91,38442,776,168,37209,36779,33947,34951,35891
55947,40,275,39961,15986,2.80254e+13,172.55,2740.78,55947,218,175,41044,32166,11671,14792,15855
45834,66,256,32746,13088,2.79914e+13,172.286,2471.35,45834,200,175,36651,30317,13184,20114,19519
84246,161,326,60171,24075,2.80141e+13,173.024,3391.23,84246,269,175,81808,64403,73662,78936,77747
88679,128,335,63341,25338,2.80108e+13,173.143,3484.36,88679,278,175,80871,66663,55158,55475,66830
4038,89,181,2887,1151,2.78245e+13,153.957,715.319,4038,100,95,3337,2797,1612,1598,2161
83410,198,324,59581,23829,2.79875e+13,173.072,3373.24,83410,268,175,83086,83086,75210,79232,82960
99478,287,354,71054,28424,2.80075e+13,173.188,3699.94,99478,297,175,99124,99124,95273,97224,99057
25926,210,221,18524,7402,2.8012e+13,170.983,1843.9,25926,164,151,25705,25705,25551,25613,25694
80254,57,319,57324,22930,2.79987e+13,173.019,3306.59,80254,262,175,62788,51352,20288,22245,28737
83264,81,324,59483,23781,2.7991e+13,173.047,3370.33,83264,268,175,68882,57948,29097,28946,41785
66694,424,439,47617,19077,2.81284e+13,172.97,3190.18,66694,236,193,66255,66255,65988,66112,66240
16422,181,204,11727,4695,2.8045e+13,169.274,1460.49,16422,147,133,16218,16218,15385,15782,16195
91990,151,340,65709,26281,2.79975e+13,173.128,3550.77,91990,283,175,87701,69662,72616,71469,80238
47238,130,259,33746,13492,2.79881e+13,172.298,2510.38,47238,202,175,43223,35586,29736,27541,35837
89460,419,480,63872,25588,2.81172e+13,173.216,3687.04,89460,277,193,88980,88980,85733,87374,88919
77311,79,456,55199,22112,2.81028e+13,173.105,3428.97,77311,264,192,63677,53164,24638,21343,34401
71163,300,303,50835,20328,2.80042e+13,172.919,3106.1,71163,246,175,70860,70860,70852,70854,70857
33507,180,234,23934,9573,2.79606e+13,171.595,2102.82,33507,177,164,33273,33273,30306,31802,33219
26135,138,221,18667,7468,2.79927e+13,171.026,1851.3,26135,164,151,24249,19667,18240,17793,20868
14467,177,200,10336,4131,2.79613e+13,168.582,1368.22,14467,143,130,14267,14267,13425,13827,14244
44074,156,254,31480,12594,2.80262e+13,172.273,2422.98,44074,197,175,42338,33504,37522,39806,39665
36644,210,241,26175,10469,2.80144e+13,171.947,2203.46,36644,184,170,36403,36403,35051,35713,36372
69710,217,300,49793,19917,2.80083e+13,172.876,3072.59,69710,243,175,69410,69410,64503,66996,69327
15151,10,202,10824,4327,2.8065e+13,168.888,1401.76,15151,145,131,6937,3761,2084,1010,811
44770,43,255,31980,12790,2.80088e+13,172.271,2442.37,44770,198,175,33312,26380,9955,9493,12792
25738,40,221,18378,7360,2.8058e+13,171.013,1837.61,25738,164,150,18857,14788,5371,3992,6697
5167,93,183,3692,1475,2.79034e+13,159.099,811.484,5167,109,102,4314,3585,2087,2031,2799
73338,215,307,52380,20958,2.80069e+13,172.978,3155.32,73338,250,175,73031,73031,67526,70327,72939
2108,74,178,1502,606,2.81198e+13,136.112,515.407,2108,83,77,1652,1392,699,590,914
83576,272,325,59693,23883,2.7996e+13,173.05,3377.33,83576,268,175,83251,83251,80372,81821,83198
46834,249,259,33450,13384,2.80191e+13,172.278,2500.09,46834,202,175,46575,46575,46435,46495,46565
56034,242,276,40023,16011,2.80321e+13,172.579,2743.82,56034,219,175,55758,55758,54187,54961,55724
95856,233,347,68469,27387,2.80126e+13,173.169,3628.27,95856,290,175,95509,95509,88479,92066,95395
68856,787,800,49272,19584,2.69897e+13,214.439,4023.65,68856,798,175,68056,67866,66216,66988,68018
43438,53,253,31023,12415,2.8025e+13,172.194,2405.08,43438,196,175,33529,27559,10628,7894,14485
89094,227,335,63638,25456,2.80036e+13,173.136,3492.24,89094,278,175,88759,88759,82124,85508,88651
18117,27,207,12935,5182,2.80479e+13,169.786,1535.33,18117,150,137,12034,8969,3104,2995,3514
70701,606,1046,50539,20162,2.71694e+13,216.583,4361.58,70701,802,199,69552,69133,63693,65844,68325
98085,285,492,70045,28040,2.80922e+13,173.319,3857.14,98085,294,192,97593,97473,76913,74517,93412
57756,262,279,41247,16509,2.80252e+13,172.568,2786.92,57756,221,175,57477,57477,57043,57235,57460
97298,348,350,69499,27799,2.80098e+13,173.168,3657.18,97298,293,175,96948,96948,96942,96943,96946
37667,198,242,26909,10758,2.80349e+13,171.88,2233.98,37667,185,172,37425,37425,35170,36298,37381
90746,100,800,64904,25842,2.72425e+13,256.922,4474.81,90746,714,176,77403,65338,39713,37069,53317
43363,88,252,30970,12393,2.80118e+13,172.122,2401.88,43363,195,175,36402,30245,16674,21035,23571
32129,228,232,22948,9181,2.80249e+13,171.48,2058.37,32129,175,162,31897,31897,31879,31883,31893
80601,147,800,57663,22938,2.71357e+13,219.566,4273.38,80601,798,175,75276,60340,59623,65162,66483
53862,37,272,38472,15390,2.80332e+13,172.522,2688.02,53862,215,175,38734,30480,11111,8016,13125
56457,4,276,40330,16127,2.80016e+13,172.614,2753.83,56457,220,175,14802,4490,3266,3165,1251
54751,255,383,39082,15669,2.81257e+13,171.204,2851.11,54751,221,175,54368,54368,53867,54019,54091
62706,266,287,44798,17908,2.79909e+13,172.782,2907.83,62706,231,175,62419,62419,61684,62031,62398
90570,148,338,64694,25876,2.80167e+13,173.132,3522.62,90570,281,175,85858,68580,69203,71987,77543
71281,187,303,50917,20364,2.80092e+13,172.909,3108.58,71281,246,175,70978,70978,63806,67465,70862
60738,167,284,43389,17349,2.79961e+13,172.746,2860.47,60738,227,175,59590,46845,53338,56977,57532
58962,636,800,42204,16758,2.68287e+13,229.333,3795.89,58962,729,179,58159,57986,57367,57677,57671
98447,229,352,70316,28131,2.8009e+13,173.194,3679.62,98447,295,175,98095,98095,90433,94347,97972
42349,38,251,30247,12102,2.80041e+13,172.243,2373.74,42349,194,175,30669,24024,8302,8039,10992
61896,162,286,44210,17686,2.79955e+13,172.759,2888.57,61896,229,175,60178,47405,54132,51807,57222
27050,11,223,19319,7731,2.80192e+13,171.022,1884.49,27050,165,152,12851,7919,3965,1854,1629
6323,4,186,4522,1801,2.79679e+13,162.251,899.768,6323,116,106,1650,493,364,350,143
64748,440,800,46333,18415,2.69385e+13,215.329,3931.51,64748,787,180,63715,63037,60041,61738,62868
74100,45,308,52928,21172,2.80058e+13,172.934,3171.98,74100,251,175,55635,44202,16521,20634,23128
38971,188,244,27838,11133,2.79819e+13,171.97,2273.11,38971,187,174,38727,38727,35621,37190,38671
82444,221,323,58888,23556,2.80166e+13,173.041,3353.39,82444,266,175,82121,82121,75922,79080,82019
61816,13,429,44135,17681,2.81273e+13,172.965,3073.07,61816,228,192,31591,21309,9329,4384,6832
6287,113,185,4491,1796,2.7949e+13,161.106,894.973,6287,113,106,5492,4631,3281,3192,4134
81460,427,945,58246,23214,2.72678e+13,250.612,4479.29,81460,691,192,80308,79575,77779,78167,78899
16075,106,204,11479,4596,2.80371e+13,169.013,1445.02,16075,146,133,13939,11770,7709,8837,10216
64741,38,291,46245,18496,2.80049e+13,172.783,2956.57,64741,234,175,46912,36750,13134,10417,16791
8337,114,189,5955,2382,2.80857e+13,164.277,1034.06,8337,123,113,7300,6148,4369,4876,5613
75361,754,946,53892,21469,2.71784e+13,234.869,4353.48,75361,810,177,74415,74167,66431,68526,72890
86331,313,330,61665,24666,2.80045e+13,173.104,3435.16,86331,273,175,86001,86001,85554,85753,85984
49214,74,263,35154,14060,2.80087e+13,172.385,2564.74,49214,206,175,40077,32911,15927,11621,21724
81593,159,322,58275,23318,2.80172e+13,173.014,3335.76,81593,264,175,78935,62372,71301,76431,74249
15962,30,202,11405,4557,2.79622e+13,168.94,1438.08,15962,146,133,10862,8216,2753,2980,2854
52298,65,269,37351,14947,2.80235e+13,172.534,2647.32,52298,212,175,41738,34499,14964,10916,20641
52689,560,947,37695,14994,2.68615e+13,221.911,3828.84,52689,813,192,51592,51251,45672,40056,45912
85873,232,330,61332,24541,2.8026e+13,173.049,3426.34,85873,272,175,85543,85543,79621,82634,85445
92571,110,342,66123,26448,2.80226e+13,173.149,3563.55,92571,285,175,81439,68262,46721,53410,61150
50334,63,265,35949,14385,2.80037e+13,172.411,2594.82,50334,208,175,39990,33020,13788,17060,20862
58089,122,279,41497,16592,2.80124e+13,172.644,2794.8,58089,222,175,52304,43343,33701,35713,41584
53043,155,270,37886,15157,2.80148e+13,172.539,2666.36,53043,213,175,50893,40337,44975,45646,47591
78526,209,316,56090,22436,2.8007e+13,173.004,3269.37,78526,259,175,78210,78210,71650,74994,78103
76132,169,312,54386,21746,2.80018e+13,172.992,3217.34,76132,255,175,75004,58865,66900,71468,73605
90779,426,800,64934,25845,2.72201e+13,257.782,4475.17,90779,691,175,89771,89022,88660,89011,88859
65389,15,292,46703,18686,2.80052e+13,172.806,2971.84,65389,235,175,35456,24468,10295,6391,6424
44627,140,255,31878,12749,2.80007e+13,172.279,2438.65,44627,198,175,41607,33607,31979,33986,36352
48352,177,262,34529,13823,2.80305e+13,172.282,2541.85,48352,204,175,48090,48090,43032,45604,48005
59169,710,800,42351,16818,2.6811e+13,224.029,3800.55,59169,798,175,58359,58123,52179,55239,58100
5220,27,184,3732,1488,2.82138e+13,159.074,816.435,5220,110,103,3453,2587,910,616,913
50908,193,266,36365,14543,2.8006e+13,172.461,2610,50908,209,175,50642,50642,46400,48551,50569
29802,142,228,21293,8509,2.79783e+13,171.436,1980.73,29802,171,158,27832,22479,21780,23056,24484
61064,183,285,43618,17446,2.80057e+13,172.779,2868.9,61064,228,175,60779,60779,54595,57746,60677
44848,52,255,32033,12815,2.8004e+13,172.279,2444.57,44848,198,175,34498,27962,11106,10405,14915
20833,467,800,14972,5861,2.46277e+13,215.963,2636.82,20833,771,136,19844,19599,17377,18476,19034
34044,118,235,24313,9731,2.802e+13,171.529,2119.87,34044,178,165,30389,25212,18723,20579,23937
91909,103,341,65651,26258,2.80084e+13,173.167,3550.45,91909,284,175,79688,67441,41574,39414,57120
81839,105,463,58436,23403,2.81101e+13,173.196,3524.62,81839,265,192,71201,60069,27227,16077,42554
3145,73,180,2247,898,2.8294e+13,149.37,631.965,3145,93,90,2488,2072,998,1071,1353
27170,50,223,19412,7758,2.8025e+13,171.135,1888.66,27170,166,153,20737,16785,6502,7919,9424
11838,109,195,8453,3385,2.80577e+13,167.123,1234.98,11838,135,125,10325,8681,5843,6724,7630
96937,243,349,69247,27690,2.79994e+13,173.235,3649.92,96937,293,175,96588,96588,90072,93394,96482
99788,334,355,71277,28511,2.80206e+13,173.217,3706.43,99788,298,175,99433,99433,98742,99065,99412
85303,24,329,60931,24372,2.80118e+13,173.1,3414.51,85303,272,175,54893,40254,14516,9882,15263
88888,230,335,63494,25394,2.80051e+13,173.13,3488.34,88888,278,175,88553,88553,82163,85419,88448
68147,281,297,48678,19469,2.79957e+13,172.818,3036.25,68147,240,175,67850,67850,67474,67637,67834
1585,54,176,1140,445,2.73598e+13,124.664,445.917,1585,72,67,1177,987,415,575,560
65587,241,293,46844,18743,2.80172e+13,172.804,2977.09,65587,236,175,65294,65294,62480,63897,65242
56468,406,415,40315,16153,2.81582e+13,172.72,2933.78,56468,231,184,56053,56053,55944,55991,56044
81062,641,800,57988,23074,2.71499e+13,224.675,4283.09,81062,788,180,80229,80051,77093,78600,79786
88592,114,335,63273,25319,2.80161e+13,173.109,3482.66,88592,277,175,78558,65649,46333,51750,60269
1878,123,177,1343,535,2.789e+13,131.26,485.116,1878,80,75,1599,1369,1100,1035,1312
89825,202,337,64158,25667,2.80077e+13,173.152,3507.82,89825,280,175,89488,89488,81060,85366,89353
46408,238,258,33149,13259,2.80183e+13,172.277,2488.11,46408,201,175,46150,46150,45525,45815,46130
58058,41,279,41470,16588,2.80055e+13,172.674,2794.08,58058,222,175,42794,33685,12298,12312,16551
7861,103,188,5614,2247,2.79233e+13,164.057,1003.69,7861,122,111,6750,5735,3559,3358,4765
63916,194,800,45745,18171,2.69081e+13,214.421,3912.3,63916,798,175,62585,62207,55862,58553,61122
58242,196,279,41610,16632,2.79944e+13,172.739,2798.59,58242,223,175,57963,57963,53010,55527,57880
77798,146,315,55564,22234,2.80157e+13,172.93,3253.7,77798,257,175,73452,58909,58750,64766,65493
99639,103,499,71141,28498,2.80964e+13,173.304,3892.61,99639,295,193,86378,73147,38432,34788,56210
40442,19,247,28885,11557,2.80086e+13,172.057,2317.35,40442,190,175,23976,17103,6873,4749,6158
8988,98,190,6422,2566,2.79623e+13,165.312,1074.21,8988,126,115,7649,6483,3894,3696,5294
19609,2,210,14007,5602,2.80607e+13,170.015,1598.88,19609,153,139,2629,499,430,1032,225
2940,12,180,2102,838,2.78716e+13,149.202,611.984,2940,93,85,1443,915,428,203,181
19049,33,208,13601,5448,2.79542e+13,169.787,1574.18,19049,151,138,13272,10147,3528,3207,4834
43803,765,800,31379,12424,2.64189e+13,208.651,3405.11,43803,784,175,43003,42833,40407,41632,42899
68860,33,299,49182,19678,2.80167e+13,172.848,3053.58,68860,242,175,48040,36730,12716,9620,15438
49510,211,264,35360,14150,2.80261e+13,172.393,2573.27,49510,207,175,49246,49246,46371,47820,49193
17227,178,205,12308,4919,2.79684e+13,169.413,1495.7,17227,148,135,17022,17022,15901,16446,16995
47322,123,260,33799,13523,2.80277e+13,172.239,2513.56,47322,202,175,42694,35393,28379,29190,34114
47397,111,260,33846,13551,2.80279e+13,172.218,2515.43,47397,202,175,41747,34944,24280,27454,31461
62359,115,287,44544,17815,2.79976e+13,172.744,2899.75,62359,230,175,55378,46198,32831,30155,42261
41725,129,250,29797,11928,2.8035e+13,172.044,2355.59,41725,192,175,38071,31425,26080,26195,31463
72206,59,304,51582,20624,2.79877e+13,172.924,3128.89,72206,247,175,56792,46324,19092,20248,26576
12204,80,196,8718,3486,2.7989e+13,167.682,1255.11,12204,137,125,10023,8439,4188,4255,6011
1245,170,176,892,353,2.75938e+13,112.627,395.829,1245,61,63,1065,908,1050,1059,1042
66522,206,294,47520,19002,2.7998e+13,172.851,2998.59,66522,238,175,66228,66228,60939,63629,66140
8941,27,190,6390,2551,2.79834e+13,165.107,1071.2,8941,125,115,5928,4425,1540,1090,1307
42817,191,251,30583,12234,2.80072e+13,172.081,2386.21,42817,194,175,42566,42566,39202,40901,42506
83480,299,325,59628,23852,2.8008e+13,173.065,3375.53,83480,268,175,83155,83155,82103,82612,83129
40805,245,247,29150,11655,2.79699e+13,172.087,2327.4,40805,191,175,40558,40558,40552,40553,40556
16526,37,204,11801,4725,2.80218e+13,169.327,1465,16526,147,134,11862,9334,3315,2606,4203
31619,106,231,22587,9032,2.79914e+13,171.389,2041.1,31619,174,161,27551,23184,15115,14125,19989
21696,159,213,15498,6198,2.79832e+13,170.226,1682.36,21696,156,143,20891,16557,18886,20222,19663
42778,172,251,30556,12222,2.79965e+13,172.059,2384.93,42778,194,175,42302,33524,37876,40243,41759
54918,241,418,39200,15718,2.81658e+13,172.736,2901.52,54918,218,192,54500,54379,45043,37572,50346
84360,175,326,60258,24102,2.79862e+13,173.058,3393.47,84360,269,175,84034,84034,74471,79362,83883
13990,76,199,9986,4004,2.80695e+13,168.175,1345.08,13990,142,129,11404,9499,4698,6471,6703
30069,97,228,21479,8590,2.79874e+13,171.265,1988.97,30069,171,158,25703,21778,12701,12208,17567
68922,107,299,49224,19698,2.802e+13,172.805,3054.79,68922,241,175,60249,50571,33318,38031,44208
23415,201,216,16728,6687,2.79613e+13,170.598,1749.55,23415,159,146,23199,23199,22876,23017,23184
58506,305,420,41767,16739,2.81351e+13,172.824,2986.98,58506,235,183,58086,58073,56350,54793,56417
12208,124,196,8719,3489,2.80144e+13,167.538,1255.12,12208,137,126,10951,9099,7400,6441,8890
27167,15,223,19404,7763,2.80334e+13,170.958,1888.33,27167,166,153,14737,10173,4291,2966,3886
63438,166,289,45320,18118,2.79919e+13,172.8,2925.9,63438,232,175,62132,48929,55652,59491,60259
32908,188,234,23505,9403,2.80202e+13,171.744,2084.58,32908,177,163,32674,32674,30296,31487,32628
85400,253,946,61062,24338,2.72958e+13,228.18,4560.1,85400,791,182,84005,83386,77910,79050,81830
10468,76,193,7477,2991,2.80172e+13,166.441,1161,10468,132,121,8511,7095,3505,3651,4931
20439,156,211,14595,5844,2.80165e+13,170.028,1632.4,20439,153,140,19563,15521,17350,18396,18168
8281,115,189,5918,2363,2.79864e+13,164.511,1030.69,8281,124,113,7266,6104,4387,4916,5611
12869,19,197,9195,3674,2.79539e+13,167.739,1288.62,12869,139,127,7615,5436,2180,2140,2081
26719,127,223,19078,7641,2.80713e+13,170.972,1873.23,26719,165,152,24240,20057,16489,16680,19796
45288,774,800,32441,12847,2.64448e+13,208.491,3445.96,45288,786,175,44488,44319,41841,43100,44411
32427,227,800,23254,9173,2.5835e+13,215.395,3062.08,32427,793,157,31175,30775,26777,28389,29862
48811,52,263,34867,13944,2.80091e+13,172.476,2554.77,48811,206,175,37542,30428,11838,8759,15876
77016,755,800,55100,21916,2.71045e+13,218.482,4199.54,77016,798,175,76216,76003,70702,73440,76082
92348,285,341,65962,26386,2.80064e+13,173.162,3558.45,92348,284,175,92007,92007,88921,90478,91951
73482,533,800,52582,20900,2.70419e+13,243.573,4124.49,73482,795,175,72458,72153,63319,67825,71881
39981,168,392,28534,11447,2.82293e+13,172.322,2489.69,39981,188,178,39092,30821,22795,16280,33564
65318,92,292,46652,18666,2.80097e+13,172.788,2970.2,65318,235,175,55337,45561,25675,24978,36902
32353,69,232,23109,9244,2.79874e+13,171.508,2065.2,32353,175,162,26036,21457,9545,11332,14431
57039,142,277,40740,16299,2.8027e+13,172.563,2768.36,57039,220,175,53402,43074,41733,46135,46859
25427,114,220,18162,7265,2.80025e+13,170.902,1825.55,25427,163,149,22507,18813,13323,12029,17025
10047,134,193,7177,2870,2.80559e+13,166.333,1137.74,10047,131,120,9157,7529,6625,6957,7789
39902,80,247,28498,11404,2.80242e+13,172,2302.15,39902,189,175,32910,27686,13681,14174,19949
12770,38,197,9123,3647,2.80053e+13,167.877,1284.19,12770,140,126,9226,7239,2602,1937,3203
79401,209,318,56712,22689,2.80176e+13,173.002,3288.72,79401,261,175,79083,79083,72393,75804,78974
88074,306,333,62909,25165,2.80018e+13,173.084,3470.95,88074,276,175,87741,87741,86619,87164,87714
13660,127,263,9758,3902,2.77889e+13,166.317,1405.24,13660,162,128,12293,10210,8373,7960,5670
82117,665,800,58748,23369,2.71543e+13,219.935,4304.25,82117,798,175,81265,81070,75245,78205,80913
83903,335,800,60024,23879,2.71653e+13,227.492,4340.28,83903,784,180,82768,82158,79042,80396,81686
15207,190,201,10861,4346,2.79708e+13,168.733,1402.93,15207,144,131,15006,15006,14837,14911,14995
1901,128,177,1354,547,2.7626e+13,132.029,488.497,1901,80,75,1632,1393,1175,1081,1361
90638,192,338,64738,25900,2.80112e+13,173.155,3523.98,90638,281,175,90300,90300,81094,85801,90154
21432,611,800,15401,6031,2.47147e+13,211.658,2661.73,21432,768,138,20632,20280,17995,15733,11922
72571,155,305,51838,20733,2.80022e+13,172.927,3137.55,72571,248,175,69686,55205,61585,65495,64975
49212,27,263,35152,14060,2.80012e+13,172.387,2564.74,49212,206,175,32724,24376,8377,5981,9264
4093,144,181,2920,1173,2.77606e+13,154.342,720.35,4093,100,95,3732,3057,2996,2968,3309
75428,20,310,53882,21546,2.79925e+13,172.996,3201.22,75428,254,175,45673,32313,12824,8320,12283
7137,36,187,5096,2041,2.80336e+13,163.391,956.232,7137,119,110,5063,4020,1415,1330,1757
52359,170,269,37399,14960,2.8007e+13,172.53,2648.74,52359,212,175,51625,40562,46144,49179,50691
55214,581,800,39523,15691,2.67526e+13,220.369,3704.61,55214,757,180,54346,53946,52723,53315,53757
78177,534,800,55929,22248,2.71144e+13,247.486,4223.48,78177,704,175,77276,76876,76428,76634,76579
24312,119,218,17372,6940,2.79895e+13,170.82,1784.23,24312,161,147,21729,18028,13443,12728,17047
51601,19,267,36865,14736,2.79873e+13,172.512,2628.24,51601,211,175,30592,21823,8772,6063,7932
75334,106,311,53813,21521,2.80068e+13,172.978,3200.18,75334,254,175,65708,55272,35975,34209,48070
1215,117,176,869,346,2.75793e+13,108.678,389.818,1215,63,62,982,865,670,635,741
54943,254,416,39227,15716,2.81658e+13,172.777,2898.93,54943,215,193,54527,54406,39263,32357,50531
95792,44,347,68422,27370,2.80004e+13,173.177,3627.05,95792,290,175,71675,56629,21570,23751,27833
62737,676,800,44900,17837,2.68908e+13,222.851,3884.93,62737,763,180,61937,61756,60362,61061,61566
18182,28,207,12983,5199,2.80173e+13,169.748,1538.07,18182,150,137,12176,9137,3113,2445,3652
49580,260,263,35415,14165,2.80008e+13,172.371,2574.04,49580,206,175,49317,49317,49305,49307,49314
2924,113,179,2087,837,2.77361e+13,146.411,607.45,2924,90,85,2501,2134,1531,1504,1885
74236,191,800,53121,21115,2.70574e+13,237.058,4140.5,74236,798,175,72877,72508,63677,67673,71383
55823,246,275,39873,15950,2.80069e+13,172.601,2737.94,55823,218,175,55548,55548,54309,54914,55519
14308,127,200,10218,4090,2.8026e+13,168.364,1360.81,14308,143,129,12933,10727,8836,8937,10662
29755,109,228,21253,8502,2.80131e+13,171.423,1979.39,29755,171,157,26080,21857,14615,13439,18980
49967,154,265,35683,14284,2.80459e+13,172.382,2585.62,49967,207,175,47833,37814,42093,43801,44018
78900,65,317,56356,22544,2.8017e+13,173.025,3277.95,78900,260,175,62999,52050,22561,24702,32607
32345,201,233,23101,9244,2.80379e+13,171.528,2066.19,32345,176,162,32112,32112,30667,31379,32080
71669,166,800,51281,20388,2.70305e+13,235.393,4085.32,71669,744,180,69170,54559,60843,58022,65576
29156,224,227,20828,8328,2.80042e+13,171.369,1958.69,29156,170,157,28929,28929,28920,28921,28926
93907,71,343,67076,26831,2.80002e+13,173.126,3588.94,93907,287,175,76015,62478,28756,42106,42581
57914,88,278,41364,16550,2.80071e+13,172.559,2789.63,57914,221,175,48630,40411,22262,28094,31646
7623,149,188,5447,2176,2.78344e+13,163.987,988.571,7623,121,111,7112,5728,5810,5731,6409
63570,125,289,45406,18164,2.80091e+13,172.737,2928.77,63570,232,175,57621,47785,38806,39439,47014
86218,216,800,61679,24539,2.71838e+13,221.34,4386.23,86218,798,180,84893,84469,76931,80284,83454
91760,224,340,65544,26216,2.80032e+13,173.149,3546.66,91760,283,175,91420,91420,84277,87919,91304
1153,56,176,823,330,2.80859e+13,106.195,381.031,1153,64,64,848,717,325,411,411
43801,141,253,31285,12516,2.79888e+13,172.203,2414.72,43801,196,175,40907,33069,31553,31656,35835
67212,25,295,48009,19203,2.79871e+13,172.812,3014.3,67212,238,175,43856,31948,11428,13757,13165
47386,156,260,33852,13534,2.79867e+13,172.339,2515.34,47386,203,175,45530,36029,40348,40856,42430
24004,97,217,17147,6857,2.80144e+13,170.621,1771.98,24004,160,147,20510,17376,10149,12376,14215
47963,127,261,34256,13707,2.80171e+13,172.396,2531.29,47963,204,175,43622,36037,29614,25967,35878
31089,103,230,22202,8887,2.80384e+13,171.386,2023.71,31089,173,160,26903,22792,14102,16826,19463
22181,349,800,15929,6252,2.48895e+13,213.206,2691.7,22181,759,139,21080,20547,18784,19544,20028
38277,61,244,27343,10934,2.80148e+13,172.005,2253.47,38277,187,173,30236,24756,10324,8329,14552
4535,22,182,3241,1294,2.79421e+13,156.149,758.731,4535,104,99,2830,2016,785,481,752
7778,27,188,5558,2220,2.80402e+13,163.921,998.048,7778,121,111,5155,3847,1338,1371,1676
64800,134,291,46290,18510,2.79946e+13,172.796,2957.85,64800,234,175,59775,48824,42856,40202,50249
17260,191,205,12335,4925,2.7972e+13,169.275,1496.74,17260,148,135,17055,17055,16781,16901,17041
43206,129,253,30863,12343,2.80124e+13,172.228,2398.95,43206,196,175,39411,32533,27017,27100,32780
25493,508,800,18297,7196,2.52624e+13,210.683,2819.77,25493,757,145,24552,24251,22693,23451,23817
81760,181,322,58397,23363,2.80117e+13,173.052,3339.24,81760,265,175,81438,81438,72579,77108,81297
88614,342,484,63262,25352,2.81091e+13,173.233,3676.34,88614,285,176,88130,88130,87785,87221,87494
68333,34,298,48812,19521,2.80019e+13,172.908,3041.46,68333,241,175,48035,38410,12892,12229,16088
30988,143,230,22130,8858,2.7998e+13,171.495,2020.74,30988,173,160,29019,23378,22857,22655,25408
56673,692,800,40571,16102,2.67645e+13,220.479,3740.1,56673,757,180,55873,55698,54561,55126,55550
68573,149,298,48981,19592,2.80066e+13,172.817,3046.48,68573,241,175,65089,51915,52890,57441,58731
38526,58,800,27606,10920,2.62148e+13,217.226,3252.46,38526,734,173,29537,24356,9517,11104,13845
96778,58,349,69128,27650,2.80061e+13,173.172,3646.82,96778,292,175,75932,62108,24622,20328,35525
32839,168,376,23433,9406,2.82633e+13,171.964,2263.69,32839,186,163,32049,25311,28082,29608,30716
80057,117,319,57187,22870,2.80078e+13,173.053,3302.8,80057,262,175,71444,59311,43553,40561,55573
21469,59,213,15333,6136,2.80234e+13,170.378,1674.31,21469,156,142,16849,13764,5694,6522,8307
88769,62,335,63405,25364,2.80062e+13,173.158,3486.17,88769,278,175,70400,57597,24091,27304,35124
30304,120,229,21643,8661,2.80167e+13,171.427,1997.9,30304,172,158,27159,22483,16915,17167,21695
94271,139,344,67336,26935,2.80116e+13,173.116,3596.44,94271,287,175,87845,71054,67292,68333,76063
6566,83,185,4692,1874,2.79198e+13,161.55,915.196,6566,117,108,5387,4559,2390,3133,3411
88015,277,333,62870,25145,2.80142e+13,173.105,3469.9,88015,276,175,87682,87682,84609,86159,87626
44401,201,254,31721,12680,2.7991e+13,172.297,2431.78,44401,198,175,44147,44147,41241,42706,44094
66343,99,294,47388,18955,2.80014e+13,172.821,2994.65,66343,237,175,57009,48074,28842,34548,40013
3586,30,181,2559,1027,2.82311e+13,152.225,675.484,3586,98,93,2421,1843,649,498,708
40137,102,247,28664,11473,2.80286e+13,172.138,2309.08,40137,190,175,34697,29278,18063,15998,24473
72379,263,305,51698,20681,2.80104e+13,172.867,3133.44,72379,247,175,72074,72074,69920,70999,72032
78009,188,315,55718,22291,2.80103e+13,173.003,3258.02,78009,258,175,77694,77694,69768,73816,77567
77285,246,314,55203,22082,2.80158e+13,173.012,3242.67,77285,257,175,76971,76971,73082,75052,76903
82871,122,323,59200,23671,2.79963e+13,173.06,3361.74,82871,267,175,74664,61852,48085,47513,59314
81961,203,322,58544,23417,2.80031e+13,173.041,3343.02,81961,265,175,81639,81639,74261,78026,81520
1369,114,177,973,396,2.87992e+13,113.816,413.848,1369,71,68,1131,982,722,828,906
35682,216,238,25494,10188,2.79766e+13,171.811,2172.17,35682,182,169,35444,35444,34648,35027,35422
21495,136,213,15355,6140,2.80091e+13,170.403,1675.17,21495,156,142,19838,16167,14557,15428,16915
3120,44,179,2235,885,2.73924e+13,148.929,628.208,3120,93,86,2297,1821,710,763,907
36806,44,241,26294,10512,2.79944e+13,171.966,2208.24,36806,184,171,27507,21736,8312,7511,10737
4684,147,182,3350,1334,2.77746e+13,157.256,771.649,4684,107,99,4313,3508,3496,3646,3836
25487,29,220,18203,7284,2.80084e+13,170.919,1827.75,25487,163,149,17214,12989,4345,4589,5337
44440,96,254,31742,12698,2.79949e+13,172.154,2432.32,44440,197,175,37944,31160,18526,17924,25664
56235,219,276,40168,16067,2.80245e+13,172.614,2748.6,56235,219,175,55959,55959,52826,54404,55902
87048,499,602,62207,24841,2.77496e+13,246.355,3857.39,87048,273,175,86446,86343,86355,86355,86446
30270,7,229,21612,8658,2.80342e+13,171.233,1996.36,30270,171,158,11716,4718,3289,2245,2336
63071,244,289,45049,18022,2.80142e+13,172.733,2917.8,63071,231,175,62782,62782,60479,61631,62737
37355,112,242,26686,10669,2.80165e+13,171.946,2225.06,37355,185,171,32947,27586,19308,17515,24876
70791,192,302,50565,20226,2.80042e+13,172.925,3097.44,70791,245,175,70489,70489,63742,67182,70379
52570,54,269,37550,15020,2.80017e+13,172.496,2653.75,52570,212,175,40733,33347,12960,11895,18223
83749,259,326,59816,23933,2.80256e+13,173.062,3381.68,83749,269,175,83423,83423,79602,81537,83356
30153,189,228,21531,8622,2.79888e+13,171.307,1991.68,30153,171,158,29925,29925,27983,28951,29886
22337,98,215,15957,6380,2.80627e+13,170.544,1709.02,22337,158,144,19105,16160,9655,9274,13024
98546,72,353,70383,28163,2.80152e+13,173.199,3682.31,98546,295,175,79956,65733,30696,33355,44716
90274,100,337,64485,25789,2.80025e+13,173.112,3516.07,90274,280,175,77798,65593,40355,37446,54275
43645,124,253,31174,12471,2.80081e+13,172.249,2410.63,43645,196,175,39460,32632,26562,21980,31489
38650,103,244,27601,11049,2.80213e+13,171.922,2263.83,38650,187,173,33488,28346,17519,16617,23984
82027,86,322,58588,23439,2.79943e+13,173.027,3344.24,82027,265,175,68611,57233,30312,27941,41830
39783,204,246,28417,11366,2.8009e+13,171.964,2298.01,39783,189,175,39537,39537,37380,38460,39495
48458,53,262,34615,13843,2.80214e+13,172.412,2544.89,48458,205,175,37406,30735,11864,13949,17029
62126,57,286,44378,17748,2.80052e+13,172.735,2893.62,62126,229,175,48596,39751,15771,20932,23619
7953,106,188,5682,2271,2.79011e+13,164,1008.76,7953,121,112,6873,5806,3815,3757,4923
4296,27,182,3074,1222,2.78249e+13,155.891,738.78,4296,103,96,2836,2113,718,892,842
40173,159,246,28705,11468,2.79683e+13,172.02,2308.76,40173,190,175,38799,30684,35064,37567,36531
15098,112,201,10791,4307,2.79489e+13,168.955,1398.51,15098,145,131,13267,11127,7801,7212,9973
77630,37,314,55454,22176,2.79965e+13,173.028,3249.66,77630,258,175,55836,43923,15473,14596,19570
19983,144,210,14275,5708,2.79864e+13,170.093,1613.69,19983,154,140,18696,15062,14798,16382,16536
34928,25,238,24951,9977,2.80162e+13,171.8,2149.85,34928,181,167,22777,16600,5938,4125,6239
71852,256,304,51324,20528,2.80139e+13,172.878,3121.38,71852,247,175,71548,71548,69019,70289,71500
8768,58,190,6265,2503,2.80057e+13,165.182,1061.04,8768,125,115,6828,5613,2299,2177,3146
65243,100,292,46602,18641,2.80095e+13,172.787,2968.49,65243,235,175,56202,47393,29135,28737,39185
21865,162,214,15613,6252,2.80504e+13,170.152,1689.92,21865,156,143,21157,16726,19068,20387,20070
6752,169,186,4819,1933,2.80264e+13,162.272,929.185,6752,116,108,6506,5177,6183,5795,6373
10710,156,194,7648,3062,2.8173e+13,166.597,1174.93,10710,133,123,10174,8107,9040,9573,9461
40682,22,800,29147,11535,2.62998e+13,208.37,3315.8,40682,776,173,25150,18222,6755,5051,6998
80838,320,462,57727,23111,2.81011e+13,173.172,3504.58,80838,273,192,80376,80376,77728,74886,77838
13547,105,198,9678,3869,2.78958e+13,168.081,1322.9,13547,141,128,11729,9916,6364,6213,8373
26592,156,222,18998,7594,2.79882e+13,171.047,1867.98,26592,165,151,25496,20202,22604,23969,23686
53999,225,271,38576,15423,2.79751e+13,172.558,2690.44,53999,215,175,53728,53728,51299,52519,53682
21658,39,213,15476,6182,2.79803e+13,170.443,1681.34,21658,156,143,15785,12357,4567,5061,5649
57128,196,278,40802,16326,2.80351e+13,172.6,2771.47,57128,221,175,56850,56850,52016,54469,56768
85475,254,328,61047,24428,2.80082e+13,173.04,3416.73,85475,271,175,85147,85147,80829,83019,85073
63745,172,800,45617,18128,2.69229e+13,237.554,3908.07,63745,793,175,62046,49215,53740,57409,59872
4443,115,182,3173,1270,2.79822e+13,156.249,751.901,4443,106,97,3848,3259,2378,2634,3007
77044,5,314,55025,22019,2.80304e+13,172.939,3237.66,77044,256,175,23971,8513,5161,4458,2168
86539,185,330,61813,24726,2.79957e+13,173.061,3438.96,86539,273,175,86209,86209,77060,81737,86064
73199,327,447,52264,20935,2.81254e+13,173.074,3335.04,73199,248,193,72752,72752,67513,65919,70991
97871,41,351,69909,27962,2.80055e+13,173.192,3668.44,97871,294,175,72173,56795,20555,26191,28297
61462,187,286,43900,17562,2.80145e+13,172.71,2878.71,61462,228,175,61176,61176,55197,58242,61077
96782,473,488,69109,27673,2.81009e+13,173.295,3829.64,96782,305,178,96294,96294,96029,96152,96279
14469,54,201,10332,4137,2.8084e+13,168.252,1369.23,14469,143,130,11179,9177,3616,4343,5152
74472,294,452,53180,21292,2.81135e+13,173.17,3367.64,74472,251,193,74020,73903,65691,63162,69678
76720,488,800,54892,21828,2.7099e+13,245.149,4193.22,76720,717,177,75771,75384,74684,75007,74984
11517,74,195,8230,3287,2.80692e+13,167.177,1218.65,11517,135,125,9322,7681,3759,3872,5298
30021,3,228,21439,8582,2.80229e+13,171.285,1987.79,30021,171,158,6296,1417,1303,2011,741
49267,229,800,35288,13979,2.6561e+13,213.829,3552.61,49267,767,179,48035,47585,45261,45978,46702
94361,341,344,67394,26967,2.80103e+13,173.118,3598.05,94361,287,175,94017,94017,94005,94007,94014
56433,261,276,40310,16123,2.80061e+13,172.617,2753.12,56433,219,175,56157,56157,55840,55979,56142
50293,49,265,35922,14371,2.80153e+13,172.447,2593.89,50293,208,175,38286,30994,11857,9300,15915
32711,28,233,23360,9351,2.80082e+13,171.594,2077.39,32711,176,163,21921,16433,5577,5447,6618
48806,184,262,34865,13941,2.79947e+13,172.427,2553.6,48806,206,175,48544,48544,43941,46280,48466
64886,446,800,46440,18446,2.69007e+13,232.94,3934.28,64886,734,180,63893,63176,62510,63006,63024
23706,153,217,16931,6775,2.8022e+13,170.562,1761.02,23706,160,146,22587,17926,19433,20475,20754
48631,239,410,34712,13919,2.81474e+13,172.637,2738.6,48631,203,188,48221,48099,36593,29073,44443
40615,67,248,29009,11606,2.80419e+13,172.072,2323.14,40615,191,175,32550,26860,11819,9439,16829
86055,420,800,61555,24500,2.71928e+13,253.746,4382.98,86055,795,175,84895,84306,73869,79396,84062
84908,240,328,60644,24264,2.80162e+13,173.014,3405.83,84908,270,175,84580,84580,79312,81991,84492
30708,102,229,21939,8769,2.79735e+13,171.373,2010.54,30708,172,159,26514,22406,13857,12892,18810
8625,177,190,6158,2467,2.8062e+13,164.874,1052.31,8625,125,115,8435,8435,8207,8306,8422
51140,200,267,36522,14618,2.80249e+13,172.485,2616.89,51140,210,175,50873,50873,47050,48985,50806
65499,148,293,46789,18710,2.80076e+13,172.863,2975.37,65499,236,175,62047,49576,50045,54742,56143
52306,140,268,37362,14944,2.79788e+13,172.499,2646.44,52306,211,175,48794,39403,37500,37518,42406
72437,350,800,51826,20611,2.7055e+13,230.109,4102.02,72437,798,175,71248,70712,62907,66778,70231
76815,202,313,54870,21945,2.80149e+13,172.972,3232.07,76815,256,175,76502,76502,69689,73164,76391
10877,96,193,7779,3098,2.78566e+13,166.906,1183.02,10877,133,123,9213,7608,4549,4609,6201
12779,155,197,9131,3648,2.79856e+13,167.767,1284.37,12779,139,127,12162,9688,10761,10916,11251
64740,51,291,46246,18494,2.80053e+13,172.782,2956.59,64740,234,175,49651,40144,15933,18393,22429
30943,203,230,22100,8843,2.8016e+13,171.45,2019.23,30943,173,160,30713,30713,29610,30145,30686
84581,394,800,60499,24082,2.71956e+13,228.104,4353.95,84581,798,175,83433,82834,74937,79147,82525
38988,763,800,27939,11049,2.62039e+13,212.722,3266.13,38988,797,169,38188,38005,34688,36386,38078
10811,89,194,7717,3094,2.80792e+13,166.188,1179.84,10811,132,123,9046,7530,4251,5281,5929
28435,267,365,20287,8148,2.83179e+13,171.557,2109.48,28435,169,170,28070,27950,19976,18030,26616
4014,45,181,2870,1144,2.78509e+13,154.764,714.463,4014,102,94,2973,2377,929,1095,1191
3787,165,181,2707,1080,2.7698e+13,153.921,693.858,3787,98,92,3555,2857,3390,3199,3446
72952,765,800,52200,20752,2.70897e+13,238.848,4082.21,72952,606,175,72152,72152,72128,72033,72151
30048,179,228,21469,8579,2.79788e+13,171.272,1988.21,30048,171,158,29820,29820,27198,28516,29771
12265,115,197,8762,3503,2.80448e+13,167.731,1259.07,12265,139,126,10808,9054,6485,7266,8349
52669,160,269,37620,15049,2.79945e+13,172.476,2656.12,52669,212,175,51005,40245,46009,47036,48358
47216,105,259,33729,13487,2.79862e+13,172.299,2509.97,47216,202,175,41077,34634,22134,20961,29609
14350,49,200,10251,4099,2.80224e+13,168.547,1362.64,14350,143,129,10892,8835,3379,4035,4750
16614,84,204,11872,4742,2.80004e+13,169.28,1468.42,16614,147,133,13788,11535,5922,5170,8476
5151,66,183,3681,1470,2.80726e+13,158.844,810.119,5151,108,102,4071,3386,1511,2265,2167
69946,34,800,50050,19896,2.70039e+13,227.311,4047.7,69946,798,175,48702,39158,12977,12707,15970
60790,392,941,43490,17300,2.70109e+13,230.741,4020.78,60790,811,192,59512,58947,51844,43418,51157
17836,80,206,12739,5097,2.7953e+13,169.454,1522.16,17836,149,136,14680,12363,6158,5821,8525
81144,293,321,57967,23177,2.79935e+13,173.069,3326.08,81144,264,175,80823,80823,79675,80232,80795
78046,249,315,55744,22302,2.80006e+13,172.989,3258.87,78046,258,175,77731,77731,73976,75876,77665
91014,292,338,65017,25997,2.7996e+13,173.143,3530.88,91014,282,175,90676,90676,88241,89463,90630
97024,125,350,69296,27728,2.80193e+13,173.175,3652.31,97024,293,175,87974,72945,59189,60199,71789
59990,242,283,42848,17142,2.80166e+13,172.736,2842.58,59990,226,175,59707,59707,57669,58685,59666
19693,27,209,14076,5617,2.79195e+13,170.096,1601.27,19693,153,140,13076,9742,3333,3557,3115
32802,227,233,23432,9370,2.7982e+13,171.591,2080.27,32802,176,163,32569,32569,32517,32535,32563
69570,196,300,49689,19881,2.8014e+13,172.83,3069.47,69570,243,175,69270,69270,62908,66151,69166
34871,93,238,24906,9965,2.80176e+13,171.737,2148.11,34871,180,167,29549,24385,13927,17467,19881
13354,59,800,9596,3758,2.46616e+13,173.175,2103.12,13354,539,125,10043,8330,3196,2153,249
47330,193,260,33809,13521,2.80259e+13,172.35,2514,47330,203,175,47070,47070,43257,45185,47003
39457,61,245,28183,11274,2.79941e+13,171.924,2287.5,39457,188,175,31183,25533,10687,9453,14720
47857,214,261,34178,13679,2.80262e+13,172.313,2528.31,47857,203,175,47596,47596,45122,46364,47549
97423,337,350,69591,27832,2.80057e+13,173.168,3659.25,97423,293,175,97073,97073,96842,96942,97060
21861,129,213,15620,6241,2.79587e+13,170.323,1688.9,21861,156,143,19905,16450,13678,12287,16469
14245,66,200,10173,4072,2.80511e+13,168.617,1358.16,14245,143,129,11347,9402,4091,3810,5910
30215,34,229,21579,8636,2.8034e+13,171.418,1994.86,30215,172,158,21222,16981,5707,4298,6952
18053,122,206,12897,5156,2.79055e+13,169.668,1531.55,18053,150,137,16186,13445,10474,9409,12850
32282,186,233,23065,9217,2.80009e+13,171.697,2064.32,32282,176,162,32049,32049,29605,30831,32002
67419,171,296,48158,19261,2.80098e+13,172.833,3019.68,67419,239,175,66643,52252,59362,63330,66140
44203,469,800,31660,12543,2.64379e+13,210.79,3415.71,44203,769,175,43217,42927,40845,41872,42410
85406,179,328,61000,24406,2.80011e+13,173.069,3415.45,85406,271,175,85078,85078,75660,80475,84929
76986,399,455,54978,22008,2.81081e+13,173.15,3420.83,76986,260,192,76531,76531,73764,74126,76246
2883,151,179,2055,828,2.83754e+13,146.001,604.104,2883,91,87,2612,2141,2211,2357,2369
40541,107,247,28959,11582,2.79854e+13,172.035,2320.05,40541,190,175,35409,29732,19584,18162,25818
42939,148,251,30680,12259,2.79702e+13,172.185,2389.55,42939,195,175,40644,32493,32775,32011,36349
58407,200,280,41720,16687,2.80238e+13,172.662,2803.22,58407,223,175,58127,58127,53428,55812,58047
74561,246,308,53263,21298,2.79894e+13,172.948,3181.39,74561,252,175,74253,74253,70730,72512,74191
70200,36,440,50118,20082,2.81356e+13,172.964,3264.53,70200,253,175,50150,39708,14230,14581,14871
19630,170,209,14026,5604,2.79588e+13,170.156,1598.91,19630,153,140,19253,15166,17498,18464,18917
85691,179,329,61208,24483,2.80066e+13,173.091,3421.96,85691,272,175,85362,85362,75880,80727,85212
85628,346,800,61247,24381,2.721e+13,220.498,4374.82,85628,798,180,84472,83879,78634,81128,83418
24664,203,219,17622,7042,2.79724e+13,170.947,1797.86,24664,162,149,24445,24445,24108,24250,24429
49008,168,262,35005,14003,2.80115e+13,172.297,2558.43,49008,205,175,48139,37801,43119,45993,47065
92539,210,341,66102,26437,2.79988e+13,173.157,3562.02,92539,284,175,92198,92198,83994,88186,92067
45771,28,256,32697,13074,2.79714e+13,172.29,2469.63,45771,200,175,30684,22995,7784,7607,9651
38404,89,243,27430,10974,2.79772e+13,171.914,2255.94,38404,186,173,32293,26785,14988,13592,20351
44831,232,255,32021,12810,2.80021e+13,172.243,2443.97,44831,198,175,44576,44576,43714,44128,44553
20215,147,210,14445,5770,2.79437e+13,170.086,1622.75,20215,154,141,19039,15276,15331,15974,17180
73612,268,307,52580,21032,2.8004e+13,172.943,3160.99,73612,250,175,73305,73305,71363,72331,73266
7549,130,188,5394,2155,2.80703e+13,163.828,983.9,7549,121,111,6809,5646,4726,4271,5634
75933,223,800,54327,21606,2.70888e+13,225.912,4176.65,75933,798,175,74622,74202,66473,69984,73218
84005,504,800,60096,23909,2.71759e+13,220.57,4342.11,84005,798,180,83018,82657,78295,80484,82317
16678,195,204,11910,4768,2.80789e+13,169.031,1471.1,16678,147,134,16474,16474,16371,16409,16465
3779,137,181,2697,1082,2.80927e+13,153.302,692.761,3779,100,93,3388,2808,2561,2688,2931
2666,22,179,1899,767,2.82548e+13,143.697,580.327,2666,90,83,1650,1182,458,289,279
91544,111,340,65383,26161,2.80201e+13,173.173,3542.77,91544,283,175,80708,67495,46833,43077,60650
13318,186,199,9513,3805,2.8037e+13,168.059,1312.99,13318,141,128,13119,13119,12918,13004,13107
74186,791,800,53072,21114,2.70681e+13,232.272,4139.09,74186,757,180,73386,73246,72999,73167,73360
75721,38,311,54085,21636,2.79995e+13,172.989,3208.01,75721,254,175,54874,42981,15742,19045,20714
51949,339,800,37189,14760,2.66859e+13,229.466,3622.55,51949,684,175,50854,50261,49623,49723,49768
11603,39,195,8289,3314,2.80069e+13,167.22,1222.98,11603,135,124,8440,6621,2385,2954,3274
58764,353,800,42060,16704,2.68328e+13,224.327,3790.98,58764,798,175,57597,57064,50537,53765,56613
98724,921,943,70582,28142,2.73927e+13,250.888,4811.35,98724,761,198,97781,97781,96666,97098,97716
34628,3,236,24734,9894,2.79662e+13,171.701,2138.8,34628,179,166,7252,1625,1498,1876,792
11766,31,195,8414,3352,2.7918e+13,167.606,1231.97,11766,137,125,8055,6110,2101,2054,2614
61611,208,285,44011,17600,2.80085e+13,172.704,2881.1,61611,228,175,61326,61326,56806,59100,61249
24409,113,218,17433,6976,2.80051e+13,170.81,1787.63,24409,161,148,21559,18057,12720,11519,16374
24236,48,218,17314,6922,2.79843e+13,170.881,1781.43,24236,161,148,18360,14785,5626,6230,7571
85711,243,477,61197,24514,2.80953e+13,173.221,3614.53,85711,270,195,85234,85113,64308,47374,76655
27732,110,224,19806,7926,2.79953e+13,171.172,1908.64,27732,167,154,24334,20422,13998,13407,18099
38076,335,383,27180,10896,2.82253e+13,172.317,2425.54,38076,199,188,37693,37693,35589,35091,37479
32968,189,233,23556,9412,2.79649e+13,171.574,2085.28,32968,177,164,32735,32735,30436,31588,32691
9770,143,192,6979,2791,2.80446e+13,165.894,1120.95,9770,129,119,9066,7345,7162,7912,8038
18213,102,207,13015,5198,2.79772e+13,169.806,1539.24,18213,150,137,15677,13268,8235,9771,11230
36363,648,800,26065,10298,2.60897e+13,214.674,3186.97,36363,797,165,35528,35346,31794,33596,35108
38769,7,244,27686,11083,2.79971e+13,172.006,2267.59,38769,187,174,14998,6028,4203,2873,3034
38148,230,243,27248,10900,2.79951e+13,172,2248.68,38148,186,173,37905,37905,37698,37787,37892
50100,237,265,35790,14310,2.80277e+13,172.454,2589.04,50100,208,175,49835,49835,48670,49236,49807
27448,363,800,19699,7749,2.5479e+13,209.947,2891.57,27448,770,149,26355,25805,23684,24661,25337
36834,100,240,26317,10517,2.79808e+13,171.855,2207.83,36834,184,171,31679,26745,16475,15301,22162
12095,44,196,8639,3456,2.80434e+13,167.543,1249.39,12095,137,125,9013,7143,2730,2627,3466
46668,225,258,33338,13330,2.79859e+13,172.375,2495.1,46668,202,175,46410,46410,44866,45630,46377
40029,106,246,28593,11436,2.79881e+13,171.982,2304.77,40029,189,175,34885,29358,19140,17865,25343
11577,156,195,8268,3309,2.80211e+13,167.039,1221.72,11577,136,124,11021,8773,9784,10364,10223
66808,79,295,47717,19091,2.80068e+13,172.764,3005.61,66808,237,175,55029,45896,22656,31182,33007
6898,48,186,4925,1973,2.78822e+13,161.973,938.02,6898,116,108,5206,4209,1617,1787,2140
84531,75,327,60375,24156,2.80128e+13,173.086,3397.75,84531,270,175,69032,56990,27985,28330,39771
11708,130,195,8369,3339,2.79481e+13,167.523,1228.96,11708,136,124,10633,8785,7345,6968,8929
4128,25,181,2945,1183,2.77298e+13,154.358,723.32,4128,100,95,2676,1950,711,577,859
92642,506,800,66262,26380,2.72518e+13,257.138,4511.02,92642,723,177,91711,91311,90630,90949,90960
19272,81,209,13768,5504,2.80253e+13,169.949,1584.33,19272,152,139,15900,13389,6736,6745,9616
24830,95,219,17734,7096,2.80237e+13,170.934,1803.74,24830,162,149,21134,17381,10245,9749,14177
51112,112,266,36510,14602,2.80044e+13,172.436,2614.92,51112,209,175,45120,37767,26433,27569,34024
73419,186,306,52445,20974,2.79798e+13,172.915,3155.98,73419,250,175,73113,73113,65648,69458,72993
24189,566,800,17372,6817,2.50933e+13,219.441,2770.88,24189,779,142,23285,22949,20164,21560,22686
38753,291,387,27657,11096,2.82518e+13,172.346,2450.15,38753,186,179,38366,38248,32577,32577,37121
31705,53,231,22649,9056,2.79776e+13,171.543,2044.29,31705,174,161,24459,20098,7758,7108,10784
31639,108,231,22604,9035,2.79915e+13,171.556,2042.18,31639,174,160,27674,23193,15434,13023,20155
72997,173,306,52141,20856,2.80066e+13,172.919,3147.25,72997,249,175,72431,57364,64358,68619,71867
66945,281,295,47820,19125,2.80146e+13,172.809,3008.52,66945,238,175,66650,66650,66398,66503,66636
38781,198,245,27698,11083,2.80247e+13,171.942,2268.73,38781,187,174,38536,38536,36092,37318,38489
99441,63,354,71029,28412,2.7998e+13,173.234,3699.25,99441,297,175,79056,65246,27721,28614,38882
85619,261,328,61154,24465,2.80055e+13,173.028,3419.47,85619,271,175,85291,85291,81437,83391,85224
57190,125,277,40844,16346,2.79874e+13,172.58,2771.7,57190,220,175,51833,42988,34903,30060,41626
24009,109,217,17146,6863,2.79732e+13,170.617,1771.97,24009,160,147,21025,17639,11837,11567,15429
93512,481,483,66771,26741,2.80989e+13,173.24,3765.39,93512,291,177,93029,93029,93025,93025,93027
85754,224,329,61254,24500,2.80041e+13,173.087,3423.11,85754,272,175,85425,85425,79007,82278,85320
46068,95,257,32909,13159,2.79898e+13,172.232,2478.12,46068,200,175,39253,32301,19037,18406,26394
96496,127,349,68921,27575,2.8015e+13,173.147,3641.71,96496,291,175,87843,72554,59657,60218,71628
79821,262,319,57020,22801,2.79989e+13,173.08,3298.23,79821,262,175,79502,79502,76382,77954,79445
8164,331,800,5885,2279,2.22305e+13,162.784,1804.06,8164,534,107,7364,7122,5951,4519,908
72739,419,460,51969,20770,2.78853e+13,172.186,3331.43,72739,248,175,72279,72279,72265,72265,72243
48399,246,800,34661,13738,2.65603e+13,219.585,3529.95,48399,746,180,47202,46718,45207,45554,45923
86243,151,330,61600,24643,2.80069e+13,173.097,3433.43,86243,273,175,82217,65305,68072,70409,75416
19429,143,209,13881,5548,2.79872e+13,169.96,1590.61,19429,153,139,18139,14644,14311,15822,15986
45212,46,256,32290,12922,2.80153e+13,172.295,2455.1,45212,199,175,34051,27287,10226,9929,13508
4135,115,182,2950,1185,2.82625e+13,154.763,725.753,4135,103,97,3593,3029,2203,2475,2829
52803,92,270,37720,15083,2.79954e+13,172.599,2660.73,52803,213,175,44697,36822,20746,20183,29486
54841,627,800,39261,15580,2.67446e+13,230.53,3695.28,54841,795,175,53944,53774,47332,50651,53522
55347,44,274,39534,15813,2.80035e+13,172.571,2725.5,55347,218,175,41395,32719,12467,9026,15737
78264,157,315,55903,22361,2.79856e+13,172.982,3263.16,78264,258,175,75447,59543,68388,66563,70027
31888,113,232,22777,9111,2.80247e+13,171.473,2050.73,31888,175,161,28179,23608,16637,18581,21605
16340,127,203,11666,4674,2.79959e+13,169.093,1455.23,16340,146,133,14801,12256,10099,8807,12071
82410,541,800,58952,23458,2.71586e+13,221.472,4310.02,82410,797,180,81468,81068,77377,79234,80833
44874,245,255,32053,12821,2.80192e+13,172.257,2445.09,44874,198,175,44619,44619,44485,44541,44609
54623,110,272,39014,15609,2.80036e+13,172.472,2706.25,54623,215,175,48016,40275,27575,31529,35738
45095,239,255,32215,12880,2.80005e+13,172.21,2450.86,45095,198,175,44840,44840,44461,44625,44824
23481,110,216,16775,6706,2.79907e+13,170.627,1751.99,23481,159,146,20600,17288,11851,12596,15417
22149,160,214,15824,6325,2.79957e+13,170.486,1701.08,22149,157,143,21365,16894,19288,20647,20199
6675,82,186,4769,1906,2.79909e+13,161.989,923.43,6675,116,108,5477,4621,2380,2449,3359
85320,163,800,61035,24285,2.71894e+13,227.395,4368.55,85320,787,180,82124,64652,72660,74089,77674
18938,114,208,13526,5412,2.80065e+13,169.741,1569.64,18938,151,138,16743,14007,9947,9000,12711
19286,174,209,13779,5507,2.80268e+13,169.813,1584.68,19286,152,139,19044,15248,17438,18247,18959
68593,257,298,48989,19604,2.80108e+13,172.843,3046.86,68593,241,175,68295,68295,66258,67274,68254
92890,119,342,66348,26542,2.80067e+13,173.133,3569.31,92890,285,175,83236,69004,51429,56275,65840
42034,173,250,30026,12008,2.8003e+13,172.157,2364.17,42034,193,175,41636,33006,37267,39562,41235
69612,717,800,49812,19800,2.69899e+13,216.21,4040.1,69612,791,180,68812,68609,65575,67113,68564
83039,656,946,59382,23657,2.72851e+13,226.979,4512.55,83039,810,178,82010,81824,74398,75251,79692
48982,113,263,34984,13998,2.80235e+13,172.309,2558.82,48982,205,175,43325,36283,25536,28529,32991
55092,707,800,39436,15656,2.67403e+13,217.889,3701.38,55092,763,180,54292,54113,52754,53426,54014
49928,173,800,35754,14174,2.66211e+13,226.375,3570.33,49928,796,175,48414,38436,41789,44508,46638
35714,97,238,25512,10202,2.79634e+13,171.796,2173.15,35714,181,168,30531,25868,15070,14442,20545
41100,141,248,29357,11743,2.79885e+13,172.04,2336.39,41100,191,175,38381,31031,29607,29696,33594
95454,22,347,68179,27275,2.8014e+13,173.176,3620.98,95454,290,175,59704,42463,16250,10722,16126
92934,785,800,66478,26456,2.72419e+13,224.052,4516.44,92934,798,180,92134,91909,88307,89770,92090
98771,135,353,70555,28216,2.80012e+13,173.221,3686.45,98771,296,175,91332,74436,66047,58581,77479
44450,65,254,31754,12696,2.79887e+13,172.251,2433.02,44450,198,175,35461,29316,12275,13916,18669
42641,110,251,30461,12180,2.80006e+13,172.136,2381.52,42641,195,175,37458,31430,21535,24587,28117
90801,449,800,64945,25856,2.72368e+13,256.777,4475.42,90801,704,175,89815,89044,88725,89053,88948
88493,97,951,63279,25214,2.73059e+13,223.169,4625.19,88493,800,195,74949,63568,34902,19811,40661
41502,163,249,29649,11853,2.80193e+13,172.091,2348.59,41502,192,175,40371,31772,36323,38844,38673
43985,149,254,31418,12567,2.79996e+13,172.281,2420.69,43985,197,175,41703,33277,33892,36808,37873
17239,172,206,12310,4929,2.80717e+13,169.286,1497.29,17239,148,135,16943,13474,15485,16253,16725
36935,507,800,26475,10460,2.6105e+13,218.071,3204.08,36935,797,166,35953,35672,31369,33537,35256
99570,243,504,71090,28480,2.81017e+13,173.284,3896.08,99570,295,196,99066,98945,82298,71132,91896
17096,23,204,12216,4880,2.79605e+13,169.391,1489.51,17096,148,135,10836,7907,2916,2848,2356
61454,139,285,43900,17554,2.80159e+13,172.739,2877.65,61454,228,175,57216,46294,43853,42001,49431
99393,157,354,70995,28398,2.80144e+13,173.208,3698.36,99393,297,175,95835,75624,86873,90093,89751
9933,98,192,7097,2836,2.79954e+13,166.128,1130.49,9933,130,119,8449,7172,4312,4151,5871
99757,217,355,71262,28495,2.80039e+13,173.253,3705.98,99757,298,175,99402,99402,90770,95181,99264
72676,661,800,52004,20672,2.70434e+13,215.739,4107.06,72676,798,175,71837,71646,66927,69331,71460
13438,135,199,9602,3836,2.79961e+13,168.486,1319.1,13438,142,128,12319,10081,8976,9479,10544
92008,124,340,65718,26290,2.80104e+13,173.123,3551.2,92008,283,175,83259,68845,56034,56924,66898
81283,304,321,58059,23224,2.80063e+13,173.01,3328.79,81283,264,175,80962,80962,80539,80724,80945
32900,333,379,23471,9429,2.82965e+13,171.91,2268.47,32900,191,180,32521,32521,30856,30543,32252
70515,228,301,50374,20141,2.799e+13,172.89,3090.58,70515,245,175,70214,70214,65947,68112,70141
83273,199,324,59488,23785,2.79896e+13,173.061,3370.48,83273,268,175,82949,82949,75150,79134,82824
92917,176,342,66371,26546,2.80091e+13,173.146,3569.84,92917,285,175,92575,92575,82036,87428,92409
33868,73,235,24185,9683,2.80285e+13,171.64,2114.92,33868,178,165,27504,22583,10819,15324,15717
10923,97,194,7804,3119,2.80488e+13,166.803,1186.46,10923,133,124,9272,7884,4628,4460,6312
36830,223,240,26310,10520,2.79648e+13,171.838,2207.73,36830,184,170,36590,36590,36135,36339,36573
95604,152,347,68289,27315,2.80113e+13,173.184,3623.71,95604,290,175,91324,72395,76685,82187,84119
41694,12,249,29787,11907,2.79814e+13,172.116,2353.86,41694,192,175,20573,13030,6181,3543,4151
96886,176,349,69200,27686,2.80171e+13,173.163,3648.78,96886,292,175,96537,96537,85508,91153,96364
12877,122,198,9201,3676,2.80349e+13,168.178,1290.53,12877,141,127,11513,9570,7467,7893,9296
40648,233,247,29032,11616,2.79879e+13,172.029,2322.84,40648,190,175,40401,40401,40125,40246,40387
62641,18,432,44719,17922,2.81345e+13,172.938,3094.55,62641,230,193,36326,25800,10576,4322,5561
28426,207,225,20310,8116,2.79804e+13,171.083,1932.18,28426,168,155,28201,28201,27687,27920,28183
32381,145,233,23133,9248,2.80154e+13,171.625,2067.35,32381,176,162,30438,24430,24250,26843,27233
89771,84,945,64194,25577,2.73234e+13,234.293,4643.66,89771,813,190,73984,62003,30003,27373,43798
70498,127,446,50335,20163,2.81205e+13,173.088,3278.69,70498,243,193,64087,53007,33063,22996,46047
20189,69,210,14422,5767,2.79798e+13,170.032,1621.49,20189,153,140,16226,13384,5981,7342,8931
73051,32,456,52157,20894,2.81053e+13,173.121,3341.75,73051,248,196,50580,38272,13356,8406,14558
4331,122,182,3091,1240,2.81535e+13,154.999,741.738,4331,104,97,3806,3204,2534,2676,3114
80876,129,321,57770,23106,2.80114e+13,173.064,3320.87,80876,264,175,73885,60937,50608,50739,61583
44491,163,255,31774,12717,2.80357e+13,172.248,2435,44491,198,175,43288,34063,38912,41637,41292
21128,152,212,15087,6041,2.80157e+13,170.268,1660.04,21128,155,142,20088,15969,16889,17339,18481
31561,155,231,22545,9016,2.79982e+13,171.476,2039.62,31561,174,160,30230,23987,26732,28414,28112
28971,138,227,20695,8276,2.80032e+13,171.421,1952.68,28971,170,156,26857,21797,20236,20907,23244
25993,13,221,18567,7426,2.80048e+13,170.893,1846.27,25993,164,151,13298,8976,3903,2511,3155
48488,80,261,34637,13851,2.79692e+13,172.418,2544.59,48488,205,175,39991,33648,16630,15728,23570
1727,111,177,1234,493,2.78827e+13,129.228,466.886,1727,74,72,1424,1237,871,833,1049
72463,32,305,51760,20703,2.8007e+13,172.933,3135.22,72463,248,175,50157,37995,13250,9443,15107
61101,136,284,43650,17451,2.79887e+13,172.783,2868.89,61101,228,175,56567,46026,41389,41390,48375
94238,14,345,67305,26933,2.80229e+13,173.161,3596.98,94238,288,175,49752,33916,14324,7159,7061
57498,78,652,41107,16391,2.7524e+13,221.828,3302.48,57498,266,175,46934,39193,19183,17190,27052
54388,39,273,38849,15539,2.80314e+13,172.544,2701.7,54388,216,175,39700,31072,10942,8293,13846
64320,283,291,45942,18378,2.80306e+13,172.76,2947.38,64320,234,175,64029,64029,63947,63976,64021
77799,261,800,55659,22140,2.71014e+13,217.238,4215.52,77799,798,180,76557,76065,70511,72980,75264
73979,30,308,52847,21132,2.80136e+13,172.931,3169.48,73979,251,175,50413,38127,12740,9242,14637
91085,241,800,65156,25929,2.72307e+13,232.643,4481.4,91085,798,175,89772,89327,80243,84497,88394
43591,179,253,31138,12453,2.8017e+13,172.262,2409.16,43591,196,175,43338,43338,39028,41215,43264
67873,266,297,48481,19392,2.80112e+13,172.837,3030.43,67873,240,175,67576,67576,66190,66871,67545
22462,176,800,16137,6325,2.49291e+13,216.246,2703.2,22462,724,144,21170,20828,18368,19012,19728
92984,96,491,66392,26592,2.81009e+13,173.261,3764.4,92984,284,195,79445,65258,33353,23435,47590
31676,414,944,22688,8988,2.61007e+13,217.573,3219.11,31676,800,174,30466,29882,26152,24546,27149
93083,35,343,66483,26600,2.80136e+13,173.177,3573.84,93083,286,175,65948,52504,17860,13327,21987
65948,212,294,47105,18843,2.80133e+13,172.828,2985.94,65948,237,175,65654,65654,60830,63281,65572
40359,13,247,28829,11530,2.79965e+13,172.037,2315.03,40359,190,175,20649,13938,6059,4972,3302
34492,220,236,24638,9854,2.79866e+13,171.621,2134.45,34492,179,166,34256,34256,33876,34041,34240
38645,633,800,27648,10997,2.70195e+13,185.731,2996.28,38645,508,171,37845,37825,33230,31057,14504
23117,210,216,16515,6602,2.80112e+13,170.63,1738.84,23117,159,145,22901,22901,22849,22867,22895
30084,8,228,21484,8600,2.79781e+13,171.307,1989.46,30084,171,158,12506,5706,3485,2882,1422
85094,256,328,60778,24316,2.80095e+13,173.037,3409.52,85094,270,175,84766,84766,80572,82701,84694
64493,19,800,46152,18341,2.69337e+13,215.77,3925.57,64493,798,175,38026,27468,10788,6289,8712
70475,410,445,50324,20151,2.81217e+13,173.081,3275.94,70475,243,192,70030,70030,68524,69270,69995
31014,167,230,22156,8858,2.79972e+13,171.407,2021.18,31014,173,160,30352,23903,27310,29079,29594
87525,303,333,62514,25011,2.8023e+13,173.056,3460.61,87525,275,175,87192,87192,85887,86527,87162
64623,663,800,46249,18374,2.69165e+13,217.664,3928.06,64623,778,180,63822,63629,61362,62498,63413
90509,280,338,64652,25857,2.80169e+13,173.153,3521.64,90509,281,175,90171,90171,86964,88582,90113
69060,240,299,49331,19729,2.80109e+13,172.871,3057.78,69060,242,175,68761,68761,65465,67129,68702
2866,178,180,2049,817,2.8002e+13,147.61,603.756,2866,93,85,2686,2686,2684,2684,2684
11503,136,343,8195,3308,2.86412e+13,168.42,1395.34,11503,141,125,10453,8644,7145,6928,8468
7313,111,800,5313,2000,1.8464e+13,266.449,1894.01,7313,719,100,5533,4726,2714,2291,3076
37668,164,242,26904,10764,2.80229e+13,171.933,2234.02,37668,185,172,36697,28832,32999,31561,35057
45756,148,257,32684,13072,2.80206e+13,172.299,2470.3,45756,200,175,43312,34624,34927,36329,39093
75380,116,311,53839,21541,2.80178e+13,172.978,3201.06,75380,254,175,67104,55847,39854,45243,52077
91528,86,339,65371,26157,2.80112e+13,173.092,3541.18,91528,282,175,76570,63870,33826,44049,49081
61580,236,431,43962,17618,2.81413e+13,172.883,3068.55,61580,227,194,61149,61027,43159,31095,55437
49323,201,263,35229,14094,2.8001e+13,172.342,2567.3,49323,206,175,49060,49060,45559,47329,48998
17742,75,206,12673,5069,2.79742e+13,169.52,1518.64,17742,149,136,14442,11949,5916,5628,8012
17989,260,800,12938,5051,2.41304e+13,218.107,2513.01,17989,753,132,16802,16363,14607,15153,15569
67237,73,800,48114,19123,2.69632e+13,218.757,3987.64,67237,798,175,53931,44406,20908,21455,29459
37963,73,242,27113,10850,2.80092e+13,171.789,2242.24,37963,185,172,30839,25323,12127,17176,17641
87778,318,333,62693,25085,2.8016e+13,173.128,3465.59,87778,276,175,87445,87445,87136,87270,87430
35681,68,239,25480,10201,2.80367e+13,171.833,2173.23,35681,182,168,28653,23658,10446,8359,15050
31060,65,231,22179,8881,2.80464e+13,171.437,2023.84,31060,173,160,24764,20484,8624,10022,13038
41791,52,249,29857,11934,2.79838e+13,172.105,2356.42,41791,193,175,32143,26049,10153,7943,13788
28532,75,226,20377,8155,2.80295e+13,171.247,1937.07,28532,169,155,23257,19218,9439,7064,13117
89391,77,335,63848,25543,2.80067e+13,173.062,3497.57,89391,278,175,73332,61089,30116,41400,43527
71816,16,800,51386,20430,2.70281e+13,242.071,4088.17,71816,673,175,39730,28299,11635,7656,9564
85412,122,328,61005,24407,2.80124e+13,173.028,3415.47,85412,271,175,76976,63757,49570,52541,61476
20610,117,211,14723,5887,2.79753e+13,170.123,1638.86,20610,154,141,18333,15245,11220,10478,14116
55989,21,275,39999,15990,2.79968e+13,172.639,2741.83,55989,219,175,34510,24597,9517,5672,6199
93248,100,487,66580,26668,2.80893e+13,173.278,3765.48,93248,284,192,80331,67782,37492,32265,51838
52530,242,269,37521,15009,2.79989e+13,172.496,2652.86,52530,212,175,52261,52261,51172,51699,52234
85907,99,329,61361,24546,2.80017e+13,173.042,3425.87,85907,272,175,73876,62268,37327,35190,51217
67239,279,295,48025,19214,2.80094e+13,172.767,3014.8,67239,238,175,66944,66944,66564,66729,66928
54116,223,272,38651,15465,2.80161e+13,172.499,2693.98,54116,215,175,53844,53844,51222,52540,53795
57914,76,279,41364,16550,2.80144e+13,172.611,2790.63,57914,222,175,47387,39357,19296,19625,27106
47356,9,259,33827,13529,2.80016e+13,172.311,2513.63,47356,202,175,20711,10015,5908,3852,2134
74986,40,310,53554,21432,2.80204e+13,172.891,3191.9,74986,252,175,55023,43126,15615,14816,20816
57050,220,277,40754,16296,2.79993e+13,172.561,2768.39,57050,220,175,56773,56773,53613,55207,56716
40812,186,248,29149,11663,2.80272e+13,172.1,2328.61,40812,191,175,40564,40564,37083,38843,40502
26880,71,223,19206,7674,2.79868e+13,171.157,1878.85,26880,166,153,21698,17859,8262,8233,12052
12214,75,196,8726,3488,2.80006e+13,167.594,1255.43,12214,138,125,9918,8216,4044,3055,5578
70632,203,302,50448,20184,2.80134e+13,172.862,3093.85,70632,245,175,70330,70330,64313,67378,70231
48813,255,262,34866,13947,2.80167e+13,172.351,2553.82,48813,205,175,48551,48551,48480,48507,48544
24582,72,219,17552,7030,2.80602e+13,170.699,1794.76,24582,161,148,19900,16388,7702,8363,11134
41836,229,250,29887,11949,2.80278e+13,172.166,2358.82,41836,193,175,41586,41586,40895,41218,41565
94954,470,800,67919,27035,2.72644e+13,261.867,4554.7,94954,794,175,93827,93586,81795,87805,93129
28065,40,225,20050,8015,2.7984e+13,171.185,1920.38,28065,168,155,20572,16123,5855,4887,7537
11567,3,195,8262,3305,2.80089e+13,167.387,1221.47,11567,135,124,2423,545,506,627,172
10045,79,193,7173,2872,2.8132e+13,165.716,1137.25,10045,129,120,8220,6890,3465,4703,4970
86507,13,330,61790,24717,2.80061e+13,173.057,3438.42,86507,273,175,44264,29880,12992,9866,6834
62472,255,287,44620,17852,2.80011e+13,172.754,2902.45,62472,230,175,62185,62185,60759,61460,62153
57710,319,418,41195,16515,2.81548e+13,172.801,2965.74,57710,223,192,57292,57292,54100,52291,55814
92168,241,489,65812,26356,2.81129e+13,173.265,3746.4,92168,298,184,91679,91558,82246,80376,89000
16579,102,203,11844,4735,2.79831e+13,169.116,1466.01,16579,147,134,14261,12085,7521,8908,10269
83467,301,325,59626,23841,2.80089e+13,173.074,3375.25,83467,268,175,83142,83142,82247,82675,83118
29276,18,227,20911,8365,2.80145e+13,171.279,1962.54,29276,170,157,16987,12069,4933,2866,3833
30000,544,800,21513,8487,2.59444e+13,201.747,2918.28,30000,568,154,29200,28996,28937,28621,28674
59305,4,281,42363,16942,2.79983e+13,172.627,2824.53,59305,224,175,15551,4717,3432,4182,1521
77685,313,315,55485,22200,2.80202e+13,172.981,3251.66,77685,258,175,77370,77370,77366,77366,77368
38561,103,244,27543,11018,2.79946e+13,171.979,2261.39,38561,187,174,33378,28273,17463,16298,23790
69255,48,299,49467,19788,2.80011e+13,172.842,3061.85,69255,242,175,52558,42317,16060,13774,21202
88180,92,334,62991,25189,2.80048e+13,173.148,3474.11,88180,277,175,74704,61516,34623,33677,49691
66881,501,800,47859,19022,2.69657e+13,216.135,3979.38,66881,798,175,65874,65564,59988,62808,65184
16526,63,204,11802,4724,2.80133e+13,169.157,1464.63,16526,147,133,13092,10833,4540,3713,6511
99909,92,355,71367,28542,2.80093e+13,173.235,3708.72,99909,298,175,84676,69705,39212,32925,55247
14072,118,200,10046,4026,2.80759e+13,168.201,1349.79,14072,142,129,12504,10401,7737,8512,9830
50685,193,266,36205,14480,2.80292e+13,172.456,2604.56,50685,209,175,50419,50419,46192,48335,50346
13458,433,800,9704,3754,2.28388e+13,228.539,2290.34,13458,735,123,12451,11840,10989,11578,11557
16884,137,205,12057,4827,2.80531e+13,169.053,1480.87,16884,147,134,15577,12697,11497,12155,13329
21533,84,213,15382,6151,2.79989e+13,170.257,1676.76,21533,156,143,17876,14976,7698,10284,11133
27307,336,800,19597,7710,2.54507e+13,218.443,2886.52,27307,689,151,26209,25664,24982,25131,25117
10751,158,193,7683,3068,2.79081e+13,166.386,1175.76,10751,132,122,10269,8184,9305,9510,9622
90429,308,338,64587,25842,2.80168e+13,173.128,3520.05,90429,281,175,90091,90091,88773,89420,90061
87271,94,332,62334,24937,2.80094e+13,173.056,3454.92,87271,274,175,74256,61059,35256,43889,50206
36882,76,800,26440,10442,2.60967e+13,217.313,3202.85,36882,729,170,29408,24588,11751,8321,15382
42391,77,251,30281,12110,2.79963e+13,172.189,2374.76,42391,194,175,34728,28948,14271,14447,20334
17974,196,341,12847,5127,2.76051e+13,167.048,1688.84,17974,205,136,17633,17633,15449,15066,7356
11466,99,195,8190,3276,2.80346e+13,167.118,1215.93,11466,135,124,9782,8283,5009,4826,6831
55287,3,274,39491,15796,2.80059e+13,172.606,2724.16,55287,217,175,11594,2599,2398,2998,947
38839,198,245,27737,11102,2.803e+13,171.938,2270.34,38839,187,174,38594,38594,36148,37374,38547
58487,60,280,41781,16706,2.80119e+13,172.66,2805.03,58487,223,175,46113,37628,15685,13875,22005
59588,313,444,42577,17011,2.78582e+13,171.81,3030.35,59588,225,175,59144,59144,59085,59052,59018
65626,285,293,46877,18749,2.80091e+13,172.824,2978.03,65626,236,175,65333,65333,65256,65285,65325
72212,787,800,51670,20542,2.70359e+13,215.808,4097.03,72212,798,180,71412,71231,69815,70478,71374
74256,220,309,53036,21220,2.80305e+13,172.899,3176.14,74256,251,175,73947,73947,68632,71335,73858
82412,653,800,58957,23455,2.71613e+13,234.096,4310.43,82412,771,180,81608,81424,79650,80537,81172
30382,102,229,21708,8674,2.7991e+13,171.473,2000.29,30382,172,159,26218,22159,13711,15122,18667
7650,157,187,5473,2177,2.78836e+13,163.711,989.352,7650,121,111,7248,5780,6581,6820,6754
78250,232,316,55894,22356,2.8014e+13,173.017,3263.95,78250,259,175,77934,77934,72972,75493,77850
76328,109,312,54523,21805,2.80037e+13,172.97,3221.34,76328,256,175,66991,56145,37577,43202,49917
16017,197,203,11439,4578,2.80156e+13,169.059,1441.46,16017,146,132,15814,15814,15762,15780,15808
11450,276,339,8160,3290,2.86632e+13,168.451,1389.02,11450,146,136,11111,10991,9890,9805,10812
24542,21,219,17530,7012,2.80657e+13,170.763,1793.28,24542,162,148,15118,10787,4192,2722,3829
57998,240,279,41429,16569,2.80102e+13,172.694,2792.84,57998,222,175,57719,57719,55789,56751,57680
1366,155,176,977,389,2.75191e+13,115.634,412.783,1366,67,63,1171,998,1064,1079,1092
27919,198,224,19948,7971,2.7964e+13,171.214,1914.8,27919,167,154,27695,27695,26630,27148,27669
47683,98,260,34060,13623,2.79956e+13,172.362,2523.1,47683,203,175,40888,34542,20616,19439,28559
39207,153,387,27992,11215,2.8194e+13,172.268,2463.09,39207,203,179,37338,29688,27350,25532,32541
20686,65,211,14781,5905,2.79541e+13,170.281,1642.36,20686,155,141,16465,13628,5923,6478,8544
98435,107,499,70286,28149,2.8101e+13,173.324,3869.92,98435,309,177,86029,72254,46222,42716,62469
10868,140,194,7764,3104,2.80355e+13,166.937,1183.88,10868,133,123,10044,8147,7759,7872,8801
65698,25,293,46925,18773,2.80106e+13,172.782,2979.43,65698,236,175,42866,31237,11180,7740,11742
77526,30,314,55372,22154,2.8005e+13,172.972,3247.45,77526,257,175,52834,39949,13355,12075,18282
26128,204,222,18659,7469,2.8038e+13,171.059,1851.92,26128,165,151,25906,25906,25432,25643,25888
81672,64,465,58321,23351,2.81021e+13,173.217,3524.92,81672,264,193,65054,53955,20859,14043,28955
8678,68,189,6205,2473,2.77929e+13,164.974,1054.7,8678,125,115,6913,5738,2584,2593,3634
75492,16,311,53924,21568,2.80004e+13,173.011,3203.51,75492,254,175,41896,29475,12423,8324,10394
90373,159,337,64556,25817,2.79999e+13,173.164,3518.14,90373,281,175,87458,69075,78998,84680,82542
35131,150,238,25090,10041,2.80388e+13,171.762,2155.91,35131,181,167,33343,26572,27250,29639,30382
7175,102,187,5126,2049,2.79832e+13,162.95,958.374,7175,120,109,6124,5214,3244,3859,4438
40891,98,248,29207,11684,2.80076e+13,172.062,2330.83,40891,191,175,35050,29624,17691,21158,24524
99942,375,800,71480,28462,2.72984e+13,231.541,4647.49,99942,798,180,98831,98168,94087,96015,97839
80911,312,320,57788,23123,2.80115e+13,172.993,3320.53,80911,263,175,80591,80591,80499,80536,80583
9352,34,191,6680,2672,2.79275e+13,165.668,1096.16,9352,127,117,6550,5247,1771,1584,2487
90726,274,338,64798,25928,2.80105e+13,173.132,3525.52,90726,281,175,90388,90388,86786,88607,90324
92279,290,800,66010,26269,2.72445e+13,222.859,4504.43,92279,798,180,91053,90518,84200,87118,89819
81093,599,800,58013,23080,2.71552e+13,233.183,4283.47,81093,770,180,80236,79836,78178,79004,79690
31153,147,231,22250,8903,2.8026e+13,171.526,2026.75,31153,174,160,29382,23556,23656,25932,26435
73317,273,307,52372,20945,2.80053e+13,172.971,3154.92,73317,250,175,73010,73010,71451,72221,72976
92274,280,341,65907,26367,2.8009e+13,173.169,3557.24,92274,284,175,91933,91933,88513,90242,91872
46108,7,257,32936,13172,2.7996e+13,172.22,2479.1,46108,200,175,17838,7167,4999,3920,1947
81570,29,321,58263,23307,2.80113e+13,172.972,3334.22,81570,264,175,55156,41592,13895,17421,18695
97381,594,800,69656,27725,2.72775e+13,224.502,4600.21,97381,798,180,96466,96066,90743,93467,95963
91445,96,339,65315,26130,2.7995e+13,173.126,3539.77,91445,282,175,78147,64137,38074,38428,52737
95865,165,347,68475,27390,2.80026e+13,173.139,3628.22,95865,290,175,93808,73636,83986,85788,90917
46512,99,258,33225,13287,2.80011e+13,172.324,2490.93,46512,201,175,39967,33697,20206,19461,27551
1019,142,176,726,293,2.81874e+13,96.632,356.428,1019,57,58,827,729,701,744,757
54314,728,800,38884,15430,2.67111e+13,210.55,3682.2,54314,795,175,53514,53322,50060,51700,53299
87933,297,333,62808,25125,2.80083e+13,173.095,3468.35,87933,276,175,87600,87600,85905,86745,87564
77939,219,315,55670,22269,2.80102e+13,172.992,3256.54,77939,258,175,77624,77624,71811,74771,77528
40689,219,248,29062,11627,2.8029e+13,172.071,2325.18,40689,191,175,40441,40441,39191,39803,40412
57712,208,278,41230,16482,2.7988e+13,172.697,2785.31,57712,222,175,57434,57434,53372,55432,57364
35367,157,238,25259,10108,2.80148e+13,171.76,2162.76,35367,181,168,34013,26880,30843,31538,31826
21094,160,212,15064,6030,2.79676e+13,170.302,1658.93,21094,155,142,20342,16092,18362,17605,19183
72199,95,305,51566,20633,2.80198e+13,172.848,3129.6,72199,247,175,61561,50637,29828,36830,42048
46455,101,258,33182,13273,2.80052e+13,172.27,2489.4,46455,201,175,40081,33819,20843,19405,28233
30545,162,229,21816,8729,2.79892e+13,171.451,2005.43,30545,172,159,29625,23375,26686,25555,28179
12110,130,196,8651,3459,2.80087e+13,167.559,1250.09,12110,137,125,10990,9091,7602,6846,9232
73129,90,306,52244,20885,2.79907e+13,172.967,3150.16,73129,250,175,61679,51013,28521,23710,39667
67434,293,296,48167,19267,2.80098e+13,172.837,3020.2,67434,239,175,67138,67138,67126,67128,67135
39911,76,246,28508,11403,2.80003e+13,172.027,2301.61,39911,189,175,32633,27108,13287,13539,19238
18662,125,207,13334,5328,2.79077e+13,169.848,1557.72,18662,151,138,16826,13997,11377,9819,13620
51604,42,267,36856,14748,2.79911e+13,172.455,2628.04,51604,210,175,38225,30226,11098,12511,14471
30898,72,230,22074,8824,2.80067e+13,171.485,2017.71,30898,173,159,25028,20592,9620,8655,13921
90749,137,338,64820,25929,2.80142e+13,173.104,3525.92,90749,281,175,84219,68391,61860,65448,72143
89767,170,336,64121,25646,2.79976e+13,173.114,3505.7,89767,279,175,88631,69589,78884,84289,87148
51799,93,800,37081,14718,2.68039e+13,219.377,3550.38,51799,560,175,43347,35792,20098,20499,27872
53352,3,271,38102,15250,2.80215e+13,172.478,2674.7,53352,213,175,11193,2515,2319,2894,797
98633,129,353,70451,28182,2.8009e+13,173.232,3683.98,98633,296,175,90138,74328,61702,61876,74875
24431,194,359,17430,7001,2.83543e+13,171.052,1964.98,24431,175,164,24070,23939,19489,16751,22112
31013,104,230,22153,8860,2.80118e+13,171.45,2021.3,31013,173,159,26914,22736,14315,12162,19065
46957,28,259,33543,13414,2.80056e+13,172.3,2503.35,46957,202,175,31483,23602,7991,8324,7304
6778,184,186,4835,1943,2.81062e+13,162.217,931.121,6778,117,108,6592,6592,6588,6588,6590
32809,79,233,23430,9379,2.80234e+13,171.52,2080.48,32809,176,163,26999,22524,11146,15324,16338
91787,17,340,65567,26220,2.80057e+13,173.153,3547.16,91787,283,175,52107,37008,15434,11950,10235
33251,144,234,23755,9496,2.79896e+13,171.671,2095.05,33251,177,164,31210,25092,24647,24366,27216
69995,154,301,50001,19994,2.80189e+13,172.917,3079.79,69995,244,175,67069,52984,59009,61399,62120
67940,222,446,48508,19432,2.8114e+13,173.038,3224.13,67940,239,196,67494,67371,51196,36994,60326
2386,62,178,1706,680,2.7617e+13,141.06,548.514,2386,85,79,1836,1530,688,711,918
77796,42,800,55654,22142,2.71205e+13,230.467,4215.65,77796,798,175,57081,45343,16503,13372,21447
44503,230,255,31790,12713,2.80091e+13,172.299,2435.29,44503,198,175,44248,44248,43300,43756,44223
98244,151,947,70242,28002,2.73889e+13,226.018,4807.02,98244,800,194,92565,73723,73887,51443,77147
16043,116,203,11460,4583,2.80141e+13,169.067,1442.62,16043,146,133,14202,11861,8521,9629,11056
31163,163,230,22256,8907,2.80171e+13,171.413,2026.14,31163,173,160,30278,23852,27266,29139,29020
53993,264,272,38559,15434,2.80174e+13,172.431,2690.97,53993,214,175,53721,53721,53629,53666,53713
67198,261,296,48000,19198,2.80223e+13,172.836,3015.1,67198,239,175,66902,66902,65265,66073,66867
89099,301,335,63639,25460,2.80068e+13,173.13,3492.29,89099,278,175,88764,88764,87166,87956,88730
41079,38,248,29347,11732,2.79856e+13,172.092,2335.85,41079,191,175,29755,23314,8316,9435,10542
45686,768,947,32696,12990,2.66704e+13,212.915,3643.92,45686,765,179,44739,44579,43044,43751,44202
34645,64,237,24750,9895,2.79971e+13,171.759,2140.15,34645,180,167,27559,22840,9541,8537,13783
66328,183,294,47375,18953,2.8012e+13,172.783,2994.18,66328,237,175,66034,66034,59188,62682,65923
43209,15,252,30870,12339,2.7991e+13,172.236,2398.07,43209,195,175,23424,16160,6796,5708,4329
6620,173,186,4726,1894,2.80109e+13,161.992,920.183,6620,116,108,6414,5149,6214,6311,6346
90103,485,800,64447,25656,2.72462e+13,229.978,4462.38,90103,789,180,89113,88743,85448,87088,88358
57235,590,800,40972,16263,2.67821e+13,211.067,3754.15,57235,793,175,56346,55946,52661,54330,55805
72102,220,304,51502,20600,2.79988e+13,172.926,3126.79,72102,247,175,71798,71798,66788,69337,71714
59381,16,282,42421,16960,2.80028e+13,172.744,2827.7,59381,225,175,32953,23187,9770,7944,6200
41040,471,800,29398,11642,2.63175e+13,212.227,3325.78,41040,755,173,40063,39770,38159,38944,39253
6606,96,186,4720,1886,2.80277e+13,161.978,918.891,6606,116,107,5562,4600,2768,2639,3800
47984,216,946,34337,13647,2.67283e+13,210.293,3705.71,47984,812,189,46572,46036,37325,32070,41882
84871,208,328,60625,24246,2.80068e+13,173.103,3405.31,84871,271,175,84543,84543,77136,80916,84423
20822,102,211,14872,5950,2.79338e+13,170.214,1647.39,20822,154,141,17947,15181,9407,9344,12789
42684,78,251,30491,12193,2.8002e+13,172.164,2382.68,42684,195,175,35049,29232,14304,11235,20324
92703,278,342,66215,26488,2.80115e+13,173.179,3566.17,92703,285,175,92361,92361,88739,90572,92297
70313,187,302,50225,20088,2.80103e+13,172.912,3087.43,70313,245,175,70011,70011,62947,66549,69896
57337,272,277,40953,16384,2.79844e+13,172.602,2775.28,57337,220,175,57060,57060,57024,57035,57055
34004,132,236,24291,9713,2.80032e+13,171.794,2120.14,34004,179,165,31188,25593,21732,21742,26058
95832,325,347,68452,27380,2.80064e+13,173.176,3627.8,95832,290,175,95485,95485,94711,95078,95463
47681,427,944,34120,13561,2.67299e+13,213.374,3695.83,47681,805,189,46473,45859,41447,36122,40775
51201,242,266,36573,14628,2.80025e+13,172.403,2617.05,51201,209,175,50935,50935,50013,50456,50911
62429,258,287,44588,17841,2.80136e+13,172.683,2901.43,62429,229,175,62142,62142,60872,61496,62113
86535,599,800,61903,24632,2.72014e+13,220.515,4392.56,86535,798,180,85631,85231,80374,82846,85132
50353,75,265,35965,14388,2.80099e+13,172.441,2595.24,50353,208,175,41093,33937,16665,16884,23697
39284,171,245,28064,11220,2.801e+13,171.98,2282.92,39284,188,175,38763,30426,34774,35289,38119
8403,285,332,5980,2423,2.89532e+13,166.195,1206.61,8403,131,115,8071,7951,7866,7847,7979
87669,201,333,62624,25045,2.80171e+13,173.136,3463.54,87669,276,175,87336,87336,79097,83305,87204
72254,191,305,51609,20645,2.80179e+13,172.911,3130.8,72254,248,175,71949,71949,64919,68505,71835
74715,305,309,53369,21346,2.80052e+13,172.935,3185.44,74715,252,175,74406,74406,74383,74389,74402
61741,110,285,44106,17635,2.79768e+13,172.735,2884.14,61741,229,175,54276,45518,31154,29733,39969
49091,189,262,35066,14025,2.79727e+13,172.377,2560.71,49091,206,175,48829,48829,44558,46725,48756
62590,502,800,44795,17795,2.69045e+13,223.016,3881.59,62590,763,180,61640,61280,59571,60404,60896
75705,43,800,54167,21538,2.70717e+13,218.954,4171.65,75705,794,180,55790,44377,16452,14819,21088
21025,42,212,15018,6007,2.80191e+13,170.282,1656.32,21025,155,141,15550,12312,4524,3327,5648
46090,228,257,32917,13173,2.79917e+13,172.253,2478.72,46090,200,175,45833,45833,44576,45191,45804
14291,174,200,10206,4085,2.80002e+13,168.629,1360.43,14291,143,129,14067,11285,13048,13552,13985
73948,322,453,52798,21150,2.81166e+13,173.035,3356.55,73948,249,192,73495,73482,69520,65216,70716
63272,18,289,45185,18087,2.80298e+13,172.745,2922.22,63272,231,175,36716,26093,10651,5277,6226
55291,272,274,39494,15797,2.80039e+13,172.579,2724.2,55291,217,175,55017,55017,55013,55013,55015
37294,179,241,26640,10654,2.80095e+13,171.858,2222.06,37294,184,171,37053,37053,33552,35322,36991
12241,188,196,8747,3494,2.79733e+13,167.58,1256.76,12241,139,126,12045,12045,11951,11989,12037
21638,66,213,15458,6180,2.79931e+13,170.371,1680.68,21638,157,143,17268,14301,6212,4959,8779
57848,165,278,41318,16530,2.79976e+13,172.636,2788.19,57848,221,175,56548,44414,50710,48487,54507
49044,104,263,35031,14013,2.80225e+13,172.432,2560.56,49044,206,175,42603,35969,22612,21237,30393
94359,773,800,67492,26867,2.72633e+13,223.877,4543.49,94359,798,180,93559,93335,87244,90416,93479
68390,283,298,48849,19541,2.80177e+13,172.864,3042.64,68390,241,175,68092,68092,67793,67920,68077
40634,210,247,29020,11614,2.8015e+13,171.955,2322.45,40634,190,175,40387,40387,38586,39481,40350
21354,188,213,15253,6101,2.8016e+13,170.421,1670.06,21354,156,143,21141,21141,20191,20647,21116
4634,155,182,3315,1319,2.78313e+13,157.394,767.969,4634,107,99,4319,3481,3845,4067,4024
82518,342,800,59030,23488,2.7164e+13,219.061,4312.33,82518,798,180,81358,80775,75497,78002,80298
10546,151,193,7533,3013,2.80235e+13,166.656,1165.16,10546,132,121,9939,7945,8262,8847,9174
77772,12,463,55523,22249,2.81064e+13,173.113,3444.76,77772,268,192,38350,24309,11569,6304,4903
48988,161,263,34986,14002,2.8023e+13,172.474,2559.37,48988,206,175,47507,37416,42794,45837,45140
24752,149,364,17656,7096,2.84075e+13,171.341,1982.9,24752,177,166,23299,18724,13928,11669,18765
14564,197,200,10406,4158,2.79975e+13,168.642,1372.76,14564,143,130,14364,14364,14352,14354,14361
13262,62,198,9478,3784,2.79962e+13,168.106,1309.3,13262,141,128,10465,8589,3642,5683,5326
22543,57,215,16100,6443,2.80373e+13,170.607,1716.8,22543,158,145,17591,14409,5740,6704,8454
75485,191,310,53912,21573,2.79937e+13,172.918,3202.06,75485,253,175,75175,75175,67793,71561,75056
58329,540,800,41751,16578,2.68133e+13,230.839,3780.59,58329,796,175,57341,57027,50198,53670,56749
95819,84,348,68444,27375,2.80072e+13,173.22,3628.69,95819,291,175,79801,66676,33983,27409,48577
97426,477,493,69565,27861,2.80972e+13,173.309,3846.78,97426,292,194,96933,96933,96637,96775,96917
92404,313,341,66007,26397,2.80061e+13,173.142,3559.4,92404,284,175,92063,92063,90881,91458,92035
2266,53,178,1617,649,2.80227e+13,139.713,535.18,2266,83,79,1700,1423,586,572,800
4218,76,181,3015,1203,2.7973e+13,155.008,731.556,4218,102,95,3394,2848,1426,1950,2012
58626,428,429,41850,16776,2.81375e+13,172.868,2999.26,58626,221,195,58197,58197,58197,58197,58196
16855,69,205,12033,4822,2.80764e+13,169.164,1479.72,16855,147,134,13538,11171,5062,5920,7513
61385,23,435,43821,17564,2.81619e+13,172.94,3068.3,61385,227,195,38931,28407,10495,5998,10830
34968,134,237,24978,9990,2.80003e+13,171.769,2149.99,34968,181,166,32212,26328,23112,23248,27466
10604,111,193,7572,3032,2.81095e+13,166.151,1168.03,10604,131,123,9260,7794,5432,6152,6982
55288,284,800,39587,15701,2.67194e+13,217.843,3706.12,55288,798,175,54065,53595,47795,50478,52882
59206,414,422,42278,16928,2.81425e+13,172.879,3005.12,59206,223,192,58784,58784,58709,58739,58776
61939,62,800,44329,17610,2.68941e+13,229.57,3866.54,61939,741,180,48430,39811,16468,13588,23122
41938,7,250,29957,11981,2.79697e+13,172.15,2361.54,41938,193,175,16218,6509,4547,3258,2340
96767,312,349,69119,27648,2.80064e+13,173.17,3646.64,96767,292,175,96418,96418,94635,95520,96381
21306,35,212,15223,6083,2.79601e+13,170.372,1667.06,21306,156,143,15074,12001,4198,3264,5193
73055,64,306,52182,20873,2.7996e+13,172.921,3148.5,73055,249,175,58201,48197,20067,21180,28925
79562,237,944,56900,22662,2.72334e+13,218.611,4439.95,79562,800,192,78141,77561,61635,35999,69736
18341,135,207,13098,5243,2.80739e+13,169.518,1544.27,18341,150,137,16858,13792,12248,12973,14304
46283,149,258,33068,13215,2.79814e+13,172.328,2484.92,46283,201,175,43893,35024,35677,37077,39931
74560,307,452,53229,21331,2.81332e+13,173.092,3369.42,74560,266,177,74108,74095,73171,71645,72762
70866,741,950,50683,20183,2.7132e+13,229.257,4260.56,70866,762,197,69916,69759,68385,68810,69289
18989,120,208,13565,5424,2.79758e+13,169.915,1572.02,18989,151,138,16981,14074,10596,9264,13334
75907,353,461,54191,21716,2.81181e+13,173.131,3405.27,75907,269,177,75446,75446,74389,73165,74547
31913,71,231,22797,9116,2.79453e+13,171.542,2050.71,31913,175,162,25781,21217,9804,9778,13873
75959,266,311,54257,21702,2.79988e+13,172.955,3212.79,75959,254,175,75648,75648,73297,74476,75603
92470,384,482,66030,26440,2.81049e+13,173.298,3745.41,92470,283,193,91988,91988,86218,89157,91890
73793,139,800,52798,20995,2.70596e+13,217.513,4131.18,73793,796,180,67798,54926,51097,48712,57448
27321,146,224,19520,7801,2.8004e+13,171.254,1894.84,27321,167,153,25705,20649,20590,22678,23080
51879,44,268,37052,14827,2.80165e+13,172.536,2636.2,51879,211,175,38792,30660,11712,10615,15125
59790,53,282,42706,17084,2.80043e+13,172.679,2836.94,59790,225,175,46172,37935,14602,13976,20267
39680,81,246,28347,11333,2.79752e+13,172.06,2295.2,39680,189,175,32780,27604,13905,12948,19135
37841,178,242,27033,10808,2.79915e+13,171.922,2238.99,37841,185,172,37599,37599,33949,35798,37535
47527,81,260,33943,13584,2.80045e+13,172.365,2519.05,47527,203,175,39302,33054,16596,14158,23646
64489,252,290,46065,18424,2.79833e+13,172.785,2950.15,64489,233,175,64199,64199,62317,63256,64161
76221,11,311,54447,21774,2.79912e+13,172.976,3218.18,76221,255,175,36239,22318,11162,6891,5733
4996,84,183,3569,1427,2.79568e+13,158.318,797.667,4996,107,102,4093,3445,1794,1816,2474
90377,113,337,64559,25818,2.79955e+13,173.129,3518.08,90377,280,175,79994,66971,47072,42535,60444
1654,30,177,1181,473,2.80916e+13,127.07,456.977,1654,73,73,1101,848,317,237,347
14250,192,200,10180,4070,2.80412e+13,168.44,1357.99,14250,143,129,14050,14050,13958,13995,14042
28626,73,226,20450,8176,2.80062e+13,171.258,1940.19,28626,169,156,23227,19076,9161,8117,13182
16850,47,205,12037,4813,2.80929e+13,169.4,1479.65,16850,148,134,12704,10195,3882,2895,4964
63215,91,288,45155,18060,2.79927e+13,172.754,2920,63215,231,175,53428,44097,24763,24074,34962
4298,92,182,3075,1223,2.78775e+13,155.815,738.806,4298,103,96,3555,2977,1713,1805,2368
22149,12,214,15819,6330,2.80212e+13,170.404,1701.02,22149,157,144,10934,6932,3292,2499,1640
65175,287,292,46553,18622,2.8015e+13,172.726,2966.91,65175,235,175,64883,64883,64847,64858,64878
62917,133,288,44936,17981,2.80112e+13,172.738,2913.28,62917,231,175,57925,47405,40732,42997,49088
6359,179,186,4549,1810,2.79424e+13,162.278,902.363,6359,116,106,6173,6173,6117,6137,6166
82831,257,324,59164,23667,2.80098e+13,173.034,3361.86,82831,267,175,82507,82507,78662,80609,82440
87332,147,332,62385,24947,2.79995e+13,173.124,3456.07,87332,275,175,82611,66121,66427,69259,73936
26888,116,222,19206,7682,2.79524e+13,171.04,1878,26888,165,152,23878,19903,14201,13615,18423
64087,93,432,45761,18326,2.81214e+13,172.984,3126.69,64087,232,192,54361,44868,22163,16648,32811
53176,281,800,38073,15103,2.67082e+13,211.308,3653.77,53176,798,175,51969,51486,47016,48992,50779
40905,242,248,29217,11688,2.80049e+13,172.056,2331.13,40905,191,175,40657,40657,40611,40623,40651
80047,156,319,57171,22876,2.80148e+13,172.995,3302.34,80047,262,175,77011,60899,68221,72393,71841
23515,174,216,16803,6712,2.79621e+13,170.664,1753.4,23515,160,147,23259,18599,21143,22222,23147
62071,145,287,44332,17739,2.80368e+13,172.667,2893.34,62071,229,175,58454,46877,46530,51545,51751
2862,76,179,2044,818,2.83374e+13,146.14,602.075,2862,91,87,2287,1927,978,1330,1368
74899,182,310,53494,21405,2.80248e+13,172.949,3190.28,74899,253,175,74589,74589,66619,70689,74461
30694,29,230,21926,8768,2.80368e+13,171.494,2011.43,30694,173,159,20735,15650,5243,3788,5776
8218,117,189,5866,2352,2.80639e+13,164.073,1026.41,8218,123,113,7240,6064,4501,4958,5706
82818,179,323,59160,23658,2.79921e+13,173.061,3360.74,82818,267,175,82495,82495,73403,78052,82351
50291,109,265,35925,14366,2.79996e+13,172.45,2593.78,50291,208,175,44138,36976,24739,23129,32475
68955,294,299,49259,19696,2.80148e+13,172.909,3055.82,68955,242,175,68656,68656,68620,68631,68651
3039,34,179,2173,866,2.7705e+13,147.351,619.326,3039,92,85,2117,1704,600,437,715
84389,230,327,60274,24115,2.80166e+13,173.076,3395.01,84389,270,175,84062,84062,78188,81180,83965
91145,48,800,65197,25948,2.7239e+13,237.092,4482.61,91145,777,180,68566,55394,20806,15256,26881
9770,34,192,6978,2792,2.8059e+13,166.141,1121.22,9770,129,119,6839,5475,1856,1352,2154
56657,165,276,40475,16182,2.79922e+13,172.686,2758.69,56657,220,175,55371,43487,49665,53102,53226
59676,219,282,42631,17045,2.80153e+13,172.661,2834.21,59676,225,175,59394,59394,55847,57640,59331
83600,72,325,59718,23882,2.80048e+13,173.082,3377.91,83600,269,175,67806,55761,26018,20893,36980
8726,77,190,6227,2499,2.80598e+13,164.969,1058.36,8726,125,115,7094,5937,2948,2568,4074
94796,276,345,67715,27081,2.79975e+13,173.183,3607.17,94796,289,175,94451,94451,90460,92484,94382
26024,81,221,18590,7434,2.80039e+13,170.986,1847.44,26024,164,151,21490,18094,9122,9839,13234
21020,21,212,15014,6006,2.7999e+13,170.158,1656.11,21020,155,142,12952,9230,3579,2218,3153
2792,95,179,1992,800,2.80386e+13,145.958,594.404,2792,90,85,2297,1924,1167,1139,1513
30326,104,228,21669,8657,2.79731e+13,171.388,1997.63,30326,172,159,26283,22234,14029,16447,18948
38192,35,243,27282,10910,2.80034e+13,171.931,2249.92,38192,186,173,27044,21539,7530,5867,9407
17749,123,206,12676,5073,2.79711e+13,169.559,1518.94,17749,149,136,15952,13247,10621,9307,12676
23540,92,216,16821,6719,2.79682e+13,170.67,1754.28,23540,160,147,19878,16408,9274,9034,13119
17358,202,205,12400,4958,2.79927e+13,169.367,1501.05,17358,148,135,17153,17153,17141,17143,17150
56441,53,800,40405,16036,2.67847e+13,211.246,3735.12,56441,791,175,42936,35457,13474,9792,17814
90984,241,338,64991,25993,2.80038e+13,173.124,3530.24,90984,281,175,90646,90646,84761,87758,90549
84018,214,470,59995,24023,2.80916e+13,173.203,3575.04,84018,283,184,83548,83425,72736,70180,80511
17694,145,206,12638,5056,2.80101e+13,169.599,1516.47,17694,149,136,16583,13331,13217,12978,14725
32199,15,232,22999,9200,2.79944e+13,171.45,2060.19,32199,175,162,17462,12051,5061,3506,4296
22151,112,214,15823,6328,2.79932e+13,170.517,1701.18,22151,157,143,19519,16342,11450,10406,14538
52047,20,269,37174,14873,2.8018e+13,172.48,2641.06,52047,211,175,31515,22304,8853,5286,7815
77774,97,315,55554,22220,2.80153e+13,173.012,3253.47,77774,258,175,66585,56357,33464,31403,45396
60957,78,800,43634,17323,2.68514e+13,216.945,3843.25,60957,798,175,49339,41278,19930,20018,28463
6946,145,187,4954,1992,2.8156e+13,161.792,942.29,6946,118,109,6429,5217,5164,5690,5698
54889,118,274,39201,15688,2.80423e+13,172.492,2714.56,54889,216,175,49029,40663,30165,33160,38579
39626,107,245,28301,11325,2.80028e+13,171.916,2292.54,39626,188,175,34603,29066,19166,21882,25250
90567,275,338,64695,25872,2.80005e+13,173.141,3522.47,90567,281,175,90229,90229,86697,88483,90166
41024,145,249,29301,11723,2.80404e+13,171.998,2335.42,41024,191,175,38585,30967,30740,34034,34075
77086,81,313,55056,22030,2.80151e+13,172.926,3237.46,77086,256,175,63788,53649,26953,36408,39576
1667,168,177,1191,476,2.7957e+13,126.367,458.537,1667,74,68,1478,1239,1446,1466,1444
26441,104,222,18886,7555,2.80203e+13,171.091,1862.75,26441,165,151,22929,19372,12183,11465,16341
89034,66,800,63681,25353,2.72128e+13,238.384,4441.31,89034,798,175,70570,58491,25170,25394,35497
22121,44,214,15801,6320,2.80057e+13,170.409,1699.86,22121,157,144,16522,13065,5011,6122,6766
9779,66,192,6986,2793,2.80476e+13,165.844,1121.36,9779,129,119,7773,6453,2812,2270,4024
25387,7,220,18139,7248,2.79856e+13,170.999,1824.3,25387,163,150,9815,3940,2749,2150,882
58499,243,418,41767,16732,2.81529e+13,172.839,2984.79,58499,221,193,58081,57960,38840,29269,53179
44488,98,255,31770,12718,2.80313e+13,172.17,2434.9,44488,197,175,38150,32231,19271,23024,26451
3013,133,180,2155,858,2.7944e+13,148.813,618.826,3013,93,85,2665,2226,1923,1942,2242
57387,144,800,41054,16333,2.72117e+13,220.655,3551.45,57387,418,175,53357,42919,41716,41618,46449
23458,56,217,16749,6709,2.80722e+13,170.51,1752.34,23458,159,146,18261,15014,5956,7138,8553
54699,219,942,39137,15562,2.68885e+13,222.184,3874.41,54699,810,177,53263,52743,44204,43614,50088
51298,160,267,36643,14655,2.80181e+13,172.459,2620.68,51298,210,175,49666,39191,44808,45806,47289
91070,302,339,65053,26017,2.80098e+13,173.165,3533.08,91070,282,175,90731,90731,88943,89832,90694
19747,4,210,14101,5646,2.80358e+13,169.635,1603.72,19747,152,139,5178,1578,1146,1107,375
95822,344,347,68447,27375,2.7999e+13,173.161,3627.52,95822,290,175,95475,95475,95463,95465,95472
2465,51,179,1763,702,2.83884e+13,143.054,559.529,2465,86,83,1837,1508,612,470,703
15039,63,201,10745,4294,2.79744e+13,168.896,1395.96,15039,144,130,11903,9847,4192,4666,6005
86100,213,475,61468,24632,2.81221e+13,173.18,3619.89,86100,286,182,85625,85502,75147,73959,83096
28130,351,800,20189,7941,2.55119e+13,216.028,2916.26,28130,724,154,27043,26485,25604,25892,25983
70996,235,303,50713,20283,2.80027e+13,172.938,3102.77,70996,246,175,70693,70693,66825,68782,70625
40749,166,248,29105,11644,2.80326e+13,172.091,2326.87,40749,191,175,39853,31413,35775,38188,38827
47042,53,259,33596,13446,2.80119e+13,172.286,2505.4,47042,202,175,36321,29844,11526,13964,16877
49761,6,264,35543,14218,2.80092e+13,172.449,2579.55,49761,207,175,17541,6655,4405,2966,1642
76754,150,313,54826,21928,2.80097e+13,173.004,3230.95,76754,256,175,73016,58111,59616,64862,66528
68473,57,731,48934,19539,2.76753e+13,170.647,3566.5,68473,374,175,53320,43702,17188,11567,422
29608,440,941,21211,8397,2.61546e+13,202.38,3102.32,29608,592,170,28667,28098,27787,27327,27327
27397,788,800,19659,7738,2.54545e+13,210.206,2889.7,27397,772,149,26597,26445,25847,26137,26562
1003,78,176,721,282,2.76527e+13,95.1326,353.137,1003,53,59,749,666,392,367,490
48348,209,261,34538,13810,2.79861e+13,172.372,2540.94,48348,204,175,48087,48087,45253,46682,48035
94644,123,495,67576,27068,2.81005e+13,173.325,3798.98,94644,287,196,85400,70823,34807,20303,58729
73970,233,308,52839,21131,2.79884e+13,172.971,3169.37,73970,251,175,73662,73662,69318,71520,73587
75789,111,311,54137,21652,2.80078e+13,172.972,3209.42,75789,254,175,66803,55880,38778,35662,50226
32630,131,233,23306,9324,2.80087e+13,171.578,2074.95,32630,176,162,29872,24566,20658,20828,25095
86823,433,800,62104,24719,2.71971e+13,233.057,4398.06,86823,798,175,85703,85073,76551,81087,84910
96090,190,348,68639,27451,2.80074e+13,173.175,3633.44,96090,291,175,95742,95742,85747,90859,95584
11706,50,195,8364,3342,2.79649e+13,167.394,1228.71,11706,136,124,8906,7220,2800,2667,3747
93641,85,343,66890,26751,2.7997e+13,173.159,3584.02,93641,286,175,78166,65337,33747,31370,47333
21023,154,212,15015,6008,2.80017e+13,170.186,1656.12,21023,155,142,20048,15889,17654,18367,18489
81899,180,322,58495,23404,2.80002e+13,173.057,3341.97,81899,265,175,81577,81577,72654,77214,81435
8236,59,188,5884,2352,2.79342e+13,164.069,1026.73,8236,123,114,6433,5275,2213,3133,3262
4691,33,182,3357,1334,2.78531e+13,158.149,773.075,4691,107,100,3243,2488,876,822,1044
24991,217,219,17849,7142,2.80009e+13,170.808,1809.19,24991,162,149,24772,24772,24768,24768,24770
15876,16,202,11343,4533,2.78918e+13,169.107,1434.31,15876,146,133,8797,6185,2611,1492,2083
61793,14,286,44139,17654,2.80103e+13,172.781,2886.37,61793,229,175,32618,22239,9387,4689,4450
24534,219,800,17611,6923,2.5171e+13,216.296,2784,24534,723,147,23316,22896,21732,21854,21993
19163,77,209,13683,5480,2.80525e+13,169.691,1579.55,19163,151,138,15668,13082,6477,6727,9281
25337,161,220,18093,7244,2.80242e+13,171.018,1822.79,25337,163,150,24501,19328,22112,23647,23266
89359,230,800,63917,25442,2.7221e+13,222.829,4447.8,89359,798,179,88056,87604,80356,83609,86653
25393,92,220,18135,7258,2.80067e+13,170.933,1824.49,25393,163,150,21477,17693,9987,9751,14178
86602,65,330,61857,24745,2.79884e+13,173.065,3440.23,86602,273,175,69161,57144,23923,29636,36965
85339,84,328,60958,24381,2.79984e+13,173.072,3414.2,85339,271,175,71074,59387,30276,30146,44094
1117,73,177,796,321,2.83611e+13,100.942,375.543,1117,58,63,838,733,424,503,489
37756,138,242,26968,10788,2.79986e+13,171.934,2236.58,37756,185,172,35072,28431,26376,25720,30233
41601,102,249,29710,11891,2.8e+13,172.098,2351.31,41601,192,175,35958,30359,18754,18647,25610
71696,272,446,51191,20505,2.8118e+13,173.093,3303.69,71696,252,192,71250,71130,64063,62265,67398
4084,87,182,2920,1164,2.79249e+13,155.625,721.609,4084,103,94,3344,2817,1555,1350,2096
31807,341,376,22700,9107,2.82507e+13,171.944,2231.26,31807,189,179,31431,31431,30095,30764,31283
39756,117,246,28400,11356,2.80068e+13,172.034,2297.16,39756,189,175,35447,29436,21621,20646,27807
44493,143,254,31776,12717,2.79964e+13,172.238,2434.01,44493,197,175,41719,33590,32863,32552,36853
41671,354,390,29744,11927,2.82096e+13,172.409,2533.99,41671,202,176,41281,41281,40519,40300,41144
55793,210,800,39936,15857,2.67653e+13,216.741,3718.94,55793,770,180,54510,54098,49837,51489,53107
22733,59,215,16239,6494,2.80073e+13,170.566,1723.66,22733,159,144,17837,14572,6057,4461,8207
49835,206,264,35597,14238,2.79903e+13,172.428,2581.44,49835,207,175,49571,49571,46351,47976,49513
86994,167,332,62134,24860,2.80128e+13,173.112,3449.57,86994,275,175,85414,67119,76285,81605,83109
93451,43,489,66722,26729,2.81082e+13,173.25,3770.5,93451,285,194,69608,55109,20776,10173,22302
86883,279,474,62039,24844,2.81133e+13,173.255,3634.16,86883,273,193,86409,86289,70275,66459,80725
11798,27,195,8430,3368,2.79377e+13,167.451,1233.42,11798,136,125,7826,5838,2016,1554,2282
30757,568,800,22055,8702,2.57317e+13,211.621,3006.13,30757,784,155,29855,29505,26751,28119,29261
53882,235,271,38481,15401,2.79915e+13,172.5,2687.37,53882,214,175,53611,53611,51873,52736,53575
29235,106,226,20889,8346,2.79719e+13,171.378,1960.32,29235,170,157,25429,21428,13979,13626,18609
35690,181,238,25492,10198,2.79664e+13,171.757,2172.32,35690,181,168,35452,35452,32278,33882,35395
76273,260,453,54462,21811,2.81013e+13,173.116,3403.8,76273,253,193,75820,75699,54611,48828,70002
52282,53,268,37338,14944,2.80214e+13,172.388,2645.54,52282,211,175,40379,33185,12806,15527,18826
8605,148,189,6147,2458,2.77998e+13,164.777,1050.28,8605,124,114,8052,6481,6513,6387,7258
36540,216,240,26095,10445,2.79979e+13,171.895,2199.44,36540,183,170,36300,36300,35401,35831,36276
46988,134,746,33593,13395,2.73999e+13,169.157,3102.76,46988,417,175,42880,35125,30483,28034,477
2250,144,178,1604,646,2.79718e+13,139.764,533.722,2250,83,79,1982,1659,1608,1699,1754
46572,50,258,33263,13309,2.80195e+13,172.329,2492.61,46572,201,175,35579,28787,11135,14491,16121
54386,244,273,38850,15536,2.80116e+13,172.593,2701.62,54386,216,175,54113,54113,52893,53489,54084
25456,99,220,18187,7269,2.79983e+13,170.904,1826.56,25456,163,149,21851,18428,11062,9256,14991
57946,193,279,41394,16552,2.79867e+13,172.674,2791.51,57946,222,175,57667,57667,52574,55162,57581
96460,198,348,68902,27558,2.79977e+13,173.183,3640.11,96460,292,175,96112,96112,86613,91472,95962
7860,34,188,5617,2243,2.79268e+13,164.066,1003.72,7860,122,111,5502,4407,1507,1408,1848
32678,201,234,23339,9339,2.80279e+13,171.537,2077.35,32678,176,163,32444,32444,30952,31688,32411
22510,199,215,16079,6431,2.80284e+13,170.527,1715.28,22510,158,144,22295,22295,21925,22086,22279
37289,238,241,26640,10649,2.79754e+13,171.958,2222.3,37289,185,172,37048,37048,37034,37037,37045
62281,202,286,44488,17793,2.79829e+13,172.732,2897.16,62281,229,175,61995,61995,56985,59534,61911
43310,371,398,30912,12398,2.82019e+13,172.442,2587.1,43310,194,182,42912,42912,41990,42430,42885
37665,181,242,26907,10758,2.79953e+13,171.884,2233.78,37665,185,172,37423,37423,33991,35725,37362
75702,267,311,54069,21633,2.80121e+13,172.927,3207.58,75702,253,175,75391,75391,73101,74250,75347
52263,245,269,37328,14935,2.80235e+13,172.477,2646.38,52263,212,175,51994,51994,51090,51524,51970
89173,378,800,63783,25390,2.72304e+13,257.587,4444.41,89173,794,175,87964,87418,76398,82013,87000
40746,139,248,29108,11638,2.80035e+13,172.119,2326.73,40746,191,175,37899,30679,29047,28101,32786
3850,94,181,2749,1101,2.81232e+13,153.308,698.949,3850,100,93,3190,2666,1577,1461,2082
9941,40,192,7100,2841,2.7987e+13,166.081,1130.82,9941,130,119,7265,5708,2138,1547,2589
9618,11,191,6872,2746,2.79458e+13,165.918,1111.55,9618,128,118,4561,2804,1404,798,931
20200,210,211,14431,5769,2.79923e+13,170.302,1623.4,20200,154,141,19989,19989,19989,19989,19988
72715,132,305,51936,20779,2.80088e+13,172.865,3140.32,72715,248,175,66826,54797,46555,47342,55691
48287,130,261,34495,13792,2.79894e+13,172.296,2539.12,48287,204,175,44182,36379,30389,27801,36708
66116,369,438,47207,18909,2.81315e+13,173.047,3176.89,66116,251,180,65678,65678,64217,63778,65089
26438,29,222,18880,7558,2.80181e+13,170.882,1862.65,26438,164,151,17867,13476,4516,3845,5578
47978,83,261,34262,13716,2.8026e+13,172.251,2531.28,47978,203,175,39855,33389,16990,22841,24746
61316,19,285,43794,17522,2.801e+13,172.66,2874.41,61316,227,175,36354,25939,10424,5215,6398
80435,152,320,57459,22976,2.80075e+13,173.059,3311.26,80435,263,175,76803,60895,64508,69129,70584
78032,671,800,55829,22203,2.70926e+13,235.256,4220.33,78032,758,180,77232,77054,75816,76430,76846
75997,227,312,54278,21719,2.80256e+13,172.965,3214.59,75997,255,175,75685,75685,70640,73205,75600
70610,236,302,50436,20174,2.80142e+13,172.866,3093.44,70610,245,175,70308,70308,66536,68445,70242
7353,152,187,5250,2103,2.79759e+13,163.331,969.907,7353,119,110,6898,5531,5815,5833,6337
3856,136,181,2755,1101,2.80794e+13,153.46,700.143,3856,99,95,3447,2865,2577,2573,2927
76799,698,800,54936,21863,2.71775e+13,242.852,4146.1,76799,725,175,75999,75865,66807,71536,36407
84621,83,327,60445,24176,2.80047e+13,173.082,3399.5,84621,270,175,70327,58878,29859,29725,43374
58649,601,944,41957,16692,2.69693e+13,231.412,3974.33,58649,719,194,57669,57205,56807,56758,56676
29318,29,227,20937,8381,2.8008e+13,171.311,1963.83,29318,170,156,19803,14942,4988,4672,5089
54116,130,272,38654,15462,2.79823e+13,172.579,2694.25,54116,215,175,49490,40762,34052,31531,41170
54732,187,273,39097,15635,2.80044e+13,172.565,2709.99,54732,216,175,54459,54459,49364,51954,54373
71401,56,303,50999,20402,2.80036e+13,172.881,3110.99,71401,246,175,55684,45690,17979,16416,25578
29270,198,227,20910,8360,2.79914e+13,171.312,1962.51,29270,170,157,29043,29043,27830,28422,29015
51386,44,267,36711,14675,2.8014e+13,172.457,2622.72,51386,210,175,38432,30370,11587,12750,15364
94215,146,345,67300,26915,2.80073e+13,173.205,3596.73,94215,288,175,88969,71334,71157,78444,79896
63793,24,290,45562,18231,2.80348e+13,172.725,2934.69,63793,232,175,41055,30116,10874,6955,10854
95484,332,347,68203,27281,2.8017e+13,173.192,3621.68,95484,290,175,95137,95137,94836,94964,95122
90756,66,480,64799,25957,2.81237e+13,173.303,3715.79,90756,294,178,72638,60129,25492,26751,37971
99503,275,354,71074,28429,2.80018e+13,173.167,3700.34,99503,297,175,99149,99149,94473,96847,99070
53452,74,271,38182,15270,2.80139e+13,172.583,2677.47,53452,214,175,43531,35737,17299,14931,24630
30428,505,800,21822,8606,2.57508e+13,217.663,2995.4,30428,791,154,29454,29176,25571,27391,28742
77863,28,315,55618,22245,2.79959e+13,173.031,3255.07,77863,258,175,52208,39123,13221,16472,16070
77467,452,800,55420,22047,2.7114e+13,223.722,4208.65,77467,798,175,76389,75733,68860,72554,75623
61743,28,285,44104,17639,2.79805e+13,172.726,2884.1,61743,229,175,41397,31024,10488,13074,13084
89710,109,941,64146,25564,2.73326e+13,222.418,4637.79,89710,800,192,77874,65402,42313,34445,51950
87875,249,333,62775,25100,2.80011e+13,173.128,3467.41,87875,276,175,87542,87542,82589,85106,87459
86206,107,329,61580,24626,2.79977e+13,173.065,3431.78,86206,273,175,75351,63262,41647,47552,55073
58745,403,421,41940,16805,2.81452e+13,172.879,2993.47,58745,236,177,58324,58324,58001,58153,58243
96997,277,349,69285,27712,2.7998e+13,173.16,3650.66,96997,292,175,96648,96648,92462,94585,96576
33007,132,234,23580,9427,2.80343e+13,171.694,2087.82,33007,177,163,30279,24842,21083,21117,25301
21901,145,214,15642,6259,2.80364e+13,170.573,1691.79,21901,157,143,20547,16505,16375,18127,18317
18467,154,208,13192,5275,2.80423e+13,169.836,1550.63,18467,151,137,17587,13943,15502,16116,16331
56016,99,276,40006,16010,2.80386e+13,172.545,2743.34,56016,218,175,48140,40587,24363,29186,33734
98907,44,353,70650,28257,2.80111e+13,173.179,3688.76,98907,296,175,74009,58478,22311,15585,28067
21128,111,212,15100,6028,2.79558e+13,170.466,1660.56,21128,156,142,18562,15547,10796,10211,13836
28972,725,800,20786,8186,2.55577e+13,210.379,2945.34,28972,757,152,28172,28011,26920,27429,27948
54552,188,273,38963,15589,2.80194e+13,172.571,2705.57,54552,216,175,54279,54279,49221,51793,54194
63572,130,800,45502,18070,2.69119e+13,213.16,3904.56,63572,798,175,57253,47212,38688,38858,46942
4759,19,183,3398,1361,2.81364e+13,157.51,778.58,4759,107,100,2805,2016,827,523,679
74231,100,308,53024,21207,2.80019e+13,172.959,3174.67,74231,251,175,63955,53928,33153,27164,43893
52484,676,800,37585,14899,2.6666e+13,210.484,3636.07,52484,798,175,51675,51470,47781,49660,51313
18503,28,208,13217,5286,2.80563e+13,169.869,1552.38,18503,151,137,12389,9302,3167,2220,3427
74646,622,941,53392,21254,2.71803e+13,242.932,4331.69,74646,716,193,73691,73238,72914,72804,72748
21810,71,363,15553,6257,2.83853e+13,170.926,1872.77,21810,171,161,17585,14557,6290,4735,8861
59267,206,430,42309,16958,2.81516e+13,172.914,3015.45,59267,223,192,58837,58711,46695,37566,53471
17139,174,205,12243,4896,2.80052e+13,169.479,1492.05,17139,148,135,16905,13544,15578,16244,16809
6287,164,186,4496,1791,2.7949e+13,162.194,897.397,6287,116,106,5991,4763,5527,5803,5772
69079,56,299,49339,19740,2.80114e+13,172.879,3058.33,69079,242,175,53865,44199,17404,15887,24243
62463,176,800,44709,17754,2.68893e+13,232.681,3878.77,62463,798,175,61098,60756,52954,56372,59583
84931,419,800,60756,24175,2.7183e+13,251.96,4360.84,84931,796,175,83773,83184,72970,78379,82940
17564,55,206,12542,5022,2.80251e+13,169.468,1510.95,17564,149,135,13619,11167,4408,3625,6174
1430,116,177,1018,412,2.80604e+13,122.001,424.828,1430,63,70,1174,1015,749,699,906
25540,143,220,18244,7296,2.79779e+13,170.917,1829.48,25540,163,150,23902,19266,18826,18661,20895
90159,84,337,64399,25760,2.80086e+13,173.117,3513.99,90159,280,175,75091,62748,32023,34452,47254
67556,164,296,48257,19299,2.8003e+13,172.867,3022.84,67556,239,175,65940,51747,59154,63310,63765
29746,4,227,21250,8496,2.79457e+13,171.344,1977.85,29746,171,158,7789,2357,1717,2092,975
83862,649,946,59964,23898,2.72826e+13,233.171,4529.07,83862,774,184,82905,82605,80545,81254,82025
31148,94,230,22248,8900,2.79807e+13,171.442,2025.49,31148,173,160,26460,21772,12596,11484,17379
39946,245,247,28533,11413,2.8018e+13,172.072,2303.52,39946,190,175,39699,39699,39697,39697,39697
13170,97,198,9409,3761,2.80101e+13,168.154,1304.89,13170,141,127,11201,9514,5549,4565,7551
38636,39,244,27590,11046,2.80242e+13,171.919,2263.44,38636,187,173,28194,22072,7770,5893,9853
78277,102,455,55886,22391,2.81302e+13,173.107,3445.76,78277,257,193,67692,57182,29421,27189,43373
52692,37,269,37637,15055,2.7993e+13,172.532,2656.93,52692,212,175,37891,29810,10502,9908,13312
10562,297,336,7514,3048,2.8927e+13,167.189,1336.01,10562,143,139,10226,10111,9397,9156,10081
59177,22,281,42269,16908,2.80113e+13,172.625,2821.86,59177,224,175,37015,26322,10066,6224,9331
35442,17,239,25314,10128,2.8027e+13,171.748,2166,35442,181,168,20115,14288,5965,3471,4584
4227,71,182,3014,1213,2.818e+13,154.519,732.925,4227,103,97,3362,2805,1352,1451,1925
66489,192,444,47466,19023,2.81452e+13,172.998,3190.56,66489,236,196,66040,65900,41326,26071,56874
66756,111,295,47682,19074,2.80138e+13,172.796,3004.39,66756,238,175,58839,49220,34196,38643,44420
49380,64,264,35273,14107,2.80372e+13,172.392,2570.04,49380,207,175,39318,32573,13565,12181,19934
71006,186,303,50717,20289,2.80265e+13,172.881,3102.82,71006,246,175,70703,70703,63488,67167,70586
47301,202,260,33782,13519,2.80223e+13,172.333,2513.25,47301,203,175,47041,47041,43825,45449,46983
28669,743,800,20569,8100,2.55724e+13,209.936,2934.89,28669,767,151,27869,27708,26311,26994,27699
13095,747,800,9447,3648,2.26653e+13,230.955,2271.14,13095,717,125,12295,12154,11924,12001,12137
50597,210,265,36143,14454,2.7975e+13,172.415,2601.35,50597,208,175,50332,50332,47297,48828,50277
11052,154,194,7899,3153,2.80144e+13,166.98,1193.26,11052,133,124,10478,8328,9232,8967,9588
73475,54,307,52475,21000,2.8016e+13,172.904,3157.95,73475,250,175,56953,46625,18098,13455,24663
48198,71,261,34426,13772,2.79974e+13,172.365,2537.18,48198,204,175,38985,32056,14781,16181,21720
1950,71,177,1392,558,2.72933e+13,133.278,494.956,1950,80,75,1517,1280,641,636,858
81640,193,470,58296,23344,2.80993e+13,173.23,3528.92,81640,276,192,81165,81025,66152,62914,77321
41295,47,249,29493,11802,2.80302e+13,172.16,2342.96,41295,192,175,31202,24995,9498,9142,12736
72491,287,305,51781,20710,2.80176e+13,172.901,3135.72,72491,248,175,72186,72186,71699,71917,72168
93052,90,342,66467,26585,2.80003e+13,173.167,3572.47,93052,285,175,78510,64920,36302,35044,51107
25166,124,219,17983,7183,2.79627e+13,170.925,1815.53,25166,163,150,22698,18800,15323,12467,18298
89401,315,336,63858,25543,2.80145e+13,173.138,3499.03,89401,279,175,89065,89065,88378,88697,89044
7562,26,188,5399,2163,2.80594e+13,162.949,984.112,7562,120,111,4980,3662,1311,937,1404
53185,78,271,37985,15200,2.80168e+13,172.502,2670.63,53185,213,175,43698,36429,17838,18684,25897
20545,85,212,14667,5878,2.80638e+13,170.137,1637.56,20545,154,141,17093,14320,7445,9855,10752
41186,544,800,29509,11677,2.63096e+13,208.704,3330.62,41186,775,174,40269,39915,37721,38818,39618
46543,152,258,33246,13297,2.80036e+13,172.283,2491.63,46543,201,175,44399,35228,37303,39967,40529
27231,52,224,19449,7782,2.80554e+13,171.02,1891.53,27231,166,153,20932,16978,6638,6337,9322
96209,249,348,68723,27486,2.80035e+13,173.182,3635.64,96209,291,175,95861,95861,89840,92907,95762
38072,66,242,27195,10877,2.79956e+13,171.871,2245.57,38072,186,172,30439,25183,10966,16716,16331
31846,147,232,22743,9103,2.80307e+13,171.424,2049.35,31846,174,161,30046,24094,24190,26515,26964
35156,46,237,25107,10049,2.80148e+13,171.621,2155.31,35156,180,167,26478,21235,7991,9939,11347
4678,19,183,3346,1332,2.79606e+13,157.962,772.576,4678,107,99,2758,1969,796,617,580
10970,181,194,7831,3139,2.80443e+13,166.505,1188.87,10970,133,123,10776,10776,10541,10642,10763
25373,191,220,18126,7247,2.80177e+13,170.908,1823.57,25373,163,149,25153,25153,23897,24511,25124
39150,152,244,27970,11180,2.79655e+13,172.049,2278.34,39150,188,175,37308,29616,31346,31362,34280
17970,41,207,12830,5140,2.80659e+13,169.471,1528.91,17970,149,136,13224,10428,3799,3782,5068
19634,148,209,14024,5610,2.79747e+13,169.893,1598.53,19634,152,139,18515,14838,14959,14622,16694
11463,64,194,8193,3270,2.79559e+13,167.059,1214.98,11463,134,124,9084,7547,3188,4976,4741
91432,45,339,65311,26121,2.80051e+13,173.101,3539.41,91432,282,175,68664,54552,20360,14722,26454
7701,185,188,5506,2195,2.79732e+13,163.887,993.801,7701,121,111,7513,7513,7506,7507,7510
43756,132,254,31251,12505,2.80239e+13,172.163,2414.4,43756,196,175,40148,32951,28004,28475,33692
77302,155,457,55185,22117,2.81335e+13,173.103,3429.49,77302,255,194,74102,58826,40407,27178,59187
79433,246,462,56711,22722,2.81125e+13,173.134,3477.16,79433,259,192,78971,78850,65788,58160,72709
95014,7,346,67864,27150,2.80104e+13,173.128,3612.04,95014,288,175,36756,14779,10313,5843,3286
61386,45,285,43847,17539,2.80079e+13,172.7,2876.06,61386,228,175,46084,36615,13680,17090,19173
24725,157,219,17666,7059,2.7983e+13,170.836,1799.72,24725,162,149,23732,18775,21531,22012,22227
19958,76,210,14255,5703,2.80073e+13,170.096,1612.58,19958,153,140,16283,13541,6651,6788,9450
42305,8,251,30222,12083,2.80033e+13,172.232,2372.63,42305,194,175,17589,8026,4894,2678,1408
29841,74,228,21315,8526,2.80173e+13,171.276,1981.62,29841,171,157,24282,19951,9668,7336,13447
20370,168,211,14553,5817,2.79453e+13,170.26,1629.91,20370,154,141,19914,15673,18055,19115,19507
64324,271,800,46031,18293,2.69278e+13,213.109,3921.82,64324,798,175,63106,62614,58051,60040,61867
26531,82,222,18952,7579,2.80207e+13,170.951,1865.57,26531,165,151,21965,18446,9333,7292,13044
1912,108,177,1365,547,2.80583e+13,130.923,489.789,1912,81,75,1603,1374,956,1081,1213
28503,17,225,20366,8137,2.79641e+13,171.267,1935.2,28503,168,155,16164,11473,4785,3696,2558
28234,112,225,20166,8068,2.80061e+13,171.188,1926.17,28234,168,154,24907,20845,14598,13260,18827
51681,170,267,36915,14766,2.80094e+13,172.414,2630,51681,210,175,50959,40050,45560,48547,49870
49360,7,263,35258,14102,2.79858e+13,172.373,2568.35,49360,206,175,19101,7676,5360,4199,2090
5050,34,183,3612,1438,2.79644e+13,158.689,802.377,5050,110,101,3524,2826,968,740,1165
39979,240,247,28557,11422,2.80337e+13,172.004,2304.41,39979,190,175,39732,39732,39673,39693,39725
37842,41,243,27022,10820,2.80393e+13,171.854,2240.01,37842,185,172,27890,21961,7967,6340,10238
38163,461,800,27347,10816,2.61505e+13,208.995,3241.24,38163,787,168,37151,36898,33519,35211,36346
14894,137,201,10634,4260,2.79535e+13,168.806,1388.9,14894,144,131,13715,11187,10135,9333,11895
12647,164,197,9031,3616,2.80218e+13,167.871,1278.34,12647,139,127,12219,9647,11101,11777,11760
91067,753,800,65144,25923,2.72315e+13,222.431,4480.8,91067,798,180,90267,90045,84198,87237,90127
38590,16,243,27570,11020,2.79919e+13,171.928,2261.34,38590,187,173,21409,15063,6340,5511,3711
18932,141,208,13522,5410,2.79857e+13,169.891,1569.71,18932,151,138,17635,14270,13597,14450,15396
2083,120,178,1487,596,2.81873e+13,137.839,514.457,2083,78,78,1763,1501,1148,1051,1369
7263,90,187,5191,2072,2.79541e+13,163.111,963.924,7263,121,109,6066,5045,2848,2426,3859
40178,141,247,28698,11480,2.8021e+13,172.063,2310,40178,190,175,37517,30327,28939,32321,32968
67377,775,800,48204,19173,2.70953e+13,234.08,3924.96,67377,705,175,66577,66460,58728,62826,58068
12490,107,197,8924,3566,2.80921e+13,167.803,1270.31,12490,139,126,10841,9128,6020,5603,7939
47572,100,260,33980,13592,2.80076e+13,172.301,2520.17,47572,203,175,40945,34554,21282,24949,28936
91762,32,340,65547,26215,2.80088e+13,173.143,3546.62,91762,283,175,63529,48113,16779,22090,22540
77611,149,944,55502,22109,2.72232e+13,241.327,4398.72,77611,737,197,72595,58102,42263,32778,57556
81300,317,321,58072,23228,2.80073e+13,173.041,3329.15,81300,264,175,80979,80979,80956,80962,80975
49205,190,263,35145,14060,2.8011e+13,172.399,2564.54,49205,206,175,48942,48942,44693,46848,48869
1968,65,178,1407,561,2.84749e+13,135.087,499.014,1968,75,78,1506,1274,562,553,758
4551,62,182,3253,1298,2.78132e+13,156.842,761.244,4551,106,98,3552,2932,1246,1411,1749
68556,173,298,48968,19588,2.80094e+13,172.829,3046.01,68556,241,175,68014,53874,60499,64462,67364
71639,443,800,51262,20377,2.703e+13,233.89,4084.65,71639,749,180,70637,69916,68853,69552,69768
94565,539,800,67636,26929,2.72664e+13,259.265,4547.65,94565,717,177,93667,93267,92733,92976,92982
96243,495,800,68838,27405,2.72694e+13,233.457,4578.93,96243,790,180,95263,94873,91554,93237,94528
74008,89,308,52864,21144,2.79931e+13,172.97,3170.06,74008,251,175,62278,51635,28802,26131,39147
7339,8,187,5243,2096,2.79331e+13,162.952,968.544,7339,119,110,3050,1393,850,460,320
9171,44,414,6565,2606,2.66523e+13,156.718,1341.19,9171,227,115,6721,5378,2003,1292,89
78473,279,316,56057,22416,2.7999e+13,173.026,3268.35,78473,259,175,78157,78157,76398,77270,78120
15243,9,202,10892,4351,2.796e+13,169.052,1406.1,15243,145,132,6661,3210,1899,1212,1306
88268,318,334,63045,25223,2.80152e+13,173.119,3475.69,88268,277,175,87934,87934,87564,87725,87918
1047,86,176,745,302,2.82411e+13,100.004,363.171,1047,63,62,793,698,396,437,510
14018,138,199,10015,4003,2.79628e+13,168.366,1346.32,14018,142,129,12955,10533,9767,9601,11091
25041,47,219,17886,7155,2.79955e+13,170.772,1810.78,25041,162,149,18913,15156,5769,4485,7507
63123,383,429,45062,18061,2.81494e+13,172.873,3100.87,63123,243,178,62694,62694,61386,61150,62472
3939,36,181,2819,1120,2.78453e+13,154.617,707.87,3939,102,93,2779,2211,784,737,946
32282,37,232,23058,9224,2.80185e+13,171.508,2063.18,32282,175,162,23203,18263,6671,8366,8593
11959,160,196,8545,3414,2.80679e+13,167.549,1242.78,11959,137,125,11463,9098,10378,11081,10830
91281,250,340,65200,26081,2.80129e+13,173.13,3537.87,91281,282,175,90941,90941,85578,88305,90851
48572,121,262,34691,13881,2.80137e+13,172.348,2547.44,48572,205,175,43664,36154,27612,29620,34725
62514,217,287,44651,17863,2.8007e+13,172.751,2903.35,62514,230,175,62227,62227,58182,60232,62157
74526,141,458,53209,21317,2.81253e+13,173.148,3374.26,74526,259,176,69592,56294,52678,58220,60509
25706,49,220,18364,7342,2.80053e+13,170.887,1835.27,25706,163,150,19552,15844,6051,7427,8589
18589,102,207,13272,5317,2.80099e+13,169.524,1554.28,18589,150,137,16029,13555,8438,10006,11507
29843,49,371,21288,8555,2.83124e+13,171.566,2163.2,29843,174,169,22728,18437,6368,3949,8277
58483,136,279,41772,16711,2.80019e+13,172.566,2803.82,58483,222,175,54148,44069,39652,42067,46168
13384,614,800,9647,3737,2.28283e+13,230.478,2285.99,13384,754,123,12549,12163,10994,11729,12025
53961,158,271,38542,15419,2.79844e+13,172.515,2689.45,53961,214,175,52069,41236,47110,45107,48813
64241,207,290,45889,18352,2.80037e+13,172.808,2944.74,64241,234,175,63951,63951,58999,61516,63868
48821,351,402,34850,13971,2.81936e+13,172.585,2733.84,48821,204,193,48419,48419,45858,47145,48368
48813,13,263,34864,13949,2.80196e+13,172.453,2554.75,48813,206,175,24971,16856,7328,4147,3416
71048,128,302,50744,20304,2.80119e+13,172.833,3102.58,71048,245,175,64783,53413,44189,44467,53079
99105,222,353,70783,28322,2.80163e+13,173.187,3692.35,99105,296,175,98752,98752,90579,94754,98621
44363,346,397,31663,12700,2.82085e+13,172.528,2613.58,44363,211,176,43966,43966,43012,42736,43714
65704,540,800,47023,18681,2.69323e+13,231.727,3952.78,65704,798,175,64708,64389,57031,60765,64124
66131,119,293,47234,18897,2.80103e+13,172.767,2988.83,66131,236,175,59232,49118,36603,40081,46329
2371,152,178,1689,682,2.82684e+13,139.426,547.231,2371,88,81,2127,1756,1831,1947,1937
67115,763,800,48030,19085,2.69535e+13,221.14,3984.71,67115,774,180,66315,66156,64416,65276,66205
62525,177,430,44640,17885,2.81529e+13,172.953,3089.61,62525,230,193,62074,61937,30264,15964,52079
75783,246,311,54133,21650,2.80119e+13,172.963,3209.32,75783,254,175,75472,75472,71802,73658,75407
94461,418,486,67449,27012,2.81013e+13,173.247,3785.4,94461,286,193,93975,93975,90238,92130,93907
5927,23,333,4208,1719,2.93605e+13,162.368,1036.23,5927,122,121,3734,2726,1061,548,902
20232,19,210,14450,5782,2.80179e+13,169.915,1623.26,20232,153,140,11994,8562,3445,3234,2507
43578,164,253,31125,12453,2.80285e+13,172.243,2408.82,43578,196,175,42478,33360,38175,40807,40761
31672,429,477,22647,9025,2.75578e+13,169.014,2338.08,31672,174,160,31195,31195,31177,31177,31151
90775,40,338,64842,25933,2.80031e+13,173.137,3526.45,90775,282,175,66611,52187,19532,13975,23602
35038,116,237,25029,10009,2.79925e+13,171.79,2152.12,35038,180,167,31151,25939,18502,16696,24028
54556,149,272,38969,15587,2.79786e+13,172.562,2704.76,54556,215,175,51772,41295,42053,41388,46972
42466,165,251,30330,12136,2.80232e+13,172.119,2376.6,42466,194,175,41465,32590,37223,39773,40045
97168,361,940,69473,27695,2.73807e+13,246.028,4779.69,97168,812,192,95810,95260,84666,80988,89193
82659,80,324,59048,23611,2.80153e+13,173.076,3358.75,82659,267,175,68243,57365,28250,23220,40827
82342,90,323,58814,23528,2.80086e+13,173.057,3351.56,82342,266,175,69477,57447,32125,31035,45338
19199,75,208,13714,5485,2.79778e+13,169.853,1580.22,19199,151,138,15625,12931,6374,7022,9204
95397,367,800,68230,27167,2.72707e+13,224.298,4563.21,95397,798,180,94259,93631,88263,90855,93252
79617,43,318,56868,22749,2.80087e+13,173.033,3293.04,79617,261,175,59275,46914,17308,15411,22393
63041,170,288,45029,18012,2.80052e+13,172.737,2916.09,63041,231,175,62193,48854,55506,56522,61291
25050,10,800,17977,7073,2.52202e+13,214.315,2803.29,25050,737,148,11560,6754,3345,1850,1218
31462,20,231,22473,8989,2.80103e+13,171.473,2036.38,31462,174,160,19048,13484,5349,2725,3253
36574,33,240,26124,10450,2.79988e+13,171.858,2200.34,36574,183,170,25504,19504,6769,6420,8429
5226,116,183,3730,1496,2.80741e+13,158.078,815.108,5226,108,103,4573,3845,2776,3155,3557
23150,497,800,16624,6526,2.49363e+13,218.758,2730.26,23150,777,141,22180,21912,19069,20484,21440
20642,188,212,14744,5898,2.8048e+13,170.178,1641.39,20642,155,141,20430,20430,19548,19969,20406
98499,346,491,70332,28167,2.80999e+13,173.261,3863.24,98499,293,192,98008,98008,89895,87409,96753
13394,152,199,9560,3834,2.80883e+13,168.142,1316.43,13394,141,128,12666,10103,10683,11425,11568
53522,168,271,38223,15299,2.80167e+13,172.448,2678.81,53522,213,175,52586,41284,47029,50210,51138
57120,126,277,40807,16313,2.79921e+13,172.671,2770.38,57120,221,175,51860,42924,35089,30799,42340
95639,220,579,68324,27315,2.78803e+13,172.339,3908.66,95639,289,175,95060,95060,83303,61339,734
9882,132,192,7060,2822,2.80402e+13,166.156,1127.37,9882,129,119,8976,7410,6287,6017,7576
58895,277,281,42061,16834,2.80307e+13,172.616,2815.3,58895,223,175,58614,58614,58591,58597,58610
12833,33,197,9172,3661,2.79666e+13,168.009,1287.49,12833,141,126,8928,6832,2363,2278,2949
25898,225,371,18473,7425,2.83628e+13,171.503,2030.08,25898,177,166,25527,25404,23034,21078,24296
9189,93,190,6571,2618,2.78407e+13,165.32,1085.62,9189,127,117,7723,6411,3695,3588,5145
97593,587,800,69804,27789,2.72889e+13,230.936,4604.27,97593,798,180,96696,96296,92713,94533,96154
36856,192,241,26320,10536,2.80215e+13,171.75,2209.41,36856,183,170,36615,36615,33997,35312,36566
82423,290,323,58874,23549,2.8005e+13,173.045,3352.99,82423,266,175,82100,82100,80572,81326,82067
9623,23,191,6872,2751,2.78729e+13,165.741,1111.59,9623,127,118,6088,4438,1636,1368,1747
4440,35,182,3172,1268,2.79694e+13,156.417,751.521,4440,104,99,3115,2486,890,616,1007
51939,57,410,37075,14864,2.81765e+13,172.64,2821.4,51939,215,192,40626,33309,12724,14186,18052
64694,143,291,46209,18485,2.80057e+13,172.798,2955.64,64694,234,175,60723,48860,47774,50462,53618
86119,155,800,61604,24515,2.71889e+13,220.149,4384.29,86119,798,180,81710,64822,71144,72026,74548
54748,141,273,39106,15642,2.80065e+13,172.582,2710.32,54748,216,175,51176,41342,39441,41911,44934
98423,228,352,70302,28121,2.80073e+13,173.214,3679.24,98423,295,175,98071,98071,90361,94298,97947
31466,43,231,22475,8991,2.80112e+13,171.486,2036.67,31466,174,160,23406,18541,6985,5030,8641
79724,127,318,56943,22781,2.79976e+13,173.013,3295.15,79724,261,175,72555,59932,49276,42730,59409
22328,73,214,15949,6379,2.79856e+13,170.506,1707.68,22328,157,144,18100,14871,7121,7414,10290
96591,139,348,68994,27597,2.79918e+13,173.182,3642.48,96591,292,175,90014,72797,68948,68445,78026
17295,96,205,12346,4949,2.80704e+13,169.278,1498.53,17295,148,135,14722,12118,7246,8905,10159
13473,185,199,9623,3850,2.81222e+13,168.14,1320.45,13473,142,128,13274,13274,13016,13126,13260
16973,200,800,12218,4755,2.38411e+13,220.479,2466.12,16973,735,134,15733,15349,13978,14157,14369
30069,103,229,21478,8591,2.80577e+13,171.37,1990.19,30069,172,158,26024,22040,13608,13890,18741
34425,353,379,24567,9858,2.8274e+13,172.021,2315.15,34425,186,167,34046,34046,33726,33674,33977
96451,86,348,68895,27556,2.80062e+13,173.166,3639.83,96451,291,175,80689,67299,35640,37205,51594
67747,283,297,48393,19354,2.80197e+13,172.855,3027.92,67747,240,175,67450,67450,67199,67304,67436
90420,262,338,64580,25840,2.80165e+13,173.056,3519.63,90420,280,175,90082,90082,85630,87889,90006
45953,128,257,32819,13134,2.80108e+13,172.268,2475.26,45953,200,175,41889,34532,28565,26865,34618
89157,296,800,63777,25380,2.72037e+13,243.186,4443.72,89157,798,175,87883,87403,77335,82244,86675
29349,107,227,20965,8384,2.80072e+13,171.308,1964.79,29349,170,157,25615,21510,14182,13164,18728
78005,239,315,55711,22294,2.80009e+13,173.001,3258.05,78005,258,175,77690,77690,73255,75505,77614
97790,520,800,69940,27850,2.72829e+13,232.417,4607.79,97790,794,180,96830,96430,92872,94672,96150
29406,104,227,21005,8401,2.79817e+13,171.334,1966.75,29406,170,157,25508,21552,13579,13304,18118
85871,102,330,61331,24540,2.80118e+13,173.108,3426.32,85871,273,175,74299,62696,38685,36675,52856
17671,115,206,12622,5049,2.80307e+13,169.45,1515.28,17671,149,135,15636,13067,9304,8916,12109
22861,35,215,16330,6531,2.79799e+13,170.547,1728.41,22861,158,145,16176,12885,4511,3138,5181
4017,9,181,2877,1140,2.77598e+13,155.141,714.82,4017,103,94,1751,838,493,330,222
71205,310,942,50926,20279,2.71334e+13,225.647,4259.1,71205,812,192,69843,69329,62015,55581,62585
47996,62,261,34289,13707,2.7989e+13,172.399,2531.92,47996,204,175,38033,31131,13051,13729,18441
67662,280,297,48330,19332,2.8032e+13,172.819,3025.96,67662,240,175,67365,67365,66946,67129,67348
94306,174,345,67365,26941,2.80041e+13,173.207,3598.32,94306,288,175,93792,74792,83087,88651,93226
83644,141,325,59745,23899,2.80002e+13,173.033,3378.56,83644,268,175,78247,63189,60313,58502,68235
95524,62,346,68237,27287,2.7989e+13,173.195,3621.36,95524,290,175,75762,61988,25948,27308,36730
93508,235,343,66795,26713,2.80022e+13,173.154,3581.7,93508,287,175,93165,93165,86514,89906,93057
43294,40,252,30921,12373,2.80108e+13,172.19,2400.07,43294,195,175,31750,24882,9010,8076,12586
64019,519,800,45813,18206,2.69418e+13,236.258,3914.71,64019,707,176,63102,62706,62167,62403,62376
74701,129,309,53357,21344,2.79992e+13,172.941,3185.28,74701,252,175,68250,56288,46730,41123,55962
91757,149,340,65536,26221,2.79965e+13,173.154,3546.54,91757,283,175,87138,69479,70784,69640,79155
4827,146,183,3440,1387,2.81482e+13,156.782,783.647,4827,106,100,4441,3620,3598,3938,3986
3833,38,181,2738,1095,2.80276e+13,153.315,698.118,3833,102,93,2750,2169,796,570,952
48882,74,800,35000,13882,2.65888e+13,210.535,3542.5,48882,777,175,39089,32251,15336,12548,21236
14391,57,200,10280,4111,2.8011e+13,168.433,1364.76,14391,143,130,11214,9199,3688,4661,5528
90603,243,951,64780,25823,2.73273e+13,221.624,4666.84,90603,800,201,89174,88575,70038,42329,79112
96565,122,349,68973,27592,2.80081e+13,173.228,3643.13,96565,292,175,87036,72071,56027,47346,69146
42247,144,250,30178,12069,2.79851e+13,172.1,2369.76,42247,193,175,39692,31896,31345,30974,34968
30346,107,229,21680,8666,2.80242e+13,171.42,1999.16,30346,172,159,26474,22240,14663,13608,19362
47271,127,260,33758,13513,2.80222e+13,172.287,2512.35,47271,202,175,42979,35524,29198,29509,35213
59707,50,282,42647,17060,2.80055e+13,172.64,2835.02,59707,225,175,45628,36917,14287,16852,19750
39999,67,247,28570,11429,2.80338e+13,172.034,2305,39999,190,175,32050,26451,11632,9296,16597
75253,203,940,53820,21433,2.71837e+13,219.134,4344.22,75253,812,192,73781,73261,59957,54193,68034
77713,104,314,55506,22207,2.80065e+13,172.955,3251.14,77713,257,175,67522,57024,35894,42175,48558
52424,68,269,37449,14975,2.79884e+13,172.522,2650.22,52424,212,175,42117,34767,15368,15568,21962
9129,133,191,6522,2607,2.8132e+13,165.635,1083.51,9129,127,117,8308,6835,5896,6216,7010
32522,181,232,23234,9288,2.79718e+13,171.571,2070.57,32522,176,163,32290,32290,29515,30912,32239
21889,6,214,15633,6256,2.80518e+13,170.463,1691.33,21889,157,143,7722,2937,1943,1304,651
22941,204,216,16392,6549,2.79866e+13,170.755,1732.67,22941,159,145,22725,22725,22552,22626,22713
27362,117,223,19546,7816,2.80085e+13,171.064,1894.98,27362,166,153,24361,20251,14901,16481,18864
32173,48,232,22986,9187,2.79865e+13,171.629,2060.01,32173,175,161,24387,19642,7452,7170,9991
35509,171,238,25361,10148,2.80059e+13,171.764,2166.92,35509,181,168,35023,27497,31448,33390,34498
28728,174,226,20518,8210,2.80049e+13,171.259,1943.63,28728,169,156,28452,22745,25694,27108,28317
63180,147,288,45129,18051,2.80037e+13,172.736,2919.11,63180,231,175,59756,47833,48032,50086,53818
69805,229,300,49858,19947,2.79984e+13,172.885,3074.59,69805,243,175,69505,69505,65399,67481,69434
45343,209,256,32387,12956,2.80088e+13,172.289,2458.42,45343,199,175,45087,45087,42601,43849,45040
50704,629,800,36309,14395,2.66274e+13,210.25,3590.65,50704,785,175,49862,49692,46893,48333,49391
5719,49,185,4079,1640,2.83125e+13,159.786,854.705,5719,112,105,4318,3524,1382,1645,1920
15523,79,202,11086,4437,2.79821e+13,168.921,1418.7,15523,145,132,12739,10645,5317,5046,7346
88285,77,333,63060,25225,2.79939e+13,173.098,3475.03,88285,276,175,72412,60327,29732,32461,43553
41464,20,249,29617,11847,2.80076e+13,172.114,2347.54,41464,192,175,25106,17762,7055,4950,6268
80682,237,319,57638,23044,2.79968e+13,173.034,3315.14,80682,263,175,80363,80363,75479,77961,80281
44786,93,255,31991,12795,2.79988e+13,172.249,2442.82,44786,198,175,38002,31309,17835,17239,25150
35421,184,238,25299,10122,2.80079e+13,171.744,2164.31,35421,182,167,35183,35183,32213,33712,35129
94602,240,345,67574,27028,2.80133e+13,173.164,3603.59,94602,288,175,94257,94257,87859,91117,94152
54657,12,422,39020,15637,2.81405e+13,172.801,2899.11,54657,215,196,26941,17069,8135,3253,5137
20406,759,800,14664,5742,2.45359e+13,215.336,2618.39,20406,765,136,19606,19453,18112,18755,19484
39910,60,247,28503,11407,2.80363e+13,171.919,2302.43,39910,189,175,31458,25685,10734,12512,15564
97056,290,350,69329,27727,2.80159e+13,173.203,3652.93,97056,293,175,96706,96706,93369,95052,96646
78153,329,800,55917,22236,2.71137e+13,230.206,4222.93,78153,798,175,76939,76418,68328,72286,75848
64045,169,290,45741,18304,2.80212e+13,172.807,2940.39,64045,233,175,63071,49513,56314,60121,61750
17366,81,205,12404,4962,2.79959e+13,169.402,1501.42,17366,148,135,14319,12064,6107,6585,8831
60592,166,284,43281,17311,2.80217e+13,172.726,2857.2,60592,227,175,59336,46734,53133,56807,57257
22200,46,214,15855,6345,2.80584e+13,170.308,1702.81,22200,157,144,16705,13401,5053,6276,7060
79541,187,461,56797,22744,2.81132e+13,173.205,3478.75,79541,261,192,79069,78935,61158,56583,74231
10681,107,193,7631,3050,2.79593e+13,166.73,1172.62,10681,132,122,9270,7805,5151,4812,6757
33271,146,234,23766,9505,2.8032e+13,171.607,2095.8,33271,177,164,31332,25164,25098,27651,27920
19309,48,209,13790,5519,2.80154e+13,169.894,1585.75,19309,152,138,14624,11793,4472,3342,5870
55543,157,275,39679,15864,2.80061e+13,172.647,2731.23,55543,218,175,53486,42231,48506,50294,50253
9903,20,191,7074,2829,2.79523e+13,165.719,1127.52,9903,129,120,5988,4241,1693,1285,1733
29308,32,227,20934,8374,2.80079e+13,171.296,1963.54,29308,170,156,20271,15362,5363,3814,6027
39155,222,245,27965,11190,2.80195e+13,171.986,2279.3,39155,188,174,38910,38910,38060,38465,38887
54346,132,273,38814,15532,2.80401e+13,172.486,2700.64,54346,215,175,49902,40939,34771,35374,41856
47189,686,799,33748,13441,2.72742e+13,169.417,3196.5,47189,470,175,46390,46390,40797,43677,39095
84199,300,326,60140,24059,2.80029e+13,173.068,3390.39,84199,269,175,83873,83873,82815,83328,83847
4366,120,181,3120,1246,2.78311e+13,155.406,744.405,4366,105,96,3814,3213,2452,2648,3023
68967,10,299,49259,19708,2.8014e+13,172.85,3055.83,68967,242,175,31547,17094,9477,4610,3542
31150,68,230,22245,8905,2.80243e+13,171.392,2025.71,31150,173,160,25014,20659,9171,13816,13740
93745,645,800,67049,26696,2.72601e+13,237.256,4532.01,93745,779,180,92925,92744,90399,91593,92481
21434,165,213,15304,6130,2.80429e+13,170.086,1672.57,21434,155,142,20851,16433,18805,20032,20096
46168,158,257,32974,13194,2.79749e+13,172.268,2480.92,46168,200,175,44534,35275,40302,41209,41725
10015,117,192,7153,2862,2.80757e+13,165.828,1134.63,10015,129,120,8839,7394,5446,6035,6920
31936,98,232,22808,9128,2.80222e+13,171.491,2052.33,31936,175,161,27371,23131,13893,16532,19212
42307,127,250,30212,12095,2.80154e+13,172.036,2371.25,42307,193,175,38460,31793,26155,26412,31452
30261,193,229,21613,8648,2.80286e+13,171.343,1996.16,30261,172,158,30032,30032,28300,29159,29996
97302,52,490,69475,27827,2.81041e+13,173.254,3840.24,97302,291,192,74931,60762,21004,14437,28000
42313,252,800,30313,12000,2.63542e+13,221.696,3362.8,42313,796,175,41065,40643,35276,37661,39808
62657,241,425,44735,17922,2.81475e+13,172.911,3085.77,62657,229,191,62232,62111,42172,31207,56849
45806,101,800,32809,12997,2.64685e+13,217.329,3459.92,45806,798,175,38703,32749,19755,18075,26282
52965,133,269,37839,15126,2.7987e+13,172.53,2663.49,52965,213,175,48730,39897,34278,34571,40911
41355,248,249,29537,11818,2.80168e+13,172.114,2344.67,41355,192,175,41106,41106,41106,41106,41105
79319,282,318,56656,22663,2.80234e+13,173.009,3287.09,79319,261,175,79001,79001,77288,78138,78965
68930,350,800,49329,19601,2.69852e+13,215.279,4025.38,68930,798,175,67777,67212,61860,64443,66766
8024,59,188,5737,2287,2.78997e+13,164.568,1014.04,8024,123,113,6248,5127,2096,2416,3071
81720,15,321,58371,23349,2.80047e+13,172.988,3337.3,81720,264,175,44319,30579,12863,8875,11694
74596,255,309,53280,21316,2.79932e+13,172.976,3183.07,74596,252,175,74287,74287,71367,72838,74233
80723,253,461,57637,23086,2.81255e+13,173.193,3500.82,80723,262,192,80262,80141,67234,59992,73936
83116,47,325,59372,23744,2.80035e+13,173.115,3368.71,83116,268,175,62844,50323,19099,14146,24984
74488,304,309,53204,21284,2.80187e+13,172.977,3180.92,74488,252,175,74179,74179,74143,74154,74174
19354,184,209,13824,5530,2.80084e+13,169.958,1587.59,19354,152,138,19145,19145,18160,18635,19120
68860,44,298,49190,19670,2.7992e+13,172.831,3052.48,68860,241,175,51516,40705,15538,11848,19855
77861,282,314,55620,22241,2.79858e+13,172.995,3254.11,77861,258,175,77547,77547,76064,76796,77515
8321,61,189,5940,2381,2.79705e+13,164.62,1033.37,8321,123,114,6528,5367,2293,2404,3164
1744,43,177,1247,497,2.77723e+13,129.486,469.165,1744,73,72,1259,1013,398,481,538
48518,67,261,34660,13858,2.79693e+13,172.392,2545.31,48518,205,175,38886,32089,14066,16778,21045
96649,358,800,69124,27525,2.72772e+13,233.544,4586.47,96649,798,175,95449,94881,85814,90331,94413
37362,31,242,26684,10678,2.80037e+13,171.994,2225.28,37362,185,172,25644,19446,6709,6417,8152
60562,268,284,43263,17299,2.80193e+13,172.74,2856.6,60562,227,175,60278,60278,59925,60075,60262
50042,193,264,35742,14300,2.80095e+13,172.362,2586.45,50042,207,175,49778,49778,45665,47750,49707
47894,125,260,34206,13688,2.80104e+13,172.251,2528.16,47894,203,175,43386,35997,29232,29734,35147
56226,238,276,40156,16070,2.80165e+13,172.551,2748.15,56226,218,175,55950,55950,54081,55011,55912
92844,527,800,66400,26444,2.72623e+13,258.786,4515,92844,714,176,91935,91535,91009,91261,91225
53842,73,271,38466,15376,2.79939e+13,172.6,2686.73,53842,215,175,43737,35902,17143,15224,24613
57348,141,278,40962,16386,2.80036e+13,172.683,2776.59,57348,221,175,53600,43300,41320,41942,47009
29258,35,227,20901,8357,2.79835e+13,171.389,1961.99,29258,170,157,20707,16490,5617,5287,7477
2183,174,178,1566,617,2.78623e+13,139.038,525.689,2183,84,77,2003,1668,1989,1993,1991
86802,112,331,62000,24802,2.80082e+13,173.116,3445.09,86802,274,175,76681,64160,44880,40704,57841
31919,61,232,22802,9117,2.79885e+13,171.533,2051.72,31919,175,162,25202,20641,8647,7643,12170
23954,254,357,17091,6863,2.83722e+13,171.199,1945.51,23954,173,164,23597,23476,17464,15263,22055
27070,35,223,19334,7736,2.80089e+13,171.01,1885.24,27070,166,153,19166,15268,5357,4719,6635
93030,144,342,66450,26580,2.79993e+13,173.164,3571.94,93030,285,175,87522,70278,69085,68264,77549
87241,56,331,62318,24923,2.79883e+13,173.106,3453.37,87241,275,175,68040,55826,21956,23831,31387
61755,370,800,44203,17552,2.68784e+13,234.774,3862.33,61755,707,176,60689,60049,59386,59557,59665
45661,254,257,32611,13050,2.80296e+13,172.313,2467.82,45661,200,175,45404,45404,45392,45394,45401
72547,42,306,51812,20735,2.80251e+13,172.914,3137.91,72547,248,175,53749,42494,15636,12890,20710
92254,88,341,65892,26362,2.80105e+13,173.168,3556.91,92254,284,175,77514,64362,35367,33920,49766
18896,182,351,13478,5418,2.84036e+13,170.544,1745.98,18896,161,138,18530,18390,17059,17318,18053
63311,127,288,45230,18081,2.79836e+13,172.771,2922.16,63311,231,175,57608,47587,39149,33940,46635
37784,47,242,26986,10798,2.79779e+13,171.896,2237.27,37784,185,172,28555,22875,8695,9645,11656
91134,146,338,65095,26039,2.8004e+13,173.097,3533.04,91134,281,175,86070,69015,68838,75889,77020
41298,3,248,29496,11802,2.7977e+13,172.063,2341.9,41298,191,175,8653,1937,1787,2238,932
43497,568,800,31161,12336,2.6391e+13,220.519,3396.02,43497,798,175,42565,42222,37425,39841,42001
68096,165,297,48633,19463,2.80022e+13,172.855,3035.39,68096,240,175,66589,52286,59677,57064,64160
21733,23,213,15520,6213,2.79745e+13,170.265,1683.88,21733,156,143,13782,10051,3697,4026,3968
78083,479,800,55872,22211,2.70947e+13,218.578,4221.3,78083,798,180,77077,76746,72665,74721,76320
50445,19,265,36030,14415,2.80314e+13,172.36,2597.5,50445,208,175,29913,21354,8600,5951,8304
30583,576,800,21929,8654,2.59241e+13,203.184,2955.05,30583,586,155,29783,29560,29569,29267,29282
9710,71,192,6932,2778,2.81019e+13,165.383,1117.21,9710,128,119,7810,6453,3031,3973,4430
51194,313,314,36572,14622,2.8031e+13,172.162,2673.46,51194,210,178,50880,50880,50880,50880,50879
58726,76,280,41951,16775,2.8001e+13,172.67,2810.49,58726,224,175,48035,39908,19547,14699,27377
50730,435,951,36306,14424,2.67774e+13,209.164,3782.85,50730,802,181,49536,48896,45386,43785,46394
69337,202,800,49619,19718,2.69913e+13,235.519,4034.07,69337,798,175,67995,67619,59161,62998,66541
41543,39,249,29672,11871,2.79984e+13,172.163,2349.87,41543,192,175,30311,23723,8355,6020,10232
40333,741,800,28900,11433,2.63075e+13,219.616,3305.93,40333,798,172,39533,39331,35173,37292,39357
19231,145,209,13727,5504,2.80558e+13,169.69,1582.21,19231,151,138,18032,14503,14387,15915,16032
31914,55,231,22795,9119,2.79709e+13,171.519,2050.74,31914,174,161,24783,20291,8003,10227,11938
40654,370,390,29017,11637,2.82538e+13,172.258,2505.53,40654,190,191,40264,40264,39816,40015,40244
45326,115,256,32374,12952,2.80069e+13,172.311,2458.09,45326,199,175,40249,33566,23844,21521,30902
65618,666,800,46959,18659,2.69311e+13,213.923,3951,65618,794,180,64804,64609,61271,62958,64417
15504,39,202,11070,4434,2.80072e+13,168.907,1417.49,15504,145,132,11296,8850,3275,3639,4070
87186,201,332,62269,24917,2.80157e+13,173.048,3453.2,87186,274,175,86854,86854,78660,82845,86723
38460,183,244,27471,10989,2.80023e+13,172.075,2258.82,38460,187,173,38216,38216,34819,36535,38155
6702,60,186,4786,1916,2.80041e+13,162.334,925.624,6702,116,107,5236,4296,1803,2047,2555
25198,20,220,17996,7202,2.80447e+13,170.878,1817.52,25198,163,149,15246,10801,4295,2527,2655
49326,213,263,35230,14096,2.79965e+13,172.403,2567.54,49326,206,175,49063,49063,46385,47732,49013
96048,66,486,68592,27456,2.80884e+13,173.288,3814.43,96048,289,193,76881,63635,23442,17110,34807
28055,203,224,20044,8011,2.79389e+13,171.24,1919.39,28055,168,155,27831,27831,27095,27442,27810
78570,120,316,56121,22449,2.80128e+13,172.964,3270.25,78570,259,175,70504,58361,43912,47744,55537
5953,28,185,4253,1700,2.80983e+13,160.731,871.658,5953,113,105,3971,2989,1041,728,1171
63714,88,434,45482,18232,2.81446e+13,172.897,3120,63714,246,177,53486,44501,23765,28270,33433
50845,293,412,36301,14544,2.8143e+13,172.7,2796.13,50845,224,181,50433,50315,47576,46960,48947
78245,16,459,55870,22375,2.81129e+13,173.117,3450.5,78245,257,192,43405,30527,12911,6590,10430
59606,102,282,42567,17039,2.80199e+13,172.614,2832.46,59606,224,175,51563,43524,26904,32041,36967
2568,15,178,1843,725,2.74133e+13,143.945,569.13,2568,88,80,1376,942,390,265,187
65282,177,434,46614,18668,2.81135e+13,172.993,3154.62,65282,234,192,64828,64690,36403,24178,56051
84445,692,800,60411,24034,2.71727e+13,222.138,4351.12,84445,798,175,83611,83392,76970,80274,83322
44321,243,254,31659,12662,2.80035e+13,172.265,2429.7,44321,197,175,44067,44067,43898,43972,44056
48283,58,262,34487,13796,2.80385e+13,172.342,2540.25,48283,205,175,37855,30980,12304,10165,17680
95342,193,495,68077,27265,2.80911e+13,173.311,3811.66,95342,289,195,94842,94702,65154,48862,84494
45800,130,257,32714,13086,2.80153e+13,172.313,2471.45,45800,200,175,41898,34495,28781,27263,35040
92920,187,342,66370,26550,2.80097e+13,173.164,3569.99,92920,285,175,92578,92578,82788,87794,92423
88831,4,335,63445,25386,2.80136e+13,173.071,3487.2,88831,277,175,23297,7079,5147,4983,2016
63066,393,429,45018,18048,2.81592e+13,172.86,3099.48,63066,243,184,62637,62637,61140,61889,62454
71794,290,303,51288,20506,2.79934e+13,172.904,3119.4,71794,247,175,71491,71491,71253,71355,71478
66369,149,294,47409,18960,2.80032e+13,172.819,2995.16,66369,237,175,63005,50245,51183,55595,56925
77199,89,314,55141,22058,2.80179e+13,172.968,3240.74,77199,257,175,65005,53854,30031,29229,42003
19303,37,209,13790,5513,2.80168e+13,169.918,1585.37,19303,152,138,13859,10918,3854,3910,5099
48068,146,406,34307,13761,2.82018e+13,172.614,2720.3,48068,203,190,45232,36395,24172,17500,35394
47341,161,260,33812,13529,2.80224e+13,172.374,2514.32,47341,203,175,45905,36163,41351,44290,43684
77406,94,314,55291,22115,2.80048e+13,172.993,3245.02,77406,257,175,65866,54136,31232,30022,44058
92661,128,341,66187,26474,2.79923e+13,173.144,3564.18,92661,284,175,84520,69668,57635,49817,68885
6708,54,186,4790,1918,2.80001e+13,162.361,926.059,6708,116,107,5154,4237,1669,1948,2367
28429,128,225,20305,8124,2.80123e+13,171.145,1932.63,28429,168,155,25858,21350,17669,17809,21201
5581,66,184,3986,1595,2.80536e+13,159.894,843.792,5581,112,104,4406,3675,1631,1824,2356
56937,248,277,40669,16268,2.8003e+13,172.629,2766.02,56937,220,175,56660,56660,55407,56018,56631
40533,32,248,28947,11586,2.80465e+13,171.98,2320.75,40533,190,175,28052,21259,7435,5308,8586
41947,255,800,30053,11894,2.63223e+13,209.031,3352.32,41947,773,175,40743,40278,37685,38632,39496
31781,62,231,22706,9075,2.79772e+13,171.629,2046.81,31781,175,162,25156,20606,8638,9761,12638
60273,407,427,43034,17239,2.81348e+13,172.923,3036.03,60273,225,193,59846,59846,59410,59604,59826
14532,175,200,10373,4159,2.8069e+13,168.469,1371.48,14532,143,130,14332,14332,13365,13830,14307
12710,14,196,9080,3630,2.79715e+13,167.646,1280.24,12710,139,127,6702,4570,1937,1366,1610
14302,114,200,10216,4086,2.80573e+13,168.533,1360.6,14302,143,130,12602,10564,7494,6800,9603
91937,282,800,65756,26181,2.72449e+13,232.13,4497.29,91937,785,180,90734,90178,86592,88036,89483
91055,575,944,65104,25951,2.73278e+13,224.914,4668.9,91055,810,177,89950,89552,82264,84676,88389
98151,154,352,70104,28047,2.80232e+13,173.203,3674.36,98151,295,175,94103,74320,82786,86144,87188
28618,186,226,20442,8176,2.80239e+13,171.271,1940,28618,169,156,28392,28392,26414,27397,28352
57896,506,800,41446,16450,2.68047e+13,214.819,3770.43,57896,778,180,56938,56594,54096,55351,56214
81161,207,320,57971,23190,2.80033e+13,172.994,3325.39,81161,263,175,80841,80841,73859,77423,80728
50786,456,800,36366,14420,2.66205e+13,220.761,3592.47,50786,746,180,49799,49101,48184,48810,48954
32797,145,233,23429,9368,2.7982e+13,171.635,2080.28,32797,176,163,30854,24750,24547,25843,27510
77397,320,800,55368,22029,2.71148e+13,248.149,4207.35,77397,689,175,76283,75663,74991,75032,75161
25683,107,221,18349,7334,2.8014e+13,171.081,1835.75,25683,164,150,22389,18813,12398,12313,16475
66756,75,800,47766,18990,2.69698e+13,220.239,3976.88,66756,777,180,53777,44551,21578,22107,30173
37172,31,241,26549,10623,2.79916e+13,171.888,2218.63,37172,184,171,25516,19348,6669,6388,8972
18243,158,207,13032,5211,2.80008e+13,169.654,1540.41,18243,150,137,17503,13908,15846,15198,16408
16232,43,204,11586,4646,2.80784e+13,168.865,1451.79,16232,146,133,12061,9570,3573,4481,4780
42786,581,800,30653,12133,2.63591e+13,208.085,3376.04,42786,779,175,41903,41513,39209,40359,41329
60415,215,283,43157,17258,2.79989e+13,172.718,2852.26,60415,226,175,60132,60132,56210,58199,60064
23688,196,216,16923,6765,2.7966e+13,170.636,1759.84,23688,160,147,23472,23472,22810,23120,23452
68331,651,800,48903,19428,2.69869e+13,222.04,4011.98,68331,774,180,67522,67339,65352,66354,67085
66617,153,295,47576,19041,2.80216e+13,172.785,3001.46,66617,237,175,63704,50435,54723,57721,58425
93584,39,343,66846,26738,2.80096e+13,173.159,3583.14,93584,286,175,68336,53462,18808,23711,26101
29466,227,228,21048,8418,2.80394e+13,171.287,1969.66,29466,171,157,29238,29238,29238,29238,29237
84286,287,326,60208,24078,2.80074e+13,173.055,3391.96,84286,269,175,83960,83960,82024,82988,83921
52395,209,269,37426,14969,2.80174e+13,172.527,2649.69,52395,212,175,52126,52126,48777,50469,52066
8814,186,800,6389,2425,1.99359e+13,241.968,2006.34,8814,675,109,7603,7241,6329,6192,6174
85883,190,329,61352,24531,2.79981e+13,173.116,3425.68,85883,273,175,85554,85554,76802,81276,85415
13432,168,198,9592,3840,2.79669e+13,168.133,1317.31,13432,141,128,13080,10325,11977,11369,12851
13848,112,199,9889,3959,2.80114e+13,168.249,1338.21,13848,142,128,12161,10208,7162,6919,9145
91115,404,485,65055,26060,2.8101e+13,173.244,3723.88,91115,280,193,90630,90630,86009,88356,90549
59723,660,800,42751,16972,2.68239e+13,225.883,3814.44,59723,749,180,58923,58748,57816,58259,58504
81792,7,322,58425,23367,2.80076e+13,173.027,3339.68,81792,265,175,31658,12726,8878,5026,2949
82340,66,323,58813,23527,2.79973e+13,173.055,3351.38,82340,266,175,65895,54473,23651,28317,36048
69504,260,299,49641,19863,2.80062e+13,172.808,3067.14,69504,242,175,69205,69205,67263,68231,69166
51183,168,267,36561,14622,2.80012e+13,172.539,2617.99,51183,210,175,50279,39462,45011,48026,49053
68799,226,448,49116,19683,2.81396e+13,173.023,3244.3,68799,241,196,68351,68228,44504,28226,60893
57518,197,278,41085,16433,2.8009e+13,172.586,2780.54,57518,221,175,57240,57240,52425,54872,57159
64274,225,290,45911,18363,2.79937e+13,172.76,2945.31,64274,233,175,63984,63984,60280,62154,63919
43048,159,252,30751,12297,2.80302e+13,172.149,2393.41,43048,195,175,41580,32882,37567,38414,39282
66193,26,800,47370,18823,2.69843e+13,233.617,3944.67,66193,619,175,43319,32099,11098,10504,12343
29379,49,228,20983,8396,2.80265e+13,171.315,1966.86,29379,170,157,22347,18099,6923,5438,9141
83718,435,469,59777,23941,2.81065e+13,173.192,3567.92,83718,267,192,83249,83249,81827,82526,83215
19850,29,350,14158,5692,2.83722e+13,170.586,1782.74,19850,166,156,13418,10096,3404,2864,3860
13701,62,199,9781,3920,2.80139e+13,167.792,1330.94,13701,141,128,10829,8889,3774,4630,5615
23414,69,216,16727,6687,2.79985e+13,170.507,1749.36,23414,159,146,18824,15523,6932,6056,9986
55355,139,274,39537,15818,2.80071e+13,172.588,2725.74,55355,217,175,51528,41698,39496,39218,44661
44247,22,254,31604,12643,2.80057e+13,172.243,2427.57,44247,197,175,27664,19678,7532,6811,7958
81037,264,320,57886,23151,2.80044e+13,173.003,3322.91,81037,263,175,80717,80717,77620,79182,80661
2652,108,179,1899,753,2.76602e+13,144.911,579.147,2652,88,81,2221,1910,1296,1295,1640
21386,202,213,15276,6110,2.80465e+13,170.392,1671.24,21386,156,143,21173,21173,21019,21081,21162
41960,242,250,29972,11988,2.80121e+13,172.151,2362.09,41960,193,175,41710,41710,41618,41655,41702
26762,146,222,19118,7644,2.79682e+13,171.158,1873.99,26762,166,153,25191,20232,20156,21121,22561
50834,212,266,36311,14523,2.79997e+13,172.503,2608.36,50834,209,175,50568,50568,47610,49100,50514
65778,60,433,46963,18815,2.81605e+13,172.993,3162.94,65778,242,177,51872,42411,17429,16279,25178
68419,243,800,48914,19505,2.74708e+13,219.312,3744.46,68419,499,175,67619,67439,58815,43359,1076
32383,7,232,23127,9256,2.80137e+13,171.422,2066.08,32383,175,162,12531,5044,3516,2461,1647
73731,13,308,52663,21068,2.80276e+13,172.917,3164.4,73731,251,175,37731,25475,11078,5466,5037
74961,211,459,53516,21445,2.81123e+13,173.116,3384.14,74961,251,196,74502,74378,51706,31810,64823
79603,48,318,56860,22743,2.79995e+13,173.001,3292.69,79603,261,175,60416,48638,18439,20459,25135
50439,220,265,36031,14408,2.80012e+13,172.375,2597.14,50439,208,175,50174,50174,47830,49004,50129
59531,463,800,42613,16918,2.68253e+13,215.472,3809.57,59531,798,175,58490,58227,52751,55519,57720
75891,255,800,54302,21589,2.70796e+13,230.166,4175.5,75891,768,180,74663,74161,70653,72007,73360
52237,177,268,37318,14919,2.79888e+13,172.543,2644.85,52237,212,175,51969,51969,46480,49275,51878
94500,452,944,67569,26931,2.73551e+13,235.874,4734.75,94500,788,182,93341,92593,90002,89711,91194
90282,221,337,64492,25790,2.79954e+13,173.154,3516.44,90282,281,175,89945,89945,82755,86425,89829
94043,57,344,67172,26871,2.80046e+13,173.174,3592.47,94043,287,175,73579,60185,23749,27901,35056
77156,213,314,55117,22039,2.80042e+13,173.03,3240.09,77156,257,175,76842,76842,70726,73842,76741
49671,260,263,35483,14188,2.79692e+13,172.439,2576.39,49671,207,175,49408,49408,49393,49396,49405
42572,55,251,30408,12164,2.80096e+13,172.163,2379.72,42572,194,175,33075,27082,10636,7888,14554
85990,327,472,61403,24587,2.8104e+13,173.255,3615.42,85990,272,192,85518,85518,77063,74460,84206
60087,111,283,42925,17162,2.79947e+13,172.7,2844.68,60087,226,175,52921,44295,30764,28070,39523
62127,103,286,44384,17743,2.79934e+13,172.779,2893.83,62127,230,175,53841,45575,28096,24182,37911
97134,439,490,69368,27766,2.80889e+13,173.364,3838.28,97134,292,193,96644,96644,94040,95349,96593
82080,50,322,58630,23450,2.79968e+13,173.028,3345.3,82080,265,175,62740,50742,19620,17066,25819
72746,627,800,52051,20695,2.70426e+13,217.604,4108.74,72746,793,180,71894,71723,68325,70085,71427
30213,225,229,21575,8638,2.80312e+13,171.264,1994.62,30213,171,158,29984,29984,29961,29967,29980
13189,194,248,9408,3781,2.80975e+13,165.795,1364.39,13189,139,127,12941,12941,12925,12927,12878
85816,293,800,61388,24428,2.71947e+13,247.803,4378.5,85816,798,175,84536,84067,73840,78828,83323
69209,24,299,49431,19778,2.79995e+13,172.845,3060.89,69209,242,175,44535,32651,11773,14050,13150
16494,4,204,11785,4709,2.79138e+13,169.357,1463.46,16494,147,134,4312,1301,951,919,397
28043,62,225,20029,8014,2.80313e+13,171.264,1920.18,28043,168,154,22198,18189,7615,7250,11211
24123,147,218,17226,6897,2.80337e+13,170.713,1777.18,24123,161,147,22729,18237,18296,20061,20436
73058,298,306,52185,20873,2.80044e+13,172.907,3148.41,73058,249,175,72752,72752,72660,72697,72744
56448,134,276,40324,16124,2.79936e+13,172.627,2753.62,56448,219,175,52071,42526,37342,39267,44194
95174,19,346,67981,27193,2.80091e+13,173.168,3614.87,95174,289,175,56438,40267,16181,14121,15331
71436,85,303,51029,20407,2.80017e+13,172.897,3111.8,71436,247,175,59610,49838,25749,23928,37467
76730,243,313,54798,21932,2.80221e+13,172.911,3230.19,76730,255,175,76417,76417,72367,74420,76347
97734,296,499,69780,27954,2.80966e+13,173.293,3858.46,97734,292,195,97235,97117,81260,77497,91300
61043,226,284,43600,17443,2.80131e+13,172.67,2867.3,61043,227,175,60759,60759,57537,59164,60701
46834,215,258,33456,13378,2.79709e+13,172.327,2499.22,46834,202,175,46576,46576,44353,45467,46533
60401,51,283,43143,17258,2.80101e+13,172.693,2851.92,60401,226,175,46320,37451,14868,18908,21234
14710,110,200,10512,4198,2.79013e+13,168.585,1379.41,14710,144,130,12864,10821,7427,7115,9483
41668,31,249,29767,11901,2.7982e+13,172.087,2352.95,41668,192,175,28610,21684,7454,9047,9117
76507,64,453,54627,21880,2.8124e+13,173.104,3408.56,76507,254,192,60946,50556,19911,24890,30066
32804,518,800,23514,9290,2.58944e+13,211.883,3073.84,32804,749,158,31877,31548,30320,30906,31158
61521,56,285,43948,17573,2.79968e+13,172.778,2879.32,61521,229,175,47957,39363,15467,11485,21174
98958,165,353,70687,28271,2.80081e+13,173.204,3689.69,98958,296,175,96835,76007,86677,92796,93904
52932,241,270,37808,15124,2.8023e+13,172.533,2663.71,52932,213,175,52662,52662,51431,52030,52633
92024,174,341,65724,26300,2.80224e+13,173.114,3552.53,92024,283,175,91518,72998,81062,86497,91083
5472,139,184,3906,1566,2.80724e+13,159.052,835.442,5472,111,103,4979,4088,3868,3933,4361
14490,174,201,10345,4145,2.8121e+13,168.286,1370.3,14490,143,130,14264,11449,13197,13725,14195
57086,45,277,40779,16307,2.7994e+13,172.59,2769.35,57086,220,175,42854,34054,12725,9910,16679
11162,13,194,7978,3184,2.79529e+13,166.883,1198.67,11162,133,124,5700,3847,1673,1267,843
6391,52,185,4563,1828,2.78909e+13,161.061,902.465,6391,113,106,4884,3977,1572,2037,2305
90745,69,338,64815,25930,2.80092e+13,173.133,3525.83,90745,281,175,73129,60202,26607,29078,40506
82108,7,323,58643,23465,2.80181e+13,173.057,3347,82108,266,175,31777,12780,8914,6091,3059
5615,151,184,4005,1610,2.79343e+13,159.894,846.53,5615,110,104,5224,4212,4360,4315,4768
61969,91,286,44267,17702,2.80171e+13,172.716,2890.15,61969,229,175,52366,43234,24292,28154,34593
15149,171,201,10817,4332,2.7985e+13,168.667,1400.28,15149,144,131,14848,11707,13642,13678,14649
70133,22,301,50092,20041,2.8016e+13,172.901,3082.55,70133,244,175,43862,31194,11931,7364,11163
16789,126,204,11999,4790,2.79433e+13,169.47,1476.45,16789,148,134,15178,12587,10290,9741,12310
71500,8,800,51165,20335,2.70215e+13,217.491,4081.49,71500,789,180,29938,14188,8216,5372,3203
26584,126,222,18988,7596,2.80019e+13,171.09,1867.69,26584,165,152,24102,19956,16324,13445,19539
28554,85,226,20402,8152,2.7993e+13,171.32,1937.94,28554,169,156,23767,19904,10308,10217,14907
77306,66,314,55215,22091,2.80137e+13,172.973,3242.92,77306,257,175,61872,51147,22190,17654,31510
28675,44,225,20490,8185,2.7978e+13,171.256,1940.95,28675,169,156,21429,16934,6464,7910,8792
7828,67,188,5591,2237,2.81493e+13,163.409,1001.14,7828,121,112,6230,5171,2338,3461,3449
31588,107,231,22566,9022,2.79966e+13,171.518,2040.54,31588,175,161,27556,23160,15266,17417,20363
62717,193,432,44772,17945,2.81475e+13,172.91,3095.67,62717,229,192,62281,62142,44869,35210,55993
62195,100,286,44429,17766,2.79899e+13,172.777,2895.39,62195,230,175,53558,45175,27779,25790,37515
16246,143,204,11605,4641,2.80454e+13,169.271,1452.55,16246,147,133,15146,12231,11966,13218,13447
88201,449,951,63064,25137,2.73133e+13,256.868,4620.2,88201,805,183,86914,86298,75559,77273,83646
73062,771,800,52286,20776,2.70297e+13,220.703,4115.2,73062,798,175,72262,72042,66183,69229,72176
82547,468,944,59034,23513,2.72515e+13,228.488,4500.12,82547,782,197,81406,81059,78182,79033,80151
40200,5,390,28685,11515,2.82682e+13,172.259,2493.32,40200,188,184,12495,4463,2719,2138,929
20135,135,211,14373,5762,2.80759e+13,170.01,1620.62,20135,153,140,18524,15141,13451,14251,15810
59368,38,281,42401,16967,2.79876e+13,172.652,2826.16,59368,224,175,43022,33700,12332,13645,15314
63321,619,800,45319,18002,2.69008e+13,214.589,3898.42,63321,786,180,62468,62068,59358,60888,61978
41266,291,800,29562,11704,2.632e+13,219.44,3332.77,41266,798,174,40061,39598,34586,36889,38923
3849,95,181,2748,1101,2.79477e+13,152.444,698.957,3849,101,94,3197,2689,1662,1972,2202
98746,303,353,70530,28216,2.80169e+13,173.202,3685.95,98746,296,175,98393,98393,95715,97062,98343
94693,47,800,67721,26972,2.72757e+13,236.007,4549.76,94693,798,175,71034,57092,21502,26207,29359
64215,220,290,45870,18345,2.80041e+13,172.752,2943.94,64215,233,175,63925,63925,59881,61930,63855
49362,5,264,35258,14104,2.80274e+13,172.404,2569.56,49362,207,175,15356,5451,3305,2856,1210
39477,90,800,28284,11193,2.62074e+13,214.172,3280.66,39477,798,171,32472,27018,14762,13214,19764
20064,90,210,14329,5735,2.79787e+13,170.066,1616.79,20064,153,140,16876,13977,7856,7610,11017
57208,182,278,40857,16351,2.80254e+13,172.578,2773.3,57208,220,175,56930,56930,51126,54081,56834
11032,145,194,7880,3152,2.79888e+13,166.814,1192.38,11032,133,123,10274,8295,8230,9086,9109
59193,12,281,42280,16913,2.80108e+13,172.678,2822.19,59193,224,175,29215,18515,8779,4170,3911
43106,115,252,30791,12315,2.80056e+13,172.193,2395.15,43106,195,175,38283,31919,22669,20454,29091
61008,205,284,43576,17432,2.79991e+13,172.735,2866.67,61008,227,175,60724,60724,56054,58428,60645
44096,238,254,31495,12601,2.80155e+13,172.272,2423.69,44096,197,175,43842,43842,43478,43636,43826
54170,52,272,38692,15478,2.8009e+13,172.506,2695.51,54170,215,175,41682,33789,13462,15979,18712
99678,832,951,71264,28414,2.73833e+13,227.409,4837.76,99678,800,196,98727,98727,93945,96229,98371
77890,25,315,55634,22256,2.80115e+13,172.961,3255.53,77890,258,175,50828,37042,13258,9171,14149
82133,108,323,58661,23472,2.80182e+13,173.053,3347.42,82133,266,175,71961,60260,40107,39253,53835
62202,228,286,44427,17775,2.79981e+13,172.726,2895.32,62202,229,175,61916,61916,58686,60316,61858
39015,203,245,27864,11151,2.80335e+13,171.987,2275.41,39015,188,174,38770,38770,36636,37703,38728
53661,572,800,38423,15238,2.67187e+13,215.667,3666,53661,798,175,52732,52367,47556,49985,52177
83174,171,324,59416,23758,2.79993e+13,173.007,3368.34,83174,267,175,82258,64482,73176,78131,81580
74787,73,310,53420,21367,2.80065e+13,172.988,3188.06,74787,253,175,60786,49875,23810,18158,33576
52421,154,800,37534,14887,2.66631e+13,221.26,3634.45,52421,798,175,49204,38989,42236,43766,44107
32605,209,233,23289,9316,2.8e+13,171.618,2074.26,32605,176,163,32372,32372,31459,31895,32348
10826,635,800,7805,3021,2.25259e+13,186.806,2065.84,10826,650,115,10026,10011,8909,7141,2106
28754,196,226,20538,8216,2.80089e+13,171.256,1944.46,28754,169,155,28528,28528,27190,27849,28498
49634,223,264,35454,14180,2.80241e+13,172.471,2576.53,49634,207,175,49370,49370,47319,48342,49329
98847,418,495,70586,28261,2.80864e+13,173.34,3874.2,98847,295,192,98352,98352,94924,94281,97808
40984,147,248,29273,11711,2.7999e+13,172.09,2333.32,40984,191,175,38720,31012,31131,32462,34894
13531,119,199,9661,3870,2.8085e+13,168.141,1323.39,13531,142,128,12044,10018,7504,8213,9488
16753,85,204,11967,4786,2.79698e+13,169.389,1474.72,16753,147,134,13925,11663,6047,6010,8738
71910,253,447,51342,20568,2.81283e+13,173.106,3308.74,71910,246,193,71463,71342,55989,48819,65645
61139,253,285,43668,17471,2.80198e+13,172.713,2870.5,61139,228,175,60854,60854,59400,60117,60822
35926,222,239,25659,10267,2.8014e+13,171.828,2180.36,35926,182,168,35687,35687,35241,35439,35670
53142,33,270,37956,15186,2.80103e+13,172.518,2668.63,53142,213,175,37066,28339,9817,12897,13430
7492,41,187,5358,2134,2.78324e+13,163.537,978.954,7492,121,111,5494,4329,1596,1111,1916
35205,145,238,25144,10061,2.80198e+13,171.733,2157.84,35205,181,167,33107,26572,26359,29192,29484
46544,227,258,33247,13297,2.8e+13,172.295,2491.66,46544,201,175,46286,46286,44889,45576,46255
19174,76,208,13692,5482,2.80292e+13,169.585,1578.89,19174,151,138,15652,13026,6422,8863,9234
62411,113,287,44577,17834,2.80082e+13,172.686,2901.06,62411,229,175,55208,46241,32522,36347,42140
11280,160,194,8066,3214,2.79474e+13,167.413,1205.63,11280,135,124,10801,8573,9787,10449,10277
58425,379,800,41790,16635,2.71934e+13,223.751,3606.97,58425,589,175,57625,57285,50000,36945,1488
58388,34,280,41701,16687,2.80112e+13,172.736,2802.86,58388,223,175,41038,32815,11026,10456,13794
96985,9,349,69272,27713,2.80088e+13,173.168,3650.55,96985,292,175,42436,20527,12101,10354,6448
52957,157,270,37828,15129,2.80178e+13,172.508,2664.23,52957,213,175,50995,40272,46240,47282,47909
94215,250,344,67302,26913,2.79998e+13,173.214,3595.74,94215,288,175,93871,93871,88171,91073,93777
2912,62,180,2078,834,2.85278e+13,146.12,608.065,2912,92,89,2256,1880,844,955,1185
72975,249,306,52123,20852,2.80073e+13,172.946,3146.85,72975,249,175,72669,72669,69515,71107,72612
96911,10,350,69219,27692,2.80186e+13,173.168,3650.17,96911,292,175,44337,24017,13326,6481,5195
73894,282,307,52780,21114,2.79867e+13,172.923,3166.68,73894,250,175,73587,73587,72589,73073,73562
93602,241,483,66840,26762,2.80944e+13,173.279,3766.48,93602,299,184,93119,92998,83188,81680,90159
44407,79,254,31722,12685,2.79873e+13,172.229,2431.71,44407,197,175,36553,30490,15074,14334,20985
79047,288,317,56458,22589,2.8013e+13,172.993,3280.6,79047,260,175,78730,78730,77468,78086,78701
75099,35,459,53610,21489,2.81357e+13,173.106,3387.08,75099,252,195,53231,42324,14393,7523,16414
62824,245,287,44883,17941,2.79831e+13,172.773,2910.27,62824,231,175,62537,62537,60379,61459,62495
47302,180,259,33792,13510,2.79829e+13,172.353,2512.27,47302,203,175,47043,47043,42364,44741,46964
14925,79,201,10664,4261,2.80088e+13,168.807,1390.53,14925,144,130,12245,10222,5052,5166,7244
90523,317,338,64660,25863,2.80111e+13,173.152,3521.93,90523,281,175,90185,90185,89485,89814,90164
14793,455,800,10658,4135,2.32238e+13,225.476,2359.75,14793,721,130,13811,13173,12615,13061,12958
44223,138,254,31586,12637,2.80114e+13,172.238,2426.95,44223,197,175,41083,33307,30890,30122,35285
73356,150,307,52397,20959,2.80116e+13,172.962,3155.75,73356,250,175,69774,55532,56968,58949,63732
72641,96,305,51887,20754,2.79985e+13,172.929,3138.96,72641,248,175,62055,50938,30224,28556,42214
48131,119,261,34381,13750,2.8007e+13,172.354,2535.35,48131,204,175,43083,35736,26638,23389,33731
76785,658,800,54936,21849,2.7087e+13,238.45,4194.27,76785,798,175,75889,75701,67303,71614,75560
26831,6,222,19172,7659,2.79645e+13,171.023,1875.91,26831,165,152,9449,3579,2372,2180,998
42177,213,250,30119,12058,2.80349e+13,172.055,2367.87,42177,193,175,41927,41927,40146,41031,41890
88515,183,334,63223,25292,2.80023e+13,173.122,3480.39,88515,277,175,88181,88181,78627,83512,88030
11369,84,340,8098,3271,2.87312e+13,168.065,1384.61,11369,146,141,9377,7929,3521,2658,4900
3241,172,180,2312,929,2.81079e+13,148.795,641.244,3241,96,89,3049,2491,2983,3017,3003
37665,188,242,26906,10759,2.79915e+13,171.91,2233.94,37665,186,172,37423,37423,34447,35946,37369
31101,18,231,22212,8889,2.80412e+13,171.39,2025,31101,173,160,18046,12828,5243,3053,4243
69581,149,300,49702,19879,2.80116e+13,172.904,3069.93,69581,243,175,66057,52676,53669,58295,60105
66695,268,294,47645,19050,2.79845e+13,172.814,3002.17,66695,238,175,66401,66401,65326,65848,66375
51586,609,800,36934,14652,2.66499e+13,220.883,3612.94,51586,748,180,50751,50351,49506,49925,50213
97994,41,494,69975,28019,2.80823e+13,173.337,3858.62,97994,309,179,72284,56867,20406,24167,28740
98550,646,800,70477,28073,2.7304e+13,228.172,4621.95,98550,798,178,97653,97471,89798,93730,97289
78973,83,316,56417,22556,2.79982e+13,173.017,3278.38,78973,260,175,65613,54959,27908,37553,40968
60409,271,429,43120,17289,2.81624e+13,172.878,3039.7,60409,225,192,59980,59860,48260,45354,56412
41734,53,250,29816,11918,2.8012e+13,172.183,2356.08,41734,193,175,32207,26466,10199,9760,14237
50086,60,265,35777,14309,2.80271e+13,172.456,2588.73,50086,208,175,39483,32225,13412,12724,19322
88157,174,800,63063,25094,2.72184e+13,224.667,4424.46,88157,798,180,86590,69124,75710,80589,84670
24078,20,218,17203,6875,2.79865e+13,170.879,1775.99,24078,161,148,14567,10304,4097,2437,3646
39074,33,245,27910,11164,2.80236e+13,171.924,2276.87,39074,188,174,27250,20841,7230,5194,8421
19800,28,210,14142,5658,2.79463e+13,170.071,1606.27,19800,153,140,13259,9937,3364,3865,3994
60673,186,284,43338,17335,2.80214e+13,172.715,2859.05,60673,227,175,60389,60389,54467,57480,60291
11736,175,195,8384,3352,2.79773e+13,167.177,1229.7,11736,135,125,11541,11541,10896,11196,11521
61652,79,285,44035,17617,2.80104e+13,172.662,2881.93,61652,228,175,50779,42348,20897,28776,30728
82758,23,324,59110,23648,2.80107e+13,173.082,3360.74,82758,267,175,52511,38307,14074,8843,12992
17005,186,205,12148,4857,2.80106e+13,169.416,1486.3,17005,148,135,16800,16800,16258,16504,16781
87865,47,333,62763,25102,2.80075e+13,173.138,3467.25,87865,276,175,66448,53202,20216,24169,27987
18045,26,207,12883,5162,2.80506e+13,169.434,1531.98,18045,149,136,11897,8741,3091,2373,3409
85241,315,478,60859,24382,2.81131e+13,173.218,3605.85,85241,270,195,84763,84750,79157,72440,80880
97239,328,350,69463,27776,2.80051e+13,173.206,3656.14,97239,293,175,96889,96889,96109,96478,96867
32056,174,232,22895,9161,2.80139e+13,171.561,2056.16,32056,175,161,31768,25386,28590,30223,31615
41174,128,248,29411,11763,2.79826e+13,172.048,2338.42,41174,191,175,37507,30936,25603,22168,30874
23804,103,217,17003,6801,2.79894e+13,170.735,1765.04,23804,160,146,20596,17442,10770,10057,14573
58467,34,280,41765,16702,2.80071e+13,172.655,2804.5,58467,223,175,41100,32867,11054,7936,13047
20682,170,351,14748,5934,2.84563e+13,170.658,1815.94,20682,162,158,20143,15996,10756,7042,16808
84547,45,327,60393,24154,2.79942e+13,173.084,3398.04,84547,270,175,63482,50431,18806,25236,26997
5552,54,184,3968,1584,2.7972e+13,159.88,841.412,5552,110,104,4257,3501,1401,1278,1869
77586,152,315,55414,22172,2.80142e+13,173.013,3249.54,77586,258,175,74074,58737,62218,66677,67981
49078,66,263,35056,14022,2.80203e+13,172.411,2561.44,49078,206,175,39253,32454,14105,13598,20918
93090,375,483,66471,26619,2.81022e+13,173.263,3757.53,93090,298,177,92607,92607,91593,90582,91574
19595,206,209,14003,5592,2.79585e+13,170.113,1597.5,19595,153,139,19386,19386,19372,19375,19383
37441,185,242,26742,10699,2.8001e+13,171.966,2227.43,37441,185,172,37199,37199,34074,35650,37142
77453,78,314,55321,22132,2.8006e+13,172.984,3245.9,77453,257,175,63665,53061,25956,24839,36879
58063,216,279,41474,16589,2.80079e+13,172.64,2794.21,58063,222,175,57784,57784,54228,56027,57721
17553,17,206,12531,5022,2.80668e+13,169.242,1510.26,17553,148,135,9959,7077,2954,1724,2273
91105,287,339,65074,26031,2.80129e+13,173.126,3533.45,91105,282,175,90766,90766,87946,89365,90714
87422,297,332,62442,24980,2.80045e+13,173.119,3457.81,87422,275,175,87090,87090,85425,86250,87055
14008,20,199,10008,4000,2.8003e+13,168.385,1345.67,14008,142,129,8468,5999,2393,1983,1765
66145,228,293,47252,18893,2.79894e+13,172.796,2989.22,66145,237,175,65852,65852,62125,64012,65787
75762,109,455,54091,21671,2.81013e+13,173.116,3396.69,75762,258,192,66448,55749,33159,29014,45839
55230,65,274,39450,15780,2.79889e+13,172.611,2722.84,55230,217,175,44076,36428,15276,18900,23808
61406,270,285,43857,17549,2.80103e+13,172.698,2876.43,61406,228,175,61121,61121,60829,60956,61106
34929,168,237,24950,9979,2.79953e+13,171.729,2148.66,34929,180,167,34265,26922,30786,32774,33362
67547,187,296,48249,19298,2.79984e+13,172.878,3022.72,67547,239,175,67251,67251,60541,63965,67142
99746,254,498,71223,28523,2.8093e+13,173.317,3893.9,99746,296,193,99248,99127,69830,54235,90244
90037,46,337,64313,25724,2.80106e+13,173.147,3511.8,90037,280,175,67852,54359,20371,24615,28839
75354,372,800,53914,21440,2.70764e+13,220.073,4164.05,75354,798,175,74205,73625,67090,70343,73250
60158,322,432,42945,17213,2.81559e+13,172.946,3038.03,60158,225,195,59726,59713,53343,54291,59103
22029,77,213,15738,6291,2.79628e+13,170.459,1695.42,22029,157,144,18008,15039,7441,8121,10764
4829,70,183,3444,1385,2.81659e+13,156.303,783.563,4829,106,100,3851,3210,1530,2171,2198
1444,96,176,1038,406,2.71046e+13,118.008,423.82,1444,68,65,1152,995,639,638,841
75232,23,310,53733,21499,2.80056e+13,172.95,3197.05,75232,253,175,47736,34820,12791,11843,11037
91146,223,339,65103,26043,2.80142e+13,173.146,3534.32,91146,282,175,90807,90807,83654,87304,90691
98130,299,800,70188,27942,2.72888e+13,261.071,4614.28,98130,798,175,96830,96359,84384,90287,95613
55617,202,274,39726,15891,2.7979e+13,172.589,2731.97,55617,217,175,55343,55343,51149,53278,55271
58745,3,281,41958,16787,2.80159e+13,172.667,2811.84,58745,224,175,12325,2762,2555,3187,1025
38156,88,243,27255,10901,2.8004e+13,171.913,2249,38156,187,172,32020,26610,14661,14320,20591
77998,239,315,55708,22290,2.80107e+13,172.983,3257.79,77998,258,175,77683,77683,73225,75488,77607
25347,9,220,18107,7240,2.80131e+13,170.934,1822.82,25347,163,149,11094,5367,3158,1971,1341
14168,151,199,10120,4048,2.79053e+13,168.473,1353.42,14168,142,129,13409,10694,11116,10959,12125
4702,113,182,3365,1337,2.77583e+13,157.366,772.982,4702,106,99,4080,3451,2445,2383,3048
85495,131,473,61044,24451,2.80987e+13,173.196,3606.43,85495,286,180,78360,64451,50947,45284,63286
28291,6,225,20209,8082,2.79995e+13,171.197,1927.96,28291,168,155,9978,3788,2508,2105,1952
73434,429,800,52540,20894,2.70442e+13,226.508,4123.29,73434,798,175,72329,71708,64465,68346,71521
31698,175,231,22642,9056,2.79794e+13,171.481,2043.8,31698,174,161,31467,31467,28375,29934,31411
66058,159,293,47183,18875,2.79943e+13,172.785,2987.25,66058,236,175,63890,50487,57701,55236,60029
79797,354,800,57084,22713,2.71339e+13,246.357,4256.13,79797,781,175,78754,78234,68309,50484,1750
93569,266,343,66832,26737,2.80231e+13,173.107,3582.69,93569,286,175,93226,93226,88727,91010,93149
76449,188,312,54606,21843,2.80054e+13,172.963,3223.69,76449,255,175,76137,76137,68415,72358,76013
43773,151,800,31358,12415,2.64273e+13,217.958,3404.25,43773,659,175,40768,32452,32878,34913,35717
7941,179,188,5676,2265,2.79078e+13,164.243,1008.71,7941,123,112,7753,7753,7636,7684,7744
92835,464,483,66282,26553,2.81096e+13,173.212,3752.82,92835,283,192,92352,92352,91931,92123,92333
84829,219,468,60574,24255,2.81169e+13,173.201,3587.76,84829,283,190,84361,84238,72995,69081,80780
62363,276,287,44539,17824,2.80117e+13,172.677,2899.97,62363,229,175,62076,62076,61907,61981,62065
22659,104,215,16188,6471,2.79994e+13,170.54,1720.95,22659,158,144,19644,16596,10455,9826,13982
34094,113,236,24358,9736,2.79911e+13,171.746,2122.74,34094,179,166,30105,25237,17766,16067,22788
42378,8,800,30358,12020,2.63536e+13,217.749,3364.39,42378,798,175,17833,8664,4846,3104,3245
90193,146,337,64429,25764,2.79996e+13,173.137,3514.72,90193,280,175,85187,68296,68108,71362,76599
21091,36,213,15064,6027,2.80315e+13,170.244,1659.66,21091,155,142,15039,11926,4273,3112,4953
89313,73,335,63793,25520,2.79948e+13,173.105,3496.2,89313,278,175,72614,59580,28475,27663,39838
1903,25,177,1363,540,2.74494e+13,132.233,488.836,1903,78,73,1220,890,316,300,268
60306,11,283,43077,17229,2.80028e+13,172.685,2849.61,60306,227,175,28675,17663,8833,5133,6320
97059,106,349,69334,27725,2.79975e+13,173.198,3651.9,97059,293,175,84681,71223,46356,43210,61552
1890,7,178,1342,548,2.84593e+13,130.325,487.798,1890,81,77,727,305,210,151,83
41287,200,398,29465,11822,2.82299e+13,172.365,2531.91,41287,195,186,40889,40751,30778,22784,36407
29751,143,227,21253,8498,2.79552e+13,171.331,1977.95,29751,171,158,27848,22449,21955,21749,24773
92311,435,800,66019,26292,2.7258e+13,257.626,4504.87,92311,796,175,91156,90550,79506,85338,90358
62804,191,288,44856,17948,2.80235e+13,172.735,2910.76,62804,231,175,62516,62516,56642,59634,62419
38999,58,384,27842,11157,2.82108e+13,172.349,2453.05,38999,196,174,30558,25094,10055,7190,13481
89976,59,336,64274,25702,2.79983e+13,173.12,3509.6,89976,279,175,70789,57740,23787,34324,35042
14663,48,200,10480,4183,2.79234e+13,168.703,1377.49,14663,144,131,11091,8935,3419,2904,4493
20165,21,210,14404,5761,2.79433e+13,170.05,1620.76,20165,153,140,12416,8851,3429,2795,2266
67273,143,295,48057,19216,2.79785e+13,172.836,3015.7,67273,239,175,63141,50810,49694,49222,55339
63857,20,289,45610,18247,2.80112e+13,172.701,2935.01,63857,232,175,38677,27369,10867,9714,11175
64182,66,290,45847,18335,2.79987e+13,172.755,2943.25,64182,233,175,51358,42458,18458,18846,26052
35414,37,238,25298,10116,2.80055e+13,171.799,2164.15,35414,181,168,25453,20026,7312,5001,8385
87800,263,333,62708,25092,2.80106e+13,173.033,3465.75,87800,275,175,87467,87467,83414,85470,87397
84750,322,327,60540,24210,2.80019e+13,173.108,3402.05,84750,271,175,84423,84423,84384,84396,84418
59467,25,282,42472,16995,2.80215e+13,172.59,2829.35,59467,224,175,38813,28282,10139,7663,10775
38252,618,800,27410,10842,2.62001e+13,208.411,3244.12,38252,782,168,37402,37002,34561,35947,36906
67369,246,296,48117,19252,2.80118e+13,172.761,3018.61,67369,238,175,67073,67073,64375,65734,67023
59568,246,282,42548,17020,2.80165e+13,172.679,2831.85,59568,225,175,59286,59286,57581,58424,59250
48851,124,263,34891,13960,2.80122e+13,172.456,2555.63,48851,206,175,44151,36527,29758,30200,35784
27235,399,800,19543,7692,2.54457e+13,210.289,2884.16,27235,765,148,26181,25592,23735,24843,25232
2064,86,178,1481,583,2.74898e+13,137.209,510.35,2064,79,75,1642,1415,780,821,1099
57017,203,277,40725,16292,2.80081e+13,172.632,2767.93,57017,220,175,56740,56740,52415,54611,56666
42133,80,250,30101,12032,2.79907e+13,172.179,2366.9,42133,194,175,34748,29227,14408,12238,20799
49397,230,263,35285,14112,2.79961e+13,172.327,2569.12,49397,206,175,49134,49134,47600,48358,49101
55645,735,800,39836,15809,2.67631e+13,211.338,3715.1,55645,798,175,54845,54647,50873,52786,54651
71606,290,304,51154,20452,2.80158e+13,172.942,3116.55,71606,247,175,71302,71302,71051,71156,71288
65288,289,292,46635,18653,2.80096e+13,172.786,2969.69,65288,235,175,64996,64996,64981,64984,64993
84121,640,951,60141,23980,2.7284e+13,232.262,4539.19,84121,814,196,83061,82884,74715,65667,74854
26169,25,221,18697,7472,2.79725e+13,170.891,1851.99,26169,164,151,17064,12430,4438,5357,5058
25655,163,221,18329,7326,2.80005e+13,171.133,1834.82,25655,164,150,24894,19611,22443,23965,23975
98003,270,351,70001,28002,2.80037e+13,173.205,3670.79,98003,294,175,97652,97652,92854,95292,97571
89194,64,485,63685,25509,2.81047e+13,173.253,3687.72,89194,277,192,71059,58912,23766,20610,34308
58787,385,800,42086,16701,2.68007e+13,213.614,3791.71,58787,782,180,57704,57087,54254,55609,56742
22451,79,214,16039,6412,2.79327e+13,170.504,1712.28,22451,157,144,18441,15407,7647,7268,10847
80000,87,319,57148,22852,2.80013e+13,173.046,3301.6,80000,262,175,67039,55813,30386,29123,42544
56083,731,800,40146,15937,2.67674e+13,217.115,3726.11,56083,769,180,55283,55117,53610,54337,55077
30401,182,229,21713,8688,2.79921e+13,171.422,2000.92,30401,172,159,30172,30172,27726,28952,30125
29034,91,227,20739,8295,2.80492e+13,171.361,1954.8,29034,170,156,24491,20235,11347,8960,15668
51186,216,266,36559,14627,2.79914e+13,172.391,2616.73,51186,209,175,50920,50920,48230,49583,50870
13530,36,199,9670,3860,2.79723e+13,168.53,1323.66,13530,142,128,9629,7632,2735,2485,3308
81868,276,322,58474,23394,2.80074e+13,173.042,3341.18,81868,265,175,81546,81546,79133,80343,81500
63529,204,289,45380,18149,2.80117e+13,172.775,2927.91,63529,232,175,63240,63240,58176,60750,63155
20635,3,212,14743,5892,2.80027e+13,170.354,1641.33,20635,155,141,4331,968,898,1120,358
37665,27,242,26906,10759,2.79915e+13,171.91,2233.94,37665,186,172,25039,18654,6413,4579,7135
18560,128,208,13260,5300,2.80003e+13,169.967,1554.61,18560,151,138,16838,13913,11517,10202,13806
70397,380,445,50259,20138,2.81329e+13,173.062,3275.95,70397,243,193,69952,69952,66437,68214,69887
74687,24,309,53347,21340,2.80025e+13,172.928,3184.95,74687,252,175,48061,35241,12701,8118,12591
25395,102,220,18137,7258,2.80101e+13,170.917,1824.64,25395,163,150,21925,18512,11439,10674,15480
38191,75,243,27281,10910,2.79968e+13,171.998,2250.24,38191,186,172,31148,25734,12619,8882,16985
40393,21,247,28854,11539,2.80078e+13,172.086,2316.07,40393,190,175,24887,17744,6875,4170,6226
32493,183,233,23203,9290,2.80315e+13,171.655,2070.88,32493,176,163,32260,32260,29595,30935,32210
20231,163,284,14440,5791,2.81721e+13,167.993,1710.64,20231,157,139,19539,15467,17539,18731,18635
9901,160,192,7069,2832,2.80432e+13,166.247,1128.66,9901,129,120,9469,7526,8576,9153,8917
80324,279,320,57370,22954,2.80287e+13,172.971,3308.91,80324,262,175,80004,80004,77953,78976,79963
76296,202,312,54496,21800,2.80099e+13,172.991,3220.66,76296,255,175,75984,75984,69226,72673,75874
10519,190,193,7514,3005,2.79885e+13,166.736,1163.89,10519,131,122,10326,10326,10314,10316,10323
7971,82,189,5692,2279,2.81916e+13,164.175,1011.32,7971,123,113,6547,5520,2826,2815,3992
27904,148,224,19933,7971,2.79943e+13,171.126,1914.06,27904,167,154,26364,21103,21285,22135,23685
7568,90,188,5405,2163,2.80929e+13,163.794,984.765,7568,121,111,6311,5245,2951,2615,4009
89464,209,336,63903,25561,2.80106e+13,173.126,3500.07,89464,279,175,89128,89128,81208,85252,89001
87916,224,333,62795,25121,2.80105e+13,173.085,3467.97,87916,276,175,87583,87583,80908,84311,87474
44620,221,254,31870,12750,2.79735e+13,172.215,2437.44,44620,197,175,44366,44366,42824,43588,44333
76221,27,312,54441,21780,2.80098e+13,172.955,3219.03,76221,255,175,50698,37762,12981,9251,14995
77890,476,800,55726,22164,2.71005e+13,244.971,4217.26,77890,721,177,76929,76553,75792,76135,76118
45712,56,257,32654,13058,2.80261e+13,172.312,2469.24,45712,200,175,35623,29241,11532,13487,16869
56790,109,277,40563,16227,2.80184e+13,172.575,2762.35,56790,220,175,49847,41764,27955,32151,37469
26689,203,223,19066,7623,2.8013e+13,171.171,1872.34,26689,166,152,26466,26466,25863,26140,26446
98946,133,353,70679,28267,2.80044e+13,173.216,3689.59,98946,296,175,91159,74572,64016,64574,76539
1786,42,177,1277,509,2.78284e+13,131.06,474.832,1786,74,72,1284,1029,401,384,491
58495,94,280,41783,16712,2.80105e+13,172.683,2805.21,58495,223,175,49766,40898,23598,20363,33154
49792,231,264,35566,14226,2.80059e+13,172.413,2580.25,49792,207,175,49528,49528,48006,48758,49495
98339,325,352,70239,28100,2.80111e+13,173.217,3677.89,98339,295,175,97987,97987,96880,97419,97960
11925,161,195,8518,3407,2.79945e+13,167.273,1239.43,11925,135,125,11456,9080,10365,11060,10893
34823,161,237,24874,9949,2.80037e+13,171.636,2145.51,34823,180,167,33724,26594,30394,32544,31944
94495,97,494,67472,27023,2.80926e+13,173.326,3795.15,94495,296,192,80881,68509,38377,33151,52979
68372,97,298,48834,19538,2.80189e+13,172.859,3042.12,68372,241,175,58556,49545,28824,27612,40113
75955,177,461,54227,21728,2.81189e+13,173.14,3406.41,75955,254,196,75473,75336,37937,18765,63419
47671,132,260,34046,13625,2.80085e+13,172.348,2522.6,47671,203,175,43797,35909,30500,29053,36980
63713,78,289,45509,18204,2.80037e+13,172.743,2931.92,63713,232,175,52361,43639,21329,21820,30894
74856,123,309,53476,21380,2.79976e+13,172.979,3188.47,74856,253,175,67584,55998,44910,39932,54443
77510,192,314,55364,22146,2.79999e+13,172.993,3247.07,77510,257,175,77196,77196,69622,73489,77074
30970,58,230,22122,8848,2.80052e+13,171.417,2020.02,30970,173,160,24261,19868,8159,6982,11218
73416,565,945,52511,20905,2.71754e+13,230.161,4311.48,73416,765,197,72384,71943,70378,70926,71331
42926,230,251,30660,12266,2.79721e+13,172.159,2389.22,42926,194,175,42675,42675,41949,42293,42654
64683,182,291,46200,18483,2.80104e+13,172.772,2955.39,64683,234,175,64392,64392,57682,61106,64283
65653,663,800,46990,18663,2.69339e+13,215.648,3951.87,65653,787,180,64844,64651,61823,63253,64443
17537,89,206,12523,5014,2.80362e+13,169.401,1509.57,17537,149,135,14702,12211,6840,6669,9445
29888,177,228,21350,8538,2.7992e+13,171.349,1983.29,29888,171,158,29660,29660,26911,28292,29609
50826,171,265,36304,14522,2.7993e+13,172.376,2606.97,50826,209,175,50202,39384,44880,47779,49550
40143,8,247,28665,11478,2.80349e+13,171.91,2308.74,40143,189,175,16698,7635,4649,3130,3379
57755,705,800,41342,16413,2.67946e+13,214.96,3766.89,57755,776,180,56955,56766,54737,55753,56671
22658,163,215,16180,6478,2.80006e+13,170.657,1720.93,22658,158,145,21971,17319,19825,18975,21037
44271,237,397,31602,12669,2.81589e+13,172.535,2612.7,44271,212,176,43874,43753,40728,38256,42173
34267,85,236,24478,9789,2.79978e+13,171.742,2127.79,34267,179,166,28548,23894,12390,13609,18097
56818,580,800,40681,16137,2.67656e+13,214.732,3744.02,56818,798,175,55897,55519,50691,53129,55358
18219,95,207,13016,5203,2.80068e+13,169.642,1539.37,18219,150,137,15473,12760,7532,7636,10392
31240,50,230,22318,8922,2.79884e+13,171.621,2028.84,31240,174,161,23840,19290,7484,8807,10514
78831,293,316,56303,22528,2.80094e+13,172.967,3275.36,78831,259,175,78515,78515,77665,78070,78492
31808,73,231,22713,9095,2.798e+13,171.453,2047.19,31808,174,161,25824,21208,10166,11502,14819
83249,21,324,59459,23790,2.80045e+13,173.025,3370.01,83249,267,175,51320,36580,14159,12655,11292
92350,167,800,66061,26289,2.72373e+13,259.257,4505.25,92350,675,175,89667,70531,79040,84333,86053
22624,69,215,16164,6460,2.80117e+13,170.541,1719.52,22624,158,144,18186,14993,6704,6226,9815
38513,227,243,27519,10994,2.79674e+13,171.971,2259.08,38513,187,174,38270,38270,37874,38047,38254
20645,102,211,14742,5903,2.8044e+13,170.008,1640.47,20645,154,141,17808,15053,9338,11110,12800
95495,144,347,68203,27292,2.80138e+13,173.113,3621.55,95495,289,175,89847,72151,70933,78666,79319
62950,548,800,45055,17895,2.68826e+13,219.071,3889.91,62950,798,175,61984,61640,55817,58766,61394
51462,192,267,36764,14698,2.80191e+13,172.453,2624.72,51462,210,175,51195,51195,46838,49046,51120
33147,186,234,23676,9471,2.80094e+13,171.572,2091.94,33147,177,164,32913,32913,30348,31638,32865
60530,280,283,43232,17298,2.79923e+13,172.642,2854.49,60530,226,175,60247,60247,60235,60237,60244
17720,120,206,12661,5059,2.79929e+13,169.551,1517.46,17720,149,135,15840,13131,9893,10038,12604
52292,137,407,37332,14960,2.81639e+13,172.724,2826.23,52292,224,177,48418,39413,33243,31699,40187
89010,234,335,63583,25427,2.80095e+13,173.103,3490.47,89010,278,175,88675,88675,82542,85667,88574
50394,147,265,35999,14395,2.80066e+13,172.472,2596.38,50394,209,175,47623,38136,38300,42012,43204
97942,28,351,69960,27982,2.80039e+13,173.186,3669.58,97942,294,175,65689,49231,16667,11694,18194
64044,333,800,45841,18203,2.69048e+13,216.054,3915.14,64044,798,175,62870,62335,56661,59381,61817
60277,265,283,43055,17222,2.8007e+13,172.719,2848.98,60277,226,175,59994,59994,59492,59719,59976
19363,83,209,13832,5531,2.79954e+13,169.962,1588.07,19363,152,138,16044,13454,6869,6818,9714
4122,44,181,2947,1175,2.7804e+13,154.71,723.09,4122,102,95,3048,2422,953,670,1167
90776,107,380,64838,25938,2.80214e+13,172.958,3575.95,90776,281,175,79364,66599,37731,30911,36743
63016,602,800,45104,17912,2.6879e+13,235.354,3891.23,63016,704,175,62183,61783,61533,61632,61622
40747,57,248,29104,11643,2.80236e+13,172.109,2326.78,40747,191,175,31849,26065,10836,7709,14342
84971,482,800,60781,24190,2.71951e+13,223.904,4361.56,84971,798,175,83921,83621,76372,80044,83217
66787,264,295,47706,19081,2.8005e+13,172.846,3005.25,66787,238,175,66492,66492,65104,65785,66461
74665,250,800,53419,21246,2.70604e+13,225.513,4149.33,74665,798,175,73382,72937,65307,68841,72061
59906,197,421,42770,17136,2.81545e+13,172.859,3020.27,59906,224,192,59485,59359,45688,36493,53873
81746,211,471,58362,23384,2.80973e+13,173.162,3531.18,81746,263,195,81275,81151,55299,32860,70732
9272,105,191,6624,2648,2.79408e+13,165.568,1091.17,9272,127,117,7981,6771,4362,4156,5784
17392,48,205,12427,4965,2.79459e+13,169.464,1502.77,17392,149,135,13166,10610,4049,3294,5275
88754,312,800,63490,25264,2.72162e+13,233.077,4436.16,88754,780,180,87600,87000,84119,85287,86440
94274,83,800,67432,26842,2.72624e+13,242.734,4542.08,94274,771,180,77601,65097,32725,26443,46502
80081,799,800,57286,22795,2.71537e+13,220.669,4262.87,80081,798,180,79281,79117,79179,79179,79278
59454,196,281,42464,16990,2.80134e+13,172.577,2827.98,59454,224,175,59173,59173,54109,56683,59088
13450,130,198,9612,3838,2.79503e+13,168.29,1318.58,13450,142,128,12233,10100,8442,8009,10234
16107,32,203,11505,4602,2.79902e+13,169.137,1445.35,16107,146,132,11129,8438,2956,3092,3797
18171,634,800,13069,5102,2.42375e+13,219.278,2521.5,18171,734,136,17365,17193,16505,16854,16874
63028,176,288,45018,18010,2.8011e+13,172.738,2915.73,63028,231,175,62740,62740,55839,59359,62628
30097,38,229,21498,8599,2.8055e+13,171.379,1991.02,30097,172,158,21791,17082,6273,4553,7501
22551,129,215,16109,6442,2.80212e+13,170.488,1716.79,22551,158,144,20536,16965,14098,14146,16994
35854,103,239,25614,10240,2.80231e+13,171.799,2178.14,35854,182,169,31038,26285,16228,15160,22084
5038,91,183,3600,1438,2.80031e+13,158.39,800.973,5038,110,100,4191,3490,1993,1937,2736
37906,4,242,27073,10833,2.79807e+13,171.802,2240.54,37906,185,172,9932,3015,2195,2670,1405
93548,28,343,66822,26726,2.80038e+13,173.167,3582.46,93548,286,175,62737,47017,15922,15743,20182
52761,245,270,37686,15075,2.80338e+13,172.496,2659.43,52761,213,175,52491,52491,51529,51991,52466
74365,328,453,53093,21272,2.8118e+13,173.093,3366,74365,250,193,73912,73912,67378,66141,72903
58894,12,281,42066,16828,2.80311e+13,172.689,2815.4,58894,224,175,29079,18437,8740,4155,3699
1308,49,176,939,369,2.72331e+13,116.035,405.764,1308,63,64,946,783,331,365,446
73886,286,307,52778,21108,2.7984e+13,172.941,3166.63,73886,250,175,73579,73579,72853,73197,73558
73401,294,306,52437,20964,2.79848e+13,172.959,3155.71,73401,250,175,73095,73095,72894,72980,73083
69151,119,299,49392,19759,2.80046e+13,172.875,3059.79,69151,242,175,61956,51354,38255,33548,48305
81209,222,321,58002,23207,2.80145e+13,173.055,3327.39,81209,264,175,80888,80888,74890,77945,80789
97340,47,350,69528,27812,2.80108e+13,173.179,3657.85,97340,293,175,73624,58953,22394,27638,31569
83040,228,324,59315,23725,2.79987e+13,173.054,3365.96,83040,267,175,82716,82716,76910,79867,82620
79086,22,800,56577,22509,2.7134e+13,218.232,4242.43,79086,798,178,49178,35310,13278,8609,12466
10079,111,193,7199,2880,2.80366e+13,166.364,1139.36,10079,131,120,8798,7398,5174,5820,6639
83710,253,325,59800,23910,2.79999e+13,173.087,3379.98,83710,269,175,83385,83385,79182,81314,83313
63085,224,288,45062,18023,2.80035e+13,172.749,2917.01,63085,231,175,62797,62797,59167,61003,62733
44145,67,254,31527,12618,2.80226e+13,172.126,2424.75,44145,196,175,35390,29211,12823,14407,18912
19536,146,209,13956,5580,2.79781e+13,170.045,1595.05,19536,152,139,18370,14759,14688,15397,16455
77299,87,800,55310,21989,2.70873e+13,218.657,4205.24,77299,798,180,64013,53415,28723,23987,39552
8562,98,189,6113,2449,2.79558e+13,164.789,1047.43,8562,123,114,7281,6176,3757,3697,5170
63787,124,435,45539,18248,2.81411e+13,172.94,3121.76,63787,246,177,57606,47728,36780,36073,45149
5882,74,185,4206,1676,2.81741e+13,160.96,866.987,5882,113,105,4725,3910,1915,1716,2637
32026,167,232,22874,9152,2.79785e+13,171.563,2055.13,32026,175,162,31346,24676,28205,26911,30653
43638,44,253,31168,12470,2.80094e+13,172.258,2410.48,43638,196,175,32626,25785,9852,8931,12753
29438,49,228,21022,8416,2.80661e+13,171.147,1968.54,29438,170,157,22401,18151,6973,8552,9769
80287,279,320,57348,22939,2.80135e+13,173.037,3308.25,80287,263,175,79967,79967,77931,78947,79926
59067,137,281,42185,16882,2.80158e+13,172.709,2819.46,59067,224,175,54796,44493,40225,40138,47030
41509,153,249,29650,11859,2.80146e+13,172.09,2348.86,41509,192,175,39633,31404,34061,35922,36328
41532,187,249,29662,11870,2.79957e+13,172.076,2349.4,41532,192,175,41283,41283,37796,39560,41221
84795,427,800,60661,24134,2.71634e+13,219.75,4357.94,84795,798,180,83708,83049,77166,80350,82876
93673,326,344,66909,26764,2.80221e+13,173.15,3585.64,93673,287,175,93329,93329,92842,93060,93311
81711,275,321,58368,23343,2.79905e+13,173.049,3337.25,81711,265,175,81390,81390,78960,80180,81344
98634,164,497,70430,28204,2.80929e+13,173.331,3872.79,98634,294,192,96201,75589,74124,71176,87558
32003,220,232,22861,9142,2.80031e+13,171.605,2054.62,32003,175,161,31771,31771,31575,31661,31759
35277,11,238,25192,10085,2.80185e+13,171.657,2160.06,35277,180,167,16770,10336,5172,2937,3463
84870,261,328,60617,24253,2.80171e+13,173.039,3405.2,84870,270,175,84542,84542,80708,82650,84475
80384,173,800,57506,22878,2.71407e+13,219.906,4269.06,80384,798,175,78705,62401,68823,73254,77064
47696,111,261,34064,13632,2.8047e+13,172.273,2524.25,47696,203,175,41995,35157,24432,27604,31602
2897,16,179,2071,826,2.78971e+13,147.433,605.757,2897,93,84,1594,1124,471,314,367
76811,356,458,54839,21972,2.81171e+13,173.188,3420.94,76811,255,193,76353,76353,70667,69560,75468
54781,10,273,39130,15651,2.80076e+13,172.564,2711,54781,216,175,25062,13574,7532,4465,5175
46551,248,258,33253,13298,2.79958e+13,172.309,2491.82,46551,201,175,46293,46293,46153,46213,46283
41910,235,392,29916,11994,2.81965e+13,172.42,2543.82,41910,207,179,41518,41397,37206,33754,39425
32825,110,233,23445,9380,2.79967e+13,171.512,2080.61,32825,176,163,28834,24189,16573,15201,21393
16526,152,204,11805,4721,2.80218e+13,169.303,1464.7,16526,147,133,15678,12480,13202,14128,14434
27155,101,223,19400,7755,2.79835e+13,171.119,1888.22,27155,166,152,23406,19757,12177,10254,16297
92399,29,487,65975,26424,2.81021e+13,173.297,3749.22,92399,293,192,62474,47094,15769,10325,16933
18774,190,208,13408,5366,2.80038e+13,169.852,1563.23,18774,151,138,18566,18566,18063,18289,18548
96838,24,800,69258,27580,2.7272e+13,228.261,4589.94,96838,798,180,61985,45751,16286,17588,17811
74411,30,308,53148,21263,2.79966e+13,172.888,3178.14,74411,251,175,50709,38343,12816,10906,17699
7841,110,188,5606,2235,2.79227e+13,164.167,1002.41,7841,122,111,6821,5746,3938,3625,5050
86904,162,331,62078,24826,2.80029e+13,173.123,3447.06,86904,275,175,84558,66579,76011,81436,80758
42176,19,399,30098,12078,2.82023e+13,172.33,2557.34,42176,208,184,24981,17826,7217,3767,4255
42327,89,250,30234,12093,2.79688e+13,172.127,2372.05,42327,193,175,35595,29524,16494,14970,22388
83491,48,325,59634,23857,2.80059e+13,173.083,3375.67,83491,268,175,63367,51007,19330,21444,27876
49457,134,264,35318,14139,2.80306e+13,172.363,2571.94,49457,206,175,45585,37253,32711,34418,38692
27394,50,223,19574,7820,2.79705e+13,171.158,1896.2,27394,167,154,20905,16920,6566,5107,8804
60425,257,283,43167,17258,2.79943e+13,172.78,2852.63,60425,227,175,60142,60142,59066,59588,60116
5126,118,184,3659,1467,2.80993e+13,159.168,808.893,5126,110,101,4486,3759,2850,3094,3581
45392,44,256,32420,12972,2.80065e+13,172.264,2459.63,45392,199,175,33943,26830,10228,12163,13989
56928,64,277,40662,16266,2.7995e+13,172.641,2765.8,56928,220,175,45334,37549,15634,19383,23888
56823,244,277,40587,16236,2.80121e+13,172.655,2763.43,56823,220,175,56546,56546,55028,55777,56513
42233,150,251,30165,12068,2.80378e+13,172.101,2370.4,42233,194,175,40107,31956,32771,35642,36524
53662,261,271,38332,15330,2.80118e+13,172.519,2682.37,53662,214,175,53391,53391,53246,53308,53381
49793,207,264,35571,14222,2.8011e+13,172.411,2580.31,49793,207,175,49529,49529,46401,47978,49472
92824,35,342,66298,26526,2.80099e+13,173.109,3568.09,92824,284,175,65778,52369,17810,13282,21001
28490,159,225,20345,8145,2.79818e+13,171.155,1934.52,28490,168,155,27476,21755,24825,23788,25861
28232,72,225,20164,8068,2.80231e+13,171.204,1926.2,28232,168,155,22864,18816,8821,10103,13073
55787,696,800,39900,15887,2.72628e+13,218.897,3489.84,55787,537,175,54987,54906,48288,51713,30616
42282,179,251,30205,12077,2.80252e+13,172.195,2372.04,42282,194,175,42031,42031,37880,39982,41959
56728,142,276,40519,16209,2.7982e+13,172.596,2760.06,56728,219,175,53133,42842,41491,41402,46417
21829,63,214,15590,6239,2.80256e+13,170.53,1689.09,21829,157,143,17299,14302,5968,5687,8721
64578,203,440,46102,18476,2.81365e+13,173.05,3145.08,64578,248,191,64138,64009,53746,49262,60587
49492,60,264,35346,14146,2.80278e+13,172.378,2572.73,49492,206,175,39024,31845,13276,12574,18987
50356,9,265,35966,14390,2.8011e+13,172.436,2595.23,50356,208,175,22030,10650,6280,4371,4779
46612,603,950,33357,13255,2.66662e+13,214.671,3672.22,46612,757,187,45617,45195,43965,44319,44621
56554,238,277,40392,16162,2.80358e+13,172.554,2756.98,56554,219,175,56277,56277,54362,55315,56238
68886,115,299,49201,19685,2.80183e+13,172.859,3054.12,68886,242,175,61207,51036,36274,40873,47094
4169,119,181,2986,1183,2.76593e+13,155.278,727.475,4169,103,96,3640,3062,2310,2051,2833
12350,120,196,8824,3526,2.80002e+13,167.665,1262.09,12350,137,126,11006,9140,6902,6580,8675
69545,105,800,49764,19781,2.69916e+13,224.449,4038.93,69545,798,175,59709,50404,31719,29746,42167
2933,27,179,2097,836,2.77946e+13,147.558,609.602,2933,92,85,1928,1445,513,385,573
38444,133,243,27467,10977,2.79846e+13,171.99,2257.28,38444,187,174,35347,28947,24867,22667,29670
68468,269,298,48903,19565,2.80105e+13,172.872,3044.41,68468,241,175,68170,68170,66929,67536,68141
63864,90,289,45620,18244,2.79926e+13,172.75,2935.25,63864,233,175,53854,44556,24941,24077,34810
4333,39,182,3093,1240,2.79781e+13,156.247,743.093,4333,104,98,3130,2457,922,857,1119
32032,177,232,22881,9151,2.80042e+13,171.502,2055.43,32032,175,161,31800,31800,28764,30296,31745
56798,77,800,40611,16187,2.74121e+13,180.529,3436.56,56798,465,175,46250,38581,18808,12488,508
30272,166,229,21624,8648,2.80276e+13,171.414,1996.78,30272,172,159,29566,23323,26616,28357,28613
45637,6,256,32602,13035,2.79857e+13,172.222,2465.95,45637,199,175,16082,6095,4038,3710,1712
30362,266,370,21659,8703,2.832e+13,171.58,2177.82,30362,174,169,29992,29872,21850,19007,28000
44303,76,254,31647,12656,2.79989e+13,172.205,2428.94,44303,197,175,36229,30098,14770,15020,21070
52841,497,800,37833,15008,2.66884e+13,218.459,3645.01,52841,798,175,51832,51549,46056,48833,51132
35118,179,951,25145,9973,2.62608e+13,207.568,3336.61,35118,783,163,33643,33154,28035,28293,31340
25248,29,220,18036,7212,2.80281e+13,170.949,1819.49,25248,163,150,17051,12874,4311,3426,5062
57247,79,277,40886,16361,2.80088e+13,172.563,2773.08,57247,220,175,47145,39322,19416,26724,28572
79742,209,318,56957,22785,2.80054e+13,173.004,3295.43,79742,261,175,79424,79424,72722,76140,79315
66666,205,295,47613,19053,2.80221e+13,172.728,3002.31,66666,237,175,66371,66371,60967,63716,66281
99799,180,354,71279,28520,2.79992e+13,173.202,3705.53,99799,297,175,99445,99445,88323,94016,99271
91330,18,339,65234,26096,2.8021e+13,173.098,3537.65,91330,282,175,53011,37664,15379,12074,14643
65449,317,432,46727,18722,2.81429e+13,172.964,3154.88,65449,234,193,65017,65017,60241,57941,63179
12803,113,197,9143,3660,2.80541e+13,167.908,1285.71,12803,139,127,11249,9452,6662,6444,8552
94442,407,800,67554,26888,2.72587e+13,224.449,4545.25,94442,798,180,93349,92678,87709,90418,92461
99641,204,354,71172,28469,2.80168e+13,173.193,3702.88,99641,297,175,99287,99287,89824,94662,99137
1998,83,178,1423,575,2.85404e+13,135.366,502.635,1998,78,77,1584,1358,712,664,954
83899,228,326,59928,23971,2.80124e+13,173.046,3384.52,83899,269,175,83573,83573,77624,80654,83475
27056,184,223,19322,7734,2.80234e+13,170.98,1884.58,27056,165,152,26833,26833,24883,25857,26794
15334,582,800,11043,4291,2.3451e+13,224.03,2387.58,15334,753,127,14469,14109,13014,13520,13880
49637,344,800,35547,14090,2.65928e+13,220.826,3562.45,49637,743,180,48539,47954,46748,47165,47469
1971,45,178,1403,568,2.85035e+13,131.599,497.665,1971,82,77,1447,1182,479,499,629
47720,22,260,34094,13626,2.79886e+13,172.42,2524.14,47720,204,175,29837,21214,8107,6983,6491
38071,35,242,27192,10879,2.8e+13,171.834,2245.48,38071,185,172,26968,21475,7327,9373,9706
81371,225,321,58125,23246,2.80002e+13,173.064,3330.67,81371,264,175,81050,81050,75227,78193,80954
55591,31,275,39705,15886,2.80098e+13,172.642,2732.36,55591,218,175,38172,28941,9972,11166,13510
87947,320,333,62821,25126,2.80086e+13,173.092,3468.72,87947,276,175,87614,87614,87374,87476,87601
51478,42,267,36768,14710,2.80077e+13,172.466,2625.02,51478,210,175,38129,30150,11092,13513,15469
2423,12,178,1729,694,2.76018e+13,141.25,552.535,2423,85,81,1185,753,359,209,286
85914,307,330,61363,24551,2.80273e+13,173.055,3427.11,85914,272,175,85584,85584,84755,85150,85561
42041,143,391,30008,12033,2.82226e+13,172.457,2545.32,42041,204,176,39324,31751,28730,30165,33701
72927,222,306,52088,20839,2.80065e+13,172.886,3145.8,72927,248,175,72621,72621,67614,70160,72537
5017,81,183,3585,1432,2.7952e+13,158.124,799.369,5017,107,101,4090,3462,1764,1781,2419
65141,122,800,46620,18521,2.69229e+13,230.378,3939.99,65141,744,180,57807,47961,36629,31332,44815
16205,541,800,11670,4535,2.35894e+13,221.698,2429.61,16205,734,133,15307,14980,14210,14558,14628
55527,182,275,39655,15872,2.8032e+13,172.545,2730.83,55527,217,175,55252,55252,49661,52506,55159
64567,266,800,46215,18352,2.69159e+13,237.846,3927.16,64567,794,175,63291,62857,54626,58524,62036
58308,159,279,41653,16655,2.79965e+13,172.644,2799.84,58308,222,175,56381,44555,50929,52079,53267
66253,39,294,47327,18926,2.79842e+13,172.845,2992.66,66253,237,175,48366,37841,14007,15462,17731
1696,14,177,1213,483,2.78938e+13,126.693,461.814,1696,76,73,884,602,257,199,227
59681,278,282,42629,17052,2.80059e+13,172.691,2834.44,59681,225,175,59399,59399,59376,59382,59395
66635,271,295,47594,19041,2.80309e+13,172.823,3001.81,66635,238,175,66340,66340,65443,65873,66316
14841,186,201,10602,4239,2.80346e+13,168.872,1386.67,14841,144,130,14640,14640,14323,14462,14625
10242,61,192,7323,2919,2.78791e+13,166.359,1147.48,10242,131,121,8043,6604,2801,2456,3895
85234,255,473,60857,24377,2.81072e+13,173.174,3600.57,85234,278,192,84761,84640,75362,71346,80718
75612,135,311,54006,21606,2.80138e+13,172.942,3205.71,75612,254,175,69901,56978,50570,53569,59671
85230,133,328,60880,24350,2.80028e+13,173.109,3412.3,85230,271,175,78503,64223,55151,58220,66476
16334,186,204,11662,4672,2.80754e+13,168.892,1455.99,16334,146,133,16130,16130,15622,15851,16112
31583,105,231,22556,9027,2.80233e+13,171.495,2040.32,31583,174,161,27441,23151,14817,14397,20027
36058,35,240,25755,10303,2.80168e+13,171.846,2185.19,36058,183,169,25531,20332,6858,4986,8130
37002,5,241,26433,10569,2.80098e+13,171.871,2213.63,37002,184,170,11509,4082,2477,2141,982
9293,45,191,6643,2650,2.78777e+13,165.729,1092.81,9293,127,117,6938,5520,2088,2313,2723
22585,26,215,16130,6455,2.80289e+13,170.356,1718.16,22585,157,144,14894,10941,3862,2960,4228
5410,125,184,3863,1547,2.80559e+13,159.784,831.016,5410,110,103,4800,4028,3265,2936,3923
60224,52,283,43017,17207,2.80036e+13,172.729,2847.88,60224,226,175,46341,37555,14592,12561,20672
39295,53,245,28068,11227,2.80021e+13,172.016,2283.35,39295,188,174,30328,24925,9616,11310,13671
96646,344,800,69118,27528,2.72898e+13,233.086,4586.64,96646,798,175,95433,94878,85867,90320,94354
65272,7,292,46626,18646,2.80144e+13,172.79,2969.23,65272,235,175,25256,10151,7079,5440,3051
57336,157,277,40957,16379,2.79726e+13,172.614,2775.28,57336,221,175,55236,43609,50074,51204,51129
23128,168,216,16517,6611,2.79613e+13,170.657,1739.13,23128,159,146,22632,17807,20471,21705,21943
65177,140,800,46643,18534,2.69275e+13,213.917,3940.87,65177,792,180,59859,48434,45190,44969,50966
4964,122,183,3551,1413,2.79386e+13,158.344,795.488,4964,107,100,4365,3667,2872,2664,3494
81000,603,800,57948,23052,2.71446e+13,225.274,4281.47,81000,785,180,80132,79732,77043,78395,79609
90840,207,339,64882,25958,2.80265e+13,173.093,3528.61,90840,281,175,90501,90501,82262,86470,90369
3146,21,180,2243,903,2.81959e+13,147.391,631.022,3146,94,89,1932,1383,547,365,492
73184,164,306,52280,20904,2.79985e+13,172.968,3151.25,73184,250,175,71444,56058,64083,68592,69093
88264,637,800,63139,25125,2.72093e+13,255.556,4426.59,88264,795,175,87317,87143,76654,82045,86976
60409,39,283,43147,17262,2.80087e+13,172.691,2852,60409,226,175,44102,34506,12154,12258,17089
35810,62,238,25578,10232,2.79986e+13,171.711,2175.87,35810,181,168,28376,23234,9764,15402,14682
80091,474,800,57304,22787,2.71292e+13,243.437,4263.36,80091,741,180,79123,78749,77686,78180,78313
23107,19,215,16511,6596,2.79318e+13,170.686,1737.63,23107,159,146,13687,9764,3930,2466,3626
95245,126,346,68034,27211,2.80001e+13,173.163,3616.16,95245,289,175,86551,71612,58552,48107,70272
36175,111,240,25842,10333,2.80235e+13,171.856,2188.69,36175,183,169,31839,26650,18500,17033,23824
94764,276,345,67691,27073,2.79936e+13,173.146,3606.43,94764,288,175,94419,94419,90438,92455,94350
19382,24,209,13849,5533,2.79825e+13,170.025,1588.93,19382,153,139,12450,9139,3296,2253,3321
92141,36,483,65794,26347,2.81044e+13,173.274,3741.25,92141,282,192,65811,52111,18653,8276,18506
22816,92,215,16300,6516,2.79795e+13,170.631,1726.84,22816,158,144,19276,15896,8988,7692,12671
3377,146,180,2416,961,2.79344e+13,151.097,654.679,3377,98,90,3057,2513,2489,2722,2767
87950,38,333,62820,25130,2.80093e+13,173.098,3468.67,87950,276,175,63744,49933,17816,13215,22034
76054,307,311,54331,21723,2.79953e+13,172.983,3214.8,76054,255,175,75743,75743,75718,75725,75739
79389,292,317,56704,22685,2.80022e+13,172.965,3287.35,79389,260,175,79072,79072,78082,78560,79047
39942,381,800,28622,11320,2.62689e+13,216.31,3294.5,39942,798,172,38833,38276,33875,36079,37885
8905,33,191,6352,2553,2.80808e+13,164.831,1069.63,8905,125,116,6195,4745,1672,1988,2202
29772,178,228,21270,8502,2.80254e+13,171.365,1979.63,29772,171,158,29544,29544,26881,28219,29494
70673,427,442,50459,20214,2.81366e+13,172.988,3277.25,70673,243,192,70231,70231,69966,70089,70216
99798,249,355,71287,28511,2.8015e+13,173.228,3706.73,99798,298,175,99443,99443,92978,96271,99337
71712,164,800,51314,20398,2.70241e+13,234.61,4086.34,71712,749,180,68965,54217,60775,64885,64686
59592,377,424,42550,17042,2.81232e+13,171.716,3017.34,59592,230,175,59168,59168,59144,59140,59110
90497,82,338,64644,25853,2.80004e+13,173.159,3521.32,90497,281,175,75030,62976,31780,31625,45799
52508,122,269,37507,15001,2.80107e+13,172.483,2652.23,52508,212,175,47310,39177,30470,30106,38079
62096,90,287,44351,17745,2.80346e+13,172.695,2894.03,62096,229,175,52374,43326,24249,30449,34365
41357,187,249,29534,11823,2.80188e+13,172,2344.52,41357,191,175,41108,41108,37601,39375,41046
89345,362,479,63794,25551,2.80982e+13,173.272,3685.79,89345,277,193,88866,88866,81789,85402,88749
59593,209,281,42572,17021,2.79764e+13,172.686,2831.41,59593,225,175,59312,59312,55109,57241,59240
91588,467,800,65505,26083,2.72457e+13,237.341,4490.77,91588,776,180,90593,90226,87727,88965,89789
7359,152,188,5259,2100,2.79719e+13,164.075,972.097,7359,121,110,6895,5519,5826,6220,6340
65459,206,292,46757,18702,2.80075e+13,172.775,2973.19,65459,235,175,65167,65167,60035,62644,65081
78573,427,457,56104,22469,2.81299e+13,173.168,3454.24,78573,258,192,78116,78116,76985,77535,78086
32763,142,233,23405,9358,2.79895e+13,171.516,2078.79,32763,176,163,30643,24730,23946,22952,26851
83265,240,325,59477,23788,2.80177e+13,173.07,3371.4,83265,268,175,82940,82940,77902,80460,82855
57386,129,278,40986,16400,2.80194e+13,172.521,2777.25,57386,220,175,52416,43241,35898,36025,43297
29359,102,227,20974,8385,2.79976e+13,171.35,1965.3,29359,171,157,25353,21417,13245,12561,18018
3185,15,180,2276,909,2.81603e+13,149.842,636.034,3185,95,90,1717,1191,504,434,416
78602,25,316,56137,22465,2.80086e+13,172.995,3270.86,78602,259,175,51293,37375,13382,10825,16432
86830,328,331,62022,24808,2.80106e+13,173.093,3445.58,86830,274,175,86499,86499,86489,86490,86496
93879,138,343,67060,26819,2.80011e+13,173.161,3588.5,93879,286,175,87312,70751,65672,67873,75172
73937,18,308,52810,21127,2.80162e+13,172.923,3168.5,73937,251,175,42910,30492,12451,7773,11076
54225,514,800,38821,15404,2.67134e+13,211.076,3679.6,54225,782,175,53271,52931,50138,51527,52567
77279,687,800,55286,21993,2.71216e+13,218.832,4204.88,77279,798,175,76452,76238,70657,73514,76141
71141,100,302,50816,20325,2.79891e+13,172.893,3104.66,71141,245,175,61277,51685,31789,29899,42890
10793,163,193,7717,3076,2.78779e+13,166.782,1178.44,10793,132,122,10396,8231,9454,10028,9830
14572,162,201,10407,4165,2.81173e+13,168.49,1374.07,14572,144,130,14046,11126,12691,13543,13325
44948,653,800,32199,12749,2.64287e+13,209.253,3436.43,44948,794,175,44122,43938,40617,42306,43708
91788,177,340,65568,26220,2.8007e+13,173.158,3547.16,91788,283,175,91448,91448,81099,86394,91285
2290,79,178,1641,649,2.77293e+13,140.806,538.615,2290,85,77,1819,1542,783,695,1032
16787,167,205,11998,4789,2.79886e+13,169.603,1477.27,16787,148,134,16350,12903,14843,15716,15865
59156,138,281,42252,16904,2.80093e+13,172.657,2821.4,59156,224,175,54981,44566,41359,40520,47189
14224,93,199,10161,4063,2.79439e+13,168.465,1356,14224,142,129,12007,9933,5710,5912,8143
60895,130,432,43470,17425,2.8155e+13,172.904,3053.13,60895,226,192,55661,45888,30052,22680,41331
63117,93,800,45172,17945,2.69119e+13,222.24,3893.94,63117,767,180,52790,43619,24445,20433,33809
87420,129,332,62442,24978,2.80035e+13,173.109,3457.72,87420,275,175,79908,65879,54675,48076,65983
2350,10,179,1676,674,2.84602e+13,139.8,545.291,2350,85,80,1075,590,330,154,130
37043,214,241,26464,10579,2.80016e+13,171.896,2215.03,37043,184,170,36802,36802,35676,36224,36775
1362,74,176,978,384,2.72899e+13,115.517,412.384,1362,67,63,1044,890,489,446,653
78050,308,315,55753,22297,2.79992e+13,172.951,3258.7,78050,258,175,77735,77735,77664,77691,77728
73901,45,308,52784,21117,2.80088e+13,172.985,3167.93,73901,251,175,55479,44074,16485,15239,22124
43272,28,253,30907,12365,2.80153e+13,172.203,2400.44,43272,196,175,29005,21747,7368,5421,8371
13845,102,199,9891,3954,2.80173e+13,168.309,1338.03,13845,142,129,11905,10078,6254,6232,8481
42984,162,252,30699,12285,2.80196e+13,172.205,2391.95,42984,195,175,41744,32909,37569,40215,39934
66763,208,295,47692,19071,2.80066e+13,172.821,3004.63,66763,238,175,66468,66468,61302,63928,66381
94183,125,344,67280,26903,2.79989e+13,173.187,3595.06,94183,288,175,85402,70807,57448,50591,69415
72174,252,304,51554,20620,2.80002e+13,172.884,3128.07,72174,247,175,71870,71870,69045,70467,71818
42633,134,251,30451,12182,2.80058e+13,172.149,2381.23,42633,194,175,39306,32109,28182,28345,33484
54576,62,273,38979,15597,2.80199e+13,172.473,2706.07,54576,215,175,43273,35429,14859,17297,21913
87135,249,332,62241,24894,2.80014e+13,173.131,3452.42,87135,275,175,86803,86803,81916,84398,86720
64434,42,800,46114,18320,2.69212e+13,231.707,3924.05,64434,738,180,47172,37512,13615,9765,16527
4463,144,182,3189,1274,2.80145e+13,156.006,753.399,4463,106,98,4068,3333,3274,3592,3651
91974,634,800,65781,26193,2.72523e+13,223.259,4498.26,91974,798,180,91083,90911,84411,87747,90677
76889,202,313,54921,21968,2.80063e+13,172.966,3233.56,76889,256,175,76576,76576,69738,73226,76465
38041,160,243,27172,10869,2.8011e+13,171.908,2245.55,38041,186,172,36793,29054,33195,35560,34892
19675,87,210,14056,5619,2.80021e+13,170.167,1601.53,19675,153,140,16421,13702,7456,7191,10496
62103,121,286,44361,17742,2.80133e+13,172.735,2893.21,62103,229,175,55829,46230,35245,37857,44115
76484,14,312,54639,21845,2.79981e+13,173.015,3224.55,76484,256,175,40373,27515,11612,9539,9823
10075,53,192,7201,2874,2.79501e+13,166.094,1137.72,10075,129,120,7743,6378,2480,2697,3456
89199,160,336,63707,25492,2.80275e+13,173.085,3495.1,89199,278,175,86463,68185,77961,83570,81742
16433,129,204,11737,4696,2.80347e+13,169.126,1460.43,16433,147,133,14929,12352,10275,10324,12430
88245,630,800,63123,25122,2.72168e+13,221.393,4426.11,88245,798,180,87357,87188,81162,84262,86935
68856,120,298,49189,19667,2.79876e+13,172.865,3052.52,68856,241,175,61792,51139,38471,35530,48301
4753,29,183,3398,1355,2.79635e+13,158.044,778.341,4753,107,100,3188,2414,822,642,1008
54891,69,273,39207,15684,2.79951e+13,172.569,2713.64,54891,216,175,44211,36404,16141,19207,24429
12387,173,196,8855,3532,2.79505e+13,167.861,1264.37,12387,139,126,12151,9679,11324,11741,12114
28327,134,225,20232,8095,2.80136e+13,171.177,1929.19,28327,168,155,26092,21324,18716,18835,22201
67308,193,296,48074,19234,2.80183e+13,172.878,3017.49,67308,239,175,67012,67012,60741,63936,66909
71069,129,303,50765,20304,2.80016e+13,172.941,3104.28,71069,246,175,64924,53543,44439,42147,53508
15275,18,202,10911,4364,2.80215e+13,168.993,1407.5,15275,145,132,8858,6291,2584,1750,2280
61587,180,285,43992,17595,2.79965e+13,172.747,2880.69,61587,229,175,61302,61302,54864,58148,61197
86417,497,800,61815,24602,2.72027e+13,245.757,4390.45,86417,798,175,85343,85064,75169,80207,84708
70874,56,800,50714,20160,2.6998e+13,239.27,4067.9,70874,723,177,54613,44981,17500,18680,24563
13900,184,338,9909,3991,2.86051e+13,168.861,1509.96,13900,148,143,13551,13414,8253,5447,11625
51961,560,950,37183,14778,2.68124e+13,211.201,3813.92,51961,813,192,50884,50522,46510,42357,46499
25265,192,220,18046,7219,2.79981e+13,170.984,1819.9,25265,163,150,25045,25045,23891,24452,25017
53998,146,272,38568,15430,2.80121e+13,172.603,2691.43,53998,215,175,50942,40864,40748,42689,45668
37577,9,242,26841,10736,2.80196e+13,171.866,2231.21,37577,185,171,16447,7955,4690,2441,1741
64378,708,945,46050,18328,2.70298e+13,232.124,4110.41,64378,810,177,63406,63171,56114,57365,61477
52524,267,269,37517,15007,2.79941e+13,172.473,2652.67,52524,212,175,52255,52255,52253,52253,52253
49499,74,800,35446,14053,2.65902e+13,226.698,3558.9,49499,794,175,39587,32661,15568,16086,21781
86511,17,330,61798,24713,2.79966e+13,173.077,3438.51,86511,273,175,49111,34869,14554,8293,11628
63578,258,289,45418,18160,2.801e+13,172.778,2929.03,63578,232,175,63289,63289,61918,62591,63258
66817,28,295,47722,19095,2.80177e+13,172.784,3005.65,66817,238,175,44804,33584,11375,7993,12538
37178,229,242,26557,10621,2.80135e+13,171.933,2219.87,37178,185,171,36936,36936,36730,36819,36923
69860,260,300,49896,19964,2.80127e+13,172.837,3075.76,69860,243,175,69560,69560,67562,68559,69520
56050,198,275,40041,16009,2.79864e+13,172.65,2743.39,56050,219,175,55775,55775,51239,53543,55698
14964,50,202,10687,4277,2.80205e+13,168.692,1393.27,14964,144,131,11399,9241,3613,4366,4969
90536,424,800,64763,25773,2.72263e+13,221.964,4470.52,90536,798,180,89442,88779,82645,85955,88608
6642,27,186,4746,1896,2.80029e+13,162.278,921.476,6642,116,107,4398,3282,1142,1236,1386
88281,407,800,63144,25137,2.72232e+13,222.123,4427.04,88281,798,180,87189,86527,81669,84322,86302
57091,148,425,40756,16335,2.81567e+13,172.841,2958.69,57091,219,196,53963,43226,28315,19291,41926
51836,437,951,37091,14745,2.68037e+13,227.983,3811.42,51836,810,192,50605,50000,43811,38785,44737
27596,181,224,19713,7883,2.80108e+13,171.136,1903.76,27596,167,153,27372,27372,25164,26268,27329
37580,783,800,26938,10642,2.6144e+13,218.429,3224.17,37580,785,167,36780,36657,33660,34970,33825
61810,97,286,44152,17658,2.80162e+13,172.728,2886.63,61810,229,175,52903,44784,26067,24982,36304
6308,32,185,4503,1805,2.80799e+13,161.179,897.051,6308,114,107,4346,3303,1184,1537,1507
72489,569,800,51864,20625,2.70511e+13,239.123,4103.17,72489,798,175,71507,71161,62909,67111,70996
65596,254,293,46857,18739,2.80219e+13,172.853,2977.48,65596,236,175,65303,65303,63388,64341,65264
6510,151,334,4621,1889,2.92616e+13,163.641,1080.35,6510,127,124,5959,4906,3611,2861,4624
15606,129,800,11242,4364,2.34032e+13,222.162,2400.53,15606,747,128,13249,11052,8476,7243,9768
13923,154,199,9944,3979,2.8073e+13,168.217,1341.98,13923,142,129,13225,10506,11656,12126,12206
23423,105,217,16730,6693,2.8072e+13,170.558,1750.88,23423,160,146,20336,17165,10992,12839,14762
70736,46,302,50528,20208,2.80061e+13,172.909,3096.28,70736,245,175,53297,42703,16029,19332,22128
4727,207,333,3386,1341,2.62713e+13,146.222,942.228,4727,105,98,4394,4394,4337,4303,4273
32193,228,232,23004,9189,2.79822e+13,171.682,2060.7,32193,176,162,31961,31961,31936,31943,31957
53301,265,270,38077,15224,2.79901e+13,172.555,2672.7,53301,214,175,53031,53031,52993,53005,53026
79871,394,800,57135,22736,2.71405e+13,218.019,4258.37,79871,798,180,78762,78133,72899,75739,77853
19053,71,208,13609,5444,2.80151e+13,169.647,1574.24,19053,151,138,15382,12667,5875,8553,8622
2989,44,179,2135,854,2.77447e+13,147.707,614.82,2989,92,85,2199,1748,687,501,855
43622,554,800,31248,12374,2.63929e+13,211.436,3399.31,43622,798,175,42691,42347,38522,40450,42084
66397,3,294,47426,18971,2.80041e+13,172.816,2995.72,66397,237,175,13927,3120,2883,3600,1149
30171,88,229,21553,8618,2.79954e+13,171.511,1993.66,30171,172,159,25284,21027,11568,11115,16307
87544,345,800,62629,24915,2.71967e+13,227.731,4412.27,87544,789,180,86415,85793,82428,83931,85357
42238,107,800,30256,11982,2.63577e+13,222.333,3360.67,42238,706,175,36039,30367,19521,21931,25410
20296,133,211,14497,5799,2.79987e+13,170.288,1626.95,20296,154,141,18605,15257,13105,11967,15562
50418,667,800,36103,14315,2.66053e+13,209.197,3582.71,50418,791,175,49608,49412,46260,47867,49220
95728,145,348,68368,27360,2.80133e+13,173.149,3626.8,95728,290,175,90220,72317,71797,79541,80070
17490,169,206,12490,5000,2.80471e+13,169.499,1507.79,17490,149,135,17104,13489,15542,16416,16695
80312,317,319,57366,22946,2.80012e+13,173.005,3307.65,80312,262,175,79993,79993,79989,79989,79991
79645,254,318,56891,22754,2.80042e+13,173.023,3293.58,79645,261,175,79327,79327,75697,77534,79263
40944,173,248,29250,11694,2.80057e+13,172.08,2332.17,40944,191,175,40552,32151,36309,38538,40299
96684,218,349,69065,27619,2.80013e+13,173.21,3645.18,96684,292,175,96335,96335,88177,92343,96204
43935,373,394,31363,12572,2.81948e+13,172.422,2599.17,43935,196,193,43541,43541,43004,43247,43520
2713,131,179,1935,778,2.81284e+13,145.819,586.915,2713,88,85,2364,1999,1688,1605,1950
14532,136,200,10377,4155,2.80007e+13,168.519,1371.05,14532,143,130,13382,10922,9818,9748,11365
96683,577,800,69146,27537,2.73026e+13,224.943,4587.4,96683,798,180,95733,95333,88780,92126,95214
9008,416,800,6518,2490,2.03194e+13,251.889,2020.55,9008,739,108,7981,7398,6279,7008,7055
90639,187,338,64739,25900,2.80109e+13,173.15,3523.99,90639,281,175,90301,90301,80755,85637,90150
90836,293,800,64972,25864,2.72434e+13,233.807,4476.53,90836,798,175,89573,89078,80013,84382,88351
82291,22,323,58785,23506,2.80054e+13,173.066,3350.52,82291,266,175,51470,36599,13995,11610,11223
60077,23,282,42910,17167,2.80089e+13,172.593,2843.26,60077,225,175,38124,27814,10231,10010,8345
87896,439,477,62765,25131,2.81193e+13,173.254,3654.71,87896,275,193,87419,87419,85744,86574,87381
62393,31,287,44563,17830,2.80117e+13,172.661,2900.58,62393,229,175,42861,32489,11204,10860,14322
58496,69,279,41786,16710,2.79859e+13,172.67,2804.25,58496,223,175,47109,38798,17198,20443,26124
10158,160,193,7263,2895,2.79849e+13,166.734,1144.15,10158,131,120,9710,7712,8793,9392,9257
13346,58,198,9532,3814,2.79468e+13,168.164,1313.37,13346,141,128,10425,8544,3525,3760,4828
46550,235,258,33247,13303,2.80328e+13,172.241,2491.78,46550,201,175,46292,46292,45465,45858,46269
10501,66,193,7499,3002,2.80096e+13,166.558,1162.65,10501,131,122,8351,6923,3051,2672,4247
81440,699,800,58266,23174,2.71259e+13,234.433,4290.41,81440,798,175,80587,80361,72245,76416,80338
30116,151,229,21513,8603,2.79998e+13,171.495,1991.91,30116,172,158,28615,22769,23739,25446,26288
41353,228,249,29544,11809,2.7984e+13,172.146,2344.44,41353,192,175,41104,41104,40428,40744,41083
90284,454,478,64466,25818,2.81023e+13,172.406,3700.94,90284,279,188,89806,89806,89074,89420,89782
37525,119,242,26802,10723,2.80172e+13,171.917,2229.83,37525,185,171,33587,27849,20769,21186,26657
6102,53,185,4364,1738,2.79661e+13,160.962,882.611,6102,113,105,4670,3858,1485,1408,2027
21391,190,212,15281,6110,2.79808e+13,170.17,1670.24,21391,155,142,21179,21179,20388,20764,21157
11512,27,195,8227,3285,2.78978e+13,167.385,1218.62,11512,135,125,7634,5687,1961,1620,2421
42509,133,251,30371,12138,2.8008e+13,172.174,2378.01,42509,194,175,39088,32010,27501,26297,32729
39895,163,247,28489,11406,2.80257e+13,171.991,2301.98,39895,189,175,38796,30539,34884,37322,37041
34419,32,237,24588,9831,2.80173e+13,171.793,2133.6,34419,180,166,23806,18040,6308,4680,7570
58237,246,280,41601,16636,2.80016e+13,172.741,2799.5,58237,223,175,57957,57957,56401,57168,57923
71678,90,303,51198,20480,2.80093e+13,172.834,3116.73,71678,246,175,60465,50017,28029,35145,39823
65668,279,292,46910,18758,2.79762e+13,172.801,2977.94,65668,236,175,65376,65376,65138,65239,65363
20880,19,212,14910,5970,2.80317e+13,169.996,1650.43,20880,154,141,12376,8838,3564,2130,2107
92270,139,486,65883,26387,2.81032e+13,173.329,3746.74,92270,283,193,85893,69546,46355,32028,65934
34066,193,235,24327,9739,2.80143e+13,171.587,2120.69,34066,178,165,33831,33831,31685,32758,33789
91689,89,800,65582,26107,2.72341e+13,224.08,4492.56,91689,798,180,76423,63467,35024,31504,46885
8391,134,189,5998,2393,2.79214e+13,164.761,1037.44,8391,125,114,7642,6285,5543,5806,6487
17802,102,207,12712,5090,2.80855e+13,169.304,1521.87,17802,149,136,15332,12976,8067,9573,10980
13530,74,199,9665,3865,2.81181e+13,168.181,1322.99,13530,142,128,10966,9032,4383,3349,6113
27012,218,223,19290,7722,2.797e+13,171.123,1883.03,27012,166,153,26789,26789,26762,26770,26784
61915,16,286,44222,17693,2.80097e+13,172.72,2889.01,61915,229,175,34367,24184,10199,5714,5490
65282,766,800,46722,18560,2.69533e+13,215.884,3943.68,65282,786,180,64482,64311,61771,63050,64381
2718,22,179,1938,780,2.80771e+13,144.847,586.67,2718,90,83,1681,1206,477,313,420
90560,208,337,64688,25872,2.79887e+13,173.132,3521.52,90560,281,175,90223,90223,82149,86274,90094
27241,60,223,19459,7782,2.79778e+13,171.044,1890.76,27241,166,153,21453,17521,7318,7720,10162
15898,10,203,11358,4540,2.80128e+13,169.224,1436.4,15898,146,132,7271,3944,2182,1066,839
4172,61,182,2979,1193,2.80788e+13,155.776,729.022,4172,103,95,3238,2676,1143,1297,1598
70972,642,800,50782,20190,2.70282e+13,234.523,4070.23,70972,798,175,70070,69891,62142,66121,69699
73979,87,307,52841,21138,2.80041e+13,172.89,3168.45,73979,250,175,62001,51624,28148,35738,40131
14506,149,200,10364,4142,2.79831e+13,168.699,1370.27,14506,143,129,13681,10946,11144,12084,12433
68743,254,298,49104,19639,2.80028e+13,172.809,3049.88,68743,241,175,68445,68445,66163,67306,68401
68543,189,298,48958,19585,2.80106e+13,172.839,3045.85,68543,241,175,68245,68245,61535,64959,68136
85290,317,329,60915,24375,2.80294e+13,173.015,3414.15,85290,271,175,84961,84961,84773,84854,84949
47084,91,260,33625,13459,2.80288e+13,172.261,2507.55,47084,202,175,39768,32849,18484,23179,26332
58808,113,800,42096,16712,2.68248e+13,211.869,3792.3,58808,791,175,51179,42921,29586,26504,37867
16679,72,205,11915,4764,2.80178e+13,169.407,1472.44,16679,148,134,13472,11104,5232,5504,7518
21909,127,214,15653,6256,2.79745e+13,170.524,1691.95,21909,157,144,19858,16436,13529,11357,16175
98933,685,800,70758,28175,2.72922e+13,238.03,4628.98,98933,784,180,98133,97935,95297,96632,97789
13729,70,199,9812,3917,2.80182e+13,168.107,1332.38,13729,142,129,11034,9118,4173,3624,5928
80435,214,320,57459,22976,2.80057e+13,173.06,3311.16,80435,263,175,80115,80115,73659,76950,80009
75159,292,310,53687,21472,2.80028e+13,172.986,3195.68,75159,253,175,74849,74849,74339,74569,74831
37291,181,241,26639,10652,2.79777e+13,171.877,2222.02,37291,184,171,37050,37050,33679,35383,36990
95867,603,800,68564,27303,2.72824e+13,224.166,4571.9,95867,798,180,94946,94546,88248,91467,94476
69573,260,443,49669,19904,2.812e+13,173.012,3255.93,69573,244,192,69130,69009,59764,56790,64778
3182,30,179,2274,908,2.79211e+13,148.673,634.348,3182,95,87,2149,1630,556,600,554
10039,117,193,7164,2875,2.80645e+13,166.095,1136.99,10039,130,120,8860,7406,5481,6038,6975
21110,2,212,15085,6025,2.7973e+13,170.187,1659.17,21110,155,142,2825,534,460,1106,238
70165,667,800,50215,19950,2.70059e+13,219.858,4052.75,70165,798,175,69314,69118,63229,66241,68967
37571,146,242,26840,10731,2.80129e+13,171.92,2231.11,37571,185,171,35415,28425,28340,31227,31756
10437,54,193,7454,2983,2.80194e+13,166.429,1158.97,10437,131,121,8046,6615,2586,1952,3499
11767,133,196,8402,3365,2.81551e+13,167.106,1232.62,11767,136,125,10731,8830,7608,8030,9014
94683,273,947,67691,26992,2.73766e+13,231.013,4740.39,94683,796,192,93295,92652,87056,79167,86751
72835,208,448,51999,20836,2.81152e+13,173.063,3329.72,72835,247,192,72387,72263,47109,29736,63115
91661,23,480,65451,26210,2.81056e+13,173.285,3727.84,91661,282,193,58154,42426,15625,9896,14437
11303,27,195,8077,3226,2.80278e+13,167.288,1207.83,11303,135,124,7497,5597,1933,1409,2062
56786,147,277,40560,16226,2.80204e+13,172.626,2762.41,56786,220,175,53681,42982,43165,47351,48522
63086,141,288,45059,18027,2.80075e+13,172.756,2917.01,63086,231,175,58990,47646,45465,50801,52228
24975,134,220,17836,7139,2.80357e+13,170.793,1809.52,24975,162,149,22951,18790,16510,17355,19498
64416,122,290,46010,18406,2.7991e+13,172.737,2948.35,64416,233,175,58043,48076,37391,33490,46206
46277,151,258,33053,13224,2.80216e+13,172.261,2484.62,46277,201,175,44051,35025,36496,39148,40263
21337,92,213,15240,6097,2.80384e+13,170.284,1669.08,21337,156,142,18022,14861,8403,8379,11919
51873,143,268,37053,14820,2.79844e+13,172.512,2635.79,51873,211,175,48648,39164,38307,37943,42737
66914,48,295,47796,19118,2.80066e+13,172.814,3007.88,66914,238,175,50779,40889,15494,11519,20429
43591,220,253,31133,12458,2.80235e+13,172.088,2408.82,43591,196,175,43338,43338,41804,42562,43305
99464,79,354,71044,28420,2.80086e+13,173.214,3699.69,99464,297,175,81957,68321,33649,25954,47601
11395,303,339,8122,3273,2.8678e+13,167.864,1386,11395,134,142,11056,10950,9863,10040,10699
60234,184,283,43029,17205,2.80129e+13,172.703,2847.95,60234,226,175,59951,59951,53956,57009,59852
34526,112,237,24661,9865,2.80488e+13,171.728,2136.66,34526,180,166,30446,25497,17864,20045,23376
16736,139,205,11955,4781,2.80233e+13,169.409,1474.71,16736,148,134,15487,12573,11917,12088,13601
99513,100,354,71084,28429,2.80103e+13,173.194,3700.46,99513,297,175,85760,72307,44449,41821,59719
70761,186,302,50545,20216,2.80061e+13,172.888,3096.78,70761,245,175,70459,70459,63273,66942,70343
65636,522,947,46949,18687,2.70759e+13,213.437,4140.86,65636,813,191,64525,64175,60122,56304,60169
45183,100,255,32279,12904,2.79678e+13,172.292,2453.33,45183,199,175,38879,32813,20198,18747,26813
35335,218,238,25236,10099,2.80163e+13,171.846,2162.02,35335,181,168,35097,35097,34459,34756,35077
94211,94,344,67295,26916,2.80055e+13,173.15,3595.39,94211,287,175,80176,65904,38372,39063,54673
11368,158,195,8119,3249,2.80658e+13,167.071,1210.82,11368,135,124,10850,8652,9832,10521,10163
24739,14,219,17669,7070,2.80244e+13,170.918,1800.6,24739,162,148,13049,8898,3762,2191,2814
10207,65,192,7294,2913,2.79333e+13,166.515,1145.77,10207,131,121,8086,6711,2931,3188,4170
7157,146,187,5113,2044,2.79356e+13,163.108,957.293,7157,119,109,6634,5377,5351,5241,5928
65899,235,293,47075,18824,2.79978e+13,172.83,2983.99,65899,237,175,65606,65606,62360,64000,65548
63245,238,289,45181,18064,2.80039e+13,172.827,2921.75,63245,232,175,62956,62956,60241,61606,62905
61613,324,888,44085,17528,2.69403e+13,210.911,3967.74,61613,802,175,60361,59821,55388,57391,59117
41426,157,249,29587,11839,2.80129e+13,172.154,2346.58,41426,192,175,39863,31493,36153,37483,37177
92685,552,800,66291,26394,2.72559e+13,224.072,4512.17,92685,798,180,91710,91320,84699,88076,91141
97383,202,350,69562,27821,2.80056e+13,173.199,3658.75,97383,294,175,97033,97033,87661,92453,96885
85189,289,468,60827,24362,2.81154e+13,173.183,3593.9,85189,275,192,84721,84603,80850,76344,80632
82246,140,323,58745,23501,2.80156e+13,173.076,3349.72,82246,266,175,76778,61971,58986,62700,67825
45202,111,255,32289,12913,2.79872e+13,172.25,2453.69,45202,198,175,39793,33317,23127,21874,29973
63425,116,289,45304,18121,2.80088e+13,172.765,2925.62,63425,232,175,56450,46987,33502,30204,43584
26868,143,222,19201,7667,2.79522e+13,171.106,1877.3,26868,166,153,25151,20268,19817,19631,22098
70140,12,301,50103,20037,2.80132e+13,172.845,3082.57,70140,244,175,34629,21944,10402,6105,7824
72399,66,800,51801,20598,2.70438e+13,220.706,4101.47,72399,784,180,57230,47468,20361,14696,27749
76202,346,944,54499,21703,2.72037e+13,240.645,4369.56,76202,798,193,74848,74328,65247,69340,73238
55086,263,274,39345,15741,2.80314e+13,172.603,2719.46,55086,217,175,54812,54812,54652,54720,54801
4435,125,182,3169,1266,2.79695e+13,156.574,751.428,4435,103,99,3910,3291,2685,2388,3127
38013,160,243,27145,10868,2.80168e+13,171.769,2244.66,38013,185,172,36765,29041,33170,35534,34655
17890,154,206,12779,5111,2.79865e+13,169.557,1524.62,17890,149,136,17054,13516,15016,15300,15730
54655,68,272,39039,15616,2.79949e+13,172.507,2707.04,54655,216,175,43921,36258,16023,24202,23868
78804,120,317,56290,22514,2.80225e+13,173.021,3275.94,78804,260,175,70732,58526,44018,40637,56388
35880,86,800,25719,10161,2.60446e+13,207.969,3171.4,35880,774,164,29210,24512,12682,12908,17647
98726,330,800,70610,28116,2.72966e+13,264.23,4625.24,98726,795,175,97456,96954,84731,90842,96328
10740,130,193,7675,3065,2.79237e+13,166.491,1175.17,10740,131,122,9755,8065,6766,6287,8115
52576,227,269,37558,15018,2.79959e+13,172.507,2653.92,52576,212,175,52307,52307,50176,51240,52265
10457,157,193,7469,2988,2.80198e+13,166.403,1160.41,10457,132,121,9958,7918,9040,9365,9301
72068,55,305,51473,20595,2.80316e+13,172.863,3126.88,72068,247,175,56037,45862,18026,16581,25889
70235,134,301,50167,20068,2.80054e+13,172.862,3084.66,70235,244,175,64797,52923,46450,41555,54631
96207,367,800,68805,27402,2.72723e+13,260.539,4578.1,96207,714,176,95138,94440,93752,93886,94108
28991,114,227,20701,8290,2.80568e+13,171.292,1953.22,28991,170,156,25653,21456,15175,16955,19674
24933,144,219,17807,7126,2.79926e+13,170.89,1807.28,24933,162,149,23381,18805,18460,19580,20728
88610,162,334,63294,25316,2.79961e+13,173.122,3482.11,88610,277,175,86222,67895,77506,74170,82050
88077,585,800,63004,25073,2.72175e+13,231.181,4422.98,88077,783,180,87193,86793,84213,85503,86632
60699,49,284,43355,17344,2.80141e+13,172.764,2859.87,60699,227,175,46214,37404,14300,17038,19992
75916,226,311,54224,21692,2.7998e+13,172.97,3212,75916,254,175,75605,75605,70534,73113,75520
66315,36,294,47368,18947,2.80047e+13,172.834,2994,66315,237,175,47335,37522,13423,9246,15197
95665,140,490,68310,27355,2.81008e+13,173.335,3812.52,95665,303,180,89237,72110,64895,63095,76003
71501,35,800,51163,20338,2.7033e+13,221.017,4081.63,71501,781,180,50168,40161,13510,9636,16459
98293,228,352,70201,28092,2.80171e+13,173.153,3676.78,98293,294,175,97941,97941,90219,94162,97817
68753,24,299,49099,19654,2.80275e+13,172.825,3051.34,68753,241,175,44249,32451,11719,7987,9362
11462,93,946,8252,3210,2.26757e+13,236.752,2349.33,11462,731,131,8871,7510,3802,2644,4348
60294,221,283,43067,17227,2.80038e+13,172.717,2849.46,60294,226,175,60011,60011,56509,58279,59949
28539,141,226,20384,8155,2.80325e+13,171.26,1937.43,28539,169,155,26613,21526,20545,22939,23397
18205,88,207,13002,5203,2.80128e+13,169.638,1538.91,18205,150,136,15245,12682,7016,6857,9857
35793,55,238,25562,10231,2.80119e+13,171.651,2175.23,35793,181,168,27813,22779,8983,10769,13422
6513,96,186,4655,1858,2.80818e+13,161.943,912.742,6513,116,108,5481,4541,2733,2618,3672
25888,22,221,18488,7400,2.8026e+13,171.046,1842.97,25888,164,151,16183,11512,4417,3196,4455
80858,495,800,57856,23002,2.71209e+13,235.23,4278.56,80858,765,180,79901,79516,77759,78625,79143
70841,127,303,50598,20243,2.80162e+13,172.888,3099.43,70841,245,175,64442,53245,43782,44188,52642
62307,826,944,44571,17736,2.70266e+13,213.402,4061.15,62307,804,184,61363,61337,59513,57365,59249
14299,40,200,10215,4084,2.80141e+13,168.576,1360.48,14299,143,129,10458,8210,3013,2951,3867
37029,89,241,26448,10581,2.80084e+13,171.926,2214.6,37029,184,171,31142,25808,14395,13712,20140
55173,166,274,39407,15766,2.80179e+13,172.613,2721.52,55173,217,175,54017,42551,48389,51722,52382
59831,75,282,42738,17093,2.79969e+13,172.679,2837.8,59831,225,175,48841,40333,19819,20059,28152
42049,171,396,30008,12041,2.82272e+13,172.454,2550.58,42049,207,184,41343,32565,30904,28497,38148
1444,67,176,1038,406,2.70071e+13,118.278,424.053,1444,68,65,1093,939,475,403,625
21590,46,213,15422,6168,2.80032e+13,170.314,1678.74,21590,156,143,16243,13025,4914,3658,6409
10984,114,194,7842,3142,2.80214e+13,167.022,1190.06,10984,133,124,9650,8101,5746,5226,7350
16275,20,204,11629,4646,2.79866e+13,169.391,1453.86,16275,147,133,9842,6967,2774,1940,2551
60571,29,319,43258,17313,2.80104e+13,172.415,2891.75,60571,226,175,40934,30861,10287,11189,12937
13056,161,733,9364,3692,2.54079e+13,157.251,1948.72,13056,436,125,12043,9620,10356,7679,460
70072,166,300,50057,20015,2.79841e+13,172.898,3080.29,70072,244,175,68656,54052,61462,58745,66435
32311,140,233,23072,9239,2.8037e+13,171.433,2064.88,32311,175,162,30083,24329,23152,23467,26017
10086,127,192,7209,2877,2.79195e+13,166.536,1139.31,10086,131,120,9088,7541,6209,5402,7502
96884,72,349,69204,27680,2.80016e+13,173.181,3648.67,96884,292,175,78602,64626,30166,31917,44169
52347,84,268,37393,14954,2.79731e+13,172.494,2647.4,52347,212,175,43561,36426,18616,17457,26334
29179,109,227,20835,8344,2.80304e+13,171.168,1959.07,29179,169,156,25572,21449,14407,16545,19028
26367,138,221,18836,7531,2.79493e+13,171.001,1859.11,26367,164,151,24441,19844,18422,18575,21111
5342,111,184,3811,1531,2.81231e+13,158.162,824.766,5342,108,103,4634,3914,2751,3120,3501
75633,259,311,54024,21609,2.80134e+13,172.979,3206.33,75633,254,175,75322,75322,72514,73928,75270
48186,196,261,34414,13772,2.80014e+13,172.384,2536.92,48186,204,175,47925,47925,44238,46103,47860
85870,44,329,61328,24542,2.80188e+13,173.056,3425.34,85870,272,175,64250,50770,19369,23791,26417
82487,199,324,58918,23569,2.80242e+13,172.993,3355.19,82487,266,175,82163,82163,74408,78365,82038
93124,204,342,66519,26605,2.80013e+13,173.164,3573.71,93124,286,175,92782,92782,84099,88538,92644
51156,86,266,36540,14616,2.79996e+13,172.454,2616.14,51156,209,175,42765,35682,18938,24611,27248
6694,48,186,4784,1910,2.79325e+13,162.638,925.619,6694,118,107,5033,4073,1555,1171,1975
92257,171,490,65877,26380,2.80858e+13,173.261,3750.19,92257,298,189,91096,71516,73343,72675,87089
7184,175,187,5130,2054,2.80265e+13,163.302,959.048,7184,119,109,6997,6997,6800,6886,6985
63216,36,288,45150,18066,2.80168e+13,172.705,2919.99,63216,231,175,45134,35774,12831,16269,16503
26995,220,223,19280,7715,2.79719e+13,171.16,1882.6,26995,166,153,26772,26772,26764,26766,26769
56838,268,276,40596,16242,2.80072e+13,172.533,2762.61,56838,219,175,56562,56562,56470,56507,56554
36660,232,241,26187,10473,2.80254e+13,171.872,2203.88,36660,184,170,36419,36419,36321,36360,36410
25537,71,220,18241,7296,2.79921e+13,170.911,1829.34,25537,163,150,20623,16972,7860,7424,11455
71519,78,303,51083,20436,2.80006e+13,172.849,3113.34,71519,246,175,58783,48998,23984,24502,34821
84904,75,800,60734,24170,2.71833e+13,250.171,4360.21,84904,798,175,68600,56800,27599,37697,39220
3213,28,179,2293,920,2.79149e+13,148.744,637.402,3213,95,89,2137,1603,565,682,704
6720,64,186,4801,1919,2.79921e+13,162.561,927.264,6720,118,107,5294,4413,1834,1789,2697
92723,306,342,66227,26496,2.80146e+13,173.131,3566.24,92723,285,175,92381,92381,90648,91508,92345
57502,266,278,41078,16424,2.80021e+13,172.641,2780.22,57502,221,175,57224,57224,57026,57113,57212
59097,443,944,42231,16866,2.75369e+13,202.583,3705.74,59097,504,192,58153,58008,50757,37381,1157
72562,277,305,51830,20732,2.80018e+13,172.87,3137.03,72562,248,175,72257,72257,71068,71648,72229
7853,124,189,5612,2241,2.80233e+13,164.246,1004.17,7853,123,112,7001,5836,4780,4846,5704
88541,319,334,63244,25297,2.80052e+13,173.098,3480.71,88541,277,175,88207,88207,87886,88026,88192
68702,191,298,49071,19631,2.80257e+13,172.809,3049.16,68702,241,175,68404,68404,61865,65198,68297
58591,342,800,41944,16647,2.67991e+13,223.702,3786.88,58591,798,175,57414,56892,50403,53585,56399
35444,173,238,25315,10129,2.79898e+13,171.774,2165.18,35444,181,168,35082,27827,31518,33387,34728
9437,172,191,6738,2699,2.80045e+13,165.64,1100.82,9437,127,117,9201,7353,8675,8942,9139
25172,172,220,17974,7198,2.80624e+13,170.951,1816.67,25172,163,149,24820,19694,22435,23703,24509
49274,156,263,35198,14076,2.80089e+13,172.413,2566.39,49274,207,175,47340,37466,41959,44514,43994
3795,145,181,2711,1084,2.76767e+13,153.929,694.696,3795,99,92,3442,2821,2792,2750,3089
24342,215,218,17385,6957,2.80128e+13,170.707,1785.19,24342,161,148,24124,24124,24114,24114,24121
79230,314,317,56596,22634,2.79998e+13,173.028,3284.42,79230,260,175,78913,78913,78901,78903,78910
40853,62,248,29182,11671,2.80129e+13,172.094,2329.66,40853,191,175,32371,26504,11079,10538,16324
45207,15,800,32386,12821,2.64424e+13,208.668,3443.91,45207,788,175,24412,17205,6944,3945,4938
2404,1,179,1718,686,2.84648e+13,141.184,551.698,2404,86,82,13,13,13,13,13
78254,19,316,55897,22357,2.8018e+13,173.009,3264.03,78254,259,175,46408,33113,13316,11619,9387
92656,120,482,66161,26495,2.81138e+13,172.669,3748.11,92656,288,175,83112,68846,51520,55998,65738
47112,238,402,33633,13479,2.82062e+13,172.6,2692.11,47112,201,192,46710,46589,36578,30146,43113
19721,124,209,14082,5639,2.80228e+13,169.726,1601.84,19721,152,139,17780,14736,12003,12222,14334
87439,129,332,62456,24983,2.79991e+13,173.098,3458.09,87439,275,175,79906,65896,54690,48124,65514
83715,117,325,59797,23918,2.79983e+13,173.048,3379.91,83715,268,175,74706,62033,45571,42440,57501
99294,317,800,71015,28279,2.73021e+13,260.798,4635.65,99294,733,179,98147,97521,95491,96180,96987
87394,50,332,62426,24968,2.80038e+13,173.105,3457.31,87394,276,175,66803,54034,20875,16297,27562
60520,256,284,43223,17297,2.80202e+13,172.66,2855.5,60520,226,175,60236,60236,59054,59631,60208
24289,45,218,17345,6944,2.80333e+13,170.772,1783.16,24289,161,147,18207,14486,5407,4019,6903
4181,148,182,2981,1200,2.81535e+13,153.896,728.431,4181,102,97,3837,3133,3146,3412,3436
40411,95,247,28864,11547,2.80127e+13,172.054,2316.37,40411,190,175,34431,28322,16682,14237,23124
41951,160,249,29968,11983,2.79947e+13,172.088,2360.86,41951,193,175,40594,32045,36631,39237,38456
59466,29,281,42480,16986,2.79888e+13,172.638,2828.36,59466,224,175,40200,30313,10123,8071,12638
19578,174,209,13982,5596,2.79469e+13,169.958,1596.47,19578,152,139,19336,15484,17703,18528,19216
92443,243,485,66010,26433,2.80826e+13,173.295,3748.87,92443,283,193,91958,91837,68045,49620,82863
73244,231,307,52312,20932,2.80237e+13,172.936,3153.38,73244,250,175,72937,72937,68502,70752,72861
55663,145,275,39756,15907,2.80242e+13,172.64,2734.12,55663,218,175,52418,42025,41716,46216,46892
23165,108,216,16545,6620,2.80018e+13,170.683,1740.77,23165,159,146,20243,16967,11297,10439,14880
1967,34,177,1405,562,2.74151e+13,133.704,497.057,1967,80,75,1357,1100,371,418,505
79081,68,317,56485,22596,2.80063e+13,173.004,3281.38,79081,260,175,63576,52464,23139,21494,33869
51308,14,267,36645,14663,2.80154e+13,172.446,2620.8,51308,210,175,27084,18468,7801,4935,6480
63180,277,288,45130,18050,2.7997e+13,172.709,2918.98,63180,231,175,62892,62892,62725,62798,62881
25865,180,221,18474,7391,2.80237e+13,170.925,1841.68,25865,164,150,25644,25644,23571,24606,25603
72330,544,800,51759,20571,2.70326e+13,233.614,4099.55,72330,798,175,71330,71003,63110,67135,70762
25142,168,219,17963,7179,2.79726e+13,170.957,1814.75,25142,163,150,24620,19357,22219,23589,23948
4028,60,181,2882,1146,2.7824e+13,155.299,715.799,4028,103,95,3114,2569,1076,1017,1451
53664,141,271,38331,15333,2.80028e+13,172.516,2682.24,53664,214,175,50158,40524,38671,43202,44249
1971,48,178,1403,568,2.84322e+13,133.956,498.561,1971,83,77,1457,1192,466,376,563
84675,113,327,60486,24189,2.80034e+13,173.062,3400.38,84675,270,175,74950,62745,44097,40643,56624
58157,21,279,41546,16611,2.79966e+13,172.678,2796.5,58157,222,175,35844,25541,9892,7575,9824
47849,141,800,34267,13582,2.65449e+13,218.668,3515.17,47849,798,175,43733,35447,32915,36494,36971
9964,23,192,7118,2846,2.7993e+13,166.02,1131.9,9964,130,119,6309,4605,1704,1068,1562
26337,205,221,18813,7524,2.8008e+13,170.831,1857.93,26337,164,151,26116,26116,25736,25901,26100
70970,724,800,50786,20184,2.70269e+13,221.503,4070.11,70970,779,180,70170,69993,67802,68891,69943
23415,47,216,16723,6692,2.80216e+13,170.565,1749.78,23415,159,146,17684,14171,5399,6664,7589
98561,431,495,70374,28187,2.80965e+13,173.286,3868.23,98561,293,193,98066,98066,94588,96349,98002
38166,50,950,27326,10840,2.63807e+13,216.187,3430.92,38166,739,189,28538,23299,8674,6064,10512
9517,127,191,6799,2718,2.78877e+13,165.591,1105.52,9517,127,118,8574,7123,5876,5149,6925
81102,208,800,58017,23085,2.71383e+13,226.201,4283.66,81102,798,175,79768,79362,71395,74981,78316
74889,162,310,53492,21397,2.80248e+13,172.936,3190.02,74889,253,175,72837,57372,65487,70154,69522
14297,168,200,10213,4084,2.80082e+13,168.525,1360.44,14297,143,129,13929,10991,12707,13400,13559
78482,69,800,56147,22335,2.71364e+13,223.615,4229.9,78482,786,180,62530,51640,22671,17212,31753
93089,276,342,66498,26591,2.79982e+13,173.177,3573.14,93089,286,175,92747,92747,88957,90877,92681
26923,11,223,19228,7695,2.80207e+13,171.173,1880.37,26923,166,152,12796,7888,3939,2195,2575
66377,120,294,47415,18962,2.80062e+13,172.822,2995.36,66377,238,175,59553,49296,37108,40326,47108
48633,164,261,34741,13892,2.79988e+13,172.332,2548.1,48633,205,175,47422,37244,42606,45559,45663
98126,326,352,70086,28040,2.80074e+13,173.228,3673.97,98126,295,175,97774,97774,96758,97249,97748
17113,293,350,12206,4907,2.84504e+13,170.237,1669.12,17113,155,140,16763,16645,16256,16205,16567
65179,380,438,46528,18651,2.81493e+13,172.96,3155.46,65179,234,194,64741,64741,61697,63233,64683
38351,18,243,27394,10957,2.79901e+13,172.001,2254.72,38351,186,173,22244,15796,6449,4368,5742
89246,243,336,63745,25501,2.80222e+13,173.107,3495.98,89246,279,175,88910,88910,83328,86166,88817
39304,229,246,28072,11232,2.80207e+13,171.987,2284.62,39304,188,175,39058,39058,38658,38830,39041
62705,4,430,44770,17935,2.81529e+13,172.931,3093.88,62705,229,192,16435,5006,3644,3587,1087
53557,33,271,38251,15306,2.80141e+13,172.442,2679.6,53557,213,175,37368,28569,9900,7969,12168
3697,177,181,2640,1057,2.81829e+13,152.149,684.704,3697,100,93,3516,3516,3493,3499,3512
72640,216,306,51885,20755,2.8028e+13,172.915,3139.89,72640,249,175,72334,72334,66951,69689,72244
20097,193,211,14354,5743,2.80449e+13,170.106,1619.06,20097,154,140,19886,19886,19412,19623,19868
91715,445,800,65598,26117,2.72325e+13,222.095,4493.19,91715,798,180,90650,89956,84458,87437,89850
15292,44,202,10928,4364,2.79717e+13,169.034,1408.17,15292,145,132,11402,9018,3459,2412,4225
31052,64,230,22185,8867,2.79856e+13,171.501,2022.54,31052,173,160,24704,20469,8797,9019,12329
92142,318,800,65908,26234,2.72453e+13,222.425,4501.4,92142,798,180,90951,90382,84576,87290,89802
78028,779,800,55826,22202,2.71012e+13,233.535,4220.54,78028,798,175,77228,76982,69500,73425,77166
90259,321,800,64559,25700,2.72366e+13,256.404,4465.52,90259,673,175,89238,88604,87881,87806,88004
97857,317,494,69876,27981,2.80972e+13,173.343,3856.21,97857,301,176,97363,97350,95792,95812,96589
89330,118,336,63812,25518,2.79989e+13,173.158,3497.69,89330,279,175,79857,66187,49092,43147,62307
67238,56,295,48035,19203,2.79888e+13,172.856,3014.95,67238,239,175,52422,43018,16934,15450,23634
80338,237,319,57385,22953,2.79975e+13,173.021,3308.29,80338,262,175,80019,80019,75148,77624,79937
1157,170,176,827,330,2.79897e+13,106.302,381.122,1157,58,61,977,846,964,972,965
29009,137,227,20715,8294,2.80491e+13,171.296,1953.93,29009,170,156,26844,21829,19748,20902,22968
91028,86,339,65026,26002,2.80103e+13,173.16,3532.26,91028,282,175,76142,63505,33585,32630,48053
12202,63,196,8719,3483,2.79936e+13,167.57,1254.63,12202,137,126,9647,7983,3377,2994,4740
40053,188,247,28614,11439,2.79994e+13,172.12,2306.67,40053,190,175,39806,39806,36551,38193,39747
77738,606,800,55614,22124,2.71136e+13,229.331,4214.59,77738,798,175,76803,76403,69003,72789,76356
23873,134,217,17048,6825,2.80561e+13,170.494,1767.17,23873,160,147,21935,17966,15786,16601,18597
79437,79,800,56827,22610,2.71292e+13,222.192,4249.71,79437,792,180,64695,54079,26399,27158,37956
49239,233,263,35169,14070,2.80116e+13,172.355,2565.34,49239,206,175,48976,48976,47689,48319,48946
66217,53,434,47281,18936,2.81269e+13,172.783,3173.83,66217,244,175,51158,42065,16153,17466,22276
11240,171,195,8023,3217,2.81598e+13,166.736,1204.04,11240,134,124,10969,8670,10173,10596,10774
33706,430,800,24168,9538,2.59073e+13,208.681,3103.12,33706,780,160,32670,32052,29413,30925,31796
89062,232,947,63679,25383,2.73212e+13,250.01,4632.72,89062,814,192,87569,87040,70901,67623,82155
18955,143,209,13536,5419,2.81078e+13,169.69,1571.38,18955,151,138,17690,14284,13967,15442,15611
11875,21,196,8483,3392,2.81242e+13,167.346,1238,11875,137,125,7310,5222,2033,1233,1733
15634,175,203,11164,4470,2.81166e+13,168.778,1424.26,15634,145,132,15431,15431,14269,14832,15403
77655,693,800,55554,22101,2.711e+13,217.209,4212.55,77655,798,180,76847,76627,71897,74304,76535
78074,154,315,55763,22311,2.80213e+13,172.926,3259.26,78074,258,175,74820,59118,65834,68506,69127
71297,221,303,50924,20373,2.80069e+13,172.847,3108.91,71297,246,175,70994,70994,66116,68596,70912
95607,337,800,68383,27224,2.72726e+13,228.428,4567.42,95607,798,175,94400,93840,85722,89691,93302
10294,5,193,7344,2950,2.80942e+13,165.87,1150.69,10294,130,121,3210,1149,693,733,676
61239,10,285,43738,17501,2.80177e+13,172.681,2872.55,61239,228,175,28022,15185,8420,4879,3540
89157,286,335,63683,25474,2.80043e+13,173.107,3493.26,89157,278,175,88822,88822,86200,87518,88773
67637,105,296,48316,19321,2.79965e+13,172.858,3024.55,67637,240,175,58870,49623,31685,29975,42499
27212,167,223,19443,7769,2.79765e+13,171.242,1890.35,27212,167,153,26613,20953,23969,25504,25816
51494,89,267,36784,14710,2.7999e+13,172.451,2625.4,51494,210,175,43329,35914,20034,19057,27878
73251,271,306,52325,20926,2.79902e+13,172.907,3152.39,73251,249,175,72945,72945,71275,72103,72910
15586,6,202,11130,4456,2.79593e+13,168.948,1421.13,15586,145,132,5486,2081,1382,1271,1304
46814,173,259,33439,13375,2.8019e+13,172.284,2499.57,46814,202,175,46389,36771,41427,44036,46025
56154,185,800,40191,15963,2.67988e+13,226.7,3718.25,56154,771,175,54994,54654,47269,34946,1006
23019,150,216,16439,6580,2.80448e+13,170.571,1735.07,23019,159,145,21803,17399,17827,19385,19879
26698,204,222,19068,7630,2.80037e+13,171.084,1871.52,26698,165,152,26476,26476,25974,26201,26458
80858,940,944,57821,23037,2.72427e+13,239.718,4465.76,80858,812,194,79914,79836,79055,79368,79494
2033,657,774,1507,526,7.34134e+12,74.908,1086.66,2033,409,49,1259,1259,1199,1196,1059
6438,92,186,4594,1844,2.81687e+13,161.216,906.706,6438,115,107,5388,4468,2568,3221,3657
69344,259,300,49533,19811,2.80038e+13,172.912,3064.94,69344,243,175,69044,69044,67009,68024,69003
82321,68,323,58803,23518,2.79952e+13,173.079,3351.12,82321,266,175,66170,54606,24091,28602,36227
87338,16,800,62472,24866,2.72125e+13,244.851,4408.19,87338,751,180,48345,34378,14214,9370,12728
38251,21,243,27325,10926,2.79971e+13,171.982,2251.81,38251,186,172,23570,16794,6507,5331,6799
9777,175,191,6990,2787,2.78227e+13,165.937,1120.51,9777,129,119,9586,9586,9190,9363,9570
64740,254,291,46242,18498,2.80118e+13,172.778,2956.59,64740,234,175,64449,64449,62670,63553,64412
2699,15,179,1929,770,2.81183e+13,145.362,584.752,2699,90,84,1455,1012,431,269,249
53389,61,271,38131,15258,2.80232e+13,172.516,2675.71,53389,214,175,42210,34550,14399,11233,19954
64358,289,440,45941,18417,2.81408e+13,172.94,3140.09,64358,232,195,63918,63798,50449,49358,61079
90807,193,338,64865,25942,2.80025e+13,173.12,3526.94,90807,281,175,90469,90469,81324,85999,90324
53482,132,271,38206,15276,2.79954e+13,172.535,2677.85,53482,214,175,49112,40286,34226,31433,41049
97054,324,493,69306,27748,2.80889e+13,173.351,3841.1,97054,291,193,96561,96561,87292,85534,94267
4292,134,182,3066,1226,2.78509e+13,155.692,738.314,4292,103,96,3845,3195,2818,2549,3260
96686,226,491,69041,27645,2.80909e+13,173.284,3831.19,96686,290,192,96195,96073,68912,46493,84645
71757,239,304,51251,20506,2.80138e+13,172.914,3119.68,71757,247,175,71453,71453,67766,69631,71388
46146,172,257,32965,13181,2.79852e+13,172.33,2480.51,46146,201,175,45646,36154,40816,43399,45147
14062,124,199,10045,4017,2.79654e+13,168.344,1348.26,14062,142,129,12650,10492,8551,6987,10153
36430,112,240,26023,10407,2.8009e+13,171.856,2196.1,36430,183,169,32156,26904,18834,18134,24188
33722,582,800,24173,9549,2.5941e+13,221.128,3104.07,33722,793,160,32816,32464,28565,30522,32267
18423,21,208,13162,5261,2.79869e+13,170.053,1549.28,18423,151,137,11339,8084,3124,1904,2698
34790,74,237,24848,9942,2.8006e+13,171.831,2144.84,34790,180,167,28310,23243,11263,11617,16155
2437,122,179,1743,694,2.85413e+13,142.116,555.743,2437,88,83,2099,1779,1428,1504,1705
40757,621,800,29208,11549,2.62756e+13,209.98,3318.26,40757,792,172,39900,39500,36376,38120,39420
36016,91,239,25726,10290,2.79948e+13,171.802,2182.94,36016,182,169,30417,25109,14126,13725,19881
23397,118,216,16715,6682,2.79828e+13,170.713,1749.29,23397,159,146,20860,17307,12836,11318,16155
40640,152,248,29024,11616,2.80212e+13,171.923,2323.57,40640,190,175,38736,30759,32553,34882,35464
91408,274,339,65296,26112,2.80002e+13,173.149,3539.17,91408,283,175,91069,91069,87350,89234,91004
14673,37,200,10488,4185,2.79427e+13,168.696,1377.91,14673,144,131,10529,8293,3039,2073,3505
48561,68,262,34688,13873,2.802e+13,172.37,2547.33,48561,205,175,39014,32203,14252,12411,20343
46759,174,258,33397,13362,2.79827e+13,172.239,2497.07,46759,201,175,46419,37067,41499,44042,46201
21955,283,800,15768,6187,2.47929e+13,217.101,2682.72,21955,721,143,20801,20322,19301,19515,19604
98702,680,800,70586,28116,2.72961e+13,242.906,4624.79,98702,776,180,97902,97711,95653,96677,97543
42392,243,251,30284,12108,2.80289e+13,172.205,2374.97,42392,194,175,42141,42141,42055,42088,42133
46069,146,800,32997,13072,2.64917e+13,217.132,3467.22,46069,749,180,42470,34176,33103,36227,37015
32873,10,233,23480,9393,2.80159e+13,171.485,2082.3,32873,176,163,15037,8151,4521,3575,1853
5124,56,183,3655,1469,2.81111e+13,158.273,808.094,5124,108,102,3953,3270,1333,1732,1938
17625,57,206,12589,5036,2.80239e+13,169.581,1513.63,17625,149,135,13744,11269,4467,3365,6135
40293,17,247,28783,11510,2.80143e+13,171.976,2313.04,40293,190,175,22878,16248,6782,4538,5800
85695,164,472,61190,24505,2.81104e+13,173.243,3608.86,85695,284,191,83540,65661,66145,65591,77157
64408,253,290,46011,18397,2.79923e+13,172.745,2948.22,64408,233,175,64118,64118,62304,63208,64081
75715,200,311,54080,21635,2.80054e+13,172.91,3207.82,75715,254,175,75404,75404,68554,72049,75293
93016,216,485,66416,26600,2.81064e+13,173.292,3758.9,93016,285,193,92531,92408,59713,38569,82257
67910,56,297,48509,19401,2.79918e+13,172.86,3031.29,67910,240,175,52950,43447,17100,18556,23957
8661,145,190,6186,2475,2.80916e+13,164.968,1054.48,8661,125,115,8051,6504,6436,7110,7205
11392,50,194,8134,3258,2.7957e+13,166.998,1211.06,11392,134,124,8673,7033,2725,3566,3980
85332,260,329,60956,24376,2.80073e+13,173.107,3415.09,85332,272,175,85003,85003,81065,83059,84934
47600,209,260,34003,13597,2.80178e+13,172.33,2520.87,47600,203,175,47340,47340,44614,45982,47289
30492,212,229,21780,8712,2.79963e+13,171.431,2003.92,30492,172,158,30263,30263,29809,30013,30246
50766,162,265,36260,14506,2.79984e+13,172.401,2605.56,50766,208,175,49335,38882,44394,47529,47090
13902,49,199,9934,3968,2.79733e+13,168.246,1340.58,13902,142,129,10554,8558,3286,2579,4383
25126,5,219,17951,7175,2.79625e+13,170.856,1813.93,25126,162,149,7805,2766,1681,1449,475
59997,244,282,42861,17136,2.79828e+13,172.7,2841.69,59997,226,175,59715,59715,57827,58767,59677
23651,82,217,16898,6753,2.80098e+13,170.813,1759.46,23651,160,146,19570,16424,8305,7028,11844
32727,231,377,23355,9372,2.82309e+13,172.025,2261.57,32727,191,174,32350,32228,28581,25569,30628
16029,39,343,11429,4600,2.85475e+13,169.902,1613.58,16029,153,144,11700,9146,3278,2316,3948
62784,108,288,44851,17933,2.80189e+13,172.781,2910.53,62784,231,175,54986,46053,30647,30780,40768
60593,104,433,43253,17340,2.81466e+13,172.882,3048.48,60593,241,178,52579,44469,26505,23669,36578
80744,213,320,57675,23069,2.80066e+13,173.019,3317.21,80744,263,175,80424,80424,73850,77204,80317
29704,456,800,21304,8400,2.56343e+13,211.054,2970.48,29704,751,153,28714,28057,26915,27657,27872
12184,137,196,8701,3483,2.80003e+13,167.681,1254.11,12184,137,125,11211,9146,8273,8263,9621
36593,6,241,26134,10459,2.80459e+13,171.724,2201.72,36593,183,170,12907,4907,3244,2654,1253
2494,157,179,1774,720,2.85102e+13,142.556,561.445,2494,88,83,2261,1852,2074,2139,2152
23800,24,217,17003,6797,2.8e+13,170.697,1764.6,23800,160,146,15304,11225,4057,3581,4460
47261,125,941,33830,13431,2.6729e+13,225.68,3680.05,47261,806,177,41845,34851,26562,24567,32218
7339,160,187,5245,2094,2.78949e+13,163.005,968.447,7339,119,110,6984,5574,6340,6751,6586
18978,192,209,13552,5426,2.81034e+13,169.719,1572.27,18978,151,138,18769,18769,18350,18533,18752
16209,49,203,11578,4631,2.79443e+13,169.053,1449.72,16209,146,133,12314,9982,3819,5008,5483
40900,717,800,29297,11603,2.62767e+13,222.006,3321.87,40900,689,173,40100,39940,39824,39856,39852
57302,97,278,40936,16366,2.79941e+13,172.67,2775.56,57302,221,175,49026,41514,24171,23149,33582
93940,213,344,67096,26844,2.80114e+13,173.146,3590.44,93940,287,175,93596,93596,85398,89586,93465
22794,33,215,16279,6515,2.79695e+13,170.514,1725.79,22794,158,145,15884,12148,4207,4671,5289
62313,67,287,44505,17808,2.80183e+13,172.707,2898.74,62313,230,175,49975,41225,18134,17394,26190
30370,99,229,21690,8680,2.8016e+13,171.288,1999.81,30370,171,158,26060,21997,13246,15828,18312
13693,117,199,9789,3904,2.79477e+13,168.369,1330.71,13693,142,129,12126,10113,7451,6965,9422
27076,222,223,19342,7734,2.79974e+13,171.144,1885.28,27076,166,153,26853,26853,26853,26853,26852
48112,169,261,34366,13746,2.80064e+13,172.345,2534.92,48112,204,175,47341,37186,42376,45172,46563
48580,158,262,34703,13877,2.80177e+13,172.344,2547.73,48580,205,175,46856,37115,42405,43366,44092
45552,25,256,32538,13014,2.79916e+13,172.284,2463.95,45552,199,175,29713,21653,7746,5020,8062
37628,219,242,26877,10751,2.80041e+13,171.9,2232.75,37628,185,172,37386,37386,36539,36942,37363
63485,250,289,45339,18146,2.80222e+13,172.703,2926.74,63485,231,175,63196,63196,61254,62222,63157
17485,104,206,12491,4994,2.80551e+13,169.562,1507.96,17485,149,135,15119,12795,8062,7589,10786
61831,635,800,44252,17579,2.69046e+13,224.623,3864,61831,757,180,61017,60845,59544,60208,60537
74025,564,800,52961,21064,2.70756e+13,216.528,4136.14,74025,798,175,73087,72694,67808,70302,72517
49058,635,800,35113,13945,2.69153e+13,215.474,3413.31,49058,492,175,48258,48258,48104,48072,48214
80314,320,464,57345,22969,2.81127e+13,173.157,3496.75,80314,261,193,79850,79837,74754,70135,76318
10689,97,193,7637,3052,2.79252e+13,166.598,1172.78,10689,132,122,9090,7720,4531,4366,6185
59381,112,281,42408,16973,2.80194e+13,172.602,2826.43,59381,224,175,52423,43891,30710,34500,39617
94517,328,345,67512,27005,2.80042e+13,173.176,3602.08,94517,288,175,94172,94172,93731,93926,94155
99110,350,800,70886,28224,2.72832e+13,224.86,4632.05,99110,798,180,97947,97338,91319,94211,96882
70123,219,301,50090,20033,2.8014e+13,172.899,3082.37,70123,244,175,69822,69822,64983,67441,69740
3998,155,181,2854,1144,2.78571e+13,154.459,712.356,3998,100,95,3703,3001,3284,3255,3421
74237,139,309,53023,21214,2.803e+13,172.891,3175.73,74237,251,175,69140,55939,52980,53804,59719
53603,205,271,38283,15320,2.80111e+13,172.475,2680.81,53603,213,175,53332,53332,49546,51465,53266
50185,193,265,35846,14339,2.80167e+13,172.505,2591.34,50185,208,175,49920,49920,45757,47867,49848
98423,281,944,70365,28058,2.73763e+13,225.27,4808.32,98423,814,192,97032,96389,84018,81718,89087
10274,11,192,7335,2939,2.79157e+13,166.158,1149.05,10274,129,120,4873,3000,1505,927,841
44595,25,254,31853,12742,2.80082e+13,172.115,2436.59,44595,197,175,29101,21208,7607,7838,6785
79120,308,317,56516,22604,2.80031e+13,173.019,3282.27,79120,260,175,78803,78803,78688,78735,78794
79773,49,461,56952,22821,2.81215e+13,173.122,3483.14,79773,259,193,60778,49216,18196,11046,22527
90692,536,551,64753,25939,2.80721e+13,172.996,3798.48,90692,279,195,90141,90141,89878,90001,90126
12507,191,196,8930,3577,2.80203e+13,167.391,1269.82,12507,137,126,12311,12311,12275,12286,12306
26542,201,222,18959,7583,2.80038e+13,171.026,1866.17,26542,165,152,26320,26320,25629,25952,26299
72901,268,306,52074,20827,2.80126e+13,172.958,3145.32,72901,249,175,72595,72595,70733,71660,72557
94822,534,800,67818,27004,2.72668e+13,229.597,4552.45,94822,798,175,93808,93454,85299,89459,93224
16926,30,205,12089,4837,2.80166e+13,169.517,1483.22,16926,148,135,11512,8717,2939,2883,3588
96488,36,946,68989,27499,2.73781e+13,233.455,4773.99,96488,791,192,68410,54394,19321,14980,22341
57286,80,278,40918,16368,2.80192e+13,172.686,2775.28,57286,221,175,47282,39743,19574,16110,28231
66109,422,800,47308,18801,2.69504e+13,219.787,3962.11,66109,798,175,65014,64396,58298,61588,64175
58377,35,800,41789,16588,2.68009e+13,221.912,3781.91,58377,798,175,40865,32752,11039,7691,12701
33189,750,800,23774,9415,2.64466e+13,198.989,2927.21,33189,466,161,32389,32389,32350,32321,32389
42094,190,250,30066,12028,2.80032e+13,172.148,2365.71,42094,193,175,41844,41844,38478,40178,41784
72897,236,306,52066,20831,2.80122e+13,172.943,3145.38,72897,249,175,72591,72591,68564,70604,72521
12992,32,197,9280,3712,2.7917e+13,167.723,1294.7,12992,139,127,8976,6805,2374,2867,3074
11476,18,194,8199,3277,2.79855e+13,166.992,1215.53,11476,134,124,6647,4720,1925,1705,1340
61535,199,286,43952,17583,2.80316e+13,172.686,2880.47,61535,228,175,61249,61249,56070,58703,61162
35277,54,238,25196,10081,2.80105e+13,171.631,2159.98,35277,180,167,27324,22384,8721,10543,12732
95833,772,800,68543,27290,2.72818e+13,261.854,4571.45,95833,704,175,95033,94900,94824,94809,94950
12961,22,340,9236,3725,2.86567e+13,162.746,1467.5,12961,137,141,8082,5764,2255,839,1658
39572,194,245,28264,11308,2.79733e+13,171.993,2291.08,39572,188,175,39327,39327,36568,37957,39276
40461,251,390,28874,11587,2.8232e+13,172.307,2501.21,40461,201,175,40071,39950,38058,36845,38958
56689,216,277,40487,16202,2.80212e+13,172.499,2759.91,56689,219,175,56412,56412,52980,54714,56351
37020,112,241,26447,10573,2.79962e+13,171.912,2214.35,37020,184,170,32676,27340,19139,18433,24580
10469,189,193,7478,2991,2.79473e+13,166.531,1160.91,10469,131,121,10276,10276,10258,10262,10272
28680,23,225,20489,8191,2.7988e+13,171.198,1941.03,28680,169,156,18188,13272,4880,4940,5492
27153,185,223,19394,7759,2.80478e+13,171,1888.03,27153,166,153,26930,26930,25089,26002,26892
6493,156,185,4641,1852,2.79299e+13,161.766,910.169,6493,116,106,6124,4901,5440,5762,5674
33292,117,234,23782,9510,2.80058e+13,171.711,2096.41,33292,178,164,29636,24642,18144,20027,23185
33360,182,234,23825,9535,2.8029e+13,171.539,2098.35,33360,177,164,33126,33126,30318,31732,33074
4774,21,182,3417,1357,2.77521e+13,157.188,778.524,4774,107,100,2935,2088,813,530,798
72875,126,306,52053,20822,2.80129e+13,172.949,3144.98,72875,249,175,66199,54774,44766,42322,53806
80979,35,320,57847,23132,2.79949e+13,173.047,3321.92,80979,264,175,57376,45670,15402,14643,19629
65305,35,292,46651,18654,2.7998e+13,172.833,2970.16,65305,235,175,46258,36828,12519,11346,15825
35044,96,381,25009,10035,2.82528e+13,172.16,2336.25,35044,195,179,29880,24604,13308,10965,18697
82869,89,324,59190,23679,2.80089e+13,173.075,3362.8,82869,267,175,69775,57805,32209,30617,44967
66874,254,294,47768,19106,2.79981e+13,172.797,3006.04,66874,238,175,66580,66580,64553,65565,66540
24284,199,361,17332,6952,2.8317e+13,171.222,1961.7,24284,167,163,23923,23797,15676,9531,20702
80954,314,320,57824,23130,2.79896e+13,172.997,3321.23,80954,263,175,80634,80634,80582,80600,80628
9589,549,671,6894,2695,2.48441e+13,159.282,1677.77,9589,285,114,8918,8903,8815,8797,8848
9752,75,191,6964,2788,2.80243e+13,165.364,1118.64,9752,127,118,7917,6567,3255,4476,4647
85381,33,800,61078,24303,2.71799e+13,242.272,4369.78,85381,755,180,59110,45439,15559,18296,19157
78169,43,315,55838,22331,2.79962e+13,173.021,3261.39,78169,259,175,58196,46064,17414,17947,23397
86422,62,330,61731,24691,2.79994e+13,173.108,3436.96,86422,273,175,68542,56079,23452,26571,34511
44454,285,394,31733,12721,2.82141e+13,172.467,2613.17,44454,196,189,44060,43942,36087,35296,42551
82314,456,800,58892,23422,2.71492e+13,231.109,4308.36,82314,798,175,81223,80572,72524,76820,80482
84439,309,327,60310,24129,2.80134e+13,173.012,3395.87,84439,269,175,84112,84112,83599,83831,84094
46981,156,259,33555,13426,2.80033e+13,172.345,2504.05,46981,202,175,45145,35722,40002,42437,42228
17911,30,207,12790,5121,2.80953e+13,169.579,1526.57,17911,150,136,12189,9231,3108,2272,3577
22248,208,353,15874,6374,2.8377e+13,171.078,1879.03,22248,168,161,21895,21771,15347,11168,19354
58966,189,281,42116,16850,2.80232e+13,172.683,2817.01,58966,224,175,58685,58685,53151,55968,58593
10850,22,194,7752,3098,2.80819e+13,166.871,1182.8,10850,133,123,6774,4828,1858,1237,1268
6374,29,186,4550,1824,2.80983e+13,161.639,902.999,6374,116,107,4286,3244,1103,838,1269
73085,158,456,52173,20912,2.81269e+13,173.124,3342.79,73085,248,196,70422,55860,35112,19911,55928
40192,149,247,28704,11488,2.80218e+13,172.072,2310.63,40192,190,175,38099,30406,30976,33636,34562
86809,108,800,62090,24719,2.72129e+13,240.774,4398.08,86809,763,180,75214,63088,41489,46833,54639
90992,178,339,64999,25993,2.80106e+13,173.152,3531.48,90992,282,175,90653,90653,80455,85671,90492
72358,754,800,51777,20581,2.70338e+13,217.932,4100.63,72358,798,175,71558,71346,66130,68817,71421
72519,303,305,51803,20716,2.80048e+13,172.946,3136.46,72519,249,175,72214,72214,72208,72209,72212
90203,226,338,64428,25775,2.80105e+13,173.119,3515.82,90203,280,175,89865,89865,83006,86503,89753
58764,147,280,41972,16792,2.80093e+13,172.661,2811.34,58764,223,175,55551,44483,44673,43744,49914
42413,255,800,30382,12031,2.64481e+13,213.072,3333.1,42413,602,175,41449,40996,40357,40045,40097
87997,26,334,62852,25145,2.80103e+13,173.114,3470.6,87997,276,175,58056,42636,14967,10041,15829
32654,22,233,23325,9329,2.80097e+13,171.616,2075.65,32654,176,163,20414,14523,5566,3430,5048
70437,27,301,50306,20131,2.80151e+13,172.822,3088.83,70437,244,175,46862,34897,11996,12771,14920
35320,124,238,25225,10095,2.80162e+13,171.832,2161.57,35320,181,168,31906,26396,21491,17489,25581
36461,186,239,26045,10416,2.79968e+13,171.786,2196,36461,183,170,36222,36222,33311,34778,36169
53640,189,271,38314,15326,2.80049e+13,172.544,2681.75,53640,214,175,53369,53369,48509,50978,53287
19790,31,355,14119,5671,2.84228e+13,167.886,1786.39,19790,158,138,13583,10284,3578,3397,4267
76519,83,313,54656,21863,2.80148e+13,173.005,3226.18,76519,256,175,63583,53240,27003,21078,38420
37023,119,241,26449,10574,2.79978e+13,171.902,2214.38,37023,184,170,33141,27476,20475,19372,26072
36059,20,239,25753,10306,2.80122e+13,171.821,2184.32,36059,182,169,21830,15450,6141,4319,4544
98436,293,352,70311,28125,2.80064e+13,173.201,3679.47,98436,295,175,98084,98084,94782,96450,98025
14106,189,199,10080,4026,2.7948e+13,168.334,1350.31,14106,143,129,13907,13907,13765,13826,13897
80383,229,320,57416,22967,2.80256e+13,173.024,3310.16,80383,263,175,80063,80063,74612,77385,79972
54808,29,273,39147,15661,2.80195e+13,172.507,2711.65,54808,216,175,37053,27948,9350,11711,12549
98830,264,353,70591,28239,2.80116e+13,173.235,3687.59,98830,296,175,98477,98477,93147,95859,98388
4252,136,182,3039,1213,2.81796e+13,155.989,736.019,4252,103,98,3830,3160,2834,2857,3249
7225,55,187,5159,2066,2.80038e+13,163.123,961.551,7225,119,110,5569,4580,1839,1989,2549
15429,160,202,11021,4408,2.80155e+13,168.882,1414.1,15429,145,131,14837,11756,13403,14337,14038
62039,821,946,44380,17659,2.70367e+13,234.891,4056.92,62039,697,193,61093,61093,60738,60791,60719
10479,185,193,7483,2996,2.80415e+13,166.391,1161.47,10479,132,121,10286,10286,10194,10231,10278
83158,161,474,59372,23786,2.81079e+13,173.186,3562.13,83158,266,192,80618,63573,60448,54957,72590
92523,340,341,66098,26425,2.7996e+13,173.202,3561.88,92523,285,175,92182,92182,92180,92180,92181
23865,145,218,17038,6827,2.80418e+13,170.684,1767.97,23865,160,147,22387,17992,17858,19758,19908
62171,224,286,44410,17761,2.79917e+13,172.739,2894.7,62171,230,175,61885,61885,58370,60149,61823
57352,96,278,40963,16389,2.80164e+13,172.597,2776.51,57352,221,175,48998,40210,23886,24093,33830
10371,7,192,7411,2960,2.79261e+13,166.327,1154.34,10371,131,120,4001,1605,1118,865,435
94663,154,345,67619,27044,2.80042e+13,173.143,3604.55,94663,288,175,90769,71688,79848,81379,83789
56711,134,424,40488,16223,2.81517e+13,172.84,2948.48,56711,218,195,52213,42736,25620,16018,38983
28888,94,227,20630,8258,2.80643e+13,171.115,1949.61,28888,169,156,24530,20203,11718,14544,16530
41208,212,392,29409,11799,2.82567e+13,172.267,2524.15,41208,196,188,40816,40693,31602,24229,36758
4681,69,183,3347,1334,2.78224e+13,158.027,773.091,4681,107,99,3699,3075,1396,1504,1953
11895,113,196,8496,3399,2.81242e+13,167.498,1239.16,11895,137,125,10449,8776,6183,5729,7947
81956,193,462,58523,23433,2.81164e+13,173.171,3525.41,81956,264,193,81492,81362,56983,43186,72549
89830,238,336,64162,25668,2.80124e+13,173.08,3506.78,89830,279,175,89494,89494,83552,86578,89396
11845,46,195,8460,3385,2.80173e+13,167.063,1235.38,11845,135,125,8898,7148,2703,3346,3743
81996,251,323,58565,23431,2.80255e+13,173.008,3344.72,81996,265,175,81673,81673,77514,79622,81601
8458,141,190,6038,2420,2.81999e+13,164.467,1042.2,8458,125,115,7792,6351,6060,6741,6874
26163,49,221,18695,7468,2.79735e+13,171.08,1852.3,26163,165,151,19893,16108,6162,6026,8551
84677,198,800,60576,24101,2.7178e+13,232.224,4355.85,84677,798,175,83316,82930,74027,78065,81827
15831,139,203,11307,4524,2.80424e+13,169.201,1433.77,15831,146,132,14656,11887,11267,11449,12717
23329,108,216,16668,6661,2.7992e+13,170.691,1746.73,23329,159,145,20389,17090,11377,10485,14927
67388,61,296,48128,19260,2.80143e+13,172.811,3018.96,67388,239,175,53296,43610,18182,14658,25811
4687,31,182,3352,1335,2.77868e+13,156.796,771.547,4687,106,99,3204,2426,856,708,1066
82176,315,323,58695,23481,2.80155e+13,173.014,3348.13,82176,266,175,81853,81853,81761,81798,81845
32079,5,232,22914,9165,2.8007e+13,171.512,2056.78,32079,175,162,9976,3538,2146,2388,2418
61792,128,285,44134,17658,2.80016e+13,172.681,2885.23,61792,228,175,56327,46449,38432,38678,46244
41824,243,250,29878,11946,2.7992e+13,172.191,2358.45,41824,193,175,41574,41574,41519,41538,41567
14115,9,200,10078,4037,2.80901e+13,168.265,1351.71,14115,142,129,6175,3000,1771,1133,1243
22152,101,214,15816,6336,2.80047e+13,170.431,1700.91,22152,157,144,19070,16107,9948,9839,13390
12984,73,197,9278,3706,2.79449e+13,168.268,1295.16,12984,141,128,10486,8633,4140,4306,5895
64239,213,290,45886,18353,2.79958e+13,172.775,2944.55,64239,233,175,63949,63949,59435,61727,63872
7733,68,188,5525,2208,2.80214e+13,163.649,995.458,7733,121,112,6156,5117,2324,3416,3403
4882,141,183,3485,1397,2.7802e+13,158.312,788.593,4882,107,100,4442,3644,3468,3488,3860
90328,130,337,64522,25806,2.80014e+13,173.14,3517.22,90328,280,175,82726,68073,56831,51786,68473
61244,93,285,43745,17499,2.79969e+13,172.722,2872.73,61244,228,175,51967,42833,24393,23548,34393
90751,19,367,64823,25928,2.79934e+13,173.01,3561.9,90751,281,175,53809,38401,15427,7734,508
94223,89,344,67305,26918,2.79989e+13,173.126,3595.55,94223,287,175,79332,65749,36670,34835,51065
20693,210,212,14775,5918,2.80537e+13,170.059,1643.39,20693,154,141,20481,20481,20477,20477,20479
78804,419,800,56381,22423,2.71185e+13,219.142,4236.47,78804,798,180,77737,77068,73129,75307,76861
80867,101,321,57757,23110,2.80198e+13,173.023,3320.6,80867,263,175,69816,58900,36302,42564,49659
76717,257,312,54803,21914,2.7981e+13,172.977,3229.16,76717,256,175,76405,76405,73358,74895,76350
43818,259,353,31305,12513,2.78783e+13,171.342,2537.87,43818,207,175,43465,43465,38193,40900,39712
16492,46,204,11775,4717,2.80453e+13,169.335,1463.29,16492,147,134,12391,9939,3769,3443,4955
7441,64,188,5309,2132,2.81563e+13,163.059,976.492,7441,120,111,5880,4898,2106,2427,3056
28610,319,365,20409,8201,2.83565e+13,171.538,2115.96,28610,168,172,28245,28245,26017,27133,28199
39744,165,246,28390,11354,2.80046e+13,172.024,2296.87,39744,189,175,38798,30498,34845,37221,37407
42097,104,394,30044,12053,2.82252e+13,172.516,2551.06,42097,192,180,36498,30885,15394,10399,22729
17021,491,945,12225,4796,2.44022e+13,221.68,2644.12,17021,764,147,15915,15650,13651,14185,14714
28728,98,226,20521,8207,2.80098e+13,171.315,1943.61,28728,169,155,24614,20796,12430,10385,16749
61535,26,285,43953,17582,2.80065e+13,172.727,2879.41,61535,228,175,40593,29808,10475,10689,9875
97047,142,350,69323,27724,2.80054e+13,173.226,3652.78,97047,293,175,90955,73307,71015,75208,80209
76879,176,313,54911,21968,2.80063e+13,172.982,3233.42,76879,256,175,76566,76566,67964,72359,76429
16720,140,204,11942,4778,2.79913e+13,169.273,1473.03,16720,147,134,15530,12570,11946,12698,13495
5630,126,184,4026,1604,2.78845e+13,160.223,847.504,5630,113,104,5014,4194,3458,3486,4100
32071,366,800,22999,9072,2.58672e+13,211.762,3050.4,32071,751,157,30991,30419,29003,29606,29969
1666,3,177,1189,477,2.80582e+13,125.184,458.33,1666,73,72,350,79,74,113,43
61187,56,425,43686,17501,2.81357e+13,172.92,3053.38,61187,226,192,47715,39200,14501,11421,19316
96102,64,800,68735,27367,2.72669e+13,261.49,4576.33,96102,673,175,75895,62995,26008,27123,37507
5010,168,183,3580,1430,2.79068e+13,158.441,799.344,5010,109,100,4778,3817,4573,4687,4655
33589,157,235,23988,9601,2.80223e+13,171.611,2106.29,33589,178,164,32292,25530,29284,30362,30119
7552,47,188,5394,2158,2.80779e+13,163.349,983.506,7552,121,111,5677,4571,1749,1338,2147
3632,164,180,2601,1031,2.76396e+13,152.574,678.457,3632,98,92,3402,2735,3217,3206,3275
93269,110,482,66601,26668,2.80996e+13,173.267,3759.31,93269,295,177,82002,68801,45846,43063,60316
59140,193,281,42246,16894,2.80002e+13,172.684,2821.11,59140,224,175,58859,58859,53586,56268,58771
74170,29,457,52950,21220,2.81255e+13,173.078,3365.83,74170,250,192,50148,37795,12663,7579,14018
90966,288,339,64972,25994,2.80202e+13,173.105,3530.92,90966,281,175,90627,90627,87881,89263,90576
66676,373,444,47604,19072,2.81275e+13,173.021,3194.71,66676,244,176,66232,66232,65856,65445,65940
16189,157,203,11569,4620,2.79701e+13,169.2,1448.96,16189,147,132,15500,12278,14068,14576,14533
29260,211,227,20896,8364,2.80058e+13,171.344,1962.15,29260,170,157,29033,29033,28669,28827,29017
37737,350,386,26935,10802,2.82364e+13,172.278,2418.83,37737,199,173,37351,37351,36338,36152,37183
85410,112,328,61008,24402,2.80065e+13,173.041,3415.5,85410,271,175,75449,63137,44176,49588,56939
98545,215,352,70393,28152,2.79983e+13,173.229,3681.54,98545,296,175,98193,98193,89574,93979,98056
37398,234,242,26718,10680,2.79842e+13,171.945,2226.3,37398,185,172,37156,37156,37082,37110,37148
20660,127,211,14757,5903,2.79553e+13,170.124,1640.95,20660,154,141,18742,15505,12772,11116,15201
6631,158,185,4736,1895,2.79432e+13,161.768,919.726,6631,117,108,6260,5029,5696,6084,5874
81469,207,321,58189,23280,2.80098e+13,173.004,3332.45,81469,264,175,81148,81148,74120,77705,81034
32378,222,232,23126,9252,2.79658e+13,171.535,2066.11,32378,175,162,32146,32146,32004,32065,32136
38174,104,243,27265,10909,2.80093e+13,171.938,2249.46,38174,186,172,33143,27993,17626,16533,23660
66400,413,434,47407,18993,2.81469e+13,172.959,3177.17,66400,236,192,65966,65966,65425,65672,65945
68401,87,800,48947,19454,2.69757e+13,218.57,4013.51,68401,798,175,56558,47204,25346,24016,34907
3948,140,181,2814,1134,2.79244e+13,154.257,708.598,3948,98,95,3563,2933,2792,2813,3089
73356,159,307,52398,20958,2.80116e+13,172.956,3155.78,73356,250,175,70953,56058,64104,68706,66772
35038,134,237,25031,10007,2.79765e+13,171.744,2152.07,35038,180,167,32289,26384,23159,21045,27162
40960,34,248,29255,11705,2.80119e+13,172.076,2332.51,40960,191,175,28783,23025,7721,7957,10239
69993,99,300,49993,20000,2.80016e+13,172.835,3078.38,69993,243,175,60175,50726,30423,30569,42062
80500,315,800,57590,22910,2.71365e+13,240.018,4271.29,80500,798,175,79256,78761,69505,74042,78119
14775,164,200,10550,4225,2.79979e+13,168.399,1382.42,14775,143,130,14301,11290,12974,13782,13754
92770,93,342,66264,26506,2.8014e+13,173.155,3567.2,92770,285,175,78773,64894,36931,35623,52507
14077,63,199,10060,4017,2.79356e+13,168.284,1348.96,14077,142,129,11139,9223,3894,3605,5479
18590,81,207,13272,5318,2.80084e+13,169.544,1554.35,18590,150,137,15337,12925,6553,8795,9475
67898,271,297,48501,19397,2.80113e+13,172.829,3030.93,67898,240,175,67601,67601,66549,67058,67575
83608,509,800,59807,23801,2.71702e+13,218.891,4334.03,83608,798,180,82612,82261,76946,79626,81935
95955,32,492,68513,27442,2.80863e+13,173.313,3819.89,95955,305,185,66449,50298,17547,17324,22019
18548,188,208,13248,5300,2.80339e+13,169.798,1554,18548,151,137,18340,18340,17704,17999,18320
40839,121,390,29146,11693,2.82085e+13,172.337,2511.53,40839,203,187,36630,30409,19030,15061,26566
61001,53,285,43562,17439,2.80301e+13,172.656,2867.31,61001,227,175,47113,38713,14957,18130,21562
12395,187,197,8859,3536,2.79892e+13,167.974,1265.72,12395,139,126,12198,12198,12080,12128,12188
26217,154,221,18730,7487,2.79803e+13,170.924,1853.7,26217,164,151,25051,19829,22048,22466,22939
64521,186,291,46089,18432,2.79999e+13,172.806,2951.77,64521,234,175,64230,64230,57842,61098,64125
61154,28,284,43679,17475,2.80106e+13,172.681,2869.74,61154,227,175,41005,30730,10408,11176,10446
47165,5,259,33689,13476,2.79896e+13,172.321,2508.65,47165,202,175,14663,5205,3157,2724,1291
51538,158,267,36811,14727,2.79969e+13,172.478,2626.55,51538,210,175,49724,39377,44996,46013,46777
54959,49,800,39349,15610,2.67461e+13,212.323,3698.26,54959,780,177,41231,33565,12641,9693,16567
34013,20,235,24300,9713,2.79668e+13,171.703,2119.29,34013,179,166,20590,14564,5776,3441,4828
5177,39,184,3695,1482,2.80671e+13,159.388,812.809,5177,110,101,3742,2937,1060,816,1291
74325,114,309,53083,21242,2.80177e+13,172.898,3177.57,74325,251,175,65903,55073,38981,43435,50559
5252,17,184,3746,1506,2.81763e+13,157.909,817.881,5252,108,103,2978,2125,905,567,739
72045,24,305,51466,20579,2.80073e+13,172.951,3126.65,72045,248,175,46358,33993,12249,7826,11748
5157,145,183,3678,1479,2.8095e+13,158.256,810.317,5157,108,103,4737,3860,3820,4210,4162
93257,71,343,66613,26644,2.80112e+13,173.177,3577.2,93257,286,175,75486,62030,28509,30550,41698
17568,49,206,12550,5018,2.79704e+13,169.548,1510.91,17568,149,136,13345,10809,4166,3770,5621
4016,52,181,2868,1148,2.79071e+13,153.937,713.609,4016,100,95,3051,2486,1020,895,1330
2462,170,178,1763,699,2.76214e+13,142.738,557.705,2462,86,80,2272,1852,2226,2253,2219
65995,275,293,47140,18855,2.79976e+13,172.827,2986.09,65995,236,175,65702,65702,65180,65419,65684
33181,63,234,23701,9480,2.80061e+13,171.629,2092.94,33181,177,163,26339,21766,9074,8627,13250
4629,71,183,3297,1332,2.83791e+13,156.582,768.031,4629,106,100,3690,3069,1469,1592,2119
78534,259,316,56094,22440,2.80095e+13,173.006,3269.52,78534,259,175,78218,78218,75052,76650,78161
31983,181,232,22850,9133,2.80119e+13,171.568,2053.91,31983,175,161,31751,31751,28999,30383,31700
83576,311,800,59787,23789,2.71621e+13,248.342,4333.5,83576,726,178,82446,81832,80842,81017,81297
51790,33,268,36993,14797,2.80156e+13,172.526,2633.88,51790,211,175,36120,27624,9578,8061,11583
66413,16,294,47441,18972,2.80016e+13,172.804,2996.06,66413,238,175,36858,25934,10928,6616,8702
30807,187,373,21984,8823,2.8336e+13,171.804,2196.49,30807,187,177,30424,30289,20820,15836,26909
77979,147,315,55699,22280,2.80066e+13,173.007,3257.46,77979,258,175,73772,59041,59311,65058,66498
82634,206,323,59028,23606,2.79965e+13,173.067,3357.21,82634,267,175,82311,82311,75048,78755,82194
17370,144,348,12382,4988,2.85243e+13,170.078,1678.81,17370,160,150,16135,13104,10699,10437,13195
51874,137,267,37055,14819,2.79757e+13,172.482,2634.85,51874,211,175,48090,39077,35352,32467,41672
34712,98,237,24794,9918,2.80243e+13,171.75,2142.41,34712,180,166,29756,25131,14999,14170,20727
97527,328,351,69666,27861,2.80047e+13,173.24,3662.39,97527,294,175,97176,97176,96364,96750,97153
57494,16,278,41063,16431,2.80109e+13,172.596,2779.93,57494,220,175,31902,22452,9455,4569,4986
54704,262,273,39071,15633,2.80136e+13,172.499,2708.98,54704,216,175,54431,54431,54262,54336,54420
98931,224,353,70660,28271,2.80114e+13,173.191,3689.12,98931,296,175,98578,98578,90516,94634,98449
44986,199,255,32141,12845,2.7987e+13,172.341,2448.4,44986,199,175,44731,44731,41622,43192,44675
83103,272,324,59361,23742,2.79995e+13,173.074,3367.36,83103,267,175,82779,82779,79945,81374,82727
42804,141,251,30578,12226,2.79795e+13,172.222,2386.17,42804,195,175,39983,32311,30817,32744,34930
5192,154,184,3706,1486,2.83117e+13,158.791,814.074,5192,110,103,4840,3887,4289,4449,4513
32151,151,232,22968,9183,2.79881e+13,171.455,2058.84,32151,175,162,30575,24326,25340,26196,27837
99713,247,950,71291,28422,2.73808e+13,229.75,4837.56,99713,800,195,98277,97670,87539,69805,89293
44843,26,256,32029,12814,2.80197e+13,172.241,2445.36,44843,198,175,29580,21726,7637,5455,8054
8121,20,188,5804,2317,2.78962e+13,164.335,1019.76,8121,122,112,4899,3459,1376,1216,1011
89630,229,336,64021,25609,2.80137e+13,173.092,3503.19,89630,279,175,89294,89294,82766,86093,89187
23102,42,216,16504,6598,2.80476e+13,170.693,1738.47,23102,159,146,17085,13521,5012,4650,6512
23270,136,216,16622,6648,2.79903e+13,170.668,1744.47,23270,159,146,21494,17505,15740,15751,18317
90588,779,800,64796,25792,2.7234e+13,252.562,4471.57,90588,735,180,89788,89650,89262,89400,89726
58696,176,280,41927,16769,2.79985e+13,172.66,2809.76,58696,223,175,58416,58416,52059,55299,58312
57222,331,800,40961,16261,2.67907e+13,221.895,3753.89,57222,798,175,56038,55525,49308,52319,54991
28069,92,225,20047,8022,2.80203e+13,171.344,1921.22,28069,168,154,23743,19555,11030,10758,15653
51817,250,409,36993,14824,2.82047e+13,172.698,2816.48,51817,211,192,51408,51287,34170,25438,47206
20176,154,210,14418,5758,2.79559e+13,170.156,1621.3,20176,154,141,19246,15244,16939,17267,17828
84726,557,800,60610,24116,2.71806e+13,238.481,4356.82,84726,798,175,83723,83376,74503,79024,83197
1508,158,176,1082,426,2.67956e+13,122.5,434.623,1508,70,67,1316,1107,1203,1189,1233
86618,258,330,61871,24747,2.80044e+13,173.078,3440.57,86618,273,175,86288,86288,82102,84225,86216
37690,620,800,27010,10680,2.61612e+13,209.039,3227.73,37690,771,167,36853,36453,34784,35783,36350
14985,177,201,10700,4285,2.79906e+13,168.796,1393.16,14985,144,131,14784,14784,13867,14307,14760
71379,252,303,50987,20392,2.80043e+13,172.893,3110.69,71379,247,175,71076,71076,68301,69698,71025
52487,164,268,37496,14991,2.79924e+13,172.501,2650.98,52487,212,175,51192,40195,45981,49175,49198
19386,92,209,13850,5536,2.80349e+13,169.884,1588.8,19386,152,139,16362,13511,7658,8113,10961
77655,365,800,55556,22099,2.71063e+13,238.511,4212.53,77655,750,180,76575,75921,74592,75084,75550
41831,125,250,29877,11954,2.80008e+13,172.19,2358.53,41831,193,175,37869,31423,25508,21060,30557
19311,70,209,13794,5517,2.79979e+13,169.846,1585.88,19311,152,138,15552,12834,5821,5901,8510
5893,100,185,4206,1687,2.79779e+13,161.231,867.604,5893,113,105,4990,4242,2624,2486,3436
81834,252,322,58453,23381,2.80087e+13,173.049,3340.59,81834,265,175,81512,81512,77468,79517,81442
75610,103,310,54004,21606,2.80071e+13,172.897,3204.65,75610,253,175,65550,55487,34249,40906,47324
46910,248,259,33505,13405,2.80127e+13,172.246,2502.16,46910,201,175,46651,46651,46482,46556,46640
5279,5,183,3766,1513,2.80055e+13,158.507,819.631,5279,108,102,1643,588,355,312,143
36705,188,240,26218,10487,2.79948e+13,171.819,2203.85,36705,183,170,36465,36465,33639,35062,36413
24023,136,218,17163,6860,2.7992e+13,170.908,1773.93,24023,161,147,22167,18065,16247,16251,19138
89284,218,336,63775,25509,2.80213e+13,173.13,3496.74,89284,279,175,88948,88948,81661,85379,88830
71941,266,304,51390,20551,2.80028e+13,172.892,3123.35,71941,248,175,71637,71637,69746,70688,71599
94306,556,946,67418,26888,2.73621e+13,228.858,4732.79,94306,814,193,93171,92794,84844,76568,85103
93390,495,800,66799,26591,2.72551e+13,226.495,4525.6,93390,798,175,92347,92024,84446,88292,91675
52724,69,269,37658,15066,2.79867e+13,172.49,2657.45,52724,212,175,42461,34973,15505,15872,22478
49560,256,264,35404,14156,2.79921e+13,172.46,2574.52,49560,207,175,49296,49296,49222,49250,49288
74008,191,308,52860,21148,2.80102e+13,172.886,3170.06,74008,250,175,73700,73700,66446,70150,73583
68723,41,298,49092,19631,2.80008e+13,172.869,3049.65,68723,242,175,50666,39878,14554,15425,19723
5254,110,183,3750,1504,2.77631e+13,158.845,817.694,5254,107,102,4544,3844,2655,2587,3315
28928,37,227,20669,8259,2.79961e+13,171.438,1951.53,28928,170,156,20780,16350,5956,4306,6901
90286,423,800,64579,25707,2.72378e+13,226.477,4465.94,90286,798,175,89170,88529,80965,85013,88339
68316,198,297,48802,19514,2.79903e+13,172.813,3039.86,68316,241,175,68019,68019,61988,65062,67920
92849,314,488,66296,26553,2.80842e+13,173.269,3757.94,92849,298,177,92361,92348,91090,89286,90659
27776,17,224,19843,7933,2.79763e+13,171.123,1909.8,27776,167,154,15759,11192,4675,3609,2486
20065,197,210,14334,5731,2.80125e+13,170.109,1616.95,20065,153,140,19855,19855,19626,19726,19842
21802,112,213,15570,6232,2.79957e+13,170.318,1686.53,21802,156,143,19202,16090,11282,10777,14572
37225,118,241,26599,10626,2.7982e+13,172.017,2220.55,37225,185,171,33222,27553,20442,19379,25984
96849,174,349,69176,27673,2.80132e+13,173.146,3648.04,96849,292,175,96326,76830,85349,91056,96325
59957,197,282,42831,17126,2.80062e+13,172.664,2840.6,59957,225,175,59675,59675,54611,57185,59590
71950,160,304,51392,20558,2.80071e+13,172.926,3123.65,71950,247,175,69726,54988,62880,67389,66244
75902,152,311,54219,21683,2.79995e+13,172.935,3211.51,75902,254,175,72486,57473,60872,65232,66548
97058,99,350,69329,27729,2.80022e+13,173.237,3653.01,97058,293,175,83453,70338,42128,39694,57868
73253,171,800,52413,20840,2.70534e+13,234.403,4119.6,73253,751,180,71359,56032,62479,66510,68765
71226,136,303,50880,20346,2.80052e+13,172.926,3107.54,71226,246,175,65970,53667,48267,51221,56513
43269,15,252,30906,12363,2.80206e+13,172.16,2399.66,43269,195,175,23467,16201,6817,5490,3880
90580,327,479,64678,25902,2.80913e+13,173.223,3707,90580,279,193,90101,90101,83824,80239,85759
75485,101,944,53985,21500,2.72084e+13,216.527,4354.05,75485,807,180,64324,54394,31543,27566,43165
86279,78,800,61714,24565,2.72022e+13,244.683,4387.2,86279,749,180,70196,58642,28416,38954,41651
92154,100,340,65821,26333,2.80073e+13,173.087,3553.75,92154,283,175,79419,66968,41205,48353,56074
11270,185,194,8051,3219,2.79597e+13,166.845,1204.19,11270,133,124,11076,11076,10961,11008,11067
53326,604,782,38124,15202,2.74226e+13,169.803,3315.41,53326,442,175,52544,52544,46146,49446,29887
31531,195,231,22522,9009,2.8007e+13,171.5,2038.71,31531,174,160,31300,31300,29554,30423,31264
79371,118,533,56719,22652,2.78152e+13,209.116,3578.31,79371,260,175,70733,58678,43486,38102,55002
2522,5,179,1804,718,2.79129e+13,144.18,565.46,2522,86,81,779,268,168,174,168
11767,184,195,8406,3361,2.79992e+13,167.164,1231.24,11767,135,125,11572,11572,11403,11477,11561
15413,105,202,11010,4403,2.80173e+13,168.856,1413.42,15413,145,131,13348,11280,7230,6853,9605
94175,272,800,67362,26813,2.72477e+13,222.791,4539.96,94175,798,180,92931,92412,85987,88919,91641
21674,69,213,15477,6197,2.79792e+13,170.295,1682.04,21674,156,143,17422,14368,6418,7623,9690
30542,71,229,21815,8727,2.80473e+13,171.319,2005.32,30542,172,159,24688,20313,9399,13712,13903
93047,319,486,66439,26608,2.81031e+13,173.302,3759.4,93047,284,192,92561,92548,83719,79448,90361
1166,112,177,830,336,2.86176e+13,106.012,383.583,1166,59,64,926,825,632,667,713
66566,441,800,47635,18931,2.696e+13,216.73,3972.72,66566,798,175,65498,64852,59377,62351,64689
45773,75,398,32675,13098,2.82285e+13,172.52,2651.93,45773,199,188,37339,30923,12631,8941,18890
98075,182,351,70050,28025,2.80105e+13,173.178,3672.06,98075,294,175,97724,97724,86954,92466,97555
43852,75,253,31326,12526,2.79883e+13,172.214,2415.97,43852,196,175,35779,29556,14537,13833,19649
63940,207,290,45670,18270,2.80188e+13,172.735,2937.9,63940,233,175,63650,63650,58722,61226,63567
82316,696,800,58884,23432,2.71793e+13,219.126,4308.37,82316,798,180,81508,81285,76394,78874,81205
30435,283,373,21713,8722,2.82938e+13,171.57,2184,30435,185,176,30062,29942,25523,24115,28924
36193,92,240,25855,10338,2.80096e+13,171.95,2189.41,36193,183,169,30619,25225,14209,12146,19914
39203,130,245,27999,11204,2.79816e+13,172.04,2280.61,39203,188,175,35821,29516,24667,22846,29760
28668,200,226,20483,8185,2.80046e+13,171.3,1941.63,28668,169,155,28442,28442,27390,27899,28416
43976,55,253,31415,12561,2.79734e+13,172.206,2419.37,43976,196,175,34170,27969,11006,11948,15298
63865,129,289,45623,18242,2.799e+13,172.735,2935.26,63865,232,175,58342,48124,39960,35949,48168
10906,168,193,7793,3113,2.79506e+13,166.764,1184.41,10906,132,122,10594,8374,9772,9810,10293
89618,45,336,64013,25605,2.80033e+13,173.126,3503.03,89618,279,175,67293,53463,19956,22394,26564
9210,67,190,6589,2621,2.78385e+13,165.481,1086.81,9210,127,117,7325,6075,2717,2729,3859
17344,57,205,12396,4948,2.79583e+13,169.553,1500.91,17344,149,135,13520,11083,4610,5139,6538
85471,365,478,61023,24448,2.80984e+13,173.234,3610.99,85471,270,196,84993,84993,78188,81661,84880
15957,68,203,11398,4559,2.80591e+13,169.072,1438.67,15957,146,133,12778,10565,4706,4360,6897
62114,22,286,44367,17747,2.79947e+13,172.728,2893.43,62114,229,175,38847,27624,10562,6513,9544
26589,108,222,18993,7596,2.80019e+13,171.009,1867.67,26589,165,152,23247,19485,12990,11983,17072
35797,214,239,25569,10228,2.80402e+13,171.832,2176.6,35797,182,169,35558,35558,34595,35058,35533
50440,31,800,36119,14321,2.66245e+13,226.577,3583.68,50440,714,176,34194,26193,8855,7567,10571
9509,31,191,6789,2720,2.80148e+13,165.71,1105.45,9509,127,118,6513,4944,1739,1571,2198
96175,12,348,68696,27479,2.79987e+13,173.196,3635.05,96175,291,175,47472,30080,14270,6781,6666
3185,88,180,2271,914,2.81157e+13,149.101,635.289,3185,95,89,2600,2192,1255,1231,1661
96296,20,348,68784,27512,2.80045e+13,173.194,3637.22,96296,291,175,58319,41259,16373,12365,15763
94849,31,346,67744,27105,2.8022e+13,173.192,3609.09,94849,289,175,65149,49395,17011,12720,20449
46352,108,258,33105,13247,2.80097e+13,172.197,2486.63,46352,200,175,40564,34006,22665,25755,30075
58829,163,281,42013,16816,2.8031e+13,172.614,2813.96,58829,223,175,57288,45059,51453,55091,54830
2500,47,178,1781,719,2.8217e+13,140.647,560.336,2500,88,83,1858,1514,609,725,820
91275,327,339,65196,26079,2.80024e+13,173.139,3536.76,91275,282,175,90936,90936,90744,90827,90924
47752,123,260,34104,13648,2.80142e+13,172.298,2524.71,47752,203,175,43076,35714,28634,29461,34485
79975,59,319,57130,22845,2.79977e+13,173.045,3301.18,79975,262,175,62898,51313,21143,18808,29644
58138,179,279,41530,16608,2.80009e+13,172.652,2795.94,58138,223,175,57859,57859,51760,54869,57759
86841,423,476,61997,24844,2.81107e+13,173.213,3635.11,86841,279,192,86365,86365,83753,85076,86086
28948,108,227,20677,8271,2.80157e+13,171.345,1951.69,28948,170,156,25303,21215,14136,13265,18602
49000,267,402,34983,14017,2.81711e+13,172.636,2738.56,49000,212,177,48598,48478,47277,46809,47719
71777,499,944,51340,20437,2.71466e+13,233.918,4275.05,71777,814,192,70589,70308,62275,56861,64072
2370,42,178,1693,677,2.79806e+13,140.022,546.11,2370,83,79,1722,1381,532,366,638
18460,143,208,13178,5282,2.8076e+13,169.556,1550.38,18460,150,137,17228,13911,13610,15042,15174
70054,305,510,50059,19995,2.78305e+13,174.821,3338.31,70054,243,175,69544,69541,69447,69361,69345
34378,81,236,24560,9818,2.79935e+13,171.77,2131.46,34378,179,165,28402,23902,12001,10253,17051
54611,170,273,39003,15608,2.80174e+13,172.535,2706.85,54611,216,175,53853,42317,48084,51279,52892
33100,16,233,23645,9455,2.79854e+13,171.58,2089.52,33100,177,164,18362,12922,5443,4253,3446
97111,150,349,69363,27748,2.79927e+13,173.168,3652.77,97111,292,175,92422,73544,75440,74410,84931
32471,8,233,23190,9281,2.80288e+13,171.429,2069.81,32471,175,162,13507,6176,3762,2533,2716
61438,88,424,43865,17573,2.81468e+13,172.823,3057.45,61438,226,193,51578,42919,19587,16856,28934
65936,57,293,47098,18838,2.79991e+13,172.791,2984.61,65936,236,175,51574,42192,16726,15283,23654
98163,437,800,70205,27958,2.7294e+13,232.908,4614.79,98163,794,180,97120,96392,92965,94879,96274
44998,251,256,32142,12856,2.8039e+13,172.248,2449.39,44998,199,175,44742,44742,44706,44717,44737
74445,170,309,53180,21265,2.79952e+13,172.975,3180.1,74445,252,175,73471,57690,65478,69909,72006
71102,260,444,50765,20337,2.81351e+13,173.066,3288.34,71102,245,192,70658,70537,58687,55448,65531
60894,93,284,43490,17404,2.80053e+13,172.714,2863.96,60894,227,175,51683,42590,24261,25161,34494
31270,43,231,22331,8939,2.80427e+13,171.524,2030.49,31270,174,160,23254,18421,6972,5015,8675
45090,115,256,32212,12878,2.80255e+13,172.315,2451.92,45090,199,175,40034,33387,23712,22687,30705
3556,120,180,2536,1020,2.77953e+13,151.593,670.98,3556,97,91,3106,2608,2001,1896,2476
53024,714,800,37960,15064,2.6668e+13,227.758,3649.53,53024,796,175,52219,51979,46121,49114,51967
20297,148,211,14496,5801,2.80253e+13,170.168,1627.22,20297,154,140,19141,15333,15463,16906,17275
18942,113,208,13538,5404,2.79783e+13,170.03,1570.25,18942,152,138,16689,14000,9860,9088,12647
5103,80,183,3647,1456,2.795e+13,158.754,806.144,5103,109,101,4149,3515,1760,1563,2422
14323,115,200,10232,4091,2.79276e+13,168.572,1361.57,14323,143,130,12634,10582,7547,7240,9712
32383,145,232,23131,9252,2.79658e+13,171.527,2066.25,32383,175,162,30453,24440,24245,23800,27122
40480,208,247,28912,11568,2.80415e+13,171.935,2318.27,40480,190,175,40233,40233,38320,39271,40194
81003,274,320,57858,23145,2.79953e+13,172.99,3322.13,81003,263,175,80683,80683,78265,79478,80637
31264,104,230,22337,8927,2.79759e+13,171.515,2029.36,31264,174,161,27101,22918,14445,13553,19454
30245,102,229,21605,8640,2.80061e+13,171.461,1995.93,30245,172,159,26111,22055,13623,12682,18478
76224,277,452,54429,21795,2.81083e+13,173.084,3401.79,76224,267,183,75772,75652,72020,70975,73181
45881,21,257,32776,13105,2.80057e+13,172.304,2473.56,45881,200,175,28277,20155,7799,5058,5248
96319,347,349,68793,27526,2.80153e+13,173.174,3638.5,96319,291,175,95970,95970,95968,95968,95968
72549,126,947,51893,20656,2.71508e+13,215.466,4294.1,72549,800,192,64895,53873,37800,16425,44555
82033,3,322,58594,23439,2.79974e+13,173.017,3344.34,82033,265,175,17204,3858,3561,4450,1865
61852,280,286,44173,17679,2.80132e+13,172.638,2887.38,61852,228,175,61566,61566,61514,61532,61560
26796,174,223,19141,7655,2.80536e+13,171.07,1875.89,26796,166,152,26526,21209,23983,25281,26395
86506,3,331,61782,24724,2.80227e+13,173.075,3439.46,86506,273,175,18151,4075,3761,4694,1487
19281,195,209,13775,5506,2.8005e+13,170.073,1584.97,19281,152,138,19072,19072,18802,18920,19058
82393,725,800,58946,23447,2.71573e+13,222.263,4310.02,82393,798,175,81592,81355,75103,78324,81369
74958,299,309,53539,21419,2.79952e+13,172.893,3190.29,74958,252,175,74649,74649,74507,74568,74639
71722,236,304,51235,20487,2.7994e+13,172.913,3118.76,71722,247,175,71418,71418,67550,69507,71350
23493,107,217,16786,6707,2.79822e+13,170.86,1753.97,23493,160,146,20467,17202,11332,10504,14889
82993,97,474,59249,23744,2.8118e+13,173.11,3558.75,82993,265,196,71038,60187,30520,25238,42598
97692,92,351,69775,27917,2.80165e+13,173.166,3665.06,97692,294,175,82797,68163,38373,40666,55608
23649,152,216,16895,6754,2.79584e+13,170.731,1758.37,23649,160,147,22489,17874,18900,18920,20666
57923,117,279,41376,16547,2.801e+13,172.694,2791.08,57923,222,175,51670,42902,31499,30081,40137
62114,247,287,44367,17747,2.80287e+13,172.708,2894.39,62114,230,175,61827,61827,59850,60833,61787
49157,239,407,35091,14066,2.81641e+13,172.711,2749.12,49157,205,193,48750,48629,32952,23295,44487
29870,48,228,21334,8536,2.80042e+13,171.322,1982.82,29870,171,158,22645,18242,6934,9158,9982
3877,41,181,2771,1106,2.79636e+13,154.014,702.149,3877,100,94,2820,2238,844,1012,1062
99652,459,800,71268,28384,2.73383e+13,262.023,4613.63,99652,609,175,98852,98485,98106,98024,97929
85155,57,328,60825,24330,2.80076e+13,173.067,3410.64,85155,271,175,66622,54498,21501,16057,29933
42588,285,800,30509,12079,2.63659e+13,208.761,3370.72,42588,785,175,41402,40917,37621,39006,40243
53289,114,271,38056,15233,2.80282e+13,172.421,2673.18,53289,213,175,47223,39478,27852,31163,35865
63604,204,289,45431,18173,2.8003e+13,172.74,2929.56,63604,232,175,63315,63315,58263,60832,63230
64834,212,385,46316,18518,2.79235e+13,172.257,3074.74,64834,234,175,64449,64449,56536,60616,45126
84739,7,328,60525,24214,2.80239e+13,173.035,3402.66,84739,270,175,32796,13186,9197,5208,3345
44237,18,254,31597,12640,2.80057e+13,172.146,2427.24,44237,197,175,25670,18233,7448,4652,5902
55540,10,274,39678,15862,2.79899e+13,172.629,2730.29,55540,218,175,25399,13744,7631,4516,3359
40361,90,247,28830,11531,2.80056e+13,171.987,2315.12,40361,190,175,34004,28159,15783,19782,22274
45814,103,257,32719,13095,2.80159e+13,172.211,2471.62,45814,199,175,39694,33611,20777,24796,28626
27385,105,224,19563,7822,2.80364e+13,171.181,1897.03,27385,167,153,23781,20065,12828,12152,17169
89024,261,335,63593,25431,2.80035e+13,173.129,3490.9,89024,278,175,88689,88689,84373,86562,88615
56485,178,276,40346,16139,2.80277e+13,172.554,2754.38,56485,219,175,56209,56209,50282,53300,56111
76344,190,312,54533,21811,2.8007e+13,172.976,3221.56,76344,255,175,76032,76032,68458,72325,75910
20619,178,212,14731,5888,2.80039e+13,170.356,1640.66,20619,155,141,20407,20407,18851,19618,20373
55770,207,275,39830,15940,2.80133e+13,172.632,2736.73,55770,218,175,55495,55495,51604,53574,55427
2242,121,178,1602,640,2.83232e+13,138.6,532.192,2242,83,81,1905,1632,1255,1217,1572
96237,620,800,68816,27421,2.7375e+13,260.487,4512.24,96237,705,175,95437,95117,83656,62005,2413
26148,217,222,18679,7469,2.80164e+13,171.045,1852.53,26148,165,151,25926,25926,25899,25907,25921
19837,17,210,14170,5667,2.80221e+13,170.112,1607.92,19837,153,139,11251,8001,3349,2232,2128
61715,32,286,44088,17627,2.79932e+13,172.773,2884.57,61715,229,175,42713,32349,11277,8029,13023
46929,188,404,33500,13429,2.82082e+13,172.627,2689.25,46929,204,192,46515,46379,33034,26701,41927
42781,85,251,30560,12221,2.79912e+13,172.186,2385.41,42781,195,175,35667,29833,15420,15278,22411
30129,207,228,21526,8603,2.79643e+13,171.438,1991.28,30129,172,159,29901,29901,29169,29513,29880
51042,397,407,36439,14603,2.81806e+13,172.713,2795.23,51042,208,193,50635,50635,50505,50562,50625
3317,144,180,2369,948,2.80154e+13,149.466,648.804,3317,97,90,2987,2467,2422,2646,2669
27118,202,223,19364,7754,2.80268e+13,171.095,1886.74,27118,166,152,26895,26895,26177,26515,26874
79387,668,800,56791,22596,2.71286e+13,217.817,4248.42,79387,798,180,78551,78354,73376,75906,78192
23376,133,216,16702,6674,2.79598e+13,170.692,1748.53,23376,160,146,21452,17586,15111,15936,18240
58277,264,423,41605,16672,2.81538e+13,172.882,2986.07,58277,229,177,57854,57734,56649,56325,57011
92957,247,487,66375,26582,2.81091e+13,173.302,3760.35,92957,284,192,92470,92349,79996,75231,87458
15542,53,203,11100,4442,2.80202e+13,168.905,1420.3,15542,145,132,11963,9847,3832,3362,5324
99779,202,354,71275,28504,2.79963e+13,173.192,3705.25,99779,297,175,99425,99425,89793,94720,99273
68683,618,800,49147,19536,2.69982e+13,220.716,4019.76,68683,798,175,67781,67381,61406,64605,67337
13499,34,198,9642,3857,2.8016e+13,167.968,1320.54,13499,141,128,9471,7589,2577,2795,2704
92914,121,342,66368,26546,2.80055e+13,173.15,3569.85,92914,285,175,83577,69189,52785,56623,66550
91832,307,340,65597,26235,2.80012e+13,173.159,3548.07,91832,283,175,91492,91492,89957,90716,91459
24995,77,219,17850,7145,2.8002e+13,170.835,1809.27,24995,162,149,20458,17058,8427,8541,12013
4736,41,183,3378,1358,2.81839e+13,156.741,776.294,4736,106,100,3464,2746,1021,828,1316
45556,388,396,32522,13034,2.82053e+13,172.482,2643.77,45556,199,193,45160,45160,45067,45106,45152
35504,96,238,25359,10145,2.80456e+13,171.7,2166.75,35504,181,168,30291,24894,14820,18249,20834
66527,113,439,47490,19037,2.81397e+13,173.014,3186.76,66527,236,193,58836,49305,27218,20452,39325
30260,188,228,21618,8642,2.79457e+13,171.43,1995.4,30260,172,159,30032,30032,28005,29017,29992
81106,155,320,57938,23168,2.79823e+13,173.03,3324.36,81106,264,175,77900,61704,68832,67815,71815
50650,234,266,36175,14475,2.80236e+13,172.459,2603.66,50650,209,175,50384,50384,48930,49647,50352
42120,145,250,30086,12034,2.80227e+13,172.15,2366.41,42120,193,175,39627,31791,31555,33225,35208
19617,111,209,14017,5600,2.79486e+13,170.084,1598.25,19617,153,140,17219,14436,10054,9186,12909
74984,309,800,53644,21340,2.70692e+13,216.605,4156.5,74984,798,175,73789,73255,67768,70317,72645
55252,60,274,39468,15784,2.80058e+13,172.612,2723.41,55252,217,175,43564,35546,14785,16809,21362
90167,253,337,64407,25760,2.80045e+13,173.123,3514.21,90167,281,175,89830,89830,84813,87363,89746
73446,98,307,52458,20988,2.80098e+13,172.921,3157.45,73446,250,175,63033,53228,31774,30456,43481
73634,103,307,52601,21033,2.80186e+13,172.931,3161.46,73634,250,175,63829,54023,33323,39820,45840
60866,127,284,43477,17389,2.80089e+13,172.717,2863.35,60866,227,175,55361,45744,37613,32631,45376
5539,155,184,3957,1582,2.80123e+13,159.788,840.55,5539,110,104,5184,4174,4605,4674,4807
67759,147,445,48372,19387,2.81289e+13,172.999,3219.15,67759,238,192,63987,51316,40728,34240,52797
80538,242,800,57614,22924,2.71308e+13,221.046,4272.23,80538,798,175,79257,78799,71863,75004,77902
71751,251,304,51251,20500,2.80161e+13,172.909,3119.36,71751,247,175,71447,71447,68559,70013,71394
79184,7,317,56566,22618,2.79947e+13,173.004,3283.36,79184,260,175,30637,12314,8593,4864,2423
93208,36,343,66572,26636,2.80199e+13,173.185,3576.34,93208,286,175,66542,52741,18887,13691,22543
68831,230,299,49158,19673,2.80285e+13,172.811,3052.89,68831,241,175,68532,68532,64562,66574,68463
38013,573,800,27240,10773,2.61389e+13,210.35,3236.81,38013,761,168,37135,36748,35321,36025,36532
48857,244,262,34904,13953,2.79828e+13,172.369,2554.68,48857,205,175,48595,48595,48082,48314,48577
38570,46,244,27546,11024,2.80174e+13,171.918,2261.67,38570,187,173,29047,23289,8740,6525,11288
33310,732,800,23883,9427,2.58603e+13,217.896,3090.27,33310,676,160,32510,32387,32338,32327,32307
65835,20,294,47024,18811,2.80122e+13,172.764,2983.42,65835,236,175,39872,28213,11205,8465,10983
96863,111,349,69188,27675,2.80048e+13,173.184,3648.35,96863,292,175,85409,71427,49571,45233,64250
12820,162,198,9150,3670,2.80609e+13,167.803,1287.31,12820,140,127,12336,9781,11159,11902,11743
48486,58,262,34628,13858,2.80227e+13,172.405,2545.63,48486,205,175,38011,31111,12715,12154,18287
36972,162,241,26405,10567,2.80135e+13,171.843,2212.93,36972,184,170,35886,28303,32303,34571,34042
17721,184,206,12655,5066,2.80231e+13,169.487,1517.46,17721,149,136,17515,17515,16771,17122,17493
55629,171,275,39732,15897,2.80236e+13,172.513,2733.03,55629,217,175,54958,43113,49022,52255,54077
50942,129,266,36386,14556,2.79956e+13,172.444,2610.86,50942,209,175,46512,38375,31861,28057,38157
67419,100,296,48156,19263,2.8014e+13,172.812,3019.68,67419,239,175,58076,48975,30117,27986,40551
76951,247,800,55054,21897,2.70963e+13,217.807,4197.58,76951,798,175,75686,75219,69017,71792,74352
27350,163,224,19541,7809,2.80001e+13,171.264,1895.81,27350,167,153,26550,20914,23929,25556,25530
45756,9,257,32685,13071,2.80237e+13,172.29,2470.27,45756,200,175,20021,9682,5709,2977,2319
73614,290,308,52581,21033,2.80128e+13,172.938,3162.03,73614,250,175,73306,73306,72840,73046,73288
23141,8,216,16533,6608,2.79576e+13,170.689,1739.74,23141,159,146,9618,4382,2672,1841,2161
98104,287,352,70065,28039,2.80237e+13,173.186,3673.5,98104,294,175,97752,97752,94067,95932,97687
57092,147,277,40779,16313,2.79911e+13,172.589,2769.47,57092,220,175,53977,43222,43392,42488,48122
34473,74,236,24619,9854,2.80145e+13,171.648,2134.08,34473,179,166,28061,23048,11200,15663,16219
88561,61,334,63261,25300,2.80004e+13,173.137,3481.29,88561,277,175,70046,57308,23855,21333,34763
84014,247,326,60011,24003,2.80042e+13,173.086,3386.86,84014,269,175,83688,83688,79030,81395,83609
66416,537,796,47473,18943,2.75573e+13,170.625,3624.41,66416,432,175,65620,65620,57566,53014,17111
83625,217,325,59733,23892,2.80015e+13,173.026,3378.13,83625,268,175,83300,83300,76671,80051,83192
77107,312,314,55081,22026,2.80038e+13,173.039,3239.09,77107,257,175,76793,76793,76791,76791,76791
92573,338,342,66116,26457,2.80235e+13,173.148,3563.58,92573,285,175,92231,92231,92208,92214,92227
94135,388,800,67334,26801,2.72578e+13,231.321,4539.41,94135,798,175,92971,92371,83813,88356,92029
29988,214,228,21417,8571,2.80584e+13,171.258,1986.47,29988,171,158,29760,29760,29502,29612,29746
88162,214,333,62976,25186,2.80058e+13,173.089,3472.57,88162,276,175,87829,87829,80453,84217,87710
8095,622,800,5875,2220,1.93239e+13,257.473,1953.7,8095,724,104,7279,6884,6498,6833,6761
76514,140,800,54739,21775,2.70983e+13,217.479,4188.68,76514,798,175,70467,56983,53328,53776,59881
20282,23,210,14486,5796,2.79556e+13,170.084,1625.39,20282,153,140,12852,9376,3453,2720,3954
73706,251,308,52650,21056,2.80084e+13,172.98,3163.94,73706,251,175,73398,73398,70278,71850,73341
64151,45,290,45823,18328,2.80057e+13,172.759,2942.63,64151,233,175,48160,38276,14280,10583,18591
87945,189,333,62813,25132,2.80061e+13,173.106,3468.61,87945,276,175,87612,87612,78572,83193,87468
4147,112,182,2956,1191,2.82825e+13,154.398,726.118,4147,103,97,3587,3033,2161,2423,2763
35444,111,238,25315,10129,2.79898e+13,171.768,2165.17,35444,181,168,31195,26114,18138,17177,23124
6441,151,186,4597,1844,2.809e+13,162.307,908.324,6441,116,107,6015,4830,5018,5367,5504
95239,419,951,68094,27145,2.73572e+13,228.515,4755.52,95239,800,197,94020,93323,88824,90596,92552
83241,88,325,59460,23781,2.80207e+13,173.076,3371,83241,268,175,69924,58071,31908,26995,44610
69456,543,800,49704,19752,2.69978e+13,216.609,4036.96,69456,791,180,68523,68134,64897,66540,67885
71802,56,303,51295,20507,2.79942e+13,172.905,3119.5,71802,247,175,55995,45945,18077,29952,27291
65987,420,438,47110,18877,2.81375e+13,172.974,3173.8,65987,235,193,65549,65549,65169,65344,65531
82569,288,324,58977,23592,2.80254e+13,173.03,3356.84,82569,267,175,82245,82245,80540,81383,82209
1303,162,176,933,370,2.74456e+13,114.502,404.254,1303,65,63,1115,951,1076,1099,1057
77771,76,315,55555,22216,2.80146e+13,173.014,3253.45,77771,258,175,63645,52847,25870,26332,36884
70668,48,800,50570,20098,2.70069e+13,214.822,4063.59,70668,798,179,53020,42882,16083,18986,22102
29053,128,227,20754,8299,2.80017e+13,171.412,1955.38,29053,170,156,26429,21809,18039,16968,21746
20619,177,211,14733,5886,2.79699e+13,170.342,1639.82,20619,155,141,20408,20408,18794,19594,20374
81460,283,322,58175,23285,2.80267e+13,172.99,3333.19,81460,264,175,81138,81138,79221,80176,81099
32385,2,232,23129,9256,2.80033e+13,171.452,2066.25,32385,175,162,4336,822,703,1699,362
7250,49,187,5178,2072,2.80238e+13,163.084,963.012,7250,119,109,5484,4456,1720,2046,2424
10838,167,193,7735,3103,2.80092e+13,166.326,1180.47,10838,131,122,10507,8329,9659,10146,10188
86563,40,331,61831,24732,2.80042e+13,173.135,3440.59,86563,274,175,63511,49752,18024,19099,24511
8948,72,190,6389,2559,2.79301e+13,165.212,1071.69,8948,125,116,7205,5949,2819,2803,3990
62335,80,287,44528,17807,2.80084e+13,172.748,2899.41,62335,230,175,51445,43257,21324,21577,30888
18785,131,208,13421,5364,2.80173e+13,169.883,1563.57,18785,151,138,17147,14120,11876,11196,14181
95535,74,347,68243,27292,2.80109e+13,173.178,3622.49,95535,290,175,77848,63895,30949,31822,44314
11190,48,195,7994,3196,2.80212e+13,167.141,1201.53,11190,135,124,8451,6821,2603,1949,3420
24818,94,219,17726,7092,2.80145e+13,170.763,1803.09,24818,162,148,21076,17343,10045,10322,14320
49993,175,265,35708,14285,2.80144e+13,172.512,2586.53,49993,208,175,49728,49728,44358,47089,49638
75804,68,311,54144,21660,2.80078e+13,172.97,3209.7,75804,254,175,60937,50287,22204,22530,31966
54694,405,800,39152,15542,2.67186e+13,218.534,3691.34,54694,759,180,53649,53002,51418,52383,52709
99241,565,800,70979,28262,2.7304e+13,234.222,4634.67,99241,798,175,98246,97865,89025,93529,97736
28425,58,226,20297,8128,2.80509e+13,171.134,1933.67,28425,168,155,22266,18243,7515,8785,10716
27662,124,800,19841,7821,2.5511e+13,211.306,2899.15,27662,777,149,24063,20014,15538,15580,18472
50467,158,309,36044,14423,2.79773e+13,172.13,2652.64,50467,208,175,48628,38532,43996,47172,34329
30398,120,229,21713,8685,2.79995e+13,171.421,2000.81,30398,172,158,27248,22553,16975,14818,21368
96196,31,348,68716,27480,2.80028e+13,173.195,3635.42,96196,291,175,66075,50086,17212,16715,21415
99924,741,800,71407,28517,2.77204e+13,206.384,4288.75,99924,415,175,99124,99085,93279,96278,99065
78363,493,774,56003,22360,2.76879e+13,171.007,3821.05,78363,388,175,77589,77589,68046,62633,19978
50026,5,265,35729,14297,2.80156e+13,172.507,2587.23,50026,208,175,15555,5513,3345,2892,1339
34168,64,236,24405,9763,2.80131e+13,171.711,2124.91,34168,179,165,27186,22534,9375,7084,13168
27577,17,223,19703,7874,2.79687e+13,171.226,1902.43,27577,167,154,15643,11107,4637,3091,2916
71590,186,303,51139,20451,2.79945e+13,172.889,3115.01,71590,247,175,71287,71287,64033,67737,71170
71787,114,304,51271,20516,2.80178e+13,172.855,3120.12,71787,246,175,63655,53192,37544,41942,48842
48668,39,262,34763,13905,2.80047e+13,172.409,2550.06,48668,205,175,35517,27795,9958,12338,13856
89610,77,337,64006,25604,2.80105e+13,173.111,3503.84,89610,279,175,73495,61237,30190,41477,43343
75942,31,311,54245,21697,2.79995e+13,172.953,3212.45,75942,254,175,52160,39544,13613,9745,15441
97116,11,494,69346,27770,2.80869e+13,173.313,3842.58,97116,291,193,46142,28417,14262,5983,9466
86593,207,331,61856,24737,2.79994e+13,173.126,3441.17,86593,274,175,86262,86262,78586,82503,86138
58172,99,800,41636,16536,2.68179e+13,215.37,3776.83,58172,798,175,49195,41565,24535,29011,33567
40531,46,247,28959,11572,2.79888e+13,172.173,2320.13,40531,191,175,30512,24454,9176,7202,11907
71339,179,800,51049,20290,2.70154e+13,215.026,4077.95,71339,798,180,69967,69617,61341,64991,68444
38822,45,244,27735,11087,2.79951e+13,172.019,2269.02,38822,188,174,29123,23148,8652,6410,11164
27235,185,223,19455,7780,2.79891e+13,171.171,1891.03,27235,166,153,27012,27012,25132,26069,26974
22030,196,214,15730,6300,2.80256e+13,170.28,1696.28,22030,156,143,21816,21816,21301,21535,21798
86822,56,800,62107,24715,2.72007e+13,252.852,4398.1,86822,714,176,67071,55206,21516,35204,32073
98668,282,353,70478,28190,2.80191e+13,173.193,3684.52,98668,296,175,98315,98315,94224,96297,98244
17672,165,206,12624,5048,2.80052e+13,169.548,1515.58,17672,149,136,17166,13535,15551,16516,16443
13333,79,198,9521,3812,2.80374e+13,167.903,1312.54,13333,141,128,10928,9146,4574,6233,6565
91372,21,339,65273,26099,2.79942e+13,173.167,3538.63,91372,283,175,56326,40137,15522,9583,10981
30569,248,374,21807,8762,2.82986e+13,171.678,2189.56,30569,186,176,30195,30074,24940,21663,28423
81815,311,800,58531,23284,2.7153e+13,229.659,4298.43,81815,778,180,80662,80073,77356,78444,79510
7361,145,188,5255,2106,2.82135e+13,163.067,971.407,7361,121,111,6813,5521,5474,6031,6106
80669,201,320,57622,23047,2.79942e+13,173.041,3315.71,80669,263,175,80349,80349,73009,76755,80230
1458,134,176,1044,414,2.70389e+13,120.005,427.02,1458,69,64,1240,1061,948,921,1069
55361,39,275,39543,15818,2.80168e+13,172.579,2726.89,55361,217,175,40412,31622,11126,9035,14318
7663,38,188,5473,2190,2.80753e+13,163.165,990.266,7663,121,111,5533,4350,1612,1179,1890
47635,81,260,34027,13608,2.80001e+13,172.361,2521.78,47635,203,175,39388,33133,16624,14187,23688
33903,178,235,24217,9686,2.79911e+13,171.703,2116.01,33903,178,165,33668,33668,30494,32098,33611
30812,214,230,22000,8812,2.80346e+13,171.3,2014.75,30812,172,159,30582,30582,30202,30367,30566
58997,535,800,42233,16764,2.68223e+13,224.174,3796.52,58997,798,175,58012,57694,51412,54608,57402
44920,48,255,32087,12833,2.79999e+13,172.27,2446.42,44920,198,175,34072,27438,10407,10004,13889
20988,48,212,14994,5994,2.80282e+13,170.192,1654.61,20988,155,142,15898,12817,4902,4282,6529
1641,12,177,1177,464,2.80562e+13,126.77,455.094,1641,73,73,805,513,246,140,82
90072,37,337,64333,25739,2.79997e+13,173.164,3512.41,90072,280,175,64791,50963,18555,20533,22909
38074,204,243,27196,10878,2.80236e+13,171.948,2246.63,38074,186,173,37831,37831,35914,36869,37792
23362,88,217,16688,6674,2.80126e+13,170.748,1748.84,23362,160,146,19567,16276,8971,8599,12586
36857,296,800,26420,10437,2.60992e+13,211.493,3201.79,36857,792,166,35675,35197,31414,33089,34545
11763,2,195,8398,3365,2.80452e+13,167.107,1231.66,11763,135,125,1576,301,256,618,132
89067,234,479,63600,25467,2.80831e+13,173.257,3679.98,89067,289,177,88588,88466,81080,82099,87269
17873,177,206,12766,5107,2.80053e+13,169.633,1523.89,17873,149,136,17667,17667,16417,17029,17638
6591,123,186,4708,1883,2.8006e+13,162.107,918.41,6591,116,108,5844,4891,3931,3304,4624
34674,180,237,24764,9910,2.80225e+13,171.693,2140.97,34674,180,166,34437,34437,31276,32871,34380
93904,42,343,67072,26832,2.80011e+13,173.13,3588.89,93904,286,175,69592,55009,20233,25301,27710
94194,270,344,67284,26910,2.80016e+13,173.177,3595.26,94194,287,175,93850,93850,89520,91719,93776
74366,145,308,53126,21240,2.79909e+13,172.943,3177.4,74366,251,175,70093,56173,55751,54688,62131
92788,238,478,66253,26535,2.8095e+13,173.256,3746.48,92788,283,191,92310,92189,64900,48232,83678
55887,134,275,39921,15966,2.80051e+13,172.588,2739.25,55887,218,175,51549,42105,36946,34655,43579
39106,106,245,27932,11174,2.80222e+13,171.99,2277.99,39106,188,175,34071,28673,18665,17439,24768
62935,73,288,44947,17988,2.80188e+13,172.778,2913.8,62935,231,175,51151,41967,20033,20872,28909
89400,35,336,63858,25542,2.8018e+13,173.144,3498.92,89400,279,175,63341,50424,16993,17497,22714
52747,186,270,37668,15079,2.80279e+13,172.426,2659.1,52747,212,175,52477,52477,47493,50027,52393
47264,26,260,33756,13508,2.80382e+13,172.329,2512.17,47264,203,175,31175,22910,8066,5667,8895
19775,57,210,14125,5650,2.79745e+13,170.029,1605.09,19775,153,140,15425,12637,5053,4318,6961
45717,156,257,32660,13057,2.79921e+13,172.311,2469.23,45717,200,175,43921,34755,38921,39411,40934
24908,142,219,17791,7117,2.80037e+13,170.832,1806.34,24908,162,148,23261,18787,18188,20100,20444
97611,473,942,69784,27827,2.73891e+13,233.313,4789.82,97611,791,182,96465,96097,92525,92274,94216
44139,90,254,31532,12607,2.79977e+13,172.247,2424.61,44139,197,175,37195,30784,17236,17687,24245
87698,30,333,62637,25061,2.80046e+13,173.152,3464.03,87698,276,175,59756,45185,15081,14909,18603
34095,90,235,24354,9741,2.79863e+13,171.68,2121.7,34095,178,165,28717,23776,13344,13675,18973
41777,244,250,29843,11934,2.79999e+13,172.214,2357.23,41777,193,175,41527,41527,41487,41500,41521
43100,21,252,30789,12311,2.79997e+13,172.216,2395.01,43100,195,175,26556,18929,7327,6001,5666
30622,87,230,21878,8744,2.79923e+13,171.582,2009.18,30622,173,159,25610,21340,11623,9849,16189
29026,27,226,20731,8295,2.80134e+13,171.14,1953.09,29026,169,156,19306,14376,4949,6047,6309
9319,137,191,6653,2666,2.80571e+13,165.227,1094.38,9319,127,117,8541,6989,6334,6692,7384
57257,113,278,40900,16357,2.7994e+13,172.7,2774.63,57257,221,175,50635,42405,29816,26934,38467
25941,193,221,18526,7415,2.8023e+13,171.015,1844.56,25941,164,151,25720,25720,24538,25115,25692
10431,56,193,7447,2984,2.79004e+13,166.72,1158.78,10431,131,121,8083,6648,2651,2865,3756
76400,299,313,54564,21836,2.80215e+13,172.957,3223.69,76400,255,175,76087,76087,75840,75945,76073
80885,30,320,57779,23106,2.79978e+13,173,3319.83,80885,263,175,55124,41669,13893,16106,17697
11441,118,195,8170,3271,2.80712e+13,167.399,1214.96,11441,135,124,10138,8436,6258,5981,7947
16830,71,205,12021,4809,2.80928e+13,169.288,1478.64,16830,148,134,13569,11180,5162,4055,7346
21456,112,213,15328,6128,2.80141e+13,170.426,1673.86,21456,156,142,18887,15827,11083,10694,14152
3003,68,180,2137,866,2.84607e+13,147.531,617.444,3003,93,89,2357,1975,925,999,1291
69391,24,300,49567,19824,2.80275e+13,172.873,3065.84,69391,243,175,44655,32752,11813,7542,11334
60041,180,283,42891,17150,2.80233e+13,172.716,2843.68,60041,226,175,59758,59758,53499,56686,59655
35784,227,239,25555,10229,2.80307e+13,171.671,2175.94,35784,181,168,35545,35545,35347,35434,35533
2678,143,178,1913,765,2.79184e+13,143.245,580.813,2678,91,83,2396,1989,1940,2117,2137
44418,206,255,31730,12688,2.80056e+13,172.329,2433.28,44418,198,175,44163,44163,41586,42879,44114
47676,149,260,34057,13619,2.79908e+13,172.319,2522.71,47676,203,175,45232,36086,36748,38201,40932
66875,138,295,47771,19104,2.80018e+13,172.829,3007.2,66875,238,175,62146,50384,46775,48329,53504
18537,24,208,13234,5303,2.80657e+13,169.647,1553.26,18537,150,137,11914,8746,3168,2033,3132
98660,38,352,70475,28185,2.79999e+13,173.203,3683.46,98660,295,175,71510,56006,19285,14087,23892
76219,120,311,54445,21774,2.79938e+13,172.978,3218.1,76219,255,175,68388,56610,42592,39319,53959
66206,9,294,47290,18916,2.80168e+13,172.824,2991.64,66206,237,175,28971,14007,8262,4308,3376
6721,44,186,4804,1917,2.79251e+13,162.325,926.926,6721,118,107,4992,3961,1512,1498,2008
85615,124,800,61238,24377,2.71812e+13,219.931,4374.12,85615,798,180,76576,63401,50881,43493,60213
59365,253,282,42401,16964,2.80127e+13,172.73,2827.15,59365,225,175,59083,59083,57862,58458,59054
58351,230,280,41682,16669,2.8e+13,172.742,2802.07,58351,223,175,58071,58071,55427,56754,58021
70942,471,944,50737,20205,2.71288e+13,232.389,4255.98,70942,751,199,69824,69475,67986,68129,68579
97191,10,349,69425,27766,2.79986e+13,173.182,3654.2,97191,293,175,44452,24066,13350,10551,7010
6842,90,186,4891,1951,2.78634e+13,162.286,934.727,6842,116,108,5710,4753,2714,2783,3695
25247,17,220,18034,7213,2.80348e+13,170.927,1819.44,25247,163,150,14332,10179,4261,2841,3624
42173,10,250,30124,12049,2.79908e+13,172.148,2367.96,42173,193,175,19280,10435,5797,3427,3954
28946,53,227,20669,8277,2.80712e+13,171.188,1951.62,28946,169,156,22330,18365,7124,8364,10251
44167,135,253,31546,12621,2.80055e+13,172.111,2424.28,44167,197,175,40777,33272,29543,31289,34822
49062,133,263,35043,14019,2.80151e+13,172.454,2561.15,49062,206,175,45145,36949,31725,33506,38201
91788,146,340,65564,26224,2.80085e+13,173.16,3547.12,91788,283,175,86687,69501,69316,67675,77102
80755,135,320,57683,23072,2.80098e+13,173.017,3317.39,80755,263,175,74646,60852,54000,50252,63494
75907,4,311,54222,21685,2.80013e+13,172.937,3211.64,75907,254,175,19904,6039,4393,4253,1737
25706,95,220,18359,7347,2.80054e+13,170.813,1835.16,25706,163,150,21873,18014,10647,13116,14894
82684,298,324,59054,23630,2.80188e+13,173.026,3359.02,82684,266,175,82360,82360,81314,81821,82334
79414,291,317,56725,22689,2.79917e+13,173.004,3288.01,79414,260,175,79097,79097,78031,78550,79071
20801,725,800,14950,5851,2.46386e+13,217.296,2635.42,20801,726,140,20001,19851,19465,19631,19777
19959,117,210,14255,5704,2.80059e+13,170.036,1612.47,19959,153,140,17754,14760,10853,9637,13747
37255,2,241,26611,10644,2.79934e+13,171.909,2221.15,37255,184,171,4979,939,807,1951,414
43595,232,253,31141,12454,2.79756e+13,172.253,2409.25,43595,196,175,43342,43342,42670,42982,43321
6955,148,186,4965,1990,2.78762e+13,162.412,942.474,6955,116,108,6482,5233,5259,5160,5888
73877,138,308,52765,21112,2.80161e+13,172.935,3167.34,73877,251,175,68685,55668,51656,53406,59684
46603,29,258,33293,13310,2.79887e+13,172.317,2493.1,46603,201,175,31496,23747,7908,9942,9924
20708,188,211,14792,5916,2.79925e+13,170.129,1642.67,20708,154,141,20497,20497,19648,20053,20474
69381,153,300,49560,19821,2.8003e+13,172.91,3065.74,69381,243,175,66353,52520,57003,60116,61464
54452,140,800,38981,15471,2.67262e+13,211.559,3685.63,54452,782,175,49839,40341,37494,36232,42103
53339,181,271,38104,15235,2.80071e+13,172.589,2674.49,53339,214,175,53068,53068,47700,50431,52978
95758,33,347,68398,27360,2.80045e+13,173.176,3626.45,95758,290,175,66816,51076,17672,14193,21566
32725,101,233,23376,9349,2.79834e+13,171.616,2077.9,32725,176,163,28221,23812,14686,14498,19595
49407,205,263,35294,14113,2.79933e+13,172.488,2569.89,49407,207,175,49144,49144,45891,47533,49086
52619,449,800,37684,14935,2.66431e+13,215.707,3639.31,52619,798,175,51567,50931,45980,48682,50766
33809,132,235,24150,9659,2.79857e+13,171.686,2113.05,33809,178,165,31016,25454,21621,20562,25772
34986,206,237,24998,9988,2.79778e+13,171.817,2150.7,34986,181,167,34749,34749,33336,34031,34718
13647,109,199,9748,3899,2.79903e+13,168.367,1328.57,13647,142,129,11892,10005,6727,6184,8819
88315,121,334,63083,25232,2.80131e+13,173.096,3476.48,88315,277,175,79449,65761,50177,53828,63256
23924,170,356,17072,6852,2.83549e+13,171.178,1944.08,23924,173,164,23352,18507,17310,16076,21280
92608,154,342,66148,26460,2.8019e+13,173.162,3564.31,92608,285,175,88780,70119,78111,81274,82606
11788,174,196,8415,3373,2.81646e+13,167.091,1233.57,11788,136,125,11572,9301,10833,11193,11507
9091,162,191,6494,2597,2.81567e+13,165.418,1081.11,9091,127,117,8705,6920,7901,8400,8328
86936,282,331,62093,24843,2.79991e+13,173.09,3447.6,86936,274,175,86605,86605,84001,85310,86556
95695,171,347,68358,27337,2.80126e+13,173.175,3625.37,95695,290,175,94664,74187,84142,81678,93297
66660,156,294,47619,19041,2.79907e+13,172.782,3001.26,66660,238,175,64124,50709,56803,57524,59709
51125,63,800,36607,14518,2.66395e+13,222.033,3601.3,51125,741,180,39930,33124,13840,15059,19676
67433,151,296,48165,19268,2.80123e+13,172.842,3020.08,67433,239,175,64257,51048,53219,55037,58657
34365,138,236,24545,9820,2.80328e+13,171.621,2130.87,34365,179,166,31876,25874,24021,24828,27437
98758,793,800,70634,28124,2.73049e+13,228.874,4625.79,98758,798,180,97958,97775,96830,97361,97938
6748,149,186,4818,1930,2.79387e+13,162.304,928.587,6748,116,108,6287,5072,5135,5075,5692
92047,46,800,65836,26211,2.72444e+13,256.925,4499.63,92047,797,175,68780,55315,20522,15084,26257
62292,604,800,44585,17707,2.68818e+13,212.905,3874.62,62292,798,175,61402,61002,56742,58902,60904
93205,341,342,66574,26631,2.80087e+13,173.114,3575.04,93205,285,175,92863,92863,92863,92863,92862
68727,25,800,49180,19547,2.6983e+13,232.743,4020.59,68727,798,175,44492,32732,11526,11624,10094
91328,334,340,65231,26097,2.8017e+13,173.12,3538.6,91328,282,175,90988,90988,90948,90961,90982
13669,88,198,9768,3901,2.79352e+13,168.21,1328.81,13669,141,128,11418,9520,5292,6081,7383
70901,125,302,50643,20258,2.80243e+13,172.859,3099.65,70901,245,175,64251,53296,43257,43993,52079
16193,93,203,11567,4626,2.79633e+13,169.138,1449.03,16193,146,133,13696,11302,6485,6725,9181
30934,57,230,22094,8840,2.8015e+13,171.426,2018.8,30934,173,159,24168,19786,7833,5850,10864
60227,111,283,43021,17206,2.80022e+13,172.737,2847.95,60227,226,175,53088,44394,30808,29858,39759
1957,167,178,1400,557,2.77698e+13,135.957,497.93,1957,76,75,1763,1452,1726,1750,1713
68091,282,297,48641,19450,2.80229e+13,172.84,3035.19,68091,240,175,67794,67794,67489,67621,67779
79743,48,318,56965,22778,2.80015e+13,173.035,3295.57,79743,261,175,60518,48721,18465,22212,26236
82669,216,323,59048,23621,2.79966e+13,173.015,3357.7,82669,266,175,82346,82346,75780,79128,82239
92469,107,341,66054,26415,2.80002e+13,173.12,3560.49,92469,284,175,80863,67857,44666,42191,59009
31934,161,232,22811,9123,2.8024e+13,171.597,2052.51,31934,175,161,30918,24376,27881,29836,29462
91614,63,340,65437,26177,2.8011e+13,173.159,3544.13,91614,283,175,72830,60117,25030,23745,36927
43415,166,252,31007,12408,2.80171e+13,172.059,2403.12,43415,195,175,42471,33485,38122,40696,41225
7128,58,187,5095,2033,2.80884e+13,162.529,954.587,7128,119,110,5542,4564,1873,1593,2543
19095,100,208,13642,5453,2.79458e+13,169.777,1575.96,19095,151,138,16387,13854,8546,7973,11464
64000,77,290,45715,18285,2.80189e+13,172.779,2939.4,64000,233,175,52480,43720,21542,21801,30812
69086,138,446,49318,19768,2.81328e+13,172.96,3246.88,69086,240,192,64145,52077,37887,30941,50184
51384,32,267,36699,14685,2.80178e+13,172.455,2622.65,51384,210,175,35559,26941,9407,6983,11395
45610,689,800,32664,12946,2.64742e+13,220.297,3454.68,45610,798,175,44797,44581,39775,42228,44478
58638,306,800,41981,16657,2.67896e+13,211.295,3787.99,58638,793,175,57466,56939,53175,54833,56342
35271,138,238,25194,10077,2.80352e+13,171.82,2160.05,35271,181,168,32739,26550,24631,24021,28270
9639,174,192,6884,2755,2.80311e+13,166.121,1113.77,9639,129,118,9431,7580,8975,9186,9391
64050,87,290,45751,18299,2.80125e+13,172.812,2940.52,64050,233,175,53685,44667,24317,23330,34322
42984,70,252,30702,12282,2.80196e+13,172.216,2391.97,42984,195,175,34684,28581,12847,11863,18957
3969,79,182,2829,1140,2.82736e+13,153.709,710.877,3969,102,94,3210,2710,1403,1858,1948
82306,17,323,58788,23518,2.80055e+13,173.065,3350.88,82306,266,175,46719,33181,13842,8485,8102
72250,328,800,51695,20555,2.70353e+13,218.12,4097.88,72250,798,175,71064,70526,64381,67323,69982
96092,225,347,68640,27452,2.79892e+13,173.177,3632.56,96092,291,175,95745,95745,88143,92024,95623
5211,125,184,3727,1484,2.79378e+13,159.795,815.895,5211,110,102,4627,3869,3148,2802,3737
94491,129,800,67579,26912,2.72714e+13,224.041,4546.05,94491,798,180,85437,70538,57819,57744,69190
51374,125,267,36702,14672,2.80123e+13,172.46,2622.47,51374,210,175,46532,38606,31335,26997,37713
62378,389,432,44530,17848,2.8147e+13,172.979,3088.13,62378,244,184,61946,61946,60271,59931,61671
48252,260,261,34467,13785,2.79951e+13,172.317,2538.27,48252,204,175,47991,47991,47991,47991,47990
59625,155,282,42590,17035,2.79897e+13,172.705,2833.09,59625,225,175,57223,45346,50574,49826,52753
80411,57,465,57406,23005,2.81103e+13,173.19,3498.92,80411,261,194,62905,51516,19918,15937,27026
97394,59,350,69568,27826,2.8001e+13,173.195,3658.97,97394,293,175,76624,62504,25708,24522,37281
89689,205,336,64063,25626,2.80015e+13,173.119,3504.22,89689,279,175,89353,89353,81159,85344,89222
53018,354,800,37963,15055,2.66869e+13,213.734,3649.38,53018,772,180,51914,51329,49075,50058,50880
81650,190,322,58319,23331,2.80166e+13,173.004,3336.84,81650,265,175,81328,81328,73068,77287,81196
41179,18,248,29411,11768,2.801e+13,172.013,2338.55,41179,191,175,23894,16980,6929,6114,4894
98236,134,944,70237,27999,2.73883e+13,241.142,4804.7,98236,783,182,89653,73377,62393,55032,73558
86439,159,331,61739,24700,2.80298e+13,173.056,3438.07,86439,273,175,83628,66074,75541,80977,78786
62328,181,286,44526,17802,2.79799e+13,172.746,2898.25,62328,230,175,62042,62042,55595,58882,61937
45283,480,800,32434,12849,2.6482e+13,218.663,3445.86,45283,659,175,44469,44143,43688,43718,43525
73204,216,307,52281,20923,2.80255e+13,172.885,3152.6,73204,249,175,72897,72897,67442,70217,72806
91747,364,483,65510,26237,2.81115e+13,173.262,3733.93,91747,282,192,91264,91264,87578,84791,88684
13938,126,199,9953,3985,2.79517e+13,168.437,1342.63,13938,142,129,12576,10443,8539,7391,10238
14253,191,709,10215,4038,2.58029e+13,158.173,1969.62,14253,413,127,13544,13488,11511,8532,425
78749,44,317,56251,22498,2.80063e+13,173.036,3274.87,78749,260,175,58909,46543,17735,16955,22730
46936,137,259,33522,13414,2.80122e+13,172.228,2502.73,46936,201,175,43512,35358,31985,33837,37148
41040,161,248,29319,11721,2.79951e+13,172.116,2334.93,41040,191,175,39784,31343,35852,38386,37912
2338,143,178,1670,668,2.81247e+13,140.381,543.73,2338,85,81,2067,1722,1683,1774,1835
75464,302,310,53900,21564,2.80146e+13,172.898,3201.63,75464,253,175,75154,75154,75062,75099,75146
81800,305,322,58426,23374,2.801e+13,172.991,3339.84,81800,265,175,81478,81478,81024,81228,81461
55107,151,274,39360,15747,2.80028e+13,172.624,2719.81,55107,217,175,52481,41707,43476,44958,48074
36849,38,241,26319,10530,2.80268e+13,171.898,2209.37,36849,184,170,26685,20908,7224,5569,9304
49432,5,263,35304,14128,2.8022e+13,172.357,2570.18,49432,206,175,15375,5460,3310,3580,3304
71780,202,304,51268,20512,2.80185e+13,172.82,3119.76,71780,246,175,71476,71476,65250,68423,71374
22532,143,215,16096,6436,2.80136e+13,170.643,1716.45,22532,158,144,21069,16984,16606,18372,18625
40271,153,247,28771,11500,2.80122e+13,171.999,2312.48,40271,190,175,38462,30472,33049,33556,35405
82704,19,323,59074,23630,2.79915e+13,173.04,3358.47,82704,266,175,49037,34984,14065,8377,12780
10247,149,193,7314,2933,2.81132e+13,166.045,1148.44,10247,130,121,9612,7724,7852,8507,8696
26508,154,222,18932,7576,2.80132e+13,170.99,1864.94,26508,165,151,25320,20045,22294,23188,23368
98428,29,352,70308,28120,2.80058e+13,173.2,3679.33,98428,295,175,66546,50184,16742,18149,17288
7906,21,188,5649,2257,2.79246e+13,164.236,1006.66,7906,122,112,4857,3460,1358,875,1263
73719,231,307,52660,21059,2.79958e+13,172.897,3162.94,73719,250,175,73412,73412,68957,71218,73336
57378,210,278,40986,16392,2.80159e+13,172.628,2777.3,57378,221,175,57100,57100,53217,55181,57032
43963,193,254,31402,12561,2.80169e+13,172.301,2420.14,43963,197,175,43709,43709,40311,42027,43648
32240,73,232,23024,9216,2.80201e+13,171.457,2061.9,32240,175,162,26181,21503,10302,14595,15000
84298,207,326,60209,24089,2.80017e+13,173.058,3392.22,84298,269,175,83972,83972,76595,80360,83853
2791,16,179,1998,793,2.82003e+13,145.702,594.557,2791,90,87,1541,1086,462,405,302
28671,150,226,20474,8197,2.80262e+13,171.321,1941.78,28671,169,156,27195,21678,22221,22998,24819
99462,349,353,71051,28411,2.79964e+13,173.225,3698.71,99462,297,175,99109,99109,99084,99091,99105
78634,415,947,56240,22394,2.72164e+13,222.017,4422.93,78634,798,191,77375,76753,69773,72917,75955
29654,212,228,21172,8482,2.80325e+13,171.175,1975.59,29654,170,157,29426,29426,29049,29212,29410
58901,797,800,42163,16738,2.68182e+13,221.085,3794.44,58901,798,175,58101,57902,57441,57605,58093
61875,130,286,44194,17681,2.80141e+13,172.772,2888.2,61875,229,175,56639,46614,38894,36824,47078
71269,137,303,50907,20362,2.801e+13,172.919,3108.39,71269,246,175,66140,53699,48547,48426,57303
78561,91,316,56118,22443,2.79999e+13,173.017,3270.17,78561,259,175,66420,54805,30745,25613,42887
55435,165,800,39691,15744,2.67348e+13,227.44,3709.92,55435,798,175,53131,41833,46586,47384,50143
11244,145,194,8033,3211,2.79242e+13,166.882,1203.32,11244,134,124,10499,8464,8375,8814,9305
76922,201,455,54926,21996,2.81058e+13,173.134,3420.45,76922,267,191,76467,76339,63945,59892,72638
36430,82,240,26018,10412,2.80167e+13,171.851,2196.08,36430,183,170,30179,25335,12798,12776,18387
71883,159,304,51347,20536,2.80038e+13,172.911,3122.18,71883,247,175,69531,54940,62811,67322,65415
31895,225,231,22786,9109,2.79522e+13,171.598,2050.29,31895,175,162,31664,31664,31610,31629,31658
61542,154,285,43956,17586,2.80032e+13,172.692,2879.41,61542,228,175,58968,46592,51874,52871,54432
51149,244,266,36530,14619,2.8009e+13,172.38,2615.82,51149,209,175,50883,50883,50102,50472,50861
70848,183,303,50604,20244,2.80174e+13,172.873,3099.51,70848,245,175,70545,70545,63139,66918,70425
67403,196,296,48143,19260,2.80123e+13,172.85,3019.57,67403,239,175,67107,67107,61040,64130,67007
53787,177,271,38420,15367,2.79938e+13,172.514,2685.09,53787,214,175,53516,53516,47839,50729,53422
76525,145,312,54664,21861,2.79978e+13,172.967,3225.27,76525,255,175,72133,57806,57362,60398,64140
45739,36,256,32677,13062,2.79695e+13,172.288,2468.82,45739,200,175,32645,25872,9246,10334,11246
47173,63,259,33699,13474,2.79908e+13,172.373,2509.09,47173,203,175,37463,30943,12895,12236,19019
92192,25,482,65832,26360,2.8101e+13,173.303,3739.99,92192,283,193,60159,43831,15714,11403,16436
22380,115,215,15979,6401,2.80592e+13,170.365,1710.44,22380,157,144,19825,16559,11786,13290,15343
79652,313,800,56984,22668,2.71179e+13,242.096,4253.59,79652,798,175,78404,77915,68516,73125,77263
92595,264,342,66132,26463,2.80214e+13,173.127,3564,92595,284,175,92253,92253,87682,90002,92175
60098,159,283,42925,17173,2.80201e+13,172.706,2844.89,60098,226,175,58103,45923,52486,56256,54850
78583,236,316,56133,22450,2.80046e+13,172.985,3270.41,78583,259,175,78267,78267,73543,75942,78187
46353,143,258,33103,13250,2.80182e+13,172.217,2486.68,46353,200,175,43471,35000,34231,37891,38262
50487,60,266,36063,14424,2.80191e+13,172.479,2599.57,50487,209,175,39792,32481,13534,9977,18676
57376,36,278,40984,16392,2.80169e+13,172.633,2777.27,57376,221,175,40952,32461,11238,8403,13966
84784,655,800,60651,24133,2.7167e+13,220.547,4357.88,84784,798,180,83922,83737,77893,80861,83550
31100,71,230,22208,8892,2.80285e+13,171.437,2024.32,31100,173,160,25139,20680,9560,13956,14124
84386,220,800,60363,24023,2.71783e+13,230.926,4349.8,84386,778,180,83072,82640,75599,78702,81648
14993,48,346,10682,4311,2.86044e+13,169.525,1570.62,14993,151,136,11358,9184,3446,2428,4304
59465,275,282,42470,16995,2.80225e+13,172.687,2829.56,59465,225,175,59183,59183,59114,59139,59176
50009,263,264,35724,14285,2.79913e+13,172.39,2585.67,50009,207,175,49745,49745,49745,49745,49744
59766,267,800,42784,16982,2.68424e+13,211.914,3815.25,59766,798,175,58549,58064,53847,55651,57305
19141,179,351,13659,5482,2.8408e+13,170.697,1756.35,19141,152,156,18771,18632,9615,5404,15742
2877,86,179,2056,821,2.77972e+13,146.613,603.119,2877,90,85,2343,1979,1090,1087,1482
15886,65,203,11347,4539,2.80428e+13,168.933,1435.27,15886,146,132,12637,10469,4406,3626,6435
13080,161,198,9341,3739,2.80307e+13,167.541,1299.93,13080,139,127,12574,9968,11359,12135,11907
28530,54,226,20384,8146,2.80068e+13,171.331,1937.28,28530,169,155,22076,18083,7042,8267,10179
21100,92,212,15076,6024,2.79863e+13,170.221,1658.82,21100,155,142,17833,14701,8308,8680,11862
22622,147,215,16155,6467,2.80266e+13,170.426,1719.24,22622,158,144,21315,17103,17162,18813,19170
38346,169,244,27381,10965,2.80489e+13,171.891,2255.38,38346,186,173,37694,29630,33789,35985,36767
27253,129,223,19462,7791,2.8012e+13,171.131,1891.35,27253,166,153,24830,20509,17027,15034,20498
50935,96,266,36386,14549,2.79967e+13,172.479,2610.72,50935,209,175,43502,35706,21196,21424,29321
84364,666,800,60348,24016,2.71787e+13,233.354,4349.36,84364,798,175,83478,83283,75039,79270,83163
50722,33,266,36233,14489,2.80087e+13,172.451,2605.47,50722,209,175,35378,27054,9384,6695,11107
18548,35,207,13255,5293,2.79502e+13,169.697,1552.7,18548,150,137,13126,10452,3643,4159,4621
11178,177,194,7989,3189,2.79128e+13,167.255,1200.42,11178,135,124,10984,10984,10524,10728,10967
40008,226,246,28576,11432,2.79782e+13,172.013,2304.14,40008,189,175,39762,39762,39117,39417,39742
91283,218,339,65203,26080,2.80123e+13,173.113,3536.86,91283,282,175,90944,90944,83466,87282,90823
80985,116,321,57846,23139,2.80207e+13,173.033,3322.99,80985,264,175,72109,60003,42768,40885,56348
19630,71,209,14028,5602,2.79301e+13,170.038,1598.78,19630,153,140,15831,13037,6029,6435,8801
4666,34,182,3337,1329,2.78216e+13,156.893,769.712,4666,106,99,3258,2612,867,1044,1096
91834,521,800,65689,26145,2.72416e+13,256.073,4495.86,91834,724,178,90917,90517,89867,90169,90197
58520,274,800,41893,16627,2.68075e+13,213.342,3785.74,58520,784,179,57324,56820,53583,54889,56104
84277,534,800,60284,23993,2.71751e+13,233.935,4347.91,84277,773,180,83352,82952,80871,81924,82679
95884,144,347,68498,27386,2.79985e+13,173.225,3628.91,95884,291,175,90206,72427,71205,78972,80515
88196,133,946,63064,25132,2.73068e+13,251.255,4615.33,88196,810,175,80221,65801,55135,52227,65891
39860,151,246,28472,11388,2.80114e+13,172.015,2300.07,39860,189,175,37934,30161,31441,33717,34859
57828,42,278,41312,16516,2.79829e+13,172.623,2787.71,57828,222,175,42841,33867,12478,9220,16089
75246,285,310,53741,21505,2.80022e+13,172.959,3197.43,75246,253,175,74936,74936,73969,74434,74911
4576,152,183,3264,1312,2.84001e+13,156.049,763.567,4576,106,100,4232,3425,3600,3834,3896
80868,218,321,57759,23109,2.80281e+13,172.979,3320.63,80868,263,175,80547,80547,74280,77473,80444
57260,76,277,40906,16354,2.79876e+13,172.618,2773.45,57260,220,175,46836,38914,19109,18151,26437
19659,175,209,14046,5613,2.7932e+13,169.993,1599.85,19659,152,139,19450,19450,17840,18639,19416
75910,191,311,54221,21689,2.79984e+13,172.961,3211.87,75910,254,175,75599,75599,68146,71952,75479
35394,23,238,25280,10114,2.80054e+13,171.774,2163.58,35394,181,167,22448,16381,6021,5254,4974
62251,268,286,44471,17780,2.79851e+13,172.721,2896.46,62251,230,175,61965,61965,61439,61679,61947
84581,148,327,60414,24167,2.80113e+13,173.072,3398.78,84581,270,175,80177,64041,64639,67230,72465
92807,124,342,66293,26514,2.8015e+13,173.153,3567.84,92807,285,175,83980,69438,56531,45869,67443
8079,43,729,5810,2269,2.37893e+13,146.966,1656.61,8079,422,109,5716,4649,1557,1032,135
64476,190,467,46067,18409,2.78514e+13,171.797,3166.16,64476,245,175,64009,64009,56093,42712,5310
13934,61,200,9956,3978,2.80101e+13,168.558,1343.55,13934,143,129,10963,8995,3766,3045,5293
36451,6,239,26039,10412,2.79968e+13,171.742,2195.61,36451,183,170,12846,4872,3227,2702,1722
48730,44,262,34802,13928,2.80037e+13,172.408,2551.64,48730,205,175,36440,28799,10974,14397,15104
17638,66,206,12596,5042,2.80193e+13,169.64,1514.3,17638,149,136,14069,11644,5081,5574,7415
27587,190,224,19706,7881,2.80148e+13,171.242,1903.82,27587,167,153,27363,27363,25773,26560,27329
35548,5,238,25394,10154,2.79831e+13,171.824,2168.34,35548,181,167,11040,3910,2377,2632,2812
36252,14,240,25897,10355,2.79911e+13,171.908,2191.05,36252,183,170,19129,13037,5505,2743,2759
86301,58,330,61646,24655,2.80044e+13,173.099,3434.61,86301,273,175,67704,55382,22623,21575,32717
60717,276,284,43366,17351,2.80081e+13,172.616,2859.87,60717,226,175,60433,60433,60341,60378,60425
28704,30,226,20501,8203,2.80331e+13,171.288,1942.75,28704,169,156,19547,14791,4971,3596,5648
43663,154,253,31185,12478,2.80159e+13,172.18,2410.94,43663,196,175,41793,33042,36779,38262,38739
96566,31,493,68942,27624,2.81098e+13,173.276,3831.72,96566,290,193,66360,50277,17349,12315,20421
62451,183,287,44606,17845,2.80083e+13,172.718,2901.89,62451,230,175,62164,62164,55835,59058,62060
25406,45,220,18144,7262,2.8009e+13,170.867,1824.78,25406,163,149,19049,15154,5662,4205,7345
78440,139,316,56027,22413,2.80126e+13,172.961,3267.56,78440,259,175,73084,59114,55979,56851,63273
31851,105,232,22754,9097,2.79996e+13,171.628,2049.81,31851,175,162,27669,23342,14919,14130,19960
36899,313,800,26448,10451,2.61114e+13,213.064,3203.52,36899,751,166,35766,35238,33727,34245,34638
21884,171,213,15638,6246,2.79422e+13,170.356,1689.87,21884,157,144,21523,16923,19534,20610,21205
36227,48,239,25877,10350,2.80066e+13,171.807,2189.18,36227,182,169,27475,22130,8397,10343,11960
70798,230,302,50571,20227,2.80074e+13,172.897,3097.48,70798,245,175,70496,70496,66310,68433,70424
66982,102,941,47912,19070,2.71204e+13,214.753,4164.19,66982,800,193,57085,48325,28069,18855,34624
31347,17,230,22394,8953,2.79828e+13,171.475,2031.9,31347,173,160,17781,12622,5268,3802,3419
10258,171,193,7322,2936,2.80831e+13,166.273,1149.31,10258,131,121,9997,7908,9320,9678,9821
50027,209,264,35737,14290,2.79925e+13,172.503,2586.41,50027,208,175,49763,49763,46715,48252,49708
62944,114,288,44956,17988,2.80126e+13,172.774,2914.13,62944,231,175,55808,46624,32996,29753,42320
57753,61,421,41233,16520,2.81533e+13,172.869,2971.77,57753,237,181,45652,37446,15026,12576,21322
44406,17,254,31718,12688,2.79879e+13,172.194,2431.59,44406,197,175,25201,17899,7470,4980,6537
27865,128,224,19904,7961,2.79778e+13,171.088,1912.81,27865,167,154,25361,20928,17341,15361,20807
4138,113,181,2956,1182,2.79014e+13,154.829,724.48,4138,101,95,3588,3032,2162,2271,2736
53808,86,271,38429,15379,2.80248e+13,172.479,2685.83,53808,214,175,44992,37543,19911,25908,28849
89248,56,336,63741,25507,2.80184e+13,173.076,3496.05,89248,278,175,69620,57127,22485,26991,32766
44666,76,255,31906,12760,2.80173e+13,172.219,2439.5,44666,198,175,36533,30345,14863,11203,20608
70375,294,301,50269,20106,2.80137e+13,172.86,3087.68,70375,244,175,70074,70074,70003,70030,70067
28359,63,226,20256,8103,2.80267e+13,171.297,1931.43,28359,169,155,22499,18589,7770,6340,11054
13023,142,197,9306,3717,2.79803e+13,167.778,1296.41,13023,139,127,12106,9806,9500,10478,10584
53603,154,271,38290,15313,2.80032e+13,172.577,2680.96,53603,214,175,51337,40569,45173,46995,47625
2053,30,178,1469,584,2.81185e+13,136.307,509.399,2053,77,77,1374,1055,375,255,425
26180,22,221,18701,7479,2.79822e+13,170.946,1852.64,26180,164,151,16366,11638,4455,2747,4030
35424,61,239,25301,10123,2.80135e+13,171.76,2165.59,35424,181,168,27980,22918,9590,11154,14021
40438,248,800,28972,11466,2.62635e+13,211.721,3308.57,40438,758,172,39237,38772,36854,37430,37972
6886,52,186,4920,1966,2.80331e+13,162.233,937.673,6886,117,108,5263,4289,1689,2156,2485
19836,692,800,14256,5580,2.45525e+13,221.157,2594.62,19836,680,138,19036,18875,18740,18775,18713
1780,69,177,1267,513,2.79212e+13,129.531,472.792,1780,74,73,1377,1157,558,594,767
59781,132,282,42704,17077,2.79991e+13,172.699,2836.65,59781,225,175,54923,45039,38245,36342,46122
48038,109,261,34314,13724,2.7985e+13,172.39,2533,48038,204,175,42114,35318,23648,23053,31199
1032,160,176,736,296,2.82425e+13,97.1599,358.886,1032,58,60,856,746,800,826,823
92354,76,341,65968,26386,2.80076e+13,173.17,3558.58,92354,284,175,75586,62768,30741,38758,44556
36744,192,241,26249,10495,2.80072e+13,171.971,2206.38,36744,184,170,36503,36503,33923,35219,36454
85010,703,800,60805,24205,2.72025e+13,220.227,4362.55,85010,798,180,84210,83980,79177,81612,83920
19048,91,209,13601,5447,2.80888e+13,169.877,1575.21,19048,152,138,16046,13266,7465,7408,10472
77116,162,314,55089,22027,2.80023e+13,173.028,3239.37,77116,257,175,75008,59072,67454,72251,71159
56615,261,276,40435,16180,2.80181e+13,172.541,2757.34,56615,219,175,56339,56339,56022,56161,56324
93594,290,343,66858,26736,2.79961e+13,173.199,3583.46,93594,287,175,93251,93251,90340,91807,93198
9853,176,192,7033,2820,2.80798e+13,165.775,1125.44,9853,129,119,9661,9661,9281,9446,9645
28828,89,226,20596,8232,2.79956e+13,171.24,1946.67,28828,169,156,24230,20094,11230,10967,15641
69305,204,300,49501,19804,2.80135e+13,172.915,3064,69305,243,175,69005,69005,63229,66170,68909
75328,125,310,53810,21518,2.79997e+13,172.981,3199.13,75328,254,175,68280,56623,45948,43580,55845
94531,26,345,67519,27012,2.80105e+13,173.179,3602.34,94531,288,175,62371,45802,16077,16434,18356
61332,204,285,43813,17519,2.8005e+13,172.746,2874.93,61332,228,175,61047,61047,56254,58689,60966
37083,154,241,26485,10598,2.7998e+13,171.92,2216.21,37083,184,170,35477,28055,31225,32480,32634
7290,40,187,5211,2079,2.79664e+13,163.453,966.028,7290,121,110,5315,4177,1528,1146,1851
90906,603,800,65023,25883,2.72286e+13,228.639,4477.88,90906,798,175,89964,89564,81885,85814,89515
86092,101,329,61504,24588,2.7989e+13,173.11,3429.58,86092,273,175,74320,62705,38623,38024,51977
68358,268,297,48824,19534,2.80082e+13,172.795,3040.78,68358,240,175,68061,68061,66799,67417,68032
75264,95,310,53763,21501,2.80048e+13,172.971,3197.83,75264,254,175,64156,52780,31060,35394,43954
97310,477,500,69476,27834,2.81062e+13,173.271,3851.74,97310,307,188,96810,96810,96134,96450,96787
17738,140,206,12669,5069,2.80279e+13,169.52,1518.43,17738,149,136,16447,13332,12699,12852,14359
7954,141,188,5686,2268,2.78799e+13,164.132,1009.4,7954,122,112,7337,5974,5679,6033,6380
70022,347,445,49998,20024,2.81307e+13,173.081,3267.27,70022,256,191,69577,69577,67017,65079,67922
69108,777,800,49456,19652,2.69809e+13,215.528,4029.04,69108,798,175,68308,68105,63398,65852,68240
50281,250,265,35915,14366,2.79967e+13,172.458,2593.49,50281,208,175,50016,50016,49724,49851,50001
88846,57,334,63462,25384,2.79883e+13,173.11,3486.52,88846,278,175,69510,56851,22528,24592,32460
84707,58,327,60509,24198,2.80028e+13,173.038,3400.95,84707,270,175,66457,54368,21572,18576,30363
75710,440,456,54049,21661,2.81206e+13,173.067,3396.08,75710,252,192,75254,75254,74957,75095,75238
39263,154,245,28045,11218,2.80034e+13,171.979,2282.38,39263,188,175,37552,29704,33055,34395,34666
91429,305,339,65302,26127,2.80153e+13,173.091,3539.51,91429,282,175,91090,91090,89507,90291,91056
43111,169,252,30794,12317,2.80121e+13,172.183,2395.05,43111,195,175,42403,33316,37982,40469,41740
54102,231,272,38646,15456,2.80155e+13,172.511,2693.8,54102,215,175,53830,53830,51784,52802,53789
27501,166,223,19646,7855,2.79488e+13,171.137,1899.71,27501,167,154,26853,21184,24205,25767,25861
30560,18,230,21833,8727,2.79984e+13,171.523,2007.13,30560,173,159,17725,12595,5127,2535,2842
61918,316,431,44208,17710,2.81605e+13,172.967,3076.81,61918,228,193,61487,61474,56535,55026,59828
39768,142,246,28408,11360,2.80125e+13,172.022,2297.48,39768,189,175,37212,30021,29063,32131,33120
98900,6,353,70639,28261,2.80131e+13,173.225,3688.84,98900,296,175,34872,13234,8761,7156,3188
28686,124,226,20493,8193,2.80262e+13,171.227,1942.09,28686,169,156,25888,21436,17463,14222,20884
45560,221,256,32544,13016,2.79959e+13,172.297,2464.2,45560,199,175,45304,45304,43626,44460,45269
93457,47,493,66733,26724,2.81094e+13,173.313,3774.95,93457,285,195,70691,56618,21256,14918,27393
23240,157,216,16597,6643,2.80143e+13,170.577,1743.27,23240,159,145,22304,17650,20235,20974,20857
82008,115,800,58667,23341,2.71561e+13,225.703,4302.04,82008,798,175,72019,60131,42160,47177,54355
27785,165,224,19847,7938,2.80026e+13,171.134,1910.18,27785,167,154,27081,21309,24399,26007,26113
93651,105,343,66897,26754,2.79956e+13,173.147,3584.29,93651,286,175,81552,68725,43880,41541,58660
7892,62,189,5634,2258,2.8242e+13,163.572,1006.09,7892,122,113,6211,5116,2199,2533,3190
12781,47,197,9125,3656,2.80476e+13,167.626,1284.55,12781,139,127,9636,7733,2990,3651,4095
40834,43,248,29165,11669,2.80191e+13,171.982,2328.95,40834,191,175,30393,24070,9098,6380,11311
98632,263,352,70451,28181,2.79964e+13,173.191,3682.89,98632,295,175,98280,98280,92940,95657,98191
83586,98,325,59707,23879,2.80044e+13,173.044,3377.44,83586,268,175,71729,60579,36160,34068,49407
42514,12,251,30371,12143,2.8018e+13,172.13,2378.08,42514,194,175,20987,13305,6307,2998,2848
67305,89,295,48075,19230,2.80029e+13,172.796,3016.4,67305,238,175,56644,46961,26218,32750,36876
49306,185,407,35191,14115,2.81876e+13,172.65,2753.03,49306,209,192,48885,48746,34925,28671,44347
83667,69,325,59765,23902,2.79958e+13,173.053,3379.05,83667,268,175,67416,55507,24572,25148,35351
41913,33,250,29933,11980,2.802e+13,172.182,2360.92,41913,193,175,29229,22353,7751,7059,9401
84142,171,326,60101,24041,2.80018e+13,173.058,3389.23,84142,269,175,83216,65223,74010,79031,81963
85604,100,329,61147,24457,2.80104e+13,173.103,3420.47,85604,272,175,73774,62187,38225,35503,51465
30922,5,230,22092,8830,2.79849e+13,171.54,2018.6,30922,173,160,9612,3406,2069,2182,756
47526,65,260,33942,13584,2.79932e+13,172.381,2518.98,47526,203,175,37922,31342,13148,16274,20257
68814,705,800,49242,19572,2.69898e+13,225.972,4022.85,68814,798,175,67989,67757,61146,64548,67730
67082,62,296,47912,19170,2.80183e+13,172.851,3012.51,67082,239,175,53188,43525,18213,14828,26085
76273,215,312,54479,21794,2.8011e+13,172.989,3220.23,76273,255,175,75961,75961,70087,73079,75864
61467,47,285,43909,17558,2.79985e+13,172.759,2878.07,61467,228,175,46471,37218,14115,13575,18914
87052,424,800,62272,24780,2.71951e+13,234.035,4402.5,87052,798,175,85921,85302,76588,81219,85100
99267,202,353,70906,28361,2.79918e+13,173.187,3695.17,99267,296,175,98914,98914,89351,94242,98763
13466,44,198,9619,3847,2.79484e+13,168.11,1319,13466,141,128,10043,7948,3051,2196,3798
78925,799,800,56462,22463,2.71394e+13,247.887,4238.8,78925,795,175,78125,77878,77857,77857,78123
63003,101,287,45003,18000,2.79975e+13,172.742,2914.37,63003,231,175,54360,45883,28295,33156,38676
24160,76,218,17259,6901,2.80374e+13,170.796,1778.78,24160,161,148,19725,16399,8051,8207,11461
93432,164,343,66738,26694,2.80085e+13,173.162,3580.21,93432,286,175,91252,71589,81798,87591,88136
96757,463,800,69198,27559,2.72861e+13,261.201,4588.86,96757,649,175,95928,95528,95080,95120,94948
56342,19,276,40248,16094,2.80038e+13,172.6,2751.04,56342,219,175,33408,23838,9585,7536,5705
17534,175,205,12525,5009,2.79686e+13,169.495,1508.72,17534,148,135,17329,17329,15991,16650,17299
33656,30,235,24038,9618,2.80167e+13,171.676,2108.36,33656,178,164,22917,17337,5808,4273,7136
11269,13,194,8051,3218,2.79622e+13,166.769,1204.08,11269,133,124,5756,3882,1682,1376,866
12512,57,197,8941,3571,2.80877e+13,167.943,1271.58,12512,139,126,9736,7989,3322,3139,4601
66115,187,293,47223,18892,2.80086e+13,172.744,2988.47,66115,236,175,65822,65822,59329,62639,65716
32434,229,233,23172,9262,2.79912e+13,171.661,2068.95,32434,176,163,32201,32201,32186,32189,32197
17943,146,206,12821,5122,2.79509e+13,169.707,1527.05,17943,150,136,16856,13552,13495,14138,15036
34144,82,236,24383,9761,2.80287e+13,171.503,2123.88,34144,178,165,28285,23760,12034,16204,17380
41707,165,250,29789,11918,2.80403e+13,172.088,2355.09,41707,193,175,40717,32005,36554,39058,39080
3670,78,181,2627,1043,2.78902e+13,153.092,683.037,3670,98,92,2935,2490,1270,1280,1747
12418,30,196,8876,3542,2.79147e+13,167.531,1265.5,12418,138,126,8449,6385,2160,2001,2673
32881,57,233,23489,9392,2.7979e+13,171.626,2082.76,32881,176,163,25686,21021,8357,7618,11732
91659,15,340,65469,26190,2.80111e+13,173.133,3544.72,91659,283,175,49714,34313,14429,8462,11714
93763,469,800,67064,26699,2.72624e+13,223.651,4532.35,93763,798,180,92707,92397,85573,89034,91970
32333,227,800,23184,9149,2.58405e+13,209.079,3058.72,32333,780,158,31095,30681,27621,28744,29782
64252,186,290,45894,18358,2.80011e+13,172.776,2944.82,64252,233,175,63962,63962,57602,60844,63858
67747,236,296,48384,19363,2.80135e+13,172.77,3026.58,67747,239,175,67451,67451,64086,65786,67391
89123,104,336,63651,25472,2.80198e+13,173.117,3493.7,89123,278,175,77427,65395,41145,48350,55786
79446,83,318,56747,22699,2.80105e+13,173.037,3289.81,79446,261,175,66027,55279,28028,21879,38800
32541,100,800,23331,9210,2.58224e+13,210.692,3065.35,32541,753,158,27182,23029,13740,13260,17954
59238,155,281,42315,16923,2.80086e+13,172.646,2823.12,59238,224,175,56857,45058,50245,50989,52732
30434,20,229,21741,8693,2.80265e+13,171.395,2001.92,30434,172,159,18425,13041,5185,3371,3767
12710,128,197,9079,3631,2.79825e+13,167.609,1281.27,12710,140,127,11493,9523,7887,7946,9408
23128,63,216,16515,6613,2.80343e+13,170.667,1739.3,23128,159,146,18339,15156,6350,7182,9447
50418,120,265,36014,14404,2.79989e+13,172.418,2596.76,50418,208,175,45234,37435,28186,24576,35684
10325,263,340,7352,2973,2.88135e+13,162.13,1326.74,10325,135,118,9985,9934,9875,9830,9869
33845,215,235,24174,9671,2.80392e+13,171.617,2114.15,33845,178,165,33610,33610,32987,33275,33590
46727,176,258,33376,13351,2.80049e+13,172.269,2496.41,46727,201,175,46469,46469,41608,44078,46387
73515,232,306,52513,21002,2.79989e+13,172.91,3157.96,73515,250,175,73209,73209,68870,71072,73135
72846,100,306,52036,20810,2.80067e+13,172.965,3144.28,72846,249,175,62776,52917,32513,26913,43418
89070,235,800,63710,25360,2.72334e+13,223.414,4442.49,89070,798,176,87777,87315,80039,83327,86391
14219,47,200,10158,4061,2.8043e+13,168.532,1356.67,14219,143,129,10715,8596,3278,2464,4222
25773,114,220,18410,7363,2.79489e+13,170.973,1837.74,25773,163,150,22789,19072,13462,12953,17328
18238,8,207,13024,5214,2.79929e+13,169.736,1540.24,18238,150,137,7582,3463,2113,1421,864
35883,166,239,25635,10248,2.80122e+13,171.82,2179.02,35883,182,169,35077,27659,31535,33627,33956
33706,137,235,24076,9630,2.80044e+13,171.642,2109.95,33706,178,164,31223,25378,22946,24283,26845
89723,398,800,64179,25544,2.72361e+13,221.72,4455.13,89723,798,180,88607,87967,82027,85233,87703
17946,7,207,12819,5127,2.80719e+13,169.615,1528.04,17946,150,136,6954,2798,1952,1105,688
43953,4,402,31371,12582,2.81929e+13,172.51,2608.63,43953,206,175,11506,3505,2559,3066,1572
90201,219,337,64431,25770,2.79987e+13,173.132,3514.89,90201,280,175,89864,89864,82545,86281,89746
63637,57,289,45455,18182,2.80106e+13,172.746,2930.24,63637,232,175,49776,40723,16911,15452,23028
36229,4,239,25883,10346,2.79817e+13,171.81,2189.16,36229,183,169,9493,2873,2091,2030,790
30005,227,228,21436,8569,2.79954e+13,171.489,1987.34,30005,172,158,29777,29777,29775,29775,29776
75292,16,310,53780,21512,2.80244e+13,172.895,3198.23,75292,253,175,41798,29417,12407,8329,11132
13704,68,199,9790,3914,2.8059e+13,168.227,1331.44,13704,142,129,10961,9069,4055,3746,5938
64336,251,290,45952,18384,2.79908e+13,172.772,2946.67,64336,233,175,64046,64046,62109,63074,64007
12557,108,196,8972,3585,2.78412e+13,167.79,1272.7,12557,139,127,10915,9186,6145,6029,8041
61895,248,286,44211,17684,2.80051e+13,172.71,2888.51,61895,229,175,61609,61609,59766,60680,61571
81428,190,321,58166,23262,2.80014e+13,173.042,3331.72,81428,264,175,81107,81107,72901,77095,80976
9682,65,192,6917,2765,2.81103e+13,166.078,1116.46,9682,129,119,7669,6370,2699,2050,3735
16543,167,345,11789,4754,2.85629e+13,169.69,1638.66,16543,150,149,15968,12737,8324,5269,12991
26141,189,221,18681,7460,2.79701e+13,171.12,1851.67,26141,165,151,25920,25920,24437,25169,25888
59061,178,281,42181,16880,2.80139e+13,172.715,2819.44,59061,224,175,58780,58780,52509,55704,58677
63641,8,289,45460,18181,2.80044e+13,172.756,2930.31,63641,232,175,26467,12081,7365,4951,5144
99904,248,355,71355,28549,2.80121e+13,173.166,3708.37,99904,297,175,99549,99549,92985,96332,99442
88692,746,800,63440,25252,2.72225e+13,221.919,4434.92,88692,798,180,87892,87688,83263,85521,87731
41078,121,248,29341,11737,2.79897e+13,172.086,2335.97,41078,191,175,36914,30567,23307,20087,29221
42639,80,251,30452,12187,2.80052e+13,172.181,2381.46,42639,194,175,35175,29583,14613,16014,21425
34197,214,236,24422,9775,2.80222e+13,171.767,2125.99,34197,179,166,33961,33961,33198,33558,33939
79268,667,951,56679,22589,2.72439e+13,240.121,4440.54,79268,800,196,78226,78026,69251,73400,77465
41409,164,249,29574,11835,2.80176e+13,172.028,2345.95,41409,191,175,40357,31708,36249,38762,38727
37016,130,241,26442,10574,2.80182e+13,171.846,2214.04,37016,184,171,33831,27872,23281,21247,28046
13767,160,198,9837,3930,2.79512e+13,168.134,1333.53,13767,142,129,13223,10488,11959,12784,12523
8642,64,190,6170,2472,2.79901e+13,165.244,1053.42,8642,125,115,6821,5672,2404,2699,3549
95360,277,496,68086,27274,2.81007e+13,173.275,3812.73,95360,288,193,94864,94744,83211,81161,88661
10389,80,193,7419,2970,2.80406e+13,166.529,1156.75,10389,131,121,8512,7178,3565,3632,5155
34191,78,236,24424,9767,2.80189e+13,171.779,2125.68,34191,179,165,28072,23395,11444,10010,16446
10789,49,194,7711,3078,2.80711e+13,166.905,1179.51,10789,133,123,8176,6629,2549,2346,3393
86630,12,947,61947,24683,2.73031e+13,221.416,4585.04,86630,800,192,42758,27513,12757,5354,7997
88692,296,334,63346,25346,2.79988e+13,173.079,3483.47,88692,277,175,88358,88358,86489,87419,88320
22616,42,214,16159,6457,2.79717e+13,170.47,1718.45,22616,158,145,16734,13234,4889,6083,6659
20955,169,212,14966,5989,2.8012e+13,170.248,1653.42,20955,155,141,20527,16169,18585,19673,20045
40821,50,248,29162,11659,2.80073e+13,172.117,2328.91,40821,191,175,31177,25226,9743,9257,13212
26010,156,221,18578,7432,2.80136e+13,171.003,1846.86,26010,164,151,24934,19757,22099,23439,23219
58275,87,418,41604,16671,2.81524e+13,172.842,2979.72,58275,235,184,48801,40700,20453,17508,28329
54770,170,273,39124,15646,2.80004e+13,172.584,2710.96,54770,216,175,54012,42437,48262,51446,52818
24377,75,218,17413,6964,2.799e+13,170.81,1786.6,24377,161,147,19861,16416,8059,7016,11288
91779,416,800,65643,26136,2.72519e+13,233.9,4494.3,91779,798,175,90638,90020,81171,85877,89785
79287,464,800,56725,22562,2.71255e+13,239.29,4246.63,79287,798,175,78194,77947,68871,73486,77479
30281,87,229,21623,8658,2.80333e+13,171.231,1996.79,30281,171,158,25350,21122,11539,14644,16257
81900,143,472,58475,23425,2.81029e+13,173.183,3535.53,81900,280,184,76792,61879,55528,49906,65473
67320,277,295,48084,19236,2.79987e+13,172.792,3016.7,67320,238,175,67025,67025,66503,66742,67007
98613,84,352,70435,28178,2.79976e+13,173.195,3682.54,98613,295,175,82141,68630,35008,32857,49581
14313,151,200,10223,4090,2.8026e+13,168.547,1361.4,14313,143,130,13537,10800,11236,11622,12397
24124,211,217,17225,6899,2.80151e+13,170.58,1776.2,24124,160,147,23907,23907,23855,23873,23901
42838,22,251,30600,12238,2.79836e+13,172.125,2386.72,42838,194,175,26785,19046,7286,5657,7938
39596,40,246,28276,11320,2.80275e+13,171.898,2292.52,39596,188,175,29041,22774,8249,8764,10953
50198,47,264,35854,14344,2.80038e+13,172.341,2590.38,50198,207,175,37955,30409,11570,14275,16438
55435,237,274,39595,15840,2.79896e+13,172.551,2727.5,55435,217,175,55161,55161,53364,54255,55124
56620,179,276,40439,16181,2.79981e+13,172.573,2757.41,56620,219,175,56344,56344,50463,53458,56247
63341,227,288,45250,18091,2.79903e+13,172.796,2922.86,63341,232,175,63053,63053,59598,61345,62992
1883,116,178,1348,535,2.83397e+13,132.97,487.779,1883,75,74,1587,1355,1001,941,1203
33364,90,800,23929,9435,2.58691e+13,208.481,3092.13,33364,769,160,27311,22757,12402,13856,17081
50569,36,265,36124,14445,2.79876e+13,172.413,2600.62,50569,208,175,36095,28615,10264,7051,11731
81574,279,321,58266,23308,2.79944e+13,172.997,3334.32,81574,264,175,81253,81253,79107,80180,81211
74761,120,450,53384,21377,2.81103e+13,173.124,3370.05,74761,251,193,67017,55543,33646,26330,48304
68272,413,442,48738,19534,2.81402e+13,173.025,3227.39,68272,239,193,67830,67830,66765,67282,67801
84176,222,326,60126,24050,2.79955e+13,173.052,3389.85,84176,269,175,83850,83850,77500,80736,83746
32355,221,232,23109,9246,2.80162e+13,171.4,2065.14,32355,175,162,32123,32123,31956,32029,32112
2695,25,179,1921,774,2.81078e+13,143.44,583.557,2695,91,83,1743,1276,472,311,470
30980,11,230,22129,8851,2.80052e+13,171.498,2020.4,30980,173,159,14725,9074,4537,2631,2172
8694,83,190,6213,2481,2.8082e+13,165.012,1056.65,8694,125,116,7151,6025,3079,3102,4376
57047,117,277,40752,16295,2.79958e+13,172.581,2768.38,57047,220,175,50880,42262,31053,27813,39352
17399,116,206,12434,4965,2.80158e+13,169.666,1504.39,17399,149,135,15417,12856,9181,9003,11925
34485,11,237,24632,9853,2.80291e+13,171.718,2135.39,34485,180,166,16408,10113,5059,2812,3493
15162,69,202,10829,4333,2.80911e+13,168.762,1402.09,15162,145,131,12164,10042,4516,3605,6466
46300,159,258,33072,13228,2.80138e+13,172.313,2485.36,46300,201,175,44730,35370,40413,43307,42209
66999,4,295,47860,19139,2.80004e+13,172.857,3009.82,66999,239,175,17567,5326,3878,3754,1489
80964,298,320,57829,23135,2.80141e+13,172.993,3321.45,80964,263,175,80644,80644,79870,80237,80622
24985,139,219,17846,7139,2.80471e+13,170.78,1809.16,24985,162,149,23187,18798,17807,18092,20065
81919,277,322,58513,23406,2.8002e+13,173.047,3342.22,81919,265,175,81597,81597,79248,80425,81552
31264,179,231,22327,8937,2.80481e+13,171.394,2030.17,31264,173,160,31033,31033,28219,29635,30981
65610,123,293,46863,18747,2.80095e+13,172.84,2977.72,65610,236,175,59222,49073,39354,32301,47288
50222,208,800,35963,14259,2.66027e+13,209.713,3577.75,50222,795,175,48944,48538,44357,45995,47548
53450,198,271,38183,15267,2.7999e+13,172.55,2677.07,53450,214,175,53179,53179,48967,51103,53106
52280,40,268,37338,14942,2.79955e+13,172.435,2645.58,52280,211,175,38355,30056,10872,11544,15592
71179,306,800,50933,20246,2.70326e+13,226.832,4074.87,71179,770,180,70029,69456,67266,68081,68881
53616,15,271,38297,15319,2.80148e+13,172.509,2681.03,53616,214,175,29081,20076,8438,4949,6410
88014,620,800,62961,25053,2.71906e+13,220.774,4421.52,88014,798,180,87131,86731,81902,84515,86674
13554,47,199,9684,3870,2.80787e+13,168.317,1324.52,13554,142,128,10209,8195,3134,2361,4105
88830,216,334,63452,25378,2.79917e+13,173.111,3486.23,88830,277,175,88496,88496,81174,84913,88378
12102,81,196,8642,3460,2.80156e+13,167.328,1249.67,12102,138,125,9953,8402,4261,4352,6017
63276,729,800,45282,17994,2.70222e+13,229.954,3835.73,63276,569,175,62476,62476,62416,62339,62476
9346,95,191,6674,2672,2.80062e+13,165.123,1095.7,9346,128,117,7892,6545,3924,4779,5401
32675,190,233,23337,9338,2.80089e+13,171.566,2076.25,32675,176,162,32442,32442,30228,31336,32399
18804,112,208,13430,5374,2.8004e+13,169.653,1564.33,18804,151,138,16527,13877,9750,10905,12577
3701,175,181,2637,1064,2.81904e+13,151.595,685.115,3701,99,93,3520,3520,3468,3486,3514
30850,4,230,22036,8814,2.80137e+13,171.498,2016.3,30850,173,159,8093,2459,1791,1730,650
5362,75,184,3833,1529,2.79921e+13,159.86,827.62,5362,110,103,4311,3583,1763,1545,2420
5980,102,185,4273,1707,2.8136e+13,160.803,873.869,5980,113,106,5083,4330,2707,2552,3540
72445,439,445,51732,20713,2.81168e+13,172.097,3316.84,72445,247,188,72000,72000,71961,71973,71994
12497,62,342,8902,3595,2.86844e+13,168.68,1445.23,12497,147,142,9861,8165,3264,2511,4386
49385,721,800,35362,14023,2.65946e+13,218.896,3555.86,49385,750,180,48585,48415,47550,47970,48349
8894,149,190,6349,2545,2.79729e+13,165.329,1068.68,8894,125,116,8329,6696,6802,7063,7544
38440,357,389,27432,11008,2.82474e+13,172.272,2443.11,38440,186,189,38051,38051,36799,37412,38019
6551,46,186,4681,1870,2.78112e+13,162.408,915.495,6551,116,107,4894,3932,1480,1971,2093
73450,43,307,52462,20988,2.80121e+13,172.922,3157.49,73450,250,175,54682,43291,15953,11724,20398
87694,431,475,62618,25076,2.80974e+13,173.232,3650.61,87694,274,192,87219,87219,85110,86164,87175
5693,79,184,4068,1625,2.80464e+13,160.02,852.147,5693,111,104,4638,3887,1974,2668,2817
25468,50,220,18196,7272,2.80238e+13,170.893,1827.02,25468,163,150,19436,15733,6097,7417,8834
22865,107,216,16333,6532,2.80551e+13,170.55,1729.52,22865,159,145,19929,16752,11052,11710,14741
22652,129,215,16181,6471,2.80205e+13,170.414,1720.38,22652,158,144,20637,17046,14188,14228,17124
92202,273,341,65860,26342,2.80156e+13,173.174,3555.9,92202,284,175,91861,91861,87974,89942,91793
81371,55,321,58117,23254,2.80088e+13,173.034,3330.48,81371,264,175,63270,51779,20335,23702,29470
50713,224,266,36226,14487,2.8022e+13,172.459,2605.29,50713,209,175,50447,50447,48334,49387,50405
68513,155,298,48935,19578,2.80106e+13,172.869,3045.28,68513,241,175,65775,52113,58128,58994,61544
89419,497,800,63963,25456,2.72216e+13,221.979,4449.1,89419,798,180,88416,88061,83048,85587,87710
18136,189,207,12956,5180,2.80339e+13,169.658,1536.01,18136,150,137,17929,17929,17447,17660,17911
44952,123,800,32199,12753,2.64577e+13,212.02,3436.81,44952,767,175,39665,32950,25693,22674,30815
21786,60,213,15557,6229,2.7971e+13,170.274,1685.93,21786,156,143,17147,14013,5854,7281,8797
76666,853,941,54834,21832,2.71951e+13,217.432,4374.47,76666,807,184,75725,75696,73671,72157,73906
83920,10,326,59946,23974,2.80121e+13,173.061,3385.01,83920,269,175,38394,20790,11536,6681,7478
99239,44,353,70885,28354,2.80083e+13,173.168,3694.64,99239,296,175,74261,58680,22363,27460,30434
11802,184,196,8431,3371,2.81074e+13,167.299,1234.39,11802,137,125,11606,11606,11423,11499,11594
69458,50,300,49610,19848,2.80167e+13,172.897,3067.45,69458,243,175,53078,42939,16590,12224,21885
45062,214,255,32193,12869,2.79772e+13,172.281,2450.16,45062,199,175,44807,44807,42715,43759,44766
3878,83,181,2771,1107,2.80292e+13,154.209,702.078,3878,100,92,3151,2673,1420,1840,1990
13292,24,198,9492,3800,2.79861e+13,168.156,1310.9,13292,141,128,8537,6266,2264,2109,1724
31494,177,230,22499,8995,2.79952e+13,171.423,2036.51,31494,174,161,31264,31264,28353,29820,31211
34609,10,237,24723,9886,2.80385e+13,171.774,2139.28,34609,180,166,15831,8576,4756,2756,1910
98653,347,352,70473,28180,2.79962e+13,173.233,3683.5,98653,296,175,98301,98301,98263,98275,98296
83488,268,325,59634,23854,2.80086e+13,173.076,3375.68,83488,268,175,83163,83163,80009,81601,83106
34463,142,236,24615,9848,2.8002e+13,171.66,2133.57,34463,179,166,32243,26015,25189,25131,28261
3609,99,180,2583,1026,2.76987e+13,152.924,676.69,3609,98,92,3015,2581,1575,1516,2068
77153,171,313,55108,22045,2.80054e+13,172.942,3238.87,77153,256,175,76292,59809,67913,72481,74653
44455,58,255,31754,12701,2.80394e+13,172.211,2433.99,44455,198,175,34847,28523,11339,8555,16041
57062,192,278,40751,16311,2.80206e+13,172.614,2769.78,57062,220,175,56784,56784,51688,54279,56698
53855,201,271,38471,15384,2.80029e+13,172.518,2686.77,53855,214,175,53584,53584,49540,51589,53514
46732,419,800,33471,13261,2.65135e+13,209.244,3485.14,46732,792,175,45673,45054,41575,43514,44789
95201,324,346,68003,27198,2.80056e+13,173.163,3615.34,95201,289,175,94855,94855,94075,94444,94833
78752,233,462,56230,22522,2.81089e+13,173.151,3463.16,78752,267,176,78290,78168,72711,74315,77490
65691,241,292,46928,18763,2.79814e+13,172.836,2978.49,65691,236,175,65399,65399,62623,64020,65348
89458,62,336,63900,25558,2.80045e+13,173.121,3499.93,89458,279,175,70950,58050,24320,21551,34678
3150,178,180,2244,906,2.82494e+13,147.379,631.355,3150,94,89,2970,2970,2966,2966,2968
23104,119,216,16502,6602,2.8039e+13,170.658,1738.43,23104,159,146,20633,17128,12764,11229,16077
70982,297,302,50703,20279,2.80023e+13,172.872,3101.25,70982,245,175,70680,70680,70644,70655,70675
73351,151,307,52386,20965,2.80173e+13,172.875,3155.48,73351,249,175,69900,55539,57902,62114,63578
79377,27,318,56703,22674,2.80118e+13,173.025,3288.28,79377,261,175,52803,39330,13516,14388,16757
30880,215,229,22058,8822,2.79636e+13,171.511,2016.27,30880,173,160,30651,30651,30364,30489,30637
74378,120,448,53107,21271,2.81206e+13,173.087,3359.74,74378,250,193,66720,55262,31508,22208,46223
79153,117,458,56519,22634,2.8123e+13,173.176,3466.93,79153,260,193,70556,58666,28034,15929,47089
24213,167,218,17297,6916,2.80399e+13,170.74,1780.49,24213,161,148,23659,18647,21356,22692,22937
49937,12,264,35669,14268,2.80007e+13,172.39,2583.78,49937,207,175,24650,15621,7407,4247,5151
46755,62,258,33391,13364,2.80062e+13,172.247,2497.11,46755,201,175,37067,30344,12740,20114,18946
55144,81,274,39393,15751,2.79942e+13,172.581,2720.65,55144,217,175,45592,38368,19276,19186,27661
86311,27,330,61654,24657,2.80061e+13,173.096,3434.76,86311,273,175,57413,42756,14685,9992,15764
36285,148,383,25895,10390,2.82411e+13,172.177,2375.03,36285,197,177,34211,27467,23563,21924,28895
45145,161,800,32335,12810,2.64506e+13,208.631,3441.94,45145,782,175,42746,33778,37431,39903,39209
4933,81,183,3529,1404,2.79142e+13,158.2,793.277,4933,108,100,4004,3414,1765,2319,2487
33046,194,234,23613,9433,2.79756e+13,171.701,2088.77,33046,177,164,32812,32812,30845,31825,32772
29066,322,367,20738,8328,2.82893e+13,171.749,2133.28,29066,182,173,28699,28699,27191,26916,28453
83557,309,325,59685,23872,2.80074e+13,173.063,3377.05,83557,268,175,83232,83232,82835,83008,83216
81994,55,322,58570,23424,2.80021e+13,173.058,3343.77,81994,265,175,63751,52169,20479,23874,30250
64749,184,291,46250,18499,2.80036e+13,172.774,2956.69,64749,234,175,64458,64458,57898,61242,64351
46160,200,800,33061,13099,2.64943e+13,210.667,3469.59,46160,798,175,44873,44483,40106,41830,43461
52454,59,269,37464,14990,2.8018e+13,172.532,2651.21,52454,212,175,41238,33656,13429,15868,20224
62280,282,286,44482,17798,2.80106e+13,172.665,2897.02,62280,229,175,61994,61994,61971,61977,61990
68880,143,299,49197,19683,2.80228e+13,172.885,3054.05,68880,242,175,64645,52016,50887,56338,57246
11730,131,636,8405,3325,2.59393e+13,154.077,1733.59,11730,343,123,10302,8586,6926,6160,188
59746,119,282,42674,17072,2.80014e+13,172.695,2835.99,59746,225,175,53494,44363,33060,30737,41615
1913,87,178,1362,551,2.85585e+13,132.593,492.022,1913,78,77,1535,1309,751,762,1008
20152,195,210,14389,5763,2.79613e+13,170.034,1620.15,20152,153,140,19942,19942,19620,19760,19927
60925,110,285,43520,17405,2.80026e+13,172.74,2865.73,60925,228,175,53555,44912,30757,35126,39985
99603,242,504,71121,28482,2.80966e+13,173.323,3896.68,99603,297,196,99099,98978,64383,41706,90346
6340,144,185,4532,1808,2.78485e+13,161.627,899.597,6340,115,106,5855,4753,4653,4927,5181
68888,491,800,49298,19590,2.69833e+13,238.503,4024.3,68888,797,175,67832,67567,59266,63496,67161
90342,296,338,64535,25807,2.80048e+13,173.176,3518.51,90342,281,175,90004,90004,87900,88951,89962
46014,23,257,32863,13151,2.80013e+13,172.264,2476.99,46014,200,175,29191,21293,7837,6589,8998
35226,31,238,25157,10069,2.80231e+13,171.73,2158.55,35226,181,167,24183,18336,6319,4550,7183
41119,19,249,29371,11748,2.80131e+13,172.155,2338.08,41119,192,175,24376,17393,6983,4095,5675
5277,166,184,3770,1507,2.79622e+13,159.965,821.083,5277,110,102,5021,4017,4736,4900,4850
3177,98,179,2268,909,2.79211e+13,148.273,633.779,3177,95,88,2650,2278,1411,1655,1888
2506,3,178,1784,722,2.80371e+13,141.35,562.001,2506,88,81,529,123,109,171,54
6966,113,187,4978,1988,2.8176e+13,162.984,944.558,6966,119,109,6077,5122,3612,3485,4552
64559,53,440,46090,18469,2.81274e+13,172.944,3144.17,64559,247,191,49866,40994,15781,14123,20554
72987,40,800,52221,20766,2.70497e+13,244.06,4113.96,72987,795,175,52995,41747,14946,14420,19082
26649,124,222,19037,7612,2.79864e+13,171.03,1869.9,26649,165,151,24069,19914,16213,15377,19471
87756,227,333,62681,25075,2.80022e+13,173.134,3465.03,87756,276,175,87423,87423,80967,84258,87317
82097,293,323,58634,23463,2.80202e+13,173.013,3346.67,82097,265,175,81774,81774,80456,81103,81744
78556,183,947,56171,22385,2.72416e+13,235.308,4421.2,78556,798,194,77016,76518,63104,19032,63963
75340,160,310,53813,21527,2.79934e+13,172.933,3199.16,75340,253,175,73020,57591,65854,70566,69050
89639,132,336,64024,25615,2.80077e+13,173.111,3503.31,89639,279,175,82391,67553,57369,54484,69137
81933,161,322,58517,23416,2.80092e+13,173.05,3342.59,81933,265,175,79561,62626,71629,68563,75203
97512,212,351,69642,27870,2.80191e+13,173.15,3661.97,97512,293,175,97161,97161,88442,92897,97022
29696,214,800,21306,8390,2.56364e+13,209.194,2969.95,29696,774,153,28450,28049,25331,26242,27102
11191,93,194,7997,3194,2.79685e+13,166.813,1200.04,11191,133,124,9446,7806,4486,4665,6270
80834,315,320,57739,23095,2.8019e+13,173.016,3319.03,80834,263,175,80514,80514,80478,80489,80509
90157,908,947,64459,25698,2.73204e+13,230.688,4653.49,90157,788,197,89210,89210,86496,87759,89094
78135,283,800,55901,22234,2.71164e+13,218.259,4222.68,78135,798,180,76928,76400,71801,73819,75700
90784,111,338,64847,25937,2.80174e+13,173.137,3526.64,90784,281,175,80020,66941,46439,52544,59959
88371,146,333,63123,25248,2.80017e+13,173.076,3476.62,88371,277,175,83455,66920,66749,73589,74444
16278,65,204,11622,4656,2.80942e+13,168.977,1453.85,16278,146,133,12954,10736,4560,5288,6746
11021,89,194,7869,3152,2.80295e+13,166.633,1191.44,11021,133,123,9212,7671,4319,4950,6091
59351,234,282,42393,16958,2.80312e+13,172.651,2826.81,59351,225,175,59069,59069,56547,57810,59021
82455,113,323,58900,23555,2.80043e+13,173.05,3353.71,82455,267,175,72960,61098,42971,48007,55662
78320,296,315,55941,22379,2.8007e+13,172.922,3264.11,78320,258,175,78005,78005,77424,77691,77986
23190,18,216,16564,6626,2.8014e+13,170.543,1741.5,23190,159,145,13444,9554,3896,1935,2220
59647,17,282,42603,17044,2.80148e+13,172.685,2833.56,59647,225,175,33858,24057,10031,5724,7813
31753,160,232,22672,9081,2.80463e+13,171.453,2046.69,31753,174,161,30681,24245,27689,29655,29024
45774,239,257,32695,13079,2.80158e+13,172.317,2470.81,45774,200,175,45517,45517,45021,45245,45499
22192,114,800,15932,6260,2.48835e+13,215.184,2692.19,22192,773,139,18760,15785,10590,11528,13276
16049,36,203,11465,4584,2.80036e+13,169.173,1442.79,16049,146,133,11429,9064,3160,2264,3895
19808,151,360,14128,5680,2.84538e+13,170.755,1791.66,19808,168,157,18651,14972,12100,10610,15414
63715,243,289,45514,18201,2.8005e+13,172.794,2932.09,63715,233,175,63426,63426,60990,62212,63380
1080,83,176,769,311,2.80297e+13,102.007,368.352,1080,63,62,819,718,399,438,507
75975,16,311,54269,21706,2.80003e+13,172.982,3213.22,75975,254,175,42164,29664,12504,7140,9766
26815,186,223,19145,7670,2.80495e+13,171.11,1876.65,26815,166,152,26592,26592,24809,25694,26555
75894,292,800,54296,21598,2.70934e+13,222.601,4175.58,75894,798,175,74659,74163,67037,70407,73462
5863,142,185,4193,1670,2.78566e+13,161.129,865.741,5863,113,105,5381,4384,4227,4472,4685
4676,85,182,3340,1336,2.80335e+13,156.901,770.601,4676,105,99,3842,3239,1746,2251,2440
2419,7,179,1722,697,2.84637e+13,139.931,553.544,2419,87,83,933,387,268,158,91
7740,49,188,5530,2210,2.80142e+13,163.92,995.849,7740,121,112,5853,4754,1840,2025,2450
48441,174,261,34598,13843,2.80023e+13,172.288,2543.16,48441,204,175,48095,38406,42975,45622,47805
95269,788,800,68130,27139,2.72836e+13,233.38,4560.69,95269,798,175,94469,94218,90846,92599,94434
17330,144,206,12385,4945,2.79728e+13,169.712,1501.59,17330,149,135,16194,13049,12827,14196,14416
38550,17,243,27532,11018,2.80137e+13,171.767,2259.86,38550,186,173,21884,15550,6499,4688,6103
99541,461,496,71086,28455,2.80731e+13,173.327,3887.99,99541,296,192,99045,99045,97533,98279,99010
49840,167,264,35599,14241,2.80015e+13,172.389,2581.32,49840,207,175,48872,38438,43787,46745,47390
97808,186,351,69863,27945,2.80092e+13,173.224,3667.4,97808,294,175,97457,97457,86959,92331,97292
66909,23,295,47791,19118,2.80066e+13,172.824,3007.82,66909,238,175,42448,30968,11390,7633,11656
