"data_size","cache_size","unique_size","reads","writes","avg_step","avg_reuse_dist","sum_sqrt_count","sum_count","lis","lds","belady","lru","pivot","ld","mru"
40191,5297,10877,25789,14402,9.43259e+12,59.4752,13555.6,40191,5295,72,29314,29314,21949,13321,13031
85412,21607,27323,54071,31341,8.7743e+12,58.7326,32063,85412,13296,72,58089,58089,53103,46209,44783
95426,5368,22190,61886,33540,9.90599e+12,60.1373,27970.8,95426,10804,72,73236,73236,48686,33354,18441
12055,1846,2874,7812,4243,9.90178e+12,59.6715,3941.73,12055,1399,72,9181,9181,7937,6314,6001
56327,1779,26191,34217,22110,6.91453e+12,56.1683,28929.3,56327,12754,72,30136,30136,16894,9883,937
68860,10373,16056,44640,24220,9.91012e+12,60.1135,20424.1,68860,7822,72,52804,52804,44589,44415,34620
33745,1290,14660,20683,13062,7.3186e+12,55.709,16556.7,33745,7135,72,19085,19045,8189,7503,1520
12764,1518,5854,7770,4994,7.07195e+12,56.2245,6716.48,12764,2845,72,6910,6910,3894,1762,1124
67235,7810,17552,43264,23971,9.55015e+12,59.668,21702.6,67235,8550,72,49683,49683,37046,22156,21591
47948,5323,13061,30756,17192,9.41323e+12,59.4601,16149.7,47948,6363,72,34887,34887,24681,17556,15294
86355,2400,27821,54628,31727,8.75715e+12,58.71,32590.1,86355,13548,72,58534,58534,34632,14313,5361
88721,11165,30338,55823,32898,8.50443e+12,58.3038,35096.9,88721,14763,72,58383,58383,44135,29427,25601
49379,11438,11493,32016,17363,9.92228e+12,60.0931,14799,49379,5599,72,37886,37886,37817,37817,37818
31907,5531,10430,20162,11745,8.7011e+12,58.343,12514.6,31907,5060,72,21477,21477,17624,13086,13126
72742,9062,16952,47161,25581,9.90439e+12,60.1107,21531.5,72742,8248,72,55790,55790,46307,33343,30278
67221,15485,15633,43585,23636,9.9071e+12,60.1136,19920.9,67221,7604,72,51588,51588,51442,51318,51324
49718,14244,14700,31687,18031,9.11235e+12,59.0931,17798.3,49718,7161,72,35018,35018,34354,33665,33722
31489,5314,7364,20423,11066,9.91621e+12,60.0007,9647.38,31489,3583,72,24125,24125,21197,21129,17771
39233,2647,17227,24013,15220,7.25008e+12,55.7839,19352.6,39233,8379,72,22006,22006,12963,3130,1760
57063,11677,17796,36210,20853,8.89462e+12,58.847,21205,57063,8666,72,39267,39267,34343,28637,28471
98379,23100,24060,63585,34794,9.75852e+12,59.952,29911,98379,11720,72,74319,74319,73015,72977,71597
84368,24972,26854,53429,30939,8.802e+12,58.7752,31556.7,84368,13074,72,57514,57514,55754,53429,52933
24626,4840,7788,15612,9014,8.853e+12,58.6287,9500.87,24626,3783,72,16838,16838,14589,11588,10941
14960,2383,3538,9699,5261,9.92385e+12,59.7805,4801.31,14960,1719,72,11422,11422,10007,9688,7810
67784,25432,29242,41577,26207,7.36206e+12,56.9607,32593.4,67784,14245,72,38542,38542,36813,34891,34919
79299,14638,18373,51433,27866,9.92293e+12,60.1521,23310.5,79299,8951,72,60926,60926,55414,55302,48816
23148,7083,7719,14601,8547,8.62122e+12,52.8408,9321.1,23148,3746,72,15429,15429,14953,14380,14594
70603,10657,22530,44711,25892,8.78923e+12,58.7275,26567.5,70603,10963,72,48073,48073,30964,10727,9931
25490,5781,5992,16527,8963,9.88935e+12,59.9568,7920.34,25490,2911,72,19498,19498,19257,19015,19015
75826,42593,42732,44736,31090,5.63814e+12,54.8555,45689.1,75826,20809,72,33094,33094,33004,32887,32959
49532,11643,28113,29187,20345,5.60488e+12,54.7769,30188.7,49532,13695,72,21419,21419,16077,11070,9864
18724,3218,9284,11279,7445,6.54935e+12,54.3824,10378.3,18724,4506,72,9440,9440,5832,3671,2951
52666,6714,16692,33367,19299,8.82873e+12,58.6317,19864,52666,8126,72,35974,35974,27207,26929,16596
40049,1922,10863,25710,14339,9.41303e+12,59.4348,13531.8,40049,5280,72,29186,29186,18434,18164,5363
39560,7764,15830,24493,15067,7.76404e+12,57.398,18084.3,39560,7708,72,23730,23730,18676,12819,12680
59088,20698,24132,36489,22599,7.63873e+12,56.8425,27229.5,59088,11734,72,34956,34956,33506,31879,31928
76976,6506,17923,49915,27061,9.91262e+12,60.1225,22727.9,76976,8723,72,59053,59053,39267,38108,22052
98414,22711,41438,60538,37876,7.4765e+12,57.0172,46103.8,98414,20165,72,56976,56976,46926,33203,29947
59522,8705,31058,35559,23963,6.18088e+12,54.7694,33676.1,59522,15113,72,28464,28464,20161,12960,11022
54453,903,12706,35297,19156,9.91516e+12,60.0998,16292.7,54453,6189,72,41747,41747,13207,14447,3422
94477,18297,21979,61262,33215,9.90489e+12,60.13,27708.3,94477,10702,72,72498,72498,68082,62107,60735
38869,8546,11456,24787,14082,9.12894e+12,59.0671,13988.5,38869,5577,72,27413,27413,24313,20035,19248
27046,12275,13249,21112,5934,78589300000,8.9898,13590.8,27046,11920,11,13797,13797,13019,13115,12941
48777,16718,19653,30164,18613,7.717e+12,56.7994,22320.5,48777,9552,72,29124,29124,27789,25932,25722
29569,772,8580,18889,10680,9.1779e+12,59.0528,10624.4,29569,4159,72,20989,20893,10617,8225,2767
62425,14077,14541,40480,21945,9.9042e+12,60.1038,18568.2,62425,7073,72,47884,47884,47334,47208,46580
48158,7099,25370,28728,19430,6.11862e+12,53.9831,27556.6,48158,12337,72,22788,22788,15511,9108,7426
95913,12764,22296,62195,33718,9.91768e+12,60.1412,28098,95913,10862,72,73617,73617,62190,59513,42870
72788,3124,21572,46372,26416,9.08884e+12,58.773,25832.5,72788,10503,72,51216,51216,24026,12144,6753
52629,27337,27590,31418,21211,6.14903e+12,55.3319,29948.8,52629,13429,72,25039,25039,24755,24452,24449
19940,4750,6274,12649,7291,8.88323e+12,58.4139,7730.79,19940,3039,72,13666,13666,11918,11852,10004
69165,7361,16061,44848,24317,9.9239e+12,60.1366,20453.4,69165,7823,72,53104,53104,41338,39393,24862
3261,218,1540,1977,1284,7.05089e+12,47.1582,1852.52,3261,745,64,1721,1673,982,65,0
29835,1200,6977,19339,10496,9.91419e+12,60.02,9165.28,29835,3395,72,22858,22858,10080,4726,4348
4603,1007,1626,2897,1706,8.5717e+12,57.1514,2086.93,4603,788,67,2977,2977,2907,2787,2901
43378,11431,13848,27471,15907,8.79527e+12,58.2106,16545.3,43378,6724,72,29530,29530,26636,26576,23268
58868,4302,17398,37530,21338,9.10416e+12,59.1127,20964.4,58868,8475,72,41470,41470,25424,15393,11815
28504,1329,1367,22602,5902,5.8199e+13,11.9925,1917.2,28504,1188,14,27137,27137,26900,26750,27030
8380,2717,3693,5137,3243,7.31695e+12,56.2043,4336.95,8380,1790,72,4687,4687,4147,3587,3663
49085,9039,11422,31826,17259,9.92382e+12,60.0983,14714,49085,5564,72,37663,37663,34245,34169,30213
58061,4613,18808,36721,21340,8.74173e+12,58.6532,22214,58061,9160,72,39253,39253,24882,14266,11930
42192,12391,17625,25976,16216,7.53536e+12,57.0671,19944.9,42192,8582,72,24567,24567,21255,17396,17467
4648,85,1121,3020,1628,9.8946e+12,58.9557,1646.42,4648,539,71,3527,3083,1001,1111,284
33279,5776,15750,20178,13101,6.8071e+12,56.2131,17521,33279,7667,72,17529,17529,12268,6108,6076
91805,8786,21290,59540,32265,9.92549e+12,60.1479,26881.9,91805,10372,72,70515,70515,52266,37334,29835
67675,7357,15738,43888,23787,9.91593e+12,60.1113,20045.8,67675,7659,72,51937,51937,40990,39030,24781
93734,4649,5824,74609,19125,5.73492e+13,12.0015,6830.87,93734,3454,20,87910,87910,79179,72316,82163
88392,4456,27093,56166,32226,8.95524e+12,58.9539,32053.1,88392,13195,72,61299,61251,40111,15047,14042
12483,2110,2963,8086,4397,9.90346e+12,59.742,4063.68,12483,1438,72,9520,9520,8585,7388,7186
18592,2452,4361,12063,6529,9.8941e+12,59.8918,5864.58,18592,2119,72,14231,14231,11411,11360,8101
7048,1604,1718,4559,2489,9.90734e+12,59.3624,2429.59,7048,833,72,5330,5330,5175,5074,5145
8371,570,2028,5417,2954,9.8514e+12,59.4518,2838.01,8371,982,72,6343,6343,3520,2448,1989
54503,1732,3353,43370,11133,5.7397e+13,12.0025,4119.89,54503,2153,20,51150,51150,40194,31951,46195
21538,4105,9696,13146,8392,7.11731e+12,56.3562,11000.8,21538,4712,72,11842,11842,8645,4953,4910
67213,1917,2833,53204,14009,5.85617e+13,12.0018,3693.95,67213,2037,19,64380,64380,56193,49092,60721
7554,1728,1784,4905,2649,1.00326e+13,59.44,2535.09,7554,865,72,5770,5770,5695,5693,5696
16636,3511,6705,10294,6342,7.78054e+12,57.1864,7839.61,16636,3266,72,9931,9931,8361,6187,5906
96215,10742,24677,61975,34240,9.60049e+12,59.6637,30342.8,96215,12014,72,71538,71538,52732,36152,29631
28084,1882,14867,16737,11347,6.10513e+12,54.6277,16284.9,28084,7237,72,13217,13217,7501,3397,2341
64040,1590,16747,41205,22835,9.53913e+12,59.6534,20728.7,64040,8152,72,47293,47293,28468,18673,5354
43585,8153,10124,28271,15314,9.92581e+12,60.0746,13107.4,43585,4926,72,33461,33461,31040,27824,27119
3087,135,1014,1960,1127,8.8285e+12,53.2504,1373.25,3087,471,62,2073,2032,1273,555,486
95878,30021,30132,60796,35082,8.85406e+12,58.6371,35400.7,95878,14659,72,65746,65746,65746,65746,65746
63089,8005,26892,38745,24344,7.41962e+12,56.6074,30077.3,63089,13095,72,36197,36197,25684,13387,13089
32878,6607,7671,21314,11564,9.92043e+12,60.0381,10038,32878,3737,72,25207,25207,23913,22216,21897
68597,14143,24587,42963,25634,8.29294e+12,58.0058,28335.5,68597,11961,72,44010,44010,37827,29304,27478
84597,9189,22725,54319,30278,9.44249e+12,59.5608,27729.5,84597,11062,72,61872,61872,45798,45391,26097
15477,6564,15477,0,15477,7.99948,0,15477,15477,15477,1,0,0,0,0,0
15489,307,4001,9987,5502,9.56764e+12,59.3961,5273.34,15489,1933,72,11488,11440,4167,2340,1150
30675,7027,7178,19886,10789,9.902e+12,59.9901,9416.52,30675,3487,72,23497,23497,23309,23181,23213
18571,629,4356,12041,6530,9.95051e+12,59.911,5853.12,18571,2122,72,14215,14215,5728,5961,2309
7018,885,1716,4549,2469,9.94899e+12,59.3287,2421.61,7018,835,72,5302,5302,4085,4063,2773
33974,11330,15083,20762,13212,7.21888e+12,56.6931,16958.3,33974,7347,72,18891,18891,16917,14303,13750
21758,1323,5148,14108,7650,9.86349e+12,59.8849,6845.25,21758,2501,72,16610,16610,11053,10941,4359
2348,373,599,1528,820,9.91332e+12,57.724,914.108,2348,286,57,1749,1749,1495,1240,1228
55643,9684,12929,36087,19556,9.91754e+12,60.1051,16586.3,55643,6291,72,42714,42714,38037,33599,32418
1824,309,480,1181,643,9.80698e+12,56.8854,740.718,1824,228,54,1344,1344,1114,1109,983
31968,143,7476,20731,11237,9.91421e+12,60.0117,9787.1,31968,3641,72,24492,24422,6226,7175,826
56408,7753,30430,33518,22890,5.94852e+12,54.9451,32859.4,56408,14809,72,25978,25978,17257,9084,6954
49750,9399,14479,31758,17992,9.16362e+12,59.1674,17596.9,49750,7050,72,35271,35271,29633,29484,22898
47760,28443,47760,0,47760,7.99983,0,47760,47760,47760,1,0,0,0,0,0
26413,5828,7831,16838,9575,9.12424e+12,58.9759,9681.84,26413,3811,72,18582,18582,17416,17131,15635
75087,11196,17425,48701,26386,9.92567e+12,60.1334,22131.5,75087,8487,72,57662,57662,50095,48348,37397
37159,2842,8650,24091,13068,9.91963e+12,60.0576,11269,37159,4212,72,28509,28509,17680,17321,9672
43116,9119,13965,27267,15849,8.7304e+12,58.6143,16633.1,43116,6788,72,29151,29151,25043,19475,18201
2659,1065,1476,1582,1077,6.18938e+12,53.2486,1711.65,2659,717,52,1183,1169,779,736,539
91404,12260,27441,58178,33226,9.03746e+12,59.0581,32586,91404,13359,72,63963,63963,48437,30895,26485
24122,2124,7008,15401,8721,9.20238e+12,59.0466,8741.32,24122,3414,72,17114,17114,11321,11187,4331
87267,22246,26218,55540,31727,9.03643e+12,59.0579,31163.3,87267,12767,72,61049,61049,55268,55152,48300
56526,10434,13131,36657,19869,9.92571e+12,60.1144,16832,56526,6396,72,43395,43395,39511,35849,34893
76272,5232,17694,49464,26808,9.91487e+12,60.1252,22467.3,76272,8611,72,58578,58578,40426,40062,18095
31058,11273,12329,19253,11805,7.78752e+12,57.4107,14196.1,31058,6000,72,18729,18729,17697,16761,16623
77774,12838,18095,50423,27351,9.9131e+12,60.1319,22945.1,77774,8810,72,59679,59679,51993,51842,42667
13415,1128,6164,8168,5247,6.9837e+12,56.143,7060.2,13415,2988,72,7251,7251,4414,2547,2129
68790,17596,22007,43544,25246,8.78967e+12,58.7324,25953.1,68790,10714,72,46783,46783,45121,42822,42513
42246,2738,12997,26838,15408,8.95024e+12,58.8939,15672.7,42246,6327,72,29249,29249,19239,7416,7118
36462,9040,9533,23473,12989,9.54489e+12,59.4776,12033,36462,4623,72,26929,26929,26349,25747,25816
3124,33,775,2031,1093,9.81525e+12,58.3009,1167.42,3124,368,62,1662,324,588,672,90
72717,8448,16895,47166,25551,9.90777e+12,60.1201,21478.6,72717,8221,72,55822,55822,43516,43271,28444
76300,21402,21789,48755,27545,9.23038e+12,59.2902,26278.6,76300,10615,72,54511,54511,54250,54003,54143
99184,35949,44056,60606,38578,7.17804e+12,56.611,48593,99184,21441,72,55128,55128,51723,47850,47780
94568,35802,36922,58686,35882,7.87657e+12,57.6272,41626.7,94568,17984,72,57646,57646,56783,55974,55986
38974,2058,9075,25278,13696,9.92016e+12,60.0512,11794.2,38974,4417,72,29899,29899,15030,15168,7272
49498,14878,17414,31068,18430,8.3731e+12,50.9186,20298.5,49498,8462,72,32084,32084,32084,32084,32084
96605,5648,31602,61026,35579,8.69193e+12,58.6374,36818.6,96605,15389,72,65003,65003,41838,27234,13540
43482,8854,10089,28201,15281,9.94253e+12,60.0842,13064.8,43482,4915,72,33393,33393,31880,29896,29510
67863,23589,24388,42481,25382,8.28225e+12,57.9367,28099.8,67863,11874,72,43475,43475,42496,41249,41027
89239,971,35482,55259,33980,7.78701e+12,57.5194,39918.5,89239,17285,72,53757,53523,30751,16297,2816
7754,1343,1835,5040,2714,9.90344e+12,59.4466,2604.16,7754,888,72,5919,5919,5323,5188,4497
62856,5525,32452,49169,13687,7.9169e+10,8.99771,32962.5,62856,29203,11,30404,30404,11284,13168,9413
57304,7191,19328,36104,21200,8.56015e+12,58.4431,22645.2,57304,9409,72,37976,37928,26365,24753,23138
48931,1105,17035,30733,18198,8.42367e+12,57.7148,19908.7,48931,8279,72,31896,31896,17260,6588,3274
10680,405,3313,6794,3886,8.93116e+12,58.482,4220.97,10680,1606,72,7367,7319,4629,4549,1441
8592,488,2480,5497,3095,9.21863e+12,58.6754,3266.2,8592,1202,72,6112,6064,2866,1826,1662
25496,2286,9742,15860,9636,8.0162e+12,57.5069,11369.4,25496,4740,72,15754,15754,8109,5477,4118
27250,7161,8492,17287,9963,8.91702e+12,58.7824,10360.3,27250,4136,72,18758,18758,17828,17582,16465
30542,4865,7144,19799,10743,9.90785e+12,60.0068,9373.2,30542,3474,72,23398,23398,20697,17090,16291
82843,5963,24519,52788,30055,9.09756e+12,59.1241,29271.8,82843,11945,72,58324,58324,31700,20860,15707
84206,22152,25821,53508,30698,8.96039e+12,56.4507,30579.9,84206,12563,72,58385,58385,58385,58385,58385
56239,2238,13079,36481,19758,9.91089e+12,60.0981,16768.7,56239,6363,72,43160,43160,27403,27081,8050
10694,2438,2487,6937,3757,1.00331e+13,59.757,3467.44,10694,1211,72,8207,8207,8150,8157,8146
41531,13799,17971,25464,16067,7.34088e+12,56.2423,20215,41531,8749,72,23560,23560,21364,18449,17838
87913,17245,20404,57010,30903,9.91932e+12,60.1444,25793.5,87913,9934,72,67509,67509,62929,62830,57478
19653,1601,9346,11912,7741,6.7606e+12,56.0151,10515.9,19653,4538,72,10307,10307,5930,3328,2590
76474,23947,37461,59697,16777,78533900000,8.99651,38041.7,76474,33708,11,39013,39013,28293,29614,26985
86513,11519,20101,56112,30401,9.91264e+12,60.1318,25415.1,86513,9784,72,66412,66412,56066,41926,38573
49491,2295,21269,30379,19112,7.36489e+12,56.7887,23867.7,49491,10339,72,28222,28222,13405,7959,5190
74326,765,18443,47986,26340,9.71602e+12,59.8845,23029.1,74326,8984,72,55883,55883,32353,31803,3418
95293,10543,40588,58541,36752,7.4175e+12,56.7652,45091.8,95293,19757,72,54705,54705,33974,15265,9963
76987,17874,17928,49922,27065,9.90765e+12,60.1163,22732.9,76987,8730,72,59059,59059,59009,59013,59004
78428,2863,31322,48553,29875,7.75306e+12,57.4729,35293.4,78428,15248,72,47106,47106,21221,10393,5479
34146,6825,7967,22140,12006,9.90963e+12,60.0301,10408,34146,3875,72,26179,26179,24878,23174,22855
42382,903,9901,27482,14900,9.92596e+12,60.058,12810.2,42382,4823,72,32481,32481,19449,12777,3502
98482,22215,41416,60589,37893,7.48859e+12,57.1565,46082.8,98482,20177,72,57066,57066,49399,38839,36524
30900,8174,16886,18323,12577,5.87952e+12,55.0546,18370,30900,8221,72,14014,14014,11318,7907,7298
3160,694,792,2057,1103,9.70476e+12,58.1696,1185.89,3160,374,62,2368,2368,2273,2230,2227
52770,915,18025,33211,19559,8.51011e+12,57.9824,21104.3,52770,8763,72,34745,34701,19999,9390,2093
56337,16165,18106,35650,20687,8.76744e+12,58.6728,21442.9,56337,8815,72,38231,38231,37295,36200,36390
32942,227,2072,26228,6714,5.72883e+13,11.9935,2659.6,32942,1351,14,30870,30870,18658,9553,25368
9145,2171,2640,5853,3292,9.25072e+12,58.6589,3463.84,9145,1277,72,6505,6505,5961,5290,5210
4515,407,1331,2878,1637,9.30449e+12,55.6206,1817.95,4515,642,70,3184,3184,1636,834,609
20906,1363,4880,13556,7350,9.93911e+12,59.9535,6529.5,20906,2371,72,16026,16026,10921,10816,4794
43719,3260,10212,28351,15368,9.91476e+12,60.0544,13198.3,43719,4971,72,33507,33507,23403,16348,11070
86808,18925,20160,56300,30508,9.91813e+12,60.1358,25488.2,86808,9818,72,66648,66648,65174,63189,62882
34663,322,8100,22481,12182,9.89707e+12,60.0015,10570.7,34663,3932,72,26563,26563,15264,15035,1431
6910,888,2094,4405,2505,9.09959e+12,58.2589,2751.25,6910,1011,72,4816,4816,3818,2716,2764
16905,243,3970,10955,5950,9.91569e+12,59.8811,5365.21,16905,1932,72,12935,12935,3911,4315,1037
63791,10309,23161,39903,23888,8.22367e+12,58.0396,26670.3,63791,11275,72,40630,40630,31194,20055,19807
42622,116,2109,33813,8809,5.81141e+13,11.9954,2783.87,42622,1770,14,40513,40513,24709,11818,33454
69128,12060,19751,44188,24940,9.22309e+12,59.2668,23881.5,69128,9612,72,49377,49377,42810,41173,31798
45921,9955,10711,29772,16149,9.90313e+12,60.0749,13827.2,45921,5208,72,35210,35210,34409,34205,33223
73930,26150,29000,45850,28080,7.85596e+12,57.3004,32815.5,73930,14122,72,44930,44930,42897,42810,40651
13144,1984,3116,8526,4618,9.934e+12,59.7506,4258.73,13144,1517,72,10028,10028,8469,8425,6751
62397,15562,22413,39061,23336,8.27996e+12,58.0998,25873.8,62397,10916,72,39984,39984,34554,27174,25475
43844,2998,14216,27725,16119,8.74057e+12,58.2977,16915.8,43844,6919,72,29628,29628,14990,7902,4951
62460,7930,19796,39581,22879,8.82157e+12,58.7594,23448.4,62460,9632,72,42664,42664,31750,21133,18195
93783,15907,42449,57177,36606,7.06486e+12,56.4147,46718.5,93783,20658,72,51334,51334,40301,30090,27234
19522,2537,4590,12663,6859,9.87389e+12,59.836,6149.88,19522,2222,72,14932,14932,12440,11871,8370
23882,9137,9480,14794,9088,7.80938e+12,56.2906,10996.4,23882,4613,72,14402,14402,14083,13714,13917
21330,2198,21330,0,21330,7.99962,0,21330,21330,21330,1,0,0,0,0,0
25278,1136,7944,16039,9239,8.8718e+12,58.6552,9697.19,25278,3861,72,17334,17296,10766,3524,2843
93571,11783,21704,60684,32887,9.9188e+12,60.1449,27388.7,93571,10567,72,71867,71867,59853,43430,39533
3414,716,846,2216,1198,9.9366e+12,58.3322,1260.41,3414,409,63,2568,2568,2428,2322,2325
34295,9803,11337,21642,12653,8.65809e+12,58.4904,13533.5,34295,5522,72,22958,22958,21513,19495,19254
94896,21524,29273,60271,34625,8.93075e+12,58.9052,34532.8,94896,14242,72,65623,65623,59816,51925,50099
24035,5720,6579,15424,8611,9.37801e+12,59.2743,8342.47,24035,3192,72,17456,17456,16336,16299,15132
47820,13035,23237,28865,18955,6.65443e+12,55.5646,25557.2,47820,11314,72,24583,24583,21150,20170,15513
86462,7758,20736,55948,30514,9.81994e+12,60.0224,26001.6,86462,10102,72,65726,65726,44061,28598,24543
5552,698,2598,3381,2171,7.03018e+12,55.5418,3057.73,5552,1256,71,2954,2858,2037,2005,1227
91402,17341,42983,55438,35964,6.83892e+12,56.0286,47047.7,91402,20917,72,48419,48419,39773,30293,27857
11729,5091,5309,7157,4572,7.11552e+12,52.373,6129.13,11729,2564,72,6420,6420,6420,6420,6420
31231,6109,11571,19494,11737,8.16194e+12,57.8343,13505.5,31231,5637,72,19660,19660,15830,11947,11377
73559,17326,35254,44500,29059,6.73787e+12,56.2052,38589.6,73559,17175,72,38305,38305,30349,19393,16983
75471,14862,17517,48941,26530,9.91478e+12,60.1252,22247.8,75471,8527,72,57954,57954,54037,53968,49355
34953,5810,8152,22674,12279,9.91624e+12,60.0313,10640.1,34953,3968,72,26801,26801,23331,20037,19228
53643,7577,15518,34257,19386,9.17612e+12,58.6044,18846.2,53643,7537,72,38125,38125,31846,23191,21333
93874,47231,51941,73651,20223,8.0076e+10,8.98701,52535.4,93874,46743,11,41933,41933,38937,39151,38742
29181,4054,6826,18923,10258,9.92221e+12,60.0054,8974.49,29181,3325,72,22355,22355,19049,18272,13608
72201,6272,16776,46824,25377,9.90784e+12,60.1189,21332,72201,8158,72,55425,55425,37579,36318,21199
46598,5417,10866,30218,16380,9.9054e+12,60.0761,14019.9,46598,5286,72,35732,35732,29229,27701,18313
14662,2806,3467,9502,5160,9.87454e+12,59.7723,4715.72,14662,1674,72,11195,11195,10261,9417,9280
40429,13730,16021,25049,15380,7.8079e+12,57.4613,18330.1,40429,7795,72,24408,24408,23253,21740,21462
99944,1172,23232,64814,35130,9.90693e+12,60.1343,29248,99944,11303,72,76712,76712,44624,43974,5025
97158,8343,23850,62783,34375,9.74684e+12,59.935,29633.5,97158,11611,72,73308,73308,52681,37009,27355
56110,20661,27951,33764,22346,6.49588e+12,55.6716,30541.4,56110,13600,72,28159,28159,24483,20219,20207
85927,32130,36334,52830,33097,7.45302e+12,57.0697,40482.3,85927,17687,72,49593,49593,47527,44767,44179
9027,2282,2679,5753,3274,9.18186e+12,58.6407,3486.58,9027,1305,72,6348,6348,5771,5284,5246
41940,31633,39196,28887,13053,9.20309e+12,3.99103,39296.8,41940,13086,9,2744,2744,2216,2744,2223
65000,18320,35890,50992,14008,8.0041e+10,8.98951,36384,65000,32296,11,29110,29110,18179,18894,17483
49467,1486,2094,39156,10311,5.8554e+13,12.0027,2831.84,49467,1555,19,47373,47373,42118,37477,42822
73918,12169,20148,47412,26506,9.39345e+12,59.4853,24585.1,73918,9810,72,53770,53770,44230,43998,32624
2627,193,667,1706,921,9.72794e+12,57.7712,1011.23,2627,312,59,1960,1960,1292,1278,636
75902,7242,27762,47438,28464,8.19795e+12,58.0083,31803,75902,13520,72,48140,48140,26282,14961,10400
67730,9814,16958,43713,24017,9.68165e+12,59.8283,21185.1,67730,8256,72,50772,50772,42804,40919,29399
64347,11182,21623,40553,23794,8.57605e+12,58.4755,25282.4,64347,10528,72,42724,42724,32807,21177,20753
21295,2954,5414,13727,7568,9.67748e+12,59.6392,7050.87,21295,2636,72,15881,15881,13100,9824,9918
15001,3334,5237,9437,5564,8.44e+12,56.2522,6360.24,15001,2530,72,9764,9764,8136,6208,6362
7826,1383,1844,5087,2739,1.00104e+13,59.5327,2617.67,7826,895,72,5982,5982,5432,4761,4681
7822,432,2568,4954,2868,8.7105e+12,57.8003,3273.56,7822,1229,72,5254,5206,2543,1863,1479
78758,29790,41561,46971,31787,6.09866e+12,55.1351,44822.1,78758,20225,72,37197,37197,34134,29901,29115
41158,14605,15674,25618,15540,8.02795e+12,57.7244,18060.3,41158,7636,72,25484,25484,25354,25160,25293
61330,1078,14227,39781,21549,9.93273e+12,60.1226,18192.8,61330,6929,72,47103,47103,27895,18244,4273
94274,10435,30438,59628,34646,8.74425e+12,58.7043,35575.6,94274,14823,72,63836,63836,46919,27008,26258
44387,2709,18794,27288,17099,7.44755e+12,57.0334,21193.5,44387,9143,72,25593,25593,14767,4649,3309
67845,7369,15775,43995,23850,9.91621e+12,60.1167,20093.7,67845,7678,72,52070,52070,41045,39081,24792
29261,1349,8933,18612,10649,8.99306e+12,58.7363,10923.8,29261,4348,72,20328,20328,12521,8044,3069
88677,16852,20588,57514,31163,9.91081e+12,60.1417,26019.1,88677,10023,72,68089,68089,63503,62454,55855
12208,4014,5402,7472,4736,7.25473e+12,54.3068,6257.37,12208,2614,72,6806,6806,5705,4481,4544
35439,5457,17354,27663,7776,7.852e+10,8.99543,17746.6,35439,15614,11,18085,18085,8642,9806,7493
44179,13318,19561,27013,17166,7.20935e+12,56.7328,21883.2,44179,9523,72,24618,24618,21234,17295,17360
64736,7397,21473,40850,23886,8.62978e+12,58.0666,25171.6,64736,10438,72,43263,43263,29092,12404,11781
26444,6409,7914,16836,9608,9.08141e+12,58.9675,9764.64,26444,3854,72,18530,18530,17978,17327,17245
57813,5599,15666,37105,20708,9.41766e+12,59.4774,19280.8,57813,7622,72,42147,42147,29861,29568,14824
98855,32295,36849,61660,37195,8.09791e+12,57.9106,41859.4,98855,17946,72,62006,62006,59282,55519,54853
87673,6370,20359,56855,30818,9.91099e+12,60.1299,25736.1,87673,9903,72,67314,67314,40923,40161,21999
19427,1804,4551,12596,6831,9.90715e+12,59.8661,6104.94,19427,2208,72,14876,14876,10492,10144,6247
93493,28483,34440,58377,35116,8.16145e+12,57.9837,39246.4,93493,16772,72,59053,59053,56287,52514,51792
8213,3889,4066,4958,3255,6.63562e+12,55.4162,4655.91,8213,1978,72,4147,4147,3912,3726,3776
65214,14280,18352,41734,23480,9.27183e+12,59.3252,22305,65214,8925,72,46862,46862,42989,42060,36554
68846,4302,15992,44648,24198,9.92041e+12,60.1284,20366.1,68846,7790,72,52854,52854,35793,35447,14884
96338,11086,31986,60775,35563,8.62762e+12,58.5649,37159.7,96338,15579,72,64352,64352,49807,30893,26390
99288,2447,47491,60077,39211,6.74163e+12,55.8332,51790.6,99288,23120,72,51797,51797,25154,10529,4975
4520,1294,1783,2814,1706,7.91396e+12,56.5412,2221.57,4520,861,72,2737,2737,2269,1721,1935
2031,449,531,1317,714,9.78598e+12,57.159,812.257,2031,253,56,1500,1500,1412,1391,1379
96736,22042,26274,62058,34678,9.41219e+12,59.52,31860.7,96736,12800,72,70462,70462,65286,65161,59074
37086,7243,15986,22760,14326,7.36345e+12,56.8926,18036.3,37086,7784,72,21100,21100,15037,8008,7792
66143,13331,15385,42891,23252,9.91387e+12,60.1133,19612.2,66143,7489,72,50758,50758,47829,47760,44398
1531,257,417,993,538,1.00123e+13,56.2195,643.453,1531,199,50,1114,1114,891,733,776
99046,6068,23001,64227,34819,9.92204e+12,60.1482,28968.2,99046,11205,72,76045,76045,51319,50828,20859
22831,5754,6135,14663,8168,9.47417e+12,58.7489,7839.71,22831,2983,72,16696,16696,16329,15939,15913
32600,13095,14890,19850,12750,7.05293e+12,56.4873,16672.5,32600,7253,72,17710,17710,16670,16616,15651
10500,1114,2454,6821,3679,9.98902e+12,59.6853,3420.18,10500,1193,72,8046,8046,6067,4373,3796
71937,20400,29761,44345,27592,7.57645e+12,57.0453,33381.1,71937,14492,72,42176,42176,36299,29365,29300
23620,4066,5520,15324,8296,9.89732e+12,59.9039,7335.77,23620,2674,72,18100,18100,16343,15938,13511
90095,10399,20903,58435,31660,9.92479e+12,60.1458,26403.9,90095,10183,72,69192,69192,56562,53609,35178
82162,5554,29826,51386,30776,8.2298e+12,57.9589,34164.4,82162,14514,72,52336,52336,28865,16312,11494
53398,10474,13443,34452,18946,9.6647e+12,59.7909,16902.2,53398,6543,72,39955,39955,36406,31624,30556
87173,29111,34567,54001,33172,7.79579e+12,57.5307,38925.2,87173,16834,72,52606,52606,49475,45873,45832
47831,2793,11156,31022,16809,9.89939e+12,60.0704,14378.8,47831,5426,72,36675,36675,19411,19389,9566
81957,954,19057,53147,28810,9.91288e+12,60.1274,24127.5,81957,9277,72,62900,62900,18449,20639,4073
88875,20879,33528,55364,33511,8.03947e+12,57.8233,38075.5,88875,16322,72,55347,55347,47769,37308,35018
30784,650,8295,19770,11014,9.44274e+12,59.414,10453.3,30784,4036,72,22489,22393,13458,13237,2471
67077,10543,23522,42098,24979,8.38159e+12,58.2257,27239.9,67077,11445,72,43555,43555,28489,10630,10091
84762,17019,26940,53684,31078,8.82116e+12,58.7775,31656.5,84762,13124,72,57822,57822,49886,40633,40313
20857,1353,13537,16335,4522,2.23041e+13,5.52174,15539.7,20857,4546,13,7320,7320,4157,3810,1554
64991,12855,15125,42141,22850,9.90626e+12,60.1118,19292.1,64991,7355,72,49866,49866,47200,46568,42826
74789,19090,25182,47119,27670,8.5742e+12,58.4693,29324.6,74789,12268,72,49607,49607,45371,39522,38353
2906,677,721,1886,1020,9.96362e+12,58.1951,1091.34,2906,344,60,2185,2185,2159,2153,2154
9254,1372,2490,5946,3308,9.56983e+12,59.1011,3337.62,9254,1212,72,6764,6764,5114,5083,3266
54550,8168,16273,34752,19798,9.06509e+12,54.9019,19611.2,54550,7906,72,38277,38277,33264,33176,27226
89796,15576,20837,58232,31564,9.92002e+12,60.145,26325,89796,10145,72,68959,68959,61257,53892,51917
93872,13005,31338,59187,34685,8.60032e+12,58.1954,36388.1,93872,15253,72,62534,62534,45783,28593,23920
31925,2586,7476,20706,11219,9.90114e+12,59.9767,9786.03,31925,3629,72,24449,24449,17439,12344,8927
55671,3283,12940,36109,19562,9.9126e+12,60.1,16598.8,55671,6298,72,42731,42731,28719,19843,11540
8945,2974,3419,5581,3364,7.99794e+12,53.7561,4151.06,8945,1643,72,5526,5526,5526,5526,5526
41558,6257,9733,26948,14610,9.891e+12,60.0302,12598.2,41558,4729,72,31825,31825,27673,22037,20761
13558,4026,6668,8172,5386,6.61615e+12,55.725,7528.85,13558,3243,72,6890,6890,5766,4200,4071
63654,1651,26978,39124,24530,7.4387e+12,56.8348,30200.8,63654,13128,72,36676,36676,18993,7835,3870
4963,350,2653,2964,1999,6.17683e+12,43.9841,3039.54,4963,1276,70,2310,2262,1645,1275,1224
86964,28274,40126,52871,34093,6.9529e+12,56.495,44078.5,86964,19536,72,46838,46838,40978,32993,31140
10171,2011,2445,6589,3582,9.87995e+12,59.5327,3381.34,10171,1187,72,7726,7726,7115,7103,6530
50742,4813,12998,32706,18036,9.60565e+12,59.713,16297.8,50742,6324,72,37744,37744,24847,16610,14080
23924,3371,5637,15509,8415,9.89577e+12,59.9235,7467.19,23924,2738,72,18287,18287,15624,12035,11255
80719,9464,18758,52343,28376,9.91721e+12,60.138,23765.4,80719,9138,72,61961,61961,50726,35374,31733
69964,5234,23563,44080,25884,8.56911e+12,58.4718,27484,69964,11475,72,46401,46401,32014,15144,14526
95689,18071,23971,61737,33952,9.68288e+12,58.6918,29648.1,95689,11671,72,71718,71718,64557,54813,52530
2575,30,741,1663,912,9.26309e+12,56.6652,1068.96,2575,338,58,1218,210,626,456,93
39704,231,9456,25721,13983,9.84855e+12,59.636,12203.8,39704,4587,72,30248,30248,17195,16937,1206
90678,20688,30057,57219,33459,8.62937e+12,58.5545,34971.2,90678,14631,72,60621,60621,50549,38660,38346
75358,15667,17483,48871,26487,9.92205e+12,60.1348,22207.9,75358,8510,72,57875,57875,55643,55136,52041
98029,45282,45391,59577,38452,6.93256e+12,56.4776,49752.9,98029,22102,72,52638,52638,52530,52471,52464
61361,13342,25494,37810,23551,7.5638e+12,57.0789,28651.7,61361,12420,72,35867,35867,30287,22590,20973
36940,11072,13036,23172,13768,8.36104e+12,58.1256,15305.2,36940,6343,72,23904,23904,23324,22494,22541
41066,2041,9551,26640,14426,9.92628e+12,60.0664,12391.8,41066,4649,72,31515,31515,15328,15558,7218
39632,8718,17396,24256,15376,7.26285e+12,56.3753,19537.7,39632,8468,72,22236,22236,17882,11877,10667
26344,4239,10206,16377,9967,7.92559e+12,57.4993,11863.2,26344,4959,72,16138,16138,12446,12285,8097
88715,23064,45430,69375,19340,79069700000,8.98866,46041.1,88715,40881,11,43285,43285,27081,28754,25421
94388,15295,24359,60780,33608,9.5818e+12,59.7293,29919.4,94388,11860,72,70029,70029,59214,44435,40944
29492,3862,7191,19078,10414,9.76034e+12,59.8189,9337.77,29492,3490,72,22301,22301,18329,17400,11738
40263,352,9350,26109,14154,9.94082e+12,60.0843,12145.3,40263,4555,72,30913,30913,8608,1343,1672
23213,6860,8065,14593,8620,8.43812e+12,58.0405,9645.14,23213,3919,72,15148,15148,14869,14463,14591
45149,2755,10676,29242,15907,9.87106e+12,60.0344,13735.7,45149,5200,72,34473,34473,23217,22973,9464
11372,5636,5748,6833,4539,6.44021e+12,55.2884,6490.31,11372,2793,72,5624,5624,5497,5426,5413
69579,14618,16162,45124,24455,9.91392e+12,60.1308,20578.4,69579,7868,72,53417,53417,51626,51197,48752
93928,14066,21830,60902,33026,9.9187e+12,60.1464,27531,93928,10635,72,72098,72098,60787,60559,46969
29332,6418,13229,17887,11445,7.10841e+12,56.0903,14885.3,29332,6439,72,16103,16103,13203,9450,8611
5555,1110,1904,3507,2048,8.68674e+12,57.5003,2440.12,5555,922,72,3651,3651,2949,1968,1979
97451,39445,63121,76413,21038,2.23491e+13,5.53177,72305.4,97451,21046,13,34330,34330,31005,33709,23115
71898,4125,19952,46054,25844,9.33361e+12,59.4026,24261.5,71898,9711,72,51946,51946,27562,13087,11168
30153,7871,8443,19310,10843,9.32004e+12,59.2624,10541.5,30153,4106,72,21710,21710,21038,20882,20073
28935,7641,8993,18377,10558,8.90826e+12,58.7561,10955,28935,4368,72,19942,19942,18647,16848,16626
86615,12428,20181,56156,30459,9.90416e+12,60.1253,25495.4,86615,9826,72,66434,66434,55146,54917,41360
79771,16932,36323,48581,31190,7.03883e+12,56.0209,40032,79771,17690,72,43448,43448,30464,17616,14239
24716,1009,8061,15631,9085,8.7062e+12,58.4567,9760.61,24716,3914,72,16655,16655,8475,4866,3313
35383,2075,8256,22946,12437,9.91611e+12,60.0266,10767.4,35383,4020,72,27127,27127,18193,12569,7303
22315,935,1449,17776,4539,5.719e+13,11.9909,1930.02,22315,917,14,20866,20866,17739,15773,19453
89134,12097,33384,55558,33576,8.08283e+12,57.8851,37960.9,89134,16259,72,55750,55750,39033,19433,18694
24501,6027,7993,15482,9019,8.72431e+12,58.5127,9681.62,24501,3889,72,16508,16508,15248,13492,13315
2967,340,741,1920,1047,9.76166e+12,58.0725,1117.99,2967,346,61,2226,2226,1732,1628,1158
96189,5366,31447,60767,35422,8.6941e+12,58.6412,36646.3,96189,15313,72,64742,64742,38052,32604,13276
86716,9968,20128,56238,30478,9.91878e+12,60.1456,25454.2,86716,9804,72,66588,66588,54289,51432,33463
28016,3746,7172,18055,9961,9.62081e+12,59.6246,9205.71,28016,3481,72,20844,20844,16304,10991,10861
2668,1000,1125,1656,1012,7.66188e+12,55.178,1413.06,2668,542,56,1543,1543,1402,1304,1309
76141,34965,35208,46281,29860,6.95674e+12,56.4763,38733.1,76141,17152,72,40933,40933,40639,40338,40333
8279,61,1955,5369,2910,9.87606e+12,59.4298,2763.99,8279,937,72,6043,2937,1591,121,159
27864,4313,9997,17460,10404,8.31291e+12,57.1963,11792.7,27864,4853,72,17867,17867,13599,8661,8526
16490,433,7030,10136,6354,7.4368e+12,54.5952,8128.44,16490,3402,72,9460,9220,5841,2986,1592
88160,26911,28362,55770,32390,8.76142e+12,58.503,33221,88160,13812,72,59798,59798,57664,55223,55209
39602,606,9270,25670,13932,9.90977e+12,60.033,12021.8,39602,4516,72,30332,30332,9356,2150,2446
1964,331,505,1268,696,9.97321e+12,57.3931,782.439,1964,241,56,1459,1459,1227,1219,1092
64112,8442,14864,41578,22534,9.92248e+12,60.1247,18985.2,64112,7235,72,49248,49248,41458,39657,28362
57471,14944,17605,36531,20940,8.96005e+12,58.927,21057.8,57471,8567,72,39866,39866,37072,33779,33859
21149,4600,10765,12688,8461,6.36232e+12,55.4485,11944.6,21149,5234,72,10384,10384,7567,4908,4378
81592,25820,34381,50192,31400,7.4732e+12,57.1307,38358.1,81592,16744,72,47211,47211,43633,39483,39538
44753,10267,17102,27845,16908,7.99217e+12,57.6949,19653.9,44753,8324,72,27651,27651,21933,16468,15138
40231,10959,11492,25719,14512,9.22929e+12,59.2234,14128.9,40231,5591,72,28739,28739,28093,27947,27181
47751,5753,11126,30961,16790,9.91586e+12,60.0821,14343.5,47751,5413,72,36625,36625,30208,21504,19475
86698,20969,34107,53762,32936,7.83847e+12,57.5761,38461,86698,16608,72,52591,52591,44409,34881,34553
31102,3918,7272,20168,10934,9.91192e+12,60.0079,9534.82,31102,3536,72,23830,23830,18987,14385,13161
65368,1781,4053,52025,13343,5.73657e+13,12.0019,4893.09,65368,2386,20,61315,61315,46773,36197,54740
44246,9748,23610,26351,17895,6.0435e+12,55.2516,25624.6,44246,11485,72,20636,20636,15185,8825,8784
27693,3505,6423,17958,9735,9.94285e+12,60.0405,8487.22,27693,3129,72,21270,21270,16945,16868,11786
77279,8392,20814,49606,27673,9.43308e+12,59.5445,25443.3,77279,10129,72,56465,56465,41203,23171,22496
13056,450,3108,8464,4592,9.8822e+12,59.6932,4244.72,13056,1510,72,9948,9948,6135,4096,1594
59397,3020,13835,38507,20890,9.92139e+12,60.1096,17692.6,59397,6739,72,45562,45562,22464,22690,10510
47080,10572,19803,28973,18107,7.50067e+12,57.0953,22325.9,47080,9643,72,27277,27277,20749,14539,12999
7908,2471,4398,6205,1703,80081300000,8.81424,4563.59,7908,3951,11,3510,3510,2304,2386,2239
84562,4337,42975,50711,33851,6.35475e+12,55.6288,46551.4,84562,20932,72,41587,41587,25604,15675,6391
59684,14643,20756,37495,22189,8.41862e+12,58.27,24141.8,59684,10098,72,38928,38928,34425,28303,26935
99456,9543,31712,62965,36491,8.79949e+12,58.6948,37116.7,99456,15443,72,67744,67744,48159,25153,24231
58662,14111,19644,36984,21678,8.59894e+12,58.4774,23031.4,58662,9567,72,39018,39018,31609,31444,22682
19113,4294,4473,12388,6725,9.92859e+12,59.9094,6008.46,19113,2179,72,14640,14640,14440,14400,14274
95787,5191,22277,62115,33672,9.90427e+12,60.1344,28077.5,95787,10839,72,73510,73510,37553,20108,17857
19892,4220,6426,12598,7294,8.76222e+12,57.5935,7865.45,19892,3109,72,13466,13466,11316,8693,8894
13428,1374,6198,8177,5251,6.97659e+12,53.9329,7093.48,13428,2996,72,7230,7230,4832,2023,2138
6512,335,1542,4229,2283,9.93914e+12,59.3563,2218.01,6512,746,72,4970,4970,3191,2156,1179
73462,6047,17059,47645,25817,9.91729e+12,60.1304,21680.3,73462,8304,72,56403,56403,40398,40073,20740
72309,14306,16798,46896,25413,9.92037e+12,60.1239,21356.1,72309,8178,72,55511,55511,52452,51752,47432
58881,4521,20772,36936,21945,8.3598e+12,58.2009,24100,58881,10111,72,38109,38061,24192,15596,12512
42195,1467,9805,27364,14831,9.92307e+12,60.0698,12709.9,42195,4771,72,32390,32390,20227,19983,5353
3853,648,928,2497,1356,1.01647e+13,58.8209,1383.13,3853,451,66,2925,2925,2586,2510,2209
11006,1432,2640,7132,3874,9.85309e+12,59.571,3635.77,11006,1274,72,8366,8366,7019,5239,4891
88661,14669,29127,55990,32671,8.68297e+12,58.6148,33963,88661,14189,72,59534,59534,50790,40516,40176
8574,1989,3459,5307,3267,7.74785e+12,56.8156,4148.36,8574,1676,72,5115,5115,4299,3403,3484
84381,6335,27197,53385,30996,8.75347e+12,58.1752,31873.2,84381,13232,72,57184,57184,33155,18795,13503
4188,796,1078,2709,1479,9.76075e+12,58.5131,1555.28,4188,518,69,3110,3110,2865,2619,2632
15597,2380,4227,10013,5584,9.42812e+12,59.2117,5488.45,15597,2054,72,11370,11370,9404,7171,7152
61233,50042,57221,42157,19076,9.21198e+12,3.99673,57343.7,61233,19090,9,4012,4012,3508,4012,3515
81012,29824,42537,63418,17594,7.9404e+10,8.99268,43111.4,81012,38278,11,38475,38475,30148,30805,29509
6476,313,1603,4200,2276,9.81908e+12,59.078,2268.62,6476,775,72,4873,4873,1992,2057,812
46752,15951,17672,29112,17640,8.05112e+12,57.7792,20333.1,46752,8602,72,29080,29080,27979,26566,26307
34185,6485,7979,22169,12016,9.9148e+12,60.0221,10422.2,34185,3881,72,26206,26206,23992,23953,21447
37599,4090,8829,24373,13226,9.87559e+12,60.0005,11467.7,37599,4285,72,28770,28770,21994,15886,13779
33060,1017,2278,26366,6694,5.69341e+13,11.9932,2864.75,33060,1348,14,30782,30782,23052,17620,27289
17379,1987,4090,11274,6105,9.91469e+12,59.8445,5512.89,17379,1987,72,13289,13289,10285,10218,6775
87019,13483,36455,53555,33464,7.50623e+12,57.1596,40669.2,87019,17754,72,50564,50564,35360,17488,16947
17133,492,4850,10968,6165,9.26234e+12,59.0233,6189.7,17133,2348,72,12283,12235,5896,4914,1800
5609,692,1393,3623,1986,9.81852e+12,59.062,1991.64,5609,675,72,4216,4216,3211,3192,2150
34189,3340,13633,21169,13020,7.77166e+12,56.5958,15645.5,34189,6628,72,20556,20556,13613,5431,5312
33703,15791,17783,26388,7315,7.9406e+10,8.99315,18149.2,33703,15996,11,15920,15920,14515,14652,14390
11647,2086,2712,7562,4085,9.94427e+12,59.7794,3762.78,11647,1314,72,8935,8935,8175,7232,7082
20405,1990,6033,13009,7396,9.15341e+12,58.9381,7541.65,20405,2939,72,14372,14372,9700,9586,4127
75929,3981,17618,49246,26683,9.92589e+12,60.131,22369.4,75929,8579,72,58311,58311,29281,29503,13873
36564,416,9153,23601,12963,9.68899e+12,59.6223,11691.8,36564,4438,72,27411,27363,15887,8467,1801
63700,10568,14835,41304,22396,9.90425e+12,60.1035,18928.5,63700,7222,72,48865,48865,42657,42532,35150
81619,5510,20125,52719,28900,9.72444e+12,58.979,25102.3,81619,9790,72,61494,61494,40141,39721,13862
14262,1555,3381,9247,5015,9.90222e+12,59.7617,4598.51,14262,1643,72,10881,10881,8405,7962,5043
3240,11,807,2106,1134,9.85767e+12,58.1123,1205.52,3240,383,62,806,227,91,108,61
64371,13060,16577,41468,22903,9.59368e+12,59.7191,20594,64371,8074,72,47794,47794,43909,38662,37481
8978,4312,4801,5351,3627,6.07086e+12,51.6252,5397.96,8978,2330,72,4177,4177,3994,3720,3853
44703,4070,17434,27747,16956,7.88683e+12,57.0992,19961.4,44703,8486,72,27269,27269,17588,6194,5934
55120,12901,18826,34676,20444,8.5079e+12,58.3719,22019.8,55120,9170,72,36294,36294,33121,28727,27910
72367,13767,35449,56489,15878,78531300000,8.99692,36013.7,72367,31902,11,36918,36918,19707,21829,17596
34168,3504,11642,21508,12660,8.52408e+12,58.3341,13806.7,34168,5664,72,22526,22526,15474,15241,7025
71179,20121,23929,44864,26315,8.57448e+12,58.2559,27909.9,71179,11637,72,47250,47250,44427,40524,39818
52138,3935,26480,31272,20866,6.37012e+12,55.6249,28883.4,52138,12894,72,25658,25658,15245,8010,5779
82067,12096,25212,52132,29935,8.945e+12,54.5724,29868.8,82067,12269,72,56855,56855,38529,21109,16002
75954,35911,45501,44339,31615,5.18568e+12,54.2985,48260,75954,22165,72,30453,30453,27399,23193,22377
43389,2215,10062,28142,15247,9.93125e+12,60.1033,13039.2,43389,4901,72,33327,33327,21898,21668,7922
20367,1279,9625,12356,8011,6.85709e+12,54.7955,10831.2,20367,4672,72,10742,10711,6998,2614,2660
20480,641,4785,13282,7198,9.95151e+12,59.9227,6401.85,20480,2331,72,15695,15695,9656,9533,2361
12407,3477,3630,7919,4488,9.19737e+12,58.8823,4665.77,12407,1766,72,8777,8777,8594,8558,8454
75609,20881,38551,45323,30286,6.33009e+12,55.2074,41802.4,75609,18767,72,37058,37058,27520,16343,16092
24196,9408,11336,14692,9504,6.89832e+12,55.2026,12723.5,24196,5505,72,12860,12860,12009,11230,11148
36839,7746,11977,23295,13544,8.73806e+12,58.5875,14317.7,36839,5833,72,24862,24862,21540,17068,16052
55462,6617,18918,34910,20552,8.50665e+12,58.3715,22131.2,55462,9205,72,36544,36496,30109,29963,22326
34559,13806,34559,0,34559,7.99977,0,34559,34559,34559,1,0,0,0,0,0
84146,22966,25579,53509,30637,8.99045e+12,58.9944,30351,84146,12457,72,58567,58567,56805,56372,54023
48656,8692,11439,31543,17113,9.87737e+12,60.0426,14700.5,48656,5564,72,37217,37217,33442,33344,28970
26649,424,6501,17232,9417,9.77879e+12,59.7928,8477.06,26649,3158,72,20148,20148,6657,1626,1738
29873,10588,12080,18476,11397,7.69722e+12,57.3021,13873.6,29873,5879,72,17793,17793,16803,15722,15789
92980,19367,32581,58356,34624,8.38967e+12,58.2661,37481.6,92980,15867,72,60399,60399,51122,40225,39986
9392,486,2273,6087,3305,9.79372e+12,59.4452,3157.07,9392,1092,72,7119,7119,3339,3447,1702
96174,32513,41417,59005,37169,7.34964e+12,56.9533,45926.8,96174,20154,72,54757,54757,52024,48363,47560
48112,437,11220,31198,16914,9.91228e+12,60.0733,14454,48112,5462,72,36892,36892,21212,13653,1970
21600,1564,5035,14008,7592,9.9352e+12,59.9765,6729.09,21600,2450,72,16565,16565,11527,11425,5488
76987,3766,76987,0,76987,7.9999,0,76987,76987,76987,1,0,0,0,0,0
91809,17979,21362,59533,32276,9.91271e+12,60.1248,26948.9,91809,10402,72,70447,70447,66384,65436,59663
79323,12663,19116,51328,27995,9.80189e+12,59.9944,24002.6,79323,9309,72,60207,60207,52380,50565,39201
20651,1784,9215,12618,8033,7.17548e+12,54.4191,10485.6,20651,4466,72,11436,11436,6845,3778,2788
64035,4030,14922,41524,22511,9.89471e+12,60.0897,19033.8,64035,7255,72,49113,49113,27292,27072,13855
94748,15655,31247,59803,34945,8.65706e+12,58.1389,36361.4,94748,15217,72,63501,63501,49519,30270,25853
96807,18693,22440,62784,34023,9.91707e+12,60.1488,28295.2,96807,10927,72,74367,74367,68920,68808,62357
92320,19413,30817,58211,34109,8.59737e+12,58.5178,35794.5,92320,14998,72,61503,61503,52109,39274,36237
43529,2224,15584,27268,16261,8.29525e+12,58.0894,18162.6,43529,7584,72,27945,27945,17047,4434,3818
15389,1116,6185,9530,5859,7.74765e+12,57.1925,7259.53,15389,3006,72,9204,9168,3992,1453,605
45038,5312,45038,0,45038,7.99982,0,45038,45038,45038,1,0,0,0,0,0
37096,5158,8831,24015,13081,9.856e+12,59.9044,11430.7,37096,4297,72,28265,28265,22929,22819,16512
8521,1061,2000,5527,2994,9.99389e+12,59.5633,2826.12,8521,967,72,6521,6521,5376,3898,3627
2261,915,1101,1369,892,6.78273e+12,46.9018,1337.54,2261,520,54,1160,1160,929,750,789
26065,1682,10468,16140,9925,7.74882e+12,56.6593,12082.1,26065,5082,72,15597,15597,9264,4102,2575
7688,1790,1821,4990,2698,9.93277e+12,59.411,2582.53,7688,883,72,5867,5867,5844,5849,5854
1385,251,378,900,485,9.94023e+12,55.1523,587.452,1385,175,47,1007,1007,858,761,785
40276,17864,21254,24032,16244,6.11076e+12,54.2243,23143.2,40276,10334,72,19022,19022,17212,15085,15230
48704,3452,11285,31592,17112,9.93168e+12,60.1017,14559.4,48704,5491,72,37419,37419,22417,13697,12060
25115,7085,7242,16047,9068,9.21182e+12,59.0763,9037.85,25115,3524,72,17873,17873,17767,17742,17770
95821,6742,30379,60711,35110,8.81641e+12,58.7939,35626.6,95821,14794,72,65442,65442,41197,12499,11486
18146,100,4273,11770,6376,9.85615e+12,59.7911,5745.62,18146,2067,72,13873,12795,7826,7704,504
15766,2705,3720,10227,5539,9.90277e+12,59.8226,5038.46,15766,1806,72,12046,12046,10855,10552,9029
76385,12956,17791,49531,26854,9.90027e+12,60.115,22567.4,76385,8653,72,58594,58594,52867,51513,43257
52994,2327,16041,33722,19272,9.00459e+12,58.9777,19283.3,52994,7806,72,36953,36953,19503,17261,7234
6606,288,2443,4133,2473,8.25022e+12,52.6804,3036.66,6606,1173,72,4163,4115,2531,803,761
17617,8563,10092,10382,7235,5.54324e+12,51.4416,11013.3,17617,4896,72,7525,7525,7246,6841,6969
96976,6456,32061,61208,35768,8.64117e+12,58.2689,37274.7,96976,15596,72,64915,64915,41225,35691,16273
11961,514,2841,7753,4208,9.96682e+12,59.6841,3901.89,11961,1383,72,9120,9120,4084,4150,1855
83757,21387,34811,51598,32159,7.54447e+12,57.0039,38912.9,83757,16944,72,48946,48946,41609,34701,32814
30893,8757,13517,18919,11974,7.27755e+12,56.4782,15278.4,30893,6562,72,17376,17376,14138,10428,10342
98493,21360,23972,63678,34815,9.77036e+12,59.9629,29838.1,98493,11668,72,74521,74521,71431,71344,67797
24051,2341,5607,15603,8448,9.94364e+12,59.9645,7446.81,24051,2728,72,18444,18444,13708,9831,8051
82055,4053,19020,53222,28833,9.92187e+12,60.1387,24099.7,82055,9260,72,63035,63035,30655,15808,14159
43793,2594,10169,28408,15385,9.9176e+12,60.0834,13169.4,43793,4945,72,33624,33624,17987,17910,8887
72155,13691,22804,45724,26431,8.84779e+12,58.7993,26926.9,72155,11109,72,49351,49351,38479,23631,20120
43396,17969,18847,26590,16806,7.31656e+12,56.8551,21166.4,43396,9176,72,24549,24549,24467,24377,24492
81475,6387,26046,51575,29900,8.78701e+12,58.5362,30602,81475,12676,72,55429,55429,34971,21374,16675
52945,1095,28667,31446,21499,5.91943e+12,55.1734,30966,52945,13951,72,24278,23894,13943,8642,1607
86608,3617,20112,56166,30442,9.9213e+12,60.141,25427.3,86608,9797,72,66496,66496,42428,28625,12786
96024,20650,22416,62254,33770,9.89747e+12,60.1217,28221.1,96024,10915,72,73608,73608,70993,68545,67940
61542,31787,33679,36499,25043,5.85347e+12,54.7853,36248.8,61542,16387,72,27863,27863,27565,27228,27425
46338,11067,29754,26700,19638,4.63139e+12,52.1958,31451.7,46338,14472,72,16584,16584,12660,8202,8242
60213,14435,26183,36902,23311,7.29803e+12,56.5695,29212.7,60213,12733,72,34030,34030,28327,20464,18798
14612,535,5203,9169,5443,8.36327e+12,57.8909,6292.89,14612,2528,72,9409,9313,5908,2641,1842
11891,1350,4128,7482,4409,8.52212e+12,57.9246,5067.71,11891,2007,72,7763,7763,4870,3182,2623
88634,26466,45254,53121,35513,6.32222e+12,55.3462,48961.8,88634,22024,72,43380,43380,35829,28740,26816
21655,1627,12652,12696,8959,5.40725e+12,53.0415,13706.1,21655,6158,72,9003,9003,4827,2430,1757
76463,18022,23824,48513,27950,8.88782e+12,58.8376,28185.9,76463,11588,72,52639,52639,45727,36302,34108
68090,27374,28901,41856,26234,7.42935e+12,57.0682,32305.4,68090,14074,72,39189,39189,38384,37506,37608
26447,1162,7431,16938,9509,9.29545e+12,59.1094,9320.06,26447,3601,72,19016,19016,7990,7437,1822
24365,5100,5683,15805,8560,9.92635e+12,59.9581,7543.08,24365,2763,72,18682,18682,17827,17811,16971
32179,4464,8846,20638,11541,9.36865e+12,59.3584,11071.7,32179,4303,72,23333,23333,19057,13273,11950
13401,929,3186,8689,4712,9.88201e+12,59.6694,4345.83,13401,1546,72,10215,10215,5749,3320,2956
60960,5266,19865,38533,22427,8.71719e+12,58.6308,23404.1,60960,9673,72,41095,41095,25145,13321,10648
39290,2369,9139,25480,13810,9.92698e+12,60.0625,11878.4,39290,4446,72,30151,30151,20207,20017,8077
59559,7171,22644,37068,22491,8.00729e+12,57.7605,25882.8,59559,11022,72,36915,36915,22976,14422,11365
82808,10361,33100,51255,31553,7.76104e+12,57.4751,37250.6,82808,16121,72,49708,49708,32698,12671,12036
9162,1046,4490,7152,2010,78505900000,8.98592,4685.26,9162,4039,11,4672,4672,1931,2269,1608
60323,1315,14067,39116,21207,9.90578e+12,60.083,17974,60323,6846,72,46256,46256,27778,18296,5061
36598,3295,8529,23737,12861,9.92418e+12,60.02,11110.7,36598,4146,72,28069,28069,20435,20286,11144
39685,9155,9231,25735,13950,9.93895e+12,60.0797,11990.2,39685,4497,72,30454,30454,30364,30347,30359
69186,13016,16090,44866,24320,9.90872e+12,60.1123,20480.6,69186,7833,72,53096,53096,48663,48568,43373
54849,8213,14309,35287,19562,9.55384e+12,59.661,17809.6,54849,6967,72,40540,40540,34234,32715,23686
51742,14984,18049,32485,19257,8.42669e+12,58.2621,21051.2,51742,8791,72,33693,33693,29260,29165,23971
8719,222,2760,5524,3195,8.92045e+12,56.2485,3532.47,8719,1338,72,5959,5914,1521,810,0
29002,9878,10622,18134,10868,8.20226e+12,57.8977,12459.4,29002,5169,72,18380,18380,17335,16332,16275
38007,2272,13031,23905,14102,8.4996e+12,58.3104,15381.3,38007,6342,72,24976,24976,12948,6101,3700
98829,20719,36052,61776,37053,8.20336e+12,58.0414,41117.2,98829,17558,72,62777,62777,52622,40697,40413
37969,8618,19146,29673,8296,7.8866e+10,8.99294,19546.3,37969,17224,11,18823,18823,10960,11827,10111
93458,4471,21672,60612,32846,9.92604e+12,60.15,27348.4,93458,10558,72,71786,71786,46668,46169,15718
34060,5438,7946,22086,11974,9.93427e+12,60.0407,10379.3,34060,3869,72,26114,26114,23032,22327,17972
67395,11976,22059,42578,24817,8.68525e+12,58.6046,25900.4,67395,10741,72,45336,45336,34791,22404,21971
42782,2587,14626,26924,15858,8.51949e+12,58.34,17215.5,42782,7125,72,28156,28156,14628,7217,4364
23956,5982,7711,15157,8799,8.80393e+12,58.5615,9374.02,23956,3756,72,16245,16245,15234,14173,14212
96599,892,54576,56966,39633,5.61877e+12,54.5917,58181.5,96599,26583,72,42023,40752,23350,14482,731
6844,1249,3329,4139,2705,6.71939e+12,55.4972,3854.4,6844,1617,72,3515,3515,2405,1459,1264
15000,946,3537,9721,5279,9.87902e+12,59.7749,4807.62,15000,1714,72,11463,11463,6403,6304,3352
57422,1900,2425,45453,11969,5.85619e+13,12.0021,3220.38,57422,1287,19,54997,54997,50329,46357,52902
49702,8359,18208,31058,18644,8.19018e+12,57.3916,21051.1,49702,8854,72,31494,31494,25205,17928,16262
72755,16091,23378,46048,26707,8.76331e+12,58.7051,27508.5,72755,11379,72,49377,49377,46411,42893,42978
21913,1522,11503,17154,4759,79378800000,8.94437,11797.6,21913,10345,11,10410,10410,3483,4129,2856
71466,59272,66785,49204,22262,9.20975e+12,3.99548,66917.9,71466,22276,9,4681,4681,4153,4681,4160
44666,4635,12717,28565,16101,9.24707e+12,59.2481,15590.6,44666,6191,72,31949,31949,22322,13921,11478
55025,7012,12798,35687,19338,9.90522e+12,60.0933,16421.4,55025,6221,72,42227,42227,35328,33707,23732
56635,2748,13210,36719,19916,9.92395e+12,60.092,16911.8,56635,6435,72,43425,43425,28209,27897,9545
17188,1308,4035,11148,6040,9.90934e+12,59.8778,5449.34,17188,1959,72,13153,13153,9228,9142,4560
80849,24663,40710,48559,32290,6.42524e+12,55.8247,44177.3,80849,19832,72,40139,40139,32859,22835,20652
3048,556,1392,1867,1181,7.40291e+12,54.3379,1693.1,3048,671,63,1656,1608,1335,984,1186
29632,11513,12780,18180,11452,7.35747e+12,56.8358,14494.4,29632,6217,72,16852,16852,16241,15485,15372
5017,948,1256,3244,1773,9.8446e+12,58.9691,1806.73,5017,606,72,3761,3761,3388,3309,2965
1197,433,542,733,464,7.5911e+12,52.391,697.523,1197,257,41,655,655,548,482,484
22881,4322,5385,14830,8051,9.90011e+12,59.9638,7154.73,22881,2622,72,17496,17496,16045,16003,14444
19033,4985,9420,11474,7559,6.53291e+12,53.3378,10530.9,19033,4566,72,9613,9613,7914,5930,6081
21806,6037,7321,13751,8055,8.62412e+12,58.3115,8839.93,21806,3564,72,14485,14485,12637,10476,10616
96383,17193,28848,61360,35023,9.05498e+12,58.97,34235.5,96383,14054,72,67535,67535,55010,54713,39731
54859,1479,12760,35574,19285,9.90419e+12,60.0868,16373.9,54859,6201,72,42099,42099,15603,16605,5523
86982,24465,36233,53577,33405,7.53879e+12,57.2163,40459.7,86982,17651,72,50749,50749,42417,31060,28380
26363,793,9700,16463,9900,8.20472e+12,57.8804,11399.9,26363,4725,72,16663,16567,7795,3815,2261
65459,12986,15237,42451,23008,9.91339e+12,60.1027,19424.2,65459,7415,72,50222,50222,47023,46952,43249
67170,3097,3323,53277,13893,5.8122e+13,12.0021,4180.36,67170,2421,20,63847,63847,62140,60830,63065
79405,16189,18474,51488,27917,9.90972e+12,60.1166,23408.4,79405,8991,72,60931,60931,57691,57616,53859
37004,11018,33440,24715,12289,8.29567e+12,7.39831,33809.1,37004,11826,65,3564,3564,1992,3564,1999
41859,16186,21928,32764,9095,79362300000,8.98636,22339.1,41859,19727,11,19931,19931,15888,16279,15511
33386,2817,9239,21392,11994,9.35296e+12,59.3294,11527.9,33386,4489,72,24147,24147,16795,16019,9513
97484,41593,51648,76341,21143,79500500000,8.987,52275.1,97484,46476,11,45836,45836,39414,39880,38965
45925,13365,16313,28797,17128,8.34442e+12,58.0549,19012.1,45925,7930,72,29612,29612,27749,25166,24780
21045,5702,9884,12770,8275,6.87919e+12,55.9292,11130.1,21045,4809,72,11161,11161,8992,6473,6600
45288,14383,19959,27715,17573,7.22104e+12,56.2053,22338.5,45288,9701,72,25329,25329,22414,19691,19067
88264,3704,20502,57241,31023,9.91372e+12,60.137,25907,88264,9984,72,67762,67762,43252,42765,13063
7082,1503,1684,4604,2478,9.86145e+12,59.3476,2403.26,7082,811,72,5398,5398,5159,5154,5016
86571,3693,20409,56086,30485,9.86667e+12,60.0823,25705.2,86571,9937,72,66162,66162,29004,13091,11740
49201,4847,11463,31910,17291,9.91782e+12,60.0776,14759.2,49201,5581,72,37738,37738,28134,20156,16426
95512,34492,35044,59676,35836,8.17622e+12,57.5462,39948.8,95512,17053,72,60468,60468,60468,60468,60468
84475,4512,28127,53289,31186,8.60941e+12,58.3771,32747.4,84475,13680,72,56348,56348,31953,26598,10000
81195,14498,18879,52646,28549,9.9116e+12,60.1315,23911.5,81195,9191,72,62316,62316,57038,49869,48213
74419,3775,20688,47664,26755,9.31506e+12,59.3839,25124.4,74419,10064,72,53731,53731,34613,31244,11153
35672,2470,8316,23129,12543,9.91536e+12,60.0439,10846.5,35672,4045,72,27356,27356,16104,15922,8631
10618,1140,2532,6883,3735,9.94451e+12,59.6373,3501.99,10618,1233,72,8086,8086,6142,6090,3928
22812,8996,10912,13819,8993,6.76324e+12,54.6268,12218.7,22812,5297,72,11900,11900,11026,9995,10188
65146,16207,19252,41518,23628,9.09837e+12,59.1127,23136.3,65146,9369,72,45894,45894,42793,39210,39132
84652,42096,42298,50907,33745,6.45872e+12,55.7651,45930.7,84652,20584,72,42354,42354,42354,42354,42354
8614,6383,6419,4813,3801,3.36148e+12,19.7599,6793.49,8614,3109,62,2195,2195,2195,2195,2195
32556,2340,9849,20723,11833,9.01173e+12,58.9107,12026.7,32556,4786,72,22707,22707,15893,7837,7724
58269,22425,28545,45485,12784,78540900000,8.99413,29050.8,58269,25686,11,29724,29724,24873,25470,24287
66266,28532,36761,51996,14270,80088100000,8.95542,37257.8,66266,33078,11,29505,29505,23905,24401,23428
67013,14606,22283,42281,24732,8.61618e+12,58.3781,26085.5,67013,10833,72,44730,44730,38931,37471,29238
23325,2475,8909,14507,8818,8.01993e+12,56.2129,10425.8,23325,4334,72,14416,14416,9826,4434,4439
80424,17315,18700,52152,28272,9.91131e+12,60.1305,23692.7,80424,9104,72,61724,61724,60028,57796,57330
23867,2961,5565,15481,8386,9.943e+12,59.9846,7393.35,23867,2710,72,18302,18302,14558,11010,10129
4026,837,993,2615,1411,9.7329e+12,58.5152,1463.85,4026,469,67,3033,3033,2842,2837,2737
29804,6370,9723,18849,10955,8.71502e+12,58.5253,11695.5,29804,4730,72,20081,20081,17606,14293,13563
99054,17862,28980,63185,35869,9.13055e+12,59.1851,34546.6,99054,14106,72,70074,70074,56883,38716,34554
56793,1403,3694,45237,11556,5.71764e+13,12.0019,4475.45,56793,2198,20,53099,53099,38445,28534,45529
39785,9459,17265,24391,15394,7.32066e+12,56.8362,19424.4,39785,8402,72,22520,22520,19190,14682,13662
56484,2617,13125,36635,19849,9.92062e+12,60.0998,16826.1,56484,6386,72,43359,43359,20415,10124,9130
81997,12734,24625,52189,29808,9.03569e+12,59.0614,29318.4,81997,11991,72,57372,57372,47649,34373,31227
66342,9907,29122,40613,25729,7.24852e+12,56.6258,32383.6,66342,14167,72,37220,37220,25271,15218,12368
21374,580,7841,13357,8017,8.20761e+12,57.8562,9286.78,21374,3819,72,13533,13335,7284,3489,2181
27304,1050,6420,17706,9598,9.88734e+12,59.9396,8454.76,27304,3115,72,20884,20884,8863,9212,3787
69044,691,18932,44264,24780,9.37404e+12,59.4112,23117.4,69044,9201,72,50112,49920,28923,18725,2904
86967,14132,24457,55645,31322,9.28304e+12,59.3702,29504.3,86967,11914,72,62510,62510,51497,51210,38059
38818,4046,11169,24796,14022,9.2141e+12,59.1842,13722,38818,5434,72,27649,27649,19767,18935,10634
76824,3760,17874,49814,27010,9.91013e+12,60.132,22676.1,76824,8702,72,58950,58950,38429,26166,13175
76285,13908,35107,46410,29875,6.97356e+12,56.5107,38654.7,76285,17098,72,41178,41178,31441,20202,17496
86148,8429,20018,55865,30283,9.90524e+12,60.1269,25313.7,86148,9738,72,66130,66130,49275,48935,28548
72992,6402,28998,45216,27776,7.7936e+12,57.325,32745.1,72992,14110,72,43994,43994,26593,12277,8612
40487,14914,15553,25172,15315,7.9615e+12,57.6499,17902.3,40487,7566,72,24934,24934,24794,24558,24691
74907,9181,17459,48570,26337,9.8986e+12,60.103,22153.5,74907,8498,72,57448,57448,45392,33831,30626
74176,29125,33645,45199,28977,7.06454e+12,56.6139,37141.5,74176,16391,72,40531,40531,38267,35631,35756
97919,23979,51981,76688,21231,79519900000,8.98958,52608.6,97919,46775,11,45938,45938,26144,28076,24231
60374,1660,3866,48077,12297,5.72404e+13,12.002,4672.3,60374,2265,20,56508,56508,42550,32415,48118
32492,936,1366,25722,6770,5.85631e+13,11.994,1956.09,32492,1362,13,31126,31126,27279,23892,29411
17375,670,4086,11270,6105,9.93312e+12,59.8429,5506.91,17375,1986,72,13289,13289,5414,5632,2133
97272,10663,23739,62868,34404,9.76457e+12,59.9646,29538.2,97272,11565,72,73533,73533,56820,55422,34985
77187,8189,19439,49788,27399,9.6649e+12,59.8182,24154.4,77187,9463,72,57748,57748,43434,41869,25539
14484,4833,5056,9106,5378,8.46662e+12,57.976,6146.57,14484,2453,72,9428,9428,9189,8942,8945
31580,5616,10392,19943,11637,8.6832e+12,58.2031,12453.1,31580,5056,72,21188,21188,17576,12707,11597
1115,177,931,618,497,3.05018e+12,11.5094,989.121,1115,436,38,184,184,184,184,184
81453,26896,30648,50756,30697,8.06265e+12,57.8475,34875.6,81453,14929,72,50805,50805,48037,47346,43538
64731,2077,3781,51478,13253,5.75613e+13,11.9967,4611.45,64731,2658,14,60950,60950,48749,39166,55472
35225,469,8213,22841,12384,9.91225e+12,60.037,10718.7,35225,3992,72,27012,27012,15761,15534,1999
58916,1527,21938,36761,22155,8.10907e+12,57.3015,25180.8,58916,10668,72,36978,36978,18865,8845,4976
93895,12616,22849,60697,33198,9.77409e+12,59.9722,28479.3,93895,11128,72,71046,71046,57033,56693,39884
36475,8613,16144,22315,14160,7.20676e+12,56.1102,18136.8,36475,7844,72,20331,20331,16367,11768,11729
79660,8363,18526,51658,28002,9.91533e+12,60.1338,23474.2,79660,9024,72,61134,61134,46369,46065,28258
67505,2523,26253,41909,25596,7.89726e+12,57.5312,29806.8,67505,12783,72,41252,41252,23902,7503,2896
80311,5172,20190,51812,28499,9.66896e+12,59.8081,25068.1,80311,9833,72,60121,60121,31399,20814,15380
59927,4395,20464,37708,22219,8.52385e+12,58.3779,23881,59927,9969,72,39463,39463,25847,25388,9278
7338,148,2757,4580,2758,8.21972e+12,57.1814,3388.88,7338,1343,72,4581,4454,1952,975,563
45769,2128,10682,29682,16087,9.91111e+12,60.0613,13785.2,45769,5199,72,35087,35087,16572,8386,7573
39008,7719,12941,24613,14395,8.64523e+12,57.6987,15376.4,39008,6299,72,26067,26067,21371,15903,15781
31254,14174,15726,18778,12476,6.43056e+12,54.6239,17338,31254,7639,72,15528,15528,14660,13710,13816
42352,6761,10323,27383,14969,9.78565e+12,59.9029,13199.4,42352,5028,72,32029,32029,27352,21811,21810
56140,10351,16447,35812,20328,9.13203e+12,59.1406,19887.1,56140,8006,72,39693,39693,34029,26335,24553
4334,269,1463,2743,1591,8.64663e+12,52.3094,1916.89,4334,690,68,2871,2871,1912,877,915
15583,2541,3681,10101,5482,9.88283e+12,59.7875,4987.73,15583,1787,72,11902,11902,10518,10201,8346
91857,3223,29516,58129,33728,8.7703e+12,58.7202,34548.9,91857,14366,72,62341,62293,38993,16396,10319
55093,13894,26134,33370,21723,6.8013e+12,56.0625,28786.6,55093,12726,72,28959,28959,21098,11945,11663
57695,14952,19772,36286,21409,8.50195e+12,57.6965,23083.1,57695,9626,72,37923,37923,34485,29745,28846
54639,18260,29562,32465,22174,5.93834e+12,55.1953,31919.4,54639,14398,72,25077,25077,21633,16933,15971
66753,582,16961,43034,23719,9.64462e+12,59.7749,21117.3,66753,8263,72,49792,49719,16321,2306,2707
41943,1240,9805,27193,14750,9.90824e+12,60.0534,12692.2,41943,4770,72,32138,32138,12328,13020,4599
35330,6984,8318,22897,12433,9.88277e+12,60.0276,10826.9,35330,4049,72,27012,27012,25387,23256,22816
75573,22546,33000,46281,29292,7.27955e+12,56.8897,36647.7,75573,16073,72,42573,42573,38356,33448,33438
30725,5652,7125,19930,10795,9.95016e+12,60.0481,9366.09,30725,3470,72,23600,23600,21797,21383,18929
61408,8670,16908,39364,22044,9.35413e+12,59.4084,20692.2,61408,8223,72,44500,44500,34811,25566,23016
10414,1072,2484,6744,3670,9.92155e+12,59.6433,3439.41,10414,1210,72,7930,7930,5913,4141,3709
70198,54299,70198,0,70198,7.99989,0,70198,70198,70198,1,0,0,0,0,0
46157,5417,10713,29940,16217,9.92927e+12,60.0845,13841.3,46157,5217,72,35444,35444,27706,20299,18312
64306,9337,18014,41167,23139,9.30102e+12,59.3543,21924.9,64306,8771,72,46292,46292,35234,22225,21746
93439,26510,38905,57563,35876,7.53291e+12,57.1851,43396.9,93439,18939,72,54534,54534,47137,37038,34685
9737,3624,4373,5948,3789,7.17184e+12,49.2377,5090.61,9737,2108,72,5364,5364,4905,4518,4532
46488,6443,11454,30039,16449,9.73654e+12,59.8547,14553,46488,5576,72,35034,35034,28241,21759,20015
36995,5918,11450,23494,13501,8.93155e+12,58.8232,13843,36995,5569,72,25545,25545,20304,14189,14016
61180,2097,14202,39681,21499,9.9109e+12,60.1089,18164.1,61180,6905,72,46978,46978,29353,28998,7682
60238,4867,14028,39051,21187,9.91497e+12,60.1171,17933.9,60238,6834,72,46210,46210,29905,19151,16698
51711,10047,21401,31884,19827,7.57562e+12,57.2067,24152.4,51711,10420,72,30310,30310,24739,17193,15448
76284,10731,26112,47998,28286,8.49557e+12,57.7106,30298.3,76284,12701,72,50172,50172,37485,25459,22070
14418,1405,4122,9214,5204,9.28292e+12,59.0368,5289.76,14418,2008,72,10296,10296,7025,5450,4872
78451,20579,24218,49812,28639,8.9231e+12,58.912,28690.9,78451,11784,72,54233,54233,52888,52844,51456
67186,17906,19447,42892,24294,9.17696e+12,55.6215,23464.7,67186,9464,72,47739,47739,45866,45437,42853
7710,249,1821,5005,2705,9.99566e+12,59.5139,2583.74,7710,886,72,5889,5889,2200,2325,887
75885,20793,27084,47543,28342,8.30457e+12,57.9106,31176.4,75885,13172,72,48801,48801,45123,40800,40849
68907,2936,16456,44606,24301,9.83753e+12,60.0245,20801.4,68907,8016,72,52451,52451,23100,10769,9684
52114,9640,15120,33272,18842,9.16216e+12,59.1569,18363,52114,7353,72,36994,36994,31485,24001,22256
9473,1337,3372,5945,3528,8.36112e+12,57.6631,4157.68,9473,1637,72,6101,6101,4265,2912,2553
90318,41399,42335,54801,35517,6.86436e+12,56.3813,46365.5,90318,20617,72,47983,47983,47752,47402,47535
43832,2071,10245,28421,15411,9.90546e+12,60.0496,13237.6,43832,4988,72,33587,33587,21797,21543,7383
36013,5878,8381,23353,12660,9.93168e+12,60.0623,10932.5,36013,4083,72,27632,27632,24659,20668,19785
49308,6947,20676,30354,18954,7.49589e+12,57.1153,23304.7,49308,10059,72,28632,28632,19401,8552,8316
43019,11882,13756,27243,15776,8.78953e+12,58.684,16430.4,43019,6696,72,29263,29263,28067,26521,26239
74962,20559,24908,47296,27666,8.61901e+12,58.5276,29085.3,74962,12120,72,50054,50054,46417,41512,40395
66109,10895,18843,42253,23856,9.23419e+12,59.2789,22824.2,66109,9174,72,47266,47266,40289,38571,28576
69708,4405,28293,43073,26635,7.67223e+12,56.8655,31859.2,69708,13761,72,41415,41415,22252,11205,7203
23662,2317,5569,15338,8324,9.93283e+12,59.9345,7380.08,23662,2712,72,18093,18093,13239,12617,7729
41021,4314,18054,25093,15928,7.24195e+12,56.1367,20251.9,41021,8789,72,22967,22967,13968,7188,5219
40158,10249,14558,25126,15032,8.22841e+12,57.9857,16957.7,40158,7076,72,25600,25600,22685,18771,17890
40731,3342,14323,25561,15170,8.37732e+12,58.1565,16783.1,40731,6966,72,26408,26408,17817,7701,7498
86720,5808,45320,51790,34930,6.16714e+12,54.958,48885.9,86720,22056,72,41400,41400,25739,7491,6928
17887,863,4201,11600,6287,9.93441e+12,59.8549,5654.14,17887,2043,72,13686,13686,6381,6567,3059
57034,8639,18848,35993,21041,8.66019e+12,58.5135,22178.2,57034,9176,72,38186,38186,29289,28922,18299
18229,4520,7582,11238,6991,7.56826e+12,57.0348,8784.09,18229,3688,72,10647,10647,8769,6660,6645
82078,8850,19024,53238,28840,9.92592e+12,60.1396,24104.8,82078,9263,72,63054,63054,48157,34719,29895
58179,12773,13566,37722,20457,9.91926e+12,60.1021,17354.7,58179,6607,72,44613,44613,43556,43521,42450
93772,1772,25527,60157,33615,9.39353e+12,59.5016,30967.5,93772,12423,72,68245,68245,39518,38829,4143
64277,23343,34350,38259,26018,6.01518e+12,54.3359,37076.9,64277,16712,72,29927,29927,25783,21909,20921
2838,451,703,1835,1003,1.00019e+13,58.2815,1067.14,2838,337,61,2135,2135,1777,1453,1521
36554,9497,11844,23124,13430,8.72894e+12,58.57,14174.1,36554,5757,72,24710,24710,22835,20618,20760
6166,543,1466,4004,2162,9.94419e+12,59.2694,2113.55,6166,709,72,4700,4700,3340,3314,1845
76278,2192,17702,49474,26804,9.92148e+12,60.1297,22473.7,76278,8619,72,58576,58576,22369,23652,8146
5355,824,1342,3462,1893,9.80686e+12,58.9305,1916.77,5355,648,72,4013,4013,3253,3237,2506
14392,3027,4966,9052,5340,8.52061e+12,58.0475,6057.13,14392,2413,72,9426,9426,7862,5741,5421
81751,12069,20146,52813,28938,9.72953e+12,59.9143,25132.2,81751,9807,72,61605,61605,50128,49880,36098
35878,9180,11259,22757,13121,8.87735e+12,58.7559,13580,35878,5481,72,24619,24619,22777,21015,20758
34530,1716,8053,22393,12137,9.91448e+12,60.0325,10518.3,34530,3916,72,26477,26477,12879,6740,6090
21156,2277,11688,12527,8629,5.8232e+12,54.8715,12780.1,21156,5693,72,9468,9468,5904,1783,1842
79859,12748,18995,51718,28141,9.84622e+12,60.0481,23925.7,79859,9252,72,60864,60864,52618,52411,42621
8724,1194,2124,5657,3067,9.79505e+12,59.3879,2958.86,8724,1023,72,6600,6600,5484,5227,3754
78947,16601,18373,51200,27747,9.90257e+12,60.1241,23286.6,78947,8944,72,60574,60574,58011,57954,55092
33529,6728,9319,21477,12052,9.34675e+12,59.3356,11611,33529,4540,72,24210,24210,21987,19030,18390
93658,35724,48959,55931,37727,6.16494e+12,55.4949,52760.6,93658,23845,72,44699,44699,40149,35807,34798
37881,2999,13115,23808,14073,8.45294e+12,58.2721,15452.7,37881,6386,72,24766,24766,15633,9120,7013
69440,4929,18837,44554,24886,9.4186e+12,59.5075,23051.8,69440,9176,72,50603,50603,29081,28744,14474
80129,4150,29803,49983,30146,8.11272e+12,57.4553,33999,80129,14513,72,50326,50326,25332,10813,5516
64099,1865,23327,40088,24011,8.21075e+12,58.0208,26846,64099,11355,72,40772,40772,24012,9617,3551
65114,10940,15159,42225,22889,9.90936e+12,60.1036,19327.5,65114,7381,72,49955,49955,44877,37987,36396
14488,3545,5824,8968,5520,7.759e+12,53.8451,6851.61,14488,2814,72,8664,8664,7249,5617,5782
78651,13947,25162,49783,28868,8.78489e+12,58.7423,29580.3,78651,12252,72,53489,53489,41279,24470,20645
47639,10674,20201,29280,18359,7.43673e+12,56.8306,22740.3,47639,9826,72,27438,27438,23124,17148,15946
52657,11215,18247,33094,19563,8.45024e+12,58.2823,21300.8,52657,8885,72,34410,34410,28692,22062,21848
47146,4332,13576,30109,17037,9.2121e+12,59.2097,16568.7,47146,6607,72,33570,33570,21480,21765,11965
92593,27236,49738,55059,37534,5.97836e+12,55.0639,53408.1,92593,24221,72,42855,42855,35616,25638,23460
61667,17919,21377,38752,22915,8.44236e+12,58.3045,24858.5,61667,10413,72,40290,40290,37966,35211,35329
61222,23101,26937,37458,23764,7.24483e+12,56.812,29979.3,61222,13123,72,34285,34285,32895,31074,30713
70411,12960,16350,45664,24747,9.91768e+12,60.1342,20810.7,70411,7963,72,54061,54061,49999,49053,43254
27341,3729,6366,17736,9605,9.90526e+12,59.9776,8410.03,27341,3085,72,20975,20975,17100,17032,12472
59015,5229,13765,38261,20754,9.89931e+12,60.0908,17605,59015,6690,72,45250,45250,31023,29936,17604
13599,1371,3219,8819,4780,9.89445e+12,59.7557,4395.38,13599,1562,72,10380,10380,7682,7382,4695
43620,7512,16992,27078,16542,7.90036e+12,57.5698,19465.3,43620,8277,72,26628,26628,19253,10649,10359
37520,5378,11868,23787,13733,8.85184e+12,58.7331,14269,37520,5778,72,25652,25652,18850,10878,10645
75481,18488,20973,48342,27139,9.34164e+12,59.4104,25458.3,75481,10217,72,54508,54508,51548,50857,46717
40207,8959,11482,25701,14506,9.23473e+12,59.2308,14117.9,40207,5588,72,28725,28725,26226,23277,23386
88094,4555,5338,70090,18004,5.74402e+13,12.0014,6314.77,88094,2850,20,82756,82756,76311,71004,79854
20813,4841,4941,13492,7321,9.86134e+12,59.8277,6576.79,20813,2393,72,15872,15872,15807,15744,15832
69480,14310,21328,44140,25340,8.94761e+12,58.9358,25374,69480,10376,72,48152,48152,43588,39310,38180
94278,22022,26889,60256,34022,9.23167e+12,59.3007,32269.6,94278,13093,72,67389,67389,62747,56480,55045
68683,25490,26113,42751,25932,8.00982e+12,57.7676,29757.9,68683,12713,72,42570,42570,41836,40913,40756
22843,1163,5969,14706,8137,9.54416e+12,59.4999,7688.69,22843,2894,72,16874,16874,10974,10840,3846
36970,7962,8617,23978,12992,9.9052e+12,60.0418,11225.6,36970,4186,72,28353,28353,27573,27394,26420
13489,2272,4498,8524,4965,8.64943e+12,58.1924,5551.68,13489,2184,72,8991,8991,7656,5796,5586
4283,841,1102,2778,1505,9.74301e+12,58.5816,1588.68,4283,531,68,3181,3181,2879,2561,2541
76324,10702,17772,49492,26832,9.9099e+12,60.1222,22540.6,76324,8657,72,58552,58552,48285,48073,35744
43296,2188,10057,28086,15210,9.92639e+12,60.0707,13023.8,43296,4895,72,33239,33239,21775,21543,7765
30018,1687,7032,19472,10546,9.90107e+12,59.9873,9230.34,30018,3419,72,22986,22986,15288,15122,5933
71242,13668,16609,46187,25055,9.8997e+12,60.0531,21109.6,71242,8077,72,54633,54633,50412,50321,45353
79505,5029,18436,51568,27937,9.91868e+12,60.135,23382,79505,8975,72,61069,61069,41483,41095,17390
67551,7763,15705,43802,23749,9.90908e+12,60.1097,20008.9,67551,7642,72,51846,51846,40304,29211,26171
57927,11688,13460,37574,20353,9.90879e+12,60.1021,17243.7,57927,6546,72,44467,44467,41864,41819,38825
66200,1965,15393,42925,23275,9.92239e+12,60.1205,19620.6,66200,7499,72,50807,50807,31191,30802,7062
19493,6627,7661,12094,7399,7.86381e+12,55.4925,8965.44,19493,3710,72,11832,11832,11480,11070,11276
85962,25126,28341,54269,31693,8.65857e+12,58.5264,33045.3,85962,13804,72,57621,57621,56415,54858,54555
58293,22506,26554,35503,22790,7.04155e+12,56.033,29413.9,58293,12931,72,31739,31739,29141,26173,26151
78190,15070,18194,50703,27487,9.91128e+12,60.1228,23065.1,78190,8856,72,59996,59996,56276,51236,50100
19378,9346,19378,0,19378,7.99959,0,19378,19378,19378,1,0,0,0,0,0
65913,8267,34074,39439,26474,6.23635e+12,55.138,36939.4,65913,16582,72,31839,31839,21546,13800,11365
48323,1948,11259,31334,16989,9.92751e+12,60.0872,14503.5,48323,5485,72,37064,37064,16339,16822,7053
77484,10997,40803,46222,31262,6.11106e+12,55.2804,44025.9,77484,19859,72,36681,36681,24892,13749,10771
43088,11521,16133,26872,16216,8.08381e+12,57.7994,18633.5,43088,7849,72,26955,26955,23454,20077,19355
17655,4509,5215,11264,6391,9.14056e+12,57.9255,6566.95,17655,2522,72,12440,12440,12021,11642,11763
93239,18639,28704,59217,34022,8.93725e+12,58.4929,33890.7,93239,13969,72,64535,64535,56501,54497,42943
63099,415,15845,40712,22387,9.66354e+12,59.7995,19825.9,63099,7704,72,47254,47123,14493,14455,2080
26677,2930,6190,17297,9380,9.94903e+12,60.0376,8193.38,26677,3015,72,20487,20487,15767,15666,10120
21279,4687,7442,13368,7911,8.4442e+12,58.0756,8908.27,21279,3621,72,13837,13837,12372,10473,10085
15139,7421,7569,11827,3312,78764500000,8.98309,7819.78,15139,6807,11,7570,7570,7457,7469,7461
33479,5831,13251,20742,12737,7.83023e+12,56.5208,15234.2,33479,6449,72,20228,20228,15745,10264,8969
82601,8193,19213,53568,29033,9.90781e+12,60.1203,24318.5,82601,9347,72,63388,63388,47380,47055,27724
90876,12444,29151,57512,33364,8.77138e+12,58.7379,34144.1,90876,14195,72,61725,61725,44860,28363,23866
72739,17072,24537,45832,26907,8.5622e+12,58.4632,28583.4,72739,11952,72,48202,48202,41444,33559,33308
67895,486,43985,53246,14649,2.23301e+13,5.52639,50409.7,67895,14659,13,23910,23910,4904,9616,3309
67302,23655,34746,40271,27031,6.25091e+12,54.9371,37668.4,67302,16904,72,32556,32556,27285,20016,18494
28070,5244,10792,17464,10606,7.94904e+12,56.9541,12543.7,28070,5235,72,17278,17278,13758,10423,9619
93201,4601,38215,57512,35689,7.62054e+12,57.292,42741.1,93201,18611,72,54986,54986,33090,8236,6484
50209,1822,11689,32553,17656,9.90546e+12,60.0858,15045.5,50209,5685,72,38520,38520,16115,16680,6439
54378,7438,12640,35269,19109,9.92103e+12,60.108,16225,54378,6155,72,41738,41738,34136,33988,24899
46785,5351,17919,29099,17686,7.97279e+12,57.3856,20566.9,46785,8708,72,28866,28866,18311,10498,8014
22262,4094,5253,14429,7833,9.92002e+12,59.916,6976.48,22262,2559,72,17009,17009,15687,15366,13643
72587,6690,16854,47080,25507,9.91758e+12,60.1349,21429.1,72587,8209,72,55733,55733,39431,37992,22856
62745,17826,23772,39077,23668,8.02367e+12,57.7838,27158.7,62745,11572,72,38973,38973,34095,28404,28275
42645,8443,15930,26596,16049,8.09443e+12,57.8248,18411.1,42645,7755,72,26715,26715,17623,17429,6601
2570,371,924,1622,948,8.5607e+12,55.935,1224.09,2570,446,59,1646,1636,1136,1102,788
54868,10741,12760,35581,19287,9.91281e+12,60.0854,16374.1,54868,6203,72,42108,42108,39750,39188,35909
78534,20544,27568,49283,29251,8.39295e+12,58.244,31805.4,78534,13430,72,50966,50966,44686,37372,37146
67144,11930,23368,42171,24973,8.42173e+12,57.9634,27104.1,67144,11365,72,43776,43776,37006,27788,25631
15788,1475,3732,10241,5547,9.88929e+12,59.7477,5050.58,15788,1808,72,12056,12056,8381,8036,4800
34514,4919,8805,22253,12261,9.62303e+12,59.69,11214.3,34514,4282,72,25709,25709,20699,20580,14678
68062,14846,21245,43184,24878,8.88373e+12,58.8483,25193.7,68062,10344,72,46817,46817,41008,35498,34046
11801,3554,7653,9255,2546,2.23285e+13,5.49809,8804.16,11801,2556,13,4148,4148,3500,3786,2216
9720,488,2330,6298,3422,9.98652e+12,59.562,3233.06,9720,1134,72,7390,7390,3578,3573,1729
35829,7456,8358,23244,12585,9.91153e+12,60.0327,10898.1,35829,4065,72,27471,27471,26381,26134,24717
43569,1718,10128,28260,15309,9.92299e+12,60.0733,13110.7,43569,4930,72,33441,33441,21186,14278,6185
55927,9865,17006,35565,20362,8.9841e+12,58.9596,20391.7,55927,8272,72,38921,38921,31177,22019,21858
87348,23182,27777,55314,32034,8.81358e+12,58.777,32619.5,87348,13525,72,59571,59571,56559,52524,51639
57453,8112,13977,37148,20305,9.77313e+12,59.9298,17686.4,57453,6803,72,43476,43476,37369,29068,27137
30190,5730,7008,19586,10604,9.94327e+12,60.0407,9218.12,30190,3413,72,23182,23182,21625,19577,19174
44808,6943,11844,28804,16004,9.50296e+12,59.5709,14793.9,44808,5760,72,32964,32964,27688,20515,18864
72068,21329,24697,45328,26740,8.48452e+12,58.0153,28687,72068,12017,72,47371,47371,45229,42353,41735
85790,4149,19924,55626,30164,9.91504e+12,60.1391,25201.6,85790,9703,72,65866,65866,31797,32220,14580
25126,2349,6932,16107,9019,9.39943e+12,59.3137,8751.25,25126,3375,72,18194,18194,12407,7853,6650
56062,2549,15362,35940,20122,9.38757e+12,59.4539,18873.8,56062,7483,72,40700,40700,20277,18090,6657
92919,31882,41602,56726,36193,7.13052e+12,56.7207,45870.8,92919,20261,72,51317,51317,48782,45275,44666
29840,8396,14549,18016,11824,6.62138e+12,55.9599,16140.2,29840,7075,72,15291,15291,13140,10152,9670
51901,9734,18103,32588,19313,8.41212e+12,58.2368,21113.9,51901,8812,72,33798,33798,33216,32387,32429
18936,4719,5964,12004,6932,8.89688e+12,58.6455,7360.4,18936,2901,72,12972,12972,11414,9928,9751
56901,324,16143,36393,20508,9.25927e+12,59.2889,19658.2,56901,7860,72,40758,40422,13517,686,1241
10253,4751,5294,6145,4108,6.36748e+12,55.1847,5965.53,10253,2574,72,4959,4959,4739,4498,4681
24199,942,8430,15200,8999,8.44588e+12,58.1619,10059.8,24199,4102,72,15769,15674,10129,4343,3391
66542,9587,27995,40942,25600,7.49952e+12,57.1296,31346.9,66542,13638,72,38547,38547,23660,14632,11523
81043,7185,42999,63470,17573,79545300000,8.98867,43569.4,81043,38692,11,38044,38044,13073,15429,10735
83250,16743,26471,52721,30529,8.81775e+12,58.7798,31117.1,83250,12895,72,56779,56779,48257,36521,33927
98626,6576,35023,61826,36800,8.32396e+12,58.1915,40144.8,98626,17055,72,63603,63555,31229,14587,7948
51150,13420,13846,32825,18325,9.42343e+12,59.2534,17115.1,51150,6728,72,37304,37304,37091,36938,36976
55281,23708,24142,33854,21427,7.27897e+12,56.7093,26957.7,55281,11747,72,31139,31139,30534,29898,29949
1635,203,427,1054,581,1.00688e+13,56.9498,668.663,1635,203,52,1208,1208,890,599,686
56877,2787,13265,36873,20004,9.91191e+12,60.0992,16986.4,56877,6456,72,43612,43612,28378,19301,9696
39144,6855,15393,24271,14873,7.85377e+12,57.3506,17648.5,39144,7499,72,23751,23751,18459,12267,12236
46677,11545,15566,29441,17236,8.61155e+12,58.1042,18381.1,46677,7561,72,31111,31111,28528,24955,24329
2348,453,597,1520,828,9.91448e+12,57.7538,912.071,2348,285,58,1751,1751,1585,1456,1469
11171,958,3983,7004,4167,8.38542e+12,57.8098,4873.06,11171,1936,72,7188,7188,4368,2447,1091
62677,1865,14541,40655,22022,9.92772e+12,60.1188,18582,62677,7079,72,48136,48136,18566,7319,6894
74223,11313,17231,48134,26089,9.91324e+12,60.1306,21897.1,74223,8381,72,56992,56992,49838,48176,37797
29922,3549,6958,19419,10503,9.91413e+12,60.0093,9155.85,29922,3379,72,22964,22964,18889,13377,12127
36008,859,8400,23359,12649,9.90956e+12,60.0289,10950.1,36008,4084,72,27608,27608,16650,16428,3255
33280,17240,17733,19821,13459,6.07294e+12,55.2773,19338.7,33280,8639,72,15547,15547,15280,15031,15171
75208,1968,36858,45348,29860,6.59023e+12,56.0436,40201.9,75208,17955,72,38350,38350,18778,6662,2455
58289,188,13521,37797,20492,9.92507e+12,60.1238,17323,58289,6587,72,44768,44768,11249,698,1339
65182,433,30646,39533,25649,6.84614e+12,56.0223,33714.1,65182,14908,72,34536,33605,19260,10561,33
15006,445,4231,9607,5399,9.30724e+12,59.088,5442.87,15006,2054,72,10775,10727,5345,2701,1661
89968,2672,20931,58331,31637,9.91366e+12,60.136,26421.3,89968,10197,72,69037,69037,26653,10354,9699
56848,4673,24909,34795,22053,7.27044e+12,56.8437,27779.6,56848,12135,72,31939,31939,20095,17446,6116
95551,20421,34125,59857,35694,8.30649e+12,58.1628,39094.6,95551,16624,72,61426,61426,48498,33314,32735
9521,2264,2289,6168,3353,9.95721e+12,59.5656,3178.04,9521,1115,72,7232,7232,7208,7208,7219
14150,809,3352,9178,4972,9.87061e+12,59.7536,4566.54,14150,1623,72,10798,10798,7161,4944,2843
15579,3082,4123,10020,5559,9.56574e+12,59.37,5387.5,15579,2007,72,11456,11456,10278,8756,8482
31951,2858,13968,19574,12377,7.28969e+12,56.7987,15773.5,31951,6803,72,17983,17935,13476,8235,8086
51200,6126,13446,32924,18276,9.53063e+12,59.6276,16746,51200,6549,72,37754,37754,28724,28499,17793
67601,14283,29543,41401,26200,7.27511e+12,56.8702,32863,67601,14384,72,38058,38058,29292,18999,18787
24963,8841,9339,15569,9394,8.09671e+12,57.7273,10953.8,24963,4544,72,15624,15624,15268,14755,14880
35746,2406,14346,22119,13627,7.76629e+12,57.371,16418.2,35746,6988,72,21400,21352,14449,14018,8360
55055,15406,18199,34753,20302,8.6418e+12,58.5261,21432.3,55055,8858,72,36856,36856,34452,31114,30553
72354,17195,24971,45480,26874,8.45104e+12,58.3235,28961.2,72354,12150,72,47383,47383,42166,35077,33433
46511,15003,24652,27720,18791,6.0789e+12,54.3734,26765.8,46511,11993,72,21859,21859,18338,14239,14297
94809,21968,21984,61484,33325,9.9165e+12,60.1467,27736.5,94809,10700,72,72825,72825,72825,72825,72825
77917,23546,27912,48793,29124,8.29201e+12,58.1274,32085.7,77917,13593,72,50005,50005,47785,44808,44171
40842,1938,13861,25713,15129,8.54892e+12,58.3688,16365.3,40842,6747,72,26981,26981,12426,5852,3069
82922,8488,19271,53767,29155,9.91391e+12,60.1355,24394.7,82922,9382,72,63651,63651,48178,46122,28726
16775,3533,5214,10657,6118,8.93497e+12,58.6278,6490.74,16775,2534,72,11561,11561,10510,10249,8923
61337,4024,18665,39000,22337,8.98307e+12,58.963,22317.6,61337,9088,72,42672,42672,27970,27602,9973
30322,5992,7106,19666,10656,9.88626e+12,59.9806,9323.87,30322,3451,72,23216,23216,21594,21564,19763
49657,2326,15875,31449,18208,8.79216e+12,58.7049,18884.1,49657,7729,72,33782,33782,15970,8095,4568
52054,21663,22150,31984,20070,7.42748e+12,56.655,24873.7,52054,10774,72,29904,29904,29822,29814,29810
93844,12819,21776,60865,32979,9.90966e+12,60.1397,27477.8,93844,10594,72,72068,72068,61268,58752,43010
32182,5781,13699,19787,12395,7.42721e+12,56.9595,15546,32182,6667,72,18483,18435,11627,5030,3380
16383,2108,3853,10622,5761,9.96242e+12,59.868,5209.41,16383,1875,72,12530,12530,10482,7778,7207
63001,14228,27073,38670,24331,7.37147e+12,56.9824,30239,63001,13187,72,35928,35928,29477,21958,21820
12561,1151,2983,8143,4418,9.89841e+12,59.7013,4088.82,12561,1447,72,9578,9578,6592,6401,3963
47458,1244,21282,28977,18481,7.13006e+12,56.3608,23722.8,47458,10356,72,26176,26124,16021,7500,3888
40006,7885,9305,25948,14058,9.91974e+12,60.0628,12086.5,40006,4527,72,30701,30701,28600,26648,26192
51807,8975,26202,31090,20717,6.39176e+12,55.7561,28601.9,51807,12762,72,25605,25605,18077,11122,9289
48130,4358,13954,30724,17406,9.19181e+12,59.1829,16988.3,48130,6796,72,34176,34176,21389,12530,10407
29484,2589,6891,19111,10373,9.92137e+12,60.0227,9057.68,29484,3357,72,22593,22593,16319,11549,8733
67779,12834,15774,43958,23821,9.90095e+12,60.1049,20090,67779,7672,72,52005,52005,47785,43769,42742
3535,799,873,2302,1233,9.87778e+12,58.4184,1300.18,3535,417,64,2662,2662,2594,2579,2571
87719,8770,43735,68521,19198,78746500000,8.99694,44351.9,87719,39357,11,43984,43984,17400,20433,14382
20116,7325,7898,12484,7632,7.87429e+12,57.3955,9231.93,20116,3840,72,12218,12218,11517,10685,10887
69775,24961,38320,54725,15050,79944800000,8.98429,38834.6,69775,34482,11,31455,31455,22690,23386,22012
28895,9848,12734,17685,11210,7.25013e+12,55.7287,14393.9,28895,6187,72,16161,16161,14559,12452,12012
65636,19290,27645,40371,25265,7.47358e+12,57.116,30963.6,65636,13456,72,37991,37991,34589,29953,28976
81431,14293,22727,52132,29299,9.30769e+12,56.4494,27512.2,81431,11058,72,58704,58704,46422,34651,31374
80145,11489,23432,51127,29018,9.14525e+12,59.1764,28073.9,80145,11410,72,56713,56713,45332,42606,26091
82537,5930,19193,53524,29013,9.90529e+12,60.1263,24297.9,82537,9336,72,63344,63344,38101,23067,20172
63267,9903,15389,40910,22357,9.77237e+12,59.9474,19416.1,63267,7489,72,47878,47878,40312,33103,31126
29263,7921,12819,17922,11341,7.29471e+12,56.7421,14498.9,29263,6239,72,16444,16396,11207,11096,4944
14026,2182,3314,9098,4928,9.95674e+12,59.8014,4516.24,14026,1614,72,10712,10712,9423,9109,7430
28562,4482,11844,17606,10956,7.57342e+12,57.0994,13547.7,28562,5761,72,16718,16718,12102,6748,6631
10802,1247,3496,6845,3957,8.82924e+12,57.8709,4394.78,10802,1686,72,7306,7306,4174,2518,2084
8033,1242,1899,5216,2817,9.9477e+12,59.4066,2686.16,8033,915,72,6134,6134,5199,5181,4212
14670,578,993,11694,2976,5.70451e+13,11.987,1380.21,14670,604,14,13677,13677,11093,9425,12511
60387,19085,25418,37148,23239,7.48379e+12,56.8304,28515.7,60387,12375,72,34969,34969,31638,27851,27765
6139,306,1847,3918,2221,9.15529e+12,58.3101,2453.18,6139,895,72,4292,4244,2606,768,757
30187,2763,7051,19567,10620,9.93003e+12,60.0312,9260.35,30187,3434,72,23136,23136,16329,15731,9592
72644,2985,16928,47108,25536,9.90978e+12,60.1184,21500.8,72644,8245,72,55716,55716,24709,25381,10501
51868,10642,14727,33172,18696,9.26003e+12,58.5811,17980.4,51868,7158,72,37141,37141,33550,32676,27629
84957,21731,25307,54115,30842,9.07166e+12,59.0852,30152.6,84957,12326,72,59650,59650,56106,52719,51986
71843,16808,22231,45622,26221,8.91797e+12,58.899,26378.1,71843,10825,72,49612,49612,45132,44989,39849
62074,3239,26859,38058,24016,7.34425e+12,56.8946,29968.7,62074,13085,72,35215,35215,17452,7902,4317
18949,7264,10014,14838,4111,79440400000,8.99061,10286.1,18949,9010,11,8935,8935,7147,7284,7029
19538,82,4564,12673,6865,9.93761e+12,59.9436,6127.5,19538,2223,72,14974,12572,8438,8307,529
67373,15056,20501,42842,24531,8.98306e+12,58.86,24454.2,67373,9973,72,46872,46872,42567,37506,37458
96400,12828,35416,60206,36194,8.17012e+12,57.95,40357.2,96400,17248,72,60984,60984,40202,24843,19868
22446,3067,9192,13862,8584,7.66396e+12,57.1581,10611.1,22446,4474,72,13254,13254,10072,6337,6414
37664,6664,11603,23927,13737,8.94255e+12,58.8496,14034.3,37664,5647,72,26061,26061,20806,14658,14511
4649,506,1120,3019,1630,9.89253e+12,58.9946,1647.28,4649,535,71,3529,3529,2700,1883,1728
92838,21075,27018,59245,33593,9.15472e+12,59.2054,32290.6,92838,13157,72,65820,65820,60701,54677,54650
60776,17863,21264,38161,22615,8.40725e+12,58.2181,24689,60776,10342,72,39512,39512,37457,34610,34160
40595,14575,16829,25034,15561,7.56622e+12,56.7902,19088,40595,8178,72,23766,23766,22287,20232,19974
67428,10521,15906,43679,23749,9.87644e+12,60.0749,20187.3,67428,7747,72,51522,51522,45001,43486,34068
55360,317,12868,35900,19460,9.90938e+12,60.0908,16510.2,55360,6255,72,42492,42492,24205,15541,1716
22011,1758,8022,13760,8251,8.24094e+12,57.8933,9504.06,22011,3908,72,13989,13989,8262,4147,2862
30091,4422,12847,18485,11606,7.41492e+12,55.7747,14597.8,30091,6236,72,17244,17244,12700,7518,6238
19739,3240,4902,12755,6984,9.72896e+12,59.659,6452.17,19739,2384,72,14837,14837,12507,12450,9824
90366,612,39457,55342,35024,7.28004e+12,56.8907,43691,90366,19218,72,50909,49709,22605,7623,1798
94636,18547,39034,58356,36280,7.59493e+12,57.2829,43598.3,94636,19016,72,55602,55602,41399,24224,19899
15580,1924,3689,10106,5474,9.8757e+12,59.7669,4995.41,15580,1784,72,11891,11891,9307,9260,6271
86527,23232,29458,54457,32070,8.51674e+12,58.4179,34125.2,86527,14345,72,57069,57069,52105,45256,43847
89826,2516,48648,53337,36489,5.92235e+12,54.9508,52195.7,89826,23692,72,41178,41178,18796,3417,1725
63455,677,14777,41148,22307,9.90448e+12,60.1045,18860.2,63455,7186,72,48678,48678,13982,15742,2989
75138,9393,32141,46131,29007,7.38977e+12,56.8162,35820.7,75138,15644,72,42997,42997,30193,15171,14752
68247,1935,19790,43574,24673,9.17156e+12,59.1984,23855.3,68247,9632,72,48457,48457,19475,17731,4150
88241,8729,35850,54518,33723,7.66294e+12,57.3694,40193.7,88241,17453,72,52391,52391,34124,12631,11930
51784,18480,21750,31871,19913,7.49913e+12,57.11,24479.9,51784,10591,72,30034,30034,27774,25620,25249
68936,5803,16017,44701,24235,9.92188e+12,60.1263,20393.3,68936,7803,72,52919,52919,35224,34202,19900
78349,11892,18222,50803,27546,9.91283e+12,60.1314,23104.2,78349,8871,72,60127,60127,52539,50762,39766
9563,980,2229,6207,3356,9.97368e+12,59.7355,3134.14,9563,1083,72,7334,7334,5523,5265,3406
35892,6407,8427,23260,12632,9.8902e+12,60.0141,10966.9,35892,4100,72,27465,27465,24601,24534,21255
84442,33905,34726,52092,32350,7.60422e+12,57.2978,38882.3,84442,16910,72,49716,49716,49055,48124,48141
93616,19168,22608,60547,33069,9.79577e+12,59.9982,28236.6,93616,11014,72,71008,71008,67132,61888,60704
16238,3394,3834,10537,5701,9.89488e+12,59.8178,5184.71,16238,1860,72,12404,12404,11882,11767,11194
42768,19172,19237,26102,16666,7.12189e+12,56.6328,21476.5,42768,9368,72,23531,23531,23459,23459,23450
45800,3910,14418,29033,16767,8.85089e+12,58.7746,17251.7,45800,7013,72,31382,31382,18453,11556,8852
96859,3971,4068,76674,20185,5.85675e+13,12.0013,5102.58,96859,3238,19,92791,92791,91975,91427,92408
31353,4206,10907,19708,11645,8.42043e+12,56.4904,12909.8,31353,5291,72,20446,20446,15267,9231,9082
7571,1175,1790,4918,2653,9.89913e+12,59.4537,2547.46,7571,863,72,5781,5781,4895,4879,3972
18895,3820,4427,12254,6641,9.91551e+12,59.9036,5949.67,18895,2149,72,14468,14468,13602,12643,12718
64280,6359,14954,41682,22598,9.90983e+12,60.1216,19083.7,64280,7279,72,49326,49326,36802,26313,21462
9651,757,9022,6638,3013,9.22703e+12,3.97565,9068.32,9651,3026,9,629,629,49,629,56
31456,4743,11649,19630,11826,8.15785e+12,57.8628,13598.6,31456,5675,72,19807,19807,14164,7553,7502
26970,110,1136,21351,5619,5.85506e+13,11.9922,1672.54,26970,1132,13,25834,25834,16626,8471,21736
47346,2812,23205,36960,10386,78540500000,8.98921,23659.9,47346,20877,11,24141,24141,7975,9965,6001
64469,16451,19373,41032,23437,9.03533e+12,58.1049,23203.2,64469,9415,72,45096,45096,42196,38834,38802
91365,6440,23599,58832,32533,9.58184e+12,59.73,29004.9,91365,11495,72,67766,67766,37947,37448,18091
55432,9090,12877,35946,19486,9.92445e+12,60.1076,16522,55432,6266,72,42555,42555,38001,36937,30430
6568,1293,1626,4252,2316,9.81125e+12,59.1468,2296.27,6568,787,72,4942,4942,4497,4467,4202
8630,421,2039,5611,3019,9.90149e+12,59.5229,2873.46,8630,985,72,6591,6591,4214,2852,1452
2006,198,1266,1170,836,5.09473e+12,51.3893,1436.15,2006,610,50,740,692,414,294,431
62775,8473,14720,40696,22079,9.88513e+12,60.0743,18757.2,62775,7161,72,48055,48055,38911,38735,27747
86419,9402,35349,53341,33078,7.63232e+12,57.2261,39599.9,86419,17206,72,51070,51070,35135,17520,13054
65247,1692,15175,42305,22942,9.91942e+12,60.1176,19353.4,65247,7387,72,50072,50072,30368,29980,6142
65252,6846,15198,42317,22935,9.90154e+12,60.0935,19375.2,65252,7389,72,50054,50054,37904,27259,23007
91741,20537,21360,59491,32250,9.90318e+12,60.119,26945.2,91741,10393,72,70381,70381,69404,69177,67897
47614,8689,47614,0,47614,7.99983,0,47614,47614,47614,1,0,0,0,0,0
36727,11525,13029,23026,13701,8.34747e+12,52.8856,15284.4,36727,6341,72,23698,23698,22766,21575,21372
82772,19765,25533,52564,30208,8.93729e+12,58.9208,30210,82772,12437,72,57239,57239,50265,48645,38535
18270,284,4295,11852,6418,9.8822e+12,59.8574,5777.75,18270,2081,72,13975,13975,8157,5320,1117
85820,15657,24269,54880,30940,9.26816e+12,58.8981,29248.4,85820,11817,72,61551,61551,51857,40385,40123
33667,7891,18046,26377,7290,79658500000,8.97692,18407.8,33667,16237,11,15621,15621,8687,9305,8087
19968,1999,8409,12293,7675,7.50619e+12,56.9307,9686.04,19968,4091,72,11559,11559,7883,3592,3640
55467,5591,15488,35520,19947,9.30432e+12,59.3534,18950,55467,7534,72,39979,39979,26539,17152,14130
76858,11872,17891,49836,27022,9.90574e+12,60.1239,22694.5,76858,8704,72,58967,58967,50279,50094,39698
63333,10738,14681,41079,22254,9.92348e+12,60.1244,18760.6,63333,7146,72,48652,48652,43904,42798,36007
63486,19621,26919,39024,24462,7.44048e+12,57.0572,30132.6,63486,13100,72,36567,36567,32994,28159,27056
88757,16545,26768,56471,32286,9.0191e+12,59.0439,31780.2,88757,13034,72,61989,61989,47313,29957,29320
93124,3920,30769,58781,34343,8.65098e+12,58.0676,35802.9,93124,14973,72,62355,62355,37810,11846,7636
22230,535,5191,14427,7803,9.92193e+12,59.9434,6921.05,22230,2525,72,17039,17039,10248,10114,2019
57160,11012,16654,36482,20678,9.14788e+12,59.1677,20154,57160,8106,72,40506,40506,35859,34723,28134
78541,11721,28051,49204,29337,8.30559e+12,58.1525,32260,78541,13663,72,50490,50490,39752,28943,26157
33544,6856,7836,21757,11787,9.91813e+12,60.0203,10241.4,33544,3813,72,25708,25708,24608,23173,22932
17597,7242,10196,13833,3764,8.0668e+10,8.92925,10435.7,17597,9175,11,7401,7401,5799,5840,5774
30298,1626,7086,19642,10656,9.92179e+12,60.0074,9298.72,30298,3452,72,23212,23212,15232,15076,5532
48088,15599,25348,28686,19402,6.12735e+12,55.4107,27525.7,48088,12348,72,22740,22740,17838,12183,12080
72930,1335,4047,57943,14987,5.77563e+13,12.0018,4937.72,72930,2019,20,68883,68883,48510,32490,54930
66928,26244,42674,38617,28311,4.68267e+12,52.72,44972.5,66928,20767,72,24254,24254,20580,17186,16432
79347,8050,21852,50851,28496,9.3589e+12,59.4531,26552.4,79347,10640,72,57495,57495,41019,27552,20827
32033,372,9933,20342,11691,8.92389e+12,58.6048,12060.9,32033,4835,72,22100,21869,7099,3983,1524
34846,3728,18774,20713,14133,5.96338e+12,54.9895,20429.4,34846,9131,72,16072,16072,10320,3610,3554
33765,6185,13734,20865,12900,7.66751e+12,56.4805,15705.2,33765,6668,72,20031,20031,14682,9619,8295
18551,2220,4356,12031,6520,9.93089e+12,59.8774,5852.38,18551,2118,72,14195,14195,11574,10973,7308
93235,7698,41484,56971,36264,7.16719e+12,56.5312,45781.6,93235,20189,72,51751,51751,35707,17112,16385
87514,22669,40197,53246,34268,6.98537e+12,56.5199,44179,87514,19580,72,47317,47317,37372,23672,20599
97097,1692,22507,62982,34115,9.91966e+12,60.1501,28378.4,97097,10960,72,74590,74590,24176,6647,6731
72642,3135,19064,46723,25919,9.53486e+12,59.6498,23485.3,72642,9285,72,53578,53578,24669,24029,9282
48800,12532,16944,30665,18135,8.44622e+12,58.2714,19809.9,48800,8248,72,31856,31856,28469,23897,22863
2693,499,729,1732,961,9.80195e+12,57.7794,1070.29,2693,355,60,1964,1964,1703,1431,1434
79745,21919,36700,48514,31231,6.97355e+12,56.2805,40380.5,79745,17860,72,43045,43045,36955,28645,26757
96132,4129,22353,62345,33787,9.90847e+12,60.1407,28171.2,96132,10885,72,73779,73779,47256,46718,14576
44283,25098,44283,0,44283,7.99982,0,44283,44283,44283,1,0,0,0,0,0
24213,1628,5643,15706,8507,9.9185e+12,59.9343,7494.56,24213,2740,72,18570,18570,10662,6434,5724
92472,16473,59902,72512,19960,2.23327e+13,5.53039,68622.4,92472,19962,13,32570,32570,24850,25173,12004
76201,14910,20249,48973,27228,9.4772e+12,59.5925,24841.8,76201,9853,72,55952,55952,50417,42894,41138
4175,590,1014,2708,1467,9.89398e+12,58.6424,1499.18,4175,479,68,3161,3161,2573,2561,2019
95907,12586,26570,61433,34474,9.33533e+12,59.4335,32083.2,95907,12939,72,69337,69337,54029,35996,35322
32247,4063,13618,19831,12416,7.47384e+12,57.0214,15475.9,32247,6629,72,18629,18629,12874,7515,6076
48959,4442,16017,30933,18026,8.69718e+12,58.5719,18962.1,48959,7794,72,32942,32942,20878,12951,10245
33065,5821,7712,21440,11625,9.94125e+12,60.0327,10087.8,33065,3757,72,25353,25353,23124,22597,19529
70210,10316,30642,42998,27212,7.28772e+12,56.8852,34068.1,70210,14927,72,39568,39568,26687,14420,11139
77268,1143,25808,48720,28548,8.61131e+12,58.5183,30080.4,77268,12572,72,51460,51460,29364,14400,2350
36951,10422,19189,28912,8039,79239800000,8.96801,19576.9,36951,17262,11,17762,17762,12009,12466,11572
15881,3069,4200,10219,5662,9.54506e+12,59.3237,5485.71,15881,2035,72,11681,11681,10049,10019,8207
74596,20754,32587,45673,28923,7.2835e+12,56.8698,36192.6,74596,15869,72,42009,42009,32908,22280,21894
81878,9674,19039,53088,28790,9.90864e+12,60.1237,24107.8,81878,9269,72,62839,62839,51530,48898,32391
27897,9147,9885,17500,10397,8.36424e+12,58.0686,11692.3,27897,4809,72,18012,18012,17063,16223,16066
92289,34248,38812,56789,35500,7.48363e+12,56.6025,43230.1,92289,18888,72,53477,53477,51953,50175,50335
61897,14189,16474,39775,22122,9.47511e+12,59.5624,20324,61897,8014,72,45423,45423,42351,39433,38728
66164,6093,36644,39151,27013,5.76635e+12,54.0823,39341.1,66164,17830,72,29520,29520,18613,5898,5578
20629,2564,4831,13384,7245,9.9214e+12,59.9124,6460.89,20629,2349,72,15798,15798,12553,12480,8735
33171,4221,15732,20102,13069,6.79512e+12,56.1746,17495,33171,7652,72,17439,17439,11839,6402,4934
57207,11402,19300,36031,21176,8.56462e+12,58.4459,22610,57207,9399,72,37907,37907,35895,33960,33655
84059,19552,45145,49982,34077,5.97749e+12,54.6976,48530.5,84059,21978,72,38914,38914,30049,19660,17052
33884,1578,9776,21641,12243,9.19867e+12,58.4951,12064.1,33884,4740,72,24108,24108,12390,11586,5143
30220,4826,7063,19597,10623,9.91928e+12,60.0167,9274,30220,3439,72,23157,23157,20517,19889,16198
34666,911,8629,22390,12276,9.71574e+12,59.8,11059.8,34666,4200,72,26037,26037,15843,15602,3403
2201,244,558,1426,775,1.0059e+13,57.5879,859.773,2201,265,57,1643,1643,1189,751,825
67792,17841,29304,41571,26221,7.3363e+12,56.9474,32657.6,67792,14270,72,38488,38488,35284,30861,30034
2708,571,745,1741,967,9.43684e+12,57.2474,1089.17,2708,348,58,1963,1963,1784,1619,1611
78348,15923,25829,49457,28891,8.65222e+12,58.0885,30181.8,78348,12569,72,52519,52519,44468,34962,34786
56619,7221,15861,36240,20379,9.31519e+12,59.3539,19372.7,56619,7727,72,40758,40758,30672,30413,18446
93261,7031,39366,57359,35902,7.46946e+12,56.8874,43812.2,93261,19161,72,53895,53895,34862,12493,11753
61635,11652,22669,38506,23129,8.17044e+12,57.9665,26055.5,61635,11040,72,38966,38966,29221,15911,12763
64987,10524,22696,40801,24186,8.41286e+12,58.2677,26321.7,64987,11057,72,42291,42291,32752,21572,21183
11733,2774,4559,7290,4443,7.98354e+12,57.3278,5446.6,11733,2221,72,7174,7174,5652,3544,3279
71959,13488,16719,46667,25292,9.91743e+12,60.1213,21257.8,71959,8142,72,55240,55240,51379,46162,44981
91153,40857,42078,55427,35726,6.95101e+12,56.4942,46187.2,91153,20493,72,49075,49075,48492,48008,47972
30405,3148,11775,18896,11509,7.95416e+12,57.5737,13629.5,30405,5736,72,18630,18630,11990,4176,4071
41502,10031,12494,26418,15084,9.02874e+12,58.4618,15152,41502,6064,72,29008,29008,26554,25991,22552
95867,26173,26975,61333,34534,9.28e+12,59.2079,32460.5,95867,13128,72,68892,68892,68414,68270,67794
24712,3673,5749,16031,8681,9.92483e+12,60.0117,7636.64,24712,2795,72,18963,18963,15944,15871,12438
65705,3474,28158,40330,25375,7.3878e+12,56.8124,31443.5,65705,13711,72,37547,37547,22496,9291,5569
99676,30779,44832,60810,38866,7.10843e+12,56.6879,49343.9,99676,21835,72,54844,54844,47058,38031,37729
85601,3249,5615,68201,17400,5.71352e+13,12.0013,6575.2,85601,2577,20,79986,79986,64800,53731,73120
93683,33234,35780,58277,35406,7.98132e+12,57.7719,40510.1,93683,17425,72,57903,57903,55747,52877,52263
3649,425,885,2361,1288,9.95799e+12,58.6955,1324.96,3649,428,64,2764,2764,2210,2093,1499
6014,710,1485,3887,2127,9.9113e+12,59.1713,2114.8,6014,717,72,4529,4529,3500,2577,2444
43801,16029,16721,27247,16554,8.01017e+12,57.7158,19229,43801,8145,72,27080,27080,26062,24935,25006
17532,5767,6977,10859,6673,7.80447e+12,57.2695,8169.35,17532,3391,72,10555,10555,10106,9567,9519
88006,17173,20439,57073,30933,9.90901e+12,60.1353,25834.1,88006,9944,72,67567,67567,62862,58386,57211
15683,2592,4334,10056,5627,9.36732e+12,59.1219,5594.7,15683,2096,72,11349,11349,9237,8754,5816
53030,8635,12346,34395,18635,9.90846e+12,60.0805,15856.3,53030,6003,72,40684,40684,35315,30204,28835
55814,12113,12961,36199,19615,9.91767e+12,60.1193,16630.3,55814,6310,72,42853,42853,41608,40480,40249
79429,10237,18405,51514,27915,9.92809e+12,60.1452,23346.4,79429,8966,72,61024,61024,51169,48874,34541
91567,15656,21243,59380,32187,9.91428e+12,60.1463,26827,91567,10338,72,70324,70324,63580,54375,52235
8265,1479,2013,5353,2912,9.82345e+12,59.3846,2812.28,8265,975,72,6252,6252,5606,5459,4719
13054,2796,3700,8364,4690,9.26417e+12,56.5734,4787.69,13054,1780,72,9354,9354,9067,9002,8766
39527,7699,9201,25642,13885,9.91791e+12,60.0543,11953.9,39527,4477,72,30326,30326,28484,26038,25538
81676,3672,26936,51560,30116,8.65416e+12,58.5882,31445.5,81676,13112,72,54740,54740,33910,11021,8403
49842,18391,18624,31083,18759,8.09883e+12,57.5987,21442.5,49842,9067,72,31218,31218,30882,30587,30656
81700,10733,18924,52990,28710,9.92326e+12,60.1525,23990.3,81700,9215,72,62776,62776,52896,39409,36226
6500,3199,4568,3683,2817,3.93063e+12,48.378,4910.02,6500,2202,67,1932,1932,1797,1590,1719
39736,8379,17655,24287,15449,7.1869e+12,56.5052,19782.4,39736,8597,72,22081,22081,18667,13943,13046
72968,530,16996,47313,25655,9.92008e+12,60.1171,21583.5,72968,8279,72,55972,55972,31942,31463,2341
95344,20441,22107,61842,33502,9.91445e+12,60.1515,27889.4,95344,10764,72,73237,73237,70776,70732,67906
39932,2485,12117,25399,14533,8.99986e+12,58.9443,14685.8,39932,5892,72,27815,27815,15303,8017,5328
89650,3371,23507,57659,31991,9.53711e+12,59.6666,28798.9,89650,11451,72,66143,66143,40747,26590,9510
74074,22405,30046,45770,28304,7.6798e+12,57.3745,33797.2,74074,14632,72,44028,44028,38436,31860,31809
80746,5391,18723,52379,28367,9.9175e+12,60.139,23735.7,80746,9115,72,62023,62023,42550,29555,18588
20079,3560,5063,12959,7120,9.67033e+12,59.6264,6632.32,20079,2455,72,15016,15016,12986,11085,10665
52225,13453,14669,33424,18801,9.29465e+12,59.3392,17954.6,52225,7146,72,37556,37556,37080,36951,36467
18495,1597,4342,11991,6504,9.89992e+12,59.8794,5837.09,18495,2109,72,14153,14153,9589,9233,5502
35966,2320,9500,23128,12838,9.51855e+12,59.5417,11962.3,35966,4622,72,26466,26466,17525,7035,6667
31607,8504,12629,19565,12042,7.75996e+12,57.378,14517,31607,6139,72,18978,18978,16636,13969,13967
48298,4561,11262,31321,16977,9.91234e+12,60.072,14507.5,48298,5481,72,37036,37036,26315,17563,15192
66224,706,15353,42954,23270,9.92114e+12,60.1237,19586.5,66224,7468,72,50871,50871,29472,19027,3116
46197,9179,20105,28308,17889,7.30004e+12,56.8742,22544,46197,9787,72,26092,26092,20666,14279,14238
89035,3306,20732,57730,31305,9.90286e+12,60.125,26173.3,89035,10095,72,68303,68303,42962,28791,11756
81935,20212,22282,52571,29364,9.39599e+12,59.4982,27131.6,81935,10845,72,59653,59653,56604,53735,53002
51945,1762,19828,32326,19619,8.00034e+12,57.5457,22713.3,51945,9642,72,32117,32117,19257,7454,3625
75007,4094,17475,48639,26368,9.90051e+12,60.1142,22178,75007,8502,72,57532,57532,38111,26115,14219
46302,16947,21231,28189,18113,6.98935e+12,56.19,23590.6,46302,10330,72,25071,25071,22379,22267,19256
70649,11763,19624,45249,25400,9.3298e+12,59.412,23871.8,70649,9559,72,51025,51025,41658,30644,30248
21581,4124,5050,13995,7586,9.90491e+12,59.9195,6739.25,21581,2454,72,16531,16531,15410,15152,13700
13574,3398,4122,8641,4933,9.055e+12,58.6753,5213.35,13574,2005,72,9452,9452,8505,7479,7546
86805,1081,20432,56240,30565,9.86954e+12,60.0869,25745.5,86805,9940,72,66373,66373,19184,3255,3799
54326,11924,12702,35224,19102,9.89413e+12,60.0689,16279,54326,6177,72,41624,41624,40626,40591,39577
73599,8124,21362,46981,26618,9.16422e+12,59.2059,25694.1,73599,10400,72,52237,52237,34850,22935,18992
19334,2323,5208,12424,6910,9.42673e+12,59.2999,6702.26,19334,2521,72,14126,14126,11010,10433,6223
94699,17469,34269,59240,35459,8.24488e+12,58.084,39168.1,94699,16695,72,60430,60430,49805,35288,31861
34203,3427,7978,22182,12021,9.90969e+12,60.0442,10427.1,34203,3878,72,26225,26225,19596,14029,11557
58745,3557,13713,38094,20651,9.8965e+12,60.0785,17535,58745,6667,72,45032,45032,24437,24322,12234
11330,2572,5438,6859,4471,6.76481e+12,50.5793,6207.34,11330,2627,72,5892,5892,4365,2244,1970
90760,1979,33665,56635,34125,8.12575e+12,57.7797,38337,90760,16384,72,57095,57095,24328,9757,3200
58720,6797,13627,38085,20635,9.91992e+12,60.118,17455.2,58720,6632,72,45093,45093,36793,34873,22823
87566,15430,26279,55731,31835,9.04443e+12,59.0686,31239.4,87566,12802,72,61287,61287,45387,45080,25862
32750,2754,13525,20198,12552,7.59301e+12,56.0836,15433.5,32750,6569,72,19225,19225,11743,5976,4274
66943,11019,19994,42626,24317,9.05765e+12,59.0637,23952.8,66943,9730,72,46949,46949,37227,36994,25365
90220,15026,20931,58507,31713,9.92362e+12,60.146,26438,90220,10197,72,69289,69289,60633,60465,50097
2922,721,781,1892,1030,9.90619e+12,58.0103,1144.15,2922,380,62,2141,2141,2087,2072,2108
79071,10319,18396,51269,27802,9.90855e+12,60.1197,23313.8,79071,8953,72,60675,60675,50963,48694,34540
43603,1532,14651,27475,16128,8.59349e+12,58.3711,17302.3,43603,7130,72,28952,28952,11565,5523,2340
24070,3684,5604,15606,8464,9.93007e+12,59.9771,7448.6,24070,2729,72,18466,18466,15752,15687,12574
94037,9847,38789,57991,36046,7.58904e+12,57.2772,43329.9,94037,18891,72,55248,55248,34894,20246,15430
22340,3255,6736,14213,8127,9.07225e+12,58.9035,8349.46,22340,3281,72,15604,15604,12696,12053,8114
40042,6640,9309,25965,14077,9.92844e+12,60.0639,12090.8,40042,4535,72,30733,30733,27564,26820,22347
64510,8925,20970,40779,23731,8.73024e+12,58.6455,24680.6,64510,10216,72,43540,43540,34216,25232,22911
70405,4096,17908,45386,25019,9.62832e+12,59.683,22260.5,70405,8701,72,52497,52497,30506,18837,14201
65804,21511,22881,41325,24479,8.42927e+12,58.1265,26552.3,65804,11141,72,42923,42923,42064,40978,40788
63538,10153,15042,41161,22377,9.86023e+12,60.0315,19107.9,63538,7320,72,48496,48496,42843,41507,33362
70117,3284,22251,44418,25699,8.8177e+12,58.7742,26275.1,70117,10832,72,47866,47866,23165,7727,6232
70181,2354,16310,45509,24672,9.9119e+12,60.121,20755.8,70181,7940,72,53871,53871,21847,9050,8386
8962,1007,4380,5412,3550,6.65208e+12,54.1994,5018.43,8962,2121,72,4582,4534,3172,1524,1690
45136,17787,25007,35414,9722,80084800000,8.98445,25416,45136,22500,11,20129,20129,15682,15961,15421
73199,14179,16992,47468,25731,9.92e+12,60.1258,21599.4,73199,8275,72,56207,56207,52773,51985,47081
72866,17071,32787,44456,28410,7.10979e+12,56.6656,36250.8,72866,15970,72,40079,40079,32196,24803,22779
71905,7619,38865,56356,15549,79754500000,8.97748,39394.4,71905,34970,11,33040,33040,13065,14517,11632
77248,13224,26114,48655,28593,8.55305e+12,58.4511,30366.1,77248,12713,72,51134,51134,43078,31967,29517
65530,26625,34837,51323,14207,79549500000,8.98814,35348.3,65530,31346,11,30693,30693,25089,25588,24604
83850,13458,25411,53326,30524,8.99856e+12,58.9946,30177.9,83850,12366,72,58439,58439,46686,30618,26802
84016,21281,34671,51816,32200,7.58202e+12,57.2676,38799.4,84016,16884,72,49345,49345,40716,38484,26192
77382,9335,20454,49750,27632,9.5012e+12,59.6221,25112,77382,9957,72,56928,56928,45653,33465,30256
94491,4550,27948,60223,34268,9.0908e+12,59.127,33271.1,94491,13602,72,66543,66495,37876,18047,15872
29766,1526,10057,18747,11019,8.58284e+12,58.3737,12000.5,29766,4897,72,19709,19709,11606,5260,3479
83606,3260,19427,54223,29383,9.91428e+12,60.1404,24586.7,83606,9463,72,64179,64179,27812,28693,11549
34540,3252,8116,22382,12158,9.8951e+12,60.0081,10576.6,34540,3948,72,26424,26424,18803,18102,10977
14864,1782,3914,9574,5290,9.51135e+12,59.3303,5140.66,14864,1894,72,10950,10950,8026,4874,4109
77848,10518,26944,48919,28929,8.44521e+12,57.6947,31185.1,77848,13104,72,50904,50904,38959,27169,23926
94328,27156,27508,60180,34148,9.14555e+12,59.1988,32849.4,94328,13396,72,66820,66820,66617,66385,66562
1027,242,292,667,360,9.95064e+12,54.406,460.623,1027,136,45,735,735,680,688,674
23086,2859,6232,14829,8257,9.46789e+12,59.3699,7945.76,23086,3031,72,16854,16854,12823,8162,8037
54567,8052,13040,35325,19242,9.83213e+12,60.0034,16613.3,54567,6347,72,41527,41527,34756,26804,26567
91728,9200,25407,58765,32963,9.33971e+12,59.4277,30713,91728,12371,72,66321,66321,46797,31026,22872
41235,8743,11796,26356,14879,9.21129e+12,59.195,14484.3,41235,5732,72,29439,29439,26382,22826,22780
12046,204,6620,7139,4907,5.93772e+12,54.7619,7337.36,12046,3224,72,5426,5186,2466,786,384
32794,576,7654,21270,11524,9.91984e+12,60.0317,10017.5,32794,3726,72,25140,25140,7962,2014,2237
41975,10524,39227,28896,13079,9.2088e+12,3.99352,39327.9,41975,13102,9,2748,2748,733,2748,740
54490,10289,18636,34283,20207,8.50202e+12,57.7703,21799.8,54490,9073,72,35854,35854,28518,19854,19714
93703,32152,35667,58311,35392,7.99781e+12,57.7874,40405.1,93703,17369,72,58036,58036,55471,53024,52561
40336,19107,19500,24381,15955,6.68581e+12,56.0784,21530.9,40336,9495,72,20836,20836,20800,20732,20803
50855,5729,11844,32977,17878,9.91627e+12,60.0829,15231.3,50855,5769,72,39011,39011,30171,21874,19413
51307,11044,13090,33070,18237,9.62697e+12,59.729,16421.2,51307,6370,72,38217,38217,36411,35947,33559
36786,6121,12312,23203,13583,8.6043e+12,58.4027,14622.6,36786,5987,72,24474,24474,20105,14170,12820
59773,11568,21605,37406,22367,8.26334e+12,58.0665,24931.4,59773,10525,72,38168,38168,31103,21489,19229
86983,10150,20196,56409,30574,9.9209e+12,60.1422,25532.2,86983,9837,72,66787,66787,52081,51794,34040
87955,36184,87955,0,87955,7.99991,0,87955,87955,87955,1,0,0,0,0,0
63173,8848,19884,40051,23122,8.86112e+12,58.81,23578.4,63173,9685,72,43289,43289,33217,20835,17789
6594,2185,2527,4115,2479,8.00801e+12,55.3672,3111.31,6594,1209,72,4067,4067,3922,3849,3861
59522,1796,16438,38146,21376,9.35695e+12,57.2374,20120,59522,7991,72,43084,43084,16364,16956,5218
89402,2112,26780,56916,32486,9.043e+12,59.0665,31831.3,89402,13041,72,62622,62574,28546,24687,7673
67210,18284,21639,42518,24692,8.76809e+12,58.7019,25497.6,67210,10541,72,45571,45571,40706,35028,34879
49368,10370,19635,30584,18784,7.78563e+12,57.4652,22343.7,49368,9558,72,29733,29733,24886,18308,16802
61423,8403,30853,36905,24518,6.43322e+12,55.8383,33626.7,61423,15031,72,30570,30570,21490,10887,10660
84488,40273,45154,50292,34196,6.0143e+12,55.3236,48568.6,84488,21981,72,39334,39334,38557,37500,37411
56608,4334,20162,35468,21140,8.31935e+12,58.1441,23366.3,56608,9817,72,36446,36398,26435,15599,12793
45077,5586,20784,27426,17651,6.96505e+12,56.3337,23083.4,45077,10104,72,24293,24293,16515,7402,7241
83176,20939,27483,52491,30685,8.64991e+12,58.5807,32055.1,83176,13389,72,55693,55693,48578,40239,39992
13904,1873,3285,9012,4892,9.92215e+12,59.7814,4481.94,13904,1594,72,10619,10619,8533,6598,6146
68404,4996,27532,42304,26100,7.71883e+12,56.8381,31060,68404,13390,72,40872,40872,25390,12486,8740
83247,15645,31609,51818,31429,8.00671e+12,57.7843,35897.7,83247,15393,72,51638,51638,43917,33383,30911
42997,12096,12185,27499,15498,9.26272e+12,59.2618,14972.7,42997,5930,72,30812,30812,30707,30648,30660
34440,27350,34440,0,34440,7.99977,0,34440,34440,34440,1,0,0,0,0,0
71742,2044,16722,46509,25233,9.89998e+12,60.1122,21250.2,71742,8136,72,55020,55020,20936,22045,7401
79619,25300,34309,48845,30774,7.3553e+12,56.7604,38150.1,79619,16697,72,45310,45310,42103,37672,36838
72770,6893,20235,46614,26156,9.3232e+12,57.8394,24588.1,72770,9837,72,52535,52535,35059,23095,19050
27083,5911,6291,17572,9511,9.93631e+12,60.0217,8319.97,27083,3061,72,20792,20792,20346,20245,19765
9954,612,4011,6165,3789,7.86984e+12,57.0135,4778.51,9954,1953,72,5943,5895,2373,1699,1221
47384,833,11064,30726,16658,9.89697e+12,60.0535,14258.7,47384,5377,72,36320,36320,21371,21079,3003
96097,18484,22335,62314,33783,9.9194e+12,60.1441,28146.1,96097,10881,72,73762,73762,69131,62859,61430
48567,3215,13999,31028,17539,9.18835e+12,55.6973,17067.7,48567,6797,72,34568,34568,20616,12452,10921
25238,4228,13981,19802,5436,80054700000,8.94481,14284.6,25238,12575,11,11257,11257,5314,5670,4971
3373,193,818,2184,1189,1.00975e+13,58.7225,1233.66,3373,395,63,2555,2555,1638,648,703
24084,1380,9230,14984,9100,7.99138e+12,57.5605,10781.5,24084,4486,72,14854,14854,8759,5052,1440
3930,1144,2278,2317,1613,5.63392e+12,53.3761,2580.57,3930,1104,66,1652,1604,1571,1446,1563
28788,5105,6683,18679,10109,9.93941e+12,60.0215,8812.55,28788,3251,72,22105,22105,20186,19747,17106
27482,298,10774,17053,10429,7.87088e+12,57.4969,12480.2,27482,5246,72,16708,16324,9584,5124,1085
97914,24333,38914,60640,37274,7.79285e+12,57.5248,43712.5,97914,18957,72,59000,59000,52629,45200,45111
9933,3908,4545,6061,3872,7.03083e+12,54.674,5263.75,9933,2192,72,5388,5388,4905,4426,4489
74255,8920,17284,48147,26108,9.90887e+12,60.1317,21948.5,74255,8418,72,56971,56971,44775,44532,29833
80968,10488,22595,51844,29124,9.31177e+12,59.392,27353.8,80968,11002,72,58373,58373,45375,30999,27251
92003,41645,49149,54757,37246,6.01669e+12,54.9891,52819.1,92003,23935,72,42854,42854,40415,37038,36460
21343,8746,10573,12856,8487,6.54379e+12,55.4771,11785.5,21343,5134,72,10770,10770,9922,8861,8669
15586,4009,7301,9461,6125,6.88495e+12,54.0284,8293.49,15586,3541,72,8285,8285,6757,4966,5126
21773,4073,8463,13533,8240,7.90109e+12,57.387,9890.68,21773,4100,72,13310,13310,10387,7042,6984
71557,10982,26129,44731,26826,8.21167e+12,58.0209,29976.4,71557,12729,72,45428,45428,36588,25817,23234
50641,2290,13082,32611,18030,9.5854e+12,59.6823,16367.3,50641,6368,72,37559,37559,23703,8336,6755
9868,1242,2572,6351,3517,9.66486e+12,59.2902,3470.7,9868,1248,72,7296,7296,5330,5295,3083
14392,890,5409,8968,5424,8.11632e+12,57.6202,6462.05,14392,2635,72,8983,8887,5227,798,845
74610,3815,19574,47986,26624,9.52699e+12,59.6474,24102.4,74610,9525,72,55036,55036,27370,26571,11342
58433,12196,16097,37452,20981,9.35663e+12,59.4241,19729.4,58433,7830,72,42336,42336,38567,33468,32315
37015,437,14919,22893,14122,7.71519e+12,57.3368,17046.7,37015,7262,72,22096,21490,9704,1401,1465
52016,14713,22249,31938,20078,7.40011e+12,56.4527,24962.7,52016,10833,72,29767,29767,24694,18735,18712
53073,695,12351,34419,18654,9.91637e+12,60.0869,15862,53073,6015,72,40722,40722,12299,13601,2912
25996,4328,10114,16152,9844,7.92755e+12,57.5217,11750.2,25996,4923,72,15882,15882,11513,7776,6733
67190,4274,17899,43167,24023,9.48049e+12,59.5878,22022.9,67190,8720,72,49291,49291,32783,32386,12540
60934,6128,14186,39506,21428,9.92269e+12,60.1129,18127.9,60934,6910,72,46748,46748,34854,33401,20645
98537,20583,29056,62810,35727,9.10912e+12,59.1537,34579.2,98537,14155,72,69481,69481,60126,50249,48752
72587,4551,25742,45514,27073,8.33002e+12,58.1564,29694.7,72587,12518,72,46845,46845,26855,14880,10502
49006,6602,11419,31780,17226,9.90532e+12,60.0812,14708.8,49006,5552,72,37587,37587,30568,23854,22058
66464,3320,36286,39421,27043,5.86846e+12,54.5897,39030.3,66464,17662,72,30178,30178,15961,7143,4149
56829,4299,13252,36843,19986,9.92012e+12,60.0973,16967.2,56829,6455,72,43577,43577,30609,30335,14739
39318,4908,9142,25501,13817,9.92001e+12,60.0708,11886.3,39318,4447,72,30176,30176,25068,23880,16540
64020,12228,17393,41067,22953,9.40904e+12,59.495,21327.7,64020,8468,72,46627,46627,39589,31337,31064
60070,12905,13989,38945,21125,9.91658e+12,60.1088,17883.2,60070,6815,72,46081,46081,44594,44550,42963
86091,1161,30770,53920,32171,8.30097e+12,58.1546,35317.2,86091,14985,72,55321,55321,32102,31285,3763
78804,8010,18277,51111,27693,9.92044e+12,60.1342,23184.3,78804,8898,72,60527,60527,45493,45201,27042
8436,1458,2484,5377,3059,9.21957e+12,58.6951,3255.07,8436,1210,72,5952,5952,5307,4656,4713
66897,21549,24570,41789,25108,8.17275e+12,57.7172,28202.3,66897,11960,72,42327,42327,39879,36990,37102
3907,72,1719,2398,1509,7.41067e+12,53.4418,2091.93,3907,831,69,2188,1502,1245,765,0
80329,8840,18694,52097,28232,9.90184e+12,60.1202,23680.6,80329,9096,72,61635,61635,47241,46959,29575
39866,7338,9337,25848,14018,9.8976e+12,60.0401,12104.8,39866,4542,72,30529,30529,27704,25038,24390
36073,1171,8405,23396,12677,9.91529e+12,60.0429,10960.4,36073,4088,72,27668,27668,11103,11567,4289
48894,15294,17878,30563,18331,8.18645e+12,57.957,20684.1,48894,8693,72,31016,31016,29496,27695,27855
25471,1985,12187,15416,10055,6.7538e+12,53.46,13613.9,25471,5914,72,13284,13284,7617,965,912
15606,2899,3691,10118,5488,9.87741e+12,59.7784,4998.2,15606,1793,72,11915,11915,10762,10740,9521
15382,5417,6547,9452,5930,7.45583e+12,56.7849,7587.87,15382,3181,72,8835,8835,8306,7542,7604
7826,1149,2640,4943,2883,8.5975e+12,57.2874,3335.49,7826,1274,72,5186,5186,3643,1902,1910
1344,22,75,1066,278,5.80485e+13,11.8371,185.091,1344,64,14,1269,1269,868,567,1084
44718,12559,12878,28559,16159,9.20459e+12,59.2023,15743.5,44718,6268,72,31840,31840,31514,31209,31348
93255,13197,36685,57823,35432,7.83534e+12,57.5794,41317.9,93255,17865,72,56570,56570,38232,23943,19446
90244,17506,20936,58526,31718,9.92728e+12,60.1435,26443.3,90244,10198,72,69308,69308,64330,59596,58373
68549,25667,30058,41963,26586,7.25531e+12,56.8427,33408.9,68549,14637,72,38491,38491,36059,32702,32137
3555,14,972,2288,1267,9.58169e+12,56.366,1391.98,3555,457,63,1026,240,280,207,44
52564,11392,14636,33671,18893,9.33184e+12,59.3697,17946.4,52564,7127,72,37928,37928,34768,34011,29580
85935,19484,25467,54760,31175,9.0906e+12,59.123,30369.5,85935,12405,72,60468,60468,55508,49754,49583
7698,566,3232,4740,2958,7.52354e+12,53.8376,3857.57,7698,1559,72,4466,4379,2580,1949,525
44619,13197,23341,26648,17971,6.16186e+12,55.4508,25406.6,44619,11366,72,21278,21278,17775,13738,13800
37249,15496,17399,22611,14638,6.90439e+12,55.3336,19353.9,37249,8471,72,19850,19850,18125,16178,16221
80719,4373,18784,52346,28373,9.90497e+12,60.117,23789.4,80719,9138,72,61935,61935,40997,40569,15226
35674,797,9041,23003,12671,9.6444e+12,59.7168,11520.3,35674,4391,72,26633,26633,10298,10017,3068
90488,22375,33093,56554,33934,8.18788e+12,57.7805,37786.7,90488,16099,72,57395,57395,51260,42803,40993
65660,12581,15276,42580,23080,9.91755e+12,60.1162,19473,65660,7441,72,50384,50384,46407,46325,41714
84863,37559,40324,51389,33474,6.7837e+12,55.9781,44112.1,84863,19639,72,44539,44539,42500,40123,40255
13028,2269,3305,8411,4617,9.71762e+12,59.4499,4420.64,13028,1605,72,9723,9723,8550,7050,6760
82322,5976,34325,50699,31623,7.53107e+12,56.9174,38360.5,82322,16706,72,47997,47997,26467,16191,11965
28368,1504,6596,18400,9968,9.90693e+12,59.9806,8701.72,28368,3199,72,21772,21772,14357,9840,5341
24223,3794,12860,18971,5252,79535900000,8.97886,13167.7,24223,11573,11,11363,11363,5199,5742,4674
19720,6100,9669,15394,4326,78548800000,8.9857,9959.43,19720,8696,11,10051,10051,7225,7573,6897
61571,6560,14273,39930,21641,9.93077e+12,60.1304,18255.5,61571,6949,72,47298,47298,36061,26031,22341
57645,10251,25251,35291,22354,7.26116e+12,56.8345,28156,57645,12296,72,32394,32394,22736,12724,10063
33915,6720,10175,21589,12326,9.0398e+12,58.9628,12433.3,33915,4944,72,23740,23740,20206,20110,16018
56701,1154,13170,36770,19931,9.92263e+12,60.1089,16880.4,56701,6415,72,43531,43531,26011,17076,4479
13443,1472,4395,8504,4939,8.74222e+12,58.2984,5450.83,13443,2137,72,9048,9048,6214,2961,2928
42122,304,1767,33347,8775,5.85694e+13,11.9954,2440.53,42122,1763,13,40355,40355,27211,15559,34508
22722,2120,5760,14659,8063,9.66968e+12,59.6244,7482.15,22722,2803,72,16962,16962,11469,8160,7016
98542,18235,22906,63900,34642,9.90387e+12,60.1329,28850.1,98542,11145,72,75636,75636,68844,68709,60608
35253,6262,17640,21193,14060,6.47402e+12,55.3723,19418.3,35253,8588,72,17613,17613,12404,7485,6307
12345,1601,2946,8000,4345,9.85372e+12,59.6242,4035.32,12345,1430,72,9399,9399,7431,7393,5173
99760,2888,5730,79306,20454,5.76311e+13,12.0015,6771.49,99760,3894,20,94030,94030,73995,58329,82944
3342,393,823,2177,1165,9.93787e+12,58.4222,1232.89,3342,397,63,2519,2519,1978,1394,1327
25076,814,1057,19852,5224,5.8567e+13,11.9923,1573.94,25076,1053,13,24019,24019,21855,19963,23052
6920,1028,2990,4256,2664,7.38451e+12,50.8225,3560.07,6920,1434,72,3930,3930,2588,1009,1178
91516,11183,21243,59352,32164,9.91513e+12,60.1395,26819.5,91516,10345,72,70273,70273,58108,41469,37521
91990,20364,34697,57307,34683,8.03733e+12,57.8288,39382,91990,16888,72,57293,57293,47557,34133,31123
70000,15145,16262,45389,24611,9.91716e+12,60.1295,20698.6,70000,7917,72,53738,53738,52101,50565,50266
17635,3810,5175,11247,6388,9.17496e+12,57.7347,6530.56,17635,2514,72,12460,12460,11659,10544,10519
14497,2053,4072,9294,5203,9.30152e+12,59.0486,5253.05,14497,1973,72,10425,10425,8669,8618,6675
62140,10685,32113,37182,24958,6.24935e+12,55.5944,34843.9,62140,15639,72,30027,30027,21005,12693,10499
24318,1128,9706,15062,9256,7.77446e+12,56.4815,11242.6,24318,4706,72,14612,14612,9054,2947,2500
75819,5041,32436,46549,29270,7.39081e+12,57.0183,36140.3,75819,15791,72,43383,43383,26553,6810,6032
58675,12016,14541,37886,20789,9.72426e+12,59.876,18299.6,58675,7083,72,44134,44134,40907,37864,37122
4778,638,2736,2817,1961,5.70286e+12,46.383,3090.22,4778,1326,67,2042,1994,1157,80,0
50633,18873,24804,39524,11109,78537100000,8.99382,25274.9,50633,22316,11,25829,25829,21128,21707,20567
30039,3547,9894,18970,11069,8.67522e+12,57.6525,11870.8,30039,4806,72,20145,20145,14259,7390,7207
87884,10500,22761,56578,31306,9.56741e+12,59.7126,27984.9,87884,11083,72,65123,65123,50770,49361,30856
16487,5490,8150,9929,6558,6.57714e+12,55.7521,9144.57,16487,3965,72,8337,8337,7473,6379,6203
49088,7885,11430,31837,17251,9.92316e+12,60.0859,14719.5,49088,5567,72,37658,37658,32517,32410,26334
7044,1301,1667,4570,2474,9.91422e+12,59.4329,2385.26,7044,800,72,5377,5377,4874,4442,4434
11147,1366,2670,7223,3924,9.85575e+12,59.5982,3676.81,11147,1295,72,8477,8477,6985,6625,4637
38729,5858,9972,24945,13784,9.61263e+12,59.6687,12605,38729,4858,72,28757,28757,24622,19039,17759
7225,2617,3622,4357,2868,6.59984e+12,50.7156,4153.95,7225,1748,71,3603,3603,3420,3147,3280
13869,1210,3269,8987,4882,9.94692e+12,59.8249,4463.41,13869,1592,72,10600,10600,7660,5458,4230
28274,6515,6626,18331,9943,9.91916e+12,59.9924,8717.97,28274,3227,72,21648,21648,21497,21494,21449
19410,3354,8898,11818,7592,7.02001e+12,55.3394,10088.9,19410,4313,72,10512,10512,8055,5268,4770
72919,31288,40977,57249,15670,80258800000,8.98869,41492.1,72919,36871,11,31942,31942,25901,26301,25518
96725,19766,24287,62407,34318,9.66727e+12,59.8467,30015.4,96725,11825,72,72438,72438,67887,66773,60326
60907,3237,21087,38273,22634,8.44528e+12,58.2929,24534.5,60907,10264,72,39820,39820,20150,10490,6472
59226,11478,32529,35100,24126,5.8307e+12,55.0263,35009.8,59226,15830,72,26697,26697,18468,11564,9520
91934,2309,41770,56006,35928,7.04785e+12,56.6111,45956.2,91934,20343,72,50164,50164,20110,18307,3786
27558,5791,7743,17649,9909,9.2915e+12,59.2163,9694.67,27558,3760,72,19815,19815,17060,16995,13833
45840,429,11814,29534,16306,9.59233e+12,59.6786,14840.5,45840,5751,72,34026,33882,19578,19233,1898
69833,15330,18372,44909,24924,9.51209e+12,59.6294,22650.7,69833,8937,72,51461,51461,47842,47762,43531
52068,9985,14803,33298,18770,9.25721e+12,59.1602,18065.4,52068,7195,72,37265,37265,33194,27575,26453
22726,2434,9952,13924,8802,7.26998e+12,56.2454,11335.2,22726,4825,72,12774,12774,8111,4315,3216
74139,18605,31078,45638,28501,7.50459e+12,56.5919,34758.9,74139,15122,72,43061,43061,37433,30869,30819
7994,265,1872,5185,2809,1.00133e+13,59.6037,2660.9,7994,909,72,6122,6122,2364,983,982
35520,4850,12077,22367,13153,8.53531e+12,58.3363,14310.4,35520,5877,72,23443,23443,17646,12473,11013
61562,1276,14340,39919,21643,9.91382e+12,60.1056,18313.3,61562,6985,72,47222,47222,15954,4736,4695
53858,3608,12513,34926,18932,9.92983e+12,60.1084,16069.6,53858,6095,72,41345,41345,28448,19862,12662
87541,28252,40582,53198,34343,6.92652e+12,56.2558,44543.7,87541,19748,72,46959,46959,40240,31095,28965
96866,1750,22501,62810,34056,9.91681e+12,60.1507,28358.6,96866,10959,72,74365,74365,44078,43475,6726
9950,2289,2379,6443,3507,9.92768e+12,59.6387,3304.49,9950,1155,72,7571,7571,7449,7446,7421
95421,14809,22179,61871,33550,9.90646e+12,60.1369,27961.1,95421,10796,72,73242,73242,62552,62334,49476
60705,8764,14152,39366,21339,9.90891e+12,60.0962,18081.6,60705,6890,72,46553,46553,40124,31384,29348
26937,274,10476,16730,10207,7.90385e+12,57.532,12163.3,26937,5094,72,16461,16077,7547,1184,1173
23872,169,6981,15241,8631,9.16809e+12,59.0189,8698.47,23872,3397,72,16891,16733,5639,5111,773
50726,11574,11805,32891,17835,9.91627e+12,60.0869,15188.7,50726,5746,72,38921,38921,38616,38609,38402
97838,28279,30289,62114,35724,8.91319e+12,58.9186,35683,97838,14750,72,67549,67549,65091,62282,62237
73361,7102,17109,47570,25791,9.89439e+12,60.0667,21720.7,73361,8321,72,56252,56252,40942,39327,23955
53373,10900,13872,34358,19015,9.55766e+12,59.6476,17296.8,53373,6751,72,39501,39501,36300,31980,31020
68426,11562,17657,44067,24359,9.59137e+12,59.7115,21882.4,68426,8597,72,50769,50769,45096,43737,35608
34682,7511,8999,22333,12349,9.58446e+12,59.6129,11401.5,34682,4379,72,25683,25683,23857,23440,20939
20760,1619,9588,12628,8132,6.97369e+12,41.9591,10836,20760,4653,72,11172,11172,8596,5628,5582
79392,23047,30802,49302,30090,7.9161e+12,57.6597,34872.7,79392,15005,72,48590,48590,40918,31866,31708
30050,5549,7024,19481,10569,9.91871e+12,60.0228,9226.84,30050,3418,72,23026,23026,21215,20809,18345
13583,2446,3161,8815,4768,9.92741e+12,59.7504,4341.74,13583,1525,72,10422,10422,9576,8480,8295
65108,21467,30991,39418,25690,6.77541e+12,55.751,34026.4,65108,15091,72,34117,34117,31011,26820,25927
81398,5607,26380,51461,29937,8.7256e+12,58.477,30908.1,81398,12836,72,55018,55018,35645,12807,11930
58949,3465,13778,38213,20736,9.89594e+12,60.0858,17609.5,58949,6706,72,45171,45171,24180,13492,11945
87220,2598,20259,56560,30660,9.91357e+12,60.1369,25609.6,87220,9864,72,66961,66961,41164,40653,9374
83496,8329,19404,54146,29350,9.91382e+12,60.1322,24558,83496,9447,72,64092,64092,47779,32518,28191
3442,1486,1888,2699,743,7.9873e+10,8.90732,1995.88,3442,1691,11,1554,1554,1249,1284,1228
63496,26561,31109,49566,13930,78542900000,8.9954,31637.3,63496,27994,11,32387,32387,28775,29220,28347
23695,3485,5589,15368,8327,9.88956e+12,59.9228,7405.06,23695,2717,72,18106,18106,15632,15047,11590
44432,8286,11354,28634,15798,9.62153e+12,59.7314,14313.3,44432,5531,72,33078,33078,28952,28845,24088
65230,2358,17343,41913,23317,9.48906e+12,59.5824,21364.7,65230,8449,72,47887,47887,22418,21086,8321
91434,15981,36243,56635,34799,7.79881e+12,57.5319,40781,91434,17651,72,55191,55191,39593,21233,20657
33053,14971,16074,19956,13097,6.64739e+12,55.8693,17803.2,33053,7825,72,16979,16979,16275,15456,15658
46182,4578,11460,29826,16356,9.73621e+12,59.8394,14534.1,46182,5582,72,34722,34722,24121,15653,13415
39955,6348,15561,24815,15140,7.88642e+12,57.5651,17867.8,39955,7575,72,24394,24394,18880,12633,11073
81646,8480,19061,52925,28721,9.9088e+12,60.1203,24109,81646,9285,72,62585,62585,47900,45812,28702
96775,15848,38306,59971,36804,7.8026e+12,57.5465,43073.4,96775,18656,72,58469,58469,42506,23671,23087
53538,12183,16803,33944,19594,8.87574e+12,56.6523,20028.2,53538,8180,72,36735,36735,31831,26141,25972
57073,19094,19275,35947,21126,8.56484e+12,58.4332,22576.6,57073,9383,72,37798,37798,37578,37389,37399
59200,21868,26831,36075,23125,7.0727e+12,56.0989,29735.5,59200,13065,72,32369,32369,28974,25097,25013
76465,3266,42443,45233,31232,5.74693e+12,54.0293,45472.6,76465,20655,72,34022,34022,19940,11594,3060
10138,918,2375,6578,3560,9.91275e+12,59.6529,3319.52,10138,1143,72,7763,7763,5638,4032,3177
72155,19016,26769,45033,27122,8.12019e+12,57.7312,30618.4,72155,13018,72,45386,45386,38112,29511,29374
5251,329,1950,3280,1971,8.2178e+12,56.9657,2450.44,5251,942,72,3301,3253,2277,1340,1158
79964,15984,18591,51845,28119,9.91144e+12,60.1322,23559,79964,9055,72,61373,61373,57536,57462,52990
97631,6753,22686,63314,34317,9.90897e+12,60.145,28584.6,97631,11046,72,74945,74945,51774,51300,23314
32171,5462,7455,20876,11295,9.93986e+12,60.0655,9785.38,32171,3630,72,24716,24716,21773,18978,18310
27641,2559,10397,17228,10413,8.0722e+12,57.7275,12145.1,27641,5056,72,17244,17244,10319,5670,4123
59750,9859,32737,35421,24329,5.84375e+12,54.4668,35244.3,59750,15942,72,27013,27013,18684,8987,8799
54054,10903,12561,35060,18994,9.92536e+12,60.1031,16128.2,54054,6118,72,41493,41493,39045,36754,36185
7383,1756,3282,4512,2871,7.28589e+12,53.8635,3868.31,7383,1593,72,4101,4101,3195,2139,2333
54597,5994,25473,33150,21447,6.89438e+12,54.9963,28140.5,54597,12387,72,29124,29124,18890,6997,6596
49542,11180,11544,32133,17409,9.91264e+12,60.0822,14860.4,49542,5620,72,37998,37998,37562,37463,37017
84427,18023,46836,49950,34477,5.74965e+12,55.0106,50124.3,84427,22811,72,37591,37591,27352,15527,15091
27373,6148,8536,17380,9993,8.90817e+12,58.7411,10409.5,27373,4154,72,18837,18837,17496,16027,16049
53233,1483,13828,34268,18965,9.5666e+12,59.6591,17245.5,53233,6730,72,39405,39405,23266,9465,3543
27062,4761,6851,17462,9600,9.64031e+12,59.6381,8833.74,27062,3324,72,20211,20211,17667,14713,14698
89338,26638,49522,52853,36485,5.75767e+12,54.1425,52973.9,89338,24104,72,39816,39816,32624,22844,20549
64668,426,2727,51189,13479,5.85623e+13,12.0019,3571.39,64668,2264,19,61941,61941,41446,23257,43354
35241,11371,15183,21616,13625,7.36242e+12,55.917,17154.8,35241,7389,72,20058,20058,17995,15571,15705
61051,1398,14223,39583,21468,9.91539e+12,60.0799,18169.8,61051,6929,72,46828,46828,16434,17696,5376
23338,5246,5434,15139,8199,9.92534e+12,60.0039,7237.63,23338,2643,72,17904,17904,17689,17477,17487
57533,24777,25637,35145,22388,7.16425e+12,56.1789,28510.7,57533,12482,72,31896,31896,31713,31440,31573
76815,8488,17882,49808,27007,9.90756e+12,60.1188,22677.8,76815,8706,72,58933,58933,45310,45026,28627
8793,2693,3225,5509,3284,8.20108e+12,57.3762,3959.04,8793,1556,72,5568,5568,5265,4915,5114
16996,1724,4005,11023,5973,9.90451e+12,59.8228,5401.98,16996,1947,72,12991,12991,9590,6472,5640
41758,523,11097,26830,14928,9.50341e+12,59.4844,13875.3,41758,5400,72,30661,30639,10256,1495,1825
28727,2821,6730,18623,10104,9.90137e+12,59.9909,8852.63,28727,3270,72,21997,21997,16335,16219,9489
61297,18677,24339,37961,23336,7.79177e+12,57.248,27581.4,61297,11851,72,36958,36958,33446,28590,27661
1195,317,339,777,418,9.97695e+12,54.6494,525.601,1195,154,45,856,856,856,856,856
82730,5588,26430,52378,30352,8.79262e+12,58.7468,31042.5,82730,12875,72,56300,56300,35055,10057,9048
89109,12277,40626,54271,34838,7.02448e+12,56.5173,44691.7,89109,19780,72,48483,48483,29483,15513,11127
72327,925,16793,46902,25425,9.91409e+12,60.1307,21356.6,72327,8172,72,55534,55534,32428,21079,3965
59243,3462,13755,38425,20818,9.91862e+12,60.093,17606.5,59243,6692,72,45488,45488,30450,20935,11974
19745,2771,5595,12634,7111,9.26615e+12,59.1045,7089.99,19745,2720,72,14150,14150,11885,8745,8232
28442,920,14894,16986,11456,6.16809e+12,53.9974,16342.9,28442,7233,72,13548,13394,8285,3621,2094
46334,16133,18744,28634,17700,7.70113e+12,56.966,21293.8,46334,9126,72,27590,27590,25936,23658,23306
96406,262,22400,62515,33891,9.91122e+12,60.1497,28235.6,96406,10908,72,74006,74006,18388,21496,2037
48679,2397,11348,31564,17115,9.9019e+12,60.0734,14618.7,48679,5513,72,37331,37331,18112,18275,8300
18695,2785,4382,12122,6573,9.93033e+12,59.89,5889.61,18695,2128,72,14313,14313,12355,11907,9221
16072,664,3800,10421,5651,9.8563e+12,59.7605,5139.44,16072,1834,72,12272,12272,5389,5516,2355
36450,7016,12350,22957,13493,8.55119e+12,58.3509,14632.8,36450,6006,72,24100,24100,19378,14848,13790
54901,603,22068,33968,20933,7.72492e+12,57.4028,25007.4,54901,10745,72,32833,32113,18887,12182,2018
25615,3317,11880,15578,10037,6.93228e+12,56.2977,13341.6,25615,5774,72,13735,13735,8772,4323,2908
59694,18757,21587,37352,22342,8.24589e+12,57.3946,24914.9,59694,10509,72,38107,38107,36229,36148,34104
16837,2062,3956,10919,5918,9.91361e+12,59.8595,5346.45,16837,1921,72,12881,12881,10652,7679,7045
53408,6873,17000,33833,19575,8.80192e+12,58.7361,20203.5,53408,8274,72,36408,36408,27631,18753,16496
33190,4015,7748,21525,11665,9.90432e+12,60.0346,10137.1,33190,3767,72,25442,25442,20956,14874,13482
96350,9875,90034,66330,30020,9.21321e+12,3.99871,90189,96350,30033,9,6316,6316,691,6316,698
13832,3151,6029,8471,5361,7.34693e+12,55.8678,6975.22,13832,2932,72,7803,7803,5731,3816,3397
23581,8898,9884,14516,9065,7.51204e+12,56.0091,11344.4,23581,4799,72,13697,13697,13334,12911,12886
5481,933,1314,3559,1922,9.94391e+12,58.9648,1903.8,5481,631,72,4167,4167,3643,3082,3175
43842,6123,14204,27727,16115,8.74098e+12,58.5951,16907.9,43842,6903,72,29638,29638,21911,14470,12436
55567,18329,24168,34043,21524,7.30787e+12,56.8878,26999.7,55567,11774,72,31399,31399,28126,23600,22751
78068,2128,18163,50616,27452,9.90497e+12,60.1253,23030.7,78068,8839,72,59905,59905,36550,36082,7763
96809,12355,24502,62418,34391,9.64131e+12,59.7268,30221.5,96809,11920,72,72307,72307,59019,55819,36516
73634,2496,17161,47742,25892,9.90002e+12,60.1105,21790.4,73634,8345,72,56473,56473,35154,34721,8897
49654,8527,11559,32199,17455,9.91311e+12,60.092,14884.7,49654,5625,72,38095,38095,33712,33621,28470
53450,6086,12430,34668,18782,9.91029e+12,60.0991,15966.5,53450,6048,72,41020,41020,33415,23040,20615
8162,593,1986,5292,2870,9.87711e+12,59.3807,2778.49,8162,963,72,6176,6176,4152,4095,1890
81034,17398,18855,52553,28481,9.90672e+12,60.1154,23878.3,81034,9175,72,62179,62179,60051,60011,57593
93995,3803,33719,58854,35141,8.28098e+12,57.5393,38613.8,93995,16404,72,60276,60276,33364,16291,10204
40453,4172,9417,26238,14215,9.90857e+12,60.039,12223.5,40453,4576,72,31036,31036,23572,16093,14076
32713,364,10392,20737,11976,8.81654e+12,58.669,12539.2,32713,5052,72,22321,22081,12921,12629,1498
83004,14981,25706,52688,30316,8.9141e+12,58.905,30391.1,83004,12518,72,57298,57298,47843,47551,36375
3012,352,1263,1855,1157,7.91419e+12,44.8728,1578.22,3012,609,57,1749,1749,997,66,0
57496,1623,16737,36696,20800,9.15361e+12,58.8386,20255.8,57496,8131,72,40759,40759,25127,24700,6011
69973,12455,16261,45383,24590,9.91886e+12,60.1181,20693.6,69973,7918,72,53712,53712,48178,48065,41501
43269,5037,22315,33846,9423,79186600000,8.99251,22737.3,43269,20076,11,20954,20954,8400,9705,7109
55675,12921,12937,36112,19563,9.91191e+12,60.1074,16597.5,55675,6297,72,42738,42738,42731,42738,42738
20858,2107,10908,12470,8388,6.18581e+12,55.2807,12044.7,20858,5302,72,9950,9902,8658,7406,7147
59341,16841,22511,36936,22405,8.02226e+12,56.9826,25743.9,59341,10961,72,36830,36830,31944,26270,26104
47381,12727,12858,30404,16977,9.41812e+12,59.4515,15918.7,47381,6255,72,34523,34523,34371,34366,34295
5592,1604,3080,3312,2280,5.9393e+12,50.5994,3490.52,5592,1494,70,2512,2512,1972,1206,1269
74073,14492,25878,46515,27558,8.4042e+12,58.1827,29924.7,74073,12587,72,48195,48195,41070,32745,32573
17216,7254,7358,10578,6638,7.42004e+12,55.8355,8491.45,17216,3573,72,9858,9858,9740,9686,9706
95354,24994,39807,58715,36639,7.52444e+12,57.1496,44369.2,95354,19384,72,55547,55547,49926,42269,40508
64038,14188,24835,39764,24274,7.9104e+12,57.6529,28240.1,64038,12097,72,39203,39203,30371,20067,19711
99287,16215,37393,61864,37423,8.04553e+12,57.7819,42397.8,99287,18195,72,61894,61894,48061,31883,31290
33637,11101,12972,20910,12727,7.94975e+12,57.6028,14989.6,33637,6313,72,20665,20665,18992,17446,17137
5611,309,1407,3628,1983,9.71517e+12,58.9137,2005.38,5611,669,72,4204,4204,2101,1132,1077
13765,1396,3912,8809,4956,9.28013e+12,59.057,5044.51,13765,1901,72,9853,9853,6990,3698,3635
87353,9671,27564,55372,31981,8.83913e+12,58.5724,32422.9,87353,13407,72,59789,59789,42228,41719,20743
93504,1776,5747,74413,19091,5.73906e+13,12.0016,6752.99,93504,3172,20,87757,87757,62156,44768,68899
49124,10689,11453,31855,17269,9.91034e+12,60.0789,14744.4,49124,5575,72,37671,37671,36836,36631,35634
16541,4658,5667,10419,6122,8.5461e+12,58.1366,6884.61,16541,2757,72,10874,10874,10232,9476,9681
80645,16872,26430,50935,29710,8.68031e+12,58.611,30899.4,80645,12867,72,54215,54215,46292,46039,36747
64196,12900,28472,39237,24959,7.19006e+12,55.9363,31627,64196,13848,72,35724,35724,27041,16925,16592
79012,19064,32318,48770,30242,7.63104e+12,56.9249,36261,79012,15730,72,46694,46694,38107,28086,27755
34893,2063,15603,21304,13589,7.15516e+12,56.6441,17513.2,34893,7596,72,19290,19290,12010,7364,3352
22763,7359,9879,13957,8806,7.33276e+12,55.7937,11271.1,22763,4797,72,12884,12884,11777,10343,10075
42427,11785,22006,33195,9232,7.9229e+10,8.99354,22422.6,42427,19797,11,20421,20421,13135,13860,12424
6023,1685,2485,3728,2295,7.63597e+12,52.2007,3012.81,6023,1188,72,3538,3538,3177,2842,2906
92578,1610,21477,60042,32536,9.91929e+12,60.1426,27108,92578,10460,72,71101,71101,42128,41546,6401
35934,5138,8377,23299,12635,9.90635e+12,60.0434,10926,35934,4068,72,27557,27557,22894,22796,17286
92220,26753,30587,58186,34034,8.62516e+12,58.5545,35573.6,92220,14885,72,61633,61633,57650,53017,52899
96186,9297,22303,62386,33800,9.92205e+12,60.1488,28125.4,96186,10861,72,73883,73883,53830,51718,31530
37136,2352,13482,23236,13900,8.22528e+12,57.9532,15731.2,37136,6555,72,23654,23654,15376,8668,6710
54902,17415,21876,33988,20914,7.77635e+12,57.4716,24829.1,54902,10653,72,33026,33026,29114,28982,24490
67923,25652,26976,42062,25861,7.79431e+12,57.5018,30504.9,67923,13142,72,40947,40947,40338,39589,39497
27311,3888,6774,17641,9670,9.72878e+12,59.74,8780.97,27311,3289,72,20537,20537,16697,16613,12122
72468,7324,20278,46386,26082,9.30712e+12,59.3775,24605.3,72468,9879,72,52190,52190,35678,23361,19558
73401,327,22031,46732,26669,9.03999e+12,58.6534,26301.1,73401,10715,72,51370,50852,16970,7769,1834
19587,4366,4638,12686,6901,9.89835e+12,59.8917,6198.43,19587,2255,72,14949,14949,14722,14482,14512
3993,225,970,2588,1405,9.91808e+12,58.6622,1440.05,3993,460,66,3023,3023,1475,818,797
80935,8198,18826,52482,28453,9.91527e+12,60.1264,23841.1,80935,9167,72,62109,62109,46756,44699,27692
10803,742,3935,6756,4047,8.26426e+12,57.6669,4794.95,10803,1913,72,6868,6820,3244,961,689
72225,13920,19151,46414,25811,9.49183e+12,59.606,23541.3,72225,9324,72,53074,53074,48864,43171,41861
65181,23471,24129,40678,24503,8.14395e+12,57.9315,27662.9,65181,11755,72,41052,41052,40351,39479,39357
2643,1430,2643,0,2643,7.99697,0,2643,2643,2643,1,0,0,0,0,0
68522,10130,15935,44436,24086,9.9095e+12,60.1141,20288.9,68522,7758,72,52587,52587,44081,35943,33734
86873,15659,20234,56330,30543,9.91225e+12,60.1263,25560.1,86873,9854,72,66639,66639,61206,59924,52130
54440,8153,21984,33658,20782,7.71965e+12,57.3662,24890.3,54440,10710,72,32456,32456,23421,12823,12600
88053,13686,21584,56902,31151,9.74884e+12,59.9346,26902.1,88053,10510,72,66469,66469,55360,55119,41791
10839,3261,3704,6822,4017,8.55111e+12,58.0095,4588.78,10839,1799,72,7135,7135,6753,6264,6293
55256,1293,29850,32831,22425,5.94908e+12,55.2106,32232.8,55256,14535,72,25406,25388,14493,6160,1414
78860,2410,18347,51134,27726,9.91345e+12,60.1257,23253.3,78860,8931,72,60513,60513,23655,9268,8665
88056,35569,40435,53571,34485,6.9827e+12,56.5338,44443.5,88056,19686,72,47621,47621,44987,41889,41992
29006,5957,9596,18306,10700,8.65632e+12,58.4481,11516.2,29006,4669,72,19410,19410,16777,16134,12470
97256,7037,22849,63029,34227,9.8801e+12,60.1005,28708,97256,11127,72,74407,74407,45312,27475,23997
3668,949,1745,2233,1435,7.08047e+12,54.931,2081.1,3668,845,68,1923,1923,1764,1589,1650
72521,16854,19396,46578,25943,9.46475e+12,59.5686,23789.1,72521,9443,72,53125,53125,49470,46029,45146
35559,6960,11187,22553,13006,8.86915e+12,58.7392,13490.2,35559,5444,72,24372,24372,20286,15564,15439
34839,7439,8136,22593,12246,9.90002e+12,60.0212,10616.9,34839,3958,72,26703,26703,25866,25673,24633
43648,5826,10141,28318,15330,9.91804e+12,60.0768,13130.1,43648,4935,72,33507,33507,28300,27089,19603
58512,11418,14029,37868,20644,9.83856e+12,59.9915,17806.6,58512,6834,72,44483,44483,41855,38334,37570
71356,4654,29259,44043,27313,7.61443e+12,57.2955,32872.9,71356,14243,72,42097,42097,26452,8117,7393
58850,15792,24393,36284,22566,7.56347e+12,56.5585,27452.4,58850,11862,72,34457,34457,29085,22773,22705
95944,14044,23911,61932,34012,9.6927e+12,58.7948,29612.4,95944,11626,72,72033,72033,60716,49869,46868
98659,32953,37828,61350,37309,7.95864e+12,57.7434,42759.7,98659,18418,72,60831,60831,58152,54442,53784
13579,847,3150,8814,4765,1.00334e+13,59.8339,4325.54,13579,1534,72,10429,10429,7016,4860,2988
2541,134,153,2020,521,5.77053e+13,11.9252,308.141,2541,113,14,2388,2388,2264,2180,2333
64715,21501,26009,40024,24691,7.73108e+12,57.4308,29376.5,64715,12667,72,38706,38706,36513,34048,34055
65293,19711,26796,40290,25003,7.61706e+12,56.8502,30152.5,65293,13034,72,38497,38497,33887,28464,28465
75799,914,31969,46612,29187,7.47137e+12,56.8327,35706,75799,15569,72,43830,43446,19884,2395,2155
88904,14381,20625,57653,31251,9.92371e+12,60.1491,26065.6,88904,10047,72,68279,68279,59231,50585,48219
78855,28328,42384,61789,17066,7.9686e+10,8.99694,42941.2,78855,38138,11,36471,36471,27371,28063,26698
60457,6029,26302,37047,23410,7.29674e+12,56.8113,29341.3,60457,12791,72,34155,34155,18465,10215,7093
35508,5944,8295,23030,12478,9.88954e+12,59.9954,10815.3,35508,4027,72,27213,27213,23758,20479,19638
28191,7044,7281,18160,10031,9.59626e+12,59.592,9316.49,28191,3535,72,20910,20910,20603,20596,20380
32803,266,10411,20784,12019,8.82683e+12,53.3713,12567,32803,5050,72,22392,22392,12572,6452,127
69586,12407,23217,43888,25698,8.61359e+12,58.5201,27133.2,69586,11307,72,46369,46369,38063,28206,28015
39502,7741,12944,24956,14546,8.70946e+12,58.5565,15412.6,39502,6306,72,26558,26558,22259,18167,17206
22010,3766,7249,13897,8113,8.66733e+12,56.999,8796.88,22010,3516,72,14761,14761,12237,8838,8101
21022,459,1282,16728,4294,5.74482e+13,11.9908,1749.53,21022,868,14,19740,19740,14530,11089,17388
96251,45799,50712,75358,20893,7.9421e+10,8.99701,51337.5,96251,45634,11,45539,45539,42666,42806,42543
68977,19339,29669,42328,26649,7.35845e+12,56.9828,33082.7,68977,14448,72,39308,39308,34214,28260,28237
49823,2875,11593,32309,17514,9.91369e+12,60.1034,14929.5,49823,5645,72,38230,38230,20133,20158,9944
52001,12541,19194,32470,19531,8.15561e+12,57.5789,22132.9,52001,9334,72,32807,32807,28994,25442,24502
9011,127,591,7178,1833,5.72152e+13,11.981,892.322,9011,376,14,8420,8420,5483,3381,7090
94732,16866,21980,61444,33288,9.91262e+12,60.1394,27727.1,94732,10695,72,72752,72752,66585,65150,56228
48966,23691,23740,29565,19401,6.66685e+12,56.0985,26109.8,48966,11565,72,25226,25226,25167,25169,25171
58036,5259,13475,37642,20394,9.91942e+12,60.1107,17263.5,58036,6559,72,44561,44561,32579,32338,17917
8012,1322,3731,4877,3135,6.9801e+12,55.8324,4333.74,8012,1813,72,4281,4281,2899,1592,1463
34095,5953,10167,21725,12370,9.06703e+12,58.9732,12436.8,34095,4939,72,23928,23928,19150,13571,13406
64476,11891,19683,40988,23488,8.9728e+12,58.9442,23486.5,64476,9582,72,44793,44793,37615,29219,28968
62210,794,24340,38596,23614,7.85778e+12,57.5795,27649.2,62210,11843,72,37870,37543,21475,10602,1526
20123,2487,4712,13056,7067,9.9031e+12,59.9056,6311.78,20123,2290,72,15411,15411,12115,8989,8228
42508,7797,10156,27526,14982,9.82687e+12,59.947,13060.1,42508,4933,72,32352,32352,29578,28920,25015
22459,3206,8792,13940,8519,7.887e+12,57.4416,10247.7,22459,4277,72,13667,13667,8985,9260,4379
92937,13450,23607,59918,33019,9.63363e+12,59.7988,29120.2,92937,11496,72,69330,69330,54589,40439,36515
30410,5905,7110,19717,10693,9.91344e+12,60.0109,9333.39,30410,3457,72,23300,23300,21919,20123,19776
57671,11962,13403,37402,20269,9.91587e+12,60.104,17169,57671,6525,72,44268,44268,42511,40189,39713
59347,7356,21751,37078,22269,8.19591e+12,57.9826,25033.9,59347,10595,72,37596,37596,25940,16522,13709
12357,5157,6886,9697,2660,80139300000,8.81508,7094.71,12357,6190,11,5471,5471,4508,4541,4491
45410,9066,10598,29445,15965,9.90198e+12,60.0682,13685.6,45410,5152,72,34812,34812,32682,32626,30235
66089,828,24051,41325,24764,8.2126e+12,58.0139,27656.7,66089,11707,72,42038,41866,24215,12572,2465
23229,2177,7894,14638,8591,8.54222e+12,58.2517,9486.54,23229,3837,72,15335,15335,9370,4528,3216
23564,2318,6069,15184,8380,9.61327e+12,59.5625,7835.2,23564,2947,72,17495,17495,12154,12615,7988
1354,161,373,878,476,9.64676e+12,55.3959,579.094,1354,176,49,981,981,688,480,480
83971,25761,38724,51068,32903,6.9573e+12,56.4965,42561.9,83971,18859,72,45247,45247,40458,33854,32497
37469,3562,12159,23693,13776,8.72781e+12,58.5992,14538.1,37469,5911,72,25310,25310,15965,9112,7078
30871,4730,7211,20015,10856,9.93067e+12,60.0204,9459.3,30871,3512,72,23660,23660,20707,20015,15873
23816,2711,12037,14304,9512,6.39509e+12,55.6112,13332.8,23816,5859,72,11779,11779,7473,3801,2390
84037,27083,29131,52808,31229,8.44137e+12,58.3167,33647.1,84037,14189,72,54906,54906,53958,52638,52564
35560,3765,8295,23062,12498,9.91459e+12,60.0277,10816.4,35560,4037,72,27265,27265,20655,20523,12648
54762,1018,28635,32704,22058,6.15848e+12,55.474,31074.8,54762,13936,72,26127,25455,14853,7191,1289
14193,2739,3345,9197,4996,9.95965e+12,59.817,4559.42,14193,1629,72,10848,10848,9957,9939,9052
77904,7246,18132,50511,27393,9.90397e+12,60.1207,22990.6,77904,8818,72,59772,59772,43965,43643,24537
7185,3011,3481,4349,2836,6.71737e+12,55.3768,4024.95,7185,1684,72,3704,3704,3590,3428,3507
68426,7088,25513,42673,25753,8.10012e+12,57.8854,29184.1,68426,12424,72,42913,42913,28324,11117,10606
29357,12592,12625,18024,11333,7.36837e+12,56.8854,14332.6,29357,6143,72,16732,16732,16700,16701,16700
75354,5623,17556,48865,26489,9.9001e+12,60.1128,22277.3,75354,8541,72,57798,57798,35545,34756,19052
21478,4774,8297,13359,8119,7.93037e+12,57.4442,9713.74,21478,4020,72,13181,13181,11030,8051,7569
9483,3871,4095,5827,3656,7.36459e+12,56.4672,4813.76,9483,1983,72,5388,5388,5094,4833,4895
27225,137,6320,17657,9568,9.94697e+12,60.0293,8356.88,27225,3074,72,20905,20866,11830,7596,775
86984,12223,24217,55701,31283,9.32041e+12,58.0177,29281.2,86984,11781,72,62767,62767,52183,37716,34292
46785,5211,19609,28802,17983,7.5236e+12,57.1249,22123.1,46785,9551,72,27176,27176,18435,12452,10470
2311,544,600,1508,803,9.7066e+12,57.4124,911.691,2311,282,57,1711,1711,1660,1659,1663
65442,14901,21064,41400,24042,8.7622e+12,58.6991,24839,65442,10256,72,44378,44378,37702,31315,29669
47311,5548,13201,30293,17018,9.31813e+12,59.3404,16232.3,47311,6425,72,34110,34110,26343,18004,15844
70537,9941,24719,44263,26274,8.39489e+12,58.2579,28597.2,70537,12040,72,45818,45818,35383,23412,20515
54887,1425,12760,35604,19283,9.91703e+12,60.1019,16374.5,54887,6213,72,42127,42127,15552,16476,5350
86163,17602,22279,55487,30676,9.57401e+12,59.7199,27420.5,86163,10847,72,63884,63884,58337,50803,49049
64415,3550,16680,41469,22946,9.57826e+12,59.6975,20690.5,64415,8125,72,47735,47735,30705,10571,9817
37017,7475,8684,23993,13024,9.89258e+12,60.0148,11288.7,37017,4220,72,28333,28333,26982,26648,24849
18091,7156,8030,11064,7027,7.24885e+12,56.5617,9175.73,18091,3912,72,10061,10061,9191,8184,8376
68392,4441,15955,44347,24045,9.91155e+12,60.1124,20298.2,68392,7771,72,52437,52437,35668,24640,15080
88286,8400,26205,56245,32041,9.08645e+12,59.1174,31219.7,88286,12766,72,62081,62081,39730,39601,19573
33422,3499,7796,21666,11756,9.92028e+12,60.0476,10196.4,33422,3794,72,25626,25626,19625,18735,11794
75678,15115,17626,49071,26607,9.90268e+12,60.1164,22365.5,75678,8574,72,58052,58052,54471,54390,50221
16693,2360,5110,10611,6082,8.97903e+12,57.6866,6392.41,16693,2475,72,11583,11583,9380,6852,6861
41873,4583,9738,27159,14714,9.92153e+12,60.0545,12623.6,41873,4741,72,32135,32135,25471,17437,15462
68597,15520,15950,44491,24106,9.91515e+12,60.1167,20308.9,68597,7766,72,52647,52647,52020,51471,51446
39771,10350,15414,24703,15068,7.92269e+12,57.2849,17719.6,39771,7503,72,24357,24357,20981,17006,17070
82311,18755,82311,0,82311,7.9999,0,82311,82311,82311,1,0,0,0,0,0
97897,25604,27712,62605,35292,9.25579e+12,59.3421,33287.3,97897,13492,72,70185,70185,67715,64396,63676
36644,3939,11861,23173,13471,8.73837e+12,58.4366,14199.9,36644,5764,72,24783,24783,17140,8132,7976
85916,5277,26003,54646,31270,9.0166e+12,59.0243,30864.5,85916,12666,72,59913,59865,29297,20986,18214
44815,7115,12365,28723,16092,9.34948e+12,59.3832,15278.2,44815,6011,72,32450,32450,25895,18171,17987
41452,4929,15947,25771,15681,7.97104e+12,57.6555,18335.6,41452,7769,72,25505,25505,18460,10166,10040
16907,6070,7198,10395,6512,7.45481e+12,56.816,8315.06,16907,3500,72,9709,9709,8550,7202,7379
98544,28623,34941,61770,36774,8.33088e+12,58.1997,40064,98544,17009,72,63603,63603,61401,58336,57838
63609,2784,14809,41249,22360,9.92054e+12,60.1059,18894.6,63609,7211,72,48800,48800,22374,10739,9714
87244,9740,20268,56578,30666,9.91418e+12,60.1365,25618.8,87244,9870,72,66976,66976,53977,37025,32917
87251,21118,26187,55536,31715,9.03817e+12,59.0623,31134.5,87251,12751,72,61064,61064,56129,49451,47912
14044,1003,3328,9102,4942,9.88441e+12,59.7521,4532.87,14044,1615,72,10716,10716,6258,3902,3490
12659,179,2997,8205,4454,9.95572e+12,59.7403,4107.44,12659,1459,72,9662,9652,2868,638,745
13843,3553,3851,8878,4965,9.35104e+12,59.0865,4993.47,13843,1870,72,9992,9992,9562,9157,9214
67665,2422,20737,42996,24669,8.96096e+12,58.5768,24694.7,67665,10086,72,46928,46928,25005,13198,8551
16522,3123,5778,10375,6147,8.45297e+12,58.035,6985.37,16522,2807,72,10744,10744,8591,5727,5119
49226,16960,17581,30848,18378,8.30406e+12,58.1054,20432.6,49226,8559,72,31645,31645,30737,29907,29806
80064,10363,18630,51919,28145,9.9062e+12,60.1173,23599.3,80064,9066,72,61434,61434,49522,49267,34941
96260,21324,33391,60470,35790,8.43411e+12,58.3234,38460.3,96260,16262,72,62869,62869,52664,40731,40292
97482,23525,28617,62166,35316,9.12045e+12,59.1683,34098.9,97482,13936,72,68865,68865,62700,61271,52369
68818,3606,16446,44544,24274,9.82566e+12,60.0086,20786.5,68818,8003,72,52372,52372,27051,14099,12564
75347,1030,17543,48855,26492,9.91595e+12,60.1224,22258.9,75347,8544,72,57804,57804,17478,3742,4019
46555,4242,20116,28545,18010,7.35347e+12,56.2885,22578.1,46555,9794,72,26439,26439,17220,6416,6181
80040,12765,23638,51022,29018,9.10755e+12,59.1349,28258,80040,11515,72,56402,56402,46707,35356,34940
98496,7208,39360,60972,37524,7.75272e+12,57.1819,44173.2,98496,19154,72,59136,59136,39751,17060,16168
92273,41736,50941,72387,19886,80017400000,8.99668,51531.4,92273,45843,11,41332,41332,35488,35901,35090
74014,18903,32258,45333,28681,7.2948e+12,56.897,35845.3,74014,15709,72,41756,41756,34175,26969,25142
26469,5172,6150,17169,9300,9.9521e+12,60.0012,8136.3,26469,2996,72,20319,20319,19126,17579,17281
68832,7962,16008,44635,24197,9.90817e+12,60.1096,20380,68832,7793,72,52824,52824,43134,40874,26773
1701,225,603,1075,626,8.6795e+12,55.2099,827.606,1701,288,53,1098,1050,839,815,700
88840,3614,26137,56641,32199,9.11298e+12,59.1471,31196.6,88840,12720,72,62703,62703,38410,13323,8565
9943,2060,2326,6450,3493,9.93567e+12,59.6683,3256.33,9943,1123,72,7617,7617,7328,7258,7004
64387,472,14980,41758,22629,9.91967e+12,60.1143,19109.8,64387,7296,72,49407,49407,28301,18188,2326
7479,152,3024,4628,2851,7.74358e+12,55.8531,3649.13,7479,1458,72,4455,4333,2512,1137,0
16790,6293,7959,10190,6600,6.81383e+12,56.057,8999.09,16790,3872,72,8831,8831,8124,7310,7512
43490,36830,43490,0,43490,7.99982,0,43490,43490,43490,1,0,0,0,0,0
46348,5543,10797,30048,16300,9.9219e+12,60.0909,13935.6,46348,5259,72,35551,35551,29183,27712,18535
88799,5924,20608,57588,31211,9.91634e+12,60.1454,26045.8,88799,10034,72,68191,68191,46704,32383,20246
95390,24446,36865,59257,36133,7.92774e+12,57.6942,41634,95390,17953,72,58525,58525,52833,44991,43340
33629,14565,14595,20611,13018,7.32702e+12,56.7944,16484.5,33629,7105,72,19034,19034,19011,19009,19025
46015,5330,10744,29835,16180,9.89839e+12,60.0559,13861.8,46015,5229,72,35271,35271,27472,20014,18011
38130,9794,14613,23707,14423,7.9881e+12,57.681,16850.5,38130,7119,72,23517,23517,20375,16031,15230
31448,1019,14216,19179,12269,7.09491e+12,55.3553,15963.8,31448,6908,72,17232,17091,10275,6512,2000
74013,13850,28771,45957,28056,7.8933e+12,57.6454,32610.8,74013,14009,72,45242,45242,34104,20985,20650
54743,28820,51159,37700,17043,9.20595e+12,3.99364,51274.8,54743,17073,9,3584,3584,2019,3584,2026
59743,5883,16604,38258,21485,9.32252e+12,59.3873,20293.3,59743,8079,72,43139,43139,31148,30793,16574
35760,9068,9350,23008,12752,9.57309e+12,59.5952,11805.9,35760,4555,72,26410,26410,25999,25620,25686
35731,11847,15069,21980,13751,7.48383e+12,57.0456,17087.7,35731,7334,72,20662,20662,19248,18848,17030
35926,5784,14111,22280,13646,7.86974e+12,57.5206,16217.5,35926,6874,72,21815,21815,16730,11010,9741
48528,7131,15476,30736,17792,8.80934e+12,58.6177,18430.4,48528,7522,72,33052,33052,25316,25086,15954
47988,8297,11405,31087,16901,9.84919e+12,59.9962,14619,47988,5547,72,36583,36583,32513,27774,27661
87930,19546,24210,56356,31574,9.36217e+12,59.4517,29335.9,87930,11790,72,63720,63720,57884,51069,50872
46147,2039,11708,29759,16388,9.63326e+12,59.7367,14767,46147,5690,72,34439,34439,21472,7385,5593
21347,7987,9357,13081,8266,7.26092e+12,56.684,10673.1,21347,4552,72,11990,11990,10838,9549,9613
98639,14937,26223,63379,35260,9.47968e+12,59.3887,31950,98639,12768,72,72416,72416,60223,43546,39585
30776,12832,16444,18325,12451,6.03239e+12,55.2258,17953.7,30776,8005,72,14332,14332,12929,11321,11486
98486,12677,22885,63867,34619,9.9152e+12,60.1407,28823.1,98486,11144,72,75601,75601,63329,46567,42588
75416,13215,23519,47842,27574,8.89065e+12,58.8694,27826.2,75416,11452,72,51897,51897,46360,45039,37126
43577,8306,12197,27897,15680,9.30231e+12,59.3269,15031.8,43577,5930,72,31380,31380,26959,26849,21676
27578,8724,10281,17213,10365,8.10126e+12,57.7517,12033.3,27578,4994,72,17297,17297,16249,14870,14658
51462,16707,21414,31705,19757,7.54605e+12,56.6927,24150.5,51462,10409,72,30048,30048,27014,24131,23526
3524,756,849,2281,1243,1.01476e+13,58.8621,1277.84,3524,412,64,2675,2675,2565,2542,2511
66839,2295,21573,42274,24565,8.74894e+12,58.28,25413.2,66839,10498,72,45266,45266,27824,27282,6482
10680,2989,3236,6795,3885,9.08973e+12,58.6669,4150.24,10680,1574,72,7444,7444,7219,7138,7034
99977,15653,32082,63274,36703,8.77352e+12,58.5821,37496.1,99977,15613,72,67895,67895,55149,37714,33561
56412,8202,13172,36578,19834,9.90807e+12,60.0848,16864.3,56412,6412,72,43240,43240,37318,35924,27409
68273,21749,21906,43215,25058,8.76489e+12,58.6956,25822,68273,10659,72,46367,46367,46214,46174,46074
75667,6088,17575,49078,26589,9.91174e+12,60.1213,22315.1,75667,8548,72,58092,58092,37526,23956,20869
7512,499,3925,4501,3011,6.19868e+12,54.6167,4455.64,7512,1899,72,3587,3443,2147,1042,928
31301,3180,7325,20300,11001,9.91244e+12,60.0006,9597.92,31301,3563,72,23976,23976,17894,12204,10636
59638,1655,16065,38280,21358,9.44118e+12,59.531,19783.3,59638,7822,72,43573,43573,25561,10354,3455
5157,1015,1236,3348,1809,1.00173e+13,59.0442,1799.1,5157,599,72,3921,3921,3605,3598,3401
13747,1405,3264,8912,4835,9.90156e+12,59.7298,4447.18,13747,1579,72,10483,10483,7832,5446,4835
75891,13615,17612,49220,26671,9.91971e+12,60.1268,22362.9,75891,8571,72,58279,58279,53486,52372,45497
73772,26348,33949,44871,28901,6.97251e+12,56.514,37400.6,73772,16532,72,39823,39823,36875,33529,33460
99633,1838,23141,64613,35020,9.91495e+12,60.1465,29142.1,99633,11269,72,76492,76492,45516,44883,7305
99072,13831,23004,64243,34829,9.91955e+12,60.1511,28975.1,99072,11206,72,76068,76068,65074,50057,46489
77150,6083,23821,48989,28161,8.94085e+12,58.916,28223.7,77150,11604,72,53329,53329,36012,35507,14847
94422,14494,47190,56765,37657,6.45784e+12,55.769,51170.6,94422,22975,72,47232,47232,31643,13426,12866
73766,4010,22188,46953,26813,9.03184e+12,59.0361,26472.2,73766,10804,72,51578,51578,33546,22400,11493
6261,45,2563,3870,2391,7.84218e+12,56.5799,3101.8,6261,1248,72,3097,999,2046,1247,267
90862,14868,35501,56375,34487,7.87289e+12,57.4605,40052,90862,17290,72,55361,55361,41655,25547,25079
56693,3860,21672,35275,21418,7.97897e+12,57.7035,24770.7,56693,10545,72,35021,35021,23165,9205,8834
54417,10635,13248,35178,19239,9.77582e+12,59.9253,16793.5,54417,6452,72,41169,41169,38705,35305,34682
91638,4210,40602,56014,35624,7.19296e+12,55.989,44852.4,91638,19757,72,51036,51036,24026,10908,5514
98504,23677,41132,60653,37851,7.52155e+12,56.7848,45825.4,98504,20016,72,57372,57372,45932,35044,32130
49460,11595,12193,31958,17502,9.734e+12,59.8304,15455.5,49460,5929,72,37267,37267,36419,35503,35543
42987,29920,42987,0,42987,7.99981,0,42987,42987,42987,1,0,0,0,0,0
96237,12814,22296,62410,33827,9.92416e+12,60.1597,28122.7,96237,10862,72,73941,73941,60077,46779,43072
32389,5641,11724,20270,12119,8.25607e+12,57.9716,13741.2,32389,5706,72,20665,20665,15483,9488,9324
45692,8459,16761,28541,17151,8.18823e+12,57.3062,19410.3,45692,8160,72,28931,28931,21778,13372,13239
83842,1931,19488,54372,29470,9.91848e+12,60.1269,24657.8,83842,9485,72,64354,64354,38844,38323,7391
63035,13507,19910,39952,23083,8.83561e+12,58.7951,23598.7,63035,9694,72,43125,43125,36203,28013,27894
77735,19510,21710,49761,27974,9.31187e+12,56.4395,26307.5,77735,10571,72,56025,56025,52878,52807,49172
59619,705,15013,38466,21153,9.6703e+12,59.7272,18802.7,59619,7310,72,44606,44606,12843,6330,1052
29705,411,1985,23677,6028,5.70633e+13,11.9933,2541.21,29705,1214,14,27720,27720,17914,11550,23290
17895,2509,5007,11462,6433,9.32747e+12,59.1822,6399.56,17895,2432,72,12888,12888,10643,7534,7023
83451,17741,19405,54115,29336,9.9056e+12,60.1208,24555.9,83451,9447,72,64046,64046,62022,61561,58766
16042,1951,5254,10142,5900,8.74127e+12,58.3025,6461.35,16042,2556,72,10788,10788,7489,4667,3913
65503,15457,19877,41655,23848,8.99675e+12,58.9847,23741.6,65503,9673,72,45626,45626,40539,34367,34414
30193,3181,7079,19580,10613,9.87697e+12,59.9506,9287.32,30193,3434,72,23114,23114,17734,16920,10657
21322,4345,9941,12959,8363,6.92293e+12,55.4981,11203,21322,4825,72,11381,11381,8631,5412,5509
66967,9909,35467,39913,27054,6.07871e+12,54.3443,38311.4,66967,17255,72,31500,31500,21236,11550,8988
38518,5803,13873,24115,14403,8.28353e+12,58.0252,16194.6,38518,6755,72,24645,24645,18774,11956,11756
89589,17958,20779,58095,31494,9.92388e+12,60.1533,26257,89589,10122,72,68810,68810,64734,60885,59882
67829,5080,28244,41792,26037,7.53329e+12,57.1905,31677.4,67829,13749,72,39585,39585,22963,11028,8230
45123,9187,10528,29260,15863,9.91764e+12,60.0768,13594.1,45123,5127,72,34595,34595,33050,31025,30601
90227,25261,36689,55733,34494,7.66407e+12,56.8706,41114.1,90227,17857,72,53538,53538,45438,35973,35653
36720,3290,8540,23813,12907,9.92604e+12,60.0751,11134.3,36720,4160,72,28180,28180,20496,14551,11154
83354,15914,26750,52756,30598,8.76606e+12,58.7274,31388.2,83354,13025,72,56604,56604,48990,38621,36178
5487,196,1383,3553,1934,9.70178e+12,58.7507,1969.21,5487,659,72,4104,4104,2490,1124,668
39177,169,1644,31016,8161,5.85661e+13,11.9953,2293.14,39177,1640,13,37533,37533,24279,12528,31637
73199,24751,32586,44721,28478,7.16671e+12,56.7479,36093.5,73199,15868,72,40613,40613,38563,35856,35271
61350,6710,20240,38727,22623,8.66177e+12,58.5727,23781.7,61350,9860,72,41110,41062,32716,24667,22503
61461,10565,14528,39816,21645,9.86546e+12,60.0477,18485,61461,7070,72,46933,46933,41189,41072,34259
19884,5948,8182,12272,7612,7.62359e+12,56.8087,9475.25,19884,3977,72,11702,11702,10181,8736,8558
14833,4519,5994,9170,5663,7.75063e+12,57.1526,7032.5,14833,2920,72,8839,8839,8634,8327,8467
10579,1248,2535,6862,3717,9.87466e+12,59.5691,3501.77,10579,1230,72,8044,8044,6146,4389,3989
27732,5869,10210,17328,10404,8.16863e+12,57.8561,11982.3,27732,4964,72,17522,17522,15035,11592,10998
11047,1941,2636,7163,3884,9.86776e+12,59.6637,3639.45,11047,1278,72,8411,8411,7564,6502,6315
4714,44,1845,2930,1784,7.94964e+12,47.2633,2298.81,4714,884,65,2373,725,701,393,0
8815,2500,4083,5362,3453,7.05195e+12,55.9602,4731.15,8815,1989,72,4732,4732,3422,1884,2057
11958,1146,2859,7757,4201,9.8286e+12,59.6247,3923.56,11958,1381,72,9099,9099,6333,6078,3643
15239,4762,7118,9259,5980,6.92955e+12,56.1297,8092.74,15239,3461,72,8121,8121,7016,5745,5925
25084,9557,16253,19665,5419,2.2342e+13,5.51981,18662.3,25084,5425,13,8831,8831,7887,8532,5659
6329,120,1509,4107,2222,9.95711e+12,59.2459,2166.43,6329,733,72,4820,4820,2788,2752,461
99033,4235,37221,61708,37325,8.06039e+12,57.865,42217.4,99033,18128,72,61812,61812,37170,15610,7132
94837,36333,39894,58349,36488,7.48308e+12,56.9031,44413.9,94837,19417,72,54943,54943,52835,50371,50501
19489,2327,4578,12638,6851,9.87607e+12,59.8519,6137.25,19489,2214,72,14911,14911,11607,8460,7694
40564,8143,9435,26314,14250,9.9094e+12,60.067,12250.5,40564,4589,72,31129,31129,29552,27487,27063
37706,3136,21150,22267,15439,5.69157e+12,54.8432,22841.5,37706,10297,72,16556,16556,9134,3662,1984
71816,11715,26625,44820,26996,8.12692e+12,57.9144,30456.8,71816,12967,72,45191,45191,33520,20823,17566
15303,6795,7563,9223,6080,6.56672e+12,54.4597,8506.61,15303,3662,72,7740,7740,7214,6597,6808
59214,5721,29110,35701,23513,6.56787e+12,55.9568,31847.7,59214,14172,72,30104,30104,17171,9092,6232
27484,753,6439,17815,9669,9.91519e+12,59.9982,8487.94,27484,3133,72,21045,21045,7740,8284,2850
30724,14992,16769,24091,6633,7.9862e+10,8.98705,17109.3,30724,15085,11,13955,13955,12812,12898,12745
76421,22941,24023,48450,27971,8.85551e+12,58.8198,28366.7,76421,11690,72,52398,52398,51152,49433,49220
36046,3952,8408,23376,12670,9.90707e+12,60.0333,10958.8,36046,4090,72,27638,27638,21866,20795,13273
71013,2752,20921,45275,25738,9.11411e+12,59.1337,25100.9,71013,10186,72,50092,50092,22163,13783,8760
35575,21140,35575,0,35575,7.99978,0,35575,35575,35575,1,0,0,0,0,0
80115,17629,18572,51957,28158,9.9211e+12,60.142,23550.1,80115,9042,72,61543,61543,60156,60130,58631
49769,17313,27125,29528,20241,5.88631e+12,54.3748,29299.2,49769,13208,72,22644,22644,19775,15811,15094
19522,2625,4589,12664,6858,9.87386e+12,59.8318,6148.88,19522,2222,72,14933,14933,12055,12003,8650
13516,3492,3899,8646,4870,9.24107e+12,58.9147,5007.04,13516,1895,72,9617,9617,9125,8547,8479
78611,8554,28351,49205,29406,8.25674e+12,58.0888,32542.8,78611,13807,72,50260,50260,35369,17931,17245
2035,275,511,1321,714,1.00426e+13,57.7803,797.909,2035,248,55,1524,1524,1244,962,958
9107,71,2141,5917,3190,9.91268e+12,59.5698,3009.64,9107,1037,72,6966,4656,1746,2030,251
94538,21712,30146,59865,34673,8.79196e+12,58.7649,35323.5,94538,14676,72,64392,64392,58034,50544,50455
53733,11045,23693,32870,20863,7.22711e+12,56.7851,26425.8,53733,11537,72,30040,30040,22277,13175,13013
16914,1118,3980,10977,5937,9.90205e+12,59.8401,5373.62,16914,1934,72,12934,12934,8808,8720,3886
13041,3499,6540,7837,5204,6.5297e+12,52.3047,7364.13,13041,3180,72,6501,6501,5228,3754,3929
46995,5814,12468,30209,16786,9.49854e+12,59.5662,15528.8,46995,6073,72,34527,34527,27180,18869,16768
50678,2969,11796,32864,17814,9.91445e+12,60.0884,15177.4,50678,5741,72,38882,38882,25992,25737,10195
52231,15032,25491,31516,20715,6.61976e+12,56.0305,27975,52231,12409,72,26740,26740,23740,19686,18794
11611,1778,3582,7388,4223,8.94848e+12,53.888,4550.77,11611,1723,72,8029,8029,7047,5958,6025
61001,851,19698,38594,22407,8.74861e+12,58.6733,23253.5,61001,9591,72,41303,41063,24253,23719,3413
85270,9678,19813,55304,29966,9.91398e+12,60.1359,25061.2,85270,9648,72,65457,65457,53279,36647,32687
72983,5335,16939,47332,25651,9.9183e+12,60.1341,21538,72983,8246,72,56044,56044,34221,20983,18369
17004,4735,6562,10584,6420,7.9632e+12,55.1363,7743.6,17004,3176,72,10442,10442,9394,8156,8340
1416,117,378,912,504,1.01226e+13,56.0756,593.267,1416,184,48,1038,1038,680,671,420
97019,33294,36145,60503,36516,8.10477e+12,57.4394,41077.4,97019,17603,72,60874,60874,58912,56613,56753
84934,21739,28962,53454,31480,8.50281e+12,58.3981,33555.1,84934,14093,72,55972,55972,50556,43085,41502
76805,36613,36842,46456,30349,6.71935e+12,55.5018,40303.7,76805,17926,72,39963,39963,39963,39963,39963
64892,5399,37878,38057,26835,5.38073e+12,53.3108,40386.9,64892,18433,72,27014,27014,14481,7292,4762
40607,3114,12147,25860,14747,9.0599e+12,59.0121,14762.3,40607,5911,72,28460,28460,16600,9432,7005
57449,6243,15999,36800,20649,9.31921e+12,59.371,19565.8,57449,7788,72,41450,41450,27498,28078,15163
7921,2590,7921,0,7921,7.99899,0,7921,7921,7921,1,0,0,0,0,0
70256,9039,20424,44839,25417,9.16382e+12,59.1918,24583.4,70256,9947,72,49832,49832,36781,21338,20899
89822,6860,20853,58253,31569,9.9172e+12,60.137,26339.6,89822,10153,72,68969,68969,43165,26800,23376
40452,1299,9400,26231,14221,9.9226e+12,60.0728,12206.8,40452,4574,72,31052,31052,19241,12826,4804
27854,6720,12491,17012,10842,7.15417e+12,56.5796,14084.8,27854,6082,72,15363,15315,12876,9434,8840
77173,14478,17958,50042,27131,9.90943e+12,60.1255,22776.8,77173,8742,72,59215,59215,55040,54064,48108
34953,1085,13835,21661,13292,7.84495e+12,57.4536,15883.4,34953,6739,72,21118,21118,10972,3706,1469
49958,17282,18908,31106,18852,8.04577e+12,57.7796,21713.6,49958,9210,72,31050,31050,30706,30328,30532
86849,13328,31949,54250,32599,8.15835e+12,57.9802,36468.2,86849,15556,72,54900,54900,43617,30474,29999
3691,431,905,2391,1300,9.8839e+12,58.5668,1346.91,3691,435,65,2786,2786,2204,2084,1453
46635,7140,10880,30234,16401,9.89763e+12,60.0595,14035.5,46635,5286,72,35755,35755,30350,30239,23825
3016,795,1418,1848,1168,7.01307e+12,43.8206,1713.81,3016,672,61,1598,1594,1594,1594,1598
13935,1567,3933,8927,5008,9.32972e+12,59.021,5073.92,13935,1911,72,10002,10002,6363,5962,2605
85659,31276,37935,52366,33293,7.19795e+12,56.7822,41945.3,85659,18478,72,47724,47724,44442,39915,39040
2302,503,576,1486,816,1.01105e+13,58.0613,889.01,2302,279,57,1726,1726,1640,1620,1637
74990,8951,74990,0,74990,7.99989,0,74990,74990,74990,1,0,0,0,0,0
32640,13135,17774,25591,7049,79861700000,8.99133,18125.7,32640,15991,11,14866,14866,11783,12038,11541
68544,4435,18311,44031,24513,9.46723e+12,59.5676,22501.1,68544,8913,72,50233,50233,33897,14624,13878
80208,8059,18650,52007,28201,9.91313e+12,60.1298,23628.3,80208,9079,72,61558,61558,46112,44103,27268
50051,8533,15867,31704,18347,8.82505e+12,58.7491,18906.8,50051,7727,72,34184,34184,28736,21330,19608
56016,12599,14953,35991,20025,9.46396e+12,59.5346,18491.4,56016,7270,72,41063,41063,39111,36498,35944
92950,18873,24991,59683,33267,9.43694e+12,57.2676,30413.1,92950,12152,72,67959,67959,65904,63190,62607
74084,14670,17265,48035,26049,9.90879e+12,60.1076,21914.1,74084,8407,72,56819,56819,53732,53008,48677
74324,12914,19356,47828,26496,9.55599e+12,59.6813,23877,74324,9423,72,54968,54968,48292,39218,37092
25317,392,5883,16420,8897,9.95643e+12,60.0092,7802.74,25317,2865,72,19434,19434,6037,6639,1624
26175,999,6759,16871,9304,9.59252e+12,59.5819,8679.41,26175,3286,72,19416,19416,12253,5072,3577
86973,19967,20200,56409,30564,9.90916e+12,60.1384,25540.8,86973,9834,72,66773,66773,66499,66439,66217
5793,783,2650,3541,2252,7.05734e+12,55.7198,3134.22,5793,1280,71,3143,3047,2332,1430,1428
76791,9239,32298,47255,29536,7.4821e+12,57.1379,36082.1,76791,15730,72,44493,44493,30660,17361,13791
21242,1360,4957,13782,7460,9.94215e+12,59.9482,6625.41,21242,2414,72,16285,16285,11066,10959,4796
86779,14619,27120,55056,31723,8.87799e+12,58.6446,31969.8,86779,13191,72,59659,59659,47188,30019,26097
16572,1120,3909,10755,5817,9.88402e+12,59.8272,5281.8,16572,1897,72,12663,12663,7078,4070,3617
32858,7802,9275,21024,11834,9.27861e+12,59.0732,11522.6,32858,4508,72,23583,23583,22008,19818,19528
25731,3760,12609,20085,5646,78540800000,8.98974,12942.1,25731,11344,11,13122,13122,6092,6960,5243
96155,16034,24191,62024,34131,9.66255e+12,59.8359,29884.2,96155,11780,72,71964,71964,60485,60237,46445
79417,15374,20103,51203,28214,9.65082e+12,58.4771,24928.1,79417,9787,72,59314,59314,53596,52268,44030
63886,2298,16251,41177,22709,9.63757e+12,59.7704,20256.2,63886,7917,72,47635,47635,29831,29392,8045
91126,8655,21207,59090,32036,9.91222e+12,60.1299,26757.9,91126,10327,72,69919,69919,51598,51233,29094
64257,2347,20982,40611,23646,8.69412e+12,58.6165,24679.6,64257,10216,72,43275,43227,24933,24549,2438
44437,6095,10371,28815,15622,9.92686e+12,60.0737,13398,44437,5052,72,34066,34066,28904,27706,20294
9127,1034,2222,5903,3224,9.8898e+12,59.5287,3084.68,9127,1078,72,6905,6905,5315,5272,3552
27591,4431,11021,17086,10505,7.77812e+12,57.3438,12712.9,27591,5360,72,16570,16570,11021,6980,5874
88149,2482,28926,55673,32476,8.6772e+12,58.6049,33742.1,88149,14083,72,59223,59223,31451,11745,5219
33412,13098,15508,20308,13104,6.93284e+12,56.3581,17308.5,33412,7548,72,17904,17904,17006,15753,15694
84655,26603,46951,50079,34576,5.75426e+12,54.5044,50250.1,84655,22850,72,37704,37704,33633,28014,26892
23966,7103,11600,14485,9481,6.68049e+12,56.0049,12948.6,23966,5646,72,12366,12318,12246,12109,12255
77633,40205,43106,45918,31715,5.74816e+12,54.9113,46171.9,77633,20983,72,34527,34527,33760,32799,32653
70982,12102,16489,46036,24946,9.9218e+12,60.1203,20974.8,70982,8029,72,54493,54493,48089,47963,40346
4470,549,1082,2903,1567,1.00328e+13,58.8423,1588.28,4470,522,70,3388,3388,2608,2594,1851
57438,2846,28685,34549,22889,6.46452e+12,55.2257,31323.4,57438,13952,72,28753,28753,17899,5365,4812
74536,13969,33352,45506,29030,7.13532e+12,56.6976,36899.7,74536,16234,72,41184,41184,31762,20791,20404
36929,9310,10136,23671,13258,9.37806e+12,59.3879,12625.9,36929,4933,72,26793,26793,26617,26557,26466
16380,2824,8376,9822,6558,6.3429e+12,54.3086,9343.79,16380,4058,72,8004,8004,6002,3735,3741
84709,17666,22818,54375,30334,9.43011e+12,59.5411,27822.7,84709,11101,72,61891,61891,55261,47391,47287
40571,3947,9429,26313,14258,9.94918e+12,60.0817,12238.6,40571,4593,72,31142,31142,23112,16498,13355
98239,6019,22770,63721,34518,9.91699e+12,60.1493,28701.6,98239,11087,72,75469,75469,51016,50529,20888
44775,5249,20723,27227,17548,6.94858e+12,56.4233,23002.8,44775,10090,72,24052,24052,15228,8269,6128
35721,10740,13461,22258,13463,8.05812e+12,57.0556,15606.8,35721,6535,72,22260,22260,20566,18577,18728
53275,10662,26102,41587,11688,78547900000,8.9933,26585.2,53275,23485,11,27173,27173,14925,16434,13430
94173,27814,50293,56055,38118,6.02266e+12,54.9662,54032.5,94173,24485,72,43880,43880,35153,23186,20458
84125,5367,24675,53650,30475,9.12769e+12,59.1646,29507.3,84125,12017,72,59450,59450,31741,29976,12362
79002,1597,3902,62663,16339,5.81219e+13,12.0016,4832.26,79002,2931,20,75100,75100,57281,42535,65390
59496,22040,25393,36537,22959,7.41445e+12,57.0267,28425.8,59496,12364,72,34103,34103,32057,29231,28794
98970,6995,26812,63506,35464,9.41355e+12,59.5336,32520.7,98970,13055,72,72158,72158,42410,26552,20246
57861,10081,13441,37527,20334,9.91999e+12,60.1026,17217.6,57861,6542,72,44420,44420,40387,39444,33700
36821,303,20379,21793,15028,5.78213e+12,54.3479,22064.2,36821,9921,72,16442,15482,6368,642,0
85955,19885,26594,54576,31379,8.92178e+12,58.9114,31421,85955,12952,72,59361,59361,52223,50498,40259
19995,2074,6158,12713,7282,8.94438e+12,57.9014,7629.61,19995,2977,72,13837,13837,9051,6883,6145
2948,212,737,1917,1031,1.00138e+13,58.1642,1109.74,2948,355,61,2211,2211,1167,779,680
96996,2245,22530,62891,34105,9.91524e+12,60.1517,28393.4,96996,10976,72,74466,74466,44873,44281,8374
28069,5285,9172,17736,10333,8.70764e+12,58.5157,11050.9,28069,4462,72,18897,18897,16385,13026,12304
66317,12631,15432,43006,23311,9.91142e+12,60.103,19665.7,66317,7508,72,50885,50885,46760,46687,41826
60350,12957,14070,39133,21217,9.91529e+12,60.0971,17978.3,60350,6850,72,46280,46280,44636,44605,42795
11713,3841,5186,7166,4547,7.2703e+12,56.4775,6013.55,11713,2526,72,6527,6527,6059,5411,5483
35875,6366,15286,22049,13826,7.43391e+12,56.9744,17296.3,35875,7444,72,20589,20589,15187,8945,8759
4111,539,1342,2614,1497,8.70292e+12,57.3342,1782.8,4111,640,71,2769,2769,1985,1618,1696
46548,9144,10811,30193,16355,9.91612e+12,60.0724,13966.2,46548,5249,72,35737,35737,33724,31054,30491
41222,6273,17994,25241,15981,7.28584e+12,55.9872,20212.1,41222,8761,72,23228,23228,16118,7819,7563
97148,26718,28597,61928,35220,9.11379e+12,59.1571,34056.2,97148,13926,72,68551,68551,65883,63389,62769
13329,2171,4641,8387,4942,8.46569e+12,57.9709,5667.37,13329,2256,72,8688,8688,6940,6859,5042
67645,1601,4381,53889,13756,5.71781e+13,11.997,5227.29,67645,2759,14,63264,63264,45981,33706,55455
76127,19014,31361,46948,29179,7.5958e+12,57.2761,35164.1,76127,15273,72,44766,44766,37553,29089,28959
47056,5861,10986,30512,16544,9.89963e+12,60.0533,14161.8,47056,5346,72,36070,36070,29977,21692,19760
84159,10330,40240,50928,33231,6.74602e+12,56.2268,43980.1,84159,19599,72,43919,43919,30437,14750,14298
28931,1842,12078,17821,11110,7.56479e+12,57.0889,13790.3,28931,5884,72,16853,16853,10393,6272,2741
29205,4511,8501,18651,10554,9.15632e+12,59.0831,10523.1,29205,4135,72,20704,20704,17008,16121,10885
26557,3720,7203,17047,9510,9.44362e+12,59.3898,9114.87,26557,3507,72,19354,19354,15990,15179,10447
88029,10589,25221,56238,31791,9.21623e+12,59.2745,30285.8,88029,12285,72,62808,62808,46746,46208,26768
37374,1795,16615,22834,14540,7.19273e+12,56.6943,18639.6,37374,8088,72,20759,20759,12307,2859,2202
84608,47000,84608,0,84608,7.99991,0,84608,84608,84608,1,0,0,0,0,0
8824,788,2133,5715,3109,9.90787e+12,59.5108,2971.97,8824,1038,72,6691,6691,4351,2782,2446
50260,4012,11977,32554,17706,9.83885e+12,59.9989,15314.5,50260,5830,72,38283,38283,25091,23986,13662
99749,10759,23841,64578,35171,9.82379e+12,60.035,29803.2,99749,11607,72,75908,75908,57907,57500,35813
80786,11153,36607,49243,31543,7.06288e+12,56.6003,40369.1,80786,17828,72,44179,44179,30885,15402,14800
17341,1768,4067,11245,6096,9.92001e+12,59.8976,5491.69,17341,1976,72,13274,13274,10112,9595,6111
45512,6477,26288,26743,18769,5.46392e+12,54.381,28196.4,45512,12784,72,19224,19224,11066,6570,5032
3302,178,871,2130,1172,9.79949e+12,58.1884,1269.79,3302,418,63,2431,2421,1522,1491,615
29106,4006,15822,17280,11826,5.91037e+12,53.4081,17248.9,29106,7685,72,13284,13284,8972,5304,4422
1547,68,411,1002,545,9.90952e+12,56.4021,642.395,1547,192,50,1136,700,399,208,276
20879,2713,6478,13269,7610,8.93253e+12,58.7131,7993.63,20879,3152,72,14401,14401,10259,7448,6712
34310,22639,34310,0,34310,7.99977,0,34310,34310,34310,1,0,0,0,0,0
16688,4009,4565,10707,5981,9.39018e+12,59.2118,5892.73,16688,2208,72,12123,12123,11339,10494,10541
85058,28769,32773,52862,32196,7.93636e+12,57.6973,37107.8,85058,15955,72,52285,52285,50601,48369,47918
49645,6250,11560,32193,17452,9.91489e+12,60.0864,14883.6,49645,5626,72,38085,38085,30315,30164,20879
13598,2476,5682,8371,5227,7.55721e+12,55.1077,6639.43,13598,2762,72,7916,7916,6099,4383,3983
96594,16958,41219,59319,37275,7.40578e+12,56.9105,45771.4,96594,20074,72,55375,55375,40584,24477,20240
31447,6870,7359,20392,11055,9.907e+12,59.9914,9639.56,31447,3583,72,24088,24088,23395,23380,22724
71883,28813,37684,56267,15616,79362900000,8.97984,38225.2,71883,33908,11,34199,34199,28520,28934,28119
68613,28110,34429,53612,15001,78821200000,8.99729,34971.7,68613,30984,11,34184,34184,29437,29965,28930
13251,894,3468,8536,4715,9.63932e+12,59.3706,4588.64,13251,1689,72,9783,9783,6163,3486,3125
33555,5948,7838,21756,11799,9.89815e+12,60.0145,10247.4,33555,3802,72,25717,25717,22953,22901,19697
22749,2534,6859,14476,8273,9.05904e+12,57.5105,8497.68,22749,3336,72,15890,15890,10171,6098,4823
45041,2864,10505,29206,15835,9.90743e+12,60.085,13573.1,45041,5113,72,34536,34536,19361,19103,9821
58039,6810,13536,37626,20413,9.90671e+12,60.0985,17320.3,58039,6588,72,44503,44503,36432,34543,22845
99798,7526,23180,64715,35083,9.9157e+12,60.146,29188.4,99798,11286,72,76618,76618,47533,29462,25699
31507,1539,11733,19664,11843,8.10894e+12,57.8137,13683.6,31507,5709,72,19774,19774,9657,3144,2411
11136,2155,2601,7230,3906,9.99212e+12,59.6483,3610.74,11136,1259,72,8535,8535,8016,7897,7308
73931,18750,36989,57760,16171,78834100000,8.99673,37553.6,73931,33286,11,36942,36942,22805,24477,21152
91437,5279,30694,57619,33818,8.58094e+12,58.4751,35617.2,91437,14947,72,60743,60743,38455,22147,16833
39253,1697,9621,25373,13880,9.76287e+12,59.8517,12320.5,39253,4678,72,29632,29632,19034,7371,6088
67805,4339,15763,43966,23839,9.91372e+12,60.1198,20079.6,67805,7673,72,52042,52042,29168,28948,14982
68232,13330,25880,42473,25759,8.01296e+12,57.5404,29512.6,68232,12593,72,42352,42352,33086,20418,17440
24732,280,12240,14897,9835,6.54239e+12,55.358,13600.4,24732,5945,72,12492,12060,7106,3971,770
29855,7099,27902,20546,9309,9.21173e+12,3.99039,27986.5,29855,9321,9,1953,1953,493,1953,500
11967,1503,2846,7750,4217,9.8917e+12,59.712,3911.41,11967,1381,72,9121,9121,7579,5560,5145
36292,2840,8506,23528,12764,9.90235e+12,60.0397,11070.2,36292,4143,72,27786,27786,17524,11028,9652
21598,1027,8606,13383,8215,7.8071e+12,57.3094,10003.1,21598,4182,72,12992,12947,8258,2941,2683
68712,29698,36410,40951,27761,6.07311e+12,55.3992,39313.1,68712,17729,72,32302,32302,29822,26514,25777
42503,13370,21789,25460,17043,6.31805e+12,55.6276,23807.5,42503,10615,72,20714,20714,17143,12213,11268
39247,8839,11815,24985,14262,9.0268e+12,58.9714,14354.2,39247,5745,72,27432,27432,25567,23102,22582
4804,898,1585,3035,1769,8.86251e+12,52.0156,2076.63,4804,766,68,3219,3219,2209,1123,1153
96443,32172,33221,60623,35820,8.46521e+12,58.3619,38316.9,96443,16180,72,63222,63222,62443,61604,61678
75566,8374,17582,48993,26573,9.91728e+12,60.1302,22313.3,75566,8564,72,57984,57984,46431,31876,28309
96322,12313,26399,61758,34564,9.3761e+12,59.4787,31952.4,96322,12857,72,69923,69923,52735,52323,31709
10331,691,5625,6138,4193,5.93528e+12,47.7569,6276.49,10331,2718,72,4706,4560,2814,648,10
57782,8999,31034,34363,23419,5.98382e+12,53.9707,33522.9,57782,15097,72,26748,26748,18504,11586,9696
77081,2104,17954,49986,27095,9.89931e+12,60.1123,22767.1,77081,8734,72,59127,59127,36045,23827,7611
46527,17402,24003,27846,18681,6.25986e+12,55.3521,26169.2,46527,11671,72,22524,22524,19126,15912,15222
43955,4587,10256,28503,15452,9.9196e+12,60.0685,13257.2,43955,4996,72,33699,33699,25924,17704,15540
37496,10824,14915,23229,14267,7.77161e+12,57.3988,17082.5,37496,7251,72,22581,22581,20128,16823,16106
71932,19406,22624,45602,26330,8.85561e+12,58.8046,26751.4,71932,11015,72,49308,49308,46607,42990,42183
42050,4753,16491,26086,15964,7.8579e+12,57.0401,18889.5,42050,8028,72,25559,25559,18108,11449,9158
81871,20274,24012,52216,29655,9.12419e+12,59.1573,28734.2,81871,11687,72,57859,57859,54641,53840,49319
24815,5085,10840,15199,9616,7.27581e+12,55.6188,12322.7,24815,5267,72,13975,13975,10531,6579,6516
85698,11699,28552,54058,31640,8.61073e+12,58.5358,33226.8,85698,13906,72,57146,57146,37563,14441,13552
1872,532,768,1169,703,7.88784e+12,54.1416,992.828,1872,366,48,1104,1104,789,505,560
63124,2907,14704,40930,22194,9.90254e+12,60.1002,18768.7,63124,7148,72,48420,48420,22655,11273,10159
92613,16043,36183,57464,35149,7.8712e+12,57.5782,40809,92613,17621,72,56430,56430,41358,24179,19896
44186,4392,12508,28254,15932,9.26722e+12,56.1077,15363.1,44186,6088,72,31678,31678,17317,16554,5392
45784,3851,10630,29699,16085,9.92032e+12,60.084,13738.5,45784,5169,72,35154,35154,25227,17801,13096
65120,5698,15315,42203,22917,9.87357e+12,59.9775,19473.9,65120,7449,72,49805,49805,36160,35874,19462
78238,16548,18201,50728,27510,9.90529e+12,60.1204,23076.6,78238,8858,72,60037,60037,58036,55362,54790
96786,18957,40080,59659,37127,7.57287e+12,57.2513,44720.2,96786,19520,72,56706,56706,45003,31268,30906
83654,8683,19438,54251,29403,9.91536e+12,60.1338,24600.6,83654,9464,72,64216,64216,49019,46807,29137
21986,2755,5131,14264,7722,9.91596e+12,59.956,6848.61,21986,2493,72,16855,16855,13340,13277,9171
26407,2410,6145,17130,9277,9.93269e+12,59.9895,8130.26,26407,2987,72,20262,20262,14830,14720,8308
71353,27259,29767,43946,27407,7.52719e+12,57.1754,33343.3,71353,14488,72,41586,41586,39704,37486,37628
39816,1999,20064,23914,15902,6.41662e+12,54.0277,22014.1,39816,9752,72,19752,19660,11171,1632,880
97031,2667,22564,62923,34108,9.90594e+12,60.1283,28427.7,97031,10980,72,74467,74467,45474,44893,9701
91572,38978,47447,54768,36804,6.22482e+12,55.597,51203.4,91572,23105,72,44125,44125,41413,37756,36960
6922,124,3133,4226,2696,7.13608e+12,55.5485,3688.55,6922,1514,72,3789,3693,1111,574,245
1788,243,470,1158,630,9.84553e+12,56.5643,727.874,1788,216,52,1318,1318,1019,1012,816
84408,10334,19605,54736,29672,9.92251e+12,60.1352,24802.7,84408,9551,72,64803,64803,51363,51083,34913
87209,4577,20243,56551,30658,9.92127e+12,60.1447,25594.1,87209,9855,72,66966,66966,33633,33949,16018
95195,27628,28494,60610,34585,9.04731e+12,59.0756,33826.6,95195,13871,72,66701,66701,65454,65430,64081
4160,19,1530,2619,1541,8.25793e+12,56.8029,1955.06,4160,738,69,1300,240,391,420,68
79126,12432,23470,50417,28709,9.09084e+12,59.1093,28037.9,79126,11429,72,55656,55656,45450,31430,28248
64898,12798,34882,38588,26310,5.97944e+12,55.2673,37610.7,64898,16988,72,30016,30016,20895,10254,10028
84698,25279,31840,52781,31917,8.06378e+12,57.6545,36214.5,84698,15494,72,52858,52858,49868,46381,46466
67474,10954,15681,43760,23714,9.9202e+12,60.1224,19979.7,67474,7638,72,51793,51793,46084,44757,36537
30560,4138,7145,19812,10748,9.92046e+12,60.0123,9376.19,30560,3474,72,23415,23415,19821,14978,13891
10394,2347,3697,6527,3867,8.41148e+12,57.717,4537.56,10394,1796,72,6697,6697,6048,5272,5156
54733,48638,54733,0,54733,7.99985,0,54733,54733,54733,1,0,0,0,0,0
67505,10207,15697,43775,23730,9.9157e+12,60.1164,19997.2,67505,7640,72,51808,51808,45151,43611,34002
43027,23093,43027,0,43027,7.99981,0,43027,43027,43027,1,0,0,0,0,0
34146,13652,16756,20588,13558,6.58438e+12,55.9516,18517.8,34146,8153,72,17390,17390,15982,14328,14494
28155,2492,6540,18263,9892,9.95103e+12,60.0114,8627.98,28155,3186,72,21615,21615,15733,11213,8641
50410,6473,11743,32698,17712,9.91094e+12,60.0876,15109,50410,5717,72,38667,38667,32382,30906,21853
60378,5640,14071,39152,21226,9.91775e+12,60.0995,17980.1,60378,6852,72,46307,46307,34002,24147,18944
53945,8636,12550,34987,18958,9.91663e+12,60.0902,16110.3,53945,6108,72,41395,41395,36677,30283,28824
77646,15861,18012,50364,27282,9.91498e+12,60.1338,22859.8,77646,8768,72,59634,59634,56997,53465,52699
28002,7578,9855,17576,10426,8.38378e+12,58.1033,11672.1,28002,4796,72,18147,18147,15982,13942,13509
52837,5731,12297,34274,18563,9.91236e+12,60.0886,15797.6,52837,5984,72,40540,40540,31026,22408,19428
58135,11939,13557,37696,20439,9.90256e+12,60.1,17349.8,58135,6597,72,44578,44578,42309,42253,39693
66115,6271,21203,41847,24268,8.76974e+12,58.7039,25015.8,66115,10324,72,44912,44912,31089,14767,14295
82668,4054,33963,51013,31655,7.60944e+12,57.0585,38046.7,82668,16525,72,48705,48705,29097,7134,5235
91209,8881,21164,59155,32054,9.91577e+12,60.1423,26726.6,91209,10304,72,70045,70045,52130,37251,30116
89086,2069,31846,55800,33286,8.29754e+12,57.8393,36530.2,89086,15492,72,57240,57240,34203,15918,6064
97956,5483,22764,63522,34434,9.91379e+12,60.1404,28673.5,97956,11087,72,75192,75192,39219,21557,19116
42299,6003,20447,25560,16739,6.6842e+12,55.4793,22559.1,42299,9944,72,21852,21852,14996,9312,7790
13122,369,3069,8519,4603,9.90865e+12,59.7181,4216.25,13122,1480,72,10053,10053,3635,3886,1322
71501,23444,28155,44325,27176,7.83704e+12,57.5699,31857.5,71501,13715,72,43346,43346,40481,36528,35817
94654,21883,28027,60311,34343,9.08711e+12,59.1323,33358.5,94654,13644,72,66627,66627,62363,56466,55280
4361,260,1052,2823,1538,9.95924e+12,58.9672,1553.14,4361,507,70,3309,3309,2155,2132,911
77152,23882,29944,47910,29242,7.90326e+12,57.3142,33924.2,77152,14565,72,47208,47208,43848,39981,39906
54860,5068,12743,35576,19284,9.93465e+12,60.1069,16352.9,54860,6207,72,42117,42117,29702,28670,17285
1910,156,562,1237,673,9.43811e+12,56.5545,823.315,1910,267,53,1348,1325,891,864,520
98790,3230,47236,59774,39016,6.74117e+12,56.19,51521.4,98790,22995,72,51554,51554,31560,15415,7462
31217,11790,18669,18224,12993,5.21961e+12,54.2504,20030.5,31217,9095,72,12548,12548,11053,9044,8703
19258,2602,5917,12236,7022,9.01322e+12,58.7548,7341.08,19258,2882,72,13341,13341,9951,6763,6090
49660,1600,11559,32204,17456,9.91196e+12,60.1003,14886.8,49660,5626,72,38101,38101,15204,15952,5938
90312,11800,20957,58568,31744,9.91991e+12,60.1443,26470.9,90312,10204,72,69355,69355,55970,43121,39583
94612,18520,47914,56778,37834,6.37286e+12,55.3353,51857.1,94612,23320,72,46698,46698,33147,19794,16256
35964,3433,8386,23320,12644,9.89818e+12,60.0195,10935.4,35964,4071,72,27578,27578,20483,20327,11873
59086,17263,23475,36605,22481,7.79262e+12,57.4875,26617.1,59086,11432,72,35611,35611,30139,23698,23653
67190,7104,26580,41637,25553,7.80762e+12,57.0317,30089,67190,12928,72,40610,40610,24401,12908,9258
6938,840,2626,4329,2609,8.10133e+12,55.3745,3236.88,6938,1258,72,4312,4264,3405,2437,2477
95705,21524,33801,60013,35692,8.35692e+12,58.2281,38803.2,95705,16467,72,61904,61904,53722,42465,39954
72371,15289,17072,46887,25484,9.8843e+12,60.0734,21612.5,72371,8316,72,55299,55299,53206,50430,49850
33779,5178,8243,21840,11939,9.78183e+12,59.8623,10635.1,33779,4009,72,25536,25536,22199,21398,16719
17282,2498,4062,11216,6066,9.91289e+12,59.8715,5480.01,17282,1976,72,13220,13220,11307,8780,8244
55858,54083,55858,0,55858,7.99986,0,55858,55858,55858,1,0,0,0,0,0
18453,8830,10320,14483,3970,80166200000,8.98927,10576.1,18453,9279,11,8133,8133,7201,7265,7158
3848,716,1953,2312,1536,6.63815e+12,51.6286,2287.37,3848,945,61,1895,1847,1381,898,1005
45606,20666,22424,27489,18117,6.573e+12,55.2138,24640.7,45606,10908,72,23182,23182,22231,20902,20820
7769,1729,1886,5033,2736,9.86528e+12,59.401,2652,7769,913,72,5883,5883,5661,5656,5546
93894,25225,41289,57450,36444,7.23779e+12,56.8392,45643.2,93894,20105,72,52605,52605,43941,33793,33581
6148,973,2099,3882,2266,8.68005e+12,57.6291,2677.78,6148,1018,72,4049,4049,3579,3572,3255
77850,4909,18119,50482,27368,9.91072e+12,60.1188,22971,77850,8818,72,59731,59731,40463,40081,16763
48514,10103,11298,31451,17063,9.91493e+12,60.087,14558.3,48514,5504,72,37216,37216,35583,35538,33756
38643,3093,15080,23989,14654,7.88954e+12,57.5389,17320.5,38643,7336,72,23563,23563,14635,4135,3894
67963,10855,15801,44083,23880,9.9136e+12,60.1246,20126.7,67963,7696,72,52162,52162,44937,44795,36157
30667,151,7184,19891,10776,9.88614e+12,59.9867,9422.24,30667,3489,72,23483,23429,13282,13073,822
43810,5725,19598,26756,17054,7.15338e+12,56.6588,21888.5,43810,9540,72,24212,24212,16025,11521,9828
8902,29,2843,5642,3260,8.84939e+12,58.1873,3626.59,8902,1372,72,3914,653,1461,801,69
38702,8711,9013,25109,13593,9.90933e+12,60.0562,11720,38702,4386,72,29689,29689,29327,29246,28897
29531,2754,8742,18822,10709,9.11266e+12,59.0302,10771.3,29531,4255,72,20789,20789,13478,8596,7154
93771,16320,21817,60806,32965,9.90529e+12,60.1263,27510,93771,10616,72,71954,71954,65416,56499,54422
63352,10591,30078,38364,24988,6.79291e+12,55.7016,33050.3,63352,14648,72,33274,33274,22094,9057,8609
87242,18653,29303,54987,32255,8.57065e+12,58.4852,34033.6,87242,14263,72,57939,57939,48730,37864,37628
94392,6205,24363,60783,33609,9.58135e+12,59.7308,29921.8,94392,11865,72,70029,70029,46755,46189,18205
34625,2380,11083,21916,12709,8.80492e+12,58.3906,13324.6,34625,5392,72,23542,23542,13206,8405,6527
47363,6059,16786,29698,17665,8.34294e+12,58.1624,19561.8,47363,8172,72,30577,30577,22098,22196,12744
55162,5425,12819,35773,19389,9.93173e+12,60.1078,16444.5,55162,6245,72,42343,42343,31594,31373,18468
86638,16762,20126,56180,30458,9.90818e+12,60.1319,25448.7,86638,9790,72,66512,66512,62406,61462,55568
27417,3944,10833,16997,10420,7.82747e+12,56.8088,12530.7,27417,5254,72,16584,16584,12497,8148,7202
33377,8891,9268,21386,11991,9.33844e+12,59.3185,11552.6,33377,4508,72,24109,24109,24027,23979,24011
50694,6636,20819,31275,19419,7.62665e+12,57.2763,23538.9,50694,10142,72,29875,29875,19988,11685,9220
2102,589,793,1329,773,8.24022e+12,48.2103,1050.41,2102,365,56,1309,1309,1309,1309,1309
7867,1125,1856,5107,2760,9.95904e+12,59.4544,2632.37,7867,898,72,6011,6011,4936,3948,3805
86828,11228,20165,56316,30512,9.91582e+12,60.1371,25495.4,86828,9820,72,66663,66663,55866,53354,37630
42032,3041,16586,26053,15979,7.82087e+12,56.6287,18975.2,42032,8064,72,25446,25446,16512,5997,5776
23062,194,5441,14947,8115,9.89635e+12,59.821,7217.6,23062,2644,72,17621,17621,9940,6298,613
91376,26008,35298,56765,34611,7.92192e+12,57.5426,39899.8,91376,17182,72,56078,56078,48531,39716,39422
89396,11550,20750,57982,31414,9.91676e+12,60.1398,26215.7,89396,10105,72,68646,68646,57524,54940,38736
62496,401,14567,40531,21965,9.90201e+12,60.093,18595,62496,7085,72,47929,47929,27346,26925,2011
68113,2023,4246,54216,13897,5.73452e+13,12.0019,5103.5,68113,1925,20,63867,63867,48649,36952,50678
48813,8245,11370,31651,17162,9.90951e+12,60.0872,14648,48813,5531,72,37443,37443,33627,32751,27287
95091,21438,34478,59469,35622,8.23328e+12,57.7391,39392.1,95091,16791,72,60613,60613,50657,36942,33869
40265,4687,18962,24425,15840,6.85251e+12,55.7727,21029,40265,9221,72,21303,21303,14279,6077,5941
28040,2267,7666,17987,10053,9.39493e+12,59.3546,9659.94,28040,3729,72,20374,20374,11038,11433,5341
22004,354,929,17420,4584,5.85603e+13,11.9908,1412.48,22004,925,13,21075,21075,15929,11384,18782
73330,10023,28422,45535,27795,7.91638e+12,57.6692,32234.7,73330,13845,72,44908,44908,32564,18035,17641
59749,5532,13939,38749,21000,9.90115e+12,60.0321,17817.1,59749,6770,72,45810,45810,33677,33435,18827
88310,24353,35488,54629,33681,7.7339e+12,57.4477,39856.8,88310,17289,72,52822,52822,43388,32268,32020
62648,294,28701,38133,24515,7.01415e+12,56.5276,31718.9,62648,13982,72,33947,32977,13943,4868,1060
44275,5780,13452,28158,16117,9.00167e+12,58.3766,16243.5,44275,6536,72,30823,30823,23395,14706,14421
17629,2038,6171,11079,6550,8.40572e+12,58.0045,7442.33,17629,2992,72,11458,11458,7895,3777,3681
58563,392,22470,36418,22145,7.96885e+12,57.7099,25647.8,58563,10946,72,36093,35325,16607,1844,1868
91767,7665,27940,58340,33427,8.98313e+12,56.6101,33077.8,91767,13595,72,63827,63827,38794,24670,19250
96093,19861,22335,62309,33784,9.91687e+12,60.14,28146.9,96093,10881,72,73758,73758,70216,66875,66018
83775,18252,19614,54302,29473,9.89763e+12,60.111,24770.3,83775,9554,72,64161,64161,62491,60295,59853
39219,6302,10479,25195,14024,9.49605e+12,59.5244,13110.2,39219,5105,72,28740,28740,23653,17633,17611
28536,6277,9598,17987,10549,8.59475e+12,58.3813,11480.3,28536,4674,72,18938,18938,16688,16113,13044
91479,18001,22424,59119,32360,9.75608e+12,59.9407,27915.8,91479,10924,72,69055,69055,64148,57502,55959
34440,1196,9453,22081,12359,9.37992e+12,59.3765,11803.6,34440,4599,72,24987,24987,10220,9236,2127
34867,7456,13915,21595,13272,7.76708e+12,57.3963,15956.5,34867,6773,72,20952,20952,16560,16403,11341
50812,1710,13576,32651,18161,9.46937e+12,59.5401,16836.7,50812,6610,72,37236,37236,22649,14717,4802
88074,24312,27315,55902,32172,8.90857e+12,58.9018,32238.5,88074,13302,72,60759,60759,56889,52181,52354
48207,11819,24381,37678,10529,78897100000,8.99558,24832.5,48207,21936,11,23826,23826,14265,15359,13189
26012,5818,6043,16876,9136,9.95236e+12,60.0062,8004.48,26012,2944,72,19969,19969,19650,19403,19431
30960,12383,15300,18650,12310,6.54665e+12,54.508,16922.8,30960,7443,72,15660,15660,14277,12354,12128
51397,5306,26373,30784,20613,6.29634e+12,55.3936,28729.9,51397,12842,72,25024,25024,16261,8866,5770
31616,2749,7387,20502,11114,9.91234e+12,60.0193,9681.41,31616,3593,72,24229,24229,17475,17341,9284
74149,4847,34198,45089,29060,6.96003e+12,56.0599,37659.5,74149,16640,72,39951,39951,25914,13275,9769
30951,2190,7172,20082,10869,9.95997e+12,60.0398,9427.41,30951,3494,72,23779,23779,14118,8679,7665
71671,3505,16653,46487,25184,9.91375e+12,60.1225,21179.2,71671,8108,72,55018,55018,26578,13610,12208
31308,1227,9990,19827,11481,8.81302e+12,58.6719,12060.5,31308,4862,72,21318,21318,11000,10503,4287
22028,1316,5792,14179,7849,9.51092e+12,59.4434,7459.02,22028,2807,72,16236,16236,10833,4498,4323
10652,2371,3358,6766,3886,8.95344e+12,58.4365,4255.21,10652,1634,72,7294,7294,6597,5865,5928
69058,25988,29838,42340,26718,7.34151e+12,56.8437,33243.4,69058,14530,72,39220,39220,36748,33447,32741
41329,11355,17089,25483,15846,7.58291e+12,56.3603,19387.2,41329,8303,72,24240,24240,21753,18312,17718
74130,41485,74130,0,74130,7.99989,0,74130,74130,74130,1,0,0,0,0,0
20384,1678,6254,12950,7434,8.98226e+12,58.0066,7748.41,20384,3041,72,14130,14130,9715,4588,4443
78384,2042,3334,62055,16329,5.85368e+13,12.0019,4263.95,78384,2478,20,75050,75050,63482,53377,69888
43719,8095,16648,27200,16519,8.01235e+12,57.7363,19158.2,43719,8107,72,27071,27071,20939,13677,13601
96757,21664,44533,58849,37908,6.97082e+12,55.9588,48866.9,96757,21672,72,52224,52224,41515,28983,28672
44880,5414,23115,26863,18017,6.27455e+12,55.5914,25219.4,44880,11256,72,21765,21765,14883,8388,6754
33526,2431,7829,21744,11782,9.90656e+12,60.017,10234.9,33526,3808,72,25697,25697,17797,17644,8182
12412,1879,2952,8047,4365,9.90271e+12,59.6675,4043.57,12412,1435,72,9460,9460,8245,7947,6375
57501,7796,18107,36451,21050,8.85649e+12,58.7966,21524.3,57501,8815,72,39394,39394,28332,15343,14859
94283,43208,50023,73838,20445,79513500000,8.99755,50639,94283,45012,11,44260,44260,39680,40071,39303
53965,2679,12550,35000,18965,9.92331e+12,60.0946,16110.6,53965,6110,72,41415,41415,27085,26789,9531
1411,30,533,888,523,8.45025e+12,50.4706,727.49,1411,238,47,582,105,308,233,74
22636,2514,5279,14682,7954,9.93207e+12,59.9598,7035.24,22636,2566,72,17357,17357,13911,13236,8630
43251,1431,10120,28045,15206,9.88457e+12,60.032,13082.3,43251,4914,72,33131,33131,13215,13782,4980
8597,639,2079,5566,3031,9.87275e+12,59.4536,2903.44,8597,1006,72,6518,6518,3822,3848,2210
22797,814,11170,13744,9053,6.6244e+12,54.4762,12453.9,22797,5436,72,11627,11456,6630,2134,757
1718,63,443,1116,602,9.91442e+12,57.3091,697.027,1718,211,53,1240,669,414,169,227
91806,1243,31734,57689,34117,8.45366e+12,58.346,36609.4,91806,15460,72,60072,60072,24204,9824,2880
79366,16788,18468,51467,27899,9.91281e+12,60.1276,23400.8,79366,8989,72,60898,60898,58548,56353,55817
12735,324,3027,8256,4479,9.8969e+12,59.696,4143.64,12735,1468,72,9708,9708,5812,5728,1177
66679,10539,17883,42820,23859,9.45109e+12,59.5565,21975.3,66679,8704,72,48796,48796,40981,39079,27844
56202,41700,52522,38703,17499,9.2069e+12,3.99416,52639.4,56202,17530,9,3680,3680,2923,3680,2930
53550,9174,12442,34725,18825,9.92334e+12,60.1119,15984.5,53550,6059,72,41108,41108,36375,36275,30708
78340,20414,37983,47313,31027,6.65295e+12,55.9256,41473.2,78340,18482,72,40357,40357,32045,24169,22135
28392,2397,10756,17682,10710,8.03853e+12,57.152,12537.3,28392,5223,72,17636,17636,11399,4080,3964
6436,2593,3851,3769,2667,5.38035e+12,52.9599,4267.41,6436,1871,71,2585,2585,1951,1235,1442
96507,12430,35413,60292,36215,8.1714e+12,58.0015,40363,96507,17240,72,61094,61094,44087,27000,22454
83585,11917,26101,53026,30559,8.88438e+12,58.8685,30798.8,83585,12713,72,57484,57484,46437,31669,28118
73647,15844,37707,44116,29531,6.31358e+12,55.3119,40874,73647,18364,72,35940,35940,27555,18872,16725
39931,8989,9286,25892,14039,9.92407e+12,60.0726,12063.2,39931,4518,72,30645,30645,30225,30216,29907
23401,3023,5464,15186,8215,9.89886e+12,59.9543,7268.13,23401,2656,72,17937,17937,14326,14263,10023
91384,10789,21208,59264,32120,9.91541e+12,60.1432,26783.2,91384,10324,72,70176,70176,55042,40506,36479
39032,10533,13743,24491,14541,8.37819e+12,58.1713,16118.9,39032,6690,72,25289,25289,23281,20578,20057
93844,11690,21828,60851,32993,9.90963e+12,60.1304,27523.5,93844,10623,72,72016,72016,59869,43240,39291
1532,484,1106,878,654,4.07603e+12,47.4478,1218.54,1532,533,39,426,381,181,45,201
4289,554,2059,2612,1677,6.75265e+12,49.5211,2436.47,4289,981,69,2230,2182,1962,1786,1797
42197,21991,23724,24917,17280,5.65117e+12,54.5398,25570.8,42197,11545,72,18473,18473,17593,16752,16750
45938,2251,16734,28730,17208,8.23079e+12,57.9979,19401.7,45938,8151,72,29204,29156,15494,15852,7687
57161,11045,14442,36866,20295,9.65411e+12,59.7954,18101.4,57161,7031,72,42719,42719,38664,38560,33842
35141,15225,15850,21446,13695,7.10067e+12,56.5657,17760.2,35141,7713,72,19291,19291,19156,18943,19074
50160,15153,16992,31592,18568,8.54279e+12,58.3926,19955,50160,8273,72,33168,33168,32416,32224,31316
42296,3105,20828,25489,16807,6.5639e+12,55.532,22912.3,42296,10128,72,21468,21468,8642,4596,2466
19806,186,6047,12602,7204,9.02904e+12,58.7904,7507.49,19806,2945,72,13759,13615,7887,4307,828
13826,3972,4692,8704,5122,8.58198e+12,57.4181,5757.83,13826,2280,72,9134,9134,8340,7409,7609
34971,8272,18695,27396,7575,79616600000,8.97138,19064.7,34971,16822,11,16276,16276,8977,9672,8296
1517,153,394,983,534,1.0103e+13,56.851,624.687,1517,189,50,1123,1123,742,540,540
27143,5558,6976,17487,9656,9.60088e+12,59.5197,8957.68,27143,3379,72,20167,20167,18550,18168,15970
89655,10640,20882,58139,31516,9.90398e+12,60.1264,26358.7,89655,10163,72,68773,68773,53914,53608,35678
11283,799,3147,7234,4049,9.409e+12,58.9528,4120.05,11283,1528,72,8136,8136,5656,5580,2777
16159,426,4584,10343,5816,9.2756e+12,59.0795,5864.6,16159,2227,72,11575,11527,7016,3257,1572
68877,14338,15997,44666,24211,9.91608e+12,60.1357,20375.9,68877,7792,72,52880,52880,50855,48164,47577
2206,848,1272,1315,891,5.72713e+12,34.2389,1472.93,2206,599,53,934,934,934,934,934
28173,288,6618,18272,9901,9.8897e+12,59.9329,8704.37,28173,3211,72,21555,21555,6099,6831,1234
63538,2610,14783,41197,22341,9.91825e+12,60.1165,18869.1,63538,7196,72,48755,48755,21795,10367,9449
22049,4433,5214,14288,7761,9.88755e+12,59.8863,6925.68,22049,2539,72,16835,16835,15998,15784,14756
97873,18154,43003,59886,37987,7.23944e+12,56.8538,47519.3,97873,20940,72,54870,54870,40512,25669,21811
52936,1069,20330,32915,20021,7.94746e+12,57.6701,23253.4,52936,9889,72,32606,32403,17087,6699,3305
94659,4154,26978,60508,34151,9.23051e+12,59.3051,32380.3,94659,13136,72,67681,67681,32626,30793,11768
53430,5849,12429,34653,18777,9.92437e+12,60.0838,15959.2,53430,6048,72,41001,41001,31476,31280,19858
15229,1408,3579,9868,5361,9.9533e+12,59.8651,4863.3,15229,1743,72,11650,11650,8291,5578,4908
55126,27151,33222,32157,22969,5.13677e+12,53.8603,35338.1,55126,16164,72,21904,21904,20617,18826,18632
82285,270,19573,53271,29014,9.84574e+12,60.0537,24632.8,82285,9532,72,62712,62639,16208,18286,1868
82859,14704,32196,51440,31419,7.89346e+12,57.091,36418.9,82859,15670,72,50663,50663,38271,24677,21108
65513,8759,15237,42479,23034,9.91393e+12,60.1127,19431,65513,7416,72,50276,50276,42431,40611,29198
2983,719,2198,1687,1296,3.61728e+12,45.3875,2376.01,2983,1050,53,785,737,546,443,572
47639,9431,11768,30772,16867,9.72472e+12,59.8592,14932.9,47639,5721,72,35871,35871,32433,32372,28339
96801,22335,22492,62770,34031,9.9205e+12,60.1425,28339.3,96801,10957,72,74309,74309,74129,74085,73986
1690,272,443,1101,589,1.00761e+13,56.7178,689.799,1690,211,51,1247,1247,1022,1018,897
26633,10867,11719,16307,10326,7.227e+12,56.675,13278.4,26633,5694,72,14914,14914,14394,13645,13707
57214,3985,17091,36426,20788,9.05979e+12,58.9742,20562.7,57214,8319,72,40123,40123,20983,11672,7819
9970,2630,3537,6257,3713,8.39951e+12,57.656,4353.46,9970,1714,72,6433,6433,6294,6058,6190
70752,1147,22460,44825,25927,8.82271e+12,58.7689,26511.5,70752,10939,72,48292,48244,18963,9810,4507
55834,425,18993,35152,20682,8.53112e+12,58.3975,22223.8,55834,9252,72,36841,36793,21177,20858,1962
23776,4130,9625,14693,9083,7.71861e+12,57.2675,11120,23776,4687,72,14151,14151,10784,6837,6905
8217,2386,3513,5053,3164,7.46209e+12,44.5571,4164.37,8217,1694,72,4704,4704,4704,4704,4704
80316,1077,24658,51025,29291,8.94915e+12,54.2734,29231.9,80316,11992,72,55658,55658,17257,4225,4433
76369,16245,29341,47483,28886,7.96189e+12,57.6236,33304,76369,14277,72,47028,47028,39871,31521,31311
35355,6578,10869,22466,12889,8.95648e+12,58.8497,13179.9,35355,5289,72,24486,24486,20193,15223,15101
52113,7096,12129,33803,18310,9.91382e+12,60.0876,15588.7,52113,5905,72,39984,39984,32736,32578,23959
86675,6048,20131,56203,30472,9.91377e+12,60.1377,25454.1,86675,9801,72,66544,66544,39338,23561,20621
50383,15934,16558,31821,18562,8.6712e+12,58.5563,19569.5,50383,8061,72,33825,33825,33565,33318,33458
32662,10053,14293,20013,12649,7.27883e+12,55.7957,16130.1,32662,6945,72,18369,18369,16410,13695,13277
60468,9894,14232,39175,21293,9.88656e+12,60.0734,18139.5,60468,6929,72,46236,46236,40998,33896,32255
74146,6111,19410,47700,26446,9.53675e+12,59.6545,23912.3,74146,9453,72,54736,54736,38254,37837,18112
32285,5717,15011,19624,12661,6.91123e+12,55.0143,16762.6,32285,7290,72,17274,17274,12187,6646,5241
28702,13597,14632,17211,11491,6.34953e+12,54.8566,16123.4,28702,7121,72,14070,14070,12963,11663,11844
37998,6548,8842,24642,13356,9.94683e+12,60.0699,11503.2,37998,4307,72,29156,29156,26394,22610,21905
37874,8623,8885,24555,13319,9.89351e+12,60.0163,11537.9,37874,4322,72,28989,28989,28725,28702,28584
32045,5069,16215,19233,12812,6.39592e+12,54.8715,17849.5,32045,7888,72,15830,15830,10715,5874,4720
21903,306,7281,13821,8082,8.66367e+12,58.3826,8811.07,21903,3546,72,14622,14430,8350,4160,882
30724,1473,9630,19488,11236,8.86992e+12,58.7358,11684,30724,4677,72,21094,21094,13038,12801,3268
68871,20398,30900,42032,26839,7.12247e+12,56.4799,34218.3,68871,15044,72,37971,37971,33994,28505,27402
68291,1446,15877,44295,23996,9.9138e+12,60.1175,20219.8,68291,7731,72,52414,52414,31307,30895,5331
16913,3587,6875,10447,6466,7.70389e+12,56.8893,8021.78,16913,3343,72,10038,10038,8586,6564,6323
97497,45248,50785,58265,39232,6.18431e+12,55.0567,54728.3,97497,24718,72,46712,46712,45281,43292,43050
15089,175,3552,9780,5309,9.93301e+12,59.8423,4828.33,15089,1725,72,11537,11526,3296,623,760
73309,2151,17031,47546,25763,9.91101e+12,60.1162,21643.1,73309,8287,72,56278,56278,21679,22884,8001
31976,5620,7476,20736,11240,9.9073e+12,60.0001,9787.19,31976,3638,72,24500,24500,21869,21804,18812
44510,10851,18572,27412,17098,7.53832e+12,56.9862,20997.8,44510,9042,72,25938,25938,20696,14621,14474
86279,4352,20042,55948,30331,9.90992e+12,60.1357,25346.4,86279,9749,72,66237,66237,32560,32981,15246
3440,271,1904,2044,1396,5.9415e+12,34.5366,2194.29,3440,904,60,1536,1536,884,60,0
25634,17358,25634,0,25634,7.99969,0,25634,25634,25634,1,0,0,0,0,0
3322,579,819,2163,1159,9.95483e+12,58.401,1226.8,3322,396,63,2503,2503,2217,2154,1918
15305,977,3613,9925,5380,9.90433e+12,59.7897,4901.35,15305,1754,72,11692,11692,7894,7811,3387
64328,10301,16777,41390,22938,9.54937e+12,59.666,20777.2,64328,8167,72,47551,47551,40283,38544,28094
11058,1724,2570,7172,3886,1.0011e+13,59.801,3578.77,11058,1249,72,8488,8488,7243,7219,5904
99064,32966,44569,60441,38623,7.10085e+12,56.5962,49060.4,99064,21691,72,54495,54495,52248,49137,48623
16644,382,6077,10411,6233,8.28816e+12,57.7784,7264.59,16644,2959,72,10567,10375,4015,3682,574
6712,1036,3431,4040,2672,6.3449e+12,54.9964,3929.62,6712,1665,70,3281,3233,2404,1572,1572
97939,22075,31847,61908,36031,8.7127e+12,58.67,37140.6,97939,15509,72,66092,66092,54975,41890,41410
22808,1835,6218,14634,8174,9.40926e+12,58.2941,7915.86,22808,3018,72,16590,16590,9723,9502,4716
53030,13280,14876,33951,19079,9.29285e+12,59.3275,18204.8,53030,7237,72,38154,38154,35875,35828,33315
53966,8502,12599,34983,18983,9.90996e+12,60.0935,16160,53966,6134,72,41367,41367,35511,35378,28461
69568,5737,27549,43098,26470,7.80994e+12,57.5184,31156,69568,13414,72,42019,42019,22891,12064,8107
3194,369,1072,2026,1168,8.53612e+12,56.5942,1434.81,3194,507,62,2122,2111,1295,726,772
62644,13059,22269,39273,23371,8.31989e+12,58.157,25759.1,62644,10843,72,40375,40375,34528,26467,24754
44146,2551,10301,28620,15526,9.91532e+12,60.0734,13315.3,44146,5012,72,33845,33845,22557,15480,8769
28165,1580,8807,17875,10290,8.90954e+12,58.7339,10720.5,28165,4285,72,19358,19358,11732,2814,2508
82072,35726,45821,64417,17655,80178900000,8.9755,46371.5,82072,41232,11,36251,36251,30078,30454,29720
90364,13114,37436,55701,34663,7.57074e+12,57.2486,41812.9,90364,18237,72,52928,52928,33992,19658,15233
81502,3484,19225,52803,28699,9.86381e+12,60.0743,24256.9,81502,9352,72,62277,62277,27359,28075,11124
16806,1664,5963,10544,6262,8.41101e+12,57.9452,7175.38,16806,2905,72,10843,10843,7004,2572,2465
64020,15620,18163,40932,23088,9.25822e+12,56.0734,22045.1,64020,8843,72,45857,45857,42203,42123,37881
44277,6674,10416,28692,15585,9.886e+12,60.0524,13433,44277,5073,72,33861,33861,29359,28315,21889
35183,154,8217,22819,12364,9.90402e+12,60.0081,10717.8,35183,3990,72,26966,26920,15244,15008,897
8162,4399,4487,4852,3310,5.84371e+12,51.7547,5029.4,8162,2163,72,3675,3675,3675,3675,3675
54806,1215,23817,33584,21222,7.3186e+12,56.8886,26616.3,54806,11603,72,30989,30989,18121,11586,2579
82834,10670,19184,53720,29114,9.92445e+12,60.1508,24307.7,82834,9342,72,63650,63650,51225,39316,36012
33651,4896,11504,21185,12466,8.50332e+12,58.2954,13637.7,33651,5599,72,22147,22147,15960,8764,8527
70852,14178,16458,45954,24898,9.92001e+12,60.1289,20938.3,70852,8016,72,54394,54394,51694,51058,47273
73323,10427,29547,45340,27983,7.71202e+12,56.4744,33283.1,73323,14372,72,43776,43776,29909,13550,13074
16077,1792,3779,10419,5658,9.92295e+12,59.8715,5119.36,16077,1837,72,12298,12298,9472,9405,6178
84484,40228,45659,50184,34300,5.9472e+12,55.2454,49033,84484,22243,72,38825,38825,36209,33157,33262
1149,917,1149,590,559,208619000,0,1149,1149,560,21,0,0,0,0,0
78353,14454,21362,50259,28094,9.39072e+12,59.4907,26026.4,78353,10400,72,56991,56991,50323,48717,39138
18886,3536,5140,12114,6772,9.43909e+12,59.3314,6601.94,18886,2502,72,13746,13746,11962,9870,10019
50373,2303,16753,31777,18596,8.62213e+12,58.0278,19753.4,50373,8149,72,33620,33620,20811,6647,5250
12471,2242,2965,8091,4380,9.90151e+12,59.6913,4063.27,12471,1441,72,9506,9506,8720,7735,7579
69589,964,16246,45121,24468,9.88816e+12,60.0835,20654.8,69589,7900,72,53343,53343,31108,30659,3714
46540,8276,14743,29487,17053,8.82e+12,58.7315,17607.5,46540,7167,72,31797,31797,26571,25278,17839
15926,1328,4329,10233,5693,9.41161e+12,59.2404,5610.73,15926,2102,72,11597,11597,8102,5125,4299
84873,12939,19721,55038,29835,9.91348e+12,60.1294,24947.3,84873,9597,72,65152,65152,57038,55134,43351
12874,1921,3951,8188,4686,8.9963e+12,58.6679,5000.99,12874,1921,72,8923,8923,6953,4391,3831
65312,9424,15200,42354,22958,9.9183e+12,60.1077,19378.6,65312,7400,72,50112,50112,41758,33786,31599
75503,5014,25502,47564,27939,8.5571e+12,58.4499,29674.4,75503,12420,72,50001,50001,28656,15251,10618
19399,5350,5983,12325,7074,8.95548e+12,56.8285,7420.91,19399,2892,72,13416,13416,13416,13416,13416
11110,299,2584,7211,3899,9.96475e+12,59.7951,3598.34,11110,1254,72,8526,8526,3068,1114,1133
11438,429,2733,7411,4027,9.82872e+12,59.5629,3762.01,11438,1316,72,8705,8705,3640,3745,1547
89781,40168,89781,0,89781,7.99991,0,89781,89781,89781,1,0,0,0,0,0
50377,17091,20264,31171,19206,7.72549e+12,57.1196,23001.8,50377,9852,72,30113,30113,28250,25667,25281
88307,14097,28722,55811,32496,8.71789e+12,58.3419,33566.7,88307,13987,72,59585,59585,49031,34622,31221
85631,27081,28160,54066,31565,8.67207e+12,58.6094,32857.3,85631,13714,72,57471,57471,55991,54636,54364
71446,6031,16595,46336,25110,9.91706e+12,60.1244,21109,71446,8077,72,54851,54851,36593,35521,20679
29703,2805,6949,19255,10448,9.91996e+12,60.0062,9129.32,29703,3378,72,22754,22754,16288,10857,9419
52193,7695,26354,31334,20859,6.3962e+12,55.7702,28773.3,52193,12827,72,25839,25839,18098,9060,8902
10936,3083,4561,6736,4200,7.6309e+12,45.3816,5373.59,10936,2215,72,6375,6375,4187,2139,1685
83249,1359,4238,66059,17190,5.803e+13,12.0017,5192.3,83249,2580,20,79011,79011,58134,41654,69624
37718,14283,15312,23304,14414,7.67676e+12,57.3112,17468,37718,7450,72,22406,22406,22030,21479,21589
23389,5308,5460,15177,8212,9.9039e+12,59.9561,7264.29,23389,2652,72,17929,17929,17726,17606,17613
24291,2951,8296,15300,8991,8.53084e+12,57.2259,9942.34,24291,4024,72,15995,15995,9686,6611,5379
91947,11050,43505,55725,36222,6.80454e+12,55.9627,47570.1,91947,21174,72,48442,48442,31211,17890,13840
83622,2540,34372,51599,32023,7.60749e+12,57.0683,38493.2,83622,16725,72,49250,49250,24695,10401,5028
24424,3539,8381,15368,9056,8.50762e+12,57.8166,10032.9,24424,4066,72,16043,16043,12195,7661,7701
43214,5008,11337,27802,15412,9.53483e+12,59.595,14203.2,43214,5518,72,31877,31877,24782,17125,15158
93303,31154,31843,58710,34593,8.50667e+12,58.4111,36817.5,93303,15507,72,61460,61460,60450,59353,59381
22726,5897,9442,14008,8718,7.56954e+12,55.7986,10868.9,22726,4577,72,13284,13284,11469,8952,8582
81000,4971,30847,50411,30589,8.0009e+12,57.7715,35029.9,81000,15025,72,50153,50153,30780,18543,7251
52230,2216,3325,41597,10633,5.72475e+13,11.9961,4067.65,52230,2136,14,48905,48905,42002,37095,45789
74864,5514,30560,46223,28641,7.64427e+12,56.7627,34333.8,74864,14866,72,44304,44304,28194,9340,8616
17047,676,5232,10839,6208,8.99201e+12,58.1997,6532.44,17047,2532,72,11815,11767,5182,5456,2440
2543,1321,1880,1423,1120,3.68363e+12,29.4617,2036.93,2543,910,53,663,663,604,498,603
69810,6890,16231,45273,24537,9.90559e+12,60.1141,20657.9,69810,7893,72,53579,53579,40066,39784,23508
40300,10535,15341,25094,15206,8.00197e+12,57.7026,17690.9,40300,7465,72,24959,24959,19329,19211,12583
10365,2605,3172,6593,3772,9.03761e+12,58.5453,4062.24,10365,1540,72,7193,7193,6388,5468,5639
86443,5212,26948,54847,31596,8.88622e+12,58.6546,31788.1,86443,13106,72,59495,59447,40874,18857,18003
46923,7212,25953,27784,19139,5.77163e+12,54.6534,27996.9,46923,12621,72,20970,20970,14200,9000,7558
53451,10732,12506,34657,18794,9.89416e+12,60.0384,16035.2,53451,6081,72,40945,40945,38889,38396,35556
95480,16463,36728,59339,36141,7.95001e+12,57.328,41514,95480,17887,72,58752,58752,42477,26088,21751
43360,2965,14460,27348,16012,8.64145e+12,58.4788,17102.4,43360,7044,72,28900,28900,18952,7228,6955
38348,4036,8924,24867,13481,9.91931e+12,60.0514,11612,38348,4337,72,29424,29424,22683,15509,13644
4775,744,1311,3077,1698,9.45352e+12,58.3106,1827.96,4775,626,71,3464,3464,2895,2208,2122
75404,11793,24831,47613,27791,8.65881e+12,58.5774,29045.3,75404,12083,72,50573,50573,42953,33914,33759
30640,2755,7593,19794,10846,9.73702e+12,59.7783,9792.8,30640,3696,72,23047,23047,16494,16331,8580
70146,11842,31110,42874,27272,7.19128e+12,56.7559,34500.5,70146,15147,72,39036,39036,28583,17871,14980
69995,4517,25489,43767,26228,8.20858e+12,58.0144,29273.3,69995,12407,72,44506,44458,30466,13860,13375
77764,40526,41399,60909,16855,7.9581e+10,8.99232,41956.2,77764,37250,11,36365,36365,35800,35843,35771
85500,18965,19866,55444,30056,9.9105e+12,60.134,25125.9,85500,9673,72,65634,65634,64319,64294,62870
64362,3906,32645,38621,25741,6.37753e+12,55.7521,35499.3,64362,15903,72,31717,31717,19141,10982,4014
98938,11572,51670,59084,39854,6.17449e+12,55.5457,55651.2,98938,25169,72,47268,47268,29398,15988,11828
48068,12740,16861,30175,17893,8.39762e+12,58.2066,19678.9,48068,8210,72,31207,31207,27301,22777,22668
93824,13647,26735,59979,33845,9.23252e+12,59.304,32094.6,93824,13016,72,67089,67089,54755,37880,33876
63321,228,14690,41072,22249,9.92091e+12,60.1183,18765.3,63321,7152,72,48631,48631,12245,14198,1452
7561,937,2971,4693,2868,7.88509e+12,54.4009,3609.81,7561,1430,72,4590,4542,1856,1380,1170
82201,19856,27364,51848,30353,8.61272e+12,58.5312,31875,82201,13325,72,54837,54837,49254,47855,39925
85174,3166,38494,51930,33244,7.07895e+12,56.0257,42436.8,85174,18731,72,46680,46680,23788,9773,4669
2577,403,980,1622,955,8.26183e+12,53.0093,1275.71,2577,457,57,1597,1597,1129,581,795
20701,886,5436,13321,7380,9.54416e+12,59.4986,7025.74,20701,2642,72,15265,15265,7854,4579,3177
23895,1661,9018,14888,9007,8.05465e+12,55.7646,10576.3,23895,4381,72,14877,14877,9277,2764,2580
50790,9712,13232,32689,18101,9.55727e+12,59.657,16518.5,50790,6443,72,37558,37558,32864,28396,27250
13400,2380,3171,8690,4710,9.91404e+12,59.7662,4334.07,13400,1541,72,10229,10229,9081,8018,7848
70482,3822,27212,43800,26682,7.92627e+12,56.8301,30910.7,70482,13235,72,43270,43270,26006,5678,5028
72030,15734,32709,43891,28139,7.06216e+12,56.6017,36116.2,72030,15935,72,39321,39321,32026,22290,20007
50018,18067,19204,31106,18912,7.96812e+12,57.6826,21993,50018,9350,72,30814,30814,30459,30047,30254
90438,20174,34477,56262,34176,7.99151e+12,57.3352,39069.9,90438,16787,72,55961,55961,45926,32094,28988
77963,23970,34232,47719,30244,7.25298e+12,56.2875,37960.2,77963,16660,72,43731,43731,38343,31031,29324
79511,9142,32431,49099,30412,7.64741e+12,57.3447,36400.7,79511,15792,72,47080,47080,31369,18798,14925
57705,11329,13461,37423,20282,9.90743e+12,60.097,17226.6,57705,6556,72,44244,44244,41728,41133,37624
66401,16475,32530,51833,14568,78592100000,8.99685,33070.5,66401,29274,11,33871,33871,21124,22696,19569
99140,5281,23037,64291,34849,9.91273e+12,60.1414,29009,99140,11219,72,76103,76103,50271,49743,18445
3364,413,823,2189,1175,1.01238e+13,58.6433,1234.74,3364,400,63,2541,2541,1949,1938,1395
63281,8623,19602,40171,23110,8.91567e+12,58.6798,23329.2,63281,9535,72,43679,43679,31939,18123,17622
73743,10022,29863,45578,28165,7.69115e+12,57.273,33602.5,73743,14532,72,43880,43880,27687,16520,12918
16963,6277,7032,10453,6510,7.61397e+12,56.5426,8168.08,16963,3420,72,9931,9931,9568,9190,9312
8042,1750,3734,4894,3148,6.9891e+12,50.9937,4344.66,8042,1800,72,4308,4308,2745,940,1036
7596,2944,3001,4721,2875,7.84866e+12,56.9231,3640.07,7596,1452,72,4595,4595,4541,4541,4542
32401,20066,20994,25409,6992,2.23339e+13,5.52113,24092,32401,7001,13,11407,11407,11279,11407,10975
72560,15380,20648,46378,26182,9.24834e+12,56.0394,24956.2,72560,10054,72,51912,51912,44313,37071,35103
83508,11747,30506,52190,31318,8.19912e+12,58.0071,34893.2,83508,14855,72,53002,53002,39283,25665,21924
88791,16342,20775,57561,31230,9.88849e+12,60.0965,26197.9,88791,10108,72,68016,68016,61864,61725,54425
69732,1544,16251,45205,24527,9.91039e+12,60.1203,20668,69732,7917,72,53481,53481,18575,19911,5716
61663,4165,17759,39383,22280,9.19789e+12,59.2369,21502.5,61663,8647,72,43904,43904,25618,23929,11327
57878,15104,33323,34018,23860,5.48833e+12,53.9623,35642.6,57878,16229,72,24555,24555,18834,13446,12133
65837,23229,24410,41092,24745,8.13398e+12,57.9164,27972.4,65837,11889,72,41427,41427,40789,40061,40265
78259,3946,18207,50745,27514,9.91692e+12,60.1282,23079,78259,8868,72,60052,60052,29600,29874,13787
43746,8425,20008,26644,17102,7.01476e+12,56.502,22264.4,43746,9742,72,23738,23738,17302,10065,8388
85789,24459,25946,54577,31212,9.01339e+12,59.0231,30805.7,85789,12637,72,59843,59843,57772,57718,55400
49283,1787,11478,31956,17327,9.91291e+12,60.0837,14778.9,49283,5586,72,37805,37805,23740,15952,6505
15351,2606,6593,9431,5920,7.43338e+12,56.7461,7624.26,15351,3211,72,8758,8758,6136,3141,3110
77314,15387,30213,47971,29343,7.87564e+12,57.6128,34178.3,77314,14719,72,47101,47101,38016,25500,22715
42057,1515,13327,26650,15407,8.82852e+12,58.7337,15964.9,42057,6483,72,28730,28730,17355,6503,3507
77769,34385,35724,47312,30457,6.98644e+12,56.4874,39334.7,77769,17398,72,42045,42045,41672,41142,41257
19060,2704,4457,12362,6698,9.91899e+12,59.9482,5992.93,19060,2168,72,14603,14603,12015,9022,8992
98985,1950,6260,78814,20171,5.72761e+13,12.0013,7294.21,98985,3349,20,92725,92725,64449,43417,73351
39152,9300,10354,25173,13979,9.49825e+12,59.5337,12993.3,39152,5036,72,28798,28798,28251,28103,27501
48488,8612,18084,30251,18237,8.10262e+12,57.5132,20842,48488,8799,72,30404,30404,24197,16905,16825
20086,3741,5673,12855,7231,9.27841e+12,59.1187,7189.74,20086,2758,72,14413,14413,11683,8527,8496
63931,11440,15993,41253,22678,9.68857e+12,59.8379,20021.1,63931,7785,72,47938,47938,43457,42358,36027
62837,14246,23618,39164,23673,8.05051e+12,57.8141,27023.3,62837,11491,72,39219,39219,33911,26679,25014
80187,19765,31232,49780,30407,7.89257e+12,57.6366,35329,80187,15214,72,48955,48955,38543,26348,25909
20745,67,4848,13460,7285,9.93422e+12,59.9317,6486.08,20745,2358,72,15897,9514,3889,200,502
61158,11828,16506,39263,21895,9.44082e+12,59.5255,20300.1,61158,8039,72,44652,44652,38695,31728,31504
21427,355,6755,13598,7829,8.86963e+12,58.6471,8293.39,21427,3287,72,14672,14576,6539,5167,1385
7494,872,1856,4850,2644,9.77319e+12,58.5749,2600.05,7494,882,72,5638,5638,4369,3314,2992
7103,1695,3452,4298,2805,6.71435e+12,55.4857,3991.91,7103,1675,72,3651,3651,2620,1676,1556
70758,370,16446,45888,24870,9.91718e+12,60.1183,20920.2,70758,8009,72,54312,54312,30876,30407,2014
69098,16056,21477,43848,25250,8.89843e+12,58.8708,25483.5,69098,10454,72,47621,47621,41624,41471,34389
13304,2135,3147,8618,4686,9.92158e+12,59.7836,4302.97,13304,1533,72,10157,10157,8935,8653,7043
64983,8096,29744,39566,25417,7.00693e+12,56.1505,32861.2,64983,14469,72,35239,35239,23362,9458,9087
49660,853,3263,39562,10098,5.71507e+13,12.0024,3993.15,49660,1588,20,46397,46397,30759,20118,39330
36433,13890,36433,0,36433,7.99978,0,36433,36433,36433,1,0,0,0,0,0
56200,12727,19958,35227,20973,8.33423e+12,57.7491,23149.7,56200,9717,72,36242,36242,29601,23252,21670
65652,9068,15280,42576,23076,9.91022e+12,60.1062,19478.7,65652,7438,72,50372,50372,41256,41082,30142
93766,24487,39081,57757,36009,7.53823e+12,57.2139,43581.3,93766,19038,72,54685,54685,45672,33257,30490
29213,2359,12976,17849,11364,7.20049e+12,56.6792,14642.7,29213,6321,72,16237,16237,10948,6990,4726
64650,13640,17109,41564,23086,9.49099e+12,59.586,21109,64650,8322,72,47541,47541,44128,43301,38467
42564,7837,17087,26346,16218,7.7364e+12,57.3888,19476.5,42564,8320,72,25477,25477,19340,12233,12038
5460,1322,1362,3534,1926,9.90283e+12,59.0722,1945.14,5460,662,72,4098,4098,4052,4055,4058
13950,2269,3940,8935,5015,9.27963e+12,59.0178,5085.73,13950,1907,72,10010,10010,8077,7614,4952
77476,12174,22445,49455,28021,9.17278e+12,55.6222,26973.3,77476,10920,72,55031,55031,40132,25831,21831
30628,684,7320,19833,10795,9.85213e+12,59.9211,9540.08,30628,3563,72,23308,23308,8326,2621,2593
58048,17169,25618,35509,22539,7.21812e+12,56.7811,28526.9,58048,12474,72,32430,32430,28316,22644,21515
81168,6453,30829,50522,30646,8.00886e+12,57.7865,35025.2,81168,15014,72,50339,50339,34563,16063,15346
74955,16419,31513,46113,28842,7.48732e+12,57.0713,35221.9,74955,15347,72,43442,43442,35786,26878,26727
15988,661,6805,9831,6157,7.45721e+12,56.804,7875.76,15988,3309,72,9183,9041,5256,2361,1648
64938,10059,15120,42109,22829,9.90782e+12,60.0975,19279.1,64938,7362,72,49818,49818,43804,35623,33732
27353,1114,10544,16998,10355,7.97013e+12,56.3394,12256.5,27353,5130,72,16809,16770,6134,3381,1599
84891,2353,26808,53809,31082,8.8347e+12,58.8067,31548,84891,13051,72,58083,58035,19757,13048,6966
8661,695,4200,5237,3424,6.81625e+12,55.6289,4819.11,8661,2046,72,4461,4365,3310,2417,2169
94583,27774,29840,59947,34636,8.84171e+12,58.8257,35039.3,94583,14537,72,64743,64743,63411,63090,61343
85492,11392,36172,52560,32932,7.45105e+12,57.0237,40301.6,85492,17604,72,49320,49320,30471,18774,14574
34813,7148,8124,22585,12228,9.91536e+12,60.039,10604.6,34813,3953,72,26689,26689,25264,23964,23679
45039,3699,24502,35310,9729,79822700000,8.97316,24917,45039,22044,11,20537,20537,7300,8246,6372
99187,28786,49150,59702,39485,6.51816e+12,55.8296,53327,99187,23939,72,50037,50037,42535,32196,29939
87425,38626,46345,52087,35338,6.07516e+12,55.2099,49883.8,87425,22572,72,41080,41080,37688,33093,32092
47501,4740,11064,30794,16707,9.91719e+12,60.0945,14266.9,47501,5390,72,36437,36437,27080,25977,16114
81437,28189,30896,50703,30734,8.01038e+12,57.7916,35109.8,81437,15040,72,50541,50541,49254,47457,47263
80945,12432,18825,52487,28458,9.91065e+12,60.1221,23842.2,80945,9162,72,62120,62120,54484,44058,41614
19861,1750,5477,12741,7120,9.34803e+12,59.2151,6992.9,19861,2654,72,14384,14384,8782,6155,5096
47589,17560,22317,28873,18716,6.87169e+12,56.3349,24690.9,47589,10866,72,25272,25272,21853,18631,17872
20274,3579,4744,13146,7128,9.91326e+12,59.91,6352.99,20274,2301,72,15530,15530,13843,13812,11930
26814,9001,11411,16479,10335,7.43189e+12,56.2519,13012.5,26814,5547,72,15403,15403,13824,11967,12124
28005,6005,9036,17719,10286,8.793e+12,58.5985,10917,28005,4402,72,18969,18969,15971,12435,12521
97035,2874,23583,62742,34293,9.77536e+12,59.9661,29375.5,97035,11486,72,73452,73452,29474,11166,10412
85585,19498,24691,54646,30939,9.19409e+12,59.247,29624,85585,12022,72,60894,60894,54968,54817,47833
85939,32770,37080,52699,33240,7.34619e+12,56.9592,41173.4,85939,18059,72,48859,48859,46135,42950,43051
9397,1614,2276,6097,3300,9.81835e+12,59.4645,3160.22,9397,1099,72,7121,7121,6166,6148,5162
98852,20254,38310,61393,37459,7.90856e+12,57.6306,43223.1,98852,18643,72,60542,60542,50420,38571,38290
43639,8272,12321,27910,15729,9.28885e+12,59.2984,15147.9,43639,5998,72,31318,31318,26749,22332,21306
50462,6507,11748,32720,17742,9.91194e+12,60.0873,15115.6,50462,5717,72,38714,38714,32367,30895,21729
35845,6485,8958,23138,12707,9.71682e+12,59.7844,11450.1,35845,4364,72,26887,26887,23955,20022,19146
49774,6362,14766,31722,18052,9.09079e+12,55.6423,17864.6,49774,7175,72,35008,35008,27948,19638,19386
82098,10394,24811,52227,29871,9.00908e+12,59.0122,29495.8,82098,12072,72,57287,57287,45986,32401,29151
66636,619,15486,43213,23423,9.91719e+12,60.1279,19741.8,66636,7543,72,51150,51150,14515,16294,2873
74485,1194,17343,48291,26194,9.91263e+12,60.1227,22014.9,74485,8449,72,57142,57142,18025,4448,4595
92206,26706,32072,57914,34292,8.42317e+12,58.3093,36954.7,92206,15620,72,60134,60134,55702,51466,50488
54586,12571,17704,34511,20075,8.73658e+12,58.6524,20940.2,54586,8624,72,36882,36882,32960,31952,26483
9119,885,2138,5922,3197,1.00228e+13,59.629,3004.42,9119,1040,72,6981,6981,5029,4806,3043
22295,7720,11233,13397,8898,6.41749e+12,55.6394,12470.3,22295,5459,72,11062,11014,10592,10139,10249
16008,3346,5892,10004,6004,8.19266e+12,55.9305,7048.38,16008,2848,72,10116,10116,8416,6171,5706
97853,5941,30738,62037,35816,8.85953e+12,58.5042,36101.6,97853,14969,72,67115,67115,44736,18361,17322
1946,233,512,1268,678,9.63115e+12,56.9229,786.997,1946,239,54,1434,1434,1052,1041,754
81051,5876,29003,50767,30284,8.29016e+12,58.1336,33319.7,81051,14124,72,52048,52048,35699,16434,15833
73803,9830,17141,47870,25933,9.91573e+12,60.1266,21780.5,73803,8342,72,56662,56662,46053,45837,33085
86628,19798,20123,56185,30443,9.91579e+12,60.1371,25442.8,86628,9799,72,66505,66505,66115,66027,65639
42160,9642,9940,27321,14839,9.89738e+12,60.0227,12830.1,42160,4842,72,32220,32220,31789,31779,31449
91775,5142,21352,59509,32266,9.91024e+12,60.134,26939.4,91775,10395,72,70423,70423,36627,36659,17662
81646,26874,32410,50570,31076,7.78815e+12,56.9728,36531,81646,15779,72,49236,49236,44968,39926,39945
58312,1672,23569,36039,22273,7.70376e+12,57.0183,26648.2,58312,11476,72,34743,34743,14297,6738,3057
55545,18402,23048,34238,21307,7.57381e+12,57.2068,25959.5,55545,11228,72,32497,32497,30253,27150,26643
57991,2375,13457,37613,20378,9.92702e+12,60.1177,17242.7,57991,6555,72,44534,44534,28405,28078,8611
54230,1642,14512,34842,19388,9.4537e+12,59.5403,17955,54230,7063,72,39718,39718,24568,10983,6026
28362,1326,6579,18396,9966,9.95841e+12,60.0283,8680.4,28362,3205,72,21783,21783,14096,9585,4766
85774,9320,25234,54685,31089,9.11435e+12,56.1359,30147.1,85774,12271,72,60540,60540,45517,27742,27088
17866,2677,4200,11586,6280,9.92247e+12,59.8626,5652.59,17866,2043,72,13666,13666,11533,9555,9084
39543,7158,9259,25640,13903,9.90651e+12,60.0348,12007.9,39543,4505,72,30284,30284,27821,27237,23790
39065,1205,9087,25339,13726,9.92606e+12,60.0684,11812.7,39065,4425,72,29978,29978,11777,4709,4460
20812,654,11238,12370,8442,5.97415e+12,53.9288,12345.6,20812,5469,72,9574,9220,5352,3104,466
65708,18062,21294,41546,24162,8.73528e+12,58.6716,25072.9,65708,10374,72,44414,44414,39736,39637,34137
24386,5177,5682,15820,8566,9.93511e+12,59.9812,7541.91,24386,2767,72,18704,18704,18097,17955,17260
35524,25701,35524,0,35524,7.99977,0,35524,35524,35524,1,0,0,0,0,0
14047,5118,5244,8766,5281,8.12398e+12,56.7046,6283.74,14047,2543,72,8803,8803,8651,8559,8585
13808,1657,3273,8957,4851,9.90899e+12,59.7365,4461.32,13808,1590,72,10535,10535,8648,8199,5630
17058,497,7461,10450,6608,7.28911e+12,55.1581,8571.3,17058,3622,72,9597,9372,5378,1706,0
57036,8020,13251,36996,20040,9.9142e+12,60.1025,16984.1,57036,6450,72,43785,43785,36133,35984,26837
43864,10203,10245,28445,15419,9.90152e+12,60.0582,13242.6,43864,4985,72,33619,33619,33575,33568,33572
2549,635,1332,1536,1013,6.45849e+12,53.763,1574.47,2549,647,58,1217,1169,962,647,780
12151,811,2887,7881,4270,9.95137e+12,59.7413,3962.85,12151,1406,72,9264,9264,5170,5168,2833
1403,158,520,883,520,8.49922e+12,50.98,715.053,1403,242,46,883,861,408,191,147
80610,13710,36222,49178,31432,7.12043e+12,56.6947,39997.6,80610,17646,72,44388,44388,32188,17888,17501
19451,6156,9529,15184,4267,78522300000,8.98643,9817.51,19451,8569,11,9922,9922,7242,7573,6926
22761,4623,11547,13671,9090,6.38565e+12,55.6002,12795.2,22761,5620,72,11214,11214,8520,5379,5479
34280,17811,19617,26936,7344,80482400000,8.9037,19960.5,34280,17649,11,14663,14663,13614,13663,13583
28978,5752,13638,17586,11392,6.85255e+12,56.2002,15230.6,28978,6631,72,15340,15340,10926,5827,5695
92863,10100,21545,60222,32641,9.91644e+12,60.1455,27193.4,92863,10490,72,71318,71318,56444,53743,34186
71495,1412,16607,46359,25136,9.91039e+12,60.1234,21126,71495,8079,72,54888,54888,32783,21491,5567
49675,2310,17599,31158,18517,8.34331e+12,58.154,20483.4,49675,8567,72,32076,32076,17772,6954,5794
33712,8191,8724,21717,11995,9.57003e+12,59.5838,11074.5,33712,4237,72,24988,24988,24366,24224,23488
65809,6809,20000,41846,23963,9.00649e+12,58.9803,23872.5,65809,9742,72,45809,45809,31033,19046,15537
76775,4822,17867,49789,26986,9.91634e+12,60.1304,22661.7,76775,8704,72,58908,58908,32720,32518,16687
6338,267,1499,4115,2223,9.94314e+12,59.3878,2162.78,6338,724,72,4839,4839,3024,2992,955
52691,7161,16196,33477,19214,8.95385e+12,58.4146,19404,52691,7873,72,36495,36495,28389,20033,17798
32294,2590,10336,20441,11853,8.80754e+12,58.6602,12455.4,32294,5031,72,21958,21958,14602,14377,5723
49949,5733,11631,32386,17563,9.91145e+12,60.0844,14969.9,49949,5660,72,38318,38318,31259,29600,19399
71072,10072,23484,44857,26215,8.65121e+12,58.5745,27489.6,71072,11437,72,47588,47588,36903,28218,25742
93705,25342,31206,59101,34604,8.61555e+12,58.5471,36251.2,93705,15202,72,62499,62499,56103,48617,48386
95759,24240,32636,60254,35505,8.51524e+12,58.425,37723.3,95759,15897,72,63123,63123,57308,50475,50417
57295,6502,24307,35219,22076,7.43196e+12,57.0491,27259.3,57295,11828,72,32988,32988,22342,9860,9552
2700,530,742,1739,961,9.46508e+12,57.52,1086.05,2700,347,59,1958,1958,1686,1475,1506
1656,255,431,1069,587,1.01117e+13,56.8122,674.16,1656,204,52,1225,1225,977,774,837
72094,9715,24777,45334,26760,8.48134e+12,58.3579,28761,72094,12064,72,47317,47317,36670,28030,25407
36503,1275,1532,28898,7605,5.85704e+13,11.9948,2158.18,36503,1529,13,34971,34971,32679,30671,33947
42939,2114,10024,27842,15097,9.91628e+12,60.0661,12968.2,42939,4883,72,32915,32915,21393,21159,7297
93834,14738,33602,58772,35062,8.29512e+12,58.1012,38489,93834,16353,72,60232,60232,45910,29092,24818
61548,4109,27728,37537,24011,7.10272e+12,56.6519,30739.4,61548,13503,72,33820,33820,21349,6780,6294
56225,26375,31189,33268,22957,5.75576e+12,54.9789,33544.2,56225,15188,72,25036,25036,23802,22088,21918
93550,8197,21754,60659,32891,9.91636e+12,60.1406,27432.2,93550,10596,72,71796,71796,52094,36913,27876
75718,10195,30865,46754,28964,7.64815e+12,56.8335,34676.7,75718,15020,72,44853,44853,29368,16560,12830
56971,729,2407,45096,11875,5.85543e+13,12.0021,3199.22,56971,1350,19,54564,54564,39682,26483,42308
24819,10186,11770,15046,9773,6.8337e+12,56.1533,13170.4,24819,5732,72,13049,13049,12147,11190,11247
47432,1854,25568,28193,19239,5.96091e+12,53.9595,27683.1,47432,12433,72,21864,21816,11326,4647,3512
5612,1325,2182,3487,2125,7.99262e+12,56.7778,2696.8,5612,1056,70,3430,3430,3223,3017,3024
97793,15967,22726,63420,34373,9.90996e+12,60.1407,28630.6,97793,11066,72,75067,75067,65253,65051,53274
62274,7568,14496,40377,21897,9.91888e+12,60.1102,18509.5,62274,7062,72,47778,47778,37715,37508,25447
61745,14439,22090,38674,23071,8.29838e+12,58.1092,25524.7,61745,10756,72,39655,39655,31795,22622,22301
37684,8910,11493,23967,13717,8.9868e+12,58.8815,13934.2,37684,5589,72,26191,26191,24292,21745,21217
38383,4266,8927,24896,13487,9.93948e+12,60.058,11611.8,38383,4349,72,29456,29456,23600,22414,14397
54255,1031,15798,34617,19638,9.16657e+12,59.175,19148.2,54255,7690,72,38457,38457,22438,10617,2858
43368,9375,10135,28120,15248,9.89704e+12,60.0542,13106.4,43368,4926,72,33233,33233,32182,31177,31125
26985,5504,7146,17347,9638,9.50968e+12,59.4886,9098.27,26985,3475,72,19839,19839,18261,16186,15758
92208,13940,41358,56265,35943,7.12687e+12,56.6494,45591.1,92208,20143,72,50850,50850,35268,16990,16431
81161,19082,24675,51601,29560,8.99572e+12,58.9949,29299.1,81161,12021,72,56486,56486,51384,45370,45348
16421,1752,6219,10231,6190,8.05588e+12,57.5535,7378.47,16421,3024,72,10202,10202,6642,2524,2451
38256,11405,17818,23244,15012,6.90103e+12,56.1131,19820.5,38256,8658,72,20438,20438,17423,13256,12486
87432,7971,40816,53082,34350,6.88323e+12,56.4,44750.5,87432,19873,72,46616,46616,27327,15684,11586
99038,18685,22998,64217,34821,9.91722e+12,60.1524,28967.1,99038,11204,72,76040,76040,69868,63981,62429
71064,34659,39203,42084,28980,5.8001e+12,54.1582,42069.3,71064,19082,72,31861,31861,30478,28555,28329
36166,9106,11917,22839,13327,8.66545e+12,52.9839,14215.4,36166,5783,72,24249,24249,24249,24249,24249
19288,1397,4513,12507,6781,9.96301e+12,59.9049,6054.45,19288,2198,72,14775,14775,10267,10171,4881
11206,1516,3632,7089,4117,8.81506e+12,58.3034,4556.83,11206,1763,72,7574,7574,5416,5346,2947
15982,4361,5422,10078,5904,8.57886e+12,57.8815,6612.71,15982,2638,72,10560,10560,9511,8287,8471
13247,835,4342,8373,4874,8.74287e+12,58.3032,5387.91,13247,2109,72,8905,8857,6124,2933,2908
21804,1532,6534,13889,7915,9.06138e+12,58.913,8124.64,21804,3175,72,15270,15270,8827,5916,4698
87695,27161,39959,53409,34286,7.03083e+12,56.3585,43976.6,87695,19444,72,47736,47736,42167,34600,32843
52819,10749,18869,33082,19737,8.30873e+12,57.5921,21890,52819,9187,72,33950,33950,28002,21096,20887
24034,153,5604,15587,8447,9.94472e+12,59.9821,7442.77,24034,2730,72,18430,18405,10463,10308,782
23548,928,5536,15261,8287,9.9089e+12,59.97,7346.05,23548,2696,72,18012,18012,11288,11155,3141
91501,20576,24598,58743,32758,9.44813e+12,59.5645,29940.6,91501,11982,72,66903,66903,63009,58508,58395
57101,6408,13256,37034,20067,9.93257e+12,60.1096,16990.1,57101,6458,72,43845,43845,33895,24582,21758
82536,4964,4986,65664,16872,5.74534e+13,12.0018,5931.39,82536,3325,20,77550,77550,77415,77433,77469
94553,4623,33440,59299,35254,8.34329e+12,58.2098,38390.3,94553,16280,72,61113,61113,32830,16760,10774
87952,8629,32959,54822,33130,8.07532e+12,57.8662,37486,87952,16040,72,54993,54993,38151,18290,17661
49333,11132,11492,31994,17339,9.90869e+12,60.082,14798,49333,5592,72,37841,37841,37410,36912,36874
61867,11203,14413,40117,21750,9.91086e+12,60.0967,18405.3,61867,7013,72,47454,47454,42831,38441,37279
42142,4400,22023,25176,16966,6.17705e+12,55.456,23996.5,42142,10725,72,20119,20119,13126,7131,4835
76065,12479,17651,49333,26732,9.91946e+12,60.1303,22411.9,76065,8593,72,58414,58414,50846,43614,41664
14882,815,3600,9636,5246,9.8423e+12,59.3407,4854.36,14882,1736,72,11282,11282,7454,5132,2908
98182,12582,28263,62702,35480,9.19419e+12,59.2569,33816.6,98182,13760,72,69919,69919,53445,53000,33257
98968,11625,29433,63039,35929,9.08089e+12,59.1123,34956.2,98968,14339,72,69535,69535,55814,39615,39031
42945,2575,10562,27743,15202,9.75631e+12,59.8784,13468,42945,5144,72,32383,32383,21366,14412,7944
65508,18996,21017,41470,24038,8.77077e+12,58.6615,24801.1,65508,10218,72,44491,44491,42820,40501,40179
65799,6688,20270,41791,24008,8.95605e+12,58.922,24122.7,65799,9875,72,45529,45529,30935,20526,17116
19493,1982,4570,12639,6854,9.90284e+12,59.8739,6129.58,19493,2217,72,14923,14923,11109,7907,6548
84446,12400,34428,52158,32288,7.64759e+12,57.1149,38604.7,84446,16751,72,50018,50018,39325,26854,26442
60679,3534,20170,38289,22390,8.61742e+12,58.5162,23670,60679,9816,72,40509,40461,23378,13794,12093
3317,1861,1883,2604,713,80235500000,8.86735,1985.13,3317,1687,11,1434,1434,1425,1425,1429
39753,18144,18157,24208,15545,7.02665e+12,56.5018,20248,39753,8837,72,21596,21596,21596,21596,21596
73425,313,17049,47627,25798,9.91652e+12,60.1283,21669.4,73425,8302,72,56376,56376,31954,31469,1869
10836,3645,4189,6748,4088,8.01577e+12,57.2788,5026,10836,2035,72,6647,6647,6237,5753,5966
37402,5122,15937,22983,14419,7.42276e+12,56.9763,18017.4,37402,7758,72,21465,21465,15160,7777,7690
15732,533,6306,9749,5983,7.77715e+12,56.8439,7396.28,15732,3061,72,9426,9272,5766,2569,1505
52122,5579,12128,33797,18325,9.91218e+12,60.0861,15590.2,52122,5898,72,39994,39994,31155,29665,18692
84571,21037,32185,52637,31934,7.99547e+12,57.7745,36528.6,84571,15668,72,52386,52386,46875,39276,37674
94485,14379,21915,61284,33201,9.91448e+12,60.1449,27650.4,94485,10670,72,72570,72570,63404,61284,47944
95926,2986,26638,61445,34481,9.32757e+12,59.4206,32148.6,95926,12973,72,69288,69288,26990,14412,6786
80583,18200,18676,52257,28326,9.92166e+12,60.1452,23681,80583,9095,72,61907,61907,61225,60635,60571
78693,33404,33633,48315,30378,7.40216e+12,56.6498,37457.8,78693,16378,72,45060,45060,44782,44505,44513
9913,1107,2655,6374,3539,9.5076e+12,59.0554,3551.56,9913,1279,72,7258,7258,5777,4138,3800
33232,5601,7759,21556,11676,9.91715e+12,60.0172,10145.7,33232,3777,72,25473,25473,22277,22221,18496
63918,20657,25845,39514,24404,7.69655e+12,57.3699,29165.1,63918,12585,72,38073,38073,34387,30031,30080
1101,246,306,716,385,1.08178e+13,55.0926,481.716,1101,148,46,795,795,724,714,714
73086,6581,16957,47395,25691,9.92746e+12,60.1373,21558.5,73086,8260,72,56129,56129,39018,37605,22295
3342,245,1325,2072,1270,8.15232e+12,56.2226,1674.2,3342,640,67,2017,1969,1353,917,861
60138,10749,13958,38999,21139,9.91276e+12,60.1109,17863.7,60138,6787,72,46180,46180,42361,37179,36011
21802,3985,5094,14140,7662,9.92149e+12,59.9267,6797.47,21802,2472,72,16708,16708,15102,15071,13290
23270,5008,5444,15098,8172,9.89979e+12,59.9287,7238.6,23270,2639,72,17826,17826,17217,16694,16637
72184,25142,29984,44484,27700,7.55065e+12,57.2138,33603.3,72184,14601,72,42200,42200,40870,39025,38823
6897,389,2386,4352,2545,8.56069e+12,57.716,3014.24,6897,1160,72,4511,4463,2045,1424,1085
97042,28237,33114,61069,35973,8.51231e+12,58.1122,38256.1,97042,16115,72,63928,63928,59790,54911,54936
60229,4210,25372,37055,23174,7.46589e+12,57.0899,28460.4,60229,12346,72,34857,34857,21831,6510,6074
41905,6318,16996,25895,16010,7.68191e+12,56.5629,19344.8,41905,8268,72,24909,24909,17964,9869,9604
30193,5490,7008,19588,10605,9.94695e+12,60.0093,9218.08,30193,3409,72,23185,23185,20966,18880,18393
7166,1222,1704,4656,2510,9.94323e+12,59.2519,2426.23,7166,819,72,5462,5462,4784,4044,4111
5730,753,1509,3689,2041,9.70887e+12,58.8466,2104.06,5730,735,72,4221,4221,3221,2342,2186
58258,6179,15699,37405,20853,9.44306e+12,59.5162,19342.5,58258,7640,72,42559,42559,31719,18964,18495
24714,2243,5760,16027,8687,9.93543e+12,59.9719,7640.47,24714,2805,72,18954,18954,13866,9905,7742
3042,506,1363,1864,1178,7.27979e+12,42.7074,1671.86,3042,650,56,1679,1679,666,234,0
17907,2688,5726,11337,6570,8.84526e+12,58.5564,7055.31,17907,2789,72,12181,12181,9990,7746,7227
44611,13792,22516,26783,17828,6.41406e+12,55.2931,24646.5,44611,10963,72,22095,22095,18315,14004,13915
55270,7642,12854,35845,19425,9.91254e+12,60.0962,16487.9,55270,6252,72,42416,42416,34817,34668,25582
76263,30603,41755,59806,16457,79929300000,8.98472,42294.8,76263,37573,11,34508,34508,28353,28547,28176
14199,3290,5019,8914,5285,8.39671e+12,57.8933,6086.62,14199,2442,72,9180,9180,7343,5187,5333
86701,40349,45108,67845,18856,79302900000,8.99316,45706.2,86701,40590,11,41593,41593,38763,38914,38632
82697,16762,29992,51718,30979,8.23488e+12,58.0666,34354.9,82697,14605,72,52705,52705,42517,30529,30246
49548,7917,11545,32137,17411,9.91144e+12,60.0645,14861.5,49548,5620,72,38003,38003,33598,32559,26296
6492,1538,2122,4120,2372,8.74589e+12,57.8332,2735.98,6492,1024,72,4370,4370,3844,3222,3433
83849,22993,37785,51134,32715,7.09606e+12,56.3769,41681.6,83849,18402,72,46064,46064,39017,29405,27166
93459,37610,41131,57181,36278,7.23501e+12,56.8145,45468.1,93459,20021,72,52328,52328,51713,50846,50876
80986,3815,18836,52523,28463,9.90566e+12,60.1262,23857.7,80986,9169,72,62150,62150,40277,27338,13356
66583,3239,66583,0,66583,7.99988,0,66583,66583,66583,1,0,0,0,0,0
75876,14088,17602,49208,26668,9.92166e+12,60.1358,22354.4,75876,8568,72,58274,58274,54055,53069,47055
15175,928,4800,9622,5553,8.8668e+12,56.9956,5978.11,15175,2322,72,10375,10375,5525,1953,1592
47945,5714,22649,29062,18883,6.82072e+12,55.8078,25027.8,47945,11011,72,25296,25296,16330,5865,5644
42568,10630,14223,26842,15726,8.61574e+12,58.4648,16824.5,42568,6928,72,28345,28345,25614,21957,21143
33816,7903,9036,21722,12094,9.46913e+12,59.4876,11372.8,33816,4391,72,24780,24780,23141,23111,21276
47399,10815,11038,30734,16665,9.91758e+12,60.0931,14236.3,47399,5377,72,36361,36361,36043,35814,35823
38809,8918,9036,25170,13639,9.92576e+12,60.0546,11745.5,38809,4399,72,29773,29773,29644,29561,29564
30213,7895,9744,19121,11092,8.7939e+12,58.6002,11742.7,30213,4747,72,20469,20469,18724,16416,15951
7677,445,1803,4981,2696,9.98333e+12,59.533,2568.2,7677,872,72,5874,5874,3008,3016,1585
73430,11109,32515,44881,28549,7.19828e+12,56.7855,36043.3,73430,15840,72,40915,40915,29005,17843,14850
52111,2631,12117,33788,18323,9.9223e+12,60.1059,15576.9,52111,5903,72,39994,39994,26130,25856,9128
5501,256,2133,3428,2073,8.05012e+12,56.7588,2637.74,5501,1035,70,3368,3320,1465,1086,848
20244,4121,4723,13129,7115,9.92781e+12,59.974,6333.28,20244,2299,72,15521,15521,14797,13892,13751
84997,25524,47029,50301,34696,5.77119e+12,54.4395,50347.2,84997,22889,72,37968,37968,31977,23718,21956
30724,148,7191,19918,10806,9.90464e+12,59.9367,9430.44,30724,3497,72,23533,23492,5784,205,503
4733,792,1142,3068,1665,9.897e+12,58.9713,1673.02,4733,550,72,3591,3591,3183,2709,2682
88426,47752,52834,51640,36786,5.2007e+12,52.7923,55979.3,88426,25717,72,35592,35592,34497,32970,32840
19216,2188,4959,12391,6825,9.60231e+12,59.5247,6464.15,19216,2411,72,14257,14257,11041,8229,7470
87408,13771,31554,54704,32704,8.25546e+12,58.0977,36136.9,87408,15370,72,55854,55854,39514,20290,19564
6786,696,1674,4398,2388,9.85134e+12,59.197,2362.42,6786,811,72,5112,5112,3603,2366,2081
12602,9280,12602,0,12602,7.99937,0,12602,12602,12602,1,0,0,0,0,0
77958,1121,31511,48185,29773,7.69056e+12,56.909,35435.5,77958,15337,72,46447,46447,26337,16487,1826
2260,279,574,1469,791,1.02333e+13,57.6695,878.007,2260,278,57,1686,1686,1326,947,932
77531,6650,17983,50293,27238,9.9204e+12,60.1396,22822.7,77531,8758,72,59548,59548,40067,38762,22515
80555,18979,33260,49663,30892,7.59048e+12,57.2742,37242.9,80555,16202,72,47295,47295,42129,35013,33536
81418,21396,27747,51240,30178,8.51423e+12,58.4116,32179.7,81418,13511,72,53671,53671,49267,43333,41967
45823,10853,15379,28884,16939,8.58617e+12,58.3812,18144.2,45823,7486,72,30444,30444,26949,22122,21194
29640,3553,9442,18784,10856,8.8111e+12,58.6468,11423.3,29640,4594,72,20198,20198,14520,7875,7698
10357,2144,2408,6715,3642,1.00035e+13,59.7765,3366.81,10357,1172,72,7949,7949,7568,7559,7296
16354,2556,3849,10601,5753,9.95419e+12,59.8759,5203.11,16354,1875,72,12505,12505,10927,8854,8427
60058,11228,32597,35657,24401,5.92701e+12,55.1784,35131.4,60058,15879,72,27461,27461,18765,8450,6029
5149,798,1931,3212,1937,8.2687e+12,54.6875,2422.22,5149,935,68,3218,3218,2179,966,1149
49917,7090,11638,32376,17541,9.90368e+12,60.0757,14976.3,49917,5660,72,38279,38279,32902,31629,23899
47050,6485,17487,29360,17690,8.10909e+12,57.857,20185,47050,8503,72,29563,29515,24959,19575,19422
23881,5045,5566,15492,8389,9.94307e+12,59.9762,7394.65,23881,2710,72,18315,18315,17681,16899,16795
97963,8703,22690,63531,34432,9.92743e+12,60.1622,28607.8,97963,11053,72,75273,75273,54820,54417,29665
52294,7499,19205,32668,19626,8.17512e+12,57.9655,22166.1,52294,9350,72,33089,33089,23653,15897,13564
90444,8352,21048,58642,31802,9.90546e+12,60.1254,26565.6,90444,10245,72,69396,69396,51008,50624,28395
10026,1322,2371,6513,3513,9.90991e+12,59.5153,3304.4,10026,1138,72,7655,7655,6408,6124,4481
63313,16335,19847,40150,23163,8.87738e+12,58.8317,23555.9,63313,9669,72,43466,43466,40591,39875,35886
83594,18211,27764,52729,30865,8.6254e+12,58.4137,32347.7,83594,13518,72,55830,55830,47271,35582,32834
28020,6371,6570,18166,9854,9.908e+12,59.977,8648.43,28020,3193,72,21450,21450,21216,21162,21000
67026,4703,15583,43462,23564,9.91043e+12,60.1227,19861,67026,7583,72,51443,51443,35638,24861,16219
88649,18603,27397,56295,32354,8.92131e+12,58.9155,32356.5,88649,13336,72,61252,61252,49008,34541,34031
20550,2521,4812,13326,7224,9.90455e+12,59.9128,6437.02,20550,2339,72,15738,15738,12355,9140,8356
69534,14459,18034,44770,24764,9.5652e+12,59.6878,22313.3,69534,8777,72,51500,51500,48474,44397,43488
35104,7837,15783,21426,13678,7.12433e+12,56.5983,17694,35104,7685,72,19321,19321,15702,10818,9725
15858,4188,6406,9809,6049,7.73306e+12,55.8965,7503.01,15858,3103,72,9452,9452,7913,6188,6196
95722,12724,26472,61324,34398,9.3415e+12,56.6616,31983.7,95722,12880,72,69250,69250,59378,45909,42709
58993,7338,28345,35666,23327,6.71741e+12,56.173,31122.3,58993,13807,72,30648,30648,20226,8097,7805
13222,3155,4903,8256,4966,8.24333e+12,57.6204,5891.61,13222,2388,72,8319,8319,7717,7528,6917
49152,8935,11453,31871,17281,9.91052e+12,60.0726,14747.2,49152,5569,72,37699,37699,34114,30703,29854
62081,16697,19831,39315,22766,8.78856e+12,58.7219,23454.8,62081,9650,72,42250,42250,39955,36902,36239
17324,2594,4057,11234,6090,9.92962e+12,59.9186,5480.31,17324,1976,72,13267,13267,11105,11067,8610
89129,15191,20737,57785,31344,9.91453e+12,60.1378,26184,89129,10102,72,68392,68392,60380,60208,50647
32242,2273,7545,20910,11332,9.89192e+12,59.9732,9874.77,32242,3661,72,24697,24697,17121,11997,7904
35618,3985,18373,27862,7756,79175900000,8.98532,18755.3,35618,16527,11,17245,17245,6754,7853,5669
59088,1290,3224,46941,12147,5.77933e+13,11.9964,4018.54,59088,2438,14,55864,55864,40341,27563,48935
35837,7308,11164,22755,13082,8.89557e+12,58.7904,13493.3,35837,5431,72,24673,24673,21529,17291,16347
92534,28740,86470,63711,28823,9.21063e+12,3.99749,86621.8,92534,28837,9,6064,6064,2012,6064,2019
77207,4432,17917,50080,27127,9.91613e+12,60.1289,22739.7,77207,8720,72,59290,59290,31320,31312,15370
59381,1375,13779,38517,20864,9.92414e+12,60.1174,17641.6,59381,6709,72,45602,45602,27518,27157,5280
13342,4646,5102,8301,5041,8.04215e+12,56.3832,6089,13342,2480,72,8240,8240,7576,6888,6945
43993,3501,15345,27638,16355,8.4143e+12,58.223,17974.1,43993,7465,72,28648,28648,18467,6476,6128
3851,12,929,2499,1352,1.01698e+13,58.7707,1383.25,3851,452,66,1036,276,324,181,53
85536,21319,85536,0,85536,7.99991,0,85536,85536,85536,1,0,0,0,0,0
18054,7477,7906,11058,6996,7.34219e+12,56.6656,9056.8,18054,3851,72,10148,10148,9989,9817,9979
66186,8307,15330,42938,23248,9.93305e+12,60.1346,19562,66186,7467,72,50856,50856,40542,40346,27941
96621,8571,29622,61389,35232,8.95492e+12,58.9624,34975.9,96621,14423,72,66999,66999,48705,34225,26224
15331,5513,5595,9594,5737,8.22142e+12,57.5592,6717.17,15331,2703,72,9736,9736,9733,9732,9736
7673,150,1873,4978,2695,9.84104e+12,59.3231,2629.55,7673,908,72,5800,5773,1812,465,545
1288,243,348,840,448,1.05706e+13,55.8183,547.316,1288,169,47,940,940,798,729,748
61305,16164,39721,48070,13235,2.23294e+13,5.52632,45527.8,61305,13236,13,21584,21584,17688,19141,10435
64822,18648,18877,41358,23464,9.15693e+12,59.1843,22764.5,64822,9190,72,45945,45945,45685,45624,45421
4337,2487,2796,2508,1829,4.81004e+12,52.5086,3081.05,4337,1361,61,1541,1541,1211,839,1045
57500,2937,13420,37290,20210,9.90339e+12,60.0929,17174.8,57500,6533,72,44080,44080,21728,11343,10136
62793,6408,14628,40725,22068,9.90715e+12,60.1054,18673,62793,7121,72,48165,48165,36249,34700,21505
10760,1638,2500,6985,3775,9.97222e+12,59.8062,3490.01,10760,1216,72,8260,8260,6993,5823,5618
62390,4659,14534,40457,21933,9.90968e+12,60.1005,18554.8,62390,7074,72,47856,47856,29295,28681,15675
29420,382,1238,23291,6129,5.85768e+13,11.9926,1798.92,29420,1234,13,28182,28182,20501,13703,24763
73410,22755,41985,57682,15728,80517300000,8.97737,42492,73410,37781,11,31425,31425,20420,20884,19974
84767,24146,38952,51566,33201,6.99226e+12,56.528,42825.8,84767,18976,72,45815,45815,40602,33420,31929
2587,713,862,1650,937,8.77945e+12,51.5833,1174.73,2587,399,60,1725,1725,1725,1725,1725
97257,9611,22609,63068,34189,9.91355e+12,60.1387,28482.8,97257,11009,72,74648,74648,55185,37438,32318
86433,3109,20078,56055,30378,9.91848e+12,60.1349,25385.7,86433,9776,72,66355,66355,27940,12311,11329
80809,8479,24749,51345,29464,8.95782e+12,58.9606,29349,80809,12048,72,56060,56060,33618,25721,21703
55976,3370,12998,36303,19673,9.91932e+12,60.1175,16675.8,55976,6327,72,42978,42978,28901,28624,11636
56271,17610,19910,35287,20984,8.35398e+12,58.1717,23106.3,56271,9693,72,36361,36361,34452,31921,31396
26567,2699,6557,17166,9401,9.7447e+12,59.8096,8526.12,26567,3194,72,20010,20010,14429,9750,8549
29194,4203,11557,18095,11099,7.81778e+12,56.7108,13337.9,29194,5623,72,17637,17637,12604,8180,7094
14640,633,4734,9269,5371,8.72627e+12,58.3207,5869.01,14640,2292,72,9906,9810,6391,2701,2219
66167,24910,26296,40992,25175,7.78248e+12,57.4932,29748.9,66167,12804,72,39871,39871,39461,38981,39193
90272,15363,27155,57446,32826,9.02661e+12,59.0494,32242.2,90272,13224,72,63117,63117,49238,32880,32246
31217,7968,16173,18666,12551,6.2472e+12,55.5133,17742,31217,7879,72,15044,15044,12066,8070,7179
87612,20150,21211,56655,30957,9.78827e+12,59.9883,26525,87612,10330,72,66401,66401,65112,63430,63110
44489,995,11315,28690,15799,9.64736e+12,59.7409,14277.8,44489,5512,72,33174,33174,19853,9397,3546
62728,15798,20147,39695,23033,8.77022e+12,58.5843,23796.8,62728,9808,72,42581,42581,38848,33710,32686
73458,10821,18629,47363,26095,9.63974e+12,59.7866,23139.9,73458,9071,72,54829,54829,46766,35774,33198
63101,20262,20438,39894,23207,8.73855e+12,58.2175,24090.4,63101,9951,72,42663,42663,42455,42408,42276
92435,7483,46827,55462,36973,6.37544e+12,55.4959,50692.1,92435,22807,72,45608,45608,29727,11340,10632
88468,12124,20542,57373,31095,9.91807e+12,60.1379,25956.5,88468,10003,72,67926,67926,55643,55397,40625
29616,2811,6936,19208,10408,9.89182e+12,60.0003,9112.97,29616,3373,72,22680,22680,16675,16554,9414
47602,3543,11088,30867,16735,9.91108e+12,60.0941,14299.9,47602,5398,72,36514,36514,25537,25315,12120
33166,8367,17169,25947,7219,79238100000,8.98637,17536.8,33166,15444,11,15997,15997,9729,10352,9119
33095,5433,7722,21466,11629,9.93228e+12,60.0303,10100.2,33095,3761,72,25373,25373,21982,21924,17962
19361,5432,6345,12235,7126,8.70912e+12,57.5431,7748.52,19361,3085,72,13016,13016,12201,11242,11438
52039,12134,19679,32416,19623,8.02986e+12,57.7583,22583.3,52039,9573,72,32360,32360,28378,22862,21772
56342,9221,16339,35967,20375,9.17968e+12,59.1919,19797.9,56342,7958,72,40003,40003,31620,31391,21544
70423,13079,16431,45668,24755,9.9e+12,60.1036,20885.9,70423,7997,72,53992,53992,49982,44557,43316
5918,461,2078,3732,2186,8.49027e+12,57.1031,2636.49,5918,992,72,3840,3792,2461,1765,1562
55993,4004,13015,36314,19679,9.92135e+12,60.0968,16687.2,55993,6336,72,42978,42978,29817,29556,13697
87917,35400,48338,52078,35839,5.81205e+12,54.9284,51771.3,87917,23535,72,39579,39579,33950,28608,27310
14618,3010,3449,9479,5139,9.90381e+12,59.8079,4694.96,14618,1674,72,11169,11169,10533,9989,9939
44281,10716,16110,27688,16593,8.23116e+12,58.0043,18703.4,44281,7844,72,28171,28171,23810,18679,18691
53141,4925,23621,32473,20668,7.17944e+12,55.6053,26318.1,53141,11485,72,29520,29520,15543,10026,7528
37381,11826,13278,23435,13946,8.3382e+12,58.1112,15563.6,37381,6462,72,24103,24103,23346,22288,22276
94805,21847,21984,61485,33320,9.92585e+12,60.1521,27732.1,94805,10710,72,72821,72821,72671,72571,72566
42660,20159,23455,33460,9200,79972300000,8.96006,23855.1,42660,21103,11,19205,19205,16887,17111,16680
26189,1921,12452,15875,10314,6.78551e+12,55.9851,13913.6,26189,6045,72,13737,13737,8586,2561,2535
30732,1509,8309,19738,10994,9.42189e+12,59.4223,10465,30732,4041,72,22423,22423,11380,7120,5061
91508,18579,24987,58675,32833,9.38853e+12,59.4985,30308.2,91508,12173,72,66521,66521,59688,59470,51502
29297,4376,8482,18710,10587,9.18553e+12,59.1314,10515,29297,4126,72,20815,20815,16402,16293,11141
24080,6312,10536,14749,9331,7.28533e+12,55.9854,11983.6,24080,5126,72,13544,13544,10741,7452,7546
98878,12239,22965,64122,34756,9.92165e+12,60.1455,28922.5,98878,11188,72,75913,75913,60309,59991,41168
31237,5882,10693,19655,11582,8.50597e+12,57.4213,12705.2,31237,5186,72,20544,20544,16885,12645,12578
55284,12410,15996,35297,19987,9.18088e+12,58.1348,19409.8,55284,7770,72,39288,39288,35257,35170,30447
68070,12304,15830,44149,23921,9.90855e+12,60.1139,20161.3,68070,7706,72,52240,52240,48005,47017,40963
33367,11301,12699,20772,12595,8.01406e+12,57.683,14717.1,33367,6180,72,20668,20668,18716,16485,16504
35728,14823,15588,21887,13841,7.29387e+12,56.7915,17562.7,35728,7585,72,20140,20140,19426,18406,18404
19998,4755,9665,12082,7916,6.72807e+12,55.4314,10836.7,19998,4702,72,10333,10333,7711,5108,4767
61891,3815,18555,39393,22498,9.05385e+12,58.422,22256.5,61891,9033,72,43336,43336,25376,14048,10031
15128,3131,3575,9809,5319,9.9076e+12,59.7732,4850.32,15128,1736,72,11553,11553,10901,10888,10293
14959,1278,3981,9623,5336,9.52597e+12,59.3399,5207.2,14959,1937,72,10978,10978,6631,7072,4153
25785,1952,10607,15904,9881,7.62385e+12,55.92,12188,25785,5162,72,15178,15178,9089,5009,1851
17579,1648,4125,11399,6180,9.97877e+12,59.8987,5558.11,17579,2009,72,13454,13454,9890,5773,5678
88176,5130,20534,57172,31004,9.9059e+12,60.1263,25930.1,88176,9998,72,67642,67642,35919,35833,17572
86228,19317,20029,55920,30308,9.91565e+12,60.1335,25326.9,86228,9749,72,66199,66199,65178,65160,64088
92297,4646,21410,59866,32431,9.92028e+12,60.1474,27028.2,92297,10429,72,70887,70887,34948,35292,16283
86735,22607,32691,54036,32699,8.05114e+12,57.6914,37148.3,86735,15909,72,54044,54044,45362,37058,34912
26584,4418,15227,15659,10925,5.53149e+12,53.801,16488.1,26584,7397,72,11357,11357,8209,4596,4579
72615,20232,35439,43814,28801,6.6145e+12,56.048,38693.7,72615,17256,72,37176,37176,31182,22895,21133
29831,6639,13009,18282,11549,7.30814e+12,56.7798,14720.3,29831,6329,72,16822,16774,15945,14903,15096
52545,6681,12226,34075,18470,9.91606e+12,60.0902,15708.4,52545,5950,72,40319,40319,33693,32136,22573
42330,23330,25316,24731,17599,5.1908e+12,53.5993,27046.5,42330,12311,72,17014,17014,16406,15675,15562
82058,14851,24799,52196,29862,9.00825e+12,59.0215,29483.5,82058,12067,72,57259,57259,48452,48171,37763
60223,10389,13977,39057,21166,9.91754e+12,60.1123,17883.9,60223,6803,72,46246,46246,41942,36113,34790
97623,4712,22630,63324,34299,9.91854e+12,60.1499,28529.6,97623,11019,72,74993,74993,48820,33214,16554
4410,434,1866,2713,1697,7.72269e+12,56.1717,2279.47,4410,907,63,2544,2496,1742,1708,1009
25249,2469,5955,16371,8878,9.87148e+12,59.9005,7865.21,25249,2886,72,19294,19294,14266,14163,8208
35102,6564,15356,21499,13603,7.29436e+12,56.7909,17299.3,35102,7476,72,19746,19746,13695,8042,6644
80874,22946,25318,51292,29582,8.8664e+12,58.8421,29883.1,80874,12318,72,55556,55556,53633,51419,51452
69409,17692,23648,43682,25727,8.515e+12,57.8992,27525.3,69409,11511,72,45761,45761,40807,34961,34944
48982,20109,23521,29634,19348,6.71125e+12,56.1514,25910.2,48982,11453,72,25461,25461,23643,21525,21670
31053,9535,9557,19739,11314,8.94959e+12,58.8293,11640.5,31053,4650,72,21496,21496,21480,21480,21478
36853,955,9504,23744,13109,9.58246e+12,59.6197,12034.3,36853,4617,72,27349,27349,11349,6160,3279
8276,1337,1979,5368,2908,9.87873e+12,59.2557,2786.89,8276,941,72,6297,6297,5579,4687,4555
75540,5702,17530,48995,26545,9.92066e+12,60.1296,22262.9,75540,8533,72,58010,58010,40795,40446,19629
45309,10273,15632,28489,16820,8.47667e+12,58.2878,18334,45309,7612,72,29677,29677,24359,18197,18010
52506,10288,12219,34058,18448,9.91536e+12,60.0971,15700.8,52506,5948,72,40287,40287,38030,35016,34363
66389,4434,15451,43059,23330,9.90293e+12,60.1094,19692.7,66389,7519,72,50938,50938,29348,28964,15243
23204,2748,7517,14678,8526,8.78333e+12,58.5345,9134.48,23204,3660,72,15687,15687,11275,11104,6093
18348,3479,8011,11237,7111,7.33315e+12,56.6597,9183.62,18348,3896,72,10337,10337,8069,5337,4808
26916,10130,26916,0,26916,7.9997,0,26916,26916,26916,1,0,0,0,0,0
83177,15823,24276,53075,30102,9.14466e+12,59.1877,29071.4,83177,11819,72,58901,58901,49830,49592,38799
95100,23837,30596,60169,34931,8.75788e+12,58.7273,35782.3,95100,14898,72,64504,64504,60433,54814,53692
40434,18738,20223,24323,16111,6.46599e+12,55.5668,22205.8,40434,9832,72,20211,20211,19141,17926,18109
90898,795,33008,56847,34051,8.22583e+12,58.0655,37735.1,90898,16076,72,57890,57377,20785,9964,3394
84992,29742,43262,66447,18545,79029300000,8.9854,43862.1,84992,38927,11,41730,41730,32322,33205,31458
88070,2785,20511,57110,30960,9.90181e+12,60.1272,25904.8,88070,9985,72,67559,67559,26712,10751,9991
61994,473,22270,38825,23169,8.27879e+12,58.0949,25711.1,61994,10845,72,39724,39197,22792,22196,2144
65345,24736,35628,38758,26587,5.88204e+12,54.6784,38336.3,65345,17351,72,29717,29717,25345,19421,18078
89737,7929,34128,55842,33895,8.00488e+12,57.7749,38694,89737,16620,72,55609,55609,37254,20815,16223
83488,13125,39103,50668,32820,6.86496e+12,56.3755,42878.2,83488,19037,72,44385,44385,33376,22937,20167
55353,9314,25536,33657,21696,6.95927e+12,56.4586,28253.4,55353,12430,72,29817,29817,20797,10226,10002
24711,702,5805,16016,8695,9.92487e+12,59.9643,7683.02,24711,2827,72,18906,18906,11553,11392,2650
65380,1893,32026,51036,14344,78531700000,8.99595,32562.3,65380,28816,11,33354,33354,9436,12387,6497
8744,1242,2055,5674,3070,9.99846e+12,59.4974,2893.68,8744,998,72,6689,6689,5717,5493,4240
81917,17395,19030,53118,28799,9.91766e+12,60.1415,24102,81917,9270,72,62887,62887,60978,60527,57932
81943,2724,19045,53136,28807,9.91453e+12,60.1335,24117.9,81943,9273,72,62898,62898,39084,38608,9751
54187,15657,18623,34081,20106,8.48663e+12,52.5575,21762.2,54187,9056,72,35564,35564,35564,35564,35564
87124,39386,40217,52966,34158,6.95955e+12,56.4961,44171.5,87124,19587,72,46907,46907,46104,45173,45371
23860,6000,7347,15164,8696,8.94702e+12,58.7453,9035.65,23860,3567,72,16513,16513,14927,13047,13204
29762,4849,6966,19298,10464,9.90043e+12,60.0086,9152.79,29762,3384,72,22796,22796,19680,19625,16005
67259,7108,15628,43609,23650,9.91821e+12,60.1314,19916.6,67259,7613,72,51631,51631,39199,28208,23983
71505,12836,16602,46367,25138,9.92081e+12,60.1325,21118.4,71505,8088,72,54903,54903,50379,44267,42869
22443,5119,6438,14339,8104,9.23332e+12,59.1067,8084.51,22443,3130,72,16005,16005,14689,14354,12662
19446,4054,4553,12606,6840,9.89763e+12,59.9034,6111.71,19446,2208,72,14893,14893,14315,14180,13514
84955,28915,30207,53247,31708,8.32014e+12,57.9422,34716.6,84955,14694,72,54748,54748,53761,52677,52744
31600,2748,7398,20491,11109,9.89956e+12,59.9986,9688.29,31600,3599,72,24202,24202,17419,17283,9197
43704,7298,10209,28336,15368,9.89887e+12,60.0613,13199.8,43704,4961,72,33495,33495,29316,25344,24318
24650,2082,5734,15994,8656,9.94947e+12,59.9884,7612.28,24650,2793,72,18916,18916,12554,12212,7222
50499,13576,20825,31152,19347,7.58886e+12,56.5282,23532.4,50499,10122,72,29674,29674,25991,21673,21722
44026,2486,25884,25793,18233,5.33245e+12,54.2935,27701,44026,12606,72,18142,18142,9052,3770,2205
11829,3412,5645,7175,4654,6.76794e+12,52.928,6441.1,11829,2727,72,6184,6184,5221,3988,3768
27870,1567,10440,17372,10498,8.1075e+12,57.7219,12201,27870,5086,72,17430,17430,9007,4513,2785
3113,416,1240,1945,1168,8.02396e+12,47.8882,1571.38,3113,586,62,1873,1873,1572,1550,1376
56614,10620,25082,34619,21995,7.19043e+12,56.3245,27927,56614,12196,72,31532,31532,23839,16940,15130
20876,4810,4877,13545,7331,9.94648e+12,59.9619,6521.98,20876,2375,72,15999,15999,15926,15912,15898
1757,162,611,1114,643,8.72526e+12,50.2578,846.163,1757,275,53,1146,1146,801,472,558
36560,6604,17109,22197,14363,6.87952e+12,56.2981,19030.3,36560,8325,72,19451,19451,14407,9652,8362
5377,1526,2484,3272,2105,7.15266e+12,55.6647,2935.64,5377,1210,66,2893,2893,2063,898,865
92598,10012,30377,58476,34122,8.68175e+12,58.6277,35402.9,92598,14798,72,62221,62221,39403,41573,21098
76342,13067,17713,49507,26835,9.91884e+12,60.1354,22489.9,76342,8623,72,58629,58629,53024,45412,43638
65850,6204,28794,40324,25526,7.26819e+12,56.2232,32045.3,65850,14005,72,37056,37056,24290,14370,11424
90092,2655,28069,57158,32934,8.88712e+12,58.8772,33082.4,90092,13665,72,62023,61975,31795,16169,9825
41068,1970,9818,26590,14478,9.82917e+12,59.9672,12643.1,41068,4773,72,31250,31250,15453,15272,7040
9480,2671,4987,7422,2058,79403400000,8.88354,5177.55,9480,4481,11,4493,4493,2945,3076,2833
51101,13335,17808,32101,19000,8.41604e+12,58.237,20780.6,51101,8663,72,33293,33293,30078,25638,24776
2305,295,651,1487,818,9.72811e+12,57.0247,951.911,2305,308,58,1654,1654,1300,999,981
22702,907,5302,14723,7979,9.9036e+12,59.9435,7064.04,22702,2567,72,17400,17400,7599,3535,3293
56406,339,13092,36575,19831,9.92425e+12,60.1224,16791.1,56406,6378,72,43314,43314,11520,1311,1831
68610,13911,28829,42214,26396,7.49701e+12,57.1393,32273.9,68610,14038,72,39781,39781,30705,19063,16404
36377,5852,36377,0,36377,7.99978,0,36377,36377,36377,1,0,0,0,0,0
29597,10760,12328,18243,11354,7.53887e+12,56.8978,14079.5,29597,5983,72,17269,17269,16414,15217,15167
51691,451,12015,33522,18169,9.91792e+12,60.1137,15455.6,51691,5852,72,39676,39676,11113,1750,2127
41201,851,14360,25873,15328,8.43308e+12,58.2295,16851.3,41201,6990,72,26841,26745,15404,6926,1526
71469,2587,3011,56574,14895,5.85576e+13,12.0017,3898.95,71469,2653,19,68458,68458,64862,61695,65405
58007,10585,28415,45280,12727,78596200000,8.99466,28919.6,58007,25567,11,29592,29592,15443,17188,13717
23813,2365,9757,14700,9113,7.65301e+12,46.728,11246.1,23813,4747,72,14056,14056,3694,1918,0
87834,17263,29400,55375,32459,8.5968e+12,58.5104,34162.1,87834,14318,72,58434,58434,53344,46446,44846
96397,27524,49586,57709,38688,6.27248e+12,55.2984,53537.7,96397,24151,72,46811,46811,37652,25037,22220
68073,42492,68073,0,68073,7.99988,0,68073,68073,68073,1,0,0,0,0,0
69892,17150,35856,41856,28036,6.28742e+12,55.3219,38885.8,69892,17453,72,34036,34036,27523,18846,16956
28935,2405,6706,18769,10166,9.94771e+12,60.0498,8845.98,28935,3266,72,22229,22229,14655,14263,8385
95786,19203,29376,60853,34933,8.95152e+12,58.9578,34690.1,95786,14306,72,66410,66410,56264,44266,43983
65023,17697,20931,41135,23888,8.76621e+12,58.6965,24682.4,65023,10197,72,44092,44092,42046,39318,38747
19499,6614,6813,12254,7245,8.41511e+12,57.9228,8186.51,19499,3304,72,12686,12686,12576,12503,12495
62291,2899,22757,38936,23355,8.20281e+12,57.7899,26185.9,62291,11069,72,39534,39534,24440,7536,6102
39276,970,9203,25457,13819,9.88745e+12,60.0267,11940,39276,4467,72,30073,30073,10681,11383,3421
73695,8383,23268,46713,26982,8.83075e+12,58.7905,27472.8,73695,11321,72,50427,50427,36095,23621,20099
7770,867,1896,5032,2738,9.86404e+12,59.3166,2658.61,7770,918,72,5874,5874,4353,4325,2665
68313,24826,29813,41838,26475,7.28034e+12,56.8862,33168.8,68313,14518,72,38500,38500,36491,34177,34311
57017,15783,28167,34342,22675,6.54201e+12,55.96,30812.6,57017,13718,72,28850,28850,23437,15977,14412
51264,4993,11923,33242,18022,9.93105e+12,60.0963,15332.6,51264,5808,72,39341,39341,29269,29063,16994
57645,10282,13379,37390,20255,9.92749e+12,60.1156,17145.4,57645,6517,72,44266,44266,39789,39695,34424
56686,3033,3594,45142,11544,5.72687e+13,11.9967,4368.28,56686,2317,14,53092,53092,49066,45914,51281
24021,2738,7655,15218,8803,8.7927e+12,58.5673,9332.53,24021,3715,72,16366,16366,11877,6559,6566
86101,12041,24142,55098,31003,9.29727e+12,59.3798,29150.6,86101,11758,72,61959,61959,50577,47851,31334
45510,9131,21798,27534,17976,6.73658e+12,55.2128,24055.7,45510,10596,72,23712,23712,17268,10488,8870
87107,32178,32752,54283,32824,8.05594e+12,57.8556,37232.8,87107,15950,72,54355,54355,54178,53978,54144
63203,24645,27756,38683,24520,7.25134e+12,56.8242,30884.3,63203,13521,72,35447,35447,33496,31206,31346
43275,9795,10100,28061,15214,9.91799e+12,60.0662,13062.8,43275,4920,72,33175,33175,32737,32727,32389
62122,2369,15499,40099,22023,9.69206e+12,59.8376,19433.7,62122,7545,72,46623,46623,19617,12372,7666
60280,5636,13989,39094,21186,9.92919e+12,60.1084,17896.6,60280,6815,72,46291,46291,34122,24364,19218
34075,5021,11290,21506,12569,8.64733e+12,58.4798,13473.8,34075,5493,72,22785,22785,16957,11718,10404
46288,2195,10804,30020,16268,9.9043e+12,60.0649,13937.8,46288,5258,72,35484,35484,16683,17002,7531
71242,6541,16557,46206,25036,9.91358e+12,60.1217,21058.5,71242,8057,72,54685,54685,40055,39769,22098
97482,9907,22655,63209,34273,9.90677e+12,60.1377,28545.2,97482,11024,72,74827,74827,56569,38638,33651
24722,441,8111,15629,9093,8.681e+12,58.4641,9808.66,24722,3945,72,16611,16419,7698,3417,1663
85931,10900,43049,51656,34275,6.44188e+12,55.2405,46719.5,85931,20950,72,42882,42882,29914,19398,16340
33354,2621,11648,20950,12404,8.42568e+12,58.1776,13745.2,33354,5664,72,21706,21706,12694,14299,6976
86691,16655,27327,54949,31742,8.84607e+12,58.8114,32153.5,86691,13304,72,59364,59364,50584,38468,35778
10748,1118,5337,6477,4271,6.64154e+12,55.5739,6052.78,10748,2599,72,5411,5341,2611,1103,744
13813,1168,4824,8686,5127,8.42657e+12,57.5312,5877.63,13813,2335,72,8989,8989,5789,3519,2029
27794,4954,12481,16962,10832,7.12907e+12,56.5566,14072.8,27794,6071,72,15313,15265,11510,10940,10570
74755,13407,17421,48474,26281,9.90345e+12,60.1044,22106.6,74755,8480,72,57334,57334,52521,51395,44480
19602,1808,4591,12714,6888,9.93412e+12,59.8928,6153.23,19602,2233,72,15011,15011,10995,10907,6210
69623,11268,16183,45158,24465,9.9077e+12,60.1199,20599.7,69623,7878,72,53440,53440,46263,46121,37555
9276,1386,2173,6014,3262,9.91588e+12,59.6179,3055.95,9276,1049,72,7103,7103,5975,5954,4750
30033,2235,15131,18051,11982,6.40869e+12,54.0988,16690,30033,7349,72,14902,14902,9316,2874,2668
8616,2504,3158,5397,3219,8.3018e+12,57.1128,3880.26,8616,1521,72,5458,5458,5280,5077,5245
38401,340,18810,29975,8426,78537900000,8.99378,19219,38401,16926,11,19591,19591,4922,6733,3129
37520,9233,12677,23629,13891,8.56817e+12,58.2373,15017.2,37520,6170,72,24843,24843,22566,21974,18897
63825,13448,14860,41394,22431,9.90926e+12,60.1034,18959.9,63825,7235,72,48965,48965,47335,46943,44752
22991,899,6011,14797,8194,9.55654e+12,57.772,7740.6,22991,2911,72,16980,16980,7357,4890,3288
71305,7000,16565,46245,25060,9.92072e+12,60.1204,21068.1,71305,8066,72,54740,54740,40746,29120,23597
56416,19852,56416,0,56416,7.99986,0,56416,56416,56416,1,0,0,0,0,0
56201,2550,13105,36437,19764,9.90986e+12,60.105,16790.4,56201,6383,72,43096,43096,27746,27434,8909
78921,11004,39501,47441,31480,6.45285e+12,54.5403,42924.3,78921,19221,72,39420,39420,26371,11191,10644
71087,894,20447,45406,25681,9.20046e+12,59.2053,24669.6,71087,9943,72,50640,50640,29461,15442,3526
88443,29677,30260,55642,32801,8.49272e+12,58.3925,35008.7,88443,14732,72,58183,58183,58063,57925,58070
1734,170,461,1128,606,1.00671e+13,56.6759,710.601,1734,220,53,1273,1273,778,740,516
13778,476,3264,8934,4844,9.92018e+12,59.6801,4448.79,13778,1581,72,10514,10514,6523,4379,1748
28567,8048,8408,18216,10351,9.12225e+12,58.3266,10389.5,28567,4082,72,20159,20159,19976,19692,19826
18331,1787,4312,11886,6445,9.8803e+12,59.8242,5796.04,18331,2095,72,14019,14019,10406,10326,6126
85688,46673,47010,50792,34896,5.83068e+12,55.0845,50377,85688,22881,72,38678,38678,38270,37946,37951
33028,334,13093,20477,12551,7.80418e+12,57.0626,15054.7,33028,6357,72,19935,19455,11473,6325,1323
15501,3432,7465,9387,6114,6.70303e+12,54.5308,8434.07,15501,3614,72,8036,8036,6226,4502,4244
20788,6767,8098,12917,7871,7.87301e+12,57.3869,9471.51,20788,3930,72,12690,12690,11207,9211,8866
17373,263,17373,0,17373,7.99954,0,17373,17373,17373,1,0,0,0,0,0
47096,10054,10988,30540,16556,9.91508e+12,60.069,14165.3,47096,5347,72,36108,36108,34968,34707,33224
16124,6078,10443,12643,3481,2.23875e+13,5.52394,12006.8,16124,3485,13,5681,5681,5068,5474,3614
64051,1635,21173,40422,23629,8.6424e+12,58.1321,24843.4,64051,10300,72,42878,42878,20985,8533,3909
81227,19205,19419,52570,28657,9.83069e+12,60.0316,24415.3,81227,9456,72,61808,61808,61550,61493,61301
8832,626,4349,5322,3510,6.6213e+12,53.6532,4975.53,8832,2112,72,4483,4387,2709,630,779
93833,6281,21755,60856,32977,9.92876e+12,60.1487,27451.4,93833,10597,72,72078,72078,49526,34440,21771
79453,12507,30099,49478,29975,8.01746e+12,57.4814,34229.1,79453,14641,72,49354,49354,38212,25097,24711
59141,3592,19332,37370,21771,8.69976e+12,58.608,22776.7,59141,9417,72,39809,39809,21451,12293,8527
55451,11488,15029,35591,19860,9.41946e+12,59.4917,18520.4,55451,7316,72,40422,40422,36808,31931,30812
14387,1363,5766,8904,5483,7.81308e+12,57.2119,6785.97,14387,2808,72,8621,8621,5818,3057,2496
61666,18046,30210,48137,13529,78532300000,8.99766,30730.6,61666,27187,11,31456,31456,21811,22997,20639
72179,7754,16766,46814,25365,9.91084e+12,60.1244,21321.8,72179,8158,72,55413,55413,42263,30463,26139
68862,12558,15993,44656,24206,9.91813e+12,60.1346,20370.5,68862,7790,72,52869,52869,47887,47784,41914
26699,585,12748,16164,10535,6.76221e+12,55.6842,14230,26699,6198,72,13951,13615,5141,2610,1093
54556,11388,12742,35375,19181,9.89664e+12,60.087,16336.6,54556,6201,72,41814,41814,40255,39879,37783
63440,7369,17744,40603,22837,9.30717e+12,56.3864,21613,63440,8638,72,45696,45696,29830,16059,12129
51548,13774,14317,33027,18521,9.33415e+12,59.373,17577.6,51548,6970,72,37231,37231,36575,36428,35656
71141,13351,21917,45192,25949,8.93811e+12,58.9178,26035,71141,10673,72,49224,49224,43092,41537,32840
41377,4662,13989,26067,15310,8.55859e+12,58.3837,16520.2,41377,6812,72,27388,27388,19097,11971,9119
53928,10378,20036,33646,20282,8.11696e+12,57.8922,23055.9,53928,9749,72,33892,33892,25972,16604,16434
66918,12603,19766,42647,24271,9.1118e+12,59.1226,23736.6,66918,9628,72,47152,47152,40210,30649,28580
11993,524,3819,7610,4383,8.87583e+12,58.3841,4796.98,11993,1857,72,8174,8078,3105,1008,1025
61734,27199,57690,42504,19230,9.21003e+12,3.99592,57813.2,61734,19250,9,4044,4044,1904,4044,1911
4509,1009,1782,2806,1703,7.99492e+12,56.4076,2213.58,4509,865,65,2727,2727,1987,944,943
86198,22054,24390,55126,31072,9.25727e+12,59.3311,29386.4,86198,11877,72,61808,61808,58472,54602,54531
21003,8865,9478,12822,8181,7.13598e+12,55.5326,10751.7,21003,4600,72,11525,11525,11261,11048,11092
28923,13027,14999,17297,11626,6.24208e+12,55.1383,16477.2,28923,7301,72,13924,13924,13374,12711,12638
60695,16427,16524,38932,21763,9.40769e+12,59.4834,20281.3,60695,8049,72,44171,44171,44071,44036,44023
98914,13938,98914,0,98914,7.99992,0,98914,98914,98914,1,0,0,0,0,0
44334,7535,10869,28656,15678,9.75811e+12,59.8694,13852.1,44334,5292,72,33465,33465,28647,24063,22863
2414,532,1236,1449,965,6.64365e+12,53.8289,1473.01,2414,602,51,1178,1130,687,114,329
12892,2057,2996,8368,4524,1.00396e+13,59.8328,4125.71,12892,1458,72,9896,9896,8513,8488,7000
69407,9523,69407,0,69407,7.99988,0,69407,69407,69407,1,0,0,0,0,0
84015,3300,23739,53737,30278,9.26466e+12,58.7593,28633.8,84015,11542,72,60276,60276,27632,14794,8644
53081,10531,12398,34407,18674,9.9041e+12,60.0887,15908.3,53081,6036,72,40683,40683,38034,37970,34955
11491,101,2755,7452,4039,9.83273e+12,59.559,3785.33,11491,1328,72,8736,8046,4950,2721,422
55837,28854,29035,43692,12145,79274900000,8.99291,29513.4,55837,26124,11,26802,26802,26685,26695,26693
43732,5207,11087,28197,15535,9.64579e+12,59.391,14011.2,43732,5395,72,32645,32645,25416,24160,14453
16358,856,5193,10368,5990,8.85026e+12,58.4708,6439.58,16358,2522,72,11165,11165,6342,3335,2440
42693,1087,2163,33869,8824,5.80574e+13,12.003,2845.12,42693,1510,20,40530,40530,31550,23789,35375
58129,13559,23243,35981,22148,7.76457e+12,57.4491,26330.9,58129,11323,72,34886,34886,30194,23725,22402
85380,15768,24678,54521,30859,9.17644e+12,59.0645,29600.6,85380,12000,72,60702,60702,53992,47085,45990
25265,1098,5887,16392,8873,9.9101e+12,59.976,7806.42,25265,2857,72,19378,19378,8674,4276,3919
49541,12034,16006,31347,18194,8.74403e+12,58.6416,18997.6,49541,7788,72,33535,33535,29738,25339,25225
90709,11800,27485,57682,33027,9.00029e+12,59.0191,32581,90709,13389,72,63224,63224,47706,29452,28742
72509,18013,24542,45669,26840,8.55021e+12,58.4392,28571,72509,11953,72,47967,47967,43944,38390,37284
19141,180,1226,15244,3897,5.72414e+13,11.9898,1670.85,19141,788,14,17915,17915,11168,6250,14869
91192,7644,91192,0,91192,7.99991,0,91192,91192,91192,1,0,0,0,0,0
88950,19898,27770,56426,32524,8.88467e+12,58.8773,32724.8,88950,13528,72,61180,61180,60183,58793,58699
44494,7335,13207,28358,16136,9.07258e+12,59.0344,16032.8,44494,6418,72,31287,31287,25076,19162,17593
46397,4875,10817,30085,16312,9.91156e+12,60.0765,13958.9,46397,5263,72,35580,35580,26982,19434,16510
8911,1009,2235,5757,3154,9.74777e+12,58.7587,3078.36,8911,1082,72,6676,6676,4980,3067,3067
82825,9499,24250,52829,29996,9.13047e+12,59.1739,29026.1,82825,11803,72,58575,58575,41683,21746,20978
6973,402,1645,4531,2442,1.00136e+13,59.436,2354.3,6973,800,72,5328,5328,3498,3467,1411
56504,2096,14114,36472,20032,9.70587e+12,59.8279,17743.4,56504,6876,72,42390,42390,26654,26286,7374
53686,7675,12483,34810,18876,9.91945e+12,60.1032,16031.1,53686,6075,72,41203,41203,35395,34044,25671
40669,4664,21364,31837,8832,79411400000,8.99466,21768.3,40669,19226,11,19305,19305,7657,8756,6573
16819,3361,3954,10905,5914,9.92402e+12,59.8546,5341.25,16819,1920,72,12865,12865,11993,11977,11108
67680,21323,24695,42307,25373,8.20404e+12,57.588,28374.5,67680,12010,72,42985,42985,40119,36825,36758
75994,19575,24847,48014,27980,8.69602e+12,58.633,29102,75994,12104,72,51147,51147,46542,40304,38878
45497,1332,17130,28358,17139,8.04887e+12,57.7839,19738.9,45497,8335,72,28367,28319,16341,6541,1690
7759,1949,2689,4880,2879,8.56045e+12,57.8074,3374.49,7759,1309,72,5070,5070,4784,4458,4651
96846,16812,26568,62080,34766,9.37374e+12,59.4768,32146.2,96846,12936,72,70278,70278,61112,58872,45661
92891,6627,21555,60245,32646,9.91648e+12,60.1366,27203.6,92891,10496,72,71336,71336,49616,49176,22883
40321,8211,9446,26147,14174,9.88463e+12,60.0291,12242.1,40321,4590,72,30875,30875,29481,29140,27285
22869,2377,5391,14820,8049,9.90533e+12,59.9236,7156.74,22869,2619,72,17478,17478,13335,9013,7910
50809,3630,11841,32949,17860,9.90028e+12,60.067,15227.5,50809,5761,72,38968,38968,23273,22877,12385
56059,6184,17624,35544,20515,8.87153e+12,58.8025,20969.5,56059,8586,72,38435,38435,27430,14527,14040
69865,9615,22210,44255,25610,8.80092e+12,58.7498,26219.1,69865,10804,72,47655,47655,31596,17423,13421
37093,4639,8636,24057,13036,9.91818e+12,60.0538,11251.2,37093,4201,72,28457,28457,23640,17113,15615
12014,9558,11230,8271,3743,9.21263e+12,3.98069,11282.1,12014,3757,9,784,784,668,784,675
85304,26304,34400,52743,32561,7.70706e+12,56.9751,38641.1,85304,16750,72,50904,50904,46050,39468,37948
96350,11983,23075,62364,33986,9.81252e+12,60.0159,28857.9,96350,11228,72,73275,73275,59945,56829,37349
68226,7501,15858,44240,23986,9.91086e+12,60.1226,20200.5,68226,7716,72,52368,52368,41704,39660,25298
64017,5441,14916,41514,22503,9.89749e+12,60.0935,19027.6,64017,7252,72,49101,49101,32833,21365,18563
18858,1523,4434,12229,6629,9.89759e+12,59.8474,5951.1,18858,2155,72,14424,14424,10127,10052,4984
40452,4764,16979,24906,15546,7.49479e+12,56.3794,19217,40452,8249,72,23473,23473,16704,10477,8891
86271,13211,28315,54493,31778,8.67847e+12,58.6141,33043.9,86271,13792,72,57956,57956,47219,34600,34286
92522,22575,26859,59051,33471,9.16298e+12,59.2131,32119.3,92522,13075,72,65663,65663,61820,60876,55428
45367,1699,10947,29351,16016,9.82353e+12,59.9506,13998.7,45367,5333,72,34420,34420,14117,8547,4997
49682,220,18314,31025,18657,8.15923e+12,57.6329,21148.6,49682,8901,72,31368,30888,12152,4692,1186
4500,997,1353,2872,1628,9.33398e+12,57.7736,1831.34,4500,659,68,3147,3147,3122,3080,3134
90769,2283,21053,58866,31903,9.92622e+12,60.1478,26589.9,90769,10256,72,69716,69716,25342,8795,8407
33831,5578,7959,21936,11895,9.88441e+12,59.877,10379,33831,3857,72,25872,25872,23046,22403,18424
8863,2652,4399,5337,3526,6.53466e+12,53.3069,5024.49,8863,2128,72,4464,4464,4134,3642,3764
62995,2774,28518,38399,24596,7.07036e+12,56.5223,31577.8,62995,13888,72,34477,34477,21036,13152,4801
28216,13204,28216,0,28216,7.99972,0,28216,28216,28216,1,0,0,0,0,0
30052,11012,12615,18490,11562,7.51887e+12,56.4115,14378.1,30052,6140,72,17437,17437,16513,15536,15576
72163,6902,18553,46475,25688,9.60211e+12,59.7373,22977.6,72163,9038,72,53610,53610,39036,26960,23326
41636,10934,12519,26501,15135,9.04047e+12,58.8804,15185.2,41636,6092,72,29117,29117,28088,27814,26523
31153,11658,13191,19167,11986,7.45833e+12,56.9939,14996.2,31153,6421,72,17962,17962,16799,15510,15570
13081,773,3104,8481,4600,9.89561e+12,59.719,4244.78,13081,1507,72,9977,9977,6525,4408,2443
52183,463,15177,33298,18885,9.17155e+12,59.1378,18422.3,52183,7387,72,37006,36766,13560,5909,1791
46712,4257,16303,29335,17377,8.42262e+12,58.2407,19062,46712,7942,72,30409,30409,20575,9088,8690
91648,6005,29781,57936,33712,8.71609e+12,58.6694,34783.8,91648,14502,72,61867,61867,35432,20635,14943
18502,7329,8720,11232,7270,6.84323e+12,56.092,9843.88,18502,4235,72,9782,9782,9191,8498,8706
24633,907,8866,15430,9203,8.29707e+12,57.2834,10494.2,24633,4302,72,15767,15671,10079,4656,3266
49809,13307,19784,30852,18957,7.79643e+12,57.4767,22515.3,49809,9632,72,30025,30025,26382,21470,20365
51622,17779,18197,32391,19231,8.36409e+12,58.1752,21179.3,51622,8853,72,33425,33425,33193,32840,32973
48689,4898,15332,30870,17819,8.85033e+12,58.5354,18313,48689,7447,72,33357,33357,23005,22711,10455
27020,3639,27020,0,27020,7.9997,0,27020,27020,27020,1,0,0,0,0,0
11886,641,2835,7703,4183,9.88749e+12,59.6147,3892.05,11886,1370,72,9051,9051,5943,5871,2269
58928,13843,16283,37767,21161,9.34549e+12,59.4035,19935.1,58928,7921,72,42645,42645,39165,35104,35044
62435,1730,3819,49690,12745,5.73986e+13,11.9969,4633.17,62435,2559,14,58616,58616,44595,34724,52303
43580,19004,20326,26458,17122,6.90463e+12,56.3642,22544.8,43580,9897,72,23254,23254,22056,20915,20834
28886,11255,12882,17654,11232,7.17389e+12,56.6338,14528.6,28886,6271,72,16004,16004,14263,11964,11471
83495,3189,21817,53724,29771,9.53988e+12,59.6752,26804.3,83495,10622,72,61678,61678,38093,37541,9080
39713,810,9305,25746,13967,9.89643e+12,60.0361,12063.2,39713,4523,72,30408,30408,10203,11077,3150
44516,7298,10401,28864,15652,9.89682e+12,60.0413,13432.4,44516,5057,72,34115,34115,29658,29562,24313
51474,9435,22833,31471,20003,7.18052e+12,56.267,25462,51474,11103,72,28641,28641,20049,9961,9758
56791,3351,17841,36020,20771,8.85744e+12,58.7972,21227.2,56791,8681,72,38950,38950,22751,12138,8470
93107,19267,26765,59470,33637,9.20141e+12,59.2717,32076.5,93107,13034,72,66342,66342,60200,58673,49902
96135,9210,22340,62340,33795,9.9213e+12,60.142,28153.2,96135,10883,72,73795,73795,53415,51272,31041
33670,881,7852,21834,11836,9.91471e+12,60.0454,10269.2,33670,3819,72,25818,25818,9489,10079,3322
54779,5636,14749,35174,19605,9.44687e+12,59.4934,18212,54779,7168,72,40030,40030,26879,18651,15731
86113,20326,35237,53159,32954,7.63459e+12,57.3232,39470.5,86113,17159,72,50876,50876,42231,32071,31865
94279,23169,24636,60657,33622,9.54465e+12,59.6777,30167.9,94279,11997,72,69643,69643,68477,67408,67237
97562,8321,41311,59971,37591,7.44581e+12,57.1064,45922.7,97562,20120,72,56251,56251,37363,15181,14451
5586,1698,5586,0,5586,7.99857,0,5586,5586,5586,1,0,0,0,0,0
98918,46609,52370,58960,39958,6.08248e+12,55.4228,56297.9,98918,25508,72,46548,46548,44500,41800,41230
25750,4413,6067,16698,9052,9.87774e+12,59.9201,8008.29,25750,2943,72,19683,19683,17377,17318,14708
3973,137,963,2573,1400,1.00025e+13,58.6829,1428.43,3973,469,66,3010,3010,1812,1790,508
34922,24363,32637,24047,10875,9.21046e+12,3.99132,32728.7,34922,10894,9,2285,2285,1705,2285,1712
65703,18565,20318,41715,23988,8.91761e+12,58.8427,24167.4,65703,9882,72,45385,45385,43169,41035,40665
46527,3212,11723,30017,16510,9.66426e+12,59.7757,14808.5,46527,5705,72,34804,34804,23772,10774,10308
24784,3147,11097,15133,9651,7.14724e+12,56.4644,12556,24784,5390,72,13687,13687,9182,8968,3904
9429,2557,4687,5693,3736,6.53355e+12,53.0699,5340.4,9429,2262,72,4742,4742,3976,3091,3290
25975,13565,15623,15162,10813,5.18016e+12,54.1299,16794.7,25975,7602,72,10352,10352,9583,8509,8449
73043,23017,27603,45484,27559,8.04463e+12,57.823,31453,73043,13447,72,45440,45440,42006,38744,38052
92450,2633,21452,59965,32485,9.91622e+12,60.1455,27080.1,92450,10446,72,70998,70998,27103,28627,9789
58077,3055,13487,37672,20405,9.91255e+12,60.1112,17279.2,58077,6565,72,44590,44590,29318,20032,10559
43200,13684,18823,26467,16733,7.29391e+12,56.549,21131.4,43200,9159,72,24377,24377,20127,15101,15120
93054,4482,36042,57806,35248,7.91025e+12,57.377,40708.4,93054,17538,72,57012,57012,33715,15506,9772
16065,2566,4457,10308,5757,9.3478e+12,59.1516,5740.29,16065,2163,72,11608,11608,9458,6996,6984
53815,15543,22893,33071,20744,7.43748e+12,57.0358,25688.2,53815,11153,72,30922,30922,26590,21593,21460
18864,2168,7552,11679,7185,7.76505e+12,55.983,8811.58,18864,3666,72,11312,11312,6603,3780,2962
58698,4631,13680,38058,20640,9.92339e+12,60.0978,17496.2,58698,6664,72,45018,45018,31796,31535,15608
12623,130,3007,8180,4443,9.85059e+12,59.6586,4117.95,12623,1448,72,9616,9571,2643,419,576
83554,8170,19410,54181,29373,9.92037e+12,60.1363,24564,83554,9456,72,64144,64144,47172,45215,27686
22370,5094,5911,14389,7981,9.51736e+12,59.4803,7598.23,22370,2871,72,16459,16459,15475,14205,13981
57200,12116,24644,35090,22110,7.35483e+12,56.0322,27566.4,57200,11983,72,32556,32556,25941,16824,14854
84457,22822,25918,53658,30799,8.954e+12,58.9486,30686.8,84457,12620,72,58539,58539,55489,51349,50507
3132,407,940,2001,1131,9.24452e+12,54.2372,1313.57,3132,441,60,2192,2192,1833,1423,1411
65565,17441,28337,40212,25353,7.32592e+12,56.929,31598.7,65565,13788,72,37228,37228,32205,25383,23803
17461,7610,9263,13674,3787,79462700000,8.91936,9523.12,17461,8328,11,8198,8198,7119,7204,7049
99928,5358,53654,78299,21629,79681100000,8.99798,54282.9,99928,48283,11,46274,46274,14780,17228,12350
82821,6492,29249,51948,30873,8.34951e+12,58.2141,33675.8,82821,14242,72,53572,53572,32223,16030,10846
94686,19433,50603,74176,20510,79617700000,8.99705,51217.1,94686,45539,11,44083,44083,22647,24597,20717
99532,25892,37457,62004,37528,8.05981e+12,57.3075,42472.4,99532,18242,72,62075,62075,50740,37356,37011
40311,3833,12656,25565,14746,8.87286e+12,58.7692,15208.7,40311,6159,72,27655,27655,18866,8582,8213
53004,2881,19398,33125,19879,8.19409e+12,57.9159,22396.9,53004,9433,72,33606,33606,20285,10578,7584
52464,4652,12196,34020,18444,9.93125e+12,60.1009,15672.7,52464,5941,72,40268,40268,27596,18268,15861
98861,30594,32983,62335,36526,8.6127e+12,58.538,38256.4,98861,16068,72,65878,65878,64556,62720,62527
42407,18704,23533,33275,9132,8.0089e+10,8.99599,23928.5,42407,21175,11,18874,18874,16060,16193,15944
4701,84,207,3722,979,5.86062e+13,11.9623,424.04,4701,204,13,4494,4494,3408,2473,4006
20793,1694,6142,13270,7523,9.10634e+12,58.9265,7679.77,20793,2980,72,14651,14651,9398,3256,3072
73091,14268,16958,47399,25692,9.92679e+12,60.1377,21559.9,73091,8261,72,56133,56133,52885,52111,47568
90063,30197,30294,56754,33309,8.56692e+12,58.4891,35152.5,90063,14751,72,59769,59769,59670,59625,59619
90779,15755,21126,58864,31915,9.91109e+12,60.135,26658,90779,10291,72,69653,69653,61902,54492,52511
42791,6419,9946,27761,15030,9.91106e+12,60.0716,12888.4,42791,4837,72,32845,32845,28621,27633,21597
98964,10329,22998,64176,34788,9.91318e+12,60.1419,28961,98964,11200,72,75966,75966,58495,55822,35018
16456,1195,6618,10188,6268,7.76263e+12,57.175,7743.89,16456,3220,72,9838,9838,6027,2768,1862
91474,1555,23565,58907,32567,9.58908e+12,59.7416,28982.5,91474,11474,72,67909,67909,40246,26406,6203
51408,210,18171,32249,19159,8.34919e+12,58.1696,21140.5,51408,8847,72,33237,32565,18758,10814,1150
14017,4364,5272,8746,5271,8.11063e+12,56.6604,6302.9,14017,2551,72,8745,8745,8562,8289,8422
64113,18412,22034,40325,23788,8.4746e+12,58.3427,25645.3,64113,10728,72,42079,42079,39261,35501,34662
22345,641,6473,14263,8082,9.21644e+12,57.82,8108.83,22345,3147,72,15872,15824,6135,2231,164
26450,5179,7107,16987,9463,9.46578e+12,59.2352,9023.61,26450,3456,72,19343,19343,16602,13452,13395
4934,888,2820,2923,2011,5.63909e+12,48.0353,3182.5,4934,1353,66,2114,2074,8,88,221
34032,7264,8423,21991,12041,9.7383e+12,59.8037,10819.9,34032,4101,72,25609,25609,24188,22343,21967
80604,12298,21924,51706,28898,9.4031e+12,59.5116,26706.1,80604,10680,72,58680,58680,49197,36197,33185
98961,23617,28784,63150,35811,9.15622e+12,56.5793,34359.2,98961,14014,72,70177,70177,64651,58111,58064
34980,5446,12384,21947,13033,8.35861e+12,57.5218,14552,34980,6015,72,22596,22596,17062,11766,10484
42493,3256,9933,27551,14942,9.9135e+12,60.0608,12848.5,42493,4838,72,32560,32560,22868,22667,11057
51583,12293,18082,32383,19200,8.38691e+12,57.2487,21072.9,51583,8786,72,33501,33501,30966,27459,26849
53990,5691,19449,33795,20195,8.28091e+12,58.075,22510.1,53990,9475,72,34541,34541,23516,10575,10129
71456,16129,21201,45531,25925,9.08147e+12,59.1038,25394.7,71456,10322,72,50255,50255,46347,41753,41774
17227,2701,8088,10456,6771,6.87986e+12,56.1296,9154.09,17227,3934,72,9139,9139,5767,4003,3378
33102,8405,11118,20864,12238,8.5927e+12,57.3489,13241.1,33102,5410,72,21984,21984,19419,16408,16514
67534,15159,15706,43797,23737,9.91154e+12,60.1126,20008.5,67534,7645,72,51828,51828,51162,50346,50240
12246,3188,4339,7691,4555,8.34569e+12,57.8036,5296.11,12246,2100,72,7907,7907,6956,5617,5535
85769,6370,32489,53400,32369,8.02272e+12,57.1919,36896.9,85769,15805,72,53280,53280,33371,9941,9038
98076,12932,22784,63595,34481,9.91612e+12,60.145,28703.6,98076,11092,72,75292,75292,63461,47304,43460
40089,2357,12563,25429,14660,8.87949e+12,58.6603,15108.6,40089,6103,72,27526,27526,17145,4960,4515
29409,2274,13463,17901,11508,7.00794e+12,55.3959,15107.8,29409,6543,72,15946,15904,9652,2208,2122
86961,15981,20245,56381,30580,9.91038e+12,60.136,25581,86961,9859,72,66716,66716,60517,60381,53073
62136,10115,14473,40299,21837,9.90906e+12,60.1026,18481,62136,7047,72,47663,47663,42406,41184,33614
76429,21169,23762,48504,27925,8.89187e+12,58.8674,28124.3,76429,11561,72,52667,52667,49512,45258,44297
27868,5603,6489,18084,9784,9.90128e+12,59.9868,8564.12,27868,3149,72,21379,21379,20101,20077,18697
73949,4183,25118,46563,27386,8.52966e+12,58.421,29209.3,73949,12232,72,48831,48783,17956,10304,5138
43255,11835,15042,27175,16080,8.44274e+12,58.2455,17633.5,43255,7327,72,28213,28213,25877,25786,23198
50069,7918,15092,31857,18212,9.02601e+12,58.9912,18189.9,50069,7343,72,34977,34977,28676,20089,18092
97466,81147,97466,0,97466,7.99992,0,97466,97466,97466,1,0,0,0,0,0
46475,1031,10850,30134,16341,9.89519e+12,60.0549,13995.9,46475,5269,72,35625,35625,12311,4020,3965
71821,17765,31648,43934,27887,7.22515e+12,56.8121,35120.6,71821,15413,72,40173,40173,32768,24105,23966
59406,3691,3713,47296,12110,5.73204e+13,11.9968,4506.31,59406,2431,14,55693,55693,55581,55523,55643
35380,7907,16823,21428,13952,6.78786e+12,55.0913,18677.8,35380,8188,72,18557,18557,14440,9783,8792
43431,4018,10162,28164,15267,9.88929e+12,60.0387,13134.2,43431,4937,72,33269,33269,23492,22598,13588
2155,401,1807,1175,980,2.37123e+12,12.0933,1905.78,2155,858,42,348,348,112,54,0
28698,7087,13553,17397,11301,6.82538e+12,55.9006,15133.1,28698,6589,72,15145,15145,12391,9774,9260
58825,44279,58825,0,58825,7.99986,0,58825,58825,58825,1,0,0,0,0,0
90678,3554,58744,71099,19579,2.23393e+13,5.52985,67294.9,90678,19582,13,31934,31934,12825,15071,5799
59695,13888,20965,37462,22233,8.37896e+12,58.2152,24332.9,59695,10208,72,38730,38730,33524,27356,27328
69684,4104,37260,41469,28215,6.01278e+12,54.9261,40172.7,69684,18129,72,32424,32424,19153,3722,3282
8281,571,2016,5364,2917,9.87246e+12,59.3945,2815.88,8281,978,72,6265,6265,4241,1874,1936
23456,983,8474,14682,8774,8.27782e+12,57.9389,10038.5,23456,4123,72,14982,14886,9642,4063,3287
57799,13704,19713,36375,21424,8.51623e+12,58.3792,23035.8,57799,9597,72,38086,38086,34395,29326,28296
10851,4667,5280,6556,4295,6.67142e+12,53.523,6014.25,10851,2567,72,5571,5571,5073,4606,4717
98305,17089,22842,63745,34560,9.91755e+12,60.1481,28769.5,98305,11128,72,75463,75463,68591,59248,57056
39176,5336,15078,24357,14819,7.95616e+12,57.6363,17360.8,39176,7339,72,24098,24098,16303,9804,7993
61807,14324,17421,39547,22260,9.27303e+12,59.303,21196.1,61807,8474,72,44386,44386,40685,36393,36286
57892,190,13519,37541,20351,9.89519e+12,60.0746,17293.9,57892,6572,72,44373,44373,25042,24643,1273
69818,9187,25382,43658,26160,8.22113e+12,57.5539,29165.2,69818,12343,72,44436,44436,31557,16371,15944
21813,3783,5092,14151,7662,9.91653e+12,59.9532,6798.93,21813,2474,72,16721,16721,14788,14754,12581
31648,6801,7398,20519,11129,9.90252e+12,60.0196,9696.42,31648,3593,72,24250,24250,23546,22673,22528
31762,11143,12836,19635,12127,7.72181e+12,56.2826,14717.2,31762,6246,72,18926,18926,18046,16931,16751
96145,1783,31397,60746,35399,8.69806e+12,58.6542,36598.4,96145,15295,72,64748,64748,37426,17941,3973
28732,4083,6662,18637,10095,9.9586e+12,60.0362,8786.82,28732,3245,72,22070,22070,18906,18181,13711
54680,3047,14658,35109,19571,9.45878e+12,59.5424,18120.7,54680,7138,72,40022,40022,19078,11097,7143
91731,13074,25820,58683,33048,9.28371e+12,59.3634,31099,91731,12573,72,65911,65911,53061,35494,31327
83326,30271,35265,51223,32103,7.44721e+12,57.0954,39302.3,83326,17174,72,48061,48061,43975,38327,37206
96723,29256,47680,58271,38452,6.55066e+12,55.557,51787.9,96723,23211,72,49043,49043,43352,37985,36671
46299,13725,24949,36284,10015,7.9725e+10,8.96734,25373.1,46299,22448,11,21350,21350,14222,14727,13730
37784,6184,19413,22623,15161,6.31068e+12,55.6014,21248.2,37784,9457,72,18371,18371,12341,5323,5173
62132,16317,21071,39133,22999,8.53462e+12,58.4121,24609.4,62132,10258,72,41061,41061,35852,28777,27144
37821,2204,8802,24523,13298,9.92236e+12,60.0498,11457,37821,4286,72,29019,29019,15368,15313,7539
14793,1064,3487,9591,5202,9.9018e+12,59.8327,4745.6,14793,1693,72,11306,11306,7735,5346,3483
31778,12830,15688,19153,12625,6.53918e+12,55.8681,17343.9,31778,7630,72,16090,16090,14681,13345,13199
90343,5359,30837,56852,33491,8.50266e+12,58.2259,35677.3,90343,15001,72,59506,59506,36276,21812,7874
37496,5329,9036,24267,13229,9.82279e+12,59.8964,11646.9,37496,4393,72,28460,28460,24366,23384,17533
26198,1799,6891,16861,9337,9.5193e+12,59.4631,8801.48,26198,3344,72,19307,19307,12640,4794,4563
63873,11231,14877,41424,22449,9.90626e+12,60.0996,18979.8,63873,7238,72,48996,48996,43720,43613,37371
55808,12766,12975,36195,19613,9.91873e+12,60.0944,16637.6,55808,6315,72,42833,42833,42558,42357,42368
46752,10209,10852,30324,16428,9.90938e+12,60.0707,14017.4,46752,5272,72,35900,35900,35145,34969,34032
11646,402,2781,7558,4088,9.88396e+12,59.6507,3823.15,11646,1349,72,8865,8865,5465,3658,1437
45890,4929,10713,29756,16134,9.90971e+12,60.0566,13821.9,45890,5210,72,35177,35177,27486,26238,16688
10509,1042,2523,6811,3698,9.88636e+12,59.5319,3483.34,10509,1220,72,7986,7986,5702,5440,3325
3936,625,958,2554,1382,9.95279e+12,58.6814,1421.12,3936,458,66,2978,2978,2523,2125,2147
73011,5909,38801,43493,29518,6.06524e+12,55.3747,41838.2,73011,18903,72,34210,34210,22363,8585,8216
41021,8716,19951,24764,16257,6.64339e+12,56.0354,22000.9,41021,9711,72,21070,21070,15663,9863,8456
99238,2703,24539,64100,35138,9.71427e+12,59.9032,30420.3,99238,11945,72,74699,74699,30092,29693,9825
93313,32506,37151,57782,35531,7.77564e+12,57.5019,41754.2,93313,18090,72,56162,56162,52065,47305,47188
10834,1735,4455,6689,4145,7.65101e+12,56.8754,5266.53,10834,2165,72,6379,6379,4413,2115,2255
99508,6836,39553,61620,37888,7.78225e+12,57.5225,44421.5,99508,19264,72,59955,59955,38097,12482,11460
56515,35305,56515,0,56515,7.99986,0,56515,56515,56515,1,0,0,0,0,0
81323,15377,24079,51822,29501,9.08963e+12,58.9906,28763.2,81323,11709,72,57244,57244,47086,35117,34716
86428,10765,20073,56048,30380,9.91252e+12,60.1265,25381.4,86428,9770,72,66355,66355,52780,39720,36126
51052,4701,25005,39852,11200,78534900000,8.99542,25477.9,51052,22501,11,26047,26047,9929,11917,7951
35227,4474,8221,22847,12380,9.91176e+12,60.0223,10724.2,35227,3998,72,27006,27006,22500,16402,15010
9085,40,2952,5754,3331,8.79586e+12,58.0846,3739.07,9085,1434,72,4895,1211,2957,1580,146
26785,1952,6618,17304,9481,9.76055e+12,59.7717,8593.48,26785,3224,72,20167,20167,11679,8151,6560
41659,2577,19398,25304,16355,6.90957e+12,55.7996,21543.8,41659,9440,72,22261,22261,11418,4744,2478
24914,1645,5806,16165,8749,9.93542e+12,59.9674,7699.77,24914,2824,72,19108,19108,10947,10771,5729
55547,8917,12903,36028,19519,9.93448e+12,60.1077,16550.4,55547,6285,72,42644,42644,37842,31339,29835
93873,5294,46756,73327,20546,78723400000,8.99671,47394.8,93873,42072,11,47117,47117,15382,19050,11731
40907,6508,9513,26538,14369,9.92322e+12,60.0606,12344.6,40907,4630,72,31394,31394,27051,26959,21873
3514,884,1431,2178,1336,8.0755e+12,56.0757,1785.29,3514,697,69,2083,2083,1931,1768,1927
53725,12431,19481,33606,20119,8.23737e+12,58.0254,22522,53725,9485,72,34244,34244,25835,15969,15658
13595,1228,3225,8810,4785,9.90761e+12,59.7298,4397.3,13595,1570,72,10370,10370,7539,7474,4226
68832,14198,20156,43907,24925,9.13077e+12,59.161,24239.2,68832,9811,72,48676,48676,41855,33870,33606
48798,6524,14249,31131,17667,9.14474e+12,58.5473,17317.3,48798,6928,72,34549,34549,25750,15406,15046
29573,3699,6917,19175,10398,9.90606e+12,60.0241,9093.41,29573,3365,72,22656,22656,18813,17911,12440
81868,2464,25764,51905,29963,8.84203e+12,58.8132,30366.3,81868,12536,72,56104,56104,34302,14565,7574
75746,13049,17796,49088,26658,9.87141e+12,60.0741,22526.7,75746,8655,72,57950,57950,52574,51302,43576
99429,14720,23087,64472,34957,9.91821e+12,60.1526,29078.6,99429,11244,72,76342,76342,66335,52684,49452
29412,3799,6834,19080,10332,9.92184e+12,59.996,9001.42,29412,3317,72,22578,22578,18103,18024,12737
84531,5069,31578,52713,31818,8.08658e+12,57.8819,35959.2,84531,15371,72,52953,52953,33230,10003,9227
72743,945,3043,57588,15155,5.85677e+13,11.9972,3931.88,72743,3039,13,69700,69700,50841,34109,61313
69638,17030,22141,44102,25536,8.80506e+12,58.7609,26139.9,69638,10777,72,47497,47497,43567,38123,37049
5893,409,1406,3832,2061,9.92336e+12,59.2018,2031.37,5893,680,72,4487,4487,3018,1369,1387
44340,13178,15237,27889,16451,8.4892e+12,58.3109,17897,44340,7419,72,29103,29103,27731,25939,25602
91763,23684,36899,56754,35009,7.72143e+12,57.1906,41417.6,91763,17968,72,54864,54864,45321,32178,29232
54859,8137,13693,35415,19444,9.68679e+12,59.8227,17240.5,54859,6658,72,41166,41166,34551,34372,26560
20387,2504,9348,12413,7974,7.01777e+12,56.3556,10584.2,20387,4548,72,11039,11039,6694,5183,4437
41407,4873,9621,26856,14551,9.94038e+12,60.0799,12478.3,41407,4687,72,31786,31786,26051,18260,16463
76306,15134,28518,47581,28725,8.08585e+12,57.8694,32536.4,76306,13878,72,47788,47788,38336,25296,22382
46946,4978,10947,30438,16508,9.91647e+12,60.0615,14115.1,46946,5332,72,35999,35999,27379,27197,16874
50292,5946,22461,30722,19570,7.15712e+12,56.5918,25026.6,50292,10938,72,27831,27831,19303,9314,9113
22843,245,5760,14742,8101,9.68068e+12,59.65,7492.47,22843,2802,72,17083,16990,5405,5412,1021
46363,473,10806,30067,16296,9.91867e+12,60.079,13943.9,46363,5263,72,35557,35557,20546,20237,2132
52409,11705,23036,32074,20335,7.24722e+12,56.7955,25716.6,52409,11212,72,29373,29373,23289,17499,16073
62306,11392,14455,40412,21894,9.923e+12,60.1155,18475.3,62306,7036,72,47851,47851,43397,43300,38128
88711,9444,28525,56138,32573,8.75514e+12,58.7145,33411.3,88711,13884,72,60186,60186,39242,31707,27786
98683,10185,27159,63240,35443,9.35465e+12,59.1638,32824.6,98683,13217,72,71524,71524,51613,51092,27166
86061,15019,26432,54672,31389,8.94548e+12,58.95,31281.3,86061,12865,72,59629,59629,55210,51022,49946
39430,8840,9174,25569,13861,9.92062e+12,60.064,11921.9,39430,4464,72,30256,30256,29783,29771,29397
20983,2162,7549,13138,7845,8.27979e+12,56.4327,8987.45,20983,3661,72,13434,13434,7610,4930,3811
35069,6463,12715,21934,13135,8.25633e+12,57.4088,14865,35069,6188,72,22354,22354,18384,13819,13694
68989,26090,31461,42018,26971,7.02803e+12,56.5649,34742.6,68989,15323,72,37528,37528,35163,32988,32495
56665,4189,20722,35422,21243,8.20563e+12,57.8272,23888.3,56665,10078,72,35943,35943,23901,15503,9288
52570,11842,24202,31988,20582,6.97132e+12,56.0343,26811,52570,11769,72,28368,28368,21280,14632,12812
28627,2465,6642,18573,10054,9.93585e+12,60.0388,8764.34,28627,3232,72,21985,21985,15915,15791,8572
52440,9433,12195,34004,18436,9.92766e+12,60.1002,15670.9,52440,5941,72,40245,40245,36956,36182,31552
28644,3906,9512,18073,10571,8.64182e+12,57.8555,11411,28644,4624,72,19132,19132,14110,8262,8124
43047,1687,10000,27926,15121,9.93099e+12,60.0821,12953.6,43047,4866,72,33047,33047,20941,20698,6109
11375,207,3070,7304,4071,9.48328e+12,59.156,4062.82,11375,1489,72,8305,8209,2793,1630,839
96473,6833,22419,62560,33913,9.92191e+12,60.1463,28250.9,96473,10921,72,74054,74054,44160,26718,23366
94947,480,41406,58156,36791,7.28606e+12,56.9027,45825.1,94947,20169,72,53541,52152,30455,17567,2366
89150,20391,20697,57816,31334,9.92179e+12,60.1379,26147.6,89150,10078,72,68453,68453,68107,68026,67695
39211,8617,11261,25055,14156,9.23023e+12,59.1897,13833.5,39211,5482,72,27950,27950,25614,22501,21838
17636,940,5348,11218,6418,9.02999e+12,57.858,6688.02,17636,2600,72,12288,12288,7427,4570,1623
19187,2268,5589,12242,6945,9.18755e+12,58.9747,7039.48,19187,2717,72,13598,13598,10766,10683,7452
45226,8820,10553,29322,15904,9.9046e+12,60.0702,13628.8,45226,5132,72,34673,34673,32251,32190,29437
74786,1323,30065,46263,28523,7.72815e+12,57.428,33863,74786,14642,72,44721,44696,25361,11861,1801
90461,1621,20989,58662,31799,9.91613e+12,60.1436,26511.3,90461,10219,72,69472,69472,22708,24786,6452
31858,1196,17073,24960,6898,79647400000,8.99068,17424.8,31858,15358,11,14785,14785,4282,5137,3442
11097,2940,3340,7065,4032,9.05607e+12,57.9993,4284.29,11097,1612,72,7757,7757,7204,6635,6694
83297,8453,19353,54014,29283,9.91696e+12,60.1366,24497.3,83297,9422,72,63944,63944,48114,46091,28606
95886,4880,5526,76230,19656,5.76196e+13,12.0015,6546.87,95886,2626,20,90360,90360,86319,83442,88512
57389,2516,16196,36713,20676,9.26966e+12,59.3011,19743.9,57389,7879,72,41193,41193,20917,12084,8242
64916,22575,35024,38578,26338,5.95586e+12,55.2449,37745.4,64916,17062,72,29892,29892,24767,17699,16229
99952,11579,31350,63385,36567,8.86662e+12,58.7861,36812.3,99952,15268,72,68602,68602,50680,29611,28804
6751,590,2503,4216,2535,8.24161e+12,57.27,3103.9,6751,1213,72,4248,4181,2039,746,397
6005,1376,1501,3889,2116,9.73936e+12,58.8863,2128.57,6005,717,72,4504,4504,4381,4351,4292
37772,2043,9230,24423,13349,9.76254e+12,59.8489,11849.7,37772,4490,72,28542,28542,18797,18563,6916
55878,11219,20746,34873,21005,8.13826e+12,57.9044,23850.9,55878,10107,72,35132,35132,29384,21463,19789
71544,13615,16603,46391,25153,9.9233e+12,60.1385,21122.4,71544,8088,72,54941,54941,51363,46554,45476
82237,2219,26010,52117,30120,8.83493e+12,58.798,30617.8,82237,12669,72,56227,56179,19406,13150,7348
22538,2659,5498,14569,7969,9.78643e+12,59.801,7229.28,22538,2673,72,17040,17040,13127,9412,8481
92307,14581,23391,59524,32783,9.641e+12,58.8407,28876.8,92307,11376,72,68916,68916,60469,48947,46242
53249,19019,21937,32836,20413,7.60723e+12,57.199,24763.3,53249,10682,72,31312,31312,29696,28158,27965
88017,6157,28114,55730,32287,8.78543e+12,58.7543,32980.9,88017,13690,72,59903,59903,34796,20250,14773
92676,7672,31888,58266,34410,8.4723e+12,58.2411,36816.7,92676,15529,72,60788,60788,39767,14957,14112
42053,1672,9777,27277,14776,9.92289e+12,60.0679,12672.5,42053,4759,72,32276,32276,20461,13798,6020
7167,1155,3594,4325,2842,6.49614e+12,55.2047,4123.9,7167,1746,72,3573,3573,2619,1607,1646
6739,1240,1604,4375,2364,9.85799e+12,59.3109,2297.07,6739,768,72,5135,5135,4634,4621,4190
59858,7184,13898,38820,21038,9.91634e+12,60.1103,17785.8,59858,6765,72,45960,45960,37813,35926,24084
9864,1114,5079,7714,2150,79156700000,8.97952,5276.31,9864,4569,11,4785,4785,1940,2226,1667
26302,1987,6111,17060,9242,9.9505e+12,59.998,8087.42,26302,2977,72,20191,20191,12475,12247,6938
39871,7003,10777,25591,14280,9.44064e+12,59.4634,13437.6,39871,5244,72,29094,29094,24641,20418,19349
36296,4712,9813,23298,12998,9.43204e+12,59.199,12281.5,36296,4774,72,26483,26483,21049,19982,12430
64262,11685,15982,41490,22772,9.7006e+12,59.8568,20037.2,64262,7773,72,48280,48280,43117,36102,34476
83925,22174,22737,53852,30073,9.4166e+12,59.4673,27692.7,83925,11060,72,61188,61188,60646,60523,59903
45316,1251,25542,26734,18582,5.63802e+12,53.9881,27492.6,45316,12428,72,19774,19486,11079,6489,750
12195,2559,2913,7905,4290,9.88153e+12,59.659,3991.3,12195,1415,72,9282,9282,8782,8772,8348
9659,412,2401,6236,3423,9.77188e+12,58.8123,3297.68,9659,1164,72,7258,7258,4434,4384,1157
46877,6047,10917,30394,16483,9.91902e+12,60.0944,14086.7,46877,5318,72,35960,35960,30068,22075,20219
40535,3631,9480,26287,14248,9.91608e+12,60.0515,12285.4,40535,4617,72,31055,31055,22601,22421,12316
76442,13112,35256,46490,29952,6.96474e+12,56.4909,38801.1,76442,17173,72,41186,41186,31514,20363,17521
12156,73,4554,7588,4568,8.17297e+12,57.5096,5479.32,12156,2214,72,7602,5277,2158,1145,296
78436,13575,18187,50869,27567,9.92352e+12,60.1381,23075.8,78436,8854,72,60249,60249,53513,53380,45353
22697,5446,6163,14572,8125,9.45483e+12,59.3509,7850.45,22697,3002,72,16534,16534,15596,14775,14625
52859,11911,12456,34253,18606,9.87077e+12,60.0296,15946.9,52859,6055,72,40403,40403,39769,38969,38861
4693,38,2480,2802,1891,6.17102e+12,46.9141,2856.16,4693,1192,67,1720,391,591,300,0
81407,8287,18941,52792,28615,9.90674e+12,60.1174,23982.9,81407,9214,72,62466,62466,47000,33717,28008
52323,1210,12160,33926,18397,9.92822e+12,60.1128,15633.2,52323,5922,72,40163,40163,14133,4782,4675
40577,2830,9430,26318,14259,9.94765e+12,60.078,12240.1,40577,4593,72,31147,31147,21472,21276,9719
79015,11353,18324,51252,27763,9.91559e+12,60.1377,23246.5,79015,8918,72,60691,60691,52324,50368,38213
21114,5008,6228,13459,7655,9.11572e+12,58.9594,7785.36,21114,3025,72,14886,14886,13452,11519,11201
7694,1855,4871,4448,3246,4.86958e+12,52.0603,5317.94,7694,2367,72,2823,2823,2120,1332,1533
65708,24017,24931,40913,24795,8.00972e+12,57.7746,28450.1,65708,12134,72,40777,40777,40306,40146,39708
37448,6176,15848,23027,14421,7.45911e+12,55.8478,17942.6,37448,7698,72,21600,21600,15643,9972,8578
39935,3153,14398,24995,14940,8.27396e+12,58.0408,16792.4,39935,7009,72,25537,25537,17203,7405,7213
13018,1523,6104,7900,5118,6.93395e+12,54.8679,6968.18,13018,2968,72,6914,6914,4698,2717,2245
80379,16600,24880,51025,29354,8.92088e+12,58.9159,29440.7,80379,12120,72,55499,55499,47524,36659,34096
10657,1340,7219,6092,4565,4.20901e+12,51.2532,7734.36,10657,3496,72,3438,3390,2141,930,816
65786,11246,15315,42661,23125,9.90736e+12,60.0982,19520.5,65786,7456,72,50471,50471,45583,44443,37415
79989,703,4920,63668,16321,5.73765e+13,11.9974,5842.93,79989,3272,14,75069,75069,47386,28329,62603
39993,2397,20963,23889,16104,6.15754e+12,55.1895,22852.4,39993,10194,72,19030,19030,11586,2901,2758
45250,2035,19922,27695,17555,7.22712e+12,56.1256,22301.5,45250,9683,72,25328,25328,14025,5377,4376
43333,6234,16568,26954,16379,7.97914e+12,57.6943,19057.3,43333,8058,72,26765,26765,20262,12612,10866
47925,9226,13566,30646,17279,9.27558e+12,58.8702,16617.6,47925,6602,72,34359,34359,30222,24638,23364
80458,19497,38138,48741,31717,6.7953e+12,55.9613,41768.9,80458,18573,72,42320,42320,33498,21345,18642
64897,1708,23552,40588,24309,8.24081e+12,58.0462,27108.2,64897,11473,72,41345,41345,18026,9561,5345
12853,8865,9075,7271,5582,3.88683e+12,52.2294,9623.44,12853,4415,72,3778,3778,3501,3496,3312
39851,3557,21132,23755,16096,6.09033e+12,55.3304,22994.6,39851,10291,72,18719,18719,11922,4024,3913
61066,10483,26118,37493,23573,7.39135e+12,56.5839,29212.5,61066,12715,72,34948,34948,25451,16109,13707
69860,2572,16250,45308,24552,9.90263e+12,60.1008,20677.3,69860,7903,72,53610,53610,22487,23369,9075
86697,36237,39190,52855,33842,7.07739e+12,56.6415,43189.4,86697,19080,72,47507,47507,46032,44298,44461
77643,2282,18010,50362,27281,9.9153e+12,60.1352,22857.7,77643,8767,72,59633,59633,22992,24267,8478
31180,6021,7294,20216,10964,9.89643e+12,59.9804,9562.71,31180,3538,72,23886,23886,22353,22004,19917
55407,11491,16173,35357,20050,9.14018e+12,59.1379,19578.6,55407,7866,72,39234,39234,34227,34088,28267
96217,12023,22361,62394,33823,9.91295e+12,60.1431,28183.4,96217,10889,72,73856,73856,61441,58538,40423
74306,13892,17243,48198,26108,9.92491e+12,60.1377,21909.4,74306,8400,72,57063,57063,52099,52010,46123
79985,8561,28362,50138,29847,8.33323e+12,58.1828,32650.4,79985,13811,72,51623,51623,34533,22737,18928
42472,3018,9933,27537,14935,9.90514e+12,60.0357,12848,42472,4828,72,32539,32539,22523,22316,10282
48719,4008,11338,31586,17133,9.92553e+12,60.0992,14608.1,48719,5523,72,37381,37381,24488,23778,13699
89822,16549,26505,57250,32572,9.10184e+12,59.1429,31607.5,89822,12903,72,63317,63317,52854,40442,40140
93708,20732,21727,60783,32925,9.92383e+12,60.1529,27419.7,93708,10585,72,71981,71981,70517,70491,68882
54322,1335,12694,35217,19105,9.89741e+12,60.0756,16271.1,54322,6179,72,41628,41628,25083,24747,4769
19372,971,4539,12562,6810,9.90595e+12,59.8924,6089.02,19372,2205,72,14833,14833,7233,3772,3430
32621,15149,16749,25512,7109,79141400000,8.992,17115.5,32621,15066,11,15872,15872,14602,14759,14458
56870,7585,13213,36885,19985,9.91327e+12,60.1062,16939.9,56870,6428,72,43657,43657,35540,27765,25673
4247,947,1041,2758,1489,9.82714e+12,58.5432,1529.09,4247,495,68,3206,3206,3124,3104,3079
30188,5612,7152,19560,10628,9.87346e+12,59.9577,9354.27,30188,3479,72,23036,23036,21064,18801,18817
65506,3424,15183,42494,23012,9.92362e+12,60.1304,19379,65506,7392,72,50323,50323,25372,25565,12158
45655,15872,18121,28283,17372,7.79707e+12,57.4616,20664.8,45655,8818,72,27534,27534,26709,25739,25935
69634,10380,16181,45155,24479,9.91423e+12,60.1183,20598.7,69634,7872,72,53453,53453,44975,44811,34646
13539,3111,3391,8753,4786,9.68713e+12,58.434,4548.51,13539,1630,72,10148,10148,10148,10148,10148
83337,25978,46336,49287,34050,5.74298e+12,54.9968,49578.4,83337,22573,72,37001,37001,31104,25602,24242
58868,46123,58868,0,58868,7.99986,0,58868,58868,58868,1,0,0,0,0,0
54421,8590,12810,35274,19147,9.87942e+12,60.0489,16386.8,54421,6233,72,41611,41611,35482,29640,28062
74817,8238,17421,48506,26311,9.91226e+12,60.1167,22110.3,74817,8487,72,57396,57396,44106,31878,27820
12184,1973,3915,7718,4466,8.80686e+12,58.4217,4906.87,12184,1902,72,8269,8269,7217,5982,6166
6480,630,1932,4135,2345,9.19922e+12,58.3299,2562.45,6480,934,72,4548,4548,2804,2103,1854
41558,5609,10640,26772,14786,9.6243e+12,59.7122,13437,41558,5181,72,30918,30918,25651,18499,16856
62833,37253,38291,36566,26267,5.05995e+12,54.0786,40605.2,62833,18653,72,24542,24542,24196,23883,24021
26567,11358,16502,15405,11162,4.91522e+12,53.8295,17649.7,26567,8033,72,10065,10065,8461,6233,5944
21549,1591,5035,13985,7564,9.92592e+12,59.9381,6722.61,21549,2450,72,16514,16514,11524,8088,5526
87350,47952,87350,0,87350,7.99991,0,87350,87350,87350,1,0,0,0,0,0
54181,6617,18980,34007,20174,8.39343e+12,58.2244,22093.7,54181,9236,72,35201,35153,24250,22529,20991
34028,3011,7945,22069,11959,9.91053e+12,60.0182,10379.1,34028,3864,72,26083,26083,18868,18726,10112
19211,8048,8831,11694,7517,7.00406e+12,42.1238,10010.4,19211,4284,72,10380,10380,10380,10380,10380
2207,502,554,1430,777,1.00315e+13,57.8487,858.689,2207,266,56,1653,1653,1595,1606,1599
31922,9544,11553,19969,11953,8.26994e+12,57.5113,13548.4,31922,5622,72,20369,20369,18372,16535,16103
76562,28514,31591,47211,29351,7.586e+12,56.7431,35411.9,76562,15369,72,44971,44971,42864,40392,40522
99455,18965,37707,61911,37544,8.01484e+12,57.8108,42702.5,99455,18356,72,61748,61748,51676,37788,34666
73216,2509,23037,46423,26793,8.84392e+12,58.8014,27223.4,73216,11209,72,50179,50131,24274,22561,8795
73018,11619,22921,46302,26716,8.86576e+12,58.828,27099,73018,11162,72,50097,50097,44660,44545,38169
52399,6603,19776,32635,19764,8.05036e+12,57.7991,22699.8,52399,9628,72,32623,32623,21740,13562,11094
45232,7823,14179,28695,16537,8.87098e+12,58.7719,16985.9,45232,6897,72,31053,31053,25444,18903,18708
65657,10446,26133,40654,25003,7.78227e+12,57.4653,29561.4,65657,12725,72,39524,39524,27400,13224,12695
33645,4746,7841,21819,11826,9.92206e+12,60.0518,10255.6,33645,3819,72,25804,25804,22011,16887,15727
31012,917,7201,20120,10892,9.93614e+12,60.0324,9461.13,31012,3498,72,23811,23811,14620,9737,3396
53458,11087,22942,32804,20654,7.38107e+12,56.1277,25709.4,53458,11171,72,30516,30516,23718,15025,12950
9495,611,2278,6154,3341,9.86604e+12,59.5957,3172.2,9495,1104,72,7217,7217,4866,3406,2143
61014,18888,26864,37335,23679,7.2301e+12,56.8035,29900.1,61014,13082,72,34150,34150,30433,26209,26109
95838,15991,33251,60215,35623,8.42841e+12,58.308,38301.8,95838,16185,72,62587,62587,49108,36219,32761
21718,8663,10629,13111,8607,6.58823e+12,55.8423,11867.3,21718,5164,72,11089,11089,10092,8915,9102
27695,6359,6496,17957,9738,9.90132e+12,59.9757,8556.15,27695,3158,72,21199,21199,21036,21002,20915
24690,1483,5752,16015,8675,9.93362e+12,59.9743,7632.77,24690,2796,72,18938,18938,12709,8774,5187
34263,6248,7985,22212,12051,9.92531e+12,60.0611,10435.3,34263,3889,72,26278,26278,24154,23670,20739
32138,593,7515,20841,11297,9.91038e+12,60.0043,9836.12,32138,3658,72,24623,24623,7906,8707,2318
29319,20868,29319,0,29319,7.99973,0,29319,29319,29319,1,0,0,0,0,0
14211,2478,3380,9217,4994,9.84854e+12,59.6928,4595.72,14211,1631,72,10831,10831,9535,9511,8097
35628,10902,17616,21456,14172,6.5493e+12,55.3469,19426,35628,8576,72,18012,18012,15148,11813,11903
20733,3613,10450,12464,8269,6.44187e+12,55.624,11616.1,20733,5087,72,10283,10283,7253,3778,3702
54688,2505,19493,34273,20415,8.3207e+12,58.1262,22603.9,54688,9490,72,35195,35195,19825,10056,6612
7835,2352,3416,4811,3024,7.39085e+12,56.2596,4033.1,7835,1655,72,4419,4419,3828,3135,3343
71980,8411,32241,43931,28049,7.13618e+12,56.7115,35684,71980,15707,72,39739,39739,25331,13073,7941
22596,711,954,17888,4708,5.85564e+13,11.9915,1444.09,22596,950,13,21642,21642,19481,17590,20676
61292,2787,14296,39748,21544,9.89745e+12,60.0884,18258.4,61292,6951,72,46996,46996,21805,22242,9682
16951,3481,5734,10692,6259,8.57435e+12,55.5882,6983.51,16951,2772,72,11217,11217,9269,7049,7036
37616,10025,10648,24065,13551,9.28196e+12,59.2583,13148.1,37616,5187,72,26968,26968,26387,26357,25919
59196,13591,13728,38391,20805,9.92642e+12,60.1283,17582.4,59196,6686,72,45468,45468,45276,45163,45182
73079,15385,24597,46051,27028,8.56907e+12,58.4596,28662.7,73079,11975,72,48482,48482,37919,25502,25052
63590,13109,21740,40001,23589,8.50402e+12,57.895,25335.3,63590,10585,72,41850,41850,34158,23556,21235
77723,2825,18084,50396,27327,9.91057e+12,60.1182,22931,77723,8801,72,59639,59639,37433,25098,10074
27696,4254,6503,17958,9738,9.91109e+12,59.9654,8560.3,27696,3163,72,21193,21193,17973,17899,14192
94613,19986,30050,59939,34674,8.80899e+12,58.7809,35237.1,94613,14628,72,64563,64563,56316,54273,42432
62579,34103,62579,0,62579,7.99987,0,62579,62579,62579,1,0,0,0,0,0
21471,2465,6890,13598,7873,8.79211e+12,58.541,8418.73,21471,3352,72,14581,14581,9931,6758,5909
25814,2919,6005,16738,9076,9.93002e+12,60.0073,7956.55,25814,2920,72,19809,19809,16086,15219,9986
33959,2537,7944,22024,11935,9.88922e+12,59.994,10374.3,33959,3854,72,26015,26015,18133,8824,8538
32446,3336,12262,20223,12223,8.0405e+12,57.5962,14244.1,32446,5952,72,20184,20184,10824,5857,4172
22739,2200,5697,14674,8065,9.69995e+12,59.6903,7428.32,22739,2770,72,17042,17042,12613,7436,7333
48934,427,13229,31410,17524,9.43246e+12,59.4974,16379.6,48934,6443,72,35705,35538,20125,10443,1103
90891,18684,21087,58944,31947,9.91764e+12,60.1405,26633,90891,10264,72,69804,69804,66974,66308,62332
59840,13361,25496,36753,23087,7.41927e+12,56.825,28546.1,59840,12415,72,34344,34344,27934,20429,20341
74959,22040,23024,47618,27341,8.95239e+12,58.9384,27333.4,74959,11210,72,51935,51935,50956,50919,50002
89235,17826,30318,56172,33063,8.52551e+12,58.4297,35113.6,89235,14764,72,58917,58917,50847,39837,37261
98266,2327,30495,62364,35902,8.90896e+12,58.9124,35903.3,98266,14856,72,67771,67723,40355,17582,6611
26623,5435,14216,15845,10778,6.04045e+12,53.7724,15566.8,26623,6920,72,12407,12407,8577,4722,3889
47165,5522,10923,30594,16571,9.93068e+12,60.1174,14114.3,47165,5320,72,36242,36242,29703,28186,18718
3408,1143,1466,2102,1306,7.49734e+12,55.6725,1808.78,3408,708,68,1942,1942,1706,1682,1619
2911,792,1480,1762,1149,6.43805e+12,54.0642,1754.72,2911,714,57,1431,1383,1056,519,629
39097,2823,10334,25135,13962,9.49707e+12,59.5388,12972.5,39097,5020,72,28763,28763,19247,19016,7646
31444,857,7359,20388,11056,9.899e+12,59.9891,9639.52,31444,3575,72,24085,24085,14681,14487,3211
58034,1229,21782,36171,21863,8.07088e+12,57.7796,24975.5,58034,10589,72,36252,36252,21841,14439,4380
3685,69,186,2911,774,5.84775e+13,12.0412,382.936,3685,108,19,3499,3499,2646,1917,2705
10913,2745,4086,6814,4099,8.19322e+12,57.4517,4938.2,10913,1987,72,6827,6827,6175,5263,5292
7661,64,1874,4963,2698,9.78313e+12,59.2987,2631.75,7661,899,72,5659,3154,1503,140,221
66568,9662,19098,42527,24041,9.2173e+12,59.2564,23089.8,66568,9303,72,47470,47470,37563,28499,25561
59937,7840,13912,38875,21062,9.92679e+12,60.1101,17800.8,59937,6774,72,46025,46025,37119,36948,26280
11699,1958,2737,7597,4102,9.90053e+12,59.705,3789.57,11699,1321,72,8962,8962,7837,6816,6623
51977,1437,15892,33036,18941,8.96773e+12,58.9263,19068.1,51977,7737,72,36085,36085,20882,8229,2311
7972,452,1938,5159,2813,9.8285e+12,59.3634,2718.31,7972,933,72,6034,6034,2991,2089,1612
68695,33686,34904,41198,27497,6.35558e+12,55.7376,37914.8,68695,16997,72,33791,33791,33224,32650,32710
76080,11035,36598,45987,30093,6.7087e+12,55.8039,40022.4,76080,17824,72,39482,39482,23893,14796,11579
35360,6384,8461,22901,12459,9.83429e+12,59.9367,10957.2,35360,4117,72,26899,26899,24452,21181,20473
30561,5382,12528,18865,11696,7.63525e+12,57.2355,14341.3,30561,6100,72,18033,18033,13243,8752,7582
47093,7369,13807,30041,17052,9.1501e+12,59.1302,16777.2,47093,6726,72,33286,33286,27633,19843,18199
9114,620,3859,5618,3496,7.53738e+12,56.5795,4561.41,9114,1875,72,5255,5159,3279,961,1096
56879,4104,13209,36887,19992,9.92164e+12,60.103,16934.1,56879,6427,72,43670,43670,26346,16096,14102
79664,1180,18535,51654,28010,9.90607e+12,60.1188,23485.4,79664,9023,72,61129,61129,35915,35399,4851
99604,28320,54772,59004,40600,5.81403e+12,54.6738,58583.4,99604,26661,72,44832,44832,33623,23047,20151
23220,5542,7284,14733,8487,8.91187e+12,58.6744,8922.43,23220,3545,72,15936,15936,13742,11155,11281
22539,10087,11704,13490,9049,6.23438e+12,55.4082,12918.7,22539,5698,72,10835,10835,10365,9696,9777
78109,14161,30516,48469,29640,7.87183e+12,57.6149,34520.5,78109,14861,72,47593,47593,36498,23554,23064
13528,1731,6910,8107,5421,6.37892e+12,54.842,7745.62,13528,3361,72,6618,6618,4362,1814,1819
82856,864,27166,52343,30513,8.67486e+12,58.6052,31740.4,82856,13220,72,55690,55642,32352,17071,3668
72027,11323,21908,45801,26226,8.98584e+12,58.9804,26090.3,72027,10667,72,50119,50119,37745,23128,22686
86034,8469,19993,55796,30238,9.91169e+12,60.1321,25280.3,86034,9729,72,66041,66041,48798,46747,28693
37261,10901,13404,23334,13927,8.27369e+12,58.0369,15670.9,37261,6523,72,23857,23857,21934,19672,19811
53311,6875,12404,34580,18731,9.91478e+12,60.0958,15931,53311,6038,72,40907,40907,34206,25096,22959
90420,9944,22679,58349,32071,9.67263e+12,59.8394,28083.7,90420,11038,72,67741,67741,50443,50065,29206
62987,1548,29771,38174,24813,6.81434e+12,55.9522,32742.1,62987,14491,72,33216,33216,17380,3846,3034
58050,2298,16951,37036,21014,9.14453e+12,59.1567,20490.2,58050,8252,72,41099,41099,21241,11389,7323
44131,7480,10320,28618,15513,9.89318e+12,60.0387,13331.2,44131,5014,72,33811,33811,29743,29655,24882
22323,233,5207,14479,7844,9.91882e+12,59.9758,6947.33,22323,2529,72,17116,17116,9861,9719,1050
91775,26791,28238,58287,33488,8.9452e+12,58.9472,33353.7,91775,13751,72,63537,63537,62883,61971,62000
49672,10782,11571,32209,17463,9.92368e+12,60.0892,14891.8,49672,5637,72,38101,38101,37064,37028,35974
81829,25853,34002,50412,31417,7.55553e+12,57.2092,38022.7,81829,16558,72,47827,47827,43337,38088,38095
83206,7596,20099,53832,29374,9.7948e+12,59.8489,25186.1,83206,9772,72,63107,63107,44289,42868,25724
33595,516,13026,20875,12720,7.90917e+12,56.5184,15038.8,33595,6324,72,20569,20216,10493,3981,1729
59027,9739,23963,36470,22557,7.67542e+12,56.3463,27069.7,59027,11652,72,35064,35064,26519,19332,17362
92752,53101,53221,54558,38194,5.50902e+12,54.7103,56646.3,92752,25918,72,39531,39531,39492,39418,39491
89930,9870,20861,58322,31608,9.92414e+12,60.1469,26354.6,89930,10163,72,69069,69069,55018,37750,33449
97124,24146,52657,57675,39449,5.90995e+12,55.217,56440.7,97124,25642,72,44467,44467,38498,31237,29619
93232,5387,40975,57044,36188,7.23746e+12,56.4467,45309.3,93232,19948,72,52257,52257,31340,6758,5922
87101,18684,20223,56488,30613,9.91415e+12,60.1402,25570,87101,9845,72,66878,66878,65090,62729,62227
84006,11089,19513,54477,29529,9.91436e+12,60.1398,24696.7,84006,9500,72,64493,64493,52205,51959,37167
33151,5969,17444,19784,13367,6.11435e+12,55.2746,19068,33151,8483,72,15707,15707,11665,8155,7337
66034,12663,23446,41392,24642,8.33116e+12,57.5049,27097.1,66034,11400,72,42588,42588,34719,23997,21482
59392,5427,13846,38517,20875,9.91039e+12,60.0964,17703.3,59392,6743,72,45546,45546,31866,30668,18237
40030,5130,9361,25956,14074,9.91363e+12,60.0506,12138.7,40030,4560,72,30669,30669,24504,18636,17044
43587,10194,16755,27102,16485,7.9522e+12,57.6546,19245.8,43587,8157,72,26832,26832,22278,16100,14693
88500,5238,24045,56776,31724,9.403e+12,59.5102,29223.4,88500,11709,72,64455,64455,42323,16182,15129
87833,5243,20401,56965,30868,9.9091e+12,60.1355,25787,87833,9927,72,67432,67432,36533,36356,18212
66505,8845,15471,43126,23379,9.91962e+12,60.1107,19714.2,66505,7535,72,51034,51034,43100,41240,29730
32237,11208,11442,20215,12022,8.34778e+12,58.0968,13471,32237,5569,72,20795,20795,20530,20249,20251
74429,4248,24123,47066,27363,8.72076e+12,58.6512,28318.6,74429,11738,72,50306,50258,34282,15332,14627
29175,8633,13371,17764,11411,7.00569e+12,56.2369,15004.8,29175,6491,72,15804,15804,13989,11472,11102
77859,4613,22727,49677,28182,9.14404e+12,59.1808,27260.5,77859,11066,72,55132,55132,36158,13757,13015
91950,3883,21331,59640,32310,9.92067e+12,60.1464,26930.7,91950,10390,72,70619,70619,31812,32617,13715
22854,9603,11824,13675,9179,6.26018e+12,54.9862,13058.7,22854,5754,72,11030,11030,10493,10010,10108
79968,21510,40594,47967,32001,6.36828e+12,55.7644,44009.3,79968,19776,72,39374,39374,34874,29755,29764
71886,9695,17434,46489,25397,9.7853e+12,59.324,21921.1,71886,8477,72,54452,54452,46231,35024,32371
48358,10217,11961,31239,17119,9.72107e+12,59.8528,15163.1,48358,5820,72,36397,36397,34501,31982,31456
89382,17431,20757,57964,31418,9.90891e+12,60.1328,26224.4,89382,10095,72,68625,68625,64664,63734,58072
58415,2249,27684,35398,23017,6.79374e+12,56.2729,30470.1,58415,13479,72,30731,30731,17634,5156,1843
13207,1125,4327,8342,4865,8.76895e+12,57.485,5370.46,13207,2102,72,8880,8880,6207,3165,3121
73837,26628,73837,0,73837,7.99989,0,73837,73837,73837,1,0,0,0,0,0
35205,9242,9577,22596,12609,9.40199e+12,59.4021,11977.4,35205,4653,72,25628,25628,25505,25360,25507
73370,1870,17035,47588,25782,9.91239e+12,60.1296,21654,73370,8293,72,56335,56335,34246,33800,7048
76023,6880,23661,48238,27785,8.90361e+12,58.8807,27997.1,76023,11526,72,52362,52314,37823,37884,23180
23589,4596,8400,14798,8791,8.32761e+12,57.0413,9981.32,23589,4071,72,15189,15189,11929,11821,8147
57612,5677,13443,37352,20260,9.90381e+12,60.0839,17202.9,57612,6538,72,44169,44169,32578,31167,19076
58680,14234,16437,37553,21127,9.30264e+12,56.3717,20060.7,58680,8002,72,42243,42243,39647,39032,35411
10940,2343,2692,7074,3866,9.808e+12,59.5778,3679.31,10940,1311,72,8248,8248,7826,7356,7323
58839,2899,13661,38157,20682,9.91917e+12,60.1146,17492.6,58839,6649,72,45178,45178,22059,22330,10333
83307,10354,19370,54022,29285,9.91079e+12,60.1281,24512.3,83307,9425,72,63937,63937,53164,38429,34940
11810,1238,4394,7384,4426,8.17223e+12,56.2384,5304.14,11810,2123,72,7416,7416,4076,2372,1751
17156,1195,4019,11124,6032,9.92761e+12,59.9127,5431.71,17156,1957,72,13137,13137,8968,8885,4027
59935,5850,15237,38635,21300,9.63828e+12,59.7651,19031.9,59935,7422,72,44698,44698,30528,20929,17696
70581,25128,34648,42559,28022,6.57987e+12,55.9816,37814.1,70581,16873,72,35933,35933,32534,27833,26935
92127,28751,48087,55029,37098,6.17497e+12,55.4326,51841.9,92127,23405,72,44040,44040,37569,28650,26728
89515,24604,24849,57341,32174,9.3234e+12,59.4164,30044.8,89515,12095,72,64666,64666,64386,64105,64102
92916,4845,27844,59156,33760,9.04618e+12,59.0688,33064,92916,13562,72,65072,65072,34396,18230,11900
10707,2487,3092,6844,3863,9.22655e+12,57.6886,4023.75,10707,1494,72,7615,7615,6755,5962,5896
10926,1741,2542,7091,3835,9.97644e+12,59.7766,3542.56,10926,1234,72,8384,8384,7204,7182,5930
74184,1634,17275,48105,26079,9.91825e+12,60.1214,21929.1,74184,8415,72,56909,56909,19716,21152,6048
35239,7749,8217,22848,12391,9.90842e+12,60.0325,10723.7,35239,3992,72,27022,27022,26490,26362,25755
43277,6378,14321,27310,15967,8.65825e+12,57.9545,16973.2,43277,6970,72,28956,28956,21406,14759,12849
29471,4716,6842,19123,10348,9.94023e+12,60.0178,9011.14,29471,3327,72,22629,22629,19502,16532,15810
26179,408,6379,16940,9239,9.78084e+12,59.5098,8330.3,26179,3086,72,19800,19800,11590,7554,1600
89938,3548,28340,57012,32926,8.8439e+12,58.8225,33322.9,89938,13800,72,61598,61598,30935,25132,7259
81495,16756,42075,48761,32734,6.24904e+12,55.3214,45498.3,81495,20476,72,39420,39420,27951,14528,14178
86388,16369,33664,53624,32764,7.88632e+12,57.272,38028.9,86388,16384,72,52724,52724,43746,31491,28599
11352,2973,4307,7074,4278,8.05218e+12,57.387,5181.16,11352,2093,72,7045,7045,6402,5685,5814
92911,14246,21555,60257,32654,9.91737e+12,60.135,27203.9,92911,10492,72,71356,71356,60752,60535,47780
82598,2493,19195,53570,29028,9.91838e+12,60.1376,24300.8,82598,9350,72,63403,63403,39032,25911,9011
35709,3687,15432,21903,13806,7.34543e+12,56.8524,17417.6,35709,7509,72,20277,20277,12738,7198,5442
7973,1239,1939,5168,2805,9.82698e+12,59.3852,2719.75,7973,938,72,6034,6034,5180,4992,3941
82342,12395,19145,53402,28940,9.90793e+12,60.1281,24238.6,82342,9321,72,63197,63197,53397,53195,41451
38233,5783,19505,22919,15314,6.32977e+12,55.5737,21372.4,38233,9487,72,18728,18728,11794,8436,7234
44248,679,16140,27665,16583,8.22443e+12,57.9833,18724.6,44248,7861,72,28108,27724,13403,4990,1991
12800,376,3672,8181,4619,9.25911e+12,58.9423,4737.67,12800,1783,72,9128,9080,5575,2680,1380
60553,6966,14106,39260,21293,9.90798e+12,60.0967,18029.7,60553,6863,72,46447,46447,37886,35881,23426
3496,922,1451,2165,1331,7.79426e+12,45.2652,1804.74,3496,690,62,2045,2045,2045,2045,2045
15879,600,3751,10292,5587,9.86867e+12,59.771,5078.85,15879,1811,72,12128,12128,7487,7405,1913
25991,3860,6057,16868,9123,9.91715e+12,59.9826,8018.74,25991,2943,72,19934,19934,16797,13775,13125
13749,3912,4457,8698,5051,8.79523e+12,58.3712,5536.36,13749,2165,72,9292,9292,8773,8157,8095
61292,3785,14273,39737,21555,9.91115e+12,60.1096,18235.7,61292,6948,72,47019,47019,31774,31461,13079
17035,2129,4002,11050,5985,9.89857e+12,59.8726,5406.42,17035,1943,72,13033,13033,10833,7917,7288
35065,3488,14072,21709,13356,7.73942e+12,56.574,16116.5,35065,6835,72,20993,20993,13377,12956,5652
81038,4892,26079,51275,29763,8.75905e+12,58.7079,30599.1,81038,12701,72,54959,54959,34974,34354,10560
86099,17390,28360,54353,31746,8.66447e+12,58.5987,33076.1,86099,13810,72,57739,57739,47495,47140,35129
61153,9002,20640,38523,22630,8.55067e+12,58.4302,24140.1,61153,10038,72,40513,40513,32999,24105,21884
41170,3926,9557,26702,14468,9.92879e+12,60.0928,12407.2,41170,4655,72,31613,31613,23369,16683,13338
71421,18765,26705,44533,26888,8.09617e+12,57.8724,30500.9,71421,13006,72,44716,44716,39653,32805,31223
44409,5628,11899,28518,15891,9.46667e+12,59.5185,14813.4,44409,5791,72,32510,32510,25156,24979,16261
6104,2688,2843,3722,2382,7.02246e+12,55.616,3337.68,6104,1380,71,3261,3261,3078,2927,2934
61769,13622,20107,39040,22729,8.71339e+12,58.6324,23688.3,61769,9787,72,41662,41662,35458,28216,27980
99538,5600,23129,64553,34985,9.90741e+12,60.142,29126.6,99538,11257,72,76409,76409,39874,39897,19281
30329,5660,7105,19662,10667,9.88407e+12,59.9693,9322.98,30329,3447,72,23224,23224,21119,21081,18674
59395,11060,15534,38220,21175,9.549e+12,59.6535,19271.6,59395,7564,72,43861,43861,39288,38201,31659
60661,15399,20097,38279,22382,8.63859e+12,58.5404,23598,60661,9785,72,40564,40564,37280,32746,31897
91299,1270,21243,59200,32099,9.91526e+12,60.1356,26802.2,91299,10349,72,70056,70056,21382,4732,5019
61485,10194,17547,39306,22179,9.23374e+12,59.2656,21289.5,61485,8544,72,43938,43938,36910,27338,25105
71925,15099,16719,46648,25277,9.9064e+12,60.1078,21257.2,71925,8132,72,55206,55206,53343,52896,50349
68095,17853,25864,42385,25710,8.00413e+12,57.7682,29487.4,68095,12585,72,42231,42231,36629,29012,27239
24180,5542,7164,15408,8772,9.12172e+12,58.9789,8890.36,24180,3490,72,17016,17016,16138,15036,14854
28679,1299,1622,22794,5885,5.76967e+13,11.9931,2171.37,28679,1185,14,27057,27057,24641,22777,25974
97676,18389,22638,63353,34323,9.92178e+12,60.1505,28539.4,97676,11022,72,75038,75038,68866,68742,61391
69977,13907,16319,45369,24608,9.90624e+12,60.1079,20749.5,69977,7943,72,53658,53658,50790,46950,46111
34458,19722,34458,0,34458,7.99977,0,34458,34458,34458,1,0,0,0,0,0
32763,4175,8500,21102,11661,9.5827e+12,59.6034,10795.2,32763,4136,72,24263,24263,18710,13410,12030
67628,11960,19028,43273,24355,9.29312e+12,59.3422,23100,67628,9270,72,48600,48600,40755,31566,31252
58997,5411,20425,37065,21932,8.45389e+12,58.0283,23782.9,58997,9944,72,38572,38572,22327,14186,10862
18060,855,4239,11712,6348,9.93352e+12,59.8894,5703.3,18060,2064,72,13821,13821,8914,8811,3042
54739,18035,20186,34178,20561,8.15229e+12,57.7714,23254.4,54739,9818,72,34553,34553,33362,32050,32077
82684,15710,41558,49674,33010,6.42696e+12,55.8389,45100.4,82684,20240,72,41126,41126,28339,13432,12926
83388,3515,19377,54079,29309,9.91967e+12,60.1369,24522.7,83388,9439,72,64011,64011,40882,40417,12412
41214,5663,11223,26434,14780,9.42218e+12,59.4502,13949.7,41214,5467,72,29991,29991,24400,16826,15064
42454,8718,14243,26764,15690,8.58554e+12,57.6251,16841.5,42454,6916,72,28211,28211,23845,18686,18699
87731,17039,39764,53463,34268,7.06672e+12,56.4307,43795.4,87731,19365,72,47967,47967,36050,23935,20807
79275,30345,45484,62299,16976,8.0547e+10,8.9969,46009.1,79275,40928,11,33791,33791,25113,25482,24757
19736,1417,6191,12525,7211,8.91741e+12,58.6423,7633.71,19736,3011,72,13545,13545,9451,4737,4608
69407,17659,19236,44460,24947,9.33324e+12,59.4016,23422.3,69407,9363,72,50171,50171,47859,47817,45169
65727,29489,61420,45258,20469,9.2104e+12,3.99725,61547.3,65727,20495,9,4307,4307,2064,4307,2071
38768,5060,12635,24496,14272,8.71716e+12,54.5188,15074.9,38768,6150,72,26133,26133,17191,6701,6329
93959,23876,33655,58849,35110,8.2902e+12,58.1406,38547,93959,16392,72,60304,60304,53603,44499,42362
79074,13199,49823,45724,33350,4.78189e+12,53.8132,52496.8,79074,24265,72,29251,29251,18517,11114,8808
84033,9703,34039,51934,32099,7.68181e+12,57.099,38215.3,84033,16572,72,49994,49994,32286,18299,14089
29801,250,15111,17892,11909,6.40096e+12,54.7207,16650,29801,7345,72,14690,14162,5085,2144,628
50841,7775,16542,32133,18708,8.71033e+12,58.5993,19591.2,50841,8044,72,34299,34299,25680,15476,15270
77634,24336,31926,47885,29749,7.61279e+12,56.4103,35796,77634,15548,72,45708,45708,42634,39795,39103
38936,733,10077,25073,13863,9.57994e+12,59.6547,12723.2,38936,4902,72,28859,28828,11277,5985,2869
36442,5382,17677,22003,14439,6.66788e+12,55.9747,19545.5,36442,8606,72,18765,18765,13689,8094,6845
93478,6207,21742,60613,32865,9.91189e+12,60.1356,27418.5,93478,10585,72,71736,71736,41212,40648,21209
34161,32011,34161,0,34161,7.99977,0,34161,34161,34161,1,0,0,0,0,0
46816,15212,26282,36755,10061,80227700000,8.98304,26693.4,46816,23653,11,20534,20534,13781,14186,13395
74262,15670,40333,44094,30168,5.90212e+12,55.189,43353.6,74262,19644,72,33929,33929,24620,15343,12926
81477,7744,26291,51532,29945,8.7467e+12,58.6976,30828.9,81477,12803,72,55186,55138,40373,22877,22227
42922,7226,10020,27829,15093,9.92019e+12,60.0641,12962.4,42922,4881,72,32902,32902,29564,28784,24071
36326,1468,1526,28757,7569,5.85695e+13,11.9945,2150.62,36326,1522,13,34800,34800,34302,33891,34574
22907,5704,8585,14287,8620,8.10442e+12,57.7368,10095.2,22907,4182,72,14322,14322,12768,11044,11052
83793,10841,31619,52198,31595,8.04586e+12,57.6024,35944.9,83793,15386,72,52174,52174,39085,27655,24308
56656,7683,23704,34881,21775,7.51562e+12,56.1246,26655.6,56656,11525,72,32952,32952,24420,14410,14210
71058,4913,16495,46083,24975,9.92316e+12,60.1325,20987.8,71058,8036,72,54563,54563,37686,37348,16967
78319,24023,24181,49735,28584,8.93256e+12,58.9218,28643.4,78319,11779,72,54138,54138,53951,53914,53802
6891,395,1699,4461,2430,9.8047e+12,59.2058,2394.98,6891,822,72,5192,5192,3383,3333,1342
31252,6950,16780,18590,12662,5.99501e+12,54.2657,18305.5,31252,8152,72,14472,14472,9408,5694,4700
86607,5355,45062,51756,34851,6.19492e+12,55.5054,48637.6,86607,21939,72,41545,41545,23231,11550,7580
53741,16132,19328,33645,20096,8.27192e+12,58.0855,22386.6,53741,9407,72,34413,34413,32425,30090,30226
56599,435,13157,36714,19885,9.91053e+12,60.0964,16865.9,56599,6401,72,43442,43442,24891,24520,2075
16169,469,3804,10482,5687,9.90194e+12,59.8534,5151.88,16169,1845,72,12365,12365,7556,4993,1785
37502,5553,13173,23530,13972,8.40191e+12,57.1478,15474.8,37502,6411,72,24329,24329,17907,10440,10196
29061,619,6806,18844,10217,9.90475e+12,59.9919,8948.15,29061,3310,72,22255,22255,13290,13102,2372
93719,2487,5217,74467,19252,5.77402e+13,12.0015,6227.27,93719,3751,20,88502,88502,68058,52024,78141
23469,1104,6072,15110,8359,9.57987e+12,59.5533,7832.74,23469,2949,72,17397,17397,8485,5545,3965
4973,453,1645,3142,1831,8.79075e+12,57.66,2147.31,4973,796,72,3328,3280,1954,346,516
57945,15959,19672,36492,21453,8.5243e+12,58.3953,23010.1,57945,9572,72,38273,38273,35095,34990,31355
37643,1904,8763,24412,13231,9.93886e+12,60.0643,11404.2,37643,4269,72,28880,28880,14194,14383,6778
71375,4138,16583,46283,25092,9.91304e+12,60.1187,21093.3,71375,8073,72,54792,54792,36650,36288,14337
31500,971,7369,20423,11077,9.89505e+12,60.0022,9657.6,31500,3576,72,24131,24131,14879,9932,3588
64860,11304,18201,41511,23349,9.29597e+12,59.3445,22136.3,64860,8858,72,46659,46659,40416,38902,29928
92505,33133,45693,55712,36793,6.53638e+12,55.4813,49645.1,92505,22238,72,46812,46812,42213,35868,34570
10984,1256,3551,6949,4035,8.8253e+12,58.3185,4461.74,10984,1724,72,7433,7433,5117,2400,2522
74442,3551,19106,47954,26488,9.6094e+12,59.7434,23651.8,74442,9307,72,55336,55336,28120,17630,12431
50979,19052,19611,31690,19289,7.95166e+12,57.048,22445.6,50979,9531,72,31368,31368,31258,31204,31190
24122,5656,12044,14514,9608,6.49589e+12,55.4076,13366.9,24122,5850,72,12078,12078,8743,4839,4906
77364,4175,23973,49112,28252,8.9163e+12,58.8929,28382.6,77364,11670,72,53391,53343,27279,29180,14461
44631,16037,17865,27619,17012,7.74709e+12,56.6309,20354.3,44631,8683,72,26766,26766,25286,23320,22956
65236,2101,15120,42310,22926,9.9298e+12,60.1316,19298.4,65236,7365,72,50116,50116,31112,30734,7755
19580,6227,8066,12075,7505,7.64019e+12,57.1112,9339.23,19580,3927,72,11514,11514,10577,9771,9632
69672,10152,16189,45187,24485,9.91693e+12,60.1272,20606.1,69672,7884,72,53483,53483,46255,44564,34102
88831,27821,28091,56299,32532,8.83108e+12,58.804,33014.2,88831,13680,72,60740,60740,60426,60084,60070
67452,8136,17861,43358,24094,9.49434e+12,57.5449,22009.3,67452,8678,72,49591,49591,41304,30012,27343
96378,3139,43601,58760,37618,7.06898e+12,56.3354,47972.3,96378,21219,72,52777,52777,32621,13228,8295
2685,146,664,1737,948,1.01472e+13,58.2186,1013.8,2685,317,60,2021,2021,896,914,510
94703,7595,52091,56105,38598,5.80922e+12,54.8232,55742.5,94703,25355,72,42612,42612,26739,15064,7736
9864,315,2315,6400,3464,9.92891e+12,59.6266,3237.29,9864,1122,72,7549,7549,2857,3013,1124
62036,15307,26699,38061,23975,7.35809e+12,56.7022,29825.2,62036,12994,72,35337,35337,29744,22133,20372
59628,12917,13906,38662,20966,9.90221e+12,60.0905,17775.4,59628,6769,72,45722,45722,44610,44335,42910
82890,31447,32382,51436,31454,7.86987e+12,57.5613,36595.3,82890,15767,72,50508,50508,49941,49140,49186
41241,8066,15614,25694,15547,8.03276e+12,57.74,18014.4,41241,7599,72,25627,25627,21844,16618,15592
13980,521,4228,8910,5070,9.01606e+12,57.1913,5350.77,13980,2037,72,9752,9704,5604,1766,662
24373,225,7639,15469,8904,8.89815e+12,58.6882,9343.59,24373,3717,72,16734,16494,6877,2821,963
9128,1498,2211,5919,3209,9.85853e+12,59.3553,3072.9,9128,1066,72,6917,6917,6168,5974,5058
76950,15798,17850,49906,27044,9.92336e+12,60.1387,22655.5,76950,8695,72,59100,59100,56064,53187,52505
63851,6252,16723,41076,22775,9.54939e+12,59.6468,20689.2,63851,8146,72,47128,47128,32491,22218,18811
45084,3433,15276,28390,16694,8.56297e+12,58.3925,17986.7,45084,7442,72,29808,29808,18831,5874,5549
73159,7544,24377,46138,27021,8.61396e+12,58.0764,28467.5,73159,11870,72,48782,48782,33164,14796,14081
68983,1197,19258,44170,24813,9.31643e+12,59.3746,23410,68983,9377,72,49725,49725,18994,17596,4452
3473,149,1579,2119,1354,7.35472e+12,53.4809,1913.66,3473,763,58,1894,1846,1074,286,11
11977,2811,4386,7495,4482,8.24795e+12,57.6377,5312.27,11977,2130,72,7591,7591,6640,5304,5222
80826,23089,29533,50515,30311,8.19725e+12,58.0268,33800.3,80826,14383,72,51293,51293,45584,38946,38756
84879,1939,33710,52573,32306,7.7858e+12,57.5259,37969.7,84879,16418,72,51169,51169,24906,11496,6166
33827,2301,11721,21256,12571,8.45881e+12,57.2284,13852.9,33827,5704,72,22106,22106,13070,2482,2102
77097,10639,17947,49986,27111,9.90819e+12,60.1226,22760.4,77097,8737,72,59150,59150,50364,48315,35555
72741,27137,29600,44937,27804,7.65674e+12,57.1453,33289.3,72741,14397,72,43141,43141,42094,40633,40519
74240,9151,28403,46171,28069,7.9762e+12,57.7405,32281.5,74240,13832,72,45837,45837,31300,14253,13629
84655,31642,38569,51552,33103,7.03516e+12,56.1755,42466.1,84655,18784,72,46086,46086,42804,38272,37423
84988,6173,44409,50764,34224,6.16596e+12,55.5145,47910.3,84988,21625,72,40579,40579,24745,13621,5686
6106,300,1469,3966,2140,9.81131e+12,59.0272,2110.17,6106,702,72,4637,4637,2945,2000,1023
88707,13043,20585,57529,31178,9.92643e+12,60.1428,26011.4,88707,10028,72,68122,68122,57137,56914,43719
24219,3402,5643,15710,8509,9.9392e+12,59.951,7494.76,24219,2742,72,18576,18576,15282,15222,11367
6426,775,1922,4091,2335,9.18795e+12,54.5336,2549.79,6426,930,72,4504,4504,2657,2481,913
41802,6696,10888,26899,14903,9.56146e+12,59.6315,13684.9,41802,5299,72,30914,30914,25445,20247,18871
31142,2097,13884,19023,12119,7.16483e+12,56.3893,15635.2,31142,6749,72,17258,17258,10178,5154,4092
38703,2928,9016,25097,13606,9.90186e+12,60.0385,11723.7,38703,4377,72,29687,29687,20789,10299,9924
75817,9468,17648,49160,26657,9.90702e+12,60.1278,22396.5,75817,8590,72,58169,58169,48320,34866,31671
99554,838,37826,61961,37593,8.00678e+12,57.3829,42821.2,99554,18405,72,61728,61182,34500,19159,1256
84356,14192,19591,54705,29651,9.91371e+12,60.146,24795.4,84356,9540,72,64765,64765,58238,49355,47290
95611,2796,29940,60638,34973,8.87138e+12,58.8536,35200.5,95611,14579,72,65671,65623,40326,26591,9137
23120,3905,5457,14991,8129,9.89609e+12,59.9049,7236.69,23120,2654,72,17663,17663,15853,13482,12987
63313,12967,28589,38619,24694,7.08415e+12,56.5461,31667.8,63313,13907,72,34724,34724,26943,19562,17672
70932,8755,19218,45518,25414,9.42455e+12,59.5067,23508.7,70932,9359,72,51714,51714,39789,39490,25251
7698,1694,1821,4996,2702,9.9564e+12,59.4453,2583.03,7698,883,72,5877,5877,5731,5698,5634
32628,2980,8229,21056,11572,9.65737e+12,59.6174,10537.9,32628,3987,72,24399,24399,17252,11805,8591
47951,11282,21071,29345,18606,7.24608e+12,55.8812,23569.9,47951,10242,72,26880,26880,21098,14307,14248
79392,4898,18415,51489,27903,9.91145e+12,60.1261,23356,79392,8957,72,60977,60977,41257,40866,16982
38701,6175,9004,25099,13602,9.93126e+12,60.0636,11707.3,38701,4385,72,29697,29697,25501,25427,20485
92325,4145,33386,57760,34565,8.24625e+12,58.0949,38186.3,92325,16263,72,58939,58939,36360,11726,8884
56210,15481,20353,35166,21044,8.24186e+12,57.8067,23517.6,56210,9907,72,35857,35857,31897,27220,27254
77357,1250,33017,47505,29852,7.40531e+12,56.9704,36791.3,77357,16072,72,44340,44340,25337,16017,2292
87427,2805,26026,55677,31750,9.07189e+12,58.7098,30994.8,87427,12674,72,61401,61401,36390,22928,5675
69044,19936,21015,43902,25142,8.99162e+12,58.9742,25047,69044,10235,72,48029,48029,46436,44964,44660
70056,15990,31244,42799,27257,7.15599e+12,56.7277,34619.7,70056,15217,72,38812,38812,32721,24333,22522
50195,9150,11694,32553,17642,9.91939e+12,60.0826,15045.9,50195,5692,72,38501,38501,34840,31390,30499
31068,570,12000,19311,11757,7.94017e+12,57.5752,13890.4,31068,5842,72,19068,18684,11383,5955,2140
87547,10548,38091,53640,33907,7.30204e+12,56.8659,42222.8,87547,18556,72,49456,49456,36518,21451,21030
10378,1027,2488,6722,3656,9.84761e+12,59.5995,3444.46,10378,1199,72,7890,7890,5865,4018,3563
45516,371,10557,29519,15997,9.92883e+12,60.0858,13651.8,45516,5138,72,34959,34959,9638,1414,1781
54314,4490,30327,42630,11684,80183500000,8.99525,30773.2,54314,27291,11,23987,23987,8689,9482,7913
30569,1283,17153,18053,12516,5.68323e+12,52.965,18590.9,30569,8334,72,13416,13416,6369,2472,1174
56782,15223,18425,35899,20883,8.72875e+12,58.3182,21770.6,56782,8968,72,38357,38357,36208,33271,32752
12073,10885,12073,0,12073,7.99934,0,12073,12073,12073,1,0,0,0,0,0
60669,16601,16964,38832,21837,9.30647e+12,59.3662,20691.7,60669,8259,72,43705,43705,43188,42672,42735
63582,10444,14791,41230,22352,9.91143e+12,60.1246,18882.9,63582,7203,72,48791,48791,42458,36426,34796
33505,2668,9543,21425,12080,9.25186e+12,59.2049,11813.6,33505,4645,72,23962,23962,16056,15853,6474
80404,14839,19846,51931,28473,9.72312e+12,59.9002,24759.3,80404,9654,72,60558,60558,53380,53224,44663
8945,1168,2171,5796,3149,9.83825e+12,59.4328,3020.19,8945,1053,72,6774,6774,5306,5280,3685
69335,14436,31598,42226,27109,7.02977e+12,56.5558,34897.6,69335,15379,72,37737,37737,29066,18908,18702
83509,26253,30965,52106,31403,8.12766e+12,57.9383,35318.3,83509,15080,72,52544,52544,50006,47033,47143
70449,310,16368,45686,24763,9.92433e+12,60.1243,20824.3,70449,7974,72,54081,54081,13930,16039,1853
97537,892,22671,63258,34279,9.91124e+12,60.1412,28561.7,97537,11039,72,74866,74866,20979,23637,3862
94964,20563,32011,59821,35143,8.56116e+12,58.4176,37088.7,94964,15582,72,62953,62953,52829,40947,40534
18874,5993,7369,11725,7149,7.9407e+12,57.4273,8638.99,18874,3590,72,11505,11505,11386,11272,11404
67067,9518,15591,43492,23575,9.92954e+12,60.1193,19863.6,67067,7595,72,51476,51476,44198,34300,31987
10730,1388,6150,6319,4411,5.60826e+12,54.2578,6782.1,10730,2995,72,4580,4580,2544,1332,1047
6998,1614,2452,4404,2594,8.51793e+12,53.982,3083.8,6998,1177,72,4546,4546,4113,3695,3760
59434,8011,16298,38111,21323,9.38043e+12,59.4408,19983.3,59434,7936,72,43136,43136,33698,22630,22229
62094,4842,14465,40270,21824,9.90212e+12,60.1031,18472.9,62094,7041,72,47629,47629,33670,33380,16555
46339,8445,13216,29617,16722,9.23793e+12,59.2426,16178.1,46339,6429,72,33123,33123,28912,23196,21891
35076,1486,8178,22752,12324,9.90592e+12,60.0439,10676.1,35076,3977,72,26898,26898,12056,5831,5333
70621,11060,16407,45794,24827,9.91236e+12,60.1177,20876.4,70621,7984,72,54214,54214,46417,46265,36918
73052,11046,16957,47377,25675,9.93199e+12,60.135,21553.6,73052,8260,72,56095,56095,47427,47259,36875
41692,16988,17427,25679,16013,7.53716e+12,57.1195,19721.1,41692,8486,72,24265,24265,23981,23667,23860
15371,3340,3576,9982,5389,9.93597e+12,59.7729,4872.19,15371,1730,72,11795,11795,11542,11480,11256
11330,4023,5561,8845,2485,78615200000,8.97352,5778.93,11330,5001,11,5769,5769,4559,4706,4432
96471,7971,37917,59819,36652,7.83891e+12,57.5972,42691.6,96471,18468,72,58554,58554,37504,12713,11868
30221,10337,11340,18840,11381,8.11525e+12,57.7597,13213.1,30221,5524,72,18881,18881,18753,18689,18695
90275,16635,20942,58550,31725,9.92388e+12,60.1458,26453.2,90275,10202,72,69333,69333,64137,62929,55454
72885,220,19839,46761,26124,9.39421e+12,59.4487,24228.8,72885,9642,72,53046,52806,15836,15363,1498
85436,12331,19840,55399,30037,9.91466e+12,60.1399,25099.4,85436,9661,72,65596,65596,56573,44263,41354
85652,6944,32493,53323,32329,8.01381e+12,57.7269,36891.8,85652,15807,72,53159,53159,35111,13981,13138
32060,9268,17954,18937,13123,5.68474e+12,52.4128,19447.5,32060,8732,72,14106,14106,10686,6710,6774
89965,5633,20865,58343,31622,9.92028e+12,60.1538,26364.2,89965,10164,72,69100,69100,38391,38165,19584
43896,3555,10257,28466,15430,9.89439e+12,60.0562,13257.7,43896,4987,72,33639,33639,21726,21137,12056
40946,6018,9520,26566,14380,9.92073e+12,60.0692,12355,40946,4635,72,31426,31426,26232,26143,19971
75195,1836,3741,59659,15536,5.80905e+13,11.9974,4641.15,75195,3115,14,71454,71454,56222,43464,64649
33698,2138,7864,21854,11844,9.90654e+12,60.0366,10283.1,33698,3824,72,25834,25834,17451,17289,7238
93065,5760,21638,60346,32719,9.91914e+12,60.1385,27290.7,93065,10541,72,71427,71427,48275,47811,19779
4206,2300,4206,0,4206,7.9981,0,4206,4206,4206,1,0,0,0,0,0
27837,5142,9098,17585,10252,8.70878e+12,58.2812,10965.7,27837,4425,72,18739,18739,15429,10973,9966
81066,2635,22140,51990,29076,9.3881e+12,59.4805,26935.7,81066,10782,72,58926,58926,36667,24550,9361
49768,2064,17889,31162,18606,8.28199e+12,58.0688,20755.2,49768,8711,72,31879,31879,19546,6779,4584
64488,2609,15003,41818,22670,9.92164e+12,60.1116,19135.2,64488,7309,72,49485,49485,31515,31139,9448
30084,5714,8009,19334,10750,9.48783e+12,59.4879,10136.3,30084,3896,72,22075,22075,19375,19307,16277
51566,15295,16564,32625,18941,8.78029e+12,58.6963,19660.8,51566,8069,72,35002,35002,34080,33020,33214
4493,866,1086,2920,1573,1.00133e+13,58.8711,1595.29,4493,525,70,3407,3407,3093,3084,2883
16219,140,3810,10514,5705,9.94085e+12,59.8453,5156.2,16219,1856,72,12409,12373,3244,3777,656
19289,8172,18029,13284,6005,9.20413e+12,3.98465,18096.1,19289,6024,9,1260,1260,568,1260,575
29140,11783,14461,22758,6382,78714200000,8.98806,14813.7,29140,13007,11,14679,14679,12569,12827,12323
32557,4621,7618,21113,11444,9.88783e+12,59.9941,9967.49,32557,3696,72,24939,24939,21288,16347,15230
66883,4129,15558,43378,23505,9.9146e+12,60.11,19823.4,66883,7575,72,51325,51325,28224,16120,14248
47436,10122,14943,30068,17368,8.85673e+12,58.7783,17857.1,47436,7274,72,32493,32493,29310,24911,24094
7016,1309,3971,5510,1506,80283200000,8.81514,4123.73,7016,3568,11,3045,3045,1375,1488,1278
5122,156,2522,3097,2025,6.65101e+12,50.3559,2944.84,5122,1206,69,2600,2481,1595,1136,564
71072,18797,27047,44233,26839,8.00418e+12,57.455,30796.9,71072,13161,72,44025,44025,40317,36014,36063
41051,16584,18187,25105,15946,7.20546e+12,55.726,20375.5,41051,8842,72,22864,22864,22826,22750,22829
20647,1402,5996,13183,7464,9.23845e+12,59.0271,7527.62,20647,2920,72,14651,14651,8738,4528,3209
38784,2582,10442,24909,13875,9.44186e+12,59.4741,13047.3,38784,5081,72,28342,28342,16409,14896,6777
93726,31095,44175,56825,36901,6.82982e+12,56.344,48315.5,93726,21516,72,49551,49551,43605,36663,36599
10568,83,453,8367,2201,5.85245e+13,11.9798,784.368,10568,448,13,10115,10115,6814,3908,8641
38100,12113,17022,23267,14833,7.1527e+12,56.668,19074.9,38100,8286,72,21078,21078,18617,15242,14588
11121,1419,2664,7217,3904,9.85315e+12,59.5954,3669.98,11121,1290,72,8457,8457,7040,6697,4809
57074,14050,19054,35999,21075,8.59971e+12,58.483,22373.2,57074,9269,72,38020,38020,34004,28572,27327
56857,24632,25894,34634,22223,7.03972e+12,56.0238,28697.1,56857,12598,72,30963,30963,30230,29319,29162
2453,1264,1425,1454,999,5.55664e+12,33.7656,1641.89,2453,672,55,1028,1028,1028,1028,1028
44273,10476,10482,28681,15592,9.88662e+12,60.015,13487,44273,5106,72,33791,33791,33785,33785,33783
93709,16896,21797,60764,32945,9.90571e+12,60.1357,27489.5,93709,10605,72,71912,71912,66105,64732,56377
93358,23781,35718,58062,35296,7.97264e+12,57.6321,40429.8,93358,17390,72,57640,57640,48345,35663,32658
71576,10890,33365,43462,28114,6.90083e+12,56.408,36695.6,71576,16248,72,38211,38211,27208,19431,17044
89835,4254,20847,58261,31574,9.91576e+12,60.1447,26339.4,89835,10150,72,68988,68988,44775,30433,14938
78232,5058,39977,61172,17060,79036500000,8.9917,40551.1,78232,35971,11,38255,38255,12802,15467,10156
29754,603,13811,18078,11676,6.92669e+12,54.9991,15455.8,29754,6712,72,15943,15559,8913,3597,0
64692,6561,18961,41263,23429,9.13577e+12,59.158,22833,64692,9236,72,45731,45731,32727,17427,16849
30243,207,10050,19077,11166,8.64469e+12,58.4546,12030,30243,4896,72,20193,19953,11518,6588,1011
66698,7405,21682,42156,24542,8.71852e+12,58.6505,25503.7,66698,10558,72,45016,44968,25464,17608,14007
6230,1233,2636,3845,2385,7.51906e+12,56.2427,3167.2,6230,1272,71,3594,3594,2421,1071,957
36189,4137,8442,23468,12721,9.90325e+12,60.0305,11002.2,36189,4107,72,27747,27747,21482,21358,13903
14185,2613,3365,9194,4991,9.84662e+12,59.6999,4580.22,14185,1624,72,10820,10820,9929,9722,8580
9098,2023,2190,5901,3197,9.92125e+12,59.5352,3051.35,9098,1066,72,6908,6908,6813,6752,6770
50285,14324,15057,32027,18258,9.04933e+12,59.0275,18172.8,50285,7330,72,35228,35228,34154,32978,33006
18971,3982,4447,12310,6661,9.928e+12,59.8883,5971.75,18971,2164,72,14524,14524,13851,13255,13212
9672,1668,2328,6265,3407,9.9342e+12,59.5561,3228.48,9672,1134,72,7344,7344,6505,5767,5665
54859,8597,12762,35584,19275,9.90418e+12,60.0908,16375.9,54859,6207,72,42097,42097,36046,30281,28717
69841,9478,28654,43093,26748,7.62898e+12,57.2971,32196.7,69841,13959,72,41187,41187,28304,15915,12473
57855,2124,13429,37523,20332,9.92106e+12,60.1149,17208.8,57855,6536,72,44426,44426,18672,8146,7498
84809,22618,36162,52092,32717,7.41061e+12,57.0595,40242,84809,17615,72,48647,48647,41564,33280,33155
35642,3043,13569,22185,13457,8.02797e+12,57.6984,15694.3,35642,6610,72,22073,22073,13959,8297,6608
58650,16470,20073,36905,21745,8.48963e+12,58.3391,23430.9,58650,9766,72,38577,38577,33774,28164,28000
60271,4100,13989,39093,21178,9.91904e+12,60.111,17900.1,60271,6809,72,46282,46282,26889,16000,14054
97592,4076,32116,61629,35963,8.66226e+12,58.4082,37366.5,97592,15625,72,65476,65476,35507,17763,11147
98822,19280,22915,64097,34725,9.91606e+12,60.1463,28877.2,98822,11151,72,75907,75907,71464,65434,64049
68890,4762,17664,44385,24505,9.61735e+12,59.7439,21920.7,68890,8605,72,51226,51226,30856,20592,16386
38900,14491,20108,30432,8468,79201300000,8.99172,20507.4,38900,18091,11,18792,18792,14661,15102,14240
61778,11715,16368,39700,22078,9.49778e+12,59.6068,20217.5,61778,7974,72,45410,45410,39609,39474,32614
32261,9293,13674,19841,12420,7.44428e+12,56.5503,15530.8,32261,6639,72,18587,18587,16318,13295,12626
43677,2102,11915,28018,15659,9.39794e+12,59.4374,14776.1,43677,5798,72,31762,31762,19602,19327,4733
13596,547,4122,8652,4944,9.07155e+12,58.6868,5215.68,13596,2008,72,9474,9426,6030,2481,1980
4328,809,1041,2803,1525,1.00344e+13,58.964,1537.59,4328,507,69,3287,3287,3024,2751,2754
81076,3242,31096,50411,30665,7.96192e+12,57.3479,35272.1,81076,15126,72,49980,49980,23539,11159,5799
64783,2671,24072,40416,24367,8.12391e+12,57.9074,27584.8,64783,11720,72,40711,40711,21431,8816,4586
36953,2436,8608,23962,12991,9.90968e+12,60.0534,11216.5,36953,4182,72,28345,28345,19316,19144,8295
88224,14374,20496,57219,31005,9.91029e+12,60.1324,25900.5,88224,9973,72,67728,67728,60417,50439,48101
10344,2152,10344,0,10344,7.99923,0,10344,10344,10344,1,0,0,0,0,0
9478,921,3833,5863,3615,7.72785e+12,53.0781,4577.4,9478,1851,72,5645,5645,2729,1176,646
67160,31504,38677,39486,27674,5.47804e+12,54.6655,41294.7,67160,18836,72,28483,28483,26477,23696,23264
47702,9053,11133,30939,16763,9.90234e+12,60.0515,14346.7,47702,5413,72,36569,36569,34034,33459,29910
74200,15680,24870,46773,27427,8.585e+12,58.2686,28999.7,74200,12093,72,49330,49330,40582,28650,25823
65164,5903,18396,41689,23475,9.2658e+12,59.3091,22340.2,65164,8949,72,46768,46768,26733,17135,13062
1443,141,400,940,503,9.44833e+12,55.6105,618.575,1443,182,48,1043,1043,696,688,437
53396,8299,18992,33466,19930,8.32534e+12,57.7475,22050.4,53396,9229,72,34404,34404,25108,14225,13842
62518,3942,14573,40540,21978,9.90312e+12,60.0889,18601.2,62518,7092,72,47945,47945,26673,26450,13557
86522,21907,22674,55652,30870,9.52773e+12,57.7695,27814.9,86522,11034,72,63848,63848,62745,61740,61557
87238,16486,24384,55856,31382,9.30468e+12,59.1551,29453.1,87238,11861,72,62854,62854,56239,47122,45152
92917,25346,39598,57084,35833,7.40867e+12,56.8773,44006.5,92917,19269,72,53319,53319,45325,35920,35747
4167,816,1013,2712,1455,9.946e+12,58.7492,1495.52,4167,489,68,3154,3154,2919,2694,2700
13475,2366,3199,8735,4740,9.85959e+12,59.7204,4367.9,13475,1544,72,10276,10276,9281,8012,7771
92439,7292,32565,57984,34455,8.36508e+12,57.9234,37431.1,92439,15857,72,59874,59874,32613,15430,9283
86096,14651,19995,55829,30267,9.91765e+12,60.1398,25283.2,86096,9740,72,66101,66101,59634,58129,48786
40568,13455,16610,25046,15522,7.64108e+12,56.5918,18884,40568,8075,72,23958,23958,21641,18973,18976
13781,2704,3209,8941,4840,9.92892e+12,59.7695,4401.91,13781,1555,72,10572,10572,9981,9843,9156
24515,298,13079,19204,5311,79562100000,8.97724,13387.5,24515,11763,11,11436,11410,2888,3608,2187
95365,52208,95365,0,95365,7.99992,0,95365,95365,95365,1,0,0,0,0,0
83110,13627,19330,53899,29211,9.90525e+12,60.1199,24462.7,83110,9403,72,63780,63780,56891,55290,45299
1102,24,316,724,378,9.79096e+12,54.8711,493.472,1102,150,44,454,72,186,203,67
26602,5515,9387,16693,9909,8.3821e+12,58.0907,11130.1,26602,4569,72,17215,17215,13833,9952,9868
82184,24920,31043,51181,31003,8.04105e+12,57.8332,35298.7,82184,15122,72,51141,51141,49235,46599,46205
18723,2459,7117,11671,7052,8.02072e+12,54.8468,8400.21,18723,3445,72,11606,11606,8578,5002,5084
75402,12399,17501,48904,26498,9.92377e+12,60.1292,22224.7,75402,8522,72,57901,57901,51722,50288,41386
67787,9168,17388,43678,24109,9.59816e+12,59.7371,21591.5,67787,8466,72,50399,50399,39682,27069,26596
10972,1037,3264,6999,3973,9.1587e+12,58.7001,4199.68,10972,1586,72,7708,7708,5743,5675,3510
13493,3471,4454,8522,4971,8.70964e+12,58.2936,5512.93,13493,2164,72,9039,9039,7938,6519,6259
67304,18628,21206,42657,24647,8.85707e+12,58.8162,25102.9,67304,10331,72,46098,46098,43150,39714,39753
18588,474,9605,11119,7469,6.27667e+12,55.088,10658.4,18588,4674,72,8983,8599,5305,2424,1014
95385,14923,23700,61575,33810,9.70775e+12,59.8923,29373,95385,11546,72,71685,71685,61423,58989,44087
80951,8218,18760,52507,28444,9.92378e+12,60.146,23781.6,80951,9138,72,62191,62191,46755,46456,27808
65067,3832,15139,42197,22870,9.91419e+12,60.1204,19307.1,65067,7373,72,49928,49928,26728,26654,13247
15324,175,3888,9886,5438,9.66978e+12,59.5323,5158.62,15324,1883,72,11436,11388,3579,1994,776
70774,7876,21609,44985,25789,8.97638e+12,58.9712,25724.1,70774,10526,72,49165,49165,33826,15734,15062
76686,6281,18447,49625,27061,9.81677e+12,60.0014,23194.2,76686,8986,72,58239,58239,38474,36989,21169
54305,16334,18903,34114,20191,8.41616e+12,58.245,22030.4,54305,9196,72,35402,35402,33392,30591,30157
29554,10865,12707,18145,11409,7.38634e+12,56.8768,14420.6,29554,6185,72,16847,16847,15515,13964,14133
17021,517,6752,10546,6475,7.80551e+12,56.9181,7920.61,17021,3273,72,10269,10029,6056,2440,1126
18734,2005,4387,12152,6582,9.90989e+12,59.917,5901,18734,2131,72,14347,14347,11060,10514,6643
83460,1779,37842,50863,32597,7.06106e+12,56.5172,41708.5,83460,18428,72,45618,45618,19051,8913,4002
62740,17138,20303,39679,23061,8.74135e+12,58.6307,23940.4,62740,9874,72,42437,42437,39902,39270,35785
37036,2581,18067,22353,14683,6.6224e+12,55.9248,19954.8,37036,8779,72,18969,18969,10512,4491,2697
59369,3847,13845,38503,20866,9.89762e+12,60.0959,17703.1,59369,6740,72,45524,45524,31009,30711,13211
91985,7317,21350,59663,32322,9.91234e+12,60.1381,26953.1,91985,10391,72,70635,70635,50248,49831,25151
74914,43463,44353,43820,31094,5.27472e+12,54.1942,47126.1,74914,21601,72,30561,30561,30284,29886,30018
14422,479,9346,11306,3116,2.23611e+13,5.51352,10747.2,14422,3123,13,5076,5076,1824,2325,886
62264,536,18307,39693,22571,9.12281e+12,59.0349,22053.4,62264,8913,72,43957,43669,17199,7085,2011
39033,1712,9153,25309,13724,9.8835e+12,59.9952,11871.7,39033,4447,72,29880,29880,19081,18861,5875
3806,1275,1346,2395,1411,8.50267e+12,55.5788,1752.75,3806,635,62,2460,2460,2460,2460,2460
58543,7409,17859,37221,21322,8.9801e+12,58.5542,21369.4,58543,8682,72,40684,40684,31043,19694,19318
78368,3029,18224,50817,27551,9.91052e+12,60.1387,23109.7,78368,8875,72,60144,60144,25958,11795,10763
12651,262,2936,8211,4440,9.96257e+12,59.8504,4056.29,12651,1426,72,9715,9715,3196,3474,1023
84469,8648,23356,54117,30352,9.34921e+12,59.4357,28301.5,84469,11377,72,61113,61113,40858,26137,21474
57336,10363,31116,34041,23295,5.91154e+12,54.5531,33565,57336,15136,72,26220,26220,16485,11286,9428
27924,2506,8666,17730,10194,8.9056e+12,58.752,10575.3,27924,4205,72,19258,19258,11173,6472,4918
69253,6657,16095,44910,24343,9.9195e+12,60.1246,20486.6,69253,7840,72,53158,53158,38592,36998,22465
18472,2854,10955,10803,7669,5.28664e+12,53.2706,11875.9,18472,5328,72,7517,7517,4689,2574,2124
99085,1223,36935,61795,37290,8.09632e+12,57.9089,41957.9,99085,17977,72,62150,62102,21996,10263,3221
50638,22923,23099,30840,19798,7.02978e+12,56.3708,25647.2,50638,11247,72,27539,27539,27294,27098,27147
35951,4016,8451,23309,12642,9.88586e+12,59.9769,10991.6,35951,4105,72,27500,27500,21168,21027,13510
43209,5241,10035,28034,15175,9.93314e+12,60.0852,12998.2,43209,4885,72,33174,33174,26183,26045,17697
55074,14185,15459,35248,19826,9.2882e+12,59.3218,18892.9,55074,7521,72,39615,39615,38170,37821,35897
61840,8246,14350,40115,21725,9.92214e+12,60.1163,18346.1,61840,6986,72,47490,47490,40080,29977,27620
25727,2163,7073,16504,9223,9.40065e+12,59.3311,8931.64,25727,3441,72,18654,18654,12032,8767,7471
28567,3500,6903,18479,10088,9.81271e+12,59.8826,8999.18,28567,3357,72,21664,21664,17810,16874,11446
47659,4226,11103,30897,16762,9.91117e+12,60.0829,14316,47659,5406,72,36556,36556,26586,26380,14401
96238,25236,40392,59214,37024,7.49803e+12,57.1744,44974.8,96238,19678,72,55846,55846,50356,42787,41202
69048,931,16054,44779,24269,9.91613e+12,60.1122,20435.9,69048,7811,72,52994,52994,16172,17850,3913
64286,14315,20644,40682,23604,8.76964e+12,58.7149,24369.4,64286,10051,72,43642,43642,38604,31766,30190
15307,3087,3614,9924,5383,9.90318e+12,59.7749,4902.36,15307,1750,72,11693,11693,11080,10940,10224
94995,16991,43376,67051,27944,1.52864e+13,32.4566,50717.1,94995,9951,73,51619,51619,27927,17468,10052
22661,7422,8174,14185,8476,8.2679e+12,57.6721,9699.92,22661,3962,72,14487,14487,14120,13788,13917
81472,30643,35604,49890,31582,7.2751e+12,56.7325,39485.8,81472,17328,72,45868,45868,43926,41765,41763
80823,4527,52360,63375,17448,2.23348e+13,5.52838,59991.6,80823,17453,13,28463,28463,14369,14463,5810
34310,7784,11188,21686,12624,8.7367e+12,58.5593,13393.5,34310,5450,72,23122,23122,20859,20283,17194
9973,1889,3067,6345,3628,8.96681e+12,58.4543,3928.58,9973,1488,72,6906,6906,5808,4387,4131
25544,3130,6004,16566,8978,9.91247e+12,59.9638,7931.59,25544,2924,72,19540,19540,15390,15301,10439
23989,1104,10678,14669,9320,7.17126e+12,54.9765,12105.7,23989,5179,72,13311,13215,8229,5211,2239
31004,6341,7250,20106,10898,9.92472e+12,60.0168,9504.86,31004,3530,72,23754,23754,22665,22397,21033
74346,17160,34929,45098,29248,6.84994e+12,56.3524,38348.3,74346,17011,72,39417,39417,31402,22046,21872
93726,17278,21789,60771,32955,9.91589e+12,60.141,27477,93726,10615,72,71937,71937,66490,65224,57402
15592,1615,4126,10031,5561,9.57582e+12,59.3772,5392.4,15592,2008,72,11466,11466,7852,3674,3574
96249,6015,6057,76629,19620,5.73031e+13,12.0016,7076.92,96249,2837,20,90192,90192,89871,89764,90029
39123,10369,15873,24170,14953,7.69114e+12,57.0802,18091.7,39123,7727,72,23250,23250,20231,16180,15270
36849,3152,14611,22834,14015,7.80379e+12,57.4399,16749.2,36849,7112,72,22238,22190,14304,4890,4721
17877,2486,6472,11189,6688,8.28857e+12,57.8833,7736.64,17877,3153,72,11405,11405,7934,8556,5500
63803,21226,27287,39176,24627,7.39452e+12,56.2524,30499.7,63803,13271,72,36516,36516,33261,28764,27914
90062,20439,20892,58400,31662,9.91907e+12,60.1528,26395.4,90062,10178,72,69170,69170,68630,68511,67923
47976,13268,20817,29405,18571,7.31342e+12,56.89,23336.1,47976,10129,72,27159,27159,24911,21787,21273
64255,11185,17615,41200,23055,9.37473e+12,59.4231,21550,64255,8570,72,46640,46640,40926,33145,31340
90630,26054,28519,57454,33176,8.85154e+12,58.7133,33538.5,90630,13877,72,62111,62111,60006,57215,56615
19353,9556,9805,11613,7740,6.42432e+12,53.0449,10908.2,19353,4770,72,9548,9548,9496,9460,9529
46787,1054,10862,30355,16432,9.92e+12,60.0784,14027.9,46787,5281,72,35925,35925,12549,13476,4028
36128,511,19924,21402,14726,5.79888e+12,54.7239,21590.1,36128,9684,72,16204,15484,9164,4642,842
80013,17395,30561,49772,30241,7.98255e+12,57.3373,34699.9,80013,14866,72,49452,49452,43077,34290,32400
57204,1685,13285,37100,20104,9.91492e+12,60.1138,17030.7,57204,6462,72,43919,43919,27040,17982,6300
59832,1416,15750,38469,21363,9.51735e+12,59.6195,19505.6,59832,7668,72,44082,44082,17101,10093,5409
61612,7722,14349,39952,21660,9.91723e+12,60.1092,18326.6,61612,6989,72,47263,47263,37646,28425,25925
23015,3315,5370,14930,8085,9.93489e+12,59.9615,7145.74,23015,2615,72,17645,17645,14604,14548,11036
57971,1138,13454,37601,20370,9.93043e+12,60.1114,17236.2,57971,6554,72,44517,44517,26552,17417,4474
50476,4076,17867,31663,18813,8.34586e+12,58.1598,20789.7,50476,8700,72,32609,32609,20916,11230,8312
84805,3215,22098,54582,30223,9.54652e+12,57.8882,27157.7,84805,10744,72,62707,62707,39814,39354,11616
18926,1796,4438,12277,6649,9.89941e+12,59.8968,5963.94,18926,2154,72,14488,14488,10695,10613,6178
2839,2651,2839,1456,1383,208811000,0,2839,2839,1383,21,0,0,0,0,0
42687,8400,15744,26650,16037,8.16611e+12,57.9193,18242.3,42687,7670,72,26943,26943,20963,13917,13850
1689,355,449,1101,588,1.00819e+13,56.6104,694.073,1689,211,51,1240,1240,1141,1136,1120
39977,7513,14717,24965,15012,8.18004e+12,56.7852,17090.3,39977,7163,72,25260,25260,20332,13675,12143
59417,254,13867,38527,20890,9.88976e+12,60.0709,17726.3,59417,6741,72,45550,45550,11676,13432,1479
45509,4616,10650,29497,16012,9.8992e+12,60.0601,13738.5,45509,5182,72,34859,34859,25974,17587,15265
32582,3200,7615,21136,11446,9.9061e+12,60.0118,9965.14,32582,3704,72,24967,24967,18227,12418,10760
38868,5096,13138,24480,14388,8.55967e+12,58.381,15547.7,38868,6391,72,25730,25730,19334,13311,11662
60592,10384,16947,38790,21802,9.30425e+12,59.3621,20672.1,60592,8250,72,43645,43645,35976,35776,26734
55805,16795,21638,34668,21137,7.90501e+12,57.405,24677.5,55805,10519,72,34167,34167,31192,27778,27743
89071,16580,38325,54647,34424,7.36042e+12,56.8892,42549.3,89071,18662,72,50746,50746,36017,18732,18201
12282,4291,6866,9641,2641,80184900000,8.83407,7073.42,12282,6172,11,5416,5416,3850,3944,3773
71253,6954,23147,45044,26209,8.72089e+12,58.6506,27185,71253,11271,72,48106,48058,36546,22931,22431
65492,14639,16861,42180,23312,9.59634e+12,59.7192,20937.1,65492,8208,72,48631,48631,45850,43258,42626
43216,2136,13488,27418,15798,8.90689e+12,58.8164,16194.6,43216,6570,72,29728,29728,15608,6079,5119
22010,10245,14261,17260,4750,2.23354e+13,5.51699,16381,22010,4757,13,7749,7749,7189,7749,5856
35447,5936,9108,22839,12608,9.6099e+12,59.6593,11562,35447,4430,72,26339,26339,23016,22218,17545
68873,13016,36982,40960,27913,5.98466e+12,55.2933,39854.4,68873,18014,72,31891,31891,21321,9030,8728
93296,16221,21699,60494,32802,9.90997e+12,60.1359,27365.6,93296,10566,72,71597,71597,63687,56132,54080
69537,25438,30845,42511,27026,7.18893e+12,56.0738,34212.2,69537,15007,72,38692,38692,35890,33220,32690
13992,2571,4760,8809,5183,8.56168e+12,57.0167,5836.27,13992,2309,72,9232,9232,7671,5608,5177
5738,561,1431,3714,2024,9.86894e+12,59.053,2035.22,5738,695,72,4307,4307,3110,1704,1883
87098,31270,31649,54474,32624,8.21978e+12,58.0507,36205.4,87098,15407,72,55449,55449,55016,54500,54455
49974,8887,11636,32405,17569,9.91775e+12,60.0867,14976.1,49974,5663,72,38338,38338,34259,34187,29397
33184,1223,9340,21236,11948,9.2901e+12,59.271,11605.9,33184,4543,72,23844,23844,9974,8891,1981
68624,1598,16680,44374,24250,9.77888e+12,59.9463,20987.9,68624,8123,72,51944,51944,30852,19964,4927
53605,3704,28813,31880,21725,5.98928e+12,55.2478,31146.6,53605,14033,72,24792,24792,13346,6471,4141
28936,267,1867,23039,5897,5.72371e+13,12.0045,2423.56,28936,1176,20,27069,27069,16706,9531,22281
76452,23212,29051,47587,28865,8.02005e+12,57.7847,33037.6,76452,14152,72,47401,47401,44968,41609,41040
6101,670,1437,3957,2144,1.00491e+13,59.4265,2080.89,6101,700,72,4664,4664,3648,3459,2335
70952,21581,24370,44630,26322,8.47397e+12,58.2052,28304,70952,11850,72,46582,46582,45007,42820,42530
55522,11710,12909,36005,19517,9.90862e+12,60.0956,16560.5,55522,6273,72,42613,42613,41173,39272,38903
88030,22363,30135,55377,32653,8.49704e+12,58.3825,34857.8,88030,14678,72,57895,57895,52119,46681,45217
94020,18714,32933,59016,35004,8.38752e+12,57.7984,37882.9,94020,16021,72,61087,61087,51448,38173,35195
19940,454,4765,12906,7034,9.85152e+12,59.8047,6345.88,19940,2314,72,15175,15175,5325,3301,1721
2524,567,634,1646,878,1.01195e+13,58.0008,966.781,2524,306,58,1890,1890,1827,1825,1803
77086,12966,18984,49791,27295,9.73651e+12,59.9167,23724.3,77086,9247,72,58102,58102,51280,41987,39827
5461,51,240,4323,1138,5.84551e+13,11.9595,474.816,5461,235,13,5221,5221,3548,2090,4471
84553,19193,20646,54652,29901,9.75799e+12,59.9404,25787.8,84553,10053,72,63907,63907,61886,59584,59572
23839,2678,7546,15111,8728,8.8475e+12,58.634,9214.61,23839,3670,72,16293,16293,11423,5674,5664
46972,6761,12611,30171,16801,9.46376e+12,59.5197,15661.5,46972,6139,72,34361,34361,27883,27721,20043
92516,18707,22959,59726,32790,9.70821e+12,59.8907,28488.9,92516,11185,72,69557,69557,64448,57507,55908
1400,199,431,893,507,9.72899e+12,53.2536,637.279,1400,203,48,969,969,635,337,411
76217,12582,28745,47476,28741,8.04494e+12,57.6,32743.9,76217,13981,72,47472,47472,34232,20369,16644
35134,3486,12742,21984,13150,8.24923e+12,57.971,14890.9,35134,6203,72,22392,22392,15382,7232,6968
22911,618,5360,14864,8047,9.88775e+12,59.9165,7133.14,22911,2597,72,17551,17551,6448,2328,2282
54762,15936,23634,33587,21175,7.34027e+12,56.9308,26449.5,54762,11498,72,31128,31128,27728,23745,23809
1275,252,355,835,440,9.79792e+12,55.3373,553.367,1275,167,46,920,920,783,716,730
18457,2163,5480,11766,6691,9.10519e+12,58.8897,6876.57,18457,2664,72,12977,12977,9887,6378,5536
80089,4831,18620,51936,28153,9.91021e+12,60.1353,23596.2,80089,9065,72,61469,61469,41428,28598,16765
51791,7420,20012,32184,19607,7.9257e+12,57.5309,22876.2,51791,9726,72,31779,31779,24174,16275,14337
59185,9616,20726,37158,22027,8.403e+12,57.822,24074.7,59185,10080,72,38459,38459,28366,16552,16114
95894,16286,22292,62184,33710,9.91085e+12,60.1397,28097,95894,10854,72,73602,73602,66408,64723,54337
12377,2135,2945,8026,4351,9.90774e+12,59.6697,4036.01,12377,1427,72,9432,9432,8268,7208,7007
82051,6363,27407,51735,30316,8.61438e+12,58.5196,31901.5,82051,13351,72,54644,54644,35299,34711,11640
77777,11367,18114,50437,27340,9.89834e+12,60.1132,22963.8,77777,8811,72,59663,59663,49893,40543,37955
13194,937,3755,8440,4754,9.2943e+12,58.9945,4849.27,13194,1823,72,9439,9439,6481,3074,3016
32808,7184,8882,21051,11757,9.4482e+12,59.4547,11152.2,32808,4327,72,23926,23926,22273,21876,19661
8116,309,2356,5187,2929,9.23382e+12,57.8066,3112.5,8116,1125,72,5760,5712,2497,807,782
34752,9333,12798,21702,13050,8.17656e+12,56.8231,14915.3,34752,6229,72,21954,21954,19052,15652,15744
59116,12399,13727,38347,20769,9.92071e+12,60.1086,17573.3,59116,6683,72,45389,45389,43427,41590,41196
10892,27,2608,7060,3832,9.85191e+12,59.6043,3600.43,10892,1259,72,5092,882,1963,2329,45
12004,4252,4637,7474,4530,7.94617e+12,57.3182,5543.85,12004,2252,72,7367,7367,7049,6716,6697
12577,2665,2991,8149,4428,9.9194e+12,59.7235,4094.25,12577,1456,72,9586,9586,9203,9116,8742
65377,3715,4087,52051,13326,5.73174e+13,11.9971,4919.79,65377,2674,14,61290,61290,58689,56786,60123
67467,25062,27517,41662,25805,7.64931e+12,57.1715,30978.4,67467,13384,72,39950,39950,38148,36042,36158
11727,1951,4383,7319,4408,8.13338e+12,48.7956,5290.03,11727,2117,72,7344,7344,6949,6550,6647
31926,9561,13410,19644,12282,7.522e+12,55.376,15258.7,31926,6527,72,18516,18516,16614,14108,13587
33738,2945,7870,21879,11859,9.94485e+12,60.0413,10284.5,33738,3833,72,25868,25868,17437,16900,9930
69706,11006,38657,54694,15012,8.0083e+10,8.99584,39166.9,69706,34783,11,31049,31049,13777,14927,12644
67997,7630,15796,44095,23902,9.91905e+12,60.1309,20125.5,67997,7695,72,52201,52201,40297,40059,25722
22366,865,11337,13426,8940,6.39685e+12,55.5742,12566.7,22366,5514,72,11029,10981,5690,3967,3054
43213,7903,16283,26934,16279,8.05056e+12,57.7737,18783,43213,7921,72,26930,26882,18390,8251,8048
86067,19502,26847,54603,31464,8.88547e+12,58.7713,31668.7,86067,13061,72,59220,59220,53705,46218,44488
36065,323,8406,23390,12675,9.91746e+12,60.0378,10959.6,36065,4087,72,27659,27659,7712,8696,1500
29069,6360,6804,18845,10224,9.90214e+12,60.0082,8948.74,29069,3308,72,22265,22265,21841,21357,21319
47188,9855,12145,30395,16793,9.60098e+12,59.4332,15245.8,47188,5910,72,35043,35043,32053,31984,28556
8679,2013,2185,5601,3078,9.74673e+12,59.3405,3008.42,8679,1059,72,6494,6494,6252,6100,6119
47348,1199,1984,37483,9865,5.85738e+13,11.996,2698.82,47348,1981,13,45364,45364,38320,32088,42228
81317,11721,30628,50671,30646,8.05007e+12,57.3341,34851.3,81317,14900,72,50689,50689,38685,27036,23792
48898,2047,11337,31719,17179,9.9328e+12,60.0978,14619.2,48898,5520,72,37561,37561,23987,23719,7353
2182,589,680,1388,794,9.36454e+12,53.0692,963.37,2182,326,55,1502,1502,1376,1332,1347
86623,11292,20116,56179,30444,9.92117e+12,60.141,25433.1,86623,9798,72,66507,66507,53619,53364,37832
90799,10058,21133,58880,31919,9.91052e+12,60.1296,26667.6,90799,10291,72,69666,69666,55670,38092,33765
87335,14446,22468,56252,31083,9.59495e+12,59.7447,27675.1,87335,10944,72,64867,64867,56925,55027,43548
66202,13069,15867,42840,23362,9.8278e+12,60.0123,20064.4,66202,7729,72,50335,50335,47326,46625,42415
57496,1027,15723,36873,20623,9.39046e+12,56.8897,19312.2,57496,7643,72,41773,41773,24742,12014,3798
81081,32463,44061,63564,17517,79817400000,8.99013,44621.3,81081,39652,11,37020,37020,29488,30066,28929
53696,7068,17969,33858,19838,8.60651e+12,58.4714,21117.7,53696,8749,72,35727,35727,25696,13943,13523
6076,207,341,4827,1249,5.77738e+13,11.9641,587.668,6076,259,14,5735,5735,4775,4024,5304
55015,14411,26745,33208,21807,6.65609e+12,56.0782,29342.4,55015,13029,72,28270,28270,22132,14979,14904
17121,963,4834,10961,6160,9.32592e+12,59.1295,6171.09,17121,2353,72,12287,12239,8107,8002,3132
28263,302,6554,18335,9928,9.94325e+12,60.0425,8654.01,28263,3192,72,21709,21709,6215,6977,1366
77410,402,30636,47960,29450,7.81088e+12,57.5276,34582.4,77410,14919,72,46774,45718,20817,1965,1980
46832,3629,11337,30290,16542,9.80717e+12,59.9314,14467,46832,5523,72,35495,35495,24558,11654,11213
44757,7218,10441,29020,15737,9.93197e+12,60.0691,13483.9,44757,5086,72,34316,34316,30449,25243,24069
46675,4064,13532,29791,16884,9.17746e+12,59.1786,16494.5,46675,6587,72,33143,33143,23231,11587,11198
87065,18053,20286,56459,30606,9.89868e+12,60.1246,25626.9,87065,9875,72,66779,66779,63596,63523,59846
6721,2867,3361,4046,2675,6.58831e+12,51.0632,3868.48,6721,1631,72,3360,3360,2894,2292,2321
94117,38650,43000,57302,36815,7.01262e+12,56.5704,47251.7,94117,20943,72,51117,51117,48709,45507,44807
86467,47248,56018,67790,18677,2.23519e+13,5.52951,64173.1,86467,18677,13,30449,30449,29217,30449,26302
82699,4018,19216,53629,29070,9.92672e+12,60.1372,24323.3,82699,9361,72,63483,63483,41339,40893,14095
39552,16911,22226,23351,16201,5.68415e+12,54.837,23977.9,39552,10828,72,17326,17326,15744,13925,14081
12559,3430,5589,7687,4872,7.18812e+12,56.0566,6459.98,12559,2700,72,6970,6970,5682,4176,4348
18729,5795,6963,11700,7029,8.12434e+12,57.6775,8258.36,18729,3380,72,11766,11766,11150,10272,10302
53318,5076,15887,33961,19357,9.07217e+12,58.5043,19164.8,53318,7722,72,37431,37431,27326,27024,15049
52525,10405,23271,32113,20412,7.2095e+12,56.7433,25941.3,52525,11333,72,29254,29254,21992,15078,13332
86566,10473,20112,56138,30428,9.91314e+12,60.1276,25426.7,86566,9794,72,66454,66454,54905,39110,35355
96021,52710,96021,0,96021,7.99992,0,96021,96021,96021,1,0,0,0,0,0
51508,8838,11978,33401,18107,9.92005e+12,60.104,15406.9,51508,5831,72,39530,39530,35671,30455,29279
19291,323,4843,12450,6841,9.71179e+12,59.6543,6363.92,19291,2354,72,14448,14400,8485,5520,1306
66764,9835,15527,43304,23460,9.91518e+12,60.1215,19787,66764,7563,72,51237,51237,42903,42741,32757
19682,4139,4604,12771,6911,9.95128e+12,59.9379,6173.73,19682,2242,72,15078,15078,14513,13847,13764
81854,7417,41096,49188,32666,6.42977e+12,55.8499,44613.6,81854,20014,72,40758,40758,26505,16135,12920
89513,3212,20777,58056,31457,9.91333e+12,60.1418,26251.1,89513,10116,72,68736,68736,43189,42668,11706
85563,21112,34095,52977,32586,7.76346e+12,57.4888,38373.8,85563,16594,72,51468,51468,41432,29606,29328
59959,3484,13911,38883,21076,9.92554e+12,60.117,17803.4,59959,6777,72,46048,46048,30793,30496,12057
54599,10431,14385,35115,19484,9.51965e+12,59.6032,17860.7,54599,7003,72,40214,40214,35976,34968,28947
83850,3200,29583,52582,31268,8.36201e+12,58.1691,34056.5,83850,14406,72,54267,54267,28762,23192,6993
63440,16336,24528,39419,24021,7.92016e+12,57.043,27913.5,63440,11926,72,38912,38912,33833,26828,25370
39778,7870,9241,25800,13978,9.93355e+12,60.0757,12008.5,39778,4502,72,30537,30537,28512,28476,26193
15806,2456,5240,9990,5816,8.65682e+12,58.2782,6432.79,15806,2544,72,10566,10566,8287,5545,5079
71565,5871,21735,45506,26059,8.99622e+12,58.6318,25897.9,71565,10582,72,49830,49830,27179,16788,12394
32184,261,14981,19545,12639,6.93255e+12,56.0492,16725.3,32184,7291,72,17203,16497,7150,558,457
24570,7504,15116,14278,10292,4.99119e+12,52.9228,16213.5,24570,7359,72,9454,9454,7210,5122,4754
4797,1761,2093,2949,1848,7.45617e+12,55.8484,2523.11,4797,1015,67,2704,2704,2303,1859,1827
38010,7680,8907,24640,13370,9.90283e+12,60.0328,11568.6,38010,4333,72,29103,29103,27399,27353,25490
73346,17160,25671,46038,27308,8.39467e+12,58.2561,29680.4,73346,12501,72,47675,47675,40458,32044,31762
23244,7322,11452,14015,9229,6.57059e+12,55.828,12748.3,23244,5568,72,11792,11744,6738,1857,703
95966,5919,22320,62231,33735,9.9035e+12,60.1326,28129.6,95966,10860,72,73646,73646,40600,40358,20551
54699,23052,26664,33018,21681,6.62473e+12,56.0267,29244.5,54699,12978,72,28035,28035,26790,25164,24854
14672,3850,7681,8774,5898,6.21046e+12,55.2056,8549.96,14672,3738,72,6991,6991,5602,3785,3428
21367,2185,5004,13858,7509,9.8849e+12,59.8965,6681.51,21367,2421,72,16363,16363,12333,8505,7497
56909,583,13226,36917,19992,9.91393e+12,60.1078,16953,56909,6439,72,43683,43683,12517,14021,2554
47142,1495,13492,30134,17008,9.22503e+12,59.2261,16489.8,47142,6569,72,33650,33650,20648,8918,4794
47317,6729,10960,30694,16623,9.93472e+12,60.1097,14157.5,47317,5339,72,36357,36357,31256,30069,22732
14162,1809,3498,9153,5009,9.82102e+12,59.6206,4694.33,14162,1704,72,10664,10664,8283,8223,5530
46106,707,1953,36495,9611,5.85694e+13,12.0031,2665.16,46106,1311,19,44153,44153,32996,23258,39174
48852,1168,16412,30791,18061,8.57682e+12,58.4448,19325,48852,7984,72,32440,32440,19779,9567,4368
35829,12333,14029,22224,13605,7.8753e+12,57.5455,16135.1,35829,6834,72,21800,21800,21547,21304,21302
84616,25963,39626,51354,33262,6.86403e+12,56.0524,43447.2,84616,19282,72,44990,44990,39335,31538,29888
24150,4814,5615,15665,8485,9.94402e+12,60.0053,7465.39,24150,2735,72,18535,18535,17555,16295,16082
8633,1104,2032,5611,3022,9.93047e+12,59.5319,2865.7,8633,984,72,6601,6601,5238,5215,3731
79262,26713,43010,47056,32206,5.90939e+12,55.1295,46203.5,79262,20931,72,36252,36252,31317,24510,23100
71841,15966,35319,43300,28541,6.56721e+12,56.01,38531.8,71841,17197,72,36522,36522,28186,18483,18295
5776,1534,2934,3475,2301,6.48701e+12,49.2029,3383.55,5776,1412,65,2842,2842,2131,1132,1130
54543,13081,16875,34634,19909,8.92579e+12,58.8762,20166.3,54543,8216,72,37668,37668,35172,31825,31106
50213,1457,17715,31494,18719,8.36693e+12,58.1827,20629.2,50213,8625,72,32498,32450,20278,13887,5333
96875,16453,22459,62836,34039,9.91599e+12,60.149,28319.3,96875,10936,72,74416,74416,65608,65441,54888
85862,8888,20151,55644,30218,9.89173e+12,60.1025,25412.1,85862,9817,72,65711,65711,50051,48041,30102
39198,5740,16489,24120,15078,7.5168e+12,57.074,18661.3,39198,8032,72,22709,22709,15506,7136,6869
85626,16103,19901,55526,30100,9.90597e+12,60.1257,25169.4,85626,9678,72,65725,65725,61182,60122,53599
5294,953,1783,3346,1948,8.73985e+12,57.5283,2302.81,5294,864,72,3511,3511,2959,2780,2242
3420,163,899,2218,1202,9.75222e+12,58.2807,1308.83,3420,436,64,2521,2504,1556,1039,557
57055,18746,27950,44537,12518,78542300000,8.9952,28450.4,57055,25148,11,29105,29105,21806,22706,20925
82394,24259,39339,49871,32523,6.746e+12,56.2252,43019.7,82394,19152,72,43055,43055,33878,23184,22837
60145,13381,16030,38637,21508,9.47726e+12,59.5731,19786.2,60145,7803,72,44115,44115,42261,39712,39297
86726,5540,20151,56247,30479,9.91278e+12,60.1225,25474.5,86726,9805,72,66575,66575,45337,44906,19185
52877,7817,12785,34210,18667,9.80274e+12,59.9443,16251,52877,6224,72,40092,40092,32935,32778,24268
63874,7331,63874,0,63874,7.99987,0,63874,63874,63874,1,0,0,0,0,0
8032,52,1895,5215,2817,9.96626e+12,59.4565,2683.1,8032,914,72,5456,1963,3452,3403,311
48457,483,19118,30032,18425,7.83807e+12,57.2443,21797.9,48457,9307,72,29339,28816,16586,16097,1125
13033,909,3810,8316,4717,9.20228e+12,58.8696,4882.64,13033,1856,72,9223,9223,5554,3590,3179
97796,13590,22725,63417,34379,9.90973e+12,60.145,28632.9,97796,11060,72,75071,75071,61745,48950,45403
83528,4670,19566,54140,29388,9.88957e+12,60.0927,24708.5,83528,9523,72,63962,63962,33661,33452,16279
22721,3382,5365,14729,7992,9.89484e+12,59.8964,7119.68,22721,2605,72,17356,17356,14562,14496,11288
17672,3554,4146,11464,6208,9.9269e+12,59.8813,5589.63,17672,2016,72,13526,13526,12676,11911,11812
1624,117,421,1053,571,1.04811e+13,56.6693,659.009,1624,204,51,1203,1203,762,322,420
82243,4496,24953,52311,29932,8.99488e+12,58.8072,29637.9,82243,12135,72,57290,57290,37759,14775,13852
21294,4208,5049,13802,7492,9.83881e+12,59.8154,6716.14,21294,2445,72,16245,16245,15152,14145,13982
19310,1280,5753,12308,7002,9.08509e+12,58.9162,7202.17,19310,2796,72,13557,13557,9249,4159,4175
46138,2148,10775,29925,16213,9.89356e+12,60.0574,13901.7,46138,5240,72,35363,35363,22788,15389,7385
22234,3673,5982,14282,7952,9.4481e+12,59.3509,7649.4,22234,2905,72,16252,16252,13137,10195,9462
47068,11878,13989,29989,17079,9.0887e+12,59.0521,16943.2,47068,6812,72,33079,33079,31512,29750,29778
50563,7606,11778,32797,17766,9.90908e+12,60.0842,15152.1,50563,5733,72,38785,38785,33754,26943,25372
94655,15478,22015,61376,33279,9.90865e+12,60.1363,27753.4,94655,10719,72,72640,72640,64798,62966,51624
85506,48072,85506,0,85506,7.99991,0,85506,85506,85506,1,0,0,0,0,0
48845,5165,15900,30877,17968,8.71743e+12,58.5914,18844.7,48845,7737,72,32945,32945,21770,8533,8195
15201,795,1064,12126,3075,5.69036e+13,11.9857,1457.86,15201,623,14,14137,14137,12493,11455,13393
22193,3133,6831,14108,8085,8.97895e+12,58.4411,8424.74,22193,3311,72,15362,15362,11323,6635,6507
20557,2085,6917,12967,7590,8.61644e+12,57.2932,8368.82,20557,3353,72,13640,13640,8998,5967,5038
23304,2540,5951,15025,8279,9.6353e+12,59.5981,7704.78,23304,2894,72,17353,17353,13271,13165,8416
39412,8190,10653,25299,14113,9.42126e+12,59.451,13291.5,39412,5174,72,28759,28759,26480,23419,22763
74764,3048,24571,47204,27560,8.67954e+12,58.4021,28758.1,74764,11964,72,50193,50193,30718,10716,6899
80548,16544,18728,52227,28321,9.9171e+12,60.1308,23724.9,80548,9117,72,61820,61820,58586,55536,54775
43755,1289,17911,27016,16739,7.62967e+12,57.0798,20330.3,43755,8703,72,25844,25844,14752,8854,1382
26498,1110,6172,17198,9300,9.92014e+12,59.9931,8164.72,26498,3000,72,20326,20326,12932,12787,3946
96075,19818,22329,62303,33772,9.90991e+12,60.1437,28145.5,96075,10871,72,73746,73746,70766,70063,65868
40164,5186,22654,31538,8626,80339900000,8.97859,23032.6,40164,20381,11,17510,17510,7243,7755,6749
66724,3016,20662,42360,24364,8.93397e+12,58.8976,24553.1,66724,10065,72,46062,46062,29285,28771,8779
41733,7119,16492,25859,15874,7.82903e+12,57.4993,18862.5,41733,8031,72,25241,25241,18367,10305,10193
8744,242,2053,5679,3065,9.93436e+12,59.5807,2896.28,8744,994,72,6691,6691,4013,3966,875
1058,233,378,679,379,8.3287e+12,52.1711,536.714,1058,170,43,680,680,551,425,545
83104,3168,5017,66116,16988,5.74549e+13,12.0014,5965.67,83104,3266,20,78087,78087,64093,52632,71193
38893,700,2369,30940,7953,5.74429e+13,12.0033,3016.28,38893,1556,20,36524,36524,25677,18192,31169
34295,511,8013,22248,12047,9.89976e+12,60.0098,10463.3,34295,3893,72,26282,26282,15389,9995,2068
52579,513,3606,41920,10659,5.69691e+13,12.0021,4356.28,52579,1872,20,48973,48973,29966,16363,37477
43920,13643,15018,27645,16275,8.50575e+12,58.2415,17665.1,43920,7311,72,28902,28902,26876,26840,24552
1800,1139,1182,1042,758,4.73199e+12,26.1572,1332.66,1800,553,49,618,618,618,618,618
39151,519,15498,24262,14889,7.80905e+12,57.464,17747.3,39151,7545,72,23653,23159,13855,7637,2048
30418,852,13761,18549,11869,7.11095e+12,56.539,15458.4,30418,6704,72,16657,16417,7884,2885,1198
12255,3290,6384,7333,4922,6.25424e+12,55.176,7145.75,12255,3107,72,5871,5871,4803,3311,3198
77243,7372,17905,50097,27146,9.92244e+12,60.1473,22732.4,77243,8721,72,59338,59338,44029,43717,25246
67530,3908,37592,39932,27598,5.73376e+12,54.8932,40314.8,67530,18309,72,29938,29938,17538,9662,2648
26731,6031,7830,17047,9684,9.15386e+12,59.0658,9709,26731,3813,72,18901,18901,16240,13177,13124
9805,2825,3653,6127,3678,8.16447e+12,57.2826,4443.25,9805,1773,72,6152,6152,5573,4878,4782
99277,18101,41611,61111,38166,7.50301e+12,57.1018,46320,99277,20268,72,57666,57666,43647,27601,23474
53963,6861,12549,34995,18968,9.91073e+12,60.1004,16115.2,53963,6101,72,41414,41414,33219,25391,23248
97176,22903,25962,62420,34756,9.4646e+12,59.5836,31601.8,97176,12639,72,71214,71214,66707,61430,61285
10210,1807,3259,6472,3738,8.84143e+12,56.1541,4129.2,10210,1578,72,6951,6951,4821,2359,2371
51488,6651,18872,32182,19306,8.18731e+12,57.4663,21795.6,51488,9174,72,32616,32616,22264,13627,11049
49775,3281,13764,31893,17882,9.34171e+12,59.3886,16938.7,49775,6692,72,36011,36011,23566,15456,8416
85539,19561,19861,55472,30067,9.91595e+12,60.143,25126,85539,9670,72,65678,65678,65314,64919,64896
71831,18970,37816,56236,15595,79446800000,8.82343,38355.4,71831,34030,11,34015,34015,20477,21849,19123
50175,9149,11687,32539,17636,9.9121e+12,60.0796,15038.2,50175,5688,72,38488,38488,34838,31397,30520
45119,9083,10985,29177,15942,9.77708e+12,59.9015,14019.9,45119,5346,72,34134,34134,32132,31662,28942
37642,7089,8771,24417,13225,9.92054e+12,60.0473,11415.1,37642,4269,72,28871,28871,26392,24032,23547
30798,3022,8649,19720,11078,9.29098e+12,59.2672,10784.7,30798,4208,72,22149,22149,16677,16515,10122
53786,9786,12663,34857,18929,9.87997e+12,60.0364,16202.5,53786,6160,72,41123,41123,37954,33670,32722
3580,196,949,2319,1261,9.5176e+12,58.1235,1374.06,3580,452,64,2631,2631,1085,1181,640
43702,12162,18165,26932,16770,7.5608e+12,56.937,20558.6,43702,8833,72,25537,25537,22561,18465,17669
21033,3410,10172,12706,8327,6.72094e+12,55.3755,11389.5,21033,4949,72,10861,10861,8002,4972,4385
65695,10402,15976,42479,23216,9.77414e+12,59.2378,20133.5,65695,7762,72,49719,49719,43026,36645,34910
87741,5040,31425,54948,32793,8.28887e+12,57.5197,36044.9,87741,15287,72,56316,56316,33956,7548,6634
20483,6567,6927,12906,7577,8.56482e+12,57.5517,8376.17,20483,3362,72,13556,13556,13057,12549,12616
31801,3830,11728,19855,11946,8.18531e+12,57.8751,13696.4,31801,5713,72,20073,20073,13846,7600,5936
19051,261,8022,11729,7322,7.50989e+12,56.8828,9251.31,19051,3899,72,11029,10741,4978,2174,1045
50787,6530,11819,32940,17847,9.92661e+12,60.0999,15204,50787,5757,72,38968,38968,31340,24062,22076
23356,3306,23356,0,23356,7.99966,0,23356,23356,23356,1,0,0,0,0,0
71436,1661,22335,45306,26130,8.8813e+12,58.8558,26444.7,71436,10881,72,49101,49101,19277,17392,3826
31454,7102,8198,20243,11211,9.56192e+12,59.5882,10416.8,31454,3988,72,23256,23256,22548,22365,21529
92648,1091,21555,60076,32572,9.9103e+12,60.1331,27185.9,92648,10498,72,71093,71093,20960,23404,4681
16495,4387,8759,9833,6662,6.09215e+12,55.0356,9701.32,16495,4261,72,7736,7736,5856,4089,3818
38237,5474,8958,24786,13451,9.91809e+12,60.0351,11629.2,38237,4364,72,29279,29279,25101,24124,18158
97491,7936,22651,63220,34271,9.92312e+12,60.1473,28535.8,97491,11034,72,74840,74840,48774,31113,27052
4018,1528,1559,2503,1515,8.05404e+12,47.4918,1965.33,4018,742,62,2459,2459,2459,2459,2459
19950,2034,7609,12420,7530,8.02505e+12,57.602,8953.79,19950,3706,72,12341,12341,7965,6073,5434
42292,7833,9876,27421,14871,9.90709e+12,60.0714,12786.6,42292,4807,72,32416,32416,30009,26795,26085
56918,1315,24213,34973,21945,7.42127e+12,57.0383,27145.5,56918,11783,72,32705,32513,19255,8476,2919
69122,6052,35139,41454,27668,6.3573e+12,55.7456,38163.1,69122,17118,72,33983,33983,20510,10574,4338
27751,13748,15127,16468,11283,5.89208e+12,52.3378,16498.5,27751,7347,72,12624,12624,12537,12396,12512
54606,14628,16719,34694,19912,8.96739e+12,58.9093,20028.6,54606,8139,72,37887,37887,36531,36205,34430
78497,10842,22600,50134,28363,9.19982e+12,59.2459,27185.5,78497,11004,72,55897,55897,42746,42422,26676
7154,29,1743,4625,2529,9.88001e+12,59.3974,2461.84,7154,849,72,3496,583,1740,1615,100
73449,5784,23516,46495,26954,8.78856e+12,58.732,27682.6,73449,11456,72,49933,49933,34190,20902,16913
47069,19050,20644,28805,18264,7.26122e+12,56.4037,23104.6,47069,10051,72,26425,26425,25580,24505,24335
5674,1313,1353,3682,1992,9.98096e+12,59.0687,1960.21,5674,650,72,4321,4321,4304,4315,4302
27466,8766,11023,17001,10465,7.75154e+12,57.3167,12704.4,27466,5364,72,16443,16443,15787,14872,14899
92278,21261,21414,59853,32425,9.91164e+12,60.142,27034.6,92278,10423,72,70864,70864,70663,70658,70556
33823,5219,7887,21932,11891,9.92018e+12,60.0401,10311.6,33823,3837,72,25936,25936,22090,18460,17524
94423,3371,21955,61220,33203,9.909e+12,60.1374,27683.8,94423,10691,72,72468,72468,30252,13160,12083
42259,16465,16524,26215,16044,7.87282e+12,57.5604,18933.4,42259,8050,72,25735,25735,25686,25694,25678
71190,7480,16549,46175,25015,9.90895e+12,60.1177,21049.8,71190,8053,72,54641,54641,42090,40167,25188
64016,9566,36737,37655,26361,5.50755e+12,54.5388,39265.8,64016,17876,72,27279,27279,18468,8229,8017
50405,19306,25102,30328,20077,6.48789e+12,55.8416,27480.9,50405,12206,72,25303,25303,22437,19717,19171
97115,13114,22570,62976,34139,9.90903e+12,60.143,28442,97115,10984,72,74545,74545,63123,60466,43808
36178,10018,18358,21701,14477,6.37533e+12,54.6689,20152.4,36178,8938,72,17820,17820,14882,10818,10081
23667,2139,5516,15351,8316,9.93121e+12,59.9694,7335.19,23667,2680,72,18151,18151,12481,12016,7117
48333,1077,2852,38433,9900,5.75436e+13,12.0025,3574.86,48333,1276,20,45481,45481,33299,24072,39978
38286,5560,8899,24831,13455,9.92054e+12,60.088,11585.8,38286,4334,72,29387,29387,25388,19984,18740
53160,1104,30535,31271,21889,5.51076e+12,54.362,32704.8,53160,14859,72,22625,22391,13217,8417,2063
55307,1841,12859,35870,19437,9.91621e+12,60.0944,16495.4,55307,6258,72,42448,42448,26409,17671,6720
55624,18844,19374,34939,20685,8.4206e+12,58.2547,22562.7,55624,9432,72,36250,36250,35601,34819,34705
39693,5363,13721,24956,14737,8.46745e+12,58.261,16145.2,39693,6680,72,25972,25972,19798,12548,12467
85777,34226,35920,52799,32978,7.50576e+12,56.9297,40086.9,85777,17487,72,49857,49857,49386,48708,48786
12555,868,2991,8139,4416,9.90313e+12,59.6992,4093.34,12555,1453,72,9564,9564,6534,6463,2980
10972,2805,3885,6891,4081,8.38279e+12,57.8088,4765.87,10972,1887,72,7087,7087,6619,6085,6298
33203,14144,15307,20195,13008,6.97639e+12,56.0765,17108.9,33203,7450,72,17896,17896,16697,15383,15413
52735,5287,15295,33663,19072,9.17253e+12,59.132,18574.9,52735,7442,72,37440,37440,24726,16200,13304
61659,7330,18099,39318,22341,9.12489e+12,59.1328,21817,61659,8806,72,43560,43560,32403,32002,18576
77113,8962,17885,50011,27102,9.91719e+12,60.1411,22706.8,77113,8704,72,59228,59228,48470,33762,30274
36830,3001,17474,22313,14517,6.7981e+12,56.0438,19392.9,36830,8490,72,19356,19356,11760,2934,2648
23321,1785,7731,14732,8589,8.65451e+12,58.3978,9344.81,23321,3761,72,15590,15590,9158,5672,4518
80874,20674,39094,48861,32013,6.67608e+12,56.0766,42684.5,80874,19029,72,41780,41780,35501,26846,24988
92515,12290,25889,59223,33292,9.30323e+12,59.3828,31214.9,92515,12608,72,66626,66626,50040,34144,29722
79456,17055,18480,51524,27932,9.91763e+12,60.1312,23416.3,79456,9001,72,60976,60976,59321,57153,56704
24418,7288,8052,15427,8991,8.64976e+12,58.4093,9729.65,24418,3908,72,16366,16366,15552,14519,14356
11810,2509,2830,7659,4151,9.83165e+12,59.5997,3883.32,11810,1365,72,8980,8980,8616,8198,8172
86795,4193,22246,55928,30867,9.60243e+12,59.7531,27432.9,86795,10828,72,64549,64549,30435,18541,12165
60228,1338,3819,47963,12265,5.72646e+13,11.9965,4617.47,60228,2462,14,56409,56409,40736,30401,49338
1605,492,495,1031,574,9.37535e+12,55.7178,720.928,1605,237,51,1110,1110,1104,1104,1106
34293,7111,13395,21291,13002,7.89275e+12,57.5402,15430.2,34293,6519,72,20898,20898,15943,10096,10079
56591,16016,25824,34472,22119,7.02767e+12,56.5471,28610.4,56591,12577,72,30767,30767,24921,18068,18006
69029,10656,17332,44537,24492,9.67213e+12,58.9926,21628.8,69029,8435,72,51697,51697,42710,42489,31779
6784,2214,3043,4150,2634,7.28007e+12,56.0411,3589.36,6784,1482,72,3741,3741,3560,3294,3430
59818,5529,16524,38324,21494,9.3581e+12,59.4205,20219.6,59818,8050,72,43294,43294,28560,28392,15858
92618,5305,25918,59290,33328,9.30506e+12,59.0406,31250.6,92618,12609,72,66700,66700,43704,43148,15442
43247,3237,10037,28051,15196,9.92455e+12,60.089,13005.6,43247,4884,72,33210,33210,23339,23136,11299
81675,11738,34873,50156,31519,7.40306e+12,56.844,38823.4,81675,16982,72,46802,46802,33815,22754,19620
63391,1508,14763,41109,22282,9.91441e+12,60.1066,18838.3,63391,7184,72,48628,48628,17218,5677,5500
70976,12692,22500,44959,26017,8.82688e+12,58.7857,26565.6,70976,10957,72,48476,48476,45011,41673,40968
75105,36287,37486,45159,29946,6.47269e+12,55.6366,40776.4,75105,18256,72,37619,37619,36986,36090,36121
47830,13637,28738,27908,19922,5.16351e+12,51.9997,30636,47830,13978,72,19092,19092,13565,8376,7110
60805,2868,33959,35926,24879,5.71426e+12,54.2398,36452.4,60805,16539,72,26846,26846,16095,9599,3327
15506,401,5609,9709,5797,8.34725e+12,57.8423,6738.75,15506,2732,72,9897,9801,3550,1714,813
98720,14027,26699,63351,35369,9.42007e+12,57.1317,32399.4,98720,12990,72,72021,72021,60700,60488,46845
34593,9673,11850,21761,12832,8.5176e+12,58.3124,14028.5,34593,5773,72,22743,22743,20075,16935,17034
7547,2858,3807,5898,1649,78824200000,8.96568,3980.66,7547,3418,11,3740,3740,2988,3081,2913
73165,6956,19532,46993,26172,9.47446e+12,59.5863,23960.9,73165,9514,72,53633,53633,38570,38213,20119
44273,15332,23979,34702,9571,7.9766e+10,8.99544,24391.9,44273,21578,11,20294,20294,15121,15404,14854
82027,653,4207,65097,16930,5.80018e+13,12.0014,5154.04,82027,2112,20,77820,77820,50238,27995,56655
24118,3574,5677,15635,8483,9.88683e+12,59.9531,7522.91,24118,2759,72,18441,18441,15445,15376,11920
96971,18650,90616,66761,30210,9.2107e+12,3.99764,90771.5,96971,30224,9,6355,6355,1306,6355,1313
68013,11599,15804,44108,23905,9.91681e+12,60.1278,20134.4,68013,7697,72,52209,52209,47145,40268,38684
53961,3154,15740,34432,19529,9.15349e+12,59.1553,19072.4,53961,7662,72,38221,38221,24701,8790,8204
71262,13418,16563,46215,25047,9.91482e+12,60.1192,21064.7,71262,8065,72,54699,54699,50942,50066,44733
36310,5616,8457,23549,12761,9.94017e+12,60.0605,11022,36310,4120,72,27853,27853,24456,23662,18874
98462,26398,38957,61007,37455,7.80157e+12,57.548,43797.3,98462,18964,72,59505,59505,52779,44882,44775
53952,4930,12594,34979,18973,9.9125e+12,60.0902,16152,53952,6135,72,41358,41358,30196,29970,16546
99223,9078,32469,62677,36546,8.6858e+12,58.6413,37809.1,99223,15810,72,66754,66754,48153,33231,25460
23779,7979,12160,14266,9513,6.32722e+12,54.304,13443.6,23779,5903,72,11619,11619,10428,8769,8607
41428,1062,1738,32797,8631,5.85666e+13,11.9948,2405.86,41428,1734,13,39690,39690,33629,28271,36991
21171,4990,6610,13430,7741,8.92967e+12,58.1373,8139.7,21171,3214,72,14561,14561,13027,11324,11332
13203,1462,4515,8316,4887,8.59947e+12,58.085,5537.63,13203,2198,72,8688,8688,5714,2303,2245
96532,4543,39198,59642,36890,7.67511e+12,57.2905,43883.6,96532,19079,72,57334,57334,35228,10386,8302
27861,2153,7372,17921,9940,9.5364e+12,59.5119,9373.97,27861,3591,72,20489,20489,12563,7360,6310
67311,5290,17522,43317,23994,9.55216e+12,59.6745,21680.7,67311,8530,72,49789,49789,29798,29755,15655
80736,4239,18714,52360,28376,9.91527e+12,60.1346,23727.8,80736,9105,72,62022,62022,31232,16622,14815
47195,18662,22050,28649,18546,6.89295e+12,55.803,24415.2,47195,10737,72,25145,25145,22868,20211,20332
67378,7364,15670,43698,23680,9.90915e+12,60.1134,19964.6,67378,7629,72,51708,51708,39706,39451,25035
56977,8555,16562,36372,20605,9.15985e+12,59.1599,20053.2,56977,8056,72,40415,40415,33951,25132,23083
66845,8952,22212,42179,24666,8.62082e+12,58.5224,26005.7,66845,10809,72,44633,44633,34193,33785,21590
61070,20972,32342,36399,24671,6.08001e+12,55.3126,34979.9,61070,15734,72,28728,28728,24801,19380,18306
90151,22972,38177,55415,34736,7.44387e+12,56.7063,42492.6,90151,18584,72,51974,51974,41468,29188,28745
99775,30986,39883,61754,38021,7.75007e+12,57.488,44750.2,99775,19424,72,59892,59892,53660,46402,46205
80310,16783,33450,49465,30845,7.54295e+12,57.2073,37398.2,80310,16296,72,46860,46860,40804,32566,30653
11044,1131,3215,7054,3990,9.20205e+12,58.7933,4162.24,11044,1561,72,7829,7829,5815,3447,3584
73185,4951,17052,47457,25728,9.90826e+12,60.123,21654.8,73185,8304,72,56133,56133,38495,38142,16823
53345,11523,16575,33856,19489,8.90799e+12,58.2788,19805.2,53345,8068,72,36770,36770,32797,27314,26228
69783,729,16212,45252,24531,9.92151e+12,60.1238,20633.2,69783,7898,72,53571,53571,15358,2847,3260
68059,18860,29654,41702,26357,7.2826e+12,56.8827,33001.7,68059,14435,72,38405,38405,30655,21507,21346
69656,602,29199,42871,26785,7.5067e+12,56.9589,32695,69656,14219,72,40457,39438,18068,6353,1661
95621,6800,39700,58920,36701,7.55237e+12,56.921,44292.3,95621,19320,72,55921,55921,36919,14648,13779
57604,16364,22262,35787,21817,7.92422e+12,56.9761,25388.3,57604,10831,72,35342,35342,30706,24413,22963
53599,10034,15851,34165,19434,9.08845e+12,59.0779,19150.9,53599,7706,72,37748,37748,33388,27357,26139
72733,28753,32876,44339,28394,7.07993e+12,56.1429,36328.6,72733,16007,72,39857,39857,38174,35826,35504
88869,2516,33873,55294,33575,7.992e+12,57.3784,38400.8,88869,16483,72,54996,54996,32016,12549,4014
15881,1103,4551,10148,5733,9.25907e+12,59.0017,5807.69,15881,2217,72,11330,11282,5450,4649,3859
80258,24515,34623,49229,31029,7.34978e+12,56.9665,38485,80258,16863,72,45635,45635,39457,32281,32048
37470,15812,18357,29249,8221,7.8541e+10,8.99295,18760.8,37470,16517,11,19113,19113,17097,17344,16865
3452,356,1886,2064,1388,5.92274e+12,42.1466,2178.93,3452,896,64,1566,1518,1172,1085,1132
17266,1433,4045,11191,6075,9.94635e+12,59.8999,5461.1,17266,1970,72,13221,13221,8520,8270,4748
15791,3886,4175,10167,5624,9.52767e+12,59.3525,5456.97,15791,2029,72,11616,11616,11203,11195,10872
79912,4848,18581,51820,28092,9.91078e+12,60.1329,23547.2,79912,9046,72,61331,61331,41371,40962,16830
12242,2048,6717,9600,2642,79980200000,8.88752,6927.67,12242,6041,11,5525,5525,2523,2745,2318
94928,11590,22070,61549,33379,9.91002e+12,60.1384,27825.7,94928,10745,72,72858,72858,57641,57331,38971
60690,3689,30347,36490,24200,6.45497e+12,55.8514,33103.8,60690,14768,72,30343,30343,18547,8894,6124
23415,3044,5733,15147,8268,9.77147e+12,59.7695,7514.35,23415,2789,72,17682,17682,14475,10173,9211
31067,5392,10278,19609,11458,8.6621e+12,58.2798,12307.3,31067,5001,72,20789,20789,17618,13267,12402
18321,3951,4312,11887,6434,9.88568e+12,59.8344,5795.78,18321,2088,72,14009,14009,13594,13113,13069
16572,3289,3910,10753,5819,9.86703e+12,59.8114,5282.74,16572,1894,72,12662,12662,11919,11749,10837
61943,19089,28446,37685,24258,6.98423e+12,56.4912,31436.8,61943,13843,72,33497,33497,30024,25987,26048
62832,10234,34347,49271,13561,79914600000,8.99564,34836.8,62832,30910,11,28485,28485,13569,14521,12636
96503,10817,22440,62578,33925,9.9072e+12,60.1303,28276.7,96503,10919,72,74063,74063,59787,56782,36370
19421,2420,4546,12593,6828,9.91016e+12,59.9218,6103.1,19421,2206,72,14875,14875,12385,11798,8326
47644,18118,26572,28162,19482,5.7199e+12,53.6004,28625.5,47644,12923,72,21072,21072,19544,17507,17145
18683,5161,5479,11931,6752,9.14706e+12,58.9374,6896.52,18683,2658,72,13204,13204,12937,12856,12647
92192,1926,21390,59795,32397,9.92083e+12,60.146,27002.6,92192,10414,72,70802,70802,42450,27918,7477
26574,1509,7203,17055,9519,9.45879e+12,59.4115,9115.39,26574,3509,72,19371,19371,10451,6167,4412
7888,450,1862,5122,2766,1.00039e+13,59.4663,2638.29,7888,902,72,6026,6026,3037,2015,1538
47830,7381,11154,31011,16819,9.89968e+12,60.0672,14376.8,47830,5417,72,36676,36676,31221,26006,24645
89651,3265,34929,55647,34004,7.88431e+12,57.3057,39436.3,89651,17000,72,54722,54722,28787,12998,7380
96878,3084,22456,62834,34044,9.92442e+12,60.1495,28313.6,96878,10936,72,74422,74422,46184,30845,11388
89707,21966,26214,57234,32473,9.13879e+12,55.4109,31328.2,89707,12750,72,63493,63493,63493,63493,63493
50751,16278,19116,31620,19131,8.05451e+12,57.4929,21970.2,50751,9303,72,31635,31635,29892,27577,27095
88866,9387,28606,56225,32641,8.75892e+12,58.7145,33495.8,88866,13929,72,60260,60260,43265,26819,22215
93619,28798,38466,57764,35855,7.6048e+12,57.2775,43003.4,93619,18717,72,55153,55153,50746,44688,43431
37412,13252,18329,29204,8208,78539400000,8.99262,18732.5,37412,16494,11,19083,19083,15060,15554,14583
21017,2996,5480,13532,7485,9.56277e+12,59.5262,7092.27,21017,2662,72,15537,15537,12858,12193,8495
71117,2836,34076,43019,28098,6.72985e+12,56.201,37326.3,71117,16589,72,37041,37041,21918,13391,3686
80707,14975,18708,52343,28364,9.92915e+12,60.1466,23714.4,80707,9114,72,61999,61999,57516,56472,50069
35018,7166,8159,22707,12311,9.92209e+12,60.0507,10653.9,35018,3969,72,26859,26859,25642,25366,23763
49055,14618,19667,30354,18701,7.74272e+12,56.4397,22354.3,49055,9558,72,29388,29388,26517,22548,21826
10260,1860,2453,6649,3611,9.95923e+12,59.5886,3396.02,10260,1194,72,7807,7807,6942,6926,6073
95003,32826,35255,59278,35725,8.1214e+12,57.3422,40113.2,95003,17152,72,59748,59748,58224,57859,55826
13026,2553,5194,8067,4959,7.84497e+12,57.1731,6141.71,13026,2524,72,7832,7832,5989,3913,3944
75447,10791,19890,48519,26928,9.50412e+12,59.2845,24455.2,75447,9668,72,55557,55557,45043,32389,32214
8077,1370,3169,5028,3049,7.94267e+12,56.7255,3837.59,8077,1540,72,4908,4908,3049,3195,1375
75098,12590,28965,46670,28428,7.93801e+12,57.6795,32862.8,75098,14108,72,46133,46133,37390,27953,25648
86168,36526,40139,52324,33844,6.89848e+12,55.4843,44035.1,86168,19541,72,46029,46029,44638,42809,42456
67423,1705,15677,43715,23708,9.91311e+12,60.1161,19974.6,67423,7632,72,51746,51746,31331,20638,6201
43956,8243,12902,28028,15928,9.14443e+12,59.119,15708.5,43956,6284,72,31054,31054,26573,20508,19120
59526,6072,20355,37456,22070,8.49812e+12,58.0515,23759.5,59526,9894,72,39171,39123,30657,22580,20299
49662,2577,19065,30885,18777,7.95682e+12,57.0467,21841.2,49662,9265,72,30597,30597,19603,12888,6297
49630,12713,15235,31532,18098,8.95703e+12,58.905,18291.6,49630,7416,72,34395,34395,30967,26940,26972
28735,7626,8663,18284,10451,9.03434e+12,58.9121,10635.2,28735,4215,72,20072,20072,18655,17290,17140
52973,30044,32243,30832,22141,5.07997e+12,54.1243,34262.2,52973,15707,72,20730,20730,19893,19188,19076
76849,658,3806,60957,15892,5.8115e+13,12.0019,4723.37,76849,3131,20,73043,73043,48683,28552,61870
3552,860,1142,2262,1290,8.99004e+12,57.4758,1539.27,3552,552,64,2410,2410,2019,2012,1718
27270,1226,8325,17336,9934,8.99379e+12,58.8531,10209.9,27270,4050,72,18945,18945,11675,3774,2948
87516,24371,35466,54088,33428,7.68734e+12,56.9418,39782.8,87516,17261,72,52050,52050,47776,42854,42766
25346,567,7708,16125,9221,9.00461e+12,58.8495,9487,25346,3749,72,17638,17542,10613,10427,2126
74615,2757,21278,47698,26917,9.22966e+12,59.2268,25686.8,74615,10353,72,53337,53337,32344,31789,6576
60260,3547,14037,39076,21184,9.92066e+12,60.1019,17940.3,60260,6838,72,46223,46223,24728,13838,12268
60544,2947,21119,38017,22527,8.41146e+12,58.2666,24541.2,60544,10281,72,39425,39425,16346,16720,4721
32537,3118,7607,21102,11435,9.89382e+12,60.0111,9956.28,32537,3693,72,24930,24930,17906,12089,10478
9374,3357,5035,5585,3789,5.99687e+12,54.7706,5647.31,9374,2438,72,4339,4339,3675,2730,2744
96854,10234,35634,60493,36361,8.15969e+12,57.6834,40593,96854,17338,72,61220,61220,41988,25972,18558
92073,31943,35010,57308,34765,8.00222e+12,57.7812,39677.1,92073,17043,72,57063,57063,55380,53462,53497
61937,4856,14419,40158,21779,9.92246e+12,60.1055,18412.7,61937,7024,72,47518,47518,30059,18809,16384
85079,10980,39587,51671,33408,6.9067e+12,56.0763,43445.4,85079,19263,72,45492,45492,27300,15579,11489
25857,2961,7013,16599,9258,9.41964e+12,59.3802,8890.51,25857,3404,72,18844,18844,14119,8614,8452
76929,26595,26599,48353,28576,8.45741e+12,58.1443,30795.1,76929,12941,72,50330,50330,50330,50330,50330
78072,15513,18742,50525,27547,9.81708e+12,60.0021,23565.3,78072,9122,72,59330,59330,55084,54977,50013
63907,2825,63907,0,63907,7.99987,0,63907,63907,63907,1,0,0,0,0,0
32928,13423,15771,19935,12993,6.73747e+12,56.1161,17512.5,32928,7674,72,17157,17157,16354,15661,15570
79483,9996,31349,49273,30210,7.82859e+12,57.5551,35389.1,79483,15267,72,48134,48134,32891,15057,14356
21371,4559,5443,13784,7587,9.64351e+12,59.6076,7085.43,21371,2645,72,15928,15928,14944,13630,13456
2180,206,562,1413,767,9.8329e+12,57.4303,859.639,2180,268,57,1618,1618,1111,804,667
98155,6325,42413,60193,37962,7.33429e+12,56.9698,46988.2,98155,20654,72,55742,55742,37440,24791,15280
84701,37031,46757,50142,34559,5.7913e+12,54.7579,50071.2,84701,22773,72,37944,37944,34910,30760,29920
41594,1599,11594,26643,14951,9.33273e+12,59.3487,14322.5,41594,5645,72,30000,30000,18724,12393,5017
35381,6407,20432,20785,14596,5.48378e+12,54.5862,21992.4,35381,9950,72,14949,14949,10193,5749,4708
77069,21112,24526,48812,28257,8.81772e+12,58.768,28874.5,77069,11948,72,52543,52543,49978,46552,45801
76549,6279,17772,49650,26899,9.91249e+12,60.1194,22558.3,76549,8644,72,58777,58777,38475,24731,21535
31922,4058,13482,19637,12285,7.48751e+12,56.9966,15322.4,31922,6561,72,18440,18392,10880,4553,1741
39731,8233,9236,25771,13960,9.94521e+12,60.0709,11997.6,39731,4499,72,30495,30495,29016,27646,27386
81887,6658,19033,53094,28793,9.91447e+12,60.1371,24102.1,81887,9266,72,62854,62854,41023,26276,22878
7914,236,1932,5124,2790,9.82855e+12,59.3452,2705.57,7914,936,72,5982,5982,3481,3433,571
4482,432,1080,2907,1575,1.00687e+13,58.921,1587.28,4482,526,70,3402,3402,2377,1652,1503
67839,13144,15770,43991,23848,9.91715e+12,60.119,20089.1,67839,7676,72,52069,52069,48842,44509,43537
94777,6821,31001,59875,34902,8.69776e+12,58.6372,36130.5,94777,15103,72,63776,63776,33188,16975,10614
75115,16480,22846,47760,27355,9.00172e+12,58.9918,27175,75115,11129,72,52269,52269,45185,38389,36688
48434,5250,23778,29197,19237,6.57615e+12,55.9726,26104.9,48434,11575,72,24656,24656,14647,8895,6925
18482,5413,5802,11724,6758,8.93842e+12,58.6284,7170.37,18482,2826,72,12680,12680,12650,12613,12664
53211,7740,12390,34511,18700,9.90156e+12,60.0696,15909.8,53211,6023,72,40821,40821,35228,27605,25845
53892,6612,12534,34947,18945,9.91322e+12,60.0949,16092,53892,6101,72,41358,41358,32678,24370,22113
27034,6842,7592,17313,9721,9.29833e+12,59.2168,9513.12,27034,3687,72,19442,19442,18369,17179,17214
69400,5498,16196,45005,24395,9.89862e+12,60.1015,20595.5,69400,7883,72,53204,53204,33960,33042,18577
13107,2258,3108,8496,4611,9.91914e+12,59.6922,4249.1,13107,1507,72,9999,9999,8984,8750,7438
72545,11866,18201,46810,25735,9.67877e+12,59.8265,22675.7,72545,8864,72,54344,54344,45333,36720,34359
60486,9660,17224,38662,21824,9.23614e+12,59.2808,20921.8,60486,8381,72,43262,43262,34944,34735,24839
65258,8712,15175,42320,22938,9.91784e+12,60.1189,19353.9,65258,7391,72,50083,50083,42332,31761,29283
1813,50,461,1170,643,1.02522e+13,57.4462,722.535,1813,222,53,1183,427,775,764,164
45461,3488,18676,28048,17413,7.61805e+12,57.2428,21165.7,45461,9088,72,26785,26785,14530,7140,4626
83372,2371,19411,54058,29314,9.90803e+12,60.1009,24558.4,83372,9439,72,63961,63961,39179,38687,8638
50342,8240,14785,32110,18232,9.13478e+12,59.1251,17922.5,50342,7203,72,35557,35557,30294,23160,21501
51509,15235,30385,30146,21363,5.30722e+12,54.1996,32439.8,51509,14797,72,21124,21124,16512,11166,11171
58822,128,2847,46652,12170,5.81754e+13,11.9965,3642.34,58822,2443,14,55975,55975,34192,15902,46250
82772,3755,19237,53683,29089,9.91808e+12,60.1364,24351.9,82772,9369,72,63535,63535,29661,30207,13206
72480,999,16880,46991,25489,9.91647e+12,60.1207,21444.3,72480,8222,72,55600,55600,16881,18641,3923
75151,6926,17456,48740,26411,9.9043e+12,60.1133,22168.6,75151,8490,72,57695,57695,42418,30226,23663
26263,4068,9442,16450,9813,8.30096e+12,57.9965,11154.8,26263,4599,72,16821,16821,13144,9185,8354
58061,3488,24248,35747,22314,7.52929e+12,56.6616,27259.3,58061,11807,72,33813,33813,20088,9491,6179
47488,5529,15198,30064,17424,8.78723e+12,58.6751,18094.9,47488,7395,72,32290,32290,22220,21933,9959
69855,513,17155,45130,24725,9.75071e+12,59.9213,21517.9,69855,8354,72,52700,52634,30195,16508,2529
98061,17326,32243,61923,36138,8.66714e+12,58.6075,37515.1,98061,15702,72,65818,65818,56089,42698,39699
73768,1250,30905,45405,28363,7.50395e+12,56.7909,34575.2,73768,15042,72,42863,42863,18055,7284,2530
25227,946,10724,15503,9724,7.427e+12,55.415,12250.3,25227,5210,72,14503,14411,8245,2373,776
91414,16185,21216,59285,32129,9.91217e+12,60.1406,26791.5,91414,10322,72,70198,70198,62868,62724,53950
25231,3974,5940,16365,8866,9.88946e+12,59.9338,7850.18,25231,2887,72,19291,19291,16988,16442,13256
22151,794,5169,14369,7782,9.91899e+12,59.9587,6897.11,22151,2511,72,16982,16982,6902,7269,2899
58888,4892,13726,38187,20701,9.92036e+12,60.0999,17553.8,58888,6686,72,45162,45162,29688,28907,16714
43130,2212,14153,27241,15889,8.68779e+12,57.9741,16808,43130,6889,72,28977,28977,17633,4458,3834
62450,11950,29033,37946,24504,6.91608e+12,56.1465,32015.2,62450,14126,72,33417,33417,25318,17685,15715
47857,6699,11155,31040,16817,9.91463e+12,60.0762,14376.4,47857,5432,72,36702,36702,30204,24008,22342
39545,6231,9206,25650,13895,9.90628e+12,60.0516,11962.7,39545,4472,72,30339,30339,26066,25972,20948
90674,2661,30280,57170,33504,8.60305e+12,58.3213,35181.7,90674,14745,72,60394,60346,25867,12389,5740
46485,6520,15747,29276,17209,8.5614e+12,58.4026,18527.4,46485,7670,72,30738,30738,23374,14785,14510
45636,2922,13922,29005,16631,8.98825e+12,58.9375,16777.8,45636,6777,72,31714,31714,16378,11080,8281
3520,995,1289,2218,1302,8.26781e+12,49.2202,1666.59,3520,606,62,2231,2231,2231,2231,2231
8620,2687,2874,5447,3173,8.69393e+12,57.9159,3623.18,8620,1391,72,5746,5746,5552,5360,5367
41914,4653,9745,27191,14723,9.92188e+12,60.0671,12634.5,41914,4743,72,32169,32169,24720,24574,15671
38256,3161,8910,24814,13442,9.92075e+12,60.058,11589.4,38256,4333,72,29346,29346,20946,20784,10712
93583,16959,28464,59494,34089,8.99075e+12,59.007,33688.7,93583,13867,72,65119,65119,55966,53679,40560
20563,4613,4897,13320,7243,9.85672e+12,59.8765,6519.96,20563,2377,72,15666,15666,15338,15268,14980
59242,6067,20736,37185,22057,8.40455e+12,58.2457,24085.6,59242,10101,72,38506,38506,26101,16182,11029
45015,14531,22811,27014,18001,6.39425e+12,55.7282,24946.9,45015,11113,72,22204,22204,18279,13726,13762
20202,2440,8945,12349,7853,7.25033e+12,56.2184,10196.6,20202,4351,72,11257,11257,6720,4181,3327
70159,7391,16301,45491,24668,9.91291e+12,60.1202,20746.6,70159,7936,72,53858,53858,41594,39687,24933
75653,6582,17617,49058,26595,9.90599e+12,60.1164,22352.7,75653,8576,72,58036,58036,39329,25670,22264
69337,12859,22771,43786,25551,8.67129e+12,58.5945,26704.7,69337,11079,72,46566,46566,38746,29531,29367
9830,594,2367,6372,3458,9.91912e+12,59.5011,3279.06,9830,1144,72,7463,7463,4979,2111,2076
40614,19892,22087,24115,16499,5.91299e+12,54.0605,23935.2,40614,10743,72,18527,18527,17816,16862,16815
8847,2365,3087,5563,3284,8.47084e+12,55.7809,3843.5,8847,1495,72,5760,5760,4953,3845,3788
32991,643,7710,21395,11596,9.91225e+12,60.0134,10081.4,32991,3752,72,25281,25281,15008,14797,2477
83421,4288,28445,52495,30926,8.51389e+12,58.4096,32968.5,83421,13852,72,54976,54976,34666,34009,9874
82247,11767,21586,52899,29348,9.5259e+12,59.6551,26503.6,82247,10509,72,60661,60661,51299,49010,35487
60442,5630,16254,38812,21630,9.44013e+12,57.2404,20018.6,60442,7895,72,44188,44188,32344,21950,18946
6171,556,2344,3860,2311,8.09649e+12,57.0193,2901,6171,1137,72,3827,3779,2858,1821,1859
8042,1123,3439,4956,3086,7.41353e+12,56.4161,4078.51,8042,1666,72,4603,4603,3079,1300,1460
5782,322,1375,3749,2033,1.00149e+13,59.2503,1991.77,5782,664,72,4407,4407,2852,1962,1129
24664,2688,5751,16002,8662,9.92111e+12,59.9771,7630.42,24664,2794,72,18913,18913,14505,14411,9233
44495,5095,10333,28866,15629,9.92697e+12,60.0812,13369.3,44495,5029,72,34162,34162,27822,19201,17181
69634,6448,29558,42794,26840,7.43572e+12,57.0095,33027.7,69634,14393,72,40076,40076,25416,13173,9638
62808,23831,25788,38752,24056,7.62006e+12,57.2873,29034.7,62808,12558,72,37020,37020,36030,34892,35078
50254,2564,17512,31570,18684,8.42495e+12,58.2512,20442.9,50254,8530,72,32742,32742,20561,6220,5825
87880,2617,20415,56994,30886,9.90867e+12,60.1241,25801.4,87880,9931,72,67465,67465,26126,27442,9436
31632,5393,7400,20512,11120,9.9252e+12,60.0078,9691.78,31632,3600,72,24232,24232,21765,21203,17762
57343,17239,20736,35886,21457,8.24253e+12,58.0309,23950.3,57343,10090,72,36607,36607,34789,32246,31876
2583,524,1860,1463,1120,3.902e+12,50.2927,2024.95,2583,897,54,723,627,502,239,374
15369,7208,14365,10583,4786,9.21214e+12,3.9849,14424.5,15369,4805,9,1004,1004,500,1004,507
17164,1565,7446,10526,6638,7.34313e+12,44.1321,8567.16,17164,3610,72,9718,9718,7708,7671,5406
59563,1703,13890,38629,20934,9.90345e+12,60.0972,17758.6,59563,6762,72,45673,45673,27906,27551,6067
2473,222,634,1611,862,9.64557e+12,57.6256,962.375,2473,299,58,1839,1839,1259,652,721
36880,3900,9192,23806,13074,9.69846e+12,59.7897,11750.1,36880,4467,72,27688,27688,20611,20454,12027
94530,21451,41265,57889,36641,7.2792e+12,56.7874,45670.3,94530,20097,72,53265,53265,42087,26816,23200
75443,4125,22086,48127,27316,9.13579e+12,59.1715,26495.1,75443,10755,72,53357,53357,33816,10772,9863
47650,8733,11110,30902,16748,9.91601e+12,60.0705,14318.4,47650,5409,72,36540,36540,33716,29936,29111
4541,527,1094,2938,1603,1.00013e+13,59.0095,1610.03,4541,527,70,3447,3447,2622,1899,1803
33522,6557,8373,21643,11879,9.70451e+12,59.7468,10734.3,33522,4070,72,25149,25149,23043,20241,19642
15867,90,3732,10282,5585,9.92907e+12,59.8562,5057.89,15867,1818,72,12135,10816,3108,3567,499
70153,24409,29243,43219,26934,7.53052e+12,57.0682,32771.7,70153,14225,72,40910,40910,38951,36236,35818
77025,4970,34000,47106,29919,7.22699e+12,56.8126,37674.7,77025,16562,72,43025,43025,27148,8521,7943
11722,2721,2790,7600,4122,9.8806e+12,59.6904,3839.94,11722,1353,72,8932,8932,8844,8834,8829
91417,19787,27688,58150,33267,8.99896e+12,59.0166,32818.4,91417,13483,72,63729,63729,54350,45408,42940
23021,833,1503,18330,4691,5.72193e+13,12.0065,1998.7,23021,791,20,21518,21518,17367,14433,19619
47829,1149,11156,31013,16816,9.89986e+12,60.0677,14378.8,47829,5421,72,36673,36673,22165,14627,4374
62332,3340,28397,37957,24375,7.04069e+12,55.9099,31417.8,62332,13829,72,33935,33935,20343,4412,3955
36936,648,15708,22693,14243,7.42435e+12,56.9918,17772.3,36936,7642,72,21228,20652,12731,8550,2497
62067,19025,30384,37442,24625,6.59747e+12,56.0265,33238,62067,14798,72,31683,31683,26453,19352,17712
34047,6323,16873,20512,13535,6.52837e+12,55.5214,18614.9,34047,8200,72,17174,17174,12798,7773,7662
3199,645,1833,2514,685,80335100000,8.67552,1932.11,3199,1643,11,1366,1366,674,707,657
32995,3316,14035,20277,12718,7.43337e+12,56.2876,15922.6,32995,6815,72,18960,18960,11464,6420,4898
77783,14787,18095,50443,27340,9.91918e+12,60.1288,22942.4,77783,8815,72,59688,59688,55719,54795,49154
36129,5871,13574,22524,13605,8.06158e+12,57.7728,15740.9,36129,6601,72,22555,22555,16544,9465,9394
96898,14974,22530,62834,34064,9.9107e+12,60.1373,28385.3,96898,10964,72,74368,74368,65299,63177,49990
51489,5633,18787,32185,19304,8.20371e+12,57.9956,21719.5,51489,9141,72,32702,32702,22338,10083,9787
36929,4688,8596,23949,12980,9.91613e+12,60.0653,11203,36929,4182,72,28333,28333,23645,17297,15824
5380,711,1743,3414,1966,8.96897e+12,57.7169,2276.85,5380,841,72,3637,3637,2743,2490,2409
37248,9182,13084,23387,13861,8.3833e+12,57.7092,15373.4,37248,6354,72,24164,24164,21566,18607,18564
66077,1944,15382,42857,23220,9.90669e+12,60.1042,19605.4,66077,7484,72,50695,50695,19432,20445,6942
77885,15735,23966,49475,28410,8.94411e+12,58.9292,28413.7,77885,11668,72,53919,53919,47880,46343,37768
68851,17821,24027,43231,25620,8.4108e+12,58.2824,27836.7,68851,11704,72,44824,44824,39592,33490,33340
45087,12366,13058,28791,16296,9.18589e+12,59.1689,15936.4,45087,6356,72,32029,32029,31709,31606,31388
17381,3308,4083,11268,6113,9.92976e+12,59.8335,5504.9,17381,1987,72,13298,13298,12373,12159,10979
73897,14610,29221,45798,28099,7.81342e+12,57.5391,33017.8,73897,14233,72,44676,44676,35205,24168,23769
4321,1961,2035,2625,1696,6.99642e+12,55.2398,2416.58,4321,986,62,2286,2286,2191,2163,2182
74451,13869,21680,47508,26943,9.15083e+12,59.1905,26051.2,74451,10549,72,52771,52771,44077,43860,33499
18867,4268,4434,12238,6629,9.89287e+12,59.8298,5951.3,18867,2149,72,14433,14433,14227,14221,14107
93716,8811,27684,59733,33983,9.10071e+12,59.1118,32971.2,93716,13469,72,66032,66032,42369,25662,20090
65045,1734,28395,39837,25208,7.27955e+12,56.4613,31617.4,65045,13824,72,36650,36650,17755,3877,3086
94449,12970,21962,61254,33195,9.91068e+12,60.1407,27690.7,94449,10697,72,72487,72487,61721,59195,43513
44639,12497,16396,27893,16746,8.16548e+12,57.9208,18995.2,44639,7973,72,28243,28243,26728,24926,25086
63312,10960,14666,41066,22246,9.92674e+12,60.139,18745.9,63312,7144,72,48646,48646,44190,43154,36786
44748,8999,10450,29018,15730,9.89628e+12,60.0614,13499.2,44748,5081,72,34298,34298,32173,32133,29721
49920,7647,13404,32056,17864,9.465e+12,59.5198,16609.6,49920,6530,72,36516,36516,30651,29252,20844
70126,3826,16299,45483,24643,9.91751e+12,60.1203,20740.6,70126,7936,72,53827,53827,27578,27703,13263
93337,8200,24602,60014,33323,9.50723e+12,59.3231,30078.1,93337,11962,72,68735,68735,45150,45134,26022
90047,7673,26911,57329,32718,9.0601e+12,59.0868,31999.3,90047,13105,72,63136,63088,46470,33410,26013
17341,4029,5097,11059,6282,9.13465e+12,58.924,6434.39,17341,2473,72,12244,12244,11680,11654,11165
29939,5837,11565,18614,11325,7.93624e+12,57.1513,13402.2,29939,5616,72,18374,18374,14527,9319,8135
81835,20192,37624,49783,32052,6.99126e+12,56.5231,41381.9,81835,18329,72,44211,44211,36697,26347,24090
82376,14997,19148,53426,28950,9.91415e+12,60.1296,24241.3,82376,9325,72,63228,63228,57181,51426,49868
30188,7024,7071,19583,10605,9.90173e+12,59.9881,9279.49,30188,3438,72,23117,23117,23077,23075,23081
31758,11514,11844,19808,11950,8.13383e+12,57.8075,13799.8,31758,5770,72,19914,19914,19445,19059,19055
51967,10937,15401,33116,18851,9.1085e+12,59.0896,18610.4,51967,7502,72,36566,36566,31430,26579,25287
55007,14534,17884,34777,20230,8.72139e+12,58.3516,21136.7,55007,8695,72,37123,37123,34045,29905,28977
6692,1176,1584,4346,2346,9.92642e+12,59.3891,2274.61,6692,764,72,5108,5108,4521,4510,3972
59283,5855,13825,38444,20839,9.91182e+12,60.0961,17675.7,59283,6728,72,45458,45458,33567,32117,19687
74907,2982,20356,48058,26849,9.41331e+12,59.5033,24846.7,74907,9917,72,54551,54551,22526,12417,6601
41340,9630,11893,26412,14928,9.21498e+12,59.1998,14578.4,41340,5793,72,29447,29447,26839,24394,23824
55447,4631,12897,35959,19488,9.91174e+12,60.0845,16540.3,55447,6279,72,42550,42550,28153,18127,15782
53660,16742,21160,33272,20388,7.82942e+12,57.2786,24074.3,53660,10291,72,32500,32500,30069,26829,26112
45885,4862,10711,29754,16131,9.91076e+12,60.0568,13819.9,45885,5208,72,35174,35174,27233,26016,16481
69642,10430,30209,42683,26959,7.31265e+12,56.9285,33632.5,69642,14708,72,39433,39433,27059,12661,12114
73805,4244,18855,47560,26245,9.61549e+12,59.7575,23375,73805,9180,72,54950,54950,36153,35696,13139
85489,26826,27199,54143,31346,8.80607e+12,58.7744,31953.7,85489,13244,72,58290,58290,57837,57303,57262
58263,2178,13535,37792,20471,9.91018e+12,60.1053,17337.5,58263,6584,72,44728,44728,19038,8595,7908
26734,3414,7630,17095,9639,9.23803e+12,59.1744,9528.3,26734,3711,72,19104,19104,14065,9262,8018
48231,552,11257,31278,16953,9.89971e+12,60.06,14499.7,48231,5470,72,36974,36974,21435,21116,2355
77125,7209,17952,50015,27110,9.9137e+12,60.1292,22765.8,77125,8742,72,59173,59173,42122,40538,24393
26111,3778,6144,16926,9185,9.88253e+12,59.9409,8106.58,26111,2988,72,19967,19967,16586,13374,12597
7121,785,1746,4614,2507,9.88566e+12,59.2414,2458.64,7121,846,72,5375,5375,4018,3809,2407
8893,2327,4849,5283,3610,5.93729e+12,50.3219,5432.05,8893,2339,72,4044,4044,2977,1536,1422
26421,4759,8876,16652,9769,8.59534e+12,58.1552,10648.9,26421,4311,72,17545,17545,14714,10915,10076
74251,18859,25185,46756,27495,8.53324e+12,58.4274,29293.7,74251,12264,72,49066,49066,44421,38017,36709
16702,1639,3935,10835,5867,9.89198e+12,59.8193,5314.94,16702,1910,72,12767,12767,9418,6408,5612
39824,9502,12245,25310,14514,8.95292e+12,58.867,14791.8,39824,5961,72,27579,27579,25239,22003,21464
37657,3732,8773,24419,13238,9.90546e+12,60.0434,11421.3,37657,4258,72,28884,28884,21316,20437,12612
34236,14161,16239,20751,13485,6.8155e+12,55.7629,18045.2,34236,7894,72,17997,17997,17142,15945,15895
66113,5383,28264,40596,25517,7.39386e+12,57.0211,31572.9,66113,13758,72,37849,37849,22323,12396,9348
39914,6396,10756,25626,14288,9.45876e+12,59.4853,13418.8,39914,5238,72,29158,29158,24612,23534,17068
42615,3150,9957,27627,14988,9.91182e+12,60.055,12882.3,42615,4845,72,32658,32658,22770,11130,10713
20883,1699,4876,13539,7344,9.92982e+12,59.9429,6522.58,20883,2369,72,16007,16007,10322,6712,5901
5103,791,1228,3316,1787,1.00122e+13,59.0896,1788.74,5103,591,72,3875,3875,3261,2739,2678
43819,7751,10245,28413,15406,9.89879e+12,60.0449,13237.4,43819,4981,72,33574,33574,30641,29944,25806
85631,27410,29894,53773,31858,8.40527e+12,58.2796,34469.2,85631,14555,72,55737,55737,54505,53147,53188
45864,9140,10706,29741,16123,9.91224e+12,60.0717,13814.6,45864,5208,72,35158,35158,33260,30730,30193
32644,1122,7622,21168,11476,9.91327e+12,60.0232,9977.31,32644,3707,72,25022,25022,15593,15397,4095
46682,5980,13677,29771,16911,9.14556e+12,59.1275,16625.7,46682,6663,72,33005,33005,24383,24478,14589
65510,14657,15238,42478,23032,9.92287e+12,60.1191,19426,65510,7422,72,50272,50272,49421,49404,48567
32131,4785,7512,20836,11295,9.91249e+12,60.0049,9833.81,32131,3654,72,24619,24619,20686,20601,16018
69241,11956,16089,44903,24338,9.91317e+12,60.1282,20487.7,69241,7830,72,53152,53152,48183,41436,39883
99485,30975,32655,62834,36651,8.67992e+12,58.5303,37996.6,99485,15891,72,66830,66830,64762,62402,62388
41713,13430,18872,25427,16286,7.08436e+12,55.8731,21059.9,41713,9188,72,22841,22841,20385,17116,16400
37307,3194,15822,22933,14374,7.46427e+12,57.0098,17900.1,37307,7708,72,21485,21485,13061,3146,2953
20655,1508,6423,13112,7543,8.96023e+12,58.7043,7920.55,20655,3129,72,14232,14232,8890,3476,2777
70136,24509,25543,43858,26278,8.21624e+12,58.0262,29332.9,70136,12439,72,44593,44593,43433,42075,42252
3361,918,1211,2118,1243,8.6125e+12,56.6932,1575.03,3361,589,62,2150,2150,1842,1511,1637
4441,994,1944,2730,1711,7.54099e+12,55.8548,2349.52,4441,945,72,2497,2449,2177,1724,1855
17484,2636,6624,10888,6596,8.08512e+12,57.6055,7840.36,17484,3226,72,10860,10860,7989,4738,4674
88149,35315,36267,54376,33773,7.60799e+12,57.2975,40570.4,88149,17667,72,51882,51882,50717,49217,48929
66756,20427,23556,41864,24892,8.36639e+12,58.2111,27246.4,66756,11470,72,43200,43200,40746,37960,37931
88182,15955,20541,57177,31005,9.90684e+12,60.122,25937.1,88182,10004,72,67641,67641,62208,60929,53139
12498,3240,3935,7936,4562,8.92596e+12,58.4617,4948.19,12498,1914,72,8563,8563,7905,6986,7009
18490,519,11116,10801,7689,5.15892e+12,51.9311,12024.3,18490,5393,72,7374,6894,3817,1574,1372
57055,5366,13307,36997,20058,9.91077e+12,60.0966,17037,57055,6481,72,43748,43748,32184,31952,18027
91068,3824,21126,59058,32010,9.91862e+12,60.1437,26682.3,91068,10284,72,69942,69942,31464,32272,13580
59016,20442,28308,35695,23321,6.72449e+12,55.543,31093.6,59016,13768,72,30708,30708,26973,21816,20806
15762,657,6324,9757,6005,7.78005e+12,57.2261,7418.65,15762,3077,72,9438,9363,5981,4069,1945
3371,125,892,2179,1192,9.60133e+12,58.1652,1300.07,3371,423,63,2479,2432,953,957,449
85750,19309,34625,53004,32746,7.70663e+12,57.42,38877.2,85750,16868,72,51125,51125,41396,28136,25006
50083,8884,11668,32474,17609,9.90771e+12,60.0714,15015.8,50083,5674,72,38415,38415,34421,30638,29649
69416,35566,35673,41568,27848,6.2895e+12,55.6384,38675.8,69416,17372,72,33743,33743,33643,33582,33580
80482,4397,27385,50654,29828,8.52154e+12,58.4195,31775.6,80482,13335,72,53097,53097,31814,14984,9721
69488,3213,16138,45060,24428,9.92672e+12,60.1287,20544.6,69488,7861,72,53350,53350,34585,34196,11526
58195,12613,13581,37731,20464,9.89252e+12,60.0737,17374.3,58195,6601,72,44614,44614,43460,43192,41671
31803,6320,7438,20624,11179,9.9254e+12,60.0118,9739.49,31803,3619,72,24365,24365,22714,21169,20869
97385,5195,47933,58681,38704,6.55863e+12,55.7402,52071.9,97385,23329,72,49452,49452,22530,10236,4970
84840,18896,19713,55017,29823,9.91066e+12,60.1312,24936.9,84840,9598,72,65127,65127,64136,63906,62640
10893,374,3854,6831,4062,8.44283e+12,53.5746,4729.5,10893,1871,72,7039,6991,3955,1212,0
96945,2641,4713,76881,20064,5.8164e+13,12.0015,5744.44,96945,3689,20,92232,92232,75138,60666,84582
53467,14377,18767,33562,19905,8.37812e+12,58.207,21845.3,53467,9131,72,34700,34700,28721,21700,21509
23702,8294,10694,14459,9243,7.11407e+12,56.057,12096.5,23702,5203,72,13008,13008,11819,10165,10008
5844,1724,2136,3657,2187,8.45015e+12,57.237,2676.84,5844,1040,72,3708,3708,3108,3094,2563
50487,4561,12936,32535,17952,9.61187e+12,59.7028,16218,50487,6292,72,37551,37551,25532,24612,14066
89664,4116,5687,71406,18258,5.72641e+13,11.9979,6663.84,89664,3661,14,83977,83977,73865,66496,79414
28004,4568,7827,17933,10071,9.34568e+12,59.2731,9801.97,28004,3813,72,20177,20177,16673,16577,12543
14154,1655,6933,11049,3105,78552200000,8.98806,7177.85,14154,6237,11,7221,7221,3025,3543,2528
60274,32204,36722,35073,25201,5.05819e+12,53.6191,38965,60274,17884,72,23552,23552,21694,19124,18747
77872,14926,20436,50088,27784,9.53064e+12,59.6575,25127.6,77872,9954,72,57436,57436,51293,42939,40998
6568,1477,1566,4264,2304,9.85539e+12,59.2706,2245.79,6568,748,72,5002,5002,4922,4904,4886
58289,14468,26144,35579,22710,7.12975e+12,56.6772,29033,58289,12732,72,32145,32145,26875,21945,20655
68094,13117,15878,44148,23946,9.90503e+12,60.066,20209.7,68094,7719,72,52216,52216,48925,44493,43491
86819,12864,23965,55632,31187,9.34478e+12,59.4327,29034,86819,11666,72,62854,62854,52195,49579,34191
60474,5874,26550,37004,23470,7.25003e+12,56.8376,29570.6,60474,12933,72,33924,33924,22123,8403,7890
7715,981,2757,4843,2872,8.42565e+12,57.5698,3428.18,7715,1342,72,4958,4910,2672,1716,1507
61527,874,14266,39906,21621,9.93779e+12,60.1203,18241.6,61527,6949,72,47261,47261,14560,3398,3618
5838,86,1492,3775,2063,9.62916e+12,58.8751,2104.7,5838,712,72,4346,3832,1130,135,306
49730,4883,11578,32250,17480,9.93198e+12,60.0924,14902.1,49730,5640,72,38152,38152,28433,28230,16583
34016,2081,12400,21266,12750,8.21181e+12,50.3438,14495,34016,6026,72,21616,21616,12132,820,0
74959,2781,17460,48606,26353,9.90674e+12,60.1124,22155.2,74959,8502,72,57499,57499,24284,25171,9829
41056,8398,11848,26213,14843,9.2095e+12,59.1967,14517.7,41056,5771,72,29208,29208,25643,25550,21437
73246,16337,24285,46214,27032,8.64239e+12,58.5484,28380.4,73246,11831,72,48961,48961,45725,41252,40419
30162,8468,9236,19169,10993,8.9785e+12,57.346,11276.9,30162,4493,72,20926,20926,20313,19453,19488
96966,20831,37378,60262,36704,7.93939e+12,57.7082,42219.9,96966,18204,72,59588,59588,47112,33045,32000
97149,26487,28391,61979,35170,9.14002e+12,59.1885,33864.2,97149,13827,72,68758,68758,66706,63867,63425
30004,1583,13135,18380,11624,7.26626e+12,56.7691,14854.5,30004,6392,72,16869,16869,10313,2645,2547
81073,2521,18864,52575,28498,9.90201e+12,60.1112,23887.7,81073,9177,72,62209,62209,38396,37920,9038
41598,10278,19734,25202,16396,6.79687e+12,54.5969,21849.1,41598,9591,72,21864,21864,17565,11747,10409
23074,1322,1379,18355,4719,5.75177e+13,11.9912,1869.7,23074,952,14,21695,21695,21266,20924,21502
45799,1137,17614,28475,17324,7.95843e+12,57.6597,20206.1,45799,8575,72,28185,28137,17352,9171,4161
40955,9352,17375,25175,15780,7.44418e+12,56.3482,19622.6,40955,8442,72,23580,23580,20060,15960,16018
75454,14169,23491,47878,27576,8.89373e+12,58.8838,27806.4,75454,11440,72,51963,51963,43766,34210,33872
59320,13316,21689,37069,22251,8.19745e+12,57.5183,24979.6,59320,10560,72,37631,37631,32144,24694,22981
24623,5227,11349,14981,9642,6.98632e+12,54.5026,12773.7,24623,5512,72,13274,13274,10136,7191,6492
10849,2184,2589,7032,3817,9.89051e+12,59.6561,3577.88,10849,1256,72,8260,8260,7691,7185,7173
38275,12236,15576,23654,14621,7.65419e+12,57.2755,17753.4,38275,7576,72,22699,22699,21115,19019,18592
52946,7747,19162,33134,19812,8.23545e+12,58.0305,22172.7,52946,9323,72,33784,33736,19424,6757,3203
65328,14885,19095,41681,23647,9.1382e+12,59.1539,23001.7,65328,9290,72,46233,46233,42212,37536,37421
20743,5488,8135,12874,7869,7.88261e+12,57.3997,9500.27,20743,3956,72,12608,12608,10987,8862,8440
16507,1508,3879,10705,5802,9.90544e+12,59.883,5250.66,16507,1883,72,12628,12628,8668,8342,4957
26008,206,6115,16864,9144,9.91039e+12,59.9475,8070.23,26008,2974,72,19893,19893,11338,7289,938
88247,4366,20541,57216,31031,9.91389e+12,60.1319,25939.6,88247,10007,72,67706,67706,44224,43737,15330
14317,8276,8293,8415,5902,5.47244e+12,50.553,9075.12,14317,4017,72,6024,6024,6024,6024,6024
20052,6853,7106,12588,7464,8.3596e+12,57.7156,8501.55,20052,3457,72,12946,12946,12595,12272,12341
65733,15240,36438,51577,14156,80063200000,8.99699,36933.1,65733,32789,11,29295,29295,16839,17458,16236
63316,22999,27288,38837,24479,7.36164e+12,56.9634,30458.2,63316,13294,72,36028,36028,34185,31729,31262
74950,4809,22428,47730,27220,9.04826e+12,59.065,26780.1,74950,10922,72,52522,52522,34585,13438,12599
34193,681,9772,21862,12331,9.21554e+12,59.1694,12081.4,34193,4744,72,24421,24277,8981,9365,2412
92171,1426,21379,59783,32388,9.92309e+12,60.1525,26991.5,92171,10414,72,70792,70792,22377,5617,5807
4036,182,971,2620,1416,1.0126e+13,58.8593,1442.63,4036,473,67,3065,3065,1906,1885,668
61482,13045,14316,39861,21621,9.91742e+12,60.1097,18288.8,61482,6967,72,47166,47166,45703,45352,43424
6932,910,1654,4505,2427,9.87005e+12,59.3113,2360.84,6932,795,72,5278,5278,4205,4184,3046
90344,18214,21812,58450,31894,9.79701e+12,59.7903,27270.9,90344,10608,72,68532,68532,64602,59297,58094
4627,1368,1782,2887,1740,8.09831e+12,56.6032,2227.85,4627,864,70,2845,2845,2633,2315,2459
86022,25169,27409,54471,31551,8.81076e+12,58.7654,32180.1,86022,13352,72,58613,58613,56385,54331,53833
95922,14172,24530,61813,34109,9.60622e+12,59.7703,30186.6,95922,11943,72,71392,71392,60339,45238,41641
35712,8544,10227,22823,12889,9.22084e+12,59.1759,12617,35712,4971,72,25485,25485,23972,21971,21559
6295,1798,3101,3809,2486,6.62946e+12,55.169,3588.52,6295,1500,72,3194,3194,2662,2040,2251
22501,968,5971,14472,8029,9.53721e+12,59.4674,7659.17,22501,2907,72,16530,16530,10602,4249,3469
90151,5731,20916,58464,31687,9.91872e+12,60.1462,26424.2,90151,10183,72,69235,69235,38794,38515,19875
27980,2365,8727,17759,10221,8.92769e+12,58.7615,10630.5,27980,4250,72,19253,19253,11642,6629,5105
5706,2264,3274,4485,1221,8.0503e+10,8.94585,3408.75,5706,2939,11,2432,2432,1865,1887,1861
53765,3688,13091,34769,18996,9.76779e+12,59.909,16601.1,53765,6363,72,40674,40674,23157,22863,11774
6707,1501,1638,4343,2364,9.90318e+12,59.3147,2322.35,6707,798,72,5069,5069,4907,4781,4790
45613,1762,14912,28821,16792,8.70038e+12,57.9929,17695.5,45613,7258,72,30701,30701,14148,2878,2223
76825,27356,33721,47019,29806,7.24964e+12,56.8412,37404.2,76825,16418,72,43104,43104,40635,37754,37866
42572,5051,11732,27291,15281,9.36189e+12,59.3803,14522.7,42572,5709,72,30840,30840,23039,23260,14508
38388,7553,11818,24380,14008,8.96228e+12,58.875,14289.6,38388,5751,72,26570,26570,22670,17399,16213
32550,7976,8022,21029,11521,9.76286e+12,59.8244,10334,32550,3907,72,24528,24528,24471,24468,24471
4504,957,1088,2919,1585,9.83367e+12,58.7784,1601.81,4504,517,69,3416,3416,3290,3186,3182
84165,18986,46446,49828,34337,5.78779e+12,55.0347,49745.4,84165,22612,72,37719,37719,28258,17257,17012
53115,3599,18630,33328,19787,8.40132e+12,58.0611,21690.4,53115,9069,72,34485,34485,21536,11634,8520
26165,7277,10401,16214,9951,7.80067e+12,57.3403,12026.8,26165,5063,72,15764,15764,13272,10376,10489
35506,7563,11580,22435,13071,8.72239e+12,58.5761,13849.8,35506,5637,72,23926,23926,20818,20044,15713
58988,14560,15198,37987,21001,9.58622e+12,59.7074,18933.1,58988,7393,72,43790,43790,43138,42967,42196
5427,2669,5427,0,5427,7.99853,0,5427,5427,5427,1,0,0,0,0,0
79090,613,18348,51302,27788,9.91693e+12,60.1312,23271.2,79090,8929,72,60742,60742,16691,18920,2938
98036,12114,27333,62767,35269,9.3121e+12,59.0593,32943.8,98036,13309,72,70703,70703,52918,51997,30122
78282,10276,21411,50203,28079,9.37748e+12,59.4751,26068,78282,10424,72,56871,56871,43271,42940,26635
39833,183,9269,25836,13997,9.92003e+12,60.0572,12038.3,39833,4509,72,30564,30564,7795,8992,1026
99071,4908,42169,60854,38217,7.42117e+12,56.6376,46826.5,99071,20538,72,56902,56902,28711,12245,6127
64004,4259,23651,39959,24045,8.14303e+12,57.8882,27141.1,64004,11500,72,40353,40353,25012,6952,6401
70026,18696,26732,43574,26452,7.98201e+12,57.7435,30431.2,70026,13012,72,43294,43294,39046,33282,31970
60658,18322,20428,38225,22433,8.56414e+12,58.4526,23907.6,60658,9945,72,40230,40230,38713,36935,37095
59497,33146,38544,46653,12844,2.23422e+13,5.52762,44182.1,59497,12853,13,20953,20953,20201,20953,18410
52808,8604,12274,34238,18570,9.92313e+12,60.1151,15774.1,52808,5979,72,40534,40534,36128,30167,28795
43089,16597,17499,26619,16470,7.68484e+12,57.3195,19895,43089,8525,72,25590,25590,24277,22813,22829
5612,1365,2726,3393,2219,6.67827e+12,55.1971,3180.75,5612,1315,72,2886,2886,1889,788,836
37900,7343,8888,24569,13331,9.88684e+12,59.9436,11546.1,37900,4308,72,29012,29012,27236,26821,24385
64365,18254,29094,39237,25128,7.08513e+12,56.6011,32211.8,64365,14168,72,35271,35271,29970,22656,21135
12750,1509,3186,8238,4512,9.75168e+12,59.5147,4288.32,12750,1548,72,9564,9564,7093,7048,4229
51791,8573,12046,33577,18214,9.92064e+12,60.1063,15489.5,51791,5865,72,39745,39745,34711,29936,28662
12301,4434,4600,7675,4626,8.16875e+12,57.5619,5535.69,12301,2240,72,7701,7701,7511,7344,7349
89355,8592,23319,57486,31869,9.54958e+12,59.6907,28606.6,89355,11356,72,66036,66036,41546,25875,20434
18164,2345,8898,14179,3985,78604200000,8.98805,9176.51,18164,8005,11,9266,9266,4061,4703,3438
56872,214,13217,36888,19984,9.92277e+12,60.1038,16939.9,56872,6435,72,43655,43655,11016,12755,1314
55853,16633,24080,34260,21593,7.34928e+12,56.8581,26944.1,55853,11719,72,31773,31773,27389,23214,22252
71374,9017,18903,45878,25496,9.49754e+12,59.603,23247.9,71374,9206,72,52471,52471,41882,39984,25368
44032,9989,19293,26965,17067,7.26253e+12,56.7911,21623.8,44032,9389,72,24739,24739,19935,14293,14285
88856,28353,30809,55830,33026,8.43409e+12,58.1917,35548.4,88856,14987,72,58047,58047,56712,54855,54645
5472,2187,2520,3338,2134,7.08158e+12,55.3109,2979.53,5472,1217,72,2952,2952,2538,2141,2260
56011,15656,18266,35405,20606,8.697e+12,58.6046,21565.8,56011,8887,72,37745,37745,36323,34727,34759
72968,13683,35191,44098,28870,6.68758e+12,56.1535,38491.4,72968,17139,72,37777,37777,29036,18942,18595
52270,6943,18842,32721,19549,8.26837e+12,58.0032,21824.5,52270,9161,72,33428,33428,25040,15238,14930
28519,3926,11649,17612,10907,7.67901e+12,57.0667,13362.1,28519,5675,72,16870,16870,11532,7885,6718
1708,742,984,1015,693,5.98155e+12,32.26,1150.93,1708,462,49,724,724,724,724,724
56837,9033,21867,35326,21511,7.96105e+12,57.6917,24960.5,56837,10653,72,34970,34970,25266,13828,13569
97658,11364,22639,63336,34322,9.91794e+12,60.1511,28539,97658,11023,72,75019,75019,61417,42713,38407
98059,6655,22724,63601,34458,9.91782e+12,60.1554,28649.8,98059,11062,72,75335,75335,51911,51442,23053
85821,7260,29964,53882,31939,8.40324e+12,58.278,34548.1,85821,14592,72,55857,55857,37188,15170,14449
52046,9060,21126,32167,19879,7.67964e+12,57.2406,23923,52046,10280,72,30920,30920,23381,15637,13577
37259,11795,11811,23607,13652,8.82274e+12,58.7137,14200.3,37259,5740,72,25448,25448,25448,25448,25448
13273,2660,4166,8416,4857,8.9077e+12,58.5469,5230.87,13273,2027,72,9107,9107,7569,5758,5919
62634,1962,14585,40621,22013,9.91409e+12,60.1051,18619,62634,7103,72,48049,48049,29736,19848,7231
31110,8963,9894,19711,11399,8.81458e+12,58.6754,11958.1,31110,4809,72,21216,21216,20092,18635,18362
16874,11596,15773,11630,5244,9.19791e+12,3.98015,15835.5,16874,5280,9,1101,1101,808,1101,815
63048,5908,14626,40891,22157,9.9144e+12,60.115,18690.7,63048,7110,72,48422,48422,35727,35473,20169
42247,3021,9818,27405,14842,9.91766e+12,60.0679,12727.6,42247,4776,72,32429,32429,19499,19166,10524
18314,3745,6345,11512,6802,8.48613e+12,58.1264,7654.12,18314,3090,72,11969,11969,9456,7083,6546
84979,20442,38042,51874,33105,7.13524e+12,56.6747,42002.2,84979,18526,72,46937,46937,35609,22394,21916
8965,766,2835,5692,3273,8.89788e+12,58.1107,3622,8965,1377,72,6130,6082,3475,360,464
14965,632,6954,9099,5866,6.94278e+12,55.3464,7922.05,14965,3365,72,8011,7867,3732,1737,1229
92995,18697,27954,59186,33809,9.03845e+12,59.0539,33170.3,92995,13615,72,65041,65041,57765,47745,45566
17410,1944,5443,11049,6361,8.90263e+12,58.638,6756.87,17410,2643,72,11967,11967,8724,7052,6602
49521,3407,11541,32118,17403,9.90548e+12,60.0738,14856.3,49521,5616,72,37980,37980,26121,18154,11605
92370,31460,47384,55328,37042,6.28785e+12,55.5796,51205.2,92370,23062,72,44986,44986,38751,30274,28304
17638,2879,17638,0,17638,7.99955,0,17638,17638,17638,1,0,0,0,0,0
18697,476,5677,11897,6800,9.01844e+12,57.6091,7081.8,18697,2757,72,13020,12972,7318,2546,0
20341,2934,6658,12857,7484,8.70828e+12,58.3519,8118.01,20341,3222,72,13683,13683,10419,6571,6641
66517,4967,15471,43134,23383,9.92206e+12,60.1193,19714.5,66517,7537,72,51046,51046,31546,30839,17049
13079,2453,3621,8391,4688,9.37641e+12,59.0762,4715.62,13079,1758,72,9458,9458,7733,6127,5799
47891,3727,13755,30598,17293,9.21116e+12,59.1965,16787.6,47891,6692,72,34136,34136,23132,14803,9682
27607,6001,14963,21641,5966,7.9766e+10,8.9077,15287,27607,13458,11,12644,12644,6744,7218,6287
43527,176,11141,28052,15475,9.61305e+12,59.6952,14045.9,43527,5416,72,32386,32173,18299,11737,1049
20229,18434,20229,0,20229,7.9996,0,20229,20229,20229,1,0,0,0,0,0
77167,1740,20476,49591,27576,9.49079e+12,59.6139,25119.1,77167,9975,72,56691,56691,34241,16266,6676
7696,2413,2965,4795,2901,7.96811e+12,57.0712,3617.74,7696,1432,72,4731,4731,3947,3107,3147
25474,418,5985,16514,8960,9.89548e+12,59.9717,7913.14,25474,2909,72,19489,19489,6198,1618,1727
81210,9501,18868,52656,28554,9.92006e+12,60.1429,23902.1,81210,9191,72,62342,62342,48757,48474,32118
3297,654,814,2144,1153,9.98691e+12,58.33,1218.61,3297,392,63,2483,2483,2296,2254,2144
47706,10042,23862,28684,19022,6.4622e+12,55.4771,26129.8,47706,11608,72,23844,23844,18321,12102,10692
74964,8188,19789,48205,26759,9.50473e+12,59.6214,24326.8,74964,9631,72,55175,55175,40889,40545,23400
43963,10371,11261,28332,15631,9.6081e+12,59.705,14193.5,43963,5478,72,32702,32702,31538,30421,30339
60442,12300,22240,37747,22695,8.17195e+12,57.9577,25571.3,60442,10828,72,38202,38202,29651,19572,19369
56103,312,2349,44415,11688,5.85707e+13,11.997,3128.17,56103,2346,13,53754,53754,35442,19195,45610
59157,16640,22348,36856,22301,8.03769e+12,57.6748,25578.9,59157,10882,72,36809,36809,33066,29517,28735
84381,3946,20750,54526,29855,9.73913e+12,59.9183,25871.8,84381,10105,72,63631,63631,28871,29420,11877
29752,18301,19276,23330,6422,2.23395e+13,5.52161,22125.3,29752,6429,13,10476,10476,10340,10476,10020
55493,8176,16421,35376,20117,9.09523e+12,58.3908,19816.6,55493,7979,72,39072,39072,32138,23959,23840
95663,19342,32329,60258,35405,8.55201e+12,58.4641,37430.6,95663,15746,72,63334,63334,51533,35406,31584
26838,9836,14951,15881,10957,5.73303e+12,54.833,16257.2,26838,7275,72,11887,11887,9891,7564,7700
19288,3013,5083,12409,6879,9.53685e+12,59.4625,6585.05,19288,2470,72,14205,14205,11257,7824,7821
83612,19828,34491,51570,32042,7.58803e+12,57.2681,38603,83612,16795,72,49121,49121,41459,32479,32324
70873,8672,31585,43291,27582,7.16156e+12,56.5205,34998.8,70873,15367,72,39288,39288,27496,16371,13266
60117,17390,27165,36657,23460,7.08296e+12,55.914,30116.6,60117,13211,72,32952,32952,27112,21552,20190
17960,9808,17960,0,17960,7.99955,0,17960,17960,17960,1,0,0,0,0,0
88592,629,21375,57315,31277,9.80485e+12,60.0016,26742,88592,10412,72,67217,67217,38204,24339,2463
45699,10311,10954,29577,16122,9.8392e+12,59.9717,14031.3,45699,5336,72,34745,34745,33958,32972,32822
38413,8597,9001,24905,13508,9.91333e+12,60.032,11683.3,38413,4382,72,29412,29412,28931,28905,28544
29392,4944,6818,19070,10322,9.96663e+12,60.034,8980.02,29392,3320,72,22574,22574,20277,19751,16560
63249,7063,63249,0,63249,7.99987,0,63249,63249,63249,1,0,0,0,0,0
54425,4131,19463,34101,20324,8.30354e+12,58.1123,22559.1,54425,9477,72,34962,34962,23494,10042,9571
91105,1970,25348,58334,32771,9.32257e+12,59.416,30616.9,91105,12344,72,65757,65757,27718,24771,7302
36070,6641,13498,22503,13567,8.09039e+12,57.7991,15664.6,36070,6571,72,22572,22572,17091,10657,10593
96762,20262,22420,62749,34013,9.9217e+12,60.1567,28274.9,96762,10919,72,74342,74342,71695,68141,67365
14885,2426,3529,9657,5228,9.879e+12,59.7558,4790.1,14885,1708,72,11356,11356,9867,9821,8205
16492,1648,3876,10694,5798,9.91438e+12,59.8554,5244.58,16492,1882,72,12616,12616,9318,6597,5429
47394,5842,15230,29994,17400,8.76875e+12,58.3689,18123.3,47394,7398,72,32164,32164,23815,15907,13719
28005,697,6513,18164,9841,9.9136e+12,59.9975,8597.9,28005,3156,72,21492,21492,7716,8241,2638
45773,8146,12628,29334,16439,9.37664e+12,59.3927,15586.3,45773,6151,72,33145,33145,27922,27780,21691
19244,3633,8334,11804,7440,7.34609e+12,56.4579,9559.28,19244,4051,72,10910,10910,8279,5193,5296
69430,9634,22156,43972,25458,8.7965e+12,58.7463,26136.5,69430,10792,72,47274,47274,40380,40245,32028
61972,21378,31228,37229,24743,6.40839e+12,55.7823,34014.4,61972,15197,72,30744,30744,24864,18050,17852
16448,825,7957,9945,6503,6.73052e+12,55.9021,8964.01,16448,3876,72,8491,8377,5463,3672,1984
52820,11436,15236,33735,19085,9.19009e+12,59.2119,18525.7,52820,7412,72,37584,37584,33841,28785,27647
75610,14633,23895,47908,27702,8.83039e+12,58.7981,28190.9,75610,11632,72,51715,51715,46873,45708,38800
80916,8570,18747,52475,28441,9.92815e+12,60.1499,23767.4,80916,9133,72,62169,62169,48297,33013,29017
32278,6363,17674,19140,13138,5.85721e+12,53.904,19210.3,32278,8587,72,14604,14604,9853,4317,4312
43631,11647,15674,27327,16304,8.27592e+12,58.0591,18251.7,43631,7629,72,27957,27957,25162,21955,21915
18781,3981,4411,12177,6604,9.88544e+12,59.8552,5926.43,18781,2132,72,14370,14370,13779,13767,13224
9328,130,5014,5556,3772,6.02579e+12,54.8484,5624.99,9328,2434,72,4314,4077,2438,1340,390
30105,3452,14652,18167,11938,6.65702e+12,56.0132,16253.8,30105,7138,72,15453,15453,9678,5359,4190
58227,1243,18138,36946,21281,8.89243e+12,58.6809,21609.1,58227,8824,72,40089,40089,23758,11144,3789
11855,136,3733,7526,4329,8.9313e+12,58.4431,4705.94,11855,1813,72,8122,7986,4627,2551,513
77022,5180,30500,47722,29300,7.80598e+12,57.5361,34428.2,77022,14858,72,46522,46522,29741,9958,9286
57442,3891,13404,37246,20196,9.91318e+12,60.0819,17151.7,57442,6525,72,44038,44038,30265,29978,13376
83635,26922,36044,51301,32334,7.35172e+12,56.9863,40049.7,83635,17555,72,47591,47591,43149,37968,37965
8148,3253,3631,4990,3158,7.26353e+12,56.2504,4258.92,8148,1767,72,4517,4517,3970,3416,3475
20473,1723,10448,16007,4466,79039700000,8.98769,10737.6,20473,9395,11,10025,10025,3613,4297,2948
44434,15620,16552,27728,16706,8.11345e+12,57.8554,19122.3,44434,8057,72,27882,27882,27395,26915,26978
64646,11822,25253,40121,24525,7.87763e+12,57.1737,28668.7,64646,12287,72,39393,39393,30707,20559,20250
64216,9078,14950,41647,22569,9.91082e+12,60.112,19071.5,64216,7278,72,49266,49266,40788,32685,30470
1997,264,524,1292,705,9.66964e+12,56.8057,802.438,1997,249,55,1473,1473,1176,1111,861
32056,2838,7479,20780,11276,9.9179e+12,60.0406,9799.03,32056,3642,72,24577,24577,17917,17768,9869
25457,5881,5917,16509,8948,9.9574e+12,59.9985,7842.94,25457,2882,72,19540,19540,19508,19499,19510
11956,3696,3980,7545,4411,8.68948e+12,58.2206,4942.96,11956,1936,72,7976,7976,7565,7181,7245
93328,19438,51086,73189,20139,79922200000,8.97837,51684.2,93328,45970,11,42242,42242,21351,23041,19679
6987,430,2228,4442,2545,8.85736e+12,58.0743,2881.47,6987,1081,72,4759,4711,2895,697,839
41031,2392,9543,26613,14418,9.92436e+12,60.0702,12380.1,41031,4648,72,31488,31488,20992,20793,8156
21653,152,5064,14047,7606,9.9372e+12,59.9322,6756.86,21653,2462,72,16589,16563,9407,6019,712
7486,1141,1782,4862,2624,9.86043e+12,59.2915,2529.11,7486,853,72,5704,5704,4795,4777,3842
11937,3144,3654,7590,4347,9.0362e+12,58.6154,4639.78,11937,1779,72,8283,8283,7538,6757,6809
89336,30284,30617,56195,33141,8.48414e+12,58.3814,35402.4,89336,14903,72,58719,58719,58488,58140,58273
41709,8109,11285,26770,14939,9.43299e+12,59.467,14045.4,41709,5491,72,30424,30424,27334,23182,22265
54923,20042,29974,43065,11858,79901300000,8.99492,30432,54923,26969,11,24949,24949,18535,19019,18070
23211,6823,10295,14188,9023,7.19152e+12,56.5932,11689.5,23211,5001,72,12916,12916,11208,9287,9292
81351,5317,27772,51186,30165,8.50557e+12,58.1836,32198.8,81351,13515,72,53579,53579,31234,16936,11892
93076,23745,27603,59293,33783,9.0855e+12,59.1275,32853.5,93076,13446,72,65473,65473,59876,59762,53132
51884,26182,27490,30918,20966,6.07325e+12,54.9713,29798.8,51884,13377,72,24394,24394,24031,23610,23817
29488,9397,13362,17986,11502,7.0663e+12,55.8083,15018.9,29488,6496,72,16126,16126,14640,12601,12298
51821,11662,19736,32258,19563,8.00593e+12,57.7375,22619,51821,9612,72,32085,32085,26669,19322,17627
65976,15967,18981,42133,23843,9.20326e+12,59.2488,22942.2,65976,9247,72,46995,46995,43744,39993,39915
65897,13466,15345,42737,23160,9.89941e+12,60.1004,19559,65897,7463,72,50552,50552,47907,45431,44807
86426,3351,46082,51454,34972,6.03047e+12,54.4943,49571.9,86426,22427,72,40344,40344,24347,8445,5092
50662,14929,19652,31470,19192,7.92282e+12,57.6272,22453.7,50662,9572,72,31010,31010,27857,23508,22700
38911,2355,22248,30573,8338,80502100000,8.9677,22614.9,38911,20022,11,16663,16663,5218,5716,4737
49080,3244,11447,31832,17248,9.90195e+12,60.0658,14737.6,49080,5565,72,37633,37633,21556,21215,11080
19371,370,819,15335,4036,5.85598e+13,11.9891,1271.89,19371,815,13,18552,18552,14534,10991,16761
57013,12939,16822,36346,20667,9.11153e+12,58.7518,20297.7,57013,8178,72,40191,40191,36869,32952,33019
93442,12933,21741,60598,32844,9.90661e+12,60.1303,27416.2,93442,10582,72,71701,71701,58862,58607,43117
19422,99,4545,12592,6830,9.90965e+12,59.9237,6102.15,19422,2206,72,14877,13719,3784,4372,577
86176,11487,20014,55880,30296,9.91515e+12,60.1402,25310.2,86176,9744,72,66162,66162,55870,41822,38503
51941,7929,20604,32176,19765,7.80433e+12,57.4876,23431.6,51941,10031,72,31337,31337,22452,14495,12380
37708,5934,10286,24194,13514,9.39513e+12,59.419,12823.4,37708,5005,72,27422,27422,22575,16935,16772
76610,6331,39345,45870,30740,6.2917e+12,55.5251,42609,76610,19161,72,37265,37265,23229,6978,6349
13849,1307,3293,8984,4865,9.83955e+12,59.7003,4485.46,13849,1591,72,10556,10556,7333,4818,4195
2887,294,1120,1807,1080,8.25741e+12,48.5722,1437.1,2887,528,62,1767,1767,1340,865,1000
90573,36369,45014,65030,25543,1.64112e+13,27.2898,52338,90573,10934,73,45559,45559,33320,21549,17779
59812,3225,24185,36983,22829,7.69342e+12,57.3776,27330.6,59812,11777,72,35627,35627,16852,8153,4536
18359,700,6631,11505,6854,8.27243e+12,57.8699,7923.64,18359,3225,72,11728,11584,7241,2952,1966
96928,10559,23583,62671,34257,9.76998e+12,59.9668,29370.1,96928,11484,72,73345,73345,54435,32062,31203
52962,308,21316,32754,20208,7.71831e+12,56.8047,24170.4,52962,10370,72,31646,30734,17666,9724,0
12259,2622,3303,7872,4387,9.51681e+12,59.2065,4351.24,12259,1609,72,8956,8956,8522,8109,8233
38459,1591,8958,24944,13515,9.92013e+12,60.0388,11647.6,38459,4355,72,29501,29501,13233,13519,5732
84962,17781,23499,54435,30527,9.34183e+12,59.4326,28472.7,84962,11442,72,61463,61463,55152,46571,44568
38011,8663,11186,24235,13776,9.1407e+12,59.0875,13675.1,38011,5449,72,26825,26825,24349,21526,21510
58002,6279,13466,37615,20387,9.92523e+12,60.1113,17251.7,58002,6554,72,44536,44536,33967,24444,21054
53226,9459,22706,32685,20541,7.41853e+12,56.8007,25473.5,53226,11056,72,30520,30520,21850,13800,11703
81023,29892,44175,48057,32966,5.87899e+12,55.1272,47407,81023,21521,72,36848,36848,32314,27168,27027
30523,4317,11127,19090,11433,8.2031e+12,57.9094,13046.9,30523,5406,72,19396,19396,14558,8839,8828
89506,4664,24145,57459,32047,9.43202e+12,59.5486,29385.5,89506,11761,72,65361,65361,32512,31951,13774
15858,2990,3742,10289,5569,9.90808e+12,59.8137,5066.56,15858,1819,72,12116,12116,11201,10040,9840
11380,2619,2711,7374,4006,9.87822e+12,59.6854,3737.68,11380,1313,72,8669,8669,8585,8571,8553
10194,626,631,8112,2082,5.7373e+13,11.9803,952.875,10194,425,14,9563,9563,9546,9545,9556
99205,23078,35663,62109,37096,8.27524e+12,58.1213,40778.4,99205,17368,72,63542,63542,55188,43792,41107
68953,32884,36368,53987,14966,7.9426e+10,8.98583,36895.6,68953,32723,11,32585,32585,30084,30338,29849
74997,10614,29483,46508,28489,7.83519e+12,57.5708,33341.8,74997,14351,72,45514,45514,31517,15025,14543
71829,23182,28817,44445,27384,7.74196e+12,57.4397,32493,71829,14036,72,43012,43012,40209,36450,35627
60150,5997,13950,39006,21144,9.92713e+12,60.1282,17854.1,60150,6796,72,46200,46200,34417,23544,20461
70873,14365,32748,43083,27790,6.95724e+12,56.4757,36071.1,70873,15954,72,38125,38125,27404,16185,13352
71957,2334,16718,46667,25290,9.91761e+12,60.1173,21256.8,71957,8134,72,55239,55239,34341,33915,8613
20270,7006,7778,12609,7661,7.98253e+12,56.7385,9138.39,20270,3767,72,12492,12492,12069,11487,11560
43782,464,10212,28384,15398,9.91993e+12,60.0796,13205.1,43782,4974,72,33570,33570,9714,1796,2090
34241,5281,7983,22201,12040,9.93154e+12,60.0407,10427.7,34241,3889,72,26258,26258,22254,22182,17480
27424,3457,7360,17611,9813,9.49164e+12,59.4382,9326.59,27424,3585,72,20064,20064,15981,11282,10136
66805,27937,28795,40986,25819,7.34282e+12,56.5136,32114,66805,14008,72,38010,38010,37981,37985,37990
14190,6367,6771,8600,5590,6.76234e+12,55.7915,7681.08,14190,3290,72,7419,7419,6953,6525,6583
88877,3772,23089,57204,31673,9.56262e+12,59.7066,28359.5,88877,11248,72,65788,65788,30200,29241,11126
40421,12001,12471,25676,14745,8.95394e+12,58.8551,15043.5,40421,6072,72,27950,27950,27477,26925,26880
27155,199,10825,16820,10335,7.77762e+12,47.0414,12501.6,27155,5251,72,16330,16330,9359,5086,904
19087,707,7615,11834,7253,7.77122e+12,55.4444,8886.85,19087,3688,72,11472,11327,5720,750,659
70220,420,16379,45523,24697,9.89634e+12,60.0716,20824.3,70220,7965,72,53841,53841,14181,1593,2214
81961,8495,26282,51879,30082,8.77639e+12,58.727,30852.2,81961,12800,72,55679,55679,41752,25316,24699
51290,3022,11937,33255,18035,9.91245e+12,60.0936,15352,51290,5809,72,39353,39353,20959,20945,10412
96086,2401,22262,62313,33773,9.92641e+12,60.1586,28081.2,96086,10844,72,73824,73824,26886,28689,9139
38846,9237,18318,23558,15288,6.83992e+12,56.26,20322.9,38846,8923,72,20528,20528,16119,11932,10971
58245,10327,20123,36616,21629,8.45111e+12,57.4318,23451.2,58245,9780,72,38122,38122,31314,22062,19895
97307,22963,30930,61640,35667,8.80722e+12,58.7833,36242.4,97307,15062,72,66377,66377,56845,45644,45256
28576,10059,11093,17755,10821,7.9271e+12,48.1714,12859.6,28576,5387,72,17483,17483,17483,17483,17483
95050,391,27834,60627,34423,9.12693e+12,59.1688,33202.5,95050,13547,72,67216,66688,21944,9829,2022
34848,1073,10774,22127,12721,8.94415e+12,58.8316,13055,34848,5242,72,24074,24074,10542,5293,2761
60004,7814,28849,36278,23726,6.72243e+12,56.1657,31659.9,60004,14054,72,31155,31155,21341,13521,11296
9086,367,2182,5881,3205,9.93436e+12,59.5821,3045,9086,1059,72,6904,6904,2977,3037,1336
90934,20774,21102,58982,31952,9.91767e+12,60.1432,26649.7,90934,10276,72,69832,69832,69444,69002,68973
67681,21099,22549,42684,24997,8.60668e+12,58.5094,26379.8,67681,10971,72,45132,45132,43536,41734,41740
3312,330,1601,2020,1292,6.85729e+12,54.6274,1911.25,3312,775,62,1711,1663,944,577,659
25097,6745,8199,15874,9223,8.70953e+12,58.4877,9919.35,25097,3988,72,16898,16898,16134,15178,15028
70792,1092,17893,45657,25135,9.65779e+12,59.7969,22267.8,70792,8713,72,52899,52899,30722,19743,3499
30175,5586,13957,18355,11820,6.94293e+12,55.819,15623.5,30175,6777,72,16218,16218,12052,7234,7226
87276,40887,47064,51866,35410,5.95225e+12,54.5748,50544.4,87276,22906,72,40212,40212,38493,36108,35770
55259,6122,17538,35006,20253,8.82536e+12,58.7553,20830.3,55259,8543,72,37721,37721,26984,26655,13944
77684,36781,37742,46898,30786,6.6433e+12,55.8587,41202.1,77684,18379,72,39942,39942,39490,38953,38908
97468,6147,33042,61367,36101,8.53349e+12,58.4425,38219.9,97468,16089,72,64426,64426,40574,12442,11448
63840,7525,14865,41406,22434,9.907e+12,60.1066,18967,63840,7237,72,48975,48975,38301,28066,25266
77556,7126,28974,48352,29204,8.09267e+12,57.5287,33048.5,77556,14109,72,48582,48582,32893,30473,14707
75567,16730,24453,47781,27786,8.73766e+12,58.6814,28704.6,75567,11907,72,51114,51114,41075,29281,28858
81356,19182,37215,49521,31835,7.01336e+12,56.5583,40973.3,81356,18123,72,44141,44141,34670,21740,18697
60505,7359,22988,37672,22833,8.01109e+12,57.766,26269.4,60505,11192,72,37517,37469,25329,15850,13048
52033,2862,17934,32708,19325,8.47781e+12,57.6078,20966.7,52033,8730,72,34099,34099,21668,7124,6564
76029,8280,17640,49316,26713,9.92402e+12,60.1364,22399,76029,8590,72,58389,58389,44719,44452,27949
16208,3570,3823,10517,5691,9.89562e+12,59.8191,5171.19,16208,1857,72,12385,12385,12024,12017,11755
38317,2323,8965,24836,13481,9.91234e+12,60.0556,11646.4,38317,4367,72,29352,29352,19709,13567,7950
5709,720,2745,3460,2249,6.86153e+12,55.3678,3205.79,5709,1331,69,2964,2868,1442,942,907
57414,11301,25152,35144,22270,7.268e+12,56.7226,28050.4,57414,12248,72,32262,32262,26220,18260,16539
26139,396,6150,16944,9195,9.88273e+12,59.9278,8113.14,26139,2986,72,19989,19989,5951,6593,1350
25830,5270,6008,16759,9071,9.93468e+12,60.0078,7958.4,25830,2925,72,19822,19822,18743,18722,17599
24964,1533,5877,16183,8781,9.90415e+12,59.9503,7767.96,24964,2862,72,19087,19087,12762,8761,5107
91357,2632,27326,58171,33186,9.0484e+12,59.0711,32476.8,91357,13298,72,64031,64031,29617,24162,6173
64088,11841,23134,40111,23977,8.2607e+12,58.0822,26663.5,64088,11268,72,40954,40954,32263,22097,21737
41179,5605,16192,25545,15634,7.85852e+12,57.5304,18542.7,41179,7887,72,24987,24987,15850,9369,7415
2145,187,563,1391,754,9.53411e+12,56.9399,857.222,2145,257,56,1582,1582,929,655,615
95283,3309,47557,57298,37985,6.47093e+12,55.8483,51572.9,95283,23162,72,47726,47726,22963,5424,3384
94143,13653,21833,61061,33082,9.91434e+12,60.1502,27552.5,94143,10630,72,72310,72310,60387,48963,45789
57121,4634,19839,35888,21233,8.43348e+12,58.2748,23101.7,57121,9661,72,37282,37234,26922,14699,14283
67747,24444,31274,41189,26558,6.96393e+12,56.4834,34478.8,67747,15236,72,36473,36473,34186,31548,31668
72977,2617,16944,47331,25646,9.91906e+12,60.1266,21540,72977,8248,72,56033,56033,35102,23470,9329
79646,14895,18514,51642,28004,9.92236e+12,60.1352,23461.3,79646,9019,72,61132,61132,55871,55763,49560
1935,804,1058,1517,418,79574100000,8.79328,1137.14,1935,943,11,877,877,712,726,715
51119,4443,15006,32605,18514,9.13482e+12,59.1208,18183.8,51119,7305,72,36113,36113,24974,11860,11405
72540,5530,27997,45070,27470,7.93608e+12,57.3368,31785.6,72540,13634,72,44543,44543,28920,10532,9965
68922,2012,22034,43626,25296,8.78927e+12,58.7383,25987.4,68922,10729,72,46888,46840,24200,19985,7152
76166,11512,17666,49391,26775,9.92113e+12,60.1397,22433.8,76166,8601,72,58500,58500,49520,49332,38652
7932,1252,1877,5148,2784,9.8784e+12,59.4323,2660.53,7932,900,72,6055,6055,5316,4385,4233
56821,6383,23193,35086,21735,7.65359e+12,57.2721,26186.5,56821,11298,72,33628,33628,22597,12999,10200
65620,7305,15276,42557,23063,9.9043e+12,60.0965,19472.3,65620,7432,72,50344,50344,38755,38523,24557
80417,20432,26715,50737,29680,8.62025e+12,58.544,31151,80417,13004,72,53702,53702,49014,47862,41197
64930,10416,27754,39870,25060,7.39735e+12,55.9254,31014.7,64930,13498,72,37176,37176,25087,15630,12844
61131,3986,14245,39646,21485,9.90939e+12,60.1069,18198.4,61131,6936,72,46886,46886,31991,31684,13714
2398,445,1002,1489,909,7.81294e+12,53.2915,1267.53,2398,484,55,1396,1356,834,193,215
34537,4373,8063,22398,12139,9.91247e+12,60.0226,10526.2,34537,3922,72,26474,26474,21110,16007,14665
17575,2600,5840,11093,6482,8.72122e+12,58.3455,7128.39,17575,2844,72,11735,11735,9628,7437,7082
93618,20650,41721,57174,36444,7.16207e+12,56.76,46028.2,93618,20324,72,51897,51897,38288,22403,21794
81097,8207,24885,51527,29570,8.94706e+12,58.9451,29496.1,81097,12110,72,56212,56212,34973,31103,27665
42364,19726,21381,25450,16914,6.40603e+12,55.7499,23425.3,42364,10410,72,20983,20983,20368,19501,19531
97511,2530,22655,63226,34285,9.91249e+12,60.1484,28545.6,97511,11033,72,74856,74856,27685,9949,9585
47895,9121,11154,31053,16842,9.92146e+12,60.0188,14379.7,47895,5427,72,36741,36741,33730,33677,30196
49789,4023,26982,29575,20214,5.91826e+12,55.1759,29169,49789,13137,72,22807,22807,14819,8668,5272
68820,5205,27890,42520,26300,7.68862e+12,57.2678,31419,68820,13581,72,40930,40930,24372,23262,10285
66886,3656,24753,41755,25131,8.13181e+12,57.9154,28367.5,66886,12046,72,42133,42133,23407,11753,7580
62687,10773,18450,39976,22711,9.12009e+12,59.1356,22214.3,62687,8986,72,44237,44237,36863,26828,24462
9549,1398,2718,6113,3436,9.33399e+12,58.8165,3569.67,9549,1323,72,6831,6831,5650,4115,3830
22202,4241,5853,14280,7922,9.51301e+12,59.4481,7530.13,22202,2834,72,16349,16349,14834,12825,12416
77987,4198,23034,49708,28279,9.09632e+12,59.1252,27554,77987,11216,72,54953,54953,34692,10790,9844
9690,1007,4694,5856,3834,6.68004e+12,53.0134,5373.35,9690,2272,72,4996,4996,3210,2029,1696
50219,12661,15764,31857,18362,8.86339e+12,58.7963,18823.4,50219,7674,72,34455,34455,32622,30195,29672
54344,1534,12685,35233,19111,9.90387e+12,60.0978,16268.6,54344,6176,72,41659,41659,15723,5816,5502
60937,13934,24139,37763,23174,7.80752e+12,57.5083,27368.1,60937,11755,72,36798,36798,31252,23678,21982
51185,22589,25077,39955,11230,78586300000,8.99609,25550.5,51185,22561,11,26108,26108,24137,24380,23905
36196,9738,9947,23215,12981,9.3642e+12,59.3753,12396.6,36196,4837,72,26249,26249,26010,25775,25779
73658,9734,24373,46480,27178,8.64806e+12,58.0108,28497.2,73658,11867,72,49285,49285,34483,22176,18617
49568,4902,11493,32154,17414,9.93031e+12,60.098,14813.2,49568,5595,72,38075,38075,28410,28225,16622
75813,274,21614,48457,27356,9.2335e+12,59.2275,26085.2,75813,10513,72,54199,53959,17226,15988,1771
73355,14430,34135,44562,28793,6.90767e+12,56.4223,37540.4,73355,16624,72,39220,39220,30859,23824,21758
2292,1408,1526,1326,966,4.46089e+12,46.0244,1701.36,2292,720,53,766,766,766,766,766
97737,6490,46177,59234,38503,6.81382e+12,56.1107,50463.3,97737,22490,72,51560,51560,25847,13029,7862
66254,3772,15509,42948,23306,9.8888e+12,60.0841,19733.2,66254,7550,72,50745,50745,26350,26366,12640
47927,1453,11163,31080,16847,9.91493e+12,60.0904,14391.1,47927,5436,72,36764,36764,14192,14919,5153
63652,11642,17382,40824,22828,9.39212e+12,59.4639,21289.3,63652,8465,72,46270,46270,40567,32818,31019
17396,1479,8877,10435,6961,6.36402e+12,53.7581,9889.58,17396,4308,72,8519,8519,4419,1802,1087
3392,72,1811,2034,1358,6.02874e+12,47.8323,2105.29,3392,862,65,1581,1071,899,438,176
65822,12307,17148,42361,23461,9.55897e+12,59.6728,21224,65822,8353,72,48674,48674,43877,37376,35874
84514,12541,20658,54621,29893,9.75413e+12,59.9381,25796.6,84514,10055,72,63856,63856,52526,41626,38717
4118,188,1337,2622,1496,8.82421e+12,52.425,1778.54,4118,630,65,2781,2781,1738,656,633
54574,12555,12673,35390,19184,9.92446e+12,60.1192,16272.8,54574,6173,72,41901,41901,41739,41643,41680
8626,1570,3219,5379,3247,8.16158e+12,57.2205,3938.62,8626,1561,72,5407,5407,4217,2657,2370
83786,5735,25706,53230,30556,8.95119e+12,58.9444,30445.9,83786,12512,72,58080,58032,39255,38846,16160
40521,8194,9474,26272,14249,9.91952e+12,60.0477,12278.4,40521,4615,72,31047,31047,29272,27621,27276
57217,1728,21230,35704,21513,8.12658e+12,57.3917,24403.8,57217,10325,72,35987,35987,21196,8624,3210
71266,11861,27424,44306,26960,7.94658e+12,57.7013,31161.2,71266,13356,72,43842,43842,33834,22122,21720
98906,29904,48445,77206,21700,78595200000,8.99677,49106.7,98906,43596,11,50461,50461,35745,37560,33941
11502,1040,2757,7456,4046,9.83564e+12,59.558,3787.65,11502,1331,72,8745,8745,6349,6290,3566
45983,13070,15849,28909,17074,8.4699e+12,58.2995,18587.3,45983,7715,72,30134,30134,28580,26422,26149
30150,2415,7851,19412,10738,9.54735e+12,59.5621,9997.71,30150,3809,72,22299,22299,12582,12822,6402
2161,47,1007,1325,836,7.09547e+12,41.9297,1242.94,2161,468,58,984,333,329,198,98
46876,2370,20016,28788,18088,7.4122e+12,56.683,22511.3,46876,9746,72,26860,26860,16292,9912,3588
28568,5333,11687,17649,10919,7.63162e+12,55.5956,13406.9,28568,5671,72,16881,16881,13578,9015,8149
28870,11388,11884,17813,11057,7.61058e+12,56.6564,13613.8,28870,5778,72,16986,16986,16402,15710,15918
18623,2397,7979,11438,7185,7.40811e+12,54.3111,9181.37,18623,3865,72,10644,10644,6570,4319,3507
16675,1427,9501,9821,6854,5.61756e+12,53.147,10389.3,16675,4623,72,7174,7078,4081,546,559
72577,14849,16858,47077,25500,9.91507e+12,60.1242,21432.8,72577,8207,72,55719,55719,53269,52707,49273
55405,5523,19214,34821,20584,8.43352e+12,58.2625,22399.1,55405,9347,72,36191,36191,23011,12275,9015
61012,3302,14156,39568,21444,9.91955e+12,60.1114,18108.8,61012,6885,72,46856,46856,30974,21221,11452
81101,13683,25884,51352,29749,8.79251e+12,58.7452,30422.4,81101,12605,72,55217,55217,42645,42315,27287
99653,43591,56114,58809,40844,5.64032e+12,54.6481,59831.7,99653,27315,72,43539,43539,38172,30771,29217
4178,553,1068,2701,1477,9.78371e+12,58.6436,1547.39,4178,514,68,3110,3110,2487,1726,1625
27410,8556,14733,16302,11108,6.02704e+12,55.1616,16100.9,27410,7177,72,12677,12677,10104,7133,7241
71230,23285,26610,44408,26822,8.09405e+12,53.697,30403.5,71230,12958,72,44620,44620,42433,40350,39997
82005,15777,26153,51933,30072,8.79256e+12,58.7492,30737.1,82005,12728,72,55852,55852,45941,34311,33881
71835,2172,24636,45183,26652,8.49213e+12,58.3663,28608.9,71835,11999,72,47199,47151,29549,14074,7933
36141,8870,9504,23245,12896,9.54688e+12,59.5689,11976.4,36141,4630,72,26637,26637,25714,24715,24760
93554,5573,21688,60672,32882,9.92199e+12,60.1551,27375.9,93554,10562,72,71866,71866,48364,47894,19429
35056,6415,15282,21484,13572,7.28799e+12,56.4464,17232.6,35056,7422,72,19774,19774,14062,7416,7226
52511,9814,12228,34059,18452,9.9091e+12,60.0796,15709.7,52511,5946,72,40283,40283,37346,33390,32499
46300,9029,10791,30015,16285,9.9139e+12,60.0886,13927.2,46300,5257,72,35509,35509,33455,32965,30140
33149,3110,11532,20825,12324,8.44339e+12,58.2113,13620,33149,5617,72,21617,21617,15045,7320,7223
98283,15938,38129,61031,37252,7.9024e+12,57.6745,43014.8,98283,18565,72,60154,60154,44106,28384,24015
54916,7532,19215,34477,20439,8.40246e+12,58.2227,22362.4,54916,9358,72,35701,35701,26605,15967,15615
44778,19006,23183,26786,17992,6.23812e+12,55.5517,25275.1,44778,11288,72,21595,21595,19905,18365,18047
38619,761,13837,24191,14428,8.29146e+12,58.0628,16175.9,38619,6729,72,24782,24590,14460,6872,2003
89666,21983,43161,54208,35458,6.69748e+12,56.1734,47086.5,89666,21015,72,46505,46505,36430,26936,24297
7183,2605,2888,4449,2734,7.82463e+12,56.9012,3495.43,7183,1406,72,4295,4295,3960,3590,3579
45403,5880,10591,29436,15967,9.90354e+12,60.078,13678.2,45403,5151,72,34812,34812,29145,27823,19644
4366,274,1751,2717,1649,7.80343e+12,56.3607,2174.9,4366,844,64,2615,2567,1509,201,382
34424,3625,8022,22320,12104,9.9283e+12,60.0414,10477.7,34424,3908,72,26402,26402,19988,14374,12241
12438,3696,8973,7006,5432,3.69677e+12,52.056,9489.18,12438,4370,70,3465,3417,2594,1567,1760
45993,22067,24777,36042,9951,79698200000,8.99528,25199.8,45993,22292,11,21216,21216,19378,19540,19233
53731,3101,16174,34196,19535,9.03418e+12,58.9327,19460,53731,7863,72,37557,37557,21370,12074,8578
77515,21340,30444,48071,29444,7.84427e+12,57.5095,34413.6,77515,14825,72,47071,47071,37526,26296,25994
9152,1753,2211,5927,3225,9.89423e+12,59.5158,3074.22,9152,1076,72,6941,6941,6493,5970,5933
60512,14400,33189,47456,13056,79920500000,8.99283,33668.2,60512,29866,11,27323,27323,15169,16089,14269
97208,30431,31041,61543,35665,8.79563e+12,58.7629,36336.1,97208,15122,72,66167,66167,65272,64317,64353
11247,2496,5523,8780,2467,78647200000,8.96746,5740.03,11247,4963,11,5724,5724,3332,3625,3058
12423,1523,2882,8062,4361,1.00078e+13,59.8219,3983.1,12423,1404,72,9541,9541,7534,5228,5244
33322,10088,13795,20543,12779,7.60712e+12,57.1556,15718.3,33322,6720,72,19527,19527,18449,16943,16830
67978,54264,67978,0,67978,7.99988,0,67978,67978,67978,1,0,0,0,0,0
89656,4651,29750,56569,33087,8.63419e+12,58.5555,34612.2,89656,14490,72,59906,59858,40222,27812,16113
20443,2210,5060,13212,7231,9.75478e+12,59.6915,6654.75,20443,2460,72,15383,15383,11789,8582,7554
56656,12006,15217,36379,20277,9.43977e+12,59.516,18783.5,56656,7398,72,41439,41439,38146,33690,32689
78722,3267,4309,62532,16190,5.77977e+13,12.0017,5234.97,78722,2727,20,74413,74413,65928,58758,70602
75761,27323,36730,45752,30009,6.65456e+12,56.1172,40124.8,75761,17882,72,39031,39031,31515,22641,22492
33872,2878,11388,21344,12528,8.59836e+12,58.4113,13547.8,33872,5543,72,22484,22484,15275,15036,6643
47004,6237,16138,29571,17433,8.47922e+12,57.8518,18933.9,47004,7839,72,30866,30866,23829,15628,15374
66272,13890,17438,42628,23644,9.51775e+12,59.6323,21530.6,66272,8491,72,48834,48834,45051,39879,38803
5003,372,1204,3250,1753,9.87375e+12,59.0368,1760.08,5003,576,72,3799,3799,2211,1372,1284
38729,857,11689,24642,14087,9.04451e+12,58.9702,14191.5,38729,5693,72,27040,26896,13370,10324,3255
70993,9529,16498,46044,24949,9.90843e+12,60.1205,20989.4,70993,8027,72,54495,54495,44276,44082,31784
9893,155,3771,6165,3728,8.03482e+12,56.0117,4557.73,9893,1824,72,6122,5936,2270,1085,596
7967,2154,3732,4849,3118,6.91358e+12,54.4333,4332.2,7967,1803,72,4235,4235,3866,3448,3415
37359,8447,24208,29289,8070,2.23362e+13,5.52488,27771,37359,8071,13,13151,13151,10451,11328,5695
31334,1130,12869,19335,11999,7.61024e+12,57.1831,14715.5,31334,6255,72,18465,18465,8813,3828,1907
47771,9915,15948,30129,17642,8.62798e+12,58.4863,18809.7,47771,7769,72,31823,31823,27282,21942,21945
34739,5917,8477,22464,12275,9.75707e+12,59.8429,10926.9,34739,4114,72,26262,26262,22898,19704,18926
39110,6993,9087,25366,13744,9.92914e+12,60.0817,11818.7,39110,4427,72,30023,30023,27033,24232,23521
74609,7964,18491,48188,26421,9.71351e+12,59.8066,23093.5,74609,8988,72,56118,56118,42264,25904,25286
55377,14682,15547,35445,19932,9.2886e+12,59.3388,18998.3,55377,7568,72,39830,39830,38872,37650,37440
21951,5778,9305,13505,8446,7.44908e+12,55.5846,10677.2,21951,4511,72,12646,12646,11191,9285,8889
45650,980,10647,29605,16045,9.92427e+12,60.0799,13743.1,45650,5187,72,35003,35003,20979,20687,3796
57907,13098,13506,37542,20365,9.90719e+12,60.0922,17281.4,57907,6574,72,44401,44401,43805,43792,43263
91406,12727,39042,56129,35277,7.39754e+12,56.4867,43385.2,91406,19008,72,52364,52364,34038,12478,11774
15458,4530,6182,9581,5877,7.78635e+12,57.2011,7260.1,15458,3003,72,9276,9276,7817,6092,6255
80933,773,26050,51212,29721,8.75812e+12,58.7082,30565.7,80933,12686,72,54883,54835,31073,17122,1841
11540,4541,6900,6756,4784,5.25185e+12,52.22,7541.53,11540,3342,72,4640,4640,3878,2989,3188
24761,22625,24761,0,24761,7.99968,0,24761,24761,24761,1,0,0,0,0,0
27018,342,6342,17519,9499,9.8973e+12,59.9654,8361.05,27018,3084,72,20676,20676,11992,7764,1432
13654,3397,3733,8755,4899,9.43848e+12,59.0852,4868.72,13654,1818,72,9921,9921,9875,9852,9906
88433,12824,20520,57349,31084,9.9188e+12,60.1486,25938.3,88433,9992,72,67913,67913,58642,56480,42998
93056,4555,28302,59166,33890,8.98682e+12,58.9974,33499,93056,13784,72,64754,64754,41383,13838,12798
30175,7500,12952,18527,11648,7.39415e+12,56.361,14698,30175,6293,72,17223,17223,13777,9730,9791
62001,17213,24689,38392,23609,7.77427e+12,57.3491,27959.4,62001,12018,72,37312,37312,34086,30405,30332
93851,3081,21828,60854,32997,9.91478e+12,60.1353,27522,93851,10634,72,72023,72023,44735,44182,11098
16852,77,4122,10903,5949,9.78696e+12,59.68,5496.9,16852,2004,72,12730,9790,7151,4064,387
32442,141,7570,21034,11408,9.92243e+12,60.0407,9914.09,32442,3684,72,24872,24800,14058,9009,847
42241,3070,9816,27394,14847,9.91911e+12,60.0643,12724.4,42241,4771,72,32425,32425,19653,19217,10489
18932,5094,6327,11942,6990,8.63649e+12,58.3232,7694.09,18932,3076,72,12605,12605,11611,10229,10140
77869,16286,18124,50494,27375,9.91197e+12,60.1196,22975,77869,8825,72,59745,59745,57587,57072,54097
45112,5569,17775,27961,17151,7.84046e+12,56.911,20305.1,45112,8654,72,27337,27337,19423,10131,9965
15557,175,4351,9976,5581,9.30648e+12,58.6961,5600.11,15557,2097,72,11206,11147,3147,1921,691
77989,14828,18133,50569,27420,9.91492e+12,60.1368,22996,77989,8834,72,59856,59856,55068,50518,49324
3512,459,857,2282,1230,1.01014e+13,58.6737,1281.3,3512,416,64,2655,2655,2177,2068,1561
50136,11387,11686,32511,17625,9.90291e+12,60.0749,15034.5,50136,5687,72,38450,38450,38099,38022,37708
35200,14533,22805,27600,7600,2.23455e+13,5.5244,26166,35200,7609,13,12395,12395,11235,12234,8483
4297,835,1860,2646,1651,7.46564e+12,55.7414,2258.88,4297,902,64,2437,2389,1667,1016,1063
29680,7896,9360,18826,10854,8.85655e+12,58.6961,11350.2,29680,4555,72,20320,20320,18267,15935,15916
44657,5019,28923,35018,9639,2.23597e+13,5.53022,33172.7,44657,9648,13,15734,15734,11316,9919,4409
25892,3838,12042,15732,10160,6.96694e+12,56.3237,13508.4,25892,5866,72,13850,13802,12634,12398,12442
21921,1112,1130,17388,4533,5.8043e+13,12.006,1617.17,21921,760,20,20791,20791,20686,20698,20724
44411,4628,10362,28794,15617,9.91999e+12,60.0626,13385.8,44411,5048,72,34049,34049,26041,17865,15690
89185,1584,40737,54307,34878,7.01213e+12,56.567,44802.2,89185,19833,72,48448,48448,28261,18218,3738
60455,1440,19112,38317,22138,8.84394e+12,58.7905,22668.3,60455,9310,72,41343,41343,18524,14075,2429
59772,1700,13872,38769,21003,9.91634e+12,60.1173,17758.7,59772,6747,72,45900,45900,17417,18463,6356
10377,3552,3784,6494,3883,8.22108e+12,57.3414,4618.31,10377,1828,72,6593,6593,6443,6305,6307
76969,18109,23866,48857,28112,8.91773e+12,58.8977,28256.4,76969,11626,72,53103,53103,47309,39324,37633
31674,6452,7408,20544,11130,9.91211e+12,59.9996,9703.27,31674,3604,72,24266,24266,22857,22831,21298
50674,5696,18090,31754,18920,8.3187e+12,58.1109,21008.3,50674,8809,72,32584,32584,22426,15167,12968
46753,10828,10908,30317,16436,9.90897e+12,60.0646,14065.2,46753,5310,72,35845,35845,35741,35713,35724
9375,1353,2267,6072,3303,9.81146e+12,59.1365,3150.58,9375,1088,72,7108,7108,6019,5768,4339
93855,13111,21824,60862,32993,9.90841e+12,60.1396,27523.7,93855,10625,72,72031,72031,61515,59065,43743
25050,894,13456,14897,10153,5.9837e+12,54.6018,14738.7,25050,6540,72,11594,11258,5942,2106,1016
66266,709,15432,42975,23291,9.90418e+12,60.099,19664.8,66266,7503,72,50834,50834,29322,28900,2824
24156,1696,6408,15529,8627,9.51864e+12,59.4674,8195.42,24156,3115,72,17748,17748,10054,5797,4223
23799,1503,7715,15049,8750,8.73145e+12,58.5077,9370.67,23799,3747,72,16084,16084,9838,4359,3814
18058,4893,7495,11135,6923,7.57727e+12,56.9744,8687.59,18058,3639,72,10563,10563,9495,9424,8424
33271,14783,20251,19369,13902,5.06812e+12,51.8418,21655.8,33271,9843,72,13020,13020,12069,10740,10658
59286,9388,59286,0,59286,7.99987,0,59286,59286,59286,1,0,0,0,0,0
92953,14204,29032,58964,33989,8.87775e+12,58.8681,34174,92953,14138,72,63921,63921,49628,35935,32254
57741,653,16237,36947,20794,9.29169e+12,59.3324,19805.5,57741,7903,72,41504,41504,16611,2359,2530
24237,2331,6951,15490,8747,9.20623e+12,59.0852,8702.87,24237,3372,72,17286,17286,11955,5720,5538
70226,20979,30717,43001,27225,7.26401e+12,56.861,34141.9,70226,14959,72,39509,39509,32367,23960,23833
27929,11099,13527,16875,11054,6.70788e+12,56.0098,15039.3,27929,6589,72,14402,14402,13698,12716,12725
23366,971,9856,14371,8995,7.50779e+12,55.4119,11298.8,23366,4795,72,13510,13458,6189,2180,785
70165,11837,17421,45303,24862,9.71175e+12,59.8699,21784.6,70165,8486,72,52744,52744,45988,44421,34639
96090,9178,22292,62321,33769,9.90846e+12,60.1377,28110.8,96090,10846,72,73798,73798,54672,54292,31133
2777,395,690,1800,977,1.02188e+13,58.1563,1044.82,2777,336,60,2087,2087,1736,1364,1355
45438,7872,13638,28919,16519,9.04932e+12,59.0123,16500.3,45438,6644,72,31800,31800,26694,25444,18166
53745,8092,16452,34157,19588,8.96843e+12,58.4642,19718.9,53745,7998,72,37293,37293,29475,22044,20013
46858,4588,13876,29871,16987,9.08722e+12,58.3622,16828.2,46858,6737,72,32982,32982,23789,13004,12629
63262,10576,14731,41023,22239,9.91216e+12,60.1009,18797.5,63262,7172,72,48531,48531,43519,42353,35171
91645,17793,21321,59424,32221,9.91186e+12,60.1367,26898.2,91645,10386,72,70324,70324,66087,65096,59050
62269,1697,14496,40375,21894,9.91964e+12,60.1048,18507.5,62269,7062,72,47773,47773,29200,28814,6374
95000,10628,22091,61600,33400,9.90851e+12,60.1367,27847.4,95000,10756,72,72909,72909,58748,55805,35719
76032,13488,26783,47687,28345,8.37059e+12,58.2355,30904.3,76032,13047,72,49249,49249,40111,27528,24727
54201,13894,19795,33878,20323,8.20172e+12,57.9425,22851,54201,9628,72,34406,34406,29119,22986,22802
85921,5804,39713,52241,33680,6.94475e+12,56.3939,43619.2,85921,19326,72,46208,46208,28537,14379,10000
61088,15235,17148,39091,21997,9.30294e+12,59.3466,20888.1,61088,8354,72,43940,43940,42512,40644,40266
86102,31572,35443,53113,32989,7.60589e+12,57.2858,39660.3,86102,17263,72,50659,50659,47800,44541,44474
38523,4200,11901,24464,14059,8.93106e+12,58.78,14380.1,38523,5786,72,26622,26622,17331,10532,8366
31938,8379,12156,19889,12049,7.99954e+12,57.5809,14106.8,31938,5899,72,19782,19782,17583,14538,14040
97451,4964,28801,62097,35354,9.09999e+12,59.1338,34268.8,97451,14026,72,68650,68650,41863,10584,8933
79343,37177,74146,54636,24707,9.20889e+12,3.99553,74286.2,79343,24739,9,5197,5197,2605,5197,2612
51324,11565,28655,30337,20987,5.70806e+12,54.9178,30830.1,51324,13954,72,22669,22669,15674,9108,7446
29683,7403,12968,18185,11498,7.28734e+12,56.7746,14673.2,29683,6312,72,16715,16715,13183,9144,9046
17865,3769,5788,11306,6559,8.77102e+12,58.4537,7109.29,17865,2814,72,12077,12077,10628,8722,8327
88403,16112,20532,57338,31065,9.91266e+12,60.1336,25945.7,88403,9993,72,67871,67871,62552,55343,53672
73667,19571,34626,44684,28983,6.84376e+12,56.035,38021,73667,16859,72,39041,39041,31518,22817,22512
39747,7125,11412,25399,14348,9.2131e+12,59.1963,14017.1,39747,5553,72,28335,28335,24169,18548,17268
8176,59,1977,5291,2885,9.92907e+12,59.4644,2769.78,8176,963,72,5832,2775,3483,3418,332
17295,2946,4660,11107,6188,9.45426e+12,59.131,6031.88,17295,2256,72,12635,12635,10990,10571,8353
27724,422,6504,17978,9746,9.89114e+12,59.9807,8568.16,27724,3160,72,21220,21220,6440,1581,1702
43896,3609,10255,28468,15428,9.9072e+12,60.055,13252.7,43896,4992,72,33641,33641,23994,16921,12224
28872,8195,14570,17342,11530,6.41061e+12,55.1065,16076.6,28872,7083,72,14302,14302,11494,8314,8285
97549,16465,51782,58118,39431,6.05876e+12,55.3063,55659.3,97549,25204,72,45767,45767,29144,13391,9085
78391,16431,24194,49780,28611,8.92982e+12,58.9237,28664,78391,11782,72,54197,54197,49031,48921,42861
97510,21919,43317,59586,37924,7.18046e+12,56.7749,47782.2,97510,21101,72,54193,54193,46693,36355,34098
86133,14775,28224,54402,31731,8.68906e+12,58.6282,32947.1,86133,13749,72,57909,57909,43690,26861,26368
36813,7647,9408,23726,13087,9.6234e+12,59.7114,11945.9,36813,4580,72,27405,27405,24802,24756,21768
46546,7184,14100,29614,16932,9.00173e+12,58.8998,17013.1,46546,6846,72,32446,32446,24720,15555,15394
37761,8656,14028,23561,14200,8.13396e+12,57.8412,16282.2,37761,6830,72,23733,23733,19934,16350,15453
33679,1876,16486,20308,13371,6.62475e+12,54.82,18228.8,33679,8025,72,17193,17193,10291,2254,2141
64252,11960,35361,38056,26196,5.8186e+12,55.0666,38004.7,64252,17227,72,28891,28891,20585,12762,10745
83646,15873,24013,53430,30216,9.20376e+12,59.2669,28862.3,83646,11687,72,59633,59633,52434,50702,40324
20826,6492,6858,13160,7666,8.7097e+12,58.373,8335.58,20826,3337,72,13968,13968,13521,13001,12965
18919,9549,11574,11013,7906,5.04171e+12,52.928,12477.4,18919,5633,72,7345,7345,6927,6340,6443
90520,19081,29628,57191,33329,8.68517e+12,58.6175,34560.6,90520,14421,72,60892,60892,57360,53260,53166
60212,12077,16797,38551,21661,9.3251e+12,59.3683,20498.3,60212,8183,72,43415,43415,38532,31908,30389
93138,8015,21930,60351,32787,9.87491e+12,60.0931,27572.1,93138,10680,72,71208,71208,48691,46664,27278
75198,20189,30359,46488,28710,7.70094e+12,56.874,34170.5,75198,14769,72,44839,44839,39155,32513,32460
6946,577,1634,4502,2444,1.0012e+13,59.4914,2342.44,6946,792,72,5312,5312,3752,2663,2006
63880,4555,24676,39683,24197,7.92997e+12,57.5637,28081.1,63880,12016,72,39204,39204,21698,10971,7104
43954,10745,15498,27575,16379,8.37e+12,58.174,18113.2,43954,7544,72,28456,28456,24820,19936,18832
44400,895,13585,28218,16182,8.97633e+12,58.9122,16374.4,44400,6612,72,30815,30671,18443,9074,3405
25097,3253,8682,15779,9318,8.46069e+12,57.6301,10361.1,25097,4215,72,16415,16415,11259,7403,6367
83462,14530,19388,54120,29342,9.91778e+12,60.1397,24541.8,83462,9439,72,64074,64074,56971,50203,48361
1072,196,307,702,370,9.53763e+12,54.4907,481.116,1072,143,44,765,765,618,532,558
81212,3973,46607,47770,33442,5.51054e+12,54.7127,49674.5,81212,22704,72,34605,34605,21083,12530,4793
47417,15271,20394,29095,18322,7.36371e+12,56.35,22903.1,47417,9922,72,27023,27023,24587,21337,20620
65102,14450,18246,41660,23442,9.29633e+12,59.3562,22198.9,65102,8886,72,46856,46856,42335,37064,36919
22717,3687,7318,14382,8335,8.77219e+12,58.5413,8916.27,22717,3559,72,15399,15399,12024,8052,8116
98320,25547,28271,62799,35521,9.19862e+12,55.7992,33837.3,98320,13750,72,70049,70049,70049,70049,70049
72396,6314,16875,46939,25457,9.90461e+12,60.1026,21434,72396,8212,72,55521,55521,40194,28426,21381
27514,7204,9340,17330,10184,8.54279e+12,58.3236,11164,27514,4543,72,18174,18174,16564,14442,14002
6412,1065,1515,4162,2250,1.00921e+13,59.3414,2178.99,6412,737,72,4897,4897,4346,4226,3616
8739,373,2048,5674,3065,9.94001e+12,59.6362,2893.48,8739,990,72,6691,6691,2904,1404,1340
29585,3294,13739,17991,11594,6.9278e+12,56.3286,15374,29585,6686,72,15846,15846,8924,4137,2585
31818,5206,8799,20385,11433,9.36754e+12,59.2586,11000.9,31818,4280,72,23019,23019,19017,14377,14268
69772,17449,39460,41141,28631,5.61466e+12,54.1035,42216.2,69772,19202,72,30312,30312,23579,14694,12740
10508,1385,2513,6810,3698,9.88727e+12,59.6187,3477.07,10508,1218,72,7995,7995,6729,6420,4749
62724,7898,17811,40113,22611,9.24159e+12,59.2742,21623.7,62724,8664,72,44913,44913,34883,23095,22666
26652,1941,6409,17250,9402,9.82024e+12,59.8704,8392.56,26652,3117,72,20243,20243,14013,9748,6499
28109,1976,18608,16111,11998,4.38312e+12,52.9313,19708,28109,9044,72,9501,9501,5867,1751,1745
95099,30951,52342,56338,38761,5.80592e+12,54.9831,56003.2,95099,25478,72,42757,42757,33360,24517,22195
95594,20567,23513,61752,33842,9.73703e+12,59.9307,29215,95594,11451,72,72081,72081,68123,68019,63424
61615,7469,17469,39405,22210,9.26028e+12,59.2526,21227.7,61615,8494,72,44146,44146,31864,32226,18287
33031,1517,7717,21422,11609,9.90045e+12,60.0194,10096.2,33031,3750,72,25314,25314,16346,11118,5407
59054,12846,14575,38146,20908,9.74583e+12,59.8807,18351.8,59054,7100,72,44479,44479,42355,41870,38934
48173,12565,18402,29971,18202,7.99049e+12,57.2342,21115.8,48173,8948,72,29771,29771,26084,20993,19999
51099,9762,13796,32804,18295,9.44387e+12,59.4971,17059.9,51099,6717,72,37303,37303,32521,26965,26803
23445,4615,5528,15198,8247,9.88016e+12,59.9262,7331.96,23445,2682,72,17917,17917,16594,15359,15160
46318,3935,15319,29243,17075,8.64162e+12,57.9629,18124.8,46318,7441,72,30999,30999,20408,12856,10697
49750,21582,26830,29568,20182,5.95705e+12,55.1344,29026.8,49750,13049,72,22920,22920,20817,17904,17438
86677,19502,39196,52845,33832,7.07414e+12,56.3145,43195.1,86677,19073,72,47481,47481,37794,24453,21459
92443,5731,49852,72447,19996,79735400000,8.98566,50454.5,92443,44859,11,42591,42591,14300,16377,12243
69472,4588,19723,44419,25053,9.26707e+12,59.3112,23874.3,69472,9608,72,49749,49749,27573,16153,11687
50102,7284,15799,31762,18340,8.83884e+12,58.7678,18848.3,50102,7682,72,34303,34303,26419,25685,15808
76804,9308,34815,46802,30002,7.06678e+12,56.6272,38418.3,76804,16961,72,41989,41989,30593,17283,16940
50425,2213,14590,32197,18228,9.18731e+12,59.199,17749.4,50425,7107,72,35835,35835,22048,7240,5214
21174,3798,4955,13740,7434,9.92081e+12,59.9309,6620.05,21174,2409,72,16219,16219,14625,14580,12844
77295,2546,24012,49056,28239,8.90956e+12,58.8804,28412.7,77295,11698,72,53283,53235,27751,10073,9022
68084,25327,26430,42280,25804,7.90518e+12,57.4771,30012.7,68084,12859,72,41654,41654,40548,39488,39422
82206,7363,25407,52200,30006,8.92465e+12,58.9155,30055.8,82206,12370,72,56799,56751,42457,30704,24869
88988,25227,27268,56541,32447,8.95741e+12,58.9697,32261.5,88988,13281,72,61720,61720,59320,58749,55413
12722,2589,3920,8085,4637,8.97006e+12,58.6226,4958.58,12722,1902,72,8802,8802,6859,6823,4625
95686,9158,41325,58685,37001,7.3337e+12,56.8222,45807.1,95686,20110,72,54361,54361,36766,16236,15455
97422,3883,38841,60320,37102,7.76824e+12,57.499,43613.6,97422,18918,72,58581,58581,30743,12492,6101
64666,6375,17148,41555,23111,9.49935e+12,59.6039,21144.9,64666,8354,72,47518,47518,34993,20153,19747
84959,26421,30672,53170,31789,8.25292e+12,58.0538,35145.8,84959,14925,72,54287,54287,51080,46655,45808
30898,15765,17934,18140,12758,5.45706e+12,54.5103,19328.2,30898,8736,72,12964,12964,12618,12238,12441
61902,7557,15205,40001,21901,9.74027e+12,59.9005,19148.1,61902,7396,72,46697,46697,36270,26303,23535
2451,289,613,1591,860,1.03605e+13,57.9531,935.535,2451,298,58,1838,1838,1418,989,974
93307,9359,31907,58696,34611,8.49871e+12,58.355,36875.8,93307,15539,72,61400,61400,44738,25148,24532
98835,22068,29519,62925,35910,9.05873e+12,59.0967,35032,98835,14377,72,69316,69316,62944,61401,52251
24654,6615,7915,15606,9048,8.77406e+12,58.57,9623.96,24654,3840,72,16739,16739,15451,13644,13450
6293,1445,1796,4026,2267,9.31542e+12,58.5621,2423.37,6293,869,72,4497,4497,4199,3765,3897
23409,2512,7071,14903,8506,9.02228e+12,58.8331,8747.84,23409,3428,72,16338,16338,11799,6520,6390
9895,2731,9895,0,9895,7.99919,0,9895,9895,9895,1,0,0,0,0,0
62100,15586,24312,38520,23580,7.87147e+12,57.2787,27613.4,62100,11838,72,37788,37788,31952,23912,22213
3367,743,1915,2644,723,80239900000,8.4155,2017.77,3367,1717,11,1452,1452,749,789,726
94931,3305,22008,61566,33365,9.92171e+12,60.1508,27767,94931,10715,72,72923,72923,30111,12862,11840
32222,8531,11825,20133,12089,8.19305e+12,57.9164,13824.2,32222,5756,72,20397,20397,17879,14939,14966
97607,9456,28779,62213,35394,9.1087e+12,59.1394,34259.6,97607,14015,72,68828,68828,47016,21209,20234
25833,4943,14661,15229,10604,5.60428e+12,51.4009,15909,25833,7120,72,11172,11172,7201,4430,3610
91068,2572,25188,58344,32724,9.35122e+12,59.4364,30461,91068,12270,72,65880,65880,29365,16190,9315
25932,8066,12912,15606,10326,6.50236e+12,53.6639,14316.8,25932,6267,72,13020,13020,11089,8829,8968
74359,13188,17265,48227,26132,9.91982e+12,60.1205,21932.6,74359,8402,72,57094,57094,51187,51066,44040
99959,16415,39016,62029,37930,7.87213e+12,57.6044,43956.6,99959,18997,72,60943,60943,44155,28104,23734
62745,5330,18669,39965,22780,9.08442e+12,59.0829,22419.4,62745,9095,72,44076,44076,27535,17757,14158
52873,9429,12311,34289,18584,9.91101e+12,60.0867,15812,52873,5993,72,40562,40562,37037,36229,31211
43965,3811,18294,27090,16875,7.55431e+12,56.7922,20698.1,43965,8895,72,25671,25671,17082,7090,6746
42708,161,15588,26700,16008,8.20548e+12,57.9188,18099.2,42708,7584,72,27120,26470,15085,8673,673
11814,2240,4306,7390,4424,8.23017e+12,57.5364,5226.44,11814,2083,72,7508,7508,6409,4854,4724
6529,2736,3772,3843,2686,5.69396e+12,53.9807,4205.93,6529,1837,72,2757,2757,2303,1881,2006
64683,27633,30502,39226,25457,6.82879e+12,56.3189,33541,64683,14856,72,34181,34181,32643,31217,31041
57356,2820,15939,36734,20622,9.34151e+12,59.3925,19498.2,57356,7765,72,41417,41417,25951,25572,7015
85451,1081,19859,55419,30032,9.90629e+12,60.13,25118.3,85451,9663,72,65592,65592,19501,21677,4303
4314,934,1687,2691,1623,7.89816e+12,56.3855,2111.74,4314,808,70,2627,2627,2396,2309,2180
2451,164,675,1584,867,9.72736e+12,57.4912,993.806,2451,325,59,1776,1761,969,663,582
68992,6305,16095,44730,24262,9.89958e+12,60.1096,20475.3,68992,7830,72,52897,52897,38706,27511,21294
45017,15588,45017,0,45017,7.99982,0,45017,45017,45017,1,0,0,0,0,0
90800,21639,40720,55419,35381,7.12797e+12,56.7092,44898.9,90800,19836,72,50080,50080,41472,31418,31215
80525,6999,18728,52226,28299,9.91117e+12,60.1315,23724.2,80525,9121,72,61797,61797,44709,31645,23707
17060,4524,7324,10478,6582,7.38822e+12,56.7695,8446.17,17060,3555,72,9736,9736,8833,7562,7496
55387,16685,16762,35236,20151,9.02027e+12,58.9863,20122.5,55387,8161,72,38625,38625,38522,38493,38517
67265,10952,18672,43079,24186,9.34328e+12,59.405,22743.1,67265,9096,72,48593,48593,41019,30703,28291
16974,482,3979,11005,5969,9.93364e+12,59.9023,5379.59,16974,1936,72,12995,12995,4882,5144,1818
58152,12929,13517,37719,20433,9.90475e+12,60.0832,17310.7,58152,6571,72,44635,44635,43802,43053,42935
38955,8913,12430,24667,14288,8.82441e+12,58.6846,14892.8,38955,6055,72,26525,26525,24342,21318,20837
42561,9056,9894,27607,14954,9.91786e+12,60.0666,12818.7,42561,4815,72,32667,32667,31646,31411,30103
6437,324,3314,3861,2576,6.35059e+12,51.076,3797.01,6437,1604,72,3123,3027,1489,257,0
12986,3524,4639,8144,4842,8.39342e+12,57.8232,5632.1,12986,2259,72,8347,8347,7191,5791,6008
17108,2439,4379,11035,6073,9.65674e+12,59.5293,5755.42,17108,2130,72,12729,12729,10362,7201,6501
53987,9273,14371,34694,19293,9.47522e+12,59.5441,17804.9,53987,6988,72,39616,39616,34283,33022,25363
75410,13673,42444,44498,30912,5.64665e+12,54.1671,45395.9,75410,20658,72,32966,32966,24585,16764,14730
29452,23052,29452,0,29452,7.99973,0,29452,29452,29452,1,0,0,0,0,0
33202,17343,17795,26013,7189,79657500000,8.99328,18154.3,33202,16012,11,15407,15407,15131,15147,15133
97759,1482,22657,63409,34350,9.92209e+12,60.1493,28561.7,97759,11034,72,75102,75102,23598,25902,6053
9852,82,2809,6299,3553,9.33498e+12,58.8964,3685.06,9852,1364,72,7043,5901,3980,2213,398
20667,5914,7072,13019,7648,8.5161e+12,56.8354,8522.38,20667,3424,72,13595,13595,12773,12055,11932
36045,6835,14537,22286,13759,7.71798e+12,57.3421,16622.3,36045,7077,72,21508,21508,16323,10304,10136
62975,3783,20613,39779,23196,8.69079e+12,58.2262,24245.8,62975,10030,72,42362,42362,23371,13596,9802
40179,6760,9408,26044,14135,9.89474e+12,60.0291,12194.9,40179,4578,72,30771,30771,26977,26894,22464
74939,381,19345,48247,26692,9.58356e+12,59.5952,23910.7,74939,9419,72,55594,55402,31311,30746,1444
37549,8040,12542,23682,13867,8.60333e+12,58.4326,14893,37549,6105,72,25007,25007,20397,15046,14903
27214,5568,7524,17445,9769,9.38752e+12,59.308,9462.03,27214,3665,72,19690,19690,17390,14320,13660
93304,13842,26920,59588,33716,9.18204e+12,59.2435,32233.7,93304,13105,72,66384,66384,51856,51489,34118
12190,2026,2890,7899,4291,9.91994e+12,59.7492,3972.33,12190,1404,72,9300,9300,8248,8008,6651
77978,29634,33465,47863,30115,7.38259e+12,57.0097,37248,77978,16302,72,44513,44513,41146,37223,37173
76612,4571,19908,49309,27303,9.55959e+12,59.3283,24553.7,76612,9692,72,56704,56704,28384,28012,11659
98259,30054,37396,61148,37111,8.00817e+12,57.7901,42323.8,98259,18218,72,60863,60863,55781,49913,49738
86897,39662,43644,52209,34688,6.42901e+12,55.7562,47342.4,86897,21251,72,43253,43253,41102,38118,37636
24406,1764,5688,15837,8569,9.90991e+12,59.9774,7554.43,24406,2765,72,18718,18718,13009,9118,6121
34575,6622,8538,22338,12237,9.75351e+12,59.8202,10967.2,34575,4159,72,26037,26037,24121,23664,21048
98907,1741,22969,64139,34768,9.91885e+12,60.1477,28930.8,98907,11189,72,75938,75938,45056,29482,6957
55860,11243,15979,35691,20169,9.23851e+12,59.2591,19428.9,55860,7784,72,39881,39881,35351,34256,27823
88597,23380,26352,56435,32162,9.07707e+12,59.1031,31376.3,88597,12835,72,62245,62245,59942,56871,56215
19576,7887,10830,15359,4217,80049100000,8.8821,11096.7,19576,9741,11,8746,8746,6893,7021,6784
90379,729,21956,58433,31946,9.78056e+12,59.9781,27408.6,90379,10693,72,68423,68423,39320,38658,3474
5662,763,1348,3674,1988,9.92722e+12,59.2791,1958.99,5662,648,72,4314,4314,3476,2734,2613
33278,1583,7763,21586,11692,9.92891e+12,60.0321,10152.3,33278,3781,72,25515,25515,12029,12199,5392
90275,11528,42069,54807,35468,6.89902e+12,55.9785,46115.8,90275,20490,72,48206,48206,33324,15863,15262
62301,15547,24725,38594,23707,7.79151e+12,57.3742,28014.6,62301,12024,72,37576,37576,33793,28642,27544
48845,12733,21310,29920,18925,7.28785e+12,56.8584,23856.2,48845,10376,72,27535,27535,22763,16288,14799
42832,1815,18281,26308,16524,7.43577e+12,56.9875,20594.2,42832,8905,72,24551,24551,11847,4292,1697
36919,5411,8647,23926,12993,9.90328e+12,60.0456,11246.4,36919,4212,72,28272,28272,24401,23490,17985
23009,8129,8888,14294,8715,7.94533e+12,57.5274,10382.1,23009,4326,72,14121,14121,13692,13188,13403
92244,1303,24042,59358,32886,9.54602e+12,59.6954,29481.1,92244,11707,72,68202,68202,39166,24840,3437
29562,393,7515,19057,10505,9.6599e+12,59.6882,9638.06,29562,3661,72,22047,21951,7667,7357,1672
17971,2531,4228,11655,6316,9.88861e+12,59.8188,5689.74,17971,2048,72,13743,13743,11258,11212,8353
68017,7956,16469,43991,24026,9.79098e+12,59.9684,20752.7,68017,8017,72,51548,51548,41088,38868,23909
95657,13338,22200,62032,33625,9.91758e+12,60.1307,27996.6,95657,10809,72,73457,73457,60518,48112,44671
52393,14320,21669,32306,20087,7.57458e+12,56.4767,24454.9,52393,10534,72,30724,30724,27090,23712,22821
44460,9398,19800,27162,17298,7.17341e+12,56.6883,22126.6,44460,9637,72,24660,24660,18686,11671,11603
24702,675,5809,16017,8685,9.92841e+12,59.9609,7684.83,24702,2830,72,18893,18893,6819,7244,2256
30002,5336,7024,19462,10540,9.90635e+12,59.9954,9220.98,30002,3418,72,22978,22978,20486,18143,17584
14450,2734,3421,9371,5079,9.92045e+12,59.766,4651.18,14450,1661,72,11029,11029,10020,10000,8975
73079,11357,19231,47003,26076,9.51681e+12,59.6356,23675.2,73079,9363,72,53848,53848,45514,43526,31473
45560,127,1931,36062,9498,5.85648e+13,12.0029,2638.89,45560,1728,19,43629,43629,27607,13394,35703
10675,435,3829,6701,3974,8.29733e+12,57.6789,4687.94,10675,1855,72,6846,6750,3219,2087,1501
43586,9829,10121,28272,15314,9.9255e+12,60.077,13106.1,43586,4923,72,33465,33465,33069,33061,32762
45987,10609,10726,29821,16166,9.91653e+12,60.0782,13841.3,45987,5224,72,35261,35261,35125,35041,35046
3657,408,1766,2212,1445,6.98445e+12,51.7312,2100.06,3657,854,58,1891,1843,1145,1112,479
86317,4825,32124,53845,32472,8.11156e+12,57.9166,36589.2,86317,15649,72,54193,54193,29586,13988,8441
17619,811,4153,11425,6194,9.86095e+12,59.7992,5592.4,17619,2007,72,13466,13466,6267,6349,2872
52372,14871,23435,31969,20403,7.14389e+12,56.688,26084.4,52372,11413,72,28937,28937,25035,21339,20522
54040,10418,20774,33588,20452,7.95821e+12,57.285,23746.1,54040,10115,72,33266,33266,24788,14801,14605
48701,10260,11358,31588,17113,9.89748e+12,60.0685,14629,48701,5523,72,37343,37343,35743,34259,33938
45518,4775,13037,29091,16427,9.21449e+12,59.2064,15950.8,45518,6336,72,32481,32481,22922,14984,12618
26090,5431,9867,16262,9828,8.05152e+12,57.6731,11530.9,26090,4802,72,16223,16223,12499,8943,8158
34586,3898,18235,27078,7508,79406300000,8.97386,18606.2,34586,16403,11,16351,16351,6721,7542,5919
40109,1106,9714,25952,14157,9.80913e+12,59.9212,12470.7,40109,4731,72,30395,30395,18460,12205,3868
42500,5800,9874,27575,14925,9.92201e+12,60.0852,12797.9,42500,4808,72,32626,32626,27728,26584,19551
74637,8963,39573,44475,30162,6.07017e+12,54.5692,42679.7,74637,19256,72,35064,35064,22677,8267,7872
76950,14324,17850,49906,27044,9.92336e+12,60.1283,22657.5,76950,8691,72,59100,59100,54787,53799,47603
85346,8641,19817,55344,30002,9.91831e+12,60.1423,25070.7,85346,9649,72,65529,65529,49252,48923,29274
3182,826,1649,1911,1271,6.42307e+12,48.4035,1938.35,3182,786,64,1533,1516,1446,1395,1421
18055,219,1100,14366,3689,5.74432e+13,11.99,1532.45,18055,747,14,16955,16955,11127,6787,14332
10157,109,435,8041,2116,5.85676e+13,11.9795,759.629,10157,431,13,9722,9722,6816,4261,8424
75322,5229,23163,47855,27467,8.9451e+12,58.8663,27488.7,75322,11266,72,52159,52159,30873,17616,13002
96927,15986,33938,60846,36081,8.39362e+12,58.1768,39016.2,96927,16516,72,62989,62989,45587,25104,24325
34627,3810,8747,22340,12287,9.65323e+12,59.7015,11167.1,34627,4246,72,25880,25880,19362,18754,11388
47257,374,14338,30058,17199,9.00443e+12,58.9553,17282,47257,6974,72,32919,32535,12801,5481,1721
40439,6888,13149,25569,14870,8.71855e+12,58.1641,15678.1,40439,6383,72,27290,27290,22979,17163,15828
36525,8017,8498,23685,12840,9.93229e+12,60.0673,11079.6,36525,4140,72,28027,28027,27442,27311,26642
53819,13421,14301,34589,19230,9.48368e+12,59.5614,17726.1,53819,6957,72,39518,39518,38468,37119,36872
3146,562,774,2041,1105,1.01037e+13,58.4339,1164.36,3146,375,62,2372,2372,2115,2059,1865
56859,7155,13273,36862,19997,9.90019e+12,60.0874,16991.5,56859,6460,72,43586,43586,36269,34551,23967
52064,12529,23552,31743,20321,7.09062e+12,56.61,26166.9,52064,11472,72,28512,28512,23431,17496,17472
95390,5551,50680,74709,20681,79532800000,8.99324,51299,95390,45604,11,44710,44710,14702,17184,12237
25192,4967,5855,16344,8848,9.93847e+12,60.0135,7769.1,25192,2852,72,19337,19337,18033,16849,16595
44240,16117,22730,34601,9639,79109700000,8.99571,23158.1,44240,20454,11,21510,21510,16466,17044,15907
42849,13016,15165,26877,15972,8.36056e+12,58.143,17719.2,42849,7384,72,27684,27684,26056,23916,23482
91989,8574,21399,59644,32345,9.91335e+12,60.1323,26996.3,91989,10425,72,70590,70590,51884,51512,28878
15040,1148,8488,8878,6162,5.66237e+12,53.3529,9320.69,15040,4114,72,6552,6519,3338,1536,1070
46180,4815,10769,29939,16241,9.90894e+12,60.072,13896.6,46180,5240,72,35411,35411,27091,25917,16322
35753,9799,9987,22898,12855,9.32899e+12,59.32,12396.1,35753,4863,72,25766,25766,25614,25477,25559
75829,27808,30337,46927,28902,7.74918e+12,56.8684,34195.4,75829,14757,72,45492,45492,44781,43782,43780
65812,7169,15260,42685,23127,9.9122e+12,60.111,19473.9,65812,7420,72,50552,50552,38787,28069,24374
23198,3126,5487,15039,8159,9.86321e+12,59.8677,7271.42,23198,2658,72,17711,17711,14359,14282,10388
43473,8525,13820,27537,15936,8.81523e+12,58.7322,16525.8,43473,6728,72,29653,29653,25726,20300,19226
97737,12805,22653,63393,34344,9.92437e+12,60.1498,28555.8,97737,11032,72,75084,75084,63160,46866,42996
61754,13381,14380,40040,21714,9.90836e+12,60.1026,18369.7,61754,6996,72,47374,47374,46176,45904,44322
24086,2708,5679,15614,8472,9.87658e+12,59.9038,7517.01,24086,2761,72,18407,18407,14816,10065,8986
80160,14829,18640,51984,28176,9.91545e+12,60.1326,23614.6,80160,9080,72,61520,61520,55978,55864,49298
48877,382,12375,31522,17355,9.65255e+12,59.7677,15584.3,48877,6025,72,36502,36406,11420,5976,1848
54208,611,12600,35160,19048,9.92594e+12,60.112,16175.6,54208,6137,72,41608,41608,12170,13571,2659
35788,7864,11887,22581,13207,8.66138e+12,58.4709,14151.9,35788,5790,72,23901,23901,20121,15765,15651
33230,2517,12110,20789,12441,8.20967e+12,57.9054,14164.7,33230,5887,72,21120,21120,12250,7331,5618
15633,3208,7850,9402,6231,6.42885e+12,55.544,8795.28,15633,3807,72,7783,7783,5387,3202,2800
78819,18054,21204,50604,28215,9.44141e+12,59.542,25908.2,78819,10321,72,57615,57615,53085,47769,47655
92607,4920,27019,59090,33517,9.1408e+12,55.6228,32278.3,92607,13140,72,65588,65588,43329,16977,15910
38949,5491,10948,24919,14030,9.3069e+12,59.3016,13525.1,38949,5333,72,28001,28001,22986,16068,14643
60595,4360,15861,38976,21619,9.54038e+12,59.648,19660.8,60595,7727,72,44734,44734,24842,14782,12635
65311,20809,22551,41063,24248,8.45602e+12,57.8938,26212.3,65311,10965,72,42760,42760,41302,39585,39748
90422,5364,21042,58630,31792,9.90783e+12,60.1338,26559.8,90422,10243,72,69380,69380,46552,46093,18422
64931,6007,20499,41156,23775,8.8399e+12,58.7907,24278.1,64931,9981,72,44432,44432,30442,14012,13373
73494,8563,17055,47664,25830,9.91879e+12,60.1346,21681.1,73494,8302,72,56439,56439,46186,43800,28874
3451,771,847,2236,1215,9.87182e+12,58.5717,1270.19,3451,401,63,2604,2604,2542,2526,2518
94291,18803,29823,59753,34538,8.83002e+12,58.7978,35001.5,94291,14520,72,64468,64468,56639,49154,47248
53362,9253,15117,34125,19237,9.25634e+12,59.0523,18454.6,53362,7350,72,38245,38245,32836,25493,23780
95964,7720,52741,75268,20696,79986200000,8.99713,53345.6,95964,47464,11,43223,43223,15242,17065,13431
30814,9041,9713,19542,11272,8.84408e+12,58.7078,11767.2,30814,4720,72,21101,21101,20678,20068,20162
6444,614,1743,4147,2297,9.51532e+12,58.7629,2390.62,6444,844,72,4701,4701,3313,3269,1848
16138,1311,4128,10398,5740,9.64821e+12,59.5226,5445.16,16138,2008,72,12010,12010,6872,4132,3125
64617,14260,15457,41825,22792,9.83166e+12,60.0077,19570.4,64617,7525,72,49160,49160,47503,47458,45661
15329,1312,6973,9339,5990,7.11069e+12,56.378,7969.45,15329,3396,72,8356,8356,5327,3087,1875
26549,6693,10155,16518,10031,7.98732e+12,57.6129,11833.4,26549,4942,72,16394,16394,13865,11236,10964
16472,3117,3866,10680,5792,9.92619e+12,59.886,5233.92,16472,1880,72,12606,12606,11615,11578,10600
78333,678,47038,45716,32617,5.16411e+12,54.2819,49863.2,78333,22912,72,31295,29601,17563,11296,1246
37929,8223,8889,24580,13349,9.89424e+12,60.0274,11547.6,37929,4326,72,29040,29040,28341,27468,27330
75911,6205,32552,46591,29320,7.38176e+12,56.9517,36256.3,75911,15853,72,43359,43359,21628,12963,8793
97305,11577,22618,63095,34210,9.90723e+12,60.1389,28499.1,97305,11003,72,74687,74687,61424,58322,38935
20478,3915,4797,13282,7196,9.89787e+12,59.904,6420.37,20478,2324,72,15681,15681,14408,13230,13018
3955,463,963,2563,1392,9.90599e+12,58.646,1428,3955,458,66,2992,2992,2295,1670,1618
10382,1027,5213,6254,4128,6.44024e+12,55.2971,5907.65,10382,2525,72,5169,5121,2870,1216,822
78529,3185,3304,62163,16366,5.85681e+13,12.0018,4235.04,78529,1679,19,75225,75225,74211,73489,74754
11155,328,2650,7227,3928,9.92416e+12,59.7143,3660.55,11155,1290,72,8505,8505,5177,5102,1243
7325,1510,1727,4751,2574,9.99795e+12,59.4445,2464.02,7325,834,72,5598,5598,5335,5278,5080
74762,16249,34789,45407,29355,6.90303e+12,55.9224,38250.8,74762,16928,72,39973,39973,32660,24227,23946
82610,5197,19203,53577,29033,9.91699e+12,60.133,24308.9,82610,9350,72,63407,63407,35290,20438,18011
19525,3881,4589,12667,6858,9.87236e+12,59.8237,6148.95,19525,2222,72,14936,14936,14102,13908,12838
10384,1048,2491,6734,3650,9.84188e+12,59.5863,3447.54,10384,1204,72,7893,7893,5787,4045,3584
86704,10135,20135,56235,30469,9.92009e+12,60.1427,25458.5,86704,9806,72,66569,66569,51948,51663,34014
72932,22634,23032,46227,26705,8.82783e+12,58.788,27199.6,72932,11204,72,49900,49900,49541,49118,49102
86947,19268,27026,55186,31761,8.90322e+12,58.8881,31891.2,86947,13163,72,59921,59921,53131,45182,44953
77605,10191,18220,50291,27314,9.87637e+12,60.0829,23051.3,77605,8860,72,59385,59385,47715,36516,33426
60284,6575,18825,38238,22046,8.89025e+12,58.8473,22389.2,60284,9171,72,41459,41459,28655,28383,15147
82710,2265,19216,53634,29076,9.92545e+12,60.1357,24324.7,82710,9361,72,63494,63494,23798,25158,8267
11051,717,2578,7179,3872,9.96635e+12,59.765,3584,11051,1254,72,8473,8473,5721,5672,2490
15668,3208,3693,10159,5509,9.89246e+12,59.8311,5009.03,15668,1788,72,11975,11975,11286,10537,10623
60010,5049,13925,38916,21094,9.91956e+12,60.1186,17822,60010,6778,72,46085,46085,30678,29741,17273
25082,3608,10168,15497,9585,7.70174e+12,57.2627,11727.4,25082,4953,72,14914,14914,10615,6283,5227
46893,8909,14751,29730,17163,8.86232e+12,58.3908,17641.1,46893,7180,72,32142,32142,26179,19212,19008
83385,23139,27697,52605,30780,8.61985e+12,58.542,32271.4,83385,13477,72,55688,55688,52288,51414,46679
34529,3046,8045,22392,12137,9.91476e+12,60.0637,10513.9,34529,3916,72,26484,26484,18004,11844,10318
46945,7207,10947,30437,16508,9.91674e+12,60.0806,14114.4,46945,5332,72,35998,35998,31506,25420,24032
31886,464,7398,20686,11200,9.93532e+12,60.0204,9708.95,31886,3594,72,24488,24488,14332,9312,1922
31394,6935,14184,19154,12240,7.08475e+12,56.4611,15926.8,31394,6900,72,17210,17210,14192,13325,9229
6899,739,2601,4308,2591,8.1878e+12,57.1819,3204.78,6899,1266,72,4298,4250,3116,1798,1859
86865,31823,48161,68158,18707,80090300000,8.98555,48731.4,86865,43336,11,38704,38704,28917,29457,28390
32433,5596,15099,19710,12723,6.93179e+12,56.349,16852.3,32433,7355,72,17334,17334,12418,6666,6652
71963,10444,24281,45334,26629,8.5541e+12,58.4453,28290.5,71963,11823,72,47682,47682,38358,26091,23306
52143,2164,12120,33809,18334,9.92981e+12,60.107,15581.6,52143,5904,72,40023,40023,17831,8322,7580
15234,1641,6621,9347,5887,7.35094e+12,56.0042,7640.03,15234,3208,72,8613,8613,4681,3027,2481
9495,2009,2289,6148,3347,9.89554e+12,59.5199,3176.93,9495,1114,72,7206,7206,6818,6512,6519
41675,9841,20739,25076,16599,6.49822e+12,55.0898,22780.9,41675,10087,72,20936,20936,17345,12386,11424
94738,19902,30817,59884,34854,8.71486e+12,58.665,35959,94738,15011,72,63921,63921,54477,43347,43099
49848,4702,13755,31945,17903,9.35644e+12,59.3947,16931.3,49848,6691,72,36093,36093,24553,15614,12815
97218,13331,23619,62863,34355,9.7759e+12,59.9722,29423.1,97218,11501,72,73599,73599,59335,45653,41876
4999,104,1258,3241,1758,9.87927e+12,58.914,1804.44,4999,610,72,3741,3423,2164,2120,404
60331,12131,56614,40906,19425,8.66529e+12,3.75247,56734,60331,17672,30,3717,3717,594,594,601
89730,8366,27639,56991,32739,8.93401e+12,58.9303,32653.9,89730,13455,72,62091,62091,46043,27015,26424
98187,19765,23776,63501,34686,9.78353e+12,59.991,29639,98187,11573,72,74411,74411,68763,63392,61943
21900,4574,7875,13709,8191,8.31491e+12,57.968,9359.31,21900,3832,72,14025,14025,11241,7976,8074
84923,7339,19724,55072,29851,9.92748e+12,60.1398,24949.4,84923,9608,72,65199,65199,47129,46767,24927
27156,3995,8607,17213,9943,8.84344e+12,58.6573,10455.8,27156,4189,72,18549,18549,13894,13763,8338
14254,893,3813,9160,5094,9.55844e+12,59.2943,4990.81,14254,1857,72,10441,10441,7085,6994,3151
74723,653,17408,48448,26275,9.90386e+12,60.1157,22093.3,74723,8475,72,57315,57315,32872,32385,2766
9808,598,2367,6355,3453,9.86961e+12,59.5211,3278.17,9808,1149,72,7441,7441,4945,4883,2041
75814,11336,23615,48105,27709,8.89265e+12,58.8672,27941.3,75814,11499,72,52199,52199,37357,37048,19210
88294,43563,49115,52200,36094,5.72936e+12,54.7869,52519.6,88294,23913,72,39179,39179,37041,35052,34714
65912,7571,15324,42743,23169,9.92268e+12,60.1188,19537.4,65912,7465,72,50588,50588,41242,39069,25502
99520,35480,49979,59793,39727,6.42935e+12,55.8563,54119.3,99520,24343,72,49541,49541,42706,34750,34641
88058,17938,24067,56462,31596,9.38092e+12,59.0337,29217.2,88058,11708,72,63991,63991,57015,47501,45265
14664,2470,4626,9309,5355,8.84744e+12,58.4819,5772.8,14664,2239,72,10038,10038,8186,5720,5198
63337,11479,22252,39746,23591,8.37678e+12,58.2191,25790.9,63337,10835,72,41085,41085,32722,21200,18655
21876,3758,6588,13934,7942,9.0574e+12,58.8595,8175.73,21876,3205,72,15288,15288,12190,9282,8538
13512,3353,4006,8614,4898,9.19048e+12,58.8074,5100.49,13512,1951,72,9506,9506,8706,7707,7561
25466,7976,8604,16049,9417,8.56102e+12,58.1156,10323.4,25466,4169,72,16862,16862,16120,15309,15394
78843,2773,27132,49577,29266,8.46826e+12,58.3565,31427.8,78843,13212,72,51711,51711,31839,12635,7526
27300,11112,13488,16447,10853,6.55089e+12,54.8854,14958.9,27300,6549,72,13812,13812,13388,12914,12875
47155,7893,22221,28604,18551,6.8268e+12,55.7089,24570.4,47155,10803,72,24934,24934,17215,10941,9069
75893,20587,34214,46284,29609,7.09187e+12,56.5722,37799.1,75893,16654,72,41679,41679,32799,22360,22142
6637,1157,1977,4239,2398,9.15358e+12,58.3453,2619.62,6637,958,72,4660,4660,4212,3718,3874
19792,1006,6735,12461,7331,8.57649e+12,58.231,8135.62,19792,3281,72,13057,13057,7782,1807,1531
79066,7659,22352,50570,28496,9.26294e+12,58.8969,26999.5,79066,10869,72,56714,56714,38233,26533,22372
55816,49595,55816,0,55816,7.99986,0,55816,55816,55816,1,0,0,0,0,0
47180,1220,11002,30602,16578,9.90956e+12,60.0726,14185.8,47180,5356,72,36178,36178,13174,4761,4574
7442,1316,1771,4838,2604,9.88018e+12,59.3698,2516.7,7442,852,72,5671,5671,5031,5018,4421
40417,15025,19114,24501,15916,6.82679e+12,56.2538,21181,40417,9310,72,21303,21303,19202,16347,15827
65031,7600,20775,41175,23856,8.78928e+12,58.7232,24540.8,65031,10116,72,44256,44256,30967,15343,14778
4656,303,1119,3020,1636,1.01187e+13,59.0215,1640.57,4656,545,71,3537,3537,1889,1284,1065
69169,14257,25354,43227,25942,8.18342e+12,57.9919,29090,69169,12347,72,43815,43815,38666,31682,30053
21076,2046,4913,13669,7407,9.93973e+12,59.9747,6573.74,21076,2393,72,16163,16163,12022,11933,7081
30891,7569,8180,19853,11038,9.51098e+12,59.5394,10357.7,30891,3984,72,22711,22711,22229,21816,21839
57956,13624,18482,36702,21254,8.81136e+12,58.7393,21902.4,57956,9003,72,39474,39474,35408,34387,28689
38043,7610,10362,24404,13639,9.42776e+12,59.4417,12913.8,38043,5048,72,27681,27681,24241,20994,20192
26448,5635,6152,17154,9294,9.91749e+12,60.007,8143.97,26448,2985,72,20296,20296,19564,19549,18835
73010,7525,16956,47351,25659,9.92233e+12,60.1232,21551.1,73010,8256,72,56054,56054,42262,30313,25371
63722,14608,29258,38769,24953,6.9875e+12,56.5063,32317.5,63722,14248,72,34464,34464,26681,15996,13598
96084,12336,23923,62024,34060,9.6963e+12,59.6318,29633.3,96084,11644,72,72161,72161,55467,39452,34959
76650,15764,33036,47013,29637,7.35502e+12,56.8826,36758.2,76650,16088,72,43614,43614,35472,26465,24251
41416,5364,12183,26409,15007,9.12959e+12,59.0926,14854,41416,5928,72,29233,29233,22819,21945,13627
27673,5017,9465,17411,10262,8.53441e+12,58.2786,11286.1,27673,4611,72,18208,18208,15118,14316,10063
65943,6952,15354,42766,23177,9.90966e+12,60.0728,19568.5,65943,7469,72,50589,50589,39213,26869,23621
82885,14346,19273,53746,29139,9.90477e+12,60.1239,24396.1,82885,9372,72,63612,63612,57777,56397,47977
37389,11128,13524,23400,13989,8.27167e+12,58.0012,15786.1,37389,6586,72,23865,23865,21975,19478,18955
95262,23206,38889,58811,36451,7.64197e+12,57.3448,43509.7,95262,18940,72,56373,56373,44966,29373,25663
40490,13170,14504,25367,15123,8.30778e+12,58.0656,16929.7,40490,7063,72,25986,25986,24944,23498,23393
21371,4909,5214,13829,7542,9.78959e+12,59.7187,6871.74,21371,2529,72,16157,16157,15817,15736,15416
41492,2104,24248,24331,17161,5.37754e+12,53.6685,25998.8,41492,11790,72,17244,17244,10713,6602,3052
93064,6333,35252,57948,35116,8.0282e+12,57.8165,39969.6,93064,17173,72,57812,57812,37388,13390,12577
26125,294,11169,16046,10079,7.41061e+12,56.9015,12729.6,26125,5435,72,14956,14524,7020,2611,1092
43736,11728,28337,34293,9443,2.23456e+13,5.52604,32498.2,43736,9447,13,15399,15399,12663,13705,7538
47694,11928,21633,29065,18629,7.07077e+12,55.6593,24067.8,47694,10533,72,26061,26061,19709,12245,12155
11433,3936,5541,6912,4521,6.70388e+12,51.4335,6310.34,11433,2676,72,5892,5892,5229,4296,4310
27922,3256,9114,17651,10271,8.71784e+12,58.4976,10983.6,27922,4437,72,18808,18808,13104,8616,7431
7656,3046,4290,4532,3124,5.78388e+12,34.1459,4797.81,7656,2073,69,3366,3366,3366,3366,3366
54747,3010,20228,34177,20570,8.15097e+12,57.609,23293,54747,9848,72,34519,34519,15973,7670,3996
50768,3863,18112,31817,18951,8.32007e+12,58.1152,21036.5,50768,8818,72,32656,32656,19295,10085,7005
72644,9514,32897,44272,28372,7.0729e+12,56.4858,36340.5,72644,16021,72,39747,39747,24677,15060,11843
91752,1511,21289,59511,32241,9.91279e+12,60.1444,26881.3,91752,10364,72,70463,70463,22479,24666,6070
36274,11725,33898,24969,11305,9.21567e+12,3.99559,33991.6,36274,11319,9,2376,2376,820,2376,827
1235,110,343,799,436,9.6575e+12,55.4421,539.14,1235,154,47,892,892,502,478,362
90901,20040,32847,56870,34031,8.24436e+12,57.6895,37586.5,90901,15987,72,58054,58054,44945,29488,28895
23877,1932,5570,15491,8386,9.93894e+12,59.9628,7399.98,23877,2709,72,18307,18307,11672,7318,6398
31045,755,1805,24686,6359,5.75934e+13,11.9936,2376.57,31045,1281,14,29240,29240,22355,17626,26140
44261,4742,13053,28221,16040,9.11364e+12,59.0797,15870.1,44261,6355,72,31208,31208,22231,21991,11375
75715,4438,4841,60295,15420,5.7239e+13,12.0017,5744.57,75715,2412,20,70874,70874,68356,66605,69716
95791,10799,22741,62027,33764,9.85038e+12,60.0678,28509.7,95791,11074,72,73050,73050,57879,38956,34265
69176,16931,23911,43486,25690,8.45343e+12,58.3222,27750.1,69176,11643,72,45265,45265,39084,30695,28739
78604,12356,18215,50980,27624,9.92401e+12,60.1492,23115.1,78604,8873,72,60389,60389,53287,51640,41353
40014,4712,9363,25946,14068,9.914e+12,60.0567,12138.9,40014,4560,72,30651,30651,25037,23731,15641
97500,4263,52166,58019,39481,6.00933e+12,55.3314,56007.4,97500,25405,72,45334,45334,24295,10465,5653
90063,27396,28608,57048,33015,8.8127e+12,58.5248,33580.8,90063,13931,72,61455,61455,61181,61069,60927
72519,29405,35222,43785,28734,6.6467e+12,56.1116,38489.7,72519,17159,72,37297,37297,34378,30464,29606
64011,1443,14831,41519,22492,9.92479e+12,60.1346,18949.1,64011,7220,72,49180,49180,17317,18543,5567
43196,9718,10093,28012,15184,9.897e+12,60.0572,13053.5,43196,4910,72,33103,33103,32624,32194,32307
88352,11459,20510,57291,31061,9.91507e+12,60.14,25923.3,88352,9985,72,67842,67842,54751,54476,38704
12081,3811,8908,6775,5306,3.43109e+12,51.7223,9394.2,12081,4330,68,3173,3125,2125,882,1066
5219,728,1314,3378,1841,9.79046e+12,58.8494,1876.15,5219,636,72,3905,3905,3162,2527,2449
78584,9716,34095,48165,30419,7.31141e+12,56.9193,37879,78584,16597,72,44489,44489,30169,16978,13360
37573,3668,9060,24322,13251,9.80663e+12,59.9172,11679.2,37573,4406,72,28513,28513,20402,19768,11964
65797,8436,16452,42471,23326,9.68135e+12,59.8397,20581.9,65797,8009,72,49345,49345,38470,38218,25188
24633,5801,8939,15417,9216,8.22844e+12,57.8996,10562.7,24633,4341,72,15694,15694,13781,11243,10707
4427,487,1067,2872,1555,1.00026e+13,58.9002,1572.67,4427,513,70,3360,3360,2569,1778,1659
54897,1387,12749,35599,19298,9.92804e+12,60.1136,16364.2,54897,6210,72,42148,42148,15444,16389,5274
3012,558,954,1919,1093,9.0477e+12,54.2009,1309.45,3012,459,60,2058,2058,1485,897,965
59791,7833,13872,38775,21016,9.92737e+12,60.1192,17754.7,59791,6758,72,45919,45919,38602,28632,26299
30408,3088,7102,19718,10690,9.91401e+12,60.0372,9326.7,30408,3459,72,23306,23306,17467,17348,10417
86307,9700,26038,54911,31396,9.01864e+12,59.0307,30927.9,86307,12675,72,60269,60269,40027,23041,17928
85256,12540,43763,51051,34205,6.29298e+12,55.3021,47332.2,85256,21314,72,41493,41493,26834,15213,11609
96411,25563,28302,61473,34938,9.12747e+12,59.172,33728.6,96411,13788,72,68109,68109,65497,61884,61259
12714,822,3030,8241,4473,9.89111e+12,59.6919,4143.56,12714,1472,72,9684,9684,6538,6466,2843
21969,667,6333,14032,7937,9.22568e+12,57.882,7951.64,21969,3078,72,15636,15588,6007,2391,623
57761,7608,24015,35592,22169,7.55852e+12,57.1896,27018.7,57761,11695,72,33746,33746,23715,11946,11670
99251,22493,54423,77840,21411,79961400000,8.92388,55039.3,99251,48973,11,44828,44828,25279,26475,24102
46794,3431,10908,30338,16456,9.91535e+12,60.0796,14069.6,46794,5314,72,35886,35886,25016,24797,11743
99274,14844,27436,63604,35670,9.34187e+12,59.4415,33120.3,99274,13360,72,71838,71838,59578,56648,38832
1633,256,448,1065,568,9.4794e+12,56.0692,687.302,1633,206,51,1185,1185,980,785,779
11747,5663,6187,7025,4722,6.16223e+12,55.0113,6920.71,11747,3001,72,5560,5560,5497,5433,5525
29514,7623,8667,18820,10694,9.13726e+12,58.3236,10700.8,29514,4211,72,20847,20847,20414,20281,19876
76476,15666,26402,48069,28407,8.463e+12,58.3392,30579.6,76476,12862,72,50074,50074,41866,30675,28047
73414,9406,17031,47605,25809,9.92563e+12,60.1393,21649.9,73414,8297,72,56383,56383,45281,45054,31716
37848,5273,9564,24410,13438,9.66034e+12,59.7389,12164.1,37848,4653,72,28284,28284,23608,17160,15847
57634,3182,14545,37171,20463,9.66348e+12,59.8006,18228.7,57634,7086,72,43089,43089,23043,22534,11018
88935,17492,26847,56579,32356,9.01388e+12,59.0314,31861.8,88935,13073,72,62088,62088,55156,45599,43534
87907,20095,20407,57005,30902,9.92007e+12,60.1417,25794.3,87907,9935,72,67500,67500,67127,66708,66694
64962,14453,15120,42124,22838,9.91068e+12,60.1029,19281.9,64962,7355,72,49842,49842,48896,48046,47893
62725,30759,62725,0,62725,7.99987,0,62725,62725,62725,1,0,0,0,0,0
86706,31188,43238,67731,18975,78792400000,8.99767,43851.2,86706,38909,11,43468,43468,35081,35867,34309
12465,2231,5441,7643,4822,7.29946e+12,56.4979,6314.29,12465,2645,72,7024,7024,5197,3900,3707
30764,6586,10228,19411,11353,8.63675e+12,57.8907,12238.5,30764,4976,72,20536,20536,17217,13308,13375
86832,25301,45588,51824,35008,6.13956e+12,55.0446,49139.2,86832,22193,72,41244,41244,35925,28590,27052
5215,877,1308,3375,1840,9.79804e+12,58.9093,1873.93,5215,630,72,3907,3907,3385,3269,2705
1448,348,449,929,519,9.41021e+12,55.3874,659.785,1448,213,48,999,999,862,808,815
42410,1642,9854,27510,14900,9.91968e+12,60.071,12772.9,42410,4794,72,32556,32556,14138,14529,5916
64612,12169,19098,41175,23437,9.10533e+12,59.1082,22952,64612,9304,72,45514,45514,38124,29418,29182
65969,10790,25502,40983,24986,7.92626e+12,57.3185,28999.7,65969,12417,72,40467,40467,29457,17786,14844
61630,13178,22248,38574,23056,8.26316e+12,58.0716,25663.5,61630,10832,72,39382,39382,32615,23396,21250
42064,2030,14379,26466,15598,8.51985e+12,58.3441,16930.9,42064,7004,72,27685,27685,17054,5047,4199
82783,25765,33305,51193,31590,7.71554e+12,56.942,37444.2,82783,16210,72,49478,49478,45033,38993,37608
36609,5786,8529,23744,12865,9.90973e+12,60.0511,11117.6,36609,4145,72,28080,28080,24032,23962,19199
77356,33097,34777,47200,30156,7.1191e+12,56.6788,38421.2,77356,16938,72,42579,42579,42361,42043,42187
25828,3099,7827,16437,9391,9.01257e+12,58.8407,9633.16,25828,3807,72,18001,18001,13912,13789,9098
92117,16985,21363,59741,32376,9.92883e+12,60.147,26968.5,92117,10407,72,70754,70754,65465,58297,56640
48103,3341,11155,31199,16904,9.91432e+12,60.0813,14397.1,48103,5420,72,36948,36948,25594,17925,11685
94802,2722,21984,61482,33320,9.9232e+12,60.1527,27732,94802,10709,72,72818,72818,27909,10787,10158
56976,9709,19940,35766,21210,8.40007e+12,58.2468,23189,56976,9709,72,37036,37036,28002,17367,17136
97241,2153,27902,62124,35117,9.2087e+12,59.2769,33415.3,97241,13586,72,69339,69339,27105,26318,7950
82744,30779,43708,64789,17955,79475100000,8.99677,44286.3,82744,39332,11,39036,39036,30422,31139,29721
86986,2464,21552,56176,30810,9.71187e+12,59.8928,26800.3,86986,10493,72,65434,65434,23758,13359,6270
53164,170,12429,34465,18699,9.90466e+12,60.0803,15940.3,53164,6054,72,40735,40679,22977,22604,1151
60724,7073,19550,38424,22300,8.7513e+12,58.6794,23097.6,60724,9509,72,41174,41174,26372,15282,11888
15651,974,3625,10162,5489,1.00112e+13,59.9127,4939.81,15651,1765,72,12026,12026,8097,5600,3421
24281,629,7139,15484,8797,9.11926e+12,58.7374,8879.93,24281,3463,72,17142,17094,7513,3519,1699
36142,6813,13421,22565,13577,8.1292e+12,57.279,15599,36142,6519,72,22721,22721,18494,17424,11465
69361,12032,20908,44145,25216,9.02425e+12,59.0246,24972.4,69361,10183,72,48453,48453,40035,28556,25846
76112,6070,17718,49359,26753,9.91325e+12,60.1215,22477.4,76112,8628,72,58394,58394,41436,29105,20590
63306,18782,22947,39604,23702,8.23282e+12,57.9133,26437.2,63306,11156,72,40359,40359,37169,33484,33442
90344,2994,24100,58045,32299,9.47021e+12,59.5911,29401.4,90344,11737,72,66244,66244,41322,40716,10680
14549,2631,7139,8786,5763,6.63365e+12,55.7686,8047.41,14549,3476,72,7410,7410,5528,3652,3366
58943,13001,22713,36633,22310,7.94638e+12,57.6797,25900.5,58943,11059,72,36230,36230,30575,23953,23900
49191,523,21244,30173,19018,7.34049e+12,56.164,23822.7,49191,10326,72,27947,27312,13348,9446,2161
37992,6451,11276,24206,13786,9.10054e+12,59.044,13758.7,37992,5487,72,26716,26716,21110,14547,14379
19204,1790,8594,11726,7478,7.1837e+12,54.7533,9790.65,19204,4181,72,10610,10610,6647,2008,2041
68062,7540,16486,44021,24041,9.78455e+12,59.9653,20773.7,68062,8021,72,51576,51576,39333,39055,24359
98599,50190,53507,77292,21307,79813300000,8.99734,54126.5,98599,48148,11,45092,45092,42636,42902,42386
5316,618,1336,3436,1880,9.77272e+12,58.9144,1908.96,5316,645,72,3980,3980,2937,2059,1833
80623,709,4746,64115,16508,5.7548e+13,12.0017,5681.09,80623,2598,20,75877,75877,49336,29560,58115
49436,10672,14465,31542,17894,9.15003e+12,59.1321,17558.9,49436,7045,72,34971,34971,31847,27651,26705
96831,11326,39063,59866,36965,7.70424e+12,57.0219,43783.9,96831,19008,72,57768,57768,37572,13889,12931
89575,25158,32052,56100,33475,8.29036e+12,58.1452,36754.8,89575,15601,72,57523,57523,53451,52365,46695
5752,964,1369,3737,2015,9.96847e+12,59.2867,1982.82,5752,665,72,4383,4383,3902,3790,3272
10333,6847,7943,5740,4593,3.04959e+12,17.9406,8338.46,10333,3850,62,2390,2390,2390,2390,2390
94974,7215,22093,61588,33386,9.90533e+12,60.1259,27849,94974,10750,72,72881,72881,51244,35914,24593
32707,3877,7642,21216,11491,9.91156e+12,60.0119,9998.29,32707,3719,72,25065,25065,20533,14391,12990
29200,6986,7054,18900,10300,9.79948e+12,59.87,9188.81,29200,3429,72,22146,22146,22074,22064,22046
91240,21747,30568,57512,33728,8.58699e+12,58.0151,35490.2,91240,14869,72,60672,60672,53490,45549,44812
61118,3649,14254,39629,21489,9.89319e+12,60.056,18207,61118,6929,72,46864,46864,25250,25156,12577
54052,2468,17314,34215,19837,8.79133e+12,58.7085,20537.6,54052,8435,72,36738,36738,21932,21484,3850
21348,2108,6320,13609,7739,9.09567e+12,58.9256,7889.66,21348,3063,72,15028,15028,10137,10019,4264
61574,4525,28651,37401,24173,6.90621e+12,56.4064,31595,61574,13953,72,32923,32923,20593,6184,5793
75142,26397,40908,58913,16229,79845900000,8.97903,41446.3,75142,36809,11,34234,34234,24853,25562,24162
42446,13323,18196,26060,16386,7.3834e+12,56.7018,20494.4,42446,8842,72,24250,24250,22026,19424,19548
50629,9591,11782,32839,17790,9.92397e+12,60.0945,15158,50629,5739,72,38847,38847,35606,32531,31780
47158,4171,10994,30582,16576,9.92001e+12,60.0811,14174.8,47158,5355,72,36164,36164,24815,23950,14173
59545,16044,31586,35480,24065,6.06419e+12,55.3716,34164.9,59545,15373,72,27959,27959,20397,13237,11411
98480,8712,24272,63626,34854,9.72986e+12,59.9189,30117.9,98480,11819,72,74208,74208,52581,26999,25969
2778,587,690,1797,981,9.81188e+12,58.0731,1049.91,2778,327,59,2088,2088,1980,1977,1947
7902,1075,2302,5050,2852,9.26776e+12,58.6835,3039.89,7902,1121,72,5600,5600,3791,1741,1729
19856,7434,7725,12331,7525,7.89209e+12,57.4194,9052.92,19856,3748,72,12131,12131,11808,11451,11430
52728,11715,18591,33076,19652,8.36624e+12,58.1789,21625.2,52728,9046,72,34137,34137,28857,22724,22540
41381,3087,12809,26275,15106,8.93151e+12,58.8452,15430.2,41381,6234,72,28572,28572,19040,7787,7535
34506,701,1985,27423,7083,5.76505e+13,12.0039,2595.51,34506,1244,20,32521,32521,23627,16711,27305
27616,11422,14490,21617,5999,79373600000,8.99124,14821.9,27616,13036,11,13126,13126,10883,11119,10666
57774,13605,15589,37088,20686,9.44108e+12,59.5116,19204.5,57774,7590,72,42185,42185,40111,40058,37748
3921,1096,1237,2487,1434,9.12058e+12,54.0143,1667.18,3921,596,64,2684,2684,2487,2354,2396
31305,7405,11896,19501,11804,8.0161e+12,57.6349,13816.2,31305,5774,72,19409,19409,15510,11837,10905
2274,11,650,1466,808,9.4891e+12,56.697,948.272,2274,312,59,537,153,12,189,37
86085,17057,36516,52907,33178,7.43926e+12,56.3838,40660.3,86085,17784,72,49569,49569,35810,19630,19150
67222,16429,36465,39920,27302,5.91628e+12,54.9618,39248.9,67222,17761,72,30757,30757,23324,15377,13462
64579,22096,31077,39049,25530,6.69917e+12,56.165,34067.9,64579,15131,72,33502,33502,31255,28265,27630
44022,13890,16726,27402,16620,8.00903e+12,57.7336,19255.2,44022,8134,72,27296,27296,23868,20620,19819
69640,18933,25864,43450,26190,8.1199e+12,57.4719,29600.1,69640,12578,72,43776,43776,40394,35830,34806
82662,3909,45891,48891,33771,5.75047e+12,55.0035,49115.7,82662,22354,72,36771,36771,19754,6702,4078
29765,582,6968,19295,10470,9.8996e+12,59.995,9152.84,29765,3384,72,22797,22797,7634,2264,2317
7801,669,5066,4491,3310,4.58551e+12,36.8754,5504.49,7801,2446,70,2735,2676,1406,378,0
99458,33117,49511,59839,39619,6.4904e+12,55.9268,53679.4,99458,24113,72,49947,49947,43956,35687,33925
70701,2491,31639,43168,27533,7.13094e+12,56.6986,35034.4,70701,15399,72,39062,39062,18118,9067,5097
63104,9492,14696,40924,22180,9.90553e+12,60.1024,18757.7,63104,7154,72,48408,48408,40795,40647,31539
71194,6873,22497,45123,26071,8.84364e+12,58.798,26575.8,71194,10959,72,48697,48649,23547,31353,10878
12893,672,3849,8220,4673,9.12606e+12,58.7312,4904.74,12893,1874,72,9044,8996,5962,2412,2348
97757,1222,30958,61936,35821,8.8333e+12,58.8027,36293.5,97757,15081,72,66799,66799,31911,21744,3897
35511,9509,13740,22072,13439,7.91416e+12,57.4042,15845.8,35511,6681,72,21771,21771,18289,14237,14180
81238,2163,26748,51297,29941,8.65891e+12,58.5946,31238.9,81238,13025,72,54490,54442,33226,14399,7149
81657,5744,27365,51475,30182,8.58667e+12,58.497,31838.9,81657,13327,72,54292,54292,31176,17562,12495
23540,2040,5490,15271,8269,9.91269e+12,59.9672,7304.52,23540,2663,72,18050,18050,12077,7799,6815
81515,3527,4049,64672,16843,5.80946e+13,11.9975,4986.74,81515,3377,14,77466,77466,73183,69560,75551
48500,1540,2033,38397,10103,5.85649e+13,11.9958,2756.6,48500,2029,13,46467,46467,42056,38165,44501
60816,3936,14170,39440,21376,9.91397e+12,60.1006,18105.1,60816,6899,72,46646,46646,31791,31486,13571
69616,5733,16183,45153,24463,9.91473e+12,60.1197,20597.3,69616,7880,72,53433,53433,38129,37831,19350
58399,7725,13605,37861,20538,9.91598e+12,60.1128,17410.6,58399,6627,72,44794,44794,36285,36106,25945
97552,8368,22686,63262,34290,9.90545e+12,60.1297,28576.7,97552,11037,72,74866,74866,50440,48829,28451
80924,9187,40416,63219,17705,78759700000,8.99618,41007.7,80924,36366,11,40508,40508,16901,19565,14248
45511,2789,10610,29511,16000,9.91726e+12,60.0795,13700.5,45511,5168,72,34901,34901,23509,23280,9573
51818,7785,14519,33170,18648,9.30196e+12,59.3484,17787.2,51818,7070,72,37299,37299,30951,22318,20291
86271,16620,33399,53586,32685,7.91681e+12,57.6785,37775.7,86271,16265,72,52872,52872,39769,27237,23882
76395,26751,35010,46497,29898,7.00061e+12,56.5303,38568.5,76395,17047,72,41385,41385,36011,29763,29607
88794,21028,27261,56420,32374,8.94982e+12,58.9166,32239,88794,13263,72,61533,61533,56136,49811,49681
79323,20928,23410,50559,28764,9.10406e+12,56.0272,28001,79323,11397,72,55913,55913,52869,48769,47860
34686,8059,10947,21985,12701,8.87118e+12,58.7302,13199.1,34686,5333,72,23739,23739,21929,19534,19028
85381,18661,19836,55370,30011,9.91435e+12,60.1336,25089.9,85381,9657,72,65545,65545,63924,62443,62125
81471,12401,18943,52832,28639,9.91791e+12,60.1284,23985.8,81471,9225,72,62528,62528,53031,52836,41473
88058,27770,28569,55668,32390,8.72326e+12,58.6777,33407,88058,13910,72,59489,59489,58537,57324,57114
1781,964,1301,1008,773,3.82541e+12,34.0831,1426.48,1781,625,40,480,480,302,99,267
98810,14006,40335,61017,37793,7.64191e+12,57.3498,45102.4,98810,19644,72,58475,58475,42264,26327,22053
75932,9815,22209,48445,27487,9.13318e+12,59.1673,26645.3,75932,10808,72,53723,53723,40159,26191,22438
71161,8272,23470,44916,26245,8.66426e+12,58.5878,27480.9,71161,11433,72,47691,47691,36382,27214,24438
64929,3944,15109,42108,22821,9.91554e+12,60.1083,19268.6,64929,7355,72,49820,49820,33588,33257,13652
70908,3351,19111,45518,25390,9.43982e+12,59.5392,23411,70908,9310,72,51797,51797,32502,21205,8859
42823,2593,2691,34097,8726,5.73039e+13,11.995,3362.63,42823,1753,14,40132,40132,39483,39018,39835
48457,1290,11298,31423,17034,9.91197e+12,60.0633,14551.3,48457,5495,72,37159,37159,13619,14456,4602
43273,4849,10107,28062,15211,9.91527e+12,60.0748,13069.7,43273,4923,72,33166,33166,26729,18375,16382
62650,7715,14846,40586,22064,9.85059e+12,60.0265,18864.7,62650,7218,72,47804,47804,37925,28473,25879
64593,9033,19073,41180,23413,9.0972e+12,59.1139,22931.9,64593,9283,72,45520,45520,36851,26687,24132
4772,162,1154,3096,1676,9.87554e+12,58.8942,1686.6,4772,556,72,3618,3618,1307,1372,538
31067,7916,11447,19405,11662,8.16878e+12,56.679,13386.7,31067,5554,72,19620,19620,17133,13700,13098
43007,6571,10050,27886,15121,9.91055e+12,60.0493,12994.6,43007,4893,72,32957,32957,27906,27801,21843
65384,11888,15198,42392,22992,9.92033e+12,60.1273,19384.2,65384,7404,72,50186,50186,45389,45288,39643
64249,10681,22283,40363,23886,8.43895e+12,57.8142,25887.4,64249,10844,72,41966,41966,33289,21893,19156
70765,12500,16429,45893,24872,9.9162e+12,60.1396,20910.7,70765,8001,72,54336,54336,48622,48506,41721
87028,15944,30019,54702,32326,8.45797e+12,58.0437,34685.3,87028,14610,72,57009,57009,46310,31554,28224
14610,2277,3459,9475,5135,9.90921e+12,59.747,4699.39,14610,1679,72,11151,11151,9820,8063,7726
46008,19679,23310,27604,18404,6.38598e+12,55.7371,25485.1,46008,11356,72,22698,22698,21800,20659,20455
65963,8720,15347,42774,23189,9.91086e+12,60.1086,19562,65963,7470,72,50616,50616,42661,40798,29275
42351,9024,16048,26378,15973,8.03989e+12,57.7501,18498.9,42351,7811,72,26303,26303,21560,15089,13671
6123,1482,2907,3711,2412,6.95338e+12,54.8354,3398.09,6123,1409,70,3216,3216,2416,1302,1279
23770,3627,6751,15214,8556,9.26734e+12,59.1643,8480.55,23770,3284,72,17019,17019,13771,10706,9961
34102,17878,18502,26731,7371,79823200000,8.95079,18862.8,34102,16648,11,15600,15600,15284,15286,15297
90186,859,44361,54350,35836,6.55975e+12,56.0069,48239.3,90186,21605,72,45825,44961,21195,2466,1951
26143,2098,7440,16717,9426,9.25137e+12,59.029,9306.83,26143,3613,72,18703,18703,12742,8527,5565
4021,290,1041,2600,1421,9.81233e+12,58.472,1502.14,4021,504,69,2980,2980,1564,1120,965
60418,6843,27407,36819,23599,7.07567e+12,56.5996,30355.9,60418,13352,72,33011,33011,23015,11372,11066
3068,708,752,1991,1077,9.99211e+12,58.4316,1139.36,3068,361,62,2316,2316,2264,2262,2268
61970,9525,24818,38353,23617,7.75063e+12,57.4423,28072.7,61970,12086,72,37152,37152,27642,18679,16325
81701,579,18990,52983,28718,9.92124e+12,60.1377,24046.3,81701,9251,72,62711,62711,17065,19368,2866
95334,36009,51805,74738,20596,79843800000,8.99721,52413.3,95334,46616,11,43529,43529,33710,34351,33080
21770,3795,8724,13473,8297,7.78439e+12,57.2914,10124.7,21770,4250,72,13046,13046,9609,6297,5438
11183,1422,3707,7064,4119,8.68132e+12,56.4431,4626.26,11183,1783,72,7476,7476,5556,3373,3371
3392,602,845,2202,1190,9.87636e+12,58.3449,1258.04,3392,407,64,2547,2547,2209,2200,1966
54732,18389,22572,33754,20978,7.59311e+12,56.3864,25465.2,54732,10974,72,32160,32160,30060,27588,27718
14810,4676,4948,9351,5459,8.66355e+12,58.2321,6077.5,14810,2406,72,9862,9862,9533,9182,9184
19807,515,12832,15530,4277,2.23731e+13,5.52815,14743.1,19807,4278,13,6975,6975,2203,3094,1137
2839,1228,1261,1754,1085,7.40028e+12,43.1229,1555.18,2839,593,61,1578,1578,1578,1578,1578
23950,9179,9639,14823,9127,7.75141e+12,57.2179,11147.3,23950,4679,72,14311,14311,13901,13513,13634
3183,574,773,2062,1121,1.01645e+13,58.591,1169.68,3183,375,62,2410,2410,2128,1902,1960
14795,1116,3498,9593,5202,9.91939e+12,59.7788,4750.22,14795,1701,72,11297,11297,6848,6755,3847
39716,6040,9231,25751,13965,9.9242e+12,60.0749,11996.6,39716,4497,72,30485,30485,25881,25784,20376
3825,264,1002,2475,1350,9.64907e+12,58.1924,1446.36,3825,478,67,2823,2823,1589,1519,902
52072,14432,15370,33202,18870,9.10939e+12,59.0976,18592.1,52072,7483,72,36702,36702,35655,35402,34072
90545,9891,28787,57346,33199,8.80352e+12,58.7732,33782.6,90545,14008,72,61758,61758,47118,33395,29347
74331,22578,69463,51187,23144,9.20624e+12,3.99494,69598.6,74331,23174,9,4868,4868,1580,4868,1587
32852,5500,10403,20817,12035,8.86515e+12,58.7089,12556.5,32852,5067,72,22449,22449,18210,13225,13246
22479,216,1307,17874,4605,5.76007e+13,11.9909,1791.61,22479,929,14,21172,21172,13567,7705,17752
6739,1774,3400,4061,2678,6.57029e+12,46.5924,3903.16,6739,1639,71,3339,3339,3161,2958,3126
22681,1576,5295,14713,7968,9.93731e+12,59.9399,7050.47,22681,2575,72,17386,17386,11975,8360,5467
84566,12429,20601,54670,29896,9.76822e+12,59.9644,25749.2,84566,10032,72,63965,63965,54109,40652,37464
55513,18605,19692,34797,20716,8.34526e+12,58.1726,22851.2,55513,9591,72,35821,35821,34964,34202,34119
47035,8592,23166,36723,10312,78656700000,8.98909,23618.3,47035,20846,11,23869,23869,12313,13735,10909
37367,5461,8693,24226,13141,9.9288e+12,60.0679,11322.7,37367,4231,72,28674,28674,23880,23795,18129
65823,11181,19653,41924,23899,9.06509e+12,59.0646,23555.1,65823,9570,72,46170,46170,37972,28287,28101
73632,10052,27579,45910,27722,8.073e+12,57.863,31475.5,73632,13426,72,46053,46053,31060,19602,16128
91440,32049,45784,54972,36468,6.44494e+12,55.673,49652.3,91440,22283,72,45656,45656,38993,29810,27824
42446,972,12002,27151,15295,9.26923e+12,58.0846,14768,42446,5824,72,30444,30444,11307,9900,1286
20691,180,8199,12825,7866,7.8201e+12,56.8507,9559.39,20691,3976,72,12492,12184,7066,3927,640
36073,6188,8408,23395,12678,9.91528e+12,60.0393,10962.5,36073,4090,72,27665,27665,24937,24318,20497
76993,7518,17928,49925,27068,9.91047e+12,60.1189,22733,76993,8730,72,59065,59065,43330,41537,25395
43223,3078,10049,28036,15187,9.91711e+12,60.0692,13012.2,43223,4891,72,33174,33174,19893,12124,10711
51947,1492,12098,33686,18261,9.902e+12,60.0769,15550.5,51947,5877,72,39849,39849,15059,15892,5306
99213,7318,23046,64340,34873,9.91682e+12,60.1476,29022.5,99213,11226,72,76167,76167,53239,52779,24998
21962,4394,7321,13857,8105,8.67245e+12,58.3652,8851.57,21962,3566,72,14641,14641,12378,9819,9798
68633,860,16017,44499,24134,9.9078e+12,60.1089,20371.4,68633,7802,72,52616,52616,15569,17298,3383
41480,9331,9631,26898,14582,9.93662e+12,60.089,12497,41480,4687,72,31849,31849,31416,31047,31081
92334,551,22949,59612,32722,9.70272e+12,59.8898,28470.1,92334,11174,72,69385,69290,19736,10806,2903
1900,149,497,1236,664,9.86181e+12,56.9063,765.35,1900,237,54,1403,1403,895,382,474
96727,4731,28448,61668,35059,9.11531e+12,59.1607,33889,96727,13854,72,68279,68231,45077,17612,16497
82979,4985,22146,53309,29670,9.47265e+12,59.5824,27073,82979,10785,72,60833,60833,30965,14211,11919
46847,8368,19967,28779,18068,7.41685e+12,55.9194,22465.9,46847,9704,72,26880,26880,19205,10214,9963
84414,5164,19621,54748,29666,9.90697e+12,60.1301,24825.8,84414,9549,72,64793,64793,35446,20267,17885
87766,13213,46412,52312,35454,6.09359e+12,55.2185,49970.8,87766,22604,72,41354,41354,28142,17216,14077
30598,9971,12039,18979,11619,7.86708e+12,57.4607,13888.1,30598,5861,72,18559,18559,17837,16809,16807
32342,6044,7507,20984,11358,9.9184e+12,60.0118,9847,32342,3645,72,24835,24835,23064,20722,20225
44749,6317,12830,28602,16147,9.22039e+12,59.2169,15701.4,44749,6246,72,31919,31919,24475,24248,15534
62578,6206,18967,39798,22780,9.00891e+12,58.9892,22686.3,62578,9234,72,43611,43611,30811,15781,15204
28672,3016,6710,18592,10080,9.92013e+12,60.0023,8828.28,28672,3268,72,21962,21962,16596,16486,10128
51057,3562,11891,33115,17942,9.91315e+12,60.0835,15291.9,51057,5788,72,39166,39166,27016,26773,12138
21752,224,5096,14114,7638,9.89894e+12,59.8775,6795.63,21752,2469,72,16656,16656,4661,5242,949
63067,9632,14676,40897,22170,9.91131e+12,60.1195,18739,63067,7146,72,48391,48391,42298,40886,32094
1431,297,384,928,503,1.03102e+13,56.2341,599.491,1431,185,49,1047,1047,928,925,908
13100,2314,3109,8495,4605,9.88141e+12,59.7208,4251.8,13100,1508,72,9991,9991,9024,8804,7563
19527,2715,5030,12580,6947,9.59498e+12,59.5178,6556.18,19527,2434,72,14497,14497,11817,8636,8736
90232,1387,20948,58513,31719,9.91e+12,60.1355,26460.5,90232,10189,72,69284,69284,21864,5465,5670
81979,55443,81979,0,81979,7.9999,0,81979,81979,81979,1,0,0,0,0,0
56586,16026,17999,35846,20740,8.8141e+12,58.7448,21357.2,56586,8760,72,38587,38587,36789,36740,34756
18252,5236,7086,11341,6911,7.93207e+12,57.4104,8328.76,18252,3441,72,11166,11166,9441,7846,7484
17980,285,4213,11654,6326,9.94614e+12,59.9058,5676.35,17980,2046,72,13767,13767,4261,1052,1168
70935,9723,16485,46003,24932,9.9165e+12,60.1197,20968.5,70935,8026,72,54450,54450,44628,35236,32648
80302,3237,21090,51648,28654,9.52858e+12,59.6494,25905.2,80302,10270,72,59212,59212,26416,25737,9427
88651,22463,26391,56463,32188,9.06837e+12,59.0929,31418.3,88651,12848,72,62260,62260,58852,58031,53218
67087,606,17850,43099,23988,9.4824e+12,59.5926,21969.5,67087,8696,72,49237,49083,28390,27869,2785
54022,4253,28884,42321,11701,79618900000,8.97486,29345.5,54022,25992,11,25138,25138,8641,10035,7265
97537,44542,49489,58518,39019,6.36792e+12,55.7755,53522.6,97537,24108,72,48048,48048,46237,43859,43364
97498,10410,48159,58716,38782,6.5336e+12,55.5089,52288.8,97498,23443,72,49339,49339,30950,9442,8738
65306,3599,15198,42351,22955,9.91487e+12,60.0947,19376.1,65306,7395,72,50108,50108,25835,25925,12487
48742,35151,48742,0,48742,7.99984,0,48742,48742,48742,1,0,0,0,0,0
48660,3180,21611,29737,18923,7.17569e+12,56.7096,24120.6,48660,10514,72,27049,27049,16200,7223,3080
49682,11236,11574,32220,17462,9.91894e+12,60.0788,14895.6,49682,5634,72,38108,38108,37652,37230,37349
98706,36189,53069,58691,40015,5.97049e+12,55.2936,56935.4,98706,25847,72,45637,45637,42199,37523,36524
22110,1074,6579,14088,8022,9.11545e+12,58.9455,8184.29,22110,3204,72,15531,15531,7473,3845,2452
82804,14680,25262,52633,30171,8.98861e+12,58.9822,29958.4,82804,12306,72,57542,57542,54219,49739,48747
54628,1519,17148,34635,19993,8.87022e+12,58.8125,20425.1,54628,8354,72,37480,37480,16331,9142,5265
3938,2116,3938,0,3938,7.99797,0,3938,3938,3938,1,0,0,0,0,0
31317,7268,7280,20321,10996,9.91667e+12,60.0096,9559.39,31317,3532,72,24037,24037,24037,24037,24037
3922,786,1272,2498,1424,8.86686e+12,52.461,1698.36,3922,600,64,2650,2650,2566,2561,2538
59835,9047,17877,38111,21724,9.05205e+12,58.855,21481.3,59835,8687,72,41958,41958,34479,24174,21916
69728,24492,27109,43297,26431,7.8899e+12,57.6336,30760.7,69728,13194,72,42619,42619,41092,40649,38688
16793,1837,3941,10885,5908,9.93929e+12,59.8884,5329.02,16793,1915,72,12852,12852,10148,7045,6334
59117,10970,24343,36462,22655,7.60603e+12,56.8303,27426,59117,11854,72,34774,34774,26580,17034,16841
25665,6047,13443,15331,10334,6.17189e+12,55.3557,14776.7,25665,6543,72,12222,12222,8604,4399,4432
49214,2174,11457,31912,17302,9.93228e+12,60.0846,14751.5,49214,5581,72,37757,37757,24188,23921,7568
97517,16419,31882,61608,35909,8.68931e+12,58.6368,37141.9,97517,15527,72,65635,65635,52595,37275,36703
61320,3344,25196,37833,23487,7.61063e+12,56.7533,28379.9,61320,12253,72,36124,36124,18467,8082,4234
97461,7461,27319,62375,35086,9.29132e+12,59.3791,32886.5,97461,13304,72,70142,70142,47369,46815,19386
12268,1862,7958,9612,2656,2.23487e+13,5.50473,9152.35,12268,2656,13,4310,4310,3208,3087,1434
11752,577,2744,7633,4119,9.95176e+12,59.759,3798.45,11752,1331,72,9008,9008,4253,4327,2041
71784,5955,16672,46556,25228,9.9178e+12,60.1249,21204,71784,8115,72,55112,55112,36266,35180,20241
14732,6476,6593,9001,5731,7.16816e+12,54.6162,7572.95,14732,3202,72,8139,8139,8016,7937,7931
43750,6392,14930,27528,16222,8.52569e+12,58.3669,17571.4,43750,7273,72,28820,28820,22881,17279,15803
5284,784,1324,3426,1858,9.85723e+12,58.9599,1893.09,5284,644,72,3960,3960,3174,2319,2393
40405,196,15627,25101,15304,7.92498e+12,57.6061,17962.6,40405,7604,72,24778,24275,14067,7072,1055
56294,6034,19098,35444,20850,8.55212e+12,58.4089,22352,56294,9304,72,37196,37196,24726,15136,12287
39974,15017,19586,31203,8771,78541600000,8.9943,20003.4,39974,17619,11,20388,20388,16763,17210,16334
6579,181,2289,4143,2436,8.54325e+12,57.5416,2892.2,6579,1112,72,4290,4184,2562,1250,629
12383,2474,4266,7791,4592,8.52768e+12,58.0099,5241.33,12383,2073,72,8117,8117,6909,5557,5627
67585,2742,15711,43820,23765,9.91446e+12,60.1217,20017.8,67585,7651,72,51874,51874,32954,32577,9687
47795,10592,11144,30995,16800,9.91848e+12,60.0715,14360,47795,5424,72,36651,36651,35953,35924,35289
14553,597,3429,9429,5124,9.94754e+12,59.8325,4669.25,14553,1667,72,11124,11124,4899,2325,2179
70969,8187,23102,44855,26114,8.71181e+12,58.6517,27127.8,70969,11250,72,47867,47867,34206,21187,17681
61873,2883,14401,40120,21753,9.90989e+12,60.1219,18399.9,61873,7013,72,47472,47472,22373,22765,10094
68286,8017,23399,42959,25327,8.49697e+12,58.372,27208.2,68286,11398,72,44887,44887,31836,16522,15931
79760,20504,28897,49887,29873,8.24266e+12,58.0504,33131.9,79760,14071,72,50863,50863,44176,36342,36191
26469,2026,7542,16924,9545,9.24466e+12,59.0906,9421.65,26469,3669,72,18927,18927,12063,4017,3753
50269,8376,50269,0,50269,7.99984,0,50269,50269,50269,1,0,0,0,0,0
11164,146,2658,7233,3931,9.91626e+12,59.6817,3668.59,11164,1289,72,8506,8473,2296,2667,586
82575,8631,24110,52688,29887,9.13753e+12,58.7796,28877.3,82575,11725,72,58465,58465,43660,26243,25567
23201,5976,7965,14602,8599,8.51551e+12,58.2225,9549.27,23201,3878,72,15236,15236,13400,11316,11314
39728,16484,18023,24219,15509,7.07378e+12,56.139,20122.1,39728,8763,72,21705,21705,20948,20102,20253
14293,2571,3379,9271,5022,9.89077e+12,59.7719,4601.38,14293,1640,72,10914,10914,10021,8902,8701
3390,289,1393,2093,1297,7.9531e+12,55.9861,1737.86,3390,678,59,1997,1949,689,437,468
88982,24958,41034,54103,34879,6.96102e+12,56.504,45062.3,88982,19985,72,47948,47948,42087,35306,35248
41997,9114,11532,26921,15076,9.36844e+12,59.3975,14297.2,41997,5609,72,30465,30465,28076,28014,25346
66739,747,15460,43288,23451,9.92742e+12,60.1286,19723.1,66739,7524,72,51279,51279,14984,16735,3234
21653,575,6299,13828,7825,9.1835e+12,59.0315,7892.21,21653,3060,72,15354,15354,9066,5817,1489
50071,6252,11663,32479,17592,9.91004e+12,60.0815,15009.1,50071,5677,72,38408,38408,31852,22938,20850
52706,1274,12264,34179,18527,9.91006e+12,60.0878,15755.7,52706,5969,72,40442,40442,14539,15481,4828
97954,31297,36422,61109,36845,8.12007e+12,57.927,41396,97954,17744,72,61532,61532,58330,53912,53087
97266,253,22568,63088,34178,9.91126e+12,60.1366,28449.3,97266,10976,72,74698,74698,18540,883,1917
52664,22349,24234,32036,20628,6.975e+12,56.4759,26844.3,52664,11801,72,28430,28430,27342,26305,26256
80824,6259,25858,51162,29662,8.78743e+12,58.7466,30379.8,80824,12597,72,54966,54966,35400,12348,11440
34295,8136,10661,21780,12515,8.90645e+12,53.8763,12909.8,34295,5172,72,23634,23634,23634,23634,23634
71727,28703,30906,44000,27727,7.34941e+12,56.9666,34425.9,71727,15051,72,40821,40821,40318,39749,39964
29649,3392,6933,19216,10433,9.91886e+12,60.0286,9110.87,29649,3376,72,22716,22716,18467,17474,11423
11871,448,3578,7568,4303,9.03952e+12,55.8632,4570.78,11871,1721,72,8293,8293,3789,1877,1590
9138,3931,4482,7134,2004,78562700000,8.9698,4676.9,9138,4026,11,4656,4656,4223,4276,4190
23122,4137,13035,13653,9469,5.67184e+12,54.4777,14185,23122,6333,72,10087,10087,7083,3610,3695
49284,3680,15932,31170,18114,8.74352e+12,58.6545,18911.3,49284,7754,72,33352,33352,21512,13485,7067
62733,13371,31368,37718,25015,6.4618e+12,55.453,34201.3,62733,15266,72,31365,31365,22288,11765,11404
69057,15763,33623,41684,27373,6.63461e+12,56.0843,36753,69057,16380,72,35434,35434,28283,19588,17603
28328,1285,6632,18370,9958,9.92042e+12,59.9969,8729.35,28328,3230,72,21696,21696,9953,4793,4366
72671,12050,16875,47126,25545,9.92557e+12,60.1343,21451.1,72671,8220,72,55796,55796,49967,48614,40223
64679,13569,16918,41615,23064,9.54789e+12,59.6524,20930.5,64679,8239,72,47761,47761,43651,38874,38781
95006,18901,22034,61615,33391,9.91394e+12,60.1459,27798.5,95006,10719,72,72972,72972,68466,64192,63059
22797,5097,9222,14092,8705,7.69571e+12,56.35,10671.7,22797,4478,72,13575,13575,11270,8176,7516
83430,13139,19385,54097,29333,9.91475e+12,60.1381,24536,83430,9438,72,64045,64045,54997,54807,43975
95088,1117,3994,75272,19816,5.85703e+13,12.0015,5019.03,95088,3278,19,91094,91094,65415,42621,76717
46637,3686,10869,30234,16403,9.91533e+12,60.0864,14022.8,46637,5295,72,35768,35768,22807,14413,12587
82489,2374,23477,52725,29764,9.23985e+12,59.3069,28281.2,82489,11432,72,59012,59012,35142,34522,5813
5216,1061,1263,3392,1824,9.82478e+12,58.9814,1834.47,5216,605,72,3953,3953,3729,3679,3510
35441,8857,15956,21624,13817,7.11257e+12,56.6201,17884.4,35441,7772,72,19485,19485,16663,12893,12056
67037,11107,23046,42155,24882,8.48588e+12,58.3517,26791.8,67037,11227,72,43991,43991,35487,24501,21893
77566,21244,22616,49488,28078,9.15646e+12,59.1934,27135.6,77566,11018,72,54950,54950,54084,54049,53265
29578,3058,10399,18571,11007,8.38817e+12,58.1179,12299.3,29578,5055,72,19179,19179,12857,5486,5248
50072,16328,16716,31581,18491,8.60596e+12,58.4845,19695,50072,8137,72,33356,33356,32886,32352,32303
11868,1205,4300,7427,4441,8.29978e+12,57.6989,5223.04,11868,2089,72,7568,7568,4937,2932,1888
56605,9714,13954,36567,20038,9.74879e+12,59.8812,17602.3,56605,6797,72,42651,42651,36469,30564,29014
69450,32634,33814,41925,27525,6.63186e+12,56.0767,36958.2,69450,16470,72,35636,35636,35205,34614,34667
36886,17242,19227,28866,8020,79308300000,8.9756,19613.6,36886,17298,11,17659,17659,16244,16385,16121
76466,18048,36141,46346,30120,6.81596e+12,56.1951,39623.5,76466,17603,72,40325,40325,31082,18464,15493
68121,4822,15845,44176,23945,9.90326e+12,60.1009,20179.6,68121,7705,72,52276,52276,36263,35938,16588
74811,6664,17421,48505,26306,9.90363e+12,60.1097,22111.8,74811,8478,72,57390,57390,39555,38211,22595
58771,710,3466,46735,12036,5.75452e+13,12.0025,4263.62,58771,1461,20,55305,55305,36181,22148,40620
94512,11027,21920,61304,33208,9.91759e+12,60.1464,27656.1,94512,10674,72,72592,72592,56747,56425,37298
73186,8173,16992,47462,25724,9.92551e+12,60.1332,21595.7,73186,8278,72,56194,56194,43327,43071,27555
39703,9811,10167,25590,14113,9.60942e+12,59.6944,12863.2,39703,4946,72,29536,29536,29108,29015,28585
28272,813,1758,22505,5767,5.73371e+13,11.9925,2301.71,28272,1161,14,26514,26514,20208,15484,23676
61012,20246,21981,38188,22824,8.2632e+12,58.0849,25375.8,61012,10699,72,39031,39031,38272,38046,37182
60192,15926,19032,38148,22044,8.82854e+12,58.5471,22579.4,60192,9260,72,41160,41160,38015,37908,34370
27188,10319,14301,16226,10962,6.13949e+12,55.3261,15690.4,27188,6956,72,12887,12887,11130,9101,9205
33693,3771,10960,21293,12400,8.73676e+12,57.7416,13138.2,33693,5333,72,22733,22733,15610,10686,9245
82365,1420,19150,53407,28958,9.90524e+12,60.1239,24245.8,82365,9314,72,63215,63215,20428,22356,5702
74859,2334,17430,48532,26327,9.90857e+12,60.1254,22124.2,74859,8487,72,57429,57429,35451,35006,8390
74513,12919,37461,58226,16287,78841200000,8.89774,38026.3,74513,33707,11,37052,37052,18395,20524,16285
92005,9695,21347,59673,32332,9.91938e+12,60.1484,26950.5,92005,10394,72,70658,70658,54674,52200,32843
72932,8675,16996,47292,25640,9.90186e+12,60.1157,21588.5,72932,8272,72,55936,55936,43922,43666,29232
80974,453,18755,52515,28459,9.92804e+12,60.1529,23780.9,80974,9136,72,62219,62219,16449,1759,2473
56304,15020,27797,33915,22389,6.56412e+12,55.9542,30409.4,56304,13541,72,28507,28507,21983,14454,14235
90106,27655,31904,56503,33603,8.34226e+12,58.2046,36651.4,90106,15538,72,58202,58202,53978,49057,48955
7153,961,1749,4632,2521,9.92026e+12,59.3316,2464.36,7153,850,72,5404,5404,4356,4321,3257
27885,3718,6547,18082,9803,9.90002e+12,59.9634,8616.85,27885,3184,72,21338,21338,17255,17167,12386
52988,2605,12815,34278,18710,9.79304e+12,59.9443,16287.7,52988,6233,72,40173,40173,18419,19049,8106
72539,20812,39183,43095,29444,5.94057e+12,55.2287,42160.4,72539,19080,72,33356,33356,28082,20791,19269
28238,7592,11120,17514,10724,7.8412e+12,56.963,12860.4,28238,5395,72,17118,17118,14759,12076,12042
34159,7380,8513,22053,12106,9.7064e+12,59.7811,10913.8,34159,4141,72,25646,25646,24427,22731,22570
94213,10088,29081,59827,34386,8.92619e+12,58.9259,34305,94213,14163,72,65132,65132,46562,24550,23832
86117,43129,44515,51509,34608,6.24326e+12,55.5875,48091.6,86117,21681,72,41602,41602,41268,40962,41103
70640,2302,22425,44741,25899,8.82062e+12,54.0918,26472,70640,10918,72,48215,48209,11467,15962,30
31411,4666,13556,19276,12135,7.36975e+12,56.5096,15351.5,31411,6587,72,17855,17807,16339,15761,15542
15148,5755,6201,9365,5783,7.64618e+12,57.0246,7250.79,15148,3015,72,8947,8947,8888,8835,8914
39493,4832,11416,25222,14271,9.20747e+12,59.1624,13997.9,39493,5558,72,28077,28077,21062,13615,11693
44542,5766,12213,28556,15986,9.38115e+12,59.1889,15116.6,44542,5937,72,32329,32329,24788,24576,15646
28452,7010,8490,18133,10319,9.07439e+12,58.9298,10452.4,28452,4123,72,19962,19962,18275,17864,15563
29695,3176,6891,19269,10426,9.92282e+12,60.0349,9077.18,29695,3351,72,22804,22804,17409,17299,10909
58497,1940,13641,37931,20566,9.91882e+12,60.0986,17446.5,58497,6644,72,44856,44856,18064,7388,6867
76468,14738,20437,49115,27353,9.46625e+12,59.5833,25034.2,76468,9956,72,56031,56031,50034,41885,40000
89446,835,20775,58011,31435,9.90813e+12,60.1249,26243,89446,10108,72,68671,68671,39618,39035,3765
56767,11634,13245,36808,19959,9.90121e+12,60.044,16962,56767,6446,72,43522,43522,41650,41202,38645
17833,679,6453,11174,6659,8.26959e+12,57.8423,7714.92,17833,3136,72,11380,11236,7272,3200,2398
88209,1480,20479,57213,30996,9.91511e+12,60.1394,25882.3,88209,9973,72,67730,67730,21622,5543,5674
91356,37640,48949,71577,19779,79652100000,8.99803,49550.9,91356,44052,11,42407,42407,35572,35965,35199
42626,11510,12944,27115,15511,9.01026e+12,58.9387,15647.7,42626,6303,72,29682,29682,28448,26738,26569
27151,448,6317,17617,9534,9.91177e+12,59.9989,8350.5,27151,3066,72,20834,20834,6554,1676,1795
8192,1701,1933,5317,2875,9.91083e+12,59.4635,2732.47,8192,936,72,6259,6259,5931,5923,5708
87038,984,20207,56439,30599,9.91797e+12,60.1408,25548.6,87038,9838,72,66831,66831,19664,21903,4283
80594,10169,18680,52265,28329,9.92204e+12,60.1451,23685.1,80594,9095,72,61914,61914,51648,49256,34306
83531,16451,26917,52852,30679,8.74747e+12,58.1436,31555.8,83531,13091,72,56614,56614,46863,35366,34982
18701,3821,4456,12122,6579,9.8367e+12,59.8035,5960.78,18701,2158,72,14245,14245,13587,12784,12655
67216,1525,15633,43594,23622,9.90772e+12,60.114,19919.2,67216,7610,72,51583,51583,30952,30549,5556
35663,314,9753,22867,12796,9.40038e+12,59.4046,12173.8,35663,4746,72,25910,25718,14875,8123,1439
34308,1842,9543,21979,12329,9.33325e+12,59.3125,11877.6,34308,4644,72,24765,24765,15966,5653,5294
74558,3216,17374,48350,26208,9.90484e+12,60.1107,22050.2,74558,8455,72,57184,57184,25972,26571,11285
33345,4570,7780,21625,11720,9.90925e+12,60.044,10179,33345,3783,72,25565,25565,21728,20833,15378
29741,7044,7685,19163,10578,9.60187e+12,59.6201,9809.91,29741,3742,72,22056,22056,21347,20372,20356
9090,1826,2710,5797,3293,9.1191e+12,58.5682,3521.66,9090,1314,72,6380,6380,5398,5142,3938
10487,4565,6355,6110,4377,5.19665e+12,49.9085,6944.46,10487,3089,72,4132,4132,3493,2778,2983
86014,2709,5581,68515,17499,5.71825e+13,12.0014,6543.89,86014,3400,20,80433,80433,61648,47681,70863
92621,7403,45944,55748,36873,6.50978e+12,55.9033,49885.9,92621,22377,72,46677,46677,29357,9088,8438
66070,10000,15370,42853,23217,9.91193e+12,60.1123,19592.3,66070,7484,72,50700,50700,42842,42689,33280
26704,7356,7824,17044,9660,9.12122e+12,59.0058,9702.46,26704,3795,72,18880,18880,18234,17553,17616
78208,17799,38772,47076,31132,6.51175e+12,55.7699,42195.6,78208,18873,72,39436,39436,28078,15133,14438
5493,78,1827,3474,2019,8.68288e+12,57.6689,2368.88,5493,876,72,3666,2848,1149,249,325
32687,16152,17029,19536,13151,6.20077e+12,55.0563,18651,32687,8290,72,15658,15658,15238,14847,14907
63150,9526,30041,38234,24916,6.76988e+12,56.1134,33002.8,63150,14620,72,33109,33109,22702,13668,11028
3703,1143,1403,2313,1390,8.27789e+12,56.6608,1787.84,3703,683,68,2300,2300,2185,2064,2197
2961,1310,1643,2322,639,79812400000,8.43398,1741.38,2961,1470,11,1318,1318,1156,1156,1166
80038,9940,24439,50875,29163,8.96612e+12,58.9603,29004.8,80038,11897,72,55599,55599,42115,29680,26286
96125,5424,22341,62332,33793,9.91797e+12,60.1461,28154.9,96125,10882,72,73784,73784,49198,33811,18933
11698,183,4021,7374,4324,8.54162e+12,58.0286,4954.64,11698,1958,72,7677,7547,3214,1491,713
74314,6378,24035,47008,27306,8.73231e+12,58.6745,28230.2,74314,11700,72,50279,50231,29613,24350,20783
50094,9353,16649,31600,18494,8.63596e+12,58.5176,19633.3,50094,8111,72,33445,33445,27107,26898,19540
45650,8188,13990,29007,16643,8.97603e+12,58.9148,16837.7,45650,6814,72,31660,31660,25863,25682,18922
47597,5915,17464,29731,17866,8.19444e+12,57.9675,20202.7,47597,8507,72,30133,30085,22002,20317,19025
46950,407,11611,30329,16621,9.74027e+12,59.8464,14730.5,46950,5653,72,35339,35339,20280,13087,1848
3156,360,778,2056,1100,1.00276e+13,58.3932,1170.05,3156,378,62,2378,2378,1769,1756,1205
1087,201,302,706,381,1.09554e+13,55.0856,475.545,1087,147,45,785,785,646,641,612
35205,5625,15583,21528,13677,7.20866e+12,55.0096,17522.7,35205,7568,72,19622,19622,14254,8016,7884
93555,7569,24316,60213,33342,9.55785e+12,59.7028,29823.1,93555,11839,72,69239,69239,42390,41480,21562
52379,6972,20003,32579,19800,7.99909e+12,57.7341,22908.4,52379,9742,72,32376,32376,23225,12558,12170
90185,10332,21227,58431,31754,9.87725e+12,60.0906,26715,90185,10334,72,68958,68958,56202,38809,34678
32220,1332,9004,20628,11592,9.30395e+12,59.2708,11221.8,32220,4374,72,23216,23216,11540,6760,4549
77299,19764,24352,49008,28291,8.8467e+12,58.8101,28733.1,77299,11855,72,52947,52947,49058,48106,42604
99205,2649,33996,62390,36815,8.48992e+12,58.3979,39227.1,99205,16562,72,65209,65209,29307,5436,4553
61189,5082,14195,39694,21495,9.9255e+12,60.1188,18154.2,61189,6914,72,46994,46994,31006,30089,17356
14604,617,3459,9466,5138,9.87472e+12,59.7312,4699.2,14604,1675,72,11145,11145,4956,2359,2211
35778,6256,8390,23190,12588,9.90175e+12,60.0347,10925.2,35778,4084,72,27388,27388,24340,21473,20756
87660,25942,34045,54422,33238,7.90144e+12,57.5766,38472.4,87660,16580,72,53615,53615,49316,43498,42183
2390,1874,1900,1320,1070,2.85195e+12,28.8435,2027.04,2390,912,42,490,490,487,486,490
81898,16957,19046,53116,28782,9.90971e+12,60.1257,24115,81898,9271,72,62852,62852,60307,56894,56145
53587,7014,24791,32584,21003,6.94749e+12,56.3585,27430.4,53587,12058,72,28796,28796,18750,6952,6628
25725,5110,7282,16463,9262,9.26931e+12,59.1934,9126.42,25725,3541,72,18443,18443,16442,14173,14150
47074,6341,11805,30382,16692,9.67271e+12,59.7738,14922.7,47074,5738,72,35269,35269,27812,27634,18753
11388,334,2718,7379,4009,9.93285e+12,59.6168,3739.09,11388,1324,72,8670,8670,3261,3411,1231
21318,20158,21318,0,21318,7.99962,0,21318,21318,21318,1,0,0,0,0,0
69625,4105,16176,45151,24474,9.93165e+12,60.1294,20587.4,69625,7880,72,53449,53449,35842,24680,14214
81124,22491,28861,50849,30275,8.32111e+12,58.1698,33193.5,81124,14056,72,52263,52263,46669,40171,39979
51995,1174,24540,31522,20473,6.81379e+12,55.7532,27079.6,51995,11940,72,27455,27359,10987,2021,1311
41802,4745,9717,27107,14695,9.91799e+12,60.0654,12601.6,41802,4728,72,32085,32085,24834,24689,16028
81857,12593,20171,52874,28983,9.73423e+12,59.9099,25158.4,81857,9821,72,61686,61686,51918,51683,40024
75038,28252,31723,46130,28908,7.46009e+12,56.9462,35422.5,75038,15449,72,43315,43315,41987,40254,39923
43541,553,12351,27848,15693,9.25471e+12,59.2534,15167.8,43541,6012,72,31190,31049,12012,2164,2262
83326,19635,21031,53741,29585,9.64799e+12,59.8069,26063.2,83326,10229,72,62295,62295,60767,58658,58352
43915,5367,10248,28472,15443,9.92846e+12,60.0654,13244.6,43915,4992,72,33667,33667,26642,26488,18137
34879,649,10865,22147,12732,8.89572e+12,58.6631,13143.9,34879,5271,72,24014,23870,13944,6615,1762
24754,99,5765,16061,8693,9.94782e+12,59.9849,7647.96,24754,2806,72,18989,17514,10687,10527,582
20785,899,5951,13282,7503,9.25943e+12,57.7175,7503.44,20785,2894,72,14834,14812,8655,8517,1200
14451,2198,3420,9367,5084,9.91977e+12,59.7604,4649.5,14451,1662,72,11031,11031,9247,9214,7206
68801,8913,16420,44550,24251,9.8301e+12,60.019,20761.9,68801,7994,72,52381,52381,43345,41236,28096
96726,14484,44046,58919,37807,7.03037e+12,56.5895,48408.5,96726,21444,72,52680,52680,40502,26229,25843
71152,814,2977,56329,14823,5.85655e+13,11.9971,3855.97,71152,2972,13,68175,68175,48737,31488,59530
69699,7086,16183,45197,24502,9.9212e+12,60.1358,20604.9,69699,7883,72,53516,53516,40227,24543,23947
44816,1646,10398,29066,15750,9.91923e+12,60.0956,13456.6,44816,5056,72,34418,34418,21668,21413,6042
39362,14392,19816,23656,15706,6.42575e+12,55.6837,21746,39362,9650,72,19546,19546,17636,15032,14587
56689,2023,23006,35021,21668,7.68144e+12,57.3592,26007.6,56689,11204,72,33683,33683,19188,8822,1614
50690,19480,25945,39638,11052,79057100000,8.97625,26404.9,50690,23342,11,24745,24745,20034,20528,19560
49120,8849,11437,31850,17270,9.91684e+12,60.088,14731.7,49120,5565,72,37683,37683,34602,33879,29535
17663,5643,6643,11015,6648,8.09986e+12,56.9993,7874.73,17663,3219,72,11020,11020,10789,10450,10582
59207,8446,13797,38388,20819,9.92442e+12,60.0978,17640.9,59207,6721,72,45410,45410,37687,30325,28312
24263,10525,14147,14237,10026,5.40533e+12,53.7981,15303.4,24263,6869,72,10116,10116,9309,8178,8144
93010,9695,51392,55048,37962,5.78665e+12,54.7823,54969.7,93010,25031,72,41618,41618,26535,13724,8406
53152,3142,12367,34478,18674,9.91235e+12,60.0955,15885.5,53152,6020,72,40785,40785,21735,21724,10773
94427,23065,35981,58758,35669,7.99065e+12,57.6255,40748,94427,17506,72,58446,58446,51198,41323,39008
76668,13336,25885,48292,28376,8.55297e+12,58.4594,30117,76668,12599,72,50783,50783,39085,38738,24828
6784,1448,2119,4319,2465,9.03732e+12,53.4867,2761.88,6784,1015,72,4665,4665,4665,4665,4665
20694,8497,10875,12349,8345,6.1727e+12,52.6234,12002.9,20694,5291,72,9819,9819,8730,7298,7099
77547,18827,31390,47928,29619,7.68731e+12,57.3398,35295.4,77547,15270,72,46157,46157,38969,30536,30405
50253,6648,13869,32208,18045,9.3544e+12,59.3994,17068.9,50253,6750,72,36384,36384,28082,18314,18002
85941,16971,42049,51829,34112,6.59956e+12,56.0612,45791.9,85941,20481,72,43892,43892,33662,23373,20592
30752,646,7136,19947,10805,9.91426e+12,60.0093,9384.32,30752,3462,72,23616,23616,14118,9301,2507
67188,6230,17022,43333,23855,9.64148e+12,59.7776,21208.2,67188,8282,72,50166,50166,33621,22464,18814
32142,1750,8048,20746,11396,9.69717e+12,59.7535,10332.2,32142,3915,72,24094,24094,15887,10868,5916
22684,5487,7057,14396,8288,8.9348e+12,57.6798,8674.62,22684,3432,72,15627,15627,13937,13891,12042
64347,9916,30635,38961,25386,6.7674e+12,56.2395,33637.2,64347,14919,72,33712,33712,23505,14034,11521
94722,13269,24795,60934,33788,9.53003e+12,59.6749,30352.4,94722,12069,72,69927,69927,55056,37498,36834
81711,2667,24956,51935,29776,8.97688e+12,58.9751,29599.8,81711,12156,72,56755,56707,28397,24966,9461
44674,5239,14106,28318,16356,8.84508e+12,58.7363,16874.9,44674,6863,72,30568,30568,21719,11261,11019
31905,4269,8477,20507,11398,9.50228e+12,59.5081,10709.3,31905,4123,72,23428,23428,19167,18152,12102
9227,1526,2230,5978,3249,9.83008e+12,59.3985,3102,9227,1072,72,6997,6997,6104,6071,5170
31068,8371,20129,24361,6707,2.23427e+13,5.52256,23101.6,31068,6716,13,10939,10939,9009,9742,5377
99563,5740,28480,63616,35947,9.22059e+12,59.0504,34115.2,99563,13869,72,71083,71083,45334,29340,13748
83257,5149,19336,53984,29273,9.92164e+12,60.1455,24478.4,83257,9418,72,63921,63921,43280,42861,17905
11463,163,2679,7437,4026,9.95507e+12,59.7055,3711.27,11463,1304,72,8784,8784,2549,2853,659
3836,328,926,2483,1353,9.99e+12,58.9119,1382.56,3836,450,66,2910,2910,1862,1801,1153
51746,6538,24501,31351,20395,6.81335e+12,55.8373,27025.2,51746,11930,72,27245,27245,18983,9548,7233
8001,1942,2451,5095,2906,9.15212e+12,58.4147,3180,8001,1193,72,5550,5550,5092,5064,4782
12389,1328,2945,8031,4358,9.89838e+12,59.6943,4038.32,12389,1429,72,9444,9444,7049,4310,4272
8322,957,5390,6524,1798,2.24307e+13,5.50817,6211.04,8322,1807,13,2932,2932,2113,1862,834
99269,26631,37874,61766,37503,7.98686e+12,57.7372,42842.7,99269,18431,72,61395,61395,52420,41925,41567
4485,708,1089,2915,1570,9.96864e+12,58.8633,1598.46,4485,526,70,3396,3396,2933,2413,2361
47457,5156,19125,29348,18109,7.7163e+12,56.5241,21733.2,47457,9295,72,28332,28332,19630,9409,9154
68879,13595,16010,44670,24209,9.91573e+12,60.1185,20385.1,68879,7792,72,52869,52869,50024,49350,45338
39348,1250,9155,25519,13829,9.91257e+12,60.0652,11901.6,39348,4448,72,30193,30193,18701,12490,4636
25775,538,8188,16335,9440,8.85438e+12,58.6427,9959.83,25775,3989,72,17587,17491,10548,6583,2064
50049,2233,11658,32462,17587,9.90314e+12,60.0829,15004.6,50049,5673,72,38391,38391,17772,8789,7973
20449,3837,4857,13259,7190,9.85638e+12,59.8341,6470.85,20449,2354,72,15592,15592,14225,12980,12715
43730,8824,11657,28100,15630,9.49031e+12,59.5422,14537.5,43730,5678,72,32073,32073,29166,25283,24412
31421,3655,11037,19720,11701,8.40183e+12,58.1614,13033.1,31421,5376,72,20384,20384,13574,5629,5375
95825,20088,28228,61085,34740,9.11807e+12,59.1546,33619.5,95825,13751,72,67597,67597,55727,44339,41221
13277,267,4225,8417,4860,8.85147e+12,58.469,5285.15,13277,2052,72,9052,8956,4240,3277,1019
75352,15306,17494,48871,26481,9.91542e+12,60.1289,22216.3,75352,8513,72,57858,57858,55195,51609,50825
44314,11479,24248,34750,9564,79908500000,8.97768,24657.6,44314,21816,11,20066,20066,12131,12649,11632
95151,16600,28115,60647,34504,9.10072e+12,59.137,33469.9,95151,13694,72,67036,67036,55530,39696,36103
26349,2761,8412,16685,9664,8.83395e+12,58.6319,10211.5,26349,4098,72,17937,17937,12633,6819,5506
46523,4810,15184,29400,17123,8.71314e+12,58.5944,18011.3,46523,7391,72,31339,31339,22728,22432,12334
46486,10259,10852,30150,16336,9.90483e+12,60.068,13998.1,46486,5280,72,35634,35634,34779,34764,33907
53530,13754,18471,33653,19877,8.46363e+12,58.3074,21574.1,53530,8992,72,35059,35059,29553,21967,20373
97151,12064,22582,62995,34156,9.90547e+12,60.1326,28454.3,97151,10986,72,74569,74569,61947,44665,40567
37017,10632,14964,22880,14137,7.71451e+12,57.3372,17088,37017,7290,72,22053,22053,19155,15759,15851
79220,21856,34474,48544,30676,7.29918e+12,56.9065,38273.6,79220,16792,72,44746,44746,37391,28763,28623
25372,94,1235,20122,5250,5.81644e+13,11.9916,1753.23,25372,1058,14,24137,24137,14926,7311,20026
48529,4184,25906,38015,10514,79587200000,8.98077,26343.5,48529,23307,11,22623,22623,8068,9299,6851
42975,15515,16465,26723,16252,7.96632e+12,57.3119,18934.5,42975,8007,72,26510,26510,25140,23498,23609
5004,1005,1792,3150,1854,8.50794e+12,56.966,2280.79,5004,857,68,3212,3212,2299,1133,929
34253,2258,9367,21967,12286,9.39783e+12,59.4124,11713,34253,4560,72,24886,24886,17103,16920,7666
28667,7804,13705,17346,11321,6.77302e+12,56.0415,15267.8,28667,6671,72,14962,14962,11405,7253,7307
24194,4553,5704,15691,8503,9.87937e+12,59.9209,7551.2,24194,2772,72,18490,18490,17192,15497,15164
6363,3245,4420,3613,2750,4.01575e+12,35.7984,4762.92,6363,2131,67,1943,1943,1856,1704,1825
93460,21185,21745,60606,32854,9.90773e+12,60.1344,27420.5,93460,10584,72,71715,71715,71035,71004,70380
85507,25195,33954,52964,32543,7.78837e+12,57.515,38235.8,85507,16534,72,51553,51553,44569,35024,32850
10317,919,2479,6685,3632,9.85053e+12,59.5435,3426.57,10317,1202,72,7838,7838,5536,5494,2885
49169,1415,11452,31888,17281,9.90707e+12,60.0876,14750.5,49169,5572,72,37717,37717,14250,15031,5015
13534,3190,4170,8610,4924,8.9978e+12,58.5972,5254.69,13534,2028,72,9364,9364,8946,8821,8455
73383,24035,28770,45515,27868,7.86034e+12,57.5896,32558.2,73383,14016,72,44613,44613,41392,37714,37635
41069,9584,9593,26625,14444,9.91165e+12,60.0702,12433.3,41069,4672,72,31476,31476,31474,31474,31476
14229,4187,6104,8742,5487,7.42146e+12,56.7107,7079.27,14229,2966,72,8125,8125,7128,6177,6143
4194,770,1011,2714,1480,1.00168e+13,58.9974,1497.93,4194,488,69,3183,3183,2900,2836,2605
67502,629,18062,43356,24146,9.46195e+12,59.5714,22197.9,67502,8799,72,49440,49249,28540,28018,2879
78125,22487,29098,48726,29399,8.11002e+12,57.9113,33204.5,78125,14172,72,49027,49027,43919,36992,35400
8598,2415,4422,5155,3443,6.33907e+12,46.4976,5018.9,8598,2131,72,4176,4176,3940,3668,3853
74158,7257,28586,46078,28080,7.94285e+12,57.698,32445.7,74158,13921,72,45572,45572,30664,18227,14489
98352,4476,22844,63776,34576,9.92278e+12,60.1458,28774.1,98352,11128,72,75508,75508,35421,36027,15814
86011,7384,20190,55744,30267,9.88132e+12,60.0953,25463.4,86011,9830,72,65821,65821,44627,42970,25039
95282,44043,44526,57837,37445,6.88214e+12,56.4068,48750.4,95282,21687,72,50756,50756,50347,49765,49876
59422,10617,17202,37936,21486,9.17229e+12,58.8593,20825.2,59422,8361,72,42220,42220,35575,27812,27574
60668,22031,23193,37735,22933,7.99173e+12,57.7325,26468,60668,11299,72,37475,37475,36689,35587,35570
81919,36934,42890,64120,17799,79358500000,8.98567,43468.8,81919,38597,11,39029,39029,34622,35098,34165
81995,16333,19293,53124,28871,9.8805e+12,60.0885,24348.3,81995,9399,72,62702,62702,58428,58336,53329
34549,13954,16491,20919,13630,6.77845e+12,56.1498,18300.7,34549,8030,72,18058,18058,16308,14286,14382
89606,7715,25839,57229,32377,9.18714e+12,59.2433,30971.6,89606,12576,72,63767,63767,43831,43326,19357
36090,15624,19451,21452,14638,5.99333e+12,55.1871,21145.6,36090,9475,72,16639,16639,15535,14118,13850
18344,7350,11460,10624,7720,4.88996e+12,53.7158,12320.6,18344,5580,72,6884,6884,5721,4650,4585
68284,15379,15873,44288,23996,9.91893e+12,60.1224,20214.2,68284,7731,72,52411,52411,51811,51677,50983
19967,406,4668,12946,7021,9.94445e+12,59.9343,6255.29,19967,2274,72,15299,15299,5101,5520,1588
93853,7566,35755,58390,35463,7.99707e+12,57.7876,40495.2,93853,17417,72,58098,58098,38810,16210,15339
42036,7260,19190,25609,16427,7.03325e+12,56.4657,21376.1,42036,9347,72,22846,22846,16243,9971,8406
96005,24304,39126,59294,36711,7.64644e+12,57.0227,43783.2,96005,19040,72,56879,56879,50670,43412,43332
3261,1069,1136,2066,1195,8.6181e+12,55.858,1498.65,3261,550,60,2125,2125,2053,2040,2027
5489,762,1318,3564,1925,1.00066e+13,59.1326,1909.36,5489,637,72,4171,4171,3355,2499,2538
95038,8350,37861,58838,36200,7.77782e+12,57.5081,42534.7,95038,18444,72,57177,57177,30573,32883,13384
11416,1936,2678,7413,4003,9.89744e+12,59.6315,3708.4,11416,1290,72,8738,8738,7864,6740,6537
33075,5842,11337,20809,12266,8.51381e+12,58.298,13435.1,33075,5522,72,21738,21738,17736,12212,11123
1926,224,505,1255,671,9.94885e+12,57.0332,776.472,1926,241,55,1421,1421,1040,971,715
29176,343,7576,18784,10392,9.57386e+12,58.9777,9670.59,29176,3671,72,21600,21552,7141,3884,1473
18769,2210,4403,12176,6593,9.9365e+12,59.876,5914.15,18769,2141,72,14366,14366,11774,8310,7552
38626,1093,19972,23117,15509,6.26136e+12,55.5446,21829.4,38626,9729,72,18654,18414,11036,4641,1997
80847,20266,29254,50583,30264,8.23738e+12,58.071,33542,80847,14238,72,51593,51593,47330,41437,40251
19282,4386,10308,15105,4177,79631200000,8.98615,10580.2,19282,9272,11,8974,8974,4938,5296,4597
88160,16194,20463,57169,30991,9.91732e+12,60.14,25865.1,88160,9964,72,67697,67697,61497,61371,53986
80731,9476,22785,51642,29089,9.26186e+12,59.3269,27515.7,80731,11086,72,57946,57946,42073,23246,22665
7349,1702,2615,4622,2727,8.34429e+12,57.5169,3267.91,7349,1265,72,4734,4734,3639,3378,1981
30999,677,1931,24666,6333,5.7368e+13,12.0044,2507.93,30999,965,20,29068,29068,20691,14347,23115
80470,17341,42537,47977,32493,6.09233e+12,55.3336,45847.5,80470,20719,72,37933,37933,28051,18731,16282
69674,785,16177,45179,24495,9.92478e+12,60.1349,20595.8,69674,7880,72,53497,53497,15581,3095,3466
28586,1065,6703,18531,10055,9.89079e+12,59.9815,8818.56,28586,3251,72,21883,21883,9100,9417,3631
21083,3518,7671,13190,7893,8.26023e+12,57.8651,9101.93,21083,3735,72,13412,13412,10207,6996,6180
23377,1104,9629,14425,8952,7.64974e+12,57.1264,11088,23377,4690,72,13748,13748,5673,2712,1408
41273,2199,19058,25090,16183,6.97403e+12,55.5024,21196.9,41273,9278,72,22215,22215,10606,5145,2997
27294,2998,8022,17401,9893,9.14194e+12,59.0558,9931.31,27294,3908,72,19272,19272,13551,8784,6689
97770,20725,26541,62724,35046,9.40714e+12,59.5224,32185,97770,12922,72,71229,71229,63848,55088,54945
81097,6069,18864,52589,28508,9.91129e+12,60.1248,23888.1,81097,9187,72,62233,62233,43566,30477,20606
47387,9296,19872,29173,18214,7.51197e+12,56.7956,22415.4,47387,9664,72,27515,27515,20104,13037,11243
23997,4675,23997,0,23997,7.99967,0,23997,23997,23997,1,0,0,0,0,0
75442,22830,26678,47304,28138,8.35328e+12,58.0351,30765.9,75442,12991,72,48764,48764,46145,42601,41879
62971,5139,25478,38925,24046,7.68174e+12,57.3607,28758.8,62971,12397,72,37493,37493,21402,10900,7410
1341,474,961,773,568,3.81544e+12,21.3035,1065.34,1341,445,44,380,380,380,380,380
79806,13279,18571,51751,28055,9.9027e+12,60.1213,23530.2,79806,9034,72,61235,61235,53628,53463,44384
3132,215,780,2035,1097,9.7905e+12,58.227,1172.66,3132,368,62,2352,2352,1547,1533,739
37114,6894,8649,24073,13041,9.91257e+12,60.0399,11263.2,37114,4208,72,28465,28465,26311,25821,22851
98762,3863,25923,63515,35247,9.52812e+12,59.6651,31672.9,98762,12629,72,72839,72839,45932,45291,12823
62787,14991,23477,39150,23637,8.0839e+12,57.8615,26891.2,62787,11424,72,39310,39310,32374,32122,24067
1131,174,310,737,394,1.0533e+13,55.0309,490.37,1131,151,46,821,821,659,625,537
23049,5116,8826,14337,8712,7.98094e+12,57.3807,10330.1,23049,4285,72,14223,14223,12472,10138,9658
15516,859,4954,9839,5677,8.8365e+12,58.4781,6144.78,15516,2410,72,10562,10562,6965,2799,2737
86806,4282,36516,53415,33391,7.48218e+12,56.8416,40711.4,86806,17768,72,50290,50290,32102,10881,10047
66259,22630,27401,40851,25408,7.57462e+12,57.2364,30778.4,66259,13343,72,38858,38858,36631,33549,33052
12749,899,2971,8265,4484,9.97486e+12,59.7899,4094.77,12749,1442,72,9778,9778,6718,6663,3106
24010,5894,8146,15132,8878,8.55974e+12,57.5529,9781.65,24010,3950,72,15864,15864,14402,12689,12852
30534,4859,11213,19080,11454,8.18131e+12,57.8775,13123.9,30534,5457,72,19321,19321,15092,10198,10082
56593,11432,21184,35278,21315,8.08579e+12,57.2628,24311.6,56593,10314,72,35409,35409,29227,20819,18857
80502,24099,28432,50483,30019,8.35716e+12,57.7331,32753.1,80502,13844,72,52070,52070,48724,44104,43229
24926,12021,13132,19515,5411,79453200000,8.98889,13446,24926,11812,11,11794,11794,10978,11065,10911
41345,6071,16623,25584,15761,7.74455e+12,56.5735,18953.5,41345,8081,72,24722,24722,16852,7577,7410
95417,3222,5142,75779,19638,5.78462e+13,12.0014,6162.39,95417,3258,20,90275,90275,77638,68299,84561
26898,450,9621,16849,10049,8.31622e+12,57.7368,11371.5,26898,4680,72,17277,16976,10122,5036,1523
65257,27465,33667,39046,26211,6.264e+12,55.0101,36514.8,65257,16395,72,31590,31590,29945,28426,28229
10972,2509,3249,6998,3974,9.15856e+12,58.7355,4188.55,10972,1577,72,7723,7723,6635,5426,5488
48398,633,15120,30698,17700,8.89171e+12,58.8231,18090.3,48398,7366,72,33278,33040,13331,6331,2635
67050,16308,21957,42355,24695,8.6875e+12,58.3481,25786.4,67050,10691,72,45093,45093,39530,39353,32855
14322,1325,3319,9292,5030,9.98915e+12,59.8719,4548.62,14322,1611,72,11003,11003,8047,7995,4574
18086,3459,4294,11720,6366,9.88795e+12,59.8629,5760.03,18086,2091,72,13792,13792,12684,12648,11511
92390,24551,49762,72402,19988,79718800000,8.98757,50364.9,92390,44778,11,42628,42628,26852,27909,25815
67929,1308,23844,42639,25290,8.38296e+12,58.1767,27599.7,67929,11595,72,44085,44085,18590,8462,3538
27033,10742,12528,16441,10592,6.93089e+12,56.318,14054.4,27033,6091,72,14505,14505,13732,13013,12982
36712,5178,8610,23795,12917,9.89356e+12,60.0144,11199,36712,4184,72,28102,28102,24014,23052,17202
24471,3348,5760,15867,8604,9.88351e+12,59.9442,7625.86,24471,2799,72,18711,18711,15848,15175,11154
54278,19834,20240,33862,20416,8.09607e+12,57.5934,23269.9,54278,9838,72,34038,34038,33940,33895,33889
67828,9656,18622,43486,24342,9.36636e+12,58.9904,22742.5,67828,9049,72,49206,49206,41005,39052,27200
76149,10914,17719,49377,26772,9.90853e+12,60.1337,22485.8,76149,8628,72,58430,58430,48563,39114,36520
25897,3630,9259,16238,9659,8.30898e+12,57.9943,10958.2,25897,4501,72,16638,16638,13125,8621,7636
90781,14012,25732,58054,32727,9.25884e+12,59.3245,30949.2,90781,12532,72,65049,65049,51374,51041,34651
27054,2122,6355,17541,9513,9.88429e+12,59.9612,8378.12,27054,3084,72,20699,20699,13049,12672,7118
76116,1374,17809,49340,26776,9.89044e+12,60.1059,22566.7,76116,8666,72,58307,58307,19191,20818,5473
15285,318,3610,9913,5372,9.91705e+12,59.7785,4895.54,15285,1750,72,11675,11675,6933,6832,1240
72352,6667,24306,45597,26755,8.56896e+12,58.4641,28343,72352,11827,72,48046,48046,32991,15250,14714
34654,2720,14063,21408,13246,7.68781e+12,57.1546,16076.4,34654,6845,72,20591,20591,10787,6274,4357
75118,1888,17431,48726,26392,9.92164e+12,60.1351,22140.3,75118,8491,72,57687,57687,35030,23180,7131
87004,5620,21140,56266,30738,9.77508e+12,59.9657,26416,87004,10294,72,65864,65864,35313,35725,17488
39266,3272,14190,24584,14682,8.25604e+12,57.3207,16549.7,39266,6892,72,25076,25076,14294,13553,5262
22851,221,5331,14820,8031,9.9195e+12,59.9235,7098.94,22851,2588,72,17520,17520,10077,9931,1022
92834,5393,31226,58499,34335,8.56805e+12,58.4648,36211,92834,15205,72,61608,61608,31187,16552,10319
87982,25458,42861,53097,34885,6.62077e+12,56.0571,46691.6,87982,20868,72,45121,45121,35936,25171,24938
54158,6995,17966,34180,19978,8.63027e+12,58.5032,21151.2,54158,8741,72,36192,36192,27072,16343,16113
53950,4823,12546,34985,18965,9.92342e+12,60.1055,16104.9,53950,6111,72,41404,41404,30163,29935,16428
38516,2848,12155,24418,14098,8.84423e+12,57.5284,14614.1,38516,5899,72,26361,26361,16705,5367,4965
57226,6485,13298,37121,20105,9.91354e+12,60.1025,17041.5,57226,6474,72,43928,43928,33920,33732,21696
11519,772,3305,7359,4160,9.31458e+12,58.9512,4287.57,11519,1609,72,8214,8166,4016,3091,2469
21818,69,5165,14137,7681,9.86252e+12,59.859,6864.55,21818,2510,72,16653,10325,4097,157,393
68216,13599,20785,43366,24850,8.98838e+12,58.9766,24776.5,68216,10125,72,47431,47431,42489,35788,34247
66907,18346,30256,40797,26110,7.07697e+12,56.6207,33474.4,66907,14734,72,36651,36651,28651,19280,19106
95075,4267,22101,61648,33427,9.91268e+12,60.1372,27863.1,95075,10760,72,72974,72974,33998,16736,15082
22116,6859,8092,13827,8289,8.20209e+12,57.8298,9576.26,22116,3937,72,14024,14024,13121,12066,12260
76329,11288,76329,0,76329,7.9999,0,76329,76329,76329,1,0,0,0,0,0
33629,8222,11646,21138,12491,8.4581e+12,58.224,13765.6,33629,5666,72,21983,21983,19789,19232,16264
52434,12170,12202,34010,18424,9.90744e+12,60.0903,15681.2,52434,5938,72,40232,40232,40202,40210,40199
3818,1727,1744,2339,1479,7.13842e+12,55.2839,2101.36,3818,844,60,2074,2074,2061,2063,2060
82931,9122,19283,53776,29155,9.90783e+12,60.1262,24406.7,82931,9388,72,63648,63648,50605,34556,30560
20750,7484,11030,12366,8384,6.07418e+12,54.7402,12151.6,20750,5351,72,9720,9720,8138,6291,6448
63385,19767,24583,39376,24009,7.90465e+12,57.6405,27959.4,63385,11967,72,38802,38802,35155,30228,29123
98437,25833,50154,59011,39426,6.33288e+12,55.6796,54209.3,98437,24417,72,48283,48283,37730,23311,19897
45739,547,15526,28809,16930,8.52759e+12,58.3799,18272.6,45739,7558,72,30213,29829,17073,8678,1067
3149,71,143,2493,656,5.84758e+13,11.9362,318.433,3149,139,13,3006,3006,2380,1853,2722
68072,728,28419,41924,26148,7.52716e+12,57.167,31853.6,68072,13838,72,39653,38981,15461,6004,1501
18533,3102,4356,12018,6515,9.89497e+12,59.8315,5851.74,18533,2118,72,14177,14177,12659,12311,10247
72876,9408,33456,44341,28535,6.98808e+12,55.1598,36879.3,72876,16276,72,39420,39420,26283,10845,10408
92919,17459,22439,60113,32806,9.78832e+12,59.989,28032.8,92919,10920,72,70480,70480,63970,63808,56099
21301,4863,4980,13817,7484,9.92814e+12,59.9194,6649.39,21301,2423,72,16321,16321,16193,16160,16114
98454,39750,41759,60511,37943,7.43883e+12,57.0917,46402.6,98454,20332,72,56695,56695,54943,52885,53033
5442,1229,1815,3441,2001,8.7631e+12,57.6106,2348.9,5442,878,72,3627,3627,3597,3545,3611
29383,340,6889,19052,10331,9.91208e+12,59.9837,9047.54,29383,3346,72,22494,22494,13025,12828,1472
56621,8914,19173,35661,20960,8.54308e+12,58.4221,22453.1,56621,9331,72,37448,37448,33364,30636,29756
53604,5981,12468,34765,18839,9.92402e+12,60.0802,16007.8,53604,6066,72,41136,41136,33043,22547,20026
90201,17556,21009,58488,31713,9.90076e+12,60.1197,26513,90201,10222,72,69192,69192,65073,64109,58226
67718,26598,32786,40903,26815,6.66522e+12,54.3532,35883.1,67718,15950,72,34932,34932,33405,31284,31010
52999,8869,19278,33141,19858,8.22697e+12,58.0144,22282.4,52999,9386,72,33721,33721,24241,13058,12806
83602,14952,19416,54212,29390,9.9215e+12,60.1405,24575,83602,9459,72,64186,64186,57668,51461,49783
54851,7571,14054,35351,19500,9.60539e+12,59.7155,17573.5,54851,6838,72,40797,40797,34182,25198,23095
41794,3994,9724,27108,14686,9.9031e+12,60.053,12608.3,41794,4721,72,32070,32070,23102,22203,13518
32929,9154,16534,19795,13134,6.46523e+12,55.7574,18209.4,32929,8055,72,16395,16395,13280,10364,9762
6086,99,2118,3842,2244,8.48967e+12,54.827,2690.24,6086,1011,72,3968,3598,1247,649,338
25907,7769,11176,15896,10011,7.36333e+12,56.836,12719.6,25907,5436,72,14731,14731,12856,10654,10796
11010,400,2633,7139,3871,9.90033e+12,59.5955,3629.89,11010,1275,72,8377,8377,5206,3495,1457
31441,3627,11649,19621,11820,8.1528e+12,57.8522,13597.8,31441,5675,72,19792,19792,14005,7263,7090
6566,202,2560,4090,2476,8.04039e+12,52.8335,3134.52,6566,1230,72,4006,3958,1424,1017,734
55785,11201,18985,35120,20665,8.51849e+12,58.3915,22217.3,55785,9241,72,36800,36800,30041,20726,18708
55001,11286,15262,35235,19766,9.32634e+12,59.365,18705.3,55001,7421,72,39739,39739,35367,35242,30141
92423,19584,26413,59053,33370,9.22649e+12,58.9865,31699.9,92423,12862,72,66010,66010,59035,49422,47341
21853,8963,9231,13443,8410,7.48242e+12,56.9234,10598.2,21853,4486,72,12622,12622,12486,12261,12393
71923,2578,28755,44527,27396,7.75169e+12,57.4601,32444.8,71923,14001,72,43168,43168,22344,10335,5965
70326,14646,16442,45595,24731,9.89341e+12,60.0908,20888,70326,7998,72,53884,53884,51367,51306,48422
77876,13680,25209,49255,28621,8.73379e+12,58.6758,29571.4,77876,12272,72,52667,52667,42828,42513,30879
44323,18922,28713,34765,9558,2.23221e+13,5.52528,32932.3,44323,9568,13,15610,15610,14240,15556,10977
64190,1302,26927,39514,24676,7.50901e+12,56.678,30189.4,64190,13101,72,37263,37263,22456,12454,4497
10132,2065,2470,6569,3563,9.80621e+12,59.2954,3403.64,10132,1182,72,7662,7662,7146,7136,6702
67255,10153,15648,43611,23644,9.90206e+12,60.1009,19936.1,67255,7609,72,51607,51607,43704,43534,34087
45626,12239,20751,27800,17826,7.05532e+12,56.5591,23093.9,45626,10108,72,24875,24875,21094,15873,14851
26475,8248,12906,15990,10485,6.62653e+12,55.9425,14354,26475,6281,72,13569,13569,11282,8626,8747
79104,455,29116,49404,29700,8.16041e+12,57.9785,33291.4,79104,14179,72,49988,49028,27944,15303,1088
60503,14102,20516,38106,22397,8.53914e+12,58.4024,23976.5,60503,9990,72,39987,39987,35054,28252,26846
55419,11739,12881,35946,19473,9.91909e+12,60.1104,16524.2,55419,6271,72,42538,42538,40867,40836,38985
59438,6762,16444,38084,21354,9.34166e+12,59.4098,20123.6,59438,8001,72,42994,42994,31273,17453,16964
79852,4491,18513,51794,28058,9.91833e+12,60.139,23478.5,79852,9013,72,61339,61339,32045,17563,15594
60240,21621,21906,37678,22562,8.22301e+12,58.0076,25245.2,60240,10661,72,38334,38334,38263,38173,38283
90499,3963,27176,57607,32892,9.03375e+12,59.0565,32277.4,90499,13234,72,63323,63275,23568,32889,11841
53026,8485,27842,31650,21376,6.13516e+12,55.4475,30211.2,53026,13550,72,25184,25184,15737,8758,6692
12846,5394,5478,7904,4942,7.42534e+12,56.2033,6386.01,12846,2646,72,7368,7368,7368,7368,7368
41068,13959,16602,25395,15673,7.69686e+12,57.3224,18912.4,41068,8078,72,24466,24466,22823,20885,21039
23782,4421,5547,15435,8347,9.92502e+12,59.9663,7373.48,23782,2698,72,18235,18235,16865,15072,14711
29333,554,11665,18179,11154,7.78093e+12,56.9391,13448.3,29333,5660,72,17668,17380,10467,6908,1803
80133,7318,24654,50893,29240,8.94468e+12,58.9361,29210.8,80133,12005,72,55479,55431,41648,41357,24701
60815,15417,21130,38208,22607,8.42998e+12,58.2788,24568,60815,10288,72,39685,39685,34946,29470,29312
32450,1206,9608,20694,11756,9.09789e+12,58.38,11795.9,32450,4660,72,22842,22842,10180,10124,4070
68297,7883,24591,42760,25537,8.26299e+12,58.0828,28318.7,68297,11968,72,43706,43706,30364,14736,14163
91693,8270,31065,57741,33952,8.5384e+12,58.448,35979.4,91693,15125,72,60628,60628,40719,17182,16394
46339,5459,15471,29220,17119,8.61908e+12,58.4738,18261.5,46339,7537,72,30868,30868,22018,14054,11941
63446,17090,19221,40357,23089,9.01978e+12,58.9993,22981.6,63446,9364,72,44225,44225,42046,40026,39556
72420,10690,34787,43786,28634,6.7146e+12,56.1899,38077.6,72420,16942,72,37633,37633,27436,15607,15327
61151,16079,31471,36605,24546,6.26699e+12,55.3727,34178.5,61151,15317,72,29680,29680,24404,18320,18174
53465,13405,14958,34223,19242,9.30215e+12,59.3557,18314.3,53465,7279,72,38507,38507,36989,36945,35300
33807,8063,10452,21479,12328,8.93417e+12,58.8192,12677.9,33807,5088,72,23355,23355,21147,18206,17575
83902,9938,20116,54294,29608,9.82511e+12,60.022,25247.7,83902,9799,72,63786,63786,48997,34809,30868
63145,9986,14691,40938,22207,9.91697e+12,60.1227,18755.1,63145,7157,72,48454,48454,41699,41549,33536
71067,31941,36917,42487,28580,6.2074e+12,55.5661,39955,71067,17978,72,34150,34150,32576,30389,30102
72525,9113,23516,45857,26668,8.73611e+12,58.6662,27617.4,72525,11456,72,49009,49009,34835,18122,17482
77003,1721,24242,48817,28186,8.84757e+12,58.8237,28613,77003,11801,72,52761,52761,17654,9415,3418
28943,5478,9421,18308,10635,8.70963e+12,57.9257,11351.2,28943,4567,72,19522,19522,15972,11775,11830
19209,970,6560,12101,7108,8.51236e+12,57.6838,7932.29,19209,3173,72,12649,12574,7935,2407,2357
36325,15175,15385,22334,13991,7.45526e+12,56.5682,17428.2,36325,7472,72,20940,20940,20940,20940,20940
20965,5377,10585,12593,8372,6.41811e+12,53.6899,11764.4,20965,5138,72,10380,10380,8572,6137,5679
42586,16663,19666,25894,16692,6.95913e+12,55.4419,21862.8,42586,9558,72,22920,22920,21105,18588,18218
83039,3268,19299,53853,29186,9.91698e+12,60.1301,24426.4,83039,9399,72,63740,63740,27872,28619,11570
15264,1162,8316,9063,6201,5.91401e+12,53.8595,9186.07,15264,4029,72,6948,6852,3747,2023,1420
10742,1974,2570,6959,3783,9.87042e+12,59.5772,3551.15,10742,1239,72,8172,8172,7324,7307,6442
4706,199,2627,2786,1920,5.79181e+12,47.7575,2986.77,4706,1265,68,2079,1983,1184,242,0
7980,981,1938,5168,2812,9.94141e+12,59.4107,2714.45,7980,944,72,6042,6042,4755,4713,3364
40248,503,9605,26057,14191,9.83897e+12,59.9651,12382.2,40248,4674,72,30643,30643,17811,17526,2108
20834,3895,5078,13472,7362,9.80995e+12,59.7794,6703.92,20834,2468,72,15756,15756,14005,13973,12030
99074,25893,30842,62875,36199,8.89084e+12,55.1359,36282.4,99074,15004,72,68232,68232,68232,68232,68232
30357,14491,14691,18345,12012,6.68602e+12,55.4531,16308.8,30357,7148,72,15666,15666,15643,15633,15662
24153,4668,5630,15674,8479,9.94279e+12,59.9826,7478.18,24153,2738,72,18523,18523,17368,15868,15584
77337,2067,23971,49100,28237,8.91029e+12,58.8918,28380.2,77337,11667,72,53366,53318,32883,14490,7678
33151,6265,7740,21500,11651,9.91577e+12,60.023,10123.7,33151,3764,72,25411,25411,23722,23313,21010
57138,4917,13279,37056,20082,9.91146e+12,60.1013,17016.5,57138,6464,72,43859,43859,31671,31426,16749
82836,3273,33289,51244,31592,7.731e+12,57.4124,37429.4,82836,16201,72,49547,49547,27997,10431,5035
66695,10274,17826,42835,23860,9.46579e+12,59.5668,21919.5,66695,8679,72,48869,48869,39958,39739,29136
61006,11319,14156,39565,21441,9.91818e+12,60.1066,18108.7,61006,6882,72,46850,46850,43393,42597,37666
83402,9023,27482,52652,30750,8.65885e+12,58.5875,32070.7,83402,13378,72,55920,55920,37007,14627,13890
23942,174,9217,14889,9053,7.9676e+12,57.5746,10761.2,23942,4486,72,14725,14356,6580,757,812
71649,7356,16642,46469,25180,9.91284e+12,60.1275,21170,71649,8099,72,55007,55007,41708,28470,24825
94412,26239,47685,56668,37744,6.39532e+12,55.8149,51627.4,94412,23231,72,46727,46727,39410,29417,27104
26255,9007,9687,16398,9857,8.17386e+12,57.8333,11380.4,26255,4713,72,16568,16568,15958,15104,15143
61082,2207,24405,37817,23265,7.75188e+12,57.0938,27627.9,61082,11867,72,36677,36677,21228,6917,2465
71947,16888,33552,43681,28266,6.88903e+12,55.9969,36899.4,71947,16331,72,38395,38395,29671,19441,19232
7975,424,1938,5165,2810,9.87752e+12,59.2934,2716.51,7975,935,72,6037,6037,3939,3885,1529
53253,14405,20669,33080,20173,7.91061e+12,57.6245,23589.3,53253,10065,72,32584,32584,29153,24529,23487
87002,3044,43824,52243,34759,6.41467e+12,55.8312,47512,87002,21350,72,43178,43178,19810,6243,4345
93599,9987,32404,58813,34786,8.44339e+12,58.2481,37361.4,93599,15770,72,61195,61195,39873,24601,19703
93390,12976,35189,58185,35205,8.04294e+12,57.6739,39937.9,93390,17130,72,58201,58201,41771,26955,22809
43230,4359,18916,26479,16751,7.27566e+12,55.9693,21216,43230,9198,72,24314,24314,15291,8468,6482
70252,5683,39149,55136,15116,80129400000,8.99617,39658.6,70252,35232,11,31103,31103,10542,11816,9282
91335,5223,26822,58241,33094,9.11889e+12,59.166,32008.4,91335,13056,72,64513,64513,40151,11295,10276
24496,8030,13357,19206,5290,79877900000,8.98661,13660.2,24496,12014,11,11139,11139,7855,8062,7666
17128,2104,4359,11050,6078,9.69502e+12,59.5348,5735.93,17128,2120,72,12769,12769,10170,10092,7175
6600,428,2411,4140,2460,8.25859e+12,57.2761,3006.11,6600,1168,72,4189,4118,2418,1716,1454
19625,3182,4979,12669,6956,9.66254e+12,59.0812,6516.63,19625,2405,72,14646,14646,12713,10152,9595
12146,2381,3801,7712,4434,8.90489e+12,58.4716,4795.87,12146,1846,72,8345,8345,7240,7202,6068
65262,24660,26442,40336,24926,7.6902e+12,57.3768,29816.4,65262,12880,72,38820,38820,38448,37918,38033
68598,5246,34458,41216,27382,6.43077e+12,55.62,37497,68598,16767,72,34140,34140,18490,10229,6956
96331,18399,29998,61120,35211,8.89343e+12,58.8928,35308.6,96331,14611,72,66333,66333,53129,37509,36991
6417,990,1533,4164,2253,9.82236e+12,59.1674,2200.06,6417,732,72,4884,4884,4122,4107,3355
61049,8243,21364,38329,22720,8.3977e+12,58.2394,24802,61049,10402,72,39685,39685,29130,16709,16316
16534,3637,4211,10664,5870,9.68283e+12,59.5542,5552.57,16534,2051,72,12323,12323,11622,11466,10631
79219,14407,18431,51370,27849,9.91149e+12,60.1236,23355.7,79219,8973,72,60788,60788,55936,54806,47852
73742,12794,24090,46598,27144,8.69226e+12,58.6065,28239.3,73742,11723,72,49652,49652,34904,17457,16830
13089,1043,5954,7987,5102,7.0279e+12,56.1898,6838.72,13089,2884,72,7135,7135,4437,1272,1372
93061,439,31929,58537,34524,8.48306e+12,58.3505,36879.5,93061,15535,72,61132,60274,24395,9519,2351
51443,7930,20190,31905,19538,7.85776e+12,57.5557,23008.1,51443,9835,72,31253,31253,23695,16620,14659
17642,4444,4474,11384,6258,9.70218e+12,59.5704,5883.49,17642,2177,72,13168,13168,13137,13130,13142
76551,17505,24952,48375,28176,8.71611e+12,58.6462,29234.2,76551,12154,72,51599,51599,46088,38613,36885
20053,2880,7518,12507,7546,8.15316e+12,57.693,8873.76,20053,3662,72,12535,12535,9220,5339,5408
50613,2289,11790,32820,17793,9.90489e+12,60.0737,15166.7,50613,5735,72,38823,38823,24953,24681,7945
79865,19824,24549,50737,29128,8.93581e+12,58.9222,29096,79865,11945,72,55316,55316,49634,48309,40088
43237,1623,1834,34223,9014,5.85578e+13,12.0031,2523.47,43237,1043,19,41403,41403,39560,38099,40563
84681,21178,27024,53623,31058,8.7962e+12,58.7548,31732.5,84681,13161,72,57657,57657,52052,50714,42694
30626,1824,9662,19418,11208,8.87931e+12,58.7181,11699.6,30626,4705,72,20964,20964,11173,6063,4220
18973,232,4435,12298,6675,9.93441e+12,59.9501,5962.45,18973,2160,72,14538,14538,4240,4728,1031
77626,3269,31311,48000,29626,7.71415e+12,57.4129,35221.5,77626,15251,72,46315,46315,23225,11342,6679
72811,18135,29122,45059,27752,7.7622e+12,57.4617,32843.1,72811,14187,72,43689,43689,34983,24784,24461
66799,10664,15522,43317,23482,9.91845e+12,60.1291,19786.6,66799,7561,72,51277,51277,44177,44037,35563
11963,1853,2851,7764,4199,9.87137e+12,59.6681,3915.25,11963,1384,72,9112,9112,7756,7716,6266
3395,685,876,2186,1209,9.86552e+12,57.6156,1287.07,3395,421,63,2519,2519,2257,2040,2099
4099,1888,2058,2468,1631,6.64745e+12,48.1122,2412.15,4099,996,68,2041,2041,1914,1866,1884
93876,7132,21763,60878,32998,9.92425e+12,60.154,27466.3,93876,10597,72,72113,72113,45036,43949,24427
22988,1685,8395,14373,8615,8.22411e+12,57.8887,9929.11,22988,4085,72,14593,14593,9591,3778,3643
23030,8679,10129,14094,8936,7.24789e+12,55.4676,11523.1,23030,4921,72,12901,12901,11672,10221,10396
27683,684,6426,17957,9726,9.96667e+12,60.0164,8486.04,27683,3130,72,21257,21257,7623,8134,2597
46779,1666,3217,37307,9472,5.69515e+13,11.9957,3917.25,46779,1904,14,43562,43562,34379,28808,39406
78635,3482,18309,50997,27638,9.90572e+12,60.1187,23204.6,78635,8909,72,60326,60326,38759,38321,12201
64400,13007,15075,41744,22656,9.89135e+12,60.096,19204.6,64400,7336,72,49325,49325,46280,43412,42676
98123,3559,29190,62511,35612,9.07102e+12,59.1078,34676.1,98123,14213,72,68933,68933,32676,10745,9494
49718,8194,11524,32244,17474,9.93453e+12,60.0947,14855.5,49718,5608,72,38194,38194,34098,33162,27310
42285,1404,14292,26641,15644,8.54286e+12,58.3664,16871.6,42285,6948,72,27993,27993,15298,6187,3369
36663,4187,8595,23768,12895,9.89509e+12,60.0337,11181.8,36663,4180,72,28068,28068,22830,21612,14128
36732,14452,15924,22520,14212,7.32631e+12,55.508,17956.9,36732,7735,72,20808,20808,20049,18984,18966
30920,3295,9699,19610,11310,8.89594e+12,58.7364,11757,30920,4725,72,21221,21221,15065,7884,7663
97641,1331,22686,63312,34329,9.91382e+12,60.1413,28582.3,97641,11047,72,74955,74955,22794,5013,5344
32634,2382,7621,21161,11473,9.91634e+12,60.0202,9973.76,32634,3705,72,25013,25013,15114,9144,8033
96179,1920,6106,76585,19594,5.72632e+13,12.0013,7125.24,96179,3602,20,90073,90073,63020,43118,74201
19975,4308,9793,15594,4381,78582400000,8.98498,10085.4,19975,8808,11,10182,10182,5835,6370,5318
44958,9127,10495,29159,15799,9.90677e+12,60.0618,13553.3,44958,5108,72,34463,34463,32791,32413,30141
49470,4830,23704,29923,19547,6.74801e+12,56.179,26112.6,49470,11547,72,25766,25766,16467,8466,6285
36772,7797,12761,23111,13661,8.43014e+12,57.7409,15039.8,36772,6204,72,24011,24011,19609,14492,14358
31488,6063,7359,20411,11077,9.89885e+12,60.0106,9646.73,31488,3576,72,24129,24129,22664,20719,20335
33372,2455,7794,21647,11725,9.90132e+12,60.0197,10191.3,33372,3791,72,25578,25578,15606,15316,8538
29710,4661,9548,18809,10901,8.77131e+12,57.5402,11529.5,29710,4628,72,20162,20162,17048,12865,11934
21085,3527,7002,13310,7775,8.64336e+12,58.39,8494.96,21085,3404,72,14083,14083,11069,7595,7556
93098,19314,34927,58023,35075,8.06808e+12,57.8763,39675.5,93098,17007,72,58171,58171,49540,37777,35002
28888,3153,6765,18731,10157,9.90519e+12,59.9936,8897.71,28888,3289,72,22123,22123,17383,11902,10556
61990,12191,14379,40206,21784,9.93008e+12,60.118,18380.3,61990,7005,72,47611,47611,44940,41360,40564
24937,3390,8957,15626,9311,8.27625e+12,57.9439,10602.9,24937,4348,72,15980,15980,12055,7869,6971
55214,10536,12846,35810,19404,9.90221e+12,60.0858,16479,55214,6243,72,42368,42368,39557,38912,34929
90269,34125,35627,55959,34310,7.81778e+12,57.4512,40127.9,90269,17336,72,54642,54642,53547,52020,51890
26387,7725,11958,16094,10293,7.07888e+12,56.4862,13475.3,26387,5815,72,14429,14429,12276,9411,8797
99558,21964,99558,0,99558,7.99992,0,99558,99558,99558,1,0,0,0,0,0
57677,10678,13395,37410,20267,9.92206e+12,60.1059,17162.4,57677,6519,72,44282,44282,41065,40306,35750
49528,2054,19607,30694,18834,7.81768e+12,57.4889,22327.1,49528,9547,72,29921,29921,19073,7501,6029
59293,18187,18920,37552,21741,8.79009e+12,58.7259,22410.5,59293,9207,72,40373,40373,39731,39115,39177
29522,9069,9190,18746,10776,8.88995e+12,58.739,11182.9,29522,4462,72,20332,20332,20221,20151,20141
79662,37942,44165,62507,17155,80096900000,8.98052,44710.9,79662,39740,11,35497,35497,31672,31910,31450
62450,22478,23162,38972,23478,8.12746e+12,57.4891,26575.8,62450,11276,72,39288,39288,38646,38034,38096
67984,16620,21778,43041,24943,8.77703e+12,58.7181,25684.2,67984,10600,72,46206,46206,39978,38534,29537
60240,14082,18556,38267,21973,8.93457e+12,58.911,22141.2,60240,9033,72,41684,41684,36778,31063,30904
50284,10239,11712,32615,17669,9.91309e+12,60.0902,15069.9,50284,5701,72,38572,38572,36522,36470,34163
96103,9300,22343,62323,33780,9.9129e+12,60.1378,28157.3,96103,10881,72,73760,73760,53723,51532,31278
49647,8349,11564,32196,17451,9.91448e+12,60.0793,14885.9,49647,5626,72,38083,38083,33453,33356,27905
8272,1289,2012,5358,2914,9.81514e+12,59.3634,2811.55,8272,975,72,6260,6260,5313,4467,4348
34098,5891,7963,22111,11987,9.89466e+12,59.9996,10402.9,34098,3864,72,26135,26135,23621,20239,19488
97245,2507,28751,61980,35265,9.09021e+12,59.1328,34209.4,97245,13995,72,68494,68494,27628,14276,6748
99907,5284,29226,63723,36184,9.13769e+12,59.187,34831.3,99907,14231,72,70681,70633,27696,39919,15319
59027,7062,13755,38270,20757,9.91624e+12,60.0962,17589.4,59027,6701,72,45272,45272,35558,35357,23722
57108,15786,16821,36408,20700,9.11143e+12,59.1177,20302.8,57108,8189,72,40287,40287,39030,38745,37093
65236,838,32729,50972,14264,78817200000,8.9965,33258,65236,29450,11,32507,32505,8369,11100,5657
8673,1524,2046,5635,3038,9.91753e+12,59.4978,2881.99,8673,987,72,6627,6627,5888,5874,5161
76915,13518,17899,49876,27039,9.92039e+12,60.1287,22699.7,76915,8719,72,59016,59016,53729,52500,44892
72665,4369,31561,44536,28129,7.31302e+12,56.8658,35101,72665,15359,72,41104,41104,22989,11805,7786
43175,10046,11636,27728,15447,9.42853e+12,59.4731,14481.2,43175,5657,72,31539,31539,29733,27595,27740
96194,9829,27257,61504,34690,9.26016e+12,59.3384,32743.5,96194,13275,72,68937,68937,48079,46465,25155
36265,6161,13970,22553,13712,7.93746e+12,57.6164,16116.6,36265,6796,72,22295,22295,16304,10113,8490
39676,9639,11766,25287,14389,9.09365e+12,59.0398,14336.8,39676,5728,72,27910,27910,26738,25446,25497
56662,12571,13212,36730,19932,9.90946e+12,60.1042,16921,56662,6435,72,43450,43450,42510,41677,41540
67482,561,20624,42899,24583,8.96849e+12,58.4681,24576.9,67482,10026,72,46858,46618,26622,14246,1856
10342,529,3498,6518,3824,8.6457e+12,58.0262,4351.7,10342,1704,72,6844,6748,3708,2406,1864
65459,8752,15216,42449,23010,9.91342e+12,60.1322,19410.3,65459,7412,72,50243,50243,42394,40577,29178
81485,14954,18944,52845,28640,9.90768e+12,60.134,23993.7,81485,9223,72,62541,62541,56739,51207,49734
44291,13732,20579,26908,17383,6.92197e+12,55.8448,22836.7,44291,10003,72,23712,23712,20128,16758,16020
2285,647,881,1428,857,8.19933e+12,47.484,1153.24,2285,407,54,1404,1404,1212,1039,1041
19326,782,6672,12163,7163,8.46089e+12,56.5807,8044.46,19326,3227,72,12654,12558,7156,1845,542
78027,5664,27080,49025,29002,8.42596e+12,58.3003,31321.8,78027,13178,72,50947,50947,28296,16164,11522
25954,3327,7311,16611,9343,9.28603e+12,59.2057,9169.26,25954,3556,72,18643,18643,14265,13839,8335
94753,47478,53685,55862,38891,5.59646e+12,54.8253,57223.6,94753,26142,72,41068,41068,39036,37202,36761
38008,14860,17829,23072,14936,6.85648e+12,55.9676,19811,38008,8663,72,20179,20179,18508,16186,15864
15096,2032,4135,9680,5416,9.41165e+12,59.1851,5361.97,15096,2009,72,10961,10961,7974,7902,4474
33831,7127,9504,21659,12172,9.28882e+12,59.2459,11804.1,33831,4617,72,24327,24327,22451,19945,19420
94359,12125,36602,58595,35764,7.90609e+12,57.473,41321.1,94359,17825,72,57757,57757,41441,25464,21086
61044,11512,14222,39584,21460,9.90498e+12,60.1053,18174.3,61044,6920,72,46822,46822,42932,42848,38298
14262,3529,3766,9178,5084,9.55379e+12,59.3166,4951.03,14262,1828,72,10496,10496,10215,10150,9929
6247,1995,3471,4902,1345,80058100000,8.50696,3617.41,6247,3116,11,2776,2776,1898,1946,1869
51649,828,23584,31455,20194,7.02414e+12,56.5287,26168,51649,11483,72,28065,27489,13811,2506,2205
92899,12607,22413,60093,32806,9.80403e+12,59.9994,28001.2,92899,10919,72,70486,70486,56595,43286,39581
50267,11309,20593,31033,19234,7.62387e+12,56.5657,23300.4,50267,10010,72,29674,29674,24174,17736,17692
51209,2061,13264,32973,18236,9.57886e+12,59.6816,16576.7,51209,6462,72,37945,37945,17769,7559,6809
80912,5787,25920,51212,29700,8.77796e+12,58.7322,30443.8,80912,12618,72,54992,54944,31118,21832,17271
85524,12771,19853,55463,30061,9.91763e+12,60.1474,25117.1,85524,9671,72,65671,65671,57155,55165,42799
50866,5535,18114,31882,18984,8.31546e+12,58.1096,21047.4,50866,8812,72,32752,32752,21393,13221,10723
85941,28901,36738,52766,33175,7.39236e+12,56.7055,40858.5,85941,17883,72,49203,49203,44162,39440,38165
98073,44659,48039,76556,21517,78543600000,8.99664,48697.8,98073,43228,11,50034,50034,47350,47681,47033
8392,2592,3118,5252,3140,8.2194e+12,57.3581,3821.69,8392,1516,72,5274,5274,4501,3686,3733
11488,2179,3748,7267,4221,8.7474e+12,56.7386,4691.61,11488,1803,72,7740,7740,6522,4943,4631
77397,2810,24147,49099,28298,8.89044e+12,58.8687,28549.6,77397,11757,72,53250,53250,32201,11891,6411
85335,2523,19814,55335,30000,9.91966e+12,60.1444,25067.5,85335,9648,72,65521,65521,25429,10014,9406
38091,3144,24680,29864,8227,2.23532e+13,5.52498,28311,38091,8236,13,13411,13411,8944,7585,3218
65692,14041,15222,42617,23075,9.92999e+12,60.1301,19427.5,65692,7412,72,50470,50470,48742,48712,46789
13936,1057,3291,9035,4901,9.89954e+12,59.8232,4493.41,13936,1598,72,10645,10645,7455,7383,3701
79938,3947,38704,48278,31660,6.66898e+12,55.7072,42255.1,79938,18850,72,41234,41234,24747,6178,4845
42671,11423,16409,26522,16149,7.95648e+12,57.531,18858.8,42671,7991,72,26262,26262,23129,18904,17963
70597,4918,35307,42452,28145,6.46569e+12,55.8701,38425.2,70597,17197,72,35290,35290,22150,6841,6407
80577,16693,22530,51579,28998,9.31106e+12,59.3811,27262.3,80577,10976,72,58047,58047,52704,51423,43787
69499,1771,19619,44466,25033,9.27187e+12,59.3294,23784.7,69499,9553,72,49880,49880,20355,11611,6335
44361,2312,10359,28765,15596,9.90579e+12,60.0598,13384.3,44361,5041,72,34002,34002,16968,8864,7917
98386,15232,22803,63811,34575,9.92526e+12,60.1499,28739.3,98386,11105,72,75583,75583,66461,53900,51081
71043,10463,16564,46065,24978,9.90141e+12,60.1128,21055.1,71043,8061,72,54479,54479,45656,45471,34911
65088,14129,31765,39276,25812,6.62045e+12,56.0507,34738.6,65088,15468,72,33323,33323,25178,15661,15482
23491,5991,11165,14228,9263,6.81536e+12,56.1209,12507.4,23491,5433,72,12326,12326,9764,6781,6888
50782,8937,17850,31868,18914,8.38214e+12,58.1905,20794.1,50782,8693,72,32932,32932,20081,19807,4395
92257,16019,34278,57560,34697,8.12306e+12,57.9297,39007.3,92257,16699,72,57979,57979,47409,34738,31720
58321,3458,16720,37254,21067,9.2235e+12,59.2544,20294.6,58321,8145,72,41601,41601,27196,26783,9653
86577,6883,26909,54951,31626,8.90517e+12,58.8923,31755.7,86577,13108,72,59668,59668,33230,18798,13157
72797,797,24876,45805,26992,8.51627e+12,58.3927,28899.1,72797,12118,72,47921,47831,27801,14543,3104
62860,8266,20062,39811,23049,8.79695e+12,58.7362,23724,62860,9767,72,42798,42798,32682,32002,19603
32158,659,7513,20855,11303,9.90432e+12,60.025,9841.65,32158,3652,72,24645,24645,14700,9653,2556
1551,832,874,934,617,6.0414e+12,51.4139,1032.69,1551,417,47,677,677,650,650,646
66432,3214,27353,40988,25444,7.59761e+12,56.6142,30748.7,66432,13305,72,39079,39079,23288,11947,8377
32971,4144,7703,21380,11591,9.90115e+12,60.0085,10074.1,32971,3747,72,25268,25268,20099,19991,13884
67166,7814,27559,41438,25728,7.62018e+12,57.113,30992.8,67166,13421,72,39607,39607,27500,13263,12881
47623,8088,11103,30879,16744,9.92447e+12,60.0822,14308.7,47623,5409,72,36520,36520,32923,32080,26976
40958,9606,23665,24059,16899,5.46844e+12,54.4183,25417.2,40958,11527,72,17293,17293,12300,7782,6693
18068,4300,7475,11151,6917,7.58888e+12,56.9854,8668.71,18068,3628,72,10593,10593,8377,5749,5873
98247,22302,30276,62399,35848,8.92815e+12,58.9333,35698.3,98247,14735,72,67971,67971,57996,46237,45835
18990,1938,9076,11489,7501,6.78643e+12,55.454,10211.5,18990,4416,72,9914,9914,5785,962,991
63651,5885,18128,40694,22957,9.24726e+12,59.2835,21981.8,63651,8830,72,45523,45523,30562,18284,14566
72400,10772,38949,43046,29354,5.97543e+12,55.1887,41931.9,72400,18971,72,33451,33451,25470,16385,16080
68046,122,3636,54031,14015,5.78801e+13,12.0019,4497.16,68046,1807,20,64410,64410,38412,17476,45217
29747,3508,6962,19287,10460,9.90543e+12,60.0029,9145.8,29747,3384,72,22785,22785,17798,13039,11806
7469,267,3788,4493,2976,6.38618e+12,55.1084,4330.75,7469,1832,72,3681,3537,2352,1185,918
56254,8285,20383,35188,21066,8.23552e+12,58.0458,23547.9,56254,9920,72,35871,35871,25249,15336,12694
64642,3833,4021,51461,13181,5.73382e+13,11.9968,4849.17,64642,2646,14,60621,60621,59529,58880,60125
81074,12957,18789,52585,28489,9.92971e+12,60.1461,23815.1,81074,9152,72,62285,62285,55206,53567,43327
74234,5646,17303,48134,26100,9.9041e+12,60.1111,21961,74234,8425,72,56931,56931,39959,39616,19108
23694,666,5522,15372,8322,9.91999e+12,59.9712,7344.46,23694,2685,72,18172,18172,11074,10935,2467
43375,22662,25314,25449,17926,5.37982e+12,53.7584,27128.8,43375,12309,72,18061,18061,16829,15667,15569
34919,3838,12690,21836,13083,8.24307e+12,57.8598,14831.2,34919,6176,72,22229,22229,14409,8114,6377
5791,1069,2222,3618,2173,8.11204e+12,56.9506,2749.39,5791,1081,72,3569,3569,3196,2863,2925
37744,9015,15816,23243,14501,7.50239e+12,57.0606,17932.6,37744,7690,72,21928,21928,19100,15168,14462
26645,770,1400,21155,5490,5.79306e+13,11.9917,1930.26,26645,1106,14,25245,25245,20717,17162,23208
24296,1747,8478,15256,9040,8.41262e+12,57.0787,10112.2,24296,4115,72,15818,15818,10141,5304,4070
36006,6709,8392,23344,12662,9.91794e+12,60.0464,10942.3,36006,4083,72,27614,27614,25128,25083,22235
77928,7229,21302,49981,27947,9.38364e+12,59.4794,25941,77928,10372,72,56626,56626,37278,36834,20074
92012,25448,28844,58351,33661,8.86669e+12,58.849,33933.6,92012,14045,72,63168,63168,60151,56099,55204
36891,8246,8605,23930,12961,9.90718e+12,60.033,11205.2,36891,4181,72,28286,28286,27793,27381,27359
7589,1674,7095,5214,2375,9.23552e+12,3.97075,7135.63,7589,2388,9,494,494,114,494,121
51113,5404,11885,33141,17972,9.92993e+12,60.103,15288.6,51113,5790,72,39228,39228,29711,21358,18100
49784,4957,20933,30637,19147,7.50097e+12,57.1035,23574.3,49784,10193,72,28851,28851,17515,8478,5867
88943,9835,29585,56106,32837,8.61734e+12,58.5462,34413.5,88943,14407,72,59358,59358,37450,21291,16191
92942,30378,39002,57196,35746,7.49519e+12,56.7967,43456.1,92942,18978,72,53940,53940,47257,40920,39223
13643,2935,3233,8849,4794,9.92459e+12,59.7361,4409.71,13643,1572,72,10410,10410,10047,9969,9638
63070,16418,19349,40077,22993,8.95669e+12,58.9384,23076.3,63070,9425,72,43721,43721,41389,39161,38761
93594,10435,34347,58463,35131,8.17993e+12,58.0034,39164.3,93594,16733,72,59247,59247,31809,35744,13286
6824,2457,2496,4275,2549,8.2374e+12,57.2868,3107.71,6824,1202,72,4328,4328,4311,4306,4307
50646,9016,12741,32680,17966,9.66312e+12,59.7723,16050.9,50646,6194,72,37905,37905,34071,33137,27718
11118,1776,2596,7216,3902,9.9576e+12,59.7032,3606.83,11118,1256,72,8522,8522,7343,7321,6052
81757,2439,26993,51602,30155,8.64738e+12,58.3608,31502.8,81757,13135,72,54764,54716,25814,11768,5825
54447,8486,12663,35310,19137,9.91896e+12,60.097,16250,54447,6166,72,41784,41784,36752,35578,28352
35220,1124,8284,22836,12384,9.88152e+12,59.9947,10784.1,35220,4026,72,26936,26936,10518,10995,3851
33068,2547,7733,21445,11623,9.88948e+12,60.0019,10112.7,33068,3752,72,25335,25335,15687,15380,8574
32458,14870,15394,19660,12798,6.8215e+12,55.7053,17126.7,32458,7494,72,17064,17064,17034,16982,17048
95742,42061,47763,57581,38161,6.47548e+12,55.9033,51791.8,95742,23260,72,47979,47979,45796,43254,43381
35216,2145,8204,22837,12379,9.91479e+12,60.0581,10711.7,35216,3992,72,27012,27012,18145,12489,7335
68850,22668,34307,41418,27432,6.48145e+12,55.4915,37375.2,68850,16690,72,34543,34543,29507,24739,23601
63039,1794,26269,38831,24208,7.53816e+12,57.1837,29496,63039,12792,72,36770,36770,21541,8701,3111
83505,3692,49110,48906,34599,5.32358e+12,54.491,52166.2,83505,23923,72,34395,34395,19291,7947,4473
94782,30157,42558,57836,36946,7.11608e+12,56.4336,46891.9,94782,20710,72,52224,52224,45273,37206,36972
66749,11057,16840,43050,23699,9.67065e+12,59.8054,21004.2,66749,8203,72,49909,49909,43612,35058,33063
2667,544,726,1724,943,9.58037e+12,57.706,1067.05,2667,347,59,1941,1941,1725,1678,1520
51104,12223,13520,32855,18249,9.4986e+12,59.5883,16809.7,51104,6577,72,37584,37584,36246,36203,34829
17521,3062,6467,10952,6569,8.19789e+12,57.719,7699.13,17521,3146,72,11054,11054,8307,8211,5122
27836,742,10409,17372,10464,8.09727e+12,56.7043,12171.8,27836,5050,72,17427,17308,10020,6124,1155
94538,42111,61241,74115,20423,2.23528e+13,5.53086,70150.3,94538,20424,13,33297,33297,30609,33297,24239
34984,4529,8162,22684,12300,9.90755e+12,60.0357,10652.5,34984,3971,72,26822,26822,21463,21356,15049
23367,236,10499,14266,9101,7.14311e+12,55.6686,11887.9,23367,5098,72,12868,12484,5486,2386,1002
36507,881,8503,23669,12838,9.92184e+12,60.0589,11082.9,36507,4136,72,28004,28004,10029,3441,3355
2333,216,586,1521,812,1.0217e+13,57.8307,899.265,2333,285,57,1747,1747,1212,679,732
15449,2473,4083,9931,5518,9.5545e+12,59.3912,5342.46,15449,1989,72,11366,11366,9489,6992,6481
33371,2081,9330,21365,12006,9.31042e+12,59.2888,11609.5,33371,4540,72,24041,24041,15249,15048,4556
12315,1030,5416,7535,4780,7.32956e+12,56.5416,6278.02,12315,2635,72,6899,6851,3994,595,685
89128,11567,27347,56636,32492,8.94977e+12,58.9328,32342.9,89128,13302,72,61781,61781,40419,21539,16129
25056,6653,8336,15815,9241,8.65551e+12,58.3891,10038.2,25056,4056,72,16720,16720,15567,14083,13797
35862,14183,16779,21768,14094,6.88659e+12,56.3301,18675.2,35862,8170,72,19083,19083,17865,16283,15982
16584,7794,8939,12996,3588,79662400000,8.89719,9189.27,16584,8037,11,7645,7645,6909,6965,6872
71700,11431,18229,46211,25489,9.63643e+12,59.4587,22647.1,71700,8875,72,53471,53471,44180,33257,32867
16246,2952,3829,10528,5718,9.8988e+12,59.8053,5180.02,16246,1860,72,12417,12417,11145,9975,9751
18736,6431,8172,11474,7262,7.31794e+12,56.546,9364.76,18736,3976,72,10564,10564,9487,8460,8411
89415,18914,24539,57316,32099,9.37175e+12,59.4739,29748.6,89415,11949,72,64876,64876,57622,49081,48833
7609,180,3710,4600,3009,6.71508e+12,55.5629,4275.49,7609,1807,72,3899,3697,2355,1235,674
38316,1185,8919,24851,13465,9.92746e+12,60.0619,11599.4,38316,4344,72,29397,29397,11551,4617,4363
3813,688,932,2478,1335,9.97549e+12,58.5948,1383.11,3813,449,66,2881,2881,2532,2275,2283
26011,3697,7703,16583,9428,9.10185e+12,59.0012,9537.61,26011,3747,72,18308,18308,14094,13972,9075
20539,3247,4810,13329,7210,9.90969e+12,59.9032,6434.76,20539,2336,72,15729,15729,13921,13490,11025
21023,2492,4999,13624,7399,9.88379e+12,59.6098,6646.89,21023,2419,72,16024,16024,13097,9166,8300
55672,4732,15513,35642,20030,9.33094e+12,59.3805,18985,55672,7557,72,40159,40159,26746,24993,13411
1218,247,342,793,425,9.79034e+12,55.0099,533.304,1218,161,47,876,876,763,703,708
95327,26216,49967,56903,38424,6.14634e+12,55.4776,53816,95327,24336,72,45360,45360,32593,20508,17258
52936,16773,24208,32227,20709,7.0142e+12,55.9611,26845.9,52936,11771,72,28728,28728,25329,20634,19736
29141,6309,8142,18652,10489,9.33198e+12,59.3034,10186.7,29141,3965,72,20999,20999,19495,19098,17149
16895,3551,7546,10318,6577,7.15809e+12,55.7405,8633.43,16895,3661,72,9349,9349,7216,4565,3973
12150,1631,6011,7325,4825,6.58843e+12,53.8146,6801.74,12150,2911,72,6139,6139,4436,2833,2561
24354,3622,8082,15378,8976,8.67178e+12,58.4304,9750.17,24354,3935,72,16272,16272,12100,8136,7118
83062,17506,28066,52315,30747,8.55073e+12,53.8173,32593.8,83062,13650,72,54996,54996,44195,31490,31049
45132,8819,18315,27897,17235,7.67062e+12,57.261,20805.4,45132,8908,72,26817,26817,20891,13955,13890
9561,1513,2226,6206,3355,9.97576e+12,59.7548,3131.17,9561,1083,72,7335,7335,6472,6274,5191
36783,2600,16613,22435,14348,7.08478e+12,56.5667,18594.7,36783,8080,72,20170,20170,12526,3522,3367
7136,202,1687,4638,2498,1.00236e+13,59.4875,2408.95,7136,819,72,5449,5449,1931,813,747
32820,2459,9910,20886,11934,9.02979e+12,58.9059,12104.6,32820,4811,72,22910,22910,15288,10262,8574
13729,1624,3879,8788,4941,9.30452e+12,59.0484,5009.89,13729,1883,72,9850,9850,6724,4141,3579
2269,20,629,1459,810,9.75675e+12,57.4077,930.555,2269,301,57,845,156,265,23,34
47303,3456,13420,30251,17052,9.25369e+12,58.7837,16439.8,47303,6515,72,33883,33883,22922,10037,9555
47870,7761,16785,30046,17824,8.39687e+12,58.2103,19594.9,47870,8171,72,31085,31085,24146,16009,15888
29644,5874,11459,18419,11225,7.9291e+12,57.5748,13284.1,29644,5569,72,18185,18185,14944,10560,9584
8419,486,2585,5366,3053,9.03618e+12,58.4368,3345.11,8419,1255,72,5834,5786,3432,2048,1673
80690,18141,34145,49607,31083,7.45122e+12,57.0652,38075.6,80690,16618,72,46545,46545,37125,28182,25844
1793,254,459,1162,631,1.04435e+13,57.1305,715.964,1793,223,53,1334,1334,1037,830,852
20349,2146,7348,12740,7609,8.28624e+12,57.8993,8746.83,20349,3573,72,13001,13001,8697,3643,3659
32223,13344,13893,19766,12457,7.3474e+12,55.5625,15728.9,32223,6753,72,18330,18330,18000,17502,17624
74036,1345,25767,46499,27537,8.43133e+12,58.283,29815,74036,12553,72,48269,48269,14884,7521,2048
35087,14945,21461,20400,14687,5.04031e+12,52.9512,22912.3,35087,10449,72,13626,13626,12210,10242,10017
51654,4834,20889,31935,19719,7.68312e+12,57.3445,23675.7,51654,10162,72,30765,30765,19744,6837,6394
36826,7864,12825,23127,13699,8.41775e+12,58.0062,15103.5,36826,6233,72,24001,24001,20311,15198,14204
77847,21056,31589,48097,29750,7.67949e+12,57.3826,35498.5,77847,15389,72,46258,46258,40999,34845,34813
24240,6265,10032,14948,9292,7.5886e+12,55.521,11535.7,24240,4865,72,14208,14208,11575,8499,8596
54865,7999,24547,33499,21366,7.14014e+12,56.2208,27303.3,54865,11937,72,30318,30318,20218,11692,9190
49007,9000,26441,29122,19885,5.95474e+12,55.2047,28608.2,49007,12870,72,22566,22566,16014,9874,8336
83540,19962,21400,53825,29715,9.61121e+12,59.7562,26415.6,83540,10424,72,62140,62140,61002,59533,59264
5857,997,1443,3791,2066,9.88644e+12,59.2042,2061.63,5857,703,72,4414,4414,3765,3753,3144
22194,886,5175,14393,7801,9.95052e+12,59.9491,6899.47,22194,2521,72,17019,17019,7452,3461,3224
89698,6119,40833,54645,35053,7.03834e+12,56.4398,44926.5,89698,19875,72,48865,48865,30895,9951,9161
7555,704,1842,4889,2666,9.84438e+12,59.3399,2589.62,7555,892,72,5713,5713,4094,4058,2374
57561,8318,19627,36223,21338,8.51935e+12,58.3823,22937.5,57561,9555,72,37934,37934,30077,28563,17890
66245,9800,33053,39845,26400,6.47916e+12,55.6253,36018.9,66245,16086,72,33192,33192,23320,14610,12240
47553,5557,11080,30830,16723,9.9153e+12,60.0812,14284.8,47553,5391,72,36473,36473,29871,28325,18818
81623,7622,21883,52415,29208,9.45261e+12,59.5762,26739.1,81623,10660,72,59740,59740,42352,41936,21111
83324,7881,19371,54035,29289,9.91206e+12,60.1291,24513.4,83324,9433,72,63953,63953,47225,46887,26690
48427,5896,11229,31419,17008,9.92979e+12,60.0947,14486.6,48427,5466,72,37198,37198,29394,29241,19910
87412,1362,20295,56691,30721,9.91774e+12,60.1391,25656.6,87412,9882,72,67117,67117,21273,23281,5570
1090,88,316,706,384,9.38315e+12,54.2734,492.386,1090,139,45,774,704,362,245,274
24107,4263,5606,15631,8476,9.93826e+12,60.0133,7453.51,24107,2730,72,18501,18501,16856,16480,14252
41683,4361,9683,27032,14651,9.92921e+12,60.0761,12560.8,41683,4710,72,32000,32000,24566,16778,14741
45866,9961,12663,29397,16469,9.35793e+12,59.3844,15626.7,45866,6165,72,33203,33203,30990,28036,27413
96661,9187,28853,61556,35105,9.06275e+12,59.0895,34260.2,96661,14051,72,67808,67808,39820,6697,5332
32876,2537,8763,21123,11753,9.49783e+12,59.507,11044.3,32876,4268,72,24113,24113,16532,7545,7394
97736,14723,30005,62100,35636,8.94863e+12,58.954,35409.6,97736,14610,72,67731,67731,54012,35124,30786
50206,1584,11688,32552,17654,9.91724e+12,60.0805,15040.5,50206,5693,72,38518,38518,23747,15768,5609
25187,575,9045,15769,9418,8.31734e+12,56.5175,10703.2,25187,4400,72,16142,15950,5999,4998,0
94224,26705,44211,57157,37067,6.85398e+12,56.3375,48387.6,94224,21524,72,50013,50013,42911,34613,34488
88217,11687,25398,56345,31872,9.19026e+12,59.2498,30466.6,88217,12359,72,62819,62819,50396,47737,30134
65534,22424,29151,40040,25494,7.17322e+12,56.3498,32353.7,65534,14195,72,36383,36383,32696,27605,26612
55341,6904,18825,34835,20506,8.5353e+12,58.3963,22030.7,55341,9170,72,36516,36468,30526,30405,23299
3903,241,940,2530,1373,1.00359e+13,58.9026,1403.23,3903,454,66,2963,2963,1938,1918,866
25494,1335,9680,15870,9624,8.01729e+12,56.8899,11314.1,25494,4700,72,15814,15814,10142,3561,3367
55171,8081,18155,34842,20329,8.67485e+12,58.459,21400.1,55171,8828,72,37016,37016,29157,20173,17884
35093,1283,10814,22302,12791,8.93056e+12,58.8354,13113.1,35093,5258,72,24279,24279,10920,8245,852
48321,2692,11264,31338,16983,9.9047e+12,60.0731,14513,48321,5481,72,37057,37057,19206,19177,9230
21430,1617,5011,13898,7532,9.90837e+12,59.92,6690.11,21430,2435,72,16419,16419,9964,9741,5344
74306,6389,17265,48193,26113,9.90993e+12,60.1163,21931.8,74306,8396,72,57041,57041,38407,24887,21593
4293,119,1040,2789,1504,9.91884e+12,58.8088,1534.42,4293,500,69,3253,3253,1055,1141,399
63444,10565,14700,41145,22299,9.93062e+12,60.1346,18784.3,63444,7157,72,48744,48744,42720,42599,35459
2424,106,614,1574,850,1.01855e+13,57.7063,934.653,2424,295,58,1810,1810,674,447,354
66637,11538,15489,43211,23426,9.91701e+12,60.1257,19745.2,66637,7541,72,51148,51148,45400,45284,38457
53253,3981,29297,31550,21703,5.82102e+12,54.9539,31570.2,53253,14256,72,23956,23956,11539,5165,2614
58416,11268,25572,35760,22656,7.26014e+12,56.8394,28513.1,58416,12449,72,32844,32844,24581,14909,14724
14377,878,5257,9002,5375,8.23356e+12,57.5146,6322.35,14377,2541,72,9120,9072,5899,2189,2111
67883,6712,15780,44024,23859,9.9108e+12,60.1231,20104.4,67883,7681,72,52103,52103,38438,26179,22617
12101,1681,2880,7847,4254,9.93406e+12,59.6715,3951.08,12101,1400,72,9221,9221,7748,7419,5461
82489,8713,26323,52231,30258,8.79591e+12,55.9762,30929.8,82489,12807,72,56166,56166,40506,22042,21321
55330,13224,15258,35459,19871,9.35794e+12,59.1224,18726.8,55330,7416,72,40072,40072,38112,37649,34975
27296,13455,15181,21420,5876,80160200000,8.98725,15496,27296,13655,11,12115,12115,11188,11210,11185
88064,18157,20447,57107,30957,9.91526e+12,60.1418,25842.8,88064,9956,72,67617,67617,64341,64268,60492
65195,9753,23973,40727,24468,8.16419e+12,57.952,27521.4,65195,11665,72,41222,41222,30771,20796,18170
16892,5158,5517,10680,6212,8.71375e+12,58.3566,6778.64,16892,2682,72,11375,11375,10955,10463,10431
27082,3586,6879,17475,9607,9.64348e+12,59.6478,8861.58,27082,3342,72,20203,20203,16372,11078,10036
86387,4481,45389,67627,18760,79391200000,8.98178,45982.2,86387,40844,11,40998,40998,12302,15050,9571
25160,1231,5875,16322,8838,9.88407e+12,59.9249,7784.95,25160,2848,72,19285,19285,12533,8544,4331
46830,1510,24972,27884,18946,6.03748e+12,55.2809,27085.8,46830,12148,72,21858,21714,12601,4455,1556
79016,9967,28956,49361,29655,8.18916e+12,57.947,33133.4,79016,14100,72,50060,50060,33181,22164,18499
68611,16570,23204,43220,25391,8.55189e+12,58.4369,27051,68611,11301,72,45407,45407,40929,35734,35621
98690,14302,43557,60360,38330,7.21685e+12,56.8136,48089.4,98690,21215,72,55133,55133,35556,12583,11671
53524,20920,27807,32005,21519,6.20538e+12,55.5365,30216.4,53524,13537,72,25717,25717,23278,19901,19323
16454,2036,3885,10673,5781,9.88584e+12,59.7837,5247.85,16454,1880,72,12569,12569,9975,9910,6941
1947,46,555,1254,693,9.62166e+12,57.0586,823.859,1947,268,53,1180,393,788,767,229
33074,10987,18686,19521,13553,5.63053e+12,54.5562,20201.2,33074,9099,72,14388,14388,11890,8545,7815
13810,5526,7321,8247,5563,6.11522e+12,53.0112,8144.28,13810,3548,72,6489,6489,5901,5219,5427
60511,17232,29156,36579,23932,6.69907e+12,56.1433,31984.8,60511,14197,72,31355,31355,26882,21742,21752
14909,3685,4538,9487,5422,9.02495e+12,58.7232,5714.08,14909,2205,72,10371,10371,9211,7850,8023
51096,6063,23053,31160,19936,7.10004e+12,56.6297,25637.3,51096,11227,72,28043,28043,20125,11786,9589
37950,534,14166,23667,14283,8.10474e+12,56.9766,16425.4,37950,6895,72,23784,23481,9219,3240,414
26050,7801,12083,15838,10212,6.96312e+12,56.3116,13560.2,26050,5882,72,13967,13919,9376,3049,1764
79566,32175,35106,48657,30909,7.21404e+12,56.4037,38889.6,79566,17088,72,44460,44460,41934,39038,38989
97650,29074,31302,61800,35850,8.77336e+12,56.1183,36615.2,97650,15227,72,66348,66348,66348,66348,66348
80764,4939,27716,50803,29961,8.4778e+12,58.171,32105.9,80764,13480,72,53048,53048,27517,15857,10725
77300,16050,29136,48165,29135,8.0461e+12,57.7897,33181,77300,14189,72,48164,48164,38647,25657,22573
74903,9949,21073,47932,26971,9.27755e+12,56.2898,25518.1,74903,10244,72,53830,53830,44520,35612,33155
81232,4447,42657,63588,17644,79393200000,8.9966,43232.2,81232,38383,11,38575,38575,12454,14793,10127
21246,4927,4980,13784,7462,9.89425e+12,59.8689,6647.78,21246,2413,72,16266,16266,16229,16233,16222
61340,15282,28672,37232,24108,6.88614e+12,56.3847,31600.2,61340,13963,72,32668,32668,26286,18849,18759
92908,7550,39319,57117,35791,7.44305e+12,57.0977,43746,92908,19140,72,53589,53589,29604,17891,12972
23708,4718,5533,15381,8327,9.93796e+12,59.9589,7353.28,23708,2691,72,18175,18175,16973,15871,15692
45903,9120,10706,29763,16140,9.90691e+12,60.0766,13820.4,45903,5208,72,35197,35197,32924,32869,30355
88075,19848,31230,55218,32857,8.33484e+12,58.1932,35882.3,88075,15208,72,56845,56845,50761,42502,40589
45182,9717,24203,26878,18304,6.00645e+12,54.6095,26247.1,45182,11781,72,20979,20979,14814,7623,7528
45826,2519,10635,29728,16098,9.93589e+12,60.0766,13744.2,45826,5174,72,35191,35191,18167,9981,8913
15359,3473,3626,9966,5393,9.90649e+12,59.7896,4917.62,15359,1762,72,11733,11733,11521,11363,11410
85994,14911,19964,55766,30228,9.92277e+12,60.1418,25249.5,85994,9726,72,66030,66030,60008,58592,49925
62597,1317,17031,40164,22433,9.40091e+12,59.4663,20890.6,62597,8284,72,45566,45566,17045,2694,2557
69275,9339,16099,44928,24347,9.92448e+12,60.1247,20492.5,69275,7841,72,53176,53176,43242,43053,31118
25520,8499,11566,15556,9964,7.07465e+12,56.498,13047,25520,5626,72,13954,13954,12025,10178,9888
90413,66954,90413,0,90413,7.99991,0,90413,90413,90413,1,0,0,0,0,0
94200,10494,29582,59728,34472,8.85962e+12,58.843,34772.3,94200,14405,72,64618,64618,36646,16382,9771
10746,531,2501,6979,3767,9.98506e+12,59.7634,3487.41,10746,1218,72,8245,8245,3923,2043,1899
17807,8413,10331,10460,7347,5.45207e+12,51.5314,11250.3,17807,5011,72,7476,7476,7245,6906,7038
42201,9582,9790,27371,14830,9.92838e+12,60.1022,12700.1,42201,4769,72,32411,32411,32170,31932,31933
19084,1526,6306,12046,7038,8.65739e+12,58.3651,7688.49,19084,3063,72,12778,12778,8346,8202,3111
76600,30282,31916,47179,29421,7.53774e+12,57.1552,35715.4,76600,15542,72,44684,44684,43783,42656,42463
6848,1460,1673,4435,2413,9.94729e+12,59.2761,2365.95,6848,815,72,5175,5175,4868,4861,4666
1810,637,1162,1050,760,5.40559e+12,51.0923,1313.5,1810,564,53,648,600,597,564,632
64336,12546,16869,41385,22951,9.53055e+12,59.6405,20864.7,64336,8212,72,47467,47467,41454,35716,34202
36961,410,11547,23450,13511,8.89367e+12,58.8067,13932.8,36961,5624,72,25414,25096,10249,3986,1220
85534,15439,19870,55467,30067,9.91653e+12,60.1349,25131.1,85534,9673,72,65664,65664,60309,53062,51390
49055,5545,11728,31758,17297,9.84312e+12,59.9883,14991.6,49055,5712,72,37327,37327,28658,20594,18117
56853,4498,27465,34353,22500,6.68075e+12,55.2838,30152.3,56853,13358,72,29388,29388,17905,9210,6616
8824,880,2133,5718,3106,9.89186e+12,59.4367,2971.77,8824,1036,72,6691,6691,4722,4509,2732
75678,6454,17626,49071,26607,9.90271e+12,60.1164,22365.5,75678,8573,72,58052,58052,38827,37658,21867
51315,743,20426,31777,19538,7.79975e+12,57.4658,23216.9,51315,9950,72,30889,30483,14532,4361,886
99379,364,23096,64444,34935,9.90616e+12,60.1371,29084.8,99379,11235,72,76283,76283,19436,22427,2353
83414,7818,19375,54089,29325,9.92336e+12,60.1391,24523.1,83414,9438,72,64039,64039,47195,46855,26512
17546,857,1135,13966,3580,5.72603e+13,12.0069,1567.28,17546,645,20,16411,16411,14707,13590,15257
66676,11207,15508,43235,23441,9.91132e+12,60.1125,19764.1,66676,7545,72,51168,51168,46005,44800,37358
50251,8999,16566,31719,18532,8.66554e+12,58.5533,19567.6,50251,8069,72,33685,33685,26988,19216,18967
79215,2232,18376,51372,27843,9.91209e+12,60.1277,23307.8,79215,8938,72,60839,60839,37324,36853,8350
55926,3062,23837,34352,21574,7.41332e+12,57.0193,26721.6,55926,11607,72,32089,32089,19223,4103,3682
51487,15656,23958,31274,20213,6.91382e+12,56.0413,26504.1,51487,11654,72,27529,27529,23064,17911,17778
76533,17474,20362,49176,27357,9.48043e+12,59.6036,24969.7,76533,9919,72,56171,56171,53635,53040,49508
12305,1582,2855,7987,4318,9.96585e+12,59.8504,3951.92,12305,1387,72,9450,9450,7573,7539,5426
67197,6347,15632,43578,23619,9.91888e+12,60.1129,19914,67197,7610,72,51565,51565,36954,35472,21369
95802,44140,52158,56845,38957,5.88475e+12,55.1134,55884.7,95802,25390,72,43644,43644,40296,37199,36391
15913,1449,4439,10191,5722,9.34764e+12,59.1297,5710.81,15913,2154,72,11474,11474,7192,7996,5028
78621,8808,18304,50987,27634,9.90035e+12,60.1176,23199.4,78621,8905,72,60317,60317,48661,46253,29710
3256,635,807,2113,1143,1.00253e+13,58.4401,1206.99,3256,392,63,2449,2449,2218,2212,2088
99128,11000,23037,64284,34844,9.91401e+12,60.1392,29008.8,99128,11212,72,76091,76091,61000,41765,37037
95781,7738,31517,60475,35306,8.66013e+12,58.6001,36685.5,95781,15338,72,64264,64264,33832,21031,15057
19962,616,4824,12918,7044,9.85437e+12,59.8112,6397.05,19962,2350,72,15138,15138,9305,9170,2273
41936,4100,13114,26600,15336,8.88781e+12,58.7963,15753.9,41936,6383,72,28822,28822,20567,10836,10652
33166,5483,7738,21507,11659,9.91132e+12,60.0418,10125.7,33166,3764,72,25428,25428,22108,22049,18162
5877,669,1403,3822,2055,9.95017e+12,59.1897,2026.61,5877,679,72,4474,4474,3537,2457,2259
8562,512,2543,5462,3100,9.15053e+12,57.5758,3323.78,8562,1232,72,6019,6000,3763,1169,1176
16414,8162,8350,9842,6572,6.3988e+12,54.2541,9320.25,16414,4062,72,8064,8064,7951,7776,7908
31772,533,7365,20610,11162,9.9308e+12,60.0337,9674.03,31772,3576,72,24407,24407,14398,14208,2153
86952,10582,20260,56385,30567,9.90497e+12,60.1257,25592.5,86952,9862,72,66692,66692,55097,52380,35468
37301,6608,15822,22933,14368,7.44292e+12,57.0164,17906.6,37301,7698,72,21479,21479,15314,10305,8975
95760,9044,37787,59352,36408,7.82588e+12,57.5656,42515.8,95760,18408,72,57973,57973,40682,20502,19731
4993,218,1199,3239,1754,9.89324e+12,59.0911,1754.85,4993,572,72,3794,3794,2372,2345,780
52374,4355,15978,33294,19080,8.97563e+12,58.9477,19181.3,52374,7773,72,36396,36396,24676,10901,10387
9876,1057,2375,6406,3470,9.83069e+12,59.5414,3294.15,9876,1151,72,7501,7501,5556,5523,3328
87952,6997,20424,57042,30910,9.91818e+12,60.1287,25811.3,87952,9941,72,67528,67528,43484,42353,24070
91922,21229,28072,58427,33495,8.97413e+12,58.9774,33207.4,91922,13671,72,63850,63850,55929,48395,46328
79910,6463,19958,51568,28342,9.69778e+12,59.862,24824.9,79910,9722,72,59952,59952,41380,40963,18585
24420,5964,8046,15435,8985,8.672e+12,58.4329,9723.85,24420,3912,72,16374,16374,13832,10430,9690
92865,15919,21555,60229,32636,9.91025e+12,60.1334,27203.3,92865,10488,72,71310,71310,64505,55241,53064
39727,6872,9233,25765,13962,9.94613e+12,60.0685,11994.5,39727,4497,72,30494,30494,26995,26931,22850
80518,13075,24681,51161,29357,8.96877e+12,58.9579,29259.7,80518,12023,72,55837,55837,50299,50186,43633
62236,19630,37977,36213,26023,5.03572e+12,54.1137,40275.6,62236,18494,72,24259,24259,19132,12061,10587
71778,13651,16680,46550,25228,9.9147e+12,60.1207,21209.4,71778,8122,72,55098,55098,50619,50540,45257
13949,2651,5497,8647,5302,7.87561e+12,56.6157,6502.86,13949,2672,72,8452,8452,7081,5479,5649
71743,1402,19055,46110,25633,9.48044e+12,59.5796,23417.6,71743,9270,72,52688,52688,31369,30858,5180
74570,38477,42146,43975,30595,5.61885e+12,53.8376,45058.7,74570,20509,72,32424,32424,31809,30942,30972
18032,7317,9717,14131,3901,79738500000,8.86502,9978.4,18032,8739,11,8315,8315,6825,6923,6743
25657,4464,5988,16648,9009,9.90258e+12,59.9575,7928.96,25657,2904,72,19669,19669,17824,17400,14856
78149,11718,19963,50367,27782,9.61141e+12,59.7631,24710.9,78149,9719,72,58186,58186,49784,38321,35623
26682,7453,11540,16371,10311,7.36215e+12,56.5991,13116.2,26682,5618,72,15142,15142,12485,10009,9425
34122,981,7959,22132,11990,9.92466e+12,60.0478,10398.5,34122,3875,72,26163,26163,9999,10504,3658
30635,340,2046,24418,6217,5.70704e+13,11.994,2611.04,30635,1252,14,28589,28589,17848,10809,23737
3741,666,1197,2383,1358,8.80469e+12,57.0944,1609.42,3741,570,69,2544,2544,2201,2178,1956
28447,1619,15063,22276,6171,79517300000,8.9465,15397.8,28447,13554,11,13384,13384,4253,5055,3466
25354,3120,8685,15957,9397,8.50931e+12,58.2229,10385.1,25354,4227,72,16669,16669,12178,6922,6833
12785,2680,4027,8108,4677,8.90345e+12,58.4803,5058.18,12785,1955,72,8758,8758,7829,6659,6451
44205,6508,15477,27756,16449,8.40593e+12,58.2042,18109.8,44205,7534,72,28728,28728,21398,12764,12623
52516,10867,14661,33627,18889,9.30814e+12,59.3515,17970,52516,7129,72,37855,37855,33346,28081,27944
55842,12881,31578,32926,22916,5.61229e+12,54.7692,33875.5,55842,15375,72,24264,24264,17129,8888,8743
93850,34959,37560,58080,35770,7.74931e+12,56.9017,42174.3,93850,18282,72,56290,56290,55785,55125,55114
13125,6267,6771,10266,2859,79148700000,8.97524,6999.64,13125,6086,11,6354,6354,5966,6011,5934
92696,36397,43366,56259,36437,6.87202e+12,56.1741,47495.7,92696,21104,72,49330,49330,44725,39385,39252
32161,16811,17395,19118,13043,5.93168e+12,52.8055,18943.1,32161,8452,72,14766,14766,14766,14766,14766
99309,20719,49358,59762,39547,6.50011e+12,55.9379,53526.5,99309,24037,72,49951,49951,34863,17171,16635
53602,24454,28169,41960,11642,79389100000,8.99327,28634.3,53602,25347,11,25433,25433,23109,23265,22970
40813,2573,24330,23846,16967,5.21679e+12,53.6809,26017.8,40813,11838,72,16483,16483,9105,3798,2260
5982,73,2177,3743,2239,8.25809e+12,57.2247,2733.33,5982,1049,72,3805,2654,2164,1231,325
95308,15258,22164,61810,33498,9.90922e+12,60.1363,27938,95308,10791,72,73144,73144,63126,62919,50889
70645,12422,30416,43348,27297,7.35352e+12,56.9712,33894.8,70645,14812,72,40229,40229,30045,19718,17081
52590,9611,12234,34106,18484,9.92102e+12,60.0967,15717,52590,5959,72,40356,40356,36579,33011,32094
11729,1092,2793,7606,4123,9.87469e+12,59.6833,3842.72,11729,1355,72,8936,8936,6485,6438,3728
92017,5014,21405,59667,32350,9.91493e+12,60.1388,27003,92017,10426,72,70612,70612,46807,46316,17492
1654,51,427,1067,587,1.02936e+13,57.0726,671.526,1654,204,52,1084,389,362,225,152
82228,6620,40904,49466,32762,6.49367e+12,55.8726,44461.4,82228,19925,72,41324,41324,26946,10346,9702
74308,13388,22374,47290,27018,9.02708e+12,59.0303,26681.7,74308,10896,72,51934,51934,44202,42292,31193
5240,5214,5240,0,5240,7.99847,0,5240,5240,5240,1,0,0,0,0,0
85849,17012,28620,54140,31709,8.61039e+12,58.3505,33301.6,85849,13926,72,57229,57229,49462,47491,36407
98109,13625,28965,62528,35581,9.10549e+12,59.1447,34462.4,98109,14111,72,69144,69144,53015,33778,28906
3891,1648,1649,2401,1490,7.44434e+12,55.6001,2027.09,3891,789,61,2242,2242,2242,2242,2240
77017,16520,17854,49944,27073,9.92389e+12,60.1456,22667.6,77017,8696,72,59163,59163,57190,57154,54939
59678,21673,22373,37199,22479,8.07685e+12,57.7202,25642.5,59678,10883,72,37305,37305,36679,35908,35800
44559,3625,10358,28907,15652,9.9128e+12,60.0664,13398.2,44559,5033,72,34201,34201,24340,24152,12297
28974,7671,10295,18163,10811,8.34728e+12,57.8392,12158.5,28974,5009,72,18679,18679,16963,14585,14254
74172,17122,27783,46242,27930,8.08297e+12,57.766,31701.4,74172,13518,72,46389,46389,40203,31796,29841
40194,2305,9419,26064,14130,9.8876e+12,60.0216,12206,40194,4577,72,30775,30775,20460,14002,7857
2982,693,737,1928,1054,9.94819e+12,58.388,1115.66,2982,355,61,2245,2245,2212,2214,2210
93846,10164,41758,57335,36511,7.17189e+12,56.7598,46075.3,93846,20339,72,52088,52088,35125,15375,14596
33479,1823,2191,26674,6805,5.71562e+13,11.9937,2782.65,33479,1369,14,31288,31288,28846,27159,30184
18070,642,5292,11530,6540,9.18964e+12,58.949,6668.86,18070,2578,72,12778,12778,7573,4752,1391
24937,4811,5812,16182,8755,9.92642e+12,59.9745,7708.56,24937,2827,72,19125,19125,17901,16313,16006
17322,2846,4067,11230,6092,9.93086e+12,59.8717,5487.63,17322,1974,72,13255,13255,11852,10023,9667
32903,1960,7687,21344,11559,9.91289e+12,60.0169,10055.7,32903,3740,72,25216,25216,13443,13372,6612
7144,1456,1909,4598,2546,9.53655e+12,57.0559,2613.67,7144,909,72,5235,5235,5023,4851,4912
73325,2516,26903,45813,27512,8.18406e+12,57.9861,30821.6,73325,13101,72,46422,46422,28348,10953,6302
25357,1588,7812,16121,9236,8.93384e+12,58.7744,9584.98,25357,3796,72,17545,17545,10845,2937,2777
99344,18327,23081,64420,34924,9.90959e+12,60.1446,29069.5,99344,11231,72,76263,76263,70542,69208,60939
19104,47,4478,12395,6709,9.89641e+12,59.9067,6014.98,19104,2174,72,12416,4106,3528,4128,303
36410,213,8480,23614,12796,9.91703e+12,60.0501,11055.2,36410,4126,72,27930,27930,15870,15631,1123
28409,7134,9090,17984,10425,8.81299e+12,58.6386,11002.5,28409,4422,72,19319,19319,17177,14218,13749
10688,2024,2558,6928,3760,9.88016e+12,59.6014,3533.85,10688,1241,72,8130,8130,7462,7431,6836
51722,8682,12039,33544,18178,9.92008e+12,60.0715,15474.6,51722,5856,72,39683,39683,34843,34742,29012
8409,1305,2048,5446,2963,9.7907e+12,59.3178,2858.7,8409,991,72,6361,6361,5474,5269,4136
54674,15751,54674,0,54674,7.99985,0,54674,54674,54674,1,0,0,0,0,0
78761,4797,22062,50409,28352,9.29875e+12,59.2969,26707.3,78761,10742,72,56699,56699,36503,12679,11717
8037,2061,4697,4728,3309,5.5092e+12,49.5546,5200.21,8037,2271,72,3340,3340,2528,1635,1758
16382,4341,16382,0,16382,7.99951,0,16382,16382,16382,1,0,0,0,0,0
28373,3457,6641,18397,9976,9.90487e+12,60.0204,8745.85,28373,3232,72,21732,21732,17928,12794,11615
64693,11010,28538,39579,25114,7.21609e+12,56.6084,31722.5,64693,13881,72,36155,36155,25466,12914,12603
1158,200,330,750,408,9.68623e+12,54.8402,513.184,1158,155,46,828,828,656,650,576
84084,12676,44888,50060,34024,6.02125e+12,54.75,48293,84084,21847,72,39196,39196,26124,13774,10444
21867,4060,7225,13820,8047,8.659e+12,57.7999,8762.5,21867,3498,72,14642,14642,12443,9531,8900
16113,1533,5121,10219,5894,8.87878e+12,57.9695,6349.25,16113,2478,72,10992,10992,7502,5321,4605
78422,6384,18196,50862,27560,9.91463e+12,60.1306,23082.9,78422,8859,72,60226,60226,39237,25139,21889
39444,7297,11277,25206,14238,9.24053e+12,59.2198,13869.1,39444,5487,72,28167,28167,23588,18262,18124
73217,13729,17057,47471,25746,9.90976e+12,60.0819,21661.7,73217,8303,72,56160,56160,51332,51232,45550
22588,3981,7672,14222,8366,8.58302e+12,58.2664,9226.05,22588,3737,72,14916,14916,12205,8583,7794
67568,14774,27356,41759,25809,7.68828e+12,56.9173,30836.4,67568,13304,72,40212,40212,33074,24718,24590
31628,392,2039,25184,6444,5.72374e+13,12.0045,2621.11,31628,1047,20,29589,29589,19171,12199,22259
32523,349,7596,21089,11434,9.93241e+12,60.0274,9939.03,32523,3699,72,24927,24927,14271,14070,1264
60702,477,16524,38939,21763,9.4112e+12,59.4749,20281.3,60702,8050,72,44178,43942,25345,13860,2251
91415,18851,21215,59292,32123,9.91205e+12,60.141,26788.9,91415,10329,72,70200,70200,66699,66637,62538
39831,11026,11668,25404,14427,9.15074e+12,59.1091,14259.2,39831,5678,72,28163,28163,27328,26460,26502
69402,14728,16134,45004,24398,9.9147e+12,60.1143,20534.5,69402,7856,72,53268,53268,51663,49537,49094
4862,1348,3296,2788,2074,4.20516e+12,46.095,3588.93,4862,1583,65,1566,1556,1031,423,634
51329,3014,11937,33288,18041,9.92136e+12,60.0996,15353.8,51329,5814,72,39392,39392,26362,26104,10392
68787,1872,15983,44609,24178,9.92882e+12,60.1212,20349.1,68787,7785,72,52804,52804,19770,20976,7042
81463,14764,27795,51265,30198,8.50949e+12,58.3992,32223.2,81463,13537,72,53668,53668,44528,42180,29135
88684,114,5128,70506,18178,5.7605e+13,12.0013,6109.5,88684,3377,20,83556,83556,48591,21491,65149
12621,1848,7475,7382,5239,5.31944e+12,52.9337,8168.62,12621,3636,72,5146,5146,3415,1417,1569
56328,9224,13090,36531,19797,9.9179e+12,60.0971,16783,56328,6367,72,43238,43238,37643,32314,30883
88558,2297,41082,53805,34753,6.92385e+12,56.4668,45080.6,88558,20009,72,47476,47476,24545,9035,3737
52320,22361,23072,32003,20317,7.22696e+12,56.7834,25747.7,52320,11233,72,29248,29248,28783,28340,28454
80216,12698,19332,51902,28314,9.79899e+12,59.9833,24264.5,80216,9404,72,60884,60884,52092,51875,41384
48067,8193,16244,30288,17779,8.55156e+12,58.3995,19109.1,48067,7902,72,31823,31823,25243,17573,17357
41295,7691,13065,26179,15116,8.82658e+12,58.646,15663.9,41295,6342,72,28230,28230,23744,18451,18458
44719,8502,10441,29000,15719,9.9027e+12,60.0593,13486.7,44719,5081,72,34278,34278,31993,28960,28295
86862,37868,37887,53204,33658,7.27486e+12,56.8874,41989.4,86862,18443,72,48975,48975,48974,48975,48974
22905,3109,22905,0,22905,7.99965,0,22905,22905,22905,1,0,0,0,0,0
14213,138,3967,9110,5103,9.36692e+12,59.0721,5127.96,14213,1928,72,10246,10111,5829,5703,563
45581,8038,10636,29560,16021,9.90228e+12,60.0683,13731.3,45581,5175,72,34945,34945,31851,27685,26762
72430,21312,28022,44989,27441,7.92463e+12,57.3817,31800.8,72430,13646,72,44408,44408,39740,35308,34273
44445,332,13567,28264,16181,8.97381e+12,58.8096,16363.2,44445,6588,72,30878,30599,10492,5053,1509
11345,1237,3047,7288,4057,9.45869e+12,57.085,4039.85,11345,1470,72,8298,8298,5749,2837,2790
40197,7792,9348,26068,14129,9.93246e+12,60.0534,12136.5,40197,4554,72,30849,30849,28960,26446,25922
19663,8669,10428,11732,7931,6.06399e+12,55.1772,11504.5,19663,5068,72,9235,9235,8583,7972,8034
28188,375,6969,18210,9978,9.75311e+12,59.7755,9026.94,28188,3395,72,21219,21171,12355,6293,1565
69452,4577,23739,43704,25748,8.49959e+12,58.3759,27608.3,69452,11553,72,45713,45713,24336,13774,9532
99018,10556,29564,63055,35963,9.05919e+12,59.0953,35084.5,99018,14401,72,69454,69454,46896,31917,26737
6164,1299,1514,3987,2177,9.94615e+12,59.2227,2154.62,6164,737,72,4650,4650,4483,4362,4366
22507,250,5252,14602,7905,9.91349e+12,59.9558,7001.93,22507,2551,72,17255,17255,9948,9805,1074
83845,6368,19481,54374,29471,9.91313e+12,60.1342,24654.9,83845,9484,72,64364,64364,40219,39312,21930
60013,15408,28170,36399,23614,6.86337e+12,55.9655,31035.5,60013,13718,72,31843,31843,24787,16524,16403
75154,5004,19828,48328,26826,9.50714e+12,59.6224,24375.3,75154,9651,72,55326,55326,31439,20579,15783
52896,4569,12303,34303,18593,9.91731e+12,60.0939,15807.3,52896,5987,72,40593,40593,29328,29101,15554
42566,13088,14785,26746,15820,8.44279e+12,58.2601,17347.9,42566,7203,72,27781,27781,26878,25615,25551
63506,11391,28392,38784,24722,7.14968e+12,56.661,31496.9,63506,13829,72,35114,35114,25021,13270,12874
24211,9988,10407,14862,9349,7.3866e+12,55.5934,11875.7,24211,5053,72,13804,13804,13804,13804,13804
40427,781,9406,26228,14199,9.91478e+12,60.0644,12212.2,40427,4577,72,31021,31021,10299,11161,3033
68650,2047,16017,44506,24144,9.90943e+12,60.1021,20372.1,68650,7803,72,52633,52633,32331,31916,7357
85699,57509,80084,59004,26695,9.20935e+12,3.99672,80229.9,85699,26722,9,5615,5615,4031,5615,4038
23034,268,7994,14485,8549,8.4664e+12,58.1428,9560.98,23034,3891,72,15040,14821,8706,4761,1095
36183,4984,8436,23473,12710,9.91648e+12,60.0487,10996.3,36183,4105,72,27747,27747,23618,22652,16752
78508,5395,18210,50915,27593,9.91457e+12,60.1345,23105.1,78508,8856,72,60298,60298,35318,34875,18646
64835,1012,21125,40983,23852,8.69991e+12,58.6141,24852.8,64835,10278,72,43710,43662,15306,15651,3726
7493,837,1766,4859,2634,1.00011e+13,59.4742,2515.79,7493,853,72,5727,5727,4537,3126,2864
75517,27831,28659,47002,28515,8.0161e+12,57.7933,32611.9,75517,13959,72,46858,46858,45901,44780,44971
49746,12916,14422,31762,17984,9.17588e+12,59.1715,17542.8,49746,7020,72,35324,35324,33208,30802,30789
61889,11739,18989,39325,22564,8.96239e+12,58.9342,22656,61889,9250,72,42900,42900,37438,36071,28325
22432,4792,8247,14022,8410,8.2001e+12,57.0256,9744.22,22432,4001,72,14185,14185,12554,10397,9964
14865,3198,4451,9481,5384,9.06166e+12,58.783,5631.26,14865,2163,72,10414,10414,8611,6488,6623
21418,5053,6396,13652,7766,9.06579e+12,57.8495,7965.49,21418,3093,72,15022,15022,14038,12953,13022
18057,3560,9626,10767,7290,6.0372e+12,52.7244,10631,18057,4667,72,8431,8431,6228,4213,3859
60962,1608,14210,39537,21425,9.90669e+12,60.0977,18154,60962,6916,72,46752,46752,28378,18708,5776
98447,7360,36765,61390,37057,8.08966e+12,57.8986,41752.3,98447,17906,72,61682,61682,40428,15494,14500
2866,76,715,1865,1001,1.01008e+13,58.2948,1080.68,2866,344,60,2151,1654,633,700,287
83175,18810,26435,52686,30489,8.81548e+12,58.7735,31077.7,83175,12875,72,56740,56740,47708,37124,36740
24062,6211,10414,14758,9304,7.36143e+12,56.8153,11867.2,24062,5073,72,13648,13648,11122,7758,7012
78753,18715,27387,49462,29291,8.42387e+12,58.2963,31657,78753,13337,72,51366,51366,42353,31793,31411
58696,14250,14429,37920,20776,9.74975e+12,59.9057,18197.4,58696,7026,72,44267,44267,44011,44005,43863
46847,510,16593,29383,17464,8.34995e+12,57.8703,19340.9,46847,8065,72,30254,29850,17026,8609,982
71178,14417,16529,46162,25016,9.93031e+12,60.1313,21024.8,71178,8052,72,54649,54649,52058,51465,47840
38149,19288,20353,22721,15428,6.02747e+12,54.4959,22146.7,38149,9893,72,17796,17796,17565,17226,17358
78838,25172,25178,49915,28923,8.79282e+12,58.7444,29607.7,78838,12259,72,53660,53660,53658,53659,53656
41098,4173,9610,26645,14453,9.90474e+12,60.0499,12450.6,41098,4676,72,31488,31488,23639,23471,14103
25892,5147,6080,16789,9103,9.93259e+12,59.967,8027.8,25892,2962,72,19812,19812,18668,17202,16936
90083,5189,34027,56105,33978,8.03561e+12,57.7315,38628.5,90083,16555,72,56056,56056,27095,10408,7623
95741,22883,40984,58783,36958,7.38287e+12,56.9951,45493.8,95741,19944,72,54757,54757,44136,34077,31311
79135,12240,24500,50249,28886,8.91233e+12,58.689,29000.7,79135,11914,72,54635,54635,44668,33006,32611
66026,17579,18177,42315,23711,9.36389e+12,59.4459,22200.5,66026,8853,72,47849,47849,46971,46955,46071
25610,5510,6013,16600,9010,9.90921e+12,59.9725,7948.22,25610,2924,72,19597,19597,18983,18847,18152
61471,13774,14263,39872,21599,9.92387e+12,60.1123,18236,61471,6944,72,47208,47208,46612,46478,45808
95106,31870,51645,56452,38654,5.90393e+12,55.2076,55354.2,95106,25155,72,43461,43461,36884,29295,29126
75361,7041,24445,47652,27709,8.72391e+12,58.6641,28684.3,75361,11903,72,50916,50916,33761,33270,12817
84782,11424,24516,54129,30653,9.18078e+12,56.5164,29408.7,84782,11926,72,60266,60266,48199,33938,33434
71562,20560,21428,45566,25996,9.04427e+12,58.4434,25613.7,71562,10416,72,50134,50134,50134,50134,50134
84090,4393,26585,53290,30800,8.83102e+12,58.8012,31284,84090,12946,72,57505,57505,36101,35457,9926
80184,17255,18635,51990,28194,9.91955e+12,60.1406,23614,80184,9077,72,61549,61549,59617,59566,57429
13094,1805,3107,8486,4608,9.88605e+12,59.7164,4249.26,13094,1503,72,9987,9987,8094,6335,5922
90646,2096,25143,58068,32578,9.32919e+12,59.4103,30393.8,90646,12236,72,65503,65503,39323,25792,7208
90293,2347,36141,55879,34414,7.74034e+12,57.4601,40605.5,90293,17594,72,54152,54152,27263,12405,6787
28818,4765,11061,17920,10898,7.97879e+12,57.0205,12851.4,28818,5383,72,17757,17757,13543,9604,8561
67622,9967,15726,43848,23774,9.91127e+12,60.1156,20033.1,67622,7655,72,51896,51896,44922,35429,33219
68780,17810,27151,42637,26143,7.82513e+12,57.545,30728.5,68780,13226,72,41629,41629,35350,26695,24837
55660,9165,12939,36099,19561,9.9246e+12,60.0991,16593.3,55660,6299,72,42721,42721,38176,37118,30635
92914,26840,40553,56909,36005,7.2775e+12,56.895,44892.2,92914,19751,72,52361,52361,44163,34640,34301
80848,23787,24554,51413,29435,8.99551e+12,58.8794,29169.2,80848,11945,72,56294,56294,55533,54650,54842
65573,19220,29315,40043,25530,7.14299e+12,56.6755,32506.2,65573,14275,72,36258,36258,29693,22052,21822
80135,30501,37520,48637,31498,6.86527e+12,56.0086,41171.6,80135,18256,72,42615,42615,39168,34407,33493
65976,14711,25368,41013,24963,7.95124e+12,56.8582,28877,65976,12335,72,40608,40608,32299,22563,22251
53496,20723,29124,31746,21750,5.89015e+12,55.0023,31432.3,53496,14166,72,24372,24372,21819,18402,17639
3162,716,793,2054,1108,9.69879e+12,58.1047,1186.92,3162,372,62,2369,2369,2306,2294,2278
93828,23435,40688,57509,36319,7.31549e+12,56.9477,45084.1,93828,19817,72,53140,53140,41904,28837,28348
64845,774,25542,40210,24635,7.83382e+12,57.549,28952.5,64845,12439,72,39303,38871,22737,22051,2645
93940,19190,21837,60908,33032,9.91299e+12,60.1439,27539.3,93940,10634,72,72103,72103,68953,68209,63771
86853,26266,30326,54532,32321,8.40148e+12,58.2742,34956.3,86853,14769,72,56527,56527,53691,50449,50390
87465,19730,41511,52976,34489,6.78328e+12,56.2812,45398.6,87465,20216,72,45954,45954,37915,28156,25740
46247,2900,46247,0,46247,7.99983,0,46247,46247,46247,1,0,0,0,0,0
74365,14421,23291,47166,27199,8.86377e+12,58.8367,27542,74365,11332,72,51074,51074,49558,48094,47916
76684,19762,39180,59962,16722,79033200000,8.99626,39748.3,76684,35255,11,37504,37504,23392,24859,21938
7756,1670,2152,4979,2777,9.44236e+12,58.3914,2890.04,7756,1032,72,5604,5604,5124,4555,4496
23754,1684,7289,15106,8648,8.9748e+12,58.5547,8972.96,23754,3546,72,16465,16465,9340,3823,3206
66113,19444,39365,38636,27477,5.22983e+12,54.3052,41853.9,66113,19159,72,26748,26748,22120,15849,14408
56205,4190,20152,35190,21015,8.29306e+12,57.6493,23327.5,56205,9812,72,36053,36053,21268,10794,7497
3829,500,928,2486,1343,1.02275e+13,58.8039,1379.31,3829,451,66,2901,2901,2382,2264,1704
23431,2747,9589,14477,8954,7.63279e+12,57.0178,11060.8,23431,4649,72,13842,13842,9339,4066,4070
68859,18513,19484,44047,24812,9.25711e+12,59.3098,23614.5,68859,9479,72,49375,49375,48951,48820,48428
85063,16352,19761,55164,29899,9.91798e+12,60.1376,24994.6,85063,9626,72,65302,65302,60357,55668,54424
92254,13078,21477,59821,32433,9.90204e+12,60.1223,27089.2,92254,10450,72,70777,70777,60667,46842,43568
47717,19694,24398,28597,19120,6.31795e+12,54.9969,26625.3,47717,11876,72,23319,23319,21264,18414,17964
50354,2679,20273,31146,19208,7.7345e+12,57.3932,23004.7,50354,9874,72,30081,30081,17716,7307,4358
97849,27053,29823,62202,35647,8.97746e+12,58.981,35246.1,97849,14525,72,68026,68026,64946,64188,59899
84117,20340,22231,54083,30034,9.49978e+12,59.6264,27234.1,84117,10825,72,61886,61886,59666,59139,56061
85932,19412,19962,55728,30204,9.91023e+12,60.1367,25248.3,85932,9715,72,65970,65970,65271,65237,64643
40850,2129,9543,26477,14373,9.90921e+12,60.0682,12368.8,40850,4649,72,31307,31307,20519,20299,7335
95040,18562,39370,58574,36466,7.56275e+12,57.0222,43944.1,95040,19166,72,55670,55670,40871,26772,22858
91082,17092,21126,59062,32020,9.91865e+12,60.1504,26683.4,91082,10292,72,69956,69956,65107,63978,57020
61239,19540,25187,37779,23460,7.62051e+12,57.2711,28358.5,61239,12270,72,36052,36052,32561,27868,26822
86244,10834,38930,52595,33649,7.08979e+12,56.66,42914,86244,18964,72,47314,47314,33488,17430,16821
6431,1260,2507,3997,2434,7.94593e+12,47.4547,3076.79,6431,1207,72,3924,3924,2519,540,0
66728,9370,15517,43263,23465,9.91215e+12,60.1155,19777.4,66728,7555,72,51211,51211,43765,33625,31252
55640,80,3453,44293,11347,5.7349e+13,11.9967,4220.55,55640,2279,14,52187,52187,29881,14416,42140
8954,2828,4836,7018,1936,79667300000,8.89602,5017.36,8954,4344,11,4118,4118,2770,2886,2672
43044,11175,20298,26093,16951,6.84538e+12,55.8766,22478.1,43044,9882,72,22746,22746,19156,14221,13243
80321,7474,39101,48485,31836,6.62846e+12,56.0849,42649.5,80321,19039,72,41220,41220,22149,13005,9122
34425,3055,9684,22036,12389,9.30138e+12,59.2706,12016.1,34425,4714,72,24741,24741,14524,9035,6913
71210,15396,19888,45595,25615,9.30423e+12,56.6961,24157.3,71210,9666,72,51322,51322,50712,49983,49870
84601,1756,19811,54843,29758,9.88498e+12,60.1039,25014.6,84601,9645,72,64790,64790,38519,37984,6143
85658,8453,30303,53705,31953,8.35122e+12,58.2139,34852.7,85658,14759,72,55355,55355,35292,19686,15070
25433,3617,13043,15248,10185,6.29538e+12,54.2553,14393.2,25433,6332,72,12390,12390,8169,4866,4048
15220,5722,8404,9017,6203,5.81921e+12,50.3862,9261.66,15220,4071,72,6816,6816,5895,5068,4960
98139,21746,24558,63329,34810,9.68128e+12,59.8562,30359.5,98139,11954,72,73581,73581,69612,65852,64867
37912,4858,14630,23557,14355,7.95171e+12,57.6315,16851.4,37912,7121,72,23282,23282,16635,8842,8737
10958,2232,2606,7096,3862,9.94692e+12,59.7132,3601.92,10958,1268,72,8352,8352,7897,7796,7337
40407,14741,21384,24081,16326,6.09793e+12,55.2102,23273.2,40407,10412,72,19023,19023,16845,13830,13349
87492,13460,44100,52536,34956,6.40478e+12,55.3138,47808,87492,21464,72,43392,43392,30475,18300,15018
42873,6929,19834,26065,16808,6.95229e+12,56.4126,22035.6,42873,9654,72,23039,23039,14969,9118,7404
18317,3444,4358,11872,6445,9.85663e+12,59.8391,5840.26,18317,2115,72,13959,13959,12950,12699,11416
72235,25072,29093,44665,27570,7.7104e+12,56.8402,32782.3,72235,14158,72,43142,43142,41062,38280,37675
42131,5821,9853,27317,14814,9.90446e+12,60.0443,12749.8,42131,4794,72,32278,32278,26401,26282,19316
17697,7472,9784,13883,3814,80021500000,8.96819,10037.3,17697,8798,11,7913,7913,6503,6589,6436
32502,1545,7594,21079,11423,9.90426e+12,60.0166,9940.45,32502,3694,72,24908,24908,16151,15967,5501
58140,8571,58140,0,58140,7.99986,0,58140,58140,58140,1,0,0,0,0,0
84456,3129,29554,53010,31446,8.39618e+12,58.248,34073.2,84456,14390,72,54902,54902,28101,11563,5572
64407,14032,21315,40644,23763,8.64731e+12,58.3128,24999.9,64407,10378,72,43092,43092,37058,35546,26973
90537,14924,21060,58701,31836,9.91402e+12,60.141,26584,90537,10255,72,69477,69477,62120,60396,49758
74712,4732,22257,47590,27122,9.06946e+12,59.0196,26601.6,74712,10836,72,52455,52455,33277,10668,9760
93288,26575,39846,57282,36006,7.40643e+12,57.0481,44257.6,93288,19412,72,53442,53442,44829,34713,34511
73073,7757,23440,46255,26818,8.77562e+12,58.7194,27587,73073,11416,72,49633,49585,26070,14984,10363
99556,18789,25109,64201,35355,9.65608e+12,59.8326,30972.5,99556,12230,72,74447,74447,67316,65641,55318
29921,8344,8685,19098,10823,9.19304e+12,59.112,10745.3,29921,4231,72,21236,21236,20753,20257,20354
49845,3861,17663,31260,18585,8.33765e+12,58.1559,20556.6,49845,8596,72,32182,32182,21974,11805,9036
80759,12162,18779,52370,28389,9.91236e+12,60.1289,23787.8,80759,9141,72,61980,61980,54060,43254,40712
3466,412,1808,2080,1386,6.38811e+12,54.1887,2112.43,3466,875,66,1658,1571,1250,872,1000
25437,4121,5993,16491,8946,9.88759e+12,59.9343,7914.18,25437,2915,72,19444,19444,16802,16738,13729
90449,13301,21056,58652,31797,9.90801e+12,60.1214,26573.2,90449,10253,72,69393,69393,58098,57871,44296
85526,4359,19865,55462,30064,9.91742e+12,60.1378,25126.1,85526,9671,72,65661,65661,43061,29389,15247
25470,5546,11751,15502,9968,6.95504e+12,56.3407,13212.1,25470,5714,72,13719,13719,10274,6735,5893
16473,1689,4608,10562,5911,9.30591e+12,59.1209,5913.52,16473,2237,72,11865,11865,8590,4753,4823
63188,18235,18301,40350,22838,9.17366e+12,59.2019,22113.3,63188,8909,72,44887,44887,44825,44823,44802
66100,2837,15315,42873,23227,9.92037e+12,60.1326,19547.1,66100,7450,72,50785,50785,32599,32236,10227
14086,2687,3333,9136,4950,9.91482e+12,59.7543,4540.32,14086,1617,72,10753,10753,9986,9810,8871
32118,1046,11661,20100,12018,8.24608e+12,57.9555,13661.7,32118,5677,72,20457,20457,11781,4084,1295
2519,48,848,1600,919,9.01358e+12,56.4339,1150.85,2519,408,57,1443,489,924,509,141
98551,21129,29737,62703,35848,9.01718e+12,59.0429,35214.3,98551,14479,72,68814,68814,58240,48123,45332
36120,3191,8420,23432,12688,9.90251e+12,60.0434,10978.4,36120,4097,72,27700,27700,20052,19904,10764
70894,17696,24568,44553,26341,8.44467e+12,58.3067,28480.2,70894,11966,72,46326,46326,39174,30725,30594
88443,16674,27118,56192,32251,8.95487e+12,58.4559,32084.5,88443,13204,72,61325,61325,50928,36734,33364
55938,5990,13005,36277,19661,9.91093e+12,60.0971,16676.4,55938,6330,72,42933,42933,32751,32541,20322
87396,9674,35078,54060,33336,7.73687e+12,57.0634,39415.3,87396,17083,72,52318,52318,37380,19844,19313
64893,15535,18044,41571,23322,9.32194e+12,58.9438,21996.8,64893,8769,72,46849,46849,45143,44734,42415
46658,2683,18138,28982,17676,7.89716e+12,57.403,20757.3,46658,8815,72,28520,28520,17376,4263,3928
82398,18999,19085,53444,28954,9.92185e+12,60.1547,24189.5,82398,9293,72,63313,63313,63221,63200,63178
12643,2465,2994,8187,4456,9.92381e+12,59.791,4106.25,12643,1457,72,9649,9649,9103,8964,8397
35721,9224,13211,22304,13417,8.15339e+12,49.2634,15374.1,35721,6419,72,22510,22510,22510,22510,22510
54008,7378,24800,32855,21153,7.00101e+12,56.5086,27470.1,54008,12079,72,29208,29208,19446,11228,8953
74284,13885,17304,48169,26115,9.90504e+12,60.1151,21966.7,74284,8425,72,56980,56980,52020,51917,46062
79368,11532,18465,51464,27904,9.9072e+12,60.1214,23397.8,79368,8990,72,60903,60903,50830,50622,38548
56532,2519,23907,34753,21779,7.46174e+12,56.686,26830.8,56532,11641,72,32625,32625,20434,7008,5755
59598,6508,13894,38648,20950,9.90947e+12,60.1043,17763.2,59598,6765,72,45704,45704,36112,34376,21860
11969,640,2859,7767,4202,9.86651e+12,59.6464,3923.98,11969,1385,72,9110,9110,5836,5778,1954
9620,2338,3920,5958,3662,7.70201e+12,54.1399,4667.03,9620,1890,72,5700,5700,4585,3525,3459
5777,941,1441,3745,2032,9.82739e+12,58.9874,2049.93,5777,697,72,4336,4336,3726,3595,2907
55969,4692,14654,36005,19964,9.55519e+12,59.6363,18204.9,55969,7138,72,41315,41315,27350,26448,15086
90970,31760,48305,54200,36770,6.06e+12,55.1653,51957.5,90970,23515,72,42665,42665,37106,29441,27823
12508,1876,6872,9811,2697,7.9962e+10,8.9398,7084.81,12508,6177,11,5636,5636,2523,2729,2330
4062,666,1053,2625,1437,9.64547e+12,58.4483,1522.28,4062,500,69,3009,3009,2471,2460,1978
2192,500,558,1419,773,9.97151e+12,57.5009,856.893,2192,265,57,1634,1634,1569,1555,1557
22114,495,5799,14231,7883,9.55046e+12,59.4539,7469.35,22114,2816,72,16315,16267,9796,9634,1913
86253,8354,26048,54864,31389,9.01762e+12,59.0373,30934.6,86253,12686,72,60205,60205,45735,28617,27994
18845,92,4433,12225,6620,9.88949e+12,59.8241,5949.68,18845,2148,72,14412,12857,3602,4167,436
11461,3042,4137,7179,4282,8.32187e+12,57.7573,5039.09,11461,2014,72,7324,7324,6685,5935,6140
68326,14891,23184,43026,25300,8.52545e+12,58.4116,27015,68326,11281,72,45142,45142,37407,28323,28077
94251,18572,36682,58518,35733,7.88806e+12,57.4829,41385.5,94251,17851,72,57569,57569,44762,27131,23097
20928,2465,8179,12997,7931,7.89439e+12,57.4197,9556.07,20928,3978,72,12749,12749,8190,4910,4057
97342,7071,28858,62029,35313,9.08108e+12,59.1226,34315,97342,14052,72,68484,68436,48548,48123,24030
7535,2624,2971,4678,2857,7.91133e+12,57.0478,3607.01,7535,1444,72,4564,4564,4287,3884,4015
3091,1019,1668,1841,1250,6.06352e+12,53.683,1941.93,3091,800,63,1423,1423,1189,954,954
70934,1284,16485,46003,24931,9.91664e+12,60.1206,20968.5,70934,8027,72,54449,54449,32309,21141,5068
46704,6906,10897,30288,16416,9.90723e+12,60.0719,14053.6,46704,5302,72,35807,35807,31015,24529,23035
21054,357,889,16667,4387,5.85722e+13,11.9906,1361.67,21054,886,13,20165,20165,15401,11198,18043
80331,16251,18674,52082,28249,9.91566e+12,60.1397,23661,80331,9095,72,61657,61657,58784,54934,54072
45530,16135,22726,27387,18143,6.4903e+12,55.8455,24906,45530,11069,72,22804,22804,20810,18050,17633
93978,31909,36421,58368,35610,7.91991e+12,57.6798,41120,93978,17743,72,57557,57557,54937,51452,50677
56326,8700,15022,36186,20140,9.46479e+12,59.549,18579,56326,7303,72,41304,41304,33670,24710,24401
60271,4077,13984,39094,21177,9.91902e+12,60.1175,17895.9,60271,6807,72,46287,46287,31790,22069,14015
45895,730,15590,28901,16994,8.54169e+12,58.3773,18340.1,45895,7590,72,30305,29983,17913,17507,2844
34410,3264,13803,21298,13112,7.77085e+12,57.3759,15813.4,34410,6724,72,20607,20607,13211,7855,6309
58275,5217,15705,37413,20862,9.44041e+12,59.5088,19348.7,58275,7642,72,42570,42570,26604,15533,12831
17854,2363,4196,11578,6276,9.90549e+12,59.854,5648.29,17854,2038,72,13658,13658,11416,8422,7787
36143,936,13900,22471,13672,7.96399e+12,57.6384,16041.5,36143,6765,72,22243,22099,13592,6737,3174
35791,7537,20103,28100,7691,80232200000,8.98933,20461.5,35791,18084,11,15688,15688,8220,8616,7842
75119,11388,20350,48199,26920,9.41711e+12,59.4919,24859.9,75119,9905,72,54769,54769,45498,32826,29848
15526,3552,3667,10072,5454,9.87346e+12,59.7972,4972.31,15526,1777,72,11859,11859,11716,11649,11658
43058,4609,10060,27911,15147,9.90229e+12,60.0533,13012.5,43058,4894,72,32998,32998,25848,24581,15615
36353,13210,16268,22208,14145,7.14889e+12,56.1845,18240.6,36353,7908,72,20085,20085,18606,16551,16293
55470,894,19878,34743,20727,8.29801e+12,58.0832,23016.5,55470,9675,72,35592,35373,20663,10253,2516
79696,10315,26461,50272,29424,8.63396e+12,58.4253,30862.2,79696,12885,72,53235,53235,37415,18734,18157
23720,2076,6384,15240,8480,9.44858e+12,59.3747,8137.34,23720,3099,72,17336,17336,12528,6917,6762
91392,19649,21204,59272,32120,9.91452e+12,60.1466,26779.4,91392,10320,72,70188,70188,67904,67863,65254
83725,21728,36514,51280,32445,7.28283e+12,56.6851,40494.3,83725,17779,72,47211,47211,39833,29795,27426
66367,11892,16219,42904,23463,9.76699e+12,59.9294,20400.2,66367,7900,72,50148,50148,44122,43985,36869
16493,1699,3886,10695,5798,9.91379e+12,59.8151,5250.86,16493,1887,72,12607,12607,9480,6835,5817
61598,1214,28152,37498,24100,7.02318e+12,56.3448,31137.1,61598,13710,72,33446,33399,18886,8612,1347
22823,17424,22823,0,22823,7.99965,0,22823,22823,22823,1,0,0,0,0,0
52596,12081,16628,33334,19262,8.84048e+12,55.4602,19797.5,52596,8083,72,35968,35968,34919,33770,33815
69416,4273,22374,43916,25500,8.75544e+12,58.6914,26337.2,69416,10896,72,47042,46994,13642,9139,4066
91740,2265,27321,58439,33301,9.06478e+12,59.0951,32498.9,91740,13298,72,64419,64371,39357,26106,8481
78022,18917,20360,50207,27815,9.53972e+12,59.6719,25072.1,78022,9907,72,57662,57662,55550,55511,53105
58585,12174,15939,37573,21012,9.40973e+12,59.4911,19590,58585,7765,72,42646,42646,39031,38165,33073
78331,20317,21512,50216,28115,9.37158e+12,59.4549,26161.1,78331,10471,72,56819,56819,55478,53716,53374
28914,8189,8295,18485,10429,9.20933e+12,59.1108,10309,28914,4028,72,20619,20619,20503,20426,20463
91706,11758,36779,56728,34978,7.73854e+12,57.1365,41298.6,91706,17912,72,54927,54927,36813,15494,14803
94139,12190,21836,61059,33080,9.92067e+12,60.1468,27551.4,94139,10634,72,72303,72303,58194,57918,40886
4870,1118,1228,3151,1719,9.79269e+12,58.8255,1765.27,4870,591,72,3642,3642,3512,3448,3448
33251,2721,7745,21556,11695,9.92851e+12,59.9529,10135.6,33251,3767,72,25506,25506,18158,18013,9255
98093,10149,28570,62592,35501,9.15046e+12,59.2098,34099,98093,13912,72,69523,69523,43796,26177,20184
61500,15433,18636,39123,22377,9.00078e+12,58.986,22303.1,61500,9073,72,42864,42864,39902,36409,36493
59496,1231,13800,38588,20908,9.93354e+12,60.1185,17666.2,59496,6723,72,45696,45696,27350,17972,4794
23215,1996,5478,15052,8163,9.90438e+12,59.924,7263.25,23215,2662,72,17737,17737,11855,7633,6656
13874,534,3291,8992,4882,9.87257e+12,59.7368,4484.4,13874,1597,72,10583,10583,4476,4608,1914
14886,235,4152,9538,5348,9.34421e+12,59.1074,5357.52,14886,2017,72,10734,10686,6250,3136,901
13518,3952,4635,8503,5015,8.56727e+12,58.1216,5678.96,13518,2256,72,8883,8883,8044,7004,6826
60705,7335,23089,37780,22925,8.00577e+12,57.7517,26379.3,60705,11235,72,37616,37616,26337,18285,15664
92531,8233,24542,59466,33065,9.48574e+12,59.6096,29964.5,92531,11946,72,67989,67989,48146,47675,23761
20459,6395,7667,12770,7689,8.08939e+12,56.6388,9050.8,20459,3714,72,12792,12792,11789,10506,10280
44929,6110,10494,29140,15789,9.89755e+12,60.0601,13551.8,44929,5107,72,34435,34435,29153,21980,20323
34557,2884,8061,22408,12149,9.92706e+12,60.0288,10523.2,34557,3927,72,26496,26496,18935,13347,9759
57245,8823,31455,33914,23331,5.83161e+12,54.6685,33868.5,57245,15318,72,25790,25790,17047,10080,8121
24510,3788,5777,15884,8626,9.86805e+12,59.9039,7644.53,24510,2800,72,18733,18733,15934,13301,12651
53017,10139,18207,33347,19670,8.48125e+12,57.4855,21294.6,53017,8847,72,34810,34810,28869,21856,21788
62552,4265,14564,40562,21990,9.91123e+12,60.1078,18596.1,62552,7089,72,47988,47988,28024,27609,14687
81623,1510,18981,52929,28694,9.91516e+12,60.1321,24032.7,81623,9246,72,62642,62642,20607,22414,5892
39886,8870,17817,24353,15533,7.15968e+12,56.6743,19944.1,39886,8677,72,22069,22069,16802,10723,10539
8186,1208,1938,5313,2873,9.95263e+12,59.4833,2737.13,8186,940,72,6248,6248,5187,5168,4072
35352,3820,15082,21718,13634,7.4195e+12,56.6411,17071.4,35352,7330,72,20270,20270,13654,5928,5818
34417,5922,12733,21480,12937,8.16527e+12,49.253,14830.4,34417,6197,72,21684,21684,13040,2954,0
38514,4972,9509,24887,13627,9.72921e+12,59.826,12164.6,38514,4627,72,29005,29005,22389,16084,14384
50260,415,3466,40074,10186,5.69458e+13,12.003,4199.3,50260,1821,20,46794,46794,28272,15066,35304
59042,27490,29390,35522,23520,6.49073e+12,55.4222,32097,59042,14295,72,29652,29652,28776,27835,27887
17680,2603,4161,11465,6215,9.91463e+12,59.8618,5602.2,17680,2023,72,13519,13519,11714,9324,8832
34178,2980,8217,22117,12061,9.81732e+12,59.9084,10642.5,34178,3994,72,25961,25961,17677,17028,10073
47323,6526,15157,29956,17367,8.78189e+12,58.3799,18050.3,47323,7373,72,32166,32166,24733,16020,15753
63773,191,17811,40836,22937,9.30765e+12,59.3509,21698.8,63773,8664,72,45962,45674,13358,13291,1285
60041,9379,13931,38936,21105,9.92384e+12,60.1151,17828.4,60041,6780,72,46110,46110,40609,39331,31430
92760,35077,38865,57100,35660,7.50379e+12,57.1746,43311.2,92760,18925,72,53895,53895,51359,49002,48417
21461,1900,9449,13146,8315,7.24869e+12,55.9654,10766.2,21461,4582,72,12012,12012,6747,2664,1590
87332,19208,40093,53145,34187,6.9821e+12,56.5338,44073.3,87332,19526,72,47239,47239,36255,23440,22957
48453,11158,11284,31421,17032,9.91279e+12,60.0922,14542.6,48453,5493,72,37169,37169,37033,37009,36949
40130,12321,15510,24939,15191,7.93677e+12,57.6018,17831,40130,7547,72,24620,24620,20827,15684,14528
24223,6572,8654,15186,9037,8.34369e+12,58.0105,10263.5,24223,4215,72,15569,15569,13999,11827,11546
23729,4632,9583,14667,9062,7.73981e+12,57.2808,11076,23729,4668,72,14146,14146,11636,8368,7807
57856,21385,23363,35774,22082,7.71286e+12,57.3863,26422.3,57856,11381,72,34493,34493,33846,33106,33311
61211,7783,21345,38449,22762,8.41258e+12,58.261,24797.8,61211,10391,72,39866,39866,28207,14527,14008
30393,980,13992,18484,11909,7.00476e+12,56.3105,15671,30393,6810,72,16401,16363,9126,4820,3294
40995,14612,18080,25077,15918,7.2292e+12,56.2103,20275.5,40995,8801,72,22915,22915,20381,16875,16268
28082,7428,7993,17963,10119,9.2793e+12,59.19,9962.65,28082,3894,72,20089,20089,19283,18363,18526
32549,3778,12617,20213,12336,7.92333e+12,57.3752,14578.7,32549,6141,72,19932,19932,12826,7116,5563
80276,5465,31632,49764,30512,7.82906e+12,57.5718,35711.1,80276,15409,72,48644,48644,25300,13536,8850
19051,3206,9463,11471,7580,6.52645e+12,54.0698,10573,19051,4587,72,9588,9588,6543,3072,3012
60778,14328,24245,37624,23154,7.76263e+12,56.9153,27458,60778,11796,72,36533,36533,29279,20805,20512
40799,6134,18855,24798,16001,6.9681e+12,55.2155,20972.1,40799,9179,72,21944,21944,14528,8243,6408
78958,23815,29199,49280,29678,8.14668e+12,57.9527,33353.2,78958,14225,72,49759,49759,46603,42359,41405
29761,4549,6970,19300,10461,9.90077e+12,59.9856,9153.16,29761,3389,72,22791,22791,19820,19142,14946
32214,8289,9528,20544,11670,9.09413e+12,58.4884,11705.1,32214,4619,72,22686,22686,21634,21580,20584
66574,451,22140,41995,24579,8.6218e+12,58.1293,25918.8,66574,10774,72,44434,43973,19088,7314,2179
70681,13440,25840,44170,26511,8.1931e+12,58.0105,29650.4,70681,12580,72,44841,44841,35265,24066,23661
65324,13873,19396,41629,23695,9.0801e+12,58.9172,23283.2,65324,9428,72,45928,45928,39881,32808,32593
62277,24712,25698,38414,23863,7.58939e+12,57.2269,28911.9,62277,12501,72,36579,36579,36348,36009,36141
18153,6860,9093,10917,7236,6.47402e+12,54.5769,10156.1,18153,4407,72,9060,9060,7892,6780,6698
75976,17485,34069,46373,29603,7.12887e+12,56.5446,37668.1,75976,16581,72,41907,41907,34476,24237,21995
61685,2958,15494,39800,21885,9.66415e+12,59.8023,19399.9,61685,7532,72,46191,46191,29653,29254,9361
97097,21729,27463,62096,35001,9.26178e+12,59.3473,32999.6,97097,13376,72,69634,69634,62441,62270,53743
18173,1064,4902,11676,6497,9.46593e+12,59.2763,6321.54,18173,2379,72,13271,13271,6460,7186,3733
46675,503,2447,37057,9618,5.79304e+13,11.9945,3152.67,46675,1931,14,44228,44228,29718,18000,37730
56193,1867,3371,44708,11485,5.74689e+13,11.9963,4143.28,56193,2306,14,52822,52822,42274,34086,48084
8385,1471,1974,5444,2941,9.95322e+12,59.5132,2788.92,8385,956,72,6411,6411,5672,5658,4966
79367,13070,18474,51469,27898,9.90386e+12,60.108,23406.6,79367,8988,72,60893,60893,53126,45684,43681
68175,6624,18318,43774,24401,9.45187e+12,59.5348,22478.9,68175,8920,72,49857,49857,35450,23317,19719
90894,7293,43422,55003,35891,6.74589e+12,56.0018,47420.9,90894,21147,72,47472,47472,32141,14413,13729
8610,150,446,6822,1788,5.81564e+13,12.0149,749.441,8610,260,20,8164,8164,5891,4090,6594
21500,1747,5088,13939,7561,9.90219e+12,59.898,6767.06,21500,2472,72,16412,16412,11594,8111,5802
71626,31009,33021,43559,28067,6.96738e+12,56.4877,36379.5,71626,16084,72,38605,38605,36722,34110,33725
75850,4551,17602,49197,26653,9.91944e+12,60.1376,22351.7,75850,8570,72,58248,58248,31577,31443,15789
69066,1782,23036,43554,25512,8.60665e+12,58.5184,26932.1,69066,11212,72,46030,46030,24417,9472,4431
69992,13753,22965,44201,25791,8.6873e+12,58.6082,26927.5,69992,11187,72,47027,47027,40497,31620,29541
79652,14753,23102,50847,28805,9.17329e+12,59.2141,27733,79652,11250,72,56550,56550,47271,47013,35987
99089,19462,32355,62608,36481,8.69751e+12,58.2507,37693.2,99089,15746,72,66734,66734,56087,41554,38112
76687,16358,17855,49728,26959,9.91294e+12,60.1184,22643.7,76687,8693,72,58832,58832,56726,56672,54320
98735,40090,41279,60780,37955,7.52112e+12,57.1322,45974.4,98735,20104,72,57456,57456,56302,55208,55141
25624,5591,10888,15751,9873,7.44462e+12,56.5418,12435.2,25624,5282,72,14736,14736,11669,8829,8100
91000,4100,27968,57803,33197,8.94649e+12,58.9555,33051.6,91000,13622,72,63032,63032,38972,38300,9446
73907,3322,18687,47656,26251,9.65592e+12,59.8035,23225.9,73907,9097,72,55220,55220,26190,25892,10995
61427,8522,14244,39839,21588,9.92641e+12,60.123,18219,61427,6933,72,47183,47183,40241,30814,28604
21783,499,5097,14128,7655,9.91078e+12,59.901,6797.48,21783,2479,72,16686,16686,5773,1865,1879
37624,2262,8834,24397,13227,9.8839e+12,60.0063,11473.2,37624,4292,72,28790,28790,19279,19080,7678
2119,1007,1405,1223,896,4.82065e+12,51.1732,1569.84,2119,684,54,714,666,677,607,681
64770,22007,25767,40116,24654,7.78375e+12,57.4811,29154.2,64770,12547,72,39003,39003,36514,33179,32446
67439,20463,34032,40497,26942,6.38995e+12,55.5918,37013.9,67439,16565,72,33407,33407,27498,21868,20490
40806,4974,9547,26458,14348,9.91289e+12,60.0398,12366.8,40806,4647,72,31259,31259,24581,24449,16494
16110,2394,4731,10289,5821,9.16267e+12,58.9205,5992.92,16110,2300,72,11379,11379,8618,7967,4091
89742,31534,33619,55934,33808,8.07874e+12,57.8831,38221.6,89742,16372,72,56123,56123,55152,53924,53700
22943,5432,8418,14342,8601,8.23978e+12,57.8522,9940.57,22943,4101,72,14525,14525,12111,9382,9340
13264,338,3930,8465,4799,9.11727e+12,58.7848,5014.7,13264,1909,72,9334,9286,3775,2143,1235
38949,6381,9072,25261,13688,9.91203e+12,60.0494,11790.8,38949,4409,72,29877,29877,26600,25846,21174
60558,6922,14118,39273,21285,9.9072e+12,60.0982,18040.1,60558,6873,72,46440,46440,37783,25975,23196
94910,13199,25416,60953,33957,9.45431e+12,59.5701,30938.6,94910,12379,72,69494,69494,55353,54993,38099
77701,13964,38378,60673,17028,78631100000,8.99085,38961,77701,34532,11,39323,39323,19967,22351,17601
5293,1090,1899,3324,1969,8.47326e+12,57.1077,2406.96,5293,918,72,3394,3394,2972,2468,2682
25569,532,5955,16584,8985,9.92532e+12,59.9598,7888.64,25569,2892,72,19614,19614,11705,7681,2067
53552,2356,16914,33942,19610,8.84177e+12,58.7593,20129.4,53552,8231,72,36638,36638,21302,9025,5391
74564,2763,24000,47179,27385,8.75444e+12,58.6897,28214.1,74564,11677,72,50564,50564,25145,13252,8258
21375,4522,4991,13867,7508,9.94664e+12,59.9602,6666.59,21375,2430,72,16384,16384,15699,14968,15052
98704,9913,22944,64006,34698,9.90486e+12,60.1354,28897,98704,11162,72,75760,75760,56874,56483,33635
34608,8245,13229,21542,13066,7.98923e+12,57.3454,15304.1,34608,6424,72,21379,21379,18684,15537,15637
86249,5883,20037,55936,30313,9.91659e+12,60.1343,25335.5,86249,9756,72,66212,66212,45621,31748,20308
18267,2225,8022,11188,7079,7.27278e+12,56.5735,9183.62,18267,3899,72,10245,10245,6274,3390,1613
49857,12263,17162,31349,18508,8.47221e+12,57.5927,20094.3,49857,8349,72,32695,32695,28097,22655,22656
81647,16052,37021,49751,31896,7.06484e+12,56.3904,40814.6,81647,18030,72,44626,44626,31335,17595,13997
27345,6216,6410,17729,9616,9.90346e+12,59.9896,8451.11,27345,3116,72,20935,20935,20705,20659,20501
41083,14351,17892,25174,15909,7.29666e+12,56.206,20109.3,41083,8693,72,23191,23191,21760,19771,19529
39935,9640,11242,25552,14383,9.29049e+12,59.2858,13872,39935,5471,72,28693,28693,27542,26201,26383
84166,1102,21635,54216,29950,9.59207e+12,59.7435,26685,84166,10531,72,62531,62531,20037,10661,3619
96409,21068,31448,60931,35478,8.7008e+12,58.6425,36662.4,96409,15313,72,64961,64961,53125,39189,38676
52476,3192,19272,32781,19695,8.17916e+12,54.0093,22240.9,52476,9382,72,33204,33204,18583,9579,0
75645,12539,19279,48765,26880,9.62183e+12,58.3552,23899.6,75645,9371,72,56366,56366,49789,43520,41817
97852,17565,22748,63451,34401,9.90408e+12,60.1344,28656.3,97852,11068,72,75104,75104,67665,67503,58628
56248,14207,20705,35126,21122,8.17562e+12,57.9542,23841.5,56248,10086,72,35543,35543,30499,25774,24507
45205,2266,15701,28403,16802,8.43974e+12,58.2474,18391.9,45205,7640,72,29504,29504,18448,5560,5023
78213,30303,34230,47892,30321,7.26617e+12,56.8627,37976.9,78213,16664,72,43983,43983,42264,39879,39541
69116,11494,17961,44487,24629,9.56137e+12,59.6828,22215.7,69116,8744,72,51155,51155,43389,43191,33991
81494,17715,18951,52851,28643,9.91342e+12,60.1263,23997.6,81494,9228,72,62543,62543,60719,60685,58647
94390,20929,38754,58241,36149,7.61328e+12,57.308,43320.4,94390,18876,72,55636,55636,45083,32752,32403
48660,1685,11342,31557,17103,9.9173e+12,60.0744,14607,48660,5521,72,37318,37318,15315,6616,6134
67592,9684,15708,43831,23761,9.92799e+12,60.1209,20010.2,67592,7652,72,51884,51884,44568,42877,32283
34288,4801,7989,22232,12056,9.93453e+12,60.0475,10438.6,34288,3891,72,26299,26299,21684,17294,16169
6265,1055,1480,4059,2206,1.00129e+13,59.3919,2135.57,6265,716,72,4785,4785,4273,4154,3601
78580,6604,18217,50973,27607,9.92697e+12,60.1428,23111.9,78580,8874,72,60363,60363,40190,39005,22652
62428,11518,27626,38168,24260,7.20273e+12,56.7861,30713,62428,13454,72,34802,34802,25248,15081,12547
94088,12686,21891,61011,33077,9.90212e+12,60.1034,27601.8,94088,10645,72,72197,72197,61191,46141,42560
44737,6915,11626,28798,15939,9.55616e+12,59.6336,14587.9,44737,5648,72,33111,33111,26895,19594,19377
9180,1923,3660,5698,3482,7.79308e+12,57.0117,4391.39,9180,1776,72,5520,5520,4500,3194,2944
50344,15950,26500,30036,20308,6.12356e+12,54.6525,28767.8,50344,12888,72,23844,23844,19457,14407,14278
5445,637,1586,3490,1955,9.22889e+12,58.1723,2145.55,5445,759,72,3859,3859,3009,2220,2137
55772,6650,23983,34227,21545,7.36003e+12,56.9611,26847.4,55772,11672,72,31789,31789,20976,12858,10440
64464,1240,33677,38508,25956,6.17378e+12,55.0117,36464.3,64464,16388,72,30787,30643,17779,8292,2165
14486,955,5411,9044,5442,8.11307e+12,57.614,6474.64,14486,2628,72,9075,9027,4780,3033,2423
64615,9415,35233,38333,26282,5.87821e+12,54.2546,37919,64615,17147,72,29382,29382,20958,13102,10917
70625,6027,34601,55131,15494,78589500000,8.99638,35158.7,70625,31133,11,36024,36024,13353,16148,10571
33623,1472,11694,21123,12500,8.45928e+12,58.2122,13807.2,33623,5696,72,21929,21929,11708,9451,3223
77481,22039,28508,48400,29081,8.16285e+12,57.4249,32610.4,77481,13868,72,48973,48973,46534,43159,42581
41535,22422,23332,24533,17002,5.65918e+12,54.7988,25157.6,41535,11357,72,18203,18203,17329,16295,16488
2463,879,1044,1520,943,7.6087e+12,46.0081,1317.65,2463,493,53,1419,1419,1215,1061,1098
53724,9368,18243,33820,19904,8.52826e+12,57.9796,21379,53724,8870,72,35481,35481,28865,19861,17758
6052,620,1978,3830,2222,8.93368e+12,57.9296,2556.51,6052,963,72,4074,4074,2699,1162,1212
60337,19359,25111,37176,23161,7.55107e+12,57.1859,28223.2,60337,12230,72,35226,35226,33143,30375,29793
3955,199,963,2563,1392,9.9059e+12,58.6498,1427.96,3955,459,66,2992,2992,1343,1380,733
32079,3142,7484,20799,11280,9.92841e+12,60.0368,9804.88,32079,3646,72,24595,24595,17950,17241,10598
26157,4521,6357,16927,9230,9.79971e+12,59.824,8305.98,26157,3093,72,19800,19800,17084,13935,13914
86153,24179,26393,54745,31408,8.9557e+12,58.9615,31251.4,86153,12847,72,59760,59760,58905,57792,57655
18195,3446,5138,11642,6553,9.29858e+12,59.1206,6543.88,18195,2495,72,13057,13057,11091,8860,8843
54294,6088,25494,32946,21348,6.852e+12,56.311,28133.4,54294,12406,72,28800,28800,18036,10540,8069
1920,371,505,1246,674,9.7595e+12,56.9099,778.188,1920,233,54,1415,1415,1257,1144,1197
51706,10375,12031,33532,18174,9.91498e+12,60.0908,15469.2,51706,5856,72,39675,39675,37222,37178,34371
1525,210,394,989,536,1.0051e+13,57.0007,626.079,1525,190,49,1131,1131,874,699,707
51330,10428,11939,33283,18047,9.92121e+12,60.1011,15357.4,51330,5811,72,39391,39391,37537,37118,34591
2077,991,1047,1263,814,6.56268e+12,45.2017,1264.14,2077,502,49,1030,1030,981,985,973
50188,3181,25223,30148,20040,6.44785e+12,55.8091,27570,50188,12287,72,24965,24965,13518,6519,4490
22395,3955,5279,14517,7878,9.88693e+12,59.9504,7019.33,22395,2567,72,17116,17116,15596,15229,13194
18405,3990,4374,11919,6486,9.88627e+12,59.8373,5858.43,18405,2125,72,14031,14031,13586,13560,13250
64403,3954,23146,40322,24081,8.27767e+12,58.0986,26697.9,64403,11270,72,41257,41209,23300,12296,1357
12232,1672,3360,7844,4388,9.42205e+12,59.1172,4402.36,12232,1631,72,8872,8872,6486,6427,3733
55306,3022,20824,34465,20841,8.05833e+12,57.3551,23884,55306,10127,72,34482,34482,21466,9630,6380
12826,189,3049,8310,4516,9.87139e+12,59.6764,4172.6,12826,1477,72,9777,9777,2916,3221,752
88199,3358,20464,57194,31005,9.92576e+12,60.1489,25866.2,88199,9969,72,67735,67735,42791,28726,12123
19631,1142,4590,12730,6901,9.95529e+12,59.9089,6153.52,19631,2236,72,15041,15041,9925,9834,3769
49302,8188,28890,28896,20406,5.35482e+12,54.284,30891.9,49302,14066,72,20412,20412,13074,6593,4811
54333,1885,12695,35229,19104,9.90579e+12,60.0748,16272.3,54333,6177,72,41638,41638,25935,17322,6643
80798,2737,3399,63960,16838,5.85674e+13,12.0017,4343.47,80798,1886,19,77399,77399,71498,66431,74756
38742,2693,9002,25122,13620,9.93541e+12,60.0816,11711.2,38742,4385,72,29740,29740,20519,20325,9346
7013,419,2119,4481,2532,9.06752e+12,58.3084,2786.7,7013,1024,72,4894,4846,3150,1081,1229
86244,10003,27795,54555,31689,8.76176e+12,58.7097,32554.9,86244,13541,72,58449,58449,41393,21353,20571
61519,1814,32413,48164,13355,79432900000,8.97906,32911.3,61519,29166,11,29106,29104,8265,10112,6438
78336,418,33824,48032,30304,7.34528e+12,56.5764,37608.5,78336,16472,72,44512,43408,20727,6052,0
32368,4394,7556,20981,11387,9.91015e+12,60.0275,9895.51,32368,3680,72,24812,24812,20252,20156,14782
64749,18296,19497,41202,23547,9.02267e+12,59.0209,23337,64749,9483,72,45252,45252,44060,43752,42223
59820,7067,20541,37625,22195,8.48475e+12,58.34,23949.1,59820,10000,72,39279,39279,27471,27089,13166
48875,675,15576,30952,17923,8.80507e+12,58.7199,18548.7,48875,7583,72,33299,33093,19525,10211,2715
63374,6423,14753,41092,22282,9.90816e+12,60.1069,18828.1,63374,7182,72,48621,48621,36474,26103,21613
8656,590,2059,5605,3051,9.92034e+12,59.3304,2893.63,8656,997,72,6597,6597,4443,4405,1965
89865,5844,25544,57444,32421,9.24899e+12,59.1529,30714.1,89865,12438,72,64321,64321,36647,34578,16164
6344,529,1560,4111,2233,9.93208e+12,59.1813,2213.44,6344,759,72,4784,4784,3378,3337,1825
63306,17373,22928,39601,23705,8.23512e+12,58.0444,26418.5,63306,11157,72,40378,40378,37174,32851,31875
27647,9802,12361,16886,10761,7.14651e+12,56.5924,13952.1,27647,6008,72,15286,15286,14575,13749,13951
38273,3972,12820,24125,14148,8.58899e+12,58.4325,15209.3,38273,6236,72,25453,25453,17705,8625,8330
54356,6801,13527,35101,19255,9.71349e+12,58.827,17047.1,54356,6573,72,40829,40829,32678,32520,22753
90851,14530,34196,56610,34241,8.05511e+12,57.6164,38835.4,90851,16642,72,56655,56655,42686,26103,22053
89171,12489,20700,57834,31337,9.91315e+12,60.1397,26155.7,89171,10078,72,68471,68471,56496,56256,41837
56622,2341,13154,36719,19903,9.91648e+12,60.1054,16863.3,56622,6403,72,43468,43468,27623,27315,8169
52885,14728,16212,33599,19286,8.96396e+12,58.9155,19430.8,52885,7898,72,36673,36673,34498,34459,31977
49372,3589,17740,30913,18459,8.27942e+12,56.5544,20594.1,49372,8620,72,31632,31632,19946,6234,5740
22202,1758,6338,14198,8004,9.23167e+12,58.5514,7973.52,22202,3080,72,15864,15864,9384,10559,5791
13669,889,4470,8647,5022,8.72251e+12,58.3252,5543.23,13669,2171,72,9199,9199,4697,3393,2820
12961,4176,4698,8116,4845,8.27896e+12,57.7435,5687,12961,2282,72,8263,8263,7629,6857,6739
68938,4349,16024,44701,24237,9.90733e+12,60.1117,20404.5,68938,7794,72,52914,52914,35930,35587,15039
22443,4277,12037,17584,4859,7.9629e+10,8.94729,12330.7,22443,10825,11,10406,10406,5473,5825,5139
31422,3926,7281,20382,11040,9.95526e+12,60.0521,9564.78,31422,3547,72,24141,24141,19173,19085,13206
87174,23909,36737,53629,33545,7.47338e+12,56.923,40942,87174,17878,72,50437,50437,45550,38809,37415
84659,27844,27913,53443,31216,8.6676e+12,58.5912,32553.8,84659,13598,72,56746,56746,56670,56656,56650
42739,8999,22195,25554,17185,6.21692e+12,55.2396,24207.2,42739,10805,72,20544,20544,15246,10284,9082
24263,10577,14147,14238,10025,5.40533e+12,52.7179,15303.4,24263,6869,72,10116,10116,9116,7805,7619
86423,18010,24137,55335,31088,9.30216e+12,59.1544,29169.1,86423,11737,72,62286,62286,57048,50946,50796
36725,17915,18624,22049,14676,6.37698e+12,55.2142,20439.9,36725,9053,72,18101,18101,17609,17122,17177
80237,17606,23143,51239,28998,9.19143e+12,59.242,27813.4,80237,11269,72,57094,57094,52015,45003,43545
25924,5370,12783,15624,10300,6.57004e+12,55.048,14196.2,25924,6211,72,13141,13141,10362,6778,6099
86664,9624,33969,53763,32901,7.86116e+12,57.6043,38329.5,86664,16549,72,52695,52695,30754,17478,12778
45236,2419,11223,29217,16019,9.72657e+12,59.8279,14246.5,45236,5463,72,34013,34013,22421,22157,8279
39789,37576,39789,0,39789,7.9998,0,39789,39789,39789,1,0,0,0,0,0
60184,9326,22894,37455,22729,8.00891e+12,57.7719,26160.8,60184,11153,72,37290,37290,26713,14313,13881
20819,832,6852,13147,7672,8.69916e+12,58.4002,8330.62,20819,3336,72,13967,13939,8967,3860,2991
36016,223,8403,23355,12661,9.90358e+12,60.0233,10953.2,36016,4088,72,27613,27613,15700,10049,1128
43345,9237,12015,27764,15581,9.35197e+12,59.374,14842.9,43345,5847,72,31330,31330,28781,25382,24629
46565,6104,10852,30193,16372,9.91231e+12,60.0859,14004.4,46565,5282,72,35713,35713,28890,28739,20630
3014,451,752,1952,1062,9.84387e+12,58.0985,1131.73,3014,361,61,2262,2262,1843,1420,1519
55035,13824,21832,34096,20939,7.79883e+12,57.0413,24800.1,55035,10619,72,33203,33203,28179,22281,22261
80238,30488,38910,48445,31793,6.65823e+12,55.9449,42467.5,80238,18951,72,41328,41328,37018,32946,32017
37208,2493,13702,23244,13964,8.16351e+12,57.8219,15940.7,37208,6661,72,23506,23506,14239,7311,5122
55450,10319,12884,35959,19491,9.92128e+12,60.1038,16530,55450,6270,72,42566,42566,39413,38698,34257
1802,192,472,1178,624,9.92422e+12,56.8674,730.365,1802,226,52,1330,1330,930,533,627
78199,19136,32119,48255,29944,7.60876e+12,57.1822,36015.9,78199,15635,72,46080,46080,36850,26082,25700
70950,23115,29242,43759,27191,7.6097e+12,57.2714,32821.8,70950,14245,72,41708,41708,36418,31430,30106
8958,960,3128,5624,3334,8.49229e+12,55.4562,3887.78,8958,1518,72,5830,5794,3953,1812,1834
24757,4313,6616,15912,8845,9.494e+12,59.4267,8433.05,24757,3213,72,18141,18141,15967,13060,12423
43982,10774,28184,25355,18627,4.64716e+12,53.2123,29817.7,43982,13708,72,15798,15798,12138,8730,7976
6156,277,3300,4823,1333,79572400000,8.19623,3449.83,6156,2963,11,2856,2856,880,1035,744
91871,4282,21321,59583,32288,9.91536e+12,60.1409,26915.7,91871,10382,72,70550,70550,33376,33934,15026
90402,44687,90402,0,90402,7.99991,0,90402,90402,90402,1,0,0,0,0,0
55123,4178,22288,34079,21044,7.69379e+12,56.4659,25230.2,55123,10835,72,32835,32835,21283,7689,7333
47731,722,26835,37474,10257,80272500000,8.99468,27249.9,47731,24147,11,20896,20896,5296,6144,4465
5450,926,1290,3537,1913,1e+13,59.3198,1882.78,5450,627,72,4160,4160,3639,3629,3183
69713,27965,28941,42955,26758,7.5516e+12,57.1248,32460,69713,14084,72,40772,40772,39706,38293,38054
59165,10909,13720,38368,20797,9.93154e+12,60.1282,17570.9,59165,6683,72,45445,45445,41996,41205,36311
9028,138,5419,5270,3758,5.28191e+12,50.746,5952.59,9028,2634,72,3609,3330,2010,988,0
16071,262,5154,10176,5895,8.79654e+12,57.2699,6379.52,16071,2499,72,10917,10869,6124,2725,0
5392,122,1406,3470,1922,9.68636e+12,57.4184,1979.23,5392,679,72,3986,3986,992,1198,0
45138,13073,16038,28292,16846,8.33904e+12,57.845,18701.5,45138,7807,72,29100,29100,26084,23253,22569
56165,12784,15820,35934,20231,9.27952e+12,59.3185,19306.8,56165,7697,72,40345,40345,37205,37133,33496
19634,3522,4594,12728,6906,9.91833e+12,59.9123,6163.98,19634,2232,72,15040,15040,13749,12065,11728
33718,10411,12117,21112,12606,8.29673e+12,58.035,14204.7,33718,5902,72,21601,21601,20182,18590,18639
47907,13602,19124,29651,18256,7.76825e+12,56.9263,21763.1,47907,9311,72,28783,28783,25986,22116,21427
25126,5495,7302,16044,9082,9.16846e+12,59.0275,9096.38,25126,3542,72,17824,17824,16737,15311,15046
75805,32702,37079,45716,30089,6.60567e+12,55.7171,40449.2,75805,18059,72,38726,38726,36105,33045,33147
1037,341,370,662,375,8.22468e+12,52.1697,526.895,1037,165,42,667,667,664,665,661
45569,449,10631,29549,16020,9.90482e+12,60.0721,13727,45569,5171,72,34938,34938,9946,11147,2016
67851,9282,15776,44003,23848,9.91534e+12,60.1155,20095.1,67851,7678,72,52075,52075,44304,42483,31223
20764,2315,7359,13022,7742,8.3668e+12,57.9957,8789.7,20764,3583,72,13405,13405,9511,5122,4899
7399,485,1749,4806,2593,9.99379e+12,59.419,2489.27,7399,848,72,5650,5650,3779,3745,1654
41442,4398,9699,26869,14573,9.90473e+12,60.0388,12555.4,41442,4722,72,31743,31743,24000,23849,14592
54258,13962,17761,34278,19980,8.69531e+12,58.5922,20968.2,54258,8646,72,36497,36497,33408,29255,28339
20854,6498,8192,12948,7906,7.86796e+12,57.3913,9562.83,20854,3986,72,12662,12662,11569,10047,9922
75664,16047,17550,49065,26599,9.9232e+12,60.1391,22290.5,75664,8544,72,58114,58114,55892,53809,53335
63989,5104,19215,40735,23254,9.03226e+12,59.0213,23018.2,63989,9348,72,44774,44774,29952,29583,11807
64904,10783,21072,41037,23867,8.71904e+12,58.6352,24809,64904,10251,72,43832,43832,40900,40205,36074
85418,14458,26032,54309,31109,8.97297e+12,54.593,30863.3,85418,12659,72,59386,59386,54778,53722,47098
46627,11763,13404,29789,16838,9.2052e+12,58.5309,16375.2,46627,6507,72,33223,33223,32041,31775,30216
90352,2506,23610,58129,32223,9.53853e+12,59.683,28948.7,90352,11495,72,66742,66742,28025,26784,9109
53171,1545,19168,33281,19890,8.26448e+12,58.0651,22194.8,53171,9331,72,34003,34003,19298,7356,3707
52168,5369,12125,33829,18339,9.92509e+12,60.1075,15589.3,52168,5907,72,40043,40043,30444,20873,18274
48217,12369,18533,29984,18233,7.94807e+12,57.6658,21240.6,48217,9017,72,29684,29684,26443,22068,21091
39225,5619,11266,25068,14157,9.20551e+12,59.1963,13844.9,39225,5479,72,27959,27959,23264,22117,15456
94928,20116,27809,60539,34389,9.13252e+12,57.1353,33173,94928,13542,72,67119,67119,58920,49321,48993
46307,4292,15911,29126,17181,8.49622e+12,58.3201,18667.3,46307,7751,72,30396,30396,18836,10577,7888
46294,4502,43262,31873,14421,9.21134e+12,3.99516,43368.2,46294,14435,9,3032,3032,312,3032,319
22735,12570,22735,0,22735,7.99965,0,22735,22735,22735,1,0,0,0,0,0
63053,10960,14684,40889,22164,9.91347e+12,60.1018,18740.7,63053,7146,72,48369,48369,43911,42871,36490
20754,13086,13607,11906,8848,4.48629e+12,51.6246,14492.3,20754,6623,72,7147,7147,6983,6738,6880
45885,9121,19404,28218,17667,7.46101e+12,57.057,21869.7,45885,9447,72,26481,26481,20425,13296,13221
65869,8333,15315,42708,23161,9.91638e+12,60.1235,19527,65869,7461,72,50554,50554,42174,30740,28053
58663,11052,13633,38051,20612,9.90791e+12,60.0855,17454.9,58663,6627,72,45030,45030,41232,41165,36687
66042,4785,17740,42402,23640,9.44772e+12,59.5389,21795.6,66042,8632,72,48302,48302,27028,17257,13143
45501,360,18522,28103,17398,7.67355e+12,57.3211,21024.7,45501,9023,72,26979,26245,15494,8831,1631
80538,7988,24690,51167,29371,8.95619e+12,58.9543,29274,80538,12023,72,55848,55848,39282,25912,18986
66626,5854,36009,39585,27041,5.93105e+12,55.2142,38785.6,66626,17526,72,30617,30617,18522,9370,4056
27758,2477,10909,17222,10536,7.86421e+12,57.4475,12621,27758,5310,72,16849,16849,10068,4246,2710
68151,26058,63686,46915,21236,9.21257e+12,3.99649,63815.7,68151,21251,9,4465,4465,1824,4465,1831
7338,405,2766,4579,2759,8.12384e+12,52.3168,3403.89,7338,1325,72,4572,4524,1782,630,0
96899,16902,32320,61096,35803,8.61274e+12,58.5438,37507.4,96899,15745,72,64579,64579,51230,35581,34983
63505,4948,20803,40118,23387,8.68967e+12,58.5752,24459.7,63505,10117,72,42702,42702,28555,11929,11318
78224,18590,23615,49769,28455,9.01427e+12,59.0319,28115.3,78224,11498,72,54609,54609,48363,41051,40812
46489,9465,16757,29104,17385,8.27071e+12,56.8668,19465.7,46489,8145,72,29732,29732,23734,23550,16526
69156,2614,16082,44849,24307,9.90893e+12,60.1054,20472.2,69156,7821,72,53074,53074,33531,33128,9474
89035,6597,41492,54056,34979,6.89949e+12,56.4321,45492.1,89035,20210,72,47543,47543,25788,12362,7673
42773,810,10420,27653,15120,9.77254e+12,59.8946,13324.2,42773,5070,72,32353,32353,11439,6685,3169
76660,650,37553,59842,16818,7.8545e+10,8.99627,38134.4,76660,33790,11,39107,39107,9817,13431,6222
38540,2892,8982,25000,13540,9.89955e+12,60.0372,11679.9,38540,4363,72,29558,29558,20651,14423,9775
94541,3995,22420,61221,33320,9.85451e+12,60.0739,28125,94541,10921,72,72121,72121,33400,15673,14170
97899,7424,34757,61369,36530,8.33343e+12,58.1964,39844.6,97899,16931,72,63142,63142,35481,19965,13988
90380,20560,20976,58619,31761,9.91248e+12,60.1426,26496.2,90380,10213,72,69404,69404,68801,68789,68238
86547,2900,21711,55847,30700,9.66935e+12,59.828,26916.4,86547,10564,72,64836,64836,28054,27476,10053
6574,380,1551,4265,2309,1.01024e+13,59.3719,2227.19,6574,755,72,5023,5023,2555,2555,1354
47319,2396,17149,29605,17714,8.24866e+12,58.0196,19888,47319,8350,72,30170,30122,20232,8480,8122
48615,14448,15543,30781,17834,8.79372e+12,58.7012,18499.4,48615,7565,72,33072,33072,31840,31528,29964
26883,10226,10378,16721,10162,7.94079e+12,57.5614,12065.7,26883,5052,72,16505,16505,16442,16380,16470
97338,8139,29394,61919,35419,9.01151e+12,59.0356,34813.9,97338,14309,72,67944,67944,33220,23349,17331
49707,1760,19371,30854,18853,7.89798e+12,57.5921,22121.4,49707,9437,72,30336,30336,18106,6496,3349
67131,7507,28741,41221,25910,7.38323e+12,56.9422,32088.4,67131,13993,72,38390,38390,25485,12499,8987
40956,3365,15466,25519,15437,8.02655e+12,57.727,17856.1,40956,7520,72,25490,25490,14004,7704,5304
73837,7472,26919,46155,27682,8.2119e+12,57.6607,30875.7,73837,13108,72,46918,46918,30531,11287,10529
66349,10222,26907,41002,25347,7.67558e+12,56.9584,30330.7,66349,13097,72,39442,39442,27480,13400,13023
99688,14654,23159,64651,35037,9.9096e+12,60.1432,29163.4,99688,11277,72,76529,76529,64118,52207,48931
53099,7569,12349,34437,18662,9.91159e+12,60.1008,15867.6,53099,6008,72,40750,40750,33782,27135,25333
32522,13162,15278,19731,12791,6.86066e+12,55.4622,17028.8,32522,7437,72,17244,17244,16304,15212,15402
54887,1091,21368,34080,20807,7.90256e+12,57.6133,24355.4,54887,10408,72,33519,33519,14094,6409,2848
25039,6264,8246,15814,9225,8.67307e+12,58.443,9956.48,25039,4011,72,16793,16793,15477,13758,13438
87044,8201,32382,54290,32754,8.1139e+12,57.8947,36883.2,87044,15770,72,54662,54662,29878,15840,10639
64614,17175,24081,40306,24308,8.09269e+12,57.8654,27581.4,64614,11717,72,40533,40533,35526,28635,27135
26304,3558,6182,17051,9253,9.89619e+12,59.9497,8155.5,26304,3005,72,20122,20122,16996,12779,11856
52616,5924,20284,32700,19916,7.93099e+12,57.6474,23187.7,52616,9867,72,32332,32332,22699,22305,11090
52477,1926,12367,34004,18473,9.86687e+12,60.0385,15838.5,52477,6009,72,40110,40110,16741,17406,6761
61647,1417,3739,49045,12602,5.74454e+13,12.0022,4555.29,61647,2454,20,57908,57908,43380,33801,50151
4147,261,1010,2697,1450,9.85816e+12,58.7345,1492.17,4147,486,68,3137,3137,1594,901,872
34565,4033,12315,21662,12903,8.32755e+12,57.7441,14459,34565,5993,72,22250,22250,15539,7659,7548
55584,9131,22902,34283,21301,7.59928e+12,57.2624,25832.9,55584,11153,72,32682,32682,23938,16497,14466
67436,9818,21692,42668,24768,8.76406e+12,58.7095,25566.6,67436,10563,72,45744,45744,33408,32886,17788
19958,1110,4734,12930,7028,9.87106e+12,59.8545,6316.34,19958,2300,72,15224,15224,7693,4981,3642
92173,34800,36409,57120,35053,7.81637e+12,57.2476,40988.1,92173,17731,72,55764,55764,54914,53727,53685
17197,3315,7213,10591,6606,7.52716e+12,56.2539,8357.82,17197,3491,72,9984,9984,7938,5539,5672
17076,3385,9668,10066,7010,5.65208e+12,54.6352,10577.8,17076,4706,72,7408,7408,4706,2673,2256
10554,3439,5631,6283,4271,6.13193e+12,51.7152,6301.38,10554,2736,72,4923,4923,4029,2787,2735
58307,12159,13551,37822,20485,9.91237e+12,60.1008,17354,58307,6591,72,44756,44756,43075,42687,40384
35807,5250,8357,23218,12589,9.89409e+12,60.0162,10896.6,35807,4057,72,27450,27450,22985,22891,17639
76789,13496,17815,49801,26988,9.91466e+12,60.1352,22618.6,76789,8666,72,58974,58974,52703,52577,45110
43300,7932,15014,27212,16088,8.45692e+12,58.2639,17613,43300,7314,72,28286,28286,23848,17837,16467
82544,2065,27260,52106,30438,8.64576e+12,58.5758,31806.6,82544,13269,72,55284,55284,29807,11759,5742
34437,5774,13937,21282,13155,7.71542e+12,56.4359,15942.7,34437,6783,72,20500,20500,15292,9287,9113
74468,1246,17279,48291,26177,9.91865e+12,60.1338,21955.2,74468,8412,72,57189,57189,33807,33338,5007
18854,721,4407,12227,6627,9.93683e+12,59.9369,5927.51,18854,2146,72,14447,14447,6046,6339,2643
38726,8015,9000,25111,13615,9.93948e+12,60.0772,11707.4,38726,4384,72,29726,29726,28271,26650,26664
87066,37223,45241,52052,35014,6.2014e+12,55.4427,48835.8,87066,22017,72,41825,41825,38570,34073,33223
98628,15397,50259,59129,39499,6.33638e+12,55.7376,54315.7,98628,24475,72,48369,48369,34279,17942,17334
17769,2400,7125,11000,6769,7.76413e+12,54.7089,8327.37,17769,3448,72,10644,10644,7994,4973,4924
91007,3400,39227,55815,35192,7.35502e+12,56.8061,43525.9,91007,19105,72,51780,51780,30701,10556,5130
4948,253,1183,3211,1737,9.98213e+12,59.092,1733.94,4948,570,72,3765,3765,2397,2373,902
82814,9496,19245,53703,29111,9.9132e+12,60.1338,24364.3,82814,9369,72,63569,63569,51865,35872,32086
70664,15662,19761,45237,25427,9.3077e+12,59.3691,23994.9,70664,9624,72,50903,50903,46264,46150,40718
53801,12461,15062,34437,19364,9.30732e+12,59.3171,18434.1,53801,7332,72,38739,38739,36695,33993,33408
22839,6108,8396,14269,8570,8.20313e+12,57.8246,9915.21,22839,4083,72,14443,14443,12205,9112,8611
87494,15958,25634,55800,31694,9.12987e+12,59.1834,30637.9,87494,12485,72,61860,61860,52128,38856,35707
93822,8345,39280,57748,36074,7.50961e+12,57.1495,43772.1,93822,19130,72,54542,54542,34321,23061,18741
32461,6637,8428,20910,11551,9.57568e+12,59.6057,10706.5,32461,4103,72,24033,24033,22253,20231,20243
88666,11772,27924,56209,32457,8.85543e+12,58.8314,32844.9,88666,13604,72,60742,60742,45855,37247,34039
54026,8994,16875,34279,19747,8.88509e+12,58.824,20128.1,54026,8217,72,37151,37151,31166,23029,21131
40473,8591,11247,25920,14553,9.34226e+12,59.3456,13919.9,40473,5474,72,29226,29226,26156,23270,22552
89804,3129,32009,56265,33539,8.31965e+12,58.1704,36723.6,89804,15592,72,57795,57795,25190,12229,6083
60538,26475,31779,36129,24409,6.13353e+12,55.3606,34417.5,60538,15467,72,28759,28759,26516,24397,24026
88046,21378,22483,56740,31306,9.61424e+12,59.7767,27741.1,88046,10947,72,65563,65563,64341,64300,63073
69220,20281,25972,43143,26077,8.0707e+12,57.0088,29670.4,69220,12630,72,43248,43248,39149,34412,34289
81192,13760,18876,52653,28539,9.91536e+12,60.1335,23905.8,81192,9194,72,62316,62316,54948,47914,46015
68933,291,27130,42744,26189,7.83259e+12,57.5606,30722.9,68933,13210,72,41803,40987,13665,6451,1590
12818,3348,5956,7793,5025,7.04145e+12,56.117,6809.76,12818,2901,72,6862,6862,5780,4274,4160
79146,17740,18410,51316,27830,9.90987e+12,60.1295,23333.1,79146,8963,72,60736,60736,59875,59842,59003
22103,1461,5225,14334,7769,9.86366e+12,59.8976,6944.03,22103,2540,72,16878,16878,11408,11297,4809
56077,7120,13092,36355,19722,9.90156e+12,60.0811,16767.9,56077,6367,72,42985,42985,35866,34192,23871
4960,86,2777,2936,2024,5.83732e+12,40.5067,3149.28,4960,1346,64,2183,1910,693,711,0
64763,8396,21425,40872,23891,8.64369e+12,58.5511,25124.9,64763,10432,72,43338,43338,33082,21111,20674
77503,24142,27400,48602,28901,8.35096e+12,58.2028,31580.9,77503,13340,72,50103,50103,48572,46555,46152
31814,5705,11402,19928,11886,8.2982e+12,57.3505,13403.9,31814,5532,72,20412,20412,17178,12827,11843
13492,464,3862,8638,4854,9.2576e+12,58.951,4971.61,13492,1877,72,9630,9582,5681,3563,1040
52944,16206,18708,33208,19736,8.35628e+12,58.1744,21748.9,52944,9110,72,34236,34236,31415,27551,26784
34898,469,8143,22634,12264,9.92365e+12,60.0277,10626.6,34898,3962,72,26755,26755,8014,8883,1930
70987,7452,32800,43149,27838,6.95805e+12,56.4805,36130.2,70987,15973,72,38187,38187,23538,13140,9873
51124,7575,11886,33148,17976,9.92785e+12,60.1083,15291.7,51124,5790,72,39238,39238,34031,26985,25350
59748,14181,30294,35846,23902,6.38537e+12,55.7517,32979.5,59748,14758,72,29454,29454,21679,12606,12446
14073,1297,4985,8826,5247,8.35135e+12,56.542,6049.02,14073,2413,72,9088,9074,6172,5838,3188
74641,2127,29223,46298,28343,7.86486e+12,57.5067,33073,74641,14231,72,45418,45418,21005,9106,4229
90346,10957,21016,58579,31767,9.91606e+12,60.1372,26527.2,90346,10238,72,69330,69330,54717,54416,36813
60336,3269,20629,37969,22367,8.5063e+12,58.3687,24068.6,60336,10045,72,39707,39707,19701,9831,5731
93000,12337,31769,58522,34478,8.49784e+12,58.1715,36728.2,93000,15455,72,61231,61231,45444,31397,27301
80245,13516,18655,52036,28209,9.91217e+12,60.1343,23638.6,80245,9082,72,61590,61590,55464,47150,45203
94321,1656,21927,61158,33163,9.91354e+12,60.1417,27650.5,94321,10676,72,72394,72394,42823,42231,6364
61627,3234,14371,39966,21661,9.89895e+12,60.0917,18352,61627,6989,72,47256,47256,31066,21206,11185
49904,13749,17265,31370,18534,8.44729e+12,58.27,20189.1,49904,8397,72,32639,32639,30175,26865,26133
62648,13179,14603,40626,22022,9.89624e+12,60.0908,18640,62648,7100,72,48045,48045,46081,44231,43835
87679,1126,20417,56850,30829,9.90706e+12,60.1288,25789,87679,9939,72,67262,67262,20154,4175,4538
66907,12217,20095,42586,24321,9.03703e+12,58.9133,24047.1,66907,9776,72,46812,46812,39289,30483,30185
29014,9298,12384,17816,11198,7.42113e+12,45.5384,14083,29014,6027,72,16630,16630,13479,9238,8280
94979,10224,22023,61597,33382,9.92259e+12,60.1437,27780.4,94979,10728,72,72956,72956,57353,54659,34672
22994,1147,12093,18000,4994,79390700000,8.98695,12394.6,22994,10876,11,10901,10901,3322,4025,2637
46819,6381,18802,28971,17848,7.73953e+12,56.5354,21382.3,46819,9142,72,28017,28017,19965,10491,10315
61255,4436,27010,37473,23782,7.22937e+12,56.3648,30053,61255,13142,72,34245,34245,19009,9460,6090
89973,13256,20942,58346,31627,9.90996e+12,60.1296,26433.4,89973,10199,72,69031,69031,57838,47106,44166
84847,12572,19701,55024,29823,9.91647e+12,60.1455,24929.2,84847,9597,72,65146,65146,56576,54574,42123
33451,2247,10527,21212,12239,8.85953e+12,57.5941,12723.9,33451,5106,72,22924,22924,14867,5434,5099
10896,2745,4057,6805,4091,8.12906e+12,57.4759,4915.63,10896,1962,72,6839,6839,5791,4319,4205
89984,22992,26982,57275,32709,9.04753e+12,59.072,32060.4,89984,13144,72,63002,63002,58338,52026,50569
96870,18107,22456,62825,34045,9.91649e+12,60.1521,28319.1,96870,10927,72,74414,74414,68097,67969,60452
27569,4284,8013,17609,9960,9.17443e+12,59.0689,9944.03,27569,3894,72,19556,19556,15829,11508,11420
6170,1488,1521,3988,2182,9.84548e+12,59.1864,2162.91,6170,735,72,4649,4649,4615,4623,4622
66545,3884,32605,51946,14599,78543200000,8.99533,33146.1,66545,29341,11,33940,33940,11151,13960,8354
66243,15204,15409,42966,23277,9.91182e+12,60.1141,19641,66243,7503,72,50834,50834,50547,50331,50358
81267,22001,34833,49880,31387,7.37742e+12,57.0063,38757.3,81267,16953,72,46434,46434,39191,30750,30470
47417,8449,25975,37186,10231,79933200000,8.99317,26398.6,47417,23370,11,21442,21442,10157,10999,9334
63747,10301,14844,41336,22411,9.90811e+12,60.1011,18938.1,63747,7225,72,48903,48903,43413,35971,34243
33230,1860,11226,20941,12289,8.57669e+12,58.3653,13346.9,33230,5464,72,22004,22004,12279,5954,3947
60871,6190,14114,39472,21399,9.92838e+12,60.1273,18058.1,60871,6872,72,46757,46757,35313,33799,21084
9015,808,2176,5847,3168,9.82489e+12,59.504,3033.88,9015,1055,72,6839,6839,4821,4786,2513
35608,9025,14741,21945,13663,7.58935e+12,56.2871,16775.4,35608,7176,72,20867,20867,16375,12127,11037
62199,19246,29896,37612,24587,6.70899e+12,55.5738,32799.2,62199,14542,72,32303,32303,28545,24175,24221
61770,9319,18298,39358,22412,9.09915e+12,59.1005,22007.8,61770,8908,72,43472,43472,34242,33983,23090
30927,522,13250,18990,11937,7.43432e+12,56.9297,15027.5,30927,6454,72,17677,17629,10581,6970,1989
16270,1604,6549,10069,6201,7.74668e+12,55.3193,7670.65,16270,3182,72,9721,9721,5793,1258,1150
17477,505,4113,11340,6137,9.90788e+12,59.8571,5542.47,17477,1996,72,13364,13364,5031,5291,1866
71717,31742,31963,43798,27919,7.16433e+12,56.28,35406.6,71717,15566,72,39754,39754,39491,39227,39239
29695,1723,7162,19219,10476,9.80806e+12,59.8911,9328.41,29695,3480,72,22533,22533,14987,14824,5824
11772,3499,3524,7501,4271,9.11494e+12,58.705,4510.55,11772,1710,72,8248,8248,8222,8232,8226
55670,7830,28675,33327,22343,6.27194e+12,55.6199,31180,55670,13967,72,26995,26995,17499,6420,6172
12256,1303,2916,7948,4308,9.86713e+12,59.7023,4003.17,12256,1412,72,9340,9340,7079,7023,4477
26891,1936,6320,17441,9450,9.88089e+12,59.955,8331.74,26891,3072,72,20571,20571,12251,11977,6452
9062,1203,2620,5800,3262,9.2101e+12,55.7876,3441.08,9062,1253,72,6442,6442,5188,5164,3820
95702,10326,38588,59174,36528,7.70617e+12,57.4327,43262.3,95702,18793,72,57114,57114,36149,36968,16144
25298,4614,12916,15175,10123,6.32889e+12,53.7057,14265.9,25298,6270,72,12382,12382,8886,4762,4820
14665,273,3469,9510,5155,9.87244e+12,59.7713,4717.75,14665,1678,72,11196,11196,3591,966,1049
89015,14262,21847,57513,31502,9.73928e+12,59.8135,27214.9,89015,10629,72,67168,67168,56156,45558,42678
53237,8930,20003,33185,20052,8.07293e+12,57.8197,22970.5,53237,9741,72,33234,33234,27423,20256,18679
56752,16076,25741,34598,22154,7.05785e+12,56.3328,28547,56752,12519,72,31011,31011,27235,22094,20979
18078,164,4248,11729,6349,9.92392e+12,59.8682,5716.02,18078,2065,72,13830,13815,3753,521,702
6010,1379,1431,3899,2111,9.9192e+12,59.288,2069.26,6010,686,72,4579,4579,4540,4536,4541
75626,11630,21906,48273,27353,9.18116e+12,59.2185,26337.1,75626,10672,72,53720,53720,42780,42491,29449
47836,21549,26256,37517,10319,79932400000,8.97608,26680.8,47836,23623,11,21580,21580,18572,18790,18364
56573,3122,13193,36680,19893,9.90506e+12,60.1065,16900.4,56573,6424,72,43380,43380,22367,12176,10843
66623,7205,24072,41685,24938,8.25534e+12,58.0718,27715.3,66623,11721,72,42551,42551,26592,16707,13330
29160,8253,16526,22903,6257,80372400000,8.97747,16845.7,29160,14866,11,12634,12634,7789,8026,7570
58361,5793,28702,35174,23187,6.56653e+12,55.6925,31409.1,58361,13971,72,29659,29659,16433,8334,5580
77238,6055,23943,49036,28202,8.9143e+12,58.8947,28347.5,77238,11660,72,53295,53247,38641,21339,20668
27657,116,1849,22045,5612,5.70592e+13,11.9922,2385.27,27657,1130,14,25808,25808,14916,7777,20893
75892,17762,22248,48395,27497,9.13406e+12,55.3614,26679.1,75892,10832,72,53644,53644,48235,46968,39223
92550,7929,36919,57299,35251,7.76618e+12,57.4901,41485.3,92550,17976,72,55631,55631,37011,21444,16728
29184,2266,15873,17329,11855,5.89478e+12,55.0643,17300.7,29184,7720,72,13311,13311,7211,3384,2230
64772,6820,16519,41747,23025,9.62412e+12,59.7547,20569.4,64772,8042,72,48253,48253,36424,36106,22003
87885,15521,20419,56998,30887,9.90976e+12,60.1313,25805.5,87885,9935,72,67466,67466,61564,53535,51676
98054,21492,39066,60705,37349,7.77599e+12,57.507,43863.9,98054,19032,72,58988,58988,46760,32383,31995
52929,2010,12937,34205,18724,9.76375e+12,59.9134,16398.8,52929,6302,72,39992,39992,17591,8006,7329
57284,25396,26684,34783,22501,6.89818e+12,56.0886,29460.2,57284,12985,72,30600,30600,30558,30462,30555
74695,13587,17330,48443,26252,9.91897e+12,60.1377,22020.5,74695,8438,72,57365,57365,51940,46779,45394
20166,404,4726,13077,7089,9.88929e+12,59.8619,6328.41,20166,2287,72,15440,15440,5125,1507,1574
78597,1678,43929,46436,32161,5.69935e+12,54.237,47006.7,78597,21379,72,34668,34380,19904,12436,2153
80567,7519,34200,49505,31062,7.44135e+12,57.0868,38116.9,80567,16657,72,46367,46367,28985,15935,7913
76322,4898,38154,59625,16697,78830200000,8.99606,38728,76322,34331,11,38168,38168,12953,15816,10110
69316,22419,30564,42400,26916,7.22821e+12,56.7613,33932.3,69316,14887,72,38752,38752,34846,29456,28399
49440,9546,11527,32059,17381,9.90165e+12,60.0662,14837.1,49440,5610,72,37913,37913,35593,35042,31834
65934,13858,26778,40734,25200,7.67219e+12,57.2478,30182.2,65934,13030,72,39156,39156,33405,25476,23794
4553,627,4261,3141,1412,9.13143e+12,3.91215,4291.41,4553,1442,9,292,292,39,292,46
48896,9746,21369,29945,18951,7.28019e+12,56.7868,23914.6,48896,10394,72,27527,27527,22090,15327,13823
22191,4524,13730,12878,9313,4.9507e+12,52.1271,14736.2,22191,6683,72,8461,8461,5707,3165,2668
80408,18743,43369,63016,17392,7.9735e+10,8.98984,43930.3,80408,39026,11,37039,37039,19915,21518,18325
43578,5525,17072,27043,16535,7.85607e+12,56.7377,19541.4,43578,8295,72,26506,26506,18875,9957,9714
18788,815,1027,14924,3864,5.78176e+13,11.9894,1469.88,18788,782,14,17761,17761,16212,14995,17062
29282,916,7525,18876,10406,9.59757e+12,59.6266,9628.9,29282,3660,72,21757,21757,12690,7860,1635
12995,1060,3025,8435,4560,9.96106e+12,59.774,4164.02,12995,1465,72,9970,9970,6450,4166,3694
95483,21835,22188,61915,33568,9.91781e+12,60.1435,27970,95483,10809,72,73295,73295,72869,72382,72358
51229,13458,14302,32804,18425,9.30927e+12,59.3565,17543.8,51229,6960,72,36927,36927,36528,36074,36030
11276,1877,2700,7306,3970,9.81899e+12,59.5448,3717.27,11276,1301,72,8576,8576,7507,7471,6357
69054,12526,16049,44782,24272,9.91525e+12,60.1199,20433.8,69054,7811,72,53005,53005,47917,47810,41793
80279,15100,18614,52065,28214,9.91686e+12,60.1375,23601.1,80279,9063,72,61665,61665,56579,51746,50458
70213,66469,70213,0,70213,7.99989,0,70213,70213,70213,1,0,0,0,0,0
60460,5532,33469,35777,24683,5.77507e+12,54.4891,35974.3,60460,16299,72,26991,26991,15200,6826,4239
46572,247,12182,29967,16605,9.54512e+12,59.6274,15236.6,46572,5930,72,34390,34246,19427,19055,1091
30990,6105,7794,20003,10987,9.6912e+12,59.7225,10006.7,30990,3792,72,23196,23196,20808,18087,18043
10312,3037,3227,6552,3760,8.97367e+12,58.3979,4103.66,10312,1567,72,7085,7085,6814,6808,6660
28452,1365,8294,18160,10292,9.15912e+12,58.9655,10275.5,28452,4029,72,20158,20158,10504,5646,3697
16197,203,3816,10508,5689,9.88492e+12,59.8282,5164.74,16197,1852,72,12381,12381,3572,3975,815
68847,9872,16009,44645,24202,9.91218e+12,60.1161,20381.2,68847,7794,72,52838,52838,43956,35471,33136
64451,16160,33250,50415,14036,79172100000,8.99825,33767.3,64451,29923,11,31201,31201,18505,19888,17142
3965,928,2668,2279,1686,4.29707e+12,45.0852,2924.08,3965,1277,61,1297,1249,883,408,620
62761,7881,14613,40694,22067,9.9055e+12,60.0943,18655.6,62761,7110,72,48148,48148,40089,29092,26510
9531,4133,5425,7486,2045,8.0412e+10,8.82552,5603.21,9531,4876,11,4106,4106,3355,3391,3336
23196,3065,5415,15049,8147,9.93704e+12,59.9555,7203.72,23196,2633,72,17781,17781,14991,11260,10426
36356,1386,8472,23573,12783,9.91618e+12,60.048,11042.3,36356,4122,72,27884,27884,17587,17374,5030
13850,1664,7467,8238,5612,5.98506e+12,53.833,8278.75,13850,3632,72,6383,6383,4172,1702,1710
20952,7625,7914,13065,7887,8.06148e+12,57.6365,9316.36,20952,3851,72,13038,13038,12621,12295,12289
43477,6719,10095,28205,15272,9.93394e+12,60.0852,13071.8,43477,4916,72,33382,33382,28483,28381,22609
13539,1279,7718,7984,5555,5.66027e+12,54.4715,8473.86,13539,3760,72,5821,5821,3475,770,836
86494,46961,47298,51280,35214,5.85508e+12,54.7518,50702.9,86494,23033,72,39196,39196,39061,38902,39054
5408,358,1302,3509,1899,9.86946e+12,58.9821,1888.36,5408,624,72,4106,4106,2736,2711,1217
49725,4804,20393,30695,19030,7.62695e+12,56.6117,23072.1,49725,9917,72,29332,29332,15842,8215,5650
84030,2970,19531,54495,29535,9.91159e+12,60.1296,24712.4,84030,9508,72,64499,64499,26919,27953,10821
99612,18268,23154,64601,35011,9.91008e+12,60.133,29152.3,99612,11267,72,76458,76458,70572,62544,60688
48733,3168,11372,31603,17130,9.89108e+12,60.0562,14643.3,48733,5523,72,37361,37361,21044,20853,10807
59225,13669,15627,38085,21140,9.50238e+12,59.4003,19345.7,59225,7601,72,43598,43598,42548,41075,40948
52185,18970,27258,31180,21005,6.17949e+12,55.4855,29603.7,52185,13275,72,24927,24927,20597,15553,15568
59688,10001,13914,38699,20989,9.90185e+12,60.1003,17791.5,59688,6766,72,45774,45774,41085,34731,33258
99717,12973,23163,64670,35047,9.91521e+12,60.1425,29166.2,99717,11281,72,76554,76554,64310,47571,43584
38973,12722,17287,23831,15142,7.21075e+12,56.6731,19383.8,38973,8404,72,21686,21686,19578,17114,17244
6219,656,2995,3763,2456,6.84616e+12,54.9854,3487.31,6219,1453,72,3224,3128,2462,2401,1799
74155,13448,25197,46692,27463,8.52133e+12,58.2503,29299.2,74155,12269,72,48958,48958,38428,26059,25634
4248,102,1026,2754,1494,1.00229e+13,58.8637,1516.01,4248,494,69,3222,2982,1858,1834,380
58240,11817,16108,37309,20931,9.34857e+12,59.4122,19722.6,58240,7841,72,42132,42132,37587,31414,30024
90818,10228,21284,58863,31955,9.89271e+12,60.1048,26808,90818,10366,72,69534,69534,55831,53021,33680
88612,556,5295,70487,18125,5.74879e+13,12.0013,6275.09,88612,2587,20,83317,83317,50697,25609,63303
19308,2330,4528,12531,6777,9.90938e+12,59.9038,6075.75,19308,2202,72,14780,14780,11642,8690,7947
22301,2496,7554,14053,8248,8.55403e+12,58.2854,9101.51,22301,3671,72,14747,14747,9820,6196,5234
95182,21673,24363,61328,33854,9.60926e+12,59.7647,29975.8,95182,11865,72,70819,70819,67527,63092,62105
19383,3612,7426,12059,7324,7.9963e+12,57.1713,8740.29,19383,3610,72,11957,11957,9838,6945,6482
57747,7892,28279,34832,22915,6.60667e+12,56.0266,30966.8,57747,13775,72,29468,29468,20780,10679,10473
66579,13035,15456,43172,23407,9.92562e+12,60.0928,19709,66579,7523,72,51123,51123,48154,47473,43292
97851,2975,6178,77910,19941,5.72846e+13,12.0012,7206.3,97851,3732,20,91673,91673,70471,55763,82107
65935,708,18626,42177,23758,9.265e+12,59.317,22607.9,65935,9069,72,47309,47214,27007,26463,2111
22394,2096,5619,14464,7930,9.69721e+12,59.6683,7327.81,22394,2733,72,16775,16775,11390,8315,7217
49960,2825,18590,31166,18794,8.11389e+12,57.8682,21421.1,49960,9046,72,31370,31370,19458,12104,5070
21381,3223,5717,13743,7638,9.47966e+12,59.4027,7337.59,21381,2779,72,15664,15664,13033,9523,8753
9824,2116,2355,6367,3457,9.88221e+12,59.5812,3271.37,9824,1141,72,7469,7469,7128,6861,6886
26238,3095,6174,17009,9229,9.8673e+12,59.9223,8145.96,26238,2993,72,20064,20064,15643,15549,10343
89846,34722,37083,55405,34441,7.58914e+12,57.2714,41449.3,89846,18061,72,52763,52763,51890,50895,51087
40741,9370,9467,26424,14317,9.94945e+12,60.0779,12285.9,40741,4611,72,31274,31274,31140,31087,31104
93333,24980,31543,58793,34540,8.54959e+12,58.4506,36539.1,93333,15351,72,61790,61790,57191,50846,49548
60799,19138,20609,38289,22510,8.54417e+12,58.4161,24083.5,60799,10034,72,40190,40190,39258,38151,38341
39140,1238,9387,25335,13805,9.82018e+12,59.9337,12096.1,39140,4563,72,29753,29753,18306,7873,4304
19719,112,10659,11720,7999,5.95989e+12,53.4704,11722.1,19719,5170,72,9060,8436,5050,2821,0
50640,3536,11797,32844,17796,9.91073e+12,60.085,15174.2,50640,5739,72,38843,38843,22889,22541,12098
21982,1168,5136,14255,7727,9.91789e+12,59.921,6850.24,21982,2491,72,16846,16846,8529,4591,4165
7582,845,1860,4911,2671,9.80985e+12,59.2087,2607.96,7582,901,72,5722,5722,4438,4269,2864
33080,797,8206,21365,11715,9.73107e+12,59.7905,10547.7,33080,3992,72,24874,24874,14838,6769,2669
91052,8405,21194,59037,32015,9.90487e+12,60.1302,26743.2,91052,10319,72,69858,69858,49239,32705,28263
43782,18278,23370,26065,17717,6.0299e+12,54.3724,25371.9,43782,11362,72,20412,20412,18594,16475,16620
17563,1936,5019,11225,6338,9.27717e+12,59.0745,6377.61,17563,2445,72,12544,12544,9068,5057,4962
58817,8904,19555,37108,21709,8.62938e+12,58.5169,22963.1,58817,9521,72,39262,39262,31669,22191,19875
12594,3763,4961,7822,4772,7.84438e+12,54.8079,5893.45,12594,2394,72,7633,7633,6959,6804,5998
47181,10577,11016,30599,16582,9.89148e+12,60.0561,14200.7,47181,5353,72,36165,36165,35654,35537,34966
21342,4288,5052,13835,7507,9.89573e+12,59.8851,6720.63,21342,2453,72,16290,16290,15386,15172,14045
84919,1157,19723,55069,29850,9.92464e+12,60.1395,24948,84919,9608,72,65196,65196,38158,37611,4842
58345,8015,21984,36356,21989,8.05704e+12,57.804,25179.5,58345,10702,72,36361,36361,25116,15515,12675
32038,6338,7491,20773,11265,9.90161e+12,59.9876,9810.27,32038,3634,72,24547,24547,23159,22844,20981
10892,3608,7361,6218,4674,4.22256e+12,52.7002,7888.45,10892,3574,71,3531,3531,2829,1953,1813
4896,588,2239,2981,1915,7.18894e+12,51.6742,2665.9,4896,1085,70,2657,2609,1662,856,629
34106,7887,12558,21299,12807,8.17331e+12,57.8937,14644.3,34106,6112,72,21548,21548,18209,13709,12714
58874,9125,30642,46070,12804,79288500000,8.98038,31133.2,58874,27570,11,28232,28232,13145,14588,11720
65872,13847,17578,42315,23557,9.48264e+12,59.5768,21626.4,65872,8562,72,48294,48294,43851,43742,38559
31192,5730,8215,20069,11123,9.51958e+12,59.5191,10413.2,31192,3988,72,22977,22977,20050,19357,15239
38905,9026,9112,25224,13681,9.89403e+12,60.0407,11829,38905,4430,72,29793,29793,29696,29654,29678
27047,5571,6352,17534,9513,9.88682e+12,59.9638,8375.02,27047,3080,72,20695,20695,19765,19551,18355
84017,21226,33942,51931,32086,7.70344e+12,57.1856,38122,84017,16529,72,50075,50075,43419,34254,32279
81349,19117,19840,52586,28763,9.77576e+12,59.9505,24810.8,81349,9665,72,61509,61509,60955,60175,60238
55521,1511,12971,35995,19526,9.89849e+12,60.0795,16614.3,55521,6314,72,42550,42550,25861,17037,5371
87668,19484,28098,55490,32178,8.77498e+12,58.7369,32939.3,87668,13681,72,59570,59570,58173,56514,56680
78733,4706,18243,51058,27675,9.92935e+12,60.1497,23147.8,78733,8887,72,60490,60490,40705,28084,16379
20427,786,7863,12709,7718,7.94945e+12,57.4735,9225.62,20427,3819,72,12564,12422,6668,2038,804
70292,12533,16334,45585,24707,9.91033e+12,60.1226,20788.3,70292,7945,72,53958,53958,49403,48340,41817
50204,2280,13048,32316,17888,9.5671e+12,59.651,16302,50204,6350,72,37156,37156,16955,7185,6306
49390,7658,27794,29149,20241,5.6556e+12,54.5397,29887.3,49390,13524,72,21596,21596,14001,8266,6624
53552,7365,12507,34712,18840,9.90716e+12,60.0777,16042.4,53552,6093,72,41045,41045,33637,26580,24675
61801,23435,25388,38140,23661,7.61567e+12,57.2765,28588.9,61801,12364,72,36413,36413,35079,33598,33647
55927,21627,22579,34578,21349,7.70493e+12,56.706,25559.8,55927,10977,72,33348,33348,32880,32332,32546
52869,6853,27237,41354,11515,79144300000,8.98962,27705.1,52869,24508,11,25632,25632,10972,12461,9497
9117,1038,2812,5794,3323,8.96789e+12,56.7247,3620.27,9117,1353,72,6305,6305,4060,2897,2496
91270,2084,44738,55032,36238,6.58747e+12,56.0506,48667.6,91270,21795,72,46532,46532,23444,11154,6342
13021,2063,4173,8257,4764,8.84001e+12,58.4058,5212.26,13021,2030,72,8848,8848,6980,4508,4000
75030,16378,17411,48659,26371,9.92004e+12,60.1326,22118.5,75030,8475,72,57619,57619,56353,56066,54395
71597,25704,29290,44193,27404,7.63624e+12,57.3274,32919.1,71597,14269,72,42307,42307,40541,38225,37745
25916,5248,6745,16686,9230,9.59486e+12,59.557,8643.15,25916,3285,72,19171,19171,17072,15124,14658
34837,3460,11224,22044,12793,8.78384e+12,58.631,13467,34837,5466,72,23613,23613,14153,15102,7513
81461,6232,20833,52485,28976,9.61255e+12,59.7615,25747.3,81461,10144,72,60628,60628,42605,42166,20497
69267,11450,22892,43713,25554,8.6553e+12,58.5699,26809.8,69267,11148,72,46375,46375,39545,30243,28084
87294,47693,87294,0,87294,7.99991,0,87294,87294,87294,1,0,0,0,0,0
49799,3551,17272,31286,18513,8.44777e+12,51.1129,20189.9,49799,8409,72,32527,32527,18245,9132,0
3749,689,1602,2305,1444,7.57168e+12,55.6858,1966.88,3749,774,69,2147,2099,1847,1731,1874
97741,19528,34609,61273,36468,8.34688e+12,58.1673,39697.3,97741,16855,72,63132,63132,50511,35720,35193
16037,4291,4611,10249,5788,9.23975e+12,59.0426,5879.77,16037,2242,72,11426,11426,10967,10508,10588
91929,20490,45022,71761,20168,78595600000,8.99787,45659.6,91929,40519,11,46907,46907,27425,29829,25041
18920,414,9962,11302,7618,6.12188e+12,53.8238,11014.4,18920,4830,72,8958,8622,3678,1320,486
51356,8689,11957,33306,18050,9.91621e+12,60.0808,15373.2,51356,5816,72,39399,39399,35413,34497,28782
61154,11330,17940,38996,22158,9.13509e+12,59.1525,21633,61154,8737,72,43214,43214,34947,25251,24903
39973,12880,21976,31353,8620,80008100000,8.82806,22363,39973,19771,11,17997,17997,12613,12893,12352
64129,20196,34255,50237,13892,79592200000,8.98871,34759,64129,30823,11,29874,29874,20258,21121,19410
51174,10783,11919,33186,17988,9.91545e+12,60.0871,15325.1,51174,5797,72,39255,39255,37890,37575,35739
33886,12013,16167,20516,13370,6.76061e+12,55.9914,17951.7,33886,7871,72,17719,17719,15977,14364,14139
98527,7372,22838,63902,34625,9.91685e+12,60.1489,28782.9,98527,11120,72,75689,75689,46866,45879,25419
47108,10191,12139,30348,16760,9.58139e+12,59.6745,15236.8,47108,5902,72,34969,34969,32795,30778,30291
2052,449,562,1331,721,9.95702e+12,56.23,842.574,2052,257,55,1490,1490,1424,1411,1401
6932,86,386,5506,1426,5.77984e+13,11.9684,650.304,6932,294,14,6546,6546,4336,2572,5555
65487,5394,15240,42468,23019,9.91778e+12,60.1089,19428.4,65487,7420,72,50247,50247,32910,32014,18425
78251,6504,27911,49028,29223,8.30743e+12,58.15,32107.3,78251,13586,72,50340,50340,32618,11789,10989
87642,5338,32219,54741,32901,8.16232e+12,57.9834,36774.9,87642,15681,72,55423,55375,24108,13456,7806
79952,19996,21784,51279,28673,9.39464e+12,59.4965,26530.5,79952,10604,72,58168,58168,56417,54734,54492
88905,795,27410,56456,32449,8.92755e+12,58.9253,32387.3,88905,13342,72,61495,61159,24655,19794,3593
42716,13576,14483,26897,15819,8.53957e+12,58.3461,17081.9,42716,7041,72,28233,28233,27467,26549,26748
19596,2955,6631,12353,7243,8.57565e+12,56.9528,8027.25,19596,3212,72,12965,12965,9535,5472,5533
81409,10257,19230,52745,28664,9.86459e+12,60.0695,24251.7,81409,9364,72,62179,62179,51914,37895,34585
23498,3891,6737,15017,8481,9.27722e+12,59.1153,8440.05,23498,3281,72,16761,16761,13756,13687,10238
78651,49,4784,62580,16071,5.74315e+13,12.0016,5706.55,78651,2421,20,73867,73867,42159,16408,52542
83365,3439,19371,54057,29308,9.919e+12,60.1366,24514.1,83365,9436,72,63994,63994,40762,40294,12157
56887,16321,19225,35831,21056,8.56282e+12,58.4335,22516.2,56887,9365,72,37662,37662,34095,33281,28205
62358,27702,31384,37461,24897,6.41877e+12,55.8047,34185.7,62358,15283,72,30974,30974,29548,27569,27335
70656,47211,70656,0,70656,7.99989,0,70656,70656,70656,1,0,0,0,0,0
7073,1070,2367,4470,2603,8.74866e+12,57.7297,3012.2,7073,1145,72,4706,4706,3121,1646,1398
87685,560,20365,56864,30821,9.91126e+12,60.1286,25742.2,87685,9906,72,67320,67320,18081,20595,2882
11858,2593,2835,7686,4172,9.86331e+12,59.5899,3889.81,11858,1377,72,9023,9023,8748,8454,8459
97536,6218,22655,63247,34289,9.9186e+12,60.1481,28545.5,97536,11037,72,74881,74881,41974,24264,21349
86539,3199,31182,54169,32370,8.26616e+12,57.9255,35730.2,86539,15174,72,55357,55357,29367,13177,7495
96631,31578,32791,60836,35795,8.53101e+12,58.3841,37931.8,96631,15952,72,63840,63840,63137,62273,62132
51198,13260,19688,31831,19367,7.95095e+12,57.5308,22532.6,51198,9568,72,31510,31510,27608,22340,21125
92436,30138,35838,57413,35023,7.90478e+12,57.6691,40474.5,92436,17453,72,56598,56598,53585,49532,48658
90998,9911,21126,59015,31983,9.91537e+12,60.1374,26675.4,90998,10288,72,69872,69872,55340,52702,33535
77164,25683,36999,46676,30488,6.72494e+12,56.1948,40471.4,77164,18019,72,40165,40165,34305,26215,24502
73061,28629,33070,44548,28513,7.07147e+12,55.9679,36532.2,73061,16090,72,39991,39991,38848,37255,37109
24311,1751,5659,15777,8534,9.94807e+12,59.9915,7516.38,24311,2756,72,18652,18652,12969,12854,6122
69845,16201,16228,45289,24556,9.91676e+12,60.1265,20655.5,69845,7900,72,53617,53617,53593,53590,53600
7479,91,2947,4652,2827,7.9698e+12,53.6451,3576.35,7479,1419,72,4532,3954,1547,709,357
73577,10385,17091,47727,25850,9.91151e+12,60.126,21720.7,73577,8319,72,56486,56486,46760,46561,34889
37298,7866,15732,22951,14347,7.48896e+12,57.0478,17818.8,37298,7659,72,21566,21566,16832,11362,11215
26832,10061,25076,18480,8352,9.21307e+12,3.9921,25155.9,26832,8383,9,1756,1756,701,1756,708
97865,49459,49678,58705,39160,6.36969e+12,55.7706,53719.4,97865,24201,72,48187,48187,47984,47809,47901
48142,9823,11222,31221,16921,9.90613e+12,60.0738,14460.9,48142,5460,72,36920,36920,35300,34917,32755
26026,1556,11494,15916,10110,7.25302e+12,56.6847,13017.4,26026,5599,72,14532,14532,7490,3038,2342
56626,7735,13165,36730,19896,9.91336e+12,60.0956,16874.2,56626,6403,72,43461,43461,35537,27963,25883
36334,12930,15120,22384,13950,7.56654e+12,57.1064,17177.1,36334,7365,72,21214,21214,20116,18693,18436
15599,3431,3675,10109,5490,9.93571e+12,59.8213,4982.84,15599,1784,72,11924,11924,11570,11563,11327
51518,8889,22803,31503,20015,7.20724e+12,56.7401,25433.5,51518,11100,72,28715,28715,21526,13065,12934
4711,524,1135,3066,1645,9.94226e+12,58.962,1664.04,4711,549,71,3576,3576,2765,2611,1759
42271,1015,15076,26496,15775,8.30726e+12,58.0851,17595.9,42271,7331,72,27195,27195,12706,5520,2718
99207,5891,23042,64335,34872,9.92311e+12,60.1493,29016.8,99207,11225,72,76165,76165,41001,40836,20266
97714,22124,29268,62202,35512,9.04645e+12,58.5601,34723.7,97714,14252,72,68446,68446,62256,60760,51882
98926,21389,54005,77569,21357,79892100000,8.98149,54622.5,98926,48597,11,44921,44921,25418,26484,24369
92716,5021,31985,58270,34446,8.46251e+12,58.1514,36908.1,92716,15577,72,60731,60731,38529,12443,11386
58124,4701,32338,45614,12510,80109600000,8.94424,32801.5,58124,29097,11,25786,25786,8959,9963,7974
42740,8423,11712,27410,15330,9.37503e+12,59.3911,14518.3,42740,5691,72,31028,31028,27387,23157,23050
26553,8320,9103,16715,9838,8.50971e+12,51.4122,10866.5,26553,4417,72,17450,17450,17450,17450,17450
75241,3226,27483,47021,28220,8.1946e+12,58.0147,31500.1,75241,13380,72,47758,47758,28392,8123,4811
67841,11658,16607,43838,24003,9.75783e+12,59.9324,20867.8,67841,8088,72,51234,51234,45742,38172,36587
48956,2696,11415,31743,17213,9.90382e+12,60.0687,14696.8,48956,5550,72,37541,37541,19350,19344,9287
62409,7612,28902,37938,24471,6.93211e+12,55.9041,31893,62409,14057,72,33507,33507,23055,14697,12295
60985,3048,28645,36998,23987,6.84275e+12,56.3258,31548.9,60985,13938,72,32340,32340,16559,5257,3569
92021,9868,27371,58622,33399,9.06943e+12,59.1049,32564.6,92021,13328,72,64650,64650,45829,50278,33310
40965,6213,13203,25927,15038,8.77268e+12,53.0614,15763.6,40965,6415,72,27762,27762,25044,21407,20595
69938,1200,29773,42971,26967,7.41963e+12,56.5668,33245.5,69938,14488,72,40165,40165,23808,11963,3945
98370,45056,46806,59559,38811,6.76996e+12,55.8115,51093.5,98370,22780,72,51564,51564,50403,49112,49170
27600,519,6488,17895,9705,9.87404e+12,59.9438,8542.46,27600,3145,72,21112,21112,6790,7467,2002
15811,7445,8298,9455,6356,6.15856e+12,37.0421,9218.83,15811,4021,72,7513,7513,7513,7513,7513
9387,1739,2210,6091,3296,9.91935e+12,59.5614,3096.67,9387,1065,72,7177,7177,6635,6508,5878
21554,10195,13964,16904,4650,2.23387e+13,5.51972,16041.2,21554,4658,13,7590,7590,7062,7590,5811
53037,837,23136,32489,20548,7.2898e+12,56.8703,25859.2,53037,11269,72,29901,29543,16921,8242,1279
69510,14573,16214,45068,24442,9.91137e+12,60.1048,20615.7,69510,7895,72,53296,53296,50981,50924,48319
63804,759,14847,41366,22438,9.91249e+12,60.1093,18946.7,63804,7233,72,48957,48957,28482,28063,3284
26228,5148,6150,16996,9232,9.91387e+12,59.9966,8121.64,26228,2996,72,20078,20078,18951,17499,17242
16975,1004,5821,10682,6293,8.52848e+12,57.9767,7064.93,16975,2830,72,11154,11058,6506,1021,1018
61126,24469,39604,47921,13205,2.2358e+13,5.52991,45390.8,61126,13209,13,21522,21522,19401,21070,14369
52824,24747,26849,31680,21144,6.35208e+12,55.0194,29278.3,52824,13064,72,25975,25975,24741,23289,23464
61468,13119,25254,37920,23548,7.61992e+12,57.2695,28441.6,61468,12297,72,36214,36214,29207,19673,17445
90428,4968,20974,58642,31786,9.92598e+12,60.1501,26494.1,90428,10217,72,69454,69454,35929,19533,17361
95410,10220,47295,57436,37974,6.51589e+12,55.9563,51333.2,95410,23037,72,48115,48115,29881,16737,12531
84720,4986,19683,54938,29782,9.91962e+12,60.1317,24898.5,84720,9589,72,65037,65037,34955,19596,17344
70170,5049,16300,45499,24671,9.91938e+12,60.1313,20745.8,70170,7936,72,53870,53870,32563,31922,17391
63663,14155,14831,41282,22381,9.89897e+12,60.0961,18923.9,63663,7209,72,48832,48832,48036,47852,46849
40691,9196,18584,24777,15914,7.03197e+12,56.0877,20716,40691,9048,72,22107,22107,17608,12349,12355
51390,5011,11957,33322,18068,9.9098e+12,60.0985,15380.1,51390,5816,72,39433,39433,29364,21041,17059
65972,2716,18626,42200,23772,9.26838e+12,58.8472,22615.7,65972,9063,72,47346,47346,29480,16825,7560
57473,8298,13405,37261,20212,9.91763e+12,60.0979,17153.7,57473,6529,72,44068,44068,36709,36549,27795
59467,18218,18280,37773,21694,8.95981e+12,58.919,21822.7,59467,8905,72,41187,41187,41116,41124,41110
90354,12807,40727,55107,35247,7.08792e+12,56.637,44875.8,90354,19827,72,49627,49627,35457,18956,18329
72190,680,3443,57232,14958,5.8227e+13,12.0017,4332.84,72190,1777,20,68747,68747,46817,28431,52589
48184,10807,11224,31245,16939,9.93248e+12,60.0825,14460.5,48184,5467,72,36960,36960,36353,36340,35807
49487,995,24408,29816,19671,6.57352e+12,55.9562,26762.8,49487,11890,72,25079,24829,14216,6419,1207
98750,19048,34334,62034,36716,8.42268e+12,58.0432,39511.8,98750,16705,72,64416,64416,53362,40452,39971
56251,1911,13696,36366,19885,9.77997e+12,59.9324,17341,56251,6665,72,42555,42555,17029,17563,6090
58549,10082,31119,34883,23666,6.05097e+12,54.9338,33658.2,58549,15150,72,27430,27430,18996,11010,8944
71120,14367,22542,45067,26053,8.82494e+12,58.7774,26614.1,71120,10979,72,48578,48578,40918,40750,31671
28551,8795,13911,17235,11316,6.66616e+12,55.969,15441.5,28551,6777,72,14640,14640,12267,8979,8434
36578,2560,15653,22459,14119,7.40362e+12,56.8029,17693.5,36578,7620,72,20925,20925,12774,3318,2983
80357,20721,25755,50860,29497,8.77497e+12,58.7391,30254.4,80357,12542,72,54602,54602,50359,45431,45336
50176,2401,12495,32393,17783,9.70813e+12,59.8265,15788.1,50176,6080,72,37681,37681,23826,23521,6869
36355,8204,10182,23281,13074,9.3228e+12,59.305,12621.7,36355,4959,72,26173,26173,24022,23949,21608
34277,1020,17100,20612,13665,6.49277e+12,54.8693,18842,34277,8325,72,17177,16942,9969,6175,1377
26495,2864,10837,16361,10134,7.64985e+12,56.6891,12459,26495,5274,72,15658,15658,10575,4611,4588
88274,2990,20498,57247,31027,9.91259e+12,60.1359,25903.2,88274,9981,72,67776,67776,42202,41695,10689
34572,2722,9036,22248,12324,9.54123e+12,59.5633,11427.3,34572,4392,72,25536,25536,17281,7561,7234
26743,3381,6228,17349,9394,9.93538e+12,59.987,8232.57,26743,3023,72,20515,20515,17151,12601,11581
96877,8603,22459,62836,34041,9.92157e+12,60.1483,28317.7,96877,10937,72,74418,74418,54159,53761,29229
28297,14219,15361,16805,11492,5.94859e+12,55.0956,16751.8,28297,7482,72,12936,12936,12567,12046,12166
4127,2052,3048,2326,1801,3.57641e+12,20.1931,3270.75,4127,1467,56,1079,1079,1079,1079,1079
69920,8028,16244,45346,24574,9.91428e+12,60.1237,20676.8,69920,7907,72,53676,53676,43761,41455,27027
12298,2156,3615,7845,4453,9.18669e+12,58.7742,4638.76,12298,1761,72,8683,8683,6909,4564,4072
8999,814,8999,0,8999,7.99911,0,8999,8999,8999,1,0,0,0,0,0
13443,6356,8343,7802,5641,4.94134e+12,50.5626,9034.34,13443,4042,72,5100,5100,4802,4465,4662
69770,3710,32826,42321,27449,6.83545e+12,55.65,36068.1,69770,15969,72,36944,36944,22230,5090,4423
77624,65301,77624,0,77624,7.9999,0,77624,77624,77624,1,0,0,0,0,0
91385,7305,31108,57517,33868,8.51749e+12,58.2619,36002.8,91385,15134,72,60277,60277,40117,22294,15535
80426,4318,21024,51734,28692,9.54037e+12,59.4384,25855.6,80426,10237,72,59402,59402,37799,37296,11238
38980,6625,9147,25272,13708,9.87527e+12,60.0037,11864.8,38980,4440,72,29833,29833,26861,26159,21973
91100,39770,43590,55109,35991,6.7369e+12,56.2302,47588.7,91100,21233,72,47510,47510,45736,44049,43754
82818,4923,19251,53707,29111,9.91264e+12,60.1295,24368.3,82818,9373,72,63567,63567,42713,42289,17063
24600,2668,5788,15946,8654,9.90079e+12,59.9406,7660.03,24600,2813,72,18812,18812,14769,10037,8911
70862,9344,17779,45713,25149,9.67831e+12,59.836,22169.4,70862,8658,72,53083,53083,43574,30587,27532
82786,4410,33875,51101,31685,7.63285e+12,57.0747,37973.6,82786,16486,72,48911,48911,30323,18901,7809
39242,4168,9188,25440,13802,9.89586e+12,60.0468,11924.6,39242,4467,72,30054,30054,23391,22237,14113
4086,238,1558,2556,1530,8.33436e+12,56.6833,1967.16,4086,759,63,2528,2480,1601,1060,705
51068,8984,11891,33115,17953,9.90565e+12,60.0852,15295.6,51068,5778,72,39177,39177,35631,30847,29767
16681,500,3923,10820,5861,9.90423e+12,59.846,5302.64,16681,1905,72,12758,12758,4870,5103,1836
31500,1651,11953,19619,11881,8.00282e+12,57.6517,13883.7,31500,5809,72,19547,19547,12662,4530,4414
79865,4582,21945,51186,28679,9.36224e+12,59.4564,26674.1,79865,10682,72,57920,57920,30796,30132,13414
62565,20461,20598,39514,23051,8.6638e+12,58.5767,24202.1,62565,10030,72,41967,41967,41783,41779,41694
29443,2783,11265,18324,11119,7.98314e+12,57.6255,13086.5,29443,5482,72,18178,18178,11032,2614,2449
22339,3378,6854,14192,8147,8.99653e+12,58.6619,8459.41,22339,3332,72,15485,15485,12944,9533,8811
16575,2315,4473,10643,5932,9.45397e+12,59.2619,5796.18,16575,2170,72,12102,12102,9018,5346,5425
60239,15107,15159,38863,21376,9.66979e+12,59.7986,18981.8,60239,7382,72,45080,45080,45028,45031,45028
49536,5269,11541,32128,17408,9.91381e+12,60.0751,14855.8,49536,5618,72,37995,37995,29494,28167,17845
31869,7616,7751,20614,11255,9.80238e+12,59.8576,10033.1,31869,3773,72,24118,24118,23925,23821,23841
56193,10337,15410,36027,20166,9.37094e+12,59.4215,18929.1,56193,7493,72,40783,40783,34718,34564,27383
88286,23043,31216,55361,32925,8.34707e+12,57.9563,35883.2,88286,15202,72,57070,57070,50570,41697,39690
63928,10439,14881,41453,22475,9.91108e+12,60.106,18987,63928,7241,72,49047,49047,42595,36440,34777
32466,3285,10120,20609,11857,8.90097e+12,58.7774,12267.9,32466,4922,72,22346,22346,15477,7351,7235
34136,1062,1434,27024,7112,5.85674e+13,11.9941,2039.13,34136,1431,13,32702,32702,29380,26457,31220
1406,148,386,915,491,1.00936e+13,55.8393,598.897,1406,183,49,1020,1020,643,446,447
89947,30356,39814,54987,34960,7.19571e+12,56.4782,43999.7,89947,19375,72,50133,50133,45197,38378,36968
26247,6836,8477,16607,9640,8.76037e+12,58.5818,10268.9,26247,4123,72,17770,17770,16891,16824,16065
36482,7653,8490,23654,12828,9.93619e+12,60.0568,11065.3,36482,4136,72,27992,27992,26760,25637,25425
40223,3706,15378,25031,15192,7.98895e+12,57.6929,17718.4,40223,7487,72,24845,24797,6461,14004,1291
58632,10935,13677,38018,20614,9.90578e+12,60.0765,17490.5,58632,6654,72,44955,44955,41031,37308,36339
10275,1974,2800,6604,3671,9.47602e+12,59.0468,3714.08,10275,1359,72,7475,7475,6465,6235,4940
46873,21649,22968,36589,10284,78586800000,8.99422,23420.7,46873,20663,11,23905,23905,22866,22994,22757
80778,16333,18786,52377,28401,9.91526e+12,60.1325,23792.3,80778,9151,72,61992,61992,58994,54960,54068
94633,2846,48745,56641,37992,6.2634e+12,55.509,52631.5,94633,23725,72,45888,45888,27349,11357,4948
66617,11376,23724,41757,24860,8.31374e+12,58.1493,27394.8,66617,11549,72,42893,42893,34196,23481,20845
87928,31613,38581,53822,34106,7.24472e+12,56.6385,42711,87928,18773,72,49347,49347,47475,44992,44469
53221,6871,20807,33026,20195,7.87268e+12,57.5773,23715.6,53221,10131,72,32414,32414,21930,9582,9279
89975,16040,20877,58355,31620,9.91918e+12,60.1456,26374.9,89975,10167,72,69098,69098,63259,61904,53478
54028,5152,15081,34584,19444,9.32068e+12,59.373,18466,54028,7347,72,38947,38947,27002,26695,12476
93156,1914,35770,57911,35245,7.95337e+12,57.5035,40463.6,93156,17412,72,57386,57386,25392,8728,1992
25679,9062,10605,15847,9832,7.60547e+12,56.2175,12176.1,25679,5148,72,15074,15074,15011,14947,15039
88218,15627,20490,57213,31005,9.90928e+12,60.1278,25894.5,88218,9968,72,67728,67728,60649,60508,52051
87180,10966,20230,56529,30651,9.92129e+12,60.1489,25579.2,87180,9855,72,66950,66950,53410,53141,36821
10140,380,473,8036,2104,5.83075e+13,11.9796,796.68,10140,429,14,9667,9667,8947,8373,9340
33509,5016,10862,21194,12315,8.74254e+12,58.5866,13034.3,33509,5286,72,22647,22647,18202,13314,12105
79592,27146,29473,49681,29911,8.1318e+12,57.9375,33655.3,79592,14353,72,50119,50119,48163,45457,45047
6849,1863,2992,4193,2656,7.41826e+12,56.21,3551.11,6849,1457,72,3857,3857,3398,2978,3056
3191,706,939,2035,1156,9.34056e+12,54.7192,1318.17,3191,452,61,2252,2252,1932,1692,1715
18532,104,5526,11811,6721,9.09878e+12,58.8616,6923.47,18532,2689,72,13006,11874,3891,1939,515
55685,13942,19194,35012,20673,8.47243e+12,58.326,22401.1,55685,9350,72,36491,36491,32273,27395,27272
30379,11138,12351,18773,11606,7.69026e+12,57.2656,14158,30379,6016,72,18028,18028,16666,15056,15226
49002,11058,17377,30721,18281,8.34191e+12,58.1128,20229.8,49002,8459,72,31625,31625,27419,22488,22510
58525,2532,13582,37956,20569,9.92379e+12,60.1171,17398.5,58525,6611,72,44943,44943,28858,28532,9107
76029,17888,37240,59349,16680,78538800000,8.99533,37819,76029,33509,11,38789,38789,23423,25320,21546
51692,16418,28607,40556,11136,80081700000,8.97305,29045.7,51692,25742,11,23085,23085,15131,15751,14529
78277,23653,39611,46974,31303,6.38269e+12,55.5936,42977.7,78277,19286,72,38666,38666,31370,21300,19106
24785,2819,6405,15957,8828,9.61474e+12,59.5744,8242.33,24785,3114,72,18380,18380,14269,9498,9388
87542,24335,34921,54195,33347,7.76295e+12,57.4952,39281,87542,17006,72,52621,52621,46660,39675,39607
20942,2040,4900,13584,7358,9.9222e+12,59.9169,6548.4,20942,2382,72,16042,16042,11908,11819,6984
46271,2522,15315,29206,17065,8.65326e+12,58.404,18112.8,46271,7458,72,30956,30956,18939,18567,4357
65752,17483,21931,41466,24286,8.60018e+12,58.1754,25667.8,65752,10669,72,43821,43821,40803,39996,35846
10894,2229,6109,8551,2343,80179800000,8.9765,6303.21,10894,5494,11,4785,4785,2450,2582,2334
4640,299,1626,2921,1719,8.6853e+12,57.2625,2089.49,4640,792,72,3014,2966,1751,1202,1043
43705,5086,10138,28349,15356,9.9373e+12,60.0909,13129.9,43705,4938,72,33567,33567,26179,26034,17204
51944,6946,13528,33432,18512,9.57432e+12,59.6595,16871.6,51944,6590,72,38416,38416,31470,22036,19831
23828,5116,5547,15455,8373,9.9355e+12,59.9863,7377.81,23828,2696,72,18281,18281,17758,17641,17070
29752,1235,6970,19291,10461,9.91324e+12,59.9848,9149.4,29752,3391,72,22782,22782,9959,4541,4160
60990,6927,20897,38371,22619,8.48964e+12,58.356,24365.8,60990,10174,72,40093,40093,27084,17393,14300
52930,13216,17658,33372,19558,8.61839e+12,57.8672,20775.8,52930,8596,72,35272,35272,30989,30865,25899
46124,1656,10687,29917,16207,9.93324e+12,60.1091,13817.9,46124,5206,72,35437,35437,22243,14957,6072
74072,19051,19454,47637,26435,9.51955e+12,59.6461,23954.5,74072,9464,72,54618,54618,54059,54046,53542
84518,12755,27542,53412,31106,8.70574e+12,58.1965,32207.8,84518,13395,72,56976,56976,42874,26949,22843
92983,5740,21632,60294,32689,9.90978e+12,60.1328,27282.1,92983,10532,72,71351,71351,39232,22300,19638
85054,3560,46938,50353,34701,5.78738e+12,54.5814,50266.1,85054,22852,72,38116,38116,21694,5614,2068
75641,5771,19995,48629,27012,9.50216e+12,59.607,24561.5,75641,9732,72,55646,55646,37232,36803,14620
9452,3938,3996,5819,3633,7.50849e+12,56.6063,4718.06,9452,1941,72,5456,5456,5395,5403,5386
33916,20322,20468,19779,14137,5.15565e+12,54.154,21901.6,33916,9969,72,13448,13448,13369,13246,13362
21375,1494,5632,13756,7619,9.55497e+12,59.2138,7257.3,21375,2726,72,15743,15743,10943,5360,5196
24476,1525,5705,15873,8603,9.92203e+12,59.975,7573.63,24476,2773,72,18771,18771,10259,10253,5336
45179,11511,21335,27387,17792,6.82361e+12,55.4725,23602.8,45179,10371,72,23844,23844,19293,13014,11732
54390,3246,12662,35276,19114,9.89574e+12,60.0673,16247.9,54390,6154,72,41728,41728,27991,19262,11127
45088,11423,13482,28708,16380,9.06598e+12,58.4708,16332.1,45088,6562,72,31606,31606,30176,28581,28619
51089,4827,20632,31590,19499,7.70124e+12,57.2541,23398.2,51089,10028,72,30457,30457,20256,10194,7429
1045,28,300,679,366,1.03178e+13,53.6833,467.351,1045,139,43,492,91,198,233,155
70283,10442,21059,44741,25542,9.0393e+12,59.0435,25179.8,70283,10245,72,49224,49224,39102,25140,22002
61758,9570,19560,39128,22630,8.82526e+12,58.7774,23181.3,61758,9521,72,42198,42198,34147,24659,24483
85600,8220,19878,55511,30089,9.92532e+12,60.1402,25139.2,85600,9684,72,65722,65722,48735,34794,27874
24875,2177,5790,16136,8739,9.92822e+12,59.987,7685.11,24875,2815,72,19085,19085,13837,13729,7518
48860,7991,11384,31688,17172,9.92022e+12,60.0817,14660.3,48860,5544,72,37476,37476,33403,27904,26664
37409,10717,15696,23030,14379,7.51237e+12,57.0813,17794.9,37409,7640,72,21713,21713,19264,15978,15261
30141,6780,10480,18936,11205,8.46647e+12,58.1937,12413.8,30141,5105,72,19661,19661,17564,14775,14186
84816,6077,31071,52986,31830,8.18645e+12,58.0139,35506.8,84816,15137,72,53745,53745,29823,14662,9276
51206,16378,17065,32295,18911,8.61491e+12,58.4946,20101.3,51206,8305,72,34141,34141,33573,32760,32806
13591,3185,3614,8741,4850,9.52444e+12,59.2558,4754,13591,1750,72,9977,9977,9490,8898,8834
33327,3068,14022,20516,12811,7.49144e+12,56.9566,15932.6,33327,6814,72,19305,19257,10490,8918,7700
10258,776,8178,5634,4624,2.65726e+12,15.7094,8537.85,10258,3968,59,2080,2080,1192,1159,0
95576,7387,36484,59456,36120,7.98364e+12,57.6765,41296.6,95576,17763,72,59092,59092,32966,17877,12266
59156,6805,20395,37190,21966,8.46486e+12,57.875,23770.6,59156,9915,72,38761,38761,25464,14736,11443
90685,11519,34891,56367,34318,7.9447e+12,57.6795,39474.2,90685,16976,72,55794,55794,37610,23887,19497
34562,7937,8062,22415,12147,9.92567e+12,60.0378,10524.3,34562,3926,72,26500,26500,26353,26247,26255
35624,10262,12042,22445,13179,8.57395e+12,58.3653,14283.4,35624,5862,72,23582,23582,22250,20706,20877
9085,1976,2133,5895,3190,9.99809e+12,59.5363,2996.52,9085,1037,72,6952,6952,6754,6749,6649
42164,12112,13432,26705,15459,8.80612e+12,53.3495,16070,42164,6522,72,28732,28732,28732,28732,28732
8087,289,413,6416,1671,5.80939e+13,11.9764,700.137,8087,343,14,7674,7674,6743,6010,7252
40104,5789,17448,24576,15528,7.30487e+12,56.5387,19624.4,40104,8480,72,22656,22656,16227,8686,8594
54985,14187,17116,34898,20087,8.90811e+12,58.8453,20420.5,54985,8336,72,37869,37869,35676,32673,32160
77237,32902,37120,46712,30525,6.70754e+12,56.1464,40591.6,77237,18062,72,40117,40117,38118,36302,35871
58272,8763,13539,37791,20481,9.90866e+12,60.0992,17341.5,58272,6579,72,44733,44733,38988,37649,29353
79079,4859,4966,62954,16125,5.73103e+13,12.0016,5890.1,79079,2182,20,74113,74113,73452,73037,73792
59308,14754,27599,36029,23279,6.90687e+12,56.3941,30454.7,59308,13432,72,31709,31709,25582,17243,15295
19342,3145,5444,12384,6958,9.2904e+12,59.1384,6917.52,19342,2647,72,13898,13898,11485,11409,8702
93661,3197,23639,60407,33254,9.65614e+12,59.8278,29200.1,93661,11516,72,70022,70022,42949,28154,9657
39815,5741,9270,25820,13995,9.91037e+12,60.0484,12038.1,39815,4506,72,30545,30545,26334,25346,19320
24478,6031,11996,19109,5369,78509100000,8.98975,12320.7,24478,10789,11,12482,12482,7753,8335,7190
53440,8180,12425,34655,18785,9.91207e+12,60.1055,15962.6,53440,6044,72,41015,41015,35924,34733,27408
27643,674,7264,17790,9853,9.55006e+12,59.5322,9258.85,27643,3536,72,20379,20379,12206,8014,2291
55486,10833,15722,35490,19996,9.26251e+12,59.3056,19165.5,55486,7658,72,39764,39764,33955,33822,26952
69773,4920,30913,42654,27119,7.19315e+12,56.7709,34290.4,69773,15055,72,38860,38860,23400,5266,4713
53788,10787,18461,33830,19958,8.48631e+12,58.3497,21585.8,53788,8989,72,35327,35327,31736,30882,25812
10372,628,2434,6739,3633,9.93506e+12,59.6323,3392.38,10372,1177,72,7938,7938,4196,4188,2185
74695,4656,17329,48444,26251,9.919e+12,60.1381,22020.3,74695,8436,72,57366,57366,31804,18285,16142
8841,1388,2133,5724,3117,9.93649e+12,59.5134,2972.71,8841,1038,72,6708,6708,5612,5591,4442
12278,2699,3358,7879,4399,9.43295e+12,59.2005,4407.48,12278,1634,72,8920,8920,8120,7129,6956
3161,697,787,2050,1111,9.79099e+12,57.9975,1180.98,3161,369,62,2374,2374,2281,2277,2249
79506,7909,26336,50176,29330,8.63334e+12,58.1514,30735,79506,12808,72,53170,53170,35579,23901,19868
77367,6606,24056,49101,28266,8.9085e+12,58.883,28458.8,77367,11717,72,53311,53263,32539,32097,7049
15351,1656,4827,9743,5608,8.92201e+12,58.549,6012.27,15351,2348,72,10524,10524,6936,2726,2747
18144,12012,18144,0,18144,7.99956,0,18144,18144,18144,1,0,0,0,0,0
24736,930,5763,16048,8688,9.91538e+12,59.9821,7650.88,24736,2798,72,18973,18973,11924,8016,3365
55375,9723,18899,34850,20525,8.50973e+12,58.3691,22103.9,55375,9197,72,36476,36476,23411,10812,7450
63148,12750,23125,39467,23681,8.19044e+12,57.6175,26587.8,63148,11248,72,40023,40023,34553,27025,25411
51406,949,11964,33339,18067,9.92585e+12,60.0915,15381.4,51406,5827,72,39442,39442,13007,3679,3723
35485,2424,8279,23009,12476,9.90373e+12,60.0198,10799.1,35485,4026,72,27206,27206,18644,18479,8200
64288,18185,20985,40618,23670,8.70096e+12,58.6179,24684.3,64288,10217,72,43303,43303,39976,35488,34495
55730,21922,27240,33614,22116,6.60154e+12,55.3997,29858.6,55730,13256,72,28490,28490,25471,21961,21949
68366,10088,15900,44334,24032,9.91541e+12,60.1115,20244.9,68366,7737,72,52466,52466,45545,43914,33895
67755,18799,20003,43193,24562,9.10824e+12,59.1203,24016.9,67755,9741,72,47752,47752,46840,45847,45922
83245,21859,31266,51883,31362,8.06141e+12,57.862,35580.8,83245,15225,72,51979,51979,47477,46254,40000
13844,185,3289,8974,4870,9.8431e+12,59.6929,4481.34,13844,1586,72,10555,10555,6099,6003,757
62162,27213,31973,37224,24938,6.27464e+12,55.6284,34716.4,62162,15571,72,30189,30189,27850,24616,24077
11371,469,3621,7207,4164,8.83763e+12,57.8819,4565.03,11371,1750,72,7750,7702,3628,2010,1294
68924,16566,23856,43312,25612,8.44522e+12,58.3078,27678.6,68924,11612,72,45068,45068,41522,36608,35662
42774,9072,16821,26527,16247,7.84437e+12,57.5361,19248.7,42774,8191,72,25953,25953,21525,15517,14143
72793,12398,16971,47201,25592,9.89747e+12,60.1086,21554.6,72793,8256,72,55822,55822,49283,43042,41361
25962,5884,6111,16831,9131,9.89531e+12,59.9453,8063.64,25962,2973,72,19851,19851,19539,19531,19334
42290,6330,11502,27125,15165,9.41741e+12,59.4564,14289.2,42290,5599,72,30788,30788,24606,24450,17166
14428,2731,3420,9359,5069,9.89657e+12,59.6939,4648.54,14428,1655,72,11008,11008,10023,10005,8984
21283,5955,6785,13491,7792,8.80322e+12,58.5801,8311.23,21283,3297,72,14498,14498,13461,12306,12375
44351,11366,22732,26569,17782,6.29827e+12,55.628,24827.1,44351,11060,72,21619,21619,17445,12588,12613
12306,714,2934,7985,4321,9.87316e+12,59.6825,4022.38,12306,1423,72,9372,9372,4771,2714,2465
45926,8763,16863,28684,17242,8.18363e+12,57.4424,19522.1,45926,8209,72,29063,29063,23615,16218,14521
72025,1705,25361,45187,26838,8.37122e+12,57.6927,29299.9,72025,12338,72,46664,46664,21948,9157,4131
23008,429,6774,14670,8338,9.1544e+12,58.9934,8436.32,23008,3300,72,16234,16115,4906,2410,673
38332,7522,8925,24859,13473,9.90873e+12,60.0541,11612.7,38332,4334,72,29407,29407,27359,25450,24990
98469,2915,41831,60517,37952,7.42764e+12,56.7116,46470.1,98469,20359,72,56638,56638,32875,11942,3966
59656,20200,28145,36168,23488,6.8237e+12,55.2041,30989.6,59656,13690,72,31511,31511,29456,26605,26155
2290,357,1073,1404,886,7.18893e+12,41.0786,1315.77,2290,505,56,1217,1217,1133,1128,1105
8107,3885,4618,6369,1738,8.0386e+10,8.9567,4781.6,8107,4150,11,3489,3489,3059,3081,3049
41333,6770,13615,26110,15223,8.66729e+12,58.5271,16173.4,41333,6628,72,27718,27718,22810,16158,14612
83639,13331,25870,53101,30538,8.91938e+12,58.9219,30590.9,83639,12599,72,57769,57769,46807,33959,33486
54556,7299,21496,33821,20735,7.83607e+12,57.4033,24453.4,54556,10466,72,33060,33060,22520,14228,11741
90336,9441,36730,55798,34538,7.67358e+12,57.3732,41153.7,90336,17893,72,53606,53606,35475,20089,13453
87775,46949,46989,68766,19009,7.9647e+10,8.99288,47579.2,87775,42285,11,40786,40786,40768,40768,40777
23107,1369,5395,14997,8110,9.92008e+12,59.9575,7179.53,23107,2623,72,17712,17712,11869,11750,4812
14624,1639,3389,9496,5128,1.00153e+13,59.8671,4635.39,14624,1651,72,11235,11235,8645,5647,5635
99193,9086,24868,64008,35185,9.67145e+12,59.8458,30722.7,99193,12101,72,74325,74325,52612,52142,25902
56510,8075,19757,35484,21026,8.40905e+12,58.2374,22981.3,56510,9616,72,36753,36753,26455,16637,13953
91544,27661,91544,0,91544,7.99991,0,91544,91544,91544,1,0,0,0,0,0
91283,14379,21176,59203,32080,9.92315e+12,60.1496,26739.9,91283,10315,72,70107,70107,61947,60037,48210
33588,4270,10210,21361,12227,9.02589e+12,58.908,12434.9,33588,4973,72,23378,23378,16319,11058,9486
58241,531,13521,37770,20471,9.92589e+12,60.1095,17318.2,58241,6587,72,44720,44720,12597,14183,2447
83732,23042,27449,52892,30840,8.68566e+12,58.5843,32062,83732,13356,72,56283,56283,52539,47387,46335
98656,10077,22925,63979,34677,9.91539e+12,60.1413,28872.4,98656,11164,72,75731,75731,57405,39191,34162
93174,26804,30073,58942,34232,8.74391e+12,58.7026,35158.8,93174,14646,72,63101,63101,61081,58817,58797
19076,712,6427,12029,7047,8.61579e+12,58.2524,7793.97,19076,3127,72,12649,12505,4257,2074,837
14925,894,928,11869,3056,5.74138e+13,12.0085,1326.84,14925,559,20,13997,13997,13805,13745,13894
77188,26674,31934,47591,29597,7.56866e+12,56.8144,35774,77188,15535,72,45254,45254,43541,41571,41722
10770,884,2564,6976,3794,9.96216e+12,59.6773,3544.76,10770,1249,72,8206,8206,5719,5675,2837
25417,4101,5969,16472,8945,9.9174e+12,59.9731,7891.43,25417,2902,72,19448,19448,16791,14300,13718
27834,7456,12490,16997,10837,7.13903e+12,56.5854,14082.9,27834,6081,72,15344,15296,13948,12295,12461
42378,5995,14877,26597,15781,8.3866e+12,58.1835,17417.7,42378,7242,72,27501,27501,19373,11008,8795
1116,165,312,728,388,1.01704e+13,55.181,490.831,1116,150,46,804,804,631,595,494
29824,557,6979,19340,10484,9.91766e+12,60.007,9163.92,29824,3399,72,22845,22845,13419,13239,1917
80867,25551,27106,50966,29901,8.58969e+12,58.5019,31542.9,80867,13199,72,53761,53761,53013,52947,52362
99214,1958,25706,63865,35349,9.56214e+12,59.7132,31506.5,99214,12507,72,73508,73508,28476,26992,7633
54308,12072,12629,35225,19083,9.91044e+12,60.0963,16212.5,54308,6146,72,41679,41679,40869,40854,40057
65763,12615,15298,42642,23121,9.91075e+12,60.1117,19503.4,65763,7447,72,50465,50465,46601,46516,42021
92808,8317,21527,60197,32611,9.92075e+12,60.1462,27171.7,92808,10485,72,71281,71281,51984,36904,28249
9539,226,637,7601,1938,5.71443e+13,11.9771,947.145,9539,397,14,8902,8902,6352,4710,7746
72967,8189,28003,45367,27600,7.95973e+12,57.5592,31823.8,72967,13627,72,44964,44964,24728,28696,12312
2730,106,1185,1684,1046,7.48749e+12,43.7436,1476.03,2730,555,59,1545,1545,625,434,361
62439,9060,23599,38879,23560,8.04469e+12,57.714,26976.1,62439,11490,72,38840,38840,30744,20746,18429
99669,1840,4211,78915,20754,5.85175e+13,62.3734,5281.25,99669,4002,20,95458,95407,73925,54666,85356
39249,8388,10147,25273,13976,9.59019e+12,59.6588,12810.1,39249,4938,72,29102,29102,26500,26454,23467
14721,3263,3472,9550,5171,9.94956e+12,59.8057,4720.39,14721,1691,72,11249,11249,10956,10749,10764
96118,22860,29203,61115,35003,9.00014e+12,59.0127,34547.4,96118,14226,72,66915,66915,60730,60573,53286
89979,1608,20954,58351,31628,9.89994e+12,60.126,26448.5,89979,10198,72,69025,69025,22459,24423,6085
42963,11163,24408,33747,9216,80424600000,8.97756,24796.8,42963,21960,11,18555,18555,10838,11204,10490
39278,6387,9127,25475,13803,9.93e+12,60.0777,11867.6,39278,4446,72,30151,30151,26792,26023,21252
88917,20782,26604,56606,32311,9.04919e+12,59.0729,31636.4,88917,12955,72,62313,62313,57068,56957,50806
14920,1097,3512,9676,5244,9.93131e+12,59.8326,4775.96,14920,1710,72,11408,11408,7947,5572,3854
75560,17503,17590,48998,26562,9.91427e+12,60.1275,22319.2,75560,8568,72,57970,57970,57875,57854,57830
31204,1602,8634,20006,11198,9.35205e+12,59.3203,10801.3,31204,4197,72,22570,22570,14914,5911,5638
19871,6203,10019,11938,7933,6.42858e+12,54.1946,11152.2,19871,4858,72,9852,9852,8421,6449,6190
41098,3498,9618,26646,14452,9.90477e+12,60.0319,12454.9,41098,4676,72,31480,31480,22648,16019,11888
13722,2629,3703,8823,4899,9.47465e+12,59.2067,4846.04,13722,1800,72,10019,10019,8434,6650,6654
25767,5977,9988,16010,9757,7.93203e+12,57.5597,11618.1,25767,4866,72,15779,15779,13628,10649,10169
52681,6961,12269,34167,18514,9.90416e+12,60.0676,15760.1,52681,5963,72,40412,40412,34008,25280,23235
66039,5065,15368,42833,23206,9.90813e+12,60.1123,19589.9,66039,7481,72,50671,50671,31694,19820,17344
94560,15711,26356,60549,34011,9.31816e+12,59.4023,31790.3,94560,12835,72,68204,68204,58997,46439,43478
33536,5216,9508,21442,12094,9.26869e+12,58.58,11787.2,33536,4626,72,24028,24028,18997,13130,12954
44531,14879,16906,27723,16808,8.0194e+12,57.7373,19456.5,44531,8230,72,27625,27625,25247,22066,21383
14050,5725,8633,8163,5887,5.03089e+12,53.0445,9353.23,14050,4200,72,5417,5417,4905,4348,4563
39656,4237,10815,25441,14215,9.40591e+12,59.4318,13458,39656,5265,72,28841,28841,21468,20442,12047
96873,9388,32968,60970,35903,8.51561e+12,58.4213,38109.7,96873,16054,72,63905,63905,44864,27053,21976
21486,2685,5021,13937,7549,9.90896e+12,59.94,6708.37,21486,2435,72,16465,16465,13024,12963,8931
32798,9376,13767,20194,12604,7.52966e+12,57.0758,15654.2,32798,6706,72,19031,19031,16630,13840,13955
3419,665,846,2219,1200,9.9632e+12,58.3954,1260.82,3419,409,64,2573,2573,2367,2325,2190
42030,6569,12741,26735,15295,9.02307e+12,58.9504,15412,42030,6207,72,29289,29289,22832,16699,15046
36664,5781,9464,23620,13044,9.57385e+12,59.6207,11984,36664,4595,72,27200,27200,22745,17550,17408
99464,28372,31536,63013,36451,8.81883e+12,58.7971,36954.1,99464,15358,72,67928,67928,65198,62073,62030
5129,3107,4797,3533,1596,9.20135e+12,3.94853,4829.66,5129,1622,9,332,332,216,332,223
60925,221,14452,39466,21459,9.84994e+12,60.0271,18377,60925,7028,72,46473,46415,12135,760,1393
87839,13580,21321,56794,31045,9.78233e+12,59.9762,26640.2,87839,10387,72,66518,66518,58544,47682,45122
42190,6957,9790,27365,14825,9.93089e+12,60.095,12698.3,42190,4769,72,32400,32400,28201,28127,23178
86104,8512,19995,55834,30270,9.91024e+12,60.1334,25289.2,86104,9732,72,66109,66109,49410,49072,28878
57610,6326,13438,37354,20256,9.90412e+12,60.0932,17200,57610,6540,72,44172,44172,35011,33326,21221
52052,7176,12105,33756,18296,9.91457e+12,60.1043,15565.2,52052,5891,72,39947,39947,34090,26126,24277
97208,4509,28213,62041,35167,9.16367e+12,56.9582,33707.1,97208,13732,72,68995,68995,24940,23598,0
18727,882,7710,11560,7167,7.63983e+12,55.8762,8939.02,18727,3746,72,11017,10970,5019,1709,1483
90367,5730,21028,58591,31776,9.90758e+12,60.1335,26541.3,90367,10239,72,69339,69339,47048,46597,19606
35093,7952,14771,21595,13498,7.52245e+12,57.062,16757.5,35093,7196,72,20322,20322,16301,11611,11637
34313,696,9147,22053,12260,9.48082e+12,59.5053,11512.6,34313,4450,72,25166,25070,10577,5370,2674
67480,10518,17246,43485,23995,9.61652e+12,59.7619,21438.5,67480,8400,72,50234,50234,42550,35252,33258
52199,3879,18553,32728,19471,8.3206e+12,58.1193,21553.9,52199,9020,72,33646,33598,24107,12882,12471
89733,14312,23660,57696,32037,9.50942e+12,59.638,28949.3,89733,11520,72,66073,66073,56490,54222,40348
12473,3176,7053,7373,5100,5.64447e+12,53.1869,7773.29,12473,3415,72,5420,5420,4070,2798,2668
25606,1448,7358,16369,9237,9.21275e+12,59.0897,9184.79,25606,3571,72,18248,18248,9376,9752,4168
12336,985,12336,0,12336,7.99935,0,12336,12336,12336,1,0,0,0,0,0
54208,11042,18616,34093,20115,8.4834e+12,58.3487,21760.1,54208,9064,72,35592,35592,29890,28532,20364
92112,20107,30272,58163,33949,8.67209e+12,58.6143,35272.4,92112,14742,72,61840,61840,53717,44241,43905
30206,11358,13245,18497,11709,7.27386e+12,56.7354,14967.5,30206,6443,72,16961,16961,14518,11612,11724
81438,7030,32741,50382,31056,7.72094e+12,57.4063,36824.6,81438,15929,72,48697,48697,31619,16093,11755
99652,20169,38988,61825,37827,7.86219e+12,57.6146,43904.9,99652,18983,72,60664,60664,49107,33311,29554
77676,5485,33259,47683,29993,7.38947e+12,56.5039,37038.7,77676,16197,72,44417,44417,20382,9886,5284
10135,2898,4507,6200,3935,7.22632e+12,54.8788,5250.6,10135,2178,72,5628,5628,4380,3263,3038
16127,4304,4502,10342,5785,9.32928e+12,58.9849,5785.79,16127,2172,72,11625,11625,11423,11281,11310
56735,1573,13189,36800,19935,9.90684e+12,60.0971,16906.8,56735,6414,72,43546,43546,26547,26208,5687
94425,497,36350,58697,35728,7.94269e+12,57.7153,41088.3,94425,17704,72,58075,56872,25437,2437,2500
25929,2736,6111,16810,9119,9.8754e+12,59.9145,8062.74,25929,2964,72,19818,19818,14956,10716,9112
2145,188,1396,1670,475,2.2853e+13,5.41538,1616.1,2145,476,13,749,749,494,431,187
38227,2845,13795,23918,14309,8.27238e+12,58.0451,16104.7,38227,6720,72,24432,24432,14325,7386,5241
59631,1468,3659,47450,12181,5.7398e+13,12.002,4461.44,59631,2083,20,55972,55972,41591,30956,49467
71580,6823,24173,45079,26501,8.55809e+12,58.4589,28163.7,71580,11774,72,47407,47407,28841,18361,14383
7609,881,1786,4938,2671,1.00714e+13,59.4961,2541.84,7609,869,72,5823,5823,4712,4460,3022
34278,4241,8009,22236,12042,9.90462e+12,60.0217,10459.1,34278,3893,72,26269,26269,21755,20699,14229
6973,1186,1715,4522,2451,9.77111e+12,59.2246,2419.67,6973,829,72,5258,5258,4620,4475,3715
3057,512,767,1984,1073,9.8443e+12,58.1207,1149.16,3057,362,61,2290,2290,1958,1635,1718
81311,20988,21321,52302,29009,9.53081e+12,59.6563,26190,81311,10383,72,59990,59990,59516,59043,59129
56349,20584,30456,44165,12184,79751300000,8.99088,30923.7,56349,27403,11,25893,25893,19317,19864,18790
41092,10728,19360,24919,16173,6.83911e+12,55.3828,21464.8,41092,9425,72,21732,21732,18477,13980,13130
62810,5946,29728,38061,24749,6.80638e+12,55.9416,32688.5,62810,14477,72,33082,33082,22456,10128,9667
80086,24213,40366,62586,17500,7.8877e+10,8.99208,40951.6,80086,36322,11,39720,39720,27488,28873,26117
2975,301,748,1927,1048,9.73598e+12,57.9506,1125.1,2975,347,61,2227,2227,1549,1096,1015
17178,4305,4676,11032,6146,9.41954e+12,59.2433,6033.29,17178,2272,72,12502,12502,11963,11423,11484
80259,18359,28731,50274,29985,8.29232e+12,58.1223,33010.7,80259,13985,72,51528,51528,42204,41914,30878
59055,2848,13711,38302,20753,9.92134e+12,60.1074,17554.2,59055,6673,72,45344,45344,29534,20143,10133
64200,11515,14886,41643,22557,9.92647e+12,60.1257,19008.3,64200,7251,72,49314,49314,44434,44331,38577
29701,5388,14525,17924,11777,6.59519e+12,55.4839,16105.9,29701,7057,72,15176,15176,10933,6608,5646
64659,5245,34139,38566,26093,6.10252e+12,55.422,36906.6,64659,16626,72,30520,30520,17066,7875,4786
5539,1529,3440,3228,2311,4.92143e+12,45.4645,3801.29,5539,1654,61,2099,2099,1580,840,902
84121,12979,19551,54559,29562,9.91271e+12,60.1318,24738.2,84121,9519,72,64570,64570,56697,45959,43434
43835,9878,15388,27509,16326,8.39263e+12,58.1465,18003,43835,7491,72,28447,28447,23676,18050,18042
59447,466,17645,37877,21570,9.08237e+12,59.0962,21239.4,59447,8590,72,41802,41562,15884,13110,2196
72903,27624,32742,44478,28425,7.12558e+12,56.3143,36214.8,72903,15945,72,40161,40161,36621,33265,32519
27318,3122,7913,17438,9880,9.19113e+12,59.11,9833.14,27318,3851,72,19405,19405,15223,14425,8807
9139,2021,2142,5936,3203,1.00011e+13,59.6351,3010.97,9139,1042,72,6997,6997,6832,6737,6769
98275,19307,32732,61978,36297,8.61352e+12,58.2245,37988.7,98275,15940,72,65543,65543,53268,52896,38313
81081,16625,18864,52579,28502,9.90807e+12,60.1225,23887.9,81081,9178,72,62217,62217,59593,56071,55290
83665,27706,28450,52665,31000,8.52139e+12,58.4221,32988.4,83665,13855,72,55215,55215,55125,55031,55150
32444,12099,16787,25382,7062,79211500000,8.99202,17150.8,32444,15100,11,15657,15657,12339,12664,12032
13376,6792,6956,8002,5374,6.23941e+12,54.8812,7776.13,13376,3376,72,6420,6420,6357,6306,6385
88137,10923,20464,57158,30979,9.91991e+12,60.137,25860.5,88137,9966,72,67673,67673,53723,40321,36631
94647,26187,40003,58192,36455,7.46501e+12,57.1182,44497.5,94647,19488,72,54644,54644,45617,35009,34786
50456,8107,15939,31981,18475,8.84414e+12,58.573,19002.7,50456,7748,72,34517,34517,29294,22091,20585
95319,17237,35511,59459,35860,8.10051e+12,57.9094,40370.1,95319,17288,72,59808,59808,51430,40179,37520
30642,6446,7172,19865,10777,9.89416e+12,59.9979,9409.94,30642,3479,72,23470,23470,22433,22412,21332
23988,4164,6424,15404,8584,9.4788e+12,59.0624,8197.52,23988,3124,72,17564,17564,14341,14267,10544
14990,7961,9506,8662,6328,4.77219e+12,53.4478,10234.2,14990,4624,72,5484,5484,5207,4807,4938
56052,12218,13030,36360,19692,9.91605e+12,60.1042,16709,56052,6343,72,43022,43022,41830,41808,40538
4614,256,1177,2982,1632,9.72183e+12,58.5997,1692.16,4614,561,70,3437,3437,1515,1532,777
51403,2575,11961,33333,18070,9.92912e+12,60.0976,15377.6,51403,5827,72,39442,39442,25722,17460,8918
40124,15195,15844,24873,15251,7.8109e+12,57.4683,18143.1,40124,7703,72,24280,24280,23517,22554,22402
95930,24150,30101,60834,35096,8.85967e+12,58.8454,35374.5,95930,14658,72,65829,65829,61427,55356,54130
52867,5989,12306,34283,18584,9.90679e+12,60.0865,15807,52867,5989,72,40561,40561,32986,31226,20282
32846,7618,13092,20341,12505,7.77825e+12,55.979,15042.1,32846,6368,72,19754,19754,16734,12674,11772
50051,6887,20548,30883,19168,7.6226e+12,56.6864,23242,50051,10004,72,29503,29503,18726,12299,10128
54444,1083,18188,34332,20112,8.60309e+12,58.5006,21381.6,54444,8856,72,36256,36256,16223,6633,2694
52743,10254,23933,32151,20592,7.05611e+12,56.5653,26572.6,52743,11646,72,28810,28810,22242,14569,14441
72720,28198,38119,43403,29317,6.1521e+12,55.3288,41188.3,72720,18565,72,34601,34601,31894,28152,27495
68805,685,29588,42224,26581,7.35224e+12,56.7409,32993.3,68805,14400,72,39217,38437,22613,12440,2508
48976,15861,18268,30547,18429,8.10293e+12,56.9912,21053.6,48976,8877,72,30708,30708,28206,25247,25356
71329,37252,41281,41893,29436,5.44433e+12,54.1033,44017.5,71329,20089,72,30048,30048,27998,25603,25736
77933,22472,41238,61027,16906,79460100000,8.99624,41798.3,77933,37107,11,36695,36695,24036,25128,22956
1313,201,373,857,456,9.51783e+12,54.9992,574.571,1313,169,46,940,940,726,548,605
52641,3931,23340,32187,20454,7.18313e+12,56.7341,26018.3,52641,11357,72,29301,29301,17081,9093,6356
75175,2467,17436,48751,26424,9.92351e+12,60.1412,22152.5,75175,8491,72,57739,57739,23337,24401,9120
13308,2434,3097,8644,4664,9.98243e+12,59.8161,4256.87,13308,1503,72,10211,10211,9419,8410,8250
89851,20841,26664,57246,32605,9.08302e+12,59.1114,31752.2,89851,12987,72,63187,63187,57312,57160,50239
60729,7340,28967,36765,23964,6.75921e+12,56.2194,31826.2,60729,14107,72,31762,31762,20825,10995,7723
38852,28427,38852,0,38852,7.99979,0,38852,38852,38852,1,0,0,0,0,0
62910,9022,14642,40795,22115,9.90897e+12,60.1145,18695.8,62910,7127,72,48268,48268,40152,39978,30290
41290,4014,9598,26790,14500,9.92058e+12,60.0706,12452.6,41290,4673,72,31692,31692,23515,23357,13572
66760,24836,37769,52430,14330,80364100000,8.98084,38258,66760,33985,11,28991,28991,21376,21760,21003
72324,3795,34092,43848,28476,6.82947e+12,55.8256,37429.4,72324,16586,72,38232,38232,23879,7117,6620
44132,18902,18952,27083,17049,7.37153e+12,56.4342,21321.1,44132,9218,72,25180,25180,25147,25153,25146
63566,25779,29605,38610,24956,6.91292e+12,55.7425,32626.4,63566,14406,72,33961,33961,32770,31111,30949
43039,354,10050,27900,15139,9.91308e+12,60.0654,12998.8,43039,4896,72,32989,32989,18932,18640,1709
90836,15080,23583,58469,32367,9.55962e+12,59.6976,28952.1,90836,11479,72,67253,67253,57356,43816,40616
41109,5537,9619,26653,14456,9.90215e+12,60.0398,12458.4,41109,4679,72,31490,31490,26567,25423,18374
80292,595,4493,63811,16481,5.77102e+13,11.9974,5420.46,80292,3304,14,75799,75799,47667,26412,63184
76664,16025,29561,47650,29014,7.93141e+12,57.6922,33531.1,76664,14395,72,47103,47103,37075,36694,24986
62263,12004,19112,39567,22696,8.95428e+12,58.9292,22800,62263,9306,72,43151,43151,38256,37015,30088
43403,11538,20151,26379,17024,6.91992e+12,56.3599,22369.7,43403,9802,72,23252,23252,18225,13493,12243
73863,1837,33722,44981,28882,7.014e+12,56.5509,37194,73863,16415,72,40141,40141,23339,10346,3044
18711,2236,4378,12135,6576,9.92189e+12,59.9321,5890.84,18711,2128,72,14333,14333,11166,11109,7429
94779,10043,34889,59190,35589,8.15858e+12,57.9884,39756.5,94779,16988,72,59890,59890,38630,13532,12675
44559,3054,10401,28897,15662,9.90008e+12,60.0688,13439.6,44559,5061,72,34158,34158,19855,11846,10425
11806,108,2813,7647,4159,9.88242e+12,59.6752,3866.76,11806,1365,72,8993,8945,5107,5021,475
30531,987,9406,19407,11124,8.9445e+12,58.7013,11460.8,30531,4561,72,21125,21029,12659,5234,2388
64508,2863,15021,41826,22682,9.90127e+12,60.0977,19160.4,64508,7303,72,49487,49487,31896,31527,10283
8748,545,2679,5563,3185,9.08518e+12,58.4606,3458.76,8748,1305,72,6069,6021,3265,1853,1665
34158,6555,9690,21841,12317,9.27432e+12,58.8395,12002.9,34158,4714,72,24468,24468,20676,16293,16183
6791,953,1612,4413,2378,9.9484e+12,59.3977,2307.43,6791,780,72,5179,5179,4226,4208,3225
66081,15670,22046,41671,24410,8.60873e+12,58.5195,25799.7,66081,10735,72,44035,44035,39299,33820,33664
71679,13537,22811,45387,26292,8.81156e+12,58.7663,26904.5,71679,11109,72,48868,48868,42695,41120,32361
89887,3196,29825,56708,33179,8.64031e+12,58.5592,34696.7,89887,14529,72,60062,60062,36030,13016,6631
76310,6676,26607,47917,28393,8.41449e+12,58.2869,30761.5,76310,12957,72,49703,49703,31541,10105,9398
59982,937,2532,47480,12502,5.85583e+13,12.0021,3345.03,59982,2053,19,57450,57450,43311,30774,49203
80266,8466,18664,52050,28216,9.90956e+12,60.1346,23650.2,80266,9084,72,61602,61602,47624,45495,28655
21421,2477,5019,13898,7523,9.90602e+12,59.8723,6697.57,21421,2432,72,16402,16402,12774,12694,8449
40380,1754,14358,25307,15073,8.33055e+12,58.1129,16788.4,40380,6989,72,26022,26022,16274,5593,4496
82606,10831,33439,51052,31554,7.69073e+12,57.3929,37553.3,82606,16283,72,49167,49167,32994,21168,17334
38646,9131,14952,24014,14632,7.93295e+12,57.61,17204.6,38646,7279,72,23694,23694,18876,13148,13137
20622,227,4826,13378,7244,9.91113e+12,59.9064,6456.17,20622,2344,72,15796,15796,4465,5016,961
48954,2012,13212,31427,17527,9.44591e+12,59.4895,16361,48954,6433,72,35742,35742,16125,15028,4998
29023,6108,6796,18814,10209,9.91764e+12,59.9952,8934.75,29023,3305,72,22227,22227,21216,20303,20171
57504,9245,16056,36812,20692,9.32004e+12,59.3658,19618.4,57504,7822,72,41448,41448,35090,26450,24443
17120,3115,4502,11018,6102,9.55071e+12,59.2655,5870.28,17120,2188,72,12618,12618,11197,9628,9642
22988,9016,9504,14184,8804,7.58249e+12,57.0619,10944,22988,4617,72,13484,13484,13106,12548,12658
42248,19242,20310,25556,16692,6.71911e+12,55.7155,22427,42248,9876,72,21938,21938,21790,21716,21739
10959,2291,2566,7115,3844,9.9724e+12,59.6859,3563.95,10959,1244,72,8393,8393,7997,7989,7708
75015,23481,29222,46575,28440,7.88252e+12,57.328,33099.8,75015,14215,72,45793,45793,41962,36806,35631
53107,13114,16623,33682,19425,8.88374e+12,58.821,19829.6,53107,8091,72,36484,36484,33373,29194,28268
73535,13923,17074,47693,25842,9.92101e+12,60.1248,21697.7,73535,8313,72,56461,56461,52683,47592,46451
47670,554,11121,30907,16763,9.89718e+12,60.0605,14334.3,47670,5402,72,36549,36549,10758,11957,2392
46375,3120,16720,29032,17343,8.26365e+12,58.0431,19423.5,46375,8139,72,29655,29655,15813,8124,5346
93883,14758,33422,58823,35060,8.3181e+12,58.1802,38326.7,93883,16277,72,60461,60461,48924,35123,31661
16558,3470,3904,10740,5818,9.87527e+12,59.8164,5276.46,16558,1889,72,12654,12654,12046,12033,11469
1840,544,570,1180,660,9.25717e+12,56.1283,820.641,1840,271,55,1270,1270,1243,1244,1243
4333,771,1096,2803,1530,9.82641e+12,58.8574,1589.42,4333,533,70,3237,3237,2853,2764,2387
48663,2209,23895,29337,19326,6.58011e+12,54.4451,26233.5,48663,11618,72,24768,24768,12686,4094,2730
25823,4709,7827,16437,9386,9.01435e+12,58.8275,9633.01,25823,3801,72,17996,17996,15312,11578,10920
36185,5070,9132,23336,12849,9.665e+12,59.6681,11641.7,36185,4440,72,27053,27053,22802,17039,15715
94546,12441,46353,56994,37552,6.58737e+12,55.7212,50399.7,94546,22577,72,48193,48193,32061,13207,12621
65358,3470,3757,51954,13404,5.76365e+13,12.0019,4599.06,65358,1807,20,61601,61601,59519,57868,60647
67193,19808,25547,41818,25375,8.01e+12,57.7265,29128.8,67193,12439,72,41646,41646,37377,31602,30286
92038,40419,49138,72099,19939,7.9605e+10,8.9975,49743.7,92038,44221,11,42900,42900,37142,37607,36697
94761,10944,28238,60361,34400,9.0648e+12,58.8461,33560.9,94761,13736,72,66523,66523,46610,47167,25986
96035,30979,34943,60053,35982,8.21153e+12,58.0507,39891.7,96035,17016,72,61092,61092,58733,56063,56029
66168,15517,31348,40096,26072,6.79568e+12,56.2848,34435,66168,15266,72,34820,34820,26692,17184,16990
39672,9014,11353,25352,14320,9.23038e+12,59.2327,13959,39672,5529,72,28319,28319,26187,26134,23746
54482,1108,19356,34161,20321,8.33135e+12,58.0793,22463.9,54482,9410,72,35126,34997,20759,9657,3269
78483,15199,18198,50900,27583,9.91764e+12,60.1425,23092.9,78483,8856,72,60285,60285,55862,55784,50545
98138,9326,53129,76923,21215,79764900000,8.99751,53748.2,98138,47810,11,45009,45009,17363,19279,15464
63023,15993,16875,40480,22543,9.45882e+12,59.5482,20776.3,63023,8216,72,46148,46148,45746,45719,45500
55301,42175,51681,38085,17216,9.20451e+12,3.99306,51797.4,55301,17248,9,3620,3620,2955,3620,2962
17436,345,4086,11303,6133,9.96317e+12,59.8895,5511.91,17436,1990,72,13350,13350,4409,4771,1368
22091,3287,5877,14198,7893,9.50898e+12,59.4178,7541.01,22091,2856,72,16214,16214,13261,9857,9789
63436,3238,4124,50540,12896,5.716e+13,11.9966,4943.06,63436,2588,14,59312,59312,53523,49559,56704
6952,518,1706,4498,2454,9.80041e+12,59.2773,2411.21,6952,819,72,5246,5246,3635,3588,1830
15997,2153,5881,9998,5999,8.19827e+12,56.554,7037.38,15997,2857,72,10116,10116,7053,4712,4029
1841,59,542,1188,653,9.55903e+12,55.9527,795.193,1841,260,52,1227,582,703,703,181
27999,5860,9815,17583,10416,8.39485e+12,58.1426,11639.3,27999,4776,72,18184,18184,14747,10781,10701
27320,6313,15896,16035,11285,5.42387e+12,53.837,17164.3,27320,7738,72,11424,11424,8798,5959,5434
7081,465,1665,4588,2493,9.98192e+12,59.5211,2384.08,7081,811,72,5416,5416,3654,2535,1669
50096,7078,11608,32497,17599,9.92774e+12,60.0996,14960,50096,5648,72,38488,38488,33020,25600,23885
20722,6644,9529,12618,8104,6.98673e+12,54.7612,10777.6,20722,4619,72,11193,11193,9714,7659,7401
77626,30649,36886,47015,30611,6.78717e+12,56.2721,40398.9,77626,17965,72,40740,40740,37305,33378,33319
2493,286,645,1621,872,9.56938e+12,57.4308,974.126,2493,300,58,1848,1848,1373,1295,910
26487,3214,6220,17171,9316,9.90274e+12,59.9616,8207.33,26487,3024,72,20267,20267,16672,15830,10739
18120,544,4402,11728,6392,9.83789e+12,59.7571,5858.56,18120,2143,72,13718,13718,4771,5046,1351
9754,1324,3906,6051,3703,7.85708e+12,54.3794,4666.8,9754,1886,72,5848,5848,4390,2673,2836
56580,3707,17577,35914,20666,8.91039e+12,58.8605,20964.2,56580,8559,72,39003,39003,25441,25094,8873
49002,14105,20709,30129,18873,7.47289e+12,57.0104,23310.9,49002,10082,72,28293,28293,24217,19445,19473
29161,269,6847,18911,10250,9.89052e+12,59.9656,8994.13,29161,3323,72,22314,22314,12795,8227,1187
20525,2333,5254,13235,7290,9.62604e+12,59.5675,6842.37,20525,2554,72,15271,15271,11439,11337,6944
14826,3222,4998,9344,5482,8.61581e+12,58.217,6126.61,14826,2430,72,9828,9828,7778,5016,4503
71335,14059,19371,45763,25572,9.40729e+12,59.4944,23682,71335,9428,72,51964,51964,46661,39441,37780
53510,17354,19840,33391,20119,8.14563e+12,57.9071,22837,53510,9665,72,33670,33670,32588,32289,30969
69069,518,16058,44792,24277,9.92131e+12,60.1183,20440.5,69069,7818,72,53011,53011,30358,19519,2473
94513,7784,21906,61292,33221,9.92498e+12,60.1527,27639.5,94513,10672,72,72607,72607,47696,30602,26751
75703,10139,17555,49100,26603,9.92183e+12,60.1438,22299.6,75703,8552,72,58148,58148,49223,47142,34183
22027,734,5137,14284,7743,9.96138e+12,59.9465,6850.57,22027,2502,72,16890,16890,10469,7005,2707
30390,9936,11430,18940,11450,8.07056e+12,57.2934,13317.6,30390,5546,72,18960,18960,18721,18485,18490
8677,1947,2367,5572,3105,9.55172e+12,59.0152,3169.02,8677,1153,72,6310,6310,5803,5201,5150
56845,7794,19163,35812,21033,8.56927e+12,58.4421,22457.3,56845,9329,72,37682,37682,27442,17555,14820
69052,5757,20146,44057,24995,9.15095e+12,59.175,24241.3,69052,9809,72,48906,48906,33330,14913,14348
47049,3055,17421,29370,17679,8.13323e+12,57.8776,20120.4,47049,8477,72,29628,29628,19411,7373,7086
19620,1215,9233,11907,7713,6.85813e+12,55.8673,10412.7,19620,4475,72,10387,10321,6861,3413,2519
69825,16097,16226,45290,24535,9.91555e+12,60.1203,20651.6,69825,7901,72,53599,53599,53455,53422,53351
23760,189,6503,15242,8518,9.39074e+12,59.3281,8254.16,23760,3156,72,17257,17161,5243,5307,882
88273,6927,43230,68907,19366,78587600000,8.99828,43854.7,88273,38905,11,45043,45043,16219,19775,12677
97468,1985,39300,60261,37207,7.7064e+12,57.4252,44044.8,97468,19135,72,58168,58168,29735,3076,2356
80334,4096,18676,52094,28240,9.92223e+12,60.1289,23658.2,80334,9098,72,61658,61658,40435,27597,14333
22039,1940,5207,14284,7755,9.89202e+12,59.898,6920.51,22039,2530,72,16832,16832,11395,10964,6442
78229,9214,18209,50731,27498,9.90999e+12,60.1202,23081.7,78229,8866,72,60020,60020,49146,34303,30779
69515,2134,16147,45076,24439,9.92295e+12,60.1287,20556.6,69515,7860,72,53368,53368,20863,21873,7653
85693,12512,21861,55226,30467,9.61986e+12,59.7738,26997.7,85693,10642,72,63832,63832,54577,52322,38969
36015,2432,8392,23352,12663,9.91555e+12,60.0462,10942.4,36015,4082,72,27623,27623,16027,9623,8522
11714,1800,3018,7561,4153,9.59698e+12,58.66,4046.83,11714,1447,72,8696,8696,7512,5989,5685
72712,15034,25654,45609,27103,8.36238e+12,57.9977,29621,72712,12481,72,47058,47058,39652,30929,30786
11695,1590,3569,7443,4252,9.02943e+12,58.6022,4544.69,11695,1731,72,8126,8126,5855,3164,3285
75497,16146,22446,48103,27394,9.07108e+12,59.0113,26835.9,75497,10913,72,53051,53051,46087,37909,37673
84708,2104,33863,52437,32271,7.75457e+12,57.4786,38096.1,84708,16493,72,50845,50845,29264,11747,2982
46279,42402,46279,0,46279,7.99983,0,46279,46279,46279,1,0,0,0,0,0
92042,8682,50598,54534,37508,5.81069e+12,55.0912,54164.7,92042,24635,72,41444,41444,24484,13036,9168
67630,9731,15719,43852,23778,9.91423e+12,60.1198,20026.3,67630,7652,72,51911,51911,44646,34762,32446
80439,2357,3363,63681,16758,5.85736e+13,11.9977,4298.35,80439,3360,13,77076,77076,68045,60049,73057
30298,652,13857,18450,11848,7.02694e+12,56.3454,15541.4,30298,6734,72,16441,16393,6696,2815,2456
41974,9635,9816,27211,14763,9.90108e+12,60.0354,12704,41974,4773,72,32158,32158,31970,31798,31799
29706,6634,11805,18403,11303,7.79777e+12,57.3846,13603.9,29706,5740,72,17901,17901,14446,10387,10448
41982,2502,11535,26918,15064,9.38509e+12,59.398,14295.1,41982,5615,72,30447,30447,19444,19188,6029
85768,16938,46313,50970,34798,5.93946e+12,55.0876,49736.9,85768,22541,72,39455,39455,28797,18795,16040
36146,4707,12697,22686,13460,8.38746e+12,57.6056,14934.5,36146,6177,72,23449,23449,16315,10139,8362
99897,9155,29169,63726,36171,9.13871e+12,59.1953,34780.6,99897,14196,72,70728,70728,49655,33318,23761
65706,14438,26118,40692,25014,7.7937e+12,57.4939,29545.1,65706,12724,72,39588,39588,32336,23911,23639
79333,14598,18470,51444,27889,9.89743e+12,60.1106,23402.2,79333,8983,72,60863,60863,56228,55143,48483
30823,6794,9005,19675,11148,9.17259e+12,58.4489,11112,30823,4370,72,21818,21818,19920,17766,17766
92246,9682,26975,58843,33403,9.13961e+12,59.1799,32208.2,92246,13131,72,65271,65271,42731,27206,21942
50585,12229,13865,32436,18149,9.37173e+12,59.4153,17088.6,50585,6747,72,36720,36720,34435,31813,31794
78272,13233,32251,48274,29998,7.59434e+12,57.1515,36146.9,78272,15704,72,46021,46021,32796,17191,16748
64339,9671,19882,40856,23483,8.93441e+12,58.8945,23659.6,64339,9682,72,44457,44457,36325,25326,22745
85141,11672,32366,52997,32144,8.00196e+12,57.788,36737.2,85141,15758,72,52775,52775,32989,18772,14088
86971,18829,30967,54491,32480,8.32302e+12,55.7434,35561.4,86971,15080,72,56004,56004,47672,39734,37699
27199,21662,27199,0,27199,7.99971,0,27199,27199,27199,1,0,0,0,0,0
60700,9495,14140,39355,21345,9.90501e+12,60.1081,18073.2,60700,6880,72,46560,46560,39801,39666,31596
21950,3431,6150,14051,7899,9.31163e+12,59.1899,7780.62,21950,2987,72,15800,15800,13304,9954,9231
84376,8006,43366,50521,33855,6.27795e+12,55.4576,46903.5,84376,21105,72,41010,41010,23419,11369,7428
73800,27686,29324,45705,28095,7.7853e+12,57.5028,33107.8,73800,14276,72,44476,44476,43634,42660,42802
12893,526,6642,7719,5174,6.34064e+12,52.6974,7443.44,12893,3229,72,6251,6011,3159,852,0
56686,1567,16728,36141,20545,9.10418e+12,59.1009,20186,56686,8143,72,39958,39958,17901,4271,3819
78807,11198,23934,50110,28697,8.99084e+12,58.9884,28448.7,78807,11651,72,54873,54873,41858,26521,25963
38204,6421,14915,23712,14492,7.89098e+12,57.5498,17135,38204,7259,72,23289,23241,20564,21629,19937
56728,7720,30307,44440,12288,79628900000,8.99201,30780.4,56728,27271,11,26421,26421,11429,12662,10212
96029,4168,51764,57079,38950,5.95944e+12,55.2717,55530,96029,25215,72,44265,44265,26942,8714,6120
67727,29760,31937,41063,26664,6.84019e+12,56.3204,35089.3,67727,15559,72,35790,35790,34630,33279,33456
66909,14030,22179,42215,24694,8.64217e+12,58.5478,25977.2,66909,10805,72,44730,44730,38142,29060,27107
77035,40537,77035,0,77035,7.9999,0,77035,77035,77035,1,0,0,0,0,0
15144,369,3863,9764,5380,9.67198e+12,59.5427,5118.5,15144,1879,72,11281,11233,3732,2547,1409
28666,525,6711,18591,10075,9.92215e+12,59.994,8827.55,28666,3268,72,21955,21955,7189,7778,2072
24849,5575,6178,16053,8796,9.73284e+12,59.7253,8037.79,24849,3004,72,18671,18671,17919,17888,17184
9298,1704,2749,5935,3363,9.15914e+12,58.6576,3579.33,9298,1332,72,6549,6549,5697,4507,4463
76500,14352,26969,47994,28506,8.3621e+12,58.1772,31109.2,76500,13121,72,49531,49531,39329,27295,27008
80027,13196,18585,51894,28133,9.9178e+12,60.1072,23558.4,80027,9047,72,61442,61442,54918,53404,43970
81669,9185,18981,52957,28712,9.91993e+12,60.1317,24034.1,81669,9247,72,62688,62688,50662,48076,30782
8687,659,4629,5180,3507,6.14322e+12,54.7808,5208.39,8687,2250,72,4058,3910,2047,708,357
7784,924,1893,5044,2740,9.84654e+12,59.3699,2659.34,7784,916,72,5891,5891,4789,4538,3154
65564,11397,15260,42512,23052,9.90635e+12,60.101,19455.6,65564,7426,72,50304,50304,45674,39390,37940
59656,11636,20755,37473,22183,8.42249e+12,57.7282,24140.3,59656,10088,72,38901,38901,32859,24650,22743
45191,10530,17012,28162,17029,8.06548e+12,57.5128,19605.5,45191,8271,72,28179,28179,24540,19515,18537
69167,11516,20268,44117,25050,9.1317e+12,59.1527,24362,69167,9870,72,48899,48899,40447,28926,26210
95594,4609,28185,60936,34658,9.11051e+12,59.141,33564.2,95594,13724,72,67409,67361,44890,18345,16130
54070,11762,12585,35068,19002,9.90696e+12,60.0748,16152.4,54070,6119,72,41485,41485,40509,39245,39008
54051,5089,21432,33497,20554,7.79392e+12,57.4818,24355.7,54051,10429,72,32619,32619,20725,6700,6326
20733,1972,4863,13450,7283,9.8858e+12,59.8605,6498.65,20733,2356,72,15870,15870,11361,10954,6759
97983,3050,22770,63542,34441,9.91396e+12,60.1397,28682.1,97983,11088,72,75213,75213,29577,11827,11006
10231,2790,2904,6553,3678,9.32251e+12,58.8772,3805.85,10231,1408,72,7327,7327,7216,7150,7142
20063,181,4707,13012,7051,9.91147e+12,59.8837,6300.15,20063,2289,72,15356,15346,8767,5625,778
41763,8107,9753,27078,14685,9.9101e+12,60.0701,12632.5,41763,4750,72,32010,32010,29692,29635,27024
11161,182,2666,7240,3921,9.91878e+12,59.6476,3673.6,11161,1294,72,8495,8485,4946,3221,734
13903,3481,7549,10898,3005,79824800000,8.98116,7776.08,13903,6790,11,6354,6354,3702,3907,3514
2583,639,1261,1578,1005,6.81492e+12,39.5343,1519.55,2583,593,59,1322,1322,1322,1322,1322
63742,8898,14847,41335,22407,9.90886e+12,60.0927,18940.9,63742,7226,72,48895,48895,40309,32085,29853
98638,3375,22920,63961,34677,9.91423e+12,60.1455,28865.3,98638,11165,72,75718,75718,47237,46664,12109
36568,807,8529,23719,12849,9.91315e+12,60.0139,11109.6,36568,4145,72,28039,28039,9578,3116,3096
61731,4216,26007,37974,23757,7.4772e+12,56.7447,29162,61731,12661,72,35724,35724,19526,7796,5542
29034,1976,9800,18297,10737,8.56487e+12,57.6728,11708.7,29034,4752,72,19234,19234,12884,8582,5302
31994,5230,7476,20746,11248,9.91503e+12,59.995,9790.32,31994,3633,72,24518,24518,21333,21259,17566
55339,10680,16563,35240,20099,9.04876e+12,59.0431,19938.1,55339,8062,72,38776,38776,34425,28492,27188
93143,16643,35034,58041,35102,8.05804e+12,57.5374,39774.4,93143,17049,72,58109,58109,44231,31043,27354
28595,6936,7485,18407,10188,9.55978e+12,59.5421,9535.93,28595,3643,72,21110,21110,20443,20293,19506
84246,3100,19582,54628,29618,9.90646e+12,60.1271,24777.7,84246,9524,72,64664,64664,40646,40167,11055
70227,16909,18963,45071,25156,9.43432e+12,59.5255,23225,70227,9233,72,51264,51264,49699,47880,48034
26693,2797,10413,16567,10126,7.91195e+12,57.5208,12082.8,26693,5068,72,16280,16280,11195,5328,5154
67360,22358,25512,41953,25407,8.02392e+12,57.793,29106.8,67360,12424,72,41848,41848,39601,36490,35977
1817,53,475,1188,629,9.9202e+12,57.1535,735.727,1817,229,52,1211,453,753,488,204
39255,2973,15147,24397,14858,7.94012e+12,56.548,17435.1,39255,7361,72,24108,24108,12256,7692,5626
73315,2900,22928,46509,26806,8.88215e+12,58.8483,27128.2,73315,11165,72,50387,50387,30206,18872,5546
57826,4296,21165,36134,21692,8.18836e+12,57.9736,24384.3,57826,10302,72,36661,36661,24436,13858,10741
61835,6314,14415,40099,21736,9.90234e+12,60.0888,18405.9,61835,7010,72,47420,47420,35638,25521,21220
5018,205,2055,3109,1909,7.80673e+12,56.2983,2515.17,5018,990,69,2963,2867,1622,866,712
66132,1520,15393,42889,23243,9.90704e+12,60.0936,19617.1,66132,7488,72,50739,50739,17851,19183,5811
37028,315,8643,24016,13012,9.88989e+12,60.015,11252.3,37028,4194,72,28385,28385,16272,16028,1434
1589,248,427,1037,552,1.00038e+13,56.3971,661.586,1589,204,50,1162,1162,908,902,749
40861,8953,14598,25611,15250,8.3089e+12,57.9468,17047.9,40861,7090,72,26263,26263,22066,21911,17141
54165,12307,12592,35120,19045,9.9156e+12,60.0979,16168.1,54165,6128,72,41573,41573,41182,41173,40873
46737,6812,23740,28043,18694,6.36533e+12,55.5365,25938.7,46737,11548,72,22997,22997,14603,9545,7895
58504,3815,20660,36699,21805,8.35545e+12,58.1855,23965.6,58504,10059,72,37844,37844,24188,11421,7811
75643,10659,24177,47894,27749,8.79264e+12,58.7388,28452.2,75643,11775,72,51466,51466,33110,31241,10004
75399,10873,19761,48502,26897,9.53266e+12,59.6524,24327.4,75399,9622,72,55638,55638,44274,44012,30404
14579,5038,7523,11404,3175,79205800000,8.96824,7764.4,14579,6762,11,7056,7056,5271,5452,5109
15444,698,5799,9639,5805,8.06987e+12,57.5358,6911.07,15444,2809,72,9645,9597,4118,1756,765
32202,4579,8072,20792,11410,9.67931e+12,59.7393,10358.6,32202,3926,72,24130,24130,19061,13140,12972
25259,8236,13295,15075,10184,6.1362e+12,52.7193,14610.7,25259,6454,72,11964,11964,10319,8772,8562
8736,55,2107,5653,3083,9.87807e+12,59.4958,2943.05,8736,1021,72,6031,2423,3733,2373,151
88723,21564,32795,55390,33333,8.14274e+12,57.9549,37383.4,88723,15972,72,55928,55928,48874,40679,40435
12067,4150,4728,7492,4575,7.90414e+12,57.3039,5633.69,12067,2300,72,7339,7339,7278,7217,7306
82849,2983,28028,52179,30670,8.54366e+12,58.4467,32538.8,82849,13650,72,54821,54821,24170,11804,5996
2074,336,531,1346,728,9.85576e+12,57.5381,821.938,2074,249,55,1543,1543,1285,1278,1118
88943,3649,27756,56428,32515,8.88696e+12,58.8726,32707.4,88943,13521,72,61187,61187,37865,13439,9285
66486,1239,15464,43115,23371,9.91398e+12,60.1135,19708.6,66486,7527,72,51022,51022,16689,18148,4623
11473,1528,2679,7448,4025,9.97089e+12,59.7138,3711.6,11473,1302,72,8794,8794,7098,7065,5195
89815,20858,21360,58158,31657,9.84211e+12,60.0484,26813.4,89815,10400,72,68455,68455,67763,67112,67165
73177,1938,30571,45055,28122,7.51802e+12,57.1781,34222.4,73177,14879,72,42606,42510,24168,8853,1746
48979,21009,22548,29798,19181,6.97807e+12,56.3907,25008.8,48979,10967,72,26431,26431,25996,25489,25445
95526,21309,44208,58063,37463,6.9359e+12,56.4675,48477.2,95526,21515,72,51318,51318,41942,30998,30756
48598,8687,11324,31519,17079,9.91821e+12,60.0786,14586.6,48598,5512,72,37274,37274,34152,29946,29005
41674,2868,11004,26802,14872,9.5225e+12,57.9147,13781.8,41674,5344,72,30670,30670,20848,9270,8843
59122,7292,26962,36007,23115,7.02934e+12,55.9358,29855.2,59122,13116,72,32160,32160,20891,14376,12118
57495,6137,13415,37276,20219,9.90176e+12,60.0802,17170.6,57495,6521,72,44080,44080,34258,32679,20619
10170,158,2439,6590,3580,9.88101e+12,59.5687,3378.14,10170,1180,72,7731,7709,4492,2904,664
31337,5822,13044,19311,12026,7.55492e+12,57.1111,14875.5,31337,6348,72,18293,18293,14643,10072,9011
40165,8418,9334,26050,14115,9.92282e+12,60.074,12126.5,40165,4540,72,30831,30831,29712,29459,27999
72375,35419,36905,43390,28985,6.33051e+12,55.5217,40040.9,72375,17957,72,35470,35470,35053,34656,34743
62846,5167,16922,40353,22493,9.44479e+12,59.5242,20805.2,62846,8241,72,45924,45924,25990,16417,12520
29369,6382,8061,18835,10534,9.38537e+12,59.3344,10127.3,29369,3924,72,21308,21308,19011,16385,16350
73325,1205,4705,58394,14931,5.72334e+13,12.0018,5594.01,73325,2599,20,68620,68620,46340,30146,55069
45004,19336,21742,27201,17803,6.68611e+12,56.0127,23961,45004,10574,72,23262,23262,22032,20683,20719
50115,10742,11660,32500,17615,9.92374e+12,60.0938,15008.2,50115,5680,72,38455,38455,37101,37076,35612
72376,21174,22104,46004,26372,8.98157e+12,58.9687,26293.2,72376,10767,72,50272,50272,49696,49045,49254
51477,2547,11975,33388,18089,9.92585e+12,60.0959,15398.2,51477,5833,72,39502,39502,25831,25548,9076
32181,2297,11142,20230,11951,8.45944e+12,58.2226,13187.7,32181,5424,72,21039,21039,11333,5141,3156
13764,902,907,10967,2797,5.71317e+13,11.9857,1282.07,13764,568,14,12857,12857,12838,12836,12843
78446,18519,23103,50016,28430,9.1171e+12,58.5746,27650.6,78446,11238,72,55343,55343,51333,51228,46611
7648,961,2378,4860,2788,8.96424e+12,58.2015,3084.22,7648,1144,72,5270,5270,4071,3441,3272
65978,15370,21665,41670,24308,8.67382e+12,58.6004,25438.9,65978,10548,72,44313,44313,38028,30685,30460
10009,1142,4116,6183,3826,7.65765e+12,56.5123,4885.4,10009,1996,72,5893,5893,4253,2336,2490
25834,5543,6072,16743,9091,9.88949e+12,59.9397,8019.16,25834,2949,72,19762,19762,19133,19103,18545
5981,1563,1766,3825,2156,9.1142e+12,58.259,2365.02,5981,846,72,4215,4215,3979,3692,3879
46822,10383,16156,29443,17379,8.47557e+12,58.3037,18933.7,46822,7868,72,30666,30666,27075,22115,21153
60914,28881,32479,47714,13200,79560200000,8.9968,32970.6,60914,29222,11,28435,28435,25572,25928,25235
53682,797,17172,33985,19697,8.78857e+12,58.5481,20383.4,53682,8348,72,36510,36318,21523,21040,3229
73941,10043,25155,46542,27399,8.52283e+12,57.9742,29246,73941,12238,72,48786,48786,36655,36274,21887
93228,6908,27639,59395,33833,9.08595e+12,59.1223,32897.1,93228,13460,72,65589,65541,47339,41689,23538
22802,2905,5390,14787,8015,9.86014e+12,59.8978,7152.38,22802,2617,72,17412,17412,13856,13778,9629
97209,2056,6050,77380,19829,5.73399e+13,12.0015,7075.4,97209,3414,20,91159,91159,64715,46390,79237
63952,1368,23471,39958,23994,8.18509e+12,57.9758,26965.4,63952,11430,72,40481,40385,23522,10676,2921
43555,5924,10106,28247,15308,9.93249e+12,60.0928,13091.2,43555,4917,72,33449,33449,27352,27230,19988
57461,9900,19372,36205,21256,8.56632e+12,58.4375,22693.7,57461,9432,72,38089,38089,24235,7867,7269
14166,1783,5112,8871,5295,8.29601e+12,57.6021,6173.72,14166,2483,72,9054,9054,6777,4611,4175
21641,3999,10726,13036,8605,6.53251e+12,54.8903,11951.4,21641,5203,72,10915,10915,8177,5472,4783
19167,2034,7749,11857,7310,7.73102e+12,56.854,9012.16,19167,3766,72,11418,11418,6304,3085,2000
2692,60,1247,1643,1049,7.17176e+12,54.4703,1522.81,2692,594,54,1375,652,838,549,178
3632,2423,2491,2073,1559,4.22078e+12,41.739,2725.7,3632,1204,59,1141,1141,1078,1075,1054
34665,5456,10857,21984,12681,8.89305e+12,58.2746,13119.3,34665,5282,72,23808,23808,19408,13344,12121
56091,1269,13024,36371,19720,9.92923e+12,60.1174,16705.3,56091,6340,72,43067,43067,25932,25587,4882
54789,9200,54789,0,54789,7.99985,0,54789,54789,54789,1,0,0,0,0,0
81685,3596,18986,52962,28723,9.91285e+12,60.1365,24045.6,81685,9247,72,62699,62699,40289,39838,12706
50029,17217,18397,31250,18779,8.17072e+12,57.6452,21251.1,50029,8939,72,31632,31632,30681,29352,29270
9676,588,4248,5939,3737,7.3051e+12,56.0472,4968.72,9676,2049,72,5428,5284,3381,983,1116
9799,1978,4671,5942,3857,6.89389e+12,55.8268,5358.43,9799,2274,72,5128,5128,3725,1852,1640
19230,469,4511,12472,6758,9.91988e+12,59.8827,6051.16,19230,2191,72,14719,14719,5183,5530,1742
69721,23549,30377,42713,27008,7.30416e+12,56.8977,33787.9,69721,14799,72,39344,39344,36190,31840,31031
45757,1078,2770,36399,9358,5.74626e+13,12.0033,3472.63,45757,1331,20,42987,42987,31031,22256,37593
7920,1780,1860,5138,2782,1.00348e+13,59.5345,2638.65,7920,906,72,6060,6060,5975,5952,5945
21905,1323,5180,14202,7703,9.87496e+12,59.8836,6885.51,21905,2517,72,16725,16725,11118,7585,4361
67795,7199,23058,42678,25117,8.51683e+12,58.4014,26860.6,67795,11219,72,44737,44737,30920,14623,14150
23901,6369,8269,15026,8875,8.4799e+12,58.2001,9886.37,23901,4028,72,15632,15632,12931,9835,9779
71459,29653,38156,55979,15480,7.96e+10,8.97919,38688.7,71459,34332,11,33303,33303,28109,28424,27813
56152,10166,17484,35644,20508,8.89251e+12,58.8456,20850.8,56152,8509,72,38668,38668,33334,26090,24410
27540,8204,11880,16897,10643,7.35959e+12,55.7711,13502.8,27540,5765,72,15660,15660,13096,10160,10127
2691,136,679,1752,939,9.91575e+12,58.0178,1027.64,2691,324,59,2012,2012,1236,1221,457
96159,16588,25127,61861,34298,9.53672e+12,59.6778,30757.1,96159,12235,72,71032,71032,62277,60149,47512
24500,2553,6664,15732,8768,9.41983e+12,59.2277,8458.81,24500,3227,72,17836,17836,12129,8750,7566
11030,210,4083,6893,4137,8.18428e+12,57.4648,4947.68,11030,1980,72,6947,6851,2849,1476,803
98595,16242,30837,62540,36055,8.87069e+12,58.8544,36241.9,98595,15011,72,67758,67758,58087,46693,46281
93239,6759,35986,57937,35302,7.928e+12,57.7027,40670.4,93239,17524,72,57253,57253,36845,12803,11991
14735,2724,5947,9116,5619,7.74447e+12,56.8876,6984.66,14735,2890,72,8788,8788,6691,4688,4354
92100,18618,21426,59718,32382,9.91074e+12,60.1352,27029.6,92100,10432,72,70674,70674,66623,62794,61810
39286,1793,9153,25485,13801,9.90662e+12,60.0207,11891.2,39286,4446,72,30133,30133,19452,13201,6394
75576,4801,36329,45689,29887,6.71585e+12,56.0767,39736.5,75576,17691,72,39247,39247,21322,11943,8212
52502,202,12203,34046,18456,9.92673e+12,60.1041,15684.6,52502,5945,72,40299,40299,22801,22449,1305
8038,48,3945,6274,1764,78592800000,8.9689,4127.2,8038,3543,11,4093,4089,1008,1387,641
59204,13554,14885,38192,21012,9.6663e+12,59.8089,18658.6,59204,7241,72,44319,44319,42385,40174,40155
88206,16074,23876,56598,31608,9.42295e+12,59.5298,29046.2,88206,11625,72,64330,64330,55042,54820,43762
68558,7008,27777,42361,26197,7.68495e+12,57.0371,31296.2,68558,13523,72,40781,40781,24483,13519,9778
31836,2169,7444,20649,11187,9.89751e+12,60.0082,9751.56,31836,3619,72,24392,24392,16679,16529,7301
57345,3189,17434,36458,20887,8.99935e+12,58.9778,20890,57345,8489,72,39911,39911,25935,9533,8896
79215,5042,18358,51373,27842,9.92978e+12,60.1422,23285.3,79215,8943,72,60857,60857,41401,41015,17473
96444,2157,27078,61718,34726,9.28919e+12,59.0857,32595.3,96444,13174,72,69366,69366,41210,19037,6559
65698,9954,25609,40782,24916,7.88121e+12,57.1771,29080.1,65698,12453,72,40089,40089,29867,17864,17577
75039,16675,26628,47036,28003,8.33014e+12,58.1826,30692.5,75039,12960,72,48411,48411,38548,26972,26551
65331,16705,27922,40116,25215,7.404e+12,57.0278,31196.2,65331,13603,72,37409,37409,31854,24198,22587
69734,18942,36088,54556,15178,79240600000,8.9957,36625.3,69734,32471,11,33646,33646,21342,22586,20114
88683,18958,20633,57501,31182,9.91003e+12,60.1431,26061.6,88683,10051,72,68050,68050,65688,65631,62967
2823,444,698,1825,998,1.00548e+13,58.3893,1061.48,2823,336,61,2125,2125,1827,1526,1515
49601,5983,19649,30736,18865,7.81756e+12,57.4417,22371,49601,9571,72,29952,29952,19502,20391,9705
81433,13152,18934,52805,28628,9.91388e+12,60.1292,23978,81433,9218,72,62499,62499,54023,53860,43704
93777,1359,5703,74618,19159,5.74271e+13,12.0013,6710.81,93777,3092,20,88074,88074,58268,35487,74658
14041,1203,3264,9114,4927,9.98689e+12,59.7855,4470.96,14041,1585,72,10777,10777,7207,6970,4170
48844,1283,48844,0,48844,7.99984,0,48844,48844,48844,1,0,0,0,0,0
95593,17404,22226,61993,33600,9.91239e+12,60.1366,28013.4,95593,10824,72,73367,73367,67532,59620,57773
12891,2293,3008,8372,4519,9.9099e+12,59.7619,4142.33,12891,1454,72,9883,9883,9027,7952,7770
67776,14436,15771,43949,23827,9.90143e+12,60.1026,20087,67776,7668,72,52005,52005,50396,48254,47822
36242,6268,8521,23499,12743,9.87706e+12,59.9984,11080.7,36242,4139,72,27721,27721,24523,24450,20745
29283,4903,7767,18835,10448,9.50018e+12,59.1191,9852.51,29283,3763,72,21516,21516,17739,13349,13251
58291,3656,17867,37035,21256,8.96052e+12,58.9318,21358.4,58291,8699,72,40424,40424,25410,7747,7059
25543,13268,13860,15173,10370,5.93452e+12,53.8286,15149.2,25543,6735,72,11683,11683,11683,11683,11683
97836,58,4109,77448,20388,5.8566e+13,12.0014,5148.81,97836,2827,19,93727,93727,57482,25296,72281
60966,1893,21838,38178,22788,8.29729e+12,58.125,25237.8,60966,10638,72,39128,39128,16586,6785,2473
17386,3218,5462,11038,6348,8.9144e+12,57.884,6769.54,17386,2644,72,11924,11924,9291,6263,6215
83906,18554,25577,53334,30572,8.97562e+12,58.9774,30335,83906,12449,72,58329,58329,52238,50747,42024
42276,720,13716,26735,15541,8.73251e+12,58.6089,16336.2,42276,6677,72,28560,28471,16760,8406,2482
91029,11740,21125,59036,31993,9.91662e+12,60.141,26677.7,91029,10285,72,69904,69904,58550,55913,39365
7924,630,1867,5147,2777,1.00121e+13,59.4783,2646.28,7924,907,72,6057,6057,3768,2408,2168
9650,2510,2932,6148,3502,9.0023e+12,58.4955,3778.67,9650,1415,72,6718,6718,6418,6159,6221
79845,6190,18582,51778,28067,9.90499e+12,60.1123,23541.6,79845,9039,72,61263,61263,38652,37664,21007
43560,84,2030,34529,9031,5.8281e+13,11.9951,2713.43,43560,1815,14,41530,41530,25523,12124,34387
66617,7608,15435,43211,23406,9.9201e+12,60.13,19694.9,66617,7507,72,51182,51182,39805,39575,25882
18327,8359,8871,11076,7251,6.69137e+12,54.1113,9969.29,18327,4299,72,9456,9456,9191,8915,8916
89300,4865,20725,57912,31388,9.91789e+12,60.1428,26187.3,89300,10090,72,68575,68575,35294,35394,16975
44960,6450,15161,28327,16633,8.56164e+12,58.4203,17878.1,44960,7374,72,29799,29799,23296,16222,14556
64926,230,2738,51395,13531,5.85613e+13,12.0018,3584.08,64926,2473,19,62188,62188,39834,19993,41893
85578,24775,37037,52463,33115,7.32419e+12,56.7799,41110.8,85578,18030,72,48541,48541,42084,34555,34336
33094,5389,33094,0,33094,7.99976,0,33094,33094,33094,1,0,0,0,0,0
50897,13736,14183,32600,18297,9.30603e+12,59.3315,17406.5,50897,6895,72,36714,36714,36198,35571,35490
74714,11491,23282,47405,27309,8.89062e+12,58.4617,27560.2,74714,11320,72,51432,51432,42321,29772,26970
35759,7497,11493,22628,13131,8.78768e+12,58.6412,13786.7,35759,5599,72,24266,24266,21381,17517,16653
91670,7811,33903,57219,34451,8.13802e+12,57.964,38623.5,91670,16513,72,57767,57767,32397,17033,12631
1905,105,495,1235,670,1.01304e+13,56.7858,762.209,1905,238,54,1410,1410,604,427,383
52992,3427,12323,34359,18633,9.91544e+12,60.1027,15833.1,52992,5998,72,40669,40669,27687,27429,11774
44157,10543,18410,27208,16949,7.5408e+12,57.1448,20818.6,44157,8965,72,25747,25747,21354,15409,14043
84797,14934,31971,52816,31981,8.05432e+12,57.8432,36341.9,84797,15575,72,52826,52826,39155,23111,22561
94716,37267,50167,56450,38266,6.07806e+12,55.0849,53955.3,94716,24423,72,44549,44549,39335,33246,33217
24590,238,5791,15944,8646,9.90462e+12,59.9286,7660.4,24590,2814,72,18799,18799,5281,5920,1083
82536,5299,22647,52912,29624,9.36873e+12,59.3317,27514.5,82536,11010,72,59889,59889,39322,38810,14107
19959,7691,11478,11747,8212,5.51842e+12,54.5071,12485.1,19959,5587,72,8481,8481,7681,6683,6506
98959,67783,98959,0,98959,7.99992,0,98959,98959,98959,1,0,0,0,0,0
87196,28202,39236,53197,33999,7.11005e+12,56.6821,43264.5,87196,19114,72,47960,47960,41848,36094,34559
65942,31172,34948,39304,26638,6.06997e+12,54.8454,37753.6,65942,17003,72,30994,30994,29755,28030,27852
2775,656,760,1789,986,9.51548e+12,57.6191,1108.67,2775,365,60,2015,2015,1886,1806,1852
89296,11563,20736,57916,31380,9.91358e+12,60.1277,26195.2,89296,10090,72,68560,68560,55180,54916,38765
59668,16115,24676,36782,22886,7.59282e+12,57.2368,27770.3,59668,12021,72,34992,34992,30742,24880,23710
91811,34044,45742,71717,20094,78730100000,8.99629,46373.6,91811,41159,11,46069,46069,36966,38052,35897
42787,18986,20765,25834,16953,6.64794e+12,54.1439,22890.9,42787,10102,72,22022,22022,20402,18552,18594
58734,6837,20828,36826,21908,8.34436e+12,58.1756,24136.5,58734,10145,72,37906,37906,25661,15911,13065
41226,19605,26705,32333,8893,2.2333e+13,5.5278,30633.6,41226,8903,13,14521,14521,13526,14521,11159
48585,12479,25197,38013,10572,79206300000,8.98561,25643.5,48585,22669,11,23388,23388,13901,14944,12875
19107,2571,6552,12027,7080,8.52759e+12,58.187,7912.24,19107,3190,72,12555,12555,8862,5939,5109
81709,25608,29079,51207,30502,8.31717e+12,58.1745,33440.8,81709,14158,72,52630,52630,50390,47361,46758
55306,8172,23155,34050,21256,7.51938e+12,57.1405,26040.9,55306,11276,72,32151,32151,23273,12960,12588
14897,5007,6430,9144,5753,7.431e+12,56.6891,7433.08,14897,3132,72,8467,8467,7824,7036,6934
37523,424,11415,23859,13664,8.98761e+12,58.9007,13852,37523,5552,72,26108,25889,10019,3961,1095
48114,9744,13880,30723,17391,9.20372e+12,59.211,16922.1,48114,6762,72,34234,34234,29538,29424,23925
33402,2760,14742,20433,12969,7.24067e+12,56.7324,16601.1,33402,7181,72,18660,18660,10855,4851,3263
54836,12574,12750,35569,19267,9.91851e+12,60.0946,16360.2,54836,6207,72,42086,42086,41836,41667,41685
38359,4243,11681,24397,13962,8.97317e+12,58.8826,14161.2,38359,5676,72,26678,26678,18994,18777,9724
51356,21796,21983,31534,19822,7.3958e+12,56.9812,24663.7,51356,10704,72,29373,29373,29104,28875,28954
46317,5079,10799,30026,16291,9.91329e+12,60.0853,13935.8,46317,5257,72,35518,35518,27258,27082,17224
91921,10991,23542,59214,32707,9.60734e+12,59.3036,28991.6,91921,11463,72,68379,68379,55324,38327,34215
75748,14179,17577,49129,26619,9.92151e+12,60.1352,22318.3,75748,8562,72,58171,58171,53132,53043,47068
5753,176,1837,3651,2102,8.88189e+12,57.8274,2406.32,5753,876,72,3916,3868,1864,1541,644
90273,6501,44218,70469,19804,78544700000,8.99681,44849.7,90273,39791,11,46055,46055,16106,19803,12429
4405,1113,2341,2632,1773,6.18656e+12,46.9526,2699.6,4405,1118,68,2064,2064,1881,1608,1741
25329,9063,13377,19833,5496,79475900000,8.95531,13693.1,25329,12034,11,11952,11952,9103,9334,8890
76261,5906,25613,48066,28195,8.57633e+12,58.4811,29832.5,76261,12472,72,50648,50648,30636,17785,13254
31078,4185,7259,20155,10923,9.91943e+12,60.0245,9520.78,31078,3536,72,23819,23819,19263,19185,13794
5093,798,1556,3243,1850,9.03067e+12,58.012,2083.79,5093,743,71,3537,3537,3087,2638,2719
85564,1350,27639,54114,31450,8.75013e+12,58.6993,32362.3,85564,13464,72,57925,57925,34309,17518,5354
69817,1322,28784,43064,26753,7.58712e+12,57.2613,32322,69817,14012,72,41033,41033,17877,4170,3696
99510,14422,29498,63400,36110,9.08574e+12,59.1255,35056.5,99510,14364,72,70012,70012,56020,52621,32343
58480,5081,24692,35975,22505,7.46573e+12,56.808,27702.8,58480,12008,72,33788,33740,19858,10002,2956
80886,20277,29619,50541,30345,8.18419e+12,58.0014,33880.2,80886,14424,72,51267,51267,43567,32953,30632
52074,11403,21613,32097,19977,7.55557e+12,57.0032,24379.3,52074,10506,72,30461,30461,25517,18813,17263
32463,3570,8295,20917,11546,9.63618e+12,59.6883,10582.5,32463,4041,72,24168,24168,17685,11960,10333
35203,9035,13989,21808,13395,7.79374e+12,57.4066,16048.6,35203,6806,72,21214,21214,18915,15710,15180
16887,3214,7889,10256,6631,6.90917e+12,56.1579,8942.95,16887,3838,72,8998,8998,6460,4046,3597
58297,13132,19732,36720,21577,8.56018e+12,58.4262,23086.6,58297,9613,72,38565,38565,31937,25648,23950
18503,2634,6410,11632,6871,8.46866e+12,58.136,7734.87,18503,3118,72,12093,12093,9388,6309,6251
92724,17720,21501,60138,32586,9.91899e+12,60.1536,27146.1,92724,10471,72,71223,71223,65739,65627,59118
23508,3773,5540,15242,8266,9.90172e+12,59.9401,7343.51,23508,2697,72,17968,17968,15904,13159,12575
88414,19982,20520,57344,31070,9.92089e+12,60.1443,25933.7,88414,9996,72,67894,67894,67244,67097,66321
15913,1119,6579,9814,6099,7.59964e+12,56.9676,7662.46,15913,3196,72,9334,9334,5528,3047,1096
86783,12099,23909,55619,31164,9.36154e+12,59.4523,28977.6,86783,11647,72,62874,62874,49011,48658,32052
82806,3504,28316,52102,30704,8.49495e+12,58.1184,32807.3,82806,13772,72,54490,54490,27370,13935,8318
38863,2379,9042,25206,13657,9.9337e+12,60.0658,11754.5,38863,4403,72,29821,29821,16313,16257,8366
46316,12901,15571,29193,17123,8.5685e+12,58.4257,18357.4,46316,7572,72,30745,30745,28700,26286,26419
91052,29531,44345,54948,36104,6.62207e+12,56.0886,48288.2,91052,21587,72,46707,46707,38555,27309,24827
33480,6722,9894,21343,12137,9.1314e+12,59.0464,12134.8,33480,4820,72,23586,23586,20887,20197,16496
16877,565,3968,10946,5931,9.9568e+12,59.8662,5356.34,16877,1931,72,12909,12909,7969,5341,2048
29462,1247,7558,18985,10477,9.6491e+12,59.657,9668.74,29462,3681,72,21904,21904,13722,13513,3854
4389,685,1125,2841,1548,9.83048e+12,58.6231,1619.11,4389,543,69,3264,3264,2729,2098,2014
49393,16436,18729,30761,18632,8.03439e+12,57.7691,21506.7,49393,9122,72,30664,30664,28891,26894,26893
43099,9347,10016,27958,15141,9.92575e+12,60.0725,12972.6,43099,4874,72,33083,33083,32103,31236,31093
91437,7092,29131,57910,33527,8.80288e+12,58.7718,34160.2,91437,14191,72,62306,62306,34270,17318,11214
31214,12297,13577,19130,12084,7.31186e+12,56.8453,15358.3,31214,6614,72,17637,17637,16926,15984,15927
12490,1172,5020,7733,4757,7.77281e+12,56.0377,5937.9,12490,2428,72,7470,7470,5307,2771,2898
9646,984,5417,5714,3932,5.70953e+12,50.994,6016.78,9646,2618,72,4229,4181,2758,1054,1217
70884,8951,16482,45973,24911,9.90174e+12,60.102,20964.7,70884,8015,72,54402,54402,43468,43246,30079
68715,63974,64211,47302,21413,9.21463e+12,3.99831,64341.3,68715,21427,9,4504,4504,4488,4504,4495
17006,2283,5529,10757,6249,8.81272e+12,58.4381,6795.01,17006,2693,72,11477,11477,8798,5682,5782
48945,8303,18401,30497,18448,8.07316e+12,57.7164,21172.2,48945,8958,72,30544,30544,22908,13939,13783
90085,9717,42278,54652,35433,6.85842e+12,56.3805,46295.3,90085,20595,72,47807,47807,32007,13527,12955
7434,603,3120,4584,2850,7.56089e+12,56.2269,3730.96,7434,1498,72,4314,4218,2063,666,392
10712,2909,10712,0,10712,7.99925,0,10712,10712,10712,1,0,0,0,0,0
43083,16320,21189,25978,17105,6.56275e+12,55.898,23304.8,43083,10300,72,21894,21894,20973,19785,19581
24551,931,7427,15626,8925,9.01884e+12,58.4449,9167.52,24551,3595,72,17124,17124,8692,4955,3338
12509,629,3790,7959,4550,9.03229e+12,58.6264,4819.63,12509,1840,72,8719,8671,5729,2275,2204
84975,8036,22157,54688,30287,9.54085e+12,59.5287,27225.5,84975,10772,72,62818,62818,45166,44718,23531
52596,582,28419,31242,21354,5.94767e+12,55.2165,30707.5,52596,13845,72,24177,23121,9970,3455,813
99708,24171,31653,63161,36547,8.81431e+12,58.7899,37078.5,99708,15415,72,68055,68055,60392,51421,51146
77769,19154,33060,47787,29982,7.42448e+12,56.8531,36862.1,77769,16083,72,44709,44709,36291,28359,26174
42685,11549,17516,26344,16341,7.62135e+12,56.9699,19884.8,42685,8511,72,25169,25169,22442,18671,17997
96054,6656,37740,59558,36496,7.83755e+12,57.5916,42496.6,96054,18377,72,58314,58314,36932,11809,10949
29248,5989,11517,18138,11110,7.84224e+12,57.4578,13302,29248,5605,72,17731,17731,14639,10366,9581
68483,21846,25260,42764,25719,8.15347e+12,57.9483,28950.8,68483,12302,72,43223,43223,40248,36820,36777
85042,20183,32579,52883,32159,7.97109e+12,57.7415,36924.6,85042,15866,72,52463,52463,42558,30917,30647
8153,1630,2663,5158,2995,8.77397e+12,58.1515,3392.23,8153,1292,72,5490,5490,4232,3945,2269
69716,14406,16198,45209,24507,9.91879e+12,60.1225,20618.4,69716,7885,72,53518,53518,50976,50915,48031
72449,4574,19483,46516,25933,9.43903e+12,59.539,23864.4,72449,9486,72,52966,52966,29037,14793,12610
55574,308,12902,36037,19537,9.92974e+12,60.1167,16554.2,55574,6284,72,42672,42672,11224,1171,1707
94329,18142,21943,61167,33162,9.90977e+12,60.1354,27663.6,94329,10679,72,72386,72386,67839,66776,60258
61351,7410,22360,38362,22989,8.2174e+12,58.012,25747,61351,10889,72,38991,38943,26311,11302,10886
25617,4954,6033,16607,9010,9.89012e+12,59.9185,7964.7,25617,2935,72,19584,19584,18122,18080,16512
3825,211,992,2471,1354,9.79568e+12,58.4235,1437.8,3825,477,66,2833,2833,1221,898,725
20176,5039,6737,12735,7441,8.61088e+12,57.328,8175.61,20176,3260,72,13439,13439,12198,10826,10850
75457,6032,26156,50229,25228,1.16463e+13,47.4078,31232.4,75457,8472,73,49301,49301,29294,14809,3472
63434,9592,23619,39573,23861,8.1088e+12,57.8897,27067.3,63434,11500,72,39815,39815,29866,20199,17589
16209,617,5118,10291,5918,8.86176e+12,58.1625,6356.31,16209,2472,72,11091,10995,6904,6783,1923
72653,33096,33115,44247,28406,7.03294e+12,56.5855,36544.8,72653,16131,72,39538,39538,39527,39529,39527
2811,178,730,1822,989,9.69599e+12,57.3664,1089.87,2811,333,60,2081,2081,1034,712,613
27302,5227,7723,17471,9831,9.29499e+12,59.214,9654.26,27302,3762,72,19579,19579,16512,12958,12923
68902,8848,16018,44685,24217,9.9165e+12,60.1147,20390.9,68902,7799,72,52884,52884,42456,42243,29742
10993,2501,2617,7129,3864,9.9156e+12,59.6866,3614.97,10993,1275,72,8376,8376,8222,8131,8164
75363,11421,23387,47838,27525,8.90448e+12,58.8685,27702.6,75363,11371,72,51976,51976,40126,26226,25699
56478,11776,25888,34377,22101,7.00897e+12,56.5119,28658.6,56478,12608,72,30590,30590,24455,17388,17193
9175,26,2215,5947,3228,9.83916e+12,59.0967,3085.55,9175,1055,72,4174,742,1657,23,45
5430,81,2664,4239,1191,78430900000,8.9547,2812.27,5430,2389,11,2766,2766,716,970,482
29964,1059,7014,19432,10532,9.92349e+12,59.996,9206.46,29964,3414,72,22950,22950,9397,4131,3855
26314,1943,8161,16708,9606,8.93217e+12,58.7764,9981.79,26314,3970,72,18153,18153,11877,4461,4374
4664,540,1120,3024,1640,1.00713e+13,59.0635,1642.07,4664,544,71,3544,3544,2823,1963,1838
34664,10875,17422,27085,7579,78896200000,8.99158,17804.8,34664,15676,11,17242,17242,12624,13071,12189
41916,13024,15913,26094,15822,8.01856e+12,57.7236,18342.9,41916,7740,72,26003,26003,22574,17939,16888
26195,983,10550,16206,9989,7.73748e+12,57.2925,12167.7,26195,5133,72,15645,15630,7513,2674,1099
72301,14755,30068,44553,27748,7.54628e+12,56.854,33691.5,72301,14628,72,42233,42233,33938,22511,19981
59421,12832,18697,37671,21750,8.85705e+12,58.8022,22211.2,59421,9102,72,40724,40724,35506,28316,26819
64109,5179,21142,40474,23635,8.66098e+12,58.5778,24817.2,64109,10300,72,42967,42967,24134,13643,9616
90489,19870,27171,57595,32894,9.04094e+12,59.053,32269.1,90489,13232,72,63318,63318,57912,56552,48859
33518,16560,17998,19940,13578,5.99623e+12,55.2035,19605.9,33518,8763,72,15520,15520,15287,15082,15205
83374,432,35374,51240,32134,7.43605e+12,56.8546,39410.3,83374,17214,72,48000,46836,23109,6618,1048
34815,10299,13356,21653,13162,7.97427e+12,57.6499,15436.6,34815,6500,72,21459,21459,19258,16734,16743
11688,1639,2795,7576,4112,9.88502e+12,59.6477,3838.26,11688,1357,72,8893,8893,7482,7164,5288
26381,957,1724,21008,5373,5.71957e+13,12.0062,2254.97,26381,761,20,24657,24657,19607,16149,22355
94889,4107,22062,61528,33361,9.91412e+12,60.1332,27811.3,94889,10745,72,72827,72827,33295,16087,14529
7212,253,1708,4684,2528,9.99706e+12,59.3838,2433.52,7212,827,72,5504,5504,3348,3310,878
84675,8244,19730,54893,29782,9.9048e+12,60.1272,24944.2,84675,9608,72,64945,64945,47460,45513,27698
37876,7688,8839,24570,13306,9.90804e+12,60.026,11497.6,37876,4292,72,29037,29037,27654,25864,25505
26993,860,15161,15941,11052,5.67894e+12,53.9442,16465.4,26993,7378,72,11832,11352,5869,2429,1185
5305,1679,5305,0,5305,7.99849,0,5305,5305,5305,1,0,0,0,0,0
41061,319,18093,25114,15947,7.2349e+12,56.7244,20290.9,41061,8808,72,22968,22249,9682,595,669
49770,4799,21333,30558,19212,7.39186e+12,55.3716,23945.4,49770,10376,72,28437,28437,15467,9171,6705
52513,9885,15162,33535,18978,9.21101e+12,59.2105,18427.3,52513,7386,72,37351,37351,31609,31458,24763
67889,11533,20836,43135,24754,8.95647e+12,58.7193,24801.7,67889,10134,72,47053,47053,40715,32090,30078
7466,100,1823,4831,2635,9.81016e+12,59.3507,2567.33,7466,876,72,5643,5185,1608,312,423
68039,10263,15811,44122,23917,9.91308e+12,60.1291,20144.5,68039,7697,72,52228,52228,45613,36624,34521
83033,20354,34813,51111,31922,7.5008e+12,57.1608,38860.1,83033,16949,72,48220,48220,37886,25725,25432
8270,80,2004,5355,2915,9.8855e+12,59.4206,2805.72,8270,969,72,6266,5017,1670,214,339
95295,18673,52020,56525,38770,5.87132e+12,55.1587,55714.1,95295,25339,72,43275,43275,32134,19180,18847
85298,8073,27892,53887,31411,8.68612e+12,58.6249,32585.8,85298,13572,72,57406,57406,39028,17434,16576
54653,10776,13436,35323,19330,9.74398e+12,59.8862,16984.4,54653,6537,72,41217,41217,38067,37328,32871
68677,4186,15978,44540,24137,9.90377e+12,60.098,20340.8,68677,7771,72,52699,52699,28774,16344,14436
18258,1963,7400,11295,6963,7.72697e+12,56.3251,8616.78,18258,3587,72,10858,10858,5539,5497,1223
77310,33327,40094,60488,16822,79260200000,8.98858,40659.5,77310,36080,11,37216,37216,32735,33101,32388
84094,2640,32587,52236,31858,7.90915e+12,57.6628,36866.4,84094,15864,72,51507,51507,23845,11574,6101
56855,3545,19408,35782,21073,8.50786e+12,58.3749,22685.7,56855,9449,72,37447,37447,23620,23173,6764
69782,3198,16212,45250,24532,9.91757e+12,60.1194,20635.9,69782,7892,72,53570,53570,34590,34212,11240
92617,9761,21537,60058,32559,9.91204e+12,60.1415,27170.6,92617,10490,72,71080,71080,53925,53580,32842
74401,8495,35631,45011,29390,6.73046e+12,55.988,39006.8,74401,17336,72,38770,38770,20084,12208,8718
72829,19076,30350,44864,27965,7.53055e+12,56.4699,33992.1,72829,14763,72,42479,42479,36579,29652,29587
63549,11308,41163,49830,13719,2.23454e+13,5.5308,47181.7,63549,13723,13,22386,22386,17078,17292,8249
37565,8861,14771,23303,14262,7.84401e+12,57.498,16954.6,37565,7190,72,22794,22794,21414,19499,19281
76084,2672,4732,60559,15525,5.73485e+13,12.0018,5638.63,76084,2997,20,71352,71352,57998,48958,65313
76271,4121,17694,49463,26808,9.92244e+12,60.1292,22465.3,76271,8618,72,58577,58577,29946,16149,14380
84910,13519,46209,66570,18340,79834800000,8.97542,46781.9,84910,41582,11,38701,38701,17451,19086,15834
34865,2706,8139,22611,12254,9.91686e+12,60.0236,10620.4,34865,3962,72,26726,26726,16792,16338,9120
98965,19354,22987,64177,34788,9.91314e+12,60.1472,28954.9,98965,11192,72,75978,75978,71613,65708,64356
50918,14409,16953,32124,18794,8.61635e+12,58.4254,19974.4,50918,8246,72,33965,33965,32502,30558,30174
26224,199,6158,17001,9223,9.92056e+12,59.9797,8126.35,26224,2999,72,20066,20066,11443,11260,959
34833,4883,12521,21823,13010,8.27991e+12,57.7669,14668,34833,6079,72,22312,22312,15844,8230,8120
40473,7699,11365,25907,14566,9.30021e+12,59.3021,14027.9,40473,5531,72,29108,29108,24898,24791,19867
93306,2577,23232,60227,33079,9.70197e+12,59.8788,28794.2,93306,11318,72,70074,70074,42997,19330,9676
72526,11258,16838,47033,25493,9.92774e+12,60.1329,21406.1,72526,8202,72,55688,55688,47513,47355,37579
90416,19458,34327,56283,34133,8.00608e+12,57.7948,38929,90416,16709,72,56089,56089,45346,35098,32392
50799,10026,26352,30384,20415,6.21975e+12,55.5249,28662,50799,12825,72,24447,24447,18126,11643,10089
55510,3228,29307,43464,12046,79459200000,8.99533,29779.2,55510,26368,11,26203,26203,8240,9881,6613
91996,5942,21403,59655,32341,9.91421e+12,60.133,26999.9,91996,10423,72,70593,70593,39846,23117,20311
88185,15056,24614,56456,31729,9.30941e+12,59.405,29735,88185,11990,72,63571,63571,55178,43735,41047
1877,254,537,1204,673,9.97671e+12,56.829,795.189,1877,261,54,1340,1340,1001,654,705
76370,11112,22229,48726,27644,9.15871e+12,59.2021,26693.4,76370,10824,72,54141,54141,44169,41762,27327
80505,73066,80505,0,80505,7.9999,0,80505,80505,80505,1,0,0,0,0,0
39961,4544,14214,25052,14909,8.31157e+12,58.0751,16624,39961,6910,72,25747,25747,18734,10565,10302
16931,1982,3982,10988,5943,9.90882e+12,59.8499,5376.88,16931,1937,72,12949,12949,10597,10038,6773
20297,6177,6270,12887,7410,8.97849e+12,58.7661,7754.75,20297,3054,72,14027,14027,13897,13851,13867
85998,18638,35419,53036,32962,7.59867e+12,57.2524,39633.4,85998,17250,72,50579,50579,40817,31615,29065
44936,16414,16863,28011,16925,8.07341e+12,56.87,19451.5,44936,8193,72,28073,28073,28073,28073,28073
95741,12578,22198,62088,33653,9.91781e+12,60.1497,27999,95741,10808,72,73543,73543,61911,59208,42250
6658,1534,2090,4230,2428,8.95376e+12,58.125,2724.43,6658,1009,72,4568,4568,3894,3193,3239
72618,10903,19213,46682,25936,9.49906e+12,59.6097,23625.2,72618,9354,72,53405,53405,43472,33999,31395
43501,241,10167,28206,15295,9.91223e+12,60.0466,13140.4,43501,4944,72,33334,33334,18949,18650,1296
79045,12422,22751,50489,28556,9.20069e+12,59.2501,27365.4,79045,11079,72,56294,56294,46415,43979,29748
49196,3094,11456,31901,17295,9.9359e+12,60.0931,14749.5,49196,5580,72,37740,37740,20865,20733,10603
29872,169,8829,19043,10829,9.12266e+12,59.0211,10875.1,29872,4295,72,21043,20775,7132,3214,857
74440,15838,36868,44818,29622,6.52096e+12,55.1309,40157.5,74440,17938,72,37572,37572,28538,20019,17790
13211,3549,3823,8445,4766,9.23921e+12,58.9291,4910.22,13211,1861,72,9388,9388,8997,8988,8704
22363,1752,5218,14504,7859,9.95145e+12,59.9663,6953.8,22363,2540,72,17145,17145,10691,10418,5856
36715,620,8544,23807,12908,9.9274e+12,60.0671,11137.8,36715,4159,72,28171,28171,9030,2410,2515
20950,6199,7767,13086,7864,8.13029e+12,57.7376,9183.81,20950,3770,72,13183,13183,12376,11236,11202
96970,14062,48504,58300,38670,6.45214e+12,55.8788,52569.4,96970,23616,72,48466,48466,33083,23934,20732
81730,13010,43308,48716,33014,6.07308e+12,55.125,46656,81730,21078,72,38422,38422,28127,18358,15780
93489,16938,21736,60622,32867,9.91073e+12,60.1419,27416.8,93489,10583,72,71753,71753,65950,64606,56252
38911,12381,22661,22824,16087,5.41317e+12,54.2718,24328.5,38911,11034,72,16250,16250,13544,9804,9147
61316,14204,31511,36724,24592,6.28248e+12,55.6369,34225.5,61316,15346,72,29805,29805,22263,15110,13291
31809,3775,13676,19525,12284,7.37595e+12,56.8922,15492.8,31809,6658,72,18133,18133,12317,5586,5394
63890,5437,14866,41426,22464,9.91694e+12,60.1136,18970.8,63890,7235,72,49024,49024,32834,21392,18607
68728,15276,15982,44572,24156,9.9128e+12,60.1119,20347.2,68728,7779,72,52746,52746,51710,50786,50630
85820,10259,26438,54510,31310,8.94076e+12,58.9308,31265.3,85820,12876,72,59382,59382,39351,25090,20521
97860,16859,40378,60348,37512,7.5884e+12,57.2809,45075.4,97860,19667,72,57482,57482,44069,28426,27821
45940,8524,10713,29784,16156,9.92344e+12,60.0752,13824.1,45940,5219,72,35227,35227,32102,32030,28422
85548,1132,41484,51657,33891,6.66131e+12,56.1269,45232.3,85548,20209,72,44064,43899,25232,13416,2481
20300,4779,5771,12978,7322,9.27118e+12,59.1366,7298.2,20300,2806,72,14529,14529,13078,11451,11466
50015,186,11652,32436,17579,9.90973e+12,60.0777,14995,50015,5670,72,38363,38363,9673,11184,1160
96132,2782,22335,62329,33803,9.91576e+12,60.1511,28152.6,96132,10881,72,73797,73797,45295,44721,10151
48225,888,17520,30161,18064,8.22914e+12,58.0271,20304.8,48225,8532,72,30705,30657,8212,4714,1306
29759,2066,6965,19297,10462,9.90148e+12,60.0026,9150.54,29759,3387,72,22794,22794,15748,11013,7209
35449,8689,10830,22538,12911,8.98479e+12,58.8854,13151,35449,5272,72,24619,24619,22860,20436,20052
44361,5649,23165,26500,17861,6.18156e+12,54.5733,25227,44361,11279,72,21196,21196,12023,6836,5062
87398,13585,20282,56680,30718,9.91938e+12,60.1481,25644.8,87398,9880,72,67116,67116,59075,48113,45531
98872,7663,22960,64110,34762,9.91943e+12,60.1489,28918.6,98872,11185,72,75912,75912,53621,53171,26186
37769,15071,15099,23378,14391,7.75658e+12,57.3843,17275.7,37769,7341,72,22670,22670,22668,22667,22669
96238,4599,28400,61351,34887,9.09971e+12,59.1451,33813.3,96238,13829,72,67838,67790,44511,44044,15786
27213,12165,12984,16483,10730,6.75976e+12,54.9705,14488.3,27213,6302,72,14229,14229,13950,13545,13673
80229,16488,25661,50792,29437,8.78888e+12,58.5159,30154.3,80229,12484,72,54568,54568,44580,32724,32446
5331,739,1275,3463,1868,9.90494e+12,59.1444,1857.6,5331,613,72,4056,4056,3408,2607,2489
80519,10522,18662,52225,28294,9.92071e+12,60.1412,23663.1,80519,9085,72,61857,61857,52036,49750,35465
47295,11009,24563,28268,19027,6.22412e+12,54.9869,26741.2,47295,11961,72,22732,22732,15604,7289,7165
70611,14503,17751,45550,25061,9.67253e+12,59.8268,22126.8,70611,8643,72,52860,52860,49208,44286,43164
58227,25602,28367,35132,23095,6.63513e+12,55.4418,31085.4,58227,13814,72,29860,29860,28472,26938,26987
97771,22474,26785,62687,35084,9.38088e+12,59.4797,32408.9,97771,13045,72,70986,70986,66307,59984,58525
4764,1564,1959,2940,1824,7.86385e+12,52.3554,2402.6,4764,948,69,2805,2805,2635,2383,2527
47756,935,19927,29420,18336,7.52545e+12,56.7981,22496.1,47756,9686,72,27829,27637,15618,9453,897
83914,31618,41073,50605,33309,6.59661e+12,55.6801,44741.3,83914,20003,72,42841,42841,37455,32404,31045
33567,9231,16330,20265,13302,6.64704e+12,55.443,18079.5,33567,7948,72,17237,17237,14494,11385,11367
31809,1816,8544,20424,11385,9.45961e+12,59.4623,10763,31809,4156,72,23265,23265,11186,6692,4452
15421,2854,4142,9906,5515,9.4983e+12,59.311,5396.66,15421,2011,72,11279,11279,9798,7862,7486
38795,4210,12286,24592,14203,8.82467e+12,58.7196,14755.5,38795,5975,72,26509,26509,19891,12855,11018
20092,5507,5538,12886,7206,9.40912e+12,59.256,7064.04,20092,2697,72,14554,14554,14525,14534,14521
51706,11068,12030,33532,18174,9.91501e+12,60.0919,15468.6,51706,5854,72,39676,39676,38497,38232,36689
87292,19675,32982,54369,32923,8.03723e+12,57.8163,37456.1,87292,16061,72,54310,54310,47608,38470,36341
27958,1352,6718,18106,9852,9.80848e+12,59.8711,8782.66,27958,3263,72,21240,21240,13740,9292,4704
34163,7045,7958,22153,12010,9.92112e+12,60.0592,10403.9,34163,3876,72,26205,26205,24864,24840,23384
50014,4823,18562,31214,18800,8.13891e+12,57.8916,21396.7,50014,9043,72,31452,31452,20923,8484,8179
8669,2014,2732,5512,3157,8.90685e+12,58.2697,3501.95,8669,1326,72,5937,5937,4886,4867,3765
56859,19331,24351,34914,21945,7.39882e+12,56.6696,27265.5,56859,11846,72,32508,32508,30054,26772,26052
1469,404,969,858,611,4.64097e+12,39.3022,1096.67,1469,465,39,500,473,147,69,109
8827,2395,5570,5116,3711,4.82428e+12,52.186,6064.71,8827,2707,71,3257,3257,2259,995,921
11329,584,2700,7339,3990,9.9222e+12,59.6607,3720.24,11329,1309,72,8629,8629,5602,3842,2055
81424,13665,18931,52805,28619,9.91503e+12,60.1288,23974.1,81424,9217,72,62493,62493,56228,47696,45711
80041,43205,51854,62756,17285,2.23407e+13,5.52972,59411.6,80041,17286,13,28187,28187,26975,28187,24098
2814,437,704,1834,980,9.8865e+12,58.0355,1064.79,2814,338,60,2110,2110,1731,1721,1443
52804,19656,52804,0,52804,7.99985,0,52804,52804,52804,1,0,0,0,0,0
54875,11089,16375,34949,19926,9.0631e+12,58.982,19731.6,54875,7956,72,38500,38500,33743,33580,28078
92375,3149,32633,57933,34442,8.35857e+12,58.2192,37484.8,92375,15893,72,59742,59694,24016,9201,7899
22816,1349,6966,14515,8301,8.98326e+12,58.7885,8601.22,22816,3380,72,15850,15850,7939,4193,2723
20900,2490,4897,13554,7346,9.90177e+12,59.902,6543.51,20900,2380,72,16003,16003,13154,9227,8499
86145,14463,20093,55845,30300,9.90549e+12,60.1231,25382,86145,9781,72,66052,66052,59319,50153,48022
92354,10543,28583,58635,33719,8.92593e+12,58.9163,33711.7,92354,13925,72,63771,63771,46120,30448,24523
46885,10048,10935,30408,16477,9.91729e+12,60.0758,14101.4,46885,5322,72,35950,35950,34678,33470,33323
70740,8863,32270,43078,27662,7.03051e+12,56.5415,35619.3,70740,15715,72,38470,38470,28427,16864,16435
89390,16278,26704,56918,32472,9.06625e+12,59.0854,31756.3,89390,13009,72,62686,62686,57308,50926,50889
87961,8209,28592,55596,32365,8.71355e+12,58.4023,33423.1,87961,13914,72,59369,59369,39697,16426,15650
45427,5106,17369,28259,17168,7.98608e+12,57.7042,19954,45427,8456,72,28058,28058,18844,8011,7775
81463,752,52776,63878,17585,2.23317e+13,5.52806,60467.6,81463,17587,13,28687,28687,6236,11670,4054
58915,6984,14163,38135,20780,9.81002e+12,59.9811,17965.9,58915,6895,72,44752,44752,35128,34914,23405
66405,17970,32390,40068,26337,6.61752e+12,56.0677,35419.1,66405,15772,72,34015,34015,29512,23290,22024
46881,7607,10939,30397,16484,9.90617e+12,60.0677,14105.2,46881,5323,72,35942,35942,31950,31017,25334
88356,23671,26542,56237,32119,9.03121e+12,59.0525,31538.4,88356,12925,72,61814,61814,58346,57519,52639
1897,349,1121,1128,769,5.39071e+12,31.3564,1297.67,1897,524,50,776,776,776,776,776
94846,21275,43942,57636,37210,6.93174e+12,55.6445,48183.1,94846,21385,72,50904,50904,42081,29928,27222
97456,28222,29591,61963,35493,9.00041e+12,59.0147,35001.4,97456,14415,72,67865,67865,65841,63543,63522
3614,133,259,2883,731,5.69566e+13,11.9405,444.976,3614,155,14,3355,3355,2571,2085,3000
1806,198,534,1162,644,9.74252e+12,56.1002,781.945,1806,256,51,1272,1272,809,326,425
96159,4127,22343,62354,33805,9.91886e+12,60.1443,28160.5,96159,10884,72,73816,73816,33611,34366,14629
2621,220,661,1707,914,9.7498e+12,57.9432,1005.23,2621,316,59,1960,1960,1324,1312,722
51619,303,12021,33473,18146,9.89899e+12,60.0671,15454.6,51619,5841,72,39598,39598,10448,1115,1586
42007,978,9775,27248,14759,9.90695e+12,60.0437,12669.6,42007,4751,72,32232,32232,19413,12777,3702
69644,8616,33656,42078,27566,6.67657e+12,55.8347,36830.2,69644,16377,72,35988,35988,23492,14898,12176
31355,6184,7281,20343,11012,9.92264e+12,60.0173,9561.24,31355,3537,72,24074,24074,22761,22457,20684
85706,7698,30406,53719,31987,8.33336e+12,58.1075,34952.8,85706,14803,72,55300,55300,30502,17070,11948
86505,19281,20081,56098,30407,9.92328e+12,60.1421,25393.7,86505,9782,72,66424,66424,65445,64195,63979
67766,22033,27731,41824,25942,7.63855e+12,57.315,31194,67766,13503,72,40035,40035,37609,34274,33694
59873,5282,13958,38829,21044,9.89971e+12,60.0985,17844.2,59873,6793,72,45915,45915,31351,20472,17735
92024,20280,43902,55699,36325,6.75865e+12,56.2514,47940.3,92024,21385,72,48122,48122,36995,24057,23729
69551,11114,20691,44312,25239,9.06904e+12,59.0777,24784.4,69551,10068,72,48860,48860,39553,39265,28263
31876,3297,8001,20572,11304,9.67151e+12,59.7241,10269.5,31876,3883,72,23875,23875,17436,17290,9647
54371,5942,13390,35127,19244,9.74223e+12,59.8821,16921.9,54371,6517,72,40981,40981,31285,31050,19500
56850,2150,33383,33315,23535,5.33301e+12,54.463,35618.5,56850,16258,72,23467,23467,14305,5492,3570
33026,6999,7710,21411,11615,9.902e+12,60.0185,10088,33026,3747,72,25316,25316,24571,23614,23470
41456,4641,16650,25659,15797,7.73097e+12,56.7631,18989.4,41456,8090,72,24806,24806,15522,9188,7234
6961,1916,2052,4452,2509,9.13585e+12,58.357,2720.47,6961,986,72,4909,4909,4773,4745,4682
10524,2813,3294,6687,3837,8.90165e+12,57.7867,4189.48,10524,1582,72,7230,7230,6752,6364,6339
82132,15221,27054,51859,30273,8.66144e+12,58.5825,31583.1,82132,13171,72,55078,55078,45861,33208,30317
46080,7232,10752,29880,16200,9.91494e+12,60.0734,13871,46080,5237,72,35328,35328,30219,30112,24085
15001,1413,3543,9730,5271,9.92501e+12,59.783,4809.8,15001,1722,72,11458,11458,8302,8245,4581
56657,8104,15143,36393,20264,9.46942e+12,59.5541,18714.1,56657,7371,72,41514,41514,34775,33154,23466
44072,3844,15468,27658,16414,8.38632e+12,58.199,18094.6,44072,7526,72,28604,28604,19366,8587,8194
98662,18868,54350,77393,21269,80001200000,8.99096,54962,98662,48907,11,44312,44312,23168,24304,22049
15244,2701,3595,9879,5365,9.90674e+12,59.8104,4879.59,15244,1745,72,11649,11649,10563,10311,8908
6790,1470,2063,4333,2457,9.03108e+12,58.2925,2714.44,6790,998,72,4727,4727,4449,4355,4175
45294,1733,1899,35858,9436,5.85673e+13,11.9954,2597.87,45294,1895,13,43395,43395,41929,40654,42737
41862,11747,16952,25874,15988,7.68984e+12,57.1596,19300.8,41862,8245,72,24910,24910,22231,18516,17858
70989,8911,27808,44042,26947,7.86155e+12,57.5964,31496.1,70989,13546,72,43181,43181,29652,13730,13272
36523,27954,36523,0,36523,7.99978,0,36523,36523,36523,1,0,0,0,0,0
34164,5286,7977,22154,12010,9.90441e+12,60.02,10418.1,34164,3880,72,26187,26187,22987,22230,17723
81394,231,5068,64788,16606,5.73347e+13,12.0014,6005.86,81394,2800,20,76326,76326,44359,20476,59617
63845,14444,14848,41392,22453,9.91945e+12,60.1222,18950,63845,7233,72,48997,48997,48508,47924,47868
86213,14469,26635,54735,31478,8.92959e+12,58.6664,31478.4,86213,12969,72,59578,59578,45520,28882,28393
14571,1591,3382,9453,5118,9.93617e+12,59.8564,4630.14,14571,1636,72,11189,11189,8894,6128,5508
5725,1402,2100,3588,2137,8.32952e+12,54.7382,2635.2,5725,1006,71,3625,3625,3051,2445,2535
67243,3039,15646,43610,23633,9.90387e+12,60.1085,19934,67243,7611,72,51597,51597,24141,12045,10878
70474,557,28150,43623,26851,7.75795e+12,57.0161,31782.2,70474,13691,72,42324,41610,23648,14646,962
86198,19006,20015,55905,30293,9.9191e+12,60.1411,25312.3,86198,9749,72,66183,66183,64704,63352,63048
13197,1442,3144,8560,4637,9.84162e+12,59.6272,4291.19,13197,1517,72,10053,10053,7676,7618,4912
60010,15245,21656,37557,22453,8.25922e+12,58.0775,25000.4,60010,10547,72,38354,38354,34275,28759,27509
43349,5603,10076,28125,15224,9.91442e+12,60.0682,13048.2,43349,4900,72,33273,33273,27891,26636,18882
48283,13166,21181,29550,18733,7.2667e+12,56.8176,23692.2,48283,10312,72,27102,27102,22787,17751,17770
46119,10013,10763,29900,16219,9.89758e+12,60.0613,13889.5,46119,5227,72,35356,35356,34395,34360,33385
62695,48411,62695,0,62695,7.99987,0,62695,62695,62695,1,0,0,0,0,0
27634,1015,1520,21954,5680,5.77817e+13,11.9923,2059.51,27634,1145,14,26114,26114,22534,19751,24502
3367,611,1869,2006,1361,6.06833e+12,49.3276,2150.1,3367,893,64,1498,1450,1378,1244,1386
2210,421,561,1433,777,1.00184e+13,57.5606,863.312,2210,266,57,1649,1649,1480,1359,1357
24829,6526,7257,15854,8975,9.15782e+12,57.2359,9030.71,24829,3516,72,17572,17572,17572,17572,17572
40587,11018,11578,25951,14636,9.2461e+12,59.2229,14231.7,40587,5636,72,29009,29009,28187,28172,27362
62038,22288,24645,38424,23614,7.79697e+12,57.4974,27916.1,62038,12006,72,37393,37393,35938,34036,33660
7087,3000,3573,4267,2820,6.48911e+12,51.5636,4096.22,7087,1734,71,3514,3514,3384,3187,3320
39041,7280,9086,25318,13723,9.90694e+12,60.041,11813.4,39041,4412,72,29955,29955,27766,27262,24197
67862,8606,24406,42479,25383,8.28229e+12,58.1048,28113.9,67862,11889,72,43456,43456,31419,17256,16825
19765,8548,10933,11715,8050,5.7883e+12,54.1387,11973.9,19765,5305,72,8832,8832,7785,6324,6210
57651,2785,13448,37384,20267,9.9142e+12,60.0954,17207.4,57651,6550,72,44203,44203,28689,19492,9656
58784,6072,13716,38119,20665,9.90199e+12,60.0792,17538.6,58784,6672,72,45068,45068,34215,23346,20390
26889,4577,6245,17440,9449,9.94457e+12,60.0187,8261.31,26889,3036,72,20644,20644,18594,18132,15316
98959,15715,22987,64172,34787,9.91367e+12,60.1459,28953.6,98959,11192,72,75972,75972,67219,65176,52468
79254,26108,31680,49058,30196,7.75806e+12,57.4718,35681.4,79254,15430,72,47574,47574,43817,39478,39381
79339,6040,32483,48971,30368,7.63524e+12,57.3218,36432,79339,15823,72,46856,46856,27009,14502,10205
21337,2176,4992,13844,7493,9.8985e+12,59.9274,6669.04,21337,2423,72,16345,16345,12223,8715,7351
43931,7629,10206,28496,15435,9.92193e+12,60.0718,13208.4,43931,4969,72,33725,33725,30574,29852,25381
80257,2823,3819,63638,16619,5.82193e+13,11.9976,4750.42,80257,3332,14,76438,76438,68047,60834,72694
3383,1255,1742,2037,1346,6.46172e+12,52.6536,2041.71,3383,844,61,1641,1641,1285,776,901
28455,5755,6663,18450,10005,9.93571e+12,59.9871,8764.68,28455,3245,72,21792,21792,20681,20429,18982
76227,16725,17694,49437,26790,9.92066e+12,60.1328,22462.3,76227,8616,72,58533,58533,57112,57085,55546
11617,1445,2697,7541,4076,9.96957e+12,59.8364,3746.11,11617,1313,72,8920,8920,7079,7047,4984
64844,9511,21499,40922,23922,8.64153e+12,58.1095,25199.5,64844,10457,72,43345,43345,32985,32722,20573
66309,874,21442,41934,24375,8.73973e+12,58.6692,25254,66309,10435,72,44867,44819,26283,17009,3470
38550,8855,13283,24245,14305,8.4828e+12,58.172,15655.6,38550,6454,72,25267,25267,21670,17495,17431
38765,1024,9088,25131,13634,9.88595e+12,60.0247,11795.5,38765,4413,72,29677,29677,10781,11449,3593
7899,582,3198,4889,3010,7.76242e+12,53.4159,3848.48,7899,1541,72,4701,4653,3297,1653,1819
57012,3180,13239,36975,20037,9.91839e+12,60.1131,16972.7,57012,6443,72,43773,43773,29074,19953,11018
49772,2194,20046,30790,18982,7.72238e+12,56.9887,22754.6,49772,9748,72,29726,29726,18065,5496,3964
3160,331,792,2054,1106,9.70476e+12,58.1209,1185.84,3160,372,62,2368,2368,1708,1187,1111
79085,20987,29025,49401,29684,8.17672e+12,57.9929,33202.4,79085,14135,72,50060,50060,43318,35456,35196
41733,6451,17982,25614,16119,7.35318e+12,56.7003,20240.6,41733,8739,72,23751,23751,17172,10755,9169
80182,9604,30525,49903,30279,7.99593e+12,57.7365,34674.3,80182,14858,72,49657,49657,33406,19757,15803
50681,3024,12546,32727,17954,9.72347e+12,59.8545,15873.2,50681,6108,72,38135,38135,25502,16060,10028
25370,2652,8869,15942,9428,8.41446e+12,58.1234,10557.4,25370,4311,72,16501,16501,10459,7602,6592
62036,10537,19119,39398,22638,8.93446e+12,58.9064,22790.2,62036,9309,72,42917,42917,34798,25292,24957
34266,2633,14340,21098,13168,7.53849e+12,57.0882,16295.7,34266,6986,72,19926,19926,10791,5314,3355
50423,1409,2113,39918,10505,5.857e+13,11.9959,2851.05,50423,2109,13,48310,48310,42003,36426,45501
5793,986,1368,3760,2033,9.99594e+12,59.3874,1988.62,5793,665,72,4425,4425,3873,3862,3374
43917,2458,24556,25949,17968,5.70114e+12,53.572,26475,43917,11952,72,19361,19361,11303,2032,1733
6730,760,1601,4367,2363,9.87109e+12,59.31,2293.77,6730,766,72,5129,5129,3919,3895,2603
32221,8052,9157,20611,11610,9.26808e+12,59.2042,11358.8,32221,4456,72,23064,23064,21540,19846,19854
69336,5076,16125,44967,24369,9.90787e+12,60.1033,20524.6,69336,7842,72,53211,53211,32438,19906,17419
82179,24644,40341,49549,32630,6.57021e+12,56.0198,43936.1,82179,19641,72,41838,41838,35562,28241,28158
62778,7857,25045,38861,23917,7.75953e+12,57.4204,28344.5,62778,12187,72,37733,37733,25584,11297,10902
64806,8828,15031,42042,22764,9.91698e+12,60.1167,19189.4,64806,7313,72,49775,49775,40695,40520,29604
92855,26216,29127,58878,33977,8.85959e+12,58.8481,34259,92855,14176,72,63728,63728,59773,55078,55112
42285,14081,14613,26580,15705,8.4587e+12,57.6593,17171.6,42285,7110,72,27672,27672,27036,26258,26135
37780,525,2101,30021,7759,5.77406e+13,11.9945,2733.61,37780,1560,14,35679,35679,24001,14620,30444
34978,8064,8148,22676,12302,9.93335e+12,60.0573,10639.5,34978,3965,72,26830,26830,26734,26702,26697
38411,390,21908,22632,15779,5.55767e+12,53.8845,23596.4,38411,10652,72,16503,15591,9628,6445,1511
46901,742,10876,30427,16474,9.93805e+12,60.0977,14046.2,46901,5297,72,36025,36025,11336,12446,3000
62133,3863,22495,38864,23269,8.25102e+12,58.0662,25930.6,62133,10958,72,39638,39638,25160,8160,7535
59797,12968,28150,36265,23532,6.83609e+12,56.323,31004.4,59797,13703,72,31647,31647,24853,16910,16800
36381,6445,8489,23595,12786,9.90945e+12,60.0333,11059.5,36381,4131,72,27892,27892,24989,24920,21585
40869,10302,12900,25904,14965,8.86264e+12,58.7538,15473,40869,6283,72,27969,27969,25442,22553,22532
11884,388,3395,7607,4277,9.3152e+12,58.9344,4401.56,11884,1653,72,8489,8441,2841,1997,1327
3909,597,1015,2523,1386,9.58789e+12,58.2661,1470.17,3909,480,66,2894,2894,2314,2304,1779
41884,11144,12636,26651,15233,9.02764e+12,54.6628,15311.7,41884,6149,72,29248,29248,27521,25236,24763
81306,9291,18906,52729,28577,9.90853e+12,60.1281,23944.1,81306,9205,72,62400,62400,48448,35129,31347
56784,20355,26486,34480,22304,6.8988e+12,56.3994,29238.7,56784,12903,72,30298,30298,28099,25054,24557
31243,11056,12390,19360,11883,7.83173e+12,57.4347,14260.9,31243,6036,72,18853,18853,18401,17758,17853
18510,1268,4353,12004,6506,9.88444e+12,59.8481,5848.21,18510,2115,72,14157,14157,8124,8070,4380
27787,5502,11355,17158,10629,7.66184e+12,57.2312,13038.4,27787,5527,72,16432,16432,12649,8274,8209
89490,4577,29043,56568,32922,8.72639e+12,58.6786,33944.7,89490,14149,72,60447,60399,40724,18301,15922
36754,5669,10518,23488,13266,9.24479e+12,59.1989,12960.7,36754,5124,72,26236,26236,20922,20777,14595
53044,11518,22522,32601,20443,7.43349e+12,57.0387,25289.6,53044,10966,72,30522,30522,25663,18972,17580
84998,3094,26476,53925,31073,8.89693e+12,58.7994,31246.1,84998,12892,72,58522,58522,29630,24507,8232
59366,4097,13844,38499,20867,9.89811e+12,60.0335,17702.9,59366,6722,72,45522,45522,31386,31107,14040
25225,4289,5928,16358,8867,9.92516e+12,59.9649,7836.09,25225,2887,72,19297,19297,17383,16930,14327
27280,1301,9234,17184,10096,8.55368e+12,58.326,11048.4,27280,4486,72,18046,18046,9538,4970,4359
92324,48763,49024,72307,20017,79516400000,8.99756,49633.1,92324,44116,11,43300,43300,43144,43153,43151
21862,5041,6072,14011,7851,9.3618e+12,59.2291,7698.48,21862,2954,72,15790,15790,15247,14603,14524
86274,1826,4371,68456,17818,5.80434e+13,12.0015,5342.69,86274,3415,20,81903,81903,61878,45155,72177
6002,249,1497,3884,2118,9.74411e+12,58.9572,2124.64,6002,719,72,4505,4505,1770,855,879
1746,888,951,1368,378,79728900000,8.8488,1026.03,1746,852,11,795,795,749,753,755
6816,1008,1879,4372,2444,9.49502e+12,58.7955,2550.8,6816,909,72,4937,4937,3783,3743,2612
99741,19295,25307,64311,35430,9.63112e+12,58.4377,31170.3,99741,12307,72,74434,74434,70545,69653,64091
38652,8233,16656,23714,14938,7.35895e+12,56.022,18781.3,38652,8108,72,21996,21996,17877,16722,11054
47579,8289,11095,30858,16721,9.91582e+12,60.0727,14300,47579,5398,72,36484,36484,33157,32374,27648
62336,18741,21321,39215,23121,8.50654e+12,58.3761,24851.6,62336,10386,72,41015,41015,39269,36847,36510
85489,1360,19860,55434,30055,9.91514e+12,60.1376,25119.9,85489,9669,72,65629,65629,20887,5336,5497
24687,8751,12098,19271,5416,78557800000,8.9902,12424.1,24687,10885,11,12589,12589,9929,10257,9617
89404,19741,30289,56290,33114,8.53484e+12,58.364,35101.9,89404,14741,72,59115,59115,50632,39053,36316
87283,8737,41660,52825,34458,6.75178e+12,55.7634,45527.4,87283,20289,72,45623,45623,29952,11676,11022
58140,9497,20177,36528,21612,8.43701e+12,58.2919,23493.2,58140,9823,72,37963,37963,33614,29905,28853
43700,17655,23819,25929,17771,5.88531e+12,54.7654,25778.6,43700,11587,72,19881,19881,18275,16803,16609
79570,16745,18506,51599,27971,9.91065e+12,60.128,23451.9,79570,9009,72,61064,61064,59004,56265,55685
62668,16602,18360,39971,22697,9.13193e+12,58.9424,22133.8,62668,8922,72,44308,44308,42792,41006,41166
85147,47063,50190,49853,35294,5.30101e+12,54.4625,53287.5,85147,24442,72,34957,34957,33138,31420,31162
44321,2615,10362,28742,15579,9.89879e+12,60.0336,13383.2,44321,5035,72,33959,33959,18031,18021,8928
58469,6694,14730,37719,20750,9.66639e+12,59.7943,18458.3,58469,7172,72,43739,43739,33501,32495,19798
77755,9901,25650,49080,28675,8.65248e+12,58.5752,29972,77755,12487,72,52105,52105,40031,25878,25375
80090,10892,37616,48585,31505,6.84784e+12,55.8082,41258,80090,18303,72,42474,42474,29193,18078,14892
25614,8507,10131,15871,9743,7.84626e+12,56.71,11736,25614,4929,72,15483,15483,14253,12549,12385
77584,2026,31176,47991,29593,7.72753e+12,57.4413,35097.1,77584,15183,72,46408,46408,27223,11205,3871
26254,6284,9447,16438,9816,8.28237e+12,57.9725,11157.8,26254,4597,72,16807,16807,14545,12448,11944
83174,12106,19331,53933,29241,9.91123e+12,60.1302,24468.7,83174,9407,72,63843,63843,55178,53150,40550
39432,7840,9183,25582,13850,9.91305e+12,60.0457,11930.8,39432,4464,72,30249,30249,28623,26479,26044
59061,16780,20355,37136,21925,8.46883e+12,58.1192,23722.5,59061,9899,72,38706,38706,36850,34403,33875
88217,10440,44767,52931,35286,6.36337e+12,54.6745,48476,88217,21792,72,43450,43450,30419,18370,15088
17181,6114,8128,10419,6762,6.84025e+12,56.0918,9188.19,17181,3954,72,9053,9053,8150,6882,6816
6357,165,1558,4116,2241,9.9124e+12,59.2539,2214.72,6357,759,72,4799,4785,1687,593,637
3270,382,1338,2027,1243,7.81296e+12,52.0835,1680.02,3270,629,60,1932,1884,1039,678,740
44141,11435,19168,27047,17094,7.31842e+12,56.2624,21518.3,44141,9332,72,24973,24973,21593,16920,16039
32410,6297,10135,20570,11840,8.88145e+12,58.7537,12278.8,32410,4932,72,22275,22275,19192,15054,14119
34611,4159,12400,21682,12929,8.31628e+12,58.0509,14536,34611,6041,72,22211,22211,15676,8084,7828
13578,1599,3218,8806,4772,9.90956e+12,59.7313,4391.42,13578,1560,72,10360,10360,8493,6013,5499
63299,11572,15530,40910,22389,9.74062e+12,59.9025,19548.2,63299,7553,72,47769,47769,42319,37115,35761
32655,7178,9079,20917,11738,9.33624e+12,58.9615,11325.3,32655,4416,72,23576,23576,22255,20528,20186
51063,16142,21744,31381,19682,7.41613e+12,57.0101,24422.7,51063,10581,72,29319,29319,26447,22467,21745
83021,23457,26603,52542,30479,8.7806e+12,58.7393,31226.8,83021,12955,72,56418,56418,54854,52767,52399
35696,10609,10766,22726,12970,9.03003e+12,58.9536,13113.8,35696,5240,72,24930,24930,24845,24795,24823
23851,3733,5955,15401,8450,9.71186e+12,59.6694,7751.77,23851,2892,72,17896,17896,15299,11799,11035
51230,1361,12585,33102,18128,9.75226e+12,59.877,15946.6,51230,6129,72,38645,38645,13497,3660,3450
58052,1200,28436,45315,12737,78536700000,8.99576,28940.8,58052,25589,11,29616,29616,8002,10667,5356
88751,16302,20594,57560,31191,9.92167e+12,60.1451,26026.1,88751,10032,72,68157,68157,62980,55960,54347
84781,31614,42040,51035,33746,6.50915e+12,55.9467,45700.9,84781,20467,72,42741,42741,37931,33382,32308
19718,6757,8167,12164,7554,7.60125e+12,57.0521,9444.15,19718,3973,72,11551,11551,10324,8879,9054
51050,21638,23739,31003,20047,6.91746e+12,56.3775,26266.5,51050,11564,72,27311,27311,26769,26105,26031
23788,3225,5611,15425,8363,9.89267e+12,59.9191,7432.09,23788,2729,72,18177,18177,15348,14680,10720
37219,5561,11587,23626,13593,8.90829e+12,58.8132,13986.4,37219,5642,72,25632,25632,20851,14643,13177
80313,14232,24345,51079,29234,8.99548e+12,58.8845,28937.9,80313,11845,72,55968,55968,47011,44821,31879
55686,2506,12944,36120,19566,9.92001e+12,60.0975,16601,55686,6302,72,42742,42742,19885,20292,8949
51678,1296,19494,32198,19480,8.05819e+12,57.792,22383,51678,9493,72,32184,32184,19262,8739,3598
6279,1501,3082,4902,1377,78463900000,8.94824,3242.03,6279,2765,11,3197,3197,1951,2103,1815
21560,712,1012,17090,4470,5.82824e+13,11.9908,1489.25,21560,902,14,20548,20548,18139,16119,19470
60170,297,13963,39033,21137,9.92381e+12,60.1163,17867.3,60170,6800,72,46207,46207,26233,16787,1653
7164,1626,1692,4654,2510,9.98489e+12,59.4195,2416.35,7164,819,72,5472,5472,5410,5418,5411
14756,2512,6420,9057,5699,7.31083e+12,56.1773,7414.47,14756,3114,72,8336,8336,6087,4011,3506
95800,1702,22276,62120,33680,9.90874e+12,60.1312,28076.7,95800,10839,72,73524,73524,43528,42928,6516
39128,8344,12442,24791,14337,8.82904e+12,58.7177,14920.6,39128,6060,72,26686,26686,23764,19843,18978
56254,14374,14426,36248,20006,9.61292e+12,59.7182,18017,56254,7024,72,41828,41828,41772,41762,41763
69748,18180,29940,42808,26940,7.37877e+12,56.9864,33384.7,69748,14585,72,39808,39808,34328,27960,27906
59703,1179,19874,37656,22047,8.61555e+12,58.5202,23326.1,59703,9673,72,39829,39781,16177,15380,4564
28022,9984,12589,17104,10918,7.15166e+12,56.5752,14186,28022,6131,72,15433,15433,14745,14713,14151
86017,1215,26908,54560,31457,8.87085e+12,58.856,31720.8,86017,13097,72,59109,59061,34821,17807,4935
68998,7529,16055,44748,24250,9.907e+12,60.1063,20436.1,68998,7807,72,52943,52943,41877,39861,25330
32463,5884,7575,21050,11413,9.91603e+12,60.0418,9921.4,32463,3686,72,24888,24888,22390,22346,19485
50450,16845,28141,29827,20623,5.70582e+12,54.4235,30288,50450,13690,72,22309,22309,17948,12896,12912
36737,9194,13404,22967,13770,8.22157e+12,57.9378,15627.3,36737,6523,72,23333,23333,19640,15301,15344
65672,5140,18916,41937,23735,9.19828e+12,59.237,22860,65672,9210,72,46756,46756,32168,31802,14318
59675,9193,15554,38395,21280,9.56127e+12,59.2968,19310.7,59675,7571,72,44121,44121,36826,26895,24564
96855,14835,22497,62803,34052,9.91792e+12,60.1503,28352.5,96855,10960,72,74358,74358,63196,62970,49555
32879,4645,7686,21322,11557,9.89446e+12,60.0077,10055.4,32879,3730,72,25193,25193,21579,20729,15577
7191,120,312,5692,1499,5.85444e+13,11.9726,583.249,7191,308,13,6879,6879,5176,3693,6117
73395,11652,28646,45558,27837,7.87089e+12,57.6098,32448.9,73395,13943,72,44749,44749,31185,18605,15025
24690,4107,5813,16012,8678,9.8991e+12,59.9366,7689.85,24690,2828,72,18877,18877,16465,16409,13671
12304,4214,4317,7732,4572,8.44412e+12,57.8878,5277.37,12304,2099,72,7987,7987,7871,7816,7818
8711,1260,2324,5608,3103,9.58038e+12,59.0623,3136.16,8711,1123,72,6387,6387,4956,4915,3366
60104,3219,16965,38458,21646,9.27122e+12,59.3159,20652.4,60104,8260,72,43139,43139,27493,9053,8327
85568,22363,28059,54046,31522,8.67851e+12,58.6227,32760.8,85568,13664,72,57509,57509,51647,44794,44614
12261,2119,2919,7945,4316,9.86329e+12,59.6897,4006.27,12261,1408,72,9342,9342,8485,7403,7221
68604,11784,68604,0,68604,7.99988,0,68604,68604,68604,1,0,0,0,0,0
94349,4692,29316,59878,34471,8.90572e+12,58.8892,34532.2,94349,14276,72,65033,65033,42181,41312,14148
77801,1318,18114,50455,27346,9.90616e+12,60.1166,22964.1,77801,8815,72,59687,59687,19126,4943,5186
57246,17046,28660,34412,22834,6.45632e+12,55.7038,31286.2,57246,13956,72,28586,28586,23167,16935,16745
33295,5114,9479,21290,12005,9.25897e+12,59.2255,11741.1,33295,4617,72,23816,23816,20083,19137,13924
6655,446,2018,4233,2422,9.12772e+12,57.8675,2659.35,6655,977,72,4637,4589,2586,2302,1057
70669,15558,21711,44895,25774,8.95951e+12,58.9353,25806,70669,10577,72,48958,48958,43682,38689,37392
11974,3500,5790,7237,4737,6.68603e+12,53.9299,6585.97,11974,2806,72,6184,6184,5278,4030,3924
26948,479,11658,16536,10412,7.3319e+12,56.8245,13248.8,26948,5673,72,15290,14858,7841,2978,1489
66651,27183,31291,40429,26222,6.85082e+12,55.7132,34417.6,66651,15229,72,35360,35360,32546,28745,27904
32801,5666,10339,20806,11995,8.86191e+12,58.738,12496,32801,5036,72,22462,22462,19063,18173,13472
20039,4799,6304,12718,7321,8.85417e+12,58.5949,7765.6,20039,3056,72,13735,13735,11829,9636,9660
20482,2180,10818,12218,8264,6.1123e+12,55.2413,11930.8,20482,5264,72,9664,9616,8291,7588,7380
42738,6922,9984,27703,15035,9.90991e+12,60.067,12917.5,42738,4858,72,32754,32754,29095,28238,23054
61360,5093,14247,39800,21560,9.90965e+12,60.1058,18218.5,61360,6927,72,47113,47113,33763,23823,17393
80281,2233,19700,51875,28406,9.73806e+12,59.9124,24613.6,80281,9583,72,60581,60581,36588,15874,7099
18220,127,4325,11802,6418,9.90847e+12,59.8548,5797.67,18220,2106,72,13895,13803,7887,7751,646
33366,620,15330,20304,13062,6.99341e+12,55.6879,17144.2,33366,7446,72,18036,17604,7441,3102,1244
43975,5071,10283,28512,15463,9.89599e+12,60.0397,13284.8,43975,5005,72,33692,33692,27491,26035,17102
2895,1063,1112,1809,1086,8.23634e+12,55.9689,1431.07,2895,535,65,1783,1783,1722,1728,1723
5621,1883,1977,3539,2082,8.53434e+12,57.2001,2511.03,5621,954,71,3644,3644,3545,3510,3510
27745,2437,8615,17621,10124,8.93691e+12,58.7557,10510.2,27745,4195,72,19130,19130,12113,7487,6007
61091,4511,23068,38061,23030,8.03883e+12,57.7983,26387.3,61091,11227,72,38023,38023,24296,8172,7702
20036,1109,4683,13000,7036,9.94547e+12,59.9248,6274.94,20036,2280,72,15353,15353,7872,7894,3919
89974,10345,20875,58348,31626,9.91929e+12,60.1463,26373.8,89974,10163,72,69099,69099,56434,53475,35014
97997,20086,53102,76816,21181,79797300000,8.97939,53720.3,97997,47784,11,44895,44895,24821,26010,23651
20778,4204,6438,13196,7582,8.93493e+12,58.0602,7952.58,20778,3113,72,14340,14340,11839,8917,8988
44233,9067,10256,28690,15543,9.93427e+12,60.0987,13278.8,44233,4996,72,33977,33977,32520,32189,30236
74599,4257,34324,45386,29213,6.97697e+12,56.4708,37804.4,74599,16719,72,40275,40275,24741,6625,6068
98291,7461,22837,63741,34550,9.91181e+12,60.1432,28768,98291,11119,72,75454,75454,47002,29215,25481
71183,9123,16599,46153,25030,9.90588e+12,60.107,21092.6,71183,8081,72,54584,54584,43699,33266,30422
61270,9367,15485,39522,21748,9.64618e+12,59.7852,19362.6,61270,7535,72,45785,45785,39040,29853,27708
51941,7208,20853,32137,19804,7.7388e+12,57.4058,23660.6,51941,10156,72,31088,31088,21219,11766,9301
63367,11561,32670,37926,25441,6.26721e+12,55.5935,35448.3,63367,15910,72,30697,30697,22207,14220,12067
11321,457,2717,7343,3978,9.8424e+12,59.4533,3735.42,11321,1310,72,8604,8604,5287,5228,1345
87476,13583,20307,56725,30751,9.92023e+12,60.1417,25669.7,87476,9893,72,67169,67169,57304,47861,45257
25354,4240,8203,16050,9304,8.73894e+12,58.5315,9944.3,25354,3987,72,17151,17151,14125,13370,9142
93698,8809,21722,60762,32936,9.92342e+12,60.1544,27415.4,93698,10577,72,71976,71976,51578,49592,29930
73199,1248,30081,45159,28040,7.60879e+12,56.6041,33769.6,73199,14639,72,43118,43118,18695,2242,1753
65932,3646,4306,52533,13399,5.71479e+13,11.9968,5141.11,65932,2689,14,61626,61626,57263,54029,59662
97934,8030,48128,59030,38904,6.57397e+12,56.0285,52286.2,97934,23446,72,49806,49806,27882,13216,8292
11592,5364,6068,6924,4668,6.17172e+12,53.2001,6799.83,11592,2941,72,5524,5524,5194,4698,4820
63273,12351,14671,41034,22239,9.92396e+12,60.1262,18745.9,63273,7142,72,48602,48602,45173,41927,41111
85972,12262,35417,53016,32956,7.59601e+12,56.9104,39631,85972,17248,72,50555,50555,31829,19728,15647
59511,528,22601,37048,22463,8.01368e+12,57.7675,25839.3,59511,11005,72,36910,36228,18658,6475,2304
86987,35437,42805,52421,34566,6.55941e+12,55.9939,46569.5,86987,20831,72,44182,44182,40352,35950,35841
60565,20269,23266,37654,22911,7.95857e+12,57.6966,26531.4,60565,11326,72,37299,37299,36003,34579,34610
7544,1791,1848,4882,2662,9.80288e+12,59.2598,2594.79,7544,895,72,5696,5696,5641,5637,5639
21367,170,4982,13855,7512,9.96355e+12,59.9599,6657.11,21367,2427,72,16385,16371,4420,5023,818
1306,308,345,841,465,1.0428e+13,56.3538,549.736,1306,166,48,961,961,923,915,931
29544,2976,10830,18463,11081,8.21493e+12,57.5212,12690.9,29544,5276,72,18714,18714,10722,10825,4217
71564,2548,22062,45442,26122,8.93879e+12,58.9277,26200.1,71564,10748,72,49502,49502,30999,12865,8351
11657,4045,5887,7009,4648,6.42916e+12,52.9935,6643.95,11657,2845,72,5770,5770,5038,4277,4323
59353,12722,15530,38195,21158,9.53678e+12,59.6445,19266.9,59353,7560,72,43823,43823,40479,39694,34961
10910,1653,2613,7078,3832,9.88729e+12,59.617,3603.78,10910,1269,72,8297,8297,7122,6856,5316
28658,5734,9106,18164,10494,8.81119e+12,58.6194,11036.8,28658,4421,72,19552,19552,17259,14189,13516
70490,7169,25359,44135,26355,8.26371e+12,58.093,29189.8,70490,12343,72,45131,45131,29036,18783,15180
7130,2545,2933,4412,2718,7.64481e+12,52.621,3531.02,7130,1406,72,4197,4197,4197,4197,4197
1813,272,462,1175,638,1.03296e+13,57.2052,722.221,1813,225,53,1351,1351,1077,871,919
87076,18412,20229,56470,30606,9.91692e+12,60.1344,25570.8,87076,9844,72,66847,66847,64646,64145,61082
2343,632,1075,1434,909,7.26908e+12,47.3047,1327.34,2343,517,59,1268,1268,1075,899,901
28956,5223,6774,18770,10186,9.92084e+12,60.0035,8907.34,28956,3300,72,22182,22182,19889,19847,17249
54515,25514,26711,42556,11959,78535800000,8.99538,27199.9,54515,24034,11,27804,27804,26867,26980,26774
52684,6724,12252,34160,18524,9.9195e+12,60.0969,15743.5,52684,5962,72,40432,40432,33730,32177,22499
88270,3866,20486,57243,31027,9.9178e+12,60.1447,25895.3,88270,9974,72,67784,67784,43532,43049,13653
59692,806,16932,38170,21522,9.24494e+12,59.2786,20593.2,59692,8234,72,42760,42568,25055,24618,3319
41820,11584,21178,25101,16719,6.39413e+12,55.7281,23193.5,41820,10317,72,20642,20642,15853,11302,10233
67019,19493,27298,41390,25629,7.65394e+12,56.9543,30741,67019,13284,72,39721,39721,36295,31658,30603
50716,8360,18160,31765,18951,8.29509e+12,56.6994,21082.4,50716,8824,72,32556,32556,24346,14649,14464
41273,12703,21390,24685,16588,6.23138e+12,54.408,23350,41273,10415,72,19883,19883,16046,11661,11558
79711,7623,18537,51686,28025,9.91446e+12,60.1292,23490.1,79711,9024,72,61174,61174,44262,29857,25805
51938,14275,20190,32252,19686,7.90319e+12,57.5985,23046.5,51938,9825,72,31748,31748,29020,25230,24556
55986,14700,17824,35449,20537,8.81222e+12,53.3279,21153,55986,8678,72,38162,38162,33533,28132,27980
96977,45592,46983,58569,38408,6.66663e+12,56.141,51152.2,96977,22889,72,49994,49994,49497,48796,48860
63718,9183,19360,40510,23208,8.99481e+12,58.9713,23134.7,63718,9426,72,44358,44358,33629,23328,20623
91063,19568,28412,57771,33292,8.88428e+12,58.8766,33468.9,91063,13834,72,62651,62651,56948,49076,47410
90879,3708,36024,56301,34578,7.79964e+12,57.5322,40535.3,90879,17547,72,54855,54855,26698,7061,5110
13865,1951,3299,8989,4876,9.82843e+12,59.6647,4491.73,13865,1591,72,10566,10566,9037,7029,6622
40241,5565,15549,24997,15244,7.94301e+12,57.6405,17877.2,40241,7575,72,24692,24692,16484,10919,9084
81626,785,26014,51682,29944,8.80539e+12,58.7663,30580.8,81626,12668,72,55612,55564,31932,16610,2811
58172,621,13563,37711,20461,9.90601e+12,60.097,17356.3,58172,6603,72,44609,44609,25845,25456,2770
2697,31,662,1750,947,1.01025e+13,58.3081,1014.02,2697,322,59,1384,256,730,564,109
12464,1948,3295,8019,4445,9.56543e+12,59.2704,4363.34,12464,1598,72,9169,9169,7795,5893,5681
35832,4313,14701,22118,13714,7.64868e+12,57.2391,16752.6,35832,7161,72,21131,21131,14700,7241,7003
77298,18370,25703,48769,28529,8.61556e+12,58.5367,29990.2,77298,12515,72,51595,51595,46036,38499,36751
24548,3678,5721,15924,8624,9.93891e+12,59.99,7591.18,24548,2786,72,18827,18827,15805,15752,12250
37067,7074,8633,24037,13030,9.92122e+12,60.05,11243.4,37067,4199,72,28434,28434,26525,26087,23470
23219,5912,11220,14033,9186,6.72378e+12,55.9897,12530.3,23219,5466,72,11999,11999,9615,6849,6968
73394,1206,17048,47603,25791,9.90924e+12,60.1226,21668.3,73394,8295,72,56346,56346,33267,21721,4839
52090,12009,12117,33777,18313,9.9236e+12,60.0941,15573.3,52090,5903,72,39973,39973,39837,39758,39796
18923,6797,9446,11382,7541,6.48098e+12,55.3492,10545,18923,4585,72,9477,9477,8477,7062,6964
70194,12091,31743,42789,27405,7.08516e+12,56.639,35092.7,70194,15461,72,38451,38451,26913,16246,13253
13539,1939,5473,8367,5172,7.7575e+12,56.2448,6443.33,13539,2661,72,8066,8066,6157,3940,4083
26488,5291,6159,17186,9302,9.94499e+12,60.0106,8148.37,26488,2999,72,20329,20329,19054,19031,17668
14083,5655,7851,11053,3030,80138200000,8.94206,8074.31,14083,7059,11,6232,6232,4868,4958,4798
3259,317,807,2112,1147,1.00161e+13,58.3369,1207.13,3259,390,62,2452,2452,1684,1167,1089
84686,8552,25776,53833,30853,8.99e+12,58.9983,30572.3,84686,12554,72,58910,58910,41912,41473,21103
87169,10874,20308,56520,30649,9.90638e+12,60.124,25650,87169,9888,72,66861,66861,53179,40058,36425
23503,419,7557,14881,8622,8.81055e+12,58.5688,9195.78,23503,3680,72,15946,15817,9030,4118,761
31212,7769,8868,19959,11253,9.25863e+12,59.2122,11015.8,31212,4315,72,22344,22344,20729,18910,18917
24872,2694,5855,16132,8740,9.8896e+12,59.944,7743.66,24872,2849,72,19017,19017,14447,10383,8981
66986,4116,21606,42382,24604,8.74886e+12,58.6828,25453,66986,10521,72,45380,45332,22800,26698,14080
9769,1893,3599,6112,3657,8.19476e+12,57.4294,4394.46,9769,1735,72,6170,6170,4959,3605,3664
11555,2183,6149,9050,2505,79551400000,8.98027,6358.52,11555,5528,11,5406,5406,2717,2953,2499
5776,561,2406,3566,2210,7.66684e+12,56.0976,2910.92,5776,1168,72,3370,3322,2607,1843,1893
22152,346,5167,14370,7782,9.9185e+12,59.9668,6895.56,22152,2511,72,16985,16985,9942,9804,1399
72146,15548,25759,45197,26949,8.30608e+12,58.135,29675.4,72146,12543,72,46387,46387,37813,26114,23378
45396,6751,10532,29453,15943,9.92993e+12,60.0969,13619.1,45396,5129,72,34864,34864,30314,29259,22756
79310,15726,25179,50244,29066,8.80507e+12,58.765,29643.2,79310,12252,72,54131,54131,45128,44845,34199
72315,15873,19637,46405,25910,9.40544e+12,59.4947,23999.5,72315,9555,72,52678,52678,49131,48259,43267
12658,1059,5173,7825,4833,7.66996e+12,57.0006,6091.49,12658,2513,72,7485,7467,4791,1716,1665
58047,722,13482,37649,20398,9.91758e+12,60.1051,17270.6,58047,6561,72,44565,44565,13287,14758,3051
81913,25741,30954,51005,30908,8.03994e+12,57.831,35194.8,81913,15080,72,50959,50959,46766,40981,39828
39733,6728,15097,24734,14999,8.01604e+12,57.4705,17425.5,39733,7348,72,24636,24636,17696,9523,9404
57123,17169,22491,35420,21703,7.83196e+12,57.535,25561,57123,10945,72,34632,34632,30759,25522,24321
96027,10434,22320,62266,33761,9.91481e+12,60.1408,28130.8,96027,10867,72,73707,73707,58398,55561,35357
2615,760,1040,1623,992,8.03374e+12,46.4099,1333.57,2615,496,55,1575,1575,1194,828,894
62901,22692,22892,39333,23568,8.22476e+12,58.029,26351.4,62901,11151,72,40009,40009,39726,39481,39546
38100,1236,11376,24269,13831,9.07486e+12,59.0009,13857.4,38100,5531,72,26724,26724,12361,11374,4267
82686,18168,31072,51521,31165,8.07112e+12,57.8559,35355.1,82686,15137,72,51614,51614,40272,29422,26511
54435,25438,28692,32462,21973,6.12218e+12,55.4331,31100.5,54435,13978,72,25743,25743,24135,22274,22414
20055,604,4704,13007,7048,9.8943e+12,59.8905,6297.03,20055,2286,72,15351,15351,9391,9270,2184
46373,4539,12468,29773,16600,9.4575e+12,59.5083,15483.5,46373,6074,72,33905,33905,22315,22950,13177
14299,5885,6427,8732,5567,7.1469e+12,55.7313,7382.72,14299,3123,72,7872,7872,7694,7491,7659
73120,1414,26235,45777,27343,8.28469e+12,54.5175,30188.3,73120,12775,72,46885,46885,16867,6390,0
45869,10600,10636,29753,16116,9.94803e+12,60.0993,13746,45869,5181,72,35233,35233,35191,35201,35203
51301,25393,28117,30411,20890,5.84335e+12,54.4896,30334.1,51301,13675,72,23184,23184,21842,20562,20432
29393,7031,13650,17855,11538,6.95334e+12,55.65,15276,29393,6643,72,15743,15743,12365,8423,8489
40200,6801,10167,25930,14270,9.66347e+12,59.7387,12896.1,40200,4950,72,30033,30033,25794,25686,20741
77173,17400,30377,47849,29324,7.83487e+12,57.2421,34325.3,77173,14782,72,46796,46796,35209,21523,21164
68221,7118,32406,41326,26895,6.79075e+12,55.7843,35562.7,68221,15771,72,35815,35815,21274,10735,7453
33530,11481,13435,20744,12786,7.76333e+12,57.1832,15407.8,33530,6539,72,20095,20095,19062,17622,17525
72010,18323,31923,44018,27992,7.19043e+12,56.7778,35393.2,72010,15545,72,40087,40087,33473,24356,22388
47213,4592,11002,30620,16593,9.92052e+12,60.0795,14186.8,47213,5358,72,36211,36211,26403,18018,15602
69221,12835,17755,44605,24616,9.59618e+12,58.1916,22033.8,69221,8627,72,51466,51466,47486,47415,42734
60173,8240,25205,37045,23128,7.5011e+12,57.1382,28302.7,60173,12264,72,34968,34968,24604,17236,14823
2330,289,588,1506,824,9.98986e+12,57.8009,902.243,2330,281,58,1742,1742,1313,886,988
11429,1325,2728,7414,4015,9.88526e+12,59.6254,3754.03,11429,1325,72,8701,8701,6626,6591,4255
79573,12344,27210,50060,29513,8.50465e+12,58.3826,31546,79573,13255,72,52363,52363,39941,25872,22399
90556,31413,46007,54316,36240,6.35729e+12,55.4654,49795.3,90556,22397,72,44549,44549,37951,28965,26869
60541,8668,20073,38206,22335,8.6392e+12,58.5201,23565.1,60541,9770,72,40468,40468,35260,35152,28975
45393,9834,11532,29270,16123,9.64303e+12,59.7339,14544.2,45393,5613,72,33861,33861,31777,29023,28431
62842,2556,14634,40755,22087,9.91067e+12,60.1123,18680.9,62842,7126,72,48208,48208,30606,20610,8961
77648,38040,42700,46007,31641,5.81291e+12,55.0815,45794.6,77648,20797,72,34948,34948,33246,31282,31433
75739,26620,75739,0,75739,7.99989,0,75739,75739,75739,1,0,0,0,0,0
48647,3169,14418,31003,17644,9.09433e+12,59.0651,17458.8,48647,7020,72,34229,34229,22202,21897,7513
84466,11813,22519,54256,30210,9.47722e+12,59.2552,27525.8,84466,10964,72,61947,61947,50781,35415,31939
82291,28590,30395,51384,30907,8.14449e+12,57.9526,34702.1,82291,14800,72,51896,51896,50148,48473,48231
30393,5005,8013,19547,10846,9.52676e+12,59.5292,10164.8,30393,3897,72,22380,22380,19456,15513,14664
82492,17205,35439,50624,31868,7.36931e+12,56.9944,39402.3,82492,17262,72,47053,47053,40006,31766,31645
95798,27515,47781,57611,38187,6.47178e+12,55.9028,51817.6,95798,23261,72,48017,48017,40774,30899,28592
3880,77,936,2521,1359,1.00945e+13,58.7807,1394.12,3880,455,66,2944,2286,1680,1659,319
66581,25417,36556,39454,27127,5.83255e+12,55.0872,39286.5,66581,17802,72,30025,30025,26731,22186,21333
4648,594,1121,3018,1630,1.00756e+13,58.9213,1642.15,4648,542,71,3527,3527,2884,2108,1995
58405,18450,19137,36896,21509,8.6903e+12,58.5864,22543.3,58405,9314,72,39268,39268,38386,37338,37526
16009,3555,4627,10235,5774,9.20323e+12,58.9291,5888.91,16009,2241,72,11382,11382,10193,8654,8353
60186,18616,21214,37758,22428,8.37642e+12,58.2028,24598.2,60186,10335,72,38972,38972,37496,35450,35200
70367,13157,24971,44121,26246,8.32655e+12,58.1711,28820.6,70367,12156,72,45396,45396,37143,27525,27188
50021,3930,16843,31525,18496,8.5805e+12,57.741,19806.3,50021,8189,72,33178,33178,20169,9955,7885
65396,7684,30992,39619,25777,6.79772e+12,55.7959,34050.4,65396,15076,72,34404,34404,20421,10464,7342
92005,2738,35745,57116,34889,7.90162e+12,57.3866,40356.8,92005,17408,72,56260,56260,25639,5711,4553
5756,1824,3877,3284,2472,4.38848e+12,25.2257,4208.66,5756,1883,58,1879,1879,1070,70,0
45878,2365,10698,29751,16127,9.91224e+12,60.0782,13810.5,45878,5208,72,35180,35180,23040,22798,8166
16520,1497,5745,10383,6137,8.45425e+12,57.6487,6958.39,16520,2781,72,10775,10775,6025,3850,2961
35210,7699,8217,22835,12375,9.91241e+12,60.0158,10718.4,35210,3993,72,26993,26993,26261,26246,25523
13305,1384,5709,8173,5132,7.42475e+12,56.696,6636.97,13305,2774,72,7596,7596,4293,2139,1616
76812,10359,22358,49017,27795,9.15776e+12,59.2015,26845.6,76812,10889,72,54454,54454,41873,27087,26526
77837,25654,36036,47307,30530,6.93661e+12,55.4363,39630.4,77837,17533,72,41801,41801,36290,28691,27089
28179,1321,6941,18219,9960,9.75138e+12,59.7853,9002.89,28179,3377,72,21238,21238,10584,10227,4692
88830,15568,35516,54987,33843,7.74638e+12,57.4228,39924.4,88830,17280,72,53314,53314,39442,24387,20403
18109,2002,5281,11570,6539,9.17036e+12,58.9512,6665.91,18109,2564,72,12828,12828,8370,5981,5259
76704,2221,22685,48887,27817,9.09304e+12,59.1118,27140.3,76704,11045,72,54019,54019,31797,12632,4532
93222,11694,47598,55871,37351,6.32168e+12,55.5658,51465.8,93222,23166,72,45624,45624,29076,16326,12452
74581,4449,25143,46985,27596,8.56392e+12,58.4578,29274.5,74581,12245,72,49438,49390,33688,15090,14400
71936,12842,24074,45350,26586,8.59467e+12,58.0067,28099.3,71936,11722,72,47862,47862,36946,24098,23656
9444,119,4872,5659,3785,6.31229e+12,51.3542,5509.89,9444,2351,72,4572,4380,1592,155,0
48589,10004,11309,31508,17081,9.92004e+12,60.0956,14573.7,48589,5509,72,37280,37280,35464,33792,33408
35872,8711,11680,22678,13194,8.71277e+12,58.5651,13970,35872,5685,72,24192,24192,22110,22024,19734
77924,9720,18084,50543,27381,9.91421e+12,60.1182,22943.5,77924,8798,72,59840,59840,47668,35983,32746
39208,16225,17483,23950,15258,7.1677e+12,56.2592,19586.5,39208,8509,72,21725,21725,21112,20247,20280
40292,16133,17733,24650,15642,7.24263e+12,56.7681,19899.2,40292,8633,72,22559,22559,22074,21505,21719
9425,1820,2282,6114,3311,9.81933e+12,59.4399,3167.09,9425,1100,72,7143,7143,6609,5958,5878
99289,15697,45563,60415,38874,6.98188e+12,56.5348,49999.3,99289,22183,72,53726,53726,36307,15939,15163
66158,12441,31162,40110,26048,6.83528e+12,56.3298,34260.3,66158,15175,72,34996,34996,26065,18182,16069
1765,325,469,1146,619,9.65358e+12,56.6374,725.008,1765,216,52,1296,1296,1121,1011,1034
42086,15301,15814,26234,15852,8.05381e+12,57.7753,18264.1,42086,7689,72,26272,26272,25554,24789,24833
27061,7934,11974,16557,10504,7.23787e+12,44.1111,13545.5,27061,5816,72,15087,15087,15087,15087,15087
95238,39875,47653,57248,37990,6.45609e+12,55.7379,51657.8,95238,23209,72,47585,47585,43973,39029,37997
55048,14167,17194,34929,20119,8.87998e+12,58.8296,20501.8,55048,8369,72,37854,37854,34427,30368,30429
82136,10951,19091,53262,28874,9.91202e+12,60.134,24174.4,82136,9293,72,63045,63045,53252,50966,36703
86612,6548,20116,56171,30441,9.91108e+12,60.1392,25438.5,86612,9791,72,66496,66496,46680,46289,22289
63948,13155,14887,41467,22481,9.91679e+12,60.1046,18990.8,63948,7249,72,49061,49061,46496,44096,43508
9918,3053,5502,5872,4046,5.83849e+12,53.8629,6121.81,9918,2674,72,4416,4416,3902,3177,3247
14204,2594,3376,9213,4991,9.85326e+12,59.7111,4591.64,14204,1631,72,10828,10828,9816,9781,8745
93884,19908,21828,60875,33009,9.90989e+12,60.1361,27529.2,93884,10625,72,72056,72056,69821,69286,66172
12653,4517,4894,7873,4780,7.94233e+12,57.1005,5838.36,12653,2362,72,7759,7759,7319,6887,6957
81800,22717,24051,52157,29643,9.11821e+12,59.1437,28764.4,81800,11707,72,57749,57749,56765,55481,55256
46921,1524,10940,30426,16495,9.90976e+12,60.0735,14110.1,46921,5323,72,35981,35981,14376,15065,5598
75319,16612,20346,48344,26975,9.4279e+12,59.5214,24866.3,75319,9909,72,54973,54973,51119,45910,44737
12895,1724,3011,8375,4520,9.90685e+12,59.7472,4145.37,12895,1455,72,9884,9884,8324,6260,5844
34791,11064,11803,21917,12874,8.53085e+12,58.3124,14001.3,34791,5735,72,22988,22988,22752,22384,22519
15413,1201,6881,9420,5993,7.18288e+12,56.1393,7896.72,15413,3343,72,8532,8532,5723,3684,2530
67438,10430,15674,43735,23703,9.92541e+12,60.1192,19968.3,67438,7636,72,51764,51764,45506,44035,35021
17837,3591,6058,11243,6594,8.56203e+12,58.2176,7353.9,17837,2946,72,11779,11779,9965,8242,7984
21599,6548,6696,13711,7888,8.94355e+12,58.7417,8252.4,21599,3262,72,14903,14903,14741,14609,14621
51893,8861,15263,33087,18806,9.12439e+12,59.1169,18481,51893,7430,72,36630,36630,28907,19855,19554
45552,3752,18872,28072,17480,7.5778e+12,57.2072,21352.4,45552,9190,72,26680,26680,16826,9881,5016
83810,33212,42805,50232,33578,6.32032e+12,55.7114,46339.7,83810,20847,72,41005,41005,36156,30481,30470
96653,20725,49417,57915,38738,6.30883e+12,55.7062,53397.7,96653,24058,72,47236,47236,39311,30575,28477
52392,4741,12187,33977,18415,9.91529e+12,60.0942,15664.1,52392,5930,72,40205,40205,28057,18590,16138
49053,11521,17395,30763,18290,8.33911e+12,58.1471,20247.7,49053,8469,72,31658,31658,23047,12914,12556
92857,6134,24817,59640,33217,9.46458e+12,59.5861,30242.7,92857,12084,72,68040,68040,45216,44659,17222
60502,10677,17070,38699,21803,9.2805e+12,59.326,20775.1,60502,8316,72,43432,43432,37450,29314,27431
27619,2302,6475,17900,9719,9.90792e+12,59.9902,8530.27,27619,3149,72,21144,21144,15070,14947,7745
4172,1330,1821,2570,1602,7.34975e+12,52.7071,2213.59,4172,864,67,2351,2351,2120,1857,1913
92811,14421,21538,60200,32611,9.91437e+12,60.1447,27185.8,92811,10486,72,71273,71273,62728,60729,48319
24929,11787,24929,0,24929,7.99968,0,24929,24929,24929,1,0,0,0,0,0
1442,473,1442,0,1442,7.99445,0,1442,1442,1442,1,0,0,0,0,0
45415,3046,14398,28776,16639,8.81661e+12,58.7166,17204,45415,6999,72,31017,31017,16104,9553,6783
17698,4875,9897,13891,3807,80180600000,8.91909,10147.6,17698,8900,11,7801,7801,4771,4945,4614
38388,7052,15108,23804,14584,7.83847e+12,57.4943,17327.3,38388,7355,72,23280,23232,13488,1870,1605
6982,728,3849,4143,2839,5.93535e+12,54.4275,4326.43,6982,1874,72,3133,2989,1886,668,571
44910,4244,18742,27652,17258,7.54385e+12,57.0453,21182.7,44910,9124,72,26168,26168,16437,9549,7323
24881,1515,9622,15462,9419,7.9407e+12,56.7823,11211.2,24881,4670,72,15259,15259,10115,4083,4057
1133,188,308,728,405,1.03925e+13,55.632,490.814,1133,146,45,825,825,657,653,595
20533,3594,6101,13081,7452,9.12422e+12,55.255,7619.91,20533,2965,72,14432,14432,10997,7041,6944
76924,14902,17840,49892,27032,9.91936e+12,60.1378,22649.3,76924,8685,72,59084,59084,55475,54650,49506
65998,8612,27120,40719,25279,7.61309e+12,57.2822,30501.3,65998,13206,72,38878,38878,27435,14011,13660
21306,4246,4980,13821,7485,9.93256e+12,59.8974,6651.04,21306,2417,72,16326,16326,15457,14334,14157
53846,4506,14421,34585,19261,9.45771e+12,59.5378,17844.4,53846,7013,72,39425,39425,27365,27076,12624
52255,522,28784,30957,21298,5.80197e+12,54.4614,31022,52255,14000,72,23471,22497,9185,1171,829
59886,3999,16300,38418,21468,9.41377e+12,59.476,20015.4,59886,7940,72,43586,43586,24685,23454,10992
50216,4460,11688,32560,17656,9.90965e+12,60.0815,15044.6,50216,5685,72,38528,38528,27932,27731,14951
89490,7964,28358,56691,32799,8.82157e+12,58.796,33308.5,89490,13810,72,61132,61132,40166,15446,14466
83999,22566,30998,52445,31554,8.15118e+12,57.9564,35384,83999,15088,72,53001,53001,48201,42587,42579
21769,628,6698,13828,7941,8.99721e+12,58.7875,8267.04,21769,3263,72,15071,14975,6571,6244,2351
37654,1774,8841,24414,13240,9.89107e+12,59.9933,11480.6,37654,4295,72,28813,28813,18564,18354,6037
7972,340,1935,5167,2805,9.82833e+12,59.4286,2716.96,7972,936,72,6037,6037,2642,1262,1207
37148,2919,11922,23519,13629,8.76898e+12,58.6301,14292.1,37148,5794,72,25226,25226,16150,5480,5116
25405,9340,11179,15554,9851,7.24079e+12,56.4157,12683.2,25405,5423,72,14226,14226,13183,12028,12094
65223,9373,28132,40017,25206,7.34672e+12,56.6374,31384,65223,13684,72,37091,37091,24503,9659,9249
84897,30201,43601,50846,34051,6.28618e+12,55.6192,47155.2,84897,21237,72,41296,41296,35390,28487,28422
14265,2295,3576,9207,5058,9.75039e+12,59.5646,4775.76,14265,1742,72,10689,10689,9556,9275,7825
57552,13583,28345,34673,22879,6.56988e+12,55.988,31015.1,57552,13807,72,29207,29207,23519,15902,14283
88796,24405,35326,54997,33799,7.77642e+12,57.3486,39744,88796,17190,72,53470,53470,49431,44707,44687
89368,12395,27701,56726,32642,8.90984e+12,58.9053,32688.1,89368,13490,72,61667,61667,50425,37107,36767
54298,23830,54298,0,54298,7.99985,0,54298,54298,54298,1,0,0,0,0,0
71761,10874,16734,46536,25225,9.89733e+12,60.1088,21261.5,71761,8146,72,55027,55027,46554,46375,36242
79922,9313,33710,49165,30757,7.46602e+12,57.117,37616.3,79922,16414,72,46212,46212,31332,21811,18625
86672,9452,30238,54420,32252,8.41074e+12,58.2874,34863.7,86672,14724,72,56434,56434,38122,22810,18190
34315,14576,15045,21001,13314,7.26741e+12,54.5475,16954.6,34315,7323,72,19270,19270,18719,18048,17969
43479,17114,28169,34093,9386,2.2342e+13,5.52547,32306.7,43479,9395,13,15310,15310,13758,14914,10077
36136,1049,1517,28608,7528,5.85818e+13,11.9948,2139.96,36136,1514,13,34619,34619,30430,26737,32752
75326,16455,18673,48636,26690,9.72269e+12,59.8861,23310.4,75326,9096,72,56653,56653,54024,53404,49753
26166,3064,6104,16978,9188,9.8945e+12,59.959,8076.01,26166,2960,72,20062,20062,15691,11546,10449
10880,3952,5218,6598,4282,6.73221e+12,55.5035,5963.22,10880,2520,72,5662,5662,5204,4665,4608
21409,2807,5068,13881,7528,9.89144e+12,59.8853,6741.9,21409,2464,72,16341,16341,13661,10077,9297
99081,52532,54033,58780,40301,5.87903e+12,55.1544,57855.3,99081,26306,72,45048,45048,44985,44934,45013
88504,21027,21652,57197,31307,9.75691e+12,59.9468,26997.1,88504,10543,72,66852,66852,65935,65114,65007
40062,3025,14340,25092,14970,8.31146e+12,58.0755,16744.5,40062,6986,72,25722,25722,16239,5094,4845
85223,13092,20174,55194,30029,9.85284e+12,59.7916,25396.8,85223,9811,72,65049,65049,56560,54577,42251
44537,1886,16770,27746,16791,8.06912e+12,57.8037,19332.6,44537,8166,72,27767,27719,15958,9239,6722
28424,2661,12549,17381,11043,7.2503e+12,56.7207,14185.3,28424,6113,72,15875,15875,10234,3744,3549
88015,29940,33197,54817,33198,8.05013e+12,57.6888,37708.5,88015,16167,72,54818,54818,52406,49986,49642
33220,1193,7762,21548,11672,9.89538e+12,60.0195,10151.5,33220,3775,72,25458,25458,15936,15739,4323
10148,572,2424,6575,3573,9.90211e+12,59.651,3364.37,10148,1177,72,7724,7724,4002,3965,2031
58090,7226,18546,36780,21310,8.79607e+12,58.6316,21977.1,58090,9028,72,39544,39544,28605,18888,16079
25894,2458,6096,16795,9099,9.88851e+12,59.9464,8047.27,25894,2962,72,19798,19798,14528,10305,8189
21137,930,4941,13709,7428,9.93801e+12,59.9003,6601.04,21137,2401,72,16196,16196,10381,7057,3350
61556,20074,29305,37276,24280,6.77896e+12,56.2459,32200.1,61556,14271,72,32251,32251,28149,23354,23382
1833,289,493,1194,639,9.60621e+12,56.3993,753.238,1833,226,52,1340,1340,1078,890,904
58284,7168,34728,34062,24222,5.2309e+12,54.0433,36968.8,58284,16903,72,23556,23556,14066,7245,5195
47775,9097,16637,30017,17758,8.41375e+12,52.2323,19452.7,47775,8082,72,31138,31138,29133,26856,26833
80783,13202,24241,51414,29369,9.04486e+12,58.9343,28873.5,80783,11803,72,56542,56542,45508,45221,32066
97441,1590,24727,62816,34625,9.63124e+12,59.7986,30473.6,97441,12029,72,72714,72714,26193,14468,6392
13976,2687,6171,8565,5411,7.25115e+12,54.7591,7117.24,13976,2986,72,7805,7805,5708,3321,3331
43502,902,12067,27877,15625,9.33793e+12,59.3544,14902.9,43502,5870,72,31435,31368,11358,11763,2806
27954,7533,13131,16967,10987,6.85483e+12,55.5886,14680.7,27954,6385,72,14823,14823,12167,9083,9186
41545,7435,9705,26935,14610,9.92106e+12,60.0594,12568.5,41545,4728,72,31840,31840,29149,25550,24750
93177,12729,21679,60422,32755,9.90745e+12,60.1318,27340.3,93177,10555,72,71498,71498,60776,46127,42664
61762,5904,14379,40045,21717,9.91843e+12,60.1078,18364.1,61762,7005,72,47383,47383,35016,24962,19879
38157,6377,9672,24602,13555,9.64174e+12,59.5685,12290.5,38157,4695,72,28485,28485,24030,18824,18692
1261,176,339,811,450,1.0351e+13,55.9833,536.021,1261,165,48,922,922,733,571,578
21188,1488,5010,13732,7456,9.88741e+12,59.8903,6671.91,21188,2434,72,16178,16178,9448,9242,4917
52154,12034,15419,33248,18906,9.1113e+12,59.0993,18643,52154,7507,72,36735,36735,33889,33198,29207
60543,13406,14111,39253,21290,9.90268e+12,60.1004,18035.3,60543,6861,72,46432,46432,45672,44608,44575
54101,18530,20489,33688,20413,8.02798e+12,56.994,23489.2,54101,9959,72,33612,33612,32181,30218,29950
11111,3876,3925,6972,4139,8.43065e+12,50.3605,4815.34,11111,1906,72,7186,7186,7137,7143,7132
16471,935,7791,9990,6481,6.82516e+12,56.0679,8819.2,16471,3783,72,8680,8488,4199,1491,721
49304,4541,19399,30574,18730,7.84178e+12,57.5348,22121.9,49304,9444,72,29905,29905,16674,9629,7027
94008,17924,25121,60387,33621,9.45751e+12,59.584,30606.4,94008,12226,72,68887,68887,60869,51440,51146
94288,15526,34914,58852,35436,8.12886e+12,57.7651,39745.1,94288,16987,72,59374,59374,45499,28822,24772
85015,7763,35049,52431,32584,7.59305e+12,57.2696,39218.5,85015,17064,72,49966,49966,31816,19173,14941
73043,2005,22972,46310,26733,8.86073e+12,58.8228,27149.2,73043,11191,72,50071,50023,24900,20861,7181
74498,20208,21165,47625,26873,9.25163e+12,59.3076,25569.7,74498,10311,72,53333,53333,52423,51551,51550
78065,21814,21984,49940,28125,9.2835e+12,59.3496,26581.5,78065,10710,72,56081,56081,55890,55718,55722
14836,4172,6663,9066,5770,7.1939e+12,56.4237,7639.92,14836,3245,72,8173,8173,7318,6142,6080
63011,3768,30872,49188,13823,78591900000,8.99543,31398.3,63011,27778,11,32139,32139,10629,13282,7994
93901,34267,35270,58508,35393,8.06552e+12,57.8005,40046.9,93901,17177,72,58631,58631,57152,55477,55525
66435,17495,24438,41504,24931,8.16763e+12,57.93,28043.1,66435,11887,72,41997,41997,35347,29047,27326
80974,10280,18825,52505,28469,9.91751e+12,60.131,23842.7,80974,9171,72,62149,62149,49691,37748,34428
10375,3244,3616,6515,3860,8.52223e+12,57.9318,4463.39,10375,1761,72,6759,6759,6217,6205,5748
12923,4461,4990,8040,4883,8.0062e+12,57.395,5945.4,12923,2430,72,7933,7933,7897,7831,7902
53070,11215,18669,33302,19768,8.37651e+12,58.1977,21723.4,53070,9090,72,34401,34401,28232,21058,20838
70530,21905,25889,44053,26477,8.17834e+12,57.8046,29682.8,70530,12607,72,44641,44641,42489,40059,40032
66560,6560,17733,42757,23803,9.47862e+12,59.5801,21823.5,66560,8639,72,48827,48827,34035,33346,19250
68935,14115,16017,44699,24236,9.92e+12,60.1252,20393.7,68935,7803,72,52918,52918,50691,50161,47094
31188,6958,8919,19935,11253,9.24735e+12,59.1881,11058,31188,4344,72,22269,22269,20569,18222,17891
89552,2321,20781,58077,31475,9.9263e+12,60.149,26252.9,89552,10123,72,68771,68771,41888,41344,8757
40271,16954,22992,23709,16562,5.55122e+12,53.8598,24743.7,40271,11187,72,17279,17279,14873,12636,12120
80183,3560,4623,63743,16440,5.76176e+13,12.0016,5556.12,80183,2773,20,75560,75560,68451,63154,72339
29778,5113,14589,23245,6533,78533300000,8.99298,14948,29778,13128,11,15189,15189,7658,8588,6747
86807,3983,30896,54398,32409,8.31919e+12,58.1822,35486.2,86807,15050,72,55911,55911,30379,16258,10779
87654,16877,26782,55700,31954,8.97387e+12,58.9805,31712.3,87654,13047,72,60872,60872,50251,40113,37321
41642,4183,9680,27005,14637,9.91862e+12,60.0708,12555,41642,4710,72,31962,31962,23854,22829,14157
8410,494,2044,5455,2955,9.85608e+12,59.4285,2855.14,8410,989,72,6366,6366,4097,2729,1464
99432,13545,28374,63550,35882,9.22706e+12,59.3006,34004.5,99432,13814,72,71058,71058,57070,54658,35410
74016,4334,21278,47280,26736,9.20456e+12,59.2475,25643.1,74016,10360,72,52738,52738,27539,16882,11942
20214,396,4722,13106,7108,9.94228e+12,59.9426,6327.62,20214,2294,72,15492,15492,9181,9055,1567
87674,10682,20362,56866,30808,9.91407e+12,60.1407,25738.3,87674,9916,72,67312,67312,55601,52879,35800
59353,5170,27133,36127,23226,7.02105e+12,56.3965,30027.4,59353,13213,72,32220,32220,17390,7437,4189
41390,9217,12248,26385,15005,9.0943e+12,57.8713,14915.9,41390,5944,72,29142,29142,25542,25463,21269
87774,13949,20385,56924,30850,9.91574e+12,60.131,25763.2,87774,9922,72,67389,67389,59700,49198,46734
31913,10524,11768,19936,11977,8.16577e+12,57.8627,13744.5,31913,5727,72,20145,20145,19335,18404,18599
21974,3923,7333,13859,8115,8.62957e+12,58.3293,8870.37,21974,3560,72,14641,14641,11597,8000,8082
56835,15527,19410,35766,21069,8.51331e+12,58.297,22682.5,56835,9453,72,37425,37425,34269,30634,30587
52093,7350,18863,32596,19497,8.23937e+12,58.0391,21832.8,52093,9183,72,33230,33230,23746,12625,12254
87115,11543,32514,54327,32788,8.09751e+12,57.8953,37007,87115,15837,72,54601,54601,40298,27056,23439
17121,1689,4022,11097,6024,9.91493e+12,59.8638,5429.26,17121,1954,72,13099,13099,9756,7002,5828
83134,19148,21041,53607,29527,9.64283e+12,59.8006,26055.9,83134,10245,72,62093,62093,59294,56055,56021
81411,7122,18921,52789,28622,9.91661e+12,60.1359,23965.6,81411,9211,72,62490,62490,42574,27875,24159
20534,894,6413,13040,7494,8.87575e+12,58.6438,7907.12,20534,3110,72,14121,14073,7182,3392,2126
55623,11044,15518,35623,20000,9.31885e+12,59.3579,18985.4,55623,7556,72,40105,40105,35708,34665,28410
3762,712,924,2442,1320,9.96028e+12,58.5327,1369.47,3762,448,65,2838,2838,2597,2544,2361
33849,4886,10863,21435,12414,8.77233e+12,58.6198,13061.3,33849,5280,72,22986,22986,17399,10889,9431
96000,14938,27369,61353,34647,9.23167e+12,59.1488,32836.5,96000,13323,72,68631,68631,53738,36089,35550
96630,32689,46280,58456,38174,6.7274e+12,56.1016,50476.4,96630,22541,72,50350,50350,41368,30847,30627
78221,6672,18144,50728,27493,9.91644e+12,60.1349,23021.5,78221,8833,72,60077,60077,40392,39149,22863
40700,12342,17807,24925,15775,7.26774e+12,56.8014,19996.1,40700,8670,72,22893,22893,20387,17487,17600
71446,1924,17775,46128,25318,9.71039e+12,59.862,22204.2,71446,8655,72,53671,53671,32688,32214,6902
30945,6777,7233,20065,10880,9.90723e+12,60.0213,9489.15,30945,3517,72,23712,23712,23073,22517,22462
63765,6538,16052,41135,22630,9.66487e+12,59.8014,20062.1,63765,7814,72,47713,47713,36047,22309,21822
85770,6433,24870,54750,31020,9.16776e+12,59.1984,29802.7,85770,12112,72,60900,60900,40646,40149,15855
51280,2244,16450,32460,18820,8.79049e+12,58.6956,19532.5,51280,8012,72,34830,34830,22130,8200,6674
10006,1714,2395,6486,3520,9.87274e+12,59.6217,3325.44,10006,1160,72,7611,7611,6616,6598,5562
60905,13949,25847,37435,23470,7.448e+12,56.9632,28946.9,60905,12587,72,35058,35058,28297,19096,16952
83878,12823,22324,53892,29986,9.47608e+12,59.5968,27302.3,83878,10870,72,61554,61554,52271,50010,36638
52656,4561,12265,34150,18506,9.89811e+12,60.0739,15755.8,52656,5960,72,40391,40391,29201,20659,15518
10081,2673,4366,6190,3891,7.4332e+12,56.5193,5112.7,10081,2127,72,5715,5715,4424,3003,3017
55039,5416,24922,33556,21483,7.08132e+12,56.6096,27658.1,55039,12140,72,30117,30117,18277,10042,7326
75460,6677,36135,45661,29799,6.73008e+12,55.7809,39549.5,75460,17583,72,39325,39325,22456,11424,7583
86909,13973,20173,56361,30548,9.91635e+12,60.1471,25511.3,86909,9823,72,66736,66736,57756,57569,46822
31970,359,11184,20071,11899,8.41742e+12,57.3292,13213.2,31970,5442,72,20786,20546,6544,2836,0
24122,5781,12295,18859,5263,7.9057e+10,8.64663,12610.4,24122,11061,11,11827,11827,6659,7296,6040
59325,4112,15175,38225,21100,9.6177e+12,59.7468,18935.8,59325,7389,72,44150,44150,29887,29528,12433
75187,5727,30525,46455,28732,7.67194e+12,57.2536,34319.2,75187,14866,72,44662,44662,22799,14149,9960
85877,19315,21152,55484,30393,9.73802e+12,59.9172,26348.7,85877,10300,72,64725,64725,62023,59483,58849
97031,9808,22540,62921,34110,9.91752e+12,60.1468,28404.1,97031,10980,72,74491,74491,55990,53521,33052
18862,4312,4407,12231,6631,9.93264e+12,59.951,5929.29,18862,2146,72,14455,14455,14329,14326,14289
87422,10680,25949,55697,31725,9.07894e+12,59.0361,30926.1,87422,12619,72,61473,61473,44644,24824,24044
60434,8397,14017,39198,21236,9.92046e+12,60.1243,17939.9,60434,6821,72,46417,46417,39608,30340,28181
72315,4452,4816,57629,14686,5.70873e+13,12.0019,5697.68,72315,2422,20,67499,67499,65184,63640,66432
22188,10274,10869,17320,4868,78520300000,8.9913,11177.7,22188,9780,11,11319,11319,10844,10902,10804
17277,5541,8467,13486,3791,78546700000,8.98611,8738.36,17277,7613,11,8810,8810,6487,6774,6220
76200,1958,3207,60319,15881,5.85689e+13,12.0019,4124.05,76200,2650,19,72993,72993,61809,52047,68002
21734,3827,5091,14098,7636,9.87472e+12,59.8701,6790.22,21734,2465,72,16643,16643,15121,14771,12696
55293,37003,55293,0,55293,7.99986,0,55293,55293,55293,1,0,0,0,0,0
61769,2131,26974,37828,23941,7.27957e+12,56.3816,30060.1,61769,13134,72,34795,34795,18877,3015,2018
66294,11825,24233,41434,24860,8.19571e+12,57.9009,27846.3,66294,11796,72,42061,42061,31675,19454,19158
28428,2735,9193,17986,10442,8.77209e+12,58.5642,11094.7,28428,4475,72,19235,19235,13717,7217,7174
54917,23375,35577,43061,11856,2.23435e+13,5.52747,40786.5,54917,11862,13,19340,19340,17628,19259,13567
97358,25736,28253,62138,35220,9.16702e+12,59.2243,33751.8,97358,13757,72,69105,69105,67104,66616,63914
8071,2571,2894,5068,3003,8.3706e+12,57.1493,3589.34,8071,1392,72,5177,5177,4891,4593,4591
29770,796,11746,18456,11314,7.83808e+12,57.4704,13557.9,29770,5719,72,18024,17880,10727,6927,2024
38214,880,12238,24199,14015,8.78049e+12,58.6671,14666.2,38214,5956,72,25976,25832,15324,6993,2429
75683,32857,34053,46177,29506,7.1114e+12,56.6745,37630.5,75683,16589,72,41630,41630,39980,38122,38131
68461,9759,15909,44389,24072,9.91824e+12,60.1293,20262.4,68461,7746,72,52552,52552,43650,35120,32821
8188,1972,3040,5110,3078,8.19927e+12,54.6558,3733.77,8188,1475,72,5148,5148,4653,4608,4299
97157,4915,31073,61502,35655,8.78282e+12,58.6958,36368.1,97157,15115,72,66084,66084,35486,17976,11462
96610,13915,35133,60405,36205,8.21555e+12,57.746,40110.1,96610,17101,72,61477,61477,46722,31763,27675
91369,12726,21412,59209,32160,9.88755e+12,60.1056,26969.8,91369,10425,72,69957,69957,59480,45165,41787
36652,1498,8606,23760,12892,9.89036e+12,60.0074,11186.8,36652,4188,72,28046,28046,12280,12570,5092
84624,25964,84624,0,84624,7.99991,0,84624,84624,84624,1,0,0,0,0,0
35018,1256,8162,22707,12311,9.92213e+12,60.0418,10655.7,35018,3971,72,26856,26856,16822,11302,4586
27670,2790,14965,16447,11223,5.95538e+12,54.4214,16339.2,27670,7273,72,12705,12705,6587,3310,2153
67453,19542,22577,42520,24933,8.59359e+12,58.4922,26389.1,67453,10991,72,44876,44876,41608,37812,37762
34980,882,9958,22367,12613,9.25127e+12,59.23,12313.7,34980,4847,72,25022,24986,14433,5766,1597
33900,6134,7916,21990,11910,9.91443e+12,60.0223,10342.5,33900,3852,72,25984,25984,23796,23299,20265
51160,7149,13274,32944,18216,9.56595e+12,59.6619,16583.6,51160,6458,72,37886,37886,29754,21921,19919
39877,469,13055,25187,14690,8.713e+12,58.5749,15544.4,39877,6359,72,26822,26534,11553,3942,979
91273,65355,85293,62848,28425,9.20863e+12,3.99658,85443.7,91273,28444,9,5980,5980,4580,5980,4587
59904,8352,20679,37647,22257,8.46332e+12,58.2527,24084.5,59904,10069,72,39225,39225,28533,15915,15605
60128,5645,14021,38990,21138,9.90478e+12,60.0967,17918.4,60128,6822,72,46107,46107,33915,33671,18982
63670,8578,14768,41299,22371,9.92442e+12,60.1142,18862.1,63670,7184,72,48902,48902,39852,39678,28814
65903,5459,28486,40412,25491,7.33977e+12,56.5584,31759.5,65903,13872,72,37417,37417,23354,7016,6376
83100,4001,19304,53892,29208,9.91989e+12,60.1371,24436.2,83100,9404,72,63796,63796,41499,41050,14042
26471,10293,13402,20691,5780,78920900000,8.98988,13734.1,26471,12054,11,13069,13069,10703,10974,10451
81380,4497,18912,52765,28615,9.9169e+12,60.1378,23953.9,81380,9209,72,62468,62468,32402,17657,15693
70145,25718,31405,42820,27325,7.13872e+12,56.7047,34776.3,70145,15294,72,38740,38740,34370,29244,29256
28119,2699,11674,17332,10787,7.57148e+12,57.1281,13359.3,28119,5681,72,16445,16445,10393,5280,3954
81920,5397,22881,52452,29468,9.30755e+12,59.3752,27685.6,81920,11135,72,59039,59039,39877,17258,16357
89242,11051,27899,56609,32633,8.87469e+12,58.7672,32867,89242,13569,72,61343,61343,45345,44861,25799
38836,1371,19699,23314,15522,6.37395e+12,55.693,21597,38836,9591,72,19137,19137,10471,1612,922
21799,2953,8763,13486,8313,7.73541e+12,57.2532,10166.3,21799,4260,72,13036,13036,9423,5600,4798
2015,657,1007,1220,795,6.7622e+12,38.5042,1221.8,2015,468,51,1008,1008,961,966,955
43797,16984,18004,27027,16770,7.62219e+12,57.2368,20415.3,43797,8761,72,25793,25793,25258,24634,24845
87571,12705,37987,53672,33899,7.31309e+12,56.5252,42135.2,87571,18484,72,49584,49584,33295,19374,15372
31005,10918,11574,19334,11671,8.1299e+12,57.8104,13493.7,31005,5638,72,19431,19431,18468,17403,17505
89834,27417,43002,54343,35491,6.73077e+12,56.041,46954.5,89834,20933,72,46832,46832,41740,35890,35870
50060,14107,17199,31483,18577,8.48046e+12,58.3128,20141.7,50060,8364,72,32861,32861,30384,27042,26322
99288,9149,42157,61021,38267,7.42787e+12,57.0894,46832.3,99288,20529,72,57131,57131,35141,9251,8358
58833,12713,27353,35737,23096,6.91907e+12,56.4157,30192.6,58833,13320,72,31480,31480,24299,16001,15792
30876,1466,9707,19575,11301,8.88109e+12,58.7507,11764.9,30876,4728,72,21169,21169,9896,8557,2070
83135,17307,21165,53587,29548,9.62733e+12,59.7723,26170.9,83135,10308,72,61970,61970,57875,56894,51065
5299,769,2038,3305,1994,8.03597e+12,55.5895,2536.05,5299,970,72,3261,3261,2615,2007,2069
77039,9031,17857,49961,27078,9.92662e+12,60.1473,22672.5,77039,8699,72,59182,59182,46292,33941,30499
50162,7041,11688,32528,17634,9.909e+12,60.0717,15037,50162,5684,72,38474,38474,32984,31683,23769
75599,18225,22638,48140,27459,9.04754e+12,59.0609,27019.4,75599,11021,72,52961,52961,49283,44319,43187
93552,7684,41052,57258,36294,7.2461e+12,56.8644,45404.2,93552,19994,72,52500,52500,33196,19242,9744
73431,10542,20580,47001,26430,9.29725e+12,59.3601,24952.4,73431,10022,72,52851,52851,43336,41024,27301
28866,4015,6753,18718,10148,9.91264e+12,60.0164,8885.08,28866,3289,72,22113,22113,18853,14465,13484
37766,9218,22692,22035,15731,5.18629e+12,54.2138,24261.1,37766,11054,72,15074,15074,11128,7689,6898
30597,3135,8159,19663,10934,9.46358e+12,59.448,10316,30597,3960,72,22438,22438,16489,11079,9613
28041,265,6510,18195,9846,9.96094e+12,60.029,8592.46,28041,3171,72,21531,21531,12371,12196,1202
88634,9333,48285,69493,19141,79867100000,8.98942,48870.1,88634,43448,11,40349,40349,15370,17205,13551
24381,2013,5680,15819,8562,9.91991e+12,59.9756,7544.06,24381,2761,72,18701,18701,12196,11894,6968
13064,1544,3047,8482,4582,9.90906e+12,59.7706,4192.98,13064,1471,72,10017,10017,7818,5742,5280
99815,32985,38102,62094,37721,7.98583e+12,57.5749,43093.8,99815,18545,72,61713,61713,58440,55329,54620
35539,7685,8295,23047,12492,9.90461e+12,60.0108,10815.9,35539,4036,72,27244,27244,26371,26355,25476
82154,28757,42017,64240,17914,79047600000,8.99647,42605.2,82154,37807,11,40137,40137,30115,31246,29003
66416,7638,18548,42521,23895,9.30899e+12,59.2371,22575,66416,9017,72,47868,47868,33746,34096,19193
9838,1119,2367,6377,3461,9.88251e+12,59.4426,3279.24,9838,1144,72,7471,7471,5997,4217,3853
39323,539,21118,23400,15923,5.98465e+12,55.1631,22943.7,39323,10266,72,18205,17437,10460,5471,1283
67156,10989,16829,43336,23820,9.67568e+12,59.8254,21025,67156,8193,72,50327,50327,43590,41985,32285
78591,7511,20841,50509,28082,9.49227e+12,59.6092,25556.8,78591,10147,72,57750,57750,41615,28681,21869
44645,5472,24229,34998,9647,79816500000,8.97807,24643,44645,21800,11,20416,20416,8507,9350,7679
71784,7597,36536,43046,28738,6.35873e+12,55.7299,39647.9,71784,17798,72,35248,35248,22114,12107,8955
64253,9857,14945,41665,22588,9.9139e+12,60.1213,19072,64253,7276,72,49308,49308,43248,41822,33087
3199,619,787,2072,1127,9.93867e+12,58.4229,1184.04,3199,377,63,2412,2412,2214,2030,2046
58317,5425,23925,35986,22331,7.62279e+12,56.867,26981.2,58317,11649,72,34392,34392,22254,7988,7602
26700,12864,15150,15743,10957,5.61359e+12,53.4218,16427.9,26700,7364,72,11550,11550,10983,10182,10228
82757,2177,19232,53660,29097,9.91307e+12,60.1338,24346.7,82757,9364,72,63525,63525,38622,38126,7940
22401,790,5323,14513,7888,9.85906e+12,59.8733,7055.28,22401,2587,72,17078,17078,7122,7280,2840
86780,20423,33063,53997,32783,8.0076e+12,57.7797,37492.9,86780,16107,72,53717,53717,42437,29122,28780
98605,12300,22920,63942,34663,9.91184e+12,60.1413,28864.9,98605,11162,72,75685,75685,60250,59933,41305
88435,7326,20527,57349,31086,9.91858e+12,60.1425,25943.2,88435,9993,72,67908,67908,44646,43382,24901
18339,939,4300,11889,6450,9.92963e+12,59.8878,5784.71,18339,2089,72,14039,14039,9051,6108,3053
28635,2536,7637,18411,10224,9.48217e+12,58.45,9681.62,28635,3700,72,20998,20998,15318,8650,8480
69016,23400,25130,43150,25866,8.21796e+12,58.0282,28869.6,69016,12237,72,43886,43886,42356,40973,40674
24151,3103,5620,15662,8489,9.94359e+12,59.9959,7470.28,24151,2732,72,18531,18531,14884,14800,10616
12143,2692,4219,7646,4497,8.46277e+12,57.9446,5176.79,12143,2050,72,7924,7924,6350,4495,4652
79158,23534,24636,50221,28937,8.90067e+12,58.8886,29126.6,79158,12002,72,54522,54522,53610,52440,52253
66654,19511,20712,42297,24357,8.90315e+12,58.8697,24599.4,66654,10084,72,45942,45942,45303,45117,44414
25978,5523,9220,16295,9683,8.327e+12,57.2985,10929.5,25978,4477,72,16758,16758,13782,10354,10305
63285,12279,19420,40202,23083,8.96206e+12,58.8817,23159.2,63285,9454,72,43865,43865,38639,37321,29921
90286,13961,20964,58557,31729,9.9103e+12,60.1341,26477,90286,10201,72,69322,69322,59168,49427,46773
17184,292,10556,9998,7186,5.02187e+12,52.0506,11392.2,17184,5124,72,6628,6148,3889,2141,788
7533,1222,1847,4887,2646,9.79828e+12,59.2695,2593.33,7533,891,72,5686,5686,5035,4229,4107
78613,13730,19818,50701,27912,9.6629e+12,59.822,24607.4,78613,9649,72,58795,58795,50548,42629,40605
55981,10205,13083,36302,19679,9.89328e+12,60.0748,16753.8,55981,6362,72,42898,42898,38769,34858,33835
73024,2486,24808,45977,27047,8.53651e+12,57.9186,28855.1,73024,12069,72,48216,48216,19010,17581,3291
21826,4399,10593,13191,8635,6.63377e+12,55.8879,11842.9,21826,5146,72,11233,11233,8646,5618,5724
16572,450,4629,10619,5953,9.35267e+12,59.1377,5937.13,16572,2251,72,11943,11895,7139,4626,1454
79232,18817,29276,49465,29767,8.14188e+12,57.9475,33444.5,79232,14258,72,49956,49956,41344,29477,26852
3227,513,781,2093,1134,1.00275e+13,58.7481,1184.74,3227,380,62,2446,2446,2064,1758,1781
23542,9359,11867,14148,9394,6.43888e+12,55.6692,13154.4,23542,5778,72,11675,11675,10556,9508,9442
9099,628,2765,5787,3312,9.04766e+12,58.3706,3574.53,9099,1342,72,6334,6286,4387,2188,2208
92146,18876,21386,59762,32384,9.91199e+12,60.1324,26997.9,92146,10404,72,70760,70760,67068,67002,62651
55855,6461,12984,36230,19625,9.91041e+12,60.0988,16652.4,55855,6320,72,42871,42871,33412,33216,21882
36273,5852,12377,22822,13451,8.52242e+12,57.5915,14646.1,36273,6024,72,23896,23896,18966,12473,10969
73097,20987,24617,46061,27036,8.5746e+12,58.4756,28682.7,73097,11991,72,48480,48480,46761,44509,44038
67736,13314,15753,43932,23804,9.9071e+12,60.1146,20067.5,67736,7668,72,51983,51983,48486,48409,44333
30253,3604,14832,18241,12012,6.58727e+12,55.1511,16433.9,30253,7211,72,15421,15421,10261,5540,4194
7654,2703,3315,4710,2944,7.34427e+12,56.3405,3926.62,7654,1609,72,4339,4339,3444,2476,2517
78412,9803,40047,46995,31417,6.321e+12,55.4915,43393.9,78412,19489,72,38365,38365,24694,15907,12993
17268,918,4052,11200,6068,9.96133e+12,59.867,5466.1,17268,1974,72,13216,13216,8679,8585,3249
42362,5484,11676,27149,15213,9.36797e+12,59.3874,14456.8,42362,5682,72,30686,30686,22910,13701,13536
44630,14733,19649,27302,17328,7.25082e+12,56.7884,21998.7,44630,9571,72,24981,24981,22658,20001,20058
89394,17256,23816,57437,31957,9.46937e+12,57.4665,29075.1,89394,11580,72,65578,65578,62411,58149,57204
44005,9143,14371,27812,16193,8.70862e+12,58.58,17072.5,44005,6994,72,29634,29634,25867,20762,19614
8485,1622,2059,5501,2984,9.83617e+12,59.404,2875.73,8485,997,72,6426,6426,5900,5780,5207
67131,12720,15626,43538,23593,9.90761e+12,60.0977,19905.4,67131,7600,72,51505,51505,47336,47245,42347
18185,1177,1197,14489,3696,5.71436e+13,11.9885,1629.87,18185,748,14,16988,16988,16894,16859,16943
24250,4400,5656,15724,8526,9.90353e+12,59.9532,7512.9,24250,2740,72,18594,18594,17083,16734,14681
12834,4941,5654,7858,4976,7.29876e+12,56.5257,6541.84,12834,2754,72,7180,7180,6808,6278,6394
50526,8970,14346,32310,18216,9.26991e+12,59.2759,17526.3,50526,6989,72,36180,36180,31155,29934,22801
59537,4741,13877,38600,20937,9.90778e+12,60.0947,17745.3,59537,6750,72,45660,45660,29159,28398,15983
28684,5612,8683,18248,10436,9.02549e+12,58.8259,10651.1,28684,4224,72,20001,20001,17516,14082,13494
80382,9041,18692,52122,28260,9.90937e+12,60.128,23679.4,80382,9100,72,61690,61690,49934,47395,30526
75314,4307,24519,47598,27716,8.70866e+12,58.6407,28749.2,75314,11936,72,50795,50795,24951,24704,9682
74506,7808,40800,58429,16077,79921500000,8.9702,41333.4,74506,36712,11,33706,33706,13236,14562,11927
52752,7532,12489,34173,18579,9.85577e+12,60.0121,15970.3,52752,6069,72,40263,40263,34292,32901,24257
23924,3789,6975,15276,8648,9.1836e+12,57.8279,8697.95,23924,3381,72,16949,16949,13254,13172,8867
86433,12094,27204,54794,31639,8.84785e+12,58.8327,32025.8,86433,13246,72,59229,59229,48503,36087,33077
79209,5266,37111,48074,31135,6.86307e+12,56.2521,40725,79209,18058,72,42098,42098,27630,10729,10226
62923,10138,16642,40453,22470,9.50093e+12,59.5997,20552.3,62923,8102,72,46281,46281,37806,37592,27571
38011,4287,8841,24649,13362,9.93975e+12,60.0582,11503.6,38011,4307,72,29170,29170,23629,16198,14483
54544,8298,35333,42764,11780,2.23521e+13,5.52917,40507.6,54544,11785,13,19211,19211,14327,13766,6413
95785,3404,46666,57809,37976,6.61496e+12,55.7713,50777.9,95785,22720,72,49119,49119,29839,10981,6556
89521,13807,20775,58053,31468,9.92187e+12,60.1438,26246.1,89521,10121,72,68746,68746,58634,58427,46300
41066,2785,15045,25655,15411,8.1982e+12,51.2149,17475.4,41066,7323,72,26021,26021,7671,3546,0
23023,136,6868,14664,8359,9.09921e+12,58.9442,8527.74,23023,3340,72,16155,15979,9155,5177,700
33935,1173,11200,21421,12514,8.66624e+12,58.4937,13378.3,33935,5451,72,22735,22735,13945,5737,3317
11125,785,2653,7215,3910,9.95053e+12,59.6931,3657.92,11125,1292,72,8472,8472,5711,5661,2482
30770,12778,14763,18607,12163,6.75289e+12,55.6546,16410.4,30770,7186,72,16007,16007,15430,14783,14993
70825,1662,19551,45381,25444,9.35475e+12,59.4304,23814.4,70825,9518,72,51274,51274,21330,11532,6049
98887,26787,52081,77420,21467,79445500000,8.99606,52715.3,98887,46865,11,46806,46806,29956,31356,28568
60467,16912,27803,36781,23686,6.98557e+12,56.4197,30731.2,60467,13538,72,32664,32664,28634,23168,21951
69767,14352,16212,45244,24523,9.92367e+12,60.1238,20631.4,69767,7898,72,53555,53555,50927,50862,47872
9150,1217,2720,5840,3310,9.19802e+12,58.5893,3534.66,9150,1322,72,6430,6430,5099,3726,3595
16397,5134,7470,9997,6400,7.06351e+12,54.797,8518.24,16397,3632,72,8927,8927,7595,5870,5533
72479,14384,26515,45286,27193,8.19537e+12,58.0116,30402.8,72479,12914,72,45964,45964,37622,27849,27587
86910,25284,26211,55305,31605,9.01494e+12,59.0335,31132.4,86910,12762,72,60699,60699,59666,58338,58091
37525,518,14145,23386,14139,8.04171e+12,57.7357,16373.8,37525,6877,72,23380,22934,13714,7459,2017
73373,21130,25412,46099,27274,8.4495e+12,58.1285,29442.1,73373,12374,72,47961,47961,44089,38752,37707
68807,13276,17265,44401,24406,9.67657e+12,59.8172,21545,68807,8401,72,51542,51542,46278,41269,39932
36365,4137,12416,22885,13480,8.5242e+12,58.3229,14687.1,36365,6043,72,23949,23949,16952,8801,8536
64943,13835,17719,41648,23295,9.38905e+12,59.4299,21699.5,64943,8617,72,47224,47224,42584,42471,37030
69378,28118,40548,40683,28695,5.37245e+12,54.5159,43188,69378,19747,72,28830,28830,25324,20468,19538
74143,17831,21300,47357,26786,9.21171e+12,59.2566,25672.7,74143,10370,72,52843,52843,49111,44073,42940
9421,747,2211,6117,3304,9.94353e+12,59.5931,3101.97,9421,1071,72,7210,7210,4505,4384,2545
41397,5677,9621,26845,14552,9.91562e+12,60.0631,12482.3,41397,4678,72,31776,31776,26066,25950,19156
27885,20068,27885,0,27885,7.99971,0,27885,27885,27885,1,0,0,0,0,0
87478,8554,20316,56726,30752,9.91038e+12,60.1366,25683.8,87478,9882,72,67162,67162,49283,47348,29027
82930,12088,25294,52716,30214,8.9751e+12,58.9801,30003.3,82930,12316,72,57636,57636,50544,49666,40356
22144,730,5168,14365,7779,9.92206e+12,59.9475,6894.39,22144,2511,72,16976,16976,10505,10375,2675
32532,1150,7604,21102,11430,9.91254e+12,60.0121,9950.15,32532,3700,72,24928,24928,15565,10444,4157
28497,475,9683,17944,10553,8.54679e+12,58.3195,11556.6,28497,4711,72,18814,18575,6506,3531,1476
25777,4649,6067,16712,9065,9.88927e+12,59.945,8009.07,25777,2946,72,19710,19710,17755,15932,15515
84991,83046,84991,0,84991,7.99991,0,84991,84991,84991,1,0,0,0,0,0
53686,26858,29446,31820,21866,5.83758e+12,54.6157,31744.2,53686,14338,72,24240,24240,23472,22510,22352
78313,14032,18159,50792,27521,9.91745e+12,60.1424,23044.8,78313,8837,72,60154,60154,55197,54041,46907
13930,2993,3302,9032,4898,9.90377e+12,59.7149,4497.74,13930,1598,72,10628,10628,10216,10207,9885
82881,17797,29617,51918,30963,8.30224e+12,58.1493,34019.4,82881,14423,72,53264,53264,44524,34340,33986
44267,2224,10325,28699,15568,9.92653e+12,60.075,13343.2,44267,5030,72,33942,33942,16492,16723,7691
95725,10462,22257,62072,33653,9.91645e+12,60.1379,28049.8,95725,10839,72,73468,73468,56297,40613,35187
37724,8313,8776,24460,13264,9.93263e+12,60.0673,11426.4,37724,4269,72,28948,28948,28271,28258,27643
38443,12188,13573,24115,14328,8.37352e+12,58.1568,15915.5,38443,6612,72,24870,24870,23918,22905,22944
29049,6510,10549,18176,10873,8.22838e+12,57.6808,12396.4,29049,5128,72,18500,18500,15763,11963,11289
14365,456,3412,9319,5046,9.85153e+12,59.7198,4638.79,14365,1650,72,10953,10953,4205,4420,1638
16663,454,1168,13281,3382,5.69733e+13,12.0069,1587.9,16663,574,20,15495,15495,11234,8236,12219
94998,9381,22097,61601,33397,9.90584e+12,60.1343,27853.3,94998,10759,72,72901,72901,53863,36556,31538
88571,2705,28559,56026,32545,8.74965e+12,58.6321,33435.5,88571,13893,72,60012,60012,28599,14327,7990
85558,6247,31555,53430,32128,8.15366e+12,57.969,36008.8,85558,15370,72,54003,53955,30782,21038,17586
84599,10350,29433,53128,31471,8.42554e+12,58.3037,33967.8,84599,14339,72,55166,55166,38463,18831,18060
34748,11919,19576,20518,14230,5.64933e+12,54.6986,21156.9,34748,9516,72,15172,15172,13021,10042,9560
2995,542,744,1937,1058,9.90552e+12,58.1917,1122.96,2995,356,61,2251,2251,2024,1973,1806
87807,8361,39690,53537,34270,7.08003e+12,56.6444,43729,87807,19330,72,48117,48117,32836,15056,14364
11706,2741,3480,7461,4245,9.13001e+12,58.7254,4463.36,11706,1690,72,8226,8226,7255,6207,6257
34008,460,12614,21237,12771,8.13434e+12,57.4455,14689.5,34008,6125,72,21394,21106,12539,6789,1821
21841,1622,9981,13310,8531,7.04438e+12,56.3765,11282.5,21841,4858,72,11860,11860,6902,1093,1075
18613,3780,4372,12077,6536,9.88304e+12,59.8708,5876.66,18613,2121,72,14241,14241,13391,13374,12526
71276,18206,27609,44279,26997,7.90969e+12,57.6613,31336,71276,13441,72,43667,43667,37868,29872,28174
87264,20269,26286,55535,31729,9.02377e+12,59.0401,31224.7,87264,12802,72,60978,60978,52267,52081,41678
96354,19642,22335,62490,33864,9.92821e+12,60.1563,28164,96354,10881,72,74019,74019,70035,69964,65278
23814,1611,5604,15431,8383,9.90565e+12,59.9519,7427.11,23814,2730,72,18210,18210,10446,6109,5398
2767,556,1083,1731,1036,8.00357e+12,55.841,1391.21,2767,520,66,1684,1638,1647,1573,1651
66259,396,15430,42967,23292,9.89673e+12,60.0946,19662.7,66259,7503,72,50829,50829,28964,28519,2034
27354,588,6373,17751,9603,9.90052e+12,59.978,8417.2,27354,3093,72,20981,20981,12528,12363,2227
26049,5305,7956,16557,9492,8.99048e+12,58.8476,9771.7,26049,3870,72,18093,18093,16247,13796,13289
17939,2084,4653,11553,6386,9.58942e+12,59.527,6079.57,17939,2263,72,13286,13286,9603,5322,5222
71165,11758,32196,43376,27789,7.08024e+12,56.3809,35582.5,71165,15679,72,38969,38969,28782,16921,16641
55903,1560,13206,36219,19684,9.86382e+12,60.0366,16859,55903,6428,72,42697,42697,16386,17048,5806
75563,15774,17538,49007,26556,9.92329e+12,60.1313,22270,75563,8542,72,58025,58025,55867,55372,52378
38558,12741,13998,24121,14437,8.25275e+12,57.9975,16314.3,38558,6818,72,24560,24560,22994,21565,21259
17663,3681,4141,11451,6212,9.93188e+12,59.8963,5585.29,17663,2011,72,13522,13522,12960,12840,12226
32054,11003,12087,19965,12089,8.07641e+12,57.0545,14050.4,32054,5882,72,19967,19967,18698,17219,17393
34248,6487,16774,26735,7513,78572400000,8.99568,17159.7,34248,15095,11,17474,17474,9306,10312,8314
68408,1099,28282,42185,26223,7.57732e+12,56.589,31753.8,68408,13757,72,40126,40126,22930,10839,2014
42079,9329,10974,27079,15000,9.55252e+12,59.6348,13787.8,42079,5341,72,31105,31105,29537,27481,27048
91015,10719,36375,56325,34690,7.75679e+12,57.486,40873,91015,17721,72,54640,54640,38203,21869,17516
54713,565,12780,35469,19244,9.89937e+12,60.0769,16380.7,54713,6215,72,41933,41933,11980,13491,2533
2445,571,620,1590,855,9.98392e+12,57.6613,943.891,2445,297,58,1825,1825,1766,1764,1770
41841,9156,9789,27125,14716,9.89189e+12,60.0411,12672.9,41841,4753,72,32052,32052,31306,31134,30211
96090,18573,32592,60493,35597,8.53758e+12,58.4362,37702.3,96090,15878,72,63498,63498,53782,51322,37404
83269,12168,25377,52936,30333,8.98113e+12,58.9752,30099.7,83269,12360,72,57892,57892,49975,40649,40365
82550,3522,22263,52993,29557,9.4359e+12,59.5389,27153.2,82550,10841,72,60287,60287,37431,13061,9345
5513,414,3231,3232,2281,5.55986e+12,45.6423,3613.12,5513,1568,66,2282,2186,1281,650,0
19550,1236,6930,12261,7289,8.39241e+12,57.9982,8294.61,19550,3376,72,12620,12620,7530,1526,1504
39021,1042,10138,25128,13893,9.55916e+12,59.4158,12784.7,39021,4933,72,28883,28883,16745,16455,1916
64449,20628,24246,40162,24287,8.06035e+12,57.8214,27719.1,64449,11808,72,40203,40203,38405,36320,36469
18115,3598,6811,11294,6821,8.08593e+12,55.2682,8070.3,18115,3295,72,11304,11304,9030,6439,6418
97273,19640,38403,60283,36990,7.82093e+12,57.5649,43193.5,97273,18709,72,58870,58870,47116,31052,27232
59538,1876,16582,38122,21416,9.32586e+12,59.3506,20257,59538,8072,72,42956,42956,26404,17462,6125
87511,3734,32653,54573,32938,8.09653e+12,57.6741,37170.3,87511,15890,72,54858,54858,33754,32956,8036
97419,21186,37695,60514,36905,7.91712e+12,57.6844,42545.7,97419,18358,72,59724,59724,49668,35820,32715
89391,9425,24328,57337,32054,9.39816e+12,59.5035,29551,89391,11841,72,65063,65063,49218,30548,29813
92309,24733,46999,55353,36956,6.34418e+12,55.6699,50840.1,92309,22879,72,45310,45310,37068,25845,23188
52501,13776,28951,31089,21412,5.80707e+12,55.0294,31191.6,52501,14097,72,23550,23550,18763,12525,11226
25586,5688,13660,15230,10356,6.05757e+12,53.9654,14969.5,25586,6649,72,11926,11926,8802,5931,5198
70357,1148,16342,45621,24736,9.91722e+12,60.1274,20797.2,70357,7955,72,54015,54015,17043,18694,4392
59564,6894,19088,37702,21862,8.77856e+12,58.7203,22587.5,59564,9293,72,40476,40476,29016,15522,15015
27049,4118,10251,16843,10206,8.0596e+12,57.6953,11961.3,27049,4993,72,16798,16798,12246,6993,6842
54710,482,12718,35490,19220,9.91803e+12,60.1019,16322.2,54710,6193,72,41992,41992,11719,1806,2201
17402,2101,5507,11043,6359,8.8577e+12,56.9501,6813.51,17402,2663,72,11895,11895,8251,5264,4431
34022,597,17772,20332,13690,6.17468e+12,55.4155,19439.4,34022,8643,72,16250,15581,9364,4641,1258
59374,162,13833,38492,20882,9.91571e+12,60.1067,17688.7,59374,6739,72,45541,45469,25654,25242,1255
94031,20824,39762,57822,36209,7.45072e+12,57.1082,44235.5,94031,19359,72,54269,54269,44534,31116,28106
76403,12243,20892,48993,27410,9.38695e+12,59.4746,25449.3,76403,10177,72,55511,55511,45143,44883,32564
56158,2969,17834,35573,20585,8.81564e+12,58.7483,21173,56158,8683,72,38324,38324,24262,7644,7160
31790,6995,7436,20614,11176,9.90733e+12,60.0019,9736.83,31790,3617,72,24354,24354,23706,23156,23100
23613,8960,14412,13745,9868,5.04933e+12,53.9942,15487.2,23613,7014,72,9201,9201,7962,6237,6059
58893,6690,13735,38181,20712,9.90291e+12,60.0929,17566.3,58893,6685,72,45158,45158,36699,25167,22456
11358,2328,2660,7377,3981,9.89783e+12,59.6805,3688.91,11358,1285,72,8698,8698,8238,8228,7858
61877,4577,29808,37407,24470,6.68901e+12,56.1419,32692.3,61877,14506,72,32069,32069,18896,9382,6681
10304,1630,4122,6379,3925,7.83759e+12,57.0311,4913.95,10304,2008,72,6182,6182,4926,3469,3645
9737,357,651,7759,1978,5.71374e+13,11.9789,964.453,9737,404,14,9086,9086,7238,5918,8251
67122,6424,22017,42392,24730,8.67828e+12,58.6052,25846.6,67122,10718,72,45105,45105,28961,17229,13428
92840,40443,46281,55839,37001,6.47612e+12,55.6929,50214.6,92840,22533,72,46559,46559,42876,38635,38550
75588,1916,17538,49021,26567,9.92938e+12,60.1394,22270.4,75588,8544,72,58050,58050,21172,7579,7265
99766,1640,29191,63632,36134,9.13357e+12,59.1914,34792.1,99766,14214,72,70575,70527,27450,25371,6310
64488,15757,31625,38888,25600,6.594e+12,56.0205,34563.9,64488,15406,72,32863,32863,26106,16921,14783
27690,11136,13457,16730,10960,6.64334e+12,54.3525,14961.4,27690,6533,72,14233,14233,13234,11839,11741
37541,722,8805,24340,13201,9.89057e+12,60.0187,11440.3,37541,4283,72,28736,28736,9336,10138,2548
94666,39345,49459,56536,38130,6.17123e+12,55.5373,53294.7,94666,24090,72,45207,45207,39835,33548,33509
68144,10506,22157,43069,25075,8.72299e+12,58.46,26048,68144,10787,72,45987,45987,35904,23690,20647
42141,9238,9777,27326,14815,9.93231e+12,60.0954,12680.6,42141,4763,72,32364,32364,31576,31560,30806
38870,6757,12361,24630,14240,8.80763e+12,58.7026,14830.5,38870,6012,72,26509,26509,21460,14608,13013
4650,953,1124,3023,1627,9.89023e+12,58.8888,1648.31,4650,542,71,3526,3526,3323,3280,3142
9686,4081,4170,5958,3728,7.38596e+12,56.4966,4899.78,9686,2025,72,5516,5516,5402,5361,5376
44311,9767,10350,28734,15577,9.90729e+12,60.0651,13371.4,44311,5036,72,33961,33961,33124,32383,32265
80722,5900,37207,49089,31633,6.96298e+12,56.2405,40924.3,80722,18106,72,43515,43515,26177,13419,9433
46747,6686,12765,29980,16767,9.40008e+12,59.4414,15788.7,46747,6213,72,33982,33982,26719,26398,18007
59258,11734,13802,38419,20839,9.91599e+12,60.1126,17654.6,59258,6724,72,45456,45456,43014,42437,39062
60477,12602,16530,38784,21693,9.3969e+12,59.4652,20271.5,60477,8051,72,43947,43947,38231,31535,31351
28466,4174,6683,18464,10002,9.89261e+12,59.9696,8789.1,28466,3247,72,21783,21783,18813,14824,13941
21942,1923,5604,14142,7800,9.65108e+12,59.5783,7275.79,21942,2730,72,16338,16338,11291,7612,5228
55004,533,2830,43660,11344,5.79907e+13,11.9968,3597.46,55004,2278,14,52174,52174,34343,20041,44205
52973,6948,12386,34343,18630,9.89761e+12,60.0692,15887.4,52973,6028,72,40587,40587,34090,32564,23201
62174,21823,23741,38690,23484,7.98774e+12,57.6659,27089.2,62174,11548,72,38433,38433,37722,36723,36721
61182,22919,25966,37599,23583,7.43302e+12,57.0604,29082.7,61182,12637,72,35216,35216,33518,31890,31664
22271,168,5532,14391,7880,9.75056e+12,59.7035,7236.35,22271,2691,72,16739,16677,4740,5073,767
85582,669,19878,55499,30083,9.92406e+12,60.1409,25139,85582,9684,72,65704,65704,37720,37154,3225
75142,4584,40999,44573,30569,5.87073e+12,55.0646,44038.1,75142,19953,72,34143,34143,21580,6965,6561
27973,6026,6571,18138,9835,9.88434e+12,59.9361,8646.6,27973,3189,72,21402,21402,20633,20618,19860
71837,35220,37341,56212,15625,79236700000,8.98107,37885,71837,33598,11,34496,34496,33032,33168,32913
60190,7074,37171,34944,25246,4.95205e+12,53.9952,39370.9,60190,18107,72,23019,23019,13100,5951,3649
96081,30535,36185,59862,36219,8.0539e+12,57.8466,41047,96081,17623,72,59896,59896,58089,55590,55233
36907,9402,9587,23751,13156,9.56822e+12,59.624,12116.7,36907,4668,72,27320,27320,27117,27069,26931
73544,2152,17139,47687,25857,9.9063e+12,60.1164,21760.3,73544,8342,72,56405,56405,34602,22917,7754
56842,9203,16100,36357,20485,9.2688e+12,59.2946,19613,56842,7838,72,40742,40742,34658,33189,24486
41770,3190,9705,27088,14682,9.92215e+12,60.0689,12589.1,41770,4718,72,32065,32065,22527,22345,10865
49239,6011,19596,30495,18744,7.78292e+12,57.463,22299.2,49239,9540,72,29643,29643,21865,12745,12584
22171,4636,5175,14380,7791,9.93536e+12,59.9536,6898.11,22171,2520,72,16996,16996,16344,16193,15439
91037,22971,37350,56171,34866,7.62234e+12,57.3177,41778.6,91037,18195,72,53687,53687,44597,32078,29293
23179,588,5409,15036,8143,9.9199e+12,59.9117,7195.74,23179,2626,72,17770,17770,10757,10619,2242
40647,4356,21482,31827,8820,79442500000,8.98507,21884.5,40647,19326,11,19165,19165,7521,8549,6510
76752,1356,37886,46231,30521,6.54641e+12,55.9772,41264.3,76752,18452,72,38866,38866,22441,10961,2616
37942,16753,18851,22838,15104,6.50911e+12,54.3821,20747.8,37942,9177,72,19091,19091,18429,17497,17514
12890,872,3009,8363,4527,9.91078e+12,59.7365,4143.22,12890,1449,72,9881,9881,5644,5578,3049
29908,439,12585,18411,11497,7.48897e+12,57.002,14337.9,29908,6117,72,17323,16987,10222,9923,1683
72722,23165,37290,56872,15850,7.9125e+10,8.9977,37842,72722,33558,11,35432,35432,24915,26065,23780
95306,18891,22148,61799,33507,9.91832e+12,60.1435,27920.6,95306,10789,72,73158,73158,68438,63967,62784
46821,19693,23232,28184,18637,6.5266e+12,55.8909,25472.8,46821,11318,72,23589,23589,21879,20303,19983
30551,170,1669,24270,6281,5.7814e+13,11.9939,2236.99,30551,1266,14,28882,28882,18033,9448,24013
22465,3837,5249,14575,7890,9.93183e+12,59.9387,6992.14,22465,2548,72,17216,17216,15510,13241,12776
12210,6526,6866,9587,2623,80228400000,8.8774,7071.55,12210,6174,11,5344,5344,5089,5117,5078
17303,1696,4076,11227,6076,9.89284e+12,59.8197,5494.2,17303,1975,72,13227,13227,9532,9119,5557
80105,15874,19568,51781,28324,9.75935e+12,59.9382,24476.6,80105,9527,72,60537,60537,55434,55310,49367
86361,6129,25179,55102,31259,9.15101e+12,59.1934,30130.7,86361,12261,72,61182,61182,39516,13858,12980
48914,11361,20172,30172,18742,7.59099e+12,56.9483,22810.2,48914,9804,72,28742,28742,23798,17091,15544
92743,28595,50624,55016,37727,5.86917e+12,55.1597,54236.7,92743,24660,72,42119,42119,33977,22886,20265
52532,6889,22167,32302,20230,7.47339e+12,56.9701,24924.3,52532,10794,72,30365,30365,20707,11556,9101
35483,11836,12273,22304,13179,8.4799e+12,58.2563,14483.8,35483,5979,72,23210,23210,22681,22046,21982
88773,20177,20658,57553,31220,9.91277e+12,60.1401,26087.5,88773,10064,72,68115,68115,67535,67403,66742
56056,12308,29603,43891,12165,79457700000,8.99422,30077.5,56056,26638,11,26453,26453,13657,15040,12291
55984,4461,29428,33400,22584,6.13537e+12,55.3292,31898.5,55984,14331,72,26556,26556,16929,9848,5436
29728,1149,6969,19276,10452,9.9022e+12,59.9864,9147.9,29728,3390,72,22759,22759,14340,14160,4105
93802,13109,35606,58397,35405,8.00759e+12,57.7095,40354.9,93802,17324,72,58196,58196,40737,28243,24114
28244,1877,6577,18326,9918,9.91021e+12,59.9772,8673.21,28244,3190,72,21667,21667,12332,7378,6548
90903,10113,21098,58960,31943,9.91793e+12,60.1431,26643.7,90903,10274,72,69805,69805,56123,38495,34186
65253,15055,15177,42310,22943,9.91855e+12,60.1173,19355.4,65253,7387,72,50076,50076,49932,49900,49842
16488,1417,5617,10378,6110,8.57361e+12,58.2003,6836.4,16488,2732,72,10871,10871,7186,4537,3735
50991,2848,12624,32935,18056,9.73109e+12,59.8492,15963.8,50991,6147,72,38367,38367,24981,16732,8614
72279,17731,18913,46492,25787,9.54346e+12,59.6674,23323,72279,9209,72,53366,53366,52333,52295,51312
23772,4880,5536,15425,8347,9.9586e+12,59.9889,7359.5,23772,2697,72,18236,18236,17432,17257,16284
68762,16062,18435,44165,24597,9.44561e+12,59.5344,22630.9,68762,8968,72,50327,50327,47940,47881,45161
42518,8335,17148,26300,16218,7.71149e+12,57.3314,19528.4,42518,8341,72,25370,25370,20625,14250,12782
52837,2904,3640,42140,10697,5.69334e+13,11.9966,4384.9,52837,2148,14,49197,49197,44856,41926,47232
17073,5177,5790,10761,6312,8.57928e+12,58.1939,7043.27,17073,2814,72,11283,11283,10459,9503,9693
26370,6922,7164,16926,9444,9.42996e+12,59.3644,9064.99,26370,3488,72,19206,19206,18876,18869,18643
80937,16885,27909,50881,30056,8.45963e+12,58.1883,32298.6,80937,13574,72,53028,53028,47582,40180,38468
64762,10966,28842,39571,25191,7.16239e+12,56.7234,32007.8,64762,14039,72,35920,35920,26574,26155,15475
47486,1448,11065,30792,16694,9.93207e+12,60.0847,14261.7,47486,5390,72,36421,36421,14071,14786,5120
30517,1460,9346,19391,11126,8.98557e+12,58.7749,11404.7,30517,4547,72,21171,21171,13728,9343,4747
87829,11560,20385,56952,30877,9.91914e+12,60.146,25768.4,87829,9931,72,67444,67444,56791,54310,38787
98422,33233,33789,61894,36528,8.47955e+12,58.2167,38984.3,98422,16453,72,64633,64633,64397,64124,64309
55305,4533,20078,34596,20709,8.24063e+12,58.0287,23189.9,55305,9780,72,35227,35227,23247,13676,11192
36254,1134,15182,22321,13933,7.51686e+12,56.6534,17235.5,36254,7374,72,21072,21072,10022,2598,2200
79592,28778,44924,46946,32646,5.62811e+12,54.5233,48001.7,79592,21865,72,34668,34668,28622,20404,18496
96278,16443,22325,62440,33838,9.91564e+12,60.1476,28153.1,96278,10870,72,73953,73953,66828,57120,54864
26977,7194,14867,21161,5816,79995500000,8.94477,15182.7,26977,13372,11,12110,12110,7522,7774,7287
32683,1515,7632,21191,11492,9.92727e+12,60.0334,9984.14,32683,3717,72,25051,25051,16081,15908,5155
99334,2865,29092,63357,35977,9.13888e+12,59.1864,34665,99334,14173,72,70242,70194,35417,29393,10332
80304,3191,22887,51329,28975,9.24194e+12,59.301,27576.3,80304,11148,72,57417,57417,35232,34689,7984
94701,6390,27288,60475,34226,9.19046e+12,59.2469,32669.3,94701,13285,72,67413,67413,38734,37690,18566
89497,18844,21984,57827,31670,9.73751e+12,59.9174,27371.1,89497,10700,72,67513,67513,63634,63532,59011
2262,152,624,1457,805,9.78655e+12,57.4589,924.737,2262,303,56,1638,1612,1057,385,561
80378,816,20591,51784,28594,9.60443e+12,59.7471,25449.8,80378,10017,72,59787,59787,19944,10462,3619
98259,11272,22826,63715,34544,9.91492e+12,60.146,28755.9,98259,11114,72,75433,75433,58600,58261,37922
44429,330,18605,27352,17077,7.51384e+12,56.1381,21023.9,44429,9041,72,25824,25180,9380,3822,972
86220,20473,25297,54983,31237,9.12646e+12,59.1603,30231.3,86220,12314,72,60923,60923,56897,52143,52174
25007,8459,8603,15722,9285,8.5134e+12,57.2172,10282.5,25007,4185,72,16404,16404,16201,16053,16123
38320,1741,8976,24836,13484,9.90419e+12,60.0343,11655.2,38320,4367,72,29344,29344,18823,18605,5976
59661,21221,23397,37015,22646,7.85556e+12,57.5676,26587.2,59661,11393,72,36264,36264,35318,34001,33927
35328,3039,8233,22917,12411,9.93136e+12,60.0492,10742.5,35328,4009,72,27095,27095,18109,11791,10280
60681,19437,21477,38045,22636,8.35491e+12,58.184,24877.7,60681,10463,72,39204,39204,37393,35363,35360
17837,2150,4325,11537,6300,9.83492e+12,59.7936,5768.22,17837,2105,72,13512,13512,10839,10234,6500
45975,218,2994,36628,9347,5.71685e+13,11.9963,3689.48,45975,1878,14,42981,42981,25193,13272,34960
29230,4526,15552,17418,11812,6.06015e+12,55.2479,17007.6,29230,7570,72,13678,13678,9227,5036,4068
43272,6875,15861,27042,16230,8.19034e+12,57.924,18394.2,43272,7718,72,27411,27411,20113,13129,11367
29521,1862,6900,19140,10381,9.92331e+12,60.02,9070.12,29521,3361,72,22621,22621,12594,12515,6580
5415,820,1305,3521,1894,9.8824e+12,59.0393,1891.74,5415,626,72,4110,4110,3425,3412,2764
18529,4678,6233,11674,6855,8.60986e+12,58.3015,7573.28,18529,3034,72,12296,12296,11595,10628,10601
37637,4776,14528,23399,14238,7.9347e+12,57.6083,16736.3,37637,7066,72,23109,23109,17153,10216,8646
91373,9473,21201,59260,32113,9.91658e+12,60.1438,26772.6,91373,10322,72,70172,70172,53658,51291,32086
1580,23,418,1026,554,1.04146e+13,56.6759,649.818,1580,202,52,664,111,262,136,98
40490,8540,14628,25338,15152,8.24497e+12,57.2114,17047.7,40490,7112,72,25862,25862,20553,14276,14241
62056,26783,32982,36974,25082,6.04758e+12,55.338,35641.3,62056,16055,72,29074,29074,26892,24344,24471
83162,25515,39553,50351,32811,6.77908e+12,56.0474,43274.3,83162,19263,72,43609,43609,36376,27896,27761
78646,16243,43458,61699,16947,80046500000,8.9877,44001.9,78646,39104,11,35188,35188,18667,19639,17713
53644,3033,12700,34754,18890,9.85338e+12,60.0111,16229.2,53644,6175,72,40944,40944,20879,11067,9768
54199,6845,16050,34544,19655,9.08216e+12,59.0703,19378.7,54199,7802,72,38149,38149,30563,22020,19844
15390,398,8894,9039,6351,5.51481e+12,51.8323,9717.5,15390,4327,72,6496,6208,3628,1379,0
92714,29347,41442,56612,36102,7.1462e+12,56.7289,45703.4,92714,20180,72,51272,51272,46547,40129,38656
64855,12403,21098,40996,23859,8.71889e+12,58.6251,24829.8,64855,10262,72,43757,43757,36708,28390,28265
94305,19927,25273,60569,33736,9.45179e+12,59.5727,30765.6,94305,12308,72,69032,69032,63422,55805,54044
90317,10644,30314,56919,33398,8.58048e+12,58.3176,35188.8,90317,14761,72,60003,60003,44445,29198,24966
51803,18381,24874,31331,20472,6.73991e+12,56.1637,27368.5,51803,12117,72,26929,26929,23838,20240,20319
6997,1417,2741,4345,2652,7.952e+12,56.9526,3342.35,6997,1330,72,4256,4256,3292,2163,2354
25847,4326,10012,16059,9788,7.96745e+12,57.5389,11639.9,25847,4877,72,15835,15835,11772,7080,6994
17372,651,4083,11262,6110,9.92665e+12,59.8826,5503.3,17372,1988,72,13289,13289,8324,8220,2368
79653,18384,21564,51116,28537,9.42973e+12,59.5277,26300.6,79653,10505,72,58089,58089,54752,51630,50829
96380,11920,22413,62498,33882,9.91093e+12,60.1381,28241.3,96380,10915,72,73967,73967,58724,58411,40012
86048,19659,43033,67225,18823,78825500000,8.99709,43642.9,86048,38724,11,43015,43015,24797,26974,22639
85506,34359,38164,52220,33286,7.15107e+12,56.7376,42151.6,85506,18586,72,47342,47342,45594,43280,42805
19666,307,4618,12753,6913,9.87381e+12,59.8552,6188.2,19666,2235,72,15048,15048,8794,5736,1223
91128,10182,25303,58369,32759,9.33269e+12,59.4179,30574.4,91128,12322,72,65825,65825,48690,31881,27364
47753,2204,19995,29405,18348,7.51106e+12,57.1107,22555.4,47753,9728,72,27758,27758,17330,5705,4740
96799,149,4066,76626,20173,5.85632e+13,12.0013,5100.25,96799,3909,19,92733,92733,57668,26537,60770
80623,2630,18747,52279,28344,9.91834e+12,60.1301,23744.4,80623,9133,72,61876,61876,38489,38003,9691
90735,20279,29897,57279,33456,8.6583e+12,58.2457,34828.8,90735,14550,72,60838,60838,53881,52149,42187
48799,4390,24797,29280,19519,6.35247e+12,55.3306,27075.6,48799,12058,72,24002,24002,15013,9156,7159
28171,313,6595,18267,9904,9.9153e+12,60.0019,8683.54,28171,3212,72,21576,21576,6243,1179,1392
56835,10081,13271,36850,19985,9.89445e+12,60.0673,16989,56835,6450,72,43564,43564,39769,38877,33467
35636,13916,15744,21793,13843,7.21718e+12,56.7187,17701.9,35636,7659,72,19892,19892,19358,18729,18940
59911,2748,34177,35288,24623,5.5486e+12,54.598,36586.9,59911,16641,72,25734,25734,11616,4754,2048
45416,8535,18006,28140,17276,7.81292e+12,57.4663,20537.7,45416,8770,72,27410,27410,21267,14033,13957
91256,10177,31812,57306,33950,8.41136e+12,58.2465,36644.1,91256,15493,72,59444,59444,36881,39556,19080
99253,5887,23067,64370,34883,9.91006e+12,60.1382,29047.3,99253,11228,72,76186,76186,51232,50720,20489
79142,6991,18357,51330,27812,9.92117e+12,60.1309,23280.9,79142,8934,72,60785,60785,44260,31456,23948
96721,9633,32358,60978,35743,8.59345e+12,58.4964,37527.9,96721,15760,72,64363,64363,47988,28824,28108
52158,3909,16012,33134,19024,8.94757e+12,58.8448,19196.3,52158,7786,72,36146,36146,23079,7709,7116
28244,1323,8770,17933,10311,8.92483e+12,58.4201,10696.2,28244,4255,72,19474,19474,12143,3975,3302
77309,22477,26927,48553,28756,8.41597e+12,58.2939,31130.3,77309,13111,72,50382,50382,47172,46359,41893
78569,10075,24707,49820,28749,8.85187e+12,58.8213,29152.7,78569,12025,72,53862,53862,39838,39416,22759
85996,3335,26463,54626,31370,8.93254e+12,58.7564,31303.7,85996,12874,72,59533,59533,36298,12943,7818
44820,1976,14652,28324,16496,8.70542e+12,58.5792,17391,44820,7137,72,30168,30168,18613,6325,4552
72428,16552,36171,43556,28872,6.46698e+12,54.8378,39363.4,72428,17615,72,36257,36257,27769,18360,16089
79005,17444,30207,49144,29861,7.97663e+12,57.7509,34297.8,79005,14710,72,48798,48798,41383,32766,32484
22306,89,7434,14071,8235,8.62846e+12,57.3003,8989.46,22306,3608,72,14872,13118,4268,4304,538
30166,12298,15962,17986,12180,6.09786e+12,55.3347,17464.4,30166,7773,72,14204,14204,12564,10648,10802
10510,1150,2455,6825,3685,9.99289e+12,59.7116,3421.6,10510,1194,72,8055,8055,6127,6093,3928
74330,5350,31519,45681,28649,7.44709e+12,57.0835,35181.6,74330,15348,72,42811,42811,23302,11267,7089
49511,1841,16407,31243,18268,8.65163e+12,58.5195,19362.1,49511,7993,72,33104,33104,20378,7781,4948
17691,5004,7403,10892,6799,7.54177e+12,55.2576,8572.26,17691,3596,72,10288,10288,9134,7512,7366
21119,1192,1283,16804,4315,5.74438e+13,11.99,1751.7,21119,871,14,19836,19836,19205,18740,19550
34257,5900,15697,20856,13401,7.01038e+12,56.4593,17550,34257,7642,72,18560,18560,13527,7659,7638
13576,178,4123,8643,4933,9.05372e+12,58.6648,5214.34,13576,2004,72,9453,9347,3145,1687,681
87578,17864,22296,56451,31127,9.62672e+12,59.781,27531,87578,10856,72,65282,65282,60174,54148,54122
1332,548,753,789,543,6.3899e+12,32.8701,895.282,1332,360,40,579,579,381,99,67
43689,6770,11752,28063,15626,9.44098e+12,59.4898,14626.5,43689,5716,72,31937,31937,25429,17708,17610
74409,3642,17276,48264,26145,9.91133e+12,60.1268,21950.2,74409,8409,72,57133,57133,37211,36819,12691
14610,2770,5036,9193,5417,8.51015e+12,58.1112,6142.43,14610,2453,72,9574,9574,8191,6268,6043
6713,1328,3888,3954,2759,5.49803e+12,53.4983,4332.54,6713,1884,72,2825,2825,1646,258,436
30236,1274,8679,19329,10907,9.23799e+12,59.0288,10765.6,30236,4211,72,21557,21557,13874,5685,4571
4969,388,1193,3227,1742,9.94034e+12,59.0332,1744.22,4969,575,72,3776,3776,2264,2203,1313
34553,8524,12957,21541,13012,8.084e+12,57.8048,15050.3,34553,6310,72,21596,21596,18332,14484,14554
73454,10381,32055,44987,28467,7.28092e+12,56.5226,35620.5,73454,15610,72,41399,41399,27994,15315,11755
59800,4704,29289,46680,13120,78531800000,8.99522,29801.5,59800,26354,11,30511,30511,10992,13401,8601
37310,5754,10698,23841,13469,9.22137e+12,59.2101,13175.3,37310,5206,72,26612,26612,20713,15116,13603
10905,409,3596,6888,4017,8.74612e+12,58.1978,4495.98,10905,1746,72,7309,7213,4525,2994,1351
73996,22637,26546,46337,27659,8.28254e+12,58.1141,30537.4,73996,12928,72,47450,47450,43723,39418,39316
9666,883,2813,6187,3479,9.19262e+12,55.6478,3672.3,9666,1349,72,6853,6853,4762,3169,2737
47947,4357,24485,28743,19204,6.32322e+12,55.6668,26722.7,47947,11918,72,23462,23462,15511,9808,7967
54078,2902,15401,34571,19507,9.25163e+12,59.2746,18764.1,54078,7502,72,38677,38677,24425,24082,6982
17729,1565,4165,11501,6228,9.89534e+12,59.8724,5614.39,17729,2020,72,13564,13564,9106,8778,5133
78792,2138,19127,50961,27831,9.7779e+12,59.9356,23976.8,78792,9297,72,59665,59665,35973,15757,6817
16404,2350,7169,10052,6352,7.34546e+12,56.6617,8240.76,16404,3491,72,9235,9235,6462,4130,3660
73487,5465,17063,47658,25829,9.91971e+12,60.126,21684.9,73487,8307,72,56424,56424,39521,39180,18759
57089,8428,29130,34229,22860,6.32504e+12,55.3969,31708.9,57089,14169,72,27959,27959,19470,11429,9347
13708,1107,3237,8890,4818,9.93944e+12,59.7824,4419.66,13708,1576,72,10471,10471,7429,7359,3851
99374,4683,5806,79020,20354,5.75683e+13,12.0014,6844.92,99374,2996,20,93568,93568,83873,75525,89224
44877,9559,10473,29101,15776,9.90571e+12,60.0659,13528.6,44877,5096,72,34404,34404,33312,33041,31670
13794,2416,4524,8724,5070,8.76608e+12,58.3087,5599.21,13794,2203,72,9270,9270,7597,5394,4947
84655,33553,36258,51970,32685,7.38887e+12,57.0037,40315.2,84655,17663,72,48397,48397,47095,45398,45069
34153,7256,7965,22144,12009,9.92405e+12,60.0359,10407.8,34153,3874,72,26188,26188,25255,24439,24302
27505,700,6457,17831,9674,9.89751e+12,59.9606,8502.85,27505,3139,72,21048,21048,7491,8061,2614
71473,4707,38257,42527,28946,6.00529e+12,54.495,41228.1,71473,18615,72,33216,33216,17813,7679,4318
32664,7956,8245,21074,11590,9.6469e+12,59.6956,10554.3,32664,4001,72,24419,24419,24098,23742,23725
58054,19610,24730,35666,22388,7.42262e+12,57.0395,27705.6,58054,12046,72,33324,33324,31118,28174,27542
68471,2537,24130,42951,25520,8.37858e+12,58.215,27897.3,68471,11755,72,44341,44341,26584,16769,4969
81236,7211,20009,52488,28748,9.73184e+12,59.8275,24966.1,81236,9742,72,61227,61227,42948,21322,20495
86192,17618,26600,54732,31460,8.9318e+12,58.9314,31444.4,86192,12958,72,59592,59592,46647,31370,30798
69383,4376,17829,44694,24689,9.59819e+12,59.7429,22114.4,69383,8685,72,51554,51554,34672,34266,13962
95729,17699,25474,61502,34227,9.47726e+12,59.6071,31050.3,95729,12404,72,70255,70255,61943,50610,47945
78580,4571,20603,50540,28040,9.52975e+12,59.6573,25334.2,78580,10031,72,57977,57977,28895,18770,13352
27379,10872,12546,16675,10704,7.00395e+12,56.3815,14096,27379,6101,72,14833,14833,12813,10103,9531
69454,11058,34026,54217,15237,78598100000,8.99462,34579,69454,30618,11,35428,35428,17203,19451,14974
27316,2848,8586,17335,9981,8.8543e+12,58.427,10453.5,27316,4160,72,18730,18730,13314,9268,8178
79926,8320,37894,48423,31503,6.79783e+12,56.237,41501.2,79926,18444,72,42032,42032,28452,12568,12110
96011,20847,33732,60249,35762,8.37911e+12,58.2491,38760.4,96011,16429,72,62279,62279,54565,43943,41613
86942,14594,20190,56378,30564,9.91264e+12,60.1334,25526.8,86942,9827,72,66752,66752,58699,58524,48895
28212,3047,9505,17778,10434,8.57296e+12,57.0332,11371.9,28212,4616,72,18707,18707,11432,7628,6166
32362,14491,15513,19584,12778,6.75411e+12,56.1107,17225.8,32362,7553,72,16849,16849,15983,14987,15182
61986,11510,19977,39211,22775,8.75616e+12,58.6865,23582.2,61986,9726,72,42009,42009,34769,24912,22596
60174,13524,14018,39018,21156,9.90667e+12,60.1107,17923,60174,6823,72,46156,46156,45560,45425,44737
49754,11072,11578,32257,17497,9.91882e+12,60.0977,14907.2,49754,5637,72,38176,38176,37568,37425,36727
60178,22731,32085,35824,24354,6.02871e+12,55.3309,34673.5,60178,15622,72,28093,28093,24336,20771,19985
8441,1472,3002,5304,3137,8.47361e+12,57.6561,3720.84,8441,1462,72,5439,5439,4378,2935,2781
44467,4753,20173,27095,17372,7.06691e+12,56.0963,22472.4,44467,9822,72,24294,24294,15908,6079,5889
43306,6343,15065,27203,16103,8.41681e+12,57.7326,17664.1,43306,7325,72,28241,28241,21712,21505,13882
75414,9408,20736,48345,27069,9.36526e+12,59.4388,25237.4,75414,10090,72,54678,54678,41390,27767,24070
77606,18538,21549,49702,27904,9.32749e+12,59.4132,26148.6,77606,10490,72,56057,56057,53101,49119,48229
28659,9291,10557,17908,10751,8.16212e+12,57.8304,12372.9,28659,5128,72,18102,18102,16377,14415,14419
60442,14911,18631,38389,22053,8.94682e+12,58.9077,22218.5,60442,9075,72,41811,41811,39065,35380,34571
89910,5171,24992,57586,32324,9.32026e+12,59.2287,30205.8,89910,12152,72,64918,64918,34233,33638,14716
93282,19738,21638,60502,32780,9.9205e+12,60.1444,27307.3,93282,10537,72,71644,71644,68831,68780,65544
61694,9476,14320,40014,21680,9.91125e+12,60.1078,18310.1,61694,6960,72,47374,47374,41542,33593,31757
95311,17856,28118,60759,34552,9.10769e+12,59.1491,33483.5,95311,13697,72,67193,67193,53962,53682,37809
54142,13124,16003,34517,19625,9.0916e+12,59.0866,19331.5,54142,7784,72,38139,38139,35919,35370,32305
95958,22867,36338,59746,36212,8.02285e+12,57.6427,41187.2,95958,17680,72,59620,59620,51676,44116,42178
94284,15292,44304,57185,37099,6.84659e+12,56.1443,48480.1,94284,21561,72,49980,49980,35999,22734,19148
14063,2841,7940,11042,3021,80250300000,8.7374,8160.26,14063,7137,11,6123,6123,3194,3322,3084
10226,1324,2448,6626,3600,9.97838e+12,59.6423,3387.77,10226,1192,72,7778,7778,6159,4619,4420
13812,1076,3264,8951,4861,9.94677e+12,59.7769,4450.88,13812,1590,72,10548,10548,6550,4508,3744
34971,4638,13131,21802,13169,8.08485e+12,57.7751,15238.5,34971,6393,72,21840,21840,14904,9576,8103
83782,2316,26833,53029,30753,8.78214e+12,58.7443,31493.6,83782,13072,72,56949,56901,33075,13269,3771
57698,1105,3069,45809,11889,5.78957e+13,12.0021,3861.7,57698,1968,20,54629,54629,39977,28089,45679
16633,1652,3920,10784,5849,9.89879e+12,59.8318,5294.39,16633,1904,72,12713,12713,9361,9301,5388
50742,9161,11816,32901,17841,9.91049e+12,60.0737,15201.7,50742,5742,72,38926,38926,35789,31550,30595
83340,28461,34932,51295,32045,7.51053e+12,57.1698,38989.4,83340,17018,72,48408,48408,46043,42767,42222
59962,5552,23332,37224,22738,7.89654e+12,57.6265,26551.2,59962,11361,72,36630,36630,23506,14297,11406
10310,1633,2483,6681,3629,9.83009e+12,59.5265,3430.18,10310,1204,72,7827,7827,6588,5446,5251
36477,5858,8502,23664,12813,9.91442e+12,60.0394,11078.9,36477,4138,72,27975,27975,24825,24086,19648
83269,27331,27691,52533,30736,8.62319e+12,58.5417,32254.5,83269,13488,72,55578,55578,55243,55147,54865
69418,26240,34716,41746,27672,6.45302e+12,55.6773,37794.4,69418,16890,72,34702,34702,29850,24249,24118
79242,23846,25047,50215,29027,8.83397e+12,58.8088,29517.4,79242,12198,72,54195,54195,53290,52494,52366
88276,12863,41418,53561,34715,6.85909e+12,56.3732,45368.5,88276,20174,72,46858,46858,32777,16355,15736
21366,2426,5373,13784,7582,9.72491e+12,59.6708,7016.54,21366,2617,72,15993,15993,11766,6781,6787
60384,7108,14067,39152,21232,9.91908e+12,60.1017,17975.5,60384,6853,72,46317,46317,36205,26534,23869
24095,5013,5604,15624,8471,9.94315e+12,59.9902,7448.11,24095,2730,72,18491,18491,17627,16865,16741
39007,5449,16458,23994,15013,7.46682e+12,57.0462,18624.8,39007,8003,72,22549,22549,16232,10337,8863
32573,6385,7961,21062,11511,9.77795e+12,59.8614,10283.8,32573,3878,72,24612,24612,22401,20346,19858
15534,3555,3668,10080,5454,9.90463e+12,59.8116,4972.08,15534,1782,72,11866,11866,11716,11630,11658
48180,2812,11229,31247,16933,9.91878e+12,60.0741,14467.3,48180,5468,72,36951,36951,19669,19566,9651
3803,1330,2073,2274,1529,6.04633e+12,53.883,2385.88,3803,1006,66,1730,1730,1643,1502,1619
58886,18745,20842,36916,21970,8.35412e+12,57.6264,24161.6,58886,10148,72,38044,38044,35147,31752,31837
46899,9586,16240,29479,17420,8.4497e+12,58.2779,19017.6,46899,7905,72,30659,30659,26108,19926,18542
26728,5656,6944,17206,9522,9.55892e+12,59.5515,8894.83,26728,3368,72,19784,19784,17914,16174,15775
61310,2961,16334,39398,21912,9.47311e+12,59.5672,20152.2,61310,7952,72,44976,44976,28385,28003,8047
46368,20196,25824,27415,18953,5.73036e+12,54.2672,27836.2,46368,12558,72,20544,20544,18079,15756,15322
72039,18329,26430,45009,27030,8.18046e+12,57.9776,30290.4,72039,12867,72,45609,45609,38604,30351,30220
72573,1156,17581,46940,25633,9.79237e+12,59.9674,22103.2,72573,8560,72,54992,54992,18496,19098,4622
83544,7845,19410,54176,29368,9.92325e+12,60.1383,24562.3,83544,9456,72,64134,64134,47286,33684,26598
55395,11236,23763,34002,21393,7.37924e+12,56.9275,26617.1,55395,11558,72,31632,31632,24283,15724,15490
94164,9990,34358,58850,35314,8.20578e+12,57.7622,39217.1,94164,16733,72,59806,59806,40595,17965,17217
65813,14335,23569,41221,24592,8.28167e+12,58.1027,27192.6,65813,11467,72,42244,42244,36106,27622,25812
9032,1161,2105,5861,3171,9.99411e+12,59.7095,2970.85,9032,1025,72,6927,6927,5776,4289,4012
81493,762,18943,52854,28639,9.90671e+12,60.0915,23993.3,81493,9206,72,62550,62550,17713,19931,3455
31927,4053,7406,20719,11208,9.92273e+12,60.0346,9722.82,31927,3602,72,24521,24521,20402,14845,13578
31015,2342,7404,20088,10927,9.86175e+12,59.9259,9647.64,31015,3604,72,23611,23611,14199,13929,7490
79051,26417,38839,47648,31403,6.57153e+12,55.5406,42319.4,79051,18899,72,40212,40212,36285,30864,29790
21793,1826,6414,13901,7892,9.14397e+12,58.976,8009.38,21793,3119,72,15379,15379,10004,3695,3565
68581,34773,35001,41115,27466,6.33294e+12,55.7036,37993.5,68581,17045,72,33580,33580,33459,33317,33464
23043,7794,10782,13988,9055,6.88663e+12,52.7472,12121,23043,5238,72,12261,12261,11402,10176,10126
19541,1134,8708,11945,7596,7.17663e+12,55.8775,9923.65,19541,4229,72,10833,10737,5603,2453,1446
84843,17422,19722,55023,29820,9.90701e+12,60.1179,24945.8,84843,9596,72,65121,65121,62428,61785,57996
33925,12314,16222,20524,13401,6.76094e+12,55.4929,18006.3,33925,7897,72,17703,17703,15659,13369,13361
79194,11269,18365,51370,27824,9.91475e+12,60.1376,23295.9,79194,8940,72,60829,60829,52298,40677,37930
10254,87,439,8118,2136,5.85757e+13,11.9814,765.247,10254,436,13,9815,9815,6672,3909,8413
11035,777,2639,7154,3881,9.87824e+12,59.6052,3638.51,11035,1280,72,8396,8396,5641,5591,2426
70798,4296,16450,45918,24880,9.91166e+12,60.1207,20929.5,70798,8008,72,54348,54348,29603,29458,14837
90690,23522,26274,57888,32802,9.17738e+12,59.2288,31447,90690,12800,72,64416,64416,62236,61701,58732
47042,45012,47042,0,47042,7.99983,0,47042,47042,47042,1,0,0,0,0,0
15631,3934,5670,9782,5849,8.28116e+12,57.7978,6809.08,15631,2756,72,9961,9961,8372,6606,6603
25607,1794,9572,15969,9638,8.11456e+12,56.1401,11223.3,25607,4657,72,16035,16035,9692,4815,3326
23980,7491,7752,15166,8814,8.76002e+12,57.5276,9418.74,23980,3767,72,16228,16228,15876,15574,15615
97472,20560,22647,63204,34268,9.91638e+12,60.1445,28532.4,97472,11033,72,74825,74825,71860,69062,68380
53173,18385,23611,32502,20671,7.17532e+12,56.7219,26309,53173,11487,72,29562,29562,26816,23120,22293
48329,2348,17022,30321,18008,8.36429e+12,58.1699,19848.2,48329,8287,72,31307,31307,19400,5771,4982
74372,15097,17264,48231,26141,9.91623e+12,60.1268,21935.4,74372,8400,72,57108,57108,53933,53875,50173
44207,29607,44207,0,44207,7.99982,0,44207,44207,44207,1,0,0,0,0,0
59334,14487,14990,38276,21058,9.64521e+12,59.7788,18764.5,59334,7292,72,44344,44344,43741,43234,43179
27381,4871,11517,16863,10518,7.50083e+12,56.9778,13152.6,27381,5606,72,15864,15864,11303,5956,5960
96448,20070,23281,62391,34057,9.80091e+12,60.0008,29054.1,96448,11342,72,73167,73167,69318,64126,62939
92761,5746,21516,60156,32605,9.9212e+12,60.1495,27156.3,92761,10481,72,71245,71245,39307,22614,19945
39986,30541,39986,0,39986,7.9998,0,39986,39986,39986,1,0,0,0,0,0
46825,318,1963,37070,9755,5.85676e+13,11.9955,2673.79,46825,1959,13,44862,44862,30081,16973,38287
17128,3463,4042,11110,6018,9.87826e+12,59.7948,5448.86,17128,1955,72,13086,13086,12412,11561,11436
88075,7929,20457,57124,30951,9.91245e+12,60.137,25852.8,88075,9957,72,67618,67618,46989,45348,26899
46328,7349,16525,29025,17303,8.30891e+12,57.709,19242.2,46328,8034,72,29803,29803,23333,15107,13139
93460,8931,36726,57954,35506,7.84688e+12,57.5903,41367,93460,17892,72,56734,56734,38452,16926,16226
89047,7974,20733,57739,31308,9.9078e+12,60.1284,26176.1,89047,10094,72,68314,68314,49798,49414,27044
58358,1922,13606,37840,20518,9.92291e+12,60.1013,17404.2,58358,6628,72,44752,44752,27722,18458,6807
1598,31,110,1271,327,5.71872e+13,11.8761,230.156,1598,74,14,1488,1488,1015,710,1269
27808,2195,7671,17827,9981,9.38122e+12,59.3181,9644.91,27808,3733,72,20137,20137,13302,8547,5090
55253,8098,18862,34771,20482,8.50792e+12,58.3762,22065.2,55253,9179,72,36391,36391,24199,23937,9326
68762,20449,21922,43550,25212,8.79331e+12,58.7435,25874.6,68762,10670,72,46840,46840,45266,45203,43565
42568,3233,22268,25432,17136,6.16527e+12,55.452,24257.8,42568,10844,72,20300,20300,9190,4349,2353
38129,15188,16864,23327,14802,7.20688e+12,56.7159,18929.3,38129,8206,72,21265,21265,20672,19988,20196
28305,9856,11366,17515,10790,7.74246e+12,57.2358,13087.5,28305,5531,72,16939,16939,16193,15268,15138
28164,9412,11372,17408,10756,7.73052e+12,56.0654,13082.4,28164,5535,72,16792,16792,14933,12780,12925
58632,12925,16626,37501,21131,9.25698e+12,59.2987,20231.2,58632,8095,72,42006,42006,38718,37926,33290
95073,16984,51945,56387,38686,5.85972e+12,55.1395,55631,95073,25301,72,43128,43128,27530,9369,8808
56658,4003,19680,35602,21056,8.42732e+12,58.2653,22922.8,56658,9574,72,36978,36978,24037,8845,8260
81292,11792,32826,50262,31030,7.69645e+12,57.3971,36891.4,81292,15977,72,48466,48466,34980,21458,17753
21000,2626,10713,12591,8409,6.37999e+12,55.5432,11877,21000,5219,72,10287,10287,6353,1874,1756
24581,540,9699,15247,9334,7.82996e+12,57.4154,11256.3,24581,4718,72,14882,14642,6211,1805,1606
43224,8212,11910,27704,15520,9.35862e+12,59.3884,14736.4,43224,5796,72,31314,31314,27790,26942,21978
30382,2341,8959,19379,11003,9.13757e+12,58.7125,11035.3,30382,4348,72,21423,21423,12706,6374,4355
80818,17708,18786,52406,28412,9.92072e+12,60.1304,23793.2,80818,9152,72,62032,62032,60444,60415,58672
26508,3321,8135,16850,9658,8.95287e+12,58.783,9972.07,26508,3955,72,18373,18373,13443,7665,7521
29773,5029,8171,19090,10683,9.38194e+12,59.3663,10263.7,29773,3973,72,21602,21602,18059,13156,12210
9271,1507,2221,6005,3266,9.92001e+12,59.6008,3097.72,9271,1081,72,7050,7050,6182,5985,4889
49244,9755,12468,31758,17486,9.65554e+12,59.7563,15692.7,49244,6071,72,36776,36776,33444,28976,27978
85058,17517,47913,50188,34870,5.64027e+12,54.8736,51166,85058,23336,72,37145,37145,28447,20430,18333
30737,807,7271,19911,10826,9.86362e+12,59.8022,9508.84,30737,3525,72,23466,23466,8421,5198,2728
19845,4088,8256,12230,7615,7.58818e+12,57.0321,9531.84,19845,4021,72,11589,11589,9400,6456,5859
78143,37671,39167,46957,31186,6.45162e+12,55.5219,42554.5,78143,19076,72,38976,38976,37968,37046,36937
35258,5723,9673,22608,12650,9.37178e+12,59.3747,12072.4,35258,4698,72,25585,25585,21953,21081,15933
28035,4406,9192,17710,10325,8.68788e+12,58.5049,11069.5,28035,4467,72,18843,18843,14238,8795,8796
40225,11751,11816,25658,14567,9.14569e+12,59.0952,14423.1,40225,5756,72,28409,28409,28334,28331,28310
50151,5537,12104,32453,17698,9.80358e+12,59.9542,15423.7,50151,5891,72,38047,38047,29852,29064,18757
81295,1121,42263,48590,32705,6.20159e+12,55.499,45657.8,81295,20577,72,39032,39032,22938,12386,3547
88901,6013,20640,57649,31252,9.91458e+12,60.1403,26080.7,88901,10050,72,68261,68261,46983,32722,20790
62398,17517,22092,39125,23273,8.34354e+12,58.1765,25574.1,62398,10757,72,40306,40306,37406,33399,32678
61220,12660,14264,39699,21521,9.90436e+12,60.1033,18225.7,61220,6940,72,46956,46956,44600,41881,41863
1466,369,387,944,522,1.00678e+13,56.543,609.536,1466,184,51,1079,1079,1058,1068,1066
66915,2664,15558,43386,23529,9.91405e+12,60.1233,19827.9,66915,7575,72,51357,51357,32656,32268,9678
23009,1605,8506,14379,8630,8.14295e+12,57.7832,10032.4,23009,4134,72,14503,14503,8751,4698,3560
50733,14765,18385,31748,18985,8.2365e+12,58.0204,21289.1,50733,8947,72,32348,32348,31925,31316,31410
85124,28005,42010,66468,18656,78630400000,8.99778,42620.9,85124,37805,11,43114,43114,32088,33428,30763
96816,8021,30752,61327,35489,8.81372e+12,58.5617,36040.8,96816,14966,72,66064,66064,42025,24635,18907
82843,16858,19255,53718,29125,9.90967e+12,60.135,24377.8,82843,9369,72,63588,63588,60175,60099,56139
6361,782,1515,4133,2228,9.9076e+12,59.2489,2177.4,6361,731,72,4846,4846,3951,2833,2635
91256,38412,39956,55865,35391,7.26038e+12,56.4492,44225,91256,19443,72,51300,51300,49814,48162,48166
86057,16908,27359,54505,31552,8.80734e+12,58.7826,32144.1,86057,13321,72,58698,58698,47866,37488,34750
1425,155,384,929,496,1.0255e+13,55.9411,598.854,1425,185,48,1041,1041,709,405,492
81444,33271,39891,63576,17868,7.8589e+10,8.99747,40490.6,81444,35899,11,41553,41553,36308,36952,35683
49105,751,15404,31136,17969,8.87932e+12,58.8118,18407.2,49105,7500,72,33701,33495,14179,1472,1613
57864,12987,13506,37528,20336,9.89992e+12,60.0853,17280.7,57864,6572,72,44358,44358,43743,43602,42905
65433,2040,15213,42433,23000,9.9173e+12,60.1227,19402.5,65433,7410,72,50220,50220,19748,20685,7310
79684,35179,43683,62492,17192,79919300000,8.99596,44234.4,79684,39306,11,36001,36001,30671,31031,30329
89911,19735,45005,54038,35873,6.45339e+12,55.8799,48817.6,89911,21920,72,44906,44906,34407,24606,21878
50741,14391,17460,31914,18827,8.47022e+12,58.3036,20432.4,50741,8491,72,33281,33281,31577,29580,29711
17360,3897,5151,11067,6293,9.12417e+12,58.9157,6484.63,17360,2508,72,12209,12209,10468,8406,8554
64330,29518,30196,39025,25305,6.85737e+12,56.361,33233.7,64330,14706,72,34134,34134,34097,34023,34101
61577,16929,23343,38337,23240,8.02141e+12,57.7853,26678.4,61577,11364,72,38234,38234,33873,28807,28705
16379,62,695,12967,3412,5.85638e+13,11.9877,1110.47,16379,691,13,15684,15684,10012,5001,13158
94782,8457,37995,58638,36144,7.73902e+12,57.4661,42643.6,94782,18505,72,56787,56787,36678,13040,12247
54021,7536,13486,34868,19153,9.71059e+12,59.8294,16982.6,54021,6569,72,40535,40535,33309,33134,24566
55135,14883,24457,33696,21439,7.19774e+12,56.7572,27238.1,55135,11911,72,30678,30678,27347,22862,21863
36896,11786,20972,21741,15155,5.58574e+12,53.1467,22616.3,36896,10194,72,15924,15924,13039,9701,9792
86787,30502,35266,53620,33167,7.67341e+12,57.3765,39545.7,86787,17178,72,51521,51521,49994,47873,47599
3886,632,1654,2393,1493,7.59765e+12,49.8788,2031.41,3886,792,63,2232,2206,2013,1785,1795
69186,15754,18057,44512,24674,9.55164e+12,59.6747,22310.5,69186,8792,72,51129,51129,48400,47755,43945
98279,8197,55228,77161,21118,80264300000,8.99731,55827.4,98279,49699,11,43051,43051,14914,16455,13389
13987,1772,3709,9006,4981,9.49861e+12,59.2953,4877.96,13987,1799,72,10278,10278,7534,5022,4317
31528,2487,7365,20446,11082,9.93966e+12,60.0196,9649.72,31528,3587,72,24163,24163,17034,16894,8396
11390,4031,4161,7125,4265,8.2864e+12,57.6304,5050.92,11390,2027,72,7229,7229,7088,6982,6985
96881,22877,34889,60637,36244,8.26284e+12,57.7877,39902.4,96881,16975,72,61992,61992,54864,46573,46316
99062,7507,28199,63327,35735,9.23292e+12,59.3097,33819.6,99062,13724,72,70863,70863,42284,25358,19064
22134,4142,5173,14356,7778,9.9265e+12,59.9297,6895.5,22134,2514,72,16961,16961,15437,13737,13744
31222,9937,13538,19153,12069,7.32825e+12,55.1646,15321.8,31222,6575,72,17684,17684,15821,13238,12852
75522,6784,23335,47947,27575,8.93075e+12,58.8855,27663.5,75522,11362,72,52187,52187,34833,22019,13613
5519,1547,1830,3484,2035,8.74431e+12,52.578,2373.13,5519,882,72,3689,3689,3366,2993,2994
46978,15906,16251,29524,17454,8.45954e+12,58.2846,19029.9,46978,7916,72,30727,30727,30229,29725,29806
95208,29744,30173,60316,34892,8.81952e+12,58.7221,35395.6,95208,14687,72,65035,65035,64900,64686,64817
6213,899,1470,4025,2188,9.98301e+12,59.3705,2121.6,6213,716,72,4743,4743,4060,3909,3101
74657,15818,17321,48415,26242,9.92394e+12,60.1365,22007.8,74657,8432,72,57336,57336,55489,55069,52548
81288,23820,24518,51725,29563,9.01335e+12,59.0212,29166.3,81288,11930,72,56770,56770,55951,55759,54725
93547,14143,25494,60001,33546,9.39487e+12,59.5003,30918.7,93547,12413,72,68053,68053,58748,46053,43062
51894,2674,12073,33656,18238,9.91196e+12,60.0945,15523,51894,5875,72,39821,39821,19650,19881,9246
50810,5229,11826,32944,17866,9.9222e+12,60.0898,15213.2,50810,5755,72,38984,38984,29408,21155,17733
30986,5128,11253,19385,11601,8.24509e+12,57.9483,13196.4,30986,5475,72,19733,19733,16481,12326,11385
57983,216,4095,46266,11717,5.68332e+13,11.9965,4875.16,57983,2353,14,53888,53888,30520,15984,43318
26793,7144,9713,16770,10023,8.26381e+12,57.7447,11446.1,26793,4715,72,17080,17080,14864,12254,12378
32093,3007,11985,20026,12067,8.1197e+12,57.8021,13958.2,32093,5835,72,20108,20108,12961,12708,4349
39817,5515,9258,25823,13994,9.92398e+12,60.0652,12029.5,39817,4504,72,30559,30559,26056,25006,18576
44654,6269,10400,28959,15695,9.91692e+12,60.0233,13444.8,44654,5049,72,34254,34254,28332,28213,21179
35710,5929,9793,22904,12806,9.39584e+12,59.3926,12213.2,35710,4770,72,25917,25917,22084,21170,15743
90879,8735,25597,58141,32738,9.27705e+12,59.3585,30834.4,90879,12464,72,65282,65282,42431,42533,23071
87684,7124,20352,56866,30818,9.92576e+12,60.1414,25724.6,87684,9914,72,67332,67332,48009,33802,24250
88109,12440,20457,57140,30969,9.91661e+12,60.1378,25854.9,88109,9959,72,67652,67652,55964,55729,41671
37679,7033,14987,23345,14334,7.77521e+12,57.4185,17164.3,37679,7288,72,22692,22644,17752,11887,11870
2377,931,1234,1431,946,6.44924e+12,37.0854,1468.93,2377,580,57,1143,1143,1143,1143,1143
39598,919,10579,25435,14163,9.46292e+12,58.871,13237.2,39598,5139,72,29019,29019,16761,7046,1780
77803,8369,18045,50461,27342,9.924e+12,60.1284,22898.2,77803,8784,72,59758,59758,45630,45353,28280
67829,8713,15783,43989,23840,9.90818e+12,60.1027,20099.7,67829,7676,72,52046,52046,41714,41503,29125
97796,17332,45813,59338,38458,6.87347e+12,56.3938,50121.6,97796,22319,72,51983,51983,38027,24791,21222
59347,7530,19800,37432,21915,8.61928e+12,58.4892,23225.6,59347,9638,72,39547,39499,26938,15673,11539
49362,3823,11502,32014,17348,9.90288e+12,60.0811,14811.1,49362,5593,72,37860,37860,23820,23242,13026
65312,22126,31957,39391,25921,6.59787e+12,55.6163,34937.9,65312,15557,72,33355,33355,30244,25938,25136
63669,9401,14829,41285,22384,9.89803e+12,60.0883,18922,63669,7209,72,48840,48840,42387,40866,31530
5036,51,1207,3275,1761,1.00324e+13,59.1116,1762.17,5036,586,72,3381,1171,2144,1362,192
64208,476,14948,41632,22576,9.90768e+12,60.1075,19069.4,64208,7276,72,49260,49260,13445,15242,2301
85610,5640,19880,55511,30099,9.91432e+12,60.1401,25148.5,85610,9682,72,65730,65730,45034,44612,19554
98791,13374,37871,61426,37365,7.96515e+12,57.6775,42808.8,98791,18443,72,60920,60920,42210,24402,19412
68649,14673,18576,44064,24585,9.42785e+12,59.5159,22753.6,68649,9046,72,50073,50073,45391,45276,39779
90347,16584,25982,57706,32641,9.19976e+12,57.4481,31158.3,90347,12651,72,64365,64365,56215,45119,42506
57056,1882,19148,35956,21100,8.58731e+12,58.473,22458,57056,9323,72,37908,37908,18455,8887,5062
84354,4620,35432,51907,32447,7.49099e+12,56.6585,39531.6,84354,17256,72,48922,48922,30330,8549,7833
33253,869,11103,20970,12283,8.63037e+12,58.4358,13232.1,33253,5408,72,22150,22150,10323,2834,2557
23538,2044,5565,15259,8279,9.86548e+12,59.879,7370.45,23538,2697,72,17973,17973,12077,11617,6766
89116,3871,31464,55886,33230,8.35215e+12,58.2219,36176,89116,15316,72,57652,57652,34592,10396,6395
87245,29314,35089,53954,33291,7.73071e+12,57.4438,39411.4,87245,17094,72,52156,52156,47905,42932,42954
3299,231,813,2144,1155,1.0066e+13,58.3716,1217.53,3299,392,63,2486,2486,1631,1030,780
3556,661,882,2308,1248,9.78121e+12,58.4027,1310.08,3556,424,65,2674,2674,2421,2367,2178
6609,1780,2253,4168,2441,8.76023e+12,57.7246,2860.99,6609,1097,72,4356,4356,3780,3090,2997
69908,1030,31607,42633,27275,7.07972e+12,56.4944,34945.7,69908,15380,72,38301,38000,18047,5821,1489
65681,12773,15213,42597,23084,9.93172e+12,60.1362,19420.1,65681,7405,72,50468,50468,46850,43431,42559
63600,6060,14810,41243,22357,9.91743e+12,60.1059,18895.9,63600,7211,72,48790,48790,36121,35853,20621
13932,1610,5042,8730,5202,8.31267e+12,57.3734,6085.12,13932,2439,72,8890,8890,4928,1765,938
30266,5948,11702,18807,11459,7.93478e+12,56.6304,13558.2,30266,5679,72,18564,18564,15191,10650,9613
78006,17541,25256,49325,28681,8.73379e+12,58.6766,29623.3,78006,12295,72,52750,52750,45596,35836,33552
68346,3800,20627,43482,24864,9.02118e+12,58.759,24641.6,68346,10043,72,47719,47719,24383,13187,8584
33393,13080,17469,19945,13448,6.17168e+12,54.9098,19113.3,33393,8487,72,15924,15924,13861,11479,11566
20560,4081,4863,13318,7242,9.89932e+12,59.8991,6483.79,20560,2369,72,15697,15697,14670,14631,13593
9951,3414,4366,6097,3854,7.35923e+12,56.432,5100.6,9951,2126,72,5585,5585,5120,4592,4804
49633,13219,19566,30768,18865,7.82421e+12,57.5093,22300.4,49633,9523,72,30067,30067,25115,19332,19197
87615,30406,30931,54951,32664,8.35904e+12,58.2238,35572,87615,15068,72,56684,56684,55922,55114,55156
75313,18423,25742,47382,27931,8.50329e+12,57.9785,29888,75313,12535,72,49571,49571,42241,35226,33442
99283,9215,23066,64380,34903,9.91275e+12,60.1424,29046.7,99283,11232,72,76217,76217,56079,55666,31305
76975,30693,37388,46484,30491,6.64005e+12,55.5073,40821.5,76975,18193,72,39587,39587,37532,34685,34235
76468,36821,38070,46014,30454,6.48177e+12,55.3702,41417.6,76468,18524,72,38398,38398,37975,37426,37466
95943,17399,33980,60149,35794,8.34359e+12,58.207,38987.4,95943,16547,72,61963,61963,51324,48596,33380
13117,550,3733,8388,4729,9.34826e+12,59.003,4818.06,13117,1818,72,9384,9336,4058,2597,1742
93131,31427,47372,55849,37282,6.34612e+12,55.5319,51249.2,93131,23068,72,45759,45759,37322,27522,27177
17104,2879,4020,11100,6004,9.92456e+12,59.8759,5425.73,17104,1956,72,13084,13084,11454,11411,9689
32315,5130,8841,20723,11592,9.40794e+12,59.3859,11074,32315,4307,72,23474,23474,18959,18847,13555
53564,2890,19014,33582,19982,8.33111e+12,58.0231,22082.3,53564,9240,72,34550,34502,24419,12844,9873
16713,3710,6899,10310,6403,7.64289e+12,57.0578,8025.21,16713,3361,72,9814,9814,7544,5386,5009
57249,12674,13303,37126,20123,9.9072e+12,60.0916,17049.1,57249,6466,72,43946,43946,43209,43037,42113
3085,1421,1664,2418,667,7.9556e+10,8.89984,1767.18,3085,1489,11,1421,1421,1266,1278,1273
37649,8450,9281,24323,13326,9.73039e+12,59.8175,11889.9,37649,4507,72,28368,28368,27379,26085,25860
3552,398,933,2301,1251,9.59188e+12,58.2787,1356.84,3552,448,66,2619,2619,1913,1872,1315
54956,8580,14188,35395,19561,9.5946e+12,59.6957,17701.5,54956,6910,72,40768,40768,34686,26426,24517
23086,1961,5383,14978,8108,9.93508e+12,59.9767,7165.41,23086,2621,72,17703,17703,11751,11442,6779
22084,4661,11727,13167,8917,6.08016e+12,55.1814,12898.8,22084,5709,72,10357,10357,7893,5680,5113
66630,6263,18591,42654,23976,9.31742e+12,59.3839,22625.2,66630,9057,72,48039,48039,33522,22321,15767
7874,3814,4646,4614,3260,5.40727e+12,31.8165,5138.89,7874,2257,68,3228,3228,2004,1982,670
65604,17261,18718,41939,23665,9.23381e+12,55.9516,22671.4,65604,9101,72,46886,46886,46886,46886,46886
53982,5897,12546,35008,18974,9.92803e+12,60.0984,16105.4,53982,6112,72,41436,41436,31788,22971,20022
63247,18888,26489,38937,24310,7.51336e+12,57.1594,29716.2,63247,12903,72,36758,36758,33272,28579,27511
95744,11538,55095,56277,39467,5.4866e+12,54.5827,58603.5,95744,26841,72,40649,40649,23190,10736,6783
77415,23312,34695,47252,30163,7.12838e+12,56.4384,38355.6,77415,16879,72,42720,42720,34909,25753,25538
2331,1108,1455,1358,973,5.11486e+12,28.8636,1649.23,2331,686,51,876,876,876,876,876
69539,17962,20853,44265,25274,9.04607e+12,59.0455,24934.3,69539,10151,72,48686,48686,45408,42311,41515
4603,231,1168,2980,1623,9.866e+12,58.796,1680.24,4603,567,72,3435,3435,2168,810,806
78084,19190,19997,50301,27783,9.60842e+12,59.7624,24737.1,78084,9741,72,58087,58087,57114,56890,55671
96654,12321,31560,61067,35587,8.69492e+12,58.6453,36783.5,96654,15370,72,65094,65094,42554,15935,14861
42807,8436,9942,27759,15048,9.92059e+12,60.075,12884.8,42807,4836,72,32865,32865,30661,28576,28117
69958,18786,38072,41516,28442,5.89184e+12,55.1787,40943.5,69958,18546,72,31886,31886,22558,13761,11454
52187,3214,12145,33850,18337,9.92141e+12,60.0936,15608.2,52187,5911,72,40042,40042,27016,26757,11042
33015,2840,10089,20988,12027,8.99354e+12,58.8813,12279,33015,4914,72,22926,22926,16655,9361,9145
42531,2972,14973,26682,15849,8.36983e+12,57.5523,17522,42531,7278,72,27558,27558,17714,17367,5780
23919,216,7124,15243,8676,9.07334e+12,58.9079,8834.51,23919,3465,72,16795,16689,9606,5227,906
69145,14113,16063,44833,24312,9.91861e+12,60.1314,20453.4,69145,7822,72,53082,53082,50699,50149,46832
14569,7964,9444,11434,3135,2.22704e+13,5.49763,10860.8,14569,3145,13,5125,5125,4923,5125,4435
72434,24675,27135,45148,27286,8.08873e+12,57.8709,30973.4,72434,13219,72,45299,45299,43637,41339,41032
33616,5213,8806,21622,11994,9.54229e+12,59.5763,11145.5,33616,4286,72,24810,24810,20184,15807,14644
20105,2834,4706,13042,7063,9.91184e+12,59.9084,6304.27,20105,2287,72,15399,15399,12739,10234,9652
94221,14215,26273,60321,33900,9.3096e+12,59.4047,31694.6,94221,12789,72,67948,67948,56071,53227,35961
44292,10577,21696,34573,9719,78532200000,8.99605,22135.9,44292,19525,11,22596,22596,13763,14853,12692
76884,2021,22214,49098,27786,9.17884e+12,59.2206,26715.2,76884,10809,72,54670,54670,32286,20588,4797
12207,6514,6533,7281,4926,6.0465e+12,52.4724,7278.82,12207,3161,72,5674,5674,5674,5674,5674
33831,7233,11087,21373,12458,8.69292e+12,58.5331,13265.5,33831,5395,72,22744,22744,19644,18872,14565
47847,1152,11144,31019,16828,9.91372e+12,60.0957,14367.4,47847,5428,72,36703,36703,22201,21901,4419
21425,266,1242,17025,4400,5.76713e+13,12.0059,1721.92,21425,539,20,20183,20183,13268,7801,15149
63429,7583,21290,39971,23458,8.586e+12,58.4815,24904.7,63429,10368,72,42139,42139,28299,16785,13313
42015,1775,9767,27248,14767,9.91835e+12,60.071,12662,42015,4753,72,32248,32248,20605,20370,6373
32066,6743,7438,20805,11261,9.93265e+12,60.0302,9760.81,32066,3617,72,24628,24628,23606,23586,22545
3192,521,806,2074,1118,9.74119e+12,58.0586,1201.27,3192,378,62,2386,2386,2071,1997,1700
76697,18283,23817,48676,28021,8.91233e+12,58.8876,28189.9,76697,11603,72,52880,52880,44794,44637,34953
7206,1636,1704,4675,2531,1.00052e+13,59.3383,2428.28,7206,828,72,5502,5502,5445,5430,5430
84356,2481,19593,54705,29651,9.91371e+12,60.1411,24795.8,84356,9538,72,64763,64763,24966,9580,8985
46112,9293,12151,29654,16458,9.51127e+12,59.5822,15172.3,46112,5914,72,33961,33961,31515,28235,27532
37186,13589,16471,22743,14443,7.1913e+12,56.6966,18494.5,37186,8010,72,20715,20715,19410,17616,17351
56968,9932,15233,36599,20369,9.45777e+12,59.5315,18819.1,56968,7409,72,41735,41735,35102,32869,27065
11876,4399,8137,6753,5123,4.15868e+12,24.4523,8684.67,11876,3957,72,3739,3739,2392,508,0
69190,8509,23775,43518,25672,8.47437e+12,58.0668,27625,69190,11564,72,45415,45415,33728,20000,19638
52961,2934,15681,33747,19214,9.10115e+12,59.0965,18946.9,52961,7636,72,37280,37280,17030,10514,6851
46719,6378,10888,30291,16428,9.91611e+12,60.0838,14048.2,46719,5299,72,35831,35831,29359,23203,21539
40131,9525,11852,25576,14555,9.11419e+12,59.0798,14452,40131,5770,72,28279,28279,26623,26226,24007
91870,10136,26969,58583,33287,9.12139e+12,59.173,32182.5,91870,13131,72,64901,64901,48594,29422,28674
36708,5146,10154,23533,13175,9.35323e+12,59.3465,12624.5,36708,4940,72,26554,26554,20864,20717,14021
38281,7568,8916,24828,13453,9.91077e+12,60.0447,11595.7,38281,4338,72,29365,29365,27376,25511,25109
20328,1746,7226,12744,7584,8.35083e+12,57.9979,8633.4,20328,3514,72,13102,13102,7321,5061,4180
63116,8153,28357,38508,24608,7.12414e+12,56.6214,31437.3,63116,13808,72,34759,34759,22710,12760,9771
84990,14121,34674,52472,32518,7.64871e+12,57.3493,38869.9,84990,16886,72,50316,50316,41250,30730,28079
56141,10335,13036,36411,19730,9.92054e+12,60.1168,16722,56141,6348,72,43105,43105,39226,35536,34612
88517,1157,35937,54693,33824,7.67739e+12,57.3811,40290.9,88517,17501,72,52580,52560,30380,15542,3411
70810,11062,16446,45918,24892,9.92188e+12,60.126,20923,70810,8012,72,54364,54364,47854,46341,36918
18768,1424,4395,12167,6601,9.93698e+12,59.904,5905.98,18768,2141,72,14373,14373,8843,8703,4969
20379,3383,4777,13215,7164,9.8972e+12,59.8787,6391.11,20379,2321,72,15602,15602,13910,13521,11218
64557,17838,27898,39591,24966,7.33459e+12,56.5208,31120.5,64557,13569,72,36659,36659,30991,24340,24287
55460,26862,30737,43516,11944,80103800000,8.96992,31191.1,55460,27657,11,24723,24723,22441,22557,22344
58545,4869,18050,37187,21358,8.94581e+12,58.8971,21544.3,58545,8789,72,40495,40495,27992,13229,12822
64210,17609,18294,41044,23166,9.23107e+12,59.2738,22181,64210,8896,72,45916,45916,45850,45771,45876
97416,18536,23271,63060,34356,9.83169e+12,60.0408,29108.9,97416,11336,72,74145,74145,67862,67719,60278
76907,17905,26263,48392,28515,8.50426e+12,58.4044,30485.6,76907,12789,72,50644,50644,43444,33638,31336
66130,5488,21334,41832,24298,8.75685e+12,58.6886,25138.1,66130,10393,72,44796,44748,27503,21852,18736
65204,17118,24695,40606,24598,8.01937e+12,57.7855,28195,65204,12018,72,40509,40509,34010,26420,26178
58708,23156,30076,35168,23540,6.30527e+12,55.241,32704.7,58708,14639,72,28632,28632,24346,19343,19344
36198,5639,9503,23290,12908,9.52839e+12,59.5543,11983.7,36198,4623,72,26695,26695,22446,16689,15367
3279,565,1432,2013,1266,7.7019e+12,55.1842,1756.34,3279,697,67,1847,1800,1661,1564,1603
43360,2712,10128,28111,15249,9.91167e+12,60.0625,13092.3,43360,4933,72,33232,33232,22442,22222,9255
60700,13435,14075,39364,21336,9.92368e+12,60.1259,18009.7,60700,6853,72,46625,46625,45686,44855,44715
50283,404,11719,32606,17677,9.90217e+12,60.0654,15076.7,50283,5701,72,38564,38564,22107,21774,1878
71507,2585,39421,56093,15414,7.9993e+10,8.99533,39940.3,71507,35470,11,32086,32086,9280,10743,7831
64204,2424,14953,41640,22564,9.90386e+12,60.0998,19074.2,64204,7275,72,49251,49251,30990,30624,8532
14829,3438,3508,9620,5209,9.90646e+12,59.7791,4764.91,14829,1704,72,11321,11321,11242,11244,11222
60251,1481,2653,47718,12533,5.84565e+13,12.002,3467.08,60251,1795,20,57598,57598,48069,39948,49828
99458,3596,32436,62845,36613,8.71082e+12,58.6599,37787.5,99458,15802,72,67022,67022,33358,14521,7400
85942,24979,39922,52211,33731,6.91663e+12,56.4459,43814.3,85942,19442,72,46020,46020,37730,26313,23791
57270,336,18010,36306,20964,8.86245e+12,58.5259,21419.3,57270,8769,72,39260,38876,21975,11682,0
89911,1678,34993,55826,34085,7.8868e+12,57.6447,39512.4,89911,17041,72,54918,54918,31570,15367,3139
78674,17636,20045,50700,27974,9.62655e+12,59.7798,24821.9,78674,9760,72,58629,58629,55771,55095,51103
46242,13248,17697,28756,17486,7.99254e+12,57.7125,20316.5,46242,8621,72,28545,28545,23098,16701,16608
75796,4566,30740,46828,28968,7.68504e+12,57.3529,34564,75796,14969,72,45056,45056,27463,6872,6203
68809,8026,32858,41650,27159,6.75748e+12,56.0576,36024.4,68809,15991,72,35951,35951,22927,13923,10918
83906,2921,35587,51579,32327,7.43633e+12,57.0053,39642.9,83906,17326,72,48319,48319,28026,9614,3438
8031,1349,1952,5210,2821,9.86156e+12,59.3779,2735.18,8031,947,72,6079,6079,5215,5188,4376
77622,13011,23895,49298,28324,8.94508e+12,58.9324,28327,77622,11641,72,53727,53727,42854,42521,29628
11858,1777,4031,7477,4381,8.59387e+12,58.083,4978.32,11858,1958,72,7827,7827,5256,2298,2247
62239,14009,21750,39073,23166,8.4126e+12,58.2614,25242.6,62239,10595,72,40489,40489,36110,30194,28834
56641,5607,13219,36731,19910,9.90812e+12,60.0861,16924.4,56641,6437,72,43422,43422,32340,23087,18798
8417,2223,3816,5143,3274,7.18308e+12,56.0524,4451.1,8417,1855,72,4601,4601,4137,3484,3573
94908,15733,21999,61558,33350,9.92403e+12,60.1519,27755,94908,10716,72,72909,72909,63718,54923,52502
35488,6653,18929,27798,7690,79555700000,8.95193,19302,35488,17032,11,16559,16559,8562,9182,7960
68828,8415,25448,42965,25863,8.14146e+12,56.9936,29155.8,68828,12375,72,43380,43380,29600,17616,14238
72237,3307,24610,45472,26765,8.51178e+12,58.4002,28617.1,72237,11983,72,47627,47627,29263,8890,6926
85984,15087,29433,54096,31888,8.49294e+12,58.3568,34063.6,85984,14329,72,56551,56551,45853,33278,32967
11082,1588,3677,7000,4082,8.65857e+12,58.102,4586.46,11082,1782,72,7405,7405,5898,4186,4223
59013,4601,26143,36068,22945,7.20101e+12,56.3114,29085.9,59013,12731,72,32870,32870,19825,4662,4076
47301,769,19038,29252,18049,7.72379e+12,57.3855,21637.6,47301,9269,72,28263,27783,16209,8095,1670
61228,29670,31440,36669,24559,6.28685e+12,54.962,34156.9,61228,15296,72,29788,29788,29436,29104,29232
48786,4529,11376,31635,17151,9.91501e+12,60.0789,14648.3,48786,5538,72,37410,37410,26507,17716,15359
28360,6243,6656,18388,9972,9.89939e+12,59.9717,8753.16,28360,3238,72,21704,21704,21107,21093,20571
46135,2505,2917,36726,9409,5.72981e+13,12.0028,3621.53,46135,1269,20,43218,43218,40254,38080,41861
7037,870,2445,4424,2613,8.55173e+12,57.5933,3079.51,7037,1190,72,4592,4592,3638,2517,2708
26456,2149,8449,16758,9698,8.79865e+12,58.6084,10255.4,26456,4110,72,18007,18007,11589,10325,4917
73402,5510,73402,0,73402,7.99989,0,73402,73402,73402,1,0,0,0,0,0
98519,1453,31193,62412,36107,8.82563e+12,58.8106,36570.3,98519,15194,72,67326,67278,27336,13369,5891
85978,38033,43059,51688,34290,6.44982e+12,55.7,46730.2,85978,20959,72,42919,42919,40432,36991,36397
26949,3157,7046,17339,9610,9.54361e+12,57.7468,9006.92,26949,3416,72,19903,19903,14276,14163,7488
24947,1863,5877,16171,8776,9.89959e+12,59.939,7767.47,24947,2859,72,19070,19070,11607,11310,6196
10227,275,2383,6640,3587,9.99199e+12,59.721,3332.34,10227,1159,72,7844,7844,4730,4676,1055
51731,13306,16888,32690,19041,8.70039e+12,58.5879,19976.1,51731,8212,72,34843,34843,31718,27493,26551
35811,11007,12789,22434,13377,8.3231e+12,58.0907,14991,35811,6230,72,23022,23022,20818,18708,18347
39323,12278,14202,24604,14719,8.27273e+12,51.7892,16564.3,39323,6912,72,25121,25121,23129,21300,20873
10340,1935,3771,6467,3873,8.23668e+12,57.6089,4604.02,10340,1826,72,6569,6569,5884,4943,4883
92053,41105,59633,72179,19874,2.23443e+13,5.5298,68311.6,92053,19884,13,32420,32420,29820,32420,23654
66357,427,15436,43035,23322,9.90763e+12,60.1145,19676.2,66357,7514,72,50921,50921,29065,28623,2155
21987,2233,5132,14260,7727,9.91553e+12,59.9641,6851.17,21987,2491,72,16855,16855,12671,12162,7721
94413,24498,37383,58488,35925,7.80233e+12,57.5341,42049.6,94413,18207,72,57030,57030,47276,35767,35505
85615,17326,28852,53937,31678,8.57413e+12,58.4742,33494.7,85615,14055,72,56763,56763,46804,33223,30004
67343,19761,26908,41678,25665,7.76448e+12,57.3045,30401.2,67343,13102,72,40435,40435,36037,29974,28753
46658,1519,14202,29674,16984,8.98017e+12,58.9346,17115.3,46658,6907,72,32456,32456,18905,6627,2397
56460,8085,16850,35966,20494,9.06759e+12,59.0548,20282.3,56460,8206,72,39610,39610,30846,19694,16982
25357,2975,6405,16359,8998,9.67233e+12,59.6982,8290.43,25357,3116,72,18952,18952,15151,14742,9967
76271,15186,17763,49454,26817,9.90389e+12,60.116,22530.9,76271,8648,72,58508,58508,54812,51319,50418
47690,7398,19337,29467,18223,7.67877e+12,56.7481,21945.6,47690,9403,72,28353,28353,19817,12208,10017
94824,8164,21986,61504,33320,9.91495e+12,60.1529,27741.5,94824,10704,72,72838,72838,49175,47621,27783
37965,498,10288,24369,13596,9.436e+12,59.4442,12841.2,37965,5007,72,27677,27581,16126,15846,2036
66976,22111,24267,41896,25080,8.23939e+12,58.0628,27925,66976,11818,72,42709,42709,41597,40311,40439
62235,13075,16300,40043,22192,9.53976e+12,59.6421,20184.2,62235,7939,72,45935,45935,42882,42148,37874
97746,4002,30237,62061,35685,8.92152e+12,58.9207,35625.7,97746,14727,72,67509,67461,34137,18670,11891
14812,3642,3844,9547,5265,9.54494e+12,59.3233,5071.12,14812,1858,72,10968,10968,10755,10704,10535
43649,22306,28278,34225,9424,2.2345e+13,5.52617,32431.9,43649,9426,13,15371,15371,14539,15371,12550
32237,3074,7532,20897,11340,9.91517e+12,60.0252,9862.07,32237,3663,72,24705,24705,17911,17196,10601
70222,4372,31789,42817,27405,7.0723e+12,56.0953,35137.2,70222,15469,72,38433,38433,24830,8958,8376
24674,5537,9343,15376,9298,8.03071e+12,57.6179,10935.3,24674,4538,72,15331,15331,12655,10141,9548
68643,3558,15973,44518,24125,9.90042e+12,60.1036,20335.4,68643,7766,72,52670,52670,34696,23783,12597
95448,9198,28814,60729,34719,9.01148e+12,58.6471,34145.6,95448,14015,72,66634,66634,47318,24470,23712
50053,10380,16971,31518,18535,8.54108e+12,57.7831,19931.9,50053,8251,72,33082,33082,28070,22160,22140
64559,7764,23698,40333,24226,8.17855e+12,57.97,27220.6,64559,11535,72,40861,40861,27096,16382,13133
37657,4366,15769,23179,14478,7.50833e+12,57.0701,17884.6,37657,7668,72,21888,21888,14957,6903,6637
94063,29171,38730,58021,36042,7.60049e+12,57.2962,43276.2,94063,18866,72,55333,55333,49968,42569,41018
12252,3047,3994,7751,4501,8.75793e+12,58.3007,4982.06,12252,1939,72,8258,8258,7744,7019,7089
58513,12730,28289,35358,23155,6.66602e+12,56.1091,31036.2,58513,13768,72,30224,30224,23181,15036,14763
19562,6060,8556,11982,7580,7.29917e+12,56.6709,9784.53,19562,4162,72,11006,11006,9564,7882,8049
88163,4822,48337,69142,19021,79949400000,8.99754,48917.4,88163,43496,11,39826,39826,12296,14220,10388
84188,2875,19566,54592,29596,9.91484e+12,60.133,24754,84188,9531,72,64622,64622,40392,39893,10552
15094,3224,6847,9203,5891,7.10877e+12,54.8372,7835.02,15094,3330,72,8247,8247,6526,4732,4331
70347,12131,16337,45614,24733,9.91862e+12,60.1323,20792.1,70347,7955,72,54010,54010,48941,47758,40486
22300,7766,10931,13444,8856,6.6193e+12,55.8633,12192.5,22300,5319,72,11369,11369,10174,8551,8328
32877,5243,7674,21314,11563,9.91214e+12,60.0251,10043.6,32877,3732,72,25203,25203,21735,21657,17610
29548,3232,13057,18069,11479,7.2246e+12,56.041,14745.1,29548,6350,72,16491,16491,10392,3332,3119
31385,2491,9926,19892,11493,8.84568e+12,57.5113,12008.6,31385,4829,72,21459,21459,14452,14234,5993
37617,2996,8763,24398,13219,9.91586e+12,60.0391,11403.5,37617,4265,72,28854,28854,18481,11599,10169
55558,3325,12911,36040,19518,9.91986e+12,60.1027,16561.6,55558,6287,72,42647,42647,22928,22881,11434
6066,1437,1454,3938,2128,9.82887e+12,59.1555,2093.97,6066,693,72,4612,4612,4612,4612,4612
29049,868,6808,18834,10215,9.90882e+12,59.9808,8947.48,29049,3310,72,22241,22241,8596,8997,3185
83524,15085,24897,53192,30332,9.0609e+12,59.0825,29673.8,83524,12123,72,58627,58627,50653,39659,37242
89233,1622,20708,57862,31371,9.91893e+12,60.1483,26166.8,89233,10083,72,68525,68525,40718,40158,6439
73315,6898,29155,45405,27910,7.78258e+12,57.4973,32914.4,73315,14197,72,44160,44160,27842,13858,9851
51216,4365,17951,32149,19067,8.38062e+12,58.1968,20923,51216,8730,72,33265,33217,25493,24147,14760
18131,2291,8645,10990,7141,6.76402e+12,55.0323,9744.38,18131,4189,72,9486,9486,5927,1827,1762
70373,14052,23367,44394,25979,8.62832e+12,58.5389,27329.5,70373,11378,72,47006,47006,40083,30539,28474
73167,10837,68374,50373,22794,9.21066e+12,3.99597,68508.5,73167,22807,9,4793,4793,756,4793,763
82669,2424,19215,53605,29064,9.91e+12,60.1254,24325,82669,9352,72,63454,63454,39088,26011,9065
94363,24661,27974,60124,34239,9.07903e+12,59.1154,33287.7,94363,13612,72,66389,66389,61622,61522,55893
64025,13773,17413,41064,22961,9.40829e+12,59.4195,21347.5,64025,8477,72,46612,46612,43487,42710,38345
77923,3595,18142,50525,27398,9.90159e+12,60.1152,23000.7,77923,8822,72,59781,59781,38645,38215,12626
8253,2084,2391,5272,2981,9.2863e+12,55.734,3155.31,8253,1159,72,5862,5862,5418,4974,5072
80540,21620,25689,51001,29539,8.79734e+12,58.746,30200.2,80540,12506,72,54851,54851,50222,44824,44666
96925,19127,34759,60701,36224,8.28255e+12,57.8665,39782.2,96925,16912,72,62166,62166,49959,38363,35125
64461,589,29751,39188,25273,6.95797e+12,56.2721,32829.5,64461,14486,72,34710,33731,19710,10947,1599
80972,18827,20898,52132,28840,9.58472e+12,59.6398,25775.5,80972,10175,72,60074,60074,57538,54150,53402
94218,18211,37375,58362,35856,7.79136e+12,57.4985,42031.2,94218,18202,72,56843,56843,41398,23189,22632
6508,167,283,5152,1356,5.85544e+13,11.969,540.465,6508,280,13,6225,6225,5207,4332,5767
31794,15657,16250,19064,12730,6.32149e+12,55.6128,17861.7,31794,7911,72,15544,15544,14960,14404,14484
98813,5530,29238,62961,35852,9.0952e+12,59.14,34766.9,98813,14244,72,69575,69575,44929,15873,14704
49686,5861,13648,31857,17829,9.38104e+12,59.4244,16819.7,49686,6647,72,36038,36038,26710,27022,16543
36583,7587,12005,23101,13482,8.69069e+12,58.5469,14325,36583,5846,72,24578,24578,20973,16097,15010
23257,3040,7908,14638,8619,8.56812e+12,58.3025,9501.36,23257,3852,72,15349,15349,10756,5368,5362
72482,1905,18484,46717,25765,9.62643e+12,59.7687,22935.8,72482,9004,72,53998,53998,21488,21205,6890
68447,20245,22979,43142,25305,8.58482e+12,58.1556,26832.2,68447,11178,72,45468,45468,42734,39499,39596
93779,24179,30998,59191,34588,8.64815e+12,58.578,36060.4,93779,15095,72,62781,62781,55871,49242,47589
63397,1519,14757,41108,22289,9.91341e+12,60.1087,18834.9,63397,7183,72,48640,48640,29298,28915,5510
61449,18575,19371,38950,22499,8.85565e+12,58.7955,22977.5,61449,9437,72,42078,42078,41113,39885,39665
67691,8245,29667,41428,26263,7.2633e+12,56.8591,32984.3,67691,14453,72,38024,38024,26120,15163,11809
9620,887,2305,6236,3384,9.91433e+12,59.5831,3205.21,9620,1121,72,7315,7315,4943,3205,2826
50926,9380,11866,33032,17894,9.89987e+12,60.0771,15261.3,50926,5770,72,39060,39060,36120,32171,31280
20898,9110,9363,12768,8130,7.17189e+12,56.2786,10637.7,20898,4545,72,11535,11535,11378,11259,11253
24011,560,5599,15574,8437,9.9308e+12,59.9586,7437.94,24011,2721,72,18412,18412,6427,6880,2094
62041,10016,14400,40249,21792,9.91517e+12,60.1155,18408.9,62041,7008,72,47641,47641,42361,41132,33533
96257,10016,22374,62414,33843,9.9147e+12,60.1441,28194,96257,10899,72,73883,73883,56518,54003,33712
36633,7241,8539,23761,12872,9.90331e+12,60.0428,11127.9,36633,4150,72,28094,28094,26308,26260,24292
33958,1956,7923,22025,11933,9.91415e+12,60.0445,10353.8,33958,3858,72,26035,26035,17294,17125,6643
78793,7344,29675,49092,29701,8.06278e+12,57.8408,33783,78793,14457,72,49118,49118,27918,14368,9735
64537,8564,18724,41203,23334,9.17093e+12,59.1963,22600.9,64537,9117,72,45813,45813,35163,34884,22179
35387,8484,8860,22840,12547,9.67461e+12,59.7341,11329.8,35387,4301,72,26527,26527,26099,26003,25550
32711,625,11471,20545,12166,8.39189e+12,58.1593,13534.9,32711,5583,72,21240,21048,9145,4595,2354
73382,14786,17042,47594,25788,9.9108e+12,60.1249,21662.2,73382,8291,72,56340,56340,53019,52960,49069
98137,12598,40275,60558,37579,7.61192e+12,57.309,44997.3,98137,19611,72,57862,57862,39062,22498,17776
5330,1019,1322,3446,1884,9.90503e+12,59.127,1898.42,5330,644,72,4008,4008,3638,3562,3234
14318,912,3652,9241,5077,9.63574e+12,58.3396,4855.11,14318,1756,72,10666,10666,5789,5745,2923
30606,6270,10080,19333,11273,8.68131e+12,58.4862,12087.1,30606,4904,72,20526,20526,17377,14429,13686
21528,2528,5030,13958,7570,9.91605e+12,59.9259,6718.25,21528,2441,72,16498,16498,12813,9320,8411
91102,24785,37345,56222,34880,7.61859e+12,57.3144,41781.9,91102,18188,72,53757,53757,45682,34556,32107
99189,16945,40782,61190,37999,7.60695e+12,57.3019,45541.2,99189,19864,72,58407,58407,41977,22650,22046
76206,8557,23706,48366,27840,8.89539e+12,58.8747,28055.4,76206,11542,72,52500,52500,38473,41494,28482
97875,20774,22750,63477,34398,9.91041e+12,60.1389,28658.6,97875,11076,72,75125,75125,72218,69483,68796
78697,9506,29963,48970,29727,7.99703e+12,57.7737,34047.2,78697,14592,72,48734,48734,34524,17835,17331
69191,12654,17448,44630,24561,9.64967e+12,59.7956,21745.5,69191,8484,72,51743,51743,47142,45992,39479
57589,2686,21116,35981,21608,8.18258e+12,57.9715,24320.8,57589,10281,72,36473,36473,16797,9961,6488
48593,11260,20195,29941,18652,7.57075e+12,57.1811,22801.1,48593,9837,72,28398,28398,22405,15411,15285
99647,28320,32984,62879,36768,8.64865e+12,58.578,38310.8,99647,16068,72,66663,66663,63412,59598,59670
6947,1191,1639,4515,2432,1.00508e+13,59.4615,2345.62,6947,798,72,5308,5308,4657,3987,4034
85847,1631,46909,67316,18531,79892300000,8.99684,47483.2,85847,42214,11,38938,38938,10183,12221,8164
72426,9803,21247,46193,26233,9.1245e+12,59.1528,25504.5,72426,10345,72,51179,51179,39475,28320,25210
8678,2150,2475,5565,3113,9.29038e+12,58.5021,3272.01,8678,1185,72,6203,6203,5876,5538,5526
43845,3340,10176,28441,15404,9.94121e+12,60.0949,13173.9,43845,4957,72,33669,33669,21103,13257,11621
1694,649,686,1055,639,8.04351e+12,45.8005,900.804,1694,312,52,1008,1008,1008,1008,1008
88748,1326,34607,55090,33658,7.87818e+12,57.6305,39071.3,88748,16852,72,54141,54141,31347,15299,3544
33958,9145,22617,19437,14521,4.32207e+12,53.0045,23877.6,33958,10997,72,11341,11341,8220,5299,4689
55524,13056,18433,35043,20481,8.63006e+12,58.2369,21685,55524,8959,72,37091,37091,33634,28970,27918
43076,7528,10079,27937,15139,9.89162e+12,60.0417,13031.6,43076,4899,72,32997,32997,29354,29274,25024
60886,11955,27240,37183,23703,7.13351e+12,56.0992,30240.9,60886,13248,72,33646,33646,27101,18541,16513
57833,9285,18212,36668,21165,8.86448e+12,58.8031,21643.4,57833,8872,72,39621,39621,32672,23228,21021
62409,17676,27025,38266,24143,7.33219e+12,56.9305,30149,62409,13165,72,35384,35384,31508,26162,25112
39236,4908,17732,23924,15312,7.0903e+12,56.4362,19817.1,39236,8625,72,21504,21504,15455,8475,8284
28111,6547,6581,18221,9890,9.9362e+12,59.9982,8663.35,28111,3205,72,21530,21530,21491,21498,21502
4392,620,1764,2727,1665,7.75839e+12,56.1967,2188.75,4392,843,70,2628,2580,2212,1745,1934
51081,8916,14694,32634,18447,9.20282e+12,59.2114,17893.6,51081,7152,72,36387,36387,30977,23523,21961
86101,67983,86101,0,86101,7.99991,0,86101,86101,86101,1,0,0,0,0,0
66670,32851,33371,40082,26588,6.45289e+12,55.8506,36343.7,66670,16253,72,33299,33299,32680,31914,31810
98883,12300,30769,62752,36131,8.89929e+12,58.894,36197.3,98883,14988,72,68114,68114,47136,22289,21443
77462,3416,20179,49852,27610,9.54282e+12,59.6719,24863.8,77462,9814,72,57283,57283,24020,14496,8591
15873,4101,7893,9554,6319,6.54527e+12,55.6658,8856.48,15873,3839,72,7980,7980,6469,4790,4808
37860,14271,15687,23350,14510,7.57298e+12,57.1712,17823.7,37860,7636,72,22173,22173,21462,20463,20461
57569,15540,19377,36269,21300,8.57977e+12,58.4641,22707.7,57569,9439,72,38192,38192,33568,27302,25879
16472,1389,6350,10249,6223,7.99622e+12,57.4515,7501.73,16472,3089,72,10122,10122,6391,2886,2337
98683,16523,40843,60839,37844,7.57116e+12,57.2629,45565,98683,19894,72,57840,57840,41787,26551,22264
73203,1672,20219,46911,26292,9.35325e+12,59.4274,24600.7,73203,9844,72,52984,52984,21504,19747,4985
31602,5261,9145,20187,11415,9.17604e+12,59.0939,11302.5,31602,4440,72,22457,22457,19195,18411,13815
46584,10691,10862,30209,16375,9.90834e+12,60.0729,14013.8,46584,5286,72,35722,35722,35519,35476,35338
98136,5164,22755,63650,34486,9.9102e+12,60.1375,28681.3,98136,11071,72,75381,75381,49712,34036,18048
31093,8893,15301,18742,12351,6.57341e+12,55.2084,16934.5,31093,7440,72,15792,15792,13268,10331,10440
4000,2035,2069,3128,872,79153100000,8.93475,2191.21,4000,1856,11,1931,1931,1909,1910,1916
19808,5494,8447,12177,7631,7.39555e+12,56.8024,9708.15,19808,4100,72,11361,11361,9735,7461,7155
90161,12370,20984,58469,31692,9.90977e+12,60.1335,26486.3,90161,10220,72,69177,69177,56698,44674,41476
81139,18440,36202,49558,31581,7.15803e+12,56.3001,40017.2,81139,17620,72,44937,44937,38370,29319,27365
86962,24872,25494,55460,31502,9.12856e+12,59.1595,30465.4,86962,12411,72,61468,61468,60700,60669,59931
7470,1086,1823,4842,2628,9.80488e+12,59.3534,2567.1,7470,882,72,5647,5647,4681,3639,3677
60003,17881,18825,38043,21960,8.87045e+12,58.8272,22371.1,60003,9171,72,41178,41178,40783,40217,40328
17555,5028,5142,11196,6359,9.16847e+12,58.974,6492.97,17555,2502,72,12413,12413,12271,12266,12224
9783,1182,3579,6121,3662,8.35542e+12,57.5619,4370.23,9783,1743,72,6204,6204,3340,1446,1027
28798,578,7296,18571,10227,9.64067e+12,59.6634,9381.09,28798,3539,72,21502,21502,8217,7822,2236
2758,493,685,1792,966,9.88166e+12,58.2451,1044.25,2758,326,60,2073,2073,1850,1646,1639
65924,19757,27714,40564,25360,7.48821e+12,57.1249,31043.8,65924,13496,72,38210,38210,33207,27425,27267
45629,3678,10641,29579,16050,9.91039e+12,60.082,13739.1,45629,5181,72,34988,34988,22576,21971,12551
65458,3587,15179,42457,23001,9.91372e+12,60.1156,19374.2,65458,7378,72,50279,50279,26016,26103,12691
39203,7368,14863,24416,14787,8.0374e+12,57.0742,17164.3,39203,7224,72,24340,24340,20221,14536,13398
2069,1270,2069,1061,1008,208806000,0,2069,2069,1008,21,0,0,0,0,0
27887,3088,6538,18077,9810,9.89434e+12,59.8937,8612.38,27887,3168,72,21349,21349,17073,16184,10389
25202,1097,13750,14959,10243,5.8799e+12,53.7007,15021.1,25202,6676,72,11452,11404,6690,1786,1160
70035,20226,24167,44026,26009,8.46317e+12,58.3287,28046.1,70035,11769,72,45868,45868,42962,39645,39580
38604,2064,14526,24063,14541,8.0739e+12,57.7734,16806.4,38604,7070,72,24078,24078,10533,3991,1267
40939,264,13873,25780,15159,8.57009e+12,58.3845,16378.3,40939,6758,72,27066,26730,15437,9985,1303
45116,12846,20932,27407,17709,6.94312e+12,56.419,23220.7,45116,10197,72,24184,24184,21182,17036,16283
75254,12086,17465,48809,26445,9.92446e+12,60.1278,22180.6,75254,8504,72,57789,57789,51271,42408,40355
13366,702,6787,8020,5346,6.37202e+12,55.3881,7620.75,13366,3291,72,6579,6435,3153,1080,550
93023,22351,36333,57720,35303,7.87312e+12,57.2404,40976.9,93023,17694,72,56690,56690,46448,32451,29150
8863,1147,2071,5750,3113,9.99242e+12,59.659,2924.3,8863,1005,72,6792,6792,5432,5407,3934
67203,1172,24219,42062,25141,8.26228e+12,57.466,27898.5,67203,11776,72,42984,42984,16421,6305,1248
54169,3348,12652,35121,19048,9.90439e+12,60.0835,16222.8,54169,6158,72,41517,41517,28051,19363,11543
67193,4292,23505,42174,25019,8.40706e+12,58.2609,27228.9,67193,11451,72,43688,43688,25513,14677,10702
21803,10519,11063,13081,8722,6.40554e+12,54.3605,12271,21803,5383,72,10740,10740,10612,10422,10557
76784,9884,23893,48728,28056,8.89501e+12,58.8771,28271.6,76784,11633,72,52891,52891,45342,35322,32944
23095,454,11083,13973,9122,6.73597e+12,56.0098,12400.1,23095,5386,72,12012,11580,4229,569,513
33255,4443,18316,19707,13548,5.80494e+12,54.9505,19876.1,33255,8910,72,14939,14939,9235,5440,4350
25411,5083,8606,16014,9397,8.55724e+12,58.2897,10316.9,25411,4181,72,16805,16805,14233,13582,10012
70146,14046,27327,43545,26601,7.88735e+12,57.5006,30989.3,70146,13309,72,42819,42819,35080,24415,22078
50178,6243,11677,32539,17639,9.91151e+12,60.1016,15033.6,50178,5683,72,38501,38501,30566,22954,20910
36575,4292,20198,21667,14908,5.79008e+12,54.4063,21875.9,36575,9819,72,16377,16377,9758,5205,3875
33154,591,13702,20453,12701,7.60304e+12,57.1682,15623.4,33154,6671,72,19452,19404,11697,5560,2267
12408,2537,3108,8018,4390,9.73464e+12,59.4809,4186.91,12408,1510,72,9300,9300,8475,7723,7648
57796,6715,28310,45115,12681,78534400000,8.99602,28813.7,57796,25474,11,29486,29486,12349,14462,10254
52800,15791,19817,32908,19892,8.06468e+12,57.8166,22769.2,52800,9637,72,32983,32983,30656,27524,26852
98543,25827,37116,61397,37146,8.04578e+12,57.8376,42085.2,98543,18070,72,61427,61427,54953,46007,44085
94801,10815,30002,60073,34728,8.82149e+12,58.5026,35206.9,94801,14595,72,64799,64799,47353,46896,26322
77667,17043,18076,50361,27306,9.91217e+12,60.1216,22917.9,77667,8800,72,59591,59591,58324,58036,56369
73586,9526,17145,47714,25872,9.90639e+12,60.1144,21770,73586,8346,72,56441,56441,45348,45124,31785
95864,66310,75915,64525,31339,8.99265e+12,15.7646,77608.7,95864,22470,72,19949,19949,19273,19273,19280
87649,39084,39308,53485,34164,7.1284e+12,56.7095,43364.2,87649,19146,72,48341,48341,48074,47799,47809
45316,7436,16179,28400,16916,8.30644e+12,58.0959,18844,45316,7876,72,29137,29137,22243,15783,14001
14955,3844,5630,9325,5630,8.08621e+12,57.6186,6716.63,14955,2738,72,9325,9325,8147,6618,6321
2287,995,1133,1785,502,78566700000,8.86751,1225.79,2287,1013,11,1154,1154,1051,1062,1053
31174,10539,16479,24410,6764,79455300000,8.97052,16830.4,31174,14824,11,14695,14695,10665,11019,10329
11615,658,6003,6957,4658,6.30535e+12,48.2386,6742.54,11615,2908,72,5612,5516,3192,1850,1560
43020,3623,10050,27898,15122,9.89785e+12,60.0622,13000.8,43020,4889,72,32970,32970,21858,21192,12287
78703,30787,37831,47586,31117,6.70876e+12,55.8462,41359,78703,18408,72,40872,40872,35341,28807,28760
6229,1312,1474,4043,2186,1.01149e+13,59.3224,2123.07,6229,717,72,4755,4755,4525,4520,4405
66822,9826,20112,42521,24301,9.03573e+12,59.0315,24050.5,66822,9798,72,46710,46710,35226,24197,21284
66858,15373,22127,42190,24668,8.6362e+12,58.1913,25929.5,66858,10765,72,44731,44731,39094,31415,29631
2488,136,642,1616,872,9.58887e+12,57.3963,970.871,2488,296,58,1846,1846,784,471,453
40231,12190,16914,24757,15474,7.50749e+12,57.0915,19134.4,40231,8239,72,23317,23317,20949,17672,17127
68894,10114,18006,44328,24566,9.54281e+12,59.6512,22239.7,68894,8763,72,50888,50888,42746,31626,29008
27247,5105,8607,17281,9966,8.8403e+12,58.6407,10465.1,27247,4180,72,18640,18640,15480,12454,11826
72112,16445,16748,46771,25341,9.91992e+12,60.1238,21296.3,72112,8153,72,55364,55364,54951,54620,54620
86329,23673,37907,52839,33490,7.24077e+12,56.8497,41970.5,86329,18461,72,48422,48422,40176,28948,26304
89706,25748,38697,55015,34691,7.34782e+12,56.6461,42943.4,89706,18846,72,51009,51009,44687,35979,34113
35154,7497,8202,22807,12347,9.91205e+12,60.0401,10702.5,35154,3991,72,26952,26952,26104,25912,24848
87972,11406,20425,57054,30918,9.91277e+12,60.1418,25819.8,87972,9942,72,67547,67547,56752,54221,38515
72731,12708,19264,46754,25977,9.49981e+12,59.6129,23678.8,72731,9384,72,53467,53467,46942,45369,35998
58989,13787,15054,38024,20965,9.61497e+12,59.7439,18800,58989,7322,72,43935,43935,42401,40382,39978
83025,12817,40704,50058,32967,6.58523e+12,56.0294,44331,83025,19821,72,42321,42321,28328,11944,11465
90872,1885,21087,58931,31941,9.91505e+12,60.1366,26630.8,90872,10264,72,69785,69785,23852,25788,7343
76988,20566,40719,45890,31098,6.084e+12,55.0223,43912.8,76988,19822,72,36269,36269,27979,20178,18160
18481,4748,4850,11898,6583,9.55391e+12,59.4487,6301.58,18481,2357,72,13631,13631,13513,13465,13480
48547,7118,25363,28998,19549,6.17481e+12,54.7658,27580.1,48547,12347,72,23184,23184,14991,5442,5222
4629,476,1119,3005,1624,9.99528e+12,58.8838,1638.72,4629,541,71,3510,3510,2543,1753,1593
16531,1695,4409,10636,5895,9.47927e+12,59.3238,5735.2,16531,2141,72,12122,12122,7948,8117,4438
69618,16464,22218,44086,25532,8.78728e+12,58.7305,26208.6,69618,10809,72,47400,47400,47167,46808,46942
32014,5016,8933,20507,11507,9.31055e+12,59.289,11140.6,32014,4341,72,23081,23081,18730,14580,13538
81000,16758,18769,52540,28460,9.92482e+12,60.145,23795.1,81000,9141,72,62231,62231,59780,59217,55784
7124,1722,1749,4617,2507,9.88168e+12,59.2551,2462.81,7124,847,72,5375,5375,5346,5345,5353
46143,5448,19953,28299,17844,7.33324e+12,56.9005,22394.2,46143,9715,72,26190,26190,18202,8850,8681
75717,9171,23058,48135,27582,8.97545e+12,58.9723,27420.2,75717,11219,72,52659,52659,40059,28012,24794
39858,1929,10737,25591,14267,9.44374e+12,59.4957,13403.3,39858,5225,72,29121,29121,18228,17975,4926
25673,1757,6038,16649,9024,9.88517e+12,59.9458,7975.74,25673,2936,72,19635,19635,11324,11112,5848
58394,14154,17773,37130,21264,8.99571e+12,58.961,21275,58394,8655,72,40621,40621,37180,32547,31520
26514,180,1619,21100,5414,5.74158e+13,11.9921,2145.49,26514,1091,14,24895,24895,15305,8607,20573
64849,972,21101,40985,23864,8.71967e+12,58.6476,24832.7,64849,10277,72,43748,43508,25304,12808,2752
99751,24874,32706,62998,36753,8.67964e+12,58.4789,38064.9,99751,15921,72,67045,67045,59472,50586,50314
38688,9221,15978,23853,14835,7.60144e+12,57.2055,18153,38688,7784,72,22710,22710,16786,8620,6891
95831,17684,35260,59853,35978,8.15796e+12,57.9853,40173.5,95831,17164,72,60571,60571,48244,31263,27389
99512,11309,48746,77681,21831,7.853e+10,8.99735,49409.7,99512,43863,11,50766,50766,21053,24718,17402
54550,2107,14223,35106,19444,9.55423e+12,59.6437,17705.5,54550,6923,72,40327,40327,24869,16222,5930
81176,12343,18885,52643,28533,9.90345e+12,60.1226,23917.1,81176,9187,72,62291,62291,54466,52629,41278
71604,2576,19605,45908,25696,9.38763e+12,59.4683,23915.8,71604,9551,72,51999,51999,32744,32267,9128
32706,7060,13670,20134,12572,7.54228e+12,55.7535,15559.5,32706,6654,72,19036,19036,15280,10971,10879
52089,7450,24682,31559,20530,6.80124e+12,55.9326,27220.3,52089,12007,72,27407,27407,20477,12421,12305
23557,2590,7265,14964,8593,8.96534e+12,58.776,8935.16,23557,3532,72,16292,16292,9781,6844,5621
73846,12096,42381,43437,30409,5.50865e+12,54.6995,45217.6,73846,20642,72,31465,31465,22889,13079,12795
91632,11057,28338,58178,33454,8.92201e+12,58.9153,33435.8,91632,13799,72,63294,63294,49832,33953,33340
74515,30939,39617,58362,16153,79534300000,8.98755,40162.8,74515,35647,11,34898,34898,29699,29987,29429
22183,2692,8829,13753,8430,7.79329e+12,56.6369,10258.1,22183,4282,72,13354,13354,9277,4557,4471
1406,67,384,918,488,9.6938e+12,55.7525,597.977,1406,181,49,1022,626,340,235,155
61023,24961,26944,37312,23711,7.21966e+12,56.0905,29974.7,61023,13120,72,34079,34079,33042,31708,31471
28815,2546,6751,18691,10124,9.91041e+12,60.0014,8876.87,28815,3287,72,22064,22064,14929,14465,8530
9759,1155,2336,6323,3436,9.94724e+12,59.5859,3244.89,9759,1138,72,7423,7423,5789,4298,3965
57513,3015,13360,37301,20212,9.92084e+12,60.1043,17117.7,57513,6502,72,44153,44153,22127,11657,10411
16782,997,4044,10867,5915,9.84455e+12,59.7336,5419.17,16782,1966,72,12738,12738,8523,3617,3482
84903,33423,37841,51861,33042,7.16171e+12,56.7296,41808.9,84903,18418,72,47062,47062,45679,43756,43530
44623,10346,10422,28929,15694,9.89856e+12,60.0497,13462.1,44623,5071,72,34201,34201,34123,34120,34116
82410,19940,23737,52633,29777,9.19705e+12,59.2415,28514.6,82410,11554,72,58673,58673,55569,51389,50448
30825,4443,11352,19254,11571,8.17758e+12,57.8942,13277.8,30825,5529,72,19473,19473,14398,8432,8409
63328,26532,29231,38499,24829,6.96579e+12,55.7273,32263.7,63328,14234,72,34097,34097,31473,28489,28438
58097,15237,18694,36757,21340,8.76566e+12,58.4978,22114.2,58097,9100,72,39403,39403,36884,36250,32776
82561,15492,19644,53458,29103,9.84724e+12,60.0408,24714,82561,9569,72,62917,62917,58263,51959,50503
32277,5658,9124,20645,11632,9.28712e+12,56.0731,11336.5,32277,4439,72,23153,23153,18988,18020,12095
51949,7799,26240,31187,20762,6.39347e+12,55.7651,28649.3,51949,12770,72,25709,25709,17203,9820,7680
23765,552,11187,14413,9352,6.88e+12,56.2159,12550.2,23765,5449,72,12578,12102,5259,1771,500
53028,8225,18435,33302,19726,8.43661e+12,58.2849,21503.8,53028,8981,72,34593,34593,23556,13331,10594
42465,477,2729,33824,8641,5.72151e+13,11.9951,3397.25,42465,1737,14,39736,39736,25257,15520,33203
17338,529,4079,11246,6092,9.92169e+12,59.8389,5498.27,17338,1978,72,13259,13259,8133,5422,1949
95416,17486,24558,61451,33965,9.59744e+12,59.7479,30171.4,95416,11964,72,70858,70858,64179,62588,52968
26687,4337,8308,16934,9753,8.91374e+12,58.7587,10145.3,26687,4042,72,18379,18379,14564,10142,10066
27994,3710,12877,17032,10962,6.99684e+12,56.4189,14454,27994,6270,72,15117,15117,9926,5883,4686
1067,276,306,693,374,9.58184e+12,54.522,480.752,1067,136,44,761,761,757,753,759
81732,20906,26235,51725,30007,8.7732e+12,58.7212,30792.1,81732,12770,72,55497,55497,50214,50058,43871
82189,13890,23743,52481,29708,9.19063e+12,59.2327,28504.4,82189,11563,72,58446,58446,48915,46636,32855
64031,5024,17187,41111,22920,9.45177e+12,59.5424,21137.7,64031,8369,72,46844,46844,32422,32076,14756
86776,5044,25175,55388,31388,9.16614e+12,59.2248,30161.1,86776,12257,72,61601,61601,32992,30855,13213
98055,5807,22780,63592,34463,9.91818e+12,60.15,28697,98055,11097,72,75275,75275,50498,34725,19974
78308,15560,18591,50713,27595,9.84562e+12,60.0388,23441.6,78308,9053,72,59717,59717,56441,55653,51048
70825,8648,16461,45930,24895,9.9079e+12,60.1177,20943.2,70825,8006,72,54364,54364,43009,42777,29109
53942,1000,12541,34984,18958,9.9145e+12,60.0994,16104.6,53942,6104,72,41401,41401,24592,24252,3949
67917,13549,32955,41020,26897,6.64577e+12,56.1028,36052.6,67917,16049,72,34962,34962,26652,16928,16740
81738,40661,42571,48845,32893,6.18883e+12,55.4868,45975.4,81738,20717,72,39167,39167,38135,37005,37065
91344,19569,31797,57376,33968,8.41874e+12,58.175,36637.9,91344,15470,72,59547,59547,50569,40077,39714
7023,1278,2258,4462,2561,8.85204e+12,53.334,2912.53,7023,1080,72,4765,4765,4524,4263,4281
9158,4399,5577,5330,3828,5.14526e+12,49.6069,6107.47,9158,2711,72,3581,3581,3130,2490,2585
79274,12616,18441,51409,27865,9.91528e+12,60.1238,23368,79274,8980,72,60833,60833,52403,52225,42157
5908,1017,1422,3837,2071,9.80367e+12,59.0774,2048.77,5908,678,72,4486,4486,4019,3912,3410
70338,20944,25429,44016,26322,8.25712e+12,58.0763,29239.8,70338,12388,72,44909,44909,41992,38090,37229
75940,12792,26890,47615,28325,8.34337e+12,58.1941,30997.6,75940,13094,72,49050,49050,38209,25451,25130
88593,18092,20565,57460,31133,9.92008e+12,60.1421,25988.1,88593,10015,72,68028,68028,65101,64412,60301
19727,1223,5274,12675,7052,9.49712e+12,57.3129,6795.85,19727,2563,72,14453,14453,5965,5976,1445
38738,2062,12555,24495,14243,8.74942e+12,58.6187,14996.9,38738,6116,72,26183,26183,13734,6272,4703
73512,5602,23585,46515,26997,8.77912e+12,58.7315,27752.7,73512,11489,72,49927,49879,29969,21301,17371
31182,5846,16039,18671,12511,6.28168e+12,55.5254,17619,31182,7800,72,15143,15143,11609,7836,7050
98929,17324,34583,62100,36829,8.40166e+12,56.0045,39756.7,98929,16841,72,64346,64346,53032,37456,33925
22285,4677,5214,14457,7828,9.89786e+12,59.8868,6946.01,22285,2528,72,17071,17071,16446,15661,15561
74705,5305,17332,48450,26255,9.91759e+12,60.1419,22025.4,74705,8438,72,57373,57373,39847,39496,18305
85229,3390,43472,51096,34133,6.33491e+12,55.6507,47058.5,85229,21161,72,41757,41757,24400,14448,3515
80587,14499,18730,52258,28329,9.91235e+12,60.1407,23733.5,80587,9122,72,61857,61857,55704,49839,48264
24628,7279,8386,15515,9113,8.54092e+12,58.2644,10051.3,24628,4082,72,16242,16242,14778,13082,13242
72170,30379,32098,44094,28076,7.17446e+12,56.246,35567.2,72170,15631,72,40072,40072,39261,38243,38084
21512,1286,5097,13943,7569,9.88376e+12,59.8793,6776.07,21512,2479,72,16415,16415,8664,8597,4229
25335,5213,11541,15439,9896,7.05888e+12,55.3086,13007.9,25335,5606,72,13794,13794,10792,7471,6688
34912,3109,8145,22643,12269,9.91973e+12,60.0249,10629.2,34912,3963,72,26767,26767,19404,13734,10479
14222,90,3896,9118,5104,9.44068e+12,59.214,5066.67,14222,1894,72,10326,9133,3002,1561,474
88901,1507,35397,55050,33851,7.77205e+12,57.4289,39815.6,88901,17229,72,53504,53504,31879,21063,5546
16666,3246,3927,10808,5858,9.91307e+12,59.8037,5302.23,16666,1903,72,12739,12739,11933,11747,10732
97615,25949,63238,76536,21079,2.23432e+13,5.53025,72435,97615,21083,13,34377,34377,28221,30542,16725
31367,3040,10063,19851,11516,8.79639e+12,58.6485,12132.4,31367,4899,72,21304,21304,14861,9105,7487
40317,161,9386,26151,14166,9.91366e+12,60.0532,12183.3,40317,4561,72,30931,30893,17483,17216,992
53254,16024,18010,33544,19710,8.57114e+12,58.4225,21121.8,53254,8773,72,35244,35244,33747,32057,32111
99301,24338,47724,60044,39257,6.70653e+12,56.2009,52010.5,99301,23242,72,51577,51577,43092,31402,28811
11939,1322,2776,7746,4193,9.98582e+12,59.7898,3845.25,11939,1346,72,9163,9163,7012,6974,4533
36893,9756,14613,22860,14033,7.81738e+12,57.4592,16752.3,36893,7118,72,22280,22280,16407,15043,6586
48188,1071,11240,31255,16933,9.89676e+12,60.0704,14482.2,48188,5467,72,36948,36948,22077,21788,3811
18728,1593,4384,12146,6582,9.913e+12,59.932,5898.71,18728,2130,72,14344,14344,10338,10251,5557
33254,830,7759,21557,11697,9.9192e+12,60.0436,10149.4,33254,3775,72,25495,25495,8994,9633,2905
54064,15916,17183,34252,19812,8.82094e+12,58.2147,20418,54064,8354,72,36881,36881,36073,35071,34904
16997,1607,3994,11024,5973,9.92037e+12,59.8563,5393.67,16997,1940,72,13003,13003,9166,6186,5305
26786,6105,8042,17057,9729,9.04011e+12,58.8876,9909.79,26786,3903,72,18744,18744,16654,14238,14269
94960,9991,43699,57758,37202,6.97125e+12,56.4939,47960.2,94960,21284,72,51261,51261,34489,15038,14270
51107,10282,15436,32509,18598,9.0313e+12,59.001,18582.1,51107,7519,72,35671,35671,30919,29771,23002
76371,2576,36313,46247,30124,6.77979e+12,56.2723,39778.8,76371,17689,72,40058,40058,19928,5384,3758
41380,9293,9614,26837,14543,9.91961e+12,60.0802,12476,41380,4676,72,31766,31766,31325,31315,30958
20272,2689,6461,12847,7425,8.82194e+12,58.5634,7928.39,20272,3142,72,13811,13811,10177,10063,5884
39122,4447,11302,24983,14139,9.18617e+12,59.169,13870.9,39122,5493,72,27820,27820,20487,14881,11667
26785,3335,7523,17152,9633,9.32079e+12,59.234,9428.59,26785,3663,72,19262,19262,14541,9059,8902
53079,17617,23295,32488,20591,7.25197e+12,56.5876,26011.8,53079,11326,72,29784,29784,26154,21986,21881
77591,2058,3895,61557,16034,5.80723e+13,12.0017,4816.48,77591,2335,20,73696,73696,59207,47083,62741
6094,1164,2204,3825,2269,8.38425e+12,57.2562,2766.13,6094,1066,72,3890,3890,2388,2354,738
50113,12920,25873,29988,20125,6.25376e+12,55.5586,28171.2,50113,12594,72,24240,24240,19449,12840,11478
48745,34589,48745,0,48745,7.99984,0,48745,48745,48745,1,0,0,0,0,0
47802,1375,11142,30997,16805,9.91714e+12,60.0633,14359.7,47802,5420,72,36660,36660,22509,14970,5143
35520,12600,13352,22149,13371,8.06787e+12,57.7658,15488.6,35520,6496,72,22168,22168,21841,21370,21491
11001,600,4558,6782,4219,7.58699e+12,55.2954,5379.07,11001,2206,72,6443,6347,3896,971,938
49179,979,15448,31185,17994,8.86599e+12,58.8077,18454.5,49179,7525,72,33731,33731,14942,11707,2638
52001,27389,27757,30960,21041,6.03484e+12,55.1897,30048.2,52001,13518,72,24244,24244,23966,23708,23853
84132,33674,44216,50196,33936,6.13413e+12,55.246,47672.9,84132,21534,72,39916,39916,35515,29450,28225
57530,18383,28410,34655,22875,6.54294e+12,55.5042,31074.7,57530,13834,72,29120,29120,25148,19668,18585
22317,3989,6068,14328,7989,9.38782e+12,59.2766,7735.28,22317,2942,72,16249,16249,14065,14009,11534
21242,9066,10409,16581,4661,78529700000,8.98851,10710.9,21242,9363,11,10833,10833,9767,9898,9650
73003,11608,17002,47327,25676,9.91159e+12,60.1229,21595.5,73003,8278,72,56001,56001,49561,48045,38760
39789,8566,9262,25805,13984,9.90976e+12,60.0547,12029.7,39789,4507,72,30527,30527,29518,28602,28457
33331,12310,12624,20754,12577,8.02713e+12,57.7098,14646.9,33331,6141,72,20707,20707,20579,20421,20570
29171,2129,14934,17490,11681,6.3061e+12,55.0679,16438.5,29171,7253,72,14237,14237,9377,5873,3685
50117,1661,16164,31706,18411,8.75118e+12,58.6548,19185.1,50117,7869,72,33953,33953,14517,7484,3981
54848,995,13227,35493,19355,9.81272e+12,59.9703,16803.6,54848,6443,72,41621,41621,13342,8500,3933
14037,763,4398,8902,5135,8.91828e+12,58.5924,5509.86,14037,2141,72,9639,9591,5381,3477,2709
64174,1755,29506,39040,25134,6.98022e+12,56.3336,32583.7,64174,14352,72,34668,34668,14156,8420,4823
92326,7456,35539,57375,34951,7.94637e+12,57.488,40187.6,92326,17308,72,56787,56787,38642,17342,16651
20109,3729,5575,12891,7218,9.38009e+12,59.2527,7099.41,20109,2715,72,14534,14534,12365,9483,8856
89850,1956,23306,57842,32008,9.55406e+12,59.6929,28629.1,89850,11339,72,66544,66544,27160,24892,7212
50128,16185,46844,34510,15618,9.21291e+12,3.99625,46954.7,50128,15632,9,3284,3284,1132,3284,1139
68245,11890,22556,43084,25161,8.64776e+12,58.5567,26424.9,68245,10981,72,45689,45689,37674,26719,24181
91200,23810,27396,58044,33156,9.03278e+12,59.0551,32529.1,91200,13341,72,63804,63804,60797,60085,55859
39940,8631,9288,25909,14031,9.9218e+12,60.0761,12065,39940,4523,72,30652,30652,29692,29676,28686
67028,10192,18153,43013,24015,9.41467e+12,59.5042,22246.6,67028,8838,72,48875,48875,40631,29389,26735
4297,866,1040,2792,1505,9.90972e+12,58.8515,1535.4,4297,500,69,3257,3257,3050,3006,2867
3632,170,890,2362,1270,9.84902e+12,58.6038,1328.9,3632,425,65,2742,2742,1148,1186,589
10131,720,2633,6534,3597,9.58323e+12,57.6688,3553.15,10131,1260,72,7498,7498,5181,3618,2504
74918,16820,17390,48591,26327,9.91974e+12,60.1264,22088.5,74918,8467,72,57528,57528,56692,55967,55852
30147,4926,7059,19555,10592,9.90581e+12,59.9909,9264.46,30147,3434,72,23088,23088,19929,16956,16197
38909,2456,16491,23926,14983,7.46345e+12,57.0174,18643,38909,8030,72,22418,22418,13585,5910,3816
33671,4377,10697,21335,12336,8.81869e+12,58.661,12895,33671,5197,72,22974,22974,16501,11268,9705
5707,257,1370,3709,1998,9.84979e+12,59.1248,1982.2,5707,657,72,4337,4337,1869,1232,885
22370,3757,5799,14409,7961,9.60601e+12,59.5092,7489.38,22370,2821,72,16571,16571,13944,11498,10891
6939,400,2092,4423,2516,9.08226e+12,58.4113,2757.35,6939,1009,72,4847,4799,2809,441,528
44175,2116,18771,27146,17029,7.44129e+12,57.0224,21154.6,44175,9139,72,25404,25404,15709,4733,4095
93045,16048,21579,60341,32704,9.92139e+12,60.1473,27237.4,93045,10506,72,71466,71466,64761,63205,53523
62014,13255,14388,40221,21793,9.9149e+12,60.1165,18396.6,62014,6996,72,47626,47626,45977,45947,44114
27773,3402,7961,17745,10028,9.22967e+12,59.1506,9912.61,27773,3873,72,19812,19812,14730,8801,8640
78191,26077,29783,48660,29531,7.99435e+12,57.7721,33845.9,78191,14503,72,48408,48408,46784,44651,44220
6734,189,3431,4054,2680,6.4702e+12,55.0549,3929.4,6734,1670,72,3303,3159,2018,1088,653
74659,5279,17317,48420,26239,9.92373e+12,60.1391,22004.3,74659,8436,72,57342,57342,34172,20779,18213
69621,15303,20748,44336,25285,9.06797e+12,59.081,24841.6,69621,10102,72,48873,48873,43563,43422,37203
94579,5133,5244,75145,19434,5.77502e+13,12.0015,6259.04,94579,3171,20,89335,89335,88514,87892,88946
68104,1284,23544,42804,25300,8.45719e+12,58.317,27329.3,68104,11466,72,44560,44560,26595,13137,4653
71458,5031,16593,46343,25115,9.91541e+12,60.1347,21111.6,71458,8077,72,54865,54865,32595,32118,17352
16224,1253,3830,10528,5696,9.86867e+12,59.7311,5180.34,16224,1856,72,12394,12394,7546,7364,4051
90069,29333,35205,55884,34185,7.86667e+12,57.6156,39719.2,90069,17140,72,54864,54864,50911,46331,46242
49044,9706,14636,31236,17808,9.0641e+12,58.3359,17694.5,49044,7108,72,34408,34408,30380,25710,25587
35203,1100,8210,22832,12371,9.91837e+12,60.0316,10712.9,35203,3992,72,26993,26993,16571,10958,3821
23676,6045,7983,14920,8756,8.60823e+12,58.3162,9600.2,23676,3889,72,15693,15693,14156,12418,12464
17322,3715,4920,11082,6240,9.24325e+12,59.0176,6270.43,17322,2382,72,12402,12402,10883,9069,9229
72208,10033,16836,46818,25390,9.90676e+12,60.1052,21384,72208,8193,72,55372,55372,47225,45317,33485
67892,8317,27554,41948,25944,7.67669e+12,57.216,31040.3,67892,13408,72,40338,40338,27500,12387,11965
69954,13559,16261,45371,24583,9.91557e+12,60.1195,20693.7,69954,7917,72,53693,53693,49692,45903,44919
23408,4346,12412,13948,9460,6.11182e+12,54.4485,13641.8,23408,6040,72,10996,10996,7547,4421,3607
7046,1461,1665,4570,2476,1.00107e+13,59.4576,2377.02,7046,810,72,5381,5381,5089,4882,4905
57294,11694,16311,36630,20664,9.24525e+12,59.1508,19843.7,57294,7929,72,40983,40983,36711,30931,29605
31753,3707,7410,20589,11164,9.92312e+12,60.034,9712.15,31753,3609,72,24343,24343,19889,18856,12494
16903,3627,3980,10969,5934,9.90852e+12,59.8489,5373.33,16903,1934,72,12923,12923,12498,12404,11980
88849,18114,26317,56618,32231,9.08651e+12,59.1235,31367,88849,12811,72,62532,62532,53895,42116,39345
43391,7087,13283,27585,15806,8.96287e+12,58.8935,16020.8,43391,6458,72,30108,30108,23763,16251,16162
53494,8434,12507,34682,18812,9.90206e+12,60.0738,16037,53494,6089,72,40987,40987,36078,29429,27894
21543,1444,8392,13377,8166,7.90613e+12,57.1623,9807.44,21543,4072,72,13151,13151,5798,2663,1429
90894,13247,22030,58787,32107,9.78146e+12,59.9764,27511.5,90894,10727,72,68864,68864,56499,56221,41384
12002,969,5173,7367,4635,7.37969e+12,53.2122,6031.23,12002,2506,72,6829,6781,3908,554,503
94813,17010,27706,60487,34326,9.14358e+12,59.1888,33065.9,94813,13492,72,67107,67107,58431,46607,43810
9822,617,2289,6369,3453,9.99937e+12,59.7079,3208,9822,1115,72,7533,7533,5062,3507,2196
57523,8624,27859,34743,22780,6.6622e+12,55.8597,30566.2,57523,13559,72,29664,29664,20914,10729,10520
35668,2778,10879,22683,12985,8.97749e+12,54.9073,13218,35668,5277,72,24789,24789,17473,12049,8647
10102,2119,2873,6462,3640,9.27366e+12,58.8903,3768.46,10102,1389,72,7229,7229,6421,5278,5240
9960,1478,3613,6242,3718,8.20969e+12,57.499,4423.07,9960,1746,72,6347,6347,4762,2893,3050
60031,3809,17986,38216,21815,9.0507e+12,59.0523,21596.7,60031,8758,72,42045,42045,26761,8698,8109
80003,35435,80003,0,80003,7.9999,0,80003,80003,80003,1,0,0,0,0,0
66184,14860,23349,41515,24669,8.36373e+12,58.1998,27011.6,66184,11371,72,42835,42835,36733,35197,26506
13558,451,4060,8648,4910,9.08695e+12,58.7449,5158.7,13558,1972,72,9498,9450,4610,3998,1590
58948,15963,31986,46209,12739,79792100000,8.99578,32463,58948,28783,11,26962,26962,16951,17617,16304
82281,9468,23615,52568,29713,9.21144e+12,59.2617,28392.5,82281,11497,72,58666,58666,41463,21151,20362
29308,5966,9079,18603,10705,8.94937e+12,58.5637,11062.6,29308,4416,72,20229,20229,17707,14221,13627
56922,6504,13286,36905,20017,9.90415e+12,60.0805,17007.3,56922,6462,72,43636,43636,35522,33618,21835
69931,33936,34109,42191,27740,6.62472e+12,55.0404,37268.2,69931,16612,72,35822,35822,35573,35410,35431
82684,3562,35057,50828,31856,7.43635e+12,56.8708,39064.4,82684,17073,72,47627,47627,27641,7063,3315
89445,5552,20746,58005,31440,9.92085e+12,60.1532,26217.6,89445,10106,72,68699,68699,46564,32232,19307
55864,14337,19459,35089,20775,8.41495e+12,58.2591,22662.5,55864,9468,72,36405,36405,32209,27254,27276
61833,2221,2608,48945,12888,5.85649e+13,12.0023,3433.57,61833,2259,19,59225,59225,55954,53076,56347
19681,2927,4616,12771,6910,9.909e+12,59.8868,6186.77,19681,2241,72,15065,15065,13008,12542,9694
47183,17643,17756,29411,17772,8.05008e+12,57.6187,20444.1,47183,8640,72,29427,29427,29309,29228,29231
85499,2263,5517,68099,17400,5.72077e+13,12.0015,6477.18,85499,2696,20,79982,79982,59864,45630,70877
33220,9194,11337,20908,12312,8.54488e+12,58.3258,13445.6,33220,5523,72,21883,21883,20702,19170,18886
12296,3793,5403,7540,4756,7.27256e+12,56.4462,6263.99,12296,2621,72,6893,6893,6140,5200,5040
8229,4008,5010,4792,3437,5.17392e+12,47.4278,5501.63,8229,2435,72,3219,3219,3102,2998,3129
96492,32683,42932,58956,37536,7.16654e+12,56.7643,47357,96492,20909,72,53560,53560,48766,44219,43149
20087,2089,4694,13029,7058,9.92062e+12,59.9501,6294.02,20087,2282,72,15393,15393,11771,11271,7215
50026,1994,13989,32019,18007,9.31729e+12,59.3559,17162.2,50026,6815,72,36037,36037,22084,21744,5018
88806,25727,28116,56272,32534,8.82238e+12,58.4605,33038.5,88806,13675,72,60690,60690,58100,55099,55078
83331,19717,30183,52127,31204,8.23697e+12,54.2711,34581.6,83331,14686,72,53148,53148,43604,32320,32066
73464,19623,35285,44416,29048,6.7196e+12,56.1973,38614.3,73464,17189,72,38179,38179,32442,24667,22869
36778,19214,36778,0,36778,7.99978,0,36778,36778,36778,1,0,0,0,0,0
24775,5843,11218,15110,9665,7.08111e+12,54.9118,12667.2,24775,5442,72,13557,13557,11550,8769,8335
97903,18560,26243,62874,35029,9.45518e+12,59.5734,31913.3,97903,12781,72,71660,71660,64227,62442,51748
43393,7978,16099,27085,16308,8.14446e+12,57.8716,18622.7,43393,7839,72,27294,27294,22681,16444,15002
90181,3206,22541,58195,31986,9.6888e+12,59.8671,27940.3,90181,10980,72,67640,67640,29223,12138,11225
38341,3656,11364,24434,13907,9.09191e+12,59.0401,13865,38341,5530,72,26977,26977,17730,17236,9059
17952,3201,4212,11636,6316,9.9146e+12,59.8903,5673.75,17952,2046,72,13740,13740,12264,10903,10625
25356,1975,7779,16126,9230,8.96754e+12,58.7933,9552.84,25356,3780,72,17577,17577,12345,12202,6108
40677,4326,16648,25104,15573,7.64163e+12,56.3971,18927.2,40677,8104,72,24029,24029,14321,7674,5625
83931,17471,19497,54433,29498,9.92312e+12,60.1379,24671.5,83931,9498,72,64434,64434,61946,61382,57911
49544,5388,22582,30182,19362,7.04731e+12,56.5455,25080.8,49544,11001,72,26962,26962,18409,8432,8232
47205,8492,10952,30624,16581,9.92837e+12,60.0887,14140.8,47205,5330,72,36253,36253,33235,29181,28284
46927,866,17470,29279,17648,8.12988e+12,57.8644,20155.2,46927,8510,72,29457,29221,15339,5874,2808
53168,10843,12370,34474,18694,9.91207e+12,60.0894,15889.5,53168,6020,72,40798,40798,38942,38517,35956
77519,9393,18045,50269,27250,9.91465e+12,60.1142,22877.6,77519,8782,72,59474,59474,49053,34796,31422
41804,7320,14490,26281,15523,8.4407e+12,57.9292,17019.6,41804,7038,72,27314,27314,21995,14683,13122
28308,2124,6644,18361,9947,9.89757e+12,59.9674,8740.16,28308,3229,72,21664,21664,15082,10518,7100
5569,767,1346,3616,1953,9.78896e+12,58.9727,1945.45,5569,640,72,4223,4223,3549,3391,2573
11070,1545,3888,6962,4108,8.43682e+12,57.7532,4774.67,11070,1883,72,7182,7182,4644,2908,2446
61303,15162,28461,37251,24052,6.91825e+12,55.6692,31403.3,61303,13843,72,32842,32842,28435,22354,21120
59480,1108,13810,38586,20894,9.91731e+12,60.1097,17677.3,59480,6722,72,45670,45670,27133,17771,4331
70740,15627,16429,45873,24867,9.91975e+12,60.127,20905.6,70740,7997,72,54311,54311,53327,52082,51857
93032,7134,21638,60329,32703,9.91508e+12,60.1374,27289.1,93032,10540,72,71394,71394,50281,49852,24320
47377,12182,23989,37032,10345,78927900000,8.99489,24436.2,47377,21586,11,23388,23388,14433,15448,13431
35727,11227,15531,21907,13820,7.30998e+12,56.837,17513.4,35727,7560,72,20196,20196,18085,15275,14682
31302,2242,7315,20294,11008,9.9031e+12,60.0234,9592.83,31302,3555,72,23987,23987,14200,14007,7604
62253,7178,33588,48789,13464,79750400000,8.98092,34080.7,62253,30223,11,28665,28665,10761,12328,9211
12698,2216,3008,8228,4470,9.92551e+12,59.7531,4123.99,12698,1459,72,9690,9690,8818,7722,7529
24668,4645,7710,15657,9011,8.89544e+12,58.7016,9432.01,24668,3752,72,16958,16958,14105,10796,10767
76434,2024,3218,60505,15929,5.85643e+13,12.0016,4136.45,76434,2824,19,73216,73216,62688,53359,66930
63040,8864,25428,38989,24051,7.70696e+12,56.8707,28718.3,63040,12367,72,37612,37612,29160,19354,19004
80316,2941,5013,63943,16373,5.73238e+13,11.9974,5937.39,80316,3284,14,75303,75303,61536,51251,69102
27581,898,6470,17887,9694,9.91636e+12,59.9698,8520.58,27581,3150,72,21111,21111,8312,3473,3290
3597,357,1208,2278,1319,8.83745e+12,57.213,1601.32,3597,587,70,2389,2341,1505,1285,1215
46706,5523,10890,30293,16413,9.91882e+12,60.0792,14046.7,46706,5303,72,35816,35816,29324,20494,18419
84934,11853,19731,55074,29860,9.91302e+12,60.1337,24963.2,84934,9603,72,65203,65203,53751,53520,39738
76957,35195,39295,46128,30829,6.32247e+12,55.7071,42586.2,76957,19134,72,37662,37662,35704,33497,33487
66969,11291,19360,42758,24211,9.18129e+12,59.228,23368.4,66969,9426,72,47609,47609,39675,30379,30064
52501,5422,14609,33634,18867,9.32156e+12,59.3168,17918.7,52501,7096,72,37892,37892,27606,27345,15120
31711,2344,7400,20557,11154,9.93615e+12,60.0368,9698.27,31711,3604,72,24311,24311,16918,11788,7953
13276,3156,6661,7982,5294,6.54225e+12,55.5473,7493.17,13276,3244,72,6615,6615,5190,3225,2997
74908,7525,20658,47995,26913,9.36017e+12,59.4452,25128.5,74908,10064,72,54250,54250,38417,25614,19071
38382,7419,14535,23905,14477,8.0393e+12,57.7313,16795.9,38382,7078,72,23847,23847,18842,12065,10497
77600,852,31187,48003,29597,7.72597e+12,57.434,35106.6,77600,15188,72,46413,46125,26419,16781,2079
39409,15454,17122,24161,15248,7.3042e+12,56.8515,19268.4,39409,8331,72,22287,22287,21409,20296,20089
20719,2028,8340,12827,7892,7.72757e+12,57.2395,9688.31,20719,4056,72,12379,12379,8005,4175,3265
75313,25700,27857,47013,28300,8.14145e+12,57.9477,31852.1,75313,13568,72,47456,47456,46457,45061,44963
58968,10663,16907,37679,21289,9.21392e+12,59.2462,20517.5,58968,8231,72,42061,42061,35097,28457,26684
26068,566,8109,16550,9518,8.93464e+12,58.7619,9910.75,26068,3949,72,17959,17863,7966,2828,931
70140,12334,16350,45474,24666,9.90739e+12,60.0673,20791.4,70140,7959,72,53790,53790,47943,47827,40895
87948,11457,22376,56685,31263,9.62506e+12,59.7243,27635.1,87948,10885,72,65572,65572,53916,37854,34204
72090,2689,27558,44836,27254,7.98559e+12,57.6573,31345.2,72090,13419,72,44532,44532,27096,26377,5935
32599,7399,15747,19706,12893,6.70501e+12,56.0479,17459.9,32599,7667,72,16852,16852,13114,8769,8817
14630,1666,3451,9487,5143,9.89572e+12,59.8274,4699.18,14630,1674,72,11179,11179,8950,8466,5453
44031,499,16796,27391,16640,8.00707e+12,57.4802,19318.4,44031,8176,72,27235,26755,15532,8147,1355
4030,2324,2638,2322,1708,4.64861e+12,48.9342,2906.86,4030,1268,61,1392,1392,1377,1381,1378
89376,3924,20739,57964,31412,9.92842e+12,60.1454,26200.2,89376,10103,72,68637,68637,31535,15343,13845
75203,13304,17447,48775,26428,9.91993e+12,60.137,22164.5,75203,8495,72,57756,57756,52773,46030,44471
77926,33020,37298,47141,30785,6.73205e+12,55.8671,40807.3,77926,18154,72,40628,40628,38808,36352,35886
77417,11552,24050,49137,28280,8.90293e+12,58.8827,28459.3,77417,11712,72,53367,53367,38324,35326,14037
24408,952,5760,15827,8581,9.87424e+12,59.8723,7618.26,24408,2793,72,18648,18648,11650,11511,3140
69316,5534,16108,44945,24371,9.91467e+12,60.1243,20507.6,69316,7841,72,53208,53208,34112,33201,18721
75609,7445,17538,49034,26575,9.92659e+12,60.1367,22272.6,75609,8544,72,58071,58071,42801,41050,25192
90903,686,27419,57845,33058,9.01854e+12,59.0369,32531.5,90903,13353,72,63484,63148,36157,35462,2544
33356,7962,9743,21281,12075,9.14865e+12,59.0791,11991.3,33356,4735,72,23613,23613,22221,22180,20682
70364,7004,31578,42936,27428,7.12458e+12,56.6816,34950.5,70364,15382,72,38786,38786,25063,9028,8563
44778,9341,13265,28534,16244,9.09086e+12,58.803,16109.6,44778,6448,72,31513,31513,27506,27403,22740
3574,877,884,2319,1255,9.88944e+12,58.4936,1313.26,3574,426,65,2690,2690,2679,2680,2680
21068,1338,4929,13662,7406,9.91689e+12,59.9292,6586.34,21068,2395,72,16139,16139,8882,8873,4665
16604,607,728,13150,3454,5.84991e+13,11.9884,1146.08,16604,699,14,15876,15876,14858,14002,15417
96617,6582,28467,61589,35028,9.11382e+12,59.1555,33898.2,96617,13868,72,68150,68102,47667,47249,22471
95421,17229,38955,58919,36502,7.64552e+12,57.2699,43579.6,95421,18973,72,56466,56466,41018,22847,22289
27646,8309,18454,15809,11837,4.31267e+12,51.9187,19528.9,27646,8968,72,9192,9192,6756,4290,3840
43585,15864,22117,26151,17434,6.36977e+12,55.2641,24201.3,43585,10752,72,21468,21468,18702,14999,14171
5260,818,1245,3412,1848,1.0037e+13,59.289,1822.14,5260,606,72,4015,4015,3392,3382,2822
78807,11309,22764,50322,28485,9.1853e+12,59.2283,27358.1,78807,11086,72,56043,56043,44497,28716,24986
25547,6161,14669,15026,10521,5.53352e+12,54.3636,15889.4,25547,7140,72,10878,10878,7707,4058,3345
70197,14311,22987,44342,25855,8.6863e+12,58.6194,26966.1,70197,11193,72,47210,47210,40302,38598,28693
99919,22142,23206,64789,35130,9.91498e+12,60.15,29222.1,99919,11300,72,76713,76713,75148,75118,73399
48097,884,11213,31193,16904,9.91526e+12,60.0708,14446.9,48097,5455,72,36884,36884,12027,13156,3509
59551,5462,13818,38621,20930,9.92451e+12,60.1169,17690.4,59551,6725,72,45733,45733,32263,21488,18622
58936,3566,31151,46148,12788,79474400000,8.99511,31637.4,58936,28028,11,27785,27785,9335,10888,7802
17490,2440,4857,11211,6279,9.34877e+12,59.2101,6228.78,17490,2359,72,12633,12633,10193,10131,7411
60314,10157,14001,39126,21188,9.91207e+12,60.1119,17915.4,60314,6815,72,46313,46313,41691,35433,33980
4595,1775,2499,2746,1849,5.9934e+12,54.1286,2859.13,4595,1211,69,2096,2096,1867,1529,1662
46889,4895,10947,30407,16482,9.89857e+12,60.0485,14113.2,46889,5319,72,35942,35942,27529,18867,16563
21173,4589,4957,13734,7439,9.89479e+12,59.9088,6623.44,21173,2402,72,16216,16216,15708,15264,15269
97644,25376,27963,62384,35260,9.21006e+12,59.2791,33502.6,97644,13608,72,69681,69681,67636,64896,64311
54440,2269,21184,33798,20642,7.88429e+12,57.5957,24155.8,54440,10306,72,33256,33256,20405,6937,4867
45196,5108,10557,29308,15888,9.90488e+12,60.0429,13627,45196,5135,72,34639,34639,26794,26627,17264
96579,16651,22443,62626,33953,9.91116e+12,60.1457,28285.9,96579,10927,72,74136,74136,67132,57587,55357
98274,30437,32895,61957,36317,8.59628e+12,58.3462,38137,98274,16009,72,65379,65379,64444,63242,63038
52675,7026,12260,34157,18518,9.91051e+12,60.0898,15751.2,52675,5967,72,40415,40415,32767,32618,23477
5805,1152,2336,3591,2214,7.92079e+12,56.7264,2854.05,5805,1135,70,3469,3469,2492,1354,1543
3924,748,1626,2430,1494,7.74123e+12,55.9284,2008.59,3924,788,69,2298,2298,1456,679,535
51463,3061,32213,29807,21656,4.83221e+12,53.0421,34122.1,51463,15671,72,19250,19250,11682,6646,2848
4932,247,1704,3110,1822,8.63353e+12,57.3587,2193.75,4932,826,72,3228,3180,2012,862,814
36142,3782,10090,23138,13004,9.33072e+12,58.6166,12523.5,36142,4909,72,26052,26052,17989,18827,10595
23433,4056,10090,14376,9057,7.40141e+12,56.8405,11514.9,23433,4915,72,13343,13343,9969,6026,6094
19472,3545,4941,12553,6919,9.67977e+12,59.6235,6466.31,19472,2407,72,14531,14531,12581,10767,10380
80897,22928,23121,51703,29194,9.22175e+12,59.2796,27838.4,80897,11258,72,57776,57776,57544,57328,57336
4813,509,1158,3125,1688,9.96706e+12,58.9331,1692.76,4813,561,72,3655,3655,2726,1878,1727
56372,8778,15902,36068,20304,9.2757e+12,59.3088,19395.8,56372,7740,72,40470,40470,33914,25017,22937
1712,567,1134,994,718,4.97084e+12,25.4714,1274.46,1712,535,48,578,578,578,578,578
9749,301,3388,6131,3618,8.55975e+12,57.8599,4196.63,9749,1650,72,6361,6265,2807,1481,1041
48431,5896,15863,30600,17831,8.68656e+12,58.5808,18785.7,48431,7719,72,32568,32568,23401,14328,12006
20879,5262,6071,13340,7539,9.1708e+12,58.9681,7620.26,20879,2944,72,14808,14808,13802,12624,12802
37249,10257,14309,23168,14081,7.97141e+12,57.6223,16502,37249,6966,72,22940,22940,20699,17604,17100
82827,2204,27561,52243,30584,8.6246e+12,58.5364,32100.2,82827,13427,72,55266,55266,32516,13311,4759
87812,11771,24170,56272,31540,9.36821e+12,59.4607,29290.8,87812,11774,72,63642,63642,51405,48493,30734
83451,16362,25541,53032,30419,8.95993e+12,58.9161,30271.2,83451,12420,72,57910,57910,49906,39011,36438
79770,6648,33320,49128,30642,7.51587e+12,56.7812,37244.6,79770,16210,72,46450,46450,31788,14754,14091
59915,7226,17567,38206,21709,9.1252e+12,59.0286,21199.6,59915,8544,72,42348,42348,31707,31439,18772
4399,503,1337,2804,1595,9.0997e+12,57.885,1809.74,4399,645,70,3062,3062,1750,985,782
83901,6966,47051,65866,18035,80250800000,8.9908,47605.3,83901,42340,11,36850,36850,13083,14324,11857
48351,10736,11276,31357,16994,9.89869e+12,60.0702,14527.7,48351,5480,72,37075,37075,36445,35662,35550
90845,7123,26824,57900,32945,9.11164e+12,59.1401,31968.6,90845,13067,72,64021,64021,41587,15118,14042
35023,3544,11939,22048,12975,8.51072e+12,58.3135,14146.7,35023,5801,72,23084,23084,14742,15361,7838
31782,6456,11454,19889,11893,8.2753e+12,57.3176,13446.8,31782,5575,72,20328,20328,16727,12587,12494
70561,17560,28331,43662,26899,7.72835e+12,57.217,31954.4,70561,13780,72,42230,42230,38591,33566,32588
55593,13246,19846,34835,20758,8.31288e+12,58.1174,22996.6,55593,9664,72,35747,35747,31146,25748,25748
40408,8996,10518,26010,14398,9.5681e+12,59.6201,13237.1,40408,5114,72,29890,29890,28648,27198,27312
47093,1408,13233,30141,16952,9.29485e+12,59.322,16248.8,47093,6443,72,33860,33860,20863,11879,4971
81503,3265,18949,52856,28647,9.9175e+12,60.1289,23995,81503,9229,72,62554,62554,39692,39233,11551
8090,781,1904,5255,2835,1.00171e+13,59.5176,2695.5,8090,925,72,6186,6186,4526,4497,2675
86422,12197,20068,56044,30378,9.91313e+12,60.1435,25381.3,86422,9768,72,66354,66354,54904,54673,40882
82665,18125,19210,53604,29061,9.91043e+12,60.1388,24323.7,82665,9350,72,63455,63455,62156,61854,60118
42190,2189,12470,26886,15304,9.12341e+12,59.0822,15176,42190,6074,72,29720,29720,17061,15395,7518
10729,2105,3528,6784,3945,8.73115e+12,58.1852,4418.56,10729,1713,72,7201,7201,6255,4940,4867
30490,6973,7129,19771,10719,9.94287e+12,60.0166,9351.97,30490,3472,72,23361,23361,23177,23136,23030
55279,22348,27189,33323,21956,6.56295e+12,55.2956,29777.8,55279,13223,72,28090,28090,27235,26042,25988
96441,14504,36045,60131,36310,8.08863e+12,57.7859,40946,96441,17543,72,60396,60396,44462,26292,21602
78453,17459,18257,50882,27571,9.90697e+12,60.1243,23143,78453,8890,72,60196,60196,59029,59008,57771
12551,2875,3737,8009,4542,9.09249e+12,58.7443,4775.28,12551,1814,72,8814,8814,7858,6641,6434
93015,4007,21580,60321,32694,9.91551e+12,60.145,27237.2,93015,10507,72,71435,71435,32503,33269,14160
54322,3124,23863,33250,21072,7.25324e+12,56.8114,26625,54322,11621,72,30459,30459,18669,4954,4464
4818,2512,2534,2877,1941,6.36197e+12,54.5828,2916.26,4818,1230,69,2284,2284,2259,2269,2268
93194,4545,21602,60437,32757,9.92375e+12,60.1579,27271,93194,10522,72,71592,71592,46682,46188,15997
30389,8997,10213,19161,11228,8.6031e+12,58.3738,12190.6,30389,4972,72,20176,20176,18691,16748,16362
2034,41,510,1319,715,1.00476e+13,57.8333,797.619,2034,247,55,1227,336,776,742,138
87216,12033,20249,56555,30661,9.9173e+12,60.1405,25599.7,87216,9859,72,66967,66967,54987,43482,40335
43990,20890,43990,0,43990,7.99982,0,43990,43990,43990,1,0,0,0,0,0
67714,2138,15744,43908,23806,9.91856e+12,60.1224,20052.4,67714,7669,72,51970,51970,32201,31794,7899
55248,14805,18714,34798,20450,8.53959e+12,57.6252,21927,55248,9094,72,36534,36534,32868,28533,28582
94374,1824,25185,60617,33757,9.47479e+12,59.597,30686.6,94374,12269,72,69189,69189,41256,40582,6893
56671,7364,13227,36752,19919,9.90296e+12,60.0893,16935.9,56671,6440,72,43444,43444,36436,26891,24656
38766,6712,9147,25114,13652,9.8854e+12,59.9008,11849,38766,4450,72,29619,29619,26722,26041,21980
5897,1289,1911,3743,2154,8.95205e+12,57.9232,2482.33,5897,930,72,3986,3986,3518,3361,2940
40085,4130,9328,25997,14088,9.91442e+12,60.044,12114.5,40085,4531,72,30757,30757,23176,23027,13946
46384,7835,10766,30085,16299,9.91446e+12,60.0823,13911.8,46384,5231,72,35618,35618,31297,31220,26109
20828,2088,5294,13438,7390,9.6496e+12,59.5919,6903.12,20828,2573,72,15534,15534,11066,7505,5730
28214,3459,9800,17728,10486,8.4514e+12,58.1965,11641.7,28214,4768,72,18414,18414,13264,7239,7115
62385,2223,16856,40043,22342,9.41921e+12,59.505,20715,62385,8197,72,45529,45529,28407,11552,7418
15321,3408,3612,9931,5390,9.89425e+12,59.8232,4904.34,15321,1750,72,11709,11709,11447,11259,11273
91126,18957,21205,59092,32034,9.90615e+12,60.133,26759.9,91126,10324,72,69921,69921,67258,63690,62903
69045,11619,16038,44777,24268,9.91661e+12,60.1328,20425.2,69045,7811,72,53007,53007,47681,40453,38785
73382,10029,25783,46045,27337,8.37891e+12,58.2481,29789.6,73382,12561,72,47599,47599,33052,20695,17159
18980,7519,8062,11670,7310,7.44839e+12,56.8812,9287.56,18980,3916,72,10918,10918,10449,9893,10107
92818,29351,40441,56865,35953,7.28963e+12,56.9093,44781.3,92818,19698,72,52377,52377,48623,43562,42405
69850,14336,30425,42790,27060,7.29084e+12,56.4555,33848.4,69850,14812,72,39425,39425,31936,23779,21672
21776,5755,7553,13684,8092,8.44749e+12,58.1496,9056.73,21776,3669,72,14223,14223,13499,12684,12884
41342,9218,11378,26494,14848,9.36912e+12,58.7276,14105.7,41342,5537,72,29964,29964,26777,26722,23010
33031,5181,18261,19563,13468,5.7755e+12,54.9355,19809.2,33031,8885,72,14770,14770,9803,4070,3937
64267,10275,14955,41675,22592,9.91177e+12,60.1127,19081.2,64267,7279,72,49312,49312,43674,42362,34225
25026,5344,6772,16068,8958,9.42627e+12,59.3699,8599,25026,3294,72,18254,18254,16269,13994,14016
46764,16295,22434,28283,18481,6.72891e+12,56.1555,24734.2,46764,10923,72,24330,24330,21813,18327,17734
15448,3346,6519,9508,5940,7.49739e+12,56.8052,7570.34,15448,3166,72,8929,8929,7781,6266,6018
34825,5917,8116,22589,12236,9.92811e+12,60.0413,10596.2,34825,3953,72,26709,26709,24116,20640,19879
77255,14873,17968,50089,27166,9.91902e+12,60.1324,22787.9,77255,8753,72,59287,59287,55578,54710,49444
23935,4709,5644,15516,8419,9.9089e+12,59.9274,7472,23935,2745,72,18291,18291,16913,15655,15407
15688,754,5485,9849,5839,8.46788e+12,56.4122,6645.65,15688,2666,72,10203,10107,5945,1458,887
52427,1629,12198,34001,18426,9.92473e+12,60.0884,15672.4,52427,5939,72,40229,40229,15691,16452,5753
3278,1098,1483,2006,1272,7.27404e+12,46.3612,1806.7,3278,716,61,1795,1795,1387,911,1123
91527,4404,21243,59363,32164,9.91849e+12,60.1371,26819.7,91527,10340,72,70284,70284,33844,34305,15466
36359,11647,11818,22997,13362,8.72869e+12,58.5764,14134.9,36359,5753,72,24541,24541,24303,24124,24164
47171,672,10933,30597,16574,9.9294e+12,60.0996,14122.6,47171,5320,72,36238,36238,21218,20926,2783
59976,6417,14548,38791,21185,9.79024e+12,59.957,18396.3,59976,7086,72,45428,45428,34579,23835,20884
99860,25197,26167,64234,35626,9.53419e+12,59.6739,31975.6,99860,12748,72,73693,73693,72264,72239,70695
98179,9887,42259,60230,37949,7.35564e+12,56.4474,46851.3,98179,20565,72,55920,55920,34050,18528,13518
57607,8893,23882,35504,22103,7.5689e+12,56.5321,26888.4,57607,11629,72,33725,33725,22079,14220,11622
5630,1137,1395,3641,1989,9.98137e+12,59.0789,1991.59,5630,679,72,4235,4235,3967,3875,3723
66718,16006,24269,41719,24999,8.22018e+12,58.0409,27908.6,66718,11820,72,42449,42449,35033,26358,26063
18770,4236,4399,12174,6596,9.95083e+12,59.9086,5909.23,18770,2141,72,14371,14371,14176,14133,14017
79205,17813,18367,51377,27828,9.92047e+12,60.1342,23295.6,79205,8943,72,60838,60838,60169,59342,59224
53555,9843,12462,34733,18822,9.91201e+12,60.0927,16001.1,53555,6062,72,41093,41093,37996,33815,32886
46986,5327,10947,30460,16526,9.92016e+12,60.0918,14120.2,46986,5333,72,36039,36039,27812,20076,17799
81118,2340,18864,52603,28515,9.91391e+12,60.1258,23888.4,81118,9187,72,62254,62254,23637,25003,8452
9000,2930,4013,5513,3487,7.19194e+12,56.2133,4690.24,9000,1949,72,4987,4987,4477,3829,3808
39408,11322,18703,23870,15538,6.78578e+12,55.4118,20726.2,39408,9097,72,20705,20705,17799,13865,13005
59056,10786,14705,38124,20932,9.70009e+12,59.8364,18479.5,59056,7152,72,44351,44351,38674,38556,31811
70463,49284,65847,48518,21945,9.2093e+12,3.99608,65978.9,70463,21964,9,4616,4616,3456,4616,3462
78572,13919,26106,49566,29006,8.6275e+12,58.4379,30452.4,78572,12711,72,52466,52466,43423,31089,28180
18294,4009,4295,11857,6437,9.90779e+12,59.8604,5778.45,18294,2086,72,13999,13999,13669,13594,13288
43327,5158,13443,27508,15819,8.91704e+12,58.8323,16161.9,43327,6545,72,29884,29884,21152,13445,10575
75981,17710,30806,46949,29032,7.68872e+12,57.3814,34636,75981,15008,72,45175,45175,36675,26663,26462
34861,1162,8129,22609,12252,9.91793e+12,60.036,10612.9,34861,3954,72,26732,26732,16632,16424,4292
1812,265,459,1169,643,1.03354e+13,57.436,720.64,1812,223,54,1353,1353,1123,903,912
60059,2551,23544,37258,22801,7.86485e+12,57.5676,26749.6,60059,11467,72,36515,36515,21803,9172,3952
31008,6334,11317,19383,11625,8.22097e+12,57.9303,13258.5,31008,5507,72,19691,19691,15596,9943,8822
10510,805,3225,6692,3818,8.96804e+12,58.4112,4122.71,10510,1558,72,7285,7237,4307,2994,2471
77817,6241,18270,50440,27377,9.87859e+12,60.0843,23110.9,77817,8890,72,59547,59547,42030,29299,20501
46821,19859,21817,28431,18390,6.91161e+12,55.6934,24171.1,46821,10623,72,25004,25004,23242,20804,20459
9401,2643,2767,5994,3407,9.23914e+12,58.729,3603.71,9401,1343,72,6634,6634,6489,6390,6392
73090,9162,19594,46943,26147,9.46089e+12,58.4603,24012.5,73090,9528,72,53496,53496,41653,27676,27184
84797,23990,25277,54015,30782,9.06209e+12,59.0911,30117.1,84797,12309,72,59520,59520,58044,57690,55729
72810,17408,21092,46484,26326,9.18155e+12,59.2107,25383.6,72810,10271,72,51718,51718,48532,44249,43293
99052,9859,24131,64037,35015,9.77248e+12,59.9642,30023.3,99052,11752,72,74921,74921,54155,53732,28615
56242,10545,13069,36484,19758,9.91784e+12,60.1048,16758.1,56242,6363,72,43173,43173,39546,39467,35240
77228,334,4227,61355,15873,5.778e+13,11.9971,5136.96,77228,3183,14,73001,73001,44796,23426,60351
61343,3678,26373,37637,23706,7.36716e+12,56.4408,29470.7,61343,12836,72,34970,34970,18003,8016,4360
3686,870,908,2392,1294,9.85928e+12,58.3432,1349.16,3686,428,65,2778,2778,2769,2761,2766
93001,14696,21576,60324,32677,9.91697e+12,60.1452,27233.1,93001,10506,72,71425,71425,63073,61139,48997
28142,3786,10587,17548,10594,8.04983e+12,57.7073,12360.3,28142,5144,72,17555,17555,12268,6118,5950
13571,1002,4750,8533,5038,8.40917e+12,57.1445,5790.4,13571,2291,72,8821,8821,5438,1462,1519
62994,6300,14613,40859,22135,9.92287e+12,60.1165,18669.9,62994,7116,72,48381,48381,36094,24672,21429
40630,5754,9504,26335,14295,9.89326e+12,60.0426,12318.6,40630,4621,72,31126,31126,26644,25594,19154
40374,623,19784,31516,8858,78593800000,8.99225,20203.5,40374,17798,11,20590,20590,5377,7254,3515
10564,2787,4664,6470,4094,7.25549e+12,54.6501,5433.68,10564,2249,72,5900,5900,5141,4076,4058
87011,9083,20217,56434,30577,9.91131e+12,60.1343,25558.1,87011,9840,72,66794,66794,50492,50177,30465
23729,7255,8190,14920,8809,8.46992e+12,58.1744,9802.35,23729,3976,72,15539,15539,15011,14385,14596
97464,4001,22596,63209,34255,9.91728e+12,60.149,28486.7,97464,11003,72,74868,74868,47688,32131,14185
53265,12051,12390,34540,18725,9.91273e+12,60.0894,15914.4,53265,6025,72,40875,40875,40495,40050,40032
62432,15400,17529,39963,22469,9.28926e+12,59.3243,21341.6,62432,8530,72,44903,44903,42744,40195,40322
26750,1585,6219,17354,9396,9.9327e+12,60.0037,8226.62,26750,3023,72,20531,20531,10931,10981,5600
