"data_size","cache_size","unique_size","reads","writes","data","ins","avg_step","avg_reuse_dist","sum_sqrt_count","sum_count","lis","lds","belady","lru","pivot","ld","mru"
23826,7343,9982,0,23826,0,23826,4.952e+17,94.7017,11667.9,23826,4844,110,13844,13844,12344,12206,10122
39502,4655,9303,37212,2290,0,39502,2.22226e+18,97.7853,12386.3,39502,4499,110,30199,30199,23897,22592,16164
46165,11876,12130,43578,2587,43578,2587,6.15777e+18,97.4372,15517.4,46165,5879,110,34035,34035,33920,33900,33744
31759,4469,7655,0,31759,11207,20552,2.50542e+15,59.9164,9941.42,31759,3724,72,24104,24104,19494,14705,13966
45305,496,1417,0,45305,43889,1416,0.0312548,0.968723,8010.66,45305,1417,1,43888,43888,43888,43888,43888
30093,12,14,29233,860,30021,72,1.44671e+14,10.6098,532.777,30093,14,12,30078,30073,29981,29980,29703
29661,10047,13115,0,29661,11521,18140,1.84221e+15,56.6897,14804.6,29661,6383,72,16546,16546,12779,7770,6557
40145,1175,16057,38315,1830,0,40145,1.74765e+18,95.2194,18641.5,40145,7792,110,24088,24088,13137,7929,3712
23324,11,12,22653,671,23313,11,1.47375e+14,9.98654,437.455,23324,12,11,23312,23312,22813,22814,22225
42934,11861,13946,42934,0,40517,2417,4.9976e+18,304.791,16052.6,42934,5109,133,28988,28986,27680,28566,25018
43312,13,15,42054,1258,43226,86,1.60585e+14,10.4474,676.095,43312,13,13,43297,43297,42581,42582,41060
16810,3236,5294,16810,0,15830,980,4.64457e+18,135.371,6385.75,16810,2016,121,11516,11458,9376,10109,7580
44753,8002,12779,42323,2430,0,44753,2.07859e+18,97.0453,16001.6,44753,6198,110,31974,31974,27944,26244,21260
15946,35,176,15896,50,15946,0,6.12955e+18,167.804,1563.89,15946,132,136,9130,2953,3242,3546,3250
18720,5850,6638,18720,0,17671,1049,4.61977e+18,139.958,7660.62,18720,1719,126,12082,12082,11984,12082,10909
15541,6429,6431,15541,0,14770,771,5.09172e+18,147.744,7391.13,15541,2711,122,9110,9110,9110,9110,9110
4540,1535,1560,1678,2862,0,4540,8.60449e+12,51.7751,2026.03,4540,753,66,2980,2980,2959,2970,2958
30499,3607,7131,10721,19778,0,30499,9.91242e+12,60.0174,9354.91,30499,3473,72,23368,23368,18248,22479,12102
43498,173,176,43414,84,43498,0,5.98157e+18,169.664,2468.6,43498,170,170,43320,43312,42806,42700,42870
41486,1399,9909,39066,2420,39066,2420,5.11909e+18,98.3625,13032.3,41486,4692,111,31577,31577,20363,25012,6420
22468,3,12,21828,640,22459,9,1.39172e+14,10.2244,422.068,22468,12,11,17067,12145,13977,14795,9484
15056,289,5035,14289,767,14289,767,7.30233e+18,95.724,6359.8,15056,2434,110,10021,9771,5396,7869,1587
40352,7909,11800,0,40352,0,40352,5.98596e+17,96.916,14749.4,40352,5724,110,28552,28552,25204,22875,19753
27802,890,901,0,27802,27009,793,3.54897e+16,167.42,2848.79,27802,128,26,26901,26901,26871,26862,26814
9772,42,176,9730,42,9772,0,6.1543e+18,158.252,1217.45,9772,112,112,6352,2226,2338,2595,2168
31336,12,15,30418,918,31286,50,1.69212e+14,10.3739,571.592,31336,12,12,31321,31320,30506,30506,26130
2948,925,2048,2878,70,0,2948,9.66706e+17,70.1102,2278.96,2948,965,57,900,801,730,686,830
19593,7811,9199,19007,586,18725,868,4.53045e+18,196.239,10295.2,19593,3003,129,10394,10394,10202,10394,10036
30153,2669,8183,0,30153,0,30153,6.17715e+17,97.1388,10585,30153,3964,110,21970,21970,15461,10172,7721
38387,13,15,37278,1109,38333,54,1.55091e+14,10.3429,613.517,38387,12,12,38372,38372,37626,37627,35906
5181,1158,1282,0,5181,0,5181,6.44581e+17,95.3459,1949.41,5181,600,87,3899,3899,3773,3796,3761
22560,159,176,22481,79,22560,0,6.02491e+18,170.384,1830.37,22560,159,157,22206,21736,20295,20476,20474
35604,250,1419,0,35604,34569,1035,4.1384e+16,280.955,4567.91,35604,229,26,33915,33315,28127,24893,12714
3206,716,1343,3056,150,3056,150,2.80659e+18,90.9345,1733.49,3206,626,64,1863,1778,1746,1845,1853
32160,538,1627,0,32160,31211,949,4.67971e+16,295.819,5077.48,32160,274,26,30533,29414,27235,25077,15391
12211,1802,2913,0,12211,4297,7914,2.52817e+15,59.6868,3991.89,12211,1415,72,9298,9298,8039,7868,6096
3466,517,1469,3306,160,3306,160,4.34165e+18,86.3122,1880.96,3466,666,74,1997,1915,1291,1348,973
24634,4589,7407,0,24634,0,24634,5.91947e+17,96.5568,9403,24634,3577,110,17227,17227,14543,11980,11615
40064,7691,10081,37784,2280,37784,2280,3.18768e+18,97.5446,13144.3,40064,4883,110,29983,29983,27571,29262,22882
11467,262,3481,4165,7302,0,11467,9.03506e+12,58.6529,4444.33,11467,1693,72,7986,7938,4785,7436,1020
44661,3667,14738,0,44661,0,44661,5.67421e+17,96.3572,17796.2,44661,7160,110,29923,29923,19967,8543,8224
48994,14,17,47554,1440,48922,72,1.73525e+14,10.4638,766.165,48994,14,12,48977,48977,48033,48034,45111
41655,4229,9711,39225,2430,0,41655,2.23032e+18,97.8717,12931.6,41655,4712,110,31944,31944,24461,23211,15214
9406,676,4232,0,9406,3651,5755,1.82603e+15,56.1413,4927.03,9406,2051,72,5174,5078,3762,2767,2282
25503,9,13,24750,753,25476,27,1.80277e+14,10.4847,487.116,25503,12,12,25237,24950,21303,21098,19214
40692,5,6,39420,1272,40532,160,0.000122874,0.999853,487.143,40692,6,1,40686,40686,40686,40686,40686
4443,169,202,0,4443,4318,125,3.53882e+16,19.6086,583.78,4443,42,26,4241,4241,4180,4183,3857
39806,1,12,38673,1133,39790,16,1.38793e+14,10.2846,566.306,39806,12,11,10207,10207,10207,10207,10207
35710,11810,15664,34188,1522,34188,1522,2.66552e+18,94.5213,17903.4,35710,7599,110,20046,20046,18505,19674,16600
17494,2064,5863,17494,0,16484,1010,5.68272e+18,138.561,6856.8,17494,2114,123,11631,11563,8557,10111,4519
44988,13632,18497,42975,2013,42975,2013,8.48585e+18,94.0749,21279.1,44988,8987,110,26491,26491,25907,25907,19728
45342,10648,13641,45342,0,42702,2640,3.67842e+18,314.429,15866.5,45342,5370,129,31701,31701,28481,29508,25735
33580,11,12,32622,958,33562,18,1.38885e+14,10.3016,519.388,33580,12,11,33568,33568,32835,32836,32110
31183,1399,1444,0,31183,30266,917,4.41755e+16,204.728,4517.31,31183,238,26,29739,29739,29611,29602,28952
36929,3530,23094,0,36929,0,36929,3.18504e+17,90.6042,24782.3,36929,11226,110,13835,13835,8753,3975,2965
25773,6353,7251,0,25773,9279,16494,2.37872e+15,59.2338,9099.1,25773,3532,72,18522,18522,17200,18292,15763
18105,2460,6623,18105,0,17105,1000,4.82256e+18,140.921,7620.54,18105,2528,121,11482,11385,8042,9555,5359
29142,1058,13746,27962,1180,27962,1180,3.90267e+18,92.9183,15547.4,29142,6612,111,15396,14973,5780,8886,2761
22520,5659,13105,22520,0,22520,0,2.4675e+18,17.8928,13479.9,22520,11778,20,9415,9415,4196,9415,4214
29918,4,12,29058,860,29908,10,1.46505e+14,10.2173,495.874,29918,11,12,25957,23008,19108,18157,14553
37755,132,176,37672,83,37755,0,5.98296e+18,169.736,2300.99,37755,171,169,36179,33948,28090,28761,28568
2700,73,969,2700,0,2540,160,4.03545e+18,88.527,1284.49,2700,337,68,1414,364,580,1198,420
17984,4521,4680,16967,1017,0,17984,2.16203e+18,96.8734,6319.34,17984,2255,110,13304,13304,13238,13226,13256
17852,2074,6184,0,17852,0,17852,5.54944e+17,95.6789,7670.45,17852,2985,110,11668,11668,8444,5374,4564
31597,9884,11828,31597,0,29897,1700,5.0837e+18,219.757,13253.3,31597,4649,128,19769,19761,18897,19433,17658
5673,32,61,5673,0,5673,0,2.27221e+18,59.8639,559.192,5673,61,61,4221,1034,2909,3019,2917
37108,625,11937,37108,0,34948,2160,5.03262e+18,266.031,13584.7,37108,4409,128,25171,24770,9783,16473,2158
30737,1660,7176,10808,19929,0,30737,9.89117e+12,60.0367,9420.01,30737,3495,72,23561,23561,15597,22185,5913
17939,943,968,0,17939,17415,524,4.33454e+16,194.412,2762.38,17939,140,26,16971,16971,16954,16952,16885
21079,837,4929,0,21079,7410,13669,2.53034e+15,59.923,6586.6,21079,2396,72,16150,16150,10193,2718,3007
10780,12,14,10452,328,10733,47,2.12647e+14,10.3801,344.235,10780,13,11,10766,10765,10742,10743,10439
36334,2853,11675,13332,23002,0,36334,8.74164e+12,58.6205,14004,36334,5671,72,24659,24659,13747,21285,5159
35380,97,176,35308,72,35380,0,6.16459e+18,172.842,2319.25,35380,160,159,31973,25006,19077,19330,19380
19675,574,4850,0,19675,0,19675,6.39295e+17,97.3275,6630.24,19675,2339,110,14825,14825,6205,3121,2826
5033,1342,1894,0,5033,0,5033,5.3823e+17,93.1534,2464.85,5033,891,90,3139,3139,3109,3025,3124
4400,995,1093,4140,260,4140,260,5.67892e+18,95.2323,1685.11,4400,511,83,3307,3307,3249,3249,3220
40659,108,208,40574,85,40659,0,6.00443e+18,199.423,2572.05,40659,180,182,36706,26036,20367,21729,21458
32093,3427,7507,11284,20809,0,32093,9.8703e+12,60.0026,9827.26,32093,3652,72,24586,24586,18657,23559,11507
12265,131,274,12263,2,12265,0,5.62726e+18,146.638,834.746,12265,265,29,11858,11754,7391,9029,7816
4480,1442,1826,4480,0,4243,237,3.55952e+18,92.1665,2257.57,4480,738,88,2654,2654,2487,2572,2598
12903,897,961,0,12903,12514,389,5.02387e+16,197.669,2581.32,12903,139,26,11942,11942,11900,11884,11652
6678,1450,2368,0,6678,2482,4196,2.16486e+15,57.4513,2972.23,6678,1150,72,4310,4310,3717,3050,2913
44792,1083,13207,42392,2400,42392,2400,6.63275e+18,96.909,16399.7,44792,6404,110,31585,31585,24283,18976,3775
8279,3497,3515,0,8279,0,8279,4.97436e+17,93.5431,4283.4,8279,1693,103,4764,4764,4760,4762,4764
37588,9084,17225,0,37588,0,37588,4.59995e+17,94.254,19488.8,37588,8366,110,20363,20363,17126,13667,11826
6857,10,11,6661,196,6852,5,1.52621e+14,10.1123,237.825,6857,11,11,6832,6809,6635,6636,6311
48854,17,176,48769,85,48854,0,5.98173e+18,172.001,2619.22,48854,171,172,17398,2875,4498,4475,4593
45008,2,16,43690,1318,44941,67,1.67598e+14,10.491,719.713,45008,13,12,26521,20289,14456,15263,13427
44562,1554,1771,0,44562,43259,1303,4.25632e+16,309.19,5841.87,44562,301,26,42791,42791,42463,42433,40621
26405,937,6188,24865,1540,0,26405,2.23174e+18,97.6748,8440.08,26405,2992,110,20217,20217,13058,11946,4261
10460,3749,3864,9950,510,0,10460,1.85908e+18,94.8228,4837.33,10460,1864,110,6596,6596,6497,6502,6552
21119,866,8024,20111,1008,20111,1008,5.0263e+18,95.8856,9617.3,21119,3841,111,13095,12940,4940,7548,2024
1127,405,639,1127,0,1077,50,5.80453e+18,58.0071,777.514,1127,238,48,488,488,488,488,488
27963,4976,11734,0,27963,0,27963,4.93592e+17,94.7791,13637.1,27963,5698,110,16229,16229,12505,8542,8549
33180,7394,11465,31530,1650,0,33180,1.90606e+18,95.9814,13849.5,33180,5553,110,21715,21715,18941,17704,14491
9277,1010,2264,8735,542,8735,542,4.57666e+18,97.1712,3272.02,9277,1062,111,7013,7013,5416,6444,3697
24504,995,7436,0,24504,0,24504,5.91664e+17,96.5385,9412.52,24504,3602,110,17068,16990,6436,2953,1988
31918,815,1168,0,31918,30995,923,3.88395e+16,241.974,3740.22,31918,182,26,30750,30750,29731,29628,25140
33621,1855,7897,31668,1953,31668,1953,5.75821e+18,97.7389,10614.5,33621,3820,110,25724,25724,22066,19377,7244
11890,1141,2866,11200,690,0,11890,2.22315e+18,96.9716,4094.74,11890,1370,110,9024,9024,6683,6214,4035
35869,11,12,34842,1027,35849,20,1.43833e+14,10.2053,542.208,35869,12,11,35857,35857,35068,35069,34179
43932,536,19329,43932,0,42072,1860,4.68285e+18,1996.77,22026.2,43932,6428,144,22522,20263,10209,14224,1790
31938,125,176,31874,64,31938,0,6.13061e+18,172.36,2212.41,31938,156,161,30409,27912,22656,22720,22558
2192,11,612,0,2192,784,1408,2.51204e+15,57.1688,901.944,2192,298,56,536,155,76,74,49
37422,105,176,37364,58,37422,0,6.06262e+18,173.439,2382.8,37422,171,167,33996,24283,20870,21803,22258
15671,382,491,0,15671,15181,490,0.0312679,0.968668,2772.97,15671,491,1,15180,15180,15180,15180,15180
20998,50,779,0,20998,20398,600,3.56136e+16,102.787,2297.1,20998,103,26,20139,20114,15866,15830,4339
18769,3863,4511,17684,1085,17684,1085,5.92814e+18,97.3091,6236.61,18769,2169,110,14258,14258,14118,14121,12929
33573,9716,14912,32153,1420,32153,1420,8.83118e+18,94.4611,17034.8,33573,7244,110,18661,18661,17437,17233,12808
33567,212,1012,0,33567,32610,957,3.55684e+16,208.07,3334.56,33567,150,26,32377,32173,27520,27510,11414
45805,7953,11693,0,45805,0,45805,6.29402e+17,97.5384,15087.9,45805,5672,110,34112,34112,30290,27908,26051
16762,5610,7174,6465,10297,0,16762,7.39706e+12,54.976,8283.97,16762,3476,72,9588,9588,9117,9488,8526
18537,10,11,18005,532,18528,9,1.4571e+14,10.1982,386.616,18537,11,11,18484,18442,17951,17952,17100
25273,4294,6036,8903,16370,0,25273,9.83985e+12,59.8856,7938.96,25273,2937,72,19237,19237,17334,18837,14314
49564,2373,16280,47034,2530,0,49564,1.95396e+18,96.3916,19607.9,49564,7906,110,33284,33284,20450,14039,7283
17677,141,176,17611,66,17677,0,5.97951e+18,169.14,1578.57,17677,152,149,17072,15936,14103,14168,14123
23084,527,7207,21864,1220,21864,1220,5.59305e+18,96.9351,9046.3,23084,3427,111,15877,15616,6746,9900,2709
24469,4,15,23759,710,24386,83,1.59068e+14,10.5853,508.372,24469,14,12,21498,19282,18281,14614,10061
12487,1247,2938,11757,730,0,12487,2.23835e+18,97.1542,4219.64,12487,1408,110,9549,9549,7251,6853,4670
44287,9648,10633,44287,0,44287,0,2.72687e+18,4297.69,15513.4,44287,7383,27,33654,33386,33316,32492,31190
35302,7513,8284,33252,2050,0,35302,2.22588e+18,97.7593,11109.5,35302,4001,110,27018,27018,26006,25807,25063
35386,7784,9677,0,35386,0,35386,6.14449e+17,97.1526,12394,35386,4691,110,25709,25709,23546,20562,20144
2546,799,1285,2446,100,0,2546,1.53077e+18,64.7679,1582.17,2546,585,60,1261,1261,1261,1261,1261
37647,8802,10330,0,37647,0,37647,6.14985e+17,97.2011,13176.5,37647,5014,110,27317,27317,25766,23347,23480
24389,6790,11691,9636,14753,0,24389,6.75504e+12,56.0844,13063.4,24389,5695,72,12698,12650,8924,11908,2710
41543,5224,12537,41543,0,39123,2420,3.79785e+18,294.207,14621.8,41543,4410,133,29006,28857,21131,23225,13199
38792,46,176,38774,18,38792,0,5.98277e+18,169.789,2332.38,38792,168,171,23799,11062,8422,10461,9901
18356,2205,4354,17287,1069,0,18356,2.22731e+18,97.4024,6055.87,18356,2098,110,14002,14002,11059,10478,7634
19301,2433,5728,18261,1040,18261,1040,3.173e+18,96.4941,7387.74,19301,2763,110,13573,13573,8766,10748,7011
3189,714,840,3009,180,0,3189,2.20808e+18,93.2368,1303.49,3189,376,71,2349,2349,2247,2254,2224
47632,16774,18670,45432,2200,45432,2200,8.20808e+18,95.3793,21652.7,47632,9071,110,28962,28962,28822,28822,27688
25150,9913,13978,10272,14878,0,25150,5.74045e+12,52.6479,15226,25150,6787,72,11172,11172,9755,10932,8290
9110,4007,5797,0,9110,0,9110,3.17662e+17,83.0884,6388.59,9110,2789,86,3313,3313,2914,2893,2530
23567,58,176,23490,77,23567,0,6.14071e+18,169.575,1899.61,23567,148,153,17522,11379,7387,7941,7909
46373,33,176,46289,84,46373,0,5.98166e+18,171.895,2551.6,46373,171,173,24331,6862,7688,9654,8496
37870,29,61,37806,64,37870,0,2.34084e+18,60.8056,1442.97,37870,61,61,26587,6257,16358,17066,17666
31765,6721,13078,30327,1438,30327,1438,2.55792e+18,95.611,15157.5,31765,6282,111,18687,18687,15493,18325,10662
47113,11149,15880,44743,2370,0,47113,1.92778e+18,96.2352,19047.6,47113,7707,110,31233,31233,26967,26073,22276
7782,2513,2822,2907,4875,0,7782,8.29367e+12,57.2954,3497.87,7782,1358,72,4960,4960,4649,4890,4304
11570,411,493,0,11570,11241,329,3.56738e+16,20.0005,1382.11,11570,69,26,11077,11077,10927,10930,9765
16771,565,1031,0,16771,16272,499,4.67681e+16,210.145,2911.99,16771,153,26,15740,15334,14879,14483,11205
28931,10628,12185,0,28931,0,28931,4.89927e+17,94.7149,14135.9,28931,5909,110,16746,16746,16391,15793,16093
23846,118,176,23773,73,23846,0,5.98208e+18,169.509,1831.46,23846,156,162,22248,20159,15709,15964,15943
39652,33,176,39591,61,39652,0,6.06819e+18,173.379,2453.36,39652,171,169,21400,6388,7029,8101,7477
42500,12509,18406,0,42500,0,42500,4.79302e+17,94.681,20990.6,42500,8939,110,24094,24094,21408,17687,17126
21603,2405,8510,0,21603,0,21603,5.15256e+17,77.3339,10129.5,21603,4110,110,13093,13093,11207,10502,8285
18955,78,175,18888,67,18955,0,5.98254e+18,165.668,1629.14,18955,147,156,15134,8569,7628,8525,8306
35645,6570,8362,0,35645,0,35645,6.46942e+17,97.7647,11209.1,35645,4044,110,27283,27283,25249,26293,22069
1495,141,451,1412,83,0,1495,2.21281e+18,87.705,708.482,1495,189,51,1044,816,535,543,442
30549,1495,1544,9099,21450,9099,21450,1.85963e+18,15.9908,2195.93,30549,1272,18,29005,29005,28956,29005,28727
18959,166,175,18952,7,18959,0,5.97787e+18,165.731,1629.9,18959,148,157,18729,18516,17940,17917,17941
19476,2003,4691,18346,1130,18346,1130,3.22417e+18,97.388,6464.78,19476,2256,110,14785,14785,11280,13330,6963
12725,924,3057,11985,740,11985,740,5.90396e+18,97.0569,4348.88,12725,1465,110,9668,9668,9147,8831,3595
2988,145,208,2988,0,2988,0,6.01927e+18,144.952,709.119,2988,85,81,2730,2580,2107,2116,1989
3311,797,938,0,3311,1175,2136,2.40773e+15,55.7076,1332.29,3311,436,62,2373,2373,2373,2373,2373
623,265,290,623,0,583,40,3.32462e+18,71.5634,392.377,623,97,35,333,333,329,329,333
49658,10012,26234,47875,1783,47875,1783,2.39093e+18,93.2264,28758,49658,12757,110,23424,23424,17597,20092,10341
16234,3207,5060,15374,860,15374,860,6.82259e+18,96.1903,6493.75,16234,2440,110,11174,11174,10108,9929,6110
11976,11876,11976,0,11976,0,11976,524244,0,11976,11976,11976,1,0,0,0,0,0
26205,6951,8675,9656,16549,0,26205,8.6205e+12,58.2539,10447.6,26205,4204,72,17530,17530,15776,17228,13787
26466,307,1111,0,26466,25700,766,4.04749e+16,223.253,3426.98,26466,168,26,25272,24854,19527,19667,11182
48537,1096,1541,0,48537,47138,1399,3.84628e+16,294.661,5277.27,48537,255,26,46996,46996,45813,45615,39654
14456,278,702,0,14456,14043,413,3.73198e+16,30.604,1875.91,14456,89,26,13754,13743,12375,12420,5586
42249,4249,17288,40349,1900,0,42249,1.72122e+18,95.0819,19941.2,42249,8398,110,24961,24961,16831,14993,7751
19860,6,14,19282,578,19785,75,1.65724e+14,10.4299,433.407,19860,13,12,18954,18327,14579,14020,10422
35419,10598,11303,0,35419,12982,22437,2.24656e+15,58.6665,13587.8,35419,5500,72,24116,24116,23842,23449,23583
38969,7,14,37842,1127,38941,28,1.57954e+14,10.3271,591.614,38969,13,12,37778,36942,33709,31698,27081
48125,2969,11220,0,48125,16919,31206,2.5313e+15,60.0749,14454.3,48125,5463,72,36905,36905,24881,20216,10175
20918,237,5217,0,20918,7409,13509,2.49425e+15,59.6979,6834.9,20918,2541,72,15701,15653,9052,3328,1030
44516,12,13,43246,1270,44489,27,1.40889e+14,10.328,605.822,44516,12,12,44503,44503,44310,44311,44020
36512,32,176,36492,20,36512,0,6.02489e+18,173.109,2333.35,36512,169,167,19189,5441,6095,7051,6591
37593,4508,8865,35413,2180,0,37593,2.22177e+18,97.7634,11830.3,37593,4287,110,28728,28728,22825,21691,15617
49021,11120,11462,0,49021,0,49021,6.47899e+17,97.8982,15127.1,49021,5561,110,37559,37559,37181,37276,36852
39193,11351,12157,0,39193,0,39193,5.85045e+17,96.6503,14979.4,39193,5903,110,27036,27036,26119,24806,24951
2711,126,705,2551,160,0,2711,2.24638e+18,93.1807,1118.59,2711,324,65,2006,1024,1232,1155,593
22426,5301,5871,0,22426,0,22426,6.25404e+17,96.2476,7807.94,22426,2818,110,16555,16555,16192,16333,15862
1621,17,170,1616,5,1621,0,6.09391e+18,99.1666,491.055,1621,63,57,597,145,177,188,214
45873,10636,15962,0,45873,0,45873,5.50824e+17,94.9455,19023.3,45873,7735,110,29911,29911,25127,21049,19721
12142,2749,2903,0,12142,4268,7874,2.50688e+15,59.6225,3979.62,12142,1400,72,9239,9239,9081,9060,8945
30663,11663,14716,29436,1227,29436,1227,2.96396e+18,89.9873,16564.5,30663,7071,111,15947,15947,13441,14242,13694
31414,8481,9871,29764,1650,29764,1650,3.60107e+18,97.0654,12192.7,31414,4699,111,21543,21543,20110,21441,17783
28328,1408,6582,9950,18378,0,28328,9.89309e+12,60.0172,8687.17,28328,3195,72,21746,21746,10648,18754,5026
970,194,329,917,53,0,970,2.20383e+18,81.9722,508.133,970,132,42,641,641,501,541,503
6000,119,267,5750,250,1750,4250,1.26502e+18,16.9437,556.566,6000,261,18,5733,5733,4999,5145,3467
10965,1939,2600,10325,640,10325,640,5.84002e+18,96.8591,3758.11,10965,1239,110,8365,8365,8205,8205,6744
17964,1815,6501,0,17964,6725,11239,2.11386e+15,57.843,7769.03,17964,3167,72,11463,11463,7370,2983,2038
46818,41,176,46793,25,46818,0,6.01154e+18,173.791,2622.65,46818,173,173,27609,9972,9373,11748,10635
22741,5,11,22082,659,22729,12,1.56092e+14,10.1194,435.977,22741,11,11,20992,18779,15751,15516,11676
42273,935,17703,42273,0,40255,2018,4.59785e+18,434.226,19734.9,42273,7676,141,24570,22982,12831,15983,2256
4956,625,1220,0,4956,0,4956,6.51328e+17,95.4459,1868.04,4956,572,86,3736,3736,2952,2065,2321
3662,7,11,3557,105,3661,1,1.37894e+14,10.6841,168.361,3662,11,11,3527,3463,3176,3197,2893
16821,3963,3992,15841,980,0,16821,2.22835e+18,97.3599,5585.86,16821,1920,110,12829,12829,12806,12805,12828
41759,13796,20461,0,41759,9161,32598,1.33688e+13,8.99167,20887.8,41759,18407,11,21298,21298,16007,21298,15372
3255,154,176,3255,0,3255,0,6.02016e+18,144.785,689.406,3255,87,83,3059,2989,2769,2787,2740
19877,5,11,19310,567,19871,6,1.38819e+14,10.2161,394.792,19877,11,11,18217,16173,16288,16652,11602
46734,2369,10937,44014,2720,44014,2720,3.3936e+18,97.8949,14463.7,46734,5300,110,35797,35797,18424,26236,9529
7948,163,2973,2983,4965,0,7948,8.12072e+12,56.2531,3651.42,7948,1426,72,4975,4879,2402,4049,631
16540,9,14,16053,487,16492,48,1.81887e+14,10.7302,427.349,16540,12,11,16351,16192,15570,14486,12785
10178,404,438,0,10178,9889,289,3.56607e+16,20.0105,1232.16,10178,65,26,9740,9740,9681,9685,9299
34233,9528,12313,34233,0,32353,1880,3.88998e+18,220.651,13829,34233,4421,133,21920,21917,20258,20727,16942
7649,9,11,7427,222,7646,3,1.60775e+14,10.0271,254.7,7649,11,11,7554,7461,7122,7121,6491
42829,586,10301,40337,2492,40337,2492,2.85241e+18,98.3161,13495.8,42829,4870,111,32528,32528,14514,18092,3881
24841,3,6,24407,434,24809,32,9.9838e+13,3.99658,362.394,24841,5,4,22757,20678,21577,21576,17035
42945,2392,42945,0,42945,0,42945,524276,0,42945,42945,42945,1,0,0,0,0,0
46076,1102,1414,0,46076,45371,705,2.46296e+16,3.73717,5434.35,46076,708,4,44662,44662,44631,44445,38958
5968,115,263,0,5968,5799,169,3.5401e+16,19.8918,756.318,5968,48,26,5705,5705,4770,4836,3132
42867,9253,14696,40727,2140,40727,2140,3.06649e+18,95.1856,17617.5,42867,7118,110,28171,28171,21154,23910,18592
33419,11,14,32460,959,33377,42,1.46444e+14,10.3947,536.511,33419,13,11,33405,33402,33085,33087,32995
19721,7196,8350,0,19721,7580,12141,1.909e+15,56.9172,9610.85,19721,4067,72,11371,11371,10585,9669,9434
22628,3198,8310,21528,1100,21528,1100,4.22047e+18,95.8277,10016.3,22628,3951,111,14318,14318,7565,8942,5009
42003,865,1515,0,42003,40788,1215,4.02139e+16,289.469,5030.4,42003,249,26,40488,40488,36812,37518,29533
34606,135,176,34525,81,34606,0,5.98497e+18,169.639,2203.4,34606,165,171,33295,31183,26138,26825,26678
44885,10140,12230,42405,2480,0,44885,2.11525e+18,97.265,15510.9,44885,5934,110,32655,32655,29869,29385,26712
38652,128,176,38572,80,38652,0,5.98165e+18,169.732,2328.11,38652,170,170,36816,34168,28131,28376,28208
34893,11,15,33867,1026,34802,91,1.74953e+14,10.3836,639.559,34893,14,12,34875,34866,33873,33564,30729
11508,402,744,0,11508,0,11508,3.75093e+18,15.9712,1135.07,11508,479,18,10764,10764,7672,8225,7111
41506,12591,24025,40176,1330,40176,1330,1.08091e+19,89.7405,26044,41506,11663,110,17481,17481,16182,15823,9760
18549,11,14,18010,539,18475,74,1.59425e+14,10.558,432.586,18549,13,12,18532,18523,17861,17854,16873
26723,4307,8739,25353,1370,0,26723,1.96166e+18,96.2378,10800,26723,4239,110,17984,17984,13912,13125,9303
30641,325,952,0,30641,29767,874,3.54726e+16,186.109,3077.62,30641,139,26,29681,29381,26053,26277,14472
6683,6,11,6484,199,6676,7,1.90711e+14,9.58522,241.525,6683,11,11,6413,6214,5815,4790,4772
17656,2283,4176,16626,1030,0,17656,2.2299e+18,97.4463,5832.02,17656,2011,110,13480,13480,10888,10444,7917
6551,633,2900,2538,4013,0,6551,7.25973e+12,55.3363,3441.01,6551,1403,72,3651,3555,2310,3063,1156
40457,1479,15720,40457,0,32211,8246,4.07027e+18,283.399,17402.9,40457,6347,132,24737,24205,11538,16862,3144
14610,829,3459,5138,9472,0,14610,9.88159e+12,59.753,4699.43,14610,1676,72,11151,11151,5789,9709,2917
9851,286,2409,9281,570,9281,570,5.79703e+18,96.6559,3473.21,9851,1141,110,7442,7442,5763,4612,1395
41375,614,1161,0,41375,40195,1180,3.55943e+16,243.307,3974.09,41375,180,26,40214,39655,33785,34695,26572
5286,48,1312,4976,310,4976,310,5.83916e+18,95.4673,1986.16,5286,612,87,2291,484,1330,1873,498
21087,4688,4979,0,21087,0,21087,6.47962e+17,97.4991,6872,21087,2403,110,16108,16108,15798,15800,15563
34309,4498,13308,34309,0,32516,1793,5.13318e+18,273.558,14834.4,34309,5353,131,21001,20859,14290,17502,8547
30951,9773,11248,30951,0,29259,1692,3.65312e+18,203.199,12658.2,30951,4367,128,19703,19703,18477,18967,17239
40983,5806,19207,39326,1657,0,40983,1.54899e+18,93.4175,21593.5,40983,9330,110,21776,21776,14766,13285,7484
37327,11864,12597,0,37327,0,37327,5.60627e+17,94.6923,15235.8,37327,6101,110,24730,24730,24661,24660,24685
46728,10812,10926,0,46728,0,46728,6.47928e+17,97.9105,14456.4,46728,5300,110,35802,35802,35675,35682,35698
41038,3873,9581,38645,2393,38645,2393,5.7557e+18,97.8471,12761.6,41038,4644,110,31457,31457,27998,27436,14043
29557,2547,6865,0,29557,10375,19182,2.53516e+15,60.0181,9040.32,29557,3340,72,22692,22692,16396,8456,8779
42004,2398,10447,39604,2400,39604,2400,3.35663e+18,97.6571,13639,42004,5070,110,31557,31557,15886,22830,8032
49668,59,176,49585,83,49668,0,6.00685e+18,171.875,2687.72,49668,173,172,34691,18716,14470,16997,16805
32476,2066,15249,23833,8643,31156,1320,3.52654e+18,89.214,17209.7,32476,7324,111,17227,17227,7713,10316,4715
46413,3560,15709,44076,2337,0,46413,1.92571e+18,96.2384,18828.7,46413,7632,110,30704,30704,19990,17866,7164
48195,12860,18933,48195,0,46002,2193,4.91013e+18,2198.32,22085,48195,7976,152,29262,27184,24548,26115,20006
35191,11233,12243,0,35191,13076,22115,2.154e+15,58.2077,14436.9,35191,5960,72,22948,22948,21460,21023,19815
46499,4890,24538,18761,27738,0,46499,6.10001e+12,54.9965,26655.9,46499,11938,72,21961,21961,15127,19453,7379
25818,9,11,25082,736,25804,14,1.39048e+14,10.1591,450.431,25818,11,11,25497,25146,21280,21392,22554
42747,5629,10031,0,42747,0,42747,6.46867e+17,97.8524,13315.5,42747,4863,110,32716,32716,26741,21172,19444
23226,715,8134,22066,1160,22066,1160,5.25965e+18,96.3489,9905.08,23226,3885,111,15092,14918,6546,9371,3257
1587,73,82,0,1587,1543,44,3.54613e+16,18.5217,245.384,1587,28,26,1505,1505,1491,1489,1472
34459,4905,13133,32829,1630,32829,1630,3.40188e+18,96.0407,15437.5,34459,6292,111,21326,21326,12853,14202,9282
36088,5390,13834,36088,0,34248,1840,4.59197e+18,352.346,15695.3,36088,5987,132,22254,21982,16284,18811,10733
31133,2214,7500,29319,1814,29319,1814,5.48373e+18,98.1896,9989.82,31133,3546,111,23633,23633,12266,14854,8142
22565,5384,6948,21375,1190,21375,1190,3.18816e+18,96.4568,8800.59,22565,3363,110,15617,15617,12892,14044,12004
16419,2641,3904,0,16419,0,16419,6.47437e+17,97.3229,5469.55,16419,1878,110,12515,12515,10803,8956,8974
46404,10215,10830,0,46404,16314,30090,2.52915e+15,60.0637,13967.9,46404,5272,72,35574,35574,34923,34058,34019
2142,294,542,751,1391,0,2142,1.03047e+13,57.4935,834.905,2142,263,56,1600,1600,1303,1533,989
1888,467,533,1778,110,1778,110,3.43495e+18,90.3337,842.291,1888,229,57,1355,1355,1272,1313,1321
33674,689,1204,0,33674,32703,971,3.87443e+16,249.811,3895.97,33674,190,26,32470,32026,30624,30367,22972
3200,794,1763,3083,117,0,3200,1.38829e+18,89.1175,2088.08,3200,834,67,1437,1351,1304,1209,1365
36027,1434,11726,0,36027,0,36027,5.70566e+17,96.3492,14324,36027,5682,110,24301,24301,13123,5527,4476
25480,23,61,25416,64,25480,0,2.32973e+18,60.7182,1188.27,25480,61,61,15338,2621,6872,7794,9529
29738,7462,9841,28210,1528,28210,1528,4.75981e+18,95.7392,12025.9,29738,4698,111,19897,19897,19897,19897,16680
12970,10,12,12589,381,12959,11,1.8527e+14,10.2119,340.201,12970,12,11,12933,12896,12662,12663,12134
19175,5,15,18597,578,19118,57,1.99902e+14,10.5078,474.323,19175,13,11,17820,16413,15533,9916,8050
26102,2034,6114,24582,1520,0,26102,2.22986e+18,97.6468,8349.07,26102,2954,110,19988,19988,14448,13442,7720
13320,193,3108,4670,8650,0,13320,9.88257e+12,59.6934,4267.64,13320,1502,72,10212,10212,5919,9472,771
43081,3958,10300,40571,2510,40571,2510,5.48097e+18,98.333,13514.4,43081,4871,111,32781,32781,18528,22720,14067
32813,118,176,32728,85,32813,0,6.05134e+18,172.508,2227.82,32813,167,165,30658,27748,21318,21908,21955
4895,105,208,4894,1,4708,187,6.0019e+18,166.644,917.37,4895,98,97,4308,3086,2537,2620,2665
23145,413,907,0,23145,22482,663,3.77302e+16,159.109,2737.47,23145,130,26,22238,21982,18650,19003,14386
19525,7481,7921,18638,887,18638,887,8.36651e+18,94.7808,9399.3,19525,3840,110,11604,11604,11494,11494,10605
4411,1786,2247,0,4411,0,4411,4.29013e+17,90.827,2683.73,4411,1070,75,2164,2164,1959,1912,1880
12145,3489,3888,0,12145,4447,7698,2.2555e+15,58.3597,4872.6,12145,1890,72,8257,8257,8045,7979,7877
6293,1093,3342,6063,230,6063,230,9.94321e+18,90.7478,3890.38,6293,1606,85,2951,2951,2615,2562,1656
31859,336,1319,0,31859,30928,931,4.15487e+16,265.661,4183.87,31859,213,26,30434,29794,23234,23908,12234
11916,4449,6753,11916,0,0,11916,8.969e+17,17.9405,7031.29,11916,6069,20,5163,5163,3419,3645,3383
11562,5161,6492,0,11562,4724,6838,1.46661e+15,52.8845,7176.37,11562,3145,72,5070,5070,4540,3999,4138
610,64,276,610,0,570,40,4.00392e+18,72.2148,378.463,610,92,37,267,74,142,226,145
23587,4904,5528,22207,1380,22207,1380,3.34643e+18,97.6462,7591.31,23587,2669,110,18059,18059,16843,17399,16513
27161,2,11,26386,775,27149,12,1.38629e+14,10.169,460.815,27161,11,11,15723,11129,10876,11465,8921
35307,1473,8952,12536,22771,0,35307,9.62124e+12,59.7196,11409.4,35307,4354,72,26355,26355,11866,22234,5286
44036,1,16,42737,1299,43933,103,1.7914e+14,10.3873,732.287,44036,13,13,7921,7921,7921,7921,7921
12203,5,13,11849,354,12137,66,1.57864e+14,10.6176,344.465,12203,12,12,11278,10271,8522,8366,7021
1239,23,381,0,1239,0,1239,6.73597e+17,86.5472,601.873,1239,163,49,348,28,77,41,108
7636,2361,3693,3020,4616,0,7636,6.76547e+12,54.4946,4260.67,7636,1799,72,3943,3943,3379,3846,2964
21168,1146,8571,20198,970,20198,970,3.69278e+18,95.501,10119.9,21168,4110,111,12597,12597,8343,7732,3069
1300,95,347,465,835,0,1300,1.02319e+13,56.1215,550.09,1300,165,47,953,877,591,884,330
20026,363,760,0,20026,19455,571,3.55359e+16,83.5732,2207.99,20026,101,26,19266,19189,17756,17884,11317
7279,1440,2756,7279,0,6889,390,6.01072e+18,93.2768,3359.12,7279,1090,104,4523,4523,3539,4119,2158
45967,5324,10760,0,45967,0,45967,6.47561e+17,97.8953,14242.8,45967,5219,110,35207,35207,29143,27090,18899
3400,593,1505,0,3400,0,3400,4.911e+17,90.9588,1902.21,3400,709,73,1895,1809,1636,1537,1644
28356,904,1131,0,28356,27537,819,3.98533e+16,244.861,3535.01,28356,175,26,27225,27225,26624,26664,24430
47187,21,176,47109,78,47187,0,5.98205e+18,169.885,2571.09,47187,171,171,19143,3257,5081,5892,5539
20288,2378,20288,0,20288,20288,0,2047.9,0,20288,20288,20288,1,0,0,0,0,0
46473,1116,10884,43771,2702,0,46473,2.22645e+18,97.8746,14396.5,46473,5278,110,35589,35589,22335,20024,5729
17329,123,176,17291,38,17329,0,5.98928e+18,169.517,1563.98,17329,152,149,16289,14895,12028,12104,12071
18012,3302,6863,17162,850,0,18012,1.80983e+18,94.5181,8301.24,18012,3310,110,11149,11149,8488,7880,5658
46083,60,61,45987,96,46083,0,2.33059e+18,60.8499,1598.39,46083,61,61,45892,44906,45567,45568,45260
17798,770,7654,16630,1168,12164,5634,3.65025e+18,146.993,8595.72,17798,3128,124,10144,9835,4904,7065,2002
46338,679,1948,44408,1930,13515,32823,1.26468e+18,16.9921,2782.95,46338,1942,18,44390,44390,38053,39319,24194
47752,3,61,47656,96,47752,0,2.33259e+18,60.859,1627.41,47752,61,61,4629,161,3,176,1502
37702,9,12,36625,1077,37684,18,1.39162e+14,10.2678,551.038,37702,12,11,37218,36694,29393,29608,31407
26059,9,12,25313,746,26044,15,1.4502e+14,10.1847,461.293,26059,12,11,25742,25390,24296,24297,20350
17442,8112,8806,16772,670,16772,670,3.89102e+18,93.8241,9976.86,17442,4229,111,8636,8636,7555,7755,7530
13975,14,593,0,13975,13578,397,3.5557e+16,20.0774,1641.75,13975,79,26,12774,12057,8120,8088,2224
25814,4499,6051,24312,1502,24312,1502,3.36794e+18,97.6264,8266.91,25814,2925,110,19763,19763,16659,18094,15311
4705,152,476,0,4705,4565,140,4.95597e+16,17.4944,1095.67,4705,64,26,4229,4229,3684,3476,1528
16106,513,3769,15166,940,15166,940,3.39957e+18,97.3519,5320.07,16106,1810,110,12337,12337,5735,8774,2445
15522,301,654,0,15522,15080,442,3.55878e+16,20.1429,1809.68,15522,83,26,14868,14868,12733,12880,8302
38911,20574,36363,0,38911,0,38911,6.03907e+17,3.99445,36460,38911,12145,9,2548,2548,1440,1440,1447
7983,2732,2913,2979,5004,0,7983,8.22719e+12,57.3435,3596.17,7983,1409,72,5070,5070,4882,5030,4705
46315,5129,10792,0,46315,16288,30027,2.53397e+15,60.0837,13925.3,46315,5257,72,35523,35523,27334,17018,17385
13437,2184,3218,12657,780,12657,780,3.3551e+18,97.1644,4565.25,13437,1549,110,10219,10219,8180,9124,7439
30393,504,961,0,30393,29526,867,3.57123e+16,189.284,3096.13,30393,140,26,29432,29113,27358,27406,19899
35750,17943,21492,34656,1094,34656,1094,8.53435e+18,92.7046,23190.6,35750,10391,111,14258,14258,14258,14258,12547
8832,837,2528,3175,5657,0,8832,9.29476e+12,58.7379,3331.44,8832,1227,72,6304,6304,4508,5994,2549
2245,96,170,2243,2,2245,0,5.98415e+18,135.343,557.674,2245,74,71,1900,1207,1200,1250,1254
22016,670,5174,20728,1288,0,22016,2.23285e+18,97.5884,7129.63,22016,2502,110,16842,16842,6831,6109,3246
8142,1060,2405,7701,441,0,8142,2.08118e+18,95.5512,3284.47,8142,1144,104,5737,5737,4662,4412,3819
20670,341,6788,0,20670,0,20670,5.7082e+17,86.5098,8481.52,20670,3282,110,13882,13882,8155,2665,0
12980,8,11,12597,383,12971,9,1.82048e+14,10.0797,336.391,12980,11,11,12758,12642,12248,12046,10863
708,27,48,0,708,688,20,3.52146e+16,17.2119,135.15,708,20,22,660,654,595,602,433
31584,8181,13678,30214,1370,30214,1370,7.06434e+18,94.606,15726.7,31584,6638,110,17906,17906,17814,17061,11541
40019,9581,13036,37949,2070,37949,2070,1.94291e+18,96.9984,15796.5,40019,6230,111,26983,26983,24628,26822,20885
27695,4300,8032,0,27695,0,27695,6.01868e+17,96.8326,10237.6,27695,3889,110,19663,19663,16722,13936,11989
14429,60,176,14419,10,14429,0,6.06812e+18,167.842,1485.41,14429,137,138,10482,6460,4644,5053,4937
11570,730,2757,4073,7497,0,11570,9.92077e+12,59.7086,3790.53,11570,1343,72,8813,8813,4686,7711,2486
25385,389,861,0,25385,24661,724,3.55988e+16,149.628,2661.66,25385,121,26,24524,24325,22288,22382,15210
34287,7577,16622,13568,20719,0,34287,6.63813e+12,55.9678,18405.2,34287,8075,72,17665,17665,14143,16858,8836
26406,2323,14049,26406,0,25425,981,5.02e+18,418.217,15463.8,26406,4576,134,12357,11526,7714,8711,3349
49806,1968,2411,0,49806,48322,1484,4.79878e+16,335.415,7856.78,49806,431,26,47395,47395,46796,46930,42925
35329,2028,9709,0,35329,0,35329,6.1438e+17,97.175,12417.2,35329,4711,110,25620,25620,17227,9202,7139
2207,72,110,0,2207,2142,65,3.54574e+16,19.1246,325.157,2207,32,26,2097,2097,1906,1930,1690
42580,8270,13572,42580,0,40095,2485,4.90603e+18,300.116,15388.6,42580,3868,133,29008,28845,25112,27564,19032
20285,4088,9254,19435,850,19435,850,3.15624e+18,69.9655,10658.9,20285,4423,111,11031,11031,4467,5614,0
30648,7844,9412,30648,0,28866,1782,5.40507e+18,200.79,11062.4,30648,3158,130,21236,21212,20490,21185,18425
14107,471,901,14107,0,13533,574,3.26463e+18,17.9329,1360.64,14107,591,29,13206,13206,13034,12895,8935
23978,794,833,0,23978,23296,682,3.54999e+16,133.062,2536.78,23978,115,26,23145,23145,23039,23029,22540
4124,1191,1852,3944,180,3944,180,8.71741e+18,73.5218,2303.34,4124,868,68,2272,2272,2272,2272,2272
6236,1158,2385,5936,300,5936,300,2.98069e+18,89.5136,3046.79,6236,1119,93,3851,3851,1768,2599,1372
16477,2321,5323,0,16477,6048,10429,2.24305e+15,58.443,6565.02,16477,2586,72,11154,11154,8328,6167,5714
26231,76,176,26212,19,26231,0,6.05091e+18,170.055,1993.43,26231,156,161,21198,13657,10810,11634,11396
46541,84,176,46442,99,46541,0,6.11494e+18,173.484,2671.63,46541,169,170,39220,27811,21506,22115,22160
24568,214,1069,0,24568,23854,714,4.07069e+16,212.047,3249.47,24568,162,26,23323,23051,20198,18906,9128
32388,12607,13278,32388,0,30799,1589,4.07855e+18,269.805,14905.3,32388,5237,133,19110,19110,19108,19110,19042
30776,6945,8711,29096,1680,29096,1680,6.62105e+18,96.9523,11121.8,30776,4222,110,22065,22065,21639,21642,17201
9412,2212,2268,0,9412,3305,6107,2.51776e+15,59.5147,3152.77,9412,1101,72,7144,7144,7094,7089,7086
46961,6743,15095,17241,29720,0,46961,8.75256e+12,58.6796,17962.2,46961,7353,72,31866,31866,25010,30274,15343
28281,104,969,0,28281,27471,810,3.67384e+16,184.79,3069.84,28281,139,26,27061,26972,22352,21837,6835
18165,591,6007,18165,0,17105,1060,3.14819e+18,141.626,7028.46,18165,2173,123,12158,12082,5744,8017,1703
29216,5647,11351,27846,1370,27846,1370,4.26766e+18,94.2952,13367.3,29216,5422,111,17865,17865,12787,13800,11154
8667,78,175,8665,2,8667,0,5.9847e+18,161.298,1105.18,8667,121,124,6858,3893,3501,3883,3989
18202,65,175,18192,10,18202,0,5.97252e+18,165.894,1597.49,18202,153,151,13151,7164,5927,7013,6782
2355,249,589,0,2355,831,1524,2.58455e+15,57.8866,906.663,2355,280,58,1766,1766,1261,1185,868
22335,3166,7780,21215,1120,21215,1120,2.97868e+18,96.3815,9503.56,22335,3711,111,14555,14555,8841,9932,6208
19941,1188,6254,18883,1058,18883,1058,3.84606e+18,95.9466,7897.48,19941,2976,111,13687,13687,5624,8328,1621
38441,44,176,38353,88,38441,0,6.02126e+18,172.551,2391.07,38441,168,170,23549,9728,8272,9914,9506
47406,10377,18621,45216,2190,45216,2190,8.23772e+18,95.2692,21587.8,47406,9036,110,28785,28785,27985,27985,19339
42745,6454,16709,16226,26519,0,42745,7.86417e+12,57.5038,19139.7,42745,8134,72,26036,26036,19151,24346,12494
20945,3317,6890,0,20945,0,20945,5.70407e+17,96.0583,8593.9,20945,3337,110,14055,14055,11069,7125,7889
18643,1288,4418,17561,1082,17561,1082,5.7571e+18,97.3677,6142.26,18643,2121,110,14225,14225,12303,11443,4773
35342,2723,8275,0,35342,0,35342,6.48797e+17,97.8061,11102.6,35342,4006,110,27067,27067,19568,10971,10366
17209,187,1166,0,17209,16693,516,5.05354e+16,259.902,3304.88,17209,181,26,15801,15437,10067,11131,3936
39465,2646,13609,14644,24821,0,39465,8.44968e+12,58.2714,16025.5,39465,6625,72,25856,25856,15838,24136,3756
5103,91,208,5099,4,5103,0,6.04928e+18,166.563,932.045,5103,102,101,4289,2817,2176,2328,2265
48307,13447,21462,46267,2040,0,48307,1.61745e+18,93.546,24275.4,48307,10416,110,26845,26845,21822,20847,16222
31843,5390,9450,30142,1701,30142,1701,3.05492e+18,96.7276,11891,31843,4567,110,22393,22393,19210,21516,13687
14852,3834,8626,0,14852,3175,11677,1.37429e+13,8.84298,8844.83,14852,7757,11,6226,6226,3533,6226,3451
46813,123,206,46733,80,46813,0,5.98118e+18,186.664,2644.19,46813,184,177,43867,40424,27787,29311,29283
28790,6197,12005,0,28790,11055,17735,1.93311e+15,57.0913,13712.2,28790,5848,72,16785,16785,13294,9377,9229
15363,3326,4780,14553,810,0,15363,2.01654e+18,96.039,6158.68,15363,2301,110,10583,10583,9563,9313,8923
43065,195,208,43003,62,43065,0,6.0121e+18,203.824,2661.75,43065,186,180,42773,42657,40495,40381,40105
22836,5512,6482,8220,14616,0,22836,9.22302e+12,59.1375,8159.3,22836,3147,72,16354,16354,15979,16274,15548
32675,5,16,31716,959,32619,56,1.76405e+14,10.386,569.104,32675,14,12,30268,27418,23316,22788,14536
25338,8,13,24594,744,25316,22,1.69943e+14,10.2902,478.08,25338,12,12,24847,24550,22984,21953,17550
9087,2042,3816,0,9087,0,9087,5.02195e+17,93.8583,4642.21,9087,1840,107,5271,5271,4683,3892,4021
788,46,291,745,43,745,43,1.99324e+18,78.7398,438.775,788,118,41,292,59,91,164,87
36521,21,61,36425,96,36521,0,2.25327e+18,60.7401,1421.08,36521,61,61,20336,2452,7659,10114,12456
8248,1401,2036,0,8248,0,8248,6.47761e+17,96.4274,2968.08,8248,967,107,6212,6212,5441,4789,4867
15151,4163,4597,5506,9645,0,15151,9.04269e+12,58.7497,5785.33,15151,2238,72,10554,10554,10030,10444,9341
46923,15010,19211,0,46923,17964,28959,1.94906e+15,57.0036,21770.4,46923,9349,72,27712,27712,25214,24591,21150
12653,4430,4483,12023,630,12023,630,2.55972e+18,93.4828,5611.84,12653,2135,111,8170,8170,8170,8170,8170
18557,2519,6110,18557,0,17476,1081,4.78953e+18,143.189,7144.84,18557,1200,126,12447,12368,9068,10441,5509
44928,12182,19566,0,44928,17394,27534,1.85983e+15,56.6112,21946.2,44928,9518,72,25362,25362,22008,21056,16472
14201,4044,8347,13751,450,0,14201,1.21491e+18,90.5593,9243.85,14201,4025,110,5854,5854,4647,3947,2980
517,163,183,0,517,182,335,2.52334e+15,47.1064,275.402,517,78,31,334,334,334,334,334
45485,20739,22293,0,45485,0,45485,3.42246e+15,17.9835,22914.8,45485,20047,20,23192,23192,21741,21816,21652
46615,14,16,45269,1346,46523,92,1.54985e+14,10.4435,671.943,46615,14,13,46599,46599,46172,46173,45412
5827,2769,3903,5677,150,5677,150,1.19386e+19,88.8704,4305.87,5827,1874,74,1924,1924,1780,1756,1512
26035,4252,6121,0,26035,9151,16884,2.52739e+15,59.944,8078.72,26035,2977,72,19914,19914,17262,15660,14179
48873,1101,1291,0,48873,47480,1393,3.5512e+16,261.723,4552.52,48873,207,26,47582,47582,46990,46974,43590
5090,2506,2753,0,5090,0,5090,3.47504e+15,17.8517,2937.82,5090,2462,20,2337,2337,2178,2337,2211
25622,758,1035,0,25622,24881,741,3.93052e+16,219.326,3180.26,25622,152,26,24587,24587,23960,23786,20890
12528,13,14,12159,369,12455,73,1.76349e+14,10.4206,361.078,12528,12,12,12514,12514,12514,12514,12415
5413,130,1560,0,5413,1942,3471,2.40952e+15,58.4314,2117.3,5413,759,72,3853,3760,1578,807,474
38086,7,176,37991,95,38086,0,6.09198e+18,173.15,2414.59,38086,171,167,7352,937,1285,989,1303
31134,485,7319,0,31134,0,31134,6.48306e+17,97.7172,9875.24,31134,3542,110,23815,23815,7984,2410,3065
17386,10494,11271,3759,13627,0,17386,2.23456e+13,5.5134,12952.3,17386,3759,13,6115,6115,6010,6010,5758
2946,334,791,2776,170,2776,170,2.64563e+18,93.5642,1224.38,2946,349,70,2155,2155,1546,1893,1164
37454,2540,16260,35844,1610,0,37454,1.64833e+18,93.4669,18599.8,37454,7888,110,21194,21194,13114,11337,4156
31202,4460,11566,31202,0,29512,1690,4.5861e+18,214.575,12981.5,31202,4537,126,19636,19571,13490,16338,9309
2259,23,71,0,2259,2189,70,0.0309872,0.96857,400.383,2259,71,1,2188,2188,2188,2188,2188
45255,11119,11962,16168,29087,0,45255,9.48904e+12,59.5906,14934.2,45255,5827,72,33293,33293,32259,33074,30718
24876,138,853,0,24876,24167,709,3.56175e+16,145.615,2622.61,24876,119,26,23947,23834,16668,16612,7847
8514,994,2066,3005,5509,0,8514,9.77566e+12,59.3915,2887.29,8514,992,72,6448,6448,5011,6198,3412
15276,14,176,15268,8,15276,0,6.00555e+18,167.579,1500.63,15276,142,147,4830,820,1078,1187,1127
19997,103,176,19944,53,19997,0,6.11774e+18,170.023,1750.79,19997,138,145,18268,13979,11276,11542,11639
18075,10,11,17560,515,18067,8,1.38845e+14,10.1135,375.378,18075,11,11,18042,18004,17973,17974,17841
15015,709,6034,14325,690,14325,690,8.29154e+18,92.4815,7255.26,15015,2904,110,8981,8742,3431,7333,1147
2412,588,651,2271,141,2271,141,5.68422e+18,92.0518,1024.63,2412,289,62,1761,1761,1727,1731,1733
35044,7496,10739,35044,0,33004,2040,4.33094e+18,247.243,12568.1,35044,4180,125,24305,24229,20960,22481,17837
17835,6280,7803,17065,770,17065,770,2.48464e+18,94.8181,9113.2,17835,3733,111,10032,10032,9413,9992,8804
32068,88,176,32013,55,32068,0,6.08593e+18,172.358,2216,32068,159,163,27700,19355,15614,15834,16226
15048,3198,4090,0,15048,0,15048,6.21333e+17,96.7721,5506.43,15048,1973,110,10958,10958,10179,9190,9694
33727,10963,12359,32097,1630,32097,1630,2.92087e+18,95.679,14707.9,33727,5995,110,21368,21368,20070,21030,18271
2859,35,1288,1097,1762,0,2859,7.32728e+12,54.937,1579.88,2859,623,65,1165,230,398,806,98
12900,3391,5557,12339,561,0,12900,1.67176e+18,87.9091,6612.77,12900,2667,110,7343,7343,6004,5499,4079
8820,2230,3362,8400,420,8400,420,2.82325e+18,87.9961,4214.53,8820,1596,109,5458,5458,4481,5189,3079
34840,622,1156,0,34840,33842,998,3.75428e+16,240.076,3791.34,34840,180,26,33684,33130,29006,29676,22999
6101,1226,1462,2140,3961,0,6101,9.83736e+12,59.0874,2103.26,6101,701,72,4639,4639,4326,4584,4097
3066,1085,1695,2956,110,0,3066,1.37962e+18,88.9563,2011.73,3066,800,66,1371,1371,1283,1269,1364
33913,19714,33913,33913,0,0,33913,134214000,0,33913,33913,33913,1,0,0,0,0,0
9119,2618,3069,0,9119,3368,5751,2.22496e+15,58.0242,3845.84,9119,1494,72,6050,6050,5718,5314,5546
17501,3356,5233,16563,938,0,17501,2.04994e+18,95.3115,6774.46,17501,2525,110,12268,12268,10617,9907,8128
1931,108,170,1931,0,1931,0,5.94522e+18,130.197,516.813,1931,70,65,1670,1188,1132,1162,1205
28539,4795,10829,27190,1349,0,28539,1.81029e+18,95.3883,12863.1,28539,5253,110,17710,17710,14079,12451,8708
40340,8972,19476,38740,1600,38740,1600,2.15703e+18,94.6064,21743.8,40340,9393,111,20864,20864,17062,18249,11136
43649,15148,18594,43649,0,42239,1410,5.21777e+18,4400.88,23384.8,43649,7872,152,25055,19703,21889,22740,20146
7368,2198,2564,7368,0,6946,422,5.21783e+18,91.5106,3147.44,7368,911,107,4804,4804,4598,4728,4437
31815,11,14,30892,923,31730,85,1.59463e+14,10.5277,577.757,31815,13,12,31799,31793,30238,30257,30169
6992,193,1702,6584,408,6584,408,5.71576e+18,96.1279,2531.16,6992,804,97,5290,5290,4023,3171,1011
29756,23,176,29674,82,29756,0,6.03407e+18,171.99,2111.52,29756,165,163,12960,2784,3679,3970,3834
31944,863,7699,30086,1858,30086,1858,5.05157e+18,98.1952,10240.8,31944,3635,111,24245,24245,13839,17609,4255
16888,45,61,16856,32,16888,0,2.27178e+18,60.5755,961.528,16888,61,61,15553,9643,12828,12980,12346
8840,420,2613,8360,480,0,8840,2.07381e+18,95.8359,3548.52,8840,1254,105,6227,6141,4103,3673,1813
29193,4297,6818,27493,1700,27493,1700,3.22973e+18,97.7372,9258.47,29193,3301,110,22375,22375,19829,21611,14878
15690,89,175,15683,7,15690,0,5.98748e+18,165.333,1483.68,15690,141,150,13385,8016,7419,7888,8013
19782,3,13,19215,567,19708,74,1.48464e+14,10.7953,439.432,19782,12,12,15235,10961,12188,12256,7279
42194,2010,11094,39833,2361,39833,2361,6.17848e+18,96.7973,14251,42194,5372,110,31100,31100,26442,22676,8049
26384,6669,8944,26384,0,24916,1468,3.39022e+18,188.564,10403.6,26384,3606,124,17440,17414,15649,16182,12897
31729,8171,14150,30389,1340,30389,1340,2.73515e+18,92.4365,16176.3,31729,6851,110,17579,17579,11784,13957,10016
3322,753,1645,3322,0,3322,0,2.33911e+18,17.8092,1799.9,3322,1469,20,1677,1677,807,1677,824
1024,370,716,1024,0,630,394,3.81913e+18,79.4414,812.877,1024,300,43,308,215,165,261,294
36531,2902,11203,34604,1927,34604,1927,6.80357e+18,96.6551,13887.8,36531,5434,110,25328,25328,21985,21429,8516
24226,7259,7949,24226,0,22818,1408,5.08733e+18,164.359,9174.12,24226,1762,128,16277,16277,16238,16277,15308
25813,150,986,0,25813,25069,744,3.81294e+16,200.143,3043.7,25813,145,26,24604,24462,20963,19597,8007
26463,65,176,26455,8,26463,0,5.98349e+18,169.619,1928.69,26463,160,163,19124,10424,8560,10087,9745
43757,8071,16368,41671,2086,41671,2086,2.88955e+18,95.654,19218.1,43757,7948,110,27389,27389,21857,25274,11545
7662,312,527,0,7662,7437,225,4.2123e+16,19.7255,1317.22,7662,73,26,7135,7135,6805,6743,4923
43032,3120,12807,40722,2310,40722,2310,4.88406e+18,97.4157,15826.3,43032,6102,111,30225,30225,15695,19702,9324
49867,8454,24640,47932,1935,47932,1935,4.3064e+18,94.3527,27259.6,49867,11885,111,25227,25227,18353,20543,10535
18908,1600,9283,18908,0,18908,0,2.35176e+18,17.9589,9677.39,18908,8338,20,9625,9625,2002,9625,1696
12709,3217,12709,12709,0,12709,0,3.4357e+10,0,12709,12709,12709,1,0,0,0,0,0
31205,13285,14405,31205,0,29785,1420,4.94371e+18,288.681,15795.1,31205,3228,134,16800,16790,16361,16780,15016
39128,11654,11873,39128,0,36848,2280,5.25366e+18,278.429,13863.6,39128,4629,132,27255,27255,27240,27255,27050
34036,7603,8180,32053,1983,32053,1983,4.52348e+18,98.2376,10849.5,34036,3869,111,25856,25856,25278,25814,24563
34547,2494,8061,0,34547,12147,22400,2.52979e+15,60.0148,10525.2,34547,3918,72,26486,26486,18406,14345,8629
32372,7092,11295,32372,0,30562,1810,5.19851e+18,224.971,12768.7,32372,4306,128,21077,21011,18316,19857,14236
32791,764,11848,12264,20527,0,32791,8.25295e+12,57.9893,13885.8,32791,5767,72,20943,20799,10637,16869,2243
47144,1092,13646,17041,30103,0,47144,9.15105e+12,59.1778,16636.9,47144,6636,72,33498,33498,15420,27432,3310
18431,1740,5574,0,18431,6703,11728,2.31189e+15,58.8401,6961.79,18431,2715,72,12857,12857,8487,5215,3108
42613,12956,14144,40445,2168,40445,2168,3.0229e+18,96.3111,17082,42613,6867,110,28469,28469,27386,28172,25898
4582,212,1209,4322,260,0,4582,2.19279e+18,94.7776,1811.32,4582,553,83,3373,3323,1372,1333,976
15341,2474,3620,0,15341,5400,9941,2.52259e+15,59.802,4913.84,15341,1750,72,11721,11721,10346,10019,8173
1008,34,59,0,1008,977,31,3.53854e+16,18.2579,172.729,1008,25,24,949,949,821,814,696
36396,7770,10021,34374,2022,34374,2022,6.54376e+18,97.7299,12732.6,36396,4754,111,26375,26375,21995,23101,20193
9878,1,12,9587,291,9870,8,1.66668e+14,10.3268,293.351,9878,12,11,2015,2015,2015,2015,2015
48399,4,15,47007,1392,48315,84,1.47388e+14,10.4204,679.57,48399,13,13,42118,37507,36638,31682,22755
2090,57,170,2090,0,2090,0,6.00457e+18,130.208,536.017,2090,74,71,1382,726,615,731,703
30217,646,9981,11141,19076,0,30217,8.65609e+12,58.4824,11964.5,30217,4862,72,20236,20071,12185,18850,2467
20953,19,176,20941,12,20953,0,6.01483e+18,171.402,1768.94,20953,154,154,8071,1531,2179,2095,2218
42207,9156,9871,0,42207,14833,27374,2.52738e+15,60.0524,12774,42207,4804,72,32336,32336,31472,30380,30186
34477,42,176,34460,17,34477,0,6.02521e+18,171.589,2265.08,34477,168,165,20681,7851,7253,8797,8504
35691,13238,13286,33983,1708,0,35691,1.82916e+18,95.6366,15723.9,35691,6454,110,22405,22405,22366,22368,22389
31142,725,12621,29732,1410,0,31142,1.73462e+18,94.8329,14728.2,31142,6124,110,18521,17987,8268,5231,2036
49115,424,1429,0,49115,47712,1403,3.70213e+16,274.999,4958.13,49115,234,26,47686,46807,37216,38035,22954
18729,3827,5945,18729,0,17084,1645,3.68815e+18,144.367,7075.74,18729,1918,125,12784,12783,11362,11745,8659
30216,15,61,30152,64,30216,0,2.26038e+18,60.7508,1293.29,30216,61,61,13224,1114,3132,4163,6856
46013,2700,19050,46013,0,41565,4448,4.5567e+18,1466.05,21693.9,46013,5080,143,26963,24496,13744,17339,7265
43954,9860,18234,41984,1970,41984,1970,3.65381e+18,95.5023,20899.4,43954,8768,111,25720,25720,17278,18982,14069
13581,4444,5414,0,13581,5169,8412,1.98508e+15,53.6422,6394.89,13581,2623,72,8167,8167,8020,7883,8031
48528,16044,23778,0,48528,0,48528,3.42637e+15,17.9844,24420.9,48528,21385,20,24750,24750,17077,17850,16756
23830,7149,11849,23830,0,22850,980,4.75864e+18,314.887,13138.2,23830,5444,129,11981,11777,9991,10931,8121
33371,5454,8812,31501,1870,31501,1870,3.34169e+18,97.2105,11431.6,33371,4266,110,24559,24559,17880,20912,14686
32346,6604,7787,30466,1880,30466,1880,2.20905e+18,98.1966,10358,32346,3680,111,24559,24559,24559,24457,21453
6586,1256,1876,6224,362,0,6586,2.11669e+18,90.7401,2640.48,6586,874,98,4710,4710,4366,4353,4199
25429,7595,11421,0,25429,9905,15524,1.82953e+15,56.5507,12900.6,25429,5564,72,14008,14008,12236,11757,9416
41046,4787,9638,38658,2388,38658,2388,5.90798e+18,97.8464,12817,41046,4677,110,31408,31408,30188,30188,16689
43738,8221,16572,41669,2069,41669,2069,8.03661e+18,95.585,19405.7,43738,8054,110,27166,27166,26246,26246,16252
10497,5545,5567,10117,380,0,10497,1.38712e+18,80.3157,6359.18,10497,2671,104,4930,4930,4930,4930,4930
24627,4049,7579,23327,1300,0,24627,2.01895e+18,88.2991,9558.2,24627,3668,110,17048,17048,12268,11397,6526
38794,8,12,37689,1105,38779,15,1.39083e+14,10.3574,560.851,38794,12,11,37890,37254,29365,29412,29876
39666,729,12652,37613,2053,0,39666,1.983e+18,96.2784,15477.3,39666,6135,110,27014,26673,12773,8460,3492
12691,5137,6895,12691,0,5811,6880,2.51935e+18,18.8565,7202.97,12691,3372,23,5796,5796,4622,4668,4353
3544,184,916,0,3544,0,3544,6.43914e+17,93.7937,1417.58,3544,417,74,2628,2628,1662,776,789
32795,12,61,32699,96,32795,0,2.33569e+18,60.7735,1347.93,32795,61,61,11975,849,1674,2395,6153
16222,3646,4246,0,16222,0,16222,6.30114e+17,96.9674,5757.59,16222,2048,110,11976,11976,11372,10919,10711
39376,4138,11350,14231,25145,0,39376,9.18757e+12,59.1882,13931.2,39376,5524,72,28026,28026,20195,26676,10715
7576,2785,3313,0,7576,2936,4640,1.89383e+15,54.1232,3915.83,7576,1607,72,4263,4263,3487,3001,2726
45868,9718,10751,43203,2665,0,45868,2.22594e+18,97.8622,14224.5,45868,5215,110,35117,35117,33729,33484,32323
46756,833,3151,14495,32261,14495,32261,2.21693e+18,15.9966,3958.14,46756,1871,26,43605,43605,30094,33858,21599
1315,41,396,1236,79,1236,79,5.84789e+18,87.4996,630.163,1315,174,48,496,93,223,354,228
33736,7744,10552,0,33736,12333,21403,2.2684e+15,58.2227,12769.1,33736,5122,72,23184,23184,20486,18093,17344
29052,10808,11200,10997,18055,0,29052,7.93154e+12,57.5892,12995.2,29052,5451,72,17852,17852,17754,17834,17782
34799,6,13,33795,1004,34772,27,1.53206e+14,10.2739,548.564,34799,12,12,33199,32305,29433,28742,20709
29871,1549,7029,0,29871,0,29871,6.48386e+17,97.6973,9504.98,29871,3403,110,22842,22842,11650,8501,6135
37102,10,14,36030,1072,37020,82,1.54439e+14,10.5551,617.716,37102,13,12,36929,36647,35222,33385,30365
3571,394,961,0,3571,1265,2306,2.43541e+15,57.7676,1384.54,3571,446,66,2610,2610,1953,1228,1325
26434,129,176,26362,72,26434,0,6.03147e+18,170.679,1990.39,26434,162,159,25191,23462,19307,19458,19510
36163,129,208,36098,65,36163,0,6.11938e+18,202.048,2532.16,36163,175,179,33665,30844,21913,22468,22397
42072,7,13,40872,1200,42053,19,1.38771e+14,10.2503,582.956,42072,12,12,40591,39487,35346,35453,25531
35647,595,1129,0,35647,34626,1021,3.6804e+16,236.873,3733.1,35647,175,26,34518,33999,32274,31997,23456
5901,773,1978,5591,310,0,5901,1.98651e+18,94.4059,2642.71,5901,944,93,3923,3923,2676,2413,1962
49833,5329,18086,0,49833,0,49833,5.39615e+17,95.8624,21289.3,49833,8790,110,31747,31747,22480,13200,11680
24311,105,176,24230,81,24311,0,6.1173e+18,170.709,1930.49,24311,149,153,22182,16976,13971,14282,14519
35337,6,13,34317,1020,35317,20,1.53454e+14,10.246,554.496,35337,12,12,33673,32703,30058,29396,21052
29675,125,176,29591,84,29675,0,6.07068e+18,172.708,2127.05,29675,165,159,28111,25638,21046,21008,21016
6066,2289,2708,6066,0,4740,1326,3.59895e+18,87.5826,3180.83,6066,1056,95,3358,3358,3273,3316,3230
41035,103,1709,0,41035,39835,1200,4.32258e+16,308.977,5571.04,41035,285,26,38421,38051,26089,24437,5556
8122,867,2056,7652,470,7652,470,4.43543e+18,96.792,2963.3,8122,956,105,6066,6066,4488,5414,3172
43694,1,12,42447,1247,43674,20,1.38992e+14,10.2924,594.436,43694,12,11,11180,11180,11180,11180,11180
28341,5577,9425,0,28341,0,28341,5.66221e+17,96.1536,11563.7,28341,4572,110,18916,18916,16210,14939,11882
46665,10735,10931,43953,2712,0,46665,2.22591e+18,97.7976,14455.3,46665,5299,110,35734,35734,35501,35519,35432
44224,1910,15455,16454,27770,0,44224,8.37275e+12,57.7995,18093.7,44224,7512,72,28769,28769,12816,23867,2467
49686,179,12391,0,49686,17608,32078,2.47729e+15,59.8174,15654.8,49686,6032,72,37295,37133,21032,458,1095
49095,115,176,49009,86,49095,0,6.00471e+18,173.456,2677.8,49095,171,173,45703,41317,30866,31870,31778
13960,452,3345,13148,812,0,13960,2.22716e+18,97.1307,4726.64,13960,1606,110,10615,10615,4299,3802,2115
28520,10372,13184,28520,0,27270,1250,4.30206e+18,339.823,14687.5,28520,5966,129,15336,15285,13709,14618,11672
7415,2945,3380,0,7415,0,7415,4.66643e+17,92.9266,4063.9,7415,1619,97,4035,4035,3778,3520,3802
31528,6,14,30629,899,31447,81,1.38925e+14,10.7122,551.027,31528,13,12,29926,29149,26061,24924,18868
20183,98,1125,0,20183,0,20183,3.78719e+18,15.9846,1650.5,20183,841,18,19058,19058,8769,8054,6719
32405,398,1521,0,32405,31448,957,4.47822e+16,259.812,4777.62,32405,253,26,30884,29884,26773,25557,10437
26188,26,176,26176,12,26188,0,6.00864e+18,170.856,1949.96,26188,158,162,12116,2860,3534,3876,3975
9713,19,208,9707,6,9713,0,6.01316e+18,176.29,1252.51,9713,125,128,3720,670,955,964,878
28021,4945,6568,9854,18167,0,28021,9.88009e+12,59.9842,8648.07,28021,3194,72,21453,21453,19555,21053,16524
16103,951,5115,15263,840,0,16103,1.99624e+18,95.4597,6537.27,16103,2467,110,10988,10988,5915,5121,3169
14466,113,176,14460,6,14466,0,6.03582e+18,169.184,1468.04,14466,142,140,13283,11669,8840,9134,9200
34858,1972,8366,32828,2030,32828,2030,5.1198e+18,98.2611,11090.7,34858,3956,111,26492,26492,18741,22132,7835
16536,659,930,0,16536,16056,480,4.34498e+16,182.798,2600.35,16536,131,26,15606,15324,15072,14868,12625
46303,7505,26897,44813,1490,44813,1490,3.39082e+18,92.0058,29040.9,46303,13010,111,19406,19406,12750,13797,6033
7919,72,335,0,7919,7694,225,3.53782e+16,19.9678,963.966,7919,55,26,7584,7584,6522,6579,2574
42685,27449,42685,0,42685,0,42685,524276,0,42685,42685,42685,1,0,0,0,0,0
2822,117,138,0,2822,2742,80,3.53905e+16,19.702,401.161,2822,36,26,2684,2684,2623,2621,2535
17667,927,4190,0,17667,0,17667,6.46855e+17,97.3568,5843.14,17667,2017,110,13477,13477,8990,5556,3573
14730,6395,8090,14730,0,14730,0,2.60519e+18,18.5974,8419.87,14730,5511,23,6640,6640,5543,5605,5270
30972,6460,7280,0,30972,0,30972,6.49286e+17,97.7456,9824.39,30972,3528,110,23692,23692,22591,22344,21555
13237,1471,3147,0,13237,4655,8582,2.52386e+15,59.7006,4295.64,13237,1530,72,10090,10090,7986,7835,5028
47850,19060,47850,47850,0,0,47850,134215000,0,47850,47850,47850,1,0,0,0,0,0
35348,7737,8285,33289,2059,0,35348,2.22815e+18,97.7945,11111.8,35348,4010,110,27063,27063,26351,26243,25774
33064,10868,11038,12201,20863,0,33064,8.59583e+12,58.4302,13162.2,33064,5373,72,22026,22026,21790,21985,21654
46359,2378,27803,44949,1410,44949,1410,2.21365e+18,91.7082,29915.2,46359,13513,110,18556,18556,5688,9991,2910
48327,14811,17746,48327,0,45799,2528,4.4576e+18,382.045,20005.6,48327,4845,141,30581,30581,29319,30273,26783
24494,1006,5893,23066,1428,23066,1428,4.95614e+18,98.0894,7968.07,24494,2779,111,18601,18601,11495,14202,4326
41572,655,10712,39230,2342,0,41572,2.15969e+18,97.4553,13848.5,41572,5185,110,30860,30860,18458,16118,3110
13861,1141,4794,5141,8720,0,13861,8.4551e+12,56.5185,5857.34,13861,2312,72,9067,9067,4818,7771,2255
24239,4,13,23549,690,24165,74,1.3906e+14,10.861,480.197,24239,13,12,21226,18986,18134,16883,11515
12655,10437,12655,12655,0,0,12655,7.99937,0,12655,12655,12655,1,0,0,0,0,0
14409,305,4795,0,14409,5318,9091,2.20294e+15,57.1743,5905.82,14409,2321,72,9614,9518,5405,81,0
30166,714,7002,10596,19570,0,30166,9.90947e+12,60.0233,9212.4,30166,3405,72,23164,23164,13935,21567,2683
32636,30829,32636,32636,0,32636,0,34358700000,0,32636,32636,32636,1,0,0,0,0,0
8244,2236,2781,7824,420,7824,420,4.72242e+18,95.4074,3623.15,8244,1314,107,5463,5463,4482,4713,4283
32555,4566,9332,0,32555,0,32555,6.0349e+17,96.9364,11840.9,32555,4522,110,23223,23223,18291,15684,12509
7169,1418,2538,0,7169,2657,4512,2.15814e+15,57.5436,3177.57,7169,1233,72,4631,4631,3180,2444,1627
20639,144,176,20633,6,20639,0,5.9837e+18,167.615,1713.18,20639,158,155,20017,18755,17091,17068,17142
38736,13,14,37614,1122,38679,57,1.57472e+14,10.501,635.57,38736,13,11,38722,38722,38506,38506,38081
30564,1870,9371,11139,19425,0,30564,8.94691e+12,58.8587,11431.4,30564,4560,72,21193,21193,14156,19983,5720
29499,1279,6884,27779,1720,27779,1720,3.22606e+18,97.7345,9342.43,29499,3326,110,22615,22615,12479,17292,5505
29352,6185,6923,27649,1703,27649,1703,3.34716e+18,97.6615,9365.13,29352,3341,110,22429,22429,21005,21656,20569
11045,236,716,0,11045,10721,324,4.18906e+16,42.7528,1809.45,11045,92,26,10329,10303,9326,9111,4470
41231,2243,12307,0,41231,14964,26267,2.31132e+15,58.9863,14956,41231,5981,72,28924,28924,16017,7403,5388
39013,16176,22916,37790,1223,37790,1223,2.17612e+18,86.4436,24808.5,39013,11134,110,16097,16097,15019,15845,13952
41823,5086,13529,0,41823,0,41823,5.7222e+17,87.2607,16461,41823,6550,110,28294,28294,22807,17321,16144
49436,15350,22066,0,49436,0,49436,4.68341e+17,93.8325,24922.5,49436,10709,110,27370,27370,23711,20648,19908
46469,12805,17961,44299,2170,0,46469,1.78588e+18,94.5789,20906.1,46469,8713,110,28508,28508,24944,24159,21170
39024,3811,9120,0,39024,0,39024,6.47494e+17,97.8413,12181.2,39024,4412,110,29904,29904,22686,13324,13769
36865,10,15,35789,1076,36782,83,1.64609e+14,10.5149,644.434,36865,13,11,36709,36469,31395,30861,29928
10418,331,3824,9908,510,0,10418,1.8663e+18,94.814,4796.39,10418,1843,108,6594,6338,3602,2250,1496
47844,1371,12858,0,47844,17129,30715,2.41438e+15,59.5243,15954.1,47844,6264,72,34986,34986,21435,4278,4871
5297,1196,1411,4997,300,4997,300,2.82536e+18,95.5205,2071.45,5297,649,89,3886,3886,3700,3873,3573
31960,97,208,31895,65,31960,0,6.1631e+18,199.458,2386.07,31960,168,168,27931,21608,15481,15787,15539
24826,6,12,24118,708,24812,14,1.39105e+14,10.4175,446.759,24826,12,11,23558,22804,20765,20823,14609
33190,3340,7786,31260,1930,31260,1930,5.88338e+18,97.7594,10478.8,33190,3770,110,25404,25404,24288,24291,11993
20876,3299,5047,19663,1213,19663,1213,5.68796e+18,97.9537,6884.47,20876,2378,111,15829,15829,12531,13256,11002
49832,4587,11637,46932,2900,46932,2900,3.22984e+18,97.9267,15355.4,49832,5647,110,38195,38195,28376,33822,16753
2351,187,248,0,2351,2281,70,4.99285e+16,18.2931,576.963,2351,47,26,2103,2096,2026,2021,1648
48993,7652,11453,46143,2850,46143,2850,5.76442e+18,97.9024,15116.9,48993,5558,110,37540,37540,35260,34890,26207
33569,1650,7840,0,33569,11804,21765,2.52581e+15,60.001,10249.6,33569,3804,72,25729,25729,12354,8104,5634
18251,3603,4724,6492,11759,0,18251,9.58527e+12,59.5242,6167.66,18251,2301,72,13527,13527,12189,13297,10776
4433,774,1162,0,4433,0,4433,6.52729e+17,94.8137,1745.18,4433,547,83,3271,3271,2761,2306,2422
49129,2997,11432,17270,31859,0,49129,9.88744e+12,60.1048,14729.8,49129,5567,72,37697,37697,25396,35577,10331
41121,4981,9834,38723,2398,38723,2398,3.96105e+18,98.3346,12933.5,41121,4644,111,31287,31287,22027,23912,17110
40816,7918,9827,38443,2373,38443,2373,1.29117e+18,98.2883,12903.1,40816,4649,111,30989,30989,30989,30989,25888
13504,1778,6182,5272,8232,0,13504,7.04334e+12,56.2179,7082.53,13504,3004,72,7322,7322,4516,6842,1311
8381,2285,2794,7951,430,7951,430,7.07387e+18,95.0302,3657.44,8381,1339,108,5587,5587,5491,5475,5366
42181,9863,13494,42181,0,39723,2458,3.75128e+18,298.728,15297.7,42181,4633,133,28687,28685,25710,26541,22056
49435,5646,11550,0,49435,0,49435,6.47728e+17,97.9168,15240.8,49435,5602,110,37885,37885,31180,24645,19819
37324,1,14,36260,1064,37246,78,1.38897e+14,10.4361,574.045,37324,14,12,9556,9556,9556,9556,9556
20004,2126,6579,19770,234,18834,1170,5.00128e+18,149.076,7664.44,20004,2383,121,13425,13330,8734,10616,4749
35476,7025,8321,0,35476,0,35476,6.4637e+17,97.7606,11157.4,35476,4021,110,27155,27155,25416,24400,23529
35766,6483,11953,0,35766,0,35766,5.63312e+17,96.2159,14515,35766,5797,110,23813,23813,19459,15462,14569
40352,11929,12912,31526,8826,38002,2350,3.53534e+18,284.16,14658.9,40352,4689,133,27440,27440,27421,27424,25963
12491,6,11,12134,357,12487,4,1.39081e+14,9.95445,310.39,12491,11,11,11898,11608,9003,8869,8058
49101,7293,24851,47259,1842,0,49101,1.43912e+18,93.5634,27447.3,49101,12082,110,24250,24250,14156,13695,5983
45794,14838,25290,44234,1560,0,45794,1.30573e+18,92.7541,27570.1,45794,12295,110,20504,20504,16732,15799,13281
14990,3225,3578,0,14990,0,14990,6.46047e+17,97.1939,5041.35,14990,1715,110,11412,11412,10961,11080,10680
6869,114,3652,6869,0,6589,280,3.85936e+18,102.309,4143.74,6869,1603,93,3217,852,1335,2052,566
34326,9658,12263,34326,0,32486,1840,5.06416e+18,234.164,14004.7,34326,4788,133,22063,22052,20559,21743,17476
11046,448,4963,10576,470,10576,470,2.56635e+18,90.0994,5874.52,11046,2373,110,6083,5822,3167,3861,1869
19854,3192,4775,18704,1150,18704,1150,5.95519e+18,97.4023,6576.15,19854,2303,110,15079,15079,14709,14709,10901
15187,4,11,14753,434,15185,2,1.40839e+14,10.1815,346.143,15187,11,11,13121,11642,9747,8970,6375
41891,10,15,40699,1192,41804,87,1.40754e+14,10.6014,645.285,41891,13,12,41669,41308,39339,38548,31811
36368,9485,12415,34548,1820,0,36368,1.91753e+18,95.2254,14988.4,36368,6015,110,23953,23953,21774,21263,19576
34699,376,12225,34699,0,32770,1929,3.97125e+18,234.239,13768.7,34699,4110,133,22474,21823,9961,14887,1328
25478,105,208,25401,77,25478,0,6.1256e+18,199.669,2133.16,25478,161,162,22829,17477,12897,13164,12863
48381,9931,11217,0,48381,16997,31384,2.53439e+15,60.0915,14472,48381,5458,72,37164,37164,35263,33269,33105
6961,60,296,0,6961,6763,198,3.53715e+16,19.9246,856.922,6961,51,26,6665,6665,4770,4757,2271
48767,143,206,48681,86,48767,0,5.9831e+18,193.533,2704.65,48767,186,180,46860,43683,35102,35427,35063
11254,4968,5326,10794,460,10794,460,2.84451e+18,92.9831,6219.73,11254,2555,107,5928,5928,5713,5916,5726
15784,7208,8201,11276,4508,15194,590,4.44213e+18,93.5288,9265.36,15784,3949,111,7583,7583,6758,6876,6909
8169,1835,2074,7699,470,7699,470,2.31555e+18,96.6994,2986.26,8169,962,106,6095,6095,6095,6095,5892
47558,13171,17688,17893,29665,0,47558,8.10693e+12,57.4661,20407.4,47558,8611,72,29870,29870,25517,29120,20375
19312,106,6872,18352,960,18352,960,2.82975e+18,96.1405,8403.31,19312,3282,111,12440,5092,4982,7680,1276
43125,2280,15978,16205,26920,0,43125,8.11985e+12,57.8613,18489.8,43125,7781,72,27147,27147,16785,25369,4302
19115,1877,4473,0,19115,6721,12394,2.54001e+15,59.9095,6005.1,19115,2179,72,14642,14642,10724,7489,6495
23005,1093,6175,0,23005,8224,14781,2.41927e+15,59.4093,7889.22,23005,3004,72,16830,16830,9461,6206,3919
32840,8419,10080,32840,0,30928,1912,3.95966e+18,225.447,11821.3,32840,3924,125,22760,22710,21037,21703,19627
12405,578,737,0,12405,12044,361,4.09633e+16,61.0631,1913.28,12405,96,26,11668,11617,11404,11409,9770
40516,3821,16307,40516,0,38526,1990,4.58952e+18,438.255,18315.4,40516,7184,136,24209,23800,14863,18575,6475
15655,54,176,15648,7,15655,0,5.9844e+18,168.828,1491.73,15655,141,148,10314,5229,4170,4930,4606
7714,2528,4288,0,7714,0,7714,3.8479e+17,91.4497,4894.37,7714,2065,84,3426,3340,2390,2104,1596
20347,355,1075,0,20347,19749,598,4.41688e+16,212.96,3150.27,20347,162,26,19237,18814,17043,15373,10667
32145,6431,7543,0,32145,0,32145,6.47542e+17,97.7585,10169.8,32145,3650,110,24602,24602,23172,22794,21767
35245,612,15249,13634,21611,0,35245,7.32494e+12,56.8902,17215.8,35245,7428,72,19996,19612,11299,18506,883
7058,9,11,6852,206,7052,6,1.61037e+14,10.3423,244.852,7058,11,11,6967,6874,6173,6193,6209
10619,2352,2570,0,10619,0,10619,6.49868e+17,96.8764,3695.83,10619,1233,110,8049,8049,7815,7864,7675
45592,2,176,45515,77,45592,0,5.98925e+18,172.575,2551.92,45592,171,173,2260,68,53,70,326
22735,1577,7095,21543,1192,21543,1192,3.07284e+18,96.3441,8946.68,22735,3423,110,15640,15640,11595,11973,5969
9356,460,709,0,9356,9080,276,4.45315e+16,35.7438,1730.78,9356,91,26,8647,8629,8087,8198,6371
47797,8180,11180,0,47797,0,47797,6.47991e+17,97.8973,14768.8,47797,5426,110,36617,36617,32494,29692,27535
23466,5076,5526,8262,15204,0,23466,9.8679e+12,59.9298,7329.38,23466,2688,72,17940,17940,17413,17827,16708
35603,6837,8333,33525,2078,0,35603,2.22901e+18,97.8054,11172.7,35603,4041,110,27270,27270,25309,24921,23221
17722,3275,4710,0,17722,6323,11399,2.42898e+15,59.3562,6109.21,17722,2288,72,13012,13012,11523,10640,9891
36995,28,176,36902,93,36995,0,6.12937e+18,173.091,2381.41,36995,166,163,18848,5718,6240,6121,5934
40967,9769,10934,38667,2300,38667,2300,5.9882e+18,97.8988,13937.9,40967,5191,111,30033,30033,29889,29549,26951
13498,1683,5332,5127,8371,0,13498,7.90587e+12,57.2617,6306.41,13498,2597,72,8166,8166,5526,7707,2478
29776,9445,13209,0,29776,11569,18207,1.83995e+15,56.6622,14899.3,29776,6431,72,16567,16567,15016,13600,12580
32998,8100,10248,31268,1730,31268,1730,7.01789e+18,94.8012,12721.1,32998,4955,110,22750,22750,22440,22440,19380
5874,1069,1407,2063,3811,0,5874,9.83205e+12,59.1558,2032.74,5874,670,72,4467,4467,4084,4387,3621
26455,161,208,26399,56,26455,0,6.08919e+18,201.466,2170.62,26455,163,163,25579,24189,20591,20756,20284
8669,5,11,8414,255,8662,7,1.77801e+14,10.2718,275.022,8669,11,11,7993,7236,6130,6127,4412
34261,4173,9920,32401,1860,32401,1860,3.48697e+18,97.4485,12471.2,34261,4715,111,24341,24341,15562,17295,11554
25252,106,175,25179,73,25252,0,5.98177e+18,167.033,1879.98,25252,163,159,22984,15788,14323,15096,15410
21247,9331,9363,21247,0,20227,1020,3.70246e+18,179.587,10420.8,21247,3895,127,11884,11884,11884,11884,11884
43831,906,2582,13332,30499,0,43831,6.90782e+18,15.993,3362.45,43831,1804,18,41249,41249,27506,26198,25209
31100,7772,10330,0,31100,11481,19619,2.20897e+15,58.4116,12356.9,31100,5026,72,20770,20770,17463,13287,13635
25472,1558,8940,24212,1260,0,25472,1.89322e+18,87.5274,10874.3,25472,4330,110,16532,16532,6283,5169,0
21878,699,865,0,21878,21251,627,3.73759e+16,146.5,2573.56,21878,122,26,21013,21013,20567,20553,18208
4472,1,11,4342,130,4471,1,1.40108e+14,9.85465,184.189,4472,10,10,1138,1138,1138,1138,1138
34757,11374,11454,12807,21950,0,34757,8.6576e+12,58.494,13674,34757,5572,72,23303,23303,23256,23290,23252
48519,4098,11307,0,48519,17051,31468,2.53165e+15,60.0749,14564.8,48519,5505,72,37212,37212,26730,21536,13938
36067,675,8469,0,36067,12679,23388,2.52565e+15,60.0149,11018.5,36067,4122,72,27598,27598,16248,7018,2362
27526,2090,7788,0,27526,9912,17614,2.36944e+15,59.1793,9730.69,27526,3785,72,19738,19738,12745,4953,4258
31172,1258,1410,31172,0,29878,1294,2.8938e+18,17.9627,2099.36,31172,670,29,29762,29762,29762,29762,28539
22225,1020,11373,22225,0,21345,880,4.20642e+18,299.978,12600,22225,5258,126,10852,10119,5166,7329,1531
15431,10,12,14988,443,15421,10,1.45508e+14,10.5876,356.203,15431,12,11,15344,15217,14475,14487,14095
1170,173,190,0,1170,1133,37,6.24499e+16,11.4803,397.12,1170,39,19,980,980,963,968,842
40898,5,15,39707,1191,40834,64,1.60972e+14,10.5479,677.99,40898,13,11,37774,34118,32677,30934,19902
28809,1512,6961,27136,1673,27136,1673,2.29899e+18,98.1395,9308.81,28809,3290,111,21848,21848,12680,15434,6102
18268,1772,10025,7439,10829,0,18268,5.85738e+12,52.8746,11012.5,18268,4878,72,8243,8243,4791,7653,835
2152,72,106,0,2152,2088,64,3.54261e+16,19.7365,317.911,2152,31,26,2046,2046,1975,1983,1667
14681,9,11,14251,430,14669,12,1.61722e+14,10.2238,352.663,14681,11,11,14511,14318,14081,14080,13258
48661,4772,16414,46211,2450,0,48661,1.92704e+18,95.6076,19663.4,48661,7961,110,32247,32247,22508,20276,11021
12772,1970,3992,4660,8112,0,12772,8.90985e+12,58.5381,5027.09,12772,1940,72,8780,8780,6970,8470,4985
28151,7178,8966,0,28151,0,28151,5.77294e+17,95.7181,11134.1,28151,4344,110,19185,19185,17281,15733,15444
30898,1311,9872,30898,0,29130,1768,4.47025e+18,211.047,11523.1,30898,3892,124,21026,20761,11506,15122,3147
33694,3909,12904,32112,1582,32112,1582,7.9256e+18,95.4052,15205.8,33694,6255,110,20790,20790,18064,17619,7159
18563,227,5620,6754,11809,0,18563,9.00506e+12,58.7874,7015.41,18563,2732,72,12943,12751,4007,10223,527
24526,6979,8831,23331,1195,0,24526,1.86732e+18,95.6135,10687.8,24526,4278,110,15695,15695,14614,14098,13146
30272,376,8195,0,30272,0,30272,6.17741e+17,97.1809,10608.8,30272,3973,110,22077,21819,8234,2482,2636
8447,1315,2089,7958,489,7958,489,5.93531e+18,96.3807,3035.94,8447,994,108,6358,6358,6159,6159,4349
46666,6706,10830,16396,30270,0,46666,9.89979e+12,60.0797,13987.1,46666,5267,72,35836,35836,30893,34806,22628
12751,5015,6098,0,12751,5022,7729,1.73905e+15,55.8849,6935.57,12751,2966,72,6653,6653,6134,5395,5457
16414,2424,4953,5964,10450,0,16414,9.0028e+12,58.7662,6224.43,16414,2399,72,11461,11461,9185,11071,6562
4880,135,1158,1720,3160,0,4880,1.00057e+13,59.2299,1702.8,4880,564,72,3722,3722,2211,3453,528
35462,5519,15470,33941,1521,0,35462,1.64406e+18,94.577,17703.6,35462,7509,110,19992,19992,14614,13998,9427
17636,49,199,17623,13,17636,0,5.97988e+18,180.351,1630.96,17636,149,158,10989,5344,3833,4890,4531
1149,82,376,1088,61,1088,61,5.82471e+18,84.114,582.343,1149,155,45,659,222,519,529,167
19110,4948,9096,18340,770,18340,770,8.42906e+18,91.5822,10405.5,19110,4353,111,10014,10014,8297,8681,6098
16254,4255,4670,0,16254,0,16254,6.06067e+17,96.5976,6147.86,16254,2255,110,11584,11584,11047,10497,10698
47449,141,176,47366,83,47449,0,5.98141e+18,171.975,2581.01,47449,172,172,46059,42946,37753,38097,37733
2828,435,749,2665,163,2665,163,5.86788e+18,92.7974,1173.77,2828,334,66,2079,2079,2006,2006,1465
16324,4692,8287,16324,0,12094,4230,5.46973e+18,172.428,9141.49,16324,2192,127,8037,8018,7017,7917,5406
30788,1,14,29911,877,30712,76,1.38955e+14,10.7152,543.88,30788,13,12,7878,7878,7878,7878,7878
26056,1561,1697,0,26056,5299,20757,1.46424e+16,11.9925,2217.67,26056,1069,14,24359,24359,23469,22685,23959
33384,731,18131,33384,0,0,33384,8.90854e+17,17.9465,18628.4,33384,16311,20,15253,15248,1080,2392,714
2653,350,773,2503,150,2503,150,3.25082e+18,93.003,1168.58,2653,348,65,1880,1880,1468,1707,1200
41266,6120,9602,14497,26769,0,41266,9.87832e+12,60.0561,12456.8,41266,4666,72,31664,31664,26635,30794,20585
9831,2211,2860,9291,540,9291,540,3.09548e+18,91.805,3864.12,9831,1349,111,6971,6971,6888,6964,6864
33190,13220,13766,12726,20464,0,33190,7.57366e+12,57.1548,15683.6,33190,6706,72,19424,19424,18758,19284,17837
41276,14329,18926,39576,1700,0,41276,1.57726e+18,94.3017,21364.4,41276,9196,110,22350,22350,19244,18510,16135
13480,4,12,13069,411,13466,14,2.11837e+14,10.1679,348.289,13480,11,12,11818,10482,9610,4484,4977
11139,1366,5239,10687,452,0,11139,1.56363e+18,93.1759,6138.84,11139,2525,107,5900,5900,3489,3536,2150
16481,1583,7165,6372,10109,0,16481,7.35123e+12,56.6725,8244.92,16481,3486,72,9316,9316,3754,7783,1154
25763,13686,13926,25763,0,25763,0,2.94976e+18,17.8376,14362.6,25763,12519,20,11837,11837,11685,11682,11715
36233,17086,20330,35023,1210,35023,1210,2.28829e+18,90.9057,22208.4,36233,9865,110,15903,15903,14837,15663,13880
46380,13541,14220,16908,29472,0,46380,8.93547e+12,58.7101,17113.2,46380,6909,72,32160,32160,31485,32040,30838
30014,8367,11139,28564,1450,28564,1450,4.32285e+18,96.1118,13238.2,30014,5342,111,18875,18875,18172,18875,15367
34102,8553,13465,0,34102,0,34102,5.12459e+17,93.2125,15758.3,34102,6524,110,20637,20637,18191,17247,15784
24301,7,11,23609,692,24292,9,1.38693e+14,10.1862,436.414,24301,11,11,23446,22752,17459,17271,17283
22818,957,7634,21648,1170,21648,1170,4.20249e+18,96.5678,9413.22,22818,3649,111,15184,15184,6151,5337,2234
20344,2,14,19750,594,20270,74,1.65407e+14,10.5928,450.192,20344,13,12,11969,9099,7079,9163,6833
27975,232,1041,0,27975,27170,805,3.82376e+16,212.733,3265.3,27975,157,26,26776,26519,20328,19670,10899
41238,4,10,39773,1465,41112,126,4.47419e+13,5.99093,598.785,41238,8,8,39358,38422,37476,36074,35858
36765,9301,13421,0,36765,13781,22984,2.09338e+15,57.934,15648.9,36765,6522,72,23344,23344,20952,17627,17065
26330,5436,7028,9405,16925,0,26330,9.46099e+12,59.4686,8938.55,26330,3421,72,19302,19302,18173,19062,16436
36951,985,12194,35068,1883,0,36951,1.95186e+18,96.2996,14831,36951,5918,110,24757,24757,13636,8451,4111
9165,94,176,9127,38,9165,0,6.10614e+18,165.473,1183.72,9165,115,120,7972,5708,4678,4855,4859
6727,697,2232,0,6727,2463,4264,2.21927e+15,57.832,2859.21,6727,1081,72,4495,4447,2693,1601,703
28764,4300,7511,0,28764,0,28764,6.24985e+17,97.2747,9852.78,28764,3635,110,21253,21253,18068,15168,12879
17396,2106,4196,16389,1007,16389,1007,5.80908e+18,97.2872,5824.29,17396,2016,110,13200,13200,11968,11772,7298
35290,189,1046,0,35290,34285,1005,3.55531e+16,217.129,3475.29,35290,157,26,34043,33823,23673,23680,11103
18319,3643,4326,0,18319,0,18319,6.50145e+17,97.4549,6026.61,18319,2088,110,13993,13993,13077,12614,12269
23094,3335,6711,21844,1250,0,23094,2.07083e+18,96.745,8630.61,23094,3246,110,16383,16383,13272,11895,8215
44776,19510,21988,0,44776,17782,26994,1.67998e+15,55.2176,24174.6,44776,10689,72,22788,22788,22142,21501,21596
45913,10063,17884,43763,2150,43763,2150,4.53971e+18,96.0582,20727.9,45913,8585,111,28029,28029,22715,27677,14076
47076,3,14,43240,3836,46893,183,1.14466e+14,8.03836,585.762,47076,13,9,35228,33314,19555,28243,31400
17491,1192,4122,0,17491,6146,11345,2.52325e+15,59.7985,5551.5,17491,1994,72,13369,13369,7549,4955,3875
44337,5,16,43046,1291,44246,91,1.62637e+14,10.6159,692.929,44337,15,12,41056,37135,34595,29880,16463
17045,2698,4044,16049,996,0,17045,2.22964e+18,97.3734,5650.36,17045,1950,110,13001,13001,11464,10850,9188
3696,129,1703,3539,157,3539,157,8.69145e+18,90.9943,2113.58,3696,805,73,1993,1032,1485,1266,570
4590,210,1963,0,4590,0,4590,5.01168e+17,90.6281,2464.44,4590,919,75,2627,2486,1639,694,877
43186,3882,24119,0,43186,17659,25527,1.45991e+15,54.3746,26011.7,43186,11733,72,19067,19067,9547,7878,3480
10459,738,3487,9919,540,9919,540,2.52171e+18,96.0686,4492.03,10459,1658,111,6972,6889,5089,4745,2619
15999,2677,4142,15096,903,0,15999,2.16612e+18,96.9429,5645.31,15999,1994,110,11857,11857,10432,10106,9062
30339,279,949,0,30339,29475,864,3.54837e+16,185.572,3057.52,30339,138,26,29340,29086,25441,25662,13021
30270,7715,9991,28730,1540,0,30270,1.9516e+18,96.1903,12252,30270,4833,110,20279,20279,18367,17565,15406
48289,95,176,48200,89,48289,0,6.00238e+18,172.359,2644.18,48289,172,172,42471,27071,24055,25745,26312
21256,103,176,21249,7,21256,0,6.01227e+18,171.366,1764.23,21256,153,158,19149,12729,11478,12007,12580
46614,9382,10869,0,46614,16393,30221,2.52786e+15,60.0656,14022.7,46614,5286,72,35745,35745,33577,31292,31052
47274,4863,17881,0,47274,17831,29443,2.05108e+15,57.7817,20568.4,47274,8704,72,29393,29393,20335,20769,9481
1942,7,11,1887,55,1940,2,1.42187e+14,9.77085,122.757,1942,11,11,1875,1847,1666,1677,1473
39454,10779,25565,34974,4480,0,39454,2.45108e+18,5.52284,29325,39454,8523,13,13889,13889,11469,12202,6896
33810,2906,15074,0,33810,0,33810,4.69155e+17,94.3883,17199.4,33810,7314,110,18736,18736,12951,6598,5557
28649,90,8609,27119,1530,27119,1530,4.16422e+18,96.6866,10844.7,28649,4171,110,17775,5757,9554,14069,1557
10469,268,2545,9853,616,9853,616,1.26263e+18,97.3586,3642.1,10469,1187,111,7924,7924,2703,3156,1424
2773,361,779,2613,160,0,2773,2.18792e+18,93.0224,1190.19,2773,360,66,1994,1994,1563,1433,1279
9284,158,176,9276,8,9284,0,6.09711e+18,154.224,1194.12,9284,116,117,9046,8869,8249,8236,8221
15129,6887,9622,0,15129,0,15129,3.16339e+17,90.942,10472.3,15129,4669,100,5507,5421,4185,2119,2306
48692,11914,15504,48692,0,45862,2830,4.91542e+18,333.611,17503.1,48692,5499,133,33188,33186,30839,32371,26671
31824,7349,10307,31824,0,29974,1850,4.20885e+18,216.034,11780.1,31824,2702,132,21517,21476,19655,20956,16003
15334,14479,15334,0,15334,15334,0,2047.87,0,15334,15334,15334,1,0,0,0,0,0
43234,7,14,42001,1233,43162,72,1.38758e+14,10.5998,649.258,43234,13,11,41734,40752,31485,31582,29517
3535,1097,1130,0,3535,1295,2240,2.29596e+15,57.4506,1526.5,3535,545,69,2405,2405,2376,2394,2377
43425,7,14,42188,1237,43348,77,1.38757e+14,10.586,646.18,43425,13,12,41899,40854,36302,36437,25665
40938,10517,16723,40938,0,38883,2055,4.53854e+18,342.87,18425.5,40938,4564,140,24215,24098,20968,22341,16643
23404,928,11742,22514,890,22514,890,2.58268e+18,90.9818,13229.9,23404,5679,110,11662,11170,3854,6819,1472
25879,5,12,25130,749,25860,19,1.55492e+14,10.2839,471.838,25879,12,11,23867,21428,20973,18619,14885
42011,3766,18561,42011,0,40041,1970,5.17854e+18,301.487,20321.6,42011,6440,141,23450,22877,15412,18093,8677
35152,542,1319,0,35152,34132,1020,4.0022e+16,268.271,4272.55,35152,213,26,33833,33086,30843,29319,16940
3107,976,1226,2111,996,2957,150,2.98981e+18,82.7444,1621.7,3107,571,64,1881,1881,1881,1881,1881
39116,6947,9103,13740,25376,0,39116,9.90001e+12,60.0581,11831.7,39116,4429,72,30013,30013,26843,29463,23096
6616,1531,1642,6226,390,6226,390,1.30345e+18,96.5886,2427.53,6616,756,96,4974,4974,4891,4967,4864
14086,2519,4490,14086,0,13269,817,4.37927e+18,116.834,5456.69,14086,1699,121,9596,9569,7519,8290,5769
26950,4240,8329,26950,0,25380,1570,4.71576e+18,172.046,9833.8,26950,1665,128,18621,18621,15422,17256,10063
16436,2746,3916,15483,953,15483,953,3.22412e+18,97.2524,5481.71,16436,1879,110,12520,12520,11345,12191,9531
39178,461,1116,0,39178,38061,1117,3.5604e+16,234.718,3791.04,39178,172,26,38062,37553,30569,31431,20988
42366,7,16,41120,1246,42300,66,1.71559e+14,10.4115,687.609,42366,14,12,41204,40437,37202,32634,26074
36625,431,14259,0,36625,0,36625,5.16672e+17,94.8071,16699.1,36625,6914,110,22366,21596,12832,3875,1996
32814,93,7693,30904,1910,0,32814,2.22774e+18,97.7859,10363,32814,3724,110,22853,7806,6843,5249,1900
2466,185,1511,2466,0,2376,90,6.80643e+18,86.9659,1726.69,2466,637,63,955,862,601,800,475
14848,2663,3943,0,14848,0,14848,6.2225e+17,96.753,5356.67,14848,1889,110,10905,10905,9181,7815,7330
26558,11,13,25771,787,26535,23,1.83778e+14,10.3195,500.109,26558,12,12,26545,26545,26129,26130,23847
37671,5505,8867,0,37671,0,37671,6.47103e+17,97.6658,11836.7,37671,4294,110,28804,28804,25036,26188,18811
15547,329,664,4533,11014,0,15547,6.92202e+18,15.979,1126.57,15547,657,17,14883,14883,10581,10134,12890
23127,1407,7484,21925,1202,21925,1202,2.71714e+18,96.7655,9302.55,23127,3560,111,15643,15643,9694,9696,4031
12344,631,4121,11713,631,0,12344,1.95509e+18,95.5166,5263.73,12344,1986,110,8223,8051,5405,4955,2310
13296,1438,4059,12588,708,0,13296,2.03517e+18,96.0801,5306.39,13296,1953,110,9237,9237,5878,5831,3839
29094,3781,6813,10231,18863,0,29094,9.90475e+12,60.0053,8952.35,29094,3319,72,22281,22281,18656,21523,12676
41847,8777,17310,41847,0,39857,1990,4.57371e+18,494.654,19431.3,41847,6447,140,24537,24225,19136,20835,13805
41931,6460,15081,41931,0,39639,2292,4.84648e+18,279.118,16832,41931,3950,134,26850,26674,20156,23444,13235
8496,1866,2623,0,8496,3091,5405,2.30296e+15,58.4233,3387.41,8496,1275,72,5873,5873,5057,4016,3854
35289,1074,15211,35289,0,33589,1700,4.81577e+18,331.023,16749.1,35289,5461,137,20078,19216,9119,13097,1600
23503,6161,7618,22293,1210,0,23503,1.97111e+18,94.3488,9495.23,23503,3675,110,15885,15885,14613,14422,13359
22778,5148,6407,21528,1250,21528,1250,6.55567e+18,95.3522,8323.4,22778,3086,110,16371,16371,16152,16155,14100
45324,17567,19863,45324,0,43466,1858,5.07528e+18,2572.12,22953,45324,7939,151,25461,25375,24737,25155,21906
41896,6,15,40687,1209,41837,59,1.54853e+14,10.5213,677.016,41896,13,11,39907,38816,35630,31700,24613
5937,209,262,0,5937,5768,169,3.53795e+16,19.8696,753.38,5937,48,26,5675,5675,5449,5478,5001
48109,7991,17770,45808,2301,0,48109,1.83418e+18,95.7133,20864.1,48109,8624,110,30339,30266,25816,26449,23218
40617,4578,9778,38252,2365,38252,2365,2.07875e+18,98.2501,12840.7,40617,4624,111,30839,30839,25356,27837,15591
4155,457,1576,3948,207,3948,207,2.84861e+18,93.4075,2065.97,4155,732,80,2579,2492,1753,1522,1008
24295,4966,10352,23225,1070,23225,1070,4.12976e+18,93.0157,12025.2,24295,4949,111,13943,13943,11093,13098,7513
5241,695,1355,4941,300,0,5241,2.19845e+18,95.1771,2022.08,5241,633,87,3886,3886,3089,2969,2481
46664,5862,18766,44544,2120,0,46664,1.74024e+18,93.7311,21665.7,46664,9101,110,27898,27898,18557,16716,8904
45453,13908,25339,43923,1530,43923,1530,1.05038e+19,92.2871,27587.5,45453,12322,110,20114,20114,18266,17958,11040
6217,1199,1559,5857,360,5857,360,4.90486e+18,96.2176,2311.14,6217,717,94,4658,4658,4034,4173,3953
10715,2494,2820,10104,611,10104,611,5.29856e+18,97.0471,3916.01,10715,1316,111,7895,7895,7596,7871,7259
44221,783,10361,41643,2578,41643,2578,5.89323e+18,97.8809,13731.7,44221,5029,110,33860,33860,29996,26983,4636
32644,5487,9775,30894,1750,30894,1750,6.74838e+18,97.2874,12208,32644,4650,111,22869,22869,15369,17883,14162
21266,6516,9291,0,21266,8234,13032,1.86065e+15,56.6682,10607,21266,4508,72,11975,11975,10715,9095,8748
26905,1,9,24666,2239,26904,1,1.16859e+14,7.54845,396.946,26905,9,8,6797,6797,6797,6797,6797
17836,671,6066,17836,0,16816,1020,4.33013e+18,143.011,7069.85,17836,1583,124,11770,11691,6021,8111,1261
44672,4769,10726,42072,2600,42072,2600,5.18958e+18,98.3404,14031.6,44672,5077,111,33946,33946,28914,31584,16611
5559,55,1362,5230,329,0,5559,2.24214e+18,95.7618,2062.22,5559,644,90,2647,646,1971,2048,517
22174,4069,7074,0,22174,0,22174,5.77293e+17,96.2497,8880.1,22174,3422,110,15100,15100,12594,13248,8630
2969,9,13,2885,84,2912,57,1.41449e+14,10.6891,157.597,2969,12,11,2913,2875,2328,2264,2144
22969,4400,12930,0,22969,9400,13569,1.44508e+15,53.421,14076.8,22969,6280,72,10039,10039,7504,5467,5065
42372,13144,16609,42372,0,40242,2130,4.74359e+18,385.726,18652,42372,5445,138,25763,25702,23896,25182,20296
30408,48,1342,0,30408,29520,888,4.27587e+16,267.244,4209.09,30408,216,26,28359,28218,22448,18062,5327
46363,11,176,46227,136,46363,0,6.11663e+18,173.182,2667.27,46363,168,170,12810,2848,2661,2711,2797
20799,2,14,20196,603,20720,79,1.62763e+14,10.686,470.297,20799,13,12,12315,9326,7365,9427,5743
37103,44,176,37088,15,37103,0,5.97999e+18,169.815,2281.43,37103,167,171,22270,9529,7672,9729,9260
36497,13603,18891,36497,0,0,36497,8.83775e+17,17.9804,19430,36497,16993,20,17606,17606,12791,14171,12650
36141,3252,12225,13367,22774,0,36141,8.52982e+12,58.3596,14494.5,36141,5946,72,23916,23916,14864,21032,6075
36047,35,176,35958,89,36047,0,6.07864e+18,170.544,2346.75,36047,167,166,20273,6445,6871,7610,7038
34767,7,15,33742,1025,34704,63,1.77263e+14,10.3273,638.233,34767,13,11,33850,33300,31134,27310,23703
34253,378,8039,32263,1990,32263,1990,5.76399e+18,97.7553,10799,34253,3890,110,26214,26214,19481,14601,2867
42011,5961,17292,42011,0,40001,2010,4.43847e+18,478.12,19404.9,42011,4314,140,24719,24190,18041,19307,11188
1125,248,346,0,1125,0,1125,6.59524e+17,86.2267,553.208,1125,146,46,779,779,675,643,699
29338,1149,11498,27978,1360,27978,1360,2.89652e+18,92.533,13547,29338,5559,110,17840,17684,6395,11189,1599
39393,1332,1585,0,39393,38243,1150,4.22289e+16,295.395,5161.44,39393,263,26,37808,37808,37429,37395,35202
15166,31,61,15134,32,15166,0,2.34157e+18,60.5271,911.726,15166,61,61,11101,2665,7375,7290,7640
33288,5456,14459,31848,1440,0,33288,1.65201e+18,94.6152,16588.4,33288,7025,110,18829,18829,14022,12863,9180
7511,1618,3946,0,7511,3022,4489,1.58246e+15,54.7705,4475.28,7511,1910,72,3565,3565,2762,2487,1685
39617,2333,12716,39617,0,37310,2307,4.76122e+18,279.683,14439.5,39617,4718,128,26901,26451,14733,20369,6051
13578,3633,4365,4973,8605,0,13578,8.79796e+12,58.393,5437.28,13578,2122,72,9213,9213,8699,9103,8047
42116,2105,14438,0,42116,15621,26495,2.16807e+15,57.6782,16996.7,42116,7012,72,27678,27678,15712,11520,6542
27343,6,13,26535,808,27319,24,1.77452e+14,10.4028,504.266,27343,12,12,26300,25758,23341,22557,15407
48653,11618,19478,46434,2219,0,48653,1.74489e+18,95.2587,22476.9,48653,9463,110,29175,29175,23694,22590,17562
12803,7,12,12441,362,12796,7,1.39298e+14,10.3567,318.743,12803,12,11,12358,12079,10840,10879,8489
41173,1542,13178,41173,0,38773,2400,4.91161e+18,291.142,14950.8,41173,4891,128,27995,27507,14401,20644,4277
49366,1,18,47919,1447,49203,163,1.69765e+14,10.5331,782.687,49366,15,14,9760,9760,9760,9760,9760
37756,36,176,37681,75,37756,0,5.98209e+18,169.753,2300.98,37756,171,170,20633,6381,6728,8704,7611
12839,158,3170,12096,743,12096,743,3.06037e+18,97.4268,4443.82,12839,1483,111,9669,9586,3505,5139,1184
7626,1,13,7402,224,7588,38,1.76171e+14,10.7619,281.03,7626,12,11,1413,1413,1413,1413,1413
23481,6180,6978,22216,1265,22216,1265,3.9241e+18,97.1581,8873.23,23481,3310,111,16503,16503,15030,15371,14576
39043,8979,22489,16087,22956,0,39043,5.467e+12,54.597,24178.9,39043,10951,72,16554,16554,11744,15736,6195
8199,5,176,8161,38,8199,0,6.04169e+18,161.412,1115.87,8199,114,115,1183,185,137,126,223
7630,3,8,6999,631,7630,0,1.15874e+14,7.79056,211.642,7630,8,8,5741,5427,3227,4711,3227
22137,2548,7904,21049,1088,21049,1088,2.91815e+18,95.7033,9628.32,22137,3834,110,14233,14233,10561,11357,4858
5903,28,174,5895,8,5903,0,6.18931e+18,152.732,932.896,5903,93,93,3071,1019,1092,962,905
24456,3168,7276,23146,1310,23146,1310,6.6556e+18,96.6031,9263.44,24456,3519,110,17180,17180,15380,15091,8340
32678,2683,9633,0,32678,0,32678,5.96112e+17,89.9036,12129.3,32678,4659,110,23045,23045,9859,6694,217
5660,2184,2535,0,5660,2197,3463,1.84377e+15,50.5055,3018.14,5660,1224,67,3125,3125,2634,2091,2204
26125,3958,15387,25305,820,0,26125,1.20331e+18,89.5851,16786.2,26125,7455,110,10738,10738,6891,6139,3400
23137,7,15,22450,687,23056,81,1.86863e+14,10.3445,485.661,23137,13,13,22570,22187,18695,17867,9870
37860,4345,8857,35657,2203,0,37860,2.22986e+18,97.8089,11844,37860,4284,110,29003,29003,23922,21781,15409
32318,12427,15250,32318,0,30895,1423,4.64937e+18,338.085,16739.3,32318,5423,135,17068,17033,15438,16531,11818
41730,9900,20136,16507,25223,0,41730,6.67512e+12,55.894,22228.9,41730,9792,72,21594,21594,17283,20694,10131
31907,10,12,30999,908,31889,18,1.38863e+14,10.3321,506.43,31907,12,11,31802,31630,30072,30110,30172
27177,139,931,0,27177,26401,776,3.63483e+16,171.992,2919.89,27177,134,26,26076,25962,22021,21508,8116
686,30,50,0,686,665,21,3.53986e+16,16.5569,132.586,686,20,22,636,636,548,551,520
4492,854,1594,4492,0,4235,257,3.20041e+18,90.3602,2026.1,4492,570,86,2898,2898,2389,2565,1908
29457,15,61,29393,64,29457,0,2.2513e+18,60.6521,1275.06,29457,61,61,12837,829,2631,4103,6833
31130,2513,7319,29314,1816,0,31130,2.22735e+18,97.7609,9874.11,31130,3546,110,23811,23811,17350,16146,9495
6282,615,1517,5912,370,0,6282,2.24507e+18,96.1934,2287.12,6282,720,94,4765,4765,3543,3346,2348
4117,405,1445,3907,210,3907,210,2.60251e+18,93.862,1952.15,4117,678,80,2672,2585,873,1541,1180
21132,2629,4984,0,21132,0,21132,6.48334e+17,97.5105,6880.75,21132,2404,110,16148,16148,12994,10628,9360
28234,7,14,27424,810,28155,79,1.43858e+14,10.7534,527.91,28234,13,12,27265,26710,20915,20910,17825
13401,2653,3224,0,13401,0,13401,6.45815e+17,97.0866,4563.83,13401,1540,110,10177,10177,9443,9024,8860
42610,838,13787,42610,0,40202,2408,4.55145e+18,297.866,15878,42610,5566,129,28823,28288,12503,18923,1356
15505,5753,6139,14786,719,0,15505,1.77201e+18,90.604,7399.49,15505,2966,110,9366,9366,9216,9085,9204
21799,4982,7137,21799,0,20529,1270,3.17092e+18,155.622,8283.31,21799,2593,125,14662,14662,12596,13301,10753
17836,707,8679,0,17836,0,17836,4.36867e+17,93.4442,9920.68,17836,4201,110,9157,8572,4059,1233,1186
48315,13339,17252,45955,2360,0,48315,1.87025e+18,95.9513,20406,48315,8379,110,31063,31063,26761,24860,19645
34519,981,1127,0,34519,33532,987,3.71884e+16,236.131,3699.77,34519,174,26,33392,33392,32975,32956,30429
46363,12246,13833,43893,2470,0,46363,2.04033e+18,96.8685,17105.6,46363,6709,110,32530,32530,31412,30982,29837
39065,643,1268,0,39065,37945,1120,3.77931e+16,263.506,4228.73,39065,202,26,37797,37107,31758,32595,24154
25920,942,6132,0,25920,9118,16802,2.51632e+15,59.915,8082.99,25920,2975,72,19788,19788,7981,4935,3003
36726,5580,17340,36726,0,35296,1430,4.85535e+18,1648.97,19761.8,36726,4876,140,19386,17348,11420,12991,7400
10803,1782,2918,0,10803,3857,6946,2.42831e+15,59.0935,3869,10803,1416,72,7885,7885,6595,6324,4599
21117,2524,4966,19887,1230,19887,1230,5.87721e+18,97.5611,6867.34,21117,2398,110,16151,16151,15531,15531,8843
31204,883,7302,0,31204,10962,20242,2.52793e+15,60.0034,9571.19,31204,3552,72,23902,23902,14604,2875,3259
42604,13706,15483,15960,26644,0,42604,8.21246e+12,58.0099,17997.4,42604,7542,72,27121,27121,25759,26881,24277
49980,149,176,49893,87,49980,0,6.00933e+18,166.046,2708.11,49980,171,171,49024,46930,42779,43055,42557
45115,1,7,43705,1410,44923,192,0.000132993,0.999845,537.638,45115,7,1,45108,45108,45108,45108,45108
30008,6613,7038,10552,19456,0,30008,9.84873e+12,59.9565,9235.89,30008,3414,72,22970,22970,22383,22870,21832
32808,373,1559,0,32808,31840,968,4.52073e+16,294.799,4905.45,32808,260,26,31215,30211,23314,24362,10460
7168,1923,4018,6918,250,6918,250,2.89314e+18,91.8737,4584.57,7168,1919,86,3150,3150,2606,2783,2746
25693,1568,9774,0,25693,9698,15995,2.04771e+15,56.2624,11416.9,25693,4755,72,15919,15919,9384,3596,1548
38777,448,9113,0,38777,0,38777,6.47782e+17,97.8514,12151.6,38777,4421,110,29664,29664,17936,4771,3323
4929,208,232,0,4929,4790,139,3.59338e+16,19.8056,660.033,4929,45,26,4697,4697,4658,4659,4496
25722,827,871,0,25722,24990,732,3.56086e+16,155.638,2697.67,25722,122,26,24851,24851,24734,24727,24144
30838,129,522,0,30838,28328,2510,2.92573e+16,10.1909,1176.41,30838,514,11,30316,30316,28669,23505,27693
17260,2971,8192,17260,0,17260,0,5.45716e+15,4303.89,11863.7,17260,8192,4,3847,0,876,3122,3847
27707,8190,13456,0,27707,0,27707,4.36565e+17,90.5744,15181.3,27707,6531,110,14251,14251,12081,10074,8706
48547,12185,15462,48547,0,45725,2822,3.80227e+18,334.448,17459.5,48547,5498,133,33085,33085,30828,31436,27233
14719,1920,3934,13891,828,13891,828,6.16896e+18,96.7973,5331.79,14719,1888,110,10785,10785,9811,9658,6207
21464,1525,6229,20304,1160,0,21464,2.07011e+18,90.5452,8047.52,21464,2993,110,15235,15235,9524,8758,5599
18701,178,935,0,18701,18157,544,4.16409e+16,187.753,2690.61,18701,136,26,17630,17477,12822,12306,4416
31548,11,14,30620,928,31491,57,1.72572e+14,10.4345,590.055,31548,13,11,31534,31532,30042,30077,29845
8028,82,176,8022,6,8028,0,6.05801e+18,155.892,1099.48,8028,113,116,6641,4190,3582,3805,3675
8998,420,621,0,8998,8735,263,4.23312e+16,19.8422,1541.9,8998,81,26,8377,8377,7669,7757,5606
21927,5095,5172,0,21927,0,21927,6.47257e+17,97.5007,7123.32,21927,2488,110,16755,16755,16711,16700,16720
20261,2306,8894,0,20261,7863,12398,1.85989e+15,55.0144,10155.5,20261,4327,72,11367,11367,7274,4920,4263
39126,14481,15241,37296,1830,37296,1830,5.39125e+18,94.6521,17758,39126,7294,111,23885,23885,23199,23834,22289
45546,1869,2831,45546,0,43689,1857,2.96994e+18,17.9861,3669.44,45546,1235,32,42715,42715,42715,42715,33200
22586,3510,5262,0,22586,7943,14643,2.53791e+15,59.9808,7014.99,22586,2559,72,17324,17324,14733,13173,11716
6022,9,10,5850,172,6016,6,1.3826e+14,9.92494,214.431,6022,10,10,5943,5850,5804,5803,5523
13042,3367,6032,12502,540,0,13042,1.58292e+18,91.2919,7049.68,13042,2905,110,7010,7010,6124,5564,4986
3904,780,1092,1403,2501,0,3904,9.57031e+12,58.2602,1536.44,3904,527,68,2812,2812,2531,2762,2371
31909,8,11,29269,2640,31907,2,1.16228e+14,7.53477,444.358,31909,11,8,31898,31897,30379,30379,31341
37765,3,6,36585,1180,37605,160,0.000132398,0.999841,458.293,37765,6,1,37759,37759,37759,37759,37759
22821,4346,5410,21493,1328,0,22821,2.22409e+18,97.6066,7419.52,22821,2616,110,17411,17411,16049,15713,14732
8514,693,2080,8014,500,8014,500,4.26392e+18,97.1367,3027.61,8514,970,108,6434,6434,3815,4583,2683
13077,2,13,12702,375,13006,71,1.39048e+14,10.9584,351.289,13077,13,12,7574,5370,5233,5550,4178
47074,6668,13639,0,47074,0,47074,6.0061e+17,96.6997,16983,47074,6609,110,33435,33435,27371,21108,17151
5637,1977,2545,5637,0,5360,277,3.99685e+18,91.0156,2994.95,5637,1015,93,3092,3092,2573,2819,2483
44476,5629,10422,0,44476,0,44476,6.47373e+17,97.8752,13811.8,44476,5053,110,34054,34054,27527,19505,19520
21171,505,4979,19933,1238,0,21171,2.23121e+18,97.5442,6876.11,21171,2407,110,16192,16192,10109,8925,2686
11190,1491,5762,2438,8752,0,11190,52598900000,8.97221,5972.71,11190,5178,11,5428,5428,2318,5428,2013
15586,431,709,0,15586,0,15586,3.82942e+18,15.9803,1171.47,15586,658,18,14877,14877,11309,12085,13224
1254,13,641,493,761,0,1254,6.77257e+12,37.2632,791.044,1254,303,40,234,60,49,0,0
34574,6485,9698,0,34574,0,34574,6.0849e+17,97.0477,12344.7,34574,4697,110,24876,24876,21444,18984,17511
2041,96,1128,2041,0,1953,88,3.8629e+18,61.2308,1343.61,2041,475,52,899,219,307,601,0
34583,1,16,33551,1032,34518,65,1.9271e+14,10.4658,640.719,34583,14,12,5332,5332,5332,5332,5332
24078,5523,5699,0,24078,0,24078,6.47207e+17,97.6236,7795.84,24078,2755,110,18379,18379,18163,18187,18113
39462,7069,9460,37164,2298,37164,2298,3.26259e+18,98.2956,12460,39462,4468,111,30002,30002,29159,30002,23168
48171,15475,18778,48171,0,45821,2350,4.34775e+18,1020.78,21324.4,48171,5716,142,29393,28693,29038,29383,28668
9209,707,2194,0,9209,0,9209,6.52699e+17,96.7405,3213.2,9209,1043,110,7015,7015,4345,3611,2740
48654,952,2045,0,48654,47224,1430,4.42692e+16,317.846,6755.09,48654,357,26,46609,46609,43581,42483,26865
38848,4901,14798,37018,1830,37018,1830,2.86949e+18,95.4895,17375.8,38848,7182,110,24050,24050,18686,20376,10008
15552,1410,7143,6081,9471,0,15552,6.98973e+12,42.1348,8147.11,15552,3457,72,8409,8409,6726,8119,4826
38765,8868,9567,36532,2233,36532,2233,4.00896e+18,98.1578,12504.8,38765,4523,111,29198,29198,28502,29147,27586
6980,82,424,0,6980,0,6980,3.77008e+18,15.9491,725.821,6980,296,18,6556,6556,3401,4082,3094
36965,1506,15751,35348,1617,35348,1617,8.54399e+18,94.7833,18087.7,36965,7645,110,21214,21214,17374,15473,4357
16560,365,3927,0,16560,0,16560,6.50858e+17,97.3502,5498.94,16560,1894,110,12633,12633,7811,3279,2014
24863,680,8799,24863,0,23473,1390,5.39513e+18,156.28,10020.2,24863,2790,130,16064,15810,8332,10833,1632
15627,1495,3730,14718,909,0,15627,2.2257e+18,97.2542,5235.14,15627,1794,110,11897,11897,8914,8396,5503
3391,1084,1628,3249,142,0,3391,1.60627e+18,78.0616,2002.74,3391,770,62,1763,1732,1068,943,329
45812,7999,10722,43142,2670,43142,2670,5.88997e+18,97.8989,14191.7,45812,5205,110,35090,35090,34415,34418,27152
2737,9,10,2654,83,2737,0,2.20079e+14,8.17647,150.425,2737,10,10,2716,2702,2693,2692,2644
13592,135,766,0,13592,13196,396,4.08638e+16,85.9012,2040.54,13592,100,26,12826,12721,11097,9995,5186
31582,1,5,30596,986,31454,128,0.000126654,0.999842,388.948,31582,5,1,31577,31577,31577,31577,31577
44136,26,1207,0,44136,42878,1258,3.55798e+16,251.015,4186.07,44136,190,26,42314,40702,32440,31081,7238
13436,2825,6046,13436,0,12796,640,6.00823e+18,136.019,6822.96,13436,2486,122,7390,7311,5688,6732,3729
37282,13434,15432,0,37282,14294,22988,1.93602e+15,57.1676,17539.7,37282,7515,72,21850,21850,21038,20437,19846
20063,2926,4735,18893,1170,0,20063,2.22999e+18,97.446,6557.12,20063,2282,110,15328,15328,12869,12434,10088
46544,13476,25354,10053,36491,0,46544,53091900000,8.98702,25775.6,46544,22814,11,21190,21190,13722,21190,13231
38565,88,208,38480,85,38565,0,6.07575e+18,203.382,2608.97,38565,183,174,32816,22608,16158,17125,16506
6529,337,687,0,6529,6332,197,5.12979e+16,18.9926,1564.3,6529,86,26,5842,5842,5377,5161,3313
27836,1754,7397,26278,1558,0,27836,2.13865e+18,97.2407,9668.32,27836,3585,110,20439,20439,13911,12380,6213
39933,9079,14348,14921,25012,0,39933,8.25151e+12,57.7252,16747.4,39933,6968,72,25585,25585,22437,25045,18803
47754,4871,17480,0,47754,0,47754,5.36115e+17,95.0457,20572.3,47754,8474,110,30274,30274,21865,13797,12474
49432,3106,3497,0,49432,9989,39443,1.45496e+16,11.9957,4216.38,49432,2007,14,45935,45935,43604,42396,44878
39090,14,15,37965,1125,39032,58,1.4981e+14,10.6409,644.905,39090,13,11,39075,39075,38828,38829,38453
44024,958,14074,44024,0,41462,2562,4.97643e+18,310.946,15935,44024,4404,136,29950,29392,11763,19162,2518
11311,2850,6861,11311,0,10941,370,5.03272e+18,160.259,7513.01,11311,3163,110,4450,4285,3046,3685,2045
36970,14695,16463,0,36970,14375,22595,1.83472e+15,56.6803,18466.9,36970,8020,72,20507,20507,19509,19659,18537
32806,581,8972,0,32806,0,32806,6.14144e+17,97.1151,11534.6,32806,4342,110,23834,23752,10126,3429,3349
9835,135,176,9828,7,9835,0,6.07842e+18,166.239,1226.91,9835,121,119,9380,8756,7453,7526,7512
40559,15,18,39366,1193,40440,119,1.78584e+14,10.5124,686.54,40559,14,12,40541,40541,40127,40129,37957
8704,2080,2597,0,8704,0,8704,6.01063e+17,91.2261,3517.39,8704,1240,104,6107,6107,5527,5618,4881
45793,12473,19339,43782,2011,0,45793,1.68155e+18,94.8829,22116.5,45793,9397,110,26454,26454,21784,20924,16661
43186,234,2884,43186,0,41433,1753,2.9645e+18,18.0815,3698,43186,1769,32,40302,40301,27875,31494,15238
48214,755,1284,0,48214,46840,1374,3.55595e+16,261.635,4511.75,48214,206,26,46930,46930,41029,41928,33756
18486,4483,5604,17506,980,17506,980,6.89616e+18,96.3823,7205.32,18486,2702,110,12882,12882,12731,12732,11400
45168,17249,20020,0,45168,0,45168,4.70707e+17,94.5241,22692.5,45168,9719,110,25148,25148,23785,22750,22539
40429,3026,10609,0,40429,0,40429,6.24522e+17,97.4069,13659.3,40429,5148,110,29820,29820,17579,13160,9383
47969,1127,1280,0,47969,46602,1367,3.55654e+16,262.186,4495.89,47969,204,26,46689,46689,46261,46245,43557
17538,268,714,0,17538,17037,501,3.5544e+16,40.8056,2001.87,17538,91,26,16824,16802,15266,15342,8143
10530,1804,2523,3709,6821,0,10530,9.90604e+12,59.6422,3484.38,10530,1229,72,8007,8007,6962,7820,5855
2743,1045,1366,2743,0,0,2743,8.78224e+17,17.716,1504.84,2743,1214,20,1377,1377,1089,1301,1112
38307,8606,10197,36170,2137,0,38307,2.13468e+18,97.3102,13109.8,38307,4944,110,28110,28110,26133,25678,24193
16994,6,12,16501,493,16986,8,1.5952e+14,9.81258,382.621,16994,12,11,16262,15960,12695,12819,11396
790,40,187,790,0,790,0,6.09005e+18,88.7873,353.8,790,49,40,404,148,146,130,122
20023,5042,11338,8218,11805,0,20023,5.59885e+12,54.6405,12366,20023,5513,72,8685,8685,7021,8311,4741
37104,3781,8639,13042,24062,0,37104,9.88768e+12,60.0581,11255.2,37104,4201,72,28465,28465,21436,26813,12805
10825,7,11,10513,312,10820,5,1.53934e+14,10.1332,300.041,10825,11,11,10473,10167,8010,7826,7977
23916,2526,12508,23916,0,22996,920,4.99304e+18,340.773,13787.5,23916,4125,134,11408,10801,6407,7775,2424
9583,152,446,9185,398,2817,6766,1.31898e+18,16.9647,815.807,9583,409,19,9137,9137,7797,8089,5032
40201,130,176,40122,79,40201,0,5.9826e+18,172.163,2377.11,40201,170,171,38412,35907,29615,29898,29397
511,30,207,481,30,0,511,2.24116e+18,70.9217,308.224,511,76,34,151,21,65,89,42
22420,2053,5288,21118,1302,0,22420,2.22957e+18,97.5202,7273.8,22420,2544,110,17132,17132,12785,11912,7594
26746,360,837,0,26746,25910,836,0.031257,0.968706,4730.54,26746,837,1,25909,25909,25909,25909,25909
48569,6571,17381,46196,2373,46196,2373,7.55791e+18,95.93,20540.4,48569,8444,110,31188,31102,26265,25445,6204
3885,328,1009,0,3885,1369,2516,2.46244e+15,58.4201,1462.18,3885,485,66,2876,2876,1880,859,826
16002,48,175,15996,6,16002,0,5.97823e+18,165.33,1498.57,16002,142,151,9972,4799,3711,4533,4436
30530,4948,7953,0,30530,0,30530,6.27094e+17,97.3442,10406.4,30530,3856,110,22577,22577,18847,14907,14638
26842,88,1291,0,26842,26053,789,4.40662e+16,267.109,3959.99,26842,205,26,24963,24787,19945,16384,5905
5003,1658,1780,5003,0,4715,288,5.91407e+18,90.8497,2241.03,5003,636,94,3223,3223,3161,3194,3166
32176,5869,16633,0,32176,0,32176,3.45187e+15,17.9258,17138.5,32176,14954,20,15543,15543,5883,6412,5556
7035,1431,2217,0,7035,0,7035,5.85465e+17,94.9846,2995.31,7035,1048,103,4818,4818,4622,4433,4513
21884,1401,9636,0,21884,0,21884,4.75581e+17,94.2633,11175.3,21884,4671,110,12248,12248,7914,3406,3429
49853,10723,14275,47153,2700,0,49853,2.07558e+18,97.0615,17788.4,49853,6921,110,35578,35578,32777,31489,28251
14733,2172,3475,5173,9560,0,14733,9.91409e+12,59.82,4724.82,14733,1692,72,11258,11258,9672,10928,7156
37465,16,176,37386,79,37465,0,5.98302e+18,169.726,2292.17,37465,168,170,12827,2123,2760,3274,3203
48876,8501,11379,0,48876,17184,31692,2.53538e+15,60.0865,14655.6,48876,5543,72,37497,37497,34055,29486,28398
25369,2646,5916,8908,16461,0,25369,9.88093e+12,59.9307,7837.27,25369,2870,72,19453,19453,14745,18642,9083
32844,12543,13104,32844,0,31154,1690,4.94102e+18,222.393,14541.1,32844,3931,134,19740,19739,19739,19740,19132
13834,2818,3586,4922,8912,0,13834,9.57646e+12,58.0223,4753.91,13834,1724,72,10248,10248,9390,10068,8130
10930,173,176,10924,6,10930,0,6.00706e+18,164.177,1253.12,10930,128,132,10752,10743,10566,10548,10568
7260,601,3186,2811,4449,0,7260,7.33055e+12,56.1952,3769.51,7260,1544,72,4074,4026,2942,3631,2083
33227,6202,7787,31290,1937,0,33227,2.22922e+18,97.8133,10481.8,33227,3775,110,25440,25440,23284,22988,20900
12515,12,13,12151,364,12475,40,1.63667e+14,10.6575,356.878,12515,12,11,12502,12501,12402,12402,12318
6388,860,1625,0,6388,0,6388,6.41836e+17,95.8007,2393.38,6388,769,94,4763,4763,3809,2509,3067
2502,55,933,2502,0,2361,141,5.98683e+18,87.028,1230.2,2502,313,66,1044,238,485,852,129
15405,354,3657,14505,900,14505,900,5.88356e+18,97.3814,5149.57,15405,1763,110,11748,11748,10421,9396,1971
38307,2180,9001,0,38307,0,38307,6.47977e+17,97.8581,12011.7,38307,4365,110,29306,29306,15860,9577,8561
41243,6,14,40058,1185,41163,80,1.46876e+14,10.504,647.911,41243,13,12,39227,38259,29714,29361,25922
44454,937,1631,0,44454,43165,1289,4.08301e+16,299.383,5433.73,44454,275,26,42823,42823,38615,39144,30022
9993,833,856,0,9993,9694,299,5.14347e+16,153.31,2167.86,9993,120,26,9137,9137,9105,9103,9022
40557,11585,18777,40557,0,38965,1592,5.15968e+18,2124.65,21472.7,40557,7924,144,21780,19621,17137,19121,12277
10133,895,3336,3724,6409,0,10133,8.71605e+12,58.1272,4187.28,10133,1617,72,6797,6797,3749,5843,1173
32062,1428,11173,30472,1590,30472,1590,7.40256e+18,94.7873,13487,32062,5400,110,20889,20889,17313,14810,4512
2759,510,788,0,2759,0,2759,6.32083e+17,92.7477,1195.97,2759,360,66,1971,1971,1684,1459,1662
6521,36,176,6515,6,6521,0,6.04174e+18,158.458,992.94,6521,108,108,3657,1150,1264,1539,1293
24817,4266,10482,24817,0,23587,1230,4.63555e+18,195.102,11674.2,24817,4323,125,14335,14281,9748,11967,5795
988,16,58,988,0,947,41,2.26103e+18,16.6508,165.415,988,50,18,852,448,811,810,375
22074,6448,6792,20911,1163,20911,1163,3.07558e+18,96.3932,8612.42,22074,3285,110,15282,15282,14960,15182,14588
5883,139,1407,0,5883,2057,3826,2.53762e+15,59.2356,2032.22,5883,680,72,4476,4476,1408,758,468
36871,6984,14059,36871,0,33492,3379,4.81375e+18,272.049,15654.8,36871,3331,137,22812,22662,16011,18621,12081
36716,644,10439,34721,1995,0,36716,2.08398e+18,96.42,13200.8,36716,5060,110,26277,26095,9989,6863,1465
17525,2281,4606,16537,988,0,17525,2.15553e+18,96.9988,6208.98,17525,2219,110,12919,12919,10976,10017,8006
41795,12,15,40582,1213,41708,87,1.57928e+14,10.4331,673.114,41795,14,12,41779,41774,40157,40156,39315
29992,2157,7058,28249,1743,0,29992,2.22668e+18,97.7201,9543.92,29992,3414,110,22934,22934,14039,12821,8094
9141,1732,2938,8662,479,0,9141,1.99727e+18,95.3633,3869.3,9141,1407,105,6203,6203,5033,4735,4069
34577,15750,17752,7536,27041,0,34577,52592800000,8.80267,18129.6,34577,15970,11,16825,16825,15827,16825,15839
38398,49,176,38292,106,38398,0,6.18043e+18,173.069,2403.39,38398,159,162,27387,11620,10656,10873,10878
38097,342,22086,36867,1230,36867,1230,3.78825e+18,92.7533,23941,38097,10658,111,16011,14535,8465,7212,1699
13954,1681,4794,0,13954,5175,8779,2.18115e+15,58.1137,5863.16,13954,2335,72,9160,9160,6372,2850,3183
48659,652,1404,0,48659,47266,1393,3.68751e+16,274.854,4879.55,48659,230,26,47255,46404,38968,40109,28085
9958,3041,4900,9958,0,0,9958,8.77002e+17,17.9274,5181.2,9958,4399,20,5058,5058,3225,3391,3192
30301,1260,1379,0,30301,29410,891,4.34924e+16,260.337,4306.32,30301,224,26,28922,28922,28705,28690,27492
15534,815,5188,5732,9802,0,15534,8.63758e+12,58.2747,6360.18,15534,2527,72,10346,10298,6518,9686,1987
39855,4757,16973,38115,1740,0,39855,1.67189e+18,93.5553,19457.2,39855,8227,110,22882,22882,15925,14391,8182
41566,12571,13687,39446,2120,0,41566,1.95184e+18,96.2878,16583.1,41566,6649,110,27879,27879,27629,27441,27492
26855,5052,6504,25293,1562,25293,1562,4.92767e+18,98.1056,8724.68,26855,3066,111,20351,20351,19893,20351,16627
49847,621,1718,0,49847,48400,1447,4.01668e+16,301.037,5834.77,49847,291,26,48129,46897,43982,41942,24730
42186,2,6,40868,1318,42026,160,0.000118523,0.999858,499.178,42186,6,1,42180,42180,42180,42180,42180
26193,7947,13646,0,26193,10534,15659,1.59219e+15,55.4349,15004.5,26193,6648,72,12547,12547,10881,8575,8262
20212,1938,5215,7187,13025,0,20212,9.59369e+12,59.5209,6776.81,20212,2536,72,14997,14997,10885,14288,6004
42069,1,8,41425,644,42005,64,9.62136e+13,3.99803,526.846,42069,6,4,17426,17426,17426,17426,17426
14104,1977,3633,13304,800,13304,800,3.26789e+18,96.9405,5005.7,14104,1749,110,10471,10471,8801,9966,5655
29167,34,206,29158,9,29167,0,5.97915e+18,187.22,2094.05,29167,169,167,15495,4710,4725,6164,4884
49785,2974,11639,46887,2898,46887,2898,3.2343e+18,97.9095,15350.3,49785,5641,110,38146,38146,23501,30686,11558
30354,8293,11337,11414,18940,0,30354,8.0672e+12,57.4866,13226.1,30354,5507,72,19017,19017,17201,18637,14296
34336,13663,14671,13246,21090,0,34336,7.37482e+12,56.9222,16611.7,34336,7133,72,19665,19665,19423,19624,19272
38213,4,14,37122,1091,38133,80,1.39077e+14,10.593,602.719,38213,13,12,33350,29705,24895,25458,16830
48874,32,176,48799,75,48874,0,6.09696e+18,173.497,2739.14,48874,174,172,26414,7987,8899,8943,8952
47079,544,16983,44791,2288,44791,2288,2.89083e+18,95.8787,20056.5,47079,8244,110,30096,29387,17915,18923,3607
39036,23,176,38956,80,39036,0,6.00415e+18,173.018,2384.53,39036,169,172,16794,3465,4578,5120,4910
4324,695,1051,1512,2812,0,4324,9.82089e+12,58.7951,1548.45,4324,505,69,3273,3273,2845,3183,2322
45992,14729,26936,0,45992,0,45992,3.51943e+17,92.3044,29086.4,45992,13104,110,19056,19056,16310,13308,11919
42050,11,15,40841,1209,41994,56,1.49232e+14,10.535,666.332,42050,13,11,42035,42033,36633,36748,34711
45930,12362,14027,43502,2428,0,45930,2.02142e+18,96.7605,17242.6,45930,6815,110,31903,31903,30314,29648,27952
14149,304,5585,13489,660,13489,660,3.27466e+18,94.1529,6753.22,14149,2646,111,8564,8216,4481,4547,951
30188,471,1076,0,30188,29652,536,2.56933e+16,3.7342,4130.94,30188,540,4,29112,29112,28359,28080,19280
12387,1084,4941,4708,7679,0,12387,7.79297e+12,57.13,5852.37,12387,2402,72,7446,7398,5134,7048,2500
16723,9,12,16229,494,16709,14,1.77708e+14,10.4358,389.312,16723,12,11,16549,16386,15945,15796,14598
31305,10074,17440,0,31305,0,31305,3.49351e+15,17.977,17910.1,31305,15680,20,13865,13865,8169,12128,8094
21731,11749,21731,21731,0,21731,0,34358200000,0,21731,21731,21731,1,0,0,0,0,0
40001,11705,11782,37841,2160,37841,2160,4.10632e+18,97.4669,14645.7,40001,5614,111,28219,28219,28124,28158,28173
18234,258,9893,17595,639,0,18234,1.34376e+18,90.7557,11048.5,18234,4798,110,8341,7306,4461,3469,806
45165,3852,10667,42545,2620,0,45165,2.22025e+18,97.8449,14093.7,45165,5172,110,34498,34498,25375,23581,14158
30117,7485,11222,30117,0,28536,1581,5.28278e+18,196.756,12785.7,30117,4586,133,18895,18833,17148,18309,14403
10711,10,11,10402,309,10705,6,1.47504e+14,10.1782,295.432,10711,11,11,10680,10647,10455,10456,10090
46930,581,16268,0,46930,17433,29497,2.15874e+15,58.2842,19045.2,46930,7925,72,30662,30252,17788,8280,2139
49448,1571,20590,47258,2190,0,49448,1.69761e+18,94.9981,23565.9,49448,9998,110,28858,28858,16535,14072,2518
45549,8372,18200,43469,2080,0,45549,1.74842e+18,95.2525,21049,45549,8844,110,27349,27349,20294,18634,12389
3199,109,186,3197,2,3199,0,5.96877e+18,153.212,682.794,3199,86,81,2829,2255,1793,1858,1820
7512,668,1819,7073,439,0,7512,2.23174e+18,96.268,2693.01,7512,862,101,5693,5693,3805,3478,2507
24797,11700,12418,23850,947,0,24797,1.46052e+18,92.9659,13971,24797,6026,110,12379,12379,11643,11466,11268
3140,3,11,3045,95,3134,6,1.70319e+14,10.7659,164.473,3140,11,11,2437,1844,1754,2007,1311
26954,6129,7514,25473,1481,0,26954,2.10336e+18,96.9419,9698.16,26954,3633,110,19440,19440,17647,17248,15789
33506,8118,10536,0,33506,0,33506,5.80267e+17,96.509,13023,33506,5109,110,22970,22970,20648,19245,18094
24505,6843,8232,23265,1240,23265,1240,7.36913e+18,96.0603,10142.5,24505,3993,110,16273,16273,16053,16053,14023
36762,3345,14683,14002,22760,0,36762,7.73892e+12,57.3947,16810.4,36762,7148,72,22079,22031,13630,20622,3412
30925,5542,7221,0,30925,10872,20053,2.5308e+15,60.0397,9476.57,30925,3517,72,23704,23704,21341,18403,18608
46750,6895,19319,0,46750,0,46750,4.96049e+17,95.0215,22177.3,46750,9381,110,27431,27431,20945,16934,12739
16559,445,3935,15595,964,15595,964,5.92451e+18,97.3118,5508.15,16559,1896,110,12624,12624,11266,10240,2231
30612,7,14,29739,873,30540,72,1.38972e+14,10.5347,518.788,30612,13,12,29534,28800,25480,25433,21178
21133,592,5048,0,21133,0,21133,6.44368e+17,97.4306,6940.04,21133,2433,110,16085,16085,6100,3455,2647
14479,3798,5129,13752,727,13752,727,1.66191e+18,96.0219,6368.46,14479,2441,111,9350,9350,9350,9338,7118
4332,4,11,4206,126,4327,5,1.61465e+14,10.5411,192.117,4332,11,11,3773,3367,2632,2835,1915
12279,641,901,0,12279,11911,368,4.85607e+16,172.409,2381.38,12279,129,26,11378,11131,11032,11040,9576
39142,9817,17334,39142,0,37332,1810,4.64491e+18,486.401,19108.2,39142,4787,140,21808,21596,17777,18659,13834
42310,5919,10132,0,42310,14916,27394,2.50754e+15,59.9632,13024.4,42310,4929,72,32178,32178,27483,21358,19676
22342,604,5214,7852,14490,0,22342,9.92057e+12,59.9544,6947.75,22342,2540,72,17128,17128,6328,14144,2264
39299,8823,9397,37029,2270,0,39299,2.21238e+18,97.7467,12458.1,39299,4545,110,29902,29902,29158,29021,28543
42316,360,2687,40593,1723,12988,29328,1.35456e+18,16.9946,3478.24,42316,1624,27,39629,39629,27032,21204,15768
31464,5105,7357,11060,20404,0,31464,9.87859e+12,60.0057,9641.53,31464,3578,72,24107,24107,20775,23527,16828
13103,5,6,12877,226,13071,32,9.95248e+13,3.99534,254.691,13103,5,4,13097,13097,13097,13096,10979
31833,12147,12183,30340,1493,30340,1493,2.89928e+18,95.3679,14388.2,31833,5902,110,19650,19650,19624,19640,19649
941,525,675,911,30,911,30,3.27486e+18,34.2997,765.166,941,286,42,266,266,101,154,77
42991,17,18,41718,1273,42889,102,1.78813e+14,10.5142,736.343,42991,14,12,42973,42973,42889,42889,42836
9451,2255,3241,9451,0,8904,547,4.36056e+18,92.1961,3918.43,9451,1156,117,6210,6210,5279,5667,4882
34295,2273,12140,0,34295,0,34295,5.46902e+17,95.8562,14559.4,34295,5889,110,22155,22155,14607,7751,5886
29629,1134,7998,0,29629,10597,19032,2.40676e+15,59.4208,10093.3,29629,3888,72,21631,21631,13519,3878,3669
17397,2224,4228,16383,1014,16383,1014,4.78402e+18,97.813,5825.47,17397,1983,111,13169,13169,9365,10186,7516
22838,2,6,22451,387,22806,32,9.89439e+13,3.99702,344.734,22838,5,4,17282,14808,16045,14808,10843
17712,62,757,0,17712,17204,508,3.68465e+16,80.4866,2137.49,17712,100,26,16917,16872,13859,13552,4365
37920,640,9091,35712,2208,35712,2208,3.91838e+18,98.282,11998.5,37920,4297,111,28829,28829,12669,18395,3831
42596,6474,21989,41016,1580,41016,1580,2.27733e+18,92.4744,24235.9,42596,10612,111,20607,20607,19602,19776,7361
25618,654,1021,0,25618,24879,739,3.90525e+16,208.133,3146.15,25618,153,26,24597,24205,22436,22861,19267
29430,4,14,28588,842,29355,75,1.42239e+14,10.6318,534.187,29430,13,12,25763,23076,22097,20857,13223
42389,1,18,41134,1255,42279,110,1.80045e+14,10.4832,723.031,42389,15,13,7560,7560,7560,7560,7560
38222,316,14525,14428,23794,0,38222,7.99869e+12,57.7157,16778.1,38222,7069,72,23697,23313,7396,18948,1384
35393,3785,8247,12441,22952,0,35393,9.8857e+12,60.0534,10764.7,35393,4011,72,27146,27146,20661,26026,12803
48018,215,296,47760,258,48018,0,5.61823e+18,242.05,1661.92,48018,273,42,47367,46056,46527,47069,40320
15907,243,5310,15907,0,14984,923,6.24638e+18,128.359,6246.85,15907,1842,126,10597,10549,3871,6853,899
13208,494,565,0,13208,12832,376,3.55924e+16,20.0302,1564.86,13208,75,26,12643,12643,12495,12477,11770
41935,9000,17047,16027,25908,0,41935,7.65496e+12,57.3255,19392.2,41935,8304,72,24888,24888,20097,24068,14470
12572,412,527,0,12572,12212,360,3.54213e+16,20.0817,1474.48,12572,72,26,12045,12045,11809,11831,10017
20408,711,772,0,20408,19828,580,3.56969e+16,95.4054,2256.76,20408,103,26,19636,19636,19485,19469,18659
24740,3274,11782,0,24740,9750,14990,1.73408e+15,56.1303,13176.9,24740,5737,72,12958,12958,8817,5094,4204
5409,248,1298,1902,3507,0,5409,9.86571e+12,59.0882,1884.75,5409,627,72,4111,4111,2580,3845,872
43893,14823,21810,42213,1680,42213,1680,2.45408e+18,92.7159,24226,43893,10583,110,22083,22083,18343,21159,13016
12943,4304,4527,12943,0,12203,740,4.01441e+18,114.179,5342.58,12943,1666,118,8416,8416,8301,8363,8235
32404,11,14,31481,923,32326,78,1.38931e+14,10.7578,559.322,32404,13,12,32388,32382,30828,30845,30783
33162,10935,16783,0,33162,0,33162,3.43863e+15,17.9845,17302.8,33162,15097,20,16379,16379,10797,16379,10598
25374,8917,9592,24164,1210,24164,1210,4.40009e+18,96.0017,11427.7,25374,4597,111,15782,15782,14679,14846,14508
25475,4,13,24749,726,25401,74,1.39097e+14,10.8335,491.976,25475,12,12,22288,19962,16641,17021,11590
49354,6432,26880,49354,0,49354,0,1.47811e+18,17.9367,27487.1,49354,24176,20,22474,22474,5803,22474,5849
13389,1261,4497,13389,0,12610,779,4.93257e+18,110.058,5335.81,13389,1616,120,8892,8872,5376,6716,2973
21169,792,1209,0,21169,20541,628,4.69401e+16,241.976,3555.56,21169,191,26,19960,19960,19204,18930,15630
23501,71,5481,0,23501,8255,15246,2.53472e+15,59.9564,7289.7,23501,2662,72,18020,12008,4401,3927,537
31069,6152,9556,29429,1640,0,31069,2.01821e+18,96.576,11918.5,31069,4636,110,21513,21513,18036,17348,14185
20272,105,176,20198,74,20272,0,6.00123e+18,170.596,1724.89,20272,156,154,18380,12549,11258,11801,12214
48652,3005,20433,48652,0,46615,2037,4.83407e+18,2864.03,23856.4,48652,7948,151,27224,23420,13926,19026,4791
39452,3247,9166,13865,25587,0,39452,9.90181e+12,60.0802,11916.9,39452,4465,72,30286,30286,19717,27604,11040
45942,2852,12707,43412,2530,43412,2530,6.51805e+18,97.1954,16028.6,45942,6173,110,33235,33235,31171,29258,8074
7409,2,12,7190,219,7399,10,1.78823e+14,10.4472,256.504,7409,12,11,4439,3500,2139,2263,1745
34007,11,14,33036,971,33930,77,1.38855e+14,10.6432,572.437,34007,13,12,33991,33982,30175,30250,30524
23053,2505,7183,23053,0,21716,1337,3.55001e+18,162.698,8535.12,23053,2464,128,15870,15737,11078,12553,5908
31526,11,12,30627,899,31512,14,1.3897e+14,10.2454,501.904,31526,12,11,31514,31514,30769,30770,30124
13263,130,4673,12603,660,12603,660,4.5712e+18,95.8551,5842.59,13263,2220,111,8590,4445,3611,4410,1047
49377,11,15,47950,1427,49284,93,1.55801e+14,10.4144,719.89,49377,13,13,49360,49355,43415,43517,39930
30518,7065,7179,0,30518,0,30518,6.47413e+17,97.7045,9697.63,30518,3475,110,23339,23339,23212,23230,23225
12689,1332,3049,11949,740,0,12689,2.22582e+18,97.0236,4336.09,12689,1465,110,9640,9640,7298,6823,4658
22184,7482,10642,21302,882,0,22184,1.52482e+18,93.6733,12114.3,22184,5162,110,11542,11542,10127,9329,8078
44398,875,1207,0,44398,43133,1265,3.55127e+16,248.88,4192.29,44398,190,26,43191,43191,40329,40892,36104
45006,3,14,43714,1292,44926,80,1.45722e+14,10.4712,661.247,45006,13,12,34402,24708,27330,28749,18148
34302,4335,8192,34302,0,34302,0,4.40231e+15,6235.59,16746.1,34302,8192,5,14539,0,5290,14537,14539
12307,2552,4119,11676,631,11676,631,4.48097e+18,96.0586,5247.02,12307,1945,111,8188,8188,7248,8127,6147
19904,5366,8183,0,19904,7612,12292,1.94428e+15,57.1061,9476.48,19904,3981,72,11721,11721,9675,10023,7410
28086,4403,15755,0,28086,11498,16588,1.45524e+15,54.8136,17098.4,28086,7675,72,12331,12331,7210,4134,3228
32784,78,208,32701,83,32760,24,6.0758e+18,202.6,2406.01,32784,175,169,26350,17162,11920,13032,12003
26982,4881,13540,26982,0,0,26982,8.79184e+17,17.9732,14009.3,26982,12178,20,13442,13442,5358,10352,5068
20162,4520,7041,19162,1000,0,20162,1.90072e+18,95.6899,8664.73,20162,3404,110,13121,13121,11429,10564,8890
42833,13357,20550,41140,1693,41140,1693,9.48357e+18,92.8673,22980.4,42833,9973,110,22283,22283,21573,21573,13953
30409,10015,11534,11474,18935,0,30409,8.04275e+12,57.6966,13406.6,30409,5618,72,18875,18875,18081,18705,16952
18237,2714,6473,0,18237,6805,11432,2.13784e+15,57.9733,7768.34,18237,3148,72,11764,11764,9009,7357,5840
20331,4814,4852,0,20331,0,20331,6.46041e+17,97.4629,6689.85,20331,2339,110,15479,15479,15450,15455,15469
41750,3484,19695,41750,0,28439,13311,4.90216e+18,3672.05,23790.3,41750,6827,145,19646,15709,8178,11313,5534
49241,9631,11453,46368,2873,46368,2873,3.23077e+18,97.9247,15134.4,49241,5552,110,37788,37788,35942,37231,32482
27956,1354,6702,26326,1630,26326,1630,3.38684e+18,98.1622,8997.71,27956,3161,111,21254,21254,11046,14367,5571
17896,7391,7542,6885,11011,0,17896,7.49762e+12,45.0869,8717.12,17896,3668,72,10354,10354,10174,10314,10039
43761,8350,17206,43761,0,40893,2868,9.42281e+17,8115.06,25873.1,43761,7784,16,22538,2869,13494,14655,16919
20488,5,12,19886,602,20472,16,1.6728e+14,10.0783,421.072,20488,11,12,18962,17069,14674,14173,12173
30217,3,14,29348,869,30166,51,1.51948e+14,10.6643,558.228,30217,13,11,23264,16857,18355,18798,11936
8657,901,3851,8287,370,0,8657,1.64041e+18,92.7275,4625.62,8657,1851,103,4806,4720,3069,2670,1582
1172,261,321,0,1172,414,758,2.59659e+15,55.3635,508.692,1172,150,46,851,851,773,750,768
18921,1277,6338,18921,0,17853,1068,3.32709e+18,151.686,7503.64,18921,2494,121,12583,12487,6854,8841,2350
37536,1785,8192,37536,0,37536,0,4.70835e+15,6404.15,17509.6,37536,8192,6,7136,0,5346,7129,7136
35756,11,1051,0,35756,34734,1022,3.55411e+16,217.803,3505.53,35756,159,26,31799,29592,25875,24800,5549
42204,11429,16792,42204,0,37404,4800,1.6515e+18,4614.19,23777,42204,7782,24,25412,20438,22700,22424,21950
45207,3,15,43902,1305,45122,85,1.55236e+14,10.3929,691.435,45207,13,13,34798,25513,27102,28136,14182
38522,3175,9074,36286,2236,36286,2236,5.7707e+18,97.7781,12094.4,38522,4394,110,29448,29448,25917,25347,11674
30068,6896,9992,28538,1530,28538,1530,3.03316e+18,96.1584,12232.6,30068,4840,110,20076,20076,18280,19608,15656
40387,1196,16016,38534,1853,38534,1853,8.11294e+18,95.2792,18622.6,40387,7786,110,24371,24371,18902,15343,3033
1459,371,416,0,1459,0,1459,6.61106e+17,89.3934,672.808,1459,184,52,1043,1043,1009,1013,1029
16918,1722,4485,15968,950,15968,950,6.30407e+18,96.9691,6043.24,16918,2167,110,12433,12433,11800,11803,4983
18252,7014,8139,7096,11156,0,18252,7.18855e+12,56.5296,9288.52,18252,3963,72,10113,10113,9899,10075,9850
14317,1285,3420,13480,837,0,14317,2.22906e+18,97.2445,4826.64,14317,1646,110,10897,10897,7429,6847,4600
3783,105,965,0,3783,0,3783,6.57092e+17,94.3788,1490.45,3783,447,79,2818,1205,883,429,388
41488,15966,18722,41453,35,37338,4150,4.94414e+18,1483.8,21182.8,41488,6954,144,22766,21762,22131,22459,20759
47412,11811,20750,0,47412,0,47412,4.76589e+17,94.3901,23544.1,47412,10074,110,26662,26662,21945,18891,14061
6587,1558,1590,0,6587,0,6587,6.58984e+17,96.2215,2384.27,6587,755,96,4997,4997,4971,4976,4991
27466,7227,8404,26016,1450,26016,1450,6.93371e+18,96.5712,10561.4,27466,4070,110,19062,19062,18822,18822,16552
37633,5120,8836,13232,24401,0,37633,9.85404e+12,59.9299,11475.3,37633,4285,72,28797,28797,24349,27867,16936
41490,9769,10483,0,41490,14729,26761,2.46972e+15,59.7561,13283.5,41490,5105,72,31007,31007,29953,29364,28848
35915,10584,11561,35915,0,33875,2040,4.40512e+18,253.553,13410,35915,4623,126,24354,24354,23657,24038,22740
33528,1327,10635,0,33528,12281,21247,2.25653e+15,58.6972,12824.2,33528,5177,72,22893,22893,12157,6639,4723
12156,3,13,11811,345,12087,69,1.3907e+14,10.9051,327.775,12156,12,12,9318,6570,7726,7415,5094
19446,42,175,19378,68,19446,0,5.98131e+18,165.846,1650.52,19446,156,153,11405,4446,3925,4977,4667
2325,908,952,2215,110,0,2325,1.82067e+18,74.228,1269.1,2325,434,56,1373,1373,1352,1354,1365
47417,12543,16216,45029,2388,45029,2388,5.8967e+18,96.7787,19308.4,47417,7759,111,31201,31201,31201,30419,24420
13934,2324,3334,13124,810,0,13934,2.22591e+18,97.1547,4717.21,13934,1598,110,10600,10600,9250,9031,7878
1983,394,579,1872,111,1872,111,6.12402e+18,89.1694,899.902,1983,251,56,1404,1404,1369,1372,1201
13323,2375,5208,12693,630,12693,630,4.34848e+18,93.883,6327.77,13323,2467,111,8115,8115,5701,6090,5368
31131,8094,8824,29431,1700,29431,1700,6.46047e+18,96.9667,11255.3,31131,4272,110,22307,22307,21859,21798,20454
9296,2134,4760,9296,0,9296,0,2.18084e+18,18.9391,5032.82,9296,2832,23,4536,4536,2737,2442,2122
11286,438,3653,11286,0,10634,652,3.58058e+18,94.1482,4485.14,11286,1373,117,7633,7633,3898,5523,1289
22226,2,176,22155,71,22226,0,5.98948e+18,169.774,1784,22226,155,161,1103,32,20,31,129
12072,2141,2854,11369,703,11369,703,5.84087e+18,96.9885,4100.4,12072,1369,110,9218,9218,9038,9038,7406
8044,1011,1979,0,8044,0,8044,6.50334e+17,96.554,2894.68,8044,945,104,6065,6065,4832,3575,3683
2395,3,122,0,2395,2327,68,3.6435e+16,19.3324,358.883,2395,35,26,1467,977,876,982,410
24984,4368,8175,24984,0,23531,1453,4.50651e+18,165.823,9425.35,24984,2973,124,16809,16809,12587,14468,9436
38724,129,208,38663,61,38724,0,6.08425e+18,203.131,2614.32,38724,181,175,36097,33423,23339,24211,24000
29528,84,1167,0,29528,28674,854,3.99992e+16,229.044,3682.31,29528,182,26,27910,27752,22957,20423,6550
24832,1138,9672,9416,15416,0,24832,7.86604e+12,56.8628,11252.4,24832,4697,72,15160,15064,9141,14130,1980
3338,861,864,3145,193,3145,193,5.87086e+18,93.6905,1345.25,3338,390,72,2474,2474,2474,2474,2474
4413,26,176,4410,3,4413,0,6.06074e+18,152.69,818.778,4413,92,91,2058,554,620,650,675
26431,1726,6182,24891,1540,24891,1540,5.87195e+18,97.6991,8440.88,26431,2987,110,20249,20249,19076,18328,6826
10175,533,4362,9725,450,9725,450,8.49932e+18,93.922,5250.66,10175,2103,103,5813,5565,4907,4452,1855
33687,1229,1414,0,33687,32704,983,4.22609e+16,270.301,4509.58,33687,232,26,32273,32273,31981,31992,30407
1528,7,10,1481,47,1528,0,1.79606e+14,8.4712,113.392,1528,10,10,1483,1447,1232,1236,1283
30604,3390,7201,28824,1780,28824,1780,3.2193e+18,97.7134,9724.79,30604,3478,110,23403,23403,18930,21761,12006
36589,3405,11850,34708,1881,34708,1881,7.21872e+18,96.3814,14485.3,36589,5751,110,24739,24739,23319,23284,7515
18332,47,176,18323,9,18332,0,6.06579e+18,169.758,1669.82,18332,148,147,11886,5103,4402,5152,4739
4516,112,1211,4256,260,4256,260,1.23086e+18,94.0952,1798.61,4516,544,86,3305,1449,840,1113,125
18361,4435,5844,6721,11640,0,18361,8.83402e+12,58.5429,7200.62,18361,2843,72,12517,12517,11706,12347,10528
17142,1359,7133,6568,10574,0,17142,7.5305e+12,55.6741,8278.69,17142,3453,72,10009,10009,6414,9389,2187
5894,230,2268,5614,280,5614,280,4.03502e+18,93.982,2896.56,5894,1061,86,3626,3465,1374,2139,1015
44156,4,208,44090,66,44156,0,6.08357e+18,203.198,2795.05,44156,186,178,5196,987,544,461,720
35713,12,16,34648,1065,35645,68,1.94257e+14,10.4025,665.03,35713,13,12,35697,35696,33964,34004,30766
48080,10969,11247,45282,2798,0,48080,2.22684e+18,97.8988,14855.3,48080,5455,110,36833,36833,36531,36464,36307
43192,40767,43192,0,43192,43192,0,2047.95,0,43192,43192,43192,1,0,0,0,0,0
5844,161,170,5839,5,5844,0,5.97215e+18,157.044,901.107,5844,107,107,5647,5557,5423,5413,5424
5289,2150,2167,2014,3275,0,5289,7.70746e+12,56.4224,2647.84,5289,1050,71,3122,3122,3110,3118,3109
766,241,247,0,766,264,502,2.27258e+15,51.4008,378.379,766,108,39,519,519,519,519,519
32169,5286,7556,0,32169,0,32169,6.48777e+17,97.7487,10178.1,32169,3659,110,24613,24613,22099,20861,18097
14633,299,620,0,14633,14214,419,3.55881e+16,20.1726,1715.47,14633,81,26,14013,14013,13124,13168,8012
47658,9923,11427,44888,2770,44888,2770,3.80605e+18,98.3577,14910.1,47658,5417,111,36231,36231,33432,34044,32408
8016,1182,2647,6695,1321,7596,420,2.73811e+18,95.7967,3476.82,8016,1253,99,5369,5369,3731,4360,4035
18426,425,5780,18426,0,17356,1070,6.01072e+18,143.964,6941.99,18426,2016,125,12646,12569,5391,8588,1374
44428,130,176,44331,97,44428,0,6.06077e+18,171.955,2598.45,44428,171,169,42769,40489,32732,32985,32381
9371,188,2206,0,9371,3290,6081,2.52887e+15,59.5664,3092.06,9371,1069,72,7165,7165,2241,964,691
5913,3452,3853,0,5913,2504,3409,1.1949e+15,52.6699,4206.75,5913,1872,66,2060,2060,2030,1976,2044
23346,71,1252,0,23346,22659,687,4.59828e+16,251.283,3745.74,23346,196,26,21518,21366,16819,13350,2973
17306,403,935,0,17306,16800,506,4.29656e+16,196.376,2646.97,17306,135,26,16371,16082,13577,13966,9607
1190,14,168,1190,0,1190,0,5.99713e+18,109.475,405.459,1190,58,51,362,58,80,75,94
21078,4802,6754,19988,1090,0,21078,1.98267e+18,95.9377,8489.02,21078,3249,110,14324,14324,13234,12665,11722
39985,10,32,39825,160,39985,0,1.11665e+18,31.9744,1131.16,39985,32,32,11601,0,6248,11233,11601
46108,16793,19658,0,46108,17789,28319,1.89547e+15,56.9325,22121.5,46108,9571,72,26450,26450,24971,24102,23358
7515,205,324,0,7515,7300,215,3.53816e+16,19.9595,925.52,7515,54,26,7191,7191,6919,6950,5170
6963,1510,1701,0,6963,0,6963,6.44825e+17,95.9694,2528.16,6963,796,97,5262,5262,5086,5131,4995
11484,1965,2713,10814,670,0,11484,2.23691e+18,97.0545,3917.21,11484,1294,110,8771,8771,7783,7631,6880
39911,3105,21328,0,39911,0,39911,3.94185e+17,91.7321,23441.1,39911,10351,110,18583,18583,11256,5726,3805
21905,2729,10311,21022,883,21022,883,9.31908e+18,89.5814,11789.2,21905,4985,110,11594,11594,10839,10847,2745
2747,56,149,815,1932,815,1932,1.86875e+18,15.8912,333.476,2747,124,18,2598,2598,1674,1963,1550
23932,131,1357,0,23932,23219,713,4.7925e+16,257.699,4063.97,23932,220,26,22057,21724,13834,14847,5182
41926,13350,14098,39814,2112,0,41926,1.93107e+18,96.1285,16988.7,41926,6838,110,27828,27828,27142,26967,26751
5841,2288,3282,0,5841,0,5841,3.49642e+15,14.8894,3473.99,5841,2938,20,2559,2559,1921,1921,1953
10060,8,176,10048,12,10060,0,6.12217e+18,160.012,1241.01,10060,118,116,2155,435,388,407,417
22248,2329,7870,21148,1100,21148,1100,7.45597e+18,95.6956,9605.72,22248,3810,110,14378,14378,12463,12151,4900
46870,7093,24280,46870,0,46870,0,2.39685e+18,17.9902,24892.9,46870,21845,20,22590,22590,6842,22590,6269
9900,765,3241,3642,6258,0,9900,8.74947e+12,55.9562,4081.79,9900,1573,72,6659,6649,4082,6209,1092
18064,1783,4896,17052,1012,17052,1012,4.68723e+18,97.4001,6495.72,18064,2303,111,13168,13168,8408,9455,6379
22278,2178,5452,0,22278,0,22278,6.39552e+17,97.388,7411.16,22278,2631,110,16826,16826,12742,8270,8008
49946,12,208,49848,98,49946,0,6.06804e+18,204.823,2959.44,49946,188,185,14488,2732,3028,3058,2691
17999,2782,7017,0,17999,6829,11170,2.02114e+15,56.8017,8244.71,17999,3413,72,10982,10982,7758,3753,3992
36541,5574,8541,34411,2130,34411,2130,5.91369e+18,97.8392,11445.2,36541,4143,110,28000,28000,27260,27261,19266
36239,1934,11324,36239,0,34151,2088,4.75658e+18,254.039,13188.4,36239,2599,132,24915,24536,12314,17106,5364
22609,127,176,22598,11,22609,0,6.04834e+18,170.545,1844.69,22609,149,157,21482,19805,16318,16233,16148
25757,79,176,25701,56,25757,0,6.14962e+18,171.189,1985.29,25757,150,154,21498,15817,11357,11665,11370
41982,7754,18104,16226,25756,0,41982,7.32297e+12,56.9001,20372.6,41982,8803,72,23878,23878,18618,22632,11879
8432,1420,2085,7944,488,0,8432,2.21256e+18,96.3936,3031.31,8432,992,106,6347,6347,5459,5322,4679
37738,4009,9056,35542,2196,35542,2196,4.82293e+18,98.2701,11952.8,37738,4278,111,28682,28682,19057,21169,13922
34651,41,176,34562,89,34651,0,6.10854e+18,172.733,2304.97,34651,160,163,21434,7471,7632,8527,7875
33960,8527,10387,33960,0,31980,1980,3.81625e+18,240.401,12176.3,33960,4053,124,23573,23506,21519,22340,20061
18371,4765,6484,17461,910,17461,910,3.0433e+18,95.5793,7990.16,18371,3132,110,11887,11887,9661,10537,9050
19076,2,208,19002,74,19076,0,6.10763e+18,198.894,1839.94,19076,148,151,1087,22,82,20,74
22813,2774,13502,0,22813,0,22813,3.46449e+17,86.7185,14759.8,22813,6544,110,9311,9311,5974,3329,3436
48603,13047,19641,48603,0,46263,2340,4.28318e+18,1197.14,22061.4,48603,7975,146,28962,27983,23257,25339,15559
21982,3568,6712,20812,1170,20812,1170,5.15246e+18,96.9909,8502.13,21982,3188,111,15270,15270,13691,14777,8175
48131,19508,20374,18534,29597,0,48131,7.43416e+12,57.0571,22934.5,48131,9919,72,27757,27757,27486,27707,27314
4295,1042,1103,1521,2774,0,4295,9.6892e+12,58.62,1590.4,4295,532,71,3192,3192,3130,3175,3133
16115,6648,8192,16115,0,16115,0,4.54049e+15,4027.63,11473.8,16115,8192,3,6647,0,6379,6416,6647
46848,9448,15219,44448,2400,44448,2400,3.03513e+18,96.4232,18418.3,46848,7380,110,31629,31629,27691,30525,20690
34933,2154,8395,32901,2032,32901,2032,6.05101e+18,98.2358,11122.7,34933,3957,111,26538,26538,11979,17243,8109
42501,946,16321,0,42501,16074,26427,2.03249e+15,57.6649,18762,42501,7946,72,26180,26132,15957,14713,3499
1999,210,542,0,1999,0,1999,6.68066e+17,91.5423,869.69,1999,245,58,1457,1457,958,884,766
10216,63,176,10150,66,10216,0,6.02863e+18,164.836,1243.67,10216,125,125,7520,4604,3393,3706,3614
8048,458,2979,8048,0,7598,450,5.81684e+18,91.9469,3581.11,8048,1105,108,5069,5069,2682,3762,985
29581,629,1534,8818,20763,0,29581,6.9154e+18,15.9946,2179.06,29581,1091,26,28047,28047,18648,17882,17030
22433,612,11462,22433,0,22433,0,3.00781e+18,17.9663,11884.2,22433,10300,20,10971,10971,515,10971,576
45624,4518,28154,44294,1330,0,45624,1.11793e+18,90.3706,30172.5,45624,13674,110,17470,17470,10647,9594,4334
12527,1599,3021,0,12527,0,12527,6.45704e+17,97.0216,4295.08,12527,1447,110,9506,9506,7974,7213,5709
9952,2908,3986,9952,0,9446,506,3.64223e+18,110.721,4706.04,9952,1637,115,5966,5944,5545,5686,3965
12357,1935,4538,4623,7734,0,12357,8.2012e+12,57.6357,5484.94,12357,2205,72,7819,7819,6182,7539,4413
26607,919,24867,0,26607,0,26607,6.03785e+17,3.98918,24946.5,26607,8306,9,1740,1740,60,60,67
6911,157,308,0,6911,6714,197,3.57734e+16,19.9897,878.073,6911,53,26,6603,6603,6176,6212,3960
40397,1307,13163,0,40397,14862,25535,2.22445e+15,58.5813,15683.8,40397,6407,72,27234,27234,15969,13410,2269
10128,187,498,0,10128,9838,290,3.71316e+16,19.9638,1340.84,10128,70,26,9630,9630,8894,8712,5085
26670,10,13,25896,774,26654,16,1.59576e+14,10.1777,481.209,26670,12,12,26618,26554,25605,25603,25851
28525,2522,11809,0,28525,10937,17588,1.93589e+15,56.7354,13517.3,28525,5746,72,16716,16716,10464,3131,3044
10986,3627,4830,0,10986,4256,6730,1.8602e+15,54.3798,5624.85,10986,2330,72,6156,6156,5514,5171,4964
22897,640,809,0,22897,22244,653,3.55111e+16,118.868,2439.83,22897,111,26,22088,21951,21543,21570,18710
7908,3305,3459,0,7908,3057,4851,1.89678e+15,56.3125,4077.46,7908,1685,72,4449,4449,4249,4185,4150
2101,478,584,1973,128,1973,128,3.58912e+18,92.1794,918.508,2101,260,60,1517,1517,1428,1509,1433
45335,883,1527,0,45335,44573,762,2.52754e+16,3.73537,5841.32,45335,766,4,43808,43808,43744,43358,32851
38896,8296,10991,0,38896,0,38896,6.07643e+17,97.0618,13886.3,38896,5332,110,27905,27905,25408,24094,22640
13124,1324,4155,0,13124,0,13124,5.80301e+17,95.8254,5375.86,13124,2000,110,8969,8969,6200,3316,3320
13977,156,175,13911,66,13977,0,5.9752e+18,164.255,1400.56,13977,143,141,13666,13319,12414,12455,12367
44345,2472,14477,16324,28021,0,44345,8.68167e+12,58.5868,17195.6,44345,7047,72,29868,29868,15103,25580,5956
41969,15707,16362,0,41969,15910,26059,2.00995e+15,57.5493,18761.9,41969,7955,72,25607,25607,24839,23897,23716
47656,15417,16228,37503,10153,45246,2410,3.2062e+18,96.816,19336.7,47656,7764,111,31428,31428,30200,30354,30077
15635,122,175,15631,4,15635,0,5.9751e+18,165.088,1481.21,15635,148,147,14663,13370,10857,10887,11015
19997,591,1117,0,19997,19405,592,4.56445e+16,234.974,3256.84,19997,170,26,18880,18372,17572,17175,11816
15649,442,888,0,15649,15192,457,4.32005e+16,172.603,2460.5,15649,124,26,14761,14525,13664,13081,9311
46779,9746,10912,16442,30337,0,46779,9.8759e+12,60.0689,14074.8,46779,5310,72,35867,35867,34151,35567,32219
20738,3,13,20146,592,20667,71,1.38783e+14,10.9086,443.154,20738,12,12,15849,11169,13155,12612,8774
1151,282,497,1092,59,1092,59,2.9708e+18,76.4492,678.644,1151,213,45,654,654,483,557,539
46976,1259,1577,0,46976,45618,1358,3.93559e+16,295.808,5345.61,46976,261,26,45399,45399,44497,44498,40525
10112,195,200,10105,7,10112,0,5.97656e+18,175.232,1233.22,10112,126,131,9912,9874,9726,9763,9776
4201,877,1004,0,4201,1480,2721,2.58719e+15,59.0559,1491.4,4201,488,68,3197,3197,3045,3037,2949
40754,6653,9571,0,40754,0,40754,6.47314e+17,97.8368,12732.6,40754,4637,110,31183,31183,27922,26037,22622
25435,6615,7285,24055,1380,24055,1380,6.64173e+18,96.8028,9361.05,25435,3526,110,18150,18150,17980,17980,16463
27388,222,6468,25798,1590,25798,1590,3.22669e+18,97.6427,8784.92,27388,3125,110,20920,20920,8570,14086,2045
9124,175,3060,9124,0,8592,532,4.09235e+18,92.0335,3727.72,9124,816,119,6064,6064,3458,4427,628
47934,5963,22156,45974,1960,0,47934,1.56589e+18,94.2923,24880.2,47934,10775,110,25778,25778,16929,14870,7281
25078,239,918,0,25078,24361,717,3.69684e+16,171.609,2820.11,25078,132,26,24107,23893,21090,20510,10550
4486,645,1126,4224,262,0,4486,2.24201e+18,94.9153,1723.42,4486,525,83,3360,3360,2824,2651,2244
16841,459,700,0,16841,16359,482,3.5556e+16,28.8962,1940.4,16841,88,26,16141,16132,14804,14956,11540
37712,215,1086,0,37712,36637,1075,3.55378e+16,225.506,3661.3,37712,166,26,36451,36157,30802,30775,13000
17311,192,737,0,17311,0,17311,3.84014e+18,15.9835,1226.01,17311,732,17,16574,16574,9537,11153,13320
33983,1735,8080,0,33983,11969,22014,2.51632e+15,59.9725,10500.8,33983,3934,72,25903,25903,16995,10048,6153
10901,2597,4238,0,10901,0,10901,5.24154e+17,94.5641,5215.96,10901,2045,109,6663,6663,5825,4827,4750
23606,11,13,22927,679,23532,74,1.48595e+14,10.6955,483.132,23606,12,12,23591,23585,23304,23297,22585
21756,3415,5072,0,21756,7648,14108,2.53814e+15,59.9745,6774.84,21756,2467,72,16684,16684,14229,11194,11373
33637,5420,16835,32357,1280,0,33637,1.45777e+18,92.5423,18788,33637,8179,110,16802,16802,11735,10529,6548
38577,11,15,37455,1122,38486,91,1.59632e+14,10.4728,650.912,38577,14,12,38560,38554,37788,37289,36921
33231,451,1705,0,33231,32247,984,4.73966e+16,297.115,5335.87,33231,287,26,31526,30314,24339,25268,11734
28513,240,274,28512,1,28513,0,5.66545e+18,219.616,1269.93,28513,268,31,28137,27355,27918,28085,25869
44642,7348,18481,0,44642,17128,27514,1.935e+15,57.2053,20921.6,44642,9000,72,26161,26161,18489,18709,10467
37803,7796,16352,14623,23180,0,37803,7.32355e+12,56.4433,18433.2,37803,7959,72,21451,21451,16726,20387,10136
14779,227,4242,5327,9452,0,14779,9.27021e+12,58.9993,5427.81,14779,2065,72,10537,10489,3714,8497,894
8328,1267,4213,8008,320,8008,320,2.59138e+18,92.2705,4905.56,8328,2028,91,4115,4115,2540,3073,2477
41378,9602,11664,39118,2260,39118,2260,3.21941e+18,97.0946,14706.6,41378,5655,110,29714,29714,26497,27765,25605
16809,9,11,16330,479,16803,6,1.38854e+14,10.2634,362.981,16809,11,11,16575,16260,16016,16017,15045
9934,100,170,9928,6,9934,0,5.99638e+18,161.618,1173.71,9934,127,127,8842,5564,5320,5648,5695
38751,5908,9343,36498,2253,36498,2253,5.90123e+18,98.2708,12294.1,38751,4415,111,29408,29408,22876,24273,19589
48749,1381,1671,0,48749,47915,834,2.54091e+16,3.73565,6381.6,48749,837,4,47078,47078,47049,46875,42375
40962,6331,13163,40962,0,38581,2381,4.86347e+18,291.842,14929,40962,4892,128,27799,27653,21044,24532,14566
4060,358,1287,0,4060,0,4060,6.03086e+17,93.6655,1806.9,4060,608,78,2773,2687,1731,1518,1375
11646,3550,3926,0,11646,0,11646,5.68669e+17,95.4127,5015.55,11646,1894,110,7720,7720,7309,6768,6946
942,236,315,889,53,0,942,2.22832e+18,82.0987,490.648,942,130,44,627,627,554,557,584
19810,4382,6502,19810,0,18653,1157,5.54647e+18,148.827,7581.95,19810,1778,125,13308,13308,12150,13112,9414
25625,1925,6913,0,25625,0,25625,6.18285e+17,97.051,9037.52,25625,3335,110,18712,18712,11616,6150,5692
38578,10895,12006,38578,0,36358,2220,3.8159e+18,279.487,13970.3,38578,4752,126,26572,26572,25715,26149,24684
45433,18,176,45348,85,45433,0,6.01733e+18,173.435,2596.17,45433,173,174,16931,2997,4538,4414,4470
510,180,183,0,510,177,333,2.48706e+15,47.3647,273.679,510,85,32,327,327,327,327,323
35872,1145,18930,0,35872,0,35872,4.00294e+17,92.7753,20901.8,35872,9180,110,16942,16103,8506,2397,2040
24969,6996,10479,23860,1109,0,24969,1.69606e+18,94.5051,12223.3,24969,5086,110,14490,14490,12855,12477,11434
44270,367,10327,0,44270,15568,28702,2.53398e+15,60.0703,13344.8,44270,5030,72,33943,33943,19475,10407,1739
37949,990,13932,37949,0,35899,2050,3.75272e+18,267.282,15568.2,37949,5509,129,24017,23276,11035,16083,2687
37180,9971,14924,0,37180,0,37180,5.07948e+17,95.1594,17346.6,37180,7252,110,22256,22256,17341,11051,9146
1237,132,167,1237,0,1237,0,5.98457e+18,108.205,411.099,1237,58,52,1062,1022,933,942,942
23002,1161,5397,21662,1340,21662,1340,3.36813e+18,97.6164,7427.27,23002,2609,110,17605,17605,9073,12943,4864
12572,527,3611,11890,682,0,12572,2.08769e+18,96.1925,4831.41,12572,1727,110,8961,8875,5813,5209,2258
11503,2253,4300,10943,560,10943,560,3.24559e+18,95.5518,5326.86,11503,2050,111,7203,7203,4707,5114,4074
43217,73,1192,0,43217,41986,1231,3.55811e+16,247.898,4113.44,43217,187,26,41525,41429,26203,26267,8875
37343,519,1880,0,37343,36233,1110,4.75766e+16,316.906,5966.7,37343,324,26,35463,34041,30579,26517,12624
5932,789,2174,5642,290,5642,290,7.48724e+18,93.3437,2825.36,5932,1028,86,3758,3672,3421,3366,2446
15621,9,61,15589,32,15621,0,2.253e+18,60.5393,930.797,15621,61,61,4300,169,146,509,2058
49236,151,176,49215,21,49236,0,5.98696e+18,171.88,2644.51,49236,171,173,48324,46859,42774,42596,42330
39484,2188,14972,39484,0,37396,2088,4.93913e+18,286.22,16661.8,39484,4517,137,24512,23941,13469,16805,5534
43110,4408,10082,0,43110,15152,27958,2.52739e+15,60.0424,13035.2,43110,4902,72,33028,33028,24853,14513,14911
32597,154,176,32508,89,32597,0,6.08121e+18,172.154,2233.4,32597,163,164,32072,31333,28538,28583,28265
46747,8537,10851,0,46747,16428,30319,2.53001e+15,60.0752,14016.3,46747,5271,72,35896,35896,33083,29497,28449
35445,3,14,34424,1021,35362,83,1.51137e+14,10.4333,594.341,35445,13,12,27213,19711,21567,21916,13980
3146,2992,3124,3146,0,3146,0,4.49764e+18,18.9895,3133.11,3146,1534,25,22,22,20,22,22
27066,161,274,27066,0,27066,0,5.54012e+18,209.37,1188.95,27066,266,31,26480,25951,20081,22611,19459
43420,170,176,43343,77,43420,0,5.98351e+18,169.804,2466.76,43420,171,170,43234,43179,42024,42151,42285
35574,1190,14932,0,35574,13682,21892,1.91894e+15,56.1513,16949.1,35574,7269,72,20642,20642,11890,876,1413
43466,1011,1423,0,43466,42215,1251,3.8542e+16,271.395,4801.02,43466,231,26,42043,42043,39253,39982,33891
35578,11,15,34561,1017,35495,83,1.44092e+14,10.6428,600.824,35578,13,12,35560,35551,31146,31231,30915
24370,3274,6289,22992,1378,22992,1378,6.06834e+18,97.2699,8356.98,24370,3040,110,18081,18081,16489,16225,10314
39113,1113,1616,0,39113,37966,1147,4.27615e+16,297.867,5245.51,39113,269,26,37497,37497,36322,36060,29506
14642,92,452,0,14642,14418,224,2.46311e+16,3.73508,1782.35,14642,228,4,14190,14190,12517,12463,7569
7058,112,175,6993,65,7058,0,6.00146e+18,158.199,997.41,7058,115,115,6425,5564,4370,4510,4568
39484,13117,13442,37501,1983,37501,1983,4.22423e+18,96.1513,16183,39484,6522,110,26042,26042,26042,26042,26020
49085,7013,11474,46228,2857,0,49085,2.2266e+18,97.9064,15143.9,49085,5568,110,37611,37611,31551,30384,24139
39773,3223,9351,37463,2310,0,39773,2.22418e+18,97.8115,12454.4,39773,4528,110,30422,30422,20058,18248,11923
9576,1878,2250,3360,6216,0,9576,9.93262e+12,59.616,3149.58,9576,1092,72,7326,7326,6877,7228,6326
42110,879,14900,42110,0,39783,2327,4.51734e+18,294.348,16677.9,42110,5824,131,27210,26493,11344,18584,2744
22785,382,5361,21458,1327,21458,1327,5.74448e+18,97.5741,7371.06,22785,2585,110,17424,17424,13165,10075,2329
22550,2474,5253,0,22550,7929,14621,2.53875e+15,59.9775,7002.17,22550,2559,72,17297,17297,13201,10703,8368
33145,9099,10141,33145,0,31215,1930,5.39114e+18,230.724,11896.7,33145,3668,130,23004,23004,22651,23004,21245
35615,831,11180,33758,1857,0,35615,1.99694e+18,96.5086,13789,35615,5418,110,24435,24435,15094,13323,4178
2317,1283,1390,2239,78,2239,78,2.3796e+18,86.5628,1625.57,2317,646,59,927,927,775,844,835
8584,276,361,0,8584,8338,246,3.53573e+16,20.0522,1035.89,8584,58,26,8223,8223,8040,8058,6810
17503,9,176,17490,13,17503,0,6.10874e+18,165.357,1638.75,17503,139,140,4114,766,726,724,820
7633,3136,3245,7293,340,7293,340,8.54317e+18,93.5223,3972.19,7633,1559,90,4388,4388,4367,4368,4283
44434,8676,16473,0,44434,0,44434,5.31925e+17,95.6801,19374.5,44434,7995,110,27961,27961,22524,14129,13393
8329,1383,4224,8009,320,8009,320,2.75255e+18,84.4086,4912.54,8329,2000,99,4105,4105,2220,2887,941
18043,890,4372,16993,1050,16993,1050,1.27028e+18,97.8933,6021.17,18043,2052,111,13671,13671,12410,12511,3494
20996,106,7090,20996,0,19789,1207,5.36188e+18,150.875,8202.93,20996,2604,122,13805,3132,4337,8401,632
8584,566,3463,8184,400,8184,400,2.53858e+18,94.0239,4267.25,8584,1625,104,5121,4947,2510,3333,1619
41554,51,176,41530,24,41554,0,6.03633e+18,172.284,2499.52,41554,168,171,27689,13755,10832,12229,11776
10343,1656,3919,10343,0,9780,563,4.91161e+18,100.585,4612.85,10343,1478,120,6424,6415,4573,5316,3693
46829,2297,18206,0,46829,17747,29082,2.02026e+15,57.5972,20829.1,46829,8866,72,28623,28623,15696,7756,4980
27338,4,12,26553,785,27318,20,1.48748e+14,10.3024,478.029,27338,12,11,23739,21147,17556,17827,13399
23373,3371,5492,0,23373,0,23373,6.47693e+17,97.5679,7545.89,23373,2647,110,17881,17881,14987,11688,11631
41750,1120,1728,0,41750,40530,1220,4.31724e+16,306.854,5641.88,41750,294,26,40022,40022,38774,38582,31555
13305,2170,6899,12813,492,0,13305,1.42008e+18,92.6442,7852.08,13305,3338,110,6406,6406,4667,3988,2565
31967,6193,11965,30447,1520,30447,1520,2.85127e+18,95.522,14202.4,31967,5798,110,20002,20002,16632,19195,12045
37947,1563,14852,0,37947,14400,23547,2.01472e+15,57.545,17054.6,37947,7234,72,23095,23095,7512,3118,1141
26924,1068,15599,0,26924,0,26924,3.58306e+17,92.1023,17051.9,26924,7575,110,11325,11215,5166,1845,1824
28686,458,7727,27093,1593,27093,1593,6.4115e+18,97.1317,10045.1,28686,3743,110,20959,20787,19040,16492,2767
39695,4907,9922,0,39695,0,39695,6.33744e+17,97.1084,12972.5,39695,4792,110,29773,29773,23800,18768,16606
38217,10911,17327,14924,23293,0,38217,7.05169e+12,56.553,19361.9,38217,8436,72,20890,20890,18053,20402,14826
7497,1431,2126,7085,412,0,7497,2.11547e+18,94.0683,2966.52,7497,996,100,5371,5371,4836,4611,4247
7762,1378,2952,7389,373,0,7762,1.84035e+18,94.1668,3723.69,7762,1416,95,4810,4810,3565,3130,2232
4785,1102,1142,0,4785,1679,3106,2.54434e+15,59.176,1681.48,4785,551,71,3643,3643,3604,3628,3606
30466,505,1491,0,30466,29568,898,4.54682e+16,288.675,4647.85,30466,246,26,28975,28019,23119,24177,13667
6412,3244,3299,6412,0,6132,280,3.88707e+18,82.2951,3750.81,6412,1374,101,3113,3112,3113,3113,3113
37743,4,15,36643,1100,37660,83,1.63621e+14,10.4715,636.621,37743,13,13,33004,29384,23781,24509,17135
30728,6092,8579,0,30728,11048,19680,2.37727e+15,59.2781,10715.1,30728,4166,72,22149,22149,19469,16170,16344
4895,242,353,0,4895,4752,143,4.26899e+16,19.3975,884.666,4895,55,26,4542,4542,3969,4015,2626
21437,3369,5007,7536,13901,0,21437,9.90379e+12,59.9381,6689.16,21437,2432,72,16430,16430,14421,16010,11208
47463,9137,11104,44703,2760,0,47463,2.22705e+18,97.8915,14679.3,47463,5379,110,36359,36359,33762,33177,30857
48114,10,17,46704,1410,48027,87,1.69672e+14,10.4618,751.014,48114,14,12,47937,47717,45707,44365,36865
45216,57,176,45127,89,45216,0,6.03629e+18,173.467,2600.06,45216,173,172,31455,17682,13092,14997,14919
34938,222,1331,0,34938,33925,1013,4.0296e+16,267.538,4300.81,34938,215,26,33272,32844,23823,22578,7356
39154,137,1224,0,39154,37931,1223,0.0312356,0.968739,6922.67,39154,1224,1,37930,37930,37930,37930,37930
14992,3861,7359,14992,0,14992,0,2.80098e+18,17.9618,7708.33,14992,6616,20,7633,7633,4170,3996,4061
30824,6524,8165,0,30824,0,30824,6.21137e+17,97.2182,10628.3,30824,3946,110,22659,22659,20650,19586,18659
19121,732,742,0,19121,18577,544,3.55333e+16,68.4407,2129.49,19121,97,26,18379,18379,18347,18340,18324
36455,766,1045,0,36455,35161,1294,1.14565e+16,7.94067,5685.17,36455,268,10,35410,35410,34884,35283,32057
28393,5077,8881,26894,1499,26894,1499,2.85812e+18,97.0965,11033.3,28393,4239,111,19512,19512,16736,19332,12635
21691,3444,5058,7629,14062,0,21691,9.90527e+12,59.9752,6755.53,21691,2464,72,16633,16633,14661,16216,11491
5936,643,2531,5669,267,5669,267,2.72838e+18,93.0807,3135.92,5936,1213,84,3405,3274,2480,2662,1829
44972,6935,23568,43342,1630,43342,1630,2.49385e+18,93.2768,25923.1,44972,11456,110,21404,21404,10666,14560,6913
38686,13561,15986,36946,1740,36946,1740,4.87208e+18,95.6451,18404,38686,7679,111,22700,22700,22650,22700,19404
17266,4125,5246,0,17266,0,17266,5.92567e+17,96.3024,6763.29,17266,2529,110,12020,12020,11621,11697,11226
45527,150,265,45300,227,45527,0,5.56638e+18,231.703,1520.01,45527,265,25,44572,43671,30103,34705,30073
40513,11,176,40432,81,40513,0,5.98871e+18,173.031,2397.2,40513,172,171,10723,1719,2251,2336,2432
31614,6740,7321,11111,20503,0,31614,9.91226e+12,60.069,9620.03,31614,3566,72,24293,24293,23456,24146,22607
9293,1085,3359,0,9293,3461,5832,2.12116e+15,56.2138,4130.37,9293,1616,72,5934,5934,3731,3030,1446
2386,545,1428,0,2386,0,2386,3.73185e+17,68.3713,1671.54,2386,671,49,958,872,548,60,32
41781,8807,9777,14693,27088,0,41781,9.86492e+12,60.0265,12652.8,41781,4753,72,32004,32004,30718,31784,29306
26801,121,208,26723,78,26801,0,6.04341e+18,201.837,2139.79,26801,170,161,24822,22690,14994,15663,15541
32861,332,1332,0,32861,31906,955,4.13036e+16,268.86,4250.63,32861,215,26,31413,30765,27721,25260,13299
6968,4,11,6770,198,6963,5,1.37991e+14,10.8848,233.256,6968,11,11,6105,5449,4564,4643,3408
32788,2756,7697,30880,1908,0,32788,2.22599e+18,97.7533,10360.7,32788,3726,110,25091,25091,18360,16766,10102
5307,119,170,5302,5,5307,0,5.95372e+18,155.438,858.401,5307,105,101,4874,4457,3618,3644,3653
1672,520,627,1672,0,1580,92,6.08976e+18,85.7195,862.953,1672,216,55,1045,1045,1001,1028,1012
22857,5572,8538,21766,1091,0,22857,1.82981e+18,95.3655,10269.9,22857,4136,110,14319,14319,12719,11769,10348
12787,3040,4458,4748,8039,0,12787,8.4128e+12,57.8992,5452.11,12787,2161,72,8329,8329,6569,8026,4628
30843,3,176,30774,69,30843,0,5.98369e+18,169.524,2080.8,30843,167,164,2640,427,273,179,308
40393,17001,23583,0,40393,0,40393,3.52736e+17,90.1958,25543.1,40393,11448,110,16810,16810,14534,13569,12448
28099,1875,10723,10612,17487,0,28099,7.97892e+12,57.5638,12484.4,28099,5204,72,17376,17376,9439,14624,2664
2005,50,64,0,2005,1942,63,0.0314214,0.96808,356.197,2005,64,1,1941,1941,1941,1941,1941
13531,3868,12650,12646,885,12646,885,1.1197e+18,3.97169,12705.5,13531,4241,9,881,881,265,268,272
29362,9824,13376,28142,1220,0,29362,1.58961e+18,93.9467,15258.6,29362,6498,110,15986,15986,14205,13770,12755
30263,6630,7242,0,30263,10665,19598,2.51078e+15,59.9036,9441.17,30263,3524,72,23021,23021,22383,21656,21502
12717,1134,4042,4658,8059,0,12717,8.81516e+12,58.4475,5068.9,12717,1959,72,8675,8675,4731,7595,3046
40641,860,1139,0,40641,39482,1159,3.55262e+16,238.35,3896.27,40641,176,26,39502,39502,38446,38503,33775
47512,140,176,47423,89,47512,0,6.04006e+18,173.541,2671.16,47512,172,174,46033,42939,37381,38200,37873
35978,5474,8380,0,35978,12643,23335,2.53787e+15,60.0476,10925.3,35978,4082,72,27598,27598,23399,18143,18387
36623,3349,10065,0,36623,13139,23484,2.39625e+15,59.3946,12534.1,36623,4901,72,26558,26558,17403,11189,9092
46487,158,10831,16349,30138,0,46487,9.89516e+12,60.0831,13974.4,46487,5276,72,35656,35590,20132,32977,1092
36440,9002,16558,14233,22207,0,36440,7.03819e+12,55.8154,18517.6,36440,8061,72,19882,19882,16832,19242,11810
47357,8766,18332,17927,29430,0,47357,7.89053e+12,57.6287,20990,47357,8925,72,29025,29025,23377,27790,14834
46896,3417,21408,44946,1950,44946,1950,6.55411e+18,94.4476,24053.2,46896,10300,111,25488,25488,11834,25488,6683
1526,239,584,1446,80,1446,80,3.11822e+18,81.5177,823.861,1526,242,54,942,942,408,607,450
10843,682,2580,10213,630,10213,630,5.72682e+18,96.8205,3731.45,10843,1229,110,8263,8263,7105,6407,2718
46335,9212,10802,0,46335,16297,30038,2.53054e+15,60.0806,13939.1,46335,5257,72,35533,35533,33294,30991,30735
5479,627,1424,5169,310,0,5479,2.19092e+18,95.1765,2110.31,5479,660,88,4055,4055,3004,2784,2032
19191,1862,13073,18721,470,18721,470,1.9459e+18,85.1918,13999,19191,6328,110,6118,6118,2478,3554,2004
43656,11749,17069,0,43656,0,43656,5.16106e+17,95.3678,19853.9,43656,8297,110,26587,26587,25733,25323,24658
41505,485,11393,0,41505,0,41505,6.14145e+17,97.229,14469.2,41505,5525,110,30112,29854,12070,2656,3217
6301,52,176,6295,6,6301,0,6.27181e+18,92.0803,930.281,6301,81,85,5069,3831,2080,1833,1542
46305,466,1622,0,46305,44968,1337,4.00849e+16,288.604,5456.11,46305,272,26,44683,43571,34399,35721,18265
24823,12208,16329,24173,650,24173,650,1.96161e+18,89.1269,17505.6,24823,7932,110,8494,8494,7778,8350,7428
2952,235,1061,2952,0,2782,170,4.10666e+18,90.4051,1408.89,2952,397,71,1891,1891,986,1404,744
6959,864,1641,2448,4511,0,6959,9.9659e+12,59.4366,2349.7,6959,793,72,5318,5318,4373,5119,2959
40015,1828,9615,37705,2310,0,40015,2.20954e+18,97.7458,12713.6,40015,4657,110,30400,30400,20170,18426,7493
32147,4537,10724,0,32147,11877,20270,2.20465e+15,58.4457,12801.4,32147,5220,72,21423,21423,16848,14281,10395
11345,74,4286,0,11345,0,11345,5.3309e+17,94.719,5309.58,11345,2065,110,5416,1705,2111,311,472
49759,10126,15026,47119,2640,0,49759,2.03059e+18,96.8312,18470.1,49759,7295,110,34733,34733,29264,28213,22722
30184,607,1373,0,30184,29295,889,4.34938e+16,272.467,4293.4,30184,224,26,28811,27996,24286,24811,16326
20421,149,176,20409,12,20421,0,5.99256e+18,170.951,1717.41,20421,151,158,19910,19047,17318,17411,17357
33345,2869,10263,31575,1770,31575,1770,1.458e+18,97.1939,12709.7,33345,4893,111,23082,23082,23082,23013,8287
46002,9,15,44652,1350,45936,66,1.69373e+14,10.3757,733.223,46002,13,11,45507,45022,43328,42432,35344
42583,14804,19940,40863,1720,40863,1720,9.18719e+18,92.5287,22402.8,42583,9674,110,22643,22643,21683,21523,18157
43018,1544,1711,0,43018,41762,1256,4.2456e+16,294.799,5629.89,43018,289,26,41307,41307,41001,40977,39191
34879,6581,15629,34879,0,26661,8218,4.5498e+18,390.39,17194.1,34879,6781,133,19250,18893,13609,16114,9146
4034,998,1409,0,4034,0,4034,5.70243e+17,83.9115,1910.21,4034,650,81,2625,2625,2625,2625,2625
20523,5357,9925,0,20523,0,20523,4.39322e+17,88.8152,11309.6,20523,4810,110,10598,10598,7982,7665,5330
8386,49,3146,7979,407,0,8386,1.84783e+18,94.5268,3970.69,8386,1514,103,3035,724,1483,1131,175
28978,4963,8951,28978,0,27288,1690,4.47504e+18,184.53,10535,28978,3466,124,20027,20019,15775,17628,11677
46790,597,10908,0,46790,16454,30336,2.53225e+15,60.0764,14068,46790,5314,72,35882,35882,20907,5149,2534
23407,3071,10292,0,23407,9083,14324,1.85757e+15,56.7103,11701,23407,5014,72,13115,13115,9027,6441,4281
40462,959,1380,0,40462,39774,688,2.53667e+16,3.73533,5287.25,40462,692,4,39082,39082,39040,38787,32182
42999,1997,10088,0,42999,0,42999,6.4717e+17,97.8496,13384.6,42999,4892,110,32911,32911,21895,10854,8146
28363,1097,7833,0,28363,0,28363,6.12233e+17,97.023,10115.4,28363,3791,110,20530,20530,10720,5813,4777
39886,2961,9618,37571,2315,37571,2315,2.44158e+18,98.2566,12638.5,39886,4546,111,30268,30268,19924,23909,10828
6051,3,10,5879,172,6051,0,1.38621e+14,9.86779,214.558,6051,10,10,4594,3245,3711,3954,2628
38519,5700,9010,36279,2240,36279,2240,3.21857e+18,97.8123,12039.2,38519,4360,110,29509,29509,26133,28524,19717
16433,1737,3904,15475,958,15475,958,5.87835e+18,97.3473,5470.12,16433,1877,110,12529,12529,11996,11999,6371
33422,11086,15049,33422,0,31874,1548,4.52516e+18,327.483,16545.8,33422,5957,134,18373,18294,16696,18071,13970
10835,107,176,10827,8,10835,0,6.09319e+18,164.182,1289.51,10835,119,125,9908,7700,6386,6525,6598
38745,4739,12155,0,38745,0,38745,5.81283e+17,96.4323,14940.1,38745,5902,110,26590,26590,19939,14568,12153
36685,9311,9734,13100,23585,0,36685,9.46055e+12,59.5046,12234.4,36685,4732,72,26951,26951,26701,26908,26594
43005,3512,19380,0,43005,0,43005,4.65468e+17,94.4492,21922.3,43005,9418,110,23625,23625,15092,8309,5615
19956,4,11,19386,570,19952,4,1.42134e+14,9.96943,395.138,19956,11,11,17285,15295,15265,13431,10185
13366,537,5387,5097,8269,0,13366,7.75139e+12,57.1404,6350.09,13366,2620,72,7979,7787,4777,7429,1094
20901,3908,6505,20901,0,19681,1220,3.69603e+18,153.448,7771.4,20901,2495,122,14396,14396,11490,12617,9048
38997,28881,38997,38997,0,0,38997,7.99979,0,38997,38997,38997,1,0,0,0,0,0
21630,1,14,20998,632,21553,77,1.65137e+14,10.6575,476.125,21630,13,12,4471,4471,4471,4471,4471
28654,6,15,27790,864,28591,63,2.01209e+14,10.364,579.6,28654,13,12,27602,26865,23023,21167,17271
18814,1599,4560,0,18814,6636,12178,2.51132e+15,59.7769,6061.33,18814,2220,72,14254,14254,10263,5279,5529
4931,968,1612,0,4931,0,4931,5.86883e+17,93.9517,2204.5,4931,762,83,3319,3319,2471,1434,1736
47459,10872,11061,44698,2761,0,47459,2.22905e+18,97.883,14637.4,47459,5354,110,36398,36398,36224,36230,36140
20925,151,175,20913,12,20925,0,5.98106e+18,166.358,1711.91,20925,157,155,20461,19861,18172,18207,18084
47251,17019,19040,45086,2165,45086,2165,2.68703e+18,95.8632,21897,47251,9146,111,28211,28211,27880,28200,28060
8775,1513,3536,0,8775,0,8775,5.12691e+17,94.134,4361.3,8775,1704,106,5239,5239,4499,4316,4020
4918,792,1284,4636,282,0,4918,2.20395e+18,95.0079,1916.61,4918,602,85,3634,3634,3085,2897,2481
6104,2161,2356,5806,298,5806,298,2.98566e+18,94.3835,2996.12,6104,1115,87,3748,3748,3567,3733,3468
17414,3374,4224,16394,1020,16394,1020,3.7118e+18,97.8559,5821.57,17414,1988,111,13190,13190,11634,11916,11305
37270,6899,13269,35442,1828,0,37270,1.87604e+18,95.4287,15843.8,37270,6440,110,24001,24001,20496,18854,14751
13207,88,6188,12667,540,12667,540,9.24241e+18,93.4556,7206.04,13207,2992,110,6120,1935,189,5159,482
45251,10095,10496,15892,29359,0,45251,9.90896e+12,60.0994,13574.7,45251,5113,72,34755,34755,34177,34655,33649
16473,6,10,16004,469,16467,6,1.38901e+14,9.94779,355.032,16473,10,10,15697,15243,13738,13955,10885
42364,15,16,41101,1263,42293,71,1.85167e+14,10.335,722.774,42364,13,12,42348,42348,42335,42336,42315
43144,11394,15636,43144,0,40794,2350,4.48551e+18,302.042,17427.1,43144,6174,132,27508,27476,24348,25986,20454
17551,1227,4813,16581,970,0,17551,2.11894e+18,92.2429,6401.43,17551,2304,110,12738,12738,9085,8330,4725
15945,706,3758,0,15945,5600,10345,2.53599e+15,59.8399,5087.96,15945,1826,72,12187,12187,7794,6284,2536
34395,4476,8027,0,34395,12085,22310,2.52834e+15,60.0264,10484.3,34395,3904,72,26368,26368,22101,16442,15024
39248,691,1120,0,39248,38129,1119,3.56065e+16,235.604,3801.72,39248,172,26,38128,37760,33420,34251,28142
48408,15651,19964,48408,0,36826,11582,4.40068e+18,1893.94,22741.7,48408,5806,141,28444,26906,26592,27790,23231
10377,5,12,10080,297,10367,10,1.46963e+14,10.4569,289.104,10377,11,11,9602,8695,7085,7191,6138
47998,13155,25479,47998,0,0,47998,8.87578e+17,17.9692,26089.5,47998,22924,20,22519,22519,11830,14779,10986
13100,3969,4264,0,13100,4807,8293,2.22396e+15,58.282,5304.99,13100,2064,72,8836,8836,8434,8206,8124
29045,10975,13728,0,29045,0,29045,4.48382e+17,93.939,15549.7,29045,6669,110,15317,15317,13924,12958,12723
36378,3725,13957,34668,1710,0,36378,1.79687e+18,95.4358,16395.7,36378,6780,110,22421,22421,14652,13349,7828
48219,208,1282,0,48219,46844,1375,3.55633e+16,261.259,4509.29,48219,205,26,46600,46233,38582,38816,14567
37866,10182,16165,37866,0,36098,1768,4.51882e+18,459.484,18078.2,37866,6614,137,21701,21511,18133,19432,15316
35418,152,1233,0,35418,34803,615,2.55247e+16,3.73573,4726.56,35418,618,4,34185,34185,29302,29214,16259
22397,800,838,0,22397,21756,641,3.6439e+16,137.126,2511.54,22397,115,26,21559,21559,21459,21450,21028
34516,7936,11154,34516,0,32506,2010,5.20399e+18,238.237,12713.5,34516,4114,128,23362,23294,20957,22361,17393
23472,108,208,23411,61,23472,0,6.06038e+18,201.493,2023.94,23472,162,157,21161,16125,11868,12490,12116
24975,2676,5877,0,24975,8786,16189,2.53308e+15,59.955,7768.27,24975,2863,72,19098,19098,14774,13917,8932
16551,5442,8395,16551,0,16551,0,2.4052e+18,701.56,9060.25,16551,7373,25,8156,7390,5011,4870,5780
34532,1024,8062,0,34532,12138,22394,2.53088e+15,60.0231,10523.6,34532,3922,72,26470,26470,16236,3422,3751
47443,14,176,47348,95,47443,0,6.09747e+18,173.547,2696.06,47443,171,171,15392,3222,3607,3677,3697
15862,459,885,0,15862,15398,464,4.27839e+16,164.136,2456.08,15862,124,26,14977,14746,13985,13502,10303
42987,654,10674,0,42987,15228,27759,2.48068e+15,59.8131,13574.6,42987,5191,72,32313,32313,10772,6716,2695
33036,4561,13870,0,33036,0,33036,4.91933e+17,94.7979,16031,33036,6728,110,19166,19080,9549,8349,7098
47618,10028,13672,45038,2580,45038,2580,6.53297e+18,97.0343,17052,47618,6635,110,33946,33946,32266,31995,25726
36083,2372,11004,36083,0,33983,2100,4.71671e+18,255.732,12876.1,36083,4302,125,25079,24708,15342,19243,6415
25464,4342,5988,0,25464,8956,16508,2.52716e+15,59.9482,7912.31,25464,2910,72,19476,19476,17554,16237,14468
17815,682,8372,17087,728,0,17815,1.55608e+18,93.7245,9636.27,17815,4060,110,9443,9013,6080,5516,2562
8070,1286,3656,5291,2779,7726,344,8.07245e+18,93.8286,4379.13,8070,1750,98,4414,4414,2722,3335,2085
24368,8,14,23643,725,24313,55,1.87773e+14,10.4291,525.499,24368,13,11,23979,23697,20300,20241,15550
47883,15342,20314,47883,0,31134,16749,4.57126e+18,2902.45,23785.4,47883,6571,144,27569,24643,24780,26151,20465
43109,5734,13677,43109,0,40659,2450,4.30802e+18,293.92,15797.1,43109,3432,133,29432,29263,21186,23477,14133
6628,1158,3742,6628,0,6628,0,3.21424e+18,18.5812,3951.28,6628,3354,21,2886,2886,940,877,935
34337,4260,8010,0,34337,12066,22271,2.53259e+15,60.0294,10462.5,34337,3897,72,26327,26327,21831,19455,14340
48771,4041,17221,18188,30583,0,48771,8.34072e+12,57.3109,20066.4,48771,8384,72,31550,31550,16803,27391,7949
25906,3263,9700,0,25906,9754,16152,2.0645e+15,57.7474,11366.2,25906,4714,72,16206,16206,10205,6086,4771
8618,2838,3001,8180,438,8180,438,5.42529e+18,95.3514,3859.19,8618,1426,102,5617,5617,5477,5518,5557
14582,1838,3495,0,14582,0,14582,6.4568e+17,97.1256,4923.7,14582,1673,110,11087,11087,9215,6765,6337
3805,774,929,0,3805,1341,2464,2.51432e+15,58.6497,1383.19,3805,439,65,2876,2876,2729,2609,2602
41691,449,1164,0,41691,40501,1190,3.55924e+16,244.782,3998.69,41691,181,26,40527,39960,32195,33080,21746
24669,5041,9595,23509,1160,23509,1160,4.61837e+18,95.8614,11365.8,24669,4602,111,15074,15074,12258,14910,8872
44717,416,1547,0,44717,43425,1292,3.96682e+16,303.972,5184.6,44717,255,26,43170,42148,37404,34632,20253
37860,782,1168,0,37860,36779,1081,3.67235e+16,247.668,3908.33,37860,182,26,36692,36692,33439,34132,29046
25007,1729,11334,25007,0,23872,1135,4.86408e+18,232.953,12643.4,25007,4996,128,13673,13122,7810,10070,1951
41529,5337,13774,15327,26202,0,41529,8.61594e+12,58.4235,16334.4,41529,6705,72,27755,27755,20845,26567,12582
27529,2572,9520,27529,0,26021,1508,4.60491e+18,209.746,11024.6,27529,2243,132,18009,17750,11358,13159,4640
46877,7347,18557,46877,0,44664,2213,4.60629e+18,1396.19,21242,46877,4796,142,28320,26638,19759,21056,14808
935,526,658,0,935,406,529,1.23963e+15,22.523,739.388,935,315,31,277,276,174,100,30
28645,267,921,0,28645,27830,815,3.55848e+16,176.367,2929.06,28645,133,26,27695,27453,21143,21214,12225
1186,90,354,0,1186,0,1186,6.56931e+17,87.1121,573.454,1186,153,48,757,261,357,274,346
44959,1034,10734,42339,2620,42339,2620,2.4786e+18,98.3564,14062.1,44959,5079,111,34225,34225,16554,20342,5387
40140,3592,12876,40140,0,37802,2338,3.83237e+18,286.581,14617.3,40140,4230,133,27264,26797,16670,20340,8713
27031,9,14,26235,796,26946,85,1.73856e+14,10.5048,544.981,27031,14,12,26744,26459,25676,24594,22428
4653,1,10,4515,138,4653,0,1.64421e+14,9.87771,195.701,4653,10,10,967,967,967,967,967
19848,4,10,19282,566,19842,6,1.38653e+14,9.96861,389.647,19848,10,10,17177,15203,15256,13707,10263
29754,11,12,28898,856,29738,16,1.4753e+14,10.2013,497.001,29754,12,11,29742,29742,29159,29160,28530
46978,3042,21704,0,46978,18418,28560,1.77708e+15,56.1955,24079.2,46978,10567,72,25274,25274,13281,5338,2783
19214,2,13,18654,560,19168,46,1.60002e+14,10.6746,444.944,19214,12,11,11381,8562,6580,6955,5531
47476,13555,14228,44946,2530,0,47476,2.03757e+18,96.6772,17552.3,47476,6912,110,33248,33248,33173,33171,33247
37240,555,1083,0,37240,36176,1064,3.56147e+16,227.274,3640.99,37240,165,26,36157,35690,33209,33489,23212
15475,5492,5674,14725,750,14725,750,5.26069e+18,92.7761,6960.48,15475,2695,111,9801,9801,9801,9801,9570
548,136,221,0,548,0,548,6.93648e+17,71.7993,325.421,548,89,34,327,218,251,248,273
38070,2413,14919,36310,1760,0,38070,1.77128e+18,95.3201,17423.7,38070,7243,110,23151,23065,16655,13667,8889
25653,4009,6033,0,25653,9021,16632,2.52831e+15,59.9104,7966.37,25653,2930,72,19620,19620,16766,14347,13404
16205,2344,3856,0,16205,0,16205,6.45697e+17,97.3113,5407.72,16205,1847,110,12349,12349,10313,7897,8035
22724,1872,5312,7979,14745,0,22724,9.86639e+12,59.9333,7074.37,22724,2577,72,17412,17412,12444,16552,6464
41219,178,291,41219,0,41219,0,5.54052e+18,227.843,1475.51,41219,267,35,40475,39515,30080,34214,29131
4574,1360,1893,0,4574,0,4574,5.1106e+17,91.2267,2402.49,4574,888,84,2681,2681,2527,2490,2623
29139,794,1212,0,29139,28293,846,4.10797e+16,251.887,3798.78,29139,189,26,27927,27927,25946,26286,22279
26247,47,176,26175,72,26247,0,6.00047e+18,171.31,1948.94,26247,163,161,16361,7557,5936,7346,6895
4766,154,1761,0,4766,0,4766,5.45008e+17,93.1997,2314.11,4766,831,86,3005,2837,1408,755,733
18226,2732,4316,17161,1065,0,18226,2.2287e+18,97.4131,6007.25,18226,2083,110,13910,13910,11750,11371,9360
49371,109,176,49345,26,49371,0,5.98322e+18,171.784,2632.03,49371,173,171,45338,35488,28612,30011,30600
19976,1581,4723,7031,12945,0,19976,9.86296e+12,59.9156,6310.83,19976,2299,72,15253,15253,9606,13803,5262
40474,2544,20434,0,40474,16163,24311,1.63652e+15,55.739,22402.4,40474,9951,72,20040,20040,12384,7726,3268
8184,2970,3691,8184,0,7792,392,4.47093e+18,100.434,4255.16,8184,1185,112,4493,4483,4393,4492,4103
33485,100,1010,0,33485,32529,956,3.55586e+16,207.062,3325.66,33485,151,26,32186,32096,25794,26203,7740
17129,2485,4021,6014,11115,0,17129,9.91546e+12,59.8776,5427.48,17129,1958,72,13108,13108,11331,12738,8487
14739,1292,3521,13881,858,0,14739,2.22597e+18,97.232,4962.32,14739,1691,110,11218,11218,7739,7143,4844
49034,11270,11757,46184,2850,46184,2850,5.68294e+18,98.3499,15319.6,49034,5570,111,37277,37277,37217,37082,36243
39203,44,176,39111,92,39203,0,6.10124e+18,173.301,2451.76,39203,164,170,25132,9713,8942,10369,9560
42168,1501,9897,0,42168,0,42168,6.48039e+17,97.8512,13143.2,42168,4799,110,32271,32271,20830,10174,6522
10879,124,460,0,10879,10569,310,3.53963e+16,20.0997,1293.63,10879,66,26,10419,10419,7985,7982,3996
49547,3151,11571,46658,2889,0,49547,2.23004e+18,97.9204,15264.4,49547,5618,110,37976,37976,21797,19951,12153
32056,8848,10863,0,32056,11865,20191,2.18382e+15,57.6782,12922.2,32056,5285,72,21193,21193,19535,19205,16913
36902,5644,10589,34902,2000,0,36902,2.0754e+18,96.9714,13356.9,36902,5134,110,26313,26313,21125,20009,15020
4833,1234,1269,4556,277,4556,277,3.19111e+18,94.9069,1892.81,4833,589,85,3564,3564,3558,3563,3564
29942,5738,14495,0,29942,0,29942,4.36518e+17,93.7132,16328.5,29942,7030,110,15447,15447,11420,8553,7333
9837,2304,2663,9287,550,0,9837,2.14077e+18,96.3364,3702.38,9837,1275,110,7174,7174,6786,6688,6441
1665,511,1053,0,1665,695,970,1.30576e+15,28.0306,1202.89,1665,491,48,612,612,612,612,612
43831,2565,10174,0,43831,15410,28421,2.53376e+15,60.0848,13175.1,43831,4953,72,33657,33657,17908,14140,8802
2515,552,660,2365,150,0,2515,2.25664e+18,92.8505,1050.03,2515,302,63,1855,1855,1735,1744,1758
6812,6,11,6618,194,6807,5,1.38176e+14,10.649,231.925,6812,11,11,6427,6200,5585,5587,4328
33245,5,14,32296,949,33167,78,1.38888e+14,10.6612,561.643,33245,13,12,30597,27422,22051,22704,18917
15783,460,5502,5855,9928,0,15783,8.39424e+12,58.0212,6670.71,15783,2675,72,10281,10137,6147,9571,1290
25182,4,12,24467,715,25168,14,1.3905e+14,10.5191,451.059,25182,12,11,21985,19580,16428,16817,12365
11523,1572,3299,0,11523,4150,7373,2.35848e+15,58.8717,4282.35,11523,1602,72,8224,8224,6309,4217,4136
42294,4,13,38832,3462,42292,2,1.14982e+14,7.91439,534.483,42294,12,8,35380,31926,23288,30198,31924
37398,5,12,36326,1072,37382,16,1.42943e+14,10.2607,553.296,37398,12,11,34419,30670,30194,28761,20887
25185,10767,11578,25185,0,24058,1127,4.05753e+18,257.471,12910,25185,5163,128,13607,13607,13343,13491,13226
13130,3844,4663,12480,650,12480,650,2.9613e+18,83.7059,5835.02,13130,2232,110,8467,8467,7664,8252,6727
36397,1768,8475,12790,23607,0,36397,9.89297e+12,60.0577,11050,36397,4125,72,27922,27922,13450,24027,6326
49888,15740,21035,19202,30686,0,49888,7.45604e+12,56.5704,23681.4,49888,10241,72,28853,28853,25402,28263,21428
46790,6203,18958,46790,0,45138,1652,4.91337e+18,4285.47,23847.8,46790,7893,148,27290,20485,15780,19224,10606
38749,314,12664,36767,1982,0,38749,1.95979e+18,95.3262,15413.2,38749,6136,110,26085,25569,15145,12791,0
27369,6031,8870,0,27369,0,27369,5.73449e+17,94.5372,10976.8,27369,4297,110,18499,18499,15452,12863,12055
32167,103,986,0,32167,31250,917,3.5573e+16,199.829,3220.33,32167,146,26,30910,30831,24859,25398,7824
38420,66,176,38352,68,38420,0,6.16657e+18,173.228,2418.22,38420,166,160,30776,22557,14049,14668,13824
17627,516,4340,16607,1020,16607,1020,4.91801e+18,97.4309,5954.15,17627,2024,111,13287,13287,6021,8541,2299
19644,200,6536,19644,0,18505,1139,4.5855e+18,148.875,7606.93,19644,2374,124,13108,12855,4257,8016,884
44300,622,1213,0,44300,43039,1261,3.55815e+16,252.031,4205.32,44300,190,26,43087,42465,39610,39935,27901
43409,5303,17237,43409,0,41189,2220,4.55653e+18,352.849,19020.7,43409,3637,138,26172,25870,16994,19873,9483
27798,6,12,27009,789,27787,11,1.39016e+14,10.3695,472.347,27798,12,11,26395,25546,23224,23182,16516
10823,142,176,10817,6,10823,0,6.03044e+18,164.522,1277.99,10823,126,128,10402,9707,8690,8742,8718
48424,579,13800,0,48424,17475,30949,2.36151e+15,59.2712,16871.4,48424,6721,72,34624,34432,12617,2790,2145
46478,1445,14465,0,46478,0,46478,5.81973e+17,96.647,17695.6,46478,7018,110,32013,32013,15915,5959,4980
18012,4900,18012,0,18012,18012,0,2047.89,0,18012,18012,18012,1,0,0,0,0,0
14755,6904,7950,14755,0,14755,0,2.89744e+18,17.9189,8277.1,14755,7143,20,6805,6805,5937,5909,5951
24269,6628,8198,24269,0,22881,1388,4.63558e+18,159.419,9416.85,24269,1807,128,16071,16071,15297,15941,13332
12443,765,2963,0,12443,4380,8063,2.51608e+15,59.6711,4062.15,12443,1427,72,9480,9480,5174,4004,2686
19657,4540,6780,0,19657,0,19657,5.54957e+17,93.3532,8381.16,19657,3270,110,12877,12877,11037,9829,9109
47942,22507,28096,0,47942,0,47942,3.50597e+17,91.4704,30321.6,47942,13662,110,19846,19846,18781,18270,17344
3459,732,850,1211,2248,0,3459,9.82141e+12,58.5357,1273.49,3459,405,64,2609,2609,2481,2579,2395
22470,5536,8149,21380,1090,0,22470,1.86014e+18,93.5385,9883.9,22470,3928,110,14321,14321,12912,12190,10841
19828,2425,10772,19128,700,19128,700,3.10255e+18,91.095,11987.1,19828,5171,111,9056,9056,3320,4778,2351
19466,1807,6483,19466,0,18337,1129,4.58162e+18,147.576,7547.24,19466,2361,124,12983,12893,7615,9681,4025
29180,166,176,29105,75,29180,0,5.983e+18,169.715,2024.74,29180,161,164,28912,28572,27429,27381,27427
25740,5230,8422,25740,0,24240,1500,3.62836e+18,167.486,9695.07,25740,2723,129,17318,17318,14825,15618,11209
48739,23780,48739,0,48739,0,48739,524277,0,48739,48739,48739,1,0,0,0,0,0
815,63,69,0,815,790,25,4.12895e+16,17.654,178.474,815,26,21,746,746,741,734,734
11792,527,4415,11222,570,11222,570,1.70275e+18,95.4199,5459.59,11792,2097,111,7377,7203,4772,3831,2164
1028,1,11,1001,27,1028,0,1.38273e+14,10.2743,90.3461,1028,11,11,264,264,264,264,264
2505,56,121,0,2505,0,2505,3.83734e+18,15.8659,297.054,2505,114,17,2384,2384,1593,1768,2011
23528,8739,8946,0,23528,8881,14647,2.05133e+15,57.2,10477.5,23528,4352,72,14582,14582,14287,14123,14097
7456,762,2256,2700,4756,0,7456,9.11148e+12,58.2584,2953.09,7456,1085,72,5200,5200,3324,4873,1183
22881,10349,11243,22881,0,22881,0,2.84811e+18,17.9749,11678.4,22881,10110,20,11638,11638,10754,10708,10769
7233,880,4004,6983,250,0,7233,1.33381e+18,91.3665,4587.4,7233,1921,89,3229,3057,2297,1900,1444
37545,3744,17201,35995,1550,35995,1550,2.68023e+18,93.3947,19467.3,37545,8338,110,20344,20344,10153,13770,7273
32674,2024,7632,11488,21186,0,32674,9.90253e+12,60.0306,9983.94,32674,3718,72,25042,25042,13686,22041,6864
37039,7647,15495,14223,22816,0,37039,7.50516e+12,56.093,17581.3,37039,7531,72,21544,21544,16483,20674,10470
12920,39,61,12920,0,12920,0,2.26939e+18,60.4564,841.047,12920,61,61,11021,7185,8317,8832,8163
25059,2801,9275,23859,1200,23859,1200,7.70988e+18,93.3408,11141.9,25059,4488,110,15784,15784,13669,13323,5328
39078,93,176,38995,83,39078,0,5.99593e+18,172.891,2369.52,39078,173,171,33988,21377,18929,20177,20838
1797,523,1259,1748,49,1748,49,1.18089e+19,83.4942,1414.65,1797,589,48,538,452,481,473,455
40416,3120,15237,0,40416,15240,25176,2.05488e+15,57.7709,17604.9,40416,7412,72,25179,25179,14592,6920,4598
47512,1512,1742,0,47512,46128,1384,4.11398e+16,302.678,5840.99,47512,297,26,45770,45770,45324,45287,42766
32148,7534,7727,11342,20806,0,32148,9.79177e+12,59.8911,10036.3,32148,3753,72,24421,24421,24174,24378,24018
33672,6349,11054,31952,1720,31952,1720,3.1127e+18,95.6916,13516,33672,5344,110,22618,22618,16947,19185,14853
851,14,159,851,0,851,0,5.98611e+18,92.6016,335.95,851,53,42,256,37,61,63,64
21623,1,12,21006,617,21615,8,1.38752e+14,10.3862,415.735,21623,12,11,5544,5544,5544,5544,5544
39245,9034,10871,0,39245,14099,25146,2.39308e+15,59.3627,13473.9,39245,5296,72,28374,28374,26840,24761,24418
11984,1400,4598,0,11984,0,11984,5.29407e+17,94.7549,5654.68,11984,2221,110,7386,7386,5965,4873,4736
47027,2440,18198,0,47027,0,47027,5.18367e+17,94.6784,21173.1,47027,8835,110,28829,28829,17298,7691,3767
15730,220,3741,14810,920,0,15730,2.23214e+18,97.3061,5253.85,15730,1803,110,11989,11959,3791,3160,1498
44387,864,18184,44387,0,42407,1980,4.74854e+18,1839.18,21040.8,44387,7728,144,24765,22354,11084,15608,1968
45935,7143,19609,45935,0,43925,2010,4.6009e+18,2036.59,22386.6,45935,7090,144,26326,23671,17396,21738,12269
46286,12343,16408,46286,0,43736,2550,4.42615e+18,309.514,18292.2,46286,3316,137,29878,29842,27532,29168,23691
16290,2446,3841,5730,10560,0,16290,9.8705e+12,59.8205,5193.14,16290,1865,72,12449,12449,10840,12111,8306
21401,2,11,20792,609,21393,8,1.38745e+14,10.1871,409.054,21401,11,11,12398,8784,8471,8812,7385
739,218,335,739,0,699,40,4.43129e+18,73.5453,456.28,739,103,44,404,404,330,358,362
39116,8116,9503,36866,2250,36866,2250,6.02033e+18,97.691,12538.2,39116,4606,110,29613,29613,29263,29263,25659
24161,49,176,24104,57,24161,0,6.00003e+18,169.293,1869.82,24161,156,163,15399,7443,5801,7020,6704
39643,11359,14838,37743,1900,37743,1900,4.55286e+18,96.0683,17429.7,39643,7093,111,24805,24805,22869,24694,20775
25645,844,1305,24586,1059,7642,18003,1.41854e+18,16.9862,1918.96,25645,1069,19,24340,24340,22960,23392,18578
28966,143,927,0,28966,28139,827,3.55835e+16,178.066,2954.81,28966,135,26,27880,27762,23088,23365,8638
15514,2592,3692,14605,909,14605,909,3.21643e+18,97.3162,5187.07,15514,1773,110,11822,11822,10701,11511,9025
21084,79,778,0,21084,20482,602,3.55298e+16,99.1921,2293.88,21084,104,26,20259,20205,13450,13314,5402
43551,21749,25119,17954,25597,0,43551,5.46003e+12,53.1318,26964.7,43551,12214,72,18432,18432,16964,18182,15420
12909,1564,3179,12159,750,12159,750,2.72013e+18,97.4974,4458.06,12909,1493,111,9730,9730,5688,7348,5567
17786,6624,7574,17786,0,16926,860,5.62923e+18,148.274,8615.9,17786,3111,127,10212,10212,9743,10127,8610
10522,109,176,10521,1,10522,0,6.00786e+18,161.025,1250,10522,128,127,9597,7739,6195,6451,6518
35081,8260,8426,33038,2043,33038,2043,2.13658e+18,98.2484,11159.8,35081,3978,111,26655,26655,26655,26655,26433
601,186,302,568,33,568,33,3.96815e+18,69.5641,399.637,601,125,39,299,242,201,288,204
1394,240,375,492,902,0,1394,9.74887e+12,56.2346,591.026,1394,173,48,1019,1019,883,989,792
48159,8937,12003,45394,2765,45394,2765,1.24849e+18,98.199,15477.6,48159,5682,111,36156,36156,33305,35952,28334
32480,1146,9975,32480,0,30590,1890,3.98677e+18,222.256,11702.8,32480,3876,125,22505,22219,11936,15995,3233
44693,2501,10440,0,44693,15714,28979,2.52949e+15,60.06,13481.2,44693,5082,72,34253,34253,22687,17827,8554
10639,1665,2657,10026,613,10026,613,2.77996e+18,97.128,3763.42,10639,1237,111,7982,7982,6980,7909,5475
42834,10930,16076,40802,2032,0,42834,1.81831e+18,95.6002,18879.8,42834,7807,110,26758,26758,23163,22386,19420
39228,15902,25039,38138,1090,38138,1090,4.16724e+18,91.0957,26734.1,39228,12130,111,14189,14189,10914,11537,11148
7764,604,3081,7404,360,7404,360,2.78817e+18,91.2418,3843.81,7764,1461,100,4683,4511,3174,3537,1544
35604,2532,11496,35604,0,33534,2070,4.96869e+18,250.312,13092.1,35604,4240,128,24108,23748,14153,18634,6226
34840,5012,10955,33010,1830,33010,1830,3.98002e+18,95.7786,13472,34840,5233,111,23885,23885,19521,22871,12726
830,712,797,0,830,0,830,1.33895e+17,2.29398,809.57,830,359,32,33,33,33,33,33
3822,353,368,0,3822,3710,112,4.85286e+16,18.4574,866.347,3822,56,26,3454,3454,3430,3433,3326
2261,317,573,799,1462,0,2261,9.7673e+12,57.4847,881.059,2261,270,56,1688,1688,1406,1628,1106
15575,2999,3696,0,15575,0,15575,6.50337e+17,97.3914,5200.69,15575,1781,110,11879,11879,11090,9983,10105
20290,190,6547,0,20290,0,20290,5.76021e+17,96.1933,8226.97,20290,3171,110,13743,13167,8034,1979,1541
6459,1435,3231,6459,0,6169,290,4.41507e+18,89.5199,3692.51,6459,1337,96,3228,3228,1943,2463,1609
28703,1,11,27886,817,28691,12,1.38997e+14,10.1588,474.651,28703,11,11,7346,7346,7346,7346,7346
9435,1423,2367,8888,547,8888,547,2.96507e+18,97.0518,3379.68,9435,1098,111,7068,7068,6113,6998,4690
33034,9606,12398,0,33034,12444,20590,2.06648e+15,57.788,14413.7,33034,6040,72,20636,20636,18829,17793,16873
32803,880,1200,0,32803,31857,946,3.90328e+16,240.188,3860.64,32803,188,26,31603,31603,29952,30589,27208
19292,9,13,18721,571,19277,15,1.80963e+14,10.1461,417.064,19292,12,12,19123,18947,16047,16065,16103
8839,744,2231,8327,512,8327,512,3.67813e+18,96.9432,3195.1,8839,1041,109,6608,6608,6608,6608,2778
6556,1189,2139,6556,0,6176,380,5.77014e+18,93.1036,2733.68,6556,529,105,4417,4417,4074,4417,2859
48895,11518,27328,0,48895,10517,38378,1.36503e+13,8.98607,27750.5,48895,24591,11,21567,21567,12066,21567,11554
27489,3874,6494,25890,1599,25890,1599,5.89783e+18,97.6604,8813.5,27489,3138,110,20995,20995,20355,20355,13404
20596,24,176,20541,55,20596,0,6.04564e+18,171.081,1761.76,20596,148,154,9212,2229,2680,2820,2768
579,512,553,569,10,569,10,3.39405e+18,2.07772,562.849,579,237,21,26,26,26,26,26
912,276,372,862,50,862,50,4.06709e+18,81.5866,528.53,912,157,45,540,540,458,534,460
10479,1923,2555,9871,608,9871,608,3.3413e+18,96.7607,3668.79,10479,1215,110,7924,7924,6693,7259,6368
29769,206,208,29755,14,29769,0,5.99348e+18,195.276,2159.4,29769,172,175,29559,29520,29361,29180,29316
24750,13,175,24740,10,24750,0,5.98138e+18,166.746,1860.75,24750,156,162,7385,1119,1571,1596,1630
3436,1253,1353,3269,167,3269,167,5.06823e+18,92.4584,1775.57,3436,630,69,2083,2083,1994,2016,2062
28696,637,7888,27099,1597,27099,1597,2.95288e+18,97.55,10149.3,28696,3746,111,20808,20634,9223,13028,3344
24594,458,5837,0,24594,0,24594,6.46457e+17,97.5803,7963.21,24594,2821,110,18757,18757,11504,4916,2621
40050,5518,13591,14830,25220,0,40050,8.52065e+12,58.3643,16052.3,40050,6615,72,26459,26459,19606,24663,12005
18578,2319,6149,18578,0,17498,1080,3.33704e+18,144.236,7185.48,18578,2218,121,12429,12347,7968,9628,5243
40505,11607,12275,40505,0,38145,2360,3.50154e+18,289.289,14317.4,40505,4841,128,28230,28230,28195,28157,27107
42161,8967,9846,39710,2451,0,42161,2.22831e+18,97.8331,13098.7,42161,4764,110,32315,32315,31152,30928,30027
30255,879,969,0,30255,29390,865,3.59109e+16,193.431,3116.15,30255,142,26,29286,29286,29049,29037,27701
16500,1366,7085,15780,720,0,16500,1.67226e+18,94.2635,8350.49,16500,3426,110,9415,9415,5802,5469,3969
20000,2282,11508,20000,0,19293,707,4.87147e+18,184.106,12473.3,20000,5274,122,8492,7963,5666,6975,4537
28336,3270,9211,28336,0,26686,1650,3.39546e+18,172.519,10564.9,28336,3193,130,19125,18933,12938,15048,7287
34713,44,176,34649,64,34713,0,6.13528e+18,169.598,2303.6,34713,157,164,22986,8510,8271,9117,8757
8078,143,186,8076,2,8078,0,5.97391e+18,173.327,1086.73,8078,117,121,7656,7188,6109,6265,6120
16932,786,10043,0,16932,0,16932,3.4842e+17,88.2928,11050.7,16932,4868,110,6889,6287,3459,698,806
27783,1246,6532,9764,18019,0,27783,9.85291e+12,59.9514,8596.96,27783,3170,72,21251,21251,9730,18123,4422
37493,8957,17629,14748,22745,0,37493,6.84048e+12,56.202,19584.7,37493,8572,72,19864,19864,15841,19024,9182
1853,699,802,1853,0,1753,100,3.75531e+18,87.606,1038.96,1853,313,58,1051,1051,1001,1030,1020
37567,11215,11725,0,37567,0,37567,5.80764e+17,96.5492,14453.1,37567,5678,110,25842,25842,25192,24696,24677
39023,2107,13052,0,39023,0,39023,5.63593e+17,96.2638,15789.7,39023,6340,110,25971,25971,15981,5599,4193
23229,13457,13773,0,23229,0,23229,3.46625e+17,89.4087,15044.5,23229,6679,110,9456,9456,9130,9014,8838
11513,9,11,11171,342,11504,9,1.83412e+14,10.0176,317.661,11513,11,11,11395,11269,10687,10705,10142
43930,105,176,43803,127,43930,0,6.15371e+18,173.094,2587.58,43930,166,167,40299,31746,25065,25785,25429
8911,531,741,0,8911,8646,265,4.72972e+16,62.0894,1801.86,8911,96,26,8170,8114,7509,7641,5990
24201,11129,14203,24201,0,23441,760,5.25559e+18,535.19,15565.3,24201,4190,132,9998,9923,9563,9840,9394
755,406,755,0,755,755,0,2045.29,0,755,755,755,1,0,0,0,0,0
30485,9410,12454,30485,0,28995,1490,4.90723e+18,296.248,14064.8,30485,3841,132,18031,18012,17087,17892,14804
19484,312,792,0,19484,18927,557,3.67463e+16,104.943,2287.97,19484,106,26,18692,18576,15498,15556,11102
12472,3961,4172,12472,0,11745,727,4.17691e+18,99.2033,4974.39,12472,1481,118,8300,8293,8208,8260,8148
25732,3319,6029,24232,1500,24232,1500,3.23933e+18,97.6551,8237.54,25732,2907,110,19703,19703,16938,18899,11790
6491,1526,1587,0,6491,2296,4195,2.52305e+15,59.3278,2254.88,6491,773,72,4904,4904,4830,4824,4831
25025,2168,5837,0,25025,8792,16233,2.53385e+15,59.9769,7737.57,25025,2839,72,19188,19188,13863,8191,7453
49932,20908,27728,48242,1690,48242,1690,2.32114e+18,92.8302,30152.9,49932,13490,110,22204,22204,19348,21545,15875
36271,544,1602,0,36271,35207,1064,4.39903e+16,295.731,5132.23,36271,268,26,34669,33578,31279,27906,14588
18161,1320,5601,17201,960,0,18161,2.02313e+18,96.2368,7168.48,18161,2700,110,12560,12560,8210,7391,3167
13759,3324,4433,13042,717,13042,717,3.10513e+18,95.8919,5688.96,13759,2140,110,9326,9326,7116,8137,6277
18428,4829,5035,17408,1020,0,18428,2.1217e+18,96.601,6684.83,18428,2419,110,13393,13393,13193,13170,13080
17169,1966,4038,6036,11133,0,17169,9.8926e+12,59.8402,5447.06,17169,1961,72,13131,13131,10584,12578,6441
3077,151,170,3075,2,3077,0,5.96244e+18,144.24,653.072,3077,87,81,2882,2815,2653,2649,2636
11380,2358,7310,11062,318,11062,318,2.01816e+18,83.3893,7997.35,11380,3523,99,4070,4070,2592,3159,1012
24267,9115,11555,0,24267,0,24267,4.44935e+17,93.8052,13141.3,24267,5605,110,12712,12712,11661,11245,10954
3903,451,1498,3713,190,3713,190,3.00168e+18,92.4017,1968.74,3903,705,71,2405,2319,1605,1882,1592
28798,3610,9464,0,28798,0,28798,5.70755e+17,96.2292,11637.7,28798,4592,110,19334,19334,13582,10192,8009
33454,5460,7802,0,33454,11765,21689,2.53442e+15,60.0443,10204.5,33454,3795,72,25652,25652,22294,20266,18340
13720,326,3848,0,13720,0,13720,6.15214e+17,96.5452,5156.32,13720,1856,110,9872,9786,6075,1941,1719
23428,8,14,22731,697,23342,86,1.85095e+14,10.4842,512.543,23428,13,12,23046,22764,21254,17281,15148
3634,1167,2383,3534,100,3534,100,3.75683e+18,70.8621,2677.75,3634,1117,66,1251,1164,1002,1075,1109
27185,4,14,26389,796,27131,54,1.65706e+14,10.5078,529.735,27185,13,11,23780,21244,17314,17634,11184
8970,528,695,0,8970,8703,267,4.4319e+16,20.6255,1670.27,8970,88,26,8275,8274,7951,8037,6635
3733,239,902,1313,2420,0,3733,1.00091e+13,58.8245,1350.18,3733,435,65,2831,2831,1467,2454,854
16077,1484,5464,15267,810,0,16077,1.9305e+18,95.1612,6850.8,16077,2632,110,10613,10613,7340,6750,4763
26876,6136,6345,25316,1560,0,26876,2.22489e+18,97.6718,8627.9,26876,3063,110,20531,20531,20297,20266,20211
47659,17248,17880,0,47659,17950,29709,2.06189e+15,57.7629,20594,47659,8704,72,29779,29779,29253,28714,28553
11808,3074,5656,11338,470,11338,470,9.26724e+18,91.4256,6584.07,11808,2725,107,6152,6152,5572,5481,3604
36546,2397,8567,34424,2122,34424,2122,3.21912e+18,97.7705,11469,36546,4142,110,27979,27979,17792,22894,9107
39009,8255,11230,36879,2130,36879,2130,3.75114e+18,97.5471,14056.7,39009,5340,111,27779,27779,22356,23600,19737
35980,3032,8381,12643,23337,0,35980,9.91305e+12,60.0498,10927.1,35980,4082,72,27599,27599,19772,26249,10265
18242,3143,6124,0,18242,6737,11505,2.19294e+15,58.2564,7451.57,18242,2970,72,12118,12118,9378,8315,6235
3161,283,771,0,3161,1118,2043,2.56753e+15,58.6751,1166.58,3161,374,62,2390,2390,1561,1206,1007
24181,4718,5671,22771,1410,0,24181,2.23095e+18,97.6244,7777.4,24181,2738,110,18510,18510,17220,16967,15935
40456,1335,10934,38215,2241,38215,2241,3.25439e+18,97.2406,13963.5,40456,5291,110,29522,29522,13445,20283,6060
935,304,389,935,0,883,52,4.31684e+18,78.661,538.926,935,133,47,546,546,495,511,524
31212,5151,8685,0,31212,11217,19995,2.38448e+15,59.295,10844.2,31212,4228,72,22527,22527,19242,18821,13852
12577,462,2979,11847,730,11847,730,3.25219e+18,97.0162,4264.22,12577,1423,110,9598,9598,4906,7154,2113
6252,329,1785,5904,348,5904,348,6.29596e+18,91.7234,2519.94,6252,831,94,4467,4467,3480,2845,172
4815,395,2414,0,4815,1913,2902,1.71545e+15,54.8901,2808.32,4815,1176,63,2401,2353,1705,1087,1109
42980,9538,16612,0,42980,16278,26702,2.02334e+15,57.2736,19071.3,42980,8077,72,26368,26368,22584,17346,16320
3916,365,1022,3686,230,3686,230,5.09803e+18,94.9316,1555.33,3916,462,81,2894,2894,2201,2527,1396
44321,24420,25186,18212,26109,0,44321,5.56959e+12,54.4932,27085.1,44321,12263,72,19135,19135,18997,19112,18991
19081,86,176,19027,54,19081,0,6.17853e+18,164.686,1694.1,19081,134,135,16743,13270,9494,9483,9095
2185,10,11,2119,66,2181,4,1.99158e+14,10.5382,138.78,2185,11,11,2165,2150,2133,2134,2061
7825,714,7825,7825,0,7825,0,34355300000,0,7825,7825,7825,1,0,0,0,0,0
8925,68,393,0,8925,8673,252,3.57341e+16,19.9276,1102.57,8925,59,26,8532,8532,6051,6011,2586
6290,1103,2284,5980,310,5980,310,7.60975e+18,89.7394,2966.42,6290,1074,87,4006,4006,3886,3886,2940
34923,17630,18857,0,34923,14166,20757,1.519e+15,53.496,20512.2,34923,9164,72,16066,16066,15499,15343,14744
30506,5482,8761,0,30506,0,30506,6.03878e+17,96.3964,11146.5,30506,4244,110,21745,21745,18550,16067,15013
20796,1576,11370,4490,16306,0,20796,5.3109e+10,8.93734,11648,20796,10231,11,9426,9426,3210,9426,2787
32668,6130,9717,30920,1748,30920,1748,3.10889e+18,96.7708,12203.5,32668,4710,110,22951,22951,20077,22161,15243
6483,1253,2290,0,6483,2404,4079,2.14632e+15,57.5153,2887.44,6483,1110,72,4193,4193,3998,3894,3906
17017,575,921,0,17017,16519,498,4.28145e+16,186.9,2600.55,17017,133,26,16096,15824,15280,15081,12059
32703,7195,7682,30803,1900,0,32703,2.22687e+18,97.7356,10343.6,32703,3712,110,25021,25021,24488,24337,23907
8125,111,356,0,8125,7893,232,3.57317e+16,20.0444,1011.59,8125,56,26,7769,7769,6158,6191,3378
14965,150,762,0,14965,14532,433,3.92044e+16,86.0009,2067.61,14965,99,26,14203,14123,12292,11499,5175
24207,4014,8843,24207,0,22917,1290,5.31746e+18,177.686,10194.4,24207,2170,133,15364,15350,12619,13866,7256
37937,6198,9440,0,37937,0,37937,6.35724e+17,97.6088,12384.8,37937,4574,110,28497,28497,25068,19973,19490
7532,1193,1913,7092,440,7092,440,4.45161e+18,96.6925,2768.4,7532,889,101,5619,5619,4869,5571,4108
9593,154,2350,9036,557,9036,557,3.22761e+18,96.6219,3393.69,9593,1119,110,7243,7161,3009,4903,984
23291,144,176,23278,13,23291,0,6.00694e+18,169.69,1846.24,23291,155,161,22620,21248,19225,19245,18967
46907,2892,10878,46907,0,46907,0,2.61647e+18,4652.3,16533.3,46907,7384,27,28434,22684,9768,6393,10609
38397,9654,10874,0,38397,0,38397,6.0589e+17,97.0469,13742,38397,5265,110,27523,27523,26243,25777,24389
16205,874,4953,13009,3196,15338,867,2.17052e+18,94.7838,6376.86,16205,2343,111,11252,11252,5279,7410,2430
38033,1450,10712,35958,2075,35958,2075,6.60053e+18,97.0507,13560.2,38033,5194,110,27321,27321,25524,22858,5681
39119,8070,20337,39119,0,0,39119,8.84412e+17,17.9829,20894.2,39119,18290,20,18782,18782,8068,11544,7218
40632,4425,9505,0,40632,14290,26342,2.53168e+15,60.053,12313.4,40632,4629,72,31127,31127,24509,23381,14928
37891,229,1091,0,37891,36811,1080,3.5541e+16,228.038,3679.09,37891,167,26,36639,36323,31035,31011,13502
23768,6878,14237,23038,730,23038,730,2.24916e+18,89.8935,15516,23768,6892,110,9531,9531,5719,6898,5188
29628,6839,9997,10956,18672,0,29628,8.54179e+12,51.8125,11936.9,29628,4848,72,19631,19631,19631,19631,19631
40586,7976,10375,38287,2299,38287,2299,6.22416e+18,97.5194,13456.7,40586,5036,110,30211,30211,29621,29621,23287
4295,249,308,0,4295,870,3425,1.45622e+16,11.9502,511.77,4295,182,14,3987,3987,3637,3449,3826
17580,5575,5815,16677,903,16677,903,2.86411e+18,92.0821,7287.14,17580,2760,111,11765,11765,11765,11765,11765
7703,136,439,7703,0,7386,317,2.4133e+18,17.7997,773.001,7703,327,21,7264,7264,4990,5665,3606
23837,4014,7764,23837,0,22484,1353,3.24424e+18,156.25,9131.3,23837,3049,124,16073,16073,12219,13274,8218
25150,89,175,25079,71,25150,0,5.98511e+18,166.595,1875.27,25150,162,160,21540,12889,11923,12612,12988
42342,20,176,42258,84,42342,0,6.01044e+18,172.847,2490.67,42342,172,173,16754,3018,4377,5143,4572
15585,460,808,0,15585,15135,450,4.02663e+16,121.74,2223.41,15585,110,26,14777,14639,13898,13724,9886
35758,4741,8336,12572,23186,0,35758,9.87985e+12,60.0447,10875,35758,4049,72,27422,27422,22227,26522,15963
25678,4965,7471,24279,1399,24279,1399,3.58403e+18,97.3786,9512.58,25678,3555,111,18207,18207,14888,15501,13517
30389,3251,7331,28620,1769,28620,1769,2.06844e+18,98.1751,9776.58,30389,3453,111,23058,23058,17449,20200,11286
1435,739,1219,652,783,0,1435,2.36737e+12,10.9798,1287.49,1435,571,38,216,216,216,216,216
41153,12353,13206,0,41153,15101,26052,2.23994e+15,58.6685,15783.5,41153,6426,72,27947,27947,26909,25985,25332
37054,5808,16728,0,37054,0,37054,4.65619e+17,93.5779,18991.4,37054,8125,110,20326,20326,13513,9917,6585
42749,4100,13698,42749,0,40259,2490,4.6098e+18,301.122,15518,42749,5104,126,29051,28887,17485,23266,10083
26909,2044,6311,9461,17448,0,26909,9.90944e+12,59.9779,8319.6,26909,3074,72,20598,20598,12729,18559,6850
2070,8,11,2011,59,2070,0,1.38154e+14,10.701,126.799,2070,11,11,2013,1967,1895,1894,1624
24796,6644,12832,0,24796,9959,14837,1.59575e+15,53.8547,14147.7,24796,6228,72,11964,11964,9560,9889,6872
10763,141,296,10763,0,10763,0,5.59256e+18,128.439,803.253,10763,266,36,10404,10291,7225,8282,7599
47576,11,16,46193,1383,47482,94,1.61995e+14,10.4458,721.547,47576,14,13,47558,47549,42586,42428,41927
24971,5694,11875,23971,1000,0,24971,1.53349e+18,93.7928,13493.6,24971,5759,110,13096,13010,11708,11460,10460
9311,346,3887,8892,419,8892,419,2.88862e+18,93.8529,4731.18,9311,1863,101,5424,5166,2280,3484,1451
30333,115,176,30260,73,30333,0,5.982e+18,169.709,2063.98,30333,168,164,28162,25421,18897,19508,19907
48307,25,176,48208,99,48307,0,6.08198e+18,173.798,2717.58,48307,171,172,22502,5893,6838,7116,6535
26429,1,14,25668,761,26348,81,1.5233e+14,10.6404,518.907,26429,13,12,6086,6086,6086,6086,6086
40225,3084,11127,28444,11781,37995,2230,1.36967e+18,97.7381,14055.4,40225,5280,111,29098,29098,29098,28963,9825
43819,3,15,42555,1264,43737,82,1.52515e+14,10.3734,669.065,43819,13,13,33645,24526,25498,27100,16656
6141,116,2299,0,6141,2294,3847,2.08876e+15,53.2185,2857.59,6141,1100,72,3842,3746,1443,1083,416
23726,5,6,23320,406,23694,32,9.93099e+13,3.99785,354.071,23726,5,4,23720,23720,23720,23719,21130
48198,12370,15179,45668,2530,45668,2530,3.82032e+18,96.1984,18415,48198,7230,111,33019,33019,28067,28925,25831
29785,3078,12446,28465,1320,0,29785,1.69763e+18,93.0516,14452.9,29785,6035,110,17339,17339,11306,9384,5164
38627,601,11782,38627,0,36384,2243,4.44419e+18,278.356,13752.8,38627,4625,126,26845,26412,9850,16899,2190
12033,69,927,0,12033,11673,360,5.04038e+16,182.306,2450.62,12033,132,26,10869,10785,7946,5941,3143
48023,1051,1537,0,48023,46638,1385,3.85894e+16,293.418,5253.33,48023,253,26,46486,46486,43245,43650,36744
48645,1762,11375,0,48645,0,48645,6.48331e+17,97.9117,15015.4,48645,5522,110,37270,37270,16395,10801,7927
33850,5741,7905,0,33850,11899,21951,2.53262e+15,60.0237,10326.6,33850,3847,72,25945,25945,23386,20015,19218
23493,786,1015,0,23493,22812,681,4.01373e+16,205.792,3063.52,23493,152,26,22478,22478,22064,22069,20030
41002,1196,1473,0,41002,39814,1188,4.00006e+16,281.11,4878.83,41002,241,26,39529,39529,39024,38958,35888
36448,971,1521,0,36448,35382,1066,4.26063e+16,281.979,4898.7,36448,250,26,34927,34927,32690,33261,27247
26678,5133,12470,10479,16199,0,26678,6.87593e+12,55.4994,13973.7,26678,6052,72,14208,14208,10208,13518,5484
32129,10272,10869,11899,20230,0,32129,8.54633e+12,58.3807,12933.4,32129,5295,72,21260,21260,20716,21142,20010
35554,14,1324,0,35554,34522,1032,3.99019e+16,265.756,4294.83,35554,213,26,32064,29680,23848,21686,4939
26582,11696,12935,0,26582,0,26582,4.35502e+17,91.8897,14608.8,26582,6272,110,13647,13647,12747,11559,12114
12654,143,3042,11917,737,0,12654,2.22477e+18,97.0627,4326.04,12654,1462,110,9612,9529,2856,2401,1098
20788,763,772,0,20788,20194,594,3.55193e+16,93.2018,2270.02,20788,103,26,20016,20016,19990,19988,19964
11132,797,3146,10516,616,0,11132,2.10838e+18,96.2458,4264.5,11132,1514,110,7986,7986,4987,4539,3099
22958,646,1127,0,22958,22287,671,4.32007e+16,247.495,3368.05,22958,172,26,21831,21312,20485,20423,14763
42314,139,176,42217,97,42314,0,6.10924e+18,173.405,2547.03,42314,166,169,41095,38634,33158,33615,33426
24865,3042,5884,0,24865,0,24865,6.46874e+17,97.6478,8031.79,24865,2844,110,18981,18981,15818,13787,10665
35937,7138,8411,0,35937,0,35937,6.49408e+17,97.8218,11272.1,35937,4079,110,27526,27526,26164,24463,24213
6024,15,176,6018,6,6024,0,6.07619e+18,158.493,958.792,6024,102,106,2030,426,461,500,467
14636,534,616,0,14636,14219,417,3.55611e+16,20.1354,1709.29,14636,79,26,14020,14020,13881,13892,12886
37801,4620,8864,0,37801,13290,24511,2.52672e+15,60.0344,11513.5,37801,4314,72,28937,28937,23827,16889,15286
47136,2,176,47051,85,47136,0,6.018e+18,173.522,2633.65,47136,172,174,2397,65,111,66,273
5386,3033,5386,5386,0,0,5386,7.99851,0,5386,5386,5386,1,0,0,0,0,0
31891,5776,7491,30034,1857,30034,1857,3.22939e+18,97.7368,10098.1,31891,3620,110,24400,24400,22665,23905,19669
21685,5,11,21068,617,21679,6,1.38719e+14,10.1595,411.589,21685,11,11,19888,17542,17626,17110,12662
20696,242,4829,7277,13419,0,20696,9.9299e+12,59.9477,6462.77,20696,2351,72,15867,15867,4594,12723,1065
31951,1089,1339,0,31951,31021,930,4.1862e+16,271.54,4243.65,31951,216,26,30612,30612,30227,30176,27927
47461,31,176,47319,142,47461,0,6.14399e+18,173.796,2696.76,47461,168,171,25439,7833,8644,8647,8195
15031,2904,5028,15031,0,14159,872,4.81988e+18,123.306,5931.49,15031,1809,121,10003,9964,7747,8626,6155
37588,8528,11882,13767,23821,0,37588,8.81147e+12,58.2078,14291.2,37588,5772,72,25706,25706,22958,25236,19820
31400,4,15,30484,916,31322,78,1.62243e+14,10.3795,549.599,31400,13,13,27371,24376,19863,20315,12234
26023,148,176,26010,13,26023,0,5.99078e+18,169.682,1913,26023,160,163,25397,24004,22091,22199,22292
14747,6,14,14311,436,14701,46,1.92205e+14,10.5657,391.609,14747,13,11,14140,13787,12979,10225,9004
22084,1406,7592,20976,1108,0,22084,1.91664e+18,95.9025,9339.48,22084,3680,110,14492,14492,9891,9009,4861
41961,12,15,40737,1224,41866,95,1.65192e+14,10.5375,690.155,41961,13,12,41946,41942,41056,41076,37697
3493,1059,1986,3493,0,3493,0,2.43755e+18,16.9871,2129.06,3493,1773,20,1507,1507,834,1507,881
20845,712,779,0,20845,20251,594,3.56538e+16,100.191,2291.43,20845,104,26,20066,20066,19889,19879,19090
11037,295,675,0,11037,10716,321,4.03084e+16,19.8556,1703.61,11037,85,26,10362,10362,8826,8953,5407
34654,12,15,33640,1014,34594,60,1.71936e+14,10.3814,625.048,34654,13,11,34639,34638,34404,34404,32029
41712,12198,15751,0,41712,0,41712,5.27484e+17,95.5833,18485.7,41712,7654,110,25961,25961,21972,20606,15363
46276,6453,20656,34391,11885,44316,1960,5.2013e+18,94.0298,23311.8,46276,9938,111,25620,25620,13690,15753,10279
1471,484,598,1399,72,1399,72,7.49921e+18,73.9449,824.883,1471,258,54,873,873,850,850,768
25171,5771,6827,23761,1410,23761,1410,5.63144e+18,97.6308,8880.01,25171,3230,111,18344,18344,16383,16832,15661
49413,18662,19273,47103,2310,47103,2310,4.58184e+18,94.5975,22283.8,49413,9244,111,30140,30140,30140,30140,28719
3227,752,846,1152,2075,0,3227,9.82396e+12,58.3812,1239.23,3227,412,63,2381,2381,2258,2353,2229
5115,132,175,5110,5,5115,0,5.98054e+18,155.417,851.943,5115,102,104,4784,4476,3804,3884,3897
49509,6904,12702,17614,31895,0,49509,9.58292e+12,59.7036,15932.4,49509,6181,72,36807,36807,30949,35584,21132
2105,137,171,2105,0,2105,0,6.06256e+18,133.962,545.588,2105,70,69,1903,1795,1632,1665,1640
27507,81,175,27495,12,27507,0,5.97958e+18,167.299,1962.1,27507,165,162,22444,12730,11687,12756,12866
33416,1340,1370,0,33416,32440,976,4.16419e+16,268.659,4372.36,33416,223,26,32046,32046,31960,31955,31641
5653,2,10,5493,160,5653,0,1.38223e+14,9.90058,207.378,5653,10,10,3270,2312,2247,2411,1917
14254,2718,4778,9846,4408,13524,730,1.59037e+18,96.2193,6033.12,14254,2268,111,9476,9476,9476,9415,6211
37434,638,9754,35310,2124,35310,2124,2.00074e+18,97.9744,12569.4,37434,4624,111,27680,27620,11277,17510,3785
24290,5268,5714,0,24290,0,24290,6.46169e+17,97.5699,7827.02,24290,2750,110,18576,18576,18011,17537,17607
933,31,262,0,933,333,600,2.71715e+15,54.314,417.327,933,127,43,470,94,194,79,110
10202,2472,2484,9605,597,9605,597,3.82557e+18,97.2802,3563.72,10202,1153,111,7718,7718,7713,7713,7718
2254,55,575,0,2254,788,1466,2.50803e+15,57.5754,882.52,2254,273,57,1536,624,463,177,117
16051,2012,6480,16051,0,15241,810,4.01397e+18,139.482,7468.9,16051,2694,121,9571,9480,5966,7540,3566
47055,10077,20481,45019,2036,45019,2036,2.92253e+18,95.0065,23211.2,47055,9851,111,26574,26574,16627,19986,15809
21966,2,14,21326,640,21917,49,1.60817e+14,10.6944,480.649,21966,13,11,12997,9793,7491,7887,6020
10563,1033,2467,0,10563,3712,6851,2.54525e+15,59.6913,3438.44,10563,1196,72,8096,8096,5975,3356,3550
16498,1,6,16210,288,16466,32,9.9876e+13,3.99576,281.479,16498,5,4,6633,6633,6633,6633,6633
9026,1554,2277,8506,520,8506,520,5.79148e+18,96.893,3259.02,9026,1062,110,6749,6749,5427,5723,5044
10726,674,2571,0,10726,3774,6952,2.51345e+15,59.5895,3551.56,10726,1240,72,8155,8155,4493,3460,2359
4785,1002,1613,4785,0,4505,280,3.25862e+18,92.753,2095.9,4785,610,90,3172,3172,2576,2776,2266
17366,7643,13309,17366,0,16229,1137,1.07559e+18,1951.93,14582.4,17366,5405,13,4057,1136,2428,3103,3462
5104,689,1258,0,5104,0,5104,6.54221e+17,95.3511,1917.14,5104,591,87,3846,3846,3219,2570,2484
14089,1974,7141,0,14089,5629,8460,1.63569e+15,54.498,8011.07,14089,3456,72,6948,6948,4632,2881,2392
11982,4781,5264,0,11982,4633,7349,1.86282e+15,56.4636,6108.08,11982,2560,72,6718,6718,6603,6487,6615
858,68,100,0,858,835,23,4.92982e+16,15.4184,231.105,858,28,20,758,758,716,708,603
20140,6480,7129,20140,0,19040,1100,5.05789e+18,146.751,8324.35,20140,2859,122,13011,13011,12607,12837,12049
40491,1072,1507,0,40491,39314,1177,4.06602e+16,287.85,4964.06,40491,250,26,38984,38984,37951,37741,32612
1000,209,658,1000,0,884,116,6.30436e+17,6.164,765.536,1000,234,14,342,342,264,201,124
7444,367,2069,7032,412,7032,412,6.3771e+18,95.6286,2908.62,7444,986,98,5375,5289,5007,4558,1534
31388,22,176,31377,11,31388,0,5.98555e+18,169.548,2098.9,31388,167,164,13093,2394,3540,4084,3457
2768,717,744,2603,165,2603,165,3.65249e+18,93.5936,1154.97,2768,330,67,2024,2024,2007,2016,2020
19377,5886,7242,0,19377,7296,12081,2.07378e+15,57.6994,8568.97,19377,3528,72,12135,12135,10719,9853,9209
21008,2333,10484,20206,802,0,21008,1.46653e+18,90.3226,11859.9,21008,5068,110,10524,10524,6371,5930,3558
32380,1,15,31434,946,32325,55,1.63052e+14,10.4969,597.216,32380,13,11,6810,6810,6810,6810,6810
17430,1102,4083,6134,11296,0,17430,9.90677e+12,59.9068,5510.31,17430,1989,72,13347,13347,7310,11735,3896
38502,3125,8958,13536,24966,0,38502,9.89624e+12,60.0524,11652,38502,4362,72,29544,29544,19181,26919,10631
49272,6006,20094,47052,2220,0,49272,1.72406e+18,95.1343,23092.8,49272,9768,110,29178,29178,17882,16645,8943
24702,1567,5788,23262,1440,0,24702,2.23081e+18,97.6403,7930.32,24702,2796,110,18914,18914,13177,12451,6197
28649,407,15594,27651,998,0,28649,1.33216e+18,92.815,17209.3,28649,7575,110,13055,12023,6206,3164,1557
25838,5780,9940,24616,1222,24616,1222,6.14453e+18,95.9002,11780.4,25838,4756,111,15898,15898,14636,15353,10083
12788,498,947,0,12788,12402,386,4.97889e+16,179.454,2538.07,12788,136,26,11841,11536,10459,10738,8684
20388,1892,7842,0,20388,7699,12689,2.0367e+15,57.5195,9202.58,20388,3816,72,12546,12546,8805,5212,4472
13405,6,10,13023,382,13402,3,1.39047e+14,9.95308,320.275,13405,10,10,12771,12426,11224,11212,9208
38604,11715,17332,38604,0,36904,1700,4.49074e+18,661.323,19360.6,38604,4426,139,21272,20945,19405,20362,15921
27985,5186,8753,26525,1460,0,27985,2.00171e+18,96.414,10923.2,27985,4231,110,19232,19232,16684,15504,12624
13740,1,13,13346,394,13667,73,1.53664e+14,10.9023,371.473,13740,12,12,3135,3135,3135,3135,3135
27656,6094,13812,26599,1057,0,27656,1.4626e+18,92.4981,15500.5,27656,6693,110,13844,13844,10515,9515,6630
29477,5848,6931,27757,1720,27757,1720,5.88644e+18,97.6929,9379.91,29477,3359,110,22546,22546,22286,22288,19817
27914,14402,15548,26966,948,0,27914,1.29733e+18,92.5787,17094.6,27914,7556,110,12366,12366,11994,11712,11689
10695,1715,3627,0,10695,0,10695,5.62046e+17,95.1936,4654.18,10695,1739,110,7068,7068,5330,3963,3697
27342,8360,9946,26015,1327,26015,1327,7.61788e+18,95.6239,11953.5,27342,4816,110,17396,17396,17088,17036,16226
48472,14767,20245,0,48472,18621,29851,1.91968e+15,57.1376,22843.9,48472,9848,72,28227,28227,23825,23088,18570
20639,6388,10124,20639,0,0,20639,8.77053e+17,17.97,10537,20639,9102,20,10515,10515,6820,9428,6700
21399,3735,7352,21399,0,20179,1220,5.51103e+18,153.745,8475.05,21399,2735,125,14047,13924,11610,12863,8045
12252,3675,4873,0,12252,0,12252,5.14821e+17,90.442,5930.73,12252,2338,110,7379,7379,6682,6136,5852
32348,5389,7554,11375,20973,0,32348,9.88438e+12,60.0072,9891.1,32348,3671,72,24794,24794,22259,24262,18108
16276,4941,6014,0,16276,0,16276,5.35736e+17,95.1639,7364.27,16276,2899,110,10262,10262,9353,8736,8701
45848,4396,10675,0,45848,0,45848,6.48233e+17,97.8949,14156.9,45848,5174,110,35173,35173,25858,20518,15931
8953,389,3145,8503,450,8503,450,1.58154e+18,93.1852,4027.33,8953,1468,106,5808,5647,5454,5413,1291
20970,438,943,0,20970,20361,609,4.00217e+16,193.806,2780.96,20970,137,26,20027,19728,18486,17759,11728
30596,5909,12842,30596,0,29076,1520,4.57792e+18,211.265,14193.6,30596,3456,133,17754,17671,14306,14929,8673
28050,14690,14773,28050,0,26990,1060,4.80714e+18,559.208,16240.9,28050,4741,136,13277,13277,13277,13277,13277
28348,11,14,27527,821,28296,52,1.57528e+14,10.5573,547.043,28348,13,11,28334,28332,27784,27428,25333
28186,4080,12499,26988,1198,26988,1198,7.16418e+18,88.7675,14355.5,28186,6051,110,15687,15687,13333,14265,6304
38387,12093,12116,36392,1995,0,38387,1.99269e+18,96.4946,14877.6,38387,5872,110,26271,26271,26270,26268,26271
18973,3942,10256,18973,0,18263,710,5.42929e+18,269.645,11310.2,18973,2484,127,8717,8580,6340,6683,4130
9363,443,495,2796,6567,2796,6567,1.91884e+18,15.963,848.527,9363,397,18,8868,8868,8295,8466,8586
31181,12,14,30286,895,31099,82,1.47955e+14,10.4398,543.974,31181,13,12,31167,31163,30254,30254,28117
48568,4597,11644,45744,2824,45744,2824,3.70157e+18,98.3425,15177.8,48568,5505,111,36924,36924,25963,30091,16288
29424,5256,9585,27913,1511,0,29424,1.96654e+18,96.2671,11804.7,29424,4645,110,19839,19839,15719,14819,10989
42810,9855,13474,0,42810,15667,27143,2.25989e+15,58.7603,16153.1,42810,6559,72,29336,29336,26341,24596,22892
30474,100,176,30394,80,30474,0,6.02191e+18,172.469,2130.25,30474,167,162,27269,18089,16143,16938,17400
26638,3596,6244,9367,17271,0,26638,9.88294e+12,59.9942,8241.54,26638,3041,72,20394,20394,16588,19734,12057
8055,2670,3090,7674,381,7674,381,2.86002e+18,94.0339,3884.58,8055,1469,96,4965,4965,4855,4953,4958
28610,1177,9544,0,28610,0,28610,5.64148e+17,89.4511,11701.6,28610,4617,110,19066,19066,11118,2813,0
30461,2733,7130,0,30461,10708,19753,2.52656e+15,59.9999,9357.62,30461,3462,72,23331,23331,16940,8904,9200
5780,500,1928,2117,3663,0,5780,8.71743e+12,56.9137,2487.33,5780,921,72,3852,3852,2395,3602,794
44845,259,12733,0,44845,0,44845,6.05639e+17,97.0848,15969.1,44845,6177,110,32112,31599,18918,3949,2864
15960,4852,10344,14140,1820,14140,1820,6.09374e+17,6.52218,11900.9,15960,3462,14,5616,5616,5214,5594,2825
39172,12116,12559,39172,0,36887,2285,5.24271e+18,278.393,14270.2,39172,4614,133,26613,26613,26464,26613,26111
11351,2151,3479,0,11351,4132,7219,2.29834e+15,58.6611,4434.72,11351,1693,72,7872,7872,6032,4343,3950
30608,8,11,29734,874,30599,9,1.38963e+14,10.1311,490.358,30608,11,11,29889,29444,28109,28099,24347
46722,8170,12055,44090,2632,44090,2632,3.29497e+18,97.4981,15495,46722,5837,110,34667,34667,27629,30684,24380
25765,126,5994,0,25765,9055,16710,2.53841e+15,59.9876,7939.12,25765,2920,72,19771,19725,5041,728,723
26351,2078,13000,0,26351,0,26351,4.30866e+17,93.5115,14642,26351,6308,110,13351,13351,7871,3377,2215
8241,178,359,0,8241,8006,235,3.57009e+16,19.9695,1020.28,8241,57,26,7882,7882,7402,7402,4718
30112,2765,7085,28362,1750,0,30112,2.2262e+18,97.7217,9580.81,30112,3422,110,23027,23027,17173,15915,10026
23455,6227,8532,23455,0,22166,1289,5.33794e+18,159.721,9703.18,23455,2154,129,14923,14923,13967,14636,12144
47415,159,176,47360,55,47415,0,6.0267e+18,173.441,2658.73,47415,172,174,46806,45750,42871,43153,42960
6336,2180,6336,0,6336,6336,0,2047.68,0,6336,6336,6336,1,0,0,0,0,0
15154,1527,6861,5902,9252,0,15154,7.09848e+12,56.3429,7850.46,15154,3338,72,8293,8293,4885,7086,1404
32704,1844,9765,0,32704,0,32704,5.93367e+17,96.7098,12251,32704,4729,110,22939,22939,13093,8246,5926
6650,1640,1666,6263,387,0,6650,2.21549e+18,96.1489,2461.99,6650,792,96,4984,4984,4969,4974,4982
15770,2336,4179,14880,890,14880,890,2.36213e+18,97.415,5637.29,15770,1976,111,11591,11591,9676,11461,6713
41031,9587,11173,38761,2270,38761,2270,3.19366e+18,97.2443,14227,41031,5415,110,29858,29858,28844,29579,27397
20564,307,1292,0,20564,4192,16372,1.46796e+16,11.9895,1753.82,20564,848,14,19272,19272,12959,9340,16424
13673,1779,3229,0,13673,4811,8862,2.54392e+15,59.7801,4407.67,13673,1572,72,10444,10444,8409,8084,6090
2507,183,728,0,2507,0,2507,6.36359e+17,92.0614,1105.27,2507,336,61,1779,1703,1138,369,733
37192,793,10294,35145,2047,0,37192,2.10467e+18,97.1478,13105.9,37192,4995,110,26898,26754,16659,14632,4210
35935,16850,17627,35935,0,34465,1470,4.78806e+18,797.617,19433.9,35935,6629,136,18308,18057,18218,18308,17046
43021,7608,10056,0,43021,15122,27899,2.52673e+15,60.0476,13004.8,43021,4893,72,32965,32965,30056,26210,25292
30973,598,961,0,30973,30091,882,3.55554e+16,190.769,3117.47,30973,141,26,30012,29692,28406,28615,22429
23045,4448,6457,21775,1270,21775,1270,6.30205e+18,97.3947,8361.86,23045,3059,111,16588,16588,14483,15510,11199
30158,6108,9581,30158,0,28435,1723,4.72345e+18,212.586,11208.3,30158,1929,129,20577,20536,18401,19901,14105
6258,1180,1535,5896,362,5896,362,5.85203e+18,95.7042,2300.31,6258,714,93,4723,4723,4640,4640,3995
3854,1239,1905,3854,0,3854,0,2.14959e+18,18.7935,2077.96,3854,1028,23,1949,1949,1575,1666,1320
41923,5145,14793,41923,0,39613,2310,4.85728e+18,343.144,16577.2,41923,3086,138,27130,26921,14670,19921,7337
36872,10063,20551,0,36872,0,36872,3.49233e+15,17.9832,21062.4,36872,18480,20,16321,16321,8528,14728,8436
8622,244,3113,5895,2727,8192,430,4.18839e+18,94.7018,3960.06,8622,1457,104,5509,5335,2656,3072,1033
46060,169,176,45977,83,46060,0,5.98081e+18,171.962,2542.99,46060,172,172,45835,45192,44021,44018,44225
41112,573,38420,0,41112,12804,28308,2.35963e+15,3.99426,38519.8,41112,12829,9,2692,2692,36,37,43
3024,695,1022,3024,0,2844,180,6.17742e+18,90.9818,1383.71,3024,369,70,2002,2002,1770,1901,1610
11966,3238,5045,11955,11,11358,608,4.45065e+18,119.796,5783.18,11966,2029,121,6921,6872,5590,6226,5125
34943,14427,18065,34943,0,0,34943,8.83514e+17,17.9781,18592.5,34943,16243,20,16878,16878,13582,14458,13329
29768,3012,10981,28338,1430,28338,1430,2.97556e+18,95.5915,13111.7,29768,5328,110,18787,18787,9605,13232,6103
669,29,45,0,669,647,22,3.60827e+16,17.6158,129.566,669,20,21,624,624,556,556,535
12183,4959,6226,11723,460,11723,460,5.56714e+18,89.0561,7123.91,12183,2972,111,5957,5957,5654,5957,5240
42797,115,176,42739,58,41982,815,6.02766e+18,173.153,2521.93,42797,173,172,39807,35900,26719,27544,27781
33981,15182,16976,33981,0,33981,0,1.30166e+18,17.9802,17506,33981,15268,20,17005,17005,15237,17005,15198
11937,5,13,11597,340,11870,67,1.39146e+14,10.9689,334.659,11937,12,12,11015,9900,7920,8114,6424
21682,1133,6047,0,21682,7794,13888,2.3864e+15,59.2451,7664.45,21682,2945,72,15635,15635,7019,4137,2611
38313,10417,10570,0,38313,13764,24549,2.39082e+15,59.3818,13130.1,38313,5143,72,27743,27743,27571,27551,27436
11973,2903,4919,11423,550,11423,550,5.93362e+18,95.0132,5928.67,11973,2355,111,7054,7054,6265,7004,5503
28174,45,176,28096,78,28174,0,6.01355e+18,171.267,2034.15,28174,158,164,17383,7616,6099,7439,7053
30662,2,12,29791,871,30647,15,1.38929e+14,10.2461,494.88,30662,12,11,17763,12589,12062,12745,8088
2629,899,1569,2629,0,2529,100,5.41406e+18,84.2438,1800.06,2629,662,57,1060,971,760,917,733
17584,2763,4228,0,17584,0,17584,6.4568e+17,97.0538,5870.95,17584,2034,110,13356,13356,11770,9580,9407
11120,676,2762,10477,643,10477,643,1.30634e+18,97.2505,3906.89,11120,1290,111,8358,8358,7695,7752,2713
8993,19,208,8925,68,8993,0,6.11133e+18,184.105,1261.27,8993,116,120,3523,730,951,906,865
40640,2480,9475,38270,2370,0,40640,2.23154e+18,97.8846,12634.9,40640,4597,110,31165,31165,17579,16014,9870
40827,130,176,40808,19,40827,0,6.00004e+18,172.579,2434.46,40827,172,170,39021,36488,29946,30296,30083
637,35,214,226,411,0,637,9.11719e+12,49.7943,325.52,637,99,37,324,67,193,255,71
15736,2516,4352,14866,870,0,15736,2.11643e+18,96.6335,5808.94,15736,2092,110,11384,11384,9621,8904,6913
15937,661,6506,15217,720,0,15937,1.73302e+18,93.307,7776.41,15937,3137,110,9431,9091,4603,3478,1756
15336,1939,8238,0,15336,3319,12017,1.35735e+13,8.96811,8478.99,15336,7407,11,7098,7098,3017,7098,2718
30693,205,1061,0,30693,29811,882,3.74316e+16,217.226,3396.49,30693,160,26,29447,29193,21229,21036,9907
23745,97,176,23668,77,23745,0,5.99813e+18,169.634,1850.71,23745,156,161,21016,13349,12173,12941,13278
15832,7,13,15381,451,15761,71,1.38924e+14,10.9587,386.487,15832,12,12,15264,14960,11593,11708,10471
17079,8,14,16584,495,17029,50,1.60671e+14,10.7809,415.618,17079,14,12,16725,16354,15796,14503,12151
37299,10724,11481,37299,0,35139,2160,5.2231e+18,265.072,13394.7,37299,4176,133,25818,25818,25818,25818,25108
18643,11522,11641,18103,540,0,18643,1.10729e+18,88.1188,12659.5,18643,5645,110,7002,7002,6973,6938,6994
18710,2707,5447,17700,1010,17700,1010,3.26848e+18,95.8959,7084.32,18710,2638,110,13263,13263,9068,10838,7518
4906,2944,2958,4906,0,4728,178,4.466e+18,90.4892,3297.82,4906,1290,75,1948,1948,1948,1948,1948
38621,700,1102,0,38621,37518,1103,3.55316e+16,229.232,3735.13,38621,169,26,37519,37519,33195,33902,28081
36084,6502,15636,34514,1570,34514,1570,8.05548e+18,95.3475,17867.6,36084,7525,111,20448,20448,10288,13900,9809
12415,84,175,12407,8,12415,0,5.98103e+18,163.628,1320.43,12415,134,139,10295,5887,5549,5978,6078
2683,406,732,2527,156,2527,156,4.10961e+18,93.1312,1135.37,2683,326,68,1951,1951,1638,1915,1336
29065,1767,6809,10218,18847,0,29065,9.87591e+12,59.9871,8950.79,29065,3311,72,22256,22256,11980,19535,5927
40862,4474,13867,38794,2068,38794,2068,1.9226e+18,96.7912,16629.4,40862,6634,111,26995,26995,20549,18266,9370
24490,982,1159,0,24490,23774,716,4.27932e+16,228.65,3503.84,24490,181,26,23331,23331,22971,22959,20883
9596,1979,4156,9596,0,9117,479,3.68216e+18,112.107,4792.53,9596,1670,112,5440,5414,3733,4373,3200
728,127,514,728,0,701,27,5.58064e+18,63.4959,586.658,728,206,37,214,66,64,152,161
35924,790,10334,0,35924,12965,22959,2.34812e+15,58.0815,12733.5,35924,5012,72,25590,25494,15283,9196,2709
39549,1028,1286,0,39549,38413,1136,3.79264e+16,260.205,4295.93,39549,203,26,38263,38263,36998,37321,33733
15796,1123,7062,0,15796,6139,9657,1.83508e+15,56.4873,8091.29,15796,3438,72,8734,8734,5120,632,919
41053,856,9581,0,41053,0,41053,6.4825e+17,97.8505,12764.7,41053,4640,110,31472,31472,19605,7734,4734
7677,2005,2466,2813,4864,0,7677,8.84941e+12,58.1536,3165.83,7677,1196,72,5211,5211,4539,5091,3911
39794,533,9854,37516,2278,37516,2278,6.0892e+18,97.6568,12914.2,39794,4782,110,29940,29940,26709,23500,3614
22984,5376,9587,0,22984,0,22984,4.93994e+17,94.6629,11235.7,22984,4645,110,13397,13397,10655,9224,7801
29057,497,6813,0,29057,10216,18841,2.52892e+15,59.9618,8951.37,29057,3310,72,22244,22244,13009,1581,1729
33628,3132,8100,31676,1952,31676,1952,5.63303e+18,98.1908,10746.5,33628,3823,111,25528,25528,16063,18515,11040
1875,312,530,1766,109,1766,109,5.82769e+18,90.3568,838.147,1875,234,56,1345,1345,1291,1294,991
2663,232,712,2503,160,2503,160,2.72008e+18,93.4818,1113.28,2663,317,64,1951,1951,1075,1349,903
16627,10,12,16155,472,16617,10,1.38765e+14,10.5562,364.787,16627,12,11,16533,16380,14910,14946,14909
19386,3722,8309,18538,848,0,19386,1.67226e+18,94.4319,9737.17,19386,4023,110,11077,11077,8068,7686,5288
6222,1774,2603,0,6222,0,6222,5.0686e+17,93.135,3232,6222,1245,94,3619,3619,3493,3415,3591
4802,114,176,4802,0,4802,0,6.05416e+18,152.551,839.596,4802,97,101,4351,3871,3011,3085,3168
28283,7743,12162,27053,1230,0,28283,1.66401e+18,93.4667,14058.5,28283,5901,110,16121,16121,14101,13038,10954
27854,9573,10746,26554,1300,0,27854,1.7901e+18,92.4399,12730.8,27854,5194,110,17108,17108,16783,16766,16630
18684,3965,4414,17594,1090,0,18684,2.23051e+18,97.4211,6140.77,18684,2130,110,14270,14270,13779,13626,13254
2386,640,657,846,1540,0,2386,9.96262e+12,57.3931,966.38,2386,320,57,1729,1729,1710,1719,1711
29912,1677,7905,0,29912,10675,19237,2.42758e+15,59.5244,10030.6,29912,3844,72,22007,22007,14157,4189,4695
6013,1356,1989,5703,310,0,6013,1.98166e+18,90.9017,2672.69,6013,928,90,4024,4024,3518,3434,3183
31249,474,1435,0,31249,30330,919,4.39992e+16,280.672,4503.71,31249,236,26,29814,28925,26715,24838,13481
16135,3588,3848,15200,935,0,16135,2.22621e+18,97.2262,5390.18,16135,1849,110,12287,12287,12019,11957,11834
44959,5225,19140,17332,27627,0,44959,7.41712e+12,57.0083,21552.6,44959,9320,72,25819,25819,17061,24319,6604
6182,1055,2054,6182,0,5822,360,3.15776e+18,93.2197,2622.9,6182,775,101,4128,4128,3090,3480,2597
37715,9236,11150,13682,24033,0,37715,9.09682e+12,55.1501,13621.1,37715,5425,72,26565,26565,24316,26094,20679
32443,518,7549,11401,21042,0,32443,9.89458e+12,59.9815,9896.3,32443,3661,72,24894,24894,7823,20172,2126
28508,559,1329,5911,22597,0,28508,5.83239e+13,11.993,1879.63,28508,1190,14,27179,27179,21221,17082,24510
31973,3258,11313,0,31973,0,31973,5.4659e+17,93.7171,13607.4,31973,5470,110,20660,20660,12825,8658,6750
7861,140,175,7855,6,7861,0,5.98717e+18,159.135,1051.88,7861,118,121,7503,7040,6371,6387,6365
45377,5670,10556,42729,2648,0,45377,2.23171e+18,97.9269,14005,45377,5124,110,34821,34821,28167,26847,19991
15034,3640,3677,14162,872,14162,872,3.14164e+18,97.6386,5110.4,15034,1719,111,11357,11357,11357,11357,11351
41853,1097,1552,0,41853,40636,1217,4.07815e+16,298.197,5134.74,41853,259,26,40301,40301,39313,39089,33531
10589,3077,3822,8275,2314,10061,528,3.70428e+18,95.6561,4802.23,10589,1820,111,6767,6767,5395,5732,5002
49479,15830,21945,19234,30245,0,49479,7.17445e+12,56.7279,24488.8,49479,10680,72,27534,27534,23454,26834,18621
27303,945,13001,0,27303,0,27303,4.44385e+17,93.8602,14735.2,27303,6310,110,14302,13720,8151,2204,1632
10163,1727,2476,9573,590,0,10163,2.2209e+18,96.7081,3565.6,10163,1180,110,7687,7687,6696,6523,5794
31595,187,18677,13106,18489,0,31595,5.26849e+12,54.3179,20071.6,31595,9086,72,12918,12006,7354,11974,818
1793,608,1107,1733,60,1733,60,9.42131e+18,47.8516,1296.52,1793,517,48,686,686,686,686,686
15605,205,655,0,15605,15159,446,3.55601e+16,20.1091,1813.21,15605,84,26,14950,14950,11913,11976,6352
38064,7668,9162,0,38064,0,38064,6.42859e+17,97.7429,12139.2,38064,4440,110,28902,28902,27286,24936,24856
26379,1660,6618,9353,17026,0,26379,9.69014e+12,59.7194,8561.4,26379,3224,72,19761,19761,10906,17302,4904
42835,1288,15480,42835,0,40502,2333,4.27087e+18,291.893,17272.9,42835,6114,130,27355,26761,13177,18903,3491
14290,3806,6977,0,14290,0,14290,4.36221e+17,88.4615,8031.13,14290,3368,110,7313,7313,6427,5975,5300
11871,424,5384,0,11871,0,11871,4.68825e+17,93.0497,6346.76,11871,2587,110,6487,6143,3809,1125,1257
28030,8996,28030,28030,0,28030,0,8.79578e+12,0,28030,28030,28030,1,0,0,0,0,0
10029,4,11,9744,285,10023,6,1.39292e+14,10.4573,281.683,10029,11,11,8693,7707,7762,7845,4611
10312,269,434,0,10312,10016,296,3.5365e+16,20.0241,1225.08,10312,64,26,9878,9878,8962,9044,6827
49423,67,176,49335,88,49423,0,6.05558e+18,173.765,2734.58,49423,175,173,37459,23358,17273,19221,18530
43351,598,1534,0,43351,42586,765,2.56409e+16,3.73518,5857.89,43351,769,4,41817,41817,39925,39568,26485
42806,23,176,42739,67,42806,0,6.11048e+18,172.982,2561.73,42806,169,170,19078,4519,5748,5739,5490
1864,533,542,673,1191,0,1864,9.56757e+12,56.7859,800.678,1864,260,55,1322,1322,1309,1315,1318
3150,122,144,0,3150,3060,90,3.53654e+16,19.4381,428.523,3150,38,26,3006,3006,2961,2961,2770
29783,3045,6977,0,29783,10466,19317,2.5257e+15,59.9869,9161.7,29783,3393,72,22806,22806,17083,12903,10189
26583,4020,8211,26583,0,25033,1550,4.46086e+18,171.34,9700.49,26583,1957,128,18372,18372,13622,15403,9293
9591,804,5509,9591,0,0,9591,8.97935e+17,17.4691,5752.92,9591,4941,20,4082,4082,673,1158,668
46982,1505,17187,17619,29363,0,46982,8.17033e+12,57.9724,19904.1,46982,8362,72,29795,29747,18735,27885,5210
35171,9954,22790,7600,27571,0,35171,2.23798e+13,5.52725,26145.7,35171,7603,13,12381,12381,10305,11142,6309
21593,3489,9096,8304,13289,0,21593,7.47268e+12,55.5319,10456.5,21593,4420,72,12497,12497,9587,11569,5759
20171,111,176,20156,15,20171,0,6.09663e+18,169.157,1758.59,20171,143,149,18686,16079,12180,12560,12711
37061,782,18165,37061,0,37061,0,3.48463e+17,17.9835,18724.6,37061,16337,20,18896,18896,1651,797,862
37781,72,176,37690,91,37781,0,6.0593e+18,171.64,2400.38,37781,170,168,29697,19562,14328,15692,15380
34761,9828,14555,0,34761,13348,21413,1.91904e+15,57.0335,16537.7,34761,7071,72,20206,20206,17911,14734,14204
7160,133,170,7158,2,7160,0,5.96508e+18,159.244,996.888,7160,117,113,6770,6375,5440,5571,5519
45121,5175,12178,42601,2520,42601,2520,5.48003e+18,97.8845,15410,45121,5792,111,32943,32943,27446,30324,15788
14990,9840,12535,14990,0,14006,984,9.25432e+17,1046.7,13203.9,14990,4679,10,2455,2359,1638,2455,2174
15306,2,176,15297,9,15306,0,6.01853e+18,169.79,1503.7,15306,145,144,778,21,39,26,109
40212,519,1623,0,40212,39034,1178,4.2392e+16,303.057,5294.75,40212,274,26,38589,37474,34911,32564,17985
40493,8647,9464,38138,2355,38138,2355,3.21985e+18,97.8227,12612,40493,4579,110,31029,31029,30222,30784,28915
48752,5272,13987,46112,2640,46112,2640,3.25751e+18,97.0562,17434.2,48752,6782,110,34765,34765,20353,26618,13459
37696,9317,15243,35986,1710,0,37696,1.73595e+18,93.8531,17688.6,37696,7401,110,22453,22453,19637,18189,15096
22576,9672,12069,22576,0,21716,860,4.44095e+18,179.889,13234.6,22576,3571,134,10507,10501,9878,10268,9262
25408,2,13,24667,741,25395,13,1.6316e+14,10.1809,472.027,25408,12,12,14842,11200,9015,11264,7825
8218,1819,2759,8218,0,7735,483,3.5423e+18,92.0552,3387.21,8218,865,114,5459,5459,5368,5399,4032
47139,1,17,45761,1378,47073,66,1.67366e+14,10.2094,735.321,47139,13,12,9535,9535,9535,9535,9535
25187,5380,6100,23719,1468,23719,1468,2.30427e+18,98.1311,8215.39,25187,2885,111,19087,19087,18354,19033,17367
39957,2097,9393,37634,2323,0,39957,2.22547e+18,97.8197,12503,39957,4554,110,30564,30564,20647,18765,8312
5143,51,1783,4883,260,0,5143,1.94319e+18,93.81,2384.11,5143,838,91,2013,468,1413,1524,117
38600,6471,12351,0,38600,0,38600,5.76495e+17,96.4989,15109.3,38600,5998,110,26249,26249,21008,16972,12218
6201,19,176,6195,6,6201,0,6.07092e+18,158.325,974.217,6201,101,102,2431,513,711,637,714
23508,2967,5553,0,23508,8271,15237,2.51557e+15,59.8743,7357.91,23508,2690,72,17955,17955,14903,12788,9862
22240,3439,5184,7812,14428,0,22240,9.92785e+12,59.9536,6913.02,22240,2525,72,17056,17056,14588,16626,11727
46465,14287,20605,44485,1980,44485,1980,4.25012e+18,93.7943,23281.1,46465,9922,111,25860,25860,20754,21661,19375
962,233,335,910,52,910,52,5.87294e+18,82.0343,511.479,962,129,43,627,627,495,543,549
7443,2,6,7215,228,7443,0,1.8455e+13,5.96614,188.704,7443,6,6,6588,6344,6222,6100,6344
8940,4299,4832,8620,320,0,8940,1.36518e+18,90.7025,5522.92,8940,2320,97,4108,4108,3763,3563,3488
36895,1624,8607,12966,23929,0,36895,9.87468e+12,60.017,11207.1,36895,4180,72,28288,28288,18172,26546,5803
17697,41,175,17685,12,17697,0,5.97588e+18,165.71,1575.44,17697,153,151,10255,3760,3499,4449,4130
5303,765,1305,4993,310,0,5303,2.23757e+18,95.5444,1983.41,5303,611,88,3998,3998,3389,3165,2726
15530,2277,4083,0,15530,0,15530,6.307e+17,96.8989,5542.3,15530,1970,110,11447,11447,8975,6006,6156
26730,6008,6266,25174,1556,25174,1556,5.74005e+18,97.6433,8540.16,26730,3027,110,20464,20464,20319,20302,20038
43317,1,15,42065,1252,43257,60,1.5284e+14,10.5313,683.198,43317,13,11,9954,9954,9954,9954,9954
8273,2650,3086,3098,5175,0,8273,8.21159e+12,57.4176,3781.48,8273,1503,72,5187,5187,4600,5087,4126
22916,700,5373,21578,1338,0,22916,2.23056e+18,97.6425,7394.16,22916,2597,110,17543,17543,11184,10066,3386
17750,1125,4252,0,17750,0,17750,6.45909e+17,97.3981,5910.19,17750,2052,110,13498,13498,9281,5206,4253
25582,5,13,24854,728,25509,73,1.39032e+14,10.7999,492.614,25582,13,12,23628,21270,19811,18518,13221
21362,2235,11142,20575,787,20575,787,7.43301e+18,93.6899,12467.7,21362,5367,111,10220,10133,4147,10220,5041
27891,4578,6578,26263,1628,26263,1628,5.88697e+18,97.7057,8921.77,27891,3186,110,21313,21313,20805,20805,15420
11918,542,817,0,11918,11565,353,4.53882e+16,125.125,2128.39,11918,112,26,11101,10955,10248,10499,8404
33239,16007,17246,32019,1220,32019,1220,2.41281e+18,92.5437,19129.9,33239,8375,110,15993,15993,15599,15921,15590
14899,3863,4345,14089,810,14089,810,6.37734e+18,95.9223,5705.11,14899,2049,111,10554,10554,10514,10420,9951
45892,12,14,44585,1307,45808,84,1.3872e+14,10.5586,664.113,45892,14,12,45877,45872,45369,45368,44540
16933,128,176,16923,10,16933,0,6.07808e+18,169.039,1608.84,16933,139,144,16105,14980,12365,12374,12171
11163,495,4751,10673,490,10673,490,8.60794e+18,93.6482,5707.59,11163,2282,106,6412,6154,2606,5439,1992
19858,3581,7996,18951,907,0,19858,1.74642e+18,94.8536,9498.07,19858,3875,110,11862,11862,8619,7896,5096
35906,12,176,35829,77,35906,0,5.98448e+18,169.747,2244.38,35906,166,170,10148,1557,1989,2111,2278
23468,88,176,23390,78,23468,0,6.04736e+18,171.493,1879.18,23468,157,155,20110,13113,11120,11513,11910
38966,5323,17345,0,38966,0,38966,4.70391e+17,94.0897,19719.6,38966,8425,110,21621,21621,14714,11177,7550
43551,8394,18183,43551,0,41531,2020,4.60587e+18,969.158,20506.9,43551,4630,140,25368,24436,19203,21101,12940
25086,3845,8872,25086,0,23723,1363,3.94506e+18,184.732,10268.7,25086,3607,123,16214,16190,11289,13395,7412
43426,4737,10124,40896,2530,40896,2530,5.87024e+18,97.8786,13454.4,43426,4909,110,33302,33302,31942,31942,16877
48924,9672,13702,0,48924,0,48924,6.08988e+17,96.0637,17185.2,48924,6651,110,35222,35222,31537,26432,25475
24558,776,842,0,24558,23857,701,3.55036e+16,138.472,2583.27,24558,117,26,23716,23716,23529,23520,22542
29175,12,14,28331,844,29108,67,1.54008e+14,10.5172,551.358,29175,13,11,29161,29160,28842,28842,27406
39169,558,1111,0,39169,38052,1117,3.55367e+16,230.948,3776.84,39169,171,26,38058,37558,34837,35139,23953
37146,12,14,36087,1059,37070,76,1.39139e+14,10.5817,590.945,37146,13,12,37131,37126,36045,36045,34031
25461,2527,12966,25461,0,25461,0,2.85381e+18,17.9728,13417.8,25461,11656,20,12495,12495,2866,2457,2516
26051,577,1247,0,26051,25288,763,4.37363e+16,256.163,3814.52,26051,198,26,24804,24138,20921,21505,14510
2263,765,1005,2163,100,0,2263,1.72535e+18,77.4954,1302.17,2263,460,61,1258,1258,1258,1234,1258
39673,169,176,39587,86,39673,0,5.9874e+18,172.247,2361.17,39673,168,171,39455,38907,37805,37966,38186
19632,1,11,19072,560,19624,8,1.38773e+14,9.96923,389.091,19632,11,11,5034,5034,5034,5034,5034
48408,10992,11326,0,48408,0,48408,6.47293e+17,97.893,14954.7,48408,5494,110,37082,37082,36659,36815,36423
18207,3752,7990,17417,790,17417,790,4.10438e+18,94.9295,9315.03,18207,3836,111,10217,10217,6431,7183,5610
11161,2121,2817,0,11161,3960,7201,2.48033e+15,59.4353,3811.85,11161,1367,72,8344,8344,7440,6857,6526
23172,177,6539,0,23172,0,23172,6.08079e+17,96.7768,8478.82,23172,3154,110,16633,16305,5206,1046,1605
17497,2845,5603,16590,907,16590,907,3.17085e+18,96.0458,7108.09,17497,2704,110,11894,11894,7775,9524,6246
14482,483,616,0,14482,14069,413,3.5586e+16,20.1168,1701.16,14482,80,26,13866,13866,13357,13408,11792
10633,1515,3456,10083,550,0,10633,1.98127e+18,94.8457,4495.93,10633,1656,110,7177,7177,5000,4496,2718
19279,213,1176,0,19279,18703,576,4.81929e+16,248.677,3402.88,19279,181,26,17901,17525,12380,12860,5709
31673,1627,9601,29980,1693,29980,1693,3.73101e+18,97.2433,11964.1,31673,4565,111,22072,22072,11143,14397,6209
40538,11164,11326,0,40538,14578,25960,2.37848e+15,59.3292,13995.5,40538,5511,72,29212,29212,29004,28911,28884
2317,353,689,2183,134,0,2317,2.17142e+18,91.6245,1042.29,2317,315,61,1628,1628,1348,1230,1180
7894,143,170,7827,67,7894,0,5.97536e+18,160.436,1047.04,7894,121,121,7568,7096,6592,6547,6576
22337,9,12,21686,651,22318,19,1.58688e+14,10.3245,440.371,22337,12,11,22083,21792,21245,21031,19317
7845,1,9,7203,642,7844,1,1.15066e+14,7.84997,220.169,7845,9,8,2074,2074,2074,2074,2074
5805,496,2032,5805,0,5468,337,3.7979e+18,90.3185,2538.41,5805,709,99,3773,3773,2071,2879,1291
1545,63,151,0,1545,1499,46,4.67791e+16,18.5715,364.464,1545,38,25,1394,1386,1237,1237,819
7577,9,11,7360,217,7571,6,1.42056e+14,10.2838,245.362,7577,11,11,7472,7358,6651,6670,6761
45772,13409,24896,44182,1590,0,45772,1.33053e+18,92.9664,27205.3,45772,12104,110,20876,20876,15790,14696,10607
30989,126,176,30906,83,30989,0,6.03423e+18,172.722,2159.05,30989,162,166,29377,26884,22141,22157,22141
36773,11,15,35681,1092,36676,97,1.82266e+14,10.3336,664.868,36773,13,12,36757,36752,34089,34152,32830
1811,692,1271,1761,50,0,1811,1.02071e+18,36.2744,1427,1811,584,49,540,540,540,540,540
28965,2567,12645,27725,1240,27725,1240,2.68997e+18,94.4692,14559.6,28965,6127,110,16320,16320,11985,12517,5997
35266,4,208,35196,70,35266,0,6.15979e+18,202.021,2507.17,35266,173,168,4218,815,544,363,444
6462,48,208,6423,39,6462,0,6.15828e+18,169.845,1067.57,6462,110,103,4246,1673,1571,1524,1416
5568,150,2210,0,5568,0,5568,5.28062e+17,93.2024,2805.13,5568,1058,83,3358,3186,1442,589,755
20097,4,7,18420,1677,20097,0,1.17271e+14,6.99637,332.338,20097,7,7,16743,15069,10882,14230,10046
25420,4684,5956,23937,1483,0,25420,2.23395e+18,97.6507,8141.79,25420,2879,110,19464,19464,18010,17489,15892
30000,12554,16644,0,30000,0,30000,3.49136e+15,17.9707,17105.7,30000,14964,20,13356,13356,10111,10021,9963
47011,398,18285,47011,0,44581,2430,4.43533e+18,385.841,20202.8,47011,5211,140,28548,27454,8904,18214,1690
5678,1112,2210,0,5678,0,5678,5.35806e+17,93.3829,2819.95,5678,1052,84,3468,3426,2801,2247,2024
48997,2044,15278,46437,2560,46437,2560,6.87455e+18,96.6578,18645,48997,7419,110,33719,33719,27221,22285,4784
3441,437,907,2857,584,3239,202,2.00701e+18,94.3482,1390.62,3441,404,74,2534,2534,1898,2146,1525
15927,3430,9795,15927,0,15417,510,3.75573e+18,143.213,10584.4,15927,4529,122,6132,6059,2720,3974,240
5747,481,2090,0,5747,2145,3602,2.11852e+15,57.2922,2631.37,5747,1009,72,3657,3609,2566,1915,1415
29005,3574,8192,29005,0,29005,0,4.15921e+15,5878.3,15375.7,29005,8192,4,10719,0,7146,7363,10719
24980,36,176,24974,6,24980,0,5.98448e+18,169.457,1874.11,24980,159,162,13632,4224,4489,5498,5032
27724,78,176,27705,19,27724,0,6.08503e+18,171.416,2060.16,27724,160,159,22792,15555,11784,12481,12514
17454,782,825,0,17454,16950,504,3.91293e+16,124.442,2321.71,17454,112,26,16629,16629,16533,16522,16147
42382,11890,18538,0,42382,16429,25953,1.85695e+15,55.5115,20805.8,42382,9008,72,23844,23844,20733,18479,15632
24719,8573,11314,9668,15051,0,24719,7.00859e+12,55.8395,12750.1,24719,5505,72,13405,13405,12398,13195,10873
40214,1809,18192,0,40214,0,40214,4.63183e+17,94.3448,20600.2,40214,8833,110,22022,22022,13145,5421,3391
29637,931,11159,11157,18480,0,29637,8.04249e+12,56.7929,13005.9,29637,5415,72,18478,18478,11532,17288,3246
12430,387,8554,12129,301,12129,301,9.59206e+18,40.0054,9213.52,12430,4120,97,3876,3876,0,3765,0
18729,3799,4535,17639,1090,17639,1090,3.59551e+18,97.9041,6231.09,18729,2137,111,14194,14194,12838,13140,12434
46012,3356,10711,0,46012,0,46012,6.48338e+17,97.9078,14203.2,46012,5189,110,35301,35301,25246,12897,12704
45798,3789,21536,18013,27785,0,45798,6.82397e+12,55.9665,23834.7,45798,10469,72,24262,24262,15992,22846,6077
22353,1270,5252,21048,1305,21048,1305,5.73478e+18,97.5958,7232.38,22353,2537,110,17101,17101,14704,13052,5163
16525,5246,5488,16525,0,15560,965,3.33323e+18,131.992,6448.56,16525,1988,120,11037,11037,10929,10977,10836
10561,552,2570,9949,612,0,10561,2.22194e+18,96.7466,3690.18,10561,1229,110,7991,7991,5304,4771,2292
25649,7708,8979,0,25649,0,25649,5.51153e+17,95.8406,10925.2,25649,4353,110,16670,16670,15424,13856,13671
10486,512,3260,9936,550,9936,550,6.9098e+18,95.594,4302.86,10486,1555,110,7226,7140,6681,6125,1854
17385,447,756,0,17385,16889,496,3.70298e+16,80.859,2124.86,17385,99,26,16629,16555,15642,15722,10624
33752,7403,11925,32092,1660,0,33752,1.88416e+18,95.8782,14316.2,33752,5786,110,21827,21827,18486,17766,15015
44083,14057,15980,41945,2138,0,44083,1.85556e+18,95.8597,18892.5,44083,7765,110,28103,28103,26653,25950,24541
42388,8109,12275,15329,27059,0,42388,9.1758e+12,59.1738,15009.7,42388,5980,72,30113,30113,26286,29313,19968
42096,111,176,42020,76,42096,0,6.15943e+18,173.516,2533.67,42096,167,165,39242,34448,25706,26084,26297
22375,3520,6534,21168,1207,21168,1207,6.55462e+18,96.6565,8403.21,22375,3155,110,15841,15841,14490,14283,9334
9863,896,3861,9863,0,9338,525,3.50412e+18,97.7666,4527.09,9863,1482,117,6002,5996,3509,4409,2145
25623,4910,13033,25623,0,16646,8977,5.15885e+18,326.78,14265.4,25623,4554,134,12590,12345,8814,10817,5591
28152,1959,6578,0,28152,0,28152,6.4976e+17,97.7011,8945.17,28152,3185,110,21574,21574,12983,8415,7622
28870,18,208,28792,78,28870,0,6.00412e+18,197.512,2184.85,28870,169,169,10734,1891,2810,2731,2456
32111,3772,7672,30239,1872,30239,1872,2.08494e+18,98.2186,10229.2,32111,3618,111,24439,24439,20661,22177,13181
42639,716,13656,42639,0,40159,2480,4.09541e+18,301.975,15474.2,42639,3905,133,28983,28458,13351,19339,2244
20295,9606,10882,19568,727,19568,727,9.25411e+18,93.4646,12130.8,20295,5247,111,9413,9413,6960,7677,6009
16192,629,7451,15522,670,15522,670,9.16389e+18,93.8236,8650.23,16192,3612,110,8741,8225,1155,7029,1287
47447,6758,11009,0,47447,16670,30777,2.53236e+15,60.0737,14213,47447,5350,72,36438,36438,30271,26300,22806
22162,1144,5400,20874,1288,20874,1288,4.17132e+18,98.0024,7317.8,22162,2549,111,16762,16762,9574,11700,4434
46583,1364,2044,0,46583,45215,1368,4.51267e+16,321.407,6698.08,46583,356,26,44539,44539,43297,43273,34655
28597,69,176,28506,91,28597,0,6.10605e+18,172.063,2094.21,28597,154,161,22796,15924,10788,11503,10896
13043,112,175,13041,2,13043,0,5.97958e+18,164.18,1353.92,13043,140,139,11968,10353,8065,8295,8415
38369,3486,9568,0,38369,0,38369,6.35333e+17,97.5935,12537.3,38369,4636,110,28801,28801,20761,18771,12640
14182,3782,4498,13765,417,13352,830,5.31046e+18,119.249,5470.91,14182,1707,120,9684,9684,9185,9454,8524
653,2,6,631,22,653,0,2.73716e+14,5.86371,57.3404,653,6,6,383,366,167,22,94
17152,844,5835,17152,0,16192,960,5.66843e+18,139.163,6920.81,17152,2279,124,11317,11245,6398,8611,2309
33007,716,1241,0,33007,32053,954,3.96822e+16,248.406,3991.37,33007,197,26,31766,31766,30038,29758,22500
18365,176,879,0,18365,17833,532,4.02094e+16,158.905,2515.21,18365,124,26,17415,17264,15017,13767,6018
44870,109,208,44804,66,44870,0,6.0298e+18,204.126,2733.84,44870,187,180,40612,32433,22455,23963,23568
694,257,326,694,0,654,40,3.12109e+18,71.0043,436.934,694,100,37,368,368,338,351,363
28930,2502,13008,0,28930,11274,17656,1.81861e+15,56.5715,14649.5,28930,6329,72,15922,15922,10693,10424,4579
36844,8388,8614,0,36844,0,36844,6.49531e+17,97.8208,11533.6,36844,4178,110,28230,28230,27946,28036,27851
43614,6,17,42326,1288,43513,101,1.78144e+14,10.3947,724.35,43614,14,13,41758,40671,37770,28760,20211
4494,171,1125,4234,260,0,4494,2.22762e+18,94.8894,1726.05,4494,523,83,3369,3369,1271,1238,793
24905,10044,10417,23795,1110,23795,1110,5.01513e+18,95.0492,12137.7,24905,4986,111,14488,14488,14243,14470,14091
49689,15,16,48256,1433,49632,57,1.5203e+14,10.3841,702.554,49689,14,12,49673,49673,49558,49559,49488
1007,209,390,0,1007,0,1007,5.8966e+17,76.1172,564.927,1007,150,42,617,617,501,538,511
20125,1985,4707,0,20125,7074,13051,2.54214e+15,59.9319,6302.05,20125,2293,72,15418,15418,11499,8161,6853
20064,2,14,19466,598,19989,75,1.82221e+14,10.339,437.137,20064,13,12,11863,9387,6425,9459,4529
5290,202,1275,0,5290,1851,3439,2.5344e+15,58.9193,1849.84,5290,611,72,4015,4015,1586,1449,709
11479,2689,2726,4040,7439,0,11479,9.91314e+12,59.7047,3757.08,11479,1328,72,8753,8753,8714,8743,8716
5220,149,1285,0,5220,0,5220,6.5215e+17,95.6471,1956.06,5220,602,88,3935,3935,2396,1270,793
21503,1716,5067,20253,1250,20253,1250,5.884e+18,97.5128,6992.74,21503,2438,110,16436,16436,15586,15325,6270
15352,561,651,0,15352,14914,438,3.55829e+16,20.077,1792.61,15352,83,26,14701,14701,14402,14416,13236
37754,4393,9461,35604,2150,35604,2150,6.13524e+18,97.564,12389.5,37754,4583,110,28293,28293,27163,27163,14664
49569,95,2299,0,49569,48098,1471,4.67897e+16,324.297,7515.71,49569,409,26,45769,45246,35242,26359,8522
2320,508,648,2187,133,2187,133,2.33733e+18,91.9401,1009.62,2320,289,63,1672,1672,1672,1654,1527
14426,7214,14426,14426,0,0,14426,134208000,0,14426,14426,14426,1,0,0,0,0,0
26739,2859,11609,0,26739,10346,16393,1.87005e+15,55.6103,13187.9,26739,5650,72,15130,15130,9932,5037,3800
48451,125,176,48434,17,48451,0,5.98149e+18,171.872,2607.99,48451,173,173,45945,42071,34464,34395,34442
14758,3219,7988,14758,0,14758,0,2.44311e+18,15.7904,8313.95,14758,7174,20,6770,6770,2078,6767,2106
14882,5919,7164,0,14882,0,14882,4.41314e+17,91.3631,8260.16,14882,3456,110,7718,7718,6707,5948,5937
10398,1531,2455,9788,610,0,10398,2.24161e+18,97.0076,3572.68,10398,1177,110,7943,7943,6690,6481,5461
3268,1047,1429,0,3268,0,3268,4.99538e+17,88.4385,1817.02,3268,659,70,1839,1839,1589,1623,1636
2506,1170,1291,2506,0,2396,110,7.19666e+18,69.2267,1552.56,2506,519,64,1215,1215,1215,1215,1215
28305,2721,8697,0,28305,0,28305,5.8596e+17,96.5193,10899.2,28305,4212,110,19608,19608,14222,8875,7938
39782,9917,16367,15235,24547,0,39782,7.5926e+12,57.2225,18596.7,39782,7969,72,23415,23415,19845,22667,13973
10197,3393,4245,9737,460,9737,460,2.72691e+18,92.7522,5148.16,10197,2041,109,5952,5952,5587,5868,5441
27906,6188,9149,27906,0,26285,1621,4.05755e+18,172.131,10487.5,27906,3347,122,18757,18757,15622,17034,13256
24097,8332,9161,22957,1140,22957,1140,2.94182e+18,93.8382,10950.9,24097,4421,110,14936,14936,13377,14040,13002
29158,5954,14709,11642,17516,0,29158,6.40756e+12,55.7139,16229.2,29158,7165,72,14449,14449,10581,13789,6108
29099,1422,9011,27569,1530,0,29099,2.0114e+18,96.3197,11255.6,29099,4365,110,20088,20088,13411,12074,5587
11242,3907,4261,10705,537,10705,537,2.82954e+18,94.7095,5276.87,11242,2050,110,6981,6981,6644,6876,6250
4124,71,175,4118,6,4124,0,6.16145e+18,148.135,789.441,4124,87,87,3332,2558,1705,1670,1548
33405,7347,7829,0,33405,0,33405,6.49758e+17,97.7866,10530.1,33405,3795,110,25576,25576,25036,24559,24452
19787,529,8971,0,19787,0,19787,4.669e+17,93.9634,10371.9,19787,4351,110,10816,10226,6542,2059,2161
17021,1602,8344,17021,0,16292,729,4.26773e+18,160.027,9304.85,17021,3307,127,8677,8412,5002,6362,2957
35731,88,208,35642,89,35731,0,6.11549e+18,202.197,2525.75,35731,172,172,30691,22294,15082,15816,14867
15795,60,204,15783,12,15795,0,5.968e+18,179.718,1543.83,15795,145,151,10929,5795,4220,5187,4490
47390,18138,18878,47390,0,45310,2080,4.89529e+18,2434.74,22201.8,47390,7951,151,28512,28499,28500,28500,27837
29891,5948,8639,28274,1617,28274,1617,6.53205e+18,96.8438,10980.7,29891,4181,110,21252,21252,20148,19964,16010
7935,106,1931,0,7935,2793,5142,2.52059e+15,59.3477,2706.69,7935,933,72,6004,5956,3443,289,459
22679,7636,10069,21719,960,0,22679,1.6248e+18,91.9971,11645.4,22679,4872,110,12610,12610,11859,11366,10940
12626,891,3041,11886,740,11886,740,4.3062e+18,97.6209,4306.22,12626,1425,111,9585,9585,5497,6737,3479
7290,427,1766,0,7290,0,7290,6.48938e+17,96.1045,2622.69,7290,835,99,5524,5524,2831,1813,1757
33089,147,176,33029,60,33089,0,6.08921e+18,172.655,2251.69,33089,165,163,32325,30817,27866,27741,27590
14214,3035,3692,5059,9155,0,14214,9.55957e+12,59.4233,4883.27,14214,1788,72,10522,10522,10051,10422,9451
31572,9,13,30658,914,31552,20,1.56437e+14,10.2346,523.127,31572,12,12,31213,30789,25266,25422,25480
9962,1883,2396,0,9962,3503,6459,2.52781e+15,59.5854,3319.19,9962,1161,72,7566,7566,6837,6389,6111
42147,10842,20861,40527,1620,0,42147,1.47202e+18,93.5924,23208,42147,10128,110,21286,21286,17656,15448,11716
9215,2030,4048,3570,5645,0,9215,7.37198e+12,56.3712,4739.81,9215,1971,72,5167,5167,3596,4897,1935
32225,13348,15698,30965,1260,30965,1260,2.59905e+18,93.7453,17627.9,32225,7618,110,16527,16527,14769,15380,14686
14192,13,199,14185,7,14192,0,5.97985e+18,179.06,1464.92,14192,144,144,4216,634,896,952,882
38302,1,14,37208,1094,38253,49,1.43523e+14,10.6055,615.076,38302,13,11,9476,9476,9476,9476,9476
20609,39,82,20548,61,20609,0,2.40072e+18,81.2918,1222.19,20609,82,82,15364,7170,8968,9275,10057
11227,4884,5901,10817,410,0,11227,1.39944e+18,78.9859,6738.59,11227,2834,107,5326,5326,5161,5044,5123
46699,10089,12220,44079,2620,44079,2620,6.15877e+18,97.4487,15644.2,46699,5927,110,34479,34479,33535,33387,30044
14095,4413,5037,13404,691,0,14095,1.88259e+18,95.2276,6268.88,14095,2429,110,9058,9058,8808,8721,8855
21163,3913,7397,20113,1050,0,21163,1.89925e+18,95.6976,9075.55,21163,3581,110,13766,13766,11035,10418,8102
34911,4086,12622,13068,21843,0,34911,8.22226e+12,56.0845,14768.4,34911,6135,72,22289,22289,15689,21159,7808
31322,7365,11722,0,31322,11788,19534,2.06841e+15,57.7731,13654.9,31322,5704,72,19600,19600,16838,13022,12347
5558,684,1983,2057,3501,0,5558,8.40384e+12,53.1729,2513.06,5558,946,71,3575,3575,2283,3348,858
30646,8640,9525,29026,1620,29026,1620,2.83646e+18,97.1472,11813.5,30646,4543,111,21121,21121,19428,19850,18902
1067,300,305,375,692,0,1067,9.55373e+12,54.5923,479.868,1067,136,43,762,762,762,762,762
41531,1834,19510,41531,0,40091,1440,4.7558e+18,2918.61,22979.2,41531,5892,144,19367,16464,8123,11905,4452
27038,104,176,27026,12,27038,0,5.9854e+18,169.672,1949.55,27038,165,162,24482,15961,14875,15685,16180
11833,300,723,0,11833,11487,346,4.10253e+16,51.1285,1853.59,11833,93,26,11110,11075,10068,9823,4724
16049,578,726,0,16049,15588,461,3.69335e+16,54.261,1992.74,16049,93,26,15323,15285,15038,15031,13093
45478,7806,11465,42876,2602,42876,2602,4.01826e+18,98.1334,14778.2,45478,5426,111,34013,34013,30538,33778,24841
4155,1,11,4033,122,4151,4,1.62449e+14,10.4775,188.271,4155,11,11,879,879,879,879,879
16709,993,4062,15736,973,15736,973,2.83665e+18,97.8198,5614.9,16709,1917,111,12647,12647,6907,8660,3977
10877,2570,5268,7036,3841,10444,433,6.82215e+18,93.0529,6125.52,10877,2516,106,5609,5609,4889,5408,3784
46981,20,176,46859,122,46981,0,6.11331e+18,173.763,2684.06,46981,168,173,19137,3968,5443,5614,5072
32327,12140,16645,0,32327,0,32327,3.45052e+15,17.9756,17152.9,32327,14968,20,15682,15682,11845,15682,11762
10728,4877,10728,0,10728,10728,0,2047.81,0,10728,10728,10728,1,0,0,0,0,0
8665,1330,2182,8160,505,8160,505,3.91893e+18,96.9938,3129.97,8665,1014,108,6483,6483,5587,6426,4598
13659,2,12,13265,394,13650,9,1.5441e+14,10.5814,340.906,13659,12,11,8044,5969,4903,5150,4070
8063,636,720,0,8063,7822,241,4.84018e+16,46.851,1711.54,8063,91,26,7343,7312,7255,7245,6890
42994,569,14410,40804,2190,40804,2190,3.84543e+18,94.7009,17301.3,42994,6872,111,28584,28282,14789,14896,0
45783,5197,14216,0,45783,0,45783,5.83505e+17,96.6557,17406.6,45783,6899,110,31567,31567,21578,17170,12438
30581,85,176,30509,72,30581,0,6.18535e+18,166.985,2141.46,30581,144,151,27451,21830,15880,15712,14783
49525,438,1306,0,49525,48114,1411,3.55625e+16,264.926,4615.57,49525,210,26,48219,47485,41840,42265,23087
9963,1698,2375,0,9963,0,9963,6.51724e+17,96.7736,3454.19,9963,1134,110,7588,7588,6824,6328,5879
11500,359,2783,10832,668,10832,668,5.78134e+18,96.9081,3977.76,11500,1331,110,8717,8717,6849,5534,1718
6609,579,1626,0,6609,2333,4276,2.52185e+15,59.2388,2298.42,6609,791,72,4983,4983,3209,2492,1986
48461,8,10,47719,742,48365,96,9.61967e+13,3.99802,599.543,48461,7,4,48451,48451,48451,48450,45913
20391,356,4794,0,20391,0,20391,6.49593e+17,97.5777,6643.23,20391,2316,110,15597,15597,9560,4479,2207
38810,6239,9131,36556,2254,0,38810,2.22454e+18,97.7981,12171.4,38810,4426,110,29679,29679,25788,25127,21208
41923,5705,12681,41923,0,39483,2440,4.25759e+18,298.325,14781,41923,4977,128,29242,29086,21410,24760,14466
5334,72,186,5329,5,5334,0,5.9814e+18,167.429,888.372,5334,105,103,3989,2215,1860,2147,1981
48401,7397,13629,45741,2660,45741,2660,2.30122e+18,97.7168,17000.5,48401,6486,111,34772,34772,31429,32129,20430
31511,4467,11687,30001,1510,0,31511,1.83488e+18,95.5821,13905.1,31511,5671,110,19824,19824,13691,13531,8611
29294,1361,8294,0,29294,0,29294,6.06391e+17,96.9091,10613.6,29294,4012,110,21000,21000,12898,5103,3094
12111,11,14,11748,363,12062,49,1.96923e+14,10.608,365.706,12111,12,11,12097,12095,11864,11728,10935
25054,15,176,24981,73,25054,0,6.00463e+18,171.595,1908.32,25054,155,161,8262,1463,1822,1948,1984
39884,4,14,38744,1140,39804,80,1.38853e+14,10.5723,615.793,39884,14,12,34798,30998,30299,30110,19226
49857,142,176,49773,84,49857,0,5.98258e+18,171.787,2644.98,49857,172,172,48463,45317,40365,40805,40336
3707,5,11,3602,105,3703,4,1.41079e+14,10.6968,170.556,3707,11,11,3421,3083,2480,2529,2071
13684,1,6,13445,239,13652,32,9.99273e+13,3.99613,251.285,13684,5,4,5499,5499,5499,5499,5499
5524,3064,3092,0,5524,2247,3277,1.49543e+15,54.097,3491.94,5524,1503,71,2432,2432,2416,2421,2416
47572,8470,11132,44802,2770,0,47572,2.22864e+18,97.8902,14709.4,47572,5398,110,36440,36440,33490,32259,28722
27840,13,15,27006,834,27780,60,1.93221e+14,10.2425,575.82,27840,13,11,27825,27825,27632,27632,25617
47962,7352,15277,47962,0,45172,2790,4.10702e+18,328.219,17253.1,47962,4550,136,32685,32463,23842,26831,17285
43975,19072,21187,0,43975,17392,26583,1.71057e+15,55.5423,23373.6,43975,10299,72,22788,22788,21486,20716,20068
35317,1,14,34305,1012,35236,81,1.42471e+14,10.6589,592.112,35317,13,12,8809,8809,8809,8809,8809
6925,309,2389,2567,4358,0,6925,8.58397e+12,57.6853,3018.81,6925,1158,72,4536,4488,2892,4246,1070
2542,438,926,2542,0,2394,148,5.1377e+18,87.9784,1228.26,2542,321,68,1616,1616,1100,1311,1005
26514,365,6264,24974,1540,0,26514,2.22495e+18,97.6322,8523.98,26514,3023,110,20250,20250,6569,5187,2492
16167,1323,3941,15227,940,15227,940,3.9336e+18,97.7564,5455.6,16167,1857,111,12226,12226,7291,8684,4986
8471,1249,2055,2983,5488,0,8471,9.85795e+12,59.4552,2868.41,8471,1000,72,6416,6416,5241,6209,3983
43339,302,1189,0,43339,42105,1234,3.55109e+16,246.082,4108.9,43339,187,26,42062,41557,35883,36004,17279
14344,2249,3422,0,14344,0,14344,6.47965e+17,97.2737,4836.49,14344,1647,110,10922,10922,9335,8381,7662
10826,1798,3255,10238,588,10238,588,3.53203e+18,96.3661,4317.68,10826,1532,111,7571,7571,6742,7234,4303
30843,10265,10596,11439,19404,0,30843,8.4623e+12,58.2349,12579.6,30843,5156,72,20247,20247,19866,20164,19404
11698,3211,3810,4301,7397,0,11698,8.71194e+12,58.2853,4765.96,11698,1845,72,7888,7888,7155,7758,6425
4875,6,13,4731,144,4837,38,1.92673e+14,10.8137,223.775,4875,12,11,4643,4437,3877,3641,2143
23288,2415,10557,0,23288,9082,14206,1.80955e+15,56.4386,11931.9,23288,5136,72,12731,12731,8397,4525,3281
29582,13,16,28688,894,29519,63,2.09256e+14,10.1139,607.082,29582,13,11,29566,29566,29190,29198,25582
35616,6160,12007,33806,1810,33806,1810,6.7515e+18,96.7902,14499.5,35616,5741,111,23609,23609,18648,20488,13332
6616,1627,1666,6229,387,6229,387,3.22249e+18,95.9427,2453.94,6616,786,96,4950,4950,4922,4938,4942
5651,2414,2490,0,5651,0,5651,4.85863e+17,85.6877,3062.48,5651,1177,85,3161,3161,3161,3161,3161
9619,11,282,0,9619,9277,342,1.14315e+16,7.88606,1536.22,9619,76,10,9337,9310,8151,8481,6069
36020,6549,8409,0,36020,12656,23364,2.52698e+15,60.0141,10959.2,36020,4083,72,27611,27611,25356,25147,21693
9154,5724,9154,0,9154,0,9154,524231,0,9154,9154,9154,1,0,0,0,0,0
32416,2358,10520,32416,0,30529,1887,5.44538e+18,218.48,12010.1,32416,3873,125,21896,21612,13575,17260,5718
28426,629,918,0,28426,27613,813,3.55852e+16,175.247,2911.87,28426,133,26,27508,27241,24642,25166,21657
10566,3397,4077,10068,498,0,10566,1.80558e+18,94.4974,5038.19,10566,1962,107,6489,6489,5575,5400,4778
35982,4,14,34939,1043,35923,59,1.55655e+14,10.4979,612.75,35982,13,11,31449,28095,23029,23593,12148
28468,3146,6823,26808,1660,26808,1660,4.69015e+18,98.1681,9151.51,28468,3214,111,21645,21645,14647,16136,11080
16744,2868,4816,15834,910,0,16744,2.08115e+18,96.5339,6327.6,16744,2321,110,11928,11928,10010,9586,8070
8591,98,170,8584,7,8591,0,5.96994e+18,161.314,1092.55,8591,122,123,7574,4747,4507,4744,4926
22541,1024,6592,8154,14387,0,22541,9.1176e+12,59.0044,8236.96,22541,3197,72,15949,15949,8513,13693,3645
6114,232,439,0,6114,0,6114,3.72846e+18,15.9486,718.781,6114,258,18,5675,5675,4037,3430,3857
38096,1,14,37004,1092,38018,78,1.4339e+14,10.4207,595.867,38096,14,12,9443,9443,9443,9443,9443
26633,11,12,25871,762,26621,12,1.41631e+14,10.3809,465.513,26633,12,11,26621,26621,26392,26393,26269
32688,6031,10733,31008,1680,31008,1680,4.96472e+18,96.8683,13090.8,32688,5132,111,21955,21955,15646,16947,13595
10133,2033,4491,10133,0,9636,497,4.30254e+18,109.04,5139.92,10133,1816,114,5642,5619,3763,4586,2790
577,50,531,567,10,567,10,1.66506e+18,5.81109,548.955,577,218,30,46,18,5,14,0
13342,2112,3987,0,13342,0,13342,5.97212e+17,96.1111,5246.86,13342,1920,110,9355,9355,7287,5055,5241
2296,78,573,810,1486,0,2296,1.01083e+13,57.8188,882.574,2296,279,57,1723,1348,1002,1595,309
47894,2864,13673,0,47894,0,47894,6.0427e+17,97.0702,17075.8,47894,6633,110,34221,34221,20701,11918,11262
41802,4126,9746,39364,2438,0,41802,2.2311e+18,97.8995,12977.9,41802,4725,110,32056,32056,24386,23017,14899
20380,5083,6314,20380,0,19190,1190,3.25933e+18,151.401,7560.46,20380,2354,128,14066,14066,13749,13853,11645
49949,137,176,49881,68,49949,0,6.0807e+18,173.551,2763.52,49949,172,173,48366,45205,38474,39165,38802
46237,3949,11085,43547,2690,43547,2690,3.30603e+18,98.3627,14487.4,46237,5252,111,35152,35152,21689,25083,14208
30686,3528,10846,29176,1510,0,30686,1.88404e+18,94.4598,13070.3,30686,5249,110,19840,19840,12750,11727,6698
14368,34,170,14300,68,14368,0,5.97817e+18,164.584,1412.26,14368,138,145,7638,2315,2425,3089,2835
26677,5343,10790,0,26677,0,26677,5.05918e+17,94.9849,12660.9,26677,5237,110,15887,15887,13445,12941,9589
12064,552,2914,11364,700,11364,700,5.78988e+18,96.9615,4152.4,12064,1389,110,9150,9150,7575,6406,2345
15120,2966,3942,0,15120,0,15120,6.28216e+17,96.8311,5380.25,15120,1896,110,11178,11178,10071,8961,8559
46600,12,14,45270,1330,46517,83,1.38726e+14,10.5078,665.243,46600,13,12,46585,46581,46279,46278,44988
23116,1,11,22450,666,23104,12,1.48835e+14,10.1849,434.69,23116,11,11,5483,5483,5483,5483,5483
32782,2560,14403,31382,1400,31382,1400,2.75076e+18,93.8028,16499.8,32782,6972,110,18379,18379,8867,12574,5476
27003,444,893,0,27003,26231,772,3.55952e+16,164.477,2797.77,27003,127,26,26110,25874,21862,22350,17094
31557,199,206,31538,19,31557,0,5.98244e+18,185.952,2188.02,31557,171,174,31351,31350,30931,30988,30954
43373,6929,13123,41073,2300,0,43373,2.02975e+18,96.7619,16208.4,43373,6367,110,30250,30250,25169,22953,16629
34766,4623,12422,0,34766,0,34766,5.44292e+17,95.1511,14859.9,34766,6027,110,22344,22344,16484,10208,9807
44375,5,14,43108,1267,44292,83,1.38996e+14,10.5559,651.214,44375,13,12,40922,36638,34722,34543,24776
41961,11178,14561,15595,26366,0,41961,8.4193e+12,58.1813,17096.8,41961,7078,72,27400,27400,23965,26810,19963
32710,5902,7648,11492,21218,0,32710,9.86592e+12,60.0101,10007.3,32710,3718,72,25062,25062,22597,24632,19732
22950,41,176,22898,52,22950,0,6.06168e+18,171.49,1869.36,22950,151,157,13879,4927,4876,5536,5182
34196,10315,15877,32788,1408,32788,1408,3.79203e+18,94.4855,17929.1,34196,7628,111,18319,18319,12761,13778,11200
24509,7,13,23792,717,24492,17,1.66423e+14,10.2581,466.26,24509,12,12,23775,23225,21231,19249,14352
19481,1,13,18926,555,19408,73,1.4125e+14,10.8449,430.941,19481,12,12,4905,4905,4905,4905,4905
35620,1698,8773,33568,2052,33568,2052,3.99085e+18,97.9948,11524.4,35620,4146,111,26847,26847,15175,18163,6707
24941,5481,11834,0,24941,9823,15118,1.739e+15,56.1496,13241.7,24941,5758,72,13107,13059,9217,8940,4628
7131,1828,2262,6751,380,6751,380,6.95494e+18,95.0763,3041.7,7131,1084,94,4869,4869,4819,4819,4581
42816,10,14,41595,1221,42736,80,1.39002e+14,10.6114,647.679,42816,14,12,42586,42174,40761,40458,36970
46122,1324,13682,16730,29392,0,46122,9.05919e+12,59.0629,16595,46122,6655,72,32440,32440,19274,30171,3195
43767,676,1202,0,43767,42519,1248,3.55769e+16,249.569,4156.25,43767,189,26,42565,41957,36446,37367,29373
15676,10,14,15220,456,15615,61,1.5855e+14,10.6706,394.274,15676,13,12,15583,15442,15056,14559,13170
14181,1504,4355,13429,752,0,14181,2.03121e+18,96.0585,5659.98,14181,2094,110,9826,9826,7016,7128,5464
31767,12,17,30809,958,31697,70,2.04432e+14,10.3221,628.971,31767,13,12,31750,31749,29604,29656,26964
13752,3014,4731,5104,8648,0,13752,8.52176e+12,57.9116,5787.38,13752,2298,72,9021,9021,7741,8751,5787
2064,54,104,0,2064,2006,58,3.53306e+16,19.3677,306.718,2064,32,26,1960,1960,1659,1679,1257
17024,758,904,0,17024,16529,495,4.21959e+16,176.751,2546.26,17024,130,26,16120,16120,15861,15839,14466
36631,13,14,35586,1045,36552,79,1.39135e+14,10.6004,588.896,36631,14,12,36617,36617,36379,36379,35588
45266,4296,10570,0,45266,15909,29357,2.52632e+15,60.0612,13648.3,45266,5141,72,34696,34696,24950,23301,14539
20548,1538,4901,19355,1193,19355,1193,3.34621e+18,97.4715,6753.23,20548,2369,110,15647,15647,8897,11975,5687
5310,1210,1272,0,5310,1865,3445,2.53849e+15,59.0793,1850.76,5310,610,72,4038,4038,3996,3957,3992
47788,2137,11180,45007,2781,45007,2781,5.72579e+18,97.8939,14768.6,47788,5420,110,36608,36608,30783,25963,8815
21353,5,14,20718,635,21300,53,1.9015e+14,10.4755,492.142,21353,13,11,19840,18066,14957,15006,9923
3931,400,1030,0,3931,1390,2541,2.43394e+15,58.2165,1485.8,3931,485,68,2901,2901,2123,1229,1334
8918,124,176,8905,13,8918,0,6.09085e+18,163.73,1168.86,8918,115,115,8393,7734,6291,6292,6299
21914,477,5183,0,21914,7706,14208,2.52647e+15,59.8945,6887.94,21914,2521,72,16731,16731,9968,5576,1787
6082,1180,3149,0,6082,1324,4758,1.34835e+13,8.95199,3301.55,6082,2830,11,2933,2933,1496,1647,1365
11691,1404,3092,11031,660,0,11691,2.15832e+18,96.6083,4275.19,11691,1482,110,8599,8599,6848,6570,5047
45373,2,14,44083,1290,45286,87,1.38731e+14,10.5615,659.051,45373,13,12,26263,18590,18142,19289,15329
39826,19200,22224,0,39826,0,39826,3.74527e+17,92.0744,24254.1,39826,10801,110,17602,17602,16717,16159,15596
10769,501,741,0,10769,10452,317,4.36668e+16,70.1071,1872.39,10769,95,26,10028,9970,9696,9561,7806
46619,6975,14806,46619,0,43899,2720,3.98124e+18,320.002,16743.2,46619,4693,136,31813,31607,23373,26068,16481
19478,3713,8679,7567,11911,0,19478,7.15059e+12,56.2977,9893.58,19478,4205,72,10799,10799,7059,9829,4050
26847,10651,11727,10398,16449,0,26847,7.29124e+12,56.7477,13299.4,26847,5706,72,15120,15120,14079,14937,12976
48491,388,1852,0,48491,47077,1414,4.2137e+16,305.548,6189.78,48491,316,26,46633,45247,34792,35190,16202
35440,638,10868,33570,1870,33570,1870,6.80814e+18,96.6196,13488.1,35440,5270,110,24572,24314,18731,14674,3571
49365,16482,17317,46932,2433,0,49365,1.88854e+18,95.9777,20548.6,49365,8398,110,32048,32048,31883,31736,31845
45371,917,1400,0,45371,44069,1302,3.76448e+16,276.795,4780.99,45371,228,26,43971,43971,40999,41477,35302
25589,2792,9348,0,25589,9598,15991,2.09852e+15,56.819,11015.2,25589,4549,72,16241,16241,11258,6845,5377
18771,341,4844,17701,1070,17701,1070,3.68191e+18,97.1114,6515.67,18771,2292,111,13927,13843,5990,8788,2060
37007,11105,15039,0,37007,0,37007,5.02316e+17,94.8005,17445.5,37007,7285,110,21968,21968,20183,20007,17482
34430,2979,11824,27066,7364,32700,1730,2.33178e+18,94.9955,14235.4,34430,5650,111,22606,22606,14667,16772,8864
1815,16,97,0,1815,1765,50,3.5334e+16,18.5725,278.637,1815,30,26,1671,1566,1092,1081,450
4275,69,193,0,4275,4154,121,3.53799e+16,19.735,563.772,4275,41,26,4082,4082,3652,3678,1914
20321,9,11,19733,588,20312,9,1.59305e+14,10.1295,413.57,20321,11,11,20098,19845,18678,18711,17830
20342,385,1021,0,20342,19749,593,4.25998e+16,206.426,2984.12,20342,152,26,19316,18927,15728,16243,10223
22987,8667,8889,8703,14284,0,22987,7.9063e+12,57.5138,10382.4,22987,4315,72,14098,14098,13811,14048,13620
22160,350,5264,0,22160,0,22160,6.47959e+17,97.532,7226.12,22160,2545,110,16896,16896,5492,1677,2240
29634,9,12,28789,845,29622,12,1.39009e+14,10.4304,488.932,29634,12,11,29234,28832,27823,27824,24153
42794,6,16,41545,1249,42725,69,1.65725e+14,10.4223,679.455,42794,14,12,40895,39619,36434,32372,21776
44222,5943,15673,44222,0,41852,2370,4.04781e+18,346.799,17797.2,44222,6089,137,28549,28281,19023,22380,10602
29492,14,15,28621,871,29415,77,1.7314e+14,10.5259,582.623,29492,13,11,29477,29477,29298,29299,28649
7209,136,175,7209,0,7209,0,5.97155e+18,160.085,1009.56,7209,114,117,6831,6381,5563,5694,5516
24841,6109,7598,9043,15798,0,24841,8.96267e+12,58.8126,9344.18,24841,3696,72,17243,17243,15915,17013,14526
26874,129,1254,0,26874,26088,786,4.32818e+16,265.586,3850.77,26874,199,26,25156,24924,20731,17383,7759
34436,5942,8075,32434,2002,0,34436,2.22732e+18,97.7601,10844.7,34436,3910,110,26361,26361,24010,23075,20285
4214,93,1144,3974,240,3974,240,1.97733e+18,95.0256,1703.75,4214,521,81,2806,899,826,1099,587
15084,710,3611,14211,873,14211,873,5.7607e+18,97.1561,5077.16,15084,1731,110,11473,11473,9593,8156,2981
33800,5042,11393,12497,21303,0,33800,8.54268e+12,56.7037,13549.3,33800,5528,72,22407,22407,17171,21507,10894
41421,627,9633,0,41421,14555,26866,2.52987e+15,60.0646,12497.4,41421,4679,72,31788,31788,9890,5381,2547
21461,172,5051,0,21461,0,21461,6.48334e+17,97.5332,6972.31,21461,2435,110,16410,16332,4761,1132,1598
22432,81,176,22359,73,22432,0,5.98615e+18,169.658,1777.25,22432,155,161,18250,10374,9316,10263,10361
21080,9,12,20469,611,21064,16,1.59685e+14,10.3027,428.292,21080,12,11,20827,20577,19958,19959,16869
13330,440,4657,12668,662,0,13330,1.90819e+18,94.2358,5849.45,13330,2229,110,8673,8501,3927,2983,1710
19254,7944,19254,19254,0,19254,0,3.4358e+10,0,19254,19254,19254,1,0,0,0,0,0
34853,10,16,33808,1045,34783,70,1.98445e+14,10.429,648.46,34853,13,12,34756,34626,33596,30574,27634
42777,895,1316,0,42777,41552,1225,3.73183e+16,265.627,4466.95,42777,212,26,41461,41461,38640,39425,33885
16361,1219,4442,11610,4751,15444,917,1.35946e+18,97.3298,5927.48,16361,2097,111,11919,11919,11049,11468,4567
17290,63,176,17272,18,17290,0,6.13132e+18,169.148,1627.59,17290,139,138,13317,9003,5982,6241,6393
49622,6057,12300,46790,2832,46790,2832,3.33172e+18,97.6634,15948.7,49622,5958,110,37322,37322,24890,30383,18825
22113,136,176,22094,19,22113,0,6.08124e+18,171.053,1838.97,22113,154,148,21316,20060,16855,17154,16979
20191,9331,11336,0,20191,0,20191,3.73513e+17,88.3829,12544.3,20191,5492,110,8855,8855,8250,8370,7981
16010,44,675,0,16010,15554,456,3.55652e+16,20.1139,1860.15,16010,85,26,15335,15335,9892,9759,3048
8414,1720,2090,7931,483,7931,483,3.42976e+18,96.2751,3035.02,8414,987,106,6324,6324,5650,5964,5578
14895,3078,3503,0,14895,5243,9652,2.53959e+15,59.8629,4766.45,14895,1705,72,11392,11392,10882,10674,10470
41630,110,208,41545,85,41294,336,6.012e+18,199.313,2609.06,41630,181,177,37990,30873,21255,22530,22150
25896,8343,12472,24866,1030,24866,1030,2.97938e+18,93.0442,14098.1,25896,6003,111,13424,13424,11568,13316,9522
39195,769,1541,0,39195,38056,1139,4.16664e+16,287.202,5029.21,39195,256,26,37654,37654,35250,34086,23881
22388,610,10580,22388,0,21418,970,5.43157e+18,255.662,11799.5,22388,3321,131,11808,10982,5896,7648,926
15817,1919,6079,15067,750,15067,750,3.81814e+18,89.271,7362.45,15817,2883,111,9738,9738,5165,6138,3745
35589,1267,11885,33782,1807,0,35589,1.94054e+18,96.2368,14430.6,35589,5770,110,23704,23704,14049,12192,2670
23411,6280,6708,0,23411,0,23411,6.03852e+17,96.7535,8657.38,23411,3235,110,16703,16703,16614,16606,16689
32902,3015,12690,31352,1550,31352,1550,1.88828e+18,96.0027,14904,32902,6085,111,20212,20212,13526,10871,4994
37586,12465,14991,35856,1730,35856,1730,4.18346e+18,95.831,17402.1,37586,7197,111,22595,22595,17997,18801,15978
8194,155,290,0,8194,8051,143,2.5564e+16,3.73395,1147.38,8194,147,4,7904,7904,7890,7810,5690
2933,117,767,0,2933,0,2933,6.57749e+17,93.5203,1200.92,2933,354,70,2166,977,761,472,552
28654,1699,6744,26984,1670,0,28654,2.22862e+18,97.731,9142.51,28654,3262,110,21910,21910,15034,13967,6573
5681,346,375,1744,3937,1744,3937,2.14746e+18,15.94,645.012,5681,241,18,5306,5306,5266,5206,5129
4909,2235,2639,0,4909,0,4909,4.08154e+17,81.5692,3089.03,4909,1258,77,2270,2270,2270,2243,2270
42818,5710,15386,40736,2082,0,42818,1.86477e+18,95.8475,18244.4,42818,7465,110,27432,27432,20706,19303,13138
34435,10942,12490,32755,1680,32755,1680,3.67091e+18,96.3503,14847.5,34435,5978,111,21945,21945,20031,20419,19516
41757,10729,27057,37016,4741,37016,4741,1.46654e+18,6.52109,31053.6,41757,9018,14,14700,14700,11492,11191,6404
17233,4854,5384,17233,0,16226,1007,3.12676e+18,137.437,6493.56,17233,2060,121,11849,11849,11841,11822,11084
44016,132,176,43995,21,44016,0,6.00556e+18,173.474,2535.54,44016,172,174,42142,39316,32618,33410,33103
35720,2775,9681,0,35720,12798,22922,2.40614e+15,59.4396,12111.8,35720,4711,72,26039,26039,17738,12650,7667
11766,1527,2842,11082,684,11082,684,5.90675e+18,96.9181,4056.8,11766,1364,110,8924,8924,8591,8594,5213
22453,3804,9188,8585,13868,0,22453,7.64024e+12,57.1494,10607.8,22453,4470,72,13265,13265,9241,12133,4649
32817,6235,7709,30907,1910,30907,1910,5.89092e+18,97.7456,10373.3,32817,3734,110,25108,25108,24731,24731,20889
41971,23674,23857,40581,1390,40581,1390,2.93072e+18,92.2611,25893.7,41971,11511,111,18114,18114,18103,18067,18003
42100,11318,11739,15132,26968,0,42100,9.29919e+12,59.332,14493.8,42100,5716,72,30361,30361,29751,30251,29184
16071,1416,4356,5755,10316,0,16071,9.44113e+12,59.2346,5644.28,16071,2121,72,11715,11715,7072,10474,4241
13487,3552,6837,0,13487,0,13487,4.20922e+17,89.9479,7820.67,13487,3302,110,6650,6650,5437,5025,4640
41925,10,176,41830,95,41925,0,6.08751e+18,172.282,2533.92,41925,170,167,10596,1884,2119,1971,2335
40000,3015,11052,37800,2200,0,40000,2.10602e+18,97.1764,14035.1,40000,5359,110,28948,28948,16954,15251,8807
7083,1861,2288,6708,375,6708,375,6.86508e+18,94.9609,3058.5,7083,1090,99,4795,4795,4571,4535,4022
20057,8,12,19469,588,20039,18,1.67451e+14,10.2821,421.127,20057,12,11,19674,19388,18748,18318,14986
34075,57,1276,0,34075,33086,989,3.97834e+16,266.794,4122,34075,204,26,32165,32053,26273,22425,6188
7486,312,348,0,7486,1554,5932,1.49422e+16,11.9714,624.507,7486,319,14,7138,7138,6840,6625,7000
39210,7897,10453,0,39210,14007,25203,2.41748e+15,57.4176,13091.5,39210,5070,72,28757,28757,27535,26540,26211
22856,7457,12877,22095,761,22095,761,2.37376e+18,89.222,14200.5,22856,6235,110,9979,9979,7100,7936,7072
48589,4112,21475,18870,29719,0,48589,7.2009e+12,56.6324,23987.3,48589,10445,72,27114,27114,15926,22990,4883
17096,2554,5679,17096,0,16099,997,4.04773e+18,136.433,6661.4,17096,2051,120,11417,11353,7863,9535,5682
49614,8727,13073,46841,2773,0,49614,2.14121e+18,97.4218,16659.9,49614,6345,110,36541,36541,31414,30418,25293
20195,10901,12454,0,20195,8463,11732,1.27033e+15,52.2106,13397.7,20195,6047,72,7741,7741,7654,7513,7629
17855,5019,5331,6482,11373,0,17855,9.06874e+12,58.8572,6691.19,17855,2591,72,12524,12524,12272,12471,12003
47794,7403,17913,47794,0,45254,2540,4.33004e+18,390.051,19861.7,47794,6959,138,29881,29519,20049,24020,13187
13354,1081,3904,12634,720,12634,720,6.6805e+18,96.2289,5175.36,13354,1869,110,9450,9450,8970,8839,3832
3097,176,806,2917,180,0,3097,2.23221e+18,93.2758,1259.02,3097,365,70,2291,2291,1037,1020,763
3463,146,174,3460,3,3463,0,6.14764e+18,143.858,720.525,3463,84,77,3266,3193,2948,2929,2936
7911,4434,4781,3294,4617,0,7911,5.15308e+12,53.6969,5264.47,7911,2320,72,3130,3130,3065,3120,3093
16168,4496,7914,16168,0,15458,710,5.34429e+18,163.246,8773.1,16168,2079,130,8254,8244,7037,7640,5491
3574,80,280,0,3574,3469,105,4.36499e+16,19.1528,692.605,3574,49,26,3294,3286,2894,2896,1437
45060,8823,10554,42440,2620,42440,2620,3.3629e+18,97.879,13983.7,45060,5119,110,34506,34506,31038,32639,29516
27641,7,176,27622,19,27641,0,6.05279e+18,172.345,2043.47,27641,163,160,5305,671,896,702,889
15152,65,3634,14264,888,14264,888,4.19102e+18,97.8254,5082.55,15152,1712,111,8020,2300,4741,5809,188
37482,147,176,37467,15,37482,0,5.98426e+18,169.671,2292.67,37482,166,170,36610,34364,31775,31740,31588
16861,1793,4685,15931,930,0,16861,2.11051e+18,96.7389,6219.73,16861,2263,110,12176,12176,8687,8769,6308
6219,394,3897,6219,0,6019,200,6.74529e+18,113.401,4306.53,6219,1132,85,2322,2020,1312,1628,220
44570,31,176,44553,17,44570,0,5.98045e+18,169.85,2499.1,44570,171,171,22646,6001,7043,7863,7569
11700,758,849,0,11700,2362,9338,1.45263e+16,11.9818,1192.62,11700,481,14,10851,10851,10314,9867,10609
20449,94,175,20441,8,20449,0,5.98734e+18,166.194,1692.43,20449,150,158,17854,11107,10200,10890,11101
17592,2340,7488,16821,771,16821,771,2.70249e+18,94.1223,8822.67,17592,3608,110,10104,10104,7531,8290,4139
35061,4094,9435,12542,22519,0,35061,9.44625e+12,59.4723,11831.9,35061,4596,72,25626,25626,18762,23991,11043
10652,874,6118,10302,350,0,10652,1.25928e+18,81.0269,6863.85,10652,2940,101,4534,4362,2622,2254,916
20157,1959,10007,0,20157,0,20157,4.28888e+17,90.613,11345.3,20157,4851,110,10150,10150,6501,3601,2993
30804,3909,10981,29294,1510,29294,1510,7.69673e+18,95.3189,13199,30804,5318,110,19823,19823,19823,19823,8379
33401,7797,9426,31578,1823,31578,1823,6.59072e+18,97.0276,12000,33401,4566,110,23975,23975,23772,23772,21881
19838,124,176,19768,70,19838,0,6.03604e+18,169.772,1721.05,19838,147,155,18717,17147,13893,13918,13872
5620,1057,2671,4143,1477,5390,230,5.2126e+18,92.5603,3213.35,5620,1260,81,2949,2866,1495,1778,1472
24686,1109,7223,0,24686,8940,15746,2.33966e+15,59.0302,8986.74,24686,3512,72,17463,17463,8256,5329,3066
20650,3,6,20307,343,20618,32,9.8414e+13,3.99753,329.314,20650,5,4,19000,17356,17813,17814,16560
18861,91,1033,0,18861,18308,553,4.43249e+16,205.03,2974.68,18861,155,26,17529,17376,14276,12206,4401
6342,1645,3515,6122,220,6122,220,2.309e+18,83.3821,4046.6,6342,1670,89,2827,2827,1971,2339,1290
31690,6059,16224,0,31690,0,31690,4.14475e+17,92.7291,18060.5,31690,7868,110,15466,15466,11279,7046,7384
12323,108,176,12314,9,12323,0,6.06418e+18,168.044,1363.97,12323,131,132,11229,8435,7123,7363,7652
40030,1696,9418,37707,2323,0,40030,2.22326e+18,97.8062,12533.7,40030,4564,110,30612,30612,20124,18058,7036
43519,84,176,43502,17,43519,0,5.98166e+18,171.685,2479,43519,172,171,36294,20762,19079,20565,20561
9655,3153,5502,9655,0,9655,0,2.51431e+18,17.8774,5749.27,9655,4942,20,4153,4153,2427,4153,2473
2623,3,11,2543,80,2618,5,1.84896e+14,10.682,151.302,2623,11,11,2051,1566,1118,1225,704
40874,4747,9545,38494,2380,38494,2380,5.8781e+18,97.8513,12717.6,40874,4626,110,31329,31329,30119,30119,16774
18014,7,12,17483,531,17998,16,1.76145e+14,10.1677,402.953,18014,12,11,17532,17232,16493,15460,13145
48446,3666,17739,0,48446,18172,30274,2.09121e+15,53.1296,20524.2,48446,8636,72,30707,30707,17197,12941,0
14360,1487,3390,0,14360,5046,9314,2.54331e+15,59.8019,4614.05,14360,1651,72,10970,10970,8156,5362,4864
3029,1454,1485,2907,122,0,3029,1.56722e+18,89.5507,1827.14,3029,700,65,1544,1544,1524,1525,1540
39053,9541,16078,14949,24104,0,39053,7.58209e+12,57.2098,18276.1,39053,7826,72,22975,22975,19525,22385,15543
5471,118,389,0,5471,5311,160,4.23311e+16,19.3361,972.979,5471,59,26,5082,5074,4092,4218,2295
13259,5645,8496,0,13259,0,13259,3.1061e+17,86.1158,9266.32,13259,4114,103,4763,4763,3836,3688,3385
17525,5575,6267,17525,0,16545,980,4.39759e+18,141.262,7248.97,17525,2358,121,11258,11258,10816,11039,10391
9549,6874,9549,9549,0,0,9549,7.99916,0,9549,9549,9549,1,0,0,0,0,0
9024,423,2222,8504,520,0,9024,2.21313e+18,96.4423,3220.97,9024,1052,109,6802,6802,3193,2857,1816
30871,6971,7224,0,30871,10858,20013,2.52821e+15,60.0017,9473.15,30871,3514,72,23647,23647,23299,22972,23045
36684,4,32,36556,128,36684,0,1.1167e+18,31.9721,1083.46,36684,32,32,3549,0,2291,3437,3549
41537,6977,9659,14596,26941,0,41537,9.89548e+12,60.0538,12525.2,41537,4695,72,31878,31878,27934,31198,23226
36129,7,14,35101,1028,36052,77,1.38794e+14,10.6824,589.141,36129,13,12,34858,34057,26315,26420,22304
30730,6729,7241,28948,1782,28948,1782,5.89633e+18,97.6835,9772.12,30730,3496,110,23489,23489,23369,23369,22319
35894,9568,13388,35894,0,34024,1870,3.84552e+18,291.528,15198,35894,5659,130,22506,22457,19545,20567,17000
3257,85,1231,0,3257,0,3257,5.46818e+17,78.4151,1650.29,3257,559,65,1746,587,1214,751,0
12305,1826,5429,11775,530,11775,530,2.76182e+18,93.8569,6432.99,12305,2621,110,6876,6876,2862,4357,1816
19696,6110,7685,18769,927,18769,927,2.04372e+18,95.7312,9179.38,19696,3683,111,12011,12011,10896,11940,9657
23431,5019,8872,23431,0,22181,1250,3.88343e+18,171.754,10036.8,23431,2895,129,14559,14544,11750,12655,8930
35847,2,14,34821,1026,35802,45,1.39941e+14,10.52,576.872,35847,13,11,20788,14773,14134,14895,11568
33363,1963,33363,0,33363,0,33363,524272,0,33363,33363,33363,1,0,0,0,0,0
6697,690,1587,2350,4347,0,6697,9.97516e+12,59.4,2272.38,6697,772,72,5110,5110,3797,4792,2366
36234,2767,8700,34124,2110,34124,2110,2.3483e+18,98.2675,11504.5,36234,4108,111,27534,27534,13112,18997,10046
18865,1,12,18322,543,18851,14,1.48966e+14,10.5009,397.92,18865,12,11,4476,4476,4476,4476,4476
48021,19710,27366,0,48021,19735,28286,1.42084e+15,54.7165,29381,48021,13329,72,20655,20655,18683,15939,15522
1690,712,1111,717,973,0,1690,5.02328e+12,42.5225,1253.28,1690,535,47,579,579,450,549,393
13197,109,564,0,13197,12823,374,3.55456e+16,20.051,1559.32,13197,76,26,12633,12633,10740,10894,3862
1481,69,170,1481,0,1481,0,5.93003e+18,118.483,453.014,1481,62,56,1050,590,540,602,652
6885,1091,2024,2481,4404,0,6885,9.12815e+12,58.4861,2690.02,6885,976,72,4861,4861,3828,4641,2252
44468,12,14,43199,1269,44388,80,1.38737e+14,10.5915,658.135,44468,13,12,44453,44449,43959,43958,42000
27642,2975,6520,26034,1608,26034,1608,5.76112e+18,97.6732,8850.46,27642,3154,110,21122,21122,18995,18650,10550
2039,482,573,734,1305,0,2039,9.71703e+12,57.2599,850.058,2039,279,55,1466,1466,1344,1438,1314
16093,414,727,0,16093,15631,462,3.69893e+16,54.5835,1998.31,16093,94,26,15366,15327,13360,13560,9420
45364,8065,13690,45364,0,42725,2639,4.0964e+18,320.676,15919.1,45364,4218,136,31674,31476,25179,27315,19890
18183,7074,8161,17416,767,0,18183,1.61498e+18,94.0492,9486.63,18183,3951,110,10022,10022,9386,9047,8680
32889,5755,8744,31052,1837,31052,1837,6.35612e+18,97.261,11330.2,32889,4240,110,24145,24145,23505,23505,16594
16932,9151,9879,0,16932,6990,9942,1.38669e+15,32.434,10755.4,16932,4795,72,7053,7053,7053,7053,7053
30618,3,14,29717,901,30536,82,1.73272e+14,10.28,534.882,30618,12,12,23716,18173,14908,16923,8519
10045,1907,3433,10045,0,9465,580,3.98104e+18,92.2264,4135.33,10045,1220,118,6612,6612,4963,5739,4059
509,64,209,479,30,479,30,6.25823e+18,71.1552,309.297,509,83,33,236,72,93,157,156
45819,9,14,44513,1306,45737,82,1.38732e+14,10.4137,645.428,45819,13,12,45203,44555,40941,39170,32247
30361,6394,12437,11611,18750,0,30361,7.62684e+12,57.2013,14236.9,30361,6054,72,17924,17924,14579,17224,9094
3856,260,1003,0,3856,1363,2493,2.50882e+15,58.3934,1449.46,3856,484,68,2853,2853,1529,995,868
7228,137,176,7220,8,7228,0,6.03729e+18,159.968,1042.46,7228,113,111,6863,6372,5652,5737,5599
28153,791,12087,26926,1227,0,28153,1.66579e+18,94.5981,13975.3,28153,5868,110,16066,15317,9964,8699,3418
14589,1917,3487,13739,850,0,14589,2.22649e+18,97.1461,4916.24,14589,1674,110,11102,11102,9412,8736,6857
45001,10958,17307,17021,27980,0,45001,7.94798e+12,57.6636,19859.8,45001,8429,72,27694,27694,23393,26954,18333
42726,7,14,41509,1217,42644,82,1.38807e+14,10.4133,614.386,42726,13,12,41221,40141,35352,33433,28786
28647,2336,14070,0,28647,0,28647,4.31311e+17,92.92,15828.8,28647,6823,110,14577,14577,9065,5070,3175
26590,867,10176,25340,1250,25340,1250,8.05287e+18,94.7571,12100.9,26590,4916,110,16414,16090,5198,13595,3813
26986,9317,13217,0,26986,5921,21065,1.33701e+13,8.99259,13558.4,26986,11893,11,13769,13769,10677,13769,10313
41449,7156,11775,39189,2260,0,41449,2.0832e+18,97.0722,14812.7,41449,5716,110,29674,29674,25123,24185,20002
13086,2486,3147,12316,770,12316,770,2.22067e+18,97.6127,4442.78,13086,1475,111,9939,9939,8951,9317,8381
42201,13380,22785,17131,25070,0,42201,5.94321e+12,54.7335,24705.4,42201,11095,72,19416,19416,16318,18888,12835
49176,13050,13893,46496,2680,0,49176,2.08617e+18,97.1504,17383.2,49176,6745,110,35283,35283,34225,34050,33305
17682,179,208,17611,71,17682,0,6.03386e+18,196.504,1736.64,17682,149,153,17298,17002,15364,15334,15100
5892,1890,2212,0,5892,0,5892,5.47799e+17,93.9228,2849.21,5892,1059,90,3680,3680,3323,3332,3018
29779,6184,8942,28196,1583,0,29779,2.03884e+18,96.6451,11249.2,29779,4331,110,20837,20837,18268,17127,14152
17830,2552,9509,17830,0,17830,0,2.48238e+18,17.9591,9873.1,17830,8544,20,8321,8321,2200,8321,2252
47628,9668,20918,0,47628,0,47628,4.74433e+17,94.2925,23720.4,47628,10165,110,26710,26710,22121,18582,15330
18242,9118,10186,17622,620,17622,620,1.0595e+19,92.1375,11314.8,18242,4939,110,8056,8056,7976,7976,7474
42695,218,10519,15107,27588,0,42695,9.72977e+12,59.8518,13405.8,42695,5122,72,32176,32080,9150,25541,1175
11070,467,3971,4126,6944,0,11070,8.36169e+12,57.7044,4849.05,11070,1930,72,7099,7003,4167,5969,1372
42536,296,1797,0,42536,41291,1245,4.37909e+16,307.901,5869.06,42536,306,26,40457,39417,34214,28253,9858
25231,2773,8275,23929,1302,23929,1302,4.88856e+18,96.7501,10208.3,25231,3937,111,16956,16956,9926,11621,7133
10818,313,3681,3997,6821,0,10818,8.518e+12,57.9165,4565.71,10818,1778,72,7137,7041,4186,5916,1107
34974,1636,17207,13893,21081,0,34974,6.55619e+12,55.9482,18998.8,34974,8380,72,17767,17767,9590,14732,3274
786,265,269,736,50,736,50,3.47342e+18,82.0891,420.691,786,114,42,517,517,517,517,517
17929,2835,6451,0,17929,6695,11234,2.11001e+15,57.8427,7722.99,17929,3127,72,11478,11478,8684,6221,5431
4224,952,1050,3974,250,3974,250,5.79641e+18,95.1411,1624.95,4224,491,81,3174,3174,3154,3154,3088
38929,6352,14991,37109,1820,0,38929,1.79071e+18,95.4328,17562.6,38929,7277,110,23938,23938,17975,16283,10316
26750,4528,6412,25190,1560,25190,1560,3.45896e+18,98.1407,8634.88,26750,3024,111,20338,20338,16759,17541,15047
41401,1,61,41305,96,41401,0,2.27052e+18,60.8325,1505.58,41401,61,61,0,0,0,0,0
40764,15067,17266,15706,25058,0,40764,7.4512e+12,57.0346,19499.5,40764,8411,72,23498,23498,22180,23219,20151
27789,9788,11073,10578,17211,0,27789,7.76235e+12,56.2845,12781.3,27789,5375,72,16716,16716,16044,16576,15088
6927,162,2248,6927,0,6527,400,2.97532e+18,93.2073,2863.73,6927,828,104,4679,4679,2323,3054,650
19762,7714,8838,7693,12069,0,19762,7.13378e+12,55.5012,10063.8,19762,4290,72,10924,10924,10162,10794,9456
22290,7230,12017,22290,0,22290,0,2.93528e+18,17.8061,12422.8,22290,10799,20,10273,10273,6393,6281,6337
32332,6,12,31410,922,32317,15,1.3897e+14,10.2105,506.654,32332,11,12,30720,29830,21339,21717,18891
35786,907,9805,33796,1990,33796,1990,4.55058e+18,97.7614,12490.6,35786,4660,111,25981,25981,11046,16166,3631
18894,6327,8106,18064,830,18064,830,3.04441e+18,95.0115,9486.69,18894,3882,111,10788,10788,9747,10729,8865
13423,230,3224,12643,780,0,13423,2.22496e+18,97.0905,4564.69,13423,1549,110,10199,10199,6170,5529,1393
38674,10036,10057,36494,2180,36494,2180,3.37597e+18,97.4297,13008.3,38674,4872,110,28617,28617,28600,28614,28617
5575,2,12,5409,166,5569,6,1.86657e+14,9.04126,222.466,5575,11,11,3367,2708,1842,2729,2004
36683,6678,12104,34813,1870,34813,1870,3.03496e+18,96.2937,14727.4,36683,5872,110,24579,24579,20492,23476,13609
3718,116,915,1298,2420,0,3718,9.86005e+12,58.5968,1358.23,3718,438,65,2803,2803,1649,2603,408
13742,5,11,13348,394,13737,5,1.39119e+14,9.99542,326.082,13742,11,11,12673,11224,10940,10660,6826
34992,826,1176,0,34992,33985,1007,3.77977e+16,241.063,3850.74,34992,184,26,33816,33816,32803,32874,28533
14752,142,427,0,14752,14230,522,1.14886e+16,7.93099,2333.18,14752,114,10,14325,14325,13481,13794,10873
34733,1302,2015,34733,0,33311,1422,3.05012e+18,19.1393,2747.75,34733,1046,30,32718,32717,32718,32516,23578
9615,3,12,9334,281,9602,13,1.72017e+14,10.4577,291.109,9615,12,11,7495,5632,4778,5174,2589
9955,75,2385,0,9955,3509,6446,2.53322e+15,59.5887,3308.91,9955,1155,72,7570,5551,1966,261,372
11033,8,13,10714,319,10995,38,1.65369e+14,10.7295,333.467,11033,12,11,10818,10627,9888,9553,8439
41954,8257,13423,41954,0,39511,2443,3.98547e+18,295.057,15219.5,41954,4989,129,28531,28377,22331,24976,18896
20773,5122,5775,19632,1141,0,20773,2.10643e+18,96.8181,7570.36,20773,2790,110,14998,14998,14354,14090,13602
35026,4813,8204,32986,2040,0,35026,2.22819e+18,97.8041,11011.3,35026,3972,110,26822,26822,22225,21331,16737
7767,89,176,7764,3,7767,0,6.08835e+18,162.736,1088.43,7767,109,116,6669,4588,3777,3899,3795
46629,9179,13450,44109,2520,44109,2520,3.1613e+18,91.0282,16774.8,46629,6530,110,33179,33179,32172,32878,30429
10956,262,456,0,10956,10644,312,3.53843e+16,20.1535,1295.39,10956,66,26,10500,10500,9363,9461,6845
25389,10791,14257,10394,14995,0,25389,5.66421e+12,54.1768,15496.8,25389,6940,72,11132,11132,9695,10884,8189
27936,7073,8093,0,27936,0,27936,6.0166e+17,96.8147,10315.1,27936,3918,110,19843,19843,18531,17563,17299
31471,12931,13481,0,31471,12140,19331,1.8871e+15,56.8986,15287,31471,6555,72,17990,17990,17217,16735,16427
4136,291,388,0,4136,4011,125,4.75099e+16,18.4316,910.216,4136,58,26,3748,3748,3653,3697,3215
2291,831,849,2291,0,2158,133,3.7061e+18,86.9354,1130.43,2291,283,64,1442,1442,1441,1442,1442
22989,202,5396,21649,1340,21649,1340,5.75225e+18,97.601,7423.16,22989,2605,110,17593,17526,12897,9563,1818
11203,1,13,10879,324,11137,66,1.56227e+14,10.7415,320.706,11203,12,12,2498,2498,2498,2498,2498
34286,652,1220,0,34286,33678,608,2.56739e+16,3.7354,4671.41,34286,611,4,33066,33066,33009,32670,23792
41472,8569,18144,41472,0,40002,1470,4.70515e+18,3434.61,21979.6,41472,6614,143,23328,18793,17207,19037,12382
16607,3049,5899,0,16607,0,16607,5.49612e+17,95.4891,7291.68,16607,2849,110,10708,10708,8293,6535,5699
31625,4783,11534,11858,19767,0,31625,8.20364e+12,57.8359,13506.7,31625,5613,72,20091,20091,15086,19228,9116
48782,16537,16647,46322,2460,46322,2460,3.56049e+18,96.8063,19814.5,48782,7967,111,32135,32135,32045,32129,32035
21694,1315,7486,8052,13642,0,21694,8.4556e+12,57.4635,8989.68,21694,3624,72,14208,14208,8436,12380,3793
2606,160,170,2606,0,2606,0,5.97586e+18,139.291,600.38,2606,81,76,2427,2396,2345,2342,2333
8420,2117,4338,8420,0,8070,350,5.66881e+18,120.911,4916.22,8420,1071,106,4082,4037,3464,3646,2977
43581,8993,11289,0,43581,15521,28060,2.44436e+15,59.4527,14192,43581,5481,72,32292,32292,29199,29851,25543
4464,2,10,4334,130,4464,0,1.61924e+14,9.51501,191.249,4464,10,10,2585,1939,1589,1963,1388
38198,11209,16890,38198,0,36488,1710,4.71602e+18,552.754,18915.2,38198,4443,141,21308,21061,18664,19901,14993
36383,12378,13475,36383,0,34478,1905,4.09746e+18,261.719,15287.2,36383,5667,129,22908,22908,22165,22596,21051
15808,1815,3899,0,15808,0,15808,6.40761e+17,97.2296,5408.71,15808,1880,110,11909,11909,9051,5317,5736
13072,2986,4252,0,13072,0,13072,5.76189e+17,95.7129,5457.11,13072,2051,110,8820,8820,7803,7953,6451
47120,4875,16355,44782,2338,0,47120,1.89933e+18,96.0935,19481.8,47120,7943,110,30765,30765,20497,19394,12206
42494,18564,19015,42494,0,40774,1720,5.06416e+18,2141.41,21859.2,42494,7920,149,23479,23479,23466,23463,23158
41219,8277,9660,14493,26726,0,41219,9.85529e+12,60.0182,12505.6,41219,4690,72,31559,31559,29990,31229,27486
40156,7424,9335,0,40156,14109,26047,2.53373e+15,60.0693,12125.3,40156,4543,72,30821,30821,28009,26256,24693
48635,18872,20776,46503,2132,46503,2132,5.41372e+18,95.4798,23609.6,48635,9985,111,27859,27859,25406,25994,24694
42892,15091,15543,40812,2080,40812,2080,2.93468e+18,95.824,18392.4,42892,7542,110,27349,27349,26946,27254,26776
36480,15041,20324,36480,0,36480,0,2.42474e+18,17.8855,20832.8,36480,18277,20,16156,16156,12137,16156,12188
25780,1204,9283,9646,16134,0,25780,8.26289e+12,56.5812,10971.3,25780,4517,72,16497,16497,9825,15346,1776
48111,12573,18838,48111,0,45649,2462,4.57126e+18,442.503,20846.2,48111,4081,141,29273,29100,25637,27828,22116
24095,2495,11411,24095,0,23055,1040,4.49139e+18,260.825,12709.4,24095,4581,132,12684,12231,7806,9469,3848
4452,1615,2019,4262,190,4262,190,4.34043e+18,88.2327,2492.67,4452,944,73,2433,2433,2305,2312,2427
6639,39,301,0,6639,6449,190,3.57955e+16,20.031,853.996,6639,51,26,6338,6334,4286,4203,1669
31270,146,7309,0,31270,10992,20278,2.53069e+15,60.0138,9582.31,31270,3555,72,23961,23895,13569,8338,869
35715,931,1050,0,35715,34701,1014,3.55496e+16,217.119,3502.74,35715,158,26,34665,34665,34326,34313,32260
28974,1392,1736,0,28974,28105,869,5.12839e+16,300.303,5299.88,28974,295,26,27238,27238,26820,26824,24430
12332,1033,2965,0,12332,0,12332,6.49859e+17,97.0173,4223.97,12332,1425,110,9367,9367,6800,4593,3922
5067,1496,1906,4817,250,4817,250,5.07182e+18,93.9029,2474.56,5067,894,82,3161,3161,2542,2625,2554
13837,5839,6365,13267,570,0,13837,1.58475e+18,93.1204,7434.47,13837,3061,110,7472,7472,7352,7221,7348
27913,5211,6485,0,27913,9808,18105,2.53391e+15,60.0139,8561.29,27913,3153,72,21428,21428,19869,18483,17421
46718,1,13,45379,1339,46691,27,1.42208e+14,10.3695,624.903,46718,12,12,11679,11679,11679,11679,11679
43372,728,1417,0,43372,42125,1247,3.84594e+16,278.496,4778.51,43372,232,26,41955,41955,35636,36707,26295
6689,1774,2562,2516,4173,0,6689,7.95719e+12,56.8656,3149.49,6689,1235,72,4127,4127,3509,3997,2649
33487,14,15,32502,985,33425,62,1.72952e+14,10.4659,621.203,33487,13,11,33472,33472,33195,33196,32586
30215,2786,7124,28463,1752,28463,1752,5.7715e+18,97.6728,9621.82,30215,3443,110,23091,23091,20525,20114,10293
49775,9953,12972,46983,2792,0,49775,2.14963e+18,97.4656,16579.7,49775,6287,110,36803,36803,33515,32788,29944
38317,6765,9235,36087,2230,36087,2230,3.52699e+18,98.2635,12161.7,38317,4368,111,29082,29082,29082,29082,22237
35759,7761,9572,33769,1990,0,35759,2.13079e+18,97.2757,12330.4,35759,4638,110,26187,26187,24312,23498,21455
39267,9477,14763,14795,24472,0,39267,8.04535e+12,57.3181,17081.4,39267,7169,72,24504,24504,20081,23744,14862
33168,6191,9309,0,33168,11940,21228,2.37821e+15,59.2837,11570.2,33168,4534,72,23859,23859,20741,21352,17141
2337,334,618,2197,140,2197,140,5.6377e+18,92.6021,987.722,2337,278,60,1719,1719,1547,1530,1165
10504,1592,2760,9904,600,0,10504,2.17237e+18,96.5625,3852.45,10504,1325,110,7744,7744,6234,5934,4727
11365,1051,4584,4330,7035,0,11365,7.72171e+12,57.0047,5433.42,11365,2227,72,6781,6781,4826,6121,2923
16830,2365,3959,0,16830,5917,10913,2.53185e+15,59.8396,5346.83,16830,1922,72,12871,12871,10914,8572,7789
19604,1160,4660,6903,12701,0,19604,9.83367e+12,59.8341,6220.29,19604,2265,72,14944,14944,9876,14067,3796
49574,14884,19235,0,49574,18778,30796,2.01734e+15,57.2326,21991.7,49574,9348,72,30339,30339,28083,26791,24421
41792,1,16,40545,1247,41720,72,1.89668e+14,10.4134,723.778,41792,13,12,6689,6689,6689,6689,6689
21507,5213,7900,0,21507,0,21507,5.37829e+17,95.4447,9565.47,21507,3821,110,13607,13607,11687,12164,8735
39183,10245,10604,37013,2170,37013,2170,6.28509e+18,97.245,13556.1,39183,5133,110,28579,28579,28362,28332,27815
6010,1879,2062,6010,0,5658,352,4.32708e+18,91.3238,2581.98,6010,728,99,3948,3948,3830,3885,3817
26771,1256,1560,0,26771,25970,801,4.97763e+16,299.533,4729.22,26771,259,26,25211,25211,24877,24823,23057
25288,455,6977,0,25288,9074,16214,2.39003e+15,57.666,8812.46,25288,3376,72,18311,18263,10841,1398,1779
883,161,163,883,0,883,0,5.85862e+18,93.1687,345.328,883,54,41,720,720,720,720,720
43934,3005,10206,15436,28498,0,43934,9.89682e+12,60.0767,13208.5,43934,4968,72,33728,33728,23147,31900,10221
45681,897,1944,0,45681,44340,1341,4.42889e+16,309.257,6375.89,45681,338,26,43737,43737,38261,38533,23974
17502,12,14,16996,506,17425,77,1.57962e+14,10.7289,421.178,17502,13,12,17487,17483,17069,17069,16390
12165,3264,5747,8931,3234,11665,500,3.69612e+18,89.0092,6691.07,12165,2750,111,6418,6418,4915,5171,5049
7431,95,608,0,7431,7210,221,4.5333e+16,19.4138,1453.54,7431,80,26,6823,6807,4999,5211,2344
32683,7417,13804,31243,1440,31243,1440,2.77159e+18,74.188,15942.8,32683,6685,110,18879,18879,7206,12315,0
43631,10081,10490,41094,2537,41094,2537,3.39552e+18,98.3226,13733.9,43631,4962,111,33141,33141,32717,33117,32507
42831,6847,13169,40561,2270,40561,2270,2.39217e+18,96.6094,16146.3,42831,6292,111,29662,29662,18563,23290,14820
39658,10563,19993,15848,23810,0,39658,6.39928e+12,55.0543,21933.8,39658,9735,72,19665,19665,14733,18821,8939
7902,17,176,7836,66,7902,0,6.13958e+18,126.941,1099.38,7902,104,101,2977,664,873,735,581
26873,165,176,26852,21,26873,0,6.09328e+18,171.295,2028.56,26873,154,159,26563,26307,25203,24948,25158
515,29,33,107,408,0,515,5.92555e+13,11.6311,96.8637,515,30,13,482,482,468,465,471
13055,630,5055,12445,610,12445,610,8.08337e+18,94.2892,6179.32,13055,2421,110,8000,7828,3138,6904,2524
24320,3019,5770,0,24320,0,24320,6.45361e+17,97.5662,7882.06,24320,2778,110,18550,18550,14870,11443,10561
8294,430,3235,8294,0,7861,433,6.10351e+18,93.4087,3880.94,8294,1292,109,5059,4966,3456,3887,1244
34001,1647,8173,32021,1980,32021,1980,5.72884e+18,98.2375,10842,34001,3862,111,25828,25828,13937,18497,6739
4101,62,176,4069,32,4101,0,6.09241e+18,150.404,792.451,4101,92,90,3008,1913,1356,1462,1438
34892,6715,8180,32860,2032,0,34892,2.22937e+18,97.7872,10976.3,34892,3962,110,26712,26712,25126,24471,22766
31952,4537,7463,0,31952,11230,20722,2.5311e+15,60.0246,9777.51,31952,3631,72,24489,24489,20168,14732,14981
20987,4675,4949,19767,1220,19767,1220,5.88254e+18,97.4914,6837.73,20987,2388,110,16038,16038,15969,15972,15520
34512,15032,15437,33062,1450,0,34512,1.61044e+18,94.3864,17594.8,34512,7494,110,19075,19075,18987,18976,19068
20116,146,777,0,20116,19540,576,3.60037e+16,97.7157,2266.18,20116,104,26,19339,19241,13594,13566,6564
41044,17272,18278,0,41044,0,41044,4.7008e+17,94.4905,20747,41044,8882,110,22766,22766,22394,22453,22330
42618,2246,2477,0,42618,0,42618,3.77615e+18,15.9926,3246.68,42618,1757,18,40141,40141,38000,38348,37606
11733,2676,2730,4123,7610,0,11733,9.94008e+12,59.7821,3784.13,11733,1324,72,9003,9003,8935,8985,8936
40753,11175,15548,0,40753,0,40753,5.22613e+17,95.476,18222.1,40753,7543,110,25205,25205,20292,13161,12048
4906,306,333,0,4906,4766,140,4.12576e+16,19.3626,845.281,4906,54,26,4573,4573,4530,4528,4309
28215,1,12,27397,818,28196,19,1.5837e+14,10.2912,493.998,28215,12,11,6191,6191,6191,6191,6191
7698,447,1859,7248,450,0,7698,2.23734e+18,96.3297,2748.62,7698,884,102,5839,5839,3014,2803,1831
37440,11526,14167,35670,1770,35670,1770,8.01118e+18,95.5417,16683.2,37440,6881,110,23273,23273,22983,22983,20046
23474,2293,5485,8244,15230,0,23474,9.88273e+12,59.9321,7290.93,23474,2660,72,17989,17989,13065,16801,7629
43526,10519,28203,9393,34133,0,43526,2.23336e+13,5.52194,32345.9,43526,9397,13,15323,15323,12330,12843,6955
48032,1454,14447,48032,0,45240,2792,4.51253e+18,334.477,16776.5,48032,2999,138,33585,32931,15578,21923,4114
12776,189,3078,12026,750,12026,750,4.42577e+18,97.616,4352.84,12776,1439,111,9698,9698,4190,6172,1315
22966,3679,6734,0,22966,0,22966,5.99394e+17,96.62,8638.44,22966,3253,110,16232,16232,13778,11833,9854
26017,7,14,25245,772,25998,19,1.79442e+14,10.2548,491.302,26017,13,12,25435,25113,23411,19877,18436
18021,1,61,17957,64,18021,0,2.33569e+18,60.5539,999.282,18021,61,61,0,0,0,0,0
38058,4803,19230,36611,1447,36611,1447,5.75687e+18,92.6074,21326,38058,9263,111,18828,18828,14766,12423,5447
17941,51,932,0,17941,17417,524,4.21477e+16,168.39,2656.14,17941,133,26,16750,16687,13506,11638,3531
24630,4206,5740,0,24630,8645,15985,2.53329e+15,59.9776,7618.73,24630,2792,72,18890,18890,17018,14759,14012
38203,5826,8923,0,38203,0,38203,6.48774e+17,97.871,11931.8,38203,4326,110,29280,29280,25816,26426,20150
9296,1768,3974,3582,5714,0,9296,7.49067e+12,56.5962,4683.37,9296,1936,72,5322,5322,3586,5022,1687
19739,6845,7482,19739,0,18702,1037,3.52128e+18,143.366,8631.68,19739,3089,124,12257,12257,11928,12080,11188
36804,3026,11219,36804,0,34662,2142,4.04021e+18,261.358,13119.2,36804,4388,128,25585,25199,15407,19489,7825
6448,249,2871,6268,180,6132,316,4.73806e+18,93.0267,3391.59,6448,1201,100,3577,3484,1740,2362,822
5177,667,1245,0,5177,1812,3365,2.54761e+15,59.0566,1812.08,5177,602,72,3932,3932,3225,2590,2241
29251,104,7059,27551,1700,27551,1700,5.20371e+18,98.153,9435.98,29251,3331,111,22024,8814,8892,14280,979
15892,8183,8286,15892,0,15892,0,2.64493e+18,235.551,8730.95,15892,4560,23,7606,7379,7606,7606,7457
23289,6,15,22590,699,23232,57,1.99313e+14,10.2313,479.637,23289,12,12,22439,21880,20810,18133,10421
773,34,228,0,773,270,503,2.81004e+15,52.6908,360.826,773,111,39,409,92,220,186,146
38141,647,12324,38141,0,35929,2212,5.19574e+18,271.433,14000.3,38141,4567,128,25817,25397,9810,16762,2140
4240,98,463,0,4240,4113,127,5.17489e+16,17.8866,1054.39,4240,64,26,3777,3762,2586,2791,817
47810,552,1495,0,47810,46316,1494,0.0312487,0.96873,8453.84,47810,1495,1,46315,46315,46315,46315,46315
25267,13136,13971,0,25267,10307,14960,1.47995e+15,54.9271,15228.5,25267,6802,72,11296,11296,11211,11092,11188
19693,4394,5779,18633,1060,18633,1060,6.76182e+18,94.9157,7477.12,19693,2774,110,13914,13914,13664,13664,11171
7337,2074,2368,7337,0,6907,430,4.59114e+18,93.5431,3007.5,7337,878,108,4969,4969,4748,4849,4648
41610,1115,1165,0,41610,40424,1186,3.55907e+16,243.987,3990.91,41610,181,26,40445,40445,40319,40313,39798
17096,6038,6048,16246,850,16246,850,4.09616e+18,91.4749,7456.26,17096,2863,111,11048,11048,11048,11048,11048
6610,1976,4049,6610,0,6390,220,6.79227e+18,123.04,4484.43,6610,1048,89,2561,2518,1809,2155,1347
26774,23,927,0,26774,26009,765,3.6454e+16,179.846,2900.82,26774,134,26,25526,23790,16000,15535,4516
28401,6847,11969,27141,1260,27141,1260,4.05072e+18,95.4061,13860.1,28401,5756,111,16432,16432,10483,11773,8327
29762,6017,6966,10465,19297,0,29762,9.87289e+12,60.0099,9152.8,29762,3384,72,22796,22796,21652,22556,19903
49685,2676,19455,49685,0,47815,1870,5.11671e+18,4373.95,24394.9,49685,7895,155,26023,22021,13020,16882,5617
10495,1,11,10186,309,10488,7,1.86184e+14,10.1776,303.448,10495,11,11,1752,1752,1752,1752,1752
24681,8273,11103,9624,15057,0,24681,7.11682e+12,56.5349,12549.4,24681,5409,72,13578,13578,12269,13353,10911
10835,6049,7025,4588,6247,0,10835,4.5465e+12,49.4652,7581.73,10835,3400,72,3810,3810,3634,3770,3487
46557,703,1254,0,46557,45230,1327,3.55699e+16,258.157,4383.11,46557,199,26,45303,45303,42355,42675,31306
46361,3,18,44997,1364,46229,132,1.71887e+14,10.535,758.499,46361,15,13,36015,27395,26205,29663,16561
30566,4003,12613,11720,18846,0,30566,7.58496e+12,56.5958,14418,30566,6139,72,17953,17953,12213,16966,5403
12245,2,12,11888,357,12237,8,1.61414e+14,10.3145,324.482,12245,12,11,7168,5393,4443,5451,3542
15301,3320,6345,5867,9434,0,15301,7.62195e+12,56.9788,7391.41,15301,3091,72,8956,8956,7306,8608,4714
23576,2040,8080,0,23576,8736,14840,2.17622e+15,58.235,9684.94,23576,3935,72,15496,15496,9847,5122,3904
40494,12435,22575,0,40494,8714,31780,1.36469e+13,8.99568,22959.6,40494,20315,11,17919,17919,12119,12362,11895
8535,520,2016,0,8535,2991,5544,2.53876e+15,59.4138,2840.41,8535,971,72,6519,6519,3430,2342,1788
9055,55,176,9047,8,9055,0,6.1334e+18,164.635,1177.96,9055,111,113,6590,4315,2705,2873,2778
38118,4983,15535,36398,1720,36398,1720,2.71792e+18,95.0522,17988.9,38118,7540,110,22583,22583,17181,18387,9041
34946,5302,8962,32966,1980,0,34946,2.16604e+18,97.4573,11697.7,34946,4346,110,25984,25984,21712,20773,16800
22781,6581,7489,22781,0,21456,1325,3.47194e+18,159.692,8667.31,22781,2532,128,15292,15292,15240,15279,13890
21086,8066,11076,21086,0,21086,0,2.60146e+18,17.968,11477.7,21086,9954,20,10010,10010,7436,10010,7493
48063,7,18,46651,1412,47943,120,1.73454e+14,10.5368,777.958,48063,15,13,46746,45917,37353,36332,27386
45290,135,176,45273,17,45290,0,5.98164e+18,169.782,2518.95,45290,171,172,43618,40863,34335,35267,34831
24565,19099,24565,24565,0,24565,0,34358300000,0,24565,24565,24565,1,0,0,0,0,0
36174,6399,11652,36174,0,34073,2101,5.19289e+18,257.993,13268.9,36174,3612,130,24522,24429,20766,23084,14495
11084,3413,4394,11084,0,10494,590,3.66821e+18,106.848,5107.34,11084,1672,122,6690,6672,6587,6629,6546
49309,11266,11522,46439,2870,0,49309,2.2272e+18,97.9118,15206.5,49309,5589,110,37787,37787,37460,37436,37309
13398,2738,5789,12808,590,12808,590,1.99342e+18,92.7827,6858.82,13398,2758,111,7609,7609,6614,6392,5458
12300,638,721,0,12300,11944,356,4.0364e+16,48.8659,1861.41,12300,93,26,11579,11546,11275,11316,10099
15247,4186,5457,15247,0,14417,830,4.75438e+18,133.708,6448.57,15247,1266,126,9790,9790,9214,9685,7425
5743,1471,1515,2050,3693,0,5743,9.61171e+12,58.9053,2114.82,5743,735,72,4228,4228,4188,4215,4190
44947,505,1485,0,44947,43647,1300,3.88384e+16,295.112,5015.27,44947,245,26,43462,42513,34117,35235,19812
31982,1,12,31069,913,31968,14,1.38925e+14,10.2333,505.473,31982,12,11,8188,8188,8188,8188,8188
42497,7673,9934,0,42497,14942,27555,2.53141e+15,60.0504,12849.9,42497,4836,72,32563,32563,29325,29992,25518
2162,26,72,2130,32,2162,0,6.42106e+18,68.0805,387.775,2162,65,58,1208,494,594,689,810
40826,1794,12390,40826,0,38456,2370,3.7293e+18,291.935,14445.4,40826,4436,133,28436,27955,15840,20246,4883
37497,6839,13555,14037,23460,0,37497,8.24383e+12,50.5068,15827.5,37497,6598,72,23942,23942,14768,22361,3609
26165,3360,10529,26165,0,24823,1342,3.78239e+18,199.013,11773.5,26165,4244,125,15636,15418,8874,11643,4816
18558,3351,4345,6521,12037,0,18558,9.88447e+12,59.9217,5848.05,18558,2111,72,14213,14213,12753,13961,11122
40945,9091,12898,38815,2130,38815,2130,6.90891e+18,96.5544,15807.8,40945,6254,110,28047,28047,26373,26110,19870
47301,287,2221,0,47301,45898,1403,4.6905e+16,318.956,7233.19,47301,393,26,44582,43249,37290,28875,11580
42447,1380,17514,42447,0,40355,2092,4.62045e+18,443.941,19360.6,42447,5522,137,24933,23987,11435,16339,2931
4515,92,176,4515,0,4515,0,5.99379e+18,154.136,824.225,4515,96,96,3830,2589,2280,2354,2279
5833,151,174,0,5833,5629,204,1.1501e+16,7.89748,945.811,5833,51,10,5659,5659,5616,5650,5492
38925,1032,1544,0,38925,37789,1136,4.18258e+16,286.795,5032.38,38925,255,26,37381,37381,36137,35880,29740
24854,245,1053,24854,0,23819,1035,2.47316e+18,16.9859,1659.94,24854,879,19,23801,23801,23159,23801,10982
30609,112,7945,10899,19710,0,30609,9.56255e+12,59.5885,10114.5,30609,3867,72,22664,22472,12751,20955,693
34809,16811,18444,33559,1250,33559,1250,2.38722e+18,93.1044,20359,34809,8960,110,16365,16365,15757,16234,15435
35593,5874,12836,33863,1730,33863,1730,3.04469e+18,95.4616,15309.4,35593,6212,110,22757,22757,14790,18013,11692
41536,10836,18838,16209,25327,0,41536,7.04711e+12,55.8935,21015.4,41536,9157,72,22698,22698,19299,21988,13706
42441,14367,22229,17095,25346,0,42441,6.15631e+12,55.4565,24209.2,42441,10828,72,20212,20212,17262,19592,12424
39247,8989,9427,36966,2281,36966,2281,1.15829e+18,98.1729,12397.9,39247,4478,111,29820,29820,29820,29820,28885
18181,6,14,17658,523,18111,70,1.47186e+14,10.5643,412.075,18181,13,12,17260,16738,15132,13481,10901
38700,1,15,37570,1130,38642,58,1.66965e+14,10.4019,657.24,38700,13,11,7862,7862,7862,7862,7862
10893,2545,2991,0,10893,3905,6988,2.405e+15,59.0388,3946.7,10893,1448,72,7902,7902,7761,7525,7659
43123,123,176,43042,81,43123,0,5.97929e+18,172.193,2461.58,43123,173,172,40726,37242,29768,30015,29797
21181,1136,4952,7445,13736,0,21181,9.88341e+12,59.9014,6618.72,21181,2398,72,16229,16229,8125,14053,4037
16996,1697,7581,0,16996,0,16996,4.71548e+17,92.2702,8849.76,16996,3668,110,9415,9415,5747,2705,1832
47491,9184,17110,17770,29721,0,47491,8.25549e+12,58.0666,19865.6,47491,8335,72,30381,30381,24663,29183,15103
19700,9,11,19140,560,19691,9,1.38794e+14,10.2366,392.823,19700,11,11,19433,19133,15485,15596,16834
15666,619,5357,0,15666,5793,9873,2.17877e+15,57.7505,6527.07,15666,2589,72,10309,10261,6580,4652,2195
8428,169,176,8422,6,8428,0,6.00202e+18,164.786,1110.47,8428,117,124,8237,8141,7945,7975,7917
46631,154,176,46564,67,46631,0,6.08356e+18,173.639,2669.54,46631,171,172,45938,44929,40707,40822,40597
17475,160,176,17471,4,17475,0,5.99377e+18,170.173,1593.79,17475,153,149,17155,16808,15772,15876,15779
39596,7920,9244,0,39596,0,39596,6.49372e+17,97.8554,12336.9,39596,4484,110,30352,30352,28550,26927,26618
1260,673,818,1220,40,1220,40,2.22199e+18,42.6683,954.822,1260,376,38,442,442,442,442,442
4170,531,1009,1461,2709,0,4170,1.00459e+13,58.8909,1490.79,4170,490,68,3161,3161,2579,3038,1786
19674,3220,6102,19674,0,18524,1150,3.1835e+18,149.237,7317.36,19674,2312,129,13572,13481,10881,11622,7444
20827,1341,7196,19787,1040,0,20827,1.91165e+18,95.7714,8864.57,20827,3481,110,13631,13631,8598,7562,2855
24498,5700,5910,23088,1410,23088,1410,3.35135e+18,97.4641,8023.32,24498,2849,110,18588,18588,18234,18398,18261
45801,9949,10650,0,45801,0,45801,6.48897e+17,97.931,14129.8,45801,5168,110,35151,35151,34361,33642,33392
39151,17208,18121,15343,23808,0,39151,6.94117e+12,55.1496,20166.5,39151,8811,72,21030,21030,21030,21030,21030
14870,5997,7291,14290,580,14290,580,9.46033e+18,87.837,8372.94,14870,3510,110,7579,7579,7531,7523,7525
14208,795,6002,13577,631,13577,631,3.47644e+18,94.8427,7132.8,14208,2861,111,8206,7886,3931,5180,2808
49808,484,1314,0,49808,48388,1420,3.55601e+16,266.179,4643.04,49808,211,26,48494,47752,42526,42974,24752
49591,960,15581,0,49591,0,49591,5.79667e+17,96.5973,18969.7,49591,7560,110,34010,34010,20404,6643,4267
39946,254,9315,37616,2330,0,39946,2.23095e+18,97.8943,12432.7,39946,4518,110,30631,30631,8909,7000,2770
33135,1541,9933,0,33135,12038,21097,2.31823e+15,58.9849,12143.6,33135,4839,72,23202,23202,13737,5774,2220
29396,7,14,28561,835,29315,81,1.38985e+14,10.7218,526.765,29396,13,12,28361,27752,21473,21621,18852
39726,16599,19293,38167,1559,38167,1559,9.44456e+18,93.866,21562.2,39726,9377,110,20433,20433,19896,19808,18106
49845,1483,15666,18243,31602,0,49845,8.84808e+12,58.7928,18700.2,49845,7632,72,34179,34179,21227,31951,5475
21933,2647,5113,7710,14223,0,21933,9.91212e+12,59.9751,6827.36,21933,2487,72,16820,16820,13795,16189,8832
12955,852,4325,12955,0,12215,740,4.15e+18,110.826,5229.31,12955,1664,118,8630,8610,4764,6231,1655
35320,8124,9145,0,35320,0,35320,6.27151e+17,97.3618,11900.3,35320,4430,110,26175,26175,25243,23900,24003
30140,656,13261,30140,0,23221,6919,4.70116e+18,299.628,14649.8,30140,5650,131,16879,15749,6187,10837,1819
40467,1040,9512,38117,2350,0,40467,2.22515e+18,97.8117,12658,40467,4605,110,30955,30955,11917,10484,5262
38197,4002,10615,36098,2099,0,38197,2.10172e+18,96.9613,13484.7,38197,5135,110,27582,27582,18188,17108,10487
31104,832,1047,0,31104,30211,893,3.7062e+16,215.563,3374.65,31104,158,26,30057,30057,29530,29522,26460
23413,4712,6008,0,23413,0,23413,6.30728e+17,97.2781,8017.37,23413,2903,110,17405,17405,15645,14191,13752
41360,34,208,41298,62,41360,0,6.0641e+18,193.011,2683.79,41360,173,177,22662,7151,7308,8407,6321
25936,96,176,25862,74,25936,0,5.97762e+18,169.599,1909.44,25936,163,161,22841,14240,12949,13944,14174
48497,668,14955,45947,2550,45947,2550,6.84358e+18,96.6245,18304.1,48497,7259,110,33542,33288,25222,19395,4256
45528,12,15,44211,1317,45450,78,1.55625e+14,10.4097,695.207,45528,13,13,45512,45507,44487,44487,40559
2972,752,921,0,2972,0,2972,5.9935e+17,87.2291,1343.1,2972,416,65,2051,2051,1872,1961,1832
19489,3155,8595,18649,840,18649,840,5.34953e+18,93.5382,9985.71,19489,4126,111,10894,10894,8338,7965,4778
40086,6670,9971,37796,2290,37796,2290,5.95673e+18,97.6103,13045,40086,4830,110,30115,30115,28139,27818,20360
16670,4322,5543,16670,0,15700,970,3.9334e+18,131.512,6507.92,16670,2005,120,11127,11127,9916,10449,9228
34499,1524,8059,12123,22376,0,34499,9.87937e+12,60.0189,10520,34499,3915,72,26440,26440,12076,22560,5467
7168,199,284,580,6588,7071,97,4.74487e+15,7.49275,1167.26,7168,122,32,6884,6884,6843,6826,6476
28912,946,1038,0,28912,28082,830,3.77211e+16,212.358,3279.39,28912,156,26,27874,27874,27616,27605,26060
12922,695,790,0,12922,12545,377,4.2542e+16,110.316,2078.9,12922,106,26,12132,12122,11983,11979,11205
49839,1369,17421,18544,31295,0,49839,8.38634e+12,58.2109,20326.4,49839,8478,72,32418,32418,16759,26768,3894
5323,34,1891,5056,267,5056,267,7.2643e+18,93.7253,2498.11,5323,893,83,1615,236,783,1259,416
30977,4212,11238,30977,0,29277,1700,3.83367e+18,226.756,12660.8,30977,4380,126,19739,19672,12185,15502,7920
7543,1,11,7327,216,7539,4,1.38181e+14,10.5489,243.945,7543,11,11,1946,1946,1946,1946,1946
17180,6354,6774,6529,10651,0,17180,7.8432e+12,57.3143,7950.86,17180,3299,72,10406,10406,10010,10323,9532
38727,9655,10427,38727,0,38727,0,2.5959e+18,4061.14,14653.1,38727,7383,27,28300,28018,27601,27358,26170
30884,286,13771,29572,1312,29572,1312,8.19448e+18,93.2113,15721.2,30884,6613,111,17113,16161,5103,7721,1772
21239,4808,5993,20079,1160,0,21239,2.0939e+18,96.8147,7810.93,21239,2892,110,15246,15246,14235,13826,12846
36012,2,176,35945,67,36012,0,5.98934e+18,171.277,2269.59,36012,170,169,1784,52,34,53,206
46361,7044,13646,0,46361,16795,29566,2.32906e+15,59.0945,16574.8,46361,6644,72,32715,32715,25689,16992,17252
24253,6798,6851,19695,4558,22917,1336,4.16922e+18,97.4346,8824.71,24253,3250,111,17402,17402,17402,17402,17386
44398,7811,10364,15611,28787,0,44398,9.89529e+12,60.0706,13387.6,44398,5047,72,34034,34034,30991,33394,26004
30799,5042,13567,29489,1310,29489,1310,2.76911e+18,94.4504,15562.8,30799,6578,110,17232,17146,10169,13121,7167
33336,10980,14757,0,33336,12947,20389,1.83912e+15,55.6355,16613.6,33336,7167,72,18579,18579,16131,13035,13357
6453,3,10,6271,182,6447,6,1.37837e+14,9.89865,221.72,6453,10,10,4901,3437,4329,4258,2816
17165,1609,4182,16169,996,16169,996,5.38206e+18,97.7325,5764.1,17165,1964,111,12983,12983,8093,9372,5608
47123,9,16,45741,1382,47057,66,1.71013e+14,10.3916,746.955,47123,13,12,46633,46114,38845,38734,34147
44786,22217,23415,0,44786,0,44786,4.03683e+17,93.2818,25767.5,44786,11383,110,21371,21371,20964,20403,20604
49013,9,15,47615,1398,48926,87,1.39471e+14,10.561,700.791,49013,14,12,48343,47660,45354,44452,40341
21458,4614,9008,8244,13214,0,21458,7.51941e+12,56.9916,10359.8,21458,4388,72,12450,12450,9825,12000,6855
16126,2893,4980,5877,10249,0,16126,8.95268e+12,58.4238,6220.28,16126,2422,72,11146,11146,8924,10678,5340
47044,4161,14153,47044,0,44306,2738,4.60907e+18,327.543,16443.5,47044,3121,137,32891,32676,18505,23968,10636
3183,2,10,3093,90,3183,0,1.38306e+14,9.84009,155.745,3183,10,10,1834,1292,1254,1351,1077
37589,4985,11135,35579,2010,0,37589,2.04776e+18,96.8475,13915.6,37589,5398,110,26454,26454,20743,19577,14089
42407,151,176,42322,85,42407,0,6.01254e+18,172.51,2495.71,42407,172,172,41611,40446,36563,36370,36361
36555,1684,8571,0,36555,12860,23695,2.53349e+15,60.021,11144.2,36555,4175,72,27984,27984,17978,13399,5779
2615,114,1261,2505,110,2505,110,2.60954e+18,67.483,1573.39,2615,592,56,1354,616,602,888,498
38336,4,11,35141,3195,38080,256,1.17096e+14,7.6286,490.489,38336,11,9,30771,28175,19028,25400,21134
30061,454,948,0,30061,29204,857,3.55866e+16,186.046,3048.38,30061,138,26,29113,28811,26561,26680,18036
11377,1814,2746,10709,668,10709,668,3.81613e+18,97.5853,3917.67,11377,1293,111,8631,8631,7672,8562,6270
21745,161,208,21732,13,21745,0,6.11846e+18,200.685,1967.76,21745,152,155,21006,19921,16887,17166,16954
15107,1708,3604,14227,880,14227,880,3.38388e+18,97.2347,5072.2,15107,1728,110,11503,11503,7743,9445,6196
47352,240,1423,0,47352,45996,1356,3.74273e+16,273.492,4899.66,47352,233,26,45629,45056,32809,31406,15692
37674,64,208,37591,83,37674,0,6.02133e+18,202.094,2509.65,37674,177,174,27383,15588,10960,12977,11569
24612,441,889,0,24612,23906,706,3.65646e+16,161.817,2726.15,24612,126,26,23723,23490,19873,20335,15549
14994,198,3580,14124,870,0,14994,2.22397e+18,97.2042,5043.51,14994,1712,110,11414,11345,3564,3038,1397
16652,37,175,16649,3,16652,0,5.98405e+18,165.576,1528.46,16652,150,149,9196,2865,3047,3802,3487
28341,16,176,28330,11,28341,0,5.99793e+18,169.946,2010.51,28341,160,164,9714,1634,2112,2474,2600
3532,2,11,3429,103,3530,2,1.88792e+14,9.71518,174.098,3532,11,11,2159,1750,1145,1763,1317
44517,10497,10620,41919,2598,41919,2598,3.65445e+18,98.3803,13920.4,44517,5030,111,33897,33897,33789,33888,33768
22637,614,10350,0,22637,8847,13790,1.7928e+15,56.3586,11689.9,22637,5030,72,12287,11951,6952,6453,658
30730,4,14,29846,884,30653,77,1.50346e+14,10.5202,543.36,30730,13,12,26792,23926,23097,19747,12747
26348,351,1340,0,26348,25572,776,4.54449e+16,273.458,4085.16,26348,217,26,24930,24234,21521,19443,11561
42196,9,17,40950,1246,42098,98,1.76973e+14,10.4176,706.699,42196,14,13,41779,41366,34272,34159,31454
38798,7517,17098,15063,23735,0,38798,7.21599e+12,56.3061,19195,38798,8324,72,21700,21700,15470,20631,8081
47573,7,14,43635,3938,47313,260,1.16323e+14,8.00046,573.055,47573,14,9,46738,45168,43665,43666,42642
6828,63,2288,6471,357,0,6828,1.97834e+18,94.714,3028.16,6828,1096,101,3120,900,2559,2221,555
12858,1407,5080,0,12858,4871,7987,2.00086e+15,57.0592,6025.2,12858,2452,72,7778,7778,4978,4143,1776
6354,1487,1620,0,6354,0,6354,6.3654e+17,95.5929,2386.18,6354,758,93,4734,4734,4600,4662,4605
15898,622,6046,15138,760,15138,760,7.52005e+18,95.7061,7337.54,15898,2889,111,9852,9591,3557,5587,2262
18538,1089,1212,0,18538,17983,555,5.02125e+16,186.906,3475.74,18538,191,26,17326,17326,16979,16964,14849
14493,3206,5603,0,14493,5478,9015,2.03264e+15,57.3863,6646.14,14493,2725,72,8890,8890,7491,7267,5302
48258,7618,10923,48258,0,48258,0,2.51606e+18,4556.01,16396.6,48258,7385,27,37335,24617,29344,25671,27682
15364,3469,5115,15364,0,14464,900,3.25795e+18,125.468,6032.33,15364,1850,121,10249,10206,8435,9118,7499
21403,4,14,20780,623,21328,75,1.56355e+14,10.7753,470.365,21403,14,12,18804,16857,15929,14722,9759
24751,1322,1362,0,24751,24019,732,4.72417e+16,273.401,4100.22,24751,218,26,23389,23389,23319,23312,23061
15558,144,175,15550,8,15558,0,5.97736e+18,165.128,1477.84,15558,146,147,15060,14134,13012,13011,12994
41568,14313,16015,0,41568,15730,25838,2.02929e+15,57.6341,18409,41568,7792,72,25553,25553,23066,19958,20184
21064,122,8707,20114,950,20114,950,4.56671e+18,94.1713,10236.5,21064,4153,111,12357,5641,4028,6984,0
2820,430,768,0,2820,1000,1820,2.46699e+15,57.6674,1119.61,2820,371,60,2052,2052,1574,1051,1180
14046,3344,6107,14046,0,13356,690,5.29593e+18,127.042,6909.94,14046,2468,120,7939,7887,6695,7201,5203
32509,1723,2286,6583,25926,0,32509,5.69037e+13,12.0043,2874.37,32509,1148,20,30223,30223,26711,24728,28619
1756,326,464,0,1756,616,1140,2.47666e+15,56.7511,719.606,1756,214,53,1292,1292,1149,1031,1044
24495,430,846,0,24495,23798,697,3.56273e+16,142.826,2592.6,24495,118,26,23649,23467,19993,20382,15386
21601,6114,9124,20641,960,20641,960,5.05515e+18,92.652,10661.8,21601,4359,111,12477,12477,11712,12477,8482
35916,664,8439,0,35916,12638,23278,2.52319e+15,60.0022,10979.2,35916,4105,72,27477,27477,8806,5697,2326
40039,6138,9352,37709,2330,0,40039,2.22843e+18,97.8353,12475.1,40039,4531,110,30687,30687,27090,25617,21164
25854,879,8418,25854,0,24347,1507,3.93195e+18,167.84,9696.13,25854,2452,129,17436,17271,9146,12062,2278
28614,7625,10334,27224,1390,0,28614,1.86162e+18,94.4791,12422.7,28614,4993,110,18280,18280,16670,16282,15134
29029,859,1879,29029,0,27168,1861,2.59426e+18,17.9802,2541.46,29029,1192,23,27150,27150,26669,26930,16398
36704,9076,12779,34884,1820,34884,1820,3.07908e+18,95.9983,15344.5,36704,6200,110,23925,23925,20299,21673,19206
21586,4654,8586,20596,990,20596,990,2.79215e+18,92.5872,10199.2,21586,4144,110,13000,13000,10768,12376,6950
44962,9234,19341,17378,27584,0,44962,7.35058e+12,56.9519,21741.3,44962,9418,72,25621,25621,20782,24574,13228
40966,5154,16835,39974,992,38926,2040,4.56892e+18,406.2,18580.1,40966,4581,140,24131,23771,14850,17941,8941
19148,955,8055,7352,11796,0,19148,7.48084e+12,56.8836,9293.46,19148,3912,72,11093,11045,6899,9374,3032
38136,28,82,37983,153,38136,0,2.39902e+18,81.6063,1662.55,38136,82,82,23034,12893,11420,12357,13976
41873,15063,18973,41873,0,40143,1730,4.72098e+18,1879.98,21553.1,41873,6150,144,22900,21463,20922,22022,18233
41216,14140,17359,39403,1813,39403,1813,2.77647e+18,94.8672,19922.4,41216,8435,110,23857,23857,20756,21906,20075
26657,4659,8856,25289,1368,25289,1368,1.60918e+18,95.9081,10863.6,26657,4226,111,17801,17801,17668,17677,9953
20042,27,206,19971,71,20042,0,5.98631e+18,186.187,1750.1,20042,154,162,9340,2181,2689,2912,2675
13774,5531,6374,13774,0,11225,2549,4.44957e+18,140.352,7161.16,13774,2675,121,7400,7400,6819,7110,6345
2592,71,1107,994,1598,0,2592,7.64537e+12,55.1532,1386.84,2592,534,62,1485,977,851,1219,171
18764,2425,8077,18764,0,12815,5949,4.08154e+18,150.465,9051.88,18764,3300,121,10687,10547,5816,8121,3122
3675,1018,1411,2508,1167,3495,180,3.07499e+18,92.7853,1858.35,3675,651,73,2264,2264,1873,2235,1464
16793,6761,9970,0,16793,6966,9827,1.34644e+15,54.1686,10828,16793,4847,72,6823,6775,6587,6442,6498
39909,2,12,38770,1139,39897,12,1.38802e+14,10.2415,565.218,39909,12,11,23098,16348,15752,16484,13583
8840,6584,6963,8690,150,8690,150,1.37968e+19,26.7245,7357.8,8840,3368,69,1877,1877,1877,1877,1877
31612,6673,7421,0,31612,0,31612,6.4789e+17,97.7561,10012.8,31612,3593,110,24191,24191,23196,22880,22304
27496,7341,9192,10151,17345,0,27496,8.60168e+12,58.36,11021.4,27496,4469,72,18304,18304,16874,18001,14607
14079,1,12,13655,424,14068,11,1.94008e+14,8.74167,354.623,14079,11,11,2143,2143,2143,2143,2143
31490,4249,11247,0,31490,0,31490,5.44363e+17,95.817,13505.6,31490,5455,110,20243,20243,15373,11834,9899
43709,14172,18456,43709,0,41599,2110,4.56296e+18,490.594,20359.9,43709,5014,141,25253,25194,23308,24795,20795
26803,6562,17362,0,26803,5778,21025,5.71898e+15,5.52386,19935.7,26803,5788,13,9441,9441,7620,7926,4325
25454,33,61,25390,64,25454,0,2.25219e+18,60.7126,1187.93,25454,61,61,19656,8142,13275,14208,13814
36537,4482,8516,12837,23700,0,36537,9.89383e+12,60.0524,11096.4,36537,4143,72,28021,28021,23175,27011,15096
17044,5246,7952,17044,0,16284,760,4.33515e+18,177.251,8944.29,17044,3504,123,9092,9072,7947,8530,7401
19060,3668,5150,6825,12235,0,19060,9.44568e+12,59.3567,6626.21,19060,2504,72,13910,13910,11830,13550,9457
35238,70,98,35112,126,35238,0,3.87003e+18,97.2383,1640.43,35238,98,98,32967,29638,27296,26556,26584
28405,3317,8772,28405,0,26755,1650,5.54632e+18,177.381,10331.5,28405,3064,129,19633,19436,15585,17952,8078
34318,6503,8762,32371,1947,0,34318,2.1691e+18,97.4742,11463.3,34318,4250,110,25556,25556,23068,22061,19092
21482,8,12,20870,612,21475,7,1.3927e+14,10.3745,414.688,21482,12,11,20981,20549,16170,16255,16802
22779,5,12,22131,648,22772,7,1.38705e+14,10.3019,426.008,22779,12,11,20907,18622,18503,18041,14309
3024,96,170,3024,0,3024,0,5.95047e+18,144.273,647.846,3024,87,81,2588,1638,1592,1670,1656
16735,5196,5550,16735,0,15755,980,4.61036e+18,133.985,6519.04,16735,2011,121,11185,11185,10988,11095,10795
25968,994,1658,25968,0,24911,1057,2.57847e+18,17.948,2283.98,25968,1068,23,24310,24310,24128,24210,17796
18903,4695,8286,18083,820,18083,820,5.37726e+18,94.8852,9649.11,18903,3973,111,10617,10617,8929,9384,7079
25964,77,176,25913,51,25964,0,6.06332e+18,171.002,1990.19,25964,156,159,21057,13955,10670,11316,11338
14888,1,6,14642,246,14856,32,9.82364e+13,3.99644,244.204,14888,5,4,6066,6066,6066,6066,6066
28119,3764,6631,26484,1635,26484,1635,5.89437e+18,97.6625,8992.66,28119,3211,110,21488,21488,20778,20778,13073
41010,12,13,39836,1174,40993,17,1.44856e+14,10.1942,583.434,41010,12,12,40997,40997,40678,40679,40209
26747,2714,11414,0,26747,0,26747,4.86224e+17,94.6026,13236.4,26747,5538,110,15333,15333,9438,5106,2984
35642,69,176,35562,80,35642,0,5.98284e+18,169.759,2236.19,35642,171,167,26625,14720,12322,14631,13868
41871,9622,9764,39431,2440,0,41871,2.2296e+18,97.8723,12999.9,41871,4733,110,32107,32107,31953,31949,31944
38321,4384,8959,36088,2233,0,38321,2.23041e+18,97.8313,11970.8,38321,4342,110,29362,29362,24187,22077,15516
48543,8012,24184,19341,29202,0,48543,6.47302e+12,55.4598,26490,48543,11775,72,24359,24359,16918,22100,8750
31101,10443,10711,0,31101,0,31101,5.54755e+17,95.9919,12982.2,31101,5194,110,20390,20390,20048,19741,19881
7268,305,1785,6839,429,6839,429,3.21979e+18,96.9121,2627.07,7268,836,100,5483,5483,2879,3606,1438
32437,10850,11919,30877,1560,30877,1560,7.86036e+18,95.6647,14200.7,32437,5780,110,20518,20518,20438,20438,19882
29017,4632,7869,10399,18618,0,29017,9.42372e+12,59.4238,9923.22,29017,3833,72,21148,21148,17439,20508,13060
9124,172,175,9123,1,9124,0,5.96786e+18,161.411,1133.82,9124,122,125,8948,8946,8836,8824,8843
6890,144,176,6886,4,6890,0,6.0469e+18,160.588,1008.71,6890,109,114,6589,6214,5630,5643,5551
18851,3,12,18288,563,18833,18,1.85435e+14,10.0477,412.727,18851,12,11,14719,11631,8183,9849,7111
3018,97,1258,1153,1865,0,3018,7.69167e+12,55.5126,1573.6,3018,607,67,1760,1582,1029,1632,335
19359,154,176,19355,4,19359,0,5.99985e+18,170.093,1680.04,19359,147,157,18953,18446,16991,17057,16889
45588,3309,25971,44081,1507,44081,1507,2.40204e+18,93.0798,28133.4,45588,12556,111,19617,19617,13816,19218,3732
25611,164,176,25596,15,25611,0,5.98481e+18,169.578,1897.64,25611,158,163,25319,24987,23969,23943,24097
34261,17310,18752,0,34261,13942,20319,1.49756e+15,54.9685,20359.6,34261,9119,72,15509,15509,14510,13115,13017
32442,47,176,32414,28,32442,0,6.08978e+18,172.773,2230.12,32442,165,164,21328,8869,7910,9007,8466
5560,121,1548,5243,317,5243,317,4.88219e+18,95.6558,2220.29,5560,713,89,4012,1868,1991,2645,640
45135,5333,10588,42515,2620,42515,2620,5.8941e+18,97.8483,14018.8,45135,5126,110,34547,34547,33227,33227,18583
12773,3348,12773,12773,0,12773,0,3.4357e+10,0,12773,12773,12773,1,0,0,0,0,0
40698,2,15,39509,1189,40607,91,1.6511e+14,10.4731,665.976,40698,13,13,23951,18205,14240,18347,12261
3106,288,845,0,3106,1098,2008,2.39219e+15,57.1594,1224.54,3106,398,61,2261,2261,1474,550,666
28135,9583,13705,27035,1100,27035,1100,2.61276e+18,93.3324,15449.9,28135,6658,110,14430,14430,11837,12698,11432
20611,1352,5911,19491,1120,0,20611,2.08016e+18,94.4141,7681.4,20611,2852,110,14700,14700,9607,8577,3531
15410,3792,5892,0,15410,0,15410,5.27288e+17,93.2299,7167.2,15410,2835,110,9518,9518,8033,7035,6645
45467,59,98,45299,168,45467,0,3.87118e+18,97.3942,1863.32,45467,98,98,40761,31048,30199,27769,30435
8712,222,367,0,8712,8462,250,3.53837e+16,20.0336,1050.15,8712,58,26,8345,8345,7982,8022,5667
36903,10543,11965,13567,23336,0,36903,8.74078e+12,58.612,14308.7,36903,5828,72,24938,24938,23467,24678,21847
39070,7850,9082,0,39070,13731,25339,2.53736e+15,60.0659,11807.4,39070,4424,72,29988,29988,28166,25927,26103
37460,10959,12094,37460,0,35287,2173,3.50261e+18,265.086,13748.2,37460,4493,128,25366,25366,24583,24938,23737
40860,10579,13102,40860,0,38482,2378,5.03508e+18,289.232,14863.8,40860,3977,133,27758,27758,26327,27392,23426
3638,395,930,0,3638,0,3638,6.42593e+17,94.0998,1443.73,3638,427,77,2708,2708,1966,1865,1427
28718,3194,8824,27206,1512,0,28718,2.01866e+18,95.6985,11051.3,28718,4259,110,19894,19894,13386,12769,7917
47237,15054,30599,41867,5370,41867,5370,7.54068e+17,6.52658,35111.1,47237,10209,14,16638,16638,13806,13515,8732
32854,15,1286,0,32854,31900,954,4.05075e+16,262.365,4113.94,32854,202,26,29766,27352,17791,18746,4152
29082,120,206,29008,74,29082,0,5.98271e+18,186.03,2101.67,29082,169,172,26910,24390,16281,16988,16698
47266,10049,19163,45116,2150,45116,2150,3.13836e+18,93.9446,22016.8,47266,9204,111,28103,28103,23411,27812,16698
23653,134,176,23642,11,23653,0,6.03206e+18,171.412,1883.35,23653,160,157,22708,21290,17744,18098,18065
13500,1168,4082,0,13500,0,13500,5.9366e+17,89.8619,5351.64,13500,1947,110,9418,9418,4596,3617,1766
25102,46,175,25029,73,25102,0,5.9779e+18,166.743,1873.92,25102,157,162,15394,7162,5523,6792,6624
49892,9427,11648,46984,2908,0,49892,2.22959e+18,97.9446,15366.1,49892,5656,110,38244,38244,35795,34734,31896
39766,532,1996,0,39766,38582,1184,4.7923e+16,322.312,6376.14,39766,345,26,37770,36206,29256,30857,12997
30660,684,1173,0,30660,29776,884,3.95518e+16,256.732,3725.9,30660,183,26,29487,28911,27867,27934,21284
26540,7057,8068,25132,1408,0,26540,2.02896e+18,96.6044,10170.4,26540,3908,110,18472,18472,17769,17636,17288
41493,1386,2121,0,41493,40259,1234,4.86219e+16,317.472,6782.23,41493,370,26,39372,39372,37426,37861,29820
30167,5025,15356,0,30167,12080,18087,1.62511e+15,55.6549,16905.4,30167,7480,72,14811,14811,10316,6374,5304
47520,16151,26085,47520,0,0,47520,8.91976e+17,17.8944,26676.4,47520,23461,20,21435,21435,13237,19450,13035
39669,3371,13855,39669,0,37460,2209,4.93236e+18,274.17,15553.4,39669,3864,134,25814,25333,14790,19180,7516
2664,132,170,2664,0,2664,0,5.97689e+18,138.868,606.659,2664,83,76,2438,2317,2018,2044,1994
44846,116,1642,0,44846,43543,1303,4.08427e+16,297.829,5475.58,44846,277,26,42384,42003,34856,30614,7353
19601,114,176,19587,14,19601,0,6.02691e+18,170.683,1703.75,19601,148,154,18117,16012,12191,12457,12672
46706,5426,12713,44126,2580,44126,2580,6.4628e+18,97.2684,16101.2,46706,6164,110,33993,33993,32433,32433,15115
14674,3978,6133,0,14674,0,14674,4.93102e+17,94.2888,7312.08,14674,2954,110,8541,8541,7448,6221,5905
47325,15181,27235,0,47325,0,47325,3.5987e+17,92.4735,29478.5,47325,13244,110,20090,20090,16280,14267,12098
47489,4012,19735,45379,2110,0,47489,1.70133e+18,95.035,22621.2,47489,9595,110,27754,27754,15114,12439,6110
43814,663,1366,0,43814,42558,1256,3.76636e+16,275.128,4643.53,43814,222,26,42448,41642,39451,38699,26761
41178,16,61,41082,96,41178,0,2.2697e+18,60.8263,1501.51,41178,61,61,19048,1734,5242,6518,10301
1608,83,121,0,1608,1562,46,4.13166e+16,18.3047,312.917,1608,33,25,1487,1487,1436,1434,1339
6530,199,454,0,6530,6338,192,4.20318e+16,19.5545,1132.5,6530,65,26,6076,6076,5192,5333,3263
17449,5,12,16941,508,17436,13,1.63168e+14,10.5213,391.935,17449,12,11,16136,14553,12210,12029,9680
42287,1301,1366,0,42287,41071,1216,3.81222e+16,268.986,4599.85,42287,222,26,40921,40921,40745,40728,39690
39787,6702,17258,0,39787,0,39787,4.79342e+17,94.6215,19710.3,39787,8382,110,22529,22529,16794,14243,9303
43158,891,1192,0,43158,41929,1229,3.55864e+16,248.219,4112.38,43158,186,26,41966,41966,40824,40871,35710
18920,3409,4474,0,18920,0,18920,6.47167e+17,97.4185,6220.7,18920,2150,110,14446,14446,13244,13506,11566
16073,3234,3815,15133,940,0,16073,2.23149e+18,97.2795,5352.95,16073,1839,110,12258,12258,11483,11348,10843
19885,500,792,0,19885,19316,569,3.65488e+16,105.509,2299.57,19885,107,26,19093,18976,16906,17167,13462
46281,10151,11877,16460,29821,0,46281,9.5785e+12,59.7007,14932.2,46281,5781,72,34404,34404,32369,34054,30058
21345,559,5113,20105,1240,0,21345,2.21962e+18,97.4959,7017.06,21345,2472,110,16232,16232,10164,9079,2826
3530,1763,1962,0,3530,0,3530,3.99385e+17,66.4187,2308.17,3530,931,67,1568,1568,1423,1413,1412
43060,14019,16924,41060,2000,41060,2000,2.83642e+18,95.816,19621.5,43060,8122,111,26136,26136,24192,26019,21865
25516,5131,5974,24027,1489,0,25516,2.23146e+18,97.671,8168.6,25516,2886,110,19542,19542,18405,18247,17337
8331,3389,3896,7991,340,0,8331,1.57375e+18,92.8731,4628.6,8331,1866,100,4435,4435,4233,4167,4293
28187,203,6600,0,28187,9913,18274,2.52983e+15,60.0032,8691.56,28187,3210,72,21587,21587,5799,1393,1018
25663,3424,7322,24263,1400,0,25663,2.08496e+18,96.9054,9412.53,25663,3548,110,18341,18341,14622,13353,9253
7187,2501,4054,1544,5643,0,7187,53392600000,8.95617,4209.23,7187,3642,11,3133,3133,2264,3133,2248
44451,9797,13466,16178,28273,0,44451,8.97942e+12,55.3182,16271.5,44451,6546,72,30985,30985,26312,30176,20712
37107,3681,8684,34942,2165,34942,2165,5.91673e+18,97.834,11619.8,37107,4211,110,28423,28423,27166,27166,13240
24583,830,6678,0,24583,8806,15777,2.40549e+15,59.1774,8481.66,24583,3232,72,17905,17905,11061,7689,2798
33539,1533,12429,31919,1620,31919,1620,4.45023e+18,96.2225,14713.4,33539,5954,111,21110,21110,9563,13120,4771
7272,1536,1757,6847,425,0,7272,2.23727e+18,96.2814,2613.31,7272,831,99,5515,5515,5286,5231,5167
15226,4598,6000,0,15226,5770,9456,1.99909e+15,55.3528,7076.13,15226,2901,72,9226,9226,8269,7111,6840
40513,486,23575,0,40513,16733,23780,1.38184e+15,54.5205,25296.6,40513,11477,72,16938,16362,9985,4366,1697
21178,6161,6570,0,21178,7729,13449,2.27897e+15,58.4799,8106.46,21178,3190,72,14608,14608,14129,13552,13510
17960,2569,4355,16921,1039,16921,1039,5.81451e+18,97.3028,6020.37,17960,2094,110,13605,13605,12633,12478,9013
28796,2836,16561,27864,932,27864,932,2.21603e+18,90.5912,18101,28796,8033,110,12235,12235,8019,8094,3533
14459,1010,4212,0,14459,0,14459,6.03044e+17,96.3295,5559.73,14459,2029,110,10247,10161,5225,4672,3862
5289,1092,2125,5289,0,5009,280,5.65047e+18,90.5727,2581.29,5289,799,96,3164,3164,2734,2974,2371
14273,3730,4460,14273,0,13441,832,3.45427e+18,118.609,5438.63,14273,1520,124,9813,9784,9805,9768,8642
24660,4861,5847,23228,1432,23228,1432,5.90793e+18,97.5884,7978.99,24660,2826,110,18813,18813,18583,18583,16378
1022,55,440,972,50,972,50,3.06838e+18,70.3845,608.765,1022,173,45,391,99,153,247,0
32120,5350,7530,30250,1870,30250,1870,5.89022e+18,97.7909,10155.3,32120,3651,110,24590,24590,24058,24060,18372
10523,5219,6429,10523,0,10183,340,6.04078e+18,154.261,7041.09,10523,2783,108,4094,4094,3769,4085,3658
36284,8417,14693,0,36284,13852,22432,1.96729e+15,57.3086,16781.2,36284,7153,72,21591,21591,21369,21143,21310
10393,8,11,10093,300,10385,8,1.57651e+14,10.0135,293.89,10393,11,11,10172,10063,9165,8788,7640
25565,1693,6952,0,25565,0,25565,6.18265e+17,97.0523,9066.22,25565,3365,110,18613,18613,12225,6146,4472
9916,740,2469,9336,580,9336,580,4.42316e+18,97.225,3518.53,9916,1156,111,7447,7447,4799,5842,2872
21454,1334,6838,20342,1112,20342,1112,3.16202e+18,96.1716,8598.29,21454,3297,110,14616,14616,7459,10543,4298
36528,3042,8761,34398,2130,34398,2130,6.15102e+18,98.2807,11585.4,36528,4138,111,27767,27767,14811,19803,10950
20087,267,853,5858,14229,0,20087,6.92377e+18,15.9839,1380.97,20087,847,17,19234,19234,11669,10933,15735
5293,1347,1516,0,5293,0,5293,6.1167e+17,94.8583,2168.64,5293,707,87,3777,3777,3597,3573,3551
10405,9,11,10110,295,10400,5,1.39236e+14,10.4579,286.445,10405,11,11,10256,10087,9751,9752,9272
19284,2321,9939,18564,720,18564,720,3.56959e+18,91.5329,11184.3,19284,4765,111,9345,9345,6207,6695,3352
45736,7519,19180,45736,0,44144,1592,4.63518e+18,4093.25,23776.7,45736,7650,151,26556,20249,17464,20334,14205
42324,433,9932,39864,2460,0,42324,2.22633e+18,97.8357,13188.7,42324,4811,110,32392,32392,19532,17678,3446
12283,1999,5546,0,12283,4793,7490,1.82308e+15,54.4594,6393.55,12283,2696,72,6737,6737,4330,3946,1853
28552,5,11,27740,812,28542,10,1.39012e+14,10.1491,472.885,28552,11,11,26217,23165,18743,19208,16745
8932,1859,2098,0,8932,3136,5796,2.53144e+15,59.5915,2956.42,8932,1009,72,6834,6834,6569,6327,6284
10796,55,176,10788,8,10796,0,6.01365e+18,163.971,1256.62,10796,128,131,7245,3884,2957,3445,3279
20462,8863,8942,19572,890,19572,890,3.67446e+18,94.9707,10388.7,20462,4288,111,11520,11520,11423,11462,11476
41138,342,2001,0,41138,39916,1222,4.71988e+16,319.514,6424.04,41138,344,26,38947,37565,27083,28003,9969
43282,9390,16011,41211,2071,41211,2071,7.72025e+18,95.6479,18857.7,43282,7775,110,27271,27271,25250,24918,17245
43546,968,12884,41216,2330,0,43546,2.04811e+18,96.5049,16006.4,43546,6251,110,30662,30662,18762,16287,4390
18264,3403,4326,17202,1062,0,18264,2.2278e+18,97.3783,6022.1,18264,2084,110,13938,13938,12891,12515,11461
27729,14,176,27670,59,27729,0,6.09829e+18,173.034,2062.65,27729,154,162,8985,1906,2086,2209,1978
32353,112,1319,0,32353,31415,938,4.13196e+16,270.07,4197.6,32353,212,26,30479,30261,20819,19692,6312
7725,1335,3983,7435,290,0,7725,1.43833e+18,80.4418,4632.88,7725,1899,95,3742,3742,2756,2439,2096
8777,188,2637,8304,473,8304,473,3.98911e+18,96.0865,3552.03,8777,1232,106,6140,5895,2392,3688,1058
26562,5882,7472,25092,1470,25092,1470,3.37139e+18,97.5236,9585.16,26562,3549,111,19090,19090,18038,19021,16745
32104,7900,12389,30601,1503,0,32104,1.79172e+18,95.3208,14596.3,32104,6010,110,19715,19715,17050,15836,12747
42451,1724,9855,0,42451,14923,27528,2.53504e+15,60.09,12776.3,42451,4801,72,32596,32596,20756,9040,6265
48991,7705,12746,46236,2755,0,48991,2.15147e+18,97.4854,16306.7,48991,6188,110,36245,36245,30090,28892,22741
35694,1390,11660,13143,22551,0,35694,8.68417e+12,58.5638,13939.3,35694,5675,72,24034,24034,13017,20261,4989
9805,1426,2731,0,9805,3519,6286,2.39465e+15,58.6839,3612.06,9805,1314,72,7074,7074,5691,5382,3542
19260,3087,4512,6773,12487,0,19260,9.87708e+12,59.8685,6055.99,19260,2189,72,14748,14748,13029,14388,10278
10767,2293,2671,10137,630,10137,630,1.24546e+18,97.302,3786.04,10767,1250,111,8096,8096,8096,8096,7319
16827,1818,6937,16067,760,16067,760,4.25415e+18,95.2002,8234.24,16827,3325,111,9890,9890,6910,7239,3088
16115,5701,7583,0,16115,6336,9779,1.75382e+15,54.8554,8598.72,16115,3672,72,8532,8532,7712,7300,6950
33698,6415,15436,32308,1390,32308,1390,2.71415e+18,92.2014,17524.1,33698,7479,110,18262,18262,9934,12954,7204
8272,2327,2721,7839,433,7839,433,3.53139e+18,95.6006,3569.51,8272,1285,101,5551,5551,5013,5132,5223
40844,1120,1150,0,40844,39680,1164,3.55948e+16,241.341,3929.71,40844,178,26,39694,39694,39627,39624,39424
20748,24,794,0,20748,20154,594,3.61156e+16,113.412,2332.81,20748,107,26,19819,18614,15386,14600,3685
33597,1552,9899,0,33597,0,33597,5.96375e+17,96.8245,12450.6,33597,4792,110,23698,23698,11630,7401,4604
23147,7211,7285,21928,1219,21928,1219,5.28584e+18,96.9088,9123.79,23147,3462,111,15862,15862,15789,15818,15841
40384,939,17560,0,40384,0,40384,4.78682e+17,94.5623,20035.5,40384,8518,110,22824,22084,13262,3982,2466
22035,175,176,22026,9,22035,0,6.02575e+18,170.061,1804.8,22035,150,158,21857,21835,21807,21807,21736
37523,4755,13795,35703,1820,35703,1820,5.28205e+18,96.3407,16295.5,37523,6613,111,23728,23728,18091,17497,8764
3243,149,838,0,3243,0,3243,6.52131e+17,93.6398,1308.44,3243,382,72,2405,2405,964,600,697
14089,6164,6504,14089,0,9478,4611,5.68115e+18,131.768,7294.83,14089,2713,121,7585,7585,7425,7536,7221
25063,97,176,25049,14,25063,0,5.97918e+18,169.483,1877.03,25063,164,159,22163,13805,12756,13517,13743
2785,257,690,981,1804,0,2785,1.01625e+13,58.2072,1046.39,2785,336,60,2095,2095,1371,1893,885
3516,548,1587,3516,0,3346,170,4.77657e+18,75.4411,1940.44,3516,630,77,1929,1929,1488,1636,1312
20564,7636,11140,19834,730,19834,730,9.1141e+18,93.4498,12388.6,20564,5376,111,9424,9337,7222,8226,4704
3295,890,1019,3115,180,3115,180,3.42239e+18,93.3399,1467.83,3295,469,71,2276,2276,2171,2268,2145
32727,7822,10592,32727,0,30817,1910,5.05615e+18,225.783,12095.8,32727,3902,128,22135,22083,20144,21289,17150
41810,1899,2055,0,41810,40568,1242,4.75673e+16,315.1,6595.31,41810,357,26,39755,39755,39542,39523,38434
20704,7013,11698,0,20704,4445,16259,1.36663e+13,8.87684,11966.9,20704,10520,11,9006,9006,6165,6332,6017
7190,195,480,0,7190,6979,211,4.15509e+16,19.0092,1205.49,7190,65,26,6710,6710,5535,5637,3109
29488,34,208,29432,56,29488,0,6.07247e+18,200.509,2270.77,29488,171,166,16033,5136,5195,5926,4760
4707,118,216,0,4707,4571,136,3.59752e+16,19.8723,629.58,4707,44,26,4491,4491,3915,3970,2911
48938,1640,1771,0,48938,47518,1420,4.10527e+16,269.408,5955.62,48938,303,26,47167,47167,46793,46776,44487
19108,58,175,19042,66,19108,0,5.98429e+18,166.028,1636.46,19108,149,158,13032,6785,5430,6388,6385
17035,4670,5663,17035,0,16045,990,4.853e+18,134.566,6641.99,17035,2036,121,11372,11372,10690,11061,9853
38637,5,14,37518,1119,38556,81,1.57424e+14,10.4269,639.402,38637,13,12,35713,32194,26862,26512,15172
25829,5664,6007,0,25829,9070,16759,2.5419e+15,60.0121,7956.65,25829,2926,72,19822,19822,19328,19732,18905
24919,787,7834,23617,1302,0,24919,2.00233e+18,96.3685,9814.23,24919,3794,110,17085,17085,8142,5338,2336
23629,102,199,23556,73,23629,0,5.98291e+18,181.738,1885.16,23629,161,166,21021,13091,11622,12487,12747
34962,534,8187,32922,2040,0,34962,2.22961e+18,97.8065,10988.3,34962,3970,110,26775,26775,16365,14018,3394
10321,2967,4120,9841,480,9841,480,3.39154e+18,88.0422,5044.86,10321,1942,111,6201,6201,5526,6167,5185
32505,6673,7593,11427,21078,0,32505,9.88876e+12,59.9961,9937.5,32505,3690,72,24912,24912,23588,24680,22121
6063,650,1533,0,6063,0,6063,6.42567e+17,95.8054,2277.19,6063,722,94,4530,4530,3417,2365,2426
24848,1347,6700,23468,1380,23468,1380,3.33979e+18,97.0869,8777.28,24848,3245,110,18148,18148,9470,13285,5475
18120,142,208,18047,73,18120,0,6.02172e+18,196.366,1741.87,18120,152,150,17207,16007,12632,12806,12571
19748,81,176,19736,12,19748,0,6.00161e+18,169.848,1688.17,19748,151,155,16093,9397,8280,9055,9042
14274,1653,3410,0,14274,0,14274,6.47248e+17,97.1885,4818.78,14274,1636,110,10864,10864,8828,8207,5726
11357,2084,3650,10760,597,10760,597,6.78313e+18,96.2695,4729.21,11357,1733,111,7707,7707,6886,7134,6518
6938,1,2,6721,217,6906,32,0.000144134,0.999712,109.573,6938,2,1,6936,6936,6936,6936,6936
38369,3,14,37264,1105,38350,19,1.51246e+14,10.2238,575.437,38369,13,12,29382,21397,22554,23962,15704
29238,3090,6785,0,29238,10268,18970,2.53801e+15,60.0351,8939.84,29238,3304,72,22453,22453,17418,14546,10619
46847,7992,11414,44157,2690,44157,2690,3.33393e+18,97.7307,14916.6,46847,5536,110,35433,35433,29038,31852,26143
16519,382,3925,15559,960,15559,960,5.75272e+18,97.3432,5498.85,16519,1892,110,12594,12594,9713,7629,2080
23306,1534,13146,9541,13765,0,23306,5.63598e+12,54.7018,14302.8,23306,6399,72,10160,10160,5776,8499,2345
21820,7732,10584,8638,13182,0,21820,6.64265e+12,55.8223,11834,21820,5148,72,11236,11236,10224,11023,8703
9611,3681,3738,9161,450,0,9611,1.80086e+18,94.3633,4636.26,9611,1788,104,5873,5873,5847,5851,5855
20145,971,6189,0,20145,7338,12807,2.28794e+15,58.762,7671.17,20145,3004,72,13956,13956,7187,4990,3178
7625,120,176,7621,4,7625,0,6.06444e+18,162.704,1078.32,7625,110,112,7080,6432,5113,5196,5228
48975,8385,11407,17215,31760,0,48975,9.8839e+12,60.0834,14693.3,48975,5551,72,37568,37568,33949,36808,27967
3262,594,845,3069,193,0,3262,2.25244e+18,93.744,1315.09,3262,390,71,2417,2417,2114,2100,1982
42824,13445,15585,16050,26774,0,42824,8.20994e+12,56.9681,18108.3,42824,7586,72,27239,27239,25713,26919,23329
46967,15674,19097,44848,2119,44848,2119,2.84912e+18,95.1445,21989,46967,9273,110,27870,27870,24419,25772,23281
43529,74,208,43465,64,43529,0,6.03771e+18,203.989,2719.14,43529,182,178,34134,20518,14614,16928,15399
7128,175,176,7122,6,7128,0,6.03044e+18,162.005,1043.45,7128,110,109,6951,6949,6941,6942,6932
8732,39,387,0,8732,8480,252,3.57647e+16,19.9447,1083.63,8732,58,26,8345,8345,6682,6875,1644
23819,96,176,23771,48,23819,0,6.11669e+18,171.208,1910.86,23819,152,149,21096,15711,12615,12936,12821
34412,7003,12550,32739,1673,32739,1673,1.91854e+18,96.3076,14898.2,34412,5998,111,21862,21862,18576,21643,13398
2467,295,612,871,1596,0,2467,1.00962e+13,57.9882,938.615,2467,298,58,1855,1855,1467,1753,1019
35354,4505,18536,7681,27673,0,35354,52780400000,8.9374,18912.9,35354,16674,11,16818,16818,7040,16818,6133
21155,3775,5110,19925,1230,19925,1230,4.96137e+18,97.9686,6968.6,21155,2411,111,16045,16045,15530,16045,12500
22210,12,14,21557,653,22165,45,1.66642e+14,10.4102,477.329,22210,13,11,22196,22195,22117,22117,21828
15416,463,731,0,15416,14972,444,3.76367e+16,56.7266,1989.35,15416,94,26,14685,14643,13634,13840,11422
35046,4275,9740,0,35046,0,35046,6.12977e+17,97.0694,12417.9,35046,4726,110,25306,25306,19265,15090,12099
4066,7,11,3950,116,4064,2,1.49322e+14,10.7241,183.93,4066,11,11,3901,3812,3058,3023,2843
35830,1,12,34809,1021,35817,13,1.38899e+14,10.2417,534.429,35830,11,12,9171,9171,9171,9171,9171
25529,33,176,25517,12,25529,0,5.99306e+18,169.735,1915.89,25529,163,159,13442,3823,4237,5238,4683
36073,3784,9428,25676,10397,34033,2040,3.20888e+18,97.9398,12166.9,36073,4475,111,26645,26645,20868,23783,13026
36704,10773,17480,35241,1463,35241,1463,9.3071e+18,93.3856,19649.9,36704,8478,110,19224,19224,17917,17709,12896
28462,272,918,0,28462,27648,814,3.55832e+16,174.476,2913.01,28462,133,26,27525,27278,23936,24119,12457
18449,2086,4317,0,18449,6490,11959,2.53745e+15,59.9108,5808.36,18449,2103,72,14132,14132,10826,7661,6922
24151,17,176,24074,77,24151,0,6.06271e+18,171.376,1916.57,24151,159,155,8755,1716,2345,2258,2148
24964,3199,10992,24964,0,23796,1168,4.00824e+18,186.011,12298.5,24964,4793,127,13972,13824,8874,10906,5604
47653,99,176,47633,20,47653,0,5.98163e+18,171.848,2586.39,47653,173,172,42544,26632,24798,26155,26785
6889,1308,1937,0,6889,0,6889,6.22042e+17,95.5683,2725.45,6889,925,101,4952,4952,4498,4597,4070
43579,336,10212,41042,2537,0,43579,2.2264e+18,97.889,13548.8,43579,4953,110,33367,33367,9961,7898,3180
31003,6358,9557,11309,19694,0,31003,8.92973e+12,58.8448,11636.5,31003,4655,72,21446,21446,18433,20926,14918
31769,2313,15169,31769,0,30369,1400,4.45724e+18,224.581,16570.9,31769,6086,137,16600,15921,10591,13529,5816
42153,96,176,42082,71,42153,0,6.14756e+18,172.376,2538.2,42153,170,165,37585,28515,22339,22945,22537
29027,81,206,28953,74,29027,0,5.98558e+18,186.999,2088.57,29027,169,167,23657,13419,10588,12332,12049
23254,89,176,23180,74,23254,0,5.97877e+18,169.577,1808.74,23254,156,161,19864,11888,10923,11551,12029
45751,1801,15040,16856,28895,0,45751,8.64999e+12,58.5183,17825.7,45751,7306,72,30711,30711,18552,28621,3755
43730,308,14009,43730,0,41187,2543,3.86978e+18,308.119,15859.7,43730,5226,128,29621,29172,9652,17932,1451
14592,4477,5544,5504,9088,0,14592,8.0314e+12,57.5522,6604.78,14592,2698,72,9048,9048,8387,8908,7478
17970,1,13,17458,512,17902,68,1.38795e+14,10.6344,393.876,17970,12,12,4607,4607,4607,4607,4607
14018,2817,6624,13448,570,0,14018,1.55227e+18,93.5307,7682.98,14018,3208,110,7394,7394,5549,5113,3934
11864,3491,3940,0,11864,0,11864,5.72298e+17,95.5855,5054.45,11864,1895,110,7924,7924,7420,7506,6903
49547,7,11,45425,4122,49291,256,1.16904e+14,7.55075,561.251,49547,11,8,48734,47156,46332,46333,48088
9872,6962,9872,0,9872,9872,0,2047.79,0,9872,9872,9872,1,0,0,0,0,0
39701,4620,12750,14570,25131,0,39701,8.77005e+12,58.6566,15247,39701,6211,72,26951,26951,19541,25671,10594
17882,8152,8303,17150,732,0,17882,1.57026e+18,93.7574,9583.85,17882,4022,110,9579,9579,9398,9413,9399
25605,6045,7347,0,25605,9242,16363,2.35477e+15,59.1285,9174.08,25605,3574,72,18258,18258,16969,15480,15577
30935,6236,30935,30935,0,0,30935,7.99974,0,30935,30935,30935,1,0,0,0,0,0
40469,10208,13997,38457,2012,0,40469,1.90468e+18,96.0058,16775,40469,6796,110,26472,26472,23357,22723,20086
18422,541,9098,0,18422,7320,11102,1.67581e+15,55.2036,10184.6,18422,4410,72,9324,8988,3237,1980,852
27499,305,6638,25899,1600,25899,1600,3.66326e+18,98.1637,8905.25,27499,3133,111,20861,20861,20645,20542,2374
47461,12681,15142,47461,0,44701,2760,4.064e+18,327.627,17105.7,47461,5658,129,32319,32319,30140,31231,28161
14770,674,3518,13910,860,13910,860,5.77114e+18,97.2479,4964.82,14770,1690,110,11252,11252,9377,7939,2925
7719,2386,3624,7399,320,7399,320,9.18532e+18,92.8226,4312.72,7719,1747,93,4095,4095,3965,3965,2938
8475,797,2674,8032,443,0,8475,2.01682e+18,95.2665,3561.26,8475,1278,103,5801,5716,3904,3807,2915
16026,2353,4014,0,16026,0,16026,6.3898e+17,97.1715,5531.61,16026,1933,110,12012,12012,9818,7079,7445
40949,5469,17718,39169,1780,39169,1780,2.21935e+18,92.1088,20182.1,40949,8503,111,23231,23231,17004,14984,6660
11027,3519,4198,11027,0,10438,589,3.8791e+18,116.128,4982.29,11027,1704,121,6829,6807,6639,6750,6670
4837,156,170,4835,2,4837,0,5.97364e+18,153.599,818.682,4837,99,99,4631,4528,4338,4355,4324
41672,1,10,40987,685,41576,96,9.81164e+13,3.9977,561.737,41672,7,4,16998,16998,16998,16998,16998
46444,14437,18483,46444,0,44274,2170,4.73234e+18,1488.84,21212.6,46444,7341,145,27961,26943,24826,26021,20294
12503,1818,4893,11921,582,0,12503,1.78783e+18,90.7467,5976.62,12503,2344,110,7610,7610,4978,5031,2915
16222,1998,5744,14698,1524,15412,810,4.24786e+18,93.5846,7094.74,16222,2725,111,10478,10478,9156,7837,5215
17626,141,176,17555,71,17626,0,5.9891e+18,168.35,1603.98,17626,145,151,17013,15867,14126,14291,14107
3321,577,865,3130,191,3130,191,5.75835e+18,93.5149,1344.55,3321,389,72,2456,2456,2282,2260,1902
18499,5988,9523,0,18499,4030,14469,1.34644e+13,8.98708,9796.42,18499,8562,11,8976,8976,6510,6744,6293
22238,14365,22238,22238,0,22238,0,34358200000,0,22238,22238,22238,1,0,0,0,0,0
47799,7,15,46418,1381,47738,61,1.54014e+14,10.4668,718.372,47799,13,11,46291,45279,42011,39781,30146
23688,1166,5526,0,23688,8320,15368,2.53309e+15,59.9541,7345.5,23688,2686,72,18162,18162,8795,5198,4121
30552,101,176,30541,11,30552,0,5.98155e+18,169.515,2071.02,30552,168,164,27423,17286,16112,17120,17706
42346,1,6,41023,1323,42186,160,0.000118075,0.999858,492.78,42346,6,1,42340,42340,42340,42340,42340
8851,816,4159,8851,0,8434,417,3.81272e+18,112.3,4744.63,8851,1725,107,4692,4569,2700,3625,1860
30447,5288,7159,0,30447,0,30447,6.47094e+17,97.7215,9676.82,30447,3462,110,23288,23288,20809,18639,18058
43677,79,1512,0,43677,42417,1260,3.95816e+16,280.169,5062.03,43677,251,26,41349,41129,28285,26509,8507
12817,280,4549,0,12817,4775,8042,2.13724e+15,53.049,5540.83,12817,2193,72,8268,8220,4649,0,0
40134,1664,1808,0,40134,38949,1185,4.50634e+16,325.104,5836.22,40134,309,26,38326,38326,38195,38178,37546
25455,2418,7485,9227,16228,0,25455,9.11898e+12,58.0779,9290.42,25455,3640,72,17970,17970,9820,15817,4962
14464,3629,4009,5199,9265,0,14464,9.36468e+12,59.1745,5191.04,14464,1951,72,10455,10455,9902,10356,9421
44049,532,1882,12851,31198,0,44049,6.92374e+18,15.9963,2675.53,44049,1029,25,42167,42167,25086,23513,33080
49483,13741,22722,0,49483,19375,30108,1.7838e+15,56.4587,25211.2,49483,11055,72,26761,26761,21825,15036,13596
1275,370,396,0,1275,0,1275,6.11465e+17,86.2745,624.001,1275,160,48,879,879,878,878,878
23432,1,8,23048,384,23368,64,9.81174e+13,3.99684,382.978,23432,6,4,9556,9556,9556,9556,9556
33041,3755,11373,33041,0,31228,1813,4.0623e+18,244.912,13085.7,33041,4638,128,21668,21562,13751,17029,7729
32006,11,176,31989,17,32006,0,5.98672e+18,169.582,2119.28,32006,163,167,8467,1342,1749,1796,1764
28313,131,176,28228,85,28313,0,6.0865e+18,169.551,2080.21,28313,160,158,27115,25373,21155,21304,21165
3860,6,11,3748,112,3859,1,1.42852e+14,10.5412,174.667,3860,11,11,3671,3582,2688,2725,2675
7659,864,2131,7229,430,7229,430,5.0995e+18,92.669,2980.17,7659,997,103,5528,5528,4766,5282,3147
30882,1947,10931,30882,0,29172,1710,3.97372e+18,233.381,12367.1,30882,4206,125,19951,19624,10295,14597,4866
13544,11,14,13140,404,13499,45,1.89617e+14,10.3715,375.667,13544,13,11,13530,13528,13339,13342,12975
15462,3648,7149,14814,648,14814,648,8.17881e+18,94.4334,8285.55,15462,3430,111,8313,8313,6552,6856,5093
19854,775,9063,0,19854,0,19854,4.61614e+17,93.9229,10464.7,19854,4387,110,10791,10202,5270,1599,1340
10357,1462,3121,3750,6607,0,10357,9.04714e+12,58.5937,4014.96,10357,1515,72,7236,7236,5367,6791,2806
49710,5699,11575,0,49710,17474,32236,2.53366e+15,60.0897,14898,49710,5637,72,38135,38135,29633,18883,19303
23953,148,175,23943,10,23953,0,5.97413e+18,166.63,1830.84,23953,155,162,23371,22094,20591,20599,20448
41238,4453,11253,0,41238,14783,26455,2.39701e+15,59.4047,13981,41238,5472,72,29985,29985,21686,22224,11601
24816,2585,7864,0,24816,0,24816,5.78628e+17,96.3264,9836.23,24816,3802,110,16952,16952,12146,8345,6757
6158,8,10,5982,176,6152,6,1.38224e+14,9.88178,216.741,6158,10,10,6007,5936,5653,5653,5096
41633,1,16,40398,1235,41563,70,1.83422e+14,10.3556,714.889,41633,13,12,7160,7160,7160,7160,7160
46839,273,1258,0,46839,45505,1334,3.55727e+16,259.197,4404.39,46839,200,26,45399,44903,32689,32554,16344
39808,2722,9314,13998,25810,0,39808,9.89843e+12,60.0459,12075.6,39808,4536,72,30494,30494,17668,27148,9270
10975,1874,2562,3853,7122,0,10975,9.93044e+12,59.6378,3562.01,10975,1239,72,8413,8413,7600,8242,6394
49137,8919,11492,46277,2860,0,49137,2.22878e+18,97.893,15162.8,49137,5572,110,37645,37645,34719,33627,29954
25300,1466,8192,25300,0,25300,0,4.43854e+15,5539.48,14383,25300,8192,4,3656,0,2930,2930,3656
7131,149,252,0,7131,7007,124,2.55248e+16,3.73075,998.491,7131,128,4,6879,6879,6869,6807,5192
34862,11619,15538,0,34862,13565,21297,1.83137e+15,56.6563,17449,34862,7563,72,19324,19324,17820,17395,15456
49428,3985,18101,0,49428,18532,30896,2.09363e+15,57.4831,20927.7,49428,8802,72,31327,31327,19552,15374,8815
16574,317,684,0,16574,16065,509,4.72589e+15,5.44238,3112.09,16574,177,7,15890,15890,15469,15496,14271
4797,9,10,4663,134,4797,0,1.38244e+14,9.81968,188.781,4797,10,10,4747,4706,4624,4625,4381
14220,4,11,13804,416,14211,9,1.72963e+14,10.0469,349.027,14220,11,11,12389,10926,8815,8983,7012
5320,1,11,5163,157,5314,6,1.82112e+14,10.3504,213.379,5320,11,11,929,929,929,929,929
5706,1668,3112,5706,0,5706,0,3.88418e+18,18.7848,3312.16,5706,2795,21,2594,2594,1509,1475,1528
8867,51,176,8860,7,8867,0,6.06594e+18,161.951,1154.81,8867,117,119,5875,2928,2320,2681,2567
25706,4,176,25653,53,25706,0,6.10872e+18,171.844,1985.78,25706,155,153,3036,583,333,265,414
16468,12,14,15976,492,16438,30,1.96544e+14,10.274,395.616,16468,13,11,16454,16453,16449,16449,16449
7439,1783,3662,7439,0,7439,0,1.97448e+18,17.9122,3902.71,7439,3286,20,3777,3777,1923,3777,1895
7715,375,1867,0,7715,2724,4991,2.536e+15,59.4845,2629.16,7715,907,72,5848,5848,3697,1008,1319
7070,1611,1703,6653,417,6653,417,3.23777e+18,96.3631,2540.52,7070,809,99,5367,5367,5294,5346,5300
3894,793,995,3667,227,3667,227,3.45248e+18,94.377,1532.97,3894,455,81,2899,2899,2556,2709,2586
21820,1545,5100,7665,14155,0,21820,9.91151e+12,59.9274,6802.25,21820,2480,72,16720,16720,9835,14925,5350
9081,2504,2639,8589,492,0,9081,2.09086e+18,95.7279,3597.68,9081,1252,108,6442,6442,6309,6322,6308
30446,2387,7165,0,30446,0,30446,6.48324e+17,97.7093,9676.44,30446,3467,110,23281,23281,16771,8590,8798
48875,13,19,47420,1455,48735,140,1.86778e+14,10.4819,823.341,48875,15,13,48856,48856,45827,45870,42061
11385,4679,5771,10955,430,10955,430,2.45494e+18,87.1744,6639.87,11385,2772,104,5614,5614,5209,5518,4994
1309,126,173,1309,0,1309,0,6.13673e+18,107.557,439.605,1309,59,56,1121,1050,959,962,953
28861,9,176,28806,55,28861,0,6.00471e+18,170.87,2056.18,28861,166,163,6618,879,1097,1066,1398
21554,2897,10063,20674,880,20674,880,9.26247e+18,90.5041,11531.5,21554,4879,110,11491,11491,10698,10731,2581
9853,411,2967,0,9853,0,9853,5.98735e+17,95.8282,3972.54,9853,1426,110,6886,6800,4476,2598,1816
7194,2054,4170,7194,0,6934,260,5.59921e+18,116.297,4654.21,7194,1859,93,3024,2979,2261,2710,1530
46373,892,1249,0,46373,45048,1325,3.55743e+16,256.979,4366.77,46373,199,26,45124,45124,43668,43787,37369
4847,637,1813,1811,3036,0,4847,8.06124e+12,56.7242,2283.91,4847,868,67,3034,2986,1515,2602,916
45933,5104,10926,0,45933,16192,29741,2.51485e+15,60.0002,14024.5,45933,5317,72,35007,35007,27776,22406,17259
47138,645,1263,0,47138,45795,1343,3.55656e+16,259.099,4427.57,47138,200,26,45875,45193,38354,39397,29751
3153,242,333,0,3153,3059,94,5.04609e+16,18.6127,770.612,3153,51,26,2820,2820,2587,2630,1978
28759,4823,12019,27486,1273,0,28759,1.69754e+18,74.2411,13969.6,28759,5817,110,16740,16740,16318,16258,16060
19190,8545,9076,19190,0,18340,850,4.16932e+18,175.902,10139.5,19190,4011,124,10114,10114,9812,10000,9329
31850,7837,15580,31850,0,30550,1300,4.82482e+18,492.159,17267.9,31850,6479,138,16270,15948,12734,14554,8948
30477,7226,9583,28885,1592,0,30477,1.99999e+18,96.4665,11893,30477,4645,110,20894,20894,18188,17650,15217
18630,5069,10606,7641,10989,0,18630,5.57665e+12,54.5622,11572,18630,5162,72,8024,7976,7105,7765,6459
34115,11969,15486,0,34115,0,34115,4.6332e+17,93.0406,17603.9,34115,7520,110,18629,18629,16708,13853,13731
38437,1191,11034,36337,2100,36337,2100,3.69729e+18,96.7502,13830.7,38437,5254,111,27403,27403,15335,17224,5485
29122,918,11310,0,29122,0,29122,5.19813e+17,95.2743,13352.6,29122,5491,110,17812,17554,10857,3958,2922
49147,12,17,47696,1451,49073,74,1.77194e+14,10.4565,775.9,49147,14,12,49130,49129,44193,44131,37525
44529,119,176,44448,81,44529,0,5.98162e+18,172.066,2500.94,44529,172,170,41739,37801,29368,30022,29741
23600,738,1373,7160,16440,0,23600,6.90839e+18,15.9867,1941.75,23600,978,18,22227,22227,16023,15455,14815
30133,7585,8391,28463,1670,28463,1670,2.00811e+18,97.6362,10728.4,30133,3990,111,21742,21742,20973,21688,19994
17669,5628,6477,6627,11042,0,17669,8.1711e+12,56.0481,7725.6,17669,3139,72,11192,11192,10725,11112,10340
24236,896,1011,0,24236,23535,701,3.96293e+16,203.74,3079.46,24236,151,26,23225,23225,23050,23044,22324
39182,14933,39182,39182,0,39182,0,8.79587e+12,0,39182,39182,39182,1,0,0,0,0,0
47624,8,176,47558,66,47624,0,6.03824e+18,173.722,2672.37,47624,174,173,10074,1528,1714,1625,1868
27621,6604,7834,26113,1508,0,27621,2.08686e+18,96.951,10050.8,27621,3794,110,19787,19787,18116,17760,16352
47011,11840,13555,16986,30025,0,47011,9.17087e+12,59.161,16537.9,47011,6597,72,33456,33456,31368,33017,28027
1914,266,1011,1914,0,1914,0,2.90988e+18,16.5199,1120.29,1914,901,20,903,903,261,238,294
7810,524,1989,7358,452,7358,452,2.33697e+18,96.6832,2867.95,7810,918,105,5821,5821,4061,4835,1829
19969,11,61,19937,32,19969,0,2.32897e+18,60.61,1050.91,19969,61,61,6728,421,579,996,3289
28541,1,14,27704,837,28487,54,1.68347e+14,10.4535,546.853,28541,13,11,5719,5719,5719,5719,5719
42351,11053,13365,0,42351,15503,26848,2.2604e+15,58.7498,16015.5,42351,6508,72,28986,28986,27048,24362,23961
45871,2641,14628,45871,0,43201,2670,3.89901e+18,316.219,16543,45871,5446,129,31243,30650,15482,22347,6809
8164,298,3566,8164,0,6388,1776,5.37953e+18,87.5288,4135.64,8164,797,109,4598,4503,2693,3334,928
24078,637,1021,24078,0,23075,1003,2.25218e+18,16.9854,1618.12,24078,1013,18,23057,23057,22674,23057,17029
38835,5225,9964,36625,2210,36625,2210,2.55791e+18,98.0243,12875.8,38835,4718,111,28871,28871,24249,28514,16383
32479,2338,7628,0,32479,0,32479,6.47738e+17,97.7459,10272.9,32479,3691,110,24851,24851,15306,10294,8991
31589,4314,7375,11103,20486,0,31589,9.89322e+12,60.0286,9667.1,31589,3592,72,24214,24214,19791,23451,14492
45300,2823,10505,15916,29384,0,45300,9.8984e+12,60.1007,13590.3,45300,5113,72,34795,34795,23624,32865,9955
17382,7879,8487,0,17382,0,17382,4.35467e+17,91.0597,9704.05,17382,4105,110,8895,8895,8697,8721,8774
5449,6,11,5293,156,5447,2,1.38232e+14,9.93412,202.764,5449,11,11,5190,5092,4693,4718,3690
14753,159,208,14743,10,14753,0,6.05153e+18,197.663,1587.04,14753,144,145,14160,13446,11177,11406,11335
8139,3736,7608,0,8139,2535,5604,2.36082e+15,3.97973,7650.26,8139,2559,9,531,531,260,260,266
40143,1158,1324,0,40143,38990,1153,3.81999e+16,271.772,4421.54,40143,213,26,38819,38819,38511,38507,36844
7241,328,1810,6821,420,6821,420,5.81921e+18,96.1175,2655.14,7241,856,101,5431,5431,4418,3727,1420
46097,4266,19212,46097,0,43885,2212,4.71045e+18,880.069,21333.5,46097,5962,143,26885,25896,15245,19162,9665
12460,3,13,12096,364,12415,45,1.67868e+14,10.3336,336.347,12460,12,11,9648,7309,7125,7959,3606
12525,2825,5125,11954,571,11954,571,4.20215e+18,94.9655,6172.39,12525,2438,111,7400,7400,5627,7296,3639
5988,1580,2050,5988,0,4971,1017,3.01804e+18,91.3687,2569.29,5988,721,98,3938,3938,3534,3700,3388
30670,2426,7148,28880,1790,0,30670,2.23307e+18,97.7736,9683.23,30670,3458,110,23522,23522,15302,14143,9211
39485,51,61,39389,96,39485,0,2.25456e+18,60.8062,1480.01,39485,61,61,38011,36578,32714,33833,33105
26345,2342,8164,26345,0,24815,1530,4.65162e+18,171.084,9645.65,26345,1705,128,18181,18010,10919,13617,5475
29728,3861,9110,28148,1580,28148,1580,5.05483e+18,97.1828,11358.4,29728,4344,111,20618,20618,13476,14879,10435
2375,772,877,2375,0,2236,139,3.60101e+18,87.4421,1165.33,2375,307,64,1498,1498,1437,1462,1466
49491,5091,19890,18872,30619,0,49491,7.72166e+12,57.3985,22586.5,49491,9689,72,29601,29601,19110,27801,6456
36240,8328,17752,0,36240,0,36240,4.32825e+17,93.7182,19855,36240,8624,110,18488,18488,14249,11524,10207
21223,5680,6173,7671,13552,0,21223,9.13038e+12,58.9723,7743.21,21223,2992,72,15050,15050,14477,14929,13682
27624,6351,9554,10248,17376,0,27624,8.42368e+12,56.5203,11369.1,27624,4632,72,18070,18070,15104,17560,11678
29426,10,14,28588,838,29375,51,1.38968e+14,10.5224,496.366,29426,13,12,29283,29042,26620,26660,27015
4838,931,1802,0,4838,1810,3028,2.08237e+15,56.7005,2272.78,4838,863,71,3036,3036,2753,2319,2448
23688,874,6481,22368,1320,22368,1320,2.27284e+18,97.5478,8437.29,23688,3067,111,17207,17207,8607,11972,3616
11866,2725,3561,11221,645,11221,645,1.48205e+18,96.6098,4696.98,11866,1682,111,8305,8305,8305,8304,6650
6675,2071,2517,6348,327,6348,327,1.74719e+18,93.6262,3209.67,6675,1188,95,4158,4158,4158,4158,3529
37658,7273,8812,35468,2190,0,37658,2.22869e+18,97.8102,11786,37658,4268,110,28846,28846,27090,26397,24405
35841,436,10231,0,35841,12928,22913,2.35358e+15,59.1814,12630.9,35841,4970,72,25610,25466,14887,3905,1805
10644,168,176,10635,9,10644,0,6.10429e+18,165.81,1278.03,10644,121,126,10439,10332,10085,9975,9989
21745,7979,9630,21284,461,20705,1040,4.9162e+18,183.692,10707.4,21745,2456,130,12115,12115,11511,12081,10934
23980,5950,8489,23980,0,22680,1300,5.13666e+18,174.258,9837.33,23980,1902,128,15491,15479,14457,15306,12094
15383,680,801,0,15383,14934,449,4.02095e+16,118.243,2192.79,15383,109,26,14582,14453,14344,14330,13114
13458,88,176,13450,8,13458,0,6.05734e+18,167.81,1427.35,13458,137,136,11472,7616,6419,6606,6817
33541,13,14,32577,964,33460,81,1.50124e+14,10.6237,585.693,33541,14,12,33527,33527,33227,33227,32697
10571,2500,3398,10021,550,0,10571,1.99218e+18,95.6582,4437.31,10571,1636,110,7173,7173,6329,6148,5763
2099,1,11,2038,61,2099,0,1.43084e+14,10.5755,130.646,2099,11,11,517,517,517,517,517
7307,1987,3596,7307,0,7307,0,1.39689e+18,18.8989,3841.29,7307,2832,23,3711,3711,2683,2426,2096
14042,55,176,13990,52,14042,0,6.05333e+18,167.096,1454.77,14042,139,140,9686,5546,3978,4618,4432
49885,2345,2575,0,49885,48393,1492,4.98026e+16,327.851,8326.65,49885,460,26,47310,47310,46996,46974,45284
29759,2786,6964,0,29759,10464,19295,2.52772e+15,60.0121,9150.77,29759,3384,72,22795,22795,16730,10188,9383
22682,886,966,0,22682,22025,657,3.9463e+16,193.633,2899.96,22682,142,26,21716,21716,21614,21585,21138
25328,3105,9478,24795,533,23959,1369,5.16286e+18,191.319,10713.4,25328,2238,132,15850,15628,11436,12763,5216
49758,1177,1315,0,49758,48339,1419,3.55712e+16,267.062,4641.03,49758,210,26,48443,48443,48060,48045,45665
22887,2006,5520,21557,1330,21557,1330,5.90061e+18,97.9907,7492.34,22887,2594,111,17367,17367,10689,12455,7321
20029,6298,8055,0,20029,7632,12397,1.97555e+15,57.2674,9370.98,20029,3917,72,11974,11974,10495,10129,8182
35329,629,1041,0,35329,34324,1005,3.55505e+16,215.509,3469.63,35329,157,26,34288,33870,32322,32560,24699
19766,8829,9849,19766,0,18919,847,5.38748e+18,197.281,10835,19766,3358,127,9917,9917,9590,9861,8861
39851,9605,10219,0,39851,14175,25676,2.45494e+15,59.7035,12922,39851,4978,72,29632,29632,28883,28736,27807
9619,12,175,9614,5,9619,0,5.98437e+18,161.898,1163.75,9619,126,129,2714,427,532,609,574
39478,26,176,39421,57,39478,0,6.07233e+18,170.359,2450.01,39478,170,168,18811,5015,5856,6076,5844
29977,2902,14752,29977,0,0,29977,8.77571e+17,17.9792,15252.5,29977,13268,20,15225,15225,3489,12002,2968
18161,1189,6257,0,18161,0,18161,5.57744e+17,95.1204,7766.11,18161,3023,110,11904,11904,7109,5407,3950
2933,512,729,1030,1903,0,2933,1.01324e+13,58.2731,1098.63,2933,355,61,2204,2204,1910,2147,1721
5393,16,176,5391,2,5393,0,6.10024e+18,146.022,908.478,5393,99,100,1892,395,453,545,551
45959,7598,10730,0,45959,16163,29796,2.52606e+15,60.0542,13847,45959,5212,72,35229,35229,30726,31655,25321
14681,279,4123,13870,811,13870,811,2.9336e+18,96.2377,5483.33,14681,1938,111,10558,10471,4890,5885,1612
21972,4779,7943,0,21972,0,21972,5.42909e+17,95.554,9645.92,21972,3850,110,14029,14029,11478,9014,8872
13434,4789,5019,5051,8383,0,13434,8.13368e+12,57.54,6018.78,13434,2441,72,8415,8415,8173,8362,7942
25037,2,6,24654,383,25005,32,9.62121e+13,3.99812,360.973,25037,5,4,18928,16477,17704,16477,15256
21603,356,6196,0,21603,0,21603,6.07126e+17,96.7579,8023.96,21603,2998,110,15407,15149,9297,2480,2149
20265,3797,8450,0,20265,0,20265,4.97537e+17,94.6649,9944.8,20265,4098,110,11815,11815,8572,7678,5046
16034,2110,3820,0,16034,0,16034,6.45645e+17,97.277,5359.17,16034,1826,110,12214,12214,10376,7989,7528
1407,506,851,0,1407,0,1407,3.50667e+15,13.14,927.851,1407,749,20,556,556,340,556,369
47775,3554,11169,44995,2780,0,47775,2.22683e+18,97.9059,14762.6,47775,5417,110,36606,36606,26249,24741,13344
43373,1153,1192,0,43373,42135,1238,3.55163e+16,247.063,4116.38,43373,187,26,42181,42181,42075,42067,41578
11434,68,2841,10774,660,10774,660,5.31092e+18,97.27,4010.72,11434,1325,111,6195,1779,2263,2809,387
32200,220,984,0,32200,31282,918,3.55499e+16,198.612,3216.72,32200,146,26,31065,30868,22614,22405,11505
4084,38,170,4080,4,4084,0,5.9889e+18,150.674,752.752,4084,96,89,2266,720,769,912,828
7580,1593,3026,7580,0,7190,390,6.3788e+18,84.9951,3631.82,7580,1204,106,4554,4554,4152,4380,3673
34531,7041,12553,0,34531,0,34531,5.38334e+17,95.7127,14959.8,34531,6088,110,21978,21978,16904,12027,11167
16603,1145,5993,15788,815,15788,815,7.69112e+18,95.4159,7373.1,16603,2900,110,10610,10610,9842,9104,1605
12712,655,710,0,12712,12345,367,3.94412e+16,37.3843,1844.29,12712,91,26,12002,11983,11907,11904,11316
19103,159,176,19089,14,19103,0,6.04425e+18,169.86,1693.24,19103,147,152,18758,18361,17202,17300,17155
43838,9412,10219,41285,2553,0,43838,2.22913e+18,97.8749,13574.4,43838,4955,110,33619,33619,32531,32325,31508
47701,505,1811,0,47701,46311,1390,4.19406e+16,300.424,6047.82,47701,311,26,45890,44550,35803,37572,20212
22515,111,200,22507,8,22515,0,5.98495e+18,181.247,1831.01,22515,163,157,20593,17338,12189,12923,13093
716,36,48,0,716,696,20,3.55256e+16,17.2961,134.107,716,22,22,668,668,644,642,571
27447,3916,6468,25848,1599,25848,1599,5.88456e+18,97.7056,8786.85,27447,3129,110,20979,20979,20350,20350,13571
36949,2373,8713,0,36949,0,36949,6.46199e+17,97.7775,11636.4,36949,4220,110,28236,28236,16153,12727,9069
22226,14325,22226,0,22226,22226,0,2047.91,0,22226,22226,22226,1,0,0,0,0,0
6433,2184,2289,0,6433,2389,4044,2.14049e+15,57.3378,2877.61,6433,1105,72,4144,4144,4032,3957,3996
37305,4711,14846,0,37305,0,37305,5.09739e+17,95.1929,17289.1,37305,7209,110,22459,22459,15336,8903,7391
37429,7473,11485,13644,23785,0,37429,8.93956e+12,58.8757,13909.8,37429,5590,72,25944,25944,22186,25294,17746
35643,9508,13727,24037,11606,33961,1682,3.14236e+18,95.7911,16076.9,35643,6586,111,21916,21916,19357,21764,16257
36591,76,98,36469,122,36591,0,3.86833e+18,97.264,1671.64,36591,98,98,34855,30777,29493,30008,29269
48930,8792,22220,0,48930,0,48930,4.61811e+17,93.2229,25022.4,48930,10784,110,26710,26710,19959,17388,11381
24279,7519,7612,0,24279,0,24279,5.82251e+17,96.4034,9558.49,24279,3686,110,16667,16667,16569,16550,16592
42426,3,176,42348,78,42426,0,5.9837e+18,172.232,2441.33,42426,172,171,3630,590,377,247,504
9335,285,399,0,9335,9068,267,3.53997e+16,19.9536,1125.84,9335,60,26,8936,8936,8379,8431,6984
30734,5815,7239,28947,1787,28947,1787,3.23629e+18,97.6923,9770.34,30734,3499,110,23495,23495,22070,23096,19737
3054,2,10,2968,86,3054,0,1.38157e+14,9.77767,152.507,3054,10,10,1762,1242,1213,1296,1058
35266,2850,8469,33213,2053,33213,2053,5.07151e+18,98.2483,11215.1,35266,3998,111,26797,26797,20213,23380,10263
3775,817,914,0,3775,1324,2451,2.53403e+15,58.8654,1367.25,3775,439,66,2861,2861,2738,2745,2701
43773,9820,10532,41231,2542,41231,2542,5.1779e+18,98.3001,13785.2,43773,4978,111,33241,33241,33241,33241,31572
30365,3853,13297,29065,1300,0,30365,1.63946e+18,93.5561,15279.1,30365,6452,110,17068,17068,11666,10341,5892
41747,828,11128,0,41747,0,41747,6.21247e+17,97.2496,14244.2,41747,5396,110,30619,30619,12241,4590,4396
30286,70,176,30260,26,30286,0,6.08988e+18,172.724,2154.72,30286,159,162,23995,16459,11472,12381,12134
44450,9272,19835,44450,0,42842,1608,5.28885e+18,3511.92,23647.1,44450,7891,152,24615,19947,14496,17325,12324
40178,4598,9350,0,40178,14118,26060,2.53415e+15,60.0594,12138.9,40178,4549,72,30828,30828,25082,17367,15483
42976,37826,42976,0,42976,42976,0,2047.95,0,42976,42976,42976,1,0,0,0,0,0
29329,9074,9956,27842,1487,27842,1487,2.65413e+18,94.3513,12096.9,29329,4747,111,19373,19373,18722,18892,18660
30692,720,11014,0,30692,0,30692,5.44001e+17,94.5462,13222.5,30692,5341,110,19678,19287,11554,3920,2151
34448,249,1465,0,34448,33440,1008,4.27288e+16,276.378,4681.41,34448,241,26,32701,32056,23717,23140,11009
7506,2270,2550,7123,383,7123,383,3.44201e+18,95.1958,3334.54,7506,1193,96,4956,4956,4669,4943,4659
43084,10,16,41821,1263,42995,89,1.73116e+14,10.4134,700.813,43084,14,13,42956,42765,36875,37009,35935
36299,2503,13031,36299,0,34301,1998,4.54493e+18,257.902,14618.1,36299,5088,126,23268,22854,12329,17472,4721
22688,5221,5980,8095,14593,0,22688,9.50745e+12,59.4946,7686.2,22688,2907,72,16708,16708,15595,16514,14399
47980,8061,11140,16853,31127,0,47980,9.88841e+12,60.0793,14373.1,47980,5413,72,36840,36840,32308,36060,26868
37662,5090,16452,37662,0,35882,1780,4.80294e+18,442.384,18119.1,37662,4726,137,21210,20808,12890,15787,8259
33927,1492,1525,0,33927,32933,994,4.39881e+16,284.525,4837.62,33927,251,26,32402,32402,32308,32304,31880
30739,114,175,30730,9,30739,0,5.98526e+18,167.602,2073.21,30739,167,164,28497,25281,19219,19789,20313
11022,1318,2767,10392,630,10392,630,6.05314e+18,96.6886,3918.09,11022,1315,110,8255,8255,7945,7945,4768
26545,2124,7469,0,26545,0,26545,6.08037e+17,95.8083,9626.84,26545,3598,110,19076,19076,13562,7417,7084
4283,22,170,4283,0,4283,0,5.96152e+18,151.857,770.913,4283,99,94,1773,324,481,532,578
9459,680,3115,8969,490,0,9459,1.977e+18,95.431,4062.99,9459,1497,108,6344,6258,4025,3603,1646
1655,165,423,0,1655,586,1069,2.62663e+15,57.1662,668.029,1655,205,51,1232,1232,860,923,589
41657,11530,14627,32605,9052,39587,2070,4.19707e+18,95.2097,17397,41657,7009,111,27030,27030,23619,24289,22399
30302,1150,1451,0,30302,29411,891,4.48535e+16,287.167,4518.09,30302,237,26,28851,28851,28401,28366,25832
1272,47,70,0,1272,1235,37,3.5519e+16,19.3082,210.213,1272,27,26,1202,1202,1086,1097,991
32753,12665,14339,31345,1408,31345,1408,8.87262e+18,94.5432,16432.5,32753,6967,110,18414,18414,18346,18346,17969
34779,2661,8141,0,34779,0,34779,6.49694e+17,97.8166,10930.1,34779,3947,110,26638,26638,19233,13407,10168
42376,7577,10117,39906,2470,39906,2470,3.35451e+18,98.3628,13295.2,42376,4791,111,32259,32259,27423,28453,24948
10230,2880,3597,10230,0,9648,582,5.24036e+18,90.8028,4300.3,10230,1290,117,6633,6633,6274,6492,5928
44485,74,176,44401,84,44485,0,6.00798e+18,172.058,2550.74,44485,172,173,34810,20461,16941,19072,18625
17441,35,208,17424,17,17441,0,6.09391e+18,195.497,1758.57,17441,147,145,9655,3148,3176,3582,2893
26981,26,176,26967,14,26981,0,5.98491e+18,169.909,1956.97,26981,164,161,12434,2848,3608,4011,4077
41321,4600,9703,0,41321,0,41321,6.47854e+17,97.8383,12897,41321,4705,110,31618,31618,24738,18688,16356
29618,1,14,28765,853,29569,49,1.51201e+14,10.6568,549.291,29618,13,11,6899,6899,6899,6899,6899
2356,153,878,2356,0,2221,135,5.80993e+18,86.8977,1163.9,2356,190,66,1478,1478,1029,1231,475
49607,277,1681,0,49607,48172,1435,3.9783e+16,294.944,5718.92,49607,284,26,47587,46743,34704,32853,13282
34831,8270,14112,0,34831,13302,21529,1.96922e+15,57.3143,16131.1,34831,6873,72,20719,20719,16494,11227,11489
39310,64,1120,0,39310,38188,1122,3.56017e+16,234.827,3801.71,39310,173,26,37757,37679,23748,23514,7918
36484,746,1536,10641,25843,10641,25843,1.74366e+18,15.9911,2253.12,36484,1530,17,34948,34948,24733,27868,30225
48645,4496,25235,19562,29083,0,48645,6.21501e+12,55.4347,27466.5,48645,12287,72,23410,23410,13355,19921,4821
15135,6,11,14703,432,15131,4,1.44243e+14,9.98692,345.61,15135,11,11,14438,14050,12731,12462,10070
49509,14091,18214,0,49509,18578,30931,2.08729e+15,57.946,21038.1,49509,8872,72,31295,31295,28339,26256,23492
16419,1587,5993,0,16419,0,16419,5.39546e+17,95.2582,7357.81,16419,2896,110,10426,10426,5930,4230,4282
15662,1,11,15214,448,15654,8,1.4692e+14,10.0168,353.95,15662,11,11,3780,3780,3780,3780,3780
11808,4530,6145,11808,0,8717,3091,4.02968e+18,145.35,6828.19,11808,2652,117,5663,5663,4814,5219,4768
9989,6,13,9701,288,9952,37,1.56165e+14,10.9256,315.328,9989,12,11,9485,9190,8300,7065,6521
29886,645,6936,0,29886,10493,19393,2.53877e+15,60.0216,9128.82,29886,3376,72,22950,22950,7837,5375,2456
39351,268,12038,39351,0,37071,2280,4.04812e+18,279.16,14035.4,39351,4723,128,27219,26865,8859,16063,1313
13323,1881,4811,0,13323,4981,8342,2.1213e+15,56.9351,5822.96,13323,2338,72,8512,8512,6472,4549,4220
17775,140,4169,0,17775,6245,11530,2.54392e+15,59.895,5616,17775,2031,72,13606,13570,3620,629,653
7232,94,2511,7232,0,6822,410,3.22033e+18,93.5998,3130.42,7232,966,106,4565,1091,1937,2873,513
3965,775,965,1389,2576,0,3965,9.85302e+12,58.7602,1433.69,3965,461,67,3000,3000,2743,2950,2582
18827,1941,4578,17737,1090,17737,1090,2.57312e+18,97.8273,6276.41,18827,2150,111,14249,14249,10729,12788,6689
5689,757,2369,3804,1885,5429,260,7.62269e+18,87.315,2961.13,5689,1124,89,3320,3233,2061,2425,1609
47486,9391,15154,47486,0,44726,2760,4.64729e+18,329.522,17119.2,47486,5663,129,32332,32330,26832,29686,21615
23448,223,1029,0,23448,22768,680,4.04756e+16,205.409,3103.49,23448,153,26,22252,22017,19367,17529,8781
31410,7277,13363,12104,19306,0,31410,7.40827e+12,56.9747,15177.4,31410,6500,72,18047,17999,12872,16967,4243
1979,362,507,691,1288,0,1979,1.02958e+13,57.4558,783.742,1979,246,55,1472,1472,1300,1432,1167
24343,1778,5727,8561,15782,0,24343,9.90741e+12,59.9553,7580,24343,2789,72,18616,18616,11194,16680,5929
25765,5,14,25003,762,25746,19,1.81241e+14,10.2305,490.076,25765,13,12,23874,21656,20844,20269,12235
21810,4498,10841,21810,0,20910,900,4.00842e+18,260.179,12031,21810,4935,126,10969,10844,7465,8854,5340
26376,753,1115,0,26376,0,26376,3.83975e+18,15.988,1722.35,26376,1109,17,25261,25261,20610,21676,23106
10996,8896,10996,10996,0,0,10996,134206000,0,10996,10996,10996,1,0,0,0,0,0
1723,697,1723,1723,0,0,1723,134140000,0,1723,1723,1723,1,0,0,0,0,0
33540,144,176,33463,77,33540,0,5.98385e+18,169.734,2169.58,33540,164,168,32631,30590,27687,27692,27422
20057,6065,6237,20057,0,18895,1162,4.52361e+18,151.056,7468.49,20057,1491,127,13820,13820,13820,13820,13701
5861,261,1396,2063,3798,0,5861,9.85368e+12,59.2123,2021.53,5861,669,72,4465,4465,1963,3767,949
21265,2547,11302,21265,0,21265,0,2.9363e+18,17.9654,11702.2,21265,10162,20,9963,9963,2425,2159,2219
38908,1,11,37527,1381,38740,168,4.48097e+13,5.99661,587.647,38908,8,8,27390,27390,27390,27390,27390
30885,6094,10004,30885,0,29085,1800,5.15028e+18,203.056,11444.9,30885,3651,128,20881,20853,17846,19477,13344
34000,7912,18984,0,34000,7313,26687,1.36507e+13,8.98976,19335.2,34000,17077,11,15016,15016,8242,8655,7847
45772,8001,10922,43103,2669,43103,2669,4.42212e+18,98.3694,14296.7,45772,5172,111,34850,34850,31803,34631,26371
11001,226,2675,10359,642,10359,642,3.81918e+18,97.3264,3815.34,11001,1240,111,8326,8326,3661,5318,1303
12602,470,854,0,12602,12229,373,4.59495e+16,145.483,2259.17,12602,120,26,11748,11556,11136,10673,8761
13124,529,711,0,13124,12744,380,3.89827e+16,38.4921,1864.17,13124,91,26,12413,12393,12120,12093,9931
20040,3356,7916,19110,930,0,20040,1.77066e+18,94.9926,9441.89,20040,3837,110,12124,12124,9130,8467,6043
32850,1466,11281,12181,20669,0,32850,8.47933e+12,58.2779,13368.6,32850,5493,72,21569,21569,13703,20219,4256
15018,49,4726,5480,9538,0,15018,8.85935e+12,58.5593,5895.5,15018,2297,72,8897,2956,2618,6243,136
1596,442,468,1505,91,0,1596,2.22179e+18,88.8026,741.221,1596,204,53,1128,1128,1114,1115,1125
2746,73,1524,2646,100,2646,100,1.01342e+19,86.303,1814.77,2746,718,56,957,304,711,826,0
41537,8829,15052,39507,2030,39507,2030,5.31996e+18,94.9306,17775.7,41537,7214,111,26485,26485,22881,25236,16433
14892,664,3519,5227,9665,0,14892,9.87499e+12,59.804,4780.68,14892,1711,72,11373,11373,7263,10663,2365
40063,2034,16687,38283,1780,0,40063,1.69994e+18,94.8963,19210,40063,8105,110,23376,23376,14561,12623,4663
27515,5708,14573,0,27515,11100,16415,1.55396e+15,53.8925,15968.4,27515,7079,72,12942,12942,8893,6558,5900
19787,2390,4634,0,19787,6951,12836,2.538e+15,59.8983,6208.92,19787,2254,72,15153,15153,11824,8300,7893
22926,3796,5650,21608,1318,0,22926,2.19705e+18,97.45,7647.8,22926,2730,110,17276,17276,14820,14349,12106
20860,116,176,20789,71,20860,0,6.001e+18,168.266,1740.86,20860,152,157,19374,17538,13446,13708,13976
39850,9025,9270,0,39850,14005,25845,2.535e+15,60.0725,12038.9,39850,4515,72,30580,30580,30230,29989,29983
9236,2461,3652,9236,0,8738,498,3.61099e+18,93.299,4289.14,9236,1410,114,5584,5583,4309,4904,3669
6040,1419,1443,2114,3926,0,6040,9.84271e+12,59.2305,2082.18,6040,694,72,4597,4597,4589,4597,4596
41244,5740,15518,39272,1972,39272,1972,3.47056e+18,96.223,18179,41244,7432,111,25726,25726,14199,16573,9804
5238,216,230,0,5238,5087,151,3.5396e+16,19.8778,671.754,5238,45,26,5008,5008,4987,4985,4921
39670,1505,12275,37583,2087,37583,2087,6.83149e+18,96.6531,15126.1,39670,5954,110,27395,27395,22629,19156,6498
6695,138,360,0,6695,6503,192,3.80146e+16,19.8414,965.478,6695,57,26,6335,6335,5876,5714,3523
11874,903,2829,4176,7698,0,11874,9.86979e+12,59.6555,3886.63,11874,1370,72,9045,9045,5398,8087,2902
25594,2568,12038,24556,1038,0,25594,1.54938e+18,93.9428,13697.5,25594,5846,110,13556,13556,6746,6162,2685
46697,36993,46697,46697,0,46697,0,3.4359e+10,0,46697,46697,46697,1,0,0,0,0,0
27473,3140,6470,0,27473,0,27473,6.48258e+17,97.7232,8791.99,27473,3133,110,21003,21003,16498,12900,11118
24022,3620,5642,22622,1400,0,24022,2.23057e+18,97.6068,7734.32,24022,2727,110,18380,18380,16081,15244,12430
44806,5321,10497,42198,2608,0,44806,2.22779e+18,97.8862,13907.5,44806,5089,110,34309,34309,28535,26234,18830
37331,1687,11008,35311,2020,35311,2020,2.53109e+18,97.453,13716.5,37331,5236,111,26323,26323,6879,15121,5451
8839,115,175,8833,6,8839,0,5.96809e+18,161.348,1116.29,8839,121,125,8121,7309,5602,5721,5843
25964,1213,1430,0,25964,25192,772,4.77378e+16,280.435,4336.58,25964,231,26,24534,24534,24264,24222,22744
26634,2691,6300,0,26634,0,26634,6.46399e+17,97.6358,8562.89,26634,3045,110,20334,20334,15449,10247,9590
15903,399,5624,15116,787,15116,787,7.58503e+18,95.4547,6975.16,15903,2715,110,10279,10021,2207,8234,1954
39462,7873,10577,37269,2193,37269,2193,3.3587e+18,97.2916,13553.7,39462,5129,110,28885,28885,24842,26616,23121
21154,4664,7892,0,21154,7958,13196,2.07598e+15,57.7241,9315.16,21154,3838,72,13262,13262,11697,10279,9231
4485,657,2337,4315,170,4315,170,2.55686e+18,79.1097,2773.39,4485,1096,78,2148,2062,654,1204,97
33957,5583,10037,0,33957,0,33957,5.96595e+17,96.8138,12605.4,33957,4864,110,23920,23920,20526,15278,15001
19259,4713,7584,19259,0,18249,1010,4.6147e+18,142.076,8594.55,19259,2977,124,11675,11675,9459,10615,7602
10484,506,772,0,10484,10177,307,4.57886e+16,99.3961,1947.96,10484,99,26,9712,9615,9231,9127,6878
21430,885,5048,0,21430,0,21430,6.49265e+17,97.5095,6964.84,21430,2434,110,16382,16382,7548,4724,3883
10082,1853,2802,0,10082,3617,6465,2.41495e+15,58.9719,3696.32,10082,1365,72,7280,7280,6067,6274,4821
7997,135,176,7932,65,7997,0,6.06152e+18,162.058,1103.25,7997,110,113,7606,7125,6170,6260,6095
39015,13369,15044,14763,24252,0,39015,7.9376e+12,57.6302,17315.6,39015,7324,72,23971,23971,21493,23541,18617
3980,743,965,0,3980,1398,2582,2.58517e+15,58.8369,1429.32,3980,468,67,3015,3015,2746,2444,2490
9393,309,548,0,9393,9119,274,3.94311e+16,19.8929,1409.24,9393,74,26,8845,8845,8502,8387,6605
43626,2783,18233,16755,26871,0,43626,7.51397e+12,57.1319,20614.1,43626,8875,72,25393,25393,15417,23683,3391
9244,996,8640,8636,608,8636,608,1.18509e+18,3.98572,8685.32,9244,2902,9,604,604,68,71,75
24308,4572,6305,0,24308,8652,15656,2.44762e+15,59.5532,8111.34,24308,3067,72,18003,18003,15976,14570,12720
29265,7388,16387,28285,980,28285,980,1.05265e+19,91.0819,17988.2,29265,7945,110,12878,12878,11746,11563,7450
28971,4892,7436,27331,1640,27331,1640,6.06559e+18,97.3574,9800.85,28971,3594,110,21535,21535,20185,19978,15022
16624,5497,5522,16624,0,15654,970,3.42347e+18,132.44,6486.21,16624,1992,120,11102,11102,11102,11102,11102
2074,10,11,2015,59,2073,1,1.56345e+14,10.5251,130.955,2074,11,11,2050,2025,2004,2005,1930
40475,7931,9746,38125,2350,38125,2350,1.81064e+18,98.2875,12805.7,40475,4613,111,30729,30729,28930,30601,25937
4877,158,176,4872,5,4877,0,6.03576e+18,157.249,842.396,4877,100,102,4667,4562,4287,4338,4285
39279,276,1953,0,39279,38115,1164,4.75303e+16,314.503,6229.9,39279,339,26,36871,35815,30716,23133,10480
16548,3271,3892,0,16548,5819,10729,2.53989e+15,59.8593,5258.92,16548,1894,72,12656,12656,11898,11015,10826
49792,12827,20454,49792,0,47579,2213,4.55392e+18,2378.37,23578.5,49792,6010,148,29338,26931,24654,25793,20535
6661,545,1848,6291,370,0,6661,2.13496e+18,92.7089,2626.07,6661,866,96,4813,4813,2611,2278,1428
35571,2990,14510,33951,1620,33951,1620,5.99173e+18,95.7119,16789,35571,6967,111,21061,20974,16973,18700,10366
30284,10,14,29418,866,30204,80,1.38646e+14,10.7308,538.793,30284,14,12,30092,29738,28416,28414,24178
2753,211,724,0,2753,0,2753,6.46954e+17,92.9219,1141.38,2753,327,67,2029,2029,1085,900,816
6828,939,2411,6488,340,6488,340,7.29978e+18,94.286,3142.28,6828,1150,96,4417,4417,3951,3885,2454
27457,537,898,0,27457,26671,786,3.55919e+16,168.082,2831.07,27457,129,26,26559,26313,23137,23600,19143
12973,2842,4203,0,12973,0,12973,5.74887e+17,95.6854,5405.23,12973,2023,110,8770,8770,6997,5787,5165
45594,9875,10635,0,45594,16033,29561,2.53352e+15,60.0728,13726.7,45594,5181,72,34959,34959,34039,32992,32670
26489,6544,6649,0,26489,0,26489,6.34525e+17,97.4066,8871,26489,3215,110,19840,19840,19720,19741,19743
33622,14071,14613,13023,20599,0,33622,7.30804e+12,56.8492,16499.2,33622,7119,72,19009,19009,18511,18901,17887
9868,2064,5426,9525,343,0,9868,1.33513e+18,82.5759,6159.1,9868,2615,97,4442,4442,3055,2676,2024
39745,4413,16731,0,39745,0,39745,4.90114e+17,92.9712,19226.3,39745,8110,110,23014,23014,13845,11252,6872
18514,704,5411,17504,1010,17504,1010,2.77169e+18,97.145,7004.61,18514,2570,111,13103,13030,6467,7838,1869
48617,535,1475,0,48617,47223,1394,3.77029e+16,290.657,5084.54,48617,244,26,47142,46204,41875,41064,22821
2591,800,920,2458,133,0,2591,1.9778e+18,81.2879,1283.68,2591,421,59,1671,1671,1551,1569,1554
18765,126,644,0,18765,18445,320,2.53824e+16,3.73435,2497.26,18765,324,4,18121,18121,15985,15912,9429
6137,136,459,0,6137,5956,181,4.33731e+16,19.6172,1130.31,6137,65,26,5678,5670,4736,4981,3151
41759,3498,9777,0,41759,14684,27075,2.52588e+15,60.0373,12652.4,41759,4758,72,31982,31982,21102,14307,11839
1407,253,387,0,1407,490,917,2.5495e+15,55.801,600.334,1407,184,49,1020,1020,861,683,752
19986,1506,4726,0,19986,0,19986,6.46076e+17,97.4289,6545.56,19986,2270,110,15260,15260,9645,7960,5759
8507,1000,2102,0,8507,0,8507,6.41175e+17,96.3978,3058.31,8507,992,107,6405,6405,5005,3717,3644
42652,154,176,42572,80,42652,0,5.98176e+18,172.132,2448.03,42652,173,171,41954,40779,37470,37661,37182
46978,7775,11376,0,46978,16594,30384,2.50207e+15,59.9382,14514.5,46978,5541,72,35602,35602,30374,27208,24085
19656,6829,10132,0,19656,4281,15375,1.34865e+13,8.9534,10413.9,19656,9111,11,9524,9524,7239,9524,7046
3187,305,1240,0,3187,1198,1989,2.04671e+15,56.1152,1583.18,3187,593,60,1947,1899,629,346,360
6828,1303,3340,5398,1430,6557,271,3.39624e+18,77.9815,3951.64,6828,1582,90,3488,3488,2155,2523,1661
35540,5686,16657,35540,0,34032,1508,4.72715e+18,555,18539.5,35540,7588,139,18883,18225,13371,15950,8001
34915,11411,12912,0,34915,0,34915,5.33472e+17,95.621,15318.5,34915,6267,110,22003,22003,21396,20970,21166
44783,4,14,43504,1279,44708,75,1.38736e+14,10.4023,632.329,44783,13,12,38891,34660,28944,29530,20749
19740,2435,5507,18647,1093,18647,1093,2.0193e+18,95.0568,7204.71,19740,2593,111,14233,14233,11475,12233,6874
48838,6378,11423,0,48838,0,48838,6.47859e+17,97.9021,15077.6,48838,5542,110,37415,37415,31701,31430,22076
27387,1209,1670,27387,0,26268,1119,2.49122e+18,17.9609,2314.42,27387,1129,23,25717,25717,24821,24248,20558
42412,9457,9949,39944,2468,0,42412,2.22565e+18,97.8617,13212.7,42412,4823,110,32463,32463,31815,31704,31343
8423,155,176,8419,4,8423,0,6.11324e+18,163.819,1136.71,8423,111,112,8179,8023,7408,7409,7329
43700,13118,18525,41770,1930,41770,1930,5.0868e+18,94.9871,21143.7,43700,8910,111,25175,25175,23996,25175,20437
38884,11497,21883,37591,1293,37591,1293,2.2953e+18,91.3905,23856.9,38884,10628,110,17001,17001,13921,16401,11217
2999,1219,1413,2999,0,2713,286,6.60343e+18,88.931,1711.99,2999,559,66,1586,1586,1483,1561,1465
37150,6730,11610,0,37150,13577,23573,2.27061e+15,58.7825,14001.4,37150,5652,72,25540,25540,21633,16384,15184
7430,93,176,7363,67,7430,0,6.02995e+18,160.376,1046.73,7430,111,116,6420,4198,3643,3841,3990
49494,4282,11562,46614,2880,46614,2880,3.22168e+18,97.9112,15259.8,49494,5608,110,37932,37932,27332,33136,15739
7310,1044,7310,0,7310,0,7310,1.36896e+13,0,7310,7310,3562,21,0,0,0,0,0
16918,3744,4437,15961,957,15961,957,3.29693e+18,96.9613,5995.81,16918,2134,110,12481,12481,11233,11755,10991
26739,813,12411,25639,1100,25639,1100,3.34558e+18,94.7219,14118.5,26739,5973,111,14328,13814,9545,8264,3538
25258,2176,5990,23793,1465,0,25258,2.22267e+18,97.5638,8161.46,25258,2888,110,19268,19268,14120,13305,7889
7679,86,175,7673,6,7679,0,5.99905e+18,159.851,1040.75,7679,117,120,6397,3750,3525,3737,3791
42355,2633,20750,0,42355,9292,33063,1.33818e+13,8.99736,21179.9,42355,18673,11,21605,21605,7233,21605,5482
18997,4784,9813,18997,0,14002,4995,4.04708e+18,202.738,10756.7,18997,4308,125,9184,9135,6413,7559,5009
13084,3780,6778,0,13084,2848,10236,1.34876e+13,8.89338,7005.66,13084,6096,11,6306,6306,4246,6306,4079
47912,5776,19371,47912,0,37139,10773,4.55619e+18,1119.57,21733,47912,5284,140,28541,27181,17708,20637,10444
36293,4,14,35260,1033,36221,72,1.38803e+14,10.5628,581.516,36293,13,12,31677,28207,23655,24196,18192
3320,335,858,3128,192,0,3320,2.23326e+18,93.6994,1336.44,3320,395,73,2462,2462,1669,1520,1216
4425,160,170,4419,6,4425,0,5.96692e+18,152.406,783.323,4425,97,95,4235,4162,4060,4053,4029
41513,3695,9718,39096,2417,39096,2417,3.38473e+18,97.7604,12928.8,41513,4706,110,31795,31795,19667,25134,13479
45177,99,176,45155,22,45177,0,5.98283e+18,169.664,2515.5,45177,170,172,40351,25268,23521,24928,25191
850,273,374,850,0,800,50,4.08757e+18,76.1506,507.365,850,103,43,476,476,470,471,448
40280,2734,17743,38565,1715,38565,1715,8.76262e+18,94.5769,20195.6,40280,8625,110,22537,22537,19003,18100,4736
31626,1379,1430,31626,0,30312,1314,2.28579e+18,17.3458,2123.3,31626,1323,21,30196,30196,30178,30196,29691
16922,3508,4550,6046,10876,0,16922,9.43498e+12,59.3208,5898.46,16922,2209,72,12372,12372,11100,12102,9115
14024,1450,3350,13204,820,0,14024,2.23014e+18,97.1615,4736.19,14024,1613,110,10674,10674,8008,7381,5098
9342,2533,3479,8889,453,8889,453,1.9419e+18,95.1311,4363.26,9342,1646,107,5863,5863,5358,5833,5052
2106,260,597,0,2106,745,1361,2.47723e+15,57.0171,880.3,2106,287,57,1509,1509,1148,1007,892
7831,352,727,0,7831,7599,232,4.96978e+16,53.7383,1728.76,7831,92,26,7104,7062,6543,6536,4624
28847,9033,10145,28847,0,27277,1570,4.18559e+18,203.281,11689.3,28847,4141,125,18702,18702,17987,18355,16930
27821,2212,10283,26489,1332,0,27821,1.83868e+18,95.5124,12304.1,27821,4978,110,17538,17538,11557,10438,4776
14857,1750,6420,14210,647,0,14857,1.66561e+18,89.6295,7587.1,14857,3091,110,8437,8437,5568,5803,4020
14935,2250,3575,0,14935,0,14935,6.45327e+17,97.162,5029.43,14935,1713,110,11360,11360,9581,8279,7650
5653,834,2034,2102,3551,0,5653,8.41224e+12,57.322,2567.78,5653,990,72,3619,3571,2672,3330,2428
45411,107,176,45333,78,45411,0,6.00161e+18,173.808,2568.3,45411,173,172,41466,29136,25476,26751,27838
14911,2926,3892,14071,840,14071,840,3.25343e+18,96.8628,5317.6,14911,1872,110,11019,11019,10168,10791,9122
18155,2355,5595,17185,970,17185,970,6.36266e+18,96.8925,7137.85,18155,2650,111,12560,12560,9377,10290,7566
26666,36,1162,0,26666,25888,778,4.14333e+16,247.66,3579.37,26666,179,26,24965,24879,15918,15496,4392
48578,13874,14605,17652,30926,0,48578,9.02062e+12,59.007,17626.6,48578,7108,72,33973,33973,33838,33943,33753
5871,35,254,0,5871,5705,166,3.53722e+16,19.8387,737.502,5871,47,26,5617,5617,3767,3762,1464
9613,203,2296,9053,560,0,9613,2.23448e+18,96.6823,3347.45,9613,1094,110,7317,7317,4447,3934,1120
19462,4190,4797,18342,1120,0,19462,2.19998e+18,97.354,6561.9,19462,2315,110,14665,14665,13984,13737,13174
38006,12214,13376,36136,1870,0,38006,1.88609e+18,93.5956,16004.9,38006,6483,110,24630,24630,24158,24088,23985
43610,8362,15497,43610,0,41210,2400,4.37356e+18,286.755,17304.5,43610,4942,136,28113,27919,20638,23517,15984
43285,8189,15189,0,43285,0,43285,5.49037e+17,95.8947,18101.3,43285,7361,110,28096,28096,23971,20387,17162
33758,10236,14260,0,33758,12991,20767,1.90629e+15,57.0294,16188.3,33758,6941,72,19498,19498,15432,13378,10641
20979,331,6594,20979,0,19759,1220,3.62269e+18,156.064,7861.59,20979,2534,124,14385,14276,5326,9677,1224
19474,272,7377,18554,920,18554,920,2.96026e+18,95.1713,8904.31,19474,3571,110,12097,11581,4512,7555,1659
18615,5292,5330,17597,1018,17597,1018,3.14489e+18,96.6351,6961.98,18615,2572,110,13285,13285,13259,13275,13277
44313,10102,10389,0,44313,0,44313,6.47237e+17,97.8672,13768.5,44313,5036,110,33924,33924,33571,33332,33403
4179,906,1049,3932,247,3932,247,5.815e+18,94.8315,1615.85,4179,492,81,3130,3130,3100,3100,2951
31178,272,2065,0,31178,6341,24837,1.46345e+16,12.0039,2642.37,31178,1255,20,29113,29113,17942,8206,23701
9344,1805,2240,8801,543,0,9344,2.23422e+18,96.5459,3269.23,9344,1060,110,7104,7104,6640,6492,6148
35134,4446,8450,0,35134,0,35134,6.42618e+17,97.6831,11244.7,35134,4094,110,26684,26684,22402,22257,15309
30255,2808,13705,28985,1270,28985,1270,3.79271e+18,92.6196,15608.4,30255,6573,111,16550,16550,11202,11471,5179
21194,8111,12897,8854,12340,0,21194,5.10202e+12,53.9839,13883.7,21194,6283,72,8297,8297,7223,8069,5613
36464,12928,15314,34854,1610,0,36464,1.69071e+18,94.1628,17645.4,36464,7439,110,21150,21150,20197,20032,19480
47977,9794,11058,47977,0,47977,0,2.52883e+18,5052.87,17291.9,47977,7384,27,36919,36066,35999,35292,34275
17669,1489,5852,17669,0,16639,1030,3.15023e+18,139.017,6855.34,17669,2117,124,11817,11747,6695,8549,3528
18326,281,6129,0,18326,0,18326,5.64884e+17,94.6686,7667.36,18326,2955,110,12197,11939,4613,864,48
37611,1377,1420,0,37611,36521,1090,4.05608e+16,285.831,4634.17,37611,232,26,36191,36191,36124,36113,35878
42119,4557,14329,15602,26517,0,42119,8.50871e+12,58.0113,16894.5,42119,6964,72,27790,27790,19577,25060,10088
7136,848,5007,6526,610,6956,180,4.28229e+18,139.842,5412.08,7136,2338,78,2129,1760,1072,1501,817
15299,1965,5915,14585,714,14585,714,2.96885e+18,94.7995,7176.26,15299,2854,110,9384,9384,4364,6436,2399
3472,484,967,3272,200,3272,200,3.24014e+18,92.1578,1448.72,3472,440,74,2505,2505,2115,2458,1686
4347,166,1559,0,4347,1613,2734,2.17531e+15,57.1291,1998.98,4347,758,72,2788,2740,1711,416,574
23412,3032,10405,0,23412,0,23412,4.70704e+17,91.6775,12018.3,23412,5028,110,13007,13007,8146,6027,4180
35348,9861,13083,35348,0,33498,1850,4.25009e+18,278.037,14872.1,35348,4801,135,22265,22238,19427,20619,17104
40384,4383,11216,0,40384,0,40384,6.10758e+17,97.127,14214.7,40384,5434,110,29168,29168,22056,15732,13398
10909,230,2716,10277,632,10277,632,1.16892e+18,97.2593,3844.36,10909,1270,111,8193,8193,7356,7256,1294
28677,546,1421,0,28677,27829,848,4.53925e+16,239.706,4381.95,28677,233,26,27256,26373,24500,24413,10930
37780,7949,18529,0,37780,0,37780,3.42211e+15,17.979,19094,37780,16660,20,19251,19251,8770,10447,8309
7174,22,176,7172,2,7174,0,6.04175e+18,150.903,1042.22,7174,108,112,3058,632,879,990,968
18601,3503,10432,18601,0,0,18601,8.94972e+17,17.9343,10788,18601,9374,20,8169,8169,2929,5820,2746
33578,32,1011,0,33578,32620,958,3.55567e+16,207.067,3335.89,33578,151,26,32201,32178,19814,19654,5818
31181,1990,7281,10967,20214,0,31181,9.89547e+12,60.0201,9546.6,31181,3547,72,23900,23900,16270,22582,7019
26600,4801,6537,25061,1539,25061,1539,2.18011e+18,98.015,8734.09,26600,3085,111,20063,20063,18469,19353,15511
46298,6184,10808,16270,30028,0,46298,9.86852e+12,60.0624,13944.2,46298,5257,72,35490,35490,29919,34330,20594
22336,619,12093,4828,17508,0,22336,53047900000,8.98603,12383.8,22336,10877,11,10243,10243,2881,10243,2355
41150,6766,9557,0,41150,14457,26693,2.53592e+15,60.0782,12403.3,41150,4655,72,31593,31593,27456,22286,22515
42262,1588,12311,39990,2272,39990,2272,3.23536e+18,96.9245,15373.5,42262,5967,110,29951,29951,13965,20656,6896
6075,199,208,6068,7,6075,0,6.06664e+18,181.049,1032.13,6075,107,111,5853,5794,5687,5699,5685
23106,748,7230,17917,5189,21766,1340,5.36917e+18,163.032,8584.9,23106,2775,125,15876,15742,7286,11007,2160
30187,6907,7075,0,30187,10605,19582,2.52549e+15,59.978,9283.35,30187,3437,72,23112,23112,22899,22784,22780
13149,160,176,13145,4,13149,0,6.07333e+18,165.367,1418.42,13149,130,134,12884,12683,11879,11867,11751
18990,3783,6263,18020,970,18020,970,2.99678e+18,95.9653,7849.16,18990,3023,110,12727,12727,11041,12271,8396
11782,9,13,11438,344,11739,43,1.73419e+14,10.8803,354.044,11782,12,11,11633,11518,11191,10573,9763
17736,4534,4540,0,17736,6294,11442,2.45166e+15,59.4974,5957.23,17736,2198,72,13196,13196,13196,13196,13196
47686,5460,11107,0,47686,16766,30920,2.5348e+15,60.0849,14317.7,47686,5410,72,36579,36579,28304,17852,18250
35501,5581,10429,33594,1907,0,35501,2.05535e+18,96.845,13092.2,35501,5057,110,25072,25072,20219,19160,14707
8079,233,502,0,8079,0,8079,3.76497e+18,15.961,827.642,8079,341,18,7577,7577,5099,4153,4643
36294,17,595,0,36294,33342,2952,2.92627e+16,10.197,1323.36,36294,584,12,35699,35663,33456,26642,31896
30394,13788,15901,29286,1108,29286,1108,9.97235e+18,93.2001,17649.7,30394,7729,110,14493,14493,14298,14282,13855
8649,789,3170,0,8649,3239,5410,2.11142e+15,57.4984,3896.53,8649,1537,72,5479,5431,3399,2762,2490
44092,4923,10295,15510,28582,0,44092,9.87749e+12,60.0621,13305.9,44092,5010,72,33797,33797,26052,32462,16672
26795,10,13,26013,782,26778,17,1.60471e+14,10.1348,483.219,26795,11,12,26722,26643,25876,25875,23084
12906,900,4121,12228,678,0,12906,1.9999e+18,95.8593,5319.25,12906,1989,110,8785,8703,5362,4602,1625
27619,2352,6416,9699,17920,0,27619,9.90092e+12,60.0118,8476.63,27619,3120,72,21203,21203,15286,20183,8147
16765,2324,4071,15785,980,15785,980,3.38272e+18,97.8312,5625.51,16765,1913,111,12694,12694,9411,10084,8081
41371,1995,11365,0,41371,0,41371,6.13448e+17,97.2124,14434,41371,5512,110,30006,30006,15222,7782,5876
1727,6,11,1675,52,1726,1,1.38211e+14,10.4163,115.753,1727,11,11,1641,1602,1170,1209,1162
36879,1724,8586,12955,23924,0,36879,9.90175e+12,60.0596,11186.3,36879,4182,72,28293,28293,13347,24251,6171
48084,1844,13925,0,48084,0,48084,6.00727e+17,97.0012,17323,48084,6761,110,34159,34159,16341,8263,6372
41889,15,16,40641,1248,41805,84,1.91299e+14,10.3581,726.173,41889,13,12,41873,41873,41782,41783,41654
28855,52,176,28846,9,28855,0,5.98221e+18,169.737,2013.62,28855,167,164,18696,9243,7416,8642,8465
31308,12622,12921,29908,1400,29908,1400,8.35758e+18,94.9283,15018.5,31308,6270,110,18387,18387,18248,18239,18003
19176,2838,4502,0,19176,6733,12443,2.52825e+15,59.869,6040.42,19176,2184,72,14674,14674,12349,12823,9654
49477,15498,15729,49477,0,46597,2880,3.92494e+18,338.018,17754,49477,5301,133,33748,33748,33748,33748,33573
3708,990,2203,0,3708,0,3708,3.60255e+17,88.9633,2541.52,3708,1047,68,1505,1427,1296,1102,1302
21587,9,11,20973,614,21579,8,1.39179e+14,10.1231,410.988,21587,11,11,21305,20946,20140,20162,19742
7171,2279,3826,7171,0,0,7171,8.87848e+17,17.4648,4050.73,7171,3428,20,3345,3345,2050,2414,2066
8685,1024,2145,0,8685,0,8685,6.40865e+17,96.4159,3115.82,8685,1010,107,6540,6540,5128,3395,3722
2747,613,1802,1152,1595,0,2747,4.68872e+12,26.4878,2004.39,2747,860,52,945,945,945,945,945
25833,54,1089,0,25833,25084,749,4.03732e+16,239.5,3342.97,25833,167,26,24328,24230,19563,17306,4055
5558,2185,2455,5558,0,5288,270,3.7475e+18,88.7402,2932.61,5558,1003,93,3103,3103,2930,3019,2849
28324,4471,14124,0,28324,11284,17040,1.65795e+15,55.5489,15625.9,28324,6873,72,14200,14200,9786,9899,5086
46437,1560,14753,46366,71,43729,2708,4.5019e+18,317.648,16683.8,46437,2921,137,31684,31082,14646,21021,4037
36749,728,8676,34618,2131,0,36749,2.2211e+18,97.634,11587.7,36749,4195,110,28073,28073,17275,14977,3794
13486,2109,3179,12696,790,12696,790,5.84623e+18,97.1649,4531.53,13486,1524,110,10307,10307,10041,10044,7420
46396,6907,10868,43696,2700,0,46396,2.2275e+18,97.8633,14373,46396,5268,110,35528,35528,30174,29131,23689
14255,203,7043,0,14255,5663,8592,1.67764e+15,54.6526,7937.75,14255,3408,72,7212,6924,4079,243,446
11779,2458,3684,11159,620,0,11779,2.01616e+18,95.8127,4818.13,11779,1770,110,8095,8095,7167,6869,6580
45637,3917,13195,43156,2481,43156,2481,3.83981e+18,97.5824,16387.1,45637,6291,111,32442,32442,18206,22134,10926
28730,1168,13598,28730,0,19035,9695,4.87178e+18,323.609,14954,28730,5917,132,15132,14413,7786,10268,2150
13756,1636,4794,0,13756,0,13756,5.58305e+17,95.3979,6011.4,13756,2317,110,8962,8962,5092,5338,3629
4942,2318,2814,4772,170,4772,170,3.29305e+18,81.0613,3244.51,4942,1345,72,2128,2128,2128,2128,2128
28289,124,176,28276,13,28289,0,5.9799e+18,169.781,1994.03,28289,166,163,26722,24464,19760,19882,20137
1366,185,417,1286,80,1286,80,4.83562e+18,87.9956,656.464,1366,177,51,949,949,713,832,578
24692,3972,5843,0,24692,0,24692,6.49126e+17,97.6049,7974.61,24692,2827,110,18849,18849,16366,15446,13599
5490,2261,3500,5330,160,5330,160,3.07775e+18,75.1157,3909.15,5490,1676,70,1990,1990,1942,1850,1331
36021,3517,9059,0,36021,12782,23239,2.47053e+15,59.7532,11559.7,36021,4408,72,26962,26962,19384,12688,10239
15098,747,8971,0,15098,6260,8838,1.35353e+15,50.9272,9759.36,15098,4353,72,6127,5839,3543,1915,645
22430,2480,7286,21278,1152,21278,1152,3.16321e+18,94.0684,9094.18,22430,3516,110,15144,15144,9276,11701,7062
41318,1182,13709,0,41318,15235,26083,2.20555e+15,57.7593,16259.2,41318,6661,72,27609,27609,11309,7832,4322
44285,398,11683,0,44285,0,44285,6.22101e+17,97.3939,14957.5,44285,5668,110,32602,32344,19472,6292,3272
10558,2994,3254,3839,6719,0,10558,9.00846e+12,58.5286,4152.81,10558,1579,72,7304,7304,6955,7244,6695
27423,2143,6742,9693,17730,0,27423,9.7343e+12,59.7885,8760.44,27423,3279,72,20681,20681,14652,19641,7403
26943,1837,9528,25603,1340,25603,1340,2.45044e+18,96.4291,11500.6,26943,4559,111,17415,17415,12121,8948,4581
27559,753,862,0,27559,26698,861,0.0312421,0.968722,4873.71,27559,862,1,26697,26697,26697,26697,26697
49791,10618,17618,18562,31229,0,49791,8.32341e+12,58.1636,20509.9,49791,8576,72,32173,32173,30648,31853,28262
695,160,262,0,695,0,695,6.9374e+17,77.1784,393.782,695,104,39,433,433,322,320,348
33855,1427,9842,32028,1827,32028,1827,3.07e+18,96.8772,12417.2,33855,4767,110,24013,24013,13384,17265,4421
37831,7200,9122,35631,2200,35631,2200,5.85332e+18,98.2625,12021.4,37831,4315,111,28709,28709,27369,27927,23576
34486,9,15,33467,1019,34394,92,1.75165e+14,10.4138,635.259,34486,14,12,34129,33776,32440,30505,26991
16698,4622,8309,16058,640,16058,640,2.55517e+18,91.5504,9473.65,16698,4010,110,8389,8389,6115,6919,5736
20262,3611,7785,0,20262,7657,12605,2.03864e+15,57.51,9139.17,20262,3783,72,12477,12477,9311,7045,5591
26799,4456,11004,10257,16542,0,26799,7.60547e+12,46.1118,12637.6,26799,5340,72,15795,15795,15370,15705,14849
38183,2637,9157,35963,2220,35963,2220,3.51052e+18,98.2636,12083.3,38183,4322,111,29026,29026,16732,19358,9749
30952,6,11,30070,882,30943,9,1.38946e+14,10.1409,493.188,30952,11,11,29436,28687,26035,26054,21296
6693,1221,2574,6693,0,6335,358,3.86699e+18,93.1832,3142.81,6693,1023,99,4119,4119,2671,3349,2033
25670,510,899,0,25670,24938,732,3.62871e+16,158.719,2778.43,25670,129,26,24771,24526,23326,23547,17871
2027,314,1319,1965,62,0,2027,1.17539e+18,85.1105,1511.56,2027,619,52,708,622,524,461,618
26408,6793,15917,25608,800,0,26408,1.1641e+18,89.056,17291.5,26408,7715,110,10491,10491,7898,6951,4996
24350,3580,10747,23312,1038,23312,1038,2.64149e+18,94.3338,12412.3,24350,5207,110,13603,13603,10082,11205,5507
10039,3171,5212,9667,372,9667,372,7.37849e+18,87.3735,5981.99,10039,2488,104,4827,4827,4343,4800,4096
49628,1773,25554,10810,38818,0,49628,52616900000,8.99285,26007.4,49628,22990,11,24074,24074,6974,24074,5256
11759,3,11,11420,339,11753,6,1.45513e+14,10.3829,308.374,11759,11,11,8942,6466,7019,7536,4872
31399,1643,7366,29569,1830,0,31399,2.22922e+18,97.7875,9943.34,31399,3569,110,24033,24033,16297,14783,6807
8888,1509,2709,8418,470,0,8888,2.04293e+18,95.4292,3638.66,8888,1286,104,6179,6179,4925,4460,3098
46618,1378,10873,0,46618,16395,30223,2.52765e+15,60.0716,14028.3,46618,5284,72,35745,35745,22006,4900,5152
47423,12378,26578,0,47423,19403,28020,1.45023e+15,54.8635,28611.8,47423,12936,72,20845,20845,17184,12409,11463
12592,654,2960,0,12592,0,12592,6.54118e+17,97.173,4245.68,12592,1423,110,9632,9632,6466,3840,2751
3289,1211,1521,3289,0,3131,158,5.01279e+18,90.626,1854.53,3289,626,72,1768,1768,1535,1672,1565
28596,731,9998,0,28596,10641,17955,2.14777e+15,57.9094,11855,28596,4856,72,18598,18565,11075,7174,2027
11777,2880,3679,0,11777,0,11777,5.85998e+17,91.0196,4815.1,11777,1751,110,8098,8098,7838,7948,7748
14002,54,175,13934,68,14002,0,5.98273e+18,164.632,1402.69,14002,143,142,9207,4633,3783,4449,4271
49901,741,11659,46997,2904,0,49901,2.22766e+18,97.9081,15377,49901,5658,110,38242,38242,12801,10721,4741
49218,22036,27821,34146,15072,47578,1640,3.71985e+18,91.4102,30134.4,49218,13432,111,21397,21397,19062,19508,18849
30048,3149,9803,30048,0,28301,1747,4.14879e+18,197.277,11215.5,30048,3594,122,20245,20009,12229,15824,7038
23610,3642,9935,23610,0,21396,2214,5.29013e+18,165.256,11071.8,23610,2741,131,13675,13659,9895,11661,4965
4400,1008,2180,4222,178,0,4400,1.53092e+18,90.528,2625.11,4400,1037,76,2220,2147,1836,1614,1664
48496,2711,17566,0,48496,0,48496,5.39389e+17,95.8696,20708.2,48496,8533,110,30930,30930,16096,8115,6251
4286,117,193,0,4286,4163,123,3.53899e+16,19.7937,565.293,4286,42,26,4093,4093,3902,3915,2977
13826,1931,4326,5044,8782,0,13826,8.92655e+12,58.4677,5422.26,13826,2106,72,9500,9500,6369,8960,2745
47853,9608,19630,0,47853,0,47853,4.98762e+17,95.076,22552.9,47853,9537,110,28223,28223,24053,18353,17162
46686,517,1333,0,46686,45028,1658,1.14539e+16,7.94319,7255.33,46686,340,10,45353,45353,43112,43988,35389
24139,543,1251,0,24139,23426,713,4.51976e+16,233.127,3755.49,24139,196,26,22888,22221,20742,21360,15820
44569,287,1214,0,44569,43298,1271,3.55187e+16,249.847,4210.39,44569,191,26,43252,42735,36699,36788,17015
39367,6,12,38243,1124,39349,18,1.38868e+14,10.2429,561.089,39367,11,12,37397,36333,32856,32634,23397
1634,670,1041,0,1634,0,1634,3.74491e+17,84.0055,1207.18,1634,487,54,593,507,535,444,566
44895,7767,12116,0,44895,0,44895,6.1757e+17,97.2847,15402.5,44895,5875,110,32779,32779,28658,28297,21813
23063,1,14,22374,689,23006,57,1.88488e+14,10.3974,503.446,23063,13,11,3742,3742,3742,3742,3742
46997,2958,29659,0,46997,0,46997,3.12646e+17,89.0857,31665.9,46997,14408,110,17338,17338,9720,4446,2660
4805,2,12,4660,145,4795,10,2.19966e+14,10.3619,206.247,4805,12,11,3013,2617,1284,2627,850
34756,1129,8208,32737,2019,0,34756,2.22278e+18,97.614,10991.7,34756,3974,110,26548,26548,10994,9788,5002
5747,1170,1964,0,5747,0,5747,5.68161e+17,86.3468,2617.14,5747,929,86,3783,3783,3023,2010,2099
26615,858,8668,26615,0,25058,1557,4.74729e+18,169.305,9969.68,26615,3163,124,17947,17774,8060,12387,2349
20630,4651,8192,0,20630,7839,12791,2.00221e+15,57.351,9542.34,20630,3990,72,12438,12438,10920,10492,8528
36731,3184,11190,36731,0,34594,2137,4.2811e+18,263.438,13088.9,36731,4369,125,25541,25151,15958,19971,8433
13764,3077,7215,13764,0,13764,0,2.87541e+18,17.9523,7536.75,13764,6487,20,6549,6549,2856,2712,2775
26403,7520,10522,25183,1220,25183,1220,2.99618e+18,95.6886,12361.4,26403,5044,111,15881,15881,15881,15575,12070
10073,3229,4313,3881,6192,0,10073,7.41916e+12,50.2927,5069.5,10073,2078,72,5760,5760,4874,5603,3953
27115,5959,6369,9538,17577,0,27115,9.8606e+12,59.9636,8393.31,27115,3097,72,20746,20746,20165,20639,19637
6984,9,11,6781,203,6977,7,1.623e+14,10.2162,243.925,6984,11,11,6898,6806,6632,6633,6123
3693,601,968,0,3693,1304,2389,2.47263e+15,58.2616,1402.03,3693,465,67,2725,2725,2279,1826,1727
48059,10344,11219,0,48059,16894,31165,2.52429e+15,60.0235,14452,48059,5451,72,36840,36840,35797,35613,34193
36419,665,8528,34299,2120,0,36419,2.22901e+18,97.797,11421.7,36419,4127,110,27891,27891,17219,15038,3913
6389,356,2268,6069,320,6069,320,2.99211e+18,85.3614,2962.03,6389,1082,89,4121,4121,2449,3069,1495
10354,2662,3539,10354,0,9754,600,3.70761e+18,92.2823,4253.47,10354,1263,118,6815,6815,5915,6317,5518
24545,11,938,0,24545,23840,705,3.77183e+16,187.955,2865.69,24545,136,26,21648,19942,16822,15979,3586
45585,8527,10673,42928,2657,0,45585,2.22653e+18,97.8998,14127.2,45585,5180,110,34912,34912,32052,31450,28797
37820,10327,17818,0,37820,0,37820,4.47373e+17,94.0415,20055.4,37820,8656,110,20002,20002,16541,13957,13285
28197,1,14,27379,818,28145,52,1.61955e+14,10.3971,529.855,28197,12,11,5990,5990,5990,5990,5990
5914,1537,2903,1298,4616,0,5914,52307400000,8.95046,3058.06,5914,2609,11,3011,3011,1925,3011,1805
18925,787,8839,18925,0,14398,4527,5.06761e+18,182.503,9808.96,18925,2057,126,10086,9691,4974,6694,945
6701,930,2639,6701,0,6351,350,4.52676e+18,92.9158,3203.54,6701,1050,105,4062,4062,2901,3316,2288
3098,26,940,2928,170,0,3098,2.10036e+18,87.8635,1378.63,3098,433,67,882,102,287,458,0
25114,1015,5885,23651,1463,23651,1463,5.86865e+18,97.6533,8055.1,25114,2843,110,19229,19229,17511,16259,4474
39951,5506,11650,37801,2150,37801,2150,6.74112e+18,96.9187,14579.1,39951,5651,110,28301,28301,27271,27271,15915
43335,13,17,42035,1300,43229,106,1.96718e+14,10.2789,748.526,43335,14,12,43318,43318,42461,42350,38054
40566,6,16,39383,1183,40483,83,1.65543e+14,10.4538,653.582,40566,14,13,38817,37902,30352,28802,19346
44901,6549,14345,44901,0,42291,2610,4.94687e+18,315.818,16233.2,44901,4570,136,30556,30364,23361,27347,15567
19775,6454,10489,19775,0,19015,760,5.6626e+18,255.754,11564.6,19775,3314,129,9286,9167,7699,8835,5997
1267,136,492,1200,67,1200,67,1.82881e+18,77.1168,698.138,1267,205,46,775,486,410,554,383
47316,22347,47316,47316,0,0,47316,7.99983,0,47316,47316,47316,1,0,0,0,0,0
45153,8,14,43865,1288,45074,79,1.38945e+14,10.3806,631.847,45153,14,12,44095,43265,41354,41195,36542
27197,8332,14324,0,27197,10966,16231,1.56677e+15,55.1416,15714.2,27197,6961,72,12873,12873,10962,8313,7911
47755,19234,22038,0,47755,18721,29034,1.77551e+15,55.5479,24447.4,47755,10722,72,25717,25717,23947,22874,21979
4109,1983,2108,0,4109,0,4109,3.4478e+15,17.8382,2278.67,4109,1889,20,2001,2001,1887,2001,1934
27842,718,12675,10879,16963,0,27842,7.03084e+12,55.3067,14255.6,27842,6160,72,15167,14879,8486,10015,148
38238,2720,10500,36108,2130,36108,2130,2.32375e+18,97.7668,13318.5,38238,4991,111,27738,27738,17105,21366,8153
20865,7367,7730,20865,0,19725,1140,3.9424e+18,154.438,8813.58,20865,2981,121,13135,13135,12927,13034,12730
47670,103,176,47592,78,47670,0,5.98018e+18,171.879,2586.64,47670,171,172,43124,27833,25558,26899,27413
21451,18888,20050,0,21451,0,21451,6.03767e+17,3.98401,20121,21451,6700,9,1401,1401,1321,1321,1328
31911,13898,15128,0,31911,12564,19347,1.73842e+15,55.3348,16838.2,31911,7351,72,16783,16783,15827,15538,14819
6108,374,1504,0,6108,0,6108,6.43957e+17,95.6496,2254.86,6108,701,92,4604,4604,3090,1673,1505
14581,706,7212,14581,0,13941,640,5.42773e+18,141.407,8003.47,14581,3086,121,7369,6876,3871,5349,1463
25214,6094,6127,23752,1462,23752,1462,2.45971e+18,98.0274,8245.03,25214,2881,111,19087,19087,19068,19074,19087
22450,558,8138,21354,1096,21354,1096,7.59784e+18,95.5386,9865.79,22450,3941,110,14312,13993,11165,9112,2716
23184,4513,5448,21834,1350,21834,1350,5.74176e+18,97.5701,7486.79,23184,2623,110,17736,17736,17165,17074,15233
20286,1898,8640,7826,12460,0,20286,7.43758e+12,56.1891,9924.51,20286,4203,72,11646,11646,6733,10081,3747
24289,4895,5714,0,24289,0,24289,6.46953e+17,97.5669,7826.97,24289,2752,110,18575,18575,17666,17077,16464
9141,24,667,0,9141,8874,267,4.31668e+16,19.543,1620.06,9141,85,26,8470,8050,6141,5434,1365
34758,267,1490,0,34758,33741,1017,4.29365e+16,287.861,4759.66,34758,244,26,33022,32314,24235,24043,12005
1250,1,10,1216,34,1250,0,1.3736e+14,9.3872,96.3534,1250,10,10,329,329,329,329,329
28359,1068,6645,0,28359,9974,18385,2.52981e+15,59.9886,8745.52,28359,3232,72,21714,21714,13544,5601,3620
15952,3731,5335,15142,810,15142,810,3.14559e+18,94.6882,6722.03,15952,2557,110,10617,10617,8198,9213,7484
17843,9438,9512,0,17843,0,17843,3.46959e+15,17.8641,9876.36,17843,8552,20,8331,8331,8267,8271,8303
32588,4346,8005,0,32588,0,32588,6.38734e+17,97.5285,10628.9,32588,3875,110,24583,24583,20783,21674,14540
43393,7,15,42142,1251,43304,89,1.51398e+14,10.5767,683.161,43393,13,12,41991,41043,32475,32211,28944
30084,161,1241,0,30084,29211,873,4.10492e+16,261.013,3904.82,30084,194,26,28460,28172,20813,19552,9269
4569,1153,2082,4376,193,0,4569,1.63593e+18,79.7269,2564.32,4569,975,79,2487,2487,2111,2085,1902
20517,124,8450,0,20517,0,20517,5.00931e+17,94.7272,9969.25,20517,4097,110,12067,5804,4579,992,1167
46752,676,10851,16428,30324,0,46752,9.8817e+12,60.0683,14016.4,46752,5272,72,35901,35901,21038,33341,2779
25022,2795,5896,0,25022,8802,16220,2.51973e+15,59.9212,7794.88,25022,2858,72,19126,19126,14669,12421,9334
31782,1903,16984,31782,0,30652,1130,5.00958e+18,1045.11,18780.3,31782,6812,139,14798,12947,6614,9591,2622
6596,1908,2695,6596,0,6249,347,3.68072e+18,91.4851,3211.61,6596,1013,107,3901,3901,3804,3843,3247
39472,8998,15241,37625,1847,0,39472,1.78834e+18,95.4248,17831.4,39472,7404,110,24231,24231,23347,23182,22741
8596,1228,2078,0,8596,3032,5564,2.52906e+15,59.4588,2903.61,8596,1006,72,6518,6518,5377,4631,4180
16807,1455,4301,15847,960,15847,960,4.17754e+18,97.6078,5843.84,16807,2031,111,12506,12506,7529,8851,5391
28365,4456,6673,26715,1650,26715,1650,3.3628e+18,97.733,9055.94,28365,3231,110,21692,21692,17277,19246,15349
43352,10148,18761,43352,0,41372,1980,4.56349e+18,1014.24,20942.7,43352,5554,139,24591,23644,16677,19859,10622
39494,728,9453,37194,2300,37194,2300,2.34758e+18,98.3089,12457.5,39494,4471,111,30041,30041,14007,17313,4197
33989,2779,7931,11951,22038,0,33989,9.8942e+12,60.0267,10363,33989,3858,72,26058,26058,18521,24757,9379
46044,13987,15444,43716,2328,0,46044,1.93395e+18,89.9525,18559.4,46044,7500,110,30600,30600,28694,28274,26682
34778,11,12,33787,991,34762,16,1.39702e+14,10.3639,530.942,34778,12,11,34766,34766,34471,34472,34332
3926,771,1028,0,3926,1381,2545,2.45527e+15,58.354,1483.79,3926,491,66,2898,2898,2705,2573,2528
36823,5,14,35776,1047,36749,74,1.39129e+14,10.4889,575.338,36823,13,12,33953,30400,28902,28473,18818
35368,368,12386,13158,22210,0,35368,8.35624e+12,58.1381,14584.2,35368,6020,72,22982,22694,13289,21315,1515
21762,1298,7866,0,21762,8137,13625,2.11128e+15,57.8807,9339.43,21762,3827,72,13896,13896,8808,2576,2782
35793,8195,16407,0,35793,14007,21786,1.79381e+15,56.4648,18320.1,35793,7993,72,19386,19386,15564,13284,11110
36045,11121,15839,36045,0,34405,1640,4.59809e+18,396.939,17684.4,36045,5802,135,20206,20058,16484,18417,9780
11001,994,3935,10461,540,10461,540,3.04517e+18,94.9582,4962.06,11001,1887,110,7066,6980,4405,5456,3638
12552,725,7600,0,12552,0,12552,3.37008e+17,86.9935,8393.62,12552,3661,104,4952,4553,2512,603,241
8940,3737,3973,8556,384,0,8940,1.64477e+18,93.3475,4764.18,8940,1914,104,4967,4967,4856,4760,4872
41143,11670,16661,41143,0,39143,2000,4.79545e+18,462.248,18704.5,41143,6724,137,24482,24298,21958,23328,17421
13625,608,834,0,13625,13227,398,4.35572e+16,134.637,2236.45,13625,115,26,12791,12623,12023,11995,10423
32073,8529,15131,30783,1290,30783,1290,9.36732e+18,92.575,17102.8,32073,7330,110,16942,16942,16302,16302,9480
10336,3443,5314,9946,390,9946,390,3.6479e+18,87.0019,6109.03,10336,2528,105,5022,5022,4300,4983,3876
4961,195,1235,4671,290,0,4961,2.23734e+18,95.2747,1877.57,4961,579,86,3726,3726,1448,1432,902
24905,6205,7001,0,24905,8963,15942,2.3744e+15,59.2269,8802.7,24905,3403,72,17904,17904,17145,16071,16053
43655,1597,17933,0,43655,16721,26934,1.94226e+15,56.89,20342.5,43655,8722,72,25722,25722,14748,7932,1444
12002,2274,6152,12002,0,11512,490,5.6798e+18,149.313,6901.55,12002,1634,117,5850,5725,4140,4429,2747
17011,2665,4005,0,17011,5980,11031,2.53472e+15,59.8442,5402.49,17011,1948,72,13006,13006,11370,9222,8773
17521,4068,4925,6305,11216,0,17521,9.30605e+12,59.1371,6290.27,17521,2393,72,12596,12596,11503,12406,10359
32301,1217,7545,11354,20947,0,32301,9.88554e+12,60.0197,9879.35,32301,3669,72,24756,24756,15496,23156,4187
17960,444,721,0,17960,17450,510,3.55434e+16,47.6203,2033.26,17960,93,26,17239,17209,15532,15690,11717
45389,1202,2252,0,45389,44035,1354,4.8257e+16,328.675,7270.09,45389,399,26,43137,43137,40903,40303,27536
45631,1279,16872,43431,2200,43431,2200,2.98437e+18,96.3502,19777.6,45631,8095,111,28759,28672,12341,14751,5826
43894,23312,24089,42384,1510,0,43894,1.31686e+18,92.0763,26307.9,43894,11710,110,19805,19805,19353,19225,19223
19507,6145,8305,19507,0,18539,968,4.53116e+18,162.472,9311.45,19507,2265,129,11202,11192,10596,11200,9746
15029,4862,6799,0,15029,0,15029,4.66609e+17,92.5278,7948.66,15029,3285,110,8230,8230,7885,7821,7610
47024,854,24249,45294,1730,45294,1730,1.00168e+19,92.8417,26722.9,47024,11772,110,22775,21438,3261,17672,3657
48408,11044,14269,0,48408,0,48408,5.96892e+17,96.9341,17663.8,48408,6931,110,34139,34139,31876,29360,28321
29467,11370,11616,11203,18264,0,29467,7.82934e+12,57.4709,13411.2,29467,5656,72,17851,17851,17632,17812,17573
38448,2222,16767,0,38448,0,38448,4.77693e+17,93.8714,19147.6,38448,8133,110,21681,21681,13257,6442,3927
13562,607,3595,4840,8722,0,13562,9.51795e+12,59.3425,4736.59,13562,1747,72,9967,9957,3444,8158,1123
29097,6225,6745,0,29097,10220,18877,2.54034e+15,60.0416,8893.42,29097,3285,72,22352,22352,21593,21771,20836
41300,1,15,40110,1190,41211,89,1.49829e+14,10.5781,664.023,41300,13,12,9724,9724,9724,9724,9724
1352,47,71,0,1352,1313,39,3.52827e+16,19.0799,214.614,1352,27,25,1281,1281,1232,1238,1060
14643,5167,5977,13973,670,13973,670,5.28524e+18,94.8245,7150.49,14643,2841,111,8666,8666,7161,7582,6670
14609,2735,4052,13799,810,0,14609,2.11648e+18,96.6178,5428.32,14609,1955,110,10557,10557,9054,8525,6839
48649,7924,20907,18802,29847,0,48649,7.35496e+12,56.8026,23467.1,48649,10180,72,27742,27742,19877,26394,10491
6113,505,1499,0,6113,0,6113,6.49455e+17,95.759,2250.57,6113,704,93,4614,4614,2907,2602,1955
27629,5311,6485,0,27629,9720,17909,2.52587e+15,59.9682,8540.26,27629,3154,72,21144,21144,19423,17339,17470
30760,3635,8329,29057,1703,0,30760,2.12425e+18,97.1277,10771.2,30760,4027,110,22431,22431,16770,15733,10366
47570,2,14,46212,1358,47486,84,1.38957e+14,10.491,671.779,47570,13,12,27540,19506,19007,20177,16044
31088,1464,8259,29348,1740,0,31088,2.14032e+18,97.2875,10733.5,31088,4004,110,22829,22829,11968,10461,6139
43860,8871,12116,0,43860,0,43860,6.12682e+17,97.2016,15320.4,43860,5884,110,31744,31744,28600,26245,25129
33283,615,10946,31583,1700,0,33283,1.9553e+18,96.2597,13378.3,33283,5313,110,22337,21832,13417,11744,2927
7896,9,12,7665,231,7886,10,1.66653e+14,10.0889,260.216,7896,12,11,7807,7733,6512,6544,6655
40813,14328,14953,15311,25502,0,40813,8.17067e+12,57.8175,17372.7,40813,7271,72,25860,25860,25223,25726,24308
8199,207,2659,8199,0,7726,473,4.33559e+18,93.6841,3341.01,8199,722,114,5540,5460,3517,4135,717
5986,353,2592,3981,2005,5719,267,6.42491e+18,84.6022,3190.18,5986,1222,90,3394,3307,2023,2552,1400
42830,9775,9942,0,42830,15047,27783,2.53795e+15,60.0807,12881.8,42830,4843,72,32888,32888,32692,32585,32521
4132,456,1064,3892,240,3892,240,3.1379e+18,95.0983,1623.39,4132,486,81,3068,3068,2268,2751,1697
13460,157,3185,12678,782,0,13460,2.23639e+18,97.0939,4536.07,13460,1519,110,10275,10275,3030,2415,1176
14608,1470,3497,0,14608,0,14608,6.47059e+17,97.1624,4926.75,14608,1682,110,11111,11111,8423,6208,5393
5961,75,208,5955,6,5961,0,6.03915e+18,171.18,1009.77,5961,106,108,4659,2877,2109,2333,2273
5291,328,1825,5291,0,4981,310,5.96164e+18,90.9643,2306.48,5291,640,94,3466,3466,1939,2695,946
15169,1493,4766,15169,0,14287,882,5.58507e+18,125.086,5786.18,15169,1795,120,10403,10364,7582,8786,3707
47505,1099,11400,44745,2760,44745,2760,2.04548e+18,98.3371,14873.3,47505,5399,111,36105,36105,15540,23687,5719
9402,3013,3109,3461,5941,0,9402,8.67133e+12,58.1031,3916.74,9402,1504,72,6293,6293,6198,6273,6152
30223,7890,8173,10814,19409,0,30223,9.39932e+12,59.4063,10299.7,30223,3969,72,22050,22050,21731,21980,21365
16325,3351,9855,6810,9515,0,16325,5.16729e+12,54.0249,10675.2,16325,4801,72,6470,6422,5879,6294,5858
25127,446,9231,9421,15706,0,25127,8.17898e+12,56.6298,10869.1,25127,4480,72,15896,15645,8200,12950,1725
29390,10420,10676,11008,18382,0,29390,8.20645e+12,57.946,12543.1,29390,5189,72,18714,18714,18532,18684,18486
23182,1147,7686,8553,14629,0,23182,8.64537e+12,58.4217,9292.51,23182,3740,72,15496,15496,9623,14486,2637
12673,2723,3965,12011,662,0,12673,2.01265e+18,95.768,5159.21,12673,1900,110,8708,8708,7957,7602,7033
41615,6448,17918,0,41615,16080,25535,1.88072e+15,56.9266,20170.7,41615,8723,72,23697,23697,16692,13078,8371
40450,1632,9504,0,40450,0,40450,6.4668e+17,97.8304,12649.8,40450,4600,110,30946,30946,14150,9358,6896
28663,5034,8684,27142,1521,27142,1521,6.90799e+18,96.6104,10914.1,28663,4209,110,19979,19979,19405,19408,13316
11858,972,2828,0,11858,4167,7691,2.53002e+15,59.6494,3883.24,11858,1370,72,9030,9030,6420,4856,3379
7423,3162,7423,7423,0,0,7423,7.99892,0,7423,7423,7423,1,0,0,0,0,0
33094,7727,13593,33094,0,31424,1670,4.37603e+18,229.098,15027.9,33094,5566,129,19501,19396,15315,17250,11682
15719,438,4212,14829,890,14829,890,2.23459e+18,97.44,5657.44,15719,1993,111,11507,11420,5355,7785,2223
14994,309,3545,0,14994,5268,9726,2.53254e+15,59.787,4812.32,14994,1723,72,11449,11449,6760,2902,1155
48644,10257,13218,0,48644,17438,31206,2.40446e+15,59.4783,16347.9,48644,6439,72,35426,35426,31598,26741,27110
18118,106,200,18110,8,18118,0,5.98526e+18,180.129,1644.29,18118,149,155,16364,11313,9422,9975,10015
47095,546,1744,0,47095,45728,1367,4.13052e+16,305.164,5833.85,47095,297,26,45351,44091,40919,37923,19728
2429,15,652,2289,140,2289,140,3.2967e+18,92.1676,1033.14,2429,293,63,513,56,0,194,47
38848,9,12,37739,1109,38834,14,1.3881e+14,10.2216,556.721,38848,11,12,38350,37743,31282,31470,32909
1653,137,170,1653,0,1653,0,5.98745e+18,125.737,479.392,1653,68,63,1465,1392,1288,1292,1273
1332,23,573,510,822,0,1332,7.6534e+12,53.0526,745.823,1332,270,45,437,74,181,241,61
42596,8194,15969,40576,2020,40576,2020,7.94925e+18,95.6015,18762.1,42596,7746,110,26627,26627,24867,24867,5257
41531,239,1162,0,41531,40347,1184,3.55907e+16,243.644,3981.56,41531,180,26,40218,39807,33872,33877,14416
40452,792,1142,0,40452,39298,1154,3.56013e+16,238.998,3898.64,40452,177,26,39310,39310,36054,36628,31803
20739,746,953,0,20739,20134,605,4.04988e+16,188.673,2802.1,20739,137,26,19786,19786,18617,18645,16538
29200,17,176,29122,78,29200,0,6.04678e+18,172.382,2102.91,29200,166,162,10559,2031,2806,2707,2744
40451,821,1621,0,40451,39272,1179,4.22431e+16,258.279,5284.69,40451,272,26,38830,38822,36341,36706,28340
34793,12370,12845,33123,1670,33123,1670,7.88632e+18,93.5488,15247.8,34793,6233,110,21948,21948,21908,21908,21764
16429,8415,16429,16429,0,0,16429,134210000,0,16429,16429,16429,1,0,0,0,0,0
44671,3608,15366,16572,28099,0,44671,8.45986e+12,58.3022,18041.7,44671,7482,72,29305,29305,17982,25266,6453
31979,3,14,31047,932,31900,79,1.5846e+14,10.3089,563.132,31979,13,12,24617,18129,18953,19948,12115
25361,11274,12168,0,25361,0,25361,4.41835e+17,93.7717,13795.9,25361,5903,110,13193,13193,12598,12300,11955
18119,9,10,17600,519,18113,6,1.38959e+14,9.95966,372.329,18119,10,10,17900,17653,17481,17480,16640
8548,1131,2151,0,8548,3029,5519,2.49241e+15,59.3501,2967.16,8548,1043,72,6397,6397,5153,3547,3226
33689,440,1185,0,33689,32716,973,3.8419e+16,248.053,3842.55,33689,186,26,32504,31917,25898,26694,17203
29397,14253,16137,6341,23056,0,29397,53148100000,8.99088,16468.1,29397,14514,11,13260,13260,12119,13260,12069
3577,282,1153,0,3577,0,3577,5.91263e+17,87.4635,1629.52,3577,533,72,2424,2424,870,305,97
19585,3330,6656,18603,982,18603,982,3.12468e+18,95.7553,8259.31,19585,3212,110,12929,12929,8879,10521,7549
9316,260,3990,8906,410,8906,410,8.65303e+18,93.7483,4827.59,9316,1919,98,5326,5068,1498,5289,1245
42941,8970,11562,0,42941,0,42941,6.16955e+17,97.2836,14740.6,42941,5598,110,31379,31379,28591,26632,25510
20654,233,5823,7427,13227,0,20654,9.2923e+12,59.1676,7373.07,20654,2833,72,14831,14687,8558,13751,1002
23327,48,176,23278,49,23327,0,5.99942e+18,169.759,1843.86,23327,154,160,14745,6931,5511,6711,6512
37622,10719,13137,37622,0,35522,2100,4.02654e+18,247.802,14770.3,37622,5054,129,24485,24485,22042,23099,20386
45642,1154,11804,43069,2573,43069,2573,6.09653e+18,97.481,15174.1,45642,5727,110,33838,33838,26610,21263,5788
23553,393,6683,0,23553,0,23553,6.06516e+17,96.7803,8645.32,23553,3225,110,16870,16698,7003,2165,2317
9956,2567,4211,0,9956,0,9956,4.92888e+17,93.8089,5092.91,9956,2028,101,5745,5745,4541,4660,2828
12860,144,176,12847,13,12860,0,6.09529e+18,169.214,1402.7,12860,128,129,12436,11799,10491,10524,10614
16088,142,176,16082,6,16088,0,5.99185e+18,167.98,1515.13,16088,142,149,15532,14533,13003,13139,13031
13087,1996,4502,0,13087,0,13087,5.58537e+17,95.4167,5683.4,13087,2169,110,8585,8585,6269,6043,4056
39833,4691,9340,0,39833,14009,25824,2.52159e+15,60.0097,12106.9,39833,4534,72,30493,30493,23734,25177,15532
26622,3090,8301,9719,16903,0,26622,8.86824e+12,58.741,10135.6,26622,4038,72,18321,18321,13295,17452,7285
3494,85,159,0,3494,3392,102,3.53689e+16,19.5094,468.923,3494,39,26,3335,3335,3129,3152,2151
2454,595,665,2314,140,0,2454,2.21677e+18,91.9976,1047.63,2454,291,63,1789,1789,1749,1757,1762
24999,4508,6283,23566,1433,23566,1433,5.52358e+18,97.907,8368.57,24999,2967,111,18716,18716,15918,16493,14891
35928,1515,1578,0,35928,34877,1051,4.37524e+16,306.465,5050.71,35928,263,26,34350,34350,34291,34313,34079
9248,9,11,8979,269,9241,7,1.56047e+14,10.2679,278.088,9248,11,11,9139,9031,8746,8745,8101
6448,2143,2289,0,6448,2395,4053,2.15787e+15,57.3617,2878.49,6448,1106,72,4159,4159,4016,3948,3895
38174,3858,11825,36154,2020,36154,2020,3.84399e+18,97.2344,14537,38174,5643,111,26349,26349,20437,20714,10524
34240,580,1052,0,34240,33716,524,2.46267e+16,3.73633,4064.14,34240,528,4,33188,33188,33141,32858,24498
25174,972,5955,0,25174,0,25174,6.49225e+17,97.6232,8117.8,25174,2882,110,19219,19219,12430,6498,4076
21611,3194,5158,0,21611,0,21611,6.44705e+17,97.4482,7084.38,21611,2486,110,16453,16453,14301,13339,10928
18657,3071,4408,17567,1090,17567,1090,5.87636e+18,97.4461,6131.74,18657,2130,110,14249,14249,13909,13909,10450
48248,3,14,46867,1381,48161,87,1.4212e+14,10.4657,684.565,48248,13,12,36814,26191,29920,29085,19067
23522,40,176,23509,13,23522,0,6.01902e+18,170.999,1875.31,23522,160,158,13809,4795,4735,5418,5202
38129,1734,2211,36567,1562,11565,26564,1.45691e+18,16.9903,2960.38,38129,1573,19,35918,35918,35442,35770,30766
25472,3653,8338,25472,0,23992,1480,3.55548e+18,166.676,9603.35,25472,3027,124,17134,16974,11533,13728,7924
46289,14652,20491,17981,28308,0,46289,7.19179e+12,56.7411,22903.5,46289,9977,72,25798,25798,23299,25278,19217
47806,1987,11461,45026,2780,45026,2780,2.09288e+18,98.3627,14953.7,47806,5425,111,36345,36345,16355,18476,8472
20364,4173,8373,0,20364,7797,12567,1.95719e+15,57.1129,9683.5,20364,4079,72,11991,11991,9403,6212,6430
22232,451,800,0,22232,21595,637,3.55037e+16,114.417,2389.48,22232,109,26,21432,21305,18565,18923,14406
33948,3018,12613,33948,0,32118,1830,4.42467e+18,249.493,14121,33948,4982,129,21335,20950,11989,16253,5336
42668,3264,13122,40407,2261,40407,2261,3.29846e+18,97.2958,16087.8,42668,6269,111,29546,29546,15043,19362,7205
5787,786,1441,5447,340,5447,340,5.08978e+18,96.3181,2155.5,5787,665,92,4346,4346,3963,4230,2812
26658,158,176,26641,17,26658,0,6.02278e+18,170.655,1991.83,26658,162,161,26246,25627,23976,24053,23999
49627,4,16,48186,1441,49534,93,1.59616e+14,10.4472,746.912,49627,13,13,43324,38603,31243,32450,20324
39683,21,208,39611,72,39683,0,6.06888e+18,198.362,2632.8,39683,173,175,16520,3392,4867,4688,4013
27067,925,7742,0,27067,9764,17303,2.3561e+15,59.143,9653.03,27067,3766,72,19325,19229,8261,4408,3081
37936,12355,14340,0,37936,14309,23627,2.05167e+15,57.4571,16587.9,37936,6970,72,23596,23596,22074,20251,20385
16378,2530,4501,5866,10512,0,16378,9.33379e+12,59.171,5806.92,16378,2179,72,11877,11877,10199,11587,8312
22416,4301,7741,21289,1127,21289,1127,2.82338e+18,95.7012,9475.69,22416,3687,111,14675,14675,11988,14513,8544
23817,5718,7720,8745,15072,0,23817,8.73582e+12,58.5111,9372.66,23817,3757,72,16097,16097,14863,15837,12978
30233,6,14,29362,871,30152,81,1.46328e+14,10.6472,551.242,30233,13,12,28726,27941,21482,21268,17591
28430,6134,6703,0,28430,0,28430,6.47969e+17,97.6738,9084.01,28430,3244,110,21727,21727,21087,21207,20348
19043,198,5559,18003,1040,18003,1040,4.36343e+18,97.1802,7185.77,19043,2635,111,13484,13240,5394,8283,1597
3110,242,310,0,3110,3016,94,4.91197e+16,16.799,728.428,3110,47,26,2800,2800,2745,2737,2515
24304,1218,12637,23404,900,23404,900,2.19837e+18,92.6308,14100.5,24304,6093,111,11667,11421,4575,11190,2633
10742,1707,5071,0,10742,0,10742,4.55909e+17,93.1678,5942.04,10742,2451,109,5671,5671,4638,3882,3733
15350,1123,4043,14482,868,14482,868,6.11647e+18,96.9258,5491.68,15350,1948,110,11307,11307,9829,9415,4104
26900,4789,12334,0,26900,10528,16372,1.79151e+15,56.4117,13862.3,26900,6002,72,14566,14518,14065,14206,14059
30635,5329,7526,10831,19804,0,30635,9.73923e+12,59.8262,9731.27,30635,3665,72,23109,23109,20847,22637,17175
38766,3191,19530,0,38766,15474,23292,1.6376e+15,55.7464,21436,38766,9509,72,19236,19236,12155,3346,3761
36865,677,1181,0,36865,35811,1054,3.72006e+16,252.963,3915.72,36865,184,26,35684,35098,33604,33568,25226
34708,1522,15665,33256,1452,33256,1452,9.07333e+18,93.4865,17814.9,34708,7611,110,19043,19043,6111,15916,3466
19343,5514,6352,18352,991,0,19343,1.9627e+18,95.9843,7961.01,19343,3071,110,12991,12991,11859,11705,10780
15694,165,176,15682,12,15694,0,6.06011e+18,169.937,1546.4,15694,138,142,15443,15301,14660,14517,14586
38301,6374,15450,0,38301,0,38301,5.0568e+17,93.1394,17929.4,38301,7502,110,22851,22851,17173,13678,11079
23496,1454,10554,9146,14350,0,23496,7.08468e+12,56.155,11949.4,23496,5124,72,12942,12942,7262,10850,2110
22132,3821,5195,20842,1290,20842,1290,3.35218e+18,97.6011,7165.49,22132,2508,110,16937,16937,14189,15454,13021
32669,6821,7858,30769,1900,30769,1900,5.67264e+18,98.2137,10448.3,32669,3711,111,24811,24811,24685,24373,22149
36892,107,176,36807,85,36892,0,6.01449e+18,172.989,2331.49,36892,167,170,33750,24003,20833,21556,22252
43891,4,13,42638,1253,43870,21,1.38977e+14,10.2335,596.024,43891,12,12,38070,33813,33669,30356,21821
31855,2814,10220,30208,1647,0,31855,1.97866e+18,95.5443,12594.9,31855,4942,110,21635,21635,15123,13712,7601
13027,3511,6546,13027,0,13027,0,2.79333e+18,18.9457,6875.82,13027,4210,23,6481,6481,3908,3793,3572
44262,8184,13793,0,44262,0,44262,5.81357e+17,96.6194,16897.8,44262,6687,110,30469,30469,26028,24336,18643
40862,6,15,39671,1191,40773,89,1.63717e+14,10.3789,663.248,40862,13,13,38992,37888,29762,28735,24130
27807,1962,14794,26807,1000,26807,1000,3.01484e+18,89.7502,16383.8,27807,7117,111,13013,13013,8120,7548,2715
6015,250,345,0,6015,5844,171,3.88141e+16,19.5691,910.287,6015,54,26,5670,5670,5357,5411,4443
38773,1194,1410,0,38773,37649,1124,3.99158e+16,273.931,4632.59,38773,230,26,37363,37363,36969,36941,35063
22800,9301,10028,22800,0,21700,1100,5.4438e+18,175.101,11134.5,22800,3451,129,12772,12772,12562,12772,11757
36641,13863,17959,36641,0,0,36641,8.76962e+17,17.9849,18515.3,36641,16153,20,18682,18682,14627,16063,14488
34069,102,176,33988,81,34069,0,6.01828e+18,172.815,2244.2,34069,165,168,30633,20200,18316,19120,19668
2067,153,771,2067,0,1947,120,4.08411e+18,86.4877,1034.07,2067,261,60,1296,1296,629,941,487
32604,7505,7661,0,32604,0,32604,6.47527e+17,97.7372,10313.3,32604,3706,110,24943,24943,24797,24824,24749
16929,4857,5180,6162,10767,0,16929,9.02916e+12,58.7482,6470,16929,2523,72,11749,11749,11381,11669,10983
35818,3605,8650,33738,2080,33738,2080,3.25541e+18,98.2452,11430.2,35818,4093,111,27168,27168,20425,24229,12634
14213,436,4681,13483,730,13483,730,3.15744e+18,93.6742,5959.51,14213,2257,110,9532,9360,4068,6362,1946
795,53,228,0,795,285,510,2.73326e+15,53.9283,367.451,795,109,39,512,207,336,125,171
3853,40,925,1359,2494,0,3853,1.01008e+13,58.9263,1381,3853,450,66,2341,595,1437,1963,160
2073,630,645,1956,117,1956,117,3.93277e+18,90.9604,967.24,2073,283,57,1428,1428,1428,1428,1428
10250,115,170,10244,6,10250,0,5.97691e+18,162.497,1192.97,10250,127,131,9450,8584,6654,6788,6853
40487,14999,15103,38557,1930,0,40487,1.82481e+18,95.6527,17795.3,40487,7334,110,25384,25384,25272,25278,25284
24091,32,199,24083,8,24091,0,5.98382e+18,181.653,1903.22,24091,161,168,12308,3355,3651,4385,3919
7930,4,13,7704,226,7866,64,1.54652e+14,10.8764,281.75,7930,12,11,6970,6247,5053,5265,3456
40034,9377,14365,38084,1950,38084,1950,3.00572e+18,95.7156,17080.9,40034,6972,110,25669,25669,20160,22312,18161
36573,1245,10483,34573,2000,34573,2000,1.44325e+18,97.5478,13172.6,36573,4987,111,26090,26090,22607,23135,5534
21174,7,14,20551,623,21094,80,1.73812e+14,10.5391,482.533,21174,13,12,20602,20287,18480,16201,14147
44519,524,1384,0,44519,43240,1279,3.76741e+16,270.482,4706.42,44519,226,26,43135,42311,34559,35635,22629
846,5,10,820,26,846,0,1.38409e+14,9.2565,79.2449,846,10,10,779,710,577,593,524
17285,756,802,0,17285,16787,498,3.85697e+16,112.994,2253.38,17285,107,26,16483,16483,16399,16404,16029
10352,408,447,0,10352,0,10352,3.84069e+18,15.9719,821.531,10352,442,17,9905,9905,9446,9544,9687
8883,662,2196,0,8883,0,8883,6.39114e+17,96.3823,3181.88,8883,1039,110,6687,6687,4074,3444,2564
22332,5302,9501,16804,5528,21342,990,4.1216e+18,95.1652,11069.2,22332,4553,111,12831,12831,8627,9464,7704
7812,576,4581,7560,252,7560,252,3.35017e+18,86.9391,5159.99,7812,2187,89,3231,2886,1047,1579,928
49412,14293,17579,0,49412,18448,30964,2.1295e+15,58.1403,20442,49412,8564,72,31833,31833,29261,25709,25098
31098,5775,9703,0,31098,11365,19733,2.27899e+15,58.7688,11774.2,31098,4726,72,21395,21395,18292,14193,13220
41751,8394,11844,0,41751,15050,26701,2.36664e+15,59.2548,14563.4,41751,5766,72,29907,29907,26641,22115,21265
24223,5026,8335,23011,1212,23011,1212,2.96414e+18,95.8791,10206.7,24223,4030,110,15888,15888,14080,15397,11268
14887,1817,3543,0,14887,0,14887,6.50483e+17,97.282,4995.13,14887,1707,110,11344,11344,9061,7640,6555
20419,2969,6451,19343,1076,19343,1076,5.61226e+18,96.8771,8123.31,20419,3076,111,13968,13968,11977,13028,7804
19962,1658,8035,13369,6593,19045,917,2.09325e+18,95.4425,9520.81,19962,3841,111,11927,11927,8375,6600,2590
31132,2499,12229,29692,1440,29692,1440,8.04905e+18,94.051,14367.5,31132,5932,110,18903,18903,16190,15739,5349
21398,4076,5100,20155,1243,20155,1243,5.9132e+18,97.491,7008.4,21398,2464,110,16298,16298,16058,16058,13741
27307,4428,6419,9604,17703,0,27307,9.85356e+12,59.9449,8453.86,27307,3121,72,20888,20888,18558,20401,14760
10110,1846,2520,9521,589,9521,589,6.05928e+18,97.2253,3585.85,10110,1170,111,7590,7590,6317,6637,5998
39094,100,176,39036,58,39094,0,6.04092e+18,173.532,2424.7,39094,171,168,35070,23682,20728,21657,22450
29119,2557,6861,27426,1693,27426,1693,5.77044e+18,97.6818,9287.6,29119,3311,110,22258,22258,19659,19238,9273
46369,4243,13722,16822,29547,0,46369,9.08401e+12,59.0908,16647.5,46369,6684,72,32647,32647,23105,31007,11549
1542,93,455,1452,90,0,1542,2.2344e+18,88.5863,718.43,1542,199,52,993,350,664,596,248
39555,694,9248,37255,2300,37255,2300,3.34889e+18,97.8193,12341.2,39555,4471,110,30307,30307,12981,20797,4070
25136,10730,12328,25136,0,25136,0,4.25574e+16,17.9715,12785.6,25136,11082,20,12808,12808,11159,12808,11217
14601,2680,8137,14105,496,0,14601,1.30408e+18,92.0966,9096.88,14601,3941,110,6464,6464,4505,3999,2733
34720,9285,10898,0,34720,12703,22017,2.2667e+15,58.5366,13162.2,34720,5303,72,23822,23822,22416,21161,20872
43457,8721,11967,41047,2410,41047,2410,2.19984e+18,97.7713,15082.4,43457,5690,111,31490,31490,29026,31321,25096
8098,725,3027,0,8098,0,8098,5.36088e+17,94.3628,3835.13,8098,1446,105,5071,4905,3029,311,1072
35440,4671,8300,0,35440,0,35440,6.47799e+17,97.7939,11135.9,35440,4013,110,27140,27140,23087,19080,16335
37332,5050,8733,35159,2173,35159,2173,3.35407e+18,97.8084,11684.1,37332,4222,110,28599,28599,21181,24516,17590
30988,6186,7184,10877,20111,0,30988,9.92056e+12,60.0495,9443.91,30988,3498,72,23804,23804,22592,23551,20707
24530,1925,12029,24530,0,0,24530,8.7668e+17,17.9747,12480.9,24530,10814,20,12501,12501,2480,5830,2047
21567,4506,5901,20367,1200,20367,1200,5.19199e+18,97.4656,7725.84,21567,2797,111,15666,15666,15201,15666,12238
30648,8321,12112,29238,1410,29238,1410,8.10683e+18,95.1808,14222.7,30648,5875,110,18536,18536,17530,17362,13805
25523,7,11,24792,731,25514,9,1.4575e+14,10.0904,453.815,25523,11,11,24661,24024,22608,22260,19367
41178,211,1151,0,41178,40004,1174,3.55213e+16,239.514,3940.59,41178,179,26,39848,39480,27750,27640,13607
39628,2630,12591,14516,25112,0,39628,8.78649e+12,58.3373,15100.4,39628,6112,72,27037,27037,18185,25517,7461
18909,4103,5421,17879,1030,17879,1030,6.63925e+18,96.7006,7077.68,18909,2623,110,13488,13488,13307,13308,11617
9277,868,4969,0,9277,3750,5527,1.54672e+15,50.8642,5579.66,9277,2397,72,4308,4168,1944,1854,646
7770,1449,1919,7318,452,7318,452,3.74761e+18,96.7355,2802.18,7770,883,103,5851,5851,5387,5817,4830
5895,62,259,0,5895,5729,166,3.53749e+16,19.888,745.605,5895,47,26,5636,5636,4153,4143,1968
46656,10483,10923,0,46656,0,46656,6.47347e+17,97.8733,14446.1,46656,5298,110,35733,35733,35246,35075,34737
29292,1060,1323,0,29292,28431,861,4.30939e+16,273.2,4129.55,29292,213,26,27969,27969,27678,27646,25930
33748,71,176,33731,17,33748,0,5.98277e+18,169.654,2176.14,33748,164,169,25597,14306,12062,14038,13843
41825,73,176,41744,81,41825,0,5.98189e+18,169.822,2421.42,41825,171,170,32230,17889,15375,17971,17526
17799,1824,4331,16767,1032,16767,1032,1.41802e+18,97.7704,5958.94,17799,2025,111,13468,13468,9490,11250,6530
28916,798,9384,27426,1490,0,28916,1.9693e+18,95.3102,11578.3,28916,4535,110,19532,19268,7407,7106,3538
2920,66,176,2918,2,2920,0,6.0862e+18,143.124,664.961,2920,82,77,2132,1356,1026,1153,1097
12594,5099,6462,0,12594,5037,7557,1.62269e+15,55.2865,7249.08,12594,3140,72,6132,6132,5938,5699,5888
7986,3193,4006,3187,4799,0,7986,6.55724e+12,55.3471,4577.15,7986,1951,72,3980,3980,3669,3911,3355
19216,763,791,0,19216,18667,549,3.69513e+16,113.995,2281.45,19216,107,26,18425,18425,18360,18355,18125
44318,7,13,43055,1263,44297,21,1.38997e+14,10.3,600.58,44318,12,12,42745,41576,37282,37355,27914
49520,3790,11098,49520,0,49520,0,2.56597e+18,4862.9,16935,49520,7384,27,32392,24597,14562,9186,12667
46786,1203,1965,13648,33138,13648,33138,1.74413e+18,15.9934,2779.2,46786,1960,17,44821,44821,34962,37985,40265
30726,4417,7348,0,30726,10822,19904,2.5095e+15,59.8855,9576.72,30726,3570,72,23378,23378,19794,17916,13861
43394,718,15189,0,43394,16154,27240,2.1443e+15,58.2187,17786.2,43394,7393,72,28205,27821,13882,6038,2581
12451,401,595,0,12451,12093,358,3.7004e+16,19.9729,1603.85,12451,79,26,11856,11856,10847,10947,8233
32002,282,7485,0,32002,11245,20757,2.52945e+15,60.0053,9800.57,32002,3641,72,24517,24517,6764,4171,1248
24190,7656,22607,7532,16658,0,24190,9.21552e+12,3.99186,22682.7,24190,7556,9,1583,1583,532,1583,539
8960,1267,2099,3153,5807,0,8960,9.93622e+12,59.6176,2958.56,8960,1020,72,6861,6861,5859,6647,4333
44114,6437,16186,0,44114,0,44114,5.34941e+17,95.755,19086.6,44114,7850,110,27928,27928,20744,15376,12565
836,77,577,0,836,836,0,16.5957,0.309809,684.281,836,577,1,259,259,259,259,259
22677,3044,6866,21472,1205,0,22677,2.03439e+18,95.6964,8734.04,22677,3321,110,15811,15811,12009,11212,7732
33535,250,1582,0,33535,32545,990,4.51083e+16,295.657,4991.75,33535,262,26,31566,30889,26764,21400,8447
24196,2345,8741,24196,0,22858,1338,3.45547e+18,163.945,9939.41,24196,3365,125,15455,15288,9480,11552,5389
9515,2199,2264,0,9515,0,9515,6.51213e+17,96.7899,3308.08,9515,1079,110,7251,7251,7194,7201,7218
19812,4160,5733,7157,12655,0,19812,9.17312e+12,58.916,7225.85,19812,2782,72,14079,14079,12501,13749,10008
5345,5,10,5193,152,5345,0,1.37815e+14,9.81553,201.565,5345,10,10,4906,4318,4381,4256,3276
44540,2117,11968,0,44540,0,44540,6.1977e+17,97.3368,15237.8,44540,5811,110,32572,32572,20886,9459,6420
12539,9,12,12183,356,12531,8,1.44565e+14,10.4107,319.601,12539,12,11,12369,12182,9904,9970,11125
3969,1291,1626,0,3969,0,3969,5.28092e+17,92.2507,2084.8,3969,773,72,2343,2343,1972,1858,1665
41396,781,1320,0,41396,40738,658,2.48832e+16,3.73584,5070.11,41396,662,4,40076,40076,40022,39698,30509
39217,5339,9171,0,39217,13792,25425,2.5279e+15,60.068,11907.1,39217,4467,72,30046,30046,24478,18986,17772
20038,3556,8308,7674,12364,0,20038,7.57219e+12,57.044,9599.94,20038,4043,72,11730,11730,8582,11190,4963
12743,559,821,0,12743,12369,374,4.43327e+16,125.466,2169.61,12743,111,26,11922,11769,11479,11462,9281
10611,2,11,10306,305,10605,6,1.38337e+14,10.4264,285.903,10611,11,11,6141,4344,4207,4406,3198
45794,4219,20266,43854,1940,43854,1940,2.65477e+18,94.567,22968,45794,9843,110,25528,25528,18074,18538,6948
35996,7,15,34934,1062,35932,64,1.73635e+14,10.4727,644.859,35996,13,11,35001,34320,31755,27484,18583
37200,10388,15313,14256,22944,0,37200,7.57935e+12,56.5128,17428.6,37200,7446,72,21887,21887,17778,21177,12889
41431,2392,9724,39021,2410,0,41431,2.22533e+18,97.8404,12928.1,41431,4714,110,31707,31707,21755,19988,9369
33893,1121,17437,32640,1253,32640,1253,2.52263e+18,90.7445,19363.5,33893,8457,110,16456,16118,5408,9523,2008
16760,2793,5926,15930,830,15930,830,7.43586e+18,95.5354,7330.01,16760,2860,110,10834,10834,9641,9441,5125
6684,535,1720,6296,388,6296,388,1.32759e+18,96.4819,2505.26,6684,797,97,4964,4964,4679,4727,2093
15929,5525,7435,15279,650,15279,650,9.11666e+18,91.0942,8611.63,15929,3593,110,8494,8494,7846,7738,5620
43873,5460,16367,41780,2093,41780,2093,7.92612e+18,95.6152,19227.8,43873,7949,110,27506,27506,26223,26223,12070
40596,15039,17966,38876,1720,0,40596,1.62405e+18,94.5432,20425.7,40596,8725,110,22630,22630,20873,20387,19360
41164,2183,13542,15171,25993,0,41164,8.65113e+12,58.539,16092.4,41164,6591,72,27622,27622,13869,23546,6758
10123,1167,3966,0,10123,3831,6292,2.0188e+15,56.9592,4757.57,10123,1926,72,6157,6157,3833,4076,1218
37969,99,176,37873,96,37969,0,6.10084e+18,173.128,2412.65,37969,168,166,34304,24851,20432,20971,21321
43520,585,1194,0,43520,42280,1240,3.55205e+16,246.671,4128.01,43520,187,26,42326,41729,35076,35988,26698
5509,1520,2098,5239,270,0,5509,1.85586e+18,93.5671,2700.13,5509,1003,84,3411,3411,2710,2582,2266
22679,2474,6328,21432,1247,21432,1247,6.37807e+18,95.3528,8243.74,22679,3046,110,16351,16351,14515,14216,7295
36554,83,176,36470,84,36554,0,6.04972e+18,172.827,2349.55,36554,170,167,30540,19433,16240,17158,17297
46287,7021,10840,43597,2690,0,46287,2.22636e+18,97.8705,14343,46287,5251,110,35447,35447,30283,29282,24035
43718,7328,16510,41648,2070,41648,2070,2.94932e+18,95.5922,19348.7,43718,8017,110,27208,27122,14730,20173,8755
15248,1352,4483,0,15248,0,15248,5.98621e+17,96.3204,5882.33,15248,2159,110,10765,10765,6349,5394,3374
41107,5731,9605,0,41107,0,41107,6.47186e+17,97.8378,12793.9,41107,4644,110,31502,31502,26273,23887,19937
41479,1359,1396,0,41479,40281,1198,3.87971e+16,281.522,4669.91,41479,226,26,40083,40083,40065,40056,39943
15905,94,5310,15905,0,14982,923,4.34021e+18,128.479,6246.7,15905,1908,121,10456,2305,3255,6400,232
7866,15,176,7860,6,7866,0,6.05064e+18,163.75,1093.12,7866,113,114,2630,535,626,656,584
35633,3121,8567,33578,2055,33578,2055,6.0109e+18,97.3525,11393.8,35633,4151,110,27066,27066,25694,25640,10507
37304,10,13,36238,1066,37292,12,1.391e+14,10.1685,546.35,37304,12,12,37227,37149,35962,35963,31840
25867,156,896,0,25867,25126,741,3.61834e+16,160.469,2782.19,25867,128,26,24861,24730,17586,17441,8167
9609,184,419,0,9609,9337,272,3.56126e+16,19.9947,1173.84,9609,62,26,9190,9190,8465,8523,4860
15944,3099,3788,0,15944,0,15944,6.4925e+17,97.282,5318.07,15944,1826,110,12156,12156,11471,10887,10652
8886,315,749,0,8886,8622,264,4.81844e+16,79.6587,1830.2,8886,96,26,8137,8066,7371,7231,4354
20789,791,940,0,20789,20186,603,4.00929e+16,193.227,2767.57,20789,137,26,19849,19849,19607,19587,18214
11916,2497,2841,4188,7728,0,11916,9.88245e+12,59.6474,3899.76,11916,1379,72,9075,9075,8575,8985,8164
43696,1112,1802,0,43696,42414,1282,4.33523e+16,321.765,5912.33,43696,309,26,41894,41894,40414,40252,31794
28639,7,11,27820,819,28626,13,1.39023e+14,10.1493,474.447,28639,11,11,27635,26942,21189,21211,21317
4705,6,13,4568,137,4645,60,1.55185e+14,10.8193,213.743,4705,13,12,4457,4321,3851,3431,3036
10366,9,12,10069,297,10360,6,1.39244e+14,10.2629,285.969,10366,12,11,10240,10125,9914,9913,8589
20964,2504,8192,20964,0,20964,0,4.89082e+15,4990.85,13040.9,20964,8192,4,5006,0,4489,4489,5006
46025,8111,19487,44011,2014,0,46025,1.67953e+18,94.8446,22270.4,46025,9463,110,26538,26538,20418,18197,11851
3796,94,207,3794,2,3796,0,6.02262e+18,160.319,782.757,3796,91,93,3168,1985,1721,1822,1791
32833,5011,9426,0,32833,0,32833,6.03463e+17,96.7206,11950.3,32833,4567,110,23407,23407,19639,16400,13421
27497,9166,11112,0,27497,10502,16995,1.97135e+15,56.4145,12790.2,27497,5407,72,16385,16385,15454,14154,14089
12104,130,176,12062,42,12104,0,6.02903e+18,166.33,1345.28,12104,132,131,11482,10726,8932,9041,8958
39205,10016,12556,39205,0,36923,2282,4.58138e+18,277.863,14267.1,39205,2459,136,26649,26649,25078,26209,22204
45189,1067,1534,0,45189,43885,1304,3.93958e+16,283.553,5169.34,45189,255,26,43655,43655,42452,42221,35889
30193,5226,7091,28433,1760,0,30193,2.22927e+18,97.7641,9589.53,30193,3435,110,23102,23102,20627,20128,17889
13589,412,7603,0,13589,0,13589,3.76804e+17,87.2357,8514.46,13589,3662,105,5986,5556,3388,1462,0
40072,1343,1498,0,40072,38907,1165,4.07167e+16,278.701,4928.3,40072,248,26,38574,38574,38353,38341,37054
19939,7,12,19358,581,19929,10,1.59435e+14,10.1168,411.666,19939,11,12,19315,18839,14949,14437,12259
45860,18564,19505,0,45860,0,45860,4.85451e+17,93.6116,22276.1,45860,9469,110,26355,26355,26207,26177,26237
35833,467,11832,24760,11073,33992,1841,5.72014e+18,96.8741,14353,35833,5650,111,24001,23479,13140,16031,3010
28667,12781,15370,27647,1020,27647,1020,3.6923e+18,89.0454,16984.4,28667,7413,111,13297,13297,13061,13282,12999
46833,11087,14774,17150,29683,0,46833,8.81289e+12,58.4751,17658,46833,7183,72,32059,32059,27719,31309,22516
17916,3707,4345,16866,1050,16866,1050,5.83073e+18,97.9089,5977.71,17916,2041,111,13571,13571,12424,12687,12302
42860,10187,18346,42437,423,41120,1740,5.10035e+18,2547.43,21526.5,42860,7642,147,24514,21644,18233,19606,16725
39133,12090,13213,39133,0,36973,2160,3.84937e+18,281.571,15166.7,39133,5386,129,25920,25920,25231,25546,24002
38519,5839,16095,14801,23718,0,38519,7.51081e+12,57.1158,18250.5,38519,7835,72,22424,22424,14709,20233,7284
39653,5070,9230,13934,25719,0,39653,9.88739e+12,60.0517,11988.4,39653,4492,72,30423,30423,25408,29375,17052
18124,1400,4249,0,18124,6367,11757,2.53896e+15,59.9057,5718.88,18124,2069,72,13875,13875,8760,5888,4870
22975,8641,12633,0,22975,0,22975,3.8275e+17,89.7466,13993.7,22975,6114,110,10342,10342,8977,8247,8088
42568,3814,10228,40088,2480,40088,2480,4.46154e+18,98.3217,13407.6,42568,4838,111,32340,32340,20099,23275,13600
14812,113,176,14798,14,14812,0,6.04712e+18,169.583,1490.37,14812,139,143,13631,12081,9083,9344,9356
7144,46,208,7107,37,7144,0,6.00757e+18,173.633,1098.68,7144,117,114,4392,1953,1486,1831,1614
14014,561,751,0,14014,13609,405,3.96538e+16,73.0372,2002.45,14014,98,26,13263,13195,11979,12174,9613
8589,175,494,0,8589,8342,247,3.92042e+16,19.9072,1284.46,8589,69,26,8095,8095,7413,7452,3885
6665,1394,1670,0,6665,0,6665,6.51267e+17,95.9976,2463.37,6665,794,96,4995,4995,4698,4684,4466
43668,3402,16667,16499,27169,0,43668,7.97352e+12,57.2443,19174.1,43668,8113,72,27001,27001,14159,22987,5640
18760,641,777,0,18760,18224,536,3.67663e+16,94.5749,2224.73,18760,103,26,17983,17885,17605,17605,15336
16911,4637,6600,6399,10512,0,16911,7.88429e+12,57.3796,7770.14,16911,3210,72,10311,10311,8824,10001,6487
42253,1537,2196,0,42253,40987,1266,4.91969e+16,324.434,7018.74,42253,386,26,40057,40057,38739,38558,32209
10772,8,11,10463,309,10767,5,1.57984e+14,10.234,300.769,10772,11,11,10540,10411,8477,8499,8219
31464,7170,8651,29714,1750,29714,1750,3.53803e+18,97.6658,11076.7,31464,4107,111,22813,22813,21296,22704,18790
37840,6594,9873,32267,5573,35697,2143,3.53631e+18,97.9681,12712.5,37840,4686,111,27967,27967,24959,27736,19013
37121,9481,11304,37121,0,34959,2162,3.93251e+18,264.188,13216.8,37121,4424,125,25817,25817,23892,24698,22394
7507,640,3365,0,7507,2919,4588,1.8438e+15,56.095,3953.46,7507,1633,72,4142,4046,2811,1531,1009
27519,1029,14768,26539,980,26539,980,4.54795e+18,90.2024,16333.9,27519,7105,111,12751,12142,3993,6765,1838
34491,3886,9811,32611,1880,32611,1880,6.47275e+18,96.6635,12442.2,34491,4741,110,24680,24680,21886,21420,10693
17809,4040,5921,17809,0,16778,1031,3.73857e+18,138.322,6927.48,17809,2135,121,11888,11888,9806,10751,8506
5187,455,1338,4887,300,0,5187,2.21067e+18,95.327,1998.26,5187,626,87,3849,3849,2316,2162,1506
28925,1516,10922,10909,18016,0,28925,8.04453e+12,57.7309,12731,28925,5317,72,18003,18003,11609,16903,3920
29634,3803,6907,27904,1730,0,29634,2.23304e+18,97.7788,9375.97,29634,3342,110,22727,22727,19163,17740,13313
11734,1143,3675,4284,7450,0,11734,8.87823e+12,58.4169,4644.87,11734,1778,72,8059,8011,4793,7132,3918
17077,5753,5980,16227,850,0,17077,1.90249e+18,95.5267,7409,17077,2890,110,11097,11097,10864,10845,10719
32947,6688,8127,0,32947,11649,21298,2.48549e+15,59.8047,10466.7,32947,3950,72,24820,24820,23112,23290,21185
18936,110,890,0,18936,18386,550,3.99863e+16,154.381,2557.62,18936,124,26,17897,17796,15112,13598,5620
17810,3560,6150,0,17810,6606,11204,2.16879e+15,58.1067,7435.05,17810,2992,72,11660,11660,9737,7400,6653
38668,11474,13949,0,38668,0,38668,5.41186e+17,95.7996,16580.9,38668,6768,110,24719,24719,23164,22917,20829
11205,1001,3460,4083,7122,0,11205,8.94343e+12,58.0348,4403.81,11205,1675,72,7745,7735,4130,6751,2783
11296,57,170,11289,7,11296,0,5.97374e+18,163.118,1252.45,11296,131,135,7627,3940,3261,3734,3879
24012,4242,5845,22620,1392,22620,1392,4.25608e+18,97.9961,7885.16,24012,2747,111,18167,18167,15171,15792,14016
10616,1414,2594,10006,610,10006,610,3.3496e+18,96.6677,3719.55,10616,1234,110,8022,8022,5683,6762,4768
15723,328,663,0,15723,15277,446,3.55636e+16,20.0535,1826.52,15723,85,26,15060,15060,13087,13244,8919
735,6,11,714,21,731,4,2.11011e+14,7.49388,80.8434,735,10,11,697,680,651,538,300
4296,355,1372,1572,2724,0,4296,8.89608e+12,57.6443,1829.45,4296,663,67,2924,2876,1792,2727,638
4339,6,36,0,4339,3980,359,2.97266e+16,9.96313,227.339,4339,34,11,3473,2724,2370,2280,2685
29474,2497,6891,10370,19104,0,29474,9.89236e+12,60.015,9056.27,29474,3357,72,22583,22583,15025,20683,8436
31624,2987,9946,29964,1660,29964,1660,3.25953e+18,96.5241,12281.7,31624,4741,111,21678,21678,16008,17031,8460
49077,5424,19456,49077,0,38469,10608,4.64163e+18,838.341,21665.2,49077,5768,140,29621,28648,18181,21448,9915
18076,123,175,18070,6,18076,0,5.98682e+18,165.665,1591.64,18076,152,151,17010,15584,12614,12682,12947
28178,2260,14714,28178,0,27128,1050,4.90892e+18,549.128,16301.1,28178,6505,135,13464,12331,7600,10233,2301
15332,3444,4247,0,15332,0,15332,6.17082e+17,96.6642,5674.36,15332,2050,110,11085,11085,10001,9619,8985
41230,34,176,41103,127,41230,0,6.09316e+18,173.324,2512.68,41230,167,170,23006,7303,7857,8665,7918
12865,3589,6500,12375,490,12375,490,2.45365e+18,92.8197,7447.45,12865,3140,110,6365,6365,5076,6056,3578
42554,7907,13659,40357,2197,0,42554,1.97657e+18,86.698,16636,42554,6618,110,28895,28895,27866,27513,26451
19668,4088,4641,18521,1147,0,19668,2.23028e+18,97.5019,6436.04,19668,2241,110,15027,15027,14407,14195,13694
16118,189,3810,0,16118,5664,10454,2.52238e+15,59.7597,5150.61,16118,1842,72,12308,12308,3499,941,779
42216,4057,10149,39756,2460,39756,2460,4.68278e+18,98.3282,13308.1,42216,4796,111,32067,32067,20446,23371,14317
19104,1463,8878,18324,780,0,19104,1.56597e+18,91.1823,10226.5,19104,4284,110,10226,10226,6273,5289,2144
46994,18,176,46973,21,46994,0,5.99196e+18,173.832,2593.78,46994,173,172,17373,2893,4601,4499,4655
30082,1278,7191,28322,1760,28322,1760,3.85368e+18,98.2395,9620.9,30082,3390,111,22891,22891,11589,15320,5471
8576,334,468,0,8576,8330,246,3.8373e+16,19.8411,1230.54,8576,67,26,8108,8108,7811,7845,5774
32943,107,206,32869,74,32943,0,5.98413e+18,186.862,2222.76,32943,172,169,29893,20784,16731,17899,17821
25043,723,10596,0,25043,9638,15405,1.90989e+15,56.7651,12113.9,25043,5158,72,14447,14216,6959,3996,616
32171,7843,10444,0,32171,0,32171,5.73196e+17,96.3044,12823.9,32171,5068,110,21727,21727,19416,18421,15789
46513,254,10866,0,46513,16351,30162,2.52405e+15,60.0449,14012.3,46513,5277,72,35647,35647,9057,1801,1065
5658,599,1434,0,5658,0,5658,6.49165e+17,95.8623,2139.6,5658,679,92,4224,4224,3176,2884,2273
25337,223,981,0,25337,24611,726,3.82912e+16,194.716,3017.68,25337,144,26,24212,24014,20826,19903,7425
22712,10,11,22060,652,22705,7,1.48211e+14,10.0425,429.027,22712,11,11,22677,22651,21965,21964,20980
44737,4999,14817,42464,2273,0,44737,1.94589e+18,96.3234,17875.4,44737,7196,110,29920,29920,22356,20651,13553
14495,1632,6937,0,14495,5713,8782,1.73481e+15,55.7571,7859.83,14495,3362,72,7558,7558,4443,3928,1816
25633,1226,7039,0,25633,0,25633,6.13749e+17,96.9745,9152.56,25633,3399,110,18594,18594,11582,4765,3185
19945,432,758,0,19945,19375,570,3.55284e+16,83.8665,2203.09,19945,100,26,19187,19110,18103,18203,12798
10391,84,176,10385,6,10391,0,5.99905e+18,162.866,1230.74,10391,124,130,8645,5178,4639,4939,4924
34028,377,1021,0,34028,33058,970,3.55524e+16,210.367,3369.81,34028,152,26,32994,32615,26226,26832,16573
39524,7848,15715,39524,0,37554,1970,4.87326e+18,355.057,17637.3,39524,6142,134,23809,23556,18687,21005,12542
2895,645,718,1014,1881,0,2895,9.97326e+12,58.1831,1087.04,2895,344,60,2177,2177,2103,2160,2088
33631,1865,12657,25985,7646,32022,1609,3.39448e+18,96.148,14930.3,33631,6064,111,20974,20974,8607,12385,3840
27896,80,87,0,27896,25575,2321,2.99019e+16,10.0253,625.021,27896,84,11,27809,27809,27656,27528,27794
22543,10469,22543,22543,0,0,22543,134212000,0,22543,22543,22543,1,0,0,0,0,0
11265,2365,2685,3963,7302,0,11265,9.9504e+12,59.6886,3698.26,11265,1307,72,8580,8580,8116,8498,7733
42563,8488,22716,9222,33341,0,42563,52930200000,8.99293,23125.2,42563,20441,11,19847,19847,10063,19847,9191
4379,1100,2273,0,4379,0,4379,4.29953e+17,81.4232,2700.65,4379,1083,67,2106,2020,1227,46,626
45069,145,176,45010,59,45069,0,6.02777e+18,173.586,2590.24,45069,175,174,43947,41388,37247,37267,37238
9677,1864,3300,0,9677,0,9677,5.63641e+17,95.1123,4250.7,9677,1579,106,6377,6377,4772,3945,3239
45206,573,15830,0,45206,0,45206,5.49917e+17,96.026,18844.9,45206,7689,110,29376,29032,13339,3425,3643
970,235,395,970,0,912,58,6.20901e+18,80.7938,551.302,970,135,45,575,575,472,531,471
36921,11967,14656,35228,1693,0,36921,1.75678e+18,95.2424,17086,36921,7118,110,22265,22265,18665,17860,14444
47236,5385,11050,44486,2750,44486,2750,5.75479e+18,97.8833,14607.6,47236,5356,110,36186,36186,32753,32189,18923
19353,492,832,0,19353,18793,560,3.80673e+16,126.164,2405.35,19353,115,26,18521,18355,16694,17036,14137
45395,2428,10636,42755,2640,0,45395,2.22586e+18,97.8496,14081.5,45395,5157,110,34759,34759,23663,21601,9861
14087,3050,3341,0,14087,4953,9134,2.531e+15,59.7439,4547.04,14087,1617,72,10746,10746,10360,9976,10053
40060,2,15,38909,1151,39988,72,1.48986e+14,10.4123,597.454,40060,13,12,23313,16977,15158,17119,12731
24281,329,5759,0,24281,0,24281,6.46765e+17,97.5624,7863.08,24281,2783,110,18522,18522,11191,3615,2205
22077,484,796,0,22077,21446,631,3.54919e+16,111.378,2376.5,22077,108,26,21281,21159,18795,19130,14915
39462,14497,14765,39462,0,37352,2110,4.98575e+18,272.159,16440.6,39462,4307,137,24697,24697,24697,24697,24452
13094,2516,3148,12332,762,0,13094,2.22715e+18,97.0643,4464.02,13094,1510,110,9946,9946,9151,9023,8580
47046,817,22039,45146,1900,45146,1900,2.59277e+18,93.0732,24700.2,47046,10696,110,25007,24065,16218,15172,2295
24105,100,176,24029,76,24105,0,6.04501e+18,171.812,1909.47,24105,154,159,21516,14731,12840,13465,13611
47342,1851,11347,44585,2757,44585,2757,3.02408e+18,98.3804,14810.9,47342,5378,111,35995,35995,18100,23898,8056
25827,12055,15070,25827,0,17834,7993,5.14813e+18,561.011,16406.6,25827,4073,132,10757,10662,10109,10641,9686
23306,1687,7244,23306,0,21949,1357,5.63095e+18,162.99,8605.18,23306,2293,128,16062,15927,10526,13303,4204
20574,3510,4919,19384,1190,0,20574,2.21768e+18,97.4097,6774.19,20574,2369,110,15655,15655,14142,13584,11913
7929,79,176,7922,7,7929,0,6.00656e+18,159.777,1075.07,7929,114,119,6346,3767,3319,3626,3536
9649,107,5510,9329,320,0,9649,1.2719e+18,90.1522,6208.56,9649,2657,98,4139,1758,1612,948,0
30115,6299,7047,10593,19522,0,30115,9.86999e+12,59.9862,9251.92,30115,3424,72,23068,23068,21998,22880,20842
4664,93,176,4602,62,4664,0,6.05951e+18,146.731,845.372,4664,93,93,4045,2952,2378,2435,2546
46185,4156,8192,46185,0,46185,0,4.24831e+15,6738.96,19433,46185,8192,6,20775,0,4635,19062,20775
8302,1682,2009,2923,5379,0,8302,9.82021e+12,59.4906,2816.73,8302,971,72,6293,6293,5909,6213,5445
39076,12470,15606,14877,24199,0,39076,7.73705e+12,57.3527,17843.9,39076,7580,72,23470,23470,21415,23040,18118
3273,1530,2142,0,3273,0,3273,3.17416e+17,84.8677,2414.3,3273,1021,57,1131,1131,805,562,849
20225,6238,11371,0,20225,0,20225,3.4961e+15,17.9511,11742,20225,10218,20,8854,8854,4874,5341,4830
39035,1004,1112,0,39035,37922,1113,3.55313e+16,231.243,3769.81,39035,171,26,37923,37923,37622,37611,35823
30408,5272,13096,29078,1330,29078,1330,5.09151e+18,93.9204,15062.1,30408,6294,111,17312,17312,14357,15460,8244
45228,8732,14699,31311,13917,42888,2340,6.91822e+18,97.0674,17741.1,45228,7029,111,30529,30529,20677,24471,19648
31319,115,176,31308,11,31319,0,6.0074e+18,173.054,2138.25,31319,168,165,29078,26140,19468,20098,20368
49598,10624,11578,0,49598,0,49598,6.48586e+17,97.937,15280.3,49598,5621,110,38020,38020,36939,35382,35443
16724,1159,7673,6542,10182,0,16724,7.00757e+12,53.925,8734.25,16724,3732,72,9051,9051,5198,8391,718
1735,175,186,1735,0,1735,0,6.00084e+18,133.337,507.429,1735,69,62,1549,1530,1503,1504,1508
37027,449,1217,0,37027,35961,1066,3.76995e+16,254.324,4023.83,37027,190,26,35810,35181,31971,31431,18489
40274,651,11224,32734,7540,38051,2223,2.62514e+18,97.6957,14149.8,40274,5328,111,29050,28966,6864,14529,3881
11844,5,12,11503,341,11832,12,1.57183e+14,10.5176,317.719,11844,12,11,10940,9908,8140,8201,6812
44971,5367,10541,42358,2613,42358,2613,5.89245e+18,97.8511,13961.6,44971,5112,110,34430,34430,33130,33130,18697
18306,1924,8745,17576,730,0,18306,1.52969e+18,92.2082,10028.4,18306,4228,110,9561,9561,5859,5356,3491
10076,4080,4650,0,10076,3945,6131,1.78735e+15,56.0177,5370.58,10076,2259,72,5426,5426,5274,5038,5176
38913,718,9155,36653,2260,0,38913,2.22378e+18,97.8096,12202.4,38913,4435,110,29758,29758,10337,9179,4125
35992,6053,9659,0,35992,0,35992,6.19557e+17,97.2765,12422.5,35992,4686,110,26333,26333,22954,23284,17439
37372,24,61,37308,64,37372,0,2.26165e+18,60.7771,1439.36,37372,61,61,23062,4555,11486,12960,14375
23162,3701,6825,21902,1260,21902,1260,1.79827e+18,97.2389,8701.78,23162,3245,111,16337,16337,13946,16166,9771
37684,11846,14804,37684,0,35784,1900,4.83835e+18,291.324,16643.2,37684,5652,135,22880,22827,21809,22696,20046
43886,20510,22983,42296,1590,0,43886,1.38847e+18,92.5973,25299.3,43886,11158,110,20903,20903,20018,19542,18897
49613,9507,11561,0,49613,17444,32169,2.52987e+15,60.0815,14880.8,49613,5627,72,38052,38052,35130,32384,31716
2970,1,10,2885,85,2970,0,1.38179e+14,9.86532,150.515,2970,10,10,759,759,759,759,759
8579,1722,3519,3269,5310,0,8579,7.72078e+12,56.8085,4201.85,8579,1712,72,5060,5060,4205,4862,2958
8123,296,358,0,8123,7891,232,3.57139e+16,19.9586,1011.48,8123,57,26,7765,7765,7521,7554,6844
43179,10097,10122,0,43179,0,43179,6.47059e+17,97.8742,13436.6,43179,4904,110,33057,33057,33055,33056,33057
11334,1975,3849,0,11334,4194,7140,2.18677e+15,57.9974,4765.16,11334,1866,72,7485,7485,5859,3583,3277
38778,8462,18153,38778,0,37228,1550,4.57682e+18,1653.96,20569.1,38778,4554,143,20625,18896,15985,16983,11545
30642,22,176,30628,14,30642,0,5.9828e+18,169.563,2074.14,30642,168,165,12780,2344,3452,3980,3747
28564,5582,13352,28564,0,27282,1282,4.88468e+18,287.811,14663.3,28564,3256,137,15212,15033,11524,12357,7584
40397,6679,9464,14206,26191,0,40397,9.86647e+12,60.03,12261.4,40397,4599,72,30933,30933,26947,30243,22184
7240,2,11,7033,207,7234,6,1.44703e+14,10.4239,242.296,7240,11,11,4205,3032,2795,2932,2403
7398,1631,1842,6968,430,6968,430,3.23421e+18,96.2221,2701.57,7398,874,101,5556,5556,5356,5496,5202
6597,880,1697,6217,380,6217,380,2.46e+18,96.4408,2477.88,6597,791,95,4900,4900,4057,4783,3159
26708,10260,13092,26708,0,0,26708,8.75835e+17,17.9764,13564.4,26708,11768,20,13616,13616,10949,12790,10725
9807,260,3347,9807,0,9237,570,5.53606e+18,92.2426,4040.14,9807,1191,118,6460,6460,2634,4364,884
41608,6022,15720,39626,1982,39626,1982,3.76511e+18,96.1893,18394.6,41608,7533,111,25888,25888,18906,21626,9456
25964,4478,25964,25964,0,0,25964,134213000,0,25964,25964,25964,1,0,0,0,0,0
3309,1220,1417,3159,150,0,3309,1.73429e+18,72.0172,1816.03,3309,655,69,1892,1892,1892,1892,1892
45400,29,206,45321,79,45400,0,5.98486e+18,186.595,2604.09,45400,181,179,22246,5487,6622,7805,6186
18327,1,15,17773,554,18268,59,2.05727e+14,10.528,466.549,18327,14,12,2375,2375,2375,2375,2375
25858,4819,9369,24601,1257,0,25858,1.86046e+18,95.616,11296.7,25858,4542,110,16489,16489,14100,12822,10301
24367,380,1333,0,24367,23643,724,4.69334e+16,199.37,3997.89,24367,215,26,23026,22259,18496,19884,11574
18071,524,778,0,18071,17554,517,3.72709e+16,99.4624,2209.02,18071,104,26,17293,17192,16212,16362,14170
39524,8571,14472,39524,0,37384,2140,4.23871e+18,278.991,16160.6,39524,4938,136,25052,24970,18887,21446,15605
30482,1669,7290,28704,1778,28704,1778,3.56391e+18,98.2116,9746.3,30482,3441,111,23192,23192,11833,13548,6678
26899,122,176,26845,54,26899,0,6.1145e+18,172.488,2031.58,26899,152,156,25435,23263,18508,18631,18856
18262,4847,4941,0,18262,6541,11721,2.41663e+15,59.3258,6365.61,18262,2407,72,13321,13321,13205,13147,13173
19141,4459,10531,18481,660,0,19141,1.31991e+18,92.5308,11717.7,19141,5111,110,8610,8524,6315,6973,5999
37289,3151,13897,37289,0,35289,2000,4.75985e+18,262.343,15507.6,37289,3062,136,23392,22929,12913,16556,5503
42524,525,13074,0,42524,15511,27013,2.28362e+15,58.8697,15762.5,42524,6363,72,29450,29199,12103,2602,2185
1276,5,10,1240,36,1276,0,1.3787e+14,9.72962,98.9865,1276,10,10,1170,1028,819,827,739
25592,14838,25592,25592,0,0,25592,7.99969,0,25592,25592,25592,1,0,0,0,0,0
1363,281,535,1323,40,1283,80,4.06173e+18,83.0968,730.957,1363,182,53,828,828,570,676,601
34545,6681,10244,32698,1847,32698,1847,3.11984e+18,96.7685,12841.9,34545,4964,110,24301,24301,21425,23508,16562
36811,9,15,35732,1079,36744,67,1.73721e+14,10.457,656.827,36811,13,11,36421,36036,31100,31033,26272
25361,307,1056,0,25361,24625,736,3.99484e+16,215.457,3239.99,25361,160,26,24222,23871,21622,20468,11299
39499,104,206,39421,78,39499,0,5.98165e+18,186.775,2431.16,39499,177,173,35619,23322,19444,20653,20165
42777,8731,12500,40477,2300,40477,2300,6.78351e+18,96.9409,15590.1,42777,6066,110,30277,30277,30277,30277,21466
25466,129,208,25415,51,25466,0,6.09936e+18,201.367,2120.51,25466,160,164,23719,21804,15364,15854,15813
887,23,60,0,887,859,28,3.51758e+16,17.6347,162.033,887,22,23,825,780,710,717,445
1773,22,1059,1773,0,1703,70,3.8649e+18,54.5606,1241.31,1773,451,50,274,21,38,68,0
41601,5837,11259,0,41601,14904,26697,2.41087e+15,59.4709,14010.3,41601,5485,72,30342,30342,24950,17515,15962
17265,2215,4092,16255,1010,16255,1010,5.87479e+18,97.403,5715.77,17265,1975,110,13173,13173,12693,12693,7661
26557,10341,10523,25337,1220,25337,1220,8.25949e+18,95.0761,12413.1,26557,5100,110,16034,16034,15994,15994,15769
14611,1508,3856,13791,820,0,14611,2.15177e+18,96.777,5253.46,14611,1853,110,10755,10755,7602,7229,5228
33621,116,176,33570,51,33621,0,6.05043e+18,173.058,2254.2,33621,165,165,31292,28189,21318,21841,21933
7287,126,176,7282,5,7287,0,6.0967e+18,162.08,1056.61,7287,110,108,6842,6339,5211,5251,5204
33850,7914,10924,33850,0,31880,1970,4.95363e+18,234.098,12463,33850,2645,133,22926,22864,21026,22382,17499
36056,8084,16798,34576,1480,34576,1480,6.73964e+18,93.4219,18928.4,36056,8088,111,19258,19258,17100,18136,10572
32272,6057,18147,0,32272,0,32272,3.49858e+15,17.8754,18619.9,32272,16316,20,14125,14125,4876,4970,4460
17798,2926,5635,0,17798,0,17798,5.80077e+17,96.1111,7165.07,17798,2721,110,12163,12163,9734,7471,7235
31367,6336,7343,0,31367,11029,20338,2.52294e+15,59.9709,9621.98,31367,3562,72,24024,24024,22918,21504,21211
12072,1000,3328,4322,7750,0,12072,9.37963e+12,59.1018,4358.81,12072,1616,72,8744,8744,4912,7690,3178
39346,1739,9198,0,39346,0,39346,6.48082e+17,97.8326,12276,39346,4458,110,30148,30148,20007,12205,7377
21709,9,14,21074,635,21656,53,1.6805e+14,10.4742,476.753,21709,13,11,21475,21273,17943,17586,16554
4601,345,1169,0,4601,1618,2983,2.50424e+15,58.7038,1681.58,4601,566,70,3432,3432,2045,1395,1171
26213,6941,8557,26213,0,24685,1528,5.37316e+18,167.151,9844.57,26213,3119,125,17656,17656,16550,17170,14791
25203,1502,11991,9926,15277,0,25203,6.76183e+12,55.983,13408.7,25203,5822,72,13212,13068,7127,10680,1352
6537,1267,1800,6170,367,0,6537,2.14257e+18,95.5721,2566.46,6537,852,94,4737,4737,4144,3999,3495
1344,10,43,0,1344,1302,42,0.03125,0.968006,239.915,1344,43,1,1301,1301,1301,1301,1301
40596,9280,9719,38233,2363,38233,2363,1.5617e+18,98.2983,12789.3,40596,4598,111,30877,30877,30456,30844,29970
7528,759,1769,2641,4887,0,7528,9.92728e+12,59.5541,2524.35,7528,856,72,5759,5759,4277,5499,2622
17504,2877,4122,0,17504,6149,11355,2.52961e+15,59.7987,5551.86,17504,1998,72,13382,13382,11981,11687,9762
8595,1765,2059,0,8595,0,8595,6.53984e+17,96.546,3024.42,8595,980,107,6536,6536,6155,6116,5955
29647,5032,11517,0,29647,0,29647,5.1813e+17,92.2412,13593.5,29647,5573,110,18130,18130,13904,8940,9253
21918,5023,5109,0,21918,7706,14212,2.53922e+15,59.9775,6821.51,21918,2484,72,16809,16809,16691,16636,16671
27553,4658,11351,27553,0,26202,1351,4.85373e+18,217.358,12780.4,27553,2997,134,16202,16133,11300,13144,7203
9033,47,3458,8603,430,0,9033,1.8227e+18,94.3388,4318.16,9033,1661,107,3156,679,2045,2225,578
2822,30,176,2821,1,2822,0,6.03139e+18,139.309,646.644,2822,80,78,1401,363,441,501,471
23933,49,200,23925,8,23933,0,5.98146e+18,181.492,1886.74,23933,161,161,15088,7394,5152,6816,5888
6885,2,11,6691,194,6883,2,1.3994e+14,10.103,229.581,6885,11,11,3984,2825,2720,2866,2295
11152,134,176,11140,12,11152,0,6.10479e+18,166.016,1307.44,11152,128,125,10664,9985,8468,8518,8380
23033,7397,9616,8843,14190,0,23033,7.52162e+12,56.2362,11053.9,23033,4676,72,13417,13417,12217,13207,10932
4757,4,11,4619,138,4751,6,1.54909e+14,9.9691,196.531,4757,11,11,4191,3773,3032,3200,2480
17353,2611,4568,16376,977,0,17353,2.15199e+18,96.9667,6158.53,17353,2201,110,12785,12785,10128,9581,7131
15480,2025,3693,14579,901,0,15480,2.22859e+18,97.2393,5186.48,15480,1776,110,11787,11787,9588,9024,7183
13337,2316,4487,13337,0,12561,776,3.35386e+18,110.963,5324.01,13337,1613,119,8850,8829,6418,7291,4937
4080,1355,1933,0,4080,0,4080,4.63784e+17,85.3005,2369.3,4080,916,68,2147,2147,1715,1066,1316
15331,2167,4217,14481,850,0,15331,2.11972e+18,96.7246,5650.61,15331,2031,110,11114,11114,8385,7736,5301
30254,752,7079,10637,19617,0,30254,9.88068e+12,60.0014,9292.01,30254,3441,72,23175,23175,14026,21595,2867
38363,5,176,38306,57,38363,0,6.06529e+18,173.324,2415.74,38363,172,167,5532,870,683,592,825
24302,3853,10661,0,24302,0,24302,4.76357e+17,94.4028,12333.4,24302,5170,110,13641,13641,9751,6460,5620
15071,4,14,14623,448,15021,50,1.8473e+14,10.711,407.223,15071,13,11,13272,11939,8884,9841,5624
43387,802,1192,0,43387,42149,1238,3.55297e+16,247.363,4117.67,43387,187,26,42195,42195,40464,40643,33275
33760,832,1387,0,33760,32777,983,4.18195e+16,275.776,4435.9,33760,224,26,32373,32373,29391,29913,22998
37171,8009,8762,0,37171,0,37171,6.46829e+17,97.642,11697.3,37171,4241,110,28409,28409,27674,26611,26754
10514,505,3580,9984,530,0,10514,1.93741e+18,95.2674,4593.21,10514,1714,110,6934,6766,3624,3118,2118
36463,6503,14779,34803,1660,34803,1660,3.48764e+18,94.6247,17114.8,36463,7093,111,21684,21684,14377,15671,11878
44134,613,1461,0,44134,42861,1273,3.88126e+16,281.059,4929.94,44134,241,26,42673,41753,39157,38155,23696
46908,14960,15734,44538,2370,0,46908,1.93355e+18,96.2828,18893.8,46908,7641,110,31174,31174,30131,29962,29160
9247,652,2552,8737,510,0,9247,2.12671e+18,95.9904,3538.41,9247,1209,108,6695,6695,3919,3541,2535
38998,2053,9188,36738,2260,36738,2260,5.77899e+18,97.7721,12239.5,38998,4448,110,29810,29810,25530,22176,8114
9053,1361,2605,8553,500,8553,500,2.58976e+18,96.4061,3552.31,9053,1223,109,6448,6448,3696,4654,3403
48001,9845,15119,0,48001,0,48001,5.78773e+17,96.5877,18414.9,48001,7337,110,32882,32882,28621,23670,21546
7213,10,13,7009,204,7151,62,1.39703e+14,10.8878,260.583,7213,13,12,7144,7034,6822,6818,6226
40859,793,1247,0,40859,39689,1170,3.69203e+16,245.053,4212.71,40859,198,26,39612,39612,35735,36413,30001
18854,602,737,0,18854,18317,537,3.55205e+16,66.543,2108.33,18854,96,26,18117,18064,17306,17432,15586
35229,8508,19210,34009,1220,0,35229,1.3272e+18,91.8964,21099.5,35229,9319,110,16019,16019,12159,11293,8433
6448,46,189,0,6448,6221,227,1.14322e+16,7.87252,1038.68,6448,54,10,6259,6259,5791,5941,4572
21284,853,1334,20416,868,6527,14757,1.74559e+18,16.9836,1888.28,21284,880,19,19950,19950,19351,19685,14907
47097,1,10,46376,721,47001,96,9.62275e+13,3.99777,601.625,47097,7,4,19506,19506,19506,19506,19506
19940,1767,4704,18780,1160,0,19940,2.22843e+18,97.4701,6521.05,19940,2266,110,15236,15236,10654,9754,6600
23683,2074,10611,22684,999,22684,999,8.85647e+18,91.3684,12227.1,23683,5132,110,13072,13072,11070,10738,3179
33241,7885,9012,11909,21332,0,33241,9.40158e+12,59.4532,11308,33241,4389,72,24229,24229,22851,23939,20707
14299,166,175,14291,8,14299,0,5.99533e+18,164.424,1416.34,14299,138,145,14085,13926,13654,13691,13723
30807,30022,30807,30807,0,0,30807,7.99974,0,30807,30807,30807,1,0,0,0,0,0
40635,11359,12892,14897,25738,0,40635,8.80546e+12,58.0554,15452.1,40635,6275,72,27743,27743,26690,27555,25587
42987,218,10088,40487,2500,0,42987,2.22589e+18,97.8502,13384.4,42987,4891,110,32899,32791,9354,7391,2742
30425,9048,9557,30425,0,30425,0,2.46365e+18,3025.97,12374.4,30425,7376,25,20868,20868,20804,20808,19867
4229,432,1037,1483,2746,0,4229,9.77427e+12,58.5604,1524.24,4229,495,68,3192,3192,2330,3039,1441
4817,147,1197,4537,280,4537,280,5.89529e+18,95.1343,1831.13,4817,557,85,3620,3620,3171,2870,753
14347,201,3380,0,14347,0,14347,6.49782e+17,97.1397,4796.37,14347,1616,110,10967,10967,6618,465,1362
40091,424,1131,0,40091,38947,1144,3.55462e+16,235.582,3856.96,40091,175,26,38960,38437,34311,34584,20406
36870,357,1071,0,36870,35819,1051,3.55402e+16,222.136,3594.55,36870,163,26,35766,35348,31211,31462,17044
4857,1820,2807,4697,160,0,4857,1.27423e+18,74.6385,3228.71,4857,1326,73,2050,2050,1913,1913,1920
19429,1461,6454,18439,990,0,19429,1.95136e+18,95.9423,8062.66,19429,3118,110,12975,12975,6841,6394,3667
18220,478,562,0,18220,17941,279,2.46309e+16,3.73491,2200,18220,283,4,17658,17658,17649,17600,16171
38329,4106,10287,36180,2149,36180,2149,2.00664e+18,97.8567,13132.5,38329,4887,111,28042,28042,19853,22663,12534
32971,12,14,32015,956,32914,57,1.5855e+14,10.5656,589.194,32971,13,11,32957,32956,32710,32710,32266
31527,987,1501,0,31527,30600,927,4.49437e+16,288.176,4697.85,31527,247,26,30026,30026,29044,28834,23340
34140,6442,8005,32152,1988,0,34140,2.22729e+18,97.7887,10755.7,34140,3876,110,26135,26135,24003,23650,21626
30449,12239,16363,6591,23858,0,30449,53001900000,8.98699,16706,30449,14719,11,14086,14086,11225,14086,10976
22458,1994,7414,22458,0,21151,1307,3.80466e+18,157.934,8580.53,22458,2707,121,15044,14920,8661,11588,4497
42826,343,1492,0,42826,42082,744,2.55229e+16,3.73621,5702.58,42826,748,4,41334,41334,37092,36889,22322
19643,8759,11245,13598,6045,18994,649,3.95327e+18,91.405,12392.2,19643,5415,111,8398,8398,7197,7373,7321
42191,443,1176,0,42191,40985,1206,3.55907e+16,246.411,4039.16,42191,183,26,41015,40437,32464,33371,21495
20403,3625,20403,0,20403,20403,0,2047.9,0,20403,20403,20403,1,0,0,0,0,0
32880,957,1032,0,32880,31938,942,3.6145e+16,212.817,3376.47,32880,155,26,31848,31848,31640,31624,30396
7913,10,12,7679,234,7906,7,1.6907e+14,10.2464,263.381,7913,12,11,7886,7870,7408,7415,7058
35112,13,14,34109,1003,35034,78,1.38862e+14,10.7225,584.146,35112,13,12,35098,35098,34624,34624,33763
32238,1060,1924,9822,22416,9822,22416,2.01943e+18,15.9906,2590.81,32238,1329,18,30314,30314,26210,27870,20949
15140,92,175,15133,7,15140,0,5.99458e+18,164.509,1456.85,15140,146,144,13092,8092,7401,7912,7966
39923,93,176,39833,90,39923,0,6.09574e+18,172.719,2473.18,39923,168,166,35427,25599,20201,20875,21148
34708,420,8100,0,34708,12205,22503,2.53163e+15,60.0259,10571.7,34708,3945,72,26608,26608,7842,2082,1792
26963,118,175,26950,13,26963,0,5.98501e+18,167.244,1942.22,26963,159,163,25187,22888,17884,18207,18326
3856,211,1793,3694,162,3694,162,8.80773e+18,90.9964,2214.19,3856,840,69,2063,1977,1657,1570,800
43455,6956,17644,0,43455,16603,26852,1.96118e+15,57.3202,20058.7,43455,8590,72,25811,25811,18173,10781,8916
22176,856,6088,20948,1228,0,22176,2.11758e+18,96.959,7980.21,22176,2941,110,16088,16002,8686,6754,3764
28982,8141,10438,0,28982,10833,18149,2.11539e+15,57.9694,12286.7,28982,5075,72,18544,18544,16573,13954,13383
39512,15844,17470,39512,0,37793,1719,4.70902e+18,1009.31,19721.8,39512,6606,138,22042,21584,21408,22025,19857
6278,1,11,6098,180,6276,2,1.44593e+14,10.1387,224.923,6278,11,11,1540,1540,1540,1540,1540
45449,2926,12373,0,45449,16293,29156,2.4013e+15,59.4638,15332.6,45449,6023,72,33076,33076,21576,8460,7537
19325,1964,5185,18245,1080,0,19325,2.13678e+18,96.9999,6900.61,19325,2507,110,14140,14140,9927,8971,5083
28289,6231,7287,0,28289,10065,18224,2.45916e+15,59.6133,9327.47,28289,3549,72,21002,21002,19445,17579,17716
36104,7954,9662,34093,2011,0,36104,2.13241e+18,97.2751,12437.3,36104,4683,110,26442,26442,24575,23810,21729
31992,5885,11179,31992,0,30202,1790,3.95902e+18,227.615,12645.5,31992,4281,125,20813,20737,15282,17656,11849
26296,6000,13634,26296,0,25256,1040,4.35656e+18,422.26,14927.2,26296,6238,130,12662,12302,8527,10195,5964
38384,14,176,38325,59,38384,0,6.03009e+18,172.976,2393.3,38384,168,170,12214,2152,2728,2968,2763
34529,26,176,34449,80,34529,0,6.01168e+18,172.834,2254.55,34529,167,169,16040,3880,4717,5074,4936
31973,148,176,31898,75,31973,0,5.98336e+18,169.779,2118.79,31973,164,168,31238,29520,27266,27355,27089
11295,2380,4282,11295,0,10683,612,3.74305e+18,111.369,5016.73,11295,1616,121,7013,6990,4890,5888,3689
2154,613,650,0,2154,0,2154,6.20181e+17,90.851,984.751,2154,289,57,1504,1504,1500,1502,1502
27315,131,176,27259,56,27315,0,6.12965e+18,170.985,2044.44,27315,150,154,26274,24793,20450,20417,20451
24885,4799,5887,23437,1448,23437,1448,5.89168e+18,97.3864,8035.3,24885,2843,110,18998,18998,18720,18720,15993
21581,94,5880,20381,1200,0,21581,2.12454e+18,97.0232,7736.25,21581,2845,110,14403,4869,4452,3383,1325
15098,1408,4449,0,15098,0,15098,5.99645e+17,96.3096,5836.67,15098,2144,110,10649,10649,7017,5140,5174
19253,717,19253,19253,0,19253,0,3.4358e+10,0,19253,19253,19253,1,0,0,0,0,0
18378,2609,7818,0,18378,7075,11303,1.89286e+15,56.8074,9010.55,18378,3793,72,10560,10560,7419,8014,3755
36588,1640,1710,0,36588,35508,1080,4.54545e+16,305.368,5450.34,36588,289,26,34878,34878,34790,34778,34313
11706,45,3610,11086,620,0,11706,2.02892e+18,95.8582,4742.73,11706,1734,110,4448,930,2191,1732,247
40238,3414,17952,40238,0,38666,1572,5.00878e+18,2309.71,20933.8,40238,7913,147,22286,19189,10763,15475,5047
41366,3592,15861,39426,1940,0,41366,1.79504e+18,95.0491,18562.3,41366,7702,110,25505,25505,15385,13226,7410
13851,2481,3314,0,13851,0,13851,6.48912e+17,97.1857,4688.04,13851,1594,110,10537,10537,9493,8630,8586
25202,201,12696,24242,960,24242,960,4.42356e+18,91.7479,14238.8,25202,6099,111,12506,11061,3357,6331,0
21599,4118,8248,0,21599,8152,13447,2.04001e+15,57.5396,9676.88,21599,4007,72,13351,13351,10189,6288,6480
1550,157,186,1550,0,1550,0,5.9249e+18,121.307,475.648,1550,64,56,1364,1330,1266,1264,1223
36877,2533,8630,0,36877,0,36877,6.48707e+17,97.8182,11553.7,36877,4182,110,28247,28247,16895,10540,9599
39284,95,176,39233,51,39284,0,6.00441e+18,167.811,2394.54,39284,167,171,34734,22385,19696,20809,20906
16901,1463,4012,15918,983,0,16901,2.22865e+18,97.3456,5613.65,16901,1925,110,12889,12889,8862,8001,5520
30145,7553,15442,29015,1130,29015,1130,2.58505e+18,94.0699,17181.9,30145,7454,111,14703,14703,11949,14090,7985
10862,1734,2562,0,10862,0,10862,6.54122e+17,97.0653,3713.53,10862,1229,110,8300,8300,7362,6291,6121
14504,2030,3425,0,14504,5102,9402,2.53808e+15,59.7956,4657.74,14504,1666,72,11079,11079,9017,7773,6662
11879,2645,2860,0,11879,0,11879,6.46557e+17,96.9991,4088.79,11879,1368,110,9019,9019,8793,8764,8656
39733,2738,21811,38371,1362,0,39733,1.31565e+18,90.3992,23866.3,39733,10586,110,17922,17922,10849,9242,3392
40980,167,176,40960,20,40980,0,5.98326e+18,172.175,2399.55,40980,172,171,40701,40186,38874,38859,38836
5786,143,1412,5446,340,0,5786,2.24037e+18,95.7283,2135.17,5786,667,91,4374,4374,1467,1284,806
7956,1150,2699,7956,0,7493,463,3.49956e+18,91.8397,3313.68,7956,955,111,5257,5257,3510,4328,2628
48716,7919,20549,48716,0,46644,2072,4.59328e+18,2584.36,23786.7,48716,6044,147,28167,24817,18373,20114,14182
14117,3569,3774,13327,790,13327,790,3.1633e+18,96.6979,5130.77,14117,1806,110,10343,10343,10155,10283,10007
17358,3440,4072,0,17358,6100,11258,2.53001e+15,59.8921,5497.78,17358,1977,72,13286,13286,12364,11815,11417
29362,3,15,28496,866,29304,58,1.80358e+14,10.5354,583.937,29362,13,11,22899,17758,13177,15371,8879
49502,9,14,48088,1414,49418,84,1.38696e+14,10.4979,687.285,49502,13,12,48819,48132,38479,37748,38481
19230,921,1317,3897,15333,0,19230,5.69851e+13,11.9897,1761.82,19230,788,14,17913,17913,15511,14232,16828
12561,2737,3023,11831,730,0,12561,2.22437e+18,97.0234,4300.8,12561,1447,110,9538,9538,9226,9152,8976
34382,3355,8061,32380,2002,32380,2002,3.22558e+18,97.7752,10824.1,34382,3898,110,26321,26321,20049,23626,12092
34950,856,1036,0,34950,33952,998,3.55629e+16,213.412,3445.49,34950,156,26,33914,33914,33381,33365,30355
41428,5326,9978,39023,2405,39023,2405,4.18762e+18,98.265,13090.4,41428,4719,111,31450,31450,22588,24435,17930
23484,868,1283,0,23484,22789,695,4.6584e+16,266.817,3840.29,23484,203,26,22201,22201,21565,21279,17965
29381,6736,8169,0,29381,0,29381,6.09972e+17,96.9869,10509.4,29381,3948,110,21212,21212,19275,17821,17144
7693,1957,4037,3091,4602,0,7693,6.18216e+12,54.9455,4577.91,7693,1960,72,3656,3656,2921,3471,1945
38894,11612,14619,0,38894,14655,24239,2.05981e+15,48.7758,16917.9,38894,7107,72,24275,24275,20608,15619,14509
19005,2801,19005,19005,0,19005,0,34357900000,0,19005,19005,19005,1,0,0,0,0,0
30864,7296,8401,0,30864,0,30864,6.1671e+17,97.1461,10845,30864,4068,110,22463,22463,21203,19638,19401
1283,1,11,1246,37,1281,2,1.3975e+14,9.52221,99.276,1283,11,11,319,319,319,319,319
43201,15475,19061,41361,1840,0,43201,1.62874e+18,94.6053,21644.3,43201,9267,110,24140,24140,22043,21562,20011
23051,8033,9793,0,23051,8876,14175,1.90514e+15,45.0004,11214.1,23051,4754,72,13258,13258,13258,13258,13258
3962,5,10,3851,111,3962,0,1.3818e+14,9.89197,173.662,3962,10,10,3630,3185,2594,2682,2332
10025,99,176,10017,8,10025,0,6.19283e+18,157.767,1229.64,10025,112,114,9072,7269,5716,5875,5700
16934,2841,7631,0,16934,0,16934,4.66721e+17,93.9947,8887.76,16934,3688,110,9303,9303,6906,6217,4053
22085,5,12,21440,645,22068,17,1.68362e+14,10.2298,444.071,22085,12,11,20434,18415,17818,14555,12034
45004,11176,18762,17276,27728,0,45004,7.51045e+12,56.7697,21211.4,45004,9118,72,26242,26242,20704,25292,14130
34134,146,1023,0,34134,33157,977,3.55686e+16,211.244,3382.38,34134,152,26,32867,32716,26762,27365,9280
44590,918,1456,0,44590,43307,1283,3.8595e+16,287.902,4928.72,44590,239,26,43134,43134,41193,41184,32401
29206,323,953,0,29206,28373,833,3.60041e+16,193.383,3040.9,29206,139,26,28240,27942,22314,22411,14061
44503,2750,15613,16562,27941,0,44503,8.35835e+12,50.823,18261.4,44503,7583,72,28890,28890,20066,27370,9314
41811,3403,10684,14856,26955,0,41811,9.60044e+12,59.7043,13496.4,41811,5201,72,31127,31127,21630,29487,10066
1512,238,451,1425,87,1425,87,5.91142e+18,88.3433,711.191,1512,188,52,1061,1061,1061,1061,745
16135,5378,8626,16135,0,15521,614,4.15413e+18,235.755,9558.66,16135,3970,123,7509,7441,6022,6522,4470
21757,165,8007,0,21757,8151,13606,2.09008e+15,57.8082,9469.1,21757,3896,72,13750,13386,7822,634,727
9783,1006,3533,0,9783,3652,6131,2.11862e+15,57.6078,4332.28,9783,1711,72,6250,6250,4310,2473,2183
44294,10952,14607,42041,2253,42041,2253,3.04265e+18,96.3325,17648.1,44294,7085,110,29687,29687,27430,29110,24144
30170,174,8909,28550,1620,0,30170,2.05383e+18,96.758,11251,30170,4315,110,21261,20589,12406,11044,1910
32529,777,10174,11885,20644,0,32529,8.87631e+12,58.1534,12322.1,32529,4940,72,22355,22355,9319,18013,983
21758,3849,9992,14203,7555,20855,903,8.44298e+18,70.0419,11464.2,21758,4795,111,11766,11766,11766,11766,11766
22187,155,5420,20904,1283,20904,1283,3.69363e+18,97.908,7337.91,22187,2551,111,16767,16601,6712,10375,1598
9136,977,4813,9136,0,8766,370,4.8508e+18,123.902,5419.03,9136,2024,110,4323,4173,2950,3494,2016
17178,4034,4044,0,17178,6038,11140,2.52909e+15,59.811,5452.4,17178,1960,72,13134,13134,13134,13133,13130
5411,1476,1869,0,5411,1994,3417,2.16981e+15,57.4661,2397.06,5411,904,72,3542,3542,3407,3200,3329
29665,10132,11654,28295,1370,28295,1370,8.04818e+18,94.5009,13719.4,29665,5652,110,18011,18011,17531,17451,16005
2408,759,1049,2298,110,2298,110,3.2864e+18,78.5145,1360.62,2408,465,68,1359,1359,1061,1344,1019
13338,3124,4589,13338,0,10984,2354,5.26228e+18,116.397,5422.82,13338,977,123,8749,8720,8102,8711,6252
39328,12,14,38208,1120,39246,82,1.38777e+14,10.4582,595.642,39328,13,12,39314,39310,38039,38039,36240
20889,916,4908,19669,1220,19669,1220,3.23497e+18,97.6012,6791.21,20889,2374,110,15981,15981,8793,12207,3989
18572,7162,9870,4027,14545,0,18572,5.2886e+10,8.97609,10138.2,18572,8878,11,8702,8702,6858,8702,6712
38417,2,16,37289,1128,38355,62,1.69873e+14,10.4589,643.246,38417,14,12,22665,17434,13103,17570,11816
15781,201,888,4762,11019,0,15781,6.91089e+18,15.9791,1350.72,15781,658,18,14893,14893,8097,7390,7108
48565,18,176,48540,25,48565,0,5.98146e+18,171.781,2610.72,48565,171,173,17934,2929,4658,4636,4690
43657,4587,8192,43657,0,43657,0,4.78636e+15,6654.82,18893.5,43657,8192,7,21045,0,6239,18730,21045
17872,3315,5922,17872,0,16832,1040,5.11466e+18,139.898,6931.92,17872,2133,121,11950,11879,9664,10720,7274
33797,8204,14949,33797,0,32217,1580,4.23817e+18,404.381,16500.4,33797,5550,136,18848,18688,15122,16347,12404
31661,1997,8542,0,31661,11330,20331,2.41473e+15,59.4533,10748.3,31661,4160,72,23119,23119,13099,8606,6732
36254,3191,8483,34144,2110,0,36254,2.22924e+18,97.8251,11370.2,36254,4106,110,27771,27771,19239,17580,11682
49165,11407,18202,46795,2370,46795,2370,5.33047e+18,96.364,21278.2,49165,8727,111,30963,30963,27286,30486,21367
27725,2435,12684,26572,1153,26572,1153,3.00363e+18,94.8139,14452.3,27725,6102,111,15041,14954,10190,7961,1993
32514,5911,11142,0,32514,12059,20455,2.17529e+15,58.2819,13209.9,32514,5428,72,21372,21372,16961,11400,11789
31185,427,1037,0,31185,30668,517,2.51722e+16,3.73529,3995.14,31185,520,4,30148,30148,29048,28793,19484
29959,2313,13413,28689,1270,28689,1270,6.46312e+18,94.9925,15310.9,29959,6449,111,16546,16546,11825,7982,4377
14500,4121,4822,14500,0,13656,844,5.04847e+18,119.219,5705.98,14500,937,125,9678,9678,9602,9678,8661
42457,10360,16453,0,42457,0,42457,5.19099e+17,95.4564,19193.6,42457,7994,110,26004,26004,24419,24825,22925
20024,146,176,20018,6,20024,0,5.9847e+18,167.31,1684.22,20024,156,154,19461,18244,16815,16700,16684
36331,1277,2171,34177,2154,11070,25261,1.72185e+18,16.9909,2901.41,36331,1497,19,34160,34160,32373,33108,23682
49855,6944,15022,18120,31735,0,49855,8.99413e+12,58.9907,18110,49855,7309,72,34833,34833,26238,33353,15828
30287,9177,14106,0,30287,11887,18400,1.76584e+15,56.2839,15764.4,30287,6863,72,16181,16181,13743,11723,10935
18008,4710,8490,7093,10915,0,18008,6.85372e+12,55.1305,9590.63,18008,4130,72,9518,9518,8194,9240,6134
3182,38,781,1112,2070,0,3182,1.01399e+13,58.5409,1175.91,3182,380,62,1872,423,580,1573,216
1837,2,6,1804,33,1805,32,1.01435e+14,3.9755,94.356,1837,5,4,1389,1173,1282,1173,1098
29690,248,941,0,29690,28842,848,3.5558e+16,184.771,3015.93,29690,137,26,28676,28453,21580,21223,11629
38296,10265,12309,38296,0,36066,2230,3.74854e+18,270.521,13991.4,38296,4556,126,25987,25987,23797,24738,22513
13953,254,967,0,13953,2825,11128,1.45856e+16,11.9849,1344,13953,573,14,12986,12986,8599,6218,11003
38007,3819,13487,36127,1880,36127,1880,1.58822e+18,96.5579,16053.3,38007,6457,111,24520,24520,24312,24412,8455
22099,2353,8609,21065,1034,21065,1034,5.53671e+18,94.6438,10238,22099,4125,111,13490,13490,11741,13469,4150
18402,6154,7605,18402,0,17492,910,4.56778e+18,141.097,8674.79,18402,3196,124,10797,10797,9928,10322,8651
48646,3832,19871,48646,0,37035,11611,4.51438e+18,1875.53,22701.8,48646,5480,145,28775,26244,14758,18608,7518
25040,8345,9723,25040,0,17438,7602,5.29617e+18,172.901,10928.6,25040,3461,129,15317,15317,15232,15317,14326
29801,527,7142,28068,1733,28068,1733,4.2898e+18,98.1571,9555.2,29801,3368,111,22659,22659,10024,14485,3115
42895,4,15,41640,1255,42806,89,1.63983e+14,10.4506,683.091,42895,14,12,37490,33449,32019,29325,16894
31916,6135,7467,0,31916,11222,20694,2.52719e+15,60.0009,9777.06,31916,3632,72,24449,24449,22830,22541,20253
15821,1541,3862,14900,921,14900,921,2.55108e+18,97.7291,5349.14,15821,1810,111,11959,11959,8737,10446,5567
13205,2685,4008,0,13205,0,13205,5.9845e+17,96.0308,5248.37,13205,1933,110,9197,9197,8151,6813,7351
38388,13823,17501,38388,0,36988,1400,4.71107e+18,2628.59,20643.1,38388,5777,142,20887,18642,19426,20287,16966
10574,2696,3579,10574,0,9959,615,3.64284e+18,92.4079,4304.12,10574,1105,122,6995,6995,6946,6981,5699
19751,2729,4830,0,19751,6976,12775,2.50954e+15,59.7618,6385.1,19751,2352,72,14921,14921,11806,8998,8149
20933,34,1150,0,20933,20316,617,4.56483e+16,260,3379.8,20933,177,26,19252,19172,14261,11302,2444
25122,3515,11531,24087,1035,24087,1035,2.67081e+18,91.9748,13195.7,25122,5587,110,13591,13591,7172,9526,5224
9357,331,665,0,9357,9085,272,4.27941e+16,19.534,1631.49,9357,85,26,8692,8692,8050,7923,4149
28082,51,910,0,28082,27281,801,3.55849e+16,172.44,2883.32,28082,131,26,26939,26913,16984,16800,5536
41849,10727,15744,0,41849,15772,26077,2.06068e+15,57.7791,18178.6,41849,7668,72,26105,26105,18791,14414,9908
15803,444,3662,5541,10262,0,15803,9.95932e+12,59.8986,4986.64,15803,1783,72,12141,12141,4448,10025,1632
14059,3571,8035,0,14059,5777,8282,1.42269e+15,54.1438,8817.12,14059,3896,72,6024,6024,3926,2465,2004
11145,4416,6815,11145,0,10773,372,5.04762e+18,163.957,7411.37,11145,2434,112,4330,4330,4023,4197,3888
45570,12677,14489,45570,0,42912,2658,4.97814e+18,314.546,16394.9,45570,4901,133,31081,31081,30218,30941,28012
3872,787,1185,3662,210,0,3872,2.07825e+18,93.6996,1696.81,3872,551,76,2687,2687,2169,2136,1809
27635,7048,9815,27635,0,26098,1537,5.53087e+18,198.112,11137.2,27635,3625,130,17820,17786,16371,17369,13953
46384,1129,1866,0,46384,45029,1355,4.30491e+16,315.744,6170.33,46384,320,26,44518,44518,42794,42357,32976
22843,3134,8690,22843,0,21653,1190,3.9833e+18,166.54,9966.84,22843,3589,123,14153,13986,9174,11266,5245
10472,2280,2827,0,10472,0,10472,6.20962e+17,96.2951,3912.54,10472,1353,110,7645,7645,6931,6627,6359
43179,11965,18015,41268,1911,0,43179,1.6971e+18,93.6385,20687.9,43179,8736,110,25164,25164,21661,20065,15908
21492,343,907,0,21492,4477,17015,1.50004e+16,11.9915,1384.69,21492,903,13,20585,20585,15530,11614,18333
36497,14785,15175,14005,22492,0,36497,7.53906e+12,56.9077,17246,36497,7376,72,21322,21322,21090,21272,20879
35350,2195,10349,33437,1913,33437,1913,5.00702e+18,97.418,12953.2,35350,4918,111,25001,25001,16306,19569,5858
42473,4,13,41264,1209,42457,16,1.38739e+14,10.2553,585.961,42473,12,12,36848,32710,32572,29426,18002
43107,7,15,41844,1263,43045,62,1.66579e+14,10.4197,703.918,43107,13,11,41865,41028,33646,33180,25613
43129,6154,13270,0,43129,15722,27407,2.28516e+15,58.8883,15988.4,43129,6461,72,29859,29859,23099,19941,14965
21783,1048,5197,20523,1260,20523,1260,5.78578e+18,97.4649,7135.23,21783,2508,110,16586,16586,13959,11857,4149
38253,6580,14518,36450,1803,0,38253,1.80735e+18,95.4936,17070.6,38253,7048,110,23735,23735,18958,17009,11616
49428,11382,16637,0,49428,0,49428,5.60749e+17,96.2856,19929,49428,8077,110,32791,32791,29457,26213,26057
43470,3139,10097,15268,28202,0,43470,9.89824e+12,60.073,13074.4,43470,4915,72,33373,33373,23147,31604,10660
1750,1,90,0,1750,1701,49,3.52465e+16,19.2491,267.431,1750,29,26,253,253,253,253,253
34472,47,176,34419,53,34472,0,6.02073e+18,172.65,2257.69,34472,166,169,21744,9840,7927,9677,9295
19754,175,1266,0,19754,19162,592,5.01748e+16,252.686,3674.56,19754,200,26,18106,17757,14355,11381,4524
27398,10385,11790,26208,1190,0,27398,1.66279e+18,94.5768,13640.7,27398,5721,110,15608,15608,15398,15224,15307
36586,2982,12476,34750,1836,0,36586,1.92005e+18,96.111,15057.2,36586,6057,110,24110,24110,12876,11041,5515
49448,1,15,48040,1408,49363,85,1.3891e+14,10.6032,704.682,49448,13,12,12661,12661,12661,12661,12661
40366,3631,9425,38016,2350,0,40366,2.22915e+18,97.8596,12567.6,40366,4563,110,30941,30941,23134,21543,13537
49808,15357,17382,0,49808,18529,31279,2.14896e+15,58.2351,20287.6,49808,8465,72,32426,32426,31926,31710,31297
6587,511,1699,6207,380,6207,380,4.78444e+18,96.3252,2475.83,6587,782,96,4888,4888,2669,3314,1995
27820,5838,6468,0,27820,9768,18052,2.53714e+15,60.0004,8537.78,27820,3147,72,21352,21352,20429,19882,19489
612,7,10,596,16,612,0,1.40738e+14,8.70588,67.5404,612,10,10,589,582,530,533,453
29897,6336,9719,0,29897,0,29897,5.71509e+17,96.2869,11969.7,29897,4711,110,20178,20178,16818,14683,13161
21685,568,791,0,21685,21065,620,3.55088e+16,108.43,2347.27,21685,106,26,20894,20778,20143,20249,16774
43577,2,16,42288,1289,43507,70,1.78534e+14,10.3834,723.875,43577,13,12,25829,20298,12653,13385,10404
45805,132,176,45727,78,45805,0,5.98447e+18,171.917,2535.78,45805,173,172,43916,41186,34046,34770,34341
30520,535,1132,0,30520,29640,880,3.8862e+16,236.759,3606.21,30520,173,26,29388,28860,26926,26332,16704
18938,1,11,18384,554,18925,13,1.60238e+14,9.86461,399.089,18938,11,11,4090,4090,4090,4090,4090
7062,586,3055,0,7062,0,7062,4.88627e+17,93.2518,3737.5,7062,1465,97,4007,3921,2792,2086,1574
21483,10,11,20866,617,21473,10,1.45697e+14,10.132,416.347,21483,11,11,21444,21399,21297,21298,21039
17221,7645,9413,16621,600,16621,600,2.42205e+18,92.417,10514.9,17221,4560,110,7808,7808,6503,6914,6623
11799,4,12,11460,339,11793,6,1.38268e+14,10.3525,304.348,11799,12,11,10332,9222,7753,7933,6729
20429,4880,5351,19279,1150,19279,1150,6.08867e+18,97.112,7153.63,20429,2583,110,15078,15078,14793,14750,13988
38847,6,12,37737,1110,38826,21,1.38865e+14,10.2398,557.254,38847,11,12,36902,35845,32401,32186,25131
28090,678,12154,0,28090,10860,17230,1.873e+15,56.8413,13798.6,28090,5912,72,15936,15504,9812,6063,2507
1855,229,515,0,1855,0,1855,6.60003e+17,90.7267,824.3,1855,226,56,1340,1340,971,986,778
2286,508,626,2156,130,0,2286,2.20821e+18,91.4755,988.308,2286,277,61,1660,1660,1550,1553,1543
41401,8631,12231,39181,2220,0,41401,2.05065e+18,96.5248,15230.5,41401,5935,110,29170,29170,25412,24745,21151
3439,197,840,1206,2233,0,3439,9.87801e+12,58.6551,1262.81,3439,401,64,2599,2599,1248,2223,705
42009,3564,13170,15363,26646,0,42009,8.84775e+12,58.7696,15810.3,42009,6406,72,28839,28839,16829,25231,6964
38196,17888,24746,33855,4341,33855,4341,7.171e+16,5.52471,28388.3,38196,8254,13,13450,13450,12484,12486,10203
43147,598,1747,0,43147,41881,1266,4.28267e+16,302.852,5740.47,43147,295,26,41400,40135,33341,34677,19497
40244,1578,12011,38094,2150,0,40244,2.04259e+18,96.8282,14931.5,40244,5832,110,28233,28233,14602,11986,6800
10854,1522,4608,10854,0,10322,532,3.83013e+18,118.907,5355.71,10854,1929,121,6246,6210,4588,5177,3666
32319,7010,7548,11359,20960,0,32319,9.88002e+12,60.0238,9884.65,32319,3671,72,24771,24771,23986,24631,23201
3486,218,295,0,3486,3382,104,4.51445e+16,18.9601,716.394,3486,51,26,3191,3191,2995,3005,2443
45696,10536,20423,0,45696,0,45696,4.69109e+17,94.3126,23099.2,45696,9931,110,25273,25273,20341,16383,15402
24985,818,1245,0,24985,24250,735,4.44516e+16,258.278,3773.53,24985,196,26,23740,23740,21875,22256,18237
18056,109,175,18045,11,18056,0,5.97245e+18,165.898,1591.35,18056,148,153,16507,12956,10717,11107,11473
22014,5822,7408,20903,1111,0,22014,1.93691e+18,95.9272,9167.84,22014,3576,110,14606,14606,13024,12703,11433
17310,2268,5741,17310,0,16300,1010,3.36107e+18,137.938,6731.62,17310,2077,121,11569,11502,7500,9014,4974
6838,51,238,0,6838,6721,117,2.54488e+16,3.73106,948.251,6838,121,4,6600,6600,5850,5820,3560
33545,12461,14426,12950,20595,0,33545,7.3419e+12,55.9014,16324.7,33545,7005,72,19119,19119,18456,18979,17537
11617,214,839,0,11617,11274,343,4.6955e+16,147.274,2180.49,11617,116,26,10778,10596,9195,8375,3924
37211,8227,17187,14582,22629,0,37211,6.9456e+12,56.3875,19153.3,37211,8364,72,20024,20024,15689,19283,10609
24793,11577,12988,24793,0,15969,8824,4.96554e+18,340.85,14199.4,24793,5891,129,11805,11805,11551,11725,11337
21329,273,783,0,21329,20718,611,3.55102e+16,103.737,2316.92,21329,105,26,20546,20438,16350,16525,10498
1366,169,374,480,886,0,1366,9.94698e+12,55.6501,582.799,1366,175,49,992,992,715,913,511
12829,2633,3086,12082,747,0,12829,2.2245e+18,97.0521,4384.89,12829,1479,110,9743,9743,9156,9085,8748
20802,12,176,20730,72,20802,0,5.99168e+18,166.812,1725.32,20802,153,159,5896,929,1150,1244,1313
14687,83,176,14676,11,14687,0,6.12763e+18,168.608,1499.62,14687,130,134,12415,9085,6816,6940,6915
33590,1801,8065,31630,1960,31630,1960,5.66705e+18,98.2619,10708.3,33590,3814,111,25525,25525,13549,17351,7025
48932,6143,11453,46090,2842,46090,2842,3.35119e+18,97.8752,15112.6,48932,5549,110,37479,37479,26816,31565,21588
7758,2167,3969,7758,0,7758,0,3.58476e+18,18.9001,4216.89,7758,3556,21,3789,3789,2180,2083,2136
49092,4471,21026,18953,30139,0,49092,7.36937e+12,56.8857,23613.5,49092,10238,72,28066,28066,17902,26326,5686
23260,169,176,23244,16,23260,0,6.02515e+18,172.432,1862.69,23260,152,159,23027,22753,22128,22155,22198
14695,2358,4082,13885,810,0,14695,2.11263e+18,96.5875,5465.45,14695,1961,110,10613,10613,9273,8995,7986
21648,460,789,0,21648,21029,619,3.55162e+16,107.82,2343.34,21648,106,26,20859,20744,19658,19785,14334
43632,1565,2530,41844,1788,13240,30392,1.72303e+18,16.9923,3332.81,43632,1799,19,41102,41102,39189,40024,29217
21532,1783,5182,20274,1258,20274,1258,3.0037e+18,98.0685,7063.07,21532,2448,111,16350,16350,11531,13740,6643
7619,136,176,7613,6,7619,0,6.06672e+18,162.746,1079.12,7619,109,107,7270,6815,5864,5897,5846
38069,13347,14072,0,38069,14293,23776,2.07876e+15,57.8812,16349.3,38069,6849,72,23997,23997,23820,23709,23786
1585,324,425,560,1025,0,1585,9.64699e+12,56.3514,661.657,1585,192,50,1160,1160,1055,1140,1028
47192,8451,11050,44449,2743,0,47192,2.22641e+18,97.8674,14605.7,47192,5356,110,36142,36142,32665,32019,28609
16599,5331,6335,16599,0,15729,870,4.4072e+18,155.074,7371.59,16599,2611,123,10264,10264,9558,9873,9057
8629,387,449,0,8629,8384,245,3.77616e+16,19.8331,1196.71,8629,65,26,8180,8180,7978,8014,7377
11281,2898,4750,10773,508,10773,508,5.08692e+18,92.1923,5706.97,11281,2251,111,6531,6531,5895,6412,3795
11423,206,2718,4021,7402,0,11423,9.91213e+12,59.651,3741.14,11423,1324,72,8705,8705,2755,7033,815
20137,48,176,20060,77,20137,0,6.0031e+18,169.137,1719.22,20137,157,153,12756,5963,4770,5675,5573
44236,116,176,44133,103,44236,0,6.10271e+18,173.752,2604.68,44236,171,169,41420,37651,28265,28979,29182
39832,10816,12077,39832,0,37512,2320,4.56804e+18,284.021,14096.1,39832,4735,126,27755,27755,26776,27317,25536
10170,2906,5221,2217,7953,0,10170,52647800000,8.84041,5421.84,10170,4695,11,4949,4949,3231,4949,3062
15428,1429,3966,0,15428,5485,9943,2.47062e+15,59.5023,5230.76,15428,1932,72,11462,11462,6950,4251,3225
37056,23724,37056,37056,0,37056,0,34358800000,0,37056,37056,37056,1,0,0,0,0,0
12214,2373,4136,12214,0,11504,710,3.17342e+18,99.2041,4926.11,12214,1483,121,8078,8071,6156,6879,5028
14621,3540,3582,13770,851,13770,851,1.86101e+18,97.6431,4983.53,14621,1676,111,11039,11039,11009,11036,11028
5111,1154,1798,4851,260,4851,260,4.16606e+18,94.3933,2386.91,5111,844,89,3313,3313,2140,2462,1829
888,74,264,310,578,0,888,1.03567e+13,53.2511,411.134,888,125,42,624,457,262,507,188
31187,4183,9132,11280,19907,0,31187,9.12222e+12,58.6533,11258.8,31187,4429,72,22055,22055,17336,21001,10464
11613,78,175,11607,6,11613,0,5.98381e+18,163.381,1277.64,11613,135,135,9220,5243,4704,5226,5279
19429,1743,7304,18496,933,18496,933,5.23761e+18,95.8503,8806.99,19429,3483,111,12125,12125,5812,7535,3458
31882,6332,17035,30742,1140,30742,1140,4.04063e+18,92.0774,18789.2,31882,8201,111,14847,14847,8907,10028,7747
8228,770,3360,0,8228,3131,5097,1.95543e+15,56.7372,4026.38,8228,1626,72,4868,4820,2642,2243,2113
42207,10999,16789,42207,0,37413,4794,1.45848e+18,4618.43,23776.9,42207,6105,23,25418,20437,21714,22176,21452
7735,4039,4048,0,7735,0,7735,4.17287e+17,92.0295,4686.13,7735,1953,95,3687,3687,3683,3683,3687
30949,6881,11543,11649,19300,0,30949,8.09028e+12,56.856,13463.1,30949,5617,72,19406,19406,16854,18871,12709
26048,7139,8005,0,26048,0,26048,5.87227e+17,88.3592,10071.6,26048,3875,110,18043,18043,17074,17381,15768
21144,3492,9614,0,21144,8250,12894,1.80961e+15,55.431,10887.8,21144,4666,72,11530,11530,8126,5455,4133
29477,5494,7551,27807,1670,27807,1670,3.1824e+18,97.3711,9949.35,29477,3652,110,21926,21926,20132,21410,16997
19883,2852,6545,19883,0,18728,1155,3.81332e+18,148.906,7626.58,19883,1962,125,13338,13243,9874,11066,6111
21690,62,208,21620,70,21690,0,6.01271e+18,195.279,1894.47,21690,161,155,15445,8637,6103,7207,6264
30762,3106,8684,29079,1683,29079,1683,6.43823e+18,96.9734,11094.1,30762,4207,110,22078,22078,19257,18799,7931
9731,1946,2344,3417,6314,0,9731,9.83271e+12,59.5492,3252.1,9731,1137,72,7387,7387,6909,7287,6296
29690,13256,14339,29690,0,28420,1270,4.92155e+18,405.028,15766.6,29690,5341,134,15351,15331,15341,15343,14692
31453,12843,13537,31453,0,29993,1460,4.53454e+18,376.845,15216.9,31453,6078,131,17916,17914,17528,17776,16813
651,23,48,0,651,633,18,3.48666e+16,16.5069,126.777,651,20,22,601,573,481,476,392
8767,1189,3207,3283,5484,0,8767,8.21797e+12,57.4574,3940.66,8767,1557,72,5560,5560,3917,5275,2085
47443,17453,21217,0,47443,18472,28971,1.82383e+15,56.6254,23666.1,47443,10314,72,26226,26226,24843,22920,22694
36526,10,13,35466,1060,36502,24,1.57129e+14,10.2912,568.333,36526,12,12,36432,36289,35111,35086,32202
41818,5417,22950,40368,1450,40368,1450,3.32433e+18,91.9774,25048.6,41818,11071,111,18868,18868,12594,13610,6271
45568,2155,18950,0,45568,0,45568,4.94655e+17,94.9861,21739.3,45568,9210,110,26618,26618,16454,8462,5170
20639,3,4,19994,645,20543,96,0.000145356,0.999806,272.133,20639,4,1,20635,20635,20635,20635,20635
35243,14370,18550,14209,21034,0,35243,6.1206e+12,55.3684,20250.8,35243,9027,72,16693,16693,15203,16443,13664
34803,10805,12967,34803,0,32933,1870,4.9456e+18,240.128,14497,34803,4213,136,21836,21836,21155,21783,19374
42135,6698,9832,0,42135,0,42135,6.48118e+17,97.8559,13084,42135,4767,110,32303,32303,28073,24876,23040
24657,8042,9317,0,24657,9302,15355,2.05732e+15,57.6928,10909.7,24657,4535,72,15340,15340,14662,14453,14075
48832,10911,19058,0,48832,0,48832,5.15733e+17,95.4229,22106.9,48832,9257,110,29774,29774,23835,20214,17193
17755,2362,4366,6279,11476,0,17755,9.7573e+12,59.7302,5798.12,17755,2127,72,13389,13389,10935,12963,8093
17329,116,176,17314,15,17329,0,6.06643e+18,167.296,1630.31,17329,139,146,16069,14450,11034,11338,11409
48904,4999,11393,17198,31706,0,48904,9.88664e+12,60.0863,14674.2,48904,5545,72,37511,37511,28248,35913,16967
49012,365,11415,17233,31779,0,49012,9.89374e+12,60.0831,14699,49012,5561,72,37597,37597,10243,29996,1779
30145,1218,1458,0,30145,29255,890,4.51277e+16,277.429,4543.39,30145,236,26,28687,28687,28303,28344,26340
27217,185,8422,27217,0,25637,1580,5.15783e+18,172.918,9937.21,27217,2154,132,18746,18438,7785,11850,744
35594,74,176,35518,76,35594,0,6.17609e+18,173.126,2316.01,35594,159,157,29629,23154,14865,15014,15025
35258,6014,11453,0,35258,0,35258,5.72473e+17,96.3738,14007.9,35258,5561,110,23805,23805,19354,16608,11955
32812,4741,10537,0,32812,0,32812,5.74456e+17,96.3666,12967.2,32812,5103,110,22275,22275,17136,13009,10559
44083,2848,10337,0,44083,0,44083,6.4725e+17,97.8516,13703.6,44083,5012,110,33746,33746,23566,14766,10912
21790,1420,6900,0,21790,7977,13813,2.2549e+15,56.5084,8458.68,21790,3348,72,14890,14890,8569,596,930
4933,958,1291,4653,280,0,4933,2.18883e+18,94.9134,1926.95,4933,600,85,3642,3642,3224,3168,2973
49901,14956,27622,10748,39153,0,49901,53247100000,8.98056,28052.8,49901,24852,11,22279,22279,14851,22279,14503
46741,7480,10905,0,46741,16433,30308,2.53029e+15,60.065,14062.5,46741,5306,72,35836,35836,31723,26416,24914
19908,8137,19908,0,19908,0,19908,524262,0,19908,19908,19908,1,0,0,0,0,0
42237,1183,9927,0,42237,0,42237,6.46555e+17,97.8222,13179.7,42237,4805,110,32310,32310,12803,6539,5746
17537,3462,5980,16657,880,0,17537,1.92494e+18,94.2747,7456.54,17537,2872,110,11557,11557,9118,8588,6575
17540,8,11,17029,511,17527,13,1.61022e+14,9.94036,385.346,17540,11,11,17213,17004,14030,14111,14463
19437,1,12,18866,571,19424,13,1.69809e+14,10.1626,412.573,19437,12,11,3837,3837,3837,3837,3837
29848,3409,8916,0,29848,10836,19012,2.31623e+15,58.9613,10954.3,29848,4334,72,20932,20932,15402,8873,8805
7052,412,2242,6682,370,6682,370,3.86893e+18,95.4046,3010.82,7052,1047,100,4810,4726,1959,2851,1382
36570,1140,10965,0,36570,0,36570,5.9353e+17,95.3063,13672.8,36570,5316,110,25605,25433,12563,3981,3003
9348,848,4592,9348,0,9348,0,3.2214e+18,18.9307,4872.01,9348,4117,21,4756,4756,1144,870,926
13409,3250,7253,13409,0,12879,530,5.09579e+18,143.917,7977.03,13409,3178,117,6156,6148,4630,5303,3473
38599,15028,15046,0,38599,0,38599,5.17156e+17,95.3535,17581,38599,7307,110,23553,23553,23542,23545,23553
9284,932,2328,8744,540,8744,540,6.10515e+18,97.0826,3328.48,9284,1086,111,6956,6956,3807,5041,3409
42936,13325,13770,42936,0,40439,2497,4.2873e+18,303.377,15596.8,42936,5129,128,29166,29166,28992,29077,28787
34394,15796,18618,0,34394,0,34394,3.47661e+15,17.9336,19124.5,34394,16745,20,15776,15776,13387,13307,13356
23159,1342,7874,0,23159,8568,14591,2.18415e+15,58.2558,9461.26,23159,3832,72,15285,15285,8267,7672,3980
5184,4,10,5036,148,5184,0,1.38131e+14,9.82485,198.493,5184,10,10,4488,3978,4036,4066,2593
39836,101,176,39772,64,39836,0,6.06867e+18,173.547,2466.16,39836,169,168,35873,25342,21555,22343,22675
7020,8,176,7019,1,7020,0,6.00078e+18,160.053,1004.38,7020,115,115,1468,196,246,218,275
17306,4511,6407,16476,830,0,17306,1.84086e+18,92.7046,7820.34,17306,3088,110,10899,10899,10220,10100,9803
13705,2268,3457,0,13705,4860,8845,2.47468e+15,59.4927,4621.49,13705,1674,72,10248,10248,8732,7535,7089
37263,5570,17083,14571,22692,0,37263,6.97405e+12,56.4656,19064.2,37263,8317,72,20180,20180,14018,18350,8070
30040,5092,9909,20759,9281,28499,1541,3.23053e+18,96.7872,12114.9,30040,4734,111,20131,20131,16254,19698,10538
23341,942,996,0,23341,22667,674,3.97103e+16,203.691,2999.43,23341,147,26,22345,22345,22199,22193,21439
23937,6,11,23254,683,23923,14,1.38733e+14,10.1786,433.244,23937,11,11,22751,21995,15972,16039,14670
42312,10678,18993,0,42312,16487,25825,1.81892e+15,56.0496,21220.3,42312,9243,72,23319,23319,20016,15624,14584
44730,5229,13498,44730,0,42127,2603,3.94979e+18,315.225,15700.5,44730,4507,136,31232,31044,21937,24635,13529
21816,2974,5810,0,21816,7799,14017,2.42654e+15,59.4361,7456.56,21816,2825,72,16006,16006,12546,10003,8476
7827,1083,1856,2748,5079,0,7827,9.85609e+12,59.3954,2629.01,7827,899,72,5971,5971,4850,5775,3661
1700,6,149,0,1700,1650,50,4.39551e+16,16.9,366.086,1700,32,25,1305,1056,811,732,263
16470,3939,5815,16470,0,11709,4761,3.90312e+18,134.553,6760.9,16470,2160,121,10655,10649,9021,9796,8328
44157,8943,10250,15520,28637,0,44157,9.8854e+12,60.0716,13270.1,44157,4982,72,33907,33907,32008,33577,29824
19072,1361,4473,0,19072,6705,12367,2.53817e+15,59.8853,6002.32,19072,2177,72,14599,14599,10004,4232,4494
15645,7,12,0,15645,14339,1306,3.00161e+16,9.98492,387.593,15645,12,10,13292,11079,10421,10100,11891
26467,5124,8606,25107,1360,25107,1360,7.22724e+18,96.2182,10654.3,26467,4165,110,17861,17861,17421,17421,12749
15393,2757,7080,15393,0,14673,720,3.91782e+18,152.726,7924.42,15393,2960,121,8313,8192,5128,6636,3405
48762,530,17960,0,48762,0,48762,5.34165e+17,94.0466,21094.8,48762,8709,110,30802,30114,13283,2157,73
39566,8310,10050,14052,25514,0,39566,9.61577e+12,59.6942,12740.3,39566,4887,72,29516,29516,27409,29076,23998
19643,1689,5249,7015,12628,0,19643,9.4254e+12,59.3294,6765.15,19643,2541,72,14394,14394,8892,12904,5787
19329,4205,4667,18199,1130,18199,1130,4.92311e+18,97.9894,6399.96,19329,1598,116,14662,14662,14662,14662,13664
13887,1,13,13486,401,13819,68,1.48977e+14,10.7611,363.889,13887,12,12,3294,3294,3294,3294,3294
47104,68,176,47013,91,47104,0,6.01407e+18,173.672,2636.55,47104,172,174,35284,20592,16274,18707,17880
6009,1747,3604,5819,190,5819,190,8.3352e+18,87.9006,4075.09,6009,1705,73,2405,2405,2405,2405,1904
15765,4272,6039,15015,750,15015,750,2.153e+18,92.4707,7319.61,15765,2883,111,9726,9726,8721,9659,7423
18715,1001,1026,0,18715,18168,547,4.4251e+16,205.71,2949.88,18715,154,26,17689,17689,17621,17615,17433
43703,1980,2415,0,43703,42390,1313,5.12266e+16,326.667,7695.13,43703,430,26,41288,41288,40758,40800,37412
18205,1957,5190,17205,1000,17205,1000,1.50976e+18,97.2411,6777.71,18205,2457,111,13015,13015,9035,10525,5416
9296,3088,5060,8966,330,8966,330,3.50424e+18,65.3993,5764.11,9296,2407,100,4236,4236,4236,4236,3524
10055,1563,2502,9467,588,9467,588,3.92594e+18,97.2187,3560.93,10055,1172,111,7553,7553,5798,6207,5182
49807,10379,18495,47407,2400,47407,2400,4.68133e+18,96.3496,21595.8,49807,8869,111,31312,31312,30784,30901,30920
22309,2048,5603,21036,1273,21036,1273,6.14985e+18,97.3257,7550.15,22309,2706,110,16706,16706,15943,15943,7623
5766,2744,2910,2297,3469,0,5766,6.48054e+12,47.2425,3362.93,5766,1395,68,2856,2856,2856,2856,2856
25389,750,9113,24149,1240,24149,1240,7.71278e+18,94.884,11019.4,25389,4412,110,16276,16036,7331,12868,1423
10346,3,13,10049,297,10293,53,1.52028e+14,10.6885,320.198,10346,12,11,7983,5768,6115,6358,3985
27997,165,176,27957,40,27997,0,6.03368e+18,170.497,2050.4,27997,163,161,27704,27438,26354,26076,26193
33050,50,176,32965,85,33050,0,6.04733e+18,173.256,2232.01,33050,167,164,21762,10222,8380,9652,9434
1421,75,428,1341,80,1341,80,5.93347e+18,87.4068,678.009,1421,179,50,798,256,635,715,191
44229,11,14,42966,1263,44151,78,1.38755e+14,10.458,638.519,44229,13,12,44212,44203,38778,38885,36798
34179,9729,17278,34179,0,32866,1313,4.92866e+18,1026.75,19149.5,34179,7681,138,16901,16104,13380,15037,9728
41932,247,1161,0,41932,40737,1195,3.55219e+16,240.694,3995.78,41932,181,26,40628,40211,34322,34357,15187
6283,2772,3065,2481,3802,0,6283,6.73563e+12,55.3395,3554.34,6283,1484,72,3218,3218,2937,3168,2761
16051,4106,5697,15251,800,15251,800,2.65606e+18,96.1141,7036.34,16051,2718,111,10354,10354,8285,8814,7766
47611,8804,13210,44991,2620,0,47611,2.10364e+18,97.2274,16623.7,47611,6417,110,34401,34401,30145,28313,23074
44175,14147,18799,42245,1930,42245,1930,8.54994e+18,94.8537,21489.5,44175,9135,110,25376,25376,24108,23896,19286
7217,1418,2534,6857,360,6857,360,7.46856e+18,93.8688,3296.53,7217,1193,99,4683,4683,4413,4413,1751
24560,385,997,0,24560,23851,709,3.90478e+16,200.72,3043.11,24560,147,26,23563,23200,19237,19791,13519
3084,6,11,2997,87,3084,0,1.41468e+14,10.7244,157.505,3084,11,11,2897,2843,2141,2204,2121
18215,5969,7757,18215,0,17315,900,5.24657e+18,146.984,8718.29,18215,2143,127,10458,10458,9878,10360,8721
36625,2748,13092,13672,22953,0,36625,8.28573e+12,57.6407,15331.4,36625,6368,72,23533,23533,14595,22000,3843
29047,4739,8919,29047,0,27357,1690,3.45287e+18,181.561,10506.5,29047,3229,129,20128,20122,16232,17300,11070
22849,1,11,22198,651,22843,6,1.38723e+14,10.145,422.283,22849,11,11,5858,5858,5858,5858,5858
45619,6679,19195,43609,2010,43609,2010,2.70131e+18,94.9324,21971.7,45619,9329,110,26424,26424,19826,22010,10679
34591,3,16,33561,1030,34526,65,1.86823e+14,10.395,637.214,34591,13,12,27067,21284,14740,17534,8370
16281,18,200,16214,67,16281,0,5.9779e+18,179.651,1560.16,16281,147,151,6003,984,1564,1553,1438
48143,23252,27383,48143,0,48143,0,2.50067e+18,17.9616,27956.8,48143,24634,20,20760,20760,17690,20760,17738
42587,3829,10245,40110,2477,40110,2477,4.00626e+18,98.2916,13427.8,42587,4842,111,32342,32342,23152,27534,13619
21432,2,12,20815,617,21420,12,1.49117e+14,10.452,424.91,21432,12,11,12503,9119,8004,8421,6769
31536,1070,11856,0,31536,0,31536,5.29444e+17,95.5221,14063,31536,5757,110,19680,19680,10219,2195,1939
10200,2231,3170,0,10200,0,10200,5.89291e+17,95.7047,4192.15,10200,1522,110,7030,7030,6054,4810,4773
40280,1324,11338,38060,2220,38060,2220,1.42903e+18,97.6728,14253.4,40280,5392,111,28942,28942,25086,25663,5987
29808,13,15,28941,867,29751,57,1.6528e+14,10.562,577.869,29808,13,11,29793,29793,29258,29258,27983
25118,3773,15144,0,25118,10468,14650,1.31563e+15,52.7847,16287,25118,7371,72,9974,9974,6489,6818,3462
10399,95,2532,9797,602,9797,602,5.80479e+18,96.7063,3639.65,10399,1201,110,7277,2456,5655,4244,565
24938,4638,12138,23958,980,23958,980,2.58329e+18,93.6345,13729.1,24938,5884,110,12800,12800,7764,9381,6702
5760,89,170,5759,1,5760,0,5.98028e+18,157.436,895.036,5760,107,108,4862,2915,2734,2893,3069
9216,20,176,9210,6,9216,0,6.0377e+18,163.777,1174.04,9216,120,123,3651,679,951,1073,1030
39911,7481,9331,37591,2320,0,39911,2.22764e+18,97.8282,12445.8,39911,4513,110,30580,30580,28138,27612,25452
25571,3168,6041,24082,1489,0,25571,2.22583e+18,97.6656,8235.21,25571,2920,110,19530,19530,16319,15023,11123
25726,8,14,24987,739,25653,73,1.48572e+14,10.3798,477.613,25726,14,12,25182,24706,23738,23505,18952
8955,341,476,0,8955,8699,256,3.81411e+16,19.9227,1265.84,8955,67,26,8479,8479,7987,8044,6601
43806,8576,10274,0,43806,0,43806,6.47109e+17,97.8587,13622.1,43806,4981,110,33532,33532,31682,28931,28861
25428,60,981,0,25428,24697,731,3.82732e+16,199.697,3021,25428,145,26,24139,24087,18753,18087,5046
44744,14214,15158,0,44744,0,44744,5.59327e+17,96.1986,18189.3,44744,7363,110,29586,29586,28886,27965,28484
13611,703,8382,13202,409,13202,409,3.71229e+18,49.3529,9196.88,13611,4025,106,5229,5229,2077,2993,0
6112,1029,2380,6112,0,5782,330,3.56176e+18,93.2649,2914.35,6112,957,101,3732,3732,2819,3177,2506
41721,6416,17927,16123,25598,0,41721,7.3685e+12,56.3359,20187.4,41721,8727,72,23794,23794,16867,21532,8741
23770,6997,7993,0,23770,8788,14982,2.19507e+15,58.2955,9623.8,23770,3888,72,15777,15777,15260,14532,14600
38063,11333,16894,36442,1621,36442,1621,2.63522e+18,94.7063,19186.8,38063,8115,111,21169,21169,18544,20998,14684
16628,10,11,16152,476,16622,6,1.38842e+14,10.1209,360.122,16628,11,11,16593,16553,16520,16521,16372
24742,150,175,24734,8,24742,0,5.97884e+18,166.727,1860.69,24742,163,160,24195,23292,21409,21423,21336
18032,126,176,18018,14,18032,0,6.08209e+18,170.475,1663.36,18032,141,145,17117,15743,12982,12949,12876
44367,12476,13562,42025,2342,0,44367,2.0209e+18,96.7375,16691.1,44367,6584,110,30805,30805,29674,29484,28666
24473,2938,5802,23050,1423,0,24473,2.22514e+18,97.5877,7919.4,24473,2804,110,18671,18671,15473,14145,10266
24837,41,175,24824,13,24837,0,5.98844e+18,166.926,1864.29,24837,156,162,14419,5276,4850,6248,5767
43584,152,176,43502,82,43584,0,5.98538e+18,171.968,2473.84,43584,170,172,42809,41557,38027,37931,37827
37153,9,14,36081,1072,37068,85,1.49317e+14,10.6152,614.865,37153,13,12,36653,36188,29565,29055,27310
9354,1167,3684,9354,0,7523,1831,5.42018e+18,90.3161,4327.29,9354,1396,114,5670,5669,3750,4524,2130
902,9,10,876,26,902,0,1.37617e+14,9.31929,81.7305,902,10,10,885,878,861,862,811
21062,2100,5652,7523,13539,0,21062,9.44855e+12,59.3722,7250.62,21062,2748,72,15410,15410,10562,14224,5497
49395,14158,20138,47155,2240,47155,2240,5.04376e+18,95.5842,23084,49395,9659,111,29257,29257,23465,24630,21607
10080,1730,2851,8209,1871,9520,560,4.10542e+18,96.6294,3878.98,10080,1339,111,7229,7229,7229,7229,5356
47991,5332,20805,45924,2067,0,47991,1.6492e+18,94.7216,23642.3,47991,10112,110,27186,27186,18842,16857,9629
47648,19662,21564,45666,1982,45666,1982,4.38156e+18,94.4118,24310,47648,10472,110,26084,26084,26084,26084,24924
10631,3112,3719,10101,530,0,10631,1.90964e+18,95.1462,4730.08,10631,1787,110,6912,6912,6230,6012,5417
42188,6,15,40953,1235,42122,66,1.73023e+14,10.394,705.531,42188,13,11,40386,39353,31714,30597,24010
25335,1,12,24597,738,25320,15,1.65863e+14,10.2283,471.278,25335,11,12,5199,5199,5199,5199,5199
12459,2381,3278,0,12459,0,12459,6.2542e+17,96.62,4522.76,12459,1563,110,9181,9181,7994,6983,6825
18877,16361,18877,18877,0,0,18877,134211000,0,18877,18877,18877,1,0,0,0,0,0
22057,1776,9581,0,22057,8533,13524,1.87273e+15,56.7406,10937.4,22057,4657,72,12476,12476,7011,6103,3094
23809,4577,7252,8669,15140,0,23809,8.98837e+12,58.8623,8944.32,23809,3533,72,16557,16557,13921,16097,10843
44528,1537,14319,30877,13651,42218,2310,2.50845e+18,97.0616,17337.9,44528,6834,111,30209,30209,16792,17594,4408
10377,2954,3965,0,10377,3914,6463,2.05321e+15,57.2794,4779.93,10377,1921,72,6412,6412,5929,5264,5279
30722,563,1028,0,30722,29841,881,3.68591e+16,212.269,3310.84,30722,154,26,29694,29293,25177,25730,19701
13397,3409,6830,13397,0,13397,0,2.47617e+18,17.9382,7152.77,13397,6131,20,6567,6567,3207,6567,3256
49613,12124,22540,47553,2060,47553,2060,2.72785e+18,94.4305,25369.7,49613,10960,110,27073,27073,20118,22599,18031
46662,11957,24899,46662,0,46662,0,2.8936e+18,17.985,25498.4,46662,22394,20,21763,21763,10595,10199,10255
36286,13,14,35217,1069,36237,49,1.74171e+14,10.4258,590.908,36286,13,12,36272,36272,36107,36108,36000
38426,4407,14032,14400,24026,0,38426,8.19922e+12,57.7702,16335.3,38426,6832,72,24394,24394,16088,22964,6084
46814,1398,1868,0,46814,45443,1371,4.29046e+16,317.917,6186.51,46814,322,26,44946,44946,43859,43934,38841
46816,1358,2254,0,46816,45426,1390,4.75479e+16,319.205,7317.21,46816,399,26,44562,44562,42208,42701,32461
18661,1985,6368,18661,0,17621,1040,5.81709e+18,148.192,7519.57,18661,2519,124,12293,12193,9025,10353,4244
10026,9,11,9729,297,10021,5,1.66257e+14,10.3019,292.787,10026,11,11,9903,9774,8352,8396,8453
32480,6,10,31910,570,32384,96,9.99288e+13,3.99766,481.44,32480,7,4,32470,32470,32258,32258,29224
586,184,221,548,38,548,38,3.3256e+18,76.3072,336.886,586,89,37,365,365,342,355,361
13424,755,4462,12741,683,0,13424,1.95652e+18,95.3456,5682.39,13424,2146,110,8962,8883,5090,4232,2747
10797,400,714,3333,7464,0,10797,6.9024e+18,15.9699,1092.01,10797,450,18,10083,10083,7396,7124,6929
17157,2538,5856,0,17157,0,17157,5.5797e+17,95.6536,7307.7,17157,2826,110,11301,11301,8915,6755,6442
37027,7865,8673,34875,2152,0,37027,2.22779e+18,97.7793,11606.7,37027,4197,110,28354,28354,27282,27054,26269
45694,1786,10699,43034,2660,0,45694,2.22782e+18,97.8665,14162.6,45694,5189,110,34995,34995,15909,14297,7879
17186,3285,5018,16257,929,16257,929,3.25492e+18,96.4719,6548.36,17186,2414,110,12168,12168,9789,10754,9241
14261,2008,3402,13431,830,0,14261,2.22595e+18,97.2254,4810.91,14261,1633,110,10859,10859,9033,8666,7134
32587,8676,13905,12570,20017,0,32587,7.40123e+12,56.7216,15769.4,32587,6768,72,18682,18682,13317,17562,4374
37828,9781,19374,0,37828,0,37828,3.4468e+15,17.7028,19926.6,37828,17420,20,18454,18454,10014,16291,9341
30848,5905,8550,11078,19770,0,30848,9.30523e+12,59.3048,10696.7,30848,4152,72,22298,22298,19736,21858,16750
41164,9287,10057,14547,26617,0,41164,9.73764e+12,59.8732,12868.1,41164,4894,72,31107,31107,29976,30907,28775
13363,3856,6146,0,13363,5227,8136,1.78964e+15,54.964,7040.97,13363,2983,72,7217,7217,5869,4176,4460
7312,10,11,7089,223,7304,8,1.94823e+14,10.0845,254.082,7312,11,11,7296,7291,7162,7163,6449
30958,723,1292,0,30958,30058,900,4.1487e+16,265.831,4074.51,30958,206,26,29666,29666,28086,27602,21225
42878,1366,1979,0,42878,41609,1269,4.60027e+16,306.564,6398.68,42878,345,26,40899,40899,39134,39086,33168
6841,306,3763,6601,240,6601,240,2.92809e+18,91.9656,4323.56,6841,1805,87,3078,2817,1349,1839,1234
33113,7208,7727,11632,21481,0,33113,9.8995e+12,60.0381,10107.5,33113,3764,72,25386,25386,24858,25276,24149
13185,2343,3127,4644,8541,0,13185,9.87605e+12,59.7438,4274.49,13185,1518,72,10058,10058,8908,9856,7675
23259,7,14,22593,666,23188,71,1.43745e+14,10.7419,471.99,23259,13,12,22464,22017,17212,17341,12618
40057,12419,16433,0,40057,0,40057,5.00184e+17,94.2778,18976,40057,7980,110,23624,23624,21936,20398,19375
3822,1144,2174,0,3822,0,3822,3.78688e+17,74.9699,2535.31,3822,1025,66,1648,1648,1398,1272,1331
11140,1947,3508,4062,7078,0,11140,8.89384e+12,58.4251,4437.52,11140,1705,72,7632,7632,5832,7322,3860
18552,152,731,0,18552,18024,528,3.55394e+16,59.2358,2082.83,18552,94,26,17821,17777,13046,13058,6504
7560,1330,1864,7119,441,7119,441,3.68483e+18,96.7856,2730.34,7560,871,102,5696,5696,5164,5657,4525
2115,233,550,0,2115,737,1378,2.46754e+15,57.2123,842.83,2115,258,56,1565,1565,1117,894,760
2730,314,1425,2730,0,2606,124,5.21411e+18,88.5681,1689,2730,589,61,1305,1212,730,970,747
44392,3239,14474,0,44392,0,44392,5.69824e+17,96.3223,17535.5,44392,7028,110,29918,29918,19765,10557,7824
8482,7,11,8241,241,8476,6,1.38249e+14,10.7086,256.939,8482,11,11,8187,8010,6220,6221,6221
31249,6448,8584,0,31249,0,31249,6.14161e+17,95.9185,11047.6,31249,4158,110,22665,22665,20497,19042,18205
25347,4273,8263,25347,0,23874,1473,5.04153e+18,165.993,9524.58,25347,1838,128,17084,17084,14563,16218,9321
43706,10177,10335,15383,28323,0,43706,9.83847e+12,60.0102,13313.9,43706,5029,72,33371,33371,33186,33331,33033
25085,307,1231,0,25085,24350,735,4.40676e+16,268.878,3736.51,25085,193,26,23771,23208,20541,18796,8671
40324,3989,15475,15253,25071,0,40324,7.9607e+12,57.6768,17815,40324,7538,72,24849,24849,16685,23449,6927
31006,3073,7240,29199,1807,0,31006,2.23121e+18,97.7414,9793.71,31006,3497,110,23766,23766,18132,17164,11268
10073,2,11,9785,288,10070,3,1.38265e+14,10.4049,278.233,10073,11,11,5831,4123,4064,4298,3365
49948,4135,14947,49948,0,47038,2910,4.62326e+18,338.488,17344.7,49948,3511,137,35001,34756,19062,25202,10769
40447,7836,11588,38257,2190,0,40447,2.07548e+18,95.3321,14564,40447,5612,110,28859,28859,25698,24343,20527
22611,6087,7018,22611,0,21291,1320,5.22763e+18,160.32,8354.41,22611,2691,122,15593,15593,14971,15305,14024
35707,24163,35707,0,35707,0,35707,524273,0,35707,35707,35707,1,0,0,0,0,0
25536,1317,5981,0,25536,0,25536,6.49486e+17,97.6624,8176.81,25536,2889,110,19555,19555,13205,6595,5443
47886,14360,20700,18527,29359,0,47886,7.31851e+12,56.3294,23219.7,47886,10077,72,27186,27186,23437,26543,19063
21800,2843,6072,7829,13971,0,21800,9.29775e+12,59.191,7696.7,21800,2945,72,15728,15728,12464,14982,7882
2239,617,1186,0,2239,486,1753,1.35257e+13,8.68379,1273.9,2239,1063,11,1053,1053,681,709,666
8607,2127,4980,3541,5066,0,8607,5.49282e+12,53.2396,5513.16,8607,2422,72,3627,3627,2401,3355,596
30412,1266,1337,0,30412,29525,887,4.2701e+16,272.772,4194.46,30412,213,26,29075,29075,29014,29006,28778
26093,12,14,25350,743,26038,55,1.39006e+14,10.6093,474.517,26093,13,11,26079,26078,26054,26055,26041
7977,94,2427,0,7977,0,7977,5.99986e+17,95.3496,3285.31,7977,1161,100,5099,1739,1693,376,750
1036,128,300,362,674,0,1036,9.83737e+12,54.083,467.947,1036,140,44,736,736,488,686,349
11273,1571,2663,10613,660,0,11273,2.23895e+18,96.9942,3848.54,11273,1275,110,8610,8610,7374,6959,5612
12721,239,542,2650,10071,0,12721,5.85906e+13,11.9842,906.734,12721,538,13,12179,12179,9475,7389,10972
35827,3030,13131,34087,1740,34087,1740,5.28396e+18,96.3414,15549.6,35827,6287,111,22696,22696,19290,22696,6863
7187,2448,2808,7187,0,6799,388,4.1451e+18,91.6624,3360.69,7187,1065,101,4379,4379,4125,4249,3996
37138,3356,10036,0,37138,0,37138,6.17427e+17,97.2569,12868.9,37138,4866,110,27102,27102,19154,12895,9467
27602,1632,8518,26134,1468,26134,1468,2.61003e+18,97.1364,10631.7,27602,4061,111,19084,19084,6976,11727,4786
39135,3054,16521,15056,24079,0,39135,7.46481e+12,56.6578,18689.4,39135,8032,72,22614,22566,11741,17826,622
9582,377,405,0,9582,9309,273,3.54046e+16,20.0478,1148.45,9582,61,26,9177,9177,9130,9126,8919
16406,935,6364,0,16406,0,16406,5.22412e+17,93.4697,7690.39,16406,3065,110,10042,9870,5210,2325,3076
49531,11433,11579,46649,2882,0,49531,2.22784e+18,97.9032,15274.6,49531,5618,110,37952,37952,37801,37800,37773
35094,6303,8237,12349,22745,0,35094,9.87306e+12,60.0221,10731.5,35094,4007,72,26857,26857,24106,26377,20889
37790,3405,15393,37790,0,35897,1893,4.81547e+18,323.701,17040.9,37790,4647,136,22397,21850,13702,16058,5320
29167,5908,6774,10248,18919,0,29167,9.92849e+12,60.0368,8923.12,29167,3300,72,22393,22393,21345,22167,19755
42463,12531,18818,40653,1810,40653,1810,4.04212e+18,94.875,21314.7,42463,9055,111,23645,23645,18665,19649,16823
42110,8551,13491,42110,0,39665,2445,4.94953e+18,299.385,15293.1,42110,3859,133,28619,28460,25239,27397,19458
40633,11,15,39475,1158,40550,83,1.38788e+14,10.6475,632.571,40633,13,12,40616,40611,36213,36313,37144
24767,331,11852,23777,990,23777,990,9.44473e+18,93.7639,13451.3,24767,5756,110,12915,12141,402,9745,1635
41637,2926,17462,41637,0,28257,13380,4.59598e+18,496.897,19354.5,41637,6990,137,24175,23040,12064,16988,5275
35839,11492,17548,34447,1392,34447,1392,9.50017e+18,93.7351,19634.1,35839,8516,110,18291,18291,17051,16843,12336
33309,4453,11258,0,33309,0,33309,5.60035e+17,96.0951,13667.2,33309,5455,110,22051,22051,16630,11602,9727
21142,50,176,21092,50,21142,0,6.05376e+18,171.322,1783.89,21142,154,151,13949,6546,5410,6211,5928
8699,624,679,0,8699,8444,255,4.45815e+16,19.5621,1636.14,8699,85,26,8020,8020,7938,7954,7295
2375,276,663,2238,137,2238,137,1.36505e+18,92.3373,1029.71,2375,287,61,1712,1712,1124,1417,961
30042,3776,7071,28294,1748,28294,1748,5.77226e+18,97.716,9558.07,30042,3420,110,22971,22971,20995,20677,13214
3252,1230,1246,1217,2035,0,3252,8.35448e+12,56.2478,1591.43,3252,607,68,2006,2006,1994,1999,1991
11478,3537,5265,11478,0,10938,540,6.12593e+18,123.746,5961,11478,2160,117,6213,6213,5185,5778,4008
11115,8,208,11109,6,11115,0,6.115e+18,193.432,1399.64,11115,129,129,2349,420,422,393,386
35402,4812,8260,12440,22962,0,35402,9.89123e+12,60.0302,10773.3,35402,4018,72,27142,27142,22935,26262,15979
12232,3355,3922,11599,633,11599,633,3.00746e+18,95.6422,5075.94,12232,1880,110,8310,8310,7768,8148,6997
33042,13719,13800,12690,20352,0,33042,7.50505e+12,57.0962,15708.9,33042,6709,72,19242,19242,19158,19222,19143
41162,2,13,39988,1174,41149,13,1.38789e+14,10.2349,576.162,41162,12,12,23836,16880,16244,17020,13678
25367,103,5954,0,25367,0,25367,6.48338e+17,97.6251,8137.36,25367,2878,110,19121,7941,11468,4866,1006
13975,2767,5346,13975,0,13245,730,3.68422e+18,129.551,6264.89,13975,2174,121,8629,8568,6531,7384,5441
6493,4297,6493,0,6493,0,6493,524207,0,6493,6493,6493,1,0,0,0,0,0
29308,1,14,28440,868,29253,55,1.82313e+14,10.3323,572.853,29308,12,11,5103,5103,5103,5103,5103
44759,5371,10738,42151,2608,42151,2608,1.53025e+18,98.3571,14047.1,44759,5086,111,34021,34021,27947,32609,18259
24856,3693,5851,8737,16119,0,24856,9.87401e+12,59.9351,7737.43,24856,2847,72,19005,19005,15927,18475,12314
4955,29,1264,4667,288,4667,288,2.26151e+18,95.6468,1897.62,4955,576,87,1573,145,328,855,265
18351,3010,7421,18351,0,17431,920,5.41596e+18,156.04,8506.95,18351,1925,127,10930,10794,8790,9848,4945
37970,7361,12239,13936,24034,0,37970,8.73029e+12,58.4036,14648.8,37970,5940,72,25731,25731,20841,24891,14996
23394,9,12,22712,682,23381,13,1.61817e+14,10.0859,448.058,23394,11,12,23160,22908,19863,19948,19889
27569,6423,9892,0,27569,0,27569,5.42727e+17,95.6727,11924.9,27569,4792,110,17677,17677,15200,12246,12587
14483,4340,4794,0,14483,0,14483,5.68744e+17,94.2711,6090.26,14483,2305,110,9689,9689,9200,8839,8674
17746,9,12,17233,513,17738,8,1.55869e+14,10.3166,389.063,17746,12,11,17542,17353,16812,16811,14411
26339,10539,10807,26339,0,25038,1301,4.15784e+18,201.971,12192.5,26339,4623,128,15532,15532,15460,15528,15226
11637,374,5293,11637,0,11084,553,6.28898e+18,118.831,5995.61,11637,2176,119,6344,6020,3725,4439,1091
27545,2171,10075,26215,1330,26215,1330,7.6618e+18,92.0902,12093.5,27545,4867,110,17470,17470,14950,14530,4924
28279,5527,6628,0,28279,9937,18342,2.53184e+15,59.9918,8720.8,28279,3228,72,21651,21651,20308,20200,18216
28756,7065,13162,28756,0,21862,6894,5.04568e+18,330.704,14524.3,28756,4727,135,15594,15353,12508,14205,8858
17063,1384,5072,0,17063,0,17063,5.97985e+17,96.3947,6586.38,17063,2450,110,11991,11991,8907,5166,5182
39825,12317,17074,26330,13495,38083,1742,5.23903e+18,94.5306,19496.6,39825,8203,111,22751,22751,21903,22751,17884
23296,8610,12928,23296,0,22476,820,4.39082e+18,402.032,14193.8,23296,6162,128,10368,10191,8237,9180,6479
598,145,225,560,38,560,38,5.64501e+18,77.3177,342.957,598,96,37,373,373,274,303,324
41911,1,14,40701,1210,41884,27,1.53542e+14,10.2743,609.097,41911,13,12,9570,9570,9570,9570,9570
16587,3636,5303,0,16587,6082,10505,2.25435e+15,58.5499,6558.6,16587,2583,72,11284,11284,9367,7766,7250
46961,4481,10993,44231,2730,44231,2730,3.36623e+18,97.8768,14537.3,46961,5329,110,35968,35968,22833,28710,16242
8478,73,176,8473,5,8478,0,6.06916e+18,163.74,1140.44,8478,112,112,6753,4695,3385,3543,3556
19858,1652,7357,7456,12402,0,19858,8.12556e+12,57.7574,8717.66,19858,3574,72,12501,12501,6556,10801,3507
13125,2621,4044,4784,8341,0,13125,8.97225e+12,58.5764,5104.4,13125,1964,72,9081,9081,8176,8888,6811
44172,12084,28617,0,44172,0,44172,1.46561e+18,5.52594,32819.5,44172,9548,13,15555,15555,12848,13311,7732
24677,3136,8116,24677,0,23240,1437,3.65601e+18,165.015,9355.01,24677,2967,124,16561,16410,10647,13170,6879
32212,2464,9309,11637,20575,0,32212,9.17464e+12,59.1317,11498.3,32212,4531,72,22903,22903,14794,21505,5012
31739,355,977,0,31739,30835,904,3.55645e+16,197.592,3183.67,31739,144,26,30751,30421,24376,24843,15626
19846,344,4828,0,19846,0,19846,6.44979e+17,97.3703,6619.54,19846,2332,110,15018,15018,5232,2125,2081
14141,4864,6275,13541,600,13541,600,2.63838e+18,93.8886,7385.56,14141,3036,110,7866,7866,7116,7696,6539
38861,484,9368,36601,2260,36601,2260,1.77471e+18,98.2796,12327.7,38861,4432,111,29493,29493,9006,9874,3398
4966,243,1195,0,4966,1742,3224,2.53919e+15,58.9901,1745.23,4966,575,72,3771,3771,1668,1041,815
49858,51,176,49738,120,49858,0,6.15915e+18,173.039,2755.68,49858,170,169,35399,18085,14074,14927,14303
2347,181,644,2207,140,2207,140,3.29179e+18,92.5526,1009.23,2347,283,62,1703,1703,958,1253,699
36325,8280,12506,34515,1810,34515,1810,7.50311e+18,96.0532,15068.2,36325,6065,110,23819,23819,23179,23182,16334
12435,1355,4410,11822,613,11822,613,7.41894e+18,95.1691,5534.85,12435,2118,110,8025,8025,7012,6851,3227
5264,124,454,0,5264,5108,156,4.6049e+16,19.1508,1083.05,5264,63,26,4810,4802,3957,4289,2802
39721,7561,9237,13958,25763,0,39721,9.90595e+12,60.0713,11999.2,39721,4498,72,30484,30484,28428,30054,25135
27372,407,1354,0,27372,26566,806,4.49689e+16,266.273,4155.98,27372,220,26,26018,25227,20333,21158,11590
27336,8,61,27272,64,27336,0,2.25215e+18,60.745,1230.35,27336,61,61,6693,181,126,549,3207
48720,13542,14782,46140,2580,0,48720,2.02628e+18,96.8186,18164.9,48720,7179,110,33938,33938,32884,32368,31467
46155,45157,46155,46155,0,0,46155,134215000,0,46155,46155,46155,1,0,0,0,0,0
20006,2702,4831,18838,1168,18838,1168,1.20586e+18,98.02,6611.1,20006,2280,111,15175,15175,12716,14677,9379
46435,3485,11500,0,46435,16439,29996,2.48143e+15,59.835,14593.2,46435,5597,72,34935,34935,19940,12583,10129
30950,944,11590,0,30950,0,30950,5.287e+17,95.4915,13771.5,30950,5613,110,19360,19102,9950,2910,2695
49588,196,1689,0,49588,48153,1435,3.98767e+16,293.786,5735.66,49588,287,26,47317,46705,39656,35338,14166
16324,979,8806,16324,0,15684,640,4.29515e+18,184.483,9648.12,16324,3902,125,7518,7094,3487,5130,1633
28539,26383,28539,28539,0,0,28539,7.99972,0,28539,28539,28539,1,0,0,0,0,0
40416,12201,17956,40416,0,38544,1872,4.93772e+18,447.261,19736.2,40416,7361,140,22460,22359,18968,20575,16350
8776,4,11,8525,251,8770,6,1.38428e+14,10.4883,262.881,8776,11,11,7622,6764,6812,6889,4486
24550,4818,13246,0,24550,9956,14594,1.52318e+15,52.5243,14505.3,24550,6430,72,11304,11304,8364,4704,5037
26735,6888,9364,25402,1333,25402,1333,3.22702e+18,96.4771,11335.4,26735,4484,111,17371,17371,15231,17239,12451
7334,2147,2405,0,7334,0,7334,5.83032e+17,94.9654,3191.02,7334,1153,100,4929,4929,4657,4698,4492
41449,51,176,41372,77,41449,0,6.01158e+18,173.734,2470.32,41449,172,170,27133,13385,10557,12166,11930
31532,5666,10235,31532,0,29692,1840,5.24871e+18,208.877,11695.2,31532,3766,126,21297,21263,17488,19509,12517
25165,7674,7805,25165,0,23703,1462,5.52052e+18,168.161,9240.99,25165,2409,129,17360,17360,17360,17360,17281
15476,2451,5169,5720,9756,0,15476,8.63346e+12,58.0946,6339.06,15476,2513,72,10307,10307,7380,9799,3967
46302,36021,46302,46302,0,46302,0,8.7959e+12,0,46302,46302,46302,1,0,0,0,0,0
42287,14654,42287,42287,0,42287,0,34358900000,0,42287,42287,42287,1,0,0,0,0,0
26640,2431,6241,25090,1550,0,26640,2.2311e+18,97.6509,8512.96,26640,3007,110,20399,20399,14493,13333,9024
25710,104,864,0,25710,24978,732,3.54851e+16,151.114,2675.33,25710,121,26,24721,24642,16620,16453,6935
24995,828,1098,0,24995,24269,726,4.11387e+16,230.068,3352.18,24995,166,26,23897,23897,23350,23180,20663
28816,1844,2088,5823,22993,0,28816,5.67779e+13,12.0047,2641.01,28816,1014,20,26728,26728,25341,24664,26077
48773,6721,20320,46593,2180,46593,2180,4.13557e+18,95.2386,23201,48773,9752,111,28453,28453,20878,22716,11285
16894,1140,3977,5933,10961,0,16894,9.88608e+12,59.8354,5368.61,16894,1933,72,12917,12917,8824,12207,3944
42141,973,17701,16214,25927,0,42141,7.4832e+12,57.1052,20010.9,42141,8620,72,24440,24225,14259,22692,1991
24851,1001,10081,24851,0,23581,1270,4.58148e+18,182.982,11271.4,24851,4055,125,14770,14364,6600,10060,1016
11597,524,707,0,11597,11259,338,4.05864e+16,32.9986,1798.63,11597,89,26,10890,10876,10621,10633,8782
15613,2362,5812,0,15613,0,15613,5.347e+17,95.2134,7117.69,15613,2812,110,9801,9801,7406,5196,5076
44554,2531,10372,41954,2600,41954,2600,3.22342e+18,97.8974,13769.8,44554,5026,110,34182,34182,20723,27350,10196
3741,2290,2575,1600,2141,0,3741,4.08732e+12,37.8313,2812.21,3741,1231,59,1166,1166,1166,1166,1166
32562,289,10947,30920,1642,30920,1642,2.99545e+18,95.2398,13321.2,32562,5299,110,21615,21185,10570,13933,2267
46954,147,176,46937,17,46954,0,5.98455e+18,172.017,2567.71,46954,173,172,45894,43071,39719,39503,39256
3811,589,1747,0,3811,1483,2328,1.82551e+15,41.9906,2105.6,3811,843,59,2064,2064,1180,702,0
14867,253,833,0,14867,14432,435,4.19734e+16,140.667,2272.68,14867,115,26,14034,13868,10782,10950,5496
21338,4062,9581,0,21338,0,21338,4.67335e+17,94.0795,11073.1,21338,4637,110,11757,11757,8753,8228,5875
39936,5078,12716,37848,2088,37848,2088,1.48198e+18,97.1466,15498.2,39936,6080,111,27220,27220,21513,22057,12880
3006,15,35,0,3006,2757,249,2.97005e+16,10.0319,192.639,3006,34,11,2971,2970,2826,2761,2889
22504,87,6429,21274,1230,21274,1230,6.46618e+18,96.1555,8316.47,22504,3104,110,13897,4506,11518,8417,1370
22424,141,1066,22424,0,21495,929,2.32138e+18,17.7575,1647.95,22424,939,21,21358,21358,20586,21205,8573
12854,253,584,0,12854,12487,367,3.63427e+16,20.1362,1595.24,12854,78,26,12270,12270,11415,11376,6825
12662,5,13,12301,361,12605,57,1.45361e+14,10.8251,345.138,12662,12,11,11693,10558,9772,9284,6866
43510,60,176,43430,80,43510,0,5.97973e+18,169.854,2469.41,43510,171,171,30252,15982,12689,15056,14781
16304,6733,7842,0,16304,0,16304,4.43762e+17,93.4495,9011.01,16304,3801,110,8462,8462,8254,7894,8165
41578,744,9751,39158,2420,0,41578,2.22608e+18,97.8716,12965,41578,4727,110,31827,31827,19542,17783,4132
15266,122,170,15260,6,15266,0,5.97796e+18,164.713,1455.62,15266,139,149,14329,13119,10817,10764,10967
13965,1717,7281,5612,8353,0,13965,6.20296e+12,55.1606,8120.46,13965,3538,72,6684,6684,4283,5916,1805
45848,1921,10708,0,45848,16121,29727,2.52663e+15,60.0505,13816.2,45848,5211,72,35140,35140,22324,14749,6619
1239,264,339,437,802,0,1239,1.05046e+13,55.6053,530.945,1239,165,48,900,900,824,882,804
47864,9277,17061,47864,0,43507,4357,4.22868e+18,395.071,19236.7,47864,6636,137,30803,30645,23839,26145,17756
17989,821,4230,0,17989,6325,11664,2.52591e+15,59.8542,5692.34,17989,2055,72,13759,13759,6131,4400,2640
29682,558,1226,0,29682,28820,862,4.09812e+16,253.671,3854.63,29682,194,26,28456,27819,26419,25136,18517
32998,3521,7748,31078,1920,31078,1920,5.74413e+18,97.7516,10423.4,32998,3747,110,25250,25250,22697,22286,12513
36602,4119,10808,34623,1979,34623,1979,2.24667e+18,97.4357,13474.5,36602,5143,111,25794,25794,19937,20238,10886
9039,108,5655,8778,261,8778,261,2.08896e+18,76.389,6258.08,9039,2720,90,3384,1438,1375,1860,393
18472,4472,7797,0,18472,0,18472,4.94104e+17,94.4828,9183.63,18472,3780,110,10675,10675,9007,7249,7698
31926,840,12166,30423,1503,30423,1503,2.91276e+18,95.415,14379.1,31926,5893,110,19760,19526,8007,12710,3511
19852,1904,7785,7528,12324,0,19852,7.87124e+12,57.3938,9104.16,19852,3783,72,12067,12067,7969,10475,3059
3521,835,875,1236,2285,0,3521,9.6499e+12,58.1474,1300.8,3521,412,64,2646,2646,2631,2645,2630
49259,5203,17537,0,49259,0,49259,5.44966e+17,95.9589,20738.8,49259,8521,110,31722,31636,20652,20288,17865
19207,594,4934,18107,1100,18107,1100,3.08616e+18,97.2516,6633.68,19207,2311,111,14273,14273,6565,9128,2529
29475,7048,8192,29475,0,29475,0,4.75449e+15,5915.19,15501.6,29475,8192,5,18995,0,15563,18966,18995
24038,4588,5642,22638,1400,22638,1400,5.8714e+18,97.6087,7737.14,24038,2721,110,18396,18396,18136,18136,15545
40908,10594,13355,40908,0,38548,2360,5.04621e+18,280.452,15108.5,40908,4402,133,27553,27551,25936,27331,22773
11085,2707,4804,10595,490,10595,490,8.00228e+18,94.5048,5732.23,11085,2293,107,6281,6281,3955,4919,4240
16558,3137,5513,16558,0,15595,963,4.01772e+18,131.969,6474.27,16558,1983,120,11045,10990,8420,9653,6834
27926,15739,16074,27926,0,27167,759,5.60868e+18,1808.62,18214.6,27926,7854,139,11852,11852,11754,11782,11672
10659,1232,3966,0,10659,4004,6655,2.0805e+15,57.4454,4808.12,10659,1923,72,6693,6693,5310,5311,3955
5662,461,1743,2056,3606,0,5662,9.09876e+12,58.1485,2306.2,5662,848,72,3919,3871,1995,3379,1576
32265,5,208,32201,64,32265,0,6.11836e+18,202.236,2392.83,32265,170,175,4673,734,623,573,624
28383,2179,6598,0,28383,9976,18407,2.53284e+15,59.9944,8704.07,28383,3206,72,21785,21785,13591,9307,7568
32953,2474,15359,31603,1350,31603,1350,6.73452e+18,93.9586,17351.4,32953,7401,111,17594,17594,10437,13292,5082
14237,7385,8246,14237,0,10062,4175,5.55203e+18,169.303,8980.26,14237,3363,121,5991,5991,5920,5991,5496
35951,8706,15767,0,35951,13931,22020,1.85251e+15,56.3419,17749.1,35951,7659,72,20184,20184,16502,14252,12232
37623,936,1083,0,37623,36551,1072,3.55414e+16,225.115,3654.59,37623,165,26,36540,36540,36103,36086,33770
38922,5,14,37794,1128,38895,27,1.59244e+14,10.3269,593.286,38922,13,12,35925,32298,31239,27339,19180
45305,8712,18438,43259,2046,43259,2046,8.4375e+18,95.1379,21246.6,45305,8963,110,26867,26867,25727,25727,13245
11719,2706,2730,4118,7601,0,11719,9.92802e+12,59.7727,3783.62,11719,1324,72,8989,8989,8970,8982,8981
47740,8568,11108,44960,2780,44960,2780,3.21968e+18,97.9065,14704.2,47740,5382,110,36632,36632,34059,35858,29043
34672,8,14,33682,990,34594,78,1.38887e+14,10.7089,580.182,34672,14,12,33880,33071,31116,31164,23540
2805,565,728,0,2805,0,2805,6.61303e+17,93.5134,1150.09,2805,336,67,2077,2077,1882,1821,1854
47066,2655,20189,45018,2048,0,47066,1.66325e+18,94.8048,22997.5,47066,9817,110,26877,26877,17641,15688,7574
2234,229,573,0,2234,785,1449,2.56247e+15,57.6173,874.635,2234,278,57,1661,1661,1134,1045,777
14991,45,176,14982,9,14991,0,6.02348e+18,165.897,1496.98,14991,142,141,9320,4004,3348,3929,3808
29631,851,8276,27991,1640,27991,1640,1.92085e+18,97.6252,10582.7,29631,3937,111,21355,21205,9825,7818,4087
18899,4853,5036,17839,1060,0,18899,2.14304e+18,96.9656,6725.27,18899,2434,110,13863,13863,13672,13643,13579
37607,4111,8192,37607,0,37607,0,4.70371e+15,6407.52,17526.3,37607,8192,6,16440,0,2616,14643,16440
45421,548,1526,0,45421,44109,1312,3.91946e+16,284.56,5146.48,45421,254,26,43895,42901,34911,36073,20990
37417,1,6,36248,1169,37257,160,0.000133629,0.99984,447.395,37417,6,1,37411,37411,37411,37411,37411
34542,6610,13452,13092,21450,0,34542,7.86757e+12,57.547,15505.9,34542,6541,72,21090,21090,17259,20290,10921
31065,8284,10176,11437,19628,0,31065,8.69312e+12,58.5245,12209.8,31065,4957,72,20889,20889,19069,20569,17010
43331,6667,11957,15558,27773,0,43331,9.32907e+12,59.3867,14789.7,43331,5819,72,31374,31374,25767,30404,19031
30307,3034,14181,0,30307,11900,18407,1.75515e+15,56.0223,15837.9,30307,6895,72,16126,16126,10864,8134,4649
13074,1701,3477,12342,732,0,13074,2.15021e+18,96.5923,4762.03,13074,1660,110,9597,9597,7585,6845,4456
12521,5,13,12161,360,12452,69,1.44638e+14,10.9463,348.339,12521,12,12,11559,10425,8421,8514,7243
35547,13247,14926,33960,1587,33960,1587,3.44305e+18,95.5364,17168.1,35547,7170,111,20621,20621,19550,19774,19406
29511,136,176,29506,5,29511,0,5.98409e+18,169.724,2036.15,29511,165,163,28408,26578,22674,23209,23209
45486,2,12,44188,1298,45469,17,1.38708e+14,10.2078,604.09,45486,11,12,26338,18648,17959,18814,12664
26066,5555,6590,0,26066,0,26066,6.32023e+17,97.3416,8782.32,26066,3181,110,19476,19476,18088,17344,16665
6619,913,3657,0,6619,0,6619,3.86818e+17,56.6658,4206.52,6619,1749,79,2962,2962,1767,948,0
37744,12583,14517,14267,23477,0,37744,7.93508e+12,57.3951,16735.2,37744,7051,72,23227,23227,22468,23067,21385
22680,2915,7447,22680,0,21360,1320,4.30672e+18,158.661,8622.3,22680,2704,121,15233,15106,9993,12251,6533
21165,8763,9046,8162,13003,0,21165,7.38316e+12,56.7215,10373.6,21165,4386,72,12119,12119,12042,12109,12079
14981,568,3864,5332,9649,0,14981,9.59902e+12,59.4615,5103.2,14981,1877,72,11117,11117,6865,10379,1798
26153,152,8102,0,26153,9548,16605,2.27774e+15,58.4898,9916.57,26153,3932,72,18051,17759,5997,342,0
33206,6005,7749,11677,21529,0,33206,9.87619e+12,60.0156,10137.6,33206,3766,72,25457,25457,22904,25016,19919
17105,818,4915,0,17105,6170,10935,2.364e+15,59.0397,6245.36,17105,2394,72,12190,12190,7955,8020,2928
44147,6086,10296,0,44147,15522,28625,2.53121e+15,60.0807,13310.8,44147,5016,72,33851,33851,27718,24639,20310
18196,2649,4962,17186,1010,17186,1010,6.42261e+18,96.8737,6595.76,18196,2394,110,13234,13234,12754,12754,7698
8411,159,176,8407,4,8411,0,6.06932e+18,161.715,1130.47,8411,111,119,8189,8040,7610,7603,7603
9964,3144,3900,9493,471,9493,471,2.34625e+18,94.9806,4805.54,9964,1849,105,6064,6064,5699,6040,5425
46520,4749,14862,46520,0,43812,2708,3.89462e+18,321.811,16795.6,46520,5551,129,31658,31451,18682,24371,11570
15135,2002,3564,0,15135,5322,9813,2.52814e+15,59.8504,4845.63,15135,1731,72,11571,11571,9280,7363,6611
43387,16724,18043,43387,0,41407,1980,4.60777e+18,1257.64,20528,43387,5051,141,25344,24593,25230,25344,24542
6285,1492,2834,6015,270,6015,270,7.95609e+18,93.0581,3442.61,6285,1341,85,3451,3451,2452,2700,2193
5000,310,1264,4707,293,4707,293,5.51786e+18,95.8742,1903.84,5000,585,87,3736,3736,1963,2544,1333
31024,9720,13164,29654,1370,29654,1370,4.14199e+18,92.1563,15180.1,31024,6305,111,17860,17860,15625,17722,12728
41628,3601,10021,39207,2421,39207,2421,5.32636e+18,98.3059,13144.8,41628,4734,111,31607,31607,19359,22635,12865
20150,3133,5772,7259,12891,0,20150,9.21591e+12,58.9033,7285.41,20150,2808,72,14378,14378,11509,13778,6831
35538,4315,10947,33666,1872,33666,1872,6.8297e+18,96.628,13568.1,35538,5305,110,24591,24591,21955,21528,11397
2723,182,730,975,1748,0,2723,9.77139e+12,58.1153,1077.02,2723,355,59,1993,1983,887,1675,481
32302,13,14,31381,921,32225,77,1.38925e+14,10.7281,558.871,32302,14,12,32288,32288,31868,31868,31602
46644,6546,10866,0,46644,0,46644,6.48309e+17,97.8979,14391.5,46644,5264,110,35778,35778,29930,24310,22788
4528,131,170,4526,2,4528,0,5.95812e+18,152.148,792.015,4528,99,95,4224,3998,3398,3476,3464
30288,3645,9941,0,30288,11153,19135,2.22509e+15,58.5066,11931.2,30288,4842,72,20347,20347,14063,13926,6576
35673,7854,16474,35673,0,34153,1520,4.75015e+18,580.059,18419,35673,5572,138,19199,18835,15219,17370,11891
27283,1149,1557,0,27283,26466,817,4.92621e+16,286.019,4743.1,27283,255,26,25726,25726,24909,24876,21606
30705,2883,12389,29313,1392,29313,1392,2.76961e+18,94.4245,14478.9,30705,6001,110,18316,18316,13008,13852,4902
23149,940,1095,0,23149,22471,678,4.22621e+16,237.858,3283.24,23149,168,26,22054,22054,21856,21842,21030
29092,353,6851,0,29092,0,29092,6.46629e+17,97.6948,9277.43,29092,3310,110,22241,22241,7071,1954,2595
26910,8757,14413,5826,21084,0,26910,52952800000,8.96964,14735.7,26910,12965,11,12497,12497,8928,12497,8695
3997,670,1017,3767,230,3767,230,5.75022e+18,94.3565,1567.89,3997,466,80,2980,2980,2766,2747,2264
18398,2297,4317,6469,11929,0,18398,9.9163e+12,59.9068,5803.15,18398,2103,72,14081,14081,11709,13584,7864
46151,10359,11085,43469,2682,43469,2682,3.52869e+18,98.3229,14478.6,46151,5237,111,35066,35066,33733,34047,33351
18115,6,11,17595,520,18109,6,1.39689e+14,10.2248,377.762,18115,11,11,17204,16635,12223,12207,12191
27065,1535,8682,25655,1410,25655,1410,3.32143e+18,95.2148,10742.4,27065,4146,111,18383,18383,8334,11311,3780
47456,5159,13131,17058,30398,0,47456,9.32636e+12,59.3989,16179.6,47456,6397,72,34325,34325,24068,31787,14491
27928,6048,11118,26648,1280,0,27928,1.75512e+18,91.7822,13078.1,27928,5375,110,16810,16810,14530,13350,10960
16460,3566,5944,0,16460,6155,10305,2.11331e+15,57.8739,7134.29,16460,2890,72,10516,10516,9085,7121,6847
17898,3284,4238,16853,1045,0,17898,2.2313e+18,97.4011,5907,17898,2046,110,13660,13660,12585,12221,11111
9024,346,2469,8524,500,0,9024,2.13425e+18,95.9935,3440.7,9024,1169,107,6555,6555,2605,2453,1557
25593,1241,6502,9086,16507,0,25593,9.63392e+12,59.637,8392.94,25593,3163,72,19091,19091,9061,16268,4388
34288,5887,8046,32295,1993,32295,1993,3.36569e+18,97.7524,10806.8,34288,3894,110,26242,26242,21886,23900,19864
1158,46,586,1158,0,0,1158,8.74182e+17,17.3221,670.01,1158,514,20,572,572,45,326,76
39285,6449,13248,37304,1981,0,39285,1.93033e+18,96.1964,15989.2,39285,6430,110,26037,26037,20111,18947,13182
29271,425,6789,10286,18985,0,29271,9.92227e+12,60.0389,8947.55,29271,3301,72,22482,22482,6866,18163,1745
32235,3480,7574,0,32235,0,32235,6.4718e+17,97.7452,10203.8,32235,3665,110,24661,24661,19514,20223,12372
22502,2956,5252,0,22502,7902,14600,2.53135e+15,59.9484,6999.89,22502,2553,72,17250,17250,14525,14234,10092
10323,64,176,10276,47,10323,0,6.17371e+18,156.13,1250.92,10323,113,115,8180,5889,3990,4151,3922
46366,5284,11138,43672,2694,43672,2694,4.94199e+18,98.3203,14542.4,46366,5268,111,35228,35228,30507,33885,18006
19895,7325,7601,18955,940,18955,940,2.84185e+18,95.2341,9146.55,19895,3685,110,12294,12294,12035,12211,11764
21285,4128,7205,21285,0,20065,1220,3.23322e+18,154.09,8326.8,21285,2672,123,14080,14080,11460,12345,8782
23217,13222,23217,23217,0,23217,0,34358300000,0,23217,23217,23217,1,0,0,0,0,0
30975,1685,9060,0,30975,0,30975,6.00121e+17,96.8143,11457.9,30975,4391,110,21915,21915,14356,7618,5398
31484,2334,9459,29806,1678,0,31484,2.03736e+18,89.2008,11867.4,31484,4584,110,22025,22025,13000,11302,0
22790,618,1293,0,22790,22113,677,4.74334e+16,183.324,3834.83,22790,206,26,21497,20771,18438,18743,12801
41328,255,1264,0,41328,40144,1184,3.70052e+16,261.643,4273.31,41328,200,26,39840,39380,33830,33054,13263
49368,335,1725,0,49368,47936,1432,4.03332e+16,308.742,5837.12,49368,294,26,47478,46406,40829,37623,17042
27981,1887,7709,26434,1547,26434,1547,3.23948e+18,97.0643,9964.78,27981,3733,110,20272,20272,10265,14456,5952
786,18,162,782,4,786,0,5.6942e+18,93.355,336.401,786,51,42,270,56,75,69,89
7217,890,2679,2702,4515,0,7217,8.15903e+12,57.1596,3308.4,7217,1299,72,4538,4538,3760,4405,2999
4606,64,1826,4386,220,4386,220,5.61133e+18,91.282,2346.89,4606,844,81,1938,544,0,815,0
10261,112,2456,0,10261,3618,6643,2.52835e+15,59.5947,3402.29,10261,1191,72,7805,7762,4442,300,487
6456,461,2011,6112,344,6112,344,3.94261e+18,95.344,2736.32,6456,934,95,4445,4358,2630,3276,1610
9112,121,208,9101,11,9112,0,6.04714e+18,174.01,1262.74,9112,119,122,8397,7723,5494,5552,5579
47793,12219,18708,38528,9265,45534,2259,4.66739e+18,1543.1,21524.4,47793,6217,145,29085,27781,25156,25282,20308
27718,4600,6502,0,27718,9745,17973,2.52561e+15,59.983,8566.05,27718,3160,72,21216,21216,18472,15917,15344
11522,261,659,0,11522,11192,330,3.92621e+16,19.682,1688.46,11522,82,26,10863,10863,9849,9803,4386
21641,2901,6735,21641,0,20379,1262,3.63373e+18,156.582,8031.07,21641,2585,124,14906,14792,10416,12132,6824
38637,17203,22149,37380,1257,37380,1257,1.08432e+19,91.6051,24076.6,38637,10754,110,16488,16488,16208,16208,13490
15900,658,668,0,15900,15445,455,3.5562e+16,20.0891,1842.63,15900,86,26,15232,15232,15219,15219,15194
44259,78,176,44177,82,44259,0,6.0536e+18,173.188,2594.09,44259,171,172,36042,23584,18512,19780,19517
12315,126,2981,0,12315,0,12315,6.44779e+17,96.9038,4239.99,12315,1423,110,9334,4663,2684,329,694
49249,462,13505,46513,2736,46513,2736,4.00988e+18,97.8382,16949.2,49249,6423,111,35744,35483,4911,35169,3733
4190,1533,2249,4032,158,4032,158,9.9925e+18,90.4055,2649.71,4190,1077,72,1941,1941,1913,1913,1862
40770,15,18,39566,1204,40644,126,1.8018e+14,10.5213,705.906,40770,15,13,40752,40752,40520,40519,39565
23749,1495,5870,0,23749,8404,15345,2.48692e+15,59.7325,7665.96,23749,2853,72,17879,17879,9425,8475,4944
35292,8,11,32390,2902,35290,2,1.15519e+14,7.90562,477.98,35292,11,8,35281,35280,33578,33578,34560
12100,21,176,12096,4,12100,0,6.03083e+18,164.059,1334.41,12100,132,132,4956,905,1350,1565,1421
22429,765,809,0,22429,21790,639,3.5632e+16,119.563,2422.61,22429,110,26,21620,21620,21510,21496,20945
38339,9210,13130,36424,1915,36424,1915,7.32626e+18,96.0718,15804.2,38339,6369,110,25209,25209,23886,23676,18827
22195,207,9213,21199,996,21199,996,5.0413e+18,95.2965,10795.1,22195,4415,111,12982,12241,6811,8001,1546
27651,9203,10592,0,27651,0,27651,5.23323e+17,95.0545,12571.9,27651,5124,110,17059,17059,15941,15634,15035
34458,3437,10559,0,34458,12547,21911,2.28818e+15,58.6202,12828.1,34458,5123,72,23899,23899,15411,14013,7887
11506,1730,3771,4228,7278,0,11506,8.70937e+12,58.2034,4707.6,11506,1833,72,7735,7735,6039,7437,4141
13896,1634,3663,13116,780,13116,780,6.27706e+18,96.7098,5010.77,13896,1761,110,10233,10233,9833,9833,5754
19574,1763,5573,0,19574,0,19574,6.08463e+17,96.7684,7277.02,19574,2694,110,14001,14001,9609,6141,4466
10752,93,175,10747,5,10752,0,5.97676e+18,162.955,1230.39,10752,128,136,9288,5773,5318,5640,5910
31587,64,176,31537,50,31587,0,6.02938e+18,172.373,2171.11,31587,167,164,23207,13722,10246,11504,11054
12569,956,6284,5005,7564,0,12569,6.48639e+12,55.6198,7090.63,12569,3061,72,6285,6198,2881,5182,837
18488,2691,5409,0,18488,6697,11791,2.34397e+15,58.9956,6813.75,18488,2635,72,13079,13079,10655,7479,6731
38589,4960,14377,0,38589,0,38589,5.30759e+17,95.622,16972.1,38589,6977,110,24212,24212,16652,13197,9120
49210,9295,20989,47050,2160,47050,2160,3.6478e+18,95.3782,23852.9,49210,10078,111,28221,28221,18002,19793,14030
11091,89,5271,0,11091,0,11091,4.51607e+17,93.1354,6159.53,11091,2548,106,5132,1631,3311,1360,757
16737,272,3984,0,16737,0,16737,6.45128e+17,97.2741,5573.13,16737,1913,110,12753,12753,7733,2829,1692
36947,11890,19345,0,36947,0,36947,4.0371e+17,90.8974,21375.1,36947,9398,110,17602,17602,14911,12200,12496
3674,133,340,0,3674,3566,108,4.75219e+16,17.3285,809.725,3674,50,26,3334,3334,2700,2856,1495
21615,6410,7231,0,21615,7977,13638,2.19275e+15,58.3004,8746.88,21615,3507,72,14384,14384,13564,12519,12785
27520,2992,8478,27520,0,25910,1610,4.37058e+18,172.906,10005.4,27520,3269,124,19042,18859,12811,15177,7298
15941,431,673,0,15941,15489,452,3.55338e+16,20.1196,1852.95,15941,85,26,15268,15268,14696,14770,10745
27867,385,8790,10199,17668,0,27867,8.83763e+12,58.6971,10683.7,27867,4277,72,19077,18837,10937,17677,1143
18757,650,796,0,18757,18221,536,3.72831e+16,107.938,2277.41,18757,107,26,17961,17840,17562,17565,15252
4751,997,1168,0,4751,0,4751,6.5597e+17,95.4816,1795.23,4751,550,85,3583,3583,3374,3372,3331
34827,7,15,33819,1008,34774,53,1.56841e+14,10.3902,578.185,34827,13,12,33727,32970,29951,29326,25525
25200,3061,7539,23840,1360,23840,1360,2.21859e+18,97.2145,9531.18,25200,3588,111,17661,17661,14068,14565,7766
6906,456,1742,0,6906,0,6906,6.40714e+17,95.893,2556.25,6906,826,98,5164,5164,2880,1986,1804
829,93,283,0,829,0,829,6.71213e+17,81.1713,441.501,829,113,41,510,189,346,169,243
21907,3678,6682,20737,1170,20737,1170,4.67993e+18,97.037,8466.93,21907,3178,111,15225,15225,13050,15083,9872
18999,7132,10671,18999,0,18299,700,3.82673e+18,158.216,11600.8,18999,4762,130,8328,8287,5554,6566,1316
16062,1566,3770,15124,938,0,16062,2.23543e+18,97.3424,5312.6,16062,1808,110,12292,12292,9073,8406,5799
49855,14015,19643,0,49855,0,49855,5.12044e+17,95.3427,22726.7,49855,9538,110,30212,30212,26462,20800,20256
6139,35,176,6102,37,6139,0,6.09007e+18,158.739,970.31,6139,105,105,3447,1109,1191,1212,1172
34410,1,14,33430,980,34338,72,1.38881e+14,10.6081,567.01,34410,13,12,8815,8815,8815,8815,8815
35005,2684,8149,12306,22699,0,35005,9.89813e+12,60.0635,10643.4,35005,3970,72,26856,26856,18968,25496,9388
27164,542,894,0,27164,26387,777,3.55938e+16,164.237,2809.17,27164,128,26,26270,26033,22956,23412,19053
17106,185,7122,0,17106,6562,10544,1.93182e+15,56.4437,8266.82,17106,3447,72,9984,9696,5661,401,556
33591,8692,12367,27610,5981,31961,1630,2.80296e+18,95.19,14661.6,33591,5923,111,21224,21224,21224,20592,15600
23327,6280,7501,0,23327,8564,14763,2.24146e+15,57.7002,9135.4,23327,3639,72,15826,15826,15460,15330,15006
42556,10,14,41332,1224,42537,19,1.48919e+14,10.2573,605.562,42556,13,12,42454,42298,40733,40732,35197
5128,947,1304,4830,298,4830,298,4.93468e+18,95.736,1953.76,5128,596,88,3824,3824,3199,3356,3133
17895,522,9729,17265,630,17265,630,3.27109e+18,86.9238,10857.6,17895,4668,111,8166,7731,2608,4325,0
23799,477,832,0,23799,23119,680,3.56216e+16,136.043,2532.26,23799,115,26,22967,22800,21560,21714,15911
24964,116,208,24942,22,24964,0,6.09445e+18,201.562,2100.81,24964,160,167,22620,20394,13542,14000,14008
14087,449,603,4109,9978,0,14087,6.92222e+18,15.977,1042.54,14087,597,17,13484,13484,11533,11339,12577
1607,92,549,1517,90,0,1607,2.09744e+18,82.2794,808.163,1607,232,52,967,341,388,398,370
42148,7001,11571,15123,27025,0,42148,9.35575e+12,59.3988,14339.7,42148,5634,72,30577,30577,25483,29699,19437
8939,223,2443,8439,500,8439,500,3.16055e+18,92.2407,3408.65,8939,1149,110,6496,6496,2777,4417,0
16375,1396,4304,5832,10543,0,16375,9.54244e+12,59.4007,5624.72,16375,2092,72,12071,12071,8757,11501,4844
7973,134,2491,7553,420,0,7973,2.02447e+18,95.2202,3343.98,7973,1189,108,5482,3355,3216,2980,807
48555,611,15664,46055,2500,46055,2500,7.05282e+18,96.3955,18962.4,48555,7605,110,32891,32309,24621,18887,4027
4434,289,2425,4274,160,4274,160,3.3098e+18,80.0379,2839.72,4434,1131,73,2009,1922,624,994,0
43175,709,1778,0,43175,41911,1264,4.32579e+16,311.104,5832,43175,303,26,41397,41397,38178,35479,22738
39872,967,1501,0,39872,38712,1160,4.08107e+16,292.932,4929.36,39872,248,26,38371,38371,35087,36114,28790
48911,11673,20544,46751,2160,46751,2160,2.78638e+18,94.9702,23476.1,48911,9987,110,28367,28367,16874,21458,12146
2081,154,573,1958,123,0,2081,2.24392e+18,91.1201,906.358,2081,257,59,1508,1508,714,727,583
3206,28,170,3201,5,3206,0,5.97121e+18,146.77,667.416,3206,89,81,1520,376,449,524,490
49594,3903,12194,46749,2845,0,49594,2.1932e+18,97.7255,15844.7,49594,5921,110,37400,37400,26458,24600,12895
25053,2514,7276,0,25053,9056,15997,2.34301e+15,59.0871,9069.23,25053,3536,72,17777,17777,12167,7236,5403
21344,4734,5025,20097,1247,0,21344,2.23241e+18,97.5413,6934.98,21344,2428,110,16319,16319,15945,15901,15746
23420,6759,9397,0,23420,8931,14489,1.98188e+15,57.3114,10881.2,23420,4573,72,14023,14023,12466,10413,10027
37086,9,15,35995,1091,36997,89,1.72569e+14,10.4814,641.917,37086,13,13,36685,36281,31336,30558,27173
8106,136,4189,7805,301,0,8106,1.43374e+18,91.1728,4858.64,8106,2002,95,3917,2433,1667,927,698
46060,16117,20564,44110,1950,44110,1950,6.53084e+18,92.981,23209.5,46060,9885,111,25496,25496,23770,25385,21451
27214,71,887,0,27214,26439,775,3.54913e+16,159.682,2794.65,27214,126,26,26143,26097,20834,20949,6183
33961,3279,10796,32201,1760,32201,1760,3.07343e+18,96.4384,13301.5,33961,5227,110,23165,23165,17005,18789,7407
33423,7183,18857,32313,1110,0,33423,1.27255e+18,91.9289,20615.3,33423,9145,110,14566,14566,10616,9622,6856
15803,1162,5593,0,15803,0,15803,5.49406e+17,95.4557,6940.81,15803,2700,110,10210,10210,6393,3607,2043
13345,883,3883,0,13345,4818,8527,2.34595e+15,58.8967,4979.99,13345,1885,72,9462,9462,6495,4671,3079
38375,194,1201,0,38375,37175,1200,0.0312704,0.968704,6786.3,38375,1201,1,37174,37174,37174,37174,37174
28399,6,14,27590,809,28326,73,1.40227e+14,10.6027,507.235,28399,13,12,26960,26355,20004,20125,18536
14741,2103,4201,13931,810,13931,810,6.42536e+18,96.5497,5575.07,14741,2025,110,10540,10540,9450,9268,5356
39141,732,1689,0,39141,37994,1147,4.38391e+16,306.345,5466.34,39141,284,26,37452,37452,32224,32593,21585
15211,284,734,0,15211,14772,439,3.79071e+16,62.1527,1993.31,15211,95,26,14477,14428,11349,11473,6094
21883,6610,10749,21033,850,21033,850,4.43267e+18,86.5707,12186.4,21883,5196,110,11134,11134,10275,11134,7020
2763,330,727,2603,160,0,2763,2.228e+18,93.0112,1147.46,2763,325,66,2036,2036,1528,1450,1189
41194,8399,16993,39354,1840,39354,1840,8.35851e+18,95.0125,19583.2,41194,8248,110,24201,24201,21501,21049,10697
17519,599,4415,0,17519,0,17519,6.35369e+17,97.1884,6037.33,17519,2128,110,13104,13104,8380,2274,2802
31617,7176,7617,29777,1840,29777,1840,3.19227e+18,98.2003,10138.3,31617,3598,111,24000,24000,24000,24000,23061
44505,4520,10390,15645,28860,0,44505,9.88436e+12,60.0595,13422.2,44505,5056,72,34115,34115,25612,32115,15334
17528,7,11,17029,499,17520,8,1.38843e+14,10.2395,370.506,17528,11,11,16878,16457,12980,13021,12744
39403,2466,9231,0,39403,13856,25547,2.52701e+15,60.0278,11970,39403,4493,72,30172,30172,16539,11055,8372
26058,7542,8503,26058,0,24541,1517,5.00752e+18,168.126,9786.94,26058,3094,122,17555,17555,16969,17298,16051
44075,8821,10595,41515,2560,41515,2560,3.3739e+18,98.3045,13867.7,44075,2976,116,33480,33480,33480,33480,28781
46512,10227,10877,43803,2709,0,46512,2.22904e+18,97.9156,14391.8,46512,5276,110,35635,35635,34898,34638,34034
35634,7061,18234,35634,0,0,35634,8.81717e+17,17.9822,18770.1,35634,16394,20,17400,17400,6313,14558,5828
23699,782,5565,22317,1382,0,23699,2.23174e+18,97.5962,7634.77,23699,2689,110,18134,18134,11622,10628,3655
34993,138,208,34913,80,34993,0,5.99918e+18,199.314,2382.68,34993,176,170,33320,31177,23200,23827,23444
2309,694,1010,891,1418,0,2309,7.35811e+12,50.948,1266.18,2309,477,62,1299,1299,1209,1279,1171
7107,1847,2853,0,7107,2697,4410,1.99853e+15,56.6018,3454.37,7107,1372,72,4254,4254,3236,2911,2160
9121,205,3892,9121,0,7194,1927,3.77459e+18,101.732,4509.3,9121,1528,113,5229,4859,2090,3639,760
15445,553,4844,14635,810,0,15445,2.0074e+18,96.1068,6229.06,15445,2338,110,10601,10515,6075,4410,2523
29885,306,935,0,29885,28951,934,0.0312531,0.968713,5285.26,29885,935,1,28950,28950,28950,28950,28950
28352,1794,16151,28352,0,27402,950,4.91531e+18,616.701,17646.9,28352,7113,134,12201,10746,5621,8100,1967
3350,322,878,3150,200,3150,200,4.39492e+18,94.5543,1354.03,3350,392,74,2472,2472,1655,2061,1227
9380,194,3213,8908,472,0,9380,1.93549e+18,90.25,4141.94,9380,1525,107,6167,6008,3699,3355,1043
32957,32,176,32946,11,32957,0,5.984e+18,169.727,2150.77,32957,169,165,17032,4637,5293,6448,5607
3730,73,1896,1474,2256,0,3730,6.37639e+12,47.6507,2223.96,3730,901,59,1834,1281,529,1331,181
41447,1802,9629,14572,26875,0,41447,9.89648e+12,60.0844,12494,41447,4687,72,31818,31818,20428,29851,6504
25478,3609,6032,23996,1482,23996,1482,5.78074e+18,97.5731,8216.34,25478,2915,110,19446,19446,18011,17786,12478
12913,2,7,12454,459,12867,46,4.47726e+13,5.97824,285.047,12913,7,7,11151,10418,10707,10414,9861
18727,3223,8068,18727,0,17834,893,5.24026e+18,180.488,9160.73,18727,1932,127,10659,10499,7576,8300,4778
21027,8708,11207,21027,0,21027,0,4.09161e+18,17.8908,11604,21027,10074,20,9820,9820,7664,9820,7653
16682,1431,3958,15712,970,0,16682,2.22752e+18,97.3709,5544.84,16682,1902,110,12724,12724,9273,8497,5184
2489,52,176,2488,1,2489,0,6.17663e+18,107.31,613.28,2489,71,70,1792,1208,824,847,860
30287,1356,1383,0,30287,29400,887,4.35933e+16,275.192,4323.23,30287,223,26,28904,28904,28842,28839,28612
11786,1893,4386,11216,570,11216,570,2.84584e+18,80.5958,5446.8,11786,2098,110,7400,7400,4572,6202,0
42826,10814,15953,0,42826,0,42826,5.30665e+17,95.6506,18766.1,42826,7747,110,26873,26873,23661,18981,18429
40501,2922,9417,14229,26272,0,40501,9.89701e+12,60.0644,12226.5,40501,4581,72,31084,31084,21685,29464,10225
11778,290,369,0,11778,11410,368,0.0312447,0.96867,2083.37,11778,369,1,11409,11409,11409,11409,11409
15955,806,3771,0,15955,5603,10352,2.52317e+15,59.7396,5100.63,15955,1824,72,12184,12184,5945,4961,2833
28349,21,915,0,28349,27539,810,3.55904e+16,175.109,2906.51,28349,132,26,26961,25129,16549,16428,4581
12046,2362,5480,7885,4161,11536,510,5.1414e+18,94.2974,6440.46,12046,2628,110,6566,6566,5523,6012,3001
34025,7691,11303,0,34025,12563,21462,2.20651e+15,58.4791,13481,34025,5504,72,22722,22722,19728,17918,16260
35280,3802,14059,35280,0,33520,1760,4.64322e+18,287.028,15816.8,35280,6067,132,21221,21038,12966,16475,5269
14346,440,3900,13539,807,13539,807,3.32586e+18,97.279,5248.92,14346,1845,111,10446,10359,4810,6692,2124
40072,4,176,39990,82,40072,0,5.98455e+18,169.832,2370.55,40072,168,171,4626,850,279,497,667
30822,8007,17997,29842,980,29842,980,2.25387e+18,90.4167,19591.3,30822,8742,110,12825,12825,7561,9154,6851
46459,8388,11083,43750,2709,43750,2709,2.2304e+18,98.3745,14497.8,46459,5248,111,35376,35376,35376,34747,27595
47855,4514,14613,17439,30416,0,47855,8.95584e+12,58.9253,17581.8,47855,7115,72,33242,33242,20705,29979,12067
48449,19878,25963,46739,1710,0,48449,1.3522e+18,91.2191,28413.8,48449,12607,110,22486,22486,20476,19973,18868
10320,3086,3524,10320,0,9720,600,4.93585e+18,92.3193,4237.39,10320,1254,120,6796,6796,6534,6699,6306
47769,12949,20229,18401,29368,0,47769,7.43127e+12,56.4281,22777.7,47769,9832,72,27540,27540,23364,26670,16422
47574,81,176,47473,101,47574,0,6.09118e+18,172.479,2698.82,47574,173,171,39991,27516,21018,22038,22009
21429,5481,6475,17223,4206,20279,1150,5.10565e+18,97.0862,8235.29,21429,3077,111,14954,14954,13092,13562,12409
42300,4384,17186,40386,1914,0,42300,1.73024e+18,95.1238,19850.5,42300,8353,110,25114,25114,17430,15730,8923
26914,1105,6329,9466,17448,0,26914,9.84499e+12,59.9365,8342.21,26914,3067,72,20585,20585,13089,19295,3980
45812,11979,45812,0,45812,0,45812,524277,0,45812,45812,45812,1,0,0,0,0,0
33427,3553,7838,0,33427,0,33427,6.49331e+17,97.7885,10541.9,33427,3799,110,25589,25589,20040,17959,12688
9107,11,61,9107,0,9107,0,2.33275e+18,60.1065,710.79,9107,61,61,3073,202,280,513,1558
28704,4293,8077,27134,1570,0,28704,2.09271e+18,96.9924,10368,28704,3916,110,20627,20627,16707,15914,12173
13852,2771,7540,13369,483,0,13852,1.34039e+18,92.2298,8484.16,13852,3646,108,6312,6312,3936,3336,1697
12231,129,176,12162,69,12231,0,6.01068e+18,164.639,1337.39,12231,138,136,11582,10808,8951,9056,9062
45692,2453,10651,0,45692,16061,29631,2.53128e+15,60.0824,13752.1,45692,5189,72,35041,35041,17812,11653,8469
21738,4439,7592,20658,1080,20658,1080,3.0486e+18,94.9258,9306.42,21738,3675,110,14146,14146,9952,11692,8402
47358,3527,11024,44598,2760,44598,2760,5.86764e+18,97.8949,14591.6,47358,5343,110,36334,36334,34464,33733,13489
28572,60,176,28558,14,28572,0,5.98711e+18,169.686,2003.72,28572,160,165,19835,10488,8339,9973,9622
26906,9254,12772,25826,1080,0,26906,1.53569e+18,92.2165,14488.2,26906,6197,110,14134,14134,12766,12008,10798
9588,64,2326,9028,560,0,9588,2.22866e+18,96.1581,3370.64,9588,1098,110,5048,1446,1959,1564,725
47074,96,176,46906,168,47074,0,6.12017e+18,172.24,2686.46,47074,168,170,42282,31884,25036,25774,25286
37994,928,1357,0,37994,36895,1099,3.94748e+16,268.943,4459.53,37994,220,26,36637,36637,35454,35370,29666
17791,156,176,17736,55,17791,0,6.05979e+18,170.653,1641.79,17791,139,149,17423,17043,15763,15757,15717
45698,10308,18124,17376,28322,0,45698,7.76812e+12,57.4071,20673.4,45698,8807,72,27574,27574,23359,26694,16372
48073,9442,14309,0,48073,0,48073,5.94298e+17,96.6973,17677.3,48073,6947,110,33764,33764,29015,25097,23465
17157,47,176,17081,76,17157,0,6.0836e+18,166.658,1619.31,17157,142,140,11257,4733,4310,4923,4519
8797,6,10,8547,250,8793,4,1.38258e+14,9.88155,258.99,8797,10,10,8383,8117,6283,6181,5800
49174,134,176,49120,54,49174,0,6.00879e+18,173.097,2683.8,49174,172,173,47332,44376,37042,37853,37635
48389,1421,25054,0,48389,0,48389,4.07368e+17,93.3633,27573.3,48389,12172,110,23335,23335,11711,2883,2629
3515,604,1672,3366,149,3366,149,2.61463e+18,88.1437,2060.54,3515,785,68,1843,1757,1318,1371,890
23587,2917,5546,22217,1370,0,23587,2.22817e+18,97.5674,7612.52,23587,2668,110,18041,18041,15050,13785,10183
43644,118,176,43618,26,43644,0,6.01901e+18,173.138,2544.06,43644,171,172,40863,37009,28477,29051,29179
12933,6352,7631,0,12933,0,12933,3.52171e+17,89.8003,8460.66,12933,3693,102,5302,5302,4769,3895,4203
38917,293,1115,0,38917,37807,1110,3.5615e+16,234.013,3775.93,38917,171,26,37705,37298,28257,28200,15690
49760,14906,17680,0,49760,0,49760,5.45813e+17,95.9742,20912.5,49760,8590,110,32080,32080,28485,25781,24367
44222,2,14,42946,1276,44189,33,1.5271e+14,10.2938,626.63,44222,13,12,25784,18957,16414,19120,13126
33691,70,176,33673,18,33691,0,6.0067e+18,172.835,2219.12,33691,164,168,25543,14852,12084,13804,13330
40659,3,15,39487,1172,40602,57,1.51174e+14,10.56,657.965,40659,13,11,31212,22645,24760,25162,15685
17819,610,4177,0,17819,6268,11551,2.53769e+15,59.8931,5629.59,17819,2029,72,13642,13642,8457,2267,2231
20604,4382,7265,14109,6495,19583,1021,2.76035e+18,96.2118,8881.32,20604,3461,111,13339,13339,11595,13235,9577
47051,106,176,46998,53,47051,0,5.99236e+18,169.752,2601.55,47051,171,172,43004,29899,26421,27752,28129
12171,182,4226,0,12171,4518,7653,2.16143e+15,57.9397,5184.67,12171,2053,72,7945,7839,4614,465,703
43987,86,206,43966,21,42730,1257,5.98398e+18,193.627,2584.39,43987,186,180,36837,20859,17525,19825,19230
39017,6436,13108,39017,0,36857,2160,4.90998e+18,265.505,15047.9,39017,4714,133,25909,25770,20649,23555,14230
47236,12008,15747,44839,2397,0,47236,1.94053e+18,96.3186,18930.1,47236,7651,110,31489,31489,28297,27571,24759
34793,121,1048,0,34793,33800,993,3.57461e+16,216.625,3472,34793,157,26,33476,33323,27219,27565,8958
11376,165,2756,0,11376,0,11376,6.45789e+17,96.8823,3939.14,11376,1320,110,8620,8539,5141,333,1095
44090,13324,16047,44090,0,41704,2386,4.56121e+18,300.241,17870.9,44090,3205,137,28043,28027,26673,27374,23988
15557,3,12,15113,444,15550,7,1.3825e+14,10.3393,351.008,15557,12,11,11792,8366,9831,10327,6568
45100,6488,10836,42480,2620,42480,2620,4.03678e+18,98.3121,14169,45100,5125,111,34264,34264,25991,27617,21673
36743,4857,8564,0,36743,12914,23829,2.53145e+15,60.0379,11154.8,36743,4166,72,28179,28179,22790,18886,16314
44353,418,1594,0,44353,43070,1283,4.04454e+16,293.883,5326.33,44353,266,26,42759,41679,38055,34106,17990
42826,9521,16523,40826,2000,0,42826,1.78838e+18,94.7422,19285.7,42826,8030,110,26303,26303,21426,20336,16317
44546,5277,15313,44546,0,42114,2432,4.17897e+18,299.564,17441.3,44546,5984,134,29233,29024,19778,23070,11439
23213,123,6183,0,23213,8284,14929,2.41952e+15,59.4124,7914.02,23213,2999,72,17030,16888,4595,1229,617
9688,58,410,0,9688,9412,276,3.53297e+16,20.0402,1159.95,9688,61,26,9278,9278,6367,6322,2491
24783,850,5802,23333,1450,0,24783,2.23504e+18,97.6558,7945.08,24783,2807,110,18981,18981,8107,7270,3936
37761,290,12978,14009,23752,0,37761,8.45624e+12,58.2935,15316.9,37761,6312,72,24783,24388,14191,22963,1340
22107,2721,6120,20887,1220,20887,1220,3.23592e+18,96.9494,8003.41,22107,2959,110,15987,15987,9976,12502,7556
5599,159,283,0,5599,5437,162,3.70906e+16,19.8516,781.95,5599,50,26,5316,5316,5098,5061,3865
22248,9896,10640,21361,887,21361,887,2.52144e+18,92.7752,12118.9,22248,5154,110,11608,11608,11123,11488,10767
29309,757,11597,29309,0,27829,1480,5.03975e+18,225.065,13122.1,29309,4701,130,17712,17361,7072,11718,55
2046,108,170,2044,2,2046,0,5.98381e+18,131.489,531.91,2046,76,67,1776,1305,1230,1267,1290
4529,15,205,0,4529,0,4529,3.83586e+18,15.9329,447.308,4529,199,17,3950,2446,1908,2457,2587
5623,114,170,5618,5,5623,0,5.97785e+18,155.674,883.06,5623,106,105,5124,4568,3605,3697,3725
43419,11370,11865,41019,2400,41019,2400,3.18692e+18,97.235,15055.2,43419,5752,110,31554,31554,31081,31409,30406
24567,3626,6489,8758,15809,0,24567,9.47766e+12,59.4659,8304.31,24567,3151,72,18078,18078,14919,17418,9729
6750,267,304,0,6750,6554,196,3.5794e+16,19.9281,861.859,6750,52,26,6446,6446,6341,6341,5965
16029,1552,3771,0,16029,5642,10387,2.53179e+15,59.8255,5107.31,16029,1835,72,12258,12258,9105,9457,5384
26181,7,14,25429,752,26107,74,1.45473e+14,10.665,507.041,26181,13,12,25330,24887,22229,21867,16405
14950,778,872,0,14950,14513,437,4.33647e+16,158.141,2386.85,14950,120,26,14078,14078,13968,14015,13580
47248,901,15255,47248,0,44518,2730,4.90829e+18,320.148,17205,47248,5345,133,31993,31367,12885,20893,2736
38525,15436,16823,0,38525,0,38525,4.76744e+17,94.027,19207.1,38525,8165,110,21702,21702,20875,20144,20399
46262,3000,10755,43562,2700,43562,2700,5.85989e+18,97.9484,14259.9,46262,5222,110,35507,35507,33488,32177,11795
19522,105,869,0,19522,18960,562,3.89817e+16,136.458,2517.66,19522,123,26,18524,18428,15673,14385,5873
41296,12779,16100,39366,1930,39366,1930,5.56108e+18,93.7696,18723.3,41296,7708,111,25196,25196,25196,25196,21048
39468,5238,9209,37168,2300,0,39468,2.23041e+18,97.8656,12297.8,39468,4467,110,30259,30259,24872,23804,18340
30333,3479,7090,0,30333,10665,19668,2.53715e+15,60.0074,9304.24,30333,3453,72,23243,23243,18900,16609,11692
2190,8,113,0,2190,2131,59,3.54366e+16,19.0411,326.705,2190,32,26,1864,1706,1555,1494,400
46537,7591,11882,0,46537,0,46537,6.30651e+17,97.5556,15315.9,46537,5770,110,34655,34655,30313,25461,23093
27023,6571,7172,0,27023,9656,17367,2.4296e+15,59.5089,9126.97,27023,3494,72,19851,19851,19449,19214,19202
37758,8352,9774,35631,2127,0,37758,2.15725e+18,97.4078,12676.2,37758,4732,110,27984,27984,26610,26018,24598
13570,818,3263,12784,786,0,13570,2.22508e+18,97.0219,4615.37,13570,1562,110,10307,10307,7051,6412,3285
25878,7205,8485,25878,0,24415,1463,3.61944e+18,168.976,9929.35,25878,3344,125,17393,17393,16541,16864,16119
10078,102,175,10072,6,10078,0,5.98906e+18,162.5,1191.11,10078,128,129,8996,5703,5358,5617,5813
8804,6,10,8557,247,8798,6,1.39459e+14,9.90788,259.872,8804,10,10,8388,8122,6292,6181,5773
45212,6816,16368,0,45212,16921,28291,2.10616e+15,58.0195,19008.4,45212,7970,72,28844,28844,22844,19662,14194
2608,2,200,0,2608,2534,74,4.25217e+16,18.9571,502.869,2608,41,26,1159,770,623,547,297
6700,47,1589,2349,4351,0,6700,9.8869e+12,59.3727,2280.87,6700,765,72,4341,1443,2882,3145,105
22738,8456,8762,0,22738,0,22738,5.20158e+17,93.0773,10462.7,22738,4236,110,13976,13976,13975,13944,13976
15422,1432,5795,0,15422,0,15422,5.30516e+17,94.9996,7081.6,15422,2792,110,9627,9627,6261,2318,2578
20987,4133,7842,19987,1000,19987,1000,2.97832e+18,92.2087,9467.9,20987,3790,110,13145,13145,9421,10917,8159
12718,3868,12718,12718,0,0,12718,7.99937,0,12718,12718,12718,1,0,0,0,0,0
30817,427,960,0,30817,29938,879,3.55694e+16,190.536,3104.87,30817,141,26,29857,29539,24404,24953,17560
39645,4,14,38507,1138,39560,85,1.47507e+14,10.5694,632.969,39645,13,12,34639,30885,25406,26268,16342
7375,4,175,7370,5,7375,0,6.0195e+18,159.512,1020.02,7375,113,118,850,156,54,91,147
31467,10458,12771,12020,19447,0,31467,7.66469e+12,56.1053,14637.6,31467,6198,72,18696,18696,16880,18316,13989
34727,3823,8138,32703,2024,32703,2024,5.88356e+18,97.785,10922.9,34727,3944,110,26589,26589,25502,25505,13597
5174,17,170,5173,1,5174,0,5.98131e+18,155.248,847.648,5174,102,104,1832,303,456,470,439
28855,9140,9452,0,28855,0,28855,5.70915e+17,94.5935,11635.7,28855,4580,110,19403,19403,18998,19076,18774
8220,5,11,7982,238,8218,2,1.5827e+14,10.1321,261.981,8220,11,11,7589,6770,6524,6409,4210
8927,139,3152,8480,447,0,8927,1.90833e+18,94.9285,4037.64,8927,1514,107,5775,4017,2082,1612,884
6484,915,1548,0,6484,2276,4208,2.52601e+15,59.1747,2217.76,6484,750,72,4936,4936,4023,3110,3073
6871,1493,3267,6591,280,6591,280,9.27333e+18,84.9335,3898.86,6871,1568,94,3604,3604,3384,3384,1356
35445,2858,8517,33385,2060,33385,2060,3.65761e+18,98.2374,11277.5,35445,4023,111,26928,26928,17016,19749,10340
29757,534,942,0,29757,28907,850,3.55772e+16,184.4,3022.67,29757,137,26,28815,28519,26921,27149,20392
41953,4037,10081,39513,2440,39513,2440,4.38894e+18,98.3293,13230.1,41953,4775,111,31872,31872,23548,27926,14267
36086,3272,12038,34256,1830,34256,1830,2.9958e+18,96.2264,14614.3,36086,5833,110,24048,24048,17955,19151,7600
24539,4171,5901,23109,1430,23109,1430,1.33273e+18,98.0779,7979.22,24539,2781,111,18638,18638,16888,18509,13818
4909,749,1241,4619,290,4619,290,5.88217e+18,95.6806,1871.51,4909,566,87,3668,3668,3068,3318,2585
36881,1000,10522,13299,23582,0,36881,9.21061e+12,59.2084,12978,36881,5120,72,26359,26263,16131,24599,3688
19103,2068,5529,0,19103,0,19103,6.05975e+17,96.649,7189.94,19103,2674,110,13574,13574,9551,7659,7266
2172,106,558,0,2172,757,1415,2.53562e+15,57.587,855.498,2172,267,56,1614,1614,973,573,367
36782,12294,14611,0,36782,0,36782,5.11427e+17,94.8178,17031.4,36782,7094,110,22171,22171,21258,20449,20690
22623,2,12,21978,645,22615,8,1.38741e+14,10.1893,421.96,22623,11,11,13100,9276,8977,9315,7776
11031,553,3624,10461,570,10461,570,3.13375e+18,95.587,4685.14,11031,1743,110,7407,7235,3084,4899,1456
17687,2158,9056,17687,0,16970,717,5.16926e+18,204.551,10046.4,17687,2372,127,8631,8365,5961,6691,2919
20905,2708,4880,0,20905,7341,13564,2.53748e+15,59.9484,6527.91,20905,2377,72,16025,16025,13362,9829,9006
14437,2520,3781,13625,812,13625,812,6.25936e+18,94.0371,5169.7,14437,1803,110,10656,10656,10446,10446,8441
8318,702,2530,0,8318,3026,5292,2.30016e+15,58.3883,3287.67,8318,1220,72,5788,5740,4091,3478,2228
7551,1047,2808,7181,370,7181,370,6.11431e+18,90.9751,3569.62,7551,1306,100,4743,4743,2987,3898,858
40996,78,176,40919,77,40996,0,5.97851e+18,169.676,2396.96,40996,171,171,32781,18559,16547,18488,17753
34502,1026,12179,32802,1700,32802,1700,2.99324e+18,95.9081,14611.2,34502,5908,110,22323,22323,9491,14596,4425
16773,248,3941,0,16773,5902,10871,2.53181e+15,59.8635,5326.03,16773,1914,72,12832,12832,3888,1177,1024
28806,2683,8758,27268,1538,27268,1538,5.03481e+18,97.1896,10954.7,28806,4166,111,20048,20048,15292,16757,7281
32329,7494,7780,30449,1880,30449,1880,5.56747e+18,98.2219,10347.7,32329,3683,111,24549,24549,24068,24180,24050
20669,5602,6818,0,20669,7614,13055,2.22283e+15,58.4137,8285.19,20669,3320,72,13851,13851,12639,11302,11396
33120,341,1385,0,33120,32154,966,4.20641e+16,269.149,4414.63,33120,223,26,31637,30905,24031,24585,12396
22376,207,10695,8827,13549,0,22376,6.75561e+12,56.0851,11983.7,22376,5208,72,11681,11105,6720,10831,874
37767,3407,10995,0,37767,13654,24113,2.33715e+15,59.1221,13482.9,37767,5350,72,26772,26772,17057,16698,8200
31971,1851,7514,0,31971,0,31971,6.48733e+17,97.7428,10123.7,31971,3637,110,24457,24457,16822,8984,7432
17014,6342,6623,0,17014,6440,10574,2.02742e+15,57.3868,7797.52,17014,3222,72,10391,10391,10281,10290,10306
13009,2109,3113,12249,760,0,13009,2.22932e+18,97.1775,4425.17,13009,1497,110,9896,9896,8535,8306,7181
715,283,574,695,20,695,20,1.85392e+18,22.0895,626.343,715,241,42,141,141,29,128,0
49263,12012,24052,47343,1920,0,49263,1.49174e+18,93.5596,26726.3,49263,11682,110,25211,25211,20678,18196,13144
35562,3,14,34547,1015,35484,78,1.38854e+14,10.6953,585.28,35562,13,12,27169,19105,22581,21624,15526
31605,11,12,30700,905,31591,14,1.45311e+14,10.2219,510.101,31605,12,11,31593,31593,31424,31425,31299
39898,455,9290,14023,25875,0,39898,9.87653e+12,60.0448,12066.4,39898,4509,72,30608,30608,8902,24590,1969
29562,844,940,0,29562,28720,842,3.5573e+16,184.356,3007.42,29562,136,26,28622,28622,28372,28353,26927
30657,3886,9941,30657,0,28869,1788,5.22752e+18,199.141,11372.5,30657,2781,133,20716,20473,16017,18668,8858
24331,556,6179,8639,15692,0,24331,9.63338e+12,59.643,7998.6,24331,3003,72,18152,18104,7168,14897,2111
20422,146,12113,20422,0,19762,660,5.05218e+18,344.53,13206.2,20422,3575,127,7857,2977,3061,5458,684
22549,7895,8908,21509,1040,0,22549,1.76606e+18,94.1508,10581.1,22549,4304,110,13641,13641,12865,12579,11895
30044,2497,7017,0,30044,10566,19478,2.53266e+15,60.0334,9219.47,30044,3418,72,23027,23027,14997,10396,8452
14503,4,10,14091,412,14497,6,1.39156e+14,9.93677,333.13,14503,10,10,12553,11111,9323,9319,7157
16482,320,690,0,16482,16011,471,3.55567e+16,21.1636,1908.89,16482,88,26,15792,15791,13452,13616,8605
25320,495,1024,0,25320,24589,731,3.92589e+16,207.377,3141.68,25320,154,26,24296,23902,20166,20606,13540
29616,127,6977,0,29616,0,29616,6.46469e+17,97.6869,9439.68,29616,3368,110,22639,11469,6271,1219,1843
21794,92,208,21743,51,21794,0,6.09426e+18,201.386,1969.97,21794,159,155,18612,13510,9594,9865,9487
42134,153,208,42079,55,42134,0,6.01892e+18,203.363,2642.03,42134,183,186,40568,37697,31221,31601,31032
27426,6260,10521,26126,1300,26126,1300,4.20223e+18,95.9537,12450.6,27426,5035,111,16905,16905,12310,13031,11272
23344,2616,7506,8562,14782,0,23344,8.73141e+12,58.1108,9140.81,23344,3640,72,15838,15838,11093,14428,5919
24252,11,13,23560,692,24181,71,1.38672e+14,10.7352,475.895,24252,13,12,24236,24227,23517,23516,21692
31266,4,15,30343,923,31205,61,1.77459e+14,10.4399,589.383,31266,13,12,27388,24416,19478,20140,8393
2989,83,170,2989,0,2989,0,6.01629e+18,141.676,642.188,2989,83,82,2423,1393,1351,1450,1493
13179,1092,3114,0,13179,4642,8537,2.54032e+15,59.8009,4262.12,13179,1514,72,10065,10065,6400,4280,3561
12515,1,12,12158,357,12504,11,1.46327e+14,10.475,320.558,12515,12,11,3030,3030,3030,3030,3030
19040,3960,4511,0,19040,0,19040,6.46984e+17,97.3891,6261.02,19040,2174,110,14529,14529,13809,13662,13230
27913,1591,11688,0,27913,10730,17183,1.92122e+15,57.0556,13354.3,27913,5688,72,16225,16225,9780,1667,2125
16081,3683,3828,15144,937,0,16081,2.22779e+18,97.2967,5368.8,16081,1841,110,12253,12253,12091,12101,12086
16566,413,5676,15726,840,15726,840,3.7425e+18,96.2281,7064.7,16566,2701,111,10890,10629,6194,6349,2071
7561,107,459,2298,5263,0,7561,6.90315e+18,15.956,773.788,7561,320,18,7102,7102,3793,3499,3168
34992,2,15,33969,1023,34903,89,1.66165e+14,10.4719,624.4,34992,13,12,20645,15742,12137,15861,8194
23901,65,176,23824,77,23901,0,6.00408e+18,170.434,1863.74,23901,154,161,17429,9880,7784,9133,8728
44605,11505,15488,42395,2210,42395,2210,3.05233e+18,96.0542,18485.2,44605,7512,110,29117,29117,23954,26095,21902
15027,4405,5036,15027,0,14157,870,4.08297e+18,123.636,5939.81,15027,1804,120,9991,9991,9503,9726,9138
15594,2136,3690,5479,10115,0,15594,9.8393e+12,59.7504,4996.79,15594,1784,72,11904,11904,9750,11534,7266
41447,11,14,40251,1196,41362,85,1.52503e+14,10.5125,655.734,41447,13,12,41430,41421,38877,38916,39363
33635,73,176,33616,19,33635,0,6.02213e+18,171.474,2233.76,33635,166,169,26134,15682,12626,14184,13918
46568,10500,14691,0,46568,0,46568,5.78457e+17,96.2305,17911,46568,7116,110,31877,31877,28675,27597,25207
48219,19072,20376,48219,0,36000,12219,4.93648e+18,2480.74,23490.3,48219,7944,152,27843,27799,27573,27636,26416
15503,2261,3692,14603,900,14603,900,3.22342e+18,97.2488,5192.09,15503,1770,110,11811,11811,10372,11378,7717
8846,1731,2101,8326,520,0,8846,2.24296e+18,96.805,3092.77,8846,1004,109,6745,6745,6263,6204,5949
26988,146,176,26978,10,26988,0,5.99145e+18,171.528,1965.25,26988,165,161,26271,24680,22545,22522,22479
22524,4120,10956,0,22524,8923,13601,1.6988e+15,53.094,12237.9,22524,5315,72,11568,11568,8744,5868,5306
20731,1,13,20139,592,20660,71,1.43039e+14,10.8518,448.093,20731,13,12,5147,5147,5147,5147,5147
48057,5033,11225,45257,2800,0,48057,2.22863e+18,97.9325,14834.5,48057,5449,110,36832,36832,28826,26486,18119
45581,17,19,44212,1369,45442,139,2.00276e+14,10.2525,790.081,45581,14,13,45562,45562,45201,45201,42927
34392,4763,17591,34392,0,33251,1141,5.15734e+18,2189.72,20168.2,34392,6851,143,16801,13840,8330,10798,6518
32245,3244,10454,32245,0,30365,1880,4.39417e+18,216.128,11938.3,32245,3845,124,21791,21513,13271,17097,7621
37804,5174,16406,37804,0,36074,1730,4.68932e+18,481.023,18351.4,37804,4433,141,21398,20871,14934,16050,7700
41337,6939,18092,0,41337,16024,25313,1.86177e+15,56.8104,20306.3,41337,8813,72,23245,23245,15900,10841,9345
8495,1369,3735,8495,0,8085,410,3.71407e+18,99.3375,4360.63,8495,1568,112,4760,4748,2833,3535,1651
22620,5072,10533,21700,920,0,22620,1.56249e+18,93.8885,12059.9,22620,5097,110,12087,12087,9287,8687,6467
1588,40,561,1506,82,1506,82,6.77401e+18,87.4194,815.888,1588,247,52,542,98,237,389,115
34987,5445,8395,32947,2040,32947,2040,5.12015e+18,98.2523,11124.2,34987,3967,111,26592,26592,25056,26568,18273
18458,72,176,18407,51,18458,0,6.15846e+18,164.302,1676.01,18458,135,139,15330,11654,7641,7881,7682
8829,640,2118,8316,513,0,8829,2.23415e+18,96.4864,3105.14,8829,1006,108,6711,6711,4706,4380,2488
31963,2381,13741,31963,0,24769,7194,4.61948e+18,299.821,15192.6,31963,5823,131,18222,17677,9287,13330,2627
20362,6,12,19782,580,20355,7,1.40613e+14,10.312,404.281,20362,12,11,19340,18714,16992,17012,11401
33891,680,1134,0,33891,32917,974,3.75246e+16,231.149,3702.66,33891,174,26,32757,32228,30999,31068,23659
22895,338,818,0,22895,22240,655,3.56401e+16,125.458,2461.12,22895,113,26,22077,21931,18066,18382,12492
24391,6956,10890,0,24391,0,24391,4.70053e+17,94.294,12549.1,24391,5282,110,13501,13501,11355,9929,9275
40111,14285,15537,0,40111,0,40111,5.18939e+17,95.4155,18158,40111,7545,110,24574,24574,23861,23911,23369
29952,130,176,29893,59,29952,0,6.13694e+18,172.362,2142.03,29952,159,158,28706,26745,22021,22203,22151
25302,6859,12320,24312,990,0,25302,1.4992e+18,92.1235,13932.3,25302,5961,110,12982,12982,11080,10060,8142
23834,1880,7671,22601,1233,22601,1233,3.0955e+18,96.2248,9566.33,23834,3709,110,16163,16163,8325,11539,5153
17432,70,176,17425,7,17432,0,6.04715e+18,169.994,1619.9,17432,143,147,13410,8365,6373,7127,6847
24886,1461,6096,0,24886,0,24886,6.39618e+17,97.4971,8229.78,24886,2947,110,18790,18790,12825,5956,5627
22286,38,805,0,22286,21652,634,3.56344e+16,117.994,2409.58,22286,109,26,21362,21345,16810,16356,4291
41431,9591,9660,39012,2419,0,41431,2.23165e+18,97.8746,12863.5,41431,4687,110,31771,31771,31705,31710,31730
27221,1217,1391,0,27221,26417,804,4.58351e+16,274.452,4257.2,27221,224,26,25830,25830,25590,25560,24098
14376,6556,6965,0,14376,5695,8681,1.71389e+15,54.0854,7874.84,14376,3387,72,7411,7411,6918,6554,6283
6372,2088,2260,0,6372,2377,3995,2.16078e+15,57.5138,2846.86,6372,1096,72,4112,4112,3869,4064,3735
2365,364,1546,2295,70,2295,70,4.67027e+18,73.6858,1761.63,2365,708,58,819,717,158,314,80
18785,3,14,18219,566,18731,54,2.00921e+14,10.1925,459.261,18785,13,11,14845,11924,6853,8474,4938
22966,4239,5381,21626,1340,21626,1340,3.35483e+18,97.6559,7407.9,22966,2600,110,17585,17585,15314,16353,14410
13773,120,175,13708,65,13773,0,5.98317e+18,164.646,1391.04,13773,136,145,12851,11668,9180,9341,9642
31792,2051,8581,11377,20415,0,31792,9.40283e+12,59.4303,10798.7,31792,4168,72,23211,23211,15847,21941,6916
44618,10232,18902,44618,0,43088,1530,5.22265e+18,4056.55,23458,44618,7878,150,25716,19820,17223,19647,14789
29186,461,926,0,29186,28356,830,3.54881e+16,176.827,2959.69,29186,134,26,28260,27983,23683,24206,18467
754,215,264,708,46,708,46,5.52586e+18,80.3541,410.862,754,111,42,490,490,459,473,476
6064,8,11,5888,176,6062,2,1.39995e+14,10.5882,219.753,6064,11,11,5891,5770,4599,4632,4774
29526,5483,9722,0,29526,0,29526,5.69253e+17,96.2002,11939.3,29526,4714,110,19804,19804,16470,11860,11014
26472,3906,9956,25202,1270,25202,1270,4.61629e+18,96.088,11853.6,26472,4770,111,16516,16516,9207,10577,6743
23039,2559,5477,21699,1340,0,23039,2.22421e+18,97.5475,7498.96,23039,2643,110,17562,17562,14051,12768,9014
33897,11172,13056,32302,1595,32302,1595,6.11907e+18,95.999,15318.4,33897,6257,111,20841,20841,20841,20824,19377
31647,5702,7620,29804,1843,29804,1843,5.02618e+18,98.1956,10142.1,31647,3603,111,24027,24027,23299,24027,18896
41061,1048,9543,0,41061,14431,26630,2.53786e+15,60.0809,12380.7,41061,4649,72,31518,31518,19127,8050,3974
31618,6737,7436,29779,1839,29779,1839,5.89538e+18,97.7268,10023.3,31618,3599,110,24182,24182,24004,24004,22409
47387,4618,15085,47387,0,44627,2760,4.29758e+18,327.418,17047.4,47387,3833,134,32302,32083,19551,24128,11093
41364,1851,19381,39694,1670,39694,1670,9.19424e+18,92.6918,21788.1,41364,9406,110,21983,21983,17861,15481,3342
43374,602,16086,41297,2077,41297,2077,2.88357e+18,95.5877,18933.3,43374,7798,110,27288,26608,16071,16966,3284
679,280,284,474,205,639,40,2.13044e+18,72.106,407.822,679,103,38,395,395,395,395,395
953,67,327,901,52,901,52,5.91466e+18,81.8898,503.684,953,128,42,471,141,348,387,149
39095,1,14,37981,1114,39014,81,1.38754e+14,10.6529,613.491,39095,13,12,10026,10026,10026,10026,10026
42177,5899,11063,39810,2367,0,42177,2.14556e+18,97.4405,14219.2,42177,5371,110,31114,31114,25559,24338,19136
28547,6302,8810,28547,0,26887,1660,4.69838e+18,179.793,10375.3,28547,1772,129,19737,19733,18300,19387,14773
46466,570,20627,18062,28404,0,46466,7.16448e+12,56.6822,23046.2,46466,10026,72,25839,25179,14605,23919,1117
36523,8,12,35480,1043,36504,19,1.44086e+14,10.2404,548.471,36523,12,11,35719,35108,28105,28263,29300
35833,1485,2410,11118,24715,11118,24715,2.09236e+18,15.9917,3110.96,35833,1464,18,33423,33423,32499,33423,24294
38663,563,15229,36863,1800,36863,1800,2.87923e+18,95.9478,17703.3,38663,7309,111,23434,23347,8095,12976,3325
16265,6769,7243,15575,690,15575,690,2.75046e+18,85.9211,8473.04,16265,3488,110,9022,9022,9022,9022,9022
33902,172,176,33839,63,33902,0,6.08166e+18,169.121,2277.45,33902,159,164,33722,33701,33104,33095,33110
31488,14817,20404,0,31488,6802,24686,5.72741e+15,5.52496,23414.2,31488,6806,13,11084,11084,10300,10300,8443
25807,598,1152,0,25807,0,25807,3.83054e+18,15.9886,1751.84,25807,1083,18,24655,24655,17886,19422,17329
25351,66,176,25277,74,25351,0,6.0461e+18,172.554,1951.65,25351,161,159,18985,11538,8584,9721,9395
47172,9714,14335,0,47172,0,47172,5.87573e+17,96.7599,17629.8,47172,6951,110,32837,32837,28232,25126,22872
5915,90,170,5911,4,5915,0,5.94637e+18,156.871,905.868,5915,106,107,5025,3047,2889,3044,3097
33742,4415,7873,0,33742,11870,21872,2.53001e+15,60.0294,10292.9,33742,3832,72,25869,25869,20870,21947,14868
43200,3086,16094,41140,2060,41140,2060,7.78857e+18,95.6452,18922.7,43200,7817,110,27106,27020,23025,21859,6468
10758,833,3682,7410,3348,10208,550,3.23163e+18,95.9566,4695.93,10758,1751,111,7076,7076,3884,4816,1248
42633,5959,13627,42633,0,40153,2480,4.1412e+18,301.037,15445.4,42633,5059,128,29006,28842,19996,24062,14063
13558,770,3199,4769,8789,0,13558,9.89653e+12,59.8163,4374.3,13558,1558,72,10359,10359,5435,9027,2759
21879,90,175,21865,14,21879,0,5.98008e+18,166.752,1750.99,21879,160,156,18782,11339,10387,11070,11530
37586,7374,8854,35405,2181,0,37586,2.22409e+18,97.6587,11819.3,37586,4280,110,28732,28732,26830,26450,24765
21460,50,61,21428,32,21460,0,2.34031e+18,60.6593,1087.6,21460,61,61,20468,19669,18016,18133,17440
12277,1036,4279,0,12277,4556,7721,2.16044e+15,57.9118,5241.34,12277,2077,72,7998,7998,5264,4848,3271
35950,1804,8621,33857,2093,33857,2093,2.7322e+18,98.288,11412.5,35950,4086,111,27329,27329,9889,16907,7398
2017,88,176,2016,1,2017,0,6.11957e+18,108.492,556.124,2017,68,62,1690,1219,1177,1217,1162
3132,66,169,3132,0,3003,129,2.33365e+18,17.5284,375.334,3132,139,20,2963,2962,2877,2947,1640
13685,3156,3239,4806,8879,0,13685,9.88747e+12,59.7834,4419.32,13685,1576,72,10446,10446,10361,10426,10338
33280,124,176,33266,14,33280,0,5.98232e+18,169.668,2161.28,33280,164,170,31468,28820,23631,23550,23602
19983,4959,6204,19983,0,18815,1168,5.54173e+18,150.601,7432.46,19983,1806,126,13779,13779,13248,13779,11482
29090,577,6817,0,29090,10227,18863,2.53101e+15,59.9587,8957.63,29090,3316,72,22273,22273,13117,4904,1963
47007,13913,24937,45317,1690,45317,1690,2.96207e+18,93.601,27305.1,47007,12028,111,22070,22070,13431,16194,13107
30733,1254,9392,30733,0,28943,1790,3.42692e+18,203.153,11050.2,30733,3475,129,21341,21095,12314,15217,3464
3607,1872,2132,3487,120,3487,120,1.07127e+19,88.794,2461.69,3607,1016,66,1475,1475,1409,1412,1018
46890,8912,11244,44160,2730,44160,2730,4.35477e+18,98.342,14679.4,46890,5322,111,35646,35646,31251,32164,29260
43482,14,176,43468,14,43482,0,5.98084e+18,172.15,2471.6,43482,173,172,13679,2087,2974,3227,3307
11675,1373,4030,11083,592,11083,592,3.69377e+18,95.8863,5100.74,11675,1905,111,7645,7645,5697,6153,2977
33380,8124,11811,0,33380,0,33380,5.47996e+17,95.8717,14179.3,33380,5731,110,21569,21569,18675,17198,15628
36783,107,1076,0,36783,35733,1050,3.56223e+16,225.371,3608.21,36783,163,26,35414,35250,23076,22944,8911
15466,15,175,15398,68,15466,0,5.99279e+18,164.911,1472.89,15466,148,146,5071,851,1107,1221,1188
1979,167,560,0,1979,0,1979,6.18967e+17,90.2319,882.654,1979,239,57,1419,1419,747,638,587
37448,97,176,37378,70,37448,0,6.01833e+18,173.505,2354.79,37448,167,170,33146,21677,19134,20274,20348
9175,223,522,0,9175,8909,266,3.90957e+16,19.8307,1355.91,9175,72,26,8653,8653,6928,7029,3436
7979,472,3561,7639,340,0,7979,1.63779e+18,70.1699,4292.28,7979,1693,94,4418,4418,2731,2586,1827
9229,1148,3711,8806,423,0,9229,1.76439e+18,94.0218,4567.32,9229,1785,107,5518,5518,3813,3140,1900
39424,8721,20106,0,39424,0,39424,4.1505e+17,92.3436,22286,39424,9754,110,19318,19318,13789,10626,8136
32411,1068,1898,0,32411,31438,973,5.13147e+16,315.905,5873.86,32411,327,26,30513,30513,29069,28073,20759
4104,823,1487,4104,0,3867,237,5.65152e+18,90.1296,1894.05,4104,531,84,2617,2617,2208,2438,1841
30520,480,1228,0,30520,29634,886,4.05997e+16,260.406,3880.87,30520,194,26,29292,28650,26594,24948,14984
19766,737,6345,7252,12514,0,19766,8.80753e+12,58.5489,7776.31,19766,3091,72,13421,13321,7086,11330,2396
34730,3,12,33741,989,34719,11,1.38873e+14,10.1749,525.56,34730,12,11,26385,18678,22131,22894,14477
609,239,253,226,383,0,609,8.36951e+12,49.9113,353.21,609,116,33,356,356,356,356,356
8355,903,2836,8355,0,7870,485,6.23699e+18,91.8701,3468.6,8355,822,116,5519,5519,4379,5231,2132
2268,55,84,0,2268,2228,40,2.57349e+16,3.72531,344.058,2268,44,4,2184,2184,2181,2163,1758
44270,4,15,42993,1277,44176,94,1.52608e+14,10.4543,663.946,44270,13,13,38552,34347,33506,27686,17552
34065,941,1020,0,34065,33093,972,3.55603e+16,211.147,3373.28,34065,152,26,33045,33045,32822,32808,31508
38362,1,15,37230,1132,38267,95,1.75399e+14,10.33,673.452,38362,13,12,7172,7172,7172,7172,7172
1649,165,534,1559,90,1559,90,3.24798e+18,88.618,806.304,1649,234,53,1115,1034,547,785,553
6261,117,170,6261,0,6261,0,5.97094e+18,158.651,933.796,6261,109,111,5746,5232,4126,4208,4313
10415,2124,3539,10415,0,9805,610,4.94082e+18,92.4914,4256.92,10415,1265,120,6876,6876,5406,6000,4503
38030,7968,10867,35969,2061,35969,2061,3.27585e+18,96.9769,13703.7,38030,5263,110,27163,27163,22326,24396,20308
16346,7143,7309,16346,0,15566,780,5.43661e+18,147.137,8195.57,16346,1698,124,9037,9037,9037,9037,9037
13042,216,5347,0,13042,0,13042,5.03553e+17,94.4518,6440.27,13042,2586,110,7695,7310,4559,1962,1259
45370,1957,11125,0,45370,16043,29327,2.49173e+15,59.8823,14167.6,45370,5417,72,34245,34245,14673,9748,6792
20833,1157,6856,20833,0,19621,1212,6.02957e+18,152.885,7969.54,20833,2489,123,13977,13871,8195,10984,2847
15733,10,11,15282,451,15726,7,1.39101e+14,10.6106,350.336,15733,11,11,15642,15482,15361,15362,15201
45914,10762,16991,43715,2199,43715,2199,2.90248e+18,95.641,19968.8,45914,8246,110,28923,28923,23802,27463,14344
17179,3037,5693,6339,10840,0,17179,8.63471e+12,58.315,6965.23,17179,2768,72,11486,11486,9800,11133,7131
48070,31,61,47974,96,48070,0,2.33501e+18,60.847,1632.36,48070,61,61,35596,8264,22744,23625,24208
49946,77,208,49839,107,49946,0,6.0978e+18,203.601,2972.2,49946,188,186,40233,26718,18238,19790,18597
36757,3046,8568,12918,23839,0,36757,9.88849e+12,60.0376,11159,36757,4170,72,28189,28189,20106,26791,10286
3057,185,1011,2895,162,2895,162,6.89431e+18,92.3137,1430.09,3057,469,72,2046,1960,217,1703,711
24189,4078,7917,24189,0,22779,1410,3.74213e+18,162.051,9141.1,24189,2881,124,16272,16272,11775,13685,8775
34303,22,176,34221,82,34303,0,6.13566e+18,171.498,2292.52,34303,160,162,14979,3496,4555,4573,4120
32384,2331,12359,0,32384,12225,20159,2.04088e+15,57.6548,14326.6,32384,6015,72,20025,20025,13141,12474,4896
19697,8,12,19130,567,19684,13,1.4849e+14,10.1426,402.534,19697,12,11,19284,18994,15275,15379,16164
26741,8213,8249,26741,0,25181,1560,3.69919e+18,171.573,9748.02,26741,3175,124,18492,18492,18492,18492,18492
46528,167,176,46445,83,46528,0,5.98041e+18,171.888,2555.82,46528,172,171,46235,45653,44068,44072,44029
46713,7898,24527,18837,27876,0,46713,6.12671e+12,54.6015,26664,46713,11943,72,22186,22186,15627,20147,8591
34908,1294,1316,0,34908,33897,1011,4.00644e+16,265.739,4257.31,34908,212,26,33592,33592,33534,33525,33357
18587,1098,6507,17665,922,0,18587,1.90078e+18,95.6046,8029,18587,3147,110,12080,11994,7905,7035,3287
33251,6890,8832,11874,21377,0,33251,9.45013e+12,59.4874,11141.3,33251,4287,72,24419,24419,21862,23979,18887
48504,5309,21884,0,48504,18920,29584,1.81083e+15,55.9061,24363,48504,10639,72,26620,26620,16312,8722,6448
25524,85,176,25440,84,25524,0,6.11757e+18,171.918,1978.24,25524,149,156,21916,15665,12061,12293,12167
3573,830,864,0,3573,1252,2321,2.55544e+15,58.808,1297.93,3573,420,64,2709,2709,2678,2691,2676
1040,159,396,983,57,983,57,3.25676e+18,83.6452,575.983,1040,170,48,644,562,305,434,407
4670,796,1643,0,4670,1721,2949,2.1649e+15,57.2428,2113.25,4670,796,69,3027,3027,2695,2447,2368
37929,4633,18747,37929,0,37929,0,1.57268e+17,17.9822,19311,37929,16859,20,19182,19182,5421,19182,4838
26092,7282,12288,25042,1050,25042,1050,2.56786e+18,93.8743,13974.9,26092,5957,110,13804,13718,10029,12724,3108
24424,127,176,24408,16,24424,0,6.07085e+18,171.465,1929.26,24424,156,158,23219,21396,17670,17583,17714
26797,488,6921,25277,1520,25277,1520,1.38245e+18,97.8125,9105.3,26797,3266,111,19876,19876,6116,6471,2423
16754,167,176,16713,41,16754,0,5.97339e+18,165.648,1542.42,16754,144,152,16535,16345,16021,15984,16027
22983,3792,5352,8075,14908,0,22983,9.90269e+12,59.9932,7132.39,22983,2603,72,17631,17631,15326,17231,12666
48343,11,14,46965,1378,48259,84,1.38906e+14,10.5345,682.549,48343,13,12,48328,48323,45512,45577,45907
15549,1312,4292,14689,860,14689,860,6.28015e+18,96.6847,5739.84,15549,2069,110,11257,11257,9955,9749,4967
32034,5804,7493,0,32034,11266,20768,2.52468e+15,59.9863,9812.14,32034,3636,72,24541,24541,22071,19736,19178
18354,2852,4351,0,18354,0,18354,6.46911e+17,97.4003,6052.84,18354,2095,110,14003,14003,12292,11305,9705
5068,1066,1551,0,5068,1839,3229,2.31647e+15,53.9625,2077.6,5068,735,70,3517,3517,3479,3497,3482
43179,43,176,43159,20,43179,0,5.98e+18,172.179,2463.02,43179,171,172,25641,10267,8761,11312,10541
8883,3331,4143,8883,0,6823,2060,3.66301e+18,113.012,4731.94,8883,1707,107,4740,4740,4021,4348,3668
14209,7274,7502,14209,0,13649,560,5.01628e+18,163.943,8330.59,14209,3372,120,6707,6705,6707,6707,6668
28193,3577,6654,26553,1640,26553,1640,5.769e+18,97.6509,9018.93,28193,3217,110,21539,21539,19707,19411,12504
29541,4855,9794,0,29541,0,29541,5.65839e+17,95.155,12009.4,29541,4738,110,19747,19747,15187,11373,10017
34152,254,1024,0,34152,33179,973,3.55583e+16,210.643,3380.43,34152,153,26,32992,32734,24566,24270,12751
950,148,322,900,50,900,50,5.90765e+18,81.7674,498.657,950,123,42,628,628,589,580,395
33436,12200,16984,13375,20061,0,33436,6.3498e+12,54.5043,18671,33436,8251,72,16452,16452,14349,16012,10970
18863,7710,8309,18863,0,17973,890,3.88393e+18,170.041,9386.09,18863,3602,125,10554,10554,10186,10398,9762
17574,2575,4171,16554,1020,0,17574,2.22641e+18,97.3634,5821.25,17574,1997,110,13403,13403,11607,10907,8831
41527,9,13,38117,3410,41266,261,1.15391e+14,8.18097,543.706,41527,12,9,41514,41514,39794,39795,40048
16221,5366,7538,15559,662,0,16221,1.56975e+18,93.6381,8730.94,16221,3639,110,8683,8683,7333,7010,6146
45028,3079,16576,42868,2160,0,45028,1.83856e+18,95.7263,19519.4,45028,8048,110,28452,28366,20754,19404,11317
49812,4712,12319,46962,2850,0,49812,2.18942e+18,97.7192,15979.4,49812,5983,110,37493,37493,26208,24404,16484
1178,289,328,415,763,0,1178,1.00914e+13,55.1486,514.012,1178,154,46,850,850,805,840,819
25347,3810,5956,0,25347,8916,16431,2.53589e+15,59.9566,7868.81,25347,2901,72,19391,19391,16861,13544,12740
30354,885,1373,0,30354,29465,889,4.34117e+16,271.123,4302.69,30354,221,26,28981,28981,26578,27098,21739
49845,11804,14717,47155,2690,47155,2690,2.23775e+18,97.5225,18112.6,49845,7016,111,35128,35128,32899,34975,29313
44613,4037,13866,44613,0,42053,2560,4.91349e+18,311.098,16050.6,44613,4710,136,30747,30559,20983,25539,10383
5349,117,176,5343,6,5349,0,6.02886e+18,156.11,896.493,5349,100,106,4909,4493,3514,3571,3599
38017,4055,11967,36037,1980,0,38017,1.99437e+18,94.1292,14715.1,38017,5789,110,26050,26050,16494,15925,9660
8264,1706,1987,7784,480,0,8264,2.23182e+18,96.4189,2929.09,8264,939,105,6277,6277,5981,5878,5761
22828,4264,7779,21680,1148,21680,1148,7.28129e+18,95.8987,9576.79,22828,3763,110,15049,15049,13945,13776,9796
2620,186,191,0,2620,2545,75,4.19144e+16,19.0534,492.906,2620,41,26,2429,2429,2420,2421,2412
3792,3,11,3684,108,3792,0,1.37546e+14,10.7065,171.451,3792,11,11,2907,2046,2423,2312,1822
43165,5440,20828,41447,1718,41447,1718,5.46712e+18,94.5673,23211.2,43165,10043,111,22337,22337,17987,15847,7924
42435,7262,17806,0,42435,16316,26119,1.9161e+15,57.0334,20130,42435,8659,72,24629,24629,18021,12999,10164
4402,689,1238,4152,250,0,4402,2.15533e+18,92.5279,1811.37,4402,578,82,3164,3164,2550,2371,1847
13102,61,175,13096,6,13102,0,5.97655e+18,163.838,1356.48,13102,134,143,9144,4871,3985,4602,4646
10254,1953,3070,9696,558,9696,558,5.10569e+18,95.7417,4095.46,10254,1430,111,7184,7184,6090,6330,5995
49439,3184,13998,46729,2710,46729,2710,3.29039e+18,97.6894,17421.1,49439,6660,111,35441,35441,22187,24966,10014
45731,5838,13821,0,45731,0,45731,5.89855e+17,95.862,17041.9,45731,6705,110,31910,31910,23630,18405,12966
28648,630,7139,0,28648,10140,18508,2.47903e+15,59.7449,9222.77,28648,3473,72,21509,21509,7503,3796,2387
47972,9,10,47145,827,47876,96,9.94715e+13,3.99814,624.361,47972,7,4,47962,47962,47962,47961,46568
49777,7083,20163,19017,30760,0,49777,7.67734e+12,57.3599,22863.7,49777,9818,72,29614,29614,21401,27070,10930
31158,7079,11336,29648,1510,0,31158,1.85582e+18,95.6901,13554,31158,5500,110,19822,19822,16332,15557,12546
24620,3225,7040,23280,1340,0,24620,2.08352e+18,96.8109,9063.28,24620,3404,110,17580,17580,13591,12627,8501
19883,1549,5722,18793,1090,18793,1090,1.78527e+18,97.2704,7413.04,19883,2722,111,14161,14161,10358,9518,5793
48310,6,15,46926,1384,48226,84,1.43167e+14,10.3807,666.978,48310,14,12,45929,44649,40259,39330,28514
32076,1,13,31151,925,32059,17,1.50338e+14,10.2321,521.286,32076,12,12,7522,7522,7522,7522,7522
33598,9784,12042,31956,1642,0,33598,1.87059e+18,95.8055,14408.7,33598,5842,110,21556,21556,19732,18888,16933
48781,9140,15540,48781,0,45941,2840,4.67782e+18,334.859,17542.8,48781,5807,131,33241,33005,27023,30237,21237
25951,9002,10215,25951,0,24601,1350,3.84764e+18,183.087,11453.2,25951,3966,129,15736,15736,15690,15661,13976
10480,896,2534,9870,610,0,10480,2.22364e+18,96.9225,3652.19,10480,1215,110,7946,7946,5787,5449,3458
12079,163,176,12074,5,12079,0,6.00762e+18,165.853,1331.5,12079,133,138,11838,11659,11213,11161,11210
23376,2927,9230,22296,1080,0,23376,1.76749e+18,94.8637,10947.8,23376,4472,110,14146,14146,9930,8971,5468
8521,67,369,0,8521,8280,241,3.57032e+16,19.9651,1051.13,8521,58,26,8152,8152,5855,5800,2546
41471,4241,9652,0,41471,14573,26898,2.52684e+15,60.0361,12516.9,41471,4688,72,31819,31819,23926,13942,14321
14147,29,176,14105,42,14147,0,6.0641e+18,165.497,1468.35,14147,131,137,7177,2001,2287,2493,2295
16855,80,208,16805,50,16855,0,6.15484e+18,198.454,1734.13,16855,140,142,13880,9595,6413,6924,6454
23711,3898,5764,22333,1378,22333,1378,2.48162e+18,98.0375,7783.3,23711,2720,111,17947,17947,13806,15159,12976
37007,9374,9727,34936,2071,0,37007,2.14451e+18,97.3249,12574,37007,4709,110,27280,27280,26906,26812,26558
48862,209,11425,0,48862,0,48862,6.4698e+17,97.8961,15083.6,48862,5533,110,37437,37266,22201,7329,3036
27836,885,7173,26266,1570,26266,1570,6.22133e+18,96.2343,9467.61,27836,3461,110,20663,20663,18653,16750,2884
24271,69,176,24244,27,22945,1326,6.10434e+18,171.432,1930.01,24271,154,152,19127,13485,9180,9724,9242
22523,64,175,22514,9,22523,0,5.97822e+18,166.625,1776.24,22523,154,162,16147,8781,7178,8327,8046
15786,2348,8038,15187,599,15187,599,4.40611e+18,93.6512,9119.33,15786,3860,111,7748,7748,3860,4631,2745
10475,860,4266,9995,480,9995,480,8.17637e+18,94.1607,5197.62,10475,2051,110,6209,6037,5536,5431,3204
48434,1920,17702,18155,30279,0,48434,8.17087e+12,57.9321,20488.1,48434,8615,72,30732,30732,18368,28610,3326
9738,640,2328,0,9738,3435,6303,2.53013e+15,59.6125,3235.88,9738,1134,72,7410,7410,4217,2813,2262
40373,1937,9454,0,40373,14192,26181,2.52732e+15,60.0422,12251.1,40373,4599,72,30919,30919,14747,13472,6648
6756,58,170,6755,1,6756,0,5.98995e+18,159.005,969.402,6756,112,114,4583,2385,1964,2311,2221
13245,520,583,0,13245,12868,377,3.58901e+16,19.9571,1597.78,13245,74,26,12662,12662,12585,12587,12214
8827,1306,3462,8408,419,8408,419,7.91734e+18,94.2793,4297.35,8827,1660,100,5365,5365,4563,4427,1662
2514,98,122,0,2514,2442,72,3.54556e+16,19.068,357.797,2514,34,26,2392,2392,2282,2287,2160
25806,9,13,25051,755,25788,18,1.64003e+14,10.2878,477.126,25806,12,12,25517,25205,24306,24305,20209
25685,119,868,0,25685,24951,734,3.55954e+16,152.588,2686.46,25685,123,26,24705,24611,16770,16604,7097
857,117,261,0,857,300,557,2.53681e+15,52.9253,403.86,857,126,40,596,596,412,231,328
39849,654,1198,0,39849,38710,1139,3.65505e+16,249.51,4049.02,39849,188,26,38651,38046,35983,36055,25766
31421,2051,10671,0,31421,0,31421,5.59139e+17,95.2625,12968.5,31421,5174,110,20750,20750,14010,7745,6271
11761,2082,5779,11761,0,11761,0,3.26937e+18,18.939,6095.21,11761,4974,23,5982,5982,2649,2504,2203
26101,43,176,26091,10,26101,0,5.98354e+18,169.509,1915.29,26101,158,165,15481,6208,5311,6746,6359
28681,3040,6770,0,28681,0,28681,6.46516e+17,97.6549,9167.81,28681,3269,110,21911,21911,17056,14175,10814
3891,105,254,0,3891,3777,114,4.06678e+16,19.2706,663.418,3891,48,26,3637,3629,2883,2952,1502
40992,10,176,40972,20,40992,0,5.99407e+18,172.807,2425.68,40992,172,171,10113,1463,2030,1749,2145
45238,7203,15388,0,45238,16751,28487,2.17546e+15,58.3557,18106.2,45238,7484,72,29850,29850,23463,20255,14810
14315,1,12,13908,407,14306,9,1.39174e+14,10.3346,336.968,14315,12,11,3653,3653,3653,3653,3653
41380,10588,14266,39320,2060,0,41380,1.90707e+18,96.0872,17097.7,41380,6925,110,27114,27114,24167,22905,19429
33214,5028,7787,31276,1938,0,33214,2.2285e+18,97.7687,10474.7,33214,3775,110,25427,25427,22351,21061,17355
49645,9278,11609,46756,2889,0,49645,2.22692e+18,97.9037,15310.6,49645,5633,110,38036,38036,34926,34235,31339
2790,542,1009,2790,0,2628,162,3.48979e+18,88.3448,1330.19,2790,352,70,1781,1781,1306,1504,1217
44084,160,176,44015,69,44084,0,6.05481e+18,173.853,2581.35,44084,170,171,43539,42669,39981,40015,40139
47252,3389,11063,44505,2747,44505,2747,5.76852e+18,97.8776,14620,47252,5365,110,36189,36189,31577,30111,12774
13592,207,4941,5081,8511,0,13592,8.26818e+12,56.0338,5961.32,13592,2398,72,8651,8532,4774,8000,406
35268,997,19250,34048,1220,0,35268,1.32553e+18,91.0291,21139.5,35268,9337,110,16018,15176,9216,7647,2232
12726,1,11,12359,367,12725,1,1.50359e+14,10.2848,322.716,12726,11,11,2986,2986,2986,2986,2986
20241,253,6495,19193,1048,0,20241,1.98229e+18,96.0367,8172.77,20241,3140,110,13746,13488,5962,3954,1668
16621,780,6214,6243,10378,0,16621,8.07318e+12,57.4854,7394.36,16621,3004,72,10407,10359,5855,8665,1805
32026,371,1276,0,32026,31095,931,4.06863e+16,257.307,4061.75,32026,204,26,30731,30052,27329,24930,12947
21801,3996,5123,0,21801,0,21801,6.48432e+17,97.5697,7069.84,21801,2471,110,16678,16678,15148,13980,13565
37945,1,12,36863,1082,37927,18,1.3882e+14,10.3575,554.041,37945,12,11,9723,9723,9723,9723,9723
36463,3935,10110,34463,2000,34463,2000,6.52682e+18,97.1008,12881.1,36463,4898,110,26353,26353,25064,25067,10809
23358,1264,7644,22149,1209,22149,1209,3.66237e+18,96.7834,9470.63,23358,3649,111,15714,15714,6969,9822,2949
28511,2234,10885,10768,17743,0,28511,7.98272e+12,57.6685,12664.1,28511,5302,72,17626,17626,11269,16536,3697
18053,2764,4235,0,18053,6344,11709,2.52897e+15,59.8866,5704.87,18053,2056,72,13818,13818,12018,11694,9137
21064,55,1182,0,21064,20440,624,4.63565e+16,257.173,3474.69,21064,183,26,19356,19240,11972,12042,2531
35511,13,14,34473,1038,35483,28,1.66788e+14,10.3692,573.867,35511,13,12,35497,35497,35412,35413,35345
8711,1921,3035,0,8711,0,8711,5.6221e+17,93.2598,3908.66,8711,1454,105,5676,5676,4936,4711,4423
5943,2985,2990,5713,230,0,5943,1.48429e+18,87.6843,3538.59,5943,1428,79,2953,2953,2953,2953,2953
20705,747,933,0,20705,20105,600,3.9911e+16,188.38,2742.33,20705,133,26,19772,19772,19444,19399,17890
25901,5568,7532,0,25901,9355,16546,2.34323e+15,59.0867,9368.69,25901,3668,72,18369,18369,17072,15307,15047
13521,817,3239,12733,788,12733,788,5.89758e+18,97.1712,4590.31,13521,1553,110,10282,10282,9596,9107,3293
6751,1524,1635,0,6751,0,6751,6.53994e+17,96.1496,2443.3,6751,777,97,5116,5116,5005,5052,5016
47849,4,15,46451,1398,47783,66,1.65865e+14,10.4265,745.294,47849,13,11,41849,37327,30180,31240,19865
26135,44,61,26071,64,26135,0,2.26938e+18,60.7283,1196.27,26135,61,61,23853,14641,19090,20076,18707
48770,11138,11686,45932,2838,45932,2838,3.32837e+18,98.3655,15230.4,48770,5532,111,37084,37084,36184,36312,36061
23391,220,1014,0,23391,22711,680,4.01522e+16,210.999,3056.71,23391,151,26,22207,21992,16588,16169,7302
10315,2561,4009,3907,6408,0,10315,7.90413e+12,57.2194,4817.3,10315,1940,72,6306,6306,5524,6169,4741
19303,8,11,18753,550,19295,8,1.3882e+14,10.2418,389.085,19303,11,11,18829,18560,14450,14563,14946
9660,190,702,0,9660,9378,282,4.33987e+16,28.1652,1717.5,9660,89,26,8958,8945,7850,7423,2625
7209,709,2452,7209,0,6787,422,4.29177e+18,91.7252,3032.17,7209,869,106,4757,4757,2748,3522,1710
46555,25,61,46427,128,46555,0,2.32989e+18,60.8049,1606.32,46555,61,61,29608,5040,15236,16018,18587
4214,46,170,4214,0,4214,0,5.98677e+18,151.69,765.228,4214,96,96,2552,1196,943,1129,1140
2305,77,630,2173,132,2173,132,5.77519e+18,91.6564,994.02,2305,276,60,1339,431,1110,975,252
6184,1,10,6008,176,6184,0,1.38189e+14,9.92755,216.929,6184,10,10,1590,1590,1590,1590,1590
8331,438,735,0,8331,8082,249,4.84103e+16,61.1983,1760.9,8331,93,26,7596,7547,7170,6981,4721
16078,2467,6527,15342,736,15342,736,3.51328e+18,95.2448,7788.86,16078,3119,111,9551,9551,6996,8006,3701
13548,2393,3207,4770,8778,0,13548,9.90378e+12,59.7575,4378.58,13548,1555,72,10341,10341,9347,10131,7867
18072,2854,5775,0,18072,0,18072,5.78969e+17,96.1138,7319.08,18072,2795,110,12297,12297,10152,9655,6821
17977,11397,11650,3876,14101,0,17977,2.23302e+13,5.50909,13389.2,17977,3885,13,6327,6327,6295,6327,6213
34911,9756,13018,0,34911,13130,21781,2.07577e+15,57.8247,15128.4,34911,6340,72,21893,21893,19319,17463,15153
23802,1,14,23104,698,23719,83,1.71212e+14,10.585,510.585,23802,13,12,4651,4651,4651,4651,4651
14207,8,11,13803,404,14201,6,1.38826e+14,10.5252,332.389,14207,11,11,13900,13550,10869,10893,11737
24416,4702,6117,23014,1402,23014,1402,2.61156e+18,97.4735,8168.29,24416,2880,111,18299,18299,15631,16359,15067
34034,9564,11477,34034,0,32094,1940,3.78095e+18,232.74,13007.3,34034,4325,125,22557,22557,21130,21788,20231
15449,2172,3692,14550,899,0,15449,2.22694e+18,97.2297,5184.27,15449,1776,110,11757,11757,9770,9403,7649
25919,13046,16863,25229,690,0,25919,1.0241e+18,89.5582,18094.8,25919,8174,110,9056,9056,8145,7889,7645
45311,5704,10556,42667,2644,0,45311,2.23132e+18,97.9026,13999.1,45311,5123,110,34755,34755,28153,26896,20052
32977,10692,13028,0,32977,12524,20453,1.99758e+15,57.2927,14990.1,32977,6327,72,19949,19949,18761,18468,16937
22369,6012,7157,0,22369,0,22369,5.77232e+17,96.2064,8970.14,22369,3460,110,15212,15212,14418,13535,13906
49375,330,13326,0,49375,17674,31701,2.40708e+15,59.4796,16501.4,49375,6477,72,36049,35857,11585,9157,1579
45059,11926,18600,17275,27784,0,45059,7.57656e+12,57.2335,21064.5,45059,9061,72,26459,26459,22089,25709,16919
47059,1625,16804,44739,2320,44739,2320,4.44095e+18,96.5553,19822.2,47059,8053,111,30255,30255,18668,16999,5463
14974,4388,5513,0,14974,0,14974,5.36479e+17,95.0998,6784.86,14974,2657,110,9461,9461,8208,7249,7202
21394,2732,5418,20164,1230,20164,1230,5.69533e+18,97.8933,7266.79,21394,2566,111,15976,15976,11295,12143,9411
36001,2270,8387,0,36001,12649,23352,2.53528e+15,60.0618,10935.8,36001,4085,72,27614,27614,18647,7277,7711
10727,53,4109,0,10727,4038,6689,2.04701e+15,57.2972,4944.59,10727,1994,72,5927,2198,3700,1229,160
44981,1506,19359,44981,0,43009,1972,4.61588e+18,1834.07,22011.3,44981,4916,142,24694,22432,10383,15082,3288
48931,13491,16290,0,48931,18061,30870,2.19936e+15,58.4729,19214.1,48931,7924,72,32641,32641,30871,28398,28044
22748,6,12,22099,649,22736,12,1.38696e+14,10.53,427.968,22748,12,11,21596,21129,15980,16135,14112
8733,1108,2485,8253,480,8253,480,3.1179e+18,95.8456,3421.11,8733,1179,106,6248,6248,4490,5547,2540
31213,1096,1160,0,31213,30311,902,3.9008e+16,244.881,3702.59,31213,180,26,30053,30053,30012,29995,29767
27877,10759,14040,27877,0,20487,7390,5.04188e+18,439.869,15401.4,27877,4588,133,13837,13714,12958,13813,11223
16169,120,176,16160,9,16169,0,6.03845e+18,168.679,1558.07,16169,139,145,15145,13784,10876,11049,11176
29498,2151,8099,0,29498,0,29498,6.14457e+17,97.0456,10452.4,29498,3918,110,21399,21399,13455,8639,7823
4863,713,1738,4863,0,4585,278,3.39677e+18,90.7066,2190.61,4863,627,92,3125,3125,2052,2571,1701
37231,691,1079,0,37231,36169,1062,3.55304e+16,225.495,3624.82,37231,164,26,36152,35819,34358,34555,27307
11724,2126,6656,11334,390,11334,390,1.06822e+19,89.4255,7463.79,11724,3202,103,5068,5068,4118,4728,1326
2764,471,1170,2764,0,2622,142,5.72423e+18,79.1454,1482.16,2764,451,64,1594,1594,1090,1378,534
24335,9,12,23639,696,24324,11,1.45416e+14,10.1126,445.091,24335,11,11,24038,23698,19216,19347,20425
14605,3433,3459,5135,9470,0,14605,9.86566e+12,59.7558,4699.21,14605,1681,72,11146,11146,11126,11139,11134
10652,1381,2562,3748,6904,0,10652,9.83313e+12,59.5279,3533.19,10652,1242,72,8090,8090,6430,7807,4647
37794,8,15,36685,1109,37704,90,1.71429e+14,10.4164,646.136,37794,14,12,37103,36580,34202,31232,24050
41883,11018,12155,39623,2260,0,41883,2.06571e+18,96.9548,15197.3,41883,5902,110,29728,29728,28536,28055,26839
17375,6622,9383,17302,73,15689,1686,4.01482e+18,189.551,10261.7,17375,4175,123,7992,7949,6309,6974,5403
30166,7304,10195,28646,1520,28646,1520,2.9814e+18,96.0885,12428.7,30166,4941,110,19971,19971,17638,19348,14019
37126,4336,14613,0,37126,14100,23026,2.00659e+15,57.4884,16772,37126,7112,72,22513,22465,13967,14744,11664
6387,841,2873,6114,273,0,6387,1.64019e+18,92.8134,3491.35,6387,1380,86,3514,3428,2807,2604,2527
32635,4658,7670,0,32635,0,32635,6.47487e+17,97.7311,10322.9,32635,3714,110,24965,24965,21612,22502,16115
33156,1491,7786,31226,1930,0,33156,2.22767e+18,97.7351,10472.1,33156,3764,110,25370,25370,12298,11317,6360
39493,486,19740,37991,1502,0,39493,1.45863e+18,93.6007,21955.6,39493,9592,110,19753,18245,10681,4740,1875
25711,119,176,25647,64,25711,0,6.17379e+18,160.512,1965.94,25711,140,147,24582,22982,17060,17405,17467
38966,15051,20240,15659,23307,0,38966,6.18977e+12,55.2167,22107.4,38966,9838,72,18726,18726,16508,18346,14024
47711,8743,20048,0,47711,0,47711,4.89946e+17,94.9213,22927,47711,9735,110,27663,27663,21588,18007,12541
47890,9608,11146,45099,2791,45099,2791,5.87206e+18,97.9121,14747.4,47890,5408,110,36744,36744,36354,36354,32306
35841,7978,13138,34111,1730,0,35841,1.84578e+18,95.7056,15601.9,35841,6382,110,22703,22703,19537,18909,16260
22997,60,274,22995,2,22997,0,5.65679e+18,206.768,1138.91,22997,269,31,22155,21993,9534,13509,8155
34904,8759,11341,0,34904,0,34904,5.70849e+17,96.3378,13880.1,34904,5500,110,23563,23563,22030,20946,20817
17469,2008,4247,16452,1017,16452,1017,1.3921e+18,97.809,5851.98,17469,1990,111,13222,13222,10109,11912,7105
34806,1949,11305,0,34806,12796,22010,2.23609e+15,58.5897,13539.1,34806,5507,72,23501,23501,13807,8733,5158
4922,279,1211,4632,290,0,4922,2.24437e+18,95.5217,1855.17,4922,567,86,3711,3711,2451,2182,1222
44943,131,1318,0,44943,43655,1288,3.67559e+16,268.381,4535.15,44943,212,26,43109,42875,34899,34020,8427
42335,8692,9840,14866,27469,0,42335,9.89292e+12,60.0773,12754.2,42335,4789,72,32495,32495,31104,32205,28930
30739,3774,8684,0,30739,0,30739,6.07457e+17,96.9518,11093.3,30739,4208,110,22055,22055,16496,9987,9893
4563,73,165,0,4563,4482,81,2.56931e+16,3.73044,661.819,4563,85,4,4398,4398,4281,4237,2942
41057,13371,15839,0,41057,0,41057,5.20536e+17,95.4518,18513.9,41057,7692,110,25218,25218,23008,21686,20674
44847,135,176,44757,90,44847,0,6.02664e+18,173.955,2589.39,44847,171,173,43183,40310,33847,34597,34249
39685,6450,9319,37375,2310,0,39685,2.22611e+18,97.8448,12413.5,39685,4521,110,30366,30366,27163,25916,21946
13102,2892,3146,12342,760,12342,760,5.78399e+18,97.0696,4468.43,13102,1510,110,9956,9956,9807,9788,9509
35466,967,8320,33405,2061,0,35466,2.22646e+18,97.7603,11156.1,35466,4025,110,27146,27146,10701,9464,4741
24275,97,5716,0,24275,8538,15737,2.52557e+15,59.9352,7568.55,24275,2778,72,18559,16945,4598,415,577
35595,4142,8709,33553,2042,33553,2042,6.06753e+18,97.6104,11523.6,35595,4218,110,26886,26886,25865,25866,14585
25565,6023,6048,24078,1487,0,25565,2.22444e+18,97.6094,8240.95,25565,2927,110,19517,19517,19504,19506,19516
44967,1012,1224,0,44967,43685,1282,3.55793e+16,253.36,4255.29,44967,194,26,43743,43743,43123,43104,39420
29919,5427,7157,28176,1743,28176,1743,3.4876e+18,98.1831,9578.41,29919,3374,111,22762,22762,20974,22632,17942
10436,313,2483,9823,613,9823,613,5.71284e+18,96.8509,3598.35,10436,1185,110,7953,7953,6197,4954,1556
29145,515,8303,0,29145,0,29145,6.05982e+17,96.9491,10610.4,29145,4022,110,20842,20670,9629,2808,3006
20753,855,979,0,20753,20147,606,4.11867e+16,204.702,2883.38,20753,145,26,19774,19774,19564,19540,18322
35966,3451,20396,14754,21212,0,35966,5.58836e+12,53.6579,22009.3,35966,9915,72,15570,15570,9697,14570,2808
10927,1647,2611,0,10927,3838,7089,2.53004e+15,59.6413,3601.82,10927,1270,72,8316,8316,6898,5623,5325
30147,186,9133,0,30147,10973,19174,2.30287e+15,58.9114,11178,30147,4443,72,21014,20804,6568,955,915
41952,1738,1760,0,41952,8740,33212,1.50004e+16,11.995,2432.15,41952,1756,13,40192,40192,40017,39896,40109
5232,709,1247,0,5232,1842,3390,2.54852e+15,59.203,1820.24,5232,602,72,3985,3985,3199,3073,2436
7411,2239,3403,2899,4512,0,7411,7.10426e+12,42.0287,3979.76,7411,1651,72,4008,4008,2580,3708,361
18677,778,9580,0,18677,0,18677,4.14227e+17,92.9798,10813.9,18677,4639,110,9097,8667,4997,877,1578
12348,516,2990,11636,712,11636,712,5.79679e+18,96.8919,4250.15,12348,1429,110,9358,9358,7644,6389,2248
14275,8,11,13852,423,14266,9,1.78586e+14,10.0885,351.801,14275,11,11,14022,13888,13439,13274,11111
35790,1598,8388,0,35790,0,35790,6.46913e+17,97.7826,11245.5,35790,4053,110,27402,27402,13253,9153,6801
43482,1186,1467,0,43482,42225,1257,3.90697e+16,280.884,4929.15,43482,239,26,42015,42015,41365,41345,37527
48896,15284,18737,37618,11278,46586,2310,5.5635e+18,95.8499,21749.8,48896,8989,111,30159,30159,28025,30021,25016
19727,7,10,19163,564,19721,6,1.39361e+14,9.96016,388.861,19727,10,10,19031,18475,17237,17199,15108
3804,912,984,3576,228,3576,228,3.44901e+18,95.0089,1504.76,3804,448,79,2820,2820,2764,2814,2781
23870,13204,15472,0,23870,5151,18719,5.71924e+15,5.51521,17765.5,23870,5160,13,8398,8398,8078,8082,7334
21646,4203,6701,21646,0,20379,1267,4.67409e+18,156.777,7998.45,21646,1426,127,14945,14945,13527,14504,9809
31442,13056,13246,30061,1381,0,31442,1.68718e+18,94.7399,15324.9,31442,6421,110,18196,18196,18031,18012,18055
14621,30,32,14589,32,14621,0,1.11696e+18,31.93,684.012,14621,32,32,13649,0,12767,13222,13649
33488,5099,7852,0,33488,0,33488,6.48159e+17,97.7709,10562.6,33488,3802,110,25636,25636,22581,17990,17608
19914,2257,4689,18754,1160,18754,1160,5.87622e+18,97.5337,6506.79,19914,2265,110,15225,15225,14625,14625,8204
5069,144,1486,4789,280,0,5069,2.10493e+18,94.1699,2114.3,5069,699,85,3583,3414,2083,1801,600
45327,12,176,45244,83,45327,0,5.98152e+18,169.836,2520.07,45327,171,172,12807,1959,2548,2909,2756
44151,2520,10609,41583,2568,41583,2568,2.01676e+18,98.3257,13883.3,44151,5021,111,33542,33542,19350,24667,9658
36074,126,176,35997,77,36074,0,5.98943e+18,170.644,2271.21,36074,170,168,34223,31359,25849,25896,26106
20157,4449,6393,7381,12776,0,20157,8.84729e+12,58.6085,7854.75,20157,3114,72,13764,13764,12488,13544,11167
42382,3249,9953,39922,2460,39922,2460,5.76828e+18,97.8308,13215.8,42382,4826,110,32429,32429,28414,27684,12103
10435,1,11,10136,299,10428,7,1.39321e+14,10.4145,283.7,10435,11,11,2661,2661,2661,2661,2661
37472,7920,17229,35930,1542,0,37472,1.57677e+18,94.2345,19483.1,37472,8370,110,20243,20243,16128,14538,10094
21450,4,12,20836,614,21442,8,1.42509e+14,10.2794,417.33,21450,12,11,18675,16602,16308,16550,10451
40139,34315,40139,40139,0,40139,0,8.79587e+12,0,40139,40139,40139,1,0,0,0,0,0
31313,247,7296,0,31313,0,31313,6.49924e+17,97.7834,9870.52,31313,3534,110,24017,24017,14366,3221,2305
3741,93,1129,0,3741,1347,2394,2.32476e+15,55.1957,1552.67,3741,527,66,2612,2312,1506,207,329
49191,22891,49191,0,49191,0,49191,524277,0,49191,49191,49191,1,0,0,0,0,0
4249,201,1078,3999,250,3999,250,1.878e+18,95.6305,1649.66,4249,500,82,3171,3171,1306,1616,1003
42569,1105,1177,0,42569,41356,1213,3.55218e+16,243.973,4051.81,42569,184,26,41392,41392,41192,41178,40057
7520,1850,3055,7177,343,0,7520,1.7578e+18,89.077,3789.59,7520,1450,100,4465,4465,4210,4007,4062
34613,3345,8115,32601,2012,32601,2012,5.75282e+18,97.7685,10896.5,34613,3922,110,26498,26498,23613,23140,12028
48826,3218,11376,17165,31661,0,48826,9.89083e+12,60.0862,14649,48826,5541,72,37450,37450,25555,35394,11004
41372,5961,14898,39362,2010,39362,2010,7.58559e+18,95.8341,17679.6,41372,7231,110,26474,26474,23546,23070,11815
20232,3112,4769,19052,1180,0,20232,2.23103e+18,97.48,6604.64,20232,2301,110,15463,15463,13669,12952,10918
6929,8,14,6720,209,6886,43,2.13879e+14,10.2223,264.523,6929,12,11,6840,6780,6510,3929,3496
48277,5293,17842,0,48277,18136,30141,2.08052e+15,57.9088,20604.2,48277,8686,72,30435,30435,20486,14357,8466
11784,9,11,11447,337,11777,7,1.39233e+14,10.3664,304.56,11784,11,11,11622,11442,11056,11055,10399
35597,108,176,35582,15,35597,0,5.98975e+18,170.653,2250.22,35597,171,169,32554,23333,20268,21248,21758
25550,6455,15736,24800,750,24800,750,1.13423e+19,89.6231,17044.9,25550,7625,110,9814,9814,8638,8442,4212
29111,756,1367,0,29111,28257,854,4.40895e+16,270.597,4248.32,29111,219,26,27744,27744,24875,25553,19544
11260,56,170,11196,64,11260,0,5.97666e+18,162.642,1249.65,11260,132,134,7543,3854,3180,3736,3607
18114,2464,4279,17054,1060,0,18114,2.23416e+18,97.4653,5963.41,18114,2066,110,13835,13835,11754,11029,8526
39184,8068,9154,36904,2280,36904,2280,5.75761e+18,97.8567,12225.7,39184,4442,110,30030,30030,29376,29274,27078
47075,13903,17448,44807,2268,44807,2268,2.98618e+18,95.2283,20417.6,47075,8353,111,29627,29627,27439,29484,24284
15893,2047,3745,0,15893,5594,10299,2.52614e+15,59.8055,5073.49,15893,1817,72,12148,12148,10082,7269,6754
47195,14870,17946,44975,2220,44975,2220,8.06014e+18,95.5462,20953.9,47195,8715,110,29249,29249,28809,28809,24261
37708,116,1087,0,37708,36633,1075,3.55243e+16,226.393,3661.7,37708,166,26,36332,36150,29152,29734,9642
9250,1533,2174,3243,6007,0,9250,9.91553e+12,59.5757,3051.46,9250,1053,72,7076,7076,6131,6906,5157
27331,13964,14170,27331,0,27331,0,1.83e+17,17.9737,14633.7,27331,12737,20,13161,13161,12969,12957,13018
1738,28,170,1738,0,1738,0,5.91187e+18,124.59,489.697,1738,72,64,819,208,244,303,306
43509,75,176,43417,92,43509,0,6.05315e+18,173.803,2567.76,43509,169,173,34915,22420,17274,18687,18410
12692,2897,4617,4757,7935,0,12692,8.25222e+12,56.6346,5587.61,12692,2244,72,8075,8075,7161,7917,6293
23565,4948,15578,22955,610,0,23565,9.96271e+17,87.6226,16701.8,23565,7554,110,7987,7987,6017,4956,3480
37957,2,15,36859,1098,37873,84,1.56878e+14,10.3581,595.264,37957,13,13,22163,16470,13770,16602,11366
20563,8222,9904,20563,0,19653,910,4.96226e+18,177.321,10915.9,20563,4243,125,10659,10659,9662,10267,8601
39198,3860,9152,0,39198,0,39198,6.484e+17,97.8602,12223.3,39198,4435,110,30046,30046,22847,14246,13971
1950,210,255,0,1950,1892,58,5.60571e+16,17.4667,564.882,1950,44,25,1695,1695,1643,1646,1442
13973,3032,4611,13253,720,13253,720,4.97409e+18,94.4788,5857.3,13973,2172,111,9362,9362,7274,7600,6853
30377,5516,7101,10676,19701,0,30377,9.89651e+12,60.0076,9319.52,30377,3458,72,23276,23276,21431,22886,18473
4287,5,7,4151,136,4279,8,2.74187e+14,6.13319,151.206,4287,7,7,4045,3721,3929,3732,3110
9913,4980,5300,9554,359,9554,359,1.00435e+19,92.1792,6051.46,9913,2563,102,4613,4613,4556,4548,4530
49505,1364,11858,46620,2885,46620,2885,4.369e+18,98.3763,15443.1,49505,5617,111,37647,37647,18815,23119,6638
46655,10060,11134,43935,2720,43935,2720,4.55043e+18,98.3529,14559.2,46655,5269,111,35521,35521,34433,35442,32760
32291,102,1526,0,32291,31341,950,4.49403e+16,285.846,4793.18,32291,253,26,29998,29679,19728,19624,5114
4264,1949,2182,1694,2570,0,4264,6.50597e+12,54.5429,2539.47,4264,1058,63,2082,2082,1749,2022,1522
41442,13473,13843,39342,2100,0,41442,1.93836e+18,96.1115,16713.5,41442,6709,110,27599,27599,27389,27246,27298
38145,5502,13485,0,38145,14226,23919,2.13162e+15,57.7436,15814,38145,6555,72,24660,24660,18252,10221,10554
16659,10,12,16184,475,16651,8,1.40493e+14,10.2813,365.213,16659,12,11,16600,16542,14450,14499,14803
3406,2639,3186,0,3406,1064,2342,2.36644e+15,3.94011,3211.93,3406,1078,9,220,220,183,184,190
15816,2,11,15367,449,15810,6,1.3894e+14,10.2599,352.235,15816,11,11,9157,6487,6185,6578,5411
35901,14,15,34838,1063,35825,76,1.80359e+14,10.4371,654.731,35901,13,12,35886,35886,35651,35652,34719
38513,9630,18864,0,38513,8450,30063,1.33838e+13,8.99408,19273.6,38513,16975,11,19649,19649,12311,13217,11423
19687,5255,6475,19687,0,18539,1148,4.38121e+18,147.838,7549.94,19687,1552,127,13212,13212,12804,13212,11183
26607,7476,12211,0,26607,0,26607,4.60182e+17,94.0939,13948.5,26607,5930,110,14396,14396,11971,11223,8107
38556,3725,10974,36446,2110,36446,2110,2.30304e+18,96.1841,13786.4,38556,5205,111,27582,27582,18664,22645,11113
42848,1908,20404,41138,1710,41138,1710,9.3111e+18,93.1507,22846.5,42848,9914,110,22444,22444,18220,15856,3450
40656,9172,9478,38286,2370,38286,2370,5.74827e+18,97.8852,12640.6,40656,4593,110,31178,31178,30990,30968,30568
20464,4591,4827,19274,1190,19274,1190,3.34709e+18,97.4923,6679.26,20464,2317,110,15637,15637,15218,15410,15217
40807,16180,22243,0,40807,16594,24213,1.50242e+15,54.0211,24099.2,40807,10813,72,18564,18564,16173,15071,12302
43492,464,10397,40960,2532,40960,2532,5.36927e+18,98.3326,13638.9,43492,4909,120,33095,33095,13141,20505,3534
2087,465,591,1965,122,1965,122,5.47201e+18,91.5237,922.932,2087,251,59,1496,1496,1307,1363,1366
26880,8292,11657,10402,16478,0,26880,7.32961e+12,56.8276,13240.1,26880,5679,72,15223,15223,13479,14923,11590
23072,8015,9783,0,23072,0,23072,4.88893e+17,91.6997,11421.7,23072,4727,110,13289,13289,12831,12240,12366
39532,77,176,39508,24,39532,0,6.04052e+18,172.92,2439.57,39532,167,171,32025,20311,16076,17372,16961
21569,3926,8176,20549,1020,0,21569,1.81265e+18,95.2526,9824.56,21569,3958,110,13393,13393,10035,9210,6310
49798,13630,19056,49798,0,47506,2292,4.4828e+18,2353.85,22379,49798,7960,146,30742,28571,27342,28972,23833
15956,1989,5016,15956,0,15033,923,4.33239e+18,131.713,6069.46,15956,1319,124,10940,10889,7996,9064,4828
47962,13320,13898,45372,2590,45372,2590,6.57314e+18,97.0075,17290.1,47962,6746,110,34064,34064,33762,33716,32901
46387,114,1615,0,46387,45044,1343,3.99939e+16,296.819,5439.92,46387,272,26,43948,43630,30615,28564,10206
34468,5970,15997,34468,0,32909,1559,5.16596e+18,250.956,17498.8,34468,4031,141,18471,18172,13420,14324,9761
3171,108,779,0,3171,1110,2061,2.57067e+15,58.5307,1172.61,3171,378,62,2392,2392,1410,818,386
14353,1417,3397,0,14353,5038,9315,2.52453e+15,59.7688,4623.07,14353,1650,72,10956,10956,8028,5535,4574
13498,1942,3199,0,13498,4741,8757,2.52868e+15,59.728,4366.47,13498,1555,72,10299,10299,8860,8084,6601
43609,2093,12802,0,43609,15799,27810,2.33312e+15,58.5448,15590,43609,6230,72,30807,30807,14282,7613,4445
14484,2348,5347,0,14484,0,14484,5.37955e+17,95.1684,6585.72,14484,2586,110,9137,9137,6507,4182,3413
10726,1429,2531,10096,630,10096,630,5.6978e+18,97.0422,3673.77,10726,1210,110,8195,8195,7523,7421,5148
27321,511,10430,26032,1289,0,27321,1.80332e+18,94.0972,12393.2,27321,5045,110,16891,16461,6972,5492,2485
4439,779,1118,4179,260,0,4439,2.24212e+18,94.8313,1709.97,4439,515,83,3321,3321,2971,2865,2665
19028,1092,4491,17918,1110,0,19028,2.23167e+18,97.4834,6243.63,19028,2162,110,14537,14537,7868,7280,4432
2671,791,1112,2671,0,2531,140,6.26094e+18,89.5814,1419.33,2671,426,64,1559,1559,1349,1472,1216
14917,1317,3533,0,14917,5246,9671,2.51901e+15,59.7447,4794.98,14917,1715,72,11384,11384,7563,6654,4265
46800,5282,14493,44330,2470,44330,2470,2.4277e+18,97.2585,17674.9,46800,6911,111,32307,32307,16058,22669,14728
19087,1244,5569,18047,1040,18047,1040,1.35008e+18,97.1963,7202.49,19087,2640,111,13518,13518,13393,13392,4589
34557,184,8638,32587,1970,32587,1970,5.96767e+18,97.5422,11373.3,34557,4181,110,25919,25597,18819,13772,2228
17587,4935,5756,6471,11116,0,17587,8.69182e+12,58.3065,7060.02,17587,2787,72,11831,11831,11216,11701,10379
19536,1960,4572,0,19536,6870,12666,2.53725e+15,59.9155,6133.25,19536,2220,72,14964,14964,11128,9302,6751
39973,126,176,39883,90,39973,0,6.03257e+18,173.17,2444.38,39973,171,170,38001,34818,28584,28603,28516
14888,624,3559,14025,863,0,14888,2.22546e+18,97.1845,5011.98,14888,1709,110,11329,11329,5173,4664,2724
15761,3143,8025,0,15761,0,15761,4.21375e+17,93.0048,9116.97,15761,3889,110,7736,7736,6001,4658,3909
30289,116,208,30206,83,30289,0,6.01855e+18,201.208,2259.85,30289,169,175,27674,25062,15935,16883,17000
7449,1725,1759,2606,4843,0,7449,9.91851e+12,59.4394,2504.44,7449,853,72,5690,5690,5656,5680,5656
11325,1403,4341,4264,7061,0,11325,7.97402e+12,55.2164,5212.65,11325,2093,72,6984,6984,3482,6022,1502
22097,405,1222,4540,17557,0,22097,5.77977e+13,11.9906,1703.12,22097,916,14,20875,20875,14845,10830,18173
26002,485,6151,24492,1510,24492,1510,5.77381e+18,97.6174,8373.39,26002,2965,110,19851,19851,15134,11700,2781
18044,171,176,18032,12,18044,0,5.99303e+18,167.556,1624.44,18044,145,154,17854,17810,17498,17545,17543
45229,115,176,45138,91,45229,0,6.02832e+18,173.206,2599.15,45229,172,173,42052,37888,28345,29209,29697
46362,97,176,46301,61,46362,0,6.04304e+18,173.954,2643.92,46362,172,173,41186,27805,23833,25125,25666
24514,104,176,24487,27,24514,0,6.13921e+18,171.584,1936.82,24514,153,152,22333,17128,13870,14301,14564
34653,6740,8109,0,34653,0,34653,6.48847e+17,97.8204,10894.2,34653,3931,110,26544,26544,24679,23620,22643
7071,2290,3164,7071,0,6721,350,6.24054e+18,81.4066,3680.9,7071,1264,103,3907,3907,3352,3710,2739
2705,78,175,2705,0,2705,0,6.05358e+18,141.647,622.118,2705,80,79,2066,1195,1111,1206,1212
20615,1952,9224,19745,870,19745,870,2.69685e+18,94.1455,10683.1,20615,4470,110,11391,11391,4832,7226,3050
17405,64,175,17398,7,17405,0,5.98443e+18,165.655,1562.6,17405,151,149,12462,6777,5588,6508,6377
17883,5,13,17362,521,17809,74,1.58091e+14,10.8171,427.822,17883,12,12,16545,15029,12494,12336,8743
19528,58,176,19473,55,19528,0,6.16156e+18,168.461,1724.99,19528,134,135,15286,10356,6569,6429,6468
10673,378,453,0,10673,10371,302,3.53841e+16,20.0617,1272.18,10673,64,26,10220,10220,9958,9970,9089
34361,6014,8045,0,34361,0,34361,6.47892e+17,97.8132,10814.6,34361,3897,110,26316,26316,23996,22182,20339
31657,2580,10528,30047,1610,0,31657,1.94505e+18,96.2159,12859.1,31657,5110,110,21129,21129,12188,10458,5874
27123,2216,13904,27123,0,27123,0,2.90643e+18,17.9198,14369,27123,12506,20,13219,13219,2308,1834,1890
36713,149,176,36698,15,36713,0,5.98081e+18,169.78,2269.42,36713,166,170,35932,34302,31347,31396,31125
11557,1534,3987,10977,580,10977,580,3.07043e+18,88.6779,5068.35,11557,1902,110,7570,7570,5394,6264,4944
26178,5727,10636,24991,1187,24991,1187,8.39927e+18,94.9843,12480.1,26178,5162,110,15542,15542,14845,14845,7351
31405,2415,7389,0,31405,0,31405,6.46857e+17,97.7214,9964.29,31405,3576,110,24016,24016,17326,8553,9187
43367,8825,16129,0,43367,0,43367,5.31314e+17,95.6825,18971.7,43367,7830,110,27238,27238,19718,13662,10585
16609,1213,4356,0,16609,5919,10690,2.45201e+15,59.4305,5688.09,16609,2122,72,12253,12253,8574,5377,4229
8256,149,463,0,8256,8018,238,3.88567e+16,19.1367,1209.84,8256,65,26,7793,7793,6744,6773,2069
4754,621,1139,1663,3091,0,4754,1.00028e+13,59.0564,1672.22,4754,553,71,3615,3615,2993,3485,2133
24757,5023,10145,0,24757,9470,15287,1.94953e+15,56.3874,11681.6,24757,4919,72,14612,14612,11789,9733,7180
8941,674,694,0,8941,8679,262,4.44225e+16,19.4506,1668.42,8941,87,26,8247,8247,8217,8215,8073
2205,1328,1856,1313,892,2173,32,3.66436e+18,58.2327,1968.53,2205,866,43,349,349,154,159,302
769,147,158,769,0,769,0,5.90179e+18,92.5241,321.142,769,50,42,611,596,595,599,601
23660,109,176,23647,13,23660,0,6.00633e+18,171.704,1857.63,23660,159,158,21658,17158,13669,14316,14494
49437,14,19,47965,1472,49299,138,1.89461e+14,10.4942,846.065,49437,15,13,49418,49418,47471,47515,44945
32336,1168,11160,32336,0,30522,1814,3.77828e+18,240.243,12646.4,32336,3952,130,21176,20833,11054,14742,3180
31031,14442,14924,31031,0,29733,1298,4.63516e+18,459.481,16565.3,31031,6932,132,16107,16107,15957,16072,15442
11981,128,508,0,11981,11640,341,3.55747e+16,20.1059,1423.99,11981,71,26,11473,11473,10059,10119,4338
48459,18,176,48399,60,48459,0,6.03106e+18,173.461,2689.83,48459,174,173,18101,3266,4942,4749,4686
16841,2989,15741,0,16841,0,16841,6.03856e+17,3.98432,15803.5,16841,5258,9,1100,1100,204,204,211
47392,12999,16158,0,47392,17565,29827,2.17442e+15,58.3778,18982,47392,7868,72,31234,31234,28840,25824,26144
44596,4445,12002,0,44596,15966,28630,2.4115e+15,59.4981,14925.2,44596,5840,72,32594,32594,23464,17904,12354
996,35,323,0,996,0,996,6.5191e+17,83.8404,507.715,996,133,45,337,52,183,142,99
15944,5,6,15676,268,15912,32,9.88446e+13,3.99561,279.692,15944,5,4,15938,15938,15938,15937,15375
43397,117,176,43319,78,43397,0,5.98073e+18,171.978,2468.79,43397,173,172,40512,36637,27882,28679,29095
17446,1586,7874,16716,730,16716,730,9.03219e+18,93.9406,9157.88,17446,3808,110,9572,9572,4938,8675,1607
49054,39781,49054,49054,0,49054,0,8.79591e+12,0,49054,49054,49054,1,0,0,0,0,0
44375,12,14,43110,1265,44296,79,1.38749e+14,10.4407,636.487,44375,13,12,44360,44352,44214,44195,43839
4284,188,1479,4284,0,4033,251,4.76745e+18,90.3737,1903.06,4284,310,87,2805,2805,2144,2452,679
36035,12,13,34993,1042,36014,21,1.5502e+14,10.3338,562.7,36035,12,12,36022,36022,35835,35836,35397
47741,13089,18994,0,47741,0,47741,5.09643e+17,94.3893,21959.9,47741,9229,110,28747,28747,26231,24931,22226
8184,449,2062,7706,478,7706,478,2.40922e+18,96.9839,2973.13,8184,966,107,6122,6122,3376,4236,1671
514,71,224,484,30,484,30,3.26095e+18,69.1887,319.744,514,83,37,224,84,112,164,133
40646,15532,22527,39266,1380,39266,1380,2.28225e+18,92.7568,24598.2,40646,10945,110,18119,18119,15757,17688,14165
7901,1026,1996,7441,460,7441,460,1.95468e+18,96.846,2884.74,7901,927,102,5905,5905,4600,5110,3425
843,94,160,795,48,843,0,5.99027e+18,92.0902,336.156,843,51,43,648,423,452,461,488
25900,3813,8794,17824,8076,24590,1310,3.07168e+18,96.5753,10743.9,25900,4202,111,17106,17106,13635,15907,9179
48946,5588,11449,46097,2849,0,48946,2.2269e+18,97.904,15109.2,48946,5549,110,37497,37497,30859,28128,19608
38451,192,1111,0,38451,37354,1097,3.57112e+16,234.506,3758.8,38451,171,26,37142,36840,30998,30978,12477
7204,85,309,0,7204,7000,204,3.53086e+16,19.9187,887.198,7204,53,26,6895,6895,6039,6111,2658
36691,7845,8741,34569,2122,0,36691,2.21682e+18,97.727,11642.1,36691,4235,110,27950,27950,26936,26569,25572
36797,12,176,36781,16,36797,0,5.98431e+18,172.344,2274.83,36797,171,169,10398,1605,2062,2368,2178
31047,5009,7306,0,31047,0,31047,6.46845e+17,97.7123,9858.85,31047,3535,110,23741,23741,21213,21722,17160
13190,1880,6989,0,13190,0,13190,3.46431e+15,17.7548,7301.28,13190,6278,20,6201,6201,1752,5097,1646
44124,3162,3216,8905,35219,0,44124,5.67294e+13,12.0027,3901.31,44124,1653,20,40908,40908,40671,40568,40780
30326,676,951,0,30326,29465,861,3.5575e+16,188.395,3067.52,30326,139,26,29375,29066,28244,28335,23784
34842,8,16,33797,1045,34773,69,1.96714e+14,10.2541,657.714,34842,13,11,34353,33992,31960,27309,20075
8907,8,378,0,8907,8656,251,3.53695e+16,19.9471,1075.65,8907,59,26,7615,6973,4901,5074,1421
19257,717,4512,6770,12487,0,19257,9.90761e+12,59.9173,6052.63,19257,2197,72,14745,14745,9227,13787,2585
2192,636,1316,2119,73,2119,73,2.36056e+18,81.9891,1543.43,2192,603,50,876,790,599,665,805
18965,5489,10396,18965,0,0,18965,8.91707e+17,17.9073,10763.7,18965,9340,20,8569,8569,4801,7111,4761
46390,10453,10857,43690,2700,43690,2700,3.35158e+18,97.8813,14363.7,46390,5263,110,35533,35533,34781,35127,34682
31209,770,7463,29388,1821,29388,1821,1.42212e+18,98.2245,9962.94,31209,3519,111,23746,23746,8512,9531,3909
12638,2735,4044,12638,0,11901,737,5.57483e+18,104.543,4942.57,12638,1527,120,8594,8583,7661,8156,6210
11131,2,176,11122,9,11131,0,6.06581e+18,157.897,1300.36,11131,123,128,598,14,41,16,66
47150,104,176,47054,96,47150,0,6.07843e+18,173.495,2685.13,47150,171,174,42723,30833,26284,27235,27729
33508,1326,8724,0,33508,11935,21573,2.43956e+15,59.6047,11062.5,33508,4243,72,24784,24784,10704,6963,4505
29343,2160,10049,27874,1469,27874,1469,2.95793e+18,95.9939,12221.3,29343,4864,110,19294,19294,13479,14664,4974
28010,274,1119,0,28010,27199,811,3.98105e+16,252.814,3493.49,28010,172,26,26775,26381,19478,19565,7854
41903,7556,17987,41903,0,40243,1660,4.76834e+18,2591.59,21252.2,41903,7799,146,23916,20920,16253,20093,12966
31889,380,1066,0,31889,30976,913,3.70942e+16,218.696,3447.36,31889,162,26,30813,30378,27767,26876,16923
5795,1307,1523,5464,331,5464,331,2.36456e+18,95.8359,2229.77,5795,697,92,4272,4272,4272,4255,3974
48117,909,19176,48117,0,46367,1750,4.87307e+18,4357.48,24081.9,48117,7890,154,22897,19182,10718,14678,1741
32606,1231,9933,0,32606,11876,20730,2.29808e+15,58.8959,12102.8,32606,4838,72,22673,22673,14416,4060,4419
14848,1222,5738,14848,0,14078,770,5.25395e+18,136.169,6694.52,14848,1581,126,9110,9027,6971,7024,2554
10461,3816,4055,0,10461,0,10461,5.21417e+17,94.43,5011.35,10461,1944,108,6406,6406,6194,6277,6204
43278,8490,12412,40935,2343,0,43278,2.0749e+18,97.0207,15548.6,43278,6022,110,30866,30866,27584,26151,22243
9439,4,11,9162,277,9432,7,1.68038e+14,10.305,284.927,9439,11,11,8247,7326,7085,5195,4532
29764,5393,13816,28546,1218,28546,1218,2.59591e+18,93.1673,15696.1,29764,6692,110,15948,15948,12150,13751,7064
31200,1,13,30309,891,31127,73,1.38951e+14,10.6782,544.608,31200,13,12,7985,7985,7985,7985,7985
46334,990,11439,43684,2650,0,46334,2.18898e+18,97.6993,14899,46334,5550,110,34895,34895,21729,19725,5363
9981,3965,6080,9981,0,9648,333,4.7898e+18,143.327,6634.2,9981,2294,102,3901,3901,3383,3641,2817
9244,1186,4091,6091,3153,8844,400,3.08791e+18,86.9932,4900.81,9244,1932,107,5153,5153,3209,3422,882
22127,329,692,0,22127,21436,691,0.0312288,0.968726,3912.83,22127,692,1,21435,21435,21435,21435,21435
22134,4604,5163,0,22134,7776,14358,2.53411e+15,59.965,6889.65,22134,2510,72,16971,16971,16174,15872,15370
41879,13440,14100,39749,2130,39749,2130,2.36111e+18,96.8577,16925.9,41879,6748,111,27779,27779,27699,27506,26223
41280,7807,18972,0,41280,16159,25121,1.78017e+15,56.4399,21118.9,41280,9226,72,22308,22308,15728,7981,7852
38042,30468,35550,0,38042,0,38042,6.04384e+17,3.9959,35645.9,38042,11870,9,2492,2492,2136,2136,2142
43187,3758,16544,43187,0,40997,2190,4.55725e+18,425.481,18668.4,43187,3885,138,26643,26224,17249,19023,7714
38823,1029,1840,0,38823,37674,1149,4.61879e+16,308.49,5890.98,38823,317,26,36983,36983,35227,35019,25500
22504,1074,1390,0,22504,0,22504,3.76248e+18,15.9857,1943.92,22504,930,18,21114,21114,18251,17593,17728
16738,9,12,16261,477,16731,7,1.38854e+14,10.4931,365.735,16738,12,11,16507,16263,15804,15805,13666
26514,394,883,0,26514,25757,757,3.55994e+16,160.922,2757.72,26514,125,26,25631,25405,23188,23310,15636
37049,27,61,36985,64,37049,0,2.25411e+18,60.8041,1433,37049,61,61,24739,3424,14112,15726,16105
18760,87,735,0,18760,18224,536,3.55333e+16,63.2253,2101.43,18760,96,26,18025,17976,14683,15058,5204
42169,7,14,40964,1205,42088,81,1.39019e+14,10.5792,634.471,42169,13,12,40683,39656,30582,30599,26097
45819,9566,10684,0,45819,16104,29715,2.53371e+15,60.0745,13789,45819,5205,72,35135,35135,33764,32530,31627
34317,102,206,34302,15,34130,187,5.98372e+18,186.047,2280.5,34317,176,176,30556,19006,16427,17570,17435
17764,716,6614,6673,11091,0,17764,8.1271e+12,57.6621,7854.4,17764,3213,72,11150,11057,5834,9176,1623
17871,6325,10714,17321,550,17321,550,7.36418e+18,88.8231,11738,17871,5165,116,7157,7157,6232,7157,5196
19346,6858,7948,18474,872,0,19346,1.72612e+18,94.398,9405.66,19346,3848,110,11398,11398,10750,10570,10482
45692,7843,10712,0,45692,0,45692,6.46597e+17,97.8439,14174.9,45692,5187,110,34980,34980,31800,32288,26618
47408,3066,11723,0,47408,16784,30624,2.48247e+15,59.8462,14870.2,47408,5701,72,35685,35685,19443,10959,8999
41918,4321,17088,16018,25900,0,41918,7.63785e+12,57.2454,19428,41918,8305,72,24830,24830,17006,23490,7597
16425,795,961,0,16425,15942,483,4.48359e+16,182.681,2698.38,16425,139,26,15464,15464,15328,15282,14596
48365,1032,1796,0,48365,46960,1405,4.15138e+16,302.283,6021,48365,307,26,46569,46569,41804,42547,30698
2045,169,534,0,2045,717,1328,2.51621e+15,57.1061,816.141,2045,256,56,1511,1511,993,680,534
17130,3895,4167,16131,999,16131,999,1.95798e+18,97.8035,5748.35,17130,1953,111,12963,12963,12928,12854,12481
10582,471,511,0,10582,10279,303,3.70434e+16,20.0386,1382.8,10582,70,26,10071,10071,9997,10000,9561
20106,4300,4745,0,20106,0,20106,6.47743e+17,97.4933,6572.33,20106,2282,110,15361,15361,14800,14592,14392
33745,3334,14378,32267,1478,32267,1478,8.539e+18,94.7731,16557.9,33745,6985,110,19367,19367,17406,17281,6022
44178,3438,11793,0,44178,15797,28381,2.4179e+15,59.5261,14697.8,44178,5740,72,32385,32385,22043,16833,9435
12213,179,3086,0,12213,0,12213,6.37974e+17,96.8145,4323.05,12213,1484,110,9127,8964,5449,536,1206
8480,842,2992,8051,429,0,8480,1.91655e+18,94.8561,3840.6,8480,1437,105,5488,5411,3514,3786,3071
14206,573,864,13626,580,4309,9897,1.34168e+18,16.9841,1317.49,14206,558,27,13342,13342,12426,12504,10433
47513,15,16,46108,1405,47439,74,1.76801e+14,10.3468,760.504,47513,13,12,47497,47497,47268,47269,46526
10192,85,3077,3695,6497,0,10192,9.09581e+12,58.5846,3956.91,10192,1496,72,7115,6140,4007,6580,343
2439,711,880,2439,0,2291,148,4.00551e+18,88.344,1175.33,2439,311,64,1559,1559,1428,1479,1461
8787,4918,5267,3651,5136,0,8787,5.21912e+12,32.208,5793.78,8787,2556,71,3520,3520,3030,3430,2601
17122,1488,7804,16412,710,0,17122,1.59451e+18,93.8537,9062.19,17122,3767,110,9318,9232,5811,5119,2015
31884,10126,11184,0,31884,0,31884,5.51585e+17,95.9248,13475.9,31884,5429,110,20700,20700,19438,17757,18361
15334,281,3621,0,15334,5386,9948,2.5237e+15,59.7831,4911.59,15334,1759,72,11713,11713,6868,835,1055
9840,146,640,9840,0,9440,400,2.92316e+18,18.3585,1021.61,9840,416,29,9200,9199,7013,7504,4263
48751,571,13169,46048,2703,0,48751,2.1226e+18,97.3355,16679.7,48751,6395,110,35582,35324,14098,9840,4070
49529,13644,15739,49529,0,46643,2886,3.92955e+18,337.22,17764.3,49529,5240,133,33790,33790,32887,33574,30321
3755,135,231,0,3755,3647,108,3.95309e+16,18.5675,611.017,3755,43,26,3524,3524,2981,3021,1890
8800,60,2849,0,8800,3218,5582,2.25224e+15,58.1753,3619.67,8800,1385,72,5643,2645,3332,2497,191
42520,137,1176,0,42520,41307,1213,3.55238e+16,243.829,4046.94,42520,184,26,40992,40768,27038,26974,11073
13607,1022,4472,12907,700,12907,700,7.20399e+18,95.7002,5707.78,13607,2156,110,9135,9049,2565,8303,3094
27889,11235,27889,27889,0,0,27889,7.99971,0,27889,27889,27889,1,0,0,0,0,0
22245,1331,6132,0,22245,7986,14259,2.39122e+15,59.2529,7788.51,22245,2979,72,16113,16113,9173,6748,4651
49449,9,14,48040,1409,49366,83,1.38896e+14,10.4794,685.992,49449,14,12,48774,48056,46369,45955,40420
32621,6920,18456,31541,1080,0,32621,1.26841e+18,90.3606,20176.7,32621,8955,110,14165,14165,10257,9283,6703
26009,6,12,25265,744,26004,5,1.40115e+14,10.0891,452.776,26009,11,12,24755,24003,21618,21491,15260
37549,8512,16829,35969,1580,35969,1580,8.88054e+18,94.3922,19126.2,37549,8174,110,20720,20720,18694,18356,10701
40443,6461,9503,38086,2357,38086,2357,5.89175e+18,97.8395,12641.6,40443,4611,110,30940,30940,30183,30183,21990
46080,1471,1991,0,46080,44724,1356,4.47154e+16,321.403,6533.46,46080,345,26,44089,44089,43145,43200,37856
44915,3,17,43587,1328,44844,71,1.76412e+14,10.4345,736.245,44915,14,12,34895,26852,21241,24427,12919
10299,1361,4681,9862,437,9862,437,3.65928e+18,92.1437,5539.16,10299,2232,101,5618,5531,4028,3420,2085
24496,11,12,23799,697,24487,9,1.39152e+14,10.2435,441.154,24496,12,11,24484,24484,24441,24442,24415
27854,7079,11531,0,27854,0,27854,4.9819e+17,94.8658,13441.1,27854,5599,110,16323,16323,13644,11528,11031
4790,1180,1453,4530,260,4530,260,3.24591e+18,94.5029,2050.6,4790,683,85,3337,3337,2900,3086,2945
45319,5379,10791,15971,29348,0,45319,9.82545e+12,59.9958,13851.8,45319,5256,72,34528,34528,27130,33251,18175
19891,7342,8172,7617,12274,0,19891,7.59989e+12,57.0338,9465.78,19891,3965,72,11719,11719,11011,11599,10378
15707,1624,3693,0,15707,5530,10177,2.53292e+15,59.8695,5009.57,15707,1799,72,12014,12014,9075,5454,5619
6619,641,1563,2317,4302,0,6619,1.00068e+13,59.3914,2244.52,6619,760,72,5056,5056,3700,4816,2202
38549,499,1183,0,38549,37959,590,2.46311e+16,3.73685,4562.09,38549,594,4,37366,37366,36166,35870,24730
33534,12003,16571,33534,0,0,33534,8.77451e+17,17.9794,17100.3,33534,14905,20,16963,16963,12434,13354,12267
39250,9,206,39231,19,39250,0,5.98751e+18,195.418,2430.46,39250,178,175,8944,1076,1458,1457,1634
45863,9907,13799,45863,0,43186,2677,4.0588e+18,318.256,16044.4,45863,5442,129,32064,32064,27660,29398,24219
39394,9,15,38220,1174,39327,67,1.85259e+14,10.3704,693.19,39394,13,11,39030,38679,34637,34578,28011
39928,7321,13282,39928,0,37705,2223,3.94463e+18,254.019,15251.6,39928,5377,128,26646,26522,20836,22922,16347
41241,131,1491,0,41241,40045,1196,4.01759e+16,281.967,4937.93,41241,244,26,39110,38768,32505,28702,9782
19953,1361,6622,19953,0,18793,1160,5.4443e+18,150.336,7703.94,19953,2409,123,13331,13234,8266,10429,3164
7162,1658,1729,6742,420,6742,420,5.83226e+18,96.2802,2575,7162,819,99,5433,5433,5413,5415,5392
21234,7,11,20625,609,21222,12,1.43018e+14,10.1953,411.66,21234,11,11,20482,19957,15858,15895,16047
706,22,48,0,706,689,17,3.4702e+16,16.8357,134.167,706,20,23,657,617,497,511,413
41782,4513,9709,0,41782,14688,27094,2.53229e+15,60.069,12593.3,41782,4722,72,32073,32073,24489,17929,15262
47534,10683,19890,18263,29271,0,47534,7.50366e+12,56.9486,22442.5,47534,9673,72,27644,27644,21049,26514,13192
31292,11,14,30401,891,31218,74,1.38948e+14,10.5204,521.284,31292,14,12,31276,31271,30823,30822,30545
25584,125,175,25570,14,25584,0,5.98263e+18,166.851,1891.73,25584,158,162,24213,22218,18259,18210,18338
39972,13717,20934,0,39972,8685,31287,1.35057e+13,8.99272,21335.6,39972,18834,11,19038,19038,13766,14320,13230
44386,652,17507,44386,0,42124,2262,4.78811e+18,429.37,19402.7,44386,5773,138,26879,25509,11525,16846,1774
47572,8018,11617,44841,2731,44841,2731,6.04849e+18,97.7261,15156.8,47572,5637,110,35955,35955,35145,35145,26417
2329,569,633,1673,656,2190,139,4.81195e+18,93.0064,997.57,2329,288,62,1696,1696,1696,1696,1668
16013,81,176,15998,15,16013,0,6.09256e+18,169.658,1567.36,16013,136,137,13377,9316,7114,7340,7340
17127,9612,9652,17127,0,16497,630,5.41879e+18,226.004,10512.1,17127,2298,129,7475,7475,7475,7475,7475
26726,6966,10292,25461,1265,25461,1265,7.55141e+18,95.9201,12178.9,26726,4933,111,16434,16434,11022,13338,11009
38092,589,10682,0,38092,0,38092,6.09269e+17,97.0833,13536.2,38092,5182,110,27410,27238,11101,2828,3605
29489,247,1009,0,29489,28644,845,3.6961e+16,206.826,3214.69,29489,150,26,28337,28102,20887,20442,9414
29724,1551,10670,29724,0,28084,1640,5.34034e+18,205.213,12053,29724,4110,128,19054,18779,10844,14446,3915
5082,993,1319,4792,290,0,5082,2.19557e+18,95.1911,1970.67,5082,610,86,3763,3763,3360,3314,3129
19132,3813,7272,18224,908,18224,908,7.99813e+18,91.6086,8775.47,19132,3518,110,11860,11860,11422,11422,6940
31007,4765,9775,0,31007,0,31007,5.79178e+17,96.4206,12116.1,31007,4729,110,21232,21232,16707,13560,11521
11069,210,3108,3974,7095,0,11069,9.30926e+12,58.4121,4067.38,11069,1509,72,7961,7923,1969,6042,296
15611,1395,3726,0,15611,0,15611,6.46484e+17,97.2474,5230.66,15611,1787,110,11885,11885,8785,5925,5211
11905,464,512,0,11905,11565,340,3.56203e+16,20.0215,1423.17,11905,70,26,11393,11393,11304,11307,10751
36092,2100,8453,33992,2100,0,36092,2.22723e+18,97.7952,11327.8,36092,4094,110,27639,27639,19029,17640,8405
6407,1429,3146,0,6407,0,6407,4.45887e+17,91.3576,3730.64,6407,1514,83,3261,3261,2097,869,1124
12212,57,3350,0,12212,0,12212,6.19796e+17,92.687,4560.1,12212,1597,110,5690,1426,2430,269,834
12262,128,176,12254,8,12262,0,6.08457e+18,168.085,1369.93,12262,127,132,11606,10759,8885,8871,8951
47804,8,13,46444,1360,47777,27,1.38953e+14,10.3044,624.864,47804,12,12,46666,45907,35852,35950,38999
34873,6437,10168,32983,1890,32983,1890,5.53588e+18,97.4581,12750,34873,4846,117,24705,24705,23484,23889,16288
32011,3224,9465,0,32011,11608,20403,2.32724e+15,59.0194,11628.2,32011,4605,72,22546,22546,16481,8808,9226
44581,1996,2183,0,44581,43256,1325,4.77933e+16,328.693,7049.11,44581,383,26,42398,42398,42222,42210,41190
40642,76,176,40566,76,40642,0,6.14849e+18,173.708,2491.54,40642,164,166,33906,25274,17261,17669,17233
24271,10527,12666,24271,0,23301,970,5.18301e+18,295.553,13826.9,24271,2978,131,11605,11582,10704,11429,9683
10300,419,3072,9740,560,9740,560,1.60991e+18,96.4849,4101.71,10300,1451,111,7228,7141,3532,3566,1880
23900,2586,6630,8579,15321,0,23900,9.30981e+12,59.26,8381.5,23900,3219,72,17270,17270,12780,16500,7440
46469,12048,43425,0,46469,15165,31304,2.16522e+15,4.7545,43609.2,46469,15106,48,3044,3044,841,977,848
45633,11433,22324,0,45633,18108,27525,1.68654e+15,55.6425,24549.9,45633,10868,72,23309,23309,19864,15105,14194
5246,1566,1705,4973,273,4973,273,3.19643e+18,86.7274,2326.67,5246,799,85,3541,3541,3541,3541,3541
39935,12181,12780,39935,0,37609,2326,4.85954e+18,282.943,14514.4,39935,3099,134,27155,27155,27155,27155,26395
6268,176,1548,2210,4058,0,6268,9.88981e+12,59.186,2193.76,6268,753,72,4720,4710,1672,3861,626
43892,60,176,43804,88,43892,0,6.03528e+18,173.226,2560.05,43892,174,173,31150,17839,13242,15274,14939
3650,1256,2372,0,3650,779,2871,5.65863e+15,5.39671,2742.84,3650,789,13,1278,1278,1117,1126,758
711,10,11,691,20,707,4,1.38956e+14,9.70042,74.6712,711,11,11,696,690,681,682,656
44963,220,14356,16487,28476,0,44963,8.7639e+12,58.6951,17132.4,44963,6981,72,30607,30223,17351,28327,1181
32456,27663,30331,0,32456,10108,22348,2.36033e+15,3.99387,30419.3,32456,10140,9,2125,2125,1940,1940,1946
21302,1983,9367,21302,0,20302,1000,5.37124e+18,184.362,10542.4,21302,3634,128,11935,11700,7848,9520,3132
26542,10776,16068,0,26542,0,26542,3.35508e+17,87.6697,17441.6,26542,7787,110,10474,10474,9280,8739,8589
46715,16534,18228,46715,0,44312,2403,4.75712e+18,421.831,20169.2,46715,5960,138,28487,28487,28364,28479,27426
36173,491,1158,0,36173,35596,577,2.49163e+16,3.73635,4461.07,36173,581,4,35015,35015,33868,33577,22704
37620,1581,8863,35436,2184,35436,2184,5.91111e+18,97.7731,11829,37620,4295,110,28757,28757,26279,24398,6571
19775,2,14,19197,578,19729,46,1.68202e+14,10.5851,449.466,19775,13,11,11693,8970,6334,6661,5668
35807,3758,8342,0,35807,12583,23224,2.53785e+15,60.0542,10878.1,35807,4064,72,27465,27465,21086,14478,12659
39201,15518,19209,0,39201,8600,30601,1.33705e+13,8.98944,19622.2,39201,17282,11,19992,19992,17070,17429,16730
45128,443,1226,0,45128,43843,1285,3.55769e+16,253.623,4265.98,45128,194,26,43902,43264,38421,38754,22578
1674,285,494,1582,92,0,1674,2.19893e+18,88.58,775.241,1674,209,52,1180,1180,946,937,858
11546,10,11,11211,335,11541,5,1.59875e+14,10.3006,311.816,11546,11,11,11499,11462,11217,11218,11007
15959,6642,9872,15489,470,15489,470,7.8362e+18,91.9779,10781.4,15959,4757,106,6087,6000,6087,5958,5496
39187,13570,15393,0,39187,0,39187,5.14604e+17,95.3123,17948.3,39187,7475,110,23794,23794,21299,17879,18468
44863,58,176,44780,83,44863,0,5.98553e+18,171.968,2509.77,44863,171,172,30669,15956,12591,14919,14534
10098,3090,5126,10098,0,9659,439,3.89897e+18,126.764,5742.99,10098,2202,112,4972,4908,3914,4354,3775
14886,2559,4979,0,14886,0,14886,5.65199e+17,95.1833,6292.41,14886,2396,110,9907,9907,8466,6315,6302
18096,720,8453,18096,0,17286,810,4.00081e+18,159.352,9474.95,18096,3688,123,9643,9192,5079,6742,1647
38831,13665,18407,37277,1554,0,38831,1.53334e+18,94.0105,20677.4,38831,8945,110,20424,20424,18914,18035,16698
3348,5,11,3252,96,3348,0,1.38299e+14,10.6798,161.049,3348,11,11,3091,2783,2221,2278,1983
33180,886,1366,0,33180,32214,966,4.17361e+16,270.231,4360.83,33180,222,26,31814,31814,30470,30380,23996
11562,47,175,11556,6,11562,0,5.98593e+18,163.056,1274.26,11562,131,136,7133,3365,2624,3308,3070
14154,984,3391,13332,822,0,14154,2.22603e+18,97.1474,4788.87,14154,1629,110,10763,10763,7535,6946,3815
35532,989,1539,0,35532,34488,1044,4.33457e+16,289.694,4924.39,35532,254,26,33993,33993,32854,32428,26530
19158,1865,6646,18198,960,18198,960,4.08026e+18,96.2845,8189.04,19158,3170,111,12512,12512,6550,7968,3923
9666,1190,2275,3394,6272,0,9666,9.84088e+12,59.535,3183.87,9666,1093,72,7391,7391,6093,7121,4062
47958,6061,16059,17717,30241,0,47958,8.57067e+12,58.4538,18928.8,47958,7818,72,31899,31899,23743,30499,13964
41155,4187,9908,38765,2390,38765,2390,5.86239e+18,98.2841,13007.5,41155,4683,111,31247,31247,23042,26004,14660
16732,172,176,16687,45,16732,0,6.12278e+18,167.497,1601.79,16732,137,144,16537,16497,16201,16217,16214
24567,494,5767,23136,1431,23136,1431,3.35857e+18,97.6047,7898.11,24567,2773,110,18800,18800,8125,12963,2738
20586,276,885,0,20586,19993,593,3.87626e+16,162.306,2599.69,20586,126,26,19701,19471,15397,15441,8808
23759,906,5589,22379,1380,22379,1380,3.35198e+18,97.5569,7666.99,23759,2691,110,18170,18170,8722,12998,4020
38525,6686,9229,36282,2243,36282,2243,5.50629e+18,98.2991,12176.2,38525,4371,111,29296,29296,24470,25504,22036
3763,1484,1677,0,3763,1454,2309,1.84908e+15,46.334,2037.28,3763,795,62,2086,2086,2086,2076,2086
3756,218,913,0,3756,1316,2440,2.54676e+15,58.7167,1361.92,3756,439,65,2843,2843,1389,983,777
13984,4604,6509,13404,580,13404,580,6.57986e+18,92.5154,7564.89,13984,3110,111,7475,7475,6609,7418,5583
26322,3831,9893,25072,1250,0,26322,1.81962e+18,95.4071,11817.2,26322,4794,110,16429,16429,12087,11153,7285
40118,8987,9330,14103,26015,0,40118,9.89272e+12,60.0668,12117.2,40118,4539,72,30788,30788,30377,30700,29890
18680,394,735,0,18680,18148,532,3.55659e+16,62.5098,2097.44,18680,96,26,17945,17897,16886,16952,11529
29064,6051,6762,0,29064,10205,18859,2.52837e+15,59.9938,8908.8,29064,3281,72,22302,22302,21281,20918,20193
23160,2771,11559,22270,890,22270,890,3.82373e+18,94.0663,13017.7,23160,5566,111,11601,11514,9798,10143,9349
10815,4692,6112,4427,6388,0,10815,5.67986e+12,54.4104,6756.72,10815,2973,72,4703,4703,4072,4594,3565
35860,1239,15354,0,35860,0,35860,4.84234e+17,93.3924,17636.4,35860,7439,110,20506,20506,11971,5143,2504
46671,9020,10867,0,46671,0,46671,6.48723e+17,97.9078,14393.9,46671,5270,110,35804,35804,33688,32328,30385
48400,3967,11261,0,48400,0,48400,6.48546e+17,97.9138,14894.2,48400,5462,110,37139,37139,27147,17507,14646
6910,1537,1700,2434,4476,0,6910,9.83173e+12,59.174,2396.89,6910,819,72,5210,5210,5007,5170,4891
43575,6138,11115,41107,2468,41107,2468,6.06074e+18,97.5422,14378.6,43575,5395,110,32460,32460,29811,29378,19224
22379,4,11,21740,639,22369,10,1.39247e+14,10.1901,419.346,22379,11,11,19423,17225,17354,15487,10640
19556,761,831,0,19556,0,19556,3.84088e+18,15.9832,1351.73,19556,825,17,18725,18725,17862,18053,18321
29976,5718,6989,28226,1750,28226,1750,3.22148e+18,97.7624,9478.89,29976,3383,110,22987,22987,21704,22603,19404
13320,4814,6972,5350,7970,0,13320,6.18447e+12,52.1564,7782.21,13320,3376,72,6348,6348,5644,6228,5026
28528,2032,15586,28528,0,27538,990,4.94873e+18,621.156,17210.4,28528,4383,132,12942,11615,6416,7975,1934
10668,2387,2528,0,10668,3750,6918,2.52704e+15,59.4639,3507.99,10668,1209,72,8140,8140,8046,8096,8003
44864,9048,10502,0,44864,0,44864,6.4756e+17,97.889,13919.7,44864,5092,110,34362,34362,32797,30484,30444
2112,286,1005,2022,90,2022,90,3.35292e+18,66.3991,1275.15,2112,462,54,1107,1107,951,1094,851
43533,4833,10167,15309,28224,0,43533,9.88393e+12,60.0619,13141.1,43533,4952,72,33366,33366,25671,32038,16341
36913,3522,11861,36913,0,34763,2150,4.02245e+18,260.167,13499.2,36913,3392,132,25052,24663,15474,18828,8418
46806,6812,14554,44356,2450,44356,2450,6.8551e+18,96.6168,17804.7,46806,7071,110,32252,32252,29468,29004,18342
49695,322,17880,18581,31114,0,49695,8.23708e+12,57.8919,20744.9,49695,8696,72,31815,31741,17842,23153,587
13938,3598,6107,13330,608,13330,608,3.32661e+18,89.3399,7199.21,13938,2907,111,7831,7831,6666,7765,5664
35306,11328,15529,33788,1518,33788,1518,3.16162e+18,95.2111,17703.4,35306,7470,111,19777,19777,13574,14410,10511
45095,9779,10568,42475,2620,0,45095,2.2259e+18,97.8609,13997.4,45095,5124,110,34527,34527,33466,33296,32468
17992,39,175,17987,5,17992,0,5.98533e+18,165.588,1587.61,17992,153,151,10199,3229,3382,4208,3991
5787,1418,1578,2070,3717,0,5787,9.44132e+12,57.0909,2176.5,5787,754,72,4209,4209,4013,4174,3896
6976,2669,3320,6689,287,6689,287,2.02197e+18,87.6499,3950.76,6976,1562,93,3656,3656,3656,3656,3502
15495,4509,4510,14652,843,14652,843,2.55635e+18,96.9371,5909.07,15495,2131,111,10985,10985,10984,10984,10985
31609,358,1144,0,31609,30700,909,3.85718e+16,241.183,3666,31609,175,26,30433,29926,23697,24202,14434
38916,18559,23256,0,38916,16185,22731,1.32961e+15,52.2636,24878.8,38916,11307,72,15660,15660,14560,14141,13433
44766,10455,18166,44766,0,42673,2093,5.10253e+18,1228.71,20684.4,44766,7969,143,26600,25517,20561,22844,17412
15089,3384,3612,0,15089,0,15089,6.45499e+17,97.1494,5078.37,15089,1728,110,11477,11477,11214,11218,11113
1594,229,464,1496,98,1496,98,4.28327e+18,89.5885,732.211,1594,202,54,1130,1130,863,1036,737
31244,5399,13092,12004,19240,0,31244,7.50195e+12,57.0567,14909.3,31244,6375,72,18152,18152,13253,16831,7831
32408,3882,15677,0,32408,0,32408,4.38209e+17,93.7942,17625.1,32408,7617,110,16731,16731,10944,7915,5101
25372,11428,14766,0,25372,0,25372,3.55367e+17,91.7137,16152.4,25372,7153,110,10606,10606,9946,9209,9195
13646,2482,3810,4899,8747,0,13646,9.335e+12,59.0312,4935.82,13646,1847,72,9836,9836,8017,9524,5937
37644,2493,13272,14027,23617,0,37644,8.34711e+12,58.0734,15580.3,37644,6447,72,24372,24372,14414,21072,5064
12321,1202,4179,11692,629,11692,629,3.9816e+18,96.0238,5300.14,12321,1980,111,8142,8142,6367,6846,4293
24980,47,1029,0,24980,24257,723,3.95884e+16,204.461,3150.13,24980,155,26,23592,23508,19103,16578,4748
5987,104,176,5982,5,5987,0,6.13819e+18,149.693,957.761,5987,100,98,5352,4105,3601,3666,3808
34976,143,176,34962,14,34976,0,5.98312e+18,169.761,2215.41,34976,167,170,33996,31802,28894,28921,28850
33196,1705,13806,31718,1478,31718,1478,8.5436e+18,94.9067,15988.5,33196,6701,110,19390,19304,13497,17312,6426
31629,4463,8230,11274,20355,0,31629,9.54513e+12,59.5981,10459.2,31629,4003,72,23399,23399,19489,22580,13028
4592,1022,1169,0,4592,1625,2967,2.48572e+15,58.2334,1683.32,4592,555,70,3423,3423,3371,3348,3353
26341,44,176,26268,73,26341,0,6.00269e+18,171.277,1957.25,26341,163,161,15964,6712,5561,6869,6560
26556,527,884,0,26556,25799,757,3.56001e+16,161.954,2763.87,26556,125,26,25672,25444,22358,22794,18470
6126,2703,3038,3953,2173,5886,240,3.82413e+18,64.6082,3599.09,6126,1439,82,3088,3088,3088,3088,3088
32437,1,12,31513,924,32420,17,1.38928e+14,10.3207,510.27,32437,12,11,8308,8308,8308,8308,8308
15085,36,176,15019,66,15085,0,5.99351e+18,166.961,1477.07,15085,145,144,8244,2571,2713,3431,3179
19524,365,6725,0,19524,7232,12292,2.16769e+15,56.4114,8109.03,19524,3255,72,12799,12655,7559,919,1337
47506,967,14335,47506,0,44744,2762,4.58206e+18,329.206,16641.4,47506,5665,132,33171,32536,13533,22187,3146
49327,8044,15357,0,49327,0,49327,5.82579e+17,96.6766,18739.6,49327,7458,110,33970,33970,28022,25223,17991
15974,983,6105,6035,9939,0,15974,7.97479e+12,55.5354,7238.83,15974,2959,72,9869,9821,5926,9189,1255
46321,68,176,46237,84,46321,0,6.01475e+18,173.726,2601.58,46321,171,173,34591,19863,15854,18542,17737
3439,120,166,0,3439,3343,96,3.62069e+16,19.4362,481.374,3439,39,26,3273,3273,3049,3056,2698
32883,7055,7686,0,32883,11552,21331,2.52889e+15,60.0201,10054.3,32883,3739,72,25197,25197,24432,23473,23330
3515,65,165,0,3515,3412,103,3.54856e+16,19.6085,482.104,3515,38,26,3350,3350,3020,3045,1693
3663,737,939,3451,212,3451,212,5.87257e+18,94.0925,1454.23,3663,436,76,2724,2724,2674,2674,2396
2881,921,977,1054,1827,0,2881,8.84212e+12,51.0767,1312.07,2881,459,59,1904,1904,1904,1904,1904
554,9,156,554,0,554,0,6.18603e+18,67.7437,281.805,554,44,33,123,24,21,29,22
39900,4594,9676,37600,2300,37600,2300,6.01323e+18,97.7209,12759.6,39900,4696,110,30224,30224,28994,28994,15389
3168,91,823,2986,182,0,3168,2.22546e+18,93.4504,1285.52,3168,378,71,2107,730,727,677,330
10484,3521,4441,10014,470,0,10484,1.70427e+18,93.9432,5352.41,10484,2144,106,6043,6043,5318,5154,4893
22478,3629,5291,21168,1310,0,22478,2.23022e+18,97.5617,7278.71,22478,2555,110,17187,17187,14919,14586,12389
25593,2143,13303,24644,949,24644,949,5.69624e+18,93.8824,14820.7,25593,6420,111,12290,12290,9367,6880,3763
2872,578,1072,0,2872,1073,1799,2.11956e+15,49.8468,1397.13,2872,515,59,1800,1800,1300,830,640
864,226,373,822,42,822,42,4.64099e+18,71.7373,519.693,864,138,42,491,491,491,491,465
48141,1580,1692,0,48141,46745,1396,4.03568e+16,300.801,5712.85,48141,287,26,46449,46449,46151,46143,44344
5519,1208,1633,5217,302,0,5519,2.10031e+18,94.8248,2296.92,5519,773,87,3886,3886,3326,3256,2943
39214,1643,13186,14496,24718,0,39214,8.56148e+12,58.4228,15615.4,39214,6421,72,26028,26028,16785,24438,5603
20004,2095,4778,18844,1160,0,20004,2.2205e+18,97.4577,6593.63,20004,2301,110,15226,15226,11638,10994,7436
40239,12542,15981,38379,1860,38379,1860,3.79404e+18,95.8878,18526.1,40239,7678,111,24258,24258,22683,24170,21138
20873,47,176,20861,12,20873,0,6.05177e+18,168.982,1775.42,20873,150,155,13483,5878,5063,5920,5581
31496,1149,1421,0,31496,30571,925,4.35695e+16,277.497,4469.4,31496,231,26,30075,30075,29716,29713,28005
7722,3196,4155,0,7722,3114,4608,1.52991e+15,54.6099,4684.66,7722,2011,72,3567,3567,3287,2952,2999
23576,9,176,23563,13,23576,0,6.00337e+18,170.74,1846.55,23576,162,159,5382,689,882,856,1034
31609,3763,7387,11113,20496,0,31609,9.88699e+12,60.0132,9679.68,31609,3592,72,24222,24222,19862,23312,12635
31908,1694,2038,30608,1300,9820,22088,1.76115e+18,16.9893,2719.93,31908,1311,19,29870,29870,29527,29750,26358
30843,8438,10299,11389,19454,0,30843,8.59069e+12,58.3976,12311.2,30843,5009,72,20544,20544,18900,20257,17047
39474,59,1117,0,39474,38348,1126,3.55286e+16,232.231,3801.22,39474,172,26,37918,37850,23779,23579,7875
5250,412,1315,1857,3393,0,5250,9.86645e+12,58.9754,1879.1,5250,639,72,3935,3935,2308,3486,1404
21665,2081,7176,21665,0,20408,1257,3.63846e+18,155.539,8315.57,21665,2617,124,14489,14374,8482,11024,4620
37649,1,13,36566,1083,37626,23,1.50797e+14,10.3008,568.286,37649,12,12,8797,8797,8797,8797,8797
36685,14873,19899,36685,0,36685,0,3.62939e+18,17.982,20421.8,36685,17894,20,16786,16786,12298,16786,12350
34516,3631,14612,32998,1518,0,34516,1.68187e+18,94.8208,16837.3,34516,7100,110,19904,19818,7758,10017,3946
26586,5989,12066,25474,1112,25474,1112,3.75683e+18,94.8148,13788,26586,5794,111,14520,14520,9289,10403,8268
9954,3704,5232,9954,0,6489,3465,3.98348e+18,128.299,5833.95,9954,2243,107,4722,4722,3702,4173,3414
32050,134,176,31973,77,32050,0,5.98773e+18,172.101,2137.41,32050,164,168,30757,28778,24081,24677,24275
38995,3662,11582,36895,2100,36895,2100,3.85946e+18,97.4138,14379.1,38995,5516,111,27413,27413,20088,21608,10040
36701,81,176,36578,123,36701,0,6.1043e+18,172.694,2372.75,36701,164,167,30916,21640,16288,16891,17012
9204,1486,2186,8664,540,8664,540,5.82001e+18,96.7604,3205.98,9204,1047,110,7018,7018,6843,6846,5260
22611,139,208,22563,48,21905,706,6.05267e+18,185.259,1929.6,22611,162,157,21603,20107,15089,15524,14501
34403,1048,1115,0,34403,33417,986,3.70143e+16,229.034,3659.87,34403,172,26,33288,33288,33099,33087,32034
29541,12,14,28689,852,29464,77,1.521e+14,10.4405,528.559,29541,13,12,29526,29521,28657,28657,26557
5797,832,1523,5466,331,5466,331,4.01422e+18,95.8618,2229.94,5797,694,93,4274,4274,2998,3290,2640
41221,884,9670,38821,2400,38821,2400,3.34405e+18,97.873,12861.8,41221,4690,110,31551,31551,13733,21774,4562
3462,6,11,3360,102,3457,5,1.90252e+14,10.7273,174.451,3462,11,11,3292,3146,3020,3093,1870
48587,1,15,47160,1427,48520,67,1.68936e+14,10.3515,755.835,48587,13,11,9682,9682,9682,9682,9682
20916,763,4929,19697,1219,19697,1219,3.23077e+18,97.5188,6810.49,20916,2374,110,15987,15987,8298,11899,3437
49603,23422,24571,19737,29866,0,49603,6.5059e+12,54.0553,26929.7,49603,11947,72,25032,25032,24854,25002,24819
47214,11231,13280,44614,2600,44614,2600,3.55294e+18,92.8685,16585.7,47214,6310,111,33934,33934,33863,33934,28133
34433,855,14251,32885,1548,32885,1548,5.28702e+18,95.5869,16458.7,34433,6843,111,20182,20095,9519,13140,3961
20943,5939,6972,19871,1072,19871,1072,2.22345e+18,95.118,8646.26,20943,3314,111,13971,13971,13966,13954,13965
5761,2114,3433,2387,3374,0,5761,5.3069e+12,52.1514,3823.94,5761,1666,69,2328,2328,2139,2298,2115
27885,6307,6748,26264,1621,26264,1621,2.44051e+18,97.9597,9035.98,27885,3169,111,21137,21137,20698,21104,20198
25204,978,1215,7459,17745,0,25204,6.917e+18,15.9864,1806.45,25204,1053,18,23989,23989,21720,21511,21289
15578,929,1044,3163,12415,0,15578,5.70893e+13,11.9861,1443.51,15578,642,14,14534,14534,13849,13488,14224
2059,8,625,0,2059,0,2059,6.3064e+17,90.9301,948.486,2059,284,58,258,44,29,21,63
18974,3973,6409,18974,0,17884,1090,3.80379e+18,146.08,7453.49,18974,2336,121,12565,12540,9976,11178,8442
34767,15063,19247,0,34767,7489,27278,1.36267e+13,8.94759,19605.1,34767,17314,11,15520,15520,13136,15520,13056
5887,168,170,5882,5,5887,0,6.00275e+18,155.426,902.505,5887,105,108,5711,5653,5659,5638,5650
47257,119,176,47179,78,47257,0,6.14417e+18,173.188,2687.41,47257,170,167,44697,40857,31333,31931,32048
20862,572,4872,7329,13533,0,20862,9.93222e+12,59.9315,6514.34,20862,2373,72,15990,15990,5931,13227,2151
8952,536,3494,8532,420,0,8952,1.79673e+18,90.8199,4346.53,8952,1661,99,5458,5297,3305,2996,1146
31912,26958,29823,29819,2093,29819,2093,1.18247e+18,3.99314,29910.5,31912,9960,9,2089,2089,1888,1888,1895
21015,5270,10073,8287,12728,0,21015,6.70851e+12,54.942,11299.4,21015,4884,72,10942,10942,8831,10582,6500
25185,2405,8454,0,25185,9306,15879,2.19264e+15,58.3557,10162.8,25185,4106,72,16731,16731,10446,6462,5260
35345,6511,8255,0,35345,12425,22920,2.52601e+15,60.0059,10765.5,35345,4016,72,27090,27090,24526,22082,21541
44946,1536,10719,42326,2620,42326,2620,2.33352e+18,98.354,14044.9,44946,5077,111,34227,34227,17234,20783,6932
30123,10503,14858,11971,18152,0,30123,6.54067e+12,54.5632,16448.5,30123,7230,72,15265,15265,12851,14855,10172
16870,4897,5927,16033,837,0,16870,1.89738e+18,95.3605,7342.33,16870,2851,110,10943,10943,9595,9252,8228
29449,12824,19081,26109,3340,26109,3340,7.11499e+16,5.51608,21903.5,29449,6357,13,10368,10368,9496,9496,7414
5085,1927,2046,1939,3146,0,5085,7.84933e+12,55.6293,2517.31,5085,991,72,3039,3039,2889,3010,2832
9000,2674,3906,8603,397,8603,397,3.41891e+18,94.17,4705.83,9000,1856,104,5094,5094,3924,5025,2791
28840,3550,9400,28840,0,27161,1679,4.53003e+18,178.372,10769.6,28840,2027,129,19440,19236,12854,15409,7926
34649,7013,14465,33109,1540,33109,1540,8.4334e+18,94.5442,16713.6,34649,7019,110,20184,20184,18009,17645,9400
11671,5,10,11336,335,11665,6,1.38193e+14,9.921,298.412,11671,10,10,10747,9485,7664,7825,7088
12690,2029,3901,12020,670,0,12690,2.02739e+18,95.9312,5106.06,12690,1869,110,8789,8789,7139,6385,4666
34548,7008,11139,34548,0,32538,2010,4.54339e+18,243.802,12703.1,34548,2317,133,23409,23335,20464,22481,15717
17647,139,176,17634,13,17647,0,5.97958e+18,170.157,1588.44,17647,144,154,16987,15858,13811,14169,14040
13461,405,422,0,13461,13040,421,0.0312755,0.96865,2381.65,13461,422,1,13039,13039,13039,13039,13039
34832,12185,12502,0,34832,13010,21822,2.11384e+15,58.0184,14649.5,34832,6078,72,22330,22330,22002,21668,21641
36180,3463,17308,34740,1440,34740,1440,2.61379e+18,93.9625,19444.3,36180,8411,110,18872,18872,7905,11752,4999
7087,41,2168,0,7087,0,7087,5.96844e+17,95.1675,2955.29,7087,1031,103,2561,494,1588,1168,252
47815,1447,11184,45035,2780,45035,2780,3.22971e+18,97.8913,14779.4,47815,5418,110,36631,36631,18296,26811,6621
30587,12200,12799,29230,1357,29230,1357,2.75915e+18,92.1744,14842.8,30587,6197,110,17788,17788,17640,17768,17766
46004,25,176,45923,81,46004,0,5.99508e+18,172.394,2575.89,46004,172,172,20814,4724,5965,6668,6114
17546,2556,4746,0,17546,6286,11260,2.41613e+15,59.3274,6127.76,17546,2312,72,12800,12800,9680,9976,5999
29522,785,1242,0,29522,6151,23371,1.49994e+16,11.9935,1803.91,29522,1239,13,28280,28280,24193,21031,26458
24056,3030,9426,24056,0,22789,1267,3.98718e+18,153.893,10588.7,24056,3734,124,14630,14468,9247,11786,6016
16609,5,12,16135,474,16601,8,1.38882e+14,10.3261,363.269,16609,12,11,15232,13603,13546,13176,9993
41072,12304,15352,39120,1952,0,41072,1.82341e+18,95.6028,18069.5,41072,7446,110,25720,25720,23827,23336,22209
25438,3491,10580,24308,1130,0,25438,1.70403e+18,91.6649,12363.4,25438,5113,110,14858,14858,9099,9043,4476
2346,301,682,0,2346,841,1505,2.40936e+15,54.8363,988.56,2346,326,56,1664,1664,1114,804,613
30292,7383,11231,0,30292,0,30292,5.32823e+17,93.5229,13388.3,30292,5430,110,19061,19061,16912,15644,13565
3593,6,10,3490,103,3587,6,1.41247e+14,9.84303,166.744,3593,10,10,3418,3325,3007,3007,2338
43138,396,11762,15463,27675,0,43138,9.37083e+12,59.44,14595.2,43138,5724,72,31376,31139,18047,29083,1769
34020,9471,18089,7375,26645,0,34020,5.289e+10,8.98627,18454.9,34020,16275,11,15931,15931,9969,15931,9438
5139,9,10,4991,148,5139,0,1.38245e+14,9.88286,197.744,5139,10,10,5071,4982,4954,4955,4815
44921,3956,10526,42311,2610,42311,2610,3.35371e+18,97.8651,13945.3,44921,5096,110,34395,34395,21134,27029,14458
33300,2809,8624,31410,1890,31410,1890,5.33346e+18,96.7493,11205.1,33300,4091,111,24676,24676,19442,21807,10318
7505,748,1842,2644,4861,0,7505,9.73217e+12,59.2485,2587.25,7505,884,72,5663,5663,4072,5384,2280
9466,2669,4040,9046,420,9046,420,2.25336e+18,75.3953,4879.74,9466,1922,100,5426,5426,5426,5426,5426
27130,4,12,26356,774,27119,11,1.38953e+14,10.211,464.341,27130,12,11,23571,20920,17576,18008,13198
4030,664,967,0,4030,1418,2612,2.58906e+15,58.8953,1438.13,4030,470,67,3063,3063,2623,2362,2284
9391,26,61,9380,11,9391,0,2.26821e+18,60.2903,721.096,9391,61,61,6098,1255,3376,3802,3989
32743,8319,17882,7068,25675,0,32743,53143300000,8.98861,18233.4,32743,16086,11,14861,14861,8936,14861,8573
24256,3369,7271,22954,1302,22954,1302,3.8391e+18,97.1546,9209.18,24256,3448,111,16985,16985,13594,16020,8365
5868,688,2220,2206,3662,0,5868,8.10454e+12,48.9826,2760.84,5868,1059,71,3648,3648,2121,3246,761
36329,10671,11453,0,36329,0,36329,5.81121e+17,96.5477,14096.4,36329,5561,110,24876,24876,23827,23879,22851
25725,7022,11480,24638,1087,0,25725,1.61765e+18,94.2846,13205.2,25725,5568,110,14245,14245,12396,11354,9584
44247,792,1400,0,44247,42974,1273,3.79757e+16,270.96,4752.94,44247,228,26,42847,42847,37792,38731,30258
7733,802,1897,2725,5008,0,7733,9.7382e+12,59.2141,2656.99,7733,916,72,5836,5836,4190,5434,2438
5494,365,1846,5494,0,5174,320,4.7246e+18,92.9512,2372.97,5494,695,97,3648,3648,1984,2561,1086
13020,1466,3086,4585,8435,0,13020,9.87081e+12,59.7335,4222.14,13020,1498,72,9934,9934,7653,9536,5032
16141,3320,3828,15201,940,15201,940,5.75845e+18,97.3607,5376.17,16141,1843,110,12313,12313,12001,11958,11133
43629,105,176,43571,58,43629,0,6.01004e+18,173.641,2530.91,43629,170,173,39729,27116,24114,25050,26072
4006,861,977,1398,2608,0,4006,9.8932e+12,58.7049,1446.21,4006,471,67,3029,3029,2874,2999,2818
3656,46,170,0,3656,3550,106,3.53587e+16,19.7566,496.156,3656,39,26,3486,3486,2575,2571,1273
17242,4325,4970,6217,11025,0,17242,9.16167e+12,58.9727,6309.5,17242,2407,72,12272,12272,11508,12112,10398
31054,1704,13384,20506,10548,29696,1358,6.48266e+18,95.333,15380.3,31054,6442,111,17670,17670,9992,12926,3738
29739,6941,8192,29739,0,29739,0,4.73227e+15,5935.41,15572.4,29739,8192,5,19045,0,15961,17792,19045
44497,7286,13044,0,44497,0,44497,5.97869e+17,96.9406,16227.7,44497,6331,110,31453,31453,25678,22825,18814
4853,918,1196,0,4853,0,4853,6.53681e+17,95.5574,1832.94,4853,564,86,3657,3657,3309,3416,3143
2036,816,1024,805,1231,0,2036,6.67426e+12,50.193,1239.25,2036,489,53,1012,1012,775,972,686
16841,2731,7204,16101,740,16101,740,2.83294e+18,93.6342,8492.2,16841,3470,110,9637,9637,5702,7151,4697
37287,15592,15847,14373,22914,0,37287,7.42487e+12,56.9997,17925.2,37287,7714,72,21440,21440,21070,21370,20805
25134,9772,11781,9884,15250,0,25134,6.87032e+12,54.9792,13210.1,25134,5734,72,13353,13353,12444,13195,11582
16223,441,5065,15373,850,15373,850,6.81579e+18,96.1265,6503.63,16223,2449,110,11158,11072,8750,7081,2184
40948,5035,15586,0,40948,0,40948,5.24643e+17,95.5158,18271.9,40948,7564,110,25362,25276,15206,13960,12674
45226,11707,13873,0,45226,0,45226,5.85778e+17,96.7388,17050.9,45226,6730,110,31353,31353,29751,29261,27340
27317,4636,6441,0,27317,0,27317,6.47886e+17,97.6911,8752.64,27317,3114,110,20876,20876,18813,19284,15589
10883,3,13,10570,313,10817,66,1.47501e+14,10.7595,311.528,10883,13,12,8341,6008,6554,6893,4235
47286,63,176,47264,22,47286,0,5.98077e+18,171.877,2576.47,47286,171,171,33690,18297,14677,17003,16432
8575,5,11,8332,243,8573,2,1.38259e+14,10.3219,259.267,8575,11,11,7829,6898,5619,5812,5033
25155,132,176,25094,61,25155,0,6.13966e+18,172.084,1961.47,25155,146,154,24197,22728,18903,18829,19071
44504,3161,13612,42154,2350,42154,2350,6.80894e+18,96.7524,16750.1,44504,6611,110,30892,30892,26507,25013,8654
18659,4116,6290,17709,950,17709,950,4.17991e+18,96.4163,7817.49,18659,2989,111,12369,12369,10788,12262,8490
32921,7550,19488,0,32921,13660,19261,1.35378e+15,54.3394,20919.7,32921,9493,72,13433,13433,9198,5575,4546
33888,13,14,32900,988,33803,85,1.63778e+14,10.5193,602.729,33888,13,12,33874,33874,33465,33466,33015
8162,364,2337,7712,450,7712,450,3.1051e+18,95.9179,3228.22,8162,1120,102,5825,5739,3341,4238,1620
5190,157,170,5189,1,5190,0,5.98842e+18,155.665,849.473,5190,102,105,4983,4872,4671,4682,4671
18232,4604,9307,17542,690,17542,690,5.33444e+18,92.1491,10507.6,18232,4479,111,8925,8925,7473,8653,5269
5856,259,323,0,5856,5686,170,3.83791e+16,19.6769,867.206,5856,54,26,5533,5533,5406,5416,4638
27655,223,1199,0,27655,26851,804,4.16347e+16,247.982,3715.86,27655,188,26,26247,25851,19094,17994,6616
20452,912,8897,20452,0,20452,0,2.70305e+18,1859.63,10348.7,20452,7373,25,9867,8975,1676,1131,1904
5673,1145,1391,5338,335,0,5673,2.2389e+18,95.7726,2100.1,5673,658,91,4282,4282,3974,3966,3842
19203,55,5583,6932,12271,0,19203,9.16909e+12,59.029,7034.21,19203,2718,72,12393,4943,3365,9913,213
7059,1365,1943,2523,4536,0,7059,9.38428e+12,58.7967,2635.11,7059,936,72,5116,5116,4762,5038,4344
2316,267,619,0,2316,0,2316,6.72665e+17,92.0786,982.668,2316,282,61,1697,1697,1240,704,956
33922,5985,7918,11917,22005,0,33922,9.88882e+12,60.0253,10346.1,33922,3854,72,26004,26004,23632,25504,19776
29720,3059,6905,10440,19280,0,29720,9.88697e+12,60.0151,9092.23,29720,3350,72,22815,22815,17246,21855,10532
33301,2114,7804,31361,1940,0,33301,2.22851e+18,97.782,10502.7,33301,3783,110,25497,25497,14644,13477,8364
40485,475,13146,38405,2080,38405,2080,3.03918e+18,96.4271,15997.8,40485,6383,110,27339,26737,14477,17537,3168
41475,104,176,41460,15,41475,0,5.97946e+18,169.671,2410.83,41475,169,171,37640,24542,22888,23908,24566
14607,1340,3484,0,14607,0,14607,6.47734e+17,97.2212,4917.95,14607,1674,110,11123,11123,7816,6977,5035
24346,6940,7521,0,24346,0,24346,5.85231e+17,88.1708,9481.77,24346,3630,110,16825,16825,16198,15414,15449
34994,5677,12677,33284,1710,33284,1710,3.77313e+18,96.3624,15061,34994,6074,111,22317,22317,14577,16075,11763
29722,2197,10024,28222,1500,0,29722,1.93178e+18,96.1312,12234.7,29722,4864,110,19698,19698,11641,9381,4939
19998,2789,5652,18898,1100,18898,1100,3.38335e+18,96.9116,7360.58,19998,2670,111,14346,14346,12331,13523,6563
35652,16153,18419,14317,21335,0,35652,6.24095e+12,55.5463,20166.8,35652,8967,72,17233,17233,16285,17033,14889
20785,1903,4901,0,20785,0,20785,6.48006e+17,97.5,6773.69,20785,2360,110,15884,15884,11262,10210,7100
26002,9687,12286,26002,0,24842,1160,5.15587e+18,258.302,13516.7,26002,2957,133,13716,13713,12706,13507,10383
33506,2221,12518,0,33506,12616,20890,2.06878e+15,48.9783,14562.4,33506,6092,72,20988,20988,4997,6001,0
23564,156,176,23491,73,23564,0,5.98295e+18,169.687,1820.81,23564,161,159,23143,22540,20946,21020,21005
5813,1296,1430,5473,340,5473,340,5.86357e+18,95.7165,2152.66,5813,674,91,4383,4383,4355,4355,4232
6038,435,2094,0,6038,0,6038,5.65325e+17,94.4646,2765.24,6038,1001,88,3944,3858,1295,362,880
34119,6505,8188,32129,1990,32129,1990,4.5649e+18,98.2721,10865.1,34119,3872,111,25931,25931,22743,23442,21257
10203,2713,2835,3663,6540,0,10203,9.43259e+12,58.9903,3736.43,10203,1381,72,7368,7368,7231,7334,7141
13523,43,176,13515,8,13523,0,6.06224e+18,168.894,1432.85,13523,132,139,8323,3169,2926,3375,3264
11037,5,12,10711,326,11026,11,1.77602e+14,10.7007,315.367,11037,12,11,10215,9290,8772,8572,5381
7355,40,176,7349,6,7355,0,6.05241e+18,161.446,1057.89,7355,110,109,4393,1508,1546,1752,1650
31457,5797,9888,29817,1640,29817,1640,6.89941e+18,96.4884,12260.8,31457,4795,110,21569,21569,20011,19768,13997
36889,2410,11003,34919,1970,0,36889,2.04362e+18,96.8139,13733.9,36889,5335,110,25886,25886,13337,13266,7945
49288,16526,18357,46937,2351,0,49288,1.8273e+18,95.704,21495.4,49288,8920,110,30931,30931,29512,28911,27420
45448,74,176,45428,20,45448,0,5.99428e+18,172.91,2565.09,45448,171,173,35416,20452,17195,19400,18579
7091,396,1740,2499,4592,0,7091,9.82054e+12,59.2162,2451.85,7091,838,72,5351,5351,2686,4617,1413
40022,3575,9306,14062,25960,0,40022,9.88815e+12,60.0724,12091.8,40022,4524,72,30716,30716,22332,29266,12111
18925,1287,9447,18195,730,18195,730,5.77309e+18,94.0014,10704.5,18925,4546,111,9478,9478,6156,3994,2127
4947,2321,2983,4787,160,4787,160,9.47812e+18,90.3529,3386.37,4947,1421,70,1964,1964,1750,1814,1258
22192,1,11,21560,632,22188,4,1.38784e+14,10.0987,415.822,22192,11,11,5681,5681,5681,5681,5681
48892,433,18397,48892,0,46412,2480,4.51701e+18,613.433,20821.2,48892,5010,141,30118,28503,13594,19033,1640
9464,2423,3723,9016,448,9016,448,4.94472e+18,94.4946,4595.2,9464,1754,103,5741,5741,4800,4977,4906
3505,541,911,0,3505,1240,2265,2.48113e+15,57.5175,1332.79,3505,437,64,2594,2594,2153,1853,1583
46434,8877,15574,46434,0,42303,4131,4.52078e+18,321.717,17498.3,46434,3029,138,30860,30680,24869,28261,18675
15594,259,780,0,15594,15143,451,3.92911e+16,95.0909,2138.78,15594,103,26,14814,14710,13346,12925,7442
8568,142,176,8562,6,8568,0,6.01846e+18,159.305,1131.51,8568,119,117,8228,7728,6948,6955,6947
47481,11,14,46124,1357,47404,77,1.4096e+14,10.3762,659.568,47481,13,12,47465,47459,44553,44552,41349
12054,2915,5718,11567,487,11567,487,2.5673e+18,93.2031,6663.77,12054,2758,110,6336,6336,5540,6121,4966
17585,2900,4979,6329,11256,0,17585,9.27229e+12,59.0662,6343.45,17585,2415,72,12606,12606,10707,12206,7635
14401,1519,3431,13561,840,13561,840,5.88373e+18,97.2519,4848.69,14401,1654,110,10970,10970,10480,10482,5361
17064,99,913,0,17064,16566,498,4.23968e+16,161.174,2573.95,17064,129,26,15962,15860,13323,11359,4649
38526,2,15,37394,1132,38456,70,1.73111e+14,10.4443,672.176,38526,13,12,22804,17696,12928,17811,8098
31065,3199,12934,0,31065,0,31065,4.94485e+17,94.6189,15007.2,31065,6272,110,18131,18131,11544,6171,4077
49004,15,206,48983,21,49004,0,5.97782e+18,192.947,2726.15,49004,188,185,15990,2670,3475,3855,3290
33812,3796,10307,32023,1789,0,33812,2.02421e+18,96.6581,12838.6,33812,4997,110,23505,23505,17250,15898,9830
39903,1460,22106,39903,0,39903,0,2.49034e+18,17.8467,22641.9,39903,19885,20,17797,17797,1246,17797,1298
6358,1265,1510,0,6358,2230,4128,2.55302e+15,59.2691,2168.81,6358,732,72,4848,4848,4551,4303,4242
41861,12001,18553,0,41861,16266,25595,1.83851e+15,56.7155,20775,41861,9032,72,23308,23308,18482,13854,12747
37801,4797,14860,36041,1760,36041,1760,2.802e+18,95.8373,17298,37801,7118,111,22941,22941,14500,18269,9103
29942,8333,13982,11763,18179,0,29942,6.88279e+12,55.06,15627.2,29942,6798,72,15960,15960,13466,15437,9402
20648,7194,9472,19795,853,19795,853,9.1517e+18,93.9788,10911.4,20648,4589,110,11176,11176,10943,10943,8757
10068,155,438,0,10068,9782,286,3.5671e+16,20.1013,1227.31,10068,64,26,9630,9630,7775,7888,4508
10323,652,3523,9803,520,0,10323,1.93406e+18,90.7634,4521.8,10323,1675,110,6800,6800,3620,3361,2438
8059,1279,2763,7649,410,7649,410,4.92183e+18,95.3639,3586.18,8059,1295,99,5296,5296,3196,3687,2551
49015,682,1297,0,49015,47618,1397,3.55606e+16,264.426,4574.78,49015,208,26,47718,46993,40327,41398,31717
9789,1947,2391,9219,570,9219,570,3.19435e+18,97.1753,3440.74,9789,1117,111,7398,7398,6972,7367,6472
38104,9,15,36989,1115,38045,59,1.67656e+14,10.2827,646.293,38104,13,11,37720,37268,34427,32060,24699
42793,5696,10922,15215,27578,0,42793,9.60504e+12,59.7275,13791.6,42793,5318,72,31871,31871,26262,30701,16893
32195,3,14,31277,918,32121,74,1.38985e+14,10.5618,542.832,32195,13,12,24598,17281,20440,19565,12185
5122,70,161,0,5122,4962,160,0.0312378,0.968567,907.44,5122,161,1,4961,4961,4961,4961,4961
36306,3487,8499,34193,2113,34193,2113,5.88039e+18,97.7975,11386,36306,4119,110,27807,27807,26547,26547,12678
2118,321,874,0,2118,0,2118,5.25606e+17,76.7309,1168.94,2118,384,58,1244,1244,981,916,799
49289,1572,19292,47009,2280,47009,2280,8.21995e+18,95.3997,22355.7,49289,9376,110,29997,29997,6503,24312,4501
35105,976,11357,33298,1807,0,35105,1.96941e+18,96.3817,13910.1,35105,5509,110,23748,23666,14873,13047,4355
4736,1978,4736,0,4736,4736,0,2047.57,0,4736,4736,4736,1,0,0,0,0,0
10165,3400,3653,9662,503,0,10165,1.8911e+18,94.8639,4615.57,10165,1758,110,6512,6512,6253,6199,6076
16860,7560,9588,0,16860,3617,13243,1.3692e+13,8.83499,9828.08,16860,8621,11,7272,7272,6107,6159,6073
29800,197,1488,0,29800,28916,884,4.59089e+16,283.471,4615.28,29800,246,26,27877,27357,19046,19175,7275
29390,3734,7083,27680,1710,27680,1710,3.2456e+18,98.1897,9470.62,29390,3350,111,22307,22307,20339,21433,12760
7953,2650,3912,3152,4801,0,7953,6.62052e+12,55.5116,4493.8,7953,1900,72,4041,4041,3460,3941,2986
29446,6127,6929,0,29446,0,29446,6.48296e+17,97.7299,9377.42,29446,3357,110,22517,22517,21446,20732,20462
35380,26613,35380,35380,0,35380,0,8.79584e+12,0,35380,35380,35380,1,0,0,0,0,0
21946,3531,6064,7874,14072,0,21946,9.3452e+12,59.2725,7700.23,21946,2946,72,15882,15882,12667,15325,8866
30016,6239,8192,30016,0,30016,0,4.70938e+15,5956.23,15646.6,30016,8192,5,17918,0,12059,15963,17918
6334,172,175,6328,6,6334,0,5.98977e+18,158.071,946.639,6334,107,112,6159,6159,6076,6068,6062
18709,747,4379,6576,12133,0,18709,9.89534e+12,59.9207,5890.99,18709,2128,72,14330,14330,9055,13420,2721
22165,4768,9706,0,22165,8584,13581,1.86357e+15,56.2316,11059.2,22165,4712,72,12459,12459,10548,7899,7497
25239,3355,10878,25239,0,24002,1237,4.06288e+18,186.466,12054.8,25239,4493,125,14361,14159,8371,10975,4860
28446,577,1347,0,28446,27610,836,4.41272e+16,265.454,4169.18,28446,218,26,27099,26314,25109,24381,17079
19076,1261,4506,0,19076,0,19076,6.47704e+17,97.4519,6262.94,19076,2170,110,14570,14570,8511,6842,4953
1197,390,584,0,1197,466,731,1.81633e+15,39.0744,734.044,1197,264,46,613,613,613,613,613
44453,15637,19935,17322,27131,0,44453,7.10688e+12,56.6337,22253.7,44453,9697,72,24518,24518,22174,24028,18372
31838,7899,13746,30458,1380,0,31838,1.65875e+18,94.6127,15814.4,31838,6671,110,18092,18006,14506,12883,8637
27617,150,176,27599,18,27617,0,6.00937e+18,170.532,2016.67,27617,161,164,27026,26072,23744,23749,23596
49330,12512,15644,0,49330,0,49330,5.77653e+17,96.6008,19006.7,49330,7598,110,33686,33686,31594,28343,28356
28794,4979,6760,10120,18674,0,28794,9.85099e+12,59.9607,8886.25,28794,3281,72,22034,22034,19423,21584,16363
46285,27343,43253,0,46285,0,46285,6.04217e+17,3.99594,43359.2,46285,14435,9,3032,3032,1916,1916,1923
3748,864,1565,3748,0,3555,193,4.64261e+18,89.4138,1929.17,3748,590,78,2183,2183,1543,1814,1360
9347,4631,5077,9017,330,9017,330,1.0193e+19,82.6442,5791.39,9347,2432,99,4270,4270,4222,4214,4225
41800,7319,10702,41800,0,41800,0,2.60348e+18,4606.51,15939.3,41800,7383,27,31098,18789,23043,21990,24034
19933,6,12,19365,568,19921,12,1.38782e+14,10.5589,400.152,19933,12,11,18891,18321,16771,16861,11926
20091,3602,7147,0,20091,0,20091,5.47112e+17,95.587,8750.9,20091,3458,110,12944,12944,10235,7851,7330
38595,7666,9665,13694,24901,0,38595,9.66696e+12,59.7912,12314.2,38595,4706,72,28930,28930,26251,28462,23140
19778,144,175,19712,66,19778,0,5.98315e+18,165.996,1664.75,19778,157,154,19187,17997,16459,16463,16294
18426,5781,6443,17506,920,17506,920,3.70147e+18,96.1818,7936.04,18426,3066,111,11983,11983,11458,11949,10967
42103,1952,9874,39653,2450,39653,2450,5.89064e+18,97.8642,13119.8,42103,4787,110,32229,32229,29631,27765,7992
5854,1457,2638,0,5854,0,5854,4.75372e+17,84.416,3221.09,5854,1257,82,3216,3216,2037,1090,1084
8467,497,4788,1818,6649,0,8467,53466900000,7.67391,4956.83,8467,4302,11,3679,3679,1244,3679,1166
23973,1501,9389,0,23973,9093,14880,2.01324e+15,57.3507,10920.5,23973,4557,72,14584,14584,9078,5763,2504
30731,122,176,30720,11,30731,0,6.00496e+18,170.598,2115.93,30731,167,164,28962,26395,21269,21309,21486
23916,5275,10790,0,23916,0,23916,4.67744e+17,94.1801,12408.3,23916,5238,110,13126,13126,10927,8321,7475
13893,3,12,13494,399,13885,8,1.39066e+14,10.463,332.204,13893,12,11,10556,7503,8705,8402,5594
20100,4068,8569,19220,880,19220,880,8.65451e+18,72.9047,10044.4,20100,4135,110,11531,11531,11531,11531,11531
49646,11,15,48219,1427,49557,89,1.46487e+14,10.4813,720.871,49646,14,12,49629,49620,48441,47922,44778
26566,8438,9894,9987,16579,0,26566,8.10378e+12,57.7664,11594.2,26566,4816,72,16672,16672,15018,16386,13224
37771,3516,18981,0,37771,0,37771,4.21426e+17,93.0958,21115.1,37771,9221,110,18790,18790,11865,4340,4508
26757,1396,8733,26757,0,25198,1559,5.56353e+18,169.911,10037.4,26757,2738,130,18024,17849,9703,13773,3377
46090,887,20665,44158,1932,44158,1932,2.63704e+18,93.5293,23359.6,46090,10029,110,25425,24995,16336,16008,2833
22547,4287,5838,8028,14519,0,22547,9.57319e+12,59.5422,7539.26,22547,2843,72,16709,16709,14822,16314,11802
17244,1430,7085,16471,773,0,17244,1.72706e+18,94.3252,8423.71,17244,3420,110,10159,10159,6540,5796,2589
45763,7886,22607,0,45763,0,45763,4.28097e+17,93.3054,25113.7,45763,10972,110,23156,23156,16705,10412,9684
1157,6,66,0,1157,1124,33,3.5188e+16,18.8384,194.071,1157,24,25,929,767,530,534,272
8750,1888,3995,8750,0,8330,420,6.13304e+18,108.827,4582.09,8750,1281,106,4755,4732,3735,4508,2715
32573,1351,8882,0,32573,0,32573,6.16811e+17,97.1539,11427.1,32573,4305,110,23691,23691,15218,6941,4913
5236,702,1766,0,5236,1931,3305,2.21452e+15,57.5877,2283.36,5236,854,71,3470,3422,2150,1602,1305
14183,2567,7332,0,14183,3089,11094,1.3484e+13,8.98971,7569.7,14183,6595,11,6851,6851,3481,6851,3165
15569,3726,7303,15569,0,11854,3715,4.5063e+18,151.836,8147.41,15569,2243,128,8266,8266,6749,7287,4719
38516,18417,38516,38516,0,0,38516,7.99979,0,38516,38516,38516,1,0,0,0,0,0
33406,4814,14571,33406,0,31809,1597,4.52491e+18,306.344,16053.3,33406,6174,130,18835,18617,12473,15104,7725
28932,3543,7646,27312,1620,0,28932,2.14263e+18,97.2806,9993.8,28932,3705,110,21286,21286,16850,15660,10802
11572,3248,4858,11052,520,11052,520,5.03968e+18,92.4558,5836.51,11572,2299,111,6714,6714,6213,6714,5243
16510,1335,6934,15775,735,0,16510,1.70212e+18,94.4188,8212.89,16510,3356,110,9576,9576,6295,5611,2897
26777,11150,13003,0,26777,0,26777,4.36487e+17,91.1898,14688.7,26777,6293,110,13774,13774,13021,11919,12111
44813,79,208,44708,105,44813,0,6.11096e+18,204.776,2828.82,44813,187,181,36557,24804,16697,17831,16927
35071,5085,10800,33223,1848,33223,1848,6.80463e+18,96.6466,13397,35071,5243,110,24271,24271,21983,21612,12901
3625,1264,2133,3505,120,3505,120,1.06881e+19,88.925,2466,3625,1015,66,1492,1492,1412,1412,908
28151,7746,9191,10358,17793,0,28151,8.68819e+12,58.5253,11078.6,28151,4471,72,18960,18960,17577,18670,15428
613,92,238,0,613,0,613,6.35584e+17,73.6591,355.682,613,94,36,349,135,202,207,189
33012,3318,8192,33012,0,33012,0,4.48634e+15,6159.14,16441.6,33012,8192,5,10198,0,6635,9951,10198
4098,132,2347,4098,0,4098,0,4.05016e+18,18.0861,2505.02,4098,2099,21,1751,1733,117,68,100
6170,601,2140,5860,310,0,6170,1.93408e+18,94.1739,2823.48,6170,1018,88,4030,3944,2308,2551,2147
515,34,218,0,515,0,515,6.48434e+17,69.5553,315.978,515,81,34,162,27,74,5,47
48223,412,1746,0,48223,46824,1399,4.09382e+16,297.995,5866.82,48223,298,26,46477,45216,35032,35791,17593
6537,481,2241,6537,0,6157,380,3.58111e+18,91.3076,2787.9,6537,781,102,4296,4296,2285,3205,1279
24313,5400,15747,21551,2762,0,24313,2.45232e+18,5.52688,18085.8,24313,5252,13,8566,8566,6785,7267,3666
41659,8499,9783,0,41659,0,41659,6.47505e+17,97.8139,12998.7,41659,4743,110,31876,31876,30501,30214,28492
17495,4075,4122,0,17495,6150,11345,2.52886e+15,59.8357,5551.71,17495,2004,72,13373,13373,13335,13336,13333
20107,2426,8441,19217,890,19217,890,2.82319e+18,94.0911,9929.15,20107,4070,110,11666,11666,6915,8655,5564
11938,2523,3500,11288,650,11288,650,6.67838e+18,96.1474,4666.09,11938,1687,110,8438,8438,8248,8248,6597
2172,161,172,2167,5,2172,0,6.15183e+18,127.358,571.85,2172,68,64,2000,1993,1970,1972,1966
31861,1804,16209,0,31861,6954,24907,1.34594e+13,8.99109,16573.1,31861,14583,11,15652,15652,4933,15652,3776
16116,153,5248,0,16116,0,16116,5.73275e+17,95.8931,6656.57,16116,2532,110,10868,10446,3950,797,1200
10498,2104,2548,9888,610,0,10498,2.22329e+18,96.7978,3665.61,10498,1218,110,7950,7950,7465,7326,6968
29714,4242,7111,27984,1730,27984,1730,3.57458e+18,98.2046,9522.46,29714,3359,111,22603,22603,19696,22389,14326
8834,138,596,0,8834,8578,256,4.16815e+16,19.7627,1482.09,8834,78,26,8238,8230,7232,6745,2813
28537,4626,11586,0,28537,0,28537,5.03183e+17,89.9961,13558.2,28537,5612,110,16951,16951,10840,9955,6256
16438,925,7943,15785,653,0,16438,1.51963e+18,90.5281,9113.04,16438,3847,110,8495,8287,4735,3494,1985
25820,8666,10226,24630,1190,24630,1190,2.86917e+18,94.566,12075.1,25820,4939,110,15594,15594,13646,14431,13243
12131,737,4433,11537,594,0,12131,1.86558e+18,95.042,5521.53,12131,2140,110,7698,7526,5455,3938,2862
30955,2625,7237,0,30955,10887,20068,2.52837e+15,60.0153,9492.9,30955,3517,72,23718,23718,17009,8522,8867
13467,7,11,13074,393,13460,7,1.70574e+14,9.79802,338.841,13467,10,10,13088,12771,11682,11384,8972
31657,4009,11249,31657,0,29957,1700,4.02e+18,269.439,12925.4,31657,4656,125,20408,20293,13424,16202,8570
34992,11020,11742,33222,1770,33222,1770,3.00486e+18,96.1928,14253.2,34992,5696,110,23250,23250,22534,23057,21646
16008,6241,7831,15379,629,0,16008,1.50033e+18,93.3849,8971.33,16008,3794,110,8177,8177,7128,6561,5725
6791,334,1664,0,6791,0,6791,6.44776e+17,95.938,2475.99,6791,777,96,5127,5127,2365,1183,1399
40588,10676,18054,40588,0,38958,1630,4.5659e+18,2190.9,20888.1,40588,7333,145,22534,20229,18530,20488,14409
39232,1246,16679,37502,1730,37502,1730,3.72649e+18,95.474,19084.9,39232,8021,111,22553,22292,9967,13898,4906
25402,3767,5907,0,25402,8926,16476,2.53335e+15,60.0133,7836.07,25402,2871,72,19495,19495,16348,12435,12615
2104,453,544,743,1361,0,2104,9.68959e+12,57.2324,836.356,2104,249,56,1560,1560,1485,1540,1443
30762,8788,10587,0,30762,0,30762,5.5484e+17,95.9573,12837.6,30762,5128,110,20175,20175,18538,17192,17044
15803,135,3730,0,15803,5554,10249,2.5313e+15,59.7861,5049.3,15803,1807,72,12073,12032,3244,660,617
17255,3654,4103,0,17255,0,17255,6.45121e+17,97.3139,5729.26,17255,1965,110,13152,13152,12585,12426,12182
30761,8245,12067,0,30761,11677,19084,2.00719e+15,57.5028,13931.7,30761,5873,72,18694,18694,16414,14342,12702
11795,2346,3583,0,11795,4296,7499,2.31621e+15,58.673,4565.83,11795,1742,72,8212,8212,6696,6422,4321
43233,8411,10080,40713,2520,40713,2520,5.87149e+18,97.8781,13397.9,43233,4887,110,33153,33153,32723,32724,28296
30245,1,14,29381,864,30168,77,1.40156e+14,10.7479,541.855,30245,13,12,7679,7679,7679,7679,7679
27962,3999,6539,0,27962,0,27962,6.48871e+17,97.6923,8895.16,27962,3156,110,21423,21423,17961,14099,13850
3900,909,938,0,3900,1368,2532,2.56409e+15,58.8923,1400.09,3900,456,66,2962,2962,2934,2930,2932
26104,8277,11330,26104,0,24834,1270,3.87283e+18,197.389,12537,26104,4706,127,14774,14753,12681,13543,11317
44079,1689,1756,0,44079,42788,1291,4.25768e+16,309.223,5784.78,44079,299,26,42323,42323,42242,42238,41967
19833,3742,6701,18833,1000,18833,1000,7.38758e+18,95.8285,8325.17,19833,3241,110,13132,13132,12592,12592,6917
28999,7673,12874,0,28999,11262,17737,1.83925e+15,56.6741,14530.2,28999,6270,72,16125,16125,12446,10933,8123
29799,1538,9696,0,29799,10956,18843,2.22523e+15,58.5358,11669.1,29799,4718,72,20103,20103,12493,3451,3389
28930,5745,13162,27720,1210,27720,1210,3.16555e+18,94.9046,14997.1,28930,6335,111,15768,15681,14992,14691,14286
49934,18641,24473,0,49934,0,49934,3.42313e+15,17.984,25125.3,49934,22013,20,25461,25461,19687,22938,19460
44239,10576,14143,44239,0,41667,2572,3.81952e+18,311.299,16010,44239,4777,133,30096,30094,27281,28097,23615
568,111,149,568,0,568,0,6.0163e+18,71.4824,267.482,568,50,35,419,363,359,357,359
7491,1418,4257,7491,0,0,7491,8.96269e+17,17.7848,4473.63,7491,3815,20,3234,3234,1084,1858,1087
37884,5036,8879,13330,24554,0,37884,9.86344e+12,60.0302,11535.7,37884,4315,72,29005,29005,24405,28045,16746
2054,1,10,1999,55,2054,0,1.38271e+14,9.72152,125.026,2054,10,10,528,528,528,528,528
19006,618,4486,17896,1110,0,19006,2.23163e+18,97.4359,6234.06,19006,2166,110,14520,14520,6010,5449,2920
42303,10934,11305,0,42303,15132,27171,2.41546e+15,59.5128,14110.7,42303,5495,72,30998,30998,30577,30279,30040
14168,1662,3360,0,14168,4978,9190,2.51662e+15,59.7345,4574.89,14168,1626,72,10808,10808,8753,6073,5451
41972,9384,17465,41972,0,32589,9383,4.66024e+18,504.152,19365.1,41972,5587,137,24507,24229,19443,20342,14344
48333,1823,20780,0,48333,0,48333,4.82101e+17,93.5447,23648.8,48333,10084,110,27553,27553,16780,6882,4715
6662,1444,2328,2474,4188,0,6662,8.58238e+12,57.5866,2934.04,6662,1134,72,4334,4334,3541,4196,2823
33266,613,10765,33266,0,31326,1940,4.77417e+18,227.719,12284,33266,3967,125,22501,22196,8800,14708,2050
13791,110,665,0,13791,13396,395,3.70451e+16,20.0299,1774.68,13791,85,26,13126,13118,11362,10977,4110
29639,2696,7160,27919,1720,27919,1720,6.27243e+18,97.9619,9560.89,29639,3364,111,22479,22479,11454,16094,9531
11924,2757,2841,0,11924,4191,7733,2.5282e+15,59.6495,3900.44,11924,1380,72,9083,9083,8972,9063,8959
22145,3443,7269,22145,0,20854,1291,3.22915e+18,156.884,8427.05,22145,2645,125,14876,14755,10326,11912,7454
12088,47,186,12082,6,12088,0,5.97267e+18,177.272,1328.63,12088,136,137,7467,3518,2597,3330,3044
4644,1335,1621,4563,81,4374,270,4.00951e+18,90.3499,2065.08,4644,560,91,3023,3023,2782,2873,2778
26764,1433,8100,0,26764,9727,17037,2.3002e+15,58.8477,9958.74,26764,3936,72,18664,18664,11617,6285,3088
45594,6934,10676,0,45594,0,45594,6.48577e+17,97.8887,14131.1,45594,5181,110,34918,34918,30708,30781,23722
7765,130,176,7703,62,7765,0,5.99942e+18,157.615,1058.69,7765,114,119,7322,6886,5701,5750,5663
49360,1082,1646,0,49360,48539,821,2.52056e+16,3.73616,6289.67,49360,825,4,47714,47714,47657,47320,38364
7010,901,2307,7010,0,6600,410,3.02576e+18,93.6155,2924.07,7010,873,105,4703,4703,3210,3689,2276
44740,20,176,44671,69,44740,0,6.08394e+18,172.032,2616.01,44740,169,171,18181,3637,5130,5377,5012
20767,526,772,0,20767,20175,592,3.55274e+16,94.0758,2268.9,20767,102,26,19995,19902,19184,19300,15050
19682,1411,4669,0,19682,6927,12755,2.5276e+15,59.8596,6231.34,19682,2273,72,15013,15013,8850,5921,4646
49509,21909,23196,47508,2001,47508,2001,9.19751e+18,94.1805,25960.5,49509,11270,110,26313,26313,26015,25963,25169
29746,3488,9044,0,29746,0,29746,5.91231e+17,96.6249,11336.4,29746,4387,110,20702,20702,13794,11632,7953
28134,1023,1065,0,28134,27322,812,3.86566e+16,223.721,3342.46,28134,160,26,27069,27069,26980,26974,26518
48708,6419,15982,46205,2503,46205,2503,2.61814e+18,96.9903,19194.9,48708,7635,111,32726,32726,27590,29739,15480
31617,1436,11360,11819,19798,0,31617,8.27291e+12,58.0232,13346.7,31617,5528,72,20257,20257,9483,16650,1824
21715,341,857,0,21715,21090,625,3.72782e+16,153.603,2548.76,21715,120,26,20858,20662,16794,17126,11157
48741,1261,14366,46111,2630,46111,2630,4.38927e+18,96.2054,17708.6,48741,6828,111,34375,34375,14257,21289,3850
22007,5817,11710,22007,0,21147,860,4.79115e+18,291.681,12789.3,22007,3916,130,10297,10131,8221,9020,5990
1404,376,424,1324,80,1324,80,5.76779e+18,88.2578,669.467,1404,188,50,980,980,942,956,970
35045,741,1462,0,35045,34022,1023,4.23278e+16,283.795,4684.3,35045,241,26,33583,33583,29379,29668,21345
47166,15257,15571,0,47166,17394,29772,2.21096e+15,58.5331,18417.3,47166,7580,72,31595,31595,31143,30788,30782
39109,11492,17344,37452,1657,0,39109,1.62231e+18,93.5946,19730.1,39109,8413,110,21765,21765,19125,17595,14923
15358,358,935,0,15358,14904,454,4.52108e+16,187.154,2581.08,15358,136,26,14423,14134,12960,12350,6990
24880,564,5840,0,24880,8759,16121,2.53401e+15,59.9872,7729.67,24880,2844,72,19040,19040,6683,6295,2190
15359,378,735,0,15359,14920,439,3.77811e+16,62.0981,1996.36,15359,95,26,14624,14575,12617,12817,8978
31580,6230,9713,31580,0,29742,1838,5.46911e+18,210.028,11401.7,31580,3775,125,21867,21833,19314,20707,14764
32006,14026,15953,30784,1222,0,32006,1.46465e+18,93.5479,17842.7,32006,7748,110,16053,16053,15212,15031,14649
10366,2020,3680,0,10366,3861,6505,2.13925e+15,56.9924,4524.91,10366,1777,72,6686,6686,5804,5664,4970
24999,2776,5815,8777,16222,0,24999,9.91925e+12,59.9924,7714.26,24999,2832,72,19184,19184,15301,18335,9286
18061,2312,6510,18061,0,17054,1007,4.52343e+18,138.206,7508.32,18061,2468,124,11551,11461,7692,9333,5220
28434,2445,13936,6237,22197,0,28434,52227900000,8.98899,14286.6,28434,12535,11,14498,14498,5385,14498,4281
22839,3851,6419,21579,1260,21579,1260,2.78521e+18,97.454,8310.33,22839,3050,111,16420,16420,10987,12769,9315
36177,684,1802,0,36177,35106,1071,4.71142e+16,319.686,5700.01,36177,309,26,34375,33046,31297,27896,17079
13231,7514,8207,13231,0,12821,410,4.32419e+18,190.477,8933.19,13231,3862,108,5024,5024,4753,4908,3974
18433,5374,6315,0,18433,6837,11596,2.17023e+15,56.3262,7642.54,18433,3060,72,12118,12118,10998,10794,9251
21509,2666,7538,21509,0,20299,1210,5.21262e+18,151.264,8658.09,21509,2818,121,13971,13848,9895,11675,5952
42133,9622,17982,0,42133,0,42133,4.86105e+17,94.8079,20567.6,42133,8741,110,24151,24151,19651,16617,15204
27161,3328,6360,25581,1580,0,27161,2.22897e+18,97.6594,8666.07,27161,3067,110,20801,20801,16651,15744,11652
43889,19053,26099,0,43889,0,43889,3.43661e+17,89.9979,28142.9,43889,12690,110,17790,17790,15895,14031,13004
26607,3,12,25850,757,26595,12,1.3868e+14,10.4588,462.983,26607,12,11,20208,14325,16777,17650,9960
10806,114,453,0,10806,10498,308,3.53487e+16,20.0556,1278.22,10806,66,26,10353,10353,9035,9135,3886
1312,375,394,1232,80,1232,80,1.99867e+18,88.7675,628.334,1312,173,50,918,918,918,918,918
873,143,261,0,873,305,568,2.65538e+15,52.315,405.604,873,119,39,612,612,478,410,423
49696,1185,1551,0,49696,48265,1431,3.82661e+16,289.121,5333.71,49696,259,26,48145,48145,47359,47354,42651
25641,1905,14577,5499,20142,0,25641,53457200000,8.96346,14875.2,25641,13111,11,11064,11064,3670,11064,3333
19955,38,175,19941,14,19955,0,5.9882e+18,166.319,1672.38,19955,156,153,11176,3527,3717,4440,4192
7699,114,3147,2934,4765,0,7699,7.72137e+12,56.6635,3777.35,7699,1522,72,4552,4408,2626,4222,449
869,181,462,340,529,0,869,7.80908e+12,49.6997,568.407,869,225,46,407,359,368,391,385
41418,3422,9720,39008,2410,39008,2410,5.89179e+18,97.8374,12922.7,41418,4716,110,31698,31698,30128,29936,12638
38889,1306,1426,0,38889,37763,1126,4.01117e+16,283.337,4686.06,38889,233,26,37463,37463,37313,37301,36567
17954,431,5491,16994,960,16994,960,6.37437e+18,96.8669,7026.2,17954,2606,111,12463,12289,5901,7972,2225
26811,5078,9635,25491,1320,25491,1320,5.9565e+18,96.3183,11587.6,26811,4604,111,17176,17176,15725,16258,10389
11401,499,748,0,11401,11067,334,4.28579e+16,77.8284,1911.16,11401,96,26,10653,10587,10069,10072,6653
29509,746,1307,0,29509,28646,863,4.26427e+16,270.04,4075.81,29509,208,26,28202,28202,27192,27506,23147
26499,10,14,25713,786,26446,53,1.8611e+14,10.4643,544.303,26499,13,11,26409,26281,23446,23502,24014
28617,96,914,0,28617,27804,813,3.54963e+16,173.589,2910.17,28617,131,26,27508,27437,22222,22769,7075
5656,878,1443,5326,330,5326,330,5.98852e+18,95.5962,2145.31,5656,685,89,4213,4213,4093,4093,3075
34972,11680,13827,33362,1610,0,34972,1.7628e+18,95.2298,16159,34972,6711,110,21145,21145,19823,19103,17944
25043,128,176,25031,12,25043,0,6.03146e+18,172.337,1938.08,25043,161,159,23783,21951,18109,18214,18102
34984,8768,14779,0,34984,0,34984,4.89991e+17,93.4952,17032.9,34984,7174,110,20205,20205,17297,14617,12586
44000,6592,10258,41438,2562,0,44000,2.23073e+18,97.878,13624.1,44000,4974,110,33742,33742,28775,27827,22814
24937,239,905,0,24937,24225,712,3.68076e+16,175.254,2781.25,24937,127,26,23993,23779,17870,17499,9052
25653,2543,16617,0,25653,5532,20121,5.72428e+15,5.52349,19081.5,25653,5542,13,9036,9036,6423,6747,2374
16137,7753,9028,16137,0,11538,4599,5.27178e+18,207.802,9860.75,16137,2834,123,7109,7109,6964,7106,6767
33966,459,8157,31986,1980,31986,1980,2.02979e+18,98.2585,10825.4,33966,3862,111,25809,25809,7888,8765,2890
48527,875,16074,0,48527,0,48527,5.65802e+17,95.1039,19337.5,48527,7806,110,32453,32136,15248,3396,3452
5961,1695,1697,5628,333,5628,333,2.17891e+18,95.8024,2401.46,5961,793,92,4264,4264,4262,4264,4264
16231,6,12,15760,471,16219,12,1.5592e+14,10.4101,372.849,16231,12,11,15466,15124,13919,13046,10468
12132,180,508,0,12132,11786,346,3.53933e+16,20.0848,1423.46,12132,70,26,11624,11624,9384,9489,5245
29004,3505,9023,27484,1520,27484,1520,3.14826e+18,96.5169,11260.1,29004,4375,110,19981,19981,11298,14921,7680
8190,1943,2966,7790,400,7790,400,3.07808e+18,94.4352,3790.49,8190,1412,103,5224,5224,4260,4603,4271
14473,400,619,0,14473,0,14473,3.83983e+18,15.9787,1064.75,14473,614,17,13854,13854,11058,11695,12557
30522,8,12,29651,871,30508,14,1.42056e+14,10.1259,495.689,30522,12,11,29836,29385,23515,23678,24927
40097,2,15,38929,1168,40038,59,1.62383e+14,10.4124,658.557,40097,13,12,23561,17787,13522,14223,11147
28463,3975,10493,27083,1380,27083,1380,4.47081e+18,96.2013,12513.1,28463,5020,111,17970,17970,13972,15503,7966
27766,609,10946,26481,1285,26481,1285,2.90114e+18,95.1562,12899.6,27766,5307,110,16820,16334,6128,10392,2223
28724,3817,12530,28724,0,27387,1337,5.05399e+18,281.303,14015.2,28724,3730,133,16194,16022,11146,12402,4956
36741,5873,16393,35191,1550,0,36741,1.61447e+18,93.0759,18659.8,36741,7962,110,20348,20348,14358,13066,7951
4068,880,1017,3828,240,3828,240,5.82419e+18,94.7441,1574.51,4068,478,80,3051,3051,3021,3021,2879
46488,7901,10844,16350,30138,0,46488,9.87683e+12,60.0643,13990.3,46488,5276,72,35644,35644,31412,34911,26350
8896,2,14,8629,267,8854,42,2.03639e+14,10.0411,304.217,8896,12,11,5477,4585,2531,4612,1285
17461,2194,8578,16781,680,0,17461,1.49113e+18,91.1189,9793.29,17461,4153,110,8883,8883,5843,5122,2807
21726,4078,5231,20458,1268,20458,1268,3.14162e+18,98.0567,7125.89,21726,2471,111,16495,16495,14326,14807,13450
5911,107,2804,5671,240,5671,240,2.68642e+18,79.5522,3371.74,5911,1336,82,3107,1346,1089,1896,456
44898,2503,2688,0,44898,9189,35709,1.47266e+16,12.0024,3384.2,44898,1606,20,42210,42210,40892,39997,41598
41239,5917,13180,41239,0,38837,2402,3.97404e+18,292.423,14955.8,41239,4066,133,28059,27911,20326,22766,13725
16680,7,11,16201,479,16674,6,1.51622e+14,10.2635,370.264,16680,11,11,16111,15642,12263,11921,12043
13723,606,816,0,13723,13326,397,4.27368e+16,131.29,2186.03,13723,110,26,12907,12760,12275,12360,10915
38278,7606,9698,0,38278,0,38278,6.32959e+17,97.5367,12645.1,38278,4706,110,28580,28580,26498,27006,23284
8055,282,2034,7587,468,7587,468,6.23628e+18,96.1181,2935.64,8055,932,106,6021,6021,2045,3262,1133
4396,82,1127,0,4396,1559,2837,2.47298e+15,57.7652,1625.57,4396,533,68,3269,2761,1859,15,0
36925,1876,9902,13202,23723,0,36925,9.44106e+12,59.4862,12407.2,36925,4820,72,27023,27023,13422,23049,5444
13834,420,3390,13027,807,13027,807,3.40909e+18,97.6696,4738.82,13834,1597,111,10444,10444,4815,6767,2073
11367,1,12,11040,327,11358,9,1.49045e+14,10.5474,307.416,11367,12,11,2688,2688,2688,2688,2688
26879,7448,12667,0,26879,0,26879,4.50344e+17,93.6563,14385.6,26879,6151,110,14212,14212,10974,7614,7637
24482,120,176,24422,60,24482,0,6.15964e+18,165.267,1927.99,24482,145,146,23195,21331,16636,16970,16949
39315,12,15,38195,1120,39232,83,1.38801e+14,10.6354,621.455,39315,14,12,39299,39295,38501,38500,36688
30463,9556,13731,0,30463,0,30463,4.65886e+17,93.8621,15681.5,30463,6665,110,16732,16732,14778,14173,11737
49361,23207,27730,0,49361,0,49361,3.71149e+17,92.2222,30104.8,49361,13473,110,21631,21631,20206,18311,18137
20921,6023,6512,20921,0,19701,1220,3.28693e+18,155.012,7780.1,20921,2496,121,14409,14409,14125,14255,13701
38771,3379,9051,0,38771,0,38771,6.48838e+17,97.8515,12094.5,38771,4391,110,29720,29720,20483,16165,12388
16224,7248,10307,16224,0,15734,490,4.51431e+18,181.614,11100.7,16224,4833,121,5917,5822,4867,5270,4716
5226,1127,1654,1895,3331,0,5226,8.88404e+12,57.7968,2183.85,5226,796,71,3572,3572,3485,3552,3458
12104,2352,3156,4300,7804,0,12104,9.54228e+12,59.3069,4206.55,12104,1531,72,8948,8948,7830,8758,6726
18754,9262,9934,18754,0,18754,0,2.43542e+18,17.9042,10309.7,18754,8927,20,8820,8820,8160,8820,8180
23410,915,10360,22419,991,22419,991,2.68014e+18,93.6546,11975.2,23410,5010,110,13050,12792,8453,7870,1836
9335,1276,3690,9335,0,8835,500,3.71134e+18,95.1198,4331.96,9335,1416,115,5645,5642,3794,4680,2918
9493,39,176,9426,67,9493,0,6.01777e+18,163.572,1191.6,9493,121,125,5470,1755,1892,2158,2008
26138,156,176,26065,73,26138,0,5.98802e+18,169.601,1916.93,26138,159,163,25691,25019,23276,23329,23146
27081,4117,8615,25661,1420,25661,1420,4.96141e+18,96.5725,10679.1,27081,4088,111,18466,18466,12131,13297,9444
16678,2621,7350,6471,10207,0,16678,7.23071e+12,56.6065,8435.61,16678,3574,72,9328,9328,6494,8570,3448
14131,1948,5058,0,14131,5273,8858,2.14097e+15,57.8695,6114.96,14131,2464,72,9073,9073,6661,5191,3897
13115,2050,3111,4609,8506,0,13115,9.84273e+12,59.7459,4256.5,13115,1508,72,10004,10004,8807,9754,6968
12461,3078,12461,0,12461,12461,0,2047.84,0,12461,12461,12461,1,0,0,0,0,0
1144,7,10,1111,33,1144,0,1.40738e+14,9.54458,93.9953,1144,10,10,1096,1056,848,855,869
42370,16510,17752,42370,0,28740,13630,4.59263e+18,539.439,19684.3,42370,4786,141,24618,24618,24543,24618,24056
38041,6,8,37441,600,37977,64,9.69968e+13,3.9979,502.22,38041,6,4,38033,38033,38033,38031,35907
27590,28,1085,0,27590,26792,798,3.933e+16,217.896,3385.27,27590,165,26,26043,25797,16157,15985,4512
39765,262,18788,38165,1600,0,39765,1.53918e+18,93.9815,21105.7,39765,9134,110,20977,19608,7621,5042,1772
37753,9490,10727,35700,2053,0,37753,2.08312e+18,97.0117,13551.4,37753,5203,110,27026,27026,25344,24997,23546
48854,13891,26294,48854,0,48854,0,2.49575e+18,17.9817,26903.7,48854,23651,20,22560,22560,12624,22560,12446
42116,14709,17708,0,42116,0,42116,4.90713e+17,94.5055,20316.1,42116,8591,110,24408,24408,22668,20714,20046
38459,718,10322,0,38459,0,38459,6.18897e+17,96.7108,13235.6,38459,5006,110,28137,28107,10550,3912,3778
45175,10107,10836,42545,2630,42545,2630,5.65299e+18,98.3639,14173.7,45175,5132,112,34339,34339,34260,34077,32803
2303,717,1200,502,1801,0,2303,52441900000,8.91142,1290.31,2303,1071,11,1103,1103,722,1103,693
32358,4011,9833,32358,0,30468,1890,4.75664e+18,222.4,11558,32358,2051,130,22525,22479,15453,18398,9988
25291,1439,7651,0,25291,9198,16093,2.30376e+15,57.7382,9433.54,25291,3704,72,17640,17640,11124,5599,3264
33543,15275,16024,32089,1454,32123,1420,4.68676e+18,412.685,17718,33543,4992,137,17519,17519,17519,17519,17431
22652,29,32,22556,96,22652,0,1.11696e+18,31.9548,851.389,22652,32,32,20433,0,18381,19793,20433
8847,1151,2511,8359,488,0,8847,2.10605e+18,95.9017,3456.77,8847,1198,107,6336,6336,5122,4891,4105
21320,629,782,0,21320,20714,606,3.55218e+16,102.964,2313.89,21320,105,26,20538,20431,19360,19592,17541
34150,4964,10081,34150,0,34150,0,2.47154e+18,3621.73,13730.7,34150,7375,25,22400,16326,13602,12266,13018
38582,7904,14558,14544,24038,0,38582,8.01232e+12,57.7371,16837,38582,7077,72,24024,24024,20429,23274,14480
25610,5830,6046,0,25610,0,25610,6.47608e+17,97.6647,8244.78,25610,2926,110,19564,19564,19294,19161,19193
40998,7097,19208,39328,1670,39328,1670,8.19652e+18,92.021,21553.9,40998,9234,111,21790,21790,14637,16827,9770
34726,5935,8339,32706,2020,32706,2020,5.11045e+18,98.2411,11055.9,34726,3940,111,26387,26387,26387,25727,19520
41504,2717,12429,15074,26430,0,41504,9.03046e+12,58.9903,15088.4,41504,6049,72,29075,29075,16377,25383,7238
24719,1,12,24009,710,24706,13,1.46835e+14,10.4548,453.861,24719,12,11,5960,5960,5960,5960,5960
28365,15304,18373,25143,3222,25143,3222,5.91869e+17,6.52318,21109.9,28365,6128,14,9992,9992,9992,9992,8439
31318,114,208,31259,59,31318,0,6.13033e+18,203.28,2358.51,31318,167,170,28505,25503,16749,17284,17061
7635,847,2541,0,7635,2811,4824,2.22101e+15,58.0596,3230.95,7635,1237,72,5094,5046,2201,1433,392
7478,568,1811,7041,437,7041,437,5.8431e+18,96.247,2683.39,7478,858,101,5667,5667,5326,5145,2188
22472,3936,5559,21182,1290,0,22472,2.19537e+18,97.0178,7524.36,22472,2673,110,16913,16913,15167,14528,12505
23592,3531,7888,8720,14872,0,23592,8.59131e+12,58.2485,9512,23592,3837,72,15704,15704,11837,15041,7319
47127,8783,17459,44869,2258,0,47127,1.83262e+18,95.7482,20496.9,47127,8487,110,29668,29668,25563,23682,18794
42971,451,15152,0,42971,0,42971,5.46584e+17,95.9574,18042.5,42971,7349,110,27819,27054,16190,5773,2478
46511,6079,11927,43862,2649,43862,2649,4.5607e+18,98.1143,15281.6,46511,5665,111,34584,34584,28213,33710,17579
2628,409,1705,0,2628,0,2628,1.46515e+18,5.414,1975.83,2628,573,13,923,923,687,739,312
1691,68,88,0,1691,1645,46,3.54535e+16,19.3282,262.535,1691,29,26,1603,1603,1542,1547,1470
24391,531,7181,23071,1320,23071,1320,4.5292e+18,97.2405,9137.74,24391,3407,111,17210,17036,8751,10076,2782
24079,4320,5682,0,24079,8470,15609,2.52506e+15,59.9171,7519.8,24079,2764,72,18397,18397,16408,14898,14166
9537,206,3267,9537,0,8984,553,4.48424e+18,92.2165,3947.79,9537,1169,118,6270,6190,2163,3924,739
24161,703,1166,0,24161,23452,709,4.32477e+16,239.421,3520.23,24161,179,26,22995,22995,20425,21153,16263
33109,7333,7974,31186,1923,31186,1923,4.27975e+18,98.1906,10588.9,33109,3765,111,25135,25135,23967,24225,23662
41530,10602,18200,39758,1772,39758,1772,8.89536e+18,93.9038,20719.1,41530,8827,110,23330,23330,22600,22600,14752
35823,10662,14886,0,35823,0,35823,4.94835e+17,94.3691,17203.4,35823,7219,110,20937,20937,17981,15553,14818
4608,110,175,4608,0,4608,0,6.16167e+18,147.59,835.692,4608,89,91,4154,3568,2820,2886,2973
40339,11554,17632,38599,1740,38599,1740,8.10745e+18,93.8464,20053.2,40339,8463,111,22707,22707,17340,19097,17083
46809,6512,13373,0,46809,16898,29911,2.35939e+15,59.2548,16357.1,46809,6512,72,33436,33436,27402,19102,17337
11241,2100,2727,0,11241,0,11241,6.45302e+17,96.844,3902.2,11241,1305,110,8514,8514,7807,7599,6953
24827,5,61,24763,64,24827,0,2.25511e+18,60.6713,1173.61,24827,61,61,3963,180,2,130,1526
32453,6645,11688,30873,1580,30873,1580,2.90933e+18,95.7557,13988.3,32453,5663,110,20765,20765,17343,19889,12127
29987,825,14592,29987,0,28701,1286,5.21591e+18,282.839,15973.1,29987,3762,135,15395,14632,7393,9600,2343
49809,13426,14956,49809,0,46912,2897,4.34709e+18,340.14,17346,49809,3814,135,34853,34851,34147,34776,32072
13889,2261,3564,4935,8954,0,13889,9.59991e+12,59.4342,4734.65,13889,1731,72,10325,10325,8523,10008,6485
49546,11062,11875,46666,2880,46666,2880,3.16514e+18,98.3543,15467.4,49546,5621,111,37671,37671,36856,37613,35715
17434,3849,9985,3735,13699,0,17434,53574300000,8.98348,10227.2,17434,8983,11,7449,7449,3931,7449,3800
12637,855,3816,11959,678,11959,678,6.64776e+18,96.1536,5022.76,12637,1841,110,8821,8821,7661,7240,3284
2711,59,723,2553,158,0,2711,2.22587e+18,92.7805,1132.74,2711,328,66,1308,368,1054,1005,229
38405,653,11695,0,38405,0,38405,5.88364e+17,94.9292,14497.4,38405,5656,110,26710,26538,15830,4591,2547
31267,9296,11604,29759,1508,29759,1508,3.83118e+18,96.1953,13768,31267,5555,111,19663,19663,18014,19561,15986
49321,105,176,49235,86,49321,0,6.01445e+18,173.649,2694.89,49321,174,173,44906,30736,27226,28539,29424
32561,287,992,0,32561,31634,927,3.55563e+16,200.71,3248.68,32561,147,26,31476,31213,23950,24119,13202
48868,8821,18565,48868,0,46465,2403,4.55021e+18,1204.82,21249.4,48868,5243,141,30303,29200,22501,25984,15008
36090,130,206,36077,13,36090,0,5.98193e+18,186.87,2325.42,36090,179,170,34116,32039,23731,24343,24467
31433,7716,9415,29743,1690,29743,1690,3.84741e+18,97.301,11774.8,31433,4483,111,22018,22018,20264,21891,17292
7857,2978,3121,0,7857,2986,4871,1.99245e+15,56.8585,3773.89,7857,1505,72,4736,4736,4595,4557,4487
46019,10565,10784,43345,2674,43345,2674,5.89348e+18,97.857,14267.5,46019,5226,110,35235,35235,35185,35185,34891
21524,3211,5084,7573,13951,0,21524,9.86375e+12,59.9097,6767.21,21524,2472,72,16440,16440,13797,15980,10700
45085,548,1911,0,45085,9399,35686,1.49993e+16,12.0032,2615.17,45085,1669,19,43174,43174,31122,21316,36846
21142,33,208,21090,52,21142,0,6.0683e+18,200.705,1927.23,21142,152,159,11262,3442,3600,3732,3402
45189,12121,12548,0,45189,0,45189,6.10884e+17,97.1832,15825.1,45189,6088,110,32641,32641,32255,31932,31905
20713,34,894,0,20713,20112,601,3.8918e+16,172.479,2629.78,20713,126,26,19586,19545,15525,13806,2951
31361,5096,8241,0,31361,11177,20184,2.43325e+15,59.5414,10449.6,31361,4008,72,23120,23120,19994,19652,14842
34139,132,1022,0,34139,33165,974,3.55592e+16,210.256,3380.37,34139,152,26,32859,32724,22103,21945,9077
28506,98,1029,0,28506,27686,820,3.77781e+16,210.845,3247.23,28506,154,26,27185,27059,22679,21311,6984
9990,7,11,9699,291,9983,7,1.57897e+14,10.261,289.547,9990,11,11,9660,9360,7414,7168,7138
43131,4382,12484,40782,2349,40782,2349,1.34043e+18,96.6377,15534.8,43131,5947,111,30647,30647,30647,30647,11664
5176,1397,1807,4916,260,0,5176,1.9378e+18,83.8236,2409.02,5176,847,83,3369,3369,2857,2801,2505
39491,1331,9192,0,39491,13878,25613,2.53236e+15,60.0533,11940.8,39491,4475,72,30299,30299,18859,4389,4873
45527,60,98,45352,175,45527,0,3.86933e+18,97.3967,1864.51,45527,98,98,40991,31083,30651,28720,30186
11154,348,2701,10506,648,0,11154,2.21995e+18,96.8643,3868.86,11154,1292,110,8453,8453,5305,4792,1674
39410,1438,19311,39410,0,39410,0,2.82106e+18,17.9834,19888.6,39410,17374,20,20099,20099,2349,1471,1531
738,1,10,714,24,738,0,1.79259e+14,7.89024,78.7865,738,10,10,132,132,132,132,132
16517,1884,7138,15797,720,15797,720,8.74433e+18,93.9197,8399.88,16517,3453,110,9379,9379,8611,8809,2828
18645,8027,8102,12304,6341,17835,810,4.42537e+18,94.9494,9459.77,18645,3893,111,10543,10543,10494,10538,10505
22472,2493,5754,20482,1990,21192,1280,2.4348e+18,97.7507,7670.13,22472,2710,111,16718,16718,11559,12634,8533
18559,1,12,18030,529,18551,8,1.38834e+14,10.3084,384.448,18559,12,11,4752,4752,4752,4752,4752
37206,4139,10288,0,37206,0,37206,6.1231e+17,96.0053,13103.5,37206,4976,110,26918,26918,19644,13674,12016
29534,133,908,0,29534,29082,452,2.46275e+16,3.73742,3519.3,29534,456,4,28626,28626,24633,24554,14301
34270,2027,19178,34270,0,34270,0,2.20809e+18,17.89,19668.4,34270,17250,20,15092,15092,1455,15092,1502
40235,3459,14377,40235,0,38092,2143,5.03931e+18,326.72,16374.9,40235,5397,130,25858,25413,16290,20629,7136
41653,6690,11103,14885,26768,0,41653,9.45344e+12,59.5083,13871.1,41653,5402,72,30550,30550,25964,29590,18303
35111,11,14,34111,1000,35034,77,1.38858e+14,10.7125,581.69,35111,13,12,35095,35086,32547,32589,33035
32211,131,176,32185,26,32211,0,6.03649e+18,172.568,2205.48,32211,163,169,30800,28769,23905,24065,24131
15285,6073,7498,15285,0,0,15285,8.76857e+17,17.9535,7851,15285,6737,20,7787,7787,6443,7523,6367
2887,28,773,2717,170,2717,170,5.06411e+18,93.4364,1199.17,2887,346,69,899,85,156,477,195
26720,1112,6735,25190,1530,25190,1530,5.44203e+18,97.944,8929.55,26720,3192,111,19985,19985,8636,10738,4774
48026,2107,48026,48026,0,0,48026,7.99983,0,48026,48026,48026,1,0,0,0,0,0
13289,1170,3129,12511,778,12511,778,5.85787e+18,97.1854,4467.83,13289,1500,110,10160,10160,9662,9630,4393
9375,64,3732,0,9375,3566,5809,1.99444e+15,57.0182,4475.17,9375,1807,72,5520,3041,1677,215,346
13445,3301,3302,12660,785,12660,785,4.4202e+18,97.6163,4617.64,13445,1546,111,10143,10143,10142,10142,10143
16988,598,4550,0,16988,0,16988,6.22472e+17,96.8286,6105.46,16988,2189,110,12438,12352,6053,2357,2723
41465,14121,15995,0,41465,0,41465,5.20557e+17,94.8332,18691,41465,7768,110,25470,25470,24005,24206,22569
22420,4094,5230,0,22420,7883,14537,2.53412e+15,59.9606,6972.34,22420,2542,72,17190,17190,15803,14003,13628
1348,40,408,1269,79,1269,79,3.21762e+18,87.1832,645.051,1348,170,52,496,94,150,303,110
22046,4565,6483,0,22046,7983,14063,2.32738e+15,58.8497,8095.99,22046,3140,72,15563,15563,14344,12753,12434
18492,3338,7791,7118,11374,0,18492,7.49335e+12,56.9611,8995.39,18492,3794,72,10701,10701,8175,10117,5033
43816,6755,10226,15409,28407,0,43816,9.88472e+12,60.0714,13222.3,43816,4976,72,33590,33590,28553,32720,22514
45136,154,176,45055,81,45136,0,5.9824e+18,169.756,2514.71,45136,171,171,44413,43177,40047,40196,39830
44176,6347,10361,41610,2566,0,44176,2.22634e+18,97.8504,13730.5,44176,5026,110,33815,33815,29307,27586,21778
7696,4,11,7479,217,7690,6,1.3964e+14,10.5798,247.236,7696,11,11,6668,5912,4961,5087,3550
35828,729,1233,0,35828,34798,1030,3.8396e+16,258.223,4043.08,35828,195,26,34595,34595,30900,31413,25158
11235,1377,3765,11235,0,10578,657,5.4192e+18,92.4674,4517.97,11235,1337,119,7470,7470,5354,6300,3086
40333,11136,12904,40333,0,37983,2350,4.88002e+18,286.473,14651.7,40333,3344,134,27429,27429,26605,27300,24445
21428,311,785,0,21428,20817,611,3.55278e+16,103.315,2322.51,21428,105,26,20643,20535,16832,16956,11338
43634,24107,25965,0,43634,0,43634,3.43331e+17,90.1524,27997.5,43634,12612,110,17669,17669,17369,16871,17158
10325,1415,2511,0,10325,0,10325,6.46834e+17,96.7353,3613.99,10325,1199,110,7814,7814,6614,6206,4934
4475,1,4,4398,77,4475,0,9.93182e+13,3.98793,127.049,4475,4,4,1808,1808,1808,1808,1808
3855,128,170,3795,60,3855,0,6.00955e+18,149.708,730.96,3855,92,96,3565,3333,2818,2854,2849
14974,1985,7906,14974,0,0,14974,8.86922e+17,17.9486,8240.68,14974,7101,20,7068,7068,2137,3116,1826
48575,1076,11365,45750,2825,45750,2825,5.751e+18,97.8907,15003.9,48575,5511,110,37210,37210,28936,22683,5714
32499,2389,11844,0,32499,12174,20325,2.09832e+15,57.9298,13859,32499,5766,72,20655,20655,13571,4628,5109
41265,8,14,40076,1189,41210,55,1.52125e+14,10.4029,646.822,41265,12,11,40397,39726,36029,34523,30167
32618,4168,7669,0,32618,0,32618,6.46688e+17,97.7374,10321.5,32618,3712,110,24949,24949,20220,16789,14533
5365,1311,2016,0,5365,0,5365,5.39454e+17,93.4188,2613.16,5365,957,87,3349,3349,2891,2317,2752
45745,933,1768,0,45745,44411,1334,4.21052e+16,300.189,5861.02,45745,302,26,43977,43969,42127,42304,34131
41677,89,176,41616,61,41677,0,5.98276e+18,172.132,2419.96,41677,171,171,35687,21328,19593,20709,21411
39871,10232,19124,0,39871,15742,24129,1.71852e+15,56.1329,21148.3,39871,9310,72,20747,20747,16507,13944,11499
36481,1857,17092,36481,0,34941,1540,4.82947e+18,649.653,19038.3,36481,5829,139,19389,18108,10145,12545,3717
21922,924,1465,0,21922,21259,663,5.28287e+16,279.409,4312.5,21922,240,26,20457,20457,19788,19620,15877
8221,908,3754,7878,343,0,8221,1.60866e+18,93.0015,4488.88,8221,1803,100,4467,4381,2775,2438,1922
3109,812,824,2926,183,2926,183,3.0437e+18,93.9624,1273.88,3109,374,72,2285,2285,2277,2285,2285
44804,11769,13257,42404,2400,0,44804,2.04842e+18,96.9058,16445.9,44804,6439,110,31547,31547,30723,30573,30100
2581,37,193,0,2581,2504,77,4.22128e+16,19.2623,492.83,2581,42,26,2388,2380,1767,1819,1033
12786,1,14,12405,381,12738,48,1.98635e+14,10.6386,378.714,12786,13,11,1827,1827,1827,1827,1827
30341,28364,30341,0,30341,0,30341,524271,0,30341,30341,30341,1,0,0,0,0,0
20072,114,274,20069,3,20072,0,5.66868e+18,196.29,1069.92,20072,266,30,19478,19254,10641,14136,10296
28992,6603,6780,0,28992,10200,18792,2.53454e+15,60.0202,8918.39,28992,3301,72,22212,22212,21999,21859,21817
30504,4,14,29634,870,30425,79,1.38938e+14,10.7639,539.126,30504,13,12,26582,23801,22947,21223,14201
22807,5636,9606,22807,0,21667,1140,3.78542e+18,151.351,10706.9,22807,3899,125,13201,13195,10197,11296,8643
23099,245,12999,23099,0,23099,0,2.49822e+18,17.9633,13396.2,23099,11684,20,10100,10000,201,10100,246
8634,2065,2808,8184,450,8184,450,3.42607e+18,95.7172,3691.42,8634,1322,103,5826,5826,5064,5777,4274
21305,4972,5018,20065,1240,0,21305,2.23013e+18,97.5379,6927.94,21305,2417,110,16287,16287,16273,16276,16280
22075,6582,10586,21195,880,21195,880,2.55549e+18,91.4966,12052.7,22075,5130,110,11489,11489,9784,11105,7995
31354,585,973,0,31354,30462,892,3.55715e+16,196.067,3157.34,31354,142,26,30381,30047,26320,26916,22218
45830,13311,18528,45830,0,43800,2030,4.94476e+18,2114.98,21613.2,45830,7943,146,27302,25445,24070,25472,21512
16565,10,12,16090,475,16552,13,1.44433e+14,10.6267,369.174,16565,12,11,16462,16328,16002,16001,14931
4673,972,1128,0,4673,1646,3027,2.51256e+15,58.8943,1656.14,4673,536,71,3545,3545,3395,3372,3265
25035,5633,5868,23575,1460,23575,1460,3.38064e+18,97.6501,8030.59,25035,2830,110,19167,19167,18749,18935,18752
32215,251,7523,11323,20892,0,32215,9.91173e+12,60.0301,9848.92,32215,3664,72,24692,24692,6467,19630,932
25073,673,1150,0,25073,24343,730,4.22379e+16,230.96,3501.44,25073,179,26,23923,23375,21259,21954,16687
39898,142,176,39811,87,39898,0,6.02479e+18,172.33,2434.03,39898,173,170,38772,36284,32202,32339,32059
20464,6547,7047,19441,1023,19441,1023,7.30881e+18,95.8095,8697.74,20464,3416,110,13417,13417,13121,13078,12273
31901,292,9092,30168,1733,0,31901,2.08244e+18,96.9332,11566.6,31901,4407,110,22809,22551,7451,5276,1956
40233,10625,11531,38053,2180,0,40233,2.07619e+18,97.0211,14493.7,40233,5588,110,28702,28702,27700,27304,26323
38842,7947,9043,0,38842,13645,25197,2.52994e+15,60.0499,11757.8,38842,4399,72,29799,29799,28459,26713,26381
38577,13,14,37456,1121,38552,25,1.60733e+14,10.3393,592.956,38577,13,12,38563,38563,38538,38539,38442
44467,77,176,44405,62,44467,0,6.06101e+18,173.3,2602.32,44467,174,173,35990,23745,18312,19588,19462
26666,1967,14144,25708,958,0,26666,1.37342e+18,92.947,15708.6,26666,6872,110,12522,12522,6674,4707,2140
19896,3057,9239,19078,818,19078,818,2.65439e+18,93.8891,10624.2,19896,4471,110,10657,10657,5465,7390,3842
19492,590,696,0,19492,19146,346,2.56852e+16,3.7342,2691.98,19492,350,4,18796,18796,18785,18722,17109
4230,305,1079,0,4230,0,4230,6.38244e+17,94.4704,1650.71,4230,494,81,3151,3151,2136,1615,1182
19673,3845,4652,18530,1143,0,19673,2.22875e+18,97.4229,6448.59,19673,2235,110,15021,15021,13955,13799,12960
17971,4136,6473,6725,11246,0,17971,8.28547e+12,57.387,7745.74,17971,3147,72,11498,11498,9742,11130,6944
2628,519,767,2480,148,0,2628,2.15676e+18,91.5906,1157.87,2628,343,64,1861,1861,1618,1579,1444
46297,5080,10764,43597,2700,43597,2700,5.86657e+18,97.9349,14272.3,46297,5226,110,35533,35533,34103,34103,18165
35809,3357,11177,13084,22725,0,35809,8.86973e+12,58.7837,13501.8,35809,5439,72,24632,24632,15843,22156,8532
25135,5159,13939,5412,19723,0,25135,53278900000,8.93276,14241.7,25135,12539,11,11196,11196,5790,11196,5466
7627,158,170,7627,0,7627,0,5.97095e+18,159.401,1028.26,7627,119,119,7401,7230,6966,6948,6961
42235,8,18,40989,1246,42133,102,1.76416e+14,10.533,710.101,42235,14,12,41468,40880,37607,31199,24667
7221,166,613,0,7221,7007,214,4.60526e+16,18.824,1451.65,7221,77,26,6608,6600,5796,5299,2249
4483,1944,4192,4188,295,4188,295,1.12142e+18,3.95963,4222.35,4483,1419,9,291,291,132,135,139
32518,123,175,32437,81,32518,0,5.97969e+18,167.459,2131.87,32518,169,166,30701,28143,22881,22966,23180
15468,1971,7337,14848,620,14848,620,2.53577e+18,93.4551,8474.9,15468,3543,110,8131,8131,5827,5981,3264
15424,4673,5093,15424,0,14521,903,3.12887e+18,124.45,6014.1,15424,1830,124,10331,10331,10113,10229,9840
42603,9024,16484,40603,2000,40603,2000,5.08256e+18,96.0756,19181,42603,7914,111,26119,26119,23744,25633,17173
9203,353,400,2682,6521,2682,6521,1.7429e+18,15.9652,752.191,9203,393,17,8803,8803,8246,8409,8538
6333,2008,2327,0,6333,0,6333,5.44869e+17,90.1893,3009.42,6333,1092,88,4006,4006,3753,3775,3666
37215,3,5,36052,1163,37087,128,0.000107484,0.999866,430.509,37215,5,1,37210,37210,37210,37210,37210
2953,110,140,0,2953,2867,86,3.5553e+16,19.3569,411.704,2953,35,26,2813,2813,2762,2754,2516
7956,966,2516,7536,420,0,7956,2.01849e+18,95.166,3362.09,7956,1199,108,5440,5440,3986,3567,2363
31375,7664,11029,0,31375,0,31375,5.49898e+17,82.6912,13295.3,31375,5349,110,20346,20346,16571,14850,10344
44116,17380,18526,44116,0,42246,1870,4.97235e+18,2291,21577.4,44116,7943,148,25590,25583,25493,25521,23727
30104,52,176,30027,77,30104,0,5.98404e+18,169.69,2056.14,30104,166,164,19507,9658,7710,8992,8840
12448,2332,4473,0,12448,4645,7803,2.12495e+15,57.7608,5432.95,12448,2174,72,7975,7975,6889,6803,5810
19982,2523,4841,18822,1160,18822,1160,1.777e+18,97.8852,6619.65,19982,2270,111,15141,15141,12833,14879,8782
528,130,349,0,528,0,528,1.46547e+18,4.88068,407.131,528,118,13,179,179,145,132,90
12656,1984,7140,2717,9939,0,12656,53403200000,8.94445,7348.66,12656,6425,11,5516,5516,2466,5516,2327
46207,6305,12167,0,46207,16495,29712,2.42782e+15,59.5833,15196.9,46207,5913,72,34040,34040,28094,19879,18133
5829,1855,2060,5829,0,5496,333,3.41691e+18,91.1064,2566.15,5829,736,98,3769,3769,3646,3697,3633
36404,125,176,36377,27,36404,0,6.06999e+18,172.407,2356.99,36404,166,169,34592,31669,25920,25841,25678
14549,3152,3654,0,14549,5153,9396,2.48301e+15,59.5347,4871.95,14549,1778,72,10895,10895,10298,9594,9476
45720,8409,10604,16063,29657,0,45720,9.90954e+12,60.1002,13707.9,45720,5165,72,35116,35116,32421,34553,28017
11947,4145,4484,11947,0,11297,650,5.36191e+18,115.889,5247.44,11947,1690,119,7463,7463,7291,7410,7124
31022,80,176,31001,21,31022,0,6.02913e+18,172.185,2153.77,31022,167,163,25519,15878,13052,14121,13576
24701,957,1046,0,24701,0,24701,3.83932e+18,15.9866,1633.21,24701,1039,17,23655,23655,22554,22801,23138
27520,6067,10845,27520,0,26130,1390,5.1712e+18,232.632,12320.5,27520,2411,134,16675,16582,13932,15509,9263
25329,734,6141,23859,1470,23859,1470,3.75524e+18,97.8965,8267.93,25329,2906,111,19188,19188,9623,11814,3587
1198,275,484,1138,60,1138,60,2.93948e+18,75.3222,680.439,1198,192,51,714,714,535,693,410
32310,545,11220,12009,20301,0,32310,8.44577e+12,58.227,13267,32310,5466,72,21090,20802,8268,16658,725
46499,83,176,46432,67,46499,0,6.0923e+18,173.261,2668.95,46499,170,173,39145,26765,21166,21832,22064
3054,411,763,1071,1983,0,3054,9.91782e+12,58.2574,1145.36,3054,362,61,2291,2291,1891,2204,1381
9958,1753,2444,0,9958,0,9958,6.40919e+17,96.5604,3515.8,9958,1159,110,7514,7514,6650,5815,5962
36836,6094,11270,36836,0,34696,2140,5.05651e+18,264.191,13171.1,36836,4408,128,25566,25468,20941,23283,14757
15422,3611,8110,0,15422,0,15422,4.042e+17,88.4614,9164.06,15422,3911,110,7312,7312,5524,3868,3933
15583,4103,5210,15583,0,14680,903,4.11871e+18,127.053,6134.95,15583,1871,118,10373,10373,9281,9772,8617
19364,117,176,19294,70,19364,0,6.09091e+18,168.626,1721.42,19364,149,147,18079,16397,12557,12901,12971
4079,15,173,4076,3,4079,0,5.98663e+18,151.452,757.677,4079,91,94,1330,227,284,311,310
18342,74,4300,0,18342,6451,11891,2.53648e+15,59.8901,5785.58,18342,2088,72,14042,10096,3463,228,214
49591,3358,11487,17424,32167,0,49591,9.89818e+12,60.1099,14813.3,49591,5588,72,38104,38104,26281,36064,11806
27085,2519,10330,25807,1278,25807,1278,2.82781e+18,95.3814,12281.2,27085,5013,110,16755,16755,11838,12679,4141
15041,7,13,14607,434,14970,71,1.58338e+14,10.8861,392.159,15041,12,12,14565,14320,11541,11517,9652
48156,1913,1960,0,48156,46745,1411,4.34866e+16,321.615,6491.02,48156,340,26,46196,46196,46070,46070,45611
17995,4784,5961,17995,0,16946,1049,5.38399e+18,140.523,6975.72,17995,1389,127,12034,12034,11613,12034,10115
37891,7816,8850,35681,2210,35681,2210,3.34609e+18,97.8445,11837.3,37891,4284,110,29041,29041,26980,27930,26205
24138,3261,9464,0,24138,0,24138,5.15721e+17,95.1015,11226.6,24138,4588,110,14674,14674,10150,4996,5301
38937,8114,10111,0,38937,13874,25063,2.44557e+15,59.6327,12751.8,38937,4919,72,28826,28826,26806,24150,23557
12698,2415,4082,0,12698,0,12698,5.78559e+17,95.732,5264.92,12698,1966,110,8616,8616,7166,4899,5058
39807,10725,15493,37957,1850,0,39807,1.77959e+18,95.3717,18094.4,39807,7523,110,24314,24314,21593,20240,17253
19551,691,9910,0,19551,0,19551,3.43895e+15,17.9655,10304.8,19551,8903,20,9641,9641,1059,6420,744
22334,10,12,21683,651,22318,16,1.61016e+14,10.3286,442.252,22334,12,11,22268,22174,21848,21849,21087
26242,135,1169,0,26242,25475,767,4.18693e+16,246.239,3585.96,26242,180,26,24726,24481,17735,16469,6378
40836,29325,38163,0,40836,12720,28116,2.35971e+15,3.99287,38262.5,40836,12735,9,2673,2673,2053,2053,2060
21631,231,6730,21631,0,20370,1261,5.8961e+18,157.187,8025.96,21631,2583,123,14901,14786,4948,9193,982
41314,15574,16516,0,41314,0,41314,5.08096e+17,95.0999,19156.9,41314,8008,110,24798,24798,24374,24316,24185
11219,6,7,10282,937,11219,0,1.17267e+14,6.9861,248.263,11219,7,7,10591,9347,10279,10279,10279
9249,359,4047,0,9249,0,9249,4.85397e+17,93.5135,4865.18,9249,1948,106,5202,4944,3205,1534,1499
35755,1458,8375,33675,2080,0,35755,2.22852e+18,97.7935,11228.8,35755,4056,110,27380,27380,12688,11426,6333
23241,2493,6631,0,23241,0,23241,6.06656e+17,96.8026,8568.55,23241,3210,110,16610,16610,12219,7024,7129
1798,494,527,1698,100,1698,100,4.40618e+18,89.802,824.141,1798,231,57,1271,1271,1256,1269,1269
44343,1144,14548,42063,2280,42063,2280,3.57508e+18,96.8664,17535.5,44343,6954,111,29795,29549,12486,18111,4136
38602,415,1458,0,38602,37481,1121,4.06768e+16,277.036,4770.22,38602,239,26,37144,36230,33335,30047,18165
9502,192,414,0,9502,9229,273,3.56876e+16,19.9886,1160.6,9502,63,26,9088,9088,7754,7858,5191
2294,80,590,797,1497,0,2294,9.74995e+12,57.5942,900.752,2294,282,57,1704,1378,529,1317,207
45869,9923,10702,0,45869,16129,29740,2.53099e+15,60.0682,13811.1,45869,5207,72,35167,35167,34218,32932,32802
2339,8,11,2273,66,2335,4,1.38271e+14,10.159,135.314,2339,11,11,2276,2237,2081,2081,1887
6138,1360,1547,5780,358,0,6138,2.21873e+18,96.0389,2296.71,6138,735,95,4591,4591,4486,4433,4492
45311,2725,12168,42774,2537,42774,2537,4.04285e+18,97.9032,15412,45311,5778,111,33143,33143,17492,19218,8458
15966,662,675,0,15966,15514,452,3.55685e+16,20.0507,1856.21,15966,85,26,15291,15291,15268,15271,15214
48196,11920,19994,46048,2148,46048,2148,2.74381e+18,95.0469,22912.1,48196,9719,110,28202,28202,24781,27376,20112
28021,10177,15997,28021,0,0,28021,8.97848e+17,17.83,16428.7,28021,14387,20,12024,12024,7595,8382,7544
37284,4575,14697,0,37284,14167,23117,2.00584e+15,57.4884,16860.8,37284,7159,72,22587,22539,15810,18685,14021
42801,3763,11988,40461,2340,40461,2340,6.42221e+18,92.2997,15123.2,42801,5799,110,30813,30813,25976,24851,6265
45346,7423,10892,42708,2638,42708,2638,2.14316e+18,98.3369,14236.6,45346,5151,111,34454,34454,30953,34199,24539
47791,13343,15097,0,47791,0,47791,5.78405e+17,96.5869,18380.5,47791,7332,110,32694,32694,30823,28047,27961
17819,1811,4702,0,17819,6353,11466,2.43809e+15,59.4158,6110,17819,2282,72,13117,13117,9837,7841,5952
43939,871,10308,41387,2552,41387,2552,5.89972e+18,97.8379,13665.7,43939,4988,110,33631,33631,29890,26961,4862
46103,6,15,44769,1334,46040,63,1.55064e+14,10.4441,683.37,46103,13,12,43934,42797,32811,32076,29335
2843,744,759,0,2843,0,2843,6.26641e+17,92.644,1184.33,2843,337,66,2084,2084,2084,2084,2084
20757,7143,7605,7782,12975,0,20757,8.18269e+12,56.627,9020.85,20757,3682,72,13152,13152,12660,13049,12005
759,140,497,759,0,729,30,4.06903e+18,45.1291,584.211,759,191,32,262,105,132,165,2
27161,11,12,26376,785,27146,15,1.55085e+14,10.2597,482.998,27161,12,11,27149,27149,26596,26597,25402
16096,1585,3840,15163,933,15163,933,5.75201e+18,97.2171,5380.86,16096,1844,110,12256,12256,10928,10713,5817
1476,415,453,1394,82,1394,82,5.45645e+18,87.832,706.34,1476,186,51,1023,1023,1001,1007,1022
30803,207,974,0,30803,29926,877,3.57961e+16,196.756,3145.2,30803,142,26,29679,29497,21507,21357,10867
12178,749,2877,0,12178,0,12178,6.48979e+17,97.0312,4134.24,12178,1371,110,9301,9301,6402,3604,3017
12105,160,175,12097,8,12105,0,5.97662e+18,163.587,1304.4,12105,133,138,11847,11614,11170,11174,11154
46697,106,176,46669,28,46697,0,6.00087e+18,172.314,2606.69,46697,172,172,42602,29773,26162,27384,28179
22820,4621,5369,0,22820,0,22820,6.48742e+17,97.5607,7380.02,22820,2594,110,17451,17451,16453,15971,15543
17575,3488,4691,0,17575,6278,11297,2.42453e+15,59.3964,6083.46,17575,2280,72,12884,12884,11113,10058,9099
21710,2201,9404,0,21710,8400,13310,1.87597e+15,56.7756,10744.6,21710,4575,72,12306,12306,7056,6359,2727
19049,6844,9886,18339,710,18339,710,4.088e+18,92.1674,11109.8,19049,4743,111,9163,9163,8036,9110,7498
18475,2224,4328,6488,11987,0,18475,9.92844e+12,59.9106,5820.34,18475,2108,72,14147,14147,11032,13607,7366
13515,667,3363,4776,8739,0,13515,9.6772e+12,59.5246,4520.65,13515,1626,72,10152,10152,6576,9532,2328
15649,679,687,0,15649,15201,448,3.60173e+16,20.0738,1873.66,15649,86,26,14962,14962,14954,14946,14937
35486,4343,10599,33576,1910,33576,1910,3.44959e+18,96.8255,13193.2,35486,5044,111,24887,24887,19570,21554,10919
46200,5207,14898,43800,2400,43800,2400,4.73957e+18,96.9443,17998.6,46200,7125,111,31302,31302,24247,23553,11718
25846,152,208,25824,22,25846,0,6.10291e+18,201.074,2137.85,25846,166,162,24708,22961,18983,19144,18543
12095,1367,3273,0,12095,0,12095,6.25772e+17,96.5532,4476.83,12095,1576,110,8822,8822,6571,4835,4728
18576,5,14,18031,545,18497,79,1.75513e+14,10.6498,450.789,18576,13,12,17188,15689,13403,12893,8372
21760,7464,9533,20820,940,20820,940,3.09888e+18,94.2877,11050.9,21760,4557,111,12227,12227,12227,12023,10283
21708,65,794,0,21708,21090,618,3.56404e+16,111.467,2360.6,21708,108,26,20834,20794,16634,16849,4966
23706,3322,6967,22435,1271,22435,1271,6.73721e+18,96.6082,8917.71,23706,3361,110,16739,16739,16068,16069,8754
36248,2,15,35208,1040,36191,57,1.47346e+14,10.6987,613.907,36248,13,11,21171,15376,13702,14477,10865
34454,5122,10116,12481,21973,0,34454,9.1117e+12,59.0704,12416.4,34454,4922,72,24338,24338,18485,23328,11437
37667,3383,8815,0,37667,0,37667,6.48164e+17,97.8153,11789.2,37667,4271,110,28852,28852,20433,18358,12531
31847,906,981,0,31847,30937,910,3.55616e+16,197.997,3193.78,31847,144,26,30866,30866,30667,30657,29625
14504,4861,5756,14504,0,13764,740,5.90722e+18,128.849,6685.01,14504,1604,124,8748,8748,8372,8653,7406
6782,2515,2561,0,6782,0,6782,5.33464e+17,93.3282,3265.79,6782,1224,92,4221,4221,4197,4205,4210
33368,405,7793,11725,21643,0,33368,9.87496e+12,60.0189,10190.3,33368,3790,72,25575,25575,7520,20558,1687
14934,3342,4095,5358,9576,0,14934,9.38293e+12,59.2076,5310.99,14934,1989,72,10839,10839,9928,10642,8568
35886,37,206,35868,18,35886,0,5.98076e+18,186.835,2318.75,35886,177,171,19866,6193,6353,8340,6633
13176,1986,3227,12406,770,12406,770,4.00144e+18,97.6562,4526.26,13176,1520,111,9949,9949,8667,9856,6635
46646,11562,18045,17666,28980,0,46646,7.91349e+12,57.64,20666.1,46646,8790,72,28601,28601,21385,27353,12679
6044,347,390,0,6044,5869,175,4.10004e+16,19.6466,1000.27,6044,60,26,5654,5654,5575,5573,5054
32535,908,994,0,32535,31604,931,3.55648e+16,203.39,3251.22,32535,147,26,31541,31541,31319,31303,30103
7003,1903,2173,6623,380,6623,380,5.67795e+18,95.8565,2940.96,7003,1023,96,4830,4830,4830,4830,4352
37872,96,176,37771,101,37872,0,6.13168e+18,171.882,2408.57,37872,163,164,33830,25480,20143,20751,20883
37542,1205,18620,36102,1440,0,37542,1.46944e+18,90.9844,20765.6,37542,9030,110,18922,18504,10912,9092,2284
4525,419,1103,0,4525,1586,2939,2.4987e+15,58.7761,1617.39,4525,523,70,3422,3422,2445,1620,1421
12559,2441,2975,0,12559,4417,8142,2.52734e+15,59.767,4083.31,12559,1444,72,9584,9584,8806,8294,8026
675,443,675,675,0,0,675,3.50117e+15,0,675,675,330,21,0,0,0,0,0
36684,9977,13625,34932,1752,34932,1752,7.74057e+18,94.8734,16121.8,36684,6601,110,23059,23059,21901,21715,17518
15303,1865,3560,0,15303,5372,9931,2.5289e+15,59.8154,4854.53,15303,1719,72,11743,11743,9267,8019,6369
39127,5253,9101,0,39127,13747,25380,2.5337e+15,60.0622,11831.9,39127,4429,72,30026,30026,24450,19848,17726
22276,7492,10955,21403,873,21403,873,5.73171e+18,94.1784,12382.4,22276,5272,111,11321,11321,9998,11231,8155
29339,1463,6816,10303,19036,0,29339,9.89949e+12,60.011,8977.9,29339,3314,72,22523,22523,11012,19436,5162
24811,9386,14959,10340,14471,0,24811,5.13435e+12,49.5157,16092.2,24811,7265,72,9852,9852,8037,9472,5150
32835,12081,15600,31523,1312,31523,1312,9.27832e+18,93.9353,17594.4,32835,7567,110,17235,17235,16729,16652,15051
45339,8429,13651,45339,0,42691,2648,4.84632e+18,315.49,15876.5,45339,5381,129,31688,31496,26847,29345,21079
5606,704,1782,0,5606,2054,3552,2.28801e+15,58.0246,2337.82,5606,868,72,3824,3824,2695,2742,2176
36908,14,15,35826,1082,36815,93,1.71571e+14,10.3471,640.789,36908,14,12,36893,36893,36647,36647,36491
7998,764,1955,7528,470,7528,470,3.91468e+18,97.0784,2860.24,7998,916,104,6043,6043,4351,5242,2903
39903,37,208,39819,84,39903,0,6.05777e+18,203.129,2628.9,39903,181,174,22584,7237,7344,8978,7110
18617,414,893,0,18617,18076,541,4.03657e+16,180.816,2561.15,18617,125,26,17724,17484,14659,15046,10430
15045,1633,7074,14435,610,0,15045,1.55387e+18,67.2907,8196.81,15045,3417,110,7971,7971,4727,4064,0
35706,14331,14853,35706,0,33936,1770,4.92606e+18,333.325,16424.8,35706,5762,134,20853,20847,20853,20853,20816
48350,7484,11258,45537,2813,45537,2813,3.35267e+18,97.8832,14886.8,48350,5454,110,37092,37092,29503,32894,25826
42211,2727,9855,14849,27362,0,42211,9.88502e+12,60.0665,12757.2,42211,4801,72,32356,32356,18295,28660,9351
506,182,249,0,506,183,323,1.72187e+15,44.9664,326.08,506,109,33,257,247,219,163,220
34857,7090,8119,12251,22606,0,34857,9.89148e+12,60.0628,10605.7,34857,3954,72,26738,26738,25230,26478,23545
15456,2168,4044,0,15456,5503,9953,2.44517e+15,59.3646,5306.91,15456,1967,72,11412,11412,9222,6507,5666
47251,9245,11280,44501,2750,44501,2750,3.57809e+18,98.35,14743.2,47251,5333,111,35971,35971,35971,35971,30243
37411,645,1602,0,37411,36316,1095,4.33644e+16,301.243,5157.61,37411,269,26,35809,34720,29375,30287,18091
32295,1358,14118,0,32295,12512,19783,1.85801e+15,56.4816,15942.9,32295,6855,72,18177,18177,9285,4083,1277
49376,379,11493,17365,32011,0,49376,9.88963e+12,60.0976,14800.6,49376,5599,72,37883,37883,21718,35096,1874
45182,3754,10528,42552,2630,0,45182,2.22966e+18,97.8904,13968.5,45182,5094,110,34654,34654,23228,21232,13861
767,4,11,742,25,767,0,1.86794e+14,8.6193,81.3154,767,11,11,679,617,472,561,397
35991,6308,15587,34441,1550,34441,1550,8.66852e+18,94.6528,17858.7,35991,7577,110,20404,20404,18124,17744,9067
40750,9474,9519,38379,2371,0,40750,2.22841e+18,97.839,12685.8,40750,4614,110,31231,31231,31196,31207,31216
13791,1532,3527,13009,782,13009,782,6.00563e+18,96.8159,4877.46,13791,1687,110,10264,10264,9208,9045,5276
39747,7363,9279,37429,2318,0,39747,2.23037e+18,97.8758,12383.7,39747,4497,110,30468,30468,28369,27544,25093
48730,14366,16842,46310,2420,0,48730,1.90293e+18,95.2297,20062.3,48730,8164,110,31888,31888,30072,29633,28270
10281,61,444,2998,7283,2998,7283,1.74241e+18,15.9707,817.181,10281,438,17,9837,9837,4903,6412,7553
40376,4196,9390,0,40376,14190,26186,2.53073e+15,60.0693,12195.5,40376,4562,72,30986,30986,23690,16280,14191
13586,384,4256,0,13586,0,13586,5.84447e+17,95.1739,5514.75,13586,2049,110,9330,9158,5621,1384,1452
30459,357,9629,11145,19314,0,30459,8.81061e+12,57.7335,11662.4,30459,4682,72,20830,20712,6651,10892,396
40185,1735,9348,14122,26063,0,40185,9.89737e+12,60.0695,12136.3,40185,4553,72,30837,30837,13965,26275,6222
43987,5797,10310,41427,2560,0,43987,2.22683e+18,97.8695,13669.3,43987,4997,110,33677,33677,28574,26603,20046
42304,4712,23118,0,42304,0,42304,3.84164e+17,91.2889,25286.6,42304,11222,110,19186,19186,12354,7358,5400
32558,435,1057,0,32558,31627,931,3.66861e+16,219.057,3442.39,32558,160,26,31501,31066,28230,27967,16754
3331,747,809,1174,2157,0,3331,1.01959e+13,58.6034,1217.11,3331,393,63,2522,2522,2443,2502,2445
45436,106,176,45325,111,45436,0,6.08746e+18,172.908,2637.61,45436,172,171,41596,31490,25991,26895,27477
15044,8,14,14602,442,15000,44,1.66876e+14,10.6212,393.807,15044,13,11,14743,14490,12100,12054,8722
40173,6806,11490,37973,2200,37973,2200,3.40211e+18,97.5997,14384.4,40173,5465,111,28683,28683,21048,22543,17304
45259,6525,16404,0,45259,16943,28316,2.10397e+15,58.0131,19047.7,45259,7985,72,28855,28855,21229,18079,10400
6198,1951,3841,0,6198,2599,3599,1.26297e+15,46.2827,4233.81,6198,1857,67,2357,2357,1630,1195,1006
2007,391,565,0,2007,0,2007,6.37885e+17,90.3931,890.542,2007,246,57,1442,1442,1274,1296,1226
21008,7407,7895,0,21008,0,21008,5.29858e+17,95.315,9517.7,21008,3821,110,13113,13113,12993,12763,12989
35648,3717,8352,33575,2073,33575,2073,5.76786e+18,97.7813,11199.4,35648,4039,110,27296,27296,24488,24034,13268
3696,980,1000,3486,210,3486,210,3.25142e+18,94.1694,1512.64,3696,468,76,2696,2696,2695,2696,2696
14347,2765,3726,13527,820,13527,820,2.33499e+18,97.3944,5089.33,14347,1751,111,10621,10621,9830,10576,9243
44318,4343,10766,0,44318,15653,28665,2.49937e+15,59.9226,13756.4,44318,5243,72,33552,33552,24757,15523,14046
47635,13629,15160,47099,536,44859,2776,4.5235e+18,326.798,17126.6,47635,2862,138,32475,32473,31921,32455,30077
18637,167,176,18559,78,18637,0,6.07345e+18,170.621,1687.1,18637,144,145,18393,18194,17623,17538,17520
23683,3148,5685,22313,1370,0,23683,2.21457e+18,97.1996,7749.94,23683,2733,110,17998,17998,14739,14039,10958
41192,414,1732,12017,29175,12017,29175,1.74423e+18,15.9933,2495,41192,1727,17,39460,39460,22373,27621,31568
21045,2805,7910,21045,0,19938,1107,3.53329e+18,166.573,9128.1,21045,3267,124,13135,12977,8119,9968,4308
12660,1010,4722,12050,610,12050,610,3.75908e+18,91.3631,5826.02,12660,2240,111,7938,7938,4839,4986,1641
8801,1460,2615,8321,480,8321,480,3.70771e+18,91.0915,3536.87,8801,1214,111,6186,6186,5539,5924,3160
7106,1164,4156,0,7106,0,7106,3.60288e+17,78.4533,4704.28,7106,1984,83,2950,2950,1550,1704,1304
28097,7462,9703,26697,1400,0,28097,1.90792e+18,95.8997,11802.6,28097,4695,110,18394,18394,17294,16787,15770
38268,3007,9722,36086,2182,36086,2182,4.94395e+18,98.0376,12608.3,38268,4603,111,28546,28546,20986,24441,10244
2922,483,1039,1090,1832,0,2922,8.71742e+12,51.7509,1371.71,2922,500,61,1883,1883,1234,1764,641
7840,1174,3386,7490,350,7490,350,3.28574e+18,91.1032,4111.8,7840,1608,92,4454,4367,3662,3662,3197
27656,210,12330,0,27656,10748,16908,1.83164e+15,56.6216,13922.3,27656,6003,72,15326,14846,8751,4834,890
32746,7173,10011,32746,0,30839,1907,3.57246e+18,228.21,11751.6,32746,3602,130,22735,22683,20542,21075,16811
11377,194,2693,0,11377,0,11377,6.5063e+17,97.0028,3886.13,11377,1288,110,8684,8684,5262,1872,1210
49034,992,1297,0,49034,47637,1397,3.556e+16,264.642,4575.38,49034,208,26,47737,47737,45488,45857,41418
23322,2,176,23309,13,23322,0,5.98299e+18,169.444,1811.31,23322,155,162,1145,34,59,34,150
49735,11279,18099,47315,2420,47315,2420,1.7521e+18,96.4718,21229.8,49735,8665,111,31636,31636,31636,31480,18766
22652,1055,12804,22652,0,21872,780,5.14067e+18,386.992,14035.5,22652,4025,135,9848,8741,5329,6601,1858
2285,551,1150,902,1383,0,2285,6.69005e+12,53.6691,1381.56,2285,553,54,1135,1087,788,1037,478
19857,68,208,19781,76,19857,0,6.01508e+18,189.698,1807.51,19857,154,161,14610,8183,5942,6982,6711
48170,6,17,46757,1413,48086,84,1.70311e+14,10.4283,751.133,48170,13,12,46033,44797,41758,32515,21105
8830,845,2068,3105,5725,0,8830,9.93811e+12,59.6119,2916.56,8830,1001,72,6762,6762,4820,6282,2908
49135,12712,17447,49135,0,46512,2623,4.67371e+18,361.81,19745.3,49135,5124,140,31688,31603,29233,30967,25500
32264,352,923,0,32264,31117,1147,1.14438e+16,7.93107,5035.29,32264,237,10,31341,31341,29757,30370,24353
49963,11570,14121,18004,31959,0,49963,9.24652e+12,59.3101,17282.6,49963,6878,72,35842,35842,33050,35361,29784
25957,1184,1433,0,25957,25186,771,4.77812e+16,275.299,4344.27,25957,233,26,24524,24524,24214,24182,22389
1377,111,170,1377,0,1377,0,5.96723e+18,113.304,437.239,1377,65,53,1168,991,883,885,865
49830,8,10,49017,813,49734,96,9.79373e+13,3.99845,628.171,49830,7,4,49820,49820,49820,49818,47228
34451,162,1395,0,34451,33448,1003,4.15475e+16,278.419,4472.7,34451,227,26,32600,32191,23641,21925,8858
45937,6905,23730,45937,0,45937,0,3.60883e+18,17.9779,24337.6,45937,21340,20,22207,22207,6436,22207,6483
34021,4792,7982,32041,1980,0,34021,2.22805e+18,97.7463,10722.8,34021,3861,110,26039,26039,21757,20832,16632
47659,5232,11103,0,47659,16758,30901,2.53322e+15,60.0841,14311.7,47659,5409,72,36556,36556,28066,19547,17750
932,112,333,882,50,882,50,5.54467e+18,80.5064,504.239,932,131,47,599,285,332,422,256
868,105,361,820,48,0,868,2.02018e+18,72.1855,511.091,868,152,40,507,230,314,227,3
19660,3966,4639,18513,1147,0,19660,2.23052e+18,97.5119,6435.7,19660,2236,110,15021,15021,14270,13991,13344
24180,5,12,23479,701,24166,14,1.53624e+14,10.209,450.855,24180,11,12,22264,19836,19601,19508,13041
31634,9086,17439,30554,1080,30554,1080,2.39254e+18,92.3508,19162.1,31634,8464,110,14195,14195,8843,10667,7601
7527,3123,3200,7527,0,7139,388,4.86071e+18,91.9288,3749.07,7527,1266,108,4327,4327,4304,4314,4313
28765,1155,1290,0,28765,27922,843,4.27711e+16,271.247,4016.2,28765,206,26,27475,27475,27271,27315,26377
22661,8,12,22002,659,22641,20,1.60754e+14,10.2095,443.685,22661,12,11,22219,21932,20491,19782,15198
42444,12126,13458,42444,0,40024,2420,4.30659e+18,299.379,15553.3,42444,5372,128,28986,28984,28784,28898,28454
12054,380,3481,0,12054,0,12054,6.06397e+17,96.2378,4661.82,12054,1672,110,8573,8487,5350,3235,1799
21669,24,176,21618,51,21669,0,6.05666e+18,170.396,1815.45,21669,153,150,9768,2458,2899,2930,2854
23972,541,5598,8418,15554,0,23972,9.88402e+12,59.9417,7435.15,23972,2716,72,18374,18374,11004,17104,2057
8802,809,2099,0,8802,0,8802,6.57535e+17,96.6234,3080.99,8802,1003,109,6703,6703,4944,2707,3055
27469,10293,13360,27469,0,26319,1150,4.4329e+18,369.359,14805.3,27469,6131,131,14109,14031,13254,13747,12570
6641,7,11,6450,191,6635,6,1.47116e+14,10.4779,232.365,6641,11,11,6400,6230,4889,4850,4627
22731,3355,5767,21441,1290,0,22731,2.1753e+18,97.2566,7739.63,22731,2782,110,16964,16964,13979,13317,10634
36952,3632,9553,0,36952,0,36952,6.26572e+17,97.4254,12410.5,36952,4621,110,27399,27399,20083,11246,11178
48594,1951,27753,19988,28606,0,48594,5.52844e+12,54.3599,29786.6,48594,13506,72,20841,20841,11766,19300,1026
12296,602,2917,4326,7970,0,12296,9.94488e+12,59.7126,4001.16,12296,1420,72,9379,9379,4265,7983,1881
37934,868,1089,0,37934,36854,1080,3.55406e+16,226.058,3678.32,37934,166,26,36845,36845,35333,35566,32450
45966,5,13,44656,1310,45944,22,1.38729e+14,10.2757,610.914,45966,12,12,42244,37578,36905,38121,23066
5456,647,1329,5136,320,5136,320,3.35783e+18,95.8103,2024.21,5456,626,89,4127,4127,2797,3402,2402
41178,496,1901,0,41178,39964,1214,4.58178e+16,317.972,6132.96,41178,329,26,39277,37829,29861,31185,11509
2487,218,902,2487,0,2339,148,4.2248e+18,88.2537,1200.53,2487,315,67,1585,1585,818,1108,633
12390,2425,2986,11670,720,11670,720,5.94209e+18,96.9734,4249.84,12390,1429,110,9404,9404,9272,9274,8095
49791,887,1736,0,49791,48924,867,2.55373e+16,3.73588,6620.51,49791,869,4,48055,48055,47970,47461,34356
42778,53,176,42698,80,42778,0,5.98484e+18,171.995,2451.28,42778,170,171,27992,13918,11128,13204,12903
22770,481,7532,22770,0,21450,1320,3.61842e+18,159.327,8708.7,22770,2733,124,15238,15109,6095,10413,1332
21999,2,11,21371,628,21987,12,1.42868e+14,10.1731,419.042,21999,11,11,12773,9149,8507,9252,7383
28171,6198,16030,27242,929,0,28171,1.26189e+18,92.4008,17559.1,28171,7784,110,12141,12141,9059,8526,5972
27407,5,12,26628,779,27397,10,1.39007e+14,10.3333,468.207,27407,12,11,25163,22402,18125,18716,15826
44554,164,176,44485,69,44554,0,6.07275e+18,172.183,2607.98,44554,169,172,44144,43583,41548,41166,41525
47427,12,14,46075,1352,47347,80,1.38936e+14,10.5546,679.861,47427,13,12,47412,47408,46912,46911,45194
5122,392,1218,1797,3325,0,5122,9.94792e+12,59.2599,1784.85,5122,591,72,3904,3904,2361,3478,1398
35844,2430,13364,34134,1710,34134,1710,2.98838e+18,95.5867,15808.9,35844,6488,110,22480,22480,10701,15536,5824
20946,9,11,20350,596,20938,8,1.39259e+14,10.1254,404.849,20946,11,11,20672,20362,19244,19245,17288
48460,3024,13399,45776,2684,45776,2684,2.34032e+18,97.8226,16791.3,48460,6383,111,35061,35061,11746,21974,9587
26756,3265,6335,25206,1550,25206,1550,5.77727e+18,97.6009,8607.73,26756,3056,110,20421,20421,18592,18293,11401
16369,1319,5636,16369,0,15438,931,5.24704e+18,134.781,6584.74,16369,2067,121,10733,10670,6709,8424,3108
45209,3008,14204,0,45209,16535,28674,2.2602e+15,58.7737,17009.9,45209,6907,72,31005,31005,20060,9587,6794
43091,15417,19605,16842,26249,0,43091,7.03901e+12,56.5492,21839.4,43091,9551,72,23486,23486,21582,23158,19508
40659,8872,19101,15985,24674,0,40659,6.85082e+12,55.5913,21187.6,40659,9288,72,21558,21558,17048,20788,11786
19332,3595,7255,19332,0,18312,1020,4.87292e+18,143.708,8401.97,19332,2978,125,12077,12077,9350,10435,6630
37171,1793,8698,35008,2163,0,37171,2.229e+18,97.8079,11640.5,37171,4215,110,28473,28473,19101,17539,7488
20548,19,61,20484,64,20548,0,2.2604e+18,60.6392,1067.89,20548,61,61,10735,1008,3547,4693,6129
44917,18103,18671,42919,1998,42919,1998,2.7382e+18,94.5029,21432,44917,9057,110,26246,26246,25727,26117,25356
47234,1,13,45887,1347,47213,21,1.38932e+14,10.2498,619.752,47234,12,12,12096,12096,12096,12096,12096
9793,11,423,0,9793,9513,280,3.56719e+16,19.994,1188.9,9793,63,26,8700,8092,7100,6854,1570
7556,632,2737,0,7556,2820,4736,2.12911e+15,57.0393,3397.62,7556,1316,72,4819,4771,3361,2464,1807
42749,123,176,42666,83,42749,0,5.97915e+18,172.147,2450.71,42749,170,172,40374,36919,29674,29900,29958
41543,6517,9992,39125,2418,39125,2418,2.6035e+18,98.3262,13113.8,41543,4734,111,31551,31551,24436,26280,21622
36547,4851,14862,36547,0,34697,1850,4.98603e+18,251.851,16405.2,36547,5088,136,21685,21536,14665,17992,7536
35103,2562,8216,33055,2048,33055,2048,3.23199e+18,97.8073,11025.1,35103,3979,110,26887,26887,17897,22511,9617
31222,9050,11982,29755,1467,29755,1467,7.93623e+18,78.9243,14152.5,31222,5799,110,19240,19240,17558,17294,11007
34817,14,16,33775,1042,34749,68,1.92886e+14,10.4015,655.349,34817,13,12,34801,34801,34518,34518,31492
6979,351,2347,2578,4401,0,6979,8.63987e+12,57.8093,2988.05,6979,1137,72,4632,4584,2941,3987,1215
39512,5790,10367,37292,2220,37292,2220,3.31573e+18,97.3887,13360.3,39512,5024,110,29145,29145,21159,24663,17401
9625,2924,3024,3509,6116,0,9625,8.82412e+12,58.272,3858.83,9625,1457,72,6601,6601,6512,6581,6475
10234,620,5544,10234,0,9826,408,5.776e+18,139.367,6151.78,10234,1354,113,4690,4316,2640,3240,27
5584,56,1388,0,5584,0,5584,6.44593e+17,95.4516,2091.04,5584,644,89,2656,672,1144,167,316
45183,6274,13047,0,45183,16333,28850,2.34806e+15,58.5999,15936.2,45183,6350,72,32136,32136,24961,16173,16281
16240,4699,9462,15720,520,0,16240,1.22732e+18,85.1927,10459.6,16240,4568,110,6778,6778,5063,4746,3656
30048,5856,7039,10563,19485,0,30048,9.8778e+12,59.9975,9237.99,30048,3421,72,23009,23009,21401,22729,19598
12560,2819,2932,4411,8149,0,12560,9.87221e+12,59.706,4043.3,12560,1413,72,9628,9628,9528,9608,9458
38398,994,1202,0,38398,37296,1102,3.7091e+16,243.703,4022.93,38398,189,26,37196,37196,36582,36562,33040
31372,18042,31372,0,31372,0,31372,524271,0,31372,31372,31372,1,0,0,0,0,0
49393,15724,17953,47003,2390,47003,2390,7.7928e+18,95.3054,21135.9,49393,8723,110,31440,31440,31170,31170,28530
18716,221,4418,17626,1090,17626,1090,5.74465e+18,97.4698,6150.51,18716,2128,110,14298,14298,10569,7939,1654
32522,4769,11753,32522,0,30735,1787,3.84706e+18,218.011,13214.9,32522,4565,126,20769,20703,13075,16372,8494
8934,273,2996,8474,460,8474,460,7.11709e+18,95.2383,3898.13,8934,1437,102,5938,5852,4609,3803,1346
23030,122,176,23015,15,23030,0,6.07001e+18,171.899,1873.59,23030,155,153,21680,19678,15781,15918,15854
3670,27,176,3670,0,3670,0,6.10404e+18,132.671,746.294,3670,86,89,1776,481,582,641,672
19314,4902,6703,0,19314,0,19314,5.53285e+17,95.6729,8278.56,19314,3241,110,12611,12611,11495,9778,9941
43129,6533,10311,40619,2510,40619,2510,3.63856e+18,98.3293,13531.5,43129,4871,111,32818,32818,28861,32541,21943
28086,4889,11238,26789,1297,26789,1297,3.59507e+18,95.7134,13160.9,28086,5387,111,16848,16848,13260,15497,8675
6775,1079,1598,2384,4391,0,6775,9.94411e+12,59.4326,2293.15,6775,773,72,5177,5177,4418,5039,3672
48062,17946,24200,19187,28875,0,48062,6.39652e+12,55.1711,26468.2,48062,11767,72,23862,23862,21112,23392,17990
19392,4170,6402,19392,0,18263,1129,5.94943e+18,146.97,7465.86,19392,2323,124,12990,12990,11433,12280,8974
7215,766,1704,2538,4677,0,7215,9.8877e+12,59.4274,2434.21,7215,819,72,5511,5511,4163,5279,2659
23656,5080,11984,0,23656,5165,18491,1.34412e+13,8.97933,12297.3,23656,10783,11,11672,11672,6387,11672,5788
42587,622,11922,40257,2330,40257,2330,3.14954e+18,97.1314,15041.1,42587,5776,110,30665,30407,14219,20293,3026
31109,77,176,31027,82,31109,0,6.05123e+18,172.668,2166.48,31109,165,165,25037,15952,12580,13724,13545
13791,189,706,0,13791,13395,396,3.80535e+16,33.419,1864.77,13791,90,26,13085,13065,11207,11380,3426
20818,281,771,0,20818,20226,592,3.54992e+16,93.097,2269.44,20818,103,26,20047,19955,17974,18111,10407
8647,971,3806,3345,5302,0,8647,7.26788e+12,53.2715,4468.84,8647,1847,72,4841,4820,2717,2699,146
43010,9841,18792,41170,1840,41170,1840,2.69918e+18,93.4703,21387.4,43010,9115,110,24218,24218,20374,23270,14880
30355,328,10517,0,30355,0,30355,5.5402e+17,95.962,12735.6,30355,5104,110,19838,19322,11724,4265,2284
23441,4264,9713,17750,5691,22388,1053,3.82872e+18,92.4497,11364.4,23441,4650,111,13728,13728,8776,9727,7489
574,59,161,574,0,574,0,5.95743e+18,72.7979,279.365,574,45,36,339,184,170,186,201
24125,19,176,24115,10,24125,0,6.03768e+18,170.275,1904.77,24125,153,158,9358,1793,2484,2460,2420
5951,502,1484,0,5951,2095,3856,2.48438e+15,59.0339,2109.73,5951,712,72,4467,4467,2729,1782,1580
46439,1179,24489,0,46439,18746,27693,1.56361e+15,55.4127,26607,46439,11927,72,21950,21950,12638,1114,1563
2404,7,10,2335,69,2404,0,1.38279e+14,9.72795,135.208,2404,10,10,2313,2230,2064,2065,1811
30683,4595,9796,11247,19436,0,30683,8.78302e+12,57.9919,11830.9,30683,4754,72,20887,20887,16758,20177,11849
45541,2451,10662,0,45541,0,45541,6.47709e+17,97.8806,14118,45541,5170,110,34879,34879,18375,13189,9749
26333,6780,10160,0,26333,9963,16370,2.03097e+15,57.5603,11819.8,26333,4943,72,16173,16173,14368,13355,11509
32546,6611,16931,0,32546,7080,25466,1.3497e+13,8.98322,17294.1,32546,15230,11,15615,15615,8574,15615,7964
38082,2799,12041,36101,1981,0,38082,1.99149e+18,96.4105,14783.5,38082,5841,110,26041,26041,16143,13376,8203
7219,727,2531,0,7219,0,7219,5.55123e+17,94.4696,3292.26,7219,1209,100,4688,4605,3446,2223,2380
30985,2339,7460,29177,1808,29177,1808,4.38574e+18,98.2163,9940.67,30985,3528,111,23525,23525,13753,16518,8526
28325,38,176,28270,55,28325,0,6.09182e+18,172.832,2083.4,28325,156,160,16690,5340,5827,6324,5719
32717,4027,14063,0,32717,12635,20082,1.88279e+15,56.8948,15921.6,32717,6845,72,18654,18654,11952,7620,5973
8702,1523,3345,0,8702,0,8702,5.3294e+17,94.3534,4179.78,8702,1609,107,5357,5357,4091,3377,2646
5661,2480,2541,2198,3463,0,5661,7.2008e+12,48.4526,3023.82,5661,1215,69,3120,3120,3120,3120,3120
42722,8816,13637,42722,0,40232,2490,4.16822e+18,297.37,15455.8,42722,3750,134,29085,28925,24302,26126,19972
39695,6,14,38552,1143,39611,84,1.48825e+14,10.5549,632.898,39695,14,12,37775,36816,33422,31395,24181
37937,18499,19070,0,37937,15134,22803,1.64376e+15,55.7611,20945,37937,9287,72,18867,18867,18809,18754,18835
6426,2051,2313,0,6426,0,6426,5.54289e+17,94.2077,3004.83,6426,1102,91,4113,4113,3859,3845,3848
19035,1999,8327,18208,827,18208,827,6.25271e+18,94.1595,9700.76,19035,3994,111,10708,10708,7730,10708,4049
17677,166,175,17608,69,17677,0,5.98496e+18,165.614,1574.38,17677,147,154,17452,17253,16781,16784,16803
22850,5236,5332,8024,14826,0,22850,9.88614e+12,59.9544,7101.92,22850,2592,72,17518,17518,17409,17491,17349
48539,10643,30719,47186,1353,47186,1353,2.13831e+18,91.5443,32763.9,48539,14937,110,17820,17820,8111,11183,5871
18421,2751,8099,17631,790,0,18421,1.64159e+18,94.1798,9452.2,18421,3918,110,10322,10322,7153,6405,3947
1475,135,424,0,1475,0,1475,6.78949e+17,89.0061,681.17,1475,188,51,1051,677,679,268,478
22673,2235,7311,21503,1170,21503,1170,7.00439e+18,96.2124,9140.21,22673,3541,110,15362,15362,13370,13038,5535
14862,606,734,0,14862,14435,427,3.81282e+16,59.1745,1976.3,14862,95,26,14128,14084,13841,13849,11983
13742,1,13,13341,401,13699,43,1.61569e+14,10.8527,376.668,13742,12,11,2920,2920,2920,2920,2920
36530,836,8754,34400,2130,34400,2130,3.09463e+18,98.3046,11579.8,36530,4143,111,27776,27776,11926,16735,4413
43285,3950,11393,40843,2442,40843,2442,2.14489e+18,97.9635,14539.2,43285,5401,111,31892,31892,21918,25086,12525
1969,484,508,683,1286,0,1969,9.99104e+12,57.3443,784.217,1969,246,55,1461,1461,1439,1451,1437
29455,3482,14159,28287,1168,0,29455,1.51589e+18,91.3143,15980,29455,6874,110,15296,15296,9713,8366,3925
7590,2,11,7373,217,7589,1,1.38253e+14,10.2659,241.069,7590,11,11,4382,3092,3052,3229,2570
35233,490,8255,33183,2050,33183,2050,3.35283e+18,97.784,11076.1,35233,3989,110,26978,26978,11262,18350,3235
22756,327,807,0,22756,22109,647,3.5519e+16,118.773,2429.8,22756,110,26,21949,21813,19805,19920,12469
20114,385,1235,0,20114,19512,602,4.88074e+16,275.731,3597.63,20114,196,26,18874,18230,16226,14684,7270
22402,3674,5228,0,22402,7866,14536,2.53614e+15,59.9663,6968.07,22402,2545,72,17174,17174,15272,13964,12224
15591,74,175,15586,5,15591,0,5.98871e+18,165.111,1479.14,15591,148,147,12056,6745,5973,6773,6782
31794,215,1342,30469,1325,9273,22521,1.26484e+18,16.99,2030.71,31794,1336,18,30452,30452,24824,25949,12525
7111,1674,2726,0,7111,0,7111,5.32203e+17,90.8536,3451.76,7111,1293,100,4385,4385,4355,4271,4379
21959,677,861,0,21959,21329,630,3.72512e+16,155.109,2567.23,21959,121,26,21098,20897,20618,20581,18074
7393,2,13,7182,211,7361,32,1.44907e+14,10.8277,265.879,7393,12,11,4314,3112,2857,3017,2286
30273,2377,30273,30273,0,0,30273,134213000,0,30273,30273,30273,1,0,0,0,0,0
40571,190,206,40492,79,40571,0,5.98423e+18,195.078,2470.5,40571,179,175,40347,40212,37960,37894,38136
41623,5436,21739,0,41623,16759,24864,1.57743e+15,54.8082,23699.5,41623,10568,72,19884,19884,12544,12963,4777
2770,254,750,0,2770,987,1783,2.45928e+15,57.7321,1098.96,2770,360,62,2020,2020,1407,755,865
44205,7,15,42935,1270,44120,85,1.45102e+14,10.5761,678.027,44205,13,12,42726,41818,32853,32832,28269
28849,1608,1820,8842,20007,8842,20007,2.01339e+18,15.995,2453.04,28849,910,26,27029,27029,26817,27029,24818
34117,17645,34117,0,34117,0,34117,524273,0,34117,34117,34117,1,0,0,0,0,0
18505,6564,6972,17615,890,17615,890,5.87787e+18,92.8623,8422.41,18505,3313,117,11533,11533,11533,11533,11067
19019,1081,6296,19019,0,17916,1103,3.61928e+18,145.097,7346.38,19019,2281,124,12723,12639,6558,9270,2671
24950,2439,5859,8776,16174,0,24950,9.87092e+12,59.9891,7756.59,24950,2852,72,19091,19091,13837,17818,8172
15178,2,12,14744,434,15169,9,1.38939e+14,10.311,346.847,15178,12,11,8779,6214,6004,6258,4397
25438,1984,10348,0,25438,0,25438,5.03219e+17,94.9328,12152.2,25438,5018,110,15090,15090,8809,2863,2856
26266,7811,8361,0,26266,9626,16640,2.25136e+15,58.5911,10164.7,26266,4064,72,17905,17905,17338,17182,16582
22667,7302,9748,22667,0,21587,1080,3.80863e+18,185.461,10985.2,22667,4204,128,12919,12883,11472,11914,10630
9357,205,4916,0,9357,3765,5592,1.57997e+15,51.5414,5540.38,9357,2374,72,4441,4297,2028,834,765
24279,15747,24279,24279,0,0,24279,134212000,0,24279,24279,24279,1,0,0,0,0,0
45807,10082,15900,43528,2279,0,45807,1.90192e+18,96.1043,18954.2,45807,7727,110,29907,29907,26676,25163,21411
46346,6684,13642,43846,2500,43846,2500,5.62481e+18,97.4896,16854.4,46346,6499,111,32704,32704,28891,30886,17368
21250,6724,8969,8182,13068,0,21250,7.47333e+12,56.9574,10308.8,21250,4364,72,12281,12281,11051,12064,9741
39048,695,1265,0,39048,37925,1123,3.77247e+16,262.346,4216.39,39048,201,26,37783,37660,32759,33420,25903
34475,3400,12116,32770,1705,32770,1705,7.45435e+18,95.9292,14549,34475,5878,110,22359,22359,19087,18553,5906
27323,4146,12710,26211,1112,0,27323,1.56226e+18,92.9208,14470.1,27323,6153,110,14613,14613,10841,9319,5545
20689,1715,6347,16596,4093,19587,1102,2.66219e+18,96.9556,8051.73,20689,3006,111,14342,14342,6421,10053,6162
38269,16538,18430,36742,1527,36742,1527,6.8789e+18,93.8968,20606.5,38269,8883,111,19839,19839,19176,19795,18540
22873,5665,8330,0,22873,8561,14312,2.09748e+15,57.8345,9857.51,22873,4047,72,14543,14543,11942,12165,8901
48446,5750,11295,0,48446,17028,31418,2.53098e+15,60.0707,14548.2,48446,5493,72,37151,37151,30551,25978,19454
32832,8347,9084,11796,21036,0,32832,9.32906e+12,59.1528,11342.5,32832,4412,72,23748,23748,22805,23585,21819
11696,8,12,11356,340,11683,13,1.66368e+14,10.4913,321.121,11696,12,11,11472,11251,10912,10455,8708
47666,123,176,47610,56,47666,0,6.0018e+18,172.177,2631.27,47666,172,172,45056,41240,32969,33238,33575
33657,929,1014,0,33657,32698,959,3.55482e+16,208.546,3339.47,33657,152,26,32643,32643,32410,32398,31065
15925,9494,10664,15520,405,0,15925,9.77258e+17,87.0094,11490.9,15925,5158,106,5261,5261,5231,5166,5255
24654,3033,8373,0,24654,0,24654,5.59855e+17,95.9547,10282.3,24654,4055,110,16281,16281,12135,8248,7609
48991,1,14,47596,1395,48910,81,1.38695e+14,10.5383,691.765,48991,13,12,12565,12565,12565,12565,12565
13487,1556,5785,12897,590,0,13487,1.67581e+18,91.6575,6880.12,13487,2777,110,7702,7702,4644,4602,2968
47229,199,240,47163,66,37617,9612,6.04946e+18,173.053,2973.88,47229,173,174,46989,46970,41362,41984,38495
24090,976,5719,22691,1399,22691,1399,5.77437e+18,97.5693,7810.99,24090,2758,110,18371,18371,15081,12503,4022
9754,745,5019,0,9754,3912,5842,1.61968e+15,55.1846,5670.06,9754,2441,72,4735,4620,3129,3213,1423
16206,53,175,16198,8,16206,0,5.98508e+18,165.086,1507.33,16206,150,148,10583,5269,4301,5038,5039
28019,928,6607,26389,1630,0,28019,2.22577e+18,97.6765,8963.14,28019,3194,110,21412,21412,13653,12396,4064
22689,16451,22689,0,22689,22689,0,2047.91,0,22689,22689,22689,1,0,0,0,0,0
27834,9380,9626,10337,17497,0,27834,8.46655e+12,58.2193,11446.4,27834,4687,72,18208,18208,18006,18160,17839
41187,6640,9850,38787,2400,38787,2400,1.36995e+18,98.327,12954.7,41187,4662,111,31337,31337,28071,31097,21967
21949,4854,5169,0,21949,0,21949,6.47451e+17,97.5399,7121.17,21949,2494,110,16780,16780,16375,16254,16144
26835,1353,6298,9438,17397,0,26835,9.87372e+12,59.9721,8306.55,26835,3061,72,20537,20537,9949,17695,4592
28661,2886,8866,28661,0,26991,1670,3.86203e+18,179.11,10436.2,28661,3431,124,19795,19595,12793,15628,6888
20508,56,5020,19318,1190,19318,1190,5.07435e+18,97.9061,6825.06,20508,2363,111,9724,2369,5209,6491,1237
17893,587,7210,17893,0,16993,900,5.04503e+18,148.73,8274.52,17893,1767,126,10683,10286,6507,7555,1625
42224,2155,9903,39764,2460,39764,2460,5.76775e+18,97.8628,13152.8,42224,4796,110,32321,32321,27649,23820,8637
24775,190,850,0,24775,24072,703,3.56144e+16,144.796,2612.63,24775,118,26,23903,23738,17282,17331,9174
15740,4300,8541,9874,5866,15180,560,4.41973e+18,91.5808,9567.63,15740,4096,111,7199,7199,5400,6812,3836
34514,5695,18983,0,34514,14062,20452,1.4866e+15,54.6789,20595.1,34514,9227,72,15531,15531,9262,6183,5109
35067,76,176,35043,24,35067,0,6.04009e+18,173.094,2298.66,35067,170,168,28204,17891,14021,15367,15083
9088,6,11,8831,257,9086,2,1.39158e+14,9.96666,265.251,9088,11,11,8651,8443,7659,7629,6324
33360,9862,10440,12197,21163,0,33360,8.85899e+12,57.9806,12636.8,33360,5064,72,22920,22920,22366,22800,21606
25178,156,176,25099,79,25178,0,6.08194e+18,170.933,1958.27,25178,158,155,24742,24164,22440,22532,22399
42118,6072,19498,41664,454,40638,1480,5.40689e+18,3223.11,23023.2,42118,7887,151,22620,17763,11660,14665,8218
1018,432,594,1018,0,975,43,6.21102e+18,77.0992,718.741,1018,242,47,424,424,349,412,423
36489,9673,13929,34771,1718,34771,1718,8.07029e+18,94.1725,16382.2,36489,6761,110,22560,22560,21892,21892,14781
43295,12139,16913,41275,2020,41275,2020,3.34952e+18,94.1527,19631,43295,8099,111,26382,26382,23851,26238,20997
16842,43,176,16799,43,16842,0,6.01728e+18,167.441,1585.5,16842,147,144,10239,3968,3677,4405,3866
38568,2461,13587,38568,0,36428,2140,4.45698e+18,242.64,15237.3,38568,3264,134,24981,24555,13040,17492,6041
15786,99,176,15706,80,15786,0,6.12989e+18,169.096,1554.97,15786,134,134,14143,10639,8612,8807,9125
19282,631,1238,0,19282,3926,15356,1.46586e+16,11.9901,1684.49,19282,794,14,18044,18044,14021,11622,16232
19172,4,12,18615,557,19159,13,1.56256e+14,10.1927,402.636,19172,12,11,16710,14833,14478,11656,8561
7833,358,3434,7833,0,7453,380,4.81012e+18,97.9256,4029.01,7833,1425,108,4399,4208,2035,2955,1100
21073,171,206,21069,4,21073,0,5.98947e+18,187.678,1784.63,21073,157,158,20637,19990,18424,18522,18225
38500,375,1368,0,38500,37389,1111,3.94389e+16,280.793,4503.17,38500,217,26,37103,36321,28322,29033,15437
16492,4966,5205,16492,0,15532,960,4.27997e+18,134.141,6282.03,16492,1979,121,11287,11287,11168,11232,11071
44172,194,1969,0,44172,42868,1304,4.52799e+16,317.84,6420.84,44172,341,26,41421,40672,34402,27162,8655
41259,420,1339,0,41259,40072,1187,3.80923e+16,269.751,4498.49,41259,217,26,39920,39147,30758,31561,16809
49864,3479,24426,0,49864,10941,38923,1.33698e+13,8.99493,24893.2,49864,21975,11,25438,25438,8807,10860,6774
21768,2362,8266,0,21768,8210,13558,2.05734e+15,57.6301,9705.84,21768,4027,72,13502,13502,8565,7213,3490
26675,850,1227,0,26675,5535,21140,1.49406e+16,11.9923,1759.43,26675,1115,14,25448,25448,22413,20234,24088
24296,4660,6032,22901,1395,0,24296,2.19246e+18,97.4225,8113.36,24296,2919,110,18264,18264,16396,16016,14364
11379,232,2708,0,11379,0,11379,6.47281e+17,96.8613,3900.48,11379,1289,110,8671,8671,5291,1729,1302
22534,2185,5291,0,22534,0,22534,6.50379e+17,97.6129,7282.64,22534,2559,110,17243,17243,12713,12011,8107
36007,2344,8389,12651,23356,0,36007,9.90565e+12,60.0581,10938.3,36007,4085,72,27618,27618,18874,26108,8228
15150,3529,3702,14270,880,14270,880,3.43738e+18,97.7079,5145.26,15150,1745,111,11448,11448,11188,11276,11235
37076,6286,8671,34916,2160,0,37076,2.22853e+18,97.8152,11608,37076,4201,110,28405,28405,25222,24691,21558
4368,105,199,4368,0,4368,0,5.97801e+18,162.664,820.571,4368,96,97,3810,2468,2209,2335,2297
35079,106,1040,0,35079,34076,1003,3.55492e+16,215.963,3455.11,35079,156,26,33755,33623,22093,21958,8492
33089,77,206,33078,11,33089,0,5.98511e+18,186.055,2239.96,33089,180,171,26017,14608,11572,13788,12975
19994,4797,5231,18870,1124,18870,1124,6.26888e+18,97.0494,7003.45,19994,2528,110,14763,14763,14654,14657,13794
19714,3220,4911,0,19714,0,19714,6.3802e+17,97.3429,6688.91,19714,2373,110,14803,14803,12488,10019,9880
2074,485,1045,1986,88,0,2074,1.58483e+18,62.3857,1300.51,2074,484,52,1029,1029,630,509,0
569,83,236,537,32,537,32,2.70335e+18,72.2004,343.619,569,83,37,289,99,134,206,132
41129,3906,9596,38732,2397,0,41129,2.22951e+18,97.8697,12784.6,41129,4654,110,31533,31533,22987,20964,14158
19828,5678,7492,18879,949,18879,949,4.74242e+18,95.8326,9014.71,19828,3579,111,12336,12336,10825,11066,10711
16841,936,5301,16841,0,15861,980,3.15689e+18,136.798,6396.08,16841,2017,124,11540,11479,6440,8023,2554
15125,1538,7652,14554,571,0,15125,1.4501e+18,92.9185,8721.49,15125,3702,110,7473,7473,4751,4139,2119
10192,395,2626,0,10192,0,10192,6.3344e+17,96.5598,3705.7,10192,1256,110,7566,7566,4835,1217,1837
25577,6507,8985,24317,1260,0,25577,1.89148e+18,94.7364,10923.4,25577,4342,110,16592,16592,15223,14931,14069
15843,1470,6470,15122,721,15122,721,3.15694e+18,95.1719,7715.6,15843,3084,111,9373,9373,4354,5272,1695
21092,220,781,0,21092,20491,601,3.56428e+16,101.6,2306.08,21092,105,26,20311,20207,17727,17884,9139
7749,439,1910,7292,457,7292,457,4.75817e+18,96.8513,2789.35,7749,881,103,5839,5839,3063,3961,1848
17184,798,8561,17184,0,16444,740,4.04373e+18,161.939,9443.31,17184,3686,124,8623,8075,4272,6184,1857
44812,1,14,43535,1277,44732,80,1.3874e+14,10.5872,659.262,44812,14,12,11492,11492,11492,11492,11492
48518,9957,18725,48518,0,46148,2370,4.53932e+18,1085.58,21314.9,48518,7899,144,29793,28730,24594,26986,22398
48957,11357,21722,0,48957,19031,29926,1.83845e+15,56.7383,24242.4,48957,10582,72,27235,27235,21860,22236,15530
23910,2,14,23211,699,23860,50,1.6513e+14,10.4392,483.333,23910,13,11,14082,10710,8399,10811,7105
4866,290,1159,0,4866,1713,3153,2.57618e+15,59.1025,1699.39,4866,564,72,3707,3707,2423,889,1028
46161,9179,14712,46161,0,43471,2690,4.2051e+18,321.283,16637.1,46161,4011,134,31449,31297,25533,27733,20925
29249,7648,10404,0,29249,10906,18343,2.12583e+15,58.0615,12280,29249,5062,72,18845,18845,16918,15959,14801
43714,6131,10143,0,43714,15355,28359,2.53637e+15,60.0867,13134.5,43714,4940,72,33571,33571,28741,27803,20687
32214,1392,1685,0,32214,31256,958,4.77924e+16,298.918,5257.03,32214,283,26,30529,30529,30072,30112,27639
14789,2070,6975,14189,600,0,14789,1.55195e+18,93.3837,8078.69,14789,3365,110,7814,7814,5464,4921,3204
42934,10751,13636,42934,0,40488,2446,4.59535e+18,297.937,15751.8,42934,5475,130,29298,29298,27178,28377,24310
29163,14443,15418,6328,22835,0,29163,52861600000,8.98183,15757.5,29163,13875,11,13745,13745,13121,13745,13093
35616,1105,1923,0,35616,34550,1066,4.93899e+16,320.929,6042.37,35616,333,26,33693,33693,32402,31310,24078
5738,1382,1435,5398,340,5398,340,1.33825e+18,96.1879,2140.85,5738,662,91,4303,4303,4273,4300,4284
39215,7246,17453,0,39215,15257,23958,1.82954e+15,56.307,19558.5,39215,8488,72,21762,21762,16346,12629,9076
27761,159,176,27698,63,27761,0,6.15217e+18,165.712,2059.46,27761,150,158,27421,26970,25256,25270,25199
23683,117,884,0,23683,23004,679,3.69066e+16,164.03,2682.04,23683,125,26,22662,22570,19075,18431,6818
39213,5774,25410,34762,4451,34762,4451,2.85581e+18,5.52059,29148,39213,8466,13,13803,13803,10248,9961,4512
29188,3,12,28339,849,29170,18,1.58646e+14,10.2384,501.69,29188,11,12,22413,16633,17167,18146,10011
25286,714,11646,16478,8808,24236,1050,6.86465e+18,94.7881,13289.8,25286,5607,111,13640,12920,5369,5271,2014
48298,376,2163,0,48298,46866,1432,4.5795e+16,337.202,7086.76,48298,381,26,46079,44372,32447,32776,9801
32152,5483,13632,32152,0,30572,1580,4.43423e+18,256.508,15055.6,32152,4514,136,18520,18379,12951,14614,9002
31848,143,176,31770,78,31848,0,5.98026e+18,169.889,2114.9,31848,168,165,30942,28946,26283,26204,26147
22753,1064,6775,21526,1227,21526,1227,2.69374e+18,97.1559,8624.67,22753,3214,111,15978,15978,9288,10098,3909
46493,8559,13608,43975,2518,43975,2518,5.63274e+18,97.5459,16831.9,46493,6484,111,32885,32885,32594,31649,23152
26426,6,12,25674,752,26413,13,1.3898e+14,10.4366,461.415,26426,12,11,25108,24560,22252,22118,17715
32010,790,2000,32010,0,30705,1305,2.54786e+18,17.9696,2697.53,32010,1315,23,30010,30010,29417,29693,17431
17420,529,854,0,17420,16916,504,4.01488e+16,144.701,2410.98,17420,119,26,16566,16375,15901,15905,13120
5146,2322,2372,5146,0,3494,1652,6.19313e+18,90.8543,2793.46,5146,540,87,2774,2774,2774,2774,2773
36688,12,15,35610,1078,36623,65,1.7728e+14,10.3622,658.94,36688,13,11,36673,36672,35661,35662,30191
36377,23685,36377,36377,0,0,36377,7.99978,0,36377,36377,36377,1,0,0,0,0,0
3925,4,11,3809,116,3923,2,1.82295e+14,9.55414,185.438,3925,11,11,3407,3041,2932,2424,2050
47615,726,1589,0,47615,46242,1373,3.93059e+16,295.805,5398.03,47615,266,26,46026,46026,42818,41459,27921
40281,94,176,40198,83,40281,0,6.02862e+18,172.859,2450.41,40281,173,170,35346,23359,20040,21197,21447
35830,98,176,35812,18,35830,0,6.02087e+18,172.446,2301.91,35830,172,168,31857,20853,18524,19484,19863
29435,6712,10373,0,29435,0,29435,5.48336e+17,95.6946,12530.4,29435,5022,110,19062,19062,16673,13829,12867
27495,4083,9566,26132,1363,0,27495,1.90164e+18,94.0173,11621.6,27495,4622,110,17929,17929,13423,12628,8043
9795,102,176,9790,5,9795,0,6.02997e+18,166.041,1208.71,9795,125,124,8733,5870,5267,5511,5647
27148,685,17010,11421,15727,0,27148,4.81763e+12,53.1088,18167.1,27148,8264,72,10138,9590,4203,8122,1016
15113,3774,6282,15113,0,14363,750,3.79971e+18,142.248,7223.52,15113,2646,124,8831,8831,7334,7910,6306
9725,6,176,9719,6,9725,0,6.08843e+18,166.112,1218.79,9725,119,121,1658,229,227,219,259
49750,6,15,48314,1436,49685,65,1.52115e+14,10.4435,716.793,49750,13,12,47353,46009,34955,34430,28578
37824,118,176,37797,27,37824,0,6.05921e+18,173.29,2393.37,37824,170,167,35408,31978,24511,25193,24865
34718,3912,11829,0,34718,12865,21853,2.17813e+15,58.3297,14018,34718,5756,72,22889,22889,15371,14812,7655
9063,3013,5875,8033,1030,8033,1030,1.35928e+18,6.48836,6775.68,9063,1967,14,3188,3188,2678,2625,1743
43956,1,15,42678,1278,43867,89,1.63995e+14,10.4282,694.349,43956,13,13,9166,9166,9166,9166,9166
34112,13031,14019,0,34112,0,34112,4.99259e+17,94.9769,16261.5,34112,6804,110,20093,20093,18969,18540,17401
20536,2,11,19943,593,20523,13,1.56747e+14,10.2281,414.811,20536,11,11,11995,8919,7190,7580,6523
18752,4327,6017,17782,970,17782,970,3.10703e+18,93.5812,7605.48,18752,2892,110,12735,12735,9713,10984,8604
28471,6254,8231,0,28471,10283,18188,2.35184e+15,59.1191,10213.8,28471,4009,72,20240,20240,17342,14418,13986
43064,12134,18036,43064,0,41223,1841,4.90563e+18,2022.49,20980.5,43064,6936,143,25028,23235,20948,21209,18168
8296,1307,3109,7893,403,7893,403,3.07989e+18,95.0407,3920.75,8296,1483,98,5187,5187,4328,4692,3787
21718,4359,5099,20448,1270,20448,1270,5.86959e+18,97.616,7036.86,21718,2466,110,16619,16619,16429,16429,14712
29631,4098,8126,0,29631,0,29631,6.14205e+17,97.0832,10489.8,29631,3935,110,21505,21505,17038,14187,11776
29540,78,176,29483,57,29540,0,6.09678e+18,171.383,2128.01,29540,161,159,24323,16858,12565,13234,12804
13034,4339,4976,4910,8124,0,13034,7.98202e+12,57.3911,5946.03,13034,2411,72,8058,8058,7935,8038,7937
32282,140,176,32273,9,32282,0,5.98161e+18,169.784,2128.94,32282,164,168,31253,29179,25971,26313,26067
10752,2687,4386,10262,490,10262,490,2.90585e+18,93.546,5337.78,10752,2093,109,6366,6366,5399,5679,5651
40178,105,176,40098,80,40178,0,6.00272e+18,172.949,2423.11,40178,169,172,36543,24823,22213,23137,23624
36036,6606,8410,0,36036,12661,23375,2.52884e+15,60.0275,10960.6,36036,4086,72,27626,27626,25536,22785,22144
18986,7,12,18429,557,18968,18,1.71812e+14,10.3906,411.616,18986,12,11,18447,18053,14773,14372,12374
35124,2943,8235,33082,2042,33082,2042,5.87983e+18,97.7638,11049.6,35124,3978,110,26889,26889,25556,25426,10818
25161,555,7796,25161,0,23698,1463,3.61118e+18,167.571,9232.88,25161,2994,124,17365,17209,7845,11894,1759
17704,1055,4161,6223,11481,0,17704,9.89741e+12,59.8528,5602.84,17704,2024,72,13543,13543,7127,11829,3691
47597,1571,11733,0,47597,0,47597,6.37079e+17,97.709,15267.7,47597,5694,110,35864,35864,14872,7688,6905
27362,7423,8973,27362,0,25771,1591,3.5376e+18,170.725,10294.9,27362,3283,125,18389,18389,16886,17440,15664
18377,59,995,0,18377,17836,541,4.3669e+16,203.412,2849.64,18377,148,26,17056,16973,11345,11097,3895
38635,39,176,38613,22,38635,0,6.00953e+18,173.038,2373.15,38635,171,169,22168,7049,7383,8728,8494
17424,1027,7606,0,17424,0,17424,4.79134e+17,89.0999,8915.1,17424,3664,110,9818,9646,5766,2489,1363
46592,5,10,45811,781,46496,96,9.87084e+13,3.99839,608.737,46592,7,4,46582,46582,43082,43079,33258
27992,5797,6617,0,27992,0,27992,6.45538e+17,97.6177,8969.62,27992,3192,110,21375,21375,20475,19805,19264
21785,3599,7804,0,21785,0,21785,5.45016e+17,81.9023,9504.9,21785,3766,110,13981,13981,13151,12513,12099
45799,16476,45799,45799,0,0,45799,134215000,0,45799,45799,45799,1,0,0,0,0,0
17019,375,703,0,17019,16533,486,3.55525e+16,31.7355,1955.41,17019,89,26,16316,16304,15381,15461,9833
32575,90,176,32562,13,32575,0,5.98272e+18,169.792,2138.74,32575,163,168,27998,16897,15389,16398,16608
12738,3546,5991,12220,518,12220,518,2.54743e+18,93.1218,6980.38,12738,2886,110,6747,6747,5547,6474,4430
10130,290,436,0,10130,9840,290,3.56091e+16,20.087,1228.2,10130,64,26,9694,9694,9356,9389,7123
31320,6694,7540,29497,1823,29497,1823,4.45911e+18,98.2099,10044.8,31320,3569,111,23780,23780,22214,22556,21705
32567,6832,9890,30827,1740,30827,1740,5.48292e+18,97.2745,12305.7,32567,4714,111,22677,22677,18469,19286,16775
8017,36,672,0,8017,7780,237,4.59562e+16,18.9716,1596.14,8017,83,26,7345,7327,4567,4866,1472
13190,1516,5334,12587,603,0,13190,1.75192e+18,94.4738,6438.93,13190,2576,110,7856,7856,4749,4570,2735
16750,6216,8070,16083,667,0,16750,1.52084e+18,93.471,9259.97,16750,3912,110,8680,8680,7617,7370,6934
1766,9,170,1761,5,1766,0,6.03293e+18,127.288,516.692,1766,71,61,402,71,67,66,105
24050,1954,5653,8460,15590,0,24050,9.88702e+12,59.9605,7491.96,24050,2754,72,18397,18397,13025,17467,6560
39969,146,176,39885,84,39969,0,6.02011e+18,172.375,2430.18,39969,172,169,38962,36669,33420,33321,33457
24581,4360,5913,23149,1432,23149,1432,4.66982e+18,98.078,7993.85,24581,2780,111,18668,18668,17063,18552,14417
37331,378,12822,13846,23485,0,37331,8.47772e+12,58.288,15134.6,37331,6242,72,24509,24029,11100,19502,1391
20029,139,4704,0,20029,7037,12992,2.51837e+15,59.8412,6296.16,20029,2277,72,15325,15286,3991,737,635
21247,343,1086,0,21247,20622,625,4.3573e+16,235.043,3199.42,21247,163,26,20114,19692,15121,15641,6227
36214,8170,11382,0,36214,13257,22957,2.26524e+15,58.0994,13722,36214,5539,72,24832,24832,22090,18431,17604
32400,3356,7623,30520,1880,30520,1880,3.22315e+18,97.7132,10263.3,32400,3683,110,24777,24777,19434,22590,11967
20758,2906,7514,20758,0,19638,1120,4.25743e+18,157.061,8727.63,20758,3056,121,13244,13114,8858,10650,5319
46058,6532,14701,43678,2380,0,46058,1.98019e+18,96.5184,17878.1,46058,7137,110,31357,31357,23049,21866,13606
48799,6410,12020,0,48799,17272,31527,2.48596e+15,59.8893,15251.5,48799,5854,72,36779,36779,30224,21352,19214
32173,454,1392,30835,1338,9389,22784,1.26555e+18,16.9942,2087.75,32173,1299,26,30781,30781,26278,27021,16452
9092,694,2209,3198,5894,0,9092,9.77699e+12,59.3748,3069.53,9092,1062,72,6883,6883,4213,6181,2373
25485,2127,11041,24385,1100,24385,1100,2.73985e+18,94.0439,12787.7,25485,5337,110,14444,14444,6274,9375,3624
47819,5641,11180,45036,2783,45036,2783,5.76174e+18,97.9091,14773.7,47819,5426,110,36639,36639,33290,32744,19758
12624,1,4,12414,210,12624,0,9.83512e+13,3.99541,213.523,12624,4,4,5141,5141,5141,5141,5141
20720,1170,6484,19630,1090,19630,1090,3.69317e+18,96.8184,8181.87,20720,3078,111,14236,14236,7535,8354,3428
5975,248,1815,5648,327,5648,327,6.75477e+18,95.7115,2507.47,5975,856,93,4160,4073,1490,2179,1190
4559,828,1586,4322,237,4322,237,3.09672e+18,93.5668,2131.31,4559,750,81,2973,2973,2626,2721,2738
43526,3548,10135,40987,2539,0,43526,2.23095e+18,97.916,13472.4,43526,4915,110,33391,33391,24379,22823,13148
2235,354,1031,2235,0,2125,110,5.93284e+18,88.2868,1290.86,2235,408,60,1204,1111,806,1055,679
14463,2492,3537,13623,840,13623,840,3.50245e+18,97.6832,4933.42,14463,1652,111,10926,10926,10926,10926,8254
6231,1,13,6048,183,6194,37,1.72381e+14,10.8093,250.367,6231,12,11,1198,1198,1198,1198,1198
36714,10408,11185,36714,0,34577,2137,4.21859e+18,261.625,13081.9,36714,4369,125,25529,25529,25011,25276,24312
22423,105,1128,0,22423,21765,658,4.36819e+16,236.49,3357.34,22423,174,26,20935,20735,17329,14782,5685
8691,787,2986,8691,0,8184,507,4.93745e+18,92.1699,3631.08,8691,1069,116,5705,5705,3205,4143,1924
45358,10842,12971,42898,2460,0,45358,2.07664e+18,97.0513,16229.6,45358,6295,110,32387,32387,30106,29583,27681
18993,2891,4455,0,18993,6680,12313,2.52971e+15,59.8885,5982.44,18993,2165,72,14538,14538,12238,9416,9567
20155,9,11,19581,574,20143,12,1.38957e+14,10.2189,397.676,20155,11,11,19890,19540,19158,19157,17804
9168,503,4677,8818,350,8818,350,3.4139e+18,88.3931,5409.96,9168,2245,99,4491,4230,2312,3048,1327
21559,367,915,0,21559,20935,624,3.89149e+16,169.011,2716.36,21559,132,26,20644,20377,18767,18093,10882
38548,1040,1470,0,38548,37424,1124,4.09282e+16,286.46,4805.2,38548,243,26,37078,37078,35362,35966,30997
28555,5053,8979,27065,1490,0,28555,1.99804e+18,96.4544,11180.5,28555,4351,110,19576,19576,16507,15163,11518
48704,8067,17009,18127,30577,0,48704,8.38709e+12,58.2353,19864.4,48704,8281,72,31695,31695,23724,30318,14088
35706,156,176,35623,83,35706,0,6.01112e+18,172.253,2287.33,35706,169,168,35118,34223,31639,31754,31176
10548,5802,6837,9348,1200,9348,1200,6.49572e+17,6.50009,7879.57,10548,2286,14,3711,3711,3531,3536,3191
17491,5470,10470,16951,540,16951,540,1.11791e+19,88.541,11491.7,17491,5076,110,7021,7021,6701,6701,3548
21102,10272,10313,0,21102,8370,12732,1.68967e+15,53.6294,11527.3,21102,5003,72,10789,10789,10789,10780,10789
10030,1,11,9740,290,10028,2,1.49521e+14,10.1239,285.197,10030,11,11,2363,2363,2363,2363,2363
1446,21,32,0,1446,1328,118,2.93016e+16,9.84302,136.713,1446,29,11,1414,1413,1365,1350,1391
44863,10011,10729,42273,2590,42273,2590,5.82128e+18,97.7764,14127.9,44863,5197,110,34134,34134,33698,33630,32319
15732,5207,5724,14962,770,0,15732,1.86681e+18,95.3241,7045.54,15732,2769,110,10008,10008,9810,9641,9744
26447,7223,7398,24997,1450,0,26447,2.09924e+18,96.947,9550.02,26447,3580,110,19049,19049,18833,18831,18787
48706,1338,11375,45868,2838,0,48706,2.22825e+18,97.9392,15022.7,48706,5523,110,37331,37331,14797,13006,6625
37657,5021,8802,35466,2191,0,37657,2.22985e+18,97.834,11777.4,37657,4260,110,28855,28855,23752,22775,17571
30534,87,7174,28754,1780,0,30534,2.22805e+18,97.7291,9692.14,30534,3476,110,20192,6562,6329,4994,1816
31476,4,14,30580,896,31401,75,1.38958e+14,10.5746,536.412,31476,14,12,27483,24476,23906,21905,16443
39638,2446,9319,0,39638,0,39638,6.47286e+17,97.8162,12409.9,39638,4518,110,30319,30319,20988,11630,9415
12475,1886,2938,11745,730,0,12475,2.23869e+18,97.1129,4216.82,12475,1406,110,9537,9537,8339,7913,6641
6571,239,281,0,6571,6382,189,3.53873e+16,19.8332,814.065,6571,50,26,6290,6290,6207,6213,5759
26630,877,10813,10177,16453,0,26630,7.65385e+12,57.0668,12447.2,26630,5253,72,15817,15681,9909,14807,2870
26851,3756,6277,25283,1568,0,26851,2.23342e+18,97.7227,8561.74,26851,3034,110,20574,20574,17685,16522,13052
27026,2048,6984,25499,1527,25499,1527,3.38118e+18,97.2842,9222,27026,3372,110,20042,20042,10688,14840,6168
36561,1288,1345,0,36561,35498,1063,3.98513e+16,270.552,4387.83,36561,218,26,35216,35216,35054,35042,34163
15618,160,176,15611,7,15618,0,6.03704e+18,168.382,1530.72,15618,139,145,15338,15038,14236,14223,14181
48220,4538,13713,45580,2640,45580,2640,2.93985e+18,97.67,17062.1,48220,6523,111,34507,34507,24636,27608,12671
44437,5372,10305,0,44437,15614,28823,2.53427e+15,60.1027,13342.3,44437,5016,72,34132,34132,26925,19290,18169
11992,1564,3518,0,11992,0,11992,6.03327e+17,96.1595,4689.51,11992,1693,110,8474,8474,6880,5864,5600
24803,13,15,24066,737,24745,58,1.85206e+14,10.5124,540.997,24803,13,11,24788,24788,24487,24487,24088
32451,470,9693,30721,1730,0,32451,2.04188e+18,96.7514,12166.4,32451,4695,110,22758,22428,9295,6346,2767
30938,13575,13794,0,30938,0,30938,4.70123e+17,94.4325,15780.1,30938,6701,110,17144,17144,16908,16634,16795
32681,7021,10047,30961,1720,30961,1720,3.09257e+18,94.2425,12509.5,32681,4867,110,22634,22634,20474,22009,16561
21091,4,10,20488,603,21086,5,1.38702e+14,9.96539,401.674,21091,10,10,18248,16148,13564,13804,11095
18375,5451,9361,0,18375,0,18375,3.44212e+15,17.9604,9742.09,18375,8410,20,9014,9014,5374,5307,5273
25429,4697,7065,9127,16302,0,25429,9.3176e+12,59.2714,8901.49,25429,3438,72,18364,18364,16373,17944,13164
1747,29,494,0,1747,0,1747,6.37309e+17,90.3171,789.997,1747,212,54,544,60,279,29,73
23281,9808,12439,23281,0,22423,858,4.47919e+18,391.93,13734.9,23281,5548,130,10842,10795,10132,10323,8772
6717,1,11,6525,192,6712,5,1.39837e+14,10.1787,229.259,6717,11,11,1710,1710,1710,1710,1710
18698,2984,5219,17668,1030,0,18698,2.10515e+18,95.7302,6873.31,18698,2507,110,13479,13479,10723,10215,7535
45994,15573,23566,0,45994,18435,27559,1.60716e+15,55.625,25722.9,45994,11467,72,22428,22428,19238,19639,15547
32516,3957,7593,30618,1898,30618,1898,5.86746e+18,97.7255,10244.7,32516,3675,110,24923,24923,24005,24005,14056
24805,3392,6018,23365,1440,23365,1440,4.6752e+18,98.0523,8112.48,24805,2840,111,18787,18787,13813,14824,11460
32986,6759,15564,31656,1330,0,32986,1.54219e+18,94.0065,17573.2,32986,7564,110,17422,17422,14002,12499,9590
47391,3,13,43468,3923,47135,256,1.16318e+14,7.93303,566.942,47391,12,9,34453,32490,17609,27706,19996
49597,2386,16797,47107,2490,0,49597,1.9232e+18,96.238,20090.7,49597,8158,110,32800,32800,20262,17744,5498
29718,149,1251,0,29718,6191,23527,1.49973e+16,11.9932,1814.81,29718,1246,13,28467,28467,18578,10901,24066
24892,4807,5881,23442,1450,0,24892,2.22663e+18,97.6696,8030.92,24892,2845,110,19011,19011,17878,17411,16302
47819,15416,23656,45969,1850,45969,1850,3.98994e+18,94.4464,26195.1,47819,11413,111,24163,24163,21105,24013,18534
23127,1968,11993,0,23127,0,23127,4.09113e+17,89.7454,13430.4,23127,5802,110,11134,11134,5329,3413,2717
28212,4388,8685,28212,0,26565,1647,4.58841e+18,173.924,10238.1,28212,3349,124,19527,19527,15004,16858,10486
47562,3,15,46206,1356,47477,85,1.38933e+14,10.6522,691.673,47562,13,12,36269,25582,30027,28800,19111
1863,40,512,0,1863,0,1863,6.57166e+17,91.0709,823.996,1863,227,56,713,132,443,312,89
48079,3357,17671,0,48079,18041,30038,2.08906e+15,57.9459,20429.5,48079,8607,72,30408,30408,19436,6110,6213
24680,363,8972,20325,4355,23473,1207,4.52142e+18,94.3053,10798.3,24680,4280,111,15708,15186,6362,5259,2212
24909,13,14,24194,715,24832,77,1.43806e+14,10.7681,492.151,24909,13,12,24895,24895,24609,24609,23988
7834,1721,1860,0,7834,2747,5087,2.52552e+15,59.3507,2633.09,7834,892,72,5974,5974,5815,5794,5743
28777,7,15,27933,844,28719,58,1.65244e+14,10.6639,567.485,28777,13,11,27917,27367,25303,22859,16406
29209,638,927,0,29209,28373,836,3.54923e+16,177.325,2966.05,29209,134,26,28282,28004,27055,27197,22251
15509,4517,5253,5731,9778,0,15509,8.54234e+12,58.1786,6419.3,15509,2553,72,10256,10256,10075,10216,9944
10118,1796,2452,0,10118,0,10118,6.49053e+17,96.8769,3540.13,10118,1176,110,7666,7666,6787,5880,6046
43230,9,12,41996,1234,43211,19,1.39038e+14,10.3061,591.892,43230,12,11,42673,42048,40855,40854,37715
39358,737,19118,37818,1540,37818,1540,2.5691e+18,92.4976,21376.9,39358,9271,110,20240,19212,6380,11691,1687
19363,3657,4535,0,19363,6809,12554,2.53002e+15,59.8901,6084.86,19363,2204,72,14828,14828,13538,12780,12133
20862,8,12,20268,594,20854,8,1.38876e+14,10.3371,408.002,20862,12,11,20377,19965,19154,19142,16070
42752,13495,15107,0,42752,15939,26813,2.1358e+15,58.1541,17658.7,42752,7353,72,27645,27645,26177,25381,23900
31402,8186,8644,29660,1742,29660,1742,6.1358e+18,97.6443,11066.8,31402,4096,111,22758,22758,22698,22571,21777
16530,3,14,16046,484,16486,44,1.71473e+14,10.6397,415.085,16530,13,11,12835,9802,9322,10556,7164
24316,2693,6797,22966,1350,22966,1350,5.19212e+18,97.5093,8776.85,24316,3224,111,17519,17519,14231,15879,7443
36177,137,176,36094,83,36177,0,6.08661e+18,172.219,2352.96,36177,167,163,35128,33315,27992,28289,28179
43699,9132,10244,41159,2540,0,43699,2.22614e+18,97.8682,13590.1,43699,4961,110,33455,33455,31964,31677,30424
18831,547,928,0,18831,18283,548,4.12578e+16,183.554,2672.81,18831,134,26,17903,17621,15734,15809,12942
9950,385,670,0,9950,9658,292,4.17427e+16,19.7408,1658.47,9950,86,26,9280,9280,8118,8200,5050
15716,184,8367,15716,0,15716,0,1.1395e+18,17.9489,8708.27,15716,7514,20,7349,7294,162,7349,215
36840,238,8646,12958,23882,0,36840,9.87007e+12,60.0143,11237.1,36840,4209,72,28194,28194,7258,22368,930
22799,1761,10627,22799,0,17337,5462,5.26576e+18,221.028,11734,22799,4405,131,12172,11864,6826,9318,2265
31685,1719,7437,0,31685,0,31685,6.49314e+17,97.7549,10027.4,31685,3604,110,24248,24248,12683,7200,6794
4659,1503,1639,0,4659,1719,2940,2.17767e+15,57.2129,2107.38,4659,794,67,3020,3020,2863,2839,2742
22758,362,5355,21435,1323,0,22758,2.22917e+18,97.5318,7364.2,22758,2583,110,17403,17403,5757,4881,2253
840,542,840,840,0,0,840,134058000,0,840,840,840,1,0,0,0,0,0
15628,696,5854,14146,1482,14875,753,4.30852e+18,95.2261,7139.23,15628,2778,111,9774,9612,5595,5236,2391
42055,9,15,40833,1222,41967,88,1.60218e+14,10.5093,669.989,42055,13,13,41543,41024,33420,33430,31587
2198,66,818,2198,0,2070,128,4.03291e+18,86.8376,1091.87,2198,287,61,1044,261,518,915,183
20863,1462,4941,0,20863,7345,13518,2.52697e+15,59.8935,6578.38,20863,2406,72,15922,15922,9281,6175,4835
8715,994,4494,8715,0,8355,360,4.87276e+18,130.424,5089.69,8715,1978,106,4221,4080,1987,2853,807
1935,9,98,0,1935,1877,58,3.53027e+16,18.9452,288.937,1935,31,26,1674,1543,1076,1121,482
13436,739,5705,12836,600,12836,600,6.47905e+18,92.1507,6785.37,13436,2727,111,7731,7474,4233,5755,1738
46570,1157,1386,0,46570,45234,1336,3.718e+16,271.956,4773.35,46570,226,26,45184,45184,44673,44510,41584
45723,7667,17863,17337,28386,0,45723,7.8505e+12,56.7403,20432.7,45723,8682,72,27860,27860,21809,26498,12929
48704,2201,3270,0,48704,9880,38824,1.46071e+16,11.9955,3985.38,48704,1984,14,45434,45434,38742,32905,42415
37932,4417,15335,37932,0,36079,1853,4.5109e+18,397.341,17239.1,37932,5300,137,22597,22244,14264,16992,7851
20717,8564,9381,0,20717,8073,12644,1.80504e+15,55.5862,10641.4,20717,4547,72,11336,11336,10807,10495,10351
40705,9160,11465,38485,2220,38485,2220,6.58915e+18,97.0747,14472.7,40705,5555,110,29240,29240,28890,28890,25255
12931,2333,4339,12272,659,0,12931,1.94871e+18,95.5638,5520.68,12931,2089,110,8592,8592,7237,6650,5276
28864,418,1047,0,28864,28033,831,3.79336e+16,214.009,3304.72,28864,158,26,27817,27395,24866,24347,13374
34201,6249,8021,32205,1996,32205,1996,5.89005e+18,97.7956,10773.1,34201,3888,110,26180,26180,25733,25733,21027
21764,5199,7139,21764,0,20526,1238,4.40896e+18,155.16,8424.67,21764,2797,123,14625,14625,12774,13588,10936
24633,3705,6072,0,24633,8717,15916,2.49179e+15,59.7696,7921.21,24633,2957,72,18561,18561,15762,11946,11190
41001,7,176,40932,69,41001,0,6.10333e+18,172.704,2507.6,41001,172,169,7898,999,1389,1076,1516
45140,56,176,45078,62,45140,0,6.07597e+18,173.684,2626.3,45140,173,170,31986,19271,13241,14689,14089
34850,3071,8169,32822,2028,32822,2028,5.88632e+18,97.7803,10963.6,34850,3955,110,26681,26681,25393,25395,11190
49463,27070,49463,0,49463,49463,0,2047.96,0,49463,49463,49463,1,0,0,0,0,0
23628,11,12,22947,681,23618,10,1.4991e+14,10.2161,442.203,23628,11,12,23616,23616,23489,23490,23309
39935,9,12,38798,1137,39919,16,1.39071e+14,10.3067,568.197,39935,12,11,39418,38832,37732,37722,34657
40608,6599,9502,0,40608,14283,26325,2.52699e+15,60.0416,12314.3,40608,4619,72,31106,31106,27665,25833,21968
25116,1008,1294,0,25116,24375,741,4.53702e+16,271.379,3913.17,25116,205,26,23822,23822,23398,23422,21295
2058,770,1089,0,2058,816,1242,1.68968e+15,36.1098,1294.14,2058,514,53,969,969,969,969,969
48647,16116,20140,18654,29993,0,48647,7.54168e+12,57.1883,22759,48647,9796,72,28507,28507,25993,28077,23137
24571,5556,5727,0,24571,8628,15943,2.53056e+15,59.9706,7602.98,24571,2783,72,18844,18844,18648,18541,18471
6464,1050,1587,2284,4180,0,6464,9.89657e+12,59.259,2249.94,6464,773,72,4877,4877,4094,4739,3333
48660,17862,22107,0,48660,18998,29662,1.80129e+15,56.4293,24577.5,48660,10752,72,26553,26553,24000,22462,21051
13857,591,3356,13047,810,13047,810,1.32102e+18,97.4925,4710.75,13857,1563,111,10501,10501,4450,5212,2505
13926,5715,6284,0,13926,5429,8497,1.81105e+15,52.4377,7216.74,13926,3047,72,7642,7642,7620,7619,7642
25847,957,6494,0,25847,9163,16684,2.47289e+15,59.7008,8409.29,25847,3158,72,19353,19353,12047,2849,3207
37538,6426,8800,0,37538,13204,24334,2.52514e+15,60.0352,11438.1,37538,4277,72,28738,28738,25939,24005,21335
40350,9514,14660,40350,0,28365,11985,3.98954e+18,285.829,16370.5,40350,5311,133,25690,25662,22243,23278,18469
34157,6814,7962,0,34157,12003,22154,2.53319e+15,60.0454,10405.3,34157,3878,72,26195,26195,24801,22898,22611
41410,397,12772,39233,2177,0,41410,2.01204e+18,96.653,15727.8,41410,6195,110,28638,28122,17003,14724,3061
36895,6211,8842,34745,2150,34745,2150,5.80695e+18,98.2938,11689.8,36895,4183,111,28053,28053,23067,24089,20723
39632,397,11684,14366,25266,0,39632,9.08555e+12,59.0857,14262.7,39632,5683,72,27948,27757,16155,25918,1784
27904,2,12,27110,794,27890,14,1.3868e+14,10.2726,471.487,27904,12,11,16162,11443,11078,11505,8825
25072,6047,11109,0,25072,9736,15336,1.84407e+15,56.6313,12586.4,25072,5407,72,13963,13963,11243,7490,6828
8778,123,701,0,8778,8520,258,4.51325e+16,25.31,1682.98,8778,89,26,8077,8050,5812,6052,2089
25561,1019,15855,25561,0,23885,1676,9.78881e+17,3902.85,19226.3,25561,6340,14,3704,1676,293,696,1193
29449,147,176,29380,69,29449,0,6.22417e+18,170.52,2079.01,29449,145,145,28953,28052,24895,24823,24711
18632,346,10624,18632,0,17992,640,5.13173e+18,297.119,11656.6,18632,3820,128,7960,6839,3393,4909,1021
19195,3898,5276,18135,1060,18135,1060,6.29807e+18,96.5742,6974.47,19195,2530,110,13919,13919,13247,13135,10908
1718,374,509,1618,100,1618,100,4.28171e+18,89.1758,795.954,1718,224,53,1209,1209,1051,1106,1105
11940,52,208,11934,6,11940,0,6.0105e+18,179.143,1403.44,11940,133,139,7720,3954,2857,3448,3286
49485,8,16,48059,1426,49413,72,1.49113e+14,10.3599,689.913,49485,13,13,48403,47620,42550,40166,28923
7198,2261,2297,2631,4567,0,7198,8.96561e+12,58.1182,2961.93,7198,1118,72,4901,4901,4859,4891,4868
29889,11170,15977,0,29889,6474,23415,1.35505e+13,8.99227,16318.1,29889,14371,11,13912,13912,10542,13912,10234
21790,174,176,21705,85,21790,0,6.19638e+18,167.384,1805.81,21790,139,141,21606,21566,21485,21456,21451
32453,5682,8164,30593,1860,30593,1860,2.45317e+18,98.0479,10713.5,32453,3866,111,24289,24289,20701,21937,18241
26217,5547,6673,0,26217,9303,16914,2.46287e+15,59.6443,8602.54,26217,3246,72,19544,19544,18001,16105,16278
46438,133,208,46355,83,46438,0,6.00315e+18,204.246,2728.54,46438,185,185,43803,40684,29031,29767,29235
4402,1,11,4277,125,4401,1,1.40546e+14,10.8401,185.843,4402,11,11,1110,1110,1110,1110,1110
18630,115,175,18616,14,18630,0,5.97854e+18,165.571,1615.24,18630,154,151,17262,15608,11873,12232,12307
30099,15290,30099,30099,0,30099,0,8.7958e+12,0,30099,30099,30099,1,0,0,0,0,0
32826,10219,18039,31696,1130,31696,1130,1.0381e+19,91.2557,19814.4,32826,8748,110,14787,14787,13481,13273,8483
15337,3434,7527,15337,0,15337,0,2.66832e+18,18.9598,7890.89,15337,5366,23,7810,7810,4116,3902,3610
27256,866,1017,0,27256,26473,783,3.80883e+16,209.855,3178.15,27256,151,26,26239,26239,25964,25952,24494
9568,112,412,0,9568,9297,271,3.56372e+16,20.0517,1165.46,9568,62,26,9156,9156,7064,7059,3510
44236,9112,15912,42066,2170,42066,2170,3.71903e+18,96.4972,18780.7,44236,7624,111,28324,28324,23662,28041,17181
43534,2,16,42258,1276,43465,69,1.68837e+14,10.47,709.169,43534,13,12,25649,19674,14919,19831,11843
8093,986,2062,7629,464,7629,464,3.17211e+18,96.6235,2964.28,8093,957,104,6031,6031,4782,5703,3511
28913,2861,15750,11746,17167,0,28913,5.87459e+12,55.0451,17163.1,28913,7668,72,13163,13163,8335,12333,2653
26453,986,6151,9295,17158,0,26453,9.91988e+12,60.0093,8136.16,26453,2995,72,20302,20302,8593,17103,3567
33607,16210,16214,0,33607,13294,20313,1.70787e+15,55.9742,17975.9,33607,7885,72,17393,17393,17393,17393,17393
16815,3553,3945,0,16815,5913,10902,2.5341e+15,59.8902,5335.12,16815,1918,72,12870,12870,12395,11870,11797
41279,8586,12544,41279,0,38877,2402,4.27664e+18,296.015,14616.8,41279,4941,128,28735,28585,24538,26448,20884
1169,1,11,1133,36,1168,1,2.14297e+14,8.04705,101.332,1169,11,11,132,132,132,132,132
8492,1142,2204,0,8492,3018,5474,2.45772e+15,58.1171,3011.51,8492,1067,72,6288,6288,4994,3375,2986
3054,688,820,2876,178,2876,178,4.09577e+18,93.8906,1263.52,3054,364,71,2234,2234,2037,2104,2096
14006,77,176,13998,8,14006,0,5.98484e+18,166.101,1415.9,14006,142,140,11042,6343,5513,6242,6145
18613,2220,5612,0,18613,0,18613,5.92063e+17,96.3621,7225.11,18613,2703,110,13001,13001,9788,8707,5303
24257,9,12,23558,699,24246,11,1.56385e+14,10.2277,455.481,24257,12,11,23980,23673,21847,21898,21372
24993,7,14,24279,714,24918,75,1.42309e+14,10.6392,471.55,24993,13,12,24118,23611,18473,18457,18492
4340,1065,1145,4090,250,0,4340,2.2005e+18,94.6567,1722.21,4340,534,84,3195,3195,3148,3151,3186
45581,1775,10675,0,45581,0,45581,6.4836e+17,97.8764,14129.7,45581,5178,110,34906,34906,15714,10575,7557
43790,7656,10211,0,43790,0,43790,6.48615e+17,97.8808,13563.1,43790,4951,110,33579,33579,30649,29129,25908
28265,484,8409,0,28265,0,28265,5.94661e+17,96.6928,10633.4,28265,4072,110,19856,19684,12136,4275,2798
3214,1213,1546,0,3214,1262,1952,1.75874e+15,40.1714,1853.9,3214,730,59,1668,1668,1668,1668,1668
49794,1707,11073,49794,0,49794,0,2.57734e+18,5278.01,17720.9,49794,7385,29,27024,21963,3535,2486,8344
32572,11257,12282,0,32572,0,32572,5.27422e+17,95.3968,14543.4,32572,5960,110,20290,20290,19008,18796,17759
5813,2158,3281,2382,3431,0,5813,5.74635e+12,48.7339,3692.93,5813,1593,71,2532,2532,1982,2434,1539
30454,1123,7495,28694,1760,28694,1760,1.76485e+18,98.0987,9930.8,30454,3538,111,22959,22959,9723,10911,4971
11944,883,2891,11254,690,11254,690,3.35106e+18,96.8738,4122.65,11944,1379,110,9053,9053,5089,6855,3424
45698,10,14,44383,1315,45670,28,1.49416e+14,10.319,631.622,45698,13,12,45568,45390,37163,37310,37524
46770,16726,21530,0,46770,18314,28456,1.78497e+15,56.4762,23899,46770,10488,72,25240,25240,23187,20343,19897
28502,8891,12273,28502,0,27115,1387,4.3794e+18,233.328,13576.5,28502,3990,132,16229,16195,15026,15935,12000
8005,160,3232,8005,0,7595,410,3.76781e+18,93.242,3855.75,8005,1304,108,4773,4587,1888,3219,631
44597,1735,10660,42000,2597,42000,2597,5.57746e+18,98.3305,13964.6,44597,5042,111,33937,33937,16879,22494,7515
37321,5160,8731,35148,2173,35148,2173,5.87992e+18,97.8155,11681.5,37321,4233,110,28590,28590,27700,27700,17938
1174,40,65,0,1174,1139,35,3.52923e+16,18.5349,192.848,1174,26,24,1109,1109,1037,1043,866
37425,3482,8808,35247,2178,0,37425,2.22576e+18,97.8314,11763.2,37425,4269,110,28617,28617,21435,19988,12668
26074,457,7462,24647,1427,24647,1427,6.36563e+18,97.3974,9537.42,26074,3539,111,18612,18438,7843,11614,2629
12543,4,13,12187,356,12475,68,1.38976e+14,10.9023,333.824,12543,13,12,10963,9824,9392,8724,6126
18486,445,771,0,18486,17955,531,3.67928e+16,91.0532,2203.04,18486,103,26,17715,17623,16882,16779,13038
46057,10708,16770,17250,28807,0,46057,8.19915e+12,57.9743,19445.3,46057,8165,72,29287,29287,28051,29027,26162
5443,1360,2235,5193,250,0,5443,1.75713e+18,88.7119,2816.35,5443,1063,82,3208,3208,2205,1986,1449
31449,5029,11194,31449,0,29762,1687,4.75642e+18,255.39,12849.7,31449,2397,135,20255,20156,15135,16841,10244
36337,4,13,35290,1047,36316,21,1.51648e+14,10.1344,557.811,36337,11,12,31610,28098,23120,23716,16630
14756,1,176,14750,6,14756,0,6.0133e+18,165.338,1472.65,14756,141,143,0,0,0,0,0
46827,1214,1372,0,46827,45485,1342,3.69267e+16,273.691,4735.27,46827,223,26,45455,45455,45024,45003,42322
21610,6390,7142,21518,92,20360,1250,3.93039e+18,156.137,8280.36,21610,2054,125,14468,14468,14386,14468,13526
27112,2039,9636,25782,1330,0,27112,1.87878e+18,94.0936,11654.8,27112,4665,110,17476,17476,11255,9714,4093
19557,1123,5331,7010,12547,0,19557,9.37968e+12,59.2744,6833.2,19557,2588,72,14226,14226,8943,12472,3985
7851,1604,1931,7391,460,7391,460,2.94731e+18,96.9022,2822.19,7851,896,104,5920,5920,5342,5477,5284
27290,1936,9222,0,27290,0,27290,5.61515e+17,94.8969,11289.5,27290,4468,110,18068,18068,10318,6951,5898
49811,7145,17153,47331,2480,0,49811,1.90743e+18,96.1439,20432.5,49811,8331,110,32658,32658,26129,24070,17408
38460,2005,17162,0,38460,0,38460,4.68865e+17,93.2757,19512.1,38460,8320,110,21298,21298,12900,3346,3420
27598,1555,6600,25988,1610,25988,1610,3.48984e+18,98.2068,8879.1,27598,3114,111,20998,20998,20998,20998,6225
11633,102,176,11626,7,11633,0,6.05494e+18,165.531,1328.79,11633,129,129,10429,7271,6376,6621,6643
7118,142,1779,0,7118,0,7118,6.41174e+17,96.0521,2616.3,7118,842,98,5339,4086,3184,1297,858
13457,271,914,0,13457,13060,397,4.72227e+16,180.181,2461.49,13457,129,26,12520,12274,9546,10153,5075
34223,69,176,34207,16,34223,0,5.98288e+18,169.533,2190.94,34223,165,169,25577,14143,11901,13983,13381
41469,9,14,40289,1180,41391,78,1.38773e+14,10.3699,593.004,41469,14,12,40919,40308,39055,39035,35803
3764,81,2069,3626,138,3626,138,2.4815e+18,80.8826,2435.48,3764,970,72,1408,454,475,904,0
2538,59,156,768,1770,0,2538,6.91643e+18,15.8893,332.034,2538,115,18,2382,2382,1423,1305,1713
43896,7405,12701,41525,2371,41525,2371,3.07448e+18,96.9653,15860.5,43896,6163,110,31195,31195,26421,29837,17569
18450,7,12,17922,528,18442,8,1.38876e+14,10.4332,384.14,18450,12,11,17804,17360,15600,15667,11877
36712,5956,8544,12908,23804,0,36712,9.90053e+12,60.0658,11137.7,36712,4158,72,28168,28168,24445,27521,20022
24907,1737,13546,24907,0,24907,0,2.45951e+18,17.9245,13972.8,24907,12181,20,11361,11361,1842,11361,1653
2647,233,718,2494,153,2494,153,3.76942e+18,93.0045,1117.19,2647,317,65,1929,1929,1051,1372,863
31116,115,7319,29306,1810,29306,1810,5.88225e+18,97.7081,9873.95,31116,3538,110,23797,10625,20596,18100,1890
1327,324,391,1247,80,1247,80,5.78017e+18,88.0814,629.381,1327,169,48,936,936,921,924,906
21338,2249,4990,7492,13846,0,21338,9.89674e+12,59.9201,6664.06,21338,2426,72,16348,16348,12401,15667,7703
11358,151,3671,11358,0,10698,660,6.33376e+18,94.2853,4506.27,11358,1383,120,7687,7596,2543,4803,638
20149,389,6308,0,20149,7365,12784,2.28018e+15,58.6747,7773.72,20149,3071,72,13841,13697,8040,690,1127
23649,306,1417,0,23649,22942,707,4.96167e+16,274.007,4228.78,23649,232,26,22064,21362,18228,14492,8330
12965,2,12,12596,369,12959,6,1.39033e+14,10.4302,320.531,12965,12,11,7511,5325,5127,5403,4377
45773,7110,10687,16094,29679,0,45773,9.87044e+12,60.059,13794.1,45773,5192,72,35086,35086,30814,34196,23697
46607,4944,24320,44897,1710,44897,1710,2.61474e+18,92.6434,26704.7,46607,11730,111,22287,22287,15888,12950,6262
38029,2025,12831,38029,0,35929,2100,4.71164e+18,263.172,14736.7,38029,2726,137,25198,24746,13439,17049,4340
46811,134,176,46745,66,46811,0,6.09643e+18,172.8,2679.94,46811,173,170,45140,42092,35447,35824,35577
22249,7568,9721,22249,0,21201,1048,5.23153e+18,192.423,10932.9,22249,2312,130,12528,12497,11906,12267,11132
36203,6195,16634,0,36203,0,36203,8.59435e+17,55.9259,19636.5,36203,4180,111,19569,19569,8177,4673,3501
36827,4791,8607,0,36827,0,36827,6.49334e+17,97.8425,11526,36827,4174,110,28220,28220,23046,16841,16787
23129,946,1083,0,23129,22455,674,4.20432e+16,221.097,3251.35,23129,163,26,22046,22046,21824,21815,20642
17181,921,4082,16181,1000,16181,1000,5.75918e+18,97.3441,5699.24,17181,1962,110,13099,13099,11208,9753,3764
17057,3075,4053,16067,990,16067,990,5.77158e+18,97.3028,5666.2,17057,1947,110,13004,13004,12452,12372,10624
19470,4363,11367,0,19470,8040,11430,1.38458e+15,54.1446,12339.5,19470,5521,72,8103,8103,5945,4227,3921
7216,304,1803,6796,420,0,7216,2.21737e+18,96.0901,2646.23,7216,857,101,5413,5413,2374,2180,1365
18624,6486,6930,0,18624,6999,11625,2.07785e+15,57.3981,8221.84,18624,3359,72,11694,11694,11342,11138,11138
11274,1183,3995,10712,562,10712,562,6.0175e+18,95.6849,5029.76,11274,1888,111,7279,7279,4917,5927,1180
42712,8327,14968,15908,26804,0,42712,8.3773e+12,57.7316,17528.1,42712,7286,72,27744,27744,23692,26896,16991
36289,1170,10391,34319,1970,0,36289,2.07701e+18,96.9664,13122.6,36289,5037,110,25898,25898,16528,14864,5144
14369,1826,3423,13530,839,0,14369,2.22981e+18,97.2802,4838.48,14369,1647,110,10946,10946,9123,8482,6321
6128,1459,1543,5770,358,5770,358,3.58345e+18,96.2355,2284.27,6128,712,93,4585,4585,4585,4585,4534
23666,3702,5564,22286,1380,22286,1380,5.7552e+18,97.5984,7632.82,23666,2687,110,18102,18102,16970,16787,12682
43562,9010,16329,0,43562,16396,27166,2.06203e+15,57.7058,18849.7,43562,7942,72,27233,27233,22917,16939,15737
46809,8,16,45431,1378,46738,71,1.76297e+14,10.3579,753.176,46809,13,12,45977,45394,42769,39329,32062
41168,342,1161,0,41168,39992,1176,3.56945e+16,241.149,3976.6,41168,181,26,39959,39448,30501,30863,18059
9839,399,719,0,9839,9549,290,4.39933e+16,44.0497,1773.94,9839,91,26,9120,9092,8145,8336,6143
40222,4348,13947,40222,0,37970,2252,4.839e+18,240.944,15643.2,40222,3597,132,26275,26156,15383,20002,10115
954,257,313,896,58,896,58,5.076e+18,84.6164,492.121,954,135,45,641,641,625,641,617
2061,511,560,0,2061,0,2061,6.48125e+17,91.5822,897.905,2061,249,57,1501,1501,1473,1472,1492
35736,10515,11323,0,35736,0,35736,5.78316e+17,96.4787,13931.3,35736,5492,110,24413,24413,23513,22881,22880
9454,39,208,9444,10,8732,722,6.14326e+18,187.791,1287.81,9454,118,116,5665,1865,1934,1897,1670
22181,2484,10244,0,22181,0,22181,4.56676e+17,93.9692,11757.6,22181,4961,110,11937,11937,7945,4848,3753
6831,1372,2003,6453,378,6453,378,1.4273e+18,90.8166,2772.97,6831,936,100,4828,4828,4784,4812,3357
16866,2868,5599,16866,0,15883,983,3.79472e+18,132.378,6571.65,16866,2027,121,11267,11210,8173,9583,6351
28918,1356,6812,27231,1687,27231,1687,3.35385e+18,97.6929,9222.97,28918,3295,110,22106,22106,11061,16069,5475
1872,394,533,1763,109,0,1872,2.2289e+18,90.1469,840.453,1872,237,56,1339,1339,1186,1202,1193
45578,19386,29527,40398,5180,40398,5180,8.16717e+17,6.52486,33882.9,45578,9851,14,16051,16051,14271,14276,10899
16310,496,714,0,16310,15844,466,3.63071e+16,42.5846,1965.18,16310,91,26,15596,15572,15049,15116,11438
30974,7520,11640,29487,1487,29487,1487,7.16463e+18,96.1564,13775.4,30974,5581,111,19334,19334,17434,18157,13289
29344,269,1312,0,29344,28485,859,4.28505e+16,271.175,4094.41,29344,211,26,27791,27289,20778,20636,10600
27910,4370,8508,26432,1478,26432,1478,6.91123e+18,96.5911,10690.9,27910,4120,110,19402,19402,18664,18664,10670
39271,40,176,39244,27,39271,0,6.04355e+18,172.658,2430.71,39271,168,172,23168,8020,7928,9394,8510
5435,2109,2991,5239,196,5239,196,2.41287e+18,90.8489,3463.64,5435,1431,81,2444,2444,2248,2277,2417
35090,6856,13789,33470,1620,33470,1620,8.23571e+18,95.1753,16139.2,35090,6680,110,21301,21301,20541,20541,12351
30743,8251,16349,30743,0,29593,1150,4.87593e+18,558.756,17879.9,30743,6493,137,14394,13985,11477,12902,8283
23804,37,175,23795,9,23804,0,5.9874e+18,166.754,1825.47,23804,156,161,13174,4107,4297,5420,4915
4373,435,1420,4143,230,0,4373,2.01674e+18,85.4178,1968.59,4373,662,80,2953,2953,1281,1086,2
18200,5251,7459,18200,0,17293,907,3.96853e+18,156.34,8533.17,18200,2969,129,10741,10741,9338,9756,8210
36008,933,1744,0,36008,34945,1063,4.62987e+16,300.259,5527.87,36008,295,26,34264,34264,31034,31449,21956
13055,332,620,0,13055,12681,374,3.68871e+16,19.9046,1666.52,13055,81,26,12435,12435,11020,11143,7678
11802,939,2795,11112,690,11112,690,5.83755e+18,96.9519,4017.71,11802,1334,110,9007,9007,8541,8363,3630
4153,106,208,4149,4,4153,0,6.09608e+18,170.414,857.436,4153,98,88,3575,2643,2153,2168,2136
14514,2109,5735,9758,4756,13836,678,7.56698e+18,95.3573,6920.54,14514,2740,111,8779,8779,6117,7045,4848
25207,7,12,24467,740,25192,15,1.70926e+14,10.1465,473.153,25207,11,12,24483,23977,22049,19651,17422
38564,1511,16276,36871,1693,0,38564,1.68434e+18,94.8173,18706.6,38564,7903,110,22288,22288,12470,7944,4034
4303,1139,1474,4083,220,4083,220,1.60653e+18,91.3493,2001.15,4303,671,79,2829,2829,2642,2813,2495
27500,57,176,27440,60,27500,0,6.07535e+18,171.038,2049.34,27500,160,159,19726,11960,8244,9173,8714
27457,703,1523,0,27457,5650,21807,1.47978e+16,12.0043,2067.67,27457,1105,20,25934,25934,19941,15752,22955
22190,8366,8721,8417,13773,0,22190,7.80776e+12,57.3704,10160.5,22190,4232,72,13469,13469,13043,13399,12774
33120,8222,10131,33120,0,31197,1923,4.22702e+18,232.828,11886.6,33120,2719,132,22989,22931,21887,22762,19365
4576,1374,1640,4576,0,4314,262,3.08877e+18,90.4893,2075.8,4576,589,87,2936,2936,2717,2825,2683
7766,1541,2531,7356,410,7356,410,2.09693e+18,95.7529,3345.26,7766,1198,102,5235,5235,4243,5161,2719
38831,2071,2767,12143,26688,0,38831,6.89612e+18,15.9965,3500.01,38831,1374,26,36064,36064,30500,30045,29517
30683,5280,7147,0,30683,0,30683,6.49374e+17,97.7815,9684.95,30683,3458,110,23536,23536,21400,21835,18066
49489,63,1302,0,49489,48076,1413,3.55068e+16,263.411,4601.65,49489,209,26,47540,47458,36995,36102,9469
37082,14085,16265,0,37082,0,37082,4.75285e+17,94.5532,18571.6,37082,7893,110,20817,20817,19305,18457,18030
19262,60,176,19250,12,19262,0,6.03003e+18,169.91,1699.35,19262,153,149,13785,7989,5889,6625,6404
24214,12,14,23524,690,24140,74,1.38692e+14,10.6797,459.292,24214,13,12,24199,24194,23379,23379,21517
13990,1625,3318,0,13990,4923,9067,2.51759e+15,59.7219,4521.3,13990,1600,72,10672,10672,8311,6317,5566
9410,5,11,9142,268,9404,6,1.38315e+14,10.5373,269.876,9410,11,11,8690,7831,6380,6484,5263
47792,2417,2722,9801,37991,0,47792,5.76788e+13,11.9956,3434.46,47792,1968,14,45070,45070,43090,41941,44173
3467,872,898,0,3467,0,3467,6.42174e+17,93.7915,1394.33,3467,404,73,2569,2569,2568,2568,2569
20034,47,176,20021,13,20034,0,5.995e+18,171.077,1701.51,20034,148,160,12458,5765,4522,5414,5437
39302,2340,12168,27398,11904,37222,2080,3.21903e+18,97.2274,14941.2,39302,5804,111,27134,27134,15868,17832,5501
15004,3138,5241,14255,749,0,15004,1.90523e+18,92.0908,6540.86,15004,2517,110,9763,9763,8248,7575,6021
33107,18905,21454,29347,3760,29347,3760,7.12498e+16,5.52098,24617.3,33107,7155,13,11653,11653,11293,11297,10453
31347,5,14,30453,894,31297,50,1.38874e+14,10.4837,512.523,31347,13,11,28817,25728,20746,21402,17742
15442,3059,6839,15442,0,14698,744,6.03146e+18,132.816,7690.5,15442,2682,125,8603,8506,6662,7801,4368
18844,298,955,0,18844,18295,549,4.20897e+16,176.098,2752.66,18844,137,26,17850,17575,16018,14962,8219
40077,14053,17931,40077,0,38607,1470,5.06946e+18,2853.94,21282.4,40077,7891,148,22146,19466,18506,19797,17451
35221,1063,1823,0,35221,34170,1051,4.80759e+16,310.574,5746.39,35221,313,26,33398,33398,30733,31323,22656
40207,7739,10969,37967,2240,37967,2240,6.0411e+18,93.9945,13911.4,40207,5191,111,29238,29238,25932,27623,20066
19644,2732,8986,0,19644,7682,11962,1.79294e+15,54.72,10188.9,19644,4357,72,10658,10658,7832,4869,4642
20757,50,176,20735,22,20757,0,6.14075e+18,169.799,1779.87,20757,143,144,14597,6361,5787,6077,5624
39414,5728,12166,37344,2070,37344,2070,6.81734e+18,95.8523,15012,39414,5903,110,27248,27248,24466,24019,13357
25965,50,61,25901,64,25965,0,2.26386e+18,60.7271,1197.68,25965,61,61,24788,23761,21729,22024,21157
25307,73,175,25297,10,25307,0,5.97474e+18,166.834,1881.68,25307,163,161,19485,10820,9371,10893,10598
31315,7460,9095,11328,19987,0,31315,9.15721e+12,59.1111,11232.8,31315,4425,72,22220,22220,20899,21991,19469
35635,7356,19890,34435,1200,34435,1200,2.36991e+18,92.5875,21753.5,35635,9669,110,15745,15745,8433,10881,6795
41029,9,13,39859,1170,41013,16,1.38786e+14,10.2451,574.833,41029,12,12,40500,39862,31474,31702,36165
5152,3,11,5006,146,5146,6,1.38224e+14,10.3273,200.699,5152,11,11,3929,2754,3279,3136,2189
8703,314,401,0,8703,8456,247,3.64221e+16,19.9316,1116.34,8703,61,26,8302,8302,8071,8067,7360
35707,1022,1173,0,35707,34679,1028,3.74707e+16,251.893,3861.82,35707,184,26,34534,34534,34226,34201,32290
37685,3962,9022,35485,2200,35485,2200,1.65826e+18,98.321,11914.3,37685,4272,111,28663,28663,21550,25045,13862
35021,4406,11715,35021,0,33071,1950,3.84666e+18,235.468,13506.6,35021,4718,126,23306,23218,15627,18534,9934
28231,1359,7653,0,28231,10109,18122,2.40274e+15,59.3773,9666.06,28231,3713,72,20578,20578,12354,11556,2341
33448,14567,21483,32528,920,32528,920,3.35479e+18,90.6614,22976.7,33448,10379,111,11965,11965,9788,11866,8432
10752,826,2497,0,10752,3774,6978,2.54768e+15,59.8092,3486.08,10752,1216,72,8255,8255,5118,3898,2915
37549,19,176,37469,80,37549,0,5.98427e+18,169.689,2294.71,37549,169,171,14331,2483,3580,3697,3939
9717,9,13,9434,283,9679,38,1.66069e+14,10.4583,299.164,9717,12,11,9611,9526,7949,7871,7017
21810,3302,7231,21810,0,20550,1260,3.62423e+18,156.647,8375.53,21810,2628,124,14579,14461,9995,11917,7134
9367,1156,2449,8835,532,8835,532,6.20843e+18,96.3269,3456.16,9367,1171,110,6918,6918,6588,6588,3262
48508,11095,11340,0,48508,0,48508,6.48629e+17,97.9152,14972.4,48508,5504,110,37168,37168,36902,36815,36722
38103,5,13,37003,1100,38077,26,1.54356e+14,10.2824,576.309,38103,12,12,35142,31542,30673,27521,22444
33343,7364,7829,31402,1941,31402,1941,5.87847e+18,97.7671,10527.2,33343,3791,110,25514,25514,25394,25394,24442
47026,1445,13178,44455,2571,0,47026,2.09327e+18,97.1441,16551.9,47026,6395,110,33848,33848,20778,18370,4833
12389,1378,3062,11669,720,11669,720,4.63303e+18,97.453,4300.22,12389,1430,111,9327,9327,6143,6860,4659
12679,2687,3022,0,12679,4462,8217,2.51497e+15,59.6321,4134.41,12679,1464,72,9657,9657,9268,8911,8809
13083,137,175,13075,8,13083,0,5.98042e+18,164.151,1355.79,13083,140,139,12536,11716,10124,10302,10198
6905,7,544,0,6905,6701,204,4.44138e+16,19.5183,1312.45,6905,73,26,5526,4681,2894,3676,850
12194,7237,12194,12194,0,0,12194,134207000,0,12194,12194,12194,1,0,0,0,0,0
14456,892,3420,5087,9369,0,14456,9.88886e+12,59.7903,4649.76,14456,1665,72,11036,11036,7417,10410,3136
11084,46,3879,0,11084,0,11084,5.52368e+17,82.5335,4920.47,11084,1856,110,4008,828,1938,76,0
42440,5939,20640,0,42440,0,42440,4.35385e+17,92.9011,23029.1,42440,10020,110,21800,21800,15783,10129,7518
34348,259,1026,0,34348,33368,980,3.55547e+16,211.012,3395.92,34348,153,26,33191,32925,28467,28566,13064
19346,658,4587,18224,1122,18224,1122,5.77054e+18,97.3953,6359.84,19346,2206,110,14759,14759,11853,9658,3010
49766,11937,14840,0,49766,18069,31697,2.31533e+15,59.048,17933.4,49766,7222,72,34926,34926,32918,30275,29688
12669,535,3341,11951,718,11951,718,3.20541e+18,96.7182,4594.76,12669,1604,110,9328,9328,4977,6809,2354
25629,7997,9923,25629,0,24318,1311,5.12075e+18,185.13,11307.6,25629,2994,131,15706,15706,14926,15557,12845
39997,8635,12012,37867,2130,0,39997,2.0366e+18,96.793,14913,39997,5833,110,27985,27985,25258,23966,20908
19982,7002,7311,19015,967,0,19982,1.85225e+18,95.4155,8889.95,19982,3538,110,12671,12671,12287,12240,12121
18532,5325,5760,6766,11766,0,18532,8.95087e+12,58.7019,7136.4,18532,2806,72,12772,12772,12256,12677,11815
20326,1952,4844,19146,1180,0,20326,2.2214e+18,97.5029,6683.88,20326,2337,110,15482,15482,11281,10340,6985
12648,238,533,0,12648,12290,358,3.55616e+16,20.132,1494.49,12648,73,26,12115,12115,10225,10353,6379
16129,944,7877,15499,630,15499,630,9.43513e+18,93.2852,9026.05,16129,3803,110,8252,7946,6753,5972,1050
6018,792,1594,5675,343,5675,343,4.24586e+18,94.3365,2317.53,6018,730,92,4424,4424,3720,4344,2781
13162,5876,5924,12602,560,12602,560,4.12498e+18,94.4176,6954.97,13162,2837,111,7238,7238,7209,7235,7224
9420,2458,3008,8920,500,8920,500,3.27278e+18,96.1567,3951.75,9420,1426,108,6412,6412,5710,5801,5746
34733,8,12,33743,990,34720,13,1.38934e+14,10.1189,523.283,34733,11,11,33927,33420,31899,31900,27605
4524,299,2539,1836,2688,0,4524,5.81926e+12,53.8223,2884.25,4524,1232,68,1985,1889,1284,1865,670
49356,120,176,49282,74,49356,0,6.10211e+18,173.436,2751.53,49356,174,170,46580,42364,32857,33571,33662
49571,5168,11548,17418,32153,0,49571,9.885e+12,60.0804,14866,49571,5621,72,38023,38023,28665,36405,17241
45447,3328,10650,42805,2642,42805,2642,5.89605e+18,97.8658,14100,45447,5167,110,34797,34797,32967,32133,12469
23879,826,872,0,23879,23199,680,3.6486e+16,147.914,2649.48,23879,122,26,23007,23007,22880,22871,22243
15769,155,176,15718,51,15769,0,6.1698e+18,158.243,1548.72,15769,129,132,15475,15201,13979,13919,13766
26864,475,926,0,26864,26095,769,3.63668e+16,175.855,2897.77,26864,133,26,25938,25661,21982,22456,17747
42771,11526,14727,15880,26891,0,42771,8.45838e+12,57.4555,17311.3,42771,7168,72,28044,28044,25650,27544,21773
14176,199,3355,0,14176,4978,9198,2.52536e+15,59.7532,4568.45,14176,1630,72,10821,10821,6257,3960,796
14520,7245,8291,14520,0,14000,520,4.50388e+18,107.669,9094.13,14520,3805,122,6229,6229,6213,6215,6229
19912,4858,10698,19202,710,19202,710,9.08248e+18,88.9911,11930.5,19912,5136,111,9214,9214,6677,7520,5435
45589,8547,10678,42939,2650,42939,2650,3.24021e+18,97.8745,14139.2,45589,5177,110,34911,34911,32761,34287,28872
16191,6182,7852,6408,9783,0,16191,6.66155e+12,55.8627,8846.63,16191,3819,72,8339,8339,7416,8142,6059
39763,195,9311,13980,25783,0,39763,9.86716e+12,60.0328,12074,39763,4530,72,30452,30452,7730,24130,1069
525,15,38,0,525,509,16,3.51367e+16,16.3333,106.758,525,19,19,473,447,414,413,273
25785,2674,6045,24284,1501,0,25785,2.23006e+18,97.6405,8258.66,25785,2921,110,19740,19740,15181,14290,9722
11624,5101,7529,11624,0,10299,1325,1.69768e+18,6.51488,8673.53,11624,1456,15,4095,4095,4095,4095,2861
35056,12,14,34040,1016,34971,85,1.59141e+14,10.5291,610.843,35056,13,12,35041,35036,34739,34732,34062
8742,2633,4268,3450,5292,0,8742,6.60646e+12,55.4707,4894.14,8742,2067,72,4474,4474,3595,4287,2277
1299,8,10,1257,42,1297,2,2.06935e+14,9.49192,104.635,1299,10,10,1277,1271,1167,1171,1075
27475,11149,11892,26275,1200,26275,1200,5.02126e+18,95.2342,13706.4,27475,5718,111,15583,15583,15583,15583,14467
33348,221,12891,0,33348,0,33348,5.19048e+17,95.3426,15164.9,33348,6256,110,20457,19597,11814,3796,1974
10622,293,2591,0,10622,0,10622,6.42752e+17,96.6823,3716.97,10622,1233,110,8031,8031,2967,1284,1459
13064,1222,4831,13064,0,12344,720,4.19854e+18,118.663,5640.49,13064,1820,118,8233,8197,4444,6117,2316
24939,540,861,0,24939,24227,712,3.57702e+16,150.287,2650.35,24939,121,26,24078,23880,21231,21649,17617
18772,3405,7595,7160,11612,0,18772,7.72073e+12,57.1729,8836.63,18772,3695,72,11177,11177,8125,10647,4580
47356,6979,11987,16812,30544,0,47356,9.61226e+12,59.7435,15113.8,47356,5824,72,35369,35369,30200,34289,21551
28518,3510,7115,10096,18422,0,28518,9.67821e+12,59.2255,9190.7,28518,3447,72,21403,21403,17520,20593,11084
2789,783,954,2789,0,2626,163,4.0315e+18,90.2399,1295.61,2789,345,67,1835,1835,1748,1781,1722
26600,2808,11753,25460,1140,25460,1140,3.86852e+18,94.2277,13506.1,26600,5629,111,14847,14847,10156,10568,4925
41358,4990,9641,38948,2410,0,41358,2.23059e+18,97.8902,12847.8,41358,4674,110,31717,31717,25384,24008,17630
26926,163,10725,0,26926,10251,16675,1.98628e+15,50.9612,12391,26926,5210,72,16201,15896,5836,0,0
14106,60,176,14098,8,14106,0,6.01218e+18,168.023,1437.12,14106,141,141,9822,5429,4194,4902,4696
26639,5112,7818,25189,1450,25189,1450,4.46787e+18,97.3368,9907.59,26639,3719,111,18821,18821,16697,18683,13640
43110,5530,19716,41330,1780,0,43110,1.58143e+18,94.3175,22238.7,43110,9580,110,23394,23394,16077,14340,8903
30175,3740,7005,10599,19576,0,30175,9.90654e+12,60.0149,9215.93,30175,3403,72,23170,23170,18402,22350,12732
42537,2,14,41324,1213,42460,77,1.39014e+14,10.616,641.269,42537,13,12,24626,17446,16977,18052,13738
2967,276,1639,0,2967,0,2967,4.126e+17,83.4698,1945.03,2967,779,56,1328,1256,484,244,462
25716,3030,6032,24216,1500,0,25716,2.23207e+18,97.651,8238.5,25716,2908,110,19684,19684,16268,14885,10646
7494,85,324,0,7494,1562,5932,1.50028e+16,11.9736,601.167,7494,321,13,7170,7170,5044,3408,6220
2694,1280,1535,2601,93,2601,93,2.33938e+18,56.3604,1813.19,2694,713,54,1159,1159,1159,1159,1159
49757,2,14,48339,1418,49675,82,1.38874e+14,10.441,680.301,49757,13,12,28826,20430,19886,21106,16828
45251,9767,13585,45251,0,42611,2640,4.44107e+18,313.994,15807.6,45251,3095,137,31666,31666,28763,30645,23993
45604,1294,1660,0,45604,44283,1321,4.07943e+16,299.587,5545.88,45604,280,26,43944,43944,42710,42673,38024
48018,567,1281,0,48018,46648,1370,3.55681e+16,262.299,4501.95,48018,205,26,46737,46033,41929,42346,27569
34216,14578,15382,34216,0,30328,3888,1.61362e+18,3474.99,20729.1,34216,5513,23,18834,18834,18834,18834,18435
34131,6855,16926,32811,1320,32811,1320,3.70714e+18,92.3287,18886,34131,8140,111,17205,17205,10661,11807,8260
40729,5465,9505,38359,2370,38359,2370,5.75132e+18,97.871,12672.4,40729,4613,110,31224,31224,28799,28403,19147
22257,1122,5232,20959,1298,20959,1298,3.3539e+18,97.5869,7206.91,22257,2526,110,17025,17025,8723,12450,4666
39344,1515,15382,0,39344,14928,24416,2.01138e+15,57.5476,17656.1,39344,7487,72,23962,23914,9578,6004,4473
20518,68,176,20503,15,20518,0,6.05829e+18,170.527,1764.56,20518,146,152,15664,9920,7368,8260,7872
9587,1899,2361,0,9587,0,9587,6.4056e+17,96.5116,3403.86,9587,1118,110,7226,7226,6736,6918,6202
46907,8712,14729,44446,2461,44446,2461,2.88471e+18,97.1904,17900.8,46907,7024,111,32178,32178,28048,31904,21397
24888,9640,13056,24888,0,18080,6808,4.51694e+18,338.28,14274.6,24888,5943,127,11832,11789,10615,11177,9678
39454,2265,21841,39454,0,39454,0,4.68753e+18,17.8934,22374.1,39454,19641,20,17613,17613,1615,17613,1661
27459,3895,9896,27459,0,25989,1470,5.1119e+18,209.697,11383.6,27459,2837,132,17563,17506,13422,15525,8095
45513,17882,24822,18514,26999,0,45513,5.85916e+12,54.5495,26844.9,45513,12077,72,20691,20691,17915,20111,13374
34408,6899,11100,34408,0,32405,2003,3.79998e+18,239.358,12657.4,34408,3504,130,23308,23240,19478,20734,15145
4164,317,1390,4164,0,3922,242,4.99702e+18,91.8802,1834.59,4164,513,86,2774,2774,1578,1967,925
27748,224,1126,0,27748,26945,803,4.00669e+16,231.812,3508.51,27748,171,26,26456,26104,22866,21199,10592
38576,26316,38576,38576,0,38576,0,8.79587e+12,0,38576,38576,38576,1,0,0,0,0,0
1309,222,579,1309,0,1239,70,7.13062e+18,81.8105,758.824,1309,202,53,730,652,531,641,491
26846,15,176,26784,62,26846,0,6.02213e+18,172.418,1996.08,26846,164,162,8900,1657,2007,2137,2165
15740,2177,6506,0,15740,6019,9721,1.94297e+15,55.1464,7582.48,15740,3149,72,9234,9234,7102,6873,4532
3438,83,1374,1302,2136,0,3438,7.90453e+12,47.6353,1732.6,3438,646,61,2064,1734,552,36,0
41885,6485,9845,39455,2430,39455,2430,3.35681e+18,97.8162,13076.4,41885,4768,110,32040,32040,25307,28340,22104
21023,3775,12265,20353,670,20353,670,2.25815e+18,86.8931,13468.4,21023,5934,110,8758,8758,4505,5780,3811
18429,6679,9254,18429,0,17661,768,3.93195e+18,181.256,10269.6,18429,4173,124,9175,9140,7662,8286,6441
27042,343,1054,0,27042,26266,776,3.89519e+16,227.573,3274.58,27042,157,26,25941,25558,22577,21858,9766
41053,953,1146,0,41053,39884,1169,3.55277e+16,238.161,3927.84,41053,178,26,39907,39907,39328,39306,35863
31340,5226,10518,11584,19756,0,31340,8.58979e+12,58.3924,12544.3,31340,5124,72,20822,20822,17306,20085,11519
12449,4792,5168,12449,0,11829,620,6.0081e+18,128.453,5992.82,12449,1686,122,7281,7281,7276,7281,6797
7253,28,323,0,7253,7048,205,3.57655e+16,19.9454,917.753,7253,53,26,6930,6871,4512,4427,1555
15830,1897,8510,15830,0,15200,630,4.98315e+18,162.453,9318.37,15830,3743,122,7320,7141,4198,5471,2418
20496,6301,7039,0,20496,7607,12889,2.17095e+15,51.3636,8478.12,20496,3421,72,13457,13457,12508,13294,11523
39982,1818,9347,0,39982,0,39982,6.48214e+17,97.8369,12463.3,39982,4531,110,30635,30635,20408,11384,7663
6116,1161,1483,5756,360,5756,360,5.82516e+18,95.9871,2236.82,6116,705,92,4633,4633,4553,4553,3971
8297,112,407,7953,344,2452,5845,1.4429e+18,16.9578,749.503,8297,355,19,7890,7890,6606,6899,3803
16492,1325,3912,15532,960,0,16492,2.22856e+18,97.3562,5484.77,16492,1881,110,12580,12580,8032,7439,4809
49284,4179,13962,46602,2682,0,49284,2.0845e+18,97.1171,17452.8,49284,6779,110,35322,35322,22591,20208,12125
28671,6,176,28662,9,28671,0,5.99313e+18,171.39,2041.71,28671,159,165,4861,658,644,593,767
35389,6420,10205,33471,1918,33471,1918,6.54338e+18,96.9875,12878.2,35389,4955,110,25184,25184,23472,23188,16799
37405,1708,12344,35503,1902,35503,1902,3.11924e+18,96.2631,15006.8,37405,5980,110,25061,25061,10662,16663,4444
7492,529,2242,0,7492,2718,4774,2.32161e+15,54.5331,2947.37,7492,1075,72,5250,5250,1814,720,0
28730,4676,6770,27060,1670,0,28730,2.22693e+18,97.6971,9173.62,28730,3270,110,21960,21960,19673,18755,16043
15568,6623,6774,0,15568,6019,9549,1.87824e+15,56.5804,7806.52,15568,3291,72,8794,8794,8645,8624,8514
38778,171,12714,14282,24496,0,38778,8.67233e+12,58.5635,15148.1,38778,6194,72,26064,25686,8481,20664,983
1061,118,345,1001,60,1001,60,5.77177e+18,84.0104,539.646,1061,135,45,716,343,555,555,286
28183,4373,6632,26543,1640,0,28183,2.22657e+18,97.7242,9001.89,28183,3211,110,21551,21551,19053,18053,15088
4323,841,1087,4071,252,4071,252,5.71845e+18,94.8064,1668.38,4323,498,82,3236,3236,3087,3074,2788
1244,120,172,1244,0,1244,0,5.97313e+18,111.768,424.28,1244,60,52,1050,947,820,827,780
37058,91,176,37043,15,37058,0,5.97931e+18,169.854,2280.05,37058,167,171,32012,19602,17682,18790,19201
10010,1302,2385,0,10010,0,10010,6.48691e+17,96.7601,3469.41,10010,1137,110,7625,7625,6405,5052,4656
976,54,280,0,976,347,629,2.52461e+15,54.2316,441.152,976,130,45,633,263,229,142,127
15105,5241,9157,15105,0,14622,483,4.44567e+18,210.155,9977.98,15105,4315,118,5948,5885,4882,5434,4498
23070,3241,8850,21983,1087,21983,1087,7.91094e+18,95.2273,10571.1,23070,4282,110,14220,14220,12260,11932,4548
24898,4391,5797,8748,16150,0,24898,9.89153e+12,59.9969,7695.25,24898,2814,72,19101,19101,17044,18741,14668
25398,88,208,25380,18,25398,0,6.03218e+18,195.32,2071.16,25398,163,168,21419,13452,10598,11452,10933
17935,734,9504,17288,647,17288,647,2.35796e+18,90.5599,10670.7,17935,4601,110,8431,7829,5232,5130,1465
47589,19280,20135,45499,2090,0,47589,1.6802e+18,93.9726,22994.8,47589,9785,110,27454,27454,26369,26158,25435
6108,2403,3506,6108,0,6108,0,2.41166e+18,14.3716,3697.59,6108,3140,20,2602,2602,1544,2599,1579
36222,117,176,36133,89,36222,0,6.04327e+18,173.011,2342.45,36222,164,168,33867,30647,23247,23798,24241
40646,3461,14548,0,40646,15182,25464,2.11812e+15,56.9592,16987.2,40646,7064,72,26098,26098,16031,9796,7746
18301,785,4343,17239,1062,17239,1062,5.76269e+18,97.3478,6042.98,18301,2085,110,13958,13958,11550,9690,3391
12316,1030,2912,0,12316,0,12316,6.50731e+17,97.0499,4174.37,12316,1397,110,9404,9404,6836,5072,3892
24490,5916,7733,8952,15538,0,24490,8.81966e+12,58.6557,9442.51,24490,3759,72,16757,16757,14547,16297,10959
47640,5795,12669,44981,2659,44981,2659,3.26702e+18,97.3395,16131.7,47640,6134,110,34971,34971,22329,27804,16401
20508,166,176,20504,4,20508,0,6.0116e+18,169.773,1727.71,20508,157,154,20259,20032,19320,19295,19280
15778,1835,3717,5551,10227,0,15778,9.88569e+12,59.8175,5035.81,15778,1805,72,12061,12061,9272,11572,6005
17118,867,6953,16338,780,0,17118,1.74137e+18,93.6833,8292.09,17118,3365,110,10165,9840,4882,3128,1041
38621,4981,25020,34231,4390,34231,4390,1.3262e+18,6.52386,28721.6,38621,8351,14,13601,13601,9262,8770,3409
47873,7,14,46508,1365,47793,80,1.38935e+14,10.4115,662.135,47873,13,12,46188,45005,34620,34516,31766
10026,40,705,0,10026,9734,292,4.29787e+16,30.8895,1742.49,10026,89,26,9321,9277,6037,6070,2003
35012,3990,8395,32972,2040,32972,2040,2.61777e+18,98.2826,11129.2,35012,3971,111,26617,26617,15691,20000,13812
4389,326,1071,1541,2848,0,4389,9.80472e+12,58.6532,1572.47,4389,512,69,3318,3318,1896,2933,1087
15181,12,14,14743,438,15116,65,1.55524e+14,10.6159,379.212,15181,13,11,15167,15166,14716,14716,14222
22850,150,176,22836,14,22850,0,6.07928e+18,171.314,1865.07,22850,150,155,22327,21616,19534,19498,19341
47796,14998,23388,18969,28827,0,47796,6.59776e+12,56.0046,25690.5,47796,11394,72,24408,24408,20667,23770,16387
44976,2832,10491,0,44976,15809,29167,2.53288e+15,60.0696,13549,44976,5110,72,34485,34485,19054,14763,9694
47963,1,15,46571,1392,47898,65,1.59614e+14,10.4076,734.17,47963,13,11,10398,10398,10398,10398,10398
29126,3623,6793,0,29126,0,29126,6.49683e+17,97.7577,9228.6,29126,3285,110,22333,22333,17973,13293,12703
48530,7161,11307,0,48530,17055,31475,2.53256e+15,60.0849,14565.1,48530,5507,72,37223,37223,31182,23620,23880
11264,3947,7477,11264,0,10954,310,4.21699e+18,182.163,8091.18,11264,3548,104,3787,3763,2625,3067,2401
14562,143,208,14517,45,14562,0,6.11182e+18,197.132,1608.61,14562,139,140,13719,12725,10130,10194,10001
35229,7288,15610,0,35229,0,35229,4.70803e+17,94.4466,17814.1,35229,7575,110,19619,19619,15808,12394,9796
8949,186,4654,8619,330,0,8949,1.41999e+18,60.8244,5370.14,8949,2226,93,4295,4295,1573,1540,908
40088,11294,15379,0,40088,0,40088,5.22016e+17,95.4628,18012.2,40088,7469,110,24709,24709,20115,13204,12443
34109,6715,17596,32849,1260,0,34109,1.41385e+18,91.5515,19527.3,34109,8547,110,16513,16513,11689,10444,6975
9128,2898,4681,3651,5477,0,9128,6.32666e+12,52.8738,5305.67,9128,2258,72,4447,4447,2872,4177,1175
10865,3293,4010,10335,530,0,10865,1.8599e+18,94.9009,5010.24,10865,1934,110,6855,6855,6046,5719,5022
17086,1420,4016,6013,11073,0,17086,9.87453e+12,59.8426,5422.3,17086,1950,72,13070,13070,9356,12427,4946
8225,339,4040,1805,6420,0,8225,52265500000,8.9628,4224.33,8225,3628,11,4185,4185,1252,4185,910
37485,1,12,36417,1068,37469,16,1.38812e+14,10.317,549.64,37485,12,11,9603,9603,9603,9603,9603
44695,16508,24460,43145,1550,43145,1550,2.88518e+18,89.1095,26675.9,44695,11801,111,20235,20235,17677,20079,14365
41808,102,176,41746,62,41808,0,6.06086e+18,173.093,2523.37,41808,170,172,37553,26240,22854,23687,24119
13829,1600,3266,4870,8959,0,13829,9.88691e+12,59.8166,4458.72,13829,1590,72,10563,10563,8110,10136,5267
6053,45,176,6046,7,5819,234,6.07022e+18,156.594,957.392,6053,102,106,3793,1604,1390,1637,1485
16705,455,926,0,16705,16216,489,4.32001e+16,173.947,2598.74,16705,133,26,15779,15502,14693,14308,10645
10553,2510,4226,4010,6543,0,10553,7.72609e+12,56.9801,5035.25,10553,2044,72,6327,6327,4508,6013,2432
37404,1001,1244,0,37404,36784,620,2.51789e+16,3.73538,4777.87,37404,624,4,36160,36160,36135,35990,32167
14557,5114,6226,13918,639,0,14557,1.68108e+18,94.1946,7381.11,14557,3010,110,8331,8331,7872,7549,7441
31625,489,7423,0,31625,0,31625,6.47626e+17,97.7569,10016.7,31625,3591,110,24202,24202,14789,3983,3109
23468,1457,7290,23468,0,22101,1367,3.52056e+18,162.705,8660.13,23468,2801,122,16178,16042,9290,11857,3734
21026,1130,8199,20046,980,0,21026,1.78394e+18,95.0938,9793.9,21026,3969,110,12827,12827,7419,5135,3289
20865,5921,10919,20105,760,20105,760,9.97033e+18,87.726,12240.9,20865,5278,110,9946,9946,9346,9246,7320
45622,4786,21552,43792,1830,0,45622,1.53654e+18,93.4984,24135.8,45622,10464,110,24070,24070,14116,13177,6744
19961,4858,6559,19961,0,18801,1160,4.17899e+18,150.068,7643.94,19961,1725,123,13402,13402,12615,13360,10367
32635,3639,10650,32635,0,30795,1840,4.60167e+18,226.108,12364,32635,4244,125,21985,21845,14616,17801,7814
26062,4502,8557,26062,0,24545,1517,3.55068e+18,168.251,9839.08,26062,3132,125,17505,17505,12774,14565,9743
45291,1682,10728,15953,29338,0,45291,9.82548e+12,60.0017,13796.6,45291,5211,72,34563,34563,14964,29158,6121
42677,6106,9972,15009,27668,0,42677,9.88322e+12,60.0442,12900.1,42677,4852,72,32705,32705,28074,31736,20332
16649,5001,6828,6366,10283,0,16649,7.65111e+12,57.0826,7954.05,16649,3325,72,9821,9821,8942,9671,8117
10275,7,11,9983,292,10273,2,1.44943e+14,9.99046,284.996,10275,11,11,9918,9575,7393,7228,7014
32400,5165,12020,32400,0,30700,1700,4.47524e+18,240.629,13689.4,32400,3689,133,20380,20268,13633,15898,9208
44534,11631,18284,42524,2010,42524,2010,2.02084e+18,94.3681,20987.7,44534,8788,111,26250,26250,23722,26074,20232
26540,1010,6233,0,26540,9340,17200,2.52305e+15,59.9526,8225.15,26540,3025,72,20307,20307,12809,6635,3697
38601,13,176,38521,80,38601,0,5.98531e+18,169.742,2326.48,38601,167,170,11529,1757,2438,2498,2666
28250,9768,14077,28250,0,0,28250,8.79171e+17,17.9695,14559.4,28250,12653,20,14173,14173,10156,11577,10031
26884,11,12,26117,767,26870,14,1.38706e+14,10.54,465.88,26884,12,11,26872,26872,26517,26518,26274
16526,942,1090,15854,672,5106,11420,1.27969e+18,16.9794,1575.57,16526,683,19,15436,15436,15382,15342,13984
3510,464,961,0,3510,0,3510,6.34266e+17,93.7618,1451.68,3510,444,74,2549,2549,1921,1179,1514
14042,259,4589,13314,728,13314,728,3.01057e+18,95.7874,5854.05,14042,2211,110,9453,9112,4899,6072,1479
16845,24,175,16779,66,16845,0,5.98061e+18,165.237,1536.85,16845,143,154,7396,1576,2039,2268,2384
28284,6005,13019,0,28284,11070,17214,1.78329e+15,56.3832,14605.3,28284,6336,72,15265,15217,10738,9829,5395
39924,2363,17688,39924,0,38244,1680,4.47661e+18,1530.63,20169.4,39924,7684,141,22236,19821,12216,15912,6382
3239,441,1432,3097,142,3097,142,7.56255e+18,91.0951,1814.05,3239,660,64,1807,1720,1368,1457,1404
35847,3,12,34824,1023,35829,18,1.38873e+14,10.3104,537.265,35847,12,11,27327,19206,23372,23726,13886
19995,2433,5687,18903,1092,0,19995,2.09106e+18,96.7144,7417,19995,2748,110,14308,14308,10848,9963,6522
11332,1,11,11004,328,11326,6,1.56038e+14,10.2424,306.79,11332,11,11,2529,2529,2529,2529,2529
42096,1823,9786,14791,27305,0,42096,9.88528e+12,60.0681,12689.3,42096,4755,72,32310,32310,14677,27538,6545
39319,13018,22257,0,39319,16126,23193,1.4303e+15,54.7296,23988.7,39319,10830,72,17062,17062,14044,9850,9080
23204,855,5448,0,23204,0,23204,6.49992e+17,97.6189,7483.74,23204,2634,110,17756,17756,7780,3957,3851
9522,1345,4249,9112,410,9112,410,2.76231e+18,93.4219,5074.2,9522,2041,104,5273,5273,2626,3634,1945
15381,158,176,15312,69,15381,0,6.01148e+18,166.9,1501.33,15381,142,147,15068,14706,13853,13903,13911
13457,59,4056,12737,720,12737,720,6.81674e+18,96.2293,5321.92,13457,1958,110,6162,1720,3993,5205,300
9958,419,4892,9568,390,9568,390,9.57099e+18,89.5795,5699.69,9958,2347,104,5066,4719,1270,4022,211
35641,2303,8297,12532,23109,0,35641,9.91202e+12,60.0579,10824.9,35641,4041,72,27344,27344,18666,25844,8116
30472,1040,9528,28864,1608,28864,1608,1.90441e+18,95.1914,11800.3,30472,4529,111,20944,20913,9073,7803,2462
44612,11897,21478,17648,26964,0,44612,6.70062e+12,55.8103,23687.7,44612,10457,72,23134,23134,18989,22424,14191
49579,705,2031,0,49579,48126,1453,4.37732e+16,319.524,6741.56,49579,354,26,47548,47548,38842,40748,22610
29394,360,13723,29394,0,28114,1280,4.98872e+18,366.254,15249.5,29394,4419,135,15546,14369,7367,9450,85
23399,3591,7437,0,23399,8579,14820,2.25774e+15,58.637,9079.66,23399,3623,72,15962,15962,12346,9276,8086
41658,16313,19309,39958,1700,39958,1700,2.66947e+18,94.2368,21747,41658,9386,110,22349,22349,20719,21237,20590
25272,666,9596,24079,1193,24079,1193,2.94888e+18,95.3376,11452,25272,4654,110,15676,15246,6498,10208,2894
45321,9703,10576,15940,29381,0,45321,9.88129e+12,60.0682,13655.2,45321,5146,72,34745,34745,33678,34517,32063
43651,1439,2581,8942,34709,0,43651,5.75741e+13,12.0038,3267.68,43651,1263,20,41070,41070,32883,27565,37370
34693,1295,12389,32983,1710,32983,1710,5.19155e+18,96.4732,14775,34693,5934,111,22304,22058,14708,8596,4643
33765,1563,1741,0,33765,32762,1003,4.76628e+16,301.311,5456.44,33765,297,26,32024,32024,31818,31778,30614
47742,22991,23088,45865,1877,45865,1877,2.61387e+18,93.8765,25715.7,47742,11217,110,24654,24654,24520,24575,24570
33730,2008,7918,31770,1960,31770,1960,5.89054e+18,97.7461,10645.1,33730,3828,110,25812,25812,24096,22980,7752
1601,109,464,1508,93,0,1601,2.24708e+18,88.9244,736.768,1601,204,53,1137,517,467,484,301
44395,921,10296,15604,28791,0,44395,9.90877e+12,60.0999,13328.3,44395,5011,72,34099,34099,11627,27910,3587
17656,3825,6743,15974,1682,16816,840,3.0225e+18,92.9662,8137.63,17656,3201,111,10913,10913,7998,8374,6526
9675,1244,4539,9675,0,9225,450,5.59464e+18,113.056,5158.55,9675,1865,114,5136,5100,3765,4449,2872
1856,23,482,0,1856,655,1201,2.57674e+15,56.9644,746.221,1856,229,54,780,132,322,252,48
39462,6082,10779,0,39462,14146,25316,2.40017e+15,59.4247,13408.9,39462,5245,72,28683,28683,23935,17551,16018
27769,3110,8983,26329,1440,26329,1440,4.74088e+18,96.8769,11077.5,27769,4286,111,18786,18786,11868,13333,8853
8978,1692,2837,8502,476,8502,476,3.02029e+18,95.4391,3759.06,8978,1355,110,6141,6141,4984,5793,2952
10878,1636,2585,10245,633,10245,633,5.87185e+18,96.8279,3737.92,10878,1236,110,8293,8293,8053,8055,5765
46836,8863,14819,44404,2432,44404,2432,6.93879e+18,96.5758,18047.5,46836,7186,110,32017,32017,29575,29167,19859
31725,6111,9163,11455,20270,0,31725,9.18161e+12,59.1317,11327,31725,4461,72,22562,22562,20271,22082,16580
42782,3784,10929,40342,2440,40342,2440,1.98816e+18,98.1154,14074.9,42782,5186,111,31853,31853,21860,25209,12662
19804,4466,4629,0,19804,6962,12842,2.54128e+15,59.913,6203.76,19804,2255,72,15175,15175,14945,15008,14821
5182,252,1309,1829,3353,0,5182,9.75108e+12,58.8807,1869.63,5182,628,72,3873,3873,2450,3623,870
49587,8577,11560,17423,32164,0,49587,9.87614e+12,60.0715,14879.3,49587,5622,72,38027,38027,34477,37287,28609
590,3,10,572,18,590,0,1.38352e+14,9.21695,67.5332,590,10,10,435,296,351,334,234
29496,1007,1047,0,29496,28649,847,3.76949e+16,214.939,3327.25,29496,158,26,28449,28449,28335,28330,27849
24118,5605,6285,22758,1360,22758,1360,6.26194e+18,97.1955,8331,24118,3044,110,17833,17833,17663,17663,16124
43785,7,15,42515,1270,43697,88,1.58734e+14,10.4775,699.156,43785,14,12,42441,41536,38194,35433,26090
22486,6263,11141,22486,0,21523,963,5.00972e+18,194.151,12208.1,22486,3964,128,11345,11285,9819,10565,8224
16244,139,688,0,16244,15782,462,3.55675e+16,20.1214,1890.95,16244,86,26,15556,15556,13309,13480,4745
25801,12072,12673,10239,15562,0,25801,6.58294e+12,55.2653,14083.5,25801,6157,72,13128,13128,12875,13081,12725
34057,8688,11813,32367,1690,0,34057,1.90148e+18,95.9787,14242.3,34057,5725,110,22244,22244,19641,19059,16886
40849,122,176,40784,65,40849,0,6.08858e+18,173.251,2501.18,40849,169,169,38632,35296,28008,28272,28291
11786,1913,5529,0,11786,4623,7163,1.77076e+15,54.0263,6329.57,11786,2677,72,6257,6257,4331,2366,1801
29460,11,12,28618,842,29445,15,1.43289e+14,10.1394,487.075,29460,12,11,29448,29448,28643,28644,27368
49001,10165,23404,0,49001,0,49001,4.42212e+17,94.0421,26110.8,49001,11377,110,25597,25597,19951,16024,12123
18184,3702,7894,16782,1402,17294,890,4.51969e+18,153.24,8847.84,18184,2587,128,10290,10269,7402,8525,5593
35685,5707,8422,33615,2070,0,35685,2.22252e+18,97.7516,11268.5,35685,4075,110,27263,27263,23625,22971,19352
702,41,614,702,0,684,18,4.03739e+18,15.2422,647.595,702,266,25,62,15,35,30,0
5175,950,1309,4871,304,4871,304,1.51046e+18,95.8827,1962.95,5175,600,88,3866,3866,3518,3839,3150
19426,6033,6429,19426,0,18296,1130,4.58844e+18,148.302,7493,19426,1393,127,12997,12997,12997,12997,12678
48968,11713,18726,48968,0,46640,2328,4.47754e+18,1734.99,21725.7,48968,6356,145,30242,28663,26632,28384,21428
21484,6913,11312,0,21484,8669,12815,1.56852e+15,54.5953,12470.4,21484,5505,72,10172,10172,8959,8490,7105
9911,13,176,9845,66,9911,0,6.06182e+18,164.047,1221.09,9911,121,127,3015,528,653,659,683
42964,9654,16094,0,42964,0,42964,5.30029e+17,95.6433,18902.7,42964,7822,110,26870,26870,19642,14360,7360
29869,808,944,0,29869,29016,853,3.55837e+16,183.802,3030.24,29869,138,26,28925,28925,28285,28336,26175
49848,5264,21808,47718,2130,47718,2130,2.68821e+18,93.0946,24718.8,49848,10582,110,28040,28040,19905,21311,8044
38349,5,14,37254,1095,38272,77,1.39082e+14,10.5946,603.437,38349,14,12,35282,31550,30447,31096,20375
5074,211,1249,4774,300,4774,300,5.82106e+18,95.3591,1903.45,5074,591,86,3825,3825,3410,3140,981
34933,3580,10230,12637,22296,0,34933,9.11644e+12,59.0806,12560,34933,4977,72,24703,24703,16424,22547,9029
35328,1703,10794,33458,1870,33458,1870,3.03372e+18,96.5939,13410.3,35328,5237,110,24534,24534,15309,18053,5878
45677,6957,15248,0,45677,0,45677,5.62937e+17,96.2843,18351.6,45677,7396,110,30429,30429,24513,20927,15097
49512,9025,23900,19579,29933,0,49512,6.66657e+12,55.6048,26300,49512,11622,72,25612,25612,18156,24332,9227
33546,503,1032,0,33546,33032,514,2.46271e+16,3.73597,3986.59,33546,518,4,32514,32514,32290,31990,22811
35888,12885,16002,34378,1510,34378,1510,8.83803e+18,94.4149,18229.1,35888,7770,110,19886,19886,19094,18962,16251
34276,5055,8027,0,34276,0,34276,6.49485e+17,97.8014,10784.9,34276,3891,110,26249,26249,22931,21227,17498
35878,1317,2005,0,35878,34798,1080,5.05215e+16,313.655,6288.29,35878,349,26,33873,33873,32874,32755,25203
20721,8652,12100,0,20721,8556,12165,1.38492e+15,54.3816,13119.3,20721,5892,72,8621,8621,7718,6455,6389
37158,2718,8996,0,37158,0,37158,6.42054e+17,97.6658,11910.2,37158,4358,110,28162,28162,17304,14006,10178
1031,76,300,360,671,0,1031,1.02939e+13,53.7624,465.866,1031,137,42,731,570,435,679,243
32219,6042,10597,11864,20355,0,32219,8.64563e+12,57.8763,12692.1,32219,5140,72,21622,21622,17811,20962,13287
3312,882,1905,3195,117,3195,117,9.12343e+18,86.0329,2225.01,3312,884,63,1407,1320,769,935,764
12614,3904,4122,11963,651,0,12614,1.97751e+18,95.654,5291.95,12614,1985,110,8492,8492,8219,8200,8135
11189,1248,2763,10539,650,10539,650,5.33937e+18,97.4389,3917.04,11189,1298,111,8426,8426,7210,7848,4525
41835,19,64,41675,160,33643,8192,1.11715e+18,31.951,1547.63,41835,33,32,24260,0,5727,21382,4671
44039,4326,8192,44039,0,44039,0,4.3456e+15,6668.15,18975,44039,8192,6,20383,0,6165,17982,20383
41887,9397,13854,0,41887,15451,26436,2.21103e+15,58.5134,16435.3,41887,6744,72,28033,28033,23371,17566,17810
2402,267,663,2262,140,2262,140,2.38964e+18,92.4455,1034.06,2402,297,62,1739,1739,1081,1227,957
29461,8081,11843,28118,1343,28118,1343,2.90215e+18,95.0544,13868.8,29461,5747,110,17618,17618,14340,15558,13461
16422,2968,3908,15469,953,15469,953,3.22105e+18,97.2655,5473.39,16422,1870,110,12514,12514,11584,12235,10012
47590,11778,13231,44960,2630,44960,2630,3.49249e+18,97.3385,16571.5,47590,6301,111,34359,34359,33125,34269,31178
41766,5180,15592,41766,0,39606,2160,4.27096e+18,373.822,17639.7,41766,6277,137,26174,25862,17055,20345,9809
17668,2206,7895,0,17668,6863,10805,1.8294e+15,56.4821,9018.56,17668,3836,72,9773,9773,6491,3178,2241
48660,2399,16095,46181,2479,46181,2479,7.14447e+18,96.3709,19362.6,48660,7817,110,32565,32565,27349,23465,6927
27324,5937,6414,9605,17719,0,27324,9.88337e+12,59.964,8449.46,27324,3118,72,20910,20910,20237,20790,19580
9363,1320,9363,9363,0,9363,0,8.79515e+12,0,9363,9363,9363,1,0,0,0,0,0
25329,2386,8438,0,25329,0,25329,5.66895e+17,95.1334,10401.5,25329,4086,110,16891,16891,10398,7954,5911
3582,193,1821,782,2800,0,3582,52404500000,8.93188,1937.47,3582,1632,11,1761,1759,536,1761,416
10627,3496,5597,10627,0,6921,3706,6.3143e+18,135.477,6224.62,10627,1695,115,5030,5030,4416,5030,2870
11527,34,2743,4056,7471,0,11527,9.87215e+12,59.6827,3779,11527,1331,72,6331,1273,3470,4267,62
26111,319,13325,0,26111,0,26111,4.17057e+17,93.3304,14913.6,26111,6473,110,12786,12098,5917,1309,1657
4414,212,327,0,4414,4284,130,4.32117e+16,17.8271,820.689,4414,50,26,4087,4087,3749,3806,2838
24370,5780,9355,24370,0,23071,1299,3.97616e+18,169.32,10544.3,24370,3694,124,15015,15001,12079,13393,10056
19866,4265,10440,19146,720,19146,720,1.01224e+19,92.8678,11707.9,19866,5062,110,9426,9426,9006,9006,4633
44146,286,1595,0,44146,42868,1278,4.04702e+16,289.858,5315.71,44146,264,26,42261,41471,31376,30120,13974
7111,134,170,7110,1,7111,0,5.97862e+18,159.967,994.911,7111,113,117,6729,6337,5438,5589,5610
15515,10,14,15062,453,15469,46,1.69447e+14,10.6303,391.793,15515,13,11,15429,15311,12877,12944,11292
46333,9518,11123,43640,2693,43640,2693,2.29132e+18,98.3212,14526.9,46333,5257,111,35210,35210,32110,32860,30815
9642,327,6254,0,9642,2073,7569,5.69483e+15,5.48154,7201.52,9642,2082,13,3388,3388,1247,2375,588
36841,231,14245,35121,1720,35121,1720,8.13459e+18,94.9408,16703.2,36841,6915,110,22596,21736,46,16948,61
40340,1503,13559,38290,2050,38290,2050,4.9207e+18,95.6017,16308.6,40340,6475,111,26781,26781,9083,26781,3432
30769,12,13,29865,904,30745,24,1.67345e+14,10.2484,528.468,30769,12,12,30756,30756,30643,30644,30424
15103,981,4257,14266,837,14266,837,2.38127e+18,97.1515,5643.43,15103,2017,111,10846,10846,6666,7208,3326
2857,130,175,2851,6,2857,0,6.18005e+18,123.716,659.285,2857,78,76,2624,2485,2230,2261,2166
8536,2417,3239,3207,5329,0,8536,8.09152e+12,57.3085,3945.39,8536,1576,72,5297,5297,4375,5137,3440
49420,12,14,48014,1406,49337,83,1.38921e+14,10.5304,694.52,49420,13,12,49406,49402,48205,48205,46528
36874,6765,12712,36874,0,34864,2010,4.89926e+18,287.791,14584.6,36874,3624,134,24162,24004,19527,22124,13688
47284,1629,19098,18050,29234,0,47284,7.68706e+12,57.25,21688.9,47284,9299,72,28186,28186,12960,23263,4204
26141,3,15,25365,776,26067,74,1.85622e+14,10.46,556.649,26141,13,11,20427,16028,11466,13219,7453
8368,663,4124,8368,0,8008,360,5.64896e+18,111.786,4712.88,8368,1405,108,4244,4026,3262,3900,1866
20811,4861,4972,19604,1207,19604,1207,3.34807e+18,97.4437,6841.13,20811,2393,110,15839,15839,15702,15754,15747
11207,160,176,11199,8,11207,0,6.04736e+18,161.503,1300.06,11207,128,127,10960,10772,10264,10242,10265
34961,7553,11276,34961,0,32931,2030,4.91293e+18,243.226,12850.3,34961,2683,132,23685,23611,21213,22887,16843
4850,89,1302,4575,275,4575,275,4.58397e+18,95.1674,1918.27,4850,596,85,3132,963,1324,2137,517
8641,239,2639,8174,467,8174,467,3.22653e+18,95.5396,3545.04,8641,1262,104,6002,5916,2487,4003,1216
37494,1094,8762,35306,2188,0,37494,2.23023e+18,97.8579,11723.9,37494,4250,110,28732,28732,18308,16877,5342
35967,6165,8431,33877,2090,33877,2090,5.76179e+18,97.773,11299.4,35967,4078,110,27536,27536,26192,25982,21065
16766,935,3969,15787,979,15787,979,5.73207e+18,97.4337,5560.01,16766,1916,110,12797,12797,10984,9647,3846
38377,760,9508,36177,2200,0,38377,2.19159e+18,97.6325,12479.2,38377,4613,110,28869,28869,11073,9169,4232
45825,1874,25010,45825,0,45825,0,2.42097e+18,17.9026,25593.3,45825,22495,20,20815,20815,1816,20815,1365
27918,970,9894,27918,0,26358,1560,3.67727e+18,179.353,11213.2,27918,3781,125,18024,17812,8547,12522,2455
26128,10558,13115,25138,990,25138,990,2.54346e+18,92.5767,14728.6,26128,6351,110,13013,13013,11960,12195,12252
28665,1604,6742,26995,1670,0,28665,2.22714e+18,97.7412,9142.08,28665,3266,110,21923,21923,14916,13450,6305
44044,6,176,43963,81,44044,0,5.98484e+18,172.058,2487.04,44044,171,172,7468,998,971,895,1347
20617,7,14,20015,602,20540,77,1.63053e+14,10.672,468.104,20617,13,12,20002,19671,15967,15761,11774
33872,66,176,33811,61,33872,0,6.02971e+18,172.562,2248.05,33872,163,167,25275,15118,11418,12803,12552
10805,2039,3245,0,10805,0,10805,5.97498e+17,95.9591,4324.06,10805,1558,110,7560,7560,6003,4411,4451
15681,1802,3736,14771,910,14771,910,3.217e+18,96.8964,5249.94,15681,1796,110,11945,11945,9912,11231,6533
32668,8,176,32591,77,32668,0,5.98547e+18,169.745,2141.48,32668,165,168,6848,847,1142,956,1299
42948,2594,10041,0,42948,15100,27848,2.52764e+15,60.0543,12984.7,42948,4884,72,32907,32907,22091,13090,8859
49118,13,14,47713,1405,49032,86,1.43987e+14,10.4792,702.848,49118,13,12,49104,49104,48509,48510,47738
32233,15271,18325,31163,1070,31163,1070,3.55094e+18,93.2166,19993.7,32233,8858,111,13908,13908,12582,13843,11747
47114,132,176,47034,80,47114,0,5.98389e+18,171.942,2571.8,47114,171,172,45175,42364,34917,35654,35340
31321,9,14,30429,892,31244,77,1.38882e+14,10.7238,546.491,31321,13,12,30860,30417,24342,24055,23806
16107,84,176,16100,7,16107,0,6.0399e+18,165.612,1560.55,16107,139,144,13493,8660,7305,7623,7907
28896,774,7904,0,28896,0,28896,6.15066e+17,97.0659,10223.4,28896,3820,110,20992,20833,10052,4592,3784
16475,465,528,0,16475,16213,262,2.48823e+16,3.73432,2065.92,16475,266,4,15947,15947,15940,15903,14844
42129,9791,14419,40020,2109,40020,2109,2.95556e+18,96.1729,17299.3,42129,7008,110,27710,27710,24405,26794,18686
19738,1230,1262,0,19738,19146,592,5.00366e+16,252.036,3661.25,19738,199,26,18476,18476,18451,18436,18330
34141,847,1434,0,34141,7112,27029,1.5001e+16,11.995,2039.19,34141,1431,13,32707,32707,27445,23368,30363
17977,3392,6282,17087,890,17087,890,7.55352e+18,95.5766,7771.47,17977,3030,110,11695,11695,11285,11285,7074
28401,92,1135,0,28401,27578,823,3.9917e+16,234.439,3554.25,28401,176,26,26871,26682,18744,17703,6836
37939,4880,8879,35731,2208,35731,2208,3.21563e+18,97.8173,11867.7,37939,4299,110,29060,29060,24989,27869,17107
20552,7210,7436,19547,1005,19547,1005,7.72092e+18,95.5276,9054.01,20552,3603,110,13116,13116,13058,13058,12736
4416,327,1462,4186,230,0,4416,1.99665e+18,84.5981,2010.64,4416,671,83,2954,2954,1798,1715,1308
28615,7756,9015,0,28615,0,28615,5.7961e+17,96.2455,11218.4,28615,4351,110,19600,19600,18589,17836,17835
24520,1749,5798,23092,1428,23092,1428,5.89352e+18,97.6599,7922.18,24520,2806,110,18722,18722,17704,17121,6554
37020,372,8688,13019,24001,0,37020,9.86425e+12,60.0134,11291.5,37020,4226,72,28332,28332,8032,22690,1612
48344,14136,15374,48344,0,45529,2815,4.3097e+18,330.024,17363.1,48344,5736,129,32970,32970,32141,32610,31025
38154,8270,12246,38154,0,35933,2221,4.90281e+18,270.275,13924.5,38154,2990,134,25908,25796,23123,24914,18624
29352,7352,10694,0,29352,0,29352,5.38506e+17,94.2012,12816.7,29352,5168,110,18658,18658,15969,13914,13180
39991,8705,17419,15478,24513,0,39991,7.27687e+12,56.5854,19586.4,39991,8465,72,22572,22572,18933,21812,12930
2785,58,145,0,2785,2708,77,3.61711e+16,19.1303,412.057,2785,37,26,2640,2640,2391,2396,1444
34528,8477,11127,34528,0,32518,2010,3.83064e+18,244.262,12690.8,34528,3498,130,23401,23327,22077,22681,18620
9909,1656,2407,9329,580,0,9909,2.22887e+18,96.8218,3474.82,9909,1154,110,7502,7502,6740,6439,5805
44914,8710,19068,17304,27610,0,44914,7.41212e+12,57.0256,21487.4,44914,9278,72,25846,25846,20728,24682,13938
36170,10,12,35133,1037,36151,19,1.42948e+14,10.2512,542.912,36170,11,12,36070,35952,33546,33593,32829
19441,2,12,18872,569,19427,14,1.68558e+14,10.2152,412.559,19441,12,11,11418,8745,6786,8808,4329
12925,83,176,12916,9,12925,0,6.00866e+18,164.424,1379.09,12925,138,138,10723,6459,5748,6088,6051
23781,909,1256,0,23781,23076,705,4.56629e+16,252.997,3764.98,23781,197,26,22525,22525,21965,22077,19751
29190,4493,7670,27557,1633,0,29190,2.1482e+18,97.2137,10034.2,29190,3705,110,21520,21520,18478,17200,13528
32111,2460,8646,11491,20620,0,32111,9.45016e+12,59.4588,10876.9,32111,4212,72,23465,23465,15494,22087,5831
34251,33,208,34171,80,34251,0,6.02114e+18,200.628,2407.97,34251,179,176,17967,5278,5587,6341,5664
2906,508,769,2736,170,2736,170,1.78907e+18,93.9222,1201.78,2906,349,67,2137,2137,1900,2118,1669
40435,7,176,40378,57,40435,0,6.02315e+18,173.173,2447.92,40435,171,170,7740,975,1311,971,1373
32214,958,985,0,32214,31296,918,3.55546e+16,199.566,3217.3,32214,146,26,31229,31229,31149,31139,30813
9172,574,2204,8640,532,0,9172,2.23291e+18,96.5243,3219.12,9172,1043,110,6968,6968,4760,4418,2279
3072,241,1040,3072,0,2892,180,5.37856e+18,90.6621,1404.89,3072,374,73,2032,2032,1257,1499,776
13743,729,834,0,13743,13340,403,4.33982e+16,142.245,2237.02,13743,115,26,12909,12909,12741,12731,11920
44855,7984,10504,42245,2610,0,44855,2.2263e+18,97.8792,13918.3,44855,5094,110,34351,34351,30982,30367,27064
3722,2135,2480,3722,0,3609,113,4.13509e+18,78.3033,2735.78,3722,1093,66,1242,1242,1209,1238,1242
28301,9,915,0,28301,27494,807,3.55616e+16,174.783,2901.76,28301,132,26,24522,22567,20399,19550,4347
5062,1195,1213,0,5062,1767,3295,2.54818e+15,59.162,1771.43,5062,590,72,3849,3849,3837,3845,3839
37054,10,16,35952,1102,36988,66,1.84508e+14,10.4578,671.054,37054,13,12,36926,36735,32898,32366,29708
49955,418,12941,0,49955,17788,32167,2.44581e+15,59.6504,16185.6,49955,6291,72,37014,36870,21269,1525,1969
37953,320,1091,0,37953,36872,1081,3.5538e+16,226.83,3682.78,37953,166,26,36792,36387,27933,28182,15951
44813,4693,10755,42203,2610,42203,2610,3.64567e+18,98.3326,14068.1,44813,5091,111,34058,34058,25447,29554,16160
14832,695,4082,14012,820,14012,820,6.47137e+18,96.6243,5478.42,14832,1955,110,10750,10750,6425,10750,2953
21824,3630,10326,21824,0,14529,7295,5.37572e+18,206.49,11387.4,21824,3385,130,11498,11441,8516,10091,4147
20565,1714,19220,19216,1349,19216,1349,2.36844e+17,3.98955,19289.5,20565,6427,9,1345,1345,233,236,123
32761,815,7702,30859,1902,0,32761,2.2265e+18,97.7141,10364.7,32761,3719,110,25059,25059,15735,13945,4169
26710,93,881,0,26710,25947,763,3.54947e+16,159.831,2760.13,26710,125,26,25671,25603,20747,21278,6780
38056,8606,11236,36016,2040,0,38056,2.05161e+18,96.8755,14045.6,38056,5451,110,26820,26820,24323,23216,20373
15104,3431,3942,0,15104,5380,9724,2.44693e+15,59.4592,5187.71,15104,1919,72,11162,11162,10418,10583,9694
28538,7,14,27708,830,28458,80,1.62801e+14,10.643,549.71,28538,14,12,27666,27172,25407,23521,18061
35851,2279,13482,0,35851,13505,22346,2.0598e+15,57.7485,15630.4,35851,6565,72,22369,22369,13842,8687,3584
48014,4852,11226,0,48014,0,48014,6.48346e+17,97.915,14829,48014,5449,110,36788,36788,27951,27183,17472
8242,355,539,0,8242,8004,238,4.10559e+16,18.9823,1348.3,8242,71,26,7703,7703,7432,7539,6470
21860,1,12,21218,642,21850,10,1.68125e+14,10.257,437.853,21860,11,12,4384,4384,4384,4384,4384
40778,10570,13070,40778,0,38408,2370,4.68289e+18,290.067,14830.3,40778,2601,136,27708,27707,26192,27300,23463
46675,2,14,45345,1330,46591,84,1.38943e+14,10.464,660.638,46675,13,12,27039,19164,18474,19335,14892
40985,2549,14470,38966,2019,38966,2019,7.6535e+18,95.9735,17251.3,40985,7031,110,26515,26515,24735,22989,4818
44720,2,13,43446,1274,44699,21,1.38742e+14,10.2713,602.071,44720,12,12,25881,18317,17882,18919,15109
9263,2009,5682,8983,280,8983,280,7.84557e+18,81.7941,6306.83,9263,2713,95,3581,3581,2083,2378,1657
22245,200,208,22223,22,22245,0,6.1309e+18,200.834,1992.82,22245,155,155,21985,21817,21288,21236,21283
13697,889,4138,4972,8725,0,13697,9.05201e+12,58.7421,5241.23,13697,2015,72,9559,9511,6590,9049,3119
32189,14412,15869,0,32189,12792,19397,1.67501e+15,54.3765,17545.4,32189,7709,72,16320,16320,15893,15474,15643
26034,48,176,25983,51,26034,0,5.98502e+18,169.653,1913.22,26034,163,161,16257,7841,5959,7426,7139
15617,3308,7085,14964,653,0,15617,1.60378e+18,93.8892,8263.28,15617,3428,110,8532,8532,6407,5893,4073
33452,828,7844,31502,1950,0,33452,2.22928e+18,97.7792,10551.1,33452,3802,110,25608,25608,9662,8345,4259
46463,3351,18655,46463,0,44543,1920,4.62212e+18,2938.47,22376,46463,7921,151,27003,23502,14305,18530,7688
26065,4394,8655,0,26065,9618,16447,2.20618e+15,58.107,10417.2,26065,4202,72,17410,17410,13420,11385,8665
9160,2523,3151,9160,0,8630,530,4.53071e+18,92.0348,3815.82,9160,1119,118,6009,6009,5432,5672,5194
1403,109,166,1403,0,1403,0,6.17631e+18,120.279,453.354,1403,63,59,1162,906,877,887,869
27509,6925,8953,21366,6143,25909,1600,3.22796e+18,171.423,10282.3,27509,3261,124,18556,18556,16968,17506,14785
3089,325,1141,2932,157,2932,157,4.32085e+18,85.9773,1543.73,3089,521,66,1948,1948,1241,1567,913
12711,2789,3055,11971,740,0,12711,2.22618e+18,97.0698,4343.71,12711,1463,110,9656,9656,9363,9326,9158
20770,584,4949,19560,1210,19560,1210,5.90571e+18,97.4722,6813.53,20770,2393,110,15821,15821,14184,12942,2912
21762,4566,5290,20510,1252,0,21762,2.20895e+18,97.3813,7217.21,21762,2544,110,16472,16472,15526,15377,14689
1613,762,859,1613,0,1613,0,2.41889e+18,17.2746,957.518,1613,759,20,754,754,674,754,717
36897,3528,8654,0,36897,12974,23923,2.5297e+15,60.0289,11249.3,36897,4215,72,28243,28243,20333,18025,11891
37077,138,176,37050,27,37077,0,6.05191e+18,173.393,2370.04,37077,168,166,35873,33600,28623,29110,29040
7492,59,176,7492,0,7492,0,6.00129e+18,159.64,1044.96,7492,113,116,5186,2833,2256,2613,2505
6026,146,170,6022,4,6026,0,5.97344e+18,156.983,914.119,6026,108,108,5760,5425,5104,5088,5044
45441,11467,12020,42882,2559,42882,2559,5.37715e+18,97.9615,15284.5,45441,5706,111,33421,33421,33421,33421,33267
33983,13708,16937,13539,20444,0,33983,6.46843e+12,55.781,18668.4,33983,8246,72,17046,17046,15659,16811,14249
26872,4828,8300,26872,0,25305,1567,3.27474e+18,172.161,9803.39,26872,3196,125,18572,18572,14666,15801,11272
24642,97,175,24635,7,24642,0,5.98226e+18,166.912,1857.2,24642,163,160,21803,13596,12651,13437,13843
20562,5378,10867,0,20562,0,20562,4.00609e+17,92.8473,12163.5,20562,5268,110,9695,9609,8990,9057,8167
32561,2556,7637,0,32561,0,32561,6.49506e+17,97.7621,10284.4,32561,3701,110,24924,24924,16113,10985,9469
5972,1176,1408,2096,3876,0,5972,9.9541e+12,59.4305,2043.64,5972,685,72,4564,4564,4289,4504,4012
5212,35,1548,0,5212,0,5212,6.1748e+17,94.6144,2181.14,5212,735,86,1753,259,971,913,203
24866,4277,5982,23416,1450,23416,1450,4.08761e+18,98.0772,8079.96,24866,2817,111,18884,18884,15668,16356,14191
34369,949,12273,32686,1683,32686,1683,7.53159e+18,95.8324,14684,34369,5951,110,22096,21894,17049,13638,2785
49515,698,18792,49515,0,47088,2427,4.65129e+18,1364.2,21562.6,49515,5011,141,29722,27742,13738,18625,2865
11070,7,11,10756,314,11063,7,1.39161e+14,10.3902,295.456,11070,11,11,10668,10435,8139,8093,8259
39181,136,176,39079,102,39181,0,6.15934e+18,171.022,2445.54,39181,167,163,38007,35675,30270,30603,30558
25639,8768,11558,24569,1070,24569,1070,9.04038e+18,94.1772,13269.8,25639,5599,110,14081,14081,13761,13761,10573
49749,23695,25245,0,49749,19902,29847,1.62567e+15,54.4227,27563.4,49749,12276,72,24504,24504,24033,23364,23442
45446,14379,16109,43216,2230,43216,2230,3.02176e+18,95.9955,19124,45446,7826,110,29337,29337,26209,27509,25235
8483,1582,3556,0,8483,0,8483,4.98625e+17,93.8002,4347.27,8483,1712,101,4927,4927,3176,2275,1592
14309,1925,3419,0,14309,0,14309,6.45685e+17,97.2006,4830.46,14309,1638,110,10890,10890,9300,7380,6887
47173,32,176,47101,72,47173,0,6.07488e+18,173.496,2685.7,47173,171,172,25464,7528,8503,8887,8377
9474,2,11,9204,270,9472,2,1.39341e+14,10.3107,273.158,9474,11,11,5481,3884,3696,3939,3207
4611,167,204,0,4611,4479,132,3.53959e+16,19.7621,599.845,4611,43,26,4407,4407,4337,4342,3951
46381,542,1586,0,46381,45590,791,2.53858e+16,3.73534,6057.15,46381,795,4,44795,44795,42130,41806,27424
2578,1045,1387,0,2578,558,2020,1.35389e+13,8.84562,1480.77,2578,1241,11,1191,1191,933,1191,923
32390,3593,7606,0,32390,0,32390,6.47517e+17,97.7554,10246.5,32390,3681,110,24784,24784,20101,18467,12747
47244,9,12,46442,802,47116,128,9.90203e+13,3.99812,618.438,47244,8,4,47232,47232,47231,47229,44030
22487,10,14,21826,661,22438,49,1.80236e+14,10.5672,501.904,22487,12,11,22391,22258,21745,20749,18988
27864,12102,15281,27864,0,26854,1010,4.89908e+18,523.809,16669.8,27864,5211,133,12583,12495,11742,12261,10395
26807,11,12,26037,770,26789,18,1.46434e+14,10.3135,470.973,26807,12,11,26795,26795,26644,26645,26541
13078,2694,3093,0,13078,0,13078,6.46888e+17,97.0476,4416.83,13078,1476,110,9985,9985,9478,9311,9136
8542,167,208,8540,2,8112,430,6.00897e+18,191.904,1212.99,8542,117,121,8198,7867,6928,6998,6865
21981,5101,5127,0,21981,7725,14256,2.532e+15,59.975,6845.76,21981,2491,72,16854,16854,16850,16854,16853
817,66,112,0,817,795,22,5.32715e+16,12.3966,243.582,817,31,19,705,705,642,645,338
9025,1549,2172,0,9025,3184,5841,2.52136e+15,59.5074,3030.42,9025,1054,72,6853,6853,5965,5635,5048
2949,54,127,0,2949,2858,91,4.71589e+15,5.38895,568.703,2949,38,7,2822,2822,2737,2731,2536
45929,7239,12694,0,45929,0,45929,6.11547e+17,97.1907,16020.3,45929,6154,110,33235,33235,28240,27209,19849
30334,365,7322,28574,1760,28574,1760,4.87623e+18,98.1413,9766.04,30334,3461,111,23012,23012,9744,14518,2643
6906,2996,3050,6906,0,6564,342,4.53645e+18,80.9464,3563.18,6906,1194,101,3856,3856,3856,3856,3856
16879,660,5360,0,16879,6181,10698,2.25835e+15,58.5358,6633.42,16879,2606,72,11519,11423,6548,241,650
41105,517,1286,0,41105,39820,1285,0.0312614,0.968714,7268.69,41105,1286,1,39819,39819,39819,39819,39819
36925,8211,8860,34775,2150,34775,2150,5.84068e+18,98.2563,11706.2,36925,4192,111,28065,28065,27985,27801,26575
7466,79,320,0,7466,7256,210,3.53146e+16,19.9858,916.604,7466,54,26,7146,7146,5352,5368,2529
6307,1127,1606,5947,360,5947,360,5.99667e+18,95.6471,2369.96,6307,752,93,4701,4701,4591,4591,3623
26024,4247,14221,25124,900,25124,900,2.42665e+18,92.3034,15721.9,26024,6904,110,11803,11803,5743,7714,4465
5831,688,1432,5491,340,5491,340,5.8471e+18,95.6877,2158.21,5831,674,91,4399,4399,4209,4209,2490
48200,17546,21433,46150,2050,46150,2050,3.10671e+18,95.0274,24181.7,48200,10303,111,26767,26767,26767,26581,22875
35760,8116,8334,0,35760,12573,23187,2.53313e+15,60.0304,10868.4,35760,4057,72,27426,27426,27182,27132,26947
40875,14,15,39700,1175,40821,54,1.45727e+14,10.5097,646.291,40875,13,11,40860,40860,40860,40860,40849
29613,6555,6905,27883,1730,27883,1730,5.73883e+18,97.7651,9370.24,29613,3343,110,22708,22708,22498,22473,21970
34503,7,12,33523,980,34485,18,1.38849e+14,10.375,528.023,34503,12,11,33294,32526,25409,25430,23162
41104,2856,14322,39054,2050,39054,2050,4.19624e+18,96.4704,17071.6,41104,6837,111,26782,26782,13109,17120,7423
41494,8784,9704,14589,26905,0,41494,9.88527e+12,60.0411,12562.9,41494,4723,72,31790,31790,30758,31570,29207
42657,9754,14823,0,42657,0,42657,5.52331e+17,95.7525,17713.9,42657,7197,110,27834,27834,24799,21848,19868
23483,3280,5646,22113,1370,22113,1370,2.09987e+18,98.0797,7657.53,23483,2665,111,17837,17837,16576,16559,11069
20196,233,5299,19049,1147,19049,1147,5.55264e+18,97.6317,7052.2,20196,2497,111,14897,14723,4475,4895,1736
25490,2080,5984,0,25490,0,25490,6.46314e+17,97.5893,8177.34,25490,2882,110,19506,19506,12879,11329,7833
41066,10712,18888,41066,0,26584,14482,4.82465e+18,1946.65,21486.7,41066,5603,140,22178,20159,17741,18276,14236
28555,1599,14004,28555,0,28555,0,2.3454e+18,17.9724,14492.9,28555,12588,20,14551,14551,2235,14551,1696
31027,862,966,0,31027,30143,884,3.55771e+16,192.594,3127.44,31027,141,26,30061,30061,29780,29772,28042
28472,146,176,28393,79,28472,0,6.16464e+18,170.73,2082.63,28472,150,156,27877,26719,23762,23752,23383
41146,1103,1154,0,41146,39972,1174,3.55945e+16,242.142,3953.37,41146,179,26,39992,39992,39863,39853,39221
44219,4439,20180,42389,1830,42389,1830,2.71543e+18,94.2941,22755.9,44219,9804,110,24039,24039,10889,15886,6218
14231,1505,4012,13450,781,13450,781,6.56553e+18,96.4728,5357.01,14231,1931,110,10219,10219,10219,10219,4558
17841,3378,4215,0,17841,0,17841,6.48854e+17,97.4469,5884.83,17841,2033,110,13626,13626,12580,12083,11666
1000,8,10,971,29,1000,0,1.36797e+14,9.23,86.4258,1000,10,10,975,960,924,925,853
8491,2419,3531,0,8491,0,8491,4.9819e+17,89.1047,4325.17,8491,1679,102,4960,4960,4570,4382,4230
17954,3100,4265,16912,1042,16912,1042,5.89402e+18,97.3401,5940.52,17954,2052,110,13689,13689,13419,13419,10711
47278,7085,16091,0,47278,0,47278,5.57994e+17,96.2024,19251.9,47278,7813,110,31187,31187,24603,18518,14588
15255,883,4556,0,15255,5534,9721,2.33709e+15,58.8007,5755.02,15255,2218,72,10699,10664,5654,3582,3096
7573,1248,3408,7253,320,7253,320,3.73689e+18,93.4762,4100.98,7573,1618,90,4165,4091,3168,3117,2654
15228,1921,3716,14338,890,14338,890,2.28533e+18,97.75,5162.51,15228,1741,111,11512,11512,9580,11273,6516
46796,24999,26818,45276,1520,45276,1520,2.21701e+18,90.4142,29055,46796,13023,110,19978,19978,19733,19930,19738
14860,62,176,14847,13,14860,0,6.17108e+18,161.959,1497.73,14860,127,124,11758,8465,5286,5349,5506
4974,793,2767,0,4974,2022,2952,1.4862e+15,46.3711,3142.67,4974,1325,65,2207,2148,1254,82,45
9533,424,2298,0,9533,3360,6173,2.50874e+15,59.503,3193.7,9533,1104,72,7235,7235,3282,2589,1517
4119,7,13,3990,129,4083,36,2.21545e+14,10.7082,208.864,4119,12,11,4044,4011,3656,3455,2868
6639,154,619,0,6639,6443,196,4.82229e+16,19.1923,1441.93,6639,81,26,6020,6004,5107,5194,3427
45352,5157,10599,42712,2640,0,45352,2.22859e+18,97.7844,14047.1,45352,5128,110,34753,34753,28656,26061,18364
32570,6321,11696,30970,1600,30970,1600,4.4294e+18,96.3925,13962.2,32570,5589,111,20874,20874,13733,15113,10975
40585,4,10,39142,1443,40459,126,4.47613e+13,5.98879,592.64,40585,8,8,38735,37815,36882,35139,35774
11641,844,3570,0,11641,0,11641,5.90462e+17,95.8598,4698.07,11641,1715,110,8071,8071,5337,2636,2333
46628,4326,17868,44440,2188,44440,2188,2.97838e+18,95.5267,20834.2,46628,8682,110,28760,28760,14516,20046,9110
20668,6823,11110,4473,16195,0,20668,53012200000,8.97668,11391,20668,9991,11,9558,9558,6717,9558,6502
49432,8597,11547,46553,2879,46553,2879,5.76277e+18,97.9213,15237.8,49432,5605,110,37885,37885,36123,35838,29233
41909,147,176,41841,68,41909,0,6.07892e+18,173.59,2533.3,41909,171,171,40945,38939,35245,35065,34966
17492,1,14,16986,506,17446,46,1.56363e+14,9.96696,401.591,17492,12,11,3903,3903,3903,3903,3903
28196,15291,15841,28196,0,27239,957,5.01398e+18,652.993,17373.8,28196,5465,135,12355,12355,12347,12349,12240
20499,7477,7588,20499,0,19379,1120,4.32051e+18,153.201,8659.67,20499,1683,127,12911,12911,12911,12911,12911
4334,315,1951,4144,190,4144,190,8.63324e+18,91.9585,2418.76,4334,930,72,2383,2297,1986,1831,778
35346,14837,15032,0,35346,13614,21732,1.89448e+15,56.7552,17024.4,35346,7300,72,20314,20314,20294,20297,20293
35360,471,1544,0,35360,34321,1039,4.35362e+16,281.866,4937.16,35360,255,26,33816,32795,26309,27469,14686
2753,462,692,0,2753,964,1789,2.52713e+15,57.9317,1046.68,2753,331,60,2061,2061,1729,1408,1511
24080,132,176,24059,21,24080,0,6.11532e+18,171.97,1922.14,24080,149,154,23084,21481,18105,18118,18036
6353,890,1546,0,6353,0,6353,6.48296e+17,95.9861,2323.58,6353,724,94,4807,4807,3947,3269,3200
6664,142,176,6632,32,6664,0,6.05016e+18,158.986,1005.47,6664,107,109,6371,6008,5417,5412,5388
10360,2177,3030,0,10360,0,10360,6.07027e+17,96.0495,4078.57,10360,1456,110,7330,7330,6454,6770,5317
10407,130,739,0,10407,10100,307,4.41818e+16,68.5153,1852.49,10407,95,26,9668,9604,8239,7131,3336
34395,842,8061,0,34395,0,34395,6.4886e+17,97.7965,10824.5,34395,3907,110,26334,26334,9896,4170,4328
33968,17284,18906,0,33968,13889,20079,1.46781e+15,53.7523,20476.7,33968,9204,72,15062,15062,14756,14384,14449
14759,4172,6207,5675,9084,0,14759,7.48056e+12,53.7688,7223.45,14759,3007,72,8552,8552,7491,8372,6430
7230,127,176,7185,45,7230,0,5.98666e+18,162.463,1038.98,7230,113,112,6781,6248,5239,5245,5186
30136,14374,14382,28936,1200,28936,1200,2.57262e+18,92.7281,16247.8,30136,6965,110,15754,15754,15754,15754,15754
5451,1241,1344,0,5451,0,5451,6.46668e+17,95.5439,2033.91,5451,630,89,4107,4107,4005,3999,4024
18286,627,4302,6427,11859,0,18286,9.84603e+12,59.8389,5785.02,18286,2080,72,13984,13984,5507,11660,2262
32068,4342,10638,0,32068,0,32068,5.65788e+17,95.3438,12999.3,32068,5141,110,21430,21430,16152,10547,10230
37030,18433,23997,32827,4203,32827,4203,1.3225e+18,6.51585,27548.9,37030,7994,14,13033,13033,12063,12068,10214
47345,4023,11047,16637,30708,0,47345,9.87743e+12,60.0723,14241.4,47345,5375,72,36298,36298,24229,33260,13655
12484,1327,2999,0,12484,0,12484,6.50851e+17,97.0292,4268.59,12484,1442,110,9485,9485,7307,5304,4898
24258,5782,6445,8653,15605,0,24258,9.46991e+12,59.4552,8239.25,24258,3133,72,17813,17813,17229,17713,16750
24741,5312,6631,23361,1380,23361,1380,6.40222e+18,97.1453,8703.01,24741,3213,110,18110,18110,17799,17800,14628
4222,1083,1466,4222,0,3972,250,4.07163e+18,90.3977,1885.29,4222,517,87,2756,2756,2389,2537,2346
6696,209,1650,0,6696,2355,4341,2.5108e+15,59.2467,2332.2,6696,799,72,5046,5046,3042,1844,741
16620,2517,3897,5846,10774,0,16620,9.91268e+12,59.9029,5274.4,16620,1897,72,12723,12723,10680,12364,8345
8552,1969,3427,0,8552,3246,5306,1.98299e+15,53.8775,4119.55,8552,1647,72,5125,5125,4942,4751,4802
11634,161,176,11619,15,11634,0,6.21501e+18,111.566,1311.4,11634,105,106,11431,11347,11059,11080,11047
36878,74,176,36813,65,36878,0,6.1155e+18,166.428,2378.76,36878,162,166,30271,21299,15414,16239,15927
40282,6669,18520,40282,0,38582,1700,5.21823e+18,1373.12,20761,40282,7934,143,21762,20051,14259,17094,10300
7190,578,686,0,7190,6976,214,4.87667e+16,19.2566,1585.9,7190,86,26,6504,6504,6179,6236,4865
39739,2761,9256,13962,25777,0,39739,9.87327e+12,60.0428,12022.8,39739,4496,72,30483,30483,20976,28843,9370
7879,1666,1944,0,7879,0,7879,6.49827e+17,96.428,2844.85,7879,928,103,5935,5935,5636,5659,5403
8202,198,3080,7802,400,7802,400,2.52943e+18,95.0193,3884.33,8202,1467,97,5122,4888,2437,2925,1081
45588,5197,10578,0,45588,16023,29565,2.53386e+15,60.0916,13676.6,45588,5148,72,35010,35010,27139,18610,17583
33806,3115,7882,11879,21927,0,33806,9.89751e+12,60.0404,10303.9,33806,3839,72,25924,25924,18296,24043,10535
36884,3103,14406,36884,0,34972,1912,4.78726e+18,286.024,16015.3,36884,3498,137,22478,21932,12820,15749,5250
31518,9262,12997,30108,1410,30108,1410,8.34423e+18,94.9393,15106.8,31518,6309,110,18521,18521,17588,17446,14170
2675,569,727,2518,157,2518,157,3.33037e+18,92.9417,1129.73,2675,318,65,1948,1948,1705,1783,1748
44158,63,176,44093,65,44158,0,6.05639e+18,173.598,2584.32,44158,171,171,32540,19752,14317,15980,15638
19485,876,9614,0,19485,0,19485,4.3178e+17,64.4007,10925.8,19485,4660,110,9871,9871,5847,2421,0
21045,3328,8965,20115,930,20115,930,3.05532e+18,93.8408,10467.1,21045,4303,111,12080,12080,7002,7846,5349
32315,5281,10483,32315,0,30435,1880,4.91784e+18,222.111,11972.1,32315,3860,125,21832,21784,16640,19277,11745
8903,495,602,0,8903,8647,256,4.17632e+16,19.1834,1496.33,8903,76,26,8301,8301,8218,8212,7829
10069,4138,4402,0,10069,0,10069,4.84554e+17,93.7412,5274.31,10069,2122,103,5667,5667,5467,5262,5382
2808,929,1196,0,2808,0,2808,5.15332e+17,82.6827,1547.4,2808,561,61,1612,1612,1330,1336,1129
2786,1114,1260,0,2786,1078,1708,1.87277e+15,55.0384,1547.1,2786,610,63,1526,1526,1355,1260,1311
45632,2772,10679,42974,2658,42974,2658,5.77094e+18,97.9112,14141.3,45632,5184,110,34953,34953,30189,27328,10774
39688,202,208,39634,54,39688,0,6.00096e+18,200.923,2541.74,39688,177,177,39450,39397,38321,38583,38573
39451,5403,16713,0,39451,0,39451,4.88123e+17,94.8202,19180.8,39451,8115,110,22738,22738,16832,13617,10459
18774,2785,4511,17689,1085,0,18774,2.21926e+18,97.3055,6236.77,18774,2168,110,14263,14263,12400,11625,9510
13958,786,6660,0,13958,5496,8462,1.74441e+15,54.8334,7558.54,13958,3228,72,7298,7202,3770,1368,1166
22511,882,1265,0,22511,4622,17889,1.47801e+16,11.9906,1750.48,22511,932,14,21246,21246,18261,16174,19906
46327,8402,21242,44407,1920,44407,1920,6.60059e+18,94.9956,23854.9,46327,10231,114,25085,25085,20314,22523,12373
14614,4352,5618,0,14614,5519,9095,2.04546e+15,57.4574,6670.16,14614,2735,72,8996,8996,8879,8744,8889
42307,2,15,41065,1242,42241,66,1.70367e+14,10.35,703.612,42307,13,11,24957,19220,13310,13992,10339
21095,2756,11388,20345,750,20345,750,3.83686e+18,89.7237,12664.3,21095,5490,111,9707,9707,6651,7232,3468
7254,133,368,0,7254,7047,207,3.74195e+16,19.859,1002.03,7254,58,26,6886,6886,5300,5395,2476
47437,10012,14249,47437,0,44667,2770,4.59464e+18,326.454,16553.6,47437,5625,132,33188,33188,29392,31309,24596
45613,3326,10643,16032,29581,0,45613,9.88935e+12,60.0592,13736.9,45613,5183,72,34970,34970,24323,33130,11321
46088,3367,18586,46088,0,43880,2208,4.56986e+18,960.658,20993.1,46088,5823,141,27502,26293,15231,18781,7629
14225,1010,3350,5005,9220,0,14225,9.90999e+12,59.836,4569.16,14225,1632,72,10875,10875,7519,10295,3568
46885,3019,10914,0,46885,0,46885,6.48143e+17,97.9136,14458.5,46885,5284,110,35971,35971,20950,17397,11873
45324,8360,12971,0,45324,16354,28970,2.35042e+15,59.2022,15875.1,45324,6304,72,32353,32353,28008,27131,20756
15386,5146,10192,14986,400,0,15386,9.97151e+17,65.4807,11014.5,15386,4924,105,5194,5194,3967,3650,3064
26549,5655,10846,26549,0,25202,1347,3.90252e+18,213.352,12106.2,26549,4428,124,15703,15635,11200,13059,8293
8719,2136,2180,0,8719,0,8719,6.42575e+17,96.3765,3147.41,8719,1039,107,6539,6539,6508,6524,6525
49981,6849,11687,47074,2907,47074,2907,3.3586e+18,97.9002,15409,49981,5668,110,38294,38294,28643,32936,23901
38101,4717,8878,13390,24711,0,38101,9.89262e+12,60.0503,11547.7,38101,4315,72,29223,29223,24234,28183,15897
4353,3352,4353,4353,0,4353,0,34351800000,0,4353,4353,4353,1,0,0,0,0,0
1344,381,444,1271,73,0,1344,2.14069e+18,83.3579,674.803,1344,178,49,900,900,898,898,900
37888,33,176,37796,92,37888,0,6.11177e+18,172.718,2410.01,37888,166,165,20890,6417,7060,7838,7109
20064,2113,7136,19075,989,19075,989,7.47606e+18,93.1575,8739.28,20064,3438,110,12928,12928,11139,10847,4102
20243,469,5058,7181,13062,0,20243,9.70475e+12,59.7033,6637.35,20243,2464,72,15185,15137,9125,14137,1827
15462,899,3626,14560,902,14560,902,5.7114e+18,97.2865,5128.32,15462,1747,110,11836,11836,10170,9042,3653
43833,10177,10245,15410,28423,0,43833,9.88095e+12,60.047,13237.7,43833,4980,72,33588,33588,33544,33578,33532
33506,9630,10569,0,33506,0,33506,5.79987e+17,96.4814,13053.1,33506,5129,110,22937,22937,22461,22342,21997
12223,1123,5064,4684,7539,0,12223,7.64226e+12,56.9189,5948.72,12223,2466,72,7159,7159,4531,6461,1660
7543,7,11,7326,217,7541,2,1.38219e+14,10.5158,241.033,7543,11,11,7289,7130,6676,6701,5580
15143,4045,6194,0,15143,0,15143,5.03525e+17,92.5642,7413.67,15143,2979,110,8949,8949,8144,8200,7120
44224,28329,44224,44224,0,44224,0,8.79589e+12,0,44224,44224,44224,1,0,0,0,0,0
39874,312,18084,38204,1670,38204,1670,8.21169e+18,93.0833,20429.9,39874,8687,111,21790,20659,8732,12290,0
31787,1277,12842,30347,1440,0,31787,1.73722e+18,76.0256,14988.5,31787,6223,110,18945,18945,5068,5900,0
43087,18655,23740,19366,23721,43087,0,6.5245e+17,17.9879,24300.4,43087,21356,20,19347,19347,15606,19347,15651
34560,625,9925,34560,0,34560,0,2.51609e+18,3423.6,13349.7,34560,7378,25,18661,17628,2885,1376,2190
46941,9356,16445,44628,2313,44628,2313,3.04412e+18,96.0146,19550.4,46941,7983,110,30496,30496,20876,24813,16806
43998,1354,1360,0,43998,42736,1262,3.75683e+16,275.653,4630.17,43998,218,26,42638,42638,42626,42615,42618
21988,4600,5330,20718,1270,0,21988,2.21117e+18,97.4407,7270.88,21988,2574,110,16658,16658,15681,15557,14813
21493,68,176,21415,78,21493,0,6.10099e+18,170.518,1814.85,21493,151,148,16750,11284,7828,8473,8207
4809,43,170,4804,5,4809,0,5.97163e+18,154.429,817.077,4809,100,99,2823,1136,999,1278,1240
46013,828,1471,0,46013,44687,1326,3.83708e+16,286.224,5010.43,46013,243,26,44542,44542,42294,41934,32105
34107,1469,7983,32118,1989,0,34107,2.23035e+18,97.8284,10732.6,34107,3870,110,26124,26124,12233,11314,6116
24068,161,176,24054,14,24068,0,6.04031e+18,171.948,1904.16,24068,155,158,23709,23305,21984,21920,21940
27096,4248,8684,25691,1405,0,27096,1.9825e+18,96.317,10778.9,27096,4212,110,18412,18412,15030,13561,9493
32901,5214,13655,0,32901,12627,20274,1.92953e+15,56.4363,15564,32901,6636,72,19246,19246,13667,7596,6202
29119,9357,9732,29119,0,27446,1673,5.32749e+18,190.062,11107.5,29119,3612,125,19387,19387,19206,19328,18992
4736,250,1139,1671,3065,0,4736,1.00405e+13,59.0006,1670.77,4736,548,71,3597,3597,2285,3367,867
31469,10312,10918,31469,0,25736,5733,4.15329e+18,234.702,12375.8,31469,4164,125,20551,20551,20208,20400,19785
5950,300,1482,0,5950,2094,3856,2.48479e+15,59.059,2107.78,5950,712,72,4468,4468,2001,1408,1043
14866,7,11,14444,422,14859,7,1.38882e+14,10.2868,341.747,14866,11,11,14340,14025,13320,13310,11045
4554,220,1196,0,4554,0,4554,6.35535e+17,94.7762,1796.82,4554,555,83,3358,3328,1366,592,979
19950,688,810,0,19950,19377,573,3.70149e+16,114.847,2356.06,19950,111,26,19140,19025,18774,18768,16668
42802,9311,9985,0,42802,0,42802,6.48418e+17,97.868,13277.6,42802,4841,110,32817,32817,32061,31723,31120
7894,183,1951,0,7894,0,7894,6.48599e+17,96.3982,2853.73,7894,926,103,5943,5867,3603,1543,1023
26985,557,1171,0,26985,26200,785,4.14909e+16,243.446,3620.17,26985,183,26,25814,25240,23907,23409,15543
18499,4174,5380,17489,1010,17489,1010,2.44149e+18,97.161,6974.67,18499,2549,111,13119,13119,10804,11376,9909
28702,7795,8185,27125,1577,27125,1577,6.30728e+18,97.4955,10418.6,28702,3883,111,20517,20517,20471,20360,19731
30254,8448,16381,6541,23713,0,30254,53059800000,8.9719,16720.9,30254,14735,11,13873,13873,8549,13873,8108
18575,93,176,18508,67,18575,0,6.00025e+18,168.417,1648.6,18575,154,151,16080,10305,9200,9667,9788
23039,3722,5378,0,23039,8090,14949,2.53521e+15,59.9466,7157.23,23039,2615,72,17661,17661,15209,12341,12361
20958,872,8137,19971,987,19971,987,3.79616e+18,95.7233,9705.14,20958,3888,111,12821,12647,7453,7839,2771
13422,11061,12546,12542,880,12542,880,2.03378e+17,3.98122,12601.3,13422,4192,9,876,876,876,876,779
35375,9271,13894,23769,11606,33726,1649,4.72838e+18,94.8943,16210.1,35375,6652,116,21481,21481,19251,21481,15442
6733,1830,4060,6733,0,6503,230,4.03377e+18,121.637,4508.32,6733,1828,86,2673,2630,1647,2031,1424
5303,85,3066,5124,179,0,5303,1.27861e+18,81.1243,3512.62,5303,1469,70,1917,627,684,507,0
38348,5019,10946,0,38348,0,38348,6.04e+17,95.0697,13803.5,38348,5300,110,27402,27402,20650,13348,12524
8474,95,199,8468,6,8474,0,5.98767e+18,174.387,1136.06,8474,119,125,7287,4466,3864,4159,4076
43987,10938,15214,0,43987,0,43987,5.54184e+17,95.9527,18181.3,43987,7387,110,28773,28773,25212,22313,21357
16745,91,176,16738,7,16745,0,6.03802e+18,166.681,1580.54,16745,145,144,14567,9631,8218,8621,8662
43938,174,176,43874,64,43938,0,6.0454e+18,173.319,2574.38,43938,173,170,43747,43720,43299,43318,43305
18247,992,7065,18247,0,17274,973,4.08166e+18,132.601,8047.88,18247,2769,121,11182,11085,5729,8127,2479
41252,1,14,40077,1175,41172,80,1.39025e+14,10.6344,634.522,41252,13,12,10555,10555,10555,10555,10555
3304,828,878,0,3304,1166,2138,2.50022e+15,58.1407,1276.35,3304,420,64,2426,2426,2394,2372,2389
37194,7872,12771,0,37194,13788,23406,2.16663e+15,58.2865,15080.5,37194,6211,72,24423,24423,20402,18269,15638
44703,585,2680,42077,2626,13606,31097,1.67611e+18,16.995,3495.19,44703,1581,27,42023,42023,34932,36901,19262
28637,2,14,27807,830,28559,78,1.5467e+14,10.4239,523.408,28637,13,12,16730,12376,10537,12459,8928
9234,111,2232,0,9234,3253,5981,2.51145e+15,59.4192,3104.26,9234,1075,72,7002,6954,1951,1270,447
34220,2483,13609,0,34220,0,34220,5.10688e+17,95.2284,15898.4,34220,6610,110,20611,20611,13186,6866,4867
10459,86,176,10413,46,10459,0,6.16618e+18,160.541,1260.97,10459,115,116,9079,6967,5098,5156,5237
46273,8452,18865,0,46273,17695,28578,1.95451e+15,56.8565,21403.7,46273,9168,72,27408,27408,21742,16925,12780
40391,6031,9396,14189,26202,0,40391,9.88197e+12,60.066,12201.7,40391,4570,72,30995,30995,26125,30155,20285
2146,70,573,2016,130,0,2146,2.27483e+18,92.2717,919.11,2146,260,60,1182,397,502,488,384
23719,3950,9718,23719,0,22549,1170,4.25326e+18,213.365,11030.5,23719,4175,125,14001,13943,9798,11609,6361
34730,4711,8100,0,34730,12212,22518,2.529e+15,60.0344,10578,34730,3935,72,26630,26630,22596,17335,15877
22426,1,13,21787,639,22353,73,1.3883e+14,10.8319,459.842,22426,13,12,5735,5735,5735,5735,5735
49237,1,10,48483,754,49141,96,9.62298e+13,3.99817,596.583,49237,7,4,20394,20394,20394,20394,20394
34335,3711,8054,32335,2000,0,34335,2.22802e+18,97.7725,10816,34335,3897,110,26281,26281,20395,19386,13227
38831,165,176,38749,82,38831,0,6.02272e+18,172.038,2404.03,38831,168,170,38492,38114,36369,36156,36194
34589,6917,11416,32822,1767,32822,1767,3.00529e+18,96.2854,13917.2,34589,5536,110,23173,23173,19667,22214,13772
18970,5157,7390,18970,0,17990,980,4.64293e+18,144.731,8504.37,18970,3056,124,11580,11580,10243,10892,8742
32563,10692,13773,31133,1430,0,32563,1.68206e+18,93.0502,15907.1,32563,6668,110,18790,18790,17950,17443,16905
13643,2057,5513,5202,8441,0,13643,7.71865e+12,57.1189,6490.71,13643,2680,72,8130,8130,5856,7740,3312
24366,8127,9795,0,24366,9293,15073,1.98076e+15,57.2997,11325,24366,4765,72,14571,14571,13429,12545,12234
28711,1140,8956,27191,1520,27191,1520,4.47378e+18,97.1025,11125.8,28711,4269,111,19755,19755,6569,19755,4855
41836,2,13,38426,3410,41578,258,1.14458e+14,8.15618,553.248,41836,12,9,27458,27458,12147,20966,13848
15132,2258,3691,14252,880,14252,880,2.12591e+18,97.7254,5136.07,15132,1736,111,11441,11441,10041,11341,7794
20112,11,12,19526,586,20098,14,1.6369e+14,10.3464,421.184,20112,12,11,20100,20100,19835,19836,19652
11894,4438,4486,11894,0,8374,3520,5.44114e+18,109.406,5243.74,11894,923,124,7408,7408,7408,7408,7408
916,238,311,0,916,0,916,6.07913e+17,81.7107,483.389,916,127,42,605,605,532,554,561
10038,43,176,10037,1,10038,0,6.02056e+18,161.614,1215.9,10038,127,124,6011,2358,2105,2631,2418
38627,604,1102,0,38627,37524,1103,3.5541e+16,229.202,3735.61,38627,169,26,37525,37036,31743,32611,25202
12808,4040,5722,4978,7830,0,12808,7.205e+12,56.3723,6597.95,12808,2784,72,7086,7086,6657,6993,6119
1763,419,984,0,1763,709,1054,1.48061e+15,42.097,1161.01,1763,465,45,779,757,358,108,92
27660,11,12,26861,799,27640,20,1.5244e+14,10.3851,486.075,27660,12,11,27648,27648,27126,27127,26331
32688,2660,7676,30788,1900,30788,1900,5.88138e+18,97.7575,10337.4,32688,3709,110,25012,25012,23752,23501,9802
33648,5379,9146,12055,21593,0,33648,9.38886e+12,59.4187,11461.6,33648,4449,72,24502,24502,19658,23662,13854
44216,5824,15176,42006,2210,42006,2210,3.09085e+18,94.2483,18164,44216,7366,110,29040,29040,19244,23122,15385
27043,7,15,26232,811,26982,61,1.93503e+14,10.4551,570.833,27043,13,11,26433,26020,24477,19932,17631
35578,17769,19803,34364,1214,34364,1214,3.04257e+18,93.4106,21631.9,35578,9564,111,15775,15775,15202,15758,15428
44299,1801,10376,0,44299,0,44299,6.48276e+17,97.8644,13753.8,44299,5035,110,33923,33923,22238,10347,7621
8721,10,12,8464,257,8713,8,1.65541e+14,10.3078,275.53,8721,12,11,8672,8605,7873,7891,7950
37449,1,12,36382,1067,37433,16,1.39118e+14,10.2672,548.617,37449,12,11,9570,9570,9570,9570,9570
34357,6765,11356,32607,1750,32607,1750,7.1593e+18,96.2726,13848.2,34357,5510,110,23001,23001,20868,20529,12463
2523,816,1131,2412,111,2412,111,5.35626e+18,70.3611,1448.89,2523,514,59,1392,1392,1392,1392,1392
12090,889,4044,12090,0,11382,708,6.24874e+18,94.5376,4830.7,12090,1436,120,8046,8044,5331,6794,2176
15086,611,3605,0,15086,0,15086,6.46847e+17,97.218,5071.54,15086,1732,110,11481,11481,7451,3719,2674
3854,857,968,3624,230,3624,230,3.2195e+18,94.6585,1502.32,3854,448,80,2886,2886,2793,2855,2781
18730,1081,9445,0,18730,0,18730,3.43715e+15,17.9594,9832.12,18730,8485,20,9285,9285,1439,6432,1152
9530,149,176,9487,43,9530,0,6.1515e+18,157.292,1197.42,9530,113,112,9250,8983,8084,8107,8147
32682,6336,10576,32682,0,30782,1900,4.53255e+18,221.238,12075.1,32682,2287,133,22106,22059,19156,21078,13885
39346,306,1125,0,39346,37948,1398,1.14608e+16,7.9419,6126.36,39346,288,10,38221,38221,35635,36572,28189
25713,3795,6165,24213,1500,24213,1500,3.57037e+18,98.1478,8321.94,25713,2909,111,19548,19548,15036,16005,12765
24691,3182,7282,0,24691,0,24691,5.98079e+17,96.1775,9291.43,24691,3511,110,17409,17409,13137,10935,8124
11966,3937,11966,11966,0,0,11966,134207000,0,11966,11966,11966,1,0,0,0,0,0
7712,2996,5738,3407,4305,0,7712,3.37727e+12,19.7823,6083.24,7712,2787,58,1974,1974,1277,270,0
33167,126,176,33085,82,33167,0,6.06373e+18,172.868,2245.33,33167,164,165,31612,29106,23767,23730,23501
6489,2,13,6301,188,6422,67,1.69432e+14,10.8776,247.831,6489,12,12,3877,2985,2160,3014,1808
23152,2833,5879,0,23152,8224,14928,2.46031e+15,59.621,7630.51,23152,2854,72,17273,17273,13300,8345,8553
1960,114,115,403,1557,0,1960,5.7762e+13,11.8878,250.011,1960,90,14,1845,1845,1845,1845,1845
36855,3117,8574,0,36855,12956,23899,2.53649e+15,60.0658,11173.7,36855,4176,72,28281,28281,20400,13263,10845
38029,19188,19899,36639,1390,36639,1390,4.63626e+18,93.9557,21935.6,38029,9611,111,18130,18130,17447,17590,17608
37946,813,13643,0,37946,14195,23751,2.11603e+15,58.0604,15942.7,37946,6644,72,24303,24126,12101,2419,1209
19225,6898,7912,18362,863,18362,863,2.87674e+18,94.7005,9364.32,19225,3835,110,11313,11313,10110,10572,9913
3814,277,1947,3814,0,3644,170,3.72149e+18,89.5409,2277.77,3814,797,73,1867,1774,955,1395,764
19403,13,175,19391,12,19403,0,5.97641e+18,166.046,1648.89,19403,154,153,5789,883,1246,1303,1332
15248,977,3625,0,15248,0,15248,6.49685e+17,97.2942,5104.48,15248,1747,110,11623,11623,6521,5625,3929
18005,1265,6025,18005,0,16992,1013,6.00051e+18,142.732,7152.17,18005,2139,128,11980,11896,8150,10003,3057
36753,15811,18446,23481,13272,35353,1400,7.06774e+18,94.2272,20497.6,36753,8896,111,18307,18307,18307,18256,16141
19832,3411,5679,18752,1080,0,19832,2.08272e+18,95.2871,7397.8,19832,2742,110,14153,14153,12180,11794,10180
49626,5106,16810,0,49626,0,49626,5.58517e+17,95.8943,20104.1,49626,8149,110,32816,32816,22748,17177,11714
43510,3974,10092,0,43510,15292,28218,2.53827e+15,60.0943,13071.8,43510,4916,72,33418,33418,24440,16829,13518
32499,9,12,31574,925,32479,20,1.38906e+14,10.2974,510.276,32499,12,11,32077,31625,25324,25509,25726
45211,746,1586,0,45211,44420,791,2.55822e+16,3.73524,6056.46,45211,795,4,43625,43625,43048,42600,29802
36602,7445,8567,34465,2137,34465,2137,5.71591e+18,97.8338,11470.7,36602,4150,110,28035,28035,27352,27244,24934
40102,5133,13443,14827,25275,0,40102,8.58362e+12,58.4466,15919.8,40102,6549,72,26659,26659,19294,25391,10460
1636,341,474,1541,95,1541,95,3.26803e+18,89.2891,753.017,1636,207,55,1162,1162,1053,1130,1018
3409,23,72,3403,6,3409,0,6.41733e+18,69.5169,486.965,3409,69,70,1757,523,839,1005,1150
38671,9774,19366,37191,1480,37191,1480,4.3782e+18,92.9635,21504.6,38671,9343,111,19305,19305,15166,19092,11098
16409,2359,3849,0,16409,5776,10633,2.53496e+15,59.8998,5211.19,16409,1875,72,12560,12560,10735,8311,7822
19013,5133,7029,0,19013,0,19013,5.36655e+17,94.4662,8544.68,19013,3400,110,11984,11984,10738,9697,9675
32391,7469,7615,30511,1880,0,32391,2.22627e+18,97.7301,10255.3,32391,3676,110,24776,24776,24649,24627,24616
42798,633,1177,0,42798,41580,1218,3.55086e+16,244.318,4063.42,42798,184,26,41621,41040,35039,35986,27711
46724,42,1258,0,46724,45390,1334,3.558e+16,259.076,4397.75,46724,200,26,44824,44788,34644,33390,8138
6556,1382,1638,6176,380,6176,380,4.23359e+18,96.3249,2419.95,6556,751,96,4918,4918,4483,4604,4481
32198,7093,7525,11322,20876,0,32198,9.8733e+12,59.9947,9854.22,32198,3652,72,24673,24673,24177,24569,23493
44005,9356,14440,41755,2250,0,44005,1.95516e+18,94.6459,17470.7,44005,6998,110,29565,29565,26558,25253,21679
31962,694,1400,0,31962,31027,935,4.2923e+16,268.681,4419.15,31962,229,26,30562,30396,26971,27522,20144
37968,13165,14659,37968,0,35986,1982,4.19626e+18,297.973,16304.5,37968,5950,132,23309,23309,22693,22996,22046
44755,6197,13479,42363,2392,42363,2392,4.48385e+18,97.3772,16580.1,44755,6419,111,31276,31276,20457,22705,15311
28710,7118,7130,27070,1640,0,28710,2.18827e+18,97.4657,9501.59,28710,3448,110,21580,21580,21579,21580,21580
46641,620,1255,0,46641,45311,1330,3.558e+16,258.092,4388.68,46641,200,26,45386,44714,41496,41813,28704
37274,2115,10457,35214,2060,35214,2060,3.04743e+18,97.6793,13203.4,37274,4970,111,26817,26817,15742,18697,6228
41635,7106,17921,41635,0,39665,1970,4.82285e+18,504.423,19782.3,41635,4795,140,23714,23130,15663,19290,9193
37179,99,176,37086,93,37179,0,6.14389e+18,172.966,2383.99,37179,162,163,33662,25685,20315,20748,20772
9297,164,176,9291,6,9297,0,6.03569e+18,165.336,1183.3,9297,118,122,9071,8957,8598,8536,8590
16881,729,3976,5930,10951,0,16881,9.89367e+12,59.8345,5366.88,16881,1932,72,12905,12905,8207,12095,2582
44368,161,176,44286,82,44368,0,5.98103e+18,169.685,2492.99,44368,171,170,43890,43070,40772,40998,41004
11596,1105,3865,4276,7320,0,11596,8.6417e+12,58.2303,4806.75,11596,1881,72,7731,7731,4772,6859,2912
35725,196,1050,0,35725,34707,1018,3.55478e+16,217.982,3504.68,35725,159,26,34481,34247,29015,29016,11608
10135,354,494,0,10135,2098,8037,1.49018e+16,11.9791,817.229,10135,427,14,9641,9641,8487,7426,9120
24545,527,874,0,24545,23843,702,3.6224e+16,150.87,2675.29,24545,123,26,23671,23458,21025,21286,17860
40393,8752,16992,0,40393,0,40393,4.90518e+17,94.8812,19515,40393,8253,110,23401,23401,17762,15079,11540
1756,3,6,1729,27,1724,32,9.68171e+13,3.96754,95.5708,1756,5,4,1622,1494,1494,1493,1409
2684,695,702,0,2684,0,2684,6.63454e+17,93.1837,1111.3,2684,317,66,1982,1982,1976,1975,1982
28457,97,206,28384,73,28457,0,5.98345e+18,186.278,2079.91,28457,174,168,24887,15284,13000,13977,13690
21745,4,176,21666,79,21745,0,6.09627e+18,168.875,1825.99,21745,150,151,2566,488,283,218,352
24069,1021,1639,0,24069,4879,19190,1.45964e+16,11.9919,2138.15,24069,985,14,22430,22430,18771,16886,20772
48235,1827,19979,48235,0,46037,2198,4.66418e+18,1889.56,22737.5,48235,5896,141,27601,25202,13090,17682,5234
20484,3198,5418,7308,13176,0,20484,9.53508e+12,59.4351,6985.02,20484,2639,72,15066,15066,12808,14676,10261
21284,600,816,0,21284,20676,608,3.64182e+16,127.279,2414.21,21284,111,26,20468,20322,19788,19834,16584
1470,857,878,1420,50,1420,50,1.03029e+19,50.0973,1048.9,1470,395,56,592,592,592,592,592
39968,252,1129,0,39968,38827,1141,3.55402e+16,235.83,3845.12,39968,174,26,38701,38317,28071,27732,14961
32699,175,176,32623,76,32699,0,5.98568e+18,169.681,2142.39,32699,164,168,32523,32523,32514,32515,32500
1878,273,544,1768,110,1768,110,5.77301e+18,90.8248,849.678,1878,233,56,1334,1334,983,1116,856
48669,11762,18213,0,48669,0,48669,5.29091e+17,95.671,21317.3,48669,8846,110,30456,30456,26195,20080,19110
24524,2673,7858,23244,1280,23244,1280,2.134e+18,96.7892,9769.94,24524,3749,111,16666,16666,13186,11882,7367
34696,1997,11210,34696,0,32677,2019,4.60239e+18,242.248,12776.1,34696,4141,125,23486,23148,12643,17224,4988
24148,7,15,23433,715,24094,54,1.79984e+14,10.1996,487.345,24148,12,11,23515,23080,21060,16964,10277
23225,2143,7250,23225,0,21875,1350,4.89019e+18,163.225,8609.73,23225,2793,122,15975,15840,10701,12542,5143
48117,8573,11876,45346,2771,45346,2771,1.62381e+18,98.2257,15359.4,48117,5614,111,36241,36241,33075,36015,27457
22622,14,175,22614,8,22622,0,5.98235e+18,166.675,1779.99,22622,154,161,7115,1085,1531,1705,1542
45724,2827,24341,0,45724,18481,27243,1.54373e+15,55.1582,26416.2,45724,11838,72,21383,21383,11324,6111,2121
2568,10,135,531,2037,0,2568,5.82689e+13,11.9151,291.703,2568,114,14,2118,1785,1457,570,1453
48801,329,19279,48801,0,46309,2492,4.53874e+18,407.884,21235.1,48801,4356,141,29272,27936,13736,18769,1364
44602,7181,13416,43465,1137,42002,2600,4.09611e+18,312.081,15614.6,44602,4170,136,31186,31002,23984,26253,17982
21365,603,863,0,21365,20753,612,3.75617e+16,158.115,2549.97,21365,120,26,20502,20300,19722,19700,16236
32550,3047,12092,0,32550,12226,20324,2.07499e+15,57.8246,14093.5,32550,5886,72,20458,20458,12302,11891,5364
17741,2,3,17187,554,17677,64,0.000112733,0.999831,220.093,17741,3,1,17738,17738,17738,17738,17738
45504,873,10644,42854,2650,42854,2650,5.75499e+18,97.9046,14098,45504,5161,110,34860,34860,26810,20812,4990
20451,1060,1222,0,20451,19837,614,4.8123e+16,240.912,3573.02,20451,190,26,19229,19229,19007,19070,18035
40324,7300,9467,37974,2350,0,40324,2.22734e+18,97.8474,12598.3,40324,4593,110,30857,30857,28461,27486,24679
9468,1986,2266,0,9468,0,9468,6.46638e+17,96.5882,3307.29,9468,1075,110,7202,7202,6857,6968,6688
47460,7,15,46097,1363,47402,58,1.47866e+14,10.5213,706.415,47460,13,11,45898,44825,40769,39276,30522
49947,9981,11674,47040,2907,47040,2907,5.89937e+18,97.9056,15395.5,49947,5665,110,38273,38273,37843,37844,33364
8543,1770,2109,0,8543,0,8543,6.42813e+17,96.4102,3066.97,8543,1001,106,6434,6434,6011,5839,5763
17686,26,208,17632,54,17686,0,6.17549e+18,192.207,1769.8,17686,131,129,8725,2863,2721,2369,2186
22589,5182,11549,0,22589,9047,13542,1.61692e+15,53.5198,12785.6,22589,5603,72,11040,11040,8657,8088,5168
23918,4054,6657,0,23918,8597,15321,2.39051e+15,59.2521,8401.74,23918,3243,72,17261,17261,14988,11980,11310
701,39,468,674,27,674,27,2.30011e+18,39.8645,548.852,701,189,46,130,24,0,70,0
11991,694,843,0,11991,11636,355,4.647e+16,136.839,2207.55,11991,117,26,11148,11116,10851,10899,9787
49496,78,176,49393,103,49496,0,6.12216e+18,171.126,2755.47,49496,170,171,41322,29741,21735,22536,21949
40653,858,18824,38982,1671,38982,1671,6.59067e+18,94.8596,21171.2,40653,9053,111,21829,20911,13865,6694,2670
2991,139,176,2989,2,2100,891,6.0724e+18,142.309,677.156,2991,77,77,2772,2620,2337,2356,2341
20344,3949,9568,8000,12344,0,20344,6.84603e+12,54.824,10781.8,20344,4638,72,10776,10776,7785,10266,4384
35520,137,176,35448,72,35520,0,5.9851e+18,169.743,2232.39,35520,165,170,34275,32042,27458,28233,27721
24091,7254,9869,23001,1090,23001,1090,2.73036e+18,93.0282,11566.2,24091,4726,111,14222,14222,12762,13194,13020
14189,33,176,14117,72,14189,0,6.03023e+18,167.566,1452.5,14189,137,142,7524,2200,2455,2929,2659
13519,64,176,13501,18,13519,0,6.13963e+18,169.023,1435,13519,125,125,10609,7575,4862,4905,4939
7471,1456,1821,0,7471,2635,4836,2.54116e+15,59.3424,2559.15,7471,887,72,5650,5650,5311,5205,4925
24266,1398,10954,0,24266,0,24266,4.67871e+17,94.1824,12589.8,24266,5318,110,13312,13226,6506,3271,2970
8238,2,9,7557,681,8238,0,1.16069e+14,7.70029,223.612,8238,9,8,5520,5520,2468,4415,4162
22279,5586,9773,8640,13639,0,22279,7.24264e+12,55.1963,11133.8,22279,4747,72,12506,12506,10222,12116,7660
26930,7930,13837,25930,1000,0,26930,1.4217e+18,91.9274,15456.5,26930,6706,110,13093,13093,11277,10294,8490
47649,1483,22717,45739,1910,45739,1910,8.39631e+18,92.445,25318.3,47649,10931,111,24932,24932,10636,13721,2090
35409,3456,8254,12443,22966,0,35409,9.88135e+12,60.0443,10771.9,35409,4014,72,27155,27155,19863,25426,11662
14077,26,599,0,14077,13674,403,3.55809e+16,20.0879,1656.14,14077,78,26,13478,12966,8321,8266,2429
33298,2040,9990,31515,1783,31515,1783,5.49967e+18,97.2965,12456.6,33298,4753,111,23308,23308,11384,14996,5862
3270,44,153,0,3270,3177,93,3.53677e+16,19.6609,449.35,3270,38,26,3117,3117,2305,2330,1281
13234,1748,3181,12465,769,12465,769,5.89292e+18,97.0561,4508.02,13234,1526,110,10053,10053,9684,9686,5967
13432,1505,4595,0,13432,0,13432,5.63493e+17,95.5453,5801.36,13432,2219,110,8837,8837,5439,4186,4261
41037,19129,41037,41037,0,41037,0,34358900000,0,41037,41037,41037,1,0,0,0,0,0
3656,298,960,3444,212,3444,212,2.47541e+18,94.523,1468.31,3656,423,78,2696,2696,1385,1746,1133
2160,117,545,0,2160,754,1406,2.61615e+15,57.5273,840.193,2160,265,56,1615,1615,686,328,420
23204,6791,10721,22244,960,22244,960,6.61876e+18,94.6535,12259.8,23204,5147,111,12483,12483,12483,12483,8483
34322,8729,15329,0,34322,0,34322,4.69176e+17,93.7063,17477.1,34322,7431,110,18993,18993,15500,12878,11903
4928,1,13,4782,146,4895,33,1.58615e+14,10.7165,216.303,4928,12,11,1082,1082,1082,1082,1082
47637,694,1428,0,47637,46271,1366,3.73955e+16,287.129,4919.66,47637,234,26,46209,45948,42783,42177,28694
6503,1,10,6314,189,6498,5,1.79022e+14,9.8902,234.106,6503,10,10,1176,1176,1176,1176,1176
6357,1003,3373,6117,240,6117,240,2.26273e+18,92.2276,3916.32,6357,1609,81,2984,2810,2479,2239,2190
35590,6037,16473,35590,0,23652,11938,4.7169e+18,448.912,18092.3,35590,7290,135,19117,18655,13121,15717,8611
33247,10871,17299,0,33247,0,33247,4.07342e+17,93.0916,19179.1,33247,8403,110,15948,15948,14094,13028,11280
47411,7536,18411,47411,0,44968,2443,4.4336e+18,420.052,20371.7,47411,7230,138,29000,28567,20528,23717,11867
28428,5909,6861,26775,1653,26775,1653,3.03519e+18,98.1814,9185.43,28428,3248,111,21567,21567,20596,21495,19164
25835,7,14,25087,748,25764,71,1.54362e+14,10.7015,518.545,25835,13,11,25023,24553,22727,21721,15193
1108,166,168,1108,0,1108,0,6.01122e+18,109.886,393.08,1108,56,49,940,940,940,938,940
11543,2595,3147,10903,640,10903,640,6.38054e+18,96.1882,4311.95,11543,1502,110,8396,8396,8286,8286,7369
10649,116,176,10638,11,10649,0,6.08897e+18,165.651,1274.7,10649,125,124,9886,8957,6871,7085,7088
6720,443,1665,0,6720,2369,4351,2.50199e+15,59.097,2347.43,6720,805,72,5055,5055,3382,1337,1490
30629,9815,11234,30629,0,29002,1627,3.80823e+18,217.101,12819.1,30629,4530,133,19395,19374,19228,19309,18684
18273,3822,8022,17482,791,17482,791,1.94624e+18,94.8676,9349.04,18273,3848,111,10251,10251,10251,10251,4941
10335,55,176,10327,8,10335,0,6.02682e+18,165.872,1246.46,10335,123,129,7076,4025,2904,3279,3148
49704,8280,11571,0,49704,17475,32229,2.53397e+15,60.0849,14892.7,49704,5637,72,38133,38133,34186,30635,27650
36301,1835,9294,12907,23394,0,36301,9.59162e+12,59.6945,11801.2,36301,4522,72,27007,27007,17660,25397,6273
9513,4244,6169,8433,1080,0,9513,2.45119e+18,5.49354,7102.92,9513,2063,13,3344,3344,3072,3132,2440
5879,704,3171,5669,210,5669,210,2.41318e+18,89.0264,3685.72,5879,1516,78,2708,2536,1935,1996,1297
45700,1607,10661,16069,29631,0,45700,9.88609e+12,60.0691,13761.7,45700,5187,72,35039,35039,14387,29422,5598
3284,327,848,3091,193,3091,193,5.6586e+18,93.8541,1320.47,3284,385,72,2436,2436,2114,2077,1198
21644,9725,11325,0,21644,0,21644,4.0628e+17,92.9543,12679.1,21644,5493,110,10319,10319,9519,8726,9132
19446,928,4551,6839,12607,0,19446,9.91329e+12,59.9173,6105.63,19446,2217,72,14895,14895,7124,12782,3334
14845,3236,6355,0,14845,5716,9129,1.90378e+15,55.0367,7362.41,14845,3079,72,8490,8490,6573,5221,3504
20110,6276,6306,0,20110,7349,12761,2.27027e+15,58.6075,7770.03,20110,3063,72,13804,13804,13801,13801,13797
21279,2031,10277,20429,850,20429,850,2.91808e+18,92.8433,11676.9,21279,4940,111,11002,11002,7768,7275,4044
32287,1156,9390,0,32287,0,32287,5.99881e+17,95.635,11874.7,32287,4533,110,22897,22897,11209,5834,4895
11645,3500,4160,11067,578,0,11645,1.89121e+18,95.2005,5226.96,11645,2008,110,7485,7485,6846,6603,6137
9087,2342,2434,8574,513,8574,513,1.33673e+18,95.9509,3404.1,9087,1119,110,6653,6653,6653,6653,6653
31284,353,13606,12115,19169,0,31284,7.29334e+12,56.4496,15389.5,31284,6616,72,17678,17630,5772,14123,686
11466,1601,3647,11466,0,10796,670,6.17692e+18,94.2773,4491.56,11466,1173,122,7819,7819,6592,7447,3859
14252,30,175,14244,8,14252,0,5.97736e+18,164.607,1414.45,14252,139,146,7093,1732,2102,2611,2374
48540,4158,11313,0,48540,17069,31471,2.52908e+15,60.0708,14574.6,48540,5502,72,37227,37227,25018,17130,14154
21396,54,176,21317,79,21396,0,6.09495e+18,171.262,1811.94,21396,150,147,15029,9296,6168,6571,6480
15717,149,175,15709,8,15717,0,5.98346e+18,165.441,1485.8,15717,148,147,15297,14609,13512,13497,13411
20829,103,176,20815,14,20829,0,5.98734e+18,167.824,1721.37,20829,158,155,18762,12203,11252,11864,12485
46639,1312,15015,44237,2402,0,46639,1.97292e+18,96.4883,18212.3,46639,7292,110,31624,31624,19884,17454,5870
40837,9048,11316,38577,2260,38577,2260,4.63517e+18,97.7573,14282.3,40837,5387,111,29521,29521,26222,26857,24879
6180,159,369,0,6180,1267,4913,1.47573e+16,11.9691,617.377,6180,262,14,5811,5811,4386,3520,5166
35867,9815,10040,12903,22964,0,35867,9.28157e+12,59.3091,12457.8,35867,4884,72,25827,25827,25561,25767,25281
42487,319,2385,0,42487,41203,1284,5.157e+16,326.818,7570.31,42487,425,26,39748,38072,30477,22751,9231
43848,3596,10175,15405,28443,0,43848,9.91611e+12,60.0865,13172.5,43848,4956,72,33673,33673,24016,32003,12232
31559,3448,13689,30199,1360,0,31559,1.6509e+18,93.1516,15742.5,31559,6628,110,17870,17870,12107,10761,6812
10432,4,11,10134,298,10430,2,1.50937e+14,10.1834,292.403,10432,11,11,9030,7973,6541,6797,5202
10052,713,2444,0,10052,0,10052,6.49624e+17,96.8298,3523.54,10052,1172,110,7608,7608,4538,4008,2823
25273,6458,7335,9139,16134,0,25273,9.14013e+12,59.0529,9139.48,25273,3558,72,17938,17938,16991,17738,15552
16408,6497,6540,0,16408,6244,10164,2.00286e+15,57.279,7667.18,16408,3186,72,9868,9868,9819,9830,9825
7053,61,176,7050,3,7053,0,6.13159e+18,158.808,1039.06,7053,105,103,5340,3662,2400,2422,2652
22436,4762,8481,21366,1070,21366,1070,3.03005e+18,93.9641,10154.5,22436,4052,111,13955,13955,9968,10745,8276
20133,2002,5440,19013,1120,19013,1120,6.38691e+18,96.9511,7206.73,20133,2626,110,14693,14693,14043,14043,7066
30969,5210,14002,30969,0,29533,1436,4.43751e+18,298.945,15406.6,30969,5324,134,16967,16762,12119,13846,7898
20930,4,12,20331,599,20923,7,1.41558e+14,10.2732,410.363,20930,12,11,18149,16196,13513,12654,10260
11858,1293,4837,0,11858,4536,7322,1.96781e+15,55.2524,5710.16,11858,2351,72,7021,7021,5051,2592,2897
39188,13844,14027,0,39188,0,39188,5.44407e+17,95.8717,16693.2,39188,6815,110,25161,25161,25047,24959,25136
45124,3619,10577,42503,2621,0,45124,2.2261e+18,97.8506,14007.7,45124,5119,110,34547,34547,22691,20540,13413
1483,882,1388,1385,98,1385,98,1.11814e+18,3.90762,1403.9,1483,488,9,95,95,59,59,66
29915,3884,7043,28175,1740,28175,1740,5.77042e+18,97.7105,9521.56,29915,3402,110,22872,22872,20984,20674,13530
22849,153,10600,21909,940,21909,940,2.64842e+18,93.3113,12136,22849,5138,110,12249,11415,4010,7229,1181
13408,881,4305,0,13408,0,13408,5.81105e+17,93.0513,5539.52,13408,2072,110,9103,9103,5917,3663,2387
15250,3414,3592,5357,9893,0,15250,9.91211e+12,59.8153,4875.79,15250,1748,72,11658,11658,11453,11611,11259
13237,5,11,12859,378,13231,6,1.39217e+14,10.6928,321.856,13237,11,11,12224,11012,10356,10263,8145
7555,38,463,0,7555,7335,220,4.00585e+16,19.6904,1187.82,7555,66,26,7092,7072,4831,4641,1518
6434,852,1584,0,6434,0,6434,6.4021e+17,95.7561,2364.66,6434,737,94,4850,4850,3892,2674,3016
10151,3615,5013,0,10151,2224,7927,1.33837e+13,8.97035,5218.15,10151,4505,11,5138,5138,4042,5138,3929
18457,992,6237,17517,940,17517,940,2.81983e+18,96.422,7750.9,18457,2968,111,12220,12220,6342,7000,3677
25812,5210,6019,0,25812,9066,16746,2.52686e+15,59.9617,7970.11,25812,2918,72,19793,19793,18831,17657,17367
15756,39,175,15685,71,15756,0,5.98314e+18,165.145,1486.54,15756,147,146,8925,2825,2960,3743,3488
28771,312,6735,10123,18648,0,28771,9.88813e+12,60.0056,8858.98,28771,3281,72,22036,22036,12735,20429,1404
31997,8177,10353,31997,0,30130,1867,4.58199e+18,217.92,11832.2,31997,2135,132,21644,21601,20276,21384,17728
21863,306,794,0,21863,21242,621,3.55163e+16,108.477,2360.53,21863,106,26,21069,20952,18936,19059,11454
8842,2133,2222,8330,512,8330,512,1.25886e+18,96.9913,3188.81,8842,1026,108,6620,6620,6620,6620,6561
6545,109,205,0,6545,6341,204,0.0311688,0.968678,1158.12,6545,205,1,6340,6340,6340,6340,6340
13011,3211,4082,0,13011,0,13011,5.86022e+17,95.9743,5297.86,13011,1970,110,8929,8929,8534,8030,8165
33254,12025,14899,31854,1400,0,33254,1.61052e+18,92.8923,16992,33254,7234,110,18355,18355,16454,15991,14774
25260,3,12,24539,721,25246,14,1.38743e+14,10.4777,451.022,25260,12,11,19185,13600,15768,15098,10201
41152,1831,9902,38755,2397,38755,2397,5.19667e+18,98.3157,12996.2,41152,4681,111,31250,31250,20996,25327,7412
11385,2822,3353,0,11385,4110,7275,2.32977e+15,58.7522,4321.15,11385,1627,72,8032,8032,7257,6935,6485
46728,5364,14044,44248,2480,44248,2480,6.69973e+18,96.8164,17327.6,46728,6811,110,32684,32684,29074,28484,14482
46542,17702,18380,17696,28846,0,46542,7.80354e+12,57.4869,20970.4,46542,8948,72,28162,28162,28135,28153,28146
45297,10840,16570,43116,2181,43116,2181,7.67971e+18,95.7848,19535.2,45297,8054,110,28727,28727,28053,27941,25695
22859,7806,9741,21859,1000,0,22859,1.67664e+18,94.5368,11362.1,22859,4722,110,13118,13118,11752,11465,10522
1237,40,79,0,1237,1201,36,3.75725e+16,18.2579,221.43,1237,28,26,1158,1155,1000,1020,861
36649,5737,12535,34819,1830,0,36649,1.91527e+18,95.417,15120.3,36649,6069,110,24114,24114,18954,17840,13286
34546,7644,9428,32636,1910,32636,1910,6.3096e+18,96.9867,12097.5,34546,4571,110,25118,25118,24324,24198,21483
3093,180,768,1084,2009,0,3093,9.97543e+12,57.9266,1152.34,3093,365,61,2325,2325,1492,2181,625
23844,2569,5591,0,23844,0,23844,6.4889e+17,97.6248,7676.09,23844,2700,110,18253,18253,14151,10837,9298
46090,11669,17471,17392,28698,0,46090,7.99686e+12,57.7487,20099.5,46090,8496,72,28619,28619,25594,27989,20607
3834,379,1556,1457,2377,0,3834,7.97276e+12,56.1794,1936.13,3834,758,61,2278,2230,848,1868,593
38748,3,15,37619,1129,38663,85,1.60721e+14,10.4212,643.107,38748,13,13,29886,22169,22801,24324,15848
18704,847,4414,17614,1090,17614,1090,5.89098e+18,97.4744,6145.03,18704,2132,110,14290,14290,13092,12245,3660
23916,8987,10629,9298,14618,0,23916,7.17294e+12,56.6236,12054.1,23916,5170,72,13287,13287,12232,13107,11173
47059,6346,23618,0,47059,18778,28281,1.64468e+15,55.8017,25851,47059,11497,72,23441,23441,14660,12138,6114
807,34,250,276,531,0,807,9.64742e+12,52.6865,387.34,807,115,39,411,81,142,340,119
1997,986,1008,0,1997,0,1997,4.46062e+17,87.3976,1257.85,1997,458,49,989,989,989,989,989
47613,11170,14324,47613,0,44843,2770,4.94794e+18,330.621,16636.4,47613,5288,133,33289,33289,31164,32585,27057
16635,1187,1233,0,16635,16130,505,5.36956e+16,277.541,3471.8,16635,191,26,15402,15402,15380,15369,15218
21693,489,1249,0,21693,21049,644,4.74106e+16,272.327,3681.11,21693,198,26,20444,19779,18267,16283,8908
12999,5929,7206,12999,0,12516,483,4.14188e+18,166.203,7968.62,12999,3288,119,5793,5792,5547,5694,5511
47227,26,176,47162,65,47227,0,6.04359e+18,172.835,2669.41,47227,174,173,22162,5728,6703,6937,6783
3096,1390,1712,0,3096,0,3096,3.9558e+17,75.2206,2030.72,3096,796,56,1384,1384,1092,1025,980
10232,282,433,0,10232,9942,290,3.54513e+16,20.0725,1223.37,10232,64,26,9799,9799,9443,9484,7113
44831,9,16,43530,1301,44762,69,1.59564e+14,10.4249,686.159,44831,14,12,44306,43760,35635,35661,32200
13765,212,719,0,13765,13366,399,3.86541e+16,44.3142,1904.01,13765,93,26,13046,13019,11726,11325,5695
12083,47,885,0,12083,11723,360,4.82034e+16,160.456,2328.12,12083,125,26,10992,10921,6630,7093,2042
3799,602,1472,1432,2367,0,3799,8.04756e+12,53.9195,1862.53,3799,710,66,2327,2316,1871,2220,1350
6675,1336,2773,6675,0,6326,349,3.38859e+18,91.529,3289.66,6675,1080,98,3902,3902,2334,2918,1501
1221,576,842,1221,0,1181,40,4.97737e+18,41.2498,957.668,1221,342,47,379,379,330,360,349
44375,11302,12525,0,44375,0,44375,6.07037e+17,97.1274,15742.7,44375,6080,110,31850,31850,30552,30799,28662
26332,6138,6496,24822,1510,24822,1510,5.91886e+18,97.4656,8717.12,26332,3136,110,19836,19836,19623,19595,19082
4455,130,199,4450,5,4455,0,5.96892e+18,165.156,829.106,4455,98,96,4065,3766,3042,3055,3043
31089,40,176,31010,79,31089,0,6.00582e+18,172.689,2132.11,31089,168,165,18057,6297,6102,7350,7051
17860,499,10206,0,17860,7346,10514,1.42823e+15,54.5408,11135.3,17860,4972,72,7654,7606,2110,1399,677
9299,248,596,0,9299,9033,266,4.10463e+16,19.5828,1498.6,9299,77,26,8703,8703,7186,7326,3881
29390,7955,12763,0,29390,11381,18009,1.86906e+15,56.2197,14461.8,29390,6211,72,16627,16627,13884,14102,10730
32082,2743,7528,30213,1869,30213,1869,5.89068e+18,97.7746,10147.6,32082,3643,110,24554,24554,23345,23290,10056
12581,1139,3107,11850,731,11850,731,4.33656e+18,97.4678,4359.92,12581,1447,111,9474,9474,5766,6767,4164
13872,1099,3312,0,13872,0,13872,6.49931e+17,97.1906,4688.84,13872,1594,110,10560,10560,7603,5086,4238
35472,6,176,35456,16,35472,0,5.9945e+18,172.631,2259.03,35472,168,169,6003,806,788,729,914
47103,13307,26061,10146,36957,0,47103,53265700000,8.98336,26479.5,47103,23449,11,21042,21042,12791,21042,12182
16579,30,696,0,16579,16106,473,3.5579e+16,21.1538,1923.25,16579,87,26,15883,15875,9949,9804,2945
47197,12943,12997,44597,2600,0,47197,2.10717e+18,97.0966,16400,47197,6307,110,34200,34200,34151,34159,34180
4890,1192,1307,4608,282,4608,282,4.909e+18,95.5354,1927.36,4890,596,86,3583,3583,3583,3583,3471
6592,2646,3499,6352,240,6352,240,2.4873e+18,91.4612,4063.02,6592,1671,82,3093,3093,2826,2891,2991
3116,5,11,3023,93,3112,4,2.04241e+14,8.68902,165.534,3116,10,10,2892,2660,2525,2522,1203
47392,1476,15940,45001,2391,45001,2391,7.4135e+18,96.2682,19121.4,47392,7743,110,31452,31452,13156,25857,6179
35389,88,206,35370,19,35389,0,5.98093e+18,186.083,2315.66,35389,176,178,29910,17299,14461,16079,16069
17605,2516,4282,16582,1023,16582,1023,2.57759e+18,97.7873,5897.55,17605,2017,111,13323,13323,9237,10679,8665
43530,245,1689,0,43530,42261,1269,4.19169e+16,248.356,5564.55,43530,286,26,41418,40643,34345,29614,12501
18330,4325,4841,17300,1030,0,18330,2.14957e+18,97.0034,6497.26,18330,2339,110,13489,13489,12912,12753,12267
18207,598,4278,6400,11807,0,18207,9.88838e+12,59.8648,5752.46,18207,2080,72,13929,13929,5445,11615,2154
2123,61,107,0,2123,2063,60,3.55706e+16,19.0669,313.923,2123,32,26,2016,2016,1751,1785,1497
31804,467,1527,0,31804,30866,938,4.52592e+16,289.696,4787.04,31804,251,26,30277,29274,26768,23840,13008
30929,1347,8519,29229,1700,29229,1700,3.11965e+18,97.0398,10960.5,30929,4121,110,22410,22410,12064,16232,4311
2542,217,237,0,2542,2466,76,4.66022e+16,18.8981,564.927,2542,46,26,2305,2305,2278,2278,2155
18975,2450,6574,0,18975,0,18975,5.54369e+17,94.5273,8127.9,18975,3172,110,12401,12401,8880,7512,5545
14549,1619,3414,13699,850,0,14549,2.23762e+18,97.2854,4848.96,14549,1636,110,11135,11135,9003,8306,5922
44414,16,19,43089,1325,44274,140,1.90798e+14,10.5522,788.959,44414,16,12,44395,44395,44098,44097,43211
19493,326,6408,19493,0,18355,1138,5.54174e+18,147.326,7476.87,19493,1746,126,13085,12994,5860,8746,967
25166,8936,12270,0,25166,0,25166,4.34945e+17,92.7373,13871.9,25166,5938,110,12896,12896,11847,10889,11250
35257,7,11,32389,2868,35255,2,1.14213e+14,7.92404,485.942,35257,11,8,35178,35178,32706,32706,33412
36723,9996,11954,0,36723,13506,23217,2.22598e+15,58.0562,14290.6,36723,5817,72,24769,24769,22812,21978,19691
24428,3708,7584,24428,0,23008,1420,5.37824e+18,165.588,8988.89,24428,2111,128,16844,16697,14391,15931,8753
31144,10860,13362,12019,19125,0,31144,7.36248e+12,56.91,15153.8,31144,6503,72,17782,17782,16211,17512,14518
14726,38,1004,0,14726,14286,440,4.86827e+16,209.346,2762.29,14726,150,26,13370,13301,9776,7395,2542
4482,109,331,0,4482,4350,132,4.2942e+16,19.4415,826.376,4482,55,26,4151,4143,3275,3349,1830
20038,405,756,0,20038,19466,572,3.5529e+16,81.081,2204.35,20038,100,26,19282,19208,16692,16956,12359
45710,9624,21793,18044,27666,0,45710,6.75033e+12,55.9678,24062.5,45710,10611,72,23917,23917,18958,22665,12123
14278,4357,4441,13528,750,13528,750,6.98288e+18,96.0452,5751.19,14278,2132,110,9837,9837,9827,9827,9791
44408,9889,16329,16667,27741,0,44408,8.15931e+12,57.9364,18910.6,44408,7954,72,28079,28079,20260,26445,7096
9089,1006,4933,9089,0,8732,357,3.90999e+18,133.833,5527.69,9089,2205,105,4156,3908,2030,2996,1012
23614,4799,12489,0,23614,9538,14076,1.56509e+15,54.1595,13729.3,23614,6078,72,11125,11125,7562,3263,3479
47012,886,1484,0,47012,45658,1354,3.82268e+16,283.919,5071.74,47012,245,26,45528,45528,43374,43285,33559
41551,12503,18359,41551,0,39651,1900,4.49763e+18,715.631,20303.4,41551,6942,141,23192,22887,20256,21937,15898
29437,3107,6824,10346,19091,0,29437,9.92405e+12,60.0523,8993.93,29437,3320,72,22613,22613,17535,21454,10706
8164,1675,4341,3283,4881,0,8164,6.10296e+12,53.2009,4898.58,8164,2094,72,3823,3823,2478,3469,1331
11209,5091,5326,4414,6795,0,11209,6.81875e+12,53.0482,6093.46,11209,2588,72,5883,5883,5606,5823,5335
47472,3121,20495,44036,3436,45755,1717,4.96859e+18,3855.46,24788.1,47472,7893,154,24132,20018,10938,14891,4492
33500,1,13,32526,974,33473,27,1.61844e+14,10.3315,548.555,33500,12,12,7123,7123,7123,7123,7123
40978,1058,1724,0,40978,0,40978,3.83983e+18,15.992,2484.95,40978,1718,17,39254,39254,30648,32626,35275
38570,4437,9021,0,38570,0,38570,6.47895e+17,97.8075,12051.2,38570,4369,110,29549,29549,23321,15594,15694
17797,1255,4217,16760,1037,16760,1037,5.89409e+18,97.3747,5881.17,17797,2036,110,13580,13580,12784,12337,4630
40784,1322,1512,0,40784,39601,1183,4.06261e+16,281.398,4986.15,40784,249,26,39272,39272,38872,38901,36480
37025,6651,11977,0,37025,0,37025,5.7222e+17,96.3901,14639.4,37025,5810,110,25048,25048,20865,19117,13946
46847,5258,14884,46847,0,44116,2731,4.90275e+18,321.813,16827.7,46847,4729,136,31963,31753,21674,27135,12843
45140,10094,10564,42510,2630,0,45140,2.22811e+18,97.8949,13993.9,45140,5128,110,34576,34576,34052,33889,33490
22713,1456,5330,0,22713,0,22713,6.50151e+17,97.6007,7333.11,22713,2578,110,17383,17383,12129,5390,5768
1259,378,386,0,1259,0,1259,6.62965e+17,86.4718,610.475,1259,166,49,873,873,873,873,873
30701,6935,11790,30701,0,29081,1620,4.31996e+18,221.2,13193.5,30701,4702,127,18911,18821,14970,16925,12042
16548,1496,5564,15708,840,0,16548,1.94353e+18,93.5212,6981.26,16548,2688,110,10984,10984,6627,5108,2710
9675,2849,3799,0,9675,3665,6010,2.02234e+15,57.1275,4563.18,9675,1845,72,5876,5876,5172,4615,4547
44668,14,15,43383,1285,44581,87,1.48236e+14,10.5983,688.633,44668,14,12,44653,44653,44508,44509,44180
16703,2,10,15336,1367,16701,2,1.15098e+14,8.15081,331.893,16703,10,9,10970,10962,4832,8496,4401
23545,578,822,0,23545,22872,673,3.55009e+16,126.747,2498.92,23545,113,26,22723,22571,20651,20985,17797
4714,37,1123,0,4714,1658,3056,2.58235e+15,59.1076,1652.67,4714,546,71,2752,586,892,138,205
32312,3761,7841,0,32312,11417,20895,2.5029e+15,59.8903,10153.9,32312,3816,72,24471,24471,18961,12592,12392
3679,164,175,3617,62,3679,0,5.99604e+18,149.656,724.245,3679,90,88,3496,3458,3393,3390,3400
2606,150,943,2606,0,2453,153,3.03724e+18,88.2141,1250.48,2606,329,66,1663,1663,768,1085,500
37671,1030,1085,0,37671,36596,1075,3.55363e+16,225.725,3657.19,37671,166,26,36586,36586,36430,36421,35605
13999,4277,4734,13999,0,13209,790,3.85482e+18,125.724,5686.14,13999,1846,120,9265,9265,8942,9079,8615
30541,7,14,29672,869,30462,79,1.38945e+14,10.7296,538.217,30541,13,12,29462,28848,22363,22413,21644
14787,373,758,0,14787,14361,426,3.91549e+16,79.9843,2048.31,14787,99,26,14029,13955,13304,12943,10347
36172,2054,8418,0,36172,12720,23452,2.53632e+15,60.0691,10979.2,36172,4098,72,27754,27754,14470,10785,7018
31101,9240,14418,29831,1270,0,31101,1.56481e+18,92.0427,16366.6,31101,6994,110,16683,16683,14717,13609,11696
47405,1099,15114,47405,0,44648,2757,4.03155e+18,325.492,17073.8,47405,4661,136,32291,31661,15331,21995,3292
23817,10871,11963,0,23817,9500,14317,1.65519e+15,55.7053,13261.8,23817,5826,72,11854,11854,11636,11420,11462
44885,98,176,44796,89,44885,0,6.02812e+18,173.306,2587.88,44885,170,173,40011,26603,23264,24573,25047
16616,9559,9972,16106,510,16106,510,2.13081e+18,91.5523,10951.7,16616,4827,110,6644,6644,6243,6524,5724
750,74,272,708,42,708,42,3.24391e+18,78.1533,414.625,750,99,42,385,130,186,291,170
12892,6,10,11826,1066,12892,0,1.1611e+14,7.64536,281.329,12892,10,8,12175,10760,11822,11822,10782
24455,7548,9156,24455,0,23175,1280,4.67423e+18,182.943,10510.1,24455,2242,132,15299,15279,14764,15288,13209
29887,11964,14022,0,29887,11758,18129,1.75551e+15,55.5464,15657.6,29887,6826,72,15865,15865,14599,13251,13301
44991,5950,16511,42811,2180,42811,2180,7.21343e+18,96.3841,19392.7,44991,7909,111,28480,28480,19097,21891,10819
14399,3377,5918,13749,650,13749,650,2.75466e+18,93.1952,7091.36,14399,2861,110,8481,8481,6746,8037,4367
15360,5993,6397,15360,0,14587,773,5.60253e+18,129.426,7264.2,15360,2032,123,8963,8963,8960,8962,8515
25891,5088,6061,24381,1510,24381,1510,5.86762e+18,97.6744,8281.15,25891,2929,110,19830,19830,19580,19580,17185
23938,4240,5604,0,23938,0,23938,6.50593e+17,97.6857,7692.74,23938,2711,110,18334,18334,16473,14931,14449
6220,2561,2729,2407,3813,0,6220,7.37238e+12,56.2092,3250.18,6220,1329,70,3491,3491,3392,3470,3345
4815,671,1164,0,4815,1687,3128,2.52859e+15,58.9281,1701.51,4815,562,72,3651,3651,2929,2087,2230
44534,5944,16970,42424,2110,42424,2110,2.36184e+18,96.17,19779.6,44534,8137,111,27564,27477,24346,25021,19846
41239,6532,16319,0,41239,0,41239,5.11941e+17,93.8807,18970.6,41239,7926,110,24920,24920,17704,10373,9468
16522,82,175,16512,10,16522,0,5.98239e+18,165.507,1522.56,16522,143,152,13538,7661,7083,7710,7964
49014,304,1299,0,49014,47618,1396,3.55643e+16,264.406,4575.35,49014,209,26,47552,46990,40341,40376,18191
21140,3909,9036,20211,929,20211,929,8.54112e+18,93.6807,10557.5,21140,4378,110,12104,12104,10919,10734,6430
5736,1521,1942,0,5736,2113,3623,2.19843e+15,53.1128,2497.79,5736,934,72,3794,3794,3323,2747,2727
42329,5199,22809,9157,33172,0,42329,53038200000,8.99334,23214.1,42329,20522,11,19520,19520,7681,19520,6687
2727,1,10,2650,77,2727,0,1.39447e+14,9.85002,144.325,2727,10,10,698,698,698,698,698
39788,3114,9855,0,39788,14093,25695,2.48431e+15,59.8278,12575,39788,4800,72,29933,29933,19279,12920,10556
21685,6314,7087,21685,0,20417,1268,3.16701e+18,155.154,8231.09,21685,2580,124,14598,14598,14056,14322,13381
48988,14501,16809,46526,2462,46526,2462,3.47319e+18,95.8357,19980.9,48988,8037,111,32179,32179,30523,32068,28154
42572,1475,1491,0,42572,41341,1231,3.97068e+16,286.236,4975.13,42572,246,26,41081,41081,41043,41031,40952
47227,127,208,47120,107,47227,0,6.11805e+18,204.277,2902.95,47227,186,179,44071,40670,28115,28799,28640
14441,1,3,13989,452,14377,64,0.000138495,0.999792,193.686,14441,3,1,14438,14438,14438,14438,14438
31406,8756,20353,0,31406,6783,24623,5.72633e+15,5.52385,23355,31406,6787,13,11053,11053,9170,9429,5571
18459,5913,9571,7407,11052,0,18459,6.25674e+12,54.0517,10614.1,18459,4646,72,8888,8888,7484,8595,5271
1939,102,222,0,1939,1884,55,5.09494e+16,16.9123,502.245,1939,41,24,1717,1709,1544,1503,822
40189,3690,13834,38169,2020,38169,2020,4.08773e+18,96.7074,16545,40189,6617,111,26355,26355,18778,19378,7985
25913,11461,11544,24815,1098,24815,1098,2.60918e+18,94.3341,13280.9,25913,5602,110,14369,14369,14304,14347,14316
15862,781,6322,0,15862,6028,9834,2.00101e+15,56.5792,7423.55,15862,3063,72,9540,9396,6284,6246,2482
25615,3014,5993,24118,1497,24118,1497,5.74334e+18,97.7029,8195.38,25615,2901,110,19622,19622,17791,17500,10626
31078,3226,7260,10922,20156,0,31078,9.89196e+12,60.0244,9522.15,31078,3536,72,23818,23818,18114,22485,10874
21813,80,176,21795,18,21813,0,6.05906e+18,169.889,1817.79,21813,154,154,17989,11668,9328,9998,9902
44694,6674,10671,42087,2607,42087,2607,5.83578e+18,98.3538,13981.3,44694,5042,111,34023,34023,29181,31294,22494
38070,166,176,38006,64,38070,0,6.06598e+18,171.478,2409.9,38070,167,164,37797,37447,36184,35953,35971
5683,536,1353,1997,3686,0,5683,1.00608e+13,59.2838,1958.57,5683,659,72,4330,4330,2998,3996,1846
14476,343,617,0,14476,14064,412,3.55908e+16,20.0727,1699,14476,79,26,13859,13859,12366,12496,8967
31461,2124,7391,29631,1830,29631,1830,5.89014e+18,97.7419,9971.77,31461,3576,110,24070,24070,22701,21848,8016
23400,387,5639,22040,1360,22040,1360,3.28388e+18,98.0141,7645.08,23400,2650,111,17761,17761,7094,9077,2365
15654,6514,8447,15654,0,15061,593,4.69677e+18,197.995,9338.19,15654,3616,126,7207,7170,6524,6781,6299
15777,2136,3744,14857,920,14857,920,5.75833e+18,97.3626,5265.13,15777,1802,110,12033,12033,11058,10894,7448
8790,770,3416,8790,0,8314,476,6.49225e+18,91.7667,4038.65,8790,1294,113,5374,5374,3847,4730,1870
12287,2621,3031,11574,713,11574,713,6.2822e+18,97.4718,4265.67,12287,1427,111,9256,9256,8515,8695,8419
32514,1123,1206,0,32514,31576,938,3.92778e+16,250.12,3873.43,32514,190,26,31308,31308,31129,31124,30110
6873,420,1741,6481,392,0,6873,2.20535e+18,95.7759,2553.2,6873,815,96,5132,5132,2705,2445,1679
48927,4256,11385,0,48927,17203,31724,2.53275e+15,60.1015,14669.6,48927,5546,72,37542,37542,27179,22236,14533
32773,3402,7648,0,32773,11526,21247,2.53403e+15,60.0317,10009.6,32773,3720,72,25125,25125,18932,13590,11467
39242,9384,24133,38082,1160,38082,1160,1.0088e+19,90.1077,25910.4,39242,11659,111,15109,15109,7284,9352,6656
25316,10,14,24557,759,25289,27,1.93817e+14,10.3147,494.652,25316,13,12,25251,25163,24555,24376,22260
21448,2683,6556,20307,1141,20307,1141,3.89733e+18,96.9645,8311.98,21448,3119,111,14892,14892,11551,13687,6285
12871,2758,6498,12381,490,12381,490,2.52581e+18,92.7951,7450.47,12871,3145,110,6373,6373,3701,4654,3251
14696,204,621,0,14696,14277,419,3.55777e+16,20.0996,1719.09,14696,81,26,14075,14075,11177,11273,5982
23953,3563,5748,22553,1400,22553,1400,2.28148e+18,98.1511,7789.53,23953,2718,111,18205,18205,13954,14958,12010
29686,438,1077,0,29686,28831,855,3.81891e+16,219.566,3421.75,29686,164,26,28609,28150,23616,24177,17560
36899,29,32,36739,160,36899,0,1.11683e+18,31.9722,1086.63,36899,32,32,33300,0,29958,32260,33300
17182,2306,4785,6180,11002,0,17182,9.33324e+12,59.1802,6133.51,17182,2331,72,12397,12397,9236,11852,5570
32063,4495,7492,0,32063,11262,20801,2.53027e+15,60.0281,9811.18,32063,3648,72,24571,24571,20988,19090,15063
29591,9592,12935,0,29591,0,29591,4.77731e+17,94.4954,14875.8,29591,6274,110,16656,16656,12674,11135,8053
17596,4229,4759,6303,11293,0,17596,9.42732e+12,59.3061,6144.15,17596,2312,72,12837,12837,12192,12699,11307
25076,900,8538,23805,1271,23805,1271,3.65285e+18,96.5655,10434.5,25076,4069,111,16538,16364,7578,10401,3620
14962,1212,3534,5259,9703,0,14962,9.87622e+12,59.7792,4799.78,14962,1716,72,11428,11428,7258,10355,4164
22302,6,61,22270,32,22302,0,2.26281e+18,60.6959,1111.53,22302,61,61,4471,210,8,397,1890
35122,6281,8270,0,35122,0,35122,6.46531e+17,97.6313,11083.6,35122,3987,110,26852,26852,24213,22293,21174
40599,10350,16436,38749,1850,38749,1850,3.22245e+18,95.7364,18973.9,40599,7893,111,24163,24163,20589,23956,16208
25266,1,12,24545,721,25253,13,1.38654e+14,10.5431,451.384,25266,12,11,6479,6479,6479,6479,6479
18929,623,8308,18929,0,18039,890,4.62424e+18,170.987,9393.4,18929,3577,123,10621,10158,5523,6922,1781
21599,4033,5854,7726,13873,0,21599,9.4362e+12,59.3715,7478.54,21599,2851,72,15745,15745,13754,15325,10543
16581,178,827,4927,11654,4927,11654,1.84992e+18,15.982,1303.37,16581,696,18,15754,15754,8874,11069,7481
21872,4,14,21234,638,21822,50,1.70401e+14,10.3889,466.918,21872,13,11,19158,17134,13984,14129,7396
41235,3889,13203,41235,0,38835,2400,4.29792e+18,291.659,14977.6,41235,4901,128,28032,27542,16404,21932,9498
36073,1414,15667,34514,1559,0,36073,1.65008e+18,94.6533,17933.1,36073,7613,110,20406,20406,12827,11045,4681
47195,10196,18339,47195,0,44755,2440,4.45687e+18,432.383,20292.6,47195,7339,138,28856,28624,22667,25371,16388
29893,8,12,29035,858,29879,14,1.42541e+14,10.2202,491.142,29893,11,12,29173,28767,26190,25954,22832
24115,3261,5616,8469,15646,0,24115,9.92483e+12,59.9992,7461.27,24115,2735,72,18499,18499,15610,17896,10868
1709,25,170,1709,0,1709,0,5.96429e+18,125.04,486.417,1709,69,60,751,167,215,240,248
2477,67,618,868,1609,0,2477,1.02823e+13,57.8857,944.215,2477,300,58,1859,1129,541,1479,278
30355,1879,7076,28585,1770,28585,1770,5.86032e+18,97.7716,9591.68,30355,3424,110,23279,23279,21835,20906,7500
15963,19,176,15957,6,15963,0,6.06001e+18,168.958,1559.93,15963,141,142,6240,1249,1760,1595,1569
8550,5020,5054,0,8550,3537,5013,1.37305e+15,48.6139,5575.42,8550,2445,72,3496,3496,3496,3496,3496
5542,56,245,0,5542,5384,158,3.54047e+16,19.9527,709.509,5542,46,26,5297,5297,3886,3883,1850
25669,8468,9474,24419,1250,24419,1250,4.59909e+18,96.1785,11338.7,25669,4531,111,16195,16195,15805,15910,15937
29950,168,176,29893,57,29950,0,6.07366e+18,173.09,2139.09,29950,163,160,29681,29381,28501,28305,28424
28926,4463,9182,27416,1510,27416,1510,2.10339e+18,96.9479,11355.3,28926,4368,111,19744,19744,16554,19112,11180
9219,165,2210,8680,539,8680,539,5.71126e+18,96.6541,3227.51,9219,1049,110,7009,7009,5182,3948,984
10657,4494,6699,10347,310,0,10657,1.10831e+18,86.5993,7371.67,10657,3228,97,3958,3958,3404,3274,3228
23846,383,992,0,23846,23158,688,3.93649e+16,201.842,3005.68,23846,147,26,22854,22498,18659,19251,13003
47744,14551,17701,0,47744,0,47744,5.31573e+17,82.2343,20773,47744,8582,110,30043,30043,30043,30043,30043
8906,2600,3964,8526,380,0,8906,1.63822e+18,93.3455,4757.02,8906,1902,104,4942,4942,4282,3882,3526
18729,3203,4395,6580,12149,0,18729,9.89986e+12,59.8322,5902.41,18729,2132,72,14334,14334,12899,14033,10639
29512,4978,9894,0,29512,10902,18610,2.19771e+15,58.3785,11826.6,29512,4817,72,19618,19618,15448,11039,10556
16633,293,1006,0,16633,16139,494,4.6034e+16,212.62,2833.53,16633,150,26,15531,15253,13590,12692,6794
43781,8999,23418,17724,26057,0,43781,5.99393e+12,55.2669,25411.6,43781,11403,72,20363,20363,15218,19486,9236
30914,1349,1423,0,30914,30007,907,4.39562e+16,280.335,4460.47,30914,233,26,29491,29491,29364,29361,28724
38807,20,176,38737,70,38807,0,6.10019e+18,173.159,2440.68,38807,170,168,15720,3304,4420,4540,4203
17522,3340,4122,6159,11363,0,17522,9.88719e+12,59.8435,5552.52,17522,2005,72,13400,13400,12263,13201,11035
3884,5,11,3772,112,3880,4,1.37549e+14,10.7078,175.403,3884,11,11,3543,3164,3006,2983,2209
3041,518,1626,0,3041,1222,1819,1.62021e+15,53.8083,1893.69,3041,791,62,1415,1367,1020,1119,1033
15342,1090,7960,14772,570,14772,570,7.24386e+18,90.8277,9008.83,15342,3831,111,7382,7382,2350,3347,1512
43700,9972,10182,41151,2549,41151,2549,5.90979e+18,97.8966,13528.6,43700,4942,110,33518,33518,33468,33468,33171
10448,1823,2875,0,10448,0,10448,6.21453e+17,96.245,3950.32,10448,1377,110,7573,7573,6145,4771,4681
1029,3,299,361,668,0,1029,9.90382e+12,54.0321,465.603,1029,139,45,94,18,9,0,8
44851,3252,10418,15761,29090,0,44851,9.88404e+12,60.0727,13476.9,44851,5059,72,34433,34433,20683,30877,11093
26116,9991,13617,26116,0,18966,7150,5.0706e+18,402.143,14896.8,26116,5085,130,12499,12408,11638,12252,10152
9250,2545,4278,0,9250,0,9250,4.67256e+17,93.1384,5066.92,9250,2065,96,4972,4972,3582,3230,2399
20038,8415,9670,19248,790,0,20038,1.51401e+18,90.9211,11031.9,20038,4682,110,10368,10368,10068,9812,9853
43461,7147,10150,0,43461,15286,28175,2.52947e+15,60.0583,13122.9,43461,4939,72,33311,33311,28973,24657,23800
44145,1190,15102,44145,0,41735,2410,4.81622e+18,311.266,17239.2,44145,4519,137,29043,28414,13188,18372,3334
24025,8767,11956,24025,0,23008,1017,5.04683e+18,259.872,13103.8,24025,4012,133,12069,12027,11067,12067,9435
7672,5,10,7442,230,7666,6,2.03989e+14,9.65706,255.059,7672,10,10,7144,6481,6619,5999,4511
44477,4,14,43206,1271,44400,77,1.39032e+14,10.5866,657.854,44477,13,12,38746,34604,33524,30875,21248
36565,12246,14976,34925,1640,34925,1640,2.77897e+18,93.2277,17349.5,36565,7275,110,21589,21589,20572,21336,19366
38066,650,1094,0,38066,36980,1086,3.55404e+16,228.365,3695.21,38066,167,26,36972,36492,34776,35019,26222
37073,1206,12302,37073,0,35010,2063,4.84003e+18,256.999,14180,37073,3154,133,24771,24342,11327,15767,3071
11850,2713,2757,0,11850,4164,7686,2.54706e+15,59.78,3818.7,11850,1343,72,9093,9093,9061,9048,9058
22415,102,175,22342,73,22415,0,5.98249e+18,166.335,1770.86,22415,160,157,20176,12768,12121,12793,13319
45269,7203,10798,42629,2640,42629,2640,2.37541e+18,98.3695,14144.5,45269,5110,111,34471,34471,28542,30308,24051
43644,2257,10177,41104,2540,41104,2540,3.23142e+18,97.8806,13523.5,43644,4937,110,33467,33467,19604,26388,9283
8524,90,175,8518,6,8524,0,5.98257e+18,161.104,1096.84,8524,119,123,7242,4379,4096,4332,4476
38234,21145,38234,0,38234,0,38234,524274,0,38234,38234,38234,1,0,0,0,0,0
25669,8071,14183,25669,0,24770,899,4.68961e+18,492.307,15594.2,25669,6841,129,11486,11204,9259,10176,7954
982,211,382,827,155,932,50,3.77246e+18,76.5815,553.452,982,151,46,600,600,556,581,497
37526,107,176,37454,72,37526,0,5.98239e+18,172.476,2297.38,37526,171,168,34265,23682,21111,22231,22639
43928,2,16,42643,1285,43860,68,1.70008e+14,10.5087,701.111,43928,14,12,25977,20006,13816,14586,11415
1324,59,72,0,1324,1286,38,3.53757e+16,18.5748,212.025,1324,27,26,1252,1252,1205,1206,1147
29701,1966,9841,29701,0,29701,0,2.6126e+18,3169.64,12882.5,29701,7375,25,15631,13685,3293,2185,4328
20048,307,10068,19288,760,19288,760,9.64177e+18,89.5307,11391.5,20048,4874,110,9980,9292,7417,5946,1632
24551,2713,5902,23120,1431,23120,1431,2.69403e+18,98.0833,7978.65,24551,2781,111,18649,18649,12468,13916,9516
47260,20545,21057,0,47260,0,47260,4.68713e+17,94.52,23816.7,47260,10227,110,26203,26203,25767,25850,25355
1455,65,183,1454,1,1437,18,6.18101e+18,95.8907,480.081,1455,61,55,1081,740,646,713,652
33519,1096,7866,31569,1950,31569,1950,5.76452e+18,97.7617,10577.6,33519,3801,110,25653,25653,20659,16809,5080
19767,90,175,19755,12,15357,4410,5.97863e+18,166.159,1664.28,19767,149,158,16970,10241,9389,9997,10263
29414,5718,6889,10340,19074,0,29414,9.87419e+12,59.9897,9052.11,29414,3349,72,22525,22525,21188,22245,19115
20487,6525,8735,0,20487,7888,12599,1.90126e+15,56.8758,10027.3,20487,4254,72,11752,11752,10930,11054,10188
7311,715,1821,6888,423,6888,423,1.25997e+18,96.5634,2665.05,7311,839,101,5490,5490,5270,5421,2637
4896,330,1188,0,4896,1716,3180,2.5018e+15,58.7216,1732.11,4896,564,72,3708,3708,2478,1443,1129
11047,4215,4929,10577,470,0,11047,1.62999e+18,90.0064,5854.99,11047,2360,108,6118,6118,5593,5323,5052
48105,3129,16676,48105,0,34067,14038,4.64285e+18,332.813,18635.1,48105,6494,132,31429,30734,17648,24018,7952
13872,986,3729,9862,4010,13092,780,5.96756e+18,97.2317,5050.43,13872,1757,111,10143,10143,6520,7561,3782
42709,6596,10026,0,42709,0,42709,6.46363e+17,97.8378,13309.6,42709,4853,110,32683,32683,28059,22984,22515
18553,5222,7135,18553,0,17563,990,5.76966e+18,149.311,8131.11,18553,2211,128,11418,11418,10749,11359,9452
31866,1202,1258,0,31866,30943,923,4.04292e+16,262.169,4001.01,31866,199,26,30608,30608,30492,30484,29901
24459,65,176,24441,18,24459,0,6.04936e+18,171.81,1920.02,24459,157,157,18197,11201,8248,9370,9345
14374,1575,4550,0,14374,0,14374,5.83366e+17,95.9212,5853.8,14374,2195,110,9824,9824,6951,3315,3824
29751,9447,10502,0,29751,11079,18672,2.13381e+15,57.9606,12411.1,29751,5093,72,19249,19249,17833,16649,16259
37081,457,1266,0,37081,36013,1068,3.84355e+16,262.087,4168.72,37081,202,26,35815,35130,28154,29022,16703
20523,5482,6708,19472,1051,19472,1051,3.04134e+18,96.0276,8395.33,20523,3246,110,13815,13815,12709,13512,11155
5326,1164,1880,5326,0,5016,310,4.51175e+18,91.1038,2359.42,5326,675,95,3446,3446,2693,2982,2450
37364,1631,14710,0,37364,14195,23169,2.00159e+15,57.5222,16886,37364,7165,72,22654,22606,15114,8436,5556
15510,873,3880,5488,10022,0,15510,9.66453e+12,59.5028,5163.85,15510,1875,72,11630,11630,6019,10126,3035
23532,7564,8771,8842,14690,0,23532,8.08403e+12,56.4005,10318.9,23532,4251,72,14761,14761,14103,14621,13179
29921,4498,7220,28178,1743,28178,1743,3.43778e+18,98.1785,9634.59,29921,3409,111,22701,22701,17526,18614,14856
19304,552,4551,18177,1127,0,19304,2.23124e+18,97.5437,6323.58,19304,2198,110,14753,14753,5845,5228,2775
39471,9581,16290,0,39471,15129,24342,1.94155e+15,57.2054,18500.1,39471,7935,72,23181,23181,20484,16750,16093
42561,7348,9932,40081,2480,40081,2480,3.39067e+18,97.8733,13207.2,42561,4808,110,32629,32629,27388,29810,24872
10890,12,32,10826,64,10890,0,1.11634e+18,31.906,590.322,10890,32,32,3858,0,2039,3736,3858
45863,3133,23992,18471,27392,0,45863,6.14768e+12,55.4074,26107.3,45863,11666,72,21871,21871,12468,18415,4543
22093,363,10877,21230,863,21230,863,3.58556e+18,94.1806,12298.2,22093,5245,111,11216,10521,3434,6043,1246
32904,6152,10645,32904,0,30984,1920,5.46426e+18,226.786,12153.9,32904,3876,130,22259,22205,18935,20864,13693
38655,3163,12411,37284,1371,36401,2254,3.68135e+18,272.84,14104.4,38655,4607,125,26244,25816,14260,19461,7815
4367,525,1249,4125,242,4125,242,6.40118e+18,94.2537,1816.45,4367,587,86,3118,3118,2938,2938,1267
36943,2,15,35854,1089,36883,60,1.7617e+14,10.4673,658.248,36943,13,11,21895,17115,10983,11597,9358
41387,5936,20814,0,41387,16528,24859,1.64244e+15,55.4405,22823.8,41387,10140,72,20573,20573,13747,5217,5688
34192,75,176,34142,50,34192,0,5.99823e+18,170.942,2223.79,34192,164,169,26845,15539,13244,14775,14493
26121,951,10995,26121,0,24865,1256,5.22583e+18,252.408,12411.5,26121,4764,133,15126,14528,8514,10433,2578
44918,8977,10489,15787,29131,0,44918,9.86916e+12,60.0634,13547.8,44918,5102,72,34429,34429,32313,34059,29879
16412,2944,7075,16412,0,15622,790,3.77833e+18,150.679,8062.08,16412,3030,119,9337,9209,6174,7264,4298
28875,119,176,28798,77,28875,0,5.98617e+18,169.195,2012.79,28875,167,162,27028,24523,19070,19485,19348
30931,9387,10042,30931,0,29131,1800,4.04418e+18,203.46,11482.8,30931,2804,133,20889,20889,20889,20889,20168
48561,12848,16966,0,48561,18075,30486,2.14892e+15,58.2416,19813.9,48561,8260,72,31595,31595,29123,25844,25112
12875,1415,3101,12127,748,0,12875,2.22163e+18,97.0448,4401.49,12875,1483,110,9774,9774,7486,7022,4906
45229,7633,17540,45229,0,42890,2339,4.552e+18,439.232,19447.4,45229,4861,140,27689,27256,20119,22099,12052
28657,13,14,27836,821,28596,61,1.43453e+14,10.5932,522.416,28657,13,11,28643,28643,28491,28491,28474
34339,1,12,33352,987,34324,15,1.46939e+14,10.1868,533.434,34339,11,12,8272,8272,8272,8272,8272
46636,9752,14886,46636,0,43996,2640,4.73012e+18,317.732,17130.3,46636,4054,134,31750,31733,28386,30503,23236
33951,1254,12579,33951,0,32119,1832,3.87477e+18,245.031,14087.5,33951,4963,126,21372,20990,9458,14402,2333
45596,69,176,45467,129,45596,0,6.07733e+18,172.974,2643.15,45596,172,172,35326,23648,16856,18219,17414
23765,1102,10334,9193,14572,0,23765,7.29003e+12,55.3508,11772.4,23765,5012,72,13431,13385,8162,12531,1969
38443,62,176,38345,98,38443,0,6.11568e+18,173.185,2428.97,38443,168,164,29258,19386,12934,13861,13486
35187,2026,8515,33145,2042,33145,2042,3.67992e+18,98.2099,11253.6,35187,4015,111,26672,26672,14285,18173,7703
16445,283,5122,0,16445,0,16445,5.84374e+17,96.0746,6574.63,16445,2468,110,11323,11151,6810,1641,1628
44510,1918,10376,41920,2590,0,44510,2.22939e+18,97.8737,13774.9,44510,5029,110,34134,34134,22616,21512,8202
47768,17,208,47700,68,47768,0,6.10456e+18,204.635,2913.49,47768,187,183,17560,3658,4803,4381,3859
34024,2808,8178,32044,1980,32044,1980,5.86944e+18,98.233,10850.3,34024,3860,111,25846,25846,15616,18410,10315
48973,6037,17217,0,48973,18244,30729,2.13973e+15,58.2021,20079.2,48973,8380,72,31756,31756,21965,21486,10829
37833,13934,19787,36461,1372,0,37833,1.39212e+18,91.6237,21853.7,37833,9601,110,18046,18046,15878,15358,13927
30956,10292,11650,0,30956,11658,19298,2.06241e+15,49.3252,13560.7,30956,5658,72,19306,19306,19306,19306,19306
32988,5668,9952,31220,1768,31220,1768,6.83293e+18,96.3134,12396.9,32988,4724,111,23036,23036,13856,17481,13149
17418,3755,5316,6339,11079,0,17418,8.97118e+12,57.2917,6643.06,17418,2567,72,12102,12102,10717,11862,9200
7931,1976,3725,6316,1615,7604,327,3.14718e+18,93.3765,4421.09,7931,1771,93,4206,4206,3007,3832,2910
8111,775,2354,0,8111,2925,5186,2.35872e+15,58.7212,3109.26,8111,1142,72,5757,5757,2925,2461,1052
39365,564,11911,39365,0,37074,2291,3.65668e+18,279.972,13911.3,39365,4372,133,27454,27009,13772,18705,2060
19348,2425,7156,18408,940,18408,940,3.15246e+18,95.6414,8667.21,19348,3424,111,12192,12192,8860,10547,4027
34049,12223,12936,0,34049,12853,21196,2.05276e+15,57.6991,14983.9,34049,6302,72,21113,21113,20564,19784,19847
22559,4,8,20679,1880,22303,256,1.1715e+14,7.62325,373.699,22559,8,8,17618,16334,10466,14215,15744
45125,11887,14396,45125,0,42495,2630,4.78035e+18,316.525,16290.4,45125,3647,134,30729,30729,29354,30381,26463
25886,1795,6996,24436,1450,24436,1450,2.35097e+18,97.6412,9094.16,25886,3313,111,18890,18890,11758,13870,5721
23839,7,12,23157,682,23827,12,1.38713e+14,10.6006,438.5,23839,12,11,23002,22515,21113,21153,17869
31206,1075,1634,0,31206,30279,927,4.75835e+16,296.128,5075.71,31206,274,26,29572,29572,27737,27891,22367
38406,7370,9038,0,38406,0,38406,6.47754e+17,97.8073,12050,38406,4381,110,29368,29368,27167,25574,24785
7588,115,176,7584,4,7588,0,5.99898e+18,163.937,1051.88,7588,114,119,6933,6181,4732,4853,4907
43167,1,14,41935,1232,43085,82,1.40963e+14,10.3301,608.234,43167,13,12,10887,10887,10887,10887,10887
17682,1648,5723,17682,0,16664,1018,3.45365e+18,143.017,6846.59,17682,2222,121,11959,11880,7456,8999,3958
9758,1227,2384,9184,574,9184,574,6.22173e+18,97.2206,3426.28,9758,1109,111,7374,7374,5155,5676,4336
44574,5,15,43289,1285,44515,59,1.52666e+14,10.4603,675.38,44574,13,12,41110,36856,30401,30412,22525
46075,1280,1977,0,46075,44722,1353,4.45311e+16,311.629,6491.07,46075,344,26,44098,44098,42792,42508,34206
11722,1998,2770,11035,687,0,11722,2.23744e+18,97.002,3988.4,11722,1329,110,8952,8952,8078,7766,6955
28918,122,176,28861,57,28918,0,6.06924e+18,172.239,2095.22,28918,162,160,27279,24908,19835,19972,20104
17729,25,32,17665,64,17729,0,1.11683e+18,31.9422,753.212,17729,32,32,13704,0,9962,13274,13704
42095,19119,21712,40535,1560,40535,1560,5.60933e+18,93.546,23939.5,42095,10472,117,20383,20383,19618,20383,18439
4891,550,1230,4601,290,4601,290,4.12438e+18,96.0137,1860.56,4891,567,86,3661,3661,2403,2717,2049
32215,64,176,32202,13,32215,0,5.98055e+18,169.556,2126.24,32215,169,166,23126,12584,10146,11774,11819
14131,3016,5614,13481,650,13481,650,2.92327e+18,94.6424,6792,14131,2715,110,8517,8517,5934,6907,5252
8921,1619,4128,5834,3087,8548,373,4.49118e+18,93.721,4891.96,8921,1965,100,4793,4793,3416,3243,1902
26391,7,14,25618,773,26311,80,1.66895e+14,10.5584,536.365,26391,13,12,25626,25196,20652,20415,17731
3737,1175,1547,0,3737,1425,2312,1.97811e+15,55.84,1917.35,3737,743,64,2190,2190,1766,1681,1241
34182,1374,15597,13354,20828,0,34182,7.00633e+12,56.4834,17452.2,34182,7592,72,18585,18539,8822,15247,2064
32172,7779,9598,11667,20505,0,32172,9.04539e+12,58.9873,11764.6,32172,4671,72,22574,22574,21065,22254,18677
6725,4,12,6526,199,6717,8,1.83785e+14,10.2559,245.558,6725,12,11,5876,5298,4399,4585,3007
8950,1833,3398,8520,430,0,8950,1.8328e+18,78.726,4258.45,8950,1631,100,5552,5552,3414,2888,1028
33306,3145,8420,0,33306,0,33306,6.31659e+17,97.4635,11069,33306,4077,110,24886,24886,18607,11283,11232
42818,8597,10711,0,42818,0,42818,6.34313e+17,97.5929,13945,42818,5189,110,32107,32107,29935,29056,26507
17039,3518,6235,16209,830,16209,830,5.06637e+18,95.9079,7618.99,17039,2973,111,10804,10804,9713,10635,6780
46832,1956,2587,9622,37210,0,46832,5.77794e+13,11.9955,3292.8,46832,1932,14,44245,44245,39107,35385,41952
46848,1449,2183,0,46848,45462,1386,4.67002e+16,332.177,7112.18,46848,380,26,44665,44665,42988,43255,35603
42821,6897,9948,0,42821,15054,27767,2.53178e+15,60.0684,12890.9,42821,4840,72,32873,32873,29236,28533,23210
17721,3795,4161,6233,11488,0,17721,9.87223e+12,59.846,5607.52,17721,2018,72,13560,13560,13057,13470,12607
10288,1837,2484,0,10288,3619,6669,2.5078e+15,59.4826,3430.21,10288,1195,72,7804,7804,7043,6097,5936
2618,1011,1273,2508,110,2508,110,8.89081e+18,89.0546,1581.15,2618,592,61,1345,1345,1216,1196,991
44990,23474,25091,43478,1512,43478,1512,1.05128e+19,92.1063,27318.4,44990,12193,110,19899,19899,19463,19395,18087
6558,1606,2288,0,6558,0,6558,5.61533e+17,94.2176,2996.7,6558,1087,92,4270,4270,3462,2757,2827
4751,844,1133,0,4751,1666,3085,2.56239e+15,59.1156,1667.11,4751,551,71,3618,3618,3275,2987,2876
13565,2,10,13178,387,13562,3,1.39046e+14,9.93535,322.24,13565,10,10,7857,5569,5333,5613,4692
13102,2359,3145,12342,760,0,13102,2.22277e+18,97.0604,4467.41,13102,1504,110,9957,9957,9075,8777,7949
3985,167,198,0,3985,3873,112,3.67431e+16,19.5004,565.671,3985,42,26,3787,3787,3730,3737,3472
49734,8178,11616,46837,2897,46837,2897,3.35107e+18,97.935,15326.7,49734,5640,110,38118,38118,31208,34295,27906
44290,10736,15436,0,44290,0,44290,5.50615e+17,95.2216,18411.8,44290,7486,110,28854,28854,25138,21319,19004
5719,9,10,5554,165,5714,5,1.51639e+14,9.56199,213.967,5719,10,10,5650,5574,5531,5530,5290
18722,1286,6578,17799,923,17799,923,2.93368e+18,93.6144,8107.33,18722,3175,110,12144,12144,8540,9145,3666
47555,4377,24293,47555,0,47555,0,2.38199e+18,17.9852,24915.6,47555,21849,20,23262,23262,4814,23262,4127
38064,4908,14893,36287,1777,36287,1777,2.98203e+18,94.1634,17348.6,38064,7141,111,23171,23171,12708,15158,10044
33752,1,13,32777,975,33735,17,1.57758e+14,10.3083,546.578,33752,12,12,7439,7439,7439,7439,7439
24946,434,852,0,24946,24234,712,3.56042e+16,146.587,2624.95,24946,118,26,24094,23903,20335,20733,15604
28788,1,14,27964,824,28710,78,1.44541e+14,10.7068,534.989,28788,14,12,7063,7063,7063,7063,7063
8849,33,2067,0,8849,3104,5745,2.55499e+15,59.6481,2917.63,8849,1006,72,4793,935,1633,945,229
15350,318,652,0,15350,14915,435,3.55688e+16,20.1061,1794.05,15350,83,26,14698,14698,12721,12872,8506
17535,624,712,0,17535,17036,499,3.5546e+16,38.9652,1999.54,17535,91,26,16823,16803,16447,16514,15303
40585,13047,16318,15483,25102,0,40585,7.70051e+12,57.0623,18616.7,40585,7935,72,24267,24267,21804,23847,19018
39469,1948,9815,37211,2258,0,39469,2.1865e+18,97.5693,12849.7,39469,4763,110,29654,29654,14241,12876,6628
48496,12257,12610,45753,2743,45753,2743,5.49321e+18,98.0276,16064.5,48496,5985,111,35886,35886,35886,35886,35213
12507,2666,3028,0,12507,0,12507,6.43787e+17,96.9167,4300.82,12507,1442,110,9479,9479,9034,9118,8746
29599,4452,17023,12190,17409,0,29599,5.48026e+12,54.5679,18386.1,29599,8288,72,12576,12576,9139,11989,5227
35263,680,1733,0,35263,34218,1045,4.65658e+16,304.586,5475.46,35263,294,26,33530,32284,30671,27606,17520
31139,153,176,31120,19,31139,0,5.99183e+18,170.609,2116.62,31139,162,167,30558,29696,27187,27081,26994
45679,6673,10700,0,45679,0,45679,6.4738e+17,97.8837,14162.9,45679,5188,110,34979,34979,30443,27957,22889
10982,870,2737,10348,634,10348,634,2.10825e+18,97.1845,3869.85,10982,1271,111,8245,8245,5482,6676,3045
27566,10,15,26754,812,27475,91,1.78293e+14,10.396,559.721,27566,13,12,27482,27365,26332,24996,19976
41358,2637,9716,38956,2402,0,41358,2.22499e+18,97.8236,12915.3,41358,4710,110,31642,31642,18206,16755,10084
38592,98,176,38514,78,38592,0,5.98085e+18,169.686,2326.18,38592,167,171,34334,21428,19986,21124,21904
43655,8628,20209,0,43655,0,43655,4.53876e+17,94.2133,22738.7,43655,9817,110,23446,23446,18001,13083,12633
38703,16,19,37527,1176,38584,119,2.11163e+14,10.4984,756.083,38703,15,13,38684,38684,38532,38532,37397
17680,26,32,17616,64,17680,0,1.11637e+18,31.9421,752.17,17680,32,32,14234,0,11042,13792,14234
25160,2298,10962,24080,1080,0,25160,1.648e+18,94.4223,12685.3,25160,5306,110,14198,14198,9014,7755,3743
32574,239,16548,31344,1230,31344,1230,3.31666e+18,90.0984,18405.8,32574,7960,111,16026,14721,0,7218,0
5010,1,1,4853,157,5010,0,0,0.9998,70.7814,5010,1,1,5009,5009,5009,5009,5009
2961,365,779,2790,171,2790,171,5.86938e+18,93.1979,1218.65,2961,357,68,2182,2182,2082,2082,1257
47456,5301,13871,44903,2553,0,47456,2.05884e+18,96.9616,17221.2,47456,6738,110,33585,33585,24117,21677,13184
49292,16294,21002,47142,2150,47142,2150,2.81553e+18,94.7132,23932.7,49292,10213,110,28290,28290,24498,25966,23432
9353,476,526,0,9353,9084,269,3.90219e+16,19.8954,1370.96,9353,72,26,8827,8827,8731,8741,8100
41635,6241,13024,39458,2177,39458,2177,3.15691e+18,96.6031,15976.2,41635,6314,110,28611,28611,19341,23080,15583
35847,1,14,34814,1033,35766,81,1.50235e+14,10.5448,609.103,35847,13,12,8409,8409,8409,8409,8409
4138,75,186,0,4138,4020,118,3.54193e+16,19.6999,546.003,4138,42,26,3952,3952,3229,3257,2047
29916,9753,9937,0,29916,0,29916,5.65561e+17,95.9175,12174.1,29916,4814,110,19979,19979,19761,19662,19708
40827,4295,10362,0,40827,14504,26323,2.46546e+15,59.7288,13121.7,40827,5048,72,30465,30465,22250,17122,12319
11154,2454,2656,3919,7235,0,11154,9.89755e+12,59.6672,3663.64,11154,1294,72,8498,8498,8260,8448,8032
32868,1777,7717,30958,1910,30958,1910,5.89294e+18,97.7447,10388.3,32868,3736,110,25151,25151,23381,22120,7211
25671,4134,5991,9015,16656,0,25671,9.88057e+12,59.9592,7932.24,25671,2905,72,19680,19680,16961,19210,13772
23385,6116,7749,0,23385,8622,14763,2.20801e+15,58.3765,9364.16,23385,3765,72,15636,15636,14056,14111,12290
29743,7750,8016,28076,1667,28076,1667,6.18435e+18,97.7335,10353.3,29743,3804,111,21727,21727,21695,21625,21279
36651,11841,36651,36651,0,36651,0,34358800000,0,36651,36651,36651,1,0,0,0,0,0
14363,829,3392,5059,9304,0,14363,9.89373e+12,59.8186,4619.43,14363,1647,72,10971,10971,7290,10333,2937
4723,313,1239,4451,272,4451,272,6.03384e+18,94.9365,1851.51,4723,582,84,3484,3484,3234,3032,1268
38872,11284,14474,37015,1857,0,38872,1.82785e+18,95.6395,17081.9,38872,7027,110,24398,24398,21618,21066,18745
3041,151,1474,2913,128,2913,128,9.12526e+18,79.289,1820.08,3041,693,70,1567,1481,0,1213,0
19037,5634,5966,19037,0,17929,1108,4.21699e+18,146.447,7153.84,19037,2281,121,13071,13071,12870,12973,12687
27710,239,13593,0,27710,0,27710,3.42655e+15,17.9715,14074.3,27710,12218,20,14117,14117,877,7115,287
16727,168,759,0,16727,16249,478,3.75043e+16,86.6128,2106.18,16727,100,26,15968,15894,13563,13377,5092
49854,9982,21144,19208,30646,0,49854,7.42703e+12,57.0578,23777.6,49854,10300,72,28710,28710,22288,27610,14621
44058,1101,12046,0,44058,0,44058,6.13938e+17,97.2438,15276.7,44058,5835,110,32012,32012,14925,5940,5517
29746,1616,6969,0,29746,10463,19283,2.52882e+15,59.9835,9148.33,29746,3394,72,22777,22777,11601,7759,5703
49768,10854,22283,0,49768,19378,30390,1.82307e+15,55.9594,24823.5,49768,10838,72,27485,27485,21974,18815,12773
29991,1595,7161,28241,1750,28241,1750,3.38398e+18,98.2431,9591.17,29991,3385,111,22830,22830,12192,15574,6458
11391,10,199,11384,7,11391,0,5.97948e+18,177.742,1314.81,11391,133,135,2787,388,557,474,580
3767,595,951,0,3767,0,3767,6.50083e+17,94.5506,1479.89,3767,439,78,2816,2816,2436,2265,2081
28418,2416,11007,0,28418,0,28418,5.19e+17,95.2786,13016.6,28418,5338,110,17411,17411,11098,5025,4069
42309,83,208,42222,87,42309,0,6.03927e+18,204.151,2681.75,42309,184,184,34694,20991,15860,17948,16876
23799,354,832,0,23799,23123,676,3.56216e+16,135.305,2532.23,23799,115,26,22967,22801,18851,19204,13459
18006,1986,6168,17096,910,17096,910,6.7583e+18,84.5944,7649.8,18006,2941,111,11838,11838,9498,10425,6966
26095,6088,6110,24568,1527,24568,1527,5.74194e+18,97.6855,8340.44,26095,2953,110,19985,19985,19978,19983,19985
16623,7,9,16033,590,16543,80,4.47535e+13,5.97774,354.317,16623,8,7,16614,16614,16444,16443,16399
28891,5563,6812,27209,1682,27209,1682,5.90974e+18,97.6918,9222.17,28891,3296,110,22079,22079,21766,21766,18592
33340,8,15,32368,972,33283,57,1.65812e+14,10.5392,613.65,33340,13,11,32688,32137,26657,26298,22466
16076,443,5390,11101,4975,15256,820,3.5463e+18,96.0154,6762.59,16076,2545,111,10686,10425,5738,5519,1617
39126,4573,9150,0,39126,0,39126,6.48638e+17,97.8112,12215.5,39126,4433,110,29976,29976,23745,18716,16124
18525,2560,4379,0,18525,0,18525,6.48934e+17,97.4171,6095.16,18525,2111,110,14146,14146,12166,10022,9086
27162,166,208,27143,19,27162,0,6.00071e+18,194.549,2106.17,27162,172,167,26509,25422,21828,22236,21952
6913,7,8,6348,565,6913,0,1.14659e+14,7.85954,202.134,6913,8,8,6889,6889,6672,6672,6600
6153,134,1461,2160,3993,0,6153,9.93735e+12,59.2899,2108.5,6153,705,72,4692,4692,1467,3785,504
18151,4909,10313,17551,600,0,18151,1.26761e+18,92.1604,11422.1,18151,4999,110,7838,7752,7642,7588,7722
24036,3679,12672,23157,879,23157,879,4.6026e+18,93.7198,14103.1,24036,6112,111,11364,11364,4565,6010,3275
47284,154,176,47264,20,47284,0,5.98124e+18,169.698,2573.29,47284,170,172,46535,45240,41920,42073,41810
24632,3270,11722,0,24632,9706,14926,1.72996e+15,41.5555,13116.4,24632,5688,72,12910,12910,11481,10380,9898
24212,731,6582,8675,15537,0,24212,9.40007e+12,56.9463,8362.73,24212,3200,72,17630,17630,4488,360,0
6511,809,1577,6131,380,6131,380,5.66129e+18,96.1063,2369.51,6511,746,95,4934,4934,4462,4397,2960
11559,215,2791,0,11559,0,11559,6.45209e+17,96.919,3994.9,11559,1332,110,8768,8726,2922,1134,1305
19985,31,208,19976,9,19985,0,5.9977e+18,199.105,1801.13,19985,154,157,10166,2777,3068,3420,2955
11244,229,328,0,11244,10846,398,1.14841e+16,7.92058,1788.91,11244,88,10,10916,10916,10730,10853,9774
30440,12,14,29570,870,30362,78,1.39018e+14,10.7444,540.292,30440,13,12,30425,30420,29663,29663,28818
1888,31,93,0,1888,1836,52,3.52655e+16,19.178,282.295,1888,31,26,1795,1795,1563,1581,904
29865,13185,13902,28637,1228,28637,1228,5.32218e+18,94.0427,15751,29865,6678,111,15963,15963,15963,15963,14538
33083,5,13,32119,964,33058,25,1.61025e+14,10.3312,543.826,33083,12,12,30542,27427,26535,26620,17011
13395,1585,6617,12873,522,12873,522,3.96597e+18,93.6497,7600.52,13395,3168,110,6778,6691,4688,5080,2384
3170,118,158,0,3170,3081,89,3.62789e+16,19.4356,456.334,3170,39,26,3012,3012,2928,2937,2562
14322,1316,4265,0,14322,5183,9139,2.32504e+15,58.7912,5412.47,14322,2071,72,10057,10057,7085,5316,3607
25453,5553,25453,25453,0,0,25453,134212000,0,25453,25453,25453,1,0,0,0,0,0
24544,2516,12402,0,24544,5361,19183,1.34303e+13,8.89602,12721.8,24544,11154,11,12142,12142,4761,12142,3966
3405,351,1211,3405,0,3206,199,2.95275e+18,89.3081,1576.45,3405,427,76,2194,2194,1275,1583,942
18232,758,858,0,18232,17706,526,3.96451e+16,150.864,2449.68,18232,120,26,17374,17374,17241,17221,16489
33426,1546,7817,0,33426,11744,21682,2.52792e+15,60.0109,10217,33426,3798,72,25609,25609,16543,5793,5479
18974,15,61,18942,32,18974,0,2.33659e+18,60.6187,1025.55,18974,61,61,8377,637,1679,2394,4338
2492,93,628,0,2492,866,1626,2.54442e+15,57.925,957.548,2492,304,58,1864,1672,1084,1119,301
17734,387,743,0,17734,17225,509,3.63986e+16,71.0306,2096.96,17734,96,26,16991,16931,16019,15948,10941
27137,2762,6362,9538,17599,0,27137,9.88887e+12,59.9833,8387.43,27137,3099,72,20775,20775,15552,19875,9269
33740,490,13857,0,33740,12919,20821,1.94595e+15,56.4579,15817,33740,6734,72,19883,19391,9431,2218,1958
46539,4701,19131,44439,2100,44439,2100,4.0622e+18,95.7434,21928.7,46539,9200,111,27408,27408,20122,20780,10468
26714,1952,11967,0,26714,10396,16318,1.82839e+15,56.5758,13509.9,26714,5825,72,14747,14747,9209,8056,5269
4069,65,176,4037,32,4069,0,6.09881e+18,150.395,787.445,4069,88,91,3052,2025,1435,1512,1508
24808,3138,7862,23518,1290,23518,1290,3.07229e+18,96.3411,9831.41,24808,3809,110,16946,16946,13245,14793,6640
38886,8629,9092,36623,2263,0,38886,2.22924e+18,97.8165,12143,38886,4398,110,29794,29794,29300,29131,28761
41123,4567,10369,38763,2360,38763,2360,5.35531e+18,98.1315,13424.7,41123,4914,111,30754,30754,19917,22266,14251
45964,14525,17498,43796,2168,43796,2168,8.0413e+18,95.5664,20436.8,45964,8506,110,28466,28466,28098,28098,24413
32251,2,12,31331,920,32236,15,1.38586e+14,10.402,509.624,32251,12,11,18665,13207,12882,13730,10725
10801,244,2560,10171,630,0,10801,2.23801e+18,96.9576,3708.94,10801,1218,110,8241,8241,5088,4380,1383
10816,3093,3653,0,10816,0,10816,5.66023e+17,95.3221,4685.74,10816,1758,110,7163,7163,6433,5987,5838
12015,5569,5692,11527,488,11527,488,2.63747e+18,93.345,6636.9,12015,2753,110,6323,6323,6136,6218,6192
29174,4893,6868,27474,1700,0,29174,2.2278e+18,97.7127,9298.86,29174,3327,110,22306,22306,20136,19275,16729
40227,8922,14733,0,40227,15095,25132,2.09331e+15,57.9606,17123.3,40227,7176,72,25494,25494,20620,16409,14877
46487,909,1655,0,46487,45138,1349,4.04597e+16,297.411,5557.99,46487,279,26,44832,44832,39870,41076,30016
13402,1843,4531,4962,8440,0,13402,8.58595e+12,57.5699,5573.31,13402,2202,72,8871,8871,6846,8522,4615
41036,3,14,39868,1168,40956,80,1.3903e+14,10.6333,633.821,41036,13,12,31345,22101,26041,25001,16071
37679,3569,16859,36082,1597,36082,1597,3.79122e+18,94.4766,19120.7,37679,8108,111,20820,20820,13928,14487,5534
9046,2,208,9040,6,9046,0,6.02047e+18,181.482,1195.99,9046,125,128,448,13,27,12,55
31171,14986,15743,6809,24362,0,31171,52455800000,8.98088,16104.6,31171,14161,11,15428,15428,14830,15428,14771
31962,10,14,31046,916,31912,50,1.45211e+14,10.648,561.747,31962,13,11,31785,31474,30510,30425,27941
18067,897,4438,17017,1050,17017,1050,4.17311e+18,97.5176,6079.43,18067,2073,111,13629,13629,6897,9086,3499
49099,5566,11447,17261,31838,0,49099,9.87634e+12,60.0725,14738,49099,5571,72,37652,37652,29044,36165,18569
12929,1037,4059,0,12929,0,12929,5.85428e+17,95.9428,5270.29,12929,1958,110,8870,8870,6455,4897,3929
32254,1391,1774,0,32254,31291,963,4.93193e+16,307.805,5512.51,32254,302,26,30480,30480,30088,30045,27471
7771,114,2690,7771,0,7321,450,3.24537e+18,91.8696,3292.89,7771,962,110,5081,1290,1743,3166,347
8421,2,12,8179,242,8414,7,1.39384e+14,10.1199,256.584,8421,12,11,4887,3475,3337,3524,2855
49440,7497,19784,49440,0,47020,2420,4.60065e+18,1210.13,22150.9,49440,5674,141,29656,28257,19664,23977,12149
30124,133,176,30060,64,30124,0,6.09057e+18,168.988,2148.92,30124,154,160,29165,27833,22947,23155,22980
48036,8811,24493,0,48036,0,48036,4.14791e+17,93.4787,27032.7,48036,11905,110,23543,23543,16272,10246,8516
23453,144,176,23440,13,23453,0,5.98361e+18,169.494,1816.26,23453,161,159,22771,21362,19375,19368,19475
6691,54,4007,6691,0,6454,237,3.96308e+18,116.548,4452.76,6691,1821,85,1681,387,855,1367,433
12390,863,3887,0,12390,0,12390,5.8694e+17,95.8105,5058.55,12390,1871,110,8503,8503,4820,3597,3357
17925,9072,11193,17405,520,17405,520,4.15048e+18,82.5215,12173.9,17925,5407,111,6732,6732,6634,6635,6726
49885,63,2095,0,49885,0,49885,3.8402e+18,15.9936,2936.25,49885,2089,17,47790,47790,21423,27499,35615
10782,8,11,10476,306,10775,7,1.38284e+14,10.5294,288.86,10782,11,11,10546,10260,9934,9935,9121
41858,3455,10309,39458,2400,39458,2400,6.0768e+18,97.661,13499.2,41858,5001,110,31549,31549,29909,29587,11597
38391,17,176,38307,84,38391,0,6.02687e+18,173.412,2394.58,38391,171,169,13839,2533,3620,3542,3497
20570,4,14,19973,597,20500,70,1.53505e+14,10.7459,457.292,20570,13,11,18057,16181,13058,13683,9082
42912,8303,10043,0,42912,15087,27825,2.52305e+15,60.0316,12985.9,42912,4878,72,32869,32869,30436,30933,27611
18064,14,208,18057,7,18064,0,6.002e+18,191.174,1701.75,18064,149,157,5656,904,1237,1352,1114
11282,83,176,11274,8,11282,0,6.04773e+18,166.279,1304.45,11282,128,130,9412,5984,5031,5301,5214
33795,7266,10433,32005,1790,32005,1790,6.45954e+18,96.9464,12907.7,33795,4978,111,23362,23362,21199,22085,16737
35523,8658,19490,34293,1230,34293,1230,2.38529e+18,92.2461,21346.6,35523,9401,111,16033,16033,12506,13657,7468
8763,1460,2093,8253,510,8253,510,5.69642e+18,96.612,3076.33,8763,1001,107,6670,6670,6288,6241,5130
27810,1352,6578,26198,1612,26198,1612,3.36073e+18,97.4327,8919.12,27810,3174,110,21232,21232,10843,15494,5617
38319,75,1734,0,38319,37192,1127,4.49432e+16,305.426,5574.81,38319,293,26,35536,35248,22944,22708,5419
2869,776,810,2708,161,2708,161,3.24108e+18,92.8428,1232.66,2869,376,66,2059,2059,2050,2057,2055
47195,8251,11058,0,47195,0,47195,6.4703e+17,97.8704,14613.7,47195,5356,110,36137,36137,33028,28359,27952
30270,6,12,29403,867,30256,14,1.45973e+14,10.1448,496.971,30270,11,12,28838,28073,25497,24948,19587
7782,2883,4424,1669,6113,0,7782,5.349e+10,8.87612,4584.47,7782,3975,11,3358,3358,2440,3358,2411
11165,5727,10437,10433,732,0,11165,1.01088e+18,3.97743,10487.1,11165,3497,9,728,728,396,397,403
41325,10484,18949,39625,1700,0,41325,1.57772e+18,94.2898,21389.5,41325,9198,110,22376,22376,18250,16058,11421
15919,1324,7423,15269,650,0,15919,1.5646e+18,89.4873,8599.75,15919,3588,110,8496,8496,5204,4337,2024
871,870,871,871,0,871,0,2.24921e+15,0,871,871,871,1,0,0,0,0,0
42484,913,24558,41116,1368,0,42484,1.23251e+18,91.7247,26613.6,42484,11940,110,17926,17160,9485,6149,2983
23464,3884,5520,0,23464,0,23464,6.47163e+17,97.5692,7576.23,23464,2665,110,17944,17944,15719,14064,13219
3186,908,1189,3026,160,3026,160,4.16402e+18,82.183,1600.96,3186,530,78,1997,1997,1731,1976,1491
23138,73,176,23129,9,23138,0,5.99364e+18,171.64,1821.53,23138,160,158,17785,10044,8484,9884,9591
26110,618,1048,0,26110,25355,755,3.93599e+16,213.872,3234.05,26110,158,26,25062,24639,23831,23780,18880
42397,8349,9855,14898,27499,0,42397,9.89512e+12,60.0694,12770.1,42397,4797,72,32542,32542,30321,32154,27774
6020,1265,1507,5670,350,5670,350,2.42962e+18,96.2076,2241.51,6020,689,93,4513,4513,4285,4446,4105
47689,156,176,47619,70,47689,0,6.06792e+18,173.662,2697.52,47689,174,172,47014,45998,42244,42381,42155
3835,1213,1547,3655,180,3655,180,2.9638e+18,90.5082,2001.11,3835,733,78,2288,2288,1692,1969,1650
28634,728,1116,0,28634,27806,828,3.94286e+16,236.106,3503.58,28634,172,26,27518,27518,25042,25283,21628
35087,4269,10985,0,35087,0,35087,5.82664e+17,96.5615,13564.8,35087,5333,110,24102,24102,18201,15455,10410
24005,1007,5627,22605,1400,22605,1400,5.86715e+18,97.6255,7722.59,24005,2721,110,18378,18378,16770,15641,4409
25653,4637,9646,0,25653,0,25653,5.29372e+17,95.4142,11532.1,25653,4675,110,16007,16007,13219,12597,9186
1947,238,684,1947,0,1829,118,5.85799e+18,88.5439,950.591,1947,245,58,1263,1263,939,1125,674
19498,103,6844,18528,970,18528,970,2.901e+18,95.8863,8399.42,19498,3257,111,12462,4897,3172,5973,748
46473,10660,14535,0,46473,16998,29475,2.26886e+15,58.8172,17406.8,46473,7081,72,31938,31938,28245,26069,23931
9574,162,176,9535,39,9574,0,6.06699e+18,161.993,1206.04,9574,117,122,9344,9214,8721,8710,8696
48275,19594,27646,46695,1580,46695,1580,4.0619e+18,91.995,29894.7,48275,13351,111,20629,20629,14637,15743,13283
11081,3023,3733,0,11081,4087,6994,2.19743e+15,58.0558,4637.22,11081,1812,72,7348,7348,6834,6109,6178
17378,4755,6412,17378,0,16451,927,5.31028e+18,134.716,7482.12,17378,2598,121,10966,10966,9789,10450,7936
20264,1182,4848,19091,1173,0,20264,2.21948e+18,97.3918,6680.35,20264,2330,110,15416,15416,10473,9663,4496
36822,745,1190,0,36822,35765,1057,3.73889e+16,264.157,3942.52,36822,183,26,35632,35632,33895,33928,26962
2281,460,1215,2191,90,0,2281,1.47866e+18,58.1333,1475.06,2281,557,57,1066,1066,1066,1066,1066
1498,82,389,527,971,0,1498,1.02022e+13,56.6829,615.768,1498,189,50,1109,941,444,911,320
32549,1549,7824,30652,1897,30652,1897,4.29229e+18,98.2619,10406.7,32549,3706,111,24725,24725,12761,16648,6432
43840,11,176,43746,94,43840,0,6.09578e+18,173.149,2590.39,43840,171,171,11928,2455,2489,2609,2440
29515,5305,15378,28435,1080,28435,1080,1.00701e+19,88.596,17092.6,29515,7456,110,14137,14137,13497,13497,6675
32967,402,10688,32967,0,31049,1918,3.56862e+18,227.705,12198.4,32967,3942,125,22279,21978,8007,14699,1548
13728,77,580,0,13728,13334,394,3.55879e+16,20.0739,1611.65,13728,78,26,13148,13148,10883,11067,3546
12983,2051,3729,12263,720,12263,720,4.20247e+18,96.688,4958.52,12983,1762,111,9254,9254,9254,9254,6755
19557,520,612,0,19557,18946,611,0.031242,0.968707,3459.22,19557,612,1,18945,18945,18945,18945,18945
11679,233,2902,11005,674,11005,674,3.25408e+18,97.2481,4087.33,11679,1354,111,8777,8777,3275,4856,1341
44427,9533,13911,16255,28172,0,44427,8.85675e+12,57.5008,16678.4,44427,6771,72,30516,30516,27616,29908,22883
44519,640,12101,42039,2480,42039,2480,2.05406e+18,97.8369,15289.8,44519,5743,111,32418,32159,13265,20218,4056
24928,10,11,22879,2049,24669,259,1.15501e+14,8.48179,417.755,24928,10,9,24917,24917,24722,24722,24750
11838,2471,2868,11151,687,0,11838,2.22036e+18,96.894,4088.9,11838,1373,110,8970,8970,8538,8387,8114
18294,627,1030,0,18294,17758,536,4.49346e+16,207.963,2955.26,18294,154,26,17264,16861,16460,16353,13136
30037,8,13,29181,856,29965,72,1.38971e+14,10.692,534.746,30037,13,12,29368,28668,26843,26899,22071
30814,3614,10000,30814,0,29022,1792,4.48671e+18,205.821,11439.4,30814,2211,132,20814,20560,13464,16276,7930
49123,23621,26984,49123,0,49123,0,2.95387e+18,17.9843,27585.2,49123,24274,20,22139,22139,19379,19296,19344
41708,30645,41708,41708,0,41708,0,8.79588e+12,0,41708,41708,41708,1,0,0,0,0,0
26960,67,176,26949,11,26960,0,5.98247e+18,169.61,1946.71,26960,159,163,19805,10814,9068,10533,10289
10818,33,274,10818,0,10818,0,5.69427e+18,131.911,779.099,10818,265,29,10365,10287,3685,5505,3557
11128,745,2663,0,11128,3919,7209,2.51381e+15,59.5837,3669.23,11128,1291,72,8465,8465,5756,2524,2584
11974,2996,3674,11337,637,0,11974,2.03351e+18,95.9331,4827.42,11974,1765,110,8300,8300,7631,7374,6846
29487,6672,12802,28217,1270,28217,1270,2.65392e+18,92.7573,14750.6,29487,6213,110,16685,16685,13910,15989,9967
29480,6,15,28608,872,29421,59,1.82157e+14,10.4735,585.939,29480,13,11,28236,27416,22579,21460,11208
29562,370,1607,0,29562,28680,882,4.83309e+16,299.536,4955.17,29562,268,26,27905,26860,20970,22002,10437
29930,452,1137,0,29930,29066,864,3.92116e+16,248.395,3599.47,29930,175,26,28793,28263,22964,23675,14527
43597,10386,26749,42314,1283,42314,1283,2.15771e+18,91.6855,28710.5,43597,12993,110,16848,16848,9403,11654,7860
42550,14926,17922,40680,1870,0,42550,1.68492e+18,94.3569,20550.8,42550,8690,110,24628,24628,22792,21862,19972
25833,13,14,25071,762,25780,53,1.75795e+14,10.5741,534.566,25833,13,11,25819,25819,25592,25593,24987
1446,9,10,1403,43,1446,0,1.70909e+14,9.23721,109.638,1446,10,10,1425,1412,1401,1402,1289
45435,14425,21649,43625,1810,0,45435,1.52527e+18,94.0499,24206.7,45435,10524,110,23786,23786,20918,19348,16274
15010,3459,3537,5284,9726,0,15010,9.901e+12,59.8256,4805.45,15010,1723,72,11473,11473,11401,11456,11381
11930,239,2882,0,11930,0,11930,6.43813e+17,96.9074,4113.31,11930,1379,110,9048,9048,3041,1262,1352
42499,10337,13454,15573,26926,0,42499,8.80903e+12,58.7408,16112.8,42499,6549,72,29045,29045,26530,28519,22426
30566,4426,7522,28816,1750,0,30566,2.1946e+18,97.5532,10018.3,30566,3633,110,23044,23044,19146,18268,14690
15631,4443,5025,0,15631,5739,9892,2.25313e+15,58.5082,6221.13,15631,2447,72,10606,10606,9862,9015,9159
15621,4301,5869,14874,747,0,15621,1.82791e+18,94.3449,7168.22,15621,2823,110,9752,9752,8462,7838,6630
41210,8206,12243,0,41210,0,41210,5.9424e+17,96.2671,15229,41210,5931,110,28967,28967,25469,24816,19753
2980,2743,2980,2980,0,2980,0,8.79314e+12,0,2980,2980,2980,1,0,0,0,0,0
45601,8876,14551,45601,0,42950,2651,4.16567e+18,318.419,16459.2,45601,4051,134,31050,30852,24892,27178,20188
37885,2983,9815,35747,2138,35747,2138,6.10035e+18,97.4409,12721.2,37885,4758,110,28070,28070,24606,24030,10624
2234,95,562,0,2234,782,1452,2.5303e+15,57.85,869.54,2234,267,57,1672,1540,997,1038,353
44778,4266,20207,44778,0,31889,12889,5.21939e+18,3163.97,23833.7,44778,7904,152,24162,19654,12352,16877,7427
8773,37,176,8706,67,8773,0,6.05031e+18,165.107,1152.11,8773,116,121,4930,1571,1678,1850,1805
28085,4066,6617,26448,1637,0,28085,2.22665e+18,97.7133,8976.55,28085,3205,110,21468,21468,18051,17329,14081
25729,288,13739,25729,0,0,25729,8.87937e+17,17.9796,14179.4,25729,12356,20,11990,11920,656,1613,337
5479,4,11,5318,161,5474,5,1.72974e+14,10.2628,217.253,5479,11,11,4811,4325,4038,2877,1962
3129,174,228,0,3129,3040,89,4.19127e+16,18.9722,577.044,3129,45,26,2901,2901,2788,2799,2210
26850,5483,15069,0,26850,5772,21078,1.36562e+13,8.9587,15378.5,26850,13555,11,11781,11781,6067,11781,5778
27751,11,14,26949,802,27674,77,1.50855e+14,10.6018,528.432,27751,13,12,27734,27725,26716,26715,25366
44481,11018,14179,44481,0,41891,2590,4.19421e+18,309.281,16052.9,44481,3825,134,30302,30302,28099,29650,24642
24925,5987,7275,9015,15910,0,24925,9.13128e+12,59.0647,9057.8,24925,3538,72,17650,17650,15756,17320,13598
19959,4,11,19389,570,19955,4,1.38897e+14,10.1234,394.647,19959,11,11,17255,15295,12820,11797,10220
30259,2518,7124,0,30259,0,30259,6.48044e+17,97.7125,9623.17,30259,3448,110,23135,23135,15553,13947,9437
42025,9,15,40795,1230,41961,64,1.70774e+14,10.3842,699.918,42025,13,11,41581,41121,35059,34964,31706
46734,15683,17613,17617,29117,0,46734,8.03194e+12,57.7878,20276.9,46734,8571,72,29121,29121,27858,28901,26484
22881,3529,9964,22881,0,21771,1110,3.91311e+18,193.648,11090.6,22881,4147,124,12917,12833,7713,9874,4741
35132,8463,11322,35132,0,33090,2042,3.52339e+18,247.234,12903.8,35132,4011,130,23810,23732,21769,22368,18628
8933,1896,2811,8453,480,8453,480,5.04056e+18,96.0952,3721.16,8933,1320,105,6122,6122,4972,5228,5116
43945,4945,11824,0,43945,0,43945,6.18043e+17,97.3382,15064.2,43945,5740,110,32121,32121,23958,19192,15666
9659,524,2367,9098,561,0,9659,2.2231e+18,96.6248,3414.17,9659,1129,110,7292,7292,4848,4588,2133
22472,4364,5253,0,22472,7891,14581,2.5331e+15,59.917,6996.14,22472,2549,72,17219,17219,16158,15966,14530
2446,609,725,0,2446,0,2446,6.21993e+17,89.4677,1094.64,2446,320,61,1721,1721,1704,1700,1721
48227,15093,15363,48227,0,45417,2810,3.90719e+18,330.915,17349.2,48227,5744,132,32864,32864,32828,32845,32604
18933,360,737,0,18933,18393,540,3.55283e+16,65.5499,2116.68,18933,96,26,18196,18144,16857,16973,10718
33537,11275,12423,0,33537,0,33537,5.34086e+17,94.2808,14753.2,33537,6028,110,21114,21114,20868,20696,20861
16420,5484,5918,15611,809,15611,809,1.89242e+18,95.9563,7269.47,16420,2815,111,10502,10502,10309,10492,10359
34557,7529,13404,0,34557,0,34557,5.19131e+17,95.3462,15735.9,34557,6506,110,21153,21153,17463,14680,13615
27431,596,1095,0,27431,26638,793,3.96552e+16,215.855,3408.86,27431,167,26,26336,25854,22988,23506,17833
16126,441,3796,5672,10454,0,16126,9.90048e+12,59.8343,5138.13,16126,1842,72,12330,12330,4543,10174,1644
21945,12,14,21297,648,21891,54,1.76388e+14,10.501,480.839,21945,13,11,21931,21930,21434,21434,19521
28080,1172,1390,0,28080,27252,828,4.51771e+16,221.019,4268.96,28080,226,26,26690,26690,25937,25945,22135
36152,7366,11528,0,36152,0,36152,5.75776e+17,95.6506,14156.7,36152,5583,110,24624,24624,20801,18234,16516
26335,53,880,0,26335,25582,753,3.55979e+16,159.371,2743.66,26335,124,26,25261,25233,16002,15832,5311
37864,15958,17014,37864,0,36121,1743,4.5918e+18,437.246,18674.4,37864,7186,137,20850,20850,20737,20753,20275
40229,5340,12857,40229,0,37881,2348,3.8055e+18,285.42,14601.9,40229,4252,133,27372,27236,19537,21919,12465
7122,2289,3962,0,7122,0,7122,3.80374e+17,86.8319,4534.46,7122,1906,90,3160,3160,2523,2231,1768
47363,800,11368,44613,2750,44613,2750,5.04801e+18,98.3217,14831.8,47363,5380,111,35995,35995,15769,22927,4518
24075,97,176,24016,59,24075,0,6.17676e+18,165.147,1905.02,24075,141,145,21834,17510,13137,13438,13720
42728,296,16248,0,42728,0,42728,5.23639e+17,93.2914,19029.7,42728,7875,110,26480,25672,10339,686,1181
34441,5232,32189,10717,23724,0,34441,9.20695e+12,3.98862,32280,34441,10752,9,2252,2252,363,2252,370
7031,1436,3421,6751,280,6751,280,9.30496e+18,84.0839,4054.39,7031,1645,90,3610,3610,3034,2938,1108
42603,7710,9937,0,42603,0,42603,6.47968e+17,97.8641,13218.6,42603,4816,110,32666,32666,29683,28138,26284
17157,1002,5430,0,17157,0,17157,5.80131e+17,96.087,6920.88,17157,2621,110,11727,11727,7268,2040,2110
18468,4238,4343,0,18468,6484,11984,2.52708e+15,59.8661,5837.26,18468,2107,72,14125,14125,14023,14011,13963
8063,1482,4585,0,8063,0,8063,3.72745e+17,75.3976,5201.73,8063,2193,88,3478,3478,2167,1084,1348
44198,11284,12899,41805,2393,41805,2393,3.57059e+18,97.5224,16000.8,44198,6139,111,31299,31299,31299,31299,26865
1853,154,162,0,1853,1798,55,4.48756e+16,18.3815,399.862,1853,39,26,1691,1691,1677,1679,1655
25472,6118,10968,24360,1112,24360,1112,3.25401e+18,89.2757,12689.3,25472,5258,111,14504,14504,11372,11819,10233
32565,11985,13883,0,32565,0,32565,4.85382e+17,93.3461,16006.5,32565,6722,110,18682,18682,17872,17420,17310
24792,172,176,24779,13,24792,0,6.0177e+18,170.636,1918.14,24792,154,164,24603,24591,23934,24001,24071
7222,2080,4062,7222,0,6942,280,3.91087e+18,116.142,4530.17,7222,1767,99,3160,3122,1821,2397,1238
13611,116,480,0,13611,13373,238,2.55757e+16,3.73198,1872.16,13611,242,4,13131,13131,11816,11749,7144
5834,53,176,5833,1,5834,0,6.02359e+18,148.889,934.33,5834,105,103,3883,2110,1608,1754,1779
32000,14,208,31924,76,32000,0,6.06338e+18,202.351,2365.2,32000,171,172,10287,2013,2317,2447,1938
13570,34,170,13567,3,13570,0,5.97021e+18,164.128,1372.36,13570,141,139,7214,2195,2325,2932,2673
6546,1770,3137,6283,263,0,6546,1.55175e+18,89.4814,3741.93,6546,1490,92,3409,3409,3126,2968,2913
24674,3352,7002,23331,1343,23331,1343,3.16204e+18,96.8061,9034.71,24674,3377,110,17672,17672,14639,16387,9181
35891,971,11617,35891,0,33802,2089,5.34732e+18,253.509,13220.9,35891,4138,132,24274,23908,10747,16827,2748
26474,5,8,26035,439,26410,64,9.83897e+13,3.99736,413.459,26474,6,4,26466,26466,25845,25845,21666
6364,234,422,6364,0,6105,259,2.45478e+18,17.8507,722.744,6364,269,21,5942,5942,5142,5127,3997
2580,506,689,0,2580,0,2580,6.47196e+17,92.4318,1083.9,2580,308,64,1891,1891,1721,1687,1650
39544,5458,16406,0,39544,15178,24366,1.9352e+15,56.7212,18615.8,39544,7986,72,23138,23138,15621,15219,6391
4268,351,2027,4088,180,4088,180,9.11002e+18,90.7964,2472.24,4268,970,70,2241,2074,542,2036,1077
44192,20423,25918,18292,25900,0,44192,5.33285e+12,54.4456,27745.5,44192,12621,72,18274,18274,16813,17965,14538
39414,2701,13835,39414,0,37282,2132,4.37858e+18,268.883,15774.5,39414,5716,129,25579,25086,14495,19055,5657
5824,358,1786,0,5824,2112,3712,2.32682e+15,58.1111,2363.43,5824,864,72,4038,3990,2672,1076,1200
39870,8451,9547,37548,2322,37548,2322,1.19739e+18,98.3013,12570.6,39870,4518,111,30323,30323,30323,30323,27455
43956,706,1199,0,43956,42701,1255,3.55223e+16,247.793,4159.25,43956,188,26,42757,42757,37140,37994,30493
30198,8342,13025,11677,18521,0,30198,7.33999e+12,56.8772,14766.9,30198,6340,72,17173,17173,13140,16476,8386
22397,11,12,21758,639,22383,14,1.38733e+14,10.45,423.849,22397,12,11,22385,22385,22044,22045,21817
20415,3,12,19831,584,20401,14,1.41985e+14,10.4415,407.938,20415,12,11,15511,11095,12630,12274,8055
11929,105,208,11916,13,11929,0,6.09863e+18,189.94,1455.65,11929,126,131,10655,7942,6011,6158,5884
31322,1023,1274,0,31322,30412,910,4.10302e+16,267.413,4034.18,31322,203,26,30048,30048,29557,29553,27270
5224,645,1255,1840,3384,0,5224,9.86288e+12,59.0069,1827.21,5224,606,72,3969,3969,3095,3816,2200
14074,3229,5162,14074,0,13319,755,3.39339e+18,125.56,6094.49,14074,2071,121,8912,8861,6983,7665,5549
2023,707,1030,0,2023,801,1222,1.71941e+15,53.3253,1240.15,2023,496,53,993,946,719,329,464
14113,2707,3342,0,14113,4966,9147,2.52637e+15,59.7209,4550.25,14113,1619,72,10771,10771,10120,9742,9183
47591,58,206,47509,82,47591,0,5.98321e+18,193.716,2672.43,47591,184,180,32496,16907,12513,15182,13491
40000,1036,2075,0,40000,38806,1194,4.88695e+16,317.594,6606.18,40000,361,26,37925,37925,33668,34704,21078
27275,4062,6435,0,27275,0,27275,6.48536e+17,97.6873,8740.5,27275,3116,110,20840,20840,18209,15908,14011
31787,7774,13446,0,31787,12229,19558,1.90594e+15,56.7403,15282.3,31787,6529,72,18341,18341,14924,12871,10916
31329,163,176,31275,54,31329,0,6.09182e+18,170.885,2190.19,31329,158,162,30976,30621,28998,28878,29095
43164,698,17026,43164,0,29794,13370,4.42634e+18,379.767,18855.9,43164,4550,139,26138,25061,12519,17411,2407
40534,10380,11493,14618,25916,0,40534,9.24643e+12,59.2721,14149.4,40534,5599,72,29041,29041,27779,28773,25840
20339,4266,4862,19159,1180,0,20339,2.22012e+18,97.4071,6696.74,20339,2341,110,15477,15477,14787,14696,14288
36290,2335,11945,0,36290,0,36290,5.67449e+17,95.8761,14551.3,36290,5788,110,24345,24345,16098,9006,6331
10504,64,176,10496,8,10504,0,6.03753e+18,165.54,1262.1,10504,126,124,7790,4861,3561,3944,3880
6392,5,11,6210,182,6391,1,1.43115e+14,10.4291,226.799,6392,11,11,5820,5151,4247,4385,3632
35529,132,176,35460,69,35529,0,6.1456e+18,173.319,2330.05,35529,160,163,34216,32128,26691,26643,26724
11375,2659,2801,10716,659,0,11375,2.20962e+18,96.3669,3981.84,11375,1328,110,8574,8574,8499,8504,8529
2427,157,612,0,2427,856,1571,2.50851e+15,57.8859,938.386,2427,287,57,1815,1815,908,709,580
11243,1981,4261,4226,7017,0,11243,8.00714e+12,57.216,5132.53,11243,2053,72,6982,6982,5524,6732,3970
23393,5402,7981,22222,1171,0,23393,1.92323e+18,95.8583,9813.38,23393,3854,110,15412,15412,14212,13544,12520
45787,25470,25752,0,45787,0,45787,3.70944e+17,91.1179,27991,45787,12521,110,20035,20035,19733,19615,19503
23755,8,11,23076,679,23741,14,1.38682e+14,10.1789,431.163,23755,11,11,23168,22858,17710,17848,18437
35808,5076,16311,34315,1493,34315,1493,2.24124e+18,94.5416,18462.6,35808,7842,111,19497,19497,14539,13336,6985
34260,6284,18336,13870,20390,0,34260,5.99878e+12,53.7934,19980.3,34260,8910,72,15924,15924,11709,15204,6778
11753,1818,4389,11190,563,11190,563,7.70827e+18,93.2554,5445.83,11753,2108,110,7364,7364,6632,6522,4033
22426,6468,9721,21456,970,21456,970,2.79432e+18,94.4443,11305.5,22426,4710,110,12705,12705,8877,10442,7527
12035,45,176,11996,39,12035,0,6.03725e+18,164.667,1342.78,12035,130,133,7482,3223,2738,3238,3079
14782,5430,5734,14092,690,0,14782,1.79316e+18,94.8093,6965.47,14782,2760,110,9048,9048,8681,8644,8478
16944,441,7224,16203,741,0,16944,1.68015e+18,94.2897,8521.74,16944,3493,110,9720,9295,4686,3019,1762
44972,199,10524,0,44972,0,44972,6.48474e+17,97.9007,13943.9,44972,5108,110,34448,34241,9713,1108,2839
1531,186,498,1441,90,0,1531,2.17785e+18,88.7381,751.151,1531,223,53,1033,958,712,600,620
17280,1006,4086,16271,1009,0,17280,2.23099e+18,97.4626,5713.96,17280,1970,110,13194,13194,9036,8452,4101
6748,3452,3728,6748,0,6488,260,5.88494e+18,106.389,4203.78,6748,1639,89,3020,3020,2890,2981,2747
34693,10134,11857,32953,1740,32953,1740,7.33154e+18,83.9172,14332.9,34693,5750,110,22836,22836,22836,22836,22836
16732,143,176,16720,12,16732,0,6.00853e+18,170.033,1572.4,16732,149,145,16195,15159,13568,13651,13450
27133,4035,6350,25551,1582,25551,1582,5.73153e+18,97.6798,8650.87,27133,3063,110,20783,20783,19358,19135,13875
45327,11,14,44033,1294,45244,83,1.38747e+14,10.5283,657.666,45327,13,12,45312,45307,42879,42934,42257
31350,72,176,31276,74,31350,0,5.97923e+18,169.587,2097.73,31350,164,166,23956,13352,11500,13221,13032
49383,26,176,49301,82,49383,0,5.98739e+18,173.517,2655.01,49383,175,174,22760,5233,6606,7309,7210
11777,1780,3871,11170,607,11170,607,2.97619e+18,93.722,4983.8,11777,1860,110,7906,7906,6850,7581,5477
43489,7,14,42247,1242,43410,79,1.42048e+14,10.4406,637.837,43489,13,12,41979,40988,32281,32340,31086
16278,3554,9349,15748,530,0,16278,1.2527e+18,91.7889,10362,16278,4519,110,6929,6929,5109,4575,3416
40754,3833,16491,38894,1860,38894,1860,1.79986e+18,95.815,19037.5,40754,7921,111,24263,24263,23163,24110,6847
8155,2839,3937,7825,330,7825,330,5.43869e+18,83.8542,4637.46,8155,1867,98,4218,4218,4083,4218,3522
6514,61,284,0,6514,6330,184,3.53872e+16,19.9154,815.033,6514,50,26,6230,6230,5322,5387,2146
45235,9522,22310,0,45235,17982,27253,1.67256e+15,55.3478,24506.9,45235,10858,72,22925,22925,17285,15157,9010
41340,5173,11506,39070,2270,39070,2270,3.10409e+18,97.1107,14557,41340,5578,110,29834,29834,24521,27503,14990
49987,18080,18551,47599,2388,47599,2388,2.86926e+18,95.7105,21731.1,49987,9010,110,31436,31436,30983,31299,30374
39538,14432,17692,0,39538,0,39538,4.67349e+17,93.1747,20087.6,39538,8578,110,21846,21846,20196,17628,17732
34397,2451,11088,34397,0,32397,2000,5.23526e+18,242.489,12647,34397,3388,131,23309,22972,14398,18777,6248
33346,490,1228,0,33346,32381,965,3.93264e+16,273.171,3957.84,33346,192,26,32118,31475,29293,27733,20410
14866,1969,3552,14003,863,14003,863,3.36691e+18,97.1787,5004.26,14866,1709,110,11314,11314,8214,9604,7037
17613,11,175,17606,7,17613,0,5.98589e+18,165.721,1571.69,17613,152,151,4650,732,973,1002,1039
25299,551,8897,0,25299,0,25299,5.49976e+17,94.3651,10819.6,25299,4310,110,16402,16058,9471,4041,1500
7724,337,1819,2706,5018,0,7724,9.89555e+12,59.5123,2587.45,7724,879,72,5905,5905,2563,4989,1198
35906,118,176,35818,88,35906,0,6.13441e+18,172.544,2345.6,35906,160,166,33823,30872,23446,23943,24251
6903,2845,3978,0,6903,2844,4059,1.42773e+15,54.0588,4435.56,6903,1932,72,2925,2925,2540,2071,2312
47411,179,1271,0,47411,46060,1351,3.55706e+16,260.836,4452.1,47411,202,26,45757,45449,37375,37889,13269
34712,8456,10580,34712,0,32691,2021,3.40302e+18,244.2,12396,34712,4135,128,24132,24060,22361,22835,20109
37428,206,8721,13155,24273,0,37428,9.89274e+12,60.041,11351.7,37428,4242,72,28707,28707,7446,22776,1062
35380,3954,8247,12436,22944,0,35380,9.88938e+12,60.0409,10761.3,35380,4011,72,27133,27133,21806,25981,13338
48486,2,14,47102,1384,48406,80,1.38932e+14,10.5356,687.668,48486,13,12,28088,19904,19224,20091,15049
827,176,354,827,0,777,50,3.02268e+18,76.3313,486.708,827,120,40,473,473,310,374,365
9703,1954,2338,0,9703,3409,6294,2.50955e+15,59.5157,3244.08,9703,1133,72,7365,7365,6901,6801,6316
43377,5,14,42133,1244,43294,83,1.47301e+14,10.5077,659.709,43377,13,12,40016,35902,29329,29486,20088
43563,62,176,43484,79,43563,0,6.17293e+18,173.308,2567.58,43563,164,166,34434,24567,15335,15498,15159
2241,168,607,2111,130,2111,130,3.42248e+18,91.7126,964.465,2241,265,61,1634,1634,803,1177,639
43163,12019,14313,40972,2191,40972,2191,7.18558e+18,96.303,17287.1,43163,6940,110,28850,28850,28038,27912,25116
40949,527,1152,0,40949,39779,1170,3.55951e+16,241.175,3938.12,40949,179,26,39797,39249,32553,33436,23626
9563,916,2565,3414,6149,0,9563,9.58997e+12,59.1027,3431.73,9563,1249,72,6998,6998,4575,6578,1820
1397,211,548,1397,0,1315,82,5.58352e+18,83.116,747.074,1397,186,51,849,849,614,740,486
37658,803,1086,0,37658,36584,1074,3.55409e+16,225.808,3658.61,37658,166,26,36572,36572,35463,35542,30651
37410,2632,8782,0,37410,13163,24247,2.5222e+15,60.0031,11410.6,37410,4262,72,28628,28628,19752,8516,8935
44429,3604,11181,0,44429,15769,28660,2.47273e+15,59.7794,14147.6,44429,5447,72,33248,33248,21989,16941,12256
5538,5,11,5380,158,5534,4,1.38247e+14,10.6423,209.305,5538,11,11,5036,4471,4527,4631,3117
40191,4872,17749,0,40191,15616,24575,1.84457e+15,55.9994,19906.2,40191,8641,72,22442,22442,14821,5232,5731
11968,246,3178,0,11968,4268,7700,2.43418e+15,59.2441,4214.23,11968,1542,72,8790,8742,5197,723,938
19060,12,14,18500,560,18982,78,1.68235e+14,10.6453,452.872,19060,13,12,19045,19040,18845,18838,18265
27298,1854,6445,25710,1588,25710,1588,3.35988e+18,97.6743,8752.83,27298,3115,110,20853,20853,11574,15784,6986
36922,7339,11848,35012,1910,35012,1910,7.18557e+18,96.4008,14510.1,36922,5754,110,25074,25074,24284,24284,15790
8801,56,176,8759,42,8801,0,6.1225e+18,128.266,1160.93,8801,107,108,6631,4373,2737,2867,2877
41521,6675,11811,39261,2260,39261,2260,3.16373e+18,97.0882,14854.7,41521,5737,110,29710,29710,25214,28414,16701
14003,510,3461,4954,9049,0,14003,9.78391e+12,59.6158,4647.01,14003,1684,72,10542,10542,6451,9832,1593
49867,9443,14625,47187,2680,0,49867,2.05549e+18,96.9655,18107.1,49867,7106,110,35242,35242,30010,28925,24075
19209,3714,7218,7233,11976,0,19209,8.04659e+12,57.6269,8534.51,19209,3500,72,11991,11991,9483,11561,6575
20407,3588,6733,20407,0,19218,1189,5.4951e+18,151.398,7831.11,20407,1770,125,13674,13573,11758,13114,7815
2646,237,714,2486,160,2486,160,3.53556e+18,93.494,1112.3,2646,315,66,1932,1932,1204,1531,903
14407,7894,8971,14407,0,13967,440,4.40582e+18,213.868,9750.58,14407,4223,114,5436,5432,5048,5264,4703
23204,395,11351,22296,908,0,23204,1.49548e+18,92.604,12854.2,23204,5505,110,11853,11079,4680,2979,1294
19263,194,829,0,19263,18709,554,3.80656e+16,139.562,2394.46,19263,112,26,18434,18271,16012,15858,7966
15495,5454,6808,14833,662,0,15495,1.64488e+18,94.0037,8001.33,15495,3285,110,8687,8687,7946,7790,7492
17970,5935,7101,0,17970,6822,11148,2.00825e+15,57.3333,8317.65,17970,3458,72,10869,10869,9878,9307,8905
39158,9712,15167,37330,1828,37330,1828,8.00636e+18,95.4174,17738.1,39158,7360,110,23991,23991,23952,23944,23957
17757,2952,4215,0,17757,0,17757,6.45683e+17,97.3381,5877.65,17757,2023,110,13542,13542,12113,11269,10024
10130,2353,2433,0,10130,3568,6562,2.51817e+15,59.5649,3368.1,10130,1180,72,7697,7697,7593,7542,7581
10953,3997,5835,0,10953,2375,8578,1.35403e+13,8.86387,6038.59,10953,5248,11,5118,5118,3883,3988,3798
790,34,709,0,790,0,790,1.52985e+17,10.481,739.639,790,305,37,57,9,16,17,21
17581,393,1140,0,17581,17057,524,4.91587e+16,238.266,3239.71,17581,174,26,16441,15907,12938,13538,6935
47510,14887,16444,47510,0,44862,2648,4.13192e+18,320.777,18378.9,47510,5652,137,31066,31054,30248,30922,28522
26840,1016,6279,0,26840,0,26840,6.48699e+17,97.6925,8563.27,26840,3034,110,20561,20561,9172,5620,4553
40383,954,10336,38102,2281,0,40383,2.16435e+18,97.3239,13408.1,40383,4995,110,30047,30047,18765,16751,4878
12171,773,3612,11518,653,11518,653,3.08321e+18,94.2628,4791.92,12171,1728,110,8559,8559,5241,6618,2709
22962,2420,5385,21622,1340,0,22962,2.2316e+18,97.6316,7410.86,22962,2601,110,17577,17577,13629,12398,8597
18411,3111,4355,17336,1075,17336,1075,5.74206e+18,97.4537,6058.97,18411,2097,110,14056,14056,13345,13236,10801
23613,5058,7742,23613,0,22237,1376,3.74809e+18,162.288,8947.24,23613,2415,129,15871,15871,13887,14539,10800
33447,5329,9844,33447,0,33447,0,2.53372e+18,3292.81,13101.9,33447,7378,25,22366,17057,15303,13057,13035
32820,506,998,0,32820,31885,935,3.55634e+16,202.286,3271.5,32820,148,26,31822,31460,29227,29452,20107
10207,2070,3436,10207,0,9610,597,3.05481e+18,92.2733,4148.04,10207,1219,120,6771,6771,5326,5866,4517
10932,10680,10932,10932,0,0,10932,7.99927,0,10932,10932,10932,1,0,0,0,0,0
42801,10,17,41539,1262,42698,103,1.76069e+14,10.4432,708.175,42801,14,13,42659,42461,40801,37990,29432
26187,16,176,26180,7,26187,0,5.98269e+18,169.789,1918.85,26187,158,163,8951,1487,1932,2276,2259
19168,1799,4477,6742,12426,0,19168,9.92405e+12,59.9525,6017.11,19168,2180,72,14691,14691,10347,13619,6001
17981,3261,6063,0,17981,0,17981,5.63332e+17,94.3034,7573.8,17981,2918,110,11918,11918,9614,8220,7223
6664,1444,6664,6664,0,6664,0,5.0189e+15,0,6664,6664,5512,2,0,0,0,0,0
25850,422,866,0,25850,25113,737,3.55131e+16,151.083,2691.52,25850,121,26,24984,24779,20903,21334,15968
28350,665,7514,0,28350,0,28350,6.22969e+17,97.259,9819.65,28350,3642,110,20836,20754,9069,3483,3509
2312,90,107,0,2312,2245,67,3.52808e+16,19.8023,329.877,2312,33,26,2205,2205,2167,2173,2031
44105,1987,10242,0,44105,15497,28608,2.53362e+15,60.0742,13255.8,44105,4983,72,33863,33863,21824,12951,7101
6546,595,1976,6193,353,0,6546,2.0692e+18,94.1525,2724.4,6546,931,99,4570,4570,3268,3151,2034
38942,783,9155,36672,2270,36672,2270,3.23968e+18,97.8382,12199.7,38942,4435,110,29787,29787,13654,21067,4387
28370,10072,13238,11140,17230,0,28370,6.88494e+12,55.8538,14817.7,28370,6441,72,15132,15132,13607,14872,11990
22661,4845,6909,21461,1200,21461,1200,6.93663e+18,96.5145,8773.97,22661,3347,110,15752,15752,15312,15312,10772
4231,681,1084,0,4231,1493,2738,2.5346e+15,58.6786,1563.81,4231,526,70,3147,3147,2654,2074,2020
17253,546,796,0,17253,16754,499,3.84658e+16,110.398,2240.03,17253,108,26,16457,16335,14993,15185,12243
47803,727,1273,0,47803,46442,1361,3.55201e+16,260.21,4469.86,47803,203,26,46530,46530,40255,41194,32433
9281,157,392,0,9281,9017,264,3.53883e+16,20.0745,1116.47,9281,59,26,8889,8889,8114,8167,4444
23259,1409,5453,0,23259,0,23259,6.50845e+17,97.6299,7495.06,23259,2637,110,17806,17806,9898,8307,5666
14219,325,6482,5552,8667,0,14219,7.04764e+12,55.8233,7424.73,14219,3151,72,7737,7497,4486,7177,698
4074,41,1079,3836,238,0,4074,2.20409e+18,94.5876,1626.69,4074,507,81,1575,310,1001,1043,323
21834,6624,12013,21834,0,17022,4812,4.92328e+18,323.496,13097.4,21834,3703,131,9821,9602,8013,8555,6519
18628,59,176,18624,4,18628,0,5.98652e+18,167.471,1626.23,18628,154,152,12809,6718,5379,6393,6306
33806,2734,15892,0,33806,0,33806,4.4782e+17,93.8782,17947.2,33806,7708,110,17914,17914,10989,5937,4733
32705,6,11,31774,931,32693,12,1.38633e+14,10.1335,506.499,32705,11,11,31108,30149,27229,27257,21718
28198,6148,6642,0,28198,0,28198,6.47385e+17,97.7009,9012.46,28198,3211,110,21556,21556,21003,20624,20395
4253,1291,1494,4128,125,4004,249,3.95192e+18,90.2276,1914.28,4253,527,86,2759,2759,2601,2670,2624
30470,121,176,30398,72,30470,0,5.97888e+18,169.784,2068.91,30470,167,165,28632,26049,20884,21029,21296
26458,6309,7217,24995,1463,0,26458,2.11899e+18,97.0374,9386.27,26458,3493,110,19241,19241,18014,17801,16804
4219,67,188,0,4219,4098,121,3.52346e+16,19.8199,553.106,4219,42,26,4031,4031,3204,3227,1996
24497,4618,5731,0,24497,0,24497,6.49769e+17,97.6896,7860.91,24497,2772,110,18766,18766,17501,17682,15682
42095,8654,10071,39644,2451,39644,2451,3.98455e+18,98.3177,13229,42095,4753,111,32024,32024,29349,29930,28169
30867,75,176,30853,14,30867,0,6.00069e+18,173.041,2123.39,30867,168,166,24122,14074,11786,13283,12818
35345,42,176,35327,18,35345,0,6.01118e+18,172.296,2287.92,35345,169,169,21156,8050,7270,8926,8469
27700,52,1170,8081,19619,8081,19619,1.74466e+18,15.9893,1792.81,27700,1165,17,26530,26530,12045,16492,19839
3889,351,958,1366,2523,0,3889,9.75525e+12,58.4438,1415.76,3889,460,66,2931,2931,1912,2652,1177
23317,21985,23317,0,23317,0,23317,524266,0,23317,23317,23317,1,0,0,0,0,0
31866,110,176,31788,78,31866,0,6.00504e+18,171.347,2159.36,31866,167,166,29299,23719,18763,19564,20011
1422,7,11,1380,42,1417,5,1.70231e+14,9.86639,111.413,1422,11,11,1373,1351,1125,1101,969
44257,2160,11363,0,44257,0,44257,6.28773e+17,97.5184,14660.8,44257,5511,110,32894,32894,21458,11110,7309
6739,136,170,6677,62,6739,0,5.97204e+18,158.169,966.822,6739,110,115,6391,6009,5275,5406,5333
31103,4306,11389,29603,1500,29603,1500,2.91625e+18,94.1904,13603.2,31103,5517,110,19714,19714,15514,17106,8094
8904,62,175,8898,6,8904,0,5.98667e+18,161.12,1119.62,8904,120,125,6234,3375,2724,3190,3116
38387,11449,14994,36607,1780,36607,1780,8.16639e+18,95.3454,17516.7,38387,7281,110,23393,23393,23283,23283,22478
22177,7861,11860,21384,793,21384,793,4.29761e+18,93.4933,13195.2,22177,5709,111,10317,10317,7885,8450,7652
21091,2970,6224,19943,1148,19943,1148,5.04837e+18,97.1967,7972.67,21091,2957,111,14867,14867,9840,10923,7652
16434,1306,3914,15481,953,15481,953,5.76315e+18,97.2503,5479.68,16434,1877,110,12520,12520,10917,10625,4706
2814,718,751,2654,160,0,2814,2.21238e+18,92.6411,1174.23,2814,334,67,2063,2063,2057,2057,2063
22017,5,12,21386,631,22009,8,1.38737e+14,10.3745,419.352,22017,12,11,20205,18010,17838,18323,11813
40580,1680,2629,0,40580,8253,32327,1.46483e+16,11.9953,3281.81,40580,1659,14,37951,37951,31484,25666,35039
8934,314,3680,8531,403,8531,403,2.83967e+18,91.8398,4506.49,8934,1756,102,5254,5059,1735,3159,217
32933,1828,13420,31435,1498,31435,1498,3.00994e+18,95.6827,15572.3,32933,6445,111,19513,19513,10897,14110,3625
20477,3676,6480,19408,1069,0,20477,1.99632e+18,96.2385,8181.52,20477,3133,110,13997,13997,11321,10758,8382
45614,1086,1871,0,45614,44279,1335,4.34203e+16,311.828,6170.19,45614,323,26,43743,43743,40989,41648,32732
3308,1163,1561,2171,1137,3163,145,2.64104e+18,91.2388,1931.51,3308,729,63,1747,1747,1628,1742,1726
15463,628,4096,0,15463,5522,9941,2.43234e+15,59.3639,5357.42,15463,1990,72,11367,11319,7215,2027,2271
48471,391,1431,0,48471,47081,1390,3.72203e+16,274.867,4953.31,48471,234,26,47040,46156,41325,39505,21557
40580,10974,12784,38463,2117,38463,2117,6.93592e+18,96.5648,15668.4,40580,6201,110,27796,27796,26682,26511,22496
1892,385,533,1782,110,1782,110,5.6478e+18,90.0766,843.032,1892,236,54,1359,1359,1282,1275,1188
42807,3,176,42723,84,42807,0,6.00247e+18,172.786,2492.32,42807,172,171,3689,569,381,252,511
28100,10787,28100,28100,0,28100,0,8.79578e+12,0,28100,28100,28100,1,0,0,0,0,0
26525,115,176,26470,55,26525,0,6.10355e+18,172.385,2017.15,26525,153,157,24742,22408,16759,17261,17214
14458,96,176,14448,10,14458,0,6.06604e+18,169.514,1486.52,14458,134,140,12695,8953,7498,7834,7904
35530,14602,17058,35530,0,34230,1300,5.27356e+18,1938.25,19650.2,35530,7895,143,18472,17101,16495,16769,15381
13863,1142,4759,13863,0,13090,773,3.33445e+18,127.816,5700.17,13863,1880,121,9104,9056,5690,6760,2917
8164,119,208,8158,6,8164,0,6.04331e+18,190.75,1174.97,8164,119,121,7397,6715,4428,4677,4607
41961,6997,17460,16110,25851,0,41961,7.53554e+12,57.1581,19771.3,41961,8505,72,24501,24501,17647,23324,9480
38240,12,176,38161,79,38240,0,6.00834e+18,171.012,2367.43,38240,168,171,10895,1791,2181,2327,2574
28059,5084,16635,0,28059,11643,16416,1.34819e+15,51.0855,17902.5,28059,8087,72,11424,11424,7612,4849,4000
15680,37,176,15668,12,15680,0,6.06923e+18,168.72,1542.92,15680,139,139,8988,2855,3029,3515,3330
16624,1185,6506,16624,0,15744,880,3.98191e+18,137.201,7433.69,16624,2545,120,10118,10029,5254,7402,2343
23622,7249,7276,23622,0,22242,1380,3.18934e+18,162.814,8653.58,23622,2804,124,16346,16346,16346,16346,16346
41839,268,1162,0,41839,40646,1193,3.55233e+16,241.566,3993.59,41839,181,26,40555,40116,34422,34480,15962
8316,2135,2749,7886,430,7886,430,6.98936e+18,94.9854,3609.22,8316,1312,102,5567,5567,5468,5369,4605
30200,3368,7120,28448,1752,0,30200,2.22448e+18,97.6726,9617.47,30200,3437,110,23080,23080,18016,16946,11897
10610,301,455,0,10610,10308,302,3.55942e+16,20.0341,1276.73,10610,66,26,10155,10155,9810,9842,7576
46511,3697,10786,16340,30171,0,46511,9.89626e+12,60.0938,13938.6,46511,5249,72,35725,35725,25309,33925,12579
48472,5337,21004,18750,29722,0,48472,7.28862e+12,56.871,23543.9,48472,10218,72,27468,27468,16937,24022,6724
17430,4926,5956,16551,879,0,17430,1.92637e+18,95.7903,7422.16,17430,2882,110,11474,11474,10796,10525,10001
19907,7279,11429,19257,650,19257,650,8.09337e+18,88.0634,12574.5,19907,5524,111,8478,8478,8478,8478,5917
45049,3137,21610,32860,12189,43253,1796,2.56069e+18,94.6457,24087.2,45049,10412,111,23439,23439,11749,14494,4891
29003,6412,8499,27431,1572,27431,1572,1.72434e+18,97.3487,10733.2,29003,4037,111,20504,20504,18973,20399,16635
22486,569,6576,0,22486,8139,14347,2.33974e+15,57.2594,8217.95,22486,3198,72,15910,15862,8932,7848,0
8228,1980,3522,3167,5061,0,8228,7.43142e+12,56.5609,4172.76,8228,1712,72,4706,4706,3828,4556,2996
972,362,385,972,0,912,60,2.96857e+18,81.323,543.029,972,135,43,587,587,580,584,587
23668,631,11146,9302,14366,0,23668,6.81769e+12,55.9684,12507.3,23668,5408,72,12522,12186,6725,10198,1970
48217,1025,1840,0,48217,46810,1407,4.20686e+16,306.333,6146.18,48217,317,26,46377,46377,41845,43195,30900
25261,2959,12499,24289,972,0,25261,1.47749e+18,92.7797,14088.5,25261,6049,110,12762,12762,8570,7481,4432
11682,1650,2771,4111,7571,0,11682,9.88655e+12,59.747,3818.66,11682,1349,72,8911,8911,7258,8621,5396
20740,1396,5492,19580,1160,19580,1160,6.32531e+18,97.0271,7311.03,20740,2650,110,15248,15248,14337,13595,4313
673,113,253,633,40,633,40,2.14522e+18,77.1189,382.503,673,99,38,420,202,246,308,274
22968,6440,7925,21819,1149,0,22968,1.91107e+18,95.8476,9722.53,22968,3839,110,15043,15043,13578,13250,12169
33821,5160,10320,33821,0,31851,1970,3.39498e+18,233.925,12101,33821,4021,128,23501,23441,17701,19324,12483
12070,2848,2874,0,12070,4246,7824,2.53361e+15,59.621,3942.52,12070,1394,72,9196,9196,9189,9190,9188
38084,2922,8861,13388,24696,0,38084,9.90072e+12,60.0618,11532.2,38084,4310,72,29223,29223,20512,27715,9906
17475,7,12,16956,519,17455,20,1.87747e+14,10.0472,396.876,17475,11,12,17045,16725,15482,14584,12917
31858,9069,9282,0,31858,0,31858,6.00957e+17,96.8479,11734.9,31858,4503,110,22576,22576,22437,22347,22411
2020,466,566,0,2020,0,2020,6.42914e+17,90.8272,893.312,2020,248,58,1454,1454,1373,1410,1383
36078,2475,16691,34588,1490,34588,1490,4.26342e+18,93.3685,18833.2,36078,8018,111,19387,19387,7435,10922,4703
15591,1723,5695,0,15591,0,15591,5.42578e+17,94.8571,7008.63,15591,2749,110,9896,9896,6941,5034,3790
49654,43,208,49578,76,49654,0,6.09645e+18,202.771,2969.32,49654,188,184,30527,11606,10365,11786,10147
17260,230,4068,6063,11197,0,17260,9.84082e+12,59.8195,5485.1,17260,1969,72,13192,13192,7637,12232,935
40045,2761,9416,37717,2328,0,40045,2.22556e+18,97.826,12532.1,40045,4563,110,30629,30629,18299,16815,10456
36470,10811,14184,13826,22644,0,36470,7.89387e+12,57.5692,16325,36470,6910,72,22286,22286,20162,21839,16751
47496,1251,1489,0,47496,46128,1368,3.81422e+16,292.389,5098.68,47496,246,26,46007,46007,45483,45494,42363
15805,2293,3763,14885,920,0,15805,2.22792e+18,97.2783,5282.62,15805,1808,110,12042,12042,10036,9646,7843
17453,1952,5914,16573,880,16573,880,7.38482e+18,95.756,7389.81,17453,2854,110,11539,11539,10929,10929,4378
8226,1800,8226,0,8226,0,8226,524224,0,8226,8226,8226,1,0,0,0,0,0
28855,1311,6972,27177,1678,27177,1678,5.98372e+18,98.1482,9320.94,28855,3292,111,21883,21883,12510,16140,5494
1263,241,394,0,1263,0,1263,6.17202e+17,86.0245,620.507,1263,159,48,869,869,708,675,687
42443,9619,10501,40015,2428,0,42443,2.18974e+18,97.6545,13722.8,42443,5091,110,31942,31942,30942,30598,29627
37171,9680,11059,35191,1980,35191,1980,6.67585e+18,96.7734,13809,37171,5360,110,26112,26112,25536,25440,23581
11379,1751,2656,0,11379,3984,7395,2.54106e+15,59.7316,3685.11,11379,1290,72,8723,8723,7621,6267,5942
29724,5789,9139,29724,0,27994,1730,4.55815e+18,195.271,10754.8,29724,2032,130,20585,20567,18474,19889,13707
39820,18916,19255,38245,1575,38245,1575,3.0854e+18,94.5595,21495.2,39820,9275,111,20565,20565,19968,20143,19928
43725,19715,25324,42315,1410,42315,1410,2.56813e+18,91.7345,27385.1,43725,12251,111,18401,18401,16997,18320,15588
24451,160,1073,0,24451,23742,709,4.09106e+16,209.939,3259.87,24451,162,26,23148,22897,16839,16235,8444
31225,323,12430,23209,8016,29615,1610,4.72122e+18,233.025,13837.4,31225,5046,129,18795,17802,5135,11758,1171
14408,660,5491,5438,8970,0,14408,8.01609e+12,54.7222,6540.39,14408,2668,72,8917,8821,4644,288,0
8656,97,2084,0,8656,0,8656,6.44101e+17,96.3952,3056.53,8656,982,107,6188,2058,1870,332,429
11448,2407,5331,0,11448,0,11448,4.56994e+17,91.2368,6256.58,11448,2572,110,6117,6117,4527,3515,3120
28127,6340,6587,9898,18229,0,28127,9.88308e+12,60.0026,8673.09,28127,3205,72,21540,21540,21245,21472,20929
36843,7141,10829,0,36843,0,36843,5.97202e+17,96.8557,13569.2,36843,5245,110,26014,26014,21928,17891,17169
21698,394,793,0,21698,21079,619,3.56502e+16,111.518,2359.83,21698,107,26,20905,20785,19311,19393,13038
24828,1446,5884,0,24828,0,24828,6.45604e+17,97.5695,8030.37,24828,2839,110,18944,18944,12917,8340,5553
44765,5272,14402,44765,0,42173,2592,4.28032e+18,304.311,16277.5,44765,3540,134,30363,30180,19687,23600,12884
7163,1770,3094,7163,0,6801,362,3.47827e+18,91.5403,3623.43,7163,1225,98,4069,4069,2643,3187,1901
14003,759,3921,13233,770,13233,770,6.51797e+18,96.5084,5254.23,14003,1886,110,10082,9996,9479,8815,3082
26084,6776,6957,24614,1470,24614,1470,2.79318e+18,97.4199,9077.59,26084,3277,111,19127,19127,18832,18925,18867
38202,5350,16038,0,38202,0,38202,4.90974e+17,94.8791,18457.8,38202,7789,110,22164,22078,14974,10018,6590
34664,2,12,33674,990,34653,11,1.38943e+14,10.2299,526.208,34664,12,11,20067,14207,13655,14366,11811
47964,13890,16288,45560,2404,0,47964,1.92156e+18,96.2065,19488.7,47964,7912,110,31676,31676,30193,29415,28014
34680,550,1032,0,34680,33692,988,3.55488e+16,212.52,3420.88,34680,155,26,33648,33244,31095,31365,22123
36819,8177,8568,0,36819,12944,23875,2.53505e+15,60.0557,11163,36819,4174,72,28251,28251,27686,27088,27183
17657,134,175,17647,10,17657,0,5.97956e+18,165.815,1573.73,17657,145,155,16899,15857,13261,13660,13441
18223,2147,4317,17161,1062,17161,1062,5.8715e+18,97.3999,6008.43,18223,2081,110,13906,13906,13369,13372,7731
25235,5439,7406,0,25235,9144,16091,2.33615e+15,58.0059,9200.66,25235,3602,72,17829,17829,15950,15553,12942
5478,268,2313,5478,0,5200,278,3.70933e+18,86.9416,2795.69,5478,943,91,3165,3072,1324,2168,0
32087,117,176,32008,79,32087,0,5.98318e+18,169.638,2122.13,32087,163,168,29928,27083,20689,21127,21599
768,8,11,746,22,768,0,1.38172e+14,9.34505,76.5627,768,11,11,743,721,704,705,613
33750,12575,17538,33750,0,0,33750,8.84365e+17,17.981,18054.4,33750,15775,20,16212,16212,12289,13276,12231
37536,7629,8783,0,37536,0,37536,6.47954e+17,97.8009,11748.9,37536,4255,110,28753,28753,27448,25606,25546
16377,2595,3896,15427,950,0,16377,2.22455e+18,97.2816,5459.25,16377,1873,110,12481,12481,11002,10423,8799
29798,10883,11531,0,29798,0,29798,5.20477e+17,95.331,13612.5,29798,5598,110,18267,18267,17775,17734,17606
29311,48,176,29299,12,29311,0,5.98736e+18,169.45,2028.46,29311,165,163,18314,8839,6740,8429,8061
22988,126,176,22907,81,22988,0,6.12007e+18,168.304,1876.78,22988,148,147,21940,20294,16796,16840,16812
27362,7304,10323,0,27362,10320,17042,2.06051e+15,57.7318,12052.7,27362,5029,72,17039,17039,15334,14332,13446
32786,638,11959,0,32786,12281,20505,2.09544e+15,57.8354,13992.3,32786,5803,72,20827,20497,8511,2868,2164
36796,1025,2032,0,36796,35689,1107,5.03087e+16,322.302,6389.81,36796,351,26,34764,34764,32658,31605,20202
904,3,10,879,25,904,0,1.40426e+14,9.0365,82.686,904,10,10,688,486,559,595,377
16024,30,678,0,16024,15567,457,3.55746e+16,20.1181,1864.63,16024,85,26,15346,15339,9555,9465,2768
18452,8557,10023,0,18452,3987,14465,1.35966e+13,8.9871,10285.8,18452,9019,11,8429,8429,7480,7551,7425
39930,5,208,39850,80,39930,0,5.98849e+18,192.505,2483.98,39930,178,176,5718,881,599,591,861
31288,1020,1150,0,31288,30384,904,3.8804e+16,247.362,3672.53,31288,177,26,30138,30138,29869,29855,28192
22814,1859,5711,21504,1310,21504,1310,4.38182e+18,97.8571,7660.77,22814,2692,111,17103,17103,10029,11922,6624
35992,9270,13416,0,35992,13547,22445,2.07185e+15,57.0505,15583.5,35992,6530,72,22576,22576,19554,16537,16019
25081,11,14,24364,717,25003,78,1.42213e+14,10.7121,492.826,25081,13,12,25065,25059,24327,24326,23964
10186,1351,4802,4007,6179,0,10186,6.8371e+12,41.1307,5520.53,10186,2322,72,5384,5384,1293,684,0
11585,56,208,11578,7,11585,0,6.00027e+18,182.569,1385.26,11585,134,135,7766,4179,3036,3616,3221
37046,6315,9066,0,37046,13094,23952,2.4883e+15,59.8369,11645.4,37046,4400,72,27980,27980,24967,20928,20010
3092,1221,1611,3092,0,2955,137,3.99237e+18,88.6666,1897.31,3092,663,66,1481,1481,1096,1294,1206
3531,7,11,3429,102,3527,4,1.54728e+14,10.8139,170.601,3531,11,11,3411,3338,2695,2681,2559
18414,5282,6506,6868,11546,0,18414,8.37812e+12,58.0304,7812.93,18414,3167,72,11908,11908,10098,11589,8046
22494,93,175,22422,72,22494,0,5.98042e+18,166.525,1774.51,22494,154,160,19577,12154,11014,11737,11971
26584,2068,26584,0,26584,26584,0,2047.92,0,26584,26584,26584,1,0,0,0,0,0
49483,10342,14428,0,49483,0,49483,5.98369e+17,96.9892,17899.9,49483,6996,110,35055,35055,31027,28870,26401
30991,13103,14232,29702,1289,29702,1289,6.55067e+18,92.8339,16149.7,30991,6851,111,16759,16759,16759,16759,16507
36964,10,176,36876,88,36964,0,6.13509e+18,170.853,2380.3,36964,163,166,9471,1793,1894,1944,1839
10794,4784,10091,3361,7433,0,10794,9.20638e+12,3.97286,10140.2,10794,3391,9,703,703,329,703,336
14553,250,528,0,14553,14291,262,2.5772e+16,3.73105,2048.23,14553,266,4,14025,14025,13862,13712,9606
46118,18510,22598,46118,0,46118,0,4.07112e+18,17.9874,23224.3,46118,20326,20,23520,23520,19265,23520,19323
16145,104,3800,5676,10469,0,16145,9.88884e+12,59.8317,5144.16,16145,1845,72,12345,11377,6973,11415,522
47504,7160,11388,44737,2767,44737,2767,4.94685e+18,98.3572,14858,47504,5384,111,36116,36116,28055,29727,23874
12413,2391,4166,12413,0,11691,722,4.09927e+18,101.036,4965.55,12413,1130,122,8247,8238,7553,7793,5124
26349,10993,13981,25409,940,25409,940,8.04226e+18,92.9156,15533.5,26349,6782,110,12368,12368,12368,12188,8982
15032,3188,3796,0,15032,0,15032,6.36808e+17,96.9643,5238.71,15032,1826,110,11236,11236,10436,10140,9763
25585,5639,10244,0,25585,0,25585,5.09027e+17,95.0026,12066.7,25585,4969,110,15341,15341,11963,8697,8326
32254,591,9906,32254,0,30377,1877,3.56227e+18,222.944,11625.7,32254,3855,125,22348,22062,9774,14932,2090
44015,10308,23435,17802,26213,0,44015,6.0296e+12,55.302,25448.1,44015,11404,72,20580,20580,15808,19268,8429
27407,8229,10491,26117,1290,0,27407,1.80092e+18,95.3618,12457.3,27407,5092,110,16916,16916,15671,14969,13913
46556,10776,23583,0,46556,0,46556,3.43883e+15,17.988,24201.8,46556,21218,20,22973,22973,11507,18489,11099
24986,2127,5828,0,24986,8780,16206,2.52914e+15,59.9458,7727.65,24986,2831,72,19158,19158,13802,14247,7344
45580,32,176,45493,87,45580,0,6.00824e+18,173.195,2582.96,45580,173,173,23708,6613,7515,8766,8171
14482,1813,3543,13636,846,13636,846,4.18074e+18,97.6841,4933.66,14482,1660,111,10939,10939,7688,8333,6359
10280,2473,2742,3658,6622,0,10280,9.50029e+12,59.134,3663.83,10280,1329,72,7538,7538,7500,7528,7503
5805,79,176,5773,32,5805,0,6.06282e+18,155.456,935.07,5805,104,103,4693,3005,2483,2637,2702
48724,19733,20565,18748,29976,0,48724,7.45977e+12,56.4651,23155.4,48724,10001,72,28159,28159,27980,28129,27924
23888,1494,5624,8408,15480,0,23888,9.88298e+12,59.9396,7452.03,23888,2733,72,18264,18264,9955,16070,4995
3361,806,3013,0,3361,1568,1793,3.88153e+14,22.7923,3111.78,3361,1445,42,348,300,171,54,0
39940,6081,13931,0,39940,0,39940,5.51352e+17,96.0228,16670.9,39940,6762,110,26009,26009,19728,16633,12418
27648,1031,6427,9715,17933,0,27648,9.89068e+12,60.0138,8491.21,27648,3118,72,21221,21221,13350,19861,3765
40958,19,176,40873,85,40958,0,6.0471e+18,171.348,2485.22,40958,170,171,15915,3067,4293,4263,4356
1480,40,413,0,1480,519,961,2.35192e+15,55.2365,633.91,1480,186,49,861,212,306,159,111
31926,815,1202,0,31926,31003,923,3.94663e+16,244.483,3842.68,31926,188,26,30724,30724,29727,29681,25285
30806,1327,8178,0,30806,10998,19808,2.42535e+15,59.4725,10346.6,30806,3975,72,22628,22628,11477,6397,4482
1954,290,544,1841,113,1841,113,3.26198e+18,90.7544,865.614,1954,244,57,1410,1410,1169,1320,974
37077,10027,15068,37077,0,35267,1810,4.95585e+18,392.923,16936.5,37077,4187,137,22009,21903,19125,20600,14637
37655,14023,18452,14943,22712,0,37655,6.58551e+12,55.9803,20355.2,37655,8989,72,19203,19203,16178,18683,12682
33225,6137,7787,0,33225,0,33225,6.48814e+17,97.7853,10477.3,33225,3775,110,25438,25438,23186,21683,20650
43161,20122,21138,41471,1690,41471,1690,4.69737e+18,94.5005,23498.1,43161,10192,111,22023,22023,20598,20847,20523
22619,5,11,21974,645,22612,7,1.38703e+14,9.98373,417.522,22619,11,11,20829,18398,18220,17726,13231
46466,12673,16801,0,46466,17383,29083,2.10548e+15,58.0286,19505.5,46466,8179,72,29665,29665,23654,18979,16400
18836,3107,11458,18836,0,18246,590,4.82516e+18,374.722,12446,18836,5442,126,7378,7068,4091,5577,2702
39951,170,208,39874,77,39951,0,6.10749e+18,203.399,2661.01,39951,181,177,38988,37528,32915,33108,32512
7455,10,13,7241,214,7393,62,1.44608e+14,10.9461,267.048,7455,12,12,7385,7273,6824,6834,6845
20472,5496,8169,19522,950,19522,950,2.7419e+18,95.5782,9688.77,20472,3905,111,12303,12303,8070,9570,7345
24076,263,11061,24076,0,22997,1079,4.63638e+18,250.471,12357.6,24076,4935,128,12949,12241,5272,8223,32
4142,492,1484,0,4142,0,4142,5.64302e+17,88.274,1989.44,4142,687,79,2658,2627,1720,431,1012
9736,1752,3030,0,9736,3551,6185,2.30726e+15,58.4556,3869.63,9736,1476,72,6706,6706,5239,4237,2948
35743,107,176,35684,59,35743,0,6.04612e+18,173.176,2321.12,35743,166,169,32727,23911,20320,21002,21686
17409,2446,4134,16399,1010,16399,1010,5.76333e+18,97.321,5772.02,17409,1984,110,13275,13275,12239,12072,8371
4319,575,1734,1637,2682,0,4319,7.86517e+12,56.3774,2153.44,4319,838,70,2585,2537,1733,2333,1646
24655,2680,5991,23224,1431,23224,1431,1.88482e+18,98.029,8072.06,24655,2819,111,18664,18664,14186,16620,9244
38150,133,1171,0,38150,37059,1091,3.66446e+16,246.699,3918.61,38150,182,26,36625,36409,24197,23752,8091
40116,8618,21135,40116,0,40116,0,2.46745e+18,17.8823,21694.5,40116,19007,20,18981,18981,7297,18981,7359
21009,7,176,21005,4,21009,0,6.01452e+18,170.63,1755.33,21009,152,158,4024,511,665,533,697
12216,9,13,11862,354,12148,68,1.52627e+14,10.7801,340.787,12216,12,12,12042,11901,9819,9596,9295
28231,593,6657,0,28231,0,28231,6.48263e+17,97.6776,9023.02,28231,3221,110,21574,21574,7782,3452,3249
4886,9,170,4886,0,4886,0,5.97662e+18,154.38,823.74,4886,99,100,1110,132,178,179,217
30396,12624,13322,29096,1300,0,30396,1.6395e+18,94.502,15302.2,30396,6462,110,17074,17074,16314,16051,15349
1686,158,662,1686,0,1588,98,4.16973e+18,87.449,894.101,1686,249,58,1024,933,546,720,462
45860,3492,10713,0,45860,16124,29736,2.52755e+15,60.0502,13821.3,45860,5214,72,35147,35147,21827,17509,11848
44797,4041,10447,0,44797,15753,29044,2.53328e+15,60.0732,13495.3,44797,5089,72,34350,34350,25058,13364,13736
10173,129,4915,4009,6164,0,10173,6.69264e+12,55.6972,5619.37,10173,2389,72,5258,5021,3008,4868,442
42068,11,17,40823,1245,41969,99,1.8364e+14,10.4383,718.979,42068,14,13,42048,42039,40503,39702,34788
11075,1626,3942,7587,3488,10525,550,3.05703e+18,95.649,4964.43,11075,1871,111,7133,7133,5735,6667,4461
43131,958,1190,0,43131,41902,1229,3.55802e+16,248.358,4107.01,43131,186,26,41941,41941,40527,40716,37230
21721,6,12,21086,635,21706,15,1.68268e+14,10.3761,440.59,21721,12,11,20763,20151,18640,15748,12782
17415,7387,8577,16735,680,16735,680,6.99069e+18,92.5801,9771.91,17415,4105,111,8838,8838,8490,8817,8320
35050,9799,12816,33360,1690,33360,1690,7.83129e+18,94.4567,15244.9,35050,6202,110,22234,22234,21764,21764,16880
13360,1365,6904,0,13360,5363,7997,1.60563e+15,52.5897,7725.61,13360,3349,72,6456,6456,2879,1062,548
13049,2905,3203,12289,760,12289,760,2.96866e+18,97.5945,4494.34,13049,1508,111,9846,9846,9846,9846,9372
35988,75,176,35917,71,35988,0,5.98513e+18,172.4,2249.73,35988,171,168,28121,15748,13642,15585,15142
6136,3296,6136,0,6136,0,6136,524203,0,6136,6136,6136,1,0,0,0,0,0
18894,2088,4471,17794,1100,0,18894,2.22797e+18,97.4246,6211.55,18894,2153,110,14423,14423,11232,10559,7546
19434,25,175,19362,72,19434,0,5.98731e+18,166.087,1650.21,19434,148,157,8745,1937,2450,2823,2692
48118,6861,11220,16916,31202,0,48118,9.88347e+12,60.0704,14454.2,48118,5463,72,36898,36898,30552,35801,22885
42803,9694,9947,0,42803,15044,27759,2.52947e+15,60.0596,12889.6,42803,4831,72,32856,32856,32525,32152,32274
22286,288,906,0,22286,21644,642,3.82016e+16,177.512,2707.55,22286,130,26,21380,21126,16331,16457,8305
25161,196,274,25160,1,25161,0,5.6414e+18,212.055,1195.87,25161,268,31,24653,24140,24192,24562,18060
19919,293,6190,19919,0,18759,1160,4.23068e+18,150.666,7416.05,19919,1663,125,13729,13634,6980,9181,1014
43736,271,10442,41186,2550,41186,2550,3.70345e+18,98.3661,13699.3,43736,4942,111,33294,33294,13824,20842,3002
45824,721,18716,45824,0,43948,1876,4.88714e+18,2898.54,22380.4,45824,6367,146,23678,20760,10575,14321,2612
30218,611,7046,28455,1763,0,30218,2.23472e+18,97.7647,9549.43,30218,3414,110,23172,23172,8300,7027,3439
5596,5,10,5431,165,5593,3,1.62215e+14,9.58399,214.542,5596,10,10,5166,4601,3942,3944,3387
25734,4374,10468,0,25734,0,25734,5.03199e+17,94.4602,12287.8,25734,5072,110,15266,15266,11699,8857,7906
33765,7615,8021,31810,1955,31810,1955,3.36025e+18,97.6916,10739.1,33765,3877,110,25744,25744,24984,25335,24872
48963,18856,27046,48963,0,0,48963,8.92905e+17,17.9146,27643.1,48963,24326,20,21917,21917,15138,17304,14980
22834,3,14,22163,671,22766,68,1.76239e+14,10.4506,503.173,22834,13,12,17807,13619,12761,14780,7754
17622,11,12,17117,505,17612,10,1.43405e+14,10.6357,380.118,17622,12,11,17610,17610,17465,17466,17368
45131,1619,1898,43251,1880,13160,31971,1.26451e+18,16.9917,2721.78,45131,1891,18,43233,43233,41849,42124,38881
6008,94,170,6006,2,4678,1330,5.99076e+18,156.624,912.862,6008,105,110,5195,3241,3047,3239,3350
25767,158,176,25716,51,25767,0,6.07621e+18,171.17,1983.82,25767,159,154,25368,24837,23106,23093,23094
19494,138,176,19450,44,19494,0,5.99035e+18,170.13,1677.15,19494,157,153,18753,17468,15094,15357,15110
27471,22,176,27441,30,27471,0,6.17007e+18,170.796,2045.54,27471,154,151,12078,2930,3724,3612,3433
42897,5,176,42818,79,42897,0,5.98529e+18,172.187,2455.07,42897,172,172,6143,941,636,592,994
9583,919,2912,0,9583,0,9583,6.00091e+17,95.7307,3890.36,9583,1400,110,6671,6671,4884,4373,3398
12257,5,10,11910,347,12253,4,1.39073e+14,9.95741,306.378,12257,10,10,11290,9973,8048,8192,7121
10605,2,11,10293,312,10597,8,1.62727e+14,9.99557,298.634,10605,10,11,6149,4624,3714,4628,2936
42390,2441,10137,39920,2470,39920,2470,3.28026e+18,98.3185,13311.6,42390,4792,111,32253,32253,19254,22647,9639
37454,16236,17500,37454,0,36184,1270,5.32808e+18,2883.58,20814.7,37454,7880,143,19954,19926,19222,19402,17999
28065,9274,14809,6091,21974,0,28065,52828500000,8.96358,15142.4,28065,13322,11,13256,13256,9310,13256,8933
38886,8391,15113,0,38886,0,38886,5.17166e+17,95.3739,17666.8,38886,7338,110,23773,23773,17958,11578,8187
820,165,273,770,50,770,50,5.78213e+18,81.8159,432.075,820,115,39,547,547,527,527,442
35314,4762,12099,33546,1768,33546,1768,7.47574e+18,95.9741,14607.6,35314,5870,110,23215,23215,22187,22187,10886
4527,155,202,0,4527,4398,129,3.54319e+16,19.7555,590.992,4527,42,26,4325,4325,4229,4227,3698
47974,4346,11219,45176,2798,0,47974,2.22831e+18,97.921,14818.4,47974,5446,110,36755,36755,26108,23974,15861
27862,4044,6540,9796,18066,0,27862,9.87559e+12,59.9464,8606.67,27862,3177,72,21322,21322,18388,20712,13545
36087,12353,17135,0,36087,0,36087,4.44184e+17,93.1856,19281.7,36087,8306,110,18952,18952,17295,15414,14787
30869,1089,1242,0,30869,29975,894,4.06776e+16,256.525,3930.59,30869,197,26,29627,29627,29338,29332,27733
21923,4989,5302,20651,1272,20651,1272,3.72084e+18,97.9473,7208.11,21923,2493,111,16621,16621,16086,16234,16056
33614,128,10075,31824,1790,31824,1790,3.2498e+18,96.7491,12613,33614,4883,110,23539,12481,8655,14987,1934
44634,1004,14107,16353,28281,0,44634,8.82829e+12,55.3338,16875.5,44634,6866,72,30527,30527,17102,4160,0
39150,6659,13258,39150,0,36930,2220,3.72401e+18,261.742,14948.3,39150,4815,133,25892,25761,19989,21850,14217
12846,1501,5842,9529,3317,12306,540,5.35732e+18,88.6464,6850.91,12846,2780,111,7004,7004,3313,4179,2364
46241,472,10829,43551,2690,43551,2690,3.23307e+18,97.8698,14324.4,46241,5251,110,35412,35412,14993,24162,3746
13550,7,11,13156,394,13546,4,1.6849e+14,9.99653,338.594,13550,11,11,13161,12876,10668,10710,10206
49614,5433,11601,0,49614,0,49614,6.47269e+17,97.9055,15302,49614,5627,110,38013,38013,30434,25574,19121
11781,457,2842,0,11781,0,11781,6.49548e+17,97.0124,4057.71,11781,1364,110,8939,8939,3899,2384,2060
23697,4818,8710,22557,1140,0,23697,1.845e+18,94.363,10505.2,23697,4202,110,14987,14987,12662,11476,9013
40046,947,1253,0,40046,38794,1252,0.031264,0.968711,7081.33,40046,1253,1,38793,38793,38793,38793,38793
9877,3196,4992,9877,0,6508,3369,3.8181e+18,120.135,5598.8,9877,2128,109,4885,4862,3893,4339,3490
10807,5,11,10499,308,10804,3,1.39266e+14,10.3612,291.814,10807,11,11,9926,8829,7077,6881,5866
14301,675,758,0,14301,13889,412,3.95937e+16,82.3193,2028.26,14301,97,26,13543,13469,13497,13481,13212
1339,22,187,0,1339,1297,42,5.66128e+16,15.345,407.318,1339,39,21,1152,1119,667,565,225
17905,1759,12293,17467,438,17467,438,3.18892e+18,88.4274,13150.9,17905,5933,111,5612,5472,3051,1824,1156
3003,332,1211,2863,140,2863,140,2.9923e+18,85.7582,1593.7,3003,551,69,1792,1680,609,1087,215
16458,244,984,0,16458,15974,484,4.54596e+16,211.138,2760.8,16458,145,26,15345,15126,11523,11640,6353
10552,2652,2845,0,10552,3771,6781,2.43107e+15,59.168,3781.69,10552,1386,72,7707,7707,7433,7177,7265
10540,9,14,10220,320,10469,71,2.03949e+14,10.4347,328.067,10540,13,12,10452,10390,9299,9265,8276
26988,7305,13987,25988,1000,25988,1000,7.38018e+18,92.8964,15574,26988,6724,111,13001,13001,13001,13001,9222
7928,461,3743,7928,0,7568,360,4.91475e+18,109.111,4325.21,7928,1583,106,4185,3977,2394,3026,1233
33144,307,14502,12855,20289,0,33144,7.26824e+12,55.6139,16360.2,33144,7059,72,18642,18162,10412,2538,0
46562,274,1247,0,46562,45235,1327,3.55088e+16,255.628,4364.67,46562,198,26,45149,44651,32723,32546,16768
7101,1742,2746,0,7101,2689,4412,2.0462e+15,54.2911,3359.22,7101,1332,72,4355,4355,3866,3727,3247
25115,7234,13301,5447,19668,0,25115,52861500000,8.99028,13615.1,25115,11968,11,11814,11814,7684,11814,7334
31074,56,176,31018,56,31074,0,6.06796e+18,172.061,2175.59,31074,164,163,22061,13150,9173,10214,10008
10364,3819,4316,6912,3452,9894,470,3.69953e+18,94.5602,5220.12,10364,2057,107,6048,6048,5582,6019,5269
37579,7307,12085,35626,1953,35626,1953,4.78703e+18,88.8155,14730.4,37579,5755,111,25494,25494,21072,25182,13257
26333,2,16,25538,795,26269,64,2.04642e+14,10.3537,519.277,26333,13,12,15883,13270,7410,13331,3486
13489,1,6,13282,207,13457,32,9.62803e+13,3.994,264.956,13489,5,4,5584,5584,5584,5584,5584
18775,1289,4554,17685,1090,17685,1090,5.97728e+18,97.8831,6251.26,18775,2150,111,14221,14221,9304,11117,4988
39998,4,15,38861,1137,39915,83,1.39049e+14,10.6513,628.24,39998,14,12,34956,31273,30292,27882,18422
18211,3634,7673,17401,810,17401,810,7.80705e+18,95.1156,9031.24,18211,3674,111,10538,10538,8123,8680,5458
37882,11831,20047,37882,0,37882,0,2.44837e+18,17.9852,20588.6,37882,18034,20,17835,17835,10549,17835,10594
41658,1124,9779,39232,2426,0,41658,2.22738e+18,97.8481,12992.8,41658,4743,110,31879,31879,20082,17961,5307
22331,10654,11739,22331,0,0,22331,8.86195e+17,17.9684,12152.7,22331,10554,20,10592,10592,9653,9954,9681
13462,6,12,13078,384,13452,10,1.39169e+14,10.4453,324.175,13462,12,11,12784,12441,9447,9368,8274
4668,57,176,4663,5,4668,0,6.16102e+18,136.54,840.496,4668,89,92,3504,2407,1623,1681,1606
26237,136,175,26224,13,26237,0,5.98311e+18,167.046,1915.98,26237,158,163,25252,23662,20290,20906,20625
38430,4144,15802,0,38430,14721,23709,1.94606e+15,57.2286,17973.1,38430,7691,72,22628,22628,15301,13405,7530
27628,311,902,0,27628,26839,789,3.55802e+16,168.396,2845.48,27628,129,26,26726,26478,20951,21120,13483
29757,9,12,28910,847,29747,10,1.38973e+14,10.1729,484.465,29757,11,12,29367,28893,23211,23381,25035
7445,1779,2041,0,7445,2652,4793,2.40438e+15,58.8098,2760.6,7445,985,72,5404,5404,5173,4853,4964
5862,10,12,5691,171,5856,6,1.80784e+14,10.3668,227.047,5862,12,11,5834,5807,5426,5436,5086
16375,414,7878,0,16375,0,16375,4.41853e+17,65.9089,9054.82,16375,3799,110,8497,8497,3619,2287,1921
23450,5094,6795,8478,14972,0,23450,9.16243e+12,59.065,8494.68,23450,3304,72,16655,16655,15154,16338,12808
16144,3269,3848,15208,936,0,16144,2.22728e+18,97.2387,5390.59,16144,1851,110,12296,12296,11662,11448,10914
20348,473,1063,0,20348,19752,596,4.37381e+16,224.213,3109.38,20348,160,26,19285,18842,16265,16562,11203
5908,172,258,0,5908,5740,168,3.54068e+16,19.8665,746.725,5908,47,26,5650,5650,5449,5474,4340
46123,3566,20852,0,46123,0,46123,4.63375e+17,94.4318,23534,46123,10129,110,25271,25271,15496,7204,7002
34192,5616,8259,32220,1972,0,34192,2.20806e+18,97.6617,10991.3,34192,4000,110,25933,25933,23257,22180,18989
39964,9273,9330,0,39964,0,39964,6.48505e+17,97.8588,12446.2,39964,4520,110,30634,30634,30583,30575,30608
16668,5503,5809,15838,830,0,16668,1.90532e+18,93.237,7218.22,16668,2794,110,10859,10859,10859,10859,10859
21156,237,7414,20106,1050,20106,1050,2.92657e+18,95.7041,9091.91,21156,3585,110,13742,13312,6975,8702,1693
26747,5361,11854,0,26747,10385,16362,1.83702e+15,56.6554,13412.8,26747,5768,72,14893,14893,11324,10127,6887
28330,1118,7290,26712,1618,26712,1618,4.57958e+18,97.9324,9566.75,28330,3448,111,21040,21040,11547,13747,4631
7355,86,4131,3009,4346,0,7355,5.77288e+12,53.3648,4623.31,7355,2007,72,3224,2699,1127,36,0
31513,748,8197,0,31513,11227,20286,2.44221e+15,59.6273,10424.3,31513,3992,72,23316,23316,14099,2466,2884
5062,1703,1811,5062,0,4782,280,4.3117e+18,91.7839,2302.43,5062,535,92,3251,3251,3251,3251,3237
21207,2855,7790,7950,13257,0,21207,8.19579e+12,57.8022,9221.82,21207,3791,72,13417,13417,9730,12357,4862
43596,751,10128,15318,28278,0,43596,9.89565e+12,60.0727,13111.2,43596,4931,72,33468,33468,19769,31101,2972
15645,605,660,0,15645,15198,447,3.55798e+16,20.1232,1822.4,15645,84,26,14985,14985,14896,14900,14247
32469,845,7593,11413,21056,0,32469,9.88671e+12,60.0025,9934.05,32469,3688,72,24876,24876,15113,23195,3191
48244,10101,11566,45436,2808,45436,2808,6.29563e+18,98.3662,15080.4,48244,5475,111,36678,36678,33853,34518,32717
40589,2977,9708,38219,2370,38219,2370,4.3179e+18,98.3356,12773.8,40589,3274,116,30881,30881,30547,30881,11165
32988,7360,13862,32988,0,31366,1622,5.12991e+18,280.758,15331,32988,4022,134,19126,18953,15310,17578,11515
3082,250,1409,0,3082,0,3082,4.81599e+17,90.2511,1772.85,3082,663,67,1673,1501,1015,660,850
47895,3299,11199,45107,2788,0,47895,2.22735e+18,97.9007,14796.8,47895,5431,110,36696,36696,22016,20206,12548
43042,630,1190,0,43042,41814,1228,3.55868e+16,248.085,4106.43,43042,186,26,41852,41258,35144,36103,27783
31567,637,8514,29817,1750,0,31567,2.12497e+18,97.1535,11010.6,31567,4117,110,23053,22881,14227,12652,3455
3807,130,1029,0,3807,0,3807,6.43192e+17,94.1182,1550.23,3807,477,78,2778,1545,993,530,657
25312,2318,6073,23832,1480,23832,1480,6.16329e+18,98.1269,8199.73,25312,2862,111,19239,19239,9177,13915,8452
44408,6586,10411,41828,2580,41828,2580,5.89822e+18,97.8531,13799.3,44408,5048,110,33997,33997,33041,33044,22566
34195,313,1024,0,34195,33221,974,3.55536e+16,210.889,3382.8,34195,153,26,33094,32776,25301,25528,14621
20555,208,6369,20555,0,19355,1200,5.1659e+18,153.315,7621.47,20555,1477,127,14186,14005,6386,9225,764
45111,1205,10504,42481,2630,42481,2630,5.86934e+18,97.905,13938.2,45111,5094,110,34607,34607,31010,28226,5992
34300,272,1024,0,34300,33323,977,3.55351e+16,209.841,3388.06,34300,153,26,33158,32882,24957,24814,13379
12052,173,176,12039,13,12052,0,6.16271e+18,166.469,1354.21,12052,119,119,11872,11826,11723,11714,11707
26769,3242,15899,25939,830,25939,830,2.19323e+18,87.807,17311,26769,7704,110,10870,10870,7503,7703,3283
44322,1243,1342,0,44322,43051,1271,3.72351e+16,272.948,4585.17,44322,217,26,42980,42980,42825,42855,42135
21109,4852,5604,0,21109,7534,13575,2.42718e+15,59.4148,7208.43,21109,2725,72,15505,15505,14399,13757,13220
11303,1092,3247,7979,3324,10675,628,1.38248e+18,96.8052,4357.44,11303,1530,111,8056,8056,8056,8046,2183
46558,6662,16056,0,46558,17294,29264,2.16355e+15,58.3106,18821.2,46558,7822,72,30502,30502,24195,19368,14897
27953,4206,11119,0,27953,10637,17316,1.99103e+15,57.4108,12834.5,27953,5416,72,16834,16834,12694,10170,7801
25735,6007,12813,25735,0,19075,6660,4.32146e+18,319.199,14046.6,25735,5574,132,12922,12702,9286,10641,6578
38343,1926,25231,37343,1000,0,38343,1.00019e+18,90.2636,26854.7,38343,12268,110,13112,13112,7329,5663,2552
34184,129,238,34112,72,27547,6637,5.98398e+18,166.587,2373.13,34184,170,166,32569,30411,18905,20209,17304
21955,5327,6630,7978,13977,0,21955,9.02538e+12,58.8681,8219.66,21955,3228,72,15325,15325,14732,15221,14191
25494,6939,12474,10113,15381,0,25494,6.59567e+12,54.5859,13878.8,25494,6054,72,13020,13020,10957,12663,8613
28830,1719,10433,0,28830,0,28830,5.40538e+17,95.6706,12531.2,28830,5057,110,18397,18397,9617,6783,5859
37339,1449,8744,35169,2170,0,37339,2.22843e+18,97.7969,11698.6,37339,4225,110,28595,28595,12864,11805,6395
21118,1918,5041,19895,1223,19895,1223,3.34803e+18,97.4398,6932.7,21118,2431,110,16077,16077,9824,12673,6879
12299,1900,2923,4320,7979,0,12299,9.89672e+12,59.7192,4008.62,12299,1423,72,9376,9376,7983,9136,6461
29084,6500,6813,10231,18853,0,29084,9.89361e+12,60.0097,8952.16,29084,3318,72,22271,22271,21825,22192,21473
31615,852,1520,0,31615,30681,934,4.52745e+16,288.59,4757.76,31615,252,26,30095,30095,27815,28283,21858
41658,6588,9783,39236,2422,39236,2422,5.7742e+18,97.834,12998.3,41658,4735,110,31875,31875,29963,29648,22416
8109,2382,3386,0,8109,3102,5007,1.93044e+15,51.8826,4038.33,8109,1627,72,4723,4723,4474,4341,4319
18732,4385,4435,17640,1092,17640,1092,5.76241e+18,97.4368,6163.01,18732,2132,110,14297,14297,14265,14276,14278
49596,5378,18084,47197,2399,0,49596,1.85035e+18,95.8421,21267.3,49596,8791,110,31512,31512,21983,18765,11203
27465,8070,13143,10840,16625,0,27465,6.74071e+12,55.4509,14653.6,27465,6386,72,14322,14322,12548,13952,9720
13181,117,647,0,13181,0,13181,3.81712e+18,15.9771,1070.23,13181,556,18,12534,12534,6723,6311,7533
49733,708,13253,46943,2790,46943,2790,4.66713e+18,97.9583,16752.9,49733,6305,111,36480,36480,16672,20067,4133
37447,8536,13302,0,37447,13973,23474,2.12492e+15,58.0882,15590.9,37447,6466,72,24145,24145,19460,20371,13858
45621,889,17980,45621,0,43291,2330,4.5736e+18,442.484,19907.9,45621,6702,140,27641,26361,12847,17728,1686
17777,6247,8365,17057,720,0,17777,1.55179e+18,93.6711,9631.04,17777,4050,110,9412,9412,8535,7964,7429
1848,692,862,1768,80,1768,80,4.62829e+18,87.4805,1109.12,1848,386,51,986,986,886,887,980
14515,3646,6290,14515,0,13802,713,3.77443e+18,135.236,7118.53,14515,2550,124,8225,8225,6233,6996,5331
13745,4030,4662,0,13745,0,13745,5.58826e+17,95.4349,5895.07,13745,2238,110,9083,9083,8263,7892,7548
17010,3524,6459,16201,809,0,17010,1.81642e+18,93.2225,7836.2,17010,3122,110,10551,10551,8909,8586,7481
16149,2,13,15689,460,16083,66,1.38916e+14,10.8926,387.382,16149,12,12,9352,6628,6388,6722,5537
46313,136,176,46215,98,46313,0,6.06944e+18,173.866,2655.99,46313,167,170,44888,42434,35352,35790,35881
13415,3032,4010,4870,8545,0,13415,9.1156e+12,58.7952,5098.88,13415,1953,72,9405,9405,9026,9325,8587
10311,3597,5368,9922,389,9922,389,2.39633e+18,93.1286,6147.75,10311,2578,100,4943,4943,4320,4905,3847
18299,9,12,17771,528,18288,11,1.48144e+14,10.3575,390.136,18299,12,11,18071,17831,14549,14644,14795
13951,4689,6413,13951,0,13313,638,5.19317e+18,129.841,7270.35,13951,1845,123,7538,7538,6670,7497,5104
18638,3885,6145,18638,0,17548,1090,5.19616e+18,143.589,7183.35,18638,2224,121,12493,12412,10707,11654,8308
40342,4521,13387,38292,2050,0,40342,1.94485e+18,96.3036,16206.7,40342,6497,110,26955,26955,19229,17442,10220
18740,4392,10629,18740,0,0,18740,8.95944e+17,17.8024,10981.9,18740,9551,20,8111,8111,3569,4663,3542
8373,1167,2337,0,8373,0,8373,6.18169e+17,95.1596,3251.69,8373,1114,106,6036,6036,4880,4205,3906
48607,5334,11925,0,48607,0,48607,6.38909e+17,97.7405,15520.2,48607,5790,110,36682,36682,28084,21789,17537
26033,5767,13313,10422,15611,0,26033,6.32848e+12,55.0578,14687.6,26033,6468,72,12720,12720,9501,12170,5808
12037,1087,3186,4300,7737,0,12037,9.54779e+12,59.2977,4224.94,12037,1552,72,8851,8851,5753,8029,3791
32202,6523,12211,12148,20054,0,32202,8.01708e+12,57.7186,14176.5,32202,5947,72,19991,19991,16491,19391,12436
18896,3954,6578,0,18896,0,18896,5.53731e+17,95.6526,8124.58,18896,3181,110,12318,12318,10668,9857,9139
40612,14571,16181,39232,1380,38542,2070,4.86671e+18,347.016,17911.9,40612,4894,137,24431,24406,24052,24431,22923
13440,2363,6846,12930,510,12930,510,3.89538e+18,87.031,7812.72,13440,3268,111,6594,6594,3915,4386,3430
30931,3302,12723,29531,1400,29531,1400,3.89672e+18,94.1205,14765.4,30931,6090,111,18208,18208,9305,11297,6172
45537,13267,18765,45537,0,43687,1850,5.00938e+18,2960.98,22374.7,45537,7169,145,26772,23723,23451,23952,20852
26636,7271,8289,26636,0,25089,1547,4.22253e+18,171.134,9779.93,26636,3194,121,18347,18347,17556,17896,16583
12997,221,7341,0,12997,2790,10207,1.36639e+13,8.87651,7552.38,12997,6599,11,5656,5636,1478,1684,1287
27540,6875,10385,0,27540,0,27540,5.28129e+17,95.4217,12371.5,27540,5036,110,17155,17155,15695,15394,13537
49847,2284,2583,0,49847,48350,1497,4.99071e+16,344.492,8348.68,49847,463,26,47264,47264,46897,46991,45003
36213,1342,1574,0,36213,35153,1060,4.35693e+16,288.199,5047.34,36213,262,26,34639,34639,34247,34196,31834
7915,1029,2835,7517,398,7517,398,3.39101e+18,95.3557,3633.01,7915,1348,106,5080,5080,2569,3047,1733
29643,8468,12311,28323,1320,28323,1320,2.83873e+18,94.5264,14311.1,29643,5974,110,17332,17332,13262,14912,11826
36229,22932,36229,0,36229,36229,0,2047.94,0,36229,36229,36229,1,0,0,0,0,0
21039,3986,5432,0,21039,7489,13550,2.45247e+15,59.5458,7046.32,21039,2641,72,15607,15607,13474,13674,11020
13385,3164,4271,13385,0,12612,773,3.10418e+18,111.053,5205.05,13385,1612,119,9114,9095,8220,8562,7297
44452,409,10692,41871,2581,41871,2581,5.07598e+18,98.2996,13985.4,44452,5051,111,33760,33760,14119,21187,3405
32227,11357,13594,32227,0,30642,1585,4.83666e+18,254.429,15020.4,32227,3341,134,18633,18619,18353,18633,17351
32195,4698,11609,30633,1562,0,32195,1.86267e+18,95.7148,13894.1,32195,5624,110,20586,20586,14289,13916,8882
10191,2981,3243,10191,0,9591,600,6.33787e+18,94.2553,4027.95,10191,1211,118,6948,6948,6808,6894,6696
28974,3167,10001,0,28974,10760,18214,2.16102e+15,57.6062,11888.9,28974,4858,72,18973,18973,12551,11423,6593
25613,2563,9174,24363,1250,24363,1250,7.69429e+18,94.1779,11099.8,25613,4428,110,16439,16439,15480,15483,4992
12351,3179,4229,0,12351,4574,7777,2.18267e+15,58.038,5204.53,12351,2054,72,8122,8122,6930,6768,5116
3981,969,1391,3773,208,0,3981,1.9607e+18,91.1281,1882.91,3981,659,75,2590,2590,2038,2001,1649
6074,739,2516,5799,275,0,6074,1.74422e+18,93.0173,3139.24,6074,1197,93,3558,3394,2513,2220,1780
10446,3175,3508,0,10446,0,10446,5.68312e+17,95.2702,4518.48,10446,1686,110,6938,6938,6571,6145,6244
45108,2220,10518,0,45108,15866,29242,2.5319e+15,60.0809,13584.3,45108,5124,72,34590,34590,22487,7248,7693
15727,3,11,15268,459,15720,7,1.65105e+14,10.1128,365.738,15727,11,11,12092,9131,9032,9811,4490
16078,8,11,15619,459,16074,4,1.38987e+14,10.2058,354.592,16078,11,11,15672,15463,13835,13816,12425
17593,264,712,0,17593,17091,502,3.55435e+16,39.8123,2001.44,17593,91,26,16881,16860,15311,15392,8298
23878,8,208,23857,21,23878,0,6.06112e+18,201.548,2044.51,23878,165,158,5078,859,885,791,855
21740,13,14,21109,631,21691,49,1.59006e+14,10.7254,477.024,21740,13,11,21726,21726,21522,21522,21223
31829,939,1319,0,31829,30903,926,4.1581e+16,266.775,4183.53,31829,213,26,30510,30510,29698,29421,25658
3381,378,934,3191,190,3191,190,5.94717e+18,93.6253,1413,3381,436,74,2447,2447,2159,2129,1379
36432,8324,14925,0,36432,13945,22487,1.95331e+15,57.2387,17004.4,36432,7271,72,21507,21507,20383,18815,18686
4886,2331,4886,2506,2380,4886,0,3.96508e+18,0,4886,4886,2381,21,0,0,0,0,0
8593,12,176,8587,6,8593,0,6.01242e+18,161.129,1128.41,8593,117,119,2460,418,503,551,553
33569,1249,7882,0,33569,0,33569,6.4661e+17,97.743,10598.4,33569,3811,110,25687,25687,11297,6798,5575
44305,676,1731,0,44305,43012,1293,4.21969e+16,292.681,5724.37,44305,295,26,42574,41330,39184,36608,22926
8019,1275,1986,7552,467,7552,467,3.42718e+18,96.3197,2897.18,8019,937,104,6033,6033,4646,5277,4227
15042,4,14,14603,439,14997,45,1.76741e+14,10.3823,380.655,15042,13,11,13188,11779,10767,10349,7165
15341,10,11,14888,453,15330,11,1.71755e+14,10.177,363.31,15341,11,11,15304,15262,15221,15222,15054
14763,48,839,0,14763,14332,431,4.22935e+16,144.457,2281.74,14763,116,26,13773,13726,8899,8708,2893
21040,2904,9755,0,21040,8247,12793,1.77726e+15,41.8059,11009.8,21040,4736,72,11285,11285,10687,10158,9855
42467,5864,9925,0,42467,14933,27534,2.52897e+15,60.0537,12842.4,42467,4828,72,32542,32542,27651,26704,19502
26541,3046,13932,5765,20776,0,26541,5.2789e+10,8.98915,14257.1,26541,12531,11,12609,12607,4751,12609,3963
562,97,236,532,30,532,30,1.24229e+18,70.9395,343.32,562,86,32,318,115,151,215,186
16122,1266,4729,15242,880,15242,880,3.90641e+18,96.9983,6163.68,16122,2239,111,11393,11393,8442,9289,4732
21116,10381,10713,0,21116,8445,12671,1.62679e+15,55.5638,11891.6,21116,5210,72,10403,10403,9954,10071,9571
43663,13,17,42362,1301,43589,74,1.88568e+14,10.3296,739.912,43663,14,12,43646,43646,41446,41464,39618
25651,2301,12266,25651,0,24521,1130,4.06008e+18,263.727,13479.6,25651,5250,131,13385,12939,7026,9582,1982
18961,39,176,18894,67,18961,0,5.97992e+18,167.128,1648.46,18961,154,151,10787,3426,3616,4288,4145
12863,4547,6452,0,12863,5124,7739,1.65637e+15,55.326,7268.4,12863,3137,72,6411,6411,5421,4812,4462
43196,10,16,41934,1262,43100,96,1.64782e+14,10.5413,696.511,43196,13,12,43000,42700,37439,37535,35827
25666,134,175,25588,78,25666,0,5.98198e+18,166.789,1894.59,25666,158,162,24630,23125,19525,20114,20028
48220,143,1441,0,48220,46837,1383,3.73947e+16,275.976,4976.76,48220,237,26,46238,45860,31929,30296,12117
7354,1916,1923,0,7354,0,7354,6.35705e+17,96.0092,2768.51,7354,912,102,5431,5431,5427,5427,5431
30999,4425,7284,29189,1810,0,30999,2.22956e+18,97.7661,9830.7,30999,3529,110,23715,23715,20522,19164,15324
32892,12605,15912,0,32892,13017,19875,1.70531e+15,54.2117,17641.6,32892,7729,72,16980,16980,15112,14043,13058
9533,2312,5048,9533,0,9153,380,4.34441e+18,141.36,5673.6,9533,2245,113,4485,4408,2938,3512,2337
20239,1,11,19661,578,20235,4,1.41732e+14,10.0677,399.194,20239,11,11,5073,5073,5073,5073,5073
32829,4189,7708,0,32829,0,32829,6.47614e+17,97.7535,10375,32829,3730,110,25121,25121,20355,17068,14630
29185,347,6862,0,29185,0,29185,6.48372e+17,97.7409,9294.96,29185,3324,110,22323,22323,7062,1834,2553
45513,1067,2463,13685,31828,0,45513,6.91352e+18,15.9932,3260.65,45513,1884,18,43050,43050,28274,26667,25222
20883,3476,6439,0,20883,7610,13273,2.2903e+15,58.7621,7957.86,20883,3137,72,14444,14444,12245,9200,8704
33521,10049,12180,31883,1638,31883,1638,4.88821e+18,96.3648,14485.1,33521,5836,111,21341,21341,18898,19450,18058
25230,643,860,0,25230,24510,720,3.56118e+16,150.426,2655.17,25230,120,26,24370,24171,22459,22831,20023
15091,149,3549,0,15091,5307,9784,2.53544e+15,59.8514,4825.49,15091,1728,72,11542,11512,6614,2274,701
3037,417,1083,3037,0,2858,179,5.02348e+18,89.0547,1423.23,3037,208,74,1954,1954,1764,1899,1019
42658,799,9947,40171,2487,0,42658,2.22964e+18,97.8844,13231.4,42658,4822,110,32711,32711,20242,18251,4614
34090,52,176,34034,56,34090,0,6.09459e+18,171.043,2285.3,34090,165,164,23618,14123,9577,10405,10256
16092,1531,3780,0,16092,5664,10428,2.53982e+15,59.8737,5121.58,16092,1838,72,12312,12312,8780,6091,5312
18160,3,11,17639,521,18151,9,1.49541e+14,10.2366,385.458,18160,11,11,13876,10138,10460,11414,7507
10009,3453,4774,3943,6066,0,10009,6.78791e+12,53.2489,5478.65,10009,2316,72,5235,5235,4762,5155,4430
8048,1332,2747,7638,410,7638,410,7.31456e+18,94.7638,3577.25,8048,1315,97,5301,5301,5121,5121,3528
39277,287,1348,0,39277,38605,672,2.54239e+16,3.73567,5166.52,39277,676,4,37929,37929,33704,33534,19992
13138,1573,3147,0,13138,0,13138,6.50931e+17,97.1076,4465.07,13138,1514,110,9991,9991,8192,7098,5440
8517,1391,2107,8027,490,8027,490,3.33249e+18,96.3235,3063.49,8517,995,107,6410,6410,5018,5657,4600
46427,18434,19542,46427,0,37873,8554,4.1812e+18,1166.85,21844,46427,5400,141,26885,26885,26758,26885,25252
29561,620,1002,0,29561,28716,845,3.68223e+16,204.081,3198.67,29561,149,26,28559,28190,25102,25632,21290
35884,4898,11501,0,35884,13162,22722,2.24569e+15,58.6512,13805.7,35884,5599,72,24383,24383,17865,10320,10001
48232,11,15,46857,1375,48155,77,1.38946e+14,10.3505,643.319,48232,13,13,48215,48206,45022,45021,40539
11193,5,13,10872,321,11126,67,1.58705e+14,10.6668,326.171,11193,13,12,10351,9393,8703,7725,6121
11158,3882,4555,11158,0,10598,560,5.22541e+18,120.44,5328.48,11158,1018,120,6603,6603,6473,6603,5570
43491,1472,10131,40951,2540,40951,2540,5.73648e+18,97.8912,13462.1,43491,4910,110,33360,33360,27056,22119,6777
42638,4643,9939,40152,2486,40152,2486,5.74467e+18,97.8964,13223.1,42638,4824,110,32699,32699,29495,28968,16578
36562,1071,8515,12852,23710,0,36562,9.89481e+12,60.0508,11098.2,36562,4142,72,28047,28047,17210,26177,3985
835,169,261,0,835,288,547,2.4742e+15,51.5066,400.016,835,115,38,574,574,477,484,443
20576,1967,5041,19386,1190,19386,1190,3.88872e+18,97.8639,6854.29,20576,2371,111,15535,15535,11291,13474,6858
40594,3000,15336,40594,0,38444,2150,4.61761e+18,304.373,17059.9,40594,3513,137,25258,24662,14451,18265,6997
11488,131,176,11422,66,11488,0,6.02745e+18,165.255,1297.28,11488,132,135,10908,10236,8491,8592,8512
49255,732,1304,0,49255,47851,1404,3.55629e+16,264.57,4596.85,49255,209,26,47951,47951,44895,45230,33132
4876,758,1181,0,4876,1703,3173,2.52669e+15,58.9787,1724.64,4876,568,72,3695,3695,3090,2574,2523
19064,2086,6124,0,19064,0,19064,5.78027e+17,92.9475,7727.7,19064,2948,110,12940,12940,9524,4797,5726
26970,2540,6362,25400,1570,0,26970,2.22666e+18,97.6554,8648.89,26970,3080,110,20608,20608,14921,13754,9179
43167,682,2133,0,43167,41884,1283,4.78665e+16,319.252,6858.6,43167,371,26,41034,39307,36513,32366,16340
20767,1925,5466,0,20767,0,20767,6.25332e+17,97.1017,7287.2,20767,2639,110,15301,15301,11502,8572,7106
18317,3257,6776,0,18317,6872,11445,2.08892e+15,56.3659,8052.05,18317,3284,72,11541,11541,8979,5617,4792
36424,5082,8490,0,36424,12805,23619,2.5347e+15,60.0392,11061.4,36424,4136,72,27934,27934,23761,21580,16824
9341,109,176,9335,6,9341,0,6.00498e+18,163.764,1167.49,9341,124,124,8468,6731,5490,5707,5807
25934,2887,6037,0,25934,9106,16828,2.53168e+15,59.987,7995.85,25934,2935,72,19897,19897,15338,14801,9879
1988,61,102,0,1988,1929,59,3.54851e+16,19.0689,297.829,1988,30,26,1886,1886,1656,1666,1381
19643,3638,6534,19643,0,18503,1140,5.05382e+18,148.278,7604.58,19643,2380,122,13109,13017,10484,11670,7762
29112,6951,8334,0,29112,10502,18610,2.35861e+15,59.1639,10359.2,29112,4056,72,20778,20778,19091,17935,16410
38710,8160,9005,0,38710,13603,25107,2.53662e+15,60.0699,11709.2,38710,4386,72,29705,29705,28670,27404,27111
40919,5303,9552,38537,2382,0,40919,2.22865e+18,97.8512,12727.1,40919,4631,110,31367,31367,25590,24375,18574
12152,6,11,11803,349,12146,6,1.39116e+14,10.3348,309.134,12152,11,11,11518,11300,8653,8718,8336
6582,1550,1637,6202,380,6202,380,5.97371e+18,95.2571,2430.16,6582,756,95,4945,4945,4945,4945,4940
31640,95,208,31628,12,31640,0,5.98787e+18,189.152,2207.02,31640,172,175,27467,16824,14307,15471,15481
46386,11810,20368,0,46386,17985,28401,1.85133e+15,55.9505,22798.3,46386,9903,72,26018,26018,22091,19825,15596
38608,63,2365,0,38608,7881,30727,1.47004e+16,11.9948,3002.68,38608,1586,14,36243,36243,20817,2404,29304
42877,4751,9989,40377,2500,0,42877,2.23072e+18,97.9027,13288.2,42877,4843,110,32888,32888,26652,24493,16934
29760,991,11046,28327,1433,28327,1433,3.96867e+18,96.1401,13131.5,29760,5285,111,18714,18469,11255,10458,4058
42070,6194,9777,0,42070,14787,27283,2.53217e+15,60.0635,12675.6,42070,4752,72,32293,32293,27123,28188,20894
7165,44,61,7165,0,7165,0,2.26908e+18,59.9689,626.143,7165,61,61,6511,4010,5222,5485,5110
19635,412,4706,0,19635,0,19635,6.44391e+17,97.1497,6492.36,19635,2263,110,14929,14929,5182,1919,2272
16519,8,12,16046,473,16512,7,1.38548e+14,10.5427,363.193,16519,12,11,16135,15730,15157,15154,12296
43393,4463,15122,41228,2165,41228,2165,4.87305e+18,96.6674,17987.3,43393,7242,116,28271,28271,20853,23271,9685
5000,868,2708,4819,181,4819,181,2.98956e+18,91.292,3160.39,5000,1276,74,2292,2205,1061,1334,1271
10949,3,11,10638,311,10942,7,1.39234e+14,10.4256,294.043,10949,11,11,8339,5854,7266,7234,4162
22201,604,969,0,22201,21557,644,3.98604e+16,196.231,2894.26,22201,142,26,21232,20901,18913,19185,15911
42225,11,13,40926,1299,42072,153,1.84584e+13,5.99335,657.034,42225,9,7,42212,42212,42147,42148,42145
25064,4391,5875,0,25064,0,25064,6.48406e+17,97.6475,8041.07,25064,2833,110,19189,19189,17521,17485,14971
45240,6893,10557,0,45240,15905,29335,2.53251e+15,60.0711,13627.9,45240,5142,72,34683,34683,30282,24412,22963
6908,1084,1899,2476,4432,0,6908,9.50636e+12,58.8005,2574.44,6908,925,72,5009,5009,4019,4801,2530
43732,16910,18283,43732,0,41582,2150,4.57657e+18,395.184,20088.4,43732,7560,141,25449,25449,25422,25417,24384
1168,3,11,1135,33,1168,0,1.37846e+14,10.3022,95.1101,1168,11,11,895,636,746,789,533
37495,695,19796,0,37495,8137,29358,1.35357e+13,8.99139,20182.5,37495,17810,11,17699,17697,4727,17699,3598
25976,3044,6231,24457,1519,24457,1519,3.46199e+18,98.1571,8400.5,25976,2933,111,19745,19745,13690,15012,10706
43542,15085,15431,41392,2150,41392,2150,3.51856e+18,96.1115,18285.1,43542,7372,111,28111,28111,27854,27909,28063
39035,10971,14932,37201,1834,0,39035,1.79891e+18,95.468,17512.6,39035,7252,110,24103,24103,21596,21064,19035
36696,8442,20540,0,36696,7891,28805,1.36544e+13,8.96406,20904.3,36696,18477,11,16156,16156,8778,16156,8353
30087,8149,12142,30087,0,28548,1539,4.10166e+18,226.347,13501.1,30087,4023,133,17945,17876,15720,16419,12088
2711,184,1076,0,2711,1022,1689,2.03182e+15,55.5699,1375.07,2711,519,57,1635,1587,1015,412,507
43878,6,15,42616,1262,43794,84,1.47986e+14,10.519,680.797,43878,13,12,41684,40532,31072,30818,22645
16090,2274,4926,0,16090,5860,10230,2.297e+15,58.3896,6172.16,16090,2392,72,11164,11164,8425,5650,4910
41603,112,1162,0,41603,40417,1186,3.55915e+16,242.878,3989.29,41603,181,26,40054,39880,32041,32242,10124
40911,10,176,40819,92,40911,0,6.07271e+18,173.177,2496.72,40911,172,169,10306,1762,2075,1902,2021
23813,3507,5604,8384,15429,0,23813,9.87849e+12,59.9542,7427.47,23813,2730,72,18209,18209,15742,17692,11736
10377,6,200,10376,1,10377,0,5.99293e+18,175.56,1249.19,10377,130,129,1756,237,222,203,285
21509,2457,5070,20259,1250,0,21509,2.22877e+18,97.5062,6995.86,21509,2438,110,16439,16439,13431,12224,8620
36471,8446,11747,36471,0,34349,2122,5.30876e+18,257.342,13370.7,36471,4346,128,24724,24632,22260,23692,18790
13986,517,13986,0,13986,13986,0,2047.85,0,13986,13986,13986,1,0,0,0,0,0
23395,895,5460,8214,15181,0,23395,9.89776e+12,59.9543,7261.77,23395,2655,72,17935,17935,7506,15100,3212
29573,5317,6968,0,29573,0,29573,6.47396e+17,97.6958,9422.65,29573,3372,110,22605,22605,20350,19458,17812
25841,5944,13830,24924,917,24924,917,2.34727e+18,92.8462,15346.9,25841,6710,110,12011,12011,9270,10676,5915
40686,1547,1607,0,40686,39498,1188,4.19902e+16,299.172,5264.36,40686,269,26,39079,39079,38940,38934,38318
23629,2585,5694,22254,1375,22254,1375,2.29254e+18,98.0395,7712.91,23629,2684,111,17935,17935,15347,16744,9134
42345,11505,13550,40281,2064,39876,2469,4.26622e+18,298.689,15358.2,42345,3461,134,28795,28795,27547,28571,25414
41650,2834,17932,0,41650,16088,25562,1.87915e+15,56.6297,20186.3,41650,8730,72,23718,23718,14559,8872,3518
46157,4895,12164,43577,2580,43577,2580,6.331e+18,97.2917,15552.3,46157,5887,110,33993,33993,32493,32493,15852
905,247,299,0,905,0,905,6.56018e+17,82.6751,471.11,905,121,42,606,606,583,582,589
5022,229,1783,5022,0,4732,290,5.87377e+18,90.8877,2245.74,5022,435,95,3239,3239,2019,2615,755
23618,2667,9191,0,23618,0,23618,5.18821e+17,94.5939,10930.3,23618,4458,110,14427,14427,9082,7422,6050
18556,1402,5986,17596,960,17596,960,3.06588e+18,95.6792,7558.37,18556,2876,110,12570,12570,9404,9973,4771
36835,113,176,36760,75,36835,0,5.98037e+18,169.549,2272.55,36835,171,169,34093,30103,22652,23335,23967
12072,5,11,11713,359,12058,14,1.90122e+14,10.0446,325.698,12072,11,11,11209,10114,9936,9078,6329
3188,87,208,3188,0,3188,0,6.08376e+18,153.782,751.494,3188,81,81,2640,1931,1390,1394,1296
19445,9075,10965,7962,11483,0,19445,5.65574e+12,54.2159,11972.1,19445,5324,72,8480,8480,7955,8390,7548
46399,1976,2019,0,46399,45030,1369,4.48972e+16,315.257,6614.05,46399,353,26,44380,44380,44273,44268,43743
3465,284,890,0,3465,0,3465,6.42573e+17,94.1131,1386.93,3465,401,74,2575,2575,1540,1294,1143
29240,9,15,28398,842,29157,83,1.53598e+14,10.2669,552.925,29240,13,12,28856,28509,22794,23027,21289
22988,383,6425,21728,1260,0,22988,2.10052e+18,91.8992,8362.24,22988,3089,110,16563,16563,10147,9161,2284
33734,7080,8115,0,33734,0,33734,6.43429e+17,97.6767,10822.4,33734,3935,110,25619,25619,24442,24837,22780
18257,2453,10212,0,18257,0,18257,3.76986e+17,90.612,11338.8,18257,4950,110,8045,8045,4943,3507,2055
3439,7,11,3339,100,3439,0,1.37668e+14,10.6999,163.268,3439,11,11,3312,3253,2980,3000,2722
31166,12335,31166,0,31166,0,31166,524271,0,31166,31166,31166,1,0,0,0,0,0
9051,12,176,9038,13,9051,0,6.06077e+18,163.63,1172.81,9051,122,122,2614,485,543,613,609
23221,6554,8362,8680,14541,0,23221,8.26525e+12,57.9557,9916.31,23221,4068,72,14859,14859,12535,14459,9890
46742,1,7,45282,1460,46550,192,0.000128364,0.99985,553.75,46742,7,1,46735,46735,46735,46735,46735
18049,4438,7352,17229,820,17229,820,4.90005e+18,95.2724,8725.22,18049,3516,111,10697,10697,8233,8607,7886
3827,282,991,3600,227,3600,227,5.81811e+18,95.0293,1514.97,3827,444,78,2836,2836,1647,2086,1157
34757,6340,18384,33507,1250,0,34757,1.37616e+18,92.7113,20302.1,34757,8930,110,16373,16373,11444,10130,6098
48843,8969,17849,46473,2370,46473,2370,4.4818e+18,96.3924,20929.1,48843,8550,111,30994,30994,14300,17713,5335
18109,102,176,18087,22,18109,0,6.15679e+18,126.869,1658.72,18109,129,131,16937,13493,10356,10301,11623
32664,5232,7626,0,32664,11481,21183,2.52921e+15,60.0295,9983.61,32664,3709,72,25038,25038,21611,18266,17558
26097,7131,9984,24867,1230,0,26097,1.80245e+18,95.3513,11879,26097,4841,110,16113,16113,13561,13002,10919
32332,4287,16935,31874,458,31094,1238,4.8558e+18,595.715,18541,32332,6891,138,15397,14645,9512,11797,4626
45127,3062,10697,45127,0,45127,0,2.5217e+18,4357.79,15703.7,45127,7377,25,29101,23017,12066,7578,11341
6578,1611,1613,0,6578,2319,4259,2.51181e+15,59.2987,2289.85,6578,779,72,4965,4965,4965,4965,4965
31489,9,12,30585,904,31474,15,1.44005e+14,10.25,506.512,31489,11,12,31086,30594,29012,29000,25662
29297,1049,10511,0,29297,0,29297,5.43314e+17,94.4743,12643.9,29297,5096,110,18786,18622,11647,3914,3168
42581,1272,9995,0,42581,0,42581,6.46991e+17,97.8296,13269,42581,4844,110,32586,32586,13243,7347,6065
13027,3643,4082,12339,688,0,13027,2.01356e+18,95.969,5298.17,13027,1970,110,8945,8945,8458,8337,7952
25424,1037,6003,0,25424,0,25424,6.47961e+17,97.6681,8188.49,25424,2906,110,19421,19421,12650,5851,4327
2898,3,10,2810,88,2893,5,1.8765e+14,9.76605,156.911,2898,10,10,2258,1781,1552,1902,992
9082,303,4039,3524,5558,0,9082,7.1696e+12,56.1649,4720.79,9082,1962,72,5043,4899,2824,4270,1046
11684,664,716,0,11684,11346,338,4.09441e+16,42.9472,1827.68,11684,92,26,10968,10942,10854,10847,10083
44014,203,375,0,44014,40387,3627,2.96391e+16,10.0951,1126.18,44014,366,12,43639,43639,42357,38918,42269
25694,5148,7202,0,25694,0,25694,6.09404e+17,96.9085,9305.18,25694,3480,110,18492,18492,17066,16133,14974
23802,10,14,23112,690,23754,48,1.574e+14,10.6128,498.495,23802,12,11,23681,23486,23040,22495,21508
15656,1098,4530,5647,10009,0,15656,9.2211e+12,59.0011,5769.27,15656,2206,72,11126,11126,7771,10546,3825
45152,251,1829,0,45152,43828,1324,4.30779e+16,299.515,6033.56,45152,315,26,42872,41962,36134,30051,10829
6296,889,1599,0,6296,0,6296,6.36519e+17,95.6936,2361.87,6296,754,93,4697,4697,3896,3075,2884
14600,7545,7962,14600,0,14600,0,2.60234e+18,18.8129,8292.49,14600,4301,23,6638,6638,6544,6621,6315
11801,3683,4183,11801,0,11132,669,3.36355e+18,101.557,4948.18,11801,1535,118,7618,7608,7404,7503,7431
48747,3698,15536,48747,0,45909,2838,4.8965e+18,333.014,17536.1,48747,5742,134,33211,32550,19242,26217,9122
40147,13,15,38977,1170,40060,87,1.63499e+14,10.4764,668.545,40147,13,12,40132,40132,39447,39447,36101
10299,1643,3145,9749,550,9749,550,3.3644e+18,96.2611,4168.75,10299,1483,111,7154,7154,4552,4963,3605
44952,123,176,44874,78,44952,0,5.98029e+18,172.027,2512.36,44952,171,172,42466,38855,30994,31340,31063
7716,201,519,0,7716,7491,225,4.16974e+16,19.7588,1298.46,7716,70,26,7197,7197,6417,6272,2273
35262,6633,17646,35262,0,33944,1318,4.99105e+18,1615.91,19830.5,35262,7244,141,17616,15650,11602,14468,7265
42000,868,2112,0,42000,40750,1250,4.82426e+16,320.35,6765.93,42000,369,26,39888,39888,34822,36034,21059
28750,8172,8693,0,28750,10450,18300,2.30886e+15,58.9142,10661.1,28750,4234,72,20057,20057,19295,18435,18539
43593,2972,18890,41713,1880,0,43593,1.65062e+18,94.7039,21524.6,43593,9178,110,24703,24703,13725,10739,5049
26907,2957,9699,25597,1310,25597,1310,7.7398e+18,95.6699,11690.9,26907,4701,110,17208,17208,16308,16308,6548
17048,154,176,17036,12,17048,0,6.09842e+18,169.163,1616.84,17048,144,141,16687,16328,14843,14922,14708
46998,5061,11007,44268,2730,44268,2730,5.88894e+18,97.874,14552,46998,5329,110,35991,35991,34520,34521,18090
4786,232,2280,4589,197,0,4786,1.57569e+18,91.5075,2764.47,4786,1084,79,2506,2334,1488,1244,851
2379,611,828,2379,0,2239,140,7.03221e+18,89.3867,1134.88,2379,296,64,1551,1551,1400,1488,1360
36336,7211,8715,34218,2118,34218,2118,3.49132e+18,98.2915,11528.6,36336,4126,111,27621,27621,26065,27508,23541
27329,4285,11075,0,27329,0,27329,5.0505e+17,95.0188,12983.3,27329,5375,110,16254,16254,12621,9135,7951
29978,4472,7054,0,29978,0,29978,6.47322e+17,97.7212,9539.6,29978,3411,110,22924,22924,20069,18107,15445
48362,14318,14548,47413,949,45552,2810,4.57021e+18,334.956,16888.3,48362,3109,137,33814,33814,33814,33814,33617
30634,1381,8998,28984,1650,0,30634,2.05906e+18,96.8403,11371.8,30634,4365,110,21636,21636,9972,9808,5805
34342,88,176,34327,15,34342,0,5.98143e+18,169.75,2195.29,34342,165,169,29279,17369,16025,16941,17198
6618,1344,3060,6341,277,0,6618,1.60079e+18,92.5264,3683.26,6618,1467,85,3558,3558,2583,2329,1864
34878,3959,17104,34878,0,34878,0,4.492e+18,17.9785,17646.2,34878,15377,20,17774,17774,4728,17774,4158
5506,1323,1362,0,5506,1946,3560,2.52689e+15,59.1596,1952.86,5506,663,72,4144,4144,4103,4105,4105
25770,9815,15027,25770,0,17782,7988,4.98554e+18,565.133,16366.4,25770,4672,132,10743,10487,9066,10042,7695
21617,6484,7499,20539,1078,20539,1078,7.52513e+18,95.7857,9212.28,21617,3629,110,14118,14118,13950,13950,12540
32103,142,176,32029,74,32103,0,5.9845e+18,169.673,2122.81,32103,169,165,31155,29139,26081,26185,26180
26560,2202,26560,0,26560,0,26560,524268,0,26560,26560,26560,1,0,0,0,0,0
3571,92,182,0,3571,3468,103,3.68662e+16,19.7561,519.872,3571,40,26,3389,3389,3172,3177,2156
22520,12,175,22512,8,22520,0,5.97653e+18,166.686,1776.12,22520,161,158,6367,979,1259,1446,1499
6434,516,2811,6154,280,6154,280,3.62471e+18,93.4055,3439.33,6434,1331,86,3623,3449,2581,2761,1896
46145,3250,14220,16839,29306,0,46145,8.90751e+12,58.596,17094.2,46145,6913,72,31925,31925,17367,27457,7061
16196,5520,6891,15486,710,0,16196,1.68219e+18,94.3101,8147.65,16196,3332,110,9305,9305,8555,8144,7661
18035,10,12,17495,540,18015,20,1.94293e+14,9.8209,404.734,18035,11,12,17997,17971,17552,17557,16299
47312,807,11070,0,47312,0,47312,6.48163e+17,97.8894,14631,47312,5371,110,36242,36242,22290,6565,4812
25231,173,1189,0,25231,24492,739,4.29815e+16,229.072,3619.07,25231,186,26,23748,23449,17116,16779,8672
12992,102,208,12949,43,12992,0,6.1225e+18,192.355,1514.94,12992,131,137,11486,8377,6392,6588,6474
22436,5,15,21770,666,22381,55,1.84221e+14,10.5246,509.558,22436,13,11,20786,19007,17988,15531,10335
15180,4726,7210,15180,0,14490,690,5.90269e+18,147.478,8034.24,15180,2772,127,7970,7970,7110,7823,5814
9789,926,4161,0,9789,3767,6022,1.90999e+15,56.2449,4904.6,9789,2021,72,5628,5580,3751,1431,1706
12841,1669,3086,0,12841,0,12841,6.47239e+17,97.0887,4385.48,12841,1479,110,9755,9755,7904,5910,5962
8593,1980,2352,3068,5525,0,8593,9.48711e+12,58.9991,3150.93,8593,1142,72,6241,6241,5808,6151,5257
13875,587,3653,0,13875,0,13875,6.25763e+17,96.7526,4998.04,13875,1752,110,10222,10140,5334,2429,2606
13303,231,4458,13303,0,12531,772,5.10677e+18,109.179,5293.64,13303,823,125,8845,8826,4583,6165,866
16244,13919,16244,16244,0,16244,0,8.79555e+12,0,16244,16244,16244,1,0,0,0,0,0
18224,360,4315,17164,1060,17164,1060,3.36218e+18,97.3907,6009.95,18224,2070,110,13909,13909,5932,9563,2035
42675,7210,9972,15008,27667,0,42675,9.88361e+12,60.0596,12897.4,42675,4857,72,32703,32703,29411,32015,23999
19678,6435,6854,7303,12375,0,19678,8.42274e+12,56.8135,8238.82,19678,3320,72,12824,12824,12824,12824,12824
39611,17781,18119,39611,0,35723,3888,4.69833e+18,977.564,20154,39611,5141,139,21492,21492,21492,21492,21333
33624,331,10779,0,33624,0,33624,5.76016e+17,96.3889,13255.1,33624,5227,110,22845,22157,13463,3547,2507
43390,2375,19697,41590,1800,41590,1800,2.72711e+18,93.9556,22248.3,43390,9568,110,23693,23693,9606,15132,4085
39742,1637,2563,38126,1616,12225,27517,1.73819e+18,16.9943,3328.97,39742,1406,27,37179,37179,36224,36942,27225
9043,179,2873,8565,478,8565,478,3.17025e+18,95.5041,3798.92,9043,1379,105,6170,5921,2393,3974,1036
38773,1082,1105,0,38773,37667,1106,3.55373e+16,229.689,3745.23,38773,169,26,37668,37668,37598,37595,37389
19491,837,886,0,19491,18928,563,3.94467e+16,155.284,2565.42,19491,125,26,18605,18605,18529,18520,18139
28518,930,8957,27028,1490,27028,1490,7.07136e+18,96.4178,11152.3,28518,4338,110,19561,19561,14378,16173,4194
39666,20,208,39578,88,39666,0,6.06265e+18,201.89,2627.15,39666,180,177,15924,3097,4256,4552,3834
34642,6423,11363,0,34642,0,34642,5.68736e+17,96.3116,13879.4,34642,5511,110,23279,23279,19308,19471,12739
29022,4504,6840,0,29022,0,29022,6.48177e+17,97.6913,9260.38,29022,3308,110,22182,22182,18991,16515,15234
34279,568,17592,33009,1270,33009,1270,2.43404e+18,92.5311,19540.8,34279,8529,110,16687,15569,10232,9536,1876
46071,5872,12544,43503,2568,43503,2568,4.56949e+18,97.865,15817.9,46071,5969,111,33527,33527,27709,32177,18433
5297,135,296,0,5297,5145,152,3.82258e+16,19.6949,793.185,5297,50,26,5001,5001,4705,4617,3243
48655,93,1290,0,48655,47267,1388,3.55142e+16,262.47,4539.6,48655,205,26,46787,46651,29639,29751,10267
38235,13747,14095,36402,1833,36402,1833,2.97406e+18,95.6631,16681,38235,6835,110,24140,24140,23509,23793,23428
19725,4991,7456,7435,12290,0,19725,8.00839e+12,57.5851,8795.29,19725,3617,72,12269,12269,10931,11989,8841
32724,4491,7646,0,32724,11506,21218,2.529e+15,60.0026,10005.6,32724,3712,72,25078,25078,21325,16306,15088
34092,560,7953,11991,22101,0,34092,9.88524e+12,60.0387,10393.1,34092,3870,72,26139,26139,8307,21205,2281
44323,789,11804,41851,2472,41851,2472,6.36522e+18,97.3584,15069.2,44323,5729,110,32519,32453,29631,25806,4535
49769,9327,16627,49769,0,47019,2750,4.51982e+18,350.082,18972.3,49769,5499,138,33142,33046,27348,30373,20134
30234,10969,11609,28819,1415,0,30234,1.79641e+18,95.3299,13723.6,30234,5633,110,18625,18625,17780,17640,17058
43958,6087,13271,43958,0,41398,2560,4.79628e+18,312.463,15447,43958,3571,134,30687,30506,23813,27167,15492
30979,1093,17148,12648,18331,0,30979,5.75699e+12,54.9274,18618.2,30979,8345,72,13831,13639,8014,12841,1176
46579,12519,15753,44239,2340,0,46579,1.92542e+18,96.2277,18888.5,46579,7640,110,30826,30826,28860,27930,25828
4578,238,1719,1716,2862,0,4578,8.16238e+12,52.1848,2172.12,4578,827,71,2859,2811,1137,108,0
24661,12242,12471,23731,930,0,24661,1.44453e+18,87.5738,14009,24661,6035,110,12190,12190,12190,12190,12190
48040,9286,11245,0,48040,0,48040,6.47232e+17,97.8772,14852.4,48040,5451,110,36795,36795,34204,32247,31312
28598,11385,13828,27460,1138,27460,1138,7.06271e+18,94.4851,15569.8,28598,6666,111,14770,14770,14103,14445,13569
31252,6062,9955,29622,1630,29622,1630,2.60212e+18,96.9792,12258.6,31252,4741,111,21297,21297,18412,21111,14179
17266,4864,6738,0,17266,0,17266,5.17906e+17,91.2708,8114.04,17266,3243,110,10528,10528,9277,8104,8274
41635,5024,9675,14622,27013,0,41635,9.89939e+12,60.0811,12548.8,41635,4711,72,31960,31960,25174,30790,16949
10010,2336,3383,10010,0,9440,570,6.2318e+18,94.036,4146.43,10010,1119,122,6627,6627,6155,6601,4996
11143,3560,4034,10600,543,10600,543,3.0177e+18,94.8807,5063.57,11143,1932,110,7109,7109,6326,6664,6262
4286,1003,1042,1503,2783,0,4286,1.00385e+13,58.842,1533.12,4286,503,69,3244,3244,3207,3234,3213
32812,105,1662,0,32812,31841,971,4.69631e+16,299.013,5200.4,32812,279,26,30297,29916,18992,19634,4783
34479,3,12,33496,983,34465,14,1.38905e+14,10.1567,523.248,34479,12,11,26257,18471,22423,22754,13076
41104,4487,9566,14437,26667,0,41104,9.87593e+12,60.0563,12411.1,41104,4650,72,31538,31538,24932,30078,15132
4142,141,188,0,4142,4025,117,3.53503e+16,19.6939,549.105,4142,41,26,3954,3954,3736,3766,3321
16205,495,5090,13589,2616,15353,852,3.96811e+18,96.6046,6501.43,16205,2406,111,11115,11028,4757,5320,2141
3318,499,840,0,3318,1165,2153,2.49007e+15,57.9382,1247.98,3318,386,63,2478,2478,2110,1910,1677
16309,4808,6922,15587,722,15587,722,5.41071e+18,94.66,8169.43,16309,3305,111,9387,9387,7909,8143,7905
19744,4239,4666,0,19744,0,19744,6.48336e+17,97.4377,6465.27,19744,2244,110,15078,15078,14632,14372,14163
23596,2748,11570,22679,917,0,23596,1.49094e+18,93.5039,13087.4,23596,5608,110,12026,11940,7568,8963,6643
48796,14167,19709,46586,2210,0,48796,1.73459e+18,95.2121,22704.6,48796,9577,110,29087,29087,26210,25441,23488
15268,5697,6888,5946,9322,0,15268,7.11962e+12,56.357,7884.66,15268,3346,72,8380,8380,7716,8240,6783
21658,3702,8226,0,21658,0,21658,5.27648e+17,95.2636,9874.38,21658,3988,110,13432,13432,10092,9028,6563
44630,981,16059,16693,27937,0,44630,8.25827e+12,57.998,18682.9,44630,7818,72,28571,28475,17125,26601,3228
21315,6869,10750,21315,0,0,21315,8.80833e+17,17.9628,11164.1,21315,9661,20,10565,10565,7050,9611,6769
4792,211,1548,0,4792,1749,3043,2.26841e+15,57.6144,2038.56,4792,750,69,3244,3196,2018,1226,697
21115,1,12,20497,618,21104,11,1.66899e+14,10.2276,430.448,21115,12,11,4291,4291,4291,4291,4291
39263,6481,9165,36973,2290,36973,2290,5.74499e+18,97.8506,12237.7,39263,4435,110,30098,30098,28448,28182,22031
13381,1948,6974,12891,490,0,13381,1.407e+18,89.9364,7930.27,13381,3373,110,6407,6407,4128,3562,2169
39222,2,12,38103,1119,39207,15,1.38814e+14,10.2384,559.879,39222,11,12,22712,16084,15675,16584,10806
746,127,158,708,38,746,0,5.96397e+18,87.3539,315.357,746,48,40,588,559,527,526,519
5689,1199,2001,5689,0,5359,330,3.28071e+18,91.2211,2500.54,5689,713,95,3688,3688,2875,3176,2525
18133,11,12,17610,523,18125,8,1.49717e+14,10.2462,388.115,18133,12,11,18121,18121,18078,18079,18050
14783,400,3485,0,14783,5198,9585,2.52948e+15,59.8184,4741.81,14783,1692,72,11298,11298,6837,3190,1511
34314,79,176,34231,83,34314,0,6.02354e+18,172.413,2259.59,34314,170,169,27821,17020,14369,15647,15255
35010,59,1511,33554,1456,10212,24798,1.26519e+18,16.9937,2237.39,35010,1434,26,33499,33499,26429,27735,10950
3566,159,232,0,3566,3465,101,4.0252e+16,19.3031,608.145,3566,45,26,3334,3334,3164,3184,2275
3594,833,938,3384,210,3384,210,2.3242e+18,94.6093,1439.41,3594,422,76,2656,2656,2626,2656,2566
15361,1176,3759,14471,890,14471,890,1.30976e+18,97.6479,5217.67,15361,1757,111,11602,11602,11041,11165,4436
16693,228,3965,15723,970,15723,970,3.22192e+18,97.3445,5550.5,16693,1911,110,12728,12728,5422,8687,1591
42779,7034,10640,40339,2440,0,42779,2.1844e+18,97.6319,13881.1,42779,5151,110,32139,32139,27266,26318,21437
29573,8799,8920,27985,1588,27985,1588,1.88475e+18,97.2854,11165.8,29573,4251,111,20653,20653,20552,20644,20538
29010,5291,8455,27440,1570,27440,1570,3.24965e+18,96.8312,10734.1,29010,4092,110,20555,20555,16268,18021,14667
29937,50,1161,0,29937,29070,867,3.96621e+16,251.904,3671.07,29937,181,26,28267,28169,22795,19793,5608
6467,1579,1639,6097,370,0,6467,2.20145e+18,95.7231,2417.87,6467,773,94,4828,4828,4777,4792,4804
8838,4462,5347,0,8838,3684,5154,1.32829e+15,53.7594,5868.87,8838,2601,72,3491,3491,3436,3384,3463
6609,46,173,6607,2,6609,0,5.98127e+18,158.517,961.519,6609,110,113,4022,1882,1471,1782,1875
43292,9442,17534,41319,1973,41319,1973,5.24899e+18,93.6362,20200.5,43292,8408,111,25758,25758,17870,19237,14958
31666,5391,7882,0,31666,0,31666,6.36242e+17,97.5485,10439.7,31666,3817,110,23784,23784,21150,21500,16963
45139,6093,10478,15859,29280,0,45139,9.89605e+12,60.0816,13551.6,45139,5098,72,34661,34661,29365,33551,20522
9983,2111,2391,3515,6468,0,9983,9.86778e+12,59.5904,3318.44,9983,1158,72,7592,7592,7259,7522,6888
42819,7860,11798,15368,27451,0,42819,9.32179e+12,59.3721,14604.2,42819,5732,72,31021,31021,27219,30229,20892
9551,4,10,9279,272,9551,0,1.38306e+14,9.92702,269.509,9551,10,10,8260,7309,7424,6639,4943
26178,3277,8895,18027,8151,24851,1327,5.89537e+18,95.2413,10857.8,26178,4241,111,17283,17283,13664,15481,8014
41180,1384,9620,0,41180,0,41180,6.48278e+17,97.8492,12810.5,41180,4664,110,31560,31560,20352,8363,6340
41567,1157,18362,41567,0,39647,1920,4.54105e+18,587.982,20233.8,41567,4559,140,23205,22034,12008,15358,3066
27185,3121,6345,0,27185,0,27185,6.50681e+17,97.7493,8650.42,27185,3072,110,20840,20840,16404,12358,11068
9009,146,501,0,9009,8747,262,3.88323e+16,19.8151,1310.45,9009,70,26,8508,8500,6519,6674,2877
43195,4293,19393,0,43195,16834,26361,1.81864e+15,56.6331,21652.8,43195,9442,72,23802,23802,14916,8493,6452
25895,7105,8133,24535,1360,24535,1360,2.17223e+18,96.9729,10139.2,25895,3879,111,17762,17762,17645,17371,15384
38331,322,1746,0,38331,37201,1130,4.50475e+16,309.544,5599.5,38331,295,26,36382,35321,26397,26786,12253
2766,68,126,0,2766,2688,78,3.53515e+16,19.8691,385.621,2766,35,26,2640,2640,2279,2300,1704
40572,1002,12768,0,40572,14847,25725,2.26128e+15,58.779,15336.5,40572,6215,72,27804,27660,16959,3239,3767
13659,6,12,13257,402,13646,13,1.75533e+14,10.2953,346.738,13659,12,11,13105,12740,11816,11315,7032
41968,2323,10782,39598,2370,39598,2370,3.18017e+18,97.4959,13944.4,41968,5226,110,31186,31186,19186,24133,8998
47540,10118,18420,45310,2230,45310,2230,2.42095e+18,95.9265,21351.7,47540,8842,111,29120,29120,24352,28806,16760
4959,271,1197,0,4959,1740,3219,2.54274e+15,59.0008,1744.56,4959,579,72,3762,3762,1774,1262,921
42877,5428,10060,0,42877,0,42877,6.47282e+17,97.8449,13351.1,42877,4878,110,32817,32817,27578,23328,18802
30459,7777,8973,0,30459,11031,19428,2.32689e+15,57.7342,11057.8,30459,4348,72,21486,21486,21055,20981,20522
48039,22955,25578,0,48039,19418,28621,1.544e+15,54.6006,27735.7,48039,12443,72,22461,22461,21347,19953,20229
919,148,299,861,58,861,58,5.54066e+18,83.889,472.708,919,125,43,620,620,534,528,435
10088,1818,2390,9498,590,9498,590,5.83255e+18,96.8934,3483.84,10088,1143,110,7698,7698,7558,7558,6312
30647,2723,8535,28967,1680,0,30647,2.10074e+18,96.8549,10953,30647,4132,110,22112,22112,15464,13679,9194
35778,2482,13676,34098,1680,34098,1680,2.85879e+18,95.2732,16093.8,35778,6622,110,22102,22102,15086,15630,3970
4301,512,1431,1581,2720,0,4301,8.94962e+12,57.5396,1878.9,4301,697,66,2870,2822,1584,2504,970
40086,3570,9328,0,40086,14090,25996,2.53098e+15,60.0464,12114.6,40086,4532,72,30758,30758,21231,17298,12094
1681,665,1215,0,1681,0,1681,2.65008e+17,33.8543,1356.5,1681,551,48,466,466,466,466,466
6792,1477,2811,6482,310,0,6792,1.7414e+18,91.0534,3488.53,6792,1345,97,3981,3981,3268,3097,2939
26654,1,11,25889,765,26640,14,1.47929e+14,10.1238,465.691,26654,11,11,6374,6374,6374,6374,6374
47696,4961,19666,45566,2130,0,47696,1.71019e+18,94.2353,22576.5,47696,9540,110,28030,28030,18888,16781,8788
15952,484,5323,15952,0,15025,927,3.77125e+18,127.822,6261.36,15952,1922,121,10629,10581,4579,7579,1397
2088,77,612,739,1349,0,2088,9.28942e+12,56.217,890.713,2088,284,54,1476,1125,849,1330,197
45240,3868,16561,43060,2180,0,45240,1.84556e+18,95.7727,19519.5,45240,8039,110,28679,28593,12994,15894,8924
23921,1562,8912,23921,0,22621,1300,4.04686e+18,145.506,10085.4,23921,3426,122,15009,14863,7980,11094,3675
15313,1897,4710,14500,813,14500,813,2.42643e+18,96.6627,6072.52,15313,2228,111,10603,10603,5871,7495,5505
11750,3668,5933,11750,0,11260,490,5.90604e+18,139.444,6666.6,11750,2615,119,5817,5817,4811,5408,3410
43586,9831,15104,16191,27395,0,43586,8.41723e+12,58.1167,17722.5,43586,7336,72,28482,28482,24787,27845,20435
3362,327,843,1176,2186,0,3362,9.76864e+12,58.2302,1254.02,3362,397,63,2519,2519,1793,2389,1068
5369,22,589,0,5369,5207,162,5.22616e+16,18.7927,1336.3,5369,75,26,4770,4570,3076,2276,726
15944,868,869,0,15944,15478,466,4.21571e+16,155.827,2414.29,15944,121,26,15075,15075,15075,15074,15075
14214,261,3418,13392,822,13392,822,5.94437e+18,97.0848,4820.12,14214,1634,110,10796,10796,9511,8551,1512
15377,217,3677,14487,890,14487,890,5.90849e+18,97.1704,5166.68,15377,1761,110,11700,11663,10248,9150,1434
41336,10350,17901,41336,0,39386,1950,4.71253e+18,478.996,19758.3,41336,4961,138,23435,23219,18461,20795,14562
19993,289,763,0,19993,19423,570,3.56666e+16,89.5566,2219.37,19993,101,26,19230,19146,15507,15699,9843
42180,37,176,42093,87,42180,0,6.02281e+18,173.631,2503.78,42180,171,172,23764,7491,7953,9509,8746
47775,9926,13912,0,47775,17284,30491,2.33901e+15,59.1471,16925.1,47775,6771,72,33863,33863,30163,28181,24044
27368,741,6372,9613,17755,0,27368,9.86789e+12,59.9565,8416.45,27368,3089,72,20996,20996,7762,17362,2748
30546,1601,1747,0,30546,29629,917,5.01591e+16,300.444,5386.07,30546,296,26,28799,28799,28659,28622,27875
18668,3,13,18123,545,18654,14,1.69642e+14,10.1333,409.631,18668,12,11,14442,10861,10669,11837,6216
29199,3927,9032,29199,0,27500,1699,5.11116e+18,185.587,10623.8,29199,3489,127,20167,20158,15340,17346,9265
9062,948,2185,0,9062,3187,5875,2.52696e+15,59.5279,3043.23,9062,1063,72,6877,6877,5051,3286,2975
39821,6676,9308,37504,2317,0,39821,2.22953e+18,97.8273,12413.9,39821,4506,110,30513,30513,27607,26418,22895
48107,6147,11243,0,48107,0,48107,6.47867e+17,97.9116,14856.4,48107,5455,110,36864,36864,29928,24799,21378
37671,15442,18459,0,37671,8265,29406,1.33846e+13,8.99522,18863.9,37671,16612,11,19212,19212,16824,17116,16550
37469,965,8192,37469,0,37469,0,4.71274e+15,6400.95,17493.8,37469,8192,6,3856,0,2492,3856,3856
511,97,100,0,511,497,14,6.48659e+16,10.2622,196.909,511,24,20,411,411,411,410,410
27300,1,4,26447,853,27204,96,0.00010989,0.999853,328.671,27300,4,1,27296,27296,27296,27296,27296
15952,3441,7834,15322,630,15322,630,3.1884e+18,92.4779,8953.94,15952,3759,111,8118,8118,4991,5614,4364
29321,831,928,0,29321,28486,835,3.54869e+16,178.924,2969.74,29321,134,26,28393,28393,28118,28112,26428
28008,13710,14432,0,28008,6100,21908,1.34706e+13,8.97529,14770.2,28008,12984,11,13576,13576,13049,13576,13007
36797,11167,14009,0,36797,13894,22903,2.04425e+15,57.4231,16195.6,36797,6802,72,22788,22788,20718,19648,18354
24563,160,844,0,24563,23863,700,3.56196e+16,142.513,2591.69,24563,117,26,23672,23537,19966,20075,8229
45104,1269,1943,0,45104,43777,1327,4.45376e+16,316.425,6363.67,45104,337,26,43161,43161,41013,41632,33971
7731,9,13,7504,227,7694,37,1.64276e+14,10.8404,281.83,7731,12,11,7620,7535,6327,6246,5893
1819,228,506,1711,108,0,1819,2.2368e+18,90.6366,809.893,1819,222,57,1313,1313,971,908,782
42140,7409,9805,0,42140,14806,27334,2.528e+15,60.0517,12708.8,42140,4761,72,32335,32335,29420,25716,24628
17872,1045,4235,0,17872,0,17872,6.47744e+17,97.3922,5904.25,17872,2035,110,13637,13637,7454,6109,4242
