"data_size","cache_size","unique_size","reads","writes","data","ins","avg_step","avg_reuse_dist","sum_sqrt_count","sum_count","lis","lds","belady","lru","pivot","ld","mru"
43289,4479,10578,40806,2483,0,43289,2.1977e+18,97.6827,13862.3,43289,5129,110,42547,42547,42547,42547,42712
21754,179,1116,0,21754,21116,638,4.39421e+16,228.471,3304.52,21754,172,26,24073,23496,16083,17099,7012
24140,641,1017,0,24140,23440,700,3.9778e+16,203.286,3087.25,24140,152,26,28328,28328,17634,5866,3799
27846,5919,6929,26251,1595,0,27846,2.18788e+18,97.4932,9238.96,27846,3356,110,20917,20917,19549,19323,18161
682,7,10,663,19,682,0,1.69215e+14,8.41789,74.1,682,10,10,659,653,538,538,535
28262,4057,6662,26615,1647,26615,1647,5.76538e+18,97.6944,9031.24,28262,3218,110,19782,19782,14023,13149,8288
33872,719,1074,0,33872,32904,968,3.65139e+16,220.931,3521.2,33872,163,26,36129,36129,11355,29256,2803
37682,1305,1569,0,37682,36581,1101,4.27485e+16,296.303,5070.75,37682,263,26,37628,37628,37628,37628,37624
39367,12485,20009,8591,30776,0,39367,52551400000,8.99119,20415,39367,18004,11,36746,36746,36746,36746,36746
8916,2125,3411,3364,5552,0,8916,8.00113e+12,55.6312,4142.08,8916,1649,72,5505,5505,4456,5325,3394
13280,709,3185,0,13280,0,13280,6.48882e+17,97.0959,4515.52,13280,1533,110,10095,10095,5196,3051,2960
15091,5,12,14646,445,15078,13,1.77379e+14,10.1626,365.377,15091,12,11,13957,12625,12549,9692,7711
31385,5,15,30474,911,31332,53,1.65307e+14,10.3859,565.296,31385,13,12,4644,1557,755,623,557
36045,3048,8442,33947,2098,0,36045,2.22741e+18,97.8024,11312.3,36045,4088,110,35889,35889,35889,35889,35889
41793,5580,15730,0,41793,15751,26042,2.05997e+15,57.7848,18162.9,41793,7657,72,23872,23872,14835,15819,7887
41147,268,1511,0,41147,39952,1195,4.0476e+16,298.712,4995.26,41147,251,26,24734,23333,9322,15717,1278
11428,950,2732,0,11428,4014,7414,2.52385e+15,59.6432,3759.02,11428,1326,72,8696,8696,6061,3121,2974
3022,44,144,0,3022,2934,88,3.55519e+16,19.5549,424.596,3022,35,26,2878,2878,2511,2544,1214
19845,6096,6560,0,19845,7314,12531,2.21294e+15,58.1501,7986.93,19845,3175,72,13285,13285,12783,12408,12353
25557,933,6142,24067,1490,24067,1490,3.22307e+18,98.0925,8284.41,25557,2892,111,20702,20702,15458,14515,10015
10287,2356,3322,10287,0,9687,600,4.07177e+18,94.248,4109.28,10287,1251,117,6965,6965,5985,6413,5323
11483,10,14,11143,340,11410,73,1.79014e+14,9.61587,348.722,11483,13,12,242,212,229,25,30
45615,8874,12851,0,45615,16419,29196,2.36955e+15,59.2891,15784.7,45615,6251,72,37055,37055,37055,37055,37055
43240,3701,10398,40729,2511,40729,2511,3.76353e+18,98.301,13620.7,43240,4924,111,43864,43864,43864,43864,43864
24676,3339,8138,23412,1264,0,24676,1.95626e+18,96.1272,10067.6,24676,3945,110,16538,16538,12023,10916,7042
30060,105,1275,0,30060,29186,874,4.17531e+16,257.933,4007.57,30060,201,26,24193,13391,16481,7009,5905
32226,389,7574,30354,1872,0,32226,2.22694e+18,97.7187,10203.5,32226,3665,110,30132,30046,28924,28794,28104
22620,8,14,21968,652,22542,78,1.58607e+14,10.6867,483.444,22620,14,12,22143,21706,20822,19326,17086
27597,1199,8679,0,27597,0,27597,5.80819e+17,96.4176,10821.1,27597,4203,110,24974,24974,16396,14609,5310
35837,5544,12071,34017,1820,34017,1820,1.84852e+18,96.5645,14578,35837,5766,111,24369,24303,20690,22626,15532
37243,6374,8715,35075,2168,0,37243,2.22863e+18,97.8158,11660.6,37243,4221,110,44369,44369,44369,44369,44369
7539,1061,1861,7099,440,7099,440,3.56357e+18,96.7427,2726.58,7539,858,102,5678,5678,4193,4523,3731
24429,6030,10075,23337,1092,23337,1092,2.8138e+18,93.7826,11811.2,24429,4874,110,14354,14354,11162,12357,10364
4553,1006,2522,4553,0,4553,0,3.5982e+18,17.7246,2692.23,4553,2253,20,2031,2031,865,2031,912
23839,767,829,0,23839,23159,680,3.55195e+16,132.313,2522.07,23839,115,26,23010,23010,22839,22826,21868
5042,2734,3537,0,5042,0,5042,2.64944e+17,78.0647,3875.52,5042,1681,66,43811,43811,43811,43811,43811
25764,8034,10556,24604,1160,24604,1160,8.46504e+18,94.8357,12370.9,25764,5119,110,15208,15208,14928,14928,12107
9356,3500,5448,3860,5496,0,9356,5.44647e+12,54.0414,6012.51,9356,2643,72,3908,3908,3431,3828,3087
41259,16800,18995,39567,1692,39567,1692,2.55664e+18,94.1821,21423.7,41259,9219,110,34077,34077,34077,34077,34077
4676,156,208,0,4676,4539,137,3.54586e+16,19.7004,608.425,4676,44,26,14249,14249,14081,14149,13385
19948,1485,4710,0,19948,0,19948,6.47297e+17,97.4638,6526.04,19948,2269,110,29122,29122,13700,12150,6378
47841,5,15,46468,1373,47755,86,1.45265e+14,10.5164,700.393,47841,14,12,24103,20663,20501,20391,20213
37515,13450,13912,37515,0,35550,1965,4.67717e+18,274.92,15762,37515,3606,136,30388,30388,30388,30388,30388
30176,687,7086,28416,1760,28416,1760,5.75149e+18,97.7761,9582.99,30176,3434,110,23090,23090,17937,14117,3687
22542,3,12,21890,652,22529,13,1.52513e+14,10.3796,438.697,22542,12,11,2064,1340,1025,1049,1179
27975,6241,9229,26547,1428,0,27975,1.95333e+18,96.1631,11354.8,27975,4472,110,23018,23018,19920,18664,15088
45164,113,176,45031,133,45164,0,6.10484e+18,172.894,2631.6,45164,171,172,41654,37377,26138,27138,27151
48339,12593,18174,46049,2290,0,48339,1.81509e+18,94.3737,21256.3,48339,8813,110,31261,31146,29362,30402,26601
21758,783,1226,0,21758,21111,647,4.6759e+16,257.435,3616.89,21758,194,26,20532,20532,19762,19380,16065
23645,3034,5753,22273,1372,22273,1372,5.43048e+18,98.0043,7768.03,23645,2702,111,17892,17892,12740,13813,10294
39931,41,176,39875,56,39931,0,6.01888e+18,172.2,2424.48,39931,172,171,16277,2801,5086,10026,1008
39431,19109,19566,37921,1510,37921,1510,4.44381e+18,92.4662,21792.3,39431,9492,110,39085,39085,39085,39085,39085
37395,10026,15248,0,37395,0,37395,5.01567e+17,95.073,17667.3,37395,7404,110,36136,36136,36136,36136,36136
44625,10,14,43351,1274,44545,80,1.38994e+14,10.5893,659.294,44625,14,12,31925,30522,30263,30370,29940
37791,2517,24481,33498,4293,33498,4293,1.48176e+18,6.5243,28106.1,37791,8162,14,37011,37011,37011,37011,37011
34796,7285,9659,0,34796,0,34796,6.11007e+17,97.0927,12331,34796,4677,110,18858,18858,13547,16614,6975
14522,6157,7104,14522,0,13882,640,3.92052e+18,147.322,7900.44,14522,3025,121,7418,7418,7081,7294,6731
48734,2955,11352,17128,31606,0,48734,9.8921e+12,60.0913,14622.2,48734,5528,72,27634,16126,12539,7769,8664
14249,474,718,0,14249,13841,408,3.81452e+16,46.3047,1916.39,14249,92,26,22837,22808,22194,22281,18076
4091,23,1458,1516,2575,0,4091,8.30536e+12,56.7978,1883.11,4091,694,67,6497,536,1346,1829,34
4634,681,1153,0,4634,0,4634,6.48582e+17,95.2035,1767.79,4634,534,84,3481,3481,2976,2725,2424
24714,2940,5851,0,24714,8703,16011,2.51596e+15,59.8922,7728.93,24714,2835,72,31497,31497,17050,7265,4517
42908,3758,16022,40865,2043,40865,2043,7.7842e+18,95.6633,18836.6,42908,7787,110,26886,26800,24243,23813,13676
24279,10412,11582,24279,0,23199,1080,5.07657e+18,241.797,12739.8,24279,3048,130,23750,23750,23750,23750,23750
44746,8486,16220,42576,2170,0,44746,1.85572e+18,95.043,19168.7,44746,7877,110,44265,44265,44265,44265,44265
36295,12080,14506,36295,0,34438,1857,4.73209e+18,293.627,16100.3,36295,3365,136,35873,35873,35873,35873,35873
35872,1903,11107,0,35872,0,35872,5.84147e+17,96.4174,13746.9,35872,5377,110,24765,24765,11868,6281,5290
11728,7,13,11383,345,11686,42,1.70618e+14,9.99216,346.014,11728,11,11,11403,11218,10323,8705,6498
30068,7752,11406,28638,1430,28638,1430,5.23042e+18,96.0636,13489.7,30068,5470,111,31264,31264,29165,30794,25273
18306,4673,7146,0,18306,6940,11366,2.01894e+15,57.4417,8391.68,18306,3477,72,11160,11160,10115,8661,8552
19709,3350,9482,19709,0,18869,840,5.4214e+18,245.999,10602,19709,3610,127,10227,10132,7402,8671,3269
12945,5096,6346,0,12945,2840,10105,1.33632e+13,8.98069,6579.68,12945,5704,11,12615,27984,46928,46928,46928
15879,210,3803,14949,930,14949,930,2.87975e+18,97.864,5304.66,15879,1788,111,12076,12076,3989,6519,1555
31162,596,967,0,31162,30274,888,3.55663e+16,193.457,3137.8,31162,141,26,30195,29868,26294,26909,22555
10468,13,65,0,10468,9600,868,2.97924e+16,10.0331,375.688,10468,63,11,10403,10399,9645,8309,9974
37031,7603,11311,13480,23551,0,37031,8.95164e+12,58.8952,13719,37031,5505,72,25720,36067,31880,35345,26785
2967,843,1002,2807,160,2807,160,2.94035e+18,92.7334,1406.84,2967,453,64,1965,4950,4950,4950,4950
22915,8219,10829,21988,927,0,22915,1.54419e+18,93.8323,12351.3,22915,5257,110,19534,19534,18326,16904,10746
27477,4069,9037,26067,1410,0,27477,1.95965e+18,96.1967,11132.1,27477,4384,110,24763,20676,12315,16814,6136
44156,8187,10349,41587,2569,41587,2569,5.89609e+18,97.8695,13718.3,44156,5018,110,44035,44035,44035,44035,44035
12442,3846,5964,11942,500,0,12442,1.53406e+18,93.2963,6925.64,12442,2886,110,6478,6478,5567,5324,5089
1173,40,375,1103,70,0,1173,2.23133e+18,84.7587,586.568,1173,157,48,431,84,226,146,10
45376,3401,18589,45376,0,43396,1980,4.68031e+18,2178.99,21657.4,45376,7945,146,23345,23345,18155,16722,13651
30111,4218,6992,0,30111,10580,19531,2.53307e+15,60.0203,9200.52,30111,3401,72,22134,22134,17256,21094,11094
8433,480,734,0,8433,8185,248,4.81068e+16,57.2861,1764.76,8433,94,26,7699,7651,7319,7236,5058
39540,9928,13247,0,39540,0,39540,5.62565e+17,96.2186,16009.3,39540,6425,110,37577,37577,35518,37183,32349
41150,2898,9611,38753,2397,38753,2397,5.75772e+18,97.8503,12800.9,41150,4656,110,33079,33079,26299,17212,18008
20322,162,175,20319,3,20322,0,5.97716e+18,165.993,1687.1,20322,157,154,18653,18444,15758,13468,13260
1816,1,12,1766,50,1772,44,1.38258e+14,10.641,119.879,1816,11,11,458,458,458,458,458
24146,312,7362,22856,1290,22856,1290,3.42882e+18,95.8153,9283.29,24146,3481,111,23347,23086,12785,16442,1671
46206,5857,14481,43796,2410,0,46206,1.99688e+18,96.6382,17689.5,46206,7032,110,36503,36503,30375,34949,19903
44417,5225,17732,0,44417,0,44417,5.08729e+17,95.2522,20526.8,44417,8616,110,34100,34070,29033,31462,25257
19174,1292,4971,18077,1097,18077,1097,3.89979e+18,97.655,6661.08,19174,2349,111,14203,14203,7763,9655,4730
49850,8439,20444,0,49850,0,49850,4.98695e+17,95.0984,23463.3,49850,9932,110,33379,33214,26321,29154,22182
21553,2385,5260,20299,1254,20299,1254,2.44414e+18,97.9605,7134.39,21553,2477,111,16293,16293,12678,15053,8200
40176,6371,9348,0,40176,14120,26056,2.53338e+15,60.0574,12136.1,40176,4548,72,32834,32834,29163,31897,21730
8190,759,3532,7830,360,7830,360,3.07105e+18,90.4326,4284.14,8190,1665,101,4658,4484,1952,2710,1465
26254,3519,11725,25147,1107,0,26254,1.61635e+18,94.2852,13475.2,26254,5682,110,37184,0,0,0,7743
32285,4155,7780,30410,1875,30410,1875,3.93827e+18,98.1696,10342.7,32285,3672,111,37469,37469,37469,37469,37469
29882,13,14,29021,861,29827,55,1.55837e+14,10.5825,544.956,29882,13,11,29868,29868,29459,29460,28865
42474,7,15,41253,1221,42389,85,1.45887e+14,10.5513,661.364,42474,14,12,4197,1067,753,336,160
42151,3218,9849,0,42151,0,42151,6.47e+17,97.8352,13101.5,42151,4765,110,46952,46952,46952,46952,46952
29972,7062,13691,29972,0,28588,1384,4.59116e+18,281.913,15041.7,29972,5882,132,16281,16108,12488,14236,26497
1284,289,353,444,840,0,1284,9.92042e+12,55.4525,552.436,1284,168,46,1164,1164,1164,1164,4896
18188,10481,10589,17598,590,17598,590,4.13375e+18,92.7305,11657.2,18188,5112,111,7599,7599,7451,7508,7508
5767,40,644,0,5767,5595,172,5.28031e+16,19.0544,1452.24,5767,83,26,5123,5091,2877,3285,947
13750,162,186,13686,64,13027,723,5.98048e+18,178.574,1417.87,13750,141,141,13348,12794,11855,11926,11896
26024,7350,8318,24674,1350,0,26024,1.98486e+18,96.3182,10353.4,26024,4027,110,17706,17706,16821,16623,16215
23634,1740,10598,22637,997,0,23634,1.61208e+18,94.2644,12212.6,23634,5143,110,12147,12147,9659,6620,5926
35767,7515,10114,33817,1950,0,35767,2.08777e+18,97.0423,12828.2,35767,4903,110,45845,45845,45845,45845,45845
536,265,280,0,536,0,536,3.42315e+15,16.694,331.516,536,239,20,256,256,251,251,256
10681,2436,2718,0,10681,3786,6895,2.46974e+15,59.3,3677.32,10681,1319,72,7963,7963,7639,7429,7268
24812,99,176,24799,13,24812,0,5.99701e+18,170.183,1895.89,24812,156,161,45972,3607,376,7932,35
27149,10290,11109,25929,1220,25929,1220,8.29091e+18,94.4246,12999.3,27149,5371,110,19814,19814,19814,19814,19814
12199,1130,2936,11489,710,0,12199,2.22544e+18,96.9804,4186.86,12199,1408,110,9263,9263,6882,6442,4261
42664,2304,11690,40287,2377,40287,2377,3.45332e+18,97.3915,14763.1,42664,5555,111,32666,32666,16706,11405,7757
41410,2897,8192,41410,0,41410,0,4.47853e+15,6571.4,18413.9,41410,8192,6,15901,18992,11272,17671,2038
19701,5780,8906,19701,0,18798,903,5.32286e+18,194.409,10014.6,19701,2436,128,10795,10757,9673,10462,7770
30619,1518,7109,10759,19860,0,30619,9.89251e+12,60.0124,9347.83,30619,3457,72,26630,26630,15286,7830,2282
36264,4732,8452,12742,23522,0,36264,9.88246e+12,60.0398,11018,36264,4112,72,35351,35351,23374,32342,13529
4588,642,2265,4588,0,4378,210,3.86584e+18,71.6953,2643.74,4588,906,83,2323,2323,1132,1606,725
38175,9,16,37057,1118,38090,85,1.6657e+14,10.575,622.558,38175,13,13,37731,37291,35265,30612,24891
36197,6,15,35136,1061,36135,62,1.70898e+14,10.4375,646.971,36197,13,11,12168,8659,7462,7406,7278
10883,9,11,10569,314,10876,7,1.57096e+14,10.0361,301.779,10883,11,11,28641,28399,27781,27786,0
9916,306,574,0,9916,9629,287,3.94224e+16,19.7253,1477.39,9916,74,26,21493,19633,12082,9731,1795
11091,2690,2762,10451,640,10451,640,4.43241e+18,97.2354,3905.59,11091,1293,111,8329,8329,8290,8325,8298
20154,5329,5855,0,20154,7290,12864,2.35155e+15,59.0313,7362.18,20154,2846,72,14299,14299,13616,12765,13026
48396,1967,2084,0,48396,0,48396,3.83782e+18,15.9963,2916.17,48396,1714,26,48354,48354,48354,48354,48354
25765,5992,9503,24527,1238,24527,1238,7.67994e+18,95.4996,11408.5,25765,4605,110,28053,28053,23548,21465,16182
23902,2500,11844,22982,920,0,23902,1.47461e+18,90.6339,13369.5,23902,5729,110,12058,12058,8164,6774,4257
16426,1,13,15958,468,16360,66,1.38955e+14,10.8524,388.738,16426,12,12,10,10,10,10,10
553,17,49,0,553,538,15,4.00031e+16,16.2242,125.197,553,22,21,496,466,359,354,209
40900,9,15,39709,1191,40847,53,1.59925e+14,10.4163,644.311,40900,12,12,9230,4855,4218,4342,3209
787,263,280,277,510,0,787,8.63741e+12,48.8513,409.535,787,114,39,507,507,507,507,507
25829,5232,6169,0,25829,9104,16725,2.50834e+15,59.7841,8109.61,25829,2991,72,20586,20586,20586,20586,20583
46226,1773,11648,0,46226,0,46226,6.31901e+17,97.5805,15079.5,46226,5643,110,34821,34821,22220,20252,6461
10937,830,4199,10421,516,10421,516,2.86012e+18,94.516,5187.86,10937,2018,110,6738,6576,4564,5034,1732
6928,769,1666,6518,410,0,6928,2.24992e+18,96.3574,2490.92,6928,792,98,5262,5262,4140,3841,2864
21314,45,176,21291,23,21314,0,6.14293e+18,171.021,1804.19,21314,148,144,14088,5440,5255,5622,5459
13684,68,176,13670,14,13684,0,6.10929e+18,167.077,1448.97,13684,130,128,15593,9543,4024,213,360
28388,4807,6688,0,28388,0,28388,6.46975e+17,97.6951,9071.98,28388,3232,110,21783,21089,19110,19419,0
2495,500,894,2495,0,2345,150,2.99616e+18,88.1764,1193.99,2495,316,62,20077,19651,12387,6497,1148
25467,2599,5994,8957,16510,0,25467,9.87053e+12,59.936,7915.88,25467,2916,72,19473,19473,14551,18623,8644
30963,1662,7195,0,30963,10875,20088,2.52777e+15,59.9925,9453.93,30963,3491,72,33494,33494,33494,33494,33494
4243,977,1131,0,4243,0,4243,6.38376e+17,94.5341,1697.72,4243,528,81,3112,3112,2949,2994,2918
40502,1019,14859,40502,0,38321,2181,4.83042e+18,293.378,16585.4,40502,3910,133,28065,27893,21922,13808,13952
47363,4052,21896,45413,1950,45413,1950,3.24371e+18,94.1805,24540.6,47363,10530,111,27376,27376,11759,10993,10999
31644,4624,7396,0,31644,11122,20522,2.5283e+15,60.0138,9692.4,31644,3596,72,24248,24248,20941,19179,15504
2983,552,768,0,2983,0,2983,6.68422e+17,93.7278,1208.46,2983,355,69,2215,2215,0,0,0
2149,10,875,812,1337,0,2149,7.90382e+12,55.235,1127.87,2149,420,58,395,120,51,215,20
18275,137,5117,17273,1002,0,18275,2.10347e+18,96.685,6743.43,18275,2468,110,18726,12708,10821,9735,1288
47440,1290,3054,0,47440,9651,37789,1.46514e+16,11.9954,3760.94,47440,1939,14,38069,38069,27031,25102,13192
31508,3,14,30596,912,31428,80,1.53646e+14,10.6075,573.996,31508,14,12,24237,17662,18265,19404,11199
26997,3,14,26209,788,26910,87,1.67444e+14,10.2797,530.056,26997,13,12,7638,6787,6378,6500,6150
45547,18067,19915,0,45547,17645,27902,1.85836e+15,56.7785,22315.5,45547,9684,72,25632,25632,23854,22794,21841
37727,1391,8847,0,37727,13266,24461,2.52401e+15,60.0263,11495.2,37727,4301,72,35893,35893,34988,34935,32272
45780,5788,26551,18893,26887,0,45780,5.41686e+12,54.5552,28456.1,45780,12929,72,32805,32805,29208,31295,24708
8251,2137,3154,0,8251,3111,5140,2.05521e+15,52.8444,3844.45,8251,1530,72,5097,5097,4003,2524,2348
6754,5,11,6561,193,6749,5,1.46906e+14,10.8617,233.83,6754,11,11,30200,29596,28525,0,0
47456,8622,11056,44694,2762,0,47456,2.22969e+18,97.8898,14632.4,47456,5356,110,46023,46023,46023,46023,46023
37721,11,12,36642,1079,37704,17,1.43316e+14,10.2056,554.969,37721,11,12,11116,3715,962,5075,258
13097,184,849,0,13097,12709,388,4.50601e+16,147.065,2265.77,13097,117,26,12219,12044,9169,9632,5355
43921,450,1383,0,43921,42658,1263,3.78524e+16,273.404,4692.38,43921,226,26,30143,29759,11289,4899,984
23650,6594,8515,22500,1150,22500,1150,7.73798e+18,95.575,10323,23650,4115,110,15135,15135,15135,15135,11252
34452,5,8,33887,565,34388,64,9.80734e+13,3.99765,477.49,34452,6,4,14177,11580,11307,10657,10527
23875,6789,6836,8613,15262,0,23875,9.20101e+12,59.0958,8567.14,23875,3319,72,43712,43712,43712,43712,43712
9551,4815,5344,9551,0,0,9551,8.94471e+17,17.2768,5595.04,9551,4800,20,4207,4207,3869,4048,3895
1526,1,11,1484,42,1524,2,1.37417e+14,10.2733,110.012,1526,11,11,396,396,396,396,396
15397,498,4846,15397,0,14506,891,3.14644e+18,127.723,5875.24,15397,1852,121,10551,10507,5451,7077,1489
37306,5309,8948,35136,2170,35136,2170,2.70579e+18,98.2677,11820.4,37306,4225,111,28358,28358,24545,28091,17931
14178,124,6243,0,14178,0,14178,4.78899e+17,93.9044,7357.9,14178,3022,110,7935,3797,3214,161,937
35618,1222,1714,0,35618,34566,1052,4.60693e+16,309.495,5437.58,35618,289,26,23963,23492,10557,16677,2099
11287,1201,6377,0,11287,4615,6672,1.45103e+15,51.131,7045.71,11287,3088,72,29497,29497,29497,29497,29497
14439,2535,7384,14439,0,13829,610,4.32305e+18,151.351,8163.66,14439,2944,125,7055,6912,4760,5676,2925
3733,145,195,0,3733,3626,107,3.72545e+16,19.5982,546.661,3733,42,26,3538,3538,3435,3459,3195
19119,3246,9267,0,19119,7566,11553,1.70569e+15,52.5076,10400.2,19119,4492,72,9852,9852,6160,4813,2945
37402,14084,16987,0,37402,14603,22799,1.80194e+15,56.5369,18985.9,37402,8270,72,28485,28485,28433,28433,28433
6518,742,2396,6198,320,6198,320,4.14927e+18,92.1698,3086.03,6518,1112,95,22358,22271,10473,17973,1924
28233,293,1193,27057,1176,8235,19998,1.2647e+18,16.9878,1841.01,28233,1187,18,27040,27040,22549,23446,12749
3695,1116,2034,0,3695,0,3695,3.91735e+17,89.4146,2396.7,3695,957,69,1661,1661,1437,1410,1441
19040,5837,6003,6956,12084,0,19040,8.84627e+12,58.6019,7405.32,19040,2920,72,25393,25393,25393,25393,25393
44665,17,18,43343,1322,44535,130,1.79705e+14,10.4871,756.45,44665,14,13,16417,4145,0,0,0
2428,348,1034,2316,112,2316,112,4.73394e+18,76.0498,1352.18,2428,466,58,3632,3460,2168,1966,978
19590,1060,4590,6888,12702,0,19590,9.88404e+12,59.8821,6154.6,19590,2225,72,19316,19316,19316,19316,19316
44337,5857,11960,0,44337,0,44337,6.17603e+17,97.3093,15216,44337,5801,110,44159,44159,44159,44159,44159
7980,109,1941,0,7980,2807,5173,2.5065e+15,59.3877,2722.67,7980,938,72,6039,5991,3448,1200,434
4429,1386,4429,4429,0,0,4429,134187000,0,4429,4429,4429,1,0,0,0,0,0
36989,1681,11251,0,36989,13462,23527,2.2923e+15,58.8915,13660.9,36989,5465,72,26642,26403,17743,21087,10878
49705,1176,1719,0,49705,48263,1442,4.018e+16,299.38,5829.8,49705,292,26,49475,49475,49475,49475,49475
26500,145,176,26489,11,26500,0,5.97968e+18,169.624,1930.07,26500,164,161,25780,24197,21976,22016,21863
41120,2740,9863,0,41120,0,41120,6.44252e+17,97.7593,13027.8,41120,4786,110,33155,33155,24315,23039,17322
24839,3627,9439,23666,1173,23666,1173,7.86992e+18,94.2331,11270.8,24839,4560,110,15400,15400,13909,13661,8144
17794,106,175,17788,6,17794,0,5.9941e+18,165.646,1579.43,17794,153,149,36014,35799,20335,6533,550
11645,269,574,3450,8195,3450,8195,1.8603e+18,15.9743,970.836,11645,493,18,11071,11071,7608,8690,7391
4441,317,1515,0,4441,1639,2802,2.25153e+15,57.3574,1970.2,4441,737,72,2926,2878,2024,1111,1119
10401,917,3366,10401,0,9794,607,3.66535e+18,94.2279,4156.98,10401,1269,118,7035,7035,4337,5482,2364
28222,2028,14524,0,28222,0,28222,4.12166e+17,90.8402,16199.9,28222,7051,110,13698,13698,7492,3521,2960
24560,599,5830,0,24560,0,24560,6.45846e+17,97.5393,7955.2,24560,2811,110,22100,22014,17541,12887,3241
25641,12,14,24890,751,25578,63,1.68857e+14,10.3391,500.335,25641,13,12,25626,25622,24966,24966,21811
35305,2,12,34301,1004,35294,11,1.38796e+14,10.2364,530.286,35305,11,12,16050,15565,15556,15718,15489
11595,185,481,0,11595,11238,357,4.72928e+15,5.44571,2184.67,11595,126,7,11114,11114,10764,10616,9821
30306,256,14859,30306,0,30306,0,2.82937e+18,17.9834,15363.2,30306,13365,20,31900,31402,11859,20142,1215
33115,19,208,33089,26,33115,0,6.05974e+18,202.07,2391.64,33115,181,175,38650,38561,38560,38535,37822
23918,5111,5622,0,23918,0,23918,6.46902e+17,97.568,7711.28,23918,2711,110,18296,18296,17732,17900,17113
12477,2859,4157,11837,640,11837,640,6.67187e+18,96.0799,5299.95,12477,1969,111,8320,8320,7479,7871,6723
20665,2623,6461,19577,1088,0,20665,2.00859e+18,96.3191,8179.19,20665,3129,110,32767,0,0,266,186
6755,136,2967,6755,0,6418,337,4.61111e+18,91.4195,3474.71,6755,1173,99,3788,1215,1389,2364,522
2310,178,1187,0,2310,0,2310,3.43715e+15,16.9641,1310.89,2310,1051,20,1123,1123,236,1055,217
6359,4,11,6176,183,6354,5,1.38192e+14,10.8907,223,6359,11,11,5569,4969,4717,4716,2962
42480,31,176,42462,18,42480,0,5.9839e+18,172.113,2446.87,42480,172,172,44755,44533,32444,28593,6782
42087,5823,11892,15156,26931,0,42087,9.24833e+12,59.2718,14635.1,42087,5788,72,39778,39778,39778,39778,39778
8246,2801,4092,8246,0,7876,370,6.46387e+18,101.86,4634.7,8246,1716,107,4154,4134,3586,3952,3377
18764,7429,9215,18034,730,18034,730,9.49513e+18,93.4232,10496.6,18764,4466,110,47952,47952,47952,47952,47952
43844,10,14,42588,1256,43760,84,1.43119e+14,10.534,656.134,43844,14,12,43641,43287,42422,42155,38532
30173,5873,15556,0,30173,0,30173,3.44913e+15,17.978,16045.8,30173,13984,20,15194,15194,11060,11244,4713
17549,8072,8936,17549,0,13013,4536,4.12131e+18,165.281,9823.83,17549,3891,122,34405,43544,0,0,0
40662,1133,1146,0,40662,39500,1162,3.55929e+16,241.527,3916.86,40662,177,26,43116,43030,41911,41932,39404
6827,1739,1743,6428,399,6428,399,5.47251e+18,96.6354,2539.38,6827,814,97,5084,5084,5081,5083,5084
22064,24,296,22062,2,22064,0,5.57382e+18,202.621,1138.65,22064,268,38,47179,46812,31914,35892,31706
2162,6,10,2094,68,2162,0,2.12083e+14,9.4445,134.636,2162,10,10,762,630,593,546,505
46540,2524,10901,43833,2707,43833,2707,3.36071e+18,97.8741,14415.9,46540,5282,110,36464,36464,26455,16551,18223
9678,2,12,9401,277,9671,7,1.39312e+14,10.2535,275.855,9678,12,11,6611,3975,3825,4031,3137
31558,1156,1277,0,31558,30640,918,4.09951e+16,251.91,4054.04,31558,202,26,30281,30281,30130,30117,29388
12372,6310,8231,12049,323,12049,323,8.08214e+18,85.8029,8922.26,12372,3956,99,4141,33836,33752,0,0
36233,549,1060,0,36233,35199,1034,3.55505e+16,220.23,3546.25,36233,161,26,37779,37283,31425,32293,23621
16229,2,12,15766,463,16216,13,1.39064e+14,10.5294,360.137,16229,12,11,9387,6644,6495,6886,5564
5176,570,1988,5176,0,4888,288,5.06418e+18,85.5904,2446.33,5176,737,95,3188,3188,1615,2212,828
39642,7573,9325,37340,2302,37340,2302,5.78201e+18,97.8101,12418.1,39642,4512,110,34162,34162,34162,34162,34162
3622,604,1335,3622,0,3415,207,5.9122e+18,89.6328,1709.99,3622,471,78,2287,2287,1764,2077,1279
23258,105,175,23250,8,23258,0,5.98317e+18,166.542,1804.1,23258,155,161,23467,23191,6341,612,599
47591,10,14,46233,1358,47511,80,1.3896e+14,10.377,654.574,47591,13,12,7567,1528,1001,3768,161
48634,172,1292,0,48634,47248,1386,3.55636e+16,263.282,4547.45,48634,207,26,38907,38491,26302,31862,20477
6143,224,269,0,6143,5965,178,3.5413e+16,19.89,774.355,6143,48,26,5874,5874,5789,5795,5295
5934,410,429,0,5934,5763,171,4.27076e+16,19.5362,1064.67,5934,63,26,5505,28830,28555,28799,28067
48470,8123,11336,0,48470,0,48470,6.48373e+17,97.8961,14965.9,48470,5500,110,34166,34166,28393,27482,21962
41609,2494,9758,0,41609,0,41609,6.47387e+17,97.864,12975.7,41609,4733,110,26637,25852,12484,17329,3279
32916,576,1742,9864,23052,0,32916,6.91396e+18,15.9909,2418.43,32916,1367,18,26005,25575,10323,15044,3400
15347,3585,7631,14757,590,0,15347,1.47529e+18,87.8183,8726.86,15347,3691,110,7716,7716,5649,5113,3373
4129,174,190,0,4129,4012,117,3.53569e+16,19.6781,549.707,4129,41,26,3939,3939,3912,3914,3851
21390,2,11,20780,610,21384,6,1.38724e+14,10.1199,408.361,21390,11,11,15866,11590,6702,5972,3261
44253,720,13986,0,44253,0,44253,5.78528e+17,96.5661,17073.5,44253,6789,110,35984,35984,25183,34059,12008
49315,9122,11485,17334,31981,0,49315,9.88464e+12,60.0824,14790,49315,5589,72,49211,49211,49211,49211,49211
5800,830,1514,5463,337,5463,337,2.86385e+18,96.0045,2219.01,5800,694,91,5485,5485,5485,5485,5485
22556,9230,11440,9008,13548,0,22556,6.37548e+12,55.612,12679.3,22556,5568,72,18910,18910,13572,15077,5501
30720,59,176,30711,9,30720,0,5.98097e+18,169.729,2076.93,30720,166,164,13636,13636,10797,11434,4914
46770,5487,12926,16794,29976,0,46770,9.333e+12,59.3845,15937.9,46770,6291,72,36321,36321,30150,35006,20324
34538,1291,8050,0,34538,12141,22397,2.53046e+15,60.0544,10518.6,34538,3916,72,26488,26488,11109,8444,4486
10910,320,2650,10280,630,10280,630,5.91571e+18,96.8248,3801.35,10910,1258,110,8260,8260,7303,6658,1394
34644,8470,9582,0,34644,12449,22195,2.38884e+15,59.3427,11939,34644,4665,72,29507,29507,29507,29507,27194
13194,3243,4774,12542,652,12542,652,2.98941e+18,95.6633,5922.71,13194,2266,111,8420,8420,7567,8370,6868
46012,10835,17517,0,46012,17368,28644,2.04122e+15,57.7197,20135.7,46012,8523,72,45547,45547,45547,45547,45547
5051,480,1702,4791,260,0,5051,1.9797e+18,93.9774,2299.97,5051,800,83,3349,3263,2038,2180,1810
15102,3,11,14656,446,15088,14,1.77623e+14,10.0222,362.774,15102,11,11,11707,9120,7301,8255,5999
29125,5491,9644,27633,1492,27633,1492,3.72737e+18,96.7513,11795.2,29125,4593,111,26202,25744,17660,15147,8986
20396,253,764,0,20396,19815,581,3.55165e+16,89.7483,2235.59,20396,101,26,19632,19546,15560,15697,9602
1723,35,494,0,1723,0,1723,6.46033e+17,89.4562,781.572,1723,218,55,601,90,339,40,105
33619,660,1051,0,33619,32569,1050,0.0312323,0.968738,5944.08,33619,1051,1,32568,32568,32568,32568,32568
42704,2145,22847,0,42704,17294,25410,1.53747e+15,54.723,24803.3,42704,11125,72,29173,28709,17002,21854,8309
35189,121,176,35117,72,35189,0,5.98013e+18,169.793,2222.06,35189,170,167,27665,27326,24019,26444,21947
26095,7790,7928,0,26095,0,26095,5.88669e+17,96.5178,10005.9,26095,3831,110,47282,47282,47282,47282,47282
48825,7735,15851,0,48825,0,48825,5.70339e+17,96.4328,19156.3,48825,7689,110,38905,38905,38673,38447,35923
3858,708,993,3638,220,0,3858,2.2172e+18,94.1407,1528.05,3858,450,79,2865,2865,2575,2468,2341
20348,80,764,0,20348,19767,581,3.5533e+16,87.444,2232.71,20348,102,26,33725,33725,33725,33725,33725
13247,4084,5901,12687,560,12687,560,2.69169e+18,88.4613,6957.03,13247,2837,110,7346,7346,6491,7118,5445
1676,114,431,586,1090,0,1676,1.01324e+13,57.0591,677.907,1676,209,51,1245,1245,789,1165,422
46266,9399,13480,43776,2490,0,46266,2.0606e+18,96.246,16773.4,46266,6538,110,46117,46117,46117,46117,46117
47434,1731,1746,0,47434,46057,1377,4.12333e+16,299.332,5849.37,47434,298,26,37818,37818,20349,32943,12163
6327,459,2692,0,6327,0,6327,4.92657e+17,92.9641,3327.49,6327,1279,94,3635,3463,2468,1552,1494
15433,4708,6582,14753,680,14753,680,8.66741e+18,91.8161,7791.72,15433,3183,110,8851,8851,8721,8721,7650
45890,9,17,44541,1349,45787,103,1.74442e+14,10.4209,741.288,45890,14,13,22273,18143,16157,20230,15028
41532,122,176,41468,64,41532,0,6.08045e+18,173.194,2519.45,41532,166,170,39112,35468,36062,35356,32621
1266,29,155,1265,1,759,507,6.11203e+18,79.4305,413.514,1266,57,54,8630,8188,8209,8159,8124
29073,3320,11541,27733,1340,0,29073,1.76122e+18,95.1508,13558.8,29073,5603,110,23445,23445,15526,10828,6248
30392,10004,14514,30392,0,26942,3450,1.70007e+18,2959.84,19014.1,30392,6159,23,19968,20614,0,0,10684
22546,61,176,22473,73,22546,0,6.05908e+18,171.673,1848.19,22546,151,156,16340,9839,7096,7851,7605
18871,1425,6423,17921,950,0,18871,1.92838e+18,95.7851,7980.44,18871,3103,110,21913,37664,23999,8600,6863
41467,2,14,40284,1183,41390,77,1.38793e+14,10.4871,617.934,41467,13,12,24007,16997,16559,17617,11368
36568,377,9348,34498,2070,34498,2070,3.17895e+18,97.4606,12186.3,36568,4522,110,30436,30264,26487,23866,16592
36166,358,1059,0,36166,35135,1031,3.55447e+16,220.132,3540.74,36166,160,26,26039,26039,7161,6169,48
10448,2246,4917,10448,0,9978,470,4.19945e+18,137.748,5622.91,10448,2111,115,5531,5464,3496,4375,2117
40407,5785,9488,0,40407,0,40407,6.47361e+17,97.8435,12629.5,40407,4598,110,30734,30734,20490,21154,16018
26244,7,176,26231,13,26244,0,5.98953e+18,169.608,1920.74,26244,158,164,4781,906,167,654,19
30355,9910,14269,30355,0,29055,1300,4.7623e+18,424.538,15869.8,30355,4270,137,25653,25653,25653,25653,25653
32533,5,12,31606,927,32519,14,1.39003e+14,10.1569,507.974,32533,12,11,0,0,118,744,5
28708,2368,9620,0,28708,0,28708,5.62232e+17,95.6657,11778.3,28708,4646,110,21917,21917,13033,19265,4969
16264,66,175,16259,5,16264,0,5.98666e+18,165.056,1510.19,16264,150,148,11828,6461,5449,6323,6161
18700,4100,4380,6569,12131,0,18700,9.90014e+12,59.9054,5889.75,18700,2130,72,44751,44751,44751,44751,44751
16513,3880,3886,5808,10705,0,16513,9.8744e+12,59.835,5254.93,16513,1883,72,12627,12627,12627,12627,12627
39490,2243,9872,37220,2270,37220,2270,3.383e+18,96.9237,12842.1,39490,4676,111,29618,29618,16077,20315,8619
9025,2066,2275,8505,520,8505,520,2.80553e+18,96.8806,3256.96,9025,1056,110,6750,6750,6568,6735,6450
15845,12,14,15382,463,15800,45,1.72349e+14,10.5636,403.771,15845,13,11,15831,15830,15800,15800,15515
46912,1,14,45573,1339,46832,80,1.38944e+14,10.4121,654.398,46912,13,12,34887,34887,34887,34887,34887
569,9,183,207,362,0,569,1.0198e+13,50.4499,287.153,569,89,35,120,45,13,64,23
12945,1,11,12575,370,12939,6,1.39118e+14,10.3508,319.129,12945,11,11,176,176,176,176,176
33445,78,176,33368,77,33445,0,5.98077e+18,169.555,2166.29,33445,169,167,33210,33037,33048,32993,33040
37104,119,176,37018,86,37104,0,6.08101e+18,173.575,2382.06,37104,165,167,46198,45989,31378,31285,11300
24128,12390,13215,23287,841,23287,841,3.57614e+18,93.3742,14604.5,24128,6369,111,10913,10913,10673,10686,10828
48683,8,61,48587,96,48683,0,2.32834e+18,60.8637,1640.4,48683,61,61,16064,12084,11278,13694,11584
43262,12801,17114,43262,0,41142,2120,4.54207e+18,544.324,19346,43262,5221,140,42926,42926,42926,42926,42926
9079,94,175,9075,4,9079,0,5.9796e+18,161.834,1131.18,9079,123,127,28156,25536,15913,4968,677
6095,841,3524,6095,0,5865,230,5.82413e+18,92.5137,3929.45,6095,1520,84,2571,2381,1481,1967,930
36567,1,12,35523,1044,36552,15,1.38832e+14,10.3287,543.126,36567,12,11,4275,4275,4275,4275,4275
15747,198,4601,5696,10051,0,15747,9.1679e+12,58.9612,5843.53,15747,2241,72,11146,11050,6457,10336,866
20583,1982,8419,19653,930,19653,930,4.31466e+18,92.518,9952.57,20583,4062,110,12164,12164,8825,9541,3487
10307,12,13,10005,302,10241,66,1.64947e+14,10.8278,317.275,10307,13,12,31857,31760,32203,0,24
40334,7654,9415,37984,2350,37984,2350,5.88825e+18,97.8599,12556.2,40334,4563,110,40131,40131,40131,40131,40131
2709,100,128,0,2709,2632,77,3.54037e+16,19.598,383.007,2709,34,26,2581,2581,2455,2465,2313
17850,4489,8607,17850,0,17078,772,3.95593e+18,196.673,9628.72,17850,3850,123,28824,28824,22092,20578,13828
29564,1236,9336,28024,1540,0,29564,1.99349e+18,96.4307,11591,29564,4524,110,20228,20228,12535,11217,3391
34390,6779,15075,0,34390,0,34390,4.75802e+17,93.3652,17254.1,34390,7308,110,29168,29168,21182,14861,12053
1678,90,163,1633,45,1678,0,6.30019e+18,119.013,489.043,1678,61,59,1426,1218,913,884,829
45371,10673,17801,43278,2093,0,45371,1.76862e+18,95.3471,20670.3,45371,8645,110,27570,27570,25599,24407,19135
12735,4993,6252,12735,0,0,12735,8.75666e+17,17.9524,6572.61,12735,5613,20,12498,12498,12498,12498,11538
49912,11,14,48489,1423,49834,78,1.38933e+14,10.4089,678.503,49912,13,12,17845,0,19,81,160
48094,7097,12649,17165,30929,0,48094,9.49986e+12,59.5702,15782,48094,6156,72,40656,40656,39858,40554,39907
28756,7534,8648,0,28756,0,28756,5.92252e+17,96.6482,10891.8,28756,4188,110,20108,20108,19190,17738,18012
33696,5472,9438,31851,1845,31851,1845,6.40501e+18,97.0585,12034.6,33696,4578,110,28060,26588,18314,17445,11229
45452,7455,20355,0,45452,0,45452,4.67755e+17,94.5088,23021.2,45452,9897,110,45248,45248,45248,45248,45248
29128,9788,10253,27688,1440,0,29128,1.89044e+18,95.8758,12389.4,29128,4976,110,30540,30540,30540,30540,30540
29457,4057,7475,0,29457,0,29457,6.33558e+17,97.4379,9875.07,29457,3623,110,21982,21982,18460,15978,12714
8284,490,2801,8284,0,7802,482,5.27824e+18,91.8732,3430.59,8284,992,111,42742,42128,37929,38283,20814
34177,7281,10451,34177,0,32187,1990,4.59447e+18,242.281,12249,34177,4069,125,23726,23656,20827,22227,17455
8500,44,674,0,8500,8248,252,4.48877e+16,19.588,1617.98,8500,86,26,7826,7802,4998,5168,1507
13888,3828,4289,13148,740,13148,740,5.22226e+18,96.4662,5557.91,13888,2017,111,9599,9599,8765,8959,8599
9100,1789,5226,8800,300,0,9100,1.26353e+18,82.6651,5892.22,9100,2505,94,39074,0,1477,1477,1521
28726,11699,11746,0,28726,10988,17738,1.95262e+15,56.8604,13475.6,28726,5705,72,28657,28657,28657,28657,28657
32343,8457,10471,32343,0,30463,1880,5.3445e+18,218.288,11959.1,32343,3244,130,23016,23016,16061,21876,8132
17136,151,897,0,17136,16636,500,4.18023e+16,162.014,2526.09,17136,128,26,16123,15977,13592,12251,4192
45690,12598,13772,45690,0,43030,2660,4.24672e+18,321.304,16012,45690,3835,134,44047,44047,44047,44047,44047
6391,584,2781,6111,280,0,6391,1.67797e+18,78.3345,3414.39,6391,1313,87,3610,3610,1168,1215,0
15863,5222,5287,15051,812,15051,812,2.67819e+18,96.306,6648.27,15863,2504,111,10576,10576,10544,10573,10565
16716,1374,7307,15996,720,0,16716,1.64907e+18,88.7514,8574.34,16716,3524,110,9409,9409,6126,5929,4551
22790,142,176,22711,79,22790,0,6.07543e+18,150.586,1864.98,22790,146,154,44490,44055,37382,33289,9731
12575,14,208,12532,43,12575,0,6.06868e+18,196.212,1484.14,12575,130,134,4042,793,925,985,811
6388,3514,3748,6179,209,0,6388,1.24596e+18,86.5027,4250.6,6388,1801,87,2640,2640,2621,2572,2640
25806,95,176,25793,13,25806,0,6.07893e+18,172.244,1979.47,25806,159,157,22670,15619,13160,13800,13888
24398,1350,11631,23421,977,23421,977,2.65709e+18,90.7441,13220.8,24398,5640,110,12767,12636,29862,32292,27225
48907,3201,11435,46060,2847,0,48907,2.2272e+18,97.9078,15094.5,48907,5547,110,37546,37546,26328,24181,12212
34008,88,176,33992,16,34008,0,6.00682e+18,171.07,2223.94,34008,170,166,24902,12667,12490,12869,7551
44415,32,176,44328,87,44415,0,6.00826e+18,172.273,2547.57,44415,171,173,25805,7673,8585,9088,8239
18218,3639,8916,17508,710,0,18218,1.49541e+18,93.3925,10172.5,18218,4319,110,9302,9302,7036,6326,4570
14783,3526,4054,5305,9478,0,14783,9.42099e+12,59.2275,5260.11,14783,1970,72,12202,12202,8247,8392,3945
45695,2040,10701,43035,2660,43035,2660,3.35926e+18,97.8668,14164.2,45695,5186,110,39400,39400,33895,26327,26986
6136,400,1495,5776,360,0,6136,2.24169e+18,95.9487,2249.82,6136,703,93,4641,4641,3152,2958,1615
36570,5916,10688,34600,1970,0,36570,2.06038e+18,96.9119,13418.8,36570,5182,110,21952,21952,15008,13318,7364
18621,5996,6454,17684,937,17684,937,6.14463e+18,96.2889,7962.18,18621,3070,111,12167,12167,11782,12133,11177
23367,3273,6656,0,23367,0,23367,6.07354e+17,96.8353,8601.47,23367,3224,110,37573,37573,26027,35055,11190
12334,250,739,0,12334,11975,359,4.11174e+16,64.0105,1916.5,12334,96,26,11595,11540,9660,10046,6800
31682,5469,18145,30642,1040,30642,1040,3.45083e+18,91.0785,19782.2,31682,8772,111,13537,13537,9563,10578,6068
36378,9707,13050,0,36378,13597,22781,2.11562e+15,58.0584,15277.6,36378,6348,72,28320,28320,28320,28320,28320
41997,9720,13953,41997,0,39597,2400,4.94439e+18,287.165,15738,41997,4580,135,24114,24114,17817,16485,10750
23904,3875,9965,22844,1060,22844,1060,8.55539e+18,92.8018,11664.2,23904,4813,110,47317,47317,47317,47317,47317
33928,8861,14123,32418,1510,0,33928,1.70317e+18,94.904,16340.7,33928,6855,110,19805,19805,15830,13951,9291
31979,3966,7514,30114,1865,0,31979,2.22948e+18,97.7611,10124,31979,3642,110,45614,45614,45614,45614,45614
26619,56,208,26601,18,26619,0,6.04005e+18,201.981,2127.31,26619,170,164,18002,9874,6847,7880,7382
2122,599,738,2122,0,1992,130,3.12513e+18,89.2243,1021.3,2122,272,60,1384,1384,1285,1333,1304
15468,10,12,15015,453,15454,14,1.68397e+14,10.2404,367.902,15468,12,11,15423,15367,15158,15159,14796
26641,138,200,26629,12,26641,0,5.98519e+18,182.282,1990.89,26641,169,162,34299,33893,10235,8051,964
31438,2275,7397,0,31438,0,31438,6.4735e+17,97.718,9973.03,31438,3581,110,24041,24041,17145,9406,8723
28560,2642,8849,28560,0,26900,1660,4.01347e+18,179.359,10416,28560,3417,122,26785,26785,26785,26785,26785
35320,2501,9231,33320,2000,33320,2000,3.44425e+18,97.8008,11922.8,35320,4378,111,35046,35046,35046,35046,35046
26219,432,1461,0,26219,25439,780,4.81941e+16,283.992,4434.46,26219,240,26,20374,20374,12473,6250,2799
41438,9318,20308,9091,32347,0,41438,52277100000,8.99399,20733.1,41438,18271,11,40459,40459,40459,40459,40459
10641,97,176,10628,13,10641,0,6.02264e+18,163.138,1254.02,10641,127,128,9411,6191,5438,5743,5908
8087,10,12,7849,238,8079,8,1.78067e+14,10.219,266.596,8087,12,11,8058,8038,7875,7876,6906
21027,3472,4959,19805,1222,0,21027,2.22832e+18,97.4848,6850.34,21027,2392,110,16068,16068,14371,13778,11827
39383,8954,20344,37933,1450,37933,1450,1.00204e+19,92.6405,22497.5,39383,9876,110,22070,22070,17322,10502,9093
43093,7967,10374,40593,2500,40593,2500,4.938e+18,98.2887,13586.8,43093,4907,111,46843,46843,46843,46843,46843
5511,721,1709,4646,865,5211,300,2.41673e+18,95.3509,2357.82,5511,801,90,3802,3802,3352,3388,2538
43351,1051,10167,40829,2522,0,43351,2.22723e+18,97.8524,13484.9,43351,4931,110,33184,33184,20751,18364,5167
39619,2161,9270,13941,25678,0,39619,9.8744e+12,60.0438,12025.7,39619,4514,72,35970,35970,16523,11809,6519
31118,12,14,30231,887,31043,75,1.38956e+14,10.5025,517.63,31118,13,12,31103,31099,30037,30037,27247
32109,1718,12149,12101,20008,0,32109,8.014e+12,57.7001,14111.4,32109,5908,72,19960,19960,12663,18710,3938
9060,3485,4537,9060,0,9060,0,1.34716e+18,18.919,4809.64,9060,4075,21,4523,4523,3724,3647,3493
3712,646,959,0,3712,0,3712,6.34861e+17,93.8656,1477.83,3712,434,77,2753,2753,2437,2288,2148
26878,6301,7124,25373,1505,25373,1505,3.29576e+18,97.2281,9338.15,26878,3453,110,43702,43702,43702,43702,43702
14386,7,11,13972,414,14379,7,1.54473e+14,10.0931,345.812,14386,11,11,13947,13672,13041,12609,10573
15911,1636,3801,0,15911,0,15911,6.45963e+17,97.2131,5328.9,15911,1822,110,12110,12110,9240,6697,5979
26724,3430,6272,0,26724,9399,17325,2.53272e+15,59.9776,8269.94,26724,3054,72,20452,20452,17055,12733,11469
40285,8421,11632,0,40285,0,40285,6.01891e+17,96.9778,14588.1,40285,5643,110,30450,30450,26605,21887,20555
44544,10,15,43274,1270,44459,85,1.38715e+14,10.6299,665.44,44544,14,12,44428,44248,40948,40825,38534
9638,1097,2992,9126,512,0,9638,2.03332e+18,95.5788,3969.25,9638,1434,108,6646,6646,4633,4196,2580
37113,719,8684,34952,2161,34952,2161,3.21981e+18,97.8124,11619.8,37113,4201,110,28831,0,0,1432,3022
4509,113,170,4504,5,4509,0,5.97057e+18,152.655,790.963,4509,97,99,41072,38045,36557,36367,35355
20371,557,764,0,20371,19792,579,3.55354e+16,88.1688,2232.78,20371,101,26,19607,19523,18115,18328,15565
21221,1,13,20615,606,21151,70,1.38808e+14,10.8411,446.977,21221,12,12,5431,5431,5431,5431,5431
6235,38,176,6229,6,6235,0,6.10965e+18,158.464,978.053,6235,100,101,3713,1201,1331,1414,1153
8251,508,2034,7771,480,0,8251,2.22251e+18,96.4802,2967.5,8251,965,105,6217,6217,3252,3032,2067
13999,252,897,0,13999,13585,414,4.55694e+16,157.678,2426.15,13999,127,26,22894,22636,13719,2960,2244
21890,379,934,0,21890,21258,632,3.91165e+16,181.993,2775.8,21890,135,26,20956,20671,16858,17344,10996
18827,1403,8300,18017,810,0,18827,1.64072e+18,94.2045,9671.23,18827,4024,110,38708,38708,38708,38708,38708
42542,4668,16193,0,42542,0,42542,5.23311e+17,95.5091,18963.9,42542,7858,110,26349,26597,17318,12002,8944
7186,945,3166,6872,314,6872,314,8.1051e+18,89.8004,3842.48,7186,1489,96,1888,0,1888,1278,1888
4452,86,321,0,4452,4320,132,4.24382e+16,19.3425,806.029,4452,53,26,4131,4123,3670,3416,1918
16283,728,5033,15413,870,15413,870,1.40225e+18,96.8158,6454.21,16283,2390,111,11250,0,0,0,1406
4362,632,1854,4362,0,4142,220,4.93582e+18,91.68,2271.81,4362,744,83,2508,2415,1799,2071,1573
5476,129,200,5476,0,5476,0,5.97852e+18,167.266,912.603,5476,105,104,5047,4710,3512,3608,3549
14275,698,3378,5019,9256,0,14275,9.87552e+12,59.7522,4597.52,14275,1640,72,10897,10897,7036,10227,2458
10629,9,11,10327,302,10628,1,1.38235e+14,10.1111,287.538,10629,11,11,10483,10335,8282,8344,8768
46379,497,27531,0,46379,19250,27129,1.34069e+15,54.342,29407.1,46379,13406,72,36230,35376,28702,34335,29084
36477,23822,34089,34085,2392,0,36477,1.01109e+18,3.99342,34182.8,36477,11376,9,34780,34780,34780,34780,34780
45398,1709,12484,42898,2500,42898,2500,3.18284e+18,96.8898,15787.7,45398,6062,110,45078,45078,45078,45078,45078
21588,171,208,21572,16,20877,711,6.09821e+18,200.335,1960.77,21588,158,155,20999,20304,18045,18025,17677
19248,1676,4513,0,19248,6763,12485,2.53008e+15,59.8808,6056.33,19248,2192,72,8009,7517,3903,5888,1197
30622,7,14,29747,875,30541,81,1.41905e+14,10.7584,546.475,30622,13,12,5318,2142,1277,2057,263
33134,2799,14301,31701,1433,31701,1433,2.7191e+18,92.7403,16436.7,33134,6929,110,24073,24073,15956,19281,12736
44993,2588,12440,0,44993,0,44993,6.11893e+17,97.1929,15710.8,44993,6037,110,36465,36465,26873,31218,23010
46481,4379,19878,17935,28546,0,46481,7.38137e+12,56.977,22349.6,46481,9680,72,31307,31307,20530,22945,16778
28926,304,404,0,28926,26566,2360,2.93727e+16,10.1413,1018.89,28926,395,12,23916,23830,14553,13430,11164
4686,376,2050,0,4686,0,4686,4.94839e+17,87.6385,2552.37,4686,962,78,2636,2550,1499,1031,1389
32467,57,176,32417,50,32467,0,6.04525e+18,172.939,2216.5,32467,163,167,18100,4661,13966,13131,1963
35327,3821,10872,35327,0,33277,2050,3.54015e+18,247.825,12709.1,35327,4259,128,39726,39726,39726,39726,39726
36753,445,1673,0,36753,35671,1082,4.47779e+16,290.914,5341.04,36753,282,26,35080,33907,27355,28524,15967
36918,2047,8625,0,36918,0,36918,6.48245e+17,97.8514,11556.5,36918,4182,110,37215,37215,37215,37215,37215
38247,532,13858,38247,0,36159,2088,4.31413e+18,274.786,15510.6,38247,5458,129,26234,25946,15979,24329,3538
11356,656,2715,3997,7359,0,11356,9.84654e+12,59.6056,3734.92,11356,1316,72,8641,8641,4275,7464,2013
3420,292,3420,3420,0,3420,0,1.40019e+19,0,3420,3420,1666,21,0,0,0,0,0
24059,10214,11882,23127,932,0,24059,1.48179e+18,93.4959,13412.8,24059,5763,110,12177,12177,10565,9841,8149
23967,119,176,23956,11,23967,0,6.03257e+18,170.813,1896.24,23967,153,160,24605,11091,8051,956,1983
39860,6768,9969,37590,2270,0,39860,2.18084e+18,97.5836,13029.7,39860,4831,110,29891,37766,33548,32641,27687
26395,2527,6391,24859,1536,24859,1536,5.71201e+18,98.0909,8583.02,26395,3009,111,30756,30076,16956,15252,6961
21131,741,786,0,21131,20530,601,3.56759e+16,105.32,2318.84,21131,105,26,20345,20345,20227,20218,19650
6972,1572,2485,5472,1500,6622,350,3.89746e+18,93.7996,3217.76,6972,1150,93,4487,4487,2853,3203,2554
16330,2239,7209,15630,700,15630,700,2.74844e+18,92.4795,8444.63,16330,3485,110,9121,9121,4372,6241,2793
36963,6661,8650,34810,2153,0,36963,2.22984e+18,97.8155,11577.1,36963,4192,110,39676,39676,39676,39676,39676
41466,5236,15079,39462,2004,0,41466,1.85373e+18,95.7646,17851.1,41466,7316,110,38059,38059,38059,38059,38059
40692,5151,13340,0,40692,14980,25712,2.22252e+15,58.5683,15869,40692,6498,72,29127,29127,21219,14499,11718
37866,11,14,36784,1082,37789,77,1.38864e+14,10.6531,607.216,37866,13,12,22121,20178,19391,19423,18853
46020,22855,24083,44340,1680,44340,1680,4.26008e+18,93.8334,26440.3,46020,11610,111,35162,35162,35162,35162,35162
22730,48,176,22652,78,22730,0,6.11071e+18,171.004,1867.69,22730,152,149,8508,2662,4643,1189,1224
42940,10591,17335,40980,1960,40980,1960,2.57876e+18,95.797,19987.3,42940,8324,111,41848,41848,41848,41848,41848
18113,9955,10481,7473,10640,0,18113,5.43905e+12,50.2887,11413.4,18113,5091,72,17409,12257,17880,15514,14287
17278,3618,4105,16275,1003,16275,1003,5.88241e+18,97.3169,5732.05,17278,1971,110,13173,13173,13058,13060,12074
38943,13405,15587,37168,1775,37168,1775,2.92127e+18,95.1661,18107,38943,7563,110,38903,38903,38903,38903,38903
37104,180,1395,0,37104,36028,1076,4.04256e+16,283.981,4549.02,37104,227,26,28651,28216,8928,0,0
15467,1106,6328,5921,9546,0,15467,7.66842e+12,55.7144,7394.06,15467,3076,72,10356,10356,6396,2273,2220
13468,166,4862,0,13468,0,13468,5.45482e+17,95.1181,6044.49,13468,2339,110,39781,39781,39781,39781,39781
46368,4081,10752,0,46368,16293,30075,2.53809e+15,60.1012,13890.7,46368,5238,72,46968,46968,46968,46968,46968
46660,6482,10877,16401,30259,0,46660,9.90087e+12,60.0781,14029.2,46660,5298,72,32672,32672,31402,31765,21721
28593,28066,28593,28593,0,0,28593,7.99972,0,28593,28593,28593,1,0,0,0,0,0
16040,4315,5543,16040,0,15150,890,5.27087e+18,136.965,6580.43,16040,1433,126,31352,0,0,0,0
21200,1645,5876,20031,1169,20031,1169,6.48919e+18,96.8701,7698.15,21200,2840,110,25530,25530,21892,16249,6197
17061,206,5236,16161,900,0,17061,2.02413e+18,93.9878,6737.86,17061,2517,110,15070,14432,8495,7467,0
31732,12003,16351,31732,0,20403,11329,4.65142e+18,556.286,17900.1,31732,6445,137,31862,31862,31862,31862,31862
18142,834,921,0,18142,17616,526,4.16808e+16,185.586,2632.3,18142,133,26,17221,17221,17127,17110,16731
18604,3931,4369,0,18604,6542,12062,2.52423e+15,59.8613,5873.45,18604,2112,72,29537,29537,0,35555,35555
36544,2603,14910,36544,0,34764,1780,4.10102e+18,356.302,16750.2,36544,6310,136,21634,21587,12947,16289,4493
38996,12063,12666,36996,2000,36996,2000,3.01027e+18,96.3868,15436.4,38996,6145,110,30979,30875,28211,29782,23713
15506,1480,8755,15506,0,15506,0,2.44782e+18,17.7391,9076.17,15506,7869,20,6751,6751,1163,6751,1221
3169,619,769,1119,2050,0,3169,1.01372e+13,58.6377,1163.54,3169,374,62,2400,2400,2222,2360,2091
44860,11,19,43518,1342,44748,112,1.93211e+14,10.4029,769.543,44860,14,12,11199,5588,4704,4899,4138
42026,3785,13483,42026,0,39576,2450,3.98289e+18,298.268,15281.5,42026,5027,129,30181,30060,20631,25115,12933
39101,2970,16764,15099,24002,0,39101,7.38442e+12,56.9535,18910.1,39101,8166,72,46289,46289,46289,46289,46289
29057,157,176,29044,13,29057,0,5.99762e+18,170.054,2032.87,29057,167,164,48843,48107,45975,49172,0
4317,327,357,0,4317,4191,126,4.51675e+16,19.0656,867.069,4317,57,26,3960,3960,3915,3911,3691
4186,485,1424,3966,220,3966,220,5.39311e+18,84.5232,1941.64,4186,641,87,5607,5607,4513,2646,175
15605,1743,4566,14763,842,14763,842,3.13479e+18,96.3733,5991.33,15605,2190,110,22193,22193,22193,22193,22193
15922,26,175,15856,66,15922,0,5.9814e+18,164.822,1494.3,15922,150,146,7324,1662,2129,2382,2326
29007,1454,13146,27797,1210,27797,1210,8.94772e+18,94.253,15017.3,29007,6378,110,22064,22064,14835,17865,11644
3728,475,1570,0,3728,0,3728,5.0759e+17,90.1092,2008.63,3728,728,75,2158,2072,1701,1344,1484
31911,89,176,31902,9,31911,0,5.98256e+18,169.577,2116.15,31911,169,165,31799,31799,31794,31794,31793
30817,7,8,28248,2569,30561,256,1.17196e+14,7.45679,433.538,30817,8,8,4206,1287,195,867,24
5596,1562,3179,5596,0,5376,220,5.14376e+18,90.9333,3566.76,5596,1366,82,2417,2417,1427,1841,952
10831,680,6238,10831,0,0,10831,8.98612e+17,17.8653,6497.12,10831,5600,20,4593,4593,533,1535,521
30852,800,963,0,30852,29973,879,3.55734e+16,192.517,3115.95,30852,140,26,21059,20876,13867,18609,9891
49254,140,176,49185,69,49254,0,6.08924e+18,172.356,2748.84,49254,171,172,49154,49154,49154,49154,49154
20363,9,12,19781,582,20355,8,1.39293e+14,10.4125,404.021,20363,12,11,20089,19806,15888,16002,16637
6180,916,1564,5820,360,0,6180,2.21551e+18,95.8453,2315.37,6180,743,94,4616,4616,3956,3690,3206
27793,1138,11045,27506,287,26354,1439,3.98209e+18,183.148,12333.1,27793,4210,133,27652,27652,27652,27652,27652
19244,731,792,0,19244,18692,552,3.68638e+16,106.107,2280.34,19244,107,26,12624,12480,8379,4854,3295
2660,1642,1916,1157,1503,0,2660,3.83127e+12,33.3835,2088.67,2660,911,49,14968,14968,14753,14624,14467
7447,371,398,7447,0,7139,308,2.38728e+18,17.9373,726.204,7447,318,20,7511,7425,5983,4696,1489
12343,696,3746,4478,7865,0,12343,9.03598e+12,58.6834,4762.83,12343,1823,72,49084,49084,49084,49084,49084
14870,386,752,0,14870,14439,431,3.88588e+16,74.5108,2034.48,14870,99,26,14118,14049,13379,13213,9916
19154,112,4534,18041,1113,0,19154,2.2278e+18,97.3906,6294.39,19154,2177,110,14620,6542,8648,8091,1329
6646,1505,1578,2327,4319,0,6646,9.96654e+12,59.3405,2261.27,6646,762,72,5068,5068,4995,5054,4985
24735,6672,8192,24735,0,24735,0,4.48849e+15,5478.89,14231.6,24735,8192,4,13503,29160,29160,29160,29160
2847,108,126,0,2847,2767,80,3.53328e+16,19.5704,389.196,2847,36,26,2721,2721,2686,2691,2513
11655,1537,4420,11655,0,11017,638,4.77873e+18,115.282,5169.94,11655,1690,121,25419,0,0,0,0
1810,90,170,1810,0,1810,0,5.98882e+18,129.186,501.213,1810,71,63,19268,12333,8221,9512,6478
1054,126,181,1054,0,1054,0,5.97572e+18,101.306,391.681,1054,58,48,868,817,693,696,697
26531,4601,6274,24991,1540,0,26531,2.22349e+18,97.6177,8531.95,26531,3032,110,21936,21936,21936,21936,21936
46055,8,17,44677,1378,45975,80,1.93197e+14,10.3898,772.522,46055,14,12,7138,2020,1450,2639,277
33560,7995,9015,0,33560,0,33560,6.19131e+17,97.2434,11634.3,33560,4368,110,27513,27513,27513,27513,27513
28877,5988,9238,0,28877,10596,18281,2.24358e+15,57.8451,11178.1,28877,4484,72,43914,43914,43914,43914,43914
29353,3699,6851,0,29353,0,29353,6.48466e+17,97.7249,9301.16,29353,3312,110,22502,22502,18973,17037,13186
45053,59,176,44955,98,45053,0,6.09362e+18,173.658,2628.06,45053,173,171,31683,28183,29984,27716,27328
24608,2807,7669,24608,0,23178,1430,3.88053e+18,166.977,9083.41,24608,2955,121,23762,23762,14416,12412,4129
43206,3526,10032,15185,28021,0,43206,9.89328e+12,60.0777,12995.1,43206,4881,72,47620,47620,47620,47620,47620
15249,1370,6803,14596,653,14596,653,3.19834e+18,94.6133,7953.33,15249,3255,111,8446,8446,5575,6663,2796
23776,3559,6301,22446,1330,0,23776,2.14194e+18,95.8623,8319.73,23776,3040,110,17475,17475,15013,13968,11121
21527,2143,5803,0,21527,0,21527,6.20482e+17,96.1154,7661.9,21527,2791,110,15724,15724,11287,6502,6154
46299,3,15,44959,1340,46208,91,1.56274e+14,10.4923,701.793,46299,13,13,21745,19973,19799,20389,19513
28205,5852,9205,0,28205,10367,17838,2.22507e+15,58.5152,11091.7,28205,4480,72,28399,28399,28399,28399,28399
34165,5441,8613,32225,1940,0,34165,2.17625e+18,97.4927,11318.4,34165,4165,110,33982,33982,33667,33667,33667
35115,2206,8230,0,35115,0,35115,6.47719e+17,97.7764,11043,35115,3986,110,33895,33895,33895,33895,33895
44187,3833,13576,0,44187,16104,28083,2.28622e+15,58.8907,16351.4,44187,6608,72,22614,22614,10439,13427,6708
37263,7,14,36196,1067,37185,78,1.48053e+14,10.2949,584.183,37263,13,12,5705,1387,810,1594,127
9590,2410,9590,9590,0,0,9590,134204000,0,9590,9590,9590,1,0,0,0,0,0
29476,6745,9607,29476,0,27757,1719,3.82906e+18,188.131,10999.1,29476,3527,124,34960,35214,0,0,0
36707,1,12,33730,2977,36701,6,1.13934e+14,7.98417,502.164,36707,12,8,9962,9962,9962,9962,9962
44268,6884,10337,0,44268,15571,28697,2.5284e+15,60.0595,13357.7,44268,5030,72,43293,43293,43293,43293,43293
20314,4073,6338,19251,1063,0,20314,2.00736e+18,96.2392,8038.73,20314,3057,110,14040,14040,0,0,0
33402,391,1488,0,33402,32422,980,4.36527e+16,278.219,4714.96,33402,243,26,28771,27374,12677,18536,1579
35722,152,176,35648,74,35722,0,5.98185e+18,172.576,2242.01,35722,170,167,22309,21267,8515,13310,98
29052,3760,11960,27745,1307,27745,1307,2.81531e+18,94.9316,13937.4,29052,5801,110,22904,0,0,0,0
11762,2803,4739,11219,543,11219,543,5.12121e+18,91.4803,5749.08,11762,2244,111,21398,21398,9592,12729,4374
33759,1203,1217,0,33759,32783,976,3.89306e+16,255.278,3940.43,33759,189,26,26729,26729,16900,19558,9576
40463,12057,12490,38323,2140,38323,2140,2.57462e+18,97.263,15333.5,40463,5967,111,23301,23301,20114,18874,16042
38988,10,14,37860,1128,38902,86,1.56909e+14,10.4623,641.469,38988,14,12,38840,38597,37834,37511,35305
24264,2041,7908,23014,1250,0,24264,1.96822e+18,96.2216,9822.76,24264,3833,110,22431,13732,9989,14990,2819
11325,1025,4307,0,11325,0,11325,5.30751e+17,94.697,5325.6,11325,2073,110,7018,6871,5388,4456,3729
20885,2005,4933,0,20885,0,20885,6.46682e+17,97.4532,6813.17,20885,2373,110,44682,44682,44682,44682,44682
13174,879,3158,0,13174,0,13174,6.50565e+17,97.1315,4481.12,13174,1520,110,10016,10016,5676,4725,3437
2826,81,1637,2826,0,2826,0,4.05295e+18,18.1454,1763.37,2826,1204,23,1189,1176,131,222,71
12042,2742,5526,4702,7340,0,12042,7.0056e+12,56.0945,6350.27,12042,2684,72,6516,6516,5131,6223,2949
30948,6811,14254,29668,1280,29668,1280,4.0796e+18,93.5563,16169.2,30948,6859,111,16694,16694,10953,11979,9225
44971,4145,10472,42351,2620,42351,2620,5.74399e+18,97.8984,13899.5,44971,5074,110,43380,43380,43380,43380,0
10291,611,719,0,10291,9991,300,4.32024e+16,46.6444,1790.07,10291,92,26,23259,23229,20010,20456,10690
35157,6517,8188,0,35157,12358,22799,2.53532e+15,60.0487,10688.5,35157,3988,72,19158,18641,13650,15467,10656
40479,1332,22217,16493,23986,0,40479,5.83235e+12,54.747,24046.2,40479,10817,72,32159,0,0,0,0
23184,5338,5645,21837,1347,21837,1347,2.16045e+18,97.9767,7630.08,23184,2656,111,19868,19868,19868,19868,19868
28564,1267,1756,0,28564,27699,865,5.21033e+16,303.494,5351.48,28564,299,26,24415,24415,14276,6753,2091
45766,9684,20001,0,45766,17745,28021,1.85898e+15,56.5565,22411.5,45766,9738,72,34832,34828,34524,34824,33568
22356,7869,11124,22356,0,0,22356,8.78952e+17,17.6644,11551.5,22356,9998,20,21738,21738,21738,21738,21738
18648,1813,4735,17578,1070,17578,1070,2.3673e+18,97.6955,6400.51,18648,2229,111,13913,13913,10314,11857,6526
3842,1189,1247,0,3842,1405,2437,2.2635e+15,52.4321,1669.54,3842,598,63,2595,2595,2547,2510,2540
36030,1232,10283,0,36030,0,36030,6.04243e+17,96.953,13001.2,36030,4979,110,41828,41828,41828,41828,41828
48404,2047,22131,0,48404,18923,29481,1.79063e+15,56.5104,24581.1,48404,10771,72,48252,48252,48252,48252,48252
5839,328,2872,5839,0,5839,0,4.17937e+18,17.9002,3083.45,5839,2572,20,2967,2967,444,2967,385
22483,1493,9465,22483,0,21363,1120,5.6075e+18,167.383,10568.8,22483,3351,129,13018,12826,7055,9813,2258
47316,9606,12006,0,47316,0,47316,6.30475e+17,96.8444,15498.5,47316,5812,110,42367,42193,42193,42193,42405
34734,4282,15351,13495,21239,0,34734,7.1884e+12,56.0746,17270.5,34734,7464,72,35525,35525,35525,35525,35525
23690,252,1130,6987,16703,6987,16703,1.80852e+18,15.9948,1707.35,23690,975,25,22560,22560,12506,15632,10363
24838,697,777,0,24838,24062,776,0.0312425,0.968717,4392.37,24838,777,1,24554,23775,21410,19989,22708
48310,6400,13624,45658,2652,45658,2652,5.73857e+18,97.69,16987.9,48310,6477,111,35950,35865,32126,33364,29151
10607,1241,3776,10077,530,0,10607,1.90034e+18,95.0588,4772.39,10607,1821,110,6831,6831,4341,3757,1576
45026,4925,12773,16226,28800,0,45026,9.24184e+12,59.2704,15668.2,45026,6215,72,44556,44556,44556,44556,44556
33340,569,1426,0,33340,32366,974,4.26078e+16,281.571,4538.19,33340,233,26,18771,17620,11783,10750,2665
33953,11464,13066,33953,0,32173,1780,4.46961e+18,283.118,14590.6,33953,5278,126,31147,31147,31147,31147,31147
38108,8,12,37023,1085,38093,15,1.3909e+14,10.2332,551.975,38108,11,12,7743,4766,4111,4570,1160
9346,173,2344,8806,540,8806,540,1.21183e+18,97.0852,3353,9346,1083,111,7002,6923,6107,6091,1119
1125,6,74,1078,47,337,788,1.27624e+18,16.6827,189.109,1125,57,19,506,47,193,137,185
9240,1911,3228,8773,467,8773,467,3.0666e+18,94.9628,4135.78,9240,1545,104,22494,22494,22494,22494,22494
28925,9662,14905,27855,1070,27855,1070,9.87111e+18,91.4063,16610.8,28925,7237,110,32339,32339,32339,32339,32339
13399,2649,5269,0,13399,5083,8316,2.01195e+15,56.6403,6247.47,13399,2550,72,8130,8130,6603,5725,4208
1293,384,419,0,1293,464,829,2.46545e+15,54.7285,608.243,1293,199,47,874,874,839,843,845
35694,3540,8349,33614,2080,0,35694,2.22925e+18,97.8158,11199.7,35694,4047,110,29913,29913,27210,27656,25919
45703,1322,1917,9521,36182,0,45703,5.85862e+13,11.9954,2619.07,45703,1912,13,33704,33704,24750,22404,13841
5116,316,1230,0,5116,1792,3324,2.54957e+15,59.009,1791.24,5116,591,72,3886,3886,2569,1681,1118
13657,1424,3203,12857,800,0,13657,2.23979e+18,97.264,4572.74,13657,1537,110,11040,11040,10275,10948,10203
25532,6290,7203,9195,16337,0,25532,9.29084e+12,59.2063,9032.01,25532,3509,72,13116,13116,9485,10155,8215
13430,159,3224,12650,780,0,13430,2.22556e+18,97.0876,4567.65,13430,1541,110,41641,41206,29401,28661,10123
42753,3840,10023,0,42753,0,42753,6.47426e+17,97.8714,13307.8,42753,4858,110,30391,30391,20144,11541,8888
20277,4958,9357,7935,12342,0,20277,6.97336e+12,56.2976,10578.9,20277,4554,72,10920,10920,8704,10540,6245
35941,7867,8785,33881,2060,0,35941,2.19777e+18,97.6084,11621.4,35941,4247,110,27156,27156,36079,35988,34885
42182,1447,10959,39812,2370,0,42182,2.15253e+18,97.435,14126.3,42182,5307,110,27975,27975,17599,15417,6030
39972,600,1594,0,39972,38806,1166,4.20985e+16,295.909,5203.38,39972,266,26,32023,31879,12218,2921,2454
16984,3885,6157,16154,830,0,16984,1.86674e+18,95.3721,7561.1,16984,2980,110,10827,10827,9120,8776,7488
38567,9167,9503,36357,2210,0,38567,2.19293e+18,97.6347,12491.8,38567,4607,110,30182,30182,30182,30182,30182
2202,379,573,0,2202,773,1429,2.53426e+15,57.3887,871.708,2202,275,57,1629,1629,1370,1136,1217
25582,7656,13424,25582,0,24609,973,4.95514e+18,373.504,14779.1,25582,4091,135,20480,20480,20480,20480,20480
10801,1252,4434,0,10801,4122,6679,1.94588e+15,56.7717,5244.89,10801,2147,72,20000,19778,9955,6689,3074
3151,691,1747,0,3151,0,3151,3.49106e+15,16.9924,1885.83,3151,1561,20,1404,1404,471,1404,498
21067,4128,7874,21067,0,19927,1140,3.42725e+18,155.756,8962.25,21067,3052,125,13193,13193,10393,11270,7453
1523,9,10,1481,42,1523,0,1.37503e+14,9.46881,107.759,1523,10,10,1497,1481,1464,1465,1382
38693,1791,13805,36803,1890,36803,1890,7.52187e+18,95.8734,16455.7,38693,6704,110,37905,37905,37905,37905,37905
25047,5909,10343,16684,8363,23917,1130,5.1436e+18,94.9336,12083.3,25047,4941,111,14704,14704,13132,14607,8969
47143,12,18,45757,1386,47019,124,1.74612e+14,10.5022,771.368,47143,15,12,34453,32479,32555,31766,31762
17628,8262,11420,17628,0,17148,480,5.68639e+18,362.985,12372.6,17628,3015,122,16559,16559,14013,13243,11478
40802,1960,14874,15285,25517,0,40802,8.2005e+12,57.9681,17296.1,40802,7241,72,36551,36551,18465,15867,8529
14584,2626,7910,14584,0,0,14584,8.90444e+17,17.9504,8233.36,14584,7110,20,6674,6674,2346,3196,2088
34803,43,176,34711,92,34803,0,6.08584e+18,172.843,2308.32,34803,167,165,20643,6000,12685,18159,151
35384,8098,16166,33924,1460,0,35384,1.58279e+18,91.4267,18335.7,35384,7835,110,26723,26723,26716,26711,26698
28381,3726,11645,0,28381,0,28381,4.98123e+17,94.8715,13595.6,28381,5640,110,22096,22096,20380,19035,18769
48610,901,1313,0,48610,47223,1387,3.58109e+16,268.103,4608.24,48610,211,26,31765,31425,20194,13276,8719
21113,135,8013,20103,1010,20103,1010,3.69298e+18,95.5474,9606.87,21113,3838,111,13100,7723,5206,6263,1349
31316,9054,10346,29722,1594,29722,1594,7.32247e+18,96.1923,12664.5,31316,5014,110,26182,26182,26182,26182,26182
38623,8665,9063,0,38623,13585,25038,2.5218e+15,60.0064,11760.9,38623,4398,72,38213,38213,38213,38213,38213
29283,965,1021,0,29283,28444,839,3.72481e+16,208.841,3242.63,29283,152,26,34611,34611,20785,31896,3627
20849,6717,7650,20849,0,19701,1148,4.9602e+18,154.744,8736.38,20849,1569,127,13199,13199,12977,13199,11742
774,129,285,0,774,0,774,6.23355e+17,77.6395,431.157,774,112,41,489,284,324,312,283
24586,6065,8567,23365,1221,0,24586,1.90158e+18,95.8171,10449.7,24586,4152,110,16019,16019,14479,13698,12213
44868,4321,11461,0,44868,0,44868,6.30133e+17,97.5152,14800.8,44868,5565,110,30013,30013,22789,16759,15144
4498,1172,1578,4498,0,4238,260,6.04219e+18,90.1243,2012.93,4498,545,89,2920,2920,2650,2811,2497
22370,92,1227,0,22370,21708,662,4.6256e+16,259.113,3644.02,22370,192,26,20636,20446,13559,13979,5440
16551,2584,4940,15669,882,15669,882,6.60693e+18,95.5815,6418.92,16551,2379,110,20293,20293,15275,8485,8902
26123,377,7872,9499,16624,0,26123,9.0374e+12,58.9229,9698.53,26123,3834,72,21409,21399,14791,12485,12287
21645,798,9970,20755,890,0,21645,1.57674e+18,93.2098,11458.6,21645,4825,110,18257,15141,8137,12642,2124
45778,10941,11665,0,45778,16266,29512,2.46003e+15,59.7359,14697.9,45778,5682,72,28527,28382,24248,26019,18939
15336,7599,7928,14766,570,0,15336,1.42214e+18,92.1099,8988.08,15336,3837,110,7408,7408,7385,7333,7408
38128,7274,8918,35908,2220,35908,2220,5.75948e+18,97.8092,11918.2,38128,4321,110,37969,26261,23211,23753,19670
14712,146,176,14704,8,14712,0,6.04026e+18,167.729,1485.99,14712,137,143,14268,13477,12247,12178,12124
32872,1042,1160,0,32872,32293,579,2.56165e+16,3.73433,4449.57,32872,582,4,21346,21202,16903,14384,11695
14602,29,175,14599,3,14602,0,5.98509e+18,164.339,1431.17,14602,138,149,5554,596,1830,2507,2
5395,152,2211,5145,250,5145,250,3.18178e+18,81.2604,2785.01,5395,1023,92,3184,3014,0,1578,0
37176,5276,9864,35096,2080,0,37176,2.13823e+18,97.3161,12708.8,37176,4786,110,30846,30846,23195,24840,11019
34070,6023,11020,34070,0,32087,1983,5.09049e+18,235.691,12565.8,34070,4065,128,21723,21423,18902,19508,17010
39022,89,176,38936,86,39022,0,6.01675e+18,173.162,2403.24,39022,172,170,34860,26008,23407,23972,24329
27697,6463,6468,26077,1620,26077,1620,3.36237e+18,97.7073,8804.66,27697,3124,110,32707,32707,32707,32707,32707
13790,43,176,13721,69,13790,0,6.02303e+18,165.928,1426.35,13790,137,141,12164,2791,6524,4276,271
25044,5868,8612,0,25044,0,25044,5.55587e+17,95.8753,10537.5,25044,4168,110,16432,16432,14685,13309,12015
14199,1840,3391,13369,830,13369,830,5.88609e+18,97.2047,4790.89,14199,1634,110,10808,10808,10436,10438,6587
9556,68,648,0,9556,9279,277,4.1835e+16,19.6083,1603.22,9556,83,26,35521,35262,33928,0,0
33232,13033,15838,0,33232,13105,20127,1.72713e+15,55.8657,17599.9,33232,7693,72,17394,17394,16395,15779,0
38419,4702,9046,36189,2230,36189,2230,3.22046e+18,97.6326,12064.4,38419,4379,110,32891,32891,28505,30988,16570
7968,235,398,0,7968,7739,229,3.72949e+16,19.9188,1080.47,7968,61,26,7570,7570,7148,7202,4624
26496,6194,8373,0,26496,0,26496,5.79747e+17,96.3691,10444,26496,4054,110,29330,27261,19715,15125,12112
33095,4434,11554,12301,20794,0,33095,8.39956e+12,58.1639,13640.2,33095,5625,72,21541,21541,15535,20511,8334
29520,2726,6959,27803,1717,27803,1717,5.76007e+18,97.6845,9412.29,29520,3364,110,21170,21022,14674,17570,10273
35823,8,14,34796,1027,35740,83,1.47334e+14,10.5238,595.592,35823,13,12,6763,3657,3360,3108,2283
23412,18166,23412,23412,0,0,23412,7.99966,0,23412,23412,23412,1,0,0,0,0,0
21074,6150,7905,7933,13141,0,21074,8.08632e+12,57.6938,9314.54,21074,3850,72,25211,25211,25211,25211,25211
45007,2213,10440,15819,29188,0,45007,9.90618e+12,60.0925,13504.3,45007,5086,72,42082,42082,41175,41905,40024
31086,1289,10666,0,31086,0,31086,5.55032e+17,95.9767,12938.7,31086,5162,110,39550,39550,39550,39550,39550
43953,8643,18255,43953,0,41963,1990,4.82126e+18,1469.13,20840.4,43953,7237,142,25698,24248,19241,20651,14896
16412,71,5884,0,16412,0,16412,5.48776e+17,95.358,7256.53,16412,2848,110,12528,0,0,550,234
38570,8780,9569,36370,2200,0,38570,2.18713e+18,97.5857,12556,38570,4627,110,29490,29490,29285,29251,29036
36149,2616,8662,34039,2110,34039,2110,4.33788e+18,98.3065,11462,36149,4102,111,27487,27487,18020,21541,9636
19855,256,857,0,19855,19284,571,3.84731e+16,145.098,2497.98,19855,120,26,18998,18801,14746,14839,8772
48393,20213,28459,0,48393,0,48393,3.49624e+17,91.6906,30689.2,48393,13839,110,38207,38207,38207,38207,38207
27479,9052,11823,26289,1190,0,27479,1.6617e+18,94.5426,13678.2,27479,5732,110,18669,18598,16103,18004,12571
19402,9,12,18838,564,19389,13,1.58451e+14,10.3057,410.474,19402,12,11,19193,18967,16592,16616,16378
39797,7925,9362,0,39797,0,39797,6.46106e+17,97.6837,12465.8,39797,4533,110,39483,39483,39483,39483,39483
38547,17012,17642,38547,0,36937,1610,4.67586e+18,1253.24,19906.9,38547,6264,141,32432,32432,32432,32432,32432
32987,8212,10687,32987,0,31067,1920,3.44363e+18,228.669,12199.5,32987,3934,128,24812,24812,19305,13743,12524
31960,7324,7686,30100,1860,30100,1860,2.58139e+18,98.228,10233.9,31960,3635,111,31209,31209,28122,25501,24648
19770,19,176,19696,74,19770,0,6.06555e+18,170.364,1737.96,19770,147,149,7736,1570,2155,2014,2027
49564,332,1308,0,49564,48150,1414,3.55621e+16,265.735,4624.16,49564,210,26,26255,24621,2067,19882,3475
31863,8327,16492,30683,1180,30683,1180,2.64604e+18,91.696,18292.5,31863,7935,111,15371,15371,12371,15073,8148
36177,2027,9644,0,36177,12929,23248,2.41586e+15,59.4794,12113.9,36177,4684,72,32136,32136,20996,30188,7201
6899,4,11,6698,201,6893,6,1.62014e+14,10.4411,240.931,6899,11,11,6052,5436,4319,4603,2921
5281,1089,1312,0,5281,0,5281,6.46411e+17,95.4223,1985.76,5281,609,88,3969,3969,3717,3565,3624
13902,2655,3326,13092,810,0,13902,2.22645e+18,97.1137,4705.01,13902,1598,110,10576,10576,9688,9551,8926
28623,3317,8045,27055,1568,27055,1568,3.15589e+18,96.8301,10329.8,28623,3881,110,20578,20578,17174,18893,11313
8376,6553,8192,8376,0,0,8376,4.45333e+15,179.958,8268.22,8376,6385,2,184,0,184,184,184
23074,34,175,23061,13,23074,0,5.97644e+18,166.909,1798.08,23074,154,161,9465,1451,2162,5353,684
20684,2827,4876,0,20684,0,20684,6.48472e+17,97.4847,6742.29,20684,2353,110,20873,20008,10972,8470,4081
44872,8654,13576,44872,0,42262,2610,3.75058e+18,316.657,15786.5,44872,5354,129,43499,43499,43499,43499,43499
16489,3742,3923,15530,959,0,16489,2.22609e+18,97.3105,5490.7,16489,1886,110,14846,14846,12508,12063,9903
4488,217,1930,0,4488,0,4488,4.9606e+17,92.2618,2423.9,4488,914,76,2558,2472,1646,879,936
38596,8651,9131,0,38596,13586,25010,2.51974e+15,60.0089,11819.5,38596,4447,72,26815,26815,23791,25994,18276
43074,10,12,41846,1228,43056,18,1.38744e+14,10.3003,589.741,43074,12,11,38076,35357,31646,30395,8258
16594,2025,4901,0,16594,0,16594,5.99243e+17,96.4396,6388.11,16594,2367,110,11693,11693,8840,8247,6917
27291,138,176,27217,74,27291,0,6.01783e+18,171.267,2007.68,27291,163,160,30520,30481,29972,29952,29747
18100,8,176,18049,51,18100,0,6.13542e+18,166.742,1665.56,18100,136,140,3872,781,691,655,811
13242,3031,4346,12560,682,12560,682,6.76478e+18,96.1892,5543.79,13242,2057,111,26515,26572,0,0,0
39204,1669,14751,0,39204,0,39204,5.28105e+17,94.0538,17365.6,39204,7162,110,30808,30808,26850,23766,11636
26964,697,1021,0,26964,26186,778,3.83538e+16,205.064,3183.14,26964,153,26,27436,27436,27436,27436,27436
1540,369,409,0,1540,540,1000,2.54109e+15,56.339,639.558,1540,193,51,1131,1131,1089,1077,1092
9117,360,2990,0,9117,0,9117,5.73845e+17,95.2493,3916.64,9117,1427,110,6127,6041,3110,1920,1631
35260,1932,15254,13638,21622,0,35260,7.32188e+12,56.2565,17223,35260,7424,72,29028,29028,23119,0,0
8467,3174,4027,0,8467,3332,5135,1.74603e+15,52.9675,4651.32,8467,1939,72,46815,46815,46815,46815,46815
44243,10294,11615,0,44243,15786,28457,2.43725e+15,59.6074,14536.5,44243,5658,72,42620,42620,42620,42620,42620
19938,338,6780,0,19938,0,19938,5.60153e+17,95.8534,8406.49,19938,3280,110,13158,12900,7797,2995,1685
41814,550,14170,41814,0,39512,2302,4.37631e+18,288.131,16207,41814,4225,137,22680,21046,10269,5303,1926
47724,13669,16393,45344,2380,45344,2380,7.33659e+18,95.1848,19570.2,47724,7944,110,38178,38178,38178,38178,38178
13518,1589,6046,12946,572,0,13518,1.62617e+18,93.7908,7114.03,13518,2922,110,7472,7472,4854,4341,2870
18615,1685,4369,0,18615,6535,12080,2.53046e+15,59.8753,5871.91,18615,2124,72,14246,14246,10383,7086,5786
44297,9857,19599,17202,27095,0,44297,7.18304e+12,56.729,21928.9,44297,9536,72,48841,48841,48841,48841,48841
31733,231,1098,0,31733,30821,912,3.76649e+16,221.869,3533.98,31733,167,26,30476,30153,22758,21887,12223
2511,537,925,2511,0,2368,143,3.39059e+18,87.4309,1223.85,2511,316,66,1586,1586,1221,1355,1173
38131,8044,13437,36251,1880,36251,1880,2.93978e+18,94.0553,16067.7,38131,6519,110,24694,36152,33197,35229,28624
42377,16034,19363,0,42377,0,42377,4.59674e+17,93.766,21858.3,42377,9392,110,36571,36571,36571,36571,36571
27965,260,6606,26343,1622,0,27965,2.22469e+18,97.6251,8958.07,27965,3190,110,27617,27617,27568,27571,27580
10210,480,846,0,10210,9905,305,5.03839e+16,158.383,2150.78,10210,115,26,9364,9181,8606,8336,4919
4826,630,1163,1693,3133,0,4826,9.85493e+12,58.9979,1704.69,4826,556,72,3663,3663,2906,3533,2153
4521,165,336,0,4521,4388,133,4.28744e+16,19.3057,836.669,4521,54,26,4185,4177,3790,3834,1552
44043,1124,1759,0,44043,42757,1286,4.26394e+16,305.304,5798.73,44043,299,26,23263,20999,10797,14808,2675
20362,449,1005,0,20362,19766,596,4.21828e+16,206.279,2942.79,20362,150,26,19357,18982,17773,17525,10344
2510,496,672,2363,147,0,2510,2.22764e+18,92.3618,1059.88,2510,305,63,1838,1838,1632,1642,1588
48772,1166,1684,0,48772,47360,1412,4.01006e+16,298.565,5707.64,48772,286,26,48709,48709,48709,48709,48709
15000,1014,3725,0,15000,0,15000,6.38189e+17,97.0762,5175.47,15000,1789,110,40419,40419,35772,34369,32803
33714,126,176,33703,11,33714,0,5.99137e+18,171.095,2205.3,33714,165,169,26501,13475,9911,17143,2079
23117,6322,7553,21935,1182,21935,1182,7.22701e+18,96.0781,9397.93,23117,3648,110,33376,33376,33376,33376,33376
14569,1193,5415,13869,700,0,14569,1.83981e+18,90.1702,6658.28,14569,2597,110,9154,9154,5833,4987,2212
8760,1053,2099,8250,510,8250,510,5.71676e+18,96.5491,3081.15,8760,989,108,6661,6661,6019,5921,3802
11932,432,2847,4193,7739,0,11932,9.82224e+12,59.6585,3911.01,11932,1377,72,9085,9085,3720,7603,1537
14059,3275,3377,0,14059,0,14059,6.43978e+17,97.0806,4767.02,14059,1619,110,10682,10682,10595,10644,10610
12681,242,3117,11941,740,11941,740,5.40713e+18,97.4878,4377.82,12681,1458,111,13180,14693,12976,11483,1705
8000,43,175,7999,1,8000,0,5.97905e+18,159.645,1061.55,8000,119,120,4714,1901,1669,2078,1970
44429,2003,17502,42379,2050,42379,2050,8.24941e+18,95.3729,20318.6,44429,8508,110,34698,34698,18865,17750,11456
36827,1093,1328,0,36827,36165,662,2.57769e+16,3.7343,5075.25,36827,666,4,32237,32237,26541,30837,20374
9263,978,2950,0,9263,0,9263,5.82815e+17,93.3664,3894.16,9263,1398,107,13642,13642,12179,10129,4077
47299,10444,11033,16625,30674,0,47299,9.88697e+12,60.0695,14222.4,47299,5370,72,47012,47012,47012,47012,47012
49538,10963,13816,0,49538,17817,31721,2.37864e+15,59.37,16970.5,49538,6728,72,35722,35722,33234,30991,29195
23465,2177,5526,8257,15208,0,23465,9.8921e+12,59.9301,7324.39,23465,2692,72,27188,27188,12494,20334,5133
41138,8564,15827,0,41138,15561,25577,2.02937e+15,57.6501,18206.1,41138,7700,72,32857,32857,32857,32857,32857
946,109,277,0,946,325,621,2.52791e+15,53.7273,433.729,946,130,41,669,669,440,226,305
39396,10065,11543,14274,25122,0,39396,9.1184e+12,58.6345,14112.6,39396,5617,72,32159,32159,29908,29409,27150
10424,1137,2945,0,10424,3748,6676,2.37763e+15,58.9556,3864.39,10424,1427,72,7479,7479,6024,5902,3924
25622,523,1396,0,25622,24864,758,4.7236e+16,283.737,4219.48,25622,225,26,21014,20966,17336,20376,13044
32883,562,13414,31392,1491,31392,1491,2.34632e+18,95.6406,15564.7,32883,6433,111,23584,22793,13432,15598,3041
9461,1669,3888,0,9461,3608,5853,1.95716e+15,56.7184,4622.28,9461,1881,72,6869,7135,0,0,1732
25156,82,907,0,25156,24435,721,3.66934e+16,173.328,2792.48,25156,129,26,29684,24476,4721,424,499
46085,18441,22399,33500,12585,44273,1812,6.89973e+18,94.557,24897.1,46085,10790,111,23686,23686,23686,23686,19642
15900,455,4160,15008,892,15008,892,6.25758e+18,96.8376,5651.45,15900,1995,110,16730,16462,10236,8991,2468
24403,9399,11858,0,24403,9656,14747,1.70162e+15,55.9543,13218.6,24403,5773,72,20081,20081,20041,20081,19756
35733,6086,12533,0,35733,0,35733,5.49813e+17,94.8946,15041.2,35733,6081,110,34360,34360,34360,34360,34360
44488,11765,21721,0,44488,17642,26846,1.69084e+15,55.5731,23902.8,44488,10565,72,38177,38177,38177,38177,38177
8234,990,3456,7859,375,7859,375,3.04137e+18,94.3164,4216.46,8234,1641,98,15666,15506,0,5857,3798
14844,3040,4683,14844,0,13982,862,3.77092e+18,123.63,5686.96,14844,1462,124,38465,38465,38465,38465,38465
24470,286,8108,0,24470,0,24470,5.67846e+17,96.1337,10024.1,24470,3927,110,16362,15774,9640,3881,2008
17646,608,716,0,17646,17144,502,3.5547e+16,44.4223,2010.67,17646,92,26,16930,16904,16407,16478,14919
47552,12932,24670,0,47552,0,47552,4.0731e+17,91.3901,27154.2,47552,11977,110,47090,47090,47090,47090,47090
10041,4005,4935,0,10041,0,10041,3.42197e+15,17.9212,5217.61,10041,4428,20,5106,5106,4193,5055,4203
5419,1963,2319,0,5419,2086,3333,1.92562e+15,51.6483,2797.78,5419,1124,67,3100,3100,2671,2601,2142
23545,7192,7514,22319,1226,0,23545,1.98808e+18,96.257,9397.54,23545,3642,110,18740,18740,18740,18740,18740
18768,523,747,0,18768,18231,537,3.59213e+16,74.6002,2137.6,18768,98,26,15186,15186,9994,11747,7469
1815,283,490,0,1815,638,1177,2.39689e+15,56.2281,748.65,1815,224,53,1325,1325,1105,1063,882
8207,1562,3925,0,8207,0,8207,4.476e+17,92.6655,4639.16,8207,1886,99,4282,9758,8334,8103,7387
25960,4,12,25204,756,25945,15,1.58563e+14,10.1906,475.585,25960,12,11,24471,20530,19577,18570,12432
35282,4656,22862,31272,4010,31272,4010,7.18061e+16,5.52372,26228.9,35282,7628,13,20400,0,0,0,0
46673,1939,14977,46673,0,43964,2709,4.70507e+18,321.459,16914.3,46673,5612,129,22240,22343,13245,20763,1762
27951,2272,9504,10353,17598,0,27951,8.52748e+12,58.2858,11345,27951,4627,72,27796,27796,27796,27796,27796
27292,9,14,26508,784,27213,79,1.4873e+14,10.7106,526.455,27292,14,12,5262,1384,524,1034,184
38640,8098,9312,36392,2248,36392,2248,4.77094e+18,98.296,12260.1,38640,4410,111,23549,23386,18812,21034,13813
44545,10265,10364,0,44545,15663,28882,2.53139e+15,60.0376,13403.8,44545,5040,72,38064,38064,38064,38064,38064
22054,853,942,0,22054,21418,636,3.92602e+16,181.459,2811.5,22054,137,26,23176,22877,14054,21377,3000
22042,4617,5252,0,22042,0,22042,6.46395e+17,97.4284,7204.61,22042,2531,110,16790,16790,15967,15794,15252
14295,5289,5335,13605,690,13605,690,2.93682e+18,94.8059,6552.73,14295,2575,110,8960,8960,8933,8944,8960
48132,2,18,46724,1408,48033,99,1.66036e+14,10.5383,749.82,48132,15,12,14328,13314,13314,13720,13315
35189,167,176,35127,62,35189,0,6.13697e+18,171.239,2319.84,35189,160,161,19875,18628,7742,620,749
38129,1283,12293,36167,1962,0,38129,1.97275e+18,95.3433,15020.8,38129,5949,110,35958,35958,34937,35264,34442
10525,3060,4525,10065,460,10065,460,2.71042e+18,93.6839,5437.3,10525,2178,104,20898,20898,15525,18362,10104
32032,602,1381,9345,22687,9345,22687,1.74653e+18,15.9951,2055.85,32032,1315,25,43828,43828,43828,43828,43828
612,91,257,582,30,582,30,2.29885e+18,72.4608,371.411,612,90,35,327,105,121,209,141
37287,3358,8782,35119,2168,35119,2168,5.77202e+18,97.8062,11727,37287,4256,110,28505,28505,25268,24742,12216
35396,6403,17396,35396,0,23015,12381,4.80738e+18,677.476,19143,35396,4060,140,18000,17184,11549,13493,6841
27289,797,899,0,27289,26510,779,3.56129e+16,166.597,2825.47,27289,127,26,37663,37663,37663,37663,37663
12716,60,176,12711,5,12716,0,5.99998e+18,162.566,1356.63,12716,136,135,8888,4851,3811,4425,4422
20452,904,8437,20452,0,18545,1907,4.43832e+18,151.697,9479.38,20452,2839,129,12015,11772,4962,7779,892
40736,9455,9751,38366,2370,38366,2370,4.09734e+18,98.2977,12830.9,40736,4608,111,33518,33518,33518,33518,33518
16339,105,176,16331,8,16339,0,6.00614e+18,170.296,1544.34,16339,148,148,22318,22062,22096,22030,21698
36238,772,1061,0,36238,35207,1031,3.55456e+16,220.178,3547.42,36238,160,26,27506,27506,15023,20034,6725
48077,1153,1875,0,48077,46674,1403,4.25134e+16,325.194,6243.06,48077,323,26,31020,30230,16160,21478,3634
16410,379,885,4923,11487,0,16410,6.91355e+18,15.9815,1357.78,16410,686,18,15525,15525,10579,10088,9618
24498,4278,5760,0,24498,8626,15872,2.52772e+15,59.9542,7626.94,24498,2806,72,29242,29242,29242,29242,29242
10349,3008,4058,0,10349,0,10349,5.19871e+17,94.3354,4999.46,10349,1953,110,6291,6291,5544,4710,4653
16571,6545,6948,0,16571,6367,10204,1.92206e+15,45.2289,8059.15,16571,3370,72,9623,9623,9063,8420,8534
42757,6762,10897,15189,27568,0,42757,9.61306e+12,59.7216,13762.9,42757,5303,72,33116,33116,31583,31435,30549
6117,1146,1547,5759,358,0,6117,2.21461e+18,95.7772,2289.37,6117,735,93,27634,27548,18040,8175,4723
24458,1478,5796,23038,1420,0,24458,2.22248e+18,97.581,7915.75,24458,2800,110,18662,18662,12788,11889,5641
31860,9079,16766,0,31860,0,31860,4.01788e+17,92.0214,18572.3,31860,8127,110,30640,30640,27656,30091,23791
6378,1,11,6195,183,6374,4,1.54419e+14,10.0886,229.858,6378,11,11,1451,1451,1451,1451,1451
12763,252,773,0,12763,12392,371,4.20162e+16,91.1324,2024.97,12763,102,26,11990,11896,10802,10494,6230
35746,2283,18769,7764,27982,0,35746,52818500000,8.99253,19147.6,35746,16888,11,35105,35105,35105,35105,35105
12723,504,2991,11974,749,11974,749,5.68501e+18,97.1706,4283.7,12723,1433,110,9732,9732,7913,6555,2273
33313,3096,10768,33313,0,31374,1939,5.36224e+18,229.289,12288.9,33313,3565,130,26842,26842,25188,26394,23671
3381,778,861,3181,200,0,3381,2.24947e+18,94.2612,1348.06,3381,395,74,12609,12609,12364,12374,12394
8751,949,2100,8240,511,0,8751,2.23786e+18,96.5574,3079.87,8751,999,108,28808,28808,27224,16585,6703
12679,1672,3116,11940,739,11940,739,3.78273e+18,97.4571,4378.37,12679,1466,111,9563,9563,8158,9450,5860
10281,261,492,9855,426,3031,7250,1.26722e+18,16.9641,875.338,10281,437,19,9789,9789,8928,9059,6893
14614,2404,3582,13764,850,13764,850,4.92942e+18,97.6462,4983.25,14614,1677,111,11032,11032,10446,11032,7925
48666,8620,11384,45834,2832,45834,2832,3.22662e+18,97.8993,15028.2,48666,5512,110,42527,42527,42527,42527,42527
30332,114,176,30274,58,30332,0,6.09275e+18,169.075,2156.54,30332,160,158,30300,26867,19761,20285,20580
5418,75,170,5414,4,5418,0,5.98645e+18,155.297,867.065,5418,103,104,4187,2363,2149,2383,2362
40829,7,14,39664,1165,40750,79,1.38776e+14,10.6462,630.819,40829,13,12,4919,1599,956,976,226
20497,3840,4792,7204,13293,0,20497,9.91593e+12,59.933,6411.57,20497,2333,72,0,0,0,0,0
34156,4231,7962,0,34156,12002,22154,2.53325e+15,60.0462,10405.3,34156,3878,72,27397,27397,26369,26350,14921
31692,55,176,31639,53,31692,0,6.06346e+18,171.577,2194.42,31692,161,163,28450,11474,8091,22522,549
9226,111,200,9225,1,9226,0,5.99179e+18,174.543,1178.78,9226,124,125,8361,7028,4896,5177,5251
944,107,164,944,0,944,0,5.98811e+18,96.3464,358.648,944,55,44,759,528,569,573,595
41156,4616,13185,41156,0,38764,2392,4.58927e+18,292.374,14957.9,41156,4892,126,36566,36566,36566,36566,36566
19407,488,6082,18389,1018,18389,1018,7.01401e+18,96.2719,7722.11,19407,2939,110,20215,20215,7074,2206,2542
17845,11,12,17335,510,17838,7,1.43932e+14,10.3027,381.195,17845,12,11,17833,17833,17466,17467,16914
44937,14338,15154,42657,2280,42657,2280,4.59774e+18,95.5532,18141.2,44937,7229,111,33804,33804,33804,33804,33804
18883,3861,4624,17783,1100,17783,1100,5.73252e+18,97.9204,6320.08,18883,2181,111,14259,14259,13989,13985,12633
6617,1098,1996,0,6617,0,6617,6.05546e+17,89.5524,2747.96,6617,937,98,4621,4621,4007,3879,3555
29757,4773,10681,29757,0,28115,1642,3.53567e+18,193.507,12055.7,29757,4113,128,47025,47025,47025,47025,47025
7017,1006,1712,2479,4538,0,7017,9.84319e+12,59.3623,2420.11,7017,830,72,5305,5305,4447,5123,3176
9983,1833,2399,3511,6472,0,9983,9.8677e+12,59.5274,3323.15,9983,1161,72,7584,7584,6917,7444,5972
27120,107,176,27026,94,27120,0,6.1355e+18,171.779,2036.84,27120,156,153,24979,19772,15833,16240,16483
29280,432,6901,27580,1700,0,29280,2.22453e+18,97.6746,9340.33,29280,3336,110,28306,28306,28160,28096,27934
44385,9,176,44299,86,44385,0,6.04054e+18,173.357,2579.88,44385,171,173,31245,28799,28093,27649,27684
42175,12074,23623,40753,1422,40753,1422,2.95035e+18,92.2008,25695.1,42175,11401,111,26641,26641,23971,26183,20912
8911,3390,3842,8911,0,8072,839,3.68998e+18,102.207,4478.89,8911,1557,114,5069,5062,4985,5038,5069
49203,10377,11508,0,49203,0,49203,6.47022e+17,97.8897,15187.1,49203,5574,110,33935,33935,31051,33173,26551
32425,2763,8411,30602,1823,0,32425,2.15536e+18,97.3297,10986.2,32425,4064,110,32494,32494,32494,32494,32494
8274,5,10,8031,243,8269,5,1.74008e+14,9.92712,263.392,8274,10,10,7665,6884,6056,5791,4477
15844,341,4094,14944,900,0,15844,2.17053e+18,97.0276,5586.65,15844,1971,110,11237,11221,7378,8489,3085
25774,2653,6089,24274,1500,0,25774,2.22691e+18,97.6571,8298.1,25774,2942,110,30586,30009,16637,24975,6675
4315,38,2483,4174,141,4174,141,1.0555e+19,89.4028,2870.28,4315,1177,68,918,129,325,640,92
25320,5102,6575,0,25320,9025,16295,2.44708e+15,57.8992,8442.96,25320,3197,72,18745,18745,16951,16009,14095
27308,1138,6992,25761,1547,0,27308,2.16704e+18,97.3229,9254.22,27308,3383,110,25599,25599,24989,25300,24347
15176,4748,8076,14626,550,14626,550,4.39809e+18,93.2603,9090.5,15176,3884,111,36478,36478,36478,36478,36478
18484,3089,4390,0,18484,0,18484,6.44386e+17,97.348,6102.33,18484,2106,110,14094,14094,12427,11474,10706
22550,321,886,0,22550,21905,645,3.76202e+16,164.205,2661.07,22550,124,26,21664,21434,19229,18933,10542
9535,302,2289,0,9535,3364,6171,2.52328e+15,59.5425,3183.25,9535,1113,72,8577,8577,7551,7347,6986
38731,78,176,38650,81,38731,0,5.97886e+18,169.647,2330.13,38731,170,170,34681,28964,25788,26286,25994
12072,2823,2858,0,12072,0,12072,6.49292e+17,96.9701,4104.24,12072,1367,110,9214,9214,9200,9200,9212
45223,9069,10589,42593,2630,0,45223,2.22639e+18,97.8826,14029,45223,5132,110,34759,34759,32324,32883,31337
30070,3444,11463,30070,0,28478,1592,3.71096e+18,236.267,12858.8,30070,4355,133,23859,23859,22059,22680,21209
13900,2653,4668,13900,0,13090,810,3.44131e+18,112.841,5526.63,13900,1674,121,34754,34754,18115,29630,5880
42898,445,1189,0,42898,41675,1223,3.5587e+16,248.82,4095.4,42898,185,26,41709,41115,36641,36963,21830
39700,80,206,39686,14,39700,0,5.98191e+18,195.154,2443.86,39700,179,173,42647,42096,33917,27932,7908
12288,197,385,0,12288,11904,384,0.03125,0.968669,2174.12,12288,385,1,11903,11903,11903,11903,11903
32479,1,14,31537,942,32400,79,1.55882e+14,10.5633,581.791,32479,13,12,5086,5086,5086,5086,5086
48103,14,17,46685,1418,48027,76,1.76628e+14,10.4368,766.429,48103,14,12,11280,11228,11183,11169,10530
30544,2134,7797,28814,1730,0,30544,2.16788e+18,96.3649,10269.2,30544,3763,110,25871,25871,18290,10534,7745
12501,4016,5230,11933,568,11933,568,5.46035e+18,94.152,6260.39,12501,2498,111,7271,7271,5949,6161,5809
47234,7,13,45887,1347,47215,19,1.38926e+14,10.21,618.123,47234,12,12,23806,21988,21839,21595,21591
4886,1149,1168,0,4886,1721,3165,2.55101e+15,59.1455,1712.99,4886,564,72,3718,3718,3697,3701,3705
36627,5836,8780,34494,2133,34494,2133,4.23501e+18,98.2915,11611.7,36627,4160,111,32166,31971,23331,21919,14990
34667,1604,14446,0,34667,0,34667,4.94471e+17,93.1342,16700.8,34667,7002,110,20221,20221,12416,5291,3583
12336,4777,5063,0,12336,0,12336,5.05288e+17,90.3637,6110.91,12336,2442,110,7273,7273,6905,6895,6717
47807,1049,17827,45511,2296,45511,2296,7.37951e+18,95.6613,20826.2,47807,8542,111,34766,34426,30529,30035,25123
9032,1206,2224,8511,521,0,9032,2.21489e+18,96.4686,3222.27,9032,1059,109,6808,6808,5431,5217,4041
31369,11485,14096,31369,0,29959,1410,4.58458e+18,373.082,15739.3,31369,5738,133,17874,17874,16830,16688,12563
15546,147,3714,0,15546,0,15546,6.44436e+17,97.1967,5216.25,15546,1777,110,21171,10077,10924,7274,951
35171,4,12,34169,1002,35160,11,1.38845e+14,10.1908,528.728,35171,11,12,30475,27018,27053,27341,18219
32742,8850,13862,12617,20125,0,32742,7.44401e+12,56.7023,15740.5,32742,6748,72,23424,23424,22722,23376,22622
47243,73,1600,0,47243,45880,1363,3.95697e+16,288.067,5421.32,47243,268,26,36464,25970,9619,28946,1771
33168,449,1136,0,33168,32602,566,2.53944e+16,3.7339,4364.48,33168,570,4,32032,32032,30677,30408,20451
42320,6,14,41115,1205,42241,79,1.38762e+14,10.4149,615.548,42320,14,12,20892,19141,18936,18877,18523
43991,3859,10244,41423,2568,41423,2568,3.34678e+18,97.8964,13605.9,43991,4968,110,43657,43657,43657,43657,43657
36149,1,14,35118,1031,36071,78,1.3881e+14,10.4529,563.046,36149,13,12,11361,11361,11361,11361,11361
24834,2776,7301,0,24834,0,24834,5.9801e+17,96.6808,9321.83,24834,3532,110,19886,19886,13929,13233,7880
747,113,154,747,0,747,0,5.98454e+18,81.7175,307.78,747,53,39,593,566,494,499,494
29424,7284,9943,27931,1493,27931,1493,1.7465e+18,96.4642,12094.1,29424,4735,111,16722,16502,13828,15380,11643
34744,4350,8348,32724,2020,32724,2020,4.79156e+18,98.2297,11065.2,34744,3939,111,34436,34436,26226,14334,14631
13975,1421,6621,13409,566,0,13975,1.54721e+18,87.7382,7677.48,13975,3201,110,7354,7354,3435,2894,960
48445,1127,1289,0,48445,47065,1380,3.5564e+16,263.541,4530.19,48445,205,26,31099,31073,21928,29390,10983
4660,416,1630,4660,0,4390,270,3.32885e+18,90.2736,2074.7,4660,563,90,3030,3030,1665,2170,1099
41670,14,265,41414,256,41670,0,5.55204e+18,228.279,1453.84,41670,265,25,41499,41267,41184,41063,40962
30880,52,438,0,30880,28357,2523,2.93879e+16,10.1582,1076.39,30880,431,11,20722,4750,10152,10630,751
3179,513,884,0,3179,0,3179,6.41879e+17,93.1384,1336.78,3179,405,71,2295,2295,1915,1870,1751
21326,2232,13470,21326,0,20743,583,5.15815e+18,543.587,14676.5,21326,6198,130,7856,6818,3429,5627,1446
43831,37,98,43656,175,43831,0,3.87096e+18,97.3444,1829.39,43831,98,98,43151,42968,40763,40740,33094
6508,1550,2034,0,6508,2374,4134,2.28838e+15,57.6985,2659.96,6508,976,72,22883,22883,14583,5961,4325
31947,751,9578,30247,1700,30247,1700,6.70628e+18,96.7373,12018.3,31947,4647,110,26459,26411,19855,24448,16191
34592,113,176,34505,87,33356,1236,6.08122e+18,172.89,2301.16,34592,162,165,23443,22931,10706,19103,5713
9346,4367,4582,2051,7295,0,9346,52204300000,8.9755,4779.26,9346,4119,11,4764,4764,4594,4764,4592
3603,222,236,0,3603,0,3603,3.76063e+18,15.9115,448.034,3603,158,18,3367,3367,3286,3303,3293
31492,3613,7350,29659,1833,0,31492,2.23202e+18,97.7416,9936.09,31492,3554,110,20983,20983,4458,20537,3799
13967,191,5501,0,13967,0,13967,5.18013e+17,94.7299,6670.64,13967,2660,110,8466,7976,4091,1164,1209
39990,13023,17760,39990,0,38353,1637,4.83621e+18,1870.47,20459.5,39990,7378,141,39924,39924,39924,39924,39924
33892,170,176,33846,46,33892,0,5.97979e+18,169.685,2180.98,33892,164,168,40678,40543,38729,38798,38856
37977,1771,8879,35767,2210,35767,2210,5.87743e+18,97.8319,11875.7,37977,4298,110,32664,32664,30263,32265,0
35953,2,14,34916,1037,35870,83,1.52078e+14,10.4645,596.959,35953,13,12,1731,37,46,316,32
11596,2343,3459,0,11596,4206,7390,2.32484e+15,58.6726,4434.69,11596,1674,72,8137,8137,7809,7697,7440
37383,7860,8975,35211,2172,35211,2172,6.16237e+18,98.2419,11850.8,37383,4237,111,28408,28408,26289,26779,25522
46546,15,206,46462,84,46546,0,5.98073e+18,193.966,2643.5,46546,185,178,27287,14741,14335,26034,14340
3407,529,827,1197,2210,0,3407,9.97008e+12,58.7241,1246.81,3407,399,63,3775,3986,3986,3986,3986
7352,230,616,0,7352,7134,218,4.59181e+16,19.4188,1467.75,7352,80,26,7325,7325,7325,7325,7325
14100,464,5058,13410,690,0,14100,1.87963e+18,95.3094,6288.85,14100,2434,110,18258,17073,7513,3361,1312
48811,5500,11375,17161,31650,0,48811,9.88235e+12,60.0726,14650.5,48811,5531,72,27296,27296,16658,20549,13717
7689,1190,1951,7241,448,7241,448,5.32423e+18,96.8783,2823.09,7689,913,103,5738,5738,4361,4627,4124
49806,9410,20145,47536,2270,47536,2270,3.05558e+18,95.8477,23122.2,49806,9684,111,40910,40910,40910,40910,40910
41957,6769,9798,39517,2440,39517,2440,3.35969e+18,97.8422,13039.6,41957,4739,110,30211,30211,27077,23437,23387
43803,3524,11770,15669,28134,0,43803,9.4224e+12,59.4948,14649.6,43803,5729,72,43364,43364,43364,43364,43364
46797,6811,11227,44077,2720,44077,2720,2.37754e+18,98.3561,14660.2,46797,5321,111,46356,46356,46356,46356,46356
43609,14887,23885,42109,1500,42109,1500,2.36957e+18,92.7525,26099.7,43609,11595,110,19724,19724,14702,16510,13368
10242,1577,2942,9682,560,0,10242,2.09317e+18,96.0557,3992.07,10242,1408,110,7300,7300,5831,5270,3655
11522,162,175,11516,6,11522,0,5.98389e+18,163.077,1272.77,11522,132,137,18886,21057,8945,852,1964
31357,16233,16641,0,31357,0,31357,3.9759e+17,91.9619,18412,31357,8066,110,14716,14716,14711,14711,14716
1174,112,198,0,1174,1136,38,6.28509e+16,11.4898,409.108,1174,35,22,976,976,891,874,625
2185,281,545,0,2185,770,1415,2.58661e+15,57.9249,847.251,2185,264,56,1640,1640,1318,1255,989
31550,936,7428,0,31550,0,31550,6.4566e+17,97.7037,10013.5,31550,3585,110,30599,30599,30599,30599,30599
31458,130,176,31379,79,31458,0,6.02925e+18,172.512,2174.21,31458,167,166,27715,14461,11378,16742,2161
13039,940,5783,12477,562,12477,562,2.65516e+18,94.4945,6814.36,13039,2760,111,7256,7082,3651,4853,2035
21674,525,5097,20404,1270,20404,1270,3.37043e+18,97.5936,7028.42,21674,2457,110,16577,16577,7328,11519,2739
31571,771,1327,6578,24993,0,31571,5.86015e+13,11.9938,1908.5,31571,1324,13,23318,22535,8330,10743,2471
7108,598,2886,0,7108,0,7108,5.14151e+17,93.6761,3590.58,7108,1381,99,4222,4136,2987,1749,1632
23489,314,994,6852,16637,6852,16637,1.7439e+18,15.9886,1566.26,23489,989,17,22495,22495,13699,16397,18428
27649,27526,27649,27649,0,0,27649,134213000,0,27649,27649,27649,1,0,0,0,0,0
36336,32,176,36262,74,36336,0,6.0965e+18,172.4,2360.47,36336,162,166,23529,18293,20682,19789,18371
9026,280,4238,0,9026,0,9026,4.5732e+17,92.9983,5008.05,9026,2045,101,4788,4530,12239,10742,10683
16037,179,200,16027,10,16037,0,5.98938e+18,179.038,1547.5,16037,145,153,15302,14690,6369,6292,612
19940,74,176,19927,13,19940,0,6.0444e+18,170.319,1737.14,19940,146,153,15591,9388,8082,9028,8127
29819,11582,15387,6493,23326,0,29819,52638400000,8.98716,15736,29819,13843,11,13960,13960,10846,8883,8084
9910,38,176,9900,10,9910,0,6.05755e+18,166.219,1222.76,9910,121,127,5667,1810,1904,2386,2090
2946,93,221,606,2340,0,2946,5.69095e+13,12.037,394.174,2946,84,20,2725,2725,1982,1383,2106
15374,2,12,14937,437,15362,12,1.4277e+14,10.6019,352.766,15374,12,11,8936,6404,6010,6358,5117
22917,1200,8192,22917,0,22917,0,3.86118e+15,5263.66,13661.7,22917,8192,3,23817,23685,14513,22157,2372
41188,7935,20769,16448,24740,0,41188,6.39185e+12,55.7579,22769.5,41188,10112,72,34312,34312,34312,34312,34312
38044,10746,12225,13965,24079,0,38044,8.75044e+12,58.6505,14640.7,38044,5950,72,29995,29995,29995,29995,29995
28769,7580,14166,28769,0,27601,1168,4.92103e+18,480.191,15744.3,28769,6654,131,18944,18719,15850,17179,12969
18958,3937,4472,17850,1108,17850,1108,5.86925e+18,97.5294,6218.52,18958,2160,110,26623,26168,14362,13368,6347
18156,6012,6586,17273,883,17273,883,2.90639e+18,93.248,8063.18,18156,3188,110,11570,11570,11535,11566,11570
10881,2036,3504,10313,568,0,10881,1.99103e+18,95.6751,4561.68,10881,1685,110,7377,7377,5790,5177,3443
14817,1,11,14385,432,14804,13,1.70838e+14,10.1815,357.661,14817,11,11,2901,2901,2901,2901,2901
49674,136,176,49585,89,49674,0,6.04047e+18,173.787,2727.22,49674,173,174,45782,41230,38715,41100,35055
10897,5832,6538,10559,338,10559,338,2.18619e+18,91.1231,7259.03,10897,3152,97,4359,4359,4211,4339,4337
45851,9,13,44543,1308,45831,20,1.38966e+14,10.2909,610.705,45851,12,12,10584,5583,5324,5741,4310
32202,4720,7515,0,32202,11329,20873,2.53396e+15,60.0449,9842.71,32202,3661,72,32023,32023,32023,32023,32023
12266,1783,2959,0,12266,0,12266,6.4433e+17,96.9426,4216.52,12266,1412,110,18827,0,0,0,2101
10900,12,13,10587,313,10834,66,1.61164e+14,10.645,318.793,10900,12,12,3834,2844,2683,2337,1874
24738,7365,9623,9376,15362,0,24738,7.89566e+12,56.723,11199.5,24738,4682,72,26360,26360,26360,26360,26360
28218,829,6556,9904,18314,0,28218,9.90643e+12,60.0175,8650.95,28218,3190,72,27237,27237,27195,27217,26945
38183,9,12,37092,1091,38164,19,1.3881e+14,10.2358,552.032,38183,11,12,7654,4042,3698,4015,3160
4140,1192,2706,4022,118,0,4140,1.07278e+18,74.4007,3030.64,4140,1294,58,1434,1434,648,649,540
10459,1862,2498,0,10459,3677,6782,2.53582e+15,59.6166,3456.6,10459,1216,72,7961,7961,7193,6686,6078
994,200,277,346,648,0,994,1.02495e+13,54.7052,441.859,994,134,43,717,717,631,697,607
35382,5233,10865,35382,0,33330,2052,4.21312e+18,250.858,12707.2,35382,4237,125,34883,34883,34883,34883,34883
12893,5,12,12507,386,12885,8,1.96812e+14,9.8742,339.883,12893,11,11,12829,944,568,3019,7
44601,4573,17852,0,44601,16993,27608,1.98226e+15,57.409,20334.6,44601,8692,72,34945,34945,31990,34195,24924
3886,61,936,1369,2517,0,3886,1.00518e+13,58.8963,1396.64,3886,452,66,2819,1381,803,2040,246
14082,1814,14082,0,14082,14082,0,2047.85,0,14082,14082,14082,1,0,0,0,22517,22517
9295,855,2241,3269,6026,0,9295,9.86713e+12,59.4888,3116.04,9295,1085,72,7054,7054,5028,6704,2703
21854,2056,6394,20674,1180,20674,1180,3.12317e+18,96.6915,8229.62,21854,3093,110,28052,28052,14026,10410,5009
48855,17834,22985,46885,1970,46885,1970,2.55801e+18,93.6576,25714.7,48855,11160,110,37045,37045,37045,37045,37045
7131,1732,1755,6711,420,6711,420,4.73457e+18,96.7948,2585.53,7131,816,99,5376,5376,5366,5376,5374
37854,9751,10295,35744,2110,35744,2110,1.29819e+18,97.7942,13106.8,37854,4891,111,36794,36794,35187,34114,31768
18692,324,5369,17678,1014,17678,1014,3.25833e+18,96.5686,7009.12,18692,2584,110,13323,13090,5251,8663,1860
39141,549,14713,37281,1860,37281,1860,7.82249e+18,95.4769,17321.7,39141,7141,110,24428,23671,18226,14150,3077
8340,1167,2873,8340,0,7857,483,3.52038e+18,91.9989,3502.31,8340,1024,113,12279,12279,9043,8621,2674
25144,3032,7821,25144,0,23682,1462,5.04924e+18,168.249,9254.77,25144,3022,122,41551,41551,41551,41551,41551
7743,590,1821,0,7743,2718,5025,2.56886e+15,59.5335,2585.24,7743,887,72,5922,5922,4107,2166,2056
47217,11897,14200,41534,5683,44467,2750,4.58117e+18,328.392,16497,47217,3040,137,46311,46311,46311,46311,46311
29636,1,14,28782,854,29564,72,1.51869e+14,10.4718,539.873,29636,13,12,20732,20732,20732,20732,20732
21807,1643,5137,20535,1272,0,21807,2.23191e+18,97.553,7079.11,21807,2480,110,32398,32398,32398,32398,32398
33067,7025,12843,31527,1540,0,33067,1.78295e+18,95.3336,15098.3,33067,6233,110,20224,20224,16593,15708,12845
17824,44,4228,0,17824,0,17824,6.47399e+17,97.3807,5892.96,17824,2034,110,16825,3376,5711,3183,1102
43218,9466,15190,41088,2130,0,43218,1.8877e+18,82.8067,18099.6,43218,7376,110,28028,28028,21621,19036,10778
16534,5,11,16053,481,16528,6,1.61677e+14,10.1364,373.058,16534,11,11,1931,565,304,461,70
27719,605,12678,26570,1149,0,27719,1.58523e+18,92.8336,14475.4,27719,6151,110,33397,33397,14304,15084,3762
43518,12,14,42277,1241,43431,87,1.38991e+14,10.5416,642.807,43518,13,12,43504,43500,42267,42267,38892
41413,113,176,41347,66,41413,0,6.1023e+18,173.626,2520.89,41413,167,170,41250,41238,41213,41201,41185
24393,3620,9376,24393,0,23100,1293,4.68784e+18,186.412,10574.1,24393,3712,125,31463,31463,26661,25027,7425
16231,2449,4716,5873,10358,0,16231,9.19105e+12,58.9874,5989.26,16231,2293,72,11515,11515,9379,11066,5956
15513,1755,4877,14703,810,14703,810,3.05475e+18,95.1296,6264.92,15513,2350,110,10636,10636,8654,9048,5421
40913,8454,15529,15444,25469,0,40913,7.99843e+12,57.7322,17909.7,40913,7560,72,33198,33198,33198,33198,33430
29495,2161,7952,27842,1653,27842,1653,2.08672e+18,97.7325,10271.4,29495,3775,111,20124,16631,9084,9729,3640
19923,3489,6656,18910,1013,18910,1013,7.34139e+18,95.9261,8290.32,19923,3217,110,11832,11819,9114,10342,7396
24871,2221,7065,8955,15916,0,24871,9.2195e+12,59.1576,8859,24871,3432,72,27622,27622,16041,25637,1920
15977,356,746,0,15977,15516,461,3.76953e+16,70.4641,2049.28,15977,98,26,15231,15170,14398,14090,10148
31469,6931,9839,0,31469,11494,19975,2.26604e+15,58.4431,11934.3,31469,4770,72,31082,31082,31082,31082,31082
41844,8634,9709,14706,27138,0,41844,9.90402e+12,60.0957,12597.8,41844,4729,72,23960,23960,17660,19213,16494
18255,80,82,18163,92,18255,0,2.40175e+18,81.1682,1150.16,18255,82,82,15872,4262,7098,7652,710
1897,618,718,1897,0,1787,110,4.12228e+18,85.7348,965.243,1897,246,59,1179,1179,1113,1138,1146
10276,278,434,0,10276,9980,296,3.54398e+16,20.0155,1224.65,10276,64,26,9842,9842,9016,9086,7069
22913,6,11,22258,655,22908,5,1.45252e+14,10.0854,427.887,22913,11,11,5023,1861,1823,1736,1677
28423,3239,9016,0,28423,0,28423,5.79596e+17,94.7521,11200.7,28423,4367,110,31287,31287,20680,27815,10596
1338,255,525,1338,0,1258,80,3.11059e+18,82.8759,718.254,1338,177,50,813,813,557,669,578
19883,7808,8512,19013,870,19013,870,8.70257e+18,92.5926,9970.25,19883,4123,110,11371,11371,11341,11341,11274
19133,4003,4934,0,19133,6805,12328,2.45436e+15,59.5222,6433.18,19133,2396,72,37381,37558,0,0,0
13102,2229,3407,12352,750,12352,750,2.65349e+18,95.2188,4683.27,13102,1583,111,21543,21543,14819,11558,6578
45023,53,176,44938,85,45023,0,6.08493e+18,173.438,2626.28,45023,170,172,21483,8597,11867,5008,5629
31720,5338,8192,31720,0,31720,0,3.99595e+15,6076.34,16103.2,31720,8192,4,24226,26705,22707,26015,17959
42528,7950,17832,42528,0,40651,1877,4.62236e+18,1596.94,20506,42528,4992,140,35284,35284,34590,34590,26863
2024,437,632,1910,114,1910,114,2.40148e+18,90.8631,946.812,2024,274,57,1392,1392,1380,1336,1114
11248,6482,6884,10908,340,10908,340,2.11397e+18,89.3708,7605.02,11248,3326,95,4364,4364,4255,4352,4358
4308,912,1508,4308,0,4058,250,3.7566e+18,90.1787,1932.06,4308,525,88,2800,2800,2163,2462,2010
45235,948,10557,0,45235,15905,29330,2.52802e+15,60.0713,13634.9,45235,5132,72,37308,37308,13002,15773,5322
48009,5566,11198,16870,31139,0,48009,9.87057e+12,60.0699,14430.5,48009,5447,72,47561,47561,47561,47561,47561
13501,2251,4767,12828,673,12828,673,4.64584e+18,94.7974,5950.3,13501,2251,111,0,0,10637,10637,5512
46266,9,10,45546,720,46170,96,9.66722e+13,3.99773,592.075,46266,7,4,14249,9591,8163,10311,7258
7555,1346,1833,0,7555,2660,4895,2.53219e+15,59.396,2581.13,7555,893,72,5722,5722,5130,5024,4318
39199,11195,12741,0,39199,14413,24786,2.22865e+15,58.5818,15202.3,39199,6204,72,21752,21280,19061,19746,15762
13163,259,562,0,13163,12787,376,3.56374e+16,20.0379,1558.12,13163,75,26,11819,11819,9646,10035,8470
9221,313,391,0,9221,8957,264,3.53997e+16,20.0166,1109.79,9221,60,26,18997,18567,8721,5119,2239
1917,20,34,0,1917,1761,156,2.93945e+16,9.91967,156.435,1917,33,11,1883,1882,1807,1734,1853
5824,51,1430,5484,340,0,5824,2.23442e+18,95.5549,2153.23,5824,669,91,2637,614,1882,2044,541
26191,6811,9902,26191,0,24824,1367,4.36366e+18,187.723,11317,26191,4123,125,25727,25727,24301,24406,21787
43078,10118,10349,40568,2510,40568,2510,1.19955e+18,98.3285,13558.9,43078,4899,111,34860,34860,34860,34860,34860
47422,1610,1640,0,47422,46047,1375,3.99674e+16,297.607,5534.28,47422,276,26,31562,31370,20356,26348,6056
49285,2548,11468,17324,31961,0,49285,9.89061e+12,60.0995,14772.3,49285,5586,72,38266,38266,25908,36127,10804
7714,2253,3314,7373,341,7373,341,2.73353e+18,91.6906,4035.94,7714,1559,100,4400,4400,3715,3866,3808
13917,1,10,13521,396,13911,6,1.39029e+14,9.94906,326.256,13917,10,10,3564,3564,3564,3564,3564
46945,16005,19684,46945,0,44825,2120,4.60064e+18,1800.54,22360.2,46945,6282,144,46388,46388,46388,46388,46388
24453,3,13,23741,712,24438,15,1.67126e+14,10.2184,465.925,24453,12,12,18910,14250,14108,15515,9373
48701,7550,19080,0,48701,0,48701,5.14263e+17,94.3817,22119.2,48701,9254,110,48108,48108,48108,48108,48108
41371,5375,17351,39541,1830,39541,1830,2.75318e+18,94.9256,19925.2,41371,8429,110,20661,20661,7496,20591,7046
16244,3432,3819,5706,10538,0,16244,9.93272e+12,59.8483,5167,16244,1860,72,36890,36890,25518,34930,11308
15135,2405,7183,0,15135,5965,9170,1.74289e+15,56.0152,8141.93,15135,3494,72,7952,7952,5623,4193,3054
47188,2327,15045,47188,0,44441,2747,4.00229e+18,325.604,16999.3,47188,4745,136,31760,31760,21628,30020,9405
31287,691,971,0,31287,30397,890,3.55693e+16,194.846,3147.66,31287,142,26,21848,21089,13873,13622,3094
13689,1045,6079,13102,587,0,13689,1.63611e+18,93.8897,7158.98,13689,2941,110,7610,7524,4151,3462,1733
3817,1307,1660,3647,170,3647,170,2.73783e+18,91.5203,2096,3817,780,70,2157,2157,1794,2074,1668
13333,507,3155,0,13333,4685,8648,2.54355e+15,59.7621,4309.93,13333,1537,72,10178,10178,6365,3337,1843
18303,4306,4321,0,18303,0,18303,6.50706e+17,97.4841,6020.07,18303,2085,110,19400,19400,11079,11997,7700
14087,136,5453,13425,662,13425,662,7.90053e+18,94.1064,6638.78,14087,2624,110,8634,5506,6237,5001,788
27535,1,14,26710,825,27505,30,1.94022e+14,10.1372,519.927,27535,13,12,13601,13601,13601,13601,13601
4822,2797,4510,0,4822,1501,3321,2.35804e+15,3.94691,4541.55,4822,1515,9,10963,10972,0,0,0
38821,6598,12095,36771,2050,36771,2050,4.49087e+18,97.2349,14837.5,38821,5780,111,45875,45875,45875,45875,45875
25373,11930,12112,10008,15365,0,25373,6.76092e+12,55.6482,13533.6,25373,5883,72,32584,32584,32584,32584,32584
40245,251,13604,0,40245,14890,25355,2.18781e+15,58.3816,16078,40245,6623,72,38848,38461,35827,33632,25001
5714,1510,2423,5714,0,5423,291,4.16546e+18,90.7798,2890.24,5714,937,92,3291,3291,2454,2849,2089
22275,10068,11705,21465,810,0,22275,1.39099e+18,89.8166,13085.4,22275,5677,110,39609,39609,39609,39609,39609
3774,127,170,0,3774,3668,106,3.53606e+16,19.8031,504.337,3774,40,26,3604,3604,3399,3409,3072
16226,10,12,15760,466,16214,12,1.45126e+14,10.666,365.236,16226,12,11,16120,15956,15678,15679,15014
31207,94,7343,29395,1812,29395,1812,5.77336e+18,97.697,9906.54,31207,3546,110,31488,17019,26450,21977,0
34544,159,176,34528,16,34544,0,6.00369e+18,172.379,2240.79,34544,166,169,43861,43853,43847,43845,43845
27089,1,14,26302,787,27039,50,1.57482e+14,10.5296,531.27,27089,13,11,2200,2200,2200,2200,2200
33465,7216,10246,33465,0,31516,1949,5.4387e+18,234.191,12014.5,33465,3945,130,25084,25084,18484,17037,11481
8684,2580,4273,8684,0,0,8684,8.77387e+17,17.909,4534.48,8684,3830,20,4411,4411,2827,3922,2728
41663,825,9721,39235,2428,39235,2428,5.74115e+18,97.8713,12942.8,41663,4712,110,33695,33695,18029,12505,12382
39485,7757,12357,0,39485,0,39485,5.80735e+17,96.0601,15192.5,39485,5979,110,30315,30315,28622,27940,26041
41963,5,16,40722,1241,41896,67,1.79699e+14,10.3438,713.368,41963,13,12,14263,12537,12079,12304,11517
19572,8,176,19522,50,19572,0,6.12358e+18,168.524,1731.46,19572,138,143,4213,848,772,723,667
33486,1352,11283,31796,1690,31796,1690,7.39121e+18,96.1536,13707.1,33486,5473,110,27542,27542,22679,18620,5920
13752,2179,4706,5090,8662,0,13752,8.52207e+12,57.546,5762.55,13752,2287,72,9046,9046,6894,8562,3973
25115,5320,11897,25115,0,24024,1091,4.99837e+18,252.68,13209.9,25115,4856,130,27528,27528,23295,16321,14768
31631,218,976,0,31631,30732,899,3.55675e+16,196.106,3174.9,31631,144,26,30511,30318,26020,26058,11348
47850,12681,18788,47850,0,45393,2457,4.59704e+18,429.289,20763.6,47850,6784,140,32726,32716,31112,32347,28375
42239,436,1649,0,42239,41006,1233,4.18913e+16,301.161,5419.79,42239,278,26,41150,40704,39114,37798,29937
36660,471,10078,36660,0,36660,0,2.40776e+18,3654.71,13819.7,36660,7384,27,0,0,0,0,0
21423,1925,6107,7717,13706,0,21423,9.19722e+12,59.0781,7698.97,21423,2959,72,26511,26511,18724,18864,8293
13013,334,837,0,13013,12631,382,4.4548e+16,137.349,2221.31,13013,113,26,12176,12005,9888,10297,6809
10622,1970,2683,3767,6855,0,10622,9.7534e+12,59.4142,3638.47,10622,1306,72,7939,7939,7066,7751,5781
24847,3242,9525,16773,8074,23669,1178,2.15356e+18,95.9236,11317.2,24847,4562,111,19020,18934,6491,18074,7723
6033,1504,1547,5691,342,5691,342,5.99128e+18,95.3807,2283.05,6033,722,91,4486,4486,4486,4486,4479
8212,222,639,0,8212,7970,242,4.43823e+16,19.2836,1539.23,8212,80,26,7573,7573,6828,6394,3314
48858,23546,26168,47128,1730,47128,1730,2.44789e+18,93.0845,28629.6,48858,12719,110,34436,34436,34436,34436,34436
40299,25,176,40224,75,40299,0,5.98187e+18,169.832,2376.93,40299,171,171,0,0,0,0,0
47394,8923,13081,44786,2608,44786,2608,3.26856e+18,96.9311,16491.6,47394,6344,110,38815,38815,38815,38815,38815
40651,9088,10885,38371,2280,38371,2280,2.47212e+18,97.8981,13868.7,40651,5173,111,36268,36268,36268,36268,36268
36055,3067,9503,34038,2017,34038,2017,3.28926e+18,97.3181,12286.9,36055,4604,110,22254,21859,12839,16757,7041
24555,9481,10166,24555,0,23315,1240,5.50266e+18,192.454,11347.3,24555,3838,127,43605,43605,43605,43605,43605
36815,52,1074,0,36815,35766,1049,3.56188e+16,225.621,3604.11,36815,163,26,20171,9264,12290,6081,5434
13257,8,11,12864,393,13243,14,1.8748e+14,10.1256,341.518,13257,11,11,13039,12923,10913,10958,10249
48139,18975,23597,48139,0,48139,0,2.81817e+18,17.9843,24237.1,48139,21228,20,36985,36985,36985,36985,36985
4559,41,2485,0,4559,1847,2712,1.52611e+15,50.0469,2844.4,4559,1197,59,1668,448,1035,310,0
13416,1988,5083,12773,643,12773,643,2.83627e+18,95.5714,6226.35,13416,2433,111,8333,8333,5610,6240,5254
4240,1911,2060,4240,0,4050,190,5.72992e+18,85.2809,2442.04,4240,853,79,2180,2180,2178,2180,2180
29105,13921,15644,28073,1032,28073,1032,4.24563e+18,92.9376,17271.7,29105,7536,111,28012,28012,28012,28012,28012
22651,3182,5449,21331,1320,21331,1320,2.17176e+18,98.0608,7407.72,22651,2570,111,17384,16687,9912,9773,3963
20677,2605,5060,19477,1200,19477,1200,3.00942e+18,97.9058,6876.46,20677,2380,111,15617,15617,14108,14947,8846
21214,798,993,0,21214,20594,620,4.11544e+16,205.232,2931.6,21214,148,26,9963,9953,1364,9951,691
34850,2394,17102,34850,0,33610,1240,4.81234e+18,1932.84,19638.2,34850,6275,141,18222,4725,3490,1965,2240
38626,5110,9972,13757,24869,0,38626,9.57122e+12,59.6644,12598.5,38626,4858,72,33410,33410,23746,25722,17599
22852,5,11,22200,652,22840,12,1.38804e+14,10.1802,423.231,22852,11,11,21031,18688,18140,17767,13220
24264,143,176,24185,79,24264,0,6.09045e+18,171.71,1927.93,24264,151,154,23602,22163,19666,19791,19573
16899,7372,8008,0,16899,0,16899,4.4791e+17,88.9069,9224.81,16899,3860,110,39502,39502,39502,39502,39502
20777,5710,10063,20777,0,19867,910,4.0429e+18,222.577,11094.7,20777,3925,126,10714,10643,8639,9504,6458
37325,11693,17340,35805,1520,35805,1520,2.63831e+18,92.6208,19577.2,37325,8424,110,34541,34541,34223,34223,34223
44667,1871,15782,0,44667,0,44667,5.47411e+17,96.0201,18758.3,44667,7670,110,33757,33757,27708,30091,26034
25810,134,274,25552,258,25810,0,5.68799e+18,212.891,1217.87,25810,270,31,32994,20471,28546,25125,2497
48770,134,176,48693,77,48770,0,5.98129e+18,171.827,2616.47,48770,171,173,36419,18705,17700,25110,10265
37580,238,9019,35392,2188,35392,2188,1.62646e+18,98.2763,11905.8,37580,4257,111,46824,46814,46801,46823,46047
47887,11529,12122,45168,2719,0,47887,2.17213e+18,97.6191,15647.1,47887,5884,110,30584,30584,27000,26260,23156
917,254,261,330,587,0,917,1.01858e+13,54.4504,415.614,917,127,42,656,656,645,649,651
41728,11790,18879,0,41728,0,41728,4.64149e+17,92.2164,21356,41728,9162,110,33749,33749,32957,32715,31983
18216,9,14,17688,528,18143,73,1.54243e+14,10.6597,426.381,18216,14,12,17975,17771,16923,16551,14759
2839,120,145,0,2839,2757,82,3.63461e+16,19.5844,418.767,2839,36,26,2694,2694,2661,2660,2560
10962,395,465,0,10962,10648,314,3.53912e+16,20.0481,1301.91,10962,66,26,10497,10497,10367,10382,9416
23492,2699,5716,22130,1362,22130,1362,5.77348e+18,97.9857,7721.43,23492,2687,111,23412,23412,17557,10031,8944
8707,1683,2198,8205,502,8205,502,5.67456e+18,96.8319,3152.04,8707,1014,108,6509,6509,5570,5790,5371
47117,1047,1266,0,47117,45773,1344,3.55677e+16,259.205,4428.84,47117,201,26,45215,45214,42760,42580,36121
12393,2335,3288,0,12393,4410,7983,2.43261e+15,59.2555,4352.83,12393,1594,72,9105,9105,7716,8016,6189
21471,1318,8093,20451,1020,20451,1020,2.89523e+18,90.6012,9742.09,21471,3901,110,33932,33932,33932,33932,33932
13974,4033,4451,13974,0,13161,813,3.76143e+18,115.72,5412.93,13974,1688,121,9523,9523,9248,9369,9114
5685,203,248,0,5685,5523,162,3.54775e+16,19.8294,722.126,5685,47,26,5437,5437,5256,5264,4919
36934,1383,14771,36934,0,35110,1824,4.72349e+18,340.038,16618.6,36934,4158,139,36863,36863,36863,36504,36504
9546,1434,2271,8986,560,0,9546,2.23858e+18,96.6981,3317.37,9546,1085,110,0,8405,5984,6511,3050
37648,6025,37648,37648,0,0,37648,7.99979,0,37648,37648,37648,1,26225,26225,20739,24851,11873
46170,2520,13917,46170,0,43487,2683,4.5358e+18,323.699,16174.5,46170,2857,137,36041,36041,23804,18088,8651
46883,13486,20238,44843,2040,44843,2040,4.42006e+18,94.9702,22976.9,46883,9740,111,37360,37360,37360,37360,37360
25439,4519,5926,0,25439,8932,16507,2.52969e+15,59.9856,7855.9,25439,2880,72,19513,19513,17445,14910,15071
30683,3510,17386,30683,0,0,30683,8.96749e+17,17.9348,17842.7,30683,15635,20,36207,36207,36207,36207,36207
42440,5270,9855,0,42440,14916,27524,2.53568e+15,60.0802,12772.9,42440,4801,72,43690,43690,43690,43690,43690
27308,84,176,27217,91,27308,0,6.15199e+18,168.29,2037.87,27308,152,151,23652,18038,13119,13165,12988
7036,2370,2873,6713,323,0,7036,1.76073e+18,93.1585,3569.57,7036,1381,97,4163,4163,3699,3570,3619
30487,4042,7163,28709,1778,28709,1778,5.76206e+18,97.7367,9676.52,30487,3466,110,17986,17956,9063,12918,3809
43282,1632,2050,0,43282,41996,1286,4.67387e+16,313.389,6627.2,43282,359,26,38882,38882,34414,33647,30479
33798,101,176,33785,13,33798,0,5.98431e+18,169.66,2177.74,33798,170,168,17544,7296,0,0,0
10182,835,2478,9592,590,9592,590,3.35052e+18,96.7713,3571.15,10182,1186,110,15561,15561,8186,4225,2850
3190,84,175,3130,60,3190,0,5.997e+18,144.064,673.32,3190,87,84,2567,1494,1409,1518,1551
18075,328,721,0,18075,17558,517,3.55126e+16,49.3529,2042.41,18075,93,26,13177,12889,7817,11914,1311
23882,843,9016,0,23882,9002,14880,2.05735e+15,57.7164,10573.2,23882,4391,72,38772,38772,38772,38772,38772
5060,199,444,0,5060,4910,150,4.66666e+16,18.9178,1059.12,5060,60,26,4616,4616,4094,4315,2982
41162,10,16,39965,1197,41103,59,1.59153e+14,10.3584,634.623,41162,14,12,39540,38553,36868,36373,30850
15576,678,5902,14836,740,0,15576,1.81835e+18,94.1833,7195.99,15576,2850,110,14701,14664,14587,14553,13873
42465,1,13,41252,1213,42443,22,1.41006e+14,10.3245,591.359,42465,12,12,17536,17536,17536,17536,17536
25776,2847,6032,24269,1507,0,25776,2.23286e+18,97.6902,8243.12,25776,2920,110,25632,25632,25632,25632,25632
13535,342,634,0,13535,13149,386,3.66863e+16,20.0229,1706.12,13535,82,26,15667,15662,11626,14077,7417
2534,4,10,2464,70,2534,0,1.38183e+14,9.73836,137.096,2534,10,10,2221,1986,1681,1723,1114
12623,1817,4683,12013,610,0,12623,1.84703e+18,92.9076,5800.89,12623,2256,110,35736,35736,15797,14356,7479
36242,5709,8438,0,36242,12737,23505,2.53143e+15,60.0681,11006.5,36242,4106,72,27804,27804,23881,24691,19206
16180,2911,3943,15238,942,15238,942,5.27437e+18,97.7609,5454.98,16180,1849,111,12237,12237,12237,12016,9801
37191,14687,15403,0,37191,14259,22932,1.93684e+15,57.1775,17506.2,37191,7503,72,32391,32391,32391,32391,32391
17638,4079,5792,16737,901,0,17638,1.96236e+18,95.8796,7294.95,17638,2790,110,11846,11846,10272,9990,8749
10959,1709,2669,10327,632,0,10959,2.21719e+18,96.7086,3821.8,10959,1271,110,8290,8290,7306,6893,5971
21714,2660,6781,0,21714,0,21714,5.84382e+17,93.3079,8570.44,21714,3280,110,21022,21022,21022,21022,21022
2974,350,845,2804,170,0,2974,2.18234e+18,93.0457,1275.32,2974,389,70,2129,2129,1604,1449,1221
12817,2889,5307,12240,577,0,12817,1.72146e+18,94.3009,6377.81,12817,2566,110,9091,9091,8824,8915,8104
10850,1211,2624,10220,630,0,10850,2.22266e+18,96.8968,3772.35,10850,1256,110,15880,15880,9846,6141,4234
21116,603,820,0,21116,20510,606,3.66158e+16,122.755,2419.41,21116,112,26,16480,16480,7662,6839,4030
23124,60,960,0,23124,22455,669,3.90889e+16,189.382,2897.4,23124,141,26,22220,22185,17940,18019,5994
27182,699,1371,0,27182,26380,802,4.54847e+16,194.856,4191.03,27182,222,26,26965,26965,26965,26965,26965
41119,96,176,41104,15,41119,0,5.98296e+18,172.192,2403.63,41119,170,172,29788,6547,10497,16548,598
19748,1458,7111,0,19748,7383,12365,2.11375e+15,57.6703,8482.94,19748,3450,72,12637,12637,7746,5180,1942
30726,3730,7181,10807,19919,0,30726,9.89465e+12,60.0192,9422.28,30726,3491,72,35292,35292,33532,28677,13838
4445,889,1471,0,4445,1630,2815,2.2661e+15,57.4547,1931.8,4445,712,72,2974,2974,2471,2331,1836
40626,14571,16537,40626,0,36014,4612,1.54309e+18,4406.63,23208,40626,4830,27,24089,23777,23341,23213,23010
23521,4786,11360,22583,938,22583,938,3.3652e+18,92.8106,12868.8,23521,5450,111,19081,19081,12108,16108,3056
21530,5,175,21523,7,21530,0,5.98167e+18,166.397,1736.14,21530,158,156,3082,474,328,298,572
9791,847,2289,3439,6352,0,9791,9.97432e+12,59.6535,3203.78,9791,1115,72,7502,7502,5384,7135,2952
16705,6,11,16229,476,16698,7,1.38808e+14,9.94618,358.405,16705,10,11,15917,15477,13972,13960,11172
40777,41,176,40716,61,40777,0,6.07849e+18,171.691,2495.43,40777,164,169,38709,38409,23070,27293,15230
46936,15546,19013,44816,2120,0,46936,1.7314e+18,94.401,21913.4,46936,9222,110,30319,30319,29922,29759,29488
32067,3850,7532,30199,1868,0,32067,2.22763e+18,97.76,10151,32067,3645,110,31824,31824,31824,31824,31824
13511,5400,6126,12941,570,12941,570,2.95176e+18,94.2704,7172.8,13511,2929,111,7385,7385,6810,6849,6897
32927,8229,11755,0,32927,0,32927,5.4427e+17,95.8294,14093.6,32927,5702,110,30566,30566,29283,30276,26996
1854,252,493,648,1206,0,1854,9.77316e+12,56.7411,755.537,1854,229,53,1361,1361,1043,1301,811
45292,150,176,45164,128,45292,0,6.08943e+18,173.746,2628.64,45292,174,171,44560,44560,42806,42906,35665
20577,629,1157,0,20577,19968,609,4.61474e+16,245.578,3387.11,20577,179,26,16728,16728,13462,15060,10854
18887,2667,7541,7186,11701,0,18887,7.73425e+12,57.2327,8801.66,18887,3657,72,17749,17749,12302,7655,5650
27320,510,9516,25962,1358,0,27320,1.90049e+18,87.547,11560.3,27320,4611,110,17804,17636,6233,4467,0
5341,524,1320,5031,310,0,5341,2.23075e+18,95.4334,2001.52,5341,619,88,5185,5185,5185,993,1374
42699,11,15,41478,1221,42612,87,1.4372e+14,10.6594,663.995,42699,14,12,25798,21736,20811,20166,19649
34926,1732,8177,32889,2037,0,34926,2.22978e+18,97.8213,10977.5,34926,3965,110,34617,34617,34617,34617,34617
5254,479,1324,1850,3404,0,5254,9.80582e+12,58.8907,1891.01,5254,640,72,3930,3930,2799,3730,1595
26471,87,176,26399,72,26471,0,6.05773e+18,172.282,2000.27,26471,158,162,43790,43541,43559,43467,41738
7311,937,2816,2767,4544,0,7311,8.01495e+12,56.0324,3443.31,7311,1366,72,4495,4495,3069,4248,1559
4036,587,1015,0,4036,0,4036,6.59533e+17,94.8142,1567.94,4036,475,81,3021,3021,2543,2323,2078
28942,162,1314,0,28942,28096,846,4.31345e+16,268.442,4086.74,28942,212,26,27173,26837,19002,18137,5212
45531,2231,14529,45531,0,42881,2650,3.97496e+18,317.049,16434.3,45531,4608,136,31637,31637,23347,16797,14182
41775,7110,9987,39338,2437,39338,2437,2.21631e+18,98.3417,13123.8,41775,4719,111,28866,28866,24796,21011,17565
26138,275,6270,0,26138,0,26138,6.4517e+17,97.5751,8491.03,26138,3032,110,19868,19868,6136,1246,2152
9114,1415,2857,8634,480,0,9114,2.01876e+18,94.8788,3797.95,9114,1362,105,6257,6257,4763,4506,3376
49011,156,176,48925,86,49011,0,5.98447e+18,171.941,2622.96,49011,171,172,37357,36851,23654,20784,6679
45085,15041,20038,0,45085,17529,27556,1.83243e+15,56.6318,22397,45085,9739,72,36841,36841,36841,36841,36841
25107,843,5889,23647,1460,0,25107,2.22887e+18,97.6201,8058.29,25107,2844,110,19218,19218,8098,7432,3877
11339,420,780,10879,460,3524,7815,1.57213e+18,16.9699,1178.76,11339,471,19,10559,10559,9982,10217,7277
4253,19,176,4251,2,4253,0,6.02132e+18,144.141,796.489,4253,94,91,1637,306,433,427,440
32519,148,1079,0,32519,31588,931,3.70692e+16,221.832,3502.64,32519,164,26,16872,0,0,0,0
37727,8478,9051,35531,2196,35531,2196,6.1259e+18,98.2729,11947.6,37727,4278,111,37408,37408,37408,37408,37408
18121,2082,4283,17063,1058,17063,1058,5.88394e+18,97.4799,5971.38,18121,2065,110,27374,27374,27374,27374,27374
35807,1350,1616,0,35807,34754,1053,4.44014e+16,301.8,5150.3,35807,269,26,26083,26083,13764,8494,5689
31840,3178,15611,31840,0,31840,0,2.36257e+18,17.9788,16128.3,31840,14036,20,26011,26011,23009,21796,18193
2226,22,110,0,2226,2161,65,3.53814e+16,19.106,326.064,2226,32,26,2108,1969,1421,1406,628
822,183,822,0,822,400,422,53417700000,0,822,822,401,21,0,0,0,0,0
37414,695,11543,35434,1980,35434,1980,6.71076e+18,97.2311,14219.6,37414,5512,111,37155,37155,37155,37155,37155
20994,1849,10716,20206,788,0,20994,1.43441e+18,93.2192,12067.1,20994,5200,110,20129,20129,11636,4973,3079
36029,1114,8646,33929,2100,33929,2100,4.30325e+18,98.2603,11439.5,36029,4086,111,48837,48837,48837,48837,48837
45138,1918,2723,0,45138,0,45138,3.76694e+18,15.993,3514.62,45138,1856,18,42415,42415,35710,36547,34596
40006,12786,18462,15686,24320,0,40006,6.95559e+12,56.3701,20548.2,40006,8988,72,38718,38718,38718,38718,38718
6332,321,1496,2221,4111,0,6332,9.92477e+12,59.4237,2159.68,6332,723,72,4836,4836,2278,4125,1154
43388,2390,16649,43388,0,41178,2210,4.61273e+18,363.42,18722.1,43388,5692,138,41556,41556,41556,41556,41556
35916,7337,10496,13002,22914,0,35916,9.12695e+12,59.1261,12883.1,35916,5111,72,26068,26068,24962,26012,24277
7356,375,3055,7356,0,6986,370,3.51084e+18,93.0249,3639.86,7356,1243,104,4301,4208,2268,2982,1106
506,5,210,476,30,0,506,2.25102e+18,70.1383,308.513,506,78,34,47,12,2,1,8
4040,26,175,4039,1,4040,0,5.99733e+18,150.299,756.954,4040,93,91,1834,426,532,605,609
47543,11717,16578,0,47543,0,47543,5.50208e+17,96.054,19724.3,47543,8049,110,34201,34201,33227,33745,31606
28897,501,11441,28897,0,27441,1456,4.1905e+18,207.28,12928.1,28897,4260,133,17456,16704,7882,11164,1043
32698,774,1141,0,32698,31759,939,3.80849e+16,234.599,3689.98,32698,177,26,30713,30713,15283,16781,3621
24701,332,844,0,24701,23994,707,3.55081e+16,141.112,2593.12,24701,117,26,23857,23676,21359,21501,13595
27430,906,8623,25990,1440,25990,1440,2.42533e+18,93.9229,10718.2,27430,4092,111,25127,24746,11624,13759,2771
31152,852,1008,0,31152,30260,892,3.63341e+16,206.673,3261.19,31152,150,26,30144,30144,29708,29691,27168
28348,6,12,27539,809,28336,12,1.3902e+14,10.3694,477.394,28348,12,11,5925,644,560,1999,191
17482,7690,8946,0,17482,6999,10483,1.6167e+15,55.5002,9961.11,17482,4353,72,17409,17409,17409,17409,17409
32159,3225,10477,30499,1660,30499,1660,2.05524e+18,96.8581,12812.9,32159,4993,111,34385,34385,24429,22714,12180
45583,10494,20033,43635,1948,43635,1948,8.7581e+18,94.6289,22731.4,45583,9736,110,43557,43557,43557,43557,43557
8752,564,3115,8319,433,0,8752,1.89929e+18,94.8091,3985.52,8752,1495,100,5637,5551,2458,2579,1853
47064,2530,11278,44324,2740,44324,2740,2.60555e+18,98.3752,14726.4,47064,5343,111,36736,36736,20911,23304,13726
25277,167,175,25265,12,25277,0,5.97969e+18,167.03,1881.1,25277,158,163,25046,24743,24174,24133,24153
26116,4674,12126,25046,1070,0,26116,1.56588e+18,94.025,13825.7,26116,5889,110,22701,22701,15278,18062,12303
38232,12,16,37104,1128,38164,68,1.79367e+14,10.3648,670.671,38232,13,12,13166,4888,5327,5461,5144
31634,10882,11407,30094,1540,0,31634,1.86318e+18,93.2986,13664,31634,5533,110,24967,24967,24967,24967,24967
39309,843,1117,0,39309,38189,1120,3.55348e+16,232.717,3792.42,39309,171,26,30758,30183,11972,19590,2122
28296,42,1027,0,28296,27481,815,3.78853e+16,215.503,3238.61,28296,154,26,22067,16397,16079,16735,16052
48537,473,1466,0,48537,47143,1394,3.76032e+16,276.422,5054.6,48537,242,26,39646,39044,33877,28374,27283
10500,1504,3403,10500,0,9894,606,5.6549e+18,94.1163,4198.17,10500,1283,120,12994,12994,9717,10107,3897
10919,135,176,10845,74,10919,0,6.11221e+18,165.368,1293.95,10919,125,122,10438,9779,8303,8353,8268
36089,12067,12195,13362,22727,0,36089,8.54202e+12,58.3974,14463.6,36089,5941,72,35800,35800,35800,35800,35800
41548,2024,13684,39428,2120,39428,2120,7.30164e+18,95.4871,16578.1,41548,6643,110,43791,43791,43791,43791,43791
49412,18176,24679,47515,1897,47515,1897,8.62057e+18,94.4149,27262,49412,11915,111,35803,35803,35803,35803,35803
28674,1,12,27855,819,28662,12,1.41582e+14,10.3548,483.606,28674,12,11,7205,7205,7205,7205,7205
30110,2327,7045,0,30110,10583,19527,2.52714e+15,60.0058,9251.07,30110,3426,72,21751,21751,14863,10754,6923
33990,3969,11689,12613,21377,0,33990,8.4905e+12,58.2778,13828.8,33990,5694,72,42886,42886,42886,42886,42886
16729,1382,7436,16019,710,16019,710,2.65514e+18,90.4077,8692.8,16729,3599,110,9293,9293,6703,6808,2947
39121,7677,9285,0,39121,0,39121,6.45875e+17,97.7771,12336.4,39121,4504,110,34062,29635,27194,29205,24302
570,31,111,0,570,550,20,6.86443e+16,9.48421,216.456,570,27,17,459,459,254,377,109
16575,1797,3949,15615,960,0,16575,2.22495e+18,97.2708,5526.07,16575,1889,110,12626,12626,9781,9252,6532
14871,4350,4961,14871,0,14002,869,3.97644e+18,121.026,5858.96,14871,1789,120,9910,9910,9406,9613,9054
22481,8673,11957,21671,810,21671,810,2.81392e+18,89.1987,13315.7,22481,5744,111,19275,19275,19275,19275,19275
47203,11151,19259,45063,2140,45063,2140,4.0231e+18,95.3595,22100.9,47203,9263,111,45502,45502,45502,45502,45502
10818,58,464,0,10818,10511,307,3.56292e+16,20.0386,1300.18,10818,66,26,10354,10354,7092,7013,2722
21333,1599,5154,20093,1240,20093,1240,5.85048e+18,97.9571,7024.11,21333,2429,111,14780,14780,11536,12599,10607
47544,1333,2735,14413,33131,14413,33131,1.95724e+18,15.9935,3549.09,47544,1959,18,32732,32221,18717,23703,8659
49402,1373,2444,0,49402,47927,1475,4.85654e+16,326.578,7936.26,49402,435,26,38818,38818,18378,13563,10434
40407,2619,11928,0,40407,14642,25765,2.32435e+15,59.0657,14544.5,40407,5804,72,28550,28550,17983,5558,5439
2711,30,1346,2601,110,2601,110,5.2743e+18,77.7233,1660.3,2711,630,60,603,55,149,271,53
49762,4714,11844,17531,32231,0,49762,9.81864e+12,59.9841,15154.1,49762,5758,72,35080,34903,25875,29077,18101
10722,4047,4249,10214,508,10214,508,2.54759e+18,95.1181,5196.59,10722,2022,108,6473,6473,6448,6403,6173
40016,13987,17767,40016,0,38416,1600,5.06143e+18,2158.82,20645.6,40016,7279,146,48045,48045,48045,48045,48045
38420,16496,20804,38420,0,38420,0,3.3418e+18,17.9777,21340.2,38420,18713,20,17616,17616,13813,17616,13727
28535,1,12,27721,814,28521,14,1.39006e+14,10.3563,478.326,28535,12,11,227,227,227,227,227
12037,2,11,11691,346,12030,7,1.49986e+14,10.4661,312.985,12037,11,11,7069,5184,4469,4726,3602
25227,4787,8588,0,25227,9332,15895,2.17749e+15,56.9355,10287.2,25227,4163,72,16639,16639,13672,10684,8817
18669,2734,4420,0,18669,0,18669,6.47904e+17,97.4091,6145.3,18669,2129,110,18457,18457,18457,18457,0
31331,3832,13956,12188,19143,0,31331,7.15586e+12,55.6845,15717,31331,6792,72,30953,30953,30953,30953,30953
28986,6,11,28157,829,28972,14,1.3863e+14,10.1647,476.048,28986,11,11,27562,26689,19044,19385,19416
32608,4931,12992,31118,1490,0,32608,1.75272e+18,95.1355,15196.1,32608,6297,110,31902,31902,25033,24222,16915
2523,986,1146,2413,110,2413,110,2.70407e+18,68.4451,1463.32,2523,532,58,1377,1377,1377,1377,1377
17114,2825,8179,0,17114,6751,10363,1.72769e+15,55.0203,9230.57,17114,3972,72,8935,8935,6294,4482,4096
5089,727,1377,4799,290,4799,290,3.67683e+18,94.8601,2017.99,5089,615,88,3712,3712,3041,3623,2408
31474,225,7578,29644,1830,29644,1830,4.05772e+18,98.2171,10094.2,31474,3588,111,20382,19952,7874,1400,1968
28476,53,176,28421,55,28476,0,6.12709e+18,171.615,2087.97,28476,154,157,14238,3633,6898,8864,554
30723,1265,1425,6371,24352,0,30723,5.83302e+13,11.9936,1997.15,30723,1282,14,29298,29298,28144,27400,28779
44887,23533,24547,43327,1560,43327,1560,2.9958e+18,92.5809,26771.5,44887,11865,111,44152,44152,44152,44152,44152
3403,60,949,3203,200,3203,200,2.05051e+18,94.3397,1420.96,3403,428,72,1644,443,762,1164,477
25861,1178,1631,24807,1054,7938,17923,1.29757e+18,16.986,2243.52,25861,1065,19,21259,21718,0,0,0
30128,983,1596,0,30128,29234,894,4.77076e+16,292.892,4932.81,30128,266,26,19054,18426,13666,15825,10485
12009,8,10,11664,345,12003,6,1.46984e+14,9.73686,307.865,12009,10,10,11738,11606,11084,11083,10048
9620,2313,2349,9060,560,9060,560,3.35196e+18,96.6932,3394.94,9620,1120,110,7271,7271,7246,7256,7264
22603,51,208,22589,14,22603,0,6.08572e+18,200.465,1988.92,22603,159,164,20398,4715,14422,4138,0
17190,748,6236,16351,839,16351,839,7.58802e+18,91.1578,7651.89,17190,3001,110,10954,10778,8354,6973,19
36219,2099,16206,14103,22116,0,36219,7.12802e+12,56.5419,18176,36219,7889,72,20013,20013,12228,18683,2964
46213,14,17,44845,1368,46144,69,1.79125e+14,10.3817,752.806,46213,14,12,19910,14006,13421,14541,13450
35244,5384,8256,33194,2050,0,35244,2.22801e+18,97.8032,11080.6,35244,3992,110,34858,34858,34858,34858,34858
9717,326,696,0,9717,9434,283,4.27956e+16,20.5637,1698.12,9717,87,26,9021,9020,8194,8187,3172
40510,11,15,39355,1155,40429,81,1.38792e+14,10.6503,629.944,40510,13,12,6444,1375,558,3471,537
29965,6271,9699,11009,18956,0,29965,8.72906e+12,58.5525,11683.6,29965,4714,72,20266,20266,18008,19796,14322
46682,6128,10897,0,46682,16410,30272,2.52729e+15,60.0484,14053.1,46682,5295,72,44439,44439,44439,44439,44439
10755,380,458,0,10755,10449,306,3.56369e+16,20.0967,1292.39,10755,66,26,10297,10297,9990,10011,8991
14901,2046,3562,14034,867,0,14901,2.22482e+18,97.1639,5015.39,14901,1711,110,37383,37383,37383,37383,37383
41800,251,9745,39360,2440,0,41800,2.23076e+18,97.8719,12972.9,41800,4729,110,32959,32787,23334,14072,11452
45067,7517,17406,0,45067,17063,28004,2.0261e+15,57.6447,19961.6,45067,8473,72,44879,44879,44879,44879,44879
36699,3259,8590,0,36699,0,36699,6.48073e+17,97.8195,11502.8,36699,4160,110,28109,28109,19553,15848,11892
46138,5478,19492,46138,0,35269,10869,4.62715e+18,1293.64,21835.1,46138,6232,145,40551,40551,40516,40524,40532
39109,4258,9166,13750,25359,0,39109,9.85848e+12,60.0293,11893.2,39109,4456,72,26807,0,0,0,0
23867,1028,5632,8390,15477,0,23867,9.85624e+12,59.9094,7458.47,23867,2735,72,31773,31728,18434,16138,1869
18504,7091,9980,17844,660,17844,660,5.26658e+18,92.9431,11139.8,18504,4807,111,8524,8524,8027,8524,6221
43428,68,176,43365,63,43428,0,6.04848e+18,173.258,2565.03,43428,173,172,43896,43688,35320,33274,8794
25094,157,175,25023,71,25094,0,5.97914e+18,166.835,1873.87,25094,163,160,24681,24057,22607,22610,22672
43473,7868,18026,43473,0,41495,1978,4.59852e+18,1353.35,20561.6,43473,5012,141,43172,43172,43172,43172,43172
34244,5017,8031,32252,1992,0,34244,2.22871e+18,97.7626,10787.4,34244,3889,110,34040,34040,34040,34040,34040
16822,3096,5102,0,16822,6110,10712,2.3005e+15,58.7663,6394.67,16822,2479,72,10081,10081,6284,8772,2712
30267,226,7118,28507,1760,28507,1760,5.75708e+18,97.7337,9622.66,30267,3446,110,30019,30019,30016,30017,30019
23633,3952,5564,22261,1372,22261,1372,3.3704e+18,97.5479,7631.57,23633,2680,110,19106,19106,15091,18164,9521
47916,5483,11217,45129,2787,45129,2787,5.88329e+18,97.8831,14815,47916,5437,110,47442,47442,47442,47442,47442
47444,14255,18584,0,47444,18007,29437,2.00709e+15,57.5603,21229.8,47444,9047,72,34781,34781,34781,34781,34781
19331,1492,4590,0,19331,6805,12526,2.52851e+15,59.8422,6130.46,19331,2236,72,14741,14741,9132,6135,4925
39937,154,206,39858,79,39937,0,5.98131e+18,186.023,2458.08,39937,178,182,31357,31311,10264,3782,4031
41938,73,176,41844,94,41938,0,6.08381e+18,171.567,2532.47,41938,171,169,23348,16462,8504,3220,1613
40648,6,14,39484,1164,40596,52,1.43764e+14,10.5536,638.187,40648,13,11,8013,1648,1580,1391,1493
44485,11956,16290,16683,27802,0,44485,8.18023e+12,57.9573,18881.2,44485,7934,72,36969,36969,36969,36969,36969
18288,549,767,0,18288,17766,522,3.67971e+16,86.346,2180.58,18288,102,26,13420,13372,6429,2862,1840
10717,95,795,0,10717,10401,316,4.65009e+16,108.891,2023.1,10717,105,26,6592,4875,4993,3681,628
15794,7339,7963,15194,600,0,15794,1.45534e+18,93.109,9070.94,15794,3858,110,7831,7831,7757,7652,7788
27208,2025,12486,27208,0,25988,1220,4.68666e+18,274.008,13890.9,27208,5569,131,19118,19118,9853,15877,1516
39509,6741,13055,39509,0,37239,2270,4.82169e+18,266.9,14760.8,39509,2758,137,25773,25725,17215,19407,6139
49135,161,176,49069,66,49135,0,6.03546e+18,173.738,2723.54,49135,175,173,39403,39346,15876,8004,8174
27027,1419,1605,8225,18802,0,27027,6.90702e+18,15.9883,2214.33,27027,1116,18,26986,26986,6595,3137,2155
49198,3461,14816,49198,0,46336,2862,3.98375e+18,337.318,17186.3,49198,5865,129,23658,23658,12003,14912,9916
28906,111,176,28892,14,28906,0,5.98828e+18,169.555,2014.95,28906,166,162,32943,32799,8412,26043,734
24345,3067,5774,22933,1412,22933,1412,5.9018e+18,97.5505,7885.14,24345,2791,110,18571,18571,17901,17901,10669
31461,4,13,30545,916,31440,21,1.60013e+14,10.3913,528.494,31461,12,12,3020,1318,492,802,210
16657,3994,5391,15787,870,15787,870,2.71374e+18,96.6241,6815.96,16657,2567,111,11266,11266,9964,10279,9261
15572,9,12,15113,459,15564,8,1.75732e+14,10.1349,369.458,15572,11,12,15416,15253,14640,14601,13380
12559,167,208,12500,59,12559,0,6.15343e+18,190.524,1493.21,12559,128,132,12107,11633,10298,10416,10244
11610,4095,4223,11040,570,11040,570,2.74212e+18,90.594,5272.15,11610,1987,111,10164,10164,3383,5644,3286
46184,7713,18380,46184,0,44054,2130,4.49376e+18,1723.74,21229.8,46184,5147,140,46074,46074,46074,46074,46074
26975,5055,7539,25485,1490,25485,1490,4.65025e+18,97.5501,9688.61,26975,3581,111,35961,35971,12738,14860,9974
45001,3058,24559,18307,26694,0,45001,5.8784e+12,55.0903,26554.8,45001,11964,72,20765,20765,11666,17225,3366
39393,20570,25529,34920,4473,34920,4473,1.24865e+18,6.51849,29302.1,39393,8507,14,24963,24963,24963,24963,24963
27631,5920,7398,9875,17756,0,27631,9.43581e+12,59.4157,9381.3,27631,3591,72,25527,25527,25527,25527,25527
19792,5297,6798,18802,990,0,19792,1.91734e+18,93.2727,8410.76,19792,3271,110,13578,13578,12882,12587,11919
23414,3171,5512,0,23414,8237,15177,2.52559e+15,59.8078,7314.41,23414,2678,72,15059,14973,9598,8521,3130
29998,297,1093,0,29998,29135,863,3.8354e+16,240.974,3472.07,29998,166,26,35836,35836,15744,23967,2947
7674,215,584,7674,0,7366,308,3.61831e+18,17.9436,916.303,7674,326,29,7090,7090,6760,6795,4014
15567,4104,4781,0,15567,5672,9895,2.29041e+15,58.7082,5995.15,15567,2320,72,10786,10786,9931,9410,9064
2327,218,584,824,1503,0,2327,9.97479e+12,57.8543,898.3,2327,279,58,1743,1743,1211,1645,747
26302,38,176,26287,15,26302,0,6.02766e+18,171.803,1983.44,26302,162,161,15072,4789,5088,5913,5618
23136,1885,5751,21816,1320,21816,1320,3.20797e+18,97.3277,7759.67,23136,2768,110,41835,41835,35847,38708,30939
20671,7022,8076,20671,0,19611,1060,4.64841e+18,154.608,9261.06,20671,3363,124,37553,37553,37553,37553,37553
14625,3049,3489,13775,850,13775,850,3.35142e+18,97.2209,4926.53,14625,1677,110,11136,11136,10379,10688,10387
45423,6730,10860,42781,2642,42781,2642,3.62484e+18,98.3311,14214.1,45423,5128,111,32660,33616,33616,33616,33616
8889,270,2585,3212,5677,0,8889,9.17204e+12,55.2263,3393.23,8889,1243,72,6304,6304,1507,126,0
43841,306,1198,0,43841,42589,1252,3.55086e+16,248.392,4148.86,43841,189,26,36251,36251,31599,28004,3306
29830,696,7011,28090,1740,28090,1740,5.89223e+18,97.7506,9484.01,29830,3398,110,25759,25759,9331,4037,3800
39677,17397,19916,38159,1518,38159,1518,3.57355e+18,93.3835,22089.8,39677,9590,111,30911,30911,30911,30911,30911
33799,387,14339,13018,20781,0,33799,7.43736e+12,56.193,16260.6,33799,6972,72,23454,23214,16291,22217,7669
24920,4040,7665,24920,0,23463,1457,5.6547e+18,166.712,9091.88,24920,2618,129,16244,16244,14375,13716,12074
26548,7387,10794,26548,0,25198,1350,3.7972e+18,216.229,12054.3,26548,4397,128,32516,32516,32516,32516,32516
13579,685,3338,12789,790,12789,790,5.2898e+18,97.5603,4664.91,13579,1563,111,10241,10241,6880,8311,2585
25123,87,176,25057,66,25123,0,6.07618e+18,171.488,1961.88,25123,158,154,31554,31402,31415,31381,30863
43986,4023,14913,43986,0,41505,2481,4.94224e+18,303.042,16753.8,43986,5298,133,41226,41226,41226,41226,41226
41946,3375,19283,40226,1720,40226,1720,2.63104e+18,92.9208,21746.5,41946,9359,110,31483,31483,22010,27089,12498
49576,7507,13755,46855,2721,46855,2721,6.38851e+18,96.5346,17281.5,49576,6669,110,37249,37249,35491,35204,28580
41641,6957,15757,39671,1970,0,41641,1.8105e+18,95.587,18488.6,41641,7653,110,41211,41211,41211,41211,41211
37539,3,12,36468,1071,37521,18,1.38769e+14,10.3444,550.642,37539,12,11,26837,17922,15663,18127,6014
19719,8,11,19156,563,19708,11,1.38803e+14,10.2188,392.921,19719,11,11,23365,20424,15025,13479,2992
5836,677,2859,2308,3528,0,5836,6.69369e+12,55.2788,3323.45,5836,1387,72,2977,2915,2107,2729,1545
10156,2681,3300,10156,0,9566,590,3.23418e+18,94.1513,4078.71,10156,1245,120,6856,6856,6375,6592,6081
35060,829,11330,35060,0,33020,2040,3.7189e+18,244.865,12907.8,35060,4177,125,44858,44858,44858,44858,44858
49948,7143,15978,18320,31628,0,49948,8.762e+12,58.6809,18999.4,49948,7773,72,40113,40113,37143,34585,31973
3421,170,1228,3248,173,3248,173,2.76643e+18,92.7825,1665.39,3421,559,72,2193,2106,882,1190,729
5597,2740,3154,5407,190,0,5597,1.31112e+18,82.4329,3632.25,5597,1509,78,2443,2443,2138,2053,2139
29215,249,12653,0,29215,11296,17919,1.87526e+15,56.0632,14345.8,29215,6147,72,28766,28286,21372,17120,12838
40574,5461,9542,38215,2359,38215,2359,5.76478e+18,97.8275,12690.2,40574,4621,110,24311,24311,16427,17598,13525
40364,8795,18767,38724,1640,38724,1640,9.13984e+18,94.1551,21140.8,40364,9115,110,35165,35165,32512,31795,29266
24019,1214,5704,0,24019,0,24019,6.44958e+17,97.521,7793.9,24019,2745,110,18315,18315,9130,4677,4777
24533,8805,11779,0,24533,0,24533,4.41628e+17,93.7109,13366.7,24533,5715,110,12754,12754,8665,5805,3748
15536,9,12,15081,455,15526,10,1.66229e+14,10.2848,367.653,15536,12,11,45924,45752,43354,43425,42801
1616,74,186,1616,0,1616,0,5.91479e+18,124.295,486.698,1616,72,61,14359,4674,10624,3578,182
29529,2187,11370,29529,0,27977,1552,4.42545e+18,245.232,12750.7,29529,3029,133,24190,24190,21767,23678,18225
20468,4972,9021,0,20468,0,20468,4.74956e+17,94.2028,10486,20468,4368,110,15254,15254,15046,15083,15135
19284,2,11,18734,550,19280,4,1.38825e+14,10.0501,387.012,19284,11,11,2822,409,471,412,497
6581,1319,1626,2319,4262,0,6581,9.80728e+12,59.1469,2296.84,6581,788,72,4955,4955,4521,4877,4213
22288,3467,8192,22288,0,22288,0,4.73405e+15,5181.01,13461.7,22288,8192,4,6932,0,5600,6932,6932
21429,1337,5809,20239,1190,20239,1190,6.41663e+18,95.9565,7662.47,21429,2795,110,15620,15620,14760,14076,5309
39315,283,9181,37025,2290,37025,2290,5.87443e+18,97.8475,12259.4,39315,4448,110,39108,39108,39108,39108,39108
16127,277,680,0,16127,15668,459,3.5553e+16,20.0639,1870.52,16127,86,26,31295,0,0,0,0
39889,7981,9386,37572,2317,0,39889,2.22478e+18,97.8126,12491.7,39889,4543,110,30503,30503,28694,0,0
41490,792,20454,0,41490,0,41490,4.2926e+17,90.1515,22781.6,41490,9923,110,40947,40947,40947,40947,40947
29243,6441,6825,27536,1707,0,29243,2.2317e+18,97.7518,9266.78,29243,3301,110,20210,20210,16940,16219,13399
46411,3,6,44961,1450,46251,160,0.000107733,0.999871,527.029,46411,6,1,9545,9545,9545,9545,9545
14307,10671,13375,4446,9861,0,14307,9.19559e+12,3.97372,13432.2,14307,4478,9,13195,13195,13195,13195,13195
43681,1691,10199,0,43681,15357,28324,2.52836e+15,60.0654,13187.6,43681,4962,72,30478,29944,14332,20295,4782
1454,534,584,1384,70,0,1454,1.89648e+18,74.6802,810.409,1454,244,51,870,870,870,870,870
45515,63,176,45498,17,45515,0,5.98334e+18,172.035,2528.23,45515,171,172,33067,23457,30804,29648,20396
14365,152,200,14359,6,14365,0,5.98524e+18,178.099,1465.9,14365,141,146,26909,26059,9997,21307,903
38922,3723,10043,36712,2210,36712,2210,4.59657e+18,97.9984,12958.5,38922,4762,111,28879,28879,20590,24166,11550
14048,1124,3365,13231,817,0,14048,2.22401e+18,97.1631,4755.07,14048,1615,110,19567,19399,10225,7777,3926
26886,3024,6345,0,26886,0,26886,6.49288e+17,97.6631,8621.63,26886,3072,110,37728,37728,37728,37728,37728
17150,5060,7745,16430,720,16430,720,8.89663e+18,91.3624,9011.39,17150,3750,110,9405,9405,9182,9153,8622
19430,3929,5370,0,19430,6971,12459,2.39446e+15,59.201,6855.35,19430,2607,72,14060,14060,12075,12483,9797
28545,298,1071,0,28545,27723,822,3.8562e+16,250.7,3363.46,28545,160,26,31429,30919,27376,25803,11265
10615,2337,5453,0,10615,0,10615,4.19432e+17,91.3892,6269.99,10615,2632,106,5162,5162,3482,2066,1929
8151,57,176,8148,3,8151,0,6.05995e+18,164.617,1112.11,8151,118,116,30471,0,0,0,0
37313,927,14025,0,37313,0,37313,5.28029e+17,95.5605,16541.3,37313,6807,110,29088,28788,15256,3356,2939
19464,3085,11239,19464,0,18804,660,3.96459e+18,206.295,12272.2,19464,5285,123,19163,19163,19163,19163,19163
7015,1565,2294,0,7015,2571,4444,2.23149e+15,57.9739,2946.23,7015,1108,72,6087,6087,4482,5241,3270
46668,16128,16922,44408,2260,0,46668,1.85427e+18,82.0183,19971.7,46668,8208,110,37504,37504,37504,37504,37504
28728,10685,16406,27788,940,27788,940,1.08122e+19,90.705,17956.4,28728,7951,110,26596,26596,26596,26596,26596
48759,13495,15251,46212,2547,46212,2547,6.91065e+18,96.6607,18598.5,48759,7410,110,48338,48338,48338,48338,0
30282,7098,7124,28522,1760,28522,1760,5.90125e+18,97.7262,9630.89,30282,3443,110,20636,20612,17832,19000,15359
10661,2359,3751,10131,530,10131,530,2.89964e+18,92.34,4762.68,10661,1786,110,6910,6910,6107,6717,5303
44463,10937,24253,0,44463,9601,34862,1.36016e+13,8.99656,24664.4,44463,21825,11,28785,28785,28380,28382,24073
26450,8,12,25691,759,26436,14,1.46686e+14,10.3526,470.356,26450,12,11,5393,1602,601,1485,269
16735,3293,6165,15925,810,15925,810,2.84505e+18,95.2476,7542.96,16735,2977,110,10570,10570,8555,10042,5594
15713,47,176,15640,73,15713,0,6.01573e+18,166.155,1518.1,15713,147,144,9847,4501,3628,4512,4381
46146,63,176,46084,62,46146,0,6.04011e+18,173.75,2636.35,46146,172,173,27592,16684,22914,25318,12496
26607,3344,6237,0,26607,9359,17248,2.53294e+15,59.9863,8231.24,26607,3038,72,23467,23467,19316,13722,11796
3186,156,206,3185,1,3186,0,6.20084e+18,146.53,749.643,3186,79,77,2922,2809,2498,2510,2497
3296,724,873,3106,190,3106,190,4.16632e+18,94.2743,1346.13,3296,400,72,2423,2423,2305,2413,2268
26990,12,14,26198,792,26937,53,1.73442e+14,10.5142,543.388,26990,13,11,26971,26971,26873,26869,26795
16175,2859,6943,6231,9944,0,16175,7.3855e+12,56.7421,8017.47,16175,3378,72,31467,31467,18077,9611,6594
14646,11,14,14208,438,14597,49,1.97144e+14,10.6525,406.992,14646,13,11,14632,14630,14226,14233,12713
49914,4387,11661,0,49914,0,49914,6.48201e+17,97.9161,15380,49914,5661,110,30747,30747,25369,29398,19056
26824,22,176,26806,18,26824,0,6.03773e+18,171.324,2004.6,26824,161,159,8881,736,2006,4133,1384
30121,1232,11023,11288,18833,0,30121,8.17638e+12,57.9024,12918.1,30121,5364,72,28873,28873,28873,28873,28857
7128,147,1781,6718,410,6718,410,5.94484e+18,96.0929,2618.17,7128,840,97,5347,5264,4707,4173,889
17028,5694,6071,17028,0,16098,930,4.4482e+18,135.806,7138.62,17028,2431,121,13484,13484,13484,13484,13484
38201,29,176,38114,87,38201,0,6.0219e+18,172.766,2387.67,38201,171,171,46901,46805,46800,46805,46810
41118,3014,12377,0,41118,0,41118,5.90162e+17,96.7569,15342.6,41118,5997,110,40969,40969,40969,40969,40969
34658,1534,11180,34658,0,32645,2013,4.39111e+18,245.13,12747.7,34658,2580,133,23478,23134,11817,16146,4175
31682,6568,16652,12762,18920,0,31682,6.11174e+12,54.9995,18221,31682,8107,72,31153,31153,31153,31153,31153
33852,153,176,33841,11,33852,0,5.97903e+18,169.813,2179.85,33852,169,167,28991,28804,17142,5411,2332
37941,1919,12167,37941,0,35731,2210,4.48694e+18,268.9,13839.2,37941,2615,133,12579,18479,11418,7711,7293
47691,95,176,47609,82,47691,0,5.98914e+18,172.017,2605.08,47691,172,173,43820,36460,30563,30881,30706
22389,173,208,22378,11,22389,0,6.01598e+18,195.331,1929.36,22389,159,166,21893,21212,18946,19057,18710
33450,1,12,32495,955,33440,10,1.38945e+14,10.1339,514.067,33450,11,12,173,173,173,173,173
1568,276,472,1477,91,1477,91,5.20866e+18,89.0415,737.858,1568,197,53,1096,1096,987,1037,810
5957,411,1621,5626,331,5626,331,6.08049e+18,93.2926,2340.14,5957,762,92,4336,4336,3724,3459,1600
36416,3515,17101,0,36416,14328,22088,1.75517e+15,56.0167,19013.4,36416,8325,72,27191,27191,19531,13646,11938
10503,255,450,0,10503,10202,301,3.5648e+16,20.1344,1268.64,10503,66,26,10053,10053,9574,9602,6655
21793,1357,5128,20523,1270,0,21793,2.23128e+18,97.5467,7071.37,21793,2473,110,16665,16665,9438,8826,5393
31808,11600,11966,0,31808,11990,19818,2.06412e+15,57.7718,13919.2,31808,5829,72,30765,30765,30765,30765,30765
38715,173,1123,0,38715,37606,1109,3.57841e+16,236.089,3795.94,38715,173,26,33182,32378,19659,6718,2665
1615,517,950,1555,60,0,1615,1.37708e+18,73.5096,1133.01,1615,427,48,665,584,443,409,462
28353,11849,18422,27593,760,27593,760,2.04472e+18,90.154,19740.2,28353,8952,110,9931,9931,6491,7616,5941
8508,6,10,8258,250,8504,4,1.75674e+14,9.94182,267.467,8508,10,10,45855,45599,45004,0,0
22771,2176,7397,21593,1178,0,22771,1.9718e+18,96.1923,9221.05,22771,3584,110,19116,19116,18299,18148,15408
36234,2018,8451,12736,23498,0,36234,9.89061e+12,60.031,11012,36234,4108,72,27486,27486,15580,19289,9928
37767,2,15,36663,1104,37706,61,1.69718e+14,10.4855,644.703,37767,12,12,23688,19314,13131,13686,11872
32858,3725,15371,31512,1346,31512,1346,8.46661e+18,94.6813,17347.8,32858,7395,111,32779,32779,32779,32779,32779
5589,1669,1907,2058,3531,0,5589,8.66059e+12,57.5162,2446.32,5589,926,72,44237,44237,39458,37117,28294
22126,442,799,0,22126,21497,629,3.55208e+16,112.619,2382.34,22126,108,26,21327,21203,18404,18719,14221
7574,4,10,7357,217,7574,0,1.3966e+14,9.89781,240.686,7574,10,10,6559,5811,4870,4999,3779
14018,4052,5132,0,14018,0,14018,5.39966e+17,95.1356,6345.3,14018,2475,110,8886,8886,8600,8574,8400
6956,490,1672,0,6956,0,6956,6.56053e+17,96.3575,2501.24,6956,795,98,5284,5284,3068,2246,1981
21763,4820,8878,21763,0,20651,1112,5.07644e+18,180.635,9975.78,21763,3594,128,21599,21599,20592,40143,40143
32928,51,176,32839,89,32928,0,6.08652e+18,170.891,2241.06,32928,162,166,22339,11204,8933,10098,9823
22250,10,15,21584,666,22195,55,1.98551e+14,10.3556,467.589,22250,13,12,6214,3815,3172,2945,2240
31381,3471,7279,11020,20361,0,31381,9.9048e+12,60.0316,9562.24,31381,3539,72,47906,47906,47906,47906,47906
41017,34,208,40956,61,41017,0,6.05351e+18,202.406,2663.78,41017,186,182,38454,38321,25852,25560,9622
23099,2959,9194,23099,0,21929,1170,3.85558e+18,154.688,10455.6,23099,3732,129,20202,20202,16471,11078,9837
48258,7044,11841,45471,2787,45471,2787,4.89356e+18,98.268,15335.5,48258,5605,111,36808,36808,31537,29327,22781
25375,122,208,25363,12,25375,0,5.99801e+18,190.271,1998.17,25375,165,164,23624,21618,14745,15276,15526
48770,12922,20817,0,48770,18818,29952,1.89012e+15,56.657,23395.8,48770,10125,72,47316,47316,47316,47316,47316
33198,1122,1511,0,33198,32223,975,4.41445e+16,287.958,4779.72,33198,251,26,32379,32379,31271,31595,0
47564,371,11138,44801,2763,44801,2763,3.3534e+18,97.8686,14715,47564,5397,110,42876,42876,34540,37673,30778
35420,10437,12435,35420,0,33450,1970,3.63451e+18,247.501,14002.2,35420,4773,128,20268,20268,20268,19751,14784
28621,451,1989,8926,19695,0,28621,6.89847e+18,15.9892,2613.03,28621,1170,18,27517,27131,26170,25044,20451
25581,8340,8707,9466,16115,0,25581,8.49884e+12,57.5988,10426.7,25581,4219,72,13143,12880,10437,10734,7191
4239,379,1840,4048,191,4048,191,5.8738e+18,92.4496,2304.82,4239,867,72,2399,2312,1799,2399,1331
44693,1149,15909,44693,0,42242,2451,4.85561e+18,297.363,17754.1,44693,4710,137,36210,36210,31050,26760,14535
9202,1924,2930,9202,0,8662,540,5.77159e+18,94.0324,3666.62,9202,1091,115,6272,6272,5580,5933,4556
43662,10,176,43578,84,43662,0,5.97947e+18,169.744,2473.46,43662,171,171,9441,5658,5147,5501,5159
8413,1757,4138,8413,0,8413,0,2.80815e+18,17.9156,4395.15,8413,3717,20,4275,4275,2031,1797,1850
21261,52,176,21255,6,21261,0,5.98572e+18,169.333,1730.05,21261,158,156,13760,23507,22198,23032,0
28480,2359,6709,26820,1660,26820,1660,5.76925e+18,97.6921,9093.35,28480,3239,110,23069,23069,19400,17537,4487
37523,2000,8770,0,37523,0,37523,6.48668e+17,97.86,11736,37523,4250,110,28753,28753,19572,10293,8215
40320,14865,22395,0,40320,16463,23857,1.46666e+15,54.3178,24199.2,40320,10887,72,23204,23204,20578,14391,11727
8793,499,2879,8333,460,0,8793,1.98784e+18,95.199,3775.23,8793,1383,108,10104,10104,6462,5787,2252
29106,10129,14674,0,29106,11629,17477,1.64325e+15,55.5737,16192.9,29106,7142,72,24305,24305,24305,0,0
2046,134,175,2046,0,2046,0,6.07397e+18,130.634,559.654,2046,70,68,8905,8802,5603,8067,1487
3320,251,1240,0,3320,0,3320,5.53198e+17,92.3548,1665.1,3320,583,74,2080,1994,1416,1190,976
8964,2864,3064,8964,0,8456,508,4.4471e+18,93.8679,3774.03,8964,1174,116,11373,11373,8107,7407,4860
11627,10245,11627,11627,0,0,11627,7.99931,0,11627,11627,11627,1,0,0,14855,15646,15646
30683,11,15,29780,903,30620,63,1.75464e+14,10.4285,595.816,30683,13,11,6135,1688,971,2791,106
37419,9099,13650,37419,0,35389,2030,4.24708e+18,264.242,15271.3,37419,5364,129,33940,33921,29788,46273,0
46071,6718,17359,43871,2200,43871,2200,5.2217e+18,96.2555,20257.8,46071,8328,111,43406,43406,43406,43406,43406
28856,540,14837,0,28856,0,28856,4.12749e+17,91.9818,16543.2,28856,7203,110,25116,24699,10743,2956,2999
2400,698,1302,967,1433,0,2400,6.13406e+12,52.0079,1526.5,2400,628,61,1098,1053,1073,1090,1085
48358,11485,15432,17734,30624,0,48358,8.78075e+12,58.7119,18376.1,48358,7514,72,34236,34223,33369,34213,31574
6544,248,292,0,6544,6357,187,3.57976e+16,19.8842,835.578,6544,51,26,6252,6252,6170,6168,5638
21865,1570,7040,20735,1130,0,21865,1.97886e+18,96.169,8818.73,21865,3405,110,18420,18420,17112,17913,15595
37335,3577,11802,0,37335,0,37335,5.784e+17,96.5063,14505.3,37335,5724,110,46820,46820,46820,46820,46820
19216,7239,7288,18298,918,18298,918,4.15861e+18,95.4138,8773.84,19216,3480,111,11928,11928,11907,11914,11928
47986,6104,11219,0,47986,0,47986,6.48719e+17,97.9107,14818.6,47986,5447,110,24056,24056,17876,19065,10362
23668,3440,5564,22290,1378,22290,1378,5.73464e+18,97.5601,7632.72,23668,2685,110,19946,19946,19777,19757,12658
43335,5068,12564,40995,2340,40995,2340,3.18895e+18,90.647,15694.1,43335,6079,110,32561,32513,26663,28663,21437
23973,3,14,23288,685,23898,75,1.4335e+14,10.6921,482.244,23973,13,12,2612,756,472,389,122
32307,1241,1379,0,32307,6737,25570,1.49979e+16,12.0047,1974.25,32307,1156,19,30928,30928,29749,28911,30383
10647,249,3813,3967,6680,0,10647,8.29565e+12,55.644,4671.4,10647,1851,72,6834,6677,3839,4100,163
20624,2,12,20034,590,20610,14,1.44423e+14,10.5865,413.076,20624,12,11,787,65,65,93,43
38280,1569,8957,36054,2226,36054,2226,3.2288e+18,97.8016,11966.9,38280,4335,110,33768,33768,28913,32318,24696
1243,214,669,0,1243,0,1243,4.47755e+17,56.7699,836.058,1243,284,40,574,574,356,125,0
39019,11707,11913,0,39019,0,39019,5.87666e+17,94.8132,14747.9,39019,5763,110,28694,0,0,14074,14074
12374,2087,4344,11761,613,11761,613,3.01233e+18,95.1768,5469.91,12374,2082,110,8030,8030,5670,6582,5055
2081,118,625,1961,120,0,2081,2.17722e+18,91.271,952.9,2081,280,58,17806,17014,17207,17060,16820
42679,814,1276,0,42679,41460,1219,3.68198e+16,262.383,4347.09,42679,204,26,42454,42454,42454,42454,42454
9016,29,2181,3167,5849,0,9016,9.82744e+12,59.4667,3036.59,9016,1058,72,4413,728,2186,3263,95
23216,6577,9602,22176,1040,0,23216,1.71405e+18,92.3524,11269.5,23216,4653,110,13614,13614,12050,11737,10654
24063,569,837,0,24063,23377,686,3.56081e+16,137.543,2555.2,24063,116,26,28456,28456,28456,28456,28456
17999,5206,9735,17999,0,17326,673,4.46969e+18,272.27,10754.8,17999,4538,121,8264,8141,6355,7323,5160
8706,2496,3808,8327,379,0,8706,1.66684e+18,93.4296,4591.87,8706,1832,104,4898,4898,4754,24625,24712
35436,94,176,35374,62,35436,0,6.11459e+18,173.21,2331.73,35436,167,165,4547,4397,4319,4174,4095
15211,16,176,15150,61,15211,0,6.00715e+18,168.429,1497.67,15211,139,144,24037,12508,15287,10325,4212
18969,4637,6910,7107,11862,0,18969,8.23748e+12,57.8389,8229.54,18969,3361,72,12059,12059,11109,11889,10156
40015,11674,17670,0,40015,0,40015,4.72897e+17,94.0705,20107.9,40015,8583,110,38883,38644,38644,38644,38644
21576,66,176,21562,14,21576,0,6.03694e+18,171.235,1795.56,21576,151,157,28082,18318,11740,13389,10692
43870,8967,10235,41318,2552,41318,2552,5.74838e+18,97.8573,13592.8,43870,4955,110,21368,21368,16857,15113,11214
34823,3565,10089,0,34823,12585,22238,2.34432e+15,59.1262,12419.7,34823,4911,72,34639,34639,34639,34639,34639
12842,3419,4346,12192,650,12192,650,7.37078e+18,95.5326,5521.7,12842,2094,110,8496,8496,8266,8266,6037
26832,800,6489,25272,1560,25272,1560,4.86373e+18,98.1215,8712.82,26832,3062,111,33435,33435,33435,33435,33435
35342,4717,14214,0,35342,13474,21868,1.96853e+15,57.3141,16268.7,35342,6910,72,21128,21080,15955,16477,9765
18613,3889,4356,6547,12066,0,18613,9.91584e+12,59.9163,5857.7,18613,2122,72,38631,38631,38631,38631,38631
27474,7554,8626,26031,1443,26031,1443,5.73559e+18,96.9922,10722.7,27474,3431,116,18848,18848,18848,18848,17215
8462,112,2845,8462,0,7962,500,3.29857e+18,92.206,3484.05,8462,1011,113,5617,1394,1919,3823,601
13466,3688,6402,5305,8161,0,13466,6.81096e+12,55.9983,7280.81,13466,3115,72,7064,7064,5835,6854,4592
27160,4435,7317,0,27160,0,27160,6.18856e+17,97.1256,9538.78,27160,3536,110,11451,11451,4704,7068,3548
48600,57,176,48517,83,48600,0,5.98288e+18,171.961,2611.95,48600,172,172,28629,15681,24607,14928,11395
4754,149,178,4749,5,4644,110,5.97475e+18,158.216,822.07,4754,100,102,4500,4267,3950,3926,3870
27941,5982,10524,0,27941,10518,17423,2.05935e+15,57.3207,12286.6,27941,5106,72,27471,27471,27471,27471,27471
7881,2,11,7652,229,7874,7,1.59899e+14,10.1351,258.185,7881,11,11,4593,3440,2794,2873,2425
21231,2874,7756,20201,1030,20201,1030,2.92829e+18,95.5367,9411.05,21231,3761,110,37538,37538,37538,37538,37538
24877,2,10,22827,2050,24877,0,1.1575e+14,7.85613,395.428,24877,10,8,16691,16691,7486,13297,12599
16579,5850,6267,15781,798,15781,798,4.27703e+18,95.7789,7599.42,16579,2996,111,10312,10312,10312,10312,9548
13187,860,5089,13187,0,12497,690,3.86324e+18,129.735,5971.91,13187,2080,120,12807,12807,12807,12807,12796
10451,390,4202,9969,482,9969,482,3.57117e+18,94.4155,5129.93,10451,1985,111,25266,25266,25266,25266,25266
35500,904,1251,0,35500,34476,1024,3.87609e+16,257.004,4083.65,35500,198,26,34571,34571,21637,7654,5058
16312,84,175,16244,68,16312,0,5.98315e+18,165.45,1512.57,16312,150,149,13554,7731,7223,7810,8015
44876,12147,16003,42663,2213,42663,2213,4.69653e+18,96.4127,18912.5,44876,7669,111,25798,25798,21075,18337,13456
6789,58,3045,6499,290,0,6789,1.63733e+18,90.1006,3695.07,6789,1456,90,2446,659,1861,1699,0
16498,262,3926,0,16498,0,16498,6.49385e+17,97.2906,5493.95,16498,1885,110,12572,12572,7631,2229,1660
38743,6125,24173,37633,1110,37633,1110,2.10331e+18,88.1484,25931.4,38743,11736,110,31192,31192,30460,30136,29483
1560,7,11,1517,43,1560,0,1.38572e+14,10.641,111.477,1560,11,11,1489,1453,0,0,0
33133,6275,11428,0,33133,0,33133,5.54327e+17,95.661,13812.1,33133,5526,110,0,0,0,3756,3756
37615,7455,12225,35685,1930,35685,1930,3.03956e+18,95.3091,14918.6,37615,5914,110,36894,36894,36894,36894,36894
34983,4771,16376,13745,21238,0,34983,6.87806e+12,56.3128,18229.5,34983,7977,72,28224,28224,25765,27706,21880
9970,2355,2406,0,9970,3510,6460,2.51502e+15,59.4812,3328.87,9970,1168,72,13846,13846,6911,11689,1688
33644,6206,7845,0,33644,11823,21821,2.53305e+15,60.0421,10258.3,33644,3821,72,17340,17340,9082,16787,7953
29827,3753,10699,29827,0,28180,1647,5.01265e+18,216.769,12091.8,29827,4142,128,35709,35709,21301,25331,13114
11305,242,354,0,11305,10952,353,0.0312251,0.968686,2000.18,11305,354,1,10951,10951,10951,10951,10951
36989,197,206,36909,80,36989,0,5.98287e+18,186.844,2353.74,36989,177,170,26788,25918,15646,4239,2333
9841,186,431,0,9841,9563,278,3.57982e+16,19.9768,1206.28,9841,63,26,9410,9410,7868,7953,4834
41102,17100,21048,16480,24622,0,41102,6.30185e+12,55.6349,23016.3,41102,10254,72,38979,38979,38979,38979,38979
19100,3026,6315,19100,0,17990,1110,4.11034e+18,146.52,7369.81,19100,2284,120,14471,19450,19450,19450,10379
41220,13484,15548,0,41220,0,41220,5.26591e+17,95.5936,18264.1,41220,7545,110,43642,43642,43642,43642,43642
8713,9,274,8713,0,8713,0,5.67345e+18,96.7442,695.201,8713,230,28,5027,1455,1555,2384,2281
31267,6312,10000,31267,0,31267,0,2.6235e+18,3384.87,13346.8,31267,7374,25,21030,14292,14843,13415,14457
26184,25,176,26159,25,26184,0,6.13176e+18,171.75,2001.9,26184,153,151,11830,1176,3204,5591,0
44196,258,12434,41779,2417,41779,2417,3.31343e+18,97.1278,15639.3,44196,6029,110,37508,37155,33134,34654,30598
21293,738,6907,21293,0,20073,1220,3.27454e+18,152.733,8176.77,21293,2699,125,17431,17267,13290,14690,11851
29764,4687,7007,28034,1730,0,29764,2.22516e+18,97.6998,9478.04,29764,3389,110,25804,25804,18289,19636,9120
24821,9271,10785,23751,1070,23751,1070,2.66351e+18,94.0439,12494.1,24821,5213,110,14036,14036,13311,13844,12510
17436,1145,4123,16416,1020,16416,1020,3.40792e+18,97.4496,5760.01,17436,1988,110,14550,14550,11773,9721,9077
42676,6639,16350,0,42676,16136,26540,2.03772e+15,57.6862,18803.7,42676,7958,72,30384,30384,25771,25183,21322
5630,2058,2338,5630,0,5340,290,4.71703e+18,80.6705,2832.61,5630,947,94,3292,3292,3107,3218,2989
29721,9111,9385,0,29721,0,29721,5.79575e+17,96.4279,11648,29721,4549,110,41869,41869,41869,41869,41869
12113,1640,2888,4254,7859,0,12113,9.81569e+12,59.6772,3964.09,12113,1401,72,9225,9225,7502,8925,5563
16026,838,884,0,16026,15559,467,4.25799e+16,150.602,2461.63,16026,123,26,15142,15142,15121,15108,14950
1484,114,186,1484,0,1484,0,5.93514e+18,120.075,467.184,1484,66,61,1260,1134,896,911,865
23184,214,5407,0,23184,8142,15042,2.53188e+15,59.9599,7197.14,23184,2629,72,17777,17777,10180,718,953
28838,3929,9557,27358,1480,27358,1480,2.50207e+18,96.7917,11690.9,28838,4563,111,35529,35529,35529,35529,35529
7935,63,451,0,7935,7705,230,3.90028e+16,19.7836,1181.58,7935,66,26,7484,7476,6321,5917,2231
13130,1854,6185,13130,0,12541,589,3.80777e+18,151.407,7007.96,13130,2691,120,6945,6835,3908,5074,2107
20183,837,898,0,20183,19595,588,3.93259e+16,178.399,2622.54,20183,128,26,23127,23041,17662,14096,2702
36539,7093,15909,36539,0,34797,1742,4.92895e+18,341.91,17491.6,36539,6760,133,18311,18311,11858,10381,5086
4594,2168,2577,4434,160,0,4594,1.33036e+18,90.3648,2993.42,4594,1236,65,2017,2017,1531,1444,1291
24197,5436,8047,0,24197,8919,15278,2.21022e+15,58.3973,9704.7,24197,3916,72,16150,16150,14220,13211,12095
30956,10981,28929,9642,21314,0,30956,9.21728e+12,3.99428,29015.1,30956,9665,9,25032,25032,25032,25032,25032
42470,6246,9924,14933,27537,0,42470,9.87807e+12,60.0534,12842.3,42470,4829,72,48782,48782,48782,48782,48782
28450,9966,14216,28450,0,27272,1178,4.32648e+18,417.183,15592.3,28450,6305,135,14234,14125,11876,12765,10057
35916,15541,17927,34543,1373,0,35916,1.46339e+18,93.5799,19984.8,35916,8707,110,17989,17989,17504,17096,17003
3731,161,176,3727,4,3731,0,6.01475e+18,145.458,740.687,3731,89,91,3544,3492,3407,3395,3386
49550,18195,18462,49550,0,39707,9843,4.61517e+18,412.182,20476.5,49550,5693,138,49147,49147,49147,49147,49147
26298,59,176,26252,46,26298,0,6.00135e+18,171.081,1961.6,26298,164,161,20752,5899,8780,553,2170
22096,5239,5316,20806,1290,20806,1290,3.68967e+18,98.0576,7235.17,22096,2509,111,16780,16780,16728,16774,16738
48121,8611,12717,0,48121,0,48121,6.22235e+17,97.4332,16214.6,48121,6177,110,38208,38208,36874,36484,34844
12469,330,605,0,12469,12111,358,3.70546e+16,19.9986,1616.3,12469,79,26,11864,11864,11163,11223,6924
3304,150,416,0,3304,3204,100,5.56571e+16,15.2969,921.254,3304,59,25,2888,2888,2217,2404,880
48869,25707,25771,19728,29141,0,48869,6.0968e+12,55.1913,27979,48869,12553,72,47961,47961,47961,47961,47961
33218,197,208,33090,128,33218,0,6.17263e+18,202.919,2427.93,33218,166,168,29188,29116,20277,17096,17878
19343,82,175,19335,8,19343,0,5.98562e+18,165.942,1646.02,19343,149,156,30557,10293,21720,18693,1697
7027,1230,1658,2467,4560,0,7027,9.91011e+12,59.4834,2375.85,7027,800,72,5369,5369,4865,5259,4189
11556,3954,4954,4445,7111,0,11556,7.3981e+12,44.5065,5788.88,11556,2393,72,6602,6602,6602,6602,6602
18852,6147,10404,18202,650,18202,650,2.3933e+18,92.516,11572.8,18852,5051,110,8448,8448,5796,6673,5491
45222,571,1915,0,45222,43891,1331,4.41377e+16,316.313,6286.26,45222,328,26,45042,45042,0,0,0
10477,1547,2544,0,10477,0,10477,6.48068e+17,96.8218,3659.65,10477,1214,110,7933,7933,6578,5715,5224
16570,12,13,16083,487,16497,73,1.70091e+14,10.6206,418.7,16570,12,12,16556,16548,16299,16299,15774
12938,2795,3115,12187,751,0,12938,2.22226e+18,97.0162,4421.08,12938,1493,110,9823,9823,9478,9371,9391
32515,301,9595,0,32515,11785,20730,2.32683e+15,58.7965,11791.8,32515,4656,72,22920,22728,13195,5315,1384
17602,3998,7042,16795,807,16795,807,8.27686e+18,94.7774,8419.73,17602,3406,110,19039,19039,19039,19039,19039
38470,2186,11721,38470,0,36240,2230,5.07939e+18,276.982,13685.3,38470,3651,133,38167,38167,38167,38167,38167
36764,13297,14017,36764,0,34874,1890,4.73274e+18,272.122,15826.7,36764,3111,137,19297,19297,16496,15002,12537
35229,126,1790,0,35229,34181,1048,4.75311e+16,312.976,5639.8,35229,306,26,32527,32023,26217,19085,5014
15319,2804,4628,14504,815,0,15319,2.04257e+18,96.1684,6018.47,15319,2223,110,35828,35828,33003,32522,30040
37074,6304,14698,35374,1700,35374,1700,8.13742e+18,95.23,17138.4,37074,7137,110,35526,35526,35526,35526,35526
40683,147,208,40618,65,40683,0,6.08929e+18,203.541,2684.11,40683,184,176,25903,12891,9884,15066,566
10523,169,176,10480,43,10523,0,6.13684e+18,164.277,1270.07,10523,116,122,10323,10229,10011,10001,10015
2985,426,1297,2985,0,2710,275,5.18017e+18,77.9055,1616.87,2985,493,74,1688,1688,1195,1374,1033
14884,3711,4165,0,14884,5354,9530,2.39538e+15,59.1325,5368.87,14884,2028,72,10719,10719,10056,9491,9439
31564,13,14,30666,898,31487,77,1.3899e+14,10.7678,551.775,31564,13,12,47077,47074,42726,42666,40979
10927,2771,4415,10427,500,10427,500,8.30429e+18,91.2023,5383.66,10927,2115,110,6512,6512,6385,6388,5331
25632,8406,9496,24402,1230,24402,1230,2.98163e+18,95.1073,11392.2,25632,4600,110,16136,16136,14277,15040,13871
4591,38,1169,4321,270,4321,270,1.97446e+18,95.6356,1770.6,4591,538,85,1691,215,470,832,128
1044,9,63,0,1044,1013,31,3.48555e+16,17.6475,178.731,1044,24,24,900,830,578,600,313
41328,12275,19470,39652,1676,39652,1676,3.45683e+18,94.6979,21818,41328,9376,111,41132,41132,41132,41132,41132
23608,6997,10819,22631,977,0,23608,1.58383e+18,91.8744,12409.6,23608,5234,110,34520,34520,29728,26334,23725
10128,2266,2477,9541,587,9541,587,5.92429e+18,96.6746,3562.89,10128,1182,110,7651,7651,7604,7604,7317
42452,14634,16767,28490,13962,40482,1970,2.11062e+18,95.9847,19426.3,42452,8061,111,37894,37894,37894,37894,37894
11918,4233,5235,0,11918,0,11918,4.76361e+17,93.7315,6220.6,11918,2522,110,13463,13463,12734,12512,12386
15932,1,6,15651,281,15900,32,1.00191e+14,3.99592,290.402,15932,5,4,237,237,237,237,237
6272,3696,3818,6075,197,6075,197,3.67908e+18,82.0917,4294.01,6272,1812,86,2454,2454,2352,2445,2338
18207,2619,6812,18207,0,17217,990,5.43237e+18,137.548,7804.85,18207,1828,127,23370,23370,15258,21115,6925
21535,4330,9219,8309,13226,0,21535,7.38763e+12,56.3505,10559.9,21535,4486,72,12316,12316,9100,11758,5347
1952,1,11,1896,56,1951,1,1.37998e+14,9.74334,123.342,1952,11,11,505,505,505,505,505
30965,3,15,30054,911,30903,62,1.77148e+14,10.5183,600.891,30965,13,11,10365,8557,8527,8431,8538
26720,3965,8373,0,26720,9776,16944,2.27274e+15,58.7408,10207.2,26720,4079,72,26630,26630,26630,26630,26630
17306,3998,4589,0,17306,6174,11132,2.43085e+15,59.3704,5963.55,17306,2231,72,25192,20706,12678,7793,6994
46413,340,2442,13881,32532,13881,32532,1.93011e+18,15.9961,3252.57,46413,1589,26,46368,46368,46368,46368,46368
16128,3,12,15669,459,16119,9,1.38888e+14,10.5405,358.937,16128,12,11,12239,8702,10065,9694,6731
1634,321,665,1634,0,1544,90,3.98894e+18,80.8513,889.973,1634,230,56,969,969,733,825,733
6190,175,176,6188,2,6190,0,6.056e+18,158.376,970.833,6190,104,102,16844,16009,6246,2609,878
41710,5333,14656,39651,2059,39651,2059,7.45527e+18,94.8225,17482.5,41710,7112,110,42100,42100,42100,42100,42100
47654,111,176,47569,85,47654,0,5.9806e+18,171.922,2586.59,47654,171,173,38326,26924,25449,31718,22529
16015,2779,7692,16015,0,15295,720,3.86051e+18,138.213,8539.84,16015,3244,121,13354,13354,13354,0,0
32519,22,176,32508,11,32519,0,5.98144e+18,169.673,2136.3,32519,169,166,14964,2806,10228,0,0
36059,6528,19175,7817,28242,0,36059,52908700000,8.98392,19551.9,36059,17252,11,36770,36770,34051,33623,22810
39433,10997,12491,37370,2063,37370,2063,2.3085e+18,97.1139,15251.8,39433,5965,111,36122,40596,0,0,0
28892,10792,13836,28892,0,27664,1228,5.02511e+18,359.193,15340.1,28892,4428,133,24893,24893,19578,17418,10704
760,169,243,0,760,266,494,2.29063e+15,51.5145,374.019,760,103,39,517,517,466,459,450
29982,3098,7058,0,29982,0,29982,6.4754e+17,97.6997,9541.25,29982,3416,110,22924,22924,17547,16020,22010
6848,575,1693,6448,400,6448,400,2.98526e+18,96.6707,2502.97,6848,787,97,16668,15900,9318,4531,1682
1778,146,474,622,1156,0,1778,9.55552e+12,56.622,730.792,1778,218,53,1304,1304,705,1116,479
19189,2251,4550,0,19189,0,19189,6.45841e+17,97.3728,6311.21,19189,2185,110,14639,14639,12033,10007,7823
20779,3116,4901,19569,1210,19569,1210,3.22653e+18,97.4631,6771.45,20779,2363,110,39578,39578,39578,39578,39578
23988,8831,11765,23988,0,0,23988,8.75973e+17,17.9736,12211.6,23988,10577,20,12223,12223,9329,9586,9243
3036,491,1362,2903,133,0,3036,1.69205e+18,90.4032,1723.45,3036,642,61,1674,1588,698,801,626
34933,1897,13368,34933,0,33084,1849,4.15776e+18,225.979,14882.4,34933,5336,129,26385,26385,20765,24441,16078
33200,22613,33200,0,33200,33200,0,2047.94,0,33200,33200,33200,1,24581,24581,24581,24581,24581
1913,7,11,1855,58,1913,0,1.80097e+14,10.518,128.557,1913,11,11,1856,1833,1730,1590,1420
47625,3691,13981,45072,2553,0,47625,2.05438e+18,96.929,17339.1,47625,6783,110,37560,37560,35516,34963,13849
13553,3147,4082,0,13553,0,13553,5.96798e+17,96.2286,5351.72,13553,1970,110,9471,9471,8254,7201,7155
23094,172,10605,0,23094,9038,14056,1.78865e+15,56.1077,11964.5,23094,5150,72,12489,38249,0,0,26171
17828,1991,7569,0,17828,6862,10966,1.90239e+15,54.3068,8737.27,17828,3664,72,10259,10259,6270,5129,4647
16474,882,5644,6109,10365,0,16474,8.53983e+12,58.1439,6855.09,16474,2749,72,10830,10794,5819,19216,11910
29239,5641,9777,0,29239,10793,18446,2.19843e+15,58.3708,11698.6,29239,4753,72,22273,22273,19701,20555,18894
36755,17387,17982,36755,0,35345,1410,5.05564e+18,1582.91,20235.8,36755,6390,141,31507,31507,31507,31507,31507
25412,807,6009,23932,1480,23932,1480,3.3589e+18,97.619,8190.75,25412,2899,110,24256,24230,24112,24125,23168
45532,1462,16685,43339,2193,43339,2193,7.68273e+18,95.7751,19655.9,45532,8099,110,45867,45867,46591,46591,46591
45905,4908,10957,43232,2673,43232,2673,2.14095e+18,98.3497,14339.7,45905,5177,111,45443,45443,45443,45443,45443
34412,552,1646,10182,24230,10182,24230,1.82002e+18,15.9908,2339.87,34412,1435,18,579,579,576,0,0
45508,17395,42528,0,45508,0,45508,6.04008e+17,3.99446,42633.3,45508,14203,9,32874,32874,32874,32874,32874
24793,2151,9279,23613,1180,0,24793,1.82539e+18,95.3923,11122,24793,4490,110,21799,10676,8416,22195,5302
24843,1547,7326,23504,1339,23504,1339,6.59298e+18,96.7076,9342.13,24843,3541,110,17517,17517,14888,13292,4383
18944,152,176,18937,7,18944,0,6.00966e+18,166.395,1663.31,18944,145,155,18530,18026,16588,16545,16567
30103,289,14343,28892,1211,28892,1211,6.87828e+18,94.5441,16171.3,30103,6906,111,23393,23393,10623,16397,4349
7239,1,11,7032,207,7237,2,1.44801e+14,9.85205,239.695,7239,10,10,1769,1769,1769,1769,1769
21145,378,779,0,21145,20544,601,3.54921e+16,98.9511,2298.13,21145,105,26,19027,18812,11465,4122,3454
15976,590,3761,5618,10358,0,15976,9.88722e+12,59.6449,5095.2,15976,1825,72,12215,12215,4875,10206,1865
44751,3303,10415,0,44751,0,44751,6.4919e+17,97.9202,13828.6,44751,5051,110,44484,44484,34126,33453,31725
3609,318,1267,3429,180,0,3609,1.95066e+18,92.4314,1729.95,3609,583,71,2342,2256,1184,1202,1140
48128,14006,20646,46038,2090,0,48128,1.66268e+18,94.5144,23508.5,48128,10023,110,25490,25490,23692,25180,21722
42050,493,1170,0,42050,40851,1199,3.55747e+16,244.411,4021.3,42050,183,26,27365,26756,15079,14311,3301
40986,875,1151,0,40986,39817,1169,3.55858e+16,240.965,3937.62,40986,179,26,40801,40801,40801,40801,40801
22710,3993,5576,0,22710,8025,14685,2.48903e+15,59.7533,7316.8,22710,2704,72,17134,17134,14929,13230,12393
29491,7406,13229,28251,1240,28251,1240,2.66259e+18,93.3029,15137.1,29491,6420,110,22314,22314,22314,22314,22314
8355,1264,2058,7865,490,7865,490,3.57412e+18,96.952,2988.88,8355,948,106,6297,6297,5523,6239,4386
10958,1327,2664,10315,643,10315,643,4.07618e+18,97.3403,3799.39,10958,1247,111,8294,8294,6786,7993,4724
40401,7716,15659,15300,25101,0,40401,7.90355e+12,57.5949,17989.9,40401,7621,72,32836,32836,32836,32836,32836
9825,167,176,9820,5,9825,0,6.08684e+18,162.793,1227.89,9825,121,121,9619,9533,9322,9281,9298
19542,3876,7710,0,19542,7425,12117,2.00805e+15,57.3735,9007.71,19542,3755,72,15245,15245,12514,9357,8907
30660,2080,7125,10767,19893,0,30660,9.89772e+12,60.0014,9364.42,30660,3462,72,22466,22154,12270,15381,5120
6659,521,1688,6278,381,6278,381,3.33085e+18,95.7689,2483.06,6659,788,96,4971,4971,2724,3720,1985
16870,63,3968,5930,10940,0,16870,9.86673e+12,59.8542,5362.15,16870,1921,72,13205,10353,8759,7562,7423
17342,707,4111,16332,1010,16332,1010,5.7535e+18,97.3783,5742.74,17342,1976,110,47807,47807,47807,47807,47807
46253,4818,10825,0,46253,0,46253,6.47368e+17,97.8869,14325.1,46253,5249,110,45914,45914,45914,45914,45914
45124,41,176,45060,64,45124,0,6.05477e+18,171.117,2616.86,45124,172,169,41230,37414,37649,36604,36118
35606,12921,17188,35606,0,34096,1510,4.8303e+18,523.782,18858.6,35606,5605,138,44515,44515,44515,44515,44515
11212,3243,5700,4484,6728,0,11212,6.36285e+12,53.2962,6431.41,11212,2761,72,5512,5512,4704,5342,3524
32639,1,14,31689,950,32584,55,1.62629e+14,10.4117,577.054,32639,13,11,6897,6897,6897,6897,6897
3841,1147,1937,0,3841,1530,2311,1.69784e+15,49.5267,2273.48,3841,938,67,1904,1904,1614,1442,1490
15829,1621,4896,5765,10064,0,15829,8.90623e+12,58.3448,6122.04,15829,2363,72,10933,10933,8314,10483,5289
20192,1791,5383,7208,12984,0,20192,9.50488e+12,59.4233,6930.57,20192,2622,72,14809,14809,9258,13392,4500
27873,10611,13187,10985,16888,0,27873,6.82474e+12,56.0612,14726.6,27873,6417,72,23582,23582,23582,23582,23582
28209,6564,7285,26602,1607,26602,1607,5.24753e+18,97.9402,9556.37,28209,3459,111,32463,32463,32463,32463,32463
32193,448,981,0,32193,31274,919,3.54838e+16,196.027,3204.14,32193,145,26,25145,25145,15388,4193,3100
3895,647,1910,3735,160,0,3895,1.55479e+18,87.0716,2319.19,3895,911,65,1985,1912,1130,919,555
35776,3,12,34756,1020,35766,10,1.38834e+14,10.2275,533.82,35776,11,12,13194,12132,11866,11867,11510
44754,171,14283,44754,0,42146,2608,4.39463e+18,313.927,16165.3,44754,3299,134,44252,44223,43420,43404,43366
10397,411,453,0,10397,10100,297,3.56927e+16,20.0085,1263.65,10397,65,26,0,0,0,0,0
38869,6787,20886,37499,1370,0,38869,1.35071e+18,91.2366,22945.1,38869,10149,110,27238,27238,21618,15137,10519
2651,202,729,2499,152,2499,152,1.18647e+18,92.8042,1129.22,2651,321,64,1922,1922,1899,1895,773
41308,13674,22762,41308,0,41308,0,2.41993e+18,17.9454,23310.3,41308,20479,20,39664,39664,39664,39664,39664
49703,8512,15549,0,49703,18178,31525,2.2658e+15,58.7641,18585.5,49703,7566,72,49428,49428,49428,49428,49428
16856,2814,4659,15926,930,0,16856,2.11359e+18,95.3633,6197.36,16856,2239,110,12197,12197,10544,10170,8944
8426,865,2017,0,8426,0,8426,6.56068e+17,96.6151,2967.8,8426,962,107,6409,6409,4789,3477,3210
21620,4217,5267,7627,13993,0,21620,9.76768e+12,59.7837,6942.78,21620,2561,72,19249,19249,16522,15373,12263
41305,13,14,40122,1183,41225,80,1.44366e+14,10.3789,622.562,41305,13,12,42986,42985,42886,42633,42561
1711,233,489,1611,100,1611,100,5.18079e+18,90.6523,779.315,1711,214,55,1222,1222,781,895,773
40472,10,176,40458,14,40472,0,5.98115e+18,169.774,2381.92,40472,169,171,41934,37577,24189,27592,6094
36815,5677,12078,13558,23257,0,36815,8.66202e+12,58.5264,14408.8,36815,5872,72,24737,24737,19176,23475,11341
41696,12218,17908,0,41696,0,41696,4.83196e+17,93.5525,20465.7,41696,8689,110,41270,41270,41270,41270,41270
2866,1235,1236,0,2866,0,2866,5.04905e+17,71.5244,1594.86,2866,561,60,1630,1630,1630,1630,1630
22520,5857,12307,21740,780,21740,780,2.32019e+18,92.6264,13652,22520,5967,110,10213,10213,7991,9169,5870
33001,3773,8293,31102,1899,31102,1899,1.92872e+18,98.0862,10869.8,33001,3921,111,24496,24496,20428,23588,14224
40544,3490,12424,40544,0,38194,2350,4.19751e+18,291.162,14463.3,40544,3536,134,40033,40033,40033,40033,40033
49978,5397,13339,0,49978,0,49978,6.19168e+17,97.3704,16935.4,49978,6469,110,35643,35643,29820,24442,23688
31845,198,979,0,31845,30938,907,3.55593e+16,197.51,3192.28,31845,144,26,44863,44863,44863,44863,44863
31992,2675,16728,0,31992,12882,19110,1.5766e+15,54.1825,18318.5,31992,8127,72,15264,15264,8087,3864,2502
35565,10240,15988,34065,1500,34065,1500,4.75621e+18,94.9279,18149,35565,7675,111,19577,19577,13280,14463,11233
6853,1143,2560,2569,4284,0,6853,8.17887e+12,57.183,3164.09,6853,1241,72,4293,4245,2622,4003,39011
8481,173,490,0,8481,8233,248,3.92362e+16,19.912,1271.1,8481,68,26,16618,16559,10127,8054,3922
42742,1068,1180,0,42742,41522,1220,3.55231e+16,244.995,4065.78,42742,184,26,37671,37671,31654,26968,24371
7857,771,1898,0,7857,0,7857,6.46995e+17,96.3229,2801.48,7857,896,103,5959,5959,4314,3795,2867
36226,142,176,36193,33,36226,0,6.08194e+18,172.003,2352.57,36226,166,167,32476,32297,28785,26944,26623
985,2,11,956,29,984,1,1.59169e+14,9.36142,90.7686,985,11,11,586,446,354,452,284
20963,4,14,20357,606,20919,44,1.52198e+14,10.4523,439.74,20963,12,11,36596,32664,25678,25835,15360
24625,6205,8840,0,24625,0,24625,5.44683e+17,95.0535,10702.5,24625,4288,110,15785,15785,12972,11084,10007
11880,5389,5647,4682,7198,0,11880,6.86211e+12,55.9423,6444.29,11880,2750,72,6233,6233,6067,6203,6055
43518,597,10129,40978,2540,40978,2540,5.87828e+18,97.9263,13466,43518,4917,110,42376,42325,42120,41793,0
11415,2253,2765,0,11415,0,11415,6.43612e+17,96.9066,3956.47,11415,1313,110,37993,37993,13759,7645,7483
43351,21529,40511,40507,2844,40507,2844,3.34837e+17,3.99622,40613.7,43351,13523,9,2840,2840,1508,1510,1515
13944,3960,4098,13194,750,0,13944,2.06424e+18,96.224,5408.43,13944,1969,110,9846,9846,9694,9700,9687
28374,3,15,27543,831,28320,54,1.70597e+14,10.3434,534.124,28374,12,12,28642,21107,13150,13638,4592
24943,3965,5877,8774,16169,0,24943,9.87366e+12,59.9383,7767.39,24943,2859,72,19066,19066,16352,18597,13196
6227,499,2026,2275,3952,0,6227,8.81921e+12,57.8786,2621.46,6227,982,72,4201,4170,2621,3729,1679
36196,13988,14493,34546,1650,0,36196,1.74728e+18,95.179,16875.2,36196,7032,110,21703,21703,21166,21022,20556
44951,7971,13910,42591,2360,42591,2360,3.21355e+18,96.6819,17058.4,44951,6746,110,44559,44559,44559,44559,44559
30588,568,1042,0,30588,29709,879,3.71619e+16,214.154,3341.4,30588,157,26,22849,20640,11758,14647,2227
1677,171,477,1578,99,0,1677,2.25084e+18,89.8199,760.93,1677,207,55,1200,1200,706,710,587
30045,5722,7074,0,30045,0,30045,6.47722e+17,97.7137,9561.13,30045,3421,110,27614,27614,27614,27614,27614
27639,139,6501,9717,17922,0,27639,9.85305e+12,59.936,8556.1,27639,3152,72,22897,15783,13033,4191,48
49895,1220,1452,0,49895,48465,1430,3.71098e+16,275.367,5044.18,49895,240,26,39510,39510,22086,28003,12151
14029,1015,3347,13209,820,13209,820,5.75084e+18,97.2344,4735.48,14029,1606,110,10682,10682,9301,8830,3997
47128,1690,10994,16564,30564,0,47128,9.88687e+12,60.0718,14174.2,47128,5352,72,46927,46927,46927,46927,46927
13217,5,11,12839,378,13210,7,1.43389e+14,10.2153,325.557,13217,11,11,3494,2054,1820,1815,1528
33999,3993,17284,32728,1271,32728,1271,2.45721e+18,93.4028,19233.8,33999,8385,110,32116,32116,30666,30666,14357
1164,375,518,1164,0,1102,62,4.0757e+18,75.7895,683.374,1164,166,50,646,646,600,610,630
1676,449,484,1578,98,0,1676,2.22403e+18,89.4636,766.966,1676,212,54,1192,1192,1166,1172,1187
41841,585,1385,0,41841,40636,1205,3.85441e+16,272.707,4645.45,41841,224,26,34892,34409,30128,31903,26183
40177,899,9620,37837,2340,37837,2340,2.08999e+18,98.3066,12661.7,40177,4545,111,31438,31438,13303,26351,6472
1927,334,544,1814,113,1814,113,3.98166e+18,91.4909,858.458,1927,244,58,1383,1383,1192,1368,1068
41111,2125,14075,0,41111,0,41111,5.57752e+17,96.1421,16897.5,41111,6838,110,40991,40991,15431,19064,10109
48399,5514,48399,0,48399,0,48399,524277,0,48399,48399,48399,1,0,0,0,0,0
26678,6132,6453,25128,1550,25128,1550,3.60411e+18,98.1128,8667.82,26678,3049,111,21465,21465,21465,21465,21465
43603,11095,17831,0,43603,16686,26917,1.9512e+15,57.2034,20241.7,43603,8681,72,48793,48793,48793,48793,48793
40668,9781,24221,39418,1250,0,40668,1.1805e+18,90.9141,26147.1,40668,11759,110,33257,33257,32989,33067,31004
47036,15042,16273,0,47036,0,47036,5.53758e+17,85.5449,19399.7,47036,7892,110,46069,46069,46069,46069,46069
12400,11,13,12047,353,12335,65,1.39035e+14,10.9457,341.317,12400,12,12,12384,12375,12219,12200,11790
47878,4343,11151,0,47878,16831,31047,2.53373e+15,60.0831,14373.2,47878,5432,72,46510,46510,46510,46510,46510
23706,3833,5712,22336,1370,0,23706,2.21261e+18,97.5093,7773.76,23706,2759,110,17994,17994,15420,14990,12471
25416,313,858,0,25416,24692,724,3.55072e+16,147.475,2653.84,25416,120,26,27583,27583,8915,2644,2878
3782,479,1045,2697,1085,3565,217,1.82705e+18,94.6322,1558.4,3782,476,79,2737,2737,2116,2423,1678
35711,139,1458,0,35711,34670,1041,4.19702e+16,273.4,4698.19,35711,238,26,34458,34344,29070,29519,13074
44661,49,176,44560,101,44661,0,6.11148e+18,173.48,2617.59,44661,172,169,42862,42648,28824,28710,13206
31022,13053,17933,30015,1007,30015,1007,2.90364e+18,88.8661,19526,31022,8659,111,13089,13089,12994,12766,18259
5011,146,170,5011,0,5011,0,5.97018e+18,154.41,833.713,5011,102,105,28487,28169,20385,20320,6999
23056,9,15,22369,687,23002,54,1.86189e+14,10.344,473.952,23056,12,12,22834,22628,19668,19003,16139
28132,793,9164,28132,0,26491,1641,4.20298e+18,171.46,10510.6,28132,3345,121,28249,28249,28249,28249,28249
11841,1506,5534,4644,7197,0,11841,6.88548e+12,56.0231,6342.35,11841,2683,72,6307,6307,3994,5907,1336
1064,263,353,1003,61,1003,61,2.10799e+18,84.4887,546.479,1064,141,45,711,711,710,678,646
35345,6,14,34328,1017,35295,50,1.49223e+14,10.3711,579.561,35345,13,11,14442,1024,255,553,3
30367,45,208,30280,87,30367,0,6.14287e+18,200.462,2322.98,30367,169,168,19103,7681,6796,7758,6728
13555,80,578,0,13555,13169,386,3.55637e+16,20.1148,1599.91,13555,77,26,40620,40403,27407,25752,7249
20388,6681,8186,19458,930,19458,930,2.73787e+18,76.0879,9724.62,20388,3946,110,12202,12202,10699,11748,7906
23431,2224,6236,8374,15057,0,23431,9.49577e+12,59.4557,7977.75,23431,3037,72,17195,17195,12104,16315,6009
2645,25,170,2640,5,2645,0,5.95487e+18,141.396,606.35,2645,79,75,1175,264,337,393,385
43253,3507,20830,17094,26159,0,43253,6.68228e+12,56.1157,22985.6,43253,10141,72,36605,36605,21679,25937,13051
28399,6705,9284,28399,0,26745,1654,3.66398e+18,174.846,10638.6,28399,3405,124,19115,19113,16379,17341,14386
15436,12,13,14998,438,15365,71,1.38823e+14,10.9572,381.457,15436,13,12,15422,15418,15099,15099,14191
33010,6368,9075,31176,1834,31176,1834,3.97051e+18,97.6831,11591.2,33010,4301,111,29533,29533,29533,29533,29533
21204,2352,4951,7447,13757,0,21204,9.93225e+12,59.9545,6615.53,21204,2411,72,28828,28828,23880,26528,11285
44441,135,1572,0,44441,43657,784,2.56444e+16,3.73457,6002.89,44441,788,4,42683,40645,34662,35011,34555
32598,8,12,31667,931,32583,15,1.38942e+14,10.3335,512.119,32598,12,11,4531,1373,793,1103,261
24267,18,175,24192,75,24267,0,5.98151e+18,166.48,1842.36,24267,162,159,23813,23593,17181,17166,17184
6257,2617,3310,2965,3292,6257,0,2.34477e+18,17.7216,3520.17,6257,2966,20,3972,3972,3310,3893,3332
5865,922,2513,2262,3603,0,5865,7.52896e+12,52.3627,3019.64,5865,1217,71,7620,7620,7620,7620,7620
4177,2842,3909,4177,0,3905,272,1.0878e+18,3.91381,3937.98,4177,1321,9,4600,4600,4565,4531,4304
1141,691,870,1113,28,1113,28,1.94538e+18,41.2103,960.175,1141,387,46,271,783,783,783,783
30973,554,1455,0,30973,30060,913,4.45425e+16,280.571,4554.12,30973,237,26,24139,24139,8127,9042,3312
44496,11782,17314,42426,2070,0,44496,1.77867e+18,95.4112,20148.4,44496,8416,110,34137,34137,34137,34137,34137
48047,9638,18104,48047,0,45594,2453,4.70057e+18,467.973,20424.5,48047,6043,141,29103,25131,22279,25312,17617
40274,991,11173,14474,25800,0,40274,9.32022e+12,59.3503,13834.1,40274,5436,72,39313,39313,39313,39313,39313
32592,460,1452,32592,0,31238,1354,2.84233e+18,17.9248,2156.31,32592,1345,30,32539,32539,32539,32539,32539
7453,65,1859,0,7453,0,7453,6.45922e+17,96.2013,2720.32,7453,886,102,17636,17570,15603,15496,8284
19542,963,4683,0,19542,0,19542,6.43661e+17,97.3677,6466.48,19542,2251,110,39327,39325,34123,37008,18127
26452,6945,12225,25354,1098,25354,1098,3.2198e+18,94.7544,13917.1,26452,5884,111,14227,14227,10104,10794,8572
18824,5882,8621,7367,11457,0,18824,7.03769e+12,55.7655,9781.65,18824,4193,72,10203,10203,8811,9963,7365
25524,7391,11999,0,25524,0,25524,4.50997e+17,93.9058,13654.9,25524,5827,110,27026,27026,20933,13913,11465
1953,205,268,0,1953,1894,59,5.79634e+16,16.8525,589.195,1953,44,25,1685,1685,1637,1623,1435
16555,1034,4624,0,16555,0,16555,6.11864e+17,96.659,6135.76,16555,2227,110,11931,11889,6665,4990,4090
43849,10070,19515,0,43849,0,43849,4.69628e+17,93.2265,22120.9,43849,9466,110,43325,43325,43325,43325,43325
19198,536,5534,18158,1040,18158,1040,3.30703e+18,96.6163,7208.51,19198,2674,110,17418,17418,15759,15445,14343
1569,542,584,1569,0,1478,91,3.22907e+18,85.898,811.179,1569,209,52,985,985,965,5892,5554
23032,2340,11627,22162,870,22162,870,2.4262e+18,93.0829,13090.1,23032,5622,110,22371,22371,22371,22371,22371
46027,1746,10718,43347,2680,43347,2680,3.22478e+18,97.892,14208.8,46027,5189,110,29283,29283,20227,17318,6407
45920,1110,1241,0,45920,44612,1308,3.55706e+16,256.084,4330.81,45920,197,26,36466,36208,30432,31556,22767
45393,10370,16968,0,45393,17092,28301,2.069e+15,57.8445,19579.4,45393,8260,72,45078,45078,45078,45078,45078
15141,117,176,15129,12,15141,0,6.00074e+18,166.207,1484.73,15141,139,147,14071,12758,9889,10084,10177
20224,6422,7800,0,20224,7655,12569,2.03352e+15,57.5264,9151.33,20224,3794,72,12424,12424,11594,11128,10396
44620,12608,14202,44620,0,42020,2600,4.84545e+18,308.616,16078.6,44620,4000,133,30418,30418,29730,30418,27762
15725,1839,5614,14945,780,14945,780,3.77008e+18,93.9368,6931.4,15725,2654,111,13339,13339,9685,8796,6016
18693,4380,6558,0,18693,0,18693,5.51805e+17,95.6314,8086.92,18693,3171,110,34899,34899,25322,33200,13442
39651,5734,14452,37721,1930,37721,1930,5.32739e+18,95.7046,17075.4,39651,6928,111,25199,25199,19383,19526,11760
43335,5788,15560,41225,2110,41225,2110,7.74138e+18,95.847,18449.2,43335,7551,110,41048,41048,41048,41048,41048
9388,6,13,9111,277,9346,42,1.80104e+14,10.7441,313.43,9388,12,11,8932,8583,7248,6899,4430
8653,220,365,0,8653,8408,245,3.53335e+16,20.0171,1042.88,8653,57,26,8288,8288,7454,7513,5653
31738,7068,10327,31691,47,29897,1841,3.89608e+18,216.484,11796.7,31738,3792,125,30426,30384,26803,28303,36107
47737,6592,11102,44950,2787,44950,2787,3.36124e+18,97.9254,14692.5,47737,5386,110,38161,38161,32915,33880,30143
3278,908,919,0,3278,0,3278,6.22643e+17,91.3661,1383.44,3278,410,70,2359,2359,2359,2359,2359
21918,7801,9822,20988,930,20988,930,5.23844e+18,92.8378,11327.8,21918,4698,111,12096,12096,9957,10351,9793
15043,663,6283,15043,0,14283,760,3.73681e+18,128.409,7138.53,15043,2510,123,10289,10145,5893,7867,3158
6058,366,1537,0,6058,0,6058,6.43093e+17,95.5928,2277.8,6058,724,94,40880,39711,36009,24398,12571
27743,127,10875,27743,0,26298,1445,5.06822e+18,206.541,12178.5,27743,4367,128,16658,4988,5672,10337,612
24319,4480,5720,22906,1413,22906,1413,3.36134e+18,97.5584,7833.74,24319,2755,110,18599,18599,16135,17274,15139
6106,1310,2270,4757,1349,5806,300,2.2902e+18,90.0003,2925.05,6106,1074,95,3836,3836,3141,3472,2354
47874,11,14,46507,1367,47791,83,1.3888e+14,10.4915,674.225,47874,14,12,33383,30858,30454,31153,30067
8429,1657,2049,2968,5461,0,8429,9.82328e+12,59.4207,2860.85,8429,989,72,6380,6380,15180,15587,14316
36074,1836,8727,33982,2092,33982,2092,1.2829e+18,98.2072,11519.4,36074,4121,111,23294,23294,15293,13567,6195
1199,791,1009,1062,137,1177,22,8.13854e+18,50.1051,1075.43,1199,464,33,190,144,126,190,114
28443,2197,9110,0,28443,0,28443,5.75289e+17,94.9266,11290.5,28443,4397,110,19107,18945,11938,15047,7100
40951,3320,9859,38570,2381,38570,2381,3.44999e+18,98.2919,12941.8,40951,4661,111,30441,30441,21848,13401,12285
36280,16288,18878,36280,0,36280,0,2.9602e+18,17.8279,19413.6,36280,16975,20,33357,33357,33357,33357,33357
47703,638,28009,46193,1510,46193,1510,2.46772e+18,91.9176,30180.5,47703,13530,111,19694,17636,1431,17511,3051
27882,3437,9015,26444,1438,0,27882,1.97286e+18,96.2929,11151.9,27882,4368,110,28421,28421,19603,20032,5405
34948,7561,8144,12283,22665,0,34948,9.9142e+12,60.0393,10628.7,34948,3967,72,34689,34689,34689,34689,34689
1850,236,518,1334,516,1740,110,2.6263e+18,91.5103,825.377,1850,232,56,1332,1332,980,1184,818
37488,226,316,0,37488,34396,3092,2.96512e+16,10.0994,995.251,37488,309,11,30021,30021,15618,21885,7456
11484,159,736,0,11484,11147,337,4.22407e+16,65.4695,1880.59,11484,94,26,27348,26273,10885,17094,1087
22864,8020,11209,0,22864,5016,17848,1.33824e+13,8.98858,11522.4,22864,10080,11,11655,11655,9135,11655,8845
47523,1391,12858,17021,30502,0,47523,9.39964e+12,59.4615,15929.7,47523,6255,72,47183,47183,47183,47183,47183
21557,2202,5915,20367,1190,0,21557,2.11605e+18,96.9287,7767.81,21557,2854,110,13987,13987,7749,11941,2073
33799,10090,14183,33799,0,32129,1670,4.56612e+18,285.656,15681,33799,5933,132,34541,34541,34083,33947,33612
5426,11,13,5266,160,5361,65,1.66883e+14,10.6686,231.608,5426,13,12,5411,5402,5365,5364,5336
14227,4,6,13976,251,14195,32,1.0013e+14,3.99613,274.616,14227,5,4,14221,14220,13203,13204,12652
32351,11222,13601,32351,0,30791,1560,4.98905e+18,204.353,15206.9,32351,5893,130,18750,18716,18652,18657,18750
5853,31,261,0,5853,5689,164,3.58257e+16,19.8291,754.181,5853,48,26,5592,5588,3736,3687,1491
44569,1423,1991,0,44569,43254,1315,4.53163e+16,317.888,6481,44569,344,26,44496,44496,44496,44496,44496
49402,11149,24799,47532,1870,0,49402,1.45059e+18,92.6104,27427,49402,12053,110,31386,31386,28989,27943,26815
16052,337,796,0,16052,15583,469,3.94584e+16,106.376,2203.22,16052,108,26,15256,15131,14030,13612,9057
14437,3832,4081,13647,790,0,14437,2.09752e+18,96.4798,5440.86,14437,1963,110,10356,10356,10045,10037,9902
2757,259,694,966,1791,0,2757,1.00615e+13,58.0116,1047.97,2757,333,60,2063,2063,1333,1857,831
4824,4,11,4688,136,4819,5,1.37762e+14,10.7614,193.942,4824,11,11,32190,31733,31113,31167,30622
30020,7670,13780,28780,1240,28780,1240,9.02997e+18,94.1546,15684.7,30020,6686,110,28159,28159,28159,28159,28159
27303,5759,7549,9801,17502,0,27303,9.33127e+12,59.309,9496.4,27303,3671,72,34443,34443,29235,28518,20199
6103,111,2930,5853,250,0,6103,1.55678e+18,89.8996,3503.23,6103,1392,88,3173,1401,1808,1529,628
13559,2746,3595,12789,770,12789,770,2.9141e+18,97.3087,4896.07,13559,1696,111,9964,9964,9068,9908,8179
45008,18660,27413,0,45008,18804,26204,1.29454e+15,53.4984,29187.4,45008,13338,72,36194,36194,36194,36194,36194
21526,1480,7934,0,21526,8075,13451,2.08063e+15,57.7549,9384.22,21526,3848,72,29660,29660,29660,29660,29660
26035,95,176,26019,16,26035,0,6.04306e+18,171.584,1977.53,26035,154,160,29849,21131,16870,17599,17511
29738,11,14,28890,848,29665,73,1.38968e+14,10.6097,519.708,29738,14,12,29722,29713,29134,29133,28441
3218,59,61,3218,0,3218,0,2.33522e+18,58.7082,420.278,3218,61,55,3137,3074,3067,3070,3068
1584,683,979,0,1584,656,928,1.37241e+15,29.0379,1126.81,1584,460,48,605,605,605,605,605
12467,3223,3971,11817,650,11817,650,6.91124e+18,93.3077,5144.16,12467,1894,110,8496,8496,8042,7974,6576
31363,5,14,30454,909,31282,81,1.55712e+14,10.6539,567.055,31363,13,12,8158,5327,4655,4496,4252
17514,1946,5780,17514,0,16495,1019,5.75246e+18,137.061,6777.11,17514,1694,125,17089,17089,0,0,0
49291,9623,17165,18337,30954,0,49291,8.40775e+12,58.2584,20052.4,49291,8356,72,28302,28302,25153,21457,20686
5175,416,1889,4918,257,0,5175,1.89451e+18,81.6783,2477.85,5175,883,88,21381,21037,12496,3752,1882
13313,373,3271,12536,777,12536,777,1.43657e+18,97.568,4578.07,13313,1532,111,10042,10042,3587,4180,1876
12560,147,176,12553,7,12560,0,6.07253e+18,164.904,1386.19,12560,130,129,31614,30993,30020,0,0
36842,544,1075,0,36842,35793,1049,3.56161e+16,225.48,3608.42,36842,164,26,36606,36606,36606,36606,36606
47157,209,1447,0,47157,46435,722,2.46319e+16,3.73671,5558.89,47157,726,4,28248,26730,16847,8264,9099
13794,3737,4473,5065,8729,0,13794,8.78314e+12,58.3505,5552.73,13794,2177,72,21732,21732,17926,20924,12672
27030,4945,10233,25750,1280,0,27030,1.81291e+18,95.3937,12189.2,27030,4961,110,16797,16797,14975,14191,11255
27690,8537,18476,26980,710,26980,710,9.48806e+18,90.3389,19708.5,27690,8924,111,29712,29712,28850,28173,28047
45808,11,14,44497,1311,45724,84,1.43552e+14,10.4728,677.929,45808,13,12,19657,13405,11771,16250,10510
25838,729,1353,0,25838,25077,761,4.61606e+16,261.669,4109.51,25838,219,26,21231,21231,7935,4710,2798
12995,2233,3084,4577,8418,0,12995,9.86805e+12,59.7362,4219.37,12995,1497,72,9911,9911,8672,9694,7339
19984,1581,4676,0,19984,7031,12953,2.53118e+15,59.9127,6267.71,19984,2273,72,32497,32497,25872,25235,24574
11671,874,3208,0,11671,0,11671,6.19921e+17,96.4369,4377.19,11671,1538,110,8463,8463,5841,3708,3347
32036,7,14,31123,913,31957,79,1.38919e+14,10.769,554.624,32036,13,12,28578,26448,24115,21961,15606
10317,4,11,10021,296,10315,2,1.38078e+14,10.1825,283.737,10317,11,11,2435,543,47,758,29
7890,2727,7890,7890,0,0,7890,7.99899,0,7890,7890,7890,1,0,0,0,0,0
22159,1047,9071,21159,1000,21159,1000,8.28725e+18,93.2198,10689.5,22159,4392,110,14839,14839,12810,11306,4857
2553,481,679,2403,150,0,2553,2.24406e+18,92.5848,1072.41,2553,305,65,1874,1874,1667,1644,1559
38885,12041,19039,37375,1510,37375,1510,9.62421e+18,92.5057,21264.6,38885,9234,110,32534,32534,32534,32534,32534
36532,2873,12111,34672,1860,34672,1860,7.16922e+18,96.047,14719.5,36532,5873,110,26325,26325,17540,6085,6064
49833,2207,14173,47103,2730,47103,2730,2.83251e+18,97.689,17611.5,49833,6748,111,40468,40468,36293,33436,19089
48336,10828,12198,0,48336,17160,31176,2.46479e+15,59.7751,15382.2,48336,5930,72,43761,43761,43761,43761,43761
14038,7620,9235,0,14038,5987,8051,1.146e+15,52.0797,9894.11,14038,4493,72,4803,4803,4629,4464,4617
41097,1126,11479,0,41097,0,41097,6.09411e+17,97.1484,14518.2,41097,5569,110,46822,46822,46822,46822,46822
38922,10968,17431,15150,23772,0,38922,7.12758e+12,56.6404,19512.8,38922,8488,72,21491,21491,17807,20721,11738
32791,10587,17569,31631,1160,0,32791,1.35528e+18,92.9725,19385.9,32791,8534,110,22264,22264,20953,22033,19498
5178,213,1299,1831,3347,0,5178,9.78579e+12,58.9235,1859.68,5178,626,72,3879,3879,1640,3242,759
31930,102,206,31916,14,31930,0,5.97705e+18,186.261,2201.52,31930,173,175,36130,33166,20327,384,717
21642,2,14,21015,627,21563,79,1.60103e+14,10.6705,475.569,21642,14,12,12737,9566,7413,7819,6024
32804,3373,8879,30982,1822,30982,1822,3.22578e+18,97.1832,11444.5,32804,4298,110,32757,32757,32757,32757,32757
27654,6805,8532,27654,0,26044,1610,5.14682e+18,172.84,10064.6,27654,3282,125,27472,27472,27472,27472,27472
40642,15300,17184,38856,1786,38856,1786,8.65926e+18,94.1431,19714.2,40642,8347,110,29714,25287,27424,28429,23033
8348,6,32,8316,32,8348,0,1.11708e+18,31.8773,516.852,8348,32,32,1345,0,782,1298,1345
2377,561,712,2244,133,2244,133,2.4529e+18,92.4178,1073.16,2377,325,63,1665,1665,1535,1654,1520
32230,3553,8684,30435,1795,0,32230,2.1286e+18,97.2141,11216.9,32230,4211,110,40533,40533,33927,33239,27861
35375,482,1044,0,35375,34365,1010,3.55552e+16,214.807,3476.93,35375,158,26,28927,28584,24506,24917,18984
2418,228,654,2276,142,2276,142,5.85011e+18,92.1729,1029.15,2418,297,62,1764,1764,1632,1568,808
41578,4,15,40392,1186,41495,83,1.39079e+14,10.6474,641.387,41578,13,12,13184,466,3095,5459,8351
48822,16094,18591,0,48822,18444,30378,2.0454e+15,57.7368,21334,48822,9057,72,31714,31714,30591,29195,29103
45443,12400,17641,0,45443,17221,28222,2.0189e+15,57.4984,20208.7,45443,8588,72,38779,38779,38779,38779,38779
6036,414,1503,2127,3909,0,6036,9.80169e+12,59.0969,2132.52,6036,723,72,5759,5759,7180,5970,2721
14167,2644,3397,0,14167,0,14167,6.44302e+17,97.1039,4797.75,14167,1623,110,10770,10770,9936,9293,8875
28386,12239,12267,27146,1240,27146,1240,2.11915e+18,95.222,14129.9,28386,5895,111,21581,21581,21581,21581,21581
30651,7155,10459,30651,0,28961,1690,4.94216e+18,225.828,12088.9,30651,3162,133,39546,39546,39546,39546,39546
37303,6027,14707,14166,23137,0,37303,7.81633e+12,57.5,16874.2,37303,7164,72,34257,34225,34225,34225,34225
4235,258,269,0,4235,4110,125,4.01039e+16,19.4279,700.929,4235,49,26,21919,21919,19143,16909,2243
37719,5671,21179,15453,22266,0,37719,5.67371e+12,54.0989,22870.1,37719,10311,72,23229,23229,18009,21770,12696
27962,4991,6585,26332,1630,0,27962,2.22851e+18,97.7083,8936.16,27962,3189,110,31405,31405,31405,31405,31405
12133,5,6,11927,206,12101,32,9.89675e+13,3.99679,246.258,12133,5,4,12127,12127,12127,12126,11627
625,60,236,585,40,585,40,5.38725e+18,75.9168,356.327,625,89,35,287,89,122,200,194
3084,1015,1179,0,3084,1152,1932,2.11459e+15,47.7552,1514.49,3084,557,62,1905,1905,1905,1905,1905
24841,265,5771,8729,16112,0,24841,9.91414e+12,60.0225,7664.96,24841,2811,72,19070,19070,5453,15276,1207
39412,7299,14680,14830,24582,0,39412,8.10187e+12,57.4558,17013,39412,7145,72,29356,29356,21516,25008,17670
5679,28,176,5642,37,5679,0,6.10709e+18,142.759,932.863,5679,97,98,2865,870,991,1039,1132
25263,277,6065,23791,1472,23791,1472,2.32414e+18,98.0893,8189.17,25263,2857,111,19198,19198,8617,12902,2094
34831,11823,14641,13385,21446,0,34831,7.47713e+12,57.0009,16623.3,34831,7112,72,34801,34801,34801,34801,34801
11741,2936,3939,4330,7411,0,11741,8.63124e+12,58.1486,4883.04,11741,1917,72,7802,27280,26830,0,0
45595,2,14,44285,1310,45512,83,1.46272e+14,10.4773,669.073,45595,13,12,21845,20693,20821,20699,20618
18844,2329,5144,17797,1047,0,18844,2.1233e+18,96.906,6819.99,18844,2483,110,20880,20880,12710,11758,8077
34928,6774,9960,0,34928,0,34928,6.05505e+17,96.6273,12613.8,34928,4827,110,21389,21389,18536,17055,13929
48202,15689,18219,48202,0,45753,2449,4.59954e+18,494.12,20588.5,48202,7411,141,48133,48133,48133,48133,48133
38655,61,176,38566,89,38655,0,6.0371e+18,173.231,2405.63,38655,169,171,28002,13503,16391,25230,567
31235,111,176,31158,77,31235,0,5.97819e+18,169.747,2094.28,31235,169,164,27561,27303,7881,21530,795
2516,557,1035,947,1569,0,2516,7.76429e+12,55.0914,1314.38,2516,493,63,1481,1436,1359,1461,1363
36496,223,265,36496,0,36496,0,5.55687e+18,223.383,1361.09,36496,265,24,28540,28540,21552,16425,4432
33811,7799,8118,31841,1970,31841,1970,3.2052e+18,98.273,10778.8,33811,3839,111,36835,36835,36835,36835,36835
6031,959,1859,5703,328,5703,328,6.61434e+18,94.9166,2554.79,6031,882,91,4172,4172,3671,3601,2019
12815,3483,6179,12305,510,12305,510,9.44012e+18,93.2147,7158.61,12815,2986,110,6636,6636,6386,6386,3969
4728,8,11,4595,133,4723,5,1.38416e+14,10.8602,192.439,4728,11,11,4609,4476,3578,3559,4041
24213,6,13,23522,691,24141,72,1.38756e+14,10.8637,479.619,24213,13,12,8393,7059,6913,6882,6329
706,47,157,706,0,706,0,6.24227e+18,85.4164,306.532,706,52,41,394,194,171,196,184
1437,438,483,0,1437,0,1437,6.19638e+17,87.4544,723.886,1437,211,52,954,954,931,940,945
6892,3,11,6695,197,6886,6,1.5593e+14,10.5548,240.342,6892,11,11,5307,3879,4144,14855,13137
2838,88,175,2838,0,2838,0,5.99982e+18,142.03,636.135,2838,81,77,2320,1410,1331,1418,1431
19012,2367,4486,0,19012,0,19012,6.49868e+17,97.4529,6235.45,19012,2166,110,16447,16447,16425,16425,16165
33935,160,208,33838,97,33935,0,6.14549e+18,202.646,2453.85,33935,167,169,33469,32804,30840,30973,31002
24097,585,832,0,24097,23410,687,3.54891e+16,133.191,2540.77,24097,115,26,23265,23100,21184,21483,18317
24444,803,907,0,24444,23743,701,3.71136e+16,170.031,2776.28,24444,128,26,27574,27574,10681,9491,4122
41895,7940,12636,41895,0,39450,2445,4.19668e+18,294.562,14731.5,41895,3612,133,40493,40493,40493,40493,40493
16714,3836,3974,15744,970,15744,970,3.21876e+18,97.3269,5562.7,16714,1914,110,12911,12911,11848,12750,9897
39472,1460,9278,37176,2296,0,39472,2.22461e+18,97.8403,12361.2,39472,4497,110,28116,28116,18311,15447,6191
6587,785,2539,2486,4101,0,6587,7.99362e+12,48.252,3122.28,6587,1215,72,5728,22877,12756,16688,3026
35072,1779,11728,0,35072,12958,22114,2.2026e+15,58.4377,13949.4,35072,5712,72,23344,23344,10713,4826,2312
31673,6466,7436,0,31673,0,31673,6.47816e+17,97.7659,10030.4,31673,3602,110,24664,24664,17701,23150,8541
19954,2486,9403,19954,0,19045,909,4.50117e+18,162.529,10388.9,19954,3992,124,10551,10362,6043,8027,3369
26764,3310,10060,26764,0,25364,1400,4.4452e+18,212.997,11511.3,26764,2809,133,22764,22257,12920,16505,4887
29863,6957,7677,28163,1700,28163,1700,1.29552e+18,97.9264,10053.8,29863,3637,111,22186,22186,21476,22132,20480
40284,258,1314,0,40284,39126,1158,3.80572e+16,263.122,4398.47,40284,209,26,22888,21270,8008,15079,1006
46422,10685,10868,0,46422,0,46422,6.47803e+17,97.8835,14373.7,46422,5273,110,35543,35543,35533,35533,35383
19244,543,743,0,19244,18697,547,3.5542e+16,72.4685,2142.7,19244,97,26,44624,44563,44027,44324,0
13518,53,199,13515,3,13518,0,5.98384e+18,179.056,1430.66,13518,142,146,17546,6433,7366,9638,3471
10335,570,2427,3628,6707,0,10335,9.86119e+12,59.5994,3384.12,10335,1166,72,7908,7908,5194,7438,2013
6029,99,176,6024,5,6029,0,6.15118e+18,160.816,962.04,6029,96,99,5356,4054,3280,3347,3403
44773,157,208,44690,83,44773,0,6.014e+18,201.27,2708.1,44773,191,186,35079,34771,10153,27287,1021
6943,1107,1706,0,6943,2444,4499,2.50509e+15,59.2054,2407.47,6943,824,72,5237,5237,4605,4348,3719
33819,8025,11073,33819,0,31919,1900,4.32333e+18,248.469,12842.6,33819,2959,134,22746,22651,20748,22263,18008
43524,9419,14042,43524,0,41004,2520,4.7014e+18,306.473,15885,43524,2948,137,29385,29104,22570,25169,16798
46500,5896,19370,46500,0,44262,2238,4.65969e+18,751.992,21466.5,46500,7893,141,37053,37053,36291,36300,27899
27393,24471,25601,0,27393,8531,18862,2.35917e+15,3.99051,25681.8,27393,8546,9,25922,25922,25922,25922,25922
22102,2100,5214,7780,14322,0,22102,9.88739e+12,59.908,6928.28,22102,2540,72,43171,43171,43171,43171,43171
13139,2554,7540,13139,0,0,13139,8.98165e+17,17.812,7828.46,13139,6770,20,5599,5599,1903,3188,1886
12882,139,548,2684,10198,0,12882,5.86225e+13,11.9846,915.118,12882,545,13,12334,12334,8676,5845,10703
4521,31,176,4515,6,4521,0,6.23269e+18,96.3904,806.641,4521,81,86,2623,868,967,775,915
2794,1547,2794,0,2794,1361,1433,53452600000,0,2794,2794,1361,21,0,0,0,0,0
43459,57,176,43378,81,43459,0,5.98522e+18,171.952,2470.44,43459,170,171,43237,43125,43090,43101,43072
47662,11373,15460,17515,30147,0,47662,8.6982e+12,58.6167,18354.1,47662,7521,72,39498,39498,39498,39498,39498
30334,4404,7255,28565,1769,28565,1769,2.96679e+18,98.2144,9701.18,30334,3424,111,29916,29916,29916,29916,29916
2945,180,1906,633,2312,0,2945,2.25273e+13,5.44788,2208.62,2945,642,13,1039,1039,533,535,218
20537,6,176,20457,80,20537,0,6.09779e+18,170.182,1774.24,20537,143,152,5623,4552,4309,4470,4306
39864,5474,25830,0,39864,8607,31257,5.7245e+15,5.52393,29627.3,39864,8617,13,39064,39064,39064,39064,39064
29874,7548,8284,28217,1657,28217,1657,6.66307e+18,97.6223,10610.3,29874,3936,111,21590,21590,20204,20551,19835
7337,1406,1781,6912,425,0,7337,2.23617e+18,96.0762,2639.75,7337,837,99,5556,5556,5091,5056,4792
44743,13362,17069,42640,2103,42640,2103,2.97165e+18,94.4277,19948.3,44743,8278,110,43766,43766,43766,43766,43766
21409,26,176,21403,6,21409,0,5.98457e+18,169.544,1736.03,21409,152,158,8956,1067,3441,4381,116
4370,660,1420,4140,230,4140,230,3.13178e+18,85.359,1968.28,4370,651,85,2950,2950,1733,2294,1422
38957,6594,9166,0,38957,0,38957,6.46699e+17,97.7898,12215.4,38957,4442,110,27944,27751,21536,24698,14189
46770,11529,23926,46770,0,0,46770,8.81744e+17,17.9879,24542.8,46770,21524,20,46391,46391,46391,46391,46391
23840,1350,1456,0,23840,0,23840,3.76581e+18,15.9877,2026.81,23840,984,18,22384,22384,21471,21629,21448
49025,6954,14980,0,49025,17854,31171,2.29121e+15,58.9298,18008.9,49025,7293,72,48583,48583,48583,48583,48583
5202,742,1256,1819,3383,0,5202,9.79612e+12,59.0052,1827.02,5202,602,72,3946,3946,3331,3816,2492
15502,296,882,0,15502,15047,455,4.30059e+16,162.193,2434.89,15502,125,26,14620,14394,37842,36843,30446
2549,664,738,0,2549,0,2549,6.36761e+17,92.1475,1120.41,2549,340,62,12214,12214,6465,5955,1773
16329,1474,5122,15918,411,15379,950,3.5023e+18,132.376,6191.34,16329,1762,124,15187,15187,15187,15187,15187
27809,806,907,0,27809,27018,791,3.55896e+16,172.151,2865.67,27809,130,26,27709,13310,1051,7770,712
19559,2733,4569,6873,12686,0,19559,9.89948e+12,59.9552,6135.26,19559,2225,72,14990,14990,12280,14520,9114
11526,7,13,11196,330,11461,65,1.38247e+14,10.9096,328.105,11526,12,12,11113,10905,8436,8552,7578
48986,8322,23672,0,48986,0,48986,4.37047e+17,93.1185,26356.3,48986,11493,110,48157,48157,48157,48157,48157
26886,8944,11960,25746,1140,0,26886,1.62128e+18,94.1316,13746,26886,5791,110,14926,14926,14370,13993,13753
20382,5,208,20376,6,20382,0,6.01986e+18,198.763,1837.32,20382,154,163,4369,2487,2230,2391,2204
28200,868,911,0,28200,27396,804,3.54948e+16,171.798,2885.81,28200,130,26,35421,35421,12941,6106,4675
15891,5049,9776,6648,9243,0,15891,4.98813e+12,53.7696,10562.4,15891,4751,72,6115,6067,4309,5805,2305
6001,184,264,0,6001,5832,169,3.53984e+16,19.9098,759.592,6001,48,26,5737,5737,5332,5375,4458
7699,1668,3355,0,7699,2966,4733,1.88257e+15,56.2064,3965.86,7699,1630,72,4344,4344,3299,2697,1735
12462,3842,5816,11952,510,0,12462,1.5679e+18,85.18,6799.39,12462,2792,108,12287,12287,12287,12287,12287
3304,834,876,3114,190,3114,190,2.84534e+18,94.0636,1347.96,3304,385,72,2428,2428,2393,2405,2416
34446,3396,12544,23443,11003,32766,1680,3.34714e+18,96.1579,14897,34446,5988,111,35658,35658,24285,22031,10010
41483,163,176,41394,89,41483,0,6.08051e+18,172.62,2518.73,41483,170,169,33582,33286,22718,31165,9343
35134,8841,11542,33341,1793,0,35134,1.95489e+18,96.3009,14083.3,35134,5598,110,25810,25810,25184,25069,24712
9198,6112,6308,0,9198,3952,5246,1.04015e+15,24.4193,6763.19,9198,3051,66,30031,30031,25468,28135,16803
5967,523,1486,2097,3870,0,5967,9.77306e+12,59.0928,2111.46,5967,719,72,4481,4481,2788,4028,1603
46002,8126,8192,46002,0,46002,0,4.65716e+15,6733.18,19393.9,46002,8192,7,37546,0,37216,37476,37546
45145,4798,18772,0,45145,17333,27812,1.92632e+15,57.1452,21231.4,45145,9128,72,40411,40411,40411,40411,40411
19267,4556,10534,7826,11441,0,19267,5.87696e+12,54.9605,11563.6,19267,5130,72,15099,15099,15099,15099,15099
30049,46,208,29986,63,30049,0,6.10033e+18,203.077,2308.87,30049,172,165,26136,22356,21840,22341,22141
24556,6,12,23855,701,24549,7,1.39121e+14,10.2322,441.522,24556,12,11,36643,30599,28401,26294,6785
18362,4618,7583,18362,0,17452,910,3.67231e+18,158.91,8664.34,18362,3223,122,10779,10779,8640,9396,6931
36735,416,1071,0,36735,35690,1045,3.55414e+16,222.43,3588.77,36735,162,26,29013,28917,18819,25538,13012
27293,6983,10414,26004,1289,26004,1289,7.87583e+18,95.3698,12374.9,27293,5043,110,32557,32302,22693,19393,15459
26670,777,881,0,26670,25908,762,3.55128e+16,158.208,2758.78,26670,125,26,25789,25789,25492,25477,23744
10604,145,3298,10044,560,10044,560,6.78591e+18,94.1109,4351.66,10604,1565,110,7306,7137,5185,3961,0
23329,324,6348,0,23329,8354,14975,2.4105e+15,59.3411,8071.47,23329,3088,72,43164,0,0,0,0
43564,7435,19094,41691,1873,41691,1873,3.38075e+18,94.2722,21655.6,43564,9177,111,31306,31306,26905,24704,21456
47594,3,13,46230,1364,47567,27,1.42151e+14,10.3174,629.784,47594,12,12,13727,12157,11562,11651,11392
48305,450,1573,0,48305,46912,1393,3.89086e+16,292.62,5363.45,48305,263,26,48100,48100,48100,48100,48100
47115,11458,16209,0,47115,0,47115,5.55194e+17,95.8269,19348.2,47115,7861,110,30711,30652,27881,29715,24432
46945,15202,15278,0,46945,0,46945,5.71427e+17,96.3673,18476.8,46945,7424,110,31053,31053,30557,30701,30029
917,286,307,857,60,857,60,2.88611e+18,83.1461,476.25,917,128,43,610,610,610,610,610
29745,611,12011,0,29745,0,29745,5.05197e+17,94.8657,14052.8,29745,5815,110,22898,22706,13674,2316,2325
26337,3,12,25585,752,26323,14,1.39012e+14,10.428,460.698,26337,12,11,1616,406,477,503,195
14598,109,176,14582,16,14598,0,6.21186e+18,143.415,1468.41,14598,113,113,13928,12605,10497,10528,9929
9116,145,397,0,9116,8856,260,3.56968e+16,19.9744,1117.72,9116,60,26,8719,8719,7918,7930,4157
1131,59,62,0,1131,1100,31,3.54236e+16,18.1406,185.983,1131,25,24,1069,1069,1061,1063,1059
34847,2491,10771,0,34847,12712,22135,2.2834e+15,58.8361,13052.1,34847,5246,72,21647,26952,13774,19587,7278
5537,53,2083,0,5537,2079,3458,2.07465e+15,56.8877,2599.27,5537,1009,71,3096,1154,934,118,157
46731,431,14938,44299,2432,44299,2432,5.69322e+18,88.4286,18079.6,46731,7130,111,42987,42804,41010,41726,39518
40527,11021,18010,40527,0,38997,1530,4.72182e+18,2770.71,21277.7,40527,5379,142,28611,28611,27632,27724,27759
15517,237,5237,14731,786,0,15517,1.93915e+18,95.6342,6588.1,15517,2527,110,10280,10125,6134,5505,1451
43824,701,1428,0,43824,42563,1261,3.8487e+16,274.27,4820.68,43824,233,26,41770,41770,40378,41018,37625
49979,8167,16323,47399,2580,47399,2580,2.63649e+18,97.0426,19604.2,49979,7803,111,49694,49694,49694,49694,49694
21693,4772,9401,20753,940,0,21693,1.65714e+18,94.4164,10944.5,21693,4560,110,21585,21585,21585,21585,21585
33147,11,176,33062,85,33147,0,6.03968e+18,172.223,2230.64,33147,164,168,7026,970,99,917,518
11514,570,3869,0,11514,0,11514,5.67151e+17,95.4005,4954.49,11514,1863,110,7645,7473,5070,2704,2330
34124,39,61,34028,96,34124,0,2.32806e+18,60.7926,1373.23,34124,61,61,31967,29795,29867,29956,29813
35693,178,206,35612,81,35693,0,5.97913e+18,186.833,2312.44,35693,178,169,27696,27364,15876,17773,9039
5173,129,170,5168,5,5173,0,6.00888e+18,155.287,847.919,5173,102,102,4826,4537,3825,3904,3807
13442,8,11,13045,397,13429,13,1.79686e+14,10.1363,342.101,13442,11,11,13206,13073,11276,11289,11164
21176,1380,5769,0,21176,0,21176,6.18499e+17,96.9398,7598.02,21176,2790,110,22098,22098,22098,22098,22098
46875,9353,10961,0,46875,0,46875,6.48271e+17,97.8948,14496.9,46875,5320,110,32226,32226,28827,30983,22460
49313,660,11470,0,49313,17332,31981,2.53057e+15,60.0375,14778.8,49313,5565,72,42841,42591,36246,42841,31565
27699,110,176,27627,72,27699,0,5.98067e+18,169.565,1973.07,27699,159,165,17508,4146,6087,7748,90
38439,1340,1561,0,38439,37316,1123,4.22628e+16,288.071,5057.61,38439,258,26,40679,40679,40679,40679,40679
27301,6732,9425,0,27301,0,27301,5.54503e+17,95.9172,11476.8,27301,4567,110,17876,17876,15460,13928,13030
9669,137,175,9662,7,9669,0,5.97214e+18,162.072,1167.08,9669,129,127,9229,8622,7488,7609,7523
29785,6231,7014,28055,1730,28055,1730,5.89656e+18,97.7036,9487.85,29785,3386,110,0,0,0,0,1874
8932,732,2187,8412,520,8412,520,2.87372e+18,97.0484,3167.95,8932,1015,110,6745,6745,4527,5469,2777
34731,2338,8394,32711,2020,32711,2020,2.9904e+18,98.0324,11104,34731,3969,111,34353,34353,34353,34353,34353
39905,10,17,38714,1191,39827,78,1.92063e+14,10.4059,706.312,39905,14,12,16186,12377,11421,10438,9803
10419,3180,4085,0,10419,3949,6470,2.04466e+15,57.1757,4888.76,10419,1990,72,7127,7127,7118,7098,0
15259,1169,3653,14377,882,0,15259,2.22272e+18,97.151,5131.78,15259,1748,110,14833,14833,8159,7419,4637
44336,11705,11814,0,44336,15853,28483,2.42234e+15,57.4017,14731,44336,5749,72,32364,32364,32032,36944,0
36229,123,176,36169,60,36229,0,6.09511e+18,170.892,2354.89,36229,164,166,28277,28146,7341,22107,817
8644,9,11,8397,247,8638,6,1.395e+14,10.6932,260.023,8644,11,11,8504,8338,8027,8024,7134
38793,1669,11743,38793,0,36533,2260,5.10474e+18,276.231,13721.1,38793,3880,133,36688,36688,36350,36556,35373
38782,6969,18769,0,38782,15351,23431,1.70418e+15,56.0871,20739,38782,9141,72,20013,20013,14960,8764,9017
36704,2318,8590,34566,2138,34566,2138,5.87514e+18,97.8257,11502.9,36704,4160,110,36390,36390,36390,36390,36390
39510,4712,16025,37720,1790,37720,1790,6.796e+18,95.1221,18553.6,39510,7780,110,22165,21689,13885,16923,7929
32068,9822,11772,30518,1550,30518,1550,7.68192e+18,95.6624,14029,32068,5708,110,31921,31921,30789,30019,28645
48886,10330,21233,0,48886,18925,29961,1.86783e+15,56.3028,23786.1,48886,10337,72,26540,26540,22483,17807,16843
11239,1448,2717,10581,658,10581,658,5.89833e+18,96.928,3888.48,11239,1305,110,8522,8522,8200,8203,4960
17921,660,4249,0,17921,0,17921,6.48036e+17,97.3726,5920.77,17921,2047,110,13672,13672,8811,3980,2959
30094,10210,11025,0,30094,11283,18811,2.09502e+15,57.8934,12915.4,30094,5367,72,19069,19069,18179,17575,16858
32400,4175,14496,0,32400,0,32400,4.67815e+17,92.6439,16550.8,32400,7022,110,23675,23675,20735,20248,8822
39884,11,14,38739,1145,39801,83,1.46249e+14,10.5931,633.467,39884,13,12,42123,37372,22690,27765,5179
15587,2745,4065,0,15587,5554,10033,2.44553e+15,59.4129,5338.46,15587,1975,72,11522,11522,9686,8059,7614
4910,125,176,4904,6,4910,0,6.18257e+18,150.299,856.311,4910,90,91,4592,4219,3577,3626,3462
28433,2474,10079,10599,17834,0,28433,8.30361e+12,58.0331,11915.5,28433,4896,72,18354,18354,12171,17294,4729
19288,453,4526,0,19288,6778,12510,2.52486e+15,59.8801,6073.96,19288,2192,72,23884,23884,19007,19221,12574
20398,4229,5395,0,20398,0,20398,6.22117e+17,97.0013,7191.02,20398,2593,110,15003,15003,13704,13903,11797
2498,703,835,913,1585,0,2498,8.83916e+12,56.6906,1140.83,2498,401,61,25546,25546,25456,25526,24650
13017,5019,5291,12423,594,0,13017,1.74587e+18,94.4551,6383.46,13017,2559,110,14855,14855,12377,7385,7393
21590,120,175,21520,70,21590,0,5.98315e+18,166.583,1738.99,21590,153,159,26606,12676,15665,13621,1983
44138,14332,41246,41242,2896,41242,2896,3.77693e+17,3.99683,41349.6,44138,13769,9,43860,43860,43860,43860,43860
27197,336,1302,0,27197,26393,804,4.40368e+16,261.996,4006.47,27197,209,26,43807,43807,43807,43807,43807
23231,564,824,0,23231,22570,661,3.56209e+16,129.635,2489.27,23231,113,26,22407,22253,20303,20603,17430
5008,1092,1290,0,5008,0,5008,6.44538e+17,94.1352,1934.74,5008,604,86,3718,3718,3472,3501,3402
21639,2737,5096,20379,1260,20379,1260,3.21907e+18,97.5345,7028.04,21639,2460,110,16543,16543,14162,15834,9556
17012,2907,4005,5982,11030,0,17012,9.89236e+12,59.8369,5402.53,17012,1950,72,13007,13007,11517,12746,9856
40266,3761,9932,37958,2308,0,40266,2.19157e+18,97.679,13024.1,40266,4820,110,31207,31207,28081,27516,15538
7286,923,3069,2802,4484,0,7286,7.59531e+12,56.5568,3665,7286,1495,72,35003,35003,33776,34795,32400
17149,2148,4082,0,17149,0,17149,6.46394e+17,97.262,5697.82,17149,1957,110,39645,39645,39645,39645,39645
35701,10136,15674,13840,21861,0,35701,7.23543e+12,56.7614,17641.6,35701,7631,72,20027,20027,16928,19497,13398
33169,12185,13754,31692,1477,0,33169,1.7061e+18,94.8952,15937.5,33169,6671,110,25560,25560,25560,25560,25560
4539,173,293,0,4539,4408,131,4.03866e+16,18.5739,757.665,4539,49,26,4246,4246,4099,4183,3690
23861,1315,5653,0,23861,0,23861,6.46875e+17,97.6057,7732.28,23861,2730,110,34961,34961,12604,13963,6094
14661,648,4675,13898,763,0,14661,1.99503e+18,95.9381,5998.87,14661,2250,110,9986,9869,6542,5985,2751
26335,4703,7304,24885,1450,0,26335,2.106e+18,96.9788,9455.67,26335,3536,110,15368,25635,15163,19418,8949
10298,31,170,10292,6,10298,0,5.97161e+18,162.357,1195.42,10298,128,131,5216,1379,1626,1807,1847
21643,2,12,21027,616,21634,9,1.38715e+14,10.3453,415.706,21643,12,11,12534,8877,8708,9147,7039
23727,2,12,23050,677,23718,9,1.3913e+14,10.2164,433.798,23727,12,11,13748,9750,9391,9794,7622
11946,10,13,11604,342,11907,39,1.47712e+14,10.5628,329.071,11946,11,11,11854,11696,11575,11547,11181
23144,123,206,23134,10,23144,0,5.9819e+18,186.079,1878.13,23144,160,167,19367,13316,10677,9952,8248
26569,5127,8201,26569,0,25020,1549,4.75641e+18,170.24,9691.83,26569,3159,124,32773,32773,27249,31593,16872
5022,760,1521,0,5022,0,5022,5.98505e+17,94.3395,2139.68,5022,709,84,3501,3501,2575,2191,1826
22274,6182,7576,21154,1120,21154,1120,2.96469e+18,93.3729,9346.31,22274,3653,110,14698,14698,13945,14469,12725
43661,9598,17281,0,43661,16597,27064,1.99179e+15,57.4759,19740.6,43661,8407,72,33595,33595,33483,33454,32717
28362,3755,6691,26712,1650,0,28362,2.22524e+18,97.6486,9067.12,28362,3232,110,21671,21671,17734,16998,26703
9627,160,2293,9067,560,0,9627,2.23417e+18,96.7524,3348.28,9627,1087,110,24194,24108,6775,1462,612
42157,130,176,42142,15,42157,0,5.98386e+18,172.064,2433.61,42157,170,172,32487,18659,9634,2562,2933
47448,245,1689,0,47448,46072,1376,4.0521e+16,295.407,5675.12,47448,285,26,32650,32077,18901,27569,9376
16338,3616,4326,15418,920,15418,920,6.30183e+18,96.951,5843.58,16338,2086,110,12012,12012,11852,11852,10442
44634,5847,10410,0,44634,15693,28941,2.53281e+15,60.0731,13449.9,44634,5071,72,31657,31250,29491,30463,28017
31687,6375,8658,0,31687,11364,20323,2.40133e+15,59.407,10860.5,31687,4217,72,41535,41535,41535,41535,41535
22208,4361,5253,0,22208,7814,14394,2.51918e+15,59.8615,6974.91,22208,2549,72,16955,16955,15785,16123,14517
6664,111,289,0,6664,6473,191,3.54125e+16,19.9439,831.513,6664,51,26,6375,6375,5174,5234,3077
19933,8159,9743,19153,780,19153,780,2.52261e+18,91.3714,11087,19933,4706,110,10190,10190,9302,9975,8444
8717,66,2122,0,8717,3066,5651,2.49422e+15,59.3612,2956.58,8717,1020,72,6547,3890,1676,1062,238
3357,1407,1564,0,3357,0,3357,4.64319e+17,90.3819,1947.04,3357,729,73,1793,1793,1763,1713,1781
42014,303,11848,39724,2290,0,42014,2.08807e+18,97.0882,14929.9,42014,5748,110,41775,41775,41775,41775,41775
41801,3,14,40601,1200,41748,53,1.45852e+14,10.5294,642.191,41801,13,11,35378,29504,30791,31770,23396
6020,2011,2301,0,6020,0,6020,5.36193e+17,93.8163,2945.35,6020,1102,95,3719,3719,3512,3468,3428
47320,10495,11029,16637,30683,0,47320,9.89749e+12,60.0854,14217.8,47320,5371,72,25706,25706,25599,25703,25599
16356,5,12,15864,492,16341,15,2.0054e+14,10.0604,386.188,16356,12,11,1939,405,242,160,4
40887,7273,11425,0,40887,14704,26183,2.38207e+15,59.3238,14110.7,40887,5566,72,40439,40439,40439,40439,40439
3105,58,209,0,3105,3017,88,4.03569e+16,18.2184,539.287,3105,39,26,2896,2896,2568,2399,1455
24076,1,15,23358,718,24006,70,1.94365e+14,10.4436,537.112,24076,13,12,0,0,0,0,0
26307,389,872,0,26307,25557,750,3.54796e+16,155.06,2721.7,26307,123,26,21941,21893,14632,19415,10747
28544,1736,9784,27114,1430,0,28544,1.91664e+18,96.0209,11913,28544,4748,110,40638,40638,40638,40638,40638
45782,10263,25215,0,45782,18670,27112,1.48164e+15,54.8721,27227.8,45782,12270,72,34066,34066,32763,32713,31771
8141,745,3557,0,8141,3145,4996,1.86943e+15,55.5413,4195.48,8141,1710,72,5972,5972,4607,4286,2778
34230,56,176,34217,13,34230,0,5.98862e+18,171.775,2212.12,34230,165,169,32862,32684,29509,27993,20287
32917,4233,7739,0,32917,0,32917,6.4701e+17,97.725,10412.3,32917,3741,110,21272,21272,16705,12916,11986
31116,1070,7311,0,31116,0,31116,6.47494e+17,97.7381,9871.21,31116,3536,110,27697,26854,13180,13214,3347
37145,7762,11648,13577,23568,0,37145,8.84043e+12,58.7323,14038.3,37145,5661,72,25497,25497,22070,24906,18018
21722,2751,5870,0,21722,7783,13939,2.41535e+15,59.3342,7505.28,21722,2854,72,34699,34699,34699,34699,34699
12931,1926,6882,2803,10128,0,12931,52883600000,8.87093,7104.13,12931,6186,11,6049,6049,2710,6049,2437
3081,512,806,0,3081,0,3081,6.50306e+17,93.4323,1256.51,3081,373,70,2275,2275,1908,1671,1729
1425,75,80,0,1425,1384,41,3.53967e+16,19.1151,230.925,1425,27,25,1345,1345,1342,1338,1339
48943,88,176,48861,82,48943,0,5.9825e+18,171.839,2621.26,48943,171,171,36159,18760,18429,16523,10564
1071,224,906,0,1071,0,1071,2.07797e+17,73.4304,966.773,1071,417,40,165,84,83,55,159
24827,3526,11456,23807,1020,0,24827,1.57316e+18,90.3381,13103.7,24827,5555,110,13371,13371,8144,8104,4236
34674,238,1439,0,34674,33665,1009,4.21573e+16,275.479,4610.86,34674,237,26,30649,30391,27055,25160,24839
22963,1258,5347,0,22963,8066,14897,2.53729e+15,59.9849,7123.85,22963,2604,72,20155,20155,12631,18750,3180
28945,1300,8953,10559,18386,0,28945,8.91921e+12,58.7846,10916.3,28945,4353,72,24858,24858,11628,8147,5393
6002,1465,1579,5660,342,5660,342,3.63265e+18,95.9132,2302.87,6002,720,94,4423,4423,4423,4423,4329
34160,1392,8220,32177,1983,32177,1983,6.03556e+18,98.1907,10898.5,34160,3881,111,35253,35253,35224,35232,34365
34305,4425,9405,32395,1910,32395,1910,3.87837e+18,97.7341,11999.6,34305,4468,111,24900,24900,16399,18235,12124
1892,568,587,0,1892,0,1892,6.27529e+17,89.2257,890.154,1892,262,58,1305,1305,1291,1296,1305
42547,16909,17298,0,42547,0,42547,5.02312e+17,95.1186,19976.2,42547,8400,110,28871,28871,28871,28871,28871
37451,13032,13237,37451,0,35441,2010,5.03878e+18,282.409,15118.5,37451,4038,133,28678,28678,25639,27850,19848
17136,6097,8955,17136,0,11108,6028,5.42214e+18,204.382,9838.37,17136,2343,126,8181,8136,7245,7996,5813
21634,4558,5167,20382,1252,20382,1252,5.78665e+18,97.4504,7093.98,21634,2486,110,17814,17814,16724,17571,14850
29322,6247,6876,10300,19022,0,29322,9.86657e+12,59.9775,9033.28,29322,3342,72,28133,28133,28133,28133,28133
38109,780,1101,0,38109,37019,1090,3.561e+16,231.665,3714.35,38109,168,26,19632,19632,3519,2858,2767
25701,933,9277,25701,0,24322,1379,4.34014e+18,191.734,10692.1,25701,3811,125,21757,21709,19622,21387,17175
12205,1612,2890,0,12205,0,12205,6.47556e+17,96.9992,4148.03,12205,1374,110,7022,6636,3995,3711,1227
47608,12,16,46209,1399,47541,67,1.73699e+14,10.3243,756.174,47608,13,12,44610,42885,35002,34998,21958
36846,10385,15828,36846,0,35116,1730,4.58955e+18,305.011,17625.1,36846,5692,135,27106,27106,27106,27106,27106
35452,8425,9289,33449,2003,33449,2003,5.16481e+18,97.9067,11985.4,35452,4396,111,25798,25798,25267,25204,21642
32093,5777,13431,12336,19757,0,32093,7.51507e+12,57.0753,15292.1,32093,6538,72,28601,28601,19518,17915,10221
22086,6221,10219,21175,911,21175,911,8.15628e+18,93.2613,11702.1,22086,4896,111,11867,11867,9750,10431,7931
37832,11952,12225,37832,0,35633,2199,3.54437e+18,267.653,13890.7,37832,4540,128,27009,27009,27009,27009,27009
516,191,220,486,30,0,516,2.23125e+18,69.6764,317.564,516,82,34,296,296,273,280,295
34231,7836,16778,34231,0,0,34231,8.76183e+17,17.9812,17315.1,34231,15090,20,21858,21858,19601,18538,16403
27819,4155,14143,0,27819,0,27819,4.16148e+17,91.1655,15817.9,27819,6849,110,20375,20375,19596,19595,11130
39844,7983,12776,39844,0,37524,2320,4.16589e+18,282.61,14507.9,39844,4730,128,32751,2658,31780,32497,32024
7634,2125,2366,7232,402,7232,402,3.0554e+18,95.0817,3193.45,7634,1121,98,5268,5268,5054,5206,4859
33512,18570,19024,0,33512,13762,19750,1.42726e+15,54.719,20550,33512,9255,72,47465,47465,47465,47465,47465
47582,1178,18906,47582,0,45622,1960,4.59751e+18,3208.78,22838.3,47582,7184,142,41067,41067,29970,29270,24681
45946,17,18,44599,1347,45871,75,1.67619e+14,10.4059,712.986,45946,15,12,31114,26580,26894,27467,24706
10845,4236,5328,2378,8467,0,10845,52238700000,8.96385,5540.91,10845,4789,11,9313,9313,9313,9313,9313
26448,3585,6205,9306,17142,0,26448,9.88961e+12,59.9808,8190.17,26448,3016,72,46396,46396,46396,46396,46396
33960,728,10563,12408,21552,0,33960,8.90236e+12,58.8097,12791.8,33960,5145,72,23397,23362,13454,21687,1441
15145,1634,6408,15145,0,14405,740,5.32329e+18,132.934,7346.89,15145,2716,119,8737,8549,5781,6824,3400
22503,3952,9138,21483,1020,0,22503,1.73531e+18,94.8678,10783.2,22503,4429,110,21790,21790,21790,21790,21790
12255,3085,3418,11573,682,11573,682,4.33311e+18,96.9283,4609.07,12255,1600,111,8837,8837,8276,8449,8390
45681,1708,13767,45681,0,43021,2660,3.90277e+18,319.642,16005.2,45681,4750,133,45226,45226,45226,45226,45226
14878,6,61,14846,32,14878,0,2.25667e+18,60.5217,908.222,14878,61,61,2815,106,1,183,1260
22279,138,5228,20979,1300,20979,1300,3.34954e+18,97.6157,7207.67,22279,2524,110,24292,24122,24075,24227,24106
14617,113,208,14567,50,14617,0,6.19337e+18,192.073,1605.84,14617,132,132,9671,9479,4636,2987,2435
9413,85,176,9346,67,9413,0,6.12624e+18,162.718,1200.3,9413,118,120,20470,15249,11194,11324,11448
21889,2068,5213,20616,1273,0,21889,2.22455e+18,97.5187,7154.57,21889,2521,110,16676,16676,12443,11589,7430
41007,8729,13195,41007,0,38627,2380,3.64895e+18,291.477,14961.9,41007,4900,128,41782,41782,41782,41782,41782
5160,177,1558,1875,3285,0,5160,9.21565e+12,58.2198,2090.43,5160,754,72,3602,3554,1804,2990,646
35567,508,1047,0,35567,34553,1014,3.55558e+16,217.45,3491.57,35567,158,26,23246,22562,14571,6837,6995
25924,3663,10682,25924,0,24654,1270,4.00484e+18,238.855,12090.7,25924,4616,126,18947,18845,15287,16981,12988
3757,1368,2332,3757,0,3627,130,4.05014e+18,72.9553,2622.42,3757,1034,69,1425,1425,1340,1400,1424
7178,98,1781,6758,420,6758,420,4.31399e+18,96.574,2613.3,7178,826,99,19144,13228,10959,10358,11884
46886,3986,10907,0,46886,0,46886,6.49698e+17,97.9167,14444.6,46886,5295,110,31806,31806,21819,31768,21115
33730,7986,11225,32008,1722,32008,1722,6.91781e+18,96.7852,13626.7,33730,5363,111,26398,26398,25862,26000,25565
3915,38,82,3915,0,3915,0,2.39831e+18,78.2194,532.872,3915,71,71,2845,1359,1641,1728,1871
48031,5655,23169,46141,1890,46141,1890,9.3991e+18,93.1426,25818.8,48031,11246,110,32261,32261,23723,21698,13811
22018,5161,8325,22018,0,20868,1150,5.61433e+18,178,9583.91,22018,2835,129,18675,18675,18675,18675,18675
44374,3400,14423,42096,2278,42096,2278,7.08002e+18,96.0334,17485.4,44374,7008,110,44031,44031,44031,44031,44031
37901,15,16,36794,1107,37828,73,1.63771e+14,10.3323,607.996,37901,13,12,2889,8,2,398,1
10232,131,443,0,10232,9941,291,3.56908e+16,19.9801,1241.38,10232,65,26,9789,9789,7689,7708,4101
14830,3820,7262,0,14830,5884,8946,1.7005e+15,55.7712,8185.43,14830,3532,72,7568,37458,0,0,0
9686,774,2328,3411,6275,0,9686,9.83455e+12,59.4721,3232.11,9686,1125,72,11581,11495,8937,6987,2708
25270,4017,9184,25270,0,23880,1390,4.95878e+18,175.886,10419.6,25270,1917,129,21741,21316,13907,17209,7486
45805,2403,10716,43135,2670,0,45805,2.22856e+18,97.8805,14185.2,45805,5201,110,45364,45364,45364,45364,45364
16984,1338,4995,16069,915,0,16984,2.06324e+18,95.2485,6509.61,16984,2412,110,12737,12737,12169,12105,7560
38339,3586,16417,36669,1670,0,38339,1.66656e+18,94.7645,18815.9,38339,7979,110,38134,38134,38134,38327,0
22841,10368,12110,22021,820,0,22841,1.3753e+18,91.8499,13507.8,22841,5873,110,10731,10731,10164,9773,9558
21009,6717,10564,8372,12637,0,21009,6.42725e+12,53.9009,11745.7,21009,5126,72,16956,16956,7449,9543,7038
12361,4653,5003,11799,562,11799,562,8.32043e+18,93.76,6059.48,12361,2398,110,7358,7358,7318,7318,7063
4315,74,193,0,4315,4193,122,3.53191e+16,19.6635,565.196,4315,42,26,4122,4122,3321,3359,2051
11017,596,3748,11017,0,10377,640,5.81879e+18,92.4074,4489.2,11017,1331,119,7269,7269,4065,5615,1565
31211,226,10139,31211,0,29399,1812,5.2919e+18,207.188,11588.9,31211,2918,132,20890,19324,10384,9551,0
38726,11864,20915,8375,30351,0,38726,53019700000,8.99424,21301.4,38726,18820,11,31720,31720,31720,31720,31720
36404,1133,1211,0,36404,35358,1046,3.78597e+16,241.193,3995.73,36404,191,26,36350,36350,36350,36350,36350
45930,232,2337,0,45930,0,45930,3.8047e+18,15.993,3139.76,45930,1907,18,35300,35300,14363,23774,2893
43652,8659,10229,41112,2540,0,43652,2.22746e+18,97.8664,13569.9,43652,4961,110,36775,36775,36775,36775,36775
46771,2927,16802,44491,2280,44491,2280,2.86363e+18,95.9338,19866.1,46771,8168,110,46203,46203,46203,46203,46203
37394,1782,12258,35484,1910,35484,1910,3.03472e+18,85.6784,14930,37394,5947,110,28445,28445,15539,6808,6302
15068,785,849,0,15068,14628,440,4.23317e+16,140.235,2324.23,15068,118,26,14219,14219,14087,14081,13538
35459,1968,9661,33499,1960,0,35459,2.11751e+18,97.1921,12387.8,35459,4676,110,34866,34866,34866,34866,34866
45752,11359,14568,45752,0,43082,2670,4.44208e+18,315.709,16479,45752,5427,129,29879,29879,23662,25063,16078
13757,38,917,0,13757,13347,410,4.67743e+16,191.873,2477.92,13757,132,26,12587,12530,7322,8098,2550
44216,9029,10361,41641,2575,41641,2575,5.77158e+18,97.8785,13731.6,44216,5023,110,31352,31352,28255,26905,23259
39094,5720,9647,36854,2240,0,39094,2.19132e+18,97.6165,12667.4,39094,4676,110,39628,39628,39628,39628,39628
8956,657,2752,6267,2689,8476,480,2.18698e+18,89.0161,3677.07,8956,1278,111,6204,6204,2430,2976,0
44304,168,176,44225,79,44304,0,5.98117e+18,169.694,2491.41,44304,170,172,30394,29539,13833,19717,6326
11665,3372,3565,11035,630,11035,630,2.89417e+18,96.5552,4680.27,11665,1687,111,8100,8100,7919,8086,7819
9239,650,4501,8871,368,8871,368,2.49532e+18,86.2116,5267.41,9239,2154,104,4738,4505,33898,34084,31703
35464,73,1866,0,35464,34407,1057,4.86161e+16,310.727,5878.89,35464,320,26,36390,36168,29023,24507,5692
12908,6492,7604,12908,0,12471,437,4.16848e+18,196.334,8349.08,12908,3534,117,31387,31359,31101,31219,6133
17968,5287,9889,0,17968,3874,14094,1.36174e+13,8.90578,10145.4,17968,8892,11,27327,27327,27327,27327,27327
47983,16922,47983,47983,0,47983,0,3.4359e+10,0,47983,47983,47983,1,30362,30362,30362,30362,30362
35308,3404,10678,0,35308,0,35308,5.91625e+17,96.7217,13301.5,35308,5181,110,32520,32520,32520,32520,32520
8993,714,2650,8503,490,8503,490,2.11895e+18,96.3255,3589.63,8993,1243,107,15411,15410,15365,15411,10654
43473,8603,10138,40943,2530,40943,2530,5.86888e+18,97.8805,13474,43473,4906,110,32227,32227,30121,27993,26855
40525,6739,11760,38322,2203,38322,2203,1.51143e+18,97.5314,14661.8,40525,5597,111,28765,28765,24400,27887,16585
11709,2765,5513,4592,7117,0,11709,6.81829e+12,55.9258,6309.67,11709,2673,72,21083,21083,15920,10814,9123
10376,300,446,0,10376,10082,294,3.56399e+16,20.0512,1255.39,10376,64,26,9930,9930,9158,9226,7266
41688,3351,17136,39818,1870,39818,1870,2.7588e+18,78.9453,19756.3,41688,8310,110,22595,14718,9976,11529,6138
46950,1688,13339,44398,2552,44398,2552,6.62831e+18,97.0858,16694.6,46950,6477,110,45559,45559,45559,45559,45559
15652,2153,8528,0,15652,3381,12271,1.35975e+13,8.98039,8768.81,15652,7670,11,7124,7124,3022,3327,2735
46978,6001,19518,0,46978,18020,28958,1.92827e+15,57.1717,22057.9,46978,9498,72,37991,37991,35900,33392,33773
29236,8722,11850,27911,1325,0,29236,1.73484e+18,95.0266,13858.7,29236,5751,110,24990,24990,23466,24673,21107
28311,11,14,27499,812,28243,68,1.48259e+14,10.4024,514.605,28311,13,11,28297,28293,35434,35436,34833
23538,2,12,22855,683,23518,20,1.57635e+14,10.2373,448.197,23538,11,12,1924,417,413,640,264
29143,822,927,0,29143,28312,831,3.55652e+16,178.825,2966.19,29143,134,26,28216,28216,27915,27905,26119
6119,507,1446,0,6119,2151,3968,2.55801e+15,59.3818,2091.44,6119,699,72,4673,4673,3290,2477,1774
10079,827,2444,0,10079,0,10079,6.48805e+17,96.851,3527.07,10079,1172,110,7635,43635,40889,0,0
44860,7,13,43580,1280,44840,20,1.38981e+14,10.2255,601.561,44860,12,12,42683,41348,40467,38826,32948
36627,7152,10416,34637,1990,34637,1990,6.6232e+18,96.9889,13175.9,36627,5046,110,25532,25532,14124,16360,10338
25450,6,14,24722,728,25376,74,1.42773e+14,10.7221,489.723,25450,13,12,24151,23599,17948,18066,14484
15716,511,949,0,15716,15251,465,4.52034e+16,191.298,2635.88,15716,135,26,14767,14460,13835,13356,10398
44697,4729,10478,42097,2600,42097,2600,5.72787e+18,97.8705,13879.2,44697,5076,110,37966,37966,37221,37816,35840
2615,198,699,2465,150,2465,150,5.89596e+18,92.5082,1099.47,2615,317,64,1916,1916,1738,1642,747
13330,539,696,0,13330,0,13330,3.80287e+18,15.9773,1120.97,13330,560,18,15340,14246,8125,1223,1586
4404,138,213,0,4404,4282,122,3.62906e+16,19.6719,605.685,4404,43,26,4191,4191,3875,3919,3203
47213,2095,2177,0,47213,45815,1398,4.64338e+16,317.85,7098.18,47213,381,26,35366,35366,22750,33117,7308
1555,526,917,0,1555,0,1555,3.81959e+17,67.5807,1095.72,1555,416,42,638,594,364,19,191
15210,75,175,15204,6,15210,0,5.99269e+18,165.139,1461.28,15210,140,149,11844,6655,5883,6638,6382
25745,4765,6092,24248,1497,24248,1497,3.34888e+18,97.628,8297.34,25745,2944,110,32416,32416,20682,19523,11593
34414,3129,17363,33104,1310,33104,1310,3.69922e+18,94.052,19307.8,34414,8354,111,17051,17051,11305,11005,4842
30041,1980,9743,30041,0,28288,1753,3.4058e+18,192.69,11154.9,30041,3562,125,29824,29824,29824,29824,29824
48598,6546,48598,48598,0,0,48598,7.99984,0,48598,48598,48598,1,42762,42762,42762,42762,42762
2691,682,1301,1057,1634,0,2691,6.94259e+12,54.353,1569.03,2691,627,55,1390,1342,924,1290,351
23780,103,175,23707,73,23780,0,5.97779e+18,166.79,1824.8,23780,156,163,28487,11872,24848,22044,1377
25794,4238,6000,9069,16725,0,25794,9.89912e+12,59.9938,7951.1,25794,2918,72,20249,20249,18345,19922,16223
983,31,63,0,983,956,27,3.54057e+16,17.7314,175.148,983,24,24,920,920,719,732,560
2911,531,1177,2771,140,0,2911,1.82546e+18,75.0622,1550.37,2911,548,62,1734,1734,1049,850,0
38435,9214,24617,0,38435,0,38435,3.04108e+17,90.1912,26304.5,38435,11960,110,12289,12289,11715,11715,11713
31334,6,14,30442,892,31259,75,1.39947e+14,10.5585,533.857,31334,13,12,3580,1127,469,764,185
30960,1206,8411,0,30960,0,30960,6.17189e+17,97.1973,10862.7,30960,4079,110,25109,25109,20900,22609,19658
10246,417,5306,0,10246,0,10246,4.12844e+17,61.1726,6098.99,10246,2553,95,13889,13889,6392,5755,1972
4504,2,6,4427,77,4491,13,9.89912e+13,3.98801,132.004,4504,4,4,3406,2914,3158,2914,2711
46392,5,13,45071,1321,46370,22,1.38948e+14,10.229,613.342,46392,12,12,9219,6333,5797,6512,5204
8762,204,473,0,8762,8508,254,3.83726e+16,19.9066,1250.59,8762,67,26,8289,8289,7221,7332,4986
20599,8,12,20013,586,20589,10,1.38777e+14,10.635,406.988,20599,12,11,4724,1598,66,3455,46
26819,1576,6322,0,26819,0,26819,6.47466e+17,97.6916,8601.78,26819,3061,110,32422,32422,32422,32422,32422
44538,9,176,44517,21,44538,0,5.98033e+18,172.184,2501.42,44538,172,172,6514,1038,527,2075,25
28609,114,208,28590,19,28609,0,6.03093e+18,200.865,2196.19,28609,170,172,20908,20663,11895,18618,648
33179,1825,7787,31244,1935,0,33179,2.22853e+18,97.7872,10473.8,33179,3774,110,40623,40623,40623,40623,40623
22354,4087,7323,22354,0,21046,1308,3.83753e+18,156.585,8487.85,22354,2669,121,15031,15031,11242,12944,8795
38041,211,13972,36211,1830,36211,1830,7.67942e+18,95.7285,16555.4,38041,6785,110,27804,27468,19623,11748,9215
44745,688,2301,0,44745,43409,1336,4.91593e+16,330.503,7391.66,44745,409,26,37441,37441,28428,20031,17052
8558,492,2255,8068,490,0,8558,2.17706e+18,96.2476,3194.42,8558,1080,108,6303,6303,3431,3084,2013
17720,3984,4199,16690,1030,0,17720,2.2275e+18,97.3778,5857.38,17720,2018,110,18640,18640,16399,15635,13645
3714,311,1471,3534,180,3534,180,2.04041e+18,88.6233,1916.22,3714,681,71,2243,2156,1275,1586,942
9982,3282,4629,9565,417,0,9982,1.58682e+18,93.3044,5462.12,9982,2235,107,5353,5353,19690,19727,0
41288,13075,17349,39468,1820,0,41288,1.68839e+18,93.162,19921.8,41288,8425,110,40830,40830,40830,40830,40830
43906,12,16,42628,1278,43820,86,1.63945e+14,10.4481,701.646,43906,13,12,14907,7574,7849,10020,4225
37759,124,1089,0,37759,36682,1077,3.55431e+16,227.417,3667.84,37759,166,26,24381,11807,9142,9906,2083
18611,3063,6508,17681,930,17681,930,2.81723e+18,96.272,8014.2,18611,3108,111,12103,12103,9716,11084,6841
2259,2,10,2193,66,2259,0,1.81046e+14,8.4927,137.873,2259,10,10,1313,1033,632,677,664
5073,79,2447,5073,0,3409,1664,4.64521e+18,90.9982,2854.63,5073,1005,85,25060,24681,16353,8593,16615
33744,1989,10909,33744,0,31784,1960,3.37765e+18,232.746,12443.9,33744,4019,128,33302,33302,33302,33302,33302
34817,11,16,33780,1037,34749,68,1.84211e+14,10.4226,640.096,34817,13,12,8307,1146,1435,2008,48
32060,3379,7660,30190,1870,30190,1870,1.65685e+18,98.2291,10214.9,32060,3617,111,24400,24400,18426,21397,11979
34702,5823,15919,34702,0,33202,1500,4.65281e+18,515.987,17772.6,34702,7408,134,40444,40444,40444,40444,40444
32552,3131,8600,11624,20928,0,32552,9.49618e+12,58.7778,10873.9,32552,4183,72,23952,23952,16036,21881,8819
9114,551,2228,8584,530,0,9114,2.22109e+18,96.6751,3234.8,9114,1062,110,6886,6886,4670,4380,2248
42050,76,176,41961,89,42050,0,6.03718e+18,173.519,2518.12,42050,174,173,49077,49077,49077,49077,49077
14616,1378,4750,5369,9247,0,14616,8.71568e+12,58.38,5883.73,14616,2301,72,9866,9866,6503,9286,2541
33220,7123,8831,31368,1852,31368,1852,6.20991e+18,97.2369,11438.6,33220,4271,110,19154,18845,16053,17172,11783
33269,8054,10276,26638,6631,31509,1760,2.73613e+18,97.1677,12719.5,33269,4902,111,36214,36214,36214,36214,36214
31595,17615,17706,0,31595,0,31595,3.49664e+15,17.8885,18175.5,31595,15923,20,13889,13889,13833,13833,13860
48039,9008,17165,0,48039,17933,30106,2.118e+15,58.1019,19961.1,48039,8356,72,41513,41513,41513,41513,41513
22577,4030,12134,21777,800,0,22577,1.35512e+18,92.025,13500.5,22577,5876,110,15141,15141,11545,11148,8150
33127,1441,7980,31202,1925,31202,1925,1.79192e+18,98.1976,10595.3,33127,3762,111,47929,47929,47929,47929,47929
36870,4907,8852,34727,2143,34727,2143,3.94628e+18,98.2524,11696.8,36870,4183,111,28018,28018,20517,22113,16676
13663,2334,4491,13663,0,12883,780,6.01214e+18,118.936,5433.51,13663,1714,123,9172,9142,7619,8470,4936
43919,7288,10562,41369,2550,41369,2550,5.46664e+18,98.3039,13824.9,43919,5000,111,27342,27057,25616,26754,23068
39873,2276,9367,37553,2320,37553,2320,5.93178e+18,97.8419,12474.3,39873,4540,110,33653,33653,30202,33055,25508
17969,7393,8429,17236,733,17236,733,4.28279e+18,94.3404,9690.14,17969,4041,111,17714,17714,17714,17714,17714
45372,7264,21852,33065,12307,43572,1800,6.8811e+18,94.6471,24337.5,45372,10541,111,29582,29582,25451,20878,18888
6291,1549,1779,5941,350,5941,350,5.15875e+18,95.8372,2514.87,6291,831,93,4512,4512,4512,4512,4460
17850,4584,4668,0,17850,0,17850,6.28772e+17,97.0734,6293.18,17850,2255,110,13528,13344,10053,11359,5486
18038,217,5176,17055,983,17055,983,3.29267e+18,96.6094,6770.48,18038,2491,110,12862,12616,4961,8360,1512
41499,6250,12044,0,41499,15010,26489,2.34694e+15,59.1555,14729.5,41499,5866,72,32831,32831,25615,28950,21450
38459,12,208,38373,86,38459,0,6.04411e+18,203.445,2566.43,38459,181,180,36968,32827,19634,23893,4391
49619,1636,2183,0,49619,48155,1464,4.5466e+16,328.528,7187.38,49619,385,26,25120,25120,14818,8434,7381
1155,182,677,1155,0,0,1155,8.99719e+17,14.2589,750.449,1155,595,20,478,478,146,397,191
16970,3853,4586,16030,940,0,16970,2.12976e+18,96.7463,6139.17,16970,2201,110,12384,12384,11633,11299,10710
5917,1302,2370,5640,277,5640,277,2.81235e+18,84.3975,2992.19,5917,1125,92,3547,3547,3103,3438,2721
41906,7413,10020,39461,2445,39461,2445,3.69251e+18,98.3322,13164.1,41906,4738,111,26288,26288,22017,24952,15981
7506,2883,3665,7206,300,0,7506,1.52386e+18,84.4987,4325.03,7506,1760,96,3841,3841,3642,3492,3569
11635,404,538,0,11635,11298,337,3.6453e+16,20.0471,1465.97,11635,74,26,11097,11097,10838,10863,8877
38013,137,176,37947,66,38013,0,6.16481e+18,171.775,2405.49,38013,161,162,36680,36547,30770,31199,13143
38123,122,176,38091,32,38123,0,6.07914e+18,171.855,2411.79,38123,171,166,34436,28792,29894,26148,24627
12754,628,4593,0,12754,0,12754,5.498e+17,95.1868,5728.77,12754,2218,110,7735,7351,3602,2290,77
34721,3661,9808,12511,22210,0,34721,9.24549e+12,58.3538,12156.9,34721,4765,72,28839,28839,26178,25711,22768
25181,4686,11957,0,25181,0,25181,4.46466e+17,93.795,13586.2,25181,5797,110,27670,27670,18776,16349,9916
5760,1741,1745,5448,312,0,5760,2.0754e+18,94.7924,2422.57,5760,827,89,4015,4015,4013,4013,4015
24282,1,15,23559,723,24204,78,1.88137e+14,10.3332,499.324,24282,12,13,3956,3956,3956,3956,3956
44139,8780,10246,15514,28625,0,44139,9.88952e+12,60.0855,13265.6,44139,4980,72,35094,35094,35079,35094,35079
36566,5901,9998,0,36566,13121,23445,2.40197e+15,59.2943,12469.6,36566,4865,72,27775,27775,24927,26948,20396
6183,1336,2086,0,6183,0,6183,5.71589e+17,94.4153,2775.47,6183,989,98,4097,4097,3887,3516,29345
41966,2758,9843,39526,2440,0,41966,2.2257e+18,97.8535,13082.4,41966,4769,110,28394,28394,16492,23826,4621
16492,1531,3888,5798,10694,0,16492,9.88677e+12,59.8243,5252.01,16492,1890,72,12604,12604,9227,12016,5242
3724,458,2349,3614,110,3614,110,1.13651e+19,66.6324,2666.08,3724,1103,66,1375,1280,1153,1275,48
18447,6215,18447,18447,0,18447,0,34357900000,0,18447,18447,18447,1,0,0,0,0,0
2489,309,893,2359,130,2359,130,2.95579e+18,83.4098,1244.38,2489,396,68,1596,1596,831,1158,384
6031,10,11,5856,175,6026,5,1.49628e+14,10.5119,222.388,6031,11,11,5989,5935,5830,5829,5573
18610,6003,6910,0,18610,6993,11617,2.07943e+15,56.9682,8203.18,18610,3359,72,11700,11700,11414,11326,11114
17529,6,14,17013,516,17479,50,1.69103e+14,10.5768,433.178,17529,13,11,16684,16123,13172,12746,9309
29627,6648,11232,29627,0,28096,1531,5.18928e+18,236.385,12798,29627,3390,131,25051,25051,21323,24547,14782
21024,6,13,20398,626,21003,21,1.89216e+14,10.2218,440.876,21024,12,12,20304,19920,33674,32024,28156
14132,9,13,13733,399,14066,66,1.39064e+14,10.8193,355.116,14132,13,12,20188,18362,15508,14065,3393
1668,225,534,0,1668,0,1668,6.11836e+17,89.1043,808.636,1668,232,53,1134,1134,837,773,754
42182,7236,10907,0,42182,0,42182,6.26949e+17,97.4393,14075.7,42182,5282,110,42024,42024,42024,42024,42024
39531,6517,9238,37231,2300,37231,2300,3.23328e+18,97.8324,12329.3,39531,4467,110,31460,31460,30871,31387,28619
19052,4361,12339,0,19052,4112,14940,5.73395e+15,5.52414,14179.9,19052,4121,13,13805,13805,13319,13455,12920
5119,923,1236,1796,3323,0,5119,9.89893e+12,58.9975,1796.98,5119,598,72,10789,10789,10789,10789,10789
31807,2134,15789,30587,1220,0,31807,1.46911e+18,90.4949,17678.5,31807,7650,110,19179,17626,17289,15395,12803
9992,2000,2382,9410,582,0,9992,2.23762e+18,96.7548,3464.85,9992,1137,110,21215,21215,21215,21215,21215
43130,138,176,43049,81,43130,0,6.0457e+18,173.453,2544.83,43130,170,173,43024,43024,43024,43024,43024
13489,289,626,0,13489,13102,387,3.65977e+16,20.0767,1691.44,13489,82,26,12863,41824,0,0,0
17344,3168,4125,6112,11232,0,17344,9.89038e+12,59.8342,5540.29,17344,2009,72,29655,29655,24632,25834,14156
44318,4972,13325,44318,0,41736,2582,4.5797e+18,312.329,15514.4,44318,2661,136,40610,40610,40610,40610,40380
2426,120,612,0,2426,850,1576,2.58344e+15,57.8479,932.432,2426,297,58,0,0,1155,1028,452
24148,10953,11194,24148,0,23076,1072,5.14506e+18,240.259,12476.9,24148,2971,133,21827,21827,20204,19216,17564
31669,83,176,31595,74,31669,0,5.98126e+18,169.755,2108.8,31669,169,166,18723,6249,12490,9728,49
19601,5871,6060,18571,1030,18571,1030,6.81934e+18,94.3296,7722.57,19601,2921,110,13541,13541,13541,13541,13541
26996,3052,9597,26996,0,25536,1460,5.26689e+18,182.878,11056.3,26996,3196,132,18271,18271,13372,12395,5683
19532,2622,4605,18392,1140,18392,1140,5.75026e+18,97.5156,6392.67,19532,2222,110,19469,30544,30544,30544,30544
15742,1797,6452,15742,0,14962,780,5.18189e+18,145.113,7426.31,15742,1628,125,9290,9184,7083,7294,3011
12589,7,11,12221,368,12577,12,1.61408e+14,10.1678,326.226,12589,11,11,12184,11825,10696,11036,9014
25446,420,1076,7422,18024,0,25446,6.92464e+18,15.9878,1672.26,25446,1070,17,24370,24370,15895,14944,20451
15550,77,762,0,15550,15100,450,3.87397e+16,93.2423,2087.72,15550,99,26,34444,34340,22021,22004,7933
47461,10500,22097,18627,28834,0,47461,6.88019e+12,56.3578,24477.3,47461,10751,72,34219,34219,32662,34122,30597
13693,180,3226,12893,800,12893,800,3.36811e+18,97.1756,4594.14,13693,1538,110,10467,10467,4288,7136,1240
37506,12959,14569,37506,0,35546,1960,4.44507e+18,271.273,16169.1,37506,5883,131,17545,17545,14415,10319,9321
15010,2378,4995,15010,0,14130,880,5.91384e+18,122.154,5898.47,15010,1445,124,10015,9978,8501,9628,5167
31408,1206,15354,12459,18949,0,31408,6.59761e+12,55.9427,17004.2,31408,7469,72,30912,30912,30912,30912,30912
37953,10,1093,0,37953,36871,1082,3.55931e+16,229.487,3693.12,37953,167,26,8870,2696,1128,36,20
33423,929,7946,11778,21645,0,33423,9.85833e+12,59.9582,10330.1,33423,3870,72,36841,36841,13006,6668,3609
4583,1484,1717,4360,223,0,4583,1.8772e+18,92.9969,2250.53,4583,814,78,2866,2866,2575,2582,2471
6116,368,441,0,6116,5937,179,4.24852e+16,19.5979,1090.38,6116,63,26,5675,5675,5592,5593,5190
32583,2101,9992,32583,0,30683,1900,4.48986e+18,221.662,11722.5,32583,3885,124,28793,28793,27823,27422,24558
26308,11745,17361,25625,683,0,26308,9.9875e+17,90.8977,18580.7,26308,8433,110,25871,25871,25871,25871,25871
34934,8177,8396,32902,2032,32902,2032,5.33684e+18,98.233,11123.7,34934,3957,111,22987,22987,22147,22016,19048
32892,4,15,31944,948,32804,88,1.5484e+14,10.6669,595.568,32892,13,12,2642,867,63,652,30
14873,73,176,14799,74,14873,0,6.10041e+18,168.27,1509.2,14873,135,138,11853,8110,5887,6393,6093
3835,935,1349,3835,0,3612,223,4.03627e+18,89.8383,1743.13,3835,473,82,2486,2486,2115,2273,2016
26302,3643,13664,0,26302,0,26302,3.45148e+15,17.9801,14118,26302,12287,20,27271,27271,27271,27271,27271
5302,560,670,0,5302,5139,163,5.63468e+16,18.8955,1474.99,5302,85,26,4632,4632,4524,4520,4052
27937,10442,12410,26756,1181,26756,1181,2.72513e+18,94.3305,14253.5,27937,6011,110,13172,13172,12587,13048,11091
28727,11479,28727,0,28727,0,28727,524270,0,28727,28727,28727,1,14258,14258,12106,14258,12119
12782,6,11,12401,381,12770,12,1.86542e+14,10.1889,335.205,12782,11,11,34292,33306,27154,26046,19616
35577,1249,1399,0,35577,34545,1032,4.10731e+16,268.333,4514.91,35577,229,26,34178,34178,33882,33861,32206
6853,11,12,6653,200,6845,8,1.64909e+14,10.28,242.832,6853,11,11,6841,6841,6841,6841,6836
7601,3642,4873,7388,213,0,7601,1.0805e+18,86.729,5387.31,7601,2352,83,2728,2728,2233,2034,2125
18148,1515,4245,0,18148,6382,11766,2.53961e+15,59.9289,5719.84,18148,2067,72,14368,14368,11998,13629,10379
14085,658,3335,0,14085,4955,9130,2.52623e+15,59.7458,4541.02,14085,1619,72,32847,32441,25496,23128,6471
27236,6397,15270,5855,21381,0,27236,53373200000,8.94544,15582.1,27236,13735,11,19592,0,0,11618,21326
12756,1471,3030,4486,8270,0,12756,9.88624e+12,59.7068,4145.03,12756,1474,72,9726,9726,7904,9330,5032
35659,3678,10835,35659,0,33579,2080,4.98588e+18,251.103,12688.5,35659,2897,133,38187,38187,38187,38187,38187
8004,261,1873,2809,5195,0,8004,9.97324e+12,59.6061,2662.32,8004,912,72,6131,6131,3752,5721,998
22406,6472,6982,22406,0,21106,1300,4.89536e+18,160.223,8307.82,22406,1424,127,15424,15424,15424,15424,14683
3317,576,942,3127,190,3127,190,5.60968e+18,94.0431,1404.98,3317,421,75,2375,2375,1808,1978,1642
44850,8999,13989,0,44850,16395,28455,2.2718e+15,58.607,16780.9,44850,6811,72,33210,33210,32123,33146,31257
24307,3508,7222,22997,1310,22997,1310,3.23201e+18,96.0606,9171.05,24307,3433,111,17085,17085,13905,16624,9493
5044,59,176,5044,0,5044,0,6.03741e+18,154.632,868.081,5044,98,99,3495,1979,1530,1718,1767
1759,3,10,1707,52,1759,0,1.38097e+14,9.71859,115.85,1759,10,10,1329,935,1073,1142,715
31446,67,984,0,31446,30463,983,0.0312599,0.968708,5561.55,31446,984,1,30294,30294,21442,14911,26344
21515,7,12,20901,614,21501,14,1.38742e+14,10.5188,415.807,21515,12,11,2821,430,7,326,30
32332,1677,12684,0,32332,12278,20054,2.00384e+15,56.8829,14624.3,32332,6164,72,31894,31894,31894,31894,31894
41990,865,9856,39550,2440,0,41990,2.22463e+18,97.838,13095.4,41990,4777,110,41808,41808,41808,41808,41808
22553,12360,12450,22553,0,22553,0,9.98973e+16,17.8043,12850,22553,11193,20,21346,21346,12500,12192,12239
35562,3025,8338,0,35562,12514,23048,2.53091e+15,60.0319,10857.8,35562,4061,72,35065,35065,35065,35065,35065
25639,7542,9621,24419,1220,0,25639,1.82189e+18,94.4743,11510.5,25639,4661,110,16018,16018,14404,14081,12841
11448,55,491,0,11448,11120,328,3.56386e+16,20.1323,1375.25,11448,69,26,15700,3926,7268,5355,273
42114,8,176,41999,115,42114,0,6.21722e+18,172.184,2495.3,42114,160,161,12554,9722,9540,9319,9234
33377,708,19399,26207,7170,32299,1078,4.21952e+18,93.057,21071,33377,9382,117,26281,25751,15951,13821,3857
831,445,816,824,7,0,831,2.62814e+17,1.0361,822.213,831,376,31,15,15,15,15,15
13537,280,717,0,13537,13145,392,3.89804e+16,53.5507,1899.28,13537,88,26,12820,12785,11633,11363,5713
44948,1231,10478,0,44948,0,44948,6.48009e+17,97.878,13899.7,44948,5076,110,44626,44626,44626,44626,44626
37547,10721,16709,0,37547,0,37547,4.69405e+17,94.4465,19016.3,37547,8113,110,28967,28323,28323,28323,28323
19077,1606,6284,18100,977,0,19077,1.95892e+18,95.9742,7874.82,19077,3041,110,29698,29698,27199,27040,6359
5890,7,11,5723,167,5885,5,1.38253e+14,9.9034,211.651,5890,11,11,5705,5626,5080,5114,4340
12380,501,531,0,12380,12025,355,3.56214e+16,20.041,1473.74,12380,72,26,11849,11849,11792,11795,11550
31031,31,176,30951,80,31031,0,5.98378e+18,169.607,2087.49,31031,162,166,13494,1620,318,772,35
23664,1885,5694,22284,1380,22284,1380,3.36717e+18,98.0721,7714.9,23664,2684,111,17970,17970,12155,14566,14051
7407,101,208,7400,7,7407,0,6.07156e+18,186.331,1138.28,7407,111,113,28539,28516,28524,24470,25830
22860,4220,6295,21590,1270,21590,1270,2.36515e+18,97.0159,8199.05,22860,2964,111,31387,31387,31387,31387,31387
20022,6237,9919,0,20022,7960,12062,1.67218e+15,54.9406,11072.3,20022,4815,72,10103,10103,8462,6407,6701
45257,12331,45257,0,45257,45257,0,2047.95,0,45257,45257,45257,1,0,0,0,0,0
27942,6152,6596,26320,1622,0,27942,2.22536e+18,97.6468,8947.26,27942,3190,110,19816,19816,15394,17014,13754
37850,3095,8192,37850,0,37850,0,4.68797e+15,6418.98,17583.7,37850,8192,6,12376,12756,8706,12066,3992
48902,9497,11386,17188,31714,0,48902,9.89855e+12,60.0831,14664.6,48902,5546,72,48654,48654,48654,48654,48654
24604,10109,12230,24604,0,23557,1047,4.79054e+18,250.786,13387.7,24604,5365,128,19574,19574,19574,19574,19574
40983,8257,15794,15501,25482,0,40983,7.92954e+12,57.6384,18160.2,40983,7690,72,32834,32834,32834,32834,32834
45363,13660,15327,43063,2300,43063,2300,2.36177e+18,96.8599,18332.9,45363,7341,111,29721,29721,28616,28226,27343
4663,5,208,0,4663,4532,131,3.52793e+16,19.7401,605.34,4663,44,26,3575,2918,1978,1846,742
43013,3915,13209,0,43013,15690,27323,2.28462e+15,58.8897,15925.4,43013,6426,72,37939,37939,36390,35206,34755
8970,4572,5062,0,8970,3666,5304,1.46229e+15,54.3253,5625.93,8970,2460,72,3908,3908,3857,3817,3889
6341,44,2163,6341,0,5971,370,3.31539e+18,91.3533,2700.42,6341,762,102,5122,1084,3319,750,570
14931,843,3532,5249,9682,0,14931,9.87766e+12,59.7888,4794.65,14931,1711,72,12237,12237,9480,8034,7327
36581,11583,12419,36581,0,34511,2070,5.13487e+18,253.482,14029.7,36581,3949,133,29512,29512,29512,29512,29512
34667,4750,13176,33017,1650,33017,1650,4.6168e+18,94.4862,15492.4,34667,6316,111,39122,39122,39122,39122,39122
37709,6,12,36634,1075,37699,10,1.3883e+14,10.2204,548.391,37709,11,12,35830,34778,24993,25386,22948
41419,1,6,40124,1295,41259,160,0.000120718,0.999855,493.575,41419,6,1,15109,15109,15109,15109,15109
47087,117,1897,0,47087,45708,1379,4.31532e+16,314.849,6283.1,47087,325,26,39075,26939,46374,0,0
15951,551,716,0,15951,15492,459,3.6659e+16,44.1557,1960.89,15951,92,26,1622,544,727,1598,1184
38879,1286,1657,0,38879,37740,1139,4.34952e+16,293.742,5357.87,38879,280,26,22474,22469,8910,16593,7650
40784,880,15734,38864,1920,38864,1920,7.38314e+18,96.0624,18343.1,40784,7553,111,32102,32102,11947,25857,3384
6991,646,1657,0,6991,2454,4537,2.52935e+15,59.3424,2366.46,6991,802,72,5334,5334,3847,2273,2199
12721,174,176,12682,39,12721,0,6.05934e+18,168.538,1386.18,12721,132,133,16958,16372,6485,12075,1305
23831,5668,8489,22661,1170,22661,1170,3.04998e+18,95.6719,10311.7,23831,4105,110,10931,10018,7297,7355,4043
39338,105,176,39321,17,39338,0,5.98357e+18,172.337,2351.57,39338,171,170,34885,14869,13894,23225,747
8246,3328,3764,0,8246,3224,5022,1.81044e+15,50.1911,4390.47,8246,1826,72,4482,4482,4471,4449,4478
29824,467,7023,0,29824,0,29824,6.4693e+17,97.684,9496.52,29824,3398,110,41517,41517,32584,22355,27861
21677,6977,8687,8253,13424,0,21677,7.7569e+12,57.1625,10085.1,21677,4215,72,12990,12990,11594,12750,10076
14343,2680,4854,13620,723,13620,723,3.12565e+18,95.5474,6127.19,14343,2336,110,12217,12217,9661,10545,6273
46828,2696,18800,44698,2130,44698,2130,8.35659e+18,94.902,21709.6,46828,9135,110,46377,46377,46377,46377,46377
46076,111,176,45978,98,46076,0,6.07999e+18,172.717,2654.35,46076,171,172,35004,24713,26322,29268,20999
18230,98,175,18224,6,18230,0,5.97072e+18,165.836,1598.57,18230,148,155,31629,28960,8445,24505,800
13051,4631,5675,0,13051,5038,8013,1.86581e+15,55.7993,6583.36,13051,2742,72,7376,7376,7193,6920,7053
41547,5983,9698,0,41547,0,41547,6.48354e+17,97.8574,12910.2,41547,4702,110,31849,31849,26816,20848,28349
5195,1139,1787,5195,0,4888,307,5.81933e+18,91.148,2263.88,5195,626,94,19163,19103,10336,15631,1795
3133,1343,1745,3023,110,3023,110,2.44216e+18,75.9547,2063.71,3133,820,57,1388,1388,1388,1388,1388
37762,361,9529,35595,2167,35595,2167,2.3005e+18,98.0971,12387.4,37762,4510,111,28233,28146,8339,15148,4119
27066,883,12910,25976,1090,25976,1090,8.36117e+18,94.5319,14598.2,27066,6217,111,38708,38708,38708,38708,38708
18988,2934,4974,0,18988,6758,12230,2.43879e+15,59.4277,6457.95,18988,2412,72,14014,14014,11534,8266,7481
31541,7253,10220,31541,0,29703,1838,3.32435e+18,208.755,11681.1,31541,3757,125,21321,21287,18382,19331,15629
5170,1590,1798,0,5170,0,5170,5.59845e+17,93.6861,2400.17,5170,842,83,3372,37574,0,0,0
37968,6330,10061,13565,24403,0,37968,9.48356e+12,59.414,12634.9,37968,4896,72,22003,22003,16207,11329,9936
44571,152,176,44487,84,44571,0,5.98357e+18,172.046,2502.18,44571,171,171,33268,32540,11625,8997,4518
49728,11535,11615,46831,2897,0,49728,2.22863e+18,97.9319,15325.5,49728,5637,110,40271,40271,40271,40271,40271
795,154,395,795,0,755,40,3.34008e+18,68.727,515.206,795,144,38,400,384,220,263,109
37411,4535,11391,37411,0,35234,2177,4.99776e+18,267.826,13315.4,37411,4461,128,38282,38282,38282,38282,38282
38013,5692,13492,14173,23840,0,38013,8.31084e+12,58.1053,15808,38013,6567,72,30271,30271,29324,29400,18577
2680,829,1180,2001,679,2540,140,3.53286e+18,79.7246,1468.19,2680,441,68,1500,1500,1452,1476,1471
44719,7734,11078,0,44719,15832,28887,2.47943e+15,59.8331,14078.8,44719,5386,72,38006,38006,38006,38006,38006
34466,196,8090,32464,2002,32464,2002,5.76274e+18,97.7453,10861.7,34466,3910,110,44388,44083,38075,41956,41723
36435,6815,12545,34620,1815,0,36435,1.91036e+18,96.0427,15109.5,36435,6088,110,23890,23890,19796,17732,13035
23123,1111,5441,0,23123,0,23123,6.47872e+17,97.547,7474.08,23123,2623,110,17682,17682,11814,5973,4654
40154,294,1135,0,40154,39007,1147,3.55981e+16,237.733,3869.84,40154,176,26,20203,20148,1130,20196,316
38342,4069,11276,13881,24461,0,38342,9.09589e+12,59.0781,13785.2,38342,5489,72,35222,35222,25136,22631,14828
8932,5,11,8676,256,8925,7,1.39288e+14,10.4969,266,8932,11,11,8187,7290,6988,6850,4673
36474,800,11795,34584,1890,34584,1890,2.60678e+18,96.9955,14376.3,36474,5635,111,32462,31950,19754,6293,4208
24949,1018,1442,0,24949,24202,747,4.89087e+16,282.313,4340.49,24949,237,26,23507,23507,22719,22769,19911
31584,21,176,31533,51,31584,0,6.06326e+18,172.758,2190.59,31584,162,166,13103,2659,3734,3933,3715
27506,9900,10545,0,27506,10399,17107,2.03919e+15,56.5936,12271,27506,5131,72,26211,26182,26182,26182,26182
36108,7845,8452,34001,2107,0,36108,2.22925e+18,97.8155,11324.6,36108,4098,110,34627,34627,34627,34627,34627
12353,10,11,12000,353,12345,8,1.43028e+14,10.3636,314.118,12353,11,11,4401,1367,595,2642,50
1021,217,337,962,59,962,59,3.37146e+18,83.713,523.931,1021,133,46,684,684,504,581,555
32911,183,208,32821,90,32911,0,6.10207e+18,200.396,2422.95,32911,173,169,20511,20511,11962,3672,1023
34185,5658,15902,32790,1395,0,34185,1.56157e+18,94.1198,17984.7,34185,7726,110,35350,35350,28418,27085,19421
15468,1575,9714,15028,440,15028,440,1.15032e+19,91.014,10598.2,15468,4702,101,5754,5668,4818,4662,1392
47010,6687,19043,44870,2140,44870,2140,4.01684e+18,95.8149,21885.5,47010,9146,111,36004,35923,31611,32975,28048
39458,2851,17499,37788,1670,37788,1670,8.80846e+18,94.4899,19901.8,39458,8494,110,27719,27719,22149,18765,12718
9700,55,175,9633,67,9700,0,5.98194e+18,162.012,1168.28,9700,127,128,6422,3282,2664,3177,3024
29057,13568,14269,0,29057,6373,22684,1.33747e+13,8.9905,14623.1,29057,12837,11,45440,45440,45440,45440,45440
37020,1575,22114,35877,1143,35877,1143,4.32612e+18,90.5012,23870.5,37020,10688,111,14906,14906,8518,7583,2394
10020,3453,4694,9610,410,9610,410,2.58383e+18,78.1239,5531.59,10020,2245,108,5326,5326,4918,5205,4373
6551,1347,1676,5415,1136,6171,380,4.79385e+18,95.5025,2452.19,6551,779,95,4875,4875,4434,4551,4429
8651,1610,3103,8224,427,0,8651,1.89213e+18,94.6413,3961.53,8651,1483,102,5548,5548,4392,3807,2784
25979,717,6057,0,25979,9126,16853,2.52735e+15,59.963,8018.41,25979,2935,72,20848,20762,12388,8128,2371
43542,839,1740,0,43542,42269,1273,4.25905e+16,262.765,5717.97,43542,294,26,25702,24115,11912,16011,2528
22505,149,176,22420,85,22505,0,6.14445e+18,168.54,1855.46,22505,147,150,29207,29191,15231,18537,15523
11961,1729,2912,11268,693,11268,693,3.23654e+18,96.9443,4141.54,11961,1399,110,9049,9049,7863,8697,5890
24046,875,5830,22646,1400,22646,1400,3.88559e+18,98.0905,7872.65,24046,2753,111,0,0,0,0,0
45330,10380,10634,42698,2632,42698,2632,5.90472e+18,97.7326,14075.6,45330,5145,110,27696,27696,23560,27042,16002
38882,15631,18583,37339,1543,37339,1543,2.57188e+18,92.7124,20844.6,38882,9019,110,37984,37984,37984,37984,37984
37089,375,12649,0,37089,13734,23355,2.17566e+15,57.4704,14958.9,37089,6143,72,31645,31501,11672,5542,1663
30848,914,10015,30848,0,29051,1797,3.32868e+18,201.717,11452.8,30848,3677,125,20498,20498,10417,4080,3842
1616,245,429,0,1616,561,1055,2.5559e+15,56.4158,666.586,1616,205,51,1187,1187,967,940,766
24954,131,176,24902,52,24954,0,6.07617e+18,172.331,1951.03,24954,156,159,18320,10158,6996,955,1576
36888,1576,17528,36888,0,35610,1278,4.89767e+18,2644.85,20577.7,36888,5079,142,31681,31681,26096,28216,21353
19990,556,1209,4085,15905,0,19990,5.74893e+13,11.9896,1664.75,19990,826,14,16033,16028,1316,675,547
43105,604,2511,0,43105,8827,34278,1.47452e+16,11.9952,3186.56,43105,1773,14,42882,42882,42882,42882,42882
41551,775,9725,14603,26948,0,41551,9.87173e+12,60.0382,12590.2,41551,4730,72,26285,25789,12921,23972,3876
43520,11427,12850,41171,2349,41171,2349,4.344e+18,97.309,15901.4,43520,6121,111,26390,26390,22446,25600,16044
22107,7116,12029,21337,770,0,22107,1.33484e+18,87.9573,13363.9,22107,5819,110,10078,10078,8743,7981,6832
28940,12289,16515,28940,0,28940,0,2.99077e+18,17.8877,16954.3,28940,14847,20,12425,12425,9268,9207,9251
44564,33,176,44479,85,44564,0,6.00633e+18,172.639,2549.12,44564,172,173,10917,1162,451,3926,124
47020,13703,16096,44670,2350,44670,2350,7.50631e+18,95.7895,19239.2,47020,7806,110,45740,45740,45740,45740,45740
24141,7161,7710,16768,7373,22881,1260,5.24316e+18,96.8684,9600.25,24141,3674,111,30937,30937,27097,30087,20118
43810,43,176,43788,22,43810,0,5.9803e+18,169.718,2477.46,43810,170,171,13758,3836,9103,12309,1289
8525,152,425,0,8525,8281,244,3.72417e+16,19.8941,1152.02,8525,63,26,8100,8100,7348,7278,3627
35179,11,15,34141,1038,35086,93,1.77771e+14,10.4201,630.621,35179,13,13,17945,15140,14627,15514,14602
27909,712,969,0,27909,27109,800,3.68486e+16,195.235,3054.22,27909,143,26,45017,45017,45017,45017,45017
22756,1500,5351,21429,1327,21429,1327,3.36831e+18,97.5788,7360.36,22756,2583,110,17405,17405,9649,13173,5878
22489,7211,12684,9209,13280,0,22489,5.66424e+12,54.7244,13808.9,22489,6177,72,9805,9805,8326,9495,6013
18000,2534,7649,0,18000,0,18000,4.88542e+17,73.0848,9010.22,18000,3694,110,33371,33371,33371,33371,33371
24974,5094,6012,23524,1450,23524,1450,5.35676e+18,98.0352,8119.11,24974,2834,111,18962,18962,17261,17630,16685
16693,3360,3963,15723,970,15723,970,3.21561e+18,97.3358,5551.15,16693,1906,110,12730,12730,12148,12550,11266
905,232,308,855,50,855,50,5.85053e+18,81.3182,479.119,905,122,42,597,597,549,553,554
21667,2599,5572,7710,13957,0,21667,9.58979e+12,59.5597,7228.01,21667,2706,72,16095,16095,13081,15396,8906
12649,9,13,12285,364,12609,40,1.49138e+14,10.9203,351.652,12649,12,11,8064,2851,511,4326,120
21015,869,1015,21015,0,20146,869,3.14385e+18,17.5823,1579.67,21015,886,29,20000,20000,20000,19874,17776
29103,2517,10044,27653,1450,27653,1450,2.97526e+18,95.9566,12199.4,29103,4866,110,19059,19059,14281,14845,6525
28579,13454,14955,28579,0,27519,1060,5.0449e+18,589.306,16565.6,28579,5449,135,26436,26436,26436,26436,26436
25085,2689,5877,23625,1460,23625,1460,5.87144e+18,97.6724,8046.04,25085,2835,110,38515,38515,38515,38515,38515
20608,1445,4922,0,20608,0,20608,6.45022e+17,97.4564,6778.45,20608,2374,110,15686,15686,10989,4808,5354
49749,18136,19748,49749,0,47259,2490,4.56647e+18,865.667,21938.2,49749,5737,142,29344,29344,27473,28305,27316
10980,1690,5224,10980,0,10492,488,5.87923e+18,124.706,5944.1,10980,1452,117,5756,5694,4525,4689,2728
27307,4553,6383,25711,1596,25711,1596,5.73544e+18,97.7193,8693.16,27307,3085,110,20838,20838,13858,12987,7266
25073,5723,8240,25073,0,23613,1460,3.42831e+18,166.194,9491.64,25073,3008,122,16833,16833,14089,15054,12241
11830,2584,3427,11183,647,0,11830,2.08632e+18,96.2046,4588.37,11830,1649,110,32416,32416,31459,31116,0
46152,108,176,46077,75,46152,0,6.12129e+18,170.415,2660.2,46152,166,171,34571,34486,25672,34563,25727
32118,9016,12897,12246,19872,0,32118,7.73838e+12,57.3447,14798.4,32118,6283,72,26412,26412,26412,26412,26412
41496,3906,41496,41496,0,41496,0,34358900000,0,41496,41496,41496,1,40783,40783,40783,40783,40783
46866,545,1637,0,46866,45510,1356,4.01232e+16,297.058,5519.91,46866,275,26,47891,47891,47891,47891,47891
9241,608,2219,0,9241,3260,5981,2.52509e+15,59.5731,3092.24,9241,1077,72,7022,7022,4639,4672,1876
35298,1015,11462,33488,1810,33488,1810,3.10747e+18,86.0863,14024.7,35298,5551,110,23836,23836,11171,16903,4718
7529,1306,2600,7149,380,0,7529,1.93446e+18,94.6249,3389,7529,1242,100,4929,4929,3872,3314,2452
18517,3128,8862,7316,11201,0,18517,6.75705e+12,40.6336,9974.42,18517,4311,72,9655,9655,2850,1314,0
8906,6,10,8649,257,8901,5,1.46016e+14,9.92735,264.748,8906,10,10,8500,8250,6482,6331,5766
4646,221,2054,0,4646,1798,2848,1.87177e+15,44.1218,2476.34,4646,978,65,2592,2592,675,360,0
49978,9301,11675,0,49978,0,49978,6.48111e+17,97.9209,15398.8,49978,5663,110,35010,34915,31199,33550,24492
34906,8062,8177,32876,2030,0,34906,2.22732e+18,97.8045,10978.9,34906,3956,110,28550,28550,28550,28550,28550
20842,124,774,0,20842,20247,595,3.55379e+16,95.3657,2276.36,20842,103,26,20068,19973,16741,16970,6852
31162,5,12,30272,890,31152,10,1.38579e+14,10.2078,496.524,31162,11,12,9490,7935,7536,7890,7290
20426,91,208,20380,46,20426,0,6.04211e+18,200.521,1878.66,20426,156,158,36106,32019,9211,27965,518
24718,4675,8529,0,24718,9173,15545,2.1695e+15,58.173,10187.7,24718,4150,72,16189,16189,13732,11485,9726
2859,1,10,2775,84,2859,0,1.57031e+14,9.37915,152.315,2859,10,10,628,628,628,628,628
31062,11,15,30149,913,31007,55,1.6949e+14,10.593,594.025,31062,13,11,31047,31045,28673,28718,27218
44627,264,1251,0,44627,43353,1274,3.59941e+16,253.781,4327.3,44627,199,26,28101,27333,19152,24637,13054
28651,4,15,27804,847,28594,57,1.77534e+14,9.25887,545.876,28651,11,12,25454,19706,18316,15376,5146
36132,13,15,35075,1057,36073,59,1.67653e+14,10.3324,610.474,36132,13,12,18877,12665,13095,13064,13048
13768,2907,3295,12968,800,12968,800,3.21303e+18,97.1463,4666.35,13768,1579,110,31965,31965,31965,31965,31965
32903,200,1473,0,32903,31940,963,4.36927e+16,274.821,4660.8,32903,241,26,15774,14102,8288,8574,1642
4910,1,13,4767,143,4850,60,1.38273e+14,10.8721,207.024,4910,12,12,1263,1263,1263,1263,1263
14990,20,175,14924,66,14990,0,5.98292e+18,165.133,1450.37,14990,139,148,5892,1014,1480,1764,1719
34580,6771,10137,32710,1870,32710,1870,5.51739e+18,97.2861,12697.9,34580,4807,111,19823,19823,13669,14276,13509
32741,7310,14509,0,32741,0,32741,4.72564e+17,94.4611,16590.2,32741,7049,110,24657,24657,21900,19418,17534
17806,3378,6977,6761,11045,0,17806,7.86953e+12,55.2415,8192.67,17806,3393,72,10829,10829,8765,10366,5556
28678,1938,6773,0,28678,0,28678,6.45622e+17,97.6309,9170.53,28678,3268,110,35821,35821,35821,35821,35821
34318,96,8013,12066,22252,0,34318,9.882e+12,60.0266,10463.9,34318,3898,72,30638,20754,19116,20486,20627
3393,37,203,3206,187,1026,2367,1.3114e+18,16.9089,414.985,3393,151,19,3190,3190,2309,2056,1391
49565,3,15,48145,1420,49478,87,1.45653e+14,10.529,722.141,49565,14,12,33369,24989,24553,25332,13845
37313,365,2191,7648,29665,0,37313,5.76022e+13,12.0035,2825.64,37313,1193,20,32508,32508,21910,25136,19350
45052,2754,10558,42430,2622,42430,2622,5.76155e+18,97.8722,13981.1,45052,5115,110,33904,33904,22434,16758,7987
4533,936,2032,0,4533,0,4533,4.86978e+17,80.8608,2515.87,4533,965,82,2501,2501,1789,1368,1292
26820,4280,12878,0,26820,10595,16225,1.7185e+15,54.7065,14359,26820,6268,72,32618,43356,0,1396,1396
46305,144,208,46241,64,46305,0,6.05388e+18,202.937,2823.27,46305,185,185,38522,38454,19756,19129,14133
42287,10,13,41083,1204,42272,15,1.39017e+14,10.2629,585.285,42287,12,12,18426,15096,15072,14854,14464
48876,19644,21757,0,48876,0,48876,4.69154e+17,93.9106,24592.3,48876,10558,110,47221,47221,47221,47221,47221
43350,5218,11695,40940,2410,0,43350,2.12578e+18,97.3,14891.1,43350,5678,110,31347,31149,20160,24518,12441
17294,7544,7904,16577,717,16577,717,2.73726e+18,93.8177,9165.63,17294,3825,110,9390,9390,8952,9081,9157
44481,4,16,43184,1297,44387,94,1.63901e+14,10.5141,690.44,44481,14,13,5479,1281,608,809,874
11099,314,4998,11099,0,10569,530,4.72687e+18,129.641,5687.72,11099,1752,119,6101,5765,2674,4067,933
6582,267,297,0,6582,6394,188,3.5777e+16,19.869,843.603,6582,52,26,6285,6285,6251,6249,6118
14347,3884,6004,0,14347,5500,8847,1.92951e+15,56.6872,6998.89,14347,2907,72,8343,8343,7625,7534,6932
4474,1,11,4343,131,4473,1,1.70244e+14,10.0744,195.091,4474,11,11,880,880,880,880,880
10840,2322,2601,0,10840,3813,7027,2.51373e+15,59.5337,3584.88,10840,1257,72,8239,8239,7868,7479,7569
38809,5854,14267,0,38809,14563,24246,2.09136e+15,57.9229,16581.2,38809,6949,72,23180,23180,13941,16181,11086
12561,327,779,0,12561,12194,367,4.27206e+16,108.018,2040.52,12561,103,26,11782,11677,10860,10259,6882
46114,8255,10798,0,46114,0,46114,6.46909e+17,97.888,14290.7,46114,5229,110,36987,36987,35776,34607,34464
3993,1118,2463,3873,120,3873,120,1.11652e+19,88.553,2804.54,3993,1174,66,1530,1530,1420,1423,575
20129,44,208,20077,52,20129,0,6.15876e+18,195.396,1891.35,20129,146,150,12851,4886,4456,4892,4148
25788,7131,11358,0,25788,10013,15775,1.85467e+15,56.6217,12876.8,25788,5527,72,48990,48990,48990,48990,48990
2583,2,10,2508,75,2583,0,1.42209e+14,9.67906,141.137,2583,10,10,1505,1082,1009,1082,881
19300,6152,8102,18440,860,18440,860,8.44055e+18,94.5939,9538.99,19300,3924,110,11198,11198,10612,10514,8617
46353,6381,15255,43993,2360,43993,2360,3.03464e+18,96.3548,18411.9,46353,7399,110,33140,32970,27032,30126,19197
43964,1,14,42709,1255,43884,80,1.39003e+14,10.6026,654.982,43964,13,12,19632,19632,19632,19632,19632
1729,22,170,1729,0,1729,0,6.016e+18,125.598,489.492,1729,68,61,705,133,185,211,235
43967,1464,1664,0,43967,42687,1280,4.14577e+16,299.989,5520.68,43967,282,26,29368,29368,17655,13183,12121
48139,73,176,48116,23,48139,0,6.01466e+18,173.916,2666.93,48139,173,174,44045,40093,38220,43037,30548
11571,3643,3996,0,11571,4283,7288,2.17944e+15,57.9551,4919.47,11571,1940,72,11646,11646,11646,11646,11646
7140,78,170,7137,3,7140,0,6.00084e+18,158.893,995.444,7140,112,116,5662,3219,2933,3247,8402
11407,2320,2688,10737,670,0,11407,2.243e+18,97.0636,3883.19,11407,1291,110,10454,10454,9548,8443,7923
7024,122,170,7023,1,7024,0,5.98415e+18,158.24,986.774,7024,111,115,10061,10022,9954,10264,10264
10723,145,208,10657,66,10723,0,6.0484e+18,186.702,1361.25,10723,130,128,19598,19516,5700,15293,636
41360,9377,14709,0,41360,0,41360,5.45434e+17,95.9317,17502.8,41360,7141,110,43674,43674,43674,43674,43674
2153,17,56,0,2153,1979,174,2.89838e+16,9.79285,190.848,2153,53,11,2097,2095,1986,1751,1942
19565,1,12,18995,570,19554,11,1.66439e+14,10.483,416.685,19565,12,11,3995,3995,3995,3995,3995
32941,7145,11826,12311,20630,0,32941,8.24999e+12,57.9991,13880.5,32941,5747,72,21115,21115,17076,20424,12291
20450,3384,5350,7283,13167,0,20450,9.55112e+12,59.4919,6922.59,20450,2605,72,16907,16907,16873,16875,16579
12880,2914,3798,12188,692,0,12880,2.06444e+18,96.1017,5031.04,12880,1822,110,10122,10122,8333,8054,0
32248,6721,7580,0,32248,0,32248,6.47203e+17,97.7157,10210,32248,3666,110,28054,28054,28054,28054,28054
11214,2140,4316,10684,530,10684,530,6.14365e+18,95.1648,5312.86,11214,2056,111,11930,11930,11930,11930,11930
48502,6540,19201,46272,2230,0,48502,1.75859e+18,94.5638,22210.4,48502,9318,110,41661,41661,41661,41661,41661
12081,1158,4449,12081,0,11431,650,3.83547e+18,119.062,5293.53,12081,1633,123,7632,7598,4903,5787,2693
31548,14603,15228,0,31548,12480,19068,1.70904e+15,54.1166,16904.4,31548,7396,72,20624,20624,20624,20624,20624
33755,148,176,33738,17,33755,0,6.02214e+18,172.22,2241.62,33755,165,168,27373,27189,12732,13142,8917
8668,819,2075,0,8668,0,8668,6.50644e+17,96.6284,3048.91,8668,987,108,6593,7406,0,0,0
47210,8589,47210,47210,0,0,47210,134215000,0,47210,47210,47210,1,22462,22462,22342,22054,20020
21206,4290,5663,0,21206,0,21206,6.2115e+17,96.9904,7507.07,21206,2727,110,26591,26591,24330,24744,14622
21774,601,7123,21774,0,20504,1270,4.25495e+18,156.115,8269.68,21774,1806,127,14651,14534,7550,10069,1643
10014,3155,3253,10014,0,9434,580,3.67857e+18,94.0634,4025.4,10014,1217,118,32192,32497,0,0,0
39924,3896,18460,38294,1630,0,39924,1.56607e+18,93.365,20822.4,39924,8952,110,32850,32850,29842,26565,26268
20457,3859,4785,0,20457,7190,13267,2.53988e+15,59.9272,6401.26,20457,2331,72,19456,19456,12009,10310,3621
41625,875,1849,0,41625,40400,1225,4.48324e+16,314.996,5990.32,41625,317,26,0,0,0,3114,2170
14416,3173,4079,0,14416,0,14416,6.09996e+17,96.4867,5435.5,14416,1959,110,10337,10337,9947,9916,9591
35752,6261,8580,33672,2080,33672,2080,2.83329e+18,98.2729,11359.3,35752,4064,111,31811,31811,31811,31811,31811
4853,1,10,4715,138,4847,6,1.38099e+14,9.93489,192.557,4853,10,10,1244,1244,1244,1244,1244
16655,4,11,16178,477,16651,4,1.38971e+14,10.2267,361.145,16655,11,11,13828,10650,7819,6709,2842
20378,164,4784,7158,13220,0,20378,9.84941e+12,59.8474,6397.85,20378,2317,72,16390,14539,6949,10355,814
42223,9442,10100,39763,2460,39763,2460,5.5165e+18,98.3281,13263.7,42223,4773,111,33445,33445,33445,33445,30454
24034,6,14,23336,698,23983,51,1.60507e+14,10.6243,501.822,24034,12,11,22880,22161,20372,17551,11609
38997,11007,17775,38997,0,37227,1770,4.57512e+18,464.443,19486,38997,7533,140,38738,38738,38738,38738,38738
4794,946,1187,0,4794,0,4794,6.50129e+17,95.2897,1818.51,4794,553,85,4542,15299,9316,11236,3997
41727,2058,12412,39487,2240,39487,2240,3.96979e+18,97.4031,15359.7,41727,5912,111,36552,36552,32883,35176,28387
18079,5128,5270,17091,988,17091,988,3.70117e+18,94.0384,6838.53,18079,2481,111,23112,23112,23112,23112,23112
20142,1171,6485,0,20142,0,20142,5.74747e+17,94.513,8159.1,20142,3118,110,13657,13657,8902,3972,3591
25916,520,1052,0,25916,25166,750,3.95155e+16,208.579,3241.17,25916,159,26,25870,25870,25870,25870,25870
18392,200,4351,17322,1070,17322,1070,5.76019e+18,97.4402,6058.55,18392,2098,110,17083,17083,12808,11566,6987
23444,4870,5958,22114,1330,0,23444,2.17402e+18,97.2795,7977.11,23444,2872,110,16127,16112,14210,15045,0
46418,7,16,45062,1356,46351,67,1.66188e+14,10.4473,729.488,46418,13,12,4243,968,567,272,113
12247,99,176,12239,8,12247,0,6.03794e+18,166.644,1355.72,12247,133,131,10851,7317,6502,6772,6895
17769,7160,7751,16999,770,16999,770,8.81438e+18,94.2965,9074.54,17769,3758,110,10018,10018,9878,9878,8765
2052,30,103,0,2052,1993,59,3.53967e+16,19.1179,303.208,2052,32,26,1949,1949,1657,1669,752
17151,3027,4168,16151,1000,16151,1000,2.66558e+18,97.8402,5750.57,17151,1962,111,14745,14745,12573,11924,10305
2209,95,202,2208,1,2209,0,6.13152e+18,142.108,621.73,2209,70,68,1847,1457,1057,18351,18304
38256,5582,15606,36536,1720,0,38256,1.72428e+18,94.9492,18069,38256,7561,110,37624,37624,29568,27919,19863
14712,4210,6096,14052,660,0,14712,1.71701e+18,94.4449,7282.64,14712,2945,110,8616,8616,7710,7430,7223
14763,687,818,0,14763,14335,428,4.15028e+16,125.867,2220.62,14763,110,26,13945,13826,13878,13836,13409
23013,7,11,22358,655,23004,9,1.38628e+14,10.1858,424.551,23013,11,11,4120,1055,656,350,170
25812,10,15,25053,759,25757,55,1.7054e+14,10.6196,539.465,25812,13,11,25686,25484,24636,24270,21919
39839,3217,18087,0,39839,0,39839,4.63799e+17,94.0232,20468.4,39839,8792,110,21752,21752,13787,6722,5156
6342,1008,1542,5972,370,5972,370,3.37342e+18,95.954,2316.89,6342,721,95,44561,0,0,13258,3670
5840,244,3159,0,5840,0,5840,3.47427e+15,17.0176,3358.02,5840,2829,20,2681,2671,227,391,189
3686,16,171,0,3686,3580,106,3.53837e+16,19.6856,497.669,3686,39,26,3410,3183,2191,2155,823
33217,9588,10716,31507,1710,31507,1710,3.06933e+18,96.3682,13167.4,33217,5196,110,25123,25123,25123,25123,25123
29766,11879,15671,29766,0,28666,1100,4.88779e+18,576.867,17311.7,29766,4041,136,27556,27556,27556,27556,27556
24334,429,843,0,24334,23640,694,3.56202e+16,142.322,2581.08,24334,116,26,20420,18767,11749,9925,2425
49256,15537,15606,0,49256,18035,31221,2.25251e+15,58.7512,18607,49256,7597,72,40786,40786,40786,40786,40786
2824,6,10,2745,79,2824,0,1.37448e+14,9.80984,146.539,2824,10,10,2686,2587,2008,1975,1886
21039,954,4964,19817,1222,0,21039,2.22773e+18,97.4706,6855.61,21039,2385,110,16075,16075,10655,9649,4059
4666,235,333,0,4666,4527,139,4.23296e+16,18.8986,838.492,4666,53,26,0,0,7157,23539,23539
1353,88,170,1353,0,1353,0,5.99724e+18,112.838,433.09,1353,63,58,1076,660,648,686,683
38019,9786,16600,36389,1630,36389,1630,8.71442e+18,94.6009,18955.6,38019,8057,110,36476,36476,36476,36990,0
47446,8345,15899,45053,2393,45053,2393,2.93867e+18,96.2669,19089.1,47446,7715,110,24926,3110,16229,16705,18056
8578,115,176,8570,8,8578,0,6.11419e+18,158.565,1145.7,8578,113,115,8296,3675,1650,3912,838
48093,57,176,48002,91,48093,0,6.03829e+18,173.196,2684.74,48093,174,174,19478,7962,11831,13435,4341
16729,226,697,0,16729,16252,477,3.55485e+16,24.9999,1928.73,16729,88,26,16032,16027,14365,14469,6884
45334,10361,17717,17209,28125,0,45334,7.86153e+12,57.1888,20267.3,45334,8625,72,31532,31532,31368,31502,31368
2427,149,989,2194,233,2307,120,4.36274e+18,90.5554,1311.1,2427,453,58,1438,1351,744,797,576
17237,1662,4045,6059,11178,0,17237,9.94344e+12,59.8749,5455.28,17237,1970,72,13192,13192,9769,12599,5726
8952,1458,2666,3243,5709,0,8952,9.10714e+12,58.6481,3471.95,8952,1294,72,30101,30101,0,0,0
43037,5041,10021,40527,2510,40527,2510,5.87322e+18,97.9096,13329,43037,4864,110,22638,22638,10084,22638,10129
43914,1989,10561,41364,2550,41364,2550,1.70798e+18,98.2961,13823.7,43914,4987,111,41387,41387,39732,37618,40050
48729,4542,18805,46457,2272,46457,2272,2.78568e+18,94.5102,21866.7,48729,9127,110,35360,35114,30923,31688,26258
42974,3557,10329,40474,2500,40474,2500,5.13282e+18,98.1942,13535.1,42974,4870,111,42650,42650,42650,42650,42650
8077,808,2083,0,8077,2863,5214,2.4762e+15,58.212,2858.21,8077,997,72,5994,5994,4479,3163,2799
25411,9637,11188,24321,1090,24321,1090,2.7393e+18,94.4096,12908.5,25411,5421,110,23631,23631,23631,23631,23631
16327,2897,6794,15597,730,15597,730,8.52523e+18,94.509,8072.64,16327,3286,110,24104,24104,12763,8990,4431
25393,1067,7240,24003,1390,24003,1390,4.48391e+18,97.3959,9279.66,25393,3436,111,18153,18153,8823,11833,4276
42029,6084,21238,42029,0,42029,0,2.84925e+18,17.9837,21825.9,42029,19098,20,29018,29018,24679,28110,17455
16711,3391,6422,15929,782,15929,782,7.87468e+18,93.2509,7773.54,16711,3096,110,10289,10289,9398,9255,6122
41278,1783,9683,0,41278,0,41278,6.47192e+17,97.8615,12880.6,41278,4694,110,40942,40942,40942,40942,40942
48175,13158,27220,46578,1597,0,48175,1.26882e+18,91.3912,29538.1,48175,13237,110,31515,31515,31331,31161,31259
45659,1942,10588,0,45659,16044,29615,2.53311e+15,60.1035,13694.9,45659,5151,72,27383,26433,15613,18771,4369
6727,781,1638,6335,392,6335,392,5.72541e+18,96.0363,2445.59,6727,764,96,5089,5089,4564,4483,2844
34645,5361,8322,32627,2018,32627,2018,4.58738e+18,98.2614,11031.7,34645,3936,111,26323,26323,23236,26101,17731
48323,50,176,48243,80,48323,0,5.98347e+18,171.797,2604.12,48323,171,171,40889,32584,31545,32250,32120
822,174,240,284,538,0,822,1.03274e+13,53.4367,381.52,822,116,40,582,582,512,562,489
24092,2228,12826,23232,860,23232,860,2.35043e+18,89.6325,14276.1,24092,6207,110,11381,11381,7621,7760,2936
22608,5778,5877,21329,1279,0,22608,2.16024e+18,97.2076,7822.75,22608,2844,110,18239,18239,15107,17694,11292
33667,11300,16635,32359,1308,32359,1308,7.46031e+18,94.3555,18575.7,33667,8021,115,35137,35137,35137,35137,35137
12775,442,3030,4499,8276,0,12775,9.83879e+12,59.6983,4151.64,12775,1467,72,9745,9745,6051,9105,1642
8791,208,2366,8298,493,8298,493,6.13373e+18,96.2467,3323.14,8791,1136,110,6425,6339,4872,3848,1157
27075,1,13,26305,770,27003,72,1.38986e+14,10.7774,507.338,27075,13,12,6938,6938,6938,6938,6938
44284,2,19,42970,1314,44176,108,1.86368e+14,10.5198,757.295,44284,15,12,4184,3185,3167,3557,3140
29627,7267,9145,29627,0,27902,1725,5.23257e+18,192.926,10756.1,29627,3544,125,30193,29934,20890,24367,14472
29963,131,208,29905,58,29963,0,6.12369e+18,201.333,2307.55,29963,167,170,27958,25803,18527,18954,19074
28182,11,13,27365,817,28169,13,1.58815e+14,10.2592,495.739,28182,12,12,28159,28151,27596,27583,26525
30212,2884,10201,0,30212,11177,19035,2.18759e+15,58.3513,12167.8,30212,4961,72,36477,36477,25286,15278,10673
49146,963,1307,0,49146,47745,1401,3.56417e+16,266.722,4609.2,49146,208,26,35653,35146,18957,26251,9233
30270,11892,15965,29180,1090,29180,1090,2.36804e+18,93.0956,17698.9,30270,7755,110,14305,14305,12532,13909,10688
41937,545,16252,39970,1967,39970,1967,7.76811e+18,96.0494,18909.8,41937,7797,111,19477,18613,9254,998,1116
48241,1,15,46859,1382,48155,86,1.43652e+14,10.5689,707.588,48241,14,12,8216,8216,8216,8216,8216
1368,213,772,1318,50,1318,50,2.47997e+18,53.6711,942.906,1368,347,45,596,596,535,572,527
25915,63,175,25844,71,25915,0,5.98051e+18,167.024,1904.1,25915,159,163,173,120,102,0,0
36295,6572,8451,12764,23531,0,36295,9.89739e+12,60.0596,11017.7,36295,4117,72,31532,31532,31532,31532,31532
42964,195,208,42878,86,42964,0,6.0468e+18,202.49,2714.75,42964,187,187,42723,42695,42572,42564,42399
3860,51,1389,0,3860,1433,2427,2.14038e+15,56.9396,1796.47,3860,670,63,2177,757,1406,774,114
17989,6,12,17473,516,17979,10,1.39447e+14,10.5775,380.039,17989,12,11,28087,22950,18930,16851,4240
24684,972,12042,24684,0,23615,1069,4.8589e+18,258.102,13220.9,24684,5289,127,12642,11832,6151,8989,2162
37559,11551,17024,14663,22896,0,37559,7.05459e+12,55.5083,19034.1,37559,8277,72,35507,35441,35441,35441,1285
5882,157,261,1716,4166,1716,4166,1.74494e+18,15.949,539.379,5882,256,17,12824,12637,4545,3035,757
40915,213,1762,0,40915,39715,1200,4.40042e+16,306.353,5721.99,40915,300,26,32609,32609,12224,6585,6195
5773,384,3650,0,5773,2424,3349,1.20553e+15,52.7611,4012.96,5773,1763,66,2123,1979,1227,483,515
880,258,261,310,570,0,880,1.061e+13,53.6273,407.261,880,127,43,619,619,613,616,615
43545,2839,10215,41014,2531,41014,2531,5.77439e+18,97.8554,13548.1,43545,4943,110,43067,43067,43067,43067,43067
12860,8,13,12476,384,12787,73,1.85629e+14,10.6084,372.086,12860,13,12,12641,12450,12026,10092,10093
10705,1,12,10400,305,10698,7,1.39252e+14,10.2972,289.793,10705,12,11,2737,2737,2737,2737,2737
45495,881,10669,0,45495,0,45495,6.46741e+17,97.8492,14121,45495,5166,110,35027,35027,22010,20196,5946
23227,3003,6974,8438,14789,0,23227,9.06724e+12,58.9015,8638.06,23227,3396,72,16253,16253,11816,15170,7410
10108,895,2360,3549,6559,0,10108,9.91411e+12,59.7204,3303.57,10108,1142,72,7748,7748,5279,7126,3138
7903,1653,3643,7573,330,7573,330,6.72576e+18,87.2807,4349.04,7903,1720,97,4260,4260,3282,3945,2754
10408,2059,3037,9838,570,0,10408,2.08452e+18,96.0024,4090.62,10408,1461,110,7371,7371,6126,5904,4965
35824,465,1357,0,35824,34785,1039,4.03574e+16,269,4404.72,35824,221,26,26265,25794,17672,8837,6768
33205,11070,11156,31515,1690,31515,1690,5.89429e+18,95.2067,13522.6,33205,5310,111,34118,34118,33251,32346,31410
42066,4751,11284,39726,2340,39726,2340,6.25556e+18,97.3118,14413.6,42066,5470,110,34953,34953,31645,31274,18962
6274,42,61,6274,0,6274,0,2.34682e+18,59.9074,586.351,6274,61,61,3478,1021,1222,1981,130
17533,3722,4256,16513,1020,16513,1020,2.09073e+18,97.8624,5867.47,17533,2006,111,20752,20752,14840,14926,7982
49508,5745,21082,47348,2160,0,49508,1.67078e+18,93.3626,24024.7,49508,10229,110,27824,27824,18879,11242,8954
48563,18772,18957,48563,0,46073,2490,4.61033e+18,461.232,20985,48563,5075,141,37503,37503,37503,37503,37503
36433,1421,1918,0,36433,35347,1086,4.88025e+16,310.062,6057.13,36433,329,26,30388,30388,20777,17363,15272
3976,147,180,0,3976,3862,114,3.53583e+16,19.8421,530.357,3976,40,26,3796,3796,3673,3680,3436
18059,1699,4276,0,18059,0,18059,6.47198e+17,97.3985,5960.2,18059,2059,110,16812,16812,16812,16812,16812
44710,11210,19128,44710,0,40345,4365,4.5642e+18,1737.61,21746.9,44710,5325,141,46612,46612,46612,46612,46612
13014,157,176,13004,10,13014,0,6.01443e+18,167.858,1383.29,13014,135,136,12715,12408,11524,11565,11558
43156,3823,18287,16619,26537,0,43156,7.43836e+12,56.1879,20629,43156,8892,72,24869,24869,14284,21563,5981
27599,3481,12038,20650,6949,26407,1192,2.86108e+18,95.1113,13852.4,27599,5777,111,15561,15561,6168,9510,5494
27035,7127,12167,10537,16498,0,27035,7.09927e+12,54.1104,13725,27035,5904,72,35455,35455,35455,35455,35455
11956,3798,5165,8981,2975,11429,527,5.10972e+18,94.5596,6148.25,11956,2461,111,6791,6791,5470,5748,5538
32756,6438,7679,30846,1910,0,32756,2.23029e+18,97.7984,10343.1,32756,3718,110,46598,46598,46598,46598,46598
41183,70,176,41167,16,41183,0,5.98518e+18,172.244,2405.61,41183,171,172,30998,17160,14523,17024,16585
4885,1242,1269,4605,280,4605,280,3.31971e+18,95.1177,1902.9,4885,595,88,3616,3616,3605,3611,3616
7762,1137,2170,2784,4978,0,7762,9.3366e+12,58.7457,2905.4,7762,1046,72,5592,5592,4101,5332,2433
9269,3735,4556,9269,0,9269,0,3.39017e+18,18.9107,4834.66,9269,3485,23,4713,4713,4191,4237,3919
46300,15672,16047,44000,2300,44000,2300,2.9348e+18,96.1013,19133.3,46300,7790,110,32418,32418,32418,32418,32418
49058,5044,14894,0,49058,17863,31195,2.29559e+15,58.9567,17933.5,49058,7242,72,36734,36734,31287,35454,24412
30158,8153,10082,11147,19011,0,30158,8.59798e+12,57.706,12054.4,30158,4906,72,23232,23232,23232,23232,23232
34625,8190,11181,34625,0,32614,2011,3.46679e+18,242.435,12745.8,34625,4027,130,34241,34241,34241,34241,34241
37041,8807,13930,13960,23081,0,37041,8.04366e+12,57.77,16138.3,37041,6780,72,43728,43728,43728,43728,43728
33612,6681,7861,11812,21800,0,33612,9.87065e+12,60.0062,10271.2,33612,3817,72,21384,21182,18188,20394,15200
19592,4630,8321,19592,0,18612,980,4.07832e+18,150.688,9322.67,19592,3399,121,19347,19335,16415,26230,0
41855,8508,14551,0,41855,15562,26293,2.15046e+15,58.2297,17080.4,41855,7072,72,25968,25968,23649,25369,20329
32442,7265,7615,30552,1890,0,32442,2.22851e+18,97.7353,10256.7,32442,3688,110,24827,24827,24447,24340,24099
46592,626,13657,44072,2520,44072,2520,4.41878e+18,97.5293,16886.4,46592,6501,111,37470,13958,8836,10980,2914
23418,5,11,22751,667,23414,4,1.38694e+14,10.019,425.778,23418,11,11,43353,38866,31419,32202,26964
42541,4141,8192,42541,0,42541,0,4.41933e+15,6614.49,18655.3,42541,8192,6,18145,29211,29211,29211,29211
13375,1153,3224,12597,778,12597,778,5.77917e+18,96.9427,4562.35,13375,1543,110,10151,10151,8928,8739,4268
44168,17,19,42853,1315,44034,134,1.88317e+14,10.4488,756.349,44168,14,13,37115,35159,35240,35935,34923
25006,5,13,24269,737,24987,19,1.74743e+14,10.1703,478.717,25006,12,12,24152,21137,20452,19821,12982
3257,1607,1621,3257,0,3110,147,6.91963e+18,90.3436,1938.3,3257,680,72,1636,1636,1636,1636,1636
17042,482,4008,5989,11053,0,17042,9.8669e+12,59.855,5413.21,17042,1943,72,9956,9812,3573,7962,456
39613,795,10712,14177,25436,0,39613,9.4043e+12,58.8281,13360.7,39613,5197,72,26849,26467,15119,10891,3935
26281,7,14,25529,752,26205,76,1.42082e+14,10.7646,503.675,26281,14,12,25366,24857,22926,22651,18424
31844,1159,9288,0,31844,11525,20319,2.33607e+15,55.3566,11454.9,31844,4510,72,30958,30958,30958,30958,30958
34752,3629,8139,0,34752,0,34752,6.49928e+17,97.8122,10924.7,34752,3946,110,27672,27672,22801,22373,17790
9869,1014,3733,0,9869,0,9869,5.30125e+17,94.5212,4660.03,9869,1793,110,13802,12808,2896,1302,2359
16672,1433,6703,15910,762,0,16672,1.75211e+18,94.6964,8022.32,16672,3243,110,35387,35387,35369,35354,34697
32037,79,176,31984,53,32037,0,6.0247e+18,172.743,2173.66,32037,163,169,30831,20511,18188,19448,0
39948,6231,12800,39948,0,37618,2330,4.00448e+18,282.225,14534.5,39948,4751,128,41372,41372,41372,41372,41372
3797,1099,1242,3597,200,3597,200,3.66425e+18,87.8752,1732.79,3797,566,78,2555,2555,2555,2555,2555
7542,300,723,0,7542,7318,224,4.99875e+16,46.6248,1696.27,7542,92,26,6819,6777,6135,6010,4108
37553,7,14,36483,1070,37476,77,1.3889e+14,10.6857,601.908,37553,13,12,12651,10388,9819,10121,9484
37614,53,176,37553,61,33648,3966,6.06418e+18,173.292,2392.19,37614,171,166,14210,6033,8394,6624,3457
39750,116,176,39672,78,39750,0,5.98217e+18,169.677,2360.52,39750,168,171,25554,24935,8946,20417,1741
24901,6163,6306,0,24901,8842,16059,2.47367e+15,59.6683,8157.59,24901,3072,72,48833,48833,48833,48833,48833
3526,361,1302,3353,173,0,3526,1.90506e+18,92.0874,1747.28,3526,607,73,2224,2138,1634,1518,1271
15379,513,968,0,15379,14923,456,4.63766e+16,205.219,2682.08,15379,140,26,14411,14080,13359,12882,9357
23860,5064,5783,8412,15448,0,23860,9.77024e+12,59.8201,7598.31,23860,2810,72,18077,18077,17147,17917,16188
879,160,162,879,0,879,0,5.96266e+18,93.3424,344.73,879,54,44,717,717,717,717,717
3227,63,199,3226,1,3227,0,5.99541e+18,154.517,706.636,3227,90,87,2211,1219,909,1110,1021
26818,111,6266,25250,1568,0,26818,2.23392e+18,97.7004,8544.5,26818,3034,110,20552,9190,12162,10689,1701
40708,949,1142,0,40708,39547,1161,3.55296e+16,237.974,3901.38,40708,177,26,37498,37498,18142,22365,5419
34299,869,1395,0,34299,33300,999,4.16665e+16,269.309,4474.08,34299,225,26,32904,32904,30438,30738,25447
21961,7341,7672,20870,1091,0,21961,1.90174e+18,95.7338,9399.68,21961,3714,110,21755,21755,21755,21755,21755
16963,641,735,0,16963,16476,487,3.65747e+16,62.7638,2043.47,16963,96,26,16228,16179,15774,15852,14278
6203,1226,1850,0,6203,0,6203,6.01184e+17,95.0274,2570.54,6203,877,91,8922,8922,5415,3264,1163
4780,286,1254,0,4780,0,4780,6.34627e+17,94.809,1874.53,4780,577,86,3526,3526,1803,1401,1183
33633,358,1622,0,33633,32641,992,4.57824e+16,294.266,5112.51,33633,269,26,35869,35869,16039,19916,3418
10059,130,437,0,10059,9769,290,3.57244e+16,20.0093,1225.74,10059,63,26,9622,9622,8489,8588,3729
21087,3679,4915,7411,13676,0,21087,9.90703e+12,59.9823,6577.53,21087,2394,72,16172,16172,14346,15852,12270
21751,57,790,0,21751,21131,620,3.55269e+16,107.402,2349.51,21751,107,26,18587,4807,14532,4766,97
26169,148,8069,0,26169,9543,16626,2.29286e+15,58.7937,9881.05,26169,3930,72,18100,17846,6072,753,769
4356,1366,1814,1659,2697,0,4356,7.73273e+12,54.3841,2226.88,4356,866,66,2542,2542,2504,2532,2507
25223,1792,5902,23753,1470,0,25223,2.23145e+18,97.678,8081.73,25223,2852,110,17316,16966,8717,12939,2587
6884,5,11,6687,197,6876,8,1.39715e+14,10.7464,232.359,6884,11,11,6352,5716,4628,4740,3799
24468,5265,11032,9539,14929,0,24468,7.08064e+12,56.5124,12470.5,24468,5361,72,21321,21321,21321,21321,21321
31012,909,965,0,31012,30128,884,3.55664e+16,192.643,3122.69,31012,142,26,30801,30801,30801,30801,30801
34405,6211,10643,12556,21849,0,34405,8.92296e+12,58.8344,12898.1,34405,5184,72,33488,33488,33488,33488,33473
16831,5046,9043,0,16831,0,16831,3.47216e+15,17.8746,9394.28,16831,8127,20,27094,27094,19513,15322,12841
40093,9382,12272,0,40093,0,40093,5.87651e+17,96.7283,15159.8,40093,5960,110,45705,45705,45705,45705,45705
45365,10666,15824,43115,2250,43115,2250,7.43614e+18,96.0735,18849.7,45365,7684,110,29541,29541,27760,27477,20782
29859,5105,7005,10494,19365,0,29859,9.85987e+12,59.9639,9193.15,29859,3399,72,19748,19748,13700,8136,6532
4103,1033,1064,3863,240,3863,240,5.65969e+18,95.0068,1615.34,4103,483,81,3039,3039,3037,3039,3036
16934,792,4005,0,16934,0,16934,6.50187e+17,97.4624,5607.97,16934,1932,110,12929,12929,8587,2659,3414
16236,8242,15175,0,16236,5061,11175,2.36249e+15,3.98627,15236.3,16236,5078,9,15226,15226,15226,0,0
25336,6711,7440,9171,16165,0,25336,9.13388e+12,59.0164,9237.27,25336,3620,72,25099,25099,0,0,0
21869,5,14,21218,651,21817,52,1.88405e+14,10.2774,480.884,21869,13,11,20344,18540,15745,15298,11131
11565,315,2749,10893,672,10893,672,3.35798e+18,96.8886,3955.46,11565,1305,110,17319,17147,8406,7726,1591
40849,7578,11372,14679,26170,0,40849,9.31367e+12,59.287,14061.2,40849,5523,72,20270,20270,14091,6473,6298
12718,3548,5694,4940,7778,0,12718,7.16705e+12,55.7033,6567.46,12718,2756,72,7024,7024,6378,6914,5832
2055,3,11,1992,63,2054,1,2.02717e+14,10.0083,131.794,2055,11,11,1646,1324,1088,1443,447
39975,29,176,39898,77,39975,0,6.01136e+18,172.733,2413.51,39975,173,171,14982,1363,3385,6860,90
34147,335,1275,0,34147,33158,989,3.97312e+16,269.509,4115.4,34147,204,26,34098,34098,34098,34098,34098
33387,14430,17839,13506,19881,0,33387,6.00311e+12,53.1181,19451.6,33387,8668,72,32280,32280,32280,32280,32280
6391,4,11,6208,183,6386,5,1.38337e+14,10.5228,224.434,6391,11,11,5553,4930,4141,4247,3013
19167,5055,5985,19167,0,18047,1120,5.19733e+18,148.867,7180.11,19167,2289,121,18837,18506,17804,17804,17804
23612,932,1293,0,23612,22909,703,4.6658e+16,270.772,3870.01,23612,207,26,41876,41876,36462,37067,21246
9603,2251,4364,9200,403,0,9603,1.61241e+18,69.2473,5189.64,9603,2102,97,5239,5239,3112,2652,0
20122,7421,9309,7890,12232,0,20122,6.97764e+12,56.3016,10519.9,20122,4535,72,10813,10813,9732,10625,8654
33076,69,176,32996,80,33076,0,5.98023e+18,169.543,2154.21,33076,163,168,24581,14286,10208,11698,10835
3174,106,201,3170,4,3174,0,6.26679e+18,150.559,728.948,3174,80,78,2754,2381,1777,1710,1573
6278,172,176,6272,6,6278,0,6.07387e+18,160.641,977.988,6278,103,106,6095,6073,5985,6014,5997
48679,12253,17369,0,48679,18170,30509,2.12288e+15,58.0782,20195.4,48679,8443,72,48197,48197,48197,48197,48197
28434,2453,8095,26886,1548,26886,1548,6.61825e+18,96.9086,10358.1,28434,3919,110,26650,26650,25467,4593,2017
4822,3,11,4679,143,4814,8,1.88779e+14,10.4314,204.911,4822,11,11,3828,3024,9470,9902,9120
11280,1721,3929,0,11280,0,11280,5.56723e+17,90.8145,4985.28,11280,1890,110,27425,27425,27425,27425,27425
5549,32,176,5542,7,5549,0,6.20612e+18,154.78,913.596,5549,93,95,3090,993,1107,1007,984
9494,227,5624,9194,300,9194,300,2.45037e+18,81.7812,6283,9494,2686,97,3870,3495,0,1155,261
33719,3631,7908,31759,1960,31759,1960,3.36348e+18,97.7847,10635.1,33719,3835,110,33381,33381,0,0,5079
1371,731,1043,1338,33,1338,33,9.7639e+18,76.4048,1149.04,1371,488,45,18200,18121,14169,17703,14236
30005,3795,12279,28645,1360,28645,1360,2.66605e+18,95.6143,14282.7,30005,5897,111,29831,29831,29831,29831,29831
24659,7387,7454,8960,15699,0,24659,9.02294e+12,58.8894,9196.42,24659,3631,72,24296,24296,24296,24296,24296
39994,111,1228,0,39994,39382,612,2.46276e+16,3.73631,4730.38,39994,616,4,31414,26263,39336,14690,5743
16216,3557,3858,15273,943,0,16216,2.2267e+18,97.2782,5406.99,16216,1857,110,31199,31199,30735,27155,21299
42859,1,14,41637,1222,42778,81,1.38817e+14,10.61,644.151,42859,14,12,15579,15579,15579,15579,15579
18333,216,1047,0,18333,17789,544,4.53303e+16,215.346,3000.9,18333,157,26,16571,16033,7982,12967,987
5220,4,11,5068,152,5213,7,1.88782e+14,10.2192,211.988,5220,11,11,4643,4198,3815,3517,2245
33536,3180,7865,31579,1957,0,33536,2.22902e+18,97.7724,10574.4,33536,3813,110,24190,24190,19908,14636,14770
6244,39,1509,5875,369,0,6244,2.24677e+18,96.155,2273.79,6244,716,94,2389,368,18582,18328,17446
16194,6925,7646,0,16194,6375,9819,1.74532e+15,54.657,8662.34,16194,3709,72,24666,24666,18642,16211,9939
32943,4057,7689,11586,21357,0,32943,9.89044e+12,60.026,10059.8,32943,3740,72,25254,25254,19975,24341,13625
47340,13,15,45972,1368,47271,69,1.56042e+14,10.4375,698.688,47340,13,13,47322,47317,46625,46626,43818
39517,5606,9195,0,39517,13883,25634,2.53072e+15,60.0559,11948.6,39517,4473,72,0,0,0,9041,16208
40099,1548,21171,0,40099,0,40099,3.9997e+17,93.1653,23313.1,40099,10291,110,34913,34913,16538,21313,6748
34568,5556,14352,34568,0,32908,1660,4.61158e+18,346.329,16119.9,34568,4635,136,27705,27705,27149,26455,26352
46230,10,16,44883,1347,46164,66,1.63277e+14,10.3846,721.251,46230,13,12,40822,37575,27133,29442,12174
40169,17605,20600,8756,31413,0,40169,5.2579e+10,8.99492,21008,40169,18532,11,33391,33391,33391,33391,33391
23819,10,14,23137,682,23749,70,1.38817e+14,10.6883,469.486,23819,13,12,21806,20720,19202,18695,9713
5934,1748,2680,5677,257,5677,257,4.20879e+18,93.14,3259.84,5934,1264,83,3254,3254,2211,2400,2225
21108,3137,5560,19928,1180,19928,1180,6.1272e+18,97.0278,7404.33,21108,2681,110,20301,20301,16855,16685,10415
8379,39,176,8369,10,8379,0,6.11245e+18,163.148,1132.7,8379,112,113,5058,1616,1782,1971,1868
5285,961,2449,5065,220,5065,220,8.89846e+18,91.9438,2981.16,5285,1166,85,2836,2753,2452,2388,1308
19100,6,14,18550,550,19057,43,1.53249e+14,10.6652,425.402,19100,13,11,4802,1386,683,667,213
43838,10401,16091,41728,2110,41728,2110,7.84057e+18,80.8147,18975.5,43838,7804,110,27747,27747,27747,27747,27747
41363,6483,13813,41363,0,39063,2300,4.0269e+18,278.124,15838.5,41363,5616,129,29681,29681,25568,29234,18591
8796,290,2058,0,8796,3094,5702,2.54576e+15,59.667,2905.59,8796,1001,72,6738,6738,4133,35813,34268
3832,977,1430,0,3832,0,3832,5.51909e+17,92.3593,1898.67,3832,667,78,3532,3532,3532,3532,3532
46979,18958,20338,44956,2023,44956,2023,8.81197e+18,94.3375,23131.4,46979,9870,110,28925,28925,28925,28925,28925
5490,443,1352,0,5490,0,5490,6.53845e+17,95.7286,2044.54,5490,639,90,4138,4138,2918,2394,1723
34092,4876,11267,12564,21528,0,34092,8.64376e+12,58.4797,13450.6,34092,5486,72,28913,28913,23452,22372,16730
40745,119,176,40727,18,40745,0,6.01808e+18,172.671,2448.19,40745,169,171,32480,32349,20700,14359,5959
2726,523,983,2726,0,2566,160,6.8662e+18,88.3243,1299.96,2726,339,66,1743,1743,1450,1604,1185
29629,5794,6943,10411,19218,0,29629,9.85997e+12,59.9899,9120.11,29629,3375,72,14759,14759,10856,6687,5741
41708,1185,9805,0,41708,0,41708,6.45865e+17,97.8155,13025.8,41708,4742,110,41413,41413,41413,41413,41413
8732,46,2108,8222,510,8222,510,5.89944e+18,96.2459,3086.06,8732,998,107,3704,765,2070,2979,414
27421,4730,9539,27421,0,25879,1542,4.68254e+18,171.803,10844.8,27421,1864,129,18577,18577,7660,10984,3540
19190,2530,5737,6955,12235,0,19190,9.05743e+12,58.8756,7174.95,19190,2790,72,28436,28436,28436,28436,28436
32577,9990,11686,32577,0,30837,1740,3.96504e+18,265.466,13388.2,32577,4855,126,22756,22756,22756,22756,22756
6333,996,2020,0,6333,2311,4022,2.2885e+15,57.9754,2625.54,6333,979,72,25704,0,6084,12940,4089
19779,3764,9366,19779,0,18909,870,3.91076e+18,177.342,10456.3,19779,4146,123,10413,10389,6655,8092,12735
2454,221,627,0,2454,855,1599,2.48101e+15,57.641,953.38,2454,298,58,1827,7814,1946,7850,1716
3810,853,962,3587,223,0,3810,2.24282e+18,94.5911,1493.06,3810,450,78,2848,2848,2753,2744,2750
19825,2846,8557,7665,12160,0,19825,7.36779e+12,56.3867,9810.54,19825,4162,72,13690,13690,11103,9083,8728
15182,510,7448,15182,0,15182,0,2.35186e+18,17.9528,7799.75,15182,6691,20,21761,21745,8895,17375,2032
2343,1300,1522,513,1830,0,2343,2.26763e+13,5.42638,1762.94,2343,517,13,821,821,789,821,726
5562,414,1413,5242,320,0,5562,2.2085e+18,94.5931,2112.43,5562,656,89,4149,4149,2817,2638,1461
13798,2604,4387,13798,0,12991,807,3.14208e+18,115.705,5340.92,13798,1668,123,9411,9386,7425,8076,5957
2336,214,588,826,1510,0,2336,9.93659e+12,57.7586,902.648,2336,280,58,1748,1748,1105,1560,741
10391,60,175,10389,2,10391,0,5.98319e+18,162.957,1209.89,10391,130,130,7163,3797,3075,3559,3646
14624,3357,3459,5142,9482,0,14624,9.91065e+12,59.7613,4699.91,14624,1680,72,23392,23392,18224,16998,11530
8308,79,175,8301,7,8308,0,5.99525e+18,160.255,1081.84,8308,123,122,6615,3760,3459,3785,3769
42506,6,14,41293,1213,42431,75,1.38969e+14,10.4461,624.292,42506,13,12,6964,4268,3621,3667,3208
4983,69,186,4978,5,4983,0,5.97215e+18,165.033,853.215,4983,102,100,3685,2036,1658,1905,1811
46782,5,15,45427,1355,46721,61,1.59582e+14,10.4558,723.215,46782,13,11,6303,1754,1261,525,183
34719,10758,15840,0,34719,13561,21158,1.79509e+15,56.0336,17718.4,34719,7696,72,22413,22413,20656,20536,18830
8165,2,4,8029,136,8165,0,9.8387e+13,3.99204,171.712,8165,4,4,6177,5309,5743,5309,4932
9025,2334,2941,9025,0,8502,523,4.02883e+18,93.9506,3664.44,9025,1107,118,21640,21640,21088,21340,20904
13541,53,170,13535,6,13541,0,5.98185e+18,164.518,1371.41,13541,135,144,13404,13366,13351,13345,13348
27352,11224,13938,26319,1033,26319,1033,7.16382e+18,94.0179,15557.7,27352,6712,111,26929,26929,26929,26929,25081
41744,19002,22053,40234,1510,40234,1510,3.5826e+18,92.1048,24223.6,41744,10628,111,29432,29432,29432,29432,29432
42472,1326,1486,0,42472,41243,1229,3.96816e+16,296.274,4960.19,42472,246,26,31825,31825,17374,22074,10003
9059,7,10,8800,259,9059,0,1.38174e+14,9.9075,262.504,9059,10,10,8736,8525,7996,7997,6876
34191,12,15,33196,995,34129,62,1.62714e+14,10.4443,589.905,34191,13,12,34141,30960,19898,22327,5035
24933,5,11,22875,2058,24933,0,1.15952e+14,7.85425,398.035,24933,11,8,22186,19795,16713,16713,16712
31336,7916,9640,31336,0,29507,1829,3.94963e+18,208.416,11318.6,31336,3747,125,29382,29382,29382,29382,29382
21881,569,5154,0,21881,0,21881,6.47766e+17,97.5169,7104.18,21881,2487,110,16727,16727,10491,2294,9644
27047,949,7262,0,27047,9669,17378,2.41145e+15,59.4191,9212.91,27047,3525,72,39652,39652,38731,38603,34126
24172,2401,5625,0,24172,8490,15682,2.5363e+15,59.9989,7477.23,24172,2738,72,18547,18547,13776,8936,8032
6650,363,1685,0,6650,0,6650,6.36114e+17,95.7442,2479.58,6650,793,97,4965,4965,3255,1002,1486
23740,58,176,23665,75,23740,0,6.03264e+18,170.192,1882.68,23740,153,160,17272,10995,7366,7955,7780
15573,4240,4875,15573,0,14663,910,4.58073e+18,127.46,5913.2,15573,1842,118,19264,20096,1163,1163,1163
23529,240,921,0,23529,22855,674,3.79015e+16,179.996,2790.03,23529,131,26,35057,34728,14557,21963,2744
28123,116,274,28121,2,28123,0,5.66132e+18,217.951,1267.21,28123,268,32,27347,26991,13627,19154,16594
15477,7079,7859,0,15477,0,15477,4.17177e+17,92.9013,8943.15,15477,3796,110,7618,7618,7452,7148,7401
12054,1706,6764,12054,0,0,12054,8.94558e+17,17.9056,7047.16,12054,6073,20,5290,5290,1422,2818,1382
17733,4033,4204,16700,1033,16700,1033,3.3542e+18,97.384,5860.86,17733,2016,110,13529,13529,13236,13370,13278
13279,3884,4230,0,13279,4862,8417,2.25934e+15,58.4465,5288.54,13279,2054,72,13291,13291,13040,12733,12771
1698,86,93,1698,0,1698,0,5.90507e+18,22.3092,249.931,1698,79,26,1605,1605,1596,1602,1580
41815,7396,9815,39385,2430,0,41815,2.22504e+18,97.8452,13045.3,41815,4752,110,46802,46802,46802,46802,46802
47278,7553,13208,44691,2587,0,47278,2.09553e+18,97.1694,16598.3,47278,6405,110,36111,36111,31429,27814,25777
2295,519,1390,2223,72,2223,72,1.05838e+19,86.0641,1622.17,2295,649,50,905,819,785,765,587
39823,15076,39823,39823,0,39823,0,8.79587e+12,0,39823,39823,39823,1,38278,38278,38248,38248,38248
35950,5249,8422,33860,2090,0,35950,2.22663e+18,97.783,11288.9,35950,4077,110,33662,33662,26502,32406,17633
45276,2091,10810,42636,2640,42636,2640,5.24027e+18,98.3444,14154.9,45276,5115,111,44353,44353,44353,44353,44353
45194,357,1856,0,45194,43806,1388,4.72584e+15,5.45196,8423.51,45194,470,7,41099,40841,39145,37315,37377
25483,10,176,25469,14,25483,0,6.00892e+18,170.442,1925.51,25483,156,161,7109,1984,2231,2140,2321
38645,2546,10221,38645,0,38645,0,2.77444e+18,3850.57,14262,38645,7375,25,45679,45679,45679,45679,45679
5377,1289,2036,5377,0,5077,300,4.37999e+18,91.0272,2507.12,5377,750,94,3341,3341,2539,2860,2268
3111,1056,1212,2961,150,2961,150,4.68527e+18,82.2392,1608.73,3111,569,63,1899,1899,1873,1873,1899
7131,2049,2059,6741,390,6741,390,6.36212e+18,95.4113,2864.31,7131,970,96,5072,5072,5071,5072,5072
22371,149,176,22363,8,22371,0,6.00675e+18,170.323,1810.82,22371,159,156,20139,0,0,0,0
31900,10797,10805,31900,0,30130,1770,3.61247e+18,213.029,12472.9,31900,4360,128,16033,16033,12540,14191,8556
15549,3395,4274,0,15549,5571,9978,2.40486e+15,59.187,5525.56,15549,2073,72,12331,12331,12331,12331,12331
24753,2,12,24043,710,24739,14,1.41903e+14,10.4359,449.05,24753,12,11,12161,8558,7863,7234,4901
32051,9778,11505,30489,1562,30489,1562,2.92066e+18,82.2776,13788.8,32051,5571,110,21249,21249,21116,20863,21103
6816,106,170,6814,2,6816,0,5.9763e+18,158.817,973.089,6816,115,111,6132,4249,3956,4115,4102
32393,5,14,31458,935,32313,80,1.50439e+14,10.5861,576.449,32393,13,12,4409,1324,580,425,165
24895,1822,6164,23468,1427,23468,1427,3.22826e+18,95.9553,8289.21,24895,2974,110,44548,44548,44053,43873,33666
23706,31,176,23663,43,23706,0,5.99671e+18,168.704,1856.55,23706,154,162,12144,3289,3861,4164,4170
2540,2,10,2466,74,2540,0,1.383e+14,9.74488,138.932,2540,10,10,1474,1045,1014,1044,805
13418,3927,4511,0,13418,0,13418,5.64124e+17,95.514,5727.26,13418,2170,110,8907,8907,8686,8559,8534
25105,193,208,25054,51,25105,0,6.07882e+18,201.85,2104.46,25105,164,160,18572,18391,10567,13252,5017
49543,5281,21513,19176,30367,0,49543,7.29089e+12,56.4016,24093.5,49543,10466,72,49138,49138,49138,49138,49138
4831,854,1580,4831,0,4544,287,2.99918e+18,92.7264,2070.23,4831,591,89,3251,3251,2480,2744,2112
8448,186,1987,0,8448,2968,5480,2.53918e+15,59.5079,2808.85,8448,956,72,6461,6461,3820,1073,715
8133,1338,3282,3092,5041,0,8133,7.72733e+12,51.7147,3947.52,8133,1576,72,4851,4851,3564,4581,1579
22213,2,12,21576,637,22199,14,1.48043e+14,10.4772,432.136,22213,12,11,17235,14297,8176,14367,6297
37535,2483,10457,35475,2060,35475,2060,6.40462e+18,97.1158,13285.6,37535,5068,110,20080,20080,11266,8143,3746
37823,406,1187,0,37823,36739,1084,3.70433e+16,235.663,3962.71,37823,186,26,36636,36044,29191,29995,20127
37011,828,16913,35471,1540,35471,1540,5.11976e+18,94.9549,19117.9,37011,8145,111,47724,47724,44062,44708,36492
25708,3328,6033,0,25708,9050,16658,2.53134e+15,59.9907,7972.57,25708,2939,72,19675,19675,16453,12163,11149
13176,100,648,0,13176,12796,380,3.73523e+16,19.9882,1724.39,13176,84,26,12528,12520,10759,10435,3706
37727,51,176,37600,127,37727,0,6.15715e+18,173.036,2395.05,37727,165,161,29609,10323,8292,4539,605
25802,3617,12060,24752,1050,24752,1050,9.17824e+18,93.9386,13738.3,25802,5848,110,13742,13656,12734,12566,9008
15726,64,199,15720,6,15726,0,5.9936e+18,180.012,1541.98,15726,144,153,21271,6137,17903,3682,208
10735,164,170,10728,7,10735,0,5.98698e+18,162.764,1220.9,10735,130,130,10523,10399,10142,10174,10195
8061,49,89,0,8061,7398,663,2.95705e+16,10.0522,362.431,8061,86,11,7972,7972,7578,6578,7736
1840,244,477,638,1202,0,1840,1.01514e+13,57.1614,739.76,1840,230,53,1363,1363,1039,1303,808
20995,79,775,0,20995,20394,601,3.55603e+16,97.1819,2288.44,20995,103,26,20176,20122,16402,16754,5569
27122,9071,14038,27122,0,26042,1080,4.86402e+18,375.402,15333.5,27122,4883,135,13084,12919,11410,11753,9519
28797,2066,6758,10128,18669,0,28797,9.85005e+12,59.9588,8884.32,28797,3276,72,34688,34688,34688,34688,34688
27901,5222,6508,0,27901,0,27901,6.50279e+17,97.7666,8863.56,27901,3150,110,21393,21393,19928,19138,17755
13649,611,4394,0,13649,0,13649,5.77672e+17,95.8119,5642.56,13649,2110,110,12025,11993,5863,8765,2669
36865,426,11690,13505,23360,0,36865,8.79996e+12,58.7145,14059,36865,5683,72,28933,28933,18744,7287,6044
22877,682,812,0,22877,22225,652,3.55107e+16,121.876,2445.33,22877,110,26,22065,21924,21222,21358,19487
24993,11,12,24278,715,24979,14,1.45496e+14,10.4601,455.335,24993,12,11,27620,27611,26603,26377,25572
5655,76,510,0,5655,5487,168,4.7414e+16,19.2311,1202.56,5655,71,26,5145,5129,4199,3907,1187
22499,2017,8312,8445,14054,0,22499,8.15299e+12,57.6501,9810.81,22499,4033,72,14187,14187,12930,17732,7981
30259,740,1335,0,30259,29378,881,4.27383e+16,275.886,4185.33,30259,215,26,29770,29770,29770,29770,29770
43052,3224,24106,0,43052,17618,25434,1.45436e+15,54.3268,25990.5,43052,11727,72,42993,42993,42993,42993,42993
32745,5454,7703,0,32745,0,32745,6.45887e+17,97.7153,10365.3,32745,3719,110,23050,23050,20547,22241,16531
33781,449,12228,32131,1650,32131,1650,5.26744e+18,96.2138,14553,33781,5845,111,38519,38519,38519,38519,38519
43449,171,176,43365,84,43449,0,6.08275e+18,173.46,2577.33,43449,169,170,36105,35949,26385,24296,14361
35159,11637,14555,0,35159,0,35159,4.97051e+17,94.603,16841.8,35159,7066,110,33915,33915,33915,33915,33915
42286,6499,13592,38385,3901,40086,2200,4.12476e+18,97.1041,16490.3,42286,6500,111,27320,27320,19446,17540,10766
4502,1313,1577,4502,0,4242,260,4.60175e+18,90.1984,2012.32,4502,549,91,2925,2925,2716,2819,2697
19394,1356,5961,0,19394,7064,12330,2.28686e+15,58.7405,7399.42,19394,2894,72,13433,13433,8806,6298,3271
44819,1374,1486,0,44819,43526,1293,3.88802e+16,287.982,5017.04,44819,245,26,32188,32188,13960,26423,4554
30653,2179,7175,10771,19882,0,30653,9.88136e+12,59.9983,9410.42,30653,3491,72,25261,25261,15374,10966,7390
32046,6233,10539,11811,20235,0,32046,8.6569e+12,58.1272,12624.2,32046,5123,72,46946,46946,46946,46946,46946
10438,889,3336,10438,0,9828,610,3.39312e+18,94.2543,4130.44,10438,1165,122,7102,7102,5159,5732,2269
41501,2707,26882,0,41501,0,41501,1.46649e+18,5.52849,30834.6,41501,8970,13,40969,40969,40969,40969,40969
7723,391,3294,7375,348,7375,348,6.03668e+18,86.012,4018.22,7723,1566,101,4429,4342,4236,4429,0
28134,8,15,27312,822,28078,56,1.62018e+14,10.6291,555.353,28134,13,11,10607,2223,2227,1572,1971
21036,288,5493,7487,13549,0,21036,9.52758e+12,59.4872,7102.4,21036,2670,72,15543,15495,5210,12514,1142
46599,16323,17694,44399,2200,0,46599,1.80607e+18,93.8139,20672,46599,8595,110,28905,28905,27348,27013,25953
11742,71,701,0,11742,11400,342,4.00975e+16,27.5542,1785.31,11742,89,26,11041,11009,7824,7460,2722
38662,880,15202,36862,1800,36862,1800,4.19197e+18,95.432,17682.2,38662,7278,111,30940,30940,15797,14593,10504
14921,2667,4149,5358,9563,0,14921,9.33413e+12,59.1573,5360.76,14921,2016,72,10772,10772,8599,10392,6081
45623,5464,17142,0,45623,0,45623,5.27011e+17,95.6052,20086.3,45623,8318,110,44425,0,0,0,0
27280,929,7554,0,27280,9794,17486,2.38552e+15,59.2684,9496.36,27280,3670,72,22164,21878,11051,12963,2583
29598,13,17,0,29598,27130,2468,2.99986e+16,9.98922,564.825,29598,14,11,5028,1334,962,1032,305
48765,2960,17221,46365,2400,0,48765,1.88176e+18,83.8137,20411,48765,8353,110,47359,47359,47159,47159,47159
34209,7355,10411,32399,1810,32399,1810,3.23379e+18,96.0297,12970.6,34209,5051,110,27202,27202,26333,24911,24408
12448,4119,4758,12448,0,11788,660,4.34534e+18,119.16,5606.55,12448,1940,120,7690,7690,7227,7462,6689
33638,14,15,32646,992,33547,91,1.73589e+14,10.4622,605.447,33638,13,13,9960,4619,5291,6224,3668
8848,6,12,8584,264,8837,11,1.80407e+14,10.5728,281.922,8848,12,11,29358,0,35413,33539,25982
10473,1108,2538,0,10473,0,10473,6.48308e+17,96.8044,3652.9,10473,1217,110,7935,7935,5986,4325,3843
9495,2597,3717,0,9495,0,9495,5.19742e+17,89.5683,4602.58,9495,1771,103,5778,5778,5063,4717,4598
42969,2,18,41700,1269,42833,136,1.81997e+14,10.4948,743.711,42969,15,13,42621,42582,42122,35479,0
24588,4,12,23886,702,24577,11,1.38711e+14,10.5262,445.119,24588,12,11,21366,19121,15907,16272,10900
40772,5812,9543,0,40772,14334,26438,2.5301e+15,60.0227,12360.5,40772,4640,72,27817,27817,19925,18019,10976
20514,8,14,19915,599,20465,49,1.61525e+14,10.7127,465.909,20514,13,11,20110,19716,15990,15825,13626
4832,53,1639,4832,0,4552,280,4.07064e+18,92.5406,2123.95,4832,615,92,1999,476,961,1613,364
17596,3337,8831,0,17596,7010,10586,1.65559e+15,53.8043,9863.64,17596,4285,72,8765,8765,6388,4131,3673
30665,1,14,29789,876,30586,79,1.4278e+14,10.6716,547.171,30665,13,12,244,244,244,244,244
26312,2569,6310,0,26312,0,26312,6.43036e+17,97.5932,8547.91,26312,3044,110,20002,20002,14470,14382,8854
29096,316,9893,27633,1463,0,29096,1.92525e+18,96.0324,12057.9,29096,4794,110,19203,18773,11327,9765,2032
13201,1442,6721,12701,500,0,13201,1.44607e+18,90.711,7681.89,13201,3239,109,6480,6480,4122,3233,1870
19278,54,176,19264,14,19278,0,6.02913e+18,170.871,1700.41,19278,152,149,11169,5129,7216,6076,1023
24548,7692,8235,23296,1252,23296,1252,4.66631e+18,96.6131,10113.6,24548,3918,111,17687,17687,17687,17687,17687
10430,107,862,0,10430,10119,311,5.07236e+16,152.203,2206.89,10430,118,26,8107,8014,5430,5398,4189
20174,62,176,20116,58,20174,0,6.18111e+18,166.94,1750.42,20174,146,141,7335,2111,3471,5207,93
37115,7,15,36054,1061,37032,83,1.44268e+14,10.6341,616.306,37115,13,12,32666,29963,27616,24421,14941
34348,5627,14396,0,34348,13191,21157,1.91889e+15,57.0904,16357.5,34348,7012,72,34147,34147,34147,34147,34147
38027,4754,14850,0,38027,0,38027,5.17124e+17,95.3485,17352.1,38027,7214,110,44928,44928,44928,44928,44928
8425,4094,4261,3362,5063,0,8425,6.4511e+12,53.7568,4855.47,8425,2069,72,4164,4164,4079,4144,4057
12363,2527,5397,12363,0,11753,610,4.45255e+18,131.171,6142.56,12363,2191,121,6966,6904,5479,6213,4853
24830,4089,9011,0,24830,0,24830,5.40939e+17,95.5923,10877.8,24830,4369,110,15819,15819,12751,12897,8558
23582,78,5565,8296,15286,0,23582,9.86132e+12,59.9013,7371.67,23582,2708,72,18066,4240,6845,9343,533
20413,102,175,20404,9,20413,0,5.97604e+18,166.467,1691.76,20413,151,158,18348,11601,11127,11635,12114
11085,3192,4063,10038,1047,10538,547,4.18469e+18,95.5656,5068.05,11085,1930,111,7022,7022,30555,30752,28824
19020,4,10,18477,543,19014,6,1.38769e+14,9.96535,381.456,19020,10,10,16458,14566,14624,13132,9984
22591,3585,7832,22591,0,21343,1248,4.01516e+18,154.861,9131.72,22591,3140,121,20270,20270,17476,19466,12400
21766,4745,6657,0,21766,7924,13842,2.2973e+15,58.7928,8229.11,21766,3239,72,26507,2050,2050,2050,2050
2973,101,1104,2973,0,2809,164,3.6283e+18,90.1393,1449.69,2973,413,70,1971,736,1646,1141,516
22894,5447,7856,21742,1152,21742,1152,4.99652e+18,96.4203,9624.18,22894,3741,111,32037,32037,23263,28911,18695
32433,6268,10217,30732,1701,30732,1701,4.11155e+18,96.3648,12596.3,32433,4856,111,22216,22216,27281,28115,25316
23953,4845,5598,0,23953,8412,15541,2.52929e+15,59.9444,7434.69,23953,2715,72,19394,19394,19394,19394,19394
36772,816,1070,0,36772,35721,1051,3.55448e+16,222.682,3587.96,36772,163,26,31618,31618,21706,28738,17140
25447,2869,12478,25447,0,25447,0,3.03968e+17,17.9731,12938.6,25447,11215,20,18303,18303,10410,18303,3748
21513,5661,7053,21513,0,20255,1258,3.75608e+18,154.769,8190.46,21513,2569,121,28875,29595,0,0,0
23045,630,7351,23045,0,21722,1323,5.88787e+18,156.688,8695.09,23045,2847,125,28683,28425,17350,6934,3762
38228,6206,9148,35998,2230,35998,2230,4.58522e+18,98.3257,12075.9,38228,4329,111,31037,34640,34640,34640,34640
31283,39,208,31225,58,31283,0,6.06617e+18,200.32,2343.76,31283,173,168,30399,30199,27343,27418,19132
41638,1,6,40337,1301,41478,160,0.000120083,0.999856,488.401,41638,6,1,677,677,677,677,677
35526,9298,11882,0,35526,0,35526,5.62942e+17,96.1758,14424.8,35526,5760,110,23644,23644,21867,20622,20243
12167,8,12,0,12167,11151,1016,3.00266e+16,9.98077,340.796,12167,12,10,10942,9121,8371,9119,10259
33791,1034,11026,0,33791,0,33791,5.69888e+17,95.196,13499.7,33791,5333,110,31925,31925,31640,31635,30472
1675,113,494,1582,93,1582,93,5.7658e+18,88.5618,775.302,1675,213,52,1181,543,875,831,291
9317,153,208,9278,39,9317,0,6.09104e+18,188.121,1278.14,9317,121,123,8808,8288,7121,19632,19321
49682,8877,14944,49682,0,46789,2893,4.21278e+18,340.795,17332.1,49682,5919,130,41120,41120,41120,41120,41120
48997,7485,13947,0,48997,17670,31327,2.36055e+15,59.2004,17047.9,48997,6780,72,43232,43232,43232,43232,43232
36547,1111,11831,36547,0,34427,2120,5.26859e+18,258.009,13456,36547,4130,132,35347,35347,35320,35347,35326
47461,3948,15557,45038,2423,0,47461,1.95541e+18,96.4109,18777.8,47461,7554,110,43149,43149,42792,42888,42796
13993,1472,5447,13336,657,13336,657,7.94223e+18,94.8772,6625.35,13993,2636,110,32493,32493,32493,32493,32493
42670,13547,19788,0,42670,0,42670,4.5391e+17,92.1782,22272.2,42670,9599,110,34529,34529,34529,34529,34529
40667,3682,9727,38297,2370,38297,2370,3.91391e+18,98.3257,12801.8,40667,4604,111,25371,25371,16753,14876,6793
38014,1101,10435,35921,2093,0,38014,2.11063e+18,97.1556,13304.6,38014,5053,110,34283,34283,29368,27107,26124
7060,62,315,0,7060,6859,201,3.5743e+16,19.8955,894.204,7060,53,26,0,0,0,0,0
24082,4359,7789,22832,1250,22832,1250,4.88781e+18,96.8041,9668.66,24082,3714,111,25968,25968,17299,9344,5841
32715,5862,12534,32715,0,31043,1672,4.30902e+18,273.622,14227.5,32715,4462,136,20181,20028,15328,16556,10492
1499,60,170,1498,1,1499,0,5.97343e+18,121.466,456.601,1499,62,55,984,529,459,528,482
19392,7624,7958,18519,873,0,19392,1.72552e+18,94.6545,9422.36,19392,3845,110,36248,36248,31988,30350,22573
23483,59,176,23470,13,23483,0,5.98181e+18,169.561,1817.71,23483,156,162,16153,8418,6761,8025,8052
5912,1255,2392,0,5912,2249,3663,1.98581e+15,52.3095,2918.78,5912,1144,72,3520,3520,3001,2854,2328
36637,6249,8781,34504,2133,34504,2133,3.15068e+18,98.3052,11613.4,36637,4161,111,33828,33828,33828,0,0
9447,128,176,9408,39,9447,0,6.06794e+18,164.734,1200.36,9447,118,121,8982,8399,7393,7420,7363
20911,1885,4877,0,20911,7346,13565,2.53674e+15,59.9659,6527.09,20911,2375,72,14739,14739,9997,4752,4491
45331,26388,45331,45331,0,45331,0,3.4359e+10,0,45331,45331,45331,1,35610,35430,35430,35430,30292
48643,6424,11370,0,48643,0,48643,6.47597e+17,97.9039,15014.7,48643,5514,110,34568,34568,28454,27346,21089
23518,11740,12409,23518,0,22598,920,5.05932e+18,332.843,13574.5,23518,3975,131,11109,11109,11105,11108,10506
46033,4021,21922,0,46033,0,46033,4.43321e+17,91.9175,24507.1,46033,10641,110,43682,43682,43682,43682,43682
48400,19,206,48373,27,48368,32,5.97749e+18,192.494,2694.45,48400,187,178,27737,17037,18196,17974,17705
29971,86,176,29955,16,29971,0,5.98266e+18,169.688,2051.66,29971,167,164,25710,17707,14888,15445,15869
38339,2,14,37231,1108,38316,23,1.55417e+14,10.2873,582.051,38339,13,12,2481,331,181,189,737
27331,2065,8646,0,27331,10002,17329,2.26172e+15,58.6467,10505.3,27331,4203,72,18685,18685,12679,9027,5500
35912,13034,17816,34522,1390,34522,1390,2.89327e+18,93.7884,19850.2,35912,8569,111,20288,20288,17784,18879,17721
43389,151,206,43306,83,43389,0,5.9843e+18,193.7,2566.96,43389,181,184,35255,35032,14168,23714,2634
36960,6847,8654,34809,2151,0,36960,2.22801e+18,97.7995,11583.2,36960,4192,110,24497,24497,18119,15153,10582
24839,317,7685,24839,0,23389,1450,3.60909e+18,166.129,9109.97,24839,2952,124,17154,17003,6011,11345,1223
1113,310,327,0,1113,390,723,2.34559e+15,54.0243,504.881,1113,145,44,786,786,786,786,786
49101,692,2152,0,49101,47652,1449,4.53543e+16,333.974,7076.84,49101,377,26,49028,49028,49028,49028,49028
14516,4566,7124,0,14516,3184,11332,1.33685e+13,8.97734,7371.83,14516,6403,11,7392,7392,5367,7392,5131
23225,152,176,23206,19,23225,0,6.05144e+18,170.404,1868.84,23225,151,158,23877,23604,7720,9821,972
48911,9553,11382,0,48911,17198,31713,2.53356e+15,60.0982,14664,48911,5544,72,46748,46748,46748,46748,46748
34012,2,15,33042,970,33959,53,1.43998e+14,10.6461,585.474,34012,13,11,19065,18521,18584,18518,18496
34170,8008,11297,32429,1741,0,34170,1.95034e+18,96.2514,13774,34170,5482,110,28236,28236,24198,23217,17892
4852,369,1263,0,4852,0,4852,6.42347e+17,95.0987,1890.02,4852,590,85,3589,3589,2450,899,1442
8196,149,2039,0,8196,0,8196,6.38358e+17,96.2189,2967.43,8196,962,104,6157,6075,3668,1017,915
7887,1455,1863,0,7887,2764,5123,2.53602e+15,59.4548,2640.74,7887,902,72,6024,6024,5525,5076,4881
16554,1444,3932,0,16554,0,16554,6.49979e+17,97.3411,5504.35,16554,1895,110,12622,12622,8705,7888,5439
27456,13702,16506,0,27456,11441,16015,1.31976e+15,52.9652,17732.6,27456,8033,72,18215,18215,18215,18215,18215
32431,6007,7809,30544,1887,30544,1887,2.95708e+18,98.198,10382,32431,3680,111,33285,33285,33285,33285,33285
21160,111,176,21148,12,21160,0,6.11163e+18,170.079,1800.56,21160,149,145,20987,20926,5838,6460,2244
25990,65,176,25911,79,25990,0,6.03893e+18,172.297,1980.58,25990,156,161,19386,11932,8779,9759,9265
43145,9241,12325,15571,27574,0,43145,9.21175e+12,59.2471,15116.5,43145,6004,72,31195,31195,28797,25386,25240
22472,140,175,22467,5,22472,0,5.98211e+18,166.666,1773.68,22472,159,156,18499,6452,5989,8924,777
5252,748,1745,1927,3325,0,5252,8.81215e+12,57.6319,2265.43,5252,845,72,3507,3507,2955,3407,2493
10091,4357,5366,0,10091,0,10091,4.04454e+17,92.019,6131.7,10091,2590,103,4725,4725,4619,4557,4623
41962,4579,9808,14755,27207,0,41962,9.87621e+12,60.052,12697.9,41962,4772,72,40391,40391,40391,40391,40391
31723,942,1699,9499,22224,0,31723,6.91398e+18,15.9949,2366.8,31723,888,26,36795,36795,36795,36795,36795
31319,199,14823,20287,11032,30049,1270,2.52537e+18,94.4456,16716.4,31319,7145,111,28278,26815,10098,794,97
1222,123,338,426,796,0,1222,9.73083e+12,55.3822,531.675,1222,158,47,884,884,526,759,373
17492,1489,4241,16472,1020,16472,1020,5.31281e+18,97.9006,5850.27,17492,1996,111,13251,13251,8011,9472,5316
23789,86,1341,0,23789,0,23789,3.78345e+18,15.9854,1912.63,23789,987,18,22448,22448,10148,9198,8010
14657,3717,4575,5354,9303,0,14657,8.90353e+12,58.581,5723.29,14657,2223,72,10082,10082,9341,9953,8632
14561,7696,7809,14041,520,14041,520,2.93574e+18,93.1579,8790.35,14561,3750,111,6752,6752,6585,6641,6638
22905,2279,10948,21985,920,21985,920,5.07776e+18,91.6071,12439.9,22905,5245,111,28922,28922,19919,10440,8747
30359,330,1541,0,30359,29461,898,4.6502e+16,287.022,4784.58,30359,256,26,28698,27801,24308,19990,10425
25604,611,834,0,25604,25189,415,2.50333e+16,3.73625,3232.17,25604,419,4,21941,21797,8716,17648,2233
29618,15,208,29604,14,29618,0,6.02242e+18,198.861,2237.23,29618,170,167,7648,848,75,2860,709
16509,2860,3926,15548,961,0,16509,2.22843e+18,97.2458,5494.28,16509,1885,110,12583,12583,11161,10907,9683
17280,2116,9595,17280,0,17280,0,1.88358e+17,17.942,9941.08,17280,8623,20,7685,7685,1879,1743,1799
26259,2551,12555,0,26259,10355,15904,1.72213e+15,56.0904,14014.1,26259,6110,72,18085,18085,14102,14857,7175
11905,1261,2874,11215,690,0,11905,2.2204e+18,96.9305,4102.29,11905,1375,110,9031,9031,6907,6468,4600
36749,1,14,35692,1057,36672,77,1.49052e+14,10.3586,587.586,36749,13,12,7008,7008,7008,7008,7008
8038,77,127,0,8038,7382,656,2.93503e+16,10.1704,408.206,8038,126,11,7911,7911,7669,7196,7805
25635,8061,8389,25635,0,24145,1490,3.21887e+18,167.728,9659.12,25635,3067,125,17246,17246,17244,17242,16918
3256,505,808,1142,2114,0,3256,9.91139e+12,58.2936,1208.44,3256,387,63,2448,2448,2078,2368,1669
3535,178,928,3328,207,3328,207,5.88655e+18,94.5918,1423.88,3535,422,76,2607,2607,1217,1746,804
13848,1760,3225,4859,8989,0,13848,9.92461e+12,59.8076,4419.83,13848,1567,72,10623,10623,8827,10245,5981
20681,40,199,20609,72,20681,0,5.9777e+18,180.837,1764.46,20681,160,158,12265,1866,6630,2997,505
31724,5366,8192,31724,0,31724,0,4.57706e+15,6076.6,16104.3,31724,8192,5,16095,36798,36798,36798,36798
1836,501,532,0,1836,0,1836,6.26695e+17,89.384,834.847,1836,227,55,1304,1304,1301,1302,1300
33790,128,176,33771,19,33790,0,6.04228e+18,172.817,2253.04,33790,164,167,33601,33545,33452,33391,33373
5304,64,247,0,5304,5151,153,3.58794e+16,19.8041,701.161,5304,47,26,5057,5057,4352,4415,1805
34748,10278,16758,13736,21012,0,34748,6.6642e+12,56.0375,18563.8,34748,8151,72,44187,44187,44187,44187,44187
13999,470,949,0,13999,13582,417,4.76232e+16,185.505,2578.82,13999,136,26,13050,12744,12087,11331,8911
32332,1654,7592,30450,1882,0,32332,2.22876e+18,97.7355,10226.5,32332,3671,110,31921,31921,31921,31921,31921
23083,3650,6878,8379,14704,0,23083,9.05067e+12,58.8874,8544.14,23083,3334,72,21354,21354,18352,20697,13028
42129,19193,19510,16526,25603,0,42129,6.93435e+12,56.4087,21679.3,42129,9499,72,23292,23292,22983,23235,22224
39938,7221,9546,37608,2330,37608,2330,1.25255e+18,98.3616,12577.4,39938,4516,111,27294,27294,19650,12362,11030
46310,824,1243,0,46310,44990,1320,3.55138e+16,255.493,4347.62,46310,197,26,34624,34480,13942,27628,872
6407,46,351,0,6407,6224,183,3.82051e+16,19.6861,934.665,6407,56,26,6056,6048,5125,4821,1632
9476,9,11,9198,278,9470,6,1.62897e+14,10.3873,284.043,9476,11,11,9352,9205,8346,8374,8390
18757,5865,7870,0,18757,0,18757,4.94529e+17,94.5135,9277.93,18757,3811,110,17304,17304,17304,17304,17304
16123,5687,5876,15335,788,0,16123,1.86335e+18,95.3422,7221.18,16123,2844,110,29021,29021,24734,23922,19630
6170,413,1539,2174,3996,0,6170,9.70454e+12,58.9002,2179.78,6170,735,72,4631,4631,2459,4027,1409
24249,10153,13446,0,24249,0,24249,3.48963e+15,17.8442,13859.6,24249,12092,20,10803,10803,8118,10803,8098
39548,90,176,39468,80,39548,0,5.9828e+18,172.186,2357.54,39548,169,171,21482,5088,7667,11985,901
30547,8712,12455,30547,0,24083,6464,3.90322e+18,207.755,13819.8,30547,4694,133,33168,33156,31137,37016,0
31648,1267,7440,29806,1842,29806,1842,5.89106e+18,97.7353,10029.3,31648,3603,110,29016,23541,23541,49137,49137
19264,5939,6941,0,19264,0,19264,5.43154e+17,94.186,8491.49,19264,3343,110,12323,12323,11530,10413,10558
12388,1705,6925,0,12388,0,12388,3.77403e+17,91.9851,7776.23,12388,3346,108,5463,5463,2979,2624,1639
26452,4883,6155,9296,17156,0,26452,9.88843e+12,60.0001,8146.99,26452,2985,72,20297,20297,18449,19977,16340
2750,9,11,2673,77,2749,1,1.51587e+14,10.5847,149.616,2750,11,11,2702,2671,2221,2236,2380
16555,4232,7511,15865,690,15865,690,2.58754e+18,91.4769,8742.11,16555,3630,110,39749,39749,39749,39749,39749
34644,8348,11179,32793,1851,32631,2013,4.69773e+18,240.852,12742.9,34644,2076,129,22170,21964,17523,19345,15219
17878,3356,4231,0,17878,0,17878,6.47523e+17,97.4106,5904.73,17878,2035,110,13647,13647,12553,11868,11582
11528,2164,2782,10858,670,0,11528,2.22398e+18,96.9434,3981.51,11528,1332,110,8746,8746,7931,7767,7238
10976,1093,5287,10536,440,10536,440,2.53673e+18,92.0515,6163.25,10976,2537,110,26274,26274,12866,16945,5026
35891,2876,10787,33965,1926,33965,1926,4.39314e+18,97.3686,13399.4,35891,5147,111,25104,25104,13502,16555,7775
10568,5897,6053,10568,0,10188,380,3.98444e+18,149.23,6693.72,10568,2750,111,29014,29014,28993,29012,0
48201,13,18,46785,1416,48067,134,1.70049e+14,10.4229,755.145,48201,14,13,21111,12957,13312,13339,10258
10210,430,2424,9612,598,0,10210,2.23739e+18,96.8778,3523.71,10210,1156,110,7786,7786,3467,3161,1904
27947,1978,7036,9908,18039,0,27947,9.66305e+12,59.7,9071.86,27947,3422,72,21387,21387,16865,14345,11697
49943,9456,13739,0,49943,0,49943,6.1291e+17,97.256,17300.6,49943,6669,110,22990,22990,16222,11261,9433
26699,2428,15297,25829,870,25829,870,1.07191e+19,90.5758,16759.9,26699,7430,110,29607,29607,29607,29607,29607
45865,7124,10751,43202,2663,0,45865,2.22532e+18,97.8524,14224.4,45865,5207,110,26932,26932,21856,15692,15721
21195,7861,7956,21195,0,20045,1150,5.53725e+18,154.802,9045.77,21195,2684,128,26504,26504,24713,23673,22516
21342,9669,12133,21342,0,21342,0,3.26738e+18,17.9337,12509.6,21342,10903,20,9209,9209,7347,9209,7398
10371,1965,4453,10371,0,9861,510,3.67211e+18,111.381,5173.22,10371,1868,115,5918,5893,4166,4826,3233
37702,6560,10612,35624,2078,35624,2078,2.38902e+18,97.6863,13383.8,37702,5055,111,37190,37190,37190,37190,37190
35979,11363,14769,0,35979,0,35979,5.01178e+17,94.5753,17102.7,35979,7176,110,26650,26650,26650,26650,26650
34531,29,176,34467,64,34531,0,6.11827e+18,172.706,2300.6,34531,165,163,8960,873,226,3932,0
44732,4706,18799,44732,0,43445,1287,4.9699e+18,5217.48,24448.9,44732,7861,154,21865,26456,18194,20011,8260
21623,2835,6842,0,21623,7907,13716,2.25226e+15,58.5976,8390.54,21623,3319,72,14781,14781,9900,8104,5467
24035,3088,5642,0,24035,0,24035,6.4837e+17,97.601,7738.17,24035,2724,110,18465,18465,12137,17121,4115
36874,60,1071,0,36874,35824,1050,3.55403e+16,222.59,3597.5,36874,163,26,17776,6575,9543,15750,3848
46491,8721,15139,46491,0,43881,2610,4.42083e+18,307.527,17364.6,46491,4456,137,45952,45952,45952,0,0
16391,2449,8084,0,16391,6507,9884,1.67136e+15,55.702,9077.31,16391,3921,72,26721,26721,24559,23468,8248
41781,18704,21990,40271,1510,0,41781,1.38288e+18,93.23,24205.3,41781,10694,110,41192,41192,41192,41192,41192
14348,928,6233,0,14348,0,14348,4.81014e+17,92.9121,7370.17,14348,3002,110,8115,7943,4392,2256,1380
27237,5731,13781,27237,0,26105,1132,4.57427e+18,209.078,15022.9,27237,3190,137,13456,13257,12308,12354,11436
12674,1939,4040,4636,8038,0,12674,8.84473e+12,58.4141,5059.8,12674,1959,72,8339,8339,6030,3607,2798
27415,9,15,26592,823,27356,59,1.93362e+14,10.3689,561.515,27415,12,12,7685,3024,641,2804,41
11501,2466,3356,0,11501,0,11501,6.03292e+17,95.7719,4493.04,11501,1611,110,8145,8145,6942,5867,5776
43681,11,15,42421,1260,43592,89,1.53429e+14,10.4942,687.969,43681,14,12,40258,32670,32374,32753,31867
42894,400,1181,0,42894,41672,1222,3.55248e+16,244.973,4077.09,42894,184,26,33855,33308,27061,29962,22861
35899,4,12,34871,1028,35885,14,1.41808e+14,10.2109,539.059,35899,12,11,3530,1125,60,92,20
19972,301,825,0,19972,19399,573,3.74359e+16,122.322,2401.46,19972,114,26,19147,18989,15459,15517,10786
25791,28,176,25734,57,25791,0,6.07889e+18,148.893,1985.43,25791,157,154,13052,3690,4502,5366,5478
49329,4642,20725,0,49329,18974,30355,1.91276e+15,56.3648,23353.2,49329,10085,72,32298,32298,23717,23603,18059
4597,101,206,0,4597,4466,131,3.54253e+16,19.7825,600.087,4597,43,26,4391,4391,3745,3775,2608
4868,1470,1818,0,4868,1814,3054,2.09904e+15,55.9723,2289.96,4868,865,67,3050,3050,2698,2546,2444
13665,2158,5738,13665,0,12974,691,3.62106e+18,123.324,6541.12,13665,2302,121,7927,7860,5584,6468,4534
33432,6457,10660,31702,1730,0,33432,1.98258e+18,96.2644,13133.8,33432,5152,110,24170,24092,20053,22469,14466
22590,3160,10026,22590,0,21540,1050,4.6977e+18,202.616,11254.7,22590,2954,134,15319,15210,13030,14252,9962
1395,7,71,0,1395,1355,40,3.56931e+16,18.8717,219.548,1395,27,26,1170,1034,733,756,360
18161,16348,18161,18161,0,18161,0,34357800000,0,18161,18161,18161,1,13331,13331,13331,13331,13331
13288,6,11,12902,386,13280,8,1.49486e+14,10.0373,327.604,13288,11,11,12686,12365,9714,9501,8477
49910,2019,14247,47200,2710,0,49910,2.07783e+18,95.863,17764.9,49910,6916,110,38384,38384,25560,12784,9473
40548,16162,20074,0,40548,16120,24428,1.6675e+15,55.1326,22077.4,40548,9760,72,20474,20474,19283,17624,17462
49690,10,176,49626,64,49690,0,6.04573e+18,173.857,2741.13,49690,173,175,15616,10159,9702,12252,9263
40180,2380,13341,38140,2040,38140,2040,3.11777e+18,96.3196,16153,40180,6480,110,26839,26839,13317,18811,7723
10805,212,4070,0,10805,4056,6749,2.0658e+15,57.4131,4917.45,10805,1974,72,10435,10435,10421,10415,10123
34112,1884,12604,12813,21299,0,34112,8.11618e+12,57.8454,14689.2,34112,6126,72,23795,23795,12838,16107,7991
41953,3333,11027,39588,2365,39588,2365,4.36468e+18,97.9441,14098.7,41953,5230,111,24846,24846,17621,10748,10412
20472,2910,9821,19659,813,19659,813,9.46283e+18,91.7097,11209.6,20472,4760,110,28912,28912,19807,22708,10626
707,8,11,686,21,705,2,2.28126e+14,7.08911,78.1699,707,10,10,692,690,643,641,634
42854,1562,15790,42854,0,40546,2308,4.4122e+18,316.838,17571.4,42854,3929,136,27039,39921,39921,39921,39921
21431,10001,11026,8598,12833,0,21431,6.30705e+12,55.4929,12199.6,21431,5370,72,10405,10405,9151,10136,7209
22686,5673,6272,0,22686,0,22686,6.13325e+17,96.8706,8196.87,22686,3029,110,16414,16414,15836,15345,15185
40651,12877,17906,40651,0,39031,1620,4.84704e+18,2205.82,20868.8,40651,6430,144,40201,0,0,19451,19451
44964,4218,10492,15806,29158,0,44964,9.88724e+12,60.0759,13549.8,44964,5110,72,38602,38602,35949,35271,33669
47392,8,15,46001,1391,47321,71,1.71954e+14,10.3497,749.958,47392,13,11,40577,37004,31569,28949,11311
35539,244,13397,35539,0,33709,1830,4.88735e+18,299.694,15208.5,35539,3263,136,21019,19251,9237,13034,1150
33651,15796,15973,0,33651,0,33651,4.4491e+17,93.9294,18005.9,33651,7751,110,17678,17678,17484,17567,17457
20208,4526,7983,0,20208,7679,12529,2.00463e+15,57.3667,9314.21,20208,3888,72,12225,12225,10532,9320,7849
10669,4877,5734,10289,380,10289,380,2.4271e+18,90.7327,6526.59,10669,2752,103,27376,27376,22455,18016,15920
32987,2952,7744,31067,1920,31067,1920,5.76574e+18,97.7635,10420.8,32987,3744,110,25243,25243,22349,21869,10702
5085,356,1722,1877,3208,0,5085,8.68406e+12,57.6012,2229.68,5085,834,72,3363,34684,33446,34194,32007
23462,5092,7167,22212,1250,22212,1250,3.95309e+18,97.0656,9047.89,23462,3411,111,36043,36043,29148,34481,16932
26127,212,871,0,26127,25383,744,3.55007e+16,153.495,2712.69,26127,123,26,25232,25045,21660,21768,10407
32731,4103,13705,0,32731,0,32731,4.9255e+17,94.8365,15854.3,32731,6652,110,19026,18940,11747,2699,2934
47207,8180,11325,44460,2747,44460,2747,5.2618e+18,98.3386,14779.3,47207,5355,117,43303,43303,43303,43303,43303
21861,11867,21861,0,21861,0,21861,524264,0,21861,21861,21861,1,30124,30124,30124,30124,30124
8725,37,176,8719,6,8725,0,6.1015e+18,164.059,1153.38,8725,113,118,5001,1605,1731,2078,1807
30426,115,176,30402,24,30426,0,6.08385e+18,172.338,2156.45,30426,165,162,25650,25468,20171,17923,17407
42482,127,208,42420,62,42482,0,6.06292e+18,202.719,2715.61,42482,184,182,38678,32888,33566,27178,27744
20722,2030,10869,8342,12380,0,20722,6.14748e+12,55.2968,11998.9,20722,5289,72,32639,32639,32639,32639,32639
8774,299,2171,0,8774,0,8774,6.41751e+17,96.2898,3145.28,8774,1026,109,6603,6603,4146,1767,1389
21109,146,10359,21109,0,21109,0,2.35374e+18,17.9728,10776.8,21109,9312,20,10750,10750,114,10750,177
869,170,301,819,50,819,50,5.84639e+18,81.2106,463.848,869,123,42,568,568,538,538,414
39078,16,176,39015,63,39078,0,6.08317e+18,173.216,2443.98,39078,167,168,15207,5587,6406,7036,3095
26291,4824,6162,0,26291,9248,17043,2.53035e+15,60.0006,8139.62,26291,3001,72,20129,20129,27703,26674,25449
33716,644,1110,0,33716,33163,553,2.51035e+16,3.73674,4271.54,33716,556,4,33505,33505,33505,33505,33505
1669,137,468,0,1669,0,1669,6.66805e+17,90.0258,752.936,1669,209,54,1201,823,601,504,514
4036,909,1088,3806,230,3806,230,3.37138e+18,92.3575,1635.45,4036,488,81,2948,2948,2649,2779,2676
22752,5036,5540,21429,1323,21429,1323,3.5325e+18,97.9208,7493.76,22752,2615,111,46784,46784,46784,46784,46784
45455,1094,1232,0,45455,44161,1294,3.55715e+16,254.511,4294.07,45455,194,26,44223,44223,43832,43812,41387
19970,1750,10563,0,19970,4334,15636,1.35298e+13,8.91222,10842.4,19970,9502,11,9407,9407,3305,9407,2759
36826,6541,10329,34806,2020,34806,2020,6.43021e+18,97.0941,13106.7,36826,5005,110,26491,26491,22532,25821,17346
38008,15455,19574,0,38008,0,38008,4.11473e+17,93.3532,21671.6,38008,9514,110,22292,22292,22270,22272,22270
35534,2471,9503,33554,1980,33554,1980,3.3631e+18,97.265,12243.6,35534,4599,110,26031,25753,13200,18642,7353
41349,146,1742,0,41349,40136,1213,4.35737e+16,299.766,5676.7,41349,293,26,28695,14196,15311,20593,7102
6994,2319,2464,6644,350,6644,350,1.98307e+18,84.1363,3201.12,6994,1148,93,4530,4530,32682,32419,32351
9891,315,626,9891,0,9488,403,2.56154e+18,17.883,1005.82,9891,413,21,7040,9014,0,0,0
15579,5273,7129,15579,0,14849,730,4.83536e+18,138.789,7975.98,15579,2387,125,9277,9200,7954,8689,6672
24118,1317,7944,24118,0,22718,1400,5.45041e+18,163.706,9165.11,24118,2894,125,28396,28396,28396,28396,28396
5593,787,2921,5593,0,5363,230,4.61387e+18,91.9026,3355.42,5593,1252,88,2672,2499,1426,1903,964
49564,15056,18593,0,49564,18670,30894,2.06158e+15,57.4837,21397.8,49564,9052,72,40480,40480,40480,40480,40480
10759,687,2523,0,10759,3776,6983,2.5427e+15,59.6916,3506.91,10759,1225,72,35253,35253,21679,7743,3922
30505,36,1186,0,30505,29624,881,3.98e+16,251.16,3755.98,30505,185,26,28752,28682,22646,19488,5087
1643,15,159,0,1643,1594,49,4.65326e+16,18.1449,382.731,1643,38,24,1441,1295,995,904,315
37942,10411,11766,35950,1992,35950,1992,7.0153e+18,96.6188,14518.3,37942,5710,110,25691,25691,21308,22057,20127
6603,7,11,6414,189,6597,6,1.38201e+14,10.6679,228.317,6603,11,11,6340,6128,4724,4658,4713
7890,1623,1862,2766,5124,0,7890,9.90259e+12,59.452,2640.99,7890,901,72,6028,6028,5689,5968,5451
39950,4035,18084,0,39950,0,39950,4.63455e+17,93.7987,20480.3,39950,8782,110,39920,39920,39920,39920,39920
35520,56,96,35424,96,27328,8192,2.26125e+18,60.6537,1723.05,35520,62,61,26532,26479,20796,24847,19801
14972,539,3927,0,14972,5332,9640,2.4467e+15,59.3905,5156.99,14972,1912,72,10503,10503,7336,8096,7353
3610,2,11,3508,102,3606,4,1.41673e+14,10.1537,168.814,3610,11,11,3323,1061,1003,1068,792
638,6,11,618,20,637,1,2.21474e+14,6.94044,73.0141,638,10,10,616,606,559,553,540
16130,3668,3942,15195,935,15195,935,4.56513e+18,97.7034,5451.93,16130,1847,111,12188,12188,11724,11846,11721
2993,8,10,2907,86,2993,0,1.68434e+14,9.82593,157.555,2993,10,10,2931,2905,2793,2794,2296
38826,4723,15944,0,38826,0,38826,4.98849e+17,93.5296,18428.2,38826,7726,110,22882,22882,14963,11509,7677
41155,13995,17645,0,41155,15879,25276,1.88589e+15,56.1212,19883.9,41155,8576,72,43822,43822,43822,43822,43822
24638,3813,5764,0,24638,0,24638,6.50562e+17,97.6943,7901.12,24638,2788,110,27197,27197,18140,19003,12961
8828,11,13,8572,256,8791,37,1.52662e+14,10.9199,287.974,8828,12,11,8815,8813,8796,8796,8657
36209,16,18,35123,1086,36105,104,1.93618e+14,10.5347,685.705,36209,14,12,34920,33805,31559,30781,22238
5238,71,1776,4968,270,4968,270,3.12131e+18,83.6296,2388.32,5238,842,84,2612,12199,12711,13420,11720
28545,173,176,28486,59,28545,0,6.14986e+18,172.142,2083.53,28545,152,156,32119,31070,27818,27969,27983
48218,164,176,48193,25,48218,0,6.00612e+18,173.04,2648.52,48218,173,173,38288,38045,29415,23062,8683
14897,4012,5200,14897,0,14047,850,4.39676e+18,123.125,6089.21,14897,1924,121,9697,9697,8623,9120,7894
40562,5304,9489,14267,26295,0,40562,9.88205e+12,60.0463,12296.7,40562,4617,72,30912,30912,25123,17520,15110
8570,257,507,0,8570,0,8570,3.77505e+18,15.9628,843.409,8570,361,18,8535,8535,8535,8535,8535
21496,7466,7644,20436,1060,0,21496,1.88356e+18,95.6292,9330.95,21496,3705,110,13852,13852,13635,13627,13580
8948,164,2158,3154,5794,0,8948,9.87023e+12,59.4927,3010.07,8948,1045,72,6790,6775,3951,6300,641
37344,14,16,36247,1097,37282,62,1.75168e+14,10.4053,642.539,37344,14,12,9108,1457,467,3531,138
12082,275,8975,12082,0,11832,250,5.08293e+18,196.477,9542.02,12082,4346,97,3080,2655,1621,2228,854
31398,4707,10163,31398,0,29568,1830,4.62548e+18,209.342,11621.6,31398,3719,124,32278,32278,32278,32278,32278
47758,1107,1274,0,47758,46395,1363,3.55656e+16,260.823,4477.4,47758,204,26,41719,41719,35052,29135,26375
42469,7678,13598,40271,2198,0,42469,1.97952e+18,96.5041,16569.2,42469,6606,110,41208,41208,41208,41208,41208
2500,185,968,2380,120,2380,120,3.81067e+18,82.8696,1308.35,2500,427,67,1532,1500,530,874,197
41924,1721,11317,39597,2327,39597,2327,3.25983e+18,97.2749,14432.5,41924,5485,110,34228,34228,23325,28454,15477
32349,17244,17418,32349,0,32349,0,2.44307e+18,17.9781,17910.8,32349,15666,20,23536,23536,21886,22697,19519
1405,5,11,1362,43,1405,0,1.37833e+14,10.3993,104.377,1405,11,11,1292,1158,940,960,769
5318,1287,4974,1653,3665,0,5318,9.19779e+12,3.94584,5007.31,5318,1667,9,344,344,86,344,91
22940,107,1297,0,22940,22254,686,4.74123e+16,276.024,3859.34,22940,208,26,21086,20849,16454,13434,5719
44530,170,176,44442,88,44530,0,6.05363e+18,171.202,2600.18,44530,172,169,45948,45948,36716,35394,16407
19355,4517,4686,18227,1128,18227,1128,3.33675e+18,97.9266,6420.37,19355,2206,111,14669,14669,14526,14657,14442
18242,329,5978,0,18242,6707,11535,2.21679e+15,58.3727,7317.22,18242,2899,72,23236,22150,9825,7450,1300
30941,2495,7280,29141,1800,0,30941,2.22714e+18,97.7207,9823.42,30941,3525,110,23661,23661,17152,16187,9185
24881,1740,9818,0,24881,9457,15424,2.00963e+15,57.4245,11385.3,24881,4783,72,16260,16260,10223,11074,3507
38117,10433,17178,38117,0,36427,1690,4.74314e+18,500.062,19117,38117,5133,138,20542,18091,15134,16925,12142
18916,2451,4472,0,18916,0,18916,6.49731e+17,97.4252,6211.84,18916,2160,110,14444,14444,12232,9219,8741
24854,3805,9912,23714,1140,23714,1140,2.79899e+18,94.0985,11701.3,24854,4805,110,13723,13723,10098,12718,6070
26069,529,870,0,26069,25323,746,3.54995e+16,153.766,2706.98,26069,122,26,29116,29116,9050,23356,2209
17725,12,14,17205,520,17654,71,1.70934e+14,10.3816,420.71,17725,13,12,17710,17705,17284,17284,16689
17936,66,176,17861,75,17936,0,6.05001e+18,170.574,1644.1,17936,148,149,20375,6113,6957,12918,1338
3720,106,175,3718,2,3605,115,6.00387e+18,147.945,726.967,3720,92,90,3287,2234,2136,2231,2241
27975,5811,8135,26455,1520,26455,1520,2.38332e+18,97.3986,10316.9,27975,3875,111,19840,19840,17393,19681,13826
25919,2500,7904,0,25919,9434,16485,2.29827e+15,58.8233,9710.65,25919,3840,72,24471,24471,17590,16384,9279
13309,2049,3210,12529,780,12529,780,3.68335e+18,97.5734,4523.36,13309,1500,111,10099,10099,8946,10014,7058
29400,165,176,29383,17,29400,0,6.01539e+18,172.726,2079.6,29400,160,167,19093,18986,11135,17652,789
48775,4680,15013,46213,2562,0,48775,2.01255e+18,96.5216,18381.1,48775,7274,110,32728,32728,21289,16475,9893
42682,8997,16890,16236,26446,0,42682,7.79953e+12,57.4938,19304.3,42682,8224,72,42398,42398,42398,42398,42398
1497,339,427,1407,90,1407,90,3.35199e+18,89.3113,688.921,1497,184,51,1070,1070,959,1000,1005
30980,12889,17582,29960,1020,0,30980,1.2637e+18,92.4358,19230.4,30980,8540,110,29131,29131,29131,29131,29131
20328,3982,6604,19281,1047,19281,1047,3.00601e+18,96.0779,8280.94,20328,3187,110,24778,24778,20320,24010,13590
33230,2209,16310,33230,0,31907,1323,4.9192e+18,599.681,18153.4,33230,6371,139,25273,25273,22264,21637,18751
34583,3994,9380,32653,1930,32653,1930,2.86889e+18,97.7765,12003.5,34583,4457,111,27276,27276,23786,26861,17707
48111,7953,11212,0,48111,16912,31199,2.53053e+15,60.0783,14448.9,48111,5455,72,32088,32006,28406,28455,25196
3444,72,186,3443,1,3444,0,5.97735e+18,156.302,709.122,3444,92,88,2575,1457,1201,1397,1321
44395,9998,10331,41805,2590,0,44395,2.23191e+18,97.9162,13721.8,44395,5014,110,31161,31161,27437,25628,21465
43115,8633,11882,40737,2378,40737,2378,3.28843e+18,97.2099,15042.9,43115,5765,110,43007,43007,43007,43007,43007
16913,5585,5628,16913,0,15933,980,5.12397e+18,135.428,6603.16,16913,2024,121,26177,26177,18931,12750,11097
36519,7007,12887,0,36519,0,36519,5.48639e+17,95.0669,15429.4,36519,6242,110,23632,23632,19093,15104,14062
48906,772,11449,46066,2840,0,48906,2.22537e+18,97.8801,15108.1,48906,5544,110,48440,48440,48440,48440,48440
39196,3843,14375,14698,24498,0,39196,8.14684e+12,57.9048,16714.7,39196,6987,72,28235,27844,16573,19031,7388
11087,1420,2639,0,11087,0,11087,6.47594e+17,96.8193,3806.66,11087,1255,110,8448,8448,7085,6933,5069
7857,2938,3003,7857,0,7427,430,5.65266e+18,91.852,3590.06,7857,1128,113,4854,4854,4850,4854,4843
44119,1862,23390,42539,1580,0,44119,1.37024e+18,89.8494,25686.7,44119,11359,110,28826,28826,20499,12873,10922
3210,486,783,1123,2087,0,3210,1.00522e+13,58.5131,1181.87,3210,380,62,2427,2427,2000,2347,1655
15033,7,12,14600,433,15025,8,1.56812e+14,10.1718,357.867,15033,12,11,14589,14275,13014,12045,10057
46064,2028,10722,0,46064,0,46064,6.49215e+17,97.9087,14212.2,46064,5203,110,45729,45729,45729,45729,45729
36540,8644,11243,0,36540,0,36540,5.84898e+17,96.6135,13926.9,36540,5447,110,41851,41851,41851,41851,41851
39176,5108,12579,39176,0,36896,2280,5.246e+18,278.59,14289.8,39176,4589,133,34849,34849,34849,34849,34849
32376,176,208,32282,94,32376,0,6.11498e+18,203.841,2402.25,32376,169,171,32608,32302,8564,15592,2477
23319,10472,11878,22439,880,22439,880,5.12386e+18,90.479,13323.1,23319,5702,111,20949,20949,20482,19654,19356
20281,60,61,20217,64,20281,0,2.33074e+18,60.6184,1059.59,20281,61,61,20165,19749,20029,20029,19890
30111,6990,7087,28358,1753,28358,1753,5.76419e+18,97.7161,9576.5,30111,3425,110,22407,22407,17832,20457,11048
10519,2028,4892,4123,6396,0,10519,6.94313e+12,53.576,5635.19,10519,2366,72,5627,5627,4049,5357,2355
25668,686,950,0,25668,24930,738,3.74212e+16,191.355,2933.81,25668,138,26,20586,20586,18729,16685,3523
8463,3051,4155,1857,6606,0,8463,52314900000,8.96337,4342.15,8463,3732,11,8448,13298,13298,13298,13298
44368,6095,17937,0,44368,16938,27430,1.96979e+15,57.3526,20396.2,44368,8738,72,44220,44220,44220,44220,44220
22338,2588,9980,21388,950,21388,950,4.44064e+18,93.0594,11510,22338,4799,111,12358,12358,5866,7139,3659
41183,37,61,41087,96,41183,0,2.26193e+18,60.8193,1510.18,41183,61,61,16030,3202,10019,6246,1093
49346,6185,8192,49346,0,49346,0,4.86789e+15,6832.03,20104.3,49346,8192,8,31334,17629,17629,17629,17629
46432,1537,10828,0,46432,16322,30110,2.52842e+15,60.0792,13973.5,46432,5268,72,35771,35771,31376,34883,26189
14525,5341,6505,13905,620,13905,620,2.92209e+18,93.8914,7617.51,14525,3098,111,14383,14383,13936,13936,13936
25532,9774,12144,0,25532,0,25532,4.44695e+17,93.5977,13793.6,25532,5885,110,25783,25783,25783,25783,25783
40338,523,1134,0,40338,39189,1149,3.55304e+16,236.284,3871.77,40338,175,26,20771,19481,12447,5449,3018
7847,123,170,7842,5,7847,0,5.96538e+18,160.614,1044.05,7847,117,119,7315,6732,5565,5574,5707
43667,17507,22265,17484,26183,0,43667,6.33997e+12,55.6712,24337.2,43667,10847,72,43463,43463,43463,43450,43448
48604,2,13,47218,1386,48582,22,1.38925e+14,10.2592,629.135,48604,12,12,9869,8404,8380,8589,8331
37205,14509,16799,35647,1558,0,37205,1.60021e+18,94.3877,19065.1,37205,8164,110,20338,20338,18083,18425,15364
42926,7086,10057,0,42926,0,42926,6.48265e+17,97.8845,13352.2,42926,4881,110,42442,42442,42442,42442,42442
43126,4391,14706,15978,27148,0,43126,8.50684e+12,58.3522,17314.5,43126,7163,72,48036,48036,48036,48036,48036
20775,4,11,20183,592,20769,6,1.39376e+14,10.0048,401.414,20775,11,11,17976,15906,15994,16131,10010
41314,1139,1152,0,41314,40137,1177,3.55265e+16,239.99,3951.9,41314,179,26,46894,46894,46894,46894,46894
12056,6,11,11713,343,12050,6,1.38333e+14,10.583,305.922,12056,11,11,11438,11124,8425,8374,7878
47855,9867,12640,45182,2673,0,47855,2.14e+18,97.4064,16122.2,47855,6136,110,47538,47538,47538,47538,42689
5270,261,335,0,5270,5117,153,4.02538e+16,19.8228,865.948,5270,54,26,4935,4935,4692,4712,3956
10444,2105,3290,3824,6620,0,10444,8.89007e+12,57.0885,4175.53,10444,1597,72,7154,7154,15969,16595,19848
10329,3676,4017,9841,488,9841,488,2.96356e+18,93.215,4961.34,10329,1919,107,21406,21406,21406,21406,21406
4034,42,1592,3844,190,0,4034,1.81577e+18,92.2571,2069.18,4034,750,72,1304,285,789,868,194
29274,1685,6899,27572,1702,27572,1702,3.21666e+18,97.6896,9335.94,29274,3328,110,24399,24399,18105,21009,15009
23199,1417,5516,0,23199,0,23199,6.45353e+17,97.5386,7549.13,23199,2663,110,16464,16464,9752,7957,4402
7136,387,475,0,7136,6928,208,4.15119e+16,18.7532,1196.79,7136,65,26,6661,6661,6493,6508,5242
43786,11927,18021,43786,0,41796,1990,4.6106e+18,1447.71,20642.3,43786,7526,143,48371,48371,48371,48371,48371
24299,76,780,0,24299,23911,388,2.49187e+16,3.73534,3026.04,24299,392,4,23519,23519,19837,19794,10974
3363,26,166,0,3363,3266,97,3.62324e+16,19.5168,476.764,3363,39,26,3197,3077,2162,2112,885
49275,88,176,49163,112,49275,0,6.17844e+18,173.834,2731.42,49275,169,169,33918,13503,16720,24468,0
47358,2473,23664,45555,1803,45555,1803,2.52639e+18,93.6712,26210,47358,11497,110,47034,47034,47034,47034,47034
26243,5854,6145,0,26243,0,26243,6.48958e+17,97.6734,8387.64,26243,2969,110,20098,20098,19722,19499,19522
28595,1145,7516,0,28595,0,28595,6.24451e+17,97.2884,9845.12,28595,3642,110,36997,0,3024,3403,2566
32240,930,7532,11326,20914,0,32240,9.88659e+12,60.0327,9861.78,32240,3668,72,38735,38735,38735,38735,38735
1168,299,1077,0,1168,543,625,3.72664e+14,9.29281,1110.36,1168,504,34,91,86,86,86,91
49637,12406,24653,0,49637,19767,29870,1.66145e+15,55.8927,27003.5,49637,12005,72,39379,39379,39379,39379,39379
32003,4121,17507,32003,0,32003,0,2.90845e+18,17.8397,17990.7,32003,15740,20,35372,35372,35372,35372,35372
18883,74,176,18806,77,18883,0,6.10466e+18,171.373,1701.51,18883,142,146,15096,10461,7587,7989,7685
13392,5856,7388,13392,0,0,13392,8.93154e+17,17.6502,7692.57,13392,6634,20,23443,23443,22019,22741,19672
40906,15260,17861,40906,0,39234,1672,4.70693e+18,2038.76,20734.3,40906,7080,141,29069,29069,29069,29069,29069
42240,3067,11580,0,42240,15162,27078,2.39842e+15,59.4259,14357.9,42240,5637,72,22880,22880,10907,15547,6931
7095,2582,3493,7095,0,7095,0,2.81465e+18,17.9153,3727.69,7095,3131,20,3602,3602,2758,2672,2727
12370,141,208,12363,7,12370,0,6.02809e+18,187.909,1442.98,12370,134,135,38347,37518,35181,35521,0
14552,2796,4232,0,14552,0,14552,6.04285e+17,96.3649,5585.78,14552,2037,110,21162,21086,12896,12540,6204
31325,242,968,0,31325,30431,894,3.55607e+16,194.108,3145.62,31325,142,26,33526,33265,15863,22016,2384
39919,11637,12064,37799,2120,0,39919,2.03159e+18,96.7531,14955.5,39919,5854,110,27855,27855,27363,27275,27122
18461,4406,5614,17481,980,0,18461,2.03201e+18,95.3516,7213.09,18461,2699,110,36659,36659,36659,36659,36659
48863,16074,22210,46840,2023,0,48863,1.58873e+18,94.3863,25003.8,48863,10796,110,47081,47081,47081,47081,47081
34402,102,176,34339,63,34402,0,6.08012e+18,169.089,2293.81,34402,166,162,20671,18283,11691,18738,634
1999,50,1631,894,1105,0,1999,2.55065e+12,37.1976,1733.12,1999,772,46,327,117,224,259,83
42112,163,176,42034,78,42112,0,5.98891e+18,173.098,2452.47,42112,173,171,35509,35347,26869,18174,16229
3415,818,846,0,3415,1198,2217,2.54647e+15,58.3769,1260.53,3415,409,64,2569,2569,2550,2561,2557
43357,7386,11963,15571,27786,0,43357,9.34942e+12,59.3935,14791.9,43357,5826,72,24193,24193,18011,14932,10992
20305,2208,4788,0,20305,0,20305,6.50508e+17,97.5186,6625.46,20305,2312,110,15517,15517,11974,7401,7764
17284,2020,6470,6496,10788,0,17284,8.10701e+12,57.6304,7681.34,17284,3149,72,28404,28404,18233,7395,5343
36708,1859,1941,7571,29137,0,36708,5.79593e+13,12.0038,2572.41,36708,1043,20,34767,34767,34246,33931,34504
12801,4269,6509,0,12801,5115,7686,1.63044e+15,53.2017,7316.7,12801,3149,72,15187,15187,15187,15187,15187
29385,7270,8750,0,29385,0,29385,5.94719e+17,95.468,11042.8,29385,4227,110,21693,21693,17553,13298,10882
22960,207,10171,8919,14041,0,22960,7.22473e+12,56.6412,11549.4,22960,4953,72,12789,12405,7251,11839,720
5544,293,393,0,5544,5381,163,4.22156e+16,19.445,981.05,5544,61,26,5151,5151,4941,4962,3477
31112,30,1098,0,31112,30216,896,3.79952e+16,239.724,3523.89,31112,167,26,29828,29816,22902,22262,5375
40805,7589,9762,38427,2378,38427,2378,3.9504e+18,98.3269,12843.5,40805,4620,111,33603,33603,33603,33603,33603
18863,3412,5753,17853,1010,17853,1010,5.71521e+18,96.9939,7347.29,18863,2734,111,32091,32091,21532,19417,12190
7589,8,10,7371,218,7586,3,1.55036e+14,9.90315,247.521,7589,10,10,7426,7350,7042,7042,6382
45395,3339,16380,16974,28421,0,45395,8.23772e+12,58.0393,19035.8,45395,7975,72,35646,35646,24859,23264,16445
1411,176,422,1331,80,1331,80,5.88886e+18,87.6974,671.49,1411,175,49,989,989,927,908,575
2210,261,610,2081,129,0,2210,2.23306e+18,91.6231,960.207,2210,274,61,1600,1600,1140,1094,878
41966,10312,11896,0,41966,15132,26834,2.36233e+15,58.8052,14632.9,41966,5780,72,41489,41489,41489,41489,41489
12376,5,6,12186,190,12344,32,9.62055e+13,3.99459,248.824,12376,5,4,12370,12370,12370,12369,11772
29293,1308,1605,0,29293,28420,873,4.85263e+16,288.102,4939.34,29293,269,26,27688,27688,27381,27340,25738
47742,3931,12628,17039,30703,0,47742,9.47512e+12,59.3173,15735.7,47742,6131,72,46323,46323,46323,46323,46323
18512,1494,4811,17455,1057,17455,1057,5.45801e+18,97.6666,6458.46,18512,2277,111,14390,14390,10397,9686,7349
46213,184,206,46192,21,46213,0,5.9838e+18,193.276,2648.14,46213,188,181,24762,22481,11024,16283,3084
15852,1707,3871,14930,922,14930,922,3.60274e+18,97.708,5361.37,15852,1820,111,11981,11981,11981,11981,6075
40766,3541,20312,39207,1559,39207,1559,9.76171e+18,92.8641,22585.8,40766,9859,110,29126,29126,22463,20828,15627
45525,5852,15672,45525,0,42975,2550,4.59757e+18,311.098,17559.6,45525,6078,132,35636,35636,31130,27332,25886
28756,5336,9744,27306,1450,0,28756,1.9285e+18,96.0943,11893.2,28756,4728,110,19012,19012,15745,14214,10409
11234,7,11,10905,329,11226,8,1.70704e+14,9.90128,310.673,11234,11,11,26718,26105,20043,19952,15779
19740,414,4659,18590,1150,0,19740,2.22919e+18,97.4746,6460.61,19740,2245,110,15081,15081,9312,8385,2316
7049,620,1763,6641,408,0,7049,2.21294e+18,96.0792,2591.55,7049,835,100,5286,5286,3813,3577,2356
45663,16303,21589,43816,1847,43816,1847,2.31197e+18,94.807,24118.9,45663,10412,111,45217,45217,45217,45217,45217
45710,4638,13667,0,45710,0,45710,5.91756e+17,96.8245,16898.5,45710,6625,110,23787,23787,11494,13633,6600
26586,5847,6237,9347,17239,0,26586,9.90204e+12,59.9692,8226.85,26586,3038,72,20349,20349,19876,20249,19281
23717,883,6383,22392,1325,22392,1325,6.23462e+18,97.0722,8382.95,23717,3085,110,0,26416,26416,26416,26416
24272,564,834,0,24272,23579,693,3.55093e+16,135.766,2556.19,24272,116,26,23438,23268,22418,22551,18126
21524,612,1171,0,21524,20891,633,4.56068e+16,245.527,3459,21524,183,26,30053,30053,18295,16053,3794
18917,3465,6316,17947,970,17947,970,5.79559e+18,96.4979,7863.94,18917,3006,111,12601,12601,11132,11919,7211
2245,124,186,2245,0,2245,0,6.00392e+18,137.286,570.261,2245,75,72,1998,1874,1492,1509,1465
1374,150,416,0,1374,0,1374,6.48099e+17,86.9541,655.8,1374,175,49,958,958,646,656,491
49478,13376,14180,46771,2707,46771,2707,4.56515e+18,97.6659,17586.2,49478,6757,111,37259,37259,37259,37259,37259
24468,6,14,23765,703,24425,43,1.507e+14,10.3447,467.273,24468,12,11,23270,22482,17197,16960,11052
27658,3897,11043,27658,0,26275,1383,5.21343e+18,227.39,12504.6,27658,3261,133,14977,14977,11612,11747,4388
9063,18,208,9062,1,9063,0,6.0266e+18,177.377,1232.58,9063,125,124,3353,593,894,860,805
5380,52,246,0,5380,5227,153,3.58949e+16,19.8545,708.066,5380,47,26,3781,1001,1638,2292,345
29549,10509,11090,29549,0,27962,1587,5.31654e+18,213.73,12454.5,29549,3679,132,28252,28252,28233,28233,29051
46602,31,176,46517,85,46602,0,5.99253e+18,172.55,2592.05,46602,173,173,41528,39312,39107,40466,38978
11484,4,14,11148,336,11448,36,1.65395e+14,10.695,322.853,11484,14,11,1385,463,152,297,54
21884,2624,8960,19767,2117,20891,993,3.03384e+18,93.697,10539.7,21884,4278,111,38618,38618,38618,38618,38618
42940,10874,14261,40760,2180,0,42940,1.94404e+18,96.3059,17219.5,42940,6923,110,42636,42636,42636,42636,42636
47655,1,17,46254,1401,47587,68,1.74219e+14,10.3756,757.903,47655,14,12,9020,9020,9020,16432,0
18585,1409,6481,18585,0,17557,1028,3.65486e+18,149.918,7618.51,18585,2434,128,11755,11669,10313,11174,5598
19663,153,175,19657,6,19663,0,5.98261e+18,165.797,1659.03,19663,155,153,19213,18706,17479,17455,17512
24484,2464,5798,23056,1428,23056,1428,5.90032e+18,97.6018,7914.74,24484,2806,110,25291,25291,14697,4615,4318
17575,2301,4133,6172,11403,0,17575,9.85759e+12,59.8578,5571.7,17575,2005,72,13442,13442,10742,12972,7574
32246,143,208,32171,75,32246,0,5.99191e+18,197.763,2259.52,32246,173,171,30854,28733,22880,23094,22770
2309,86,112,0,2309,2244,65,3.51394e+16,19.2837,331.941,2309,32,26,48244,48102,48046,48039,48159
28316,16,176,28284,32,28316,0,6.13704e+18,171.961,2081.85,28316,152,155,47648,47476,47480,47102,44943
43584,778,1666,0,43584,42315,1269,4.1612e+16,301.836,5516.63,43584,281,26,43523,43523,43523,43523,43523
43630,10231,19838,43630,0,30846,12784,5.04604e+18,3184.14,23510.1,43630,7884,149,43083,43083,43083,43083,43083
22950,1061,8689,8661,14289,0,22950,8.02987e+12,57.6776,10194.3,22950,4231,72,14261,14261,7616,11776,2352
46366,11272,27276,0,46366,19208,27158,1.3598e+15,54.4394,29172.4,46366,13282,72,34897,34897,34711,34816,34619
43717,6435,13161,43717,0,41169,2548,4.37597e+18,305.392,15326,43717,3191,134,42102,42102,42102,42102,42102
2279,20,143,467,1812,0,2279,5.75161e+13,11.9087,289.129,2279,102,14,2136,2136,1302,792,1756
26581,5785,10660,25361,1220,25361,1220,4.21801e+18,94.7164,12507.3,26581,5106,111,15921,15921,11303,12249,10051
19389,4373,7158,18449,940,18449,940,4.124e+18,93.9472,8676.09,19389,3424,111,0,0,0,1400,1400
31845,173,176,31761,84,31845,0,6.06961e+18,172.989,2203.55,31845,164,163,39210,38355,33866,31052,31172
6265,1189,1590,0,6265,0,6265,6.45518e+17,95.7438,2347.18,6265,751,93,4675,4675,4146,3678,3785
21457,118,176,21405,52,21457,0,6.16421e+18,168.579,1808.45,21457,140,146,20917,19039,14518,14862,14772
855,14,255,0,855,300,555,2.54274e+15,53.1216,399.919,855,117,42,250,60,72,1,38
41958,116,1431,0,41958,40745,1213,3.90857e+16,279.255,4780.14,41958,234,26,22838,22838,7506,22472,5167
17071,1745,4316,16093,978,0,17071,2.1857e+18,97.1573,5900.75,17071,2084,110,12755,12755,9228,8539,5047
30762,7450,12554,0,30762,11759,19003,1.95997e+15,57.2449,14375.6,30762,6114,72,26441,26323,22637,21156,17027
49482,17005,19388,47699,1783,47209,2273,4.67614e+18,2142.61,22527.8,49482,7861,141,45273,45273,45273,45273,45273
3983,2278,2440,3861,122,3861,122,2.2547e+18,85.0331,2783.12,3983,1154,63,1543,1543,1518,1531,1541
3269,723,1111,0,3269,0,3269,5.7886e+17,83.2674,1549.63,3269,500,69,13304,13304,0,0,0
21584,280,7844,20534,1050,20534,1050,7.60979e+18,95.5357,9523.06,21584,3799,110,28844,28328,24474,22306,1798
45022,3998,10544,0,45022,0,45022,6.47763e+17,97.8818,13967.8,45022,5112,110,43766,43766,43766,43766,43766
27727,2248,6505,0,27727,9751,17976,2.52479e+15,59.9781,8569.2,27727,3156,72,21222,21222,13693,9166,7546
20474,262,766,0,20474,19891,583,3.55291e+16,88.6939,2243.96,20474,101,26,27837,27597,16005,25464,1419
49759,5813,20517,49759,0,47571,2188,4.55089e+18,2535.61,23730.4,49759,6473,146,48765,48765,48765,48765,48765
41360,167,206,41343,17,41360,0,5.97932e+18,186.744,2486.94,41360,180,176,39926,39694,28598,28540,15418
2928,396,1831,2838,90,2838,90,9.61298e+18,64.9136,2099.98,2928,845,58,1097,1010,304,546,0
30454,7,14,29562,892,30397,57,1.68391e+14,10.5352,575.048,30454,13,11,7511,4871,3618,5669,3265
5287,205,242,0,5287,5138,149,3.57903e+16,19.729,694.081,5287,47,26,5045,5045,4925,4929,4617
41566,183,206,41483,83,41566,0,5.97666e+18,186.851,2493.52,41566,182,173,35361,10460,8630,17230,2391
22438,1825,10546,8817,13621,0,22438,6.83192e+12,55.1478,11852.3,22438,5123,72,11892,11892,6433,9955,1695
19071,598,4466,6701,12370,0,19071,9.88575e+12,59.9105,6000.46,19071,2169,72,14605,14605,5702,12146,2200
23583,15,208,23508,75,23583,0,6.00829e+18,195.567,1968.01,23583,164,158,7795,1410,1740,1877,1504
20887,1,11,20295,592,20879,8,1.3879e+14,10.0943,403.323,20887,11,11,95,95,95,95,95
45413,2210,14343,43034,2379,43034,2379,4.09185e+18,97.1718,17425.3,45413,6847,111,31070,31070,15416,20366,8566
27906,1,14,27088,818,27853,53,1.76081e+14,10.5063,548.613,27906,13,11,56,56,56,56,56
38478,4140,15054,36680,1798,36680,1798,4.70395e+18,94.814,17530.8,38478,7208,111,23424,23424,11930,14426,8394
31837,1149,7754,30007,1830,30007,1830,5.86314e+18,97.5932,10335.6,31837,3744,110,18379,18121,14769,12891,4190
22542,2038,7121,0,22542,0,22542,5.79403e+17,96.2412,8953.67,22542,3437,110,20783,20783,11422,17773,4799
3489,408,893,3282,207,3282,207,5.82349e+18,94.0911,1388.69,3489,416,74,2596,2596,2476,2476,1465
6850,804,1731,6458,392,6458,392,5.84863e+18,95.8191,2542.25,6850,812,98,5119,5119,4603,4529,2897
34042,697,1021,0,34042,33071,971,3.55547e+16,209.823,3371.95,34042,152,26,30863,30863,25763,25344,23354
27898,8326,10978,26608,1290,0,27898,1.77055e+18,95.1679,12943,27898,5323,110,16621,15887,13182,15562,10529
28318,6825,11468,27038,1280,0,28318,1.73468e+18,94.9636,13429.6,28318,5553,110,26586,26586,26586,26586,26586
25061,7,12,24347,714,25048,13,1.38677e+14,10.4186,448.398,25061,12,11,4805,1110,420,588,149
11556,548,698,0,11556,11220,336,4.02004e+16,25.7466,1773.58,11556,88,26,10858,10852,10388,10406,8808
13156,306,975,2661,10495,0,13156,5.67716e+13,12.0103,1346.74,13156,447,20,12181,12181,8245,6232,10380
43932,1172,1201,0,43932,42679,1253,3.55204e+16,248.29,4158.07,43932,189,26,43701,43701,43701,43701,43701
26129,120,176,26074,55,26129,0,6.05594e+18,172.031,1986.01,26129,162,159,24497,22198,17395,17769,17748
39145,10155,13392,37187,1958,0,39145,1.91471e+18,96.112,16110.4,39145,6500,110,34997,34997,34997,34997,34997
37700,5016,9098,35507,2193,35507,2193,3.63047e+18,98.2601,11985.9,37700,4299,111,26153,26050,21332,23375,18150
45774,11052,20931,43884,1890,0,45774,1.58071e+18,93.9884,23577.2,45774,10173,110,41250,41250,41250,41250,41250
13909,815,3341,0,13909,0,13909,6.46239e+17,97.0909,4719.05,13909,1605,110,42756,42756,42756,42756,42756
32676,8784,8930,30856,1820,30856,1820,2.68657e+18,97.7377,11434.6,32676,4243,111,23746,23746,23623,23737,23564
20101,1473,5311,18972,1129,0,20101,2.14968e+18,96.7723,7084.95,20101,2562,110,14790,14790,8631,31321,27649
19912,1800,4668,0,19912,6998,12914,2.52942e+15,59.8902,6250.95,19912,2270,72,18090,18090,11932,10350,5938
21009,144,176,20958,51,21009,0,6.13473e+18,168.604,1792.35,21009,136,143,19295,18714,7305,3235,0
5977,246,268,0,5977,5808,169,3.5842e+16,19.7422,767.668,5977,49,26,5709,5709,5673,5668,5507
39053,17495,18641,0,39053,15413,23640,1.72576e+15,54.7249,20642.9,39053,9059,72,17078,17078,16238,0,0
36815,14719,15968,35228,1587,0,36815,1.64997e+18,94.6197,18275.6,36815,7753,110,29421,29421,29421,0,0
32978,252,1614,0,32978,32002,976,4.60384e+16,294.666,5065.75,32978,269,26,30958,30259,21352,21620,7913
943,18,61,0,943,915,28,3.53793e+16,17.0074,168.396,943,23,24,869,822,603,594,358
28774,7902,12726,28774,0,27406,1368,5.41586e+18,254.738,14042.2,28774,4714,133,23763,23690,21766,23191,18287
48752,267,21654,0,48752,0,48752,4.70345e+17,93.405,24487.1,48752,10523,110,21976,21976,10281,13049,9155
8685,391,435,0,8685,8435,250,3.74268e+16,19.6555,1177.36,8685,62,26,8250,8250,8165,8174,7717
41124,453,13247,0,41124,0,41124,5.73599e+17,96.4369,16139.1,41124,6425,110,35026,35026,21673,18621,17158
49990,11574,16707,47460,2530,0,49990,1.93737e+18,96.0687,20035.3,49990,8114,110,39001,39001,39001,39001,39001
39831,6,15,38663,1168,39768,63,1.68612e+14,10.4236,663.532,39831,12,12,869,852,786,708,232
17707,120,176,17627,80,17707,0,6.09599e+18,169.96,1648.03,17707,138,145,14034,13945,4017,11021,618
34555,622,1645,0,34555,33534,1021,4.56389e+16,298.857,5210.58,34555,277,26,27589,27048,12754,13357,2467
15581,131,663,0,15581,15134,447,3.55918e+16,20.121,1822.61,15581,84,26,14918,14918,10750,10732,4606
20970,4649,4902,7373,13597,0,20970,9.9284e+12,59.9615,6550.52,20970,2388,72,16068,16068,15769,16000,15456
15962,20,175,15950,12,15962,0,5.98068e+18,165.167,1496.53,15962,148,148,4424,313,456,1192,172
8055,155,175,8052,3,8055,0,5.9904e+18,160.771,1065.52,8055,116,123,32560,32189,11783,3759,1003
2882,947,2172,1267,1615,0,2882,3.43849e+12,50.0524,2335.16,2882,1054,51,710,617,503,673,457
27720,4248,15624,11360,16360,0,27720,5.63717e+12,53.408,16950.9,27720,7588,72,12096,12096,8173,10818,4144
23129,6522,11342,9185,13944,0,23129,6.60901e+12,55.9118,12639.2,23129,5524,72,11787,11787,9687,11427,7388
26582,8097,14788,0,26582,0,26582,3.76876e+17,89.6951,16288.5,26582,7163,110,25842,25842,25842,25842,25842
21834,3938,9309,20875,959,0,21834,1.67835e+18,94.576,10873.8,21834,4516,110,48798,48798,48798,48798,48798
10582,135,176,10571,11,10582,0,6.01852e+18,163.295,1258.19,10582,126,125,10121,9553,8065,8201,8217
34307,6103,11748,12715,21592,0,34307,8.46606e+12,58.2848,13915,34307,5711,72,22559,22559,17608,21709,11738
25257,3290,5981,0,25257,0,25257,6.46387e+17,97.6113,8152.7,25257,2889,110,19276,19276,16286,12054,11431
41674,8021,19095,16299,25375,0,41674,6.97633e+12,56.0329,21262.5,41674,9284,72,40817,40817,40817,40817,40817
1719,6,13,1671,48,1657,62,1.37545e+14,10.5526,125.799,1719,12,12,1619,1578,1202,1203,1101
10058,10,11,9758,300,10054,4,1.8515e+14,9.68145,296.15,10058,10,10,10047,10047,10047,10047,10004
16336,277,3973,15386,950,15386,950,3.61371e+18,97.7844,5502.38,16336,1869,111,12363,12363,5329,7834,1742
27518,358,7361,9832,17686,0,27518,9.44356e+12,59.4441,9339.31,27518,3580,72,38629,38629,38629,38629,38629
14695,1349,3508,0,14695,0,14695,6.48888e+17,97.2154,4944.91,14695,1689,110,11187,11187,7744,5433,4773
32753,886,1092,0,32753,31813,940,3.72201e+16,223.714,3550.17,32753,167,26,22361,22103,13939,12183,3675
27610,4187,8021,26117,1493,26117,1493,6.70169e+18,96.7776,10217.9,27610,3885,110,19589,19589,18886,18886,11233
29306,2298,9818,29306,0,29306,0,2.53484e+18,3205.95,12874.3,29306,7375,25,21599,21460,16568,18385,10607
17876,5332,5951,6593,11283,0,17876,8.61482e+12,58.3039,7258.54,17876,2893,72,17780,18006,0,0,0
32926,15506,18370,0,32926,0,32926,3.49347e+15,17.8963,18851.8,32926,16518,20,21757,21757,15273,12931,12237
37154,3242,8661,0,37154,13055,24099,2.52785e+15,60.04,11279.7,37154,4207,72,28675,28675,20133,26554,12010
9249,35,61,9249,0,9249,0,2.32429e+18,60.1295,710.394,9249,61,61,7579,3676,5120,5417,5310
19450,18,32,19354,96,19450,0,1.11703e+18,31.9474,788.923,19450,32,32,10654,0,2436,10318,10654
36629,9194,18503,35249,1380,35249,1380,9.73369e+18,93.5091,20577.5,36629,8988,110,36003,27543,32209,33487,28732
25008,8223,13963,0,25008,10224,14784,1.46052e+15,53.2969,15199.8,25008,6791,72,11045,11045,8879,7552,6468
11810,6,11,11464,346,11798,12,1.80754e+14,10.0865,321.458,11810,11,11,11343,11016,8823,8302,6938
11648,1,11,11309,339,11640,8,1.61085e+14,10.0508,311.955,11648,11,11,2497,2497,2497,2497,2497
22494,1,14,21825,669,22438,56,1.86762e+14,10.4638,498.107,22494,13,11,3723,3723,3723,3723,3723
14732,533,3427,5172,9560,0,14732,9.91505e+12,59.8312,4686.34,14732,1661,72,41763,42244,13894,21876,2131
8569,1731,4139,8229,340,0,8569,1.52796e+18,92.5467,4871.14,8569,1988,93,4430,4430,3145,2781,2176
21843,17,208,21836,7,21843,0,6.04132e+18,193.449,1927.49,21843,156,166,19614,18142,18261,19102,0
38267,1992,8904,0,38267,13445,24822,2.53382e+15,60.059,11585.2,38267,4334,72,29771,29771,19614,13564,7103
33531,1,8,32998,533,33467,64,9.72499e+13,3.9977,455.172,33531,6,4,313,313,313,313,313
48584,11053,23062,46644,1940,46644,1940,9.28769e+18,92.2929,25766.5,48584,11214,110,47951,47951,47951,47951,47951
48969,11,14,47573,1396,48886,83,1.38913e+14,10.5322,686.376,48969,14,12,6951,1537,850,1263,234
8238,344,2710,8238,0,7762,476,3.94857e+18,93.6536,3392.28,8238,1015,114,5528,5528,2648,3997,1063
14487,213,749,0,14487,14067,420,3.914e+16,69.8443,2011.01,14487,99,26,13738,13675,12372,11797,7229
25378,101,176,25359,19,25378,0,6.11753e+18,170.162,1972.24,25378,151,157,23024,16938,14029,14470,14505
32832,13969,15829,32832,0,31474,1358,4.85578e+18,512.752,17560.2,32832,4235,136,34258,34258,34258,34258,34258
29001,7478,7622,0,29001,0,29001,6.2371e+17,97.2547,9974.8,29001,3689,110,21379,21379,21218,21097,21218
22949,2139,5534,21612,1337,21612,1337,3.09305e+18,98.0307,7508.2,22949,2606,111,26875,26875,18330,25391,7135
20595,4409,9794,20595,0,19668,927,5.56987e+18,182.48,10808.7,20595,2934,130,10801,10767,8575,9676,5126
48847,12037,20418,46687,2160,46687,2160,2.74344e+18,94.9786,23358.5,48847,9920,110,25029,25029,21152,24653,15507
803,120,290,760,43,0,803,2.18622e+18,78.6588,440.987,803,113,41,513,265,320,330,274
41581,12,15,40381,1200,41494,87,1.53697e+14,10.5329,672.752,41581,13,12,18395,15317,14559,14631,14363
39054,370,10540,36866,2188,36866,2188,2.56645e+18,97.8574,13420.7,39054,5010,111,28608,28416,18604,11180,6433
21919,101,1276,0,21919,21267,652,4.79047e+16,181.92,3761,21919,203,26,18719,7721,6845,4475,1593
32686,4026,7636,11493,21193,0,32686,9.87311e+12,60.0225,9995.09,32686,3707,72,15963,15963,11126,12305,7204
1525,49,81,0,1525,317,1208,1.48728e+16,11.8616,199.195,1525,71,14,1444,1444,1220,1076,1338
37727,6291,9669,0,37727,0,37727,6.28453e+17,97.0508,12579.5,37727,4686,110,37263,37263,37263,37263,37263
46583,132,176,46497,86,46583,0,6.01672e+18,164.323,2625.33,46583,170,172,46510,46510,46510,46510,45423
14771,143,176,14759,12,14771,0,6.0607e+18,168.888,1495.21,14771,140,139,14281,13452,11964,12048,11888
18467,432,812,0,18467,17935,532,3.80169e+16,125.53,2318.05,18467,109,26,17655,17513,16472,16338,11109
44214,594,1212,0,44214,42955,1259,3.55839e+16,251.357,4197.53,44214,190,26,42817,41999,40033,39085,28068
23374,6317,7596,22174,1200,22174,1200,2.96923e+18,95.1787,9462.81,23374,3662,110,30315,30315,28986,29979,27269
34225,5,14,33218,1007,34195,30,1.71114e+14,10.2957,567.731,34225,13,12,5594,1469,848,1497,4
48504,1716,11343,45681,2823,0,48504,2.22699e+18,97.8967,14975.9,48504,5503,110,37527,37527,32726,34772,22049
2587,613,689,2433,154,2433,154,5.67554e+18,92.5903,1083.41,2587,312,63,1898,1898,1861,1865,1857
43074,7837,13840,43074,0,40635,2439,4.77061e+18,299.35,15957.1,43074,3451,137,29556,29556,27001,26587,16820
15388,264,6721,14728,660,14728,660,2.77497e+18,94.0419,7913.31,15388,3248,110,8667,8409,3168,5401,1310
39934,126,176,39869,65,39934,0,6.08897e+18,172.873,2473.59,39934,170,166,34524,17627,29537,26133,2554
23834,5815,6071,0,23834,8462,15372,2.46284e+15,59.6123,7858.43,23834,2951,72,23466,22369,22369,22369,22369
23139,10617,11676,22266,873,22266,873,9.82876e+18,93.2626,13141.6,23139,5663,110,14335,14335,14335,14335,14335
17032,2892,4006,5987,11045,0,17032,9.90562e+12,59.8344,5404.06,17032,1948,72,27036,27036,16735,16118,3988
45015,2329,13179,0,45015,0,45015,5.98403e+17,96.9767,16394.4,45015,6402,110,34304,34304,27795,29975,21364
39529,356,14594,0,39529,0,39529,5.3409e+17,95.6834,17246,39529,7088,110,38943,38943,38942,38930,38897
35482,9953,11434,35482,0,33412,2070,5.27225e+18,248.031,13025.5,35482,4222,128,16816,16816,13600,16034,8452
44657,10,13,40966,3691,44400,257,1.16128e+14,8.02705,557.088,44657,12,9,20771,14101,14455,14337,14060
29904,9320,13014,0,29904,0,29904,4.80165e+17,94.5949,14977.1,29904,6321,110,33634,33634,33634,33634,33634
31234,48,176,31216,18,31234,0,6.03084e+18,172.24,2156.85,31234,166,162,13880,3048,9527,10152,1355
18271,4963,6270,0,18271,0,18271,5.60466e+17,95.7915,7785.22,18271,3035,110,12001,12001,11039,11159,9788
18872,345,1180,0,18872,18309,563,4.87397e+16,249.284,3398.6,18872,183,26,17647,17110,15132,13379,7319
12092,4061,4125,11482,610,11482,610,2.97409e+18,95.3635,5243.97,12092,1977,110,28301,28639,0,5874,5874
12699,499,849,0,12699,12323,376,4.55417e+16,160.418,2243.86,12699,119,26,13238,12420,7261,2303,44
6434,1164,1663,6064,370,6064,370,3.13561e+18,96.2838,2429,6434,768,97,4771,4771,4568,4771,3691
6046,1154,2226,6046,0,5716,330,4.08992e+18,91.373,2769.61,6046,856,99,3820,3820,2779,3236,2340
16786,1990,5135,15896,890,15896,890,6.90739e+18,96.2341,6615.73,16786,2479,110,26936,0,12455,10029,6698
45145,1410,19431,45145,0,43155,1990,4.68712e+18,1796.83,22040.8,45145,4761,141,31459,30883,23234,26285,17309
2043,72,170,2043,0,2043,0,5.91444e+18,133.605,531.955,2043,76,66,1508,854,775,867,832
24547,43,175,24475,72,24547,0,5.97838e+18,166.703,1853.44,24547,163,161,16141,5796,5632,6166,5899
26725,1908,7645,0,26725,0,26725,6.03941e+17,96.8164,9802.98,26725,3697,110,28479,28393,16525,23704,5272
16866,1,12,16376,490,16854,12,1.53688e+14,10.3407,378.475,16866,12,11,3848,3848,3848,3848,3848
11800,2044,2788,0,11800,0,11800,6.50886e+17,97.0308,4013.89,11800,1333,110,9012,9012,8175,7275,7102
29232,792,934,0,29232,28400,832,3.55876e+16,180.574,2980.65,29232,135,26,28298,28298,27561,27637,25400
14657,3220,3505,13805,852,13805,852,5.76982e+18,97.1687,4939.16,14657,1676,110,14490,14490,14490,14490,14490
24002,331,839,0,24002,23317,685,3.56445e+16,137.127,2554.82,24002,115,26,42445,42199,31150,30766,15967
11319,262,4795,4356,6963,0,11319,7.50249e+12,56.7645,5621.67,11319,2336,72,6524,6332,3955,6084,1009
10680,465,4622,10213,467,0,10680,1.67199e+18,92.0876,5537.87,10680,2215,105,6058,5800,3249,2574,1898
12021,118,2844,11321,700,11321,700,3.3754e+18,96.9847,4087.3,12021,1351,110,41989,37546,0,0,0
24772,3697,7680,0,24772,0,24772,5.85643e+17,96.4246,9661.22,24772,3718,110,19295,19295,18535,18535,10273
544,189,224,514,30,514,30,5.8195e+18,70.7188,328.523,544,77,33,320,320,302,305,314
7938,5,11,7707,231,7932,6,1.70523e+14,10.1179,261.821,7938,11,11,7280,6519,5484,5515,4361
26852,13902,14255,25892,960,0,26852,1.37145e+18,89.3488,15830.7,26852,6903,110,24164,24164,23882,23214,12597
48025,1435,1675,0,48025,46630,1395,4.02277e+16,296.013,5662.17,48025,281,26,37045,37045,29687,24893,22900
10431,1883,2740,0,10431,0,10431,6.29594e+17,96.5202,3832.4,10431,1310,110,7691,7691,6718,6424,5436
33343,6203,15758,32003,1340,0,33343,1.53877e+18,94.0205,17784.9,33343,7656,110,48905,48905,48905,48905,48905
30663,403,957,0,30663,29791,872,3.55694e+16,190.31,3092.02,30663,140,26,29706,29390,26592,26778,16762
40787,11317,12164,38609,2178,0,40787,2.04227e+18,96.8511,15119.3,40787,5903,110,26560,26560,24108,23452,21823
18989,696,772,0,18989,18444,545,3.65013e+16,93.9009,2217.85,18989,102,26,18217,18210,18022,18001,16882
46617,3278,12546,16693,29924,0,46617,9.43036e+12,59.5114,15573.8,46617,6112,72,38783,38783,36792,38451,35256
38247,5957,18738,0,38247,8390,29857,1.33719e+13,8.99247,19146.1,38247,16859,11,15905,15905,10995,10498,4069
10565,66,208,10499,66,10565,0,6.09161e+18,188.732,1359.67,10565,125,131,7774,4640,3251,3692,3371
27492,7267,11641,0,27492,0,27492,4.89908e+17,94.6693,13510.5,27492,5645,110,22462,22462,15500,7313,7214
42119,1781,11504,39789,2330,0,42119,2.11553e+18,97.2386,14617.3,42119,5586,110,33921,0,0,0,19442
44845,18179,25154,44845,0,0,44845,8.95563e+17,17.9838,25716,44845,22630,20,33415,33415,33415,33415,33415
13344,8312,13344,13344,0,0,13344,134208000,0,13344,13344,13344,1,0,0,0,580,587
48296,1,15,46902,1394,48211,85,1.50774e+14,10.4697,705.496,48296,14,12,15402,15402,15402,14437,14437
11651,191,364,0,11651,11471,180,2.46521e+16,3.73487,1437.64,11651,184,4,33762,33762,33762,33762,33762
3668,204,945,3450,218,3450,218,4.77764e+18,95.2549,1456.91,3668,438,78,2723,2723,1463,1875,959
44390,5796,10365,0,44390,15612,28778,2.52718e+15,60.0638,13394.6,44390,5037,72,35862,35862,32173,29191,28116
3520,764,957,3320,200,3320,200,6.09868e+18,93.8565,1452.43,3520,441,74,2563,2563,2523,2523,2264
19474,1,12,18910,564,19463,11,1.56579e+14,9.99733,407.039,19474,12,11,4333,4333,4333,4333,4333
3426,445,846,1206,2220,0,3426,9.91516e+12,58.3973,1261.35,3426,411,63,2580,2580,2013,2477,1492
32511,5875,7639,30620,1891,30620,1891,5.88297e+18,97.7362,10285.7,32511,3698,110,32033,0,175,175,175
23937,5258,7840,22707,1230,0,23937,1.96335e+18,96.1478,9730.94,23937,3800,110,48788,48788,48788,48788,48788
42416,4170,9849,14908,27508,0,42416,9.8907e+12,60.089,12771.3,42416,4790,72,32567,32567,23960,30525,14173
39499,6279,14807,37609,1890,37609,1890,3.12374e+18,96.2378,17388.7,39499,7105,111,24692,24692,14480,15851,9704
43265,9104,13444,40995,2270,0,43265,2.00666e+18,96.6826,16494.7,43265,6531,110,42376,42376,42376,42376,42376
20378,4238,6082,19278,1100,19278,1100,3.92869e+18,97.134,7784.91,20378,2892,111,21826,21826,18971,17280,14084
49553,182,1714,0,49553,48116,1437,4.01739e+16,303.926,5808.54,49553,291,26,47964,47650,33695,33587,17114
33759,6119,9426,0,33759,12136,21623,2.37636e+15,59.2651,11726.3,33759,4580,72,28943,28943,28943,28943,28943
5967,3243,3367,5765,202,5765,202,2.40507e+18,90.5832,3866.05,5967,1606,77,16730,16730,15906,16582,15969
992,299,344,940,52,940,52,2.5434e+18,82.0444,523.956,992,137,47,2768,2681,2564,2745,1124
12983,3958,6851,5237,7746,0,12983,6.14854e+12,53.0516,7641.46,12983,3331,72,17942,17942,16064,15961,13142
28485,1328,6656,26820,1665,26820,1665,5.74254e+18,97.7379,9044.26,28485,3218,110,27477,27477,27464,27762,8701
18703,4296,5676,0,18703,6805,11898,2.30159e+15,58.8124,7079.88,18703,2757,72,13067,13067,12081,12396,9594
31127,982,1377,0,31127,30212,915,4.30234e+16,279.762,4333.83,31127,222,26,21619,21619,10521,17656,2207
36827,7,15,35773,1054,36744,83,1.43455e+14,10.618,611.509,36827,14,12,5029,1685,948,1132,246
28165,5975,13473,0,28165,11125,17040,1.72903e+15,54.4999,15013.5,28165,6557,72,14692,14692,10784,8087,5613
14406,156,611,0,14406,13994,412,3.55886e+16,20.0688,1689.02,14406,80,26,26620,24812,9833,6127,1464
16645,207,6725,15885,760,15885,760,8.34149e+18,93.819,8039.38,16645,3252,110,9920,9272,1768,7522,1071
17705,1577,4192,0,17705,0,17705,6.4756e+17,97.4176,5851.63,17705,2016,110,13513,13513,10019,7116,5935
39371,12230,16998,0,39371,0,39371,4.80639e+17,93.9327,19438.4,39371,8246,110,36470,36470,36470,36470,36470
26557,5948,6852,25056,1501,0,26557,2.16406e+18,97.2898,9059.07,26557,3315,110,19705,19705,18679,18340,17285
8765,1603,3926,0,8765,0,8765,4.78319e+17,93.3838,4701.5,8765,1894,104,4839,4839,3717,3220,3017
18001,7,13,17476,525,17936,65,1.68797e+14,10.4821,435.647,18001,12,11,16432,16271,15655,16260,0
42254,29,176,42185,69,42254,0,5.99472e+18,172.981,2464.91,42254,169,172,20479,13153,15057,16119,12874
41106,2054,11676,0,41106,14811,26295,2.35887e+15,59.2379,14364.1,41106,5676,72,29041,28687,21982,25011,18421
30841,1386,7193,29041,1800,0,30841,2.2321e+18,97.7366,9736.35,30841,3479,110,30720,30720,30720,30720,30720
28362,154,175,28287,75,28362,0,5.97971e+18,167.336,1991.73,28362,165,162,41406,39303,30042,30755,30098
8994,270,553,0,8994,8731,263,4.02109e+16,19.7225,1405.01,8994,75,26,8441,8441,7944,7807,5071
48592,4142,11297,0,48592,0,48592,6.49231e+17,97.9335,14940.7,48592,5485,110,37295,37295,25454,18979,15278
12788,1747,3079,12048,740,0,12788,2.22118e+18,96.9966,4376.17,12788,1470,110,35814,35814,35631,35715,32917
21928,21,208,21849,79,21928,0,6.08951e+18,198.963,1969.36,21928,159,157,9092,1960,2547,2638,2058
44549,3967,13702,42183,2366,42183,2366,2.63597e+18,97.3091,16765.1,44549,6545,111,36435,36435,31716,25099,23583
44720,714,1219,0,44720,43443,1277,3.55841e+16,252.794,4235.69,44720,193,26,47907,47907,47907,47907,47907
7386,2,11,7173,213,7379,7,1.49274e+14,10.3098,246.33,7386,11,11,4335,3171,2868,2926,2459
19688,4123,4762,18540,1148,18540,1148,2.64922e+18,97.941,6519.38,19688,2237,111,14926,14926,14287,14880,13444
4066,91,176,4064,2,4066,0,6.05893e+18,151.052,779.536,4066,93,91,3447,2318,1996,2107,2084
16117,865,3833,15177,940,0,16117,2.22917e+18,97.2705,5375.01,16117,1845,110,12284,12284,6255,5675,3579
26388,134,176,26310,78,26388,0,6.00749e+18,172.453,1967.11,26388,158,163,26217,26204,26168,26147,26136
37383,8746,12514,35479,1904,35479,1904,5.00828e+18,85.8431,15107.6,37383,5972,111,29525,29525,29525,29525,29525
3142,488,821,0,3142,0,3142,6.43645e+17,93.3689,1280.72,3142,376,71,2321,2321,1956,1724,1629
9572,263,706,0,9572,9292,280,4.37676e+16,32.7511,1730.48,9572,89,26,8866,8852,7263,7446,3962
3336,861,917,3146,190,3146,190,3.3792e+18,93.5887,1390.1,3336,417,74,2419,2419,2358,2384,2396
30122,8,12,29262,860,30110,12,1.38607e+14,10.2965,490.543,30122,12,11,23671,23179,23016,23252,22789
14220,591,827,0,14220,13804,416,4.24542e+16,129.001,2234.35,14220,113,26,33370,33370,13369,6924,3896
16768,252,4068,15788,980,15788,980,1.30263e+18,97.8793,5624.68,16768,1920,111,12700,12700,3895,4427,1712
25245,9065,9262,0,25245,9457,15788,2.09267e+15,56.9443,10907.9,25245,4492,72,24491,28496,41808,41808,41808
2445,19,617,0,2445,855,1590,2.593e+15,57.7591,939.95,2445,297,58,917,171,284,221,71
48302,13473,18980,0,48302,0,48302,5.1333e+17,95.3732,21990,48302,9218,110,29322,29322,27041,25353,23448
49059,17275,27261,10560,38499,0,49059,5.3305e+10,8.98488,27686.6,49059,24529,11,46533,46533,46533,46533,46533
35954,812,8684,33881,2073,33881,2073,3.39689e+18,97.6979,11529.5,35954,4215,110,34733,34733,32546,32760,29450
38127,8298,8968,35907,2220,0,38127,2.22633e+18,97.8124,11963.6,38127,4350,110,37567,37567,33886,30892,27527
12594,3000,6690,0,12594,0,12594,4.00691e+17,91.1863,7589.91,12594,3220,106,5904,5904,4571,4836,2782
49080,173,176,48943,137,49080,0,6.15616e+18,173.095,2732.58,49080,168,169,48916,48916,48916,48916,48916
13919,1816,3321,0,13919,0,13919,6.47756e+17,97.2192,4705.56,13919,1596,110,10598,10598,8545,6144,6268
17161,1759,4082,16164,997,0,17161,2.22652e+18,97.311,5698.44,17161,1960,110,12710,12710,9472,8971,6400
48013,4514,11429,45233,2780,45233,2780,3.36391e+18,97.8543,15020.6,48013,5545,110,31593,31593,23264,15772,13363
49672,32101,49672,49672,0,0,49672,7.99984,0,49672,49672,49672,1,0,0,0,0,0
38399,6126,11677,38399,0,36165,2234,4.88484e+18,274.498,13636.5,38399,3016,133,29629,29629,26873,23170,22326
22343,10673,14478,19808,2535,19808,2535,2.85489e+18,5.52066,16629.9,22343,4822,13,7865,7865,7333,7334,6065
34269,4,12,33215,1054,34147,122,1.84562e+13,5.98891,563.144,34269,9,7,4409,1222,914,1231,395
3925,404,424,0,3925,3805,120,5.14225e+16,18.8836,969.225,3925,62,26,3501,3501,3469,3465,3347
48813,150,176,48731,82,48813,0,5.98004e+18,171.897,2617.44,48813,171,173,48639,48638,48623,48617,48605
1275,173,340,0,1275,453,822,2.67037e+15,55.9098,538.316,1275,165,48,935,935,45124,44945,44485
31744,115,176,31649,95,31744,0,6.1452e+18,171.533,2199.58,31744,155,159,29404,26393,19200,19818,19402
1811,427,503,0,1811,0,1811,6.75855e+17,90.2938,803.807,1811,226,55,0,0,6484,782,1660
28389,5465,6690,26739,1650,0,28389,2.22582e+18,97.6898,9073.96,28389,3232,110,21699,21699,20126,19850,18528
5284,1916,2323,0,5284,0,5284,4.8454e+17,92.437,2871.53,5284,1108,83,2961,2961,2543,2477,2452
4402,1777,2218,0,4402,0,4402,3.4388e+15,17.8278,2397.1,4402,1982,20,2184,2184,1780,2184,1791
39103,6792,14044,37198,1905,37198,1905,7.72725e+18,95.8359,16705.9,39103,6822,110,32302,32302,32302,32302,32302
21337,5318,6423,20197,1140,20197,1140,3.15326e+18,89.1933,8209.42,21337,3090,110,14914,14914,12776,13714,12100
18634,2222,9542,0,18634,0,18634,4.14193e+17,91.5468,10775.7,18634,4617,110,9092,9092,6349,4538,3963
37843,5217,8807,0,37843,13300,24543,2.53824e+15,60.0681,11460.2,37843,4290,72,30089,29728,18995,19501,10353
38882,1552,12663,14300,24582,0,38882,8.70374e+12,58.5567,15105.2,38882,6160,72,29936,29936,23882,28287,23820
31936,7103,16863,31936,0,22932,9004,4.9245e+18,582.439,18453.7,31936,4749,136,27349,27349,25872,25322,23861
41458,10000,15569,39478,1980,39478,1980,4.63967e+18,96.2181,18246,41458,7470,111,43676,43676,43676,43676,43676
22407,8163,10394,22407,0,21417,990,5.26291e+18,253.04,11631,22407,3615,130,12013,12001,11461,11969,10236
33717,1107,1299,0,33717,32741,976,4.03084e+16,267.133,4174.75,33717,208,26,21816,20491,11645,14617,2366
27572,3839,6500,0,27572,0,27572,6.47615e+17,97.7027,8826.97,27572,3148,110,21031,21031,18529,20262,13300
16002,2845,4697,0,16002,5790,10212,2.33682e+15,58.9459,5956.34,16002,2282,72,11305,11305,9959,10181,8553
30468,289,1403,0,30468,29577,891,4.38736e+16,260.126,4384.69,30468,227,26,21408,21225,9064,15077,3354
18390,2529,4317,6463,11927,0,18390,9.88243e+12,59.823,5803.42,18390,2094,72,13753,13753,10152,11728,8042
26857,3,4,26018,839,26761,96,0.000111703,0.999851,319.756,26857,4,1,15087,14723,14569,14600,14574
30145,2608,10321,25009,5136,28625,1520,4.23902e+18,96.6179,12499.3,30145,4929,111,43261,43261,43261,43261,43261
44764,2605,23985,18125,26639,0,44764,5.995e+12,54.6482,26011.7,44764,11668,72,43166,43166,43166,43166,43166
11299,3122,11299,11299,0,0,11299,134206000,0,11299,11299,11299,1,0,0,0,0,0
39899,158,208,39808,91,39899,0,6.02291e+18,199.284,2591.63,39899,181,178,39708,39705,39680,39654,39645
26587,650,884,0,26587,25829,758,3.5602e+16,159.894,2761.33,26587,126,26,22392,22392,17630,16980,11146
34336,13349,14076,32794,1542,32794,1542,8.45278e+18,94.9852,16333.3,34336,6835,110,33053,33053,33053,33053,33053
27408,6,12,26626,782,27394,14,1.39033e+14,10.3882,469.266,27408,12,11,27125,26989,26400,26254,25322
8984,970,3092,8534,450,8534,450,2.99345e+18,94.8521,3991.32,8984,1473,107,6722,6722,5033,4906,3500
40502,9,17,39293,1209,40400,102,1.88426e+14,10.5181,706.697,40502,14,13,9258,5262,4572,4920,4239
32544,108,1139,0,32544,31607,937,3.80658e+16,234.207,3675.99,32544,176,26,25013,12938,9940,4137,4905
32187,74,176,32109,78,32187,0,5.97838e+18,169.679,2125.56,32187,170,166,32018,31906,31923,31881,31929
8901,586,2083,3125,5776,0,8901,9.92266e+12,59.6577,2939.63,8901,1009,72,6818,6818,3822,6006,2093
29519,12886,15746,29519,0,29519,0,2.94907e+18,17.9035,16219.3,29519,14155,20,28189,28189,28189,28189,28189
47356,4030,11094,0,47356,0,47356,6.46405e+17,97.8677,14659.9,47356,5370,110,41888,41888,41568,41568,38245
17411,11,14,16903,508,17364,47,1.60517e+14,10.6662,423.582,17411,12,11,22529,22515,535,999,20
33952,11,12,32970,982,33931,21,1.52187e+14,10.1482,536.285,33952,11,12,33940,33940,33723,33724,33384
26004,2185,6149,24489,1515,0,26004,2.22585e+18,97.6494,8368.12,26004,2976,110,19855,19855,14477,13405,7988
17420,2584,4332,16420,1000,0,17420,2.1947e+18,97.2098,5950.18,17420,2091,110,29672,29672,16889,10354,5698
31794,59,176,31774,20,31794,0,5.98017e+18,169.754,2112.81,31794,163,167,21889,11397,9204,10920,10712
11833,245,2857,11145,688,11145,688,5.773e+18,96.9577,4078.12,11833,1368,110,45584,0,0,0,0
42989,150,176,42971,18,42989,0,5.99663e+18,172.55,2489.26,42989,170,173,43849,43828,43793,43747,43746
28249,5,12,27431,818,28228,21,1.56924e+14,10.233,491.98,28249,11,12,22616,18303,9490,14198,2958
47713,1,14,46344,1369,47688,25,1.4805e+14,10.3528,644.372,47713,13,12,18463,18463,18463,18463,18463
5548,333,1414,5228,320,5228,320,3.21249e+18,95.6044,2110.81,5548,666,89,4134,4134,2355,3160,1398
23720,1,6,23324,396,23688,32,9.85874e+13,3.99751,353.137,23720,5,4,23616,23616,12352,12352,12352
43060,9652,13870,40840,2220,0,43060,1.97349e+18,96.4584,16869.3,43060,6728,110,33022,33022,33022,33022,32645
45314,11196,18942,45314,0,43084,2230,4.68305e+18,410.052,20795.4,45314,4873,140,46927,46927,46927,46927,46927
26217,117,175,26208,9,26217,0,5.97426e+18,166.987,1915.18,26217,160,164,24975,11407,14567,4613,1765
40775,59,208,40710,65,40775,0,6.00348e+18,200.863,2546.38,40775,183,176,29923,22928,24989,28209,20603
46203,7258,10814,43514,2689,0,46203,2.22749e+18,97.8901,14308.4,46203,5244,110,35621,35621,35323,35313,32423
10664,1166,2591,10044,620,10044,620,5.92358e+18,96.8107,3719.97,10664,1238,110,22173,22173,21822,0,7157
22863,5816,8189,21743,1120,21743,1120,2.90708e+18,95.6753,9954.24,22863,3969,110,14674,14674,13760,14471,13042
40456,13616,18531,0,40456,0,40456,4.59483e+17,94.2811,20929.9,40456,9008,110,32468,32468,32468,32468,32468
41002,1,15,39813,1189,40949,53,1.5606e+14,9.80345,628.668,41002,11,12,30719,30719,30719,30719,30719
32016,9631,15344,32016,0,23901,8115,4.89534e+18,451.695,16861.8,32016,3685,135,23023,23023,23023,23023,23023
31809,8625,14961,12513,19296,0,31809,6.83476e+12,55.0861,16680,31809,7266,72,41743,41743,41743,41743,41743
48660,15766,18378,48660,0,46101,2559,4.40431e+18,417.288,20389.4,48660,5880,138,47994,47994,47994,47994,47994
46028,9813,21986,0,46028,0,46028,4.42554e+17,93.0395,24565.2,46028,10687,110,40191,40191,40191,40191,40191
48952,9704,11415,17205,31747,0,48952,9.87417e+12,60.0525,14696.6,48952,5550,72,3634,3634,3071,3634,3071
30484,596,10637,28974,1510,0,30484,1.89691e+18,95.6696,12862.7,30484,5155,110,26429,26010,11797,14704,1808
21749,4198,7331,0,21749,0,21749,5.62975e+17,95.998,9074.01,21749,3553,110,14418,14418,12533,10078,9623
1831,375,464,646,1185,0,1831,1.02017e+13,57.42,727.991,1831,226,53,1367,1367,1246,1344,1219
19391,7037,8002,18521,870,18521,870,8.32554e+18,94.6984,9462.86,19391,3875,110,11389,11389,11249,11225,10994
35290,8040,8465,33230,2060,33230,2060,5.70773e+18,98.2698,11210.8,35290,4002,111,35076,35076,35076,35076,35076
3345,85,154,0,3345,3247,98,3.53718e+16,19.8493,459.291,3345,37,26,3191,3191,3006,3025,2195
47110,271,1262,0,47110,45767,1343,3.55623e+16,259.593,4424.35,47110,201,26,44157,42805,35596,25974,10290
33713,375,10784,12369,21344,0,33713,8.76625e+12,58.6692,12980.6,33713,5246,72,20706,17992,8925,10842,380
25037,7221,7320,0,25037,9053,15984,2.333e+15,58.9889,9104.53,25037,3553,72,24879,21881,17245,13171,11541
24195,3570,5736,22789,1406,22789,1406,5.89958e+18,97.5664,7837.11,24195,2775,110,18459,18459,17929,17929,12273
24144,4,11,23456,688,24138,6,1.38616e+14,10.0936,433.585,24144,11,11,20890,18483,15528,15834,11688
25583,9969,10547,0,25583,0,25583,4.98909e+17,90.194,12344.2,25583,5114,110,11992,11992,10562,8900,8953
5313,2537,2659,5313,0,5081,232,3.79744e+18,91.4457,3091.33,5313,1138,91,18370,17675,10087,13174,4426
20192,7158,10177,0,20192,8063,12129,1.63664e+15,52.0665,11322.8,20192,4943,72,10015,10015,9361,8557,8792
8913,2527,3520,8496,417,8496,417,8.132e+18,89.0748,4362.06,8913,1690,108,5393,5393,5246,5246,4055
16878,3890,5321,16878,0,15898,980,3.24135e+18,136.556,6416.52,16878,2023,121,22605,22605,15089,15027,4137
18445,81,176,18433,12,18445,0,6.10305e+18,169.873,1679.05,18445,147,146,15293,10348,8076,8508,8242
1971,212,599,0,1971,0,1971,6.2126e+17,87.4729,915.951,1971,262,56,1372,1372,763,631,549
10386,1635,5872,4246,6140,0,10386,5.66917e+12,51.6889,6500.42,10386,2843,72,4514,4514,3108,4014,1762
14491,2703,4858,14491,0,13651,840,5.7048e+18,119.947,5741.09,14491,1737,121,22370,22370,22370,22370,22370
6018,1857,2860,6018,0,5745,273,4.19923e+18,92.5,3342.4,6018,1203,96,3158,3158,3034,3067,2860
36828,12944,14037,35095,1733,35095,1733,8.04364e+18,95.4698,16508.3,36828,6817,110,27634,27634,27634,27634,27634
45024,8730,11536,42480,2544,42480,2544,6.22402e+18,97.5436,14883,45024,5599,110,39834,39834,39834,39834,39834
32992,1278,12743,0,32992,0,32992,5.19584e+17,94.8357,15003,32992,6178,110,24533,24485,11771,19704,2157
35734,2321,10401,33794,1940,33794,1940,1.79616e+18,97.4707,13031.9,35734,4947,111,33679,33679,27777,0,0
907,88,272,0,907,317,590,2.39812e+15,53.3308,425.002,907,120,41,44298,43794,34914,24170,9241
48255,10424,11219,45437,2818,0,48255,2.23302e+18,97.9297,14839.8,48255,5447,110,37036,37036,36137,35825,34973
48135,13664,26778,0,48135,19675,28460,1.46341e+15,54.5607,28852.5,48135,13029,72,44096,44096,44096,44096,44096
31442,1,14,30538,904,31362,80,1.51749e+14,10.6542,568.677,31442,14,12,168,168,168,168,168
18223,2224,7749,17423,800,0,18223,1.68256e+18,94.4039,9118.93,18223,3751,110,10474,10474,7005,6220,3288
40631,2545,14815,40631,0,38431,2200,4.8937e+18,279.801,16530,40631,5511,134,31181,31181,27795,24577,24350
7960,631,2017,7500,460,7500,460,3.57416e+18,96.7866,2913.88,7960,941,104,5943,5943,3369,4130,2449
41713,14,176,41699,14,41713,0,5.98195e+18,172.21,2420.86,41713,170,172,9157,1756,1073,2664,1056
26549,8572,12128,25449,1100,0,26549,1.58624e+18,93.5539,13871,26549,5873,110,21628,21628,21628,21628,20399
38006,3991,18815,36536,1470,36536,1470,5.72157e+18,94.1124,20943.1,38006,9065,111,47993,47993,47993,47993,47993
24265,12,15,23536,729,24208,57,1.9205e+14,10.567,537.176,24265,13,11,24250,24249,23925,23926,22088
49467,7,16,48044,1423,49377,90,1.49293e+14,10.3717,673.959,49467,14,13,22100,16466,16637,16359,16745
38988,10171,16358,37251,1737,37251,1737,2.921e+18,95.5403,18767.9,38988,7858,111,38907,38907,38907,38907,38907
29784,97,176,29728,56,29784,0,6.09397e+18,171.975,2135.47,29784,163,158,32193,29412,18122,29726,686
35333,7,15,34303,1030,35277,56,1.65381e+14,10.3945,603.011,35333,13,12,34286,33566,30607,27806,19890
19821,3726,4690,18671,1150,0,19821,2.22638e+18,97.4273,6497.81,19821,2250,110,19462,19462,19462,19462,19462
47989,4561,11111,16864,31125,0,47989,9.90996e+12,60.1165,14346.8,47989,5413,72,39172,39172,35267,37086,32140
40111,9846,12217,40111,0,37781,2330,4.89467e+18,286.159,14244,40111,4789,128,39960,30255,30255,30255,30255
24870,5023,11345,0,24870,0,24870,4.6101e+17,92.8881,13007,24870,5493,110,13525,13525,11165,9031,7684
41240,1230,9620,0,41240,0,41240,6.49571e+17,97.8802,12812.1,41240,4668,110,40069,40069,40069,40069,40069
35263,7,14,34258,1005,35189,74,1.38858e+14,10.6063,575.123,35263,14,12,32946,31519,30625,28779,22764
18885,6543,7729,0,18885,7223,11662,1.95703e+15,57.1469,8973.79,18885,3761,72,15468,15468,15468,15468,15468
45464,17612,17948,0,45464,17285,28179,1.99883e+15,57.469,20492.6,45464,8738,72,44228,44228,41841,34904,34904
6842,107,176,6841,1,6842,0,6.00237e+18,158.403,1000.22,6842,109,111,6160,4393,3970,4113,4187
40028,4843,9633,0,40028,14122,25906,2.50923e+15,59.9358,12388.9,40028,4692,72,47466,47466,47466,47466,47466
31807,1137,1433,0,31807,30872,935,4.36328e+16,273.087,4515.68,31807,230,26,30374,30374,29925,29912,27414
3293,26,2146,3293,0,3191,102,5.0058e+18,87.2997,2397.12,3293,946,61,469,52,123,142,117
2804,8,10,2724,80,2804,0,1.38228e+14,9.84914,146.038,2804,10,10,2730,2698,2183,2200,2272
40004,983,1136,0,40004,38864,1140,3.56109e+16,238.538,3864.54,40004,175,26,39813,39813,39813,39813,39813
42646,10496,13046,40396,2250,0,42646,2.01925e+18,96.5557,16082.8,42646,6331,110,42202,42202,42202,42202,42202
16680,903,8573,16060,620,16060,620,9.92843e+18,90.6985,9709.67,16680,4146,110,8107,7763,3532,6923,1818
45978,28166,42967,0,45978,0,45978,6.03845e+17,3.99476,43072.8,45978,14339,9,25613,25613,25613,25613,25613
14602,3173,5027,14602,0,13770,832,3.38775e+18,122.069,5908.58,14602,1831,120,9575,9537,7715,8416,6701
49706,2631,16883,47196,2510,47196,2510,2.8875e+18,95.9773,20105.2,49706,8064,111,31753,31705,21799,29952,9421
15336,132,6536,15336,0,14596,740,4.55928e+18,146.511,7474.24,15336,1852,125,8747,3016,4517,5970,668
14420,1849,6937,13848,572,13848,572,2.52711e+18,92.6706,8007.03,14420,3345,110,7483,7483,5291,5398,2997
10958,274,476,3197,7761,3197,7761,1.74649e+18,15.9708,861.715,10958,466,18,10482,10482,7945,8719,9287
18013,933,1037,3693,14320,0,18013,5.76842e+13,11.9893,1469.72,18013,747,14,16976,16976,16238,15771,16640
13265,2238,6224,13265,0,10115,3150,4.01323e+18,147.981,6990.7,13265,2363,126,12536,12536,12536,12536,12536
25604,12898,13020,25604,0,24576,1028,5.04002e+18,313.222,14347.9,25604,5609,130,24828,24828,24828,24828,24828
1931,285,542,1821,110,1821,110,3.33944e+18,90.3553,859.962,1931,230,58,13392,13392,13126,13274,12385
39175,1320,1456,0,39175,38036,1139,4.04553e+16,286.112,4783.97,39175,240,26,43724,43724,41793,40914,28892
23023,755,1018,0,23023,22355,668,4.0531e+16,204.563,3060.24,23023,152,26,22005,22005,20501,21167,18186
23672,2585,15343,20982,2690,20982,2690,7.8831e+17,6.51403,17632.5,23672,5121,14,8329,8329,5541,4956,1847
17899,6330,6929,0,17899,0,17899,5.19809e+17,94.9457,8345.55,17899,3347,110,10970,10970,10624,10064,10320
49751,1168,11603,0,49751,17486,32265,2.52583e+15,60.0636,14931.7,49751,5637,72,47680,47680,44387,44938,35591
30355,11,15,29475,880,30299,56,1.57646e+14,10.649,573.629,30355,13,11,8428,2820,1565,3636,186
24812,4706,6642,0,24812,8869,15943,2.41834e+15,59.4595,8465.96,24812,3232,72,18170,18170,16050,15484,13622
42876,260,1582,0,42876,41631,1245,4.079e+16,290.39,5246.23,42876,262,26,44982,44982,44982,44982,44982
10956,4,176,10892,64,10956,0,6.02564e+18,163.459,1271.72,10956,129,129,1272,239,107,110,179
34678,12168,14964,33178,1500,33178,1500,8.64235e+18,92.3144,17178.2,34678,7248,110,33615,33615,33615,33615,33615
41512,11367,13267,41512,0,39095,2417,4.03973e+18,291.338,15049.7,41512,3952,133,33431,33431,33431,33431,33431
47201,10523,10988,0,47201,0,47201,6.49294e+17,97.9128,14546.4,47201,5330,110,47101,47101,47101,47101,47101
29845,3253,7833,0,29845,10642,19203,2.43304e+15,59.5447,9958.71,29845,3804,72,32167,32167,22807,30509,11336
13307,1213,3188,12527,780,12527,780,5.76023e+18,97.1538,4518.95,13307,1528,110,10119,10119,8909,8715,4313
20931,4338,5577,0,20931,7483,13448,2.43044e+15,59.4395,7171.67,20931,2712,72,15354,15354,13634,12263,11719
24612,1,14,23893,719,24560,52,1.69672e+14,10.4152,498.931,24612,12,11,11800,11800,11800,11800,11800
46030,7852,18521,43920,2110,43920,2110,3.29483e+18,95.7668,21324.7,46030,8895,111,45481,45481,45481,45481,45481
11617,152,176,11555,62,11617,0,6.09579e+18,162.024,1334.04,11617,126,126,11300,11042,10096,10123,9957
13037,3009,4874,13037,0,12324,713,3.91954e+18,118.906,5679.83,13037,1851,120,8163,8126,6922,7512,6491
40819,5465,13052,40819,0,38447,2372,5.08872e+18,290.22,14814.8,40819,4268,133,27767,27623,20849,24564,12915
12316,72,176,12308,8,12316,0,6.01769e+18,161.909,1354.21,12316,133,136,25181,8127,19644,17643,2350
10838,70,3594,3984,6854,0,10838,8.61981e+12,58.1159,4490.09,10838,1740,72,7244,4663,2086,4965,249
30361,7696,7927,28653,1708,0,30361,2.15228e+18,97.3216,10369.3,30361,3838,110,22434,22434,22147,22129,22046
23456,684,5530,0,23456,8247,15209,2.52109e+15,59.9346,7334.21,23456,2686,72,17926,17926,6708,6352,2536
2463,1099,1393,2463,0,1602,861,7.27899e+18,87.8863,1625.19,2463,586,56,1070,1070,895,1013,791
17201,2557,4180,16201,1000,16201,1000,4.11496e+18,97.8027,5768.99,17201,1965,111,25726,22221,11319,7062,4595
39939,11164,14715,38009,1930,38009,1930,3.12394e+18,94.7599,17339.1,39939,7036,111,25224,25224,21329,21924,19640
4248,1045,1118,4000,248,4000,248,3.34417e+18,94.9649,1685.94,4248,526,84,47304,47885,6846,6846,6846
33325,7847,8008,31385,1940,31385,1940,2.78479e+18,98.2395,10638.4,33325,3787,111,35240,35240,35240,35240,35240
48274,1007,1284,0,48274,46897,1377,3.55661e+16,262.012,4518.14,48274,206,26,31656,31560,23835,16706,14505
11930,2574,2840,0,11930,4193,7737,2.53598e+15,59.6836,3899.04,11930,1382,72,9090,9090,8705,8800,8430
16699,4256,7395,16699,0,12935,3764,4.13865e+18,156.868,8299.92,16699,3063,120,17197,17197,17197,17197,17197
15235,5071,5760,5742,9493,0,15235,8.10088e+12,57.5612,6852.35,15235,2806,72,11721,11721,11721,11721,11721
29556,5819,7995,10588,18968,0,29556,9.42434e+12,59.4358,10083.2,29556,3890,72,20119,20119,15020,16885,14136
18075,394,792,0,18075,17556,519,3.77211e+16,103.181,2247.86,18075,107,26,13937,13937,4997,11143,1582
41263,1841,1926,0,41263,40048,1215,4.60604e+16,313.172,6205.69,41263,331,26,39761,39761,39761,39761,39761
14711,3254,5742,14711,0,13931,780,4.87959e+18,131.127,6604.7,14711,1652,121,8969,8895,7537,8162,4191
8312,1,11,8077,235,8307,5,1.39518e+14,10.4877,256.234,8312,11,11,2116,2116,2116,2116,2116
15201,1385,5910,5750,9451,0,15201,7.93303e+12,57.3752,6988.68,15201,2871,72,9291,9291,5396,8059,1458
5363,181,246,0,5363,5212,151,3.58071e+16,19.7917,705.801,5363,47,26,5117,5117,4797,4821,4175
1300,453,506,1300,0,1078,222,3.11319e+18,83.0662,695.794,1300,175,48,794,794,767,781,790
27503,10038,12796,27503,0,26293,1210,5.37915e+18,289.419,14222.1,27503,4395,133,32316,32316,32316,32316,32316
39126,9582,9738,36893,2233,36893,2233,6.11425e+18,97.6136,12756.8,39126,4719,110,34155,34155,33954,33954,33954
11628,2771,4199,11058,570,11058,570,3.01535e+18,94.6504,5261.03,11628,2007,110,14787,14787,6279,9488,3228
8294,1340,2902,8294,0,7827,467,4.31148e+18,91.1639,3574.16,8294,1119,113,5392,5392,3797,4377,2735
25285,4356,6133,23815,1470,23815,1470,3.15151e+18,98.0705,8254.43,25285,2895,111,44791,44791,44791,44791,44791
35111,12,15,34083,1028,35058,53,1.71494e+14,10.2924,608.497,35111,12,12,35096,35094,34434,34452,34032
31858,432,975,0,31858,30951,907,3.54837e+16,194.278,3177.26,31858,143,26,25847,25847,15678,14466,3001
25968,6917,14832,0,25968,5565,20403,1.37003e+13,8.97343,15130.5,25968,13342,11,12620,12620,10279,10977,8716
48878,16962,18774,48878,0,46456,2422,4.72288e+18,973.159,21298.7,48878,5665,142,35711,35711,35711,35711,35711
13787,537,3279,12987,800,12987,800,5.87237e+18,96.8699,4654.18,13787,1562,110,10508,10508,9478,8793,2371
27366,74,1066,0,27366,26576,790,3.90701e+16,215.915,3322.47,27366,162,26,25952,25822,21536,19338,6237
9883,1890,4843,9883,0,9453,430,3.72014e+18,124.146,5507.44,9883,2096,110,5040,4983,3366,3963,2665
3538,8,11,3436,102,3537,1,1.38112e+14,10.7012,167.252,3538,11,11,3429,3370,2645,2666,2721
40577,12903,14384,40577,0,38337,2240,4.22268e+18,287.636,16108.2,40577,5590,129,32886,32886,32683,32824,32357
17547,291,913,0,17547,17037,510,4.19813e+16,159.264,2589.24,17547,131,26,16634,16372,14914,13785,9467
7349,324,325,0,7349,7137,212,3.57102e+16,20.0418,924.296,7349,54,26,7024,7024,7023,7021,7021
46826,2167,2405,46826,0,44894,1932,2.38614e+18,17.9431,3255.09,46826,1942,25,38900,38900,29713,32226,21391
18829,3509,6033,0,18829,6907,11922,2.2553e+15,58.532,7411.55,18829,2939,72,12796,12796,10994,10781,8132
9009,1174,2297,0,9009,0,9009,6.42439e+17,96.401,3280.97,9009,1100,109,30863,30863,29190,27455,28002
12897,126,3107,12147,750,12147,750,3.22503e+18,97.0479,4408.22,12897,1482,110,11482,5720,4591,7295,718
49627,11035,11595,46737,2890,0,49627,2.2278e+18,97.9167,15297.2,49627,5625,110,31398,28592,27407,27352,23810
14608,2146,5045,0,14608,5421,9187,2.17284e+15,58.0468,6148.76,14608,2450,72,9563,9563,7587,5068,4543
14136,53,61,14136,0,14136,0,2.34393e+18,60.5148,880.212,14136,61,61,10886,4506,3638,18,0
48266,15099,18684,46016,2250,46016,2250,6.61501e+18,95.469,21716.3,48266,9074,110,32010,32010,29561,30524,28893
609,46,47,0,609,591,18,3.56147e+16,15.7455,122.453,609,20,21,562,562,562,561,561
36980,2409,8660,0,36980,13008,23972,2.52794e+15,60.0499,11265.2,36980,4218,72,43991,43991,43991,43991,43991
22633,3762,7418,22633,0,21313,1320,3.24772e+18,158.461,8592.95,22633,2697,125,17469,17469,15993,15419,13791
931,309,321,0,931,0,931,5.98292e+17,81.5231,494.98,931,122,42,610,610,610,610,610
32296,2537,7780,30416,1880,30416,1880,2.00031e+18,98.1979,10343.2,32296,3670,111,24990,24990,15099,18384,11109
37557,9971,11073,35544,2013,0,37557,2.05204e+18,96.8485,13851.8,37557,5372,110,41524,41524,41524,41524,41524
42478,5028,21081,40838,1640,40838,1640,2.47613e+18,94.4121,23394.4,42478,10172,111,21397,21397,15721,13985,7798
49061,9704,17047,46609,2452,46609,2452,3.30786e+18,96.7176,20202.8,49061,8157,111,39337,39337,39334,39337,39337
10916,1061,2601,0,10916,3844,7072,2.53589e+15,59.6446,3590.14,10916,1267,72,8315,8315,6107,4095,3672
32878,68,208,32791,87,32878,0,6.08641e+18,195.329,2412.31,32878,164,163,23161,6833,8638,6704,323
37603,1167,11612,35625,1978,0,37603,2.01183e+18,96.6665,14351.4,37603,5637,110,37328,37328,37328,37328,37328
4831,5,11,4689,142,4826,5,1.62383e+14,10.2405,202.747,4831,11,11,4444,4019,3371,3301,2581
4710,181,1187,4440,270,0,4710,2.22386e+18,94.8875,1807.57,4710,543,84,3523,3523,2187,1890,823
31797,1124,7474,29947,1850,0,31797,2.22711e+18,97.7348,10074.2,31797,3615,110,29866,29811,28440,29032,21475
34653,12541,14315,33093,1560,33093,1560,4.69855e+18,95.6388,16539.1,34653,6883,111,25930,24789,32361,30982,29962
36139,15844,17537,34727,1412,34727,1412,2.62386e+18,93.4545,19650.8,36139,8513,110,18602,18602,17202,17745,16933
29451,1998,6931,0,29451,0,29451,6.50058e+17,97.7316,9376.44,29451,3357,110,22520,22520,13391,8373,7791
31090,10959,11797,0,31090,11722,19368,2.0489e+15,57.6795,13707.2,31090,5737,72,34355,34355,31608,27633,26809
18161,82,175,18155,6,18161,0,5.98007e+18,165.509,1595.21,18161,153,151,14901,8436,7934,8538,8658
34927,1,14,33932,995,34854,73,1.39194e+14,10.5263,563.053,34927,14,12,8926,8926,23150,23150,23150
37452,11789,16759,14586,22866,0,37452,7.12023e+12,56.5961,18782,37452,8148,72,36788,36788,36788,36788,36788
35163,429,8303,33123,2040,33123,2040,5.91265e+18,97.7524,11114.5,35163,4022,110,24305,24218,20364,20957,17335
4496,16,176,4490,6,4496,0,6.10502e+18,149.449,828.244,4496,96,92,1566,319,383,395,426
26867,4,14,26089,778,26788,79,1.57233e+14,10.5991,521.26,26867,14,12,7891,6796,6308,6322,6220
14486,724,3546,13639,847,13639,847,3.94712e+18,97.6633,4937.07,14486,1660,111,31051,30029,15022,8076,1947
33722,13,14,32760,962,33648,74,1.38893e+14,10.587,558.165,33722,14,12,33708,33708,33558,33558,33027
12784,255,6521,0,12784,5109,7675,1.63255e+15,52.1926,7322.94,12784,3160,72,6263,6071,2573,1576,946
18150,4248,4313,17100,1050,0,18150,2.22396e+18,97.3187,6001.29,18150,2068,110,13837,13837,13803,13810,13810
2955,697,729,0,2955,1040,1915,2.59902e+15,58.3029,1100.86,2955,355,61,2226,2226,2200,2194,2204
14332,825,3462,13497,835,13497,835,3.15066e+18,97.613,4849.52,14332,1620,111,26435,26193,26377,26390,20160
10815,929,5139,0,10815,0,10815,4.52838e+17,93.2911,6012.66,10815,2484,110,5676,5380,3054,1828,982
47728,6121,16638,45348,2380,45348,2380,6.10584e+18,96.6937,19725.5,47728,7966,111,30303,30303,22744,25339,0
41620,9,13,40426,1194,41596,24,1.46033e+14,10.3432,593.329,41620,12,12,11685,0,0,0,53
30573,3836,8299,10951,19622,0,30573,9.38885e+12,59.4078,10445.1,30573,4030,72,25483,25483,24210,25206,23284
49319,6374,17066,0,49319,0,49319,5.52959e+17,96.1199,20314,49319,8289,110,49177,49177,49177,49177,49177
16433,602,689,0,16433,15962,471,3.55267e+16,21.1376,1900.75,16433,88,26,16405,16405,16405,16405,16405
6755,1957,2302,6413,342,6413,342,7.29286e+18,90.024,3035.73,6755,1082,94,28610,28610,20252,21785,6390
31074,4137,7259,0,31074,10928,20146,2.53265e+15,60.0242,9521.49,31074,3531,72,23815,23815,20076,15102,13895
12174,4147,4542,12174,0,11524,650,3.51502e+18,114.233,5384.75,12174,1810,120,7632,7632,7629,7632,7632
41891,6604,14614,0,41891,15579,26312,2.15202e+15,58.2186,17136.1,41891,7115,72,24862,24862,19405,14416,13450
42321,10030,42321,42321,0,42321,0,34358900000,0,42321,42321,42321,1,42,42,0,35,0
8884,173,208,8875,9,8884,0,6.064e+18,170.32,1249.93,8884,116,119,21355,21046,11444,8667,7462
12369,464,2927,0,12369,4351,8018,2.531e+15,59.7823,4022.14,12369,1425,72,9442,9442,5907,2602,1727
18527,2678,4382,17447,1080,0,18527,2.2297e+18,97.422,6099.73,18527,2110,110,24061,24061,12313,10438,7201
9918,3241,3459,0,9918,3684,6234,2.18451e+15,57.8334,4274.24,9918,1685,72,6459,6459,6196,6159,5950
18318,4021,4458,17256,1062,17256,1062,3.24758e+18,97.7935,6121.38,18318,2090,111,13860,13860,13093,13279,12962
36012,7044,12704,13421,22591,0,36012,8.34805e+12,57.4568,14929.5,36012,6182,72,34368,34368,34368,34170,34170
23746,2969,8407,8850,14896,0,23746,8.32712e+12,57.8673,9999.61,23746,4090,72,17412,17412,15877,15237,0
34792,11,13,33784,1008,34775,17,1.55243e+14,10.1942,550.438,34792,12,12,34779,34779,34160,34169,33755
18900,950,4466,0,18900,0,18900,6.47845e+17,97.4612,6209.67,18900,2149,110,35175,35175,27733,20745,4767
9271,10,176,9261,10,9271,0,6.0908e+18,135.118,1192.67,9271,114,113,2370,432,483,395,352
11285,21,176,11281,4,11285,0,6.05521e+18,165.398,1305.35,11285,128,128,4673,925,1353,1438,1350
36972,1261,8615,0,36972,13000,23972,2.52853e+15,60.0434,11223.7,36972,4183,72,27012,27012,20940,25972,13711
14877,206,3510,0,14877,5229,9648,2.53295e+15,59.8149,4769.27,14877,1708,72,11367,11367,6579,556,835
40496,18565,19258,15971,24525,0,40496,6.7805e+12,56.1296,21317.3,40496,9380,72,32832,32832,32832,32832,32832
39528,6827,9232,37228,2300,37228,2300,5.88897e+18,97.8424,12324.9,39528,4474,110,39682,39682,39682,39682,39682
39482,14926,17520,39482,0,37762,1720,4.77734e+18,1030.55,19746.2,39482,7761,140,33411,33411,33411,33411,33411
48445,19054,20449,48445,0,46438,2007,4.52023e+18,2918.32,23923.2,48445,7114,143,34380,34380,34380,34380,34380
33371,728,1253,0,33371,32405,966,3.97288e+16,253.286,4037.63,33371,197,26,32118,32118,30377,30385,22926
19609,3432,7607,18680,929,18680,929,5.49635e+18,95.707,9095.96,19609,3641,111,15328,15328,14467,15145,13160
14606,3440,4056,13796,810,13796,810,6.31882e+18,96.6063,5431.29,14606,1947,110,12943,12943,12943,12943,12943
25691,12907,13634,25691,0,0,25691,8.86616e+17,17.9743,14076.1,25691,12255,20,36785,36785,36785,36785,36785
45544,9514,13911,16595,28949,0,45544,8.95039e+12,58.9085,16760.4,45544,6768,72,31786,31786,31266,30622,20190
20299,4447,6383,0,20299,0,20299,5.83531e+17,96.2394,8074.48,20299,3091,110,13916,13916,12051,11409,10123
48689,10963,11702,0,48689,17175,31514,2.50865e+15,59.9768,14943.4,48689,5700,72,35076,35044,32992,33999,30828
26337,1864,8859,0,26337,9731,16606,2.19573e+15,57.7217,10624.4,26337,4299,72,17478,17478,10187,5354,3755
30684,1,5,29725,959,30556,128,0.000130361,0.999837,380.508,30684,5,1,987,987,987,987,987
11504,1,11,11175,329,11503,1,1.38413e+14,10.2265,299.805,11504,11,11,2951,2951,2951,2951,2951
29085,7701,12701,27838,1247,0,29085,1.64361e+18,94.4671,14617.9,29085,6159,110,19800,19800,16330,14689,10782
42708,11192,20851,0,42708,16939,25769,1.69005e+15,55.3965,22964.8,42708,10151,72,34289,34289,34289,34289,34289
17489,8317,9521,0,17489,7110,10379,1.51655e+15,54.2184,10482.9,17489,4632,72,7968,7968,7452,7201,7071
45713,5008,23312,44008,1705,0,45713,1.4288e+18,92.7148,25753.3,45713,11332,110,45268,45268,45268,45268,45268
13143,2032,3476,0,13143,0,13143,6.26717e+17,96.764,4768.96,13143,1672,110,9667,9667,8107,8690,5798
23424,6827,10521,0,23424,9128,14296,1.81918e+15,56.5381,11915.2,23424,5113,72,22691,22691,22691,22691,22691
33764,9,13,32789,975,33743,21,1.5065e+14,10.2677,536.588,33764,12,12,11377,2466,2550,2198,2379
43756,17428,17889,0,43756,16730,27026,1.95101e+15,56.7435,20308.9,43756,8694,72,25867,25867,25867,25867,25867
48793,3963,11685,45953,2840,45953,2840,5.80797e+18,98.3782,15233.6,48793,5532,111,37341,37341,26203,31091,15359
42549,4605,17821,42549,0,40581,1968,4.81397e+18,919.601,20116.8,42549,4527,141,24728,28322,18813,21769,11698
16935,1906,5264,16040,895,16040,895,4.99391e+18,96.6844,6725.63,16935,2496,111,19056,19056,19056,19056,19056
35137,6968,8185,0,35137,12351,22786,2.53678e+15,60.0438,10682.7,35137,3987,72,24404,24404,22126,21716,12912
39519,6075,18038,0,39519,15448,24071,1.79344e+15,56.19,20122.6,39519,8765,72,19850,19850,14823,13752,9754
6990,8,11,6791,199,6988,2,1.38523e+14,10.3225,234.203,6990,11,11,6801,6702,6010,6011,5553
48897,14623,20440,46737,2160,0,48897,1.69374e+18,94.4757,23383.6,48897,9924,110,37066,37066,37066,37066,37066
31537,8213,8918,29817,1720,29817,1720,3.14566e+18,96.9528,11374.2,31537,4321,110,29601,29601,25494,19039,17540
26285,1006,9124,24975,1310,0,26285,1.90514e+18,95.8885,11109.5,26285,4426,110,17161,17161,9128,7115,4326
29901,2569,11034,11232,18669,0,29901,8.14188e+12,57.4704,12912.1,29901,5364,72,29781,29781,29781,29781,29781
10772,3775,4763,10312,460,10312,460,8.8384e+18,93.582,5676.06,10772,2287,105,6009,6009,5829,5829,4221
38489,19,176,38479,10,38489,0,5.98735e+18,169.841,2323.49,38489,170,170,9808,775,1076,1715,30
29652,5042,13454,11574,18078,0,29652,7.04561e+12,56.4322,15119.9,29652,6532,72,29308,29308,29308,29308,29308
29224,943,10732,27814,1410,0,29224,1.84583e+18,95.6264,12836.6,29224,5203,110,30319,30319,30319,30319,30319
20404,4368,8417,15471,4933,19484,920,3.46842e+18,94.8818,9911.68,20404,4031,111,11987,11987,8430,9052,7469
36404,10348,12826,13563,22841,0,36404,8.3515e+12,57.3688,15072.7,36404,6243,72,21550,21550,19257,18121,16177
29766,292,8078,0,29766,0,29766,6.17025e+17,97.1695,10460.4,29766,3916,110,21688,21516,6975,1122,2322
12906,3225,6629,12426,480,0,12906,1.43032e+18,85.0769,7571.09,12906,3190,110,10384,10384,10384,10384,10226
47830,9851,12607,45157,2673,0,47830,2.14122e+18,97.4068,16090.2,47830,6117,110,41545,41545,41545,41545,41545
33711,7155,7866,11852,21859,0,33711,9.88774e+12,60.0126,10282.6,33711,3823,72,42710,42710,42710,42710,42710
15836,1,12,15379,457,15823,13,1.53642e+14,10.5563,367.808,15836,12,11,3611,3611,3611,3611,3611
42885,8961,17702,42885,0,40865,2020,4.66395e+18,700.256,19964.3,42885,7980,143,40986,40986,40986,40986,40986
25467,85,175,25391,76,25467,0,5.97956e+18,167.142,1888.43,25467,164,162,21357,12251,11407,31301,30942
12804,143,176,12797,7,12804,0,5.99417e+18,165.714,1356.77,12804,137,138,12551,12423,7321,11607,629
12586,2283,3624,11896,690,11896,690,6.4571e+18,96.2909,4841.44,12586,1737,110,19502,19502,14294,18577,7513
38126,302,1148,0,38126,37034,1092,3.6352e+16,238.466,3856.32,38126,176,26,27165,26230,11517,17301,1220
33510,1431,7820,11781,21729,0,33510,9.88365e+12,60.0322,10226.1,33510,3802,72,28753,28753,11592,19028,3271
42950,18247,18263,41070,1880,0,42950,1.6746e+18,94.2835,20895.2,42950,8872,110,36028,36028,36028,36028,36028
6862,433,2366,0,6862,0,6862,5.62373e+17,94.4411,3103.15,6862,1122,92,4496,4410,2675,120,858
46749,6066,10830,16433,30316,0,46749,9.90638e+12,60.1111,13994.6,46749,5276,72,43338,43338,43338,43338,43338
17433,4774,6428,17433,0,16481,952,5.71393e+18,141.197,7401.83,17433,2140,127,12576,12576,12508,12523,12500
2479,111,186,2479,0,2479,0,5.96901e+18,141.534,599.361,2479,78,75,2183,1873,1452,1510,1473
39656,8,13,38525,1131,39644,12,1.388e+14,10.2131,564.743,39656,12,12,15324,13300,12842,13158,12480
41809,23,176,41756,53,41809,0,6.01938e+18,173.711,2493.37,41809,173,171,14082,914,2543,4519,66
14540,1318,4681,13780,760,13780,760,3.81496e+18,96.5429,5974.75,14540,2228,111,22830,22519,11640,8198,3475
9330,1479,4494,0,9330,3683,5647,1.72434e+15,54.9932,5158.77,9330,2167,72,4836,4836,3098,1530,1304
25212,1080,1440,0,25212,24463,749,4.85929e+16,275.259,4342.4,25212,235,26,23772,23772,23333,23130,20907
14357,2140,6915,13787,570,0,14357,1.52175e+18,91.2776,7982.77,14357,3329,110,13773,13773,13773,13773,13773
27438,12,13,26658,780,27365,73,1.38655e+14,10.751,508.993,27438,13,12,16176,13143,13133,14288,11484
48040,5823,11213,0,48040,16885,31155,2.52526e+15,60.0576,14445.8,48040,5449,72,34555,34555,25640,27174,15353
8347,984,2467,7889,458,7889,458,6.11652e+18,91.3492,3353.87,8347,1141,106,5880,5880,3657,4432,1820
27283,5534,7362,0,27283,9766,17517,2.42233e+15,59.4279,9317.29,27283,3586,72,19411,19411,16697,14146,13593
39916,1976,14086,39916,0,37708,2208,4.82446e+18,289.027,15798.7,39916,3756,133,30412,30412,28008,26620,8189
42136,4112,13109,0,42136,15390,26746,2.27026e+15,58.8169,15767.4,42136,6372,72,41860,41860,41860,41860,41860
23284,4228,7235,23284,0,21931,1353,5.43612e+18,163.042,8594.96,23284,2038,129,16049,16049,14230,15471,9941
32912,1084,1636,0,32912,31941,971,4.64526e+16,301.487,5129.26,32912,276,26,19727,19653,5946,15669,2347
11947,6,9,10965,982,11947,0,1.15399e+14,7.8464,271.06,11947,9,8,11284,9986,10962,10962,10577
27861,282,9759,10376,17485,0,27861,8.39245e+12,57.3965,11574.9,27861,4749,72,37389,36893,27792,27533,13553
17582,2902,4745,6287,11295,0,17582,9.41103e+12,59.2753,6130.21,17582,2306,72,12837,12837,10704,12471,8349
21772,1499,5134,20505,1267,20505,1267,3.34788e+18,97.5201,7074.2,21772,2475,110,16638,16638,9343,12595,5829
20764,2765,10674,8325,12439,0,20764,6.29183e+12,55.4658,11822.7,20764,5191,72,28415,0,0,29599,29599
49529,141,176,49438,91,49529,0,6.03362e+18,173.209,2719.48,49529,173,173,39519,34099,28049,32074,23156
9821,10,11,9534,287,9815,6,1.65228e+14,9.86498,288.8,9821,11,11,9804,9796,9785,9786,9729
45467,624,16970,0,45467,17100,28367,2.06568e+15,57.8415,19588.8,45467,8259,72,34072,33928,16151,28307,7054
49238,17496,24131,49238,0,49238,0,2.80713e+18,17.9859,24778.7,49238,21709,20,45523,45330,45330,45330,45330
23138,136,176,23129,9,23138,0,5.98084e+18,169.669,1804.72,23138,163,158,27380,9079,8637,10303,967
45271,11175,20722,43391,1880,43391,1880,5.34977e+18,94.7661,23292.7,45271,9986,111,35708,35708,35708,35708,35708
31128,115,176,31054,74,31128,0,5.97915e+18,169.772,2090.9,31128,163,168,21969,9907,6481,4713,0
47990,48,176,47909,81,47990,0,5.98344e+18,171.83,2595.23,47990,172,172,36017,21039,19757,27132,13456
35592,3280,9870,12782,22810,0,35592,9.30566e+12,59.3317,12279.6,35592,4798,72,33998,33998,33998,33998,33998
29942,4188,11376,0,29942,11302,18640,2.05118e+15,57.6897,13225.4,29942,5541,72,28105,28105,23030,18583,14542
17166,76,176,17122,44,17166,0,6.08071e+18,170.767,1619.93,17166,139,145,13889,9383,7088,7453,7584
32592,12208,14458,32592,0,31062,1530,4.9489e+18,325.571,15932.7,32592,3560,134,27427,27427,27427,27427,27427
5745,19,1523,0,5745,2035,3710,2.44719e+15,58.7558,2120.98,5745,737,72,2091,387,644,390,71
23929,202,5814,22539,1390,22539,1390,3.63935e+18,98.0379,7848.47,23929,2744,111,26911,25850,11408,9861,843
6660,251,446,0,6660,0,6660,3.75071e+18,15.9524,739.465,6660,281,18,6214,6214,4495,4838,4214
14530,5563,8544,14070,460,0,14530,1.21337e+18,88.7419,9455.46,14530,4121,108,5986,5986,4937,4660,4340
14209,2194,3352,4994,9215,0,14209,9.92095e+12,59.7851,4566.74,14209,1633,72,10857,10857,9148,10557,7216
12271,60,176,12227,44,12271,0,6.18106e+18,166.464,1366.57,12271,120,123,9503,6547,4176,4269,4261
31203,1594,10099,31203,0,29383,1820,3.79229e+18,206.403,11549.9,31203,3705,124,17373,17373,5361,9368,1965
48804,123,208,48712,92,48804,0,6.048e+18,204.654,2892.72,48804,190,191,38816,38651,24645,35883,7025
19233,3559,7220,7248,11985,0,19233,8.08041e+12,56.4898,8537.3,19233,3511,72,12013,12013,9881,11566,6437
15504,56,175,15438,66,15504,0,5.97572e+18,165.287,1474.79,15504,141,148,10382,5311,4291,5063,5038
4167,496,1133,3927,240,3927,240,1.45569e+18,94.6947,1684.2,4167,518,82,3034,3034,2208,2676,1765
30838,809,1084,0,30838,29951,887,3.78584e+16,221.374,3474.16,30838,166,26,44002,44002,44002,44002,44002
33630,6,14,32655,975,33549,81,1.56548e+14,10.4876,583.398,33630,13,12,32055,31078,23919,23435,16383
40074,2040,20729,38604,1470,0,40074,1.40699e+18,91.438,22909.9,40074,10058,110,37318,37318,23888,34977,7116
30354,722,7132,28584,1770,0,30354,2.22834e+18,97.7439,9638.91,30354,3456,110,23222,23222,14531,12890,3791
31835,6092,8503,0,31835,0,31835,6.20627e+17,97.2191,11020.7,31835,4120,110,23332,41000,37942,35572,35057
21965,1976,7005,18379,3586,20815,1150,2.50467e+18,96.821,8763.75,21965,3330,111,38606,38606,38606,38606,38606
19366,3453,4686,18236,1130,18236,1130,5.46568e+18,97.9357,6421.19,19366,2207,111,14680,14680,12358,12862,11391
6219,7,11,6042,177,6217,2,1.56194e+14,10.1405,228.506,6219,11,11,6014,5823,4586,4438,4628
49160,1004,1301,0,49160,47758,1402,3.55642e+16,264.37,4587.24,49160,208,26,46414,46414,41948,36932,20009
36102,4,14,35067,1035,36023,79,1.45899e+14,10.4886,589.252,36102,14,12,31517,28015,27380,23850,18339
49876,10618,16529,18396,31480,0,49876,8.62132e+12,58.5157,19504.7,49876,8047,72,36517,36517,35706,35232,34224
16300,223,687,0,16300,15835,465,3.55514e+16,20.1368,1893.43,16300,86,26,15613,15613,14008,14087,6747
29950,161,176,29860,90,29950,0,6.09511e+18,168.353,2143.02,29950,153,160,33013,32451,11879,13725,1170
49190,20250,20647,0,49190,18924,30266,1.91667e+15,56.4201,23266.8,49190,10052,72,48978,48978,48978,48978,48978
47826,26,176,47748,78,47826,0,5.97935e+18,171.996,2591.12,47826,171,172,48710,48475,48485,48433,48431
26065,8386,9351,9734,16331,0,26065,8.2758e+12,57.9801,11055.4,26065,4549,72,16714,16714,16441,16654,16187
34306,14254,15860,32899,1407,32899,1407,9.0777e+18,94.1077,17961.5,34306,7699,110,18446,33818,32996,32948,32182
47896,9,16,46507,1389,47805,91,1.57786e+14,9.97419,711.156,47896,14,12,12680,8677,8470,8827,7658
23075,1093,1569,0,23075,0,23075,3.73664e+18,15.9852,2128.18,23075,947,18,19630,19630,8868,16125,3891
3197,332,1132,3197,0,3008,189,3.17675e+18,89.2921,1483.99,3197,394,73,2065,2065,1224,1528,893
20231,3408,9122,0,20231,0,20231,4.67666e+17,90.9776,10553.7,20231,4409,110,17594,17594,17594,17594,0
24128,434,836,0,24128,23440,688,3.56227e+16,136.529,2557.57,24128,116,26,29168,28912,26514,25960,15223
15741,3069,6381,15021,720,15021,720,4.45902e+18,95.2287,7625.55,15741,3047,111,25047,23301,15065,9368,7430
41673,13316,13455,39531,2142,0,41673,1.9698e+18,95.7947,16377.8,41673,6515,110,31663,31663,31663,31663,31663
15314,1543,3648,0,15314,0,15314,6.46911e+17,97.2346,5134.96,15314,1751,110,13312,13312,0,0,0
18818,5779,9461,18098,720,18098,720,2.63688e+18,93.3371,10706.9,18818,4552,111,102,102,0,102,0
11393,307,598,0,11393,11069,324,3.80179e+16,19.9149,1573.06,11393,78,26,10795,10795,10131,10226,6046
6383,2532,3326,6143,240,6143,240,5.24182e+18,89.5153,3884.49,6383,1567,87,3057,3057,2884,3057,3010
29336,1410,10231,29336,0,27731,1605,5.5082e+18,210.31,11795.6,29336,3537,130,42692,42692,42692,42692,42692
1703,146,186,1703,0,1703,0,5.90576e+18,129.42,501.356,1703,73,64,1499,1420,1304,1307,1314
35057,390,1322,0,35057,34042,1015,4.01181e+16,271.291,4281.39,35057,213,26,30329,30157,24977,27267,22826
24480,9011,9034,23297,1183,23297,1183,3.08634e+18,96.0808,10837.4,24480,4316,111,29541,29541,24912,27634,16780
42677,8929,10010,40191,2486,0,42677,2.22646e+18,97.8734,13286.2,42677,4857,110,29403,29403,25474,28535,20822
30265,12021,16136,30265,0,29262,1003,5.06355e+18,1267.21,18179.8,30265,7265,140,14129,13382,12282,13027,10913
18450,315,5447,17453,997,0,18450,2.06086e+18,96.5017,7054.94,18450,2635,110,25895,25895,7261,20183,1269
31645,4224,7682,29823,1822,29823,1822,3.21508e+18,97.61,10253.3,31645,3709,110,21043,21043,18466,18931,16428
42756,11799,12456,40436,2320,40436,2320,3.55438e+18,97.5429,15481.7,42756,5937,111,42285,42285,42285,42285,42285
25992,11862,12195,24936,1056,24936,1056,2.53544e+18,93.9556,13874.9,25992,5915,110,13797,13797,13471,13701,13115
38506,1066,1101,0,38506,37406,1100,3.5531e+16,229.865,3727.35,38506,168,26,32456,32456,27075,26781,20535
28305,943,6569,9943,18362,0,28305,9.901e+12,60.0401,8673.56,28305,3194,72,35453,35453,35453,35453,35453
10417,2679,3471,9885,532,9885,532,7.07834e+18,95.2908,4482.58,10417,1657,110,6946,6946,6568,6504,5432
26118,3538,6150,9186,16932,0,26118,9.85776e+12,59.9302,8112.61,26118,2991,72,19968,19968,16877,19323,11788
20421,5211,6859,20421,0,19271,1150,4.18524e+18,149.635,8085.1,20421,2713,121,29620,29620,18512,17558,10369
42690,3580,21142,41040,1650,41040,1650,4.06959e+18,94.4176,23467,42690,10204,111,21548,21548,8932,12283,5203
24866,507,1261,0,24866,24135,731,4.49078e+16,263.722,3816.55,24866,201,26,31702,31702,31702,31702,31702
47016,1621,17234,0,47016,0,47016,5.36242e+17,95.2151,20281.2,47016,8374,110,30407,30407,16720,21066,11838
26651,8036,8874,9837,16814,0,26651,8.60361e+12,58.352,10667.2,26651,4313,72,17777,17777,16562,17567,15248
43639,1636,10244,41104,2535,41104,2535,5.89851e+18,97.8307,13581.5,43639,4961,110,43370,43370,43370,43370,43370
19792,2266,4791,18642,1150,18642,1150,2.71182e+18,97.9376,6557.85,19792,2262,111,15001,15001,11979,14158,8022
5454,219,1339,0,5454,0,5454,6.53074e+17,95.6327,2030.96,5454,627,89,4115,30186,27725,26956,27113
38441,6945,9273,36209,2232,36209,2232,6.08082e+18,98.2529,12208,38441,4376,111,29326,29326,27460,24594,24219
48649,7976,11378,0,48649,0,48649,6.47517e+17,97.8959,15021.5,48649,5519,110,47148,47148,47148,47148,47148
35278,111,176,35199,79,35278,0,5.98185e+18,169.758,2224.8,35278,166,170,45000,44773,31245,30495,10641
20365,1273,4781,0,20365,7157,13208,2.5195e+15,59.853,6394.58,20365,2314,72,15584,15584,8616,6679,4435
29507,48,176,29489,18,29507,0,6.02112e+18,172.597,2086.13,29507,167,163,20647,9196,7536,9037,8140
19411,456,958,0,19411,18846,565,4.16435e+16,195.788,2779.57,19411,138,26,18453,18137,17005,16306,10566
10271,2452,5043,0,10271,2253,8018,1.33708e+13,8.97439,5250.04,10271,4531,11,5228,5228,3186,5228,2957
41716,16,1166,0,41716,40527,1189,3.55918e+16,244.23,3999.89,41716,182,26,27499,21326,21536,21791,21501
906,213,362,906,0,848,58,3.39002e+18,80.6567,510.74,906,131,43,544,544,412,458,455
45210,5490,16517,16949,28261,0,45210,8.17749e+12,57.9643,19147.1,45210,8041,72,45098,45098,45098,45098,45098
5040,1600,1875,0,5040,1896,3144,2.10649e+15,55.794,2360.62,5040,908,67,3165,3165,2787,2624,2495
28615,813,12000,27345,1270,0,28615,1.69591e+18,94.816,13936.9,28615,5827,110,32084,32084,24491,21912,4325
28257,10471,13015,28257,0,27009,1248,4.94866e+18,330.372,14502.1,28257,4622,134,15242,15195,14383,15104,12456
26685,156,176,26622,63,26685,0,6.01889e+18,170.587,1979.85,26685,156,163,25400,24699,9435,17143,1864
38018,726,2646,7692,30326,0,38018,5.69268e+13,11.9949,3275.83,38018,1547,14,37997,36918,36626,36555,36670
16085,8,61,16053,32,16085,0,2.32244e+18,60.4878,935.862,16085,61,61,4508,768,10,2258,7
34541,7265,14811,0,34541,0,34541,4.83395e+17,94.6909,17025.8,34541,7184,110,33205,33205,33205,33205,33205
9649,3339,3526,0,9649,3613,6036,2.11043e+15,57.5366,4312.63,9649,1712,72,6123,6123,5857,5606,5704
37267,882,12025,37267,0,35107,2160,5.13547e+18,264.657,13673.2,37267,3605,133,31577,31577,24832,30252,16631
31716,2136,14300,30394,1322,30394,1322,9.05425e+18,92.4829,16309.7,31716,6935,110,38942,38942,38907,38939,34853
22116,110,176,22043,73,22116,0,5.98319e+18,169.181,1763.84,22116,153,159,9639,2737,3253,4709,464
46862,1755,1834,0,46862,45491,1371,4.24931e+16,300.386,6089.1,46862,316,26,45328,45328,45328,45328,45328
15022,3297,5032,15022,0,14152,870,6.33572e+18,123.663,5935.72,15022,1809,121,9990,9950,8726,9479,6932
6827,9,10,6632,195,6827,0,1.38243e+14,9.89512,227.85,6827,10,10,6739,6661,6580,6579,6258
39383,1709,11940,39383,0,37083,2300,3.63544e+18,279.142,13939.9,39383,4688,128,38940,38940,38940,38940,38940
17243,7349,8932,16603,640,16603,640,3.08394e+18,89.9176,10074.5,17243,4298,111,8311,8311,6752,7194,6367
37026,12079,14082,37026,0,35135,1891,4.52558e+18,332.485,15963.9,37026,3049,138,32647,32647,32647,32647,32647
42339,202,1172,0,42339,41131,1208,3.55072e+16,243.621,4031.75,42339,183,26,42124,42124,42123,42124,42072
32375,20251,21901,31575,800,0,32375,9.47958e+17,88.6572,23274.6,32375,10628,110,30774,30774,30774,30774,30774
27127,1844,9623,25787,1340,25787,1340,5.38404e+18,96.3429,11606.8,27127,4593,111,22821,22821,19596,21972,15524
46733,3918,16396,44430,2303,0,46733,1.88856e+18,95.7869,19490,46733,7949,110,44164,44164,44164,44164,44164
26353,451,6187,24822,1531,24822,1531,5.88501e+18,97.6201,8437.41,26353,2982,110,23604,21010,10894,10673,1218
4619,99,199,4614,5,4619,0,5.99761e+18,164.338,843.467,4619,100,99,3968,2455,2224,2331,2173
15619,202,3676,0,15619,5494,10125,2.53326e+15,59.8348,4987.17,15619,1785,72,11943,11943,6903,2810,852
45825,610,45825,45825,0,0,45825,134215000,0,45825,45825,45825,1,44847,44847,44847,44847,44847
31861,55,1437,0,31861,30926,935,4.36267e+16,287.661,4523.88,31861,234,26,29622,29460,23724,18730,5263
23270,7,14,22585,685,23217,53,1.74304e+14,10.5535,503.916,23270,13,11,2747,1090,680,891,103
22850,3311,6792,21630,1220,21630,1220,6.61721e+18,96.5502,8682.99,22850,3287,110,18450,18450,18187,18187,15556
26237,1796,6296,24707,1530,24707,1530,5.54683e+18,98.1316,8483.62,26237,2967,111,24305,24305,7740,20432,3691
29692,8593,10752,28246,1446,28246,1446,2.93846e+18,95.7043,12891.4,29692,5212,110,18940,18940,17574,18580,15626
17967,5278,6791,6770,11197,0,17967,8.03538e+12,57.5633,8039.1,17967,3289,72,35192,35192,34096,34962,0
39117,3777,17218,0,39117,15171,23946,1.84616e+15,55.9809,19334,39117,8367,72,27690,27690,20124,16425,6505
551,81,227,519,32,519,32,3.36018e+18,71.3702,331.508,551,79,37,276,98,136,201,147
14007,259,5572,13359,648,13359,648,8.2325e+18,94.7014,6738.99,14007,2692,110,8435,8091,3427,6486,1154
45703,13147,18925,45703,0,43513,2190,4.36146e+18,887.021,21092.6,45703,7246,141,36750,36750,36750,36750,36750
21611,4707,9725,8417,13194,0,21611,7.08031e+12,56.4501,11031.1,21611,4723,72,18871,18871,13724,12586,7889
16172,4687,7432,15502,670,0,16172,1.5851e+18,88.744,8631.14,16172,3585,110,8740,8740,7428,7136,6362
1019,149,300,356,663,0,1019,9.86274e+12,53.4524,463.988,1019,140,42,8641,8375,7427,11037,435
35374,14205,16143,35374,0,26897,8477,4.91736e+18,398.595,17714.7,35374,4559,139,22697,22697,22697,22697,22697
45577,2769,18512,0,45577,0,45577,5.02301e+17,95.1342,21338.9,45577,8988,110,45179,45179,45179,45179,45179
13729,7,13,13336,393,13662,67,1.41711e+14,10.9551,360.55,13729,12,12,13242,12983,10113,10182,9524
48013,7,16,46613,1400,47925,88,1.64566e+14,10.4996,727.573,48013,13,12,10926,6917,6370,7988,5448
33126,7888,11609,0,33126,0,33126,5.49965e+17,95.9077,13973.3,33126,5633,110,26171,26171,23234,25401,18180
10334,8,11,10035,299,10326,8,1.52886e+14,9.95278,290.844,10334,11,11,10105,9985,9573,9536,8360
18383,15,176,18335,48,18383,0,6.04984e+18,170.399,1667.9,18383,148,146,17711,17466,17479,17470,17518
4226,741,1066,3979,247,3979,247,3.24108e+18,94.6995,1638.38,4226,489,82,4636,4636,3756,4545,3411
34273,7501,9543,32392,1881,32392,1881,6.38514e+18,97.0711,12174.8,34273,4621,110,30591,30406,22348,21841,17519
38612,3494,14205,36742,1870,36742,1870,2.41883e+18,96.339,16762.8,38612,6807,111,30882,0,0,0,0
45257,15070,18890,43255,2002,0,45257,1.69677e+18,93.7586,21661.5,45257,9164,110,44879,44879,44879,44879,44879
12923,4591,6782,12453,470,12453,470,2.50465e+18,91.7635,7709.57,12923,3266,110,6141,6141,4374,4995,4233
37717,13858,18463,0,37717,14958,22759,1.68317e+15,55.706,20372.2,37717,8972,72,32150,32150,32150,32150,32041
43931,709,13992,43931,0,41371,2560,4.31526e+18,304.377,15847.3,43931,3393,134,42453,42447,36872,37903,30214
4181,1162,2072,4181,0,3184,997,3.63269e+18,89.684,2428.96,4181,840,76,2109,2109,1617,1866,1689
33434,1132,7829,31484,1950,0,33434,2.23088e+18,97.827,10536.4,33434,3795,110,23612,23612,12311,5480,3566
42661,2073,20423,40963,1698,40963,1698,9.48289e+18,93.9974,22845.2,42661,9925,110,40886,40886,40886,40886,40886
32750,2624,15569,31440,1310,31440,1310,2.54784e+18,93.9504,17558.7,32750,7563,110,23720,23586,18385,14652,3207
537,89,187,0,537,187,350,2.69789e+15,48.8007,282.93,537,86,34,350,316,222,178,181
37642,4621,8833,13241,24401,0,37642,9.85924e+12,60.0162,11472.6,37642,4297,72,25075,25075,13694,8392,5754
25240,109,176,25228,12,25240,0,5.98414e+18,169.641,1884.11,25240,159,162,19324,8691,7691,12829,1664
25100,6397,9603,0,25100,0,25100,5.23301e+17,93.858,11445.3,25100,4637,110,31220,31220,31220,31220,31220
47854,6386,19493,47854,0,45574,2280,4.52967e+18,1330.14,21945.3,47854,4914,143,41400,41400,41400,41390,41384
38894,11748,12115,36839,2055,36839,2055,2.64905e+18,97.211,14858,38894,5783,111,38374,38374,38374,38374,38374
2486,134,186,2426,60,2486,0,6.00484e+18,143.375,603.928,2486,79,74,2236,2120,1777,1783,1785
28871,6760,6897,27201,1670,0,28871,2.21609e+18,97.6262,9301.41,28871,3336,110,35258,35258,29740,28741,23117
37723,898,8884,35533,2190,35533,2190,5.90304e+18,97.8034,11859.5,37723,4298,110,28839,28839,25703,23284,4440
9989,127,175,9982,7,9989,0,5.99164e+18,162.049,1185.74,9989,129,128,9403,8677,7260,7299,7219
23907,10,11,23223,684,23898,9,1.38801e+14,10.1668,432.954,23907,11,11,33757,33757,25011,25009,30294
15276,2912,3600,0,15276,5367,9909,2.53321e+15,59.8184,4887.43,15276,1750,72,11676,11676,10683,9828,9638
18824,5229,8289,18824,0,17936,888,3.7107e+18,154.313,9359,18824,3579,124,47749,47749,47749,47749,47749
43521,13304,16123,0,43521,16354,27167,2.07809e+15,57.8889,18658.4,43521,7849,72,27398,27398,24047,21026,18531
25681,4509,8366,25461,220,24189,1492,3.1956e+18,167.393,9638.66,25681,3053,125,17315,17315,13181,14503,9727
5656,6,11,5496,160,5652,4,1.382e+14,10.729,209.258,5656,11,11,5382,5250,4658,4575,3891
38340,7579,11106,36268,2072,0,38340,2.06822e+18,96.9473,13946.3,38340,5387,110,28526,28439,25874,22416,21546
29329,6863,11446,27959,1370,27959,1370,1.71278e+18,93.3292,13463.1,29329,5475,111,17883,17883,17883,17883,10694
4762,1377,1625,0,4762,0,4762,5.76544e+17,94.0542,2194.2,4762,773,82,3137,3137,2826,2955,2696
43416,10,14,42179,1237,43338,78,1.38974e+14,10.4062,626.118,43416,13,12,30654,29298,29171,29673,28783
28088,4435,9391,0,28088,0,28088,5.64065e+17,95.0463,11515,28088,4545,110,46723,46723,46723,46723,46723
38276,1093,9017,0,38276,0,38276,6.46573e+17,97.7856,12025.2,38276,4368,110,29259,29259,11556,6116,5054
20341,423,4746,7155,13186,0,20341,9.91539e+12,59.9571,6358.02,20341,2312,72,15595,15595,9292,14506,1673
36920,55,1074,0,36920,35869,1051,3.55409e+16,223.642,3601.39,36920,163,26,22455,5506,9687,7399,813
21994,1815,5212,7736,14258,0,21994,9.81436e+12,59.8279,6922.07,21994,2524,72,16782,16782,10880,15271,5979
21150,5,11,20547,603,21142,8,1.40498e+14,10.1659,408.657,21150,11,11,19400,17225,13954,14474,12414
24368,1,11,23674,694,24361,7,1.38716e+14,10.1863,436.543,24368,11,11,219,219,219,219,219
28182,6773,12703,27001,1181,27001,1181,8.90524e+18,94.2609,14538.6,28182,6159,110,21931,21931,21931,21931,21931
24213,1,14,23496,717,24164,49,1.82709e+14,10.3114,505.415,24213,13,11,166,166,166,166,166
39689,65,176,39594,95,39689,0,6.10975e+18,173.581,2467.78,39689,163,168,28430,19335,26021,16695,16736
12933,210,405,0,12933,12529,404,0.0312379,0.968685,2287.61,12933,405,1,12528,12528,12528,12528,12528
7574,1210,3793,7283,291,7283,291,9.63523e+18,92.0858,4445.99,7574,1823,88,3781,3699,18259,19703,18229
22458,2,12,21818,640,22450,8,1.38757e+14,10.245,422.146,22458,12,11,1917,405,426,407,381
36296,11174,11680,36296,0,34177,2119,4.57996e+18,255.118,13298,36296,4321,125,23972,23972,21230,19903,17034
27049,12188,12365,0,27049,10569,16480,1.80035e+15,56.4491,13902.3,27049,6023,72,14684,14684,14476,14441,14287
40578,8609,11426,0,40578,14604,25974,2.37168e+15,59.284,14091,40578,5562,72,22622,22622,18141,21748,12534
41015,859,9522,0,41015,14413,26602,2.5337e+15,60.0954,12365,41015,4636,72,40106,40106,40106,40106,40106
28480,551,6880,26822,1658,26822,1658,3.66992e+18,98.1639,9206.69,28480,3252,111,28165,28165,28165,28165,28165
24699,1439,7241,23367,1332,0,24699,2.06169e+18,96.7012,9252.31,24699,3508,110,23873,23873,0,0,0
8056,1890,2137,7596,460,0,8056,2.1719e+18,96.1204,3034.66,8056,1022,103,5919,5919,5603,5568,5467
48339,3104,11305,45529,2810,0,48339,2.22763e+18,97.9059,14932.5,48339,5476,110,47142,47142,47142,47142,46950
4240,632,1093,3990,250,3990,250,2.16663e+18,95.2776,1659.4,4240,493,83,3147,3147,2936,2994,0
17326,484,762,0,17326,16829,497,3.72515e+16,83.8118,2140.5,17326,101,26,20466,20466,12886,4687,2750
10016,2805,2931,0,10016,3620,6396,2.34425e+15,58.2846,3813.65,10016,1417,72,7085,7085,6932,6847,6869
32558,3030,10004,32558,0,30668,1890,4.52472e+18,225.745,11735.7,32558,3883,124,29416,29416,20135,23604,10795
43739,4,15,42465,1274,43647,92,1.63245e+14,10.4799,698.92,43739,14,12,3735,1519,557,568,248
11923,2755,2884,0,11923,0,11923,6.44189e+17,96.8986,4112.38,11923,1380,110,9039,9039,8913,8896,8890
34156,9399,12194,32486,1670,32486,1670,2.87133e+18,95.8311,14596.1,34156,5919,110,21962,21962,19997,21451,17062
15977,950,8407,15397,580,15397,580,2.40925e+18,91.2259,9488.35,15977,4054,110,39266,0,0,0,0
9385,790,3874,8955,430,8955,430,7.82102e+18,94.6294,4719.72,9385,1846,104,23950,23534,9219,14487,2828
37252,11456,13854,35472,1780,0,37252,1.82904e+18,95.6458,16379.6,37252,6725,110,23398,23398,21919,21410,19713
19462,8,11,18901,561,19451,11,1.49719e+14,10.231,398.691,19462,11,11,5910,1112,1054,1013,1047
22838,2666,5369,21508,1330,0,22838,2.23142e+18,97.5697,7382.94,22838,2588,110,17469,17469,14394,13235,9377
31568,6399,7405,29728,1840,0,31568,2.22922e+18,97.7933,9993.31,31568,3587,110,27703,27703,19415,15425,10222
26160,2152,12241,25098,1062,0,26160,1.5559e+18,93.9475,13935.7,26160,5940,110,13919,13919,9257,8298,4380
39051,5488,9386,13782,25269,0,39051,9.78617e+12,59.9396,12092,39051,4562,72,43937,43937,43937,43937,43937
37730,7193,16528,37730,0,35960,1770,4.81095e+18,453.531,18231.4,37730,6702,136,37207,37207,37207,37207,37207
9746,164,175,9744,2,9746,0,5.98973e+18,162.48,1171.68,9746,124,131,9532,9414,9106,9128,9125
10137,3131,3830,9654,483,9654,483,2.82972e+18,94.5134,4773.8,10137,1831,108,6307,6307,5632,6127,4896
8421,1322,3888,0,8421,3288,5133,1.78581e+15,52.596,4517.21,8421,1883,72,4533,4533,3625,3034,2666
25132,3035,23488,0,25132,0,25132,6.04036e+17,3.99029,23565.2,25132,7844,9,1644,1644,208,208,215
41537,13915,16475,39629,1908,0,41537,1.75728e+18,93.6344,19137.9,41537,8002,110,28900,28900,28900,28900,28900
7794,7,12,7562,232,7786,8,1.83714e+14,10.5405,264.77,7794,12,11,7583,7438,6275,6135,5840
24934,6,15,24183,751,24871,63,1.99722e+14,10.4444,542.854,24934,13,11,7897,4879,4788,4722,4738
46798,8217,11219,44075,2723,44075,2723,3.52713e+18,98.3676,14651.2,46798,5304,111,26034,26034,23754,23374,14274
38222,35,176,38133,89,38222,0,6.06048e+18,173.094,2408.44,38222,169,170,17033,2518,9499,7260,76
30446,1833,11977,0,30446,11553,18893,2.00417e+15,57.4721,13822.5,30446,5830,72,37324,37324,19449,28699,7488
13112,300,557,0,13112,12737,375,3.56331e+16,20.0745,1551,13112,75,26,12555,12555,11899,11951,7858
1226,7,11,1193,33,1226,0,1.38671e+14,10.1697,97.2402,1226,11,11,1176,1156,1064,1071,956
26508,548,1136,0,26508,25737,771,4.09843e+16,238.008,3499.07,26508,175,26,25372,24843,23403,22608,14811
36337,635,18305,34967,1370,0,36337,1.44657e+18,93.2031,20371.2,36337,8876,110,38172,37257,35580,34326,22228
28651,2871,12302,28651,0,27254,1397,4.75834e+18,233.527,13622.5,28651,5148,129,30450,30450,14910,13108,6323
6276,571,2517,0,6276,2384,3892,2.00913e+15,56.6748,3065.06,6276,1219,72,3759,3676,2703,1920,1660
46569,10668,15211,44188,2381,44188,2381,3.05097e+18,96.2776,18387.4,46569,7370,110,44323,44323,44323,44323,44323
35810,422,1052,0,35810,34788,1022,3.55378e+16,217.52,3508.85,35810,159,26,36765,36305,29257,29940,19132
15668,33,176,15622,46,15668,0,6.10678e+18,162.861,1549.37,15668,138,135,8623,2634,2909,3255,2844
5313,52,1382,5013,300,5013,300,6.02381e+18,95.0262,2052.5,5313,640,87,2376,543,1455,1986,251
25850,43,1053,0,25850,25103,747,3.95941e+16,210.629,3240.65,25850,159,26,14850,3356,7613,612,501
22694,3132,5385,21374,1320,0,22694,2.22503e+18,97.5521,7385.04,22694,2604,110,17309,17309,14818,13829,10849
43977,129,176,43903,74,43977,0,5.98051e+18,172.027,2485.3,43977,171,173,25208,12572,13634,18162,7137
6979,202,458,0,6979,6776,203,4.12377e+16,19.6808,1160.65,6979,65,26,6521,6521,5866,6058,4403
43082,6304,19287,43082,0,41304,1778,5.0139e+18,2120.18,22024.9,43082,7128,143,42804,42804,42804,42804,42804
11219,1004,2678,3949,7270,0,11219,9.84065e+12,59.6644,3694.07,11219,1294,72,8541,8541,5696,7811,3221
42446,701,1908,0,42446,41196,1250,4.52775e+16,322.755,6191.58,42446,330,26,34232,34232,22148,27315,11807
4413,342,1065,0,4413,1553,2860,2.54532e+15,58.8819,1568.44,4413,512,70,3348,3348,1976,1510,1170
9032,2586,3242,0,9032,3360,5672,2.11833e+15,53.2403,3999.89,9032,1557,72,5790,5790,5790,5790,5790
14384,302,7554,0,14384,5793,8591,1.58196e+15,55.1567,8407.7,14384,3675,72,6830,6542,4171,1479,1126
14919,335,3657,0,14919,0,14919,6.41652e+17,97.1012,5102.17,14919,1757,110,13464,13464,11316,10507,10399
10824,171,469,0,10824,10514,310,3.56627e+16,20.0204,1307.81,10824,67,26,8868,8782,5880,4647,4928
30429,12,176,30372,57,30429,0,6.09401e+18,170.203,2160.62,30429,155,162,15613,12723,12329,13159,12527
2923,538,767,2750,173,2750,173,3.23082e+18,93.3031,1199.79,2923,346,70,2156,2156,1940,2087,1772
21114,295,785,0,21114,20511,603,3.56534e+16,105.45,2317.33,21114,105,26,33322,32542,12982,21115,1519
12182,52,176,12175,7,12182,0,5.99733e+18,167.508,1330.01,12182,134,135,7943,4088,3181,3659,3518
19076,5043,5916,6964,12112,0,19076,8.90389e+12,58.681,7329.38,19076,2871,72,13160,13160,12423,13030,11692
19297,8324,9035,18507,790,18507,790,6.84531e+18,90.9137,10368.8,19297,4322,111,10262,10262,10262,10262,10086
47815,1456,11187,45035,2780,0,47815,2.22609e+18,97.8858,14783.1,47815,5420,110,28605,28605,13974,5676,3906
27932,1,12,27125,807,27918,14,1.52991e+14,10.1778,484.658,27932,11,12,82,82,82,82,82
29858,295,9347,28295,1563,28295,1563,7.04091e+18,96.4534,11623,29858,4530,110,19072,17800,10637,8746,1629
47494,124,176,47423,71,47494,0,6.05936e+18,173.781,2687.53,47494,173,172,46313,46073,43595,41571,37039
41066,6765,14887,41066,0,38896,2170,4.20351e+18,328.534,16914.9,41066,6291,133,26179,25924,19529,22141,13774
17201,468,706,0,17201,16712,489,3.55617e+16,33.5207,1971.8,17201,90,26,15171,15171,12542,13834,10244
37770,9083,11752,35790,1980,35790,1980,3.06312e+18,96.311,14492.9,37770,5699,110,41261,41261,41261,41261,41261
26276,4486,6302,24745,1531,24745,1531,5.78965e+18,98.1295,8492.98,26276,2980,111,19974,19974,16541,17280,14934
29084,10064,10581,27664,1420,27664,1420,2.84594e+18,95.7897,12650.6,29084,5043,111,25638,25638,25638,25638,25638
21380,3,15,20743,637,21323,57,1.84394e+14,10.484,496.295,21380,12,11,16735,13095,9419,10861,6623
2025,838,1039,2025,0,2025,0,4.3156e+18,18.6904,1157.16,2025,927,21,986,986,796,782,831
5857,933,1399,0,5857,2059,3798,2.52423e+15,59.2158,2024.3,5857,667,72,4458,4458,3920,3879,3171
21397,5325,6569,7791,13606,0,21397,8.9697e+12,58.7814,8119.04,21397,3194,72,24437,24437,16636,9742,7775
27081,27,176,27057,24,27081,0,6.09257e+18,172.451,2037.44,27081,161,158,13274,3804,4209,4208,3950
32218,6806,10107,30518,1700,30518,1700,4.14527e+18,97.1054,12471.7,32218,4822,111,23877,23877,22070,22477,21729
36962,9,15,35887,1075,36879,83,1.60918e+14,10.3508,589.808,36962,12,13,21265,19821,19750,19746,19518
15264,2110,3579,14371,893,14371,893,5.71004e+18,97.3025,5062.74,15264,1715,110,0,0,0,0,0
4510,90,208,4510,0,4510,0,5.73569e+18,24.3761,467.651,4510,167,27,4023,0,0,0,532
40044,3924,20903,8706,31338,0,40044,52742800000,8.99413,21305.8,40044,18806,11,27922,27791,16819,20952,10207
33637,1097,9152,31774,1863,0,33637,2.12006e+18,97.1782,11764.8,33637,4438,110,24485,24485,12193,9502,4829
33190,1632,7789,31260,1930,0,33190,2.22625e+18,97.7616,10483,33190,3764,110,26900,26900,13973,11255,5642
7288,1201,2510,0,7288,0,7288,5.65103e+17,94.6531,3281.32,7288,1198,94,4778,4778,3730,2347,2926
25824,8224,11554,10041,15783,0,25824,7.13624e+12,56.5761,13059.5,25824,5623,72,18206,18206,15458,16786,11290
7777,1322,3212,0,7777,2975,4802,1.95683e+15,55.2891,3848.43,7777,1557,72,4565,4565,3479,2448,2259
21566,273,9264,21566,0,20506,1060,4.47032e+18,169.554,10336.9,21566,3795,124,29618,29618,29618,29618,29618
42064,6751,9813,39614,2450,39614,2450,3.22649e+18,97.8697,13060.2,42064,4758,110,29037,28837,26811,28375,24849
2157,5,11,2095,62,2157,0,1.37801e+14,10.6806,129.407,2157,11,11,1987,1786,1451,1488,1212
24483,4363,5733,0,24483,0,24483,6.50136e+17,97.6487,7858.86,24483,2774,110,23866,23866,11566,14643,6197
14345,2813,3511,13506,839,13506,839,1.19797e+18,97.6851,4892.82,14345,1649,111,10834,10834,10834,10834,9392
37545,2060,8782,35358,2187,0,37545,2.22909e+18,97.8171,11748.2,37545,4257,110,31466,31466,25673,28047,23227
26811,5,15,26037,774,26729,82,1.53278e+14,10.5948,525.691,26811,13,12,26788,26769,26742,26736,26708
9528,11,400,0,9528,9256,272,3.53784e+16,20.0267,1139.22,9528,61,26,6078,1883,838,136,78
6686,969,2216,2450,4236,0,6686,8.63783e+12,57.3485,2841.9,6686,1057,72,4470,4470,3827,4360,3262
22093,4419,7558,8190,13903,0,22093,8.53323e+12,58.2296,9081.92,22093,3681,72,402,402,0,331,0
11761,1777,4992,4532,7229,0,11761,7.5093e+12,56.7513,5841.31,11761,2426,72,6769,6769,4789,6114,2767
13407,235,574,0,13407,13025,382,3.56177e+16,20.0354,1585.57,13407,77,26,12833,12833,11804,11836,6536
26911,680,9796,10080,16831,0,26911,8.2049e+12,56.4944,11536.3,26911,4763,72,27372,27372,12900,20607,3707
12304,22,199,12302,2,12304,0,5.98045e+18,178.281,1365.73,12304,137,139,5082,24475,24897,25149,24879
2198,427,954,0,2198,846,1352,1.97786e+15,52.8858,1201.83,2198,459,52,1244,20655,26514,22950,3209
33115,544,1492,0,33115,32146,969,4.38874e+16,287.824,4722.55,33115,247,26,31623,30665,28633,26312,14144
4332,702,1617,1621,2711,0,4332,8.2336e+12,56.8091,2051,4332,781,67,2715,2667,2456,2639,2366
1439,83,416,1351,88,1351,88,5.52636e+18,88.6942,666.95,1439,180,50,870,297,726,641,342
39350,417,1451,0,39350,38206,1144,4.03321e+16,281.948,4772.14,39350,239,26,27094,26237,20219,18819,12457
27922,281,951,0,27922,27123,799,3.64185e+16,177.028,2998.89,27922,138,26,26982,26726,23704,24058,18866
11990,2006,3180,0,11990,0,11990,6.23586e+17,96.5037,4386.26,11990,1517,110,29249,28708,14057,9143,5088
30642,7842,9441,30642,0,28854,1788,3.74302e+18,200.816,11091.4,30642,3667,124,21201,21177,19613,20255,18308
48202,9,15,46829,1373,48117,85,1.38933e+14,10.6291,696.123,48202,14,12,16110,12093,11329,11518,11304
13914,3019,3335,13104,810,0,13914,2.22612e+18,97.0898,4713.49,13914,1598,110,10579,10579,10190,10159,9965
28785,12204,12497,27535,1250,27535,1250,2.91281e+18,94.6442,14377.6,28785,5985,111,28660,28660,28660,28660,28660
11501,97,176,11495,6,11501,0,6.06755e+18,166.737,1322.08,11501,131,127,10164,7055,6010,6253,6441
13525,4300,5787,5214,8311,0,13525,7.40932e+12,56.7498,6729.03,13525,2814,72,7738,7738,6975,7608,6281
46767,253,13474,44237,2530,44237,2530,6.68385e+18,97.031,16803.4,46767,6540,110,33087,29394,11379,19235,1168
46071,2,7,44631,1440,45879,192,0.000130234,0.999848,550.507,46071,7,1,46064,46064,46064,46064,46064
31884,6009,16420,30694,1190,30694,1190,5.19614e+18,94.0273,18224.1,31884,7918,111,46818,46818,46818,46818,46818
5959,143,208,5959,0,5959,0,5.98275e+18,169.393,984.696,5959,107,107,5566,5204,4206,4217,4139
40968,6637,20214,39388,1580,0,40968,1.47709e+18,93.2449,22516.2,40968,9822,110,20754,20754,15576,13748,9285
38360,2060,8966,36123,2237,0,38360,2.22913e+18,97.8319,11981.4,38360,4348,110,47920,47920,47920,47920,47920
46418,11,16,45046,1372,46322,96,1.81869e+14,10.3215,757.067,46418,14,13,19315,15306,14740,16625,14392
1293,283,369,455,838,0,1293,9.20153e+12,54.7061,568.553,1293,164,47,924,924,854,905,822
32951,93,176,32936,15,32951,0,5.99709e+18,171.714,2183.06,32951,169,166,2046,1763,1938,2042,1976
48576,8,15,47176,1400,48490,86,1.50049e+14,10.4598,715.21,48576,14,12,47766,47324,46365,46290,44694
27028,39,176,27014,14,27028,0,5.98254e+18,169.559,1948.96,27028,160,164,19893,13277,16357,14501,11378
42128,3168,10063,39668,2460,39668,2460,2.2522e+18,98.3548,13220.9,42128,4763,111,41830,41830,41830,41830,41830
11289,153,513,0,11289,10968,321,3.62235e+16,19.9602,1405.23,11289,70,26,26660,26660,26889,0,0
10901,308,3403,3972,6929,0,10901,8.88143e+12,55.8278,4323.15,10901,1635,72,23936,23506,10042,2016,2499
969,39,61,0,969,943,26,3.49506e+16,18.2343,171.74,969,25,23,908,908,801,809,749
44783,10045,18183,0,44783,17110,27673,1.96127e+15,56.6648,20658,44783,8841,72,32647,32647,32491,32635,32527
1362,10,90,0,1362,1325,37,3.74573e+16,18.5323,243.851,1362,27,24,1173,1073,745,774,290
43511,1701,23649,0,43511,0,43511,3.48005e+15,17.9611,24219,43511,21269,20,29604,29453,23176,28235,15753
48927,697,2067,0,48927,47491,1436,4.44154e+16,305.964,6820.44,48927,361,26,48700,48700,48700,48700,48700
16456,3819,5310,0,16456,6036,10420,2.24588e+15,58.4759,6552.12,16456,2586,72,11146,11146,9756,9576,7584
11643,2034,3717,11643,0,10965,678,4.52458e+18,94.3009,4566.13,11643,903,121,7926,7926,7181,7718,4740
13172,115,176,13125,47,13172,0,6.16159e+18,167.248,1415.02,13172,120,129,21931,20921,8955,529,687
7192,1495,1738,0,7192,0,7192,6.50048e+17,96.2387,2587.19,7192,819,99,5454,5454,5168,5227,5044
46643,11925,14869,46643,0,43930,2713,4.9361e+18,324.375,16808.4,46643,4785,136,40003,40003,40003,40003,40003
37152,436,8658,13051,24101,0,37152,9.89004e+12,60.0476,11274.4,37152,4214,72,24784,24010,10429,6332,2132
42808,10440,17616,40889,1919,40889,1919,8.33349e+18,95.0609,20287.8,42808,8562,110,42347,42347,42347,42347,42347
29367,97,176,29289,78,29367,0,5.9845e+18,169.524,2030.66,29367,166,162,25991,16183,14953,15966,16344
29622,712,9867,28105,1517,28105,1517,2.3544e+18,96.6669,12040.6,29622,4716,111,23634,23398,21906,0,0
32761,7466,15173,32761,0,31338,1423,4.91021e+18,480.184,16877.8,32761,6636,134,40189,40189,40189,40189,40189
1859,184,1144,1859,0,1789,70,5.22378e+18,85.3045,1321.48,1859,465,53,715,617,477,593,411
11355,3867,4433,0,11355,0,11355,5.22806e+17,94.5111,5439.93,11355,2140,110,6922,6922,6493,6276,6378
7569,1299,3430,0,7569,0,7569,4.70606e+17,91.441,4128.56,7569,1643,98,4139,4139,2998,2508,1427
22944,6334,7255,0,22944,0,22944,5.80548e+17,96.3138,9110.05,22944,3514,110,15689,15689,14523,13697,13464
31028,108,176,31009,19,31028,0,6.03894e+18,172.679,2162.68,31028,163,168,23365,11639,19558,19998,4466
31591,919,1247,0,31591,30676,915,4.03889e+16,268.947,3965.06,31591,198,26,30344,30084,29442,22349,24063
47849,6115,11157,16823,31026,0,47849,9.87693e+12,60.061,14380.1,47849,5421,72,39963,39963,37997,36700,36384
25853,7539,10918,0,25853,0,25853,4.90827e+17,94.7272,12707.9,25853,5299,110,25530,25530,25530,25530,25530
38430,18310,18567,38430,0,37190,1240,5.09541e+18,3083.38,21976.4,38430,7267,145,22366,22366,22366,22366,22366
26090,5930,6309,24570,1520,24570,1520,3.16207e+18,98.1553,8484.66,26090,2987,111,27424,27424,27424,27424,27424
23893,3816,16906,23353,540,23353,540,3.57698e+18,83.4531,17914,23893,8168,111,29180,29180,29180,29180,29180
17077,161,208,17063,14,17077,0,6.07321e+18,194.504,1726.84,17077,146,149,16504,15784,13263,13505,12992
26036,10235,12664,26036,0,24906,1130,5.97595e+18,224.424,13882,26036,3401,136,25598,25598,25598,25598,25598
41744,8715,9745,39313,2431,39313,2431,5.75681e+18,97.8602,12971.5,41744,4715,110,31963,31963,30940,31754,29009
2213,103,676,2090,123,2090,123,2.17916e+18,91.3507,1015.07,2213,293,60,1515,610,553,920,327
29119,439,14647,28009,1110,28009,1110,2.93677e+18,90.2969,16367,29119,7059,111,14472,13776,8359,7230,1468
34207,126,176,34130,77,34207,0,5.99459e+18,170.542,2217.03,34207,165,170,44902,44888,44875,44874,44872
42024,3121,17592,40164,1860,40164,1860,8.43792e+18,94.9437,20202.4,42024,8549,110,41970,41970,41970,41970,41970
47899,4909,15891,17670,30229,0,47899,8.61661e+12,58.5075,18768.9,47899,7735,72,33891,33722,23426,27165,15844
37393,15,208,37314,79,37393,0,6.00549e+18,203.167,2448.04,37393,181,176,34048,31599,26092,24510,8102
16713,3562,3967,0,16713,0,16713,6.50449e+17,97.3843,5549.53,16713,1912,110,25551,25173,17654,21010,9209
16645,2236,9410,0,16645,0,16645,3.72262e+17,90.293,10453.3,16645,4560,110,7235,7235,4646,3277,3064
32249,4932,7481,0,32249,11324,20925,2.53703e+15,60.0372,9814.1,32249,3639,72,31550,31550,31550,31550,31550
4131,98,1063,3891,240,3891,240,5.09578e+18,95.238,1622.6,4131,489,82,4095,4095,4095,4095,4095
22846,207,5331,8028,14818,0,22846,9.91243e+12,59.9268,7096.91,22846,2592,72,18663,18468,13840,9480,1704
10676,5768,5848,4341,6335,0,10676,5.88646e+12,51.1368,6510.9,10676,2842,72,4828,4828,4740,4808,4709
42788,9946,10244,0,42788,0,42788,6.44283e+17,97.7967,13509.9,42788,4971,110,40389,40389,40389,40389,40389
24565,1368,8022,0,24565,9034,15531,2.22439e+15,58.4815,9711.63,24565,3903,72,20338,20338,18497,18874,17721
32342,64,206,32263,79,32342,0,5.98234e+18,186.024,2214.83,32342,174,176,25441,7389,14231,19689,1555
28508,60,176,28490,18,28508,0,6.01634e+18,172.638,2057.43,28508,160,165,26728,26412,22537,19663,9019
17994,3741,5579,0,17994,6557,11437,2.28551e+15,58.6732,6928.13,17994,2715,72,14806,14806,13927,13242,12565
33269,15,176,33188,81,33269,0,6.03645e+18,172.751,2233.03,33269,169,166,11337,2482,2871,8265,90
21524,2438,8685,21524,0,20442,1082,5.21487e+18,158.034,9890.21,21524,3668,125,22895,22895,13280,10893,5720
21883,2312,5843,20646,1237,20646,1237,5.41675e+18,97.628,7694.95,21883,2767,111,16040,16040,12712,14348,6921
19010,7197,9874,0,19010,7648,11362,1.59725e+15,55.0092,10939.9,19010,4804,72,33091,33091,29753,33091,22343
39200,173,1269,0,39200,38075,1125,3.77861e+16,261.974,4237.2,39200,203,26,44249,43504,29447,28578,7762
31503,3,5,30518,985,31375,128,0.000126972,0.999841,385.715,31503,5,1,31498,31498,31498,31498,31498
21024,12817,21024,21024,0,21024,0,8.79567e+12,0,21024,21024,21024,1,0,0,0,0,0
16280,7428,8114,15652,628,15652,628,2.53508e+18,63.7297,9253.77,16280,3915,110,8166,8166,6820,7444,6459
37069,3987,8644,0,37069,13028,24041,2.52974e+15,60.0368,11254.2,37069,4200,72,31734,31734,30609,29908,29759
10144,10,13,9854,290,10107,37,1.49006e+14,10.8985,315.933,10144,12,11,10059,9916,9748,9580,8698
11481,440,886,0,11481,11136,345,4.94631e+16,164.46,2309.7,11481,126,26,8227,7938,3780,5089,40
17358,2102,5760,16469,889,16469,889,2.95188e+18,95.9376,7236.16,17358,2787,110,14322,14322,13578,12869,12147
39821,5,15,38671,1150,39766,55,1.51612e+14,10.5893,652.921,39821,13,11,28326,26625,26386,26392,26127
24963,1086,10741,23881,1082,23881,1082,2.65916e+18,93.6188,12465.2,24963,5197,110,24570,24570,24570,24570,24570
17428,600,4196,6143,11285,0,17428,9.78657e+12,59.7426,5614.37,17428,2038,72,16413,16246,5491,8617,2563
4418,552,1585,1641,2777,0,4418,8.36221e+12,56.9495,2030.06,4418,766,66,2833,2785,1437,2448,917
36888,6206,14410,36888,0,34968,1920,4.64914e+18,258.496,15992.5,36888,5838,132,33011,33011,27558,32061,20884
30814,263,7247,29024,1790,29024,1790,5.90759e+18,97.7144,9787.42,30814,3507,110,29559,29268,25602,25383,11257
45683,13790,23292,0,45683,18294,27389,1.61807e+15,55.6955,25447.6,45683,11345,72,45470,45470,45470,45470,45470
34943,3871,9708,33023,1920,0,34943,2.10211e+18,97.1391,12386.1,34943,4711,110,39626,39626,39626,39626,39626
35219,7152,11866,33425,1794,33425,1794,3.17823e+18,96.7783,14334,35219,5669,111,27404,27028,18318,17834,12010
13993,139,170,13987,6,13993,0,5.98175e+18,164.358,1393.67,13993,136,146,13462,12586,11298,11418,11406
46696,3333,19524,46696,0,31364,15332,4.52782e+18,1330.92,21937.2,46696,7359,144,34197,34197,22668,22509,12809
31275,8391,11583,31275,0,29635,1640,4.34096e+18,243.918,13215.9,31275,3358,132,19692,19679,17725,19287,15553
1891,1010,1551,1861,30,0,1891,6.46308e+17,69.587,1661.23,1891,714,49,340,254,310,248,334
14374,2983,8982,6046,8328,0,14374,4.84508e+12,53.5171,9700.81,14374,4361,72,12617,12617,8401,11143,4023
25100,555,852,0,25100,24385,715,3.54977e+16,144.43,2627.65,25100,118,26,34597,34597,34597,34597,34597
12509,25,919,2522,9987,0,12509,5.67058e+13,11.9845,1274.52,12509,512,14,11590,11590,6342,3680,9212
15692,638,826,0,15692,15233,459,4.08917e+16,136.941,2280.12,15692,114,26,14866,14708,14478,14412,12348
48257,99,296,47996,261,48165,92,5.64721e+18,241.487,1682.91,48257,273,42,39514,30581,31389,34447,26895
38401,6876,8995,36169,2232,36169,2232,5.87708e+18,97.7983,12014.4,38401,4350,110,38164,38164,38164,38164,38164
33092,6364,11332,31422,1670,31422,1670,3.7005e+18,96.6798,13671.6,33092,5418,111,22824,19885,14742,15274,9581
19785,2314,8217,0,19785,7588,12197,1.93397e+15,53.4426,9498.91,19785,3981,72,11568,11568,6687,4158,3356
35603,8608,9905,0,35603,0,35603,6.11217e+17,97.0894,12619,35603,4803,110,17228,17228,10670,16826,9811
11409,1377,6441,0,11409,4672,6737,1.44824e+15,50.6337,7119.09,11409,3115,72,4968,4968,3152,27855,25627
12014,174,785,0,12014,11664,350,4.3652e+16,86.9933,2036.6,12014,104,26,11229,11105,8511,8932,6345
44073,3438,19995,42241,1832,0,44073,1.59227e+18,94.3764,22572.1,44073,9719,110,32171,31735,21827,25528,14085
34914,5771,8148,0,34914,12267,22647,2.52813e+15,60.0258,10635,34914,3964,72,24127,22676,15176,15308,10008
15162,13404,15162,15162,0,15162,0,8.79551e+12,0,15162,15162,15162,1,0,0,0,0,0
11536,1419,3861,11536,0,10862,674,5.55299e+18,92.4874,4625.34,11536,1370,119,7675,7675,5666,6664,3224
18476,6388,6460,17556,920,0,18476,1.90226e+18,93.7147,7976.9,18476,3111,110,11789,11789,10370,10891,10350
13801,891,911,0,13801,13392,409,4.65103e+16,170.972,2467.18,13801,131,26,4821,4773,4223,4416,4005
989,96,164,989,0,989,0,5.94472e+18,97.7816,365.425,989,55,43,790,517,560,570,576
4982,1194,2159,0,4982,0,4982,4.91556e+17,84.4635,2690.18,4982,1022,78,4681,4681,4681,2955,1915
8767,1319,2144,8254,513,8254,513,5.67877e+18,97.1351,3109.64,8767,1004,108,6623,6623,5630,6064,4633
12537,782,5095,11967,570,11967,570,2.7649e+18,94.3685,6159.87,12537,2452,110,12207,12207,12207,12207,12207
22152,4158,5342,20861,1291,20861,1291,3.64038e+18,98.0143,7261.55,22152,2515,111,34793,34793,30581,29891,13049
37980,1056,11239,13773,24207,0,37980,9.07819e+12,59.073,13726.6,37980,5472,72,26741,26741,16322,24951,3716
26711,5638,6315,25161,1550,25161,1550,5.77889e+18,97.6186,8586.82,26711,3050,110,25979,25979,21422,20649,15947
40534,21086,22477,0,40534,0,40534,3.48932e+15,17.931,23016.8,40534,20213,20,31677,31677,31677,31677,31677
23552,3335,12999,0,23552,0,23552,3.82031e+17,89.84,14376.3,23552,6308,110,31773,31773,31773,31773,31773
45627,80,208,45569,58,45627,0,6.00937e+18,203.145,2740.35,45627,188,182,25815,8305,8298,8712,2289
47049,3,16,45657,1392,46975,74,1.8223e+14,10.3774,764.084,47049,13,12,2273,612,406,659,165
46481,6593,13152,43931,2550,43931,2550,5.48718e+18,97.6804,16414,46481,6261,111,46269,46269,46269,46269,46269
49977,5696,11677,0,49977,0,49977,6.48124e+17,97.9011,15399.9,49977,5664,110,45323,45323,45323,45323,45323
49921,18016,22160,47792,2129,47792,2129,6.35219e+18,93.7795,24984.2,49921,10672,111,48354,48354,48354,48354,48354
1474,150,423,1384,90,1384,90,5.72656e+18,89.3229,681.666,1474,185,50,1051,1051,955,914,534
25325,4658,8428,24035,1290,24035,1290,7.31963e+18,95.1826,10392.5,25325,4082,110,14556,14556,10773,14071,10059
8078,370,2143,7620,458,7620,458,6.05285e+18,96.1321,3044.83,8078,1025,103,5935,5935,4861,4147,1628
25503,7631,13415,25503,0,22603,2900,1.40397e+18,2058.81,16823,25503,5518,18,18889,18889,18889,18889,18889
7325,2030,2477,6954,371,6954,371,3.01004e+18,94.5932,3257.5,7325,1172,95,4848,4848,4430,4724,3881
35414,1935,9192,33415,1999,33415,1999,6.11505e+18,97.3943,11945.2,35414,4454,110,39538,39538,39538,39538,39538
27098,9,15,26287,811,27033,65,1.95447e+14,10.4447,568.924,27098,13,11,26865,26656,22984,22892,18304
36320,5873,8505,0,36320,0,36320,6.4768e+17,97.7869,11394.1,36320,4120,110,32680,32878,0,0,19663
5699,7,11,5534,165,5698,1,1.39972e+14,9.98702,208.66,5699,11,11,5522,5417,5194,5187,4581
24457,7162,10814,0,24457,0,24457,4.73341e+17,93.6745,12487.6,24457,5240,110,13643,13643,12173,11427,10024
44298,7592,10396,41728,2570,41728,2570,5.90598e+18,97.831,13774.8,44298,5031,110,45738,45738,45738,45738,45738
13132,160,3162,12362,770,12362,770,5.90116e+18,97.6839,4465.64,13132,1484,111,9970,9970,3704,6222,1243
15507,14,176,15500,7,15507,0,6.01594e+18,166.545,1514.14,15507,145,142,4927,841,1097,1193,1114
34231,6,14,33258,973,34156,75,1.38908e+14,10.6123,567.125,34231,13,12,44423,43365,35364,0,0
21780,2896,5085,7654,14126,0,21780,9.90376e+12,59.9415,6787.33,21780,2471,72,36088,36088,26199,22265,9629
13700,7,14,13299,401,13656,44,1.75809e+14,10.5004,364.779,13700,13,11,13333,13117,12510,11561,7990
2950,135,237,0,2950,2863,87,4.41139e+16,17.2271,589.315,2950,43,26,2713,2713,2171,2205,1090
16094,269,3828,15156,938,0,16094,2.22792e+18,97.329,5369.37,16094,1840,110,12266,12266,4051,3405,1663
9778,326,3331,9778,0,9215,563,4.83478e+18,92.108,4022.7,9778,668,118,6447,6447,3912,4829,909
14395,2860,4562,14395,0,13555,840,6.0359e+18,119.647,5544.64,14395,1730,120,9833,9802,8610,9248,6529
22779,2274,7484,22779,0,21489,1290,4.40373e+18,159.034,8809.35,22779,2029,128,48966,48966,48966,48966,48966
38208,3096,8929,35980,2228,35980,2228,5.76038e+18,97.8492,11935.1,38208,4320,110,29279,29279,25734,25159,11434
27363,936,6453,25773,1590,0,27363,2.22546e+18,97.6709,8769.14,27363,3119,110,29824,29776,13813,6294,3301
34194,109,176,34167,27,34194,0,6.06149e+18,172.197,2279.91,34194,164,167,32987,32859,29928,28542,19094
37622,4458,18708,14974,22648,0,37622,6.48234e+12,55.8296,20587.3,37622,9101,72,25514,25455,20094,22723,15065
42311,6,17,41055,1256,42242,69,1.86045e+14,10.3531,723.633,42311,14,12,41009,40124,34751,33742,27905
27260,844,1390,0,27260,26454,806,4.58198e+16,210.322,4251.58,27260,226,26,40899,40899,40899,40899,40899
5192,871,2470,5192,0,4946,246,3.84316e+18,90.8251,2886.38,5192,1007,89,2722,2722,1423,1962,1102
18452,7721,9356,0,18452,7369,11083,1.63966e+15,55.5494,10416.7,18452,4556,72,9096,9096,8192,7996,6870
16120,1947,3826,0,16120,0,16120,6.4907e+17,97.3179,5369.92,16120,1845,110,12294,12294,9804,8690,7019
4796,628,1152,1682,3114,0,4796,9.91614e+12,58.994,1689.38,4796,555,72,3644,3644,2879,3506,2118
44141,174,1204,0,44141,42884,1257,3.55073e+16,247.966,4173.16,44141,190,26,26645,25570,11404,4839,5936
4033,1672,1951,1592,2441,0,4033,6.73941e+12,53.9058,2310.96,4033,934,61,2082,2082,1771,2032,1628
10436,2809,3842,9926,510,9926,510,4.43536e+18,88.3487,4808.72,10436,1809,109,6594,6594,6394,6579,6296
34982,29,176,34920,62,34982,0,6.10363e+18,170.15,2315.29,34982,161,164,14362,1562,6386,8992,2203
19572,48,4628,18432,1140,0,19572,2.22949e+18,97.458,6414.84,19572,2232,110,8505,1816,3997,3011,493
41720,2045,13319,41720,0,39290,2430,4.29113e+18,295.255,15109.9,41720,3295,134,37469,37469,20413,28271,8816
18776,63,175,18765,11,18776,0,5.98268e+18,165.595,1621.44,18776,155,152,13360,7271,5958,6890,6852
23437,357,1177,0,23437,22750,687,4.40887e+16,240.394,3531.71,23437,182,26,22227,21680,17437,18099,10585
28996,1865,6775,27304,1692,27304,1692,3.35906e+18,97.7227,9197.37,28996,3269,110,20629,20629,12346,10538,3053
44420,2660,10322,0,44420,15608,28812,2.5312e+15,60.0739,13353.1,44420,5024,72,34142,34142,20626,26413,14324
25883,949,1149,0,25883,25132,751,4.16399e+16,242.729,3517.36,25883,179,26,23979,23979,22636,23614,21166
20829,9,14,20212,617,20760,69,1.81299e+14,10.3521,459.261,20829,13,12,4088,853,375,287,7
16912,617,991,0,16912,16414,498,4.51851e+16,207.311,2798.03,16912,147,26,15921,15566,14296,14623,11637
39485,5866,9224,37185,2300,37185,2300,5.88914e+18,97.8399,12310.9,39485,4469,110,46025,46025,46025,46025,46025
34771,2108,8340,32743,2028,32743,2028,3.60608e+18,98.2894,11056.3,34771,3949,111,26431,26431,16218,19576,8252
35173,4632,16873,0,35173,13896,21277,1.71834e+15,55.4354,18708.2,35173,8197,72,35111,35111,26786,24983,16306
20383,800,999,0,20383,19786,597,4.2051e+16,205.152,2931.31,20383,149,26,19384,19384,19086,19066,17461
28255,10239,10907,26935,1320,0,28255,1.79138e+18,95.3046,12912.4,28255,5284,110,29716,29716,29716,29716,29716
47747,13705,18417,32178,15569,45504,2243,1.7766e+18,96.1125,21365.1,47747,8838,111,46593,46593,46593,46593,46593
8735,198,199,8734,1,8728,7,5.99829e+18,174.007,1152.1,8735,122,126,8536,8530,8529,8529,8519
37929,2193,8890,13334,24595,0,37929,9.8777e+12,60.0259,11545.5,37929,4329,72,29039,29039,15175,25351,7457
14464,155,920,4441,10023,4441,10023,2.12972e+18,15.9792,1360.56,14464,599,18,32972,31925,19105,15990,0
25091,7689,12303,0,25091,0,25091,3.42099e+15,17.9743,12760.2,25091,11062,20,12788,12788,8227,8308,8058
31554,7600,12383,30084,1470,30084,1470,1.80381e+18,78.4366,14510.4,31554,5919,111,19171,19171,19171,19171,19171
35269,3455,8312,33219,2050,0,35269,2.22326e+18,97.7966,11132.9,35269,4027,110,14437,14437,8796,7406,3376
36337,757,12229,0,36337,0,36337,5.61102e+17,95.6636,14814,36337,5917,110,35952,35952,35952,35952,35952
26742,4224,6898,25232,1510,0,26742,2.16138e+18,97,9122.81,26742,3336,110,28764,28764,11476,5349,0
21213,3038,7416,7892,13321,0,21213,8.40707e+12,58.1238,8884.13,21213,3610,72,13797,13797,8851,12527,4899
29002,8,14,28165,837,28926,76,1.57479e+14,10.5551,546.365,29002,13,12,23734,22873,22471,0,0
15189,120,208,15176,13,15189,0,6.11404e+18,195.424,1640.27,15189,139,144,13875,12512,8602,8862,8843
3982,60,1367,3982,0,3752,230,5.34775e+18,92.0208,1795.43,3982,512,83,1805,441,859,1539,225
43750,6090,14325,41513,2237,41513,2237,7.28038e+18,94.7649,17344.8,43750,6942,110,33193,33193,28692,30614,22523
42624,11206,12550,40336,2288,40336,2288,3.25171e+18,96.9339,15622.9,42624,6096,110,31752,31752,31752,31752,31752
6492,266,6492,6492,0,0,6492,134197000,0,6492,6492,6492,1,0,0,0,0,0
43749,894,11734,41317,2432,41317,2432,3.31718e+18,97.3199,14960.8,43749,5682,110,34863,34863,27545,28556,27340
2255,667,689,2133,122,2133,122,3.19641e+18,90.8683,1035.2,2255,304,60,2111,2111,2013,1524,1538
831,5,10,807,24,831,0,1.36842e+14,9.14561,79.6419,831,10,10,763,673,661,643,490
4410,185,206,0,4410,4283,127,3.59798e+16,19.5383,593.599,4410,44,26,31221,30072,2975,23427,2613
25885,5158,8713,24565,1320,24565,1320,5.17083e+18,95.2408,10667.6,25885,4140,111,17172,17172,15904,17098,11440
743,387,545,743,0,721,22,4.8476e+18,34.1413,613.36,743,211,39,198,198,198,198,198
15192,6406,8659,0,15192,6237,8955,1.43104e+15,52.4556,9487.14,15192,4202,72,6533,6533,5877,5036,4952
21957,1214,8917,20957,1000,20957,1000,7.61068e+18,95.1288,10507.9,21957,4269,111,13040,12874,7985,9104,4386
47067,146,176,46985,82,47067,0,5.98164e+18,171.899,2570.66,47067,172,173,45863,45720,42071,41497,28525
49400,4017,15709,49400,0,46524,2876,4.86168e+18,336.672,17729,49400,5315,133,49048,49225,0,0,0
32434,7771,10252,30744,1690,30744,1690,3.07966e+18,96.5007,12673.5,32434,4975,110,24976,24976,24976,24976,24976
14963,4275,4678,12557,2406,14173,790,2.71132e+18,96.5926,6012.87,14963,2217,111,10285,10285,9965,10261,9674
39522,427,17608,15365,24157,0,39522,7.14834e+12,56.5692,19724.3,39522,8557,72,32115,31306,18704,5412,2324
34273,313,1026,0,34273,33296,977,3.55715e+16,211.419,3393.22,34273,153,26,24364,23848,11482,16868,5125
36602,2899,13568,0,36602,0,36602,5.32205e+17,95.6322,16062.1,36602,6585,110,30418,30418,26741,29235,21211
18981,99,176,18911,70,18981,0,5.99372e+18,166.249,1663.31,18981,147,154,10913,6204,6085,4117,3413
10303,3362,3512,9773,530,9773,530,2.37917e+18,95.931,4493.89,10303,1670,111,8277,8277,8277,8277,8277
29485,4766,10695,28055,1430,0,29485,1.85714e+18,93.0949,12829.1,29485,5169,110,30755,30755,14112,16121,10921
7395,1,2,7164,231,7363,32,0.000135227,0.99973,119.3,7395,2,1,7393,7393,7393,7393,7393
25153,2607,8226,0,25153,9256,15897,2.22992e+15,58.4944,9945.65,25153,4007,72,16927,16927,11679,10758,6532
11009,65,371,0,11009,10825,184,2.52126e+16,3.73476,1461.61,11009,188,4,10638,10638,9287,9251,5449
24646,730,5985,23216,1430,23216,1430,5.40232e+18,98.0493,8068.66,24646,2827,111,32684,32684,32684,32684,32684
20395,9,14,19805,590,20338,57,1.5311e+14,10.6473,435.457,20395,14,12,20112,19825,19094,18864,16518
47822,322,1799,0,47822,46431,1391,4.16913e+16,307.358,6010.85,47822,306,26,47732,47732,47732,47732,47732
47458,408,2181,45489,1969,13959,33499,1.29713e+18,16.9957,3027.68,47458,1077,27,47243,47243,47243,47243,47243
12679,5230,6601,12211,468,0,12679,1.41169e+18,89.2634,7518.12,12679,3192,109,6078,6078,5528,5402,5295
37193,19,176,37183,10,37193,0,5.98462e+18,169.715,2283.89,37193,170,168,17157,11730,11869,12751,11330
8834,2454,3770,8439,395,8439,395,8.44159e+18,93.6773,4571.35,8834,1812,105,5064,5064,4864,4832,4397
28939,11622,11726,27623,1316,0,28939,1.73692e+18,94.9466,13714.6,28939,5694,110,22581,22581,22581,22581,22581
44872,12021,13497,44872,0,42259,2613,4.94397e+18,313.207,15705.4,44872,4487,136,43677,43677,43677,43677,43677
17443,3840,4132,6131,11312,0,17443,9.83486e+12,59.7245,5559.72,17443,1990,72,43201,43201,43201,43201,43201
36854,6381,14301,35135,1719,0,36854,1.78367e+18,95.4009,16751.7,36854,6948,110,22553,22553,17404,16333,11709
13627,4191,5460,13627,0,12917,710,4.03659e+18,122.297,6271.19,13627,2133,118,41155,41155,41155,41155,41155
14570,1526,3774,13740,830,13740,830,1.95693e+18,97.4283,5158.04,14570,1775,111,10796,10796,8154,8793,5270
36097,822,8508,33999,2098,0,36097,2.22284e+18,97.6355,11377.9,36097,4121,110,27589,27589,17136,14798,4101
6887,530,1707,6480,407,6480,407,2.14536e+18,96.6808,2513.06,6887,789,98,5180,5180,3006,3613,38312
12089,398,520,0,12089,11743,346,3.56086e+16,20.0912,1445.28,12089,71,26,11752,11752,11511,11536,9604
27763,151,176,27686,77,27763,0,5.99259e+18,170.556,1998.47,27763,159,165,22157,20926,12690,2654,1746
9827,3,13,9546,281,9765,62,1.38231e+14,10.8825,303.19,9827,13,12,33570,31319,32285,32627,30752
34428,129,208,34359,69,32517,1911,6.15573e+18,179.278,2377.51,34428,161,162,19202,18387,13605,5465,5770
48642,1537,11375,0,48642,0,48642,6.48371e+17,97.9101,15015.3,48642,5522,110,32224,31429,17294,21436,4590
4849,1394,1981,1844,3005,0,4849,7.70653e+12,53.2673,2434.68,4849,942,66,2868,2868,2486,2798,2192
26800,4896,14999,0,26800,5762,21038,1.36549e+13,8.98149,15309.1,26800,13498,11,11801,11801,5605,5986,5244
1752,133,643,1752,0,1652,100,3.41994e+18,86.4384,888.724,1752,228,59,1109,394,577,785,399
47853,1354,2034,0,47853,46446,1407,4.44711e+16,314.615,6700.43,47853,352,26,36774,36774,15110,13692,6426
34478,2713,13887,32909,1569,0,34478,1.74146e+18,95.1194,16172.2,34478,6740,110,31819,31819,31819,31819,31819
28039,9177,10635,0,28039,10583,17456,2.05342e+15,57.6803,12393.7,28039,5181,72,27719,27719,27719,27719,27719
14788,34,186,14775,13,14788,0,5.98556e+18,179.663,1479.91,14788,145,145,7778,2348,2423,3153,2632
26089,21,176,26077,12,26089,0,5.98446e+18,169.573,1914.96,26089,164,161,7451,504,799,2233,36
15394,620,650,0,15394,14957,437,3.55654e+16,20.0565,1790.85,15394,83,26,14744,14744,14696,14700,14415
4818,54,1158,0,4818,1689,3129,2.52701e+15,59.0513,1699.5,4818,556,72,3306,1316,2077,488,118
17030,523,10272,0,17030,7095,9935,1.31497e+15,52.6804,11120.4,17030,4998,72,12651,12651,6035,8320,2464
526,97,153,526,0,526,0,6.08352e+18,68.6825,262.321,526,42,34,373,255,283,290,268
47909,1258,13949,45328,2581,0,47909,2.0624e+18,96.4334,17329.4,47909,6774,110,34768,34768,18106,24960,10745
8226,140,176,8220,6,8226,0,6.12705e+18,164.634,1122.64,8226,106,110,7899,7466,6530,6603,6577
45860,2894,20696,43942,1918,0,45860,1.59963e+18,94.4523,23364.7,45860,10064,110,42380,42380,41585,41439,41099
49451,7267,13278,0,49451,0,49451,6.1826e+17,97.3582,16834.6,49451,6444,110,47365,47365,47365,47365,47365
13196,98,698,0,13196,12817,379,3.82731e+16,24.9165,1821.33,13196,88,26,12498,12485,10704,10088,3527
18668,7,13,18133,535,18600,68,1.41461e+14,10.7791,418.401,18668,12,12,2843,984,493,1364,61
38646,9687,15034,38646,0,30741,7905,4.66786e+18,286.365,16672.6,38646,3138,137,37186,37186,37186,37186,37186
18347,6,12,17806,541,18335,12,1.78148e+14,10.1016,402.457,18347,12,11,17634,17262,14316,13706,11902
13351,2115,4901,4993,8358,0,13351,8.18448e+12,55.0774,5906.73,13351,2367,72,13311,13311,9186,10059,7506
20549,1669,5740,19409,1140,19409,1140,3.97339e+18,97.3625,7486.25,20549,2718,111,32929,32929,14644,7465,5585
29561,4117,13109,0,29561,11488,18073,1.83863e+15,55.0631,14796,29561,6364,72,16452,16452,11566,10359,6290
17858,150,717,0,17858,17351,507,3.55527e+16,47.8383,2025.41,17858,92,26,17141,17111,14772,14848,6045
35774,14085,16607,14028,21746,0,35774,6.91598e+12,56.3497,18507,35774,8076,72,35454,35454,35454,35454,35454
44207,6569,12586,15941,28266,0,44207,9.23058e+12,59.2483,15433.3,44207,6127,72,38302,38302,38302,38302,38302
33775,3,12,32813,962,33762,13,1.38892e+14,10.1934,518.709,33775,12,11,16171,15191,15177,15223,14594
26583,2348,6255,0,26583,9342,17241,2.52442e+15,59.9491,8247.79,26583,3038,72,25470,25470,25470,25470,25920
12346,2531,4346,0,12346,4591,7755,2.14834e+15,57.8941,5310.65,12346,2112,72,29574,29574,18088,7775,3857
5533,696,1429,5214,319,5214,319,3.25322e+18,95.4182,2119.1,5533,669,89,4104,4104,3303,3805,2271
20676,1528,7692,19680,996,19680,996,2.62237e+18,95.9359,9274.21,20676,3672,111,12984,12984,9072,8260,3628
5148,1114,1364,4851,297,4851,297,5.36071e+18,95.7348,2010.74,5148,631,88,3784,3784,3784,3750,3364
46037,13257,21682,0,46037,0,46037,4.47714e+17,94.1138,24285.9,46037,10539,110,45709,45709,45709,45709,45709
7472,175,176,7430,42,6132,1340,6.11965e+18,158.423,1067.76,7472,103,105,7295,7290,7289,7289,7281
36240,7862,12406,13439,22801,0,36240,8.483e+12,57.7126,14672.1,36240,6037,72,36071,36071,36071,36071,36071
1525,18,521,1443,82,1443,82,2.92039e+18,83.6197,771.753,1525,218,52,337,24,0,54,37
3707,1985,2008,3569,138,3569,138,2.40788e+18,84.0531,2374.87,3707,940,71,1699,1699,1682,1696,1699
43570,9,15,42304,1266,43510,60,1.57974e+14,10.475,692.18,43570,13,11,9429,4544,3551,4723,3302
23167,8500,13146,23167,0,22357,810,5.00734e+18,423.883,14310.7,23167,5011,131,10021,9834,8998,9983,7452
16570,1,3,16052,518,16506,64,0.0001207,0.999819,212.425,16570,3,1,16567,16567,16567,16567,16567
6593,16,32,0,6593,6046,547,2.98702e+16,9.98771,269.048,6593,29,11,6561,6559,6223,5896,6529
6583,1201,1664,6202,381,6202,381,3.19862e+18,95.9016,2449.21,6583,780,96,7864,7864,4694,4041,1666
24016,115,176,23959,57,24016,0,6.14479e+18,167.255,1915.62,24016,146,152,47069,46849,38648,37876,10159
43973,13003,13274,43973,0,41413,2560,3.64461e+18,310.596,15449.1,43973,5245,129,36340,0,0,0,0
3908,639,992,0,3908,0,3908,6.45639e+17,94.4529,1531.26,3908,459,80,11740,11740,4817,2543,2782
11012,147,208,11006,6,11012,0,6.05012e+18,195.758,1376.17,11012,133,130,30520,30496,30461,30456,28177
37998,670,1451,0,37998,36894,1104,4.08854e+16,286.552,4736.19,37998,239,26,34476,34476,28329,32752,25459
39512,8153,16629,37772,1740,0,39512,1.68676e+18,94.8755,19111.7,39512,8076,110,23119,23119,18916,16292,14487
22877,4921,7124,21677,1200,21677,1200,6.85948e+18,96.3326,8986.39,22877,3440,110,39683,39683,39683,39683,39683
14923,2297,3520,5250,9673,0,14923,9.90182e+12,59.8046,4783.01,14923,1709,72,11403,11403,9593,11083,7539
31712,6799,9716,31712,0,29864,1848,4.68363e+18,212.393,11410.2,31712,1957,129,21996,21960,20100,21439,16172
6755,38,2947,6465,290,0,6755,1.66977e+18,92.8308,3602,6755,1403,93,7402,1033,4407,3377,470
7652,709,2905,2871,4781,0,7652,7.99165e+12,57.1002,3558.62,7652,1402,72,4747,4699,2651,3987,946
36674,9564,11181,36674,0,34542,2132,4.05354e+18,264.427,13079,36674,4371,128,36307,36307,36307,36307,36307
38005,8218,8843,0,38005,13357,24648,2.5398e+15,60.0669,11505.1,38005,4307,72,22028,22028,18411,21763,14238
26246,4598,8044,24854,1392,24854,1392,4.07431e+18,97.0596,10085.4,26246,3824,111,23863,23863,17004,11268,9794
3989,9,11,3872,117,3983,6,1.75066e+14,10.1534,184.906,3989,11,11,3936,3902,3796,3795,3613
19646,334,4608,0,19646,6896,12750,2.5268e+15,59.9048,6178.01,19646,2239,72,15038,15038,4713,1594,1273
2178,222,573,0,2178,762,1416,2.44641e+15,56.8526,869.274,2178,266,56,1605,1605,1080,798,720
45519,1106,12728,16371,29148,0,45519,9.291e+12,59.3313,15663,45519,6196,72,43774,43774,43000,42799,39013
35860,2593,14779,0,35860,13737,22123,1.94005e+15,56.4578,16832.7,35860,7177,72,26416,4753,4753,4753,4753
10153,1719,2414,9560,593,0,10153,2.23884e+18,96.7936,3507.85,10153,1154,110,7739,7739,6806,6599,5909
8362,305,356,0,8362,8125,237,3.53739e+16,19.9876,1017.9,8362,57,26,0,0,0,0,0
12932,11732,12932,0,12932,12932,0,2047.84,0,12932,12932,12932,1,2830,2830,2830,2830,2830
30734,6449,7408,28946,1788,28946,1788,3.13018e+18,98.181,9875.05,30734,3499,111,26112,26112,22632,17775,16788
49791,7871,14104,47061,2730,47061,2730,2.67964e+18,97.7136,17545.6,49791,6724,111,45430,45430,45430,45430,45430
20824,322,5034,19614,1210,19614,1210,4.87109e+18,97.9316,6869.9,20824,2367,111,25764,25763,10950,18757,2654
19411,3972,10148,0,19411,0,19411,4.07143e+17,92.9315,11400.4,19411,4919,110,9263,9263,7060,4481,3932
3904,314,960,1370,2534,0,3904,9.78998e+12,58.5909,1418.8,3904,462,67,2944,2944,2011,2777,1049
42230,1424,1426,0,42230,41519,711,2.52978e+16,3.73576,5461.46,42230,715,4,37674,37674,15332,13686,6724
12877,125,614,0,12877,12507,370,3.68318e+16,20.0054,1648.17,12877,81,26,12263,12263,10689,10462,4149
34756,9016,10462,32908,1848,0,34756,2.03413e+18,96.7339,13059.7,34756,5073,110,27239,27239,27239,27239,27239
42885,6417,14126,40698,2187,40698,2187,3.10989e+18,96.3357,17092.1,42885,6853,110,41028,41028,41028,41028,41028
41311,360,1393,0,41311,40119,1192,3.88223e+16,273.898,4656.15,41311,226,26,41064,41064,41064,41064,41064
26654,2067,6657,0,26654,9442,17212,2.47823e+15,59.7182,8620.35,26654,3238,72,19997,19997,14163,9996,7141
49779,77,176,49696,83,49779,0,5.98301e+18,171.863,2643.21,49779,172,172,41423,36038,24418,18732,18967
20820,5660,7554,0,20820,0,20820,5.39999e+17,95.1624,9191.44,20820,3650,110,23904,23904,23004,23904,17949
21838,8816,9659,20908,930,0,21838,1.63038e+18,92.23,11195.1,21838,4680,110,12179,12179,11882,11680,11678
25681,8,14,24946,735,25609,72,1.42519e+14,10.6462,480.419,25681,13,12,3782,722,396,1557,60
38032,43,176,37984,48,38032,0,6.01258e+18,172.384,2358.07,38032,169,171,15012,3246,9661,3955,0
35979,633,1639,0,35979,34919,1060,4.46758e+16,291.157,5222.92,35979,277,26,35799,35799,35799,35799,35799
46175,7178,14004,16803,29372,0,46175,8.97517e+12,54.5278,16897.4,46175,6799,72,44732,44732,44732,44732,44732
23090,69,175,23081,9,23090,0,5.97854e+18,166.719,1798.43,23090,155,162,17230,9529,8117,9437,9138
1331,38,94,1276,55,407,924,1.46521e+18,16.7491,220.204,1331,66,19,1237,1237,1057,1101,45459
48151,8,16,46759,1392,48055,96,1.54145e+14,10.4522,716.226,48151,14,13,47937,47813,45951,45924,44729
41685,2620,9776,0,41685,0,41685,6.47983e+17,97.8705,12993,41685,4744,110,46235,46235,44277,44731,43584
3174,321,795,1115,2059,0,3174,9.63457e+12,57.9382,1189.37,3174,373,62,2379,2379,1718,2262,1063
49213,8369,18359,46853,2360,46853,2360,3.25474e+18,96.0528,21428.7,49213,8801,111,34295,34295,29478,24673,23798
36752,4,14,35698,1054,36674,78,1.43219e+14,10.3903,570.449,36752,13,12,24021,23451,23124,23161,22760
37949,5345,8930,0,37949,0,37949,6.47491e+17,97.8221,11915.2,37949,4330,110,32966,32966,25142,26718,15527
26419,1839,9328,0,26419,0,26419,5.47736e+17,94.823,11312.1,26419,4503,110,17091,37352,30765,25709,24081
3924,958,1376,3924,0,3695,229,3.1637e+18,89.9485,1776.29,3924,485,80,32391,32391,30440,30288,2075
27441,3555,6581,25841,1600,25841,1600,2.79822e+18,98.1542,8844.82,27441,3102,111,20860,20860,17702,20633,12080
47002,4963,14983,47002,0,44262,2740,3.95845e+18,325.46,16932.8,47002,5602,129,38646,38646,37528,38456,35853
21500,164,786,0,21500,20886,614,3.55495e+16,103.801,2329.75,21500,106,26,15351,14853,9354,3709,1644
39531,1872,9270,0,39531,13902,25629,2.52344e+15,60.0096,12018,39531,4504,72,38340,38340,38340,38340,38340
40761,3,15,39581,1180,40674,87,1.58426e+14,10.4318,654.965,40761,13,13,33302,26252,0,0,5352
24043,2194,8051,22814,1229,22814,1229,2.32805e+18,96.6389,9901.08,24043,3842,111,9941,9941,5365,8539,1943
5998,19,176,5992,6,5998,0,6.03208e+18,158.22,954.188,5998,107,103,2325,459,652,608,552
37807,3622,9399,35647,2160,35647,2160,6.10921e+18,97.597,12338.1,37807,4561,110,37278,37278,37278,37278,37278
28070,5,14,27233,837,28040,30,1.88138e+14,10.2693,521.695,28070,13,12,4758,1289,869,0,14
42431,4620,19336,0,42431,0,42431,4.61705e+17,94.3677,21833.5,42431,9400,110,23229,23229,19289,22331,14621
15801,298,791,0,15801,15343,458,3.95152e+16,98.4682,2178.08,15801,107,26,23501,23501,23501,23501,23501
43539,816,14811,0,43539,16124,27415,2.17711e+15,58.3592,17444.2,43539,7210,72,39416,39416,32702,31082,29877
18897,5531,7981,15255,3642,18057,840,3.09807e+18,94.6745,9375.02,18897,3805,111,10916,10916,10916,10649,9101
47940,9310,23381,46071,1869,46071,1869,9.47348e+18,93.8671,26000.8,47940,11363,110,39677,39677,39677,39677,39677
14189,2299,5237,13499,690,13499,690,2.79829e+18,92.6141,6443.8,14189,2502,111,21108,20782,12023,8244,4570
45766,41,206,45686,80,45766,0,5.98182e+18,193.335,2635.44,45766,188,180,24179,17744,18991,20510,16511
9173,6292,9173,9173,0,9173,0,3.4356e+10,0,9173,9173,9173,1,0,0,0,0,0
11141,512,2907,10511,630,10511,630,3.23589e+18,96.5488,4055.72,11141,1389,110,25842,25842,0,0,0
18111,21,175,18105,6,18111,0,5.97347e+18,166.042,1594.02,18111,154,152,11077,843,1636,1135,627
45161,2,14,43859,1302,45077,84,1.50127e+14,10.4138,683.132,45161,13,12,9336,8248,8244,8414,8223
47799,16043,24668,0,47799,0,47799,4.09862e+17,93.4144,27168.6,47799,11992,110,47491,47491,47491,47491,47491
37154,108,267,0,37154,34084,3070,2.97122e+16,10.0815,930.536,37154,261,11,33739,33691,25316,23121,23045
41790,6166,14440,39710,2080,39710,2080,7.36913e+18,83.5666,17291.7,41790,7010,110,40047,40877,10992,10622,6656
16574,632,3937,0,16574,0,16574,6.47538e+17,97.3553,5514.54,16574,1894,110,12637,12637,5571,3426,2850
23812,3136,10183,22772,1040,22772,1040,2.66904e+18,92.0446,11853.3,23812,4939,110,13629,13629,10102,11050,4945
49129,5953,14024,46466,2663,46466,2663,6.65004e+18,97.0725,17497.2,49129,6808,110,48463,48463,48463,48463,48463
32460,5217,12255,0,32460,12227,20233,2.05395e+15,57.7262,14237.6,32460,5964,72,32036,31804,20102,19117,11339
11369,550,4514,10839,530,10839,530,4.14223e+18,95.0848,5506.75,11369,2154,110,6855,6594,4712,4204,2243
8822,256,776,0,8822,8562,260,4.97836e+16,101.496,1897.17,8822,104,26,8046,7949,6347,6746,3556
20756,6670,7333,20756,0,19593,1163,4.52986e+18,147.491,8426.21,20756,2750,124,13423,13423,13023,13238,12501
38647,10521,13843,14433,24214,0,38647,8.28423e+12,58.0576,16178.9,38647,6740,72,38238,38238,38238,38238,38238
42336,11055,15081,15802,26534,0,42336,8.30129e+12,58.048,17602.3,42336,7338,72,25123,25123,21648,24291,16292
25391,5598,10722,24262,1129,24262,1129,4.14141e+18,95.3422,12456.3,25391,5153,111,19273,19273,18861,18453,18363
7462,1408,3123,0,7462,2855,4607,1.92308e+15,51.8413,3735.31,7462,1499,72,4339,4339,4156,4024,4008
567,315,425,0,567,250,317,1.27724e+15,17.6314,472.684,567,201,25,142,142,99,31,0
23372,2878,11842,0,23372,0,23372,4.19112e+17,88.9524,13317.4,23372,5728,110,35761,35761,20080,31171,9870
42273,1150,9888,0,42273,14865,27408,2.52773e+15,60.0499,12792.9,42273,4808,72,40986,40986,40984,40984,40835
20488,152,175,20478,10,20488,0,5.97355e+18,166.234,1694.14,20488,153,159,20045,19465,17976,17962,17871
42435,4255,9896,39959,2476,39959,2476,3.34881e+18,97.8782,13162.5,42435,4793,110,41098,41098,41098,41098,41098
36704,1522,8545,12893,23811,0,36704,9.90265e+12,60.058,11134.6,36704,4163,72,28159,28159,17955,26399,5503
19292,94,914,0,19292,18733,559,4.04586e+16,173.978,2641.71,19292,131,26,27418,9313,5170,14700,1205
15705,620,8347,15705,0,15100,605,4.53824e+18,217.776,9257.21,15705,3828,120,7358,6525,3580,4806,1523
49097,11299,12633,17479,31618,0,49097,9.57962e+12,59.6299,15837.6,49097,6148,72,28853,28853,25360,28221,22654
20654,8,9,18952,1702,20653,1,1.1573e+14,7.95139,355.415,20654,9,8,5956,1175,666,1463,51
17668,3885,6299,17668,0,16678,990,5.30945e+18,140.778,7284.4,17668,2350,121,11369,11329,9710,10632,7258
22139,4518,7952,21059,1080,0,22139,1.87143e+18,94.3706,9674.9,22139,3839,110,14187,14187,12249,11122,9225
26389,2765,6195,9289,17100,0,26389,9.87431e+12,59.9734,8177.35,26389,3015,72,20540,20540,19296,19798,11711
27280,119,176,27196,84,27280,0,6.11061e+18,171.892,2046.05,27280,149,156,23112,10735,6497,590,1168
10418,2264,4042,9928,490,9928,490,7.89494e+18,94.4524,4992.29,10418,1946,107,6376,26867,26178,0,0
47749,1075,1268,0,47749,46388,1361,3.5512e+16,258.76,4458.31,47749,202,26,33755,33152,20690,24982,10779
1695,392,904,1625,70,1625,70,3.76107e+18,58.4968,1112.45,1695,414,46,791,791,791,791,791
3512,11,254,0,3512,3411,101,4.19584e+16,19.25,643.979,3512,46,26,3035,2734,1757,37380,35963
2770,754,1430,2661,109,2661,109,7.5549e+18,88.9336,1737.72,2770,667,56,18320,19541,11984,10346,2647
11152,46,199,11146,6,11152,0,5.98243e+18,177.47,1300.92,11152,134,132,6733,3123,2209,2945,2450
34334,2942,11163,34334,0,32344,1990,3.48347e+18,236.685,12714.6,34334,4118,128,35555,35555,35555,35555,35555
49217,285,11659,0,49217,0,49217,6.4457e+17,97.8444,15326,49217,5655,110,47710,47710,47710,47710,47710
31185,14727,31185,31185,0,0,31185,7.99974,0,31185,31185,31185,1,20175,20175,20175,20175,20175
38828,11,14,37721,1107,38748,80,1.38838e+14,10.6361,614.832,38828,13,12,7308,1809,1480,2500,292
10468,2559,4051,3959,6509,0,10468,7.95044e+12,56.8599,4870.25,10468,1957,72,6417,6417,5637,6254,4490
25481,7928,9156,24219,1262,24219,1262,1.82607e+18,83.1649,11042.1,25481,4348,112,16325,16325,15130,16224,13335
38383,12,15,37262,1121,38326,57,1.62771e+14,10.5086,658.482,38383,13,11,38360,38355,37922,37914,37566
19583,4163,4628,0,19583,0,19583,6.49866e+17,97.4411,6415.22,19583,2229,110,26795,31097,35439,35439,35439
27086,5,12,26303,783,27068,18,1.57832e+14,10.2839,482.074,27086,11,12,24949,22347,18655,18583,14808
1547,406,480,0,1547,545,1002,2.36589e+15,55.5223,701.211,1547,227,50,1067,1067,983,961,968
37441,8401,8763,0,37441,0,37441,6.48599e+17,97.8188,11720.7,37441,4246,110,32851,32851,30688,32152,27646
10687,1371,2600,10067,620,0,10687,2.2215e+18,96.7809,3728.99,10687,1245,110,8087,8087,6783,6243,4913
8657,14,366,0,8657,8411,246,3.53255e+16,20.0582,1044.97,8657,57,26,7917,7480,5017,5019,1497
32446,3966,9246,11705,20741,0,32446,9.21331e+12,58.4951,11463.5,32446,4488,72,32211,32211,32211,32211,32211
7770,1374,1899,2737,5033,0,7770,9.83667e+12,59.3434,2660.77,7770,921,72,5871,5871,5106,5733,4355
19741,7369,8997,7705,12036,0,19741,7.02665e+12,56.3464,10202.8,19741,4373,72,26986,26986,23695,26986,17816
29193,1448,8246,27603,1590,27603,1590,3.28197e+18,96.914,10563.9,29193,3986,110,20947,20947,9174,14322,3553
9493,2281,2289,3341,6152,0,9493,9.8405e+12,59.4876,3176.65,9493,1111,72,17222,17222,10287,7882,3519
22787,10203,11228,22787,0,17004,5783,4.86838e+18,245.076,12333.2,22787,4926,127,11559,11559,10988,11352,10420
14663,2376,5672,13967,696,13967,696,4.8756e+18,95.5607,6879.42,14663,2715,111,24172,24172,16067,21399,9101
12685,8,11,12323,362,12679,6,1.38907e+14,10.3544,316.136,12685,11,11,12374,12145,9554,9629,9931
43308,10,15,42045,1263,43216,92,1.64207e+14,10.4161,703.546,43308,14,12,14066,10181,9488,10728,9321
22608,2646,10701,21690,918,21690,918,4.7154e+18,93.8921,12185.9,22608,5130,111,19606,19606,19220,19536,18910
2498,555,681,0,2498,0,2498,6.24063e+17,91.8579,1066.6,2498,299,62,1817,1817,1698,1675,1692
4883,372,1224,4603,280,0,4883,2.22289e+18,95.0422,1861.38,4883,563,85,3659,3659,2536,10222,8851
7759,1110,2955,7387,372,0,7759,1.83701e+18,94.1424,3727.4,7759,1416,103,20434,20434,7286,18881,4324
7048,934,1750,6636,412,6636,412,3.5443e+18,96.5875,2570.47,7048,803,99,5298,5298,3778,4106,3284
38094,3716,11029,36034,2060,36034,2060,6.70056e+18,96.9877,13857,38094,5355,110,25438,25438,14978,17660,6176
24804,3522,8117,24804,0,23361,1443,4.26035e+18,163.626,9360.59,24804,2954,121,16687,16537,11389,13769,7828
49334,10662,19925,0,49334,18826,30508,1.96546e+15,57.2919,22612.7,49334,9683,72,48996,48996,48996,48996,48996
44053,9889,10254,41483,2570,41483,2570,5.75341e+18,97.9107,13623.5,44053,4970,110,36717,36717,36717,36717,36717
12652,4000,7919,12429,223,12252,400,5.54208e+18,167.593,8567.58,12652,3441,116,8942,8855,7899,8581,6535
8180,1009,3476,0,8180,3146,5034,1.9136e+15,52.0819,4127.37,8180,1671,72,7688,7688,6693,6997,3695
20642,4745,5614,7386,13256,0,20642,9.40763e+12,59.3037,7180.22,20642,2730,72,46996,46996,46996,46996,46996
25355,1056,1192,0,25355,24613,742,4.28964e+16,251.382,3626.81,25355,185,26,24163,24163,23938,23926,22670
18386,351,4317,6460,11926,0,18386,9.91513e+12,59.8563,5802.64,18386,2096,72,14069,14069,8322,13076,1380
33273,3942,13676,0,33273,0,33273,5.00129e+17,94.9664,15872.5,33273,6644,110,21678,21678,15766,14512,8706
40228,5858,12168,40228,0,37888,2340,4.71539e+18,287.093,14201.4,40228,2638,136,27396,27276,20283,22606,14304
41612,1627,16211,39674,1938,39674,1938,2.91155e+18,95.4086,18898.1,41612,7873,110,31779,31779,19264,14362,12796
32310,6348,9927,32310,0,30430,1880,4.71492e+18,218.64,11647,32310,3860,125,31864,31864,31864,31864,31864
8290,2081,2583,3026,5264,0,8290,8.94659e+12,58.3402,3330.39,8290,1253,72,5707,5707,5091,5599,4538
17975,9,12,17461,514,17968,7,1.38866e+14,10.4734,379.138,17975,12,11,3492,1020,521,1050,162
38347,3,14,37241,1106,38324,23,1.51546e+14,10.2358,575.855,38347,13,12,27893,22199,22558,23101,15233
22725,8,11,22070,655,22713,12,1.49488e+14,10.0954,430.78,22725,11,11,22217,21958,19989,23464,20436
39026,5635,12546,0,39026,0,39026,5.75664e+17,96.4551,15320.8,39026,6093,110,49039,49039,49039,49039,49039
37788,10355,16866,36198,1590,0,37788,1.61369e+18,94.3109,19183.1,37788,8181,110,20922,20922,18722,17675,15232
29761,21875,29761,29761,0,0,29761,7.99973,0,29761,29761,29761,1,0,0,0,0,0
17158,708,4019,6032,11126,0,17158,9.89889e+12,59.9201,5432.54,17158,1957,72,45901,45901,40892,44994,34790
49584,1656,11868,46694,2890,46694,2890,1.71857e+18,98.3808,15458.7,49584,5622,111,49377,49377,49377,49377,49377
45001,13015,24589,0,45001,18311,26690,1.49766e+15,54.1059,26590.9,45001,11956,72,31859,31859,31519,31407,31056
28733,5357,6773,27058,1675,27058,1675,5.89643e+18,97.7066,9172.41,28733,3280,110,21960,21960,21602,21602,17927
48062,65,176,47994,68,48062,0,6.08664e+18,173.049,2714.89,48062,172,172,36785,0,0,0,0
43628,7,17,42322,1306,43547,81,1.94829e+14,10.3821,751.806,43628,14,12,6036,1635,1103,1637,60
26477,6342,6411,24937,1540,24937,1540,3.76152e+18,98.0824,8609.71,26477,3026,111,25838,25838,25838,25838,25838
37623,10688,11823,35643,1980,35643,1980,4.11931e+18,97.1492,14489.6,37623,5638,111,29323,29323,29323,29323,29323
20443,4991,10235,20443,0,20443,0,3.67725e+18,17.968,10641.8,20443,9202,20,10208,10208,5077,10208,5133
9083,76,176,9072,11,9083,0,6.08181e+18,161.414,1179.63,9083,115,119,7364,5108,3814,3968,3762
47496,127,176,47435,61,47496,0,6.03577e+18,173.913,2673.82,47496,173,174,46591,45437,43000,43052,43156
22618,3748,10084,22618,0,17438,5180,4.17856e+18,192.586,11189.2,22618,4236,126,27354,27354,27354,27354,27354
37864,534,9719,0,37864,13462,24402,2.45361e+15,59.6857,12309.1,37864,4732,72,32945,32945,10087,6452,2195
28905,8186,14405,6327,22578,0,28905,52400800000,8.9863,14755.5,28905,12957,11,14500,14500,9613,14500,9039
13237,4,12,12861,376,13230,7,1.38494e+14,10.4167,323.955,13237,12,11,11569,10311,10144,10277,5841
7648,1470,1898,7202,446,0,7648,2.21915e+18,96.3223,2778.1,7648,906,102,5750,5750,5197,5135,4814
37085,12,14,36011,1074,37062,23,1.56999e+14,10.2566,573.382,37085,13,12,37065,37065,37024,37023,36941
31441,6614,12110,29961,1480,29961,1480,6.12487e+18,95.9954,14249.1,31441,5815,111,25440,25440,22689,19978,19984
14016,3013,4875,14016,0,13216,800,3.21059e+18,121.652,5733.85,14016,1790,123,9141,9104,7110,7892,5986
44467,11450,18215,44467,0,42247,2220,4.46037e+18,386.817,20037.2,44467,6967,138,31553,31515,30429,31066,29079
49437,8,15,48007,1430,49353,84,1.50727e+14,10.4014,716.904,49437,13,13,8622,3407,2548,3119,2137
39303,38806,39303,39303,0,0,39303,7.9998,0,39303,39303,39303,1,28131,28131,28131,28131,28131
43031,161,15408,40931,2100,0,43031,1.86818e+18,95.9161,18283.5,43031,7487,110,42616,42616,41884,39645,41450
32628,6539,17265,32628,0,31458,1170,5.11826e+18,1161.51,19134.3,32628,6888,139,25727,25727,25727,25727,25727
14894,56,809,0,14894,14462,432,4.11281e+16,120.5,2205.35,14894,108,26,23428,10169,14344,770,243
12042,2035,6449,11612,430,11612,430,2.39606e+18,85.6648,7316.62,12042,3099,110,5593,5593,3700,4444,1724
8376,3092,4991,0,8376,0,8376,3.47772e+17,83.6572,5594.18,8376,2391,86,3385,3299,2545,1223,1500
22496,6721,6995,22496,0,21186,1310,4.05103e+18,159.149,8326.41,22496,2677,120,15501,15501,15353,15431,15239
33392,2964,17366,32162,1230,32162,1230,3.12592e+18,93.5815,19223.8,33392,8385,111,33020,33020,33020,33020,33020
26790,6983,8270,25370,1420,25370,1420,3.70337e+18,97.1022,10341.7,26790,3940,111,28372,28372,28372,28372,28372
12448,503,769,0,12448,12085,363,4.22517e+16,94.0873,2001.95,12448,100,26,11679,11589,11233,11237,8845
35117,2372,8231,33076,2041,0,35117,2.22791e+18,97.7714,11045.5,35117,3976,110,42650,42650,42650,42650,42650
29926,6624,11765,0,29926,0,29926,5.15152e+17,95.2272,13838.1,29926,5713,110,18161,18161,14374,10519,10220
42211,8822,18543,40411,1800,0,42211,1.63324e+18,94.5987,21090.5,42211,9010,110,23668,23668,18525,17491,13003
10116,2036,3389,9596,520,9596,520,2.83279e+18,95.8994,4367.61,10116,1608,109,20386,24800,13405,11059,5985
19584,5582,9009,19584,0,18674,910,5.4499e+18,177.338,10002.6,19584,3750,128,10575,10547,9191,10171,7762
38705,3204,11892,36665,2040,0,38705,2.01673e+18,96.6964,14699.8,38705,5774,110,30703,30703,24161,26425,17562
49656,35,208,49558,98,49656,0,6.07582e+18,202.747,2956.83,49656,188,185,21424,9288,11500,16928,6429
46011,171,176,45983,28,46011,0,6.01453e+18,173.979,2607.83,46011,174,174,37064,36844,24321,18138,18241
33231,11138,13792,0,33231,12742,20489,1.93e+15,57.1154,15713,33231,6706,72,14583,14583,11381,10423,8358
7584,2279,3387,0,7584,2938,4646,1.85371e+15,56.0814,3980.73,7584,1646,72,4197,4197,3535,2812,2929
13721,4607,6147,13141,580,13141,580,8.80093e+18,93.5839,7226.17,13721,2974,110,12421,12421,12421,12421,12421
1199,704,881,1169,30,0,1199,9.87496e+17,41.6214,985.462,1199,404,37,318,300,222,163,66
11431,2419,2736,0,11431,4019,7412,2.51059e+15,59.6091,3764.78,11431,1320,72,17070,17070,9876,4487,3114
5079,207,498,0,5079,4927,152,4.94288e+16,19.0665,1159.98,5079,68,26,4581,4578,4115,3985,2334
10834,3603,5383,10412,422,10412,422,5.24096e+18,93.4376,6221.55,10834,2570,107,5451,5451,4216,4411,4322
39090,1771,19155,0,39090,8576,30514,1.3368e+13,8.99371,19567.6,39090,17236,11,31348,31348,20801,12029,7634
16528,559,713,0,16528,16055,473,3.61334e+16,39.8549,1968.75,16528,91,26,15815,15794,15249,15364,13492
46447,2934,10875,0,46447,0,46447,6.47062e+17,97.8846,14388.3,46447,5265,110,46092,46092,46092,46092,46092
16796,588,604,0,16796,16496,300,2.5741e+16,3.73196,2343.01,16796,304,4,16192,16192,16190,16180,16035
7567,1363,1882,7129,438,0,7567,2.21398e+18,95.5326,2755.35,7567,893,101,5685,5685,4997,4910,4457
42696,1816,9924,15005,27691,0,42696,9.89216e+12,60.0717,12857.9,42696,4829,72,35634,35634,32058,34440,29089
25925,2381,6221,24415,1510,24415,1510,4.09997e+18,98.1128,8392.8,25925,2937,111,24829,24829,24829,24829,24829
28407,3366,9296,28407,0,26757,1650,4.91844e+18,175.005,10651.7,28407,3403,125,23449,23449,21551,19825,19601
11875,527,666,0,11875,11530,345,3.89445e+16,19.9037,1714.45,11875,84,26,11209,11209,10967,10968,9106
35757,13065,13131,13413,22344,0,35757,8.17012e+12,57.9048,15299.7,35757,6386,72,35038,35038,35038,35038,35038
12243,18,274,12243,0,12243,0,5.64104e+18,147.749,831.313,12243,265,29,11508,9078,2259,4203,3409
17778,3770,4209,16739,1039,16739,1039,3.35094e+18,97.4272,5869.84,17778,2020,110,34006,34006,21024,13099,10324
42151,3277,9799,14815,27336,0,42151,9.88575e+12,60.0578,12703.1,42151,4766,72,41061,41061,41061,41061,41061
31419,1254,9873,29769,1650,29769,1650,5.09686e+18,97.055,12195.9,31419,4701,111,25233,23137,12283,11416,2866
14398,3331,5884,14398,0,13653,745,5.11725e+18,122.22,6717.38,14398,2341,120,8514,8491,7032,7686,5706
15101,150,638,0,15101,14669,432,3.55827e+16,20.0921,1763.4,15101,82,26,16920,16297,15061,15013,14290
26899,157,176,26820,79,26899,0,5.98268e+18,169.515,1943.97,26899,165,161,20578,20555,5367,1009,787
14273,61,3926,13476,797,0,14273,2.12394e+18,96.6595,5280.45,14273,1893,110,15207,4150,6546,1103,1498
44356,3208,11935,41896,2460,41896,2460,6.26862e+18,97.3089,15197.6,44356,5794,110,34348,34348,29256,26635,8383
34542,6,8,34014,528,34478,64,9.62207e+13,3.99763,465.311,34542,6,4,34534,34534,34533,34533,33860
13605,162,3263,12811,794,0,13605,2.22608e+18,97.1576,4617.19,13605,1570,110,13218,13088,12759,12692,12682
28903,61,208,28812,91,28903,0,6.13979e+18,198.976,2272.26,28903,167,166,28806,28785,0,5220,5
3545,1,11,3439,106,3541,4,1.88894e+14,9.86996,176.6,3545,11,11,572,572,572,572,572
1090,28,338,0,1090,0,1090,6.80563e+17,85.7752,537.879,1090,146,46,336,40,177,177,100
24170,12635,14272,23410,760,23410,760,1.0967e+19,90.8984,15585.7,24170,6913,110,23774,23774,23774,23774,23774
30833,792,7250,29039,1794,0,30833,2.22647e+18,97.7195,9787.48,30833,3510,110,27353,27353,21137,18177,4197
49847,10052,13168,0,49847,17790,32057,2.42498e+15,57.5731,16390.9,49847,6392,72,35264,35264,31582,33290,27588
2387,484,1038,2387,0,1669,718,3.52052e+18,77.9912,1307.57,2387,376,65,1349,1349,1082,1184,1038
5334,1399,2601,2110,3224,0,5334,6.6876e+12,55.1652,3037.54,5334,1256,68,2733,2733,2205,2623,1490
27972,3665,9448,26562,1410,26562,1410,2.98071e+18,95.001,11558.3,27972,4561,110,18524,18524,14784,16370,8460
26582,10549,13219,0,26582,0,26582,3.42985e+15,17.9793,13686.9,26582,11890,20,19839,19839,15575,13867,11848
10692,10,11,10383,309,10684,8,1.51452e+14,10.4093,295.459,10692,11,11,10647,10579,10346,10347,10054
28284,173,176,28265,19,28284,0,6.0666e+18,171.98,2079.29,28284,156,161,28120,28120,28120,28120,28120
1949,17,232,0,1949,1888,61,5.3313e+16,15.0298,527.326,1949,42,24,1689,1556,826,1102,196
8042,2104,2584,7622,420,7622,420,3.23449e+18,95.6036,3425.81,8042,1219,100,5458,5458,5317,5454,5437
18677,7634,10400,0,18677,7630,11047,1.46672e+15,54.7821,11392.2,18677,5056,72,35246,35246,29088,23915,21623
42556,1010,21759,40976,1580,40976,1580,7.86164e+18,93.104,24064.9,42556,10562,110,20797,20075,2632,15661,1900
23640,957,997,4925,18715,0,23640,5.85893e+13,11.9918,1498.57,23640,993,13,25081,25081,12526,19667,4377
31624,3235,8357,0,31624,11292,20332,2.42906e+15,59.5328,10576.1,31624,4065,72,30769,30251,19538,19098,8541
27104,1103,6411,0,27104,0,27104,6.44788e+17,97.5987,8706.51,27104,3090,110,20693,20693,9411,4672,4804
6887,1415,2404,6887,0,6489,398,3.99048e+18,91.6277,2964.54,6887,859,104,4483,4483,3397,3893,2971
27546,9,15,26722,824,27485,61,1.9281e+14,10.4113,572.3,27546,13,11,4142,1325,944,1074,244
7371,13,175,7371,0,7371,0,5.9821e+18,160.07,1020.36,7371,117,117,2194,340,472,494,524
5031,1374,1781,0,5031,1864,3167,2.16069e+15,57.2095,2274.9,5031,862,69,3250,3250,2654,2004,2108
6547,488,1594,6167,380,6167,380,5.71931e+18,96.0516,2387.97,6547,758,95,4953,4953,4281,4055,1939
23100,6727,8465,8651,14449,0,23100,8.16172e+12,57.8402,10001.5,23100,4117,72,36608,36608,36608,36608,36608
23117,7834,8553,21997,1120,21997,1120,2.78261e+18,96.0523,10277.9,23117,4090,111,14564,14564,13848,14512,12864
22997,1431,6639,8295,14702,0,22997,9.17064e+12,59.0744,8316.45,22997,3227,72,16358,16358,8745,14014,3205
38334,677,2455,7813,30521,0,38334,5.72808e+13,12.0034,3096.5,38334,1522,20,29261,29261,22664,23782,3476
8774,213,371,0,8774,8523,251,3.54129e+16,19.9761,1059.62,8774,58,26,8403,8403,7481,7552,5518
18226,77,1071,0,18226,17689,537,4.6316e+16,217.9,3071.15,18226,161,26,16804,16652,13374,10407,2470
19160,2676,4966,18070,1090,18070,1090,5.82269e+18,97.668,6659.89,19160,2349,111,9027,9027,5256,6089,1984
13799,1842,7944,0,13799,0,13799,3.63008e+17,91.7595,8837.72,13799,3845,107,5855,5855,3908,2726,2385
32079,101,10099,30409,1670,30409,1670,3.11634e+18,96.4601,12505.9,32079,4894,110,22396,4933,6850,13560,312
11055,1998,4107,0,11055,4150,6905,2.08458e+15,55.4,4977.07,11055,1978,72,6948,6948,6093,4896,4846
14712,986,3469,0,14712,5180,9532,2.53182e+15,59.8233,4719.38,14712,1685,72,11243,11243,7664,3161,3469
37308,16,176,37243,65,37308,0,6.07962e+18,171.913,2388.32,37308,166,168,20320,15594,15982,15690,14413
43410,19219,21261,0,43410,9525,33885,1.33682e+13,8.99516,21696.4,43410,19127,11,23740,23740,23739,23740,23572
2184,30,1294,2184,0,2104,80,4.21427e+18,87.2308,1506.27,2184,548,57,393,40,149,154,57
12128,4,12,11760,368,12114,14,2.05002e+14,10.0794,333.581,12128,12,11,10680,9565,7691,7632,4344
22113,6038,9989,22113,0,21103,1010,4.79844e+18,220.272,11204.6,22113,4396,127,35935,35935,35935,35935,35935
19103,3658,4481,0,19103,6708,12395,2.52654e+15,59.8817,6015.95,19103,2177,72,14622,14622,13618,12714,12112
28326,2921,8743,28326,0,26676,1650,3.96171e+18,177.655,10299.6,28326,2652,132,19583,19386,12988,15069,6855
9614,4026,4444,9214,400,9214,400,2.67063e+18,93.3193,5261.86,9614,2144,97,13407,13405,10864,13260,6154
39031,8521,20241,0,39031,0,39031,4.07822e+17,93.0981,22375.1,39031,9820,110,40523,40523,40523,40523,40523
42413,331,1323,0,42413,41196,1217,3.75315e+16,267.261,4480.24,42413,213,26,42741,42192,32247,32588,18410
36146,831,11615,36146,0,34036,2110,4.43565e+18,253.3,13228.1,36146,2603,133,21087,20227,12840,5617,3965
41792,2602,13423,0,41792,15344,26448,2.23693e+15,58.6443,16031.9,41792,6525,72,36386,36386,33482,34801,30868
11690,4647,7122,4880,6810,0,11690,5.0853e+12,52.1769,7758.59,11690,3463,72,44535,44535,44535,44535,44535
39347,4461,9193,0,39347,0,39347,6.47832e+17,97.8354,12275,39347,4449,110,30154,30154,23727,18533,15866
22610,3679,7417,22610,0,21292,1318,3.71301e+18,157.564,8589.96,22610,2696,124,15193,37793,33468,35284,30375
11952,600,3361,0,11952,4301,7651,2.37989e+15,58.9848,4379,11952,1631,72,15117,14933,14233,13711,11425
10642,1,11,10340,302,10635,7,1.39071e+14,10.5569,287.815,10642,11,11,2727,2727,2727,2727,2727
42042,7875,9806,39592,2450,0,42042,2.22952e+18,97.864,13051.6,42042,4752,110,29359,29359,23515,20910,13723
31228,7029,7348,29411,1817,29411,1817,5.76724e+18,97.7192,9912.13,31228,3554,110,41702,41702,41702,41702,41702
7847,6076,7847,0,7847,7847,0,2047.74,0,7847,7847,7847,1,0,0,0,0,0
36138,5208,8662,34031,2107,34031,2107,1.25453e+18,98.3134,11464.8,36138,4103,111,32543,32543,32543,32543,32543
45910,2406,14643,45910,0,43240,2670,4.62319e+18,320.997,16561.3,45910,3065,137,41439,41439,38781,41009,35591
26831,158,200,26752,79,26432,399,5.98257e+18,180.799,2006.04,26831,161,169,20870,20362,16788,16045,12419
14487,3464,4629,0,14487,5310,9177,2.26098e+15,58.4874,5755.77,14487,2254,72,14385,14385,14385,14385,14385
7818,5,13,7594,224,7758,60,1.38289e+14,10.9202,268.047,7818,12,12,7216,6485,5175,5298,3992
29899,12056,14070,0,29899,0,29899,4.50465e+17,94.0196,15937.2,29899,6835,110,15806,15806,0,0,0
19533,885,5071,18433,1100,0,19533,2.15973e+18,97.0685,6818.43,19533,2438,110,14462,14462,9568,8696,3763
13634,4703,4706,0,13634,5058,8576,2.16863e+15,57.4938,5757.3,13634,2270,72,12338,12338,12338,12338,12338
3404,764,863,3204,200,0,3404,2.24222e+18,94.3299,1354.94,3404,399,73,2541,15685,15449,15454,15432
5870,1314,1462,0,5870,2072,3798,2.49389e+15,58.737,2078,5870,706,72,21953,26695,16820,4458,4419
12126,4297,5667,12126,0,11576,550,6.02917e+18,119.643,6439.28,12126,2357,122,6459,6459,5630,6196,4199
31413,654,11522,29891,1522,29891,1522,2.80387e+18,96.227,13706.7,31413,5510,111,21108,19575,15927,13373,2553
2180,872,946,839,1341,0,2180,7.66113e+12,54.6505,1190.09,2180,454,61,1234,1234,1153,1215,1131
16901,4,11,16420,481,16897,4,1.38864e+14,10.0807,362.58,16901,11,11,14618,12931,13063,11677,8633
47777,7309,22114,0,47777,0,47777,4.54318e+17,92.8317,24829.7,47777,10742,110,33612,33465,27957,29739,22938
43149,629,13798,43149,0,40639,2510,4.29568e+18,303.851,15631.9,43149,5125,129,20630,20630,5399,6577,4216
37669,11071,16227,36039,1630,36039,1630,8.77598e+18,94.206,18588.7,37669,7864,110,32083,32083,32083,32083,32083
19469,2279,6934,18509,960,18509,960,3.96632e+18,96.1305,8478.02,19469,3309,111,17826,17826,13029,15530,7897
29550,21,939,0,29550,28707,843,3.55777e+16,183.9,3008.11,29550,136,26,9992,1361,598,3391,1462
48598,1834,11375,0,48598,0,48598,6.47055e+17,97.8789,15014.2,48598,5511,110,48363,48363,48363,48363,48363
43193,34,208,43104,89,42810,383,6.01084e+18,202.606,2668.63,43193,182,184,16678,2479,8573,12988,3393
15916,3123,3806,14996,920,0,15916,2.22252e+18,97.1958,5333.95,15916,1820,110,30996,30996,30103,29838,15241
16185,2,11,15709,476,16171,14,1.70798e+14,10.077,373.046,16185,11,11,9419,7232,5526,7273,4671
37689,4080,12150,35732,1957,35732,1957,3.72124e+18,97.0116,14796.8,37689,5798,111,21195,22665,18077,12705,11419
13188,10,11,12805,383,13181,7,1.58666e+14,10.1598,332.972,13188,11,11,13159,13140,12882,12883,12048
11102,1592,3324,10501,601,10501,601,2.04759e+18,96.5246,4406.95,11102,1564,111,7778,7778,6731,7160,5226
49123,11949,13569,0,49123,17651,31472,2.38986e+15,59.409,16708.5,49123,6608,72,48833,48833,48833,48833,48833
36922,2630,11917,36922,0,34832,2090,3.67095e+18,253.698,13798.3,36922,4754,128,25325,24928,14192,18879,7575
41225,8356,10196,0,41225,14592,26633,2.47953e+15,59.8041,13002.3,41225,4952,72,35096,35096,35096,35096,35096
40515,981,1161,0,40515,39359,1156,3.58305e+16,240.636,3951.63,40515,180,26,31263,31263,17997,22518,10887
29529,13717,19135,26169,3360,26169,3360,6.10209e+17,6.5244,21977,29529,6389,14,19410,19410,19410,19410,19410
28126,9689,11278,0,28126,10719,17407,1.9788e+15,53.9132,12997,28126,5477,72,23579,23579,23579,23579,23579
48766,24,176,48688,78,48766,0,5.98217e+18,171.901,2616.47,48766,172,171,14283,5717,6302,8293,5144
25143,6710,7226,0,25143,0,25143,6.03569e+17,96.7586,9281.17,25143,3494,110,17917,17917,17244,16568,16735
36370,9264,18385,7944,28426,0,36370,52469600000,8.98103,18776.1,36370,16539,11,28745,28745,28745,28745,28745
35923,590,1309,0,35923,34888,1035,3.95201e+16,267.141,4260.86,35923,209,26,22850,22226,9383,18091,1193
46996,1554,17290,44736,2260,44736,2260,3.01572e+18,95.7585,20331.6,46996,8395,110,46506,46506,46506,46506,46506
4716,85,257,0,4716,4579,137,3.82749e+16,19.0937,704.488,4716,45,26,4459,4459,3281,3307,1348
31260,5150,14188,31260,0,29813,1447,4.83241e+18,286.207,15588.4,31260,4567,135,17072,16875,12760,14567,7795
1423,587,1059,1423,0,1383,40,4.40515e+18,54.3675,1168.75,1423,468,47,364,326,326,33178,32732
3044,9,11,2950,94,3043,1,2.20723e+14,8.11334,161.407,3044,10,10,1628,193,262,264,327
9985,845,4312,9985,0,9485,500,4.49869e+18,111.371,4964.18,9985,1340,123,0,0,0,0,12276
1122,114,369,1062,60,0,1122,2.17016e+18,84.0882,572.329,1122,145,45,753,354,479,421,308
31026,2396,7884,29266,1760,0,31026,2.17062e+18,97.462,10389.2,31026,3821,110,30849,30849,30849,30849,30849
39309,4807,12613,39309,0,37019,2290,3.60999e+18,278.664,14327.4,39309,4675,128,33307,33307,31925,31234,30556
4382,37,196,0,4382,4259,123,3.52724e+16,19.8104,573.395,4382,42,26,4186,4186,3488,3548,1324
1477,1,10,1433,44,1477,0,2.1306e+14,7.77048,111.132,1477,10,10,173,173,173,173,173
45558,13,15,44252,1306,45501,57,1.4825e+14,10.5633,696.612,45558,13,11,29001,26389,26271,26280,25740
40787,64,1900,0,40787,39582,1205,4.59514e+16,318.319,6108.47,40787,328,26,32632,26643,26595,23011,18975
13361,60,175,13355,6,13361,0,5.9862e+18,163.965,1369.22,13361,141,140,43906,43647,28342,27735,7377
21699,6432,11956,20956,743,20956,743,1.05011e+19,92.2852,13254.8,21699,5786,110,9743,9743,9343,9343,5257
41864,5581,9818,39424,2440,0,41864,2.22866e+18,97.8626,13044.9,41864,4764,110,40453,40453,40453,40453,40453
32412,1045,1121,0,32412,31480,932,3.78696e+16,234.707,3626.58,32412,173,26,17654,17654,9022,17416,8192
13300,2762,6194,0,13300,5208,8092,1.76548e+15,55.7005,7077.52,13300,2995,72,8048,8048,5976,5419,3466
2054,1219,1324,1994,60,1994,60,2.25446e+18,85.1217,1523.41,2054,623,49,730,0,3739,3736,3741
9381,307,2306,0,9381,0,9381,6.40773e+17,96.4934,3333.61,9381,1097,110,26492,25645,15543,13213,2639
43797,15800,19710,41955,1842,41955,1842,5.2929e+18,95.0861,22240.2,43797,9485,111,35609,35609,35609,35609,35609
24018,5465,5631,22618,1400,0,24018,2.23046e+18,97.6277,7727.71,24018,2719,110,18387,18387,18185,18201,18153
15469,4477,8390,15469,0,9924,5545,5.71396e+18,197.062,9201.4,15469,3452,123,7079,7041,5901,6686,4403
30448,4444,7203,0,30448,10727,19721,2.52285e+15,59.9711,9418.8,30448,3509,72,13961,13961,8982,13862,5419
6058,1421,2058,0,6058,0,6058,5.72653e+17,94.3325,2735.33,6058,978,88,4000,4000,3201,2421,2629
3024,1036,1061,0,3024,0,3024,5.73604e+17,91.8056,1467.85,3024,495,71,1963,1963,1955,1958,1963
26999,7132,11736,0,26999,0,26999,4.80303e+17,93.8974,13552.6,26999,5695,110,35227,35227,30080,26925,23324
6922,87,170,6917,5,6922,0,5.97222e+18,158.499,979.955,6922,115,112,5818,3447,3269,3455,3410
3640,109,266,0,3640,3531,109,4.24823e+16,19.4959,674.383,3640,49,26,3374,3366,2785,2866,1721
44240,6,176,44156,84,44240,0,6.01121e+18,172.817,2546.78,44240,174,172,5129,1079,270,738,15
30527,6911,16715,12425,18102,0,30527,5.84212e+12,54.2959,18185.9,30527,8120,72,13812,13812,10690,13282,7160
4250,278,1041,0,4250,1490,2760,2.50684e+15,58.5668,1529.31,4250,495,68,3209,3209,1691,1201,953
35191,2193,9621,0,35191,12618,22573,2.40111e+15,59.4025,12013.1,35191,4686,72,35034,35034,35034,35034,35034
43342,4242,17596,43342,0,41232,2110,4.73585e+18,467.446,19710.5,43342,5596,141,36854,36854,34882,35776,32310
16953,694,4317,0,16953,6021,10932,2.4792e+15,59.5765,5682.19,16953,2103,72,32924,32924,20330,17628,4054
38778,2254,19017,38778,0,38778,0,2.54251e+18,17.9781,19589.6,38778,17100,20,19761,19761,3128,19761,2375
41573,84,176,41494,79,41573,0,5.98547e+18,169.75,2413.95,41573,169,171,34509,29648,8690,5215,804
16679,5279,6299,0,16679,6284,10395,2.05949e+15,55.9262,7478.42,16679,3050,72,10380,10380,9869,9523,9192
3932,227,996,3702,230,3702,230,5.85182e+18,94.5346,1538.48,3932,461,80,2936,2936,2645,2471,965
6802,2665,3813,2772,4030,0,6802,5.74344e+12,54.1935,4277.57,6802,1852,71,2989,2989,2876,2959,2821
26869,36,176,26854,15,26869,0,6.02092e+18,170.762,1998.29,26869,162,161,45028,44933,27938,27724,7798
35945,277,10168,33972,1973,33972,1973,3.29516e+18,96.2191,12835,35945,4828,111,25777,25520,11451,13609,2546
6312,1480,3153,6312,0,6039,273,6.24659e+18,70.7739,3635.19,6312,1335,95,3159,3159,3075,3132,3065
43204,3113,23251,43204,0,43204,0,7.6293e+17,17.9501,23823.4,43204,20913,20,43061,43061,43061,43061,43061
47461,3196,11213,0,47461,16710,30751,2.5194e+15,60.0265,14402.8,47461,5456,72,36840,36840,34937,34032,14430
9719,958,4199,9291,428,9291,428,8.54393e+18,93.8268,5054.51,9719,2027,99,5520,5434,4768,4644,2086
25647,9502,10221,24470,1177,24470,1177,8.28275e+18,95.0464,12052.6,25647,4961,110,15426,15426,15316,15316,33900
44738,7226,10444,15724,29014,0,44738,9.87089e+12,60.0672,13492.3,44738,5083,72,40006,40006,40006,40006,40006
32921,5428,8623,31071,1850,0,32921,2.14916e+18,97.3527,11222,32921,4176,110,21521,21521,20290,20695,18149
10992,105,176,10923,69,10992,0,6.04146e+18,166.496,1285.33,10992,128,127,32380,21857,16853,17788,17697
39368,426,9210,0,39368,13848,25520,2.52924e+15,60.0529,11952.3,39368,4482,72,30158,30158,8610,2022,1897
48141,179,206,48061,80,48141,0,5.98433e+18,193.133,2702.32,48141,184,186,47962,47962,47962,47962,47962
3919,1126,2383,0,3919,1630,2289,1.33141e+15,42.7349,2673.29,3919,1138,63,1536,1536,1132,811,859
8740,899,3739,8350,390,8350,390,8.60765e+18,93.6374,4533.5,8740,1804,103,5001,4915,2785,4697,1659
9551,11,12,9277,274,9545,6,1.39426e+14,10.2185,274.191,9551,12,11,9539,9539,9490,9491,9451
32805,1541,1738,0,32805,31827,978,4.8269e+16,306.893,5423.49,32805,294,26,32611,32611,32611,32611,32611
39970,8707,11580,0,39970,14448,25522,2.34968e+15,59.1648,14185.6,39970,5641,72,30839,30839,30153,30323,30070
34005,8229,9667,32138,1867,32138,1867,4.11266e+18,97.5752,12218.1,34005,4601,111,30888,30888,28797,28435,26604
41145,536,1155,0,41145,39970,1175,3.56059e+16,242.098,3952.75,41145,180,26,40246,40025,37045,37524,33067
11505,79,192,11461,44,11432,73,6.1168e+18,170.867,1357.74,11505,125,124,9475,6692,4822,5042,4724
9544,1723,3098,9051,493,0,9544,1.98453e+18,95.2433,4056.64,9544,1480,106,6446,6446,4588,4211,2573
26936,7223,11162,10330,16606,0,26936,7.56669e+12,57.1274,12791.5,26936,5432,72,18581,18581,18230,18570,16599
18620,6920,7976,0,18620,7184,11436,1.8915e+15,55.9284,9178.37,18620,3863,72,10644,10644,9654,9840,8672
31806,4012,7437,11180,20626,0,31806,9.87917e+12,60.005,9740.92,31806,3617,72,25048,25048,21954,17739,16935
47919,15676,16077,0,47919,0,47919,5.62141e+17,96.0153,19293.8,47919,7807,110,28497,28497,25832,26235,24773
31635,3437,16538,31635,0,31635,0,2.95849e+18,17.9787,17035.5,31635,14875,20,20740,31304,0,5287,6089
8206,1732,4609,8206,0,0,8206,8.95419e+17,17.6204,4839.51,8206,4140,20,3597,3597,1405,1919,1410
37199,22,61,37135,64,37199,0,2.33275e+18,60.7892,1436.27,37199,61,61,36338,36175,27598,29591,10943
49635,1518,1634,0,49635,48200,1435,3.92321e+16,296.798,5576.77,49635,274,26,49591,49591,49591,49591,40140
41595,1051,1162,0,41595,40410,1185,3.55949e+16,243.693,3987.16,41595,181,26,37760,37760,14333,12112,5749
25780,735,1001,0,25780,25035,745,3.84494e+16,203.781,3088.11,25780,148,26,24779,24779,24074,24003,21109
28051,4639,9971,28051,0,26540,1511,5.22526e+18,222.783,11496,28051,2807,133,28516,28516,26932,27015,10432
22775,204,7197,8330,14445,0,22775,8.80042e+12,58.2461,8810.45,22775,3490,72,15578,15402,5221,10633,374
49075,135,176,48998,77,49075,0,5.99179e+18,173.484,2650.58,49075,173,174,24105,23535,4088,3477,2648
40941,814,1457,0,40941,39754,1187,3.98173e+16,287.093,4831.82,40941,239,26,28916,28834,19513,20922,8593
19543,8,14,18983,560,19470,73,1.38757e+14,10.6289,415.225,19543,14,12,0,0,177,152,179
40688,1792,9550,38320,2368,38320,2368,5.88957e+18,97.865,12708,40688,4630,110,44543,44543,44543,44543,44543
37468,181,1083,0,37468,36399,1069,3.55365e+16,225.963,3645.16,37468,165,26,36176,35918,24858,24825,11758
49367,5351,17113,0,49367,0,49367,5.5242e+17,94.464,20364.1,49367,8299,110,49140,49140,49140,49140,49140
14233,11,13,13826,407,14167,66,1.39146e+14,10.8286,356.066,14233,13,12,12378,4118,1835,837,426
19197,86,813,0,19197,18647,550,3.75209e+16,127.565,2341.62,19197,110,26,18305,18228,15211,14655,5220
23156,2564,8962,0,23156,0,23156,5.19172e+17,95.1886,10685.2,23156,4336,110,14194,14194,9891,5798,5135
18389,2829,4315,6465,11924,0,18389,9.88303e+12,59.8723,5804.24,18389,2092,72,14074,14074,12282,13697,9391
47441,7357,23552,45622,1819,45622,1819,2.4587e+18,92.1315,26116.4,47441,11438,110,42440,42440,42440,42440,42440
28833,3359,8459,0,28833,0,28833,5.98386e+17,90.0955,10730.1,28833,4095,110,26771,26316,16011,19995,8253
6143,2628,2824,5883,260,5883,260,2.82641e+18,87.4622,3416.03,6143,1321,85,3319,3319,3319,3319,3319
3255,723,833,3065,190,0,3255,2.2365e+18,93.9124,1307.94,3255,381,72,2422,2422,2297,2309,2313
31975,891,16804,31975,0,20440,11535,4.82322e+18,557.903,18356.1,31975,6375,139,31797,31797,31797,31797,3090
28211,1671,12772,10998,17213,0,28211,7.0643e+12,56.0345,14374.5,28211,6201,72,29073,29073,18097,25283,2547
14297,73,3381,5032,9265,0,14297,9.90953e+12,59.8151,4599.84,14297,1646,72,10916,7672,6128,10089,410
48006,167,176,47882,124,48006,0,6.13573e+18,172.359,2711.39,48006,172,169,47846,47846,47846,47846,47846
20278,158,920,0,20278,19692,586,3.98559e+16,191.14,2686.08,20278,130,26,19221,19088,13012,12700,4943
40211,15217,17084,0,40211,15492,24719,1.9031e+15,57.0229,19291.3,40211,8322,72,40091,37298,37298,37298,37298
32536,13267,13968,31114,1422,31114,1422,7.91883e+18,94.8346,16041.9,32536,6705,111,32081,32081,32081,32081,32081
20625,304,1299,0,20625,20011,614,4.99599e+16,265.972,3790.27,20625,206,26,16136,16012,12283,13867,10049
4794,514,1662,4794,0,4513,281,5.90634e+18,90.82,2115.3,4794,585,92,10247,11828,0,5431,2049
7900,843,1860,0,7900,2772,5128,2.56372e+15,59.5318,2636.38,7900,906,72,6040,6040,4634,3876,2887
39757,3200,13557,31294,8463,37750,2007,3.0175e+18,96.7557,16256.5,39757,6482,111,28508,28312,23874,25871,20750
13461,158,3997,12731,730,12731,730,3.97788e+18,96.7446,5249.73,13461,1892,111,9464,9294,3780,5822,1224
49807,3203,20073,18999,30808,0,49807,7.69556e+12,57.3663,22781.6,49807,9769,72,40997,40997,31323,29616,23108
23512,698,5865,0,23512,0,23512,6.35186e+17,97.3286,7896.85,23512,2828,110,22230,22224,21563,21506,19215
5597,530,1529,5277,320,5277,320,5.22925e+18,94.3509,2208.74,5597,706,94,7716,7630,5120,4565,2091
23140,2264,8863,0,23140,0,23140,5.24321e+17,93.7793,10591.6,23140,4282,110,22582,22582,22582,22582,22582
48664,5061,15684,46135,2529,46135,2529,3.07112e+18,97.1189,18912.7,48664,7500,111,48074,48074,48074,48074,48074
35015,8359,10694,35015,0,32975,2040,3.47901e+18,244.635,12522.8,35015,4172,128,24321,24248,21916,22675,19932
31884,31,176,31819,65,31884,0,6.19592e+18,172.25,2187.44,31884,152,156,15398,8317,11782,10988,7944
12851,1343,4375,0,12851,0,12851,5.63003e+17,95.5142,5547.44,12851,2107,110,8476,8476,6054,5373,15739
32374,4296,12754,30883,1491,0,32374,1.76585e+18,93.8712,14958.2,32374,6173,110,21897,21897,14065,17182,11041
41098,9458,19189,39428,1670,39428,1670,9.29831e+18,92.9918,21587.5,41098,9325,110,44916,44916,44916,44916,44916
44980,195,206,44959,21,44980,0,5.98039e+18,193.581,2613.28,44980,189,181,31240,30699,12596,18996,907
5133,155,238,0,5133,4987,146,3.58674e+16,19.7871,679.307,5133,46,26,4895,4895,4698,4724,3485
47933,7035,11181,0,47933,16850,31083,2.52934e+15,60.0676,14405.3,47933,5443,72,46464,46464,46464,46464,46464
14854,3126,3732,0,14854,5258,9596,2.47358e+15,59.4917,4971.36,14854,1804,72,11122,11122,10381,9944,9651
18641,2620,4532,17561,1080,17561,1080,5.80616e+18,97.818,6218.31,18641,2131,111,36792,36792,19112,12626,8959
6775,1289,1669,6375,400,6375,400,3.59725e+18,96.8443,2470.14,6775,782,97,5106,5106,4727,5079,4329
44272,5104,22022,42579,1693,42579,1693,9.62348e+18,93.5717,24448,44272,10708,110,22250,22250,23038,22553,9671
4118,974,1043,3877,241,3877,241,3.31056e+18,94.6935,1603.6,4118,476,82,19017,20597,11339,2940,3167
1271,101,346,446,825,0,1271,1.04631e+13,55.8906,543.179,1271,167,47,925,856,572,861,319
26763,1022,6256,0,26763,0,26763,6.48825e+17,97.7044,8537.3,26763,3023,110,20507,20507,13382,6531,4606
4092,1074,1091,3858,234,0,4092,2.19256e+18,94.391,1641.68,4092,510,80,3001,3001,2991,2994,3001
43024,2,12,41798,1226,43005,19,1.38991e+14,10.3319,590.618,43024,12,11,4427,3075,3077,3223,3096
2155,157,170,2155,0,2155,0,5.97994e+18,136.047,547.858,2155,71,71,1980,1946,1887,1884,1879
33838,3342,13677,0,33838,0,33838,5.04944e+17,94.0292,15927.2,33838,6639,110,20161,26833,19530,13822,11838
46409,10461,10802,0,46409,0,46409,6.48985e+17,97.9043,14313.7,46409,5242,110,46232,46232,46232,46232,46232
34935,868,15931,33485,1450,33485,1450,9.12978e+18,93.6369,18079.5,34935,7725,110,30061,29975,25886,25134,21014
42380,1937,9847,14893,27487,0,42380,9.899e+12,60.0717,12762.7,42380,4791,72,36450,36450,33890,33741,24701
24025,3350,5641,22625,1400,0,24025,2.23071e+18,97.5978,7734.98,24025,2719,110,36847,36847,25624,34752,11183
20624,2871,7104,7647,12977,0,20624,8.48238e+12,57.1866,8546.68,20624,3444,72,13520,13520,9926,12618,6478
35678,4168,14734,23751,11927,34070,1608,5.32523e+18,94.9008,17006.3,35678,7061,111,29140,29140,25881,24338,22495
4216,424,1750,4216,0,3997,219,3.45721e+18,91.8397,2162.58,4216,705,80,2466,2374,1369,1766,999
12977,7,12,12593,384,12965,12,1.82611e+14,9.96409,339.541,12977,12,11,12655,12451,10473,10373,10141
25896,5333,8566,24566,1330,24566,1330,2.83681e+18,96.1034,10535.9,25896,4091,111,20182,20182,20050,20171,19959
27729,4452,6480,26111,1618,0,27729,2.23133e+18,97.7159,8821.58,27729,3133,110,35223,35223,26671,31375,15985
19618,3604,8671,0,19618,7605,12013,1.84334e+15,56.4967,9897.59,19618,4202,72,10947,10947,7791,3956,4165
24475,6179,6884,23135,1340,0,24475,2.09587e+18,96.5846,8909.59,24475,3329,110,17591,17591,39135,39125,39185
18336,358,959,0,18336,17800,536,4.25759e+16,187.05,2743.89,18336,140,26,33727,33727,33727,33727,33727
10666,116,175,10664,2,10666,0,5.99041e+18,162.808,1224.77,10666,132,132,9850,8917,6975,7114,7199
1680,349,1680,1680,0,1680,0,2.25046e+15,0,1680,1680,1680,1,0,0,0,0,0
44594,7141,10378,41994,2600,0,44594,2.23125e+18,97.9197,13783,44594,5034,110,44186,44186,44186,44186,44186
527,386,527,527,0,527,0,1.04855e+19,0,527,527,258,21,0,0,0,11253,11253
12985,150,175,12979,6,12985,0,5.99546e+18,163.772,1349.86,12985,135,142,12626,12169,11189,11164,11141
3639,125,951,3426,213,3426,213,3.14983e+18,94.6227,1455.84,3639,426,78,2688,1310,1194,1592,437
30681,4969,9451,29068,1613,29068,1613,3.21219e+18,96.5451,11792,30681,4578,110,24607,24607,23381,24432,8560
26959,756,1156,0,26959,5622,21337,1.49965e+16,12.0049,1699.28,26959,676,19,25803,25803,22265,19590,24209
48849,5,15,47446,1403,48758,91,1.48577e+14,10.4227,697.362,48849,13,13,45280,41016,34305,34414,25411
49931,3993,15999,0,49931,0,49931,5.74786e+17,96.5405,19378.6,49931,7770,110,37988,37988,28064,18577,15876
10338,2675,4088,9858,480,0,10338,1.7776e+18,83.5295,5028.45,10338,1950,105,6250,6250,5952,5929,5830
25876,6062,8990,24587,1289,24587,1289,7.55081e+18,94.6478,10952.9,25876,4355,110,18093,18093,15549,14939,12836
42210,1399,2055,0,42210,40960,1250,4.73607e+16,319.317,6608.36,42210,355,26,40450,40450,40034,40003,37317
39806,1220,9300,37488,2318,0,39806,2.22849e+18,97.8415,12405.7,39806,4506,110,27892,27892,16513,20490,14654
2949,560,2949,2949,0,2949,0,8.79311e+12,0,2949,2949,2949,1,0,0,0,0,0
34840,6233,9679,32910,1930,32910,1930,5.52579e+18,97.6875,12295,34840,4602,111,29787,29787,29787,29787,29787
14378,476,4136,13598,780,0,14378,2.08271e+18,96.1256,5485.32,14378,1974,110,25382,25382,25382,25382,25382
7187,1276,1753,2528,4659,0,7187,9.92472e+12,59.3242,2471.22,7187,853,72,5434,5434,4957,5334,4340
31556,13,206,31480,76,31556,0,5.98216e+18,186.815,2176.01,31556,173,166,6501,798,200,397,33
48394,12,14,47015,1379,48313,81,1.3894e+14,10.5458,682.59,48394,13,12,28496,25791,25947,26148,24663
16796,6412,9455,0,16796,3609,13187,1.36732e+13,8.89724,9697.26,16796,8505,11,7341,14507,12367,14101,12138
45405,10,15,44090,1315,45313,92,1.59053e+14,10.4401,712.723,45405,13,12,9240,4274,3345,3607,3231
2553,404,1371,2453,100,2453,100,4.66187e+18,89.3373,1651.92,2553,643,61,1182,1095,537,677,705
19952,5147,7337,18982,970,18982,970,3.20192e+18,93.0891,8889.62,19952,3485,111,12615,12615,11165,12524,9388
46862,6237,10907,44131,2731,0,46862,2.23009e+18,97.9042,14443.9,46862,5292,110,36468,36468,32245,30851,27290
8779,1295,4466,8779,0,5784,2995,5.36651e+18,117.941,5027.05,8779,1893,108,4313,4274,2816,3432,1675
48432,4139,11766,17115,31317,0,48432,9.74934e+12,59.9109,14986.2,48432,5723,72,34130,34130,23582,25943,19386
25391,90,176,25377,14,25391,0,5.98444e+18,169.748,1889.67,25391,164,160,25185,24963,24978,24993,24982
13630,1188,3795,4897,8733,0,13630,9.34582e+12,57.7377,4924.99,13630,1842,72,43737,43737,43737,43737,43737
34115,10260,13115,32515,1600,32515,1600,2.8568e+18,95.2023,15436.9,34115,6351,110,21000,21000,19432,20581,17167
5234,1960,2416,5014,220,5014,220,2.70232e+18,84.0783,2946.65,5234,1135,87,2818,2818,2067,2407,1934
14119,1577,3346,4962,9157,0,14119,9.88439e+12,59.7448,4554.43,14119,1624,72,10773,10773,8463,10254,5092
18651,6179,7531,17801,850,17801,850,8.19974e+18,92.1159,8965.14,18651,3645,110,11120,11120,11096,11092,11114
24889,4320,5892,23441,1448,0,24889,2.224e+18,97.6167,8039.14,24889,2850,110,24261,24261,20685,19391,14865
25246,6405,15077,24466,780,24466,780,2.47453e+18,89.9077,16388.4,25246,7287,111,10169,10169,10160,10169,4984
1804,10,11,1751,53,1804,0,1.37617e+14,10.5255,118.197,1804,11,11,1780,1754,1732,1733,1675
35203,4343,20769,0,35203,0,35203,3.47825e+17,91.186,22515.2,35203,10077,110,26396,26396,21837,25443,14244
11255,1806,3302,9511,1744,10643,612,3.77637e+18,96.5676,4405.64,11255,1548,111,7953,7953,7137,7236,5897
24041,5028,5604,8448,15593,0,24041,9.92594e+12,59.9835,7442.94,24041,2730,72,28467,28467,28467,28467,28467
14484,371,3462,0,14484,0,14484,6.49371e+17,97.1848,4882.43,14484,1664,110,10187,10015,6589,5787,4766
22007,2140,8636,20987,1020,20987,1020,2.89918e+18,95.0615,10282.2,22007,4179,110,28995,28995,17257,26706,3125
22461,57,176,22387,74,22461,0,5.98363e+18,167.872,1786.19,22461,155,161,15219,7920,6296,7296,7416
23050,5,11,22393,657,23039,11,1.39211e+14,10.1959,425.181,23050,11,11,21130,18645,15130,15545,13555
29593,3047,13804,0,29593,0,29593,4.52626e+17,93.8824,15668.1,29593,6702,110,45178,45178,45178,45178,45178
24030,7381,8292,0,24030,0,24030,5.55861e+17,95.8594,10151.2,24030,4015,110,15738,15738,14506,14038,13296
49804,5791,11635,0,49804,0,49804,6.48139e+17,97.7756,15348.4,49804,5633,110,36635,0,0,0,0
37617,3,18,36492,1125,37510,107,1.95656e+14,10.5806,710.439,37617,15,12,13101,11105,10529,10578,10554
44615,7087,14426,16398,28217,0,44615,8.71799e+12,58.5479,17172.5,44615,7015,72,44186,44186,44186,44186,44186
44182,5098,20013,42342,1840,0,44182,1.59417e+18,94.3311,22602.6,44182,9724,110,37211,37211,34609,33612,30922
5414,341,374,1097,4317,0,5414,5.69984e+13,11.9594,604.515,5414,228,14,7823,7651,6262,3188,1445
44943,1,16,43645,1298,44858,85,1.55008e+14,10.3555,659.771,44943,14,13,10164,10164,10164,10164,10164
515,105,216,0,515,0,515,6.48413e+17,69.6058,314.953,515,80,36,299,146,202,204,193
13569,897,3197,12779,790,0,13569,2.23391e+18,97.1433,4558.38,13569,1533,110,15155,14811,8326,2571,2694
22722,704,711,0,22722,22012,710,0.0312472,0.968709,4018.19,22722,711,1,22011,22011,22011,22011,22011
5056,5,13,4909,147,5020,36,1.55992e+14,10.7848,217.244,5056,12,11,4669,4241,3883,3407,3004
34081,7088,7988,0,34081,0,34081,6.47775e+17,97.7944,10737.4,34081,3869,110,32307,32307,32307,32307,32307
14566,4,10,14149,417,14560,6,1.38979e+14,9.95222,333.843,14566,10,10,12603,11153,9355,9487,7248
11889,173,4814,0,11889,0,11889,5.05605e+17,83.8567,5841.61,11889,2304,110,7075,6878,4148,1110,446
32049,12,14,31137,912,31970,79,1.38933e+14,10.7577,556.682,32049,14,12,5459,848,340,711,272
24624,1,12,23905,719,24608,16,1.64365e+14,10.3585,467.293,24624,12,11,15800,15800,15800,15800,15800
25392,2,11,24667,725,25378,14,1.44252e+14,10.1707,451.497,25392,11,11,21078,20801,20015,20108,19919
9180,581,4951,9180,0,4244,4936,2.44506e+18,18.8964,5212.03,9180,2496,23,38157,37987,27414,28931,37353
16001,131,175,15993,8,16001,0,5.98556e+18,165.004,1497.78,16001,142,150,15237,14315,11915,12162,12088
47997,26,208,47901,96,47997,0,6.07333e+18,202.804,2900.19,47997,192,186,25319,9566,14732,9286,6665
8571,1270,2844,8131,440,0,8571,1.96704e+18,92.9858,3726.48,8571,1344,101,5727,5727,4368,4028,3225
14086,1473,3462,13267,819,13267,819,1.58293e+18,97.3549,4825.5,14086,1617,111,10624,10624,7864,9286,5264
17199,822,4040,0,17199,6047,11152,2.52814e+15,59.8824,5456.08,17199,1959,72,13159,13159,6279,4288,2959
27152,13556,13677,27152,0,26024,1128,5.60743e+18,253.92,14947.7,27152,3181,135,22760,22760,22760,22760,22760
10390,797,2454,9780,610,0,10390,2.24286e+18,96.986,3570.55,10390,1176,110,15137,15137,11986,11769,10138
26606,4040,6184,9350,17256,0,26606,9.89498e+12,60.0148,8185.37,26606,3004,72,18372,18372,17281,17942,13337
32827,3432,15057,12847,19980,0,32827,6.98499e+12,56.0234,16849.3,32827,7329,72,32561,32561,32561,32561,32561
49253,1200,1460,0,49253,47842,1411,3.73711e+16,278.1,5060.6,49253,241,26,28604,28266,7185,23855,8559
13659,3752,4039,12912,747,12912,747,2.32966e+18,96.8743,5304.27,13659,1910,111,39738,39738,39738,39738,39738
14671,3091,4921,14671,0,13820,851,4.28011e+18,120.09,5809.99,14671,1770,120,9750,9716,7752,8672,6511
41262,5955,9675,38862,2400,38862,2400,3.22522e+18,97.8725,12871.2,41262,4694,110,33032,33032,27533,30274,13175
27736,7434,12007,0,27736,0,27736,4.81585e+17,72.3455,13868.5,27736,5825,110,15729,15729,10563,5631,1892
5898,29,256,5898,0,5898,0,5.63992e+18,25.5439,572.828,5898,222,28,5642,5467,2049,3003,1606
24032,2275,5843,22637,1395,22637,1395,5.87848e+18,97.9963,7883.84,24032,2750,111,18189,18189,13008,14799,7996
35685,5660,14668,34085,1600,0,35685,1.71643e+18,93.9833,16992.4,35685,7121,110,31955,33658,0,0,0
13706,4164,6611,5419,8287,0,13706,6.69207e+12,53.2999,7494.07,13706,3206,72,26111,26111,20431,17383,7134
21089,3403,4974,0,21089,0,21089,6.4877e+17,97.5253,6867.3,21089,2396,110,16115,16115,14339,12215,11617
4515,287,302,918,3597,0,4515,5.73189e+13,11.957,511.783,4515,192,14,4213,4213,4099,4031,4161
42649,8953,14399,0,42649,15770,26879,2.18517e+15,58.4012,16998.4,42649,7009,72,42445,42445,42445,42445,42445
9076,588,3072,8616,460,8616,460,7.33892e+18,95.0158,3984.51,9076,1471,104,37179,36927,15859,29452,16613
46795,536,1627,0,46795,45442,1353,4.0024e+16,295.336,5482.29,46795,274,26,45945,45945,45772,45765,45390
42230,5,15,40996,1234,42165,65,1.64766e+14,10.4729,695.245,42230,13,11,35305,28807,19475,18290,6823
36356,6040,16736,14239,22117,0,36356,6.961e+12,55.3332,18675.7,36356,8147,72,19620,19620,13598,18590,6468
16922,10,13,16438,484,16854,68,1.44247e+14,10.7314,399.996,16922,12,12,6172,3218,3286,3161,2819
11545,2318,3920,8959,2586,10875,670,4.45683e+18,92.488,4681.86,11545,1405,118,7625,10669,8857,9497,7661
43971,189,206,43956,15,43971,0,5.98368e+18,193.696,2584.01,43971,187,180,28630,27452,23350,20421,11936
1121,371,422,1058,63,1058,63,4.44176e+18,84.9777,611.439,1121,181,46,699,699,654,671,685
42415,13720,14674,42415,0,40045,2370,4.06646e+18,307.669,16472.7,42415,5687,129,37592,37592,37592,37592,37592
45688,85,176,45606,82,45688,0,5.98303e+18,169.786,2530,45688,172,170,40533,36146,38168,35549,34129
40595,955,1878,0,40595,39397,1198,4.5764e+16,319.627,6052.24,40595,324,26,40731,40731,39596,39701,36183
35821,294,1565,0,35821,34771,1050,4.36055e+16,288.122,5010.79,35821,260,26,25421,25108,10471,16510,2604
44048,6587,10509,41478,2570,41478,2570,5.11608e+18,98.3805,13783.7,44048,4976,111,34487,34487,33489,33489,22577
7224,91,176,7216,8,7224,0,6.04893e+18,161.296,1049.23,7224,111,112,6192,4275,3602,3711,3730
47050,62,208,46984,66,46667,383,6.08154e+18,203.902,2879.68,47050,186,185,45668,45410,40008,37980,14077
25840,2,14,25081,759,25761,79,1.7077e+14,10.5063,530.465,25840,13,12,15322,11829,8081,8558,7886
49683,7998,11898,46785,2898,46785,2898,2.81302e+18,98.3965,15493.3,49683,5632,111,39659,39659,36898,34851,33805
8230,1285,2022,7750,480,7750,480,5.24637e+18,96.9843,2945.65,8230,946,106,4541,4188,3019,3809,2136
31431,6074,9133,29734,1697,29734,1697,6.55984e+18,96.8547,11564,31431,4422,110,31160,31160,31160,31160,31160
1515,10,91,0,1515,1471,44,3.7099e+16,19.1584,257.959,1515,30,26,1307,1196,1052,1066,355
12553,5677,6292,12073,480,12073,480,9.73457e+18,92.4069,7233.05,12553,3024,108,31360,31360,31360,31360,31360
975,204,975,975,0,975,0,34324500000,0,975,975,975,1,0,0,0,0,0
22240,497,8239,21171,1069,0,22240,1.83868e+18,95.4188,9940.67,22240,3990,110,14001,13488,8556,7414,2500
7486,2402,4038,1621,5865,0,7486,52999900000,8.96193,4203.29,7486,3625,11,3448,3448,2369,3448,2299
18503,355,927,0,18503,17962,541,4.16309e+16,187.616,2663.81,18503,134,26,17576,17294,15633,14754,7222
40032,6033,10401,0,40032,14260,25772,2.44114e+15,59.6071,13100.4,40032,5057,72,26234,25395,14478,16340,1022
31831,3308,10904,30241,1590,30241,1590,4.22692e+18,95.9415,13221.1,31831,5282,110,40815,40815,40815,40815,40815
24894,5335,9599,9408,15486,0,24894,7.91472e+12,57.5465,11190.4,24894,4668,72,15295,15295,12856,14785,8903
6512,1315,2263,0,6512,0,6512,5.64056e+17,94.5278,2973.16,6512,1082,99,4249,4249,3956,3464,3758
20900,2413,9178,20007,893,0,20900,1.64017e+18,92.3202,10668.6,20900,4432,110,11722,11722,7768,6810,3640
21546,7064,8138,0,21546,0,21546,5.28251e+17,95.2931,9787.2,21546,3937,110,19400,19400,19400,19400,19400
18884,160,12290,18374,510,18374,510,3.89644e+18,85.299,13256.7,18884,5921,115,15159,14996,12185,14649,8766
44725,5426,13574,42355,2370,42355,2370,6.7728e+18,95.5902,16733.2,44725,6573,110,44447,44447,44447,44447,44447
37307,8,12,36243,1064,37296,11,1.38825e+14,10.1745,544.932,37307,12,11,15794,12602,2959,6595,2235
47296,11292,14808,17291,30005,0,47296,8.84637e+12,58.7889,17722,47296,7200,72,39051,39051,39051,39051,39051
12428,2330,4340,11808,620,11808,620,7.33575e+18,95.3248,5473.04,12428,2089,110,8088,8088,7423,7311,5107
27059,10541,14039,0,27059,10875,16184,1.59084e+15,53.5735,15443.8,27059,6816,72,37382,37382,35982,35100,33943
985,105,281,351,634,0,985,1.03431e+13,54.2975,443.52,985,130,43,704,704,454,654,312
30662,901,13185,29322,1340,29322,1340,4.54174e+18,95.281,15166.7,30662,6333,111,17477,17137,5875,9690,1896
6180,2984,3603,6180,0,5547,633,3.86515e+18,104.678,4026.87,6180,1597,87,2577,2556,2344,2470,2483
47836,8,19,46426,1410,47710,126,1.78055e+14,10.4966,795.313,47836,15,12,17949,14597,13761,13761,13507
1239,108,383,0,1239,0,1239,6.29058e+17,86.4657,607.703,1239,154,49,856,389,397,347,364
29230,4,14,28396,834,29158,72,1.38629e+14,10.6936,521.433,29230,13,12,3150,1096,368,806,153
34311,1136,34311,0,34311,0,34311,524273,0,34311,34311,34311,1,0,0,0,0,0
46125,7905,14592,43728,2397,0,46125,1.98952e+18,96.5872,17781.8,46125,7084,110,23497,23497,11858,23497,10435
1373,5,10,1331,42,1373,0,2.19563e+14,9.60233,106.816,1373,10,10,1282,1166,1191,664,806
30748,4869,7203,10810,19938,0,30748,9.86934e+12,59.973,9442.65,30748,3504,72,30527,30527,7410,11660,3928
25567,6356,10508,0,25567,0,25567,4.99232e+17,94.8395,12306.1,25567,5095,110,15059,15059,12760,10231,9143
30254,4418,10595,28762,1492,28762,1492,7.57782e+18,95.8504,12800.5,30254,5130,110,33986,33986,33037,33013,23125
35758,330,8372,0,35758,0,35758,6.48514e+17,97.8009,11223.6,35758,4060,110,28248,28056,21813,19162,18431
20495,173,1013,0,20495,19895,600,4.2222e+16,209.001,2966.84,20495,150,26,40242,38792,35400,35342,34501
17572,5976,6305,16708,864,0,17572,1.87705e+18,95.4479,7748.48,17572,3051,110,11267,11267,10842,10793,10600
48119,14866,15450,17668,30451,0,48119,8.75371e+12,58.6908,18378.7,48119,7523,72,47824,47824,47823,47823,47823
7232,102,412,0,7232,7025,207,3.89681e+16,19.7024,1082.26,7232,62,26,6820,6812,6088,5793,3042
1855,57,533,1692,163,1747,108,2.08404e+18,90.6787,836.779,1855,231,56,855,213,479,628,153
37920,7550,21094,0,37920,0,37920,3.49287e+15,17.9005,21613.9,37920,18969,20,29048,29048,27258,26790,25334
15545,2264,5000,5693,9852,0,15545,8.74131e+12,58.4242,6192.04,15545,2425,72,10545,10545,8760,10157,5970
12418,760,2990,11691,727,0,12418,2.22858e+18,97.0477,4253.59,12418,1438,110,9428,9428,6456,5822,3055
48403,9,16,46995,1408,48309,94,1.61722e+14,10.5071,742.943,48403,14,12,11787,7136,6408,6825,6302
39311,4110,11388,37191,2120,37191,2120,3.19169e+18,96.9351,14288.4,39311,5521,110,28003,27947,21736,24103,17067
5428,170,234,0,5428,5274,154,3.53783e+16,19.8646,687.189,5428,46,26,30534,29777,11160,19214,1244
47947,265,11217,45157,2790,0,47947,2.22819e+18,97.8889,14817.3,47947,5436,110,41134,41048,35776,32318,23569
11123,1599,2645,3921,7202,0,11123,9.89971e+12,59.7095,3651.83,11123,1286,72,8478,8478,21800,23122,19703
17319,330,4671,16349,970,16349,970,6.36114e+18,96.8772,6245.13,17319,2258,110,20241,19888,13036,10136,1901
44487,2147,20549,0,44487,0,44487,4.55388e+17,93.0936,23121.8,44487,9970,110,30798,30705,21157,18383,13845
37035,1434,1558,0,37035,35951,1084,4.28727e+16,233.827,5007.59,37035,260,26,21998,21998,15438,14729,4884
3176,28,213,0,3176,3081,95,4.07253e+16,19.5331,557.881,3176,43,26,37502,37075,22418,23226,4813
30515,41,176,30506,9,30515,0,5.98117e+18,169.616,2069.95,30515,161,167,28641,2111,6239,5602,149
21832,19101,19155,0,21832,0,21832,7.72973e+17,4.28596,19636.1,21832,6405,13,2677,2677,2675,2677,2660
32575,435,7776,30675,1900,30675,1900,1.23835e+18,98.2514,10364.4,32575,3665,111,25874,25530,22082,20239,19250
27196,394,15251,0,27196,0,27196,3.49871e+15,17.9107,15685,27196,13710,20,40644,40644,40644,40644,40644
2528,41,191,0,2528,2455,73,4.22426e+16,19.2571,486.381,2528,42,26,2337,2329,1993,1804,1052
23040,69,175,22969,71,23040,0,5.97885e+18,166.558,1795.93,23040,161,159,35232,0,14324,14324,14324
748,62,260,0,748,0,748,6.94047e+17,79.6203,402.709,748,108,42,361,115,193,165,223
46467,8210,14808,46467,0,43759,2708,4.18271e+18,321.458,16741.5,46467,4130,137,21475,21475,14285,10694,5659
32204,2594,8548,0,32204,11508,20696,2.42581e+15,59.5196,10797.4,32204,4158,72,23656,23656,13226,8626,6528
16406,28,175,16398,8,16406,0,5.98109e+18,165.167,1516.47,16406,142,151,19166,5263,5903,6384,5868
40831,12,13,39666,1165,40815,16,1.39031e+14,10.2441,574.103,40831,12,12,40818,40818,40769,40770,40729
48146,4,19,46725,1421,48005,141,1.79756e+14,10.5596,802.27,48146,15,13,42695,38780,37793,35659,24948
37456,468,18438,27126,10330,35996,1460,2.78524e+18,93.4427,20549.7,37456,8891,111,24618,24618,24575,24597,24575
3971,4,11,3858,113,3967,4,1.3815e+14,10.8159,176.237,3971,11,11,0,0,0,4,6
37432,12044,12928,0,37432,13901,23531,2.16058e+15,57.7774,15246.4,37432,6275,72,34847,34847,34847,34847,35143
28369,861,18087,0,28369,11998,16371,1.20823e+15,53.5921,19250.2,28369,8810,72,26502,25831,12943,4162,3982
26751,12903,13916,18312,8439,25690,1061,4.75428e+18,406.52,15200.9,26751,6330,132,12835,12805,12733,12805,12807
22615,191,208,22604,11,22615,0,6.00032e+18,196.136,1908.22,22615,158,161,27554,26075,15824,13397,2337
24825,7,13,24102,723,24813,12,1.61084e+14,10.1476,463.736,24825,11,12,24092,23579,18792,18332,16193
29063,4,12,28227,836,29045,18,1.50873e+14,10.2432,495.796,29063,12,11,25256,22493,18515,18946,12949
24963,7609,8679,23713,1250,23713,1250,4.70654e+18,95.656,10558.4,24963,4124,111,21112,21112,21112,21112,21112
45925,2,16,44569,1356,45859,66,1.76718e+14,10.3551,743.968,45925,13,12,16583,15710,15690,15965,15583
37747,8459,9111,35555,2192,35555,2192,4.1879e+18,98.2464,12004.1,37747,4302,111,27808,27808,26835,26675,22650
41409,9225,15467,15582,25827,0,41409,8.08036e+12,57.8241,17890.1,41409,7529,72,41084,41084,41084,41084,41084
45899,2692,10650,0,45899,16133,29766,2.53252e+15,60.0818,13767.3,45899,5181,72,35196,35196,19091,30658,9534
10899,588,2612,0,10899,3829,7070,2.51673e+15,59.593,3602.37,10899,1267,72,8287,8287,3999,2735,2036
16907,552,4124,0,16907,5973,10934,2.51167e+15,59.7131,5501.09,16907,2007,72,12783,12783,4719,2467,1761
2615,65,186,2613,2,2600,15,5.95683e+18,145.511,617.036,2615,78,73,1848,1021,849,990,877
43426,4404,12561,0,43426,0,43426,6.01081e+17,96.9795,15696.7,43426,6098,110,26890,26890,20934,19717,14868
18146,3694,10870,17586,560,0,18146,1.18033e+18,88.627,11918.5,18146,5271,110,7276,7276,4991,4532,3136
17223,32,707,0,17223,16732,491,3.55456e+16,34.5266,1976.24,17223,90,26,34100,34088,30432,30247,0
41717,534,10245,14755,26962,0,41717,9.73067e+12,59.8646,13081.7,41717,4987,72,36084,38923,0,0,0
48595,5936,24113,0,48595,0,48595,4.26059e+17,93.3582,26730.4,48595,11713,110,35971,35971,29453,24768,6804
27908,2760,6538,26285,1623,26285,1623,5.86297e+18,97.65,8890.47,27908,3153,110,21370,21370,20427,20427,10095
25635,6721,10207,0,25635,9757,15878,1.99998e+15,57.3857,11802.8,25635,4972,72,15428,15428,13194,10104,9606
43341,439,1689,0,43341,42077,1264,4.20382e+16,293.665,5575.18,43341,286,26,45871,45871,45871,45871,45871
2642,339,673,927,1715,0,2642,9.64551e+12,57.7237,1017.94,2642,313,59,1969,1969,1590,1889,1136
18808,2193,4397,0,18808,6616,12192,2.54292e+15,59.9302,5911.81,18808,2141,72,14411,14411,11256,7375,7547
1375,207,413,1295,80,0,1375,2.23075e+18,87.5084,655.206,1375,176,50,962,962,703,704,622
20453,2821,7596,20453,0,19333,1120,5.23453e+18,152.632,8665,20453,2932,122,12857,12738,8916,10698,4815
32883,10,12,31940,943,32873,10,1.4343e+14,10.2639,517.346,32883,11,12,8169,24,353,1931,11
26219,8,11,25472,747,26207,12,1.38585e+14,10.1653,452.994,26219,11,11,25576,25235,19536,19689,20042
3958,80,177,0,3958,824,3134,1.5008e+16,11.949,375.128,3958,173,13,3781,3781,2930,2283,3397
13482,305,4248,0,13482,4922,8560,2.27634e+15,58.5006,5321.1,13482,2067,72,9234,9138,4457,2208,1131
22787,4787,5554,21466,1321,21466,1321,4.08036e+18,97.9756,7513.52,22787,2608,111,31308,31308,24789,23388,16631
34122,427,11369,0,34122,12591,21531,2.20449e+15,58.4463,13547.8,34122,5531,72,22753,22465,9469,2128,1763
36220,3927,8426,0,36220,12730,23490,2.53296e+15,60.0748,10992.3,36220,4104,72,31585,31568,31028,31388,30754
17971,6790,7295,6851,11120,0,17971,7.65578e+12,57.1492,8497.72,17971,3548,72,42801,42801,42801,42801,42801
35890,886,8366,0,35890,12615,23275,2.53205e+15,60.0389,10909.2,35890,4069,72,27524,27524,9677,3698,3085
20264,2608,4784,0,20264,0,20264,6.48183e+17,97.4943,6620.42,20264,2306,110,22402,22402,18894,16180,9032
39772,1792,13176,37752,2020,0,39772,1.94595e+18,96.2968,15968.2,39772,6386,110,38361,38361,38361,38361,38361
1395,221,378,0,1395,493,902,2.49403e+15,55.5326,590.705,1395,175,48,1017,1017,864,726,725
31222,6717,7309,10980,20242,0,31222,9.8647e+12,59.9827,9578.39,31222,3555,72,22619,22619,20943,20282,18981
13471,91,176,13425,46,13471,0,6.17122e+18,120.852,1426.73,13471,117,117,12370,9929,7113,6914,6698
2520,964,1495,1041,1479,0,2520,5.39363e+12,46.1075,1711.63,2520,712,57,1025,1025,915,1005,893
26086,9330,9692,24836,1250,0,26086,1.83419e+18,95.4854,11610.1,26086,4698,110,29700,29700,28474,28283,27275
11639,1801,11639,0,11639,0,11639,524243,0,11639,11639,11639,1,0,0,0,0,0
20109,4621,8124,19189,920,19189,920,5.43622e+18,95.4294,9618.65,20109,3890,111,11985,11985,8329,8929,7461
49350,7228,13192,46581,2769,46581,2769,4.67035e+18,97.9529,16666.6,49350,6274,111,47785,47785,47785,47785,47785
34347,9,12,33367,980,34336,11,1.3966e+14,10.2571,525.128,34347,12,11,5323,1186,560,853,153
4868,437,1236,1720,3148,0,4868,9.76934e+12,58.673,1769.46,4868,592,71,3632,3632,2333,3272,1508
12821,3,13,12448,373,12748,73,1.6795e+14,10.7734,363.979,12821,13,12,1310,454,421,694,138
18336,5909,7917,0,18336,0,18336,4.83627e+17,94.3511,9281.35,18336,3832,110,10551,10551,9916,9818,9011
17082,1432,6889,16302,780,0,17082,1.74652e+18,93.6834,8233.47,17082,3331,110,17511,17511,12044,6771,2747
22627,1015,1139,0,22627,21962,665,4.38008e+16,245.407,3399.7,22627,174,26,17159,17073,15653,14998,9806
2920,710,1522,2808,112,2808,112,2.58513e+18,89.026,1841.02,2920,706,61,28651,28043,8497,13799,896
32107,9371,10598,30469,1638,30469,1638,7.16024e+18,85.4236,12961.9,32107,5135,110,21509,21509,21509,21509,21509
9246,383,4083,8846,400,8846,400,4.47766e+18,94.0998,4891.72,9246,1945,98,5163,4902,3425,3255,1625
4068,1307,1445,0,4068,1512,2556,2.13808e+15,56.8815,1869.34,4068,688,67,2623,2623,2464,2375,2391
12484,541,2913,4381,8103,0,12484,9.93178e+12,59.7454,4015.55,12484,1416,72,40794,40794,40794,40794,40794
44930,26233,44930,44930,0,0,44930,134215000,0,44930,44930,44930,1,0,0,0,0,0
23467,1639,6816,22197,1270,22197,1270,3.24355e+18,96.516,8760.02,23467,3278,110,17903,22718,11981,10988,6471
21411,75,176,21397,14,21411,0,6.02757e+18,171.192,1788.36,21411,156,153,25129,4199,4742,3569,883
26991,714,8924,0,26991,9945,17046,2.21635e+15,58.4518,10733.6,26991,4346,72,13308,13308,1088,5532,503
41057,7705,9581,0,41057,0,41057,6.49087e+17,97.8833,12762.2,41057,4648,110,29424,29424,25352,28713,20505
42765,7940,13724,40555,2210,0,42765,1.97714e+18,96.5052,16711.7,42765,6667,110,29723,29723,25378,20722,20413
23297,4651,7306,22077,1220,0,23297,2.00324e+18,96.3242,9188.72,23297,3536,110,34355,34355,34355,34355,34355
31580,8116,11639,31580,0,29870,1710,3.68687e+18,213.095,13072.9,31580,4551,128,19941,19864,17103,18042,15528
1116,8,10,1084,32,1116,0,1.38468e+14,9.41756,92.4656,1116,10,10,1084,1072,1023,1022,932
6801,9,11,6606,195,6799,2,1.38275e+14,10.3158,228.465,6801,11,11,6712,6639,6519,6518,5727
40483,11802,14081,38473,2010,38473,2010,7.57414e+18,96.0549,16853.9,40483,6836,110,40083,40083,40083,40083,40083
21172,164,208,21158,14,21172,0,6.01096e+18,200.556,1871.38,21172,157,162,16458,14218,7051,6970,1453
44536,241,1320,0,44536,43257,1279,3.68847e+16,266.683,4527.7,44536,212,26,44288,44288,44288,44288,44267
7911,1766,2022,7459,452,7459,452,1.6947e+18,96.5141,2909.31,7911,931,103,5889,5889,5657,5872,5464
16536,4707,5698,0,16536,6138,10398,2.16934e+15,58.1124,6913.95,16536,2770,72,10838,10838,10113,9890,9465
25311,9012,12162,0,25311,0,25311,4.40883e+17,93.7315,13788,25311,5894,110,32747,32747,31392,31131,30113
37810,2890,9064,35610,2200,35610,2200,2.57351e+18,98.2713,11969.2,37810,4286,111,36099,36099,36099,36099,36099
17701,2167,8174,17701,0,16903,798,4.71245e+18,175.697,9192.56,17701,2618,130,9527,9341,5773,6745,3011
40122,1,12,38979,1143,40107,15,1.39005e+14,10.2665,568.641,40122,12,11,49,49,49,49,49
23071,226,8199,23071,0,21789,1282,3.32629e+18,145.743,9360.71,23071,3108,124,14872,14490,5827,9572,936
6253,1445,1529,0,6253,0,6253,6.46818e+17,95.8306,2294.45,6253,718,93,4724,4724,4653,4651,4670
47930,12,176,47856,74,47930,0,6.04462e+18,174.132,2683.35,47930,173,172,41317,40101,39985,40115,40122
26302,6694,12265,0,26302,0,26302,4.52834e+17,93.9843,13972.3,26302,5951,110,26035,26035,26035,26035,26035
1247,3,10,1212,35,1247,0,1.3769e+14,9.21893,97.1759,1247,10,10,16755,16283,16467,16401,15906
8610,6745,8049,0,8610,2679,5931,2.36122e+15,3.97456,8092.54,8610,2711,9,1728,2336,1914,472,478
4209,716,4209,4209,0,0,4209,7.9981,0,4209,4209,4209,1,23228,23228,10000,15209,0
43237,4608,13989,0,43237,15887,27350,2.23253e+15,58.6213,16660.7,43237,6809,72,37683,37683,27704,22744,15594
16489,6584,7467,6426,10063,0,16489,7.10735e+12,56.3958,8522.02,16489,3631,72,9022,9022,8407,8892,7561
16664,709,986,0,16664,0,16664,3.77339e+18,15.981,1461.17,16664,693,18,15678,15678,13203,12346,12759
3210,203,865,0,3210,0,3210,6.41504e+17,92.4589,1328.22,3210,397,71,2345,2345,1465,602,706
836,523,836,836,0,836,0,8.95511e+17,0,836,836,408,21,0,0,0,0,0
48889,4,7,47361,1528,48697,192,0.000122727,0.999857,573.407,48889,7,1,48882,48882,48882,48882,48882
10621,311,710,0,10621,10311,310,4.21721e+16,37.0937,1773.85,10621,91,26,48961,0,0,0,0
37238,3126,10634,0,37238,13432,23806,2.35865e+15,59.208,13106.4,37238,5175,72,27046,7461,7443,7461,5875
3694,2285,2489,3594,100,3594,100,3.29594e+18,67.9597,2774.8,3694,1188,54,29033,29033,8774,24000,10533
28302,9781,10270,28302,0,26792,1510,5.10739e+18,202.341,11779.5,28302,3394,132,18032,18032,18032,18032,17533
28550,297,1006,0,28550,28049,501,2.56051e+16,3.73538,3868.11,28550,505,4,36261,36261,31701,28066,3555
45286,688,2534,0,45286,43922,1364,5.18052e+16,337.11,8083.91,45286,451,26,31414,30818,14021,20742,2128
7367,154,175,7360,7,7367,0,5.98957e+18,159.598,1019.56,7367,114,118,7120,6936,6555,6621,6583
41866,5090,14923,0,41866,0,41866,5.44604e+17,94.588,17739.3,41866,7247,110,45691,45691,45691,45691,45691
13834,456,3314,13031,803,0,13834,2.22644e+18,97.1074,4687.49,13834,1592,110,10520,10520,4179,3741,2138
789,8,417,789,0,789,0,2.89239e+18,16.8492,481.943,789,359,20,183,0,1,0,5
22853,147,176,22831,22,22853,0,6.162e+18,163.028,1862.97,22853,139,144,22356,21479,19294,19203,18824
36041,3904,11998,13296,22745,0,36041,8.59282e+12,58.4341,14277.5,36041,5831,72,33583,33583,24371,31986,13195
12512,7,12,12139,373,12499,13,1.83796e+14,10.0878,334.51,12512,12,11,12202,11957,9969,9643,9216
44229,5,17,42905,1324,44147,82,1.95911e+14,10.3014,758.435,44229,14,12,47081,47071,47081,47076,46899
37283,7163,16985,35736,1547,0,37283,1.58675e+18,93.0067,19246.7,37283,8251,110,36783,36783,31437,26475,24245
13812,3087,3264,0,13812,4859,8953,2.5393e+15,59.7545,4449.33,13812,1590,72,10548,10548,10339,10292,10163
29578,4691,6961,27858,1720,27858,1720,3.23547e+18,97.7059,9421.02,29578,3365,110,41189,0,15512,22088,6006
16716,1354,6119,0,16716,6271,10445,2.10687e+15,57.8047,7313.67,16716,2978,72,10597,10597,7095,5302,2992
46899,8197,10921,44167,2732,0,46899,2.23017e+18,97.9024,14463.7,46899,5297,110,33855,33723,30084,32438,24831
17094,6228,8536,17094,0,17094,0,2.93003e+18,1103.63,9412.47,17094,7067,23,0,0,8462,18251,8692
46828,12,16,45445,1383,46748,80,1.77939e+14,10.2663,756.277,46828,14,13,17427,11810,11552,13156,10257
42540,6439,13349,15551,26989,0,42540,8.84704e+12,58.1079,16017.9,42540,6484,72,28616,28616,21949,27466,13899
5297,1993,2607,5297,0,5297,0,1.06251e+18,17.8816,2807.51,5297,2335,20,2690,2690,2082,2690,2114
31613,4073,7560,29772,1841,29772,1841,3.05798e+18,98.2049,10089.1,31613,3562,111,24053,24053,17397,18813,13857
49492,622,1414,0,49492,48076,1416,3.67684e+16,283.471,4926.53,49492,231,26,31673,31049,24525,30358,16034
48694,4529,11670,45862,2832,45862,2832,5.76724e+18,98.354,15210.2,48694,5515,111,48441,48441,48441,0,0
15393,271,734,0,15393,14953,440,3.7693e+16,58.1151,1992.57,15393,95,26,38915,38871,34365,31735,6906
45993,9474,23314,44263,1730,44263,1730,2.42502e+18,93.5591,25773.3,45993,11334,110,24552,24552,19433,31679,0
9367,727,2203,3288,6079,0,9367,9.88257e+12,59.5809,3089.01,9367,1068,72,36493,36493,29075,20219,6220
40640,7812,9547,38274,2366,38274,2366,5.76732e+18,97.8329,12698.3,40640,4623,110,35341,35341,34610,34605,26380
2523,160,647,882,1641,0,2523,9.76267e+12,57.5442,978.399,2523,303,58,1876,1876,882,1594,534
8227,2108,3549,7867,360,0,8227,1.68066e+18,90.8951,4311.4,8227,1696,102,4678,4678,4449,4262,4297
9396,421,2301,0,9396,0,9396,6.46619e+17,96.5818,3327.59,9396,1100,110,7095,7095,3262,2257,1822
8802,864,3159,3279,5523,0,8802,8.29778e+12,57.5735,3903.29,8802,1526,72,5643,5596,2243,4696,1246
6564,1725,3569,6564,0,6304,260,6.54707e+18,104.482,4041.2,6564,1426,93,2995,2978,2282,2828,1641
22555,2887,5275,0,22555,7922,14633,2.52544e+15,59.924,7026.79,22555,2557,72,40879,40879,38061,34141,33363
11694,1132,4083,0,11694,4341,7353,2.16584e+15,57.8237,5008.84,11694,1980,72,7643,7643,6647,6447,2750
569,201,233,536,33,536,33,2.92201e+18,72.2127,340.24,569,82,32,336,336,321,326,334
2505,658,732,2363,142,2363,142,6.05077e+18,92.01,1108.34,2505,327,62,1773,1773,1734,11180,10716
7157,633,1728,0,7157,0,7157,6.53197e+17,96.272,2573.02,7157,818,99,5429,5429,3941,2782,2400
928,770,872,928,0,868,60,8.20504e+17,3.68103,883.492,928,314,9,56,56,56,56,55
36892,5461,15371,35252,1640,35252,1640,2.71321e+18,93.9097,17735.2,36892,7461,110,19622,16391,13085,14077,10046
21412,9694,13869,4618,16794,0,21412,2.23452e+13,5.52148,15934.3,21412,4626,13,7543,7543,6957,7543,5565
11787,5831,6856,11787,0,11373,414,5.42835e+18,164.062,7547.69,11787,3163,112,4931,4931,4788,4891,4731
30060,4992,7042,0,30060,10570,19490,2.52651e+15,59.9842,9241.1,30060,3425,72,20851,20851,14764,10375,7712
41934,1346,1364,0,41934,40726,1208,3.82472e+16,275.118,4589.3,41934,219,26,33693,33693,24346,22904,11944
7669,1322,3367,7336,333,7336,333,4.90804e+18,93.706,4075.93,7669,1594,93,4302,4302,2673,3051,2582
29205,5696,12836,0,29205,0,29205,4.76413e+17,94.4645,14752.4,29205,6234,110,22380,22294,20216,18414,0
1112,4,31,0,1112,1022,90,2.90305e+16,9.72032,120.991,1112,29,11,3317,1042,460,404,428
28462,7810,8460,26940,1522,26940,1522,6.80367e+18,96.7028,10694.8,28462,4099,110,19964,19964,19924,19909,18936
36910,8883,18294,0,36910,0,36910,4.28233e+17,93.6511,20407.1,36910,8893,110,13311,13311,13311,13311,13311
27845,1942,6573,26226,1619,0,27845,2.22606e+18,97.6561,8915.31,27845,3177,110,26049,26049,12763,13697,6744
10328,7109,9656,9652,676,0,10328,1.0092e+18,3.96902,9704,10328,3231,9,672,672,493,493,499
35757,11228,13190,34027,1730,34027,1730,5.32217e+18,95.3996,15598.7,35757,6319,111,29093,29093,29093,29093,29093
19818,5807,10498,19107,711,19107,711,1.00473e+19,91.5769,11756.2,19818,5082,110,31118,31118,23834,22341,15226
6733,6,11,6539,194,6729,4,1.48534e+14,10.6465,232.369,6733,11,11,6429,6286,5646,5440,4460
25314,2379,5905,0,25314,8886,16428,2.53071e+15,59.9657,7825.24,25314,2867,72,19409,19409,14312,8796,8182
43280,6089,10138,0,43280,0,43280,6.48105e+17,97.8824,13455.6,43280,4920,110,42318,42318,42318,42318,42318
46549,13830,16538,46549,0,43989,2560,4.67899e+18,318.797,18443.6,46549,6223,137,44668,44668,44668,44668,44668
39475,8538,11520,37335,2140,37335,2140,5.48389e+18,97.4719,14362.9,39475,5488,111,26407,26407,21840,26230,21643
5427,295,298,0,5427,5270,157,3.81333e+16,19.7197,801.426,5427,51,26,7132,7132,7132,7132,7132
616,43,47,0,616,598,18,3.47421e+16,16.4545,122.88,616,20,21,569,569,564,557,554
9402,2381,2754,8892,510,8892,510,3.21346e+18,95.817,3734.64,9402,1310,110,33294,33294,27428,23226,5375
14309,6050,8015,14309,0,13789,520,4.04956e+18,191.691,8837.12,14309,3679,122,6294,6262,5289,5679,4703
29211,67,208,29157,54,28365,846,6.03704e+18,185.05,2196.82,29211,166,165,21904,13309,9088,10511,9417
39515,942,9463,37212,2303,37212,2303,3.604e+18,98.3039,12464.7,39515,4478,111,34468,34468,12914,6168,5160
49902,570,1665,0,49902,48460,1442,3.95074e+16,298.275,5680.36,49902,281,26,46011,46011,43529,41696,35517
46145,23,1246,0,46145,44832,1313,3.55643e+16,256.71,4347.74,46145,198,26,23121,8978,12878,16822,6233
24328,4457,6155,22939,1389,22939,1389,6.00439e+18,97.3668,8228.58,24328,2971,110,18599,18599,17448,18409,15875
26921,12351,12896,10627,16294,0,26921,6.71419e+12,56.0649,14380.3,26921,6277,72,17211,17211,17211,17211,17211
30199,807,8055,28500,1699,28500,1699,6.4607e+18,97.8002,10425.5,30199,3822,111,28860,28860,28267,28053,25246
38360,3025,12349,38360,0,36130,2230,4.65989e+18,274.366,14032.8,38360,2301,136,32053,32053,28695,30786,22928
2872,2,138,0,2872,2791,81,3.53765e+16,19.5279,405.256,2872,35,26,1260,740,822,741,429
25514,807,1003,0,25514,24779,735,3.86949e+16,201.743,3088.55,25514,149,26,37765,37765,34982,35510,31049
32749,78,176,32670,79,32749,0,5.99793e+18,172.534,2177.54,32749,170,167,18448,9465,10150,8652,5331
5292,82,354,0,5292,5138,154,4.13256e+16,19.5716,901.124,5292,57,26,4938,4930,4340,3997,2310
18047,1939,8101,0,18047,0,18047,4.68762e+17,89.1583,9422.9,18047,3905,110,17237,17237,17237,17237,17237
6652,1162,1612,0,6652,0,6652,6.52597e+17,96.1245,2413.43,6652,761,96,18741,18741,8838,7629,4895
11719,3,11,11383,336,11713,6,1.39044e+14,10.3866,303.714,11719,11,11,8946,6287,7750,7775,4955
8882,1143,3716,8482,400,8482,400,8.32534e+18,90.3263,4531.64,8882,1783,100,7673,7673,0,0,4103
12501,131,176,12432,69,12501,0,6.05208e+18,166.244,1375.02,12501,133,132,32376,31641,22895,27985,20389
36590,38,208,36504,86,36590,0,6.03485e+18,199.46,2496.45,36590,177,174,16851,2414,8949,6812,83
5739,384,1363,2009,3730,0,5739,1.00612e+13,59.2553,1974.63,5739,663,72,4376,4376,2403,3846,1340
8351,20,433,0,8351,8112,239,3.78279e+16,19.9066,1162.1,8351,64,26,7830,7328,5816,5747,1424
6312,987,1485,0,6312,2215,4097,2.54874e+15,59.4845,2147.49,6312,722,72,4827,4827,4101,3248,3387
24136,6464,8659,22956,1180,22956,1180,7.71072e+18,95.7015,10498.3,24136,4201,110,15477,15477,15137,15137,11747
38707,785,9282,36457,2250,36457,2250,4.83621e+18,98.2751,12239.4,38707,4393,111,32311,32154,27397,29189,22521
43442,8924,13095,0,43442,15798,27644,2.31119e+15,58.9919,15845.7,43442,6379,72,35573,35573,35573,35573,35720
30549,1635,7125,28769,1780,0,30549,2.23169e+18,97.7638,9654.12,30549,3441,110,30078,30078,30078,30078,30078
22336,362,1192,0,22336,21676,660,4.53844e+16,237.569,3542.69,22336,185,26,43709,43709,43709,43709,43709
24388,8919,13269,0,24388,0,24388,3.47934e+15,17.9652,13691,24388,11931,20,11119,11119,7599,8561,7542
47680,1475,1938,0,47680,46282,1398,4.3425e+16,322.472,6412.11,47680,335,26,36614,36614,23571,12291,6783
48031,4299,11782,45281,2750,0,48031,2.19388e+18,97.7067,15347.5,48031,5707,110,32404,32356,27898,24805,21579
784,121,234,0,784,282,502,2.58785e+15,53.2041,370.131,784,108,41,550,550,426,408,353
13736,277,968,0,13736,13328,408,4.89442e+16,200.278,2627.33,13736,142,26,12690,12425,9693,10334,4977
49152,951,19905,0,49152,0,49152,5.02755e+17,95.0776,22912.8,49152,9656,110,25643,25332,15264,12242,2914
12229,7,11,11878,351,12225,4,1.39161e+14,9.96435,307.216,12229,11,11,11791,11504,10797,10779,8924
47296,704,1687,0,47296,45921,1375,4.0569e+16,296.832,5673.92,47296,286,26,47252,47252,47252,47252,47252
33360,3025,11414,0,33360,12361,20999,2.17017e+15,57.5121,13531.1,33360,5543,72,35513,35513,28235,24258,20158
1630,175,478,1540,90,1540,90,5.88875e+18,88.5288,755.301,1630,199,52,1152,7785,7620,7639,7542
29245,100,208,29185,60,29245,0,6.10912e+18,202.539,2276.78,29245,164,170,29753,9796,9096,14965,2088
13972,4569,5380,13312,660,13312,660,7.89817e+18,91.5044,6561.96,13972,2594,110,8592,8592,8424,8406,8081
18244,1259,4316,17180,1064,0,18244,2.23084e+18,97.4283,6010.24,18244,2084,110,47811,47811,47811,47811,47811
15829,1682,3726,5568,10261,0,15829,9.87179e+12,59.8485,5051.97,15829,1807,72,12103,12103,9216,11603,5829
7162,49,310,1492,5670,0,7162,5.86509e+13,11.9751,580.69,7162,307,13,6852,6852,4526,2733,5813
18175,2913,9330,17495,680,17495,680,9.93912e+18,88.3924,10537.8,18175,4510,110,8845,8845,8355,8355,3243
23547,503,9428,22556,991,22360,1187,4.83937e+18,181.897,10723.7,23547,3989,125,39153,38468,31127,33833,26079
9146,21,175,9139,7,9146,0,5.99189e+18,161.51,1134.83,9146,124,125,8248,1444,2742,934,81
3831,636,975,0,3831,0,3831,6.48915e+17,94.326,1507.36,3831,452,79,2856,2856,2482,2011,2144
47529,6203,12429,0,47529,16954,30575,2.43801e+15,59.6299,15532.1,47529,6055,72,37570,37570,32996,28870,27967
6106,106,170,6046,60,6106,0,5.97797e+18,157.997,921.41,6106,106,110,5480,3757,3482,3600,3832
41618,14908,15813,39641,1977,39641,1977,4.64121e+18,96.1677,18481,41618,7579,112,33196,33196,33196,33196,33196
34553,5182,14456,33023,1530,33023,1530,2.8067e+18,94.8569,16697.1,34553,7015,110,42731,42731,42731,42731,42731
20545,3803,8086,20545,0,19465,1080,5.44805e+18,155.406,9147.48,20545,3206,124,12459,12459,9886,11036,6678
27495,3,15,26692,803,27439,56,1.70339e+14,10.4454,554.388,27495,13,11,3233,986,693,732,467
10778,1881,5969,0,10778,0,10778,3.82141e+17,87.1,6746.54,10778,2866,103,4809,4809,3456,2561,2555
36142,7821,9855,0,36142,12951,23191,2.39813e+15,59.3918,12305.4,36142,4786,72,24301,24301,21466,20391,17202
8243,1168,2710,8243,0,7766,477,3.5429e+18,93.6797,3392.64,8243,1016,114,5533,5533,3911,4580,2861
12286,3050,4537,12286,0,11609,677,3.38269e+18,110.132,5313.96,12286,1704,119,7749,30503,29502,29848,28900
31755,5573,7475,29912,1843,0,31755,2.22579e+18,97.7045,10072.3,31755,3609,110,31300,31300,31300,31300,31300
38337,904,1506,0,38337,37219,1118,4.1552e+16,275.148,4903.97,38337,248,26,38287,38287,38287,38287,38287
44841,6265,18395,42831,2010,42831,2010,8.49269e+18,94.2426,21175.7,44841,8937,110,35871,39312,0,0,0
5599,254,1622,2009,3590,0,5599,9.20259e+12,58.2493,2194.77,5599,777,72,3977,3929,2501,3719,853
17801,5580,5604,6509,11292,0,17801,8.84197e+12,58.5715,6934.2,17801,2720,72,12197,12197,12196,12197,12196
16966,3055,4131,15979,987,15979,987,1.32842e+18,97.7841,5700.58,16966,1936,111,12835,12835,12835,12823,10294
39517,591,1126,0,39517,38390,1127,3.56158e+16,236.647,3827.17,39517,173,26,32979,32979,24248,17090,13591
20031,11,32,19967,64,20031,0,1.11689e+18,31.9489,800.62,20031,32,32,6306,848,577,1586,50
31456,9206,14067,12243,19213,0,31456,7.12751e+12,56.6262,15828.7,31456,6842,72,31047,31047,31047,31047,31047
49681,14283,30052,0,49681,20730,28951,1.30409e+15,54.1835,31991.9,49681,14632,72,49251,49251,49251,49251,49251
3367,1182,2335,3367,0,3267,100,6.11581e+18,89.2067,2561.43,3367,1046,61,1032,1032,782,971,883
33085,1067,9049,0,33085,0,33085,6.1568e+17,97.1827,11627.2,33085,4385,110,21166,20297,10359,11605,2048
20974,2766,10287,20974,0,20974,0,1.50868e+18,17.9692,10703.5,20974,9247,20,10687,10687,3228,10687,2918
16879,3666,4013,15897,982,15897,982,5.76308e+18,97.129,5610.36,16879,1917,110,30723,30354,17720,11382,7718
13528,13,176,13518,10,13528,0,5.98896e+18,166.48,1400.42,13528,136,143,4053,647,871,892,904
33649,63,176,33590,59,33649,0,6.10181e+18,173.062,2272.32,33649,160,164,27920,23529,25716,26655,21709
3333,168,885,1178,2155,0,3333,9.68225e+12,57.8806,1284.59,3333,422,64,2448,2434,1127,2054,580
1882,26,154,0,1882,1828,54,4.32652e+16,18.1753,382.658,1882,38,26,0,88,2778,3353,73
21823,8,13,21202,621,21755,68,1.38784e+14,10.7095,448.766,21823,12,12,21332,20859,16688,16654,16188
5172,3,4,5082,90,5172,0,9.99748e+13,3.99188,136.479,5172,4,4,28260,27809,27992,27999,28927
2364,384,960,0,2364,895,1469,2.02323e+15,45.8972,1232.24,2364,445,54,1404,1404,818,955,276
11662,3040,5345,4548,7114,0,11662,7.02744e+12,56.1716,6152.44,11662,2599,72,6317,6317,5512,6147,4356
43574,254,1338,0,43574,42907,667,2.46233e+16,3.73668,5145.38,43574,671,4,31389,30873,17314,22880,7563
2221,334,611,0,2221,0,2221,6.47374e+17,91.4435,962.162,2221,276,60,1610,1610,1266,936,1099
9733,2769,4780,9733,0,9733,0,2.80734e+18,17.9366,5058.09,9733,4291,20,4953,4953,2970,2871,2931
43575,5725,11459,41115,2460,41115,2460,5.92249e+18,97.9751,14622.9,43575,5439,111,35909,35813,33809,34698,32361
35342,2983,10475,0,35342,0,35342,5.95266e+17,96.5245,13125,35342,5074,110,21680,21680,15153,9400,8102
45133,13319,14359,45133,0,42503,2630,3.81435e+18,311.951,16251.2,45133,4867,133,44120,44120,44120,44120,44120
15129,2074,3604,14249,880,0,15129,2.22577e+18,97.2559,5076.19,15129,1732,110,35516,35516,35499,35471,33907
43339,2971,10101,40812,2527,0,43339,2.23047e+18,97.8872,13425.4,43339,4901,110,43155,43155,43155,43155,43155
16119,3319,5220,15289,830,0,16119,1.97621e+18,95.929,6633.37,16119,2512,110,10899,10899,9782,9330,8199
15966,3120,5302,15966,0,15039,927,3.11671e+18,129.927,6242.62,15966,1919,120,12304,12304,11335,11092,10419
19495,2,176,19481,14,19495,0,6.03319e+18,170.278,1712.56,19495,147,151,27266,19324,18851,19975,15628
13363,82,176,13355,8,13363,0,6.02141e+18,168.05,1403.53,13363,135,141,10976,6617,5802,6209,6262
33792,6000,10790,32042,1750,0,33792,1.98246e+18,96.428,13278.1,33792,5235,110,23002,23002,18164,17230,12343
44981,62,176,44918,63,44981,0,6.05621e+18,171.258,2613.06,44981,167,171,30999,22986,24119,19583,20716
4360,205,1092,4103,257,0,4360,2.23826e+18,94.8759,1677.39,4360,512,82,3268,3268,2068,1956,907
26781,854,6265,0,26781,0,26781,6.48396e+17,97.69,8547.79,26781,3023,110,36775,36775,16888,27825,5032
9478,1116,4838,0,9478,3779,5699,1.63241e+15,52.3227,5479.53,9478,2338,72,4640,4640,3045,2052,1283
14159,1252,3343,0,14159,4986,9173,2.52841e+15,59.7873,4557.73,14159,1625,72,10816,10816,7239,5591,4118
24890,10867,11821,0,24890,9799,15091,1.7353e+15,56.1288,13226.1,24890,5753,72,28947,28947,28947,28947,28947
28108,7,12,27291,817,28088,20,1.58833e+14,10.3409,495.506,28108,12,11,27240,26616,24327,22698,20371
40384,5,8,39714,670,40320,64,9.8395e+13,3.99876,521.603,40384,6,4,34347,27995,17340,19188,5849
39536,843,1790,0,39536,38371,1165,4.50451e+16,302.329,5760.66,39536,306,26,32498,32344,28661,31001,25949
3929,57,189,0,3929,3817,112,3.59463e+16,19.6852,543.314,3929,42,26,3740,3740,2899,2896,1705
11204,1,13,10883,321,11136,68,1.48802e+14,10.8418,324.075,11204,13,12,240,240,240,240,240
17772,4655,10221,0,17772,0,17772,3.63268e+17,92.051,11297.6,17772,4960,110,14468,0,0,0,0
42310,1874,12768,42310,0,39850,2460,4.45457e+18,301.153,14882.7,42310,2897,136,35864,35864,16938,29966,6799
43030,6736,10056,0,43030,15127,27903,2.52955e+15,60.0485,13003.3,43030,4894,72,31669,31397,30121,30627,29242
45895,3143,10744,43225,2670,43225,2670,3.35436e+18,97.8851,14221.9,45895,5211,110,44394,44394,44394,44394,44394
9940,520,2841,0,9940,3574,6366,2.36222e+15,58.8325,3724.21,9940,1374,72,7099,7051,3718,2641,1825
21598,178,791,0,21598,20984,614,3.56218e+16,108.095,2349.17,21598,107,26,20807,20692,17888,17944,8525
39151,52,176,39070,81,39151,0,5.98389e+18,172.36,2346.15,39151,171,170,27932,10040,8027,17988,502
26847,3816,9238,25507,1340,0,26847,1.91236e+18,95.155,11268.4,26847,4470,110,26516,26516,26516,26516,26516
4806,77,226,0,4806,4667,139,3.58939e+16,19.8589,645.705,4806,45,26,4580,4580,4090,4108,2150
19236,6093,10022,18526,710,18526,710,3.29117e+18,91.0601,11254.5,19236,4806,111,29603,29603,25281,24646,20143
2600,321,651,0,2600,914,1686,2.56421e+15,57.7485,990.823,2600,309,58,1949,1949,1574,1152,1111
31032,38,61,31000,32,31032,0,2.34348e+18,60.784,1304.22,31032,61,61,26063,15039,18985,19403,19090
35842,9922,10524,12976,22866,0,35842,9.09859e+12,59.0828,12903.3,35842,5118,72,36924,36924,35385,35101,32935
8771,4311,5122,8488,283,0,8771,1.24074e+18,52.7101,5758.51,8771,2466,85,3649,3649,2749,2451,1549
6644,154,1822,2375,4269,0,6644,9.50109e+12,58.7444,2479.54,6644,883,72,4822,4726,1735,3915,537
49209,18444,18896,49209,0,46819,2390,5.00325e+18,1341.49,21648.2,49209,6869,142,31271,31271,31271,31271,31271
24321,1031,1499,0,24321,23595,726,5.08442e+16,287.794,4483.98,24321,246,26,27931,27469,12590,19711,3043
6277,1256,2202,5957,320,5957,320,2.94279e+18,94.8359,2882.79,6277,1033,90,4075,4075,2859,3013,2688
15406,7,13,14966,440,15337,69,1.41377e+14,10.8318,378.985,15406,12,12,14872,14581,11369,11443,10837
23496,1704,5525,22128,1368,0,23496,2.23087e+18,97.5518,7582.1,23496,2665,110,17971,17971,11017,10249,6559
46818,9,15,45474,1344,46740,78,1.46425e+14,10.4501,669.301,46818,13,13,11829,7640,7320,7801,6350
47720,6,18,46325,1395,47582,138,1.67971e+14,10.4776,744.273,47720,15,13,20423,18493,18106,18165,17431
9985,85,208,9976,9,9985,0,6.08196e+18,189.037,1331.72,9985,121,124,8311,5697,4171,4361,4211
24491,6607,8060,24445,46,23069,1422,4.53924e+18,165.003,9292.65,24491,2945,124,21231,21231,21231,21231,21231
30295,5872,8225,0,30295,10854,19441,2.41116e+15,59.4109,10350.2,30295,4006,72,20506,20441,16042,16645,11534
13953,1618,5401,5273,8680,0,13953,7.91258e+12,56.8884,6417.46,13953,2609,72,24802,24446,14274,9003,4579
37333,825,10752,0,37333,0,37333,6.0228e+17,96.9508,13540.6,37333,5213,110,25842,25508,16872,15542,6746
20031,664,1039,0,20031,19443,588,4.33835e+16,212.03,3030.36,20031,157,26,24651,24311,14367,12143,71
42671,9551,10011,40189,2482,0,42671,2.22672e+18,97.8527,13287,42671,4855,110,32626,32626,32159,31951,38308
29663,5584,6956,10422,19241,0,29663,9.86768e+12,59.9814,9133.64,29663,3380,72,37062,37062,34371,34965,30711
18557,3146,4679,6588,11969,0,18557,9.67132e+12,59.6342,6151.92,18557,2274,72,13878,13878,12004,13480,9004
15554,1512,4880,0,15554,5682,9872,2.26443e+15,58.5478,6083.39,15554,2363,72,10674,10674,37632,37742,0
7243,152,2274,0,7243,2642,4601,2.28121e+15,58.313,2952.15,7243,1104,72,30787,30517,15038,9988,1001
1834,3,10,1784,50,1834,0,1.37361e+14,9.63195,116.712,1834,10,10,1395,993,1161,1119,787
26694,6,14,25918,776,26613,81,1.61257e+14,10.419,526.953,26694,13,12,25448,24621,19457,18792,15763
49469,22967,28727,47879,1590,47879,1590,3.78989e+18,89.2401,30986.1,49469,13876,111,48975,48975,48975,48975,48975
10849,2551,3782,4031,6818,0,10849,8.45393e+12,55.9069,4662.06,10849,1836,72,7067,7067,6550,6957,5888
46788,3822,18738,46788,0,44750,2038,4.61254e+18,2484.56,22081.5,46788,6315,144,46302,46302,46302,46302,46302
47875,188,206,47789,86,47875,0,5.98213e+18,193.062,2694.8,47875,188,182,39789,39641,28770,17054,15562
7812,1963,2574,7812,0,7360,452,3.60155e+18,93.6158,3234.32,7812,969,109,5238,5238,4625,4894,4325
14827,2619,4204,0,14827,0,14827,6.08108e+17,96.5049,5591.33,14827,2016,110,10623,10623,8586,6982,6496
11223,3446,6827,11223,0,10853,370,4.86213e+18,157.284,7469.86,11223,3164,107,4396,4396,3212,3849,2699
3833,581,976,0,3833,0,3833,6.4858e+17,94.3107,1508.76,3833,452,78,2666,2584,1925,4578,2489
47118,110,176,47032,86,47118,0,5.99064e+18,173.425,2593.85,47118,174,175,45858,45858,38156,31197,42390
21853,6341,11627,4737,17116,0,21853,52936400000,8.98298,11918.4,21853,10456,11,16666,16666,7869,10579,6115
6287,185,2862,0,6287,0,6287,4.72134e+17,92.5009,3468.43,6287,1369,84,3425,3178,2042,1544,852
20070,2457,5877,0,20070,7260,12810,2.33978e+15,58.967,7373.31,20070,2860,72,14193,14193,11038,7809,6949
26386,100,176,26305,81,26386,0,6.0226e+18,171.569,1984.96,26386,159,164,20255,18229,0,0,0
40234,1276,12924,40234,0,37895,2339,3.64926e+18,286.778,14667.1,40234,4546,133,30413,30413,17148,18245,5598
49401,7765,22530,19310,30091,0,49401,7.01385e+12,56.5305,25021.6,49401,10972,72,49280,49280,49280,49280,49280
16542,3692,5713,15713,829,0,16542,1.91518e+18,95.6106,7116.58,16542,2756,110,16398,16398,16398,16398,16398
10011,1395,2533,9438,573,0,10011,2.19383e+18,96.539,3600.22,10011,1212,110,9739,9563,12112,12112,12112
37954,140,176,37897,57,37954,0,6.01727e+18,172.969,2369,37954,166,171,48063,48063,48063,48063,48063
27030,9024,9325,27030,0,25543,1487,3.57451e+18,188.699,10800.4,27030,3761,125,26626,26626,26626,26626,26626
22961,140,176,22908,53,22961,0,6.06633e+18,170.932,1871.36,22961,153,153,25868,25748,7127,1230,734
24353,1053,6227,0,24353,0,24353,6.31896e+17,97.2997,8296.59,24353,3014,110,18126,18126,11851,6793,4268
30647,6053,13161,0,30647,11837,18810,1.88695e+15,45.0453,14929.3,30647,6405,72,23305,23305,15900,10302,7050
682,72,415,0,682,0,682,3.53095e+15,16.6877,465.636,682,358,18,267,262,44,267,76
4071,1042,1683,3879,192,3879,192,3.08523e+18,92.6898,2147.05,4071,786,74,2388,2388,1640,1739,1645
12535,602,718,2571,9964,0,12535,5.77041e+13,11.984,1077.09,12535,522,14,11817,11817,11031,10547,11464
25662,3237,13566,0,25662,10357,15305,1.55883e+15,54.2626,14892.9,25662,6586,72,12096,12096,8166,3290,3624
12045,1874,3538,11395,650,11395,650,6.5331e+18,96.1486,4715.43,12045,1702,110,43565,43565,0,0,0
3996,1239,1329,3996,0,3759,237,5.94023e+18,92.0663,1762.22,3996,486,82,29400,29400,18605,9344,2642
44147,4376,14248,44147,0,41595,2552,3.60303e+18,308.366,16108.8,44147,5304,133,32381,32381,24106,30947,14055
29485,168,1288,0,29485,28625,860,4.22741e+16,267.857,4024.91,29485,206,26,24837,24756,18816,13181,10173
39369,10,15,38217,1152,39277,92,1.67102e+14,10.4885,658.091,39369,14,12,24884,22114,21417,22323,20594
32288,2958,9028,30508,1780,30508,1780,6.31581e+18,97.6173,11493,32288,4296,111,36004,36004,25011,13936,11202
33844,4096,13643,0,33844,12901,20943,1.96997e+15,56.9633,15625.5,33844,6626,72,20201,20201,13333,8801,7439
19663,1,12,19081,582,19652,11,1.78021e+14,10.1882,419.004,19663,12,11,0,0,0,0,0
29666,4452,7829,28006,1660,0,29666,2.143e+18,97.243,10222,29666,3790,110,21837,21837,17937,17111,13413
44548,4567,17969,42526,2022,42526,2022,2.87144e+18,95.1855,20754.5,44548,8722,110,34502,34460,30886,0,0
9114,3,10,8851,263,9109,5,1.46976e+14,9.93515,268.231,9114,10,10,8396,5274,5530,5769,3641
7234,1728,1795,6812,422,6812,422,3.62423e+18,96.6442,2632.89,7234,832,100,5439,5439,5439,5439,5405
41670,8,10,40927,743,41574,96,1.00499e+14,3.99815,575.617,41670,7,4,6514,1718,1181,3213,307
27722,1399,9388,10249,17473,0,27722,8.51646e+12,56.9964,11224.1,27722,4551,72,18334,18334,9407,15406,2972
2413,115,116,0,2413,2345,68,3.53569e+16,19.4998,347.512,2413,32,26,2297,2297,2296,2296,2297
20012,3812,4713,18842,1170,18842,1170,3.34705e+18,97.52,6531.76,20012,2270,110,14058,14058,12714,7851,7984
5559,44,245,5383,176,5559,0,5.71942e+18,25.4352,551.031,5559,183,28,14033,3270,8884,3805,1527
10488,10397,10488,10488,0,10488,0,34356500000,0,10488,10488,10488,1,0,0,0,0,0
36862,777,1551,36862,0,35326,1536,2.22123e+18,16.9907,2293.89,36862,1547,18,30574,30487,15863,17137,4283
33772,1143,2016,6905,26867,0,33772,5.75247e+13,11.994,2612.15,33772,1389,14,31756,31756,25887,22331,29115
39696,7160,11075,0,39696,14278,25418,2.37694e+15,59.318,13703.5,39696,5379,72,32989,32989,32989,32762,32762
15338,573,4880,5622,9716,0,15338,8.82198e+12,58.5073,6062.15,15338,2372,72,33593,32979,13402,8757,2089
28582,1143,1738,0,28582,5839,22743,1.4706e+16,11.9927,2285.16,28582,1177,14,26844,26844,22776,19086,25016
46455,14587,17331,46455,0,43992,2463,4.63186e+18,388.552,19264.3,46455,5141,137,45871,45871,45871,45871,45871
20848,7182,7822,7844,13004,0,20848,8.06555e+12,57.6874,9225.06,20848,3805,72,19220,19220,19220,19220,19220
19044,4949,6306,19044,0,17934,1110,3.15185e+18,145.802,7356.91,19044,2297,123,20228,20228,18488,19856,15624
47010,13354,16877,17580,29430,0,47010,8.2737e+12,57.736,19616.1,47010,8216,72,33373,33373,33360,33353,33072
28509,2881,6695,10025,18484,0,28509,9.86008e+12,59.9525,8801.83,28509,3257,72,19386,19386,12095,8765,4143
7399,161,176,7394,5,7399,0,6.14029e+18,152.173,1060.4,7399,104,107,7191,7081,6738,6695,6716
18360,3816,4343,17290,1070,0,18360,2.23015e+18,97.4436,6046.89,18360,2091,110,14017,14017,13313,13184,12763
36002,9,14,34975,1027,35927,75,1.3883e+14,10.541,575.633,36002,14,12,11329,7238,5966,5231,4392
20354,1355,5732,7317,13037,0,20354,9.26271e+12,59.1469,7266.59,20354,2786,72,11080,11080,6265,7349,2031
24436,14,16,23696,740,24381,55,2.06556e+14,10.411,519.675,24436,14,12,11800,9598,9742,9565,18360
12202,3301,4441,0,12202,0,12202,5.47304e+17,94.8576,5535.29,12202,2144,110,7761,7761,6963,6849,5955
21596,415,907,0,21596,20975,621,3.86681e+16,177.63,2691.7,21596,130,26,20689,20433,18919,18500,11803
7781,561,3862,0,7781,0,7781,3.42635e+15,17.9057,4107.54,7781,3460,20,3919,3919,842,3919,581
34681,917,10327,32828,1853,0,34681,2.04597e+18,96.7782,12928.1,34681,5008,110,28463,28463,0,0,2367
8231,1844,1976,7750,481,7750,481,5.81643e+18,96.4517,2910.22,8231,941,105,6255,6255,6226,6226,6098
10492,270,2491,9881,611,9881,611,5.8419e+18,96.8486,3615.36,10492,1182,110,8001,8001,7076,6444,1430
41765,6460,10246,14773,26992,0,41765,9.73974e+12,59.8725,13083.7,41765,4990,72,33590,33590,32016,33518,30579
35667,565,8645,12592,23075,0,35667,9.76225e+12,59.8999,11154.1,35667,4203,72,35831,35831,21004,2544,2392
47495,1,14,46139,1356,47418,77,1.38921e+14,10.5399,682.396,47495,13,12,2161,2161,2161,2161,2161
44186,3036,16101,0,44186,0,44186,5.37841e+17,95.8248,19013.1,44186,7822,110,42972,42972,42972,42972,42972
21701,2912,8787,21701,0,20618,1083,4.4115e+18,175.358,10005.8,21701,3090,129,27328,27328,24044,23508,10746
813,156,283,763,50,763,50,3.20572e+18,80.1205,437.26,813,109,42,530,530,421,474,400
2899,133,136,0,2899,2817,82,3.54944e+16,19.4874,405.04,2899,37,26,2763,2763,2762,2759,2756
31756,1011,1878,30456,1300,9659,22097,1.53111e+18,16.9886,2560.02,31756,1311,19,34388,34388,32232,32634,23711
32370,12684,14108,30980,1390,0,32370,1.64464e+18,93.4973,16196.1,32370,6832,110,39347,39347,39347,39347,39347
32673,818,16019,32673,0,32673,0,1.35311e+18,17.9785,16543.2,32673,14406,20,32687,32687,20259,14694,3105
49166,4632,18103,0,49166,18451,30715,2.0871e+15,57.9414,20910.1,49166,8818,72,48975,48975,48975,48975,48975
29265,123,176,29243,22,29265,0,6.05454e+18,172.215,2107.64,29265,158,165,27680,25393,20250,20432,20310
31369,178,208,31285,84,30798,571,6.02787e+18,188.402,2269.63,31369,167,172,0,0,0,0,1372
4294,593,1494,4294,0,4043,251,5.93611e+18,90.4616,1917.56,4294,525,85,2800,2800,2142,2534,1428
30291,4720,7300,28528,1763,28528,1763,5.89416e+18,98.1934,9739.16,30291,3453,111,22991,22991,18120,19069,15847
39335,3453,9470,37046,2289,37046,2289,4.8537e+18,98.2759,12459.5,39335,4488,111,31839,31839,27283,23769,20380
49971,13,15,48540,1431,49880,91,1.43675e+14,10.5234,715.041,49971,14,12,16270,6143,6474,9564,2299
36143,2775,8419,0,36143,12711,23432,2.53235e+15,60.0586,10978.7,36143,4098,72,33762,33762,18608,12361,9373
47005,7367,11264,44265,2740,44265,2740,3.30637e+18,98.3699,14704.6,47005,5333,111,36983,36983,34135,36586,29349
48136,15,234,48054,82,36130,12006,6.03285e+18,172.637,2796.07,48136,174,173,27338,9837,18809,26570,27117
44961,3765,20005,43051,1910,43051,1910,3.49892e+18,95.0981,22607.8,44961,9628,111,44609,44609,44609,44609,44609
29157,4621,6773,0,29157,10241,18916,2.53516e+15,60.0129,8924.52,29157,3293,72,30486,30486,25224,22598,16145
599,181,334,599,0,569,30,3.23101e+18,66.5526,420.873,599,125,36,265,207,210,234,247
43419,859,1196,0,43419,42180,1239,3.55865e+16,248.754,4133.71,43419,188,26,29936,29529,14677,19878,7983
11214,3745,4355,10691,523,0,11214,1.79675e+18,94.4594,5357.33,11214,2090,110,6859,6859,6104,5940,5540
33735,832,1309,0,33735,32755,980,4.05026e+16,265.369,4210.5,33735,211,26,24012,23838,11178,15446,4072
40904,876,1147,0,40904,39739,1165,3.5532e+16,239.758,3921.24,40904,177,26,30775,30347,23525,18158,2865
38627,3155,9017,36377,2250,36377,2250,5.74637e+18,97.8622,12054.8,38627,4373,110,37940,37940,37940,37940,0
4014,279,407,0,4014,3895,119,4.97797e+16,18.843,942.463,4014,61,26,29577,28707,15624,16186,2963
44285,615,2532,0,44285,42949,1336,5.234e+16,329.714,8046.4,44285,455,26,44237,44237,44237,44237,44237
10939,3023,3794,10389,550,0,10939,1.9203e+18,95.1475,4826.22,10939,1826,110,7145,7145,6686,6463,6219
27122,2554,8871,0,27122,0,27122,5.7047e+17,96.2115,10954.9,27122,4296,110,23880,19739,12085,11655,5141
38591,7322,9231,36341,2250,36341,2250,4.57717e+18,98.342,12182.7,38591,4371,111,29360,29360,25738,26525,32520
46454,5,176,46367,87,46454,0,6.03029e+18,172.796,2627.72,46454,172,172,43107,39500,34341,33847,24081
26080,3026,12633,25049,1031,25049,1031,3.69707e+18,94.351,14260.2,26080,6072,111,13447,13447,6339,7878,4235
12046,1152,2904,11346,700,0,12046,2.22472e+18,96.9695,4142.66,12046,1389,110,9142,9142,6466,5857,4060
13084,1067,4499,9006,4078,12417,667,6.02784e+18,96.0745,5662.82,13084,2141,111,10415,10415,8935,9652,6853
28958,183,927,0,28958,28132,826,3.5561e+16,178.669,2952.88,28958,135,26,22839,22666,13814,18192,10113
42345,6777,11234,39983,2362,39983,2362,6.20576e+18,97.3488,14391.2,42345,5453,110,40918,40918,40918,40918,40918
39355,5131,9252,37066,2289,37066,2289,5.91481e+18,97.685,12325.6,39355,4483,110,34823,34823,34823,34823,35010
47774,1513,2541,0,47774,9845,37929,1.48282e+16,12.0024,3261.88,47774,1182,20,0,0,0,0,0
13200,1596,3225,4660,8540,0,13200,9.81111e+12,59.6102,4362.76,13200,1567,72,37723,37723,31761,33933,12565
46061,5206,11044,43381,2680,43381,2680,2.03203e+18,98.3619,14434.8,46061,5232,111,37400,37400,36510,36393,27535
27195,4532,9185,10060,17135,0,27195,8.546e+12,58.3245,10991.5,27195,4469,72,27010,27010,27010,27010,27010
28861,9,14,28005,856,28804,57,1.79822e+14,10.4657,566.372,28861,13,11,7623,2594,150,4288,99
3708,78,170,3648,60,3708,0,6.01304e+18,149.349,717.829,3708,91,86,2902,1654,1538,1681,1619
7508,2683,3493,7198,310,7198,310,2.59998e+18,92.8307,4175.24,7508,1681,90,4015,4015,3572,3919,3380
24969,56,61,24905,64,24969,0,2.33646e+18,60.7194,1175.67,24969,61,61,24529,23431,22815,23426,22895
28570,10710,28570,28570,0,0,28570,134213000,0,28570,28570,28570,1,19007,19005,18942,19007,18294
10249,92,170,10245,4,10249,0,5.98087e+18,162.351,1192.88,10249,126,133,8845,5473,5065,5359,5484
14284,2221,7865,13786,498,13786,498,1.03302e+19,92.2305,8815.81,14284,3808,109,22854,22854,21958,21810,18673
39172,126,208,39094,78,39172,0,6.10255e+18,204.31,2640.74,39172,181,178,34730,28691,26191,23285,23465
10066,1314,2866,0,10066,3623,6443,2.37574e+15,58.8708,3757.64,10066,1389,72,13053,13053,13053,13166,13166
44847,113,176,44824,23,44847,0,5.99643e+18,172.457,2544.09,44847,172,172,43172,42956,35217,35466,13075
38395,10785,15158,36632,1763,0,38395,1.7626e+18,95.2386,17667.3,38395,7354,110,24100,24100,20855,20584,13428
33568,8497,16092,33568,0,32121,1447,4.54666e+18,469.485,17656.8,33568,7204,135,17476,17188,13414,15009,10037
45252,5,7,43838,1414,45060,192,0.000132591,0.999845,542.849,45252,7,1,45245,45245,45245,45245,45245
3188,54,176,3183,5,3188,0,6.11269e+18,143.963,698.184,3188,77,80,2216,1426,948,985,1033
16370,119,10364,16370,0,15873,497,5.41383e+18,179.935,11161.9,16370,4851,121,11714,5217,4298,340,1117
16311,3160,5057,0,16311,0,16311,5.86891e+17,96.109,6499.84,16311,2436,110,15967,15967,15967,15967,15967
39207,2863,12512,39207,0,36975,2232,4.37238e+18,254.228,14475,39207,4985,129,42817,42817,42817,42817,42817
38602,3590,12400,38602,0,36352,2250,3.94086e+18,272.893,14091.8,38602,4591,125,35889,35889,25675,23938,13217
45954,25502,25867,44414,1540,44414,1540,3.31722e+18,91.202,28071.4,45954,12485,111,20087,20087,19917,20074,19796
9502,4161,4326,9502,0,9062,440,5.58821e+18,117.557,4993.28,9502,1834,114,31036,31036,31036,31036,31036
20548,820,7626,20548,0,19426,1122,4.1058e+18,138.942,8696.65,20548,2935,122,12922,12714,6198,9062,2099
20028,56,175,20020,8,20028,0,5.98313e+18,165.894,1674.79,20028,157,154,21108,5443,9113,799,1125
11464,884,2759,0,11464,0,11464,6.50516e+17,97.0593,3952.79,11464,1325,110,8705,8705,6140,4388,3198
27358,131,176,27284,74,27358,0,6.00378e+18,170.672,2006.47,27358,160,163,26129,24442,20266,20394,39003
39970,47,176,39891,79,39970,0,5.98078e+18,169.764,2367.07,39970,170,170,30581,26712,28620,29607,25764
23041,7129,7205,23041,0,21701,1340,3.26144e+18,162.742,8556.37,23041,2775,125,25392,25392,25392,25392,25392
19739,1640,4733,18597,1142,0,19739,2.21822e+18,97.3694,6529.1,19739,2277,110,15006,22107,17931,17240,12844
27645,2160,10329,10404,17241,0,27645,8.10971e+12,57.7755,12079.5,27645,5031,72,17879,17879,11061,7926,4549
6666,1011,1687,6284,382,6284,382,5.87097e+18,95.7694,2482.48,6666,791,97,4589,7115,5985,5812,1631
13395,5650,5787,0,13395,5173,8222,1.88272e+15,53.4817,6718.46,13395,2811,72,10814,10814,10814,10814,10814
24834,3,176,24812,22,24834,0,6.08947e+18,171.886,1951.67,24834,157,155,2894,472,292,197,357
37648,8053,12446,0,37648,0,37648,5.66688e+17,96.0635,15120,37648,6039,110,37200,37200,37200,37200,37200
18009,4880,5660,18009,0,16961,1048,3.57573e+18,141.887,6803.64,18009,2161,121,18203,18203,18203,18203,18203
41315,13,16,40105,1210,41244,71,1.71004e+14,10.4176,689.088,41315,13,12,23007,17494,17787,18458,15491
2522,200,689,2380,142,2380,142,3.40335e+18,91.9647,1076.57,2522,305,63,1833,1833,913,1341,745
47707,10949,14456,45184,2523,0,47707,2.0271e+18,96.7711,17782.7,47707,7010,110,47256,47256,47256,47256,47256
794,309,579,0,794,0,794,3.04017e+17,61.5907,654.625,794,242,39,215,129,139,35158,35254
13377,2163,4754,13377,0,12626,751,3.82833e+18,115.688,5581.67,13377,1334,123,22633,22633,19726,18766,8024
32672,148,1519,0,32672,31710,962,4.45905e+16,295.612,4788.28,32672,251,26,30532,30119,25317,20559,6964
22036,872,1225,6622,15414,0,22036,6.91158e+18,15.9919,1779.06,22036,646,26,33830,33830,26067,17933,4618
14911,3611,4357,14101,810,14101,810,5.49418e+18,96.7511,5717.15,14911,2053,111,10554,10554,9214,9509,9021
6667,146,1578,0,6667,2339,4328,2.54351e+15,59.3582,2265.14,6667,763,72,5089,5089,1604,656,545
12553,3752,3944,4592,7961,0,12553,8.88501e+12,58.4975,4962.69,12553,1915,72,8609,8609,8387,8561,8184
49493,14459,19833,0,49493,18863,30630,1.9767e+15,57.4245,22539.3,49493,9656,72,30171,30171,29165,29203,26325
43302,76,176,43210,92,43302,0,6.04441e+18,173.707,2561.52,43302,171,173,40373,40008,28774,30400,16800
39639,10168,11971,37519,2120,37519,2120,3.37152e+18,97.3382,14787.5,39639,5707,111,28778,28778,28178,28745,27822
35236,13792,14183,0,35236,0,35236,5.05452e+17,95.1414,16510.1,35236,6882,110,25098,25098,25098,25098,25098
42932,6717,10010,40427,2505,0,42932,2.23146e+18,97.8978,13307,42932,4857,110,47615,47615,47615,47615,47615
12292,116,4083,4525,7767,0,12292,8.61355e+12,58.1167,5065.64,12292,1976,72,8209,8065,4659,7599,469
42741,10,14,41524,1217,42663,78,1.38969e+14,10.4864,629.443,42741,13,12,42554,42224,38791,38719,39168
8664,524,3107,8238,426,8238,426,2.91258e+18,94.2396,3965.82,8664,1486,102,5557,5471,3982,4191,1803
26174,7321,13984,0,26174,0,26174,3.95509e+17,89.3031,15522,26174,6771,110,19251,19251,19251,19251,19251
39022,20006,20736,39022,0,39022,0,2.94112e+18,17.9818,21284.3,39022,18646,20,30198,30198,30198,30198,30198
5665,322,1391,0,5665,0,5665,6.54929e+17,95.5502,2099.67,5665,653,90,4274,4274,2131,1639,1364
10156,2998,3809,10156,0,8603,1553,3.98963e+18,95.1837,4495.86,10156,1433,117,6347,6344,6046,6196,6074
2040,135,170,2040,0,2040,0,5.93105e+18,133.274,531.929,2040,70,66,1839,1749,1563,1589,1558
23528,5382,7323,8587,14941,0,23528,8.87942e+12,57.5377,8989.13,23528,3545,72,28486,28486,26698,26981,18459
10381,145,208,10375,6,10381,0,6.14571e+18,188.702,1361.45,10381,121,123,9852,9177,7431,7521,7138
4540,111,170,4540,0,4540,0,6.00903e+18,152.84,793.618,4540,98,100,4090,3464,2791,2853,2940
24905,5242,9598,23728,1177,23728,1177,2.3601e+18,95.8694,11388.4,24905,4593,111,15307,15307,12731,15136,8829
37308,582,1086,0,37308,36246,1062,3.56097e+16,227.778,3649.35,37308,165,26,26337,25592,15449,7133,2287
19664,1352,4768,18522,1142,18522,1142,2.03734e+18,97.8707,6524.17,19664,2237,111,14896,14896,9263,11370,5155
28878,1774,10880,0,28878,0,28878,5.28073e+17,94.5803,12944.9,28878,5262,110,27800,27800,13894,12834,7124
41753,1706,39020,0,41753,13013,28740,2.3596e+15,3.99284,39120.6,41753,13025,9,40799,40799,40799,40799,40799
2286,28,114,0,2286,2221,65,3.56821e+16,19.1881,334.624,2286,33,26,2172,2156,1519,1519,834
31295,2780,8850,29585,1710,0,31295,2.08991e+18,96.9999,11292.2,31295,4293,110,22445,22445,15162,13940,9179
30134,9400,14258,30134,0,28844,1290,4.69285e+18,376.331,15825.9,30134,5291,135,28269,28269,26581,26347,24775
44200,8445,23836,0,44200,9561,34639,1.35741e+13,8.9512,24249.9,44200,21445,11,43913,43913,43913,43913,43913
18667,742,4776,0,18667,6623,12044,2.45936e+15,59.547,6249.35,18667,2319,72,13891,13891,6752,3992,2664
20309,1594,4785,19120,1189,0,20309,2.23375e+18,97.535,6621.56,20309,2312,110,21895,21895,14725,13378,5972
47436,12447,20934,0,47436,18423,29013,1.84244e+15,56.7714,23403.4,47436,10186,72,35529,35529,35529,35529,35529
47924,1537,19461,47924,0,45594,2330,4.80114e+18,1055.34,21726.8,47924,6661,141,44637,44637,40965,42099,30037
3189,2,11,3096,93,3187,2,1.41664e+14,10.0637,159.095,3189,11,11,1854,1328,1269,1321,1109
28229,4232,9156,26779,1450,26779,1450,3.13284e+18,96.2559,11313.7,28229,4433,110,29765,29765,21621,13990,11677
49539,8833,19523,47259,2280,47259,2280,2.82231e+18,95.3641,22594.2,49539,9487,110,41453,41453,41453,41453,41453
30258,4856,7048,28488,1770,0,30258,2.23526e+18,97.7898,9553.37,30258,3414,110,35658,35658,25800,19723,14487
29391,9,14,28533,858,29334,57,1.65345e+14,10.5457,560.008,29391,13,11,29048,28702,27794,27411,24023
36283,5402,15281,34672,1611,34672,1611,2.32051e+18,94.7529,17555.2,36283,7340,111,25002,25002,19011,14812,12280
12127,459,4518,0,12127,4550,7577,2.07962e+15,57.519,5445.42,12127,2195,72,7609,7465,3953,1794,1328
20134,732,7008,19134,1000,0,20134,1.90374e+18,95.688,8633.05,20134,3387,110,13126,12954,6979,5417,3183
22621,6389,9533,22621,0,21501,1120,5.45882e+18,192.577,10659,22621,3434,129,12036,12036,9437,6989,7200
22602,5406,10130,21652,950,0,22602,1.61225e+18,94.0425,11692.5,22602,4909,110,17814,17814,17814,17814,17814
46383,6,16,45035,1348,46293,90,1.58643e+14,10.4962,671.735,46383,14,13,20025,9592,6015,7157,3580
15545,336,6341,5935,9610,0,15545,7.64848e+12,57.1002,7415.53,15545,3083,72,9204,8964,5551,8574,1255
47293,7810,11571,16721,30572,0,47293,9.73859e+12,59.8883,14718.8,47293,5634,72,43300,43300,43300,43300,43300
14392,4348,4453,5253,9139,0,14392,8.94939e+12,58.6178,5589.32,14392,2163,72,32133,32133,24220,16801,14560
41862,6396,12117,0,41862,15128,26734,2.34395e+15,59.1556,14825.9,41862,5891,72,30642,30642,0,0,0
25911,10424,10428,9882,16029,0,25911,7.71317e+12,57.2942,12031.8,25911,5074,72,15483,15483,15476,15479,15476
34467,8,176,34400,67,34467,0,6.12843e+18,171.63,2299.06,34467,160,166,15145,13655,13383,13645,13321
27147,11107,12614,26034,1113,26034,1113,8.5529e+18,93.321,14336.6,27147,6064,111,23061,23061,20891,18737,18269
35563,538,9237,33548,2015,33548,2015,2.77154e+18,97.9395,11946.8,35563,4373,111,27882,27734,14482,9308,9226
28698,1144,12742,0,28698,11158,17540,1.83586e+15,56.6435,14386.7,28698,6198,72,21980,21980,8089,13360,5903
10632,180,4713,10632,0,10130,502,5.82981e+18,120.294,5439.37,10632,1279,119,5919,5505,2796,3676,721
43821,3677,14457,41591,2230,41591,2230,3.01778e+18,96.3433,17475.1,43821,7019,110,42519,42519,42519,42519,42519
45033,8746,10462,0,45033,15820,29213,2.52972e+15,60.0722,13530.7,45033,5084,72,40930,40930,40930,40930,40930
15147,12,14,14698,449,15102,45,1.8936e+14,10.487,402.47,15147,12,11,10158,3239,3468,7622,249
10991,164,773,0,10991,10670,321,4.47779e+16,80.5626,1966.93,10991,103,26,10218,10100,8611,7733,5562
21486,4410,7558,0,21486,0,21486,5.49162e+17,94.4588,9256.86,21486,3648,110,13928,13928,11258,10409,8404
5719,1,12,5549,170,5711,8,2.00315e+14,9.90628,226.748,5719,11,11,798,798,798,798,798
38081,3077,10839,36011,2070,0,38081,2.08116e+18,96.5479,13684.9,38081,5241,110,26132,26132,20481,21434,12986
22884,1594,5512,21551,1333,21551,1333,3.3268e+18,98.0279,7480.74,22884,2596,111,25580,25580,17210,18110,13923
42984,2984,16311,40955,2029,0,42984,1.80704e+18,95.5587,19105.4,42984,7921,110,13124,13124,12907,12810,12451
24608,3263,5734,8650,15958,0,24608,9.89314e+12,59.961,7612.24,24608,2783,72,30296,30296,19328,22279,11560
19356,5484,8221,7461,11895,0,19356,7.45857e+12,56.2509,9463.16,19356,3998,72,11135,11135,9711,10835,7509
26812,4585,6275,25249,1563,0,26812,2.23173e+18,97.6716,8554.98,26812,3034,110,46083,46083,46083,46083,46083
17111,438,735,0,17111,16622,489,3.65784e+16,63.2489,2052.56,17111,95,26,16376,16326,14885,15035,11933
1093,269,528,1047,46,1037,56,3.87445e+18,69.9076,681.96,1093,187,47,565,565,476,496,513
14048,355,3350,13228,820,0,14048,2.2297e+18,97.2519,4741.11,14048,1613,110,10698,10698,6659,6012,1899
49339,9313,11491,17340,31999,0,49339,9.87987e+12,60.0874,14798.3,49339,5591,72,22750,22750,17110,15767,11728
38393,4238,10151,36246,2147,0,38393,2.13951e+18,97.3442,13074.5,38393,4922,110,31388,31388,23911,15998,14371
32274,3018,7576,30394,1880,0,32274,2.22854e+18,97.7648,10208.5,32274,3665,110,24698,24698,17835,16214,10901
7340,26,199,7278,62,7340,0,5.9871e+18,171.781,1056.77,7340,117,117,28335,27221,21958,21526,4902
23074,574,1081,0,23074,22402,672,4.20466e+16,219.555,3244.18,23074,163,26,21993,21527,20697,20058,15693
17126,1139,4054,16126,1000,0,17126,2.23069e+18,97.4438,5671.28,17126,1952,110,16687,16687,16687,16687,16687
49338,7804,20111,47118,2220,0,49338,1.72442e+18,95.1528,23115.6,49338,9769,110,37460,37460,36640,36632,27753
22641,5618,11258,0,22641,0,22641,4.27727e+17,93.4041,12713.4,22641,5462,110,11383,11383,8516,7495,5592
23724,4933,10466,22714,1010,22714,1010,8.75103e+18,90.0748,12103.4,23724,5058,110,31665,31665,29995,28144,11319
15887,6,12,15424,463,15879,8,1.58836e+14,9.99119,368.274,15887,11,11,15172,14868,11889,11646,10644
10262,3624,5953,4230,6032,0,10262,5.46198e+12,47.0022,6563.72,10262,2877,72,4309,4309,3742,4189,2986
27821,320,1198,0,27821,27014,807,4.14666e+16,266.358,3717.15,27821,187,26,40533,39048,27447,29167,11845
3076,222,809,2896,180,2896,180,5.44419e+18,94.1772,1260.04,3076,365,71,2267,2267,1188,1547,915
10446,3679,3732,0,10446,3898,6548,2.12641e+15,57.6963,4577.97,10446,1809,72,6714,6714,6683,6654,6670
29598,266,935,0,29598,28753,845,3.54859e+16,181.327,2996.41,29598,135,26,26455,26455,22888,24454,20525
5191,668,1347,4891,300,0,5191,2.20561e+18,95.1688,2004.86,5191,629,89,17582,16903,9930,9575,591
16104,7,11,15644,460,16098,6,1.3892e+14,10.1585,354.622,16104,11,11,15513,15124,11932,11982,11657
49774,1024,11607,17493,32281,0,49774,9.8732e+12,60.0642,14936,49774,5641,72,49540,49540,49540,49540,49540
13145,718,972,0,13145,12756,389,5.02128e+16,194.069,2619.62,13145,141,26,12613,12613,12613,12613,12613
25851,7976,8225,0,25851,0,25851,5.76999e+17,96.3037,10256,25851,3979,110,18461,18461,17997,17997,17997
37394,9069,15870,14406,22988,0,37394,7.44512e+12,57.0219,17952.3,37394,7731,72,37034,37034,37034,37034,37034
20813,5,11,19119,1694,20757,56,1.14346e+14,8.3812,384.423,20813,11,9,18030,15803,12876,13268,12274
32589,362,7841,30691,1898,30691,1898,2.22607e+18,98.2341,10424.4,32589,3709,111,31323,31007,25265,25792,16426
43103,392,18858,0,43103,16706,26397,1.85615e+15,56.8233,21154.7,43103,9181,72,43481,42510,37981,35234,17576
22052,2002,7653,0,22052,8194,13858,2.15582e+15,58.0067,9169.27,22052,3721,72,14399,14399,9374,3162,3365
866,33,504,0,866,185,681,1.37103e+13,7.27714,551.025,866,448,11,45315,45315,44802,44812,44414
10407,5,11,10103,304,10401,6,1.66418e+14,10.0089,298.301,10407,11,11,18848,16693,16388,15840,11795
19228,3980,5097,0,19228,6871,12357,2.4328e+15,59.454,6591.08,19228,2483,72,24393,24393,11305,20102,8786
35550,4785,13711,35548,2,33740,1810,4.30126e+18,298.108,15510.2,35550,5877,130,34451,34451,34451,34451,34451
27534,113,176,27522,12,27534,0,5.98538e+18,169.465,1966.69,27534,160,164,44857,44814,44688,44608,43635
12002,1004,2892,0,12002,0,12002,6.49185e+17,96.9767,4126.43,12002,1389,110,9110,9110,5867,5212,3566
46145,78,176,46054,91,46145,0,6.05359e+18,173.798,2638.5,46145,170,172,33692,20428,31210,32004,16110
48357,9533,20384,46235,2122,46235,2122,8.48811e+18,94.7985,23285.9,48357,9903,110,34882,34880,32418,34106,28402
47748,324,1364,0,47748,46053,1695,1.14588e+16,7.94603,7421.17,47748,348,10,47544,47544,47544,47544,47544
34200,12,14,33225,975,34127,73,1.38894e+14,10.514,551.355,34200,13,12,16084,12061,12281,12062,10363
33898,12221,15772,32518,1380,32518,1380,9.12092e+18,94.1192,17845.4,33898,7657,110,32053,32053,32053,32053,32053
43226,479,1512,0,43226,41976,1250,3.97762e+16,294.407,5055.32,43226,249,26,43003,41426,32648,34273,14947
6535,652,3351,6285,250,6285,250,3.3377e+18,85.2571,3925.01,6535,1578,92,3184,3010,1872,2245,618
6249,1698,2031,6249,0,5882,367,2.96828e+18,93.1747,2608.46,6249,754,99,4218,4218,3995,4080,3845
23869,5137,5744,22477,1392,22477,1392,5.10656e+18,98.0605,7776.11,23869,2704,111,18125,18125,18125,18125,16717
30566,2055,8161,28846,1720,28846,1720,3.73063e+18,97.8315,10553.7,30566,3878,111,20865,20865,13265,19555,3509
43319,47,176,43228,91,43319,0,6.0738e+18,171.016,2574.27,43319,172,171,29809,13982,10601,13396,12533
48107,10526,17322,17987,30120,0,48107,8.24988e+12,58.0696,20108.9,48107,8437,72,47651,47651,47651,47651,47651
2523,64,671,2375,148,0,2523,2.23578e+18,92.5291,1060.3,2523,303,64,1294,380,1104,1008,185
49858,153,176,49773,85,49858,0,5.98192e+18,171.766,2645.19,49858,172,172,38783,38733,11534,7699,3101
48211,141,1537,0,48211,46822,1389,3.85166e+16,285.453,5256.53,48211,256,26,38785,32719,18475,24142,18440
30565,834,10317,11302,19263,0,30565,8.55762e+12,58.3585,12300.8,30565,5018,72,28950,28950,18264,8215,4426
39350,155,206,39333,17,39350,0,5.97968e+18,186.811,2426.75,39350,177,173,27839,27245,16681,14180,3197
18895,74,175,18826,69,18895,0,5.98079e+18,165.807,1627.35,18895,154,153,18564,4651,6961,4455,574
25476,7896,9031,0,25476,0,25476,5.4617e+17,94.3276,10957,25476,4358,110,16445,16445,16036,15791,15862
16092,5869,6233,6090,10002,0,16092,7.91619e+12,47.758,7366.48,16092,3024,72,9859,9859,9436,9769,8920
44169,6593,22274,0,44169,17638,26531,1.63419e+15,55.7532,24389.8,44169,10839,72,34462,34462,29762,33436,21940
6776,1080,2022,6406,370,6406,370,6.50521e+18,95.4427,2791.01,6776,966,94,4754,4754,4228,4150,2456
24292,961,1260,0,24292,23573,719,4.53015e+16,254.431,3797.91,24292,198,26,32986,32986,20758,18653,4347
46685,241,1257,0,46685,45353,1332,3.55789e+16,258.577,4395.41,46685,199,26,46623,46623,46623,46623,46623
27368,2,14,26575,793,27290,78,1.55188e+14,10.5641,525.723,27368,13,12,16032,11879,10002,11970,8015
31067,1535,1731,0,31067,30134,933,4.94687e+16,302.817,5350.81,31067,294,26,39189,39189,0,0,21491
39468,11361,17696,39468,0,37658,1810,4.6973e+18,469.926,19462.5,39468,7013,137,30874,30874,30874,30874,30874
33522,5,15,32538,984,33464,58,1.69866e+14,10.3034,579.325,33522,13,12,3279,1214,630,444,63
12340,923,2912,11615,725,11615,725,5.85419e+18,97.0562,4175.5,12340,1400,110,9428,9428,8921,8654,3581
19799,4616,4782,18641,1158,18641,1158,4.19264e+18,97.9789,6544.45,19799,2255,111,35321,35321,0,0,0
29994,338,948,0,29994,29137,857,3.5594e+16,186.413,3044.79,29994,137,26,26309,26309,21819,21091,16250
13463,1510,3193,0,13463,4731,8732,2.52989e+15,59.7142,4357.14,13463,1551,72,10270,10270,8087,6748,4898
30585,1047,7865,0,30585,0,30585,6.28714e+17,97.3527,10330.3,30585,3809,110,32784,32112,17299,16318,3444
4335,694,1590,4115,220,0,4335,1.9131e+18,93.1361,2104.1,4335,755,78,2745,2659,1756,1441,1018
45840,2702,10724,43170,2670,43170,2670,5.89535e+18,97.8933,14197,45840,5207,110,43928,43928,43928,43928,43928
28638,15043,16415,0,28638,6134,22504,1.37138e+13,8.88997,16727.6,28638,14767,11,31116,31116,30811,30638,30570
11299,9,13,10961,338,11255,44,1.91021e+14,10.5277,349.112,11299,12,11,11184,11100,10865,10313,8843
17367,3677,7389,0,17367,6689,10678,1.90279e+15,56.8408,8530.96,17367,3593,72,9978,9978,8060,7554,4983
23079,3405,7008,8399,14680,0,23079,9.02727e+12,58.8681,8656.59,23079,3414,72,16071,16071,13061,15425,8192
3283,11,13,3179,104,3247,36,2.25489e+14,10.6899,183.289,3283,12,11,3270,3268,3264,3265,3093
19536,2819,5213,18443,1093,18443,1093,6.35057e+18,96.9901,6943.5,19536,2521,110,14323,14323,13880,13880,9297
33791,1870,7903,0,33791,11875,21916,2.52637e+15,59.9995,10323.4,33791,3836,72,26710,26098,13361,15340,2953
34978,2726,8544,32968,2010,32968,2010,3.2256e+18,97.6608,11321.3,34978,4141,110,26434,26434,17414,22038,9180
49581,2348,20936,47401,2180,47401,2180,8.65872e+18,94.8724,23891.9,49581,10173,110,37868,37868,25318,14260,9579
17946,2288,4688,15317,2629,16926,1020,2.25112e+18,97.5681,6295.26,17946,2210,111,13258,13258,10905,11926,6938
45126,3664,14426,45126,0,42498,2628,5.01263e+18,316.269,16320,45126,5142,133,28016,28016,17754,11423,5217
5503,596,1631,5203,300,0,5503,2.08744e+18,90.3296,2296.39,5503,770,89,3872,3872,2385,2096,1283
26533,6440,14764,5712,20821,0,26533,53319800000,8.97339,15074.2,26533,13283,11,11769,11769,6582,11769,6255
25289,1024,1547,0,25289,5165,20124,1.47017e+16,11.9917,2060.88,25289,1041,14,23819,23615,10537,15485,2911
26860,3,11,26095,765,26851,9,1.39071e+14,10.1653,458.576,26860,11,11,20423,14380,16802,16026,11231
42767,6152,10323,40297,2470,0,42767,2.20801e+18,97.7677,13581.9,42767,5010,110,40515,40515,40515,40515,40515
4904,1,11,4758,146,4897,7,1.88147e+14,10.4419,205.665,4904,11,11,793,793,793,793,793
12253,2129,3022,11536,717,11536,717,2.04931e+18,97.4672,4249.13,12253,1418,111,37153,37153,36020,36736,34922
47854,1318,1414,0,47854,46483,1371,3.71822e+16,272.322,4888.02,47854,231,26,36497,36497,23872,21038,7788
4158,5,11,4035,123,4157,1,1.75059e+14,10.0226,188.699,4158,11,11,3855,3466,3063,2885,1840
33380,7659,9944,31600,1780,0,33380,2.04373e+18,91.3871,12473.5,33380,4811,110,23436,23436,21427,20596,18303
6436,351,2430,6436,0,6086,350,4.93894e+18,93.2118,2989.25,6436,960,101,4006,3913,1717,2647,877
3732,131,304,0,3732,3619,113,4.4505e+16,19.3794,742.239,3732,53,26,3428,3420,3090,3056,2573
30697,4819,7639,28940,1757,28940,1757,6.09247e+18,97.442,10131.9,30697,3703,110,27493,27386,27386,27386,27386
31799,3,12,30895,904,31783,16,1.386e+14,10.3862,505.882,31799,12,11,3541,2386,2073,2215,2069
4932,1094,1249,4642,290,4642,290,1.83491e+18,95.85,1883.02,4932,576,87,28763,29081,7106,5932,5522
31287,685,966,0,31287,30394,893,3.54933e+16,191.628,3133.88,31287,142,26,30321,29996,29164,29271,24457
42179,13988,20668,9252,32927,0,42179,52284300000,8.9909,21096.9,42179,18595,11,34153,34153,34153,34153,34153
44709,19253,21962,17762,26947,0,44709,6.57217e+12,55.8061,24142.2,44709,10692,72,44335,44335,44335,44335,44335
41035,4464,9628,38647,2388,38647,2388,5.89161e+18,97.8646,12807.3,41035,4668,110,32572,32572,29701,25804,24998
2273,68,967,0,2273,870,1403,2.03985e+15,54.4294,1219.64,2273,469,56,1306,773,33,33,253
6443,1375,1557,2257,4186,0,6443,9.84194e+12,59.0334,2224.32,6443,739,72,4886,4886,4710,4846,4564
14937,66,5054,14180,757,0,14937,1.9371e+18,92.5933,6366.19,14937,2426,110,6997,2103,2775,12961,11455
26601,2370,6284,25054,1547,25054,1547,3.23984e+18,97.6479,8545.89,26601,3032,110,47723,47723,47723,47723,47723
2679,346,712,2519,160,2519,160,2.45225e+18,93.7671,1117.61,2679,324,66,1967,1967,1536,1834,1233
10266,32,175,10261,5,10266,0,5.98776e+18,162.759,1202.37,10266,129,130,5272,1438,1654,1951,1845
42115,1448,16720,42115,0,40041,2074,4.35881e+18,469.509,18849.6,42115,7401,140,34092,34092,34092,34092,15273
40331,8992,9465,37981,2350,37981,2350,5.90052e+18,97.863,12598.5,40331,4593,110,31460,31460,31460,31460,31460
42703,13773,15228,15934,26769,0,42703,8.29295e+12,57.3051,17768.2,42703,7399,72,41808,41808,41808,41808,41808
46413,5542,14740,17002,29411,0,46413,8.80105e+12,58.7272,17591.8,46413,7178,72,33173,33173,26224,26246,20795
13605,2250,3222,4788,8817,0,13605,9.86269e+12,59.748,4398.87,13605,1560,72,0,0,6437,8195,3290
11947,2645,5604,11457,490,11457,490,6.92166e+18,93.8184,6543.66,11947,2674,108,6343,6343,4580,5058,3544
8966,189,208,8960,6,8966,0,6.11405e+18,183.824,1263.12,8966,116,122,8728,8628,8246,8214,8059
44265,14995,16485,16647,27618,0,44265,8.09619e+12,49.9764,19048.3,44265,8014,72,26216,26216,24910,26143,23697
32166,5523,11157,0,32166,0,32166,5.53681e+17,95.9825,13478.7,32166,5415,110,21009,21009,16737,15346,9624
35551,28,1347,0,35551,34522,1029,4.0266e+16,270.954,4362.67,35551,217,26,35486,35483,35325,35336,35047
4622,411,1947,4412,210,4412,210,4.19085e+18,82.1134,2454.51,4622,916,82,2675,2588,1550,1789,964
8576,1161,2104,8076,500,8076,500,5.92035e+18,96.5205,3063.79,8576,1007,106,6472,6472,6232,6232,3921
29533,7337,9811,28033,1500,28033,1500,7.31938e+18,96.1627,12024,29533,4756,110,17802,17802,11191,12824,8214
49199,4025,17227,18323,30876,0,49199,8.38317e+12,57.9323,20102.2,49199,8387,72,33467,33467,24529,17069,13980
12112,927,4333,11512,600,11512,600,4.92406e+18,95.7559,5422.28,12112,2062,111,7779,7692,4268,5233,3256
3331,403,854,0,3331,0,3331,6.59884e+17,94.1435,1332.87,3331,396,73,2477,2477,1880,1159,1442
32692,2,13,31749,943,32675,17,1.56115e+14,10.3108,535.158,32692,12,12,19090,14163,22857,23512,21394
38835,162,176,38776,59,38835,0,6.06754e+18,172.361,2432.35,38835,171,170,21709,19923,12276,3932,1023
16424,6756,16424,16424,0,0,16424,134210000,0,16424,16424,16424,1,0,0,0,0,0
23441,191,206,23368,73,23441,0,5.98847e+18,186.225,1890.23,23441,160,166,29391,29298,26379,26907,24787
26886,7269,8146,0,26886,0,26886,5.92023e+17,96.6306,10272.3,26886,3946,110,28379,28379,24436,19076,17499
6881,1590,2468,0,6881,2566,4315,2.14839e+15,57.4607,3085.82,6881,1196,72,4413,4413,4247,4147,4235
28225,6,199,28213,12,28225,0,5.98429e+18,182.559,2059.31,28225,168,171,6160,846,882,894,1013
8752,61,176,8746,6,8752,0,6.04487e+18,163.707,1154.65,8752,114,120,6451,4028,2810,3072,3066
8260,4,11,8021,239,8253,7,1.58458e+14,10.2806,263.972,8260,11,11,7176,6362,6077,6290,3930
3826,332,1031,0,3826,0,3826,6.40036e+17,93.9263,1554.7,3826,477,81,2795,2795,1740,1550,1259
14089,1569,4424,0,14089,0,14089,5.84639e+17,95.9535,5714.59,14089,2130,110,9665,9665,6212,6191,4552
10589,13,200,10586,3,10589,0,5.9951e+18,176.677,1262.46,10589,129,133,3151,479,666,675,658
9992,375,2937,0,9992,0,9992,6.01576e+17,90.3566,3963.62,9992,1398,110,7055,7055,1904,882,0
10859,2781,3552,3996,6863,0,10859,8.75875e+12,58.2543,4452.29,10859,1724,72,7307,7307,6460,7157,5621
29156,280,926,0,29156,28324,832,3.549e+16,176.996,2958.78,29156,134,26,26750,26750,7476,1614,1294
30382,6,176,30310,72,30382,0,5.98495e+18,169.768,2065.86,30382,164,166,37773,36662,34322,29706,20106
21403,9306,10272,20553,850,0,21403,1.5219e+18,93.5398,11707.4,21403,4979,110,11131,11131,11069,11022,11093
5755,1164,1933,5755,0,5425,330,4.07987e+18,92.853,2476.28,5755,723,97,3822,3822,3048,3360,2605
35521,16950,17655,0,35521,14138,21383,1.66072e+15,55.8357,19450.7,35521,8589,72,26111,26111,26111,26111,26111
44952,8155,17227,44952,0,39842,5110,1.54268e+18,4950.13,24764.4,44952,7782,24,27646,23686,23686,23686,23686
49067,10687,21513,46957,2110,46957,2110,3.92881e+18,93.894,24324.6,49067,10336,111,36978,36978,35989,36682,34883
12428,299,532,0,12428,12073,355,3.56288e+16,20.098,1480.53,12428,72,26,11896,11896,11279,11357,7512
28440,7904,12318,27204,1236,27204,1236,3.6357e+18,95.19,14179.5,28440,5913,111,16122,16122,11274,12296,9786
23591,3682,11297,22655,936,0,23591,1.52459e+18,93.694,12839.5,23591,5481,110,23191,24153,24153,24153,24153
37811,6305,8840,35604,2207,35604,2207,5.74759e+18,97.8279,11819.5,37811,4283,110,35006,35006,33476,33101,21632
15747,4086,6637,15047,700,15047,700,5.44096e+18,94.8986,7858.1,15747,3174,111,9110,9110,6270,6986,5304
18136,3492,6103,0,18136,0,18136,5.64147e+17,95.8193,7620.73,18136,2948,110,12033,12033,10353,9353,7844
13605,114,208,13594,11,13605,0,6.01184e+18,180.21,1490.47,13605,141,140,9055,4124,5197,2048,0
5627,970,5627,5627,0,5627,0,34353600000,0,5627,5627,5627,1,0,0,0,0,0
9949,212,636,9329,620,3055,6894,1.59745e+18,16.9682,1009.52,9949,417,19,36210,36093,10636,2023,1802
33128,4153,7781,31201,1927,31201,1927,5.89186e+18,97.7542,10466.4,33128,3765,110,25347,25347,24447,24447,14549
14567,569,718,0,14567,14148,419,3.7822e+16,46.5091,1924.93,14567,92,26,13849,13820,13137,13236,11278
38714,5444,10615,36556,2158,36556,2158,2.57879e+18,97.7914,13462.2,38714,5044,111,21742,21742,15163,5858,6097
12782,1284,5471,4931,7851,0,12782,7.44118e+12,56.695,6371.42,12782,2658,72,7311,7311,3956,6255,1893
35354,138,206,35343,11,35354,0,5.98693e+18,186.79,2301.62,35354,176,168,35678,35668,35654,35652,35615
36693,5209,14656,0,36693,13976,22717,1.98878e+15,57.4124,16777,36693,7138,72,35876,35876,35876,35876,35876
45290,10525,10550,42650,2640,42650,2640,3.34624e+18,97.8961,13993.5,45290,5110,110,32837,32837,32454,32452,28606
21908,352,5343,20635,1273,20635,1273,3.44087e+18,97.964,7240.86,21908,2517,111,16565,16565,7422,9368,2199
42785,8143,10044,0,42785,0,42785,6.46943e+17,97.8478,13329.2,42785,4865,110,42478,42478,42478,42478,42478
15435,2871,7733,0,15435,0,15435,3.43274e+15,17.9611,8084.08,15435,6948,20,26525,26525,26525,26525,26525
43580,85,176,43495,85,43580,0,5.99749e+18,173.505,2513.01,43580,171,173,26905,18545,22439,16503,14335
15323,684,1052,0,15323,3105,12218,1.45903e+16,11.9862,1447.78,15323,630,14,21990,21343,15694,10793,13245
32047,1004,7724,30197,1850,0,32047,2.20901e+18,97.6847,10327.2,32047,3743,110,29452,29452,12753,10480,3665
48622,4,12,47818,804,48494,128,9.83096e+13,3.99766,625.888,48622,8,4,10652,7437,7136,7456,6350
39257,21794,25434,34796,4461,0,39257,2.45316e+18,5.52633,29175.5,39257,8486,13,17251,17251,0,0,0
31917,3561,9036,0,31917,11495,20422,2.36365e+15,59.1925,11224.7,31917,4390,72,27213,27213,25816,25647,24549
18103,3432,4295,17053,1050,0,18103,2.22419e+18,97.3501,5982.08,18103,2066,110,444,444,279,193,0
8205,2395,3352,7825,380,7825,380,2.10185e+18,89.2127,4125.11,8205,1581,105,4853,4853,4357,4821,3960
26709,1498,6656,0,26709,0,26709,6.3522e+17,97.3926,8895.58,26709,3211,110,20053,20053,10381,7012,5385
23466,119,176,23392,74,23466,0,5.98285e+18,169.441,1817.11,23466,161,158,19941,19655,789,19710,89
29545,11404,15127,29545,0,28405,1140,4.66785e+18,511.349,16724.2,29545,6960,136,26496,26496,26496,26496,26496
1716,5,504,1616,100,1616,100,1.83238e+18,89.9936,788.698,1716,215,55,1180,784,390,980,23
27549,1529,7232,0,27549,0,27549,6.24259e+17,97.2082,9494.26,27549,3495,110,20317,20317,13669,7190,5902
32654,149,176,32574,80,32654,0,5.97806e+18,169.765,2140.93,32654,164,168,17045,15339,10159,8029,1734
31353,87,1374,0,31353,30437,916,4.28443e+16,268.434,4330,31353,223,26,19633,4996,7457,13560,840
25102,262,9786,0,25102,9512,15590,2.02083e+15,57.5008,11374.6,25102,4766,72,23501,23501,13199,622,889
9723,891,3692,9255,468,9255,468,2.95331e+18,94.6425,4603.14,9723,1779,107,6031,5863,2684,4018,1736
40394,7308,15400,38494,1900,0,40394,1.80064e+18,78.8688,18060.8,40394,7464,110,39920,39920,39920,39920,39920
38719,2557,9077,13617,25102,0,38719,9.87731e+12,60.0269,11777.5,38719,4416,72,29730,29730,17065,26011,11626
25856,65,1436,0,25856,25083,773,4.79065e+16,286.13,4350.07,25856,234,26,25777,15083,14537,3110,523
39554,146,176,39499,55,39554,0,6.05657e+18,173.237,2450.29,39554,168,170,33272,33009,21117,19553,16961
2232,424,611,2099,133,0,2232,2.26249e+18,91.6662,963.497,2232,274,59,1621,1621,1411,1444,1353
47516,4833,11115,44750,2766,0,47516,2.22761e+18,97.9028,14691.4,47516,5391,110,39425,39425,38947,38911,34693
46644,12083,16376,17377,29267,0,46644,8.37505e+12,58.2157,19125.7,46644,7975,72,30253,30253,27012,29578,21819
1505,263,437,1415,90,1415,90,2.4681e+18,89.8605,698.744,1505,193,52,1068,1068,914,1055,824
22974,1892,5353,8069,14905,0,22974,9.90652e+12,59.98,7131.15,22974,2605,72,17621,17621,12610,16753,6582
32128,5653,11419,32128,0,30351,1777,4.77381e+18,231.964,12890.1,32128,2274,136,31743,31743,31743,31743,31743
914,43,263,321,593,0,914,1.11395e+13,54.1805,414.2,914,127,42,550,165,326,500,178
30214,5477,10088,0,30214,0,30214,5.655e+17,96.1567,12330,30214,4896,110,34653,34653,26630,26643,16303
19733,1649,6540,19733,0,18590,1143,3.63179e+18,149.773,7614.78,19733,2062,125,13193,13098,8373,10040,3673
49329,640,1708,0,49329,47898,1431,4.01576e+16,300.957,5783.07,49329,290,26,36741,36483,20151,16268,11111
43772,923,13449,41465,2307,0,43772,2.01612e+18,96.1895,16542.8,43772,6528,110,42450,42450,41969,41900,39517
46749,4667,46749,46749,0,0,46749,134215000,0,46749,46749,46749,1,44722,44722,44722,44722,44722
33116,534,1908,0,33116,32117,999,5.0973e+16,303.493,5927.87,33116,325,26,31213,19892,12316,10710,2997
9546,604,9546,0,9546,0,9546,524233,0,9546,9546,9546,1,0,0,0,0,0
10016,2262,3586,9517,499,9517,499,4.2134e+18,95.5056,4530.98,10016,1694,111,6430,6430,4147,4550,3702
34518,11,15,33514,1004,34459,59,1.58555e+14,10.5748,616.733,34518,13,11,4475,1236,1022,1303,227
24262,5021,8472,23062,1200,0,24262,1.89785e+18,95.7603,10339.2,24262,4095,110,15790,15790,14001,24797,22853
12044,172,176,11971,73,12044,0,6.1086e+18,167.307,1357.27,12044,124,130,12545,12487,7528,11030,677
8390,140,208,8383,7,8390,0,6.05882e+18,185.851,1206.79,8390,120,120,13728,13728,13442,13512,7860
26215,194,8013,24816,1399,24816,1399,3.6172e+18,97.166,10054.4,26215,3821,111,23790,23714,22431,23064,21940
26779,41,175,26703,76,26779,0,5.97819e+18,166.959,1935.19,26779,160,164,46993,46956,46954,46951,46790
15335,22,32,15271,64,15335,0,1.11661e+18,31.9332,700.514,15335,32,32,10373,0,5749,10046,10373
17464,6435,7812,16724,740,16724,740,8.96788e+18,93.2499,9100.5,17464,3782,110,9652,9652,9622,9622,9565
16497,5774,7071,6367,10130,0,16497,7.4128e+12,56.765,8162.89,16497,3438,72,9426,9426,9019,9356,8788
11313,1254,3407,0,11313,4096,7217,2.30619e+15,57.2813,4364.09,11313,1637,72,7906,7906,6068,5134,3984
37362,1353,13227,0,37362,0,37362,5.46698e+17,95.9152,15812.9,37362,6420,110,28346,28127,22841,24920,19051
43112,2365,10111,0,43112,0,43112,6.47198e+17,97.8638,13417.1,43112,4901,110,22960,22960,9681,20270,6683
10502,1648,2517,3694,6808,0,10502,9.8653e+12,59.5685,3478.43,10502,1218,72,7985,7985,6944,7765,5352
33201,8,16,32211,990,33114,87,1.87311e+14,10.4816,630.379,33201,14,13,32653,32249,30245,26407,18463
2330,398,581,0,2330,818,1512,2.61201e+15,57.8571,894.944,2330,283,57,1749,1749,1491,1285,1336
26451,4864,7645,0,26451,9559,16892,2.35065e+15,59.1279,9517.67,26451,3724,72,33369,33369,33369,33369,33369
19633,3934,6103,18593,1040,18593,1040,2.03553e+18,96.2879,7738.81,19633,2886,111,13530,13530,11549,13392,8405
20613,1,14,20014,599,20536,77,1.65529e+14,10.7341,467.044,20613,14,12,4235,4235,4235,4235,4235
4868,150,175,4863,5,4868,0,5.98641e+18,153.887,831.001,4868,100,101,4635,4475,4151,4138,4100
23996,13,831,0,23996,23312,684,3.55123e+16,134.313,2533.73,23996,115,26,17552,14221,3050,11667,2284
18074,1059,4280,17021,1053,17021,1053,5.87851e+18,97.404,5960.86,18074,2064,110,13794,13794,12853,12215,4266
13486,3160,7244,0,13486,0,13486,3.47034e+15,15.9481,7556.78,13486,6504,20,6242,6242,3356,6242,3341
14973,4080,4552,14165,808,14165,808,2.40676e+18,96.8129,5894.46,14973,2159,111,44722,44722,44691,47069,0
17739,2126,4200,0,17739,0,17739,6.5048e+17,97.4413,5855.82,17739,2026,110,17650,17650,14054,8227,7397
7560,477,2703,7182,378,7182,378,7.40666e+18,88.2255,3484.09,7560,1279,103,0,12460,9288,7978,0
28674,3572,11708,27374,1300,27374,1300,3.72836e+18,95.5324,13645.1,28674,5611,111,28075,28037,28037,28037,28037
22468,105,176,22389,79,22468,0,6.10613e+18,171.183,1856.87,22468,151,148,35389,35068,9340,28002,632
19421,5627,7903,18541,880,18541,880,8.24132e+18,94.7497,9372.66,19421,3820,110,11518,11518,10836,10738,8455
9312,1528,2324,8773,539,8773,539,3.28547e+18,96.373,3340.19,9312,1099,110,6988,6988,6188,6749,4912
6910,105,175,6906,4,6910,0,5.95582e+18,159.257,988.094,6910,113,113,6184,4110,3927,4128,4193
6901,1214,1626,2429,4472,0,6901,9.96762e+12,59.4853,2330.84,6901,792,72,5275,5275,4690,5168,4162
30094,10277,13654,28834,1260,28834,1260,2.57712e+18,94.7107,15547,30094,6552,111,28192,28192,28192,28192,28192
20544,4725,10655,20544,0,13325,7219,4.96777e+18,222.083,11665.6,20544,3886,129,19828,19828,19828,19828,19828
36093,506,8667,33991,2102,33991,2102,4.15364e+18,98.2626,11463.4,36093,4088,111,29076,28813,16629,26914,999
16639,2793,8667,16639,0,10805,5834,4.04725e+18,197.378,9534.19,16639,3801,123,7972,7734,4246,5930,2195
28119,4046,8998,26661,1458,0,28119,1.98261e+18,96.3906,11157.5,28119,4364,110,48771,48771,48771,48771,48771
9709,596,2366,9142,567,9142,567,3.35858e+18,96.7717,3417.82,9709,1132,110,7343,7343,3846,5420,2435
27413,4,14,26623,790,27362,51,1.52571e+14,10.5993,524.708,27413,12,11,23941,21421,20546,19526,12516
26403,5312,6170,24863,1540,24863,1540,3.22329e+18,97.704,8427.49,26403,2984,110,20233,20233,19387,19980,17979
3328,1736,1770,3328,0,3328,0,2.44041e+18,16.9691,1918.36,3328,1581,20,1558,1558,1543,1558,1556
15826,143,176,15763,63,15826,0,6.15024e+18,168.638,1554.97,15826,133,136,15371,14453,12854,12914,12736
23586,77,826,0,23586,22910,676,3.55064e+16,130.739,2505.06,23586,113,26,22654,22602,14852,14730,5792
30011,4048,14757,30011,0,19649,10362,5.05712e+18,402.598,16176.3,30011,4875,134,21804,21804,18037,19286,15327
17604,154,175,17596,8,17604,0,5.98302e+18,165.641,1570.91,17604,151,151,19483,18920,7017,462,639
22843,10234,12085,22843,0,0,22843,8.86761e+17,17.9654,12501.8,22843,10864,20,10758,10758,9118,9637,9026
2730,55,147,0,2730,2653,77,3.71638e+16,19.1692,415.215,2730,35,26,2583,2583,2273,2294,1154
39542,2995,13395,37542,2000,37542,2000,5.27042e+18,95.8894,16092.8,39542,6398,111,30573,30573,28062,27652,17948
43278,2285,17589,43278,0,33851,9427,4.50204e+18,462.005,19495.4,43278,6373,139,32117,32117,16948,9919,9209
6078,2503,3069,5838,240,5838,240,7.06703e+18,90.281,3618.11,6078,1450,86,3009,3009,2678,2989,2551
24820,2955,11026,0,24820,0,24820,4.73504e+17,93.2551,12706.5,24820,5351,110,13794,13794,9240,5210,3956
36453,676,8490,0,36453,12815,23638,2.53465e+15,60.0488,11063.6,36453,4136,72,23948,23432,13053,10586,7177
30838,4731,11626,30838,0,29188,1650,4.97765e+18,226.079,13033.5,30838,2465,135,20117,21418,0,0,0
14664,5437,8340,3146,11518,0,14664,53464700000,8.94388,8563.34,14664,7498,11,24512,24460,17016,6325,4543
43655,14902,21075,41935,1720,41935,1720,2.53637e+18,92.0985,23528.8,43655,10239,110,41967,41967,41967,41967,41967
48538,7324,11312,17068,31470,0,48538,9.87968e+12,60.0715,14573.6,48538,5502,72,46976,46976,46976,46976,46976
5205,3845,5205,5205,0,5205,0,5.79454e+15,0,5205,5205,4741,2,0,0,0,0,0
41640,277,16658,41640,0,39530,2110,4.92879e+18,413.207,18447.4,41640,3897,137,39254,39062,35378,36077,33373
27224,9,11,26442,782,27214,10,1.4722e+14,10.1203,470.289,27224,11,11,5509,1200,982,1125,478
32326,7470,17621,0,32326,0,32326,3.85667e+17,92.7002,19391.6,32326,8555,110,21041,21041,18831,18616,15357
39781,3,17,38599,1182,39711,70,1.82692e+14,10.4588,693.445,39781,14,12,10066,530,339,1957,3362
39637,600,9269,37328,2309,0,39637,2.23068e+18,97.8395,12364,39637,4493,110,40492,40492,40492,40492,40492
27495,4313,12241,27495,0,26253,1242,4.87702e+18,317.237,13727.4,27495,2968,134,15254,15037,11248,11776,6565
5440,58,176,5402,38,5440,0,6.09681e+18,149.838,912.715,5440,96,99,3962,2512,1874,2037,1974
21961,6736,10769,0,21961,4818,17143,1.33845e+13,8.98944,11076,21961,9689,11,11192,11192,7990,8384,7615
40288,115,176,40221,67,40288,0,6.11598e+18,171.916,2486.84,40288,169,165,39438,38851,24434,26312,5831
34082,17712,18482,32892,1190,32892,1190,2.33081e+18,91.6516,20332.1,34082,8964,110,20388,20388,20388,20388,20388
23866,4640,5745,22476,1390,22476,1390,1.24352e+18,98.0325,7783.09,23866,2700,111,42807,42807,42807,42807,42807
12817,1578,3143,12068,749,12068,749,5.74709e+18,97.6303,4414.85,12817,1479,111,9674,9674,7546,8394,5599
38698,8240,15870,14806,23892,0,38698,7.61498e+12,57.2335,18054,38698,7728,72,34771,34771,34771,34771,34771
43028,8,16,41764,1264,42950,78,1.73793e+14,10.5111,698.951,43028,15,12,6039,1063,265,825,13
1146,255,354,1076,70,1076,70,5.78551e+18,85.2941,562.12,1146,155,45,792,792,772,772,706
40227,8744,21518,38805,1422,38805,1422,1.01741e+19,91.5788,23642.4,40227,10452,110,28751,28742,27578,28047,25659
18478,1229,5842,18478,0,17408,1070,3.70468e+18,144.063,7003.05,18478,2238,121,23209,23209,22999,23000,20952
27780,1739,10178,26440,1340,0,27780,1.84721e+18,94.9344,12208.1,27780,4923,110,28325,28325,28325,28325,28325
22588,77,997,0,22588,21932,656,4.02652e+16,199.901,2984.09,22588,147,26,21284,21198,14606,14092,4985
7068,3,10,6869,199,7064,4,1.39543e+14,9.8796,233.055,7068,10,10,5372,3801,4391,4190,2968
30585,1193,7133,28799,1786,28799,1786,5.73404e+18,97.7523,9659.47,30585,3445,110,24486,24486,10223,6755,1342
1650,373,480,1550,100,1550,100,1.20537e+18,90.0255,757.786,1650,204,53,1170,1170,1091,1163,1069
23021,711,1296,0,23021,22339,682,4.72987e+16,196.354,3849.43,23021,208,26,21725,21717,20291,20474,12254
34319,1979,14644,32819,1500,32819,1500,2.68923e+18,93.733,16851.6,34319,7095,110,23523,23193,12202,16209,4761
30103,24899,30103,30103,0,30103,0,8.7958e+12,0,30103,30103,30103,1,14329,14329,14329,14329,14329
17414,149,176,17406,8,17414,0,6.0249e+18,170.119,1604.92,17414,144,150,15890,15121,9160,2178,1505
31687,5635,10528,0,31687,11692,19995,2.20921e+15,58.4542,12582.9,31687,5128,72,24408,24408,20990,22868,19853
13103,1806,3144,0,13103,0,13103,6.45636e+17,97.0724,4465.77,13103,1507,110,9959,9959,8139,7227,6161
14765,7804,8531,0,14765,6092,8673,1.4086e+15,33.7504,9329.39,14765,4150,72,6234,6234,5345,4454,18980
40440,204,1187,0,40440,39285,1155,3.62302e+16,248.341,4029.4,40440,186,26,27918,27630,12084,4044,4188
33295,2894,8490,0,33295,11837,21458,2.46273e+15,59.6929,10825.1,33295,4136,72,35543,35543,35543,35543,35543
33941,2487,10675,32169,1772,32169,1772,3.0441e+18,96.5043,13185.7,33941,5169,110,19539,18820,13215,15104,7909
35041,8943,9042,33061,1980,33061,1980,6.08618e+18,97.4503,11782.1,35041,4386,110,30562,30562,30176,29980,29359
31290,9207,10134,31290,0,29469,1821,4.01627e+18,211.423,11589.7,31290,2854,133,27680,27680,27680,27680,27680
42011,1877,9827,0,42011,14767,27244,2.52882e+15,60.0475,12717.6,42011,4783,72,41970,41970,41970,41970,41970
21881,2,14,21255,626,21808,73,1.40924e+14,10.6367,445.898,21881,13,12,16275,15890,15900,15903,15871
22798,743,5378,8026,14772,0,22798,9.85905e+12,59.9113,7140.54,22798,2612,72,45096,44725,41447,38096,23737
17923,4130,4278,0,17923,6311,11612,2.51497e+15,59.7873,5729.96,17923,2072,72,13645,13645,13516,13575,13519
35834,7192,8376,0,35834,0,35834,6.49205e+17,97.8556,11236.3,35834,4061,110,27458,27458,25846,37057,35488
18268,633,4289,0,18268,6425,11843,2.52304e+15,59.8434,5771.77,18268,2075,72,18006,18006,18006,25425,25425
13335,1133,3608,4769,8566,0,13335,9.42547e+12,59.2458,4729.87,13335,1750,72,9727,9727,5808,8673,3936
29125,30,61,29061,64,29125,0,2.34365e+18,60.7532,1263.45,29125,61,61,20754,13868,0,0,0
34996,285,1497,0,34996,33972,1024,4.29657e+16,287.6,4788.85,34996,248,26,33289,32534,28343,24273,9800
33491,5729,8513,31591,1900,0,33491,2.17081e+18,97.4691,11169.8,33491,4123,110,24978,24978,21602,20927,17695
8261,1114,1938,2905,5356,0,8261,9.93747e+12,59.5543,2745.89,8261,941,72,47524,0,0,0,0
29746,6872,6907,0,29746,10441,19305,2.53369e+15,60.0196,9093.61,29746,3359,72,48063,48063,48063,48063,48063
34467,569,1029,0,34467,33488,979,3.55595e+16,212.244,3404.9,34467,154,26,33438,33037,28408,29107,22404
30321,919,1295,0,30321,29438,883,4.19831e+16,270.323,4073.55,30321,208,26,40649,40649,40575,40367,33567
9052,4020,8463,9052,0,8459,593,9.9454e+17,3.96918,8507.7,9052,2825,10,589,589,277,455,284
22394,2836,5388,21084,1310,21084,1310,3.38918e+18,98.0566,7323.91,22394,2540,111,11450,11450,4938,7299,3284
2324,89,170,2324,0,2324,0,5.99331e+18,137.372,567.867,2324,77,71,1909,1170,1109,1178,1145
38630,4285,8992,13575,25055,0,38630,9.89268e+12,60.0503,11693.2,38630,4374,72,41550,41550,41550,41550,41550
5019,264,1266,0,5019,1768,3251,2.5122e+15,58.8107,1813.42,5019,610,72,3753,3753,2414,813,943
27525,12,13,26720,805,27508,17,1.65265e+14,10.3216,496.514,27525,12,12,27512,27512,27337,27338,27126
31185,5533,11063,0,31185,0,31185,5.47303e+17,95.8206,13306.8,31185,5366,110,20122,20122,17114,12943,12249
15382,52,176,15369,13,15382,0,6.07544e+18,169.232,1533.95,15382,138,135,19815,4509,14136,6282,2120
6734,2,11,6543,191,6729,5,1.3986e+14,10.3865,230.528,6734,11,11,3900,2771,2659,2793,1891
42597,23,176,42465,132,42597,0,6.11591e+18,173.537,2556,42597,167,168,21657,14954,16086,14498,14364
46316,13808,14766,46316,0,43617,2699,4.20603e+18,322.882,16696.3,46316,3983,134,10307,10029,9993,9961,9961
26083,4485,6105,24563,1520,0,26083,2.2318e+18,97.6783,8339.39,26083,2947,110,33046,33046,30801,24818,16999
46369,5254,10830,0,46369,16299,30070,2.52717e+15,60.0465,13967.2,46369,5262,72,46126,46126,46126,46126,46126
24737,139,846,0,24737,24033,704,3.55176e+16,141.568,2598.04,24737,118,26,23823,23709,16573,16544,7822
4460,327,1111,0,4460,0,4460,6.48911e+17,95.054,1711.19,4460,515,83,39617,0,0,13640,7670
9050,844,2501,8550,500,0,9050,2.12372e+18,95.9692,3472.23,9050,1190,107,6549,6549,4702,4273,2926
37926,6269,8825,0,37926,13332,24594,2.53369e+15,60.0613,11488.1,37926,4292,72,39888,39888,39888,39888,39888
27124,13,15,26326,798,27068,56,1.73073e+14,10.5952,556.107,27124,13,11,5605,2825,2446,2847,2201
37687,8,14,36597,1090,37602,85,1.56829e+14,10.4588,630.037,37687,13,12,8525,1739,1954,1729,1730
16593,509,3896,5833,10760,0,16593,9.92862e+12,59.8569,5267.6,16593,1898,72,12697,12697,4914,10543,1901
17054,67,176,16981,73,17054,0,6.07633e+18,169.985,1614.04,17054,139,143,27429,27337,27303,27280,27269
43089,10951,18285,16599,26490,0,43089,7.43677e+12,57.0328,20619.7,43089,8906,72,49077,49077,49077,49077,49077
39076,9319,11215,0,39076,14099,24977,2.35158e+15,58.7928,13784.7,39076,5443,72,27368,27368,23087,24006,20998
22135,3823,5213,20845,1290,20845,1290,3.2304e+18,97.546,7177.29,22135,2508,110,16922,16922,15487,16518,13249
40122,171,1189,0,40122,38976,1146,3.63467e+16,243.151,4027.84,40122,186,26,27129,26263,10177,6704,2239
43987,12146,14939,41777,2210,0,43987,1.92232e+18,96.071,17928.9,43987,7252,110,29048,29048,27551,26907,25345
3024,174,176,3022,2,3024,0,6.02558e+18,138.965,669.939,3024,85,81,2848,2848,2845,2846,2847
23275,10,14,22599,676,23197,78,1.59779e+14,10.6501,495.65,23275,13,12,9594,2304,2501,1870,1841
25654,1081,8398,0,25654,0,25654,5.68421e+17,96.1328,10395,25654,4058,110,17256,17256,11029,3936,3938
32675,14999,19680,31675,1000,31675,1000,4.75717e+18,92.7198,21266.5,32675,9520,111,28816,28816,28816,28816,28816
17162,625,706,0,17162,16673,489,3.5546e+16,33.5993,1968.43,17162,90,26,16456,16442,16311,16319,15267
49544,3596,11582,46664,2880,0,49544,2.2264e+18,97.905,15281.8,49544,5609,110,48974,48974,48974,48974,48974
6630,2166,2592,0,6630,0,6630,5.20508e+17,85.6738,3276.8,6630,1221,95,19191,19191,19191,19191,19191
11377,11,13,11048,329,11341,36,1.50003e+14,10.9133,334.744,11377,12,11,11364,11362,11074,11075,10224
42664,38124,42664,42664,0,0,42664,134215000,0,42664,42664,42664,1,45224,45224,45224,45224,45224
35494,87,8332,33433,2061,33433,2061,3.23023e+18,97.7602,11168.7,35494,4027,110,23472,7612,10602,17926,1245
38702,227,1420,0,38702,37582,1120,4.01566e+16,284.09,4667.92,38702,231,26,36956,36411,31084,28023,11181
23858,176,1328,0,23858,23148,710,4.72854e+16,188.917,3967.36,23858,214,26,13917,12798,6485,3523,1507
18910,5131,6751,0,18910,7047,11863,2.12882e+15,57.9549,8078.83,18910,3286,72,18863,18863,17697,17087,16492
7187,1620,1692,2522,4665,0,7187,9.92571e+12,59.5061,2421.47,7187,817,72,25084,24997,14620,21382,5766
21276,1022,7100,16823,4453,20186,1090,2.36985e+18,96.5869,8792.3,21276,3386,111,14176,14021,7078,9014,3139
35730,846,8371,0,35730,0,35730,6.47994e+17,97.797,11221.8,35730,4053,110,35250,35250,35250,35250,35250
10420,584,2523,0,10420,0,10420,6.51587e+17,96.8911,3632.3,10420,1210,110,7897,7897,5241,3511,2201
28071,1363,1556,0,28071,27237,834,4.85518e+16,291.236,4759.39,28071,260,26,21414,21414,11381,14619,5720
46222,12023,13867,46222,0,43524,2698,4.21394e+18,319.036,16124.5,46222,4015,134,0,0,14997,14997,14997
26175,5089,8529,26175,0,24645,1530,3.53337e+18,168.409,9817.23,26175,3113,125,17680,0,6203,15422,4747
6305,643,2147,0,6305,2331,3974,2.20672e+15,51.855,2740.44,6305,1040,72,4158,4158,2347,732,0
35198,70,1183,0,35198,34187,1011,3.78201e+16,247.965,3878.85,35198,185,26,33965,18935,16124,18860,17570
13325,3702,5682,12736,589,12736,589,2.81677e+18,94.2424,6766.29,13325,2750,110,7643,7643,6029,6622,5764
4267,49,2010,4267,0,4067,200,3.64593e+18,91.5641,2399.88,4267,837,77,1328,293,637,1074,414
6557,2705,3049,6557,0,5048,1509,5.96331e+18,91.4499,3533.22,6557,653,94,3508,3508,3508,3508,3159
41167,691,10232,38817,2350,0,41167,2.1847e+18,97.629,13376.3,41167,4960,110,21977,21972,623,21889,635
32169,6866,11310,11972,20197,0,32169,8.36853e+12,58.1375,13341.8,32169,5507,72,20859,20859,17479,20279,13572
35455,3,12,34441,1014,35441,14,1.38868e+14,10.1332,529.205,35455,12,11,2527,950,398,427,173
28264,374,1076,0,28264,27448,816,3.88179e+16,229.387,3374.19,28264,163,26,27172,26731,21604,22188,13955
19134,4,14,18573,561,19084,50,1.67349e+14,10.6016,453.083,19134,13,11,2540,1140,532,669,182
49303,408,3060,15112,34191,15112,34191,2.11749e+18,15.9933,3887.26,49303,2022,18,31260,30142,20428,10601,6144
23176,9396,10622,22218,958,22218,958,9.01187e+18,94.0387,12189.1,23176,5150,110,19474,19474,19474,19474,19474
18953,8,11,18412,541,18947,6,1.4076e+14,10.2343,387.333,18953,11,11,2905,862,673,459,138
18641,57,176,18630,11,18641,0,6.09695e+18,170.09,1688.63,18641,141,149,16728,4063,4354,12277,117
29761,47,176,29682,79,29761,0,6.03983e+18,171.728,2119.08,29761,164,164,18390,3975,8820,599,1380
14444,1197,3458,13604,840,0,14444,2.22684e+18,97.1731,4875.34,14444,1662,110,10986,10986,7278,6738,4508
49144,3071,11492,0,49144,0,49144,6.47787e+17,97.9034,15163,49144,5576,110,31817,31817,27695,23788,18166
34872,7583,8139,0,34872,12256,22616,2.53115e+15,60.0116,10620.5,34872,3956,72,27621,27621,27621,27621,27621
14722,6551,14722,0,14722,14722,0,2047.86,0,14722,14722,14722,1,0,0,0,0,0
31261,4501,7404,11003,20258,0,31261,9.85211e+12,59.9547,9667.47,31261,3602,72,23332,23332,18222,20965,10017
16385,948,3902,15435,950,0,16385,2.22569e+18,97.2821,5466.22,16385,1866,110,0,0,0,0,0
35477,106,176,35403,74,35477,0,5.98566e+18,169.495,2230.39,35477,171,168,19917,19162,11721,1314,1669
27079,5155,9458,10072,17007,0,27079,8.40486e+12,58.1423,11234.6,27079,4600,72,29371,29371,29371,29371,29371
1513,244,1178,1483,30,0,1513,8.00688e+17,77.5744,1287.03,1513,532,43,335,249,194,156,290
6988,691,1757,6588,400,6588,400,5.97498e+18,95.929,2582,6988,822,96,5231,5231,4991,4991,2584
15371,1044,3742,14473,898,14473,898,3.71425e+18,97.7799,5198.8,15371,1763,111,11629,11629,7266,8837,3845
12855,4172,4352,12855,0,12113,742,4.87703e+18,106.05,5168.63,12855,1554,120,11878,11878,11878,11878,11878
11680,703,5662,11680,0,11151,529,4.68309e+18,126.67,6350.85,11680,2396,117,34427,34427,34427,34427,34427
32049,4151,7483,0,32049,11266,20783,2.53696e+15,60.0161,9798.15,32049,3645,72,24566,24566,20565,15173,13938
7837,175,176,7831,6,7837,0,6.10679e+18,161.891,1096.8,7837,112,111,35165,0,0,0,0
36915,5695,14975,35232,1683,35232,1683,2.00317e+18,95.719,17328.4,36915,7193,111,40736,40736,40736,40736,40736
27572,1098,7833,26069,1503,0,27572,2.08726e+18,96.8934,10043.9,27572,3794,110,19739,19739,12388,10745,3629
3076,412,1034,0,3076,1128,1948,2.26161e+15,56.8274,1385.47,3076,498,60,2042,2003,1099,855,377
35505,7326,8283,0,35505,12482,23023,2.52891e+15,60.0334,10803.5,35505,4030,72,27222,27222,25917,25995,24548
19753,2495,6136,18713,1040,0,19753,2.01481e+18,96.3085,7802.86,19753,2964,110,40944,40944,40944,40944,40944
20354,886,7104,0,20354,7571,12783,2.15756e+15,58.1054,8524.47,20354,3454,72,13250,13182,7848,3163,1440
17529,1168,4264,16508,1021,16508,1021,1.31069e+18,97.8314,5871.22,17529,2007,111,13265,13265,12418,12604,4491
20945,5028,6490,0,20945,7641,13304,2.28353e+15,57.9234,8011.5,20945,3144,72,27549,27549,18308,9785,7940
14312,727,953,0,14312,0,14312,3.74645e+18,15.9787,1390.44,14312,592,18,13359,13359,11393,11477,11071
37011,5480,8631,0,37011,12999,24012,2.52977e+15,60.0397,11240.2,37011,4197,72,18130,18130,12293,17105,5422
15808,647,1004,0,15808,15338,470,4.70508e+16,208.652,2800.02,15808,150,26,14804,14432,13551,13757,10984
40976,3089,17993,40976,0,39488,1488,4.8288e+18,3116.24,21616.1,40976,7884,150,29161,29161,23354,22447,18588
43204,7241,10062,40684,2520,0,43204,2.23227e+18,97.9118,13380.8,43204,4879,110,42040,42040,42040,42040,42040
45754,2726,10715,0,45754,0,45754,6.47131e+17,97.8766,14183.7,45754,5195,110,45322,45322,45322,45322,45322
19391,6,10,17818,1573,19388,3,1.13949e+14,7.97416,349.659,19391,10,8,18324,16249,17815,17815,16711
20747,45,176,20735,12,20747,0,6.04452e+18,170.957,1767.56,20747,155,152,12997,5529,4608,5524,5097
13240,384,3124,0,13240,0,13240,6.48773e+17,97.1164,4460.73,13240,1498,110,10116,10116,3873,2200,1855
43248,419,1193,0,43248,42016,1232,3.55856e+16,249.265,4119.36,43248,187,26,39135,39135,30459,36795,0
12750,2109,3138,12010,740,12010,740,4.03412e+18,97.5052,4406.45,12750,1466,111,39295,39295,34892,37552,34388
20124,2986,5847,0,20124,0,20124,6.02899e+17,96.6893,7576.44,20124,2829,110,14277,14277,11735,11477,7707
28841,4406,7242,0,28841,10231,18610,2.47497e+15,59.7274,9329.64,28841,3527,72,25275,25275,19078,15405,11671
8153,1101,2019,7680,473,0,8153,2.22249e+18,96.358,2940.98,8153,961,104,6134,6134,4888,4651,3673
26076,686,901,0,26076,25333,743,3.6178e+16,162.79,2800.77,26076,129,26,25175,24928,24371,24409,20850
26413,3613,6207,9281,17132,0,26413,9.87078e+12,59.9603,8189.27,26413,3020,72,27415,27415,20398,22428,9572
35004,7550,8205,32964,2040,0,35004,2.22769e+18,97.7915,11010.1,35004,3972,110,30936,30936,29843,29682,29090
30369,2698,16201,6580,23789,0,30369,52926100000,8.97339,16545.4,30369,14572,11,21577,21491,14630,12896,6169
39238,5702,9223,36958,2280,36958,2280,5.90296e+18,97.829,12294.2,39238,4469,110,33743,35256,0,0,0
30897,2619,7254,0,30897,0,30897,6.4847e+17,97.7595,9798.37,30897,3515,110,23757,23757,17408,20854,10531
43416,3425,15733,43416,0,41056,2360,4.53528e+18,296.661,17535,43416,3587,136,35856,35856,30143,34704,23182
16731,28,176,16720,11,16731,0,6.01668e+18,167.77,1561.59,16731,149,147,18568,3186,6856,16434,97
24852,2890,8773,9254,15598,0,24852,8.33812e+12,58.0684,10428.6,24852,4263,72,16079,16079,8738,14189,3216
47419,179,1855,0,47419,46033,1386,4.25425e+16,304.975,6167.26,47419,317,26,47194,47194,47192,47194,46975
27678,7572,9636,0,27678,0,27678,5.5231e+17,95.8566,11701.3,27678,4670,110,18042,18042,16167,14832,14306
40048,448,9355,37718,2330,0,40048,2.22928e+18,97.8349,12479.8,40048,4529,110,30546,29687,12627,19662,1314
35170,832,1041,0,35170,34167,1003,3.55473e+16,215.491,3462.03,35170,157,26,34129,34129,32724,32948,29965
25242,6750,8233,9282,15960,0,25242,8.68033e+12,58.488,9963.38,25242,3997,72,28920,28872,25979,28410,22535
6937,335,1640,2428,4509,0,6937,9.95657e+12,59.4541,2346.39,6937,797,72,5297,5297,3372,4963,1165
39663,2,14,38534,1129,39584,79,1.38804e+14,10.5374,609.464,39663,13,12,22969,16268,15864,16870,11959
16642,615,774,0,16642,16165,477,3.81634e+16,91.0669,2149.05,16642,104,26,15868,15773,15401,15425,12688
22733,3325,5531,21413,1320,21413,1320,5.08063e+18,97.9959,7488.98,22733,2612,111,19433,19433,19433,19416,11281
34659,7250,8317,32639,2020,32639,2020,2.83417e+18,98.2809,11029.2,34659,3938,111,34176,34176,34176,34176,34176
21907,4766,10981,0,21907,8739,13168,1.64744e+15,53.6602,12206.8,21907,5334,72,17180,17180,17180,17180,17180
37928,1462,1839,0,37928,36803,1125,4.66357e+16,322.233,5856.78,37928,317,26,37907,37907,37907,37907,37907
48634,13654,14462,0,48634,0,48634,5.95069e+17,96.9036,17859.1,48634,7026,110,29738,29738,27043,23336,22566
5704,740,1820,5404,300,0,5704,2.01887e+18,87.4081,2486.94,5704,845,92,3884,3884,3155,3039,2624
24099,6209,7814,0,24099,0,24099,5.72748e+17,96.2104,9726.05,24099,3782,110,19478,19478,19478,19478,19478
1426,230,862,594,832,0,1426,5.95222e+12,29.8724,1000.71,1426,413,40,564,564,162,74,0
38874,297,2528,37294,1580,11975,26899,1.24374e+18,16.9946,3285.19,38874,1328,27,38578,38578,38578,38578,38578
31830,2160,8539,11390,20440,0,31830,9.44481e+12,59.4884,10761.8,31830,4159,72,23291,23291,13986,20520,6148
14704,1507,3592,13844,860,13844,860,2.20801e+18,97.6829,4999.46,14704,1685,111,26327,26327,14432,21926,3210
41581,7107,18217,41581,0,39948,1633,4.54822e+18,2625.73,21369.2,41581,5841,142,24261,21191,17229,16450,12762
6153,40,170,6149,4,6153,0,5.97325e+18,157.462,924.094,6153,109,109,3511,1227,1202,1488,1351
19346,6723,7961,18476,870,0,19346,1.7212e+18,94.7155,9420.16,19346,3859,110,11385,11385,10507,10265,9975
15896,221,741,0,15896,15441,455,3.76154e+16,66.1602,2033.71,15896,96,26,24849,23741,3141,18613,2329
5748,234,1425,5418,330,5418,330,5.88146e+18,95.4953,2143.44,5748,661,90,4323,4323,3854,3551,1055
3384,5,10,3288,96,3384,0,1.49305e+14,9.82595,163.698,3384,10,10,3125,2786,2717,2499,1975
39615,14226,14765,37725,1890,0,39615,1.82663e+18,95.6335,17409.1,39615,7168,110,41877,41877,41877,41877,41877
3214,861,1188,0,3214,0,3214,5.54134e+17,79.4642,1607.29,3214,537,65,2026,2026,1654,1679,1445
27273,4397,6393,0,27273,9590,17683,2.53484e+15,59.9736,8424.59,27273,3114,72,20880,20880,18435,15371,14462
33232,6278,13493,0,33232,12698,20534,1.96262e+15,57.0334,15440.8,33232,6567,72,18664,18664,11549,12000,11374
2796,1046,1528,2696,100,2696,100,1.00075e+19,88.176,1826.16,2796,718,60,1268,1268,1248,1248,1222
20995,3543,7053,19928,1067,0,20995,1.94087e+18,95.9288,8748.19,20995,3416,110,20578,20578,20578,20578,20578
44817,2,16,43505,1312,44750,67,1.69273e+14,10.4119,724.269,44817,13,12,22973,17093,14599,13592,9755
12195,2,12,11829,366,12181,14,1.95082e+14,10.0402,331.194,12195,11,11,1540,0,0,771,20
40769,151,176,40706,63,40769,0,5.9816e+18,169.844,2390.99,40769,169,171,34093,33670,29946,27845,22014
22024,201,827,0,22024,21398,626,3.63233e+16,125.569,2464.64,22024,114,26,27595,27595,27595,27595,27595
29503,9950,10981,29503,0,27953,1550,4.00182e+18,226.601,12533.7,29503,4582,125,21613,21613,0,0,12788
17443,126,176,17430,13,17443,0,6.01548e+18,167.355,1605.55,17443,142,150,16518,15203,12578,12598,12450
21626,409,793,0,21626,21011,615,3.56523e+16,111.035,2355.66,21626,107,26,20833,20714,19348,19433,13198
31715,80,176,31697,18,31715,0,6.00299e+18,170.86,2146.85,31715,168,166,31147,24710,8261,99,0
30696,5657,8993,29046,1650,29046,1650,6.59271e+18,96.8167,11377.1,30696,4360,110,23602,23602,23111,22818,22808
33143,2494,7743,11652,21491,0,33143,9.8736e+12,60.008,10124.1,33143,3766,72,40608,40608,40608,40608,40608
27268,126,176,27242,26,27268,0,6.08009e+18,171.833,2041.38,27268,161,158,22320,15960,16692,11014,10438
27152,456,1060,0,27152,26367,785,3.90436e+16,216.628,3300.18,27152,161,26,21800,21800,9725,13997,2692
24221,19,176,24170,51,24221,0,6.07125e+18,171.431,1924.08,24221,152,158,8791,826,0,4253,725
15636,3357,8167,15636,0,15009,627,3.9187e+18,157.774,9045.46,15636,3672,125,7469,7467,4703,5682,2647
9155,1419,2211,3226,5929,0,9155,9.86351e+12,59.5132,3074.35,9155,1076,72,6944,6944,6083,6757,4808
28071,4046,6620,26441,1630,0,28071,2.22567e+18,97.6932,8982.12,28071,3194,110,21451,21451,18025,17334,14018
33277,5062,7783,0,33277,11695,21582,2.52621e+15,59.9829,10173.2,33277,3778,72,33484,33484,27202,21562,16696
19002,726,6268,19002,0,17892,1110,3.72509e+18,145.077,7318.33,19002,2275,121,12734,12650,6207,9216,2007
32241,1513,1609,0,32241,31286,955,4.64248e+16,300.848,5031.15,32241,270,26,26869,26869,21502,16895,15449
19696,5956,6574,0,19696,0,19696,5.65153e+17,95.9192,8197.4,19696,3178,110,15455,15455,15455,15455,15455
29443,8919,13287,0,29443,11476,17967,1.81156e+15,56.5162,14944.8,29443,6463,72,14778,14778,10217,14074,6258
34007,4844,10324,0,34007,0,34007,5.89179e+17,96.6732,12871.9,34007,5005,110,38745,38745,38745,38745,38745
7641,626,1853,0,7641,0,7641,6.45863e+17,96.1616,2739.33,7641,872,101,5788,5788,4140,2585,2406
41803,2019,2695,12867,28936,12867,28936,2.08053e+18,15.9965,3458.78,41803,1635,26,23024,23024,12264,4081,3059
33241,10,15,32264,977,33178,63,1.76086e+14,10.4377,617.721,33241,13,11,33134,32984,28467,27875,24331
16061,2727,9854,15584,477,15584,477,1.12804e+19,91.2806,10785.6,16061,4776,104,39419,39333,38928,0,0
48534,282,17029,0,48534,18068,30466,2.14118e+15,58.1652,19870.7,48534,8290,72,42873,42529,40398,38759,38816
5200,112,1284,4897,303,4897,303,3.2408e+18,95.3708,1950.63,5200,595,88,20866,5421,7432,4410,927
40052,170,176,40031,21,40052,0,6.0186e+18,172.597,2436.55,40052,168,170,39759,39532,38693,38731,38621
37687,8289,8771,13253,24434,0,37687,9.89244e+12,60.0675,11420,37687,4269,72,36223,36223,36223,36223,36223
47059,1040,10964,16547,30512,0,47059,9.88925e+12,60.0881,14143.8,47059,5337,72,37105,36928,29663,32417,24295
33900,7810,17618,32660,1240,0,33900,1.40128e+18,89.9555,19531.1,33900,8542,110,37765,37765,37765,37765,37765
18461,247,731,0,18461,17933,528,3.55741e+16,60.3228,2080.05,18461,95,26,17730,17685,15871,15956,8250
42446,11651,14063,40273,2173,40273,2173,4.95834e+18,86.4506,16938.1,42446,6706,111,42229,29398,29321,29420,28580
22571,128,176,22519,52,22571,0,6.09226e+18,169.284,1858.98,22571,155,153,21490,19919,16464,16541,16583
48406,3,15,47016,1390,48353,53,1.46366e+14,10.3548,665.603,48406,13,12,2483,650,492,367,96
22080,415,7254,22080,0,20794,1286,3.30683e+18,156.91,8409.8,22080,2637,122,12001,12001,9097,11518,5615
46000,57,61,45904,96,46000,0,2.33474e+18,60.8383,1597.04,46000,61,61,20922,5862,9199,6429,163
17433,2793,4140,0,17433,0,17433,6.45444e+17,97.3175,5778.78,17433,1984,110,45012,45012,43202,42145,41237
26307,2745,11525,10205,16102,0,26307,7.2581e+12,56.2681,13073.5,26307,5609,72,35219,35219,35219,35219,35219
34580,6935,8302,32569,2011,32569,2011,5.29467e+18,98.26,11010.3,34580,3934,111,21910,21754,18466,20277,12757
28975,7291,9450,28975,0,27293,1682,3.33137e+18,180.11,10824.4,28975,3350,129,24587,29168,1688,1688,1688
49762,690,13263,0,49762,0,49762,6.19618e+17,97.3104,16848.9,49762,6426,110,49495,49495,49495,49495,49495
38669,2528,9035,0,38669,0,38669,6.47917e+17,97.8374,12071.9,38669,4374,110,39636,39636,39636,39636,39636
7103,177,653,0,7103,6892,211,4.79944e+16,19.1542,1525.14,7103,84,26,6450,6446,5005,5456,2540
26840,2402,6236,0,26840,9435,17405,2.53666e+15,60.0291,8249.78,26840,3034,72,20604,20604,14235,12702,8322
13415,2333,4904,0,13415,0,13415,5.39352e+17,95.0756,6080.01,13415,2364,110,13150,13150,13150,13150,13150
43168,12899,13900,40928,2240,40928,2240,2.21379e+18,97.0665,16843.2,43168,6646,111,36542,36542,36542,36542,36542
20324,858,5986,19224,1100,19224,1100,2.54051e+18,97.1718,7692.87,20324,2849,111,14745,13742,8858,9546,1875
13397,1404,7537,13397,0,0,13397,8.95065e+17,17.7877,7835.62,13397,6772,20,5860,5860,1146,2135,1097
17441,4799,5501,17441,0,16430,1011,4.22311e+18,139.972,6620.93,17441,2092,120,16381,17963,13539,12613,8660
38537,10908,16716,38537,0,36777,1760,5.43048e+18,499.866,18703.4,38537,4293,141,38052,38052,38052,38052,38052
3090,850,1017,0,3090,0,3090,5.88441e+17,92.2485,1441.12,3090,464,66,2073,2073,1893,1800,1851
32783,5233,7693,30874,1909,30874,1909,5.75853e+18,97.763,10356.6,32783,3724,110,25090,25090,23628,23398,17966
16057,1818,3816,15120,937,15120,937,3.23573e+18,97.3503,5356.31,16057,1839,110,12241,12241,9963,11411,6607
15652,3062,7543,15652,0,14972,680,4.22391e+18,115.678,8452.93,15652,1689,124,0,0,0,0,0
4562,158,1127,0,4562,0,4562,6.58723e+17,95.3281,1734.21,4562,530,84,3435,3435,2123,1083,834
5283,1315,2731,2107,3176,0,5283,6.42918e+12,50.2285,3144.44,5283,1313,69,2395,2309,2024,1835,1845
22720,4,176,22698,22,22720,0,6.08849e+18,171.927,1866.06,22720,153,153,1767,543,9,34,6
31906,11,15,30968,938,31849,57,1.74949e+14,10.4236,592.789,31906,12,12,14997,12794,12621,13905,12372
19499,2291,6421,19499,0,18359,1140,3.70322e+18,145.447,7488.41,19499,2329,121,24807,24807,15216,23160,3633
30027,8,17,29111,916,29958,69,2.17731e+14,10.3374,615.768,30027,14,12,29701,29459,26161,25606,16653
12330,1374,5013,12330,0,9806,2524,4.34037e+18,122.375,5772.92,12330,1964,121,7317,7274,4256,5592,2649
18801,3649,4513,17710,1091,17710,1091,3.2199e+18,97.3654,6240.64,18801,2166,110,37710,37710,37710,37710,37710
36121,673,1064,0,36121,35090,1031,3.56388e+16,223.179,3554.11,36121,161,26,35057,34613,30842,31530,26445
12519,81,176,12511,8,12519,0,6.05788e+18,168.289,1377.64,12519,133,136,11915,11881,10701,10484,5815
23118,2136,5491,21778,1340,0,23118,2.22278e+18,97.561,7522.13,23118,2645,110,18028,18028,12149,7347,4580
23741,1,14,23052,689,23664,77,1.59903e+14,10.6214,498.182,23741,14,12,8894,8894,8894,8894,8894
4720,110,248,0,4720,4583,137,3.74028e+16,19.7945,683.065,4720,47,26,4472,4472,4172,4103,2777
42947,7,15,41677,1270,42879,68,1.82274e+14,10.2876,722.915,42947,13,11,38563,35865,31798,29731,23819
35629,11456,12117,13191,22438,0,35629,8.49365e+12,58.3109,14355.9,35629,5889,72,26322,26322,26322,26322,26322
17471,11,12,16973,498,17461,10,1.38877e+14,10.5508,373.446,17471,12,11,17459,17459,17376,17377,17321
43813,1187,12939,0,43813,15886,27927,2.32967e+15,59.087,15728.9,43813,6302,72,39442,39442,38054,38114,29970
27657,7260,10265,10398,17259,0,27657,8.10654e+12,57.3736,12026.8,27657,4986,72,42157,42157,42157,42157,42157
18384,2005,4795,0,18384,6541,11843,2.44789e+15,59.454,6242.12,18384,2332,72,13589,13589,9967,7869,5675
19497,3868,6944,7266,12231,0,19497,8.33387e+12,57.9831,8304.53,19497,3381,72,12553,12553,10697,12163,7733
37799,2455,8807,0,37799,13282,24517,2.53261e+15,60.0451,11459.2,37799,4285,72,24580,21535,12144,14131,4995
12270,483,2965,11551,719,11551,719,5.05139e+18,97.5552,4202.05,12270,1391,111,9305,9305,6030,7406,2168
44207,4758,10361,0,44207,0,44207,6.47947e+17,97.8788,13731.4,44207,5028,110,27227,27227,19435,20660,10106
1338,125,360,465,873,0,1338,1.01528e+13,55.9372,566.9,1338,173,48,978,978,582,846,422
4290,3717,4290,4290,0,0,4290,7.99814,0,4290,4290,4290,1,0,0,0,0,0
6577,1601,1647,6197,380,6197,380,4.46084e+18,96.3214,2429.87,6577,753,96,4930,4930,4911,4929,4921
13212,1463,3972,10652,2560,12502,710,4.29679e+18,96.6684,5205.92,13212,1867,111,48815,48815,48815,48815,48815
44572,1,14,43300,1272,44497,75,1.38957e+14,10.4639,642.767,44572,13,12,11406,11406,11406,11406,11406
30471,3185,7724,0,30471,10825,19646,2.46862e+15,59.7047,9903.37,30471,3757,72,25553,25553,16111,20622,10407
4307,5,10,4182,125,4307,0,1.38025e+14,9.79406,181.017,4307,10,10,3977,3528,2833,2856,2521
46855,10,16,45494,1361,46769,86,1.60078e+14,10.4066,721.013,46855,13,12,37395,35407,34831,36192,33875
16530,618,5497,16530,0,15570,960,4.89953e+18,132.206,6457.4,16530,1974,121,11056,5369,3918,3695,2047
29084,21,176,29064,20,29084,0,6.05603e+18,171.951,2098.28,29084,160,163,44764,44646,44662,44642,44532
25566,790,992,0,25566,24828,738,3.84076e+16,222.759,3053.5,25566,144,26,24574,24574,24285,24330,22851
33098,3207,7757,31168,1930,31168,1930,5.88343e+18,97.7894,10441,33098,3761,110,33246,33246,21595,6545,6871
16919,2568,7887,6642,10277,0,16919,6.92672e+12,56.1933,8944.52,16919,3836,72,9032,9032,6162,8542,2936
35419,7,176,35341,78,35419,0,5.98306e+18,169.705,2229.03,35419,167,171,4336,819,259,590,0
32662,287,996,0,32662,31731,931,3.55677e+16,202.138,3260.01,32662,147,26,31569,31306,27294,27509,13247
24261,8507,9322,23121,1140,23121,1140,7.9113e+18,92.9232,11110.8,24261,4516,110,18953,18953,18953,18953,18953
42835,6,14,41615,1220,42759,76,1.38816e+14,10.5587,639,42835,13,12,36526,36100,35821,35881,35430
18374,24,61,18342,32,18374,0,2.32655e+18,60.4598,1008.55,18374,61,61,9326,615,1097,2969,421
3253,629,1227,3253,0,3072,181,4.06498e+18,88.64,1575.38,3253,432,74,2026,2026,1453,1707,1254
31293,8,14,30371,922,31268,25,1.77648e+14,10.3045,545.638,31293,13,12,9088,6246,5693,6121,5268
24407,7,11,23711,696,24395,12,1.40224e+14,10.1726,439.073,24407,11,11,5648,1717,842,1661,294
20187,3,12,19611,576,20179,8,1.38779e+14,10.3113,400.97,20187,12,11,15323,10889,12695,13365,7034
46922,9428,10985,0,46922,0,46922,6.47824e+17,97.8879,14521.6,46922,5332,110,35111,35111,34743,34388,30274
46537,3341,10862,0,46537,16356,30181,2.52893e+15,60.068,14009,46537,5283,72,39234,39234,33965,28290,26612
22635,161,176,22619,16,22635,0,6.11601e+18,171.733,1863.74,22635,149,157,30446,0,0,0,0
41847,4576,10683,0,41847,0,41847,6.30404e+17,97.4984,13844.1,41847,5184,110,29200,29200,24551,26329,18194
14478,471,797,0,14478,14059,419,4.10307e+16,113.537,2155.16,14478,108,26,16294,15520,8662,2929,2535
23418,210,1047,0,23418,22736,682,4.09674e+16,211.233,3154.43,23418,158,26,28646,0,0,0,0
25528,11,12,24801,727,25517,11,1.39062e+14,10.241,450.481,25528,12,11,29614,26209,25756,25062,24392
32131,953,1354,32131,0,30793,1338,2.20052e+18,16.9879,2046.44,32131,1349,18,30777,30777,26385,27572,24206
18794,1138,1290,0,18794,18226,568,5.21818e+16,262.111,3712.85,18794,204,26,17504,17504,17322,17353,16518
13257,3726,5663,0,13257,5111,8146,1.9023e+15,55.7938,6591.68,13257,2752,72,12874,12874,12874,12874,12874
11947,132,170,11940,7,11947,0,5.97021e+18,163.629,1288.12,11947,132,137,15477,9076,5165,1082,1381
4342,825,1080,4085,257,4085,257,5.83293e+18,95.2331,1666.77,4342,507,82,3262,3262,3201,3204,2824
3573,656,906,3363,210,3363,210,5.64673e+18,94.356,1414.13,3573,417,76,2667,2667,2513,2501,2206
4268,1075,1997,3166,1102,4088,180,4.47351e+18,86.2919,2449.4,4268,948,71,2271,2271,1634,1763,1874
29159,4036,10091,27709,1450,27709,1450,7.53748e+18,95.9303,12247.1,29159,4893,110,28901,28901,28901,28901,28901
22834,4052,10345,21874,960,21874,960,5.28244e+18,94.7784,11882.6,22834,4966,111,41511,41511,41511,41511,41511
37702,10182,11449,37702,0,35512,2190,5.21394e+18,269.773,13383.9,37702,4116,131,32148,32148,31674,32148,29935
6114,1015,1705,5772,342,5772,342,2.18259e+18,92.6377,2427.63,6114,784,94,4122,4122,2630,2801,1125
22210,4,12,21570,640,22195,15,1.52207e+14,10.3358,432.338,22210,12,11,3282,1076,531,911,178
29949,1209,1335,0,29949,29072,877,4.29641e+16,268.658,4183.74,29949,214,26,35381,35381,22263,8054,6050
36184,2086,10716,34231,1953,34231,1953,6.39532e+18,97.405,13354.4,36184,5097,111,25468,25468,14961,17964,6510
7682,5,13,7460,222,7618,64,1.60377e+14,10.9267,279.171,7682,13,12,7093,6453,5915,5455,4151
9949,431,2493,9373,576,9373,576,3.56319e+18,97.0424,3545.93,9949,1154,111,7456,7456,3191,3765,1889
22118,7670,22118,22118,0,22118,0,34358200000,0,22118,22118,22118,1,9148,9148,7384,7337,4487
43872,15,16,42579,1293,43775,97,1.72964e+14,10.4543,716.957,43872,14,12,43850,43850,43689,43655,43470
39444,12,15,38295,1149,39352,92,1.65635e+14,10.5863,667.323,39444,14,12,26053,24263,24060,24288,23797
561,334,435,561,0,541,20,4.63986e+18,27.0178,481.137,561,163,33,126,126,126,126,126
40959,18844,22806,0,40959,8814,32145,1.36451e+13,8.98279,23193.4,40959,20518,11,31891,31891,31891,31891,31891
24964,7833,12906,0,24964,0,24964,4.10222e+17,89.734,14431.5,24964,6262,110,28169,28169,27164,27964,25532
6452,701,2444,6139,313,6139,313,7.82989e+18,93.7717,3120.32,6452,1170,90,4008,3922,3723,3828,2185
45343,132,176,45316,27,45343,0,6.00931e+18,172.852,2573.32,45343,172,173,37238,36960,22854,32913,17136
25808,12126,13135,0,25808,0,25808,4.1836e+17,93.3531,14714.4,25808,6380,110,12673,12673,12520,15231,15365
13135,3080,4177,4812,8323,0,13135,8.79337e+12,57.5158,5229.29,13135,2020,72,14316,13746,8936,6285,3876
43365,10060,16914,0,43365,16439,26926,2.01289e+15,57.5466,19375.1,43365,8228,72,18134,18134,13316,11050,7616
10661,22,456,0,10661,2221,8440,1.50001e+16,11.9822,788.893,10661,453,13,10205,10205,6324,3323,8475
18263,51,175,18255,8,18263,0,5.98051e+18,165.924,1600.59,18263,147,155,15110,3640,6377,9907,436
48079,17,61,47983,96,48079,0,2.33766e+18,60.7783,1630.77,48079,61,61,14178,6917,6236,10838,6143
11897,2,10,11555,342,11893,4,1.39093e+14,9.9594,301.774,11897,10,10,6886,4879,4660,4931,3877
21626,77,176,21610,16,21626,0,6.05326e+18,171.551,1811.75,21626,158,153,18761,18060,17100,16519,16347
19917,1817,4819,18757,1160,18757,1160,2.99706e+18,97.9209,6591.46,19917,2266,111,22496,22496,16669,13525,6650
17949,452,797,0,17949,17429,520,3.79618e+16,109.674,2262.83,17949,106,26,14217,14169,10518,12735,1653
1425,406,416,1337,88,0,1425,2.26524e+18,88.447,663.907,1425,184,51,1009,1009,1001,1002,1009
9683,493,519,0,9683,9404,279,3.81609e+16,19.8256,1361.83,9683,69,26,9164,9164,9146,9145,9087
35880,936,1054,0,35880,34856,1024,3.55428e+16,217.576,3514.23,35880,159,26,29745,29745,18578,16833,4575
49060,2768,17733,46680,2380,46680,2380,3.00796e+18,95.8739,20905.5,49060,8606,110,28606,28606,20656,15916,14256
6233,6,13,6050,183,6195,38,1.62888e+14,10.881,252.443,6233,12,11,5910,5711,5226,4139,3425
49317,1642,1991,0,49317,47867,1450,4.34111e+16,318.152,6613.76,49317,345,26,40838,40725,38020,38220,35189
45014,5889,21486,43213,1801,43213,1801,3.10852e+18,94.0725,23972.5,45014,10348,111,30895,30895,22779,19163,13304
41163,318,1148,0,41163,39990,1173,3.55238e+16,239.582,3935.92,41163,178,26,34741,34741,21250,25283,16690
3286,90,170,3285,1,3286,0,6.27458e+18,80.517,658.364,3286,66,73,3046,2795,1805,1685,1642
42402,11485,12988,0,42402,15452,26950,2.28676e+15,58.8947,15675.8,42402,6314,72,42667,42667,42667,42667,42667
29143,1132,6856,27443,1700,27443,1700,3.22078e+18,97.721,9283.15,29143,3316,110,22287,22287,11759,16752,4817
22409,709,5738,0,22409,7970,14439,2.46098e+15,59.596,7438.08,22409,2789,72,0,0,5403,4914,3002
30057,13,14,29187,870,29994,63,1.56924e+14,10.1457,559.03,30057,12,12,8799,5518,4102,4095,4095
4781,218,1194,4503,278,4503,278,5.7038e+18,95.1115,1819.46,4781,553,85,3587,3587,2849,2396,939
24724,19,175,24712,12,24724,0,5.97995e+18,166.803,1860.12,24724,163,161,16458,12246,12669,12638,12737
2726,278,1418,2726,0,2726,0,3.09359e+17,17.4648,1552.86,2726,1260,20,1308,1308,297,1308,326
37701,93,176,37686,15,37701,0,5.98421e+18,169.804,2299.52,37701,168,170,35266,31286,19907,32042,801
2995,666,729,1058,1937,0,2995,1.0018e+13,58.5219,1108.41,2995,355,61,2266,2266,2188,2248,2190
6508,1053,3359,0,6508,0,6508,3.44661e+15,17.3958,3577.21,6508,3014,20,3149,3149,1013,3149,977
49972,143,208,49905,67,49972,0,6.06553e+18,201.714,2950.77,49972,183,184,49263,48009,46318,46205,46264
41956,10789,11698,15085,26871,0,41956,9.31077e+12,59.3361,14443.2,41956,5699,72,40498,40498,40498,40498,40498
4142,116,170,4136,6,4142,0,5.96084e+18,151.224,758.41,4142,94,94,0,5241,18303,18805,22184
47507,74,1272,0,47507,46154,1353,3.55791e+16,261.051,4460.6,47507,203,26,38413,30010,15626,8883,8898
19653,138,176,19603,50,19653,0,6.08465e+18,170.976,1734.53,19653,149,148,18935,17640,15240,15513,15173
2246,492,625,2114,132,2114,132,1.85797e+18,92.1233,975.516,2246,271,60,1621,1621,1540,1575,1468
24720,5642,5856,0,24720,0,24720,6.46912e+17,97.5926,7992.74,24720,2832,110,29410,29410,29410,29410,29410
656,168,260,0,656,0,656,5.94364e+17,74.279,383.285,656,96,34,396,396,324,352,336
16705,6789,8079,16045,660,0,16705,1.51356e+18,89.0731,9269.05,16705,3894,110,8626,8626,7944,7749,7560
9462,3889,4892,0,9462,0,9462,3.4534e+15,17.648,5158.28,9462,4394,20,4570,4570,3730,4570,3720
43770,103,206,43698,72,43770,0,5.98234e+18,186.689,2557.68,43770,180,178,30129,17426,8553,24689,8191
39279,11510,12571,39279,0,36989,2290,4.2915e+18,278.73,14285.7,39279,3093,134,38787,38787,38787,38787,38787
12009,53,176,11997,12,12009,0,6.15347e+18,167.896,1351.66,12009,118,119,8708,5712,3540,3724,3793
44034,4703,13336,44034,0,41474,2560,3.97051e+18,311.696,15514.2,44034,5256,129,46063,46063,46063,46063,46063
13001,4886,7006,0,13001,0,13001,3.93854e+17,85.9329,7918.12,13001,3373,104,5995,5995,5109,5249,3980
34736,8242,8348,32716,2020,32716,2020,3.43898e+18,98.2337,11063.1,34736,3936,111,47798,47798,47798,47798,47798
3271,1202,1501,3271,0,3111,160,5.45109e+18,77.059,1821.24,3271,578,74,1770,1770,1754,1770,1770
23947,2051,5678,22557,1390,22557,1390,5.90457e+18,97.5652,7764.78,23947,2742,110,18269,18269,17362,17291,7466
17157,6,12,16667,490,17148,9,1.38925e+14,10.55,366.384,17157,11,11,16284,15851,14515,14387,11061
25281,7131,9732,9567,15714,0,25281,7.92791e+12,57.1437,11344.6,25281,4724,72,39878,39878,39878,39878,39878
15007,50,274,14894,113,15007,0,5.52026e+18,169.13,907.15,15007,265,29,14429,14338,6045,7017,5912
22656,4567,12881,22656,0,21894,762,5.13872e+18,437.488,14144.7,22656,4738,131,29744,29187,27527,27527,9113
24086,112,176,24037,49,24086,0,6.07615e+18,172.198,1917.13,24086,154,157,22193,19331,14624,14969,15217
8308,1707,2044,7821,487,7821,487,5.95716e+18,96.9699,2972.82,8308,954,107,6264,6264,6158,6128,5623
15712,2968,3751,14802,910,14802,910,5.77276e+18,97.2033,5265.58,15712,1796,110,11961,11961,11481,11412,9953
1004,249,395,0,1004,0,1004,5.63838e+17,81.8725,568.444,1004,168,44,609,609,496,439,564
40981,4754,11841,0,40981,0,40981,6.00735e+17,96.9511,14838.9,40981,5735,110,40783,40783,40783,40783,40783
21569,3223,8074,0,21569,0,21569,5.31551e+17,94.9605,9732.49,21569,3909,110,13495,13495,10324,7772,6953
22985,4251,7289,8412,14573,0,22985,8.83648e+12,58.6222,8909,22985,3549,72,17641,17641,16374,17572,14950
8477,2958,3894,8120,357,0,8477,1.60345e+18,88.8076,4643.49,8477,1875,102,4583,4583,4564,4536,17605
44067,5346,10478,41509,2558,0,44067,2.21903e+18,97.8325,13827.7,44067,5086,110,22597,22597,19428,18900,6701
19283,7,11,18731,552,19279,4,1.38789e+14,10.0718,387.228,19283,11,11,18588,17977,15925,16399,14712
21703,252,8871,0,21703,0,21703,5.02624e+17,92.7558,10466.8,21703,4286,110,12832,12355,6283,1072,1674
18495,2263,5756,18495,0,17415,1080,4.87164e+18,143.925,6922.75,18495,1125,126,12739,12662,9058,10550,5440
47699,3680,11129,0,47699,16761,30938,2.52809e+15,60.0653,14342.7,47699,5413,72,43442,43442,42755,42290,41843
36144,99,1288,0,36144,35102,1042,3.91349e+16,286.323,4208.6,36144,204,26,23991,8700,4129,22763,1880
5396,2664,2681,5396,0,5156,240,6.77638e+18,79.3816,3119.83,5396,1143,87,2715,2715,2715,2715,2715
28228,90,176,28153,75,28228,0,5.98263e+18,169.743,1991.71,28228,160,164,24247,14636,13309,14164,14582
6540,128,481,0,6540,6347,193,4.32566e+16,18.9786,1183.79,6540,67,26,6190,6190,5801,5641,3948
34936,2257,8193,32904,2032,0,34936,2.22728e+18,97.7696,10995.3,34936,3966,110,31732,31732,20475,19276,9564
1690,48,116,516,1174,516,1174,1.99349e+18,15.8195,256.37,1690,80,18,1574,1574,1113,1264,1029
30664,1387,1572,0,30664,29756,908,4.68642e+16,287.163,4880.22,30664,263,26,21890,21890,16676,11366,10435
30721,4246,7420,28939,1782,28939,1782,4.54875e+18,98.1334,9886.32,30721,3501,111,30511,30511,30511,30511,30511
8168,117,696,0,8168,7925,243,4.64563e+16,21.5045,1650.1,8168,88,26,7472,7454,6233,5939,1746
8715,4,12,8462,253,8709,6,1.51218e+14,10.2348,268.074,8715,12,11,7576,24734,23587,23418,0
16359,256,8308,16359,0,15666,693,3.51874e+18,118.65,9153.76,16359,3596,124,8051,7794,3363,5013,14
9537,333,443,0,9537,9267,270,3.64104e+16,19.8859,1216.9,9537,64,26,9094,9094,8865,8884,7352
44160,6513,11648,41690,2470,41690,2470,6.33863e+18,96.9943,14913,44160,5652,110,44038,44038,44038,44038,44038
3050,171,193,3050,0,2925,125,2.29867e+18,17.6833,396.357,3050,135,21,2857,2857,2822,2818,2738
11556,482,2757,4069,7487,0,11556,9.89619e+12,59.6871,3789.98,11556,1342,72,8799,8799,3823,7440,1713
44580,735,2173,0,44580,43255,1325,4.76586e+16,325.752,7013.72,44580,381,26,33797,33722,16465,28105,8047
49013,1593,2015,0,49013,47576,1437,4.37818e+16,308.022,6674.27,49013,351,26,38855,38855,23961,27721,13237
30253,1550,19632,29443,810,0,30253,1.02812e+18,88.8439,21019.1,30253,9523,110,27734,27734,16425,6645,4477
33154,3855,10022,31394,1760,0,33154,2.03205e+18,96.1283,12526.1,33154,4858,110,23132,23132,17005,15811,10724
4930,1276,2503,4740,190,0,4930,1.47973e+18,79.2114,2979.86,4930,1190,71,2427,2427,1743,39619,39433
19741,1084,8633,0,19741,0,19741,4.79276e+17,94.2887,10064.1,19741,4181,110,19448,19374,10659,6607,3315
16100,1105,5887,15310,790,15310,790,2.02529e+18,95.9582,7212.59,16100,2815,111,22823,0,0,0,0
39393,4211,9489,37103,2290,37103,2290,5.56264e+18,98.2848,12483.1,39393,4487,111,31808,31616,16110,20032,6317
1452,458,811,1394,58,1394,58,2.41788e+18,55.4263,989.947,1452,358,57,641,641,381,625,0
13263,342,3543,0,13263,4731,8532,2.42602e+15,59.2279,4660.1,13263,1720,72,41947,41899,0,3045,2757
36431,16606,17626,35001,1430,35001,1430,9.41245e+18,93.7187,19760.7,36431,8561,110,18805,18805,18709,18693,18602
27051,6349,15613,26181,870,26181,870,2.31063e+18,91.9852,17077.6,27051,7575,110,21613,21613,21613,21613,21613
19920,566,757,0,19920,19354,566,3.55332e+16,81.4391,2196.6,19920,100,26,33580,33580,33580,33580,33580
10794,874,4798,0,10794,4187,6607,1.85294e+15,54.5013,5573.67,10794,2320,72,5996,5948,3949,1883,1684
38801,8912,9074,36541,2260,0,38801,2.22929e+18,97.8333,12116.2,38801,4398,110,27707,27707,26814,26392,25700
11473,1733,3248,10843,630,0,11473,2.102e+18,96.3021,4396.32,11473,1558,110,8225,8225,6689,6393,5235
28364,5426,6686,0,28364,0,28364,6.4752e+17,97.6811,9064.66,28364,3232,110,20571,20571,19449,20367,16463
30221,2285,9577,0,30221,0,30221,5.78272e+17,96.4108,11869.7,30221,4640,110,46873,46873,46873,46873,46873
18967,1695,4457,6659,12308,0,18967,9.85066e+12,59.8652,5983.61,18967,2161,72,14510,14510,9915,13355,5809
11283,3,13,10956,327,11217,66,1.55993e+14,10.8813,336.474,11283,13,12,8720,6398,6324,6800,4377
6538,1137,1592,0,6538,0,6538,6.52615e+17,95.9835,2380.72,6538,752,95,4946,4946,4344,3954,3915
32226,1298,1746,0,32226,31268,958,4.88232e+16,304.282,5430.26,32226,298,26,19486,19486,12972,9756,8890
6262,1301,1622,5368,894,5900,362,3.38853e+18,96.1721,2368.93,6262,751,95,4640,23430,23114,23369,22359
32736,3686,7632,11515,21221,0,32736,9.89242e+12,60.0489,9991.9,32736,3718,72,28831,28831,19215,27180,7560
32717,23,176,32706,11,32717,0,5.98244e+18,169.651,2142.83,32717,164,169,43969,41641,29085,21722,4644
34757,655,1604,0,34757,33731,1026,4.48388e+16,285.458,5097.8,34757,268,26,33153,32058,30496,29177,17908
1581,3,10,1536,45,1581,0,1.37622e+14,9.72992,108.451,1581,10,10,1193,840,990,953,637
14179,10,11,13776,403,14172,7,1.39001e+14,10.2669,333.724,14179,11,11,4082,1829,984,1551,225
18893,134,6405,0,18893,0,18893,5.59729e+17,95.7501,7969.36,18893,3089,110,18668,18596,18618,18611,18613
4565,1080,1128,4295,270,4295,270,5.82075e+18,95.2666,1735.32,4565,531,83,3437,3437,3427,3427,3422
28069,7758,10132,28069,0,26529,1540,3.8503e+18,208.866,11467.5,28069,3910,124,27539,27539,27539,27539,27539
40564,63,208,40478,86,40564,0,6.08697e+18,203.922,2676.57,40564,185,183,40292,40125,40115,40080,40086
35036,2491,8216,32996,2040,32996,2040,5.88777e+18,97.7846,11021.7,35036,3975,110,39775,39775,39775,39775,39775
41620,17642,18517,16188,25432,0,41620,7.18225e+12,56.6982,20719.7,41620,9020,72,36690,36690,36690,36690,36690
7425,3,11,7210,215,7419,6,1.74761e+14,10.2263,254.237,7425,11,11,12669,11312,11091,2986,2173
30527,3612,7170,28747,1780,28747,1780,5.88648e+18,97.7549,9688.48,30527,3475,110,25643,25643,24155,23371,22652
25376,2443,14331,0,25376,0,25376,3.69937e+17,89.4624,15757.7,25376,6942,110,23159,23159,23159,23159,23159
45114,5916,10521,15869,29245,0,45114,9.88587e+12,60.0864,13590.2,45114,5124,72,19468,19468,19468,19455,18657
43838,6812,19070,16976,26862,0,43838,7.28396e+12,55.6549,21408.5,43838,9268,72,27091,27091,21788,24392,13783
40099,4,13,38953,1146,40079,20,1.44349e+14,10.2905,578.888,40099,12,12,34823,30988,25752,26305,18539
31922,6195,7453,0,31922,11226,20696,2.53349e+15,60.0276,9765.1,31922,3624,72,31609,31609,31609,31609,31609
1792,63,514,1690,102,1690,102,3.39508e+18,89.6964,813.463,1792,217,55,900,260,445,674,172
3573,9,11,3468,105,3571,2,2.00412e+14,10.1903,174.174,3573,11,11,3536,3514,3479,3480,2791
11558,848,5681,11558,0,7656,3902,3.90739e+18,134.291,6365.43,11558,2399,121,5877,5617,2726,3960,1087
11456,27,793,0,11456,11118,338,4.5187e+16,109.246,2047.53,11456,104,26,5444,1423,1674,1821,1731
17378,266,6509,17378,0,16430,948,3.69278e+18,134.397,7474.31,17378,2519,124,25228,24472,13176,15760,2159
20587,2106,4977,19387,1200,19387,1200,3.72147e+18,97.9572,6793.16,20587,2340,111,15610,15610,10163,11455,7523
19365,1001,1336,6006,13359,6006,13359,2.08807e+18,15.9917,1850.91,19365,685,26,18029,18029,17695,18029,14799
7437,315,1795,7004,433,0,7437,2.238e+18,96.2346,2664.23,7437,852,100,37434,37660,0,0,0
6460,2109,3677,6460,0,6460,0,3.97211e+18,18.8268,3881.17,6460,3145,23,2783,2783,1828,1859,1730
44412,2729,14054,42090,2322,42090,2322,2.23007e+18,97.1388,17083.6,44412,6698,111,44851,44851,44851,44851,44851
4831,17,170,4830,1,4831,0,5.94228e+18,153.893,818.132,4831,100,100,1713,285,437,443,463
19947,126,1087,0,19947,19361,586,4.48811e+16,223.115,3170.81,19947,164,26,44312,0,0,0,0
35987,1051,10713,13059,22928,0,35987,9.06181e+12,59.0051,13084.3,35987,5210,72,22175,22175,6773,12126,4779
17506,2435,10166,16939,567,16939,567,1.09148e+19,91.9623,11218.4,17506,4934,110,7340,7254,5308,7183,5883
900,17,29,0,900,872,28,0.0311111,0.967778,161.052,900,29,1,871,871,871,871,871
8979,1754,2210,0,8979,0,8979,6.44636e+17,96.4198,3200.51,8979,1049,109,6769,6769,6284,6338,5771
34262,3,15,33260,1002,34199,63,1.65671e+14,10.5087,619.14,34262,13,11,13663,125,0,63,43
39254,8693,13132,37254,2000,37254,2000,5.5488e+18,96.8433,15827.9,39254,6276,111,32063,32063,26940,22679,18692
19444,665,6594,0,19444,0,19444,5.61021e+17,86.0673,8193.97,19444,3171,110,12850,12850,7513,2637,0
10500,1203,2445,3692,6808,0,10500,9.97492e+12,59.7696,3413.01,10500,1191,72,8055,8055,6541,7737,4158
31563,13,16,30624,939,31490,73,1.8625e+14,10.3912,605.329,31563,14,12,16747,11409,11565,11438,10812
9115,2319,2575,0,9115,0,9115,6.10622e+17,95.8549,3544.26,9115,1229,110,6540,6540,6298,6348,6269
45156,2579,14105,0,45156,0,45156,5.81954e+17,96.6247,17253.6,45156,6844,110,45051,45051,45051,45051,45051
39061,54,176,39007,54,39061,0,6.03745e+18,172.178,2421.78,39061,171,168,27673,16367,11183,12147,12185
38203,3655,13445,14228,23975,0,38203,8.36941e+12,58.1616,15777.1,38203,6545,72,32758,32758,18745,13895,7979
2207,85,106,0,2207,2142,65,3.52942e+16,19.4717,319.632,2207,31,26,2101,2101,2036,2037,1968
32393,724,1436,0,32393,31441,952,4.33218e+16,287.243,4543.53,32393,236,26,30957,30957,26963,27460,19853
31502,3815,14541,30212,1290,0,31502,1.5701e+18,94.1313,16513.6,31502,7052,110,31027,31027,31027,31027,31027
49064,8835,25079,49064,0,0,49064,8.81875e+17,17.9657,25711.5,49064,22564,20,48326,48326,48326,48326,48326
47656,6383,11102,44881,2775,0,47656,2.23005e+18,97.888,14689.3,47656,5378,110,42818,42818,42818,42818,42818
25981,351,15321,25161,820,25161,820,4.16338e+18,90.2717,16692.4,25981,7382,111,29494,29494,29494,29494,29494
21856,1759,9156,20886,970,20886,970,2.84544e+18,90.7403,10740.3,21856,4417,110,21088,21088,8426,18080,4959
1545,306,452,1455,90,1455,90,1.13708e+18,89.7443,719.57,1545,188,51,1093,1093,1093,1093,929
28741,13,14,27917,824,28667,74,1.43867e+14,10.5586,523.397,28741,14,12,28727,28727,36693,36697,36436
34307,263,1235,0,34307,33315,992,3.89935e+16,261.494,4001.17,34307,196,26,25728,25632,14744,1222,1367
33602,571,1013,0,33602,32645,957,3.5572e+16,207.384,3338.59,33602,150,26,26101,25929,16430,10496,9975
46403,14170,18551,0,46403,0,46403,5.07354e+17,95.2324,21442.5,46403,9005,110,37135,37135,37135,37135,37135
29837,11977,17741,0,29837,12392,17445,1.34072e+15,53.7595,19067.9,29837,8620,72,22828,22828,22828,22828,22828
47404,94,176,47321,83,47404,0,5.98082e+18,169.702,2576.51,47404,172,171,47269,47233,47231,47212,47220
44974,9502,12414,42482,2492,42482,2492,4.54898e+18,97.7771,15612.4,44974,5895,111,44483,44483,44483,44483,44483
6199,1086,2600,0,6199,0,6199,5.02778e+17,93.0773,3226.37,6199,1244,85,3599,3599,2908,2422,2590
7046,2346,2528,0,7046,0,7046,5.52906e+17,88.4174,3270.7,7046,1207,92,4518,4518,4295,4134,4237
48728,9298,23350,46778,1950,46778,1950,2.80194e+18,94.5794,25979.9,48728,11263,111,48324,48324,48324,48324,48324
14356,1982,3880,13556,800,0,14356,2.13452e+18,96.7155,5251.9,14356,1864,110,24249,24249,22653,0,0
21061,117,4980,0,21061,7413,13648,2.53241e+15,59.9038,6628.81,21061,2426,72,16081,15985,9088,5001,628
36299,2974,10371,34329,1970,34329,1970,3.08576e+18,96.492,13108.5,36299,5028,110,35718,35718,35718,35718,35718
5754,1816,3199,2349,3405,0,5754,5.90309e+12,50.3648,3614.66,5754,1552,67,2555,2555,1721,2405,895
9072,2125,2161,0,9072,0,9072,6.50301e+17,96.6728,3171.6,9072,1027,110,6911,6911,6888,6890,6905
42991,1596,1645,0,42991,41737,1254,4.15608e+16,294.833,5434.75,42991,278,26,28132,27179,20263,22731,14483
45190,5,14,43904,1286,45109,81,1.39018e+14,10.5839,660.034,45190,13,12,42823,41530,40376,39714,37052
1429,638,1080,0,1429,626,803,9.12888e+14,20.9279,1178.97,1429,505,42,349,349,349,349,8259
29923,5228,7836,0,29923,10672,19251,2.44116e+15,59.5699,9963.96,29923,3817,72,27049,27049,23836,16898,15838
32290,4892,7588,0,32290,0,32290,6.48079e+17,97.7323,10219.1,32290,3669,110,25835,25835,23762,25298,21263
43851,14658,22998,0,43851,17681,26170,1.57082e+15,54.6799,25032,43851,11199,72,34513,34513,16041,28246,28246
18246,174,176,18199,47,18246,0,6.10604e+18,169.6,1672.22,18246,141,145,18060,18028,17927,17879,17895
26791,1614,15172,10999,15792,0,26791,5.61072e+12,53.0945,16455.6,26791,7385,72,21896,11872,25761,21586,7142
16481,4596,5021,15603,878,0,16481,2.03465e+18,94.5187,6486.64,16481,2422,110,11460,11460,10910,10839,10571
9350,1283,2178,3286,6064,0,9350,9.99057e+12,59.7213,3065.88,9350,1060,72,7172,7172,6076,6942,4425
8746,130,385,0,8746,8501,245,3.5724e+16,19.818,1078.86,8746,59,26,8361,8361,6696,6745,3730
1654,90,483,1556,98,1556,98,4.80577e+18,90.0701,762.089,1654,213,54,1053,326,602,809,310
2964,342,777,2794,170,0,2964,2.2185e+18,93.165,1218.17,2964,353,69,2187,2187,1615,1488,1217
42344,3591,9885,0,42344,0,42344,6.47989e+17,97.8445,13148.6,42344,4787,110,47746,47746,47746,47746,47746
10340,249,2481,0,10340,3639,6701,2.52308e+15,59.5449,3430.96,10340,1199,72,7859,7859,2722,1401,948
2880,1590,1600,2880,0,2880,0,5.07411e+18,16.7705,1731.74,2880,1432,20,1280,1280,1275,1280,1280
25558,85,176,25539,19,25558,0,6.03078e+18,171.791,1957.99,25558,162,158,21653,13705,11620,12283,12321
25265,12440,14659,0,25265,0,25265,3.56872e+17,88.1196,16045.4,25265,7100,110,33527,33527,33027,32424,32550
18010,1,11,17496,514,18003,7,1.38831e+14,10.2479,375.834,18010,11,11,10180,10180,10180,10180,10180
21750,2,14,21129,621,21678,72,1.38758e+14,10.6518,446.378,21750,14,12,974,113,97,325,68
42418,3506,12196,40118,2300,40118,2300,3.25979e+18,97.0484,15280.3,42418,5925,110,32607,32607,24308,23868,18308
36100,534,14551,34460,1640,0,36100,1.73955e+18,93.1937,16920.4,36100,7054,110,27911,27911,24871,22485,5374
46108,7378,10800,43426,2682,0,46108,2.22674e+18,97.8769,14288.9,46108,5238,110,39695,39695,39695,39695,39695
22561,6642,7317,22561,0,21271,1290,3.41065e+18,157.473,8637.6,22561,2862,121,13975,13975,7776,13975,7213
43997,19045,20464,17264,26733,0,43997,6.91012e+12,56.2882,22703.5,43997,9952,72,36072,36072,36072,36072,36072
38255,3870,12389,0,38255,0,38255,5.71284e+17,96.3742,15117.8,38255,6004,110,28350,28255,26655,27658,23588
34060,852,7954,0,34060,11967,22093,2.53085e+15,60.0246,10390.3,34060,3870,72,46967,46967,46126,46948,26388
11914,3120,3433,11264,650,11264,650,6.61409e+18,96.3252,4606.81,11914,1655,110,8481,8481,8441,8441,8288
21671,3960,9201,21671,0,20592,1079,3.96441e+18,159.357,10272.5,21671,3767,124,12470,12462,8441,10264,6346
29780,2213,8950,28198,1582,28198,1582,3.04392e+18,96.6317,11257,29780,4325,110,22122,22122,14489,12997,5517
16520,3908,7266,0,16520,0,16520,4.78382e+17,92.8494,8514.9,16520,3504,110,9254,9254,7206,5735,5264
25919,5440,6071,24404,1515,24404,1515,5.86569e+18,97.6674,8289.85,25919,2938,110,18842,18842,14756,11414,8163
30981,7629,9272,29331,1650,29331,1650,3.08658e+18,96.7015,11656.3,30981,4492,110,29363,29363,22089,14329,12855
5123,1667,1940,0,5123,1929,3194,2.12152e+15,56.9325,2423.7,5123,945,71,3183,3183,2856,2478,2501
9392,281,541,2839,6553,2839,6553,1.94461e+18,15.9673,894.191,9392,396,18,8851,8851,7197,7791,6101
33491,10853,12272,0,33491,12555,20936,2.09027e+15,57.9188,14335.3,33491,5972,72,21219,21219,20413,19823,19250
27177,702,8004,25707,1470,25707,1470,2.37147e+18,97.3304,10130.4,27177,3810,111,24494,23837,9474,12604,2244
23403,4792,8013,8674,14729,0,23403,8.49131e+12,58.233,9611.01,23403,3897,72,15390,15390,13592,15010,10723
39541,7462,9424,0,39541,0,39541,6.4465e+17,97.2232,12500.3,39541,4555,110,29180,28954,21768,25380,16017
7078,130,1720,0,7078,0,7078,6.44827e+17,96.0637,2559.7,7078,808,98,5358,3028,1653,512,797
4228,6,10,4108,120,4227,1,1.40205e+14,9.76466,180.204,4228,10,10,4026,3883,3022,2965,2855
40799,551,1149,0,40799,39637,1162,3.55988e+16,241.584,3927.29,40799,178,26,27495,26893,16250,18305,4776
37253,8,16,36155,1098,37163,90,1.75566e+14,10.5476,628.278,37253,13,13,6132,1367,850,1691,101
43941,7774,10254,0,43941,15449,28492,2.53315e+15,60.0645,13253.4,43941,4995,72,34290,34266,32830,34148,30943
45692,1990,1994,0,45692,44347,1345,4.48901e+16,318.085,6526.63,45692,347,26,38684,38684,35945,34766,32907
18630,5018,9476,0,18630,0,18630,4.18244e+17,87.6178,10719.3,18630,4575,110,43820,43820,43820,43820,43820
40199,8,176,40104,95,40199,0,6.12112e+18,173.279,2482.78,40199,164,167,36643,32088,23979,22594,4750
33512,382,9777,12129,21383,0,33512,9.14389e+12,59.108,12028.3,33512,4762,72,35870,0,0,0,0
22934,2630,7786,21766,1168,21766,1168,4.26827e+18,96.5601,9559.99,22934,3717,111,26558,26558,16891,15171,9421
47183,5187,11032,44435,2748,0,47183,2.22702e+18,97.9177,14588,47183,5352,110,30854,30347,24597,27280,19503
19287,4158,4609,18167,1120,18167,1120,5.92073e+18,97.448,6375.17,19287,2222,110,14678,14678,14588,14588,13867
34008,114,176,33926,82,34008,0,6.05999e+18,171.506,2274.45,34008,162,165,25555,25355,8448,20499,2723
49377,23857,24816,47509,1868,47509,1868,2.46328e+18,93.6372,27435.8,49377,12063,110,32129,32129,32129,32129,32129
34621,13470,13765,34621,0,32840,1781,4.89574e+18,244.828,15267.9,34621,3091,135,27708,27708,25650,27132,21981
14803,5071,5403,14803,0,13985,818,3.35692e+18,130.505,6283.44,14803,2055,123,9400,9400,9288,9322,8980
5731,54,176,5724,7,5731,0,6.12893e+18,158.469,936.738,5731,97,97,4059,2626,1700,1792,1814
3112,142,806,2924,188,0,3112,2.26179e+18,93.8911,1259.65,3112,374,72,2306,1773,887,811,653
45392,863,14547,16660,28732,0,45392,8.75583e+12,57.8077,17342.5,45392,7076,72,24178,23604,15187,20767,8047
30598,164,175,30586,12,30598,0,5.9772e+18,167.475,2068.47,30598,163,167,46195,45994,39150,39388,12691
34538,806,13150,0,34538,13030,21508,2.04368e+15,57.2557,15225.3,34538,6386,72,21388,21209,10139,5541,2972
20351,2721,6032,19261,1090,0,20351,2.05347e+18,96.5271,7766.44,20351,2914,110,40644,47810,47810,47810,47810
40003,8741,10167,37713,2290,37713,2290,4.01167e+18,98.0915,13150.6,40003,4822,111,29836,29836,28460,29753,26954
35911,8355,13462,34191,1720,34191,1720,7.16854e+18,94.6673,15861.9,35911,6456,111,26119,26119,22742,25519,18568
34403,6707,18362,0,34403,7454,26949,1.35522e+13,8.97186,18729,34403,16518,11,43505,43505,43505,43505,43505
44026,3,14,42773,1253,43948,78,1.38986e+14,10.3623,617.627,44026,14,12,33579,23623,28468,29143,17333
49941,1790,22698,47871,2070,0,49941,1.58791e+18,94.3067,25543.9,49941,11017,110,36209,36209,22226,4694,5057
977,329,350,920,57,0,977,2.1486e+18,79.912,527.017,977,146,43,627,627,614,612,627
31748,518,976,0,31748,30841,907,3.55703e+16,196.474,3181.06,31748,144,26,17638,17638,5014,17638,4545
5872,43,61,5872,0,5872,0,2.34266e+18,59.8747,567.422,5872,61,61,5291,3273,4191,4227,4113
29415,1142,10458,27975,1440,0,29415,1.87807e+18,95.5825,12604.9,29415,5056,110,23243,0,0,0,4370
17613,13,176,17608,5,17613,0,5.98674e+18,167.336,1587.36,17613,146,155,8451,1027,1085,1978,517
2447,16,903,2447,0,2307,140,4.45925e+18,87.3796,1197.12,2447,217,68,494,42,88,41,7
12778,1783,5335,12208,570,12208,570,2.73145e+18,94.2149,6399.28,12778,2566,110,7443,7443,5362,6023,2430
19158,4654,6906,18211,947,18211,947,3.75382e+18,96.128,8420.2,19158,3300,111,12252,12252,11283,12195,10390
3433,43,72,3396,37,3433,0,6.40941e+18,69.5552,488.71,3433,62,71,2689,787,1815,1916,2133
26056,9416,12262,25006,1050,25006,1050,9.34319e+18,93.1987,13948.6,26056,5940,110,13794,13794,13554,13554,11204
11630,410,613,0,11630,11295,335,3.8123e+16,19.8727,1604.71,11630,80,26,8496,7984,2994,4779,1078
35070,7,14,34050,1020,35018,52,1.58668e+14,10.5198,604.991,35070,12,11,7435,1149,1421,1025,1313
47410,1327,15486,44983,2427,44983,2427,7.09085e+18,96.4191,18706.1,47410,7515,110,32501,32501,26539,27356,8199
21673,774,5100,20413,1260,0,21673,2.22911e+18,97.5569,7037.69,21673,2455,110,16573,16573,10717,9910,3562
19753,1781,8053,0,19753,7549,12204,1.9591e+15,54.0509,9346.18,19753,3901,72,15202,0,0,3065,3065
2219,494,621,2089,130,2089,130,3.13312e+18,92.0266,969.676,2219,269,60,1598,1598,1412,1467,1461
15732,3134,3750,14819,913,14819,913,3.35142e+18,97.2506,5265.52,15732,1804,110,15373,15373,15373,15373,15373
34823,5,15,33808,1015,34734,89,1.62986e+14,10.5122,624.04,34823,13,12,4843,1014,205,7,10
45518,6,15,44191,1327,45449,69,1.62282e+14,10.3188,719.936,45518,13,11,15697,12814,12423,12530,11943
3104,1140,2134,0,3104,0,3104,2.86892e+17,69.2287,2380.59,3104,1002,56,17639,17639,17639,17639,17639
10230,936,2424,0,10230,0,10230,6.52835e+17,96.9136,3527.39,10230,1156,110,7806,7806,5458,4002,3532
28336,121,176,28287,49,28336,0,6.05508e+18,172.32,2076.27,28336,162,162,45910,45876,45813,45795,44721
44645,10382,16975,0,44645,0,44645,5.23592e+17,95.5284,19854.2,44645,8240,110,30604,30604,27829,29544,23432
39556,2096,11377,0,39556,0,39556,6.02205e+17,96.9791,14297.1,39556,5517,110,28179,28179,13581,7642,5844
34784,6454,14078,23250,11534,33194,1590,3.02771e+18,95.7611,16330.1,34784,6765,111,27244,27244,26769,26705,24588
1307,187,408,1230,77,1230,77,4.37681e+18,87.4002,638.597,1307,174,52,899,899,633,782,570
3373,328,1455,0,3373,1294,2079,1.93357e+15,55.6339,1792.89,3373,705,67,1918,1870,28817,28806,28658
4780,72,2462,4598,182,4598,182,2.18825e+18,82.6324,2918.98,4780,1155,71,24589,16562,1903,2288,1646
14282,1232,5689,9590,4692,13622,660,3.54583e+18,95.2159,6858.72,14282,2713,111,8593,8593,6097,6174,2714
19193,7103,10179,19193,0,0,19193,8.86501e+17,17.975,10558.9,19193,9154,20,9014,9014,5960,6215,5869
37700,9729,11527,35698,2002,35698,2002,3.01255e+18,96.1606,14225.6,37700,5494,111,15366,15366,15366,15366,15359
11624,3555,4197,11624,0,10994,630,3.63853e+18,113.661,5023.56,11624,1654,117,20987,20987,16820,15948,11877
20276,11318,11380,20276,0,20276,0,2.93386e+18,17.813,11752.1,20276,10226,20,21251,21251,19851,20961,16326
46688,8,176,46609,79,46688,0,6.1305e+18,173.807,2673.28,46688,169,171,45366,44759,41848,41801,36976
1065,10,11,1035,30,1065,0,1.36905e+14,9.96056,91.8009,1065,11,11,1046,1033,1020,1021,967
33439,7,13,32470,969,33417,22,1.56878e+14,10.2434,540.268,33439,12,12,4587,1397,753,845,96
27974,1496,1530,0,27974,27141,833,4.80865e+16,292.309,4678.11,27974,253,26,26444,26444,26376,26370,26137
29048,4081,15113,0,29048,6318,22730,1.34968e+13,8.99277,15455.5,29048,13597,11,26944,26944,26944,26944,26944
9125,1726,2454,8615,510,0,9125,2.14846e+18,96.1915,3439.06,9125,1161,108,12082,12082,9374,7811,5782
26271,4848,12592,0,26271,0,26271,4.43119e+17,93.7732,14263.3,26271,6114,110,21525,21525,4372,21401,3949
1110,620,798,0,1110,0,1110,3.00901e+17,38.6757,901.049,1110,364,33,312,302,202,73,47
14316,3396,3424,13483,833,13483,833,3.22549e+18,97.1654,4831.8,14316,1638,110,10892,10892,10873,10889,10892
15546,788,922,0,15546,15089,457,4.45482e+16,170.1,2557.55,15546,129,26,14624,14624,14396,14377,13210
19411,3039,4589,18280,1131,18280,1131,3.23571e+18,97.4129,6364.14,19411,2211,110,14822,14822,13252,14377,10628
29333,6522,13288,29333,0,28011,1322,4.95182e+18,283.505,14781,29333,4404,136,28318,28318,28318,28318,28318
2301,493,612,2162,139,2162,139,5.79863e+18,92.4259,974.186,2301,280,60,17328,17328,17289,17298,16747
44436,880,1477,0,44436,43156,1280,3.89088e+16,277.066,4977.11,44436,244,26,42000,41900,39748,40503,31199
21404,1,12,20770,634,21383,21,1.80755e+14,10.0351,439.001,21404,11,12,11272,11272,11272,11272,11272
16071,2121,4330,0,16071,0,16071,6.23334e+17,96.8006,5819.92,16071,2090,110,2689,2689,433,176,151
13750,3013,4098,13009,741,13009,741,3.33888e+18,96.7104,5370.94,13750,1941,111,9652,9652,8304,8377,8139
23740,6357,8568,22580,1160,0,23740,1.86723e+18,95.6731,10377,23740,4155,110,27783,0,5355,5355,5355
35768,4789,8405,12583,23185,0,35768,9.85734e+12,60.0064,10935.7,35768,4089,72,47774,47774,47774,47774,47774
24968,154,851,0,24968,24257,711,3.55065e+16,143.786,2617.62,24968,118,26,24059,23930,20242,20378,8411
8215,1337,2029,7738,477,7738,477,3.33278e+18,96.4123,2957.76,8215,958,105,6186,6186,4825,5452,4433
43603,3371,10119,15321,28282,0,43603,9.89412e+12,60.097,13109.6,43603,4923,72,43230,43230,43230,0,0
19652,3979,4628,18504,1148,18504,1148,3.22732e+18,97.5399,6422.81,19652,2235,110,30532,30532,22797,15502,13443
5402,1790,2063,0,5402,2037,3365,2.09255e+15,56.9685,2566.36,5402,1004,69,3339,3339,2946,2731,2660
9073,56,2135,0,9073,3183,5890,2.55186e+15,59.5848,2998.77,9073,1035,72,6366,2689,3894,1181,248
16193,1158,4263,5776,10417,0,16193,9.52748e+12,59.3849,5570.64,16193,2070,72,11930,11930,7738,10689,4025
26687,4686,7394,25217,1470,25217,1470,6.5057e+18,96.9739,9566.3,26687,3576,110,16033,16033,11671,16033,11722
25349,1083,9612,0,25349,9553,15796,2.05122e+15,57.6516,11237,25349,4674,72,25365,25365,25285,25266,24748
25034,1023,5835,8794,16240,0,25034,9.88307e+12,59.965,7735.77,25034,2837,72,19199,19199,12167,17981,3640
16702,3873,4066,15732,970,15732,970,1.48882e+18,97.8,5620.78,16702,1912,111,39739,39739,39739,39739,39739
9568,286,407,0,9568,9295,273,3.53887e+16,20.0046,1151.08,9568,61,26,9161,9161,8889,8923,7083
28634,2,16,27768,866,28569,65,2.01527e+14,10.263,583.227,28634,13,12,17274,14339,8230,14402,3982
39534,1292,15655,39534,0,37564,1970,4.66193e+18,350.752,17585.3,39534,4616,140,25783,25783,17915,24453,8384
12699,1397,3133,11961,738,11961,738,3.35685e+18,97.4898,4395.57,12699,1466,111,9566,9566,6279,7071,4745
29825,113,1011,0,29825,28972,853,3.69409e+16,204.528,3237.65,29825,151,26,17336,8944,11113,4473,3475
36091,56,207,36018,73,36091,0,5.98341e+18,188.544,2347.99,36091,177,179,19284,18990,420,15265,82
38442,4702,15309,38442,0,34876,3566,4.23009e+18,352.106,16981.9,38442,6314,130,22734,22734,20278,19727,10712
35725,5850,15160,26894,8831,34152,1573,6.09107e+18,95.4089,17400.1,35725,7275,111,23145,23145,19498,18769,16282
24653,10842,11773,23670,983,23670,983,9.28859e+18,92.6456,13370.5,24653,5702,110,23935,23935,23935,23935,23935
20193,3423,5158,19046,1147,0,20193,2.17257e+18,97.1859,6955.22,20193,2489,110,21077,21077,15457,9413,7974
7616,3889,7616,7616,0,7616,0,34355200000,0,7616,7616,7616,1,0,0,0,0,0
48082,8801,11246,45284,2798,0,48082,2.22724e+18,97.9017,14854.4,48082,5455,110,38197,38197,36926,35687,35582
28694,2655,13074,28694,0,19233,9461,4.02519e+18,290.086,14399.9,28694,5614,130,15620,15133,7950,11221,3580
9200,2349,3841,9200,0,8727,473,6.28839e+18,101.773,4466.83,9200,1516,115,10827,10827,10827,10827,10827
45762,12427,14909,45762,0,43130,2632,4.77992e+18,320.423,16819.2,45762,3780,134,45253,45253,45253,45253,45253
45282,9582,17817,45282,0,43035,2247,4.61378e+18,464.516,20024.7,45282,5714,141,45091,45091,45091,45091,45091
23706,13,176,23657,49,23706,0,6.08688e+18,172.028,1904.32,23706,152,153,6419,607,150,994,1189
9449,734,2756,0,9449,0,9449,6.0667e+17,96.0144,3740.47,9449,1324,109,6693,6693,4715,2861,2775
40310,391,1135,0,40310,39160,1150,3.55211e+16,236.856,3872.16,40310,176,26,40099,40099,40099,40099,40099
9709,11,13,9414,295,9665,44,2.11954e+14,10.3341,325.61,9709,12,11,9696,9694,9609,9610,9202
33705,9160,11840,33705,0,31883,1822,3.93887e+18,241.744,13566.1,33705,4109,136,26844,26844,26844,26844,26844
23543,3458,6900,8519,15024,0,23543,9.16192e+12,59.0276,8595.6,23543,3361,72,20660,20660,20660,20660,20660
26069,9723,10532,24877,1192,24877,1192,1.98712e+18,95.5907,12342.7,26069,5045,111,12663,12556,11243,12040,9845
2443,542,651,2294,149,0,2443,2.27147e+18,92.5919,1028.26,2443,298,63,0,0,0,0,1999
25387,8223,12450,25387,0,25387,0,2.66244e+18,17.9715,12910,25387,11192,20,24761,24761,24761,24761,24761
37510,2573,12075,37510,0,35330,2180,4.72183e+18,267.654,13734,37510,4467,125,31006,31006,23975,25499,20278
1286,176,573,1226,60,1226,60,8.03507e+18,69.0016,769.182,1286,237,46,713,710,663,632,334
46607,1903,19656,46607,0,31191,15416,4.60132e+18,1530.97,22137.6,46607,5747,142,35937,35937,17435,13980,8663
41404,7320,18165,41404,0,31797,9607,5.40618e+18,362.256,19955.3,41404,4641,138,40946,40946,40946,40946,40946
33563,7942,8739,0,33563,0,33563,6.26807e+17,97.3549,11380.2,33563,4238,110,24824,24824,24017,23186,22992
4761,5,12,4619,142,4756,5,1.89897e+14,9.98992,202.839,4761,11,11,4707,650,441,432,730
30252,4344,13291,0,30252,0,30252,4.7466e+17,94.4754,15263.6,30252,6443,110,16961,16961,11650,7315,6138
15778,52,176,15771,7,15778,0,6.01093e+18,168.225,1525.44,15778,140,145,10397,5485,4120,4736,4675
24101,1666,5610,0,24101,8466,15635,2.5437e+15,59.9791,7452.65,24101,2732,72,31269,31269,15031,13544,7246
48724,3746,15261,46184,2540,46184,2540,6.91566e+18,95.0834,18607.3,48724,7408,110,34614,34614,32613,34614,19879
47243,6286,10947,0,47243,16601,30642,2.5371e+15,60.0951,14135.4,47243,5333,72,39265,39265,37297,38850,34107
36686,11504,12609,36686,0,34623,2063,3.70098e+18,251.482,14220.2,36686,4610,133,36101,36101,36101,36101,36101
37158,4691,8692,34991,2167,34991,2167,3.23628e+18,97.8246,11631.6,37158,4207,110,26675,26675,17737,24970,6518
11552,325,497,0,11552,11223,329,3.56358e+16,20.117,1385.56,11552,69,26,11055,11055,10648,10699,7976
6994,2236,4178,6994,0,6753,241,5.92349e+18,128.545,4643.22,6994,1896,88,2816,2764,2267,2632,2101
27872,164,176,27788,84,27872,0,6.09861e+18,170.819,2066.13,27872,161,156,24558,30163,11497,12766,49
30887,8628,16161,12437,18450,0,30887,6.15894e+12,55.4177,17704.8,30887,7868,72,14726,14726,12575,14276,9109
39308,12033,15470,37490,1818,37490,1818,2.93998e+18,95.3058,18025.8,39308,7513,110,37927,37927,37927,37927,37927
33586,10,13,32615,971,33569,17,1.54298e+14,10.3577,540.494,33586,12,12,7204,4277,4258,4046,3554
38060,1,14,36975,1085,37982,78,1.38807e+14,10.5927,600.411,38060,14,12,44,44,44,44,44
1429,362,386,0,1429,497,932,2.58586e+15,55.8726,601.609,1429,185,49,1043,1043,1017,1017,1019
17372,3396,5338,0,17372,6329,11043,2.3026e+15,58.7193,6653.33,17372,2600,72,12034,12034,10373,8912,8529
22819,2080,6046,0,22819,0,22819,6.24376e+17,97.1137,7997.85,22819,2926,110,16773,16773,11163,10331,6599
41556,8799,9990,39136,2420,39136,2420,4.8428e+18,98.3115,13110.2,41556,4727,111,41143,41143,41143,41143,41143
10515,1403,2452,3698,6817,0,10515,9.96071e+12,59.7621,3422.22,10515,1191,72,8063,8063,6526,7795,4813
22252,1261,5587,7883,14369,0,22252,9.67463e+12,59.6921,7287.08,22252,2718,72,16665,16665,8674,14535,4430
25690,9818,11194,0,25690,9953,15737,1.86183e+15,55.7991,12720.1,25690,5439,72,31348,31348,31348,31348,31348
23451,2285,9267,0,23451,0,23451,5.12637e+17,95.0513,10989.6,23451,4489,110,14184,14184,8661,7162,4986
34294,641,1032,0,34294,33317,977,3.56296e+16,214.708,3407.56,34294,154,26,41725,41725,41725,41725,41725
10260,1063,3771,0,10260,3837,6423,2.08385e+15,57.4252,4594.08,10260,1823,72,6489,6489,4350,3512,2017
9195,881,3310,8736,459,8736,459,1.87562e+18,90.0028,4197.19,9195,1557,111,5885,5844,3863,3493,1433
32866,12063,12936,0,32866,12492,20374,2.00322e+15,57.438,14897.6,32866,6296,72,19930,19930,19538,19417,19083
31174,69,176,31096,78,31174,0,6.0543e+18,171.632,2175.95,31174,165,164,24389,16036,14680,6601,2636
37802,662,1321,0,37802,36713,1089,3.89815e+16,270.15,4347.45,37802,213,26,29160,29064,20017,14557,8787
15954,144,899,0,15954,15486,468,4.32147e+16,177.496,2500.76,15954,126,26,15838,15838,15838,15838,15838
6538,1226,3391,0,6538,2613,3925,1.61828e+15,54.8261,3872.75,6538,1647,72,3205,3205,2726,2803,2424
23160,35,176,23140,20,23160,0,6.05368e+18,168.776,1872.42,23160,151,156,22825,22617,22633,22611,22606
25397,10947,13110,25397,0,24375,1022,6.03497e+18,262.857,14322.8,25397,3985,134,28874,28874,28874,28874,28874
33935,3309,11601,0,33935,12571,21364,2.17182e+15,58.2922,13748.6,33935,5642,72,33827,33827,33827,33827,33827
1134,82,416,1074,60,0,1134,2.05756e+18,78.4136,612.978,1134,162,44,621,216,445,428,365
14517,75,175,14512,5,14517,0,5.9684e+18,164.833,1427.83,14517,140,147,16672,11603,10548,0,3712
16352,118,176,16284,68,16352,0,5.99301e+18,165.875,1527.26,16352,151,147,15214,13778,10887,11100,11240
37487,8001,8773,35307,2180,35307,2180,3.35995e+18,97.8139,11737.9,37487,4252,110,31812,31812,31812,31812,31812
28092,6212,18206,6061,22031,0,28092,2.23454e+13,5.51844,20897.5,28092,6072,13,25920,25920,21048,15291,13016
43512,1353,10205,0,43512,0,43512,6.47638e+17,97.8606,13533.1,43512,4950,110,36109,36109,23122,32351,16875
13819,4468,5584,13189,630,13189,630,2.90496e+18,93.6529,6733.97,13819,2679,110,8235,8235,7308,7667,7222
14581,4565,5947,14581,0,13851,730,4.84681e+18,124.87,6869.06,14581,2474,120,18479,18479,18479,18479,18479
46579,12271,14182,0,46579,0,46579,5.87879e+17,96.7785,17442.9,46579,6880,110,36824,36824,36824,36824,36824
39426,6432,14315,14760,24666,0,39426,8.2139e+12,57.7692,16675.5,39426,6956,72,31158,31158,28299,28976,27644
43909,11603,12665,41535,2374,0,43909,2.06963e+18,97.0287,15832.9,43909,6150,110,27672,27672,22655,24475,20577
39843,2004,12008,37725,2118,37725,2118,6.90609e+18,96.7979,14899,39843,5827,110,35422,35422,31891,31477,28520
32563,1036,7644,0,32563,0,32563,6.48057e+17,97.753,10293.6,32563,3704,110,37263,37263,36655,36531,32131
35414,63,206,35403,11,35414,0,5.9811e+18,186.13,2316.59,35414,181,173,47834,47681,39688,40491,47588
16206,2637,8269,16206,0,15549,657,5.53106e+18,212.61,9213.62,16206,1913,122,7937,7670,5930,6133,2907
1385,99,174,1385,0,1385,0,6.06054e+18,114.14,454.425,1385,62,53,1129,762,731,753,805
43560,1065,1196,0,43560,42316,1244,3.55557e+16,248.411,4136.88,43560,187,26,40603,40516,39618,39299,38241
1195,77,377,1125,70,0,1195,2.24276e+18,85.7071,590.867,1195,156,48,656,220,280,256,272
21189,5346,7584,21189,0,20039,1150,3.43288e+18,145.821,8814.52,21189,3063,124,18248,18248,13891,12985,9351
19346,4056,4677,18216,1130,18216,1130,4.23525e+18,97.9181,6409.77,19346,2199,111,14669,14669,13523,13774,13220
9580,61,175,9514,66,9580,0,5.98731e+18,161.954,1161.27,9580,124,126,18903,10632,7292,8796,7995
31033,3547,7295,29226,1807,29226,1807,3.35854e+18,97.746,9847.77,31033,3533,110,32056,32056,23766,14220,13018
32635,11484,14899,32635,0,31197,1438,4.73718e+18,434.059,16610.9,32635,3626,134,17736,17626,16509,17340,14979
23837,1,11,23157,680,23825,12,1.3876e+14,10.1863,432.394,23837,11,11,4161,4161,4161,4161,4161
27218,7600,7925,25748,1470,25748,1470,6.56713e+18,96.799,10099.6,27218,3838,110,26383,26383,18958,24105,9509
21465,51,175,21395,70,21465,0,5.9834e+18,166.196,1733.69,21465,159,156,13787,6752,5405,6359,6348
43542,955,1244,0,43542,41995,1547,1.14668e+16,7.94497,6773.2,43542,318,10,43309,43309,43309,43309,43309
10710,1658,3999,10198,512,10198,512,2.92445e+18,94.6003,4986.15,10710,1917,110,34399,34399,20911,32006,3588
31692,190,1337,9244,22448,0,31692,6.92444e+18,15.9902,2004.28,31692,1331,17,30355,30355,15494,13733,23490
7354,6,11,7137,217,7346,8,1.76448e+14,10.0383,250.743,7354,11,11,7075,6893,6377,5847,4986
27319,4958,6412,0,27319,9602,17717,2.53061e+15,59.971,8447.4,27319,3118,72,40691,46218,0,0,0
38860,9150,10100,13836,25024,0,38860,9.54278e+12,59.622,12735.8,38860,4916,72,23379,23379,20080,22699,14821
48612,20,176,48554,58,48612,0,6.01895e+18,173.861,2685.31,48612,174,175,15538,4152,3119,7087,3125
27740,9883,13781,27740,0,26570,1170,4.74785e+18,315.876,15067.6,27740,3195,134,24316,24316,24316,24316,14275
7539,855,1820,7098,441,0,7539,2.23864e+18,96.3118,2695.6,7539,865,101,5719,5719,4554,4163,3111
43960,2477,10210,15444,28516,0,43960,9.90379e+12,60.0773,13214.5,43960,4969,72,46663,46663,46663,46663,46663
32182,7010,11092,30564,1618,30564,1618,4.24014e+18,96.6256,13375.7,32182,5304,111,21090,21090,15772,16841,13603
35804,911,1617,0,35804,34753,1051,4.44735e+16,306.049,5161.38,35804,271,26,45597,0,0,7093,1672
3156,528,1120,3156,0,2969,187,3.16759e+18,89.4515,1468.88,3156,394,72,2036,2036,1385,1661,1253
48411,8063,13544,45761,2650,45761,2650,6.56277e+18,97.1819,16998.2,48411,6574,110,48084,48084,48084,48084,48084
47361,1027,1518,0,47361,45993,1368,3.85461e+16,293.992,5180.81,47361,252,26,30000,29478,22951,24727,21614
41000,4296,9800,38610,2390,38610,2390,5.31406e+18,98.3325,12894.7,41000,4638,111,47912,47912,47912,47912,47912
41887,8480,9769,39447,2440,39447,2440,3.22398e+18,97.874,13006,41887,4732,110,32118,32118,30820,31723,28470
34641,3446,8314,32622,2019,32622,2019,2.42908e+18,98.269,11023.8,34641,3935,111,29630,29630,28201,29331,25475
34779,3807,8161,0,34779,0,34779,6.46519e+17,97.7632,10953.9,34779,3941,110,26476,26476,25586,25676,23864
48359,10742,17521,46019,2340,46019,2340,7.61205e+18,95.8384,20656.8,48359,8506,110,36672,36672,36253,36602,35960
17424,208,538,0,17424,17157,267,2.46395e+16,3.73491,2108.78,17424,271,4,14343,14309,3485,8778,2562
31021,6,14,30138,883,30950,71,1.38946e+14,10.6002,532.599,31021,13,12,4104,1074,414,607,100
38048,1743,8860,0,38048,13378,24670,2.5313e+15,60.0527,11528.9,38048,4310,72,29750,29750,27266,25119,7414
3491,87,206,3485,6,3491,0,6.2552e+18,156.571,781.891,3491,81,84,2860,2225,1465,1515,1589
10529,431,2561,9915,614,9915,614,5.78761e+18,96.8484,3677.22,10529,1223,110,7968,7968,6466,5384,1940
22918,904,7438,21729,1189,21729,1189,3.95559e+18,96.73,9242.7,22918,3541,111,15480,15480,7155,9853,3597
5874,1351,2609,2270,3604,0,5874,7.32502e+12,55.9539,3103.95,5874,1267,72,3265,3265,2801,3185,2490
8525,739,2111,8035,490,8035,490,5.82794e+18,96.3072,3067.73,8525,997,108,6414,6414,36512,36252,33212
14663,3176,4662,14663,0,13813,850,5.15896e+18,123.026,5657.52,14663,1762,121,14218,14218,12472,13836,9343
8917,5,13,8656,261,8850,67,1.74561e+14,10.6751,301.547,8917,12,12,8253,7579,6484,6136,5364
40660,4225,9494,0,40660,0,40660,6.479e+17,97.8506,12652.7,40660,4601,110,27393,27393,18743,15340,10824
48322,14205,16161,17854,30468,0,48322,8.57639e+12,57.8248,19054.2,48322,7852,72,35682,35682,35682,35682,35682
24823,3719,9839,23683,1140,0,24823,1.76072e+18,93.3606,11634.1,24823,4752,110,23376,23376,23376,23376,23376
47824,854,14924,45324,2500,0,47824,2.00176e+18,96.6502,18220.4,47824,7248,110,33764,33620,19789,31096,2126
38724,920,1879,8013,30711,0,38724,5.818e+13,11.9942,2522.05,38724,1610,14,48067,48067,48067,48067,48067
13039,4679,6487,0,13039,5187,7852,1.66736e+15,52.3522,7319.69,13039,3138,72,6552,6552,5736,5239,4970
4333,140,170,4329,4,4333,0,5.96763e+18,152.966,776.36,4333,95,99,4077,3827,3520,3510,3535
28667,5329,10873,0,28667,10809,17858,2.04766e+15,48.5498,12666.7,28667,5274,72,17794,17794,17685,17727,17663
30075,22,176,30021,54,30075,0,6.09218e+18,168.966,2147.36,30075,153,160,12395,2106,4700,24,45
16525,720,742,0,16525,16050,475,3.71211e+16,67.4456,2053.86,16525,97,26,15783,15783,15727,15719,15562
48219,16256,21361,46179,2040,46179,2040,2.64176e+18,94.572,24173.2,48219,10376,110,34120,34120,34120,34120,34120
1200,434,756,1200,0,1150,50,7.53343e+18,79.5308,882.559,1200,315,41,444,360,258,386,299
18121,3940,4404,17069,1052,17069,1052,4.56131e+18,97.8038,6055,18121,2063,111,21064,21064,21064,21064,21064
35984,766,1636,0,35984,34926,1058,4.46355e+16,301.964,5220.69,35984,276,26,29073,29073,17201,14989,2737
5377,690,1859,0,5377,0,5377,5.72691e+17,94.1614,2475.32,5377,887,94,3518,3518,2719,2273,2288
20753,28,176,20705,48,20753,0,6.08949e+18,167.88,1783,20753,145,149,10391,3007,3298,3387,3323
4298,1135,1352,4068,230,0,4298,2.05248e+18,93.5987,1893.74,4298,631,81,2946,2946,2771,2731,2801
33542,1029,1172,0,33542,32958,584,2.55538e+16,3.73532,4499.1,33542,588,4,29638,29638,25041,26701,23734
37845,11559,11718,35859,1986,35859,1986,6.85177e+18,96.5992,14468.4,37845,5680,110,27663,27663,27663,27663,27663
42637,6848,9993,0,42637,0,42637,6.47446e+17,97.873,13274.4,42637,4845,110,35368,35368,34403,34011,33916
21084,7680,9742,21084,0,20144,940,4.11761e+18,228.321,10918.2,21084,4313,127,30067,30067,27673,26820,23846
24746,3049,6429,0,24746,8811,15935,2.44239e+15,59.5518,8264.63,24746,3121,72,18317,18317,14073,10153,9005
16364,4101,4630,15464,900,0,16364,2.09918e+18,96.672,6120.02,16364,2236,110,42366,42366,42366,42366,42366
8087,2743,4018,0,8087,3213,4874,1.66693e+15,55.3204,4602.41,8087,1942,72,4069,4069,3245,2504,2471
31896,3964,20671,6890,25006,0,31896,2.23421e+13,5.52135,23720.6,31896,6890,13,11225,11225,8161,8573,3319
30305,5910,7331,28555,1750,28555,1750,5.85381e+18,97.6527,9819.74,30305,3551,110,22974,22974,22100,21967,18906
15204,377,3597,0,15204,5337,9867,2.52149e+15,59.788,4880.25,15204,1745,72,11450,11450,4472,5005,1976
28455,7258,9053,26975,1480,0,28455,1.98813e+18,95.9172,11236.7,28455,4386,110,20095,20095,19892,19847,19231
3204,119,803,0,3204,1120,2084,2.51085e+15,58.117,1199.27,3204,379,62,2401,2401,1427,930,401
17123,3836,7812,6689,10434,0,17123,7.04268e+12,56.3555,8895.08,17123,3799,72,34618,34618,22551,17687,12517
6909,2955,3921,2829,4080,0,6909,5.65431e+12,47.1502,4388.95,6909,1887,66,2988,2988,2950,2978,2953
22988,534,5370,8077,14911,0,22988,9.89445e+12,59.9478,7145,22988,2612,72,17618,17618,10556,16400,2003
43516,82,1197,0,43516,42275,1241,3.5585e+16,249.763,4139.89,43516,188,26,42306,42306,30372,33617,24330
27735,145,175,27723,12,27735,0,5.98544e+18,167.222,1969.72,27735,166,161,39889,37387,31926,32030,32752
13250,655,791,0,13250,12861,389,4.22829e+16,122.642,2096.65,13250,104,26,12459,12343,12352,12329,11887
35631,455,11400,33774,1857,33774,1857,4.86316e+18,97.0294,13941.3,35631,5437,111,24231,23970,10289,20554,8293
48222,3898,18892,0,48222,0,48222,5.14751e+17,94.6875,21904.8,48222,9168,110,47951,47951,47951,47951,47951
27928,1226,8876,0,27928,0,27928,5.77923e+17,96.3735,11029.7,27928,4296,110,27540,27540,27540,27540,27540
34093,1086,7953,11982,22111,0,34093,9.89723e+12,60.0387,10389.7,34093,3873,72,42435,42435,41544,41131,36690
11078,603,4058,10535,543,10535,543,5.05611e+18,95.5707,5066.49,11078,1937,111,7020,6933,3258,4378,2216
35099,6994,8283,33059,2040,0,35099,2.22439e+18,97.7709,11089.3,35099,4011,110,20877,20877,10666,13796,9239
10268,137,222,0,10268,9437,831,2.90674e+16,10.1651,557.409,10268,217,11,10046,10046,9791,9178,9627
16965,2697,3976,0,16965,5967,10998,2.5373e+15,59.9107,5376.02,16965,1936,72,12989,12989,11418,9436,8962
17269,466,848,0,17269,16768,501,4.01952e+16,122.265,2394.87,17269,118,26,24492,24492,18783,14297,2649
16466,138,694,0,16466,15995,471,3.55562e+16,21.088,1906,16466,88,26,15772,15771,11545,11491,5119
23780,7288,8854,22640,1140,0,23780,1.83371e+18,95.4361,10640.4,23780,4294,110,22184,22184,22184,22184,22184
40541,9132,17652,38801,1740,0,40541,1.64456e+18,94.6456,20134.2,40541,8575,110,31533,31533,31533,31533,31533
16879,4211,4433,6009,10870,0,16879,9.51776e+12,59.3807,5785.05,16879,2148,72,12446,12446,12159,12396,11969
23060,1713,9267,8787,14273,0,23060,7.73371e+12,57.2616,10730.8,23060,4505,72,29192,29192,25075,28245,0
45859,702,1815,0,45859,44518,1341,4.2651e+16,321.004,6009.6,45859,312,26,45745,45745,45745,45745,45745
32136,15151,16773,0,32136,6987,25149,1.35014e+13,8.96434,17133,32136,15091,11,30897,30897,30897,30897,30897
3176,370,830,0,3176,0,3176,6.42593e+17,93.2944,1292.98,3176,378,71,21173,20530,18318,15992,7715
11022,2883,3980,10482,540,10482,540,7.52988e+18,88.71,5005.74,11022,1898,110,7042,7042,6747,6706,5920
41579,8474,13109,15219,26360,0,41579,8.82352e+12,58.6045,15727.2,41579,6364,72,31494,31051,29392,29919,29403
46441,10740,13209,16750,29691,0,46441,9.23146e+12,59.2555,16174.1,46441,6435,72,38335,38335,38335,38335,38335
45610,4852,10678,0,45610,0,45610,6.4835e+17,97.8973,14134.3,45610,5181,110,26063,26063,18476,13758,12277
24967,4740,9547,24967,0,17454,7513,3.96362e+18,170.13,10753.2,24967,3750,125,15420,15406,11113,12980,8338
37208,7,12,36145,1063,37188,20,1.38869e+14,10.2605,544.966,37208,11,12,33543,29606,20838,21324,6002
48258,9234,11234,16966,31292,0,48258,9.88997e+12,60.0975,14481.6,48258,5471,72,48900,48900,48900,48900,48900
29430,131,932,0,29430,28592,838,3.55024e+16,180.568,2984.73,29430,135,26,28318,28212,19288,19156,8312
16188,1978,5888,15398,790,0,16188,1.86407e+18,92.2233,7240,16188,2833,110,10300,10300,7308,6546,4202
5744,8,11,5581,163,5742,2,1.3863e+14,10.071,211.579,5744,11,11,5596,5514,5273,5272,4705
37043,2988,8657,34883,2160,34883,2160,3.34673e+18,97.858,11593.2,37043,4196,110,28386,28386,29553,34441,23418
17774,419,4222,0,17774,0,17774,6.45072e+17,97.3413,5885.14,17774,2021,110,16913,15795,5439,11929,0
11977,2868,4127,11370,607,11370,607,4.11153e+18,95.9478,5220.17,11977,1960,111,7850,7850,6525,7762,4756
16624,5902,6236,15824,800,15824,800,1.82975e+18,94.461,7580.92,16624,2963,111,10388,10388,10069,10367,9892
46561,1200,10792,16362,30199,0,46561,9.91592e+12,60.0948,13941.9,46561,5257,72,33246,33246,22123,26507,10282
36769,3777,8612,0,36769,12939,23830,2.53061e+15,60.048,11203.5,36769,4194,72,22974,22974,17046,20967,11004
44345,2968,24335,42823,1522,42823,1522,2.41746e+18,91.941,26570.8,44345,11818,110,33444,33444,22396,31449,8147
16384,164,200,16378,6,16384,0,5.97972e+18,179.754,1564.95,16384,146,151,15937,15259,14148,14236,14138
39099,96,1114,0,39099,37984,1115,3.55414e+16,231.732,3778.13,39099,171,26,26376,8511,11131,17377,1358
1585,184,461,1492,93,0,1585,2.26001e+18,88.9558,731.208,1585,202,53,1124,1124,728,701,594
48570,11613,15845,17871,30699,0,48570,8.6726e+12,58.5885,18777.9,48570,7704,72,34771,34771,33641,33661,33037
43528,11342,15081,0,43528,16171,27357,2.15767e+15,58.2596,17691.7,43528,7342,72,41908,41908,41908,41908,41908
31369,23998,31369,0,31369,0,31369,524271,0,31369,31369,31369,1,21811,21811,21811,21811,21811
31358,6541,10382,29748,1610,29748,1610,4.09302e+18,96.8261,12656.5,31358,4958,111,20976,20976,18336,20805,14493
44467,5710,13136,0,44467,0,44467,5.95771e+17,96.8906,16309,44467,6375,110,26869,26869,26702,26657,26623
48710,43,176,48639,71,48710,0,6.05336e+18,173.906,2717.3,48710,173,175,20413,10976,14462,13841,8335
16791,591,4732,15871,920,0,16791,2.09716e+18,96.2687,6257.58,16791,2266,110,12059,11973,7755,6880,2719
29317,5203,8057,27699,1618,27699,1618,6.29871e+18,97.0734,10399,29317,3897,110,20677,20657,16732,18170,11392
43068,18,176,43014,54,43068,0,6.01242e+18,172.525,2518.07,43068,173,171,11249,1053,1049,4228,1628
22200,469,5190,0,22200,7800,14400,2.52664e+15,59.9287,6920.42,22200,2515,72,47704,47704,47704,47704,47704
1284,152,462,1214,70,1214,70,3.53381e+18,85.6713,675.574,1284,197,49,822,739,458,571,464
15665,8,10,15219,446,15660,5,1.38896e+14,9.94536,346.257,15665,10,10,15293,15113,14383,14384,12967
22954,4730,7748,21785,1169,21785,1169,5.37125e+18,96.558,9529.29,22954,3690,111,15206,15206,13040,14411,9408
22044,536,913,0,22044,21410,634,3.85327e+16,176.402,2723.57,22044,130,26,21131,20869,18444,18802,14806
30043,8821,10518,0,30043,11181,18862,2.1516e+15,58.1532,12441.6,30043,5124,72,19525,19525,18358,18052,16572
12534,3191,4160,0,12534,0,12534,5.71319e+17,95.5437,5318.99,12534,2003,110,35174,35174,19246,30672,8327
19968,910,4718,0,19968,0,19968,6.48496e+17,97.4664,6534.58,19968,2275,110,15250,15250,7305,4759,3844
27389,2595,10408,26088,1301,26088,1301,4.61371e+18,93.2098,12346.8,27389,4975,111,16981,16981,8341,10644,4783
5694,108,186,5689,5,5694,0,5.97741e+18,166.968,911.525,5694,106,108,47674,6131,6131,6131,6131
24637,7139,11415,23617,1020,23617,1020,6.90689e+18,94.0656,13018.9,24637,5483,111,36627,36627,36627,36627,36627
1044,271,338,0,1044,0,1044,6.57385e+17,84.8879,529.021,1044,145,46,706,706,653,656,673
7671,1329,1879,0,7671,2704,4967,2.49421e+15,59.2625,2636.98,7671,900,72,5792,5792,5018,4408,4229
17405,3845,5788,17405,0,16395,1010,3.97712e+18,137.013,6780.4,17405,2082,120,11617,11552,9477,10445,8116
41096,4480,9600,38706,2390,38706,2390,5.87558e+18,97.8353,12788.7,41096,4651,110,49024,49024,49024,49024,49024
48357,9998,15340,48357,0,45537,2820,3.69801e+18,327.737,17328,48357,5722,129,34908,34908,32642,34518,30052
43254,6385,17703,16553,26701,0,43254,7.61791e+12,56.9491,20100.1,43254,8618,72,20578,20578,13596,8601,6371
34350,35,176,34336,14,34350,0,5.98516e+18,172.703,2198.67,34350,164,169,20057,8340,8612,9719,9226
3835,309,981,0,3835,0,3835,6.3867e+17,94.302,1515.09,3835,443,79,2854,2854,1690,1480,1205
42628,14239,18231,40775,1853,40775,1853,2.77249e+18,94.669,20838.8,42628,8850,110,45570,45570,45570,45570,45570
11166,1848,4449,0,11166,0,11166,5.15045e+17,94.4064,5435.52,11166,2146,109,6717,6717,4554,4606,3245
30661,13429,14092,30661,0,29319,1342,4.8067e+18,415.429,15715.6,30661,6219,136,16569,16569,16565,16567,16468
4616,2078,2665,4616,0,4446,170,4.38631e+18,89.5154,3020.85,4616,1157,78,1951,1951,1864,1920,1945
35593,5464,18746,34305,1288,34305,1288,2.40348e+18,93.1525,20700.6,35593,9108,110,32323,32323,32323,32323,0
28956,4,14,28127,829,28879,77,1.39046e+14,10.7541,526.68,28956,13,12,4277,1021,167,868,59
22819,4557,12305,0,22819,9251,13568,1.5244e+15,54.4637,13496,22819,5973,72,10514,10514,7520,7368,4122
37128,818,1076,0,37128,36072,1056,3.55359e+16,223.39,3616.1,37128,164,26,27278,26846,21894,20532,15931
28921,5579,10361,27511,1410,0,28921,1.87024e+18,94.9566,12473.3,28921,5006,110,19733,19733,16908,19143,12287
1784,49,259,0,1784,1730,54,5.9294e+16,16.083,557.493,1784,44,24,1525,1517,1063,824,287
27311,31,208,27249,62,26805,506,6.20159e+18,194.879,2178.95,27311,155,156,13055,1477,2966,5963,1886
31525,506,972,0,31525,30627,898,3.55682e+16,195.608,3161.88,31525,143,26,30553,30218,25709,26320,20169
17539,1543,5107,16589,950,16589,950,6.54216e+18,96.589,6665.96,17539,2466,110,29784,29784,18841,27855,5337
6282,5178,6282,0,6282,6282,0,2047.67,0,6282,6282,6282,1,0,0,0,0,0
20834,4026,4928,0,20834,7334,13500,2.52526e+15,59.7451,6567.89,20834,2395,72,15906,15906,14587,13865,13181
45041,1845,2626,43197,1844,13656,31385,1.46902e+18,16.9957,3445.05,45041,1595,27,36130,36130,31819,28243,13855
43986,16074,16268,41876,2110,0,43986,1.83501e+18,95.7212,19148.2,43986,7906,110,36760,36760,36760,36760,36760
20962,1,12,20357,605,20951,11,1.56972e+14,10.2474,423.194,20962,12,11,4653,4653,4653,4653,4653
37722,4094,8881,35527,2195,35527,2195,5.78321e+18,97.8035,11850.2,37722,4300,110,28841,28841,25996,25525,14586
44557,41,176,44474,83,44557,0,6.00417e+18,173.823,2546.8,44557,171,172,27054,7194,16711,23750,137
13319,327,474,0,13319,13084,235,2.56549e+16,3.73406,1850.04,13319,239,4,12845,12845,12830,12741,10553
46176,3,176,46098,78,46176,0,5.98195e+18,169.795,2543.47,46176,171,171,7839,6519,6432,6319,6159
16067,1954,4296,5748,10319,0,16067,9.47875e+12,58.8517,5591.52,16067,2087,72,11771,11771,9328,11229,5878
9744,1140,3087,0,9744,0,9744,5.82615e+17,86.7594,4071.16,9744,1472,108,6657,6657,4010,2304,957
43385,2878,14227,0,43385,0,43385,5.69569e+17,96.3966,17223,43385,6911,110,43639,43639,43639,43639,43639
36710,1051,10734,0,36710,0,36710,5.98358e+17,96.8674,13473,36710,5201,110,25976,25976,11865,4796,4462
9184,1393,2194,8646,538,0,9184,2.23851e+18,96.7127,3210.38,9184,1044,110,6990,6990,6087,5797,4930
28577,6400,13105,27397,1180,27397,1180,2.60276e+18,94.1754,14942.9,28577,6362,110,27062,27062,27062,27062,27062
37706,2,10,37114,592,37610,96,9.68732e+13,3.99812,519.273,37706,7,4,24992,19965,19320,20049,17589
4865,32,176,4860,5,4865,0,6.05835e+18,150.151,862.933,4865,95,94,2653,817,909,915,877
36252,39,176,36167,85,36252,0,6.00973e+18,172.704,2307.16,36252,171,167,23257,16605,19520,18505,15359
2584,272,962,0,2584,971,1613,2.18707e+15,52.0824,1260.69,2584,463,59,1622,1599,922,197,145
14515,534,736,0,14515,14097,418,3.86723e+16,61.9363,1981.79,14515,96,26,0,0,0,0,0
13000,1324,7352,12591,409,12591,409,1.33909e+18,162.232,8461.3,13000,2394,270,5648,5559,3942,3999,3509
35784,11319,19263,35784,0,35784,0,4.36556e+18,17.9832,19782.3,35784,17327,20,30460,30460,30460,30460,30460
31930,4004,9068,30180,1750,30180,1750,2.40392e+18,97.5229,11500.8,31930,4311,111,24570,24570,20184,19286,15004
1704,6,10,1655,49,1704,0,1.38095e+14,9.5,112.544,1704,10,10,1620,1581,1467,1467,1133
31115,1,13,30230,885,31040,75,1.38951e+14,10.6836,544.235,31115,12,12,5218,5218,5218,5218,5218
12030,1861,6435,4869,7161,0,12030,6.07082e+12,55.0195,7173.02,12030,3132,72,11397,11397,11397,11397,11397
10924,791,10211,0,10924,3405,7519,2.36172e+15,3.98142,10260.6,10924,3432,9,2155,0,0,0,0
5542,2232,2573,5311,231,0,5542,1.60033e+18,91.3443,3121.05,5542,1229,89,26329,26243,17416,10253,6551
3196,27,205,3196,0,3196,0,6.20904e+18,142.175,748.668,3196,85,78,1535,511,520,506,444
9107,1543,3170,3379,5728,0,9107,8.39342e+12,57.7293,3941.32,9107,1530,72,5937,5937,3845,5577,1448
11034,124,4874,11034,0,10494,540,3.78073e+18,120.699,5562.81,11034,1941,120,6146,1878,3143,4166,604
35610,5343,14877,0,35610,0,35610,4.92849e+17,94.8792,17173.9,35610,7223,110,35310,35310,35310,35310,35310
24144,1616,5730,22742,1402,0,24144,2.22425e+18,97.5627,7826.94,24144,2768,110,18590,18574,14572,14620,1456
21109,4773,7825,0,21109,7930,13179,2.08043e+15,55.7275,9251.89,21109,3789,72,13284,13284,11085,8040,7542
42531,13864,15890,40508,2023,40508,2023,7.77475e+18,95.6161,18683.4,42531,7715,110,42295,42295,42295,42295,42295
35685,1746,8365,33608,2077,0,35685,2.22771e+18,97.7792,11213.2,35685,4048,110,37420,37420,37420,37420,37420
31271,10416,15249,0,31271,12401,18870,1.69634e+15,55.9957,16898.4,31271,7426,72,16022,16022,12937,10796,9403
9678,454,2365,0,9678,0,9678,6.44089e+17,96.6455,3416.55,9678,1127,110,7313,7313,3437,2471,1953
45707,3893,18202,45707,0,43395,2312,4.57105e+18,464.083,20144.4,45707,7057,138,45553,45553,45553,45553,45553
34915,174,176,34899,16,34915,0,5.99625e+18,170.402,2248.39,34915,166,169,34826,34826,34826,34826,34826
12430,401,534,0,12430,0,12430,3.84071e+18,15.9743,945.908,12430,528,17,11896,11896,10213,10593,11113
42035,484,13065,39835,2200,39835,2200,7.04475e+18,96.1287,16051,42035,6323,110,30386,29863,17586,28186,2023
13136,704,5063,13136,0,12448,688,4.7416e+18,128.377,5943.93,13136,2075,120,8073,7922,4597,5612,1764
32488,161,176,32482,6,32488,0,5.9794e+18,169.714,2135.59,32488,169,167,18258,16917,8030,11602,785
48834,20,176,48811,23,48834,0,5.9834e+18,171.812,2617.84,48834,172,172,24405,11190,12530,13024,12546
21228,4040,9474,8265,12963,0,21228,7.16102e+12,54.4581,10769,21228,4610,72,11754,11754,8689,11227,5179
10471,9,12,10169,302,10463,8,1.45805e+14,10.3321,291.08,10471,12,11,10343,10230,9734,9673,9444
11613,6,12,11269,344,11605,8,1.79409e+14,10.1445,320.732,11613,11,11,11149,10953,9103,8745,6285
40957,100,206,40878,79,40957,0,5.98765e+18,194.886,2481.64,40957,178,177,28384,10003,12276,18388,5026
10296,363,433,0,10296,10003,293,3.54059e+16,20.0277,1224.62,10296,64,26,9863,9863,9739,9746,8785
29269,3578,6890,0,29269,0,29269,6.4778e+17,97.7117,9327.05,29269,3335,110,23383,23325,22449,21876,21985
5621,145,170,5621,0,5621,0,5.96849e+18,155.758,882.96,5621,104,108,18393,18090,10611,7890,519
19984,1316,4687,0,19984,7023,12961,2.52397e+15,59.8825,6278.42,19984,2269,72,39581,39581,39581,39581,39581
11290,757,6182,5127,6163,11290,0,2.64333e+18,17.8963,6462.21,11290,5549,20,5108,5108,717,5108,763
8310,349,1987,7820,490,0,8310,2.24307e+18,96.5335,2929.3,8310,949,106,6323,6323,4084,3650,1583
39027,6965,9748,13827,25200,0,39027,9.66162e+12,59.788,12425.9,39027,4740,72,29279,29279,25968,28589,20515
21425,4255,5054,0,21425,7546,13879,2.52664e+15,59.7724,6731.81,21425,2457,72,34417,34417,26158,17643,14743
1485,190,422,1395,90,0,1485,2.27489e+18,89.6465,683.592,1485,186,51,1063,1063,770,774,654
40224,1857,9360,14134,26090,0,40224,9.88088e+12,60.0579,12155.9,40224,4547,72,40075,40075,40075,40075,40075
20328,3984,7317,20328,0,19201,1127,4.95789e+18,142.777,8390.63,20328,1700,126,43482,43482,43482,43482,43482
11308,2305,4518,0,11308,4297,7011,1.99942e+15,55.521,5369.7,11308,2184,72,6790,6790,5065,4801,3123
41669,10116,19354,0,41669,0,41669,4.54121e+17,92.5892,21787.1,41669,9404,110,22315,22315,17435,14188,12658
5536,1813,2016,0,5536,2068,3468,2.15969e+15,57.263,2536.68,5536,982,72,3520,3520,3241,3100,3068
39347,4,14,38218,1129,39294,53,1.4474e+14,10.4663,618.481,39347,13,11,9739,8185,7433,7504,7256
32178,4593,13682,30768,1410,30768,1410,8.52732e+18,94.1797,15788.3,32178,6624,110,25078,25078,17891,10771,9705
28905,2614,8986,27375,1530,27375,1530,2.16871e+18,96.9546,11173.7,28905,4262,111,19919,19919,12849,25022,16473
11990,6,11,11649,341,11982,8,1.39212e+14,10.3797,306.991,11990,11,11,4442,1449,856,1049,186
3018,494,776,2838,180,2838,180,3.485e+18,93.7462,1222.44,3018,353,69,2242,2242,1735,1958,1697
41466,7724,12312,15045,26421,0,41466,9.07943e+12,59.0512,14973.1,41466,5998,72,44856,44856,44856,44856,44856
19896,6359,7975,18976,920,18976,920,1.76162e+18,95.5198,9460.46,19896,3817,111,11921,11921,11921,11921,10439
44753,15009,19718,42837,1916,42837,1916,8.28992e+18,95.2483,22323.2,44753,9486,111,41429,41429,41429,41429,41429
36980,4501,11928,36980,0,34830,2150,3.69869e+18,262.269,13568.1,36980,3992,130,36664,36664,36664,36664,36664
43732,8969,12818,41382,2350,0,43732,2.05785e+18,96.9311,15955.9,43732,6222,110,32031,32031,25878,20550,18305
43285,12448,15995,41193,2092,41193,2092,4.28526e+18,96.3459,18779.6,43285,7661,111,22758,22758,11722,22680,11242
45200,6089,12929,42730,2470,42730,2470,3.7395e+18,92.3161,16108.4,45200,6160,111,44879,44879,44879,44879,44879
49042,2697,11474,0,49042,0,49042,6.46871e+17,97.8822,15142.9,49042,5559,110,26765,26765,17235,8078,5732
12883,801,4338,12883,0,12133,750,3.24073e+18,104.572,5156.29,12883,1556,121,41630,41630,41630,41630,41630
15238,16,176,15228,10,15238,0,6.07909e+18,170.028,1527.78,15238,139,136,5341,1126,1311,1351,1362
26780,9,13,25988,792,26757,23,1.78607e+14,10.4177,499.086,26780,12,12,26529,26302,22513,22537,21733
18027,167,4778,17017,1010,17017,1010,3.3793e+18,96.959,6413.49,18027,2300,110,36864,36621,32006,28198,2877
14333,926,3381,5043,9290,0,14333,9.93376e+12,59.7822,4601.63,14333,1647,72,10952,10952,7428,10343,3262
2427,762,1109,0,2427,930,1497,1.85149e+15,47.44,1367.25,2427,519,59,1318,1318,1318,1318,1318
7101,173,176,7098,3,7101,0,6.08235e+18,159.858,1041.1,7101,104,108,6922,6910,6848,6843,6844
16068,509,750,0,16068,15609,459,3.77643e+16,74.5489,2065.04,16068,97,26,15318,15251,14038,14220,11520
24508,5303,8333,0,24508,0,24508,5.59407e+17,95.9548,10233.3,24508,4032,110,16175,16175,13538,12536,10646
34980,139,176,34962,18,34980,0,5.98254e+18,169.802,2215.69,34980,170,166,32621,30623,27784,27449,26562
10564,10,12,10258,306,10558,6,1.55339e+14,10.5272,299.523,10564,12,11,3671,697,524,812,871
36567,2998,9901,34537,2030,34537,2030,6.27461e+18,97.258,12695.6,36567,4800,110,30481,30481,21743,28931,10143
42669,3,14,41448,1221,42590,79,1.41506e+14,10.5382,648.194,42669,13,12,39438,36377,37427,37311,33891
16774,1425,4101,15803,971,15803,971,2.45924e+18,97.6943,5657.39,16774,1922,111,14712,14712,10428,13743,4679
30567,4621,8099,28857,1710,28857,1710,6.32917e+18,97.2226,10542.4,30567,3918,110,27574,27574,15783,18846,10471
47045,649,1827,0,47045,45672,1373,4.23248e+16,301.917,6074.56,47045,312,26,34543,34094,21415,27356,13378
49494,1047,11853,46614,2880,46614,2880,5.11477e+18,98.3725,15441.9,49494,5610,111,37177,37177,22183,13395,11244
39432,6723,15227,37592,1840,37592,1840,8.00334e+18,95.4217,17820.8,39432,7393,110,30172,30172,27643,28519,25489
15220,6197,6252,14533,687,14533,687,2.75654e+18,94.4834,7472.75,15220,3016,110,8968,8968,8942,8957,8949
23432,7,11,22762,670,23420,12,1.38683e+14,10.1957,428.205,23432,11,11,4993,1628,1062,1799,772
39295,5155,10481,37104,2191,0,39295,2.13441e+18,97.3152,13450.3,39295,5082,110,28199,26317,17322,21635,10026
33509,211,1107,0,33509,32547,962,3.71782e+16,227.114,3608.63,33509,169,26,32223,31908,27631,26393,11875
42813,69,98,42638,175,42813,0,3.87032e+18,97.3202,1807.9,42813,98,98,21037,6968,16282,4115,21
33296,3258,10651,0,33296,12215,21081,2.24612e+15,58.6757,12824.8,33296,5187,72,33105,33105,33105,33105,33105
15277,6,12,14835,442,15269,8,1.60627e+14,10.2353,363.491,15277,12,11,14578,14285,13207,12577,9964
5026,2,11,4884,142,5022,4,1.38665e+14,10.6635,199.374,5026,11,11,2905,2051,2024,2113,1706
42337,10499,11107,39947,2390,39947,2390,4.88486e+18,97.9644,14202.5,42337,5276,111,41946,41946,41946,41946,41946
680,33,154,680,0,680,0,6.15711e+18,83.4412,298.523,680,46,39,328,95,114,130,125
6449,1430,2970,6449,0,6139,310,5.56796e+18,84.2847,3452.6,6449,1179,101,3479,3479,2574,3087,1352
40432,12653,21970,16420,24012,0,40432,5.88135e+12,54.1864,23816.5,40432,10681,72,28217,28217,24109,23312,19548
32869,7035,7709,0,32869,0,32869,6.48514e+17,97.7886,10377.5,32869,3737,110,33523,33523,33523,33523,33523
29488,532,7059,27768,1720,27768,1720,4.67673e+18,98.1959,9452.13,29488,3328,111,22429,22429,9948,14351,3100
16509,1937,7197,16509,0,15721,788,3.76233e+18,149.044,8180.94,16509,3092,123,39810,39810,39810,39810,39810
35168,1,13,34158,1010,35153,15,1.455e+14,10.1969,540.771,35168,12,12,13591,13591,0,0,0
9494,930,2842,8983,511,0,9494,2.06389e+18,95.7256,3822.28,9494,1360,108,27864,27864,25423,25603,8832
43719,36,176,43634,85,43719,0,5.9823e+18,172.173,2478.46,43719,171,172,16120,2367,8856,6860,596
45685,8676,10683,43025,2660,43025,2660,3.22987e+18,97.9136,14150,45685,5186,110,39454,39454,39454,39454,39454
9207,900,2757,8708,499,0,9207,2.06382e+18,95.8472,3714.08,9207,1324,107,6450,6450,4902,4588,3378
41264,9950,9983,38885,2379,0,41264,2.20487e+18,97.7428,13151.9,41264,4839,110,32922,32922,32922,32922,32922
28719,2997,10528,10762,17957,0,28719,8.16163e+12,57.8798,12351.8,28719,5122,72,28472,28472,28472,28472,28472
12716,1678,6203,5029,7687,0,12716,6.67822e+12,54.7496,7027.36,12716,3005,72,6513,6513,3674,5607,1291
43822,1,17,42521,1301,43750,72,1.82931e+14,10.3662,733.875,43822,14,12,211,211,211,211,211
28738,4038,6774,27068,1670,0,28738,2.22542e+18,97.6774,9177.31,28738,3276,110,21401,21401,18122,13719,12691
27527,144,175,27516,11,27527,0,5.97804e+18,167.328,1962.75,27527,161,165,31953,29382,22517,22604,22833
21000,338,8124,0,21000,7948,13052,2.02911e+15,57.2531,9514.66,21000,3941,72,12876,12588,5236,1965,504
25000,7183,11468,0,25000,0,25000,4.58614e+17,91.0752,13130.2,25000,5545,110,14965,14965,13871,13616,13080
17456,2293,4428,6193,11263,0,17456,9.63279e+12,59.5895,5833.02,17456,2150,72,14498,14498,14032,13909,13878
19058,2004,10208,7720,11338,0,19058,6.01575e+12,49.9418,11249.6,19058,4967,72,31213,31213,31213,31213,31213
1376,91,130,0,1376,1336,40,4.48789e+16,16.1374,315.16,1376,30,23,1246,1246,1210,1204,1096
3108,137,186,3108,0,3108,0,6.015e+18,152.847,673.428,3108,87,84,2846,2701,2258,2293,2221
15480,5210,6206,15480,0,14670,810,4.30614e+18,128.748,7082.78,15480,2125,126,9274,9274,8956,9265,7700
31706,220,1319,0,31706,30782,924,4.16355e+16,260.081,4176.61,31706,210,26,28439,28409,27201,26278,18916
22294,4871,5213,7833,14461,0,22294,9.89147e+12,59.9371,6945.42,22294,2535,72,48903,48903,48903,48903,48903
38233,13282,14551,14432,23801,0,38233,7.99631e+12,57.716,16802.1,38233,7088,72,23682,23682,22907,23546,22142
12883,2843,3107,12138,745,0,12883,2.22113e+18,96.9565,4407.42,12883,1484,110,9776,9776,9513,9451,9311
21958,3221,8766,21958,0,20818,1140,5.53379e+18,173.481,9873.35,21958,2525,131,26042,26042,17901,16358,8399
25664,7232,8723,24370,1294,24370,1294,3.10457e+18,95.997,10688.1,25664,4224,110,16941,16941,14022,15330,12918
26763,28,208,26679,84,26763,0,6.11389e+18,200.089,2183.4,26763,167,163,14016,8746,9519,10472,8292
3578,2212,2476,0,3578,0,3578,2.79996e+17,68.5034,2746.6,3578,1165,55,1102,1102,1091,1092,1102
47054,6230,19792,45204,1850,37928,9126,4.74951e+18,1925.51,22569,47054,6802,144,38988,38988,37135,38388,34848
7084,1034,1765,6674,410,0,7084,2.21389e+18,96.1928,2600.78,7084,836,98,5319,5319,4335,4188,3447
21475,1,14,20858,617,21400,75,1.48477e+14,10.7511,460.804,21475,13,12,7412,7412,7412,7412,7412
37679,7359,11652,0,37679,13758,23921,2.28485e+15,58.8505,14080.6,37679,5676,72,25312,25193,22993,24184,22223
21304,1096,6636,21304,0,20064,1240,5.48136e+18,156.599,7920.45,21304,2541,125,16592,16438,8155,11468,2595
32086,13,14,31163,923,32003,83,1.46694e+14,10.7317,569.132,32086,13,12,4693,740,670,977,829
39949,2047,20381,38449,1500,38449,1500,4.78609e+18,93.1449,22541.7,39949,9814,111,32514,32514,24651,21775,15109
30297,5767,10649,11273,19024,0,30297,8.3532e+12,58.1283,12589.4,30297,5179,72,30032,30032,30032,30032,30032
24618,1643,8225,24618,0,23198,1420,4.59481e+18,165.15,9457.76,24618,3031,124,28372,27867,12818,18890,4062
24381,7,11,23682,699,24372,9,1.41032e+14,10.1764,439.731,24381,11,11,23537,22979,21727,21603,17440
5193,1134,1646,1885,3308,0,5193,8.83175e+12,53.1103,2174.37,5193,779,71,3547,3547,3547,3547,3547
20280,6325,6799,19243,1037,19243,1037,4.97563e+18,96.4317,8427.51,20280,3234,111,35199,35199,35194,37085,0
10724,7671,10724,10724,0,0,10724,7.99925,0,10724,10724,10724,1,10605,10605,10605,10605,10605
21989,8459,9212,21011,978,0,21989,1.69948e+18,94.3331,10802.3,21989,4464,110,19994,19994,18887,19684,16201
29220,9,14,28373,847,29163,57,1.58067e+14,10.4691,545.526,29220,13,11,11996,10046,9976,9833,9370
5390,622,1354,1901,3489,0,5390,9.87302e+12,58.9557,1930.57,5390,655,72,4036,4036,2956,3846,15891
20017,3418,4732,18854,1163,0,20017,2.22815e+18,97.4275,6552.48,20017,2274,110,47892,47892,47892,47892,47892
27136,4342,6368,9547,17589,0,27136,9.86852e+12,59.9617,8392.81,27136,3097,72,20768,20768,17772,20250,14250
30903,1723,8916,29220,1683,29220,1683,2.61546e+18,97.4316,11274.8,30903,4232,111,22621,22621,15081,6308,5960
11060,1916,5806,10657,403,0,11060,1.40358e+18,89.9741,6632.43,11060,2790,106,5254,5254,3490,3459,2628
3485,173,951,3285,200,0,3485,2.1897e+18,91.9461,1439.5,3485,429,74,2534,2528,1089,1033,782
32231,25,208,32144,87,32231,0,6.08849e+18,193.225,2383.64,32231,167,165,18283,3108,7351,5185,615
14874,3407,3498,0,14874,5237,9637,2.53346e+15,59.8488,4759.3,14874,1704,72,11376,11376,11254,11184,11218
14694,1345,6764,14084,610,14084,610,9.15987e+18,89.0894,7880.26,14694,3272,110,21310,21310,21310,21310,21310
48206,161,176,48114,92,48206,0,6.01579e+18,169.552,2665.02,48206,172,171,41962,41828,30672,27132,26328
47909,650,26702,46281,1628,46281,1628,9.25556e+18,92.9793,28996.1,47909,12891,111,48692,48692,48692,48692,48692
36609,439,1067,0,36609,35567,1042,3.55495e+16,222.224,3576.46,36609,162,26,35542,35094,31728,31886,19642
25173,6157,12983,0,25173,0,25173,4.11237e+17,89.39,14521,25173,6284,110,22955,22955,21788,21208,18970
45176,290,1223,0,45176,43885,1291,3.55152e+16,252.252,4256.53,45176,194,26,45095,45095,45095,45095,45095
41943,8886,9738,0,41943,14742,27201,2.53636e+15,60.081,12627.4,41943,4744,72,34670,34670,28217,31320,25679
17713,3993,7858,6878,10835,0,17713,7.19176e+12,56.5653,8989.79,17713,3821,72,9855,9855,8085,9485,5263
6037,2,11,5859,178,6035,2,1.69901e+14,9.98774,227.839,6037,11,10,3511,2690,2100,2716,1243
33737,30,176,33660,77,33737,0,5.9853e+18,171.067,2183.03,33737,165,169,40429,40082,40104,40083,40065
18706,4152,4415,0,18706,0,18706,6.4861e+17,97.4828,6146.89,18706,2128,110,14291,14291,14004,14001,13794
4304,172,176,4298,6,4304,0,6.1115e+18,152.918,811.948,4304,93,91,4125,4115,4056,4061,4059
21238,1006,7141,20165,1073,20165,1073,2.98733e+18,94.9604,8853.3,21238,3446,110,46484,46484,46484,46484,46484
3086,782,805,2906,180,0,3086,2.23641e+18,93.4861,1257.33,3086,367,71,2281,2281,2263,2266,2281
17451,3395,8227,0,17451,0,17451,4.50748e+17,93.577,9473.85,17451,3984,110,9224,9224,5729,3429,2942
20494,226,871,20494,0,19641,853,2.23631e+18,16.9821,1420.57,20494,863,18,19623,19623,18979,19623,9412
24126,3747,5682,0,24126,8491,15635,2.52911e+15,59.9457,7521.11,24126,2767,72,18444,18444,16168,15701,12503
25972,149,1368,0,25972,25200,772,4.63247e+16,266.064,4150.69,25972,223,26,22026,22079,0,0,0
30372,114,176,30322,50,30372,0,6.04805e+18,171.103,2141.09,30372,165,162,35989,16341,10189,7428,2366
31812,15705,17237,30702,1110,0,31812,1.33791e+18,88.8307,18995.7,31812,8366,110,14575,14575,14072,13988,13946
17156,6472,6560,0,17156,0,17156,5.25541e+17,91.0423,7944.51,17156,3171,110,10596,10596,10503,10508,10527
49509,13388,15736,49509,0,46629,2880,4.76884e+18,338.317,17761.3,49509,4463,137,36488,36488,36488,36488,36488
6817,134,176,6810,7,6817,0,6.12138e+18,160.955,1019.21,6817,102,98,6488,6103,5201,5199,5114
33997,218,1021,0,33997,33030,967,3.5553e+16,209.569,3369.84,33997,152,26,37679,37571,10760,8726,3078
26722,153,176,26715,7,26722,0,5.98545e+18,169.345,1937.74,26722,158,163,26205,25467,23324,23360,23121
43758,15161,17202,43758,0,41506,2252,4.81692e+18,373.831,19012.3,43758,4525,138,42547,42547,42547,42547,42547
3047,5,8,2801,246,3047,0,1.13902e+14,7.75057,133.889,3047,8,8,2713,2428,2058,2059,2476
44788,1440,16360,44788,0,36074,8714,4.08709e+18,350.324,18232,44788,6385,137,24416,24319,9478,19401,1067
11093,496,677,0,11093,10773,320,4.02673e+16,19.7388,1708.91,11093,86,26,10416,10416,9846,9938,8156
1418,642,1204,1418,0,1389,29,4.67403e+18,73.1107,1276.1,1418,545,36,214,122,72,163,194
2847,86,175,2847,0,2847,0,5.97519e+18,144.158,638.613,2847,86,80,2309,1372,1278,1356,1276
15963,4420,4900,15113,850,15113,850,5.2663e+18,89.1604,6308.92,15963,2322,111,11063,11063,11063,11063,11063
26660,104,176,26651,9,26660,0,5.9799e+18,169.646,1935.85,26660,160,164,18250,9506,7842,3768,4423
35541,5627,10486,12887,22654,0,35541,9.08007e+12,59.0528,12845.2,35541,5095,72,23109,23109,16626,9128,8399
3268,130,162,0,3268,3177,91,3.62714e+16,19.6193,469.757,3268,39,26,3106,3106,3044,3049,2726
3409,1,11,3311,98,3407,2,1.58366e+14,9.97947,168.283,3409,11,11,748,748,748,748,748
47720,4452,14764,47720,0,44978,2742,4.14563e+18,328.269,17069.8,47720,5893,130,29692,29226,18978,23486,9041
9216,2172,2199,0,9216,0,9216,6.52196e+17,96.6298,3217.49,9216,1047,110,7017,7017,7013,7016,7017
4656,5,11,4519,137,4655,1,1.60204e+14,9.90851,197.409,4656,11,11,4282,3805,3829,3319,2805
47543,1051,1271,0,47543,46185,1358,3.55703e+16,260.195,4461.31,47543,203,26,31724,31560,23001,21146,12906
16023,155,176,15981,42,16023,0,5.99389e+18,168.474,1521.17,16023,148,148,15671,15263,14072,14094,14034
34048,14,16,33043,1005,33987,61,1.80006e+14,10.4322,631.417,34048,13,12,7254,905,650,937,121
37930,3729,11860,35950,1980,0,37930,2.00027e+18,96.5561,14608.8,37930,5743,110,32914,32914,31287,30969,29680
11135,2090,4738,10637,498,10637,498,6.56665e+18,91.2496,5680.91,11135,2246,110,29388,29388,29388,29388,29388
23764,119,5644,22383,1381,22383,1381,3.34206e+18,97.5651,7714.14,23764,2717,110,17534,7889,5959,10603,1397
34584,4543,11468,32824,1760,32824,1760,2.99222e+18,95.2041,13969.7,34584,5547,110,33116,33116,33116,33116,33116
32779,7688,7883,30870,1909,30870,1909,3.34402e+18,98.2298,10477.4,32779,3727,111,18584,18584,7697,11483,7357
13370,7027,7107,12890,480,0,13370,1.37873e+18,88.0832,8048.38,13370,3430,107,6263,6263,6233,6231,6250
6419,960,3039,6419,0,6119,300,6.00153e+18,91.1633,3513.31,6419,1235,95,3380,3287,2100,2897,746
39835,151,176,39753,82,39835,0,5.98137e+18,172.362,2366.61,39835,170,172,30317,29873,10018,16512,1066
8714,31,176,8708,6,8714,0,6.0367e+18,163.392,1141.08,8714,119,122,4461,1264,1421,1526,1474
29982,2667,7013,10540,19442,0,29982,9.91347e+12,60.0121,9205.57,29982,3416,72,22969,22969,15774,21181,8961
49718,2384,18207,47300,2418,47300,2418,1.86106e+18,96.4436,21321.1,49718,8732,111,47621,47621,47621,47621,47621
26076,2,13,25310,766,26059,17,1.69181e+14,10.2758,485.401,26076,12,12,33555,0,0,14247,11990
20435,51,175,20369,66,20435,0,5.9766e+18,166.488,1692.44,20435,150,160,13103,6419,5164,6031,5924
7977,1247,3179,7607,370,0,7977,1.77806e+18,93.9649,3953.52,7977,1522,103,4798,4725,3915,3719,3375
39466,8966,12478,14449,25017,0,39466,8.82242e+12,58.234,14981.6,39466,6062,72,26773,26773,23448,24087,22814
28383,3761,7576,0,28383,0,28383,6.19649e+17,97.1488,9882.26,28383,3662,110,30014,29927,23892,17428,12706
13083,414,3612,4689,8394,0,13083,9.3474e+12,56.7117,4710.83,13083,1737,72,9471,9471,5833,8841,1519
27393,70,176,27313,80,27393,0,6.08902e+18,172.205,2048.54,27393,159,157,21567,14673,10305,11074,10685
10439,235,2536,9829,610,9829,610,5.37213e+18,97.3361,3636.69,10439,1183,111,7903,7903,3525,5056,1331
24649,3436,5917,23209,1440,23209,1440,1.85916e+18,98.0875,8001.48,24649,2791,111,19522,19522,17306,16855,14844
43900,856,13856,41620,2280,41620,2280,3.15129e+18,96.0093,16928,43900,6716,110,43364,43364,43364,0,0
39714,11829,15354,0,39714,15034,24680,2.02548e+15,57.6097,17654.9,39714,7476,72,24360,24360,22192,22605,19726
22616,4799,10255,21666,950,21666,950,3.57631e+18,94.8006,11783.3,22616,4932,111,35277,35277,27435,26894,17026
9199,2592,4363,0,9199,3619,5580,1.7489e+15,54.1484,5027.77,9199,2103,72,4836,4836,3622,2335,2344
26268,2675,11902,26268,0,20136,6132,4.51032e+18,168.651,13113,26268,5030,129,14366,14042,9214,11392,5905
28143,5638,6644,26509,1634,26509,1634,5.7731e+18,97.6572,9007.64,28143,3212,110,23296,23296,17812,15847,10651
47366,5706,13751,44794,2572,44794,2572,3.85892e+18,97.5696,17031.1,47366,6545,111,47194,47194,47194,47194,47194
17590,2396,4972,0,17590,6331,11259,2.37303e+15,59.1085,6340.27,17590,2417,72,12618,12618,9551,5730,5954
39961,1,15,38798,1163,39897,64,1.62605e+14,10.4617,667.709,39961,13,11,25720,25720,25720,25720,25720
2002,38,163,0,2002,1944,58,4.37673e+16,17.7188,411.575,2002,36,26,1839,1835,167,4699,148
14735,7,61,14703,32,14735,0,2.3326e+18,60.5426,903.937,14735,61,61,3390,225,106,279,1449
1489,603,885,0,1489,0,1489,3.7398e+17,83.8428,1057.2,1489,403,47,604,518,483,424,460
11505,127,2792,0,11505,0,11505,6.45011e+17,96.8425,3986.66,11505,1331,110,8713,4416,5159,998,948
40307,7981,12931,40307,0,37957,2350,3.963e+18,287.74,14676.8,40307,3931,133,31586,0,0,10513,10513
14574,2695,3453,5126,9448,0,14574,9.84805e+12,59.7483,4692.37,14574,1676,72,21241,21241,13383,19877,3869
10068,1334,2674,9501,567,9501,567,3.29192e+18,96.3242,3732.73,10068,1275,110,7394,7394,4798,5956,3885
4133,411,1087,3893,240,3893,240,3.32025e+18,94.8693,1645.01,4133,508,82,3046,3046,1724,2329,1341
11629,3,12,11293,336,11617,12,1.59653e+14,10.502,316.889,11629,12,11,8981,6609,6386,6962,4138
31621,1,8,31105,516,31557,64,9.78633e+13,3.99832,454.72,31621,6,4,368,368,368,368,368
16098,10,12,15634,464,16090,8,1.4983e+14,10.2192,366.323,16098,12,11,16042,15968,15703,15704,15013
22124,3481,5227,7789,14335,0,22124,9.85237e+12,59.8873,6947.26,22124,2536,72,16897,16897,14872,16474,11605
20205,250,6168,0,20205,7349,12856,2.30257e+15,58.8027,7652.71,20205,3004,72,14037,13941,7989,4564,755
46215,16970,18837,42684,3531,44363,1852,4.49412e+18,3258.79,22690.3,46215,5541,142,45880,45880,45880,45880,45880
1220,132,446,1157,63,1157,63,3.2745e+18,84.5861,652.402,1220,184,46,774,443,294,476,348
47445,11123,15294,44985,2460,44985,2460,5.15499e+18,95.7866,18465.1,47445,7310,111,38644,38644,38644,38644,38644
48307,12240,23825,0,48307,0,48307,4.2898e+17,93.774,26439.3,48307,11583,110,33667,33667,31688,32692,29310
16676,645,698,0,16676,16197,479,3.55621e+16,25.0402,1928.67,16676,88,26,15978,15973,15881,15886,15214
32994,10065,17817,0,32994,13393,19601,1.52103e+15,54.4767,19398,32994,8674,72,15177,15177,11872,10027,8061
22788,1331,8869,22788,0,21588,1200,3.57917e+18,181.151,10014.1,22788,3529,124,18874,18874,12687,11555,5402
7915,1486,3446,7572,343,0,7915,1.67075e+18,93.2374,4181,7915,1653,96,4469,4469,3143,2792,2049
45456,1592,15904,45456,0,42936,2520,4.13017e+18,306.449,17774.8,45456,5749,134,36370,36370,20928,19804,14058
28696,1532,6773,0,28696,0,28696,6.47144e+17,97.6817,9171.24,28696,3277,110,20841,20702,14090,17006,9767
33321,10578,12039,12460,20861,0,33321,8.22389e+12,57.956,14104.6,33321,5852,72,29535,29535,29026,29447,28660
31616,9191,9921,0,31616,0,31616,5.8092e+17,96.4941,12303.6,31616,4807,110,30410,30410,30410,30410,30410
12372,4086,4531,11772,600,11772,600,2.89281e+18,92.6978,5640.28,12372,2165,110,7841,7841,7632,7805,7718
38420,726,1099,0,38420,37326,1094,3.55337e+16,229.902,3720.16,38420,168,26,35146,35146,11296,18588,4534
4868,156,3151,4728,140,0,4868,1.08785e+18,78.2434,3520.89,4868,1510,67,1717,1631,994,819,0
12876,121,539,0,12876,12509,367,3.53796e+16,20.1164,1506.6,12876,73,26,12337,12337,10672,10782,4271
27829,9001,12733,26669,1160,26669,1160,4.4154e+18,94.8194,14505.4,27829,6125,111,15096,15096,12759,14937,9090
24696,2478,5815,8678,16018,0,24696,9.8578e+12,59.9359,7692.7,24696,2828,72,15632,15274,8089,10528,3214
18800,950,5007,17740,1060,17740,1060,5.4569e+18,97.5121,6661.12,18800,2362,111,18439,18439,18439,18439,18439
9640,86,418,0,9640,9366,274,3.56625e+16,19.9758,1175.3,9640,62,26,9222,9222,6640,6629,2957
46773,10,13,42932,3841,46772,1,1.15339e+14,7.92983,562.011,46773,13,8,6996,1414,1150,1620,224
4019,17,176,4019,0,4019,0,6.08533e+18,151.177,783.164,4019,89,90,1467,298,384,355,391
49024,9091,23766,47104,1920,47104,1920,2.61916e+18,91.6,26448.7,49024,11537,110,46390,46390,46390,46390,46390
8904,1492,2132,8384,520,0,8904,2.23791e+18,96.6126,3124.63,8904,1014,109,6772,6772,6051,5816,5176
35920,7732,8475,12648,23272,0,35920,9.85108e+12,59.8107,11014.5,35920,4116,72,34448,34448,34448,34448,34448
5254,626,1294,4944,310,4944,310,3.35126e+18,95.5084,1966.76,5254,603,88,3960,3960,2659,3257,2313
26076,2751,11920,0,26076,0,26076,4.61025e+17,94.124,13635.5,26076,5783,110,36646,36646,36646,36646,36646
21795,2556,5184,0,21795,0,21795,6.48593e+17,97.537,7120.09,21795,2507,110,16611,16611,13077,9215,8954
48557,15928,17822,46204,2353,46204,2353,3.06243e+18,96.4051,20878.7,48557,8536,111,35787,35787,35787,35787,35787
14886,1930,4138,0,14886,5341,9545,2.3951e+15,59.1534,5345.13,14886,2016,72,20545,0,12657,23637,23637
44708,25,61,44612,96,44708,0,2.25578e+18,60.8483,1575.15,44708,61,61,22167,7596,8761,9291,8768
35851,114,176,35763,88,35851,0,6.07354e+18,169.182,2340.61,35851,166,163,29613,19982,22394,15923,13280
19405,6171,6334,19405,0,18305,1100,5.56443e+18,145.663,7524.58,19405,1920,125,41400,41400,41400,41400,41400
45622,120,176,45543,79,45622,0,6.03794e+18,173.426,2615.19,45622,173,171,42920,39140,31183,31695,31590
5977,1314,1524,0,5977,0,5977,6.39413e+17,95.5332,2256.66,5977,718,91,4453,4453,4236,4224,4108
40947,8997,9800,38564,2383,38564,2383,1.72877e+18,98.3137,12891,40947,4636,111,35733,35733,35733,35733,35733
1253,303,380,1173,80,0,1253,2.29476e+18,87.4549,602.947,1253,165,50,873,873,802,802,821
42217,921,1323,0,42217,41008,1209,3.75505e+16,267.168,4471.06,42217,212,26,28932,0,0,0,1363
21246,2146,4951,0,21246,7468,13778,2.53769e+15,59.9783,6622.8,21246,2411,72,27391,27391,15473,22051,8573
27524,3655,7974,0,27524,9944,17580,2.34334e+15,59.0628,9904.79,27524,3872,72,19550,19550,15094,10434,9323
18661,2503,4438,6569,12092,0,18661,9.83005e+12,59.6642,5942.11,18661,2139,72,14223,14223,11967,13753,8298
2995,296,783,0,2995,0,2995,6.50392e+17,93.1699,1225.93,2995,358,68,2212,2212,1570,1203,1075
25148,6681,7954,0,25148,9205,15943,2.26494e+15,58.6653,9695.33,25148,3874,72,29437,29437,29437,29437,29437
9593,163,176,9587,6,9593,0,6.06122e+18,164.485,1203.76,9593,120,123,9374,9246,8849,8822,8815
34725,6256,10813,12688,22037,0,34725,8.87762e+12,58.7896,13082.4,34725,5262,72,38204,38204,38204,38204,38204
36401,368,1701,0,36401,35324,1077,4.54406e+16,305.401,5420.93,36401,287,26,34635,33490,25654,26608,12490
32152,5720,7515,0,32152,11300,20852,2.5289e+15,60.0093,9839.58,32152,3656,72,31984,31984,31984,31984,31984
30489,2088,7086,0,30489,10706,19783,2.53258e+15,59.9993,9315.31,30489,3439,72,18372,17948,10119,11949,1605
8209,2697,7041,8110,99,8110,99,3.40684e+18,18.0777,7319.66,8209,3392,63,1168,1168,629,1140,0
26696,9688,10049,26696,0,21466,5230,3.87244e+18,211.205,11338.7,26696,3962,124,26448,26448,26448,26448,26448
30223,7917,16389,29162,1061,29162,1061,9.20784e+18,91.4789,18051.2,30223,7901,111,24471,24471,24471,24471,24471
31297,1294,1955,0,31297,30350,947,5.32794e+16,306.415,6002.58,31297,336,26,31038,31038,31038,31038,31038
38539,11900,19424,37070,1469,37070,1469,4.77947e+18,93.093,21543,38539,9353,111,30207,30207,30207,30207,30207
3651,695,946,1294,2357,0,3651,9.76892e+12,58.4465,1379.31,3651,454,65,2705,2705,2402,2636,2085
13241,2457,7349,0,13241,5402,7839,1.47773e+15,53.4587,8118.34,13241,3565,72,11039,11039,11039,11039,11039
29993,2255,6965,10533,19460,0,29993,9.90997e+12,60.0142,9164.38,29993,3384,72,35783,35783,16502,24447,9267
45118,2278,2700,13733,31385,13733,31385,2.00926e+18,15.9955,3495.92,45118,1766,26,43756,43756,43756,43756,43756
4299,2,13,4178,121,4239,60,1.54258e+14,10.8953,205.36,4299,13,12,2525,1868,1522,1625,1210
17039,2601,5029,16119,920,16119,920,3.25049e+18,94.5239,6546.5,17039,2411,110,12010,12010,8840,10210,7593
4978,832,1728,4978,0,4688,290,4.75774e+18,90.6133,2191.32,4978,601,95,3250,3250,2273,2652,1941
3533,1007,1641,0,3533,0,3533,4.72595e+17,87.3946,2039.75,3533,775,64,1892,1892,1502,1510,1164
32398,844,9979,30688,1710,30688,1710,3.17513e+18,96.5921,12416.9,32398,4834,110,34479,34479,21575,0,0
20125,5394,7519,0,20125,0,20125,5.33731e+17,95.3002,9089.89,20125,3640,110,24527,24527,23007,21952,11597
9039,919,2270,8512,527,8512,527,4.05364e+18,97.0535,3249.25,9039,1052,111,6769,6769,4225,4896,3144
20389,2335,7469,19401,988,0,20389,1.85142e+18,94.3822,9071.96,20389,3614,110,12914,12914,8818,11905,3194
36679,1,15,35604,1075,36618,61,1.68775e+14,10.5126,647.88,36679,13,11,220,220,220,220,220
48744,8434,17221,46354,2390,46354,2390,7.50342e+18,95.8995,20410.5,48744,8354,110,48481,48481,48481,48481,48481
14766,8467,9512,0,14766,6260,8506,1.17797e+15,53.2989,10217.6,14766,4619,72,5254,5254,4782,4252,4434
12834,1334,3543,12123,711,0,12834,2.12125e+18,96.4625,4796.16,12834,1703,110,11533,11533,4745,10235,3130
42790,1085,9975,40293,2497,40293,2497,3.22049e+18,97.8977,13263.3,42790,4833,110,27328,26622,17218,20843,8874
21092,149,175,21080,12,21092,0,5.97997e+18,166.455,1718.75,21092,158,156,20582,19666,18060,18009,17854
37032,10813,11283,37032,0,34874,2158,3.96447e+18,263.894,13189.3,37032,3555,133,19997,19997,11101,13235,10725
36479,12236,15605,24122,12357,34879,1600,4.01079e+18,93.677,17875,36479,7482,111,27120,25045,21958,20374,19298
24594,49,176,24579,15,24594,0,6.05917e+18,170.064,1932.03,24594,159,158,16193,7516,6157,7109,6770
6121,341,1981,5801,320,5801,320,4.48687e+18,95.1198,2672.13,6121,915,89,4140,4053,1884,4140,1442
46647,202,206,46567,80,46647,0,5.97973e+18,193.845,2646.09,46647,184,179,10132,10132,7515,10106,7182
42405,12264,14893,40315,2090,0,42405,1.88835e+18,94.9573,17760.7,42405,7223,110,42166,42166,42166,42166,42166
42953,17,208,42852,101,42953,0,6.14335e+18,203.328,2770.05,42953,182,176,26931,10296,12314,26173,26607
16540,646,4113,5846,10694,0,16540,9.69574e+12,59.6028,5464.4,16540,1994,72,17302,17302,17302,17302,17302
33095,3835,7756,0,33095,0,33095,6.49123e+17,97.8042,10441.5,33095,3756,110,28855,28855,18701,25888,9517
27693,3,12,26903,790,27681,12,1.38608e+14,10.3889,471.503,27693,12,11,21037,14932,17434,18359,9836
49215,13189,18591,18568,30647,0,49215,8.02391e+12,57.7958,21367.4,49215,9057,72,37900,37900,37900,37900,37900
41948,4929,11258,39615,2333,0,41948,2.12848e+18,97.3151,14378.1,41948,5465,110,25688,25688,23725,23378,16601
13085,151,176,13078,7,13085,0,6.01162e+18,166.225,1393.32,13085,132,139,12734,12389,11308,11245,11080
28177,1922,10045,26797,1380,26797,1380,3.06437e+18,95.3992,12121.6,28177,4852,110,32063,32063,21277,19548,7915
47772,2156,2877,14560,33212,14560,33212,1.99571e+18,15.9973,3696.17,47772,1706,26,35357,35357,20247,14388,10112
45949,8405,18760,45949,0,43879,2070,4.97177e+18,1860.77,21605.9,45949,7532,144,32708,32708,30428,30048,21352
41444,204,1542,0,41444,40239,1205,4.0798e+16,284.154,5092.61,41444,257,26,39731,39337,35999,32756,22971
3743,488,1278,3543,200,0,3743,2.00715e+18,93.2161,1754.04,3743,603,73,2465,2381,1947,1838,1692
25559,4290,8332,9399,16160,0,25559,8.70532e+12,58.4856,10075.8,25559,4049,72,22049,22049,22049,22049,22049
10286,2409,4551,10286,0,9796,490,3.65884e+18,122.892,5264.73,10286,1930,114,20845,20845,12107,17844,5710
35487,4479,8740,0,35487,0,35487,6.36753e+17,97.5871,11543.5,35487,4225,110,28806,28806,22702,19608,16188
40212,15962,16525,38412,1800,38412,1800,2.72275e+18,95.0271,19074.2,40212,8020,110,40040,40040,40040,40040,40040
46731,183,16572,44441,2290,44441,2290,7.68843e+18,95.8796,19654.1,46731,8033,110,46266,46266,46226,46071,45917
38643,4813,8997,13579,25064,0,38643,9.893e+12,60.0596,11696.8,38643,4382,72,29646,29646,23557,28589,16196
30082,109,176,30039,43,30082,0,6.03415e+18,160.369,2128.54,30082,159,164,32132,31736,20999,21762,6284
24420,339,1055,0,24420,23713,707,4.05051e+16,210.912,3207.1,24420,160,26,21876,21876,7344,1991,2219
18587,599,732,0,18587,18055,532,3.55423e+16,59.1913,2087.38,18587,95,26,28005,27961,27207,27310,25386
4060,19,342,0,4060,3939,121,4.55773e+16,18.5953,828.69,4060,53,26,2168,956,714,1004,146
1686,165,175,1686,0,1686,0,6.08635e+18,124.515,491.082,1686,66,64,34560,34484,9379,27513,998
44383,1285,1452,0,44383,43106,1277,3.86013e+16,284.402,4907.12,44383,239,26,44173,44173,44173,44173,44173
9592,28,175,9586,6,9592,0,5.9681e+18,162.2,1162.44,9592,125,128,4575,1131,1329,1555,1664
43852,2,12,42602,1250,43837,15,1.38748e+14,10.2235,593.003,43852,11,12,22961,21851,21964,21856,21725
12054,303,657,0,12054,11708,346,3.86172e+16,19.9317,1704.96,12054,84,26,11397,11397,9249,9411,4813
36423,502,1232,0,36423,35809,614,2.52952e+16,3.73525,4728.78,36423,618,4,43831,43831,43831,43831,43831
42931,15,16,41668,1263,42861,70,1.73339e+14,10.4247,709.442,42931,13,12,42915,42915,42862,42863,42527
24394,1284,5683,0,24394,8567,15827,2.53109e+15,59.9864,7550.03,24394,2761,72,19200,19195,2920,14203,1375
34850,6847,8159,32820,2030,32820,2030,3.35182e+18,97.8,10957,34850,3951,110,34804,34804,34804,34804,34804
36172,3398,8439,0,36172,12713,23459,2.52836e+15,60.0156,10998.8,36172,4098,72,23964,23964,9889,15792,8460
1341,316,408,1263,78,0,1341,2.21458e+18,87.2975,644.182,1341,175,50,933,933,837,849,862
6564,160,1641,0,6564,0,6564,6.44389e+17,96.0916,2431.28,6564,779,95,4923,4841,1708,862,939
12580,34,176,12571,9,12580,0,6.08359e+18,167.718,1387.83,12580,128,130,7003,2222,2392,2556,2304
25526,4645,6036,24036,1490,0,25526,2.22843e+18,97.595,8223.14,25526,2921,110,23149,22973,13864,19622,7502
10478,997,4756,10035,443,10035,443,3.67244e+18,89.3161,5627,10478,2257,109,5722,5635,2243,3171,1283
2951,631,1742,2852,99,2852,99,2.30157e+18,87.7869,2027.12,2951,821,60,1209,1037,737,898,665
28568,7021,11655,27268,1300,27268,1300,3.7215e+18,95.5798,13584.8,28568,5592,111,36012,36012,31446,34998,22977
27232,4676,6435,25650,1582,0,27232,2.22412e+18,97.6428,8739.05,27232,3111,110,20797,20797,18471,18068,15900
25390,688,12101,24363,1027,24363,1027,2.691e+18,94.5017,13708.8,25390,5826,111,13289,12516,6354,7961,3065
45476,3543,12283,0,45476,0,45476,6.16819e+17,97.136,15608.1,45476,5943,110,34970,34970,23199,21296,14168
17225,2318,4044,0,17225,6058,11167,2.53061e+15,59.8434,5459.51,17225,1961,72,29776,29776,15972,25510,5437
2167,63,106,0,2167,2103,64,3.55799e+16,19.6285,320.116,2167,32,26,2061,2061,1951,1960,1546
9077,166,699,0,9077,8811,266,4.43602e+16,23.413,1686.66,9077,89,26,8378,8366,6562,6884,3629
41305,11395,15665,39351,1954,0,41305,1.80788e+18,95.5425,18373.1,41305,7612,110,25640,25640,24665,24453,23948
11328,3045,6290,0,11328,0,11328,3.4859e+15,17.8225,6567.01,11328,5646,20,10707,10707,10707,10707,10057
3940,2158,2454,3940,0,3810,130,7.66408e+18,76.2317,2752.46,3940,617,70,0,0,13968,16320,7571
26874,4590,6306,0,26874,9454,17420,2.52939e+15,59.9597,8316.05,26874,3066,72,34683,34683,34683,34683,34683
24266,111,1195,0,24266,23554,712,4.38861e+16,234.506,3609.66,24266,186,26,22644,22426,18337,15194,4447
15974,771,3762,5614,10360,0,15974,9.88837e+12,59.8252,5094.96,15974,1826,72,11526,11425,7494,6726,2875
26113,1216,6813,0,26113,9299,16814,2.43667e+15,59.5079,8723.34,26113,3306,72,17735,17648,11880,14341,11043
49617,3444,14517,0,49617,17964,31653,2.33108e+15,59.1224,17624.4,49617,7055,72,49420,49420,49420,49420,49420
10141,5303,5463,10141,0,0,10141,8.88744e+17,17.9406,5731.35,10141,4907,20,4678,4678,4537,4646,4583
37080,10696,18547,35658,1422,35658,1422,6.99562e+18,94.2304,20616.2,37080,8937,111,45713,45713,45713,45713,45713
38267,5433,17213,38267,0,36497,1770,4.86697e+18,271.196,18842.2,38267,7293,139,21054,20731,17236,18661,12666
35038,10489,11285,35038,0,32998,2040,4.9538e+18,243.049,12861.3,35038,2797,133,34700,34700,34700,34700,34700
41407,8862,18409,39657,1750,39657,1750,8.84336e+18,94.5383,20900.8,41407,8946,110,31186,31186,30693,31086,29884
548,164,526,263,285,0,548,2.06286e+12,1.07664,534.16,548,252,28,22,22,21,0,0
22377,7,14,21719,658,22327,50,1.74593e+14,10.5341,493.755,22377,13,11,2888,1135,905,1001,162
46537,1348,1911,0,46537,45174,1363,4.35145e+16,307.726,6301.83,46537,329,26,45597,45597,45590,45590,45590
1529,124,464,1441,88,1441,88,1.89562e+18,88.69,723.667,1529,193,53,1065,518,0,0,0
25137,1616,6709,23735,1402,23735,1402,3.22524e+18,97.1138,8808.33,25137,3234,110,16963,16963,14975,14540,12835
23500,625,1305,0,23500,22803,697,4.70582e+16,262.313,3897.08,23500,206,26,20860,19932,9197,13548,2075
47048,2426,12289,44388,2660,44388,2660,3.19086e+18,98.0438,15661,47048,5842,111,32808,32808,18912,15709,9897
43460,3,14,42201,1259,43433,27,1.56541e+14,10.3825,627.215,43460,13,12,29947,29085,29040,28921,28788
47234,12076,14213,47234,0,44484,2750,4.72085e+18,328.908,16512.4,47234,3748,134,45087,45087,45087,45087,45087
29473,7330,11060,28073,1400,0,29473,1.82132e+18,94.4915,13160.4,29473,5353,110,18413,18413,15742,15288,12916
2956,699,841,0,2956,0,2956,6.27639e+17,92.8163,1269.8,2956,381,69,46746,46746,46194,46579,46148
39637,6835,12711,39637,0,37327,2310,4.11266e+18,280.683,14435.6,39637,4712,128,27394,27394,22915,21090,15951
9120,312,650,0,9120,8853,267,4.28316e+16,19.6826,1594.53,9120,83,26,8470,8470,7854,7659,4141
26425,8240,26425,26425,0,26425,0,8.79576e+12,0,26425,26425,26425,1,0,0,0,0,0
49450,10650,16631,46940,2510,46940,2510,2.00181e+18,96.2534,19853,49450,7947,111,47533,47533,47533,47533,47533
41510,2889,13092,0,41510,15189,26321,2.25562e+15,58.7191,15701.9,41510,6365,72,40035,40035,40035,40035,40035
9504,2,11,9225,279,9498,6,1.70265e+14,10.5822,284.838,9504,11,11,5684,4387,2982,3148,3355
13958,2349,4187,5056,8902,0,13958,9.04545e+12,58.7422,5310.49,13958,2031,72,9771,9771,7467,9371,4804
38480,741,1384,0,38480,37368,1112,3.96336e+16,273.868,4548.61,38480,225,26,36653,36653,35061,35838,33497
36702,9379,21699,35552,1150,35552,1150,3.3018e+18,91.4429,23465.8,36702,10489,111,29437,29437,29437,29437,29437
4926,163,1264,4643,283,4643,283,1.46035e+18,95.4669,1895.35,4926,570,86,3662,3662,1214,1549,845
25117,1338,11995,24117,1000,24117,1000,2.60981e+18,93.7805,13619.9,25117,5820,110,13122,16000,7086,10705,4344
44626,2595,15112,44626,0,42105,2521,4.53768e+18,305.752,16972.4,44626,3354,136,42712,42712,42712,42712,42712
11459,7,13,11129,330,11393,66,1.39399e+14,10.9473,327.092,11459,13,12,11044,10827,9620,9502,7307
29165,6006,6818,10261,18904,0,29165,9.90013e+12,60.027,8967.08,29165,3320,72,28817,28817,28817,28817,28817
16805,14610,15706,15702,1103,0,16805,1.01085e+18,3.98923,15768.4,16805,5257,9,16407,16407,16407,9461,14525
8792,151,176,8790,2,8792,0,6.06012e+18,164.238,1150.41,8792,114,123,8514,8304,7523,7492,7429
26294,3051,6160,24764,1530,24764,1530,3.35487e+18,97.659,8409.28,26294,2979,110,26592,26592,22957,22320,8004
9541,2400,3513,0,9541,0,9541,5.40565e+17,94.6018,4425.95,9541,1688,105,6028,6028,5168,5424,4060
4361,2122,2362,4201,160,0,4361,1.39454e+18,89.371,2775.76,4361,1126,65,1999,1999,1739,1699,1721
42392,28,176,42281,111,42392,0,6.09284e+18,173.184,2548.76,42392,172,169,15103,1694,0,10230,594
1252,284,659,494,758,0,1252,6.78168e+12,35.8562,803.441,1252,304,48,593,593,593,593,593
5935,1091,1465,5592,343,5592,343,5.86238e+18,95.5415,2200.04,5935,681,91,4470,4470,4381,4384,3706
13039,2820,3944,12342,697,0,13039,2.04388e+18,96.0768,5177.71,13039,1901,110,9095,9095,8255,7871,7210
36728,2773,8567,12908,23820,0,36728,9.88097e+12,60.0376,11157.4,36728,4169,72,28201,28201,19920,11475,9382
42766,1110,1946,0,42766,41506,1260,4.55874e+16,315.295,6302.52,42766,337,26,32404,32404,24828,18793,16138
21564,5083,5193,20305,1259,20305,1259,5.29698e+18,98.0605,7076.81,21564,2453,111,29633,29633,29633,29633,29633
44931,14,15,43628,1303,44871,60,1.59372e+14,10.3936,710.318,44931,13,11,7069,1597,1417,3212,88
32872,5117,10815,32872,0,30979,1893,5.1325e+18,223.243,12316.4,32872,2841,133,24700,24700,20285,19408,15210
42623,102,176,42579,44,42623,0,5.98212e+18,172.135,2447.12,42623,171,172,32949,15912,12023,10224,6053
26722,5610,6281,9397,17325,0,26722,9.85209e+12,59.9511,8283.61,26722,3046,72,20016,20016,18974,17475,17537
39872,10869,17692,39872,0,38322,1550,5.07497e+18,2346.5,20723.1,39872,7922,148,38416,38416,38416,38416,38416
36325,18645,36325,0,36325,0,36325,524274,0,36325,36325,36325,1,29845,29845,29845,29845,29845
33694,7085,9970,31874,1820,31874,1820,3.4533e+18,97.4102,12470.4,33694,4747,111,33626,33626,29109,25971,24061
15896,2942,7604,6272,9624,0,15896,6.73182e+12,55.9517,8596.75,15896,3690,72,8292,8292,5833,7872,3055
24811,1314,1541,0,24811,24068,743,5.1327e+16,289.08,4622.69,24811,255,26,23270,23270,23027,22998,21654
32773,3148,7671,0,32773,11519,21254,2.52526e+15,59.9825,10031.2,32773,3724,72,28974,28974,28447,28142,27905
3499,272,1616,1357,2142,0,3499,7.11956e+12,55.1149,1948.23,3499,780,58,6780,18734,5511,5630,37
16182,515,916,0,16182,15708,474,4.35142e+16,175.538,2555.51,16182,129,26,15266,14996,13555,13738,10895
41236,152,208,41157,79,41236,0,5.98602e+18,197.153,2541.06,41236,180,183,41084,41084,41084,41084,41084
3789,501,2789,0,3789,0,3789,2.35103e+17,71.9509,3039.85,3789,1318,61,1000,828,542,298,597
9690,1662,4241,9690,0,9210,480,6.5343e+18,97.362,4874.83,9690,1569,115,27661,27644,25860,26893,23229
48082,11220,12078,0,48082,17060,31022,2.47176e+15,59.7802,15247.7,48082,5879,72,39736,39736,39736,39736,39736
36578,1060,1238,0,36578,35525,1053,3.82115e+16,256.229,4078.44,36578,196,26,32046,32046,15247,21036,5388
21409,106,200,21400,9,21409,0,5.97805e+18,181.265,1786.34,21409,162,155,46892,46679,46668,46586,45794
13510,632,5463,12890,620,12890,620,5.0292e+18,94.6583,6579.03,13510,2610,111,8047,7718,5153,5498,2313
47912,8,176,47838,74,47912,0,6.04197e+18,173.684,2688.43,47912,175,173,41000,37357,30903,26425,18254
31939,10467,16902,31939,0,0,31939,8.86946e+17,17.9731,17397.9,31939,15199,20,24809,24746,22237,24380,18240
22747,5115,5701,8068,14679,0,22747,9.6696e+12,59.6813,7432.42,22747,2771,72,17046,17046,16442,16918,15606
39359,2427,13773,37412,1947,37412,1947,3.07325e+18,96.0002,16479.5,39359,6687,110,38466,38466,38466,38466,38466
19258,415,1031,0,19258,18693,565,4.38789e+16,208.535,2985.03,19258,152,26,741,741,728,736,81
44297,7451,14267,44297,0,41797,2500,3.7914e+18,324.937,16428.5,44297,4863,136,47687,47687,47687,47687,47687
46879,10207,10932,0,46879,16483,30396,2.52902e+15,60.0738,14098.3,46879,5320,72,35947,35947,35062,33887,33772
18531,542,5258,17521,1010,0,18531,2.09091e+18,96.6781,6896.03,18531,2531,110,13273,13187,5573,4728,2618
45538,13502,18643,43476,2062,43476,2062,7.86337e+18,95.7451,21395.9,45538,8953,111,32457,32457,32453,32398,32111
30556,804,957,0,30556,29687,869,3.5569e+16,190.922,3089.77,30556,140,26,22353,22081,9795,15199,2571
45735,2466,17210,45735,0,43315,2420,4.665e+18,374.385,19092.1,45735,3756,138,18877,18877,11966,12406,7120
29618,137,1114,0,29618,28763,855,3.89215e+16,242.8,3525.1,29618,172,26,19440,16438,9337,15247,676
12513,4378,5339,11963,550,0,12513,1.68321e+18,86.4516,6378.73,12513,2559,110,7174,7174,6818,6784,6627
28880,10199,12345,28880,0,27523,1357,5.13809e+18,345.158,13902.3,28880,5026,132,19668,19503,16552,18251,12029
9544,867,2263,8984,560,0,9544,2.24206e+18,96.8644,3312.07,9544,1081,110,7281,7281,5057,4623,3316
783,19,53,0,783,759,24,3.55227e+16,17.0421,146.079,783,21,24,721,685,522,513,363
1564,54,641,598,966,0,1564,8.05468e+12,45.2628,840.702,1564,306,47,836,339,248,18,0
22154,2,14,21509,645,22106,48,1.65551e+14,10.561,486.227,22154,12,11,939,274,263,459,181
47655,658,1504,0,47655,46285,1370,3.83022e+16,288.92,5144.41,47655,250,26,35051,34625,26178,18437,15622
28349,4435,6623,26694,1655,26694,1655,5.74387e+18,97.7103,9003.21,28349,3198,110,34378,34378,34378,34378,34378
40731,451,1767,0,40731,39531,1200,4.41711e+16,297.698,5729.92,40731,302,26,29483,29095,16424,20926,4808
13136,126,176,13130,6,13136,0,6.01558e+18,164.708,1393.54,13136,135,139,12396,11391,9486,9509,9482
42251,2478,42251,42251,0,0,42251,7.99981,0,42251,42251,42251,1,28331,28331,24181,22130,6649
11944,1254,2992,11254,690,11254,690,2.16428e+18,96.9544,4198.8,11944,1402,111,8952,8952,6943,7824,4319
22950,676,5408,21618,1332,21618,1332,3.23889e+18,97.5201,7429.17,22950,2603,110,17542,17542,8625,12767,3237
21681,17,994,0,21681,21050,631,4.08862e+16,204.052,2950.66,21681,146,26,19857,18370,14021,13025,2793
20221,1271,4902,19048,1173,19048,1173,2.79724e+18,97.8846,6694.06,20221,2304,111,22742,22742,20128,19840,18913
11872,1184,3374,11222,650,0,11872,2.09719e+18,90.9223,4550.88,11872,1615,110,13346,13346,13346,13346,13346
3044,149,170,3044,0,3044,0,5.96194e+18,144.832,650.118,3044,86,82,2846,2741,2587,2593,2585
17804,4129,6397,16934,870,16934,870,7.69517e+18,93.6575,7860.11,17804,3075,110,23776,23776,19247,21085,13890
44927,897,1800,0,44927,43617,1310,4.28188e+16,309.174,5941.79,44927,307,26,31963,31717,18942,16716,2761
47634,69,176,47539,95,47634,0,6.08331e+18,173.921,2695.71,47634,175,173,36732,29856,30703,29551,26623
19783,4360,6892,18801,982,0,19783,1.90484e+18,92.181,8493.75,19783,3318,110,29562,29562,24516,25543,15493
16372,3805,6663,16372,0,15552,820,4.98646e+18,137.719,7659.04,16372,2790,121,9709,9709,7846,8744,5733
14651,37,175,14644,7,14651,0,5.9687e+18,164.934,1434.28,14651,143,143,8089,2522,2704,3260,3203
23344,5663,7237,23344,0,21984,1360,4.72462e+18,162.951,8604.06,23344,2777,124,44148,44148,44148,44148,44148
7236,675,2406,2660,4576,0,7236,8.68489e+12,54.8014,3063.77,7236,1163,72,4830,4808,3483,4492,2052
37216,83,176,37190,26,37216,0,6.00578e+18,173.516,2343.47,37216,166,172,30660,10113,21635,18063,280
3813,98,170,3811,2,3813,0,5.97309e+18,148.592,726.422,3813,93,92,3316,2091,2037,2142,2171
43419,9,13,42173,1246,43396,23,1.46822e+14,10.2816,606.739,43419,12,12,36510,32333,20746,26141,8136
4219,354,1060,3971,248,0,4219,2.23995e+18,94.9211,1632.39,4219,492,82,3159,3159,1945,1824,1373
21883,899,1060,0,21883,21244,639,4.24285e+16,219.178,3148.16,21883,161,26,20823,20823,20623,20601,19549
34165,7941,8861,28049,6116,32225,1940,5.38402e+18,97.5638,11491,34165,4179,111,32998,32998,32998,32998,32998
4203,434,1035,0,4203,1474,2729,2.48337e+15,58.5368,1520.8,4203,487,68,3168,3168,2289,1591,1442
2771,292,728,2604,167,2604,167,5.78039e+18,92.9881,1143.31,2771,336,66,2043,2043,1936,31805,31034
39227,12,14,38099,1128,39140,87,1.48828e+14,10.4364,619.712,39227,13,12,13838,9131,9400,9368,7296
45582,8924,10635,0,45582,16028,29554,2.53416e+15,60.0793,13725.3,45582,5181,72,37013,37013,37013,37013,37013
25647,3627,7957,0,25647,0,25647,5.85905e+17,96.4463,9989.12,25647,3857,110,26590,26590,26590,26590,26590
18211,4432,4630,17173,1038,17173,1038,6.15306e+18,97.2095,6294.26,18211,2236,110,13581,13581,13553,13553,13453
27268,193,200,27256,12,27268,0,5.97745e+18,182.122,2013.53,27268,167,165,31249,30769,17926,28912,1075
43934,15728,15835,16436,27498,0,43934,8.23468e+12,58.0355,18424,43934,7698,72,36720,36720,36720,36720,36720
30874,6028,7221,10847,20027,0,30874,9.88392e+12,60.0228,9470.34,30874,3516,72,23653,23653,22010,23367,20158
43126,6065,10303,40609,2517,40609,2517,3.17988e+18,98.3596,13519,43126,4871,111,35523,29268,22102,16488,13485
13559,1625,3157,0,13559,4752,8807,2.54404e+15,59.8083,4334.21,13559,1533,72,10402,10402,8141,6763,5527
22731,492,836,0,22731,22083,648,3.61762e+16,132.026,2509.54,22731,115,26,21895,21726,20742,20901,15762
36657,2873,19071,0,36657,0,36657,3.4532e+15,17.9411,19609.6,36657,17147,20,38284,38284,38284,38284,38284
9274,372,400,0,9274,9009,265,3.56714e+16,20.006,1132.49,9274,61,26,8874,8874,8826,8829,8625
4354,1279,2171,4184,170,4184,170,2.57138e+18,82.6592,2612.36,4354,1019,80,2183,2183,1842,2111,1755
20620,4421,6483,0,20620,0,20620,5.82994e+17,96.2365,8197.27,20620,3137,110,14137,14137,12412,11481,10656
16775,3626,4381,15830,945,0,16775,2.15873e+18,96.9117,5934.54,16775,2109,110,12394,12394,11640,11340,10725
19633,5313,7020,18673,960,18673,960,7.5065e+18,95.5037,8596.42,19633,3392,110,32697,32697,32248,32183,30240
39900,1255,9637,37600,2300,0,39900,2.20632e+18,97.7455,12726.3,39900,4676,110,35835,35835,15589,12147,4575
38265,1257,9014,0,38265,0,38265,6.45795e+17,97.7854,12022,38265,4358,110,28624,28624,19190,11484,7716
41390,344,12416,0,41390,15040,26350,2.31113e+15,58.7557,15069.3,41390,6043,72,40117,39707,36226,36655,31086
26032,3636,13253,26032,0,24992,1040,5.42582e+18,206.232,14583.5,26032,5087,135,19414,19414,12825,6078,4299
41882,3861,13866,15447,26435,0,41882,8.61777e+12,58.4967,16446.2,41882,6750,72,33365,33365,25664,27456,22031
9261,223,406,0,9261,8996,265,3.5737e+16,20.0294,1141.89,9261,61,26,8855,8855,8405,8433,5684
6234,6,11,6055,179,6232,2,1.43672e+14,10.09,221.04,6234,11,11,30422,30249,28932,28877,28704
41329,8950,9873,38919,2410,38919,2410,2.57747e+18,98.3531,12987.5,41329,4675,111,35228,35228,32902,29389,29555
46029,12,19,44664,1365,45921,108,1.8332e+14,10.4842,775.001,46029,14,12,46010,46008,44261,42131,33171
20352,2466,4980,19169,1183,19169,1183,3.25979e+18,97.8956,6774.07,20352,2346,111,26307,26307,26307,26307,26307
28890,1750,8454,27337,1553,0,28890,2.06105e+18,95.7624,10727.1,28890,4080,110,21336,20503,12621,14429,4692
11246,1134,3185,10629,617,10629,617,3.25412e+18,96.1974,4312.79,11246,1526,110,8061,8061,4274,5906,2812
20816,4648,5761,19656,1160,19656,1160,5.44479e+18,97.5083,7529.13,20816,2734,111,15055,15055,15055,14869,12133
4828,4,11,4679,149,4820,8,2.39032e+14,7.29681,199.425,4828,11,11,37346,36772,15581,15684,11694
41993,15040,17251,41993,0,39957,2036,4.69879e+18,410.901,19271.1,41993,4061,140,32589,32589,32589,32589,32589
10542,273,717,0,10542,10232,310,4.27137e+16,41.6876,1793.09,10542,92,26,9825,9800,8944,8631,4773
15654,146,668,4568,11086,4568,11086,1.74446e+18,15.9812,1132.23,15654,663,17,14986,14986,8251,10314,11871
18627,3106,6000,17657,970,17657,970,4.72611e+18,95.0585,7554.24,18627,2834,111,41775,41775,41775,41775,41775
47490,2,14,46126,1364,47462,28,1.46315e+14,10.3087,638.789,47490,13,12,7794,6303,6301,7018,6243
1630,114,492,0,1630,581,1049,2.40088e+15,55.9227,723.585,1630,233,51,1138,1090,460,370,361
10957,1411,3547,10957,0,10325,632,5.34244e+18,94.0726,4363.71,10957,1331,118,7410,7410,5584,6320,3413
21151,2322,5105,19921,1230,19921,1230,3.28787e+18,97.979,6963.65,21151,2404,111,16046,16046,13304,14797,8017
24691,11551,11914,23709,982,23709,982,4.0264e+18,94.3743,13478.5,24691,5726,111,18296,18296,18296,18296,18296
2948,769,1165,2808,140,0,2948,1.84504e+18,91.2032,1547.14,2948,534,62,1783,1783,1289,1237,950
11316,1,11,10990,326,11313,3,1.52329e+14,10.235,304.922,11316,11,11,2609,2609,2609,2609,2609
30678,848,959,0,30678,29803,875,3.55778e+16,191.874,3099.89,30678,140,26,28171,27883,16325,9604,2251
21403,747,784,0,21403,20792,611,3.5539e+16,102.654,2323.43,21403,105,26,20619,20619,20521,20512,20070
24581,2987,5769,23151,1430,23151,1430,3.35465e+18,97.6254,7904.05,24581,2791,110,21278,21278,21037,21262,20892
20465,393,4790,7188,13277,0,20465,9.9039e+12,59.9069,6407.82,20465,2329,72,18095,17047,13722,8123,2181
19468,430,749,0,19468,18914,554,3.55291e+16,75.2036,2160.36,19468,98,26,45036,45036,45036,45036,45036
853,19,84,0,853,828,25,4.51099e+16,15.5991,204.411,853,27,22,761,725,513,532,171
7140,10,11,6937,203,7135,5,1.38333e+14,10.9007,236.396,7140,11,11,7075,6965,6883,6882,6555
1326,57,76,0,1326,1288,38,3.53767e+16,18.408,216.962,1326,26,26,1250,1250,1213,1214,1117
14144,28,175,14134,10,14144,0,5.98033e+18,164.384,1408.94,14144,145,142,6778,1670,1980,2355,2231
7712,256,1921,0,7712,0,7712,6.4231e+17,96.2283,2807.61,7712,912,102,5791,5791,3604,1684,1237
10529,420,3204,3830,6699,0,10529,9.03335e+12,58.2633,4107.29,10529,1555,72,7325,7277,4528,6841,1253
29507,2445,7107,27787,1720,27787,1720,3.98687e+18,98.2214,9498.82,29507,3364,111,32021,32021,27685,25079,9501
16456,2870,3907,0,16456,0,16456,6.49347e+17,97.3543,5474.72,16456,1879,110,12549,12549,11141,9707,9719
5151,1359,1924,0,5151,1932,3219,2.11024e+15,56.9666,2415.03,5151,931,72,3227,3227,2537,2244,1946
16241,9,176,16198,43,16241,0,6.04693e+18,169.098,1564.89,16241,138,145,3745,562,636,645,769
37640,1701,10578,35580,2060,0,37640,2.09313e+18,96.3572,13404.7,37640,5117,110,41316,41316,41316,41316,41316
30216,10831,11370,30216,0,28596,1620,5.17306e+18,199.429,12747.3,30216,4221,133,20995,20995,20995,20995,20995
30912,126,176,30834,78,30912,0,6.02214e+18,172.821,2144.85,30912,166,163,33378,16025,27745,28002,2547
39616,4406,12001,39616,0,37314,2302,3.50449e+18,282.43,14009.8,39616,4656,133,31463,31463,28289,26867,22986
12196,3812,6540,4935,7261,0,12196,6.08078e+12,54.9562,7278.41,12196,3186,72,28579,28579,17630,15563,8721
47738,954,1276,0,47738,46378,1360,3.55669e+16,261.28,4478.02,47738,203,26,47514,47514,47514,47514,47514
16850,5877,16850,0,16850,0,16850,524257,0,16850,16850,16850,1,12800,12800,12800,12800,12800
26113,2778,8499,26113,0,24591,1522,4.56348e+18,168.548,9785.43,26113,1773,128,45805,45805,45805,45805,45805
23180,449,6788,8385,14795,0,23180,9.14068e+12,59.0344,8464.94,23180,3305,72,16392,16296,9365,15182,908
696,286,325,696,0,656,40,4.75712e+18,71.4713,436.351,696,101,43,371,371,359,361,371
35709,10985,14223,0,35709,13596,22113,1.99184e+15,57.4301,16300.9,35709,6929,72,28528,28528,28528,28528,28528
49424,16,17,47964,1460,49324,100,1.78069e+14,10.4231,782.265,49424,14,13,26950,18777,19396,24070,16884
42864,6,18,41592,1272,42728,136,1.82981e+14,10.5363,745.897,42864,15,12,9660,7391,6794,6778,6275
37409,8289,8955,35229,2180,35229,2180,4.191e+18,98.3239,11835.6,37409,4242,111,35954,35954,35954,35954,35954
37197,8065,8674,0,37197,13066,24131,2.52882e+15,60.0338,11293.3,37197,4216,72,29308,29308,25868,27587,24103
5984,1573,2492,5713,271,5713,271,8.2104e+18,93.0262,3107.28,5984,1181,84,3492,3492,3092,3024,1868
10188,1991,4473,0,10188,0,10188,4.8073e+17,91.2345,5353.65,10188,2153,107,5715,5715,4357,2967,2743
40794,3774,21804,39334,1460,39334,1460,5.07525e+18,92.2141,23912.5,40794,10512,111,36823,36823,36623,36411,36529
31328,3125,9313,29640,1688,29640,1688,2.06581e+18,97.3294,11672.8,31328,4429,111,22644,22644,14176,3123,3553
32903,655,1357,0,32903,31946,957,4.16582e+16,266.636,4316.48,32903,220,26,25869,25869,16001,4312,3741
13590,72,3221,0,13590,4780,8810,2.52759e+15,59.7253,4395.1,13590,1560,72,10369,7139,2610,421,424
10897,472,3669,10897,0,10264,633,6.04683e+18,92.3194,4408.19,10897,1051,123,7228,30701,27492,29119,24170
39915,200,208,39830,85,39915,0,6.05732e+18,201.421,2633.62,39915,182,177,28899,27640,16391,4540,2463
43448,10227,18276,41521,1927,41521,1927,6.01826e+18,95.5434,20892,43448,8776,111,25172,25172,25172,25172,13244
17558,3837,5052,16607,951,0,17558,2.08093e+18,96.5169,6617.25,17558,2429,110,48305,48305,48305,48305,48305
28782,18,176,28703,79,28782,0,5.9841e+18,169.934,2025.19,28782,162,165,10636,1766,2781,2771,2902
17845,849,17845,0,17845,17845,0,2047.89,0,17845,17845,17845,1,0,0,0,0,0
11841,3602,11841,11841,0,11841,0,8.79535e+12,0,11841,11841,11841,1,20825,20825,20825,20825,20825
28794,4221,6774,27114,1680,0,28794,2.22964e+18,97.7325,9178.71,28794,3281,110,16724,16724,12598,11403,7411
37378,17035,18280,0,37378,14823,22555,1.68677e+15,55.9756,20174.7,37378,8900,72,36995,36995,36995,36995,36995
1697,626,751,0,1697,0,1697,5.24684e+17,87.3883,990.807,1697,341,59,946,946,837,870,854
14338,11913,13402,13398,940,13398,940,1.18122e+18,3.98215,13459.3,14338,4479,9,936,936,832,835,839
17372,4,14,16862,510,17323,49,1.75622e+14,10.5648,428.892,17372,13,11,15244,13677,10437,11352,8440
13279,16,565,0,13279,12903,376,3.55866e+16,20.0543,1568.09,13279,75,26,12324,11474,9762,9390,2075
7813,305,336,0,7813,7589,224,3.53602e+16,20.0274,958.732,7813,55,26,33738,14324,14324,14324,14324
32469,5645,12789,0,32469,0,32469,5.14229e+17,94.7261,14995.5,32469,6195,110,23653,23653,20434,17517,16761
28698,1598,6922,27028,1670,27028,1670,3.53398e+18,98.1828,9264.78,28698,3270,111,27794,27794,27794,27794,27794
41467,16722,22366,0,41467,16818,24649,1.52046e+15,54.441,24264.2,41467,10873,72,25340,25340,25340,25340,25340
30753,5,14,29876,877,30682,71,1.38957e+14,10.6527,535.214,30753,13,12,5161,1095,62,1725,25
16005,288,1029,0,16005,15533,472,4.76017e+16,200.793,2870.26,16005,154,26,14874,14578,12796,11368,6674
14499,3075,3792,0,14499,0,14499,6.29518e+17,96.8733,5184.27,14499,1823,110,10707,10707,9742,9029,8877
45519,4372,19562,43530,1989,43530,1989,4.43593e+18,94.6048,22241,45519,9397,111,31977,31729,18320,22254,9501
46748,2928,10946,44028,2720,44028,2720,3.22432e+18,97.8816,14472.1,46748,5303,110,46311,46311,46311,46311,46311
33034,3,14,32094,940,32959,75,1.38923e+14,10.6513,557.082,33034,13,12,25148,17796,20696,19845,12731
30966,722,964,0,30966,30083,883,3.55704e+16,192.941,3121.54,30966,141,26,30928,30928,30928,30928,30928
26420,3537,10449,25200,1220,25200,1220,2.79283e+18,95.1544,12330.7,26420,5071,110,30360,30360,21484,17558,12135
6169,298,1499,0,6169,0,6169,6.49579e+17,95.9676,2260.7,6169,705,93,4670,4670,2132,1385,1314
12195,2,12,11827,368,12180,15,1.94367e+14,10.3316,332.332,12195,12,11,7287,5944,3612,5954,3463
44255,110,176,44225,30,44255,0,6.04082e+18,172.96,2582.21,44255,171,173,41404,35979,29078,29643,30197
23207,4452,7490,22007,1200,22007,1200,7.02155e+18,96.197,9347.49,23207,3621,110,18778,18778,18778,18778,18778
43889,1510,1566,0,43889,42617,1272,4.01998e+16,293.738,5226.82,43889,261,26,37008,37008,15989,9502,7172
9177,39,3238,8718,459,0,9177,1.90838e+18,94.9276,4140.13,9177,1553,110,2989,458,1762,1896,81
39698,2661,19787,0,39698,0,39698,4.24802e+17,93.6047,22014.8,39698,9613,110,45560,45560,45560,45560,45560
20245,638,4809,0,20245,7125,13120,2.51293e+15,59.8327,6411.4,20245,2327,72,15436,15436,5843,5444,2074
11031,2149,2640,3881,7150,0,11031,9.85423e+12,59.5317,3636.59,11031,1277,72,8391,8391,7820,8271,7035
7401,1502,1802,0,7401,2603,4798,2.52614e+15,59.3691,2539.08,7401,876,72,5599,5599,5285,5107,5076
2836,482,734,2666,170,0,2836,2.26362e+18,93.451,1159.56,2836,338,68,2102,2102,1830,1759,1638
35860,12466,14322,0,35860,0,35860,5.09065e+17,94.9633,16689.2,35860,6952,110,28135,28135,27736,27793,27371
13089,2732,3144,12329,760,12329,760,5.89662e+18,97.0794,4462.63,13089,1505,110,9945,9945,9848,9851,9087
7302,6,11,7096,206,7300,2,1.39697e+14,10.143,239.323,7302,11,11,6933,6776,5210,5185,5015
43961,8,15,42706,1255,43880,81,1.3898e+14,10.6786,663.151,43961,14,12,39560,35609,29817,23723,6306
17899,665,721,0,17899,17387,512,3.55397e+16,48.7072,2032.37,17899,92,26,17178,17147,17047,17051,16221
25957,3652,11873,24870,1087,24870,1087,5.11594e+18,94.4573,13553.8,25957,5713,111,14084,14084,11088,11442,5213
34520,1958,16771,34520,0,33160,1360,4.78878e+18,963.251,18821.2,34520,6274,138,37109,37109,18039,27120,8216
48116,2108,11252,0,48116,0,48116,6.47746e+17,97.8985,14863.8,48116,5455,110,43759,43759,41544,42849,38947
30865,1044,1266,0,30865,29969,896,4.10984e+16,265.917,3999.91,30865,202,26,31704,31704,31704,31704,31704
46352,12033,16179,46352,0,43782,2570,4.01198e+18,351.431,18089.1,46352,5808,131,31170,31170,28808,25146,25099
16462,2016,3926,15509,953,15509,953,3.35278e+18,97.0537,5492.42,16462,1882,110,12536,12536,8710,10470,6965
10716,4,11,10401,315,10708,8,1.79061e+14,10.0538,304.871,10716,11,11,9329,8252,8015,5265,5038
11935,44,512,0,11935,11595,340,3.56575e+16,19.9576,1425.12,11935,71,26,11423,11423,9223,9437,2528
22575,6238,9785,0,22575,8733,13842,1.86995e+15,56.7529,11168.6,22575,4754,72,12790,12790,11104,8857,8393
33989,599,1020,0,33989,33020,969,3.55571e+16,210.117,3365.84,33989,152,26,19815,33275,0,9874,2326
17194,1256,6274,11717,5477,16354,840,7.38991e+18,95.9279,7666.75,17194,2986,111,10920,10920,2883,6405,2614
26325,3532,11740,25205,1120,25205,1120,5.0377e+18,92.445,13471,26325,5623,111,25282,25282,25282,25282,25282
44979,5595,14690,16552,28427,0,44979,8.6789e+12,58.5798,17438.6,44979,7152,72,44544,44544,44544,44544,44544
5363,1654,2200,5363,0,5083,280,3.60048e+18,92.7734,2682.08,5363,895,90,12613,12613,5892,7712,3462
16851,211,700,0,16851,16370,481,3.55563e+16,27.9337,1942.68,16851,89,26,31991,31715,13482,21354,2713
26290,7837,8399,0,26290,9638,16652,2.24929e+15,58.6275,10198.8,26290,4087,72,17891,17891,17085,16524,16278
49979,76,274,49973,6,49979,0,5.64987e+18,242.571,1689.51,49979,271,35,12713,12413,12502,12587,11946
18151,754,4312,17099,1052,17099,1052,5.76103e+18,97.3293,6000.4,18151,2071,110,10816,10472,6543,5477,2208
1337,132,355,0,1337,465,872,2.60121e+15,56.1683,562.624,1337,173,48,982,982,610,532,444
9037,1359,2967,8569,468,8569,468,7.00602e+18,95.2577,3883.57,9037,1425,104,6070,6070,5630,5558,4239
11330,527,4097,10770,560,10770,560,4.10597e+18,95.6034,5125.55,11330,1941,111,16561,0,724,1933,1516
27898,6,12,27090,808,27882,16,1.58455e+14,10.3346,492.783,27898,12,11,4049,1032,363,571,70
2052,356,765,2052,0,1932,120,3.14214e+18,86.6574,1026.64,2052,270,58,1287,1287,869,1038,833
16517,7981,10543,16517,0,16047,470,5.54372e+18,300.857,11421,16517,2799,125,5974,24782,24407,24436,23550
31185,50,176,31112,73,31185,0,5.98109e+18,169.783,2092.56,31185,169,166,19373,6756,6121,0,0
48693,19263,24169,19387,29306,0,48693,6.4881e+12,55.3991,26487.8,48693,11758,72,32634,32634,32634,32634,32634
33973,1320,1957,32580,1393,10296,23677,1.28238e+18,16.9895,2663.59,33973,1404,19,32016,32016,31505,31189,23090
20588,641,962,0,20588,19994,594,4.08063e+16,199.818,2822.68,20588,141,26,15368,15111,0,0,0
18077,325,9928,17450,627,17450,627,2.4195e+18,92.1671,11066.9,18077,4799,110,13500,13414,6409,3840,3799
2703,139,185,0,2703,2627,76,4.05741e+16,18.0392,479.363,2703,38,26,2518,2518,2308,2323,1978
41063,5504,13665,15158,25905,0,41063,8.60345e+12,58.4791,16200.4,41063,6651,72,29976,27087,18196,20518,11886
48635,13713,14649,48635,0,45805,2830,3.89272e+18,335.303,16999.2,48635,5788,132,48207,48207,48207,48207,48207
30358,3208,7086,0,30358,0,30358,6.48993e+17,97.7426,9598.75,30358,3427,110,31313,31313,31313,31313,31313
15547,2998,6325,0,15547,5928,9619,1.95779e+15,56.7124,7400.96,15547,3059,72,9222,9222,6832,3901,4130
32305,6064,7554,0,32305,11356,20949,2.53038e+15,60.0075,9885.1,32305,3676,72,25904,25904,23214,20795,20074
9569,4,12,9288,281,9560,9,1.66196e+14,10.2661,289.154,9569,11,11,32648,31731,31522,31308,28538
27650,5630,9681,26280,1370,0,27650,1.8964e+18,95.8663,11739.6,27650,4690,110,23554,23554,23554,28198,18695
19527,153,175,19456,71,19527,0,5.98135e+18,165.867,1653.99,19527,150,157,19113,18576,17376,17302,17337
49115,6419,14328,0,49115,17775,31340,2.33715e+15,58.8877,17412.4,49115,6963,72,32930,32930,31530,31458,15840
3093,730,1016,1134,1959,0,3093,8.78692e+12,52.043,1375.63,3093,481,59,2077,2077,1756,2007,1388
48205,4156,11815,0,48205,0,48205,6.38089e+17,97.7207,15391.1,48205,5727,110,33046,32842,23366,25611,15095
3610,269,936,0,3610,1283,2327,2.49913e+15,58.428,1363.96,3610,450,67,32474,32216,19261,4518,929
40159,8504,14600,40159,0,37979,2180,4.58696e+18,295.366,16317.3,40159,2956,138,25559,25428,21257,23624,16060
12339,6,13,11984,355,12273,66,1.4725e+14,10.7803,341.433,12339,12,12,10961,9988,8445,8524,6288
38975,13,18,37818,1157,38822,153,1.83177e+14,10.5043,692.795,38975,15,12,9023,2252,2596,4609,53
3447,1,11,3344,103,3441,6,1.9059e+14,10.1451,173.032,3447,11,11,541,541,541,541,541
17773,2385,4169,0,17773,6254,11519,2.53208e+15,59.9019,5619.67,17773,2027,72,18073,18073,10304,5652,3708
9772,1,10,9492,280,9766,6,1.45778e+14,9.89183,277.149,9772,10,10,2375,2375,2375,2375,2375
40825,13515,17732,0,40825,0,40825,4.78069e+17,94.6351,20229.8,40825,8607,110,29711,29711,29711,29711,29711
8372,319,2455,0,8372,0,8372,6.07159e+17,93.846,3355.93,8372,1172,105,5917,5863,3750,2132,1450
24894,3553,5848,8763,16131,0,24894,9.89289e+12,59.9732,7738.61,24894,2845,72,21091,21091,17581,13117,11874
9622,78,176,9615,7,9622,0,6.00563e+18,159.927,1185.55,9622,126,127,7676,4537,3973,4346,4322
48239,2214,22055,31458,16781,46231,2008,8.34822e+18,93.332,24754,48239,10609,111,39733,39733,31352,21917,21015
31910,6766,11613,30351,1559,30351,1559,5.00577e+18,96.3689,13831.1,31910,5568,111,19234,19234,13149,11549,7405
26344,135,176,26272,72,26344,0,5.98109e+18,169.728,1924.6,26344,161,163,25309,23687,20015,20520,20321
39043,8303,9408,36773,2270,36773,2270,5.29582e+18,98.2842,12380.6,39043,4452,111,26151,26151,23231,22622,20227
17947,3992,4368,16906,1041,16906,1041,3.72362e+18,97.7889,6007.02,17947,2045,111,13579,13579,13222,13551,12833
34845,3574,8377,32818,2027,32818,2027,1.1815e+18,98.2367,11097.6,34845,3950,111,28457,28457,16844,13345,6835
33279,372,13126,12648,20631,0,33279,7.80881e+12,57.4734,15105.4,33279,6386,72,20153,19673,11614,18686,1302
3981,1316,1488,1483,2498,0,3981,8.10756e+12,56.5818,1897.07,3981,714,67,2493,2493,2406,2473,2379
2087,136,170,2086,1,2087,0,5.97674e+18,134.08,538.207,2087,77,71,1886,46923,46743,47613,0
37378,3072,8801,35202,2176,0,37378,2.22516e+18,97.8011,11749.6,37378,4269,110,25973,25973,14955,10915,4336
20864,3184,4930,19654,1210,19654,1210,5.74883e+18,97.4609,6809.56,20864,2376,110,15934,15934,14874,14702,10878
35667,14860,17507,34277,1390,34277,1390,3.38709e+18,94.3869,19546.9,35667,8431,111,34155,34155,34139,34139,34139
7254,628,2376,6874,380,0,7254,1.99144e+18,94.9041,3156.5,7254,1139,95,12534,11000,5615,4630,963
33750,618,13474,12853,20897,0,33750,7.75011e+12,57.3991,15462.7,33750,6557,72,20791,20017,15107,14221,9740
43211,8630,10127,40698,2513,40698,2513,5.76752e+18,97.8804,13441.1,43211,4917,110,30350,30350,23089,26122,19958
9519,3643,4097,9099,420,0,9519,1.68385e+18,91.6354,4943.05,9519,1970,108,5422,5422,5399,5342,5421
30726,1018,8366,0,30726,0,30726,6.15864e+17,97.1413,10805.9,30726,4049,110,22360,22360,25026,18920,17728
41663,85,208,41548,115,39780,1883,6.11194e+18,204.009,2727.07,41663,182,178,36876,31953,20776,5525,763
31477,3583,15008,31477,0,30149,1328,4.95621e+18,490.09,16673.9,31477,6487,136,27563,27563,27443,9500,4911
13970,351,592,0,13970,13572,398,3.56007e+16,20.0764,1639.79,13970,78,26,13378,13378,12073,12156,9045
40422,23,176,40356,66,40422,0,5.98065e+18,172.377,2383.78,40422,172,171,43420,40822,25516,26649,5412
49091,1674,15997,47354,1737,46341,2750,4.63199e+18,344.605,18333.6,49091,6522,132,32526,32526,14820,20274,6962
40117,1993,15440,15175,24942,0,40117,7.94533e+12,57.6512,17765.2,40117,7520,72,27980,27980,22119,21844,13311
19545,13,14,18976,569,19501,44,1.61699e+14,10.6583,438.233,19545,13,11,26011,24441,16556,16975,4564
9512,2144,3709,0,9512,3590,5922,2.02659e+15,57.1586,4466.44,9512,1802,72,5803,5803,4810,4202,3835
16436,8,12,15954,482,16425,11,1.6956e+14,10.3967,383.065,16436,12,11,16123,15904,13296,13242,12346
20463,3977,4863,0,20463,7200,13263,2.51449e+15,59.814,6477.03,20463,2356,72,46548,46548,46548,46548,46548
39839,3,14,38694,1145,39782,57,1.49029e+14,10.5495,635.269,39839,13,11,30521,22114,24216,24361,15321
31527,7007,9600,29857,1670,0,31527,2.02665e+18,96.6552,12000.2,31527,4652,110,44009,44009,44009,44009,44009
14475,1855,3796,13658,817,13658,817,6.10515e+18,96.7681,5185.8,14475,1821,110,10679,10679,9752,9611,6348
44995,11,18,43658,1337,44889,106,1.86833e+14,10.4771,783.296,44995,15,12,12473,4169,1949,583,239
45577,2933,10938,42926,2651,42926,2651,6.23396e+18,98.3342,14296.3,45577,5182,111,44261,44261,44261,44261,44261
28582,3670,9621,10568,18014,0,28582,8.58179e+12,58.3663,11501.7,28582,4687,72,18961,18961,13436,17395,7058
43948,3962,10244,0,43948,0,43948,6.48817e+17,97.86,13603.9,43948,4963,110,43454,43454,43454,43454,43454
1219,568,818,1202,17,1179,40,5.56452e+18,44.0016,938.348,1219,192,51,401,401,401,401,401
32151,619,985,0,32151,31234,917,3.55615e+16,199.409,3216.53,32151,146,26,22591,21373,9648,12325,2137
10036,107,486,0,10036,9749,287,3.6955e+16,19.632,1312.5,10036,66,26,9550,9550,7239,7283,3514
9520,2244,4514,0,9520,3745,5775,1.78102e+15,55.8632,5188.41,9520,2199,72,5006,5006,4330,3433,3376
14349,3578,4338,13586,763,13586,763,6.66413e+18,96.1085,5662.94,14349,2083,110,10011,10011,9548,9479,8063
7047,1,12,6837,210,7037,10,1.85533e+14,10.015,250.799,7047,11,11,1185,1185,1185,1185,1185
27723,79,7944,26214,1509,0,27723,2.08048e+18,96.9056,10157.8,27723,3851,110,27062,8938,9111,738,2066
2200,28,108,0,2200,2138,62,3.53737e+16,19.3445,321.411,2200,32,26,2092,2074,1453,1451,732
16671,6975,8604,16671,0,15981,690,4.02552e+18,183.946,9470.5,16671,3754,125,8067,8037,7461,7694,7491
9889,1010,2470,9316,573,9316,573,3.23061e+18,97.1679,3520.94,9889,1160,111,7419,7419,4673,5390,3478
49006,121,176,48866,140,49006,0,6.11374e+18,173.401,2742.02,49006,174,171,30641,19333,7507,16057,684
20372,34,176,20322,50,20372,0,6.04084e+18,166.645,1748.63,20372,154,153,11076,3453,3733,4390,4103
10273,785,10273,10273,0,0,10273,7.99922,0,10273,10273,10273,1,0,0,0,0,0
47345,2328,10984,16632,30713,0,47345,9.90132e+12,60.0844,14179.6,47345,5341,72,35632,35632,25120,27888,20400
8223,1613,3887,0,8223,0,8223,4.55717e+17,92.9863,4605.93,8223,1875,100,13465,13378,7556,12103,4755
32023,6703,11019,32023,0,30263,1760,5.0828e+18,219.054,12686.5,32023,2853,133,24529,24529,24364,24414,24329
36397,7387,8468,0,36397,12793,23604,2.5326e+15,60.0757,11045.1,36397,4123,72,30837,30837,30837,30837,30837
11536,1918,4200,4313,7223,0,11536,8.29384e+12,57.633,5100.03,11536,2040,72,7336,7336,5592,7033,3636
28056,6606,6780,26423,1633,26423,1633,4.59039e+18,98.1278,9076.32,28056,3199,111,27860,27860,27860,27860,27860
12366,6,11,12014,352,12365,1,1.38165e+14,10.1066,309.939,12366,11,11,11757,11482,10416,10417,8540
2141,698,1164,0,2141,464,1677,1.35901e+13,8.70715,1247.99,2141,1046,11,977,977,667,692,25217
34614,3076,8314,32597,2017,32597,2017,4.02385e+18,98.2614,11023.1,34614,3935,111,34499,34499,34499,34499,34499
39005,7705,13212,39005,0,36795,2210,4.62962e+18,267.584,14901,39005,2567,135,19676,19676,14871,16914,8689
28075,1969,10593,26745,1330,26745,1330,2.97904e+18,95.4216,12610.8,28075,5132,110,33579,33579,33579,33579,33579
17737,3967,6276,0,17737,0,17737,5.52233e+17,94.4376,7738.68,17737,3039,110,11461,11461,9810,9877,8168
42047,7507,9815,39598,2449,0,42047,2.22924e+18,97.8609,13058.6,42047,4759,110,27795,27795,21316,16462,14198
49673,199,208,49603,70,49673,0,6.09499e+18,205.381,2956.98,49673,190,190,40560,40176,35868,31462,29695
16523,3011,8821,0,16523,0,16523,3.97472e+17,89.6343,9916.12,16523,4256,110,20170,20170,16530,15005,10701
43526,14,15,42263,1263,43466,60,1.56659e+14,10.4054,683.708,43526,13,11,28564,19232,19228,24239,18589
37380,14,15,36286,1094,37323,57,1.67635e+14,10.3555,654.897,37380,13,11,8484,1211,504,2151,501
46563,6145,10901,43853,2710,43853,2710,3.22204e+18,97.8709,14416.5,46563,5283,110,23967,23967,14331,23699,13572
35475,3756,14732,33884,1591,33884,1591,3.60228e+18,95.5733,16984.6,35475,7074,111,32141,32141,32141,32141,32141
45125,1,16,43791,1334,45052,73,1.81155e+14,10.4106,744.751,45125,13,12,16129,16129,16129,16129,16129
19109,177,208,19057,52,19109,0,5.99134e+18,192.157,1735.72,19109,158,154,8671,8576,830,5203,174
16765,6415,8467,16765,0,12459,4306,5.61353e+18,172.551,9339.97,16765,2091,126,10177,0,0,7280,13595
15237,222,3719,14348,889,14348,889,3.16598e+18,97.727,5166.82,15237,1740,111,36660,36660,28309,30541,19135
22334,7131,7788,8297,14037,0,22334,8.39102e+12,58.0701,9315.59,22334,3781,72,14546,33362,32913,33184,36020
41907,7954,15685,41907,0,33632,8275,4.71614e+18,296.622,17432.5,41907,3154,138,41315,41315,41315,41315,41315
23033,11,12,22363,670,23019,14,1.58085e+14,10.3014,444.82,23033,12,11,35716,35716,35715,35713,35352
34712,1193,11215,34712,0,32692,2020,5.00335e+18,242.985,12783,34712,4130,128,33907,33907,21419,7877,5434
35178,11586,12662,0,35178,0,35178,5.41092e+17,94.5701,15113.8,35178,6128,110,22516,22516,21862,21959,21105
20782,2,14,20182,600,20705,77,1.5248e+14,10.6463,458.25,20782,14,12,1397,133,115,366,86
29385,7258,14037,11604,17781,0,29385,6.76259e+12,56.1437,15630.7,29385,6835,72,15348,15348,12542,14868,9393
34849,1219,1432,0,34849,33832,1017,4.1927e+16,285.534,4588.87,34849,232,26,32224,32224,12382,26783,4540
30716,12995,13203,30716,0,29268,1448,4.54518e+18,309.457,14783.5,30716,5834,130,29288,29288,29288,29288,29288
3726,164,168,0,3726,3622,104,3.541e+16,19.6876,497.688,3726,39,26,20484,20484,20443,20446,20350
13658,20,176,13655,3,13658,0,5.99371e+18,164.82,1397.23,13658,135,145,3520,310,168,561,47
28917,3408,11820,28917,0,27448,1469,5.23729e+18,203.733,13145.2,28917,4831,128,27927,27927,17601,12019,8645
40110,415,1363,0,40110,38953,1157,3.87703e+16,264.552,4535.54,40110,220,26,30450,30210,25230,21967,19048
41731,7964,13679,39601,2130,39601,2130,7.11146e+18,85.8322,16590.1,41731,6637,110,31601,31578,31493,31568,31568
11309,3879,4215,10759,550,10759,550,5.25298e+18,95.4062,5229.2,11309,2000,111,23228,23228,15564,11642,8519
29328,1,11,26939,2389,29324,4,1.14431e+14,7.963,438.946,29328,11,8,7865,7865,7865,7865,7865
31952,1216,12718,12163,19789,0,31952,7.76101e+12,56.9186,14626.7,31952,6183,72,19560,19388,15027,10846,10533
24103,4720,6748,8671,15432,0,24103,9.30159e+12,59.2578,8505.36,24103,3287,72,13712,13712,11295,9520,9483
18244,474,5196,17236,1008,17236,1008,2.90742e+18,97.2763,6783.21,18244,2465,111,18719,18632,7860,9876,2576
46209,13337,20785,44279,1930,44279,1930,2.66753e+18,93.945,23479.6,46209,10092,111,37449,37449,37449,37449,37449
3363,467,1635,3363,0,3203,160,3.66736e+18,89.2367,1950.29,3363,657,71,1728,1635,1184,1419,1097
24969,1651,10007,23829,1140,23829,1140,2.83885e+18,92.7003,11801.3,24969,4843,110,28009,28009,12858,8286,3044
15508,5622,9149,0,15508,0,15508,3.51701e+17,87.0543,10098.1,15508,4421,110,6359,6359,5506,4999,5064
16255,2902,5113,16255,0,15305,950,3.26915e+18,132.675,6180.84,16255,1951,121,11142,11089,8650,9489,6864
40803,3312,9511,38423,2380,0,40803,2.23051e+18,97.8941,12682.1,40803,4614,110,34833,34833,31945,34102,27551
1627,251,468,0,1627,0,1627,6.4431e+17,89.5261,746.599,1627,203,55,1159,1159,934,988,826
24500,10624,11978,9706,14794,0,24500,6.58618e+12,55.7488,13339.3,24500,5812,72,44706,44706,44706,44706,44706
17955,2920,9534,17307,648,17307,648,1.01876e+19,91.5561,10700.4,17955,4620,110,8421,8421,6692,7963,3260
8021,3551,3776,3157,4864,0,8021,6.91709e+12,55.8524,4376.7,8021,1837,72,4245,4245,3978,4187,3717
44255,103,208,44238,17,43216,1039,5.98507e+18,198.315,2618.69,44255,184,185,20568,4900,6569,12163,565
34858,172,176,34847,11,34858,0,5.98219e+18,169.688,2211.56,34858,170,169,30675,30379,0,425,409
28812,5851,6776,27132,1680,0,28812,2.22965e+18,97.753,9183.59,28812,3282,110,30120,30120,25831,24125,18521
37525,5,6,36353,1172,37365,160,0.000133245,0.99984,457.969,37525,6,1,37523,37523,37523,534,872
20326,114,1050,0,20326,19733,593,4.347e+16,206.762,3074.01,20326,156,26,19000,18817,13043,12827,5242
35198,18,176,35132,66,35198,0,6.1719e+18,172.812,2309.88,35198,154,159,13820,3142,4294,3681,3371
41786,155,1162,0,41786,40594,1192,3.55253e+16,242.648,3989.99,41786,181,26,32439,32345,8452,25569,1082
5637,1740,2991,0,5637,0,5637,3.46497e+15,17.3124,3189.2,5637,2687,20,2646,2646,1562,2646,1580
47129,1142,2813,45202,1927,14361,32768,1.73441e+18,16.9926,3647.24,47129,1938,19,45740,45740,43317,40869,28454
37054,7,12,35996,1058,37039,15,1.3915e+14,10.2546,544.287,37054,11,12,35706,34662,26358,26109,24103
9388,1584,2356,8845,543,8845,543,3.14563e+18,97.0059,3364.73,9388,1092,111,7032,7032,6251,6975,43917
44918,18301,20318,43048,1870,0,44918,1.59493e+18,91.6472,22945.9,44918,9857,110,37036,37036,37036,37036,37036
45593,7065,14546,45593,0,42941,2652,4.75055e+18,319.454,16454.1,45593,3572,134,38656,38656,38656,38656,38656
30501,12343,12694,0,30501,0,30501,4.95107e+17,93.6807,14738.4,30501,6148,110,48663,48663,48663,48663,48663
25008,513,5868,23550,1458,0,25008,2.23026e+18,97.6375,8028.17,25008,2835,110,19140,19140,11839,10619,2833
12549,1970,2981,0,12549,4411,8138,2.52933e+15,59.7028,4085.32,12549,1446,72,9568,9568,8099,8414,6452
29487,130,176,29410,77,29487,0,6.04692e+18,172.133,2105.52,29487,159,163,32924,18690,23690,17391,2034
41268,4926,17510,41268,0,39398,1870,4.65919e+18,922.271,19823.1,41268,5667,138,30637,30637,27714,30019,22956
32147,11491,16428,32147,0,0,32147,8.81727e+17,17.9754,16936.7,32147,14770,20,24765,24765,24765,24765,24765
41197,6,12,40022,1175,41181,16,1.38814e+14,10.2863,576.443,41197,12,11,7791,4182,2990,3522,2899
22676,8501,9857,22676,0,21576,1100,5.55196e+18,184.741,10967.3,22676,3400,130,17435,17420,16195,17003,14022
41032,8541,9634,38645,2387,0,41032,2.2264e+18,97.846,12811.5,41032,4673,110,44811,44811,44811,44811,44811
10887,303,2642,10257,630,10257,630,5.77696e+18,96.7875,3791.31,10887,1257,110,8245,8245,6377,5036,1534
20098,8556,10865,19390,708,19390,708,2.39972e+18,89.8619,12112.3,20098,5264,110,9233,9233,7861,8375,7720
2940,57,148,0,2940,2854,86,3.62494e+16,19.4514,426.809,2940,37,26,2792,2792,2478,2487,1259
16688,1,12,16208,480,16676,12,1.46759e+14,10.677,371.781,16688,12,11,4035,4035,4035,4035,4035
26413,513,1636,0,26413,25617,796,5.1725e+16,294.861,4940.29,26413,272,26,24777,23647,21263,19026,10233
49311,1,16,47885,1426,49221,90,1.58048e+14,10.449,713.103,49311,13,13,10279,10279,10279,10279,10279
28892,72,176,28881,11,28892,0,5.98267e+18,169.541,2014.4,28892,161,166,19766,6303,10668,13206,1857
7061,648,2622,0,7061,0,7061,5.36039e+17,94.0045,3354.9,7061,1246,91,4439,4322,2300,1323,1804
14439,2136,3420,5076,9363,0,14439,9.88103e+12,59.7342,4649.06,14439,1655,72,11019,11019,9481,10699,7027
1565,8,585,1565,0,1475,90,4.82305e+18,85.4319,811.553,1565,203,58,179,27,8,18,2
16192,1568,5854,0,16192,6048,10144,2.12134e+15,57.8386,7024.01,16192,2851,72,35763,35763,15874,12485,4594
26333,4707,6392,0,26333,9305,17028,2.50156e+15,59.8558,8353.94,26333,3110,72,19941,19941,17884,16046,14568
3456,309,890,3254,202,3254,202,5.8419e+18,93.9679,1381.96,3456,412,74,2566,2566,2400,2321,1149
27799,2203,6547,26179,1620,26179,1620,5.77252e+18,97.7102,8888.3,27799,3165,110,21252,21252,18627,18203,8139
37289,5157,12062,35369,1920,0,37289,1.97002e+18,96.3708,14737.6,37289,5852,110,43756,43756,43756,43756,43756
13357,1470,3108,4691,8666,0,13357,9.95005e+12,59.8303,4269.28,13357,1513,72,10249,10249,8141,9778,5051
23921,4828,6852,8627,15294,0,23921,9.20688e+12,59.1114,8584.1,23921,3333,72,23600,23600,23600,23600,23600
23859,8165,10481,0,23859,0,23859,4.75872e+17,90.8111,12130.1,23859,5080,110,21362,21362,21362,21362,21526
12744,3577,4800,0,12744,4788,7956,2.06985e+15,54.4698,5758.72,12744,2321,72,41266,41266,40781,39554,13867
38606,9737,18912,8471,30135,0,38606,52220200000,8.99246,19322.1,38606,17013,11,19694,19694,12410,19694,11525
44990,929,1218,0,44990,43708,1282,3.55211e+16,251.006,4241.77,44990,192,26,44662,44662,44662,44662,44662
28742,7717,8453,27192,1550,27192,1550,6.78654e+18,96.7652,10708.1,28742,4100,110,28509,28509,28509,28509,28509
20047,146,175,20039,8,20047,0,5.97875e+18,166.161,1676.18,20047,151,158,24987,24777,14785,12785,1657
13454,2824,3380,12684,770,12684,770,6.10765e+18,96.9116,4710.34,13454,1619,110,10074,10074,9944,9944,8777
21167,3,14,20562,605,21097,70,1.39508e+14,10.6404,432.227,21167,13,12,9852,8775,8721,9069,8369
7111,600,3673,6841,270,0,7111,1.44587e+18,85.7671,4281.87,7111,1764,88,3438,8848,7131,0,0
15713,1229,3693,5530,10183,0,15713,9.90839e+12,59.8544,5007.82,15713,1799,72,23441,23441,19077,22303,4292
7154,113,2725,0,7154,0,7154,5.29053e+17,93.4849,3457.08,7154,1287,91,4429,1980,2580,188,489
37495,6601,17716,37495,0,36255,1240,5.16776e+18,3027.42,21067.3,37495,7886,149,32547,32547,26283,23664,15748
24477,3858,6461,23100,1377,23100,1377,6.30024e+18,97.1609,8519.73,24477,3129,110,18016,18016,17479,17480,11820
25745,888,6032,24244,1501,24244,1501,5.85843e+18,97.6481,8239.29,25745,2917,110,19713,19713,17802,16360,4058
40427,5645,12897,38317,2110,38317,2110,2.99277e+18,97.1043,15703.3,40427,6159,111,35150,34969,34969,34969,34969
16202,2880,6211,0,16202,6118,10084,2.03961e+15,55.3464,7356.05,16202,3003,72,30971,30971,20725,18570,8392
10861,723,5446,10441,420,10441,420,4.4055e+18,83.7107,6285.09,10861,2591,105,5415,5156,2075,3072,1390
7441,1373,1797,0,7441,0,7441,6.50721e+17,96.2119,2666.68,7441,852,100,5644,5644,5087,4606,4698
39579,233,1124,0,39579,38451,1128,3.55436e+16,234.578,3816.87,39579,173,26,24707,23315,17313,16636,11051
22166,2619,7285,0,22166,0,22166,5.72451e+17,96.0977,9064.04,22166,3530,110,28251,28251,28251,28251,28251
37181,6203,14950,35491,1690,35491,1690,8.35416e+18,94.0061,17378.9,37181,7254,110,42221,42221,42221,42221,42221
1227,22,340,427,800,0,1227,9.69148e+12,55.3594,534.014,1227,160,46,487,84,191,324,60
17978,6873,10630,0,17978,7451,10527,1.35443e+15,52.8799,11537.2,17978,5157,72,7348,7348,6157,4498,4336
2826,898,1488,2716,110,0,2826,1.47709e+18,89.1465,1797.04,2826,700,56,1338,1252,884,773,752
24945,9,12,24228,717,24931,14,1.46836e+14,10.2463,453.604,24945,12,11,24642,24282,23674,23675,21492
29056,136,176,29044,12,29056,0,5.98618e+18,169.675,2020.43,29056,160,166,25643,21717,19672,20807,16542
28597,3062,9345,27137,1460,0,28597,1.96129e+18,96.187,11515.9,28597,4519,110,19854,19695,0,0,4490
30175,2273,9860,30175,0,28425,1750,4.13695e+18,193.712,11273.8,30175,3603,122,20315,20083,11237,15230,5333
24227,11053,24227,24227,0,24227,0,34358300000,0,24227,24227,24227,1,0,0,0,0,0
8772,263,639,8418,354,2747,6025,1.30541e+18,16.9569,986.97,8772,365,19,8133,8133,6868,42366,40030
15056,344,1150,0,15056,14599,457,5.36077e+16,176.424,3178.61,15056,179,26,23803,23177,4109,2145,1403
20605,11,13,19999,606,20591,14,1.78393e+14,10.1316,431.763,20605,12,12,20592,20592,20140,20142,18663
1089,210,349,0,1089,0,1089,6.47345e+17,84.4252,547.912,1089,147,47,740,740,597,560,565
40786,3793,9536,38414,2372,0,40786,2.22947e+18,97.8304,12704.1,40786,4615,110,27637,27176,16281,21424,9198
45781,13326,15081,0,45781,0,45781,5.68328e+17,96.3911,18199.5,45781,7327,110,45070,45070,45070,45070,45070
32581,6332,8678,0,32581,0,32581,6.21788e+17,97.2559,11242.9,32581,4201,110,29598,29598,29598,29598,29598
44284,8926,10315,0,44284,0,44284,6.485e+17,97.8926,13699.9,44284,5001,110,33555,33555,30475,31015,29177
16332,2774,4131,15392,940,15392,940,3.18444e+18,97.5837,5641.44,16332,1939,111,12201,12201,11564,12201,9407
29966,8259,12680,0,29966,11527,18439,1.90569e+15,56.9985,14431.2,29966,6173,72,30565,30565,29335,30299,27117
6117,294,656,0,6117,5932,185,5.17962e+16,18.7721,1490.76,6117,82,26,5461,5461,4713,4990,2994
45049,10642,12638,42569,2480,42569,2480,4.10381e+18,97.7086,15829.3,45049,6010,111,35584,35584,33558,32504,30906
44250,13170,21990,0,44250,17619,26631,1.66064e+15,54.8155,24135.8,44250,10690,72,22260,22260,17990,18267,13008
20155,3967,5916,7300,12855,0,20155,9.15714e+12,58.9805,7414.89,20155,2882,72,25003,25003,20107,19042,13879
17195,1744,5381,0,17195,0,17195,5.82623e+17,94.3343,6882.33,17195,2580,110,11814,11814,8207,3812,4228
12040,349,640,0,12040,11692,348,3.82731e+16,19.9724,1673.1,12040,83,26,22702,22702,10221,14691,2493
35395,4962,11689,0,35395,13045,22350,2.21123e+15,58.4882,13941.1,35395,5687,72,27427,27427,22646,26319,16683
15426,1306,3632,0,15426,5428,9998,2.53675e+15,59.8318,4929.07,15426,1763,72,11794,11794,7694,6646,4408
48635,19459,20328,46485,2150,0,48635,1.69437e+18,93.7732,23260.4,48635,9870,110,46722,46722,46722,0,11078
22993,7303,10783,22993,0,15330,7663,4.48641e+18,243.817,11905.7,22993,4639,126,12210,12107,10684,11440,9382
28302,2413,11871,0,28302,10878,17424,1.9204e+15,57.0415,13552,28302,5777,72,24389,24389,12978,7191,4801
25382,281,9597,0,25382,0,25382,5.26272e+17,95.3499,11464.1,25382,4640,110,15785,15183,6408,242,1482
9232,413,2264,8692,540,8692,540,3.45389e+18,97.0951,3264.82,9232,1048,111,38146,0,0,40784,40784
28571,920,1959,5788,22783,0,28571,5.69927e+13,11.994,2503.74,28571,1167,14,26612,26612,20160,16616,23693
47872,8251,18768,47872,0,45552,2320,4.54269e+18,1210.59,21345.9,47872,6485,144,37507,37507,36755,36755,28037
6967,1383,1738,6564,403,6564,403,2.7973e+18,96.4254,2552.89,6967,799,98,5229,5229,4618,4772,4548
49676,15336,15874,18229,31447,0,49676,8.77004e+12,58.7109,18885.1,49676,7727,72,40833,40833,40833,40833,40833
45640,10469,11096,42990,2650,42990,2650,5.62881e+18,98.3018,14443.3,45640,5256,111,45236,45236,45236,45236,45236
8879,350,2191,8367,512,0,8879,2.2171e+18,96.4333,3176.91,8879,1043,108,6688,6688,4254,3832,1564
23150,5180,5954,0,23150,0,23150,6.29884e+17,97.2089,7942.39,23150,2873,110,21804,21804,9430,16322,5306
31354,54,176,31343,11,31354,0,5.9815e+18,169.711,2098.12,31354,168,165,20687,10397,8347,9798,9645
46822,148,176,46725,97,46822,0,6.06384e+18,171.665,2668.37,46822,171,169,46651,46643,46634,46621,46613
29141,6692,6876,0,29141,0,29141,6.46496e+17,97.662,9305.97,29141,3323,110,19667,19667,17025,17637,16247
5790,1763,2562,2238,3552,0,5790,7.28508e+12,55.9283,3051.66,5790,1244,72,24061,24061,23509,0,0
47499,7930,11102,44730,2769,0,47499,2.22911e+18,97.9108,14673.5,47499,5390,110,34197,34051,28885,31564,24283
31260,1186,8665,29525,1735,29525,1735,4.56653e+18,97.6419,11070,31260,4111,111,22595,22595,10914,14771,5140
29057,2,13,28209,848,29040,17,1.62025e+14,10.24,507.812,29057,12,12,19161,18349,14605,15647,14353
45037,7919,14398,42707,2330,42707,2330,3.03135e+18,96.5294,17515.9,45037,6992,110,46749,46749,46749,46749,46749
20469,2525,9581,20469,0,19559,910,5.29189e+18,188.293,10701.4,20469,2302,132,44394,44394,44394,44394,44394
17916,2827,4246,16873,1043,16873,1043,5.88103e+18,97.3806,5916.91,17916,2048,110,13670,13670,13330,13330,9859
12790,3257,3827,12103,687,0,12790,2.05369e+18,96.1091,5047.45,12790,1844,110,8963,8963,8393,8180,7783
35411,14,1045,0,35411,34399,1012,3.55455e+16,216.48,3478.65,35411,158,26,34890,20403,9601,12423,6452
42785,7704,10040,40295,2490,40295,2490,5.92587e+18,97.8472,13325.3,42785,4868,110,25011,24123,19992,20913,15910
45470,1783,19119,0,45470,0,45470,4.89614e+17,94.1321,21890,45470,9276,110,26864,26864,16458,25077,3890
49641,12237,13678,46911,2730,46911,2730,3.27918e+18,97.2491,17222.3,49641,6642,110,32465,32465,27473,32062,18434
39368,5883,20121,37898,1470,37898,1470,9.82061e+18,93.4476,22288.3,39368,9774,110,47356,47356,47356,47356,47356
49480,294,17108,47020,2460,47020,2460,2.94832e+18,96.1273,20362.3,49480,8308,110,48629,48629,47534,47586,41540
30963,9538,10285,0,30963,11420,19543,2.20475e+15,58.4367,12304.1,30963,5004,72,25627,25627,19076,24262,11644
19984,7655,11179,8173,11811,0,19984,5.69461e+12,54.7607,12218.8,19984,5436,72,8805,8805,7300,8545,5654
47150,301,1260,0,47150,45805,1345,3.55062e+16,257.95,4413.85,47150,200,26,48094,48094,48094,48094,48094
33063,5730,7749,0,33063,0,33063,6.49467e+17,97.7939,10428.7,33063,3756,110,27922,27922,23020,26421,15790
35650,12864,13751,33982,1668,33982,1668,2.84728e+18,93.9366,16148.3,35650,6661,110,31275,31275,31275,31275,31275
6865,2148,2581,2582,4283,0,6865,8.1643e+12,57.2291,3186.78,6865,1252,72,4284,4284,3856,4194,3329
32209,3281,9952,0,32209,0,32209,5.84057e+17,96.5434,12381.7,32209,4820,110,44833,44833,44833,44833,44833
28905,1316,9398,28905,0,28905,0,2.49083e+18,2777.7,11879.3,28905,7373,25,16036,14740,3658,2096,3243
23363,3641,8027,8667,14696,0,23363,8.5056e+12,58.2229,9617.29,23363,3910,72,46650,46650,46650,46650,46650
13477,1676,3317,12697,780,12697,780,5.71109e+18,97.4911,4639.61,13477,1551,111,10160,10160,7964,8788,5888
48674,6939,11383,45844,2830,45844,2830,5.76452e+18,97.8911,15030.9,48674,5519,110,37291,37291,34651,34228,24136
39353,483,1116,0,39353,38231,1122,3.5539e+16,233.315,3795.31,39353,172,26,32326,32326,26795,22786,12257
19127,433,4515,0,19127,0,19127,6.51766e+17,97.4901,6269.86,19127,2180,110,14557,14557,4161,14181,2450
39972,156,176,39912,60,39972,0,6.07587e+18,173.385,2470.13,39972,170,172,20814,20027,10865,17343,4710
11827,1114,2841,11137,690,11137,690,5.7585e+18,97.0958,4064.88,11827,1364,110,8986,8986,7926,7761,3947
1682,76,117,0,1682,1635,47,3.9456e+16,18.7669,309.944,1682,32,25,1565,1565,1478,1490,1099
39956,9108,9319,37626,2330,37626,2330,5.75043e+18,97.8773,12436.1,39956,4514,110,29102,29102,29102,29102,29102
27346,3736,7962,25872,1474,0,27346,2.06528e+18,96.7612,10144.2,27346,3856,110,20639,20396,11501,16896,5263
546,87,147,546,0,546,0,6.06128e+18,69.7308,261.125,546,46,32,385,257,255,270,252
39465,138,1306,0,39465,38329,1136,3.8208e+16,264.54,4355.07,39465,210,26,28450,28276,8382,7294,1036
31846,2512,10460,30218,1628,0,31846,1.95582e+18,96.2652,12813,31846,5072,110,25936,25936,21765,24242,16125
37451,5874,8722,0,37451,13159,24292,2.53099e+15,60.047,11356.4,37451,4243,72,29471,29471,27933,28804,27432
15243,2175,3575,14351,892,0,15243,2.23906e+18,97.2898,5056.44,15243,1720,110,10823,10813,9398,10125,6440
25902,89,1095,7556,18346,7556,18346,1.74384e+18,15.9883,1696.73,25902,1090,17,24764,8082,20261,14483,1614
23463,2906,7738,22264,1199,0,23463,1.95565e+18,96.0889,9595.86,23463,3745,110,15725,15725,11208,10314,6024
20359,614,4803,19172,1187,0,20359,2.22935e+18,97.5105,6647.67,20359,2315,110,46790,46790,46790,46790,46790
22491,3603,11375,0,22491,8978,13513,1.63367e+15,55.5869,12614.1,22491,5531,72,11116,11116,6958,4238,3516
41135,866,16215,0,41135,15624,25511,1.99781e+15,57.5043,18563.3,41135,7894,72,33321,33013,27601,29374,21807
40887,10341,15743,38974,1913,0,40887,1.79179e+18,95.4493,18411,40887,7647,110,34656,34656,34656,34656,34656
35409,10,15,34378,1031,35345,64,1.63166e+14,10.3884,624.337,35409,13,11,40832,40637,38964,38964,38049
38542,12408,14093,36682,1860,36682,1860,3.0082e+18,95.7227,16704.7,38542,6839,110,24529,24529,22599,23279,22473
21766,5676,6709,20616,1150,20616,1150,3.11839e+18,96.406,8507.36,21766,3242,110,34471,34471,28951,26716,19584
19359,2588,7433,18449,910,18449,910,8.05567e+18,79.5031,8946.03,19359,3580,110,11926,11926,11026,11026,0
3381,33,866,0,3381,0,3381,6.50219e+17,93.9967,1351.02,3381,397,75,1163,178,632,81,172
3767,1,11,3660,107,3766,1,1.3816e+14,10.5705,172.572,3767,11,11,971,971,971,971,971
37708,8717,9660,0,37708,13407,24301,2.45322e+15,59.6626,12240.9,37708,4696,72,44781,44781,44781,44781,44781
10247,579,2760,9670,577,0,10247,2.14773e+18,96.4391,3830.39,10247,1324,110,7487,7487,5065,4670,2390
4249,273,1134,4008,241,0,4249,2.18133e+18,94.4114,1702.18,4249,528,81,3115,3115,1988,1798,986
48854,10201,17715,46472,2382,46472,2382,3.21951e+18,95.7092,20805.7,48854,8483,111,48086,48086,48086,48086,48086
22628,3074,6892,21418,1210,21418,1210,4.50335e+18,97.0527,8719.56,22628,3275,111,15736,15736,12586,14076,7540
941,288,308,881,60,881,60,5.64275e+18,83.5792,483.83,941,122,42,633,633,618,631,633
49558,5226,20501,47351,2207,47351,2207,8.52502e+18,95.0381,23489.5,49558,9959,110,39788,39788,33687,32560,26510
45105,17166,23342,43448,1657,0,45105,1.40629e+18,91.3324,25728,45105,11335,110,35254,35254,35254,35254,35254
10912,246,5013,0,10912,4267,6645,1.79315e+15,54.1066,5782.67,10912,2431,72,5899,5662,3304,1704,0
46883,3488,13175,0,46883,0,46883,6.08197e+17,97.1399,16537.1,46883,6394,110,46252,46252,46252,46252,46252
41407,259,15627,39446,1961,39446,1961,7.84072e+18,95.5697,18346.2,41407,7585,110,35214,35214,27320,19139,17403
16746,3104,3927,5893,10853,0,16746,9.92247e+12,59.8839,5308.94,16746,1913,72,16431,16431,16431,16431,16431
4877,770,2131,0,4877,0,4877,4.79428e+17,92.0033,2649.4,4877,1005,76,2746,2671,1800,792,1013
34115,407,11609,32402,1713,0,34115,1.92295e+18,96.1007,14056.3,34115,5633,110,32224,31068,24393,25323,11151
35554,3447,11445,35554,0,33484,2070,3.41232e+18,249.877,13040.3,35554,4226,128,10347,10347,8792,8459,8438
638,194,231,0,638,239,399,2.49811e+15,48.1583,340.222,638,107,35,407,407,374,391,385
7296,2193,4237,2995,4301,0,7296,5.50939e+12,53.3914,4709.71,7296,2046,72,3059,3059,2374,2939,21064
39707,6060,9273,0,39707,0,39707,6.49426e+17,97.8585,12371.3,39707,4497,110,40430,40430,40430,40430,40430
8795,20,61,8763,32,8795,0,2.25354e+18,60.0523,696.634,8795,61,61,4704,491,1667,2288,2687
27916,713,1486,0,27916,27090,826,4.72726e+16,272.915,4553.45,27916,246,26,26430,26430,23412,23632,30948
28371,3368,12597,0,28371,11031,17340,1.8391e+15,56.6819,14226.9,28371,6136,72,22664,22664,17791,21512,11277
48902,3295,15895,46372,2530,46372,2530,5.83697e+18,97.0647,19127.5,48902,7594,111,45543,45543,45876,4684,6192
31854,1154,9620,30159,1695,30159,1695,6.8732e+18,96.6982,12042.1,31854,4667,110,30738,30738,16318,24927,5283
8763,3112,3384,8343,420,0,8763,1.81905e+18,94.2956,4220.38,8763,1629,100,5379,5379,5084,5012,4865
44215,8297,16261,0,44215,0,44215,5.35383e+17,95.7555,19159.6,44215,7902,110,28707,28707,22994,24044,21809
26129,5380,9309,0,26129,0,26129,5.45296e+17,95.7167,11267.6,26129,4510,110,23223,23223,22793,22795,18320
29450,115,176,29371,79,29450,0,6.01289e+18,171.646,2072.07,29450,167,165,44012,39932,27084,28380,28389
19749,4975,6971,19749,0,18639,1110,3.94391e+18,146.701,8032.26,19749,2266,128,12778,12778,11946,12164,9215
38806,13048,16094,37079,1727,37079,1727,2.82056e+18,94.9461,18559.1,38806,7815,110,22712,22712,19233,20652,18079
8033,103,170,8027,6,8033,0,5.97207e+18,160.065,1055.75,8033,117,123,7196,4684,4505,4705,4821
10469,853,2532,9859,610,0,10469,2.22531e+18,96.9019,3648.59,10469,1214,110,7937,7937,5081,4699,3294
48300,6085,23663,0,48300,10596,37704,1.33804e+13,8.99489,24122.7,48300,21289,11,33411,33219,26018,28111,19047
18581,1,12,18048,533,18567,14,1.48531e+14,10.5554,394.955,18581,12,11,4415,4415,4415,4415,4415
47171,17481,27873,0,47171,0,47171,3.46884e+17,91.4753,30049.3,47171,13555,110,36926,36926,36926,36926,36926
27073,4388,6559,25502,1571,25502,1571,4.87635e+18,98.0749,8797.38,27073,3090,111,26868,26550,26550,26550,26550
29173,1,14,28330,843,29093,80,1.59914e+14,10.5622,554.524,29173,13,12,101,101,101,101,101
31778,5950,14049,0,31778,12349,19429,1.84715e+15,56.7059,15835.5,31778,6837,72,17729,25886,20089,20560,14596
3553,106,268,0,3553,3448,105,4.26302e+16,19.4126,670.37,3553,48,26,12179,5513,7266,6628,225
34336,6672,19760,33226,1110,0,34336,1.23985e+18,92.3561,21518.7,34336,9598,110,20723,20409,14381,17115,9870
23469,59,176,23396,73,23469,0,6.01321e+18,171.293,1862.72,23469,154,161,12246,3652,5675,8209,1351
12070,826,2915,11370,700,11370,700,3.27768e+18,96.9557,4154.37,12070,1388,110,9155,9155,5713,7466,3216
21055,86,176,20978,77,21055,0,6.05173e+18,170.753,1788.42,21055,151,153,13135,11673,6533,5889,4077
44756,20341,25365,18374,26382,0,44756,5.58821e+12,54.2378,27284.7,44756,12342,72,30402,30402,30402,30402,30402
27433,922,982,0,27433,26645,788,3.73172e+16,195.447,3080.34,27433,143,26,43757,43757,43757,43757,43757
17164,131,4082,16169,995,16169,995,5.88022e+18,97.2682,5698.42,17164,1958,110,13082,7425,11349,10087,1157
10258,1852,2488,9660,598,0,10258,2.22382e+18,96.8823,3586.88,10258,1191,110,7770,7770,7056,6780,6197
43798,8866,11883,41369,2429,41369,2429,6.27617e+18,97.298,15099.7,43798,5767,110,43253,43253,43253,43253,43253
29808,3250,7056,10498,19310,0,29808,9.85752e+12,59.9741,9236.29,29808,3437,72,22752,22752,17656,21602,10542
45454,2038,17400,43305,2149,43305,2149,4.80018e+18,96.1567,20245.9,45454,8344,111,45094,45094,45094,45094,45094
3951,74,170,3951,0,3951,0,5.99601e+18,149.817,740.446,3951,95,88,8863,8577,2362,2718,1617
44859,20154,25023,43349,1510,0,44859,1.28992e+18,91.8022,27246.4,44859,12155,110,25691,25691,25691,25691,25691
17215,4002,4045,0,17215,6049,11166,2.54042e+15,59.8671,5454.96,17215,1969,72,22867,22781,18592,17659,13118
11225,5207,6363,11225,0,11225,0,3.12529e+18,18.1744,6638.84,11225,5184,23,4862,4862,4228,4277,4035
19667,6893,7116,18709,958,0,19667,1.86454e+18,95.4675,8683.04,19667,3442,110,12551,12551,12451,12335,12473
41509,4,6,40212,1297,41349,160,0.000120456,0.999855,486.154,41509,6,1,3319,1241,555,1241,573
34526,10,14,33514,1012,34494,32,1.68823e+14,10.3865,567.503,34526,13,12,10139,4966,2747,2703,2280
18051,3475,5621,17099,952,17099,952,3.14546e+18,96.7404,7154.11,18051,2664,111,12430,12430,9452,9969,8175
22850,3996,5955,8147,14703,0,22850,9.56386e+12,59.5451,7671.83,22850,2901,72,28291,28291,22163,26926,13264
30695,7964,9133,11142,19553,0,30695,9.07465e+12,58.9985,11220.4,30695,4443,72,21562,21562,19836,21262,17896
43869,6425,19676,0,43869,0,43869,4.66877e+17,94.4634,22266.4,43869,9559,110,43022,43022,43022,43022,43022
25444,12,14,24687,757,25387,57,1.83472e+14,10.4927,532.928,25444,13,11,25430,25429,25309,25309,24865
8491,1635,2062,0,8491,2985,5506,2.51773e+15,59.4078,2878.91,8491,1000,72,8390,8390,7814,7750,5762
20296,278,1079,0,20296,0,20296,3.80188e+18,15.9922,1610.97,20296,781,26,23658,22890,13084,4190,0
521,42,358,501,20,501,20,4.849e+18,35.8944,418.419,521,129,35,113,24,14,37,0
33180,5933,10727,33180,0,31250,1930,4.90731e+18,231.11,12246.4,33180,2394,133,31421,31421,31421,31421,31421
22453,1121,6924,0,22453,8186,14267,2.28512e+15,58.7671,8534.13,22453,3367,72,15529,15448,9314,3155,1869
5769,66,1456,5433,336,5433,336,2.88675e+18,96.0962,2165.88,5769,668,92,3044,897,1748,2235,349
5408,601,1353,0,5408,1912,3496,2.51912e+15,58.8776,1930.86,5408,659,72,10312,10226,6357,5621,1505
22617,644,7655,0,22617,0,22617,5.61061e+17,93.8876,9449.3,22617,3688,110,24109,24109,8761,7629,3416
574,32,232,0,574,0,574,5.82377e+17,72.3659,343.063,574,80,32,168,25,80,103,45
8583,1937,2055,0,8583,0,8583,6.53816e+17,96.5652,3018.49,8583,980,107,6528,6528,6413,6387,6403
5959,103,186,5959,0,5959,0,5.9695e+18,169.379,938.482,5959,107,108,5247,3298,3069,3251,3208
46611,3,15,45284,1327,46529,82,1.38965e+14,10.5767,680.386,46611,13,12,10896,7983,7812,7674,7609
5628,1204,1400,1992,3636,0,5628,9.78315e+12,59.1038,1999.82,5628,678,72,4228,4228,3966,4180,3806
49444,148,176,49422,22,49444,0,5.98368e+18,171.883,2634.35,49444,172,172,0,4946,5950,19984,863
38595,11,176,38488,107,38595,0,6.15759e+18,173.182,2421.98,38595,163,163,27338,924,0,4670,31
16295,7089,8347,6535,9760,0,16295,6.34068e+12,54.991,9305.77,16295,4060,72,7948,7948,7417,7849,6963
3249,6,11,3153,96,3244,5,1.75348e+14,10.4598,167.925,3249,11,11,3100,3057,2805,2639,2176
852,95,362,852,0,804,48,6.23534e+18,77.8521,500.808,852,116,43,481,123,238,356,255
14568,6312,7685,5863,8705,0,14568,6.13072e+12,51.5805,8545.58,14568,3725,72,6883,6883,6643,6833,6404
44129,10301,16025,16522,27607,0,44129,8.21735e+12,57.997,18610.2,44129,7804,72,31027,30952,30127,30570,28924
24916,1599,6038,23466,1450,23466,1450,2.51313e+18,98.0707,8136.4,24916,2849,111,13929,13929,1756,4092,1368
42468,10040,16113,40448,2020,40448,2020,5.18149e+18,96.221,18826.8,42468,7734,111,42094,42094,42094,42094,42094
10294,356,447,0,10294,9997,297,3.56578e+16,20.0352,1249.09,10294,64,26,9847,9847,9454,9483,8393
5404,5229,5404,0,5404,0,5404,524191,0,5404,5404,5404,1,0,0,0,0,0
46270,9623,13881,46270,0,43570,2700,4.96235e+18,320.532,16142.1,46270,4987,133,35320,35320,34606,34492,32018
49557,841,11587,0,49557,0,49557,6.47632e+17,97.9016,15286.6,49557,5622,110,44701,44701,37757,42503,33961
6541,1472,1593,6161,380,6161,380,3.37055e+18,95.9578,2386.46,6541,752,96,12359,12359,9371,6304,5308
3786,198,1338,3786,0,3566,220,4.73275e+18,89.7245,1728.7,3786,467,82,2448,2448,1030,1616,634
47213,1743,2014,13774,33439,13774,33439,1.74584e+18,15.9973,2835.98,47213,1080,25,47005,47005,47005,47005,47005
34172,4007,11436,32432,1740,32432,1740,4.19095e+18,96.7875,13858.3,34172,5468,111,22736,22736,16931,15448,9099
1395,27,378,490,905,0,1395,9.94367e+12,55.2659,589.659,1395,175,48,647,121,261,491,132
12192,3483,4891,0,12192,0,12192,5.1127e+17,93.8969,5943.28,12192,2358,110,39275,39275,0,0,0
4108,216,1071,1453,2655,0,4108,9.51143e+12,58.286,1542,4108,506,67,25377,25377,23169,2847,732
48549,1664,17564,48549,0,45989,2560,4.50371e+18,392.54,19851.8,48549,5068,140,38294,38294,35258,33182,12485
26418,11581,13658,0,26418,0,26418,3.45238e+15,17.926,14114.4,26418,12278,20,15684,15656,14734,15290,13721
5753,8,11,5587,166,5747,6,1.55489e+14,10.6965,218.769,5753,11,11,5629,5496,4524,4509,4854
21328,1,12,20717,611,21320,8,1.43918e+14,10.26,415.994,21328,12,11,7385,7385,7385,7385,7385
45446,9454,17416,43296,2150,43296,2150,6.33052e+18,96.1417,20259.9,45446,8356,111,35462,35462,35462,35462,34628
47924,7942,15315,17588,30336,0,47924,8.7775e+12,58.7178,18236.6,47924,7461,72,29462,29462,22539,20575,13871
5876,1138,2026,5876,0,5536,340,6.84951e+18,91.0291,2538.6,5876,702,98,3850,3850,3261,3576,2544
15639,3880,4446,14782,857,14782,857,3.19317e+18,96.5374,5884.26,15639,2137,110,11193,11193,10639,11024,9818
47404,7508,11097,44646,2758,0,47404,2.22661e+18,97.8932,14664,47404,5382,110,47221,47221,47221,47221,47221
20112,216,983,0,20112,19526,586,4.17004e+16,205.151,2866.19,20112,142,26,19336,18267,8209,1218,25
39203,94,274,39200,3,39203,0,5.64742e+18,234.063,1494.57,39203,270,34,29617,26570,9384,3431,733
32769,10,12,31837,932,32756,13,1.38895e+14,10.4009,514.17,32769,12,11,32642,32460,31615,31616,29221
16705,136,176,16635,70,16705,0,6.00924e+18,168.808,1553.78,16705,147,149,16561,16561,16560,16559,16559
49494,1795,19611,49494,0,47894,1600,4.80319e+18,5329.36,25557.7,49494,7359,153,48975,48975,48975,48975,48975
15029,174,849,0,15029,14592,437,4.23169e+16,138.049,2319.31,15029,119,26,14147,13991,12239,11411,5593
42850,3,16,41609,1241,42791,59,1.5624e+14,10.334,642.586,42850,12,12,26833,25474,24858,25121,24633
25130,1348,6698,23720,1410,23720,1410,3.24868e+18,97.1756,8792.95,25130,3238,110,17788,17788,15758,15445,14489
40280,10,16,0,40280,36917,3363,3.00217e+16,9.99223,659.635,40280,16,10,6732,1282,388,1459,1519
23955,464,1321,0,23955,23241,714,4.70939e+16,268.507,3968.81,23955,211,26,20206,20110,17318,14189,13988
28771,11243,13797,28771,0,21581,7190,4.59113e+18,305.017,15126.9,28771,5121,135,46757,46757,46757,46757,46757
18559,2370,6583,0,18559,6912,11647,2.13978e+15,57.8095,7893.71,18559,3202,72,11976,11976,8652,5225,4844
46420,10640,10871,0,46420,0,46420,6.48233e+17,97.8887,14377.4,46420,5273,110,35929,35929,35929,35929,35929
40308,13844,16456,38496,1812,0,40308,1.72401e+18,94.8295,19019.2,40308,7978,110,24286,24252,23404,24019,21493
12585,3010,3746,0,12585,0,12585,5.98492e+17,96.1524,4953.52,12585,1801,110,8839,8839,8089,7795,7550
11454,2222,3879,10867,587,10867,587,2.82912e+18,96.0484,4944.81,11454,1845,111,7575,7575,5851,6343,6160
22232,3191,5353,20932,1300,20932,1300,3.05238e+18,98.045,7278.54,22232,2519,111,47839,47839,47839,47839,47839
43165,1,14,41935,1230,43086,79,1.38726e+14,10.6143,647.071,43165,14,12,11072,11072,11072,11072,11072
19400,1124,8646,18580,820,18580,820,8.96384e+18,92.2906,10045.9,19400,4188,110,30637,30397,18617,7838,3618
30967,621,1062,0,30967,30438,529,2.54029e+16,3.73481,4083.84,30967,533,4,29905,29905,29860,29596,22383
27750,4906,11724,26530,1220,26530,1220,8.63439e+18,94.694,13612.6,27750,5688,110,16026,16026,15316,15316,7703
37922,171,1090,0,37922,36840,1082,3.55443e+16,227.853,3680.24,37922,167,26,21957,20133,12738,16056,7683
37185,22,61,37121,64,37185,0,2.33246e+18,60.8112,1436.04,37185,61,61,35079,32672,26783,24623,6531
39000,2275,9936,13864,25136,0,39000,9.62451e+12,59.7205,12593.2,39000,4840,72,30578,30578,16670,10881,9175
31095,4426,9522,31095,0,29282,1813,5.50145e+18,206.018,11193.9,31095,3476,130,21573,21543,17567,19750,10721
25891,3539,13386,0,25891,10399,15492,1.59546e+15,55.3023,14746.8,25891,6507,72,22132,22132,21908,22046,25553
17460,5895,6035,6479,10981,0,17460,8.46316e+12,57.6565,7302.96,17460,2923,72,33553,33553,29065,27868,22636
41619,6715,18828,39870,1749,39870,1749,8.39901e+18,95.0658,21252,41619,9059,111,22791,22791,11574,15110,10153
44375,74,176,44293,82,44375,0,5.97967e+18,169.855,2493.63,44375,171,171,23080,7265,10203,18132,2213
45514,1627,14003,0,45514,0,45514,5.85331e+17,96.7043,17192.1,45514,6793,110,46715,46715,46715,46715,46715
15042,5910,7383,15042,0,0,15042,8.75916e+17,17.9628,7732.96,15042,6637,20,7659,7659,6209,7264,6195
1741,331,655,1741,0,1636,105,7.02818e+18,85.8334,889.051,1741,226,55,1086,1086,856,982,751
39631,4699,14554,14879,24752,0,39631,8.16075e+12,57.9116,16913.7,39631,7085,72,25077,25077,17882,23843,9261
5473,1105,1314,0,5473,1921,3552,2.54226e+15,59.1023,1903.51,5473,637,72,4159,4159,3872,3946,3679
24726,972,1046,0,24726,0,24726,3.84028e+18,15.9886,1633.55,24726,1041,17,21472,21386,19186,18828,17693
29330,7610,8597,0,29330,0,29330,5.99625e+17,96.7715,10893.9,29330,4163,110,16460,16460,14800,13885,13485
23276,453,1322,0,23276,22584,692,4.77061e+16,255.224,3946.84,23276,213,26,16696,16435,9130,11659,5229
1323,8,13,1287,36,1261,62,1.37653e+14,10.3726,110.409,1323,13,12,1281,1252,1183,1160,1059
13618,3,10,13231,387,13612,6,1.39022e+14,9.96394,322.898,13618,10,10,31998,22550,27088,27721,13149
11180,325,467,0,11180,10861,319,3.53456e+16,20.0404,1316.92,11180,67,26,10713,10713,10383,10429,8119
41299,3136,16652,39409,1890,39409,1890,7.6193e+18,95.82,19227.6,41299,7998,111,40881,40881,40881,40881,40881
46906,156,208,46814,92,46906,0,6.05082e+18,203.725,2837.44,46906,187,188,44261,43660,38263,32401,17112
22098,2,12,21467,631,22090,8,1.44062e+14,10.263,424.587,22098,12,11,12825,9209,8468,9044,6390
39062,18377,21150,39062,0,39062,0,1.33378e+18,17.9186,21690.8,39062,19028,20,43725,43725,43725,43725,43725
35087,8167,13715,35087,0,33267,1820,4.73257e+18,295.617,15279.7,35087,5603,128,21372,21189,17125,19285,13015
27259,2219,6387,0,27259,9591,17668,2.53614e+15,59.9868,8417.98,27259,3111,72,29484,29484,29484,29484,29484
12404,3860,6938,12404,0,0,12404,8.94217e+17,17.672,7226.49,12404,6230,20,5466,5466,3050,4719,3038
32111,8066,9945,30423,1688,0,32111,2.0106e+18,96.5794,12364.8,32111,4820,110,31917,31917,31917,31917,31917
17187,7097,7984,16477,710,0,17187,1.57355e+18,93.769,9224.15,17187,3870,110,20168,20168,16654,14947,10970
16858,233,4931,0,16858,0,16858,6.00863e+17,95.4862,6444.08,16858,2375,110,11927,11755,4070,698,73
37427,6784,20601,0,37427,8070,29357,1.36239e+13,8.9919,20974.8,37427,18537,11,22398,21342,15745,16576,10624
14613,619,6501,5675,8938,0,14613,7.19672e+12,56.4033,7473.14,14613,3164,72,26265,26265,26265,26265,26265
7543,1305,1820,7098,445,7098,445,3.2428e+18,96.37,2695.94,7543,860,102,5723,5723,5213,5569,4515
41006,841,2046,0,41006,39786,1220,4.78814e+16,319.086,6548.16,41006,357,26,25210,24443,12312,7489,3044
43722,17330,17751,41750,1972,41750,1972,2.74681e+18,95.1191,20489.8,43722,8614,110,36221,36221,36221,36221,36221
44113,6246,11513,0,44113,0,44113,6.24942e+17,97.4508,14787.4,44113,5584,110,45992,45992,45992,45992,45992
14061,1980,4646,13341,720,0,14061,1.96036e+18,92.6861,5914.76,14061,2238,110,9415,9415,6990,6135,3500
21177,7595,13829,9009,12168,0,21177,4.49154e+12,53.2013,14736.2,21177,6715,72,20344,20344,20344,20344,20344
15970,1360,3797,0,15970,0,15970,6.48207e+17,97.3046,5330.55,15970,1825,110,40523,40523,40523,40523,40523
34232,6845,15679,32822,1410,0,34232,1.58004e+18,93.2035,17791.1,34232,7605,110,18553,18553,14545,12778,9080
36926,1081,8939,0,36926,13037,23889,2.50029e+15,59.8819,11518.5,36926,4341,72,36873,36744,36744,36744,36744
8565,1448,3972,3357,5208,0,8565,6.94121e+12,55.9122,4610.93,8565,1921,72,18848,18848,12966,13966,3689
7301,1976,2277,6911,390,6911,390,6.73357e+18,95.1218,3075.61,7301,1082,95,5024,5024,4847,4828,4447
36846,5411,9158,34736,2110,0,36846,2.18844e+18,97.5943,12033.1,36846,4442,110,27888,27888,21702,26490,13297
12559,176,4753,11959,600,0,12559,1.82537e+18,91.9745,5855.12,12559,2280,110,7806,7470,3167,2189,1118
45008,4980,15655,0,45008,0,45008,5.51513e+17,96.0852,18671.7,45008,7602,110,43089,43089,43089,43089,43089
19895,5,11,19313,582,19886,9,1.66452e+14,9.92722,412.739,19895,11,11,18388,16476,13901,13740,11144
12252,407,3025,11542,710,11542,710,4.54695e+18,97.422,4256.32,12252,1410,111,36396,36396,31424,33147,28663
26997,8076,9413,26997,0,26997,0,2.22518e+18,2671.78,11753.8,26997,7342,23,21716,21716,21716,21716,26267
9674,938,2840,3496,6178,0,9674,9.13001e+12,58.6984,3698.41,9674,1371,72,24842,24526,17568,17028,9840
49686,6305,15050,47056,2630,47056,2630,3.11744e+18,96.3142,18490,49686,7308,110,49057,49057,49057,49057,49057
26652,1243,8076,25239,1413,25239,1413,6.88711e+18,96.5573,10187.7,26652,3913,110,18576,18576,17456,16035,5114
1450,245,402,508,942,0,1450,9.37548e+12,55.5876,621.098,1450,181,49,1048,1048,889,1012,748
33380,75,175,33366,14,33380,0,5.98723e+18,167.697,2159.92,33380,163,168,23501,7333,12247,18118,2217
19897,3236,10187,0,19897,7969,11928,1.61712e+15,55.5344,11306.4,19897,4961,72,9710,9710,7005,4436,3968
35167,7575,9950,0,35167,0,35167,6.07715e+17,97.0351,12624.9,35167,4822,110,32427,32427,32427,32427,32427
20243,350,762,0,20243,19666,577,3.55287e+16,86.1681,2222.99,20243,101,26,15597,15453,13340,10794,10359
1572,8,10,1526,46,1572,0,1.38589e+14,9.54517,109.446,1572,10,10,9183,9158,9084,9082,8976
14642,3604,5318,5479,9163,0,14642,8.23606e+12,57.8101,6403.46,14642,2586,72,8378,8378,4946,5357,4399
15580,1020,3667,5473,10107,0,15580,9.92005e+12,59.8279,4972.27,15580,1786,72,38781,38781,38781,38781,38781
28183,74,176,28171,12,28183,0,5.98326e+18,169.659,1989.99,28183,160,167,35637,35500,35492,35480,35385
39443,8114,16854,39443,0,26776,12667,4.685e+18,398.036,18549.8,39443,4220,141,28405,28402,27936,28199,27688
35754,6198,8641,33694,2060,0,35754,2.20588e+18,97.6972,11474.3,35754,4182,110,25670,25670,19302,17797,12143
19686,2035,4603,0,19686,6925,12761,2.53631e+15,59.9256,6174.27,19686,2236,72,15083,15083,11468,10357,7024
49734,1551,1733,0,49734,48289,1445,4.03406e+16,302.281,5873.68,49734,296,26,49031,49031,49031,49031,49031
32946,6411,15970,31646,1300,31646,1300,4.67669e+18,94.455,17908.6,32946,7686,111,42865,42865,42865,42865,42865
49217,1917,3199,0,49217,0,49217,3.75075e+18,15.9964,4028.49,49217,1876,26,49181,49181,49181,49181,49181
31591,8881,11111,30021,1570,30021,1570,5.19326e+18,94.7459,13348.2,31591,5295,111,27397,27397,27397,27397,27397
26207,143,176,26197,10,26207,0,6.02511e+18,171.135,1977.27,26207,161,162,45908,45892,45878,45878,44355
42850,1652,10015,15067,27783,0,42850,9.86987e+12,60.0546,12957.2,42850,4866,72,34723,34723,22211,26657,15721
31585,60,176,31564,21,31585,0,6.05383e+18,172.535,2185.78,31585,163,165,24124,16128,14316,15596,15617
25920,446,8009,25920,0,24410,1510,4.55186e+18,169.621,9476.36,25920,3072,124,18661,18059,10155,5421,2260
43991,8847,10253,41428,2563,0,43991,2.23174e+18,97.8836,13616.6,43991,4973,110,29996,29904,27959,29327,24259
37456,4256,15171,14294,23162,0,37456,7.67109e+12,57.3141,17315.5,37456,7386,72,23143,23143,13916,15691,9766
30081,5093,9937,28551,1530,0,30081,1.95018e+18,93.9839,12186.5,30081,4800,110,24097,18131,13562,15655,9116
7941,562,2613,7941,0,7481,460,5.91784e+18,93.6919,3279.49,7941,718,113,5328,5328,3806,4509,1519
39840,661,1782,0,39840,38669,1171,4.48371e+16,304.421,5753.79,39840,305,26,46853,45005,37333,38875,18152
28420,43,208,28363,57,28420,0,6.11436e+18,198.8,2252.13,28420,166,166,17680,6641,6080,6676,5799
38088,11149,13263,0,38088,0,38088,5.52343e+17,96.0044,15906.3,38088,6436,110,32185,32185,32185,32185,32185
49720,13,15,48273,1447,49623,97,1.60971e+14,10.3987,752.668,49720,13,12,30997,25797,25918,28739,23784
32799,5777,8256,0,32799,11643,21156,2.47128e+15,59.7463,10573.3,32799,4022,72,39897,39897,39897,39897,39897
16203,3032,3942,15256,947,15256,947,3.66713e+18,97.8237,5457.72,16203,1858,111,47648,47648,47648,47648,47648
18746,1959,4433,0,18746,0,18746,6.50181e+17,97.4308,6160.84,18746,2141,110,14313,14313,11050,10202,7174
5026,8,10,4882,144,5023,3,1.40458e+14,9.84302,196.691,5026,10,10,4904,4847,4621,4620,4181
10837,6,10,10517,320,10832,5,1.79321e+14,9.95783,302.474,10837,10,10,10455,10231,8494,8071,7530
48418,13951,16588,45998,2420,45998,2420,7.33394e+18,96.1787,19800.5,48418,8056,110,31830,31830,31028,30894,28135
27262,856,6388,0,27262,9594,17668,2.53059e+15,60.0036,8422.53,27262,3110,72,21075,21075,7780,12971,5895
14785,4218,4512,13437,1348,13992,793,2.50367e+18,96.7305,5839.95,14785,2135,111,32142,32142,24181,30722,13892
32247,1,13,31316,931,32230,17,1.54682e+14,10.1756,525.686,32247,12,12,7295,7295,7295,7295,7295
47098,5210,12332,0,47098,16792,30306,2.43723e+15,59.6219,15412,47098,6006,72,36341,36341,31018,29670,22283
46498,5909,12029,43859,2639,43859,2639,2.14242e+18,98.0592,15374.1,46498,5707,111,28261,28261,21972,23873,12985
29318,13328,14171,0,29318,11603,17715,1.70559e+15,55.8722,15751.1,29318,6889,72,32116,32095,30616,27880,26995
48733,13479,14235,0,48733,17646,31087,2.33762e+15,59.1522,17296.8,48733,6930,72,34498,34498,34363,34262,34335
8025,1550,3322,0,8025,0,8025,4.99396e+17,93.603,4086.13,8025,1584,102,44910,44910,43878,43556,42535
30977,1809,15545,29804,1173,29804,1173,2.52895e+18,93.4605,17378,30977,7542,110,24188,24188,18410,21015,10036
41996,18376,19566,40276,1720,40276,1720,6.63848e+18,94.8683,21961.8,41996,9427,111,41775,41775,41775,41775,41775
48459,107,176,48371,88,48459,0,5.99454e+18,172.837,2638.95,48459,173,174,32517,17619,21677,19205,8120
44874,12,15,43575,1299,44784,90,1.56162e+14,10.3935,675.822,44874,14,12,11034,6457,5945,7197,6121
25305,114,208,25245,60,25305,0,6.22088e+18,199.143,2091.29,25305,151,157,14023,13410,4413,1985,0
43042,3562,14044,40822,2220,40822,2220,5.48258e+18,97.0165,16969.5,43042,6717,111,34466,34466,30270,29588,13217
9702,1,13,9414,288,9629,73,1.79266e+14,10.7086,321.919,9702,13,12,1748,1748,1748,1748,1748
30493,4961,10085,28943,1550,28943,1550,3.11817e+18,93.9262,12357.2,30493,4879,110,20408,20408,14698,17089,12329
6633,146,1672,6253,380,0,6633,2.20494e+18,95.9023,2466.35,6633,783,96,4961,4878,2981,2610,851
22331,6218,9295,0,22331,0,22331,4.93914e+17,94.6355,10909.5,22331,4495,110,31635,31635,30598,31635,19200
42180,762,1789,0,42180,40944,1236,4.38069e+16,301.824,5830.77,42180,304,26,42038,42038,42038,42038,42038
30671,8160,8802,0,30671,11071,19600,2.35801e+15,59.1418,10910.6,30671,4284,72,21869,21869,20982,20442,20117
29371,821,6852,0,29371,0,29371,6.51515e+17,97.7663,9297.02,29371,3319,110,28958,0,0,0,0
46325,7550,16344,17257,29068,0,46325,8.34724e+12,58.1798,19070.9,46325,7960,72,39025,39025,39025,39025,39025
44467,12765,17425,42407,2060,0,44467,1.77218e+18,95.3842,20248,44467,8469,110,32890,32890,32202,32158,32084
30277,450,1047,0,30277,29407,870,3.73675e+16,215.821,3351.17,30277,158,26,29230,28807,26658,26041,16502
529,290,322,509,20,0,529,1.57859e+18,45.4764,395.083,529,115,33,207,207,207,207,207
45018,5520,17446,0,45018,17058,27960,2.01947e+15,57.3367,19995.3,45018,8484,72,43690,44428,0,5964,11200
9633,1,10,9359,274,9628,5,1.3932e+14,9.94685,271.68,9633,10,10,2461,2461,2461,2461,2461
17289,2,11,16793,496,17276,13,1.42878e+14,10.1798,371.402,17289,11,11,0,0,0,18,0
47589,54,176,47494,95,47589,0,6.05945e+18,172.82,2689.06,47589,168,171,46857,46729,44557,44736,37625
28970,3101,6828,27288,1682,0,28970,2.22461e+18,97.6722,9246.22,28970,3304,110,17823,17649,13665,15080,8441
19261,2283,7464,19261,0,13442,5819,3.84015e+18,148.196,8486.17,19261,2921,124,41362,41362,41362,41362,41362
23165,92,175,23156,9,23165,0,5.98374e+18,166.673,1801.03,23165,161,157,20073,12377,11339,12050,12264
28012,4651,6610,26383,1629,26383,1629,3.35401e+18,97.6624,8963.48,28012,3191,110,46908,46908,46908,46908,46908
37802,7044,20019,36450,1352,0,37802,1.37274e+18,92.7416,22062.5,37802,9713,110,17783,17783,12812,11183,7012
10729,820,4642,8071,2658,10259,470,3.84705e+18,91.2978,5553.99,10729,2199,108,6087,5913,2567,3602,1842
33610,1884,13721,33610,0,31968,1642,4.80668e+18,302.45,15421.4,33610,4057,135,33247,33247,33247,33247,33247
5674,1064,1390,0,5674,0,5674,6.47428e+17,95.8072,2104.61,5674,648,90,15683,15602,9053,4892,4445
30195,5591,7055,0,30195,10618,19577,2.53435e+15,60.0181,9263.68,30195,3437,72,33447,33447,33447,33447,33447
19077,643,4706,0,19077,0,19077,6.39877e+17,97.3697,6442.59,19077,2274,110,14371,14371,9091,4695,2777
3016,5,6,2922,94,3016,0,1.86655e+13,5.96817,120.245,3016,6,6,2937,2715,2912,2912,2912
927,144,279,0,927,325,602,2.34683e+15,53.2783,433.75,927,122,41,648,648,490,403,418
45669,12706,14748,45669,0,43028,2641,4.59029e+18,312.446,16651.9,45669,3089,137,45369,45369,45369,45369,45369
4906,5,10,4764,142,4900,6,1.67015e+14,9.85202,201.949,4906,10,10,4532,4038,4089,3342,2620
3538,556,2172,0,3538,0,3538,3.46085e+17,48.4406,2488.07,3538,1017,61,1366,1366,399,198,0
49474,425,11524,0,49474,17392,32082,2.53111e+15,60.0805,14836.4,49474,5607,72,46607,46607,25272,23005,20881
9106,374,2199,0,9106,3209,5897,2.51486e+15,59.48,3060.57,9106,1066,72,7104,0,0,4606,2138
25495,7136,11270,25495,0,24317,1178,5.04714e+18,258.116,12628.3,25495,2831,133,23459,23459,19247,16996,14513
17761,859,1243,0,17761,17228,533,5.22429e+16,264.328,3542.95,17761,195,26,16518,16518,16075,16056,13875
6415,248,2189,6415,0,6037,378,4.78877e+18,91.603,2730.58,6415,772,102,4226,4226,1718,2740,820
15921,8504,8709,6475,9446,0,15921,5.86757e+12,49.5216,9603.75,15921,4220,72,12786,12786,12518,12648,12424
21104,4746,4962,19874,1230,19874,1230,5.86958e+18,97.5624,6861.09,21104,2398,110,25132,25132,19615,12952,12377
25797,3336,6102,24297,1500,0,25797,2.22543e+18,97.6219,8310.27,25797,2948,110,19695,19695,15972,15232,11597
20311,8423,20311,20311,0,20311,0,8.79566e+12,0,20311,20311,20311,1,33947,33947,33947,33947,33947
7681,2184,3413,7351,330,7351,330,2.6802e+18,93.1228,4124.48,7681,1635,91,4268,4268,4025,4221,4086
15772,152,175,15760,12,15772,0,5.98774e+18,165.098,1487.81,15772,148,146,15395,14953,13835,13869,13808
43616,379,2880,43616,0,41844,1772,2.60181e+18,17.9849,3695.2,43616,1781,24,42987,42987,42071,42169,39128
37076,1584,8727,0,37076,0,37076,6.48468e+17,97.7732,11655.5,37076,4232,110,44852,44852,44852,44852,44852
24785,5596,6898,0,24785,0,24785,6.12278e+17,96.924,8948.31,24785,3338,110,37362,40946,40946,40946,40946
20627,4982,6412,19547,1080,0,20627,2.0117e+18,96.2657,8136,20627,3088,110,14215,14215,13285,12773,12065
32601,484,1925,32601,0,31266,1335,2.49745e+18,17.9689,2630.31,32601,1345,23,26902,26672,23337,20720,18428
5186,1162,2874,5000,186,5000,186,1.02954e+19,86.8722,3328.07,5186,1381,74,2312,2312,2215,11473,11378
7519,837,1887,7089,430,7089,430,5.85161e+18,96.0185,2757.22,7519,892,100,8478,8478,8478,8478,8478
28110,6052,6603,0,28110,9880,18230,2.52135e+15,59.9557,8688.28,28110,3205,72,23024,23024,7342,9822,6343
19931,8,12,19343,588,19916,15,1.75712e+14,10.0996,420.365,19931,12,11,19582,19349,16417,16448,15191
20135,1460,6646,20135,0,18965,1170,3.4381e+18,150.169,7736.02,20135,2401,120,13489,13391,7363,9806,3474
48119,9870,12743,0,48119,17188,30931,2.43067e+15,59.5735,15863.6,48119,6208,72,47813,47813,47813,47813,47813
44468,2280,16524,16725,27743,0,44468,8.11012e+12,57.877,19095.6,44468,8049,72,44137,44137,44137,44137,44137
3798,1717,2098,3798,0,3645,153,4.12332e+18,90.9255,2422.31,3798,920,70,1700,1700,1497,1586,1580
19546,11,13,18967,579,19533,13,1.82139e+14,8.91272,421.155,19546,11,11,19533,19533,18479,18496,18165
33383,8442,17025,32134,1249,32134,1249,9.79536e+18,92.3488,18941,33383,8256,110,32047,32047,32047,32047,32047
26988,720,15410,26988,0,26988,0,2.45043e+18,17.8856,15833.3,26988,13854,20,23659,23659,0,0,0
30730,3064,12747,29360,1370,0,30730,1.7067e+18,94.1695,14809.2,30730,6186,110,17983,17983,11238,9487,5204
20923,79,175,20914,9,20923,0,5.98739e+18,166.262,1712.04,20923,152,159,20750,20630,20643,20621,20664
48936,13679,13740,17617,31319,0,48936,9.26709e+12,58.6507,16856.4,48936,6685,72,0,0,0,0,6982
48824,54,176,48739,85,48824,0,5.98221e+18,171.849,2617.85,48824,172,173,21107,4985,9867,17084,66
39785,680,13326,14699,25086,0,39785,8.57391e+12,58.4275,15787.3,39785,6488,72,28902,28902,23984,21011,18431
24506,4766,6655,23146,1360,23146,1360,6.41382e+18,97.037,8701.77,24506,3218,110,23305,23305,23305,23305,23305
14517,4871,6596,13907,610,13907,610,2.62894e+18,88.4939,7710.69,14517,3175,110,11220,11257,14753,14753,14753
27548,291,1241,0,27548,26743,805,4.25419e+16,261.205,3835.93,27548,197,26,39436,38904,25672,28464,10792
44831,5630,15569,42611,2220,42611,2220,3.07365e+18,95.9359,18577.2,44831,7548,110,27600,27600,15846,8076,5580
28947,1020,1281,0,28947,28102,845,4.24724e+16,257.881,3988.53,28947,203,26,27666,27666,27212,27206,24702
47069,6,16,45703,1366,46982,87,1.59333e+14,10.4051,697.098,47069,14,13,17282,11974,11525,11422,11432
13375,4669,5343,12757,618,12757,618,8.24416e+18,89.5917,6469.1,13375,2578,110,8032,8032,7884,7884,6682
1612,359,493,0,1612,0,1612,6.21617e+17,87.273,766.359,1612,206,52,1119,1119,1005,1035,986
1867,406,533,1758,109,1758,109,5.68929e+18,90.3251,839.995,1867,232,56,1334,1334,1255,1261,35173
3277,28,152,0,3277,3182,95,3.53582e+16,19.646,448.741,3277,38,26,33316,33006,25824,24651,6015
32995,9077,9192,31184,1811,31184,1811,6.38326e+18,97.0545,11746.7,32995,4450,110,23803,23803,23739,23738,23684
16599,3380,4790,15690,909,15690,909,5.46601e+18,97.0857,6264.16,16599,2264,111,31523,31523,18479,27708,8217
21650,7125,9346,20710,940,20710,940,8.75966e+18,91.7374,10892.3,21650,4518,110,12304,12304,12094,12094,10174
13481,2956,3235,12699,782,12699,782,5.77631e+18,97.0766,4581.93,13481,1543,110,10246,10246,10079,10057,9709
35554,1212,8777,33502,2052,33502,2052,2.6924e+18,98.1511,11521,35554,4149,111,44897,44876,43875,43437,34459
6672,2176,6672,6672,0,6672,0,8.79477e+12,0,6672,6672,6672,1,0,0,0,0,0
20563,134,176,20557,6,20563,0,6.00466e+18,169.968,1738.94,20563,149,156,19703,18459,15476,15783,15631
26622,3,11,25863,759,26609,13,1.38676e+14,10.1811,456.606,26622,11,11,4778,1297,885,1579,265
49413,21587,24217,49413,0,0,49413,8.77137e+17,17.9846,24865.8,49413,21787,20,29752,29752,29752,29752,29752
27703,1586,9049,27703,0,26093,1610,5.47063e+18,171.41,10382.1,27703,2724,128,18654,18469,10115,14215,3787
3160,125,170,3160,0,3160,0,6.01052e+18,145.582,662.259,3160,85,83,2885,2674,2273,2289,2274
6924,919,3398,0,6924,1520,5404,1.33859e+13,8.97371,3566.51,6924,3057,11,3526,3526,1557,3526,1334
45659,6,14,44357,1302,45577,82,1.38959e+14,10.4232,646.744,45659,13,12,43432,41961,39410,40154,36247
33334,7,12,32375,959,33314,20,1.48962e+14,10.2491,530.914,33334,12,11,20910,9629,6213,9093,3425
35671,11821,17707,14188,21483,0,35671,6.49951e+12,55.3416,19512.2,35671,8606,72,17964,17964,15271,17504,12217
25679,7611,9595,0,25679,9663,16016,2.06582e+15,57.7345,11250.7,25679,4658,72,26599,26599,26003,25727,25348
38898,33,176,38882,16,38898,0,5.98516e+18,172.251,2338.15,38898,171,170,26636,15131,19908,23467,12415
9538,2744,4176,9127,411,0,9538,1.659e+18,93.5114,5015.63,9538,2011,107,5362,5362,4297,3776,2861
33425,13,15,32440,985,33335,90,1.78578e+14,10.3802,625.091,33425,13,12,15903,12284,12198,12432,11426
5317,163,234,0,5317,5165,152,3.53715e+16,19.9144,680.205,5317,46,26,5083,5083,4922,4943,3959
40816,20909,23214,39476,1340,39476,1340,1.0667e+19,92.2242,25244.1,40816,11289,110,19311,19311,19140,19291,19266
27959,27313,27959,27959,0,0,27959,134213000,0,27959,27959,27959,1,23409,23409,23409,23409,23409
23398,8022,9968,23398,0,22278,1120,4.13671e+18,206.296,11245.3,23398,4296,128,17444,17444,15546,16550,12799
44320,9809,16915,16741,27579,0,44320,7.98076e+12,57.7049,19446.6,44320,8236,72,44187,44187,44187,44187,44187
22759,4703,5327,7994,14765,0,22759,9.8761e+12,59.9217,7089.97,22759,2582,72,17281,17281,14149,13002,9944
2481,8,11,2411,70,2481,0,1.42383e+14,10.6723,139.973,2481,11,11,2414,2332,2275,2263,1967
18239,298,7658,6999,11240,0,18239,7.49654e+12,56.9191,8851.31,18239,3723,72,15257,15257,10939,13049,7689
11441,46,4121,10874,567,10874,567,7.66326e+18,95.1087,5169.11,11441,1988,110,7748,1584,5264,6956,188
36701,8945,9699,0,36701,13100,23601,2.42871e+15,59.5389,12202.1,36701,4718,72,26294,26294,25076,24655,24394
18316,264,976,0,18316,17777,539,4.32283e+16,188.547,2798.57,18316,143,26,17242,17001,13101,13299,6300
48190,18256,31222,10411,37779,0,48190,2.23684e+13,5.52625,35799.9,48190,10412,13,38938,38938,38938,38938,38938
39783,6,16,38612,1171,39691,92,1.71724e+14,10.4643,648.713,39783,14,12,38775,38136,36675,34942,28512
26575,1391,1416,0,26575,25787,788,4.68924e+16,274.299,4310.52,26575,229,26,20411,20411,19020,18026,5745
23680,127,885,0,23680,23000,680,3.68808e+16,163.392,2682.12,23680,123,26,20187,19414,11236,18581,537
21060,586,779,0,21060,20458,602,3.55293e+16,100.11,2295.9,21060,104,26,20281,20179,18823,19061,16489
25457,2269,5993,8951,16506,0,25457,9.87445e+12,59.9291,7914.71,25457,2909,72,19464,19464,14084,18534,7595
34523,10,13,33524,999,34506,17,1.56102e+14,10.4089,551.35,34523,12,12,7710,4362,4203,4760,3304
18552,431,731,0,18552,18023,529,3.55394e+16,59.2394,2083.97,18552,95,26,17821,17777,15834,16026,11859
45543,195,1944,13287,32256,13287,32256,1.74578e+18,15.9963,2751.08,45543,1883,25,29524,28101,12327,10125,4416
45857,8522,18225,43757,2100,43757,2100,8.15455e+18,94.5683,21102.7,45857,8859,110,43387,43387,43387,43387,43387
27381,1343,7135,0,27381,9756,17625,2.44548e+15,59.5769,9119.49,27381,3476,72,20246,20246,13250,12889,4794
49745,38762,49745,0,49745,49745,0,2047.96,0,49745,49745,49745,1,48776,48776,48776,48776,48776
40672,12144,12677,0,40672,0,40672,5.82932e+17,96.6163,15579.8,40672,6156,110,31401,31401,31401,31401,31401
43570,1409,2617,8916,34654,0,43570,5.75071e+13,12.0027,3302.69,43570,1633,20,39886,39886,36194,38656,32472
20364,46,82,20303,61,20364,0,2.39798e+18,81.2412,1214.8,20364,82,82,11068,10616,483,10530,58
45943,448,1717,0,45943,44606,1337,4.13732e+16,293.257,5719.14,45943,291,26,28487,26980,12387,18507,1886
30463,8011,10417,0,30463,11292,19171,2.1696e+15,58.2744,12388.6,30463,5060,72,20046,20046,18473,17542,16728
11182,1304,2668,3935,7247,0,11182,9.87305e+12,59.6435,3677.76,11182,1293,72,8514,8514,6932,8179,4454
33183,2402,11422,31523,1660,31523,1660,7.35105e+18,96.0271,13804.1,33183,5537,110,29411,29411,26879,28008,25851
44840,10222,12037,0,44840,16042,28798,2.41452e+15,59.5016,14972.3,44840,5858,72,36057,36057,36057,36057,36057
44552,438,1212,0,44552,43281,1271,3.55161e+16,250.697,4209.57,44552,191,26,33681,33251,23446,17874,18002
14518,2809,3460,0,14518,0,14518,6.51666e+17,97.2459,4883.15,14518,1666,110,11058,11058,10186,9525,9455
3034,448,740,1069,1965,0,3034,1.00755e+13,58.5455,1124.39,3034,358,61,2294,2294,1869,2214,1532
14782,2071,4043,13961,821,0,14782,2.12551e+18,96.6536,5435.57,14782,1948,110,10612,10612,7845,9687,4768
19299,205,5359,18223,1076,18223,1076,2.83918e+18,97.3739,7025.6,19299,2539,111,17787,17637,7563,9547,1856
48103,1352,18595,18215,29888,0,48103,7.90926e+12,57.1243,21289.1,48103,9042,72,33628,33628,23945,15180,12631
606,241,347,606,0,576,30,3.46569e+18,68.2162,431.893,606,118,36,259,259,191,229,259
49197,413,1355,0,49197,47793,1404,3.61482e+16,271.354,4745.62,49197,219,26,46263,46263,42642,45617,38335
27640,489,903,0,27640,26852,788,3.55934e+16,167.726,2847.21,27640,130,26,31322,31322,10305,11379,3626
39669,5,6,38430,1239,39509,160,0.000126043,0.999849,477.936,39669,6,1,39663,39663,39663,39663,39663
20669,253,7126,20669,0,19496,1173,5.29618e+18,153.459,8221.87,20669,1688,127,27566,27338,22210,22693,11910
34042,128,176,33936,106,34042,0,6.19342e+18,170.845,2252.6,34042,156,155,27483,17136,13040,17154,8919
46671,4620,11200,43958,2713,43958,2713,2.40125e+18,98.3379,14623.9,46671,5304,111,33440,33440,27444,22219,20921
18938,5577,6033,6940,11998,0,18938,8.78942e+12,58.5199,7424.45,18938,2930,72,22485,22485,20829,21243,14270
48262,4623,16753,17941,30321,0,48262,8.41114e+12,58.2758,19597.5,48262,8153,72,43991,43991,43991,43991,43991
37457,6675,15697,35804,1653,0,37457,1.69226e+18,94.8493,18082.9,37457,7617,110,25810,25810,16381,15039,9577
40467,10536,18769,40467,0,38854,1613,4.72989e+18,2009.17,21356.6,40467,4891,140,25778,25778,23699,23256,15714
1943,396,503,678,1265,0,1943,1.01238e+13,57.0973,775.502,1943,243,54,1440,1440,1295,1410,1252
45475,10393,13151,16433,29042,0,45475,9.15078e+12,59.1712,16054.6,45475,6393,72,37021,37021,37021,37021,37021
7764,3,10,7544,220,7764,0,1.39614e+14,9.93174,243.721,7764,10,10,5906,4152,4881,4692,3364
23013,13,14,22332,681,22966,47,1.76556e+14,10.3592,489.521,23013,12,11,6867,1252,1822,602,149
14238,3084,6857,0,14238,0,14238,4.45599e+17,93.3355,7913.06,14238,3321,110,7381,7381,5588,4095,4047
12626,252,3555,0,12626,0,12626,6.12714e+17,93.1753,4787.63,12626,1707,110,9071,8985,2688,93,0
29115,61,176,29098,17,29115,0,6.075e+18,171.972,2106.52,29115,163,162,28916,28802,28791,28776,28818
24449,3573,10656,24449,0,23301,1148,3.90651e+18,237.652,11975.6,24449,4671,126,28646,28646,18126,20949,12197
6638,1403,2698,6638,0,6298,340,3.88921e+18,85.7785,3251.97,6638,1072,100,3940,3940,3114,3461,2696
19224,4604,10300,19224,0,18493,731,4.68987e+18,240.728,11343.6,19224,4742,124,8924,8821,6416,7599,4765
48351,2901,11300,45531,2820,0,48351,2.22983e+18,97.9157,14922,48351,5486,110,32006,32006,20073,11655,9264
49284,14,16,47838,1446,49212,72,1.72447e+14,10.4124,770.022,49284,13,12,48537,47869,40056,40050,23492
22834,661,6542,21594,1240,21594,1240,6.47097e+18,96.7482,8452.84,22834,3155,110,16292,16210,12765,10164,2647
36840,10738,12161,36840,0,34723,2117,5.15854e+18,259.685,13787.6,36840,3722,133,34862,34862,34862,34862,34862
3909,675,1740,0,3909,0,3909,4.84118e+17,91.4889,2179.79,3909,819,69,2169,2083,1057,454,753
20098,369,4697,7063,13035,0,20098,9.88765e+12,59.9519,6298.41,20098,2282,72,17408,17060,7961,7757,0
39283,10567,11344,14195,25088,0,39283,9.16625e+12,58.6877,13922.5,39283,5516,72,40640,40640,40640,40640,40640
42646,10062,10206,15042,27604,0,42646,9.7976e+12,59.9706,13119,42646,4961,72,32440,32440,32268,32410,32187
43851,4814,10275,0,43851,15420,28431,2.52847e+15,60.0512,13267.5,43851,4999,72,42093,42093,42093,42093,42093
20820,21,175,20808,12,20820,0,5.98284e+18,166.403,1708.06,20820,153,160,8431,1437,2236,2594,2391
43993,13680,14046,43993,0,41432,2561,4.92407e+18,309.725,15906.2,43993,5228,128,26078,26078,23560,25680,20601
25686,5265,11076,0,25686,0,25686,4.82473e+17,94.3958,12836.1,25686,5371,110,45764,45764,45764,45764,45764
28838,718,1065,0,28838,28009,829,3.83376e+16,218.766,3361.21,28838,161,26,27773,27773,25491,25893,22180
39833,7305,15018,15005,24828,0,39833,8.03057e+12,57.7664,17356.4,39833,7311,72,27588,27480,22038,24259,18098
21031,8,13,20431,600,20989,42,1.40008e+14,10.7926,444.905,21031,12,11,20549,20029,19017,19013,16590
10156,1019,3352,9636,520,9636,520,7.05858e+18,95.3061,4349.65,10156,1600,109,6804,6718,6064,5950,3442
23106,2587,5572,21763,1343,21763,1343,5.40508e+18,97.9962,7556.91,23106,2619,111,16811,16811,10760,15602,4195
41677,2840,9780,0,41677,0,41677,6.47226e+17,97.8546,13000.6,41677,4739,110,32690,32516,26768,29196,20549
35544,6774,8277,12494,23050,0,35544,9.89153e+12,60.0634,10804,35544,4028,72,20112,20112,13100,9569,6284
1040,25,341,381,659,0,1040,9.79476e+12,51.1327,503.618,1040,160,42,421,77,182,93,0
21611,7181,7377,20528,1083,20528,1083,7.45186e+18,95.6996,9101.6,21611,3573,110,14234,14234,14190,14193,13933
22551,161,175,22479,72,22551,0,5.98424e+18,166.12,1775.81,22551,160,157,22520,22520,22520,22520,22520
42504,9827,12893,42504,0,40032,2472,5.0418e+18,303.644,15013.4,42504,5080,128,42574,42574,42574,42574,42574
12060,170,516,0,12060,11716,344,3.56225e+16,20.0575,1437.96,12060,71,26,11544,11544,9152,9202,4947
13149,164,4836,4937,8212,0,13149,8.1917e+12,57.5029,5829.56,13149,2350,72,8313,8106,2946,6655,545
5118,54,1593,4839,279,0,5118,2.05821e+18,94.5537,2209.66,5118,756,85,2199,543,1577,1633,478
6735,275,1860,2413,4322,0,6735,9.51895e+12,58.7305,2520.24,6735,906,72,4875,4827,3031,4556,995
44498,60,176,44444,54,44498,0,5.99976e+18,172.76,2543.78,44498,171,173,42389,42145,32278,31518,18400
42198,11130,17866,42198,0,40328,1870,4.76356e+18,1392.14,20400,42198,5443,141,42019,42019,42019,42019,42019
5182,800,1326,4882,300,4882,300,5.86432e+18,95.5484,1988.19,5182,623,86,3856,3856,3532,3492,2605
4045,9,13,3928,117,4035,10,1.65475e+14,10.78,188.299,4045,12,11,3984,3942,3866,3866,3655
47042,8086,23054,0,47042,0,47042,3.42598e+15,17.9831,23686.7,47042,20736,20,46378,46378,46378,46378,46378
47492,7151,11046,0,47492,0,47492,6.49221e+17,97.9076,14624.2,47492,5360,110,29794,29794,20487,27117,10761
12994,920,3492,12267,727,0,12994,2.14097e+18,96.562,4765.88,12994,1673,110,9502,9502,6649,6139,3551
14571,654,881,13975,596,4439,10132,1.38083e+18,16.9753,1337.32,14571,606,19,13690,13690,12919,13072,11304
39369,2003,2360,0,39369,0,39369,3.76872e+18,15.9924,3098.43,39369,1620,18,42781,42781,42781,42781,42781
20172,6863,8810,0,20172,7802,12370,1.86275e+15,55.4239,10071.2,20172,4272,72,11362,11362,10484,9945,9650
39535,2609,9308,37242,2293,37242,2293,5.76839e+18,97.7881,12392,39535,4508,110,29618,29213,26990,27857,23842
20791,4260,4901,0,20791,0,20791,6.50032e+17,97.5194,6772.03,20791,2369,110,15785,15785,14189,15406,11970
6124,939,2808,5864,260,0,6124,1.61793e+18,92.6675,3402.2,6124,1347,92,3316,3161,2587,2205,1816
22678,4798,7403,22678,0,21353,1325,3.45289e+18,158.308,8579.19,22678,2492,129,24939,24843,16187,20279,11064
18042,5361,18042,0,18042,18042,0,2047.89,0,18042,18042,18042,1,0,0,0,0,0
7524,1150,2467,7524,0,7084,440,4.86131e+18,93.7803,3112.34,7524,930,109,5057,5057,3710,4145,2837
25471,3638,6075,0,25471,8981,16490,2.51511e+15,59.9012,7994.84,25471,2954,72,25702,25702,19235,13782,12118
39238,4,176,39179,59,39238,0,6.03503e+18,173.043,2422.22,39238,169,169,30334,25758,20992,20350,14209
38635,1750,9260,36385,2250,36385,2250,2.20939e+18,98.2923,12209.4,38635,4377,111,29982,29982,25675,22387,9116
15993,105,176,15943,50,15993,0,6.19815e+18,168.362,1552.91,15993,133,132,18244,13255,9445,9973,9660
15871,3749,3784,0,15871,0,15871,6.45256e+17,97.2251,5310.77,15871,1817,110,12087,12087,12069,12075,12084
928,198,309,0,928,0,928,6.69509e+17,82.1821,482.117,928,129,42,619,619,496,430,519
36533,4877,17389,14416,22117,0,36533,6.76457e+12,56.1989,19288.4,36533,8468,72,31092,31092,23454,18588,14357
11276,158,2667,10616,660,0,11276,2.23972e+18,97.0049,3851.1,11276,1274,110,8609,8609,2622,2409,1084
43081,1273,10011,0,43081,15137,27944,2.53329e+15,60.0599,12965,43081,4868,72,43002,43002,43002,43002,43002
38729,5478,13260,36791,1938,36791,1938,3.06183e+18,95.9676,15956,38729,6424,110,24743,24743,20245,17342,15383
8306,1,11,8067,239,8304,2,1.44533e+14,10.1631,255.262,8306,11,11,2037,2037,2037,2037,2037
24929,6249,9203,23719,1210,23719,1210,2.41464e+18,96.1773,11030.8,24929,4410,111,24747,24747,24747,24747,24747
27235,3180,11436,0,27235,10471,16764,1.91584e+15,55.9676,13069.7,27235,5559,72,24719,24719,24719,24719,24719
15237,507,641,0,15237,14801,436,3.55583e+16,20.0865,1773.03,15237,83,26,34380,34380,15126,22043,2760
33219,2135,15447,13038,20181,0,33219,6.90254e+12,55.2012,17240.1,33219,7503,72,17772,17772,10698,16562,2280
29557,2669,13933,29557,0,28296,1261,5.04532e+18,428.229,15518.7,29557,3539,133,24528,24528,21577,20915,18374
42271,7,14,41067,1204,42193,78,1.38763e+14,10.422,614.25,42271,13,12,5478,1260,491,958,100
33777,4185,7883,11865,21912,0,33777,9.88933e+12,60.0405,10302.8,33777,3839,72,21881,21750,16894,19241,14205
16869,2691,7020,6471,10398,0,16869,7.55148e+12,56.0512,8152.36,16869,3413,72,9849,9849,7696,9349,4500
42619,7845,17062,42619,0,40529,2090,4.40333e+18,440.417,19150.6,42619,6405,140,41251,41251,41251,41251,41251
33503,13184,15451,32126,1377,0,33503,1.57224e+18,92.1626,17518,33503,7503,110,25065,25065,25065,25065,25065
23949,3691,6918,0,23949,8649,15300,2.34216e+15,59.0364,8648.89,23949,3355,72,17031,21143,18240,15353,13240
32549,5931,11287,0,32549,12084,20465,2.15522e+15,58.208,13352.2,32549,5489,72,36599,36599,36599,36599,36599
42596,204,208,42508,88,42596,0,6.04625e+18,202.656,2706.29,42596,187,180,34643,38631,0,2486,1519
3108,48,170,3107,1,3108,0,5.97512e+18,144.937,656.191,3108,86,84,1905,920,746,893,855
4491,826,1187,4233,258,0,4491,2.1951e+18,94.8061,1777.53,4491,554,83,3304,3304,2908,2787,2544
44681,8704,14274,44681,0,42081,2600,3.80917e+18,310.894,16152.6,44681,4819,133,44196,44196,44196,44196,44196
8068,228,3068,7679,389,7679,389,2.07949e+18,92.7698,3855.66,8068,1447,105,5000,4848,92,1351,774
37323,4916,17161,37323,0,35861,1462,4.68716e+18,1726.08,19740.9,37323,4880,141,26567,26567,18671,25150,8347
36853,1802,14660,36853,0,29106,7747,4.72407e+18,332.292,16289.5,36853,5742,134,48712,48712,48712,48712,48712
19640,2826,8424,7580,12060,0,19640,7.37984e+12,56.7895,9673.35,19640,4091,72,11216,11216,7695,9945,3357
9172,2553,5330,9172,0,9172,0,2.51393e+18,17.7371,5564.03,9172,4782,20,3842,3842,1864,3842,1916
7970,330,2578,7970,0,7503,467,3.00543e+18,93.4695,3250.18,7970,963,110,5392,5392,2839,3646,992
22176,6018,9809,22176,0,21146,1030,4.47821e+18,220.354,11033.9,22176,4299,125,12367,12306,10126,11225,7694
35291,5759,9416,33323,1968,0,35291,2.13412e+18,97.2811,12145.1,35291,4563,110,48766,48766,48766,48766,48766
27075,170,1295,0,27075,26276,799,4.39877e+16,271.869,3982.22,27075,208,26,25350,25035,21230,17842,6290
15538,2056,6189,5912,9626,0,15538,7.82454e+12,57.2351,7270.53,15538,3015,72,9349,9349,5767,8731,1548
6435,1414,1666,6063,372,6063,372,1.21773e+18,96.2715,2426.55,6435,773,95,4769,4769,4769,4769,4327
38549,6814,11008,0,38549,0,38549,6.03506e+17,96.3904,13876.5,38549,5328,110,27541,27541,22754,20313,17084
49872,4057,11618,0,49872,17528,32344,2.52837e+15,60.0817,14955.8,49872,5650,72,44785,44785,42700,43852,42195
12083,3625,4021,12083,0,11375,708,3.04049e+18,94.5168,4808.18,12083,1427,119,8062,8060,7920,7967,7563
19227,1570,4505,0,19227,6756,12471,2.53281e+15,59.8934,6047.17,19227,2187,72,29772,29772,15440,23638,4798
46277,81,208,46218,59,46277,0,6.05766e+18,203.42,2829.53,46277,189,188,30239,12219,12299,19170,5565
41698,4865,9969,39268,2430,39268,2430,2.02524e+18,98.336,13105,41698,4716,111,29774,29774,25187,27261,18738
20162,7,8,19824,338,20098,64,9.86321e+13,3.99688,346.345,20162,6,4,2220,955,807,298,296
32055,34,176,32042,13,32055,0,5.98546e+18,169.754,2121.55,32055,169,167,8222,3859,5273,5974,3400
7930,2990,5338,3397,4533,0,7930,4.28379e+12,48.5122,5760.34,7930,2578,69,2592,2592,2409,2552,2269
47248,130,206,47166,82,47248,0,5.98457e+18,193.198,2677.28,47248,184,185,40524,30573,28189,30460,21245
6412,1433,3594,6192,220,0,6412,1.31486e+18,83.801,4124.65,6412,1710,80,2818,2818,1625,1628,1172
45785,14644,18596,17495,28290,0,45785,7.67889e+12,57.3295,21110.4,45785,9058,72,45349,45349,45349,45349,45349
45050,90,176,44959,91,45050,0,6.04588e+18,173.076,2606.09,45050,172,174,44813,44526,44539,44433,44484
18036,2519,4267,16986,1050,0,18036,2.22857e+18,97.4161,5950.25,18036,2054,110,13769,13769,11859,11073,8926
46699,401,2013,0,46699,45325,1374,4.4706e+16,312.983,6613.2,46699,349,26,35305,34961,18221,25500,9947
10712,217,2603,10092,620,10092,620,3.46564e+18,96.7793,3737.15,10712,1234,110,8650,7704,2756,4833,1146
44611,6899,18856,42651,1960,0,44611,1.68106e+18,94.6253,21575.5,44611,9150,110,37436,37436,32485,32745,23655
45895,13861,16519,43645,2250,43645,2250,3.17814e+18,96.4767,19472.6,45895,7921,111,45571,45571,45571,45571,45571
18258,5,15,17712,546,18201,57,1.97023e+14,10.383,461.077,18258,13,11,16934,15539,13280,12829,5757
29776,4891,11355,29776,0,28196,1580,5.30335e+18,214.572,12728.5,29776,4491,128,26258,26258,26258,26258,26258
37578,5428,8783,0,37578,0,37578,6.48701e+17,97.8227,11752,37578,4258,110,22548,22500,12921,13469,9927
4925,1408,3520,0,4925,2142,2783,9.71197e+14,38.1094,3792.34,4925,1692,59,1405,1405,816,84,342
39974,106,9305,0,39974,14050,25924,2.53079e+15,60.0561,12082.7,39974,4528,72,28199,21946,20682,23457,18448
14654,1,3,14196,458,14590,64,0.000136482,0.999795,204,14654,3,1,14651,14651,14651,14651,14651
11677,1362,5302,0,11677,0,11677,4.67093e+17,89.6679,6255.34,11677,2557,110,6375,6375,3811,3362,2265
39713,9179,15488,0,39713,15060,24653,2.01458e+15,57.5789,17782.3,39713,7545,72,18369,18369,10503,10862,9906
14974,1218,7294,0,14974,0,14974,4.38578e+17,89.0883,8385.06,14974,3528,110,8735,8649,5630,5066,1914
48132,1214,1376,0,48132,46422,1710,1.14617e+16,7.94663,7479.43,48132,350,10,48114,48114,48114,48114,48114
21227,2975,5159,20005,1222,20005,1222,5.83187e+18,97.3615,7050.36,21227,2482,110,16068,16068,14724,14513,9600
4647,66,220,0,4647,4513,134,3.60211e+16,19.646,629.24,4647,43,26,4427,4427,3905,3915,1871
49995,14,176,49908,87,49995,0,6.03505e+18,173.979,2734.95,49995,175,173,18643,14836,14517,14953,14381
14318,1670,7063,14318,0,13691,627,5.74041e+18,154.786,7852.11,14318,1598,124,7255,7119,4890,5553,2174
49531,5431,21562,0,49531,0,49531,4.77928e+17,94.1993,24463.8,49531,10482,110,28009,28009,20947,25313,12889
2103,152,170,2103,0,2103,0,5.96581e+18,131.135,538.437,2103,77,67,1924,1890,1805,1801,1792
18277,2773,4912,6543,11734,0,18277,9.46321e+12,59.3626,6341.41,18277,2388,72,13365,13365,10742,12816,6475
23274,1575,8205,22114,1160,22114,1160,4.34177e+18,96.3414,9974.49,23274,3914,111,33315,33315,15377,25326,5715
47756,689,12076,16950,30806,0,47756,9.62647e+12,59.7562,15223,47756,5872,72,28725,28293,18022,26866,5477
10631,797,3637,10631,0,10018,613,4.13773e+18,92.2227,4362.35,10631,1294,117,6994,6994,3842,5209,1943
19739,6253,6853,0,19739,7329,12410,2.1624e+15,58.0984,8239.73,19739,3334,72,12886,12886,12154,11289,11104
30553,88,176,30468,85,30553,0,6.07947e+18,172.657,2161.24,30553,160,164,19280,11248,11823,14719,7167
46374,12,16,45016,1358,46289,85,1.69823e+14,10.4288,739.911,46374,14,12,22385,18158,18333,21207,16513
11559,2244,2757,0,11559,4066,7493,2.52964e+15,59.6492,3789.94,11559,1341,72,9629,9629,9629,9629,9415
1128,369,450,1128,0,1058,70,5.62963e+18,81.5301,620.666,1128,149,48,678,678,634,659,3113
27870,950,1233,0,27870,27056,814,4.22055e+16,245.057,3824.69,27870,194,26,26637,26637,26133,26005,23270
35067,4720,15665,33587,1480,0,35067,1.61478e+18,94.2829,17847.9,35067,7596,110,27189,27189,23192,18874,18414
12755,77,176,12744,11,12755,0,6.1211e+18,163.183,1399.21,12755,123,131,10511,7518,5738,5927,5934
8461,2453,2912,8461,0,7971,490,5.07752e+18,91.9497,3546.25,8461,1037,114,5549,5549,5265,5424,5002
17007,4433,6594,0,17007,6428,10579,2.02618e+15,57.4311,7773.51,17007,3207,72,16808,16808,16808,16808,16808
5671,2715,3291,5481,190,5481,190,2.23211e+18,78.6373,3757.53,5671,1574,72,2380,2380,2375,2380,2380
34689,250,8100,12190,22499,0,34689,9.88642e+12,60.0054,10571.2,34689,3938,72,24933,23963,6658,14169,101
7078,3390,3646,2830,4248,0,7078,6.24035e+12,54.8493,4160.93,7078,1760,72,3432,3432,3098,3372,2856
33485,5646,8037,31535,1950,31535,1950,2.3328e+18,98.2694,10679.1,33485,3804,111,30030,30030,30030,30030,30030
26567,6069,6218,25017,1550,0,26567,2.23235e+18,97.6801,8482.12,26567,3004,110,20296,20296,20080,20040,19968
5425,1094,2260,5175,250,5175,250,2.83352e+18,86.8846,2832.83,5425,1073,83,3165,3165,1736,2338,1400
8830,432,4475,8490,340,0,8830,1.46692e+18,91.7822,5195.58,8830,2145,95,4355,4097,2364,2077,1728
24303,12,176,24245,58,24303,0,6.17242e+18,169.148,1914.59,24303,145,143,10353,1905,2131,2286,2137
44513,7174,12334,42070,2443,0,44513,2.10245e+18,97.1727,15576.1,44513,5979,110,28208,27686,23595,25731,18907
46190,14398,14748,46190,0,43507,2683,4.97043e+18,320.704,16672.7,46190,5110,133,31575,31575,29262,30226,28606
6714,1881,3858,2758,3956,0,6714,5.56554e+12,48.3789,4310.93,6714,1856,70,2856,2856,2289,2736,1534
45817,17756,17955,45817,0,43477,2340,4.63466e+18,452.367,19911.3,45817,5009,140,31356,31356,31356,31356,31356
39616,1734,2434,12124,27492,12124,27492,2.01716e+18,15.9924,3174.19,39616,1628,18,39346,39346,39346,39346,39346
37906,9,12,36824,1082,37887,19,1.40225e+14,10.2346,552.248,37906,11,12,6631,2162,814,25,37
42950,14109,15800,40888,2062,0,42950,1.84019e+18,95.7276,18635.8,42950,7674,110,28760,23791,24373,26039,20089
29863,7633,12982,29863,0,28465,1398,4.25134e+18,273.12,14507.4,29863,5724,128,16881,16768,13640,14840,11014
27489,17561,27489,0,27489,27489,0,2047.93,0,27489,27489,27489,1,22306,22306,22306,22306,22306
5538,22,252,0,5538,5379,159,3.58857e+16,19.9281,724.334,5538,47,26,5266,4892,4237,4218,1096
27187,2595,6384,0,27187,9561,17626,2.52693e+15,59.9342,8410.45,27187,3101,72,376,376,0,319,0
15994,842,931,0,15994,15526,468,4.41518e+16,182.385,2586.64,15994,134,26,15063,15063,15010,14984,14695
42377,1823,19284,42377,0,30700,11677,4.74404e+18,2476.58,22283.9,42377,5116,141,34531,34531,32927,31785,17583
4056,354,1292,3839,217,0,4056,2.04014e+18,93.6827,1811.93,4056,609,78,2764,2678,1951,1822,1352
22138,4210,6167,20920,1218,20920,1218,6.51074e+18,96.8752,8047.84,22138,2980,110,24157,24157,20612,18754,14344
44182,1080,1903,44182,0,42344,1838,2.65458e+18,17.0513,2722.04,44182,1802,28,37620,37620,25843,21987,20893
21012,720,10986,8460,12552,0,21012,6.19708e+12,55.3455,12127.4,21012,5352,72,10026,9649,6064,9348,1486
9792,9,11,9515,277,9784,8,1.39387e+14,10.8776,277.38,9792,11,11,25253,24912,21980,20174,20134
12322,441,2912,0,12322,0,12322,6.51909e+17,96.9877,4174.51,12322,1391,110,9410,9410,6043,1381,2045
13419,1937,3171,0,13419,4719,8700,2.52741e+15,59.8121,4338.54,13419,1541,72,10248,10248,8754,6859,6391
11615,3247,4354,0,11615,0,11615,5.33494e+17,94.7732,5398.79,11615,2098,110,7261,7261,6323,19736,19206
3293,787,852,3103,190,3103,190,5.7419e+18,93.6025,1330.03,3293,388,72,28775,28631,13311,10856,2414
46890,8019,11191,44160,2730,44160,2730,4.10529e+18,98.3598,14634,46890,5296,111,31982,31982,30864,30864,18032
18059,5826,7974,0,18059,0,18059,4.74616e+17,94.1594,9308.44,18059,3859,110,10085,10085,9333,9359,8425
9087,690,3917,9087,0,8629,458,6.22504e+18,102.311,4529.74,9087,897,110,5170,4982,1858,3317,804
42316,1235,9894,14880,27436,0,42316,9.88719e+12,60.0604,12799.6,42316,4819,72,48991,48991,48991,48991,48991
13890,966,4548,13173,717,0,13890,1.97062e+18,93.7005,5807.37,13890,2191,110,9342,9342,5440,4593,2638
40163,6916,12868,40163,0,37823,2340,4.33068e+18,285.304,14610.3,40163,4769,125,32098,32098,30666,31848,29046
24341,5,11,22355,1986,24188,153,1.14725e+14,8.43269,415.499,24341,11,9,21042,18411,14950,15436,18388
19923,6025,10634,19211,712,0,19923,1.36725e+18,92.7502,11884,19923,5159,110,9289,23437,21619,21449,20492
31954,9642,12673,31954,0,30344,1610,4.43204e+18,228.309,14282.4,31954,5379,129,24923,24923,15287,17017,12053
19256,299,1277,0,19256,3921,15335,1.4643e+16,12.0066,1729.68,19256,617,20,17979,17979,11880,6513,13382
18045,18,175,18039,6,18045,0,5.98184e+18,165.599,1590.56,18045,145,156,6740,3772,4114,4680,3071
30686,3486,13467,29376,1310,0,30686,1.63634e+18,92.7899,15462.8,30686,6528,110,40420,40420,40420,40420,40420
24447,4359,8742,23247,1200,0,24447,1.87559e+18,94.317,10599.2,24447,4223,110,15705,15705,12596,12051,9169
47462,976,1269,0,47462,46111,1351,3.55658e+16,260.254,4452.3,47462,202,26,46275,46275,45926,45905,44326
6413,9,13,6230,183,6381,32,1.49055e+14,10.9152,249.841,6413,12,11,6308,6225,5990,5702,5213
23352,5356,6690,0,23352,0,23352,6.05366e+17,96.7813,8632.52,23352,3234,110,26530,26530,18039,24907,7317
5711,1,11,5545,166,5705,6,1.6575e+14,10.4017,220.652,5711,11,11,1176,1176,1176,1176,1176
17484,5029,11018,7361,10123,0,17484,4.76065e+12,53.5342,11840.2,17484,5352,72,6466,6466,4880,6086,2918
30613,4288,7376,28833,1780,28833,1780,6.03967e+18,98.1927,9840.29,30613,3487,111,23237,23237,16316,18504,14534
2476,3,13,2405,71,2416,60,1.3835e+14,10.7157,144.706,2476,12,12,1893,1329,1574,1504,967
26477,1063,6266,24940,1537,0,26477,2.2235e+18,97.601,8517.8,26477,3024,110,26001,26001,26001,26001,26001
21069,2471,5102,19847,1222,19847,1222,5.00345e+18,97.9048,6951.16,21069,2399,111,15967,15967,13920,15401,8655
22785,5019,5412,21458,1327,0,22785,2.22563e+18,97.5803,7414.91,22785,2616,110,23390,23390,15249,13598,5989
33003,2065,13031,33003,0,31340,1663,4.27727e+18,234.448,14686.1,33003,5107,132,19972,19564,11170,14561,4684
19798,5527,7847,7525,12273,0,19798,7.80689e+12,57.3651,9159.57,19798,3821,72,19594,19594,19594,19594,19594
46140,1,15,44802,1338,46044,96,1.58764e+14,10.463,704.829,46140,13,13,1838,1838,1838,1838,1838
25426,2616,5994,8940,16486,0,25426,9.84769e+12,59.9068,7914.81,25426,2906,72,19432,19432,14568,18592,8727
14355,359,444,0,14355,14135,220,2.46266e+16,3.73445,1748.75,14355,223,4,13911,13911,13903,13852,12418
12394,357,3062,11674,720,11674,720,3.43035e+18,97.4484,4300.43,12394,1430,111,9332,9332,4418,5588,1554
29164,4265,9028,27623,1541,27623,1541,3.80019e+18,97.073,11234.2,29164,4292,111,17605,17605,13036,14676,10538
19212,8904,11888,18652,560,18652,560,2.16226e+18,91.3747,12942.8,19212,5769,110,23300,23300,23281,23270,23061
48031,3896,18965,48031,0,45938,2093,5.02926e+18,2770.13,22471.1,48031,7948,152,47331,47331,47331,47331,47331
21540,133,176,21530,10,21540,0,6.04668e+18,170.974,1805.66,21540,155,152,27825,27551,19659,18591,6520
34868,5349,17003,33497,1371,33497,1371,8.58953e+18,93.8145,19012.9,34868,8194,111,32922,32922,26560,25185,18552
15769,163,176,15757,12,15769,0,6.09336e+18,169.829,1554.07,15769,135,138,15500,15354,14552,14468,14526
26615,5390,6385,25065,1550,25065,1550,4.04862e+18,98.1157,8600.75,26615,3012,111,20230,20230,18373,18789,17689
7394,924,2896,7044,350,7044,350,7.40925e+18,94.6124,3629.88,7394,1378,92,4498,4411,3164,3560,2667
29082,4790,6818,10222,18860,0,29082,9.87013e+12,59.9783,8960.01,29082,3316,72,28975,28975,28958,28957,11297
32458,4504,7618,0,32458,0,32458,6.48153e+17,97.7492,10262.1,32458,3688,110,26565,26565,22551,20862,15731
34520,5532,10286,27784,6736,32660,1860,5.63512e+18,97.3691,12826.1,34520,4896,111,30521,30521,26434,29624,18609
9571,2928,5315,9571,0,9211,360,4.17704e+18,139.048,5924.96,9571,2389,105,4256,4169,3509,3893,3234
45287,83,176,45220,67,45287,0,6.06918e+18,172.131,2630.23,45287,173,170,24830,8128,17111,13912,2119
14777,1513,3536,0,14777,0,14777,6.47187e+17,97.1725,4978.33,14777,1701,110,11241,11241,8481,6986,5285
42351,6478,24577,40999,1352,40999,1352,1.09596e+19,91.0816,26620.2,42351,11934,110,18107,18107,14123,12687,9635
44678,13059,13499,42308,2370,0,44678,2.02987e+18,95.8381,16662,44678,6552,110,31584,31584,29139,30634,25715
38250,18768,19592,36830,1420,0,38250,1.42242e+18,91.2277,21714.7,38250,9504,110,20612,20612,20612,20612,20612
9741,1559,6035,4090,5651,0,9741,4.99832e+12,51.4978,6579.34,9741,2934,72,3706,3706,2202,3448,637
47049,105,176,46972,77,47049,0,5.98123e+18,171.949,2570.33,47049,172,173,38451,37791,32934,36763,26097
17369,189,4084,0,17369,6103,11266,2.52842e+15,59.8428,5507.48,17369,1984,72,24066,22303,7757,6250,1674
25958,19,176,25909,49,25958,0,6.05899e+18,171.874,1985.17,25958,154,162,10107,1986,2758,2674,2610
19945,8309,8451,19065,880,19065,880,1.82885e+18,93.9047,9892.25,19945,4054,111,11494,11494,11494,11494,11359
31852,13387,17380,12954,18898,0,31852,5.86569e+12,52.8321,18905.5,31852,8444,72,34163,34163,34163,34163,34163
9933,96,175,9927,6,9933,0,5.97945e+18,161.561,1182.01,9933,128,126,8688,5439,5162,5406,5584
17938,269,4707,16927,1011,0,17938,2.15792e+18,96.9815,6336.9,17938,2269,110,13231,13145,4860,3695,1679
17855,8,14,17332,523,17812,43,1.76925e+14,10.547,423.821,17855,12,11,5597,1438,1344,895,1097
23844,4484,5979,8454,15390,0,23844,9.66398e+12,59.6873,7774.56,23844,2907,72,17865,17865,16130,17497,13361
3272,236,848,3082,190,3082,190,5.85282e+18,93.702,1321.33,3272,390,72,2424,2424,2215,2098,923
27977,84,175,27902,75,27977,0,5.98722e+18,167.138,1977.89,27977,159,164,43327,42838,27695,28396,8063
7001,942,1688,6591,410,0,7001,2.23875e+18,96.2261,2522.21,7001,800,98,5313,5313,4320,4189,3427
20707,10,14,20097,610,20663,44,1.71547e+14,10.3654,465.33,20707,13,11,20649,20570,17834,17866,15208
32999,5,14,32058,941,32923,76,1.38891e+14,10.7862,564.635,32999,13,12,3234,938,166,890,65
18392,249,1213,0,18392,17840,552,5.03095e+16,253.939,3476.35,18392,188,26,17006,16558,11885,12805,4911
38028,1085,1093,0,38028,36945,1083,3.55437e+16,228.158,3691.82,38028,167,26,38001,34816,27577,29135,22912
20553,3336,8192,20553,0,20553,0,4.04629e+15,4926.84,12910.3,20553,8192,3,6670,21690,14754,20500,6499
36427,11,15,35351,1076,36335,92,1.74663e+14,10.4309,638.531,36427,13,13,5174,1072,574,1136,149
43186,113,10088,15182,28004,0,43186,9.87165e+12,60.0637,13049.2,43186,4909,72,41507,41287,33505,32836,21949
5120,211,283,0,5120,4973,147,3.80977e+16,19.6289,761.579,5120,50,26,27396,26847,10536,17273,1179
37308,7,61,37212,96,37308,0,2.2574e+18,60.7156,1438.94,37308,61,61,8311,305,11,667,3724
11772,3552,5786,11772,0,11262,510,3.81178e+18,129.728,6533,11772,2542,114,5986,5986,4659,5079,3768
42601,8611,9946,14984,27617,0,42601,9.88755e+12,60.0716,12872.8,42601,4842,72,33796,33796,33737,33787,33368
40749,8832,9466,0,40749,14323,26426,2.53773e+15,60.0722,12286.2,40749,4611,72,40492,0,0,2991,2991
29405,2083,9244,0,29405,0,29405,5.81067e+17,96.4344,11492.5,29405,4481,110,18756,18756,11908,9279,3149
16584,146,1024,16584,0,15907,677,3.18404e+18,17.9563,1521.36,16584,379,23,15560,15560,14220,14405,6062
46891,14,17,45515,1376,46816,75,1.72129e+14,10.4684,745.248,46891,14,12,25665,27634,27634,27634,27634
8830,2982,3849,0,8830,3416,5414,1.8713e+15,56.3092,4524.3,8830,1866,72,4981,4981,4188,3112,3002
17308,132,175,17234,74,17308,0,5.98603e+18,165.535,1557.73,17308,152,149,16515,15504,12945,13315,13250
48972,5353,18034,46602,2370,46602,2370,2.34949e+18,95.562,21108.3,48972,8649,111,36858,36778,33143,34576,29242
48842,16747,19760,0,48842,0,48842,5.04228e+17,95.1977,22749.3,48842,9607,110,36189,36189,36189,36189,36189
25655,2,14,24914,741,25583,72,1.52768e+14,10.5439,502.748,25655,14,12,14737,11224,11896,11286,8953
39937,1277,1453,0,39937,38778,1159,4.01236e+16,284.049,4793.82,39937,239,26,35323,35323,21574,32953,4739
8422,3434,4807,1806,6616,0,8422,53502300000,8.9715,4973.49,8422,4318,11,3615,3615,2788,3615,2755
45319,6204,12764,42827,2492,42827,2492,3.50604e+18,97.6939,15961.9,45319,6066,111,32174,32174,29794,31052,23739
29799,514,10437,28309,1490,28309,1490,2.23028e+18,96.517,12573.3,29799,4994,111,17090,16058,12742,10022,2209
35578,575,1989,10740,24838,10740,24838,1.99977e+18,15.9909,2691.73,35578,1471,18,30861,30780,24956,22477,21497
41379,11784,12775,0,41379,15096,26283,2.28024e+15,58.4125,15402.4,41379,6217,72,31485,31485,31485,31485,31485
11034,376,465,0,11034,10721,313,3.54149e+16,20.0092,1307.04,11034,66,26,10569,10569,10398,10413,9075
21082,4905,11723,20362,720,20362,720,3.99955e+18,93.1569,12969,21082,5655,111,14568,14568,12304,10995,8653
26913,7422,8294,25497,1416,25497,1416,6.95806e+18,96.4834,10408.5,26913,4018,110,26740,30820,24261,29378,14568
22739,8,128,0,22739,20854,1885,2.9791e+16,10.0541,615.897,22739,124,11,20430,17093,15351,15516,17165
31179,8024,9516,31179,0,29361,1818,5.36005e+18,207.727,11190.1,31179,3098,130,21663,21632,20914,21607,18842
39864,2992,14227,39864,0,37734,2130,4.026e+18,327.231,16212.4,39864,5969,132,43473,43473,43473,43473,43473
30522,4,176,30512,10,30522,0,5.98343e+18,169.744,2070.52,30522,162,166,3547,709,13,2080,28
43634,13466,18615,16828,26806,0,43634,7.39588e+12,57.0023,20970.6,43634,9065,72,32028,32028,32028,32028,32028
7645,6945,7645,7645,0,0,7645,7.99895,0,7645,7645,7645,1,0,0,0,0,0
6695,1,11,6506,189,6694,1,1.39623e+14,10.2695,229.874,6695,11,11,1706,1706,1706,1706,1706
20167,4819,13067,17877,2290,0,20167,2.45112e+18,5.51436,15013.3,20167,4358,13,7100,7100,5705,6106,3203
33204,1482,1824,31840,1364,9975,23229,1.44137e+18,16.9933,2526.6,33204,1369,27,28086,28086,22859,21796,17035
28171,6463,6926,26558,1613,0,28171,2.1972e+18,97.4834,9267.49,28171,3343,110,37462,37462,37462,37462,37462
26985,3103,6532,25417,1568,25417,1568,3.67335e+18,98.1047,8761.8,26985,3081,111,20453,20453,13929,15323,10645
27414,11699,12227,27414,0,26124,1290,4.74917e+18,254.663,13501.2,27414,2920,136,15187,15187,15187,15187,15187
836,134,261,290,546,0,836,9.31662e+12,51.3158,400.039,836,115,38,575,575,426,544,353
25239,7,14,24514,725,25165,74,1.44133e+14,10.5213,465.038,25239,13,12,8632,2935,1061,3812,694
2585,385,1303,2585,0,2467,118,7.2987e+18,67.6843,1573.21,2585,545,58,1282,1282,704,1080,0
42702,8,16,41454,1248,42605,97,1.68376e+14,10.4519,683.075,42702,15,12,40630,40366,40282,40505,0
46426,938,1843,0,46426,45067,1359,4.27509e+16,310.906,6099.95,46426,315,26,16400,13199,15068,16010,16131
8832,414,705,0,8832,8571,261,4.5395e+16,30.6958,1701.07,8832,89,26,8127,8115,7229,7350,4874
5586,264,1925,5306,280,5306,280,7.12029e+18,89.2261,2562.47,5586,901,90,3661,3553,2538,2366,243
23862,465,5979,0,23862,8455,15407,2.47814e+15,59.6996,7777.41,23862,2909,72,39599,39599,39599,39599,39599
49102,9,13,47700,1402,49081,21,1.38685e+14,10.3172,633.695,49102,12,12,48811,48547,44177,44037,38345
7126,153,1670,0,7126,2506,4620,2.56259e+15,59.563,2393.25,7126,813,72,5456,5456,3209,434,632
33679,1115,7853,0,33679,11838,21841,2.53044e+15,60.0535,10271.6,33679,3821,72,30446,30446,24601,16238,4793
30928,1187,9438,11256,19672,0,30928,8.95163e+12,58.8653,11520.9,30928,4591,72,21490,21490,10536,17840,3962
44203,15976,18038,44203,0,42146,2057,4.86137e+18,1125.17,20522.7,44203,7354,143,37893,37893,37893,37893,37893
39060,11242,14214,0,39060,0,39060,5.38604e+17,95.7741,16858.3,39060,6900,110,29731,29731,29731,29731,29731
33234,143,13848,31757,1477,31757,1477,8.40468e+18,94.106,16029.6,33234,6716,110,34603,34592,34558,34552,34282
1650,381,651,0,1650,619,1031,2.13001e+15,54.5612,859.602,1650,316,53,999,999,799,731,748
14136,2711,5246,0,14136,0,14136,5.3546e+17,95.071,6460.58,14136,2531,110,8890,8890,7379,7373,5163
43707,1935,2226,0,43707,42401,1306,4.87523e+16,335.19,7141.05,43707,393,26,47298,47298,47298,47298,47298
47872,10248,11211,0,47872,0,47872,6.46409e+17,97.8716,14808,47872,5429,110,37616,37616,37616,37616,37616
28897,8012,8979,0,28897,10547,18350,2.27213e+15,58.7593,10940.3,28897,4360,72,25786,25786,25786,25786,25786
8333,1697,3180,3138,5195,0,8333,7.95023e+12,57.0958,3873.87,8333,1535,72,5153,5153,3627,4892,1924
16686,35,208,16673,13,16686,0,6.05909e+18,189.209,1707.12,16686,142,149,9550,1432,5046,3855,72
38127,3,15,37041,1086,38044,83,1.38822e+14,10.6344,610.829,38127,13,12,29117,20524,24188,23210,14939
19284,1813,4817,18167,1117,18167,1117,3.43675e+18,97.8344,6530.55,19284,2272,111,22049,22049,22049,22049,22049
8664,1710,2719,3170,5494,0,8664,8.91967e+12,58.4034,3490.85,8664,1324,72,5945,5945,4478,5688,2881
7909,799,2549,7678,231,7448,461,4.14851e+18,93.6324,3218.7,7909,950,109,5360,5360,3461,4141,2029
40971,7944,9514,0,40971,14397,26574,2.53638e+15,60.0794,12350,40971,4634,72,43841,43841,43841,43841,43841
4866,1714,1795,4866,0,4598,268,6.59087e+18,92.4151,2268.62,4866,696,89,3071,3071,3052,3069,3051
27991,3350,7126,26391,1600,26391,1600,1.6131e+18,97.9292,9391.12,27991,3370,111,20865,20865,16966,19228,10846
42479,2340,18161,0,42479,16387,26092,1.89023e+15,56.832,20461.1,42479,8829,72,36468,36468,25596,30637,9540
20614,411,4862,0,20614,0,20614,6.49319e+17,97.4519,6720.81,20614,2341,110,15752,15752,5543,1638,2336
45814,4639,18802,45814,0,44016,1798,4.6366e+18,3475.12,22752.3,45814,7490,146,27844,27844,18934,26344,8140
4375,232,267,0,4375,4251,124,3.94464e+16,19.5618,704.942,4375,47,26,4108,4108,4075,4070,3961
22806,78,176,22797,9,22806,0,6.0057e+18,171.039,1823.98,22806,159,158,18208,10759,9299,10280,10012
24892,107,175,24818,74,24892,0,5.97938e+18,166.81,1866.52,24892,163,161,19108,8291,7275,12570,1288
9268,47,176,9260,8,9268,0,6.09831e+18,163.17,1192.06,9268,115,113,6807,1474,3341,110,657
20799,208,771,0,20799,20204,595,3.55317e+16,93.1799,2269.31,20799,103,26,17192,16941,14499,10143,10458
44741,36863,44741,44741,0,0,44741,134215000,0,44741,44741,44741,1,19336,19336,19336,19336,19961
41526,8207,9939,39106,2420,39106,2420,3.27815e+18,98.318,13061.9,41526,4701,111,36426,36426,36426,36426,36426
31268,6213,8534,0,31268,11205,20063,2.40108e+15,59.1248,10712.3,31268,4140,72,30769,30769,30769,30769,30769
43272,969,1959,0,43272,41996,1276,4.55322e+16,313.842,6356.12,43272,338,26,28061,27285,11378,17929,2870
46697,1,16,45335,1362,46632,65,1.61102e+14,10.4182,706.921,46697,14,13,4139,4139,4139,4139,4139
49565,6984,13892,46855,2710,46855,2710,6.5832e+18,97.1837,17411.7,49565,6744,110,42394,42394,42309,42214,42184
40450,171,1143,0,40450,39298,1152,3.55959e+16,240.221,3897.33,40450,176,26,44804,44711,43367,43561,43271
15698,6,11,15242,456,15688,10,1.58865e+14,9.99025,363.32,15698,11,11,15001,14700,11761,11501,10435
36617,1702,12001,34747,1870,0,36617,1.95667e+18,96.131,14629.4,36617,5805,110,33581,33581,18314,16790,11208
1790,488,678,0,1790,0,1790,5.59723e+17,77.6564,949.884,1790,289,56,1112,1640,11773,14214,1780
38110,8488,8876,0,38110,13394,24716,2.53192e+15,60.0457,11545.8,38110,4318,72,27795,27795,20516,14844,12291
23746,1294,5545,0,23746,8346,15400,2.52698e+15,59.9387,7370.52,23746,2684,72,18201,18201,9213,6145,4586
14394,3986,5063,0,14394,0,14394,5.5483e+17,95.454,6317.45,14394,2446,110,9331,9331,8209,7558,7235
23445,1178,5534,8244,15201,0,23445,9.85861e+12,59.9059,7333.99,23445,2691,72,17911,17911,11559,16811,3876
39697,10125,17760,39697,0,38049,1648,4.68817e+18,1590.56,20298.7,39697,5293,138,38833,38833,38833,38833,38833
21724,258,799,0,21724,21102,622,3.58298e+16,113.504,2381.96,21724,109,26,20925,20797,18536,18578,10710
41878,7,16,40643,1235,41811,67,1.78451e+14,10.3685,710.158,41878,13,12,34083,29316,23299,19013,5553
11167,428,3225,0,11167,4038,7129,2.36212e+15,58.888,4182.37,11167,1571,72,20455,20167,8674,1861,1075
20811,5319,9409,8120,12691,0,20811,7.10038e+12,56.4642,10672.4,20811,4578,72,11402,11402,9120,11012,6615
22932,6413,7363,0,22932,0,22932,5.76804e+17,96.276,9208.11,22932,3566,110,28569,28569,23878,20917,15615
13426,10,13,13032,394,13353,73,1.71535e+14,10.6539,373.469,13426,12,12,13354,13248,12559,12576,12282
15774,2426,5659,0,15774,0,15774,5.44551e+17,93.0234,6995.68,15774,2733,110,10115,10115,7084,6990,4637
15908,59,3802,0,15908,0,15908,6.44352e+17,97.2017,5329.74,15908,1821,110,7908,2206,3272,408,622
13324,1858,5611,0,13324,5116,8208,1.92533e+15,54.2162,6548.65,13324,2716,72,7713,7713,5599,3784,3271
11365,2581,4925,11365,0,10800,565,4.32612e+18,116.454,5630.94,11365,1988,117,6440,6400,3898,4983,2406
42736,2531,14536,0,42736,15832,26904,2.1773e+15,57.9277,17134.3,42736,7058,72,42050,42050,42050,42050,42050
39323,1500,15214,37491,1832,37491,1832,8.01012e+18,95.3987,17798.7,39323,7381,110,30198,30198,22061,21692,18805
43062,1120,1827,0,43062,41798,1264,4.39069e+16,311.242,5968.12,43062,314,26,30572,30572,14661,24808,5499
25150,469,787,0,25150,24364,786,0.0312525,0.968708,4447.73,25150,787,1,25116,25116,25116,25116,25116
23296,9,14,22632,664,23222,74,1.38732e+14,10.6801,463.921,23296,14,12,4787,1384,1120,705,244
17132,6219,6608,17132,0,16215,917,4.69561e+18,144.603,7553.61,17132,2573,124,10524,10524,10367,22083,21749
7219,1817,2249,0,7219,0,7219,5.96157e+17,95.1463,3038.11,7219,1077,99,26566,26566,26566,26566,26566
8844,1718,2171,0,8844,0,8844,6.51272e+17,96.6093,3149.58,8844,1039,109,6673,6673,6076,5875,5658
9176,147,680,0,9176,8908,268,4.3544e+16,19.1969,1651.51,9176,83,26,8496,8488,6309,6389,2423
49401,8828,21688,47277,2124,47277,2124,4.65947e+18,95.3181,24507.4,49401,10446,111,40055,40055,39903,39879,39513
12966,747,3123,12216,750,12216,750,3.23375e+18,97.0029,4433.38,12966,1494,110,9843,9843,5716,7770,2779
36477,13,14,35423,1054,36425,52,1.5335e+14,10.3524,586.705,36477,12,11,6899,1391,633,1544,509
29406,130,1062,0,29406,28560,846,3.80284e+16,215.064,3370.03,29406,160,26,28084,27888,35661,34489,24013
28081,11,12,27280,801,28071,10,1.38567e+14,10.319,473.457,28081,12,11,10896,2211,2593,2070,1995
1965,82,984,1965,0,0,1965,8.76435e+17,17.6728,1098.76,1965,876,20,981,981,147,683,117
16008,178,3809,0,16008,0,16008,6.48974e+17,97.3304,5340.76,16008,1836,110,12199,12122,7283,2004,1363
17354,4150,7086,0,17354,0,17354,5.02984e+17,91.0299,8436.5,17354,3414,110,10268,10268,8861,9057,6792
4518,505,1165,4258,260,4258,260,3.42043e+18,95.1897,1759.82,4518,526,84,3353,3353,2500,3027,1820
41584,7318,12528,15109,26475,0,41584,9.00625e+12,54.6986,15187,41584,6083,72,24352,24352,18293,13952,11806
45989,17394,17494,31070,14919,43809,2180,4.25988e+18,96.1773,20378.8,45989,8390,111,35584,35584,35584,35584,35584
26420,22742,26420,26420,0,26420,0,34358400000,0,26420,26420,26420,1,0,0,0,0,0
5117,194,5117,5117,0,5117,0,3.4353e+10,0,5117,5117,5117,1,0,0,0,0,0
40935,11778,18626,39235,1700,39235,1700,2.5763e+18,94.233,21058.5,40935,9036,110,31771,31771,31771,31771,31771
35982,6180,8377,12648,23334,0,35982,9.91248e+12,60.0494,10923.6,35982,4080,72,27653,27653,25853,27343,23890
27965,5069,6566,0,27965,9827,18138,2.52532e+15,59.9638,8641.6,27965,3191,72,43321,43321,43321,43321,43321
40551,13,15,39380,1171,40502,49,1.5361e+14,10.3479,632.897,40551,13,12,48100,48097,46404,46302,44057
48058,6458,18161,0,48058,0,48058,5.26735e+17,95.3572,21214.9,48058,8828,110,36469,36469,33696,34878,33690
24524,11,12,23811,713,24506,18,1.60249e+14,10.3557,462.548,24524,12,11,11394,2840,3132,2473,2206
13309,393,840,0,13309,12919,390,4.42611e+16,130.123,2243.1,13309,112,26,12469,12294,10662,10960,8170
46803,17012,18508,46803,0,44553,2250,4.72468e+18,1106.93,21042.7,46803,7088,142,37733,37733,37733,37733,37733
35245,8150,8333,0,35245,0,35245,6.4534e+17,97.7297,11148.4,35245,4028,110,24913,24874,23483,23967,22917
3343,272,846,3144,199,3144,199,3.23301e+18,94.4212,1328.81,3343,396,74,2497,2497,1578,2041,1118
23891,3476,5798,22501,1390,22501,1390,3.17091e+18,98.044,7830.07,23891,2734,111,23725,23725,23550,23550,23550
9125,5726,9125,0,9125,0,9125,524231,0,9125,9125,9125,1,0,0,0,0,0
30020,6438,8333,28367,1653,28367,1653,6.37357e+18,97.0204,10709.6,30020,4036,110,28974,28974,28974,28974,28974
14619,108,290,0,14619,13435,1184,2.91209e+16,10.2362,705.86,14619,287,11,14329,14329,13757,12154,13653
41175,4291,17986,40615,560,39245,1930,4.69483e+18,469.695,19813.3,41175,4857,140,32400,32247,21807,25379,19246
26894,839,6306,0,26894,9461,17433,2.53286e+15,59.9751,8314.26,26894,3072,72,40671,40671,40671,40671,40671
47950,8268,11207,45160,2790,45160,2790,5.75858e+18,97.912,14813.1,47950,5439,110,41164,41164,41164,41164,41164
33813,8084,10323,33813,0,31844,1969,4.68476e+18,235.708,12102.9,33813,2062,129,26389,26389,26389,26389,26389
16156,3687,3784,0,16156,0,16156,6.50507e+17,97.3289,5335.06,16156,1821,110,2377,2377,2377,2377,2377
42471,525,10172,40001,2470,40001,2470,3.49194e+18,98.2298,13337.8,42471,4823,111,30641,30438,11772,24608,2201
33619,11,12,32660,959,33605,14,1.389e+14,10.1451,515.621,33619,12,11,6381,1604,823,832,645
33885,1566,15915,0,33885,0,33885,4.50039e+17,93.0583,17973.5,33885,7718,110,27367,27367,20303,12076,11725
35153,7,10,33906,1247,35028,125,4.47919e+13,5.99425,544.491,35153,8,8,5785,1371,676,1296,247
11454,2064,2717,10785,669,0,11454,2.23663e+18,96.9493,3912.78,11454,1301,110,8737,8737,8006,7769,7120
20967,38,176,20911,56,20967,0,6.10751e+18,167.472,1793.62,20967,148,147,12409,3987,4368,4620,4425
33220,4,176,33141,79,28466,4754,5.98367e+18,169.69,2159.11,33220,168,166,39701,36287,25273,33160,21047
40593,700,1607,0,40593,39413,1180,4.19728e+16,299.05,5252.94,40593,267,26,43907,43907,43907,43907,43907
36365,22,176,36285,80,36365,0,6.01971e+18,173.029,2313.19,36365,172,170,11487,753,1233,3394,1584
21804,3725,6646,20644,1160,20644,1160,2.80083e+18,96.9828,8425.36,21804,3157,111,15158,15158,10187,11942,9509
26627,5,12,25867,760,26613,14,1.39083e+14,10.3797,462.221,26627,12,11,24533,21960,17754,17934,13057
8970,8,11,8707,263,8963,7,1.70548e+14,9.81929,278.367,8970,11,11,8795,8708,8011,7665,6827
19762,206,1188,0,19762,19175,587,4.79011e+16,232.425,3448.18,19762,183,26,19715,19715,19715,19715,19715
31441,7113,9173,29731,1710,29731,1710,4.88648e+18,97.4647,11554,31441,4370,111,31158,31158,31158,31158,31158
11105,1,12,10775,330,11096,9,1.93116e+14,9.87465,316.848,11105,12,11,10460,10460,10460,9436,0
27978,4607,6552,0,27978,9844,18134,2.53316e+15,60.0047,8629.47,27978,3187,72,20099,19001,12021,11352,6523
12915,1502,4189,12247,668,12247,668,7.15849e+18,95.7034,5384.14,12915,2016,110,8726,8726,8307,8307,4046
4399,139,1051,1544,2855,0,4399,1.00378e+13,59.0266,1554.93,4399,512,69,3348,3348,1200,2742,523
14806,310,3463,13936,870,13936,870,3.37472e+18,97.3646,4915.11,14806,1665,110,11343,11343,4934,7899,1785
20752,4671,7216,19712,1040,19712,1040,3.82087e+18,96.3749,8852.08,20752,3444,117,13536,13536,12603,13455,9877
21274,1353,5309,7537,13737,0,21274,9.66068e+12,59.6337,6954.28,21274,2572,72,33029,34996,0,0,0
10680,99,346,0,10680,10509,171,2.49368e+16,3.73343,1369.68,10680,175,4,15213,14504,11447,9440,6005
24040,6200,9072,24040,0,22748,1292,5.12953e+18,151.698,10247.9,24040,3517,125,28595,28595,28595,28595,28595
36416,459,1311,0,36416,35363,1053,3.93847e+16,265.729,4285.23,36416,211,26,36159,36159,36159,36159,36159
25086,8,12,24358,728,25071,15,1.58814e+14,10.0828,463.014,25086,12,11,5392,3445,2450,2429,2353
22409,4265,11407,21569,840,21569,840,9.88435e+18,91.1228,12831.7,22409,5516,110,32938,32938,32938,32938,32938
1252,343,383,0,1252,0,1252,6.73997e+17,86.6845,605.9,1252,166,48,869,869,839,854,862
5603,2,11,5439,164,5597,6,1.92104e+14,10.1944,222.286,5603,11,11,3355,2727,1686,2737,1778
19394,1552,7102,7259,12135,0,19394,8.19574e+12,57.8107,8441.39,19394,3457,72,12292,12292,7681,11502,2263
21165,4739,5034,19935,1230,19935,1230,5.7913e+18,97.5234,6930.38,21165,2427,110,16131,16131,15948,15932,15545
14650,3,6,14396,254,14618,32,9.96786e+13,3.99556,278.635,14650,5,4,2912,556,546,315,497
49730,114,176,49653,77,49730,0,5.98264e+18,171.774,2641.42,49730,172,172,40194,23235,27443,25165,10686
9982,733,2438,9402,580,9402,580,5.79908e+18,96.6224,3511.39,9982,1161,110,7544,7544,6554,6234,2864
46943,6599,19853,44883,2060,44883,2060,8.51828e+18,94.0481,22684,46943,9648,110,37825,37825,35841,37412,32459
21482,759,13923,19042,2440,0,21482,2.45237e+18,5.51438,15991.5,21482,4646,13,7559,7559,2861,5420,1333
9150,2604,4575,9150,0,8760,390,4.6144e+18,117.641,5197,9150,2002,103,28230,28186,26747,27233,25958
37339,9,14,36267,1072,37259,80,1.43945e+14,10.6153,611.513,37339,13,12,38189,37589,30481,30511,29288
18021,11,12,17501,520,18009,12,1.47196e+14,10.7101,387.864,18021,12,11,18009,18009,17842,17843,17603
20880,1415,5031,19660,1220,19660,1220,2.64985e+18,98.0569,6869.64,20880,2376,111,35960,35960,15106,13436,6004
18898,7139,18898,0,18898,18898,0,2047.89,0,18898,18898,18898,1,0,0,0,0,0
41717,126,176,41628,89,41717,0,6.02779e+18,172.859,2492.96,41717,169,172,40387,40254,30625,30514,18526
5107,255,1855,1905,3202,0,5107,8.31446e+12,50.2281,2352.53,5107,881,68,3252,3252,1128,2652,391
23953,1,11,23265,688,23946,7,1.45397e+14,10.14,438.292,23953,11,11,7401,7401,7401,7401,7401
32536,3586,11172,30896,1640,30896,1640,3.13708e+18,96.6573,13478.6,32536,5342,111,29008,29008,0,0,0
39334,1,18,0,39334,36053,3281,3.00037e+16,9.99092,658.993,39334,15,11,52,52,52,52,52
14075,4804,5165,9588,4487,13390,685,1.64975e+18,95.677,6363.5,14075,2454,111,8910,8910,8639,8895,8591
38237,1783,8896,0,38237,13431,24806,2.5358e+15,60.0722,11574.5,38237,4333,72,29341,29341,19007,7624,6389
15229,174,8562,15229,0,0,15229,8.95099e+17,17.968,8881.65,15229,7697,20,6667,6602,296,3613,213
42889,756,1185,0,42889,41666,1223,3.55861e+16,246.943,4087.43,42889,186,26,30173,29915,18309,14499,10025
17991,2837,4472,16958,1033,16958,1033,3.32754e+18,97.1877,6127.63,17991,2155,110,13519,13519,10718,11900,9669
44929,656,2347,0,44929,43589,1340,4.96716e+16,327.59,7532.53,44929,414,26,48877,48877,48877,48877,48877
22784,9862,11391,14575,8209,21904,880,7.03781e+18,91.9073,12828,22784,5467,111,11393,11393,11393,11358,10935
27006,4398,10868,0,27006,0,27006,5.06974e+17,95.0004,12762,27006,5272,110,16138,16138,12273,9103,7929
10798,2146,3399,0,10798,3934,6864,2.26845e+15,57.3708,4308.29,10798,1635,72,7399,7399,6017,4836,4517
12813,3482,9123,12523,290,12523,290,9.93104e+18,90.4379,9758.94,12813,4409,94,3690,3603,181,3690,922
31383,1137,7892,11121,20262,0,31383,9.64264e+12,59.7199,10130.5,31383,3835,72,23491,23491,14739,21981,4094
13472,2715,3841,12735,737,12735,737,6.58756e+18,96.3367,5127.8,13472,1846,110,9631,9631,9351,9351,6538
39629,13578,18777,38029,1600,38029,1600,4.18645e+18,94.7261,21041.7,39629,9047,111,31305,31305,30937,31305,29449
18998,7041,10780,18998,0,11959,7039,4.45006e+18,269.916,11740.1,18998,4949,124,8218,8068,6768,7414,6054
34909,112,176,34820,89,34909,0,6.11396e+18,172.833,2313.99,34909,166,162,24507,10560,8896,14466,2031
46317,50,176,46253,64,46317,0,6.04351e+18,173.771,2644.15,46317,175,175,16410,4512,7616,10278,1126
20767,1106,7782,0,20767,0,20767,5.30645e+17,95.3104,9391.44,20767,3767,110,29010,29010,14022,3517,3491
11133,2389,2752,10484,649,10484,649,5.12592e+18,97.4532,3898.26,11133,1295,111,8381,8381,8381,8381,7642
23963,70,176,23949,14,23963,0,6.02362e+18,171.273,1883.27,23963,160,156,18280,10886,8697,10029,9481
9381,693,2655,0,9381,3374,6007,2.37169e+15,57.1906,3501.83,9381,1279,72,6726,6726,4704,3699,2397
12710,61,3982,0,12710,4633,8077,2.28062e+15,58.5332,5011.03,12710,1937,72,8338,4016,4888,1689,216
6088,598,1547,5735,353,5735,353,3.33415e+18,95.6045,2288.01,6088,731,93,4541,4541,2667,3533,2009
979,181,272,0,979,343,636,2.66378e+15,54.6404,435.125,979,132,43,707,707,605,614,554
38622,169,206,38604,18,38622,0,5.98108e+18,186.877,2404.48,38622,177,173,35262,34963,10190,7469,2646
11642,553,2885,10967,675,10967,675,3.12757e+18,97.2991,4069.29,11642,1342,111,8757,8757,4604,5380,2340
46836,7302,13261,0,46836,0,46836,6.06039e+17,96.0705,16617.2,46836,6421,110,27386,27386,23937,24171,16635
31794,2856,9776,31794,0,29944,1850,4.35929e+18,214.546,11473.9,31794,3801,125,23244,19456,10508,13977,6004
13985,1765,5008,13295,690,13295,690,2.95769e+18,93.7978,6230.33,13985,2401,110,8977,8977,6879,7338,4037
35546,1999,17121,14056,21490,0,35546,6.68956e+12,54.8601,18965.3,35546,8334,72,27818,27818,24749,24615,14524
42843,1231,1339,0,42843,41505,1338,0.0312303,0.968746,7574.08,42843,1339,1,32293,32135,23349,23518,14967
25456,7837,12763,25456,0,24426,1030,4.29583e+18,353.03,14134,25456,5924,129,20281,0,0,0,17469
34075,4568,8993,32150,1925,32150,1925,2.71288e+18,97.8965,11599.7,34075,4263,111,31064,31064,3844,3844,3844
34491,8224,8275,32481,2010,32481,2010,3.31827e+18,98.285,10977.7,34491,3915,111,1457,1457,1023,1433,1023
46587,10935,15281,44207,2380,44207,2380,7.15551e+18,85.777,18454.1,46587,7402,110,36059,36059,36059,36059,36059
46336,901,18590,44227,2109,0,46336,1.74346e+18,95.2195,21471.4,46336,9028,110,46173,46173,46173,46173,46173
2857,587,751,0,2857,0,2857,6.49323e+17,93.146,1178.69,2857,343,67,2106,2106,1919,1904,1901
29962,1176,1772,9097,20865,9097,20865,1.99834e+18,15.9951,2418.73,29962,1054,26,24272,23817,11736,14651,3188
10912,2088,2639,10274,638,10274,638,3.2096e+18,96.9515,3786.98,10912,1264,110,8273,8273,7726,8107,6958
37103,57,1079,0,37103,36044,1059,3.56142e+16,225.812,3626,37103,165,26,26236,19006,24071,17880,16427
14387,124,3405,5062,9325,0,14387,9.85786e+12,59.7723,4632.76,14387,1653,72,10982,17284,9326,14878,6638
37131,82,206,37116,15,37131,0,5.97982e+18,186.05,2371.15,37131,181,175,21204,6992,8472,15114,1810
45359,13160,16886,43179,2180,43179,2180,4.03685e+18,96.3225,19769,45359,8101,111,35331,35331,35331,35331,35331
27323,7,12,26543,780,27312,11,1.39105e+14,10.1771,465.047,27323,12,11,3743,1120,507,1038,176
40090,10428,11195,37891,2199,0,40090,2.09782e+18,97.1365,14170.4,40090,5433,110,39799,39799,39799,39799,39799
45975,5591,18730,45975,0,43993,1982,4.96311e+18,2486.35,21969.9,45975,7820,144,45369,45369,45369,45369,45369
13748,10,12,13346,402,13740,8,1.65265e+14,10.2557,344.596,13748,12,11,13703,13665,13353,13352,12396
31475,462,2221,0,31475,0,31475,3.72642e+18,15.9892,2875.77,31475,1283,18,31387,31387,31387,31387,31387
40822,10729,17668,40822,0,38970,1852,4.61409e+18,710.671,19795.5,40822,6028,142,40268,40268,40268,40268,40268
29437,12,176,29389,48,29437,0,6.01642e+18,171.422,2077.76,29437,167,162,8385,1382,1707,1926,1949
37799,9146,20641,0,37799,0,37799,3.84797e+17,92.8714,22627.6,37799,10031,110,32585,32585,28478,22660,20161
34645,357,1029,0,34645,33657,988,3.55473e+16,211.758,3415.25,34645,155,26,48505,0,0,0,1320
20509,1767,4827,0,20509,0,20509,6.51265e+17,97.5438,6679.43,20509,2332,110,19570,19570,13800,12522,6866
38886,1571,9950,36686,2200,0,38886,2.16496e+18,97.5006,12931.2,38886,4828,110,30919,30919,21769,29068,10461
46465,1545,12218,33035,13430,43845,2620,3.20789e+18,97.3525,15550.6,46465,5783,111,42470,42470,38875,41591,34166
31828,2677,13882,0,31828,0,31828,4.78541e+17,94.037,15938.2,31828,6739,110,21148,21148,15030,14941,6778
46224,131,176,46122,102,46224,0,6.07448e+18,173.192,2658.68,46224,173,169,30607,18730,19270,7839,5491
34684,10292,15523,33224,1460,0,34684,1.61117e+18,94.4219,17685.7,34684,7543,110,19161,19161,16614,15228,12576
35982,4592,8395,0,35982,12648,23334,2.52561e+15,60.0085,10944.6,35982,4075,72,34457,34457,25945,32950,15515
17065,4789,9949,0,17065,7051,10014,1.38444e+15,52.7477,10832.9,17065,4833,72,7116,7116,5849,4300,3954
30883,7822,11006,30883,0,29173,1710,5.48027e+18,213.076,12423.3,30883,3626,130,14836,14097,11794,12457,10681
7580,5,11,7364,216,7579,1,1.38212e+14,10.4127,244.069,7580,11,11,6908,6083,4958,5133,4603
3147,771,1612,3147,0,3008,139,7.31725e+18,90.4522,1916.23,3147,361,63,1535,1442,1104,1372,533
31472,5104,7511,0,31472,11091,20381,2.51446e+15,59.925,9783.14,31472,3652,72,40677,40677,40677,40677,40677
32467,6884,9966,32467,0,30577,1890,3.50147e+18,224.061,11694,32467,3876,125,22501,22453,19163,20194,16366
47729,11005,11141,0,47729,16775,30954,2.52651e+15,60.0523,14355,47729,5413,72,45456,45456,45456,45456,45456
29344,8179,9023,29344,0,27634,1710,5.21493e+18,190.158,10621.8,29344,2505,132,22111,22111,22111,22111,22111
29270,1361,11156,29270,0,27765,1505,4.27304e+18,243.891,12705.9,29270,3597,132,23195,23195,13445,5117,3023
19293,4116,7070,19293,0,18263,1030,5.00271e+18,161.166,8227.04,19293,1492,128,12223,12223,10991,12050,7918
29057,7199,12209,0,29057,0,29057,4.90358e+17,94.7416,14170.5,29057,5914,110,22006,22006,22006,22006,22006
9906,82,175,9905,1,9906,0,5.9741e+18,161.954,1180.65,9906,128,127,8087,4589,4241,4564,4602
10361,45,89,0,10361,9505,856,2.96689e+16,10.0649,404.283,10361,85,11,10272,10272,9868,9262,10122
44708,13514,18726,44708,0,43018,1690,5.31395e+18,3505.21,22699.9,44708,7906,154,34194,34194,34194,34194,34194
31625,5168,7964,29825,1800,29825,1800,6.00112e+18,97.4888,10511.6,31625,3857,110,26786,26786,16474,23842,5939
5381,322,2366,5381,0,5111,270,6.79091e+18,79.0504,2809.39,5381,913,92,3015,3015,1227,2294,0
12025,1315,4087,11415,610,11415,610,2.34912e+18,95.9397,5191.18,12025,1936,111,7938,7938,5336,5494,2363
6082,1024,2617,0,6082,0,6082,4.94136e+17,93.0497,3229.93,6082,1256,86,3465,3465,2533,1395,1938
32244,1055,9892,32244,0,30364,1880,5.03486e+18,219.539,11610.2,32244,3845,128,22352,22070,10583,15790,3202
9986,2384,2442,9406,580,0,9986,2.22216e+18,96.6374,3515.48,9986,1161,110,7544,7544,7518,7519,7528
956,17,164,956,0,956,0,6.05525e+18,101.366,361.84,956,58,47,328,144,216,101,41
15427,2262,4883,0,15427,5638,9789,2.25489e+15,58.5004,6075,15427,2367,72,15641,15641,12261,8439,7438
21935,4416,7388,20825,1110,20825,1110,3.09695e+18,93.554,9140.27,21935,3560,110,23352,23352,23352,23352,23352
17447,2158,4236,16429,1018,16429,1018,3.65422e+18,97.8802,5840.59,17447,1998,111,13211,13211,10927,12867,7341
31968,4005,8687,0,31968,0,31968,6.16308e+17,97.1553,11200.8,31968,4208,110,47364,47364,47364,47364,47364
43823,15479,17372,41813,2010,0,43823,1.75717e+18,94.1509,20152.9,43823,8423,110,26451,26451,25551,25177,24360
9917,407,725,9917,0,9516,401,2.72117e+18,17.9117,1102.18,9917,411,21,20170,19912,12257,3930,2507
1439,201,379,0,1439,508,931,2.693e+15,56.2689,595.209,1439,184,50,1060,1060,845,859,669
39913,12602,12654,39913,0,37635,2278,4.91868e+18,266.068,14647,39913,3599,134,44441,44441,44441,44441,44441
4091,184,200,4091,0,4091,0,6.00401e+18,160.345,792.05,4091,95,95,3889,3804,3804,3796,3795
12812,5229,5342,12812,0,12173,639,3.80442e+18,119.807,6180.96,12812,2241,123,7470,7470,7450,7462,7412
20846,5185,20846,20846,0,20846,0,8.79567e+12,0,20846,20846,20846,1,0,0,0,0,0
2545,34,175,2483,62,2545,0,6.02305e+18,137.422,602.192,2545,79,75,1319,417,426,554,534
13571,3110,5092,12921,650,0,13571,1.83352e+18,94.95,6262.77,13571,2455,110,8479,8479,7051,6750,5749
22187,4203,10282,21269,918,21269,918,8.21999e+18,93.5284,11766.8,22187,4926,111,11905,11905,7991,9157,4616
22948,2651,5573,21615,1333,21615,1333,2.48422e+18,97.783,7545.7,22948,2612,111,28370,28370,13137,17676,5920
8073,8,175,8068,5,8073,0,5.98011e+18,159.578,1065.86,8073,118,123,1692,210,280,239,358
41044,4177,9868,38654,2390,38654,2390,2.96679e+18,98.3261,12959,41044,4673,111,22956,22956,16290,17325,6950
18913,3598,4500,0,18913,6661,12252,2.51745e+15,59.8298,6016.78,18913,2186,72,14413,14413,13419,12165,11910
25717,184,208,25690,27,25717,0,6.1324e+18,199.893,2138.32,25717,162,163,15759,14197,7638,9411,1610
43961,10,16,42682,1279,43869,92,1.64822e+14,10.4037,685.716,43961,14,13,11919,4234,2131,9208,202
46191,13461,19087,46191,0,43977,2214,4.67863e+18,981.696,21290.5,46191,6481,141,29403,28811,25427,27390,21803
35666,11,15,34629,1037,35580,86,1.6353e+14,10.51,632.935,35666,14,12,11621,3853,1922,7686,264
40503,4638,17782,30227,10276,38763,1740,4.78768e+18,94.3297,20203.7,40503,8538,111,40052,40052,40052,40052,40052
7825,140,176,7819,6,7825,0,6.06017e+18,156.434,1091.04,7825,111,115,7471,7017,6136,6180,6120
24941,87,1039,0,24941,24218,723,3.97601e+16,214.813,3172.7,24941,156,26,22249,19361,7182,17437,635
28391,2819,9620,0,28391,0,28391,5.60653e+17,96.0273,11746.7,28391,4664,110,18771,18771,12622,5598,5564
21535,3493,5073,20283,1252,0,21535,2.22862e+18,97.5063,6998.48,21535,2448,110,16462,16462,14659,13994,11891
24398,2954,8546,0,24398,9069,15329,2.14751e+15,50.8289,10181.2,24398,4144,72,25976,25976,20020,14565,10904
30498,2474,10479,0,30498,11313,19185,2.17179e+15,58.2728,12443,30498,5104,72,30254,27052,25534,25673,24664
39436,159,176,39361,75,39436,0,6.1903e+18,172.679,2437.89,39436,161,160,35863,35543,20462,33169,1034
45221,11906,15098,42931,2290,42931,2290,2.96827e+18,96.3132,18176.1,45221,7333,110,43924,43924,43924,43924,43924
26084,6231,7699,24674,1410,24674,1410,5.50771e+18,97.2695,9755.7,26084,3651,111,18385,18385,16972,17210,16819
44023,14542,18572,0,44023,16938,27085,1.90627e+15,56.2075,20961.3,44023,9025,72,25515,25515,23774,23319,21085
4995,545,1409,1781,3214,0,4995,9.37921e+12,56.612,1939.86,4995,668,71,3586,3586,2607,3416,1590
14518,4719,4852,14518,0,13671,847,6.13823e+18,120.002,5736.18,14518,1748,120,9666,9666,9635,9663,9601
28162,321,6635,0,28162,0,28162,6.48204e+17,97.6725,8999.43,28162,3213,110,23085,21934,9790,11215,1315
5645,3,9,5174,471,5645,0,1.17078e+14,7.00992,179.872,5645,9,8,4232,3997,2356,3519,3762
33619,9616,10001,0,33619,12188,21431,2.31727e+15,58.2717,12249.5,33619,4850,72,23618,23618,23618,23618,26862
31582,11,12,29008,2574,31579,3,1.14571e+14,8.13416,471.906,31582,12,9,16601,7614,4601,6081,2506
1749,73,456,0,1749,615,1134,2.54829e+15,56.5838,709.255,1749,213,51,1293,924,764,343,294
40882,2553,8192,40882,0,40882,0,4.50729e+15,6550.47,18299.5,40882,8192,6,27156,27156,18202,8962,6740
1698,34,697,0,1698,0,1698,5.24628e+17,87.6325,948.211,1698,308,54,479,74,259,194,70
29870,532,7192,28148,1722,0,29870,2.21015e+18,97.5803,9655.87,29870,3471,110,22678,22678,13905,12050,3102
3634,116,175,3593,41,3634,0,6.01144e+18,147.434,716.976,3634,88,91,3281,2946,2358,2396,2432
35818,2866,10334,33878,1940,0,35818,2.07213e+18,90.6963,13032.4,35818,5010,110,21312,21312,14957,8430,2946
37985,12895,21559,37985,0,0,37985,8.97201e+17,17.9406,22068.1,37985,19393,20,16426,16426,10096,11343,9914
33255,883,1040,0,33255,32215,1040,0.0312434,0.968727,5880.12,33255,1040,1,27484,27397,21598,22716,16510
47070,14531,17074,17632,29438,0,47070,8.2271e+12,58.0289,19802,47070,8317,72,32116,32116,32066,32066,31306
46668,3415,15072,46668,0,43968,2700,4.37902e+18,326.393,17009.3,46668,5667,129,43679,43679,43679,43679,43679
42190,5392,20677,42190,0,42190,0,1.67766e+18,17.9845,21275.2,42190,18597,20,27469,27075,21879,23020,16976
48648,6177,11337,0,48648,17107,31541,2.52941e+15,60.0709,14603,48648,5514,72,30930,30930,23274,24795,0
18867,5,11,18321,546,18853,14,1.5814e+14,10.1483,398.058,18867,11,11,4476,990,774,674,785
20220,47,176,20172,48,20220,0,6.12328e+18,170.29,1760,20220,146,148,13438,5467,5052,5677,5203
43350,14018,18345,43350,0,41532,1818,4.74675e+18,2285.27,21389.7,43350,5962,142,34984,34984,34984,34984,34984
8537,2342,5553,8306,231,8306,231,1.1837e+19,85.4656,6104.2,8537,2672,89,2984,2984,2758,2852,1771
26604,142,175,26534,70,26604,0,5.98055e+18,167.025,1929.3,26604,158,165,25800,24132,21862,21901,21832
25072,5888,10224,25072,0,23795,1277,5.39144e+18,205.79,11432.4,25072,2829,130,14848,14788,12665,14096,9484
25601,716,6151,24111,1490,24111,1490,5.8109e+18,98.0891,8301.1,25601,2904,111,25423,25423,25423,25423,25423
9213,1651,2853,0,9213,3348,5865,2.29679e+15,58.4637,3663.5,9213,1388,72,6360,6360,4960,5219,3479
46807,3143,11724,44145,2662,44145,2662,5.99997e+18,97.6085,15196.7,46807,5683,110,42130,42130,40585,39840,38340
1129,123,157,1124,5,1129,0,6.3135e+18,70.651,394.562,1129,58,47,18875,18555,18549,18491,19145
23277,7668,12970,23277,0,22472,805,5.06291e+18,464.868,14275.8,23277,4864,133,17975,17975,17975,17975,17975
41402,701,1157,0,41402,40220,1182,3.55885e+16,241.55,3969.27,41402,180,26,35494,35494,23836,32102,19092
4071,74,185,0,4071,3955,116,3.52589e+16,19.7966,539.983,4071,41,26,3886,3886,3525,3545,2055
3427,46,170,3427,0,3427,0,5.95755e+18,148.179,689.729,3427,90,86,2063,974,769,974,952
42528,2,15,41301,1227,42442,86,1.54742e+14,10.5442,682.993,42528,14,12,19363,18528,18512,18587,18441
19325,4318,7868,0,19325,0,19325,5.04951e+17,94.824,9333.52,19325,3813,110,22178,22178,22178,22178,22178
33436,6678,12384,33436,0,31629,1807,4.23679e+18,231.112,13872.1,33436,4860,128,28060,28060,22105,14681,13674
44356,10464,16093,0,44356,16600,27756,2.10269e+15,57.9883,18692.6,44356,7827,72,31174,31174,29148,26577,26287
10045,142,424,0,10045,9757,288,3.54514e+16,20.0477,1199.05,10045,63,26,9621,9621,8613,8683,4291
35503,5334,10838,0,35503,12927,22576,2.29631e+15,58.8886,13163.2,35503,5277,72,34479,34479,34479,34479,34479
22692,11545,14701,20112,2580,20112,2580,7.20084e+16,5.52018,16885,22692,4912,13,36579,36579,36579,36579,36579
12584,3,11,12225,359,12577,7,1.39105e+14,10.6933,313.66,12584,11,11,9636,6778,8011,7669,4683
24510,440,7991,0,24510,9022,15488,2.22933e+15,58.5242,9679.93,24510,3889,72,16519,16231,9797,3146,1738
19505,531,913,0,19505,18939,566,4.02976e+16,170.143,2647.44,19505,129,26,18592,18329,17507,17486,13078
37664,5174,9034,35490,2174,0,37664,2.21191e+18,97.6945,11989.5,37664,4370,110,34636,34636,34636,34636,34636
29209,4557,6819,27507,1702,27507,1702,5.74362e+18,97.7281,9259.85,29209,3304,110,31226,31226,20659,16784,12182
3847,56,174,3844,3,3847,0,6.1097e+18,147.321,765.395,3847,85,85,2717,1782,1197,1326,1279
45330,18093,22278,18005,27325,0,45330,6.55715e+12,54.7083,24485,45330,10830,72,28839,28839,28839,28839,28839
19264,50,175,19255,9,19264,0,5.98252e+18,166.002,1643.23,19264,156,153,12244,6007,4698,5632,5459
23667,5737,6896,0,23667,0,23667,6.02002e+17,96.7361,8849.02,23667,3340,110,26518,26518,26518,26518,26518
6188,520,1616,5835,353,5835,353,3.61802e+18,96.0037,2356.18,6188,740,93,4572,4572,2561,3159,2009
29790,1195,8099,28140,1650,0,29790,2.12029e+18,97.1235,10478.5,29790,3921,110,41747,41747,41733,41689,40543
27306,7445,8529,0,27306,9972,17334,2.26652e+15,58.695,10397.7,27306,4142,72,18777,18777,17487,17220,15479
34902,17274,19580,33732,1170,0,34902,1.2835e+18,92.6268,21403.5,34902,9514,110,37640,37640,37640,37640,37640
18642,5331,6490,0,18642,6918,11724,2.15364e+15,58.0628,7818.7,18642,3152,72,12152,12152,11676,11747,11289
23426,3541,5700,22065,1361,22065,1361,5.66621e+18,97.9764,7698.29,23426,2691,111,17726,17726,15142,16243,11865
14637,521,618,0,14637,14219,418,3.55882e+16,20.0943,1711.04,14637,81,26,14019,14019,13664,13683,12356
25686,9480,10376,25686,0,24366,1320,3.93706e+18,182.854,11597.8,25686,4193,125,15310,15310,14753,15070,13926
8344,320,559,0,8344,8101,243,4.17112e+16,19.4163,1398.35,8344,72,26,37964,37964,0,0,0
4324,976,1084,4069,255,0,4324,2.24854e+18,94.8663,1664.36,4324,506,82,32849,32849,13549,26483,3148
43847,10558,15558,41697,2150,41697,2150,3.01811e+18,94.6145,18488.7,43847,7560,110,28289,28289,21984,24633,19271
15268,710,914,0,15268,14819,449,4.45287e+16,183.716,2521.6,15268,129,26,29127,29127,17015,5014,2586
45754,4027,10642,0,45754,0,45754,6.49558e+17,97.9272,14114.9,45754,5166,110,26933,26933,14859,8223,6821
5244,664,1653,1913,3331,0,5244,8.90754e+12,57.8875,2184.04,5244,799,72,3591,3591,2011,3190,535
14139,146,176,14129,10,14139,0,6.02081e+18,166.115,1452.74,14139,140,142,13714,12968,11830,11830,11766
22648,3700,5292,0,22648,7956,14692,2.5342e+15,59.9299,7045.88,22648,2571,72,17356,17356,15026,13629,12324
35270,802,8268,0,35270,0,35270,6.46981e+17,97.7806,11093,35270,3995,110,27114,26724,24106,24017,20898
8252,125,176,8185,67,8252,0,6.03502e+18,164.421,1105.31,8252,114,121,7711,14209,13021,12984,12980
9483,475,4061,3644,5839,0,9483,7.43303e+12,56.5446,4780.7,9483,1975,72,17408,17169,10640,2726,2517
24015,2379,11732,24015,0,22975,1040,4.40607e+18,246.909,12882.5,24015,5145,127,25681,25681,18356,9203,8908
43417,20612,23615,41907,1510,41907,1510,2.39045e+18,91.8468,25833.8,43417,11465,110,34280,34280,34280,34280,34280
37857,20,176,37768,89,37857,0,6.02201e+18,172.44,2362.68,37857,168,170,23455,8983,12284,12950,15880
12483,12,13,12128,355,12419,64,1.3908e+14,10.9739,336.288,12483,13,12,12469,12464,12098,12098,11893
21182,8340,10762,0,21182,0,21182,4.20383e+17,93.1933,12123.7,21182,5224,110,10420,10420,9356,9331,8671
18452,605,4330,0,18452,6488,11964,2.52928e+15,59.8562,5824.05,18452,2097,72,11670,11117,5786,7176,1296
2779,943,1009,2779,0,2619,160,3.23953e+18,88.1101,1329.02,2779,349,71,1770,1770,1749,1755,1761
39011,17180,19639,0,39011,0,39011,3.43687e+15,17.9764,20205.9,39011,17665,20,38139,38139,38139,38139,38139
18942,747,6004,17952,990,17952,990,3.19669e+18,96.1813,7606.9,18942,2897,110,25814,25814,9618,20893,2632
24333,8,15,23620,713,24249,84,1.71351e+14,10.5873,520.452,24333,13,12,23891,23500,19514,19376,16351
31013,6129,15209,31013,0,31013,0,2.81469e+18,17.978,15719.2,31013,13680,20,30134,30134,30134,30134,30134
42810,144,176,42791,19,42810,0,5.98383e+18,172.105,2452.25,42810,170,172,42634,42614,42594,42568,42543
11700,1304,4814,0,11700,0,11700,5.0422e+17,94.1829,5818.85,11700,2320,110,6886,6886,3421,2760,2145
8841,1068,3768,8451,390,0,8841,1.69328e+18,93.6176,4574.69,8841,1811,103,5073,5073,3213,2842,1406
10467,137,176,10464,3,10467,0,6.06625e+18,166.008,1262.73,10467,125,123,10016,9407,8074,8184,8162
38990,9065,14519,38990,0,36960,2030,4.64254e+18,274.098,16422.6,38990,3724,137,26202,26202,24217,23890,16321
33459,5799,12046,31815,1644,31815,1644,1.65807e+18,95.2239,14354.6,33459,5767,111,26800,26800,26797,26797,26797
46728,16773,21276,18268,28460,0,46728,7.01535e+12,55.8718,23665.3,46728,10350,72,28437,28437,26742,27511,26736
3205,484,815,0,3205,0,3205,6.59812e+17,94.1785,1284.4,3205,378,72,2390,2390,2026,1968,1702
17975,4766,6055,17065,910,17065,910,3.02184e+18,95.8366,7566.62,17975,2927,110,11920,11920,11062,11686,9917
29526,3558,7068,27804,1722,27804,1722,3.40095e+18,98.1815,9462.79,29526,3332,111,31226,31226,31226,31226,31226
15152,272,466,0,15152,14921,231,2.46343e+16,3.73614,1838.32,15152,235,4,14686,14686,14667,14550,11138
23858,2,12,23161,697,23841,17,1.66327e+14,10.2944,459.723,23858,12,11,14004,10670,8319,10759,6899
8466,1655,2918,8466,0,7976,490,3.80633e+18,91.9714,3552.5,8466,1039,113,30322,30322,29171,0,0
27093,2,12,26321,772,27080,13,1.38655e+14,10.5053,467.448,27093,12,11,9317,8392,8488,8487,8314
3066,284,750,1077,1989,0,3066,9.97112e+12,58.5483,1138.42,3066,361,61,2316,2316,1640,2196,1003
2651,192,728,2501,150,2501,150,3.21436e+18,91.4734,1130.6,2651,322,66,1923,1923,1070,1482,743
8367,6,7,8067,300,8318,49,4.47762e+13,5.97359,226.789,8367,7,7,8359,8356,8280,8280,8354
29114,52,208,29094,20,29114,0,6.07236e+18,201.601,2252.18,29114,169,167,14624,3370,7523,9037,450
46281,4604,13144,43761,2520,0,46281,2.08248e+18,97.0962,16460.2,46281,6384,110,46122,46122,46122,46122,46122
16965,7358,8301,6727,10238,0,16965,6.60774e+12,52.0523,9328.61,16965,4022,72,13070,13070,13070,13070,13070
47480,20501,27416,19586,27894,0,47480,5.44946e+12,54.2697,29388,47480,13350,72,46312,46312,46312,46312,46312
47610,375,21008,45570,2040,45570,2040,5.11724e+18,95.271,23739.1,47610,10110,111,39707,39707,22240,16285,16722
45989,9733,25219,44409,1580,44409,1580,2.3649e+18,89.963,27524,45989,12245,110,45044,45044,45044,45044,45044
39415,2215,9221,37125,2290,37125,2290,3.23361e+18,97.8063,12304.1,39415,4463,110,38985,38985,38985,38985,38985
23086,5828,8565,0,23086,0,23086,5.35187e+17,94.7995,10315.9,23086,4147,110,34469,34469,34469,34469,34469
32701,8966,12872,32701,0,31051,1650,4.90322e+18,252.986,14530.5,32701,5485,132,25403,25403,25403,25403,25403
33176,5660,7972,31246,1930,31246,1930,2.41805e+18,98.2367,10595.1,33176,3770,111,26358,26358,25330,23549,23814
12226,4587,6568,0,12226,0,12226,3.96806e+17,87.77,7439.65,12226,3162,105,13591,13591,8256,9539,4897
13047,2480,4994,12427,620,0,13047,1.81269e+18,94.7757,6119.55,13047,2413,110,8053,8053,5586,5014,2992
8720,3251,3302,0,8720,0,8720,5.32961e+17,94.3365,4145.75,8720,1586,99,5418,5418,5385,5391,5402
5601,1292,3454,2348,3253,0,5601,5.15441e+12,47.7233,3819.76,5601,1676,69,2147,2147,1528,1981,1003
49727,598,1312,0,49727,48309,1418,3.556e+16,266.251,4636.44,49727,210,26,44102,44102,32880,29685,28780
42478,4208,18013,42478,0,40578,1900,4.79535e+18,1311.07,20490.9,42478,7959,145,42049,42049,42049,42049,42049
33178,2068,7743,0,33178,11663,21515,2.52933e+15,60.0398,10132,33178,3764,72,23124,23124,16808,12507,11131
21814,8903,9944,20904,910,0,21814,1.59339e+18,92.4792,11445.2,21814,4825,110,0,0,0,0,0
32302,494,14442,30932,1370,30932,1370,8.08489e+18,92.5018,16458.1,32302,6952,111,25998,25480,10870,14317,1756
30672,6171,7218,0,30672,0,30672,6.47185e+17,97.7044,9746.81,30672,3493,110,24026,24026,23733,23400,23365
34389,849,8021,0,34389,12083,22306,2.52878e+15,60.0386,10479.5,34389,3902,72,32893,32893,12161,6016,4449
728,605,728,0,728,355,373,53454700000,0,728,728,355,21,0,0,0,0,0
14390,938,7062,14390,0,14390,0,2.34413e+18,17.9477,7403.92,14390,6340,20,7328,7328,1253,7328,1017
16634,54,61,16602,32,16634,0,2.3354e+18,60.591,960.278,16634,61,61,16167,15544,14666,15041,14660
17837,628,720,0,17837,17325,512,3.5538e+16,48.8219,2026.54,17837,93,26,22633,19474,11320,14246,644
33016,2736,7940,31089,1927,31089,1927,4.2972e+18,98.2439,10546.6,33016,3754,111,25076,25076,15171,17847,10071
13420,509,572,0,13420,13037,383,3.55993e+16,20.0768,1586.17,13420,76,26,12848,12848,12691,12699,11921
4190,140,1856,1621,2569,0,4190,7.29687e+12,48.1277,2247.39,4190,893,70,2334,2250,1326,324,0
33293,4664,10207,0,33293,0,33293,5.88425e+17,96.6647,12703.1,33293,4953,110,25117,25117,17624,20247,6038
32601,236,12156,0,32601,12267,20334,2.07174e+15,57.8029,14157.9,32601,5914,72,20445,19965,8361,1194,1133
6755,1200,2239,6755,0,6365,390,3.01352e+18,93.3147,2840.58,6755,840,103,4516,4516,3454,3804,2756
9948,194,513,2964,6984,0,9948,6.91822e+18,15.9708,878.156,9948,421,18,9435,9435,6119,5832,5454
3661,7,11,3556,105,3657,4,1.41084e+14,10.7419,169.94,3661,11,11,3524,3443,3179,3182,2547
35520,4,15,34494,1026,35462,58,1.57648e+14,10.6036,624.876,35520,13,11,4453,3143,2782,3064,2236
9573,2108,2330,9013,560,9013,560,4.08933e+18,97.2488,3363.77,9573,1087,111,30966,30966,30501,33265,0
21458,2506,5009,0,21458,7539,13919,2.53291e+15,59.953,6694.02,21458,2434,72,25369,25369,16739,14703,9240
19444,1879,6903,18483,961,18483,961,2.55886e+18,96.1407,8447.36,19444,3285,111,12541,12541,4578,8004,4320
5802,141,175,5801,1,5802,0,5.9662e+18,155.738,904.393,5802,107,107,5509,5170,4697,4710,4698
30494,747,12209,30494,0,28919,1575,4.24858e+18,197.266,13567.1,30494,4932,128,28386,27427,13186,19188,2256
30837,178,208,30756,81,30837,0,6.01488e+18,197.374,2271.94,30837,171,171,36754,36754,36754,36754,36754
766,237,268,719,47,0,766,2.25194e+18,80.577,416.493,766,108,40,498,498,481,482,494
36647,9,16,35569,1078,36555,92,1.77901e+14,10.5117,624.239,36647,14,12,42401,41769,39025,38643,36315
23779,5859,7916,23779,0,22406,1373,4.25315e+18,160.847,9123.19,23779,2906,121,15863,15863,13763,14742,12124
40819,12769,18339,40819,0,38989,1830,4.7179e+18,809.564,20301.3,40819,4857,140,32881,32881,32881,32881,32881
6973,2478,3133,0,6973,0,6973,4.78868e+17,92.3832,3792.61,6973,1501,95,3840,3840,3506,3498,3252
32018,4547,7483,0,32018,11252,20766,2.53266e+15,60.0062,9797.4,32018,3642,72,16423,6061,11488,16412,16261
44481,13,15,43213,1268,44399,82,1.38994e+14,10.6467,666.689,44481,14,12,12790,6239,5549,6571,5261
42009,3919,18891,42009,0,40239,1770,4.64661e+18,1759.89,21386.4,42009,6160,143,33879,33879,30223,33098,24311
6747,2348,2560,0,6747,2538,4209,2.06232e+15,57.1535,3157.52,6747,1237,72,6535,6286,14367,13288,6030
28986,92,1057,0,28986,28151,835,3.80971e+16,215.77,3341.57,28986,160,26,27629,27479,18941,18132,7187
9593,3741,4123,9173,420,0,9593,1.68071e+18,72.3185,4976.26,9593,1967,99,29874,29874,29668,29668,33873
40546,4570,14371,40546,0,38308,2238,3.79964e+18,280.802,16094,40546,5605,129,32720,32559,22098,25707,10624
40828,6,14,39663,1165,40748,80,1.39455e+14,10.4669,612.447,40828,13,12,40781,40765,40597,40580,40439
36439,936,21080,35269,1170,35269,1170,2.20028e+18,92.0619,22910.2,36439,10246,110,35908,35908,35908,35908,35908
42663,17,176,42523,140,42663,0,6.15047e+18,172.135,2551.87,42663,164,165,30819,28874,28732,28957,28682
1954,436,553,1844,110,1844,110,3.24496e+18,90.2303,873.459,1954,235,58,1401,1401,1317,1376,0
40525,462,1265,0,40525,39362,1163,3.7285e+16,255.197,4257.88,40525,200,26,28388,27908,16158,25968,1725
21708,2467,5071,7621,14087,0,21708,9.90403e+12,59.9406,6767.9,21708,2468,72,16637,16637,12891,15987,8441
29073,681,7018,27383,1690,27383,1690,3.75764e+18,98.1523,9382.5,29073,3312,111,28877,28877,28877,28877,28877
31754,3,14,30845,909,31704,50,1.43955e+14,10.6525,560.445,31754,13,11,24363,17322,19814,20605,10090
14288,64,176,14276,12,14288,0,6.02351e+18,167.674,1463.27,14288,134,144,35124,24438,13905,15125,12806
45260,14486,14716,0,45260,16649,28611,2.22721e+15,58.6085,17484,45260,7163,72,30544,30544,30271,30111,29996
12297,3438,5045,12297,0,11681,616,3.75829e+18,126.899,5869,12297,2096,121,7252,7252,6304,6656,5770
776,29,58,0,776,752,24,3.54717e+16,17.2964,150.949,776,20,22,718,718,644,647,469
11620,3598,3926,11029,591,11029,591,2.99554e+18,95.4209,5014.31,11620,1886,110,7694,7694,7425,7640,7460
9046,83,2229,8526,520,0,9046,2.21317e+18,96.4407,3228.86,9046,1052,110,5712,1872,1926,1556,254
22523,3830,5298,21213,1310,0,22523,2.22857e+18,97.5706,7294.01,22523,2548,110,36762,36762,36762,36762,36762
41936,6674,14425,39846,2090,0,41936,1.90891e+18,94.5756,17292.7,41936,6997,110,25272,25272,13784,14991,9138
9999,1335,2880,9449,550,9449,550,3.95543e+18,95.2478,3901.68,9999,1334,111,7119,7119,4743,5119,3968
48529,2233,20685,18706,29823,0,48529,7.39365e+12,56.8507,23254.4,48529,10056,72,34476,33985,25149,29005,19982
14546,387,4554,5314,9232,0,14546,8.87434e+12,54.2993,5699.11,14546,2197,72,9992,9984,2648,180,0
49622,3542,14922,49622,0,46732,2890,4.21756e+18,339.721,17308.7,49622,5906,130,49215,49215,49215,49215,49215
2038,146,511,715,1323,0,2038,1.00004e+13,57.8489,799.182,2038,247,55,1527,1527,823,1315,550
8408,2,11,8171,237,8407,1,1.38327e+14,10.1376,253.071,8408,11,11,4862,3435,3389,3583,2854
17098,169,175,17031,67,17098,0,5.98119e+18,165.352,1548.4,17098,143,154,28965,28580,10831,8131,860
17610,1184,4149,6190,11420,0,17610,9.83829e+12,59.8097,5588.25,17610,2005,72,13461,13461,9212,12730,4125
33120,2738,10130,33120,0,31197,1923,3.69833e+18,229.495,11882.9,33120,3466,130,22990,22688,14684,17258,6936
9239,2553,5987,3919,5320,0,9239,4.59606e+12,47.2158,6484.53,9239,2894,69,3252,3252,2157,3022,500
3042,139,170,3042,0,3042,0,6.01702e+18,143.552,649.194,3042,86,82,2822,2659,2433,2443,2393
32124,4518,9444,0,32124,0,32124,5.97438e+17,96.811,11908,32124,4577,110,32574,32574,32574,32574,32574
32609,97,176,32550,59,32609,0,6.07669e+18,172.843,2235.99,32609,165,161,27362,24623,15531,5490,744
11628,4843,11628,11628,0,0,11628,7.99931,0,11628,11628,11628,1,0,0,0,0,0
14620,65,676,0,14620,14204,416,3.65759e+16,20.0034,1818.9,14620,86,26,13944,13936,9197,9182,2784
21399,1063,6925,7857,13542,0,21399,8.73092e+12,58.5084,8448.22,21399,3367,72,31825,31825,15625,24735,5050
36682,5950,8590,34549,2133,34549,2133,5.89515e+18,97.7951,11502.2,36682,4158,110,28092,28092,27439,27442,20446
16566,4679,5209,16566,0,15596,970,3.7495e+18,133.18,6289.08,16566,1990,121,20511,20495,16793,18612,10826
38856,485,1108,0,38856,37748,1108,3.55337e+16,231.364,3754.58,38856,170,26,34247,34247,24399,31322,20416
11841,2657,2871,0,11841,0,11841,6.43176e+17,96.8753,4091.92,11841,1375,110,22130,22130,22130,22130,22130
686,107,209,241,445,0,686,9.90385e+12,52.3047,332.944,686,95,36,477,477,340,447,289
45986,3885,11786,0,45986,0,45986,6.29338e+17,97.5415,15187.8,45986,5717,110,45672,45672,45672,45672,45672
47159,12056,17571,47159,0,41801,5358,1.68507e+18,5188.49,25553.9,47159,6518,27,36566,36566,36566,36566,36566
41709,47,176,41652,57,41709,0,5.99777e+18,172.85,2444.05,41709,170,172,14650,3218,7590,8444,92
18550,4497,6944,17659,891,17659,891,2.39018e+18,93.8633,8402.82,18550,3302,111,11606,11606,10024,11499,7793
33476,322,13637,31964,1512,0,33476,1.72849e+18,94.9285,15855.6,33476,6624,110,19839,18979,9082,5113,2041
20242,197,200,20234,8,20242,0,5.98645e+18,180.893,1737.26,20242,155,159,22348,22718,22718,22718,22718
22642,6191,6901,0,22642,8250,14392,2.30439e+15,57.9334,8526.51,22642,3355,72,26119,26119,23512,23075,12890
25459,7684,15083,24669,790,0,25459,1.19239e+18,91.848,16445.3,25459,7310,110,10376,10376,8027,7453,6138
29307,5873,6831,27597,1710,27597,1710,5.85925e+18,97.7694,9280,29307,3308,110,28151,27859,19809,17050,10755
10675,62,170,10668,7,10675,0,5.97343e+18,162.729,1217.28,10675,129,134,7517,4041,3368,3847,3826
44939,22863,23782,43329,1610,0,44939,1.37266e+18,92.4752,26118.6,44939,11551,110,44193,44193,44193,44193,44193
25053,9494,12918,25053,0,24063,990,4.55187e+18,217.858,14216,25053,4829,133,12135,12126,9909,11302,4816
16060,2240,6595,15330,730,15330,730,4.0506e+18,91.278,7850.73,16060,3136,111,24966,24966,21537,22936,16773
13339,121,176,13333,6,13339,0,5.98825e+18,164.915,1381.79,13339,135,143,38873,38873,38873,38873,38873
14166,3232,3349,0,14166,4988,9178,2.52714e+15,59.767,4564.15,14166,1624,72,10817,10817,10682,10794,10634
7880,91,175,7876,4,7880,0,6.00031e+18,159.487,1053.81,7880,117,120,6729,4145,3845,4074,4072
43612,1401,43612,0,43612,43612,0,2047.95,0,43612,43612,43612,1,34059,34059,26755,17495,17407
19466,3616,5110,0,19466,0,19466,6.26143e+17,97.0234,6844.78,19466,2467,110,14356,14356,12404,10547,10375
8247,713,2029,7767,480,7767,480,5.70309e+18,96.9007,2954.93,8247,945,106,6218,6218,3753,4428,2704
31813,4,14,30906,907,31732,81,1.38928e+14,10.6996,549.628,31813,13,12,2950,771,532,533,28
26275,10511,12999,10448,15827,0,26275,6.5289e+12,54.1461,14423.7,26275,6316,72,13276,13276,12037,13016,10134
23827,413,828,0,23827,23147,680,3.55162e+16,131.675,2519.94,23827,114,26,15587,14675,6559,191,43
9969,111,431,0,9969,9687,282,3.56493e+16,20.0331,1210.78,9969,63,26,9538,9538,7294,7287,3702
14584,7037,7671,5872,8712,0,14584,6.1436e+12,55.1468,8532.85,14584,3733,72,6913,6913,6856,6897,6856
41872,152,176,41788,84,41872,0,5.9973e+18,173.382,2460.28,41872,172,171,46906,46587,40039,37881,11866
26878,577,10977,0,26878,10281,16597,1.95743e+15,56.3002,12617.5,26878,5341,72,15901,15582,7350,4122,425
23123,8,11,22459,664,23109,14,1.45223e+14,10.1445,431.296,23123,11,11,22585,22294,17506,17624,17463
49991,1390,23244,0,49991,0,49991,4.52017e+17,94.2272,26047.5,49991,11290,110,38433,40638,16176,16176,16176
42831,4609,12876,40553,2278,40553,2278,3.11582e+18,96.8195,15938.6,42831,6249,110,32954,32954,26894,25433,16552
32780,936,1435,0,32780,31821,959,4.30983e+16,289.026,4545.01,32780,236,26,36217,36217,21583,3069,3678
47524,1110,1272,0,47524,46167,1357,3.55648e+16,260.983,4461.26,47524,202,26,32008,32003,19365,28575,18640
39747,10440,14437,37825,1922,37825,1922,7.6236e+18,94.3314,17121.2,39747,7003,110,44057,44057,44057,44057,44057
3408,153,156,0,3408,3311,97,3.53522e+16,19.6018,460.96,3408,37,26,3252,3252,3251,3251,3252
13154,209,571,12606,548,3843,9311,1.26538e+18,16.975,1007.81,13154,559,19,12583,12583,10814,11160,6892
28534,1102,9700,27101,1433,27101,1433,2.96449e+18,96.0602,11835.7,28534,4708,110,18834,18834,11049,12966,2400
9671,59,3315,9671,0,9111,560,3.27385e+18,92.1294,4001.76,9671,1177,117,4380,1063,2004,3824,136
12141,516,622,12141,0,11640,501,2.34135e+18,17.7661,1045.93,12141,511,21,46047,46047,45806,45557,44686
19753,1675,4629,6939,12814,0,19753,9.91687e+12,59.8813,6201.52,19753,2247,72,21700,21700,14642,18546,6797
38134,5754,9140,35910,2224,35910,2224,4.15741e+18,98.2966,12058.9,38134,4320,111,37812,37812,37812,37812,37812
17816,16275,17816,17816,0,0,17816,134210000,0,17816,17816,17816,1,0,0,0,0,0
2815,894,1196,2685,130,0,2815,1.76866e+18,90.1734,1547.89,2815,555,70,1619,1619,1588,1505,1598
40840,2773,14857,0,40840,0,40840,5.38747e+17,95.8129,17596.3,40840,7214,110,24392,22996,17200,18628,10436
28144,6933,11362,0,28144,0,28144,5.06244e+17,94.9916,13315,28144,5512,110,34891,34891,34891,34891,34891
39837,17507,19460,38277,1560,38277,1560,5.68126e+18,94.4794,21687.2,39837,9374,111,26605,26605,26605,26605,26605
10620,417,645,0,10620,10313,307,4.01202e+16,19.6262,1633.26,10620,81,26,9975,9975,9664,9659,7656
9907,2448,3331,9907,0,9327,580,4.06466e+18,92.2668,4031.29,9907,1179,117,6576,6576,5714,6104,5281
46381,1397,10845,0,46381,0,46381,6.47975e+17,97.9055,14353.3,46381,5263,110,32787,32153,15194,21169,3749
20821,2778,4872,7311,13510,0,20821,9.87077e+12,59.9269,6516.95,20821,2365,72,15949,15949,13414,15419,9297
37077,12,16,35968,1109,37011,66,1.93496e+14,10.3533,679.026,37077,13,12,34071,31883,27439,26327,5695
44413,5864,10365,15616,28797,0,44413,9.90461e+12,60.0752,13389.3,44413,5049,72,27322,27322,10829,14804,1023
9959,2046,3401,9959,0,9379,580,4.079e+18,92.3029,4099.92,9959,1212,118,6558,6558,5090,5798,4313
18087,4276,7001,18087,0,17150,937,3.50456e+18,154.256,8090.68,18087,2906,121,11086,11086,8952,9666,7264
13449,4,10,13061,388,13443,6,1.55189e+14,9.94669,329.919,13449,10,10,948,307,98,272,43
34987,453,1035,0,34987,33989,998,3.555e+16,213.656,3440.58,34987,155,26,22803,22029,16511,12210,12439
37059,12250,17350,37059,0,27772,9287,4.58926e+18,543.22,19104.9,37059,7187,136,36884,36884,36884,36884,36884
45221,4292,10557,15898,29323,0,45221,9.8843e+12,60.059,13627.5,45221,5139,72,0,0,0,0,0
9774,1,11,9496,278,9768,6,1.39298e+14,10.4383,277.942,9774,11,11,2502,2502,2502,2502,2502
49079,13994,15749,46549,2530,0,49079,1.97494e+18,96.5187,19084.8,49079,7641,110,32512,32512,30775,28672,27977
41855,12620,14020,41855,0,39475,2380,4.78403e+18,270.473,15787.5,41855,3612,134,27835,27835,27255,27781,25558
4225,855,1629,1585,2640,0,4225,8.04047e+12,56.4847,2048.21,4225,788,69,2596,2596,1900,2476,1301
36560,12044,12457,34717,1843,34717,1843,2.43432e+18,96.6998,14987.7,36560,5953,111,33106,33106,33106,33106,33106
29560,166,176,29508,52,29560,0,6.05984e+18,171.965,2117.91,29560,164,161,38739,38733,38734,38734,38507
24626,2975,5832,23196,1430,23196,1430,5.91562e+18,97.5953,7963.62,24626,2817,110,18794,18794,18084,18084,10413
11632,2323,3348,0,11632,4194,7438,2.35502e+15,58.8715,4340.44,11632,1618,72,8284,8284,7989,7799,7838
15871,1150,3780,14951,920,0,15871,2.22517e+18,97.2658,5307,15871,1809,110,12091,12091,7416,6840,27621
21009,2762,6895,21009,0,19781,1228,3.20229e+18,152.507,8015.42,21009,2509,125,14599,14909,10083,11724,6489
46148,9779,16835,0,46148,0,46148,5.36889e+17,95.7894,19844.7,46148,8173,110,34003,34003,33539,33735,32451
25510,4429,6187,0,25510,0,25510,6.4143e+17,97.5143,8364.13,25510,2990,110,22813,22813,13384,19060,4925
48120,5723,19048,48120,0,46091,2029,5.05786e+18,3102.35,22819.9,48120,7934,149,2612,2612,2430,2047,2047
12927,34,176,12882,45,12927,0,6.0991e+18,167.743,1408.13,12927,128,130,13798,2097,7026,11747,114
22933,2827,5337,0,22933,8061,14872,2.54058e+15,59.9931,7111.78,22933,2599,72,17596,17596,14607,10642,9710
40169,7,15,38971,1198,40101,68,1.86667e+14,10.2878,701.952,40169,13,11,38746,33666,22644,25339,6234
46351,6422,10845,43651,2700,0,46351,2.22822e+18,97.8507,14348.3,46351,5263,110,38191,38191,37107,36784,36320
39285,8772,18220,37672,1613,37672,1613,2.29064e+18,94.345,20502.8,39285,8764,111,44702,44702,44702,44702,44702
11924,2698,2811,11224,700,0,11924,2.23945e+18,97.0185,4044.38,11924,1350,110,9113,9113,8986,9004,9000
22558,12,14,21889,669,22504,54,1.82713e+14,10.5821,494.981,22558,13,11,22544,22543,22057,22057,18785
12620,885,3032,11887,733,11887,733,5.90427e+18,97.0675,4316.65,12620,1451,110,9588,9588,9065,8719,3491
42072,4967,9828,0,42072,14801,27271,2.53031e+15,60.0625,12722.9,42072,4782,72,32864,32864,19763,25682,13543
34668,4094,8130,32648,2020,32648,2020,3.35966e+18,97.7847,10913.5,34668,3933,110,26538,26538,18414,22091,14461
38157,4435,13954,0,38157,0,38157,5.3725e+17,95.7275,16544.3,38157,6774,110,37996,37996,37996,37996,37996
47608,6869,19085,0,47608,18138,29470,1.97733e+15,57.2077,21704.4,47608,9277,72,46953,46953,46953,46953,46953
26793,5094,10613,0,26793,10188,16605,1.99611e+15,56.3875,12276.9,26793,5163,72,20031,20031,18725,19003,18560
19886,2558,4712,7000,12886,0,19886,9.90015e+12,59.8878,6287.67,19886,2294,72,19382,19382,12816,14457,8975
34343,10223,15609,0,34343,13413,20930,1.7979e+15,56.4293,17476.6,34343,7587,72,26555,26501,23356,21373,18493
40800,1175,10208,0,40800,14467,26333,2.47246e+15,59.792,12984.1,40800,4961,72,43762,43762,43762,43762,43762
14686,179,208,14607,79,14686,0,6.12675e+18,195.202,1615.26,14686,139,140,14292,14001,12686,12634,12624
14735,100,176,14665,70,14735,0,6.06448e+18,166.488,1495.96,14735,134,138,13245,9264,7930,8262,8236
20270,1,6,19937,333,20238,32,9.81205e+13,3.99684,326.542,20270,5,4,8267,8267,8267,8267,8267
46462,16390,18123,17618,28844,0,46462,7.85965e+12,57.5793,20729,46462,8823,72,36800,36800,36800,36800,36800
8393,2686,5465,3571,4822,0,8393,4.58689e+12,27.0581,5922.64,8393,2656,66,2928,2928,1879,396,0
34397,1,12,33414,983,34382,15,1.38819e+14,10.2669,525.153,34397,12,11,158,158,158,158,158
15669,151,175,15661,8,15669,0,5.98292e+18,164.635,1481.68,15669,141,148,15284,14844,13697,13660,13675
27976,5404,7379,26408,1568,0,27976,2.14484e+18,97.2316,9664.4,27976,3570,110,36760,36760,30270,26284,19237
44072,19,176,44002,70,44072,0,6.1253e+18,173.685,2599.33,44072,170,168,24275,14505,15970,18007,12342
12369,605,2874,0,12369,4347,8022,2.54856e+15,59.8185,3971.5,12369,1400,72,9495,9495,6146,3405,2177
6228,1223,2500,6228,0,5898,330,6.13818e+18,83.2455,3003.18,6228,474,100,3728,3728,3141,3725,1673
25015,1,12,24301,714,25001,14,1.38684e+14,10.4443,448.103,25015,12,11,5938,5938,5938,5938,5938
14947,2806,4539,0,14947,0,14947,5.90821e+17,96.1343,5902.83,14947,2184,110,10408,10408,9198,8591,7493
28284,3592,8857,26794,1490,26794,1490,5.83412e+18,97.0683,11004.8,28284,4222,111,19427,19427,16211,17563,8296
27490,4244,9031,26070,1420,26070,1420,3.34016e+18,96.7984,11091.8,27490,4309,111,20953,20953,16525,17392,14256
30916,1220,10424,29356,1560,29356,1560,3.10577e+18,96.1199,12702.5,30916,5053,110,48995,48995,48995,48995,48995
11598,906,2798,0,11598,0,11598,6.46232e+17,96.4089,4003.63,11598,1337,110,8800,8800,6226,4104,3280
35623,8391,14080,33983,1640,33983,1640,2.90944e+18,94.0411,16448.1,35623,6836,110,21543,21543,15249,17833,12841
11491,2452,2774,10822,669,0,11491,2.22602e+18,96.959,3968.73,11491,1326,110,8717,8717,8451,8364,8273
12142,741,12142,12142,0,12142,0,34356900000,0,12142,12142,12142,1,0,0,0,0,0
41452,8817,9686,14578,26874,0,41452,9.8748e+12,60.0663,12549.2,41452,4714,72,33879,33813,33813,33813,33813
20746,4498,10252,19946,800,19946,800,9.53677e+18,93.4031,11626.7,20746,4974,110,20085,20085,15926,10065,5993
30760,1521,11032,29258,1502,29258,1502,2.90286e+18,95.7536,13242.6,30760,5342,110,23783,23783,16675,17232,7284
43934,1299,14254,0,43934,0,43934,5.70914e+17,96.4085,17294.9,43934,6914,110,36777,36777,14795,30040,4575
40762,10017,15906,38872,1890,0,40762,1.77538e+18,95.1674,18554.4,40762,7713,110,20222,20222,13737,19990,13049
30787,769,7198,0,30787,10822,19965,2.52805e+15,60.0187,9445.38,30787,3500,72,30719,30719,30719,30719,30719
44842,5714,19654,44842,0,43062,1780,4.4795e+18,2925.18,22945.6,44842,6835,144,34986,34986,30989,34148,24360
624,3,10,603,21,624,0,1.40286e+14,8.91506,69.2083,624,10,10,463,315,365,392,252
28397,6191,11590,10850,17547,0,28397,7.65578e+12,57.171,13300.9,28397,5629,72,39664,39664,39664,39664,39664
40851,16858,17103,0,40851,0,40851,4.91386e+17,94.8954,19656.1,40851,8306,110,36954,37254,0,505,894
33644,2072,2159,32274,1370,10359,23285,1.82947e+18,16.9894,2859.57,33644,1381,19,31485,31485,31399,31465,30536
48534,60,1422,0,48534,47144,1390,3.71022e+16,287.615,4928.9,48534,231,26,27998,15930,18617,25091,5695
14418,98,876,0,14418,13993,425,4.41552e+16,154.529,2380.35,14418,123,26,13397,13288,10989,9578,3135
11094,2110,4184,10564,530,0,11094,1.82977e+18,93.8755,5195.68,11094,2000,110,6910,6910,5620,4919,3788
33917,1400,7925,0,33917,11918,21999,2.52555e+15,60.0124,10354.7,33917,3849,72,31663,31639,31317,31637,30492
36192,7503,10940,0,36192,0,36192,5.90511e+17,96.6493,13618.6,36192,5305,110,30695,30695,26718,29967,21564
1929,427,870,0,1929,751,1178,1.91591e+15,44.1908,1090.43,1929,418,49,1059,1059,611,13,35
16907,1948,9345,0,16907,3643,13264,1.36173e+13,8.8671,9592.48,16907,8402,11,7562,7562,2944,7562,2654
11810,622,2811,0,11810,4162,7648,2.52809e+15,59.7047,3865.02,11810,1363,72,8999,8999,4239,2749,1934
17332,4291,9484,16724,608,16724,608,3.94272e+18,90.7252,10577,17332,4552,111,7848,7848,5727,7154,3876
17004,3061,8964,6845,10159,0,17004,6.11e+12,53.1556,9933.27,17004,4346,72,8040,8040,4811,7210,2168
11884,128,628,3553,8331,3553,8331,1.93101e+18,15.9748,1028.27,11884,501,18,11256,11256,6467,7923,4943
5936,1,11,5765,171,5929,7,1.46286e+14,10.5472,220.169,5936,11,11,1441,1441,1441,1441,1441
19604,26,32,19540,64,19604,0,1.11631e+18,31.9478,792.04,19604,32,32,38377,0,0,0,55
25249,4224,7101,0,25249,9090,16159,2.37645e+15,59.2434,8922.07,25249,3457,72,23038,23038,18399,21004,9224
33243,733,1362,0,33243,32273,970,4.15985e+16,264.625,4343.14,33243,221,26,25522,25522,19896,15703,4012
49295,98,176,49206,89,49295,0,6.00991e+18,172.421,2689.38,49295,173,174,27810,15338,15552,13298,10775
36711,5429,11813,36711,0,34573,2138,3.52842e+18,258.739,13445.1,36711,4213,133,25565,25565,21418,23686,14005
30251,11066,11846,0,30251,0,30251,5.15149e+17,95.2283,13943,30251,5747,110,18405,18405,17432,16205,16616
46349,6013,24399,46349,0,46349,0,2.54844e+18,17.9775,25002.1,46349,21948,20,29299,29299,22535,21016,16312
12087,6,11,11744,343,12086,1,1.39119e+14,10.0553,306.371,12087,11,11,3907,1419,839,938,230
5208,370,1631,4928,280,4928,280,3.22664e+18,86.994,2258.13,5208,753,93,3577,3577,1355,2320,0
32242,1636,2093,6567,25675,0,32242,5.7242e+13,12.0041,2680.64,32242,1217,20,30149,30149,27496,26129,28926
32727,6794,7693,0,32727,0,32727,6.4624e+17,97.7319,10355.1,32727,3713,110,25214,25214,24586,24602,23828
28833,4,15,27976,857,28775,58,1.85092e+14,10.4823,586.19,28833,13,11,25319,22654,20893,13436,14780
6939,3848,4099,6939,0,6689,250,4.04223e+18,114.51,4541.07,6939,1800,96,7203,7203,7203,7203,7203
43502,65,176,43422,80,43502,0,5.98219e+18,172.071,2472.13,43502,171,172,25182,10367,21791,19662,5399
1173,57,151,0,1173,1139,34,5.27071e+16,17.6897,334.967,1173,35,25,1022,1014,875,839,603
33412,14,1009,0,33412,32457,955,3.55759e+16,205.995,3322.83,33412,151,26,45988,45957,45697,45692,43907
39922,13,14,38785,1137,39845,77,1.39052e+14,10.6636,621.963,39922,13,12,11623,7687,7421,9734,6429
46079,12572,14023,0,46079,16784,29295,2.29302e+15,58.5784,16906.9,46079,6817,72,35507,35507,35507,35507,35507
31391,481,9183,29701,1690,0,31391,2.06103e+18,96.8213,11607.2,31391,4448,110,22208,22036,9711,6709,2931
4866,1017,3250,4736,130,4736,130,9.18066e+18,75.7725,3605.23,4866,1536,71,1616,1459,1094,1092,904
16983,688,831,0,16983,16491,492,3.9875e+16,124.395,2336.05,16983,115,26,16152,16016,15261,15484,13552
17679,85,176,17671,8,17679,0,5.99569e+18,167.023,1602.32,17679,144,154,15192,5093,10437,3305,1315
14364,343,819,0,14364,13945,419,4.20085e+16,123.751,2216.8,14364,112,26,23024,22874,20797,21115,17857
34794,1083,8346,32766,2028,32766,2028,3.67549e+18,98.2872,11066,34794,3953,111,29170,29170,20222,16771,16421
9308,586,2287,0,9308,0,9308,6.43784e+17,96.5466,3305.08,9308,1090,110,19298,19298,21048,0,0
48007,14740,17690,32604,15403,45687,2320,4.07288e+18,96.3865,20718.1,48007,8483,111,37103,37103,37103,37103,37103
24729,1135,1322,0,24729,23998,731,4.6427e+16,263.868,3989.26,24729,213,26,23407,23407,23148,23140,21699
32108,599,1354,9363,22745,9363,22745,1.74312e+18,15.9892,2025.74,32108,1347,17,30754,30754,20993,23988,26241
7633,6,11,7411,222,7631,2,1.51229e+14,10.386,247.873,7633,11,11,7274,7086,5542,5440,4885
46599,2186,12011,0,46599,0,46599,6.28223e+17,97.5377,15444.3,46599,5828,110,32006,31390,15861,23000,5815
18734,4222,6470,0,18734,6947,11787,2.17199e+15,58.1277,7805.47,18734,3149,72,12264,12264,10510,8219,7724
40858,10136,10322,38538,2320,0,40858,2.17388e+18,97.5513,13430.9,40858,4999,110,30536,30536,30337,30323,30284
21839,1520,7040,21839,0,20589,1250,3.23274e+18,158.174,8332.69,21839,2726,130,21466,21466,21466,21466,21466
36570,28,176,36545,25,36570,0,6.04428e+18,172.403,2346.9,36570,166,168,39495,38870,29298,23523,4770
40063,3111,15314,0,40063,0,40063,5.23725e+17,95.4911,17946.9,40063,7442,110,39739,39739,39739,39739,39739
36659,2575,11567,34731,1928,34731,1928,2.42826e+18,97.1292,14174,36659,5522,111,36829,36829,36829,36829,36829
26469,4291,9594,25170,1299,25170,1299,2.28192e+18,96.2822,11519.7,26469,4596,111,16875,16875,13865,15708,8862
13989,3324,4847,0,13989,0,13989,5.56991e+17,94.2852,6087.88,13989,2336,110,9142,9142,8165,8313,6876
13126,2006,4864,0,13126,4924,8202,2.09517e+15,57.6083,5848.86,13126,2365,72,39284,39284,39284,39284,39284
21651,3768,5222,20391,1260,20391,1260,3.06614e+18,97.9837,7112.85,21651,2456,111,16429,16429,13682,14277,12467
45843,11203,19401,43818,2025,43818,2025,4.9239e+18,95.5363,22120.8,45843,9331,111,45263,45263,45263,45263,45263
8602,11,12,8345,257,8594,8,1.93387e+14,10.0051,279.123,8602,12,11,8590,8590,8493,8494,7919
39073,6624,9149,0,39073,13745,25328,2.52608e+15,60.0431,11874.6,39073,4448,72,30050,30050,17454,15371,7310
46929,26,176,46825,104,46929,0,6.13234e+18,174.06,2681.35,46929,172,171,22224,15529,0,0,123
17777,3446,4215,0,17777,0,17777,6.48069e+17,97.3487,5877.27,17777,2030,110,13562,13562,12696,11824,11577
19425,9,12,18858,567,19414,11,1.62002e+14,10.2208,410.093,19425,12,11,10113,2572,2527,1960,2094
10846,252,5932,10846,0,10416,430,4.01127e+18,130.233,6555.06,10846,2590,111,4914,4543,2108,3183,843
23844,958,7242,0,23844,8679,15165,2.30526e+15,58.8375,8934.77,23844,3528,72,16602,16506,10634,7599,3442
38834,30,176,38818,16,38834,0,5.98481e+18,172.363,2336.56,38834,169,172,15041,1904,8028,8378,1316
6974,276,370,0,6974,6775,199,3.78473e+16,19.774,994.282,6974,58,26,6604,6604,6404,6426,5031
40417,16416,17882,40417,0,38520,1897,4.16121e+18,298.128,19585.6,40417,4324,141,22535,22535,21976,22305,21495
37970,12936,17268,37970,0,36310,1660,4.94539e+18,591.946,19241,37970,7301,140,45576,45576,45576,45576,45576
11858,98,176,11814,44,11858,0,6.17656e+18,157.608,1337.26,11858,118,117,10705,8494,6700,6809,6930
42170,69,176,42106,64,42170,0,5.99611e+18,173.024,2459.98,42170,171,173,19084,5020,8204,14769,632
22345,2678,8034,21245,1100,21245,1100,5.14293e+18,94.4285,9739.35,22345,3838,111,15837,15837,12029,10661,6863
21941,328,794,0,21941,21315,626,3.55148e+16,109.644,2365.1,21941,107,26,18081,18081,6082,1903,2209
1355,4,10,1316,39,1355,0,1.37933e+14,9.36384,100.465,1355,10,10,1185,1057,1045,947,802
24596,4,12,23880,716,24575,21,1.61199e+14,10.0527,461.051,24596,11,12,1848,474,0,499,12
31082,6967,11526,0,31082,0,31082,5.33599e+17,95.5521,13721.1,31082,5588,110,33343,33343,25059,20491,15271
8924,144,2210,8412,512,8412,512,5.82346e+18,96.3946,3197.55,8924,1049,108,6714,6631,4929,3748,897
16679,367,8129,0,16679,0,16679,4.36035e+17,93.2987,9308.59,16679,3931,110,8550,8120,3394,1898,1718
48995,12599,16612,46535,2460,0,48995,1.92231e+18,95.5837,19872.8,48995,8068,110,46882,46882,46882,46882,46882
17195,2,14,16679,516,17118,77,1.98056e+14,10.547,439.975,17195,13,11,10404,8582,4872,8624,2782
45603,7,176,45519,84,45603,0,5.98489e+18,171.886,2539.28,45603,171,171,8320,2403,20,4508,28
10035,2432,5421,2171,7864,0,10035,52970600000,8.88321,5613.44,10035,4872,11,4614,4614,2667,4614,2536
13597,683,3255,12807,790,12807,790,3.23165e+18,97.1397,4613.53,13597,1560,110,10342,10342,5844,8016,2892
47179,8219,18606,45272,1907,44992,2187,4.67222e+18,1735.39,21514.1,47179,7831,142,38501,38501,37946,38401,37439
18491,3701,7888,18491,0,17571,920,3.89176e+18,142.53,8848.3,18491,3208,124,10603,10587,7452,8904,5591
25568,5558,5993,24077,1491,0,25568,2.23196e+18,97.6513,8188.74,25568,2898,110,26413,26291,18299,23788,12913
46892,5473,10925,0,46892,16488,30404,2.53141e+15,60.0889,14095.7,46892,5318,72,32784,32578,24267,28235,14391
8610,304,6894,0,8610,0,8610,1.8097e+17,25.1045,7262.7,8610,3323,67,1716,1716,1344,1433,1052
11135,9,13,10813,322,11063,72,1.56322e+14,10.9328,335.741,11135,13,12,10970,10842,10520,10134,8438
37298,10129,10509,0,37298,0,37298,6.07324e+17,97.0524,13313.8,37298,5096,110,36389,36389,36389,36389,36389
36097,1,15,35040,1057,36037,60,1.69258e+14,10.3225,632.377,36097,12,12,7172,8964,8964,8964,8964
29609,9539,11071,28197,1412,0,29609,1.82696e+18,95.5063,13178.8,29609,5371,110,28829,28829,27068,26631,16920
2412,437,668,2270,142,2270,142,3.31158e+18,92.6082,1038.38,2412,289,63,1744,1744,1358,1465,1370
5150,1,10,5002,148,5145,5,1.51669e+14,9.84039,203.11,5150,10,10,1189,1189,1189,1189,1189
45103,11141,12296,16172,28931,0,45103,9.37675e+12,59.3794,15234.5,45103,5985,72,44879,44879,44879,44879,44879
41863,2873,15870,39883,1980,39883,1980,2.88253e+18,95.552,18606.7,41863,7705,110,29362,29362,21569,11283,11745
48331,901,19251,48331,0,46423,1908,4.67453e+18,3814.05,23568,48331,7924,150,41447,41447,35026,30606,30102
24946,558,849,0,24946,24232,714,3.55204e+16,144.545,2616,24946,118,26,22068,21801,11291,15059,2003
28467,113,916,0,28467,27655,812,3.5582e+16,174.461,2912.71,28467,132,26,18893,5339,8029,12434,999
25569,4563,12543,25569,0,25569,0,2.82739e+18,17.9766,13004.6,25569,11279,20,13026,13026,5112,4718,4782
44144,6111,17546,42111,2033,42111,2033,1.76004e+18,95.8914,20276.9,44144,8415,111,43859,43859,43859,43859,43859
19139,2406,4535,18029,1110,0,19139,2.22462e+18,97.3852,6294.84,19139,2178,110,14604,14604,11785,11244,8569
28864,1017,7109,27194,1670,27194,1670,5.74857e+18,98.0649,9447.57,28864,3359,111,35503,0,6947,1152,0
19609,99,176,19597,12,19609,0,6.03901e+18,170.113,1715.52,19609,151,151,17633,11984,10413,10908,11166
3382,1429,1695,0,3382,1336,2046,1.6716e+15,50.2185,2004.48,3382,803,66,1687,1687,1687,1687,1687
2433,21,612,856,1577,0,2433,1.01207e+13,57.7945,933.655,2433,298,58,969,176,350,843,126
42837,8,16,41584,1253,42773,64,1.67346e+14,10.3722,694.92,42837,12,12,37148,34315,25087,26021,9136
38157,508,1095,0,38157,37067,1090,3.55407e+16,228.313,3698.05,38157,167,26,38116,38116,38116,38116,38116
4890,1073,1226,0,4890,0,4890,6.37477e+17,95.0018,1863.71,4890,564,85,3664,3664,3534,3481,3484
5047,1087,1237,4747,300,4747,300,3.22627e+18,95.6564,1889.77,5047,583,87,3810,3810,3673,3763,3611
3428,412,834,0,3428,1203,2225,2.53684e+15,58.7617,1256.49,3428,401,63,22624,22624,22014,21443,20756
28078,3031,6584,9871,18207,0,28078,9.89516e+12,59.9719,8663.53,28078,3204,72,28348,28348,28348,28348,28348
2173,99,659,2052,121,0,2173,2.1497e+18,89.1822,996.452,2173,297,58,1448,526,927,750,213
27320,4,8,26833,487,27256,64,1.00453e+14,3.99784,422.843,27320,6,4,2564,1268,617,308,278
34032,66,176,33968,64,34032,0,6.10469e+18,172.789,2285.33,34032,159,165,25410,18431,19220,18421,15542
3656,107,176,3655,1,3656,0,5.97573e+18,145.812,730.402,3656,89,88,3242,2320,2144,2213,2240
13157,3882,8944,13157,0,12807,350,5.49878e+18,122.01,9585.86,13157,2926,114,9513,9473,9318,9351,9351
35867,4521,11563,35867,0,33777,2090,5.33432e+18,251.112,13167,35867,4180,133,21380,21380,14616,7950,7106
43367,5476,18445,43367,0,41867,1500,4.71494e+18,3889.11,22804.7,43367,6018,146,24234,24234,17365,8667,9138
3054,538,767,1071,1983,0,3054,9.82618e+12,58.1667,1148.86,3054,369,62,38570,38570,0,0,0
34399,63,208,34334,65,34399,0,6.1474e+18,199.728,2471.53,34399,171,167,40804,40696,40684,40625,39994
44631,12723,14429,42321,2310,42321,2310,2.64888e+18,97.0441,17447.7,44631,6893,111,25284,25284,21405,17682,17227
24529,50,175,24521,8,24529,0,5.98134e+18,166.777,1852.9,24529,162,160,15607,7658,6065,7170,7082
15215,2072,6717,0,15215,5908,9307,1.8575e+15,56.426,7726.92,15215,3267,72,8498,8498,5587,1932,2269
26678,2129,9392,0,26678,0,26678,5.50747e+17,95.8458,11389.4,26678,4556,110,20866,20866,15972,14943,10060
15670,3,12,15225,445,15663,7,1.38923e+14,10.2815,351.754,15670,12,11,11946,8385,10368,10398,6979
12666,348,648,0,12666,12299,367,3.77469e+16,19.9238,1704.75,12666,83,26,12018,12018,10479,10640,7092
21864,2878,9504,20923,941,0,21864,1.65178e+18,90.2832,11056.1,21864,4590,110,27748,27748,19164,17365,9068
46263,123,176,46179,84,46263,0,6.00503e+18,172.523,2598.29,46263,173,173,35775,623,594,1188,472
38243,8,15,37120,1123,38183,60,1.71831e+14,10.4597,666.578,38243,13,11,6446,1400,277,2952,637
14536,2114,5914,13868,668,13868,668,4.89052e+18,93.9638,7085.32,14536,2832,111,8622,8622,5400,6024,4538
3374,735,923,0,3374,0,3374,6.37822e+17,93.8115,1399.83,3374,428,71,2451,2451,2238,2164,2183
49657,451,11889,46767,2890,46767,2890,2.44964e+18,98.3803,15487.3,49657,5628,111,46568,46568,42969,40251,39370
49126,4815,11778,46270,2856,46270,2856,3.51155e+18,98.3441,15342.3,49126,5567,111,32561,32561,20947,29080,10565
42900,16367,17642,40980,1920,40980,1920,2.7426e+18,92.7924,20324.7,42900,8553,110,40830,40830,40830,40830,40830
16228,7696,8100,6458,9770,0,16228,6.49787e+12,55.6123,9072.86,16228,3945,72,8128,8128,7744,8041,7280
46116,5745,10791,43427,2689,43427,2689,5.7651e+18,97.8998,14276.8,46116,5233,110,21464,21464,6896,15805,6610
35025,4486,8475,32993,2032,32993,2032,2.38788e+18,98.2062,11203.4,35025,3997,111,26550,26550,18689,20565,15032
35698,242,8357,33618,2080,33618,2080,5.87286e+18,97.8131,11206.5,35698,4047,110,35219,35219,35168,35112,34796
32344,5491,7601,30462,1882,30462,1882,5.77367e+18,97.7476,10236.8,32344,3671,110,25566,25566,24874,25426,23609
42394,1603,9887,0,42394,0,42394,6.48534e+17,97.8722,13154.6,42394,4792,110,36156,36156,27378,26692,22499
37728,259,1094,0,37728,36653,1075,3.56125e+16,230.724,3682.15,37728,166,26,37495,37495,37495,37495,37495
19166,2070,8016,7359,11807,0,19166,7.53265e+12,56.9655,9256.73,19166,3898,72,27473,27473,14559,7310,5638
2329,621,2329,2329,0,2329,0,2.25083e+15,0,2329,2329,2329,1,0,0,0,0,0
35037,288,1039,0,35037,34038,999,3.55507e+16,214.8,3451.63,35037,156,26,33896,33585,29196,29364,14122
37936,3,12,36853,1083,37918,18,1.39098e+14,10.2569,550.97,37936,11,12,2244,679,21,67,34
37766,4358,15714,36086,1680,36086,1680,8.5555e+18,94.9521,18123.6,37766,7637,110,20593,20593,9900,12687,7753
4320,1190,1546,0,4320,0,4320,5.58318e+17,93.1037,2067.04,4320,730,79,2774,2774,2388,2251,2037
31983,13092,16791,31983,0,31003,980,4.78376e+18,2338.42,19383.2,31983,5029,137,24516,24516,18652,20435,18093
19572,3186,5331,7016,12556,0,19572,9.41558e+12,59.3079,6831.08,19572,2597,72,14241,14241,12068,13784,8574
16466,2717,7034,16466,0,15666,800,4.56856e+18,142.247,8017.38,16466,2996,124,9432,9328,6583,7782,4153
16379,294,6792,16379,0,15542,837,5.93741e+18,135.791,7690.64,16379,2732,124,9587,9223,4235,6081,1042
21624,1,11,21007,617,21618,6,1.38759e+14,10.221,411.708,21624,11,11,10278,10278,10278,10278,10278
46605,1109,16097,0,46605,0,46605,5.54105e+17,95.8038,19205.9,46605,7818,110,46208,46208,46208,46208,46208
44469,1930,10422,41882,2587,41882,2587,5.88716e+18,97.8672,13811.6,44469,5057,110,38042,38042,0,0,0
35956,6330,20005,34729,1227,34729,1227,9.16236e+18,92.6212,21853.6,35956,9648,111,28154,28154,25078,24485,21691
26747,5511,8463,25356,1391,0,26747,1.99259e+18,96.3484,10550,26747,4098,110,18284,18284,16007,14908,12446
30886,2341,7276,29094,1792,29094,1792,3.22297e+18,97.6835,9817.83,30886,3511,110,37738,37738,37738,37738,37738
42402,6578,15259,40341,2061,0,42402,1.86356e+18,95.8366,18095,42402,7407,110,27517,26859,22959,23803,19437
36757,1266,8606,34617,2140,34617,2140,3.22799e+18,97.7913,11519.9,36757,4168,110,33732,33654,31154,30729,28667
10054,103,176,10017,37,10054,0,5.99183e+18,163.955,1219.38,10054,126,124,8478,6963,7213,7450,6515
41179,150,206,41164,15,41179,0,5.9803e+18,194.785,2488.29,41179,179,174,41048,41048,41048,41048,41048
30178,3390,10704,30178,0,28502,1676,4.93391e+18,204.949,12100.7,30178,2377,133,35181,35181,22318,17173,11541
3336,1895,2166,2961,375,0,3336,2.42647e+18,5.44424,2506.58,3336,718,13,1170,1170,1136,1146,1046
36442,766,1648,0,36442,35373,1069,4.4561e+16,299.764,5256.75,36442,278,26,34794,34794,32414,31805,20600
36184,3147,12757,34392,1792,34392,1792,4.77541e+18,96.5099,15233.8,36184,6097,111,26393,26393,21446,20392,16031
2475,101,825,904,1571,0,2475,8.92065e+12,56.76,1128.04,2475,401,63,1650,1492,661,1357,370
41018,3503,15627,0,41018,15487,25531,2.04326e+15,57.7035,18008,41018,7609,72,40792,40792,40792,40792,40792
2331,9,10,2262,69,2331,0,1.77869e+14,9.69927,137.506,2331,10,10,2307,2294,2266,2267,2135
33868,955,8138,31898,1970,31898,1970,5.16063e+18,98.2323,10803.6,33868,3848,111,25730,25730,15692,19766,4636
24374,19,837,0,24374,23679,695,3.55055e+16,134.646,2566.28,24374,116,26,15712,3427,4578,4615,4226
20589,370,801,0,20589,19997,592,3.6384e+16,112.039,2346.5,20589,109,26,19788,19660,16277,16558,11279
42393,1932,13567,42393,0,39923,2470,4.15338e+18,300.393,15377.3,42393,3722,134,44818,44818,44818,44818,44818
13638,434,3264,0,13638,0,13638,6.46161e+17,97.143,4625.83,13638,1562,110,10374,10374,4226,2010,2135
38942,463,1678,0,38942,37799,1143,4.37338e+16,298.449,5422.83,38942,283,26,34994,34994,26943,32763,23938
38652,88,176,38575,77,38652,0,5.9854e+18,172.411,2331.22,38652,171,171,31775,29798,21210,20116,16905
6206,817,1607,5846,360,5846,360,6.21648e+18,96.2457,2350.12,6206,744,95,4599,4599,2846,3443,2908
3733,317,1603,3563,170,3563,170,8.43124e+18,88.9255,2034.1,3733,746,66,9279,8861,3290,5370,0
1829,1,11,1776,53,1829,0,1.60821e+14,9.86003,123.679,1829,11,11,395,395,395,395,395
25777,6942,7448,0,25777,9303,16474,2.34471e+15,59.0959,9283.18,25777,3622,72,39845,39845,39845,39845,39845
1164,51,167,1164,0,1164,0,5.98796e+18,108.502,401.077,1164,60,51,707,346,310,334,340
39130,2334,13057,39130,0,36900,2230,4.66958e+18,274.243,14753.1,39130,2831,136,36457,36457,36417,36417,36185
40464,83,206,40389,75,40464,0,5.97924e+18,186.039,2474.02,40464,178,182,26191,9354,12773,20787,1612
25500,8456,10282,24331,1169,24331,1169,2.13343e+18,95.6036,12063.7,25500,4923,111,36365,36365,36365,36365,36365
18508,1218,8084,0,18508,7156,11352,1.86383e+15,56.0642,9265,18508,3917,72,10424,10396,4455,2102,1172
37415,689,1422,0,37415,36326,1089,4.06731e+16,285.008,4636.29,37415,231,26,26172,26086,20361,16059,3825
9222,2266,3273,0,9222,0,9222,5.552e+17,94.9281,4176.12,9222,1576,103,5949,5949,4894,3595,4082
18852,94,6232,18852,0,17754,1098,3.69331e+18,144.187,7277.33,18852,2256,121,12429,2742,3892,8604,692
25456,2085,7774,0,25456,0,25456,5.88855e+17,96.5124,9807.08,25456,3763,110,17682,17682,9393,6701,4164
10879,1643,3710,10879,0,10249,630,3.21195e+18,92.351,4445.52,10879,1322,120,7169,7169,4927,5761,3647
38422,7590,21675,37145,1277,37145,1277,2.32631e+18,91.6637,23625.9,38422,10531,110,37890,37890,37890,37890,37890
23983,5463,8056,0,23983,8864,15119,2.19373e+15,58.3455,9698.42,23983,3916,72,15927,15927,13882,12663,11602
9701,2506,3711,9236,465,9236,465,4.5311e+18,92.5543,4610.92,9701,1768,105,5990,5990,5746,5990,4917
4343,1,10,4217,126,4343,0,1.5438e+14,9.73382,187.013,4343,10,10,980,980,980,980,980
31441,12,15,30512,929,31378,63,1.76516e+14,10.4149,602.811,31441,13,11,5886,1378,689,2072,477
28792,5174,6783,27115,1677,27115,1677,3.36627e+18,97.6936,9187.78,28792,3274,110,26658,26658,23110,24592,21567
13758,3146,5182,0,13758,0,13758,5.33962e+17,95.0129,6361.79,13758,2506,110,8576,8576,7295,5289,5482
15010,4060,5524,14280,730,14280,730,4.23537e+18,95.7718,6779.63,15010,2631,112,9486,9486,9134,9486,7677
14211,2106,5223,13521,690,13521,690,7.80979e+18,95.198,6446.2,14211,2526,110,8988,8988,8609,8612,4756
5742,1117,1401,5404,338,0,5742,2.24049e+18,95.8995,2120.64,5742,659,91,4341,4341,4033,3951,3796
7090,1965,2337,6720,370,6720,370,7.1479e+18,94.8863,3104.06,7090,1120,93,4753,4753,4703,4703,4473
20569,365,4834,19369,1200,19369,1200,3.34889e+18,97.5852,6696.08,20569,2334,110,15735,15735,6701,10782,2228
34835,151,646,0,34835,32007,2828,2.9181e+16,10.2289,1364.88,34835,639,11,42603,42067,29998,27757,8602
5574,922,1414,0,5574,1970,3604,2.49615e+15,59.0199,2006.78,5574,686,72,4160,4160,3454,2676,2756
18223,4314,5642,17260,963,0,18223,2.01966e+18,96.2553,7210.37,18223,2728,110,12581,12581,11092,10821,9690
3803,1,11,3693,110,3801,2,1.3774e+14,9.87378,169.867,3803,11,11,989,989,989,989,989
44202,822,10365,41632,2570,0,44202,2.22642e+18,97.8585,13737.5,44202,5025,110,31460,30939,18174,23179,8347
8454,2090,3714,3271,5183,0,8454,7.23356e+12,56.2271,4367.17,8454,1792,72,4740,4740,3452,4470,1450
11760,3321,4199,0,11760,0,11760,5.4977e+17,95.1232,5273.49,11760,2026,110,7561,7561,6667,5450,5509
47469,14073,16343,45088,2381,45088,2381,2.25232e+18,95.1142,19433.4,47469,7805,111,47091,47091,47091,47091,47091
18125,4467,6003,18125,0,17072,1053,3.1907e+18,141.485,7022.11,18125,2173,122,24967,24967,20762,17312,14849
22429,2741,11291,0,22429,0,22429,4.21849e+17,93.3263,12727.2,22429,5474,110,11138,11052,8886,7314,6517
38994,5,15,37862,1132,38937,57,1.57412e+14,10.4466,630.436,38994,13,12,44437,40034,38807,35453,23220
46206,11479,12366,0,46206,16531,29675,2.41842e+15,59.5327,15379.4,46206,6018,72,30231,30231,28276,27457,26570
8626,655,2113,8120,506,8120,506,4.84007e+18,97.1266,3069,8626,990,108,6513,6513,4701,5533,2563
26437,513,7654,25007,1430,0,26437,2.07066e+18,96.6865,9786.76,26437,3703,110,25148,24767,21787,22000,16171
8199,3207,3419,3135,5064,0,8199,7.54462e+12,56.5406,4074.28,8199,1652,72,4780,4780,4714,4770,4740
43789,85,206,43708,81,43789,0,5.98306e+18,194.297,2564.87,43789,181,177,25964,11434,18799,15858,5938
13578,1303,3961,0,13578,0,13578,6.01202e+17,96.2082,5247.11,13578,1898,110,9617,9617,7275,5364,4762
30952,4030,7225,29152,1800,29152,1800,3.23336e+18,97.7236,9777.35,30952,3494,110,30787,30787,30787,30787,30787
18793,1833,4455,17703,1090,17703,1090,5.75308e+18,97.383,6190.71,18793,2147,110,26031,26031,13619,5204,5222
22997,3646,5408,0,22997,0,22997,6.4859e+17,97.574,7430.83,22997,2612,110,17589,17589,15181,14251,12447
26133,6512,12252,25066,1067,25066,1067,5.01555e+18,94.6224,13916.2,26133,5893,111,13881,13794,7717,8785,4760
41445,4377,16434,39528,1917,39528,1917,3.08064e+18,95.9093,19038.6,41445,7888,111,39752,39752,39752,39752,39752
39735,5545,12312,14509,25226,0,39735,8.90517e+12,58.8251,14845.9,39735,5996,72,38520,38520,38520,38520,38520
33780,6857,14925,0,33780,13119,20661,1.84921e+15,56.7205,16795.9,33780,7271,72,16904,8111,10574,12181,12392
19736,5632,10635,0,19736,8002,11734,1.5348e+15,55.0754,11694.7,19736,5181,72,9101,9053,7205,6015,5112
26432,2826,8621,26432,0,24892,1540,3.28744e+18,168.966,9916.74,26432,3142,124,27060,27060,16296,18960,10327
39821,3412,14641,14949,24872,0,39821,8.14678e+12,57.7017,17010.1,39821,7117,72,39340,39340,39340,39340,39340
33093,126,1284,0,33093,32134,959,4.03499e+16,265.87,4114.23,33093,205,26,34333,33845,22807,22344,5702
14522,3726,4615,13764,758,13764,758,3.18985e+18,95.9382,5928.37,14522,2222,110,9907,9907,8220,8955,7780
24227,714,1231,0,24227,23511,716,4.47033e+16,249.192,3710.16,24227,195,26,17517,17517,5339,9861,3768
20108,2740,7246,15683,4425,19118,990,5.1221e+18,96.1597,8819.7,20108,3464,111,20281,20281,14190,12634,6946
10216,4,12,9922,294,10209,7,1.54624e+14,10.433,294.081,10216,12,11,8939,7992,6426,6778,5413
36079,7245,10237,36079,0,36079,0,2.69188e+18,3988.76,14373.1,36079,7384,27,28213,28213,28128,28104,28118
27989,5602,6599,0,27989,0,27989,6.47251e+17,97.6789,8952.08,27989,3191,110,32836,32836,27734,26737,18862
2388,235,596,0,2388,838,1550,2.54906e+15,57.9719,918.498,2388,285,58,1792,1792,1213,940,822
14406,2234,4031,0,14406,5177,9229,2.38441e+15,59.1123,5208.35,14406,1958,72,10375,10375,8930,8219,7348
40951,7862,9620,0,40951,0,40951,6.47372e+17,97.8303,12790.2,40951,4664,110,33413,33413,33413,33413,33413
21450,3486,6302,0,21450,0,21450,5.99369e+17,96.3814,8110.45,21450,3046,110,22665,22391,15506,16116,8702
33761,6042,7894,0,33761,11864,21897,2.52433e+15,60.0018,10313.9,33761,3832,72,22620,22620,19333,19144,18797
11762,1439,2846,11082,680,11082,680,5.79313e+18,96.8671,4064.05,11762,1358,110,8916,8916,8100,7974,5172
45223,795,1229,0,45223,43933,1290,3.55771e+16,254.6,4275.04,45223,195,26,23353,22691,13151,10622,957
38383,6,8,37741,642,38319,64,9.85892e+13,3.99802,507.418,38383,6,4,18672,15790,14768,17371,14570
16498,2375,4947,0,16498,0,16498,5.93745e+17,96.2981,6423.27,16498,2382,110,31026,31026,16743,14590,8683
30228,5180,7265,28480,1748,28480,1748,3.22123e+18,97.6363,9751.85,30228,3509,110,22963,22963,20856,22351,17053
35606,6,15,34561,1045,35514,92,1.70509e+14,10.5006,638.773,35606,14,12,4888,1405,1097,1168,558
29970,1,14,29116,854,29895,75,1.38606e+14,10.6504,526.462,29970,14,12,7687,7687,7687,7687,7687
21878,11,945,4564,17314,0,21878,5.85707e+13,12.0066,1433.85,21878,727,19,19106,16373,12747,4974,10916
39876,5347,12105,39876,0,37556,2320,4.39799e+18,285.227,14123.8,39876,2958,134,39317,39317,39317,39317,39317
29211,7424,8322,27621,1590,27621,1590,3.27477e+18,96.9254,10634.4,29211,4027,110,26579,26579,25821,26429,24094
47580,8236,11133,0,47580,0,47580,6.48025e+17,97.8804,14710.5,47580,5398,110,39431,39431,39431,39431,39431
16872,58,4009,15892,980,0,16872,2.22512e+18,97.3166,5606.91,16872,1928,110,8312,2252,6596,6496,661
4844,2276,3371,4844,0,4714,130,6.62173e+18,90.2219,3671.18,4844,1322,71,30918,30904,30371,30650,29998
49493,1302,11558,46613,2880,0,49493,2.22761e+18,97.9289,15257.1,49493,5607,110,48124,48124,48109,48112,48096
43819,144,1204,0,43819,42569,1250,3.55807e+16,251.176,4163.12,43819,189,26,43761,39084,35099,32258,25088
41146,10865,21560,0,41146,16583,24563,1.57455e+15,54.733,23494.2,41146,10498,72,46586,46586,46586,46586,46586
29031,797,908,0,29031,28124,907,0.0312425,0.968723,5133.41,29031,908,1,28123,28123,28123,28123,28123
42343,875,9885,0,42343,0,42343,6.48435e+17,97.8404,13148.6,42343,4789,110,32860,32663,23135,26680,15720
29732,9,14,28884,848,29656,76,1.42139e+14,10.6744,538.086,29732,13,12,28811,25258,15251,19474,3795
18109,6081,6280,18109,0,17083,1026,4.59973e+18,140.052,7287.17,18109,2330,124,11829,11829,11783,11823,11695
10566,1734,2561,9948,618,9948,618,3.33824e+18,96.9064,3681.67,10566,1227,110,8005,8005,6464,7126,6066
7993,10,11,7760,233,7985,8,1.62272e+14,10.3349,260.807,7993,11,11,7955,7929,7812,7813,7413
36566,3,14,35519,1047,36487,79,1.43201e+14,10.5118,589.154,36566,14,12,2499,832,466,1059,210
21745,8,15,21096,649,21688,57,1.89259e+14,10.4219,499.271,21745,13,11,21445,21197,19860,17548,13043
19034,899,8912,19034,0,18191,843,5.52854e+18,193.126,9987.34,19034,2718,127,10122,9586,5399,6523,1761
10149,2219,4297,9697,452,9697,452,4.34983e+18,94.4703,5180.25,10149,2042,105,5852,5852,4780,5723,3683
39554,180,1791,0,39554,38388,1166,4.50775e+16,312.987,5760.95,39554,306,26,0,0,0,0,0
44001,9018,15338,44001,0,41557,2444,4.46665e+18,299.02,17166.2,44001,3926,134,35215,35215,35215,35215,35215
27852,4465,6667,26225,1627,26225,1627,5.30544e+18,98.2089,8960.45,27852,3155,111,21737,21737,20722,21327,19513
35889,8513,12385,35889,0,33929,1960,4.69271e+18,261.558,14204.4,35889,2666,135,33126,33126,30445,30613,25989
13074,144,176,13060,14,13074,0,6.16382e+18,165.961,1403.28,13074,118,121,12735,12117,10932,10858,10566
32470,196,1414,0,32470,31521,949,4.2915e+16,287.795,4477.03,32470,229,26,30668,30181,21947,20623,7866
32075,52,208,32004,71,32075,0,6.00103e+18,194.668,2287.1,32075,172,175,32575,32508,32508,32491,32514
34961,337,1034,0,34961,33964,997,3.55476e+16,213.336,3439.52,34961,156,26,21969,20824,12404,3788,1868
33592,85,208,33537,55,33592,0,6.04615e+18,201.41,2405.07,33592,176,173,33578,0,0,683,557
37692,638,16571,36082,1610,36082,1610,2.6528e+18,93.3454,18902.6,37692,8035,110,35743,25296,17184,11596,11281
28320,1302,9201,26852,1468,26852,1468,4.77476e+18,96.884,11320.2,28320,4389,111,19121,19121,24925,0,0
36374,6019,9958,34364,2010,34364,2010,6.46843e+18,97.1621,12731.2,36374,4830,110,36141,36141,36141,36141,36141
1381,586,626,1381,0,1308,73,4.16401e+18,82.5771,810.176,1381,221,55,755,755,750,752,753
12084,5916,6470,0,12084,2617,9467,1.35497e+13,8.19687,6683.48,12084,5815,11,23680,23680,21477,18570,17915
45222,5326,22604,18022,27200,0,45222,6.46004e+12,55.0353,24772.5,45222,10995,72,29611,29525,27299,27316,23364
35909,103,208,35848,61,35909,0,6.10672e+18,201.675,2521.38,35909,174,176,29915,12399,8478,6382,710
15996,1900,3809,15065,931,15065,931,5.8827e+18,97.2814,5340.15,15996,1834,110,12187,12187,11719,11719,6828
36983,9,12,35928,1055,36965,18,1.38823e+14,10.2487,543.323,36983,11,12,15689,12924,12689,12767,12321
24319,546,5731,0,24319,8548,15771,2.52104e+15,59.9243,7586.25,24319,2785,72,23505,22905,10330,9359,60
15497,137,208,15489,8,15497,0,6.03389e+18,183.502,1616.32,15497,147,144,14612,13593,10477,10706,10752
36696,413,1481,0,36696,35626,1070,4.18706e+16,295.157,4782.55,36696,244,26,36891,36891,22321,7677,3329
14273,2800,3412,0,14273,0,14273,6.47294e+17,97.1797,4819.54,14273,1636,110,10861,10861,10063,9869,9388
15979,1580,6979,15289,690,15289,690,2.66973e+18,94.0008,8205.03,15979,3362,110,9000,9000,6253,6582,2800
41439,35,61,41375,64,41439,0,2.33131e+18,60.7823,1515.94,41439,61,61,21178,13380,16632,15988,12001
557,435,478,557,0,545,12,6.41428e+18,16.0987,507.349,557,182,34,41445,41445,40128,38395,79
8225,1410,2047,7753,472,0,8225,2.21037e+18,96.194,2976.67,8225,967,104,6178,6178,5478,5241,4641
16602,2251,3921,5832,10770,0,16602,9.85568e+12,59.8042,5294.37,16602,1898,72,12681,12681,10239,12261,7393
557,138,229,527,30,0,557,2.16465e+18,71.0144,336.795,557,80,35,328,246,254,259,275
21141,184,200,21132,9,21141,0,5.98389e+18,181.019,1774.96,21141,156,158,20909,20406,20245,20174,20311
43996,8003,10223,15453,28543,0,43996,9.88306e+12,60.0716,13233.5,43996,4970,72,43692,43692,43692,43692,43692
10410,2148,4028,9920,490,9920,490,2.87338e+18,94.5588,4982.49,10410,1942,106,6382,6382,5562,6166,4615
29560,7052,9655,29560,0,27841,1719,4.1909e+18,185.918,11047.7,29560,3539,122,28216,28216,22443,27183,14550
10052,9,11,9761,291,10048,4,1.58323e+14,9.94399,287.458,10052,10,11,9941,9802,9735,9736,8942
44867,2,15,43566,1301,44775,92,1.61086e+14,10.4142,697.357,44867,13,13,16205,14685,14837,14690,14557
18305,273,957,0,18305,17772,533,4.25772e+16,182.177,2737.12,18305,138,26,18400,17981,9005,12619,1219
14640,186,208,14630,10,14640,0,6.01197e+18,183.178,1562.39,14640,144,147,14382,14255,13470,13391,13407
11307,2265,2727,0,11307,0,11307,6.49707e+17,97.012,3908.9,11307,1305,110,8580,8580,7969,7594,7514
40623,5697,15549,38700,1923,38700,1923,2.81416e+18,96.1179,18155.8,40623,7453,111,30489,30320,21600,23495,14506
6198,245,2864,2422,3776,0,6198,7.01118e+12,55.7075,3366.67,6198,1390,70,3334,3238,2116,3119,821
28360,571,6684,26710,1650,26710,1650,5.7684e+18,97.6766,9062.56,28360,3230,110,12824,11878,7274,5645,1686
14789,397,768,0,14789,14360,429,3.95783e+16,86.7134,2078.61,14789,102,26,14021,13930,12644,12866,10629
1467,53,85,0,1467,1426,41,3.68884e+16,18.7157,243,1467,27,26,1382,1382,1201,1209,1038
14483,1645,6477,13863,620,13863,620,3.27724e+18,93.5315,7585.68,14483,3104,111,9233,9008,5328,6879,2156
29544,55,175,29469,75,29544,0,5.9785e+18,167.274,2032.58,29544,167,164,26650,16143,10348,11886,10574
28648,6969,15313,27625,1023,27625,1023,3.68176e+18,92.2362,16929,28648,7380,111,13335,13335,7908,8823,6727
1672,298,444,590,1082,0,1672,9.82052e+12,56.6148,687.577,1672,211,52,1228,1228,1025,1190,935
21480,789,7202,0,21480,0,21480,5.64848e+17,95.9524,8928.52,21480,3486,110,14278,14106,7632,3116,3166
25625,5299,7813,24268,1357,24268,1357,3.20043e+18,96.5183,9857.6,25625,3777,110,17812,17812,13720,15402,12207
24681,6663,11699,0,24681,0,24681,4.46492e+17,91.3159,13311.3,24681,5658,110,36747,36747,36747,36747,36747
9656,2182,2366,9096,560,9096,560,5.80537e+18,96.5737,3412.3,9656,1129,110,7290,7290,7191,7180,7045
39498,10154,12638,39498,0,37198,2300,4.11378e+18,279.269,14359.2,39498,3477,133,29940,29741,23189,26647,18184
37669,5548,19485,37669,0,37669,0,1.32639e+18,17.9627,20033.2,37669,17521,20,18184,18184,5115,18184,5162
18934,2878,6099,0,18934,6950,11984,2.24097e+15,58.4977,7484.16,18934,2966,72,12835,12835,9627,6374,5867
25294,2108,5923,0,25294,0,25294,6.49105e+17,97.6855,8104.92,25294,2863,110,17098,17098,10588,14211,3687
35568,273,8333,33498,2070,0,35568,2.22813e+18,97.7944,11174.5,35568,4030,110,27257,27257,20935,27006,19897
28199,333,10928,0,28199,0,28199,5.19083e+17,95.2673,12925.6,28199,5300,110,19235,18953,6675,11705,1246
26448,2687,6264,0,26448,0,26448,6.45342e+17,97.5908,8514.94,26448,3019,110,40648,40648,40648,40648,40648
3997,341,2199,3997,0,3997,0,2.4454e+18,17.8511,2358.49,3997,1968,20,1798,1793,312,1798,367
22897,4318,5508,21557,1340,21557,1340,2.31912e+18,98.0641,7475.85,22897,2596,111,17389,17389,17389,17148,14261
45625,412,1237,0,45625,44323,1302,3.55795e+16,256.174,4312.16,45625,196,26,45370,45370,45370,45370,45370
2762,428,728,2599,163,2599,163,3.3571e+18,92.7755,1143.22,2762,332,65,2034,2034,1494,1745,1472
47466,18353,20741,45436,2030,0,47466,1.63899e+18,94.6562,23543.9,47466,10076,110,28044,28044,27558,27433,27258
36615,917,8783,34485,2130,34485,2130,2.42367e+18,98.2632,11615.8,36615,4152,111,28721,28721,16370,15116,11730
47045,8114,13278,44455,2590,44455,2590,4.49582e+18,97.7105,16566.8,47045,6320,111,46557,46557,46557,46557,46557
45974,14646,22346,44174,1800,0,45974,1.49847e+18,93.9019,24889.2,45974,10862,110,38305,38305,38305,38305,38305
6974,1776,2382,6974,0,6567,407,6.06023e+18,91.6402,2950.51,6974,841,106,4592,4592,4158,4404,3785
34174,4935,8510,0,34174,12111,22063,2.48104e+15,59.7884,10913.2,34174,4139,72,34009,34009,34009,34009,34009
42457,665,14672,15771,26686,0,42457,8.44094e+12,58.2849,17236.6,42457,7142,72,34447,34447,11967,9856,4260
41433,3147,9733,0,41433,0,41433,6.4656e+17,97.8297,12934.2,41433,4718,110,43813,43813,43813,43813,43813
36061,6341,8432,33961,2100,33961,2100,3.3455e+18,97.8303,11308.8,36061,4085,110,31162,31162,31162,31162,31162
22879,1677,5369,0,22879,0,22879,6.49499e+17,97.6336,7385.98,22879,2597,110,33434,33434,33434,33434,33434
8204,1794,3247,3113,5091,0,8204,7.86702e+12,57.0283,3922.01,8204,1576,72,4957,4957,3806,4717,2040
31510,13690,31510,0,31510,31510,0,2047.94,0,31510,31510,31510,1,0,0,0,0,0
2381,1,10,2315,66,2381,0,1.38314e+14,9.69719,134.534,2381,10,10,614,614,614,614,614
11286,1739,3965,0,11286,0,11286,5.52331e+17,94.6532,5018.72,11286,1906,110,7321,7321,6477,6298,5779
40423,12192,13109,40423,0,38083,2340,5.12287e+18,283.607,14853.4,40423,4463,133,39968,39968,39968,39968,39968
45958,2790,10731,0,45958,16151,29807,2.52612e+15,60.0596,13848,45958,5219,72,45635,45635,45635,45635,45635
5102,690,1274,4807,295,4807,295,5.86387e+18,95.1213,1930.51,5102,591,86,3828,3828,3685,3685,2440
1217,142,338,0,1217,425,792,2.50119e+15,55.189,530.217,1217,158,47,879,879,597,360,429
39896,9971,12861,0,39896,14650,25246,2.24054e+15,58.6404,15364.1,39896,6264,72,27035,27035,24797,22765,21208
41461,651,9732,39051,2410,39051,2410,5.89002e+18,97.8454,12937.9,41461,4717,110,30590,30155,17992,22207,12223
32450,1759,9960,32450,0,30562,1888,4.9692e+18,224.999,11687.7,32450,3880,127,29117,29117,12818,7521,5922
49026,4732,11465,46176,2850,0,49026,2.22647e+18,97.8918,15133.7,49026,5555,110,38899,38899,32413,37291,21822
11587,2099,2803,0,11587,0,11587,6.46834e+17,96.8853,4004.07,11587,1343,110,8784,8784,7990,8078,6992
44097,696,10604,41535,2562,41535,2562,3.74697e+18,98.3047,13877.1,44097,5009,111,30340,29738,20110,9438,8378
33509,4409,8138,31579,1930,31579,1930,3.43277e+18,97.6356,10824.1,33509,3934,110,25371,25371,17856,21254,14249
6175,269,1468,2164,4011,0,6175,9.90218e+12,59.2729,2116.64,6175,710,72,4707,4707,2938,4397,934
40878,10365,11201,0,40878,0,40878,6.14037e+17,97.1952,14241.8,40878,5433,110,23674,23674,20269,22973,16247
27040,1302,1787,0,27040,5493,21547,1.4629e+16,11.9922,2317.34,27040,1108,14,24133,24133,15541,17206,2210
31215,337,7243,0,31215,10963,20252,2.53749e+15,60.0267,9513.79,31215,3524,72,39584,39535,39299,38806,39569
20595,1235,1248,0,20595,19981,614,4.86787e+16,265.317,3647.76,20595,197,26,19347,19347,19307,19302,19257
24135,2987,7436,0,24135,0,24135,5.86499e+17,96.4476,9382.47,24135,3595,110,16699,16699,12440,8328,7505
38867,70,176,38801,66,38867,0,6.00727e+18,172.446,2384.56,38867,171,171,19236,18908,1128,18867,112
38859,3147,15097,38859,0,26966,11893,4.32114e+18,281.185,16744.6,38859,4599,137,28519,28266,20044,23830,14416
36891,7,12,35841,1050,36880,11,1.38842e+14,10.2331,543.104,36891,12,11,32215,29348,22978,23603,12486
40489,3,10,39054,1435,40365,124,4.47771e+13,5.99439,595.571,40489,8,7,31128,0,0,0,14
4255,927,2249,4255,0,4255,0,3.47349e+18,18.6971,2424.17,4255,1445,23,2006,2006,1086,1143,833
35197,6808,8447,33147,2050,33147,2050,5.26753e+18,98.267,11191.8,35197,3993,111,34988,34988,34988,34988,34988
35952,3997,8421,33860,2092,0,35952,2.22815e+18,97.7875,11286.1,35952,4079,110,29993,29993,28630,26730,26619
30798,10,14,29914,884,30750,48,1.45819e+14,10.69,555.789,30798,12,11,11153,6980,5926,9805,5171
43541,7957,20488,41789,1752,41789,1752,9.21386e+18,93.7762,22984.6,43541,9949,110,21218,21218,6876,16371,6422
16301,5380,6713,6240,10061,0,16301,7.60626e+12,54.8081,7822.97,16301,3247,72,9588,9588,9309,9528,9032
2824,36,144,0,2824,2745,79,3.63605e+16,19.33,413.54,2824,36,26,2680,2678,1930,1980,45309
13026,533,834,0,13026,12643,383,4.44759e+16,136.782,2217.15,13026,114,26,32544,32544,32544,32544,32544
2880,2,11,2796,84,2877,3,1.62532e+14,10.3299,157.509,2880,11,11,1677,1266,1029,1021,820
9018,631,3647,0,9018,3434,5584,1.97689e+15,56.9509,4364.93,9018,1769,72,5371,5276,3293,2511,1937
42957,12,15,41710,1247,42895,62,1.60326e+14,10.4927,694.838,42957,13,11,18079,13874,13478,14527,12569
41045,2130,2567,12591,28454,0,41045,6.90323e+18,15.9914,3320.23,41045,1684,18,28799,28799,16373,11292,10152
5806,2133,2327,5531,275,5531,275,2.8034e+18,93.345,2937.88,5806,1107,89,3479,3479,3281,3446,3405
17705,2304,4302,16672,1033,16672,1033,3.49691e+18,97.8164,5920.88,17705,2015,111,13403,13403,13403,13403,7796
33791,3105,11313,12490,21301,0,33791,8.58675e+12,58.4229,13471,33791,5505,72,20439,20437,7765,20260,6262
36048,3872,8425,33948,2100,33948,2100,5.88286e+18,97.8482,11300.9,36048,4087,110,35889,35889,35889,35889,35889
13931,262,594,0,13931,13535,396,3.55866e+16,20.0391,1639.51,13931,78,26,13884,13884,13884,13884,13884
19478,41,176,19466,12,19478,0,6.0407e+18,171.031,1712.2,19478,150,150,25308,22203,22168,21936,21143
17358,1873,4539,0,17358,6174,11184,2.44026e+15,59.3878,5923.63,17358,2203,72,16342,16342,16342,16342,16342
16903,339,702,0,16903,16422,481,3.55578e+16,29.8942,1950.38,16903,89,26,46600,46600,46467,46451,46193
11426,2029,4118,10866,560,10866,560,7.66247e+18,94.5298,5168.91,11426,1982,110,7308,7308,7198,7198,6275
4830,1019,1803,4591,239,0,4830,1.87839e+18,92.511,2357.97,4830,854,89,3027,3027,2852,2788,2944
24592,4553,8953,24592,0,23280,1312,4.1697e+18,165.718,10310.4,24592,2141,132,15639,15639,13845,14355,10499
6415,236,1574,6044,371,6044,371,5.85953e+18,95.7998,2353.93,6415,740,94,4841,4841,4298,3943,1091
44037,9825,11582,41556,2481,41556,2481,2.50708e+18,97.9544,14774.6,44037,5492,111,47947,47947,47947,47947,47947
5871,3,10,5704,167,5867,4,1.38316e+14,9.90802,211.497,5871,10,10,4453,3112,3962,3862,2401
48903,1195,3220,15106,33797,0,48903,6.90126e+18,15.9972,4046.43,48903,1836,26,45683,45683,28682,27047,25657
15537,1038,5604,5799,9738,0,15537,8.27199e+12,57.7711,6740.08,15537,2718,72,9933,9933,5664,8508,1945
30410,2777,7148,28640,1770,0,30410,2.22674e+18,97.7382,9661.58,30410,3458,110,26806,26806,25993,25112,24760
12264,1493,3289,4380,7884,0,12264,9.4181e+12,59.1433,4341.96,12264,1588,72,21112,21112,11522,4632,2946
46919,15,16,45544,1375,46850,69,1.74816e+14,10.314,750.654,46919,13,11,46903,46903,46903,46903,46902
20164,4157,4940,18993,1171,18993,1171,3.38669e+18,97.885,6721.94,20164,2325,111,19206,19206,16740,15764,13331
46408,5103,10868,43708,2700,0,46408,2.22638e+18,97.8798,14373.3,46408,5272,110,39520,39520,37113,39019,34240
26025,3230,10799,0,26025,0,26025,4.96144e+17,93.0654,12617.2,26025,5219,110,14500,14500,7270,3483,2542
10919,1766,2849,0,10919,0,10919,6.32029e+17,96.5867,3978.44,10919,1368,110,8070,8070,6600,5375,5082
8577,25,176,8535,42,8577,0,6.09226e+18,161.909,1146.09,8577,112,117,4016,1069,1238,1214,1262
49022,7780,13120,17531,31491,0,49022,9.42421e+12,59.5141,16285.4,49022,6375,72,47781,47781,47781,47781,47781
30714,4472,8315,29012,1702,0,30714,2.12396e+18,97.1381,10756.1,30714,4026,110,27943,27943,18641,19934,15321
27913,10361,10362,27913,0,26404,1509,5.22814e+18,212.783,11688.2,27913,4071,128,27730,27730,27730,27730,34788
41371,10417,13816,39260,2111,39260,2111,4.4274e+18,96.8631,16623.4,41371,6596,111,27555,27555,23688,24262,22400
38151,6304,15381,0,38151,14558,23593,1.9717e+15,57.3519,17563.3,38151,7486,72,37190,37190,37190,37190,37190
22959,1,11,22306,653,22947,12,1.38684e+14,10.2014,424.302,22959,11,11,102,102,102,102,102
33089,33,176,33062,27,33089,0,6.05698e+18,173.012,2237.04,33089,167,163,10497,1599,2380,6003,162
1780,91,494,1672,108,0,1780,2.26401e+18,90.5135,790.764,1780,222,55,1161,408,793,675,387
12412,2530,4272,4598,7814,0,12412,8.48429e+12,58.028,5250.49,12412,2074,72,8140,8140,7109,7920,5544
17913,5278,7989,17146,767,17146,767,5.00334e+18,94.8005,9287.89,17913,3838,111,41742,41742,41742,41742,41742
26773,2277,13125,26773,0,0,26773,8.77168e+17,17.9753,13597.9,26773,11802,20,13648,13648,2884,6478,2408
34799,516,1034,0,34799,33805,994,3.55391e+16,213.759,3429.43,34799,155,26,34551,34551,23414,13165,25364
19645,1754,4697,18505,1140,18505,1140,3.35097e+18,97.4249,6486.99,19645,2260,110,14948,14948,9044,11749,6295
10803,1454,2948,10195,608,10195,608,3.97458e+18,96.9517,4041.31,10803,1385,111,7855,7855,7855,7855,5112
2189,170,568,0,2189,769,1420,2.4834e+15,57.2832,865.896,2189,271,57,1621,1621,1052,802,539
6952,2068,2415,6952,0,6550,402,6.39131e+18,91.6669,2979.15,6952,864,102,4537,4537,4332,4476,4159
12329,4833,7994,0,12329,0,12329,1.46441e+18,5.50182,9195.8,12329,2670,13,4335,4335,3895,3895,2852
19556,4598,6935,18594,962,0,19556,1.88639e+18,95.5822,8511.75,19556,3348,110,33663,33663,25278,32205,14623
33007,617,1484,0,33007,32036,971,4.38017e+16,222.464,4686.28,33007,246,26,31523,30569,28058,28639,18682
27070,5821,13533,26030,1040,26030,1040,4.03281e+18,91.4294,15170.2,27070,6501,111,13537,13537,9960,11874,5698
38019,12925,15444,36299,1720,0,38019,1.73071e+18,94.9941,17896.9,38019,7505,110,23695,23695,20739,19041,15955
6580,395,1549,2315,4265,0,6580,1.00232e+13,59.4293,2227.36,6580,754,72,5031,5031,2628,4372,1422
32656,2282,13961,0,32656,0,32656,4.8516e+17,94.679,16082.3,32656,6778,110,18695,18695,11611,6095,3716
33585,4331,7890,31634,1951,31634,1951,3.3507e+18,97.7372,10606.7,33585,3809,110,28502,28502,27760,27439,26709
11199,1032,3666,10619,580,10619,580,2.8058e+18,93.1367,4729.32,11199,1733,111,7533,7533,4882,5980,2426
27269,1905,7090,0,27269,0,27269,6.2861e+17,97.3068,9337.65,27269,3434,110,12567,11435,6651,8701,3065
40694,7714,16850,38881,1813,0,40694,1.70672e+18,93.8184,19413,40694,8179,110,32956,32956,32953,32953,32956
18397,10,11,17875,522,18391,6,1.38817e+14,10.2575,379.97,18397,11,11,18339,18260,17989,17990,17415
21588,363,953,0,21588,20965,623,3.98373e+16,180.152,2826.48,21588,138,26,23975,22751,11635,1589,424
4656,34,176,4649,7,4656,0,6.03389e+18,154.766,840.364,4656,97,93,2503,788,822,996,916
48397,12594,16465,45949,2448,45949,2448,2.71193e+18,96.8358,19613.5,48397,7876,111,40587,40587,40587,40587,40587
25086,35,1268,0,25086,24349,737,4.48443e+16,267.596,3840.13,25086,202,26,22427,7289,7616,9092,7816
17140,3095,4059,0,17140,0,17140,6.49413e+17,97.4179,5677.39,17140,1953,110,13081,13081,11774,10872,10490
14627,121,878,2991,11636,0,14627,5.7529e+13,11.9863,1266.25,14627,606,14,13749,13749,8573,5375,11423
23807,8243,9850,20619,3188,22607,1200,5.04646e+18,188.689,11014.3,23807,2063,128,13957,13957,13174,13945,11816
49230,9405,14184,0,49230,17784,31446,2.34936e+15,59.1994,17283.3,49230,6907,72,28616,23253,20928,23345,17477
15947,5,12,15487,460,15934,13,1.50878e+14,10.644,367.107,15947,12,11,14672,13221,10714,10991,8350
49973,14619,19397,18939,31034,0,49973,7.88521e+12,56.8467,22172.8,49973,9427,72,41718,41718,41718,41718,41718
44417,15180,15366,44417,0,41937,2480,4.34221e+18,300.442,17215.8,44417,5945,129,21510,21510,19420,16524,16242
41327,2506,14178,15333,25994,0,41327,8.46634e+12,58.3207,16695.4,41327,6899,72,38048,38048,37111,37065,36274
37926,8146,12897,14046,23880,0,37926,8.51636e+12,58.3444,15248.5,37926,6280,72,32765,32536,24562,24494,19211
10684,160,2600,10064,620,10064,620,3.22462e+18,96.7483,3728.81,10684,1241,110,8084,8002,3365,5458,1086
3033,88,1142,2883,150,2883,150,3.11403e+18,85.3271,1538.97,3033,507,69,1670,515,484,888,0
49652,7713,18468,0,49652,0,49652,5.31315e+17,95.7139,21628.8,49652,8972,110,47712,47712,47712,47712,47712
4372,539,1501,4372,0,4122,250,3.08614e+18,92.0668,1955.5,4372,562,85,2871,2871,1841,2206,1412
31343,1,13,30440,903,31323,20,1.53575e+14,10.3037,518.879,31343,12,12,14499,14499,14499,14499,14499
19094,3304,4511,17984,1110,0,19094,2.22901e+18,97.4534,6267.71,19094,2170,110,20557,20557,13865,11510,5079
2862,292,2175,1257,1605,0,2862,3.36263e+12,37.3952,2335.41,2862,1042,53,687,639,548,631,575
13991,2999,5136,13991,0,13241,750,3.51986e+18,129.242,6067.54,13991,2062,120,8855,8799,7102,7681,6265
43133,8552,10064,0,43133,15166,27967,2.53023e+15,60.0796,13021.9,43133,4902,72,32185,32185,30169,29275,27943
48112,26,208,47964,148,48112,0,6.10943e+18,204.687,2921.33,48112,191,187,13081,1543,3117,4012,49
12678,212,592,0,12678,12318,360,3.65744e+16,20.0487,1601.34,12678,77,26,12086,12086,10014,10095,5904
32817,146,208,32737,80,32817,0,6.01522e+18,199.343,2324.79,32817,173,172,24794,13663,14541,18633,7985
26306,617,9972,9925,16381,0,26306,8.033e+12,57.4264,11642.6,26306,4858,72,13968,13536,7121,1803,1476
20033,2519,4720,18863,1170,18863,1170,5.75692e+18,97.4852,6540.38,20033,2271,110,15313,15313,14008,13802,9014
5449,4,10,5292,157,5444,5,1.58585e+14,9.82309,210.636,5449,10,10,24997,24365,23640,23628,22692
47030,9164,15014,44600,2430,0,47030,1.97976e+18,96.5332,18244.8,47030,7279,110,46658,46658,46658,46658,46658
20780,141,6755,7646,13134,0,20780,8.7455e+12,58.4794,8239.69,20780,3284,72,14025,13845,7956,12975,663
32601,7,14,31671,930,32526,75,1.38937e+14,10.4853,521.033,32601,13,12,6043,3448,3061,3122,2299
19373,2172,6485,19373,0,18283,1090,6.03944e+18,146.191,7668.45,19373,2545,124,18976,18976,18976,18976,18976
42414,18025,18170,42414,0,40644,1770,4.70278e+18,2143.77,21124.3,42414,5095,143,35747,35747,35747,35747,35747
25953,773,8022,9470,16483,0,25953,8.94382e+12,58.7843,9819.44,25953,3908,72,17931,17883,8328,14603,1856
22293,775,1012,0,22293,21646,647,4.08821e+16,207.757,3022.24,22293,150,26,21281,21281,20019,20129,18014
43070,4849,14602,0,43070,15946,27124,2.18062e+15,58.3988,17220.2,43070,7108,72,42012,42012,42012,42012,42012
7456,23,334,7456,0,7146,310,2.24161e+18,16.9658,659.709,7456,320,19,7122,7121,6818,7116,2359
28484,37,176,28435,49,28484,0,5.99498e+18,171.928,2039.65,28484,162,165,20961,0,0,0,81
45240,1665,15198,16725,28515,0,45240,8.5662e+12,58.4342,17927.3,45240,7401,72,29914,29914,22220,21860,11089
35335,1,14,34321,1014,35255,80,1.45306e+14,10.4997,575.664,35335,13,12,8621,8621,8621,8621,8621
43172,715,1232,0,43172,41941,1231,3.61023e+16,255.635,4229.75,43172,195,26,29516,29081,16262,14399,2813
9207,148,208,9202,5,8668,539,6.07378e+18,191.241,1275.2,9207,119,124,8683,8128,6658,6650,6619
36522,346,8541,0,36522,0,36522,6.48163e+17,97.8268,11443,36522,4136,110,36200,36200,36200,36200,36200
5100,1104,2942,4930,170,0,5100,1.27777e+18,67.1833,3380.63,5100,1392,75,2158,2158,1755,1578,1428
40875,8,15,39695,1180,40817,58,1.54748e+14,10.3424,611.741,40875,13,12,46996,46216,41947,41120,34412
22617,7,11,21973,644,22609,8,1.38715e+14,10.1211,419.955,22617,11,11,21797,21181,19802,19784,16547
25654,4619,6173,24162,1492,24162,1492,2.31523e+18,98.0686,8324.23,25654,2902,111,30534,30534,24977,29364,15411
7794,830,3069,7424,370,7424,370,2.91318e+18,91.6739,3825.64,7794,1455,94,4725,4638,3503,3141,2176
19692,4887,6206,19692,0,18550,1142,5.2343e+18,151.14,7420.44,19692,2387,122,13486,13486,12558,13060,11171
26661,1456,10665,24091,2570,25431,1230,4.59378e+18,94.0098,12516.3,26661,5109,111,15996,15996,9436,7743,4033
9845,2,11,9558,287,9836,9,1.71001e+14,10.2425,291.165,9845,11,11,2396,269,303,521,168
11668,1849,4244,11668,0,9919,1749,3.96332e+18,108.042,5001.17,11668,1573,118,7424,7406,5137,6263,4115
19242,5927,12473,17052,2190,17052,2190,7.18433e+16,5.52089,14328,19242,4165,13,6769,6769,5741,5689,3675
44135,13269,19601,42273,1862,42273,1862,2.64733e+18,94.4353,22220,44135,9516,110,38142,38142,38142,38142,38142
1509,277,445,1419,90,0,1509,2.2488e+18,88.387,705.279,1509,192,51,1064,1064,878,887,854
4600,681,2408,4429,171,0,4600,1.44386e+18,61.5957,2850.02,4600,1140,67,2192,2192,1289,1039,0
27305,45,206,27296,9,27305,0,5.9802e+18,187.208,2026.31,27305,166,164,24240,10937,8179,10386,9611
16005,53,199,16002,3,16005,0,5.97337e+18,180.12,1555.07,16005,149,147,10334,5105,3873,4619,4343
17406,312,712,0,17406,16911,495,3.55527e+16,40.0108,1992.3,17406,90,26,16694,16673,15410,15465,8948
3026,8,10,2935,91,3022,4,2.04828e+14,7.90879,159.778,3026,10,10,2982,2964,2892,2891,2749
31571,6921,11499,30041,1530,0,31571,1.85417e+18,95.7362,13741.2,31571,5582,110,44256,44256,44256,44256,44256
40284,7,13,37004,3280,40243,41,1.14396e+14,8.20802,543.088,40284,13,9,39696,38708,37001,37002,37597
6621,943,1564,2318,4303,0,6621,1.00038e+13,59.3842,2245.56,6621,760,72,5057,5057,4154,4897,3221
23784,1,12,23095,689,23764,20,1.59578e+14,10.4722,455.933,23784,12,11,5167,5167,5167,5167,5167
33025,5,15,32058,967,32967,58,1.72797e+14,10.414,619.23,33025,13,11,2844,852,152,695,76
34818,7,15,33813,1005,34760,58,1.53519e+14,10.6767,612.193,34818,13,11,33698,32999,26243,26096,23571
25354,1527,6008,23884,1470,0,25354,2.22263e+18,97.574,8188.98,25354,2898,110,18708,18708,12018,11710,3382
8529,714,2150,8035,494,8035,494,3.53718e+18,96.9873,3091.87,8529,999,108,6379,6379,6379,6379,2488
21093,2611,10355,21093,0,20203,890,4.12285e+18,224.602,11497.7,21093,4643,126,18523,18523,11870,17333,2973
4215,567,2261,4056,159,4056,159,7.33751e+18,89.8282,2664.53,4215,1061,68,1954,1780,1463,1294,1503
24860,5196,5776,0,24860,8735,16125,2.53608e+15,60.0273,7672.25,24860,2812,72,19084,19084,18382,18007,17379
11312,3837,4903,11312,0,10752,560,6.13776e+18,117.503,5607.11,11312,1980,118,6409,6409,5691,6101,4673
38014,697,8886,35797,2217,35797,2217,3.21623e+18,97.8422,11878.9,38014,4302,110,23426,22738,14107,12192,3695
9493,32,176,9450,43,9493,0,6.02245e+18,164.143,1197.31,9493,122,121,34470,30877,741,1892,184
49691,16792,22137,36941,12750,47581,2110,4.79601e+18,95.2414,24948.6,49691,10666,111,41569,41569,41569,41569,41569
12139,61,176,12097,42,12139,0,6.07019e+18,167.7,1361.21,12139,129,130,32440,32236,32193,32147,31463
1879,9,11,1823,56,1877,2,1.44108e+14,10.5934,122.504,1879,11,11,1841,1820,1489,1499,1618
7737,593,1824,0,7737,2713,5024,2.56155e+15,59.4795,2588.5,7737,886,72,5913,5913,3583,3215,2037
10889,101,461,0,10889,10579,310,3.53902e+16,20.0199,1293.55,10889,66,26,10428,10428,9007,9089,3543
20439,127,4777,0,20439,7181,13258,2.53155e+15,59.9363,6398.28,20439,2320,72,15662,15616,4058,3658,652
11901,4041,5267,11391,510,11391,510,2.65034e+18,93.8656,6247.94,11901,2546,110,6634,6634,5874,6453,5153
41422,4879,16856,41422,0,28368,13054,4.77509e+18,427.203,18678.6,41422,6999,138,39354,39354,39354,39354,39354
12192,8,11,11842,350,12186,6,1.39121e+14,10.6421,308.512,12192,11,11,11919,11597,11229,11227,9821
16667,650,3916,5858,10809,0,16667,9.88488e+12,59.8629,5296.18,16667,1902,72,9167,9033,5829,6849,2082
22659,6533,6573,21437,1222,0,22659,2.07074e+18,96.6543,8465.1,22659,3171,110,13554,13554,11507,11082,9504
44487,1022,1216,0,44487,43219,1268,3.55793e+16,252.192,4220.67,44487,192,26,35085,34884,25874,29211,17866
23019,5352,5604,21681,1338,21681,1338,3.28989e+18,98.0214,7578.19,23019,2644,111,33845,33845,24486,15406,12106
46800,285,2441,0,46800,45397,1403,4.97875e+16,336.873,7853.29,46800,436,26,45496,0,0,0,0
34891,1537,34891,34891,0,0,34891,134214000,0,34891,34891,34891,1,0,0,0,0,3094
15219,59,61,15187,32,15219,0,2.26535e+18,60.4886,916.494,15219,61,61,7507,4136,6027,3225,2303
28468,1010,9272,28468,0,26808,1660,4.18312e+18,172.781,10629.1,28468,3378,122,32433,32303,32222,32388,30364
9917,1171,2478,9342,575,9342,575,3.61899e+18,97.0887,3528.45,9917,1149,111,7439,7439,5002,5531,4167
26405,10927,11075,26405,0,25085,1320,3.73667e+18,199.898,12306.2,26405,4547,128,31228,31228,31228,31228,31228
25143,6200,10774,0,25143,0,25143,4.84413e+17,94.5512,12510.9,25143,5225,110,14369,14369,11595,8649,8844
20955,2585,5451,0,20955,0,20955,6.26814e+17,97.1101,7293.58,20955,2627,110,15504,15504,12361,8960,8906
43161,679,1251,0,43161,41927,1234,3.63452e+16,251.042,4287.16,43161,198,26,39741,39655,38149,37069,36291
5395,1201,1391,5084,311,5084,311,6.00073e+18,95.3644,2067.05,5395,656,88,18858,18022,8604,3449,1161
1091,110,310,0,1091,386,705,2.4585e+15,54.0935,486.826,1091,137,43,781,781,526,278,349
33418,4823,11143,33418,0,31501,1917,5.30945e+18,229.737,12657.8,33418,3487,131,32726,32726,32726,32726,32726
5498,83,317,0,5498,0,5498,3.78537e+18,15.9405,583.64,5498,236,18,14475,3519,5926,9873,779
3277,424,807,0,3277,1149,2128,2.55399e+15,58.3613,1208.24,3277,391,63,2470,2470,1915,1744,1433
27327,2962,6407,25737,1590,0,27327,2.23003e+18,97.6329,8724,27327,3087,110,20920,20920,17791,16799,12062
15258,232,477,0,15258,14782,476,0.0311967,0.968738,2697.77,15258,477,1,15053,15053,15053,15053,15053
34487,5,15,33481,1006,34406,81,1.68883e+14,10.5067,627.689,34487,13,12,40572,36511,34926,32062,21968
20186,5535,6105,0,20186,7336,12850,2.30482e+15,58.8417,7596.36,20186,2967,72,14081,14081,13900,13817,13765
31762,3719,7458,29912,1850,0,31762,2.22704e+18,97.7348,10057.1,31762,3612,110,29742,29742,22423,13435,13437
5055,286,346,0,5055,4907,148,4.17093e+16,19.453,878.526,5055,56,26,4709,4709,4599,4609,3881
15238,1396,3626,14349,889,0,15238,2.22882e+18,97.3008,5105.03,15238,1742,110,11612,11612,8269,7526,5224
21808,335,1381,4443,17365,0,21808,5.72962e+13,11.9902,1856.8,21808,896,14,20427,20427,13733,9904,17407
16164,2991,3849,15223,941,0,16164,2.2286e+18,97.2944,5392.44,16164,1852,110,43746,43746,43746,43746,43746
47072,18392,19437,0,47072,18045,29027,1.93673e+15,57.2156,21987.7,47072,9464,72,38782,38782,38782,38782,38782
9487,8,11,9214,273,9485,2,1.52798e+14,10.1493,278.863,9487,11,11,9269,9147,8784,8785,7696
5459,11,13,5296,163,5422,37,1.80672e+14,10.4428,240.648,5459,12,11,5446,5444,5379,5379,4638
28039,10366,14298,26989,1050,0,28039,1.43377e+18,93.3192,15975.7,28039,6937,110,21453,21453,21453,21453,21453
17988,389,1021,0,17988,17456,532,4.48978e+16,203.93,2915.86,17988,153,26,16967,16579,13977,14438,9544
9358,2554,3218,9358,0,8818,540,3.24191e+18,92.0088,3891.18,9358,1141,118,6140,6140,5560,5803,5250
26889,4721,6319,9450,17439,0,26889,9.85409e+12,59.9581,8331.87,26889,3069,72,43727,43727,43727,43727,43727
28245,1470,7257,0,28245,0,28245,6.30538e+17,97.352,9575.36,28245,3517,110,20988,20988,10559,5103,5592
10158,898,2692,9588,570,0,10158,2.1555e+18,96.3426,3761.19,10158,1279,110,7466,7466,5452,5154,3369
13847,252,7741,0,13847,0,13847,3.49465e+15,17.8902,8046.93,13847,6953,20,6106,6051,319,3773,234
26276,1,12,25507,769,26259,17,1.66908e+14,10.328,483.956,26276,12,11,5333,5333,5333,5333,5333
10321,2497,2820,3687,6634,0,10321,9.38054e+12,57.5365,3740.27,10321,1351,72,7501,7501,7501,7501,7501
16383,4872,6021,15583,800,15583,800,2.44721e+18,95.4638,7362.19,16383,2852,111,10362,10362,9873,9964,7966
37311,5443,8731,0,37311,0,37311,6.4739e+17,97.8258,11685.2,37311,4220,110,24103,23911,19174,21199,16457
2829,606,758,2345,484,2662,167,3.12629e+18,93.6179,1177.72,2829,331,66,2071,2071,1830,1914,1880
40815,86,176,40743,72,40815,0,6.12941e+18,173.748,2501.96,40815,164,167,22414,8559,10852,15689,2047
20179,4278,4721,7086,13093,0,20179,9.9039e+12,59.9335,6322.22,20179,2298,72,15458,15458,14929,15348,14224
48880,9076,11437,46040,2840,0,48880,2.22691e+18,97.888,15095.8,48880,5538,110,47138,47138,47138,47138,47138
7827,23,343,7827,0,7501,326,2.19414e+18,16.9526,676.131,7827,336,18,7484,7484,3998,4937,2468
47299,2641,11030,16629,30670,0,47299,9.87509e+12,60.0738,14223.8,47299,5360,72,46988,46988,46988,46988,46988
7372,121,330,0,7372,7161,211,3.57747e+16,19.8821,930.629,7372,54,26,7042,7042,6395,6399,3370
34896,5907,8263,0,34896,0,34896,6.47515e+17,97.7623,11052,34896,4006,110,26695,26695,23533,19617,19807
33362,1684,17250,0,33362,13389,19973,1.59442e+15,55.5097,18906.5,33362,8396,72,32885,32885,21681,10711,7110
42152,151,176,42039,113,42152,0,6.12626e+18,173.391,2542.26,42152,170,167,41401,40441,37249,37137,36990
35394,125,176,35262,132,35394,0,6.18968e+18,169.932,2308.67,35394,157,160,30687,15240,4877,22794,2102
26031,1098,1315,0,26031,25265,766,4.5154e+16,267.133,4005.48,26031,212,26,24716,24716,24489,24458,23197
20537,5493,7427,0,20537,0,20537,5.42003e+17,94.04,9050.28,20537,3582,110,13110,13110,12129,11110,11464
20479,3834,4831,0,20479,0,20479,6.46818e+17,97.4814,6684.77,20479,2329,110,15648,40599,39146,38007,37726
31655,709,7403,11123,20532,0,31655,9.87276e+12,60.0015,9698.34,31655,3601,72,35868,35868,16130,24082,4454
23144,5357,6351,21864,1280,21864,1280,3.18513e+18,96.5954,8307.03,23144,3071,110,16793,16793,15913,16528,14429
35101,3,15,34081,1020,35017,84,1.63491e+14,10.4145,596.4,35101,14,12,27074,20240,18590,20523,12298
22538,7928,8093,15390,7148,21428,1110,1.8135e+18,96.1797,9805.52,22538,3864,111,27741,27741,27741,27741,27741
34719,2376,8335,32699,2020,32699,2020,5.61266e+18,98.252,11052.6,34719,3941,111,27623,27623,19858,18454,13783
44563,4271,10708,41971,2592,41971,2592,5.46842e+18,98.328,14007,44563,5058,111,34239,34239,27078,23664,18464
6910,1492,1733,6510,400,0,6910,2.21489e+18,96.043,2549.56,6910,820,97,5177,5177,4871,4865,4741
28520,5471,13764,28520,0,27320,1200,4.88412e+18,280.517,15242.9,28520,4680,134,14756,14447,9255,10633,3369
13963,2571,3343,13153,810,0,13963,2.22288e+18,97.1223,4730.05,13963,1602,110,10620,10620,9588,9401,8632
5785,1417,1548,5455,330,5455,330,3.52546e+18,95.8429,2248.49,5785,710,92,4237,4237,4136,4228,4094
46272,4780,19169,44212,2060,44212,2060,2.83138e+18,95.0218,22000.4,46272,9309,110,45969,45969,45969,45969,45969
32098,8265,9790,32098,0,30228,1870,3.54339e+18,218.716,11504.6,32098,3510,130,23248,23248,22974,22870,22336
30740,510,1160,0,30740,29851,889,3.92355e+16,240.988,3688.33,30740,181,26,22062,20456,9555,14415,1735
45645,15948,16828,17141,28504,0,45645,8.13677e+12,57.9153,19467.8,45645,8192,72,45285,45285,45285,45285,45285
34757,3581,8340,32730,2027,32730,2027,3.35567e+18,98.291,11057.6,34757,3951,111,26417,26417,17349,19490,12546
633,36,43,130,503,0,633,5.8209e+13,11.6777,114.714,633,36,14,590,590,569,568,581
10404,206,455,0,10404,10108,296,3.56617e+16,19.9847,1265.07,10404,65,26,9949,9949,9244,9270,5533
29852,5436,7039,28120,1732,0,29852,2.22557e+18,97.6612,9514.12,29852,3399,110,22813,22813,20999,20277,18208
2374,4,11,2306,68,2374,0,1.38366e+14,10.7085,137.154,2374,11,11,2040,1822,1517,1409,1129
29736,547,942,0,29736,28887,849,3.55781e+16,183.985,3021.25,29736,137,26,28791,28503,27037,27249,20931
42835,1,16,41577,1258,42765,70,1.76981e+14,10.3954,716.404,42835,13,12,7531,7531,7531,7531,7531
18711,9,14,18167,544,18665,46,1.59504e+14,10.5312,426.829,18711,12,11,18484,18274,17131,15615,13128
2223,87,107,0,2223,2161,62,3.53643e+16,19.3248,322.895,2223,32,26,2116,2116,2041,2038,1877
7935,5,6,7794,141,7903,32,1.00387e+14,3.98803,203.704,7935,5,4,7929,7929,7929,7928,6880
10542,1879,5598,10542,0,0,10542,8.86417e+17,16.8115,5874.97,10542,5022,20,4944,4944,1547,4106,1462
8969,67,2199,8447,522,8447,522,3.06972e+18,97.0016,3180.65,8969,1016,111,4832,1410,2311,3925,471
41947,9011,12375,39697,2250,39697,2250,6.6345e+18,90.9706,15407.5,41947,5989,110,20305,20305,14606,9380,8316
3075,214,791,2895,180,0,3075,2.23801e+18,93.7483,1246.43,3075,363,69,2284,2284,1524,1392,896
21493,7769,9932,20610,883,0,21493,1.57461e+18,93.9602,11406.9,21493,4815,110,11561,11561,10626,10351,9998
41794,10999,15232,39774,2020,39774,2020,7.64493e+18,95.5744,18017.7,41794,7392,110,32607,32607,32607,32607,32607
30587,39,176,30533,54,30587,0,6.06399e+18,172.336,2157.24,30587,158,165,11329,1808,5859,355,400
44851,5314,24133,18173,26678,0,44851,5.95822e+12,54.8271,26156.6,44851,11736,72,45481,45481,45481,45481,45481
43416,7225,12123,41036,2380,41036,2380,3.25288e+18,97.1846,15294.2,43416,5887,110,35376,35376,35177,35165,33595
42116,6791,9830,39665,2451,39665,2451,5.76103e+18,97.8543,13080.8,42116,4756,110,32712,32712,29648,32072,24592
29388,6150,6889,0,29388,10333,19055,2.52511e+15,59.9746,9047.55,29388,3350,72,22434,22434,22395,22342,21179
24512,4397,9644,23382,1130,0,24512,1.76943e+18,95.0597,11427.8,24512,4668,110,17199,17199,14077,15224,11388
37525,8206,8727,0,37525,13193,24332,2.53755e+15,60.0669,11364,37525,4251,72,24112,24112,21605,20840,18430
23578,629,846,0,23578,22907,671,3.60074e+16,139.787,2564.33,23578,118,26,17381,17124,13510,14838,9697
40753,4921,9478,0,40753,14324,26429,2.52868e+15,60.0446,12303.5,40753,4603,72,35268,35268,29006,33045,17530
19227,4752,7507,0,19227,7283,11944,2.01274e+15,56.289,8800.82,19227,3635,72,11720,11720,9905,8203,7928
16676,424,914,0,16676,16190,486,4.29209e+16,170.771,2566.78,16676,131,26,15762,15497,13378,13636,9660
22254,1706,7241,21106,1148,0,22254,1.97047e+18,96.1571,9032.7,22254,3509,110,15013,15013,8356,6201,2579
37778,5778,11305,35749,2029,35749,2029,5.51557e+18,97.2917,14025.8,37778,5381,111,36550,0,1532,10607,6654
18282,2578,4723,17249,1033,17249,1033,6.22283e+18,97.0399,6386.34,18282,2271,110,13559,13559,13016,13016,7224
5609,478,3063,0,5609,0,5609,3.96896e+17,82.4338,3555.62,5609,1467,80,2546,2374,1243,842,0
4557,2,10,4428,129,4557,0,1.38298e+14,9.86087,184.085,4557,10,10,2632,1858,1809,1883,1564
35842,10,14,34814,1028,35762,80,1.47303e+14,10.6009,603.93,35842,13,12,4667,582,29,351,15
43636,1434,1707,0,43636,42360,1276,4.21454e+16,302.805,5636.61,43636,290,26,26593,26593,18263,16380,8649
47238,15690,16770,17616,29622,0,47238,8.31179e+12,58.1364,19534.1,47238,8165,72,46983,46983,46983,46983,46983
3112,89,146,3112,0,2982,130,2.24397e+18,16.8904,349.804,3112,139,18,2966,2966,2909,2966,2158
34806,9372,14996,33296,1510,0,34806,1.66046e+18,94.6614,17213.6,34806,7279,110,20250,20250,16179,15143,11974
44899,11913,15505,0,44899,16672,28227,2.15958e+15,58.2921,18191.2,44899,7547,72,42905,42905,42905,42905,42905
46863,4,15,45515,1348,46779,84,1.49035e+14,10.4599,676.324,46863,13,13,10082,7987,7660,7871,6991
34981,131,176,34962,19,34981,0,5.9836e+18,169.694,2215.36,34981,170,168,25873,14505,7756,753,2036
38979,14736,20165,0,38979,15661,23318,1.59517e+15,55.5585,22039.4,38979,9823,72,45774,45774,45774,45774,45774
5211,806,1259,0,5211,1828,3383,2.50354e+15,58.9737,1830.33,5211,598,72,3952,3952,3426,3334,2721
39922,886,13482,14768,25154,0,39922,8.53742e+12,58.3768,15942.9,39922,6562,72,39606,39606,39606,39606,39606
40315,8905,11800,38132,2183,38132,2183,3.06427e+18,97.5,14685.4,40315,5626,111,31281,31281,31207,31136,31194
7554,1,11,7339,215,7550,4,1.38502e+14,10.0745,241.35,7554,11,11,1938,1938,1938,1938,1938
1884,2,60,0,1884,1825,59,0.0313163,0.968153,334.83,1884,60,1,1824,1824,1824,1824,1824
25432,1,5,24637,795,25304,128,0.000157282,0.999803,312.753,25432,5,1,25427,25427,25427,25427,25427
17536,6937,7420,16765,771,16765,771,8.62106e+18,91.1122,8756.73,17536,3574,110,10116,10116,10116,10116,10116
34752,2685,12099,33031,1721,0,34752,1.89836e+18,94.2635,14562.1,34752,5854,110,42998,42998,42998,42998,42998
7365,4576,4777,6525,840,6525,840,7.13763e+16,5.50265,5504.26,7365,1597,13,2588,2588,2564,2564,2502
23119,9773,23119,23119,0,23119,0,34358300000,0,23119,23119,23119,1,0,0,0,0,0
29559,273,1060,0,29559,28712,847,3.78754e+16,216.151,3361.84,29559,160,26,29944,29449,11918,7328,2756
2613,2,10,2539,74,2613,0,1.38206e+14,9.87639,140.978,2613,10,10,1510,1069,1043,1071,890
22282,6,13,21648,634,22214,68,1.39184e+14,10.7214,453.734,22282,12,12,21158,20662,15629,15694,15091
33839,162,208,33755,84,33839,0,6.03632e+18,200.41,2403.36,33839,175,177,41011,41011,31633,34412,13147
34426,6862,8060,32419,2007,0,34426,2.22835e+18,97.83,10831.1,34426,3908,110,26366,26366,24746,24439,23044
44138,7594,10341,41569,2569,0,44138,2.22665e+18,97.8781,13710.1,44138,5013,110,37601,37601,37601,37601,37601
17203,1857,5411,17203,0,16200,1003,4.36952e+18,137.678,6519.74,17203,2063,121,17018,17018,12565,16202,6160
45144,5989,13830,42764,2380,0,45144,2.01866e+18,96.7294,17000.6,45144,6712,110,43564,43564,43564,43564,43564
28358,11859,12220,27118,1240,27118,1240,4.20853e+18,95.2738,14085.5,28358,5875,111,28316,28264,26467,25311,23370
38260,17807,19143,15248,23012,0,38260,6.43716e+12,54.8801,21041.6,38260,9303,72,19117,19117,18694,19027,18185
20405,9809,10159,0,20405,0,20405,3.43033e+15,17.9581,10566.6,20405,9137,20,10246,10246,9902,10246,9941
27100,2993,10203,27100,0,25690,1410,4.97923e+18,238.759,11677.8,27100,2556,132,25913,25913,25913,25913,25913
6324,1462,1561,0,6324,2237,4087,2.50959e+15,59.1962,2215.46,6324,755,72,4763,4763,4643,4580,4613
22539,6693,11460,0,22539,0,22539,4.18953e+17,93.2767,12888.2,22539,5561,110,17975,17975,17975,17975,17975
33156,9455,11805,0,33156,12376,20780,2.12993e+15,58.0695,13873.2,33156,5751,72,25276,25276,25276,25276,25276
41876,555,2167,0,41876,0,41876,3.80108e+18,15.9917,2932.44,41876,1738,18,39868,38363,34947,30589,17155
27088,4195,9403,10055,17033,0,27088,8.42308e+12,57.3658,11186.8,27088,4560,72,17685,17685,13448,16709,7560
1456,149,434,1366,90,1366,90,2.57806e+18,89.0955,685.029,1456,180,52,1022,1022,499,645,496
11586,8,13,11256,330,11519,67,1.4426e+14,10.9419,334.092,11586,12,12,11310,11021,8805,8819,8886
32181,6952,10551,30539,1642,30539,1642,3.08116e+18,96.2349,12925.8,32181,5107,110,31154,31154,31154,31154,31154
26266,2118,6377,24744,1522,24744,1522,4.39217e+18,98.0434,8561.73,26266,3003,111,46828,46828,46828,46828,46828
25029,613,1334,0,25029,24287,742,4.63542e+16,270.054,4027.1,25029,214,26,23695,22927,21787,20310,13119
33864,4595,7905,11908,21956,0,33864,9.889e+12,60.0332,10327,33864,3850,72,25959,25959,21173,25132,15436
17841,5311,5888,17841,0,16802,1039,3.14372e+18,139.743,6897.4,17841,2135,124,30995,30995,22353,24078,17449
26150,932,1224,0,26150,25384,766,4.30913e+16,246.957,3739.4,26150,191,26,24926,24926,24775,24669,23694
18041,354,556,0,18041,17765,276,2.46356e+16,3.73566,2178.14,18041,280,4,17485,17485,17464,17344,13853
15034,6393,6967,15034,0,14354,680,3.8872e+18,150.077,7874.25,15034,3019,124,8067,8067,8046,8066,7978
8348,144,359,0,8348,8107,241,3.53901e+16,19.9976,1017.42,8348,57,26,7989,7989,7278,7329,3978
39212,14,19,38022,1190,39100,112,2.11982e+14,10.3326,749.831,39212,15,12,14912,6815,7217,13066,4147
2959,426,769,2779,180,0,2959,2.26176e+18,93.6458,1205.9,2959,354,69,2190,2190,1746,1701,1473
5268,907,1549,3717,1551,4978,290,2.37851e+18,90.5759,2190.63,5268,698,94,3719,3719,3082,3673,2237
45353,18467,19206,0,45353,17460,27893,1.90149e+15,57.0357,21646.3,45353,9346,72,44240,44240,44240,44240,44240
44652,11,15,43377,1275,44570,82,1.38991e+14,10.6108,666.366,44652,14,12,8090,1642,598,995,241
7628,3837,3888,3039,4589,0,7628,6.38352e+12,54.8984,4434.04,7628,1883,72,3740,3740,3707,3727,3698
8183,1091,3088,8183,0,7743,440,3.9254e+18,93.5301,3737.35,8183,1222,113,5095,5095,3489,4198,2509
46593,7000,10871,16378,30215,0,46593,9.87891e+12,60.0646,14021.2,46593,5290,72,46415,31442,24075,16591,14687
12471,1845,4183,12471,0,11743,728,3.07335e+18,101.042,4985.23,12471,1505,119,8288,8279,6075,6855,4124
17741,1175,8192,17741,0,17741,0,4.33073e+15,4409.3,12016.5,17741,8192,3,2348,0,1174,1174,2348
43930,1169,1201,0,43930,42680,1250,3.55203e+16,248.313,4159.42,43930,189,26,30390,30316,18503,22273,13027
14765,6,12,14333,432,14751,14,1.71821e+14,10.6226,363.902,14765,12,11,14090,13673,10960,10529,8093
22354,1221,5305,21054,1300,0,22354,2.22387e+18,97.5804,7284.23,22354,2563,110,17049,17049,8852,8180,4776
40732,1227,1833,0,40732,39533,1199,4.50634e+16,319.026,5918.22,40732,315,26,31257,31257,21342,18757,13714
3507,33,160,0,3507,3404,103,3.5546e+16,19.7847,476.072,3507,38,26,3347,3347,2334,2328,1159
8653,320,2025,3035,5618,0,8653,1.00099e+13,59.5936,2859.25,8653,986,72,6628,6628,4108,6188,1172
9311,9,13,9036,275,9242,69,1.76122e+14,10.6483,308.477,9311,13,12,9204,9122,8901,8798,8189
24792,119,175,24779,13,24792,0,5.98104e+18,167.176,1863.36,24792,162,160,19623,19239,10940,5984,676
22325,691,10214,21396,929,21396,929,2.60551e+18,93.6663,11738.2,22325,4948,110,37941,37766,37681,37941,37915
29676,7,14,28801,875,29646,30,1.77786e+14,10.3348,529.013,29676,13,12,28892,28364,26234,23051,16690
8765,32,170,8763,2,8765,0,5.98145e+18,160.97,1102.81,8765,124,123,4515,1225,1407,1724,1642
38939,9801,20446,37529,1410,37529,1410,2.36445e+18,93.1283,22551.8,38939,9921,110,30576,30576,30576,30576,30576
46018,425,1932,0,46018,44666,1352,4.39787e+16,316.097,6355.98,46018,335,26,45843,45843,45843,45843,45843
10015,3,11,9730,285,10007,8,1.3825e+14,10.4032,280.533,10015,11,11,7591,5403,6240,6611,3973
13848,28,176,13835,13,13848,0,6.06803e+18,165.714,1453.56,13848,132,134,9859,1168,3288,4494,71
40451,633,11570,38253,2198,0,40451,2.07723e+18,97.0539,14544.6,40451,5618,110,32322,32186,21826,23527,14613
48360,18571,19019,46127,2233,0,48360,1.76713e+18,94.819,22029.5,48360,9241,110,23698,23698,22480,21574,20771
8464,610,2291,7992,472,7992,472,6.15092e+18,92.5448,3220.23,8464,1085,104,6173,6173,5347,5088,2355
34918,11107,11250,34918,0,32885,2033,3.40879e+18,247.152,12826.7,34918,4124,132,17482,17482,14597,15146,11116
8847,2172,3569,3361,5486,0,8847,7.68019e+12,56.8229,4275.79,8847,1725,72,5278,5278,4123,5038,2331
17243,14,176,17231,12,17243,0,6.00966e+18,169.007,1590.82,17243,144,150,5455,911,1193,1332,1351
21136,5013,8449,0,21136,8042,13094,1.97504e+15,57.2305,9822.42,21136,4101,72,19322,19322,18497,19266,16255
6165,1137,1706,5815,350,0,6165,2.15258e+18,95.483,2436.05,6165,812,92,4459,4459,3818,3610,3090
34837,2096,8380,32812,2025,32812,2025,2.32096e+18,98.2235,11100.3,34837,3958,111,44862,44862,44862,44862,44862
48720,107,176,48664,56,48720,0,6.01608e+18,172.952,2678.64,48720,172,175,36524,36040,21967,9382,3929
39075,6517,15208,37258,1817,0,39075,1.77879e+18,95.1765,17769,39075,7389,110,18795,18795,14061,15278,8974
48087,3947,17663,0,48087,0,48087,5.3549e+17,95.7766,20763,48087,8582,110,38518,38518,28375,33003,23316
14854,2061,3555,13994,860,13994,860,5.77395e+18,97.1646,5006.7,14854,1710,110,11299,11299,10387,10251,7054
24001,3112,5620,22601,1400,22601,1400,5.87314e+18,97.6594,7716.09,24001,2720,110,25603,25603,18315,16787,9135
22564,268,937,0,22564,21914,650,3.88263e+16,180.737,2808.77,22564,136,26,21577,21334,19290,18222,11109
18495,4674,18495,18495,0,0,18495,7.99957,0,18495,18495,18495,1,0,0,0,0,0
15248,6065,9821,15248,0,13518,1730,1.43705e+18,67.2625,11331.2,15248,3297,18,5427,5365,4972,4894,23089
38567,219,1721,0,38567,37431,1136,4.4585e+16,307.82,5535.82,38567,290,26,18919,17255,2465,17523,0
16753,343,818,0,16753,16267,486,3.95235e+16,122.706,2286.58,16753,112,26,12986,12818,4713,8176,1209
21695,443,789,0,21695,21076,619,3.5519e+16,106.862,2345.09,21695,106,26,21922,21922,13396,4603,2811
17829,2592,4200,0,17829,6265,11564,2.52419e+15,59.8085,5651.37,17829,2032,72,13629,13629,11280,11787,8538
23891,5580,7067,8656,15235,0,23891,9.09979e+12,58.9889,8780.67,23891,3441,72,27381,27203,18186,15305,11108
22928,527,9163,8738,14190,0,22928,7.7781e+12,56.0328,10626.3,22928,4457,72,13765,13573,6537,216,0
1175,341,372,1107,68,0,1175,2.20704e+18,85.6826,583.334,1175,157,48,803,803,781,788,798
27157,1141,9115,10033,17124,0,27157,8.58911e+12,58.3616,10922.3,27157,4437,72,18042,18042,10792,16792,2082
49647,11934,27075,20182,29465,0,49647,5.86162e+12,54.1769,29242.4,49647,13169,72,36242,36242,36242,36242,35886
3303,492,852,0,3303,0,3303,6.40391e+17,93.7975,1331.11,3303,384,72,2451,2451,2079,1787,1711
19008,2328,6171,19008,0,17918,1090,3.22164e+18,147.618,7348.86,19008,2404,124,12837,12745,8574,9936,5525
41422,11995,18094,41422,0,31833,9589,4.98451e+18,367.055,19884.4,41422,5862,138,39522,39522,39522,39522,39522
25090,4323,5846,0,25090,8815,16275,2.53022e+15,59.9787,7754.95,25090,2835,72,25624,25624,16844,14882,6760
43775,15912,18288,43775,0,41618,2157,4.69881e+18,391.305,20092.2,43775,4076,140,23601,23601,19962,23208,19838
4409,67,176,4405,4,4409,0,6.03669e+18,152.971,808.545,4409,98,96,3197,1889,1525,1750,1676
17483,4577,6422,0,17483,0,17483,5.39046e+17,95.3553,7846.39,17483,3110,110,11061,11061,10150,10290,8986
45286,10389,14574,16632,28654,0,45286,8.75743e+12,58.6713,17352.7,45286,7100,72,34964,34964,34964,34964,34964
25051,625,1498,24027,1024,7607,17444,1.33363e+18,16.9911,2104.92,25051,854,27,23553,23553,20827,20819,33833
5275,184,1469,4977,298,0,5275,2.14667e+18,92.7784,2123.98,5275,692,87,34802,34802,34802,34802,34802
41356,1,15,40157,1199,41303,53,1.54935e+14,10.4343,641.71,41356,13,12,10336,10336,10336,10336,10336
21004,1858,10809,8419,12585,0,21004,6.28049e+12,54.9574,11968.3,21004,5248,72,20115,20115,15924,30822,0
44003,8334,22190,0,44003,17583,26420,1.63702e+15,55.7639,24296.8,44003,10805,72,33412,33412,31093,30619,28094
20687,8277,8599,20687,0,19677,1010,4.47559e+18,179.514,9775.45,20687,3666,124,36689,36689,36689,36689,36689
41696,173,234,41617,79,34531,7165,5.98399e+18,168.935,2659.42,41696,172,170,31719,31641,18591,14573,15016
44528,9143,10427,0,44528,0,44528,6.47445e+17,97.8792,13823.5,44528,5055,110,22525,22525,17086,20719,10652
46002,124,2537,0,46002,44619,1383,5.14281e+16,340.344,8115.46,46002,454,26,45887,45880,45811,45828,45613
25746,3839,5998,0,25746,9042,16704,2.53328e+15,59.9743,7942.94,25746,2916,72,19748,19748,16544,12728,12765
45307,950,1231,0,45307,44018,1289,3.55779e+16,255.623,4284.8,45307,194,26,35425,35425,13831,13429,4733
3382,738,868,0,3382,0,3382,6.47306e+17,93.9539,1352.94,3382,399,74,2514,2514,2365,2379,2362
35667,317,8305,12542,23125,0,35667,9.90488e+12,60.0615,10836.4,35667,4041,72,27362,27362,7627,21876,1488
17207,4255,5501,0,17207,0,17207,5.77369e+17,96.0087,6990.85,17207,2646,110,44549,44549,44549,44549,44549
43276,7116,18998,16776,26500,0,43276,7.22821e+12,56.5812,21297.1,43276,9234,72,24278,24278,16322,22208,8136
29351,7732,8701,0,29351,10647,18704,2.3258e+15,59.022,10719,29351,4235,72,20650,20650,19856,18958,19081
43426,1352,10119,40896,2530,40896,2530,5.73719e+18,97.8864,13451.1,43426,4902,110,43225,43225,43225,43225,43225
22621,2294,6574,0,22621,8176,14445,2.34503e+15,59.0417,8224.47,22621,3196,72,16047,16047,11516,6903,5657
39746,6158,15129,37876,1870,37876,1870,7.88307e+18,95.4234,17757.5,39746,7340,110,32058,32058,28009,25448,20527
31377,3021,7366,29547,1830,0,31377,2.22876e+18,97.7528,9938.36,31377,3570,110,21672,21672,18257,14776,14803
18166,50,176,18153,13,18166,0,6.05068e+18,168.231,1659.17,18166,147,146,5913,1432,150,3293,0
40931,3741,10941,0,40931,0,40931,6.20037e+17,97.1363,14007.2,40931,5294,110,35942,35942,35411,35311,33125
31649,7770,14589,30914,735,30266,1383,5.05409e+18,416.305,16248.8,31649,4538,136,35914,35914,33854,33525,25740
27848,2618,6540,0,27848,9793,18055,2.52682e+15,59.9657,8606.36,27848,3182,72,21308,21308,15025,13347,8751
42651,5664,12716,40378,2273,0,42651,2.04255e+18,96.8292,15776.4,42651,6172,110,30551,30551,23623,24715,20563
48776,6839,16608,0,48776,0,48776,5.57782e+17,96.2221,19849.9,48776,8069,110,26794,26794,20661,17681,13955
3351,485,853,3151,200,0,3351,2.25485e+18,94.0943,1334.84,3351,397,74,2498,2498,2091,1966,1703
40359,1020,1296,0,40359,39200,1159,3.78008e+16,261.877,4349.32,40359,208,26,40306,40306,40306,40306,40306
32532,4481,7634,0,32532,0,32532,6.50084e+17,97.7861,10278.8,32532,3700,110,27737,24373,15328,14905,8089
4839,215,1196,4552,287,0,4839,2.24689e+18,95.429,1829.04,4839,564,86,3643,3643,2322,2056,997
27296,17565,17681,24188,3108,0,27296,2.45771e+18,5.53118,20297.7,27296,5897,13,9615,9615,9599,9602,9564
45236,31,176,45163,73,45236,0,6.06009e+18,173.786,2621.54,45236,171,172,23781,4290,8317,15735,76
24682,5161,11048,23642,1040,0,24682,1.61348e+18,94.2651,12719.3,24682,5360,110,27250,27250,19982,15519,11092
10571,908,2573,9951,620,9951,620,2.13075e+18,97.3065,3680.29,10571,1194,111,7998,7998,5663,6676,3409
18895,150,176,18882,13,18895,0,6.04279e+18,170.725,1691.32,18895,145,151,18421,17830,16196,16138,16035
19580,3505,4742,18440,1140,18440,1140,1.21357e+18,97.9086,6489.45,19580,2233,111,14838,14838,14838,14838,11543
25446,6529,7367,0,25446,9192,16254,2.35234e+15,59.0988,9178.53,25446,3588,72,41709,41709,41709,41709,41709
45593,10516,10636,0,45593,16034,29559,2.53278e+15,60.0769,13726.5,45593,5180,72,45401,45401,45401,45401,45401
6574,999,3079,6303,271,6303,271,2.60138e+18,92.369,3694.82,6574,1465,85,3495,3495,2485,2865,1626
1169,173,486,1169,0,1104,65,3.3617e+18,80.3644,657.993,1169,165,50,683,683,371,500,390
13787,1089,3302,0,13787,0,13787,6.49906e+17,97.1452,4669.46,13787,1590,110,10485,10485,6642,4761,4166
47368,742,18565,0,47368,0,47368,5.14633e+17,81.3904,21536.3,47368,9020,110,35846,35592,32635,28062,4538
40554,6877,15456,38644,1910,0,40554,1.80236e+18,95.5175,18120.7,40554,7505,110,25098,25098,19004,17587,12160
39246,7464,11181,14153,25093,0,39246,9.21817e+12,59.2007,13762.5,39246,5438,72,45922,45922,45922,45922,45922
23735,227,827,0,23735,23056,679,3.55142e+16,132.147,2516.82,23735,113,26,22908,22747,17494,17226,10286
3041,36,143,0,3041,2955,86,3.53535e+16,19.681,423.557,3041,38,26,2898,2898,2475,2496,1069
6888,2344,3745,6888,0,6618,270,5.11769e+18,99.6556,4229.54,6888,1017,100,3143,3125,2964,3135,3110
10260,810,3414,9730,530,9730,530,3.96146e+18,93.0338,4406.31,10260,1595,111,6846,6846,4014,5048,1980
17711,2045,4157,0,17711,6226,11485,2.52868e+15,59.8919,5606.11,17711,2016,72,13554,13554,10558,7565,7028
2775,1023,1316,0,2775,1087,1688,1.87953e+15,54.5697,1589.57,2775,641,63,1459,1459,1287,1210,1178
25254,6945,9811,24071,1183,24071,1183,3.01997e+18,95.8028,11614.3,25254,4696,111,15443,36726,34765,36490,31945
36096,17803,19422,14630,21466,0,36096,5.97586e+12,55.2029,21121.8,36096,9461,72,20901,20901,20901,20901,20901
37229,8829,15763,35599,1630,0,37229,1.67921e+18,94.786,18125.5,37229,7652,110,26703,26703,26119,26009,24267
17300,1724,5252,0,17300,6288,11012,2.30187e+15,58.746,6570.46,17300,2554,72,7163,7001,3950,1582,1160
47050,6126,10951,44310,2740,0,47050,2.23031e+18,97.9011,14504.1,47050,5310,110,37393,37393,32815,28100,27269
2672,82,173,2668,4,2672,0,5.99265e+18,141.719,614.001,2672,79,77,2115,1229,1181,1265,1295
33367,624,13362,31830,1537,31830,1537,2.41943e+18,95.8234,15556.8,33367,6421,111,22770,22009,9671,3349,3381
36315,888,1589,0,36315,35252,1063,4.3689e+16,297.515,5084.88,36315,266,26,37769,37769,37038,37009,33094
9714,1409,2722,3497,6217,0,9714,9.32537e+12,58.924,3593.89,9714,1324,72,6992,6992,5834,6749,4067
32566,7229,7654,30674,1892,30674,1892,3.21531e+18,97.7225,10305.3,32566,3694,110,24912,24912,24512,24791,23972
23296,4687,7597,22097,1199,0,23296,1.96733e+18,95.6223,9453.89,23296,3676,110,29614,29614,21682,19929,11777
10266,2641,4332,9806,460,9806,460,8.53902e+18,93.965,5233.18,10266,2092,102,5934,5934,5834,5834,5095
7572,1047,2398,7172,400,0,7572,2.01868e+18,87.7264,3213.94,7572,1134,100,5174,5174,4371,4225,3704
38142,10036,15547,0,38142,14577,23565,1.95321e+15,57.2201,17714.8,38142,7561,72,42825,42825,42825,42825,42825
6763,466,5165,3013,3750,0,6763,3.181e+12,18.2821,5460.94,6763,2510,56,1598,1598,403,216,0
6900,2179,2873,6590,310,0,6900,1.73186e+18,91.5477,3557.23,6900,1364,90,4027,4027,3501,3194,2940
16082,331,4608,15204,878,0,16082,2.08686e+18,96.5587,6074.25,16082,2221,110,11474,11302,7000,6289,1830
1975,297,563,1865,110,1865,110,5.95871e+18,90.2228,885.124,1975,241,56,1412,1412,1352,1352,950
38117,5635,9140,35898,2219,35898,2219,3.69605e+18,98.2823,12058.4,38117,4316,111,28977,28977,25295,28720,18960
36995,771,12398,0,36995,13676,23319,2.19783e+15,58.443,14720.1,36995,6039,72,34523,34523,20342,12049,2971
49625,7,14,48211,1414,49553,72,1.38681e+14,10.5304,696.868,49625,12,11,27871,25436,24962,25665,24720
14972,1414,4941,0,14972,5521,9451,2.22166e+15,58.3036,6085.64,14972,2407,72,10031,10031,7035,5261,4625
14510,1063,3360,5088,9422,0,14510,9.9495e+12,59.8939,4603.02,14510,1636,72,16431,16431,16431,16431,16431
32655,1126,10023,32655,0,30755,1900,3.89063e+18,227.488,11759,32655,3896,125,25660,23851,11991,16079,2707
24699,1176,7983,0,24699,9071,15628,2.23576e+15,58.5029,9685.43,24699,3880,72,16716,16669,10910,5173,3924
12129,3,13,11775,354,12086,43,1.66346e+14,10.8232,355.776,12129,12,11,9422,7051,6941,7690,4394
44180,8374,10594,41630,2550,41630,2550,5.98047e+18,97.7782,13950.5,44180,5134,110,45728,45728,45728,45728,45728
21012,6780,7859,7906,13106,0,21012,8.08341e+12,57.7151,9272.98,21012,3821,72,13153,13153,12447,13033,11820
44535,4448,10399,0,44535,15657,28878,2.52869e+15,60.0588,13434,44535,5061,72,32637,32637,26909,26093,20935
42784,5,13,41562,1222,42767,17,1.38751e+14,10.2744,588.529,42784,12,12,4408,1392,1095,1338,223
47131,6948,14626,17208,29923,0,47131,8.90107e+12,58.8513,17538.4,47131,7125,72,33047,33047,29699,25215,24185
24157,4761,6352,0,24157,0,24157,6.25126e+17,97.2183,8396.38,24157,3072,110,17805,17805,15988,14958,13200
5347,488,1339,1890,3457,0,5347,9.74145e+12,58.922,1913.44,5347,647,72,4008,4008,2757,3790,1411
35338,5261,12580,33595,1743,33595,1743,5.31471e+18,96.4628,15001.7,35338,6012,111,28499,28349,19130,21122,12414
10606,794,4133,10606,0,10054,552,4.95402e+18,115.92,4894.78,10606,1682,117,6473,6352,3993,4800,2104
8328,650,1964,0,8328,2925,5403,2.53231e+15,59.5134,2774.94,8328,951,72,6364,6364,3930,2662,2239
5739,151,200,5737,2,5739,0,6.00367e+18,168.26,933.694,5739,108,107,5421,5165,4594,4649,4550
29742,6556,12182,0,29742,0,29742,5.01497e+17,94.5749,14203.7,29742,5899,110,23850,23850,23850,23850,23850
46171,22575,23997,0,46171,18577,27594,1.58607e+15,55.3843,26133.7,46171,11685,72,45920,45920,45920,45920,45920
44353,44,176,44272,81,44353,0,6.01697e+18,172.885,2561.33,44353,174,172,13805,2952,6908,10226,88
14178,4342,4960,0,14178,0,14178,5.53498e+17,93.4637,6206.4,14178,2378,110,9218,9218,8887,8473,8605
27736,130,176,27659,77,27736,0,6.00514e+18,171.039,2020.97,27736,162,162,26725,26592,15114,24690,706
48993,2067,17387,46573,2420,46573,2420,4.19082e+18,96.5217,20515.3,48993,8309,111,38608,38608,21600,17180,13487
45838,1,16,44509,1329,45778,60,1.56722e+14,10.421,705.037,45838,13,12,14547,14547,14547,14547,14547
46188,10322,14598,0,46188,16907,29281,2.25932e+15,58.1518,17444.2,46188,7095,72,32196,32196,29173,28618,25793
37025,8377,15642,35395,1630,0,37025,1.68428e+18,94.8076,17994.1,37025,7601,110,21383,21383,18114,16360,12808
28321,5301,10291,26938,1383,26938,1383,2.00459e+18,95.9899,12319.8,28321,4909,111,26645,26645,23125,18849,17735
11437,1360,3819,4211,7226,0,11437,8.61366e+12,58.0989,4747.53,11437,1854,72,7618,7618,4859,6921,2647
42202,1836,2145,42202,0,40461,1741,2.81308e+18,17.9681,2953.4,42202,1136,32,28788,25156,7671,4035,6794
44086,6279,24560,19545,24541,44086,0,4.59768e+18,17.8941,25121.1,44086,22089,20,46806,46806,46806,46806,46806
49360,14718,49360,0,49360,49360,0,2047.96,0,49360,49360,49360,1,0,0,0,0,0
32861,9,14,31918,943,32785,76,1.46412e+14,10.598,569.519,32861,13,12,5318,923,364,2308,84
18112,6433,7104,0,18112,6875,11237,2.01653e+15,55.958,8334.17,18112,3453,72,11008,11008,10189,10050,8991
16677,2472,4022,0,16677,5883,10794,2.50303e+15,59.7153,5394.45,16677,1943,72,12655,12655,10676,9173,8424
46601,2064,18621,46601,0,44641,1960,4.54682e+18,2820.44,22249.4,46601,5979,145,38066,38066,26924,23828,20113
28786,5154,8895,28786,0,27106,1680,4.67934e+18,181.945,10470.4,28786,3443,124,27017,27017,18352,19730,8269
29437,3773,6860,0,29437,0,29437,6.50382e+17,97.7732,9313.77,29437,3323,110,22577,22577,19036,17046,13214
24294,6158,10349,24294,0,23134,1160,4.72399e+18,219.511,11670.5,24294,3293,130,30283,30283,18832,22123,13137
42149,16881,20059,40469,1680,0,42149,1.52659e+18,89.8116,22476.4,42149,9731,110,22090,22090,20866,20630,19742
47609,8,17,46194,1415,47506,103,1.82912e+14,10.3683,773.434,47609,14,13,33392,31582,31332,32068,30856
11247,264,6138,11247,0,10817,430,4.07582e+18,154.415,6831.39,11247,2780,112,12769,12759,12516,12353,12337
49051,24791,24870,47201,1850,47201,1850,2.42307e+18,93.7854,27409.6,49051,11991,111,47022,47022,47022,47022,47022
18285,6379,18285,18285,0,18285,0,34357900000,0,18285,18285,18285,1,0,0,0,0,0
10577,1,13,10274,303,10511,66,1.38303e+14,10.9406,313.448,10577,12,12,2715,2715,2715,2715,2715
42477,484,1181,0,42477,41269,1208,3.55869e+16,246.429,4060.97,42477,184,26,25531,23747,14377,18457,7820
46235,3684,16720,17305,28930,0,46235,8.22882e+12,57.9079,19415.8,46235,8129,72,37505,37505,30207,35780,21671
11368,5371,6477,10988,380,10988,380,2.87663e+18,79.4096,7257.15,11368,3095,98,4891,4891,4891,4891,4891
14670,2015,3510,13819,851,13819,851,3.35208e+18,97.1718,4946.83,14670,1673,110,11160,11160,8167,9539,6866
27592,2125,12591,26442,1150,26442,1150,4.44288e+18,94.8474,14357.9,27592,6062,111,24855,24768,21487,22139,34509
37348,3,13,36279,1069,37329,19,1.47483e+14,10.2533,560.713,37348,12,12,25798,16909,15718,17093,6116
35748,2646,11526,35748,0,33666,2082,4.87525e+18,253.175,13128.2,35748,4262,127,42611,42611,42611,42611,42611
49201,2721,13910,46517,2684,0,49201,2.08548e+18,97.1436,17395,49201,6757,110,42673,42673,37546,39361,32812
8185,378,619,0,8185,7943,242,4.37628e+16,19.146,1502.89,8185,78,26,7566,7566,7166,7095,4514
667,225,258,629,38,629,38,5.71152e+18,75.8771,384.225,667,97,38,409,409,395,401,404
16182,41,3813,0,16182,5686,10496,2.53468e+15,59.812,5156.4,16182,1853,72,9951,2634,6166,2222,133
28879,79,208,28828,51,28879,0,6.05013e+18,200.031,2217.19,28879,168,172,27380,26078,26219,26740,25777
6137,1933,2098,6137,0,5777,360,6.78874e+18,91.3577,2625.14,6137,737,99,16277,16277,9768,6088,4173
42842,42,176,42740,102,42842,0,6.10718e+18,173.135,2562.7,42842,169,169,28513,16103,14976,17023,16186
13717,827,4082,12984,733,12984,733,6.56884e+18,96.1383,5369.02,13717,1960,110,9635,9635,8364,8432,2771
3132,988,1229,2982,150,0,3132,1.84378e+18,76.6711,1629.72,3132,567,64,1903,1903,1657,1602,1494
46249,10260,10829,0,46249,0,46249,6.47823e+17,97.8837,14324.2,46249,5254,110,23170,23170,18268,12387,12474
11471,554,2732,4041,7430,0,11471,9.87101e+12,59.6834,3762.49,11471,1325,72,8739,8739,5627,8201,1976
34611,11063,12764,12996,21615,0,34611,8.14614e+12,57.8875,14875.2,34611,6212,72,41734,41734,41734,41734,41734
44604,2501,10966,42032,2572,42032,2572,5.48664e+18,98.2245,14249.6,44604,5186,111,33650,33650,21252,26496,15617
36559,21178,21859,0,36559,15206,21353,1.32813e+15,54.2414,23398.2,36559,10644,72,32722,32722,32722,32722,32722
31641,9240,10286,31641,0,29801,1840,5.31486e+18,211.163,11750.5,31641,3764,125,21355,21338,20691,21092,19917
12415,319,3061,11695,720,11695,720,4.549e+18,97.47,4306.8,12415,1437,111,9354,9354,4242,6022,1691
4718,440,1744,4718,0,4458,260,4.7253e+18,92.2666,2208.77,4718,672,90,2974,2974,1831,2226,1244
46922,3,16,45538,1384,46818,104,1.79154e+14,10.3653,759.327,46922,14,12,4947,1259,576,543,222
42718,11497,19588,0,42718,16712,26006,1.78805e+15,56.4902,21796.9,42718,9539,72,32696,32696,32696,32696,32696
46303,1668,10829,43605,2698,0,46303,2.22759e+18,97.9202,14330.8,46303,5257,110,36872,36637,32484,34208,28448
41191,11710,21739,16629,24562,0,41191,6.10265e+12,54.6929,23662.7,41191,10584,72,24192,24074,21888,23193,18648
20393,2187,5503,19260,1133,0,20393,2.13099e+18,96.9362,7287.25,20393,2659,110,14890,14890,10983,10032,6685
7747,2,11,7526,221,7746,1,1.39593e+14,10.0003,245.266,7747,11,11,4489,3190,3054,36494,35888
36124,10225,11062,0,36124,0,36124,5.87508e+17,95.9663,13724.9,36124,5365,110,42026,42026,42026,42026,42026
28946,158,176,28926,20,28946,0,6.01882e+18,172.445,2063.01,28946,167,162,28494,27784,25889,26029,25900
1144,68,90,232,912,0,1144,5.6679e+13,11.8164,189.401,1144,55,14,1054,1054,945,900,1002
42805,10844,16337,0,42805,0,42805,5.22693e+17,95.501,19118.4,42805,7932,110,25346,24397,21851,22925,18925
8472,1257,4847,0,8472,0,8472,3.67908e+17,83.8647,5481.53,8472,2320,94,30986,30986,30318,9421,5285
49685,2458,11609,0,49685,0,49685,6.47457e+17,97.9054,15317.4,49685,5631,110,49452,49452,49452,49452,49452
17344,1202,4117,16334,1010,0,17344,2.22789e+18,97.3581,5747.07,17344,1981,110,13227,13227,9299,8404,4677
21904,4189,5148,0,21904,0,21904,6.50446e+17,97.5615,7097.36,21904,2489,110,16756,16756,15457,14609,14161
18049,162,556,0,18049,17773,276,2.46247e+16,3.735,2179.96,18049,280,4,17493,17493,16034,15940,10263
14978,4,12,14539,439,14963,15,1.80465e+14,9.95367,363.657,14978,11,12,13031,11495,9130,9654,6602
13530,480,4742,12860,670,12860,670,7.54738e+18,93.1741,5946.92,13530,2269,110,8788,8702,3704,7283,2100
19441,4519,8100,0,19441,7465,11976,1.9346e+15,57.0235,9357.15,19441,3946,72,19507,19507,6049,5625,4747
26116,10299,11641,25013,1103,0,26116,1.61879e+18,91.7932,13388.9,26116,5644,110,14475,14475,13465,13268,12671
8975,620,649,0,8975,8714,261,4.29134e+16,19.5533,1581.72,8975,83,26,8326,8326,8283,8284,8028
23375,5419,8859,23375,0,23375,0,2.2341e+18,1882.42,10391.3,23375,6582,23,24131,24131,24131,24131,24131
7743,1376,5696,0,7743,3404,4339,8.98452e+14,21.6632,6050.96,7743,2768,64,2047,2047,626,281,0
47962,30,61,47866,96,47962,0,2.3439e+18,60.8577,1621.4,47962,61,61,34300,24292,22295,33793,21574
39398,444,1118,0,39398,38276,1122,3.5535e+16,233.501,3801.5,39398,172,26,49095,49095,49095,49095,49095
35897,31414,35897,35897,0,0,35897,7.99978,0,35897,35897,35897,1,0,0,0,0,0
4581,88,1157,4318,263,0,4581,2.22319e+18,94.7981,1763.42,4581,530,83,2999,972,2049,1731,375
29607,2473,6903,27877,1730,27877,1730,5.74039e+18,97.7447,9366.54,29607,3334,110,22704,22704,20021,19591,9322
21617,603,1247,0,21617,20971,646,4.74606e+16,255.176,3675.31,21617,196,26,25258,25258,25258,25258,25258
29304,9,13,28447,857,29284,20,1.65346e+14,10.283,513.961,29304,12,12,4745,1282,619,2470,29
42708,627,11713,0,42708,15318,27390,2.39255e+15,59.1304,14518.7,42708,5683,72,42116,42116,42116,42116,42116
22132,5,8,20284,1848,21876,256,1.17286e+14,7.41162,366.594,22132,8,8,19154,16747,13592,13978,17667
42115,4073,11609,39799,2316,39799,2316,6.34884e+18,97.1812,14714.7,42115,5628,110,44758,44758,44758,44758,44758
2063,320,574,0,2063,0,2063,6.56426e+17,91.1847,906.116,2063,256,59,1489,1489,1210,1126,1021
45302,65,208,45241,61,45302,0,5.98935e+18,195.475,2645.13,45302,184,177,21777,21579,785,2116,108
45734,5438,15319,0,45734,0,45734,5.6223e+17,94.689,18422.2,45734,7421,110,43914,43914,43914,43914,43914
34548,6834,8097,0,34548,0,34548,6.47613e+17,97.7959,10875.3,34548,3916,110,34207,34207,34207,34207,34207
41664,43,176,41648,16,41664,0,5.98297e+18,169.613,2416.23,41664,171,170,28229,8175,17664,52,715
15566,736,4433,14708,858,14708,858,3.42628e+18,97.0969,5845.25,15566,2093,111,11133,11046,6541,7469,2804
28092,9195,9796,0,28092,0,28092,5.50786e+17,95.8545,11885.4,28092,4739,110,18296,18296,17515,17052,16869
5081,482,1248,0,5081,0,5081,6.57171e+17,95.642,1906.06,5081,584,87,3833,3833,2801,1512,1868
46446,10,16,45094,1352,46381,65,1.62767e+14,10.4454,727.554,46446,13,12,16220,11427,10575,11060,11039
46585,65,176,46507,78,46585,0,5.98238e+18,172.011,2557.49,46585,171,172,40920,34439,32423,33511,33204
40503,116,176,40428,75,40503,0,5.98222e+18,169.753,2382.88,40503,172,170,38956,37122,32542,32928,33030
3940,643,1408,1455,2485,0,3940,8.47768e+12,57.0442,1819.38,3940,685,66,27954,27906,24993,25195,26435
33211,10986,15681,31878,1333,0,33211,1.54013e+18,93.9759,17700.5,33211,7617,110,34075,34075,34075,34075,34075
48186,12367,23037,19022,29164,0,48186,6.73246e+12,56.181,25398.3,48186,11219,72,32870,32870,31373,32772,29406
28035,7567,7879,26503,1532,26503,1532,6.5652e+18,96.9339,10127.4,28035,3817,110,27835,27835,27835,27835,27835
41268,6290,9659,14512,26756,0,41268,9.86751e+12,60.0344,12505.6,41268,4701,72,28772,28772,23805,21775,15804
3177,627,1173,0,3177,1191,1986,2.14413e+15,56.5178,1520.83,3177,566,69,2004,2004,1792,1670,1739
25338,5375,12867,25338,0,24318,1020,5.16458e+18,217.59,14175.7,25338,5887,129,12471,12351,11968,12212,11462
44798,1113,1697,0,44798,43493,1305,4.15797e+16,296.723,5642.31,44798,288,26,30965,30965,19662,17423,5775
23178,1353,1379,0,23178,22489,689,4.91514e+16,278.763,4100.4,23178,222,26,21799,21799,21787,21781,21702
36778,11167,15013,0,36778,14058,22720,1.95467e+15,57.2374,17115.5,36778,7309,72,23470,22814,18666,19187,11050
36703,8319,8577,34563,2140,34563,2140,5.87661e+18,97.842,11491,36703,4160,110,28126,28126,28066,28066,27641
7704,227,242,0,7704,7463,241,0.0312825,0.968588,1364.12,7704,242,1,40960,40960,40846,40959,41319
37510,8104,8781,0,37510,0,37510,6.47418e+17,97.8041,11746.3,37510,4253,110,25328,25328,22631,24575,17886
43346,9030,24650,17808,25538,0,43346,5.56425e+12,53.513,26516.6,43346,11986,72,42994,42994,42994,42994,42994
12606,3640,5803,12083,523,12083,523,2.62813e+18,93.534,6796.99,12606,2798,110,6803,6803,5753,6564,4833
36242,12105,17998,14419,21823,0,36242,6.4986e+12,55.7092,19824.8,36242,8750,72,29867,29867,29867,29867,29867
29255,2160,10249,27795,1460,27795,1460,3.64386e+18,96.5296,12359.7,29255,4903,111,30477,30477,30477,30477,30477
7998,776,3631,7998,0,7609,389,4.37591e+18,97.8248,4185.6,7998,1470,108,4367,4359,1918,2885,857
24354,5792,8029,23096,1258,23096,1258,6.61237e+18,96.7293,9904.91,24354,3831,111,23863,23863,23863,23863,23863
29840,2,12,28990,850,29830,10,1.38974e+14,10.1708,485.337,29840,11,12,1854,64,200,272,41
38551,8923,9076,0,38551,0,38551,6.4677e+17,97.8024,12098.8,38551,4397,110,29475,29475,29291,29139,29272
13660,271,579,0,13660,13268,392,3.5591e+16,20.0846,1607.73,13660,78,26,13081,13081,12158,12242,7154
41244,9710,13512,39134,2110,39134,2110,7.08917e+18,96.3547,16393,41244,6555,110,37619,37619,37190,37619,32549
47476,6841,13940,0,47476,0,47476,5.97088e+17,96.944,17288.2,47476,6767,110,39719,39719,39704,39704,38481
8718,23,32,8654,64,8718,0,1.11596e+18,31.8825,528.182,8718,32,32,17480,17128,7790,10078,12052
9387,565,2263,3298,6089,0,9387,9.86103e+12,59.4957,3145.09,9387,1099,72,7124,7124,3652,6171,1949
48945,12373,20407,48945,0,46853,2092,5.01478e+18,2685.81,23730.4,48945,7934,151,38845,38845,38845,38845,38845
30631,18,957,0,30631,29757,874,3.55548e+16,189.437,3090.88,30631,140,26,36770,36721,36507,36638,36077
45447,10855,12166,42917,2530,42917,2530,3.20962e+18,97.3619,15495.4,45447,5905,110,31489,31489,31489,31219,27108
32959,593,1416,0,32959,31996,963,4.26871e+16,273.348,4495.57,32959,230,26,29880,29880,17551,2000,2454
3653,305,954,0,3653,1295,2358,2.49949e+15,58.3134,1384.46,3653,459,65,2699,2699,1781,653,903
19479,6137,9374,18699,780,18699,780,4.29017e+18,91.6509,10690.8,19479,4486,111,10105,10105,8174,8562,8301
36202,232,9910,0,36202,12976,23226,2.39812e+15,58.5863,12360.6,36202,4810,72,24878,24110,11454,6278,1110
18745,817,894,0,18745,18203,542,4.03169e+16,158.604,2569.64,18745,127,26,17851,17851,17683,17676,16792
40076,17907,18664,38446,1630,38446,1630,2.63657e+18,93.2354,21018.6,40076,9055,110,27049,27049,27049,27049,25118
39272,6992,10470,37082,2190,0,39272,2.13398e+18,97.3071,13438.9,39272,5075,110,34262,34262,34262,34262,34262
42197,75,176,42182,15,42197,0,5.9828e+18,172.025,2434.72,42197,171,171,47117,46973,37755,37090,9679
40440,8554,18988,38810,1630,38810,1630,9.33875e+18,93.3418,21350,40440,9209,110,30396,30396,28221,24451,23788
3634,25,176,3634,0,3634,0,6.00319e+18,144.049,730.222,3634,90,85,1639,385,482,536,541
39134,5,12,38019,1115,39118,16,1.39076e+14,10.2258,559.273,39134,11,12,20748,19041,18866,18576,18490
36354,7129,8467,12771,23583,0,36354,9.90462e+12,60.0597,11036.2,36354,4124,72,36174,36342,0,991,991
28023,683,9178,28023,0,26393,1630,3.69138e+18,172.245,10520.4,28023,3363,124,34948,34948,12403,14051,3804
30575,1273,11769,29142,1433,29142,1433,2.85793e+18,95.3462,13898.4,30575,5703,110,18806,18776,13128,12794,3820
19299,5253,6518,19299,0,18219,1080,3.27915e+18,145.797,7695.39,19299,2569,125,12781,12781,11621,12026,10424
22678,557,764,0,22678,22298,380,2.52542e+16,3.73512,2958.62,22678,384,4,21664,21287,20374,20292,15044
8038,258,2556,8038,0,7568,470,4.37431e+18,93.6925,3232.15,8038,661,110,5482,5482,3575,18166,14413
38950,4759,12479,38950,0,36682,2268,4.96093e+18,280.11,14185.8,38950,3333,133,27869,27869,19413,8741,9078
42252,5737,9860,0,42252,0,42252,6.48078e+17,97.8646,13118,42252,4779,110,34746,34746,33167,30977,30694
8685,1992,2988,8685,0,8183,502,5.46729e+18,91.9899,3631.92,8685,1068,115,5697,21853,20951,21549,20206
41920,672,9782,39480,2440,39480,2440,5.73931e+18,97.8581,13021.1,41920,4733,110,41606,31374,19115,24636,12383
645,40,87,0,645,627,18,5.32891e+16,13.1488,194.028,645,26,18,558,558,441,469,215
6318,1233,1895,5978,340,0,6318,2.0681e+18,88.7208,2626.62,6318,882,96,4423,4423,4180,4170,4119
20921,1,3,20267,654,20857,64,9.55977e-05,0.999857,249.065,20921,3,1,20918,20918,20918,20918,20918
13051,1768,3542,0,13051,0,13051,6.2259e+17,93.093,4817.66,13051,1700,110,9509,9509,7160,4512,4572
9468,652,2719,3418,6050,0,9468,9.29794e+12,58.8297,3564.44,9468,1324,72,6749,6701,2504,5602,539
27850,5345,6578,26232,1618,0,27850,2.22524e+18,97.6475,8920.36,27850,3183,110,34872,34872,26529,24835,16290
25426,2161,6280,0,25426,0,25426,6.39153e+17,97.4567,8440.26,25426,3040,110,19146,19146,14112,7706,8117
30971,668,12738,29571,1400,29571,1400,5.84869e+18,95.5549,14783.9,30971,6115,111,18233,17802,2402,18066,2666
30059,11892,14860,30059,0,28836,1223,4.92647e+18,424.902,16429.3,30059,4502,140,28624,28624,28624,28624,28624
14326,2553,5659,13656,670,13656,670,3.17221e+18,95.3625,6833.29,14326,2703,111,8667,8667,6979,8046,5176
23775,797,1081,0,23775,23083,692,4.15403e+16,211.702,3266.19,23775,165,26,34342,34342,15368,20028,4546
16986,91,1031,0,16986,16484,502,4.64349e+16,211.621,2913.59,16986,153,26,15657,15502,12458,9824,3966
4271,664,1072,4021,250,4021,250,5.70867e+18,94.8658,1649.36,4271,495,82,3199,3199,2948,2919,2288
7357,1551,2695,6997,360,6997,360,3.72278e+18,94.7551,3447.37,7357,1265,94,4662,4662,3845,4611,3064
24971,2208,6579,23570,1401,23570,1401,6.29478e+18,97.1709,8671.66,24971,3183,110,18392,18392,17493,17493,7756
15234,1105,3537,5349,9885,0,15234,9.94127e+12,59.8787,4823.34,15234,1722,72,11697,11697,7010,10476,3831
9061,137,170,9054,7,9061,0,5.9687e+18,161.731,1122.09,9061,122,127,8646,8113,7163,7301,7312
10234,146,3926,9744,490,9744,490,3.49516e+18,95.0929,4858.02,10234,1867,108,6308,6050,2333,3736,978
13077,44,555,0,13077,12705,372,3.55963e+16,20.1112,1546.69,13077,75,26,16914,16826,1770,8268,188
49823,2720,12892,47003,2820,47003,2820,3.75881e+18,97.9658,16413.1,49823,6131,111,48175,48175,48175,48175,48175
14039,4778,4855,13333,706,13333,706,3.96287e+18,96.0128,6079.76,14039,2304,111,9184,9184,9130,9178,9144
1658,340,437,591,1067,0,1658,1.02411e+13,56.6568,680.245,1658,206,52,1221,1221,1106,1191,1051
32769,2,14,31835,934,32692,77,1.38972e+14,10.6672,556.972,32769,14,12,2090,1023,1025,1067,1025
47280,3190,18157,0,47280,0,47280,5.2109e+17,82.9021,21154.4,47280,8814,110,47075,47075,47075,47075,47075
24308,3299,6445,0,24308,0,24308,6.22768e+17,97.1648,8497.49,24308,3117,110,24031,24031,24031,24031,22391
27543,132,176,27529,14,27543,0,6.01551e+18,171.748,2013.92,27543,165,162,31344,0,0,0,172
44939,55,176,44854,85,44939,0,6.09375e+18,173.424,2624.63,44939,172,169,23150,6056,9821,554,704
27589,2503,7320,0,27589,9852,17737,2.42709e+15,59.464,9305.41,27589,3555,72,32860,32860,22254,30809,8371
49747,12,15,48314,1433,49662,85,1.5153e+14,10.3852,720.964,49747,14,12,23526,18544,17989,18616,17617
15011,4787,6508,0,15011,0,15011,4.84463e+17,93.8867,7681.57,15011,3147,110,8503,8503,7038,6514,5784
5456,102,111,5449,7,5456,0,6.3959e+18,85.2603,698.528,5456,88,78,5345,5345,5344,5343,31632
28379,1658,6858,26729,1650,26729,1650,5.1332e+18,98.1335,9177.84,28379,3241,111,17627,17541,9790,6178,6323
18155,531,568,0,18155,17588,567,0.0312311,0.968714,3210.81,18155,568,1,17587,17587,17587,17587,17587
13591,3125,4308,0,13591,0,13591,5.81496e+17,95.9025,5561.43,13591,2075,110,0,0,470,21722,21722
46925,10682,14954,46925,0,44194,2731,3.85047e+18,325.204,16901.7,46925,5104,133,37438,37438,37438,37438,37438
33211,2978,7787,31278,1933,31278,1933,5.72558e+18,97.7809,10480.8,33211,3777,110,25424,25424,22517,22049,10871
7512,115,3597,2960,4552,0,7512,6.7832e+12,50.004,4166.26,7512,1742,72,35753,3898,8936,15942,70
37163,9117,15905,37163,0,25188,11975,4.82588e+18,409.007,17563.8,37163,4690,140,21258,21051,17041,19286,12580
21192,2101,11585,4574,16618,0,21192,53166800000,8.97678,11865.8,21192,10419,11,9607,9607,3561,9607,3140
48814,5637,11412,0,48814,0,48814,6.47608e+17,97.908,15066.2,48814,5531,110,48379,48379,48379,48379,48379
11262,3872,7681,10982,280,10982,280,3.78277e+18,88.0639,8305.83,11262,3690,93,3581,3581,2206,2411,2324
16132,130,6365,0,16132,6115,10017,2.00357e+15,57.305,7488.34,16132,3095,72,9767,9437,3532,2378,515
32820,195,206,32809,11,32820,0,5.98427e+18,186.013,2230.9,32820,174,175,32614,32599,31701,31688,31714
16345,3,12,15880,465,16335,10,1.38938e+14,10.5195,357.867,16345,11,11,12524,8811,10441,9989,7601
14323,3447,4812,14323,0,13493,830,4.17889e+18,116.264,5687.29,14323,1720,120,9511,9482,8081,8721,7238
15422,10,11,14985,437,15418,4,1.39004e+14,10.1034,346.703,15422,11,11,2906,912,417,50,60
46755,161,208,46675,80,46755,0,6.11428e+18,204.054,2888.68,46755,186,180,36303,35873,25092,22978,11388
27625,6036,6520,0,27625,0,27625,6.47378e+17,97.6517,8849.9,27625,3155,110,27305,27305,20003,19975,19025
11739,124,4902,0,11739,4497,7242,1.92615e+15,53.8233,5760.53,11739,2365,72,6837,6646,2232,475,486
14507,3886,4087,0,14507,0,14507,6.1381e+17,96.5891,5450.3,14507,1971,110,30191,30191,28671,28671,11669
14984,56,698,0,14984,14552,432,3.67405e+16,24.9122,1877.61,14984,89,26,14286,14273,9671,9326,3112
39082,4,16,37925,1157,39004,78,1.83324e+14,10.5111,672.692,39082,15,12,37974,37900,37878,37854,37916
4462,82,175,4462,0,4462,0,5.98837e+18,151.595,795.053,4462,97,94,27465,9329,12847,19402,2051
14369,1411,3427,13531,838,13531,838,5.75172e+18,97.2754,4842.36,14369,1651,110,10942,10942,9755,9562,5258
43309,16882,20290,41559,1750,41559,1750,2.6265e+18,93.5448,22785.5,43309,9862,110,23019,23019,19907,21069,19153
35426,4945,12393,35426,0,33506,1920,4.30732e+18,253.051,14184.4,35426,3549,133,37579,37579,37579,37579,37579
3865,3022,3303,3865,0,3815,50,4.38334e+18,85.1752,3461.62,3865,1548,55,562,562,557,559,562
38303,2903,8949,36073,2230,0,38303,2.22813e+18,97.844,11966.8,38303,4334,110,29298,29298,26974,26538,17828
39604,12254,15276,37752,1852,0,39604,1.79094e+18,95.4319,17875.2,39604,7419,110,25612,25612,24943,25230,24340
36463,8088,11750,34583,1880,0,36463,1.97348e+18,96.415,14384.1,36463,5702,110,42749,42749,42749,42749,42749
4211,943,1406,0,4211,1540,2671,2.2713e+15,57.4431,1848.01,4211,684,65,2805,2805,2245,1547,1493
43751,3468,10251,41204,2547,41204,2547,3.35309e+18,97.8921,13598.3,43751,4975,110,27440,27440,19937,18153,12042
11117,3,170,11116,1,11117,0,5.97052e+18,163.226,1242.46,11117,130,135,951,155,92,65,136
26782,4,15,25983,799,26718,64,1.87864e+14,10.2778,562.273,26782,13,11,23538,21104,19394,12108,9090
46328,15599,21882,44468,1860,0,46328,1.53711e+18,94.1132,24494.4,46328,10640,110,32685,32685,32685,32685,32685
17261,5515,6072,6429,10832,0,17261,8.36424e+12,56.588,7320.14,17261,2944,72,20726,20726,12238,6188,3734
18631,3814,7173,18631,0,17641,990,4.07237e+18,148.83,8170.99,18631,2305,128,11458,11419,8471,9667,6590
38581,1153,9006,0,38581,0,38581,6.49144e+17,97.8601,12037,38581,4369,110,35435,35435,24337,43261,0
38365,12596,12887,0,38365,0,38365,5.6286e+17,94.8756,15583.2,38365,6243,110,29238,29238,29238,29238,29238
44362,13,15,43072,1290,44303,59,1.60014e+14,10.4573,689.457,44362,13,12,10418,3346,2361,5212,2167
14064,4046,7248,5640,8424,0,14064,6.28e+12,53.3298,8105.66,14064,3524,72,6816,6816,5817,6606,4324
27887,5023,6579,26267,1620,26267,1620,5.90195e+18,97.6645,8927.52,27887,3181,110,39766,39766,39766,39766,39766
39440,13,14,38314,1126,39359,81,1.39068e+14,10.6669,620.816,39440,13,12,15130,11195,11391,10967,10405
13228,226,3172,12458,770,0,13228,2.22715e+18,97.1118,4500.68,13228,1520,110,10056,10056,6082,5421,1394
28371,17,1668,0,28371,27521,850,5.05224e+16,300.701,5093.17,28371,280,26,7902,1134,389,2051,89
7790,386,1883,7338,452,0,7790,2.23221e+18,96.2499,2783.13,7790,891,102,5907,5907,3876,3553,1615
28214,5060,6613,9919,18295,0,28214,9.87277e+12,59.981,8704.88,28214,3215,72,21601,21601,19794,21221,16916
45786,5,14,44481,1305,45707,79,1.38961e+14,10.4286,646.988,45786,13,12,7122,1590,1153,1142,1251
28293,5128,7364,26703,1590,0,28293,2.15384e+18,96.0964,9681.17,28293,3547,110,20929,20929,18400,18022,15507
3192,668,2269,3112,80,3112,80,3.30643e+18,67.4659,2504.37,3192,1060,56,923,836,263,384,0
29254,4119,7962,27624,1630,27624,1630,1.55586e+18,97.6635,10265.4,29254,3771,111,28803,28803,28803,28803,28803
48493,3790,14539,48493,0,45670,2823,4.24696e+18,331.029,16882.2,48493,4162,137,47123,47123,47123,47123,47123
46406,12,14,45085,1321,46324,82,1.38948e+14,10.5145,663.085,46406,13,12,46389,46387,46323,46324,46260
32370,5151,9864,30658,1712,0,32370,2.02461e+18,96.6375,12312.5,32370,4782,110,23687,23687,18257,19671,10885
49660,4947,15944,49660,0,46780,2880,4.60918e+18,337.876,17969.7,49660,3278,138,33686,33686,32521,32625,20868
49088,3577,13180,46358,2730,46358,2730,6.40336e+18,97.3676,16715,49088,6403,110,38355,38355,36545,35880,16392
7201,157,170,7200,1,7201,0,5.97315e+18,159.188,999.803,7201,116,116,6975,6811,6497,6529,6545
17793,1977,4873,0,17793,6370,11423,2.40297e+15,59.2357,6264.67,17793,2369,72,12920,12920,9962,7477,6495
8270,75,208,8264,6,8270,0,6.02217e+18,176.609,1180.53,8270,118,122,4251,12761,29,5806,517
9355,1357,5020,0,9355,2026,7329,1.35774e+13,8.86756,5206.5,9355,4510,11,4335,4335,1923,4335,1742
34426,7856,8079,0,34426,0,34426,6.46681e+17,97.7571,10849.9,34426,3903,110,26347,26347,26090,26026,25996
44326,8931,14954,42096,2230,0,44326,1.92789e+18,95.1157,17972.3,44326,7244,110,43855,43855,43855,43855,43855
29219,8139,11122,29219,0,27669,1550,4.47557e+18,230.872,12487.4,29219,4415,126,15039,15039,13049,9888,9758
39378,10,12,38255,1123,39359,19,1.39079e+14,10.3094,564.108,39378,12,11,11062,5064,3546,2497,2218
40745,20,176,40664,81,40745,0,6.01733e+18,172.882,2452.45,40745,169,172,12379,1089,304,3691,811
41592,3129,9707,39170,2422,39170,2422,3.22992e+18,97.8547,12923.7,41592,4696,110,41185,41185,41185,41185,41185
39097,701,13290,37137,1960,37137,1960,2.96041e+18,96.0215,16015.8,39097,6435,110,25807,25291,15003,17123,3596
39844,6683,9541,37523,2321,37523,2321,4.88819e+18,98.3028,12562.4,39844,4509,111,40250,40250,40250,40250,40250
30014,4877,13142,0,30014,0,30014,4.77176e+17,92.846,15104.5,30014,6378,110,28497,28497,28497,28497,28497
17129,1189,4791,16189,940,0,17129,2.10358e+18,96.4132,6339.93,17129,2309,110,12338,12338,8580,7817,4311
17669,2649,4399,6254,11415,0,17669,9.70876e+12,59.5105,5822.77,17669,2126,72,41088,41088,41088,41088,41088
37082,108,176,36999,83,37082,0,5.98263e+18,169.699,2280.55,37082,170,169,29101,17020,19337,23255,13634
23761,10,12,23069,692,23746,15,1.6838e+14,10.218,457.653,23761,11,12,3773,728,333,1158,77
23308,4565,7644,22117,1191,0,23308,1.96017e+18,96.088,9499.49,23308,3691,110,15664,15664,13302,12802,10829
20414,7238,10504,20414,0,0,20414,8.83311e+17,17.9423,10904.3,20414,9439,20,13181,13181,11329,9315,8305
26504,4212,6266,24961,1543,24961,1543,5.77873e+18,97.6044,8518.64,26504,3029,110,28560,28560,21014,23068,13145
24138,7,12,23437,701,24120,18,1.59337e+14,10.4731,459.394,24138,12,11,23384,22864,18357,17986,15850
27124,2,12,26352,772,27111,13,1.39036e+14,10.2901,465.28,27124,12,11,15706,11128,10749,11185,9231
37242,10922,11348,13552,23690,0,37242,8.96547e+12,58.6787,13768.5,37242,5511,72,27024,27024,27024,27024,27024
49443,11586,13364,0,49443,0,49443,6.17417e+17,97.3414,16911.2,49443,6491,110,49095,49095,49095,49095,49095
17331,1850,4121,16325,1006,0,17331,2.22692e+18,97.2935,5749.56,17331,1980,110,13210,13210,10194,9641,6721
46828,15439,24437,45111,1717,45111,1717,4.79219e+18,93.8177,26828.5,46828,11794,111,22391,22391,16458,17500,15291
17199,4011,6695,0,17199,0,17199,5.2312e+17,94.9803,8063.33,17199,3243,110,18986,18986,16638,15728,12302
10456,2566,5750,10089,367,10089,367,9.26385e+18,87.6524,6505.48,10456,2755,101,4706,4706,2947,3500,3001
3789,42,72,3748,41,3789,0,6.40527e+18,69.7213,513.41,3789,70,72,2928,873,1930,2036,2339
29227,355,7447,27557,1670,27557,1670,5.37269e+18,97.936,9787.21,29227,3528,111,30496,30478,22734,16663,3010
49629,3096,32150,43989,5640,0,49629,2.45366e+18,5.52764,36864.6,49629,10724,13,48439,48439,48439,48439,48439
22015,555,695,0,22015,21669,346,2.48004e+16,3.73518,2705.97,22015,350,4,29121,29121,17946,15504,3813
3976,1077,1567,3786,190,3786,190,7.93262e+18,92.5729,2040.24,3976,742,70,2409,2409,2309,2309,1488
29381,30,176,29369,12,29381,0,5.98661e+18,169.515,2031.53,29381,160,165,22583,18333,19296,19803,17480
14277,5994,7056,14277,0,13649,628,5.86504e+18,155.167,7834.72,14277,3018,122,7477,7477,7433,7469,7475
47086,153,176,47005,81,47086,0,6.01514e+18,173.452,2631.37,47086,173,174,46892,46889,46787,46784,46774
1608,120,804,1608,0,1608,0,1.889e+17,17.5236,906.363,1608,709,20,804,804,131,804,159
3981,141,177,0,3981,3867,114,3.54044e+16,19.8191,526.397,3981,41,26,3804,3804,3730,3735,3394
44764,8165,12108,42284,2480,0,44764,2.12162e+18,97.3117,15390.1,44764,5873,110,34942,34942,30478,28895,24406
7286,3799,4098,7036,250,7036,250,4.04595e+18,73.2871,4673.36,7286,1943,92,25306,25306,25306,25306,25306
49738,1793,2095,14512,35226,14512,35226,1.74641e+18,15.9936,2934.93,49738,2082,18,49680,49680,49680,49680,49680
24474,3432,6187,23072,1402,23072,1402,6.06393e+18,97.8768,8235.99,24474,2913,111,18287,18287,14984,16246,11445
33451,1,15,0,33451,30659,2792,3.00243e+16,9.99166,593.688,33451,15,10,85,85,85,85,85
47243,1178,17458,44961,2282,44961,2282,3.26779e+18,96.3689,20439.8,47243,8364,111,24401,24399,9005,10547,7462
2267,1,113,0,2267,2206,61,3.53454e+16,18.85,329.978,2267,33,26,332,332,332,332,332
3142,685,881,2962,180,0,3142,2.18613e+18,93.1645,1330.18,3142,401,70,2261,2261,2095,2058,2043
41968,4188,13186,15346,26622,0,41968,8.84284e+12,58.7714,15823.8,41968,6419,72,40675,40675,40675,40675,40675
36600,2177,14254,0,36600,0,36600,5.17022e+17,95.3446,16689.6,36600,6920,110,26842,26842,17134,13245,7726
13429,3234,4288,13429,0,12649,780,4.55351e+18,113.485,5225.97,13429,1618,118,9141,9119,8092,8477,7313
13506,361,647,3992,9514,3992,9514,1.81454e+18,15.9773,1075.87,13506,570,18,12859,12859,10052,10955,9282
15435,4326,5213,14655,780,0,15435,1.93828e+18,95.6769,6558.45,15435,2512,110,10222,10222,9915,9794,9653
31715,8355,13284,0,31715,0,31715,4.91956e+17,92.9516,15384.9,31715,6431,110,30858,30858,30858,30858,30858
27260,2070,9145,25880,1380,25880,1380,7.20808e+18,96.0825,11215.7,27260,4428,110,23273,23273,15185,21460,4607
15664,2571,8607,15124,540,15124,540,1.04594e+19,57.1904,9633.56,15664,4152,110,7057,7057,7057,7057,7057
5288,334,2772,2114,3174,0,5288,6.26327e+12,54.5668,3181.35,5288,1346,65,2516,2420,1798,2390,1109
4355,167,176,4351,4,4355,0,6.1584e+18,150.987,813.855,4355,90,88,4176,4142,4070,4058,4000
34297,2701,9036,32377,1920,0,34297,2.14349e+18,97.3101,11715.3,34297,4377,110,0,0,0,10174,9215
35159,5722,11812,33379,1780,33379,1780,7.39809e+18,96.1841,14329,35159,5737,110,23347,23347,22657,22657,15228
24245,7,14,23541,704,24194,51,1.60468e+14,10.6136,507.661,24245,13,11,23509,23072,18615,18439,15397
36846,12,14,35776,1070,36788,58,1.55244e+14,10.5415,618.316,36846,13,11,11660,6831,6108,9402,5410
16301,6732,7990,16301,0,15601,700,5.70484e+18,149.633,8920.03,16301,3389,126,8311,22860,22097,22590,20412
18754,1,12,18200,554,18739,15,1.74567e+14,10.0786,404.667,18754,11,11,13594,13594,13594,13594,13594
23355,5183,7700,23355,0,21997,1358,3.61665e+18,160.549,8895.52,23355,2809,124,15077,15077,13351,11896,10239
11901,2509,3674,4341,7560,0,11901,8.96733e+12,58.5593,4657.41,11901,1783,72,28429,28429,15393,25208,8605
36160,6,14,35128,1032,36081,79,1.3883e+14,10.7288,592.535,36160,13,12,34294,33350,24995,25042,23521
45187,7543,10580,42557,2630,0,45187,2.2277e+18,97.8838,14014.6,45187,5130,110,45066,45066,45066,45066,45066
16865,3136,7857,16167,698,16167,698,4.26468e+18,94.4982,9066.06,16865,3782,111,9008,9008,5157,5974,4559
44555,61,1212,0,44555,43284,1271,3.55234e+16,250.322,4211.64,44555,190,26,35494,28656,29849,29056,26804
49595,154,176,49500,95,49595,0,6.06169e+18,173.895,2742.46,49595,173,174,41672,41242,37459,34517,32369
38620,1979,14683,36800,1820,36800,1820,8.02965e+18,95.5101,17253.1,38620,7129,110,21492,21492,3309,15652,2098
37855,1061,13719,36015,1840,0,37855,1.85855e+18,95.8023,16301.8,37855,6664,110,36275,36275,35725,35551,32575
34551,548,34551,34551,0,34551,0,34358700000,0,34551,34551,34551,1,1028,0,1175,1819,2652
3754,311,1325,3754,0,3535,219,3.50824e+18,89.8362,1713.87,3754,467,81,2429,2429,1283,1812,860
11460,2134,2674,4021,7439,0,11460,9.92996e+12,59.7248,3708.58,11460,1297,72,8786,8786,7995,8646,7221
7105,145,176,7104,1,7105,0,6.01645e+18,159.812,1022.39,7105,110,114,6808,6406,5843,5841,5802
3816,782,1001,1350,2466,0,3816,9.60755e+12,58.3063,1444.98,3816,482,67,2815,2815,2513,2757,2321
5668,85,178,0,5668,5491,177,0.0312279,0.968596,1004.09,5668,178,1,5490,5490,5490,5490,5490
45086,330,1609,0,45086,43781,1305,4.0368e+16,296.183,5389.88,45086,268,26,25172,25167,7189,25172,6512
27916,6694,6744,9858,18058,0,27916,9.79548e+12,59.8882,8801.93,27916,3285,72,21172,21172,21112,21160,21114
44564,9444,10338,15653,28911,0,44564,9.90928e+12,60.0894,13377.1,44564,5035,72,30192,43729,0,0,9206
48824,10193,14872,46224,2600,46224,2600,5.48982e+18,97.3697,18177,48824,7095,111,35560,35560,31553,32952,30157
37034,12529,15880,35424,1610,35424,1610,2.82412e+18,94.7445,18216.5,37034,7712,110,35768,35768,35768,35768,35768
11901,115,508,0,11901,2480,9421,1.49981e+16,11.9835,860.39,11901,504,13,9026,6962,6735,7081,4859
12841,388,858,0,12841,12460,381,4.56554e+16,149.912,2274.04,12841,120,26,11983,11787,10078,10379,7472
3361,439,1820,0,3361,0,3361,4.19429e+17,89.7358,2159.7,3361,868,62,1541,1369,832,467,874
22904,777,813,0,22904,22252,652,3.55192e+16,121.76,2449.89,22904,110,26,22091,22091,21992,21981,21590
35998,8,14,34970,1028,35918,80,1.38861e+14,10.4103,544.383,35998,12,12,35153,34540,30355,29853,22554
19027,12,13,18483,544,18983,44,1.43571e+14,10.8955,429.586,19027,12,11,35358,35357,31658,31984,28316
43636,1,16,42366,1270,43545,91,1.63792e+14,10.4653,699.399,43636,14,13,27812,27812,27812,27466,27466
15085,97,4824,14295,790,14295,790,4.65428e+18,96.4703,6151.72,15085,2279,111,22411,7439,6570,4893,1391
22239,1623,10049,0,22239,0,22239,4.65488e+17,92.5868,11587,22239,4858,110,12190,12190,7536,2878,2650
1586,243,814,1518,68,1518,68,2.55259e+18,60.7579,1020.26,1586,358,60,772,772,0,576,0
31960,516,1627,0,31960,31013,947,4.69502e+16,295.453,5080.68,31960,274,26,24459,24459,18493,14123,2944
39647,8379,9269,37338,2309,37338,2309,5.88287e+18,97.835,12364.2,39647,4493,110,33694,33694,27712,28990,24395
39476,12,14,38352,1124,39396,80,1.39083e+14,10.6688,621.17,39476,13,12,13594,5066,5064,5017,4486
6224,896,3802,6034,190,0,6224,1.17027e+18,80.9275,4278.29,6224,1811,81,2422,2340,1645,1491,1356
2681,477,664,937,1744,0,2681,1.01343e+13,58.1044,1011.93,2681,323,59,2017,2017,1795,1967,1590
38929,3725,24868,37849,1080,37849,1080,3.07382e+18,87.1015,26552.3,38929,12021,111,14061,14061,8856,7155,3640
18454,78,953,0,18454,17916,538,4.23935e+16,181.893,2734.77,18454,137,26,17243,17158,11656,11097,2752
41140,1371,1544,0,41140,39944,1196,4.09296e+16,299.663,5090.46,41140,258,26,30912,30912,20193,8435,6883
22169,7652,8353,21109,1060,21109,1060,1.65821e+18,95.7569,9997.37,22169,4008,111,34381,34381,30999,29609,25474
27336,5413,6461,25746,1590,0,27336,2.2272e+18,97.6572,8769.59,27336,3125,110,20875,20875,19779,19338,18260
20026,6614,7109,19041,985,0,20026,1.88459e+18,94.7091,8711.75,20026,3426,110,12917,12917,12689,12574,12550
10515,2191,6494,10205,310,0,10515,1.13402e+18,48.4414,7177.5,10515,3123,93,4021,4021,4021,4021,4021
20000,593,757,0,20000,19431,569,3.55064e+16,82.0266,2201.58,20000,100,26,27593,27593,27593,27593,27593
30896,11297,11415,11602,19294,0,30896,8.13623e+12,57.8342,13339,30896,5550,72,17091,17046,16210,17052,14586
48523,2243,2737,46533,1990,14644,33879,1.68433e+18,16.9957,3588.5,48523,1453,27,37228,37228,18992,27124,9391
6610,297,2366,6280,330,0,6610,1.91156e+18,94.2085,3072.54,6610,1123,92,4244,4158,2664,2307,1225
47995,9,13,46627,1368,47976,19,1.38928e+14,10.2939,625.517,47995,12,12,42187,38996,34273,32637,13649
2850,47,807,2690,160,2690,160,6.04347e+18,92.7119,1227.64,2850,366,67,1175,256,765,1043,159
3747,968,1781,0,3747,0,3747,4.55615e+17,90.5226,2188.47,3747,834,64,1966,1880,1412,1054,1218
43134,20001,43134,43134,0,43134,0,34358900000,0,43134,43134,43134,1,42364,42364,42364,42364,42364
19524,3757,9533,18754,770,18754,770,5.55839e+18,93.0995,10839.7,19524,4584,111,16356,16356,12088,11907,4367
7893,2585,4230,7893,0,7893,0,2.94617e+18,17.8628,4465.78,7893,3794,20,3663,3663,2281,2173,2215
19842,6923,8691,0,19842,0,19842,4.76855e+17,94.2408,10129.2,19842,4204,110,14804,14804,14804,14804,14804
49375,4008,25864,0,49375,0,49375,4.03541e+17,92.0336,28397.3,49375,12574,110,39840,39840,32373,30367,23639
23613,1324,12366,22753,860,22753,860,2.3727e+18,91.7648,13811.5,23613,6000,110,11247,11247,6970,6585,1677
45138,1827,2342,0,45138,43783,1355,4.94528e+16,338.466,7517.15,45138,414,26,32646,32646,21129,15009,11126
38016,12833,15668,36314,1702,0,38016,1.71478e+18,94.9985,18101.4,38016,7610,110,34413,34413,34413,34413,34413
45039,9107,10507,15836,29203,0,45039,9.88032e+12,60.0752,13572.6,45039,5113,72,34500,34500,32872,32467,30560
13101,153,175,13097,4,13101,0,5.98853e+18,164.379,1356.8,13101,139,140,12771,12421,11433,11477,11567
34838,173,206,34818,20,34838,0,5.98344e+18,185.976,2297.61,34838,176,177,34615,34545,34002,33925,34018
17915,3400,4212,6290,11625,0,17915,9.87581e+12,59.8625,5670.74,17915,2047,72,13703,13703,12513,13493,11225
39256,3826,9171,0,39256,0,39256,6.4839e+17,97.854,12244.2,39256,4444,110,46903,46903,46903,46903,46903
10402,2378,2429,0,10402,3654,6748,2.54978e+15,59.6974,3390.31,10402,1176,72,7973,7973,7914,7908,7910
2371,12,13,2301,70,2339,32,1.89708e+14,10.7132,158.182,2371,12,11,2358,2357,2352,2352,2263
38137,4388,9198,35919,2218,35919,2218,5.54228e+18,98.2807,12115.3,38137,4354,111,28939,28939,19777,21627,15144
7505,722,1881,7075,430,0,7505,2.20597e+18,96.0153,2750.61,7505,885,100,5624,5624,3906,3573,2675
33160,2448,7778,31230,1930,31230,1930,3.35046e+18,97.7681,10467.9,33160,3761,110,18178,18178,2301,10138,1964
31986,7536,11467,31986,0,30226,1760,3.6403e+18,231.032,12924.9,31986,4443,128,28477,28319,21328,24420,17104
44302,13,15,43040,1262,44217,85,1.38927e+14,10.6846,665.934,44302,13,12,24924,21246,20736,20913,20620
15403,3651,4599,0,15403,0,15403,5.97388e+17,96.1318,6001.33,15403,2216,110,10804,10804,9984,8974,9454
15523,2788,3665,0,15523,5462,10061,2.52103e+15,59.787,4970.25,15523,1769,72,30355,30355,30355,30355,30355
32739,1352,8565,30901,1838,30901,1838,6.28445e+18,97.3248,11152.1,32739,4148,110,26340,26340,20939,24137,17180
39743,4268,12797,39743,0,37433,2310,4.76686e+18,281.23,14523.3,39743,4754,128,25456,25456,17334,12143,10222
3211,128,347,0,3211,3115,96,5.13896e+16,16.5447,797.384,3211,54,26,2864,2864,2503,2296,826
47988,980,2607,0,47988,0,47988,3.79085e+18,15.994,3426.38,47988,1985,18,31620,31428,20040,10040,8516
30875,869,9492,0,30875,0,30875,5.8645e+17,96.5773,11845,30875,4599,110,25573,25438,15363,9319,2918
46733,8,13,45399,1334,46713,20,1.40301e+14,10.2487,618.829,46733,12,12,11576,7425,6644,8205,6315
8768,454,2132,3088,5680,0,8768,9.783e+12,59.3914,2968.43,8768,1033,72,6636,6636,3222,5688,1561
4793,72,213,0,4793,4653,140,3.53899e+16,19.914,621.912,4793,44,26,4580,4580,3618,3645,2182
7255,2860,3195,6978,277,6895,360,3.65713e+18,90.6844,3724,7255,1251,109,4060,4060,3911,4025,4030
24646,1933,10487,0,24646,9499,15147,1.90532e+15,56.9301,11981.2,24646,5109,72,23782,23782,23782,23782,23782
29472,4770,8234,27842,1630,27842,1630,5.07325e+18,97.6213,10531.4,29472,3917,111,21528,21528,19381,20544,15921
48154,20683,23364,46267,1887,46267,1887,2.48529e+18,93.1028,26004.7,48154,11360,110,33087,33087,33087,33087,33087
25712,2,14,24969,743,25666,46,1.54761e+14,10.489,506.196,25712,12,11,15067,11156,9140,9718,6197
48448,12731,20296,46288,2160,46288,2160,5.38918e+18,95.6321,23149.3,48448,9763,111,38634,38634,38634,38634,38634
42088,4,16,40830,1258,41991,97,1.91765e+14,10.3205,728.072,42088,13,13,14957,13868,13372,13519,13311
26592,3055,6289,0,26592,0,26592,6.46031e+17,97.6147,8550.78,26592,3036,110,23035,0,0,0,0
9712,2,11,9437,275,9705,7,1.46215e+14,10.2409,280.877,9712,11,11,1235,206,201,290,129
8356,2787,3699,7994,362,7994,362,2.65308e+18,93.8962,4447.88,8356,1753,95,4657,4657,4439,4530,4074
48642,9,13,47257,1385,48621,21,1.38915e+14,10.2943,630.096,48642,12,12,8372,2616,1435,2130,2806
12199,1513,4622,11619,580,11619,580,7.946e+18,94.7942,5702.6,12199,2228,110,7577,7577,7107,7107,2227
21070,4108,5349,19861,1209,19861,1209,1.3579e+18,97.8261,7175.85,21070,2531,111,15721,15721,14499,15634,12640
7542,376,508,0,7542,7325,217,4.1532e+16,19.5644,1270,7542,69,26,7034,7034,6745,6809,5855
49993,7634,12062,47090,2903,47090,2903,3.59483e+18,98.3431,15669.4,49993,5712,111,39495,39495,37061,33331,32567
18879,108,175,18806,73,18879,0,5.98439e+18,165.908,1626.49,18879,155,151,24269,17366,14208,14928,15508
43635,1787,24181,43635,0,0,43635,8.93458e+17,17.983,24742,43635,21751,20,3310,3310,3084,3071,3071
36332,7376,8471,0,36332,12774,23558,2.52919e+15,60.028,11040.7,36332,4119,72,28281,28281,27319,27230,26824
47767,20329,21409,45764,2003,45764,2003,9.02371e+18,94.4865,24177.5,47767,10409,110,47319,47319,47319,47319,47319
47796,15,17,46380,1416,47721,75,1.80071e+14,10.3084,768.341,47796,14,12,47779,47779,47430,47430,43855
10701,10,11,0,10701,9809,892,3.00258e+16,9.98122,314.072,10701,11,10,10690,10690,10241,9792,10241
8672,1945,2920,8672,0,8162,510,3.11105e+18,92.1177,3567.84,8672,1037,114,5752,5752,4730,5129,4266
43735,1066,1197,0,43735,42489,1246,3.55172e+16,248.608,4141.89,43735,187,26,26970,26956,15040,7859,6486
35853,10840,10939,0,35853,0,35853,5.8782e+17,96.5288,13590.3,35853,5290,110,28996,28996,29422,0,0
40186,16280,40186,40186,0,40186,0,8.79587e+12,0,40186,40186,40186,1,5301,5301,0,5158,0
31067,1817,7615,29285,1782,0,31067,2.19873e+18,97.5477,10145,31067,3684,110,23452,23452,16013,14823,6974
38787,11,14,37663,1124,38762,25,1.59225e+14,10.2756,591.34,38787,12,12,7976,1868,1394,2714,29
26943,7595,8911,9931,17012,0,26943,8.63643e+12,58.4443,10722,26943,4336,72,18032,18032,16377,17742,14520
22285,1688,9133,8526,13759,0,22285,7.62167e+12,56.3564,10548.9,22285,4431,72,26070,26070,26070,26070,26070
6295,415,1486,0,6295,2208,4087,2.55555e+15,59.3863,2144.29,6295,722,72,4809,4809,3236,3272,1463
43631,518,21178,0,43631,0,43631,4.36255e+17,93.8982,23623.6,43631,10295,110,23697,23692,6277,11586,5681
34525,7,12,33542,983,34507,18,1.38875e+14,10.281,526.099,34525,12,11,8423,5472,5065,6009,4303
21464,10,15,20826,638,21410,54,1.85206e+14,10.6063,499.218,21464,13,11,21373,21256,18967,18678,17736
43120,34,61,43024,96,43120,0,2.32611e+18,60.8439,1543.14,43120,61,61,26392,14636,16686,23711,12158
22041,8,176,22031,10,22041,0,5.98998e+18,170.172,1784.18,22041,151,160,4628,614,780,650,879
33908,2751,13247,32335,1573,32335,1573,2.83994e+18,95.304,15537.3,33908,6431,110,20661,20661,14785,15019,6086
46885,3187,10879,0,46885,16467,30418,2.5341e+15,60.0899,14050.4,46885,5295,72,36006,36006,24809,15418,11122
24556,295,5790,8632,15924,0,24556,9.85638e+12,59.9161,7658.48,24556,2811,72,18766,18766,10854,17400,1222
9001,1664,2172,3170,5831,0,9001,9.87502e+12,59.4303,3025.66,9001,1052,72,6829,6829,6113,6705,5405
43376,16949,23564,17615,25761,0,43376,5.89321e+12,54.7497,25515.6,43376,11460,72,19812,19812,18045,19442,15240
21646,794,1179,0,21646,21004,642,4.57326e+16,252.624,3485.42,21646,179,26,20467,20467,19253,19282,16497
37778,3773,11386,0,37778,13725,24053,2.30481e+15,54.7172,13845.9,37778,5526,72,26392,26392,20180,17055,12667
42048,163,206,41970,78,42048,0,5.98148e+18,194.603,2513.87,42048,183,175,41114,39314,34528,34725,34913
30433,15935,30433,30427,6,30427,6,1.86042e+15,0,30433,30433,30427,3,0,0,0,0,0
12577,2950,4755,12577,0,11897,680,6.11162e+18,118.036,5540.65,12577,1807,119,7822,7787,6548,7283,4628
39561,7456,14712,39561,0,37441,2120,3.77211e+18,281.164,16386.8,39561,5740,131,24849,24683,18640,20784,13410
22763,10,14,22104,659,22713,50,1.56003e+14,10.7362,479.207,22763,13,11,22621,22382,19921,19909,20305
48485,18493,19109,46255,2230,0,48485,1.76299e+18,94.3803,22127.5,48485,9276,110,29376,29376,28579,28432,27891
734,5,11,711,23,734,0,1.37286e+14,9.46049,75.1998,734,11,11,676,612,567,566,446
15268,1216,5019,5622,9646,0,15268,8.70471e+12,58.3573,6180.3,15268,2444,72,10249,10249,6580,9612,2246
33175,250,1620,0,33175,32193,982,4.60387e+16,292.487,5092.21,33175,273,26,31139,30439,26399,20678,10487
14997,4756,5645,0,14997,0,14997,5.3192e+17,91.5534,6904.83,14997,2725,110,9352,9352,8435,7905,7229
27714,17542,25901,25897,1817,0,27714,1.01121e+18,3.99051,25982.3,27714,8651,9,1813,1813,1225,1225,1232
46946,7986,20496,0,46946,18186,28760,1.86164e+15,56.8426,22957.2,46946,9977,72,26450,26450,19610,12681,11467
32095,5762,10417,32095,0,30225,1870,4.36149e+18,216.56,11896.9,32095,3829,125,21678,21636,16661,19019,12750
14211,2202,3303,4990,9221,0,14211,9.96956e+12,59.8676,4521.55,14211,1609,72,10908,10908,9570,10621,7480
44161,16079,23254,0,44161,17817,26344,1.56552e+15,55.4079,25290.1,44161,11323,72,20907,20907,17877,16296,14432
36012,280,1135,0,36012,34979,1033,3.67492e+16,232.32,3756.17,36012,175,26,34767,34348,26214,25921,15164
38336,9156,10082,36188,2148,36188,2148,3.15391e+18,97.2189,13005.9,38336,4882,110,28254,28254,27853,28158,27569
24438,3103,5874,23015,1423,23015,1423,5.94257e+18,98.096,7947.72,24438,2777,111,18564,18564,14844,16274,10570
1384,120,416,1303,81,1303,81,5.66723e+18,86.8714,656.922,1384,179,48,968,482,747,697,408
20063,2902,7632,20063,0,19013,1050,5.18679e+18,147.004,8801.43,20063,3128,125,12431,12303,9057,10265,5528
38399,10,15,37283,1116,38314,85,1.63282e+14,10.463,637.927,38399,13,13,38257,38051,32087,32239,27889
45325,4,15,44019,1306,45270,55,1.49957e+14,10.4233,677.743,45325,12,12,39479,35177,34181,28958,21971
48742,6907,13560,0,48742,17525,31217,2.3818e+15,59.3543,16669,48742,6601,72,35182,35182,28720,29987,20945
36780,972,13693,35023,1757,35023,1757,7.7708e+18,95.1687,16190.6,36780,6641,110,23087,23005,17860,14323,3225
11485,8,11,11160,325,11483,2,1.39157e+14,10.0673,298.932,11485,11,11,11202,11050,8908,8975,9420
29885,1841,11623,28485,1400,28485,1400,1.70697e+18,93.8953,13673,29885,5564,111,18262,18262,17328,18003,2542
18469,14,15,17913,556,18414,55,1.9491e+14,10.4531,464.196,18469,13,11,18454,18454,18454,18454,18394
13282,151,176,13272,10,13282,0,6.01434e+18,165.62,1394.29,13282,136,137,12927,12562,11476,11449,11438
41034,302,15908,39114,1920,39114,1920,1.70531e+18,95.9227,18510.3,41034,7641,111,25126,24006,13651,14061,1326
6689,1330,1623,0,6689,0,6689,6.49004e+17,96.0698,2427.93,6689,767,96,5066,5066,4687,4559,4482
29107,699,1907,0,29107,0,29107,3.74633e+18,15.9887,2537.81,29107,1194,18,27200,27200,16916,15596,15238
24746,1,15,24020,726,24689,57,1.69003e+14,10.5037,524.97,24746,13,11,4928,4928,4928,4928,4928
21522,4253,9803,20629,893,20629,893,2.70955e+18,93.3574,11293.4,21522,4742,110,11719,11719,7449,8990,6240
11954,2,14,11606,348,11898,56,1.67251e+14,10.3856,342.428,11954,12,12,7124,5466,4122,5521,4167
33157,4012,13716,12704,20453,0,33157,7.56436e+12,57.1296,15637,33157,6670,72,19441,19393,15946,18838,11843
47334,5317,10976,16632,30702,0,47334,9.90359e+12,60.0942,14171.9,47334,5340,72,36358,36358,29422,34889,17975
28957,3502,8646,10514,18443,0,28957,9.07179e+12,58.9686,10631.7,28957,4212,72,20311,20311,13583,18653,7225
26312,10,14,25539,773,26232,80,1.73943e+14,10.4956,540.444,26312,14,12,26221,26084,25470,25341,22365
5598,146,2410,5348,250,5348,250,6.02902e+18,84.4759,2985.36,5598,1120,89,3188,3017,0,3117,0
11573,2000,3724,11573,0,10900,673,5.33357e+18,94.3039,4569.38,11573,1401,119,7849,7849,6460,7134,4613
22237,1224,6130,0,22237,0,22237,6.15683e+17,96.9149,8022.81,22237,2966,110,16107,16107,10845,5862,4677
36458,139,176,36399,59,36458,0,6.09624e+18,173.598,2364.22,36458,164,168,35325,33107,28518,28925,28842
23746,4257,5581,22366,1380,22366,1380,3.35008e+18,97.5805,7658.82,23746,2697,110,18165,18165,15539,16745,14454
45565,10211,14561,45565,0,42912,2653,4.87828e+18,318.865,16467.9,45565,5438,129,31004,31002,27617,29576,23117
37111,4035,8640,0,37111,13045,24066,2.53075e+15,60.0634,11258.2,37111,4201,72,28471,28471,21768,19803,13629
20713,3224,5300,7353,13360,0,20713,9.59419e+12,59.5645,6899.07,20713,2575,72,15413,15413,12871,14883,8727
32721,3034,9819,0,32721,0,32721,5.91924e+17,96.709,12303.1,32721,4758,110,22902,22902,14597,11278,8003
34271,706,17707,34271,0,21423,12848,4.9412e+18,1756.74,19979.6,34271,5764,138,14942,12264,5228,9115,1366
14035,2006,4628,13314,721,13314,721,7.21966e+18,95.7129,5890.49,14035,2232,110,9407,9407,9008,9008,4869
3448,1363,1416,0,3448,1305,2143,2.01742e+15,55.893,1766.75,3448,686,68,2032,2032,1980,1957,1983
22511,10648,11485,0,22511,9011,13500,1.62251e+15,54.0955,12716.9,22511,5589,72,11026,11026,10542,10159,10147
38939,10166,10551,36780,2159,0,38939,2.12086e+18,97.2474,13485.8,38939,5112,110,28388,28388,28019,27913,27972
10782,1550,2568,3797,6985,0,10782,9.92377e+12,59.6669,3549.84,10782,1250,72,8214,8214,6714,7954,5055
2258,841,943,0,2258,867,1391,1.98998e+15,44.7834,1200.73,2258,452,52,1315,1315,1213,1118,1167
16380,589,751,0,16380,15909,471,3.75553e+16,74.5433,2076.06,16380,98,26,15629,15562,15289,15252,13217
38078,1771,2020,0,38078,36943,1135,4.92584e+16,313.407,6392.49,38078,348,26,36058,36058,35735,35712,34160
43558,2368,24718,0,43558,17887,25671,1.42751e+15,53.7781,26595.4,43558,12021,72,18840,18840,8964,4983,2188
32538,129,350,0,32538,29865,2673,2.95447e+16,10.1145,986.636,32538,344,11,32188,32188,30353,25168,29743
43942,16929,17329,0,43942,16700,27242,1.99881e+15,56.3704,19807.1,43942,8435,72,26613,26613,26134,25556,25508
43134,918,1705,0,43134,41876,1258,4.23285e+16,306.942,5615.28,43134,285,26,41429,41429,39277,38412,29198
8892,1833,2172,8374,518,0,8892,2.22245e+18,96.6974,3159.35,8892,1039,109,6720,6720,6344,6268,6025
19852,6887,9248,19852,0,18971,881,5.30114e+18,209.955,10363.1,19852,4084,127,10604,10546,9363,10120,7504
