"data_size","cache_size","unique_size","reads","writes","data","ins","avg_step","avg_reuse_dist","sum_sqrt_count","sum_count","lis","lds","belady","lru","pivot","ld","mru"
12373,16,33,0,12373,11745,628,2.47629e+16,24.4302,358.92,12373,24,22,12303,12255,11229,11759,9909
4023,1,9,3868,155,4023,0,9.77438e+13,8.63361,145.014,4023,9,9,1522,1522,1522,1522,1522
14369,162,679,10876,3493,10876,3493,6.86204e+18,196.651,1697.79,14369,121,120,13542,13165,11357,9654,4425
3083,138,283,3083,0,3083,0,3.14796e+18,136.211,713.484,3083,87,67,2737,2421,2531,2337,2115
5247,35,371,5247,0,5247,0,3.21528e+18,211.848,1028.22,5247,122,79,3977,2869,2795,1939,837
4384,169,280,3787,597,3787,597,1.9123e+18,143.909,874.747,4384,106,95,4083,3803,3839,3841,3679
15971,331,552,0,15971,0,15971,1.90499e+18,248.78,2133.01,15971,208,145,15354,15099,14472,14426,10052
37709,756,1605,0,37709,0,37709,1.22981e+18,534.863,4657.42,37709,414,261,36104,35783,34353,33188,15620
14061,237,661,3607,10454,0,14061,3.05657e+13,135.355,1578.69,14061,88,118,13400,13280,12156,12129,6122
38020,4378,6396,0,38020,6180,31840,1.86115e+15,63.4489,7670.56,38020,807,84,31624,31624,29654,29994,25083
46794,188,387,0,46794,12228,34566,3.12299e+15,284.431,2766.88,46794,243,147,45491,42514,42439,42299,37202
12674,500,627,11204,1470,0,12674,4.24451e+18,221.899,1522.98,12674,86,163,12047,12031,11856,11857,10595
34932,3,14,34018,914,30838,4094,7.90713e+13,6.66607,358.024,34932,10,8,34413,34233,32072,32507,22195
12932,267,658,0,12932,2716,10216,4.7421e+15,296.689,1916.37,12932,225,137,12127,11780,11537,11174,7826
48406,221,2123,11493,36913,0,48406,3.05443e+13,255.668,4901.7,48406,398,312,45816,44837,38953,12580,7197
38768,5,12,38243,525,38768,0,9.75377e+13,10.6257,380.376,38768,12,12,38482,38276,36446,36428,31386
9968,226,501,2596,7372,0,9968,2.97607e+13,133.815,1243.54,9968,80,104,9467,9381,8795,8973,4638
39175,1284,1559,9835,29340,0,39175,2.97372e+13,198.471,3672.01,39175,354,153,37616,37616,37149,37293,33626
19415,890,1104,19415,0,18087,1328,9.96072e+17,564.334,3038.62,19415,293,189,18311,17679,17788,18009,17311
36166,1067,2328,30281,5885,30187,5979,2.66174e+18,375.456,5426.72,36166,536,247,33838,33814,31171,32826,15074
4200,157,409,3160,1040,3160,1040,3.833e+18,73.2557,865.025,4200,77,78,3791,3770,3703,3692,2039
30095,350,1044,7600,22495,0,30095,3.22373e+13,286.824,2658.59,30095,121,262,28981,28230,25391,27072,12742
29513,34,47,0,29513,29408,105,2.70134e+16,20.2814,583.175,29513,25,25,29466,29454,29426,29408,27184
16915,1,7,16877,38,16915,0,8.31531e+13,6.93355,253.908,16915,7,7,9715,9715,9715,9715,9715
4254,76,326,0,4254,0,4254,1.34851e+18,133.091,840.776,4254,95,73,3579,3078,3214,3334,1341
14230,341,957,13126,1104,13126,1104,2.44329e+18,298.975,2309.95,14230,360,124,13171,12695,12585,12514,6344
27777,1196,2336,27230,547,27015,762,8.3007e+17,362.017,4511.03,27777,347,137,25441,25438,25098,25068,15492
36989,109,783,27870,9119,27870,9119,7.00516e+18,351.389,2754.85,36989,213,169,34748,33971,24699,18440,8413
11013,544,650,2421,8592,0,11013,1.72522e+13,191.267,1705.38,11013,202,117,10363,10301,10342,10309,9224
26484,39,47,0,26484,26385,99,2.674e+16,20.086,553.455,26484,24,25,26437,26429,26415,26404,26126
2980,25,257,0,2980,583,2397,6.31216e+15,68.1624,679.243,2980,107,55,2497,2273,2028,1959,590
47720,1280,2082,47720,0,42905,4815,7.97313e+17,616.036,5871.08,47720,544,189,45638,45369,45147,43349,37956
47624,606,1405,44483,3141,44483,3141,2.05832e+18,581.48,4769.22,47624,363,242,45968,44283,44594,43822,32870
41851,1373,2772,38054,3797,38051,3800,1.37668e+18,385.352,6525.55,41851,639,213,39079,39013,38833,38962,23148
9771,16,50,0,9771,9703,68,2.66446e+16,25.4946,401.043,9771,26,25,9627,9475,9052,8729,5803
10845,200,699,10845,0,10117,728,1.10003e+18,233.948,1766.7,10845,192,136,10010,9749,8663,9133,6149
38114,875,1370,38114,0,35582,2532,9.74835e+17,700.758,4394.5,38114,412,224,36717,35306,33895,33115,28776
8878,631,708,8157,721,8157,721,2.47492e+18,207.318,1719.44,8878,215,89,8170,8170,8131,8135,7128
18928,193,1405,17259,1669,0,18928,3.26501e+18,220.977,3210.7,18928,366,95,17238,16949,15750,15270,4821
47767,9,13,47208,559,47767,0,9.9598e+13,10.9632,425.977,47767,12,12,47737,47719,45712,45712,39932
14261,4,7,14244,17,14261,0,8.16145e+13,6.93815,233.819,14261,7,7,13881,13623,11692,11707,10968
40753,706,1249,11191,29562,0,40753,6.28977e+13,236.01,3286.99,40753,275,138,39504,39501,39133,38919,38239
36809,961,1490,32814,3995,32812,3997,1.00174e+18,289.143,3844.62,36809,172,182,35319,35310,34984,35238,26050
3718,15,33,0,3718,3581,137,2.00979e+16,8.79909,209.56,3718,13,12,3685,3683,3638,3680,3387
39085,721,1299,36513,2572,0,39085,2.38702e+18,644.756,4282.2,39085,402,231,37629,36137,36321,35881,28801
3491,3,6,3422,69,3491,0,1.07559e+14,5.28846,106.571,3491,6,6,3429,3413,3423,3414,2736
15159,582,1096,14123,1036,14123,1036,6.97458e+17,381.369,2644.08,15159,256,162,14063,13547,13463,13458,11192
17486,2,10,17353,133,17486,0,9.88367e+13,9.21291,258.193,17486,10,10,15226,14788,13014,14262,11494
37203,1766,1989,37203,0,33598,3605,1.19665e+18,333.633,4975.78,37203,610,142,35214,35214,35214,35214,32068
46600,662,1861,46600,0,41841,4759,1.57268e+18,285.707,4959.19,46600,448,187,44739,44616,38904,42376,12087
37993,788,865,0,37993,0,37993,1.87548e+18,342.296,3773.18,37993,307,199,37128,37128,37047,37101,35366
20317,518,1119,20317,0,19024,1293,8.9894e+17,556.622,3077.93,20317,283,193,18957,18087,16858,16743,12407
2609,184,460,2609,0,2458,151,1.05043e+18,81.6577,839.569,2609,68,97,2149,2140,1816,1878,710
42147,455,1291,39386,2761,39386,2761,2.01187e+18,681.003,4439.58,42147,403,222,39809,38385,37639,37577,25255
11930,38,63,0,11930,11848,82,2.56098e+16,29.7083,474.511,11930,32,31,11863,11842,11683,11693,10955
19641,1155,1363,17544,2097,17542,2099,1.23362e+18,189.874,3042.08,19641,370,136,18278,18278,18188,18261,15414
3191,91,300,2407,784,2407,784,6.98837e+18,61.4224,658.409,3191,65,68,2891,2845,2666,2507,1614
17623,548,552,4587,13036,0,17623,2.92029e+13,189.648,1612.12,17623,98,125,17071,17071,17070,17070,17061
40570,359,1299,9906,30664,0,40570,3.80348e+13,245.142,4316.13,40570,284,181,39171,38679,35009,23234,18494
21746,822,832,4842,16904,0,21746,2.16746e+13,224.221,2605.09,21746,357,124,20914,20914,20914,20914,20861
11155,409,527,2884,8271,0,11155,2.98488e+13,129.634,1336.32,11155,82,112,10628,10618,10431,10493,9053
46767,1399,1926,43625,3142,0,46767,2.46174e+18,620.684,5800.72,46767,414,285,44841,44798,43837,43656,32035
27075,156,1624,22366,4709,0,27075,5.90832e+18,205.07,4235.33,27075,255,167,25118,24324,19151,19670,4831
47445,866,1384,44241,3204,44241,3204,2.07292e+18,689.04,4796.43,47445,438,254,46061,45322,44472,44099,37346
28350,28,48,0,28350,28233,117,2.62763e+16,23.0049,587.19,28350,24,23,28302,28283,27905,28049,24036
12098,83,384,12098,0,12098,0,3.29842e+18,190.73,1345.44,12098,122,103,11381,10972,7997,7608,3220
8607,503,522,8607,0,6490,2117,8.06883e+17,198.13,1316.96,8607,124,109,8085,8085,8068,8020,8038
1078,15,161,943,135,943,135,3.22024e+18,80.6818,352.215,1078,66,46,672,512,512,413,263
37661,503,1079,33170,4491,33170,4491,1.70736e+18,412.312,4182.87,37661,312,200,36582,35500,34201,34193,19546
38921,1017,2168,35691,3230,35687,3234,1.4314e+18,471.101,5782.64,38921,804,161,36753,36620,36203,36131,18522
18432,375,584,0,18432,0,18432,8.05865e+17,301.198,2212.13,18432,207,140,17842,17466,17054,17162,16528
30297,991,1371,28339,1958,28339,1958,6.55945e+17,484.113,3955.11,30297,279,221,28926,28856,28524,28731,23174
21496,285,365,0,21496,5575,15921,3.15188e+15,212.5,1842.77,21496,196,114,21131,20991,20828,20891,20765
2462,17,288,1870,592,1870,592,6.78276e+18,52.0792,580.545,2462,60,74,1429,942,855,918,343
23475,88,1373,21219,2256,21219,2256,1.34801e+18,332.548,3647.88,23475,432,143,19265,18074,13955,16347,1619
7682,11,13,7629,53,7682,0,1.01312e+14,7.54803,172.411,7682,9,9,7669,7666,7412,7411,7624
1435,79,265,1280,155,1280,155,1.82895e+18,75.5038,448.159,1435,120,37,1121,1021,789,933,375
42885,844,1663,38563,4322,38563,4322,2.64404e+18,539.562,4989.05,42885,549,202,41222,40700,37871,36069,28498
4541,197,235,4541,0,4541,0,5.79338e+18,107.18,726.131,4541,88,69,4306,4300,4275,4241,4108
40310,120,523,40310,0,40310,0,3.16872e+18,306.883,2588.81,40310,188,146,38611,37610,29338,28156,11313
16888,352,707,15132,1756,0,16888,3.80384e+18,242.024,1936.83,16888,142,140,16181,16065,15394,15410,11141
38082,757,1213,0,38082,0,38082,1.4537e+18,484.794,4393.16,38082,410,186,36869,36524,35221,35058,23978
23260,263,711,17500,5760,0,23260,8.35026e+18,305.938,2197.48,23260,174,142,22298,21478,20076,20013,9077
23013,1161,1196,0,23013,0,23013,1.17112e+18,464.768,3247.32,23013,364,187,21817,21815,21817,21811,21712
35782,108,1394,0,35782,9112,26670,7.58556e+15,206.352,3424.02,35782,225,156,33563,31886,28964,28930,8045
31134,206,1286,31134,0,29067,2067,9.56449e+17,607.569,3868.4,31134,369,207,28359,27434,23622,23667,12247
39451,545,1414,9286,30165,0,39451,2.37871e+13,314.744,4262.53,39451,340,171,38026,37472,36183,19628,19035
38771,20,63,0,38771,38534,237,2.59342e+16,34.9569,744.297,38771,36,35,38591,38463,36953,37750,29667
20295,210,728,5060,15235,0,20295,3.26944e+13,256.872,1827.45,20295,91,199,19347,18887,16815,17407,9004
29844,33,40,0,29844,29549,295,1.96635e+16,23.9362,638.401,29844,28,27,29804,29794,29686,29755,28536
7439,445,848,6952,487,0,7439,2.33627e+18,179.085,1748.36,7439,167,124,6591,6432,6398,6409,4864
10367,430,431,10367,0,10367,0,4.04291e+18,226.569,1319.02,10367,157,85,9936,9913,9936,9936,9935
48728,39,98,0,48728,48412,316,2.46719e+16,50.1635,1207.96,48728,51,43,48549,48442,46711,45037,32226
25584,435,587,22468,3116,25584,0,3.56428e+18,331.441,2533.81,25584,263,143,24997,24754,23589,23313,21405
36122,8,463,36122,0,36122,0,5.25698e+18,295.803,2534.22,36122,204,166,20477,13986,11427,8836,4002
36643,4,13,36367,276,36643,0,9.59427e+13,11.8282,374.171,36643,13,12,36163,35974,33318,33980,28105
48134,16,1449,44898,3236,44898,3236,6.56072e+17,761.181,4971.76,48134,450,263,29150,23018,17586,19167,4548
44285,218,1437,41406,2879,41406,2879,6.48102e+17,699.598,4745.89,44285,394,246,40289,38959,36561,36553,17142
32685,576,1277,0,32685,7016,25669,4.83704e+15,371.687,3844.38,32685,343,185,31405,30830,30387,30352,22376
43669,432,500,43221,448,43669,0,3.83677e+18,299.555,3006.47,43669,263,210,43169,43156,42815,42728,40302
43061,294,1163,0,43061,9165,33896,4.68394e+15,493.137,4045.47,43061,389,220,41296,40298,38885,34058,11296
31374,209,1625,28521,2853,28520,2854,1.05688e+18,413.01,4531.88,31374,371,195,28905,28173,25492,25810,11869
21023,322,839,18819,2204,18819,2204,3.2638e+18,251.154,2319.21,21023,130,148,20184,19989,18398,17494,9974
24113,276,1248,0,24113,5895,18218,7.1866e+15,156.547,2850.63,24113,446,118,22865,22559,20037,20866,9316
41393,317,727,41329,64,41393,0,3.54212e+18,386.057,3461.11,41393,260,157,40343,39300,35770,34123,25921
42868,750,2521,36905,5963,36811,6057,2.25177e+18,488.171,6275.7,42868,513,277,40326,39465,33003,36687,9522
18989,474,1055,17663,1326,0,18989,2.50861e+18,459.756,2851.84,18989,270,177,17707,17112,16930,16727,12426
15674,403,1014,0,15674,0,15674,1.38477e+18,315.207,2488.9,15674,362,124,14615,14199,14037,13770,7418
26993,69,616,24040,2953,26993,0,3.75413e+18,301.118,2706.14,26993,245,160,23916,22046,16500,13283,5725
20246,444,1076,0,20246,3711,16535,4.46046e+15,158.788,2811.68,20246,317,95,19170,19054,18675,18299,10802
13343,973,1007,0,13343,94,13249,1.31471e+14,15.0213,1950.45,13343,299,17,12336,12336,12300,12101,12013
39004,1,11,37177,1827,39004,0,9.60316e+13,10.7264,442.061,39004,11,11,15224,15224,15224,15224,15224
42038,1515,1605,37560,4478,37560,4478,2.71458e+18,381.536,5153.09,42038,444,203,40433,40433,40422,40418,38543
28502,460,763,25088,3414,0,28502,3.85985e+18,339.958,3150.42,28502,275,183,27739,27624,26812,26922,17358
3103,58,286,3103,0,3103,0,3.24066e+18,74.5769,652.808,3103,69,70,2770,2591,1893,1854,853
14362,613,1077,13391,971,13391,971,2.12727e+18,257.541,2507.92,14362,303,116,13285,13164,13010,12874,8291
34007,487,772,25620,8387,25620,8387,7.03198e+18,352.008,2680.83,34007,213,165,33235,33083,32585,32247,25896
41936,552,2599,37886,4050,37885,4051,1.17257e+18,371.97,6307.09,41936,492,270,39114,38435,36618,37334,15445
6826,343,655,6324,502,0,6826,2.6945e+18,153.207,1414.93,6826,160,116,6171,6050,5900,5882,3428
47107,91,755,13131,33976,0,47107,6.30344e+13,263.881,2729.76,47107,190,154,45154,44195,37613,19779,12944
34069,2,10,33827,242,34069,0,9.99692e+13,9.46456,360.466,34069,10,10,29610,28727,25290,27729,22130
45690,1076,2165,36728,8962,0,45690,6.64313e+18,366.548,5550.94,45690,403,240,43525,43497,42595,42854,27736
3605,275,347,3570,35,0,3605,6.93244e+18,32.2333,684.535,3605,137,36,3258,3258,3248,3258,2564
10090,67,537,8935,1155,8935,1155,3.13818e+18,283.39,1707.89,10090,190,120,8227,7044,6765,6162,2319
5633,3,8,5621,12,5633,0,1.18776e+14,6.1777,139.42,5633,8,7,5362,5217,4844,5209,3660
11272,313,550,2940,8332,0,11272,2.9464e+13,125.421,1359.16,11272,85,109,10722,10694,10302,10450,7450
12366,309,559,10897,1469,0,12366,3.84416e+18,261.833,1910.85,12366,203,132,11725,11440,10853,10912,6624
39319,124,1305,36769,2550,36769,2550,1.99584e+18,692.674,4314.93,39319,412,233,34742,31639,29301,30511,5536
21443,110,119,0,21443,20475,968,2.44708e+16,25.0928,660.216,21443,43,34,21324,21324,21320,21324,21294
9601,271,991,0,9601,0,9601,1.74659e+18,194.546,2082.78,9601,262,87,8548,8275,7959,6504,4215
37400,54,1960,33280,4120,33280,4120,3.08817e+18,294.541,5050.98,37400,405,219,30009,26661,25605,23639,3790
16885,24,1435,14642,2243,14573,2312,2.31801e+18,448.706,3080.37,16885,323,205,11896,8533,8037,8620,747
18250,803,1322,0,18250,4589,13661,1.08363e+16,291.542,2975.66,18250,287,143,16928,16906,16246,16600,7302
10467,628,1014,9558,909,0,10467,3.22643e+18,182.222,2214.58,10467,278,87,9453,9421,9190,8992,7256
1158,47,174,0,1158,185,973,3.4857e+15,30.9128,341.025,1158,81,29,969,926,903,733,389
36530,203,1821,32175,4355,32175,4355,1.78301e+18,357.637,4984.91,36530,346,247,33271,31857,28368,30184,10208
41804,1344,1391,41804,0,39076,2728,9.7002e+17,720.293,4556.77,41804,417,235,40413,40413,40383,40367,40315
6703,14,20,0,6703,6683,20,3.07989e+16,17.2209,240.978,6703,17,15,6665,6633,6526,6588,4920
48758,533,2261,0,48758,0,48758,1.8976e+18,500.465,6138.13,48758,651,271,45860,44258,38677,33862,5957
49855,1691,1739,44335,5520,44335,5520,2.80897e+18,378.959,5780.45,49855,464,206,48116,48116,48115,48115,47716
48546,131,1565,45310,3236,45310,3236,2.07136e+18,639.335,5047.21,48546,400,237,43305,40111,36636,37545,13540
24362,90,349,24362,0,24362,0,3.85219e+18,232.423,1875.4,24362,137,142,22434,20971,15156,13271,8519
42751,374,1277,10085,32666,0,42751,3.09123e+13,293.264,4407.7,42751,306,194,41327,40621,37890,29299,22475
21403,441,790,16125,5278,16125,5278,7.02287e+18,253.459,2175.39,21403,170,145,20613,20461,20003,19486,15036
36652,1165,1414,9224,27428,0,36652,2.90198e+13,189.894,3460.71,36652,347,142,35238,35238,34525,34782,30200
28784,844,940,0,28784,6191,22593,4.65391e+15,324.223,3076.72,28784,274,183,27844,27838,27802,27802,26562
14386,181,446,14386,0,14386,0,3.50315e+18,232.296,1843.07,14386,159,130,13708,13360,11920,10140,8449
34379,1480,1926,7557,26822,0,34379,2.9965e+13,187.787,4309.33,34379,457,230,32453,32453,30952,31594,24229
46729,571,1408,43622,3107,43622,3107,6.92345e+17,745.649,4856.25,46729,390,260,44335,41986,42192,42383,31169
15504,1080,1190,14005,1499,0,15504,3.53925e+18,197.022,2684.56,15504,210,135,14314,14307,14314,14314,13684
23783,683,721,20951,2832,20951,2832,3.21242e+18,327.553,2849.39,23783,264,160,23062,23062,23040,23034,22588
8234,546,1079,7579,655,0,8234,3.01614e+18,92.3881,1910.25,8234,288,157,7155,7155,7155,7154,3042
21577,535,1083,4709,16868,0,21577,2.1702e+13,136.741,2927.46,21577,346,86,20494,20417,20034,19163,10566
6364,199,466,6364,0,5987,377,1.03219e+18,156.47,1163.79,6364,153,79,5898,5671,5160,5558,3383
1686,100,230,0,1686,0,1686,1.05028e+18,76.2954,472.804,1686,72,47,1438,1298,1307,1331,817
32890,771,1224,0,32890,0,32890,1.20869e+18,658.592,3880.72,32890,365,216,31555,30337,30541,27900,25103
44695,1,18,43067,1628,44695,0,9.53034e+13,10.6427,479.706,44695,16,12,19728,19728,19728,19728,19728
48503,67,79,0,48503,48185,318,2.25207e+16,31.4475,1049.94,48503,34,38,48424,48415,48414,48328,43575
21602,28,45,0,21602,21581,21,2.08248e+16,24.4288,501.609,21602,31,26,21554,21523,19786,20299,20548
26092,348,920,23361,2731,0,26092,3.82905e+18,266.143,2611.01,26092,155,159,25172,24948,22968,23120,13885
48442,479,647,44796,3646,48442,0,3.75213e+18,328.23,3557.39,48442,284,192,47795,47659,46682,46110,42716
23638,641,1479,0,23638,0,23638,1.5172e+18,368.782,3788.35,23638,462,133,22159,21838,21259,17261,12259
17607,488,612,0,17607,0,17607,4.13849e+18,272.559,1831.34,17607,160,121,16995,16938,16881,16837,15159
31779,156,387,31779,0,31779,0,3.59895e+18,309.588,1858.25,31779,273,53,30699,29776,26392,23137,15403
33321,533,954,7430,25891,0,33321,2.27067e+13,301.063,3301.79,33321,391,133,32367,32191,31857,31772,26880
35335,100,2100,30059,5276,30059,5276,4.37566e+18,439.665,4988.6,35335,522,215,31280,28664,26064,21985,4796
31289,1576,1998,25806,5483,0,31289,5.95266e+18,359.515,4711.49,31289,360,214,29291,29291,29253,29291,24339
16128,283,778,14423,1705,14423,1705,8.97335e+17,244.215,2054.24,16128,141,144,15325,15063,14616,14515,7884
36128,361,1367,7292,28836,0,36128,2.3234e+13,333.89,4079.14,36128,573,111,34411,33879,32527,19253,14696
7955,86,475,7043,912,7043,912,3.06724e+18,249.858,1453.63,7955,173,99,6694,5696,5541,4907,1915
3349,2,12,3321,28,3349,0,8.51403e+13,5.44252,113.696,3349,9,7,3025,2919,2455,2928,2221
23645,202,484,23645,0,23645,0,4.69337e+18,298.856,2191.59,23645,186,117,22674,22018,17676,17944,13649
22831,2,8,22503,328,22831,0,1.00996e+14,7.64969,278.112,22831,8,8,20758,20264,18391,19963,14024
16846,481,1111,15695,1151,15695,1151,6.81223e+17,466.102,2797.06,16846,248,182,15551,15144,14795,14794,7068
12886,364,1160,12886,0,9475,3411,3.83483e+18,22.9434,1642.67,12886,396,388,11726,11726,8818,7522,10675
8477,74,510,0,8477,1790,6687,6.3752e+15,134.682,1380.24,8477,213,69,7595,7192,6917,6752,1028
28075,1692,1868,25621,2454,25620,2455,1.50249e+18,364.422,4435.93,28075,622,120,26207,26207,26202,26203,25871
36801,22,643,34057,2744,36801,0,3.99108e+18,312.112,3164.31,36801,270,177,28591,22244,17682,15041,3783
33551,657,1208,0,33551,0,33551,1.2118e+18,623.965,3904.68,33551,352,211,32010,30854,30986,28614,21655
32573,61,1308,0,32573,7137,25436,4.89451e+15,321.38,3879.94,32573,340,188,28906,26018,25571,21201,7071
45101,84,106,0,45101,44054,1047,2.0516e+16,49.8046,1124.83,45101,43,46,44995,44981,44272,44636,41154
24615,4,8,24443,172,24615,0,1.07433e+14,7.54061,289.843,24615,8,8,24526,24498,23200,23137,17851
17353,274,1082,17353,0,16210,1143,9.67577e+17,456.669,2829.64,17353,291,180,15699,15207,13300,12495,8112
12538,39,603,3133,9405,0,12538,3.27184e+13,176.223,1407.15,12538,85,160,11447,10948,9803,10270,2141
49582,316,599,49582,0,49582,0,3.71223e+18,340.286,3302.47,49582,277,181,48912,48584,43345,42621,36874
46867,1447,1794,0,46867,11547,35320,6.89853e+15,253.732,4707.52,46867,465,180,45073,45073,43710,43829,37364
44705,40,1428,39414,5291,39414,5291,3.24392e+18,342.345,4768.49,44705,306,190,34546,30541,27871,26228,4031
9968,288,305,9968,0,9968,0,3.39716e+18,186.219,1104.3,9968,89,124,9663,9619,9654,9647,9388
43052,905,2079,37978,5074,37978,5074,3.6536e+18,346.887,4520.32,43052,371,289,40973,40905,35812,33168,15370
49342,1954,5671,43114,6228,0,49342,7.3851e+18,14.5305,7772.22,49342,1436,26,43671,43671,30367,31558,12790
35594,367,1296,33166,2428,33166,2428,6.39101e+17,606.885,4096.56,35594,341,221,33287,32293,31116,31158,20518
11616,66,269,0,11616,3039,8577,2.86693e+15,187.92,1267.21,11616,162,87,10283,9457,9797,9967,5886
34681,1268,1319,32308,2373,32308,2373,6.94855e+17,676.408,4184.26,34681,333,231,33362,33362,33330,33349,33237
3859,124,245,0,3859,1069,2790,1.62177e+16,42.916,579.749,3859,52,53,3614,3602,3501,3528,1957
12472,170,1123,9169,3303,0,12472,6.45888e+18,21.937,1579.97,12472,383,377,11349,11349,4714,3819,10090
14693,173,578,13171,1522,13171,1522,3.22492e+18,231.011,1690.51,14693,114,128,13768,12612,12192,11117,5341
13053,335,674,11531,1522,11531,1522,9.1485e+17,227.092,1623.14,13053,98,163,12355,12069,12004,11784,8394
5842,2,7,5825,17,5842,0,8.34502e+13,6.95943,150.458,5842,7,7,4833,4496,4530,4609,3837
39101,12,32,38340,761,39095,6,1.01415e+14,8.8819,467.224,39101,18,18,39061,39046,37836,37788,29763
23205,312,1059,0,23205,4847,18358,5.50916e+15,184.207,3025.05,23205,355,90,22053,21809,21219,13834,10596
35769,788,2166,33074,2695,33074,2695,2.36988e+18,370.07,5140.58,35769,733,144,33603,33116,32449,31287,18397
14658,846,1152,13426,1232,0,14658,3.1255e+18,204.778,2741.75,14658,332,89,13506,13506,13368,13333,9381
26126,561,604,26126,0,25041,1085,4.68592e+17,380.806,2702.27,26126,240,159,25522,25422,25409,24185,25359
24248,1367,1723,22716,1532,22716,1532,2.00388e+18,260.367,3817.16,24248,490,122,22525,22525,22204,22301,19062
13721,873,1009,0,13721,0,13721,1.22879e+18,217.875,2335.92,13721,224,143,12712,12696,12669,12681,11262
9153,286,349,2027,7126,0,9153,2.84972e+13,170.311,1271.9,9153,154,86,8804,8706,8738,8793,7448
9775,119,620,8752,1023,0,9775,3.82856e+18,172.5,1480.18,9775,93,117,8810,8229,7980,8165,2594
9300,153,307,9300,0,9300,0,5.06343e+18,166.643,1126.81,9300,140,69,8900,8555,6694,6214,4406
35606,2224,2412,32628,2978,32628,2978,2.51296e+18,408.068,5743.7,35606,561,214,33194,33194,33194,33194,30736
21330,57,62,0,21330,21197,133,2.67353e+16,44.764,645.78,21330,33,35,21263,21237,21126,21057,20738
18665,1,9,18616,49,10711,7954,6.36695e+13,8.30565,305.365,18665,9,9,9516,9516,9516,9516,9516
7906,30,33,0,7906,7893,13,2.10814e+16,25.8781,302.807,7906,26,29,7872,7854,7609,7604,7499
16006,69,1432,14340,1666,14340,1666,9.52578e+17,185.923,2958.76,16006,234,176,13527,12870,10629,11095,2475
11475,13,59,0,11475,11401,74,2.4509e+16,40.7641,484.03,11475,31,28,11219,11044,10390,10260,6872
9475,204,664,8847,628,8847,628,2.06312e+18,207.136,1606.42,9475,157,116,8720,8534,8036,7940,5764
46856,288,924,10493,36363,0,46856,1.82981e+13,466.257,3722.96,46856,351,209,45015,43941,42879,38472,23973
29002,1756,1886,23390,5612,0,29002,8.12159e+18,14.8904,3655.1,29002,945,15,27116,27116,26986,26899,25692
40957,976,1889,38168,2789,38168,2789,6.66732e+17,512.839,5434.91,40957,363,282,39068,38652,37968,37489,24108
40925,1385,1746,0,40925,8847,32078,6.34221e+15,282.895,4824.11,40925,565,148,39179,39179,38323,38427,33820
16919,314,612,12746,4173,12746,4173,3.80701e+18,283.719,1864.14,16919,153,139,16202,15669,15832,15775,9695
17588,66,190,0,17588,17152,436,2.62699e+16,22.8622,871.585,17588,73,33,17398,17366,16608,16314,9016
16220,407,663,0,16220,3633,12587,6.0263e+15,175.373,2022.78,16220,288,95,15557,15556,14587,14767,8368
14903,400,709,11233,3670,11231,3672,3.79362e+18,262.224,2020.54,14903,153,156,14194,13707,13849,13822,7953
16271,1,13,16146,125,16271,0,9.80519e+13,10.8259,252.356,16271,11,10,9102,9102,9102,9102,9102
22557,739,1133,20141,2416,0,22557,3.16694e+18,309.202,3281.39,22557,354,159,21424,21424,21299,21293,18725
46479,861,937,10415,36064,0,46479,1.81075e+13,500.981,3782.27,46479,407,203,45542,45535,45445,45392,44655
20181,364,540,5624,14557,0,20181,6.28772e+13,176.094,1661.39,20181,119,112,19641,19615,19411,19468,16911
37948,766,1364,35428,2520,35428,2520,6.60452e+17,695.693,4348.61,37948,353,233,36433,34921,35243,35290,25977
30598,37,1300,30598,0,28639,1959,9.35765e+17,633.391,3869.46,30598,389,210,22181,17069,13999,12197,6000
17544,470,484,17544,0,17544,0,3.4746e+18,274.342,2079.92,17544,166,142,17060,17057,17059,17059,16968
18549,155,484,18549,0,18549,0,3.53779e+18,268.63,2134.99,18549,167,151,17516,16860,14414,11798,8406
12740,275,540,11190,1550,11190,1550,3.28053e+18,265.15,1902.33,12740,202,139,12090,11765,11032,10757,8360
16424,5,27,0,16424,16361,63,2.91846e+16,18.254,409.17,16424,20,19,16169,16009,12635,14686,9839
36973,686,2285,36973,0,33138,3835,1.43538e+18,352.572,5510.78,36973,400,210,34688,34591,32072,30739,19424
28345,83,1675,6175,22170,0,28345,2.50637e+13,164.714,3935.12,28345,389,169,25932,24607,22963,18409,4631
16001,839,1240,0,16001,0,16001,1.33889e+17,79.2517,2448.59,16001,422,58,14761,14761,14320,12913,10680
24122,1297,2153,24122,0,17736,6386,3.83743e+18,22.9717,2821.86,24122,727,718,21969,21969,18929,17789,20839
49456,189,1026,43560,5896,0,49456,3.84274e+18,359.381,4516.31,49456,334,212,46703,45068,37687,37939,11709
39399,762,878,34664,4735,0,39399,3.85964e+18,334.764,3867.67,39399,313,189,38521,38521,38388,38376,35790
27041,740,1117,25204,1837,25204,1837,2.09318e+18,560.785,3439.74,27041,329,211,25874,24925,25153,24878,20900
8211,242,508,8211,0,6154,2057,8.89892e+17,150.494,1240.62,8211,124,112,7703,7548,7275,6656,4979
22712,1081,1122,21245,1467,21245,1467,5.81845e+17,510.146,3144.3,22712,294,177,21590,21590,21590,21582,21383
9377,40,529,9377,0,7051,2326,8.20966e+17,203.841,1361.2,9377,125,112,7491,3781,5463,5883,1067
27505,510,711,24228,3277,0,27505,3.84077e+18,336.371,3048.68,27505,268,184,26794,26785,26249,26361,19700
1237,40,94,998,239,0,1237,8.09931e+18,14.5974,229.12,1237,49,15,1143,1143,959,880,592
8301,16,399,8301,0,8301,0,5.24961e+18,159.832,1242.64,8301,145,86,5685,4400,3296,2410,1065
30801,459,1109,28754,2047,0,30801,2.40981e+18,619.256,3631.89,30801,327,206,29057,28061,27561,27504,13788
38998,451,892,8590,30408,0,38998,1.84127e+13,458.344,3419.47,38998,315,197,37852,36914,36403,34811,25535
33163,872,895,0,33163,7134,26029,4.80646e+15,455.057,3252.61,33163,344,188,32268,32268,32253,32264,32131
10008,143,407,10008,0,10008,0,3.0407e+18,206.134,1441.1,10008,116,100,9308,8440,7977,7035,4828
32858,52,61,0,32858,32662,196,2.63423e+16,33.329,679.325,32858,35,32,32797,32795,32792,32780,31715
26064,177,1194,0,26064,0,26064,1.19542e+18,584.002,3489.49,26064,383,198,23358,22357,20419,18901,9630
30253,1106,1208,27250,3003,27250,3003,2.48718e+18,376.987,3898.03,30253,405,177,29045,29018,29013,28989,26698
34309,3,44,0,34309,34059,250,2.54656e+16,38.1861,633.906,34309,32,32,31459,30110,26104,26674,17499
22923,5,13,22854,69,22923,0,8.84838e+13,5.90795,302.436,22923,7,10,22708,22483,20739,20748,18200
47599,223,516,47599,0,47599,0,3.39594e+18,459.414,2758.28,47599,516,49,44752,41323,41449,42097,21700
26279,35,45,0,26279,26095,184,2.56324e+16,35.522,554.184,26279,29,31,26214,26138,26025,26128,24003
30707,1124,2059,27747,2960,27747,2960,2.86355e+18,234.672,4729.44,30707,381,234,28648,28648,28479,28473,18463
16697,971,1525,15155,1542,0,16697,3.096e+18,185.566,3298.03,16697,358,172,15172,15172,15128,15172,10438
36958,187,2041,0,36958,0,36958,1.79128e+18,252.034,4840.98,36958,392,187,34312,31419,29830,18597,8447
5394,24,31,0,5394,5378,16,1.70192e+16,11.6296,242.533,5394,16,18,5363,5363,5301,5348,4837
46239,26,49,0,46239,46068,171,2.61651e+16,33.2051,752.042,46239,28,28,46169,46131,45455,45773,37036
6491,303,376,6491,0,6491,0,3.41847e+18,96.9586,954.479,6491,146,63,6115,6115,5944,5933,5869
9425,378,538,2232,7193,0,9425,1.69027e+13,102.758,1350.27,9425,164,111,8887,8881,8812,8818,7268
13952,427,1016,0,13952,0,13952,1.15953e+18,242.732,2371.08,13952,263,153,12936,12714,12406,11931,6924
38489,417,786,28987,9502,28987,9502,7.03853e+18,375.405,2867.96,38489,232,170,37675,37398,36236,35237,26990
12758,310,920,11960,798,0,12758,2.29129e+18,247.664,2201.36,12758,216,128,11749,11558,11208,11161,8386
32396,305,722,24413,7983,0,32396,8.27488e+18,342.059,2531.67,32396,193,163,31448,30332,29588,29504,17752
23156,626,1020,0,23156,4031,19125,5.76985e+15,281.131,3015.21,23156,336,109,22136,22063,21800,18782,16869
24967,115,754,0,24967,6258,18709,6.58947e+15,219.172,2698.51,24967,293,131,22998,21589,20259,19185,6005
45445,2,13,45162,283,45445,0,1.02668e+14,11.6272,418.247,45445,13,12,41219,39868,30798,39607,27936
13145,44,60,0,13145,13054,91,2.59013e+16,23.1463,488.272,13145,30,30,13085,13074,12757,12850,11891
3010,85,241,0,3010,21,2989,1.33975e+14,6.24684,500.035,3010,138,13,2769,2769,2627,1989,1304
36458,71,799,27497,8961,0,36458,8.26688e+18,355.82,2792.12,36458,221,168,33687,32410,22479,23528,6511
7157,9,30,0,7157,7141,16,2.10827e+16,27.1661,282.372,7157,25,26,6759,6448,5722,6164,4762
40740,316,845,9781,30959,0,40740,2.72536e+13,228.58,3574.62,40740,352,151,39895,39720,35206,37138,20690
18216,704,828,3892,14324,0,18216,2.23903e+13,221.356,2434.67,18216,357,114,17388,17377,17337,17387,16521
10668,457,587,9534,1134,9534,1134,8.91894e+17,207.779,1540.27,10668,101,122,10081,10073,10017,10064,8466
41228,311,487,41228,0,41228,0,4.92311e+18,317.381,2798.12,41228,208,166,40603,40016,37747,35726,31903
12937,1,50,0,12937,12762,175,2.50478e+16,35.9511,463.349,12937,32,32,3558,3558,3558,3558,3558
46380,369,772,0,46380,12920,33460,1.61622e+16,270.066,2742.83,46380,185,149,45608,45380,43824,43990,31464
19898,1058,1099,0,19898,4802,15096,7.03242e+15,200.273,2595.29,19898,452,112,18799,18799,18784,18798,18416
36876,497,727,32782,4094,36876,0,3.48826e+18,357.077,3274.54,36876,263,177,36149,35911,34424,32898,27705
44877,1266,1666,40380,4497,40380,4497,2.77834e+18,615.114,5144.36,44877,630,201,43211,43019,42702,42426,38793
5725,274,424,4317,1408,4317,1408,6.97228e+18,82.7476,938.596,5725,98,92,5301,5275,5265,5211,3615
3334,285,308,3129,205,3129,205,5.63932e+17,121.274,744.588,3334,87,70,3026,3026,3025,3025,2995
28436,171,605,0,28436,0,28436,8.26661e+17,421.484,2786.91,28436,244,173,25525,22831,23199,23369,11767
41299,8,12,40783,516,41299,0,1.01974e+14,11.0264,392.899,41299,12,12,41267,41254,39391,39389,33629
40778,3,10,40486,292,40778,0,9.97982e+13,9.50853,394.35,40778,10,10,38811,37963,32640,36737,30538
36777,357,1974,0,36777,0,36777,1.88913e+18,270.399,4684.06,36777,307,219,34779,34095,31061,15054,11831
29261,903,1270,29261,0,27286,1975,9.45138e+17,658.715,3836.75,29261,340,215,27991,27213,26627,26628,23800
14076,21,26,0,14076,13822,254,2.74645e+16,15.7689,345.837,14076,19,17,14048,14030,14003,13666,12992
33485,1219,1420,31327,2158,0,33485,2.37645e+18,543.28,4180.64,33485,337,209,32065,31805,31863,31844,30879
29463,1475,1565,0,29463,7717,21746,1.28891e+16,251.575,3774.41,29463,312,154,27898,27898,27898,27898,27058
7738,211,343,1673,6065,0,7738,2.76507e+13,170.628,1159.01,7738,136,70,7388,7289,6971,7055,4416
46720,7133,8711,46720,0,45648,1072,4.73652e+17,14.9825,9481.55,46720,1139,23,38009,38009,37759,35955,31569
41239,37,47,0,41239,41110,129,2.71848e+16,24.1285,668.113,41239,25,25,41192,41175,41146,41173,37195
1150,128,131,1150,0,1150,0,5.10205e+18,60.0861,316.104,1150,46,43,1019,1019,1018,1017,1010
29977,600,1224,28031,1946,0,29977,2.3458e+18,629.55,3722.16,29977,400,206,28404,27295,27160,26982,18938
42702,535,1270,39902,2800,0,42702,2.3853e+18,646.673,4395.28,42702,391,230,40657,38995,38725,38675,31740
38089,774,1660,34404,3685,0,38089,3.17589e+18,510.86,4697.4,38089,552,188,36429,35787,33927,34091,24578
10549,101,503,7945,2604,0,10549,8.26923e+18,167.4,1308.24,10549,113,94,9881,9722,7487,7396,2988
26154,17,20,25762,392,26150,4,9.75811e+13,17.8318,391.737,26154,19,19,26122,26084,25833,25833,25833
43494,5,13,43186,308,43494,0,1.00374e+14,11.145,407.093,43494,13,12,43214,43014,40883,40585,36242
31066,996,1207,31066,0,29022,2044,9.52054e+17,606.327,3822.63,31066,336,219,29859,29806,29277,29452,28435
38004,1330,1598,38004,0,35400,2604,1.01321e+18,525.611,4799.83,38004,334,270,36406,36392,35752,35878,33596
23163,350,911,0,23163,4966,18197,4.91535e+15,341.889,2757.95,23163,299,158,22102,21554,21118,19688,14514
33931,784,844,7815,26116,0,33931,2.23153e+13,304.873,3292.15,33931,379,127,33087,33066,33034,33076,30856
13505,629,985,0,13505,0,13505,1.22393e+18,450.659,2441.5,13505,269,173,12520,12117,12055,10825,8256
12598,111,737,3376,9222,0,12598,6.35387e+13,109.655,1670.57,12598,140,82,11787,11585,10431,9778,4411
37786,1781,1941,0,37786,0,37786,1.9229e+18,258.786,4610.26,37786,438,174,35845,35845,35539,35392,33206
33759,59,440,33759,0,33759,0,4.93145e+18,260.017,2448.8,33759,213,150,29780,25225,17829,16826,9523
15152,374,456,15152,0,15152,0,3.23599e+18,232.626,1899.33,15152,161,133,14696,14647,14465,14072,13455
41834,34,46,0,41834,41552,282,2.57957e+16,38.2014,723.883,41834,35,34,41742,41609,41271,41350,37444
37083,570,1284,0,37083,0,37083,1.2128e+18,659.288,4198.74,37083,404,227,35187,33554,33495,26714,24438
33642,360,445,33642,0,33642,0,3.58571e+18,253.767,2580.7,33642,250,165,33197,33136,32204,30378,29236
49530,619,988,10928,38602,0,49530,1.85437e+13,513.138,3964.41,49530,388,221,48512,47730,47094,44940,38779
7852,161,517,0,7852,1807,6045,4.79019e+15,113.041,1271.03,7852,186,107,7335,7223,6855,6905,2494
3301,116,314,2886,415,0,3301,3.88427e+18,109.487,806.398,3301,122,74,2879,2449,2682,2706,2239
16884,514,612,0,16884,0,16884,4.09662e+18,263.282,1799.5,16884,154,117,16272,16264,16198,16198,15021
40542,39,1646,10863,29679,0,40542,5.50053e+13,253.79,4213.43,40542,338,167,36739,35091,30317,12388,7064
45914,1057,2121,0,45914,10367,35547,7.72903e+15,246.39,5027.97,45914,459,293,43793,43787,38763,39650,21241
49145,2313,2710,0,49145,0,49145,1.60915e+18,391.253,6740.43,49145,555,256,46435,46430,46393,46435,41844
23019,783,1680,21250,1769,21250,1769,2.41454e+18,253.795,3585.73,23019,525,133,21339,21074,21028,20799,12243
1460,69,142,358,1102,0,1460,1.31089e+13,65.2336,345.321,1460,55,33,1292,1175,1232,1223,862
15967,627,878,14145,1822,0,15967,4.17447e+18,203.661,2013.53,15967,113,154,15089,15069,14892,14891,12706
30344,9,11,30138,206,30344,0,1.02585e+14,9.01954,345.159,30344,10,10,30328,30323,30210,30209,30311
26493,396,997,5754,20739,0,26493,1.72334e+13,326.685,3050.87,26493,259,177,25440,24924,24488,19695,14685
45914,30,56,0,45914,45454,460,2.63849e+16,20.3786,743.612,45914,26,24,45858,45845,45624,45719,42017
4463,2,9,4247,216,4463,0,9.62433e+13,7.41564,146.252,4463,9,9,3224,2703,2865,2817,1848
45658,456,2625,40980,4678,40980,4678,2.98568e+18,392.172,6529.66,45658,775,251,42820,41919,39506,38493,16680
39112,278,840,0,39112,0,39112,4.15715e+18,360.359,2912.67,39112,225,174,37801,36211,31690,20689,16793
11279,215,503,10105,1174,10105,1174,3.2405e+18,211.563,1437.02,11279,107,121,10703,9779,9697,9297,5590
17989,58,723,13502,4487,0,17989,8.35582e+18,223.221,2163.3,17989,164,155,16300,14691,11282,11920,3142
39052,7,13,38758,294,39052,0,1.01477e+14,10.8193,384.452,39052,12,11,39012,39004,37498,37497,36251
17846,970,1761,16432,1414,16432,1414,1.36674e+18,211.767,3258.93,17846,487,135,16085,15921,14496,15187,10425
17149,28,32,0,17149,16379,770,2.45306e+16,26.4056,421.441,17149,24,24,17109,17077,17002,17085,16058
27390,137,720,27390,0,20636,6754,8.34002e+17,354.07,2482.41,27390,187,171,25636,24974,21179,20806,7470
9395,245,796,0,9395,2055,7340,8.06067e+15,110.843,1529.72,9395,302,74,8599,8450,7896,8354,5841
37681,6,33,0,37681,35930,1751,2.46269e+16,28.7655,626.739,37681,26,29,35306,34323,25870,31857,18367
38365,752,2290,0,38365,0,38365,1.32771e+18,466.883,5477.33,38365,712,142,36075,35206,34723,31157,18513
17957,233,750,17957,0,13545,4412,8.75935e+17,260.04,2067.4,17957,164,139,17064,16447,15430,14384,7451
14203,434,749,3090,11113,0,14203,1.85802e+13,270.631,2061.46,14203,268,124,13454,13218,13038,11986,9707
38002,647,1426,38002,0,35500,2502,9.40698e+17,688.656,4420.8,38002,422,234,36147,34449,31432,28602,23430
37244,715,2506,34475,2769,0,37244,2.78534e+18,451.795,5565.15,37244,741,219,34714,33929,33509,32980,8768
5922,524,657,5922,0,5520,402,1.14651e+18,137.001,1354.82,5922,158,108,5265,5265,5154,5244,4944
47230,2020,2527,47230,0,42452,4778,1.59217e+18,305.469,5941.24,47230,374,275,44703,44703,44516,44699,41392
1746,7,8,1745,1,1746,0,1.12848e+14,6.93585,82.2854,1746,8,8,1734,1726,1732,1732,1483
31997,50,61,0,31997,31781,216,1.97502e+16,18.9934,788.308,31997,25,33,31936,31936,31880,31854,28245
6478,538,551,6478,0,5677,801,1.1888e+18,172.541,1416.4,6478,145,114,5927,5927,5927,5927,5912
49442,1838,1939,11563,37879,0,49442,2.65177e+13,258.038,5270.69,49442,526,169,47503,47503,47434,47471,46261
12233,64,1406,0,12233,0,12233,1.35263e+18,207.098,2776.21,12233,338,130,10204,9648,8334,2087,1411
2451,54,287,0,2451,0,2451,1.90401e+18,67.4211,561.158,2451,62,68,2108,2021,1940,1611,807
30445,1174,1240,28346,2099,28346,2099,6.39926e+17,485.464,3731.61,30445,302,202,29205,29205,29205,29205,28999
41813,1087,1932,39045,2768,39045,2768,7.05218e+17,606.254,5575.47,41813,402,259,39881,39653,39218,39304,32788
996,195,221,257,739,0,996,3.36317e+13,39.1657,385.352,996,57,38,775,774,775,775,741
779,26,66,779,0,629,150,3.01451e+18,15.3081,166.501,779,35,16,713,713,713,713,328
7139,439,542,1526,5613,0,7139,1.93994e+13,120.912,1356.74,7139,151,87,6597,6586,6539,6563,6111
5203,236,829,4711,492,0,5203,3.57118e+18,74.3713,1417.55,5203,208,129,4374,4373,4198,4235,2073
37251,2134,2258,34554,2697,0,37251,2.71112e+18,448.173,5374.19,37251,712,142,34993,34993,34972,34988,34538
25441,474,1562,0,25441,5328,20113,6.95339e+15,173.48,3634.61,25441,458,112,23879,23690,21956,20496,10378
27471,18,50,0,27471,26912,559,2.04939e+16,18.9757,692.865,27471,28,23,27400,27378,27024,26863,19593
4761,224,324,4377,384,4377,384,1.39703e+18,107.251,865.238,4761,162,60,4437,4437,4185,4349,3893
18007,160,1358,16049,1958,0,18007,3.96447e+18,175.676,2819.09,18007,339,158,16467,16021,14384,14072,5429
6348,9,10,6305,43,6348,0,1.00609e+14,7.77773,155.874,6348,9,9,6338,6337,6315,6315,6337
42293,563,2403,42293,0,34854,7439,9.67328e+17,375.903,5821.6,42293,487,291,39540,38398,37341,37214,19104
49953,360,1054,37627,12326,37627,12326,7.02133e+18,373.508,3525.23,49953,250,191,48755,47031,40836,35399,24357
47502,174,3046,43170,4332,0,47502,3.26725e+18,546.519,7160.93,47502,640,285,42723,41113,38404,37824,6827
42317,2088,2112,37876,4441,37876,4441,3.1665e+18,267.121,5104.72,42317,377,233,40205,40205,40205,40205,40053
24340,1566,2074,22305,2035,22305,2035,2.62849e+18,226.155,4203.04,24340,734,188,22266,22266,22100,22088,17242
1329,151,170,340,989,0,1329,2.97552e+13,23.991,332.821,1329,42,44,1159,1158,1157,1159,1105
4130,8,19,0,4130,4120,10,9.14242e+15,10.8208,205.771,4130,13,11,3858,3598,3658,3627,3241
46951,643,1291,0,46951,0,46951,1.20464e+18,675.616,4627.13,46951,373,247,45185,43134,43357,35961,32289
34726,18,1264,32424,2302,0,34726,2.42742e+18,632.771,3978.16,34726,411,207,22239,17627,15107,12918,3697
40949,278,481,40501,448,40949,0,3.82403e+18,284.572,2884.63,40949,253,205,40364,39746,35297,35654,25139
16080,24,841,3517,12563,0,16080,1.92207e+13,208.847,2326.58,16080,237,115,12674,10904,10207,6431,3014
40031,535,1046,8676,31355,0,40031,2.23109e+13,430.026,3810.36,40031,432,139,38914,38525,37033,37808,18970
20786,315,1185,20786,0,18127,2659,1.19775e+18,344.996,3228.57,20786,279,148,19257,18598,17475,13119,7614
4282,24,50,0,4282,4243,39,2.57133e+16,19.1798,276.986,4282,22,26,4231,4223,4000,4061,2568
35605,261,899,26848,8757,26848,8757,6.98694e+18,326.694,2865.21,35605,213,172,34306,33173,28162,23399,12582
1667,132,156,1667,0,1667,0,4.95533e+18,74.3689,394.096,1667,51,49,1511,1510,1495,1471,1439
20720,604,887,18543,2177,18543,2177,8.91854e+17,251.311,2406.34,20720,140,158,19833,19812,19691,19696,14986
31926,773,1383,0,31926,0,31926,1.18566e+18,531.632,4037.82,31926,315,206,30543,29960,29757,24830,24752
4786,250,504,4530,256,4530,256,1.71821e+18,111.36,950.812,4786,159,67,4282,4272,4252,4238,3347
21895,36,469,4922,16973,0,21895,2.79278e+13,222.461,2127.94,21895,200,116,18902,16900,15896,4807,3721
36597,5096,5329,33484,3113,0,36597,6.93382e+18,14.3071,6566.56,36597,992,26,31268,31268,31035,30788,28655
44174,271,1198,44174,0,38919,5255,1.15094e+18,428.261,4673.06,44174,335,217,41641,40045,38121,28291,9988
7404,145,431,6494,910,6494,910,2.95747e+18,294.594,1346.51,7404,224,101,6255,5640,5672,5471,2714
18606,788,815,18606,0,16664,1942,1.76736e+18,247.971,2217.47,18606,134,148,17791,17787,17744,17774,17641
14802,629,712,0,14802,3378,11424,4.6636e+15,178.951,1965.03,14802,234,126,14090,14071,14060,14056,13221
34400,724,1082,0,34400,0,34400,1.92338e+18,290.121,3148.37,34400,156,175,33318,33280,32610,31381,27445
28417,8,9,28366,51,20338,8079,7.09112e+13,8.05923,376.677,28417,9,9,28406,28403,28313,28313,28313
15456,229,585,11655,3801,0,15456,8.28514e+18,275.987,1715.57,15456,152,127,14669,14185,13677,13725,6466
28639,675,1564,5677,22962,0,28639,2.32937e+13,200.39,3946.15,28639,409,178,27075,27033,26475,26531,13756
9774,47,423,2304,7470,0,9774,1.97707e+13,185.851,1480.38,9774,240,91,8425,8043,7449,6188,2093
13096,2,89,0,13096,12990,106,2.46337e+16,30.5938,626.43,13096,35,31,9035,7963,6874,6592,5232
10594,338,547,10594,0,7981,2613,8.45331e+17,258.006,1485.42,10594,139,117,10039,9682,9540,8765,6212
16864,236,685,0,16864,0,16864,1.62659e+18,327.806,2351.75,16864,266,130,15199,13464,13746,13623,5105
27562,315,536,6338,21224,0,27562,2.84165e+13,218.711,2472.03,27562,227,124,27026,26922,26548,26785,19208
22673,22,41,0,22673,22593,80,2.73509e+16,16.4557,488.885,22673,20,21,22632,22622,22396,22241,17101
30703,23,57,0,30703,30145,558,2.71844e+16,38.3465,582.124,30703,34,29,30600,30560,29346,29876,22305
34793,1531,2269,31832,2961,31832,2961,2.55349e+18,298.024,5341.42,34793,497,236,32524,32524,32160,32322,23353
16041,553,567,0,16041,0,16041,8.08647e+17,304.329,2051.68,16041,212,139,15474,15474,15474,15474,15432
42731,62,85,0,42731,41835,896,2.5379e+16,36.2355,1122.22,42731,44,36,42646,42643,42282,42511,38074
7222,450,704,0,7222,0,7222,1.28731e+18,190.162,1500.69,7222,162,123,6518,6449,6368,6362,4716
21716,1175,1525,19863,1853,0,21716,3.21389e+18,248.545,3371.42,21716,385,201,20191,20191,20191,20191,18849
23727,474,1926,21463,2264,21463,2264,2.68819e+18,248.03,4269.78,23727,412,211,21801,21396,20920,19271,10747
29164,10,18,28438,726,29164,0,9.71905e+13,10.1035,379.428,29164,15,12,29140,29128,27739,27472,24519
33632,27,64,0,33632,33406,226,2.55904e+16,46.6305,806.687,33632,37,39,33471,33432,32067,31988,26937
30216,690,1208,0,30216,0,30216,1.44384e+18,480.612,3918.03,30216,401,157,29008,28677,27443,27206,14909
19274,39,975,0,19274,4506,14768,7.55397e+15,168.567,2755.22,19274,246,138,16680,14721,13834,12358,3594
24846,389,514,24846,0,24846,0,3.55253e+18,286.892,2525.6,24846,185,162,24332,24311,23735,23214,21065
32437,325,1168,7449,24988,0,32437,2.05313e+13,372.261,3628.48,32437,379,172,30923,30307,29048,9174,10037
49878,20,34,0,49878,47453,2425,2.46204e+16,30.9363,732.151,49878,32,33,49708,49573,44725,47772,40968
27304,120,913,23973,3331,23973,3331,1.73471e+18,382.382,3407.38,27304,268,187,23703,19148,19208,19766,5733
41119,567,751,40991,128,41119,0,3.29143e+18,416.43,3474.27,41119,258,156,40359,40193,39186,39145,34258
22381,5,14,22359,22,22377,4,7.52078e+12,11.3801,295.839,22381,13,13,22312,22278,22208,22180,18878
41051,159,1756,41051,0,38278,2773,9.86208e+17,528.35,5279.35,41051,376,292,37102,35018,28817,29670,10315
40172,748,1926,33264,6908,33264,6908,4.95717e+18,289.223,5321.38,40172,315,197,38246,38194,29940,25813,14473
42599,6,11,42195,404,32010,10589,7.11569e+13,7.25785,458.812,42599,9,9,42530,42474,41203,41234,37051
46813,823,1371,43791,3022,43791,3022,1.98504e+18,708.334,4679.97,46813,460,241,45324,43653,43870,43501,33345
30858,142,346,30858,0,30858,0,4.81753e+18,237.418,2166.82,30858,188,140,29975,29275,22719,22132,18488
47977,778,961,36139,11838,36139,11838,7.03369e+18,380.491,3359.06,47977,264,187,47016,47008,46795,46756,44980
13960,815,915,13960,0,13960,0,1.66598e+17,14.8775,1851.81,13960,459,15,13045,13045,12946,12996,11964
36120,840,1027,0,36120,7856,28264,4.86572e+15,426.536,3540.68,36120,348,169,35093,34913,34820,34948,33173
13902,422,636,10510,3392,10510,3392,3.75459e+18,229.487,1743.77,13902,144,134,13266,13190,13137,13128,9830
31296,546,1185,29302,1994,0,31296,2.32993e+18,610.523,3750.35,31296,345,216,29606,28536,28445,28354,13069
19982,1529,3824,19982,0,19982,0,1.34957e+18,16.9659,4301.22,19982,488,26,16158,16158,14034,15892,6754
21773,90,507,0,21773,6052,15721,1.60912e+16,201.389,1657.65,21773,128,111,20817,20447,17846,18159,6312
9300,39,583,8512,788,0,9300,3.12357e+18,201.369,1426.88,9300,234,83,8080,7878,6778,6579,974
21542,139,687,0,21542,4809,16733,5.3253e+15,211.84,2432.2,21542,341,123,20036,18603,18620,18469,9829
45631,729,1449,42576,3055,42576,3055,6.41048e+17,741.599,4844.96,45631,455,244,43809,41866,42140,42202,33680
48584,13,14,48292,292,48584,0,9.53566e+13,10.9,442.246,48584,13,12,48570,48569,47164,47163,46275
28329,1366,1577,26460,1869,0,28329,2.41193e+18,524.86,4229.23,28329,347,208,26752,26742,26720,26711,25827
10024,85,758,9314,710,9314,710,2.20491e+18,322.652,1799.92,10024,203,140,8329,7222,7011,6944,2874
3796,197,331,2860,936,2860,936,7.05449e+18,67.2445,730.954,3796,74,75,3465,3456,3437,3427,3027
6769,326,951,6092,677,6091,678,1.73252e+18,97.7505,1743.35,6769,232,77,5818,5719,5363,5595,2734
26536,15,66,0,26536,26348,188,2.54249e+16,53.1607,733.989,26536,37,38,26040,25545,24443,23905,15706
5973,222,368,5973,0,5973,0,2.91075e+18,130.083,1083.87,5973,102,88,5605,5591,5477,5270,4982
12004,258,383,0,12004,2738,9266,7.31882e+15,174.904,1489.66,12004,174,89,11617,11478,11422,11454,8200
12945,327,1130,11825,1120,0,12945,3.19477e+18,145.378,2416.26,12945,446,99,11815,11759,10759,11185,4897
28332,181,715,21355,6977,0,28332,8.30025e+18,332.618,2404.5,28332,206,153,26823,26077,20760,21232,12235
22610,326,385,5933,16677,0,22610,1.28504e+13,281.842,1971.34,22610,208,118,22223,22110,21978,21998,21243
3258,104,255,3040,218,3040,218,2.08277e+18,113.338,677.012,3258,80,63,2893,2535,2677,2640,1751
49571,1229,1889,49571,0,46295,3276,9.20116e+17,753.142,5842.7,49571,467,264,47682,47611,46376,46393,43184
36751,2,65,0,36751,36502,249,2.62538e+16,45.0007,836.191,36751,38,40,25905,23041,19514,19299,14555
1626,135,141,1626,0,1626,0,3.07641e+18,60.4662,374.971,1626,51,54,1485,1485,1478,1482,1455
49928,763,1436,45113,4815,45113,4815,2.499e+18,612.998,5247.57,49928,521,203,48347,47689,46881,46389,30446
35465,264,422,35465,0,35465,0,3.95661e+18,264.626,2474.23,35465,175,164,35000,34817,31814,30287,24226
12377,6,12,12206,171,12377,0,9.89042e+13,10.1333,214.499,12377,10,10,12323,12290,11759,11717,11029
26978,459,924,26978,0,23816,3162,1.15857e+18,423.223,3402.73,26978,271,180,25969,25026,23878,19849,12630
27688,1489,1814,27688,0,27688,0,9.24996e+17,16.6008,3657.44,27688,904,19,25874,25874,25874,25874,22049
28138,28,94,0,28138,27998,140,2.38443e+16,37.2435,924.145,28138,44,35,28000,27941,26391,25915,19823
20805,4,14,20473,332,18061,2744,7.29902e+13,6.65547,270.952,20805,10,8,20677,20587,18835,19299,16634
16951,903,1103,15794,1157,15794,1157,7.14873e+17,485.502,2824,16951,251,185,15848,15446,15684,15619,14340
29624,4,15,28300,1324,29624,0,9.57672e+13,10.4739,391.408,29624,12,12,28012,27477,25218,23530,11859
8559,288,463,8010,549,0,8559,2.37247e+18,106.695,1330.61,8559,166,84,8096,8095,8013,8052,6419
11209,223,1190,9878,1331,9878,1331,3.66658e+18,101.372,2179.05,11209,323,114,10019,9873,8796,6098,3951
20769,188,674,4815,15954,0,20769,2.40018e+13,195.145,2259.07,20769,305,100,19654,18408,17452,16849,3402
30610,17,1254,30610,0,26721,3889,1.19934e+18,373.582,3948.1,30610,318,192,19719,15713,12417,2597,1906
6121,21,26,0,6121,6017,104,2.5946e+16,11.7899,231.725,6121,14,14,6095,6094,6095,6094,6085
29873,440,852,6614,23259,0,29873,1.84211e+13,438.802,3004.09,29873,312,184,28807,28100,27749,24864,18263
7928,3,16,0,7928,7922,6,1.37426e+16,9.9223,244.129,7928,13,10,6416,6228,5287,6416,4832
27719,433,898,0,27719,6152,21567,4.69235e+15,419.46,2953.1,27719,388,169,26688,26039,25655,24574,17504
39206,1182,1596,35016,4190,35016,4190,1.43179e+18,458.802,4915.71,39206,442,173,37610,37482,37305,37339,29565
43202,1528,1793,40238,2964,0,43202,2.49591e+18,560.283,5423.02,43202,410,270,41409,41393,41233,41190,37557
7627,125,429,6823,804,0,7627,3.85637e+18,180.161,1129.89,7627,89,103,6905,6493,6219,6382,2416
15569,29,572,13750,1819,13750,1819,2.84288e+18,343.976,2159.06,15569,265,130,10925,8192,8088,8321,1680
41215,1630,2114,0,41215,0,41215,1.86945e+18,260.179,5103.16,41215,379,233,39101,39101,39101,39101,35980
40821,819,1684,8508,32313,0,40821,2.46311e+13,328.8,4822.29,40821,502,198,39137,38921,38361,36810,20831
32191,214,713,7217,24974,0,32191,1.87111e+13,353.741,2700.14,32191,287,164,30800,30132,28979,27582,16488
42054,51,745,11736,30318,0,42054,6.28504e+13,260.85,2594.83,42054,172,153,39740,38827,33288,14403,9069
20744,860,1656,18628,2116,18628,2116,3.1485e+18,204.304,3486.83,20744,409,139,19088,19057,18011,16974,13012
8576,87,664,0,8576,0,8576,1.73054e+18,248.966,1671.98,8576,230,105,7042,6546,6326,6421,2364
47513,1062,1375,47513,0,44435,3078,9.73129e+17,704.611,4740.02,47513,455,252,46138,46073,44230,44660,42621
18955,53,582,18955,0,18955,0,3.18474e+18,264.298,2318.29,18955,178,131,15516,12542,11170,7522,4562
23709,673,1146,23709,0,22115,1594,9.81489e+17,521.579,3276.62,23709,318,190,22402,21625,20691,20124,19159
11305,111,400,0,11305,3117,8188,1.6168e+16,156.408,1165.03,11305,89,90,10762,10551,9712,9729,4534
21114,424,495,0,21114,5869,15245,1.63034e+16,192.398,1642.98,21114,134,104,20619,20612,20539,20566,19159
10770,6,10,10683,87,10770,0,9.78499e+13,9.06323,202.427,10770,10,10,10713,10666,10148,10139,8479
45684,4992,7097,2903,42781,0,45684,4.89425e+11,163.938,10212.9,45684,1465,18,38587,38415,35582,36488,30762
16454,6,9,16410,44,16454,0,1.09261e+14,6.74091,236.804,16454,8,8,16426,16402,15927,15926,12727
33746,228,1673,31070,2676,31070,2676,2.48631e+18,348.995,4643.64,33746,466,134,31338,30702,29204,26908,8282
33684,43,63,0,33684,33212,472,2.50097e+16,41.5609,827.175,33684,36,37,33607,33535,32673,32778,27755
11893,217,417,11893,0,11893,0,4.91598e+18,246.328,1514.49,11893,156,115,11393,11105,10074,9400,7822
40520,1713,2167,0,40520,0,40520,1.27578e+18,462.633,5816.07,40520,621,135,38353,38242,38218,28555,31625
18568,681,729,16630,1938,0,18568,3.81629e+18,246.459,2054.93,18568,135,139,17839,17838,17836,17835,17728
47212,2047,2466,42589,4623,42589,4623,3.05251e+18,328.976,6161.37,47212,538,294,44746,44746,43329,42953,36390
8056,23,330,2252,5804,0,8056,6.28588e+13,105.487,907.837,8056,76,76,7183,6031,6196,3567,1376
14332,469,601,14268,64,14332,0,3.4031e+18,234.284,1953.84,14332,232,102,13731,13717,13551,13550,12364
24353,16,34,0,24353,23200,1153,2.46003e+16,29.0106,511.381,24353,27,27,24210,24091,22209,23205,19888
32093,412,571,7369,24724,0,32093,2.88608e+13,223.738,2722.34,32093,232,137,31522,31517,31265,31465,26076
25782,753,755,7120,18662,0,25782,6.07682e+13,187.33,2422.71,25782,142,139,25027,25027,25027,25027,25027
6153,473,474,5424,729,0,6153,3.82426e+18,147.821,1280.38,6153,158,106,5679,5679,5679,5679,5679
16254,893,1261,16254,0,14364,1890,1.12738e+18,324.558,2811.7,16254,272,169,14993,14989,14846,14785,14075
35210,449,1413,31449,3761,0,35210,3.12088e+18,371.371,4494.24,35210,411,188,33788,33333,29941,29953,16112
1209,160,204,1209,0,1015,194,1.37317e+18,108.311,428.578,1209,68,46,1005,818,940,908,882
29054,297,857,7535,21519,0,29054,2.9406e+13,211.626,2419.03,29054,117,155,28197,27944,25403,26705,14892
6860,303,437,1792,5068,0,6860,2.96637e+13,91.741,1008.92,6860,75,98,6423,6419,6310,6350,5149
21637,522,1012,0,21637,5483,16154,8.06227e+15,163.309,2301.85,21637,139,154,20625,20607,19741,19900,13246
7948,145,491,7948,0,5986,1962,8.77088e+17,159.488,1217.24,7948,121,109,7343,7190,6323,6130,3083
8311,377,842,7695,616,0,8311,2.76983e+18,110.203,1696.42,8311,306,75,7469,7467,7342,7238,4303
35061,745,795,35061,0,26402,8659,8.58321e+17,376.288,2881.43,35061,215,178,34266,34266,34216,33788,33706
46532,1451,2152,41372,5160,41372,5160,3.35434e+18,303.006,5011.37,46532,429,186,44380,44364,42963,42839,35008
43271,322,1797,0,43271,10760,32511,7.88625e+15,313.891,3981.06,43271,319,165,41378,41110,34756,35885,4305
11195,483,797,11195,0,10418,777,1.15623e+18,232.964,1898.99,11195,186,137,10398,10247,9707,9953,8139
24626,90,895,6141,18485,0,24626,2.43243e+13,222.051,2759.61,24626,288,121,22008,20510,19896,18410,6731
23929,574,741,0,23929,6061,17868,7.17651e+15,417.313,2490.75,23929,446,96,23151,22393,22736,22793,20076
16121,308,599,0,16121,4186,11935,6.77867e+15,204.049,1906.01,16121,242,101,15522,15514,14368,14537,5550
44579,87,94,0,44579,44299,280,2.42073e+16,48.649,1157.67,44579,49,42,44485,44485,44423,44123,43179
13079,324,1284,12106,973,12106,973,1.25271e+18,292.006,2723.36,13079,424,104,11717,10882,10049,10401,3850
43054,2300,3821,31657,11397,31657,11397,5.49254e+18,21.9841,4688.95,43054,1282,1277,39233,39233,28629,25098,37214
2852,48,313,2852,0,2852,0,4.85191e+18,82.2833,709.704,2852,79,66,2343,2017,1552,1375,773
27981,162,1627,0,27981,0,27981,1.21271e+18,372.149,4226.29,27981,312,228,25346,24092,21968,19391,6582
45289,1823,1848,45289,0,35553,9736,8.37745e+17,336.363,5340.09,45289,395,223,43441,43441,43441,43441,43304
47590,1164,1382,10280,37310,0,47590,1.87494e+13,383.451,4695.99,47590,334,228,46208,46193,45924,45691,41458
31468,4,7,31441,27,31468,0,4.48493e+13,5.48646,362.238,31468,6,6,29794,27565,28958,29327,28466
8286,2,13,8236,50,8286,0,1.02691e+14,6.69213,180.157,8286,9,9,7522,7270,5685,7242,5049
28383,519,1123,0,28383,0,28383,1.15621e+18,535.092,3448.15,28383,337,188,26889,26049,25992,22719,20795
20933,926,997,0,20933,0,20933,1.12624e+18,493.179,2913.71,20933,273,179,19936,19936,19887,19844,19332
45823,566,677,45823,0,45823,0,3.51799e+18,314.947,3656.11,45823,227,203,45146,45143,44847,44377,41872
34708,525,605,33191,1517,0,34708,1.66064e+18,445.305,3083.83,34708,261,180,34065,33846,33352,33439,32627
18251,5,11,18134,117,18251,0,1.01418e+14,8.6667,268.615,18251,10,10,18112,18047,17000,17265,15757
10175,124,882,9474,701,9474,701,2.13563e+18,165.316,1970.43,10175,177,115,9021,8371,7945,7888,3584
17892,1,11,17070,822,17892,0,9.60911e+13,10.1798,298.668,17892,11,11,7007,7007,7007,7007,7007
26853,64,65,0,26853,26658,195,2.5691e+16,53.8676,734.399,26853,37,38,26788,26788,26788,26788,26761
11190,632,679,0,11190,0,11190,1.22478e+18,222.581,1735.04,11190,165,122,10511,10494,10509,10508,10241
16896,1079,1214,0,16896,0,16896,1.4784e+18,245.091,2953.71,16896,372,93,15682,15682,15627,15682,14684
34265,1621,1730,0,34265,7853,26412,6.74814e+15,180.787,4228.49,34265,360,165,32535,32535,32535,32535,31704
19658,674,980,0,19658,3983,15675,5.69302e+15,182.487,2651.81,19658,342,75,18678,18678,18354,18336,12972
40293,8,62,0,40293,40005,288,2.54481e+16,50.8054,888.033,40293,41,42,38199,36929,35376,31967,19255
32092,411,2546,29285,2807,29284,2808,1.27635e+18,438.236,5617.27,32092,584,229,29124,27892,26340,26895,6260
14078,708,1268,0,14078,0,14078,1.61326e+18,229.635,2621.19,14078,300,184,12810,12810,12807,12810,8480
34777,656,1497,34777,0,30605,4172,1.13012e+18,363.673,4518.2,34777,319,182,33280,33264,31443,29932,21612
3135,78,272,3087,48,3135,0,2.69346e+18,99.0673,637.261,3135,108,47,2723,2407,2399,2350,1077
3023,4,8,3021,2,3023,0,1.16203e+14,7.12008,108.407,3023,8,8,2983,2971,2762,2756,2605
19379,41,635,0,19379,0,19379,1.87131e+18,297.971,2472.19,19379,244,154,14763,12961,11868,3575,3134
39487,442,1164,35305,4182,35305,4182,3.0051e+18,521.747,4109.96,39487,508,175,37518,36377,32968,30904,21695
31619,2,13,31406,213,31619,0,1.03149e+14,10.1964,348.835,31619,11,10,28579,27566,21262,27403,19355
34842,45,468,34842,0,34842,0,3.68891e+18,267.804,2493.1,34842,263,168,30225,27253,17366,15140,5302
39578,666,843,0,39578,0,39578,4.1231e+18,380.457,2954.21,39578,238,175,38735,38706,38482,38160,35655
11769,11,12,11615,154,11769,0,9.99e+13,6.92497,206.697,11769,9,9,11757,11755,11454,11454,11754
8825,572,894,0,8825,0,8825,1.98989e+18,159.767,1722.67,8825,308,79,7931,7786,7680,7611,6913
33750,827,832,29712,4038,29712,4038,3.2214e+18,340.678,3520.28,33750,297,181,32918,32918,32918,32918,32889
43308,2032,2150,0,43308,8321,34987,6.58388e+15,275.561,5306.7,43308,578,200,41158,41158,41027,41051,39926
42292,972,1541,10130,32162,0,42292,2.62417e+13,260.586,4353.39,42292,292,179,40751,40707,39994,27589,28760
42044,173,1283,0,42044,0,42044,1.21009e+18,661.302,4405.27,42044,375,233,38125,36438,33693,30439,14634
44648,6,13,44318,330,44648,0,9.97344e+13,12.3818,414.037,44648,13,13,44518,44437,42154,42064,33063
22519,32,356,22519,0,22519,0,3.75869e+18,229.159,1814.45,22519,121,166,18512,14219,10412,7955,2854
24127,10,12,23523,604,20712,3415,7.736e+13,6.77009,304.744,24127,9,8,24115,24115,24101,24101,22895
6080,140,537,1277,4803,0,6080,1.90286e+13,113.332,1267.84,6080,139,103,5484,5379,5115,3815,2813
2075,49,168,0,2075,0,2075,2.2229e+18,123.131,507.47,2075,82,61,1545,1312,1335,847,616
24964,370,1063,23276,1688,23276,1688,6.43775e+17,469.384,3202.28,24964,291,193,23442,22418,22108,22268,13300
48946,122,1875,12318,36628,0,48946,2.98217e+13,289.833,4515.06,48946,380,167,46194,43924,39559,33837,9624
8123,64,581,0,8123,1757,6366,4.72832e+15,136.915,1467.06,8123,144,102,7140,6478,6284,5246,2379
48390,2296,2357,43578,4812,43578,4812,3.00828e+18,291.21,5876.75,48390,414,250,46033,46033,46033,46033,45828
30916,181,898,7131,23785,0,30916,2.37449e+13,261.231,3170.37,30916,370,136,29216,27219,27032,25942,9355
8603,787,825,0,8603,0,8603,1.26094e+18,105.866,1773.65,8603,219,95,7778,7778,7778,7778,7604
37809,567,893,8305,29504,0,37809,1.78565e+13,464.885,3407.56,37809,360,196,36893,36159,35804,35032,30061
26495,1047,1713,0,26495,0,26495,2.70352e+18,191.678,4326.61,26495,262,149,24782,24773,23438,15496,12699
24949,659,1164,0,24949,0,24949,1.19336e+18,495.061,3292.96,24949,354,173,23629,23034,22912,21473,19315
30855,89,515,30855,0,30855,0,3.39809e+18,291.066,2397.87,30855,161,149,29029,28085,20717,19660,6105
37679,450,621,0,37679,10467,27212,1.6188e+16,259.209,2310.38,37679,185,137,37058,37013,36689,36746,31775
12359,195,622,11079,1280,11079,1280,3.22432e+18,208.635,1609.85,12359,109,124,11603,10583,10335,9626,3599
39443,524,2325,35847,3596,35843,3600,1.32672e+18,333.092,5853.28,39443,723,191,36925,36464,35121,33945,8956
31859,695,1867,28478,3381,0,31859,3.71902e+18,234.386,4313.65,31859,271,220,29992,29966,29221,29107,21373
11259,174,506,0,11259,0,11259,1.92172e+18,219.865,1433.87,11259,102,121,10514,9665,9388,4748,4196
44937,1142,3162,44937,0,40869,4068,1.0824e+18,515.942,7269.01,44937,798,199,41775,41536,38701,34751,14785
37983,695,732,37979,4,37983,0,4.04144e+18,300.681,3210.84,37983,213,143,37251,37246,36999,36793,36574
6491,168,557,1428,5063,0,6491,1.73901e+13,110.306,1320.01,6491,151,110,5916,5820,5553,5387,2395
12753,428,557,11415,1338,11415,1338,3.26622e+18,241.101,1583.63,12753,111,127,12196,12174,11949,11912,10275
42189,146,1034,42189,0,31770,10419,8.95218e+17,381.689,3416.06,42189,245,180,39541,38344,32669,31777,8509
46532,723,2407,43245,3287,0,46532,2.64465e+18,454.798,6543.8,46532,671,141,43961,43364,41948,41567,18088
18081,206,1285,16781,1300,16781,1300,1.24302e+18,335.366,3028.94,18081,372,129,16286,15684,13914,14514,4625
49040,806,1483,45767,3273,45767,3273,6.59851e+17,736.549,5002.84,49040,429,251,47351,45352,45964,45813,32763
22388,2,62,0,22388,22246,142,2.66563e+16,43.7612,654.715,22388,34,32,15860,14155,11846,11981,9401
3153,23,334,3153,0,3153,0,4.67956e+18,91.9144,767.598,3153,70,77,2342,1702,1428,1297,436
35229,6,12,35058,171,35211,18,1.05626e+14,8.4081,365.73,35229,10,10,35122,35019,33733,33722,29494
7641,189,254,7641,0,7641,0,3.76438e+18,171.299,975.735,7641,90,102,7351,6945,7046,6654,5753
7780,425,471,0,7780,0,7780,4.09844e+18,181.417,1157.7,7780,112,101,7309,7309,7309,7307,7098
602,5,7,601,1,602,0,3.55351e+13,6.51827,49.5078,602,7,7,573,561,558,541,554
39744,191,741,39680,64,39744,0,3.24567e+18,377.155,3553.25,39744,251,165,37737,35765,29501,23433,14903
17181,108,736,3691,13490,0,17181,1.84805e+13,298.034,2245.41,17181,235,142,15787,15274,14403,11831,6066
46223,1,14,46030,193,46223,0,8.6185e+13,8.803,435.207,46223,11,10,26046,26046,26046,26046,26046
16686,467,576,0,16686,3653,13033,4.95737e+15,276.798,1856.18,16686,197,131,16110,15988,16034,16047,14842
14577,717,1003,14577,0,13605,972,9.16385e+17,436.887,2552.67,14577,231,172,13574,13146,12870,12816,11238
25079,878,1427,23151,1928,23151,1928,2.34992e+18,353.382,3775.01,25079,318,178,23652,23619,23112,22947,20359
45368,13,14,44761,607,42624,2744,8.01717e+13,6.80579,421.889,45368,9,10,45354,45354,42991,42991,44222
43916,858,1382,0,43916,0,43916,1.19042e+18,677.041,4596.08,43916,380,238,42493,41045,40975,37198,28466
42020,125,972,0,42020,9053,32967,4.84458e+15,481.168,3712.4,42020,357,198,38887,37745,35436,30285,12407
14414,449,1139,0,14414,0,14414,1.30416e+18,414.191,2667.61,14414,244,177,13122,12741,12312,11793,3752
38923,1065,1320,0,38923,8557,30366,4.82817e+15,402.088,4214.79,38923,353,209,37603,37560,37158,37192,31297
15700,241,592,0,15700,3453,12247,4.82124e+15,270.041,1827.19,15700,188,132,14959,14641,14157,14128,8879
33565,2,67,0,33565,33263,302,2.16399e+16,23.6021,773.515,33565,33,33,23905,21094,20586,18243,16043
23581,1284,3757,1498,22083,0,23581,4.89663e+11,12.263,5434.97,23581,761,17,19824,19824,15481,17130,10943
28625,94,572,0,28625,6475,22150,7.2852e+15,228.647,2567.3,28625,229,123,27263,26182,22322,23349,7431
48924,246,1008,0,48924,11029,37895,5.78688e+15,415.973,4143.09,48924,447,147,47396,45610,42269,43878,15355
49912,199,1356,0,49912,10793,39119,4.80465e+15,420.933,4789.72,49912,367,232,47316,46100,43642,39586,16810
25811,1753,2216,23624,2187,0,25811,3.15608e+18,216.201,4447.54,25811,693,215,23595,23595,23477,23332,19054
40764,592,2005,36513,4251,36513,4251,9.19399e+17,281.644,4774.1,40764,301,212,38759,38697,37937,38164,25108
7494,344,375,7494,0,7494,0,2.86744e+18,239.759,1225.77,7494,152,93,7119,7099,7068,7078,6993
23612,1,71,0,23612,23412,200,2.59245e+16,38.4456,728.141,23612,33,38,8979,8979,8979,8979,8979
44185,9,14,43226,959,40091,4094,8.09804e+13,6.75994,417.034,44185,10,8,44171,44171,44147,44146,39136
33035,360,518,33035,0,33035,0,3.51269e+18,416.095,2388.67,33035,517,44,32090,30256,31126,30556,24264
21086,858,917,0,21086,4488,16598,4.61018e+15,304.489,2689.9,21086,234,162,20169,20126,20148,20162,19483
6454,471,518,150,6304,0,6454,1.97535e+12,28.5158,1048.25,6454,325,34,5936,5936,5922,5839,5479
33741,59,1401,33741,0,29557,4184,1.13033e+18,379.432,4424.26,33741,310,198,25939,22494,17924,4113,3268
29898,4,14,29451,447,29450,448,9.31191e+13,7.91642,336.811,29898,10,11,29683,29582,28299,28313,22684
36275,497,921,27331,8944,0,36275,8.30629e+18,319.803,2907.41,36275,223,176,35354,35182,34166,34192,25290
17826,667,1411,17826,0,16313,1513,7.72033e+17,342.034,3287.85,17826,424,135,16415,16176,15649,12980,10036
23474,9,11,23040,434,23026,448,9.57357e+13,5.54869,272.61,23474,10,7,23463,23463,23462,23461,23459
25798,10,12,25591,207,25459,339,9.27632e+13,7.84092,379.257,25798,10,9,25786,25786,25784,25785,24837
32850,154,1133,28890,3960,0,32850,3.56943e+18,323.649,4023.45,32850,356,181,29465,27266,24656,24944,4809
13262,19,44,0,13262,13170,92,2.57108e+16,31.3285,401.283,13262,24,25,13182,13149,12607,12845,10214
41565,27,34,0,41565,39577,1988,2.46279e+16,29.1763,665.134,41565,30,30,41491,41379,40395,40181,37500
33378,3,14,32949,429,32930,448,8.38069e+13,6.72698,368.17,33378,9,9,32417,32134,28775,29492,24090
2600,127,330,2600,0,2600,0,4.66584e+18,109.283,730.88,2600,110,57,2233,2077,1741,1484,1157
28916,35,1451,28916,0,25907,3009,1.54103e+18,242.178,3686.69,28916,437,154,23911,20121,15731,5332,3094
15568,5,11,15485,83,15568,0,1.1293e+14,7.48401,243.28,15568,9,9,15497,15465,14853,14858,13262
35360,422,432,35360,0,35360,0,4.948e+18,255.999,2562.75,35360,192,150,34928,34922,34862,34874,34788
13367,6,10,13331,36,13304,63,9.66749e+13,5.91374,216.709,13367,8,8,13346,13331,12990,12987,12169
12147,364,368,0,12147,2815,9332,7.29202e+15,164.864,1467.25,12147,173,90,11779,11779,11778,11779,11737
24654,8,14,24316,338,24651,3,1.08633e+14,6.11738,285.535,24654,11,10,24634,24628,24359,24357,20368
29225,469,734,22007,7218,0,29225,8.32505e+18,331.593,2449.78,29225,204,158,28491,28353,28024,28024,22702
8321,11,17,0,8321,8268,53,2.94085e+16,7.26607,210.771,8321,11,10,8304,8301,8262,8172,5450
3984,447,547,3575,409,3575,409,1.54417e+18,139.568,1137.36,3984,146,72,3437,3410,3437,3433,2817
8467,228,404,2000,6467,0,8467,2.26061e+13,154.581,1295.28,8467,209,79,8042,7806,7663,7783,4704
23106,465,984,21600,1506,21600,1506,5.67863e+17,455.006,2903.31,23106,267,185,21953,21303,21042,20991,14215
10498,207,1039,9361,1137,9361,1137,3.3418e+18,143.302,2019.9,10498,319,88,9416,9262,8545,6575,5453
23342,1256,1335,21863,1479,21863,1479,6.79933e+17,455.218,3581.52,23342,301,194,22007,21862,21954,21981,21688
22561,517,1797,19172,3389,19078,3483,2.53202e+18,396.622,4058.31,22561,329,221,20365,19479,17018,19217,5240
32971,7,10,32025,946,28877,4094,8.01033e+13,6.32316,322.3,32971,9,8,32961,32959,32774,32775,30685
3350,499,672,2825,525,2825,525,4.77656e+18,16.6436,919.748,3350,233,59,2678,2678,2656,2629,2169
6909,22,29,0,6909,6881,28,1.90861e+16,11.8214,264.121,6909,19,17,6880,6879,6846,6875,6387
1588,40,125,1184,404,1184,404,7.25528e+18,59.1423,342.031,1588,48,55,1349,779,1030,973,622
23757,1533,1799,0,23757,0,23757,1.23098e+17,71.8822,3504.25,23757,434,63,21958,21958,21705,20378,19298
19017,4,47,0,19017,18937,80,2.51067e+16,20.5671,477.07,19017,23,24,18627,18346,15186,14185,10086
37091,1791,2419,34389,2702,0,37091,2.73647e+18,589.047,5455.06,37091,745,200,34672,34612,34448,34517,28368
33450,6,15,33420,30,33444,6,7.52285e+12,13.0038,363.49,33450,15,15,33366,33330,33193,33160,28154
13204,43,557,11609,1595,11609,1595,3.26085e+18,273.127,1964.14,13204,197,136,10110,8858,8222,7613,1653
30977,2,10,30869,108,30913,64,1.03796e+14,7.81205,327.875,30977,9,10,27592,27211,23952,26081,19636
17757,460,749,0,17757,0,17757,1.2772e+18,393.87,2283.26,17757,201,156,16913,16346,16405,15987,14923
1402,3,9,1398,4,1402,0,1.12028e+14,6.3495,74.8145,1402,8,8,1306,1263,1191,1251,998
19699,565,868,17632,2067,17632,2067,8.91054e+17,245.437,2343.79,19699,141,158,18831,18811,18686,18617,14446
34413,990,1078,30167,4246,30167,4246,1.73213e+18,384.4,3999.14,34413,309,205,33335,33333,33323,33331,32997
47485,287,914,0,47485,0,47485,4.15273e+18,381.426,3292.61,47485,277,186,46044,44139,37506,20406,22740
10563,200,278,10563,0,10563,0,4.01553e+18,182.736,1156.52,10563,95,113,10254,9886,9796,9336,8049
31157,57,566,0,31157,8666,22491,1.61768e+16,247.726,2065.51,31157,165,124,29461,28841,24557,25362,7599
20481,462,1097,20481,0,18367,2114,8.91973e+17,562.583,2738.34,20481,436,111,18828,17996,17517,18683,13736
21834,489,1515,20366,1468,20366,1468,1.17256e+18,322.139,3560.35,21834,445,126,20260,19699,18561,19323,7517
44806,1547,1754,41829,2977,0,44806,2.4445e+18,593.494,5315.15,44806,395,258,43052,43048,42940,42906,41408
34220,1353,2040,30978,3242,30978,3242,2.83531e+18,345.798,5005.57,34220,485,244,32180,32153,31912,32016,21667
4021,64,258,1111,2910,0,4021,6.29327e+13,51.2131,619.724,4021,56,66,3759,3699,3324,3304,1252
22777,273,468,22777,0,22777,0,3.24306e+18,266.678,1940.92,22777,166,121,22241,21664,20218,19544,14250
15269,553,1204,0,15269,0,15269,1.7928e+18,218.352,2563.85,15269,466,123,14065,13921,13519,13527,10302
3373,70,347,0,3373,0,3373,8.20587e+17,216.28,835.442,3373,127,80,2588,2311,2200,2324,1062
3353,150,272,3353,0,2523,830,8.13002e+17,67.0686,650.536,3353,73,70,3081,3074,2919,2707,1871
26061,492,792,5665,20396,0,26061,1.8556e+13,410.12,2772.46,26061,293,172,25211,24605,24386,23808,19548
37545,18,36,0,37545,35758,1787,2.46201e+16,30.7998,640.959,37545,29,31,37381,37263,33576,35695,27846
8202,312,795,0,8202,0,8202,1.18527e+18,228.547,1723.79,8202,152,133,7407,7167,7065,7014,2465
25808,103,692,19442,6366,19442,6366,7.01056e+18,320.134,2253.29,25808,173,151,24125,23520,16980,12675,6278
20622,591,1175,19259,1363,19259,1363,6.50744e+17,453.018,3093.57,20622,279,179,19315,18659,18479,18518,14868
31326,393,1044,27534,3792,0,31326,3.7776e+18,315.156,3679.24,31326,334,196,30264,29582,25107,25709,10217
17771,461,502,17771,0,17771,0,4.10458e+18,235.458,1902.93,17771,151,140,17269,17264,17250,17217,17100
13660,14,892,0,13660,2963,10697,6.45161e+15,138.726,1960.89,13660,277,70,11708,10697,10119,4982,2484
17870,108,621,13460,4410,13460,4410,3.81078e+18,281.759,1918.02,17870,159,135,16662,16261,13187,13615,4023
44325,341,990,10364,33961,0,44325,2.30104e+13,303.608,3841.45,44325,439,147,43257,42992,39559,38553,19121
29421,202,555,0,29421,8170,21251,1.61675e+16,229.742,1989.43,29421,155,121,28727,28012,26752,26767,14720
9119,891,953,8494,625,8494,625,6.76194e+17,175.478,2007.04,9119,179,131,8166,8157,8157,8158,7910
31893,274,571,0,31893,7316,24577,7.38952e+15,222.65,2712.63,31893,240,133,31322,30788,29966,30453,18131
35711,222,1275,33289,2422,0,35711,2.45786e+18,677.514,4112.76,35711,395,222,32508,31572,29425,29023,13386
35046,1370,1388,35046,0,32756,2290,9.6142e+17,506.168,4295.71,35046,289,234,33658,33658,33653,33654,33555
5213,4,11,0,5213,5212,1,2.11902e+16,8.35853,149.039,5213,10,10,5159,5146,3795,4816,3764
11597,97,459,3006,8591,0,11597,2.9415e+13,166.756,1265.74,11597,88,112,10864,10355,9510,10243,3377
10488,315,529,9249,1239,9249,1239,3.22242e+18,248.606,1713.72,10488,185,127,9913,9701,9064,8811,5403
15512,1,7,15492,20,15512,0,3.57469e+13,6.98272,251.407,15512,7,7,6646,6646,6646,6646,6646
45561,101,955,0,45561,0,45561,4.10699e+18,370.069,3233.66,45561,238,186,42692,41610,30081,13633,8151
37601,548,644,37601,0,37601,0,3.48208e+18,317.352,3303.41,37601,209,184,36957,36933,36579,36201,34734
11871,41,314,11871,0,11871,0,4.88229e+18,156.428,1271.48,11871,119,108,9739,7516,5743,5347,3099
530,6,86,526,4,526,4,9.72964e+16,23.2208,171.834,530,38,28,270,166,180,144,35
41844,182,385,10921,30923,0,41844,1.20375e+13,280.22,2626.66,41844,237,144,40517,37729,37763,37409,31998
7957,544,698,7390,567,0,7957,2.66778e+18,157.946,1556.97,7957,239,96,7259,7211,7228,7254,6404
14725,1181,1397,14725,0,13576,1149,4.1568e+18,196.531,2698.11,14725,394,135,13328,13313,12294,12463,11802
47128,297,924,0,47128,10462,36666,4.77196e+15,461.461,3727.67,47128,349,208,45395,44326,43208,40496,25493
19375,417,809,19375,0,17336,2039,1.76689e+18,248.611,2254.38,19375,136,157,18566,18509,16991,17938,13239
10804,349,445,0,10804,0,10804,1.64598e+18,322.952,1657.93,10804,244,117,10245,9392,9978,10125,9468
38440,1473,1531,9611,28829,0,38440,2.91202e+13,221.23,3861.9,38440,253,160,36909,36909,36909,36909,36612
30873,445,1703,27573,3300,27570,3303,1.07686e+18,247.296,3743.39,30873,340,172,29170,29053,28249,27549,4233
49841,3,55,0,49841,49617,224,2.6557e+16,30.4532,778.35,49841,26,29,45843,43928,37529,35234,24359
19899,71,1094,18594,1305,0,19899,2.38872e+18,538.362,3038.83,19899,285,185,16171,13859,13234,13329,3109
12737,285,579,2807,9930,0,12737,1.97116e+13,256.911,1665.76,12737,201,124,12104,11868,11648,11340,8232
26158,26,48,0,26158,26067,91,2.66711e+16,21.2442,557.699,26158,23,25,26110,26095,25929,26076,24187
41137,264,578,39401,1736,41137,0,3.7982e+18,288.376,3129.18,41137,262,176,40336,39622,33004,31787,20900
27162,319,1556,24414,2748,24414,2748,1.41368e+18,400.284,4118.01,27162,432,164,24886,21796,21052,21681,13272
31988,21,63,0,31988,31768,220,2.61262e+16,44.2898,780.669,31988,36,39,31774,31655,30213,29254,25289
22073,49,88,0,22073,21996,77,2.01421e+16,26.8586,767.518,22073,36,30,21985,21980,21883,21929,18794
14117,22,389,13781,336,14117,0,4.40838e+18,230.116,1514.67,14117,188,71,11688,9816,7465,7569,2467
29939,765,2036,0,29939,0,29939,1.75656e+18,235.493,4594.22,29939,387,192,27903,27831,27410,22387,19500
40623,354,463,40623,0,40623,0,4.92199e+18,287.408,2813.43,40623,214,154,40160,40082,37788,37302,33938
30121,281,1871,0,30121,0,30121,1.82156e+18,229.806,4196.41,30121,386,178,28204,27736,25079,15767,10053
36128,102,2713,36128,0,36118,10,1.62973e+18,27.4092,5113.47,36128,398,28,33415,33217,21634,33406,25434
14142,8,12,13953,189,14142,0,9.84627e+13,9.61172,226.746,14142,10,10,14124,14118,13641,13642,13274
16606,366,969,15510,1096,15510,1096,2.05107e+18,281.456,2497.19,16606,254,149,15506,15275,14923,14743,11605
12159,119,1050,11354,805,11354,805,6.03552e+17,207.763,2320.94,12159,270,124,10502,9423,8906,9426,3603
7686,98,331,0,7686,1804,5882,7.43601e+15,117.366,1133.11,7686,147,79,7293,7112,6177,5593,3321
35346,1477,1837,32989,2357,32989,2357,2.05664e+18,542.35,5000.77,35346,424,221,33509,33506,33352,33292,30535
4681,162,316,0,4681,1027,3654,6.74387e+15,88.9184,900.61,4681,137,67,4365,4304,3887,4139,2713
33963,63,84,0,33963,33452,511,2.1225e+16,23.1195,937.897,33963,31,35,33879,33878,32239,33042,30243
37894,48,65,0,37894,37642,252,2.66009e+16,48.7453,847.913,37894,37,39,37803,37732,36741,36865,32857
25030,743,1122,0,25030,5870,19160,7.7629e+15,187.574,3325.67,25030,258,139,23908,23906,23407,23563,18287
11364,411,529,8574,2790,0,11364,8.27754e+18,242.238,1438.84,11364,134,111,10835,10621,10747,10745,9363
44977,666,1360,9729,35248,0,44977,1.86184e+13,395.528,4590.29,44977,354,220,43617,43439,42178,41101,30294
27511,2041,2339,25217,2294,25217,2294,2.61982e+18,212.382,4708.64,27511,741,217,25172,25172,25157,25154,22517
21122,381,766,0,21122,4659,16463,4.87849e+15,361.548,2481.42,21122,287,147,20182,19750,19463,19202,14589
25643,585,721,22603,3040,22603,3040,3.20702e+18,335.07,2954.03,25643,263,164,24922,24922,24739,24571,20713
34166,864,1311,34166,0,31903,2263,9.68426e+17,608.632,4043.5,34166,408,218,32816,31902,30393,30199,26865
42129,390,1865,0,42129,8221,33908,6.01227e+15,364.942,5185.45,42129,513,193,39973,39549,37799,31636,13486
23650,1038,1155,0,23650,0,23650,1.45391e+18,361.709,3404.91,23650,396,160,22495,22477,22453,22487,21449
18992,324,852,17698,1294,0,18992,2.4926e+18,409.011,2465.39,18992,258,151,17879,17384,16893,16907,11539
32905,11,18,32452,453,32629,276,9.77314e+13,16.9526,430.572,32905,18,18,32806,32745,32080,32102,30694
25708,91,1363,24053,1655,0,25708,2.37958e+18,523.896,3706.38,25708,311,193,21877,19071,18760,18844,6072
28667,4,10,27837,830,24925,3742,7.53691e+13,6.10346,299.233,28667,9,7,28589,28556,26990,26988,24993
8910,1,7,8902,8,8910,0,3.57609e+13,6.97183,190.548,8910,7,7,3818,3818,3818,3818,3818
21696,363,379,21696,0,21696,0,5.06284e+18,238.72,1917.27,21696,181,130,21317,21317,21236,21228,21044
36532,632,1580,36532,0,32798,3734,1.52761e+18,270.157,4216.53,36532,442,167,34952,34844,30736,33275,11603
13618,580,986,0,13618,0,13618,1.22868e+18,449.766,2455.41,13618,244,171,12571,12013,12033,11364,9193
40412,8,12,40166,246,33436,6976,8.23977e+13,7.87924,468.558,40412,10,9,40399,40398,39147,39162,34379
19602,3,8,19480,122,19602,0,1.15307e+14,7.46204,261.969,19602,8,8,18742,18300,17078,18119,12253
37670,1,37,0,37670,35919,1751,2.45767e+16,30.2131,645.712,37670,31,31,14466,14466,14466,14466,14466
36345,1939,2500,32916,3429,0,36345,3.37937e+18,300.319,5655.2,36345,788,250,33845,33845,33715,33637,28260
36936,967,1094,8612,28324,0,36936,2.55924e+13,218.467,3678.85,36936,382,144,35842,35842,35755,35801,32109
30267,168,1613,26898,3369,26898,3369,3.45706e+18,260.821,3575.58,30267,217,227,27977,26632,24251,19950,6498
969,156,178,892,77,0,969,2.90699e+18,69.5119,343.233,969,51,42,791,791,783,785,758
41795,1199,1345,36599,5196,36599,5196,3.3251e+18,319.969,4490.18,41795,306,198,40450,40450,40370,40309,39610
49188,973,1870,0,49188,11773,37415,7.14343e+15,209.757,4806.29,49188,387,161,47318,47314,46939,47317,38987
19844,160,1351,17587,2257,0,19844,3.94179e+18,203.678,2861.53,19844,194,151,18026,16840,15939,16291,4191
37670,1,10,37402,268,37670,0,1.00552e+14,9.63186,379.665,37670,10,10,20141,20141,20141,20141,20141
31955,738,2282,31955,0,29697,2258,3.98464e+18,516.658,4853.14,31955,800,152,29660,28790,21726,24784,13714
29117,1510,1696,25893,3224,25893,3224,3.26309e+18,341.288,4507.23,29117,364,196,27421,27416,27368,27330,26157
705,64,108,0,705,0,705,4.05576e+18,38.2681,222.737,705,37,37,597,593,546,518,439
40979,6,10,40708,271,40979,0,1.01781e+14,9.47458,396.31,40979,10,10,40774,40571,38715,38690,36132
19491,241,405,19491,0,19491,0,3.37555e+18,319.717,1418.82,19491,154,157,18594,17752,17522,17649,12496
49355,5,13,49025,330,49355,0,1.0229e+14,11.0306,435.15,49355,13,12,49044,48830,46560,46085,40535
28749,1114,1682,22975,5774,22975,5774,5.74448e+18,253.333,4275.65,28749,267,181,27067,27059,25973,24836,14886
14355,10,11,13661,694,14355,0,9.63159e+13,9.98683,267.641,14355,11,11,14341,14338,14092,14092,14339
39183,77,667,39183,0,39183,0,4.05984e+18,293.194,3208.23,39183,211,180,36364,33781,24278,22766,7198
34022,753,796,0,34022,7489,26533,4.87754e+15,428.455,3020.18,34022,288,183,33226,33212,33225,33225,33089
15026,300,1073,13245,1781,13245,1781,1.70026e+18,310.854,2631.95,15026,240,128,13540,12057,11068,12141,9692
17482,1,10,17384,98,17482,0,1.02369e+14,8.37496,258.823,17482,10,10,9205,9205,9205,9205,9205
8415,55,266,8415,0,8415,0,3.82172e+18,184.404,1046.59,8415,94,109,7361,6824,4487,3871,2119
41140,362,871,36123,5017,0,41140,3.87442e+18,334.553,3945.82,41140,315,207,40100,39181,37407,37710,18593
8223,445,547,8223,0,7196,1027,7.95431e+17,348.554,1595.97,8223,233,106,7655,6703,7350,6533,7346
7154,587,744,6659,495,0,7154,2.46376e+18,111.236,1553.63,7154,146,86,6410,6410,6367,6390,6097
35829,24,43,0,35829,35795,34,1.35673e+16,9.77479,730.054,35829,19,12,35786,35786,34886,35092,29841
43368,46,1800,0,43368,0,43368,1.21251e+18,693.961,5351.98,43368,445,271,32913,26962,26231,23706,6238
24259,190,675,24259,0,18275,5984,8.02898e+17,322.711,2306.57,24259,197,155,22915,22261,18851,18912,7086
42814,46,71,0,42814,42262,552,2.51143e+16,45.919,960.384,42814,38,42,42727,42649,41112,41434,34289
41418,1717,7441,0,41418,0,41418,7.41439e+17,14.0644,8256.94,41418,1028,26,33977,33977,27065,27817,9807
49592,170,490,49592,0,49592,0,5.03873e+18,317.589,3020.28,49592,212,178,48084,46588,35081,32328,24103
19761,5,12,19518,243,19761,0,1.00947e+14,10.6642,270.664,19761,10,11,19597,19485,18614,18540,13097
3921,174,425,3921,0,3723,198,2.40816e+18,105.423,824.469,3921,141,59,3496,3405,3243,3466,2587
45720,2003,2402,42436,3284,0,45720,2.68781e+18,466.919,6505.3,45720,679,141,43318,43318,43185,43272,36410
44644,446,2083,44644,0,39447,5197,1.21081e+18,369.742,5842.88,44644,413,238,42376,40906,38066,35252,17279
6505,167,833,6505,0,6056,449,9.84264e+17,126.161,1610.92,6505,131,139,5646,5284,4487,3682,982
15652,357,537,13508,2144,15652,0,3.5812e+18,275.028,1926.53,15652,232,112,15097,14890,14266,13744,12276
20717,16,19,20453,264,20714,3,9.77289e+13,15.0518,324.293,20717,17,17,20694,20678,20539,20539,20552
2696,34,207,596,2100,0,2696,1.74344e+13,65.9432,526.223,2696,74,49,2221,1874,1914,1710,814
11551,145,907,10805,746,0,11551,2.31926e+18,147.378,2037.52,11551,219,100,10485,9727,9438,9451,4146
739,14,91,0,739,190,549,6.53454e+15,39.3924,215.705,739,47,29,572,481,492,334,188
2051,13,177,489,1562,0,2051,1.63302e+13,74.0034,438.98,2051,70,40,1412,1217,1058,576,366
42394,1429,1509,7545,34849,0,42394,2.11888e+13,377.591,4858.1,42394,563,108,40885,40885,40876,39396,38917
27195,3,10,27098,97,27131,64,1.04952e+14,7.81688,307.919,27195,9,10,26213,25698,23896,25125,20300
16127,1016,1017,15000,1127,0,16127,2.54323e+18,443.29,2640.34,16127,273,167,15110,15110,15110,15110,15109
25222,863,1463,22834,2388,0,25222,3.34813e+18,329.705,3883.73,25222,318,185,23759,23722,22713,22232,18466
11662,513,962,10935,727,0,11662,2.28873e+18,379.956,2243.38,11662,243,162,10700,10326,10104,10133,7166
15248,774,788,14197,1051,0,15248,2.52523e+18,327.134,2155.68,15248,170,159,14460,14460,14460,14457,14368
42641,22,36,0,42641,40634,2007,2.4652e+16,29.3587,678.84,42641,31,31,42525,42395,39261,40787,35786
12120,5,8,11932,188,12120,0,1.14843e+14,5.20074,191.871,12120,7,7,12104,12091,11909,11909,11723
43027,12,46,0,43027,42716,311,2.56364e+16,38.7904,737.076,43027,35,35,42511,41914,40432,39665,27432
3319,286,423,652,2667,0,3319,1.98482e+13,104.205,899.664,3319,114,78,2896,2835,2792,2827,2337
23155,1221,2218,21306,1849,21306,1849,1.21264e+18,330.951,4538.51,23155,504,205,20937,20929,19664,20034,10518
36029,1791,1891,0,36029,0,36029,1.5468e+18,396.704,5068.14,36029,574,156,34138,34138,34120,34117,33737
3543,14,274,2659,884,0,3543,8.40833e+18,60.0669,640.059,3543,77,63,1973,1299,1228,1241,470
27152,43,89,0,27152,26685,467,2.01906e+16,29.8846,821.847,27152,38,32,27063,27049,26749,26698,17613
34302,361,917,25888,8414,25888,8414,3.77925e+18,365.777,2964.77,34302,208,174,33242,32050,32082,32082,12746
26871,889,1171,23595,3276,0,26871,3.95611e+18,306.055,3493.05,26871,264,163,25700,25700,25482,25507,23094
8491,524,861,0,8491,0,8491,1.57719e+18,168.383,1789.34,8491,228,80,7630,7596,7443,7420,5450
45540,638,1574,0,45540,10342,35198,6.98385e+15,250.268,4623.21,45540,421,165,43966,43934,43286,43705,30624
39369,273,929,0,39369,9055,30314,5.8168e+15,306.824,3589.53,39369,378,143,38300,37906,35196,35211,16603
12584,329,540,11080,1504,11080,1504,3.22478e+18,262.721,1891.54,12584,200,136,11992,11747,11181,11144,8719
43220,372,980,0,43220,10355,32865,6.75976e+15,225.251,3861.17,43220,376,148,42240,42169,37450,38133,18419
12357,653,1185,11503,854,11503,854,2.16183e+18,227.369,2497.97,12357,330,107,11172,11019,10766,10626,7898
3952,192,347,3952,0,3952,0,3.07651e+18,116.817,911.912,3952,104,74,3605,3550,3234,3136,2178
5024,423,496,4604,420,0,5024,2.97394e+18,201.606,1208.07,5024,199,85,4528,4516,4528,4528,4215
13246,1087,1101,0,13246,2969,10277,6.78936e+15,101.103,2353.39,13246,248,153,12145,12145,12145,12145,12097
18645,6,9,18578,67,18581,64,1.048e+14,6.71515,254.42,18645,8,8,18618,18593,17882,17881,15538
15021,53,972,14080,941,14080,941,5.97927e+17,300.12,2438.76,15021,216,166,11659,9490,8531,8834,3543
7510,228,730,7040,470,0,7510,2.28477e+18,130.491,1560.62,7510,150,137,6780,6736,6377,6307,1317
25201,330,584,0,25201,0,25201,7.82706e+17,369.528,2586.51,25201,228,156,24418,22606,22368,22683,21630
13700,273,571,13700,0,10296,3404,8.29732e+17,244.49,1657.59,13700,148,128,13039,12646,12308,11261,8409
31656,367,1181,28053,3603,28053,3603,9.15739e+17,326.571,3135.03,31656,149,269,30372,29570,28963,28087,14694
9128,671,940,9128,0,8551,577,9.43808e+17,143.805,1981.87,9128,154,141,8188,8186,7687,7815,5862
23056,4,9,22636,420,20312,2744,7.57162e+13,6.19427,264.976,23056,9,7,22983,22951,21794,21790,18878
16493,72,1084,16493,0,15387,1106,1.04371e+18,310.273,2631.4,16493,311,167,13446,11378,10026,10332,4078
7392,3,7,7329,63,7392,0,1.03497e+14,6.66964,158.707,7392,7,7,7079,6915,6870,6848,5232
6444,94,382,0,6444,1707,4737,1.24407e+16,50.3054,1021.31,6444,111,75,6062,6044,4690,5109,1669
11403,5,47,0,11403,11348,55,2.17886e+16,18.0113,371.414,11403,22,17,11287,11239,9625,9894,6835
47649,321,2415,44090,3559,44089,3560,1.29368e+18,532.063,6610.53,47649,826,154,44135,43026,39715,41836,10490
16440,1623,1670,14877,1563,0,16440,3.00737e+18,241.384,3492.8,16440,358,181,14770,14770,14770,14770,14599
20640,759,809,5071,15569,0,20640,2.97605e+13,204.886,2407.02,20640,219,99,19831,19831,19820,19825,19072
13104,309,417,13104,0,13104,0,3.57906e+18,231.509,1732.23,13104,163,108,12661,12501,12187,11630,10606
32421,1079,1556,28896,3525,0,32421,3.81947e+18,267.947,3767.17,32421,239,161,30865,30865,30864,30865,29486
40205,115,1535,40205,0,37528,2677,9.14419e+17,624.134,4793.92,40205,390,224,34900,30771,25587,27413,7926
19896,101,370,19896,0,19896,0,3.86642e+18,214.735,1719.8,19896,120,163,18599,17610,12513,11409,6854
13364,213,407,13364,0,13364,0,5.02652e+18,245.368,1570.69,13364,150,108,12849,12558,11360,10745,9085
37563,555,1112,0,37563,8127,29436,4.88205e+15,358.482,3739.33,37563,307,212,36451,36223,34438,34148,18261
45116,4,12,44874,242,45116,0,8.33148e+13,6.65606,425.076,45116,8,9,44120,43459,38386,38436,34732
40863,299,850,30810,10053,30810,10053,3.79255e+18,388.601,3096.97,40863,228,193,39462,37905,37853,37614,20242
6382,746,1231,6382,0,6230,152,5.02895e+17,14.9088,1468.83,6382,164,23,5151,5151,4793,5151,3222
4588,278,505,4202,386,4202,386,2.63187e+18,112.032,1067.62,4588,228,51,4083,4034,3877,3934,2258
41705,65,2376,0,41705,0,41705,1.7378e+18,261.092,5600.07,41705,415,234,35762,33718,31193,19849,3587
24507,360,983,21594,2913,0,24507,3.59183e+18,304.583,3296.24,24507,352,168,23479,22702,19595,20147,10531
42177,1108,2585,38149,4028,38149,4028,2.87816e+18,408.937,6264.73,42177,596,260,39592,39452,38212,36593,18902
18490,23,60,0,18490,18370,120,2.64536e+16,46.5465,599.099,18490,31,32,18379,18351,17421,16680,11483
34786,182,1511,27129,7657,27129,7657,6.27265e+18,281.782,4168.86,34786,232,200,32635,31875,22370,17025,2220
10952,435,787,2130,8822,0,10952,2.48665e+13,80.0361,1873.82,10952,262,65,10165,10165,9872,9799,6452
30490,502,1184,0,30490,6688,23802,4.71726e+15,320.817,3638.46,30490,292,173,29306,28761,28303,28293,20721
20514,430,956,0,20514,3642,16872,4.72883e+15,174.376,2628.95,20514,314,99,19558,19456,19063,19078,11215
14522,277,609,3776,10746,0,14522,2.12052e+13,153.08,1671.34,14522,243,66,13913,13759,13409,13092,7728
26578,1165,1306,6616,19962,0,26578,3.02558e+13,168.608,3042.81,26578,184,170,25272,25272,25272,25258,24482
8611,194,360,8611,0,8611,0,3.24959e+18,145.564,1114.95,8611,115,96,8239,8095,7505,7473,5454
3406,361,578,0,3406,0,3406,1.26206e+18,66.7082,1055.61,3406,121,54,2828,2828,2772,2738,2296
34040,1912,2265,0,34040,0,34040,1.58845e+18,392.085,5384.82,34040,543,217,31775,31771,31604,30959,29015
27338,116,713,23996,3342,23996,3342,3.26424e+18,313.785,3045.64,27338,267,179,24561,20682,19897,17397,6646
14951,1317,1469,13848,1103,13848,1103,2.33928e+18,153.615,2754.24,14951,365,188,13482,13482,13482,13482,12926
6066,67,478,1293,4773,0,6066,1.84223e+13,77.3897,1160.42,6066,106,114,5465,5052,4794,4853,1548
36717,7,18,34968,1749,36717,0,9.64245e+13,10.4971,451.144,36717,11,11,36451,36223,33190,33162,32351
7873,542,1509,1127,6746,0,7873,7.00636e+12,9.96863,1733.72,7873,198,18,6364,6364,5399,3287,3243
34143,114,2086,30873,3270,0,34143,3.50837e+18,256.297,5092.21,34143,487,156,30649,28506,27399,26855,5281
769,79,95,578,191,578,191,7.0388e+18,51.6801,226.364,769,35,43,674,657,670,669,628
7445,208,474,6523,922,0,7445,3.96738e+18,183.799,1399.77,7445,164,104,6926,6735,5779,5833,3666
6345,353,480,6345,0,4795,1550,8.76382e+17,156.899,1104.87,6345,113,97,5865,5745,5712,5458,5068
38535,2,66,0,38535,38255,280,2.51674e+16,52.8824,873.164,38535,40,40,26937,23826,20617,20058,15247
38184,782,1737,38184,0,34408,3776,7.60233e+17,492.706,4966.64,38184,431,175,36447,36041,34348,28155,24180
46111,21,68,0,46111,45926,185,2.75223e+16,28.2338,822.054,46111,30,32,46012,45960,44983,45172,35894
35927,372,1106,31604,4323,0,35927,3.60154e+18,344.168,4180.78,35927,374,187,34641,33086,29887,30691,15453
16846,176,602,12706,4140,12706,4140,6.97575e+18,275.534,1778.77,16846,151,136,15909,15525,13300,11386,5562
1027,133,174,0,1027,0,1027,2.2992e+18,35.554,335.919,1027,102,36,853,844,853,834,638
1586,126,174,1189,397,0,1586,8.46071e+18,51.4502,389.546,1586,50,51,1412,1412,1402,1411,1182
11558,906,1027,10728,830,10728,830,7.59432e+17,416.702,2338.89,11558,208,171,10531,10349,10491,10510,10107
10290,282,306,10290,0,10290,0,4.75021e+18,190.859,1223.2,10290,139,102,9984,9949,9880,9866,9673
11589,361,391,3214,8375,0,11589,6.31148e+13,149.241,1160.39,11589,96,88,11198,11194,11181,11173,10935
46200,1722,3395,45895,305,0,46200,7.04656e+18,91.0759,6496.31,46200,514,79,42805,42804,40724,37443,25502
29584,1056,1212,27686,1898,27686,1898,6.03294e+17,527.354,3622.37,29584,324,200,28372,28214,28193,28105,27347
29902,343,1141,6901,23001,0,29902,2.424e+13,291.946,3297.37,29902,394,133,28757,28460,26215,21047,10888
886,69,144,861,25,861,25,3.92145e+18,6.74266,247.791,886,74,28,742,742,718,709,696
18420,494,1817,16715,1705,16715,1705,2.51954e+18,243.876,3794.18,18420,402,197,16603,16204,15899,13993,5889
45849,5,12,45592,257,45849,0,8.35667e+13,6.65986,428.955,45849,8,9,45226,44470,39060,39078,37369
16912,616,1458,16912,0,14099,2813,2.6282e+18,15.7178,2540.87,16912,534,27,15454,15454,15454,15454,5841
47800,3,14,47442,358,47800,0,9.99061e+13,11.6881,431.589,47800,13,13,46045,45121,42674,43887,32423
6140,39,838,5724,416,5724,416,7.09447e+17,179.192,1645.29,6140,184,117,4451,3434,2996,3258,1154
23895,25,1089,4925,18970,0,23895,2.19824e+13,182.296,3099.81,23895,371,92,20910,19944,18117,8111,3352
28381,508,1204,0,28381,6029,22352,6.03019e+15,285.025,3434.52,28381,444,92,27139,26808,25697,23554,12057
30415,308,1635,26734,3681,0,30415,4.41422e+18,298.401,3420.4,30415,313,282,28569,27766,23644,22743,2397
9894,323,643,8765,1129,8765,1129,1.65771e+18,300.377,1848.93,9894,195,123,9134,8887,8638,8517,4762
42329,310,1597,38144,4185,38144,4185,1.37161e+18,666.168,5186.15,42329,504,196,38826,33837,32179,33460,17894
39952,152,1257,37273,2679,37273,2679,2.05962e+18,657.303,4299.08,39952,361,231,35932,33957,30765,31439,12979
38858,4,13,38528,330,38748,110,9.71379e+13,8.31834,458.215,38858,11,10,38486,38330,33972,36322,26678
30459,54,718,22942,7517,0,30459,8.2933e+18,332.629,2447.72,30459,190,157,27667,24037,19017,19833,5034
49942,4,10,49583,359,49942,0,1.00586e+14,9.66395,436.89,49942,10,10,49387,49188,43416,45876,33061
36701,912,2099,0,36701,0,36701,3.74055e+18,297.625,4786.93,36701,377,218,34602,34556,33761,29899,27366
45639,1156,2020,40160,5479,40160,5479,1.73509e+18,380.907,5765.55,45639,371,283,43619,43597,42841,42923,39845
18112,6,10,17978,134,18112,0,9.9741e+13,9.25734,262.858,18112,10,10,18020,17936,17077,17064,13950
21998,1238,1965,20030,1968,20030,1968,2.49942e+18,248.074,4180.33,21998,469,202,20033,20033,19679,19810,13121
12561,341,597,9460,3101,9460,3101,3.8198e+18,246.395,1637.74,12561,152,123,11964,11532,11733,11699,7906
6228,192,391,6228,0,6228,0,3.52886e+18,151.876,1181.91,6228,117,84,5813,5669,5208,4649,4192
34885,90,993,8099,26786,0,34885,2.88589e+13,221.055,3239.34,34885,241,133,32921,30946,26951,13847,7611
22977,249,1850,0,22977,0,22977,1.92677e+18,204.149,3775.96,22977,405,182,20953,20554,18555,9258,3929
44295,302,2410,44295,0,40469,3826,9.98428e+17,394.061,6364.91,44295,778,155,41017,40003,36200,31161,9981
12946,40,42,0,12946,12659,287,1.84625e+16,21.0199,396.247,12946,22,22,12904,12904,12903,12903,12896
26675,145,1142,24237,2438,0,26675,2.81614e+18,402.735,3539.35,26675,371,159,23249,21050,20743,21145,5426
40732,181,1416,0,40732,0,40732,1.91192e+18,337.062,4555.43,40732,307,184,37698,36237,31090,13276,10306
40211,626,929,0,40211,9006,31205,4.77214e+15,513.673,3546.51,40211,375,184,39260,38394,38126,38191,32968
21144,805,833,4664,16480,0,21144,2.20853e+13,220.233,2631.2,21144,362,111,20311,20309,20299,20310,19875
18795,9,13,18655,140,18795,0,9.87972e+13,10.473,270.328,18795,11,10,18774,18770,18218,18218,17954
23006,158,599,23006,0,23006,0,4.11458e+18,248.453,2459.65,23006,192,151,22018,21482,16783,16462,8027
14904,157,583,0,14904,0,14904,8.01005e+17,299.226,2022.48,14904,196,121,13128,11760,11768,11456,9140
1885,176,201,1412,473,1412,473,7.16046e+18,51.3512,436.311,1885,55,52,1684,1684,1684,1684,1577
29247,145,730,6444,22803,0,29247,1.90743e+13,378.015,2705.99,29247,222,169,27557,26959,25413,24244,5606
40727,13,49,0,40727,40596,131,2.61146e+16,30.6861,699.651,40727,26,26,40548,40401,37791,38331,22712
1973,105,177,1973,0,1973,0,3.37506e+18,59.2352,437.88,1973,56,59,1796,1781,1702,1692,1300
45391,68,95,0,45391,45070,321,2.54919e+16,55.5973,1092.99,45391,46,44,45296,45286,43783,41775,32268
47575,84,87,0,47575,47030,545,2.11258e+16,25.0362,1103.13,47575,33,38,47488,47488,47144,47100,47086
39121,35,76,0,39121,38727,394,2.18949e+16,24.4413,855.54,39121,33,34,39045,39038,34627,36347,26264
45772,458,1665,0,45772,0,45772,1.65244e+18,581.081,5185.87,45772,624,193,43518,42306,38022,31164,19190
47279,2059,2513,43333,3946,0,47279,3.09115e+18,438.968,6697.46,47279,599,185,44766,44766,44147,44150,40112
26228,722,1684,26228,0,23706,2522,1.65274e+18,226.667,3922,26228,255,223,24544,24469,23407,23740,17206
43152,4,11,42883,269,43152,0,1.06036e+14,8.91898,407.079,43152,10,10,42741,42562,38296,39886,34220
16599,397,590,0,16599,0,16599,4.13476e+18,268.718,1758.47,16599,154,119,16009,15560,15764,15685,12284
19882,377,1006,19882,0,17485,2397,8.77086e+17,357.805,3071.09,19882,332,138,18571,16790,16021,13648,8831
43348,112,518,43348,0,43348,0,3.34248e+18,438.68,2718.4,43348,517,46,39542,38209,27197,28692,11722
18240,29,900,17030,1210,0,18240,2.42766e+18,390.73,2539.44,18240,243,158,12657,9875,9107,8929,2075
47502,1907,4210,34947,12555,34947,12555,2.19784e+18,23.0436,5165.05,47502,1411,1405,43292,43292,40993,38694,39996
10535,528,618,2195,8340,0,10535,2.20693e+13,166.898,1738.83,10535,289,83,9917,9916,9907,9917,9662
9950,3,7,9901,49,9950,0,1.12675e+14,6.80754,184.621,9950,7,7,9539,9342,9262,9256,6804
9562,138,443,8514,1048,0,9562,2.94101e+18,301.942,1547.99,9562,236,106,8132,7334,7344,7533,4584
46676,1225,1435,43566,3110,0,46676,2.45219e+18,598.01,4783.39,46676,411,260,45241,45010,44902,44909,42162
2971,122,269,0,2971,0,2971,1.11753e+18,107.229,663.176,2971,84,65,2675,2420,2488,2489,1786
32088,300,2081,29306,2782,29302,2786,1.4294e+18,361.391,5076.6,32088,721,169,29426,28872,26609,27792,7240
16797,991,2684,0,16797,1069,15728,1.25202e+14,12.2444,3918.1,16797,549,18,14113,14113,11757,5560,6628
7714,334,501,0,7714,1542,6172,5.24049e+15,154.755,1399.56,7714,280,74,7213,7199,7144,7213,6206
10287,11,32,0,10287,9785,502,2.47058e+16,22.1187,326.937,10287,22,21,10124,9843,8369,9088,6567
12177,821,1049,11350,827,11350,827,7.66808e+17,453.201,2439.2,12177,216,166,11128,10842,10976,11022,9784
32758,481,752,9090,23668,0,32758,6.24418e+13,231.178,2340.48,32758,189,136,32006,31986,31825,31380,29242
8214,35,328,2277,5937,0,8214,6.33625e+13,111.455,928.151,8214,79,75,7656,7328,6530,4682,2077
1932,124,181,1932,0,1932,0,4.62228e+18,70.6097,468.053,1932,59,51,1751,1735,1720,1735,1563
46217,788,2695,42813,3404,0,46217,2.76229e+18,709.467,6595.16,46217,750,228,43157,42120,41338,40636,13083
11637,494,559,0,11637,0,11637,1.87801e+18,266.913,1859.25,11637,200,128,11078,11077,11018,11059,10327
16819,341,1259,14979,1840,14979,1840,3.36344e+18,169.586,2696.15,16819,348,122,15560,15380,13712,11114,5771
42795,653,1747,0,42795,8886,33909,6.05347e+15,344.966,5065.13,42795,574,154,41048,40897,39072,27392,22384
6278,436,906,0,6278,0,6278,2.38869e+18,72.6711,1432.69,6278,242,84,5372,5371,4990,4475,2109
18273,225,517,15760,2513,18273,0,3.41026e+18,295.943,2014.7,18273,258,123,17520,16926,14895,13632,10250
40723,324,727,40717,6,40723,0,4.17696e+18,305.799,3302.48,40723,216,152,39942,39422,33036,32945,24642
8910,261,385,2500,6410,0,8910,6.17929e+13,96.3742,1019.91,8910,73,86,8525,8515,8447,8507,7296
31287,25,65,0,31287,31059,228,2.61312e+16,47.2332,781.329,31287,39,38,31117,31066,29874,28759,24099
32762,35,68,0,32762,32520,242,2.50933e+16,52.9413,812.96,32762,40,39,32621,32538,31455,31484,26087
22601,81,94,0,22601,22526,75,2.01052e+16,27.1853,783.837,22601,38,31,22507,22507,22501,22505,20889
49521,746,1436,0,49521,0,49521,1.48854e+18,616.169,5285.89,49521,521,196,47921,47248,46271,45705,28441
15871,120,1128,14447,1424,14447,1424,2.38813e+18,341.828,2852.49,15871,387,118,13565,12422,11842,10746,2815
35896,3,60,0,35896,35642,254,2.60922e+16,37.7043,704.674,35896,33,34,32873,31452,27016,27868,18078
22963,4,8,22775,188,22963,0,1.05723e+14,7.63289,279.877,22963,8,8,22874,22846,21695,21637,16502
48413,776,1380,45194,3219,45194,3219,6.3656e+17,746.614,4863.69,48413,436,252,46619,44717,45471,45228,40466
14312,789,965,13383,929,13383,929,6.3375e+17,268.628,2372.19,14312,191,167,13347,13159,13227,13184,12104
36039,531,1254,0,36039,0,36039,1.23104e+18,651.281,4056.37,36039,379,218,34223,32802,32607,28871,19425
25202,1116,1206,22215,2987,22215,2987,1.62848e+18,348.502,3710.72,25202,338,171,23996,23996,23947,23938,22373
47663,1304,1766,0,47663,10836,36827,6.93763e+15,267.215,4866.77,47663,372,197,45897,45893,45726,45897,38126
48364,1844,2724,43798,4566,0,48364,3.47484e+18,362.418,6680.02,48364,597,283,45640,45640,43101,43150,32552
21117,349,836,18636,2481,18636,2481,2.73526e+18,306.35,2890.86,21117,285,163,20084,18530,18219,17433,14826
18126,379,536,5056,13070,0,18126,6.2645e+13,162.861,1581.45,18126,102,115,17590,17570,17403,17523,15385
9354,197,927,0,9354,0,9354,1.49691e+18,111.344,1877.64,9354,367,77,8427,8414,7580,6392,3457
12729,1523,1627,11390,1339,11390,1339,1.12821e+18,134.534,2984.1,12729,345,162,11102,11102,11102,11102,10958
38917,2513,2885,38763,154,38672,245,3.31637e+18,91.573,5553.32,38917,481,77,36032,36032,35691,36022,32251
12192,367,738,10852,1340,0,12192,4.02074e+18,154.445,1696.76,12192,102,123,11454,11411,10844,10878,6406
41139,1145,1340,0,41139,9986,31153,9.32368e+15,259.839,4418.18,41139,312,185,39799,39794,39572,39612,36536
28146,167,584,26936,1210,26936,1210,1.36936e+18,367.867,2733.41,28146,236,167,25131,22371,22377,23257,11612
43469,26,514,43469,0,43469,0,5.12295e+18,317.615,2852.92,43469,214,170,32937,25901,19583,16222,6136
6439,3,31,0,6439,6124,315,2.48102e+16,17.2654,254.944,6439,19,20,5482,5203,4072,4233,2888
47721,275,1417,44539,3182,0,47721,2.41812e+18,725.37,4861.42,47721,417,237,43898,42645,40265,40403,19784
3317,1,10,3283,34,3317,0,9.31745e+13,5.84383,109.517,3317,9,8,1912,1912,1912,1912,1912
22868,292,572,6387,16481,0,22868,6.31208e+13,191.215,1797.78,22868,124,118,22296,22149,21603,21749,15170
46899,505,662,46899,0,46899,0,3.98482e+18,309.464,3473.09,46899,210,184,46237,46163,43829,42677,38740
27281,26,458,27281,0,27281,0,3.32423e+18,279.022,2106.26,27281,158,131,18422,10362,11143,10365,2285
3502,32,57,0,3502,3470,32,2.34568e+16,21.0508,265.939,3502,24,23,3445,3431,3359,3387,3025
44809,871,1377,0,44809,0,44809,1.21077e+18,725.108,4660.35,44809,439,244,43398,42442,41791,37558,33825
31184,31,41,0,31184,30839,345,2.71834e+16,21.6197,556.321,31184,26,21,31143,31134,31116,31101,30068
6196,125,471,5444,752,0,6196,3.904e+18,150.48,1285.15,6196,161,91,5515,4766,4460,4658,1989
25085,5,10,24906,179,25085,0,1.00595e+14,9.37907,309.44,25085,10,10,24897,24813,23092,23632,16393
4851,152,265,1261,3590,0,4851,2.37319e+13,163.504,840.882,4851,173,59,4439,4122,4246,4143,3159
49000,255,1051,0,49000,11115,37885,5.72056e+15,409.49,4169.2,49000,448,150,47534,46764,44425,43689,22138
6541,29,41,0,6541,6499,42,2.80365e+16,20.7688,314.444,6541,24,25,6500,6500,6275,6348,5580
24287,26,1196,24287,0,22679,1608,9.57802e+17,623.91,3427.66,24287,347,193,16307,12958,9865,6856,2483
42715,1353,2062,39413,3302,39413,3302,2.4294e+18,470.465,5831.44,42715,555,136,40653,40491,39740,38519,27491
2378,151,264,2132,246,0,2378,3.78442e+18,71.2069,535.6,2378,59,64,2114,2055,2013,1993,1581
28510,882,1774,26494,2016,0,28510,2.64809e+18,427.981,4082.12,28510,690,119,26736,26107,26190,25982,16365
40971,1705,2363,0,40971,0,40971,1.76315e+18,308.432,5737.88,40971,534,241,38608,38608,36629,37251,27890
49240,1585,1739,0,49240,9741,39499,5.2746e+15,354.848,5516.78,49240,525,112,47501,47501,47426,47501,46025
16673,8,55,0,16673,16229,444,2.25037e+16,17.123,552.306,16673,21,22,16504,16414,15430,15444,9167
17606,5,12,17547,59,16682,924,8.12165e+13,6.80813,273.66,17606,10,8,17382,17163,15361,15550,15077
8966,188,415,0,8966,2136,6830,6.76711e+15,194.473,1390.4,8966,215,96,8356,7713,7948,8085,3305
31928,230,1632,29751,2177,29751,2177,6.89567e+17,457.462,4531.06,31928,299,264,29280,28442,26671,26796,9199
18341,421,682,0,18341,4767,13574,7.56632e+15,163.245,1845.19,18341,101,127,17659,17628,17140,17209,13488
12057,2,9,12023,34,12057,0,1.13622e+14,7.1395,205.371,12057,8,8,10640,10472,9191,9993,7837
39497,756,1333,34702,4795,0,39497,3.90204e+18,305.301,4393.45,39497,294,184,38164,38164,37201,37266,32911
717,83,186,677,40,677,40,5.17018e+17,44.1353,301.765,717,45,34,531,492,464,480,291
2182,244,323,1980,202,1980,202,1.61093e+18,53.7456,602.329,2182,65,55,1859,1859,1789,1858,1766
2369,10,167,0,2369,0,2369,2.85902e+16,14.7104,388.864,2369,84,15,1754,1147,425,1368,204
23464,62,668,20608,2856,20608,2856,3.27536e+18,306.646,2751.54,23464,240,160,18991,16081,15745,13599,3224
35909,942,1584,32040,3869,32040,3869,2.72563e+18,339.251,4727.12,35909,392,175,34325,34286,31837,30798,19509
32984,18,48,0,32984,32871,113,2.70413e+16,26.4791,630.849,32984,25,26,32897,32780,32246,32216,23766
35146,593,1681,32802,2344,32802,2344,2.06917e+18,557.609,4798.99,35146,369,222,33138,31666,31621,31101,18973
8565,310,510,8565,0,6455,2110,8.3902e+17,192.905,1304.38,8565,118,112,8051,7810,7705,7182,5491
45452,7,106,0,45452,45296,156,2.07397e+16,36.2849,1005.65,45452,41,36,42210,39369,36865,35404,22018
574,25,151,538,36,0,574,2.29439e+18,41.77,247.009,574,39,32,366,294,256,233,137
36036,783,1577,32228,3808,32228,3808,1.39893e+18,433.393,4704.58,36036,439,168,34459,34221,32574,32182,22450
28306,10,34,0,28306,26969,1337,2.45837e+16,30.0583,550.948,28306,27,29,27701,27028,21919,24620,17015
12919,521,554,12919,0,9723,3196,8.78704e+17,232.217,1588.35,12919,139,125,12365,12355,12322,12261,11977
27408,79,705,20641,6767,0,27408,8.31975e+18,323.042,2351.1,27408,188,147,25406,24603,17267,17900,5544
37585,451,540,37585,0,37585,0,3.2808e+18,321.353,2589.07,37585,195,140,37045,37004,36591,36408,35497
22840,1866,2004,5051,17789,0,22840,6.18576e+12,248.853,3582.12,22840,309,101,20836,20836,20711,20231,20336
618,38,110,0,618,101,517,3.73249e+15,23.3042,203.581,618,52,26,505,476,463,455,301
18132,159,1012,16989,1143,16989,1143,1.9592e+18,290.863,2637.15,18132,273,146,16659,15662,14783,14753,7592
33338,60,1173,0,33338,0,33338,1.17085e+18,593.823,3795.78,33338,340,218,26777,22766,21463,18413,6180
45815,324,2281,0,45815,0,45815,2.4185e+18,478.54,6067.72,45815,581,271,42076,39984,35803,24288,8797
42625,4882,8133,0,42625,0,42625,4.60289e+17,13.9895,8745.84,42625,1027,22,34492,34492,31244,24843,21952
13207,724,812,11924,1283,11924,1283,1.28618e+18,332.665,2363.05,13207,254,151,12395,12395,12362,12367,12036
20231,512,1434,0,20231,0,20231,1.4717e+18,119.322,3363.55,20231,368,128,18797,18796,18127,6892,6303
10461,70,380,0,10461,2913,7548,1.61981e+16,129.723,1086.18,10461,80,83,9919,9743,8648,8732,3406
23098,359,481,23098,0,23098,0,4.93361e+18,295.254,2133.39,23098,183,140,22617,22432,21933,21195,20210
16818,3,9,16428,390,15222,1596,8.49213e+13,5.98347,227.977,16818,9,7,16574,16486,15880,16013,13987
37176,598,2406,33488,3688,0,37176,3.4498e+18,374.418,5684.04,37176,576,244,34733,34430,32803,32349,15323
11747,225,727,2455,9292,0,11747,1.54599e+13,113.666,1640.94,11747,197,72,11020,10932,10854,10523,5433
5022,133,382,4662,360,4662,360,2.22542e+18,128.08,963.106,5022,104,77,4590,4276,4208,4086,2315
1445,170,205,0,1445,261,1184,4.98738e+15,25.2083,416.855,1445,72,40,1240,1240,1239,1240,1031
20007,147,633,17653,2354,17653,2354,3.17873e+18,318.755,2508.49,20007,235,152,18521,16653,14805,12870,5536
30277,790,1129,26873,3404,26873,3404,9.10573e+17,315.631,3062.61,30277,150,258,29148,29112,28962,29087,23350
32804,344,601,32804,0,32804,0,3.38609e+18,298.356,3015.32,32804,204,180,32158,31696,29945,26651,22912
23316,1627,1759,0,23316,0,23316,1.41319e+17,89.6438,3447.98,23316,450,67,21557,21557,21424,21460,20268
2418,302,466,2280,138,0,2418,2.09947e+18,69.4512,822.448,2418,71,91,1952,1951,1927,1926,1161
45593,1,63,0,45593,45266,327,2.58073e+16,47.9836,932.584,45593,40,43,17916,17916,17916,17916,17916
39468,1005,1553,0,39468,9918,29550,7.58541e+15,203.373,3670.18,39468,355,148,37915,37915,35301,35529,23885
12128,989,1407,10848,1280,10848,1280,2.93438e+18,144.959,2788,12128,324,189,10721,10721,10721,10721,7987
43612,2086,2424,40483,3129,0,43612,2.68961e+18,505.012,5921.83,43612,733,145,41188,41188,40905,40897,38044
32543,184,605,31093,1450,0,32543,1.69083e+18,451.835,3001.47,32543,258,174,29344,26022,26094,23833,16893
37006,507,1197,0,37006,0,37006,3.9745e+18,321.369,3666.54,37006,227,209,35809,35661,29365,17506,13447
33616,555,1388,0,33616,0,33616,1.18366e+18,501.703,4113.55,33616,360,233,32053,30897,30898,13685,20419
24988,53,80,0,24988,24471,517,2.11461e+16,21.159,778.299,24988,28,30,24908,24906,24360,24267,23448
41421,14,43,0,41421,41106,315,1.8148e+16,24.0963,778.18,41421,30,27,41239,41033,40082,40401,27032
16827,150,540,0,16827,4686,12141,1.61362e+16,160.284,1544.44,16827,107,108,16211,15808,14778,14650,7229
14851,501,608,13147,1704,0,14851,3.71651e+18,316.359,2128.39,14851,227,140,14243,14243,14137,14162,12666
48829,2063,2176,43658,5171,43658,5171,3.25502e+18,305.544,5257.39,48829,538,185,46653,46653,46653,46653,46472
28756,28,34,0,28756,28715,41,1.06399e+16,6.49405,585.257,28756,20,12,28722,28722,28710,28707,24983
35212,882,2264,31609,3603,0,35212,3.75478e+18,261.812,5201.02,35212,480,244,32948,32937,29809,29172,11745
9688,206,544,0,9688,0,9688,1.81494e+18,276.529,1682.1,9688,185,117,8957,8595,7362,5250,3561
5572,7,338,5572,0,5572,0,3.13769e+18,105.06,897.421,5572,104,81,2277,1543,1363,1171,245
779,69,78,200,579,0,779,2.87237e+13,24.4698,183.236,779,28,27,701,701,695,697,670
14972,442,733,0,14972,0,14972,1.94163e+18,221.059,1854.46,14972,111,126,14239,14200,13535,13479,9143
37926,356,2398,34261,3665,34261,3665,2.91143e+18,260.11,5559.98,37926,500,236,35497,34834,32582,29150,12436
29815,867,877,26155,3660,0,29815,3.81705e+18,316.18,3372.73,29815,285,191,28938,28938,28937,28937,28729
49912,931,1986,49912,0,44956,4956,7.72079e+17,718.634,6059.15,49912,574,192,47683,46986,44382,37412,24865
30907,874,1983,28681,2226,28681,2226,2.27133e+18,490.772,4534.47,30907,681,135,28924,28125,28210,28017,17624
29501,844,1145,0,29501,0,29501,1.75093e+18,494.836,3535.12,29501,479,163,28356,27704,27268,27018,24192
20739,155,940,18771,1968,18771,1968,2.37977e+18,315.693,2981.78,20739,367,148,18077,16245,16042,15068,7663
5027,109,322,5027,0,5027,0,3.00601e+18,88.2994,834.107,5027,95,77,4699,4600,3959,3860,2473
35454,415,471,35454,0,35454,0,5.15282e+18,304.334,2526.52,35454,198,158,34983,34964,34724,34565,34232
30776,1495,1582,0,30776,5297,25479,5.73665e+15,305.45,4077.73,30776,419,172,29194,29167,29194,29194,28216
13561,128,603,10228,3333,10228,3333,6.99272e+18,197.549,1616.25,13561,131,127,12700,12401,10550,8940,5177
30782,352,1219,28649,2133,28649,2133,6.8226e+17,640.772,3836.03,30782,339,216,28514,27573,26557,26574,16600
28057,173,1156,0,28057,7282,20775,1.24359e+16,159.401,3415.25,28057,234,131,26811,26251,22249,21129,6030
16909,427,763,16909,0,15598,1311,6.551e+17,296.155,2265.98,16909,375,119,16146,15878,15658,15974,10872
14862,337,714,3778,11084,0,14862,2.74453e+13,398.201,1810.94,14862,433,72,13879,13333,13276,12480,9465
19470,23,624,0,19470,0,19470,4.10111e+18,287.89,1938.89,19470,160,139,12941,7640,8255,4468,1745
18837,36,61,0,18837,18699,138,2.57712e+16,35.6453,596.578,18837,33,34,18759,18730,17949,18113,14294
3454,176,262,3454,0,3454,0,3.50424e+18,76.0657,668.308,3454,82,70,3192,3180,3097,3077,2933
36432,1451,1817,32991,3441,32991,3441,1.34162e+18,795.116,5025.39,36432,567,175,34615,34574,34249,34449,31427
11858,819,940,1920,9938,0,11858,1.97738e+13,166.856,2086.94,11858,329,95,10918,10918,10885,10917,10002
5592,154,386,5012,580,5012,580,8.8982e+17,181.344,982.565,5592,87,93,5041,4685,4785,4783,2515
28659,356,682,0,28659,6426,22233,4.90017e+15,354.41,2524.81,28659,256,157,27759,27143,26757,26753,19336
36995,1263,1823,36995,0,29438,7557,8.62855e+17,308.938,5040.43,36995,390,219,35172,35158,34668,34234,18632
46640,204,883,35107,11533,35107,11533,7.05273e+18,390.735,3215.65,46640,263,174,44506,43049,32893,26246,17209
18649,886,1167,16371,2278,16371,2278,3.78304e+18,238.332,2445.93,18649,203,221,17482,17482,16839,16746,13486
9773,360,596,0,9773,2129,7644,4.61558e+15,187.3,1559.83,9773,156,122,9177,9068,8898,8863,6546
3691,99,447,3691,0,3495,196,5.6167e+17,96.3305,866.83,3691,123,63,3165,2712,2684,1585,1271
12519,172,369,3495,9024,0,12519,6.34064e+13,150.595,1178.82,12519,94,87,12110,11861,11670,11727,7505
25682,256,1417,25682,0,23064,2618,7.95186e+17,467.066,3896.17,25682,405,168,22782,20321,18272,10279,5142
17714,186,1199,16538,1176,0,17714,2.43492e+18,404.754,2953.36,17714,273,181,15955,15479,14264,13935,2620
35747,495,845,31435,4312,0,35747,3.87861e+18,339.91,3632.56,35747,298,200,34902,34889,33666,33857,20873
35778,1316,1723,28737,7041,28737,7041,5.63167e+18,262.796,4723.17,35778,275,189,34055,34049,33281,32882,22562
48560,536,1394,10439,38121,0,48560,1.90125e+13,394.054,4766.92,48560,368,232,47166,46594,45018,43371,27135
6798,81,263,6798,0,6798,0,5.45132e+18,163.531,944.809,6798,113,63,6258,5911,4170,3820,1708
16493,68,586,0,16493,0,16493,4.20051e+18,242.12,1738.44,16493,156,121,15206,14527,9963,6001,3872
45680,120,1408,11244,34436,0,45680,3.44082e+13,292.817,4675.09,45680,340,189,43260,42162,37378,24894,11072
29580,1005,1688,0,29580,0,29580,3.17496e+18,227.88,4407.06,29580,265,179,27892,27883,25195,14581,11529
20008,206,1181,18249,1759,0,20008,2.83568e+18,352.569,3200.21,20008,399,145,17897,16198,16279,16491,5998
31414,379,1332,7970,23444,0,31414,3.62363e+13,403.25,3665.43,31414,476,158,29445,28225,24867,27701,8000
44011,153,469,44011,0,44011,0,5.00041e+18,272.884,2858.39,44011,205,170,42720,41666,31347,29510,20079
16257,338,578,0,16257,0,16257,1.83742e+18,306.817,2212.67,16257,223,143,15597,15224,14688,14639,9209
34289,1255,2504,0,34289,746,33543,5.0568e+14,54.3698,4808.37,34289,466,55,31785,31785,30259,20398,18945
13741,1,10,13636,105,13741,0,7.78406e+13,6.26454,236.604,13741,7,8,8033,8033,8033,8033,8033
4814,63,425,4171,643,4171,643,2.37967e+18,278.073,1110.35,4814,187,89,3673,3448,3071,2772,1590
5504,39,475,5504,0,4832,672,1.15389e+18,135.502,1215.75,5504,140,98,3983,3517,2724,971,1490
37505,2259,2509,34756,2749,34756,2749,2.3117e+18,477.033,5526.02,37505,739,211,34996,34996,34976,34987,32269
45788,116,199,0,45788,45161,627,2.71169e+16,26.4304,1135.81,45788,74,34,45589,45586,44590,43523,24468
44708,1507,2690,0,44708,0,44708,1.71029e+18,409.183,6580.31,44708,629,245,42018,41912,39785,31608,24121
45863,170,495,45709,154,45863,0,4.15228e+18,276.717,3043.24,45863,270,165,44420,41960,33699,31439,17016
4003,73,364,4003,0,3587,416,1.76237e+18,151.043,817.947,4003,77,85,3420,3248,2446,1646,603
42393,1566,2401,42393,0,35214,7179,9.41623e+17,401.615,5837.43,42393,491,294,39992,39992,39007,33430,22531
37370,2137,2828,8295,29075,0,37370,6.23159e+12,287.149,5218.77,37370,385,120,34542,34542,33343,30921,28393
26938,134,1174,25085,1853,25085,1853,2.11037e+18,579.497,3514.36,26938,341,195,23848,22097,20534,20709,8376
30204,587,1679,0,30204,4911,25293,5.63326e+15,320.455,3953.49,30204,475,156,28525,27975,27566,27798,10350
8063,62,546,7152,911,7152,911,1.30795e+18,333.508,1564.94,8063,227,105,6236,5934,4478,5110,1691
41148,824,987,8924,32224,0,41148,1.81822e+13,407.324,3642.49,41148,292,198,40161,39940,39837,39561,37697
26939,44,47,0,26939,26758,181,2.59727e+16,35.6114,562.277,26939,29,30,26892,26892,26891,26892,26883
9326,446,614,2063,7263,0,9326,1.85924e+13,119.445,1558.29,9326,154,94,8712,8699,8592,8600,7710
13039,228,270,13039,0,13039,0,3.0376e+18,110.242,1112.38,13039,114,32,12769,12717,12759,12721,12206
9038,299,366,0,9038,1970,7068,6.90579e+15,184.108,1281.01,9038,156,81,8672,8593,8616,8647,8301
21562,297,992,19131,2431,19131,2431,9.12881e+17,271.88,2487.7,21562,132,198,20468,19949,19209,18662,8523
18561,16,598,4304,14257,0,18561,2.88491e+13,197.495,2076.4,18561,204,111,14606,12661,11768,3700,2250
17543,565,1141,4139,13404,0,17543,2.7902e+13,126.313,2586.21,17543,232,155,16402,16402,16283,16401,13040
16406,5,11,15654,752,16406,0,9.61648e+13,9.25216,284.812,16406,11,11,15862,15786,14498,14333,12500
37431,83,405,0,37431,9736,27695,3.28108e+15,307.161,2532.23,37431,234,141,33650,30770,31763,25257,13240
36984,59,84,0,36984,36319,665,2.052e+16,23.5381,945.999,36984,32,38,36900,36897,36161,36472,35197
40364,1975,2509,37195,3169,37195,3169,2.47413e+18,456.055,5897.38,40364,746,225,37855,37855,37784,37810,31607
9745,3,7,9724,21,9745,0,8.34463e+13,6.93822,192.62,9745,7,7,9322,9230,7817,7914,7810
15189,591,1046,14184,1005,0,15189,2.407e+18,407.342,2589.35,15189,289,151,14143,13698,13544,13457,10282
42330,37,939,37274,5056,0,42330,3.83347e+18,358.834,4077.93,42330,317,195,31833,28183,25057,24863,4366
14410,495,687,12861,1549,0,14410,3.87533e+18,210.982,1893.72,14410,118,130,13723,13717,13316,13367,10533
34390,2096,2129,31857,2533,31857,2533,2.31958e+18,487.236,5036.93,34390,712,142,32261,32261,32258,32261,32086
20878,657,1729,18781,2097,0,20878,3.66109e+18,198.793,3674.35,20878,450,129,19149,19061,17545,17652,7105
20376,18,40,0,20376,20330,46,2.12291e+16,28.261,497.854,20376,31,30,20182,20007,17492,18821,16288
47671,61,65,0,47671,47498,173,2.66216e+16,32.7335,774.012,47671,25,29,47606,47605,47605,47604,47577
25102,122,1122,22521,2581,0,25102,3.81173e+18,541.927,3160.8,25102,469,140,22194,20028,19845,20060,9320
16213,209,1373,2959,13254,0,16213,2.05941e+13,119.251,2611.55,16213,420,148,14840,14622,14143,12806,3701
32869,224,441,32869,0,32869,0,5.04422e+18,248,2512.2,32869,178,146,32240,31713,27952,26343,20578
34287,783,1249,32002,2285,0,34287,2.42756e+18,658.505,3937.3,34287,405,211,32930,31838,31891,31795,23792
32541,1320,2111,4199,28342,0,32541,4.35447e+11,11.8942,4014.57,32541,1058,12,30430,30430,29639,29639,23342
17855,37,923,15853,2002,0,17855,4.10288e+18,209.649,2188.32,17855,118,171,15280,12721,11992,12171,1128
1033,169,305,958,75,0,1033,2.68736e+18,29.9622,454.412,1033,63,34,728,727,709,707,545
12001,532,621,3016,8985,0,12001,3.14204e+13,358.058,1529.43,12001,227,65,11318,10765,11143,10780,10717
30941,166,804,6785,24156,0,30941,1.86494e+13,429.766,3014.14,30941,286,179,29065,28581,26906,22453,13139
1310,249,295,1216,94,1216,94,1.15349e+18,47.6702,484.001,1310,65,36,1015,1005,998,1007,935
10663,67,523,8037,2626,8037,2626,3.79682e+18,208.298,1440.06,10663,131,118,9659,8884,7331,7470,2318
17218,443,444,17218,0,17218,0,3.26523e+18,240.084,1677.46,17218,153,113,16774,16774,16774,16774,16769
40913,224,1432,38215,2698,0,40913,2.42853e+18,586.137,4566.61,40913,368,215,37932,36871,34159,33899,14026
4076,399,471,3788,288,0,4076,2.58381e+18,118.829,975.906,4076,109,91,3605,3605,3591,3590,3268
22678,4,34,0,22678,22629,49,1.72471e+16,15.8896,516.069,22678,24,21,21813,21684,18525,18300,11994
45427,135,814,0,45427,0,45427,4.14917e+18,376.068,3096.12,45427,252,181,42844,41849,29583,15825,12346
49900,583,2066,0,49900,11791,38109,7.38458e+15,313.715,5144.68,49900,364,183,47834,47576,42225,37328,16939
48456,8,12,47787,669,48456,0,9.66599e+13,11.5622,425.663,48456,12,12,48415,48393,46423,46424,42710
10539,175,411,10539,0,10539,0,3.35615e+18,183.202,1519.86,10539,147,105,10024,9851,8609,7515,5639
32991,22,32,32076,915,32987,4,9.9448e+13,9.45522,452.013,32991,18,18,32959,32952,32502,32539,29073
9017,405,439,7879,1138,7879,1138,2.65425e+18,337.86,1536.23,9017,237,109,8569,8032,8526,8549,8436
22784,86,794,4897,17887,0,22784,1.86553e+13,383.366,2591.43,22784,271,157,20913,19746,18224,15189,7464
24550,208,469,24550,0,24550,0,3.15479e+18,257.173,1999.36,24550,165,126,23813,23242,20154,19635,12572
40071,389,754,40067,4,40071,0,4.44188e+18,326.726,3417.19,40071,228,137,39243,39033,31968,32451,22391
31459,980,1713,31459,0,28341,3118,7.61884e+17,400.987,4439.97,31459,403,182,29746,29681,29254,27934,22663
49952,1726,2157,45067,4885,0,49952,3.57027e+18,384.573,5751.1,49952,376,260,47795,47789,47522,47431,41282
28043,1162,1860,0,28043,0,28043,2.35598e+18,448.739,4298.74,28043,478,206,26183,26164,25624,21963,12634
32388,144,498,32388,0,32388,0,5.0877e+18,263.397,2600.9,32388,176,154,31230,30250,21394,19303,11125
11303,1019,1036,9961,1342,0,11303,3.86792e+18,160.182,2100.14,11303,201,131,10267,10267,10267,10267,10251
20271,3,9,19744,527,18451,1820,8.53688e+13,6.09516,249.466,20271,9,7,19993,19893,18964,19234,14576
14844,722,1128,14840,4,0,14844,7.21451e+18,20.7226,2176.87,14844,299,19,13716,13716,13317,12236,9564
42223,415,714,11776,30447,0,42223,6.29921e+13,258.34,2724.68,42223,190,156,41509,41408,40532,40557,29430
41510,13,850,31249,10261,31249,10261,7.04768e+18,364.094,3017.99,41510,239,172,22584,15136,13580,13697,1634
36378,406,610,36378,0,36378,0,4.52598e+18,261.49,3030.1,36378,231,175,35768,35663,34204,33748,29564
5994,469,772,0,5994,0,5994,2.37878e+18,55.9663,1329.29,5994,223,87,5222,5222,4962,4982,2933
41024,133,1241,0,41024,0,41024,1.23747e+18,686.373,4343.1,41024,383,233,36490,33627,30928,28465,11793
5715,386,399,5715,0,5715,0,3.48136e+18,143.672,1135.6,5715,128,77,5316,5316,5316,5315,5314
17080,36,1302,16011,1069,16011,1069,1.98186e+18,217.449,2927.44,17080,458,100,13864,13007,11441,11113,2141
31162,397,2079,0,31162,0,31162,2.54521e+18,404.022,4725.37,31162,498,211,28419,27352,24659,21620,7280
6558,474,503,0,6558,1429,5129,4.15369e+15,120.832,1260.97,6558,165,104,6055,6053,6051,6047,5917
9243,380,703,0,9243,67,9176,1.3321e+14,14.689,1384.96,9243,283,16,8540,8540,8211,5706,5254
44420,401,1657,41542,2878,41542,2878,2.02654e+18,732.795,5092.97,44420,453,259,41742,40278,39460,37298,9718
44167,397,1031,0,44167,9621,34546,4.59752e+15,413.222,3792.87,44167,332,204,42891,41876,41216,40926,28029
46463,1819,1900,46463,0,36962,9501,8.46823e+17,330.059,5564.42,46463,410,226,44563,44562,44563,44555,43560
18995,213,604,14313,4682,14313,4682,7.01585e+18,269.164,1875.48,18995,166,135,18087,17571,16242,14770,10187
8644,355,714,0,8644,0,8644,1.27848e+18,203.489,1623.97,8644,293,72,7930,7716,7663,7495,5465
40628,1048,1329,37971,2657,37971,2657,6.76753e+17,720.134,4453.68,40628,384,237,39299,39231,38877,38677,36219
7942,448,1070,7019,923,0,7942,3.70428e+18,109.572,1944.66,7942,171,136,6872,6871,6869,6870,5031
4411,134,425,3889,522,0,4411,3.52503e+18,233.095,1037.3,4411,185,69,3661,3363,3321,3449,1611
1382,11,15,0,1382,1300,82,2.53403e+16,12.3871,100.537,1382,14,13,1355,1312,1215,1315,1163
17962,390,587,0,17962,0,17962,1.88436e+18,304.913,2343.07,17962,224,160,17372,17021,16604,16727,12011
38612,36,97,0,38612,38111,501,2.07615e+16,28.6205,998.175,38612,39,35,38515,38495,37081,37491,31615
15671,92,1508,0,15671,0,15671,1.65984e+18,197.95,3240.94,15671,365,197,13291,12173,11610,2831,2661
43521,3,4,43482,39,43521,0,2.94922e+12,3.94672,302.597,43521,4,4,43492,43492,43492,43492,43492
21346,140,845,21346,0,19112,2234,1.78391e+18,257.841,2359.15,21346,134,152,19467,17952,16153,18340,5360
23939,192,1619,20086,3853,20086,3853,4.6246e+18,179.827,4052.05,23939,259,153,22199,21785,17343,14764,5666
6940,11,15,6770,170,6940,0,9.30818e+13,7.1866,183.683,6940,11,11,6925,6925,6818,6817,6503
22576,425,453,22576,0,22576,0,3.18518e+18,262.264,1929.92,22576,165,130,22123,22114,22072,22082,21724
45343,28,90,0,45343,43756,1587,2.4583e+16,33.4577,1133.29,45343,44,36,45196,45075,41121,42887,23365
30544,524,1201,0,30544,7260,23284,8.54256e+15,233.864,3767.78,30544,271,173,29343,29284,27171,27370,18072
48736,1677,1872,12083,36653,0,48736,2.77214e+13,266.151,4755.65,48736,475,184,46864,46862,46718,46779,44414
42150,20,34,0,42150,40121,2029,2.46092e+16,31.8421,676.615,42150,30,32,41989,41862,37853,40257,31608
3408,183,189,3408,0,3408,0,5.13499e+18,99.0848,602.703,3408,71,67,3219,3219,3217,3217,3208
12077,191,473,10705,1372,12077,0,3.64857e+18,220.061,1628.98,12077,235,99,11476,11114,9424,8937,6309
36603,1057,1662,33674,2929,0,36603,2.8985e+18,480.048,4834.13,36603,402,208,34941,34910,33996,33770,23308
16679,501,1128,14995,1684,0,16679,3.32861e+18,294.925,2607.31,16679,378,149,15551,15288,13882,14158,10662
30489,32,82,0,30489,29818,671,2.06609e+16,22.836,869.574,30489,32,37,30407,30393,29584,29147,24686
25497,411,605,24317,1180,24317,1180,1.46471e+18,422.679,2655.38,25497,235,168,24784,24333,23415,23209,22971
6630,14,621,6158,472,0,6630,2.6031e+18,147.311,1353.41,6630,140,106,3962,3302,2714,2587,1025
22742,1661,3800,22742,0,22742,0,2.52301e+18,8.49582,4942.81,22742,1900,11,18942,18942,16320,14816,8293
32683,8,34,0,32683,31092,1591,2.46713e+16,28.694,587.487,32683,27,29,31452,30197,23466,28192,17531
37118,45,2146,33038,4080,33035,4083,1.24443e+18,281.091,4863.29,37118,442,261,32301,28579,23674,26317,2623
36070,86,892,0,36070,8541,27529,6.12309e+15,264.636,3408.14,36070,374,146,32220,29947,29142,27690,5601
10415,687,697,9697,718,0,10415,2.52778e+18,252.248,1718,10415,184,125,9718,9718,9713,9718,9675
26504,269,924,26504,0,23350,3154,1.15764e+18,406.488,3371.91,26504,274,176,24835,23879,22768,16822,8171
29307,74,546,0,29307,6692,22615,7.26936e+15,224.244,2560.31,29307,231,132,27351,24734,22558,22393,5902
37884,56,78,0,37884,37642,242,2.15922e+16,22.723,920.482,37884,31,34,37806,37805,37307,37652,30330
37459,42,63,0,37459,37212,247,2.67848e+16,49.1649,847.422,37459,39,40,37350,37269,36388,36508,34658
47956,916,1490,43163,4793,43163,4793,2.53365e+18,609.363,5242.54,47956,477,195,46466,45965,44615,44209,24979
44535,36,1683,11118,33417,0,44535,2.98238e+13,217.95,4055.79,44535,405,163,39858,38371,34064,7084,5130
49625,2282,2802,0,49625,0,49625,1.56814e+18,395.45,7035.45,49625,598,250,46823,46817,46701,46785,40088
1039,54,142,786,253,0,1039,8.12522e+18,41.4466,299.11,1039,42,46,897,772,765,767,493
45908,1,9,45463,445,45844,64,1.02711e+14,7.23588,398.666,45908,8,8,23779,23779,23779,23779,23779
23892,57,1599,23892,0,22076,1816,7.86139e+17,249.827,3978.15,23892,454,139,20334,18922,15073,3874,2418
33418,237,604,33418,0,33418,0,3.40245e+18,293.822,3045.41,33418,217,174,32351,31581,27863,23704,16427
38597,220,1414,34456,4141,0,38597,3.0412e+18,383.775,4654.64,38597,411,205,34824,31239,31010,31594,12011
28274,907,1628,0,28274,6024,22250,6.99064e+15,178.604,3878.96,28274,461,122,26646,26644,25175,25755,19429
40884,191,1034,0,40884,9601,31283,7.60117e+15,231.227,3647.84,40884,257,137,39363,38442,34089,33239,14811
38514,327,3963,38514,0,38240,274,2.69758e+17,14.9097,5835.19,38514,1157,23,34551,34551,33065,26278,9139
21770,585,694,21770,0,16417,5353,8.49844e+17,330.295,2224.92,21770,182,151,21076,21050,20936,20125,19938
26081,7,46,0,26081,26032,49,2.11662e+16,30.1608,576.063,26081,34,34,24096,23094,20016,21291,15304
20058,386,974,18702,1356,0,20058,2.48379e+18,401.549,2765.74,20058,238,180,18840,18258,17982,17883,5896
32863,2343,2442,32653,210,32653,210,3.81152e+18,87.7358,4725.67,32863,470,70,30421,30421,30375,30235,29415
18346,978,1114,16335,2011,0,18346,4.01439e+18,194.648,2463.08,18346,175,149,17232,17232,17232,17232,16935
49995,85,91,0,49995,48484,1511,2.54231e+16,34.0603,1215.31,49995,43,36,49904,49904,49585,49850,49291
29191,133,538,29191,0,29191,0,3.18244e+18,275.362,2278.96,29191,171,139,27910,27125,21224,20229,9285
46706,66,86,0,46706,46088,618,2.2099e+16,24.9629,1098.29,46706,34,38,46620,46620,45845,46179,44384
48020,730,1875,0,48020,0,48020,1.23005e+18,583.691,5816.4,48020,407,275,46059,44644,44016,37005,31027
24908,413,745,24908,0,18785,6123,8.71561e+17,351.228,2421.88,24908,197,157,24133,23157,22956,20694,15956
38854,854,1281,36254,2600,36254,2600,2.06901e+18,629.286,4192.15,38854,364,217,37570,36471,36337,36052,28590
49583,371,1470,49583,0,46361,3222,9.65588e+17,763.73,5048.76,49583,501,254,46209,44521,38921,36710,21885
1510,139,143,318,1192,0,1510,1.54708e+13,52.2311,353.459,1510,54,40,1367,1367,1367,1366,1365
9780,318,938,9780,0,9129,651,9.18547e+17,192.691,2025.91,9780,221,137,8842,8618,8171,7440,6501
14204,357,1193,11797,2407,0,14204,7.85948e+18,14.729,2108.34,14204,451,26,13011,13011,8261,8739,3078
22260,662,1160,0,22260,5576,16684,7.38347e+15,149.071,2732.77,22260,196,135,21100,21097,21035,21082,18681
6899,143,1164,0,6899,0,6899,1.83841e+18,86.1886,2015.23,6899,195,156,5686,5392,5136,4204,1927
32111,814,841,7067,25044,0,32111,1.88195e+13,383.529,3055.55,32111,287,169,31270,31270,31259,31270,30986
41013,20,66,0,41013,40744,269,2.61891e+16,51.0624,891.193,41013,39,41,40697,40496,38364,36743,24211
34399,478,1717,0,34399,6597,27802,6.53794e+15,282.769,4378.42,34399,512,162,32650,32278,30482,23230,16197
35969,459,1216,33593,2376,0,35969,2.38117e+18,629.814,4006.22,35969,367,216,33966,32822,32305,32204,20986
15897,746,1058,14840,1057,14840,1057,6.2669e+17,322.557,2578.4,15897,263,164,14839,14626,14640,14473,12147
27447,1140,1582,25379,2068,0,27447,2.80464e+18,233.294,4124.58,27447,427,131,25865,25865,25548,25712,20010
5866,215,514,5245,621,0,5866,3.87281e+18,133.528,1090.23,5866,91,94,5352,5093,5096,5080,2826
44174,297,525,44174,0,44174,0,4.89575e+18,251.605,3004.52,44174,226,168,43644,43424,41979,41538,39204
44873,961,1675,10647,34226,0,44873,2.7662e+13,249.139,4587.54,44873,328,184,43198,43111,42933,43145,35191
47831,1,12,47574,257,39743,8088,8.17516e+13,7.95781,509.271,47831,10,9,25494,25494,25494,25494,25494
24007,410,534,6689,17318,0,24007,6.29162e+13,201.316,1754.68,24007,120,111,23473,23453,23309,23338,20671
47698,1646,1849,0,47698,9240,38458,6.09342e+15,396.435,5324.72,47698,530,191,45849,45845,45805,45832,42694
5074,807,819,0,5074,0,5074,3.2089e+16,12.1851,1251.48,5074,174,17,4255,4255,4244,4245,4236
33427,1438,1490,33427,0,31139,2288,1.01147e+18,473.184,4428.34,33427,331,262,31937,31937,31879,31817,31536
43016,17,81,0,43016,42935,81,2.09057e+16,21.1084,941.643,43016,33,33,42863,42641,39504,41550,24196
49600,856,2647,45900,3700,45900,3700,2.34869e+18,541.888,6791.74,49600,826,146,46953,45898,44886,43496,22151
15331,1015,1106,0,15331,3531,11800,7.56693e+15,121.706,2219.4,15331,311,109,14225,14225,14169,14190,13495
14320,488,906,13356,964,0,14320,2.46671e+18,259.978,2273.6,14320,180,135,13414,13138,13096,12940,11498
10392,72,332,0,10392,2503,7889,7.7052e+15,122.089,1289.48,10392,159,90,9687,8686,8478,8030,4329
28457,301,1292,28457,0,26590,1867,8.97426e+17,635.494,3833.2,28457,346,215,25933,25027,21832,20599,8558
28001,664,930,24732,3269,24732,3269,1.68663e+18,404.979,3457.28,28001,288,185,27071,27070,26400,26408,21128
44229,180,758,12309,31920,0,44229,6.32347e+13,266.453,2775.48,44229,202,153,43032,41893,36903,31847,12590
47180,309,1268,41529,5651,41529,5651,1.71946e+18,425.936,4889.72,47180,325,212,44771,43129,41559,41257,13053
33575,7,10,33340,235,33575,0,1.01398e+14,9.41596,358.86,33575,10,10,33482,33346,32024,32025,29522
19720,513,595,0,19720,0,19720,4.15392e+18,278.932,1910.2,19720,161,137,19125,19117,19064,19069,18348
33298,27,44,0,33298,33034,264,2.53905e+16,39.5167,634.914,33298,32,33,33178,33078,32466,32815,26511
7933,10,44,0,7933,7878,55,2.57784e+16,24.3589,305.937,7933,22,21,7793,7708,7352,7228,5291
5059,96,397,5059,0,5059,0,3.70304e+18,152.939,1085.56,5059,111,76,4357,3703,3416,2594,1487
19019,301,317,19019,0,19019,0,4.89504e+18,202.549,1645.09,19019,174,124,18702,18690,18548,18549,18489
40336,715,861,0,40336,9079,31257,4.76619e+15,433.346,3352.57,40336,305,182,39475,39431,39102,39215,36984
23737,1,35,0,23737,23688,49,1.72305e+16,15.9029,528.671,23737,24,21,11075,11075,11075,11075,11075
40315,58,91,0,40315,40080,235,2.06691e+16,28.9615,998.83,40315,39,34,40224,40217,40176,40198,36473
47579,325,1112,0,47579,11389,36190,6.10814e+15,281.905,4200.85,47579,386,168,46426,46102,42101,41730,21650
43356,188,1728,0,43356,8128,35228,5.95062e+15,359.367,4915.23,43356,490,174,40680,39776,37791,38613,11580
27917,40,352,27917,0,27917,0,3.81527e+18,243.118,2047.35,27917,157,156,23738,20337,13207,10538,4059
47869,269,936,0,47869,10388,37481,4.83063e+15,482.275,3817.04,47869,344,204,45917,44641,43616,39507,25162
36581,750,1260,34168,2413,34168,2413,2.0302e+18,632.682,4092.19,36581,342,228,35255,33832,33963,33439,26001
43957,2062,2726,0,43957,0,43957,1.66117e+18,419.072,6555.52,43957,800,252,41231,41185,41166,41170,33971
47492,2229,2578,42651,4841,42651,4841,9.57608e+17,295.829,5990.42,47492,447,224,44914,44914,44914,44914,41930
12741,221,391,0,12741,2921,9820,7.37058e+15,170.276,1543.74,12741,175,90,12309,12171,11694,12013,7506
7201,29,33,0,7201,6862,339,2.45464e+16,16.849,268.9,7201,19,20,7168,7162,7100,7151,6966
48330,1972,4288,35536,12794,35536,12794,2.18883e+18,22.9819,5244.27,48330,1437,1431,44042,44042,41729,39418,40963
47593,2354,2794,43253,4340,43253,4340,2.71702e+18,448.626,6827.09,47593,799,253,44799,44793,44770,44767,40127
31487,1210,2146,31487,0,29383,2104,2.26845e+18,396.866,4955.48,31487,504,195,29341,29219,27867,28725,19668
47016,4,194,0,47016,45519,1497,2.50493e+16,24.9123,1262.62,47016,76,39,43738,42328,34534,34270,19838
2352,2,8,2325,27,2352,0,9.47826e+13,4.57653,88.1266,2352,6,7,2190,2154,1980,2141,1542
29159,1,10,29058,101,29095,64,9.93306e+13,7.81803,315.437,29159,8,10,16218,16218,16218,16218,16218
42585,5,44,0,42585,42275,310,2.56639e+16,38.5378,706.49,42585,35,34,41437,40933,38117,38372,23872
40127,1,12,39578,549,40127,0,9.60441e+13,11.1764,386.148,40127,12,12,22668,22668,22668,22668,22668
614,42,114,600,14,0,614,8.86814e+17,20.1971,214.854,614,41,30,500,500,477,461,428
1382,161,234,0,1382,0,1382,6632700,51.487,451.707,1382,71,35,1148,1128,1099,1106,869
41487,1391,1619,0,41487,10288,31199,7.28594e+15,232.56,4142.04,41487,296,171,39868,39868,39868,39868,38049
42553,192,2046,37825,4728,0,42553,3.93103e+18,342.528,4641.79,42553,276,190,39652,36218,33939,33927,2123
20276,1022,1145,0,20276,0,20276,1.24778e+18,438.088,3034.77,20276,274,176,19131,19111,19014,18826,18360
48446,195,911,10601,37845,0,48446,1.81625e+13,490.429,3817.79,48446,356,203,45929,44976,42908,37412,20651
8289,766,1446,6883,1406,6883,1406,4.64181e+18,107.27,2357.98,8289,217,168,6843,6796,6506,6211,2754
30532,2,43,0,30532,30467,65,1.77478e+16,22.4769,653.068,30532,26,22,23811,20810,20067,20976,15614
3582,395,428,3278,304,3278,304,2.65523e+18,67.3183,778.795,3582,115,67,3154,3154,3154,3154,3102
37553,1840,2022,33687,3866,0,37553,3.63343e+18,250.499,4753.48,37553,324,222,35531,35531,35531,35531,34353
9229,401,1529,8333,896,8333,896,1.11542e+18,114.053,2606.84,9229,373,130,7700,7540,6913,7183,2287
1647,190,236,1647,0,1552,95,9.97968e+17,84.4693,485.145,1647,70,49,1411,1404,1365,1395,1295
15546,407,728,13732,1814,13732,1814,9.227e+17,277.676,1822.4,15546,108,180,14818,14378,14532,14409,9561
47335,448,531,47335,0,47335,0,4.9925e+18,290.022,3197.66,47335,208,176,46804,46781,45642,45428,42881
22398,10,15,21924,474,22395,3,1.07045e+14,5.99259,273.117,22398,12,10,22381,22376,22225,22212,19706
29051,183,1193,27071,1980,0,29051,2.46276e+18,625.4,3627.85,29051,357,214,26273,24995,23250,22838,8980
48078,145,1267,0,48078,11104,36974,6.43709e+15,245.469,4522.16,48078,398,155,45415,43119,39525,31511,9753
17416,1122,1585,15634,1782,15631,1785,1.60984e+18,206.104,3193.43,17416,442,125,15831,15829,15795,15815,13351
3409,140,281,3409,0,3409,0,3.40628e+18,86.1904,688.799,3409,86,53,3128,3051,2786,2684,2347
8530,231,610,0,8530,0,8530,1.27813e+18,253.037,1721.21,8530,224,117,7585,6895,7167,7427,4406
5220,27,39,0,5220,5180,40,2.5165e+16,11.8625,233.067,5220,18,16,5181,5180,5147,5140,4308
30522,12,814,0,30522,6600,23922,4.82573e+15,421.959,3007.38,30522,291,188,21480,19331,15895,14185,4401
34849,1,11,33225,1624,34849,0,9.5915e+13,10.592,416.778,34849,11,11,13657,13657,13657,13657,13657
42481,1288,1579,10072,32409,0,42481,2.533e+13,287.488,4486.21,42481,334,173,40902,40891,40629,38439,35324
25160,230,1145,0,25160,0,25160,1.23543e+18,546.234,3367.98,25160,317,204,22889,22325,21019,19776,4679
36500,1595,1734,0,36500,7110,29390,6.20095e+15,268.462,4512.43,36500,419,191,34766,34761,34766,34766,32978
20826,483,1861,0,20826,0,20826,1.56602e+18,221.176,3965.43,20826,379,202,18965,18674,18295,11318,8900
15448,837,975,0,15448,3122,12326,4.86548e+15,230.488,2507.05,15448,238,143,14473,14466,14459,14447,13795
18169,546,792,16256,1913,0,18169,3.85177e+18,235.387,2135.78,18169,121,146,17377,17345,16780,16778,13287
23297,89,697,23297,0,17543,5754,8.32159e+17,333.844,2303.76,23297,201,154,21409,20513,16552,17272,4199
33588,7,10,33357,231,33588,0,1.01351e+14,9.43995,358.765,33588,10,10,33495,33356,32004,32005,29643
27502,153,913,5885,21617,0,27502,1.76501e+13,329.658,2975.02,27502,271,153,26014,25474,24432,19047,11417
27167,993,1431,24482,2685,0,27167,3.11203e+18,296.678,3825.48,27167,406,161,25736,25736,25566,25688,22361
25591,240,436,25591,0,25591,0,5.12159e+18,247.797,2118.52,25591,183,136,25012,24599,22001,21243,19207
40853,2368,2624,36933,3920,36933,3920,2.86516e+18,462.878,6267.71,40853,612,254,38229,38189,38014,38044,34989
46471,1271,1667,41811,4660,0,46471,3.3997e+18,602.984,5221.47,46471,631,194,44804,44660,44510,44599,41215
46311,1444,1887,0,46311,10307,36004,6.91922e+15,223.967,5033.94,46311,505,163,44424,44424,42002,42252,32150
16574,44,714,16574,0,14650,1924,2.26195e+18,256.786,1844.42,16574,103,185,14684,12220,10502,7279,1217
7602,187,594,0,7602,0,7602,1.78357e+18,252.24,1520.19,7602,215,100,6576,5952,6046,6169,2351
28464,12,14,28438,26,28459,5,7.73307e+12,12.3154,335.574,28464,14,14,28440,28420,28423,28420,20762
19222,24,822,17211,2011,0,19222,3.82728e+18,229.896,2210.91,19222,121,144,14692,9373,10367,10197,1288
5050,241,477,0,5050,769,4281,6.02203e+15,82.5402,1062.01,5050,163,67,4573,4509,4428,4507,2597
24035,255,564,0,24035,6669,17366,1.61868e+16,217.207,1867.06,24035,141,116,23449,22939,22495,22597,12498
27634,188,1091,0,27634,0,27634,1.1682e+18,605.85,3417.63,27634,308,194,25211,24336,22174,21352,4714
26967,1036,1207,24403,2564,0,26967,2.91556e+18,342.889,3652.01,26967,400,149,25760,25738,25646,25612,20607
9231,1,7,9081,150,7859,1372,6.95532e+13,5.9064,164.632,9231,7,7,6119,6119,6119,6119,6119
46514,56,670,35667,10847,46514,0,3.91976e+18,394.899,3536.21,46514,302,174,39826,35431,27348,22095,7648
3479,15,49,0,3479,3440,39,2.40469e+16,21.4863,251.619,3479,23,25,3382,3311,3139,3084,1943
14571,46,663,3273,11298,0,14571,1.85835e+13,278.646,1963.12,14571,188,137,12494,11103,10859,9506,2315
10665,503,607,10665,0,8065,2600,8.4063e+17,170.547,1508.88,10665,131,118,10058,10050,9963,9629,9314
41595,2384,2496,38174,3421,0,41595,3.07874e+18,439.31,6016.86,41595,751,230,39099,39099,39099,39099,38255
30057,643,788,26481,3576,26481,3576,3.20872e+18,343.083,3281.38,30057,287,191,29269,29269,29085,28937,26118
2762,142,148,0,2762,680,2082,8.40222e+15,78.7918,508.13,2762,80,57,2614,2614,2614,2614,2614
25777,31,62,0,25777,25629,148,2.62463e+16,30.0986,611.54,25777,33,32,25693,25637,25156,25117,19393
38731,1134,2268,0,38731,0,38731,1.38324e+18,415.352,5452.11,38731,765,145,36463,36304,35408,35970,26101
18397,206,1349,16400,1997,0,18397,3.95798e+18,181.206,2844.88,18397,333,157,16933,16615,14887,14837,6436
25427,357,597,25427,0,25427,0,4.1677e+18,248.374,2590.21,25427,192,166,24830,24694,22612,22096,16647
24932,222,1143,22516,2416,0,24932,2.98073e+18,396.185,3449.69,24932,373,156,22417,20189,20350,20740,2687
3396,34,236,3396,0,3396,0,3.92162e+18,134.942,643.798,3396,71,72,2776,2253,1594,1414,383
36420,127,475,36420,0,36420,0,5.0905e+18,271.562,2645.92,36420,214,159,34978,33282,24296,23393,16858
10610,43,49,0,10610,10492,118,2.55836e+16,37.4074,427.062,10610,30,31,10558,10539,10356,10412,9269
10056,231,672,8952,1104,8952,1104,9.0698e+17,156.646,1554.65,10056,101,128,9367,8879,8829,8546,3817
30400,401,588,29055,1345,29055,1345,1.3997e+18,430.652,2868.56,30400,248,165,29669,29208,27910,27492,25369
22937,19,65,0,22937,22603,334,2.42748e+16,42.0854,701.419,22937,34,38,22645,22341,21519,20437,12201
47156,2151,2352,47156,0,42621,4535,1.2658e+18,323.046,6008.66,47156,641,158,44804,44804,44804,44804,41842
892,109,127,0,892,250,642,1.85842e+15,21.2814,258.555,892,61,25,765,765,765,765,755
1373,31,209,1268,105,0,1373,2.79766e+18,76.8172,424.535,1373,58,49,947,694,732,751,374
4891,162,384,4610,281,4610,281,4.6137e+17,153.185,950.885,4891,117,77,4475,4209,4237,4215,2794
47440,1321,2493,47440,0,42964,4476,1.22052e+18,325.615,6385.18,47440,777,156,44947,44947,41926,43626,21302
37883,1124,1253,35369,2514,35369,2514,2.04143e+18,677.503,4166.97,37883,378,221,36630,36618,36438,36455,35591
19674,695,1158,0,19674,4742,14932,7.89242e+15,142.17,2499.17,19674,334,109,18516,18507,16613,16926,7981
10848,827,1010,10118,730,10118,730,6.24277e+17,209.149,2194,10848,195,150,9838,9776,9770,9704,8173
1074,2,119,1074,0,1074,0,2.52047e+18,50.4348,251.732,1074,47,26,374,152,253,186,151
46138,16,23,45606,532,46116,22,1.05567e+14,7.7494,438.012,46138,13,14,46115,46114,45021,45146,29410
45342,535,703,45238,104,45342,0,3.27325e+18,360.821,3672.88,45342,225,193,44639,44551,43488,41578,39341
40735,110,929,30732,10003,30732,10003,6.97525e+18,355.104,3059.38,40735,225,177,38222,37242,27406,19689,8982
27310,433,859,0,27310,6007,21303,4.68611e+15,403.003,2886.57,27310,358,172,26348,25722,25289,24733,17579
30274,10,11,30218,56,29953,321,8.28603e+13,6.8728,352.937,30274,9,8,30263,30263,30262,30262,30260
26769,1573,3835,3682,23087,0,26769,4.50716e+12,10.7061,4767.77,26769,735,18,22934,22934,20675,16834,15601
34204,343,1151,30541,3663,30541,3663,3.08625e+18,541.546,3820.4,34204,488,169,31820,30104,28139,25498,17449
33882,1936,2075,0,33882,0,33882,2.5007e+18,465.814,4876.77,33882,518,214,31807,31807,31807,31807,30690
917,15,194,876,41,876,41,6.1028e+17,37.4602,331.951,917,80,32,650,563,439,461,205
45241,337,757,45177,64,45241,0,3.66762e+18,390.928,3648.75,45241,269,159,44168,43688,39880,38240,30396
4539,267,390,4539,0,4247,292,1.12065e+18,144.484,940.347,4539,124,72,4149,4134,3927,4062,3540
17281,564,1222,0,17281,0,17281,1.47429e+18,268.989,2999.06,17281,384,95,16059,15845,15488,11128,10188
46730,663,747,46666,64,46730,0,3.23748e+18,377.681,3904.9,46730,253,195,45983,45942,45769,45422,43959
32331,699,917,0,32331,7445,24886,5.97756e+15,271.309,3254.44,32331,369,137,31414,31369,31166,31252,26304
4677,8,286,0,4677,996,3681,3.48318e+15,53.2249,715.392,4677,109,45,3839,3383,2906,1943,950
4064,512,604,4064,0,3809,255,6.2591e+17,74.7158,1113.02,4064,116,63,3460,3458,3408,3460,3279
26018,444,848,0,26018,5707,20311,4.79969e+15,387.509,2800.82,26018,324,153,25063,24498,24142,23892,18099
10958,122,926,10160,798,10160,798,2.2248e+18,202.899,2095.06,10958,184,125,9546,8673,8457,8438,3492
30027,325,741,22645,7382,22645,7382,7.00142e+18,336.111,2495.87,30027,202,159,29140,27921,27554,26270,16221
6914,160,345,6914,0,6914,0,3.15192e+18,118.754,986.275,6914,104,89,6565,6453,5659,5647,4050
2402,5,40,0,2402,2363,39,2.17193e+16,8.23522,162.619,2402,17,12,2337,2315,2186,2213,1469
37292,187,1782,7256,30036,0,37292,2.51124e+13,290.69,4625.72,37292,512,171,34883,34090,32131,20651,10300
16991,650,770,16991,0,15201,1790,1.78411e+18,232.833,2093.25,16991,138,144,16221,16217,15760,16037,14621
30495,15,40,0,30495,30167,328,1.96549e+16,23.7462,645.408,30495,28,27,30400,30334,29933,29854,22723
7084,65,139,0,7084,6932,152,2.60808e+16,15.9627,533.771,7084,50,26,6945,6930,6657,6484,3797
42259,311,385,0,42259,11103,31156,3.10933e+15,279.835,2642.22,42259,234,142,41839,41659,40505,40774,39848
41760,1188,1694,10225,31535,0,41760,3.06128e+13,257.634,3983.73,41760,326,271,40066,40066,38303,39185,29807
28253,619,985,0,28253,0,28253,1.75005e+18,324.037,3591.63,28253,354,172,27268,27258,26332,26058,16923
27486,206,420,27486,0,27486,0,4.94043e+18,275.8,2192.98,27486,185,146,26788,26225,21996,20771,15826
42650,2164,2394,0,42650,0,42650,1.34808e+18,480.736,5846.8,42650,765,145,40256,40256,40033,40244,38953
38872,70,78,0,38872,38570,302,2.3976e+16,33.1714,882.133,38872,33,37,38794,38786,38793,38794,36037
39414,38,69,0,39414,38869,545,2.5001e+16,43.5264,911.218,39414,40,40,39299,39196,37989,38178,30622
19449,120,302,19449,0,19449,0,3.40089e+18,225.216,1520.8,19449,108,172,18720,18252,14446,12781,8638
48995,840,1832,0,48995,0,48995,1.21516e+18,688.311,5655.1,48995,416,272,47035,46531,44927,42012,24933
31842,74,90,0,31842,31204,638,2.42954e+16,37.5625,975.393,31842,43,36,31752,31749,31495,31671,29421
15799,3,34,0,15799,15011,788,2.47339e+16,26.078,409.299,15799,25,24,13495,12823,10119,10365,6851
42645,1863,1920,0,42645,9738,32907,6.83463e+15,212.17,4797.05,42645,404,178,40725,40725,40725,40725,40409
9424,187,692,8782,642,8782,642,6.18563e+17,192.529,1650.32,9424,144,131,8643,8399,7730,7829,5285
18478,11,34,0,18478,17608,870,2.46147e+16,26.7353,444.381,18478,25,25,18175,17706,14865,16206,12308
13071,14,31,12815,256,13067,4,1.0386e+14,8.18239,290.484,13071,16,15,13038,13032,12457,12337,7779
19960,186,499,19960,0,19960,0,4.31817e+18,282.633,2070.89,19960,175,105,19029,18424,15079,14396,10021
19008,7,12,18743,265,19008,0,9.79419e+13,8.53898,268.662,19008,9,10,18990,18988,18204,18202,15474
11615,4,8,11580,35,11615,0,1.11766e+14,7.06216,199.444,11615,8,8,11575,11564,11003,10984,9961
42809,620,1987,42809,0,37870,4939,2.00593e+18,334.508,4541.92,42809,392,332,40822,40605,34028,38026,5103
32562,1091,1170,0,32562,0,32562,1.71133e+18,337.555,4033.5,32562,354,181,31392,31392,31388,31379,30528
24987,26,1158,23352,1635,23352,1635,2.03235e+18,515.188,3309.81,24987,381,189,17317,13593,12012,12356,2494
48288,532,1714,0,48288,9940,38348,5.60534e+15,428.926,5345.56,48288,573,142,46296,45720,43597,32194,24128
35768,1314,2300,0,35768,0,35768,1.81512e+18,258.939,5278.81,35768,468,236,33468,33468,31153,31992,21808
42575,340,600,40440,2135,42575,0,3.95207e+18,303.414,3267.91,42575,273,151,41895,41542,35813,35308,26149
4353,160,361,4353,0,4353,0,3.76067e+18,146.008,980.026,4353,114,72,3952,3772,3453,3121,2762
3518,53,516,3113,405,3113,405,3.45422e+18,138.712,1021.17,3518,128,70,2763,2147,2447,2255,589
13314,70,87,0,13314,12967,347,2.40031e+16,26.6035,636.438,13314,35,30,13227,13224,13003,13142,11388
47691,29,83,0,47691,47107,584,2.09868e+16,24.4441,1085.84,47691,30,38,47608,47590,43218,43535,31485
27571,591,1222,25709,1862,25709,1862,7.25138e+17,607.268,3658.82,27571,293,209,25976,24625,24827,24958,15180
11223,548,600,2756,8467,0,11223,2.61114e+13,143.816,1722.15,11223,262,91,10623,10623,10623,10623,10279
48211,22,36,0,48211,48139,72,9.29973e+15,5.01276,800.952,48211,18,7,48175,48175,47731,47736,37769
25345,804,1404,23720,1625,23720,1625,6.87015e+17,529.341,3795.2,25345,309,214,23941,23372,23326,23414,18648
21193,79,3540,21193,0,0,21193,5.39122e+18,7.4963,4589.03,21193,1772,9,17653,17653,15923,13830,1402
36976,1481,1908,33023,3953,33021,3955,1.0611e+18,271.261,4316.79,36976,347,179,35068,35068,34820,35004,28702
29370,421,575,0,29370,8174,21196,1.61588e+16,234.983,2006.66,29370,154,126,28795,28753,28527,28575,24527
45746,241,1738,0,45746,11271,34475,7.78246e+15,253.229,4183.92,45746,329,278,43729,42771,37285,37208,12764
4941,41,335,4941,0,4941,0,3.33938e+18,131.031,984.898,4941,117,87,3782,3280,2634,1806,1194
24529,25,35,0,24529,24480,49,1.74379e+16,15.5323,537.126,24529,24,21,24494,24490,24396,24402,22461
27520,3,13,27315,205,27520,0,9.87517e+13,11.141,327.678,27520,12,11,26526,26019,24464,25277,18175
20403,16,33,0,20403,20362,41,2.12257e+16,27.7173,488.831,20403,29,29,20171,20021,17426,18484,15282
10510,877,899,9783,727,9783,727,2.112e+18,272.643,2058.34,10510,220,138,9611,9611,9611,9611,9452
7510,121,715,6916,594,6916,594,2.49078e+18,204.741,1596.85,7510,255,87,6529,5765,5877,5248,1145
47807,9,11,45490,2317,47807,0,9.61945e+13,10.6724,488.494,47807,11,11,47769,47743,46433,46434,47758
46950,2,12,46299,651,43304,3646,7.83096e+13,6.88268,437.327,46950,9,8,40670,38569,36711,39084,31540
12864,427,1167,12864,0,12092,772,6.87147e+17,276.64,2674.1,12864,265,162,11697,11394,11059,10604,6001
24865,3,8,24479,386,24865,0,1.011e+14,7.52616,289.666,24865,8,8,24461,24337,23733,23537,16403
39874,973,2378,36081,3793,36078,3796,1.33316e+18,300.335,5910.99,39874,609,163,37496,37487,36972,37151,15839
47964,60,71,0,47964,47598,366,2.48185e+16,52.2684,1048.04,47964,41,44,47891,47855,47773,47622,46241
544,51,90,420,124,420,124,3.50008e+18,42.2794,192.485,544,33,35,454,333,429,437,300
43383,893,2074,40028,3355,40028,3355,2.43072e+18,476.571,5889.63,43383,556,136,41309,41048,38784,36551,20886
36243,1035,1313,33781,2462,33781,2462,6.59286e+17,724.608,4244.74,36243,382,233,34930,34604,34503,34344,31859
14186,111,1223,12962,1224,12962,1224,2.70393e+18,115.626,2654.33,14186,329,102,12804,11901,11917,10907,2059
25217,20,23,0,25217,25205,12,7.60097e+14,16.5046,485.603,25217,20,11,25194,25194,25175,25068,24045
23210,727,773,6029,17181,0,23210,2.94189e+13,178.839,2105.44,23210,109,140,22437,22437,22369,22414,21798
5229,66,739,5229,0,4687,542,9.0631e+17,68.3771,1359.58,5229,208,76,4405,4204,3404,2349,994
576,48,88,441,135,441,135,6.42085e+18,37.6094,188.604,576,31,33,488,467,431,418,334
49908,1314,2365,44729,5179,44705,5203,1.65105e+18,517.605,6349.99,49908,632,263,47543,47536,46976,47115,37044
46162,6,11,45905,257,46162,0,1.07414e+14,9.16618,420.542,46162,10,10,45984,45808,43875,43858,32002
24297,620,1273,24297,0,22674,1623,9.28388e+17,592.874,3539.52,24297,324,198,22783,21581,19951,18628,15686
25515,399,580,25515,0,25515,0,4.49323e+18,223.796,2537.28,25515,189,157,24935,24861,23945,23607,20904
12321,113,358,3224,9097,0,12321,1.30246e+13,207.974,1458.49,12321,187,99,11267,10413,10598,10722,5774
29490,547,775,29490,0,22250,7240,9.01499e+17,367.825,2646.32,29490,213,169,28715,28619,28171,26069,24097
32854,1054,1177,30717,2137,0,32854,2.37597e+18,610.818,3769.96,32854,354,201,31677,31659,31536,31537,30913
5848,512,547,5146,702,5146,702,1.72976e+18,162.413,1357.5,5848,149,108,5301,5301,5300,5301,5090
1521,151,163,0,1521,0,1521,2.25018e+18,111.406,429.423,1521,79,53,1358,1309,1350,1349,1335
5647,351,425,4860,787,4860,787,2.81797e+18,291.998,1198.93,5647,190,89,5130,4581,5013,5046,4631
31680,748,960,6885,24795,0,31680,1.79701e+13,352.621,3262.39,31680,280,198,30720,30630,30293,30037,25642
1838,170,233,0,1838,0,1838,1.26449e+18,88.519,502.075,1838,72,52,1605,1586,1562,1568,1388
1560,55,219,1560,0,1464,96,1.06325e+18,95.2288,461.428,1560,68,49,1205,961,877,943,618
4350,254,261,0,4350,1130,3220,7.55313e+15,101.255,671.077,4350,58,71,4089,4089,4088,4089,4046
23168,208,1202,23168,0,20383,2785,9.25437e+17,370.199,3542.14,23168,369,156,20343,18432,15835,7084,4297
44213,455,1307,0,44213,0,44213,1.18243e+18,722.079,4519.65,44213,422,238,41814,40188,39472,37625,18950
36160,163,861,0,36160,8108,28052,4.60924e+15,437.806,3238.48,36160,359,178,34145,33586,31756,29190,15070
37462,1467,3059,37462,0,37462,0,1.96534e+18,16.0231,5213.2,37462,1177,25,34403,34403,32819,34403,22854
6829,30,440,6829,0,6115,714,1.79045e+18,186.189,1110.29,6829,95,103,5384,4089,3261,720,694
37606,1630,2081,33687,3919,0,37606,3.69764e+18,260.636,4779.49,37606,396,188,35525,35524,35525,35525,33131
38490,1,11,38376,114,38490,0,8.0545e+13,6.68511,391.398,38490,8,8,21798,21798,21798,21798,21798
18920,128,327,18920,0,18920,0,5.04918e+18,215.515,1655.01,18920,152,126,18212,17724,13060,13082,9310
7734,339,522,7734,0,5837,1897,8.85909e+17,153.112,1226,7734,118,107,7212,7083,6974,6698,5960
11216,1,10,11175,41,11216,0,7.29037e+13,5.97718,214.747,11216,7,8,6552,6552,6552,6552,6552
20258,137,968,20258,0,18028,2230,1.98863e+18,227.333,2412.8,20258,120,204,18601,17611,15138,17378,3996
14672,417,1315,12960,1712,0,14672,4.24841e+18,163.936,2430.7,14672,335,124,13357,13311,11609,11201,2943
48998,1186,1966,48998,0,45190,3808,1.2026e+18,589.446,5931.23,48998,489,258,47032,47004,45148,45673,28035
3129,144,496,2753,376,2753,376,3.73809e+18,14.8447,727.265,3129,191,35,2633,2633,2298,1431,1359
2417,77,214,2417,0,2072,345,1.21496e+18,137.341,602.675,2417,92,65,1873,1523,1360,1156,930
40190,317,573,39266,924,40190,0,3.88386e+18,266.886,2963.41,40190,187,169,39613,39369,38687,37854,34844
8955,923,1073,8955,0,8220,735,8.7389e+17,179.784,2067.37,8955,363,77,7882,7875,7840,7879,7302
45794,1492,1512,11720,34074,0,45794,3.36626e+13,387.208,4755.01,45794,547,180,44282,44282,44282,44282,44223
36587,92,612,10177,26410,0,36587,6.32523e+13,252.797,2261.73,36587,170,131,35043,34341,29521,17833,11313
8044,558,1543,1148,6896,0,8044,7.03944e+12,9.96208,1770.18,8044,203,18,6501,6501,5519,3809,3318
31852,1944,2060,28753,3099,0,31852,3.56083e+18,248.588,4911.74,31852,487,154,29792,29792,29643,29669,28406
44714,632,1268,0,44714,9455,35259,4.72834e+15,494.356,4339.76,44714,417,226,43405,43112,41479,38993,22218
19243,706,720,4204,15039,0,19243,1.84455e+13,332.995,2318.3,19243,238,152,18523,18520,18523,18523,18383
43136,1274,1920,36586,6550,0,43136,5.1995e+18,322.429,5548.55,43136,358,196,41216,41201,39742,39939,25822
10195,263,383,10195,0,10195,0,3.16904e+18,243.987,1417.94,10195,149,101,9714,9224,9208,9059,7555
28222,200,1685,25417,2805,25417,2805,1.36129e+18,386.748,4337.84,28222,491,152,24612,22258,19503,21399,5020
19821,1,11,18916,905,19821,0,9.60268e+13,10.1776,314.74,19821,11,11,7776,7776,7776,7776,7776
3472,240,360,730,2742,0,3472,1.91729e+13,70.697,809.614,3472,96,61,3112,3094,3073,3086,2687
39029,3,13,38735,294,39029,0,9.77004e+13,11.3289,388.616,39029,13,12,37590,36838,34893,35811,26542
41388,284,1905,0,41388,0,41388,2.75449e+18,293.346,5407.47,41388,341,198,39133,37965,30676,22435,11708
13738,1077,1137,0,13738,3637,10101,1.5693e+16,107.333,2337.78,13738,216,117,12601,12601,12601,12601,12331
39310,2109,4359,38971,339,38971,339,3.76983e+18,14.5582,6141.38,39310,1159,22,34951,34951,32706,25733,26281
36305,136,502,36305,0,36305,0,3.26711e+18,306.483,2468.87,36305,196,144,34820,33909,26477,25537,11960
40219,781,1919,0,40219,8171,32048,6.8781e+15,240.351,4795.23,40219,515,224,38300,38292,35803,36575,21347
39105,36,67,0,39105,38806,299,2.51783e+16,51.5237,878.896,39105,41,41,38958,38855,37642,37603,31885
22100,1,10,22021,79,22036,64,1.04795e+14,6.82493,277.157,22100,8,8,11945,11945,11945,11945,11945
16703,292,676,0,16703,3631,13072,4.74107e+15,221.029,2113.52,16703,193,118,15958,15699,15446,14622,12412
8146,300,486,0,8146,1318,6828,5.0781e+15,152.867,1274.09,8146,199,78,7660,7590,7473,7637,5676
17745,117,620,17745,0,13399,4346,8.6158e+17,313.524,1956.56,17745,169,140,16434,15992,13371,13143,3750
27968,23,917,26046,1922,0,27968,2.51572e+18,492.665,3037.52,27968,271,181,18368,14641,12998,12203,3333
17754,42,425,4145,13609,0,17754,2.91772e+13,187.522,1851.78,17754,194,109,15536,13858,12983,4264,2752
38950,10,11,37079,1871,38950,0,9.62225e+13,10.8163,441.095,38950,11,11,38928,38915,38093,38093,38924
1309,82,202,1293,16,1293,16,3.79671e+17,34.1047,385.372,1309,43,37,1107,1096,973,1032,608
47838,1378,2157,42859,4979,42857,4981,8.69962e+17,350.373,5437.11,47838,335,297,45681,45652,45479,45509,39407
35668,567,650,9934,25734,0,35668,6.27077e+13,247.058,2272.33,35668,160,137,35018,35013,34917,34867,33332
40183,2,13,39892,291,40183,0,1.00239e+14,11.3297,392.771,40183,12,12,36483,35380,27843,35110,24319
36623,629,1915,33297,3326,33297,3326,2.8136e+18,317.438,4898.5,36623,331,189,34674,34154,32846,31694,15654
5333,137,813,4936,397,4936,397,9.2741e+17,92.543,1535.5,5333,194,71,4480,4218,4048,4096,2135
44930,352,3302,44641,289,44641,289,3.81061e+18,89.3275,6324.35,44930,680,77,41628,41316,37897,16364,10919
29877,467,605,28530,1347,0,29877,1.70801e+18,444.995,2866.12,29877,254,165,29181,28940,27836,28019,26186
30908,211,1209,0,30908,0,30908,1.46882e+18,385.052,3936.22,30908,406,173,27747,24837,25079,10108,8858
35070,187,904,26414,8656,0,35070,8.31338e+18,320.67,2845.67,35070,204,171,33393,32373,25753,25597,12456
42419,7,18,40977,1442,42419,0,9.56127e+13,10.4824,465.652,42419,16,12,42202,42036,38569,39059,30593
10773,92,674,9513,1260,9513,1260,1.69318e+18,322.923,1969.1,10773,193,129,8828,7395,6709,7300,2477
46742,2639,3044,46742,0,46742,0,1.20658e+18,16.3171,5952.78,46742,1461,22,43698,43698,43698,43698,38924
42740,417,695,0,42740,11841,30899,1.61797e+16,271.543,2535.52,42740,203,142,42045,41915,41226,41328,32183
28680,653,744,21600,7080,0,28680,8.3343e+18,321.591,2446.93,28680,195,154,27936,27934,27870,27878,26800
37040,710,1322,34538,2502,34538,2502,6.96728e+17,641.622,4294.34,37040,330,239,35402,33875,34361,34400,22008
4878,2,7,4866,12,4878,0,8.26309e+13,6.86142,137.654,4878,7,7,4033,3741,3785,3845,3355
33224,9,41,0,33224,32884,340,2.7412e+16,22.0086,576.738,33224,26,22,33014,32908,28304,30469,21009
42724,7,102,0,42724,42500,224,2.39765e+16,41.3356,1153.27,42724,48,38,39774,37914,35150,27893,21681
40937,208,2479,37006,3931,37005,3932,1.11739e+18,356.159,5967.8,40937,448,273,37343,34942,32579,32963,7608
20206,557,1230,0,20206,0,20206,1.46446e+18,337.599,3201.48,20206,440,114,18961,18528,18264,15081,12689
10653,38,398,10653,0,10653,0,5.04571e+18,164.622,1362.72,10653,157,102,8633,6784,5273,4526,2264
26579,9,12,26230,349,26579,0,9.91344e+13,10.6721,313.858,26579,12,12,26557,26544,25322,25323,24792
41313,449,632,39017,2296,41313,0,3.7376e+18,307.148,3235.85,41313,268,181,40681,40478,39891,39155,35913
47303,2,45,0,47303,46952,351,2.54791e+16,40.2984,759.53,47303,36,35,37983,35644,33006,34451,23874
17140,387,1558,15997,1143,15997,1143,1.14835e+18,197.065,3030.48,17140,485,129,15582,15440,13624,14650,4999
6206,5,54,0,6206,6166,40,2.62756e+16,18.9686,348.688,6206,26,24,5581,5276,4605,4692,3255
13076,695,780,12192,884,0,13076,2.47747e+18,320.924,2029.7,13076,193,148,12296,12296,12244,12245,11931
540,33,172,473,67,473,67,2.16468e+18,18.5278,256.326,540,50,31,368,300,273,307,196
42276,117,990,9194,33082,0,42276,1.81238e+13,459.148,3695.33,42276,393,210,39323,38193,35772,29826,8898
30308,157,1971,30308,0,30308,0,8.37523e+17,15.888,3847.52,30308,986,16,28337,28337,16539,24162,6646
23760,597,787,0,23760,5122,18638,4.62961e+15,382.246,2635.66,23760,272,155,22973,22736,22581,22704,20282
1507,3,16,0,1507,1462,45,2.31428e+16,11.5149,102.796,1507,13,14,1289,1227,1028,1017,737
32669,709,889,24595,8074,24593,8076,3.79932e+18,343.133,3141.59,32669,218,212,31780,31767,31706,31693,28404
47714,84,92,0,47714,46156,1558,2.50981e+16,33.6786,1176.97,47714,44,35,47622,47622,47398,47600,46393
49440,674,1016,0,49440,0,49440,4.14337e+18,379.181,3444.52,49440,262,184,48424,48356,47843,45426,42882
47759,8,10,47502,257,47695,64,1.07913e+14,7.4757,408.185,47759,9,10,47748,47746,47705,47705,45630
44245,11,14,43615,630,41501,2744,8.01008e+13,6.60994,412.244,44245,9,10,44231,44231,42257,42256,42933
14199,179,576,3691,10508,0,14199,2.94757e+13,151.581,1536.08,14199,92,118,13594,13373,12226,12818,6795
33582,196,793,33582,0,25290,8292,9.03832e+17,381.321,2825.91,33582,220,175,31761,30771,26553,26001,9170
19089,35,62,0,19089,18945,144,2.62804e+16,36.4051,603.788,19089,32,32,19007,18979,18230,18169,12440
45614,814,1157,0,45614,10929,34685,6.12023e+15,248.144,4232.85,45614,385,169,44457,44434,43955,43745,38985
10938,242,435,10938,0,10938,0,3.21326e+18,191.682,1567.79,10938,138,116,10497,10332,9714,8820,7687
6017,20,397,0,6017,1305,4712,5.03552e+15,90.2814,993.928,6017,118,64,4500,3822,3586,3564,1233
18218,415,1524,16851,1367,16851,1367,7.20852e+17,412.424,3465.35,18218,366,203,16502,16103,15580,15711,5001
15350,7,10,15219,131,15350,0,9.7847e+13,8.81739,240.63,15350,10,10,15306,15249,14791,14791,15168
18064,370,621,15887,2177,0,18064,3.87494e+18,307.832,2389.18,18064,228,160,17403,17013,16236,16281,10910
9997,561,589,9997,0,8920,1077,1.84998e+18,199.335,1472.75,9997,113,119,9408,9408,9408,9408,9399
1924,9,39,0,1924,1914,10,2.83512e+16,8.671,169.108,1924,18,13,1876,1863,1660,1729,928
49073,123,713,47200,1873,49073,0,3.40532e+18,367.927,3811.62,49073,253,195,45650,39490,34776,27748,14585
43621,114,904,32859,10762,32859,10762,3.81025e+18,404.373,3299.23,43621,243,187,40601,39426,31001,32260,7581
47864,2,10,47688,176,47736,128,1.0283e+14,8.84962,407.084,47864,10,10,42665,41997,36826,40392,29620
7955,20,325,0,7955,1830,6125,7.26608e+15,134.703,1152.45,7955,150,77,6414,5723,5190,3836,1482
3002,244,298,2265,737,2265,737,7.00391e+18,59.3761,641.67,3002,61,69,2704,2703,2701,2700,2458
16405,33,48,0,16405,16338,67,2.42813e+16,19.4062,447.049,16405,23,21,16357,16347,16317,16295,14500
15174,298,379,15174,0,15174,0,5.03644e+18,226.17,1591.77,15174,145,119,14795,14687,14464,14139,13370
12356,871,949,11545,811,11545,811,2.01055e+18,355.24,2281.17,12356,248,142,11407,11276,11360,11351,10705
9000,248,377,9000,0,9000,0,3.26163e+18,181.741,1175.6,9000,112,95,8613,8438,7850,7746,6001
19959,346,1483,0,19959,0,19959,1.13152e+18,235.97,3271.33,19959,436,114,18391,17985,17511,14107,7736
46531,1647,2768,0,46531,0,46531,1.70708e+18,357.14,6631.28,46531,598,260,43763,43762,41462,42165,30376
48399,2,14,47903,496,47951,448,8.74105e+13,7.47646,438.593,48399,10,11,42445,40930,39955,40672,32979
24468,1,10,24300,168,24468,0,1.01326e+14,9.0188,306.043,24468,10,10,13023,13023,13023,13023,13023
33940,1049,1324,33940,0,31689,2251,1.00884e+18,663.12,4073.17,33940,414,208,32616,32157,31636,31871,29558
39174,642,995,29503,9671,29503,9671,3.81237e+18,373.722,3262.7,39174,232,195,38179,38111,37916,37859,30382
8092,182,470,1317,6775,0,8092,1.97252e+13,139.861,1259.1,8092,186,74,7587,7411,7379,7430,3838
19472,1214,1276,0,19472,2513,16959,1.37824e+16,11.8783,2493.54,19472,639,13,18196,18196,18122,18158,17721
25331,866,1833,25331,0,21774,3557,9.35113e+17,259.847,4561.36,25331,384,200,23498,23434,22657,22479,12667
28170,291,365,0,28170,7379,20791,3.00649e+15,237.393,2119.48,28170,207,121,27805,27617,27006,27156,26987
19104,16,64,0,19104,18952,152,2.63201e+16,34.2239,591.575,19104,33,33,18801,18441,17671,17347,13300
27145,118,359,27145,0,27145,0,3.82619e+18,236.515,2027.25,27145,148,154,25431,23726,18928,16842,11207
20627,2,10,20492,135,20627,0,1.02072e+14,9.12314,281.355,20627,10,10,17877,17359,15261,16720,13286
22255,1359,1599,20542,1713,20542,1713,2.41623e+18,295.718,3534.72,22255,626,115,20656,20656,20640,20630,19047
15137,6,9,15095,42,15137,0,1.14323e+14,7.07293,230.153,15137,8,8,15109,15085,14570,14569,11250
42032,4,14,41855,177,42032,0,8.6662e+13,8.46814,413.71,42032,11,10,41105,40562,36125,36261,33737
43286,70,75,0,43286,42944,342,2.48588e+16,29.1621,896.527,43286,34,32,43211,43211,43211,43211,41140
35635,256,1218,33249,2386,0,35635,2.43049e+18,645.858,4044.12,35635,338,225,32707,31890,30098,30216,6802
48778,400,1003,0,48778,0,48778,4.12148e+18,371.967,3392.19,48778,257,186,47704,46431,42000,23439,22834
39379,58,950,29668,9711,0,39379,8.29174e+18,327.837,3034.8,39379,218,184,35935,33500,24795,25445,6124
10702,398,918,10702,0,9994,708,9.83314e+17,329.951,2113.1,10702,224,146,9781,9439,8805,8758,6509
34484,1311,2240,26804,7680,26710,7774,3.51423e+18,292.902,4912.78,34484,375,245,32244,32236,31841,32156,26881
48147,1814,2766,42937,5210,0,48147,3.85219e+18,317.371,5949.92,48147,428,226,45381,45375,45155,45160,40153
10119,98,522,2383,7736,0,10119,1.81077e+13,111.301,1344.47,10119,148,115,9510,9079,8386,8343,2392
47462,62,544,47462,0,47462,0,3.24451e+18,329.822,2880.86,47462,218,155,43621,40343,26842,25821,7127
30864,72,1227,28832,2032,28832,2032,2.03877e+18,591.343,3745.16,30864,381,188,25611,22241,20827,21428,5963
44806,75,2415,40134,4672,40134,4672,2.98059e+18,395.605,6195.76,44806,557,244,37442,32758,32087,29392,5906
22038,1048,1461,22038,0,20243,1795,9.17085e+17,303.695,3646.1,22038,465,114,20577,20577,20575,20518,14856
29377,579,1569,0,29377,5979,23398,6.30133e+15,218.891,3973.75,29377,414,174,27808,27703,27134,27427,15322
26574,531,2263,0,26574,0,26574,1.56198e+18,216.861,4542.23,26574,741,217,24311,24023,22981,16749,6356
1189,226,244,1189,0,1045,144,1.30114e+18,54.6257,448.06,1189,73,49,945,945,944,937,896
1449,23,170,0,1449,321,1128,5.79511e+15,50.6618,407.822,1449,83,45,1170,1072,974,882,412
37978,805,2005,32396,5582,32393,5585,2.06759e+18,355.121,5598.56,37978,422,218,35973,35889,35012,34151,18199
36492,9,10,36286,206,36428,64,1.06637e+14,7.67237,358.347,36492,9,10,36482,36480,36461,36461,35570
5044,264,378,0,5044,0,5044,2.14296e+18,68.6917,820.695,5044,65,83,4666,4663,4591,4599,3622
12770,460,1019,12723,47,12695,75,3.22157e+18,69.5099,2007.89,12770,353,55,11751,11705,11169,11739,6044
48453,520,3567,10745,37708,0,48453,6.18867e+12,289.464,6487.35,48453,426,126,44886,44064,33799,27969,10262
17375,588,1491,17375,0,16245,1130,4.1529e+18,198.574,2955.57,17375,529,76,15884,15750,14163,15060,6795
1219,293,465,1219,0,950,269,1.78957e+18,26.6489,645.514,1219,112,85,754,754,652,645,571
14379,367,1163,13314,1065,13314,1065,1.28576e+18,323.841,2650.49,14379,370,126,13081,12543,11774,12264,4160
20235,787,1637,0,20235,0,20235,1.21176e+18,276.208,3474.39,20235,468,135,18598,18328,18120,18118,13229
21809,454,883,19527,2282,19527,2282,8.86264e+17,259.448,2452.97,21809,138,159,20926,20850,20265,20217,12660
12254,150,509,12190,64,12254,0,3.40582e+18,208.808,1703.75,12254,192,104,11390,10603,9642,9311,6510
1307,160,224,1307,0,0,1307,5.38323e+18,7.44759,342.874,1307,114,9,1083,1083,1052,1083,877
45621,3328,3368,45445,176,45341,280,3.34476e+18,92.0099,6443.91,45621,497,80,42253,42253,42253,42253,41876
48506,262,2092,0,48506,11703,36803,7.87145e+15,292.534,4840.07,48506,372,281,46145,45230,38693,39056,4610
20047,182,1375,18397,1650,0,20047,3.05869e+18,245.27,3301.11,20047,366,95,18318,17810,16834,16512,5312
24235,1,44,0,24235,24057,178,2.55138e+16,36.3742,538.986,24235,29,31,11669,11669,11669,11669,11669
6278,660,725,0,6278,0,6278,1.22532e+18,113.662,1469.54,6278,144,133,5553,5553,5551,5552,5313
25256,1759,1916,25152,104,25091,165,3.24177e+18,90.0115,3730.79,25256,452,68,23340,23340,23263,23340,21770
25179,302,514,25179,0,25179,0,3.52481e+18,358.845,1968.02,25179,514,31,24241,23566,22959,22317,16690
30798,554,1000,0,30798,0,30798,1.93631e+18,270.569,2904.72,30798,148,164,29798,29731,28362,21659,20950
18989,613,1043,4856,14133,0,18989,4.48559e+13,119.504,2851.66,18989,220,125,17946,17941,17095,14296,9221
20277,1378,1427,20277,0,18465,1812,7.78364e+17,352.016,3490.97,20277,424,150,18850,18850,18849,18846,18525
10464,15,443,9210,1254,0,10464,3.1171e+18,334.837,1643.26,10464,251,112,6291,5338,4131,3424,1180
15808,419,969,0,15808,0,15808,1.3958e+18,350.633,2423.21,15808,376,111,14768,14358,14204,13997,10004
10182,19,32,0,10182,9722,460,2.45289e+16,24.4643,325.247,10182,23,21,10132,10107,9381,9743,8706
29371,472,651,8188,21183,0,29371,6.2869e+13,218.38,2083.88,29371,131,134,28720,28706,28454,28515,23272
19737,66,685,0,19737,0,19737,4.09656e+18,263.424,2008.85,19737,157,141,18085,17113,13060,6351,3576
12691,442,1028,12691,0,11808,883,9.04552e+17,438.713,2455.69,12691,217,158,11473,10991,9853,8534,6416
20464,33,45,0,20464,20319,145,2.58455e+16,34.7589,484.648,20464,28,28,20403,20342,20206,20346,19525
17057,317,1020,15952,1105,15952,1105,5.90498e+17,315.011,2598.33,17057,259,165,15825,15555,15122,15154,10611
45418,648,2278,38726,6692,38726,6692,4.21059e+18,472.311,6013.94,45418,574,267,42853,40975,37539,34527,13051
23856,810,880,5967,17889,0,23856,3.23505e+13,259.242,2182.56,23856,112,233,22976,22968,22942,22960,22298
44064,1103,2266,37921,6143,37921,6143,3.939e+18,489.185,5947.5,44064,569,270,41798,41763,39955,39106,11705
47879,67,650,45247,2632,47879,0,3.63496e+18,324.789,3499.22,47879,273,188,42608,39135,28331,23128,10058
4192,233,282,543,3649,0,4192,4.35349e+11,11.8449,610.445,4192,143,12,3910,3910,3861,3861,3500
35701,5,9,35404,297,35637,64,1.03299e+14,7.52287,353.65,35701,8,8,35622,35559,34739,34739,29479
36066,420,573,36066,0,36066,0,3.32929e+18,319.784,2590.92,36066,192,154,35493,35391,33529,32597,29960
42106,2,14,41626,480,41658,448,8.84416e+13,7.5466,406.655,42106,10,11,37236,36080,35036,35681,25354
45596,912,919,10186,35410,0,45596,1.80322e+13,495.92,3723.91,45596,359,201,44677,44677,44676,44675,44621
8361,417,834,7798,563,7798,563,2.08886e+18,163.265,1791.39,8361,162,140,7527,7394,7288,7247,4894
3148,402,468,3148,0,2897,251,7.89242e+17,62.9247,818.476,3148,137,42,2680,2680,2680,2680,2458
23392,734,1294,21596,1796,0,23392,2.86129e+18,338.636,3504.84,23392,446,114,22098,21904,21750,21418,15691
39212,7,12,39014,198,39148,64,1.03317e+14,8.68841,383.425,39212,11,10,39157,39081,37483,37484,32555
39176,49,82,0,39176,38506,670,2.06171e+16,23.4457,1014.26,39176,34,37,39094,39091,37309,37455,33876
2738,13,21,0,2738,2725,13,2.79493e+16,18.9803,170.021,2738,18,20,2678,2631,2582,2583,2227
43758,461,1191,38534,5224,38534,5224,1.71604e+18,415.298,4633.15,43758,317,205,42461,40994,39273,39165,19640
21297,496,803,16073,5224,0,21297,8.2423e+18,262.472,2186.8,21297,175,152,20494,20396,20083,20101,15786
3070,92,406,2782,288,2782,288,2.82252e+18,92.0124,873.291,3070,114,56,2568,2299,2174,2014,879
34195,1,13,33948,247,34195,0,9.83415e+13,11.2407,365.635,34195,13,11,19089,19089,19089,19089,19089
47256,157,2268,42582,4674,0,47256,3.62036e+18,280.569,5872.6,47256,507,177,43461,40699,38345,37463,5741
17449,38,53,0,17449,16763,686,2.42947e+16,28.7824,552.39,17449,27,28,17396,17383,16723,16834,13226
49592,153,1713,8494,41098,0,49592,2.15587e+13,427.855,5460.33,49592,659,108,46755,46023,42744,27422,10489
37157,1362,1669,34392,2765,34392,2765,2.29258e+18,555.268,4864.22,37157,412,212,35488,35488,35132,35066,32398
20879,239,490,0,20879,5787,15092,1.61831e+16,196.084,1632.32,20879,124,106,20363,19929,19659,19744,13156
6709,584,585,6709,0,5894,815,1.1618e+18,173.008,1471.93,6709,154,92,6124,6124,6124,6124,6124
39633,1195,1428,36062,3571,36062,3571,2.47247e+18,635.365,4688.43,39633,509,173,38205,38183,38092,38097,34335
15995,116,586,12063,3932,12063,3932,3.78702e+18,283.825,1799.42,15995,146,136,14898,14494,11478,12037,3742
48010,4,15,45829,2181,48010,0,9.5735e+13,10.5932,495.593,48010,12,12,45392,44543,41042,37789,19397
33857,621,1306,31569,2288,31569,2288,6.95697e+17,649.395,4091.92,33857,364,222,32113,30541,30716,30662,22866
45777,569,598,45777,0,45777,0,3.26197e+18,335.755,2907.57,45777,200,164,45179,45169,45052,44991,44177
37849,838,1685,29635,8214,0,37849,7.33265e+18,297.214,4573.66,37849,271,197,36164,36153,27603,27700,7793
39810,739,1719,37210,2600,37210,2600,2.03417e+18,605.449,5046.92,39810,430,219,37918,36536,36709,36104,29245
19945,3,63,0,19945,19785,160,2.56294e+16,41.3729,622.966,19945,35,32,16791,15747,12150,11756,8347
27115,251,1151,0,27115,0,27115,1.96734e+18,273.002,2873.88,27115,163,164,25847,25216,22043,20922,2725
20003,1192,1480,20003,0,18569,1434,1.09224e+18,383.933,3506.2,20003,349,191,18523,18522,18459,18265,16883
23257,294,580,15249,8008,23257,0,4.73705e+18,302.229,2295.07,23257,283,130,22524,22020,18204,16395,16010
44447,91,96,0,44447,43821,626,2.09427e+16,30.3667,1113.76,44447,44,34,44351,44351,44351,44351,44156
18200,311,1055,16130,2070,0,18200,3.83525e+18,289.935,2632.66,18200,248,141,16765,16019,15429,15958,8821
31428,237,1219,0,31428,0,31428,1.20264e+18,496.251,3716.9,31428,309,190,29229,28367,26814,24819,15123
1692,44,301,1692,0,1588,104,1.00974e+18,80.1413,563.407,1692,58,76,1165,875,784,674,222
3263,223,519,3000,263,3000,263,2.5457e+18,71.2914,923.507,3263,134,77,2744,2738,2744,2675,1084
12972,1,11,12334,638,12972,0,9.63645e+13,10.3254,255.088,12972,11,11,5051,5051,5051,5051,5051
10649,6,11,10149,500,10649,0,9.61605e+13,9.51066,230.225,10649,11,10,10526,10440,9620,9526,8469
26251,695,698,19783,6468,0,26251,8.3008e+18,322.934,2316.25,26251,192,151,25553,25553,25553,25553,25548
17896,150,870,0,17896,2755,15141,5.77018e+15,179.666,2376.01,17896,366,75,16903,16834,15464,16226,5184
45144,921,1318,0,45144,0,45144,1.21036e+18,710.854,4607.34,45144,413,250,43826,43043,42649,39937,37424
47361,128,2601,47361,0,42491,4870,1.58111e+18,305.105,6245.59,47361,652,238,43253,40888,33601,14529,5754
24781,185,699,21793,2988,21793,2988,3.2381e+18,321.559,2871.56,24781,264,166,23321,22537,19610,17485,9900
43009,659,892,32389,10620,32389,10620,3.81896e+18,410.193,3279.59,43009,248,185,42117,42074,42011,41988,38120
24256,174,1215,0,24256,5411,18845,6.32327e+15,288.061,3069.23,24256,475,98,22609,22385,21028,9452,5296
25556,468,693,19257,6299,19257,6299,3.80487e+18,334.663,2380.47,25556,190,165,24863,24758,24614,24609,20407
12072,161,455,0,12072,3158,8914,7.46074e+15,150.615,1271.67,12072,85,116,11582,10982,10294,10449,5640
7157,480,602,0,7157,0,7157,3.2812e+18,94.7521,1394.88,7157,170,95,6555,6555,6426,6385,4923
24148,681,686,0,24148,0,24148,1.89866e+18,314.647,2809.87,24148,244,160,23462,23462,23462,23462,23365
5941,315,467,5939,2,5939,2,3.83628e+18,18.4839,935.791,5941,267,16,5474,5474,5324,4245,3950
25634,901,1029,22797,2837,0,25634,4.04945e+18,250.792,2657.64,25634,126,193,24605,24600,24503,24552,22667
33843,248,366,33843,0,33843,0,3.88416e+18,245.542,2250.83,33843,155,157,33424,33227,32115,31102,27752
42382,21,69,0,42382,41818,564,2.46086e+16,46.6469,971.642,42382,38,39,42034,41683,39858,37774,20349
28865,4143,5512,28178,687,0,28865,6.26233e+18,13.9799,6013.8,28865,699,22,23353,23353,21987,21914,18101
42485,1,13,42388,97,42485,0,8.09347e+13,7.71602,416.383,42485,9,9,24562,24562,24562,24562,24562
15103,123,735,14101,1002,14101,1002,6.4013e+17,368.364,2132.16,15103,189,166,13505,12098,11065,12004,6724
10948,357,1103,0,10948,2138,8810,6.49617e+15,82.1793,2233.59,10948,276,118,9845,9823,9521,9651,4907
18374,47,88,0,18374,17940,434,2.07851e+16,19.5423,684.329,18374,34,28,18286,18282,18262,18241,14185
27092,1284,1306,6731,20361,0,27092,3.00246e+13,186.846,3109.28,27092,188,171,25786,25786,25786,25786,25692
37400,655,852,37400,0,28203,9197,8.42076e+17,374.719,3023.33,37400,211,195,36548,36524,35983,33338,31909
48752,739,1871,48752,0,43097,5655,1.02206e+18,405.904,5941.1,48752,470,212,46881,46794,43564,36442,18703
4881,405,565,4339,542,4339,542,1.62063e+18,157.877,1268.71,4881,148,83,4316,4252,4285,4304,3458
32739,1118,1549,0,32739,0,32739,1.28214e+18,605.766,4318.85,32739,424,215,31190,31180,30467,28499,25684
35350,1329,1433,0,35350,0,35350,1.99796e+18,289.817,3599.76,35350,261,168,33917,33917,33797,33776,32682
32102,624,2456,32102,0,29303,2799,1.1921e+18,318.472,5487.88,32102,497,265,29646,28945,27334,15641,11163
23281,65,79,0,23281,22768,513,2.1279e+16,19.9162,747.22,23281,28,28,23202,23201,23042,23117,22962
20423,1,10,20285,138,20423,0,1.01534e+14,9.10895,279.647,20423,10,10,10857,10857,10857,10857,10857
16133,666,742,3497,12636,0,16133,1.8721e+13,205.157,2215.22,16133,211,112,15391,15391,15359,15354,14308
6932,178,354,6932,0,6932,0,5.05869e+18,151.233,1122.68,6932,125,86,6535,6310,5353,5355,4415
10148,28,29,0,10148,10129,19,2.12098e+16,25.3931,328.734,10148,25,28,10117,10115,10058,10065,9868
38870,579,616,37267,1603,38870,0,3.80576e+18,288.392,3063.19,38870,251,180,38254,38237,38158,38069,37910
45700,981,1888,0,45700,0,45700,1.84317e+18,281.934,4899.21,45700,522,179,43812,43809,39286,37287,18854
19984,1,12,19570,414,18986,998,8.28482e+13,6.25185,252.967,19984,9,9,11864,11864,11864,11864,11864
33595,4,12,33110,485,32245,1350,8.1925e+13,6.25316,372.965,33595,9,8,32869,32468,29051,29067,28775
26625,4,13,26448,177,26625,0,9.92802e+13,11.0731,321.347,26625,12,10,26257,26107,24486,24716,20620
44827,244,913,0,44827,9944,34883,4.78223e+15,474.033,3650.94,44827,380,197,42836,41857,40605,37310,22053
35085,34,66,0,35085,34846,239,2.55329e+16,54.554,844.699,35085,40,42,34930,34836,33596,33730,28548
33271,1,13,33022,249,33271,0,9.99305e+13,11.812,357.24,33271,12,12,18389,18389,18389,18389,18389
34767,1108,1201,32442,2325,32442,2325,2.05344e+18,631.002,3941.73,34767,361,218,33566,33566,33453,33453,33058
46203,4,10,45887,316,46203,0,1.01318e+14,9.58626,420.566,46203,10,10,45683,45496,40124,42445,35160
7652,355,480,0,7652,1218,6434,5.57059e+15,150.594,1276.14,7652,178,67,7172,7126,7050,7155,5562
21345,460,653,5439,15906,0,21345,2.64165e+13,185.414,2414.54,21345,302,127,20692,20681,20341,20542,16457
16294,465,1245,16294,0,15205,1089,1.01344e+18,463.672,2890.01,16294,346,165,14888,14488,12813,10922,3695
35573,7,47,0,35573,35511,62,2.11091e+16,30.1124,677.831,35573,32,35,32897,31525,27237,28989,21574
35210,1097,2437,32582,2628,0,35210,2.79751e+18,457.176,5341.64,35210,739,211,32773,32499,31854,31681,17262
19419,1045,1293,0,19419,0,19419,1.97293e+18,209.506,2780.8,19419,170,141,18126,18126,18126,18126,17544
39287,4,46,0,39287,39004,283,2.57769e+16,37.4697,701.731,39287,33,34,37946,37434,34480,32721,21719
48860,1482,3015,44120,4740,44117,4743,1.30327e+18,511.184,7322.05,48860,693,291,45845,45566,44913,44881,26422
16178,355,560,12183,3995,12183,3995,7.03779e+18,257.789,1706.06,16178,150,123,15618,15105,15370,15303,11929
39960,321,2140,36556,3404,0,39960,3.14655e+18,383.039,5633.81,39960,593,180,37127,36230,34513,33666,10692
40896,58,733,36802,4094,40896,0,3.6944e+18,342.027,3414.35,40896,257,189,35620,32498,23154,18280,7101
2169,3,24,0,2169,2156,13,2.73082e+16,19.4122,157.187,2169,19,20,1792,1653,1246,1396,969
17367,51,60,0,17367,17162,205,2.4791e+16,23.7443,528.038,17367,25,23,17307,17306,17305,17307,16495
20009,559,1436,17340,2669,19921,88,2.41495e+18,127.735,2950.77,20009,377,66,18573,18508,17272,18557,15838
48212,560,2182,0,48212,0,48212,3.62115e+18,359.41,5510.57,48212,414,237,45872,45075,42840,42410,29469
7483,10,38,0,7483,7460,23,2.19746e+16,8.51249,264.502,7483,17,13,7433,7416,7230,7279,4944
3537,1,8,3529,8,3537,0,1.17062e+14,6.06842,110.242,3537,8,6,1770,1770,1770,1770,1770
20194,915,1356,18055,2139,18053,2141,1.27674e+18,203.493,3125.69,20194,379,133,18838,18830,18646,18780,11415
22644,1153,1403,0,22644,0,22644,1.66107e+18,371.918,3353.96,22644,444,152,21241,21241,21089,21108,20264
45313,1930,2649,0,45313,0,45313,1.71063e+18,356.612,6441.47,45313,599,267,42664,42664,40807,41331,32569
17252,20,62,0,17252,17150,102,2.71991e+16,24.7401,554.839,17252,32,29,17122,17038,16313,15926,14001
40002,1066,1308,0,40002,8600,31402,4.80344e+15,392.775,4252.46,40002,329,205,38694,38678,38589,38581,36088
16273,686,762,14570,1703,0,16273,3.82845e+18,229.843,1978.62,16273,135,140,15511,15507,15455,15442,15076
46659,315,2150,0,46659,9003,37656,6.23775e+15,456.138,5718.24,46659,628,213,43990,43163,40870,29478,12974
42968,1541,2330,0,42968,0,42968,2.62125e+18,460.578,5855.07,42968,574,244,40638,40638,40320,33628,29218
35181,364,929,26541,8640,26541,8640,3.78321e+18,356.649,3029.48,35181,224,187,34123,32864,33051,32978,15407
29621,493,579,26877,2744,29621,0,3.64697e+18,320.633,2684.38,29621,269,148,29042,28959,27631,26936,26182
21886,340,903,21886,0,20385,1501,1.12578e+18,472.504,2736.91,21886,261,180,20541,19780,17930,18578,13880
5812,5,7,5798,14,5812,0,8.26702e+13,6.87801,149.373,5812,7,7,5710,5610,4992,4991,5141
13064,369,763,2612,10452,0,13064,1.44833e+13,87.4916,1786.11,13064,186,83,12301,12265,12233,12051,7317
9498,344,476,0,9498,0,9498,1.94838e+18,162.415,1550.65,9498,174,125,9022,8962,8692,8672,7018
4805,298,629,4497,308,4497,308,1.04225e+18,166.399,1312.47,4805,187,91,4152,3827,3708,3892,2683
21930,74,1467,21930,0,19609,2321,1.48544e+18,208.137,3235.79,21930,436,136,18976,18007,14772,5799,2507
22287,55,448,22287,0,22287,0,4.91465e+18,294.63,2061.8,22287,178,143,19146,16262,12263,10690,5395
17807,516,1230,0,17807,0,17807,1.59128e+18,299.916,3012.01,17807,426,110,16554,16165,15887,13425,10781
34719,1826,2604,34709,10,0,34719,7.21428e+18,24.4863,4876.59,34719,395,25,32115,32115,31330,29039,24123
15002,1057,1072,13974,1028,13974,1028,7.30193e+17,435.531,2670.78,15002,222,174,13930,13929,13928,13926,13821
24067,614,782,0,24067,6310,17757,7.50856e+15,197.193,2128.23,24067,113,135,23285,23280,22998,23066,20550
30891,97,2009,30891,0,30891,0,1.55258e+18,16.8884,3941.19,30891,1006,17,28882,28882,28882,26135,6014
11516,7,8,11461,55,11516,0,1.11774e+14,6.67193,196.648,11516,8,8,11502,11490,11488,11488,9676
15218,109,416,0,15218,4236,10982,1.61611e+16,170.661,1350.78,15218,109,94,14568,14248,12958,13010,6154
2641,6,7,2639,2,2641,0,8.30253e+13,6.7554,99.594,2641,7,7,2623,2605,2306,2305,2585
17593,392,698,0,17593,3985,13608,4.48484e+15,231.837,2092.63,17593,242,131,16895,16681,16354,16390,12910
32055,216,1587,32055,0,28256,3799,2.124e+18,332.795,3599.74,32055,241,299,29907,28936,24728,14550,1880
35484,126,450,35484,0,35484,0,3.90725e+18,266.521,2741.75,35484,246,158,33684,31616,25175,22631,13302
31240,23,41,0,31240,31178,62,1.84389e+16,17.7581,631.805,31240,25,21,31197,31190,30988,31034,26961
25520,481,706,19219,6301,19219,6301,7.04154e+18,323.616,2282.6,25520,182,146,24814,24672,24435,24287,20191
17553,487,736,4483,13070,0,17553,2.66852e+13,325.993,2116,17553,399,95,16762,16448,16264,16262,13709
38533,535,635,8804,29729,0,38533,2.85819e+13,237.03,3062.64,38533,255,142,37898,37897,37745,37857,34402
16682,274,518,16682,0,16682,0,3.55414e+18,332.475,1665.83,16682,424,36,15820,14664,15211,15072,9443
3564,422,426,3183,381,3183,381,2.51617e+18,191.138,947.162,3564,134,86,3138,3138,3138,3138,3133
48020,139,1422,0,48020,0,48020,1.18205e+18,703.217,4882.98,48020,427,258,42770,39688,35822,32107,12330
7226,43,46,0,7226,7125,101,2.58474e+16,22.2461,335.824,7226,25,27,7180,7180,7179,7142,6827
36220,172,787,27289,8931,0,36220,8.30811e+18,361.043,2770.62,36220,215,173,34319,33383,25371,25450,9761
47720,388,995,42041,5679,42041,5679,3.21514e+18,362.242,4397.61,47720,337,214,46684,45462,43109,41610,19972
26469,529,812,0,26469,5907,20562,4.65519e+15,363.964,2727.16,26469,315,158,25630,25208,25046,24979,19675
42922,133,543,42474,448,42922,0,3.78928e+18,289.774,3177.6,42922,258,166,40801,38305,30077,26237,11862
32565,612,1994,28202,4363,28202,4363,3.97989e+18,527.177,4776.64,32565,529,210,30216,28442,26661,24623,6887
42796,7,11,42521,275,42796,0,1.0532e+14,9.12672,406.276,42796,10,10,42699,42558,41265,41266,34355
34150,866,1244,8672,25478,0,34150,4.44929e+13,193.818,3889.27,34150,253,158,32906,32899,31787,32293,21714
42616,4,12,42095,521,42616,0,9.82945e+13,10.824,399.264,42616,12,12,41971,41714,39559,39554,30212
9630,827,912,9630,0,9020,610,9.39341e+17,155.391,1982.95,9630,154,143,8718,8718,8637,8683,8351
4539,390,427,0,4539,1003,3536,4.92121e+15,97.7306,944.73,4539,129,90,4112,4106,4111,4111,3989
47189,777,966,35542,11647,0,47189,8.30958e+18,380.754,3472.5,47189,262,212,46223,46216,46003,45960,42916
36541,1294,1435,0,36541,0,36541,1.45339e+18,661.487,4503.63,36541,515,172,35106,35106,35106,35106,34764
19754,842,1217,0,19754,0,19754,1.50219e+18,360.762,3140.25,19754,426,114,18537,18489,18430,15837,16187
38802,1089,1278,9483,29319,0,38802,3.79905e+13,238.172,4214.19,38802,286,180,37524,37522,37297,37286,33951
49361,804,2887,0,49361,0,49361,1.73442e+18,424.562,6993.34,49361,614,279,46456,46049,44090,34354,20007
44357,530,1190,39033,5324,39033,5324,1.72439e+18,425.68,4658.6,44357,340,217,43167,42076,40546,40658,21959
43106,826,2058,0,43106,0,43106,1.68645e+18,363.705,5379.93,43106,362,199,41048,40567,39453,32194,22803
17675,107,1253,15655,2020,0,17675,3.8654e+18,204.258,2642.99,17675,196,134,15592,14755,14019,14354,2367
46062,11,13,45638,424,46015,47,9.98076e+13,8.94247,450.968,46062,11,10,46049,46049,46047,46049,45913
32794,8,10,32565,229,32794,0,1.00191e+14,9.4438,354.491,32794,10,10,32771,32766,32635,32634,32756
45144,242,691,0,45144,10389,34755,7.3566e+15,231.631,3391.25,45144,267,154,44313,43569,41426,42576,20344
24871,809,1145,23137,1734,23137,1734,2.12312e+18,597.186,3376.25,24871,336,195,23726,22947,23054,22904,19474
45252,354,729,10293,34959,0,45252,2.86743e+13,242.775,3420.73,45252,275,147,44523,44505,43431,43942,27718
22813,532,2130,22813,0,20988,1825,2.79102e+18,209.654,4161.07,22813,409,158,20683,20359,16642,18864,7554
17447,65,409,17447,0,17447,0,4.11788e+18,214.35,1822.48,17447,233,118,15990,15185,10603,9582,5044
49449,503,1788,0,49449,8034,41415,5.21309e+15,405.176,5218.72,49449,617,107,47533,46687,45743,42308,20200
45686,754,3013,41268,4418,41265,4421,1.33826e+18,480.109,7124.73,45686,683,251,42490,42055,39564,39394,11687
49188,419,915,10684,38504,0,49188,1.81977e+13,464.8,3840.41,49188,331,215,47838,46536,45937,40961,34106
15368,291,605,15304,64,15368,0,3.16567e+18,249.518,2015.81,15368,220,108,14704,14340,13324,12517,9081
13582,199,320,13582,0,13582,0,4.03513e+18,200.043,1368.47,13582,116,126,13211,12641,11895,11208,8565
35814,1123,1212,35814,0,33460,2354,9.71582e+17,613.342,4001.76,35814,369,225,34602,34594,34370,34440,33960
20850,19,45,0,20850,20682,168,2.545e+16,35.8523,503.43,20850,27,29,20732,20680,19848,20215,15789
9062,124,476,7953,1109,0,9062,3.91109e+18,159.318,1512.08,9062,171,124,8260,7099,7155,6757,4353
20684,29,31,20220,464,20680,4,1.03832e+14,8.66056,355.053,20684,17,17,20653,20653,20629,20627,20635
21296,18,33,0,21296,20277,1019,2.46363e+16,30.2341,476.568,21296,25,26,21194,21140,19117,20226,17039
49684,7,12,49006,678,49684,0,9.81459e+13,11.1243,431.372,49684,12,12,49635,49623,47501,47506,44772
24345,212,1267,24345,0,22788,1557,9.02456e+17,601.802,3520.01,24345,341,195,21811,21025,18210,16565,9171
10650,321,577,2310,8340,0,10650,1.92938e+13,160.807,1610.08,10650,149,119,10073,9913,9784,9561,7954
29309,367,575,6638,22671,0,29309,2.84133e+13,227.109,2603.12,29309,234,123,28734,28728,28378,28660,21432
13431,875,1249,12617,814,12617,814,7.31854e+17,281.918,2785.74,13431,247,164,12182,12010,11993,12120,10266
11894,184,540,0,11894,0,11894,4.09767e+18,239.817,1485.85,11894,134,120,11133,10822,9588,5994,4650
28200,128,512,28200,0,28200,0,4.95928e+18,271.557,2475.34,28200,178,153,26832,25507,19853,17353,11845
43092,363,478,43092,0,43092,0,5.14868e+18,318.826,2795.88,43092,215,169,42592,42289,41040,39361,37336
10296,282,376,2856,7440,0,10296,6.29615e+13,135.668,1078.79,10296,88,70,9920,9839,9840,9834,8363
20337,715,1229,18248,2089,18248,2089,3.16523e+18,197.947,2957.19,20337,352,122,19108,19069,17642,16596,10722
37613,1452,2521,37613,0,34414,3199,1.16303e+18,353.645,5892.27,37613,499,274,35092,35091,33453,30259,20680
33198,8,11,31591,1607,33198,0,9.61404e+13,10.7065,406.995,33198,11,11,33098,33017,32063,32063,32928
29692,154,385,0,29692,7657,22035,3.25519e+15,277.426,2230.97,29692,218,130,28183,26030,26100,25809,21175
32403,425,464,32403,0,32403,0,4.99008e+18,302.392,2431.5,32403,189,159,31939,31929,31833,31811,31352
17056,25,63,0,17056,16956,100,2.67808e+16,26.3059,554.189,17056,32,31,16975,16961,16308,16112,15028
13596,378,616,10239,3357,10239,3357,3.81611e+18,264.215,1714.55,13596,155,125,12980,12503,12771,12747,9112
34777,1765,2280,29354,5423,29260,5517,2.57e+18,383.867,5265.97,34777,523,231,32497,32497,32351,32405,26423
31967,26,44,0,31967,31699,268,2.72997e+16,19.5269,596.687,31967,24,23,31923,31910,31651,31512,29690
27301,828,1102,25473,1828,25473,1828,2.07909e+18,506.249,3345.55,27301,331,180,26177,25554,25757,25688,23063
11803,446,515,8883,2920,8883,2920,7.04888e+18,208.446,1416.01,11803,125,110,11288,11273,11277,11276,10445
43591,58,2449,43591,0,39327,4264,1.50455e+18,298.81,5965.66,43591,386,308,36368,33623,25754,8296,4208
12923,33,439,12923,0,12414,509,4.24319e+17,298.486,1763.21,12923,193,119,9607,8283,6767,2375,2465
27497,453,465,27497,0,27497,0,3.15877e+18,266.009,2083.88,27497,164,129,27032,27032,27017,27021,26894
17783,148,579,0,17783,0,17783,1.87481e+18,292.868,2305.77,17783,230,152,16563,14883,13839,8008,7022
49379,1074,1930,44507,4872,44507,4872,1.38369e+18,730.572,5929.67,49379,564,203,47374,46682,44189,44434,24723
49676,1305,1412,46419,3257,46419,3257,2.00981e+18,674.12,4905.11,49676,475,244,48264,48259,48153,48148,47315
35266,280,613,9790,25476,0,35266,6.27638e+13,251.355,2230.41,35266,174,139,34610,34129,33262,33483,21100
6786,23,595,1117,5669,0,6786,1.46058e+13,60.1452,1051.86,6786,207,61,5576,5229,4495,4688,772
4185,11,29,0,4185,4159,26,2.66536e+16,21.3892,223.012,4185,23,22,4008,3819,3818,3859,3108
32305,850,2198,0,32305,0,32305,1.77417e+18,261.903,5006.99,32305,472,191,30107,30095,27713,24887,12651
45698,1319,1733,40302,5396,40302,5396,1.74528e+18,392.48,5373.45,45698,365,230,43965,43965,43758,43737,39556
2188,1,11,2105,83,2188,0,9.24963e+13,6.58455,103.787,2188,9,9,887,887,887,887,887
6360,250,529,6360,0,5965,395,1.12323e+18,152.678,1239.22,6360,147,97,5831,5776,5134,5355,3042
31809,779,994,0,31809,0,31809,1.72695e+18,335.875,3827.31,31809,364,174,30815,30815,30592,30683,24817
17062,144,409,0,17062,4348,12714,6.53781e+15,238.063,1815,17062,247,114,15747,14366,14447,15317,4482
44117,74,1425,0,44117,0,44117,1.48062e+18,590.979,4941.66,44117,474,193,36129,33829,30475,3158,4307
29378,788,855,0,29378,6493,22885,4.54509e+15,423.687,2969.32,29378,337,169,28523,28515,28458,28499,28044
12934,61,65,0,12934,12836,98,2.42347e+16,36.22,508.347,12934,34,30,12869,12859,12868,12867,12844
42814,975,978,0,42814,9122,33692,4.76469e+15,408.274,3707.95,42814,309,186,41836,41836,41836,41836,41809
712,4,8,712,0,699,13,7.59034e+13,4.06039,51.1341,712,6,6,702,701,690,692,665
2369,27,249,2213,156,0,2369,2.40899e+18,114.724,584.54,2369,81,59,1615,1194,1123,1115,551
24306,215,793,0,24306,5407,18899,4.66939e+15,397.304,2666.06,24306,309,168,22991,22538,21542,19618,8181
31948,566,1211,0,31948,0,31948,1.50819e+18,388.134,4011.72,31948,408,184,30737,30411,29012,28282,21749
35318,563,615,32574,2744,35318,0,3.8238e+18,321.741,3015.94,35318,278,151,34703,34696,34550,34566,33890
49236,2177,2649,44243,4993,44241,4995,9.83083e+17,301.502,6233.08,49236,438,245,46587,46586,46587,46586,43444
17953,88,564,15589,2364,17953,0,2.90856e+18,278.795,2061.3,17953,241,115,16205,14368,13315,11059,4876
13608,228,310,13608,0,13608,0,3.39118e+18,205.281,1288.3,13608,101,160,13250,13058,12751,12639,10726
507,53,93,475,32,475,32,1.96051e+18,25.8363,173.316,507,40,27,414,379,412,390,250
12404,32,36,0,12404,12352,52,1.9124e+16,12.2279,406.738,12404,17,20,12368,12368,12344,12355,11923
9839,684,760,9159,680,9159,680,2.15152e+18,317.297,1796.08,9839,227,137,9079,9001,9055,9045,8836
31598,10,13,31387,211,31598,0,1.00233e+14,11.2893,348.593,31598,12,11,31576,31565,30270,30268,26527
11109,254,593,2368,8741,0,11109,2.44125e+13,150.89,1642.56,11109,271,79,10516,10462,9547,9469,4220
17565,276,408,0,17565,4114,13451,7.52106e+15,184.739,1820.6,17565,189,104,17157,16962,16816,16931,11952
3325,19,20,0,3325,3150,175,2.5009e+16,13.9224,165.202,3325,16,16,3305,3304,3305,3305,3284
27519,468,758,0,27519,5978,21541,4.79191e+15,388.357,2792.28,27519,264,179,26663,26052,25773,25581,19723
48007,648,1010,36222,11785,36222,11785,6.97484e+18,375.75,3399.68,48007,250,196,46997,46927,46061,45568,35896
43478,2020,2486,37183,6295,37089,6389,2.38805e+18,468.647,6217.95,43478,523,275,40992,40992,40985,40987,36679
17547,183,411,17547,0,17547,0,5.26096e+18,260.84,1792.47,17547,178,107,16717,16242,12019,12777,8669
12611,7,41,0,12611,12584,27,2.12328e+16,28.2937,395.824,12611,27,31,11686,11163,9726,10323,7022
7215,107,327,1630,5585,0,7215,2.81529e+13,132.683,1099.9,7215,143,69,6827,6660,5728,3819,2474
25389,586,2067,25389,0,23488,1901,4.42672e+18,346.038,4138.87,25389,798,120,23322,22859,17112,17603,9505
34792,45,56,0,34792,34354,438,2.57562e+16,40.7348,797.749,34792,34,37,34729,34671,34014,34267,32739
4021,4,29,0,4021,4015,6,2.11819e+16,22.6879,209.137,4021,21,23,3420,3187,2846,2846,1835
33963,2260,3013,0,33963,0,33963,1.086e+17,14.7123,4846.76,33963,1054,22,30950,30950,30201,30359,28083
15142,468,720,0,15142,3314,11828,4.8397e+15,239.624,2032.62,15142,212,130,14422,14271,14056,14035,11170
4218,73,612,3951,267,3951,267,1.90106e+18,97.6472,1198.16,4218,118,117,3368,2963,2845,3012,856
1982,13,145,0,1982,0,1982,4.23485e+18,62.4415,396.906,1982,53,59,1069,692,629,577,241
46798,123,1515,43744,3054,43744,3054,6.6668e+17,753.332,5011.34,46798,463,251,40779,36576,32872,35815,12990
31753,5,13,31512,241,31753,0,9.92827e+13,12.5002,352.12,31753,12,12,31533,31383,29854,29540,19312
5970,158,452,5970,0,5349,621,1.76556e+18,166.715,1071.53,5970,90,102,5394,5034,4642,5158,2389
37331,20,95,0,37331,36795,536,2.07327e+16,29.0093,1014.9,37331,43,32,37152,37041,34928,35136,22613
8417,8,9,8162,255,7969,448,8.61783e+13,5.21504,162.852,8417,9,6,8408,8408,8407,8407,7965
18944,4,410,18944,0,18944,0,4.97137e+18,243.679,1828.33,18944,162,134,8358,5939,4794,3633,1999
15500,5,11,15463,37,14754,746,8.32442e+13,6.66568,259.078,15500,9,8,15253,14997,13455,13451,13061
11647,9,12,11599,48,11361,286,8.2072e+13,6.74594,226.283,11647,10,8,11635,11635,11631,11630,11134
49010,17,972,10714,38296,0,49010,1.88209e+13,488.582,3918.86,49010,361,210,36666,31731,27370,12493,7718
48929,54,77,0,48929,48444,485,2.6002e+16,45.6438,1046,48929,38,47,48849,48806,47334,47969,41689
15586,351,977,14590,996,0,15586,2.34443e+18,371.222,2485.33,15586,275,152,14435,14102,13661,13638,9342
40328,1896,1954,40328,0,36060,4268,1.63572e+18,280.016,4590.53,40328,436,178,38374,38374,38374,38374,37839
48538,29,66,0,48538,47882,656,2.50891e+16,44.6553,997.328,48538,41,42,48362,48249,46269,45799,32129
29922,372,1364,26195,3727,26195,3727,1.80252e+18,337.225,4052.86,29922,304,173,28268,27106,25415,26222,12224
31929,63,605,30506,1423,30506,1423,1.41349e+18,450.304,2962.43,31929,257,174,25612,23244,22640,23252,7534
8979,465,653,8387,592,8387,592,2.05221e+18,207.885,1562.31,8979,147,105,8326,8219,8209,8211,7733
18540,948,1207,0,18540,4388,14152,7.35704e+15,137.931,2474.92,18540,316,133,17333,17333,16952,17000,14529
12780,272,414,12780,0,12780,0,5.09403e+18,202.853,1625.51,12780,147,106,12366,12218,11247,10675,9250
27870,1935,1966,25308,2562,0,27870,3.37168e+18,262.923,4523.63,27870,472,138,25904,25904,25902,25902,25797
2766,147,336,0,2766,0,2766,1.98726e+18,95.5672,667.424,2766,182,44,2430,2177,2090,2206,1026
14196,465,832,0,14196,0,14196,1.95521e+18,246.725,2147.14,14196,206,120,13364,13314,12556,13091,9251
5065,15,42,0,5065,5053,12,2.85101e+16,17.3159,249.872,5065,21,19,5006,4973,4797,4841,3775
46931,1928,7944,6597,40334,0,46931,1.51561e+13,10.3174,8934.55,46931,1195,22,38987,38987,30394,18096,15981
11879,474,512,0,11879,0,11879,1.86229e+18,256.301,1799.63,11879,187,136,11367,11367,11325,11339,10375
38218,1504,1779,34486,3732,34486,3732,1.38835e+18,650.688,5055.99,38218,518,175,36439,36435,36349,36431,33184
16879,577,989,14699,2180,0,16879,3.94367e+18,235.324,2601.34,16879,222,148,15890,15888,15671,15680,15098
1997,93,455,1854,143,1854,143,2.2684e+18,40.0836,750.733,1997,98,41,1542,1451,1363,1345,590
20369,435,1088,17807,2562,0,20369,3.97351e+18,256.987,2969.49,20369,239,152,19281,19120,18172,18197,12205
39369,766,955,29691,9678,29689,9680,3.79756e+18,409.146,3307.13,39369,239,194,38414,38407,38334,38311,35014
45836,474,868,34523,11313,34523,11313,3.81394e+18,397.557,3328.85,45836,252,192,44968,44644,44155,44017,32997
46480,777,1938,0,46480,0,46480,1.22757e+18,566.913,5801.01,46480,397,269,44514,43332,42698,36051,28197
41961,7,10,41682,279,41961,0,1.01613e+14,9.39151,401.249,41961,10,10,41847,41675,40014,40015,36981
43891,38,62,0,43891,43585,306,2.5777e+16,50.4622,915.074,43891,42,42,43755,43654,42224,42216,36825
24871,387,1206,22483,2388,22483,2388,2.47238e+18,339.746,3538.96,24871,397,147,23599,22230,21435,19213,9402
19804,43,52,0,19804,18962,842,2.45094e+16,27.956,569.194,19804,27,27,19752,19748,19414,19632,18371
9506,124,456,0,9506,0,9506,1.91906e+18,198.953,1277,9506,96,115,8622,8117,7751,4565,2698
22898,216,443,22898,0,22898,0,4.99317e+18,292.584,2075.05,22898,177,138,22201,21662,18011,17267,14744
23359,415,1704,23359,0,21805,1554,1.90998e+18,284.05,3785.29,23359,385,181,21550,20937,19452,20008,8832
19009,395,505,19009,0,19009,0,3.36228e+18,268.22,2198.27,19009,189,128,18504,18493,18149,17623,16125
26770,270,1719,26770,0,24912,1858,9.38658e+17,388.886,4414.27,26770,307,246,24491,23825,20997,19950,5396
24130,519,1679,22015,2115,22015,2115,2.74146e+18,301.009,3879.33,24130,441,114,22443,21917,20789,18297,10795
43036,1995,2400,43036,0,39024,4012,1.16149e+18,324.687,6091.68,43036,771,150,40636,40636,40636,40636,32259
38792,1012,1083,8661,30131,0,38792,1.88225e+13,440.618,3738.34,38792,316,199,37709,37709,37637,37648,37026
40886,11,922,8934,31952,0,40886,1.81201e+13,465.73,3527.52,40886,342,203,28298,24764,20671,9575,6089
27794,1,10,27608,186,27794,0,1.00786e+14,9.21012,326.525,27794,10,10,14758,14758,14758,14758,14758
41275,538,635,11481,29794,0,41275,6.3123e+13,269.397,2420.96,41275,190,138,40640,40633,40511,40434,38331
45668,523,1820,11382,34286,0,45668,3.07911e+13,383.999,4239,45668,343,160,43848,43572,37079,37913,6224
17185,470,601,12930,4255,0,17185,8.33033e+18,261.629,1775,17185,144,125,16584,16554,16499,16511,14600
38362,1841,2478,34556,3806,0,38362,3.46389e+18,371.14,5852.92,38362,640,246,35884,35811,35848,35844,30962
20424,9,11,19494,930,20424,0,9.60308e+13,10.0918,318.66,20424,11,11,20404,20392,19906,19907,20399
16978,377,421,16978,0,16978,0,3.06329e+18,226.394,1630.58,16978,142,116,16557,16554,16396,16422,16018
31849,1,13,31640,209,31849,0,1.01741e+14,10.8564,351.693,31849,12,11,17455,17455,17455,17455,17455
31502,76,2023,0,31502,0,31502,3.36036e+18,325.265,4673.83,31502,369,213,27679,25670,20962,7006,4442
1933,264,305,0,1933,0,1933,7.7797e+17,96.1604,582.642,1933,104,55,1628,1600,1621,1625,1562
45940,1519,1664,41427,4513,0,45940,3.30718e+18,581.403,5184.47,45940,624,192,44276,44260,44192,44254,42119
14866,628,679,0,14866,3186,11680,4.65348e+15,293.213,2046.45,14866,233,144,14187,14187,14158,14175,13898
31260,2,10,31199,61,31260,0,8.01928e+13,6.81705,352.44,31260,7,8,25560,23615,24364,24319,20611
28003,8,718,24620,3383,24620,3383,3.23457e+18,328.91,3092.04,28003,268,182,15517,11284,10823,8498,1846
1803,152,161,0,1803,0,1803,4.34339e+18,61.7565,398.879,1803,52,56,1642,1642,1642,1642,1623
30193,991,2704,27749,2444,27749,2444,1.38894e+18,299.859,5322.91,30193,681,208,27489,27075,24054,25428,14331
29051,4189,4630,29051,0,29051,0,5.20728e+18,12.2621,6660.85,29051,938,19,24421,24421,24421,24421,22858
43326,1076,1438,39199,4127,0,43326,2.92301e+18,644.385,4923.77,43326,521,185,41888,41487,41727,41742,34387
24128,397,432,24128,0,24128,0,5.18293e+18,258.036,2042.56,24128,176,139,23696,23650,23611,23571,23490
25173,1377,1776,23471,1702,23471,1702,2.136e+18,298.512,4091.1,25173,567,137,23397,23329,23064,23009,20042
3082,314,359,487,2595,0,3082,1.85441e+13,63.8647,697.467,3082,127,55,2723,2723,2723,2723,2539
41922,297,1647,37625,4297,0,41922,3.17929e+18,501.428,4935.74,41922,473,194,38997,35059,33972,34064,11103
20922,714,1137,20922,0,19517,1405,9.75818e+17,522.866,3112.35,20922,318,184,19699,19043,18080,17748,15423
37802,474,7216,37802,0,36902,900,5.09755e+17,14.986,7816.43,37802,912,23,30586,30586,25589,3083,2842
12084,4,12,11931,153,12084,0,8.35063e+13,5.88547,220.542,12084,8,9,11927,11826,11075,11088,9669
36901,1819,2416,36901,0,33325,3576,1.44544e+18,298.23,5615.85,36901,383,305,34485,34485,33513,33342,28614
18122,154,855,16223,1899,16223,1899,8.94681e+17,249.152,2248.4,18122,132,147,16591,15230,15357,14508,4019
3372,57,435,3056,316,0,3372,3.33724e+18,128.125,940.902,3372,122,68,2662,2383,2177,2158,817
8399,70,855,7485,914,7485,914,3.36532e+18,195.551,1778.72,8399,234,104,6913,6339,6228,5555,2275
35372,770,1523,0,35372,7050,28322,6.70239e+15,338.059,4305.4,35372,391,196,33849,33665,33358,32296,19667
14443,189,1058,0,14443,0,14443,1.45283e+18,336.266,2653.19,14443,390,116,12749,11653,11534,6563,4216
26503,775,874,5830,20673,0,26503,1.81615e+13,402.05,2831.92,26503,339,156,25629,25624,25532,25562,24947
21542,10,11,20491,1051,21542,0,9.63257e+13,10.1256,327.717,21542,11,11,21526,21521,21139,21139,21524
31763,648,1357,28742,3021,0,31763,3.00791e+18,367.978,4084.27,31763,409,162,30406,30148,28397,28508,15770
27847,8,10,27667,180,27847,0,1.01969e+14,9.31034,327.034,27847,10,10,27827,27823,27704,27703,27815
18557,39,59,0,18557,18454,103,2.66998e+16,27.2833,512.053,18557,28,30,18494,18465,18390,18340,17519
43668,1424,1742,43668,0,39322,4346,7.7525e+17,512.195,5280.21,43668,440,177,41926,41895,41765,41763,34803
11267,2021,2157,1608,9659,0,11267,7.01627e+12,9.96831,2427.69,11267,279,18,9110,9110,8977,8592,8693
17364,420,448,0,17364,3938,13426,7.26567e+15,205.755,1876.23,17364,196,102,16916,16916,16889,16906,16469
4253,10,482,3767,486,0,4253,4.09268e+18,201.811,1091.8,4253,180,81,2395,1868,1653,1428,212
42946,303,1351,40133,2813,40133,2813,6.61459e+17,658.066,4559.78,42946,381,241,39821,38632,37169,37297,22529
38820,3,14,38605,215,38820,0,9.23461e+13,10.0854,398.9,38820,12,11,37268,36654,32972,33827,27836
11762,408,902,0,11762,1757,10005,5.01816e+15,109.397,1817.96,11762,271,80,10860,10812,10668,10837,6300
28038,486,743,28038,0,21092,6946,8.24922e+17,345.807,2547.53,28038,214,163,27295,27093,26562,24563,20957
15175,723,1163,15175,0,13211,1964,1.16345e+18,225.553,2752.13,15175,234,149,14012,14010,13557,13420,11713
21592,125,1781,19972,1620,19972,1620,2.36912e+18,174.043,3493.97,21592,580,210,19406,17184,17978,17549,5303
21568,324,617,16257,5311,16257,5311,6.99215e+18,294.555,1999.33,21568,162,138,20878,20159,20225,19677,14634
39229,354,518,39229,0,39229,0,3.39038e+18,442.116,2533.41,39229,516,47,38148,34309,36780,36326,26927
28192,1362,1898,28192,0,26079,2113,1.5516e+18,420.008,4641.44,28192,453,181,26294,26240,25923,25940,21801
15334,2005,2936,15334,0,14969,365,4.83793e+17,14.964,3312.95,15334,377,23,12398,12398,11803,12398,8627
11676,346,667,10446,1230,0,11676,3.85222e+18,184.987,1626.54,11676,101,129,11009,10971,10309,10298,5994
5967,596,978,5336,631,5336,631,2.57694e+18,136.328,1731.06,5967,239,137,4989,4970,4917,4904,2826
13981,6,7,13969,12,13981,0,8.09337e+13,6.95487,230.996,13981,7,7,13887,13705,11768,11769,13753
14503,114,372,14501,2,14503,0,4.06231e+18,212.074,1666.28,14503,162,108,13456,12144,8986,9082,5038
26784,786,1151,25058,1726,25058,1726,6.20379e+17,616.974,3469.02,26784,316,200,25537,24690,25108,24945,23393
44534,514,1292,41546,2988,41546,2988,2.06964e+18,668.108,4490.45,44534,378,230,42377,40574,40341,39964,27973
42692,1251,1438,39912,2780,0,42692,2.39759e+18,596.305,4614.9,42692,380,249,41254,41027,40982,41002,36974
6546,229,514,6088,458,0,6546,2.56451e+18,139.162,1219.44,6546,131,78,6032,5996,5820,5837,4306
35433,639,1212,0,35433,0,35433,1.21381e+18,578.937,3938.94,35433,380,212,33909,32675,32766,29023,27951
25347,139,896,0,25347,0,25347,1.93574e+18,270.128,2544.53,25347,149,166,23339,21631,20672,16883,5116
30710,46,75,0,30710,29852,858,1.97332e+16,30.1702,791.588,30710,29,34,30635,30624,30396,30351,20058
27800,802,1785,0,27800,0,27800,1.42407e+18,369.171,4347.85,27800,490,142,26015,25748,24919,22271,13597
18880,532,755,0,18880,4160,14720,4.74034e+15,315.665,2350.73,18880,243,153,18125,17810,17755,17811,15173
29179,172,440,29179,0,29179,0,5.30479e+18,264.5,2239.91,29179,199,140,28318,27615,21385,19940,16644
30718,17,45,0,30718,30618,100,2.72861e+16,19.4281,581.11,30718,24,24,30642,30524,30142,30241,21449
4246,216,301,4246,0,4246,0,4.00234e+18,99.7381,725.529,4246,151,39,3945,3902,3863,3936,3378
6394,21,35,0,6394,6384,10,2.11756e+16,24.6756,276.007,6394,24,25,6331,6274,5693,5982,5675
12679,570,1067,12679,0,11772,907,9.41365e+17,453.577,2500.81,12679,240,155,11566,11104,10219,9196,5775
44270,6,15,43222,1048,40176,4094,7.98839e+13,10.209,410.452,44270,10,10,44208,44136,41854,41851,35343
3164,300,413,2977,187,0,3164,2.23368e+18,88.03,809.279,3164,116,62,2751,2733,2733,2701,2090
15597,47,1663,13940,1657,13940,1657,1.17017e+18,174.851,3356.53,15597,298,216,12545,11268,9010,9715,1502
45654,1256,1970,45654,0,41155,4499,7.73086e+17,729.76,5780.95,45654,573,188,43684,43072,41847,39553,27655
24554,235,763,0,24554,5482,19072,4.70427e+15,370.06,2617.53,24554,301,158,23334,22931,22227,21104,13279
47458,52,58,0,47458,46840,618,2.19067e+16,22.0687,983.646,47458,32,28,47400,47400,47400,47400,47022
31777,1202,1244,31777,0,29663,2114,9.66244e+17,636.523,3873.38,31777,361,217,30533,30530,30453,30433,30395
41112,60,62,0,41112,40717,395,2.59875e+16,32.7324,762.448,41112,36,33,41050,41050,41050,41049,41028
42162,8,68,0,42162,41958,204,2.65213e+16,32.6152,810.991,42162,32,33,41636,41361,38034,38924,26349
10973,9,12,10820,153,10973,0,9.50137e+13,9.15474,201.681,10973,10,10,10958,10954,10602,10601,10386
47004,710,1844,0,47004,0,47004,1.22679e+18,532.347,5568.9,47004,393,279,45158,44384,43172,38181,20887
45560,754,938,0,45560,10744,34816,7.12948e+15,235.556,3836.58,45560,360,162,44622,44622,44434,44507,38917
39180,79,96,0,39180,38304,876,2.01754e+16,30.6775,1023.45,39180,43,36,39084,39084,39076,39082,34913
31736,2,13,31505,231,31736,0,9.7704e+13,12.0337,351.136,31736,12,12,28762,27908,22324,27698,19820
6024,704,1011,0,6024,0,6024,2.105e+16,7.48738,1385.17,6024,507,9,5013,5013,4861,4861,3960
16106,563,734,3694,12412,0,16106,1.68995e+13,207.551,2012.92,16106,243,131,15372,15275,15237,15252,12974
33041,751,923,7133,25908,0,33041,1.89674e+13,332.65,3237.92,33041,276,164,32118,32118,32069,32063,30173
28405,794,842,6260,22145,0,28405,1.90065e+13,408.426,2910.52,28405,346,159,27563,27563,27528,27563,27268
38959,1338,2204,35264,3695,0,38959,3.35414e+18,276.683,5405.91,38959,476,249,36755,36755,36455,36594,24198
44555,410,518,44555,0,44555,0,3.45382e+18,440.881,2761.64,44555,516,48,43611,41987,42883,42510,36538
33835,933,2008,29384,4451,29384,4451,3.89654e+18,521.973,4937.84,33835,531,227,31827,31200,29667,28667,7871
27089,89,194,0,27089,26039,1050,2.52279e+16,26.697,1022.42,27089,75,39,26895,26878,26347,26311,22411
2059,63,172,1538,521,1538,521,7.34278e+18,63.9267,431.351,2059,55,58,1870,1698,1555,1547,1007
27342,33,34,0,27342,26005,1337,2.4702e+16,30.9858,543.096,27342,27,28,27308,27307,27296,27285,26636
23286,188,615,19626,3660,23286,0,3.55103e+18,322.949,2466.17,23286,235,137,22138,21249,17930,15197,8309
19413,287,1264,3827,15586,0,19413,2.40562e+13,149.631,3018.67,19413,315,169,18149,18005,17441,17164,6980
532,7,130,0,532,0,532,2.14967e+18,25.1353,197.552,532,43,19,363,294,276,55,54
33083,512,2102,29980,3103,29980,3103,2.79777e+18,266.301,4947.96,33083,481,240,30981,30496,29652,28667,12771
32982,331,485,32758,224,32982,0,3.90688e+18,276.645,2713.28,32982,243,149,32488,32378,30114,29810,26137
25190,511,736,19021,6169,19021,6169,6.94239e+18,297.647,2294.7,25190,176,152,24454,24402,24189,24104,19583
8928,239,1105,8928,0,8142,786,8.42004e+17,206.314,2183.6,8928,355,110,7639,7060,6619,4374,2252
13994,364,571,0,13994,0,13994,4.13922e+18,247.797,1613.85,13994,143,121,13423,12968,13211,13151,10090
11284,689,902,10515,769,10515,769,2.08021e+18,225.984,2091.41,11284,192,148,10382,10285,10288,10298,8093
38009,12,13,37671,338,37924,85,9.89374e+13,8.5404,441.218,38009,11,10,37996,37996,37995,37996,37683
30451,12,13,30157,294,30382,69,9.91833e+13,8.30804,388.15,30451,11,10,30438,30438,30437,30438,30258
43252,6,12,43074,178,43188,64,1.06878e+14,8.4674,401.754,43252,11,11,43154,43058,41293,41288,31772
5309,528,779,4987,322,4987,322,1.04665e+18,115.796,1409.55,5309,356,49,4530,4470,4438,4518,3243
16403,1142,1184,15243,1160,15243,1160,1.22437e+18,327.342,2807.14,16403,371,129,15219,15219,15219,15219,14941
48588,1729,3399,47352,1236,0,48588,7.35568e+18,62.3349,6238.02,48588,1563,23,45189,45132,43426,43617,28838
7806,4,23,0,7806,7715,91,2.40562e+16,7.56213,245.46,7806,13,12,7632,7588,6679,6570,4436
33570,4,13,33248,322,33570,0,1.0122e+14,10.119,356.041,33570,11,11,33142,32971,31112,31309,25325
17761,6,12,17510,251,17761,0,9.47232e+13,10.6317,257.479,17761,11,11,17709,17684,16918,16882,14919
9862,190,429,2513,7349,0,9862,2.98668e+13,136.803,1140.76,9862,90,101,9433,9287,8722,9003,5903
47221,26,36,0,47221,44960,2261,2.46354e+16,31.5505,717.74,47221,32,32,47124,46990,45233,45416,42324
30365,2878,5069,30365,0,30365,0,2.86182e+18,7.49718,6498.9,30365,2537,9,25296,25296,24201,23107,16286
6092,267,272,6092,0,6092,0,5.46039e+18,122.99,891.686,6092,104,76,5820,5820,5819,5819,5812
21597,322,655,0,21597,0,21597,1.87604e+18,328.132,2644.6,21597,233,157,20782,20182,18502,18651,10327
47232,1800,1961,0,47232,11682,35550,7.52393e+15,211.512,4566.25,47232,429,161,45271,45271,45058,45107,42873
14983,13,25,0,14983,14963,20,1.11769e+16,7.07462,372.729,14983,16,12,14958,14958,14360,14506,10307
43519,696,1325,9484,34035,0,43519,1.88765e+13,376.227,4406.83,43519,361,211,42194,42069,40668,39577,26916
5657,520,738,5657,0,5155,502,4.94902e+18,96.1658,1384.21,5657,226,90,4919,4919,4046,4306,3703
14352,145,700,14352,0,12650,1702,1.14766e+18,357.139,2294.64,14352,206,138,12764,10668,10508,7063,3927
19171,508,545,19171,0,19171,0,3.68592e+18,228.04,2083.47,19171,160,152,18626,18626,18536,18552,17999
12758,249,461,12758,0,12758,0,3.35234e+18,232.264,1750.25,12758,159,114,12208,11981,10930,9347,7692
37014,461,667,10302,26712,0,37014,6.30852e+13,247.895,2335.38,37014,180,140,36347,36303,35986,35906,30631
10045,5,23,0,10045,10033,12,7.46044e+14,12.3176,305.274,10045,20,6,9997,9993,9959,9898,6414
48296,6720,7671,48296,0,48296,0,4.04903e+18,16.7003,9068.3,48296,1264,26,40625,40625,40625,40625,36764
47838,82,1333,44650,3188,44650,3188,2.05075e+18,707.047,4736.87,47838,407,250,40030,34610,34031,34434,10407
30821,143,612,24098,6723,30821,0,4.23931e+18,314.146,2737.42,30821,272,151,29070,26635,20946,18136,11377
21801,35,1643,21794,7,0,21801,7.20685e+18,25.5504,3129.44,21801,347,22,20158,20030,18530,17642,3666
43270,436,473,43270,0,43270,0,5.10494e+18,311.48,2807.5,43270,207,167,42797,42789,42582,42512,41828
38115,1688,1792,34030,4085,34030,4085,1.37999e+18,447.054,5061.72,38115,497,172,36323,36323,36318,36319,36205
29119,146,1276,29119,0,27171,1948,9.66298e+17,607.89,3786.55,29119,375,207,25797,23925,19986,20896,10365
41725,23,46,0,41725,41425,300,2.56783e+16,37.5369,702.8,41725,32,34,41567,41443,40614,41145,34677
14846,26,349,14846,0,14846,0,3.90438e+18,191.233,1499.42,14846,126,124,11401,8506,6162,5549,1777
48721,873,1774,43999,4722,43999,4722,1.37398e+18,714.427,5728.33,48721,577,203,46724,46083,43599,43241,27556
19321,289,1671,18814,507,18814,507,3.12299e+18,319.882,3312.01,19321,303,120,17235,16304,12983,11625,4936
45687,213,646,45687,0,43710,1977,5.00513e+17,503.095,3656.62,45687,276,202,41831,36978,32366,8462,30455
45513,1412,1975,10476,35037,0,45513,2.68583e+13,209.989,4946.87,45513,411,180,43538,43519,43291,43536,37199
24582,1542,1710,22362,2220,0,24582,3.32504e+18,268.096,3986.22,24582,444,122,22872,22872,22695,22671,21754
36288,326,807,36288,0,27342,8946,8.71388e+17,381.962,2944.71,36288,232,182,35155,33491,32400,29491,17581
44394,72,78,0,44394,43900,494,2.51132e+16,44.5812,997.484,44394,36,45,44316,44316,44187,44052,43026
1910,3,18,0,1910,1903,7,2.94644e+16,6.76335,112.7,1910,10,8,1757,1707,1374,1491,1339
42621,1165,1542,42621,0,37523,5098,1.08459e+18,390.938,5164.93,42621,372,209,41079,41079,40217,39715,31164
2680,1,10,2661,19,2680,0,9.6836e+13,4.96903,98.6356,2680,8,7,1517,1517,1517,1517,1517
13382,891,936,12525,857,0,13382,2.34784e+18,355.718,2295.2,13382,196,160,12446,12287,12435,12429,12319
20439,298,552,17873,2566,20439,0,3.48193e+18,305.342,2200.25,20439,233,129,19782,19387,18123,16186,14027
23454,1541,1648,21690,1764,0,23454,2.80106e+18,304.642,3637.81,23454,618,119,21806,21804,21806,21806,21121
42965,426,2724,39160,3805,0,42965,3.16908e+18,520.657,6534.64,42965,620,239,39784,38558,36877,35876,9019
48082,188,1795,37191,10891,37188,10894,3.47906e+18,362.811,5188.11,48082,393,244,44915,43667,36267,37312,2613
5399,263,316,1216,4183,0,5399,1.85587e+13,81.3769,828.661,5399,89,67,5083,5083,5040,5042,4761
31150,293,1127,31150,0,27666,3484,2.06541e+18,320.042,3108.06,31150,130,281,29790,29018,25173,27971,10358
41777,245,1416,37551,4226,37551,4226,2.5688e+18,491.916,4735.51,41777,473,194,38097,34081,34075,30420,8770
17468,22,25,16662,806,17465,3,9.56358e+13,9.71817,334.449,17468,13,14,17443,17443,17442,17442,17378
39604,1209,1455,0,39604,0,39604,3.83068e+18,319.436,4185.86,39604,242,211,38149,38149,37848,37722,32686
41015,2025,2326,36953,4062,36953,4062,2.9932e+18,262.853,5458.23,41015,404,227,38689,38689,38689,38689,37191
26036,667,704,26036,0,19626,6410,8.21129e+17,328.881,2372.72,26036,184,156,25332,25330,25299,24756,25001
49686,609,2889,0,49686,0,49686,1.73569e+18,403.265,7001.82,49686,607,276,46609,46140,43818,30002,17503
2274,19,21,0,2274,2270,4,1.59706e+16,9.25066,138.123,2274,12,12,2253,2253,2247,2250,2056
11406,263,577,0,11406,0,11406,1.44914e+18,313.149,1928.65,11406,241,137,10324,9156,9731,9816,6953
16047,336,804,0,16047,0,16047,1.24261e+18,343.952,2222.17,16047,201,143,15028,14577,14429,13803,11069
32242,1208,1389,0,32242,0,32242,1.1706e+18,510.415,4102.79,32242,345,228,30853,30723,30702,30709,28221
36410,799,891,0,36410,8129,28281,4.62311e+15,435.623,3270.99,36410,344,177,35519,35491,35384,35440,34628
36832,825,856,8303,28529,0,36832,1.79132e+13,452.301,3278.53,36832,352,193,35976,35976,35967,35934,35650
2360,11,31,0,2360,2326,34,2.61973e+16,19.1496,171.988,2360,22,20,2254,2175,2124,2051,1361
49623,1099,1258,43680,5943,43680,5943,1.7192e+18,421.175,5007.63,49623,347,214,48365,48365,48175,48242,45595
19998,37,754,15081,4917,0,19998,8.2778e+18,260.996,2081.09,19998,164,147,16425,9158,11164,11005,2338
26282,506,1815,26282,0,22702,3580,9.43414e+17,262.423,4588.86,26282,402,203,24467,24044,21881,21814,9766
28364,716,1097,26557,1807,26557,1807,1.97793e+18,547.141,3460.3,28364,330,184,27148,26200,26302,26077,24389
33456,1248,1747,29588,3868,29588,3868,3.5903e+18,304.105,3956.56,33456,345,281,31709,31709,30037,29577,22983
24311,1352,1943,24311,0,21783,2528,1.33884e+18,214.628,4054.02,24311,492,131,22368,22368,21537,21936,15089
31250,903,1234,31250,0,23997,7253,8.38269e+17,314.934,3682.09,31250,272,195,30016,30016,28896,26453,21457
37917,139,506,37917,0,37917,0,3.30386e+18,302.898,2516.2,37917,199,143,36407,35500,27999,27111,11864
49233,1,11,48855,378,49233,0,1.0144e+14,9.14458,436.103,49233,10,10,25683,25683,25683,25683,25683
32451,297,1125,24743,7708,24743,7708,6.74903e+18,297.733,3399.32,32451,208,199,31126,30031,21915,16455,4178
1542,40,186,1542,0,1437,105,1.05873e+18,98.3171,431.634,1542,64,52,1061,795,769,793,623
4098,144,331,4098,0,3088,1010,7.99853e+17,65.8145,762.282,4098,88,78,3767,3752,3412,3255,1878
1795,140,415,1644,151,1644,151,2.64146e+18,30.3866,612.201,1795,95,40,1380,1350,1367,1361,595
38848,1346,2465,35413,3435,35413,3435,2.65624e+18,393.22,5957.7,38848,553,240,36383,36315,35644,35723,20742
41768,1576,2027,37748,4020,37748,4020,2.99563e+18,320.143,5175.44,41768,490,210,39741,39741,38075,37867,29469
26963,1118,1248,26963,0,25195,1768,9.23404e+17,585.7,3633.22,26963,329,203,25715,25677,25619,25625,24932
20616,451,1004,18317,2299,18317,2299,9.09831e+17,232.729,2464.29,20616,129,192,19612,19374,18986,18769,11226
23050,437,467,23050,0,23050,0,3.35375e+18,265.059,1951.75,23050,166,125,22583,22575,22515,22531,22176
46468,1319,3866,42641,3827,42155,4313,1.76442e+18,327.706,7470.86,46468,555,197,42602,42594,41651,40500,15362
24671,737,1078,23074,1597,23074,1597,1.99514e+18,490.854,3216.76,24671,297,174,23542,22876,22912,22803,21282
5045,264,426,4521,524,0,5045,3.13921e+18,235.916,1101.5,5045,190,88,4509,4062,4336,4370,3723
14972,294,1065,14040,932,0,14972,2.29829e+18,284.805,2628.59,14972,234,131,13749,13325,13020,13027,8032
33368,3452,4445,33368,0,32940,428,2.90618e+17,14.9317,5755.4,33368,934,23,28923,28923,28342,28923,24898
28894,6,8,28859,35,28894,0,4.65069e+13,5.57926,369.629,28894,7,6,28886,28886,28121,28120,27357
47018,370,2084,0,47018,9816,37202,6.57172e+15,447.442,5603.39,47018,612,234,44500,43873,40993,33438,14704
17545,110,1027,0,17545,0,17545,1.23017e+18,431.082,2761.14,17545,268,170,15202,13551,13143,11249,5388
38388,429,2496,4956,33432,0,38388,3.7408e+13,11.8911,4791.09,38388,1249,13,35892,35892,22025,16703,15831
13083,483,1304,13083,0,11684,1399,1.28127e+18,139.242,2509.68,13083,420,101,11779,11658,10630,11490,5907
28298,1987,2265,28298,0,25667,2631,1.31882e+18,277.746,5003.22,28298,425,255,26033,26033,25797,25942,24520
17332,592,827,0,17332,4337,12995,7.73595e+15,274.402,2219.89,17332,236,132,16505,16468,16475,16502,15378
31464,1068,1466,29362,2102,29362,2102,6.74915e+17,525.66,4276.5,31464,293,239,29998,29876,29548,29751,21340
35999,513,1338,31667,4332,31667,4332,1.60523e+18,381.014,4613.4,35999,381,201,34656,34114,32798,32730,19774
20089,4,13,19966,123,20089,0,1.06627e+14,7.14555,273.616,20089,9,9,19817,19705,18586,18789,15334
10392,635,909,9364,1028,9364,1028,1.71011e+18,232.101,1800.25,10392,339,93,9483,9189,9122,9330,7643
42729,180,889,0,42729,9425,33304,4.65786e+15,478.22,3588.17,42729,342,199,40289,39549,37641,34045,17572
23546,384,1131,21163,2383,21163,2383,2.51586e+18,319.711,3319.67,23546,334,143,22294,21093,19637,18929,6346
18885,63,444,0,18885,4296,14589,7.37695e+15,209.602,1935.48,18885,197,107,17256,15556,14348,12283,3790
22243,937,1131,22243,0,20107,2136,7.0035e+17,387.301,3366.54,22243,282,171,21112,21072,21053,20233,20297
23496,200,779,0,23496,5155,18341,4.74145e+15,401.273,2640.36,23496,254,162,22158,21780,20635,18773,7194
31217,1226,1450,0,31217,6384,24833,6.54528e+15,263.575,3865.56,31217,360,192,29767,29700,29720,29767,26283
36007,11,14,35339,668,33725,2282,8.06271e+13,6.67315,368.558,36007,9,10,35993,35993,34997,34996,34943
12802,76,845,0,12802,0,12802,1.19741e+18,251.745,2122.03,12802,202,136,10668,8941,9221,8049,3518
26106,619,1054,23096,3010,0,26106,4.21866e+18,313.06,2656.52,26106,131,253,25052,24979,24277,24135,19653
43033,993,2187,38675,4358,38675,4358,3.04705e+18,267.574,5440.17,43033,403,243,40846,40843,40549,40202,31105
8944,312,791,8329,615,8329,615,2.13365e+18,128.158,1781.34,8944,183,88,8153,8144,7894,7792,5998
6037,357,643,0,6037,0,6037,1.18276e+18,125.637,1307.78,6037,203,86,5394,5358,5333,5367,3596
10606,440,494,9298,1308,0,10606,3.92305e+18,238.99,1686.14,10606,186,130,10112,10021,10077,10080,9271
18571,283,1538,16478,2093,16475,2096,1.4682e+18,239.585,3654.95,18571,303,158,16914,16556,15788,15446,4849
23670,72,796,5098,18572,0,23670,1.8516e+13,406.19,2686.97,23670,299,162,21228,19454,18641,14953,6078
27982,9,11,27792,190,27982,0,1.02121e+14,8.87331,330.914,27982,10,10,27967,27963,27868,27867,27499
45701,1237,1636,0,45701,11600,34101,7.37232e+15,220.082,4098.7,45701,353,155,44065,44065,42904,43046,36094
17461,222,412,17461,0,17461,0,3.04064e+18,233.062,1642.2,17461,156,114,16908,16519,14696,14429,10778
3509,86,174,2613,896,0,3509,8.47818e+18,82.2437,571.158,3509,65,73,3318,3196,3083,3132,1926
11030,969,1011,2413,8617,0,11030,3.06724e+13,101.781,1897.11,11030,363,79,10019,10019,10012,10018,9733
20478,550,605,19520,958,19520,958,1.47536e+18,419.885,2406.4,20478,229,145,19873,19726,19778,19800,19341
32410,300,429,32410,0,32410,0,4.9528e+18,281.594,2377.14,32410,190,147,31893,31562,30348,28994,25671
7676,7,8,7645,31,7676,0,1.06525e+14,6.22837,158.967,7676,8,8,7665,7658,7656,7656,6952
16773,295,367,4232,12541,0,16773,2.4082e+13,225.992,1766.62,16773,243,110,16406,16382,16405,16405,15916
565,114,136,0,565,0,565,9.79409e+17,42.8035,231.405,565,39,31,429,413,426,422,401
30333,674,718,22890,7443,0,30333,8.22881e+18,347.337,2466.55,30333,198,165,29615,29614,29603,29598,29232
14909,226,538,14845,64,14909,0,3.3854e+18,237.505,1922.66,14909,227,103,14264,13667,12858,12101,8996
16505,334,502,4602,11903,0,16505,6.35106e+13,164.494,1599.54,16505,114,107,16003,15962,15779,15763,11636
25180,228,891,23440,1740,23440,1740,6.21394e+17,453.095,2890.62,25180,246,192,23497,22914,21206,20995,8741
21168,17,23,0,21168,21156,12,7.52304e+14,15.8674,445.404,21168,20,9,21137,21061,21102,20932,19315
23529,16,62,0,23529,23363,166,2.5036e+16,50.3446,692.08,23529,36,36,23149,22779,21705,21186,16468
45113,445,1301,42112,3001,42112,3001,2.05178e+18,670.959,4514.17,45113,405,241,42733,41294,40531,40397,28190
17355,1,7,17320,35,17355,0,8.26506e+13,6.96762,257.802,17355,7,7,9960,9960,9960,9960,9960
45926,6,10,45688,238,45862,64,1.06753e+14,7.53974,401.257,45926,9,10,45867,45806,44253,44252,40291
23075,191,852,20386,2689,20386,2689,3.62726e+18,315.971,2237.49,23075,122,231,21766,21236,18637,14365,6677
3620,72,589,3367,253,3367,253,1.22582e+18,78.6506,1054.91,3620,113,82,2881,2628,2343,2490,539
8269,289,607,0,8269,1346,6923,5.62135e+15,106.711,1514.35,8269,214,69,7662,7607,7400,7411,4331
37073,1,11,36795,278,37073,0,1.01132e+14,9.33593,381.151,37073,10,10,19745,19745,19745,19745,19745
48722,218,615,46426,2296,48722,0,3.73977e+18,305.606,3418.52,48722,269,186,47579,46620,42078,38149,28712
18106,656,1657,16436,1670,16436,1670,2.62541e+18,221.73,3552.25,18106,364,209,16449,16399,16131,15766,6080
3092,72,317,2888,204,0,3092,2.40178e+18,102.634,722.619,3092,88,68,2552,2065,2205,2217,738
10167,13,42,0,10167,10164,3,2.11772e+16,9.77407,317.487,10167,19,15,10125,10117,8250,9790,6706
41263,56,2454,41263,0,37193,4070,1.50447e+18,286.806,5846.48,41263,387,307,34305,31764,23951,7522,3948
9322,264,444,9322,0,9322,0,5.53438e+18,194.966,1424.27,9322,138,114,8878,8758,8066,7455,6735
5707,1,5,5695,12,5707,0,3.6301e+13,4.98248,143.149,5707,5,5,2760,2760,2760,2760,2760
19667,334,776,19667,0,17309,2358,1.16179e+18,356.178,2764.21,19667,225,159,18595,18001,17276,14571,10269
14002,363,582,3152,10850,0,14002,1.86743e+13,215.504,1680.12,14002,164,108,13420,13234,13097,12878,11515
17708,187,441,17708,0,17708,0,3.33085e+18,213.59,1890.45,17708,233,120,17073,16379,14958,14352,10759
29071,246,1188,6241,22830,0,29071,1.83004e+13,359.325,3574.01,29071,318,182,27447,26789,25846,21595,12624
45759,758,1155,34505,11254,34505,11254,6.96338e+18,377.049,3550.95,45759,269,182,44604,44594,44287,44096,41827
31213,468,1221,29146,2067,29146,2067,2.05085e+18,623.303,3773.66,31213,379,213,29328,28323,27959,27349,16018
47820,113,655,0,47820,13317,34503,1.61682e+16,273.233,2598.79,47820,195,141,46125,45114,38852,39864,15858
38572,28,34,0,38572,36724,1848,2.46296e+16,30.1679,643.75,38572,30,31,38505,38393,37710,37611,35555
3729,44,337,3514,215,0,3729,2.11413e+18,126.199,804.982,3729,104,67,2867,2201,2157,2097,820
11252,215,676,10076,1176,10076,1176,3.2523e+18,190.844,1614.31,11252,117,121,10513,9687,9593,9002,4725
42748,629,1231,37404,5344,0,42748,3.93208e+18,329.072,4366.86,42748,315,210,41517,41510,40948,41040,32187
17873,29,46,0,17873,17426,447,2.07751e+16,18.5427,549.82,17873,25,22,17827,17821,17717,17540,16170
35851,1,8,35798,53,35851,0,3.63204e+13,4.99392,408.29,35851,6,6,17345,17345,17345,17345,17345
23758,375,582,16756,7002,23758,0,4.16229e+18,289.791,2370.45,23758,284,120,23148,22880,22319,21680,18581
25276,32,44,0,25276,25227,49,2.12331e+16,28.0039,560.814,25276,31,32,25232,25223,24456,24627,24533
30803,166,625,30803,0,29473,1330,5.14524e+17,462.854,2977.89,30803,248,169,27375,24431,21738,8804,17584
30489,755,1331,0,30489,5176,25313,5.02525e+15,219.47,3716.18,30489,492,99,29158,29150,28645,29043,20619
42822,1260,1716,0,42822,10629,32193,7.52305e+15,215.271,4074.18,42822,413,155,41106,41106,39103,39265,31049
33976,8,12,33513,463,33976,0,9.80061e+13,10.0754,357.521,33976,11,12,33950,33940,32489,32487,28395
6604,163,845,6187,417,0,6604,2.32954e+18,142.11,1617.75,6604,288,68,5715,5265,5069,5199,1867
19015,704,809,0,19015,4069,14946,4.50211e+15,214.801,2387.51,19015,188,152,18206,18206,18145,18148,17187
34792,1293,1524,0,34792,0,34792,1.90596e+18,256.163,3892.13,34792,372,155,33268,33268,32656,32273,28339
39210,1017,4342,0,39210,5255,33955,7.23762e+14,11.2002,6049.45,39210,1156,18,34868,34868,31554,28974,19969
20365,180,1129,18259,2106,0,20365,3.45897e+18,401.276,2903.83,20365,425,151,18129,17124,16248,16340,7618
15591,509,590,13980,1611,0,15591,3.78005e+18,232.434,1755.78,15591,112,130,15001,14999,14939,14975,14094
38107,179,678,37979,128,38107,0,3.16455e+18,410.459,3241.97,38107,256,153,35973,33539,29172,24737,14309
38193,807,1580,8896,29297,0,38193,2.7349e+13,235.161,4253.55,38193,318,179,36613,36514,36302,36294,28500
13346,163,1247,12526,820,12526,820,7.3629e+17,289.354,2768.56,13346,226,181,11797,11122,10151,10789,2945
37874,654,1293,35391,2483,35391,2483,2.02356e+18,647.311,4212.3,37874,432,212,36228,34782,34816,34376,24902
34255,682,1371,0,34255,0,34255,1.46906e+18,589.7,4270.13,34255,464,169,32770,32295,30921,30264,17339
46175,641,887,0,46175,10273,35902,4.74405e+15,460.788,3647.71,46175,349,192,45288,45014,44298,44394,39699
20176,1139,1264,0,20176,0,20176,1.49864e+18,318.401,3245.22,20176,446,114,18912,18912,18889,18912,17919
12451,386,920,1819,10632,0,12451,2.05745e+13,119.226,1901.58,12451,288,81,11531,11470,11270,11421,6334
46090,716,1348,34747,11343,34677,11413,3.80416e+18,395.758,3967.88,46090,314,209,44742,44718,44663,44660,41908
11864,40,538,0,11864,0,11864,1.86461e+18,249.862,1834.83,11864,191,130,9031,7965,7217,1093,1391
8691,345,610,7989,702,7989,702,2.12993e+18,252.693,1736.38,8691,224,117,8054,7296,7767,7786,6260
45216,2,11,44917,299,45216,0,1.03717e+14,9.17341,417.682,45216,10,10,39361,38360,33687,36849,25100
30147,412,1209,30147,0,28150,1997,9.10569e+17,591.297,3777.24,30147,318,221,28078,26882,24121,22729,18225
23817,1,11,23682,135,23817,0,1.10737e+14,8.28035,299.953,23817,10,10,12181,12181,12181,12181,12181
18898,111,751,4186,14712,0,18898,1.83206e+13,351.778,2328.83,18898,284,154,17468,16782,15751,13015,6310
38370,269,860,0,38370,8366,30004,4.89595e+15,440.255,3376.64,38370,315,197,36689,35675,34879,32843,20571
43330,834,1277,0,43330,0,43330,1.41982e+18,609.992,4793.43,43330,495,190,42024,41464,40765,40820,28367
21451,288,470,4978,16473,0,21451,2.88604e+13,200.934,2102.64,21451,206,120,20981,20719,20271,20686,14701
34561,645,790,34561,0,26043,8518,8.09051e+17,373.818,2821.88,34561,220,169,33771,33742,33200,31109,31018
42738,648,896,0,42738,9450,33288,4.60968e+15,464.552,3559.14,42738,347,198,41842,41550,41067,41213,37028
38588,49,91,0,38588,37647,941,2.47332e+16,36.4248,1087.16,38588,44,36,38497,38481,37797,37618,31173
35049,856,861,0,35049,7651,27398,4.74509e+15,417.276,3230.18,35049,298,180,34188,34188,34188,34188,34139
48905,2043,2558,44155,4750,44155,4750,2.94975e+18,283.688,6259.2,48905,518,243,46347,46347,46339,46347,42296
1616,69,145,366,1250,0,1616,1.91585e+13,62.203,368.35,1616,60,40,1445,1325,1368,1350,947
13012,365,773,11495,1517,11493,1519,9.47872e+17,234.608,1811.78,13012,101,178,12239,11888,11706,11917,5757
14841,907,1128,0,14841,0,14841,1.8569e+18,158.442,2464.49,14841,341,102,13713,13709,13462,13304,11488
45120,210,647,45120,0,43189,1931,4.85776e+17,512.784,3630.3,45120,279,202,41309,36588,32205,9379,29116
21514,448,1123,0,21514,0,21514,1.64548e+18,303.063,2959.66,21514,382,152,20391,20156,17344,17827,13310
19521,482,1176,18209,1312,18209,1312,6.52224e+17,525.539,3052.84,19521,326,186,18068,17476,17070,17169,12066
44483,1100,1649,0,44483,11221,33262,7.82037e+15,255.116,3860.4,44483,333,162,42834,42804,41108,41276,32242
10450,129,366,2386,8064,0,10450,2.8557e+13,165.842,1363.84,10450,169,86,9972,9817,8267,4981,4023
33196,1781,2165,0,33196,0,33196,2.87497e+18,14.8851,4228.66,33196,1081,17,31031,31031,30649,30841,26689
5284,364,372,887,4397,0,5284,2.08302e+13,79.5819,958.959,5284,129,65,4912,4912,4912,4912,4883
23988,269,440,23988,0,23988,0,5.15495e+18,253.77,2061.32,23988,185,139,23472,23140,21931,21112,19268
10763,473,498,8110,2653,8110,2653,7.05251e+18,222.338,1377.83,10763,133,108,10265,10262,10246,10231,10112
1543,39,109,404,1139,0,1543,3.32071e+13,69.9786,340.746,1543,70,43,1301,1167,1125,1152,716
10729,494,611,1788,8941,0,10729,2.06235e+13,172.62,1614.32,10729,207,88,10118,10112,10084,10114,8968
13953,391,1147,0,13953,0,13953,1.59384e+18,194.727,2681.27,13953,320,89,12806,12604,12176,8011,6505
41113,277,471,41113,0,41113,0,5.06867e+18,272.251,2771.7,41113,217,169,40563,40126,37012,35627,31429
18410,674,1397,16800,1610,16800,1610,2.70347e+18,300.226,3319.31,18410,276,169,17013,16756,16223,15900,10193
16112,3,4,16099,13,16112,0,8.60397e+13,3.98188,218.593,16112,4,4,15921,15921,13347,13347,15827
49971,289,1151,0,49971,11719,38252,6.03491e+15,425.568,4286.09,49971,447,154,48477,47860,42888,41403,24446
6440,385,804,5738,702,0,6440,3.99143e+18,93.7797,1344.61,6440,361,59,5636,5552,5291,5494,4421
11371,531,626,2509,8862,0,11371,1.97288e+13,152.842,1692.91,11371,171,123,10745,10703,10730,10688,9790
3086,56,288,0,3086,0,3086,2.03277e+18,104.252,742.691,3086,92,72,2410,2071,2091,639,461
33146,203,909,8634,24512,0,33146,2.94228e+13,214.881,2629.47,33146,125,152,32150,31656,27816,29932,14033
7745,503,535,5856,1889,5856,1889,3.75626e+18,141.789,1274.91,7745,120,115,7210,7210,7210,7210,7051
43147,735,1659,38459,4688,0,43147,3.85921e+18,291.508,4255.56,43147,208,176,41488,41451,40099,40068,31377
38993,74,98,0,38993,38307,686,2.06141e+16,37.7219,1048.91,38993,36,45,38895,38891,38043,38377,36853
28405,644,1175,26486,1919,26486,1919,2.08249e+18,561.778,3612.72,28405,319,205,27010,26008,26165,25709,17800
49597,654,1444,0,49597,0,49597,1.20506e+18,669.805,4953.32,49597,406,237,47874,46789,46323,36839,35378
24771,273,297,24771,0,24771,0,4.82683e+18,235.722,1858.42,24771,163,138,24470,24411,23864,23710,23610
30434,157,576,30434,0,30434,0,4.5548e+18,297.9,2650.86,30434,202,122,28769,27611,21335,22352,14567
10115,241,701,9414,701,9414,701,2.15585e+18,184.016,1681.21,10115,165,124,9388,9191,8665,8497,5880
37483,382,448,37483,0,37483,0,3.92826e+18,269.413,2601.44,37483,266,164,37035,37009,36641,36465,34379
12583,5,13,12491,92,12583,0,1.0375e+14,7.2958,218.379,12583,9,9,12511,12462,11850,11814,10399
35751,27,35,0,35751,34059,1692,2.45837e+16,31.1188,625.318,35751,29,32,35677,35567,34727,34588,32287
37859,323,1330,0,37859,8437,29422,4.73069e+15,354.086,4145.54,37859,328,198,36208,35479,34468,32763,18393
20725,437,1265,4491,16234,0,20725,2.5179e+13,140.749,3023.63,20725,335,140,19460,19402,18980,16878,11699
39360,848,1155,9353,30007,0,39360,2.41975e+13,362.308,3800.98,39360,578,135,38205,38147,37930,38167,34421
31716,788,1889,0,31716,0,31716,1.57915e+18,362.476,4765.83,31716,520,162,29827,29677,28011,24098,12052
25085,1839,1922,20610,4475,0,25085,7.95627e+18,14.8006,3440,25085,800,26,23163,23163,23080,22945,22278
642,72,162,0,642,0,642,1.09199e+18,16.2383,255.413,642,63,21,480,466,442,430,255
38103,4,14,37869,234,38103,0,9.43423e+13,10.2702,392.066,38103,12,11,37402,37072,33731,34102,29824
26108,621,1274,24328,1780,24328,1780,6.80155e+17,630.277,3609.58,26108,346,203,24617,23722,23478,23301,12400
19362,8,14,19251,111,19362,0,9.16737e+13,9.92248,283.315,19362,11,10,19337,19334,18851,18861,17664
32473,1049,1786,32473,0,26261,6212,8.16253e+17,273.545,4814.53,32473,369,216,30687,30667,29585,28399,12016
8617,8,10,8602,15,8513,104,8.84898e+13,6.88349,212.443,8617,9,8,8607,8607,8590,8590,7725
23585,225,718,17775,5810,17775,5810,3.80348e+18,325.725,2326.73,23585,186,152,22337,21602,21517,20964,10724
37549,66,75,0,37549,37150,399,2.50434e+16,44.9056,924.831,37549,36,45,37474,37474,37080,37105,34067
11498,34,1011,11498,0,10757,741,9.32579e+17,385.355,2300.15,11498,253,146,8097,6450,5113,4173,1309
14851,452,619,11219,3632,0,14851,8.18591e+18,223.241,1701.93,14851,138,127,14232,14189,14108,14101,11983
11652,402,499,10433,1219,0,11652,3.82719e+18,216.866,1463.02,11652,101,122,11153,11143,11029,11038,9934
32966,419,1273,6641,26325,0,32966,2.10064e+13,296.603,3992.46,32966,403,112,31538,31307,30370,21818,14913
20555,837,1573,0,20555,0,20555,1.47908e+18,242.954,3307.89,20555,679,134,18982,18730,18507,18161,12022
43693,7,12,43444,249,42090,1603,8.09775e+13,6.86584,423.663,43693,10,8,43680,43676,42901,42900,41644
11992,341,432,11992,0,11992,0,5.1793e+18,235.246,1510.12,11992,160,99,11560,11512,11412,11360,10652
10448,755,970,10448,0,9723,725,9.90651e+17,191.458,2118.64,10448,186,157,9478,9434,8989,9204,7361
36457,2,11,34703,1754,36457,0,9.61394e+13,10.418,425.925,36457,11,11,26315,22158,23338,22956,17562
38601,105,2525,35277,3324,35277,3324,2.59712e+18,394.101,6088.15,38601,575,236,33757,30782,29781,25040,4663
33913,34,44,0,33913,33685,228,2.58883e+16,36.8288,627.028,33913,32,32,33837,33731,33606,33738,31743
4618,24,674,4618,0,4275,343,7.87121e+17,93.7347,1308.61,4618,158,71,3056,2671,2056,1487,830
20155,1316,1518,17493,2662,0,20155,4.5935e+18,438.512,3381.8,20155,304,197,18637,18637,18637,18637,16500
14534,425,573,10956,3578,10956,3578,7.01467e+18,258.198,1649.74,14534,145,126,13961,13935,13812,13761,11636
27402,9,36,0,27402,26166,1236,2.45374e+16,28.45,542.169,27402,28,27,26597,25677,20064,23759,17632
1454,171,195,0,1454,0,1454,4.25052e+18,56.566,414.431,1454,55,55,1259,1259,1258,1259,1240
39391,3,11,39267,124,39391,0,8.06392e+13,6.74832,395.895,39391,8,8,37887,37496,31932,32663,27630
20310,138,703,4407,15903,0,20310,1.81001e+13,344.929,2354.67,20310,250,148,18955,18583,17566,14582,8515
3905,232,362,3504,401,3504,401,8.8726e+17,149.051,809.498,3905,84,85,3543,3275,3487,3472,2546
9558,598,901,8918,640,0,9558,2.42688e+18,166.798,1967.72,9558,195,108,8657,8612,8519,8559,7771
49718,26,1322,0,49718,0,49718,1.21326e+18,705.714,4731.72,49718,412,246,34188,26928,24072,21673,6615
25787,101,1011,22575,3212,22575,3212,3.19465e+18,296.63,3367.99,25787,368,171,22362,18789,18104,15490,2227
20516,331,1266,20516,0,18475,2041,8.14126e+17,440.363,3082.2,20516,395,145,18825,17807,16503,17948,10649
14490,331,697,12691,1799,12691,1799,1.76027e+18,296.936,2286.81,14490,198,148,13648,13303,13063,12871,8380
44330,1249,1944,0,44330,0,44330,2.02777e+18,430.065,5676.46,44330,420,227,42386,42364,41412,34284,31687
43337,6,13,43023,314,43337,0,9.89194e+13,12.1322,410.778,43337,13,13,43205,43119,40925,40744,25863
21808,716,1424,21808,0,21808,0,1.18912e+18,16.8819,2850.67,21808,714,17,20384,20384,20384,20371,11965
12296,351,569,0,12296,3197,9099,7.62075e+15,137.854,1439.55,12296,84,118,11727,11701,11247,11303,7598
29151,262,840,6208,22943,0,29151,2.20248e+13,342.489,2984.24,29151,391,126,28125,27774,25030,22882,9218
37952,1018,2333,34142,3810,34139,3813,1.28643e+18,250.755,5551.14,37952,603,165,35619,35616,35164,35358,11351
15366,6,48,0,15366,15301,65,2.42162e+16,19.4035,438.576,15366,22,21,15229,15188,12712,14218,9360
23999,228,677,0,23999,0,23999,1.90277e+18,308.833,2791.33,23999,246,162,22898,22176,18867,16242,7563
31391,259,526,30943,448,31391,0,4.16246e+18,263.325,2658.9,31391,254,137,30771,30413,24456,24037,16987
45910,905,2306,45910,0,35207,10703,9.71506e+17,343.363,5330.9,45910,308,307,43604,43584,42825,41540,38305
33272,6,10,33167,105,33208,64,1.07626e+14,7.82297,341.527,33272,9,10,33225,33177,31903,31902,28279
26717,894,2381,19645,7072,19645,7072,2.18341e+18,22.9768,3086.14,26717,802,796,24336,24336,22852,21372,22365
20606,472,1069,19159,1447,0,20606,2.50185e+18,535.493,3063.74,20606,280,196,19158,18303,18229,18111,7939
16939,122,1508,15960,979,0,16939,2.20215e+18,231.044,3047.02,16939,394,125,15198,13143,14304,14153,2684
6093,7,10,6049,44,6093,0,1.002e+14,7.81109,153.018,6093,9,9,6071,6048,5877,5878,5347
26357,5,15,25227,1130,26357,0,9.52923e+13,10.423,368.641,26357,12,12,25522,25419,23306,23004,12265
16812,959,1431,0,16812,0,16812,2.62027e+18,138.394,3327.23,16812,249,128,15381,15373,14798,10170,9095
37398,391,1293,8981,28417,0,37398,3.41292e+13,249.444,4180.86,37398,278,177,36044,35575,32638,22991,18509
15432,234,1208,13955,1477,13955,1477,2.96645e+18,215.47,2570.51,15432,471,121,14043,13783,12839,10924,7240
42886,1973,2402,39868,3018,39868,3018,2.22044e+18,516.385,5845.41,42886,712,143,40484,40484,40154,40158,36987
2432,29,195,2432,0,2432,0,3.31103e+18,55.4465,500.699,2432,58,63,1731,949,1093,1040,374
30674,374,1321,0,30674,5071,25603,5.36127e+15,225.326,3724.02,30674,509,100,29353,28930,28472,25789,12276
40695,544,2883,40695,0,37670,3025,3.43682e+18,709.237,6385.91,40695,853,190,37251,36422,27646,29866,6761
23844,15,501,6622,17222,0,23844,6.29332e+13,218.463,1756.45,23844,136,117,18983,15351,16088,6006,2527
1438,16,26,0,1438,1415,23,2.52553e+16,19.1453,131.193,1438,20,20,1395,1358,1336,1361,1010
48502,640,1042,36583,11919,36583,11919,3.78908e+18,400.034,3584,48502,241,200,47460,47368,46863,46803,32935
45095,855,880,33939,11156,33939,11156,7.05587e+18,379.741,3166.31,45095,257,172,44215,44215,44207,44197,44056
14038,700,1192,12954,1084,0,14038,2.88247e+18,187.395,2460.96,14038,490,101,12846,12748,12634,12538,8206
27712,663,699,0,27712,0,27712,4.11552e+18,311.017,2314.75,27712,181,154,27013,27013,27013,27010,26681
6124,578,652,5622,502,5622,502,2.56891e+18,174.449,1389.78,6124,248,81,5472,5472,5456,5465,5047
4730,207,498,998,3732,0,4730,1.92232e+13,118.516,1119.8,4730,118,96,4227,4115,3973,3693,2305
26933,426,750,5991,20942,0,26933,1.83309e+13,361.065,2689.21,26933,255,153,26025,25509,25123,23515,20295
13814,57,724,0,13814,3561,10253,6.74763e+15,220.674,1865.17,13814,296,86,12218,11558,11025,8587,4109
39056,31,63,0,39056,38802,254,2.59147e+16,47.2017,871.473,39056,40,42,38897,38835,37595,37459,32782
22279,506,557,22215,64,22279,0,3.28166e+18,270.555,2373.22,22279,226,128,21722,21715,21687,21691,21159
42012,587,890,9253,32759,0,42012,1.84115e+13,452.449,3532.79,42012,340,202,41100,40440,40115,39295,34862
29626,844,2403,26916,2710,26916,2710,1.11494e+18,287.167,5261.47,29626,485,247,27223,27006,25334,26018,12544
21196,9,11,20677,519,19376,1820,8.58662e+13,5.70627,257.701,21196,9,8,21185,21185,21184,21184,21181
21262,541,1661,19868,1394,0,21262,2.47301e+18,276.072,3648.38,21262,519,131,19601,19283,18892,18686,11519
5900,3,11,5616,284,5900,0,9.65609e+13,10.2744,172.924,5900,11,10,5290,5122,4175,3996,3396
21099,202,463,21099,0,21099,0,4.67515e+18,244.995,2126.48,21099,165,149,20441,19644,16489,15276,12704
15392,229,394,15392,0,15392,0,4.97094e+18,251.313,1666.49,15392,159,126,14907,14600,13495,12850,10723
16264,652,750,3617,12647,0,16264,1.83623e+13,276.77,2141.91,16264,254,126,15514,15384,15442,15418,14508
43118,1,62,0,43118,42798,320,2.49674e+16,52.7424,917.049,43118,40,43,16886,16886,16886,16886,16886
29823,687,758,22455,7368,22455,7368,3.81776e+18,370.912,2644.16,29823,204,165,29065,29060,29039,29041,28425
15259,9,11,14889,370,15101,158,8.80821e+13,6.62901,235.382,15259,8,9,15248,15247,15039,15038,14842
7922,24,576,7390,532,0,7922,2.46079e+18,165.405,1383.24,7922,167,85,5294,3968,3621,3208,1242
34738,40,582,0,34738,8015,26723,7.38392e+15,224.162,2845.57,34738,244,127,30274,26954,25409,20709,6453
1178,4,9,1110,68,1178,0,9.89232e+13,7.97708,76.5642,1178,8,9,1108,1085,962,873,765
10760,6,10,10671,89,10760,0,9.79932e+13,8.71004,201.887,10760,10,9,10705,10660,10149,10142,9482
19067,79,652,19067,0,14349,4718,8.78919e+17,298.937,2027.44,19067,162,142,17501,16672,13955,13764,3561
31718,1318,1647,0,31718,6793,24925,6.81095e+15,197.709,4107.4,31718,462,126,30071,30071,29173,29268,24878
20058,27,500,0,20058,5546,14512,1.60622e+16,194.498,1617.53,20058,128,102,18259,16314,15344,15208,4205
3994,24,193,0,3994,1104,2890,4.6188e+15,50.7434,572.347,3994,156,35,3655,3572,3405,3261,1916
33873,1,5,33840,33,33873,0,1.87492e+14,4.93499,347.065,33873,5,5,8467,8467,8467,8467,8467
24857,435,729,24857,0,18726,6131,8.48718e+17,354.491,2411.78,24857,191,152,24128,23767,23061,20893,16781
28542,125,924,25543,2999,0,28542,3.84387e+18,262.002,2726.52,28542,150,170,26095,24427,23253,22535,6053
38802,390,2345,35003,3799,35003,3799,1.04256e+18,280.48,5577.24,38802,434,271,36368,35676,33450,34292,13322
3531,1,5,3525,6,3531,0,3.61915e+13,4.96262,112.55,3531,5,5,1709,1709,1709,1709,1709
17101,1157,1458,14685,2416,0,17101,4.83039e+18,144.587,3410.78,17101,259,126,15643,15638,15456,15437,12793
29486,474,1545,0,29486,6989,22497,7.30674e+15,165.132,3577.51,29486,403,133,27941,27784,24936,24180,7802
17926,682,1222,16556,1370,0,17926,2.85177e+18,256.387,3034.75,17926,383,94,16704,16562,16329,16379,11178
12536,339,550,9435,3101,9435,3101,3.81346e+18,222.112,1552.84,12536,133,125,11967,11662,11767,11753,8240
2287,190,385,2287,0,2287,0,2.7864e+18,8.44775,570.5,2287,126,12,1902,1902,1900,1810,968
43614,969,3258,299,43315,0,43614,5.06869e+11,16.0772,6036.11,43614,667,24,40356,40356,38009,37813,16869
43060,1,12,42805,255,34972,8088,8.2011e+13,8.13421,485.788,43060,10,9,22373,22373,22373,22373,22373
24373,1024,1081,0,24373,0,24373,1.20188e+18,461.856,3178.02,24373,269,186,23292,23248,23263,23258,22808
38008,1399,1791,34518,3490,34518,3490,1.35547e+18,748.278,5095.15,38008,564,175,36217,35802,35946,36091,31607
20101,225,660,15166,4935,15166,4935,3.78564e+18,341.875,2123.24,20101,177,145,18989,18332,18264,17750,7100
36411,19,42,0,36411,36200,211,1.79338e+16,24.8005,725.396,36411,29,27,36340,36306,35831,35725,27971
17964,6,13,17847,117,17964,0,1.01158e+14,10.8274,264.494,17964,11,10,17908,17877,16930,16932,15104
23345,52,63,0,23345,23142,203,2.16251e+16,18.3565,627.161,23345,22,30,23282,23282,21406,22138,20297
23764,340,796,17929,5835,17929,5835,6.97157e+18,265.946,2272.66,23764,173,149,22952,22357,21076,19741,13484
7339,362,544,6460,879,6460,879,1.40618e+18,339.607,1499.17,7339,229,114,6634,5729,6109,6142,4520
18363,636,2928,0,18363,0,18363,3.20949e+16,12.2556,4265.72,18363,595,17,15435,15435,10084,6536,7210
2352,2,9,2251,101,2352,0,9.55011e+13,7.29889,105.872,2352,9,9,1693,1416,1507,1479,1165
8177,4,10,8133,44,8177,0,1.04267e+14,7.7581,177.672,8177,9,9,8080,8047,7162,7491,7135
12077,519,646,0,12077,2586,9491,4.70764e+15,208.476,1786.31,12077,199,125,11431,11372,11366,11368,10132
49975,58,88,0,49975,49604,371,2.57605e+16,53.1528,1085.65,49975,45,44,49882,49813,47869,45787,33321
31391,359,362,31385,6,31391,0,3.24342e+18,303.465,2408.79,31391,191,153,31029,31025,31015,31020,30954
32750,1419,1522,29701,3049,29698,3052,1.19033e+18,301.694,4167.07,32750,508,148,31228,31228,31219,31220,30258
21579,37,42,0,21579,21535,44,2.11776e+16,29.1246,519.687,21579,31,32,21537,21537,21042,21114,21450
25759,250,1161,0,25759,0,25759,1.20099e+18,586.318,3419.29,25759,349,186,23568,23041,21616,19641,10703
15086,629,1046,14039,1047,0,15086,2.47865e+18,476.392,2620.74,15086,311,176,14040,13573,13468,13343,8854
27177,329,368,27177,0,27177,0,3.59354e+18,250.527,1982.23,27177,139,207,26809,26800,26641,26507,26130
44550,5,13,44027,523,44151,399,8.48029e+13,6.76988,423.492,44550,8,9,44080,43601,39588,39574,31961
2271,82,161,2125,146,0,2271,2.35185e+18,14.325,303.752,2271,150,16,2110,2110,2032,1779,1513
29715,550,1123,27753,1962,27753,1962,2.05866e+18,479.186,3477.94,29715,298,209,28500,27493,27318,27106,14790
48519,29,63,0,48519,48160,359,2.58816e+16,51.764,964.397,48519,41,45,48309,48232,46378,44045,29643
1795,170,279,1795,0,1608,187,1.77293e+18,52.1103,500.07,1795,56,62,1516,1499,1426,1496,1305
33154,1228,1306,7754,25400,0,33154,2.37207e+13,276.92,3850.74,33154,333,163,31848,31848,31808,31819,31356
27548,797,2195,27548,0,24664,2884,1.41079e+18,210.657,4585.3,27548,507,136,25353,25324,23349,24459,7027
32639,265,509,32639,0,32639,0,3.27356e+18,296.546,2357.33,32639,186,140,31970,31075,28017,27560,19795
3253,223,346,0,3253,677,2576,4.89538e+15,76.5859,757.09,3253,100,71,2907,2861,2845,2875,2599
6142,56,388,5754,388,5754,388,4.99611e+17,151.95,1061.39,6142,129,82,4849,3849,3678,3823,1768
39975,4,16,39365,610,37216,2759,8.65304e+13,7.61906,412.694,39975,10,12,39822,39755,38072,38082,25381
14827,5,13,14695,132,14827,0,9.57552e+13,9.36939,237.848,14827,11,10,14752,14698,14006,13845,11270
6124,264,337,0,6124,1578,4546,7.54178e+15,119.782,852.907,6124,68,84,5787,5769,5699,5719,5055
47934,665,2288,0,47934,0,47934,1.78907e+18,275.1,5760.8,47934,407,249,45646,45539,44049,32067,27792
22323,171,410,22323,0,22323,0,5.34019e+18,268.382,1961.04,22323,184,129,21595,21036,16221,15056,12623
745,53,227,635,110,0,745,5.35234e+18,18.5906,302.409,745,81,22,518,487,489,489,281
39830,284,503,39830,0,39830,0,4.97568e+18,307.159,2724.46,39830,214,167,39127,38576,35125,32900,28984
29539,45,432,29539,0,29539,0,5.00718e+18,245.393,2370.88,29539,180,141,24631,20247,14723,13269,6500
39778,624,1296,0,39778,8606,31172,4.78967e+15,376.982,4223.24,39778,348,199,38482,38116,37550,37550,29843
34097,1951,2138,0,34097,0,34097,2.69348e+18,391.335,4967.6,34097,514,214,31959,31959,31959,31959,30480
49911,137,2223,39937,9974,0,49911,6.76358e+18,380.073,5784.59,49911,422,247,45567,43017,34998,35807,10651
41139,39,1238,38357,2782,0,41139,2.4437e+18,665.985,4319.71,41139,381,232,30520,23823,23346,23171,6509
13286,43,738,12401,885,12401,885,2.07471e+18,236.883,1910.46,13286,162,122,10019,7613,8038,7591,2686
32174,12,36,0,32174,32131,43,1.1187e+16,7.1131,647.021,32174,20,12,32138,32138,30176,29707,20887
10838,601,1017,2400,8438,0,10838,2.96316e+13,76.0871,1863.12,10838,362,81,9821,9809,9277,9227,6184
8707,5,7,8703,4,8707,0,8.0819e+13,6.91788,181.707,8707,7,7,8567,8385,7164,7163,7356
25525,719,854,25525,0,19253,6272,8.75732e+17,303.161,2543.74,25525,195,163,24671,24663,24438,23120,22351
17845,302,3413,17420,425,17420,425,3.59618e+18,13.977,3804.6,17845,437,22,14432,14432,11325,1630,2428
35114,1844,2633,0,35114,0,35114,3.33946e+16,24.2981,4929.24,35114,395,25,32481,32481,31685,25911,24378
7871,678,806,7333,538,7333,538,7.0797e+17,132.807,1753.41,7871,187,83,7065,7065,7058,7063,6882
18681,438,618,0,18681,0,18681,1.87555e+18,301.277,2412.43,18681,229,151,18063,17806,17799,17887,13739
13244,459,985,12393,851,12393,851,1.97941e+18,221.526,2285.49,13244,241,151,12259,12081,11794,11697,6803
19667,670,832,19667,0,14802,4865,9.14366e+17,271.291,2519.37,19667,179,185,18835,18822,18530,17412,16176
9782,378,781,8532,1250,8532,1250,1.45361e+18,337.989,1972.98,9782,297,127,8844,7942,8281,8314,6371
46615,1257,1324,43498,3117,0,46615,2.42914e+18,700.522,4616.14,46615,386,243,45291,45291,45226,45236,45091
17849,500,795,3807,14042,0,17849,2.18964e+13,219.462,2372.18,17849,355,114,17054,16940,16877,16984,14066
33841,718,816,0,33841,7459,26382,4.6909e+15,437.192,3140.35,33841,292,185,33025,33003,32860,32919,31777
3875,2,7,3867,8,3875,0,8.2082e+13,6.88645,122.166,3875,7,7,3202,2982,3014,3059,2518
21786,7,28,0,21786,21768,18,1.37163e+16,9.95089,486.746,21786,15,10,19998,17115,16307,18835,14060
16787,28,1230,0,16787,0,16787,1.52423e+18,203.026,2965.56,16787,338,91,13611,12030,11134,2878,1899
40267,16,34,0,40267,38365,1902,2.45861e+16,31.482,656.639,40267,30,30,40034,39849,35786,38201,30373
17820,155,730,17820,0,15675,2145,1.14932e+18,358.046,2592.36,17820,219,162,16119,13308,13576,10137,6377
38059,14,45,0,38059,37796,263,2.57017e+16,36.8928,666.918,38059,32,33,37748,37217,35765,36374,27693
49151,501,605,46650,2501,49151,0,3.7018e+18,323.382,3570.65,49151,281,159,48546,48524,47236,46138,43389
47436,272,405,0,47436,12372,35064,3.21056e+15,302.285,2835.18,47436,251,150,46887,46360,44479,44474,44326
4632,81,271,4632,0,4632,0,3.22078e+18,156.649,813.914,4632,97,68,4091,3724,3424,2766,2294
17080,1193,1295,0,17080,0,17080,1.32961e+18,270.19,2883.29,17080,338,126,15785,15785,15765,15782,15468
19001,589,1424,0,19001,0,19001,1.19221e+18,321.192,3400.49,19001,296,210,17577,17158,16887,14560,9544
28869,470,1174,26938,1931,26938,1931,2.04888e+18,630.695,3645.87,28869,316,210,27087,25820,25544,25105,14787
41256,332,1658,9741,31515,0,41256,2.77948e+13,233.56,4407.34,41256,325,177,39598,39256,36204,37114,18586
2251,83,252,1944,307,1944,307,1.8719e+18,124.423,618.581,2251,90,76,1765,1437,1366,1532,1068
21964,321,1593,21964,0,20093,1871,8.45075e+17,268.579,3670.92,21964,526,109,20163,19613,17999,17605,7484
17295,2,10,17176,119,17295,0,1.00677e+14,8.76317,257.323,17295,10,10,14984,14524,12832,14015,11254
47117,2356,2587,47117,0,42794,4323,1.18785e+18,369.711,6741.98,47117,695,153,44530,44530,44530,44530,40472
27863,5,494,27863,0,27863,0,3.40604e+18,279.411,2168.3,27863,172,129,10093,7128,5285,5254,651
18250,123,660,13759,4491,13759,4491,6.99207e+18,253.837,1890.7,18250,144,133,17120,16689,12832,9898,4365
42772,524,1910,38309,4463,38309,4463,1.46134e+18,459.682,5405.65,42772,444,176,40772,40211,34440,35641,10632
1057,75,232,216,841,0,1057,2.15704e+13,30.9272,394.484,1057,61,28,825,802,746,722,460
2291,221,258,0,2291,0,2291,1.2399e+18,101.423,587.426,2291,76,55,2033,2033,2019,2020,1957
1179,2,6,1175,4,717,462,7.90231e+13,4.49534,57.5352,1179,5,6,1097,1097,909,1055,1041
37919,1131,1666,34868,3051,0,37919,2.9349e+18,493.007,4869.81,37919,381,218,36253,36247,35358,35227,26065
4531,18,32,0,4531,4326,205,2.45071e+16,14.2187,217.294,4531,19,18,4499,4489,4427,4431,4211
6882,159,476,0,6882,0,6882,1.91688e+18,154.55,1354.93,6882,164,113,6340,6106,5733,4375,4086
29045,70,2254,29045,0,26651,2394,9.3106e+17,442.763,5043.9,29045,559,180,23977,22059,17185,5324,2345
12357,163,332,12357,0,12357,0,3.47503e+18,186.096,1275.58,12357,97,151,11927,11721,10504,10358,7873
23626,2075,2228,23626,0,21379,2247,1.27302e+18,234.714,4582.62,23626,409,246,21398,21398,21388,21382,20793
45487,325,1798,42185,3302,0,45487,2.65818e+18,614.301,5405.61,45487,457,225,42414,41452,39334,39218,10840
29253,411,650,29253,0,29253,0,3.61207e+18,307.897,2788.78,29253,188,149,28600,28485,27061,26535,23172
8137,135,959,7070,1067,0,8137,4.74536e+18,60.312,1631.93,8137,236,118,7178,7053,6081,5651,1150
45403,92,2405,45403,0,40605,4798,1.41908e+18,418.421,6201.23,45403,426,217,38093,32267,30969,16789,5799
44596,1023,1425,40208,4388,40208,4388,2.51964e+18,589.988,4964.2,44596,474,193,43171,42795,42466,42538,31756
33930,5,91,0,33930,33678,252,1.9895e+16,29.3621,940.433,33930,41,33,31641,30655,26912,28131,17788
23649,469,744,0,23649,6174,17475,6.48724e+15,235.19,2414.88,23649,315,103,22905,22698,21641,21770,17656
15704,301,480,15704,0,15704,0,2.91926e+18,268.684,1929.37,15704,171,120,15129,14421,14475,14141,13411
1940,267,330,1940,0,1783,157,7.12774e+17,94.1495,607.079,1940,114,61,1610,1539,1531,1602,1434
916,39,182,704,212,704,212,6.53852e+18,38.4432,328.032,916,35,56,701,412,518,489,222
5014,367,434,3759,1255,3759,1255,3.87876e+18,82.8526,941.491,5014,100,83,4580,4578,4574,4573,4247
20894,253,796,4653,16241,0,20894,1.83149e+13,311.601,2467.6,20894,248,157,19822,19393,18939,17245,10991
14689,340,796,13684,1005,13684,1005,5.66341e+17,264.637,2118.16,14689,211,146,13839,13551,13267,13306,10466
6118,82,247,6118,0,6118,0,5.40277e+18,115.739,839.115,6118,88,78,5679,5232,3850,3649,2896
34800,32,1476,32476,2324,0,34800,2.45744e+18,473.095,4240.22,34800,371,260,24809,19589,18131,18167,3638
14118,380,388,3222,10896,0,14118,2.82369e+13,188.771,1618.86,14118,179,93,13730,13729,13727,13728,13537
24113,1302,1372,22560,1553,0,24113,2.38107e+18,402.358,3576.23,24113,319,212,22741,22737,22732,22738,22057
15394,439,1223,15394,0,14332,1062,8.42162e+17,281.152,2768.58,15394,315,135,14120,13742,12644,12249,6817
20055,6,38,19851,204,20053,2,6.97268e+13,6.70177,402.909,20055,16,15,19983,19955,19048,19065,14591
17939,790,879,15843,2096,15843,2096,3.6189e+18,274.136,2131.81,17939,105,224,17060,17060,16975,16938,16145
13367,1175,1446,0,13367,0,13367,1.587e+18,143.577,2899.05,13367,346,147,11921,11921,11921,11921,10012
13541,145,683,11993,1548,0,13541,3.39425e+18,300.885,2118.17,13541,246,124,11567,10502,10509,10806,2755
30231,90,733,22763,7468,22763,7468,7.04499e+18,337.868,2487.56,30231,200,160,28121,27389,19086,14646,7745
46325,1032,1361,43230,3095,43230,3095,6.5947e+17,743.934,4775.19,46325,406,247,44964,44855,44370,44016,41567
46649,573,677,46649,0,46649,0,3.44333e+18,332.174,3682.5,46649,239,193,45972,45962,45750,45446,43956
37093,363,610,8497,28596,0,37093,2.87731e+13,229.273,2965.34,37093,245,134,36483,36478,35966,36222,25274
10436,6,8,10243,193,10436,0,9.79069e+13,6.83892,187.611,10436,8,8,10419,10413,10319,10319,9179
30361,1933,2278,30248,113,30181,180,3.26782e+18,86.7393,4410.88,30361,450,70,28083,28083,27783,28075,24582
2923,399,599,2923,0,2717,206,6.64955e+17,55.8652,1022.92,2923,155,61,2324,2324,2321,2307,1777
7879,168,545,0,7879,0,7879,2.13977e+18,125.002,1150.31,7879,82,111,7334,7188,6592,4279,3127
37478,945,1755,33342,4136,33342,4136,3.42633e+18,278.289,3926.79,37478,373,176,35723,35716,31754,30022,13713
46949,38,86,0,46949,46313,636,2.20245e+16,25.2573,1084.7,46949,35,38,46863,46852,44850,44642,37583
29208,3622,4654,29208,0,29208,0,2.34666e+18,13.268,6732.32,29208,943,20,24554,24554,24093,24220,20146
42337,287,405,11036,31301,0,42337,1.28811e+13,303.654,2674.93,42337,240,143,41830,41310,39665,39833,38075
41664,151,626,39778,1886,39778,1886,1.43427e+18,485.005,3418.18,41664,278,194,36750,31714,33030,33676,13681
7876,3,10,7830,46,7876,0,1.03927e+14,7.81272,174.276,7876,9,9,7464,7282,6384,7066,5005
48256,2441,2812,43570,4686,0,48256,3.45937e+18,461.709,6887.8,48256,631,288,45444,45380,45184,45131,41918
29701,254,744,22403,7298,22403,7298,3.78536e+18,367.711,2600.41,29701,193,172,28401,27402,27211,26872,11308
20968,469,486,5830,15138,0,20968,6.32019e+13,197.141,1622.12,20968,126,105,20482,20481,20482,20474,20304
9115,238,1124,8118,997,8118,997,3.37465e+18,95.9347,1949.18,9115,378,84,7991,7829,7144,5522,4099
7999,330,365,0,7999,2086,5913,7.42237e+15,127.22,981.84,7999,74,95,7634,7632,7602,7610,7309
15421,640,1183,15421,0,13998,1423,7.48633e+17,299.313,2882.99,15421,372,152,14238,14185,14077,12039,10777
41420,66,98,0,41420,41247,173,2.28595e+16,33.1596,1105.44,41420,44,38,41322,41308,40613,39948,35382
5661,646,741,5127,534,0,5661,3.50795e+18,104.139,1341.63,5661,173,76,4920,4920,4865,4913,4656
28879,1560,1968,0,28879,0,28879,1.44115e+18,360.904,4457.06,28879,711,141,26911,26856,26525,26733,25033
40045,60,733,11164,28881,0,40045,6.29108e+13,244.552,2501.72,40045,170,141,38036,37226,31687,14798,8986
39223,51,474,39223,0,39223,0,5.07472e+18,267.747,2726.87,39223,223,170,33578,28621,20265,18929,9666
20942,42,59,0,20942,20839,103,2.8748e+16,21.2387,532.97,20942,25,27,20883,20873,20800,20851,20001
13268,278,976,12417,851,12417,851,6.22005e+17,397.906,2383.43,13268,244,157,12023,11711,11190,11229,3816
9322,19,390,9322,0,9322,0,4.8912e+18,155.068,1278.26,9322,132,97,6571,5363,3911,3278,1482
44528,733,1449,39745,4783,0,44528,3.11797e+18,390.507,5009.8,44528,419,222,43079,42843,40116,40361,27568
44943,675,1620,11310,33633,0,44943,2.92087e+13,225.985,4106.73,44943,371,158,43323,43292,37878,38892,15358
18365,19,637,13848,4517,13848,4517,6.98624e+18,287.706,1887.24,18365,149,140,11384,7142,7132,6965,606
29603,24,925,26044,3559,26044,3559,1.71288e+18,397.954,3561.73,29603,278,180,20218,16060,12557,14325,3406
42254,705,2062,0,42254,0,42254,1.40914e+18,459.801,5801.75,42254,555,136,40107,39606,37749,22960,15068
18856,790,1115,3645,15211,0,18856,2.51388e+13,173.955,2685.56,18856,342,71,17741,17741,17425,17740,15615
27507,685,708,0,27507,0,27507,4.13415e+18,325.809,2339.48,27507,184,152,26799,26799,26798,26796,26613
25529,580,705,19258,6271,0,25529,8.2736e+18,299.482,2285.74,25529,190,158,24824,24813,24711,24692,23416
3199,79,227,855,2344,0,3199,2.30539e+13,46.3742,603.193,3199,115,42,2972,2891,2899,2848,1759
32051,1196,2535,7106,24945,0,32051,6.17436e+12,275.243,4626.56,32051,355,111,29516,29516,26460,23127,16708
18719,445,639,18719,0,14100,4619,8.28271e+17,314.844,2025.61,18719,171,144,18080,17984,17683,16837,14319
13131,8,12,12960,171,13131,0,9.67833e+13,9.78494,220.293,13131,10,10,13114,13107,12679,12680,12357
17199,316,761,15372,1827,0,17199,3.09086e+18,312.899,2454.8,17199,263,129,16081,14344,14899,14933,7172
44797,6,12,44148,649,41151,3646,7.95599e+13,6.84852,427.663,44797,9,8,44603,44236,40764,40760,40654
27012,275,974,0,27012,6258,20754,5.67677e+15,240.791,3039.27,27012,373,125,26021,25709,23539,23143,9408
20961,263,657,18531,2430,18531,2430,3.14748e+18,334.844,2600.8,20961,228,157,19948,19268,16773,15716,7980
16667,234,908,14791,1876,0,16667,4.11767e+18,191.192,2105.27,16667,113,155,15728,15104,13914,13942,5718
35236,254,1158,0,35236,9155,26081,7.62326e+15,226.305,2967.06,35236,129,159,34051,33680,28890,29662,7303
26056,93,963,22876,3180,22876,3180,2.91589e+18,321.083,3436.62,26056,350,170,21866,19093,18265,15890,4871
25484,3,8,25226,258,25484,0,1.0515e+14,7.77115,295.863,25484,8,8,24781,24458,23147,23652,15561
24013,13,35,0,24013,23963,50,1.78307e+16,15.8052,531.647,24013,25,20,23875,23727,23110,23510,15228
35414,1192,1275,35414,0,33112,2302,9.88829e+17,639.408,4058.55,35414,405,217,34139,34139,34032,34024,33620
16590,490,527,0,16590,4610,11980,1.61711e+16,166.717,1615.42,16590,113,109,16063,16062,16053,16051,15631
4954,415,513,1026,3928,0,4954,1.86381e+13,112.523,1162.67,4954,122,96,4441,4427,4417,4426,4120
27576,1277,1300,0,27576,0,27576,1.20813e+18,426.189,3654.77,27576,298,224,26276,26276,26276,26273,26064
8312,919,1393,8312,0,8312,0,1.61421e+18,7.49038,1876.13,8312,699,9,6919,6919,6919,6919,5277
23209,639,691,17472,5737,17472,5737,3.82145e+18,334.775,2276.55,23209,181,153,22518,22516,22501,22503,22104
18468,704,1026,0,18468,3674,14794,5.99532e+15,166.847,2602.78,18468,342,71,17442,17442,17130,17427,12183
26301,427,808,0,26301,5648,20653,4.84808e+15,390.959,2796.16,26301,314,176,25378,24768,24475,23882,17738
42306,388,2408,38395,3911,38391,3915,1.28998e+18,321.943,6060.11,42306,726,198,39569,38951,36866,35684,7224
47537,1048,1450,47537,0,44404,3133,9.89424e+17,724.156,5015.3,47537,438,244,46087,45495,44948,45466,42378
42495,730,1369,37335,5160,0,42495,3.90686e+18,329.445,4608.66,42495,305,188,41126,41120,40027,39981,33712
19067,60,84,0,19067,19015,52,2.15036e+16,31.1334,627.964,19067,37,33,18983,18979,18976,18983,18566
44164,1191,1773,41190,2974,41190,2974,2.10067e+18,548.496,5270.13,44164,418,265,42391,42193,41208,41353,28248
23415,661,1444,20994,2421,20994,2421,1.47714e+18,321.5,3692.64,23415,305,166,21971,21965,19934,20035,8583
8954,3,12,8821,133,8954,0,9.60047e+13,10.2606,182.947,8954,10,10,8594,8406,8143,8109,6055
31437,768,2934,23377,8060,23377,8060,5.37405e+18,22.4617,3756.28,31437,899,766,28503,28503,15193,10331,23298
38993,353,627,38993,0,38993,0,4.34688e+18,262.339,3159.41,38993,222,178,38366,38173,35576,34973,29792
11081,704,1223,10205,876,0,11081,2.97958e+18,131.468,2266.45,11081,279,174,9858,9858,9858,9857,5871
42413,292,1348,0,42413,0,42413,1.55861e+18,447.765,4719.58,42413,416,201,39494,34727,35529,21439,9131
34427,10,18,33856,571,34427,0,9.86927e+13,9.95663,394.072,34427,14,12,34403,34388,32900,32912,32392
44656,403,1815,44656,0,40126,4530,7.9555e+17,595.294,5459.23,44656,504,178,42003,38534,33378,24891,10212
26575,1003,1542,24052,2523,24052,2523,2.95035e+18,335.576,3709.86,26575,472,178,25033,25033,24291,23672,20044
31803,1062,1183,29769,2034,0,31803,2.33048e+18,618.398,3746.15,31803,329,195,30620,30594,30537,30543,29907
31390,508,2061,27647,3743,27553,3837,2.05141e+18,562.702,4799.1,31390,498,247,28627,27164,23165,26418,3596
3561,105,133,0,3561,3481,80,2.50514e+16,17.8815,430.843,3561,51,23,3428,3426,3405,3400,2891
21634,813,1061,21634,0,20251,1383,9.46127e+17,516.091,3057.27,21634,301,183,20573,19917,19687,20002,18783
38933,1321,1356,34862,4071,34862,4071,2.87802e+18,494.546,4461.47,38933,506,177,37577,37577,37577,37577,37497
34893,1221,2096,31641,3252,31641,3252,2.90155e+18,310.183,5091.73,34893,525,193,32797,32797,31001,29626,20237
48109,88,461,48109,0,48109,0,4.18717e+18,271.286,3066.57,48109,275,172,44498,41683,28512,25972,12962
1283,205,235,1134,149,1134,149,2.0023e+18,30.5246,434.259,1283,80,54,1048,1048,1012,1047,850
15999,42,62,0,15999,15910,89,2.69468e+16,24.514,537.724,15999,30,31,15937,15921,15546,15623,14511
48777,9,11,46448,2329,48777,0,9.62955e+13,10.6475,493.773,48777,11,11,48735,48708,47347,47348,48724
13092,571,961,12255,837,12255,837,1.97133e+18,253.17,2271.48,13092,248,149,12131,11891,11748,11804,9114
12368,382,416,0,12368,3213,9155,6.89832e+15,218.643,1542.69,12368,227,98,11952,11952,11944,11919,10375
4738,677,739,0,4738,0,4738,1.16814e+18,152.663,1391.42,4738,135,103,3999,3999,3998,3999,3868
16722,647,1094,13488,3234,13488,3234,6.55622e+18,14.8792,2186.83,16722,549,15,15628,15628,15181,11849,10563
48399,440,761,11030,37369,0,48399,2.84939e+13,242.159,3598.79,48399,284,149,47638,47631,47021,47427,32864
16274,512,937,15239,1035,0,16274,2.32452e+18,301.869,2429.3,16274,238,149,15337,15011,14934,14830,12390
48547,67,517,48547,0,48547,0,3.50769e+18,348.005,2736.21,48547,514,64,45974,45492,30347,19056,11993
24198,24,701,18222,5976,0,24198,8.31992e+18,321.602,2226.12,24198,181,149,16461,9750,10509,10597,958
8233,169,450,7372,861,0,8233,3.82135e+18,201.091,1192.24,8233,93,105,7594,7054,6930,7044,3823
48831,819,1055,48831,0,36808,12023,8.11674e+17,393.464,3669.87,48831,264,192,47776,47748,46941,45272,40979
6443,107,441,5774,669,5774,669,9.18242e+17,196.157,1106.83,6443,91,103,5628,5212,5378,5051,1868
31597,186,753,23849,7748,0,31597,8.22251e+18,345.044,2542.62,31597,193,166,30054,29234,24041,23890,11398
47434,46,778,13204,34230,0,47434,6.29796e+13,268.004,2772.46,47434,185,150,44705,43524,37294,15363,9626
13535,451,557,10206,3329,10206,3329,7.01528e+18,241.292,1584.38,13535,140,117,12978,12950,12905,12888,11437
6665,596,697,6171,494,6171,494,1.28439e+18,192.164,1481.92,6665,262,78,5968,5939,5887,5896,5585
2823,12,266,2638,185,2638,185,5.25672e+17,116.604,659.372,2823,85,66,1525,1052,900,936,511
33311,122,477,33311,0,33311,0,5.13024e+18,289.065,2459.52,33311,210,150,31798,30497,21186,18866,13521
32677,239,862,7078,25599,0,32677,1.84774e+13,440.59,3150.25,32677,316,194,31078,30222,29188,25532,12972
17512,38,42,0,17512,17478,34,2.12322e+16,27.8455,464.802,17512,30,33,17470,17464,16534,16865,16714
41208,398,982,0,41208,9543,31665,7.4121e+15,231.039,3517.81,41208,259,145,40226,40200,39492,38993,28168
18319,238,1230,16806,1513,0,18319,3.07162e+18,295.681,3063.15,18319,440,110,16726,16282,15725,15255,5855
43616,1543,1899,9491,34125,0,43616,2.54361e+13,220.933,4973.32,43616,429,185,41717,41712,41661,41717,36693
2801,1,9,2666,135,2801,0,9.75774e+13,7.95395,117.126,2801,9,9,1081,1081,1081,1081,1081
27270,762,1252,27270,0,25411,1859,9.5685e+17,622.106,3645.8,27270,347,206,25954,24928,23701,22962,18615
44356,1806,2027,0,44356,0,44356,1.81022e+18,333.264,5544.13,44356,407,229,42329,42319,42329,42329,41490
42105,193,405,10941,31164,0,42105,1.25576e+13,297.858,2661.89,42105,242,146,40996,38546,38066,37814,34101
1984,11,15,0,1984,1982,2,1.68887e+16,12.7434,147.491,1984,14,13,1845,1284,1711,1767,1789
37465,1551,2430,34093,3372,0,37465,3.20938e+18,388.167,5790.22,37465,530,237,35035,34984,34603,34611,24044
14734,359,591,0,14734,0,14734,1.91153e+18,266.487,2098.81,14734,211,142,14112,13853,13453,13408,9857
22834,434,1117,0,22834,0,22834,1.8441e+18,521.872,3004.5,22834,461,133,21173,20340,19354,18930,14154
8255,492,580,1848,6407,0,8255,1.85154e+13,102.717,1434.33,8255,159,118,7675,7675,7657,7661,6948
1676,345,399,1430,246,0,1676,3.29086e+18,67.4356,641.992,1676,94,62,1277,1251,1277,1277,1175
17406,21,25,0,17406,17391,15,1.37318e+16,9.94278,416.445,17406,14,10,17381,17381,17332,17347,17061
41563,634,1125,0,41563,0,41563,1.74626e+18,346.5,4507.48,41563,389,192,40438,40419,38889,38399,24300
22358,482,604,22358,0,21439,919,4.63113e+17,377.043,2514.81,22358,232,154,21754,21606,20887,19903,21489
35197,856,3987,35197,0,35197,0,4.83913e+18,16.2988,5678.07,35197,1031,26,31210,31210,28722,31210,13986
27697,400,451,27697,0,27697,0,5.14196e+18,288.43,2235.09,27697,180,148,27246,27230,27032,26720,26058
40815,788,1576,0,40815,0,40815,1.23253e+18,679.505,4816.9,40815,408,248,39120,38804,37539,33099,22302
17134,76,1357,15394,1740,15391,1743,1.29299e+18,174.505,2874.6,17134,406,123,14887,14174,12301,13165,3944
19359,238,916,17247,2112,17247,2112,8.96508e+17,217.99,2313.54,19359,123,182,18317,17228,17095,16493,5315
36558,1,13,36312,246,36558,0,1.03473e+14,11.6236,375.161,36558,12,11,19890,19890,19890,19890,19890
46988,467,1903,0,46988,11037,35951,6.79954e+15,248.512,5085.7,46988,526,165,44923,44627,40229,38360,11392
37827,1596,2058,28986,8841,28986,8841,6.60646e+18,288.593,4616.62,37827,334,213,35769,35769,35769,35752,32754
9675,603,641,9675,0,9675,0,1.20157e+18,16.8521,1360.66,9675,322,17,9034,9034,9034,9034,8667
41044,555,646,41044,0,39249,1795,5.29913e+17,501.497,3475.29,41044,275,194,40368,39979,40087,36614,38835
15561,316,947,14073,1488,14073,1488,3.00737e+18,458.168,2159.55,15561,418,97,14200,13814,12985,12077,9074
25232,322,1062,0,25232,0,25232,1.20926e+18,552.384,3291.61,25232,278,209,23345,22657,21850,21109,6595
26743,327,729,23609,3134,23609,3134,3.16233e+18,350.858,3019.36,26743,266,185,25784,25039,23521,22826,11304
19137,646,683,19133,4,19137,0,3.97479e+18,237.771,2276.45,19137,168,121,18454,18451,18410,18393,18341
26255,38,720,23190,3065,23190,3065,3.17893e+18,341.728,2973.54,26255,246,166,19900,17582,15721,14957,2495
12395,246,985,11566,829,11566,829,2.0447e+18,215.134,2237.09,12395,218,139,11266,11076,10590,10342,6486
37019,30,62,0,37019,36640,379,2.55946e+16,32.6265,728.921,37019,35,33,36920,36830,35966,35973,28804
19272,1,6,19255,17,19272,0,5.36311e+13,5.99159,275.42,19272,6,6,10095,10095,10095,10095,10095
16059,246,1029,15021,1038,15021,1038,6.32086e+17,305.901,2611.62,16059,187,171,14759,14463,13721,13699,3545
12028,196,659,10601,1427,10601,1427,1.72082e+18,311.682,2059.52,12028,197,143,11020,10552,9851,9974,5550
36213,929,980,8578,27635,0,36213,2.97904e+13,222.341,3381.71,36213,243,130,35233,35233,35228,35231,34905
29841,1193,1465,26856,2985,0,29841,3.20528e+18,436.91,4066.27,29841,434,172,28376,28312,28170,28282,25763
15355,621,953,14372,983,14372,983,1.97789e+18,268.089,2380.34,15355,228,141,14402,14199,14066,14101,12073
6931,363,377,6931,0,6931,0,3.75226e+18,142.179,1103.35,6931,200,83,6554,6553,6548,6549,6390
10596,47,401,10596,0,10596,0,3.22859e+18,183.019,1279.91,10596,121,100,9253,6376,5352,5256,1612
17122,173,1092,16012,1110,16012,1110,2.00946e+18,490.868,2780.55,17122,324,178,15300,14605,13448,13448,5763
7566,13,30,0,7566,7418,148,1.84573e+16,14.3333,275.955,7566,20,16,7522,7490,7395,7491,5869
30092,1025,1260,28061,2031,28061,2031,6.872e+17,608.652,3808.32,30092,352,214,28832,28795,28508,28497,26973
4736,47,292,1061,3675,0,4736,2.83546e+13,73.6163,865.548,4736,107,53,4168,3766,3489,1751,920
35705,57,93,0,35705,34503,1202,2.49362e+16,28.9325,1018.18,35705,41,34,35612,35606,34789,35132,26002
32109,74,815,7120,24989,0,32109,1.89528e+13,430.43,3039.79,32109,333,166,29058,26399,25725,21018,8466
10017,6,10,9929,88,10017,0,9.69442e+13,8.98203,194.351,10017,10,10,9967,9928,9427,9432,9897
19101,414,708,4951,14150,0,19101,2.95882e+13,170.158,1887.74,19101,107,131,18393,18362,17877,18068,14427
23353,366,892,23353,0,21783,1570,1.11202e+18,470.475,2825.42,23353,277,183,21998,21204,19366,19958,15485
27546,1125,1191,25767,1779,0,27546,2.34033e+18,615.374,3617.54,27546,380,203,26355,26355,26296,26324,25965
17728,528,1188,17728,0,15898,1830,7.88999e+17,341.156,3079.47,17728,382,159,16540,16395,16291,14019,13533
35788,54,98,0,35788,35650,138,2.23817e+16,32.3921,1014.92,35788,43,30,35690,35662,35203,34777,31098
3113,122,228,809,2304,0,3113,2.95199e+13,79.3652,551.429,3113,50,63,2885,2775,2720,2766,1736
37430,196,484,37430,0,37430,0,5.04705e+18,302.196,2631.06,37430,207,166,36430,35501,29497,27861,22746
3781,21,332,3382,399,3382,399,3.28547e+18,115.802,735.299,3781,77,75,2779,1284,1945,2080,535
31151,411,869,0,31151,6856,24295,4.76751e+15,408.239,3072.32,31151,321,182,30018,29320,28832,28106,19177
21328,256,1322,19632,1696,0,21328,2.94847e+18,245.382,3198.37,21328,327,134,19869,19654,18663,18237,3765
36617,1134,2492,36617,0,34057,2560,3.55617e+18,594.624,5387.96,36617,789,160,34125,33270,25576,30585,19994
34270,527,543,34270,0,34270,0,3.30056e+18,286.593,2434.71,34270,193,138,33727,33727,33718,33705,33552
14841,32,43,0,14841,14721,120,2.49806e+16,32.6439,410.089,14841,24,26,14785,14746,14609,14739,13162
40244,223,499,40244,0,40244,0,5.19792e+18,320.839,2777.52,40244,209,168,39307,38464,30934,30731,24411
29915,62,89,0,29915,29664,251,1.9718e+16,26.7319,875.671,29915,39,32,29826,29824,29781,29797,24787
10225,250,500,0,10225,2669,7556,7.56819e+15,127.631,1272.82,10225,84,110,9725,9672,9329,9385,6452
42287,572,663,34167,8120,42287,0,3.81061e+18,380.511,3309.71,42287,292,161,41624,41548,40857,40515,40110
30373,4,13,30174,199,30373,0,1.03367e+14,9.33961,338.276,30373,11,10,29983,29825,27991,28330,23882
47743,278,886,0,47743,0,47743,4.13162e+18,389.509,3262.58,47743,253,185,46185,44231,37200,24409,19098
3121,6,20,0,3121,2988,133,2.42426e+16,12.108,160.911,3121,16,15,2934,2844,2298,2640,2220
9308,31,319,9308,0,9308,0,3.46695e+18,162.235,1085.67,9308,91,124,7625,5820,4392,3189,1351
24694,145,514,24694,0,24694,0,3.15718e+18,280.596,2048.61,24694,167,128,23632,23108,18068,17282,8407
17075,3,12,16876,199,17075,0,8.53906e+13,6.03291,261.424,17075,8,9,16583,16433,14696,15264,11778
38329,14,68,0,38329,38037,292,2.55188e+16,53.0094,873.136,38329,41,43,37527,36824,35023,34483,22161
41526,579,1365,0,41526,0,41526,1.22609e+18,707.481,4499.86,41526,380,239,39543,37689,37629,33251,18798
7889,274,530,0,7889,0,7889,1.95732e+18,257.124,1372.73,7889,163,93,7182,6895,6722,7113,5498
38916,397,640,38916,0,38916,0,3.87802e+18,303.301,3138.23,38916,201,177,38276,38112,34217,33563,25651
25869,466,502,5888,19981,0,25869,2.82521e+13,226.091,2348.78,25869,223,121,25367,25367,25340,25363,25021
32384,436,2431,0,32384,0,32384,3.32717e+16,23.6823,4561.77,32384,379,24,29953,29953,27917,14354,9388
14963,339,583,14289,674,14289,674,1.42798e+18,329.439,2024.22,14963,207,136,14344,13714,13409,13313,12974
39114,1258,2151,33061,6053,33061,6053,4.51656e+18,436.088,5248.27,39114,535,216,36963,36953,36325,36083,15403
38879,3,13,38577,302,38879,0,1.00018e+14,11.6323,386.459,38879,12,12,37456,36707,34953,35729,24530
13729,6,32,0,13729,13087,642,2.45792e+16,27.2157,382.201,13729,23,23,12846,12492,9430,11580,7118
22375,561,872,19734,2641,19734,2641,1.70517e+18,397.397,3038.22,22375,257,170,21503,21463,20719,20704,15435
1829,131,173,1829,0,1829,0,2.8188e+18,59.1263,434.06,1829,86,41,1656,1613,1588,1554,1409
9762,224,459,8727,1035,8727,1035,3.30084e+18,189.762,1288.35,9762,92,115,9294,8564,8457,8181,5326
38575,715,793,9342,29233,0,38575,2.70202e+13,226.805,3428.2,38575,343,144,37782,37782,37776,37757,35863
1456,1,6,1406,50,1456,0,9.12481e+13,5.85165,77.6007,1456,6,6,601,601,601,601,601
32774,162,1479,32774,0,28809,3965,1.11424e+18,330.99,4364.4,32774,325,174,29671,25793,25034,16107,8053
25547,821,1574,23817,1730,23817,1730,6.89079e+17,438.275,4048.75,25547,268,241,23973,23802,23174,22957,11065
24664,172,633,5632,19032,0,24664,1.82932e+13,328.211,2265.32,24664,240,137,23477,23058,22052,20781,12477
3230,182,349,0,3230,597,2633,6.12475e+15,36.4217,686.57,3230,92,38,2881,2881,2729,2384,2382
30837,352,1209,0,30837,0,30837,1.50211e+18,417.936,3954.74,30837,407,156,29236,26616,26285,18272,12129
49454,519,1418,46194,3260,46194,3260,6.42889e+17,700.655,4893.37,49454,422,260,47004,45132,44538,44657,35021
44028,941,1044,10642,33386,0,44028,2.43009e+13,267.061,3973.09,44028,387,164,42984,42984,42950,42966,41585
41537,733,992,41537,0,31312,10225,8.94569e+17,375.688,3345.92,41537,246,177,40545,40498,39785,37763,33005
23425,358,972,20564,2861,0,23425,3.74692e+18,298.537,3130.98,23425,306,169,22378,21871,18333,18726,7920
42017,1388,1415,0,42017,0,42017,1.46638e+18,587.589,4801.23,42017,474,191,40602,40602,40597,40596,40314
32994,1343,2164,32994,0,30045,2949,1.05035e+18,349.043,5220.38,32994,664,116,30830,30830,30419,30702,25026
25911,1105,1195,24213,1698,0,25911,2.392e+18,597.516,3498.13,25911,369,209,24716,24714,24633,24631,24173
24488,178,1791,22705,1783,22705,1783,2.29367e+18,326.64,3974.83,24488,599,139,22327,21840,20064,19645,5207
7311,132,456,5493,1818,0,7311,8.39359e+18,128.67,1082.23,7311,104,83,6803,6704,5652,5685,2970
36365,2474,3218,26782,9583,0,36365,6.42574e+18,22.1406,4023.91,36365,1080,1075,33147,33147,27995,28249,32165
20016,468,1341,0,20016,0,20016,1.12442e+18,428.745,3312.42,20016,293,192,18557,18011,17745,9208,9940
17802,1163,1732,16075,1727,16075,1727,1.16479e+18,211.991,3680.65,17802,348,220,16070,16070,15465,15595,10850
23452,9,27,0,23452,23428,24,7.55851e+14,15.5807,485.87,23452,21,10,23372,23334,23296,23133,17020
40543,1139,1706,0,40543,0,40543,1.21691e+18,635.684,4981.27,40543,408,226,38837,38774,38567,36320,35739
44294,36,500,44294,0,44294,0,5.10589e+18,338.095,2899.41,44294,218,169,35962,28492,21700,18252,7664
28960,1405,1508,6778,22182,0,28960,3.33064e+13,222.644,3046.67,28960,323,253,27452,27452,27309,27422,26095
46025,153,868,0,46025,0,46025,4.13795e+18,377.721,3189.3,46025,259,182,43460,42309,30327,17019,14522
37158,714,919,0,37158,8629,28529,5.88754e+15,267.94,3467.51,37158,373,141,36239,36203,35973,35980,29036
16324,357,836,15197,1127,15197,1127,2.14923e+18,353.459,2279.73,16324,220,150,15298,14841,14697,14371,11097
27004,1752,1793,22994,4010,0,27004,5.07462e+18,202.501,4454.63,27004,292,157,25211,25211,25209,25207,24921
12721,325,1119,12076,645,0,12721,1.94386e+18,133.408,2186.34,12721,280,105,11602,11568,11496,11458,3814
3789,30,242,3789,0,3789,0,4.0547e+18,124.565,670.507,3789,64,75,3042,2319,1755,1462,590
13677,234,1119,0,13677,0,13677,1.13706e+18,170.919,2603.44,13677,240,96,12534,12301,11787,8583,5961
3898,185,303,977,2921,0,3898,3.1845e+13,152.724,802.316,3898,174,68,3545,3326,3390,3456,1845
7895,332,359,2178,5717,0,7895,6.29454e+13,97.2633,926.284,7895,72,60,7536,7536,7536,7535,7296
2710,58,212,0,2710,667,2043,8.40173e+15,38.8576,452.365,2710,48,45,2498,2454,2250,2285,918
10350,1053,1102,9076,1274,9055,1295,2.17205e+18,331.977,2156.82,10350,256,164,9248,9248,9247,9247,9140
22041,820,1299,22041,0,19699,2342,8.02e+17,371.101,3272.58,22041,336,147,20742,20409,19734,19390,16847
27881,162,1968,0,27881,0,27881,1.77712e+18,237.963,4562.63,27881,481,145,25307,24056,22626,8688,5341
19618,8,12,19022,596,17008,2610,7.65743e+13,6.72357,270.446,19618,9,8,19606,19605,19559,19559,16178
8542,415,595,7385,1157,7385,1157,3.34444e+18,163.945,1596.16,8542,188,125,7947,7910,7728,7651,6464
35989,32,54,0,35989,35477,512,2.09712e+16,23.8433,828.748,35989,29,26,35934,35917,35694,35549,32710
585,2,128,519,66,519,66,3.50455e+18,21.3265,204.854,585,49,17,214,95,118,78,66
32974,875,1206,7594,25380,0,32974,2.17248e+13,329.952,3733.18,32974,356,178,31768,31764,31184,28727,25556
40933,939,1785,40933,0,38171,2762,9.35929e+17,532.104,5399.54,40933,363,282,39148,38908,37135,36714,29688
45148,485,673,45148,0,45148,0,3.38904e+18,322.897,3617.05,45148,233,191,44475,44451,43390,41459,38218
16168,788,1020,14871,1297,14871,1297,1.38484e+18,114.875,2421.75,16168,240,133,15148,15148,14922,15126,12099
43524,1022,2073,43524,0,38840,4684,8.75589e+17,433.77,5889.55,43524,542,175,41451,41256,39863,37290,21264
46117,70,626,44062,2055,0,46117,1.69033e+18,495.801,3576.78,46117,280,200,37396,33700,33257,28677,11567
20259,210,489,20259,0,20259,0,3.1961e+18,234.56,1863.84,20259,153,127,19609,19160,16596,16235,11165
27683,17,47,0,27683,27633,50,2.11595e+16,31.1829,597.574,27683,32,33,27373,27143,23553,25042,20187
9134,383,479,2237,6897,0,9134,2.34358e+13,151.865,1184.75,9134,206,59,8655,8594,8576,8655,8443
24402,719,1115,4005,20397,0,24402,2.16182e+13,253.215,3012.13,24402,442,93,23287,23242,23059,23013,17290
17687,57,2094,0,17687,0,17687,1.30763e+18,97.9116,3638.35,17687,577,172,15071,14392,8261,6668,2527
7199,158,319,1804,5395,0,7199,1.34131e+13,166.347,1048.09,7199,162,77,6754,6341,6401,6372,3794
24446,1944,2016,22053,2393,22053,2393,9.88737e+17,204.277,4241.51,24446,411,200,22430,22430,22430,22430,21999
17481,2,44,0,17481,17376,105,2.62822e+16,31.4538,450.893,17481,26,26,14096,13312,12171,12784,8550
13240,221,1029,11931,1309,11929,1311,1.48659e+18,180.041,2269.28,13240,379,96,12115,11935,11257,11813,7152
3175,90,278,2594,581,3175,0,3.52054e+18,99.4063,679.544,3175,121,48,2815,2502,2419,1961,1427
43348,2543,2820,40277,3071,40277,3071,4.85613e+18,14.8886,5448.44,43348,1409,17,40528,40528,40253,38260,37418
9865,448,751,0,9865,2226,7639,5.1643e+15,99.1087,1728.12,9865,180,125,9114,9092,8907,8876,4817
21902,122,1994,20067,1835,0,21902,3.12828e+18,204.059,3936.77,21902,621,198,19520,16574,16855,17944,2430
33393,563,1680,30603,2790,0,33393,3.03682e+18,374.65,4582.57,33393,355,187,31528,30930,30106,29866,16043
39577,744,1252,0,39577,0,39577,1.17457e+18,641.509,4200.93,39577,421,219,38160,36728,36967,33733,29896
11211,6,30,0,11211,11178,33,2.88976e+16,16.8261,315.579,11211,21,18,11077,11034,8856,10181,7463
41304,82,686,41200,104,41304,0,3.20023e+18,335.874,3484.23,41304,207,188,36088,31014,27391,19864,9645
43988,1087,1898,39160,4828,0,43988,4.01122e+18,325.256,4713.88,43988,353,299,42090,42084,38184,38221,22544
46676,697,1299,43634,3042,0,46676,2.38816e+18,665.834,4565.8,46676,459,237,45108,43302,43513,43248,31203
48229,536,926,0,48229,0,48229,4.15388e+18,392.678,3313.92,48229,258,183,47303,47144,46250,36606,36999
42818,13,44,0,42818,42511,307,2.56067e+16,39.1634,707.69,42818,35,34,42393,41819,40182,40507,31024
7813,143,458,0,7813,0,7813,4.11422e+18,121.07,1126.71,7813,96,103,7310,7162,6537,4254,2816
49911,948,2206,39038,10873,0,49911,7.31587e+18,352.253,5551.31,49911,418,238,47705,47663,46431,46903,36798
3785,294,466,0,3785,0,3785,1.99599e+18,153.001,909.65,3785,129,79,3319,3237,3125,3284,2776
15030,807,2406,0,15030,0,15030,3.20449e+16,12.2417,3523.11,15030,492,19,12624,12624,9839,7225,6900
15541,543,764,13912,1629,13912,1629,8.88197e+17,229.801,2025.85,15541,129,140,14777,14748,14679,14696,11765
872,162,184,814,58,0,872,2.43326e+18,57.6617,328.455,872,47,40,688,679,684,686,664
46906,541,1730,11620,35286,0,46906,2.90485e+13,271.41,4448.04,46906,308,257,45176,44921,42005,35942,24268
9150,394,534,9150,0,6882,2268,8.85522e+17,205.418,1365.81,9150,123,112,8616,8433,8405,7811,7204
8751,262,575,7728,1023,0,8751,4.27447e+18,171.05,1251.88,8751,84,117,8176,8014,7554,7477,4095
20329,910,1458,0,20329,0,20329,1.90094e+18,204.489,3101.66,20329,200,159,18871,18871,18871,18871,17147
47682,294,1901,0,47682,0,47682,1.84006e+18,308.196,5105.48,47682,526,186,45445,44758,39652,35119,10256
25649,290,721,19312,6337,19312,6337,7.0456e+18,315.767,2303.64,25649,182,140,24710,23720,22770,21327,14758
19072,179,370,19072,0,19072,0,4.87713e+18,226.121,1791.92,19072,174,124,18556,18207,15913,15174,12628
39597,13,64,0,39597,39327,270,2.62066e+16,53.7098,889.887,39597,40,43,38712,37874,36051,35215,23062
21692,186,1525,19328,2364,19328,2364,3.37802e+18,217.825,3243.74,21692,398,189,19873,19431,17562,13435,2447
7871,38,294,7871,0,7871,0,3.30299e+18,231.015,1166.72,7871,126,88,6161,5228,4518,3010,1520
19047,7,10,18720,327,16303,2744,7.2412e+13,6.68609,241.915,19047,8,7,19037,19036,19002,19004,18977
11113,27,956,0,11113,0,11113,1.25159e+18,162.915,2132.15,11113,230,108,7752,5905,5311,5137,1556
26286,640,733,19819,6467,19819,6467,3.79482e+18,347.89,2426.06,26286,182,161,25553,25548,25536,25536,24516
16883,248,1259,0,16883,2777,14106,5.52738e+15,164.975,2860.17,16883,375,136,15624,15247,14684,12045,3094
20207,88,1129,0,20207,0,20207,1.78802e+18,490.258,2872.94,20207,465,143,17566,16087,15764,13396,5555
46940,1046,1494,43836,3104,43836,3104,6.71807e+17,778.646,4996.09,46940,399,257,45446,44927,44561,43904,38897
17111,216,611,12880,4231,0,17111,8.35517e+18,262.107,1813.3,17111,169,120,16255,15767,14134,14006,7927
24693,696,1561,21671,3022,21671,3022,3.79575e+18,264.818,3110.9,24693,347,256,23132,23121,19476,14654,4086
4933,331,662,4619,314,4619,314,1.9568e+18,106.478,1289.18,4933,131,120,4271,4268,4194,4188,1475
35098,1491,2279,28304,6794,28304,6794,6.56054e+18,14.8909,4376.46,35098,1141,15,32819,32819,32031,26142,23833
43168,467,685,43104,64,43168,0,3.80666e+18,396.192,3513.66,43168,255,156,42432,42272,41060,41022,36622
29558,871,1942,27420,2138,27420,2138,2.27963e+18,352.215,4541.98,29558,647,140,27616,27206,26815,25732,18479
35365,10,91,0,35365,34770,595,2.5233e+16,37.0878,1014.72,35365,43,36,33976,33009,30861,28892,15226
37583,355,891,8207,29376,0,37583,1.82746e+13,460.779,3398.92,37583,359,194,36216,35215,34606,30217,22168
27772,862,1125,25991,1781,25991,1781,1.98305e+18,467.467,3413.74,27772,350,185,26647,26181,26378,26384,24259
45127,125,666,41481,3646,45127,0,3.62126e+18,344.922,3484.67,45127,269,188,42300,39024,32276,27801,14365
6430,99,336,6430,0,6430,0,3.26495e+18,106.65,942.683,6430,96,86,6054,5935,4840,4772,2953
31674,592,623,30305,1369,30266,1408,7.72844e+17,423.412,2986.49,31674,256,172,31051,30947,31043,31033,30919
36715,4,69,0,36715,36452,263,2.61578e+16,54.1876,861.769,36715,38,41,32189,30590,25146,23679,14966
15974,469,1365,15974,0,14829,1145,8.9209e+17,273.899,2947.35,15974,361,130,14592,14216,13231,13509,6584
34072,84,1359,31874,2198,0,34072,2.37846e+18,523.323,4159.95,34072,355,191,28857,24907,24565,24898,8302
13540,26,731,0,13540,3084,10456,4.64594e+15,177.294,1920.4,13540,256,129,10948,9164,8723,7867,2359
44941,10,13,44617,324,44941,0,9.84391e+13,12.2193,418.733,44941,13,13,44910,44892,43055,43053,38304
18268,374,414,18268,0,18268,0,5.30336e+18,237.449,1771.33,18268,178,120,17854,17792,17714,17461,17383
3772,169,324,3378,394,0,3772,3.82121e+18,126.552,735.361,3772,74,76,3413,3229,3244,3264,2514
7582,199,607,6722,860,6722,860,3.07841e+18,241.201,1540.69,7582,214,97,6591,5990,6103,5793,2479
7365,293,330,0,7365,1672,5693,7.09472e+15,132.944,1113.61,7365,145,75,7035,7006,6996,7018,6432
44917,1,15,43878,1039,41197,3720,7.8846e+13,6.42579,408.255,44917,9,10,27601,27601,27601,27601,27601
42983,2117,2175,42983,0,39038,3945,1.52549e+18,401.618,5680.77,42983,397,309,40808,40808,40808,40808,40693
49878,247,519,49878,0,49878,0,5.10011e+18,326.717,3059.16,49878,226,182,48926,47982,39193,37180,33715
2021,25,309,0,2021,0,2021,1.8072e+18,68.7996,563.906,2021,124,40,1518,1364,1241,431,280
46571,343,747,10559,36012,0,46571,2.84546e+13,245.01,3494.01,46571,277,150,45824,45805,44334,45108,26264
35777,1258,2304,32214,3563,0,35777,3.47943e+18,308.496,5371.31,35777,636,246,33473,33412,33080,32929,25464
18628,143,1455,16954,1674,16954,1674,1.32965e+18,334.844,3393.91,18628,428,120,15859,14515,12191,13621,3891
24165,960,1127,3997,20168,0,24165,2.12655e+13,223.099,3033.14,24165,455,93,23038,23038,22935,22941,22114
27240,598,1439,24219,3021,24219,3021,3.39702e+18,578.429,3545.9,27240,483,184,25404,23845,23334,21971,8676
22632,153,448,22632,0,22632,0,3.85685e+18,238.451,2183.28,22632,234,127,21706,20704,18382,17728,11580
34031,65,79,0,34031,33413,618,2.05029e+16,23.7275,879.319,34031,32,34,33952,33950,33687,33807,33394
46817,2388,2986,42665,4152,42664,4153,1.17791e+18,427.798,7153.56,46817,614,268,43831,43816,43824,43781,37473
29879,12,457,29879,0,29879,0,5.1751e+18,287.276,2319.33,29879,188,144,19248,14028,11173,8446,3581
45590,336,1832,36051,9539,0,45590,7.06381e+18,304.418,5209.93,45590,286,209,43599,42114,29739,30191,6032
8687,777,1063,0,8687,0,8687,1.27657e+18,101.156,1839.46,8687,331,143,7624,7624,7624,7624,6543
23045,54,696,17377,5668,0,23045,8.27315e+18,298.109,2157.77,23045,176,156,20830,17982,13945,14889,3617
32197,1073,1107,28268,3929,28268,3929,1.71826e+18,393.329,3878.75,32197,281,194,31090,31090,31088,31090,30888
18471,296,637,16232,2239,0,18471,3.87723e+18,304.399,2434.4,18471,229,154,17643,17152,15681,15511,9022
23527,613,681,17750,5777,17750,5777,6.99213e+18,317.113,2177.3,23527,184,148,22846,22844,22797,22782,22260
38849,31,865,29216,9633,29216,9633,3.83381e+18,392.359,3084.72,38849,235,180,27383,14643,17089,16450,2489
1261,103,310,1078,183,1078,183,2.48772e+18,57.2205,494.14,1261,77,43,951,869,719,863,579
21390,25,759,16113,5277,16113,5277,6.9824e+18,263.457,2376.1,21390,189,168,14674,8635,9658,8863,2259
32115,39,1502,0,32115,0,32115,1.26108e+18,465.401,4190.61,32115,356,253,23507,18507,18308,16295,4592
12373,64,748,0,12373,0,12373,1.2165e+18,262.118,1891.07,12373,192,117,10062,8361,8180,8286,2086
6886,254,319,1539,5347,0,6886,2.73515e+13,138.97,1065.44,6886,134,68,6567,6533,6529,6566,6082
26660,1246,1266,26660,0,24846,1814,9.66955e+17,632.975,3640.72,26660,363,203,25394,25394,25387,25389,25343
23152,40,667,20291,2861,0,23152,3.94017e+18,292.735,2722.4,23152,245,163,17532,15412,14087,13791,1868
6150,212,667,5372,778,0,6150,3.19196e+18,182.751,1497.8,6150,235,90,5351,4984,4655,4704,2496
48790,84,86,0,48790,48123,667,2.12599e+16,24.2096,1122.74,48790,32,39,48704,48704,48529,48495,48528
19243,528,530,17423,1820,19243,0,3.84698e+18,258.846,2079.01,19243,262,116,18713,18713,18713,18713,18695
36662,5,14,36068,594,34380,2282,8.0154e+13,6.73411,374.092,36662,9,10,36495,36305,33860,33858,28186
21616,133,766,0,21616,5385,16231,8.36994e+15,253.581,1945.5,21616,99,219,20426,19986,17380,17786,7202
29887,792,1257,7421,22466,0,29887,2.94201e+13,180.034,3104.16,29887,338,134,28630,28625,25973,27030,15249
40806,2057,2811,36900,3906,36897,3909,1.3909e+18,430.726,6622.11,40806,672,220,37995,37941,37814,37810,30721
21925,10,12,21851,74,21001,924,7.98788e+13,6.76602,304.04,21925,10,8,21913,21913,21904,21903,21899
31936,270,1350,29754,2182,29754,2182,7.00076e+17,679.07,4055.64,31936,382,209,29132,28261,26970,26921,11223
10214,191,953,9383,831,9383,831,2.54904e+18,113.52,2033.51,10214,318,98,9261,9215,8213,8596,2970
4099,62,413,3651,448,3649,450,9.77623e+17,101.645,949.186,4099,83,90,3548,3419,3059,3051,1076
44992,791,1450,0,44992,0,44992,1.22651e+18,624.297,4743.94,44992,383,244,43454,42818,42075,35942,34588
42408,308,646,11778,30630,0,42408,6.31724e+13,276.721,2480.1,42408,203,137,41727,41424,40070,40271,26957
6155,691,864,5490,665,0,6155,4.01026e+18,100.824,1542.14,6155,188,77,5291,5291,5234,5271,4815
32240,488,1592,28404,3836,28404,3836,3.69321e+18,329.185,3517.51,32240,257,289,30636,29946,25493,19000,3871
27978,379,1568,27978,0,26139,1839,8.98012e+17,570.392,4158.24,27978,374,208,25798,25070,22265,20909,10564
37385,533,1534,0,37385,9293,28092,7.45689e+15,201.409,3680.35,37385,466,159,35851,35747,31347,32189,10519
6460,386,422,0,6460,0,6460,7.68401e+17,260.38,1248.53,6460,149,94,6038,5990,5927,5959,5825
45017,443,2857,45017,0,41096,3921,1.10332e+18,433.669,6997.66,45017,639,273,41694,40526,38204,24785,12590
30331,36,39,0,30331,30291,40,9.14648e+15,10.9556,748.593,30331,16,11,30292,30292,30239,30241,29707
33978,290,772,25620,8358,0,33978,8.28506e+18,340.549,2680.91,33978,217,166,32886,31533,28937,28871,18578
23558,1137,1275,23558,0,22044,1514,8.68351e+17,446.689,3549.04,23558,321,211,22283,22110,22058,22115,21737
11642,800,1312,1563,10079,0,11642,3.69176e+13,11.1591,1951.95,11642,349,22,10330,10330,7469,4447,5527
43844,1527,2284,39731,4113,39731,4113,2.92156e+18,314.244,5842.58,43844,551,206,41560,41560,39170,37385,27081
28916,1784,1912,0,28916,0,28916,1.85186e+18,220.211,4211.23,28916,384,179,27004,27004,27004,27004,26731
17090,184,949,16017,1073,16017,1073,1.9272e+18,317.209,2518.53,17090,203,145,15738,15291,14323,14235,8558
36968,1026,1427,0,36968,0,36968,1.46106e+18,658.838,4537.58,36968,509,172,35541,35148,35274,35471,26292
4228,172,297,3169,1059,0,4228,8.50664e+18,75.6298,730.923,4228,82,73,3931,3926,3906,3890,3351
29879,651,1208,26870,3009,0,29879,2.96509e+18,378.607,3882.91,29879,406,160,28671,28432,26837,26954,16168
14067,339,1389,12890,1177,12890,1177,1.31067e+18,322.317,2924.87,14067,377,117,12583,11594,11022,11410,4040
45712,12,13,45194,518,45712,0,9.80965e+13,10.9503,416.426,45712,12,12,45699,45697,43976,43976,43606
48033,861,2341,36966,11067,36872,11161,3.60498e+18,325.994,5441.38,48033,376,253,45692,45650,44828,45577,39415
15275,159,409,15275,0,15275,0,5.00224e+18,218.156,1725.8,15275,162,110,14649,14294,11097,10194,7064
31831,413,447,31831,0,31831,0,3.84551e+18,251.034,2590.98,31831,247,158,31384,31383,31182,31007,30030
21780,3070,3470,0,21780,1383,20397,1.25374e+14,12.2622,5031.3,21780,704,17,18310,18310,17755,16575,16897
37824,897,1045,8121,29703,0,37824,2.1983e+13,435.045,3668.65,37824,420,135,36779,36779,36705,36771,34883
43070,357,503,43070,0,43070,0,5.0355e+18,326.331,2861.98,43070,220,172,42558,42142,40576,38637,36087
9744,269,543,9067,677,9067,677,2.17383e+18,133.003,1465.38,9744,230,80,9201,9156,8937,8633,5602
15600,340,394,15600,0,15600,0,5.22669e+18,183.213,1601.54,15600,157,114,15206,15170,15046,14821,14425
23201,29,44,0,23201,23020,181,2.54831e+16,37.338,530.934,23201,29,31,23116,23039,22838,23015,20101
41982,3,13,41708,274,35320,6662,8.28161e+13,8.3583,478.271,41982,11,10,40469,40109,34586,37275,28221
45480,562,1437,42589,2891,42589,2891,6.16668e+17,740.146,4770.06,45480,461,241,43113,41414,40781,40641,28868
17024,509,970,15860,1164,0,17024,2.45535e+18,447.675,2625.06,17024,215,176,15900,15423,15311,15335,9926
6885,116,339,1645,5240,0,6885,1.62292e+13,99.1476,939.332,6885,139,63,6536,6341,6190,6230,3853
6669,281,429,0,6669,0,6669,4.09382e+18,98.0373,1010.42,6669,98,80,6240,6204,6204,6156,5307
10184,128,378,0,10184,2652,7532,7.47131e+15,139.143,1109.54,10184,80,101,9730,9217,8603,8731,4946
35871,390,1414,0,35871,8568,27303,6.43098e+15,259.116,3964.21,35871,302,163,34374,33939,32027,30891,12656
26646,13,27,0,26646,26622,24,7.57194e+14,16.1455,522.402,26646,21,11,26584,26511,26512,26309,21028
30157,828,923,0,30157,7182,22975,7.38444e+15,219.12,3063.91,30157,225,118,29234,29234,29179,29230,27699
9185,2,13,9123,62,9185,0,9.89225e+13,7.39194,189.367,9185,9,9,8302,8035,6382,7985,5453
10750,207,760,10012,738,10012,738,6.06297e+17,237.196,1826.7,10750,167,128,9858,9643,8980,8986,5600
46924,128,1335,43693,3231,0,46924,2.49662e+18,710.089,4724.19,46924,401,250,41563,38367,35146,34290,12834
49077,378,1634,0,49077,9895,39182,5.27158e+15,420.2,5328.78,49077,503,113,46963,46280,44210,30431,17142
27271,27,389,27271,0,27271,0,4.92228e+18,247.422,2141.55,27271,203,136,20624,16275,12476,11209,5310
35441,62,1567,31773,3668,31771,3670,1.10045e+18,277.24,4089.87,35441,389,170,30729,29261,24960,26363,4606
25267,408,693,19063,6204,19063,6204,3.7903e+18,342.428,2377.61,25267,189,160,24556,23545,24126,24089,18299
9327,1,10,9225,102,9327,0,8.05165e+13,6.33558,195.518,9327,7,8,5364,5364,5364,5364,5364
5132,5,7,5124,8,5132,0,8.34226e+13,6.8562,140.195,5132,7,7,5039,4937,4388,4388,4581
42014,291,1870,0,42014,9676,32338,7.18257e+15,198.071,4689.7,42014,473,149,40086,39517,34975,28024,9310
33183,203,797,9214,23969,0,33183,6.19238e+13,227.436,2666.42,33183,168,149,32218,31459,26753,26871,6312
37333,7,12,37242,91,37333,0,8.188e+13,6.56232,386.528,37333,7,9,37321,37320,32127,32138,27885
39506,886,1301,39506,0,36882,2624,9.60784e+17,647.816,4334.55,39506,371,241,38205,37135,35763,35619,31471
29003,268,1211,27095,1908,27095,1908,2.02466e+18,609.23,3644.19,29003,373,205,26675,25955,24552,24030,13569
42490,956,1969,37887,4603,37887,4603,8.97313e+17,322.253,4837.27,42490,274,273,40521,40468,40207,40345,31535
4589,39,286,0,4589,1188,3401,7.58368e+15,97.5099,709.474,4589,62,76,4103,3957,3667,3785,1092
46631,759,1050,10431,36200,0,46631,2.23584e+13,414.637,4090.87,46631,445,146,45581,45302,45302,45389,35613
8958,371,865,0,8958,0,8958,1.49301e+18,108.367,1846.03,8958,286,93,8093,8081,7975,7847,4451
20765,238,1538,18794,1971,18794,1971,1.36792e+18,354.328,3638.51,20765,429,135,18328,16569,14707,15661,4786
38765,1685,2549,35363,3402,35363,3402,2.64804e+18,395.426,6100.43,38765,559,241,36216,36141,35826,35740,24830
30334,4,8,30077,257,30334,0,1.07268e+14,7.78117,322.572,30334,8,8,30217,30180,28751,28565,23970
47203,1256,3460,47203,0,47005,198,1.07485e+18,102.86,6685.27,47203,456,85,43743,43741,43429,43684,36399
47741,717,1283,0,47741,11205,36536,7.41438e+15,269.486,4377.88,47741,314,144,46458,46441,46135,45866,37278
48201,1412,2323,37384,10817,37290,10911,3.52748e+18,359.726,5629.82,48201,407,262,45878,45871,45602,45776,39149
43066,1262,2317,36560,6506,36560,6506,4.42228e+18,468.878,5861.08,43066,572,257,40749,40739,39815,39438,15773
1750,106,184,1750,0,1544,206,2.29336e+18,53.0246,405.491,1750,57,45,1566,1554,1418,1529,1005
12134,25,512,10680,1454,0,12134,3.83661e+18,263.675,1836.98,12134,199,138,8629,6812,6659,5911,1723
34158,478,1137,7991,26167,0,34158,2.32509e+13,247.335,3471.78,34158,482,132,33021,32690,31205,28276,23219
5202,83,782,0,5202,0,5202,1.6775e+18,74.3191,1501.33,5202,173,83,4312,3919,3517,3418,931
3659,231,288,2750,909,0,3659,8.33673e+18,59.8617,659.176,3659,71,67,3371,3369,3360,3370,2984
8031,6,10,7974,57,8031,0,1.03744e+14,6.23073,167.458,8031,8,7,8008,7997,7663,7664,7209
523,66,112,122,401,0,523,2.12572e+13,26.109,198.076,523,33,25,411,396,402,399,331
14977,450,666,0,14977,3743,11234,8.37578e+15,201.448,1569.45,14977,89,174,14311,14231,13900,14002,10902
43590,7,13,43206,384,43508,82,9.9372e+13,8.78123,464.489,43590,11,10,43498,43370,42032,41904,37168
11605,27,37,0,11605,11584,21,2.11672e+16,25.9283,370.721,11605,25,27,11565,11539,11065,11128,11172
9080,420,533,6841,2239,6841,2239,3.81078e+18,190.28,1351.7,9080,135,112,8547,8519,8519,8524,7517
28285,17,44,0,28285,28084,201,2.71009e+16,20.2003,563.563,28285,23,22,28207,28107,27162,27326,23658
44261,12,13,43944,317,44261,0,9.75666e+13,11.8749,413.164,44261,13,13,44242,44230,42651,42651,44129
13194,9,13,13101,93,13194,0,1.00375e+14,10.7939,226.321,13194,10,9,13178,13175,12663,12661,10769
11993,126,364,0,11993,2787,9206,7.47577e+15,166.167,1453.47,11993,173,90,11503,11341,9369,9297,4582
29391,493,1718,0,29391,6726,22665,7.91375e+15,193.297,3625.92,29391,390,223,27673,27522,24337,24434,7536
1314,149,256,1212,102,0,1314,2.90289e+18,39.1256,442.987,1314,64,38,1058,1038,1046,1043,787
16053,506,586,0,16053,0,16053,4.12369e+18,253.184,1709.72,16053,146,126,15467,15461,15421,15418,14509
48786,769,1675,45482,3304,45482,3304,2.10954e+18,748.198,5348.7,48786,435,262,46900,46131,45034,44068,36067
41603,512,1845,0,41603,0,41603,2.00672e+18,533.294,5163.33,41603,553,261,39063,37586,32822,30393,4439
12925,398,730,0,12925,0,12925,1.27588e+18,342.145,1961.76,12925,195,144,12078,11754,11612,11449,8191
22017,317,604,22017,0,21066,951,4.99946e+17,354.678,2487.24,22017,233,156,21155,19718,17919,11098,18572
23273,592,699,17495,5778,17495,5778,3.84113e+18,321.636,2269.55,23273,177,155,22574,22567,22551,22552,21799
39683,2200,2312,39683,0,34676,5007,9.63412e+17,522.858,5844.29,39683,454,286,37371,37371,37275,37369,37113
13129,557,1227,13129,0,11511,1618,1.7142e+18,178.724,2394.99,13129,197,169,11902,11901,11452,11244,10608
10288,36,60,0,10288,10206,82,2.5985e+16,23.5867,440.528,10288,29,31,10228,10208,9956,10028,9055
44161,442,623,42317,1844,42267,1894,7.48664e+17,453.39,3522.35,44161,273,193,43382,42758,40691,41985,42006
25193,424,619,0,25193,7036,18157,1.61206e+16,188.979,1910.52,25193,127,118,24574,24541,24283,24363,20334
18760,6,13,18630,130,18760,0,1.00827e+14,10.4078,269.641,18760,11,10,18704,18673,17735,17729,16120
9744,1,9,9696,48,9680,64,9.00987e+13,5.42857,179.415,9744,8,8,5820,5820,5820,5820,5820
19224,31,69,0,19224,18972,252,2.51737e+16,33.5181,646.218,19224,33,34,19132,19094,18597,18532,15043
15594,469,521,0,15594,4070,11524,7.46219e+15,176.423,1493.78,15594,99,120,15073,15070,15015,15030,14598
27923,26,1542,0,27923,5893,22030,6.10428e+15,178.276,3793.1,27923,380,177,24382,22564,20614,12197,3862
8258,407,431,7410,848,7410,848,3.19693e+18,187.93,1173.5,8258,98,108,7827,7827,7815,7815,7645
47264,946,3069,0,47264,6101,41163,5.66492e+15,11.8921,5839.15,47264,1535,13,44195,44195,30127,30820,21557
24347,295,752,5466,18881,0,24347,1.74687e+13,335.711,2579.22,24347,259,146,23305,22840,22435,19786,14907
7636,556,894,7636,0,7130,506,9.30691e+17,179.983,1823.87,7636,225,134,6742,6604,6381,6078,5736
43706,1055,1197,43706,0,38459,5247,1.16258e+18,421.66,4644.07,43706,337,222,42509,42509,42382,42428,40657
44014,824,1756,44014,0,41111,2903,9.23821e+17,655.429,5281.03,44014,431,251,42185,40641,38906,38609,32063
38704,551,1336,38704,0,36149,2555,9.9768e+17,638.012,4313.1,38704,429,226,36681,35305,32058,29305,26510
18615,363,1287,4277,14338,0,18615,3.22359e+13,141.659,2529.45,18615,316,163,17328,17019,15169,15868,7289
49852,271,599,47108,2744,49852,0,3.70747e+18,311.175,3501.05,49852,277,188,48938,48048,40649,38531,26704
18115,467,708,3783,14332,0,18115,1.86306e+13,272.665,2209.32,18115,191,153,17407,17375,16877,16765,12671
6180,240,447,5797,383,0,6180,2.26718e+18,135.653,1111.08,6180,128,79,5733,5715,5570,5570,4272
3025,9,356,2703,322,2703,322,8.7696e+17,120.7,711.746,3025,74,73,1291,677,573,692,115
505,2,4,0,505,492,13,3.02499e+16,3.78614,42.8531,505,4,4,400,345,388,382,370
23645,109,662,0,23645,5898,17747,6.25072e+15,202.193,2510.95,23645,245,123,21756,20445,19321,18732,6630
13448,343,404,13000,448,13448,0,4.49716e+18,205.392,1529.02,13448,185,73,13044,13038,12097,11909,11766
30997,630,1583,30997,0,27831,3166,7.60282e+17,426.349,4423.76,30997,434,158,29414,29093,26655,21048,14092
43208,157,1036,10178,33030,0,43208,2.89549e+13,245.767,3783.75,43208,272,136,41246,40105,34199,34406,12317
4177,51,664,0,4177,0,4177,4.55302e+17,141.472,1148.43,4177,159,79,3144,2777,2469,502,420
36764,362,385,0,36764,9546,27218,3.09369e+15,282.506,2471.89,36764,236,136,36379,36302,36360,36342,36024
33239,1142,1206,0,33239,0,33239,1.22484e+18,598.124,3891.98,33239,354,206,32033,32033,31977,31972,31886
16398,4,12,16242,156,15159,1239,7.75869e+13,6.61422,258.664,16398,10,8,16156,16008,14313,14637,13226
24228,249,625,24228,0,23133,1095,5.13672e+17,442.205,2660.55,24228,236,158,22616,19972,17713,6559,17954
49778,790,1760,11120,38658,0,49778,2.63617e+13,267.257,5003.02,49778,384,198,48018,47840,47348,47306,32777
806,51,191,719,87,719,87,9.08743e+17,36.268,317.425,806,50,46,613,570,535,532,298
8826,310,500,8826,0,7885,941,1.79306e+18,211.762,1314.38,8826,98,121,8326,8266,7512,7992,5574
11153,1029,1124,0,11153,0,11153,2.11863e+18,126.58,2165.27,11153,343,98,10029,10029,9975,9964,9333
44230,30,944,38924,5306,38924,5306,3.22187e+18,349.408,4178.88,44230,327,198,32290,28234,25039,22809,4721
36019,552,3839,36019,0,35738,281,3.98948e+17,14.9149,5564.45,36019,1071,23,32180,32180,26048,30189,11204
20317,1162,1395,18527,1790,18527,1790,7.63434e+17,206.001,3321.55,20317,280,172,18922,18920,18863,18870,16723
47372,11,13,47059,313,47372,0,1.03471e+14,11.8291,425.572,47372,13,12,47349,47333,45521,45520,45173
8805,39,42,0,8805,8532,273,2.31108e+16,10.4441,372.806,8805,18,13,8763,8763,8763,8763,8399
18334,26,81,0,18334,17952,382,2.46272e+16,31.4008,735.127,18334,35,32,18217,18183,16940,17305,9249
3712,363,393,3534,178,3534,178,1.48949e+18,84.5929,821.513,3712,123,48,3319,3319,3311,3309,3188
29110,477,588,29110,0,29110,0,3.46527e+18,308.595,2814.72,29110,216,169,28522,28518,28207,27775,26682
42262,265,752,11788,30474,0,42262,6.28344e+13,253.055,2583,42262,173,148,41443,40613,38159,37754,20267
25714,455,797,5791,19923,0,25714,1.80177e+13,370.221,2708.92,25714,315,157,24801,24289,24038,22525,19104
36132,1556,2013,32315,3817,32315,3817,3.15966e+18,241.556,4764.01,36132,362,226,34119,34119,34119,34119,31294
3245,28,434,0,3245,0,3245,1.25058e+18,75.2832,839.801,3245,96,52,2555,2185,1891,1704,333
6459,243,486,0,6459,0,6459,1.53945e+18,300.147,1367.29,6459,208,109,5679,5055,5321,5469,3587
42754,275,571,42358,396,42754,0,3.8931e+18,313.602,2977.72,42754,189,180,42091,41770,38435,35237,27819
17047,679,1270,0,17047,0,17047,1.15901e+18,312.798,3015.95,17047,265,153,15777,15490,15428,11735,11421
44254,1012,1910,40546,3708,0,44254,3.04631e+18,456.93,5459.53,44254,374,211,42344,42242,40875,40434,22864
7413,313,546,7413,0,6625,788,1.78419e+18,176.295,1272.4,7413,102,107,6867,6815,6071,6569,3850
35306,2461,6666,0,35306,0,35306,4.52204e+17,14.0004,7266.71,35306,858,22,28640,28640,24440,25185,12394
5599,296,728,0,5599,0,5599,1.24245e+18,95.5222,1273.32,5599,237,115,4871,4863,4871,4871,1756
41319,855,914,0,41319,9128,32191,4.71567e+15,462.262,3550.68,41319,308,200,40405,40404,40347,40370,39886
29215,379,710,29209,6,29215,0,3.86763e+18,287.467,2787.62,29215,194,138,28505,28321,25332,25488,21665
23389,471,660,17625,5764,0,23389,8.28875e+18,299.834,2114.54,23389,164,140,22729,22650,22518,22491,18908
26410,234,2038,23945,2465,0,26410,3.24813e+18,238.225,4573.45,26410,483,228,24167,22801,21927,21707,6861
30026,1256,1272,26899,3127,26899,3127,1.73343e+18,552.651,3706.98,30026,441,158,28754,28754,28754,28754,28754
24071,830,1376,0,24071,0,24071,1.93568e+18,207.563,3211.25,24071,358,137,22695,22675,20446,19834,10351
13690,17,848,0,13690,2574,11116,6.27969e+15,141.787,2180.24,13690,296,69,11579,10787,9774,3602,2180
18180,3,25,0,18180,18168,12,1.69642e+16,12.9549,510.686,18180,17,17,12346,10694,9092,9627,8161
18486,18,24,0,18486,18220,266,2.52276e+16,15.7404,386.369,18486,19,17,18457,18436,18270,18019,17323
40762,188,1445,40762,0,35736,5026,1.06011e+18,397.877,5043.65,40762,393,211,36867,34729,30222,18354,6917
12628,683,757,11769,859,11769,859,6.52716e+17,318,1996.81,12628,189,145,11871,11871,11864,11861,11627
40190,1,14,39194,996,36096,4094,8.19284e+13,6.60998,390.32,40190,10,8,24398,24398,24398,24398,24398
29246,670,879,22063,7183,22063,7183,3.7909e+18,321.379,2714.97,29246,197,172,28367,28340,28296,28298,24879
18465,587,1615,16538,1927,0,18465,3.55142e+18,198.578,3513.46,18465,369,204,16850,16799,16510,16330,9609
35762,1850,1932,0,35762,0,35762,1.38665e+18,350.565,5238.94,35762,492,135,33830,33830,33830,33830,33403
15587,321,1229,14637,950,14637,950,1.91365e+18,287.776,2867.01,15587,255,143,14250,13898,13617,13250,7749
41409,1576,3009,897,40512,0,41409,1.9506e+12,55.2447,5740.29,41409,486,56,38400,38399,36664,36218,23632
5818,1,7,5808,10,5818,0,8.22947e+13,6.88518,149.037,5818,7,7,3352,3352,3352,3352,3352
13950,550,870,13950,0,12211,1739,1.07874e+18,261.881,2261.51,13950,224,146,13080,13075,12227,12476,10112
21884,487,1018,19558,2326,19558,2326,2.62603e+18,346.498,3142.96,21884,371,157,20866,20739,19682,19287,13180
10409,3,21,0,10409,10401,8,1.69537e+16,12.936,366.236,10409,16,15,7067,6122,5204,5514,5816
9301,197,1124,8115,1186,8113,1188,1.63467e+18,89.1762,1956.36,9301,314,109,8164,7952,7498,7794,1853
45056,1084,2200,45056,0,40978,4078,1.54698e+18,407.961,5725.21,45056,461,318,42856,42581,41162,41587,27021
45004,870,989,33896,11108,0,45004,8.29536e+18,343.238,3262.89,45004,237,187,44015,44011,43889,43894,42269
24592,65,1456,22704,1888,22704,1888,2.41303e+18,367.208,3818.85,24592,448,134,20748,19013,17738,15460,3639
23765,826,1610,23765,0,22163,1602,9.26446e+17,433.996,3968.12,23765,409,212,22155,21680,20665,20620,15310
19858,32,53,0,19858,19611,247,2.58795e+16,33.8617,567.712,19858,35,33,19787,19751,19133,19474,17425
25924,88,1911,25924,0,19859,6065,9.82851e+17,252.766,4053.79,25924,272,261,23060,21750,18181,17556,4310
21363,749,847,19120,2243,19120,2243,8.83961e+17,258.715,2420.02,21363,145,157,20516,20508,20472,20503,19492
41996,911,1717,37622,4374,0,41996,3.16748e+18,387.033,5279.72,41996,458,183,40279,40178,37348,37618,23350
16097,725,1110,14999,1098,14999,1098,7.13895e+17,476.622,2756.54,16097,238,179,14987,14536,14628,14584,11042
36582,28,36,0,36582,34898,1684,2.45886e+16,30.3504,627.172,36582,29,30,36520,36438,35410,35608,33372
30864,412,443,30864,0,30864,0,3.64476e+18,252.615,2326.24,30864,251,169,30421,30419,30169,29941,29027
7868,422,474,7051,817,7051,817,8.76121e+17,196.478,1218.12,7868,94,109,7394,7388,7378,7390,6968
34570,733,1395,30756,3814,30756,3814,1.75124e+18,582.829,4206.7,34570,451,188,33124,31713,30949,31506,25386
16227,253,458,15848,379,16227,0,4.38253e+18,245.873,1760.25,16227,237,91,15709,15468,13142,13578,10680
34018,748,1228,34018,0,31730,2288,9.7205e+17,619.246,4000.28,34018,344,233,32616,31308,30330,29475,27485
8583,5,33,0,8583,8570,13,2.1316e+16,24.3112,311.542,8583,25,28,7614,7178,6372,6633,4473
11693,1499,1876,11693,0,11693,0,1.16702e+18,13.2336,2792.51,11693,388,20,9817,9817,9671,9729,8177
871,176,245,781,90,781,90,1.76875e+18,27.5086,385.582,871,73,43,626,626,578,618,507
1541,85,307,0,1541,0,1541,1.08942e+18,60.3738,551.401,1541,82,47,1232,1160,1140,862,498
15785,60,1083,0,15785,2355,13430,5.31427e+15,171.717,2248.39,15785,329,94,14194,12936,12583,10016,1827
22825,1419,1505,20912,1913,0,22825,3.11342e+18,277.296,3592.32,22825,397,95,21320,21320,21276,21320,21133
20570,9,14,20485,85,20570,0,9.02036e+13,7.06932,291.705,20570,10,9,20554,20553,20212,20210,20021
46741,1293,1407,43613,3128,43613,3128,2.05962e+18,728.931,4789.36,46741,478,239,45334,45331,45241,45234,44793
9186,327,831,2160,7026,0,9186,3.50978e+13,87.6917,1489.81,9186,153,119,8355,8291,7319,7825,2396
26353,266,1945,0,26353,0,26353,1.5772e+18,406.103,4575.36,26353,505,214,23801,22989,22148,14858,5061
13530,125,408,2070,11460,0,13530,8.60803e+13,31.0979,958.097,13530,34,206,13122,13120,9200,10938,10221
27030,19,40,0,27030,26843,187,2.76848e+16,19.5731,518.638,27030,24,23,26976,26885,26677,26354,21979
45202,1164,1301,0,45202,0,45202,1.22676e+18,682.554,4595.74,45202,390,248,43901,43901,43691,43533,43004
5659,316,359,5659,0,5659,0,3.58335e+18,137.874,1090.76,5659,117,94,5300,5299,5257,5257,4912
32300,960,1870,32300,0,29601,2699,8.12082e+17,399.205,4838.47,32300,724,151,30430,30419,30092,29971,14064
34386,306,1564,6877,27509,0,34386,2.47795e+13,312.41,4386.38,34386,463,195,32516,32125,30890,26287,12008
16163,306,554,12189,3974,0,16163,8.24239e+18,254.144,1693.43,16163,144,118,15558,15063,15180,15106,11897
15429,2,60,0,15429,15081,348,2.31459e+16,14.9504,503.426,15429,19,26,11508,10190,10716,9883,7035
26612,30,32,26135,477,26608,4,9.91068e+13,8.53551,389.199,26612,18,17,26580,26580,26552,26550,26562
21756,721,806,19100,2656,19100,2656,1.74107e+18,353.241,2926.22,21756,238,165,20950,20950,20914,20934,19403
9888,663,939,0,9888,0,9888,1.16041e+18,176.176,2024.78,9888,207,136,8949,8914,8835,8869,6631
8996,154,939,8363,633,8363,633,6.9326e+17,209.36,1996.29,8996,160,147,7830,7317,6772,6981,3594
42850,690,1160,10145,32705,0,42850,2.52222e+13,429.849,3995.17,42850,585,135,41690,41429,41145,40519,32514
24749,606,1963,0,24749,0,24749,1.55947e+18,242.47,4171.98,24749,458,214,22786,22667,22220,21967,10169
37847,485,2252,30135,7712,30041,7806,3.24888e+18,356.339,5355.03,37847,382,256,35348,34611,32484,34147,19308
17200,215,393,4000,13200,0,17200,2.8636e+13,184.575,1781.31,17200,185,106,16760,16555,15914,16203,10252
15033,269,661,3405,11628,0,15033,1.79185e+13,249.171,1931.53,15033,206,112,14300,14054,13814,12507,9820
19436,654,826,0,19436,4338,15098,4.82719e+15,282.331,2457,19436,235,156,18610,18609,18408,18489,16393
21747,344,1108,20347,1400,20347,1400,1.99583e+18,475.558,3064.05,21747,301,181,20198,19687,19042,18867,12850
30184,13,101,0,30184,29691,493,2.04304e+16,27.6858,910.556,30184,38,33,29717,29118,26273,26831,16431
11443,46,55,0,11443,11365,78,2.80409e+16,18.4504,359.338,11443,30,26,11388,11382,11370,11373,11099
32547,129,517,32547,0,32547,0,3.53185e+18,342.819,2310.82,32547,514,46,31072,30514,24235,22759,11973
25330,7,8,25307,23,25330,0,5.06057e+13,5.81492,339.337,25330,7,6,25322,25322,25037,25036,25035
7659,126,468,0,7659,0,7659,4.11265e+18,154.327,1122.73,7659,112,97,7129,7000,6006,3426,3245
16377,460,957,2162,14215,0,16377,2.4664e+13,166.386,2337.81,16377,387,74,15420,15285,14983,14938,8896
30588,1995,2134,24705,5883,24611,5977,3.10205e+18,330.138,4880.65,30588,362,243,28454,28454,28454,28450,27540
40586,63,562,40586,0,40586,0,3.2574e+18,323.583,2730.51,40586,196,152,37393,34659,22726,21648,5035
15094,171,740,0,15094,3174,11920,5.7096e+15,164.258,2126.96,15094,279,89,14092,13334,13013,13294,5324
18148,159,604,18148,0,17357,791,4.90324e+17,311.076,2258.63,18148,218,141,16003,13767,12785,12718,10956
45635,129,1016,34392,11243,0,45635,8.30078e+18,360.343,3347.34,45635,257,182,42889,41801,30162,31083,12634
32464,48,1028,29077,3387,0,32464,3.81671e+18,282.274,2999.15,32464,156,171,27880,26436,24965,23996,2817
42809,485,508,42809,0,42809,0,5.01103e+18,316.764,2952.16,42809,210,175,42301,42300,42228,42193,41940
38163,84,846,8865,29298,0,38163,2.22452e+13,324.868,3494.6,38163,381,143,34148,31766,30915,13058,7546
46306,751,2016,46306,0,43267,3039,8.88846e+17,602.831,5907.54,46306,431,269,44090,42559,39707,38932,27977
22862,394,1122,21361,1501,21361,1501,6.61087e+17,407.017,3212.43,22862,224,208,21438,20791,20305,20278,5332
9117,393,578,0,9117,1975,7142,6.75756e+15,143.487,1246.6,9117,239,44,8539,8403,8365,8539,8073
4600,201,314,4600,0,4600,0,1.14814e+18,16.7878,709.654,4600,159,17,4286,4286,4173,4117,3013
6995,311,555,0,6995,0,6995,1.52694e+18,244.066,1490.79,6995,207,98,6389,5724,6115,6152,5124
42242,1061,1254,0,42242,0,42242,1.20049e+18,660.872,4403.47,42242,388,243,40988,40978,40652,40207,39524
49820,1111,1493,44898,4922,44898,4922,2.46698e+18,615.008,5343.76,49820,480,197,48327,47919,48064,47833,35004
30907,318,1108,28825,2082,0,30907,2.44447e+18,569.539,3606.16,30907,329,213,28828,28022,26891,26957,16389
27658,1672,1733,27658,0,24323,3335,9.23377e+17,283.86,4571.23,27658,373,191,25925,25925,25925,25925,25624
49918,996,3052,49918,0,46033,3885,2.97367e+18,731.037,7422.36,49918,857,196,46636,45470,36412,42766,22901
49327,1746,1846,0,49327,9584,39743,5.97696e+15,418.936,5398.47,49327,530,190,47481,47481,47481,47464,45802
1234,47,109,342,892,0,1234,6.12439e+13,26.3169,261.33,1234,34,37,1125,1120,1079,1078,679
49487,1027,2416,45010,4477,45010,4477,2.82145e+18,346.623,6475.63,49487,611,206,47071,47065,43704,40680,18418
35351,174,1988,30933,4418,30931,4420,1.67102e+18,354.517,5397.32,35351,446,206,32458,31371,26825,27785,4460
38667,4,7,38631,36,38667,0,4.37715e+13,5.42481,400.744,38667,6,6,36660,33845,35659,36053,34072
39673,52,869,8839,30834,0,39673,1.7567e+13,452.689,3391.46,39673,332,183,34867,30947,30717,25418,8886
44941,3,11,44658,283,44941,0,1.02278e+14,9.27681,418.893,44941,10,10,42730,41762,35981,40578,33540
31737,526,546,31737,0,31737,0,3.21382e+18,298.778,2394.56,31737,193,138,31191,31189,31166,31108,30932
42339,534,625,42339,0,40539,1800,4.80691e+17,461.029,3477.3,42339,275,195,41665,41316,40345,35430,40724
28919,191,628,25504,3415,28919,0,3.73462e+18,308.074,2821.51,28919,246,168,27714,26405,23266,20567,13924
46482,488,684,12903,33579,0,46482,6.33067e+13,266.069,2602.49,46482,212,141,45798,45755,45301,45232,38304
27569,7,47,0,27569,27471,98,2.59856e+16,25.7568,561.414,27569,22,24,27347,27263,23705,25715,16922
6319,44,55,0,6319,6281,38,2.69004e+16,16.0605,275.326,6319,28,22,6264,6258,6233,6242,5400
48508,409,3719,47558,950,47183,1325,9.21098e+17,388.785,7072.88,48508,430,172,44074,41400,34578,40929,8260
34922,9,13,34702,220,34922,0,1.03847e+14,10.9933,365.071,34922,12,11,34895,34888,33517,33517,31390
34320,97,627,7772,26548,0,34320,2.82596e+13,239.399,2865.09,34320,242,141,32712,31739,26962,15027,7780
10392,111,338,10392,0,10392,0,3.75303e+18,135.87,1272.95,10392,143,76,9949,9417,8695,7618,5002
19872,524,660,5185,14687,0,19872,2.93396e+13,179.937,1824.39,19872,113,129,19212,19211,19097,19150,18059
5163,21,274,0,5163,1344,3819,6.16905e+15,182.646,878.371,5163,199,77,4130,3436,3286,3013,1434
22246,93,341,22246,0,22246,0,3.84899e+18,233.764,1774.46,22246,135,139,20494,19119,14287,12447,8312
15214,790,797,15214,0,13443,1771,7.89979e+17,362.676,2426.95,15214,254,129,14417,14417,14415,14417,14392
26211,668,749,0,26211,6688,19523,6.9503e+15,387.047,2631.4,26211,456,102,25462,25334,25331,25362,23401
39389,1118,2268,0,39389,0,39389,1.37349e+18,386.573,5460.31,39389,764,144,37121,36975,36061,36700,26491
38927,737,1520,0,38927,9850,29077,7.40583e+15,216.619,3726.85,38927,351,146,37407,37393,33238,33886,15921
5306,502,790,5306,0,4643,663,1.66373e+18,93.5944,1316.61,5306,130,84,4516,4516,4006,4279,2525
36858,284,634,0,36858,8417,28441,7.32976e+15,231.495,2990.7,36858,252,135,36224,35589,34795,35521,20471
11891,780,891,11891,0,11071,820,8.93406e+17,303.116,2066.92,11891,306,99,11000,10963,10863,10932,10127
31279,377,579,31279,0,31279,0,3.36435e+18,300.936,2912.75,31279,219,168,30700,30633,29291,27325,23934
13680,28,53,0,13680,13672,8,2.21967e+16,13.0941,426.731,13680,20,21,13627,13619,13526,13573,10349
17783,359,1128,16593,1190,16593,1190,6.58165e+17,512.893,2901.97,17783,306,177,16280,15769,15220,15310,10190
36053,558,2255,33219,2834,33218,2835,1.3592e+18,431.956,5533.31,36053,682,138,33584,32639,31078,31803,10310
41229,41,88,0,41229,40642,587,2.0536e+16,23.5735,1034.49,41229,32,39,41141,41136,38509,38878,33251
35180,158,2347,31935,3245,0,35180,3.26818e+18,261.247,5419.61,35180,490,230,31788,29560,28134,28402,4741
34445,290,827,0,34445,7410,27035,4.70286e+15,420.044,3181.66,34445,279,196,33015,32135,31382,27999,16188
45492,1045,1572,40605,4887,40605,4887,2.65534e+18,390.087,5221.69,45492,443,221,43920,43868,43089,42438,34902
47134,287,804,47130,4,47134,0,4.26524e+18,339.633,3738,47134,239,141,45987,45066,35716,36579,22750
15844,8,10,15722,122,15844,0,9.98594e+13,9.22829,245.968,15844,10,10,15828,15826,15767,15766,15818
47191,517,943,0,47191,10316,36875,4.76872e+15,483.577,3809.53,47191,370,210,46123,44966,44239,43472,34954
14499,964,1297,0,14499,0,14499,1.59613e+18,223.992,2967.81,14499,263,150,13202,13201,12969,12085,11128
9322,129,742,0,9322,0,9322,2.1176e+18,364.962,1603.56,9322,215,89,8140,7185,7195,7460,4475
12528,332,696,0,12528,0,12528,1.58068e+18,283.707,2049.25,12528,241,118,11668,10695,10807,10652,5838
3567,66,336,3567,0,3194,373,1.79019e+18,158.394,756.639,3567,76,77,3021,2882,2171,1291,460
27268,679,755,0,27268,6073,21195,4.72754e+15,363.126,2688.81,27268,267,167,26513,26502,26429,26457,25934
39485,1026,1343,36818,2667,36818,2667,7.01922e+17,680.213,4433.91,39485,399,238,38142,38045,37592,37500,35045
15401,75,599,15401,0,11600,3801,8.20858e+17,261.842,1792.16,15401,160,128,14071,13229,10884,11087,3220
14333,264,357,14330,3,14333,0,3.23207e+18,234.124,1637.37,14333,144,109,13929,13492,13444,13280,11886
44761,49,66,0,44761,44458,303,2.58571e+16,47.5089,933.804,44761,40,40,44663,44564,43470,43715,38840
38229,707,2403,32801,5428,32707,5522,2.36715e+18,487.459,5758.4,38229,509,259,35723,33726,29645,33063,9540
5509,7,28,0,5509,5503,6,2.04964e+16,17.1452,234.613,5509,19,19,5054,4556,4432,4620,3823
30915,326,510,29989,926,30915,0,3.89297e+18,254.831,2405.26,30915,167,154,30405,30287,30008,29862,28398
15163,399,1043,13632,1531,13632,1531,3.1791e+18,299.334,2499.41,15163,225,169,14033,13261,13539,13312,10313
30971,1154,1265,27188,3783,27188,3783,1.69668e+18,366.626,4045.93,30971,289,187,29706,29706,29679,29668,28072
16893,466,526,15073,1820,16893,0,3.78791e+18,244.491,1945.2,16893,259,106,16367,16336,15894,15734,15563
48835,11,65,0,48835,48480,355,2.5e+16,56.2613,996.301,48835,43,45,47232,45671,43658,42825,23025
33360,2347,2580,33360,0,30314,3046,3.05952e+18,282.567,5497.73,33360,574,182,30780,30780,29688,29826,29156
9552,472,516,9552,0,9552,0,2.98968e+18,182.394,1497.38,9552,206,95,9036,9036,9034,9033,9023
45783,980,1371,45783,0,42789,2994,1.02274e+18,705.126,4685.91,45783,414,238,44412,43414,42167,41989,40208
46922,1123,2330,42699,4223,42699,4223,2.80735e+18,345.587,6226.62,46922,579,202,44592,44589,41471,38783,22646
37417,218,1887,33047,4370,33047,4370,3.62661e+18,314.012,4100.96,37417,355,294,34976,33671,29199,20582,3574
44487,498,2475,0,44487,0,44487,2.00395e+18,299.184,5586.88,44487,454,322,42012,41250,35717,29603,6335
13572,117,635,0,13572,3021,10551,4.71993e+15,210.163,1854.56,13572,171,115,12645,12344,11661,10576,5988
36881,38,456,36881,0,36881,0,3.79736e+18,265.045,2530.81,36881,223,171,31214,26001,16885,14812,5003
10116,140,384,10116,0,10116,0,3.52497e+18,193.419,1314.22,10116,231,105,9542,9233,7340,6911,4890
17057,832,1200,17057,0,15081,1976,1.74886e+18,189.463,2564.74,17057,289,148,15857,15857,14238,15135,8881
27953,973,1332,26094,1859,26094,1859,6.69716e+17,628.482,3781.89,27953,372,204,26621,26157,26150,25932,22415
28409,255,1805,25222,3187,0,28409,4.1023e+18,251.357,3877.91,28409,409,248,26312,25722,22729,22192,3046
20676,48,275,20676,0,20676,0,3.59318e+18,230.906,1281,20676,154,153,19085,18977,10739,8739,15107
23762,1069,1134,22163,1599,0,23762,2.4535e+18,512.353,3186.72,23762,312,186,22628,22626,22595,22588,22246
30852,58,99,0,30852,30737,115,2.21812e+16,32.1357,939.71,30852,43,31,30753,30736,30326,30029,26959
1042,99,162,0,1042,0,1042,1.91231e+18,87.5067,352.065,1042,55,45,836,706,797,816,608
47759,2346,2703,44215,3544,0,47759,2.78199e+18,753.437,6754.65,47759,752,236,45056,44803,44896,45045,41484
35783,222,1156,35783,0,31710,4073,1.15136e+18,430.09,4162.7,35783,306,189,33055,31460,29072,22853,8172
13850,664,695,13850,0,12170,1680,1.17415e+18,304.058,2230.99,13850,195,139,13155,13155,13154,13151,13062
32395,275,498,32395,0,32395,0,3.16148e+18,290.889,2311.33,32395,190,144,31762,30968,27814,26833,20843
44582,1465,1886,0,44582,10918,33664,7.4096e+15,214.611,4485.45,44582,425,163,42696,42694,41027,41165,33789
28366,407,761,0,28366,6160,22206,4.86727e+15,383.562,2820.62,28366,295,175,27437,26798,26450,25716,20070
9914,407,915,9914,0,9033,881,7.80035e+17,99.8877,1931.97,9914,298,101,8999,8971,8403,8735,2786
14792,211,351,14792,0,14792,0,3.57237e+18,198.148,1449.92,14792,104,147,14391,14172,12957,12903,10751
48053,182,203,0,48053,47070,983,2.63066e+16,26.9494,1255.68,48053,75,37,47850,47850,47819,47833,38794
43149,879,1283,40197,2952,40197,2952,2.10042e+18,682.855,4462.31,43149,382,241,41866,41246,40651,40410,36801
16952,1438,1497,16952,0,15825,1127,8.30837e+17,311.728,3443.34,16952,287,215,15455,15455,15421,15425,15173
12556,335,543,0,12556,0,12556,4.16592e+18,236.442,1514.55,12556,139,110,12010,11591,11767,11724,8162
40741,1347,2053,40741,0,36378,4363,8.69579e+17,419.201,5661.95,40741,540,163,38688,38637,38321,38487,30108
19590,294,617,4254,15336,0,19590,1.94396e+13,312.432,2071.13,19590,209,148,18807,18335,17992,17520,12085
48349,2818,2968,44050,4299,44050,4299,2.69405e+18,578.044,7169.16,48349,650,266,45381,45365,45319,45308,44432
8774,467,587,7701,1073,7701,1073,1.74073e+18,181.432,1653.45,8774,159,116,8187,8122,8172,8156,7094
34061,216,1211,30551,3510,0,34061,3.03647e+18,391.091,4127.42,34061,407,184,30606,27284,27630,28112,10461
40072,667,1438,0,40072,0,40072,1.46044e+18,659.972,4759.39,40072,522,176,38395,37720,35890,34870,19902
10706,647,989,9432,1274,9432,1274,3.6761e+18,147.611,1854.02,10706,225,115,9717,9717,9097,9075,5299
5741,623,803,5339,402,5339,402,7.5451e+17,167.372,1573.03,5741,172,119,4938,4848,4878,4895,4551
34426,1009,1212,32102,2324,32102,2324,6.01958e+17,540.539,3978.04,34426,342,199,33214,33177,33201,33203,32174
37329,804,1251,0,37329,0,37329,1.24729e+18,634.448,4117.54,37329,370,212,36020,34804,34864,32255,28632
17808,6,8,17779,29,17808,0,8.31087e+13,6.95412,262.195,17808,7,7,17678,17452,15620,15621,15783
35703,69,2281,32219,3484,32219,3484,1.03094e+18,255.928,5329.02,35703,384,271,30187,27925,23503,25679,3676
46728,1714,1941,35422,11306,35422,11306,6.82482e+18,352.514,4737.18,46728,345,204,44787,44787,44787,44787,43522
16962,544,619,14968,1994,0,16962,3.78825e+18,320.549,2308.37,16962,241,150,16343,16339,16274,16281,15389
3724,418,578,3201,523,3201,523,3.05291e+18,93.6724,1120.43,3724,170,71,3146,3136,3013,2921,2371
36029,309,889,7946,28083,0,36029,1.82425e+13,467.544,3337.6,36029,340,187,34513,33616,32753,28775,19239
27355,2,9,27304,51,19279,8076,6.9929e+13,8.16937,369.264,27355,9,9,23361,21462,20362,20554,16096
2090,55,309,2090,0,2090,0,4.01888e+18,79.9072,637.068,2090,81,53,1669,1485,1277,907,464
44301,141,2291,36991,7310,0,44301,5.65723e+18,439.896,5676.45,44301,578,230,39904,37105,32462,32860,6662
47354,854,2318,42809,4545,42805,4549,1.2032e+18,325.082,5957.41,47354,591,204,45036,45003,44285,44286,11046
13468,540,675,12063,1405,12063,1405,3.24655e+18,197.193,1736.23,13468,124,132,12793,12793,12732,12739,12049
39949,13,47,0,39949,39796,153,2.74313e+16,23.064,677.725,39949,25,25,39767,39601,37627,38005,25766
22455,510,1141,19995,2460,0,22455,3.99306e+18,225.858,2634.07,22455,209,152,21314,21293,18513,18149,5941
12843,214,1125,11861,982,0,12843,2.72891e+18,379.811,2587.48,12843,240,173,11282,11022,10385,10153,2531
32417,575,1548,29156,3261,29156,3261,3.12545e+18,253.987,3908.79,32417,494,161,30869,30720,27513,25056,11771
17009,7,14,16942,67,17009,0,8.76582e+13,6.99994,266.191,17009,10,9,16991,16989,16759,16758,16377
13921,69,390,13921,0,13921,0,5.23769e+18,190.748,1521.87,13921,154,109,12520,11169,7989,6714,4529
49132,1168,1223,10719,38413,0,49132,2.1421e+13,476.448,4514.61,49132,344,225,47909,47909,47854,47903,47122
31749,455,617,0,31749,8796,22953,1.62214e+16,241.541,2131.76,31749,166,124,31132,31096,30841,30908,27099
38189,8,13,37906,283,38189,0,9.91787e+13,11.4041,382.458,38189,13,12,38149,38141,36556,36594,35017
7500,333,478,5657,1843,5657,1843,3.78612e+18,148.299,1168.86,7500,116,98,7022,6913,6946,6950,5715
4167,502,504,3904,263,3904,263,1.08595e+18,93.0761,983.63,4167,167,59,3663,3663,3661,3662,3663
2629,98,210,0,2629,570,2059,4.41252e+15,65.9369,523.306,2629,71,52,2419,2370,2321,2338,1831
26554,313,729,23334,3220,23334,3220,3.23878e+18,318.603,3024.43,26554,271,166,25594,24865,23493,22942,12912
47899,1846,1980,44678,3221,44678,3221,2.08899e+18,595.779,5900.24,47899,421,264,45919,45919,45890,45905,45075
41583,1041,1500,36605,4978,36605,4978,1.66712e+18,378.124,5008.35,41583,338,208,40083,40083,39172,39532,27498
10960,8,12,10774,186,10960,0,8.75758e+13,5.58075,206.018,10960,8,9,10948,10948,10516,10515,10475
36127,265,1531,32170,3957,32170,3957,9.17545e+17,297.658,3857.39,36127,248,181,34398,32856,31677,31319,11437
17080,309,1124,15343,1737,15343,1737,2.98334e+18,378.748,2645.9,17080,413,140,15662,14664,13926,12932,7601
32567,163,784,32567,0,24527,8040,8.83059e+17,371.399,2778.25,32567,219,173,30573,29702,25313,24943,9083
47048,1698,1833,47048,0,43724,3324,1.07679e+18,689.319,5607.77,47048,514,251,45215,45215,45158,45040,44528
37645,30,55,0,37645,37070,575,2.17389e+16,20.3155,856.218,37645,28,26,37588,37581,37334,37047,31786
44540,184,648,12382,32158,0,44540,6.29162e+13,271.39,2524.14,44540,199,143,43459,42273,38466,36967,19853
16620,420,421,3748,12872,0,16620,2.84748e+13,211.102,1810.44,16620,192,103,16199,16199,16199,16199,16198
19476,1033,1056,17300,2176,0,19476,4.04408e+18,218.916,2483.25,19476,235,143,18420,18420,18418,18415,18244
42495,1,12,42377,118,41571,924,8.08428e+13,6.84015,419.151,42495,10,8,24937,24937,24937,24937,24937
16504,2097,3372,0,16504,0,16504,8.48731e+17,15.3607,4091.38,16504,1844,69,13132,13128,11648,10835,9415
20147,743,751,17729,2418,17729,2418,2.76897e+18,312.651,2726.57,20147,270,162,19396,19396,19396,19396,19386
27998,399,714,21085,6913,21085,6913,7.03989e+18,330.002,2396.48,27998,202,156,27272,26626,26422,25907,18721
48912,546,1807,12025,36887,0,48912,3.04868e+13,263.648,4367.83,48912,332,283,47105,46825,40132,41496,14082
18779,87,631,16519,2260,16519,2260,3.23482e+18,300.517,2436.48,18779,244,152,15936,13389,13204,11844,4533
49609,1383,1987,0,49609,0,49609,1.92623e+18,296.098,5052.36,49609,421,186,47622,47621,45835,39774,35737
42508,505,2385,38191,4317,38191,4317,1.01134e+18,285.539,5711.26,42508,394,275,40123,39736,37867,38507,20059
15191,99,402,15191,0,15191,0,3.38552e+18,221.877,1534.87,15191,136,115,14352,13950,10448,10113,4302
23095,491,686,20298,2797,0,23095,3.88684e+18,318.735,2755.18,23095,245,160,22409,22404,22065,22068,16202
38479,771,1712,0,38479,0,38479,1.24163e+18,516.702,4927.34,38479,375,254,36767,36403,35113,31134,21709
36869,122,566,36421,448,36869,0,3.81388e+18,292.686,2990.92,36869,250,150,34846,32569,26007,22355,8900
7712,211,329,2145,5567,0,7712,6.35089e+13,93.9614,888.113,7712,76,65,7383,7306,7264,7316,5713
3630,567,669,0,3630,0,3630,1.27063e+18,134.546,1193.17,3630,129,103,2961,2928,2954,2959,2707
21302,653,883,0,21302,0,21302,1.31145e+18,475.396,2677.65,21302,260,180,20419,19659,20015,19682,17949
43080,286,925,10312,32768,0,43080,2.63147e+13,224.974,3802.04,43080,346,147,42137,41734,36535,38762,15664
9429,442,561,8332,1097,0,9429,4.25616e+18,138.868,1252.79,9429,81,127,8868,8800,8748,8764,7583
21652,23,67,0,21652,21570,82,2.32693e+16,17.7762,594.825,21652,25,31,21560,21491,19986,20239,16911
15695,388,592,13815,1880,13815,1880,3.22427e+18,287.601,2172.19,15695,216,143,15096,14834,14422,14208,10981
3379,198,283,3379,0,3379,0,2.93267e+18,69.5389,677.253,3379,122,45,3096,3089,2979,3066,2664
3405,256,426,3047,358,0,3405,2.86361e+18,190.946,924.607,3405,166,86,2922,2686,2844,2845,2406
21975,197,848,19673,2302,0,21975,3.83307e+18,256.834,2370.14,21975,133,150,20787,18925,18181,17914,6360
32948,4,14,32291,657,31128,1820,8.05864e+13,6.56944,352.397,32948,9,10,32689,32547,30890,30936,26752
41519,1186,1261,38755,2764,38755,2764,2.05317e+18,640.291,4290.48,41519,426,213,40258,40256,40202,40206,39884
33082,1627,2275,30320,2762,30320,2762,2.49969e+18,454.078,5332.85,33082,527,209,30807,30750,30570,30554,22454
21982,535,714,4896,17086,0,21982,1.80678e+13,355.815,2414.1,21982,280,148,21250,20900,20944,20744,18514
39330,5,15,37590,1740,39330,0,9.56578e+13,10.5227,449,39330,12,12,38059,37897,34773,34215,17272
32565,25,89,0,32565,32473,92,2.11693e+16,29.9709,842.233,32565,37,34,32415,32242,29594,30663,26556
6000,44,425,5373,627,5373,627,8.91124e+17,187.697,1042.89,6000,90,100,5009,4421,3581,3829,721
8683,249,589,7582,1101,7582,1101,1.79032e+18,181.53,1657.49,8683,161,111,8093,7891,7607,7605,5026
15675,564,812,0,15675,3154,12521,5.70715e+15,203.526,2257.99,15675,325,86,14863,14807,14492,14651,9574
37823,788,848,9062,28761,0,37823,2.278e+13,254.24,3406.37,37823,383,141,36975,36949,36916,36955,34545
13068,736,997,12192,876,12192,876,6.26173e+17,253.747,2337.22,13068,188,160,12071,11942,11891,11841,9317
23964,1176,1317,21521,2443,0,23964,3.70374e+18,214.176,3244.54,23964,360,130,22647,22647,22393,22411,20498
12953,71,1039,0,12953,0,12953,1.75875e+18,172.536,2184.75,12953,318,98,11443,11021,10116,7860,4344
37819,267,497,37819,0,37819,0,5.02183e+18,325.111,2695.78,37819,198,164,37032,36426,31810,29662,23398
31422,610,884,0,31422,8159,23263,7.54649e+15,218.221,2518.48,31422,121,150,30538,30507,29909,29981,26002
19680,54,66,0,19680,19413,267,2.52605e+16,35.393,650.72,19680,33,33,19614,19597,19476,19258,17086
24057,446,448,24057,0,24057,0,5.13135e+18,296.52,2123.5,24057,184,137,23609,23609,23609,23609,23607
38031,473,823,0,38031,9180,28851,6.92047e+15,231.283,3438.78,38031,345,145,37208,37189,36022,36656,24093
39820,287,765,39756,64,39820,0,3.16165e+18,384.788,3560.78,39820,252,162,38578,37117,33299,29624,22575
36926,21,49,0,36926,36883,43,2.08626e+16,30.9617,686.226,36926,32,36,36785,36651,30767,33467,23553
21628,414,426,21628,0,21628,0,5.11256e+18,251.775,1961.69,21628,183,128,21202,21202,21178,21179,20949
24467,891,1180,22778,1689,22778,1689,2.10989e+18,615.362,3407.43,24467,347,197,23287,22657,22778,22669,20317
20795,626,1416,18418,2377,18418,2377,3.544e+18,207.409,2809.7,20795,339,140,19379,19366,16780,14767,3643
6710,24,43,0,6710,6665,45,2.53222e+16,17.3872,271.463,6710,21,20,6667,6659,6583,6617,5510
38568,1175,1453,38568,0,35956,2612,9.2772e+17,732.443,4572.91,38568,392,238,37115,37101,36212,36408,34951
21507,86,462,21507,0,21507,0,5.24612e+18,242.761,2097.48,21507,183,144,19817,17953,12518,11786,7061
22205,335,413,22205,0,22205,0,4.86623e+18,281.64,1994.68,22205,160,137,21790,21579,21241,20831,19430
47966,2790,3521,47768,198,47651,315,3.21699e+18,98.5689,6743.74,47966,513,83,44445,44445,43648,44425,36925
10420,176,412,10420,0,10420,0,3.29009e+18,177.484,1275.99,10420,134,102,9915,9732,8379,8221,5127
33351,272,671,9322,24029,0,33351,6.27936e+13,232.329,2247.42,33351,142,140,32653,32116,31048,30783,19780
21128,106,1875,15577,5551,15577,5551,2.18774e+18,23.2359,2508.77,21128,633,627,19253,19253,17488,16043,16569
46160,70,987,0,46160,0,46160,1.8762e+18,360.462,4296.13,46160,330,216,38143,32302,31298,6467,5082
48859,1650,2464,48859,0,44283,4576,1.21094e+18,323.621,6475.9,48859,779,156,46395,46395,44768,45100,28395
7292,4,6,7239,53,7292,0,1.12598e+14,5.69158,145.263,7292,6,6,7261,7253,7181,7181,5968
17385,334,1194,3605,13780,0,17385,2.24603e+13,163.609,2517.87,17385,383,149,16166,15915,15831,16143,7951
35443,1281,1656,0,35443,7532,27911,6.68391e+15,278.261,4283.26,35443,475,170,33787,33621,33774,33767,30711
24875,99,1105,5885,18990,0,24875,3.05637e+13,187.216,3299.61,24875,257,139,23260,22764,20018,13859,7497
14222,283,531,14158,64,14222,0,3.31902e+18,239.68,1880.45,14222,216,102,13652,13393,12889,12117,9028
9660,9,12,9545,115,9660,0,1.01547e+14,6.82153,189.255,9660,9,9,9648,9645,9399,9399,9154
27412,652,1712,27412,0,25532,1880,9.52583e+17,452.344,4483.12,27412,338,242,25694,24848,22926,21444,13732
14084,368,576,0,14084,0,14084,4.1049e+18,251.021,1628.83,14084,142,121,13508,13034,13271,13237,9754
24715,467,532,6881,17834,0,24715,6.34489e+13,202.349,1805.19,24715,140,122,24183,24178,24135,24163,23456
30159,1135,1827,30159,0,28101,2058,9.11646e+17,516.625,4803.44,30159,348,248,28332,28218,27364,26644,23200
12375,17,32,0,12375,12324,51,2.68549e+16,14.3686,367.495,12375,20,19,12332,12294,12288,12241,9918
914,37,99,0,914,197,717,4.25803e+15,26.4201,228.371,914,41,22,804,772,735,750,477
33846,61,604,32351,1495,0,33846,1.6782e+18,426.692,3038.56,33846,248,183,27015,24522,23765,20011,10039
5582,153,542,4926,656,4926,656,1.69155e+18,163.469,1314.96,5582,146,108,4914,4046,4259,4440,2970
47344,1227,1309,0,47344,10655,36689,5.37422e+15,426.361,4509.83,47344,413,206,46035,46033,45964,46034,45208
35003,1,12,34698,305,32483,2520,7.78576e+13,6.8803,376.374,35003,10,8,21383,21383,21383,21383,21383
826,110,140,826,0,826,0,5.50708e+18,42.9794,278.911,826,36,35,686,684,680,679,626
11906,6,13,11808,98,11906,0,1.00524e+14,6.99597,211.756,11906,9,9,11875,11857,11403,11409,10747
33298,8,11,33175,123,33234,64,1.06468e+14,7.96042,346.908,33298,10,10,33285,33281,33196,33196,30908
46630,280,392,46623,7,46630,0,4.10138e+18,315.484,3062.5,46630,240,166,46038,45592,40116,39710,36042
38665,722,1382,38665,0,34561,4104,8.34104e+17,536.663,4461.09,38665,450,181,37223,35632,34909,34219,28687
31508,5,40,0,31508,31246,262,1.93752e+16,24.3557,664.156,31508,28,27,31085,30913,26901,28957,19889
12934,621,718,12934,0,12041,893,1.10217e+18,339.669,1986.4,12934,169,156,12216,12020,11988,12048,11600
29200,79,1243,29200,0,27180,2020,9.97332e+17,620.211,3766.3,29200,345,209,23846,19880,18025,18294,7105
23728,21,77,0,23728,22812,916,2.44587e+16,28.7366,761.645,23728,32,31,23604,23542,20826,21808,11278
4388,195,239,0,4388,1027,3361,4.07227e+15,80.7397,677.772,4388,90,56,4149,4148,4125,4129,3926
39776,1105,1728,7303,32473,0,39776,2.33266e+13,329.76,4721.76,39776,487,174,38048,37931,37577,37932,28416
18397,4,8,18101,296,18397,0,1.02694e+14,5.43371,239.06,18397,7,7,18365,18356,18073,18086,15555
46253,3972,7719,46253,0,46253,0,2.12454e+18,9.42047,9832.97,46253,3860,11,38534,38534,34788,31048,19847
25758,823,1038,22781,2977,0,25758,4.22808e+18,321.978,2622.85,25758,139,246,24720,24700,24608,24614,23175
41861,55,2140,32909,8952,0,41861,7.18188e+18,326.093,5155.04,41861,394,231,36499,32367,26211,27474,5663
17713,617,928,15716,1997,15716,1997,9.12841e+17,218.71,2206.87,17713,121,180,16785,16769,16661,16695,13409
38946,100,481,38946,0,38946,0,4.91964e+18,312.403,2670.59,38946,190,169,36625,34581,23505,21108,12983
4261,138,266,4261,0,4261,0,4.69915e+18,97.2239,777.52,4261,92,80,3995,3922,3727,3692,3372
39912,922,1161,39912,0,35216,4696,1.15823e+18,435.143,4397.77,39912,341,218,38751,38746,38282,38129,34166
21599,113,1152,4746,16853,0,21599,2.49207e+13,207.358,2756.52,21599,371,150,19674,19030,18152,16554,5133
23669,1,13,23512,157,23669,0,1.02082e+14,9.63002,301.688,23669,11,10,12928,12928,12928,12928,12928
11220,389,735,0,11220,1448,9772,1.39577e+16,11.8772,1480.73,11220,371,12,10485,10485,10139,10139,7407
6851,6,11,6543,308,6851,0,9.50719e+13,9.68778,184.894,6851,11,10,6769,6716,6176,6046,5403
49403,850,3422,49403,0,44836,4567,1.1627e+18,591.414,7811.59,49403,805,226,45774,45203,41299,40045,11899
33144,291,845,7852,25292,0,33144,2.2756e+13,246.506,3220.84,33144,379,138,32299,32017,30037,28663,16314
4293,42,283,1132,3161,0,4293,2.45874e+13,49.9776,717.892,4293,120,39,3958,3792,3731,3265,859
2749,118,356,2616,133,2616,133,1.54037e+18,87.1277,696.325,2749,102,60,2391,2100,2278,2275,676
37868,1567,1602,33767,4101,33767,4101,2.75696e+18,355.319,4898.17,37868,438,179,36266,36266,36265,36259,35902
14218,237,565,12747,1471,0,14218,3.78487e+18,229.022,1662.4,14218,108,133,13604,12820,12209,12171,6757
18509,486,708,4056,14453,0,18509,1.85991e+13,313.499,2253.09,18509,223,156,17789,17471,17350,16930,14440
38928,238,738,10848,28080,0,38928,6.29012e+13,240.583,2493.46,38928,163,147,38106,37287,35028,34973,18410
11748,319,401,3252,8496,0,11748,6.33384e+13,135.26,1165.01,11748,91,79,11347,11334,11286,11310,10068
1942,114,157,441,1501,0,1942,1.50728e+13,67.3527,411.301,1942,64,42,1785,1775,1759,1759,1541
6864,58,586,6864,0,6034,830,1.17351e+18,174.392,1488.69,6864,155,109,5238,4505,3606,1552,1375
39263,49,66,0,39263,38985,278,2.54954e+16,51.8759,884.676,39263,39,42,39169,39074,38158,38369,36834
15113,329,765,0,15113,0,15113,1.28035e+18,341.907,2142.51,15113,204,151,14133,13649,13445,13354,8961
41135,334,962,0,41135,8717,32418,4.70694e+15,405.367,3651.13,41135,321,183,39767,38713,38157,35747,26400
2372,31,165,2372,0,2372,0,3.32492e+18,58.4785,443.985,2372,55,57,1965,1512,1298,898,453
651,20,21,0,651,646,5,2.81147e+16,12.1382,82.9034,651,14,15,630,629,626,629,610
20851,705,1346,18496,2355,18496,2355,3.29315e+18,217,2921.25,20851,182,148,19505,19499,19194,19105,16423
28023,7,62,0,28023,27829,194,2.57729e+16,49.2119,743.082,28023,37,38,26320,25196,23705,21345,14244
33151,3,15,31716,1435,33151,0,9.5487e+13,10.2907,413.05,33151,12,11,29763,28826,23765,23535,16959
6526,22,46,0,6526,6425,101,2.40487e+16,16.3705,344.192,6526,24,24,6476,6463,6255,6016,4542
14860,354,571,3405,11455,0,14860,1.9528e+13,226.43,1711.99,14860,172,104,14285,14072,13921,13683,12265
38634,35,55,0,38634,38339,295,2.57855e+16,17.9678,680.323,38634,24,25,38579,38575,38394,38406,35189
36253,2036,2172,29274,6979,29180,7073,3.09821e+18,354.739,5239.2,36253,361,252,34081,34081,34081,34077,33142
9619,168,331,9619,0,9619,0,5.51548e+18,226.445,1239.65,9619,133,90,9087,8822,6638,7091,6079
9005,73,506,6782,2223,6782,2223,3.81521e+18,206.229,1330.85,9005,124,116,8149,7606,5911,6246,1813
11702,312,545,10319,1383,10319,1383,3.2296e+18,249.642,1831.68,11702,188,131,11092,10879,9999,9606,5541
46966,1197,3505,322,46644,0,46966,5.07395e+11,16.2047,6480.91,46966,446,26,43461,43461,41091,40911,19774
25239,747,1142,22862,2377,0,25239,2.88923e+18,390.023,3474.16,25239,330,156,24097,23995,23032,23282,14228
48671,40,91,0,48671,48310,361,2.42907e+16,51.6805,1166.04,48671,46,47,48495,48369,46628,44727,29200
27502,1711,1933,0,27502,0,27502,2.8135e+18,363.151,4429.99,27502,348,210,25569,25569,25569,25569,23181
37460,23,64,0,37460,37194,266,2.52183e+16,52.2828,862.516,37460,40,44,37217,37142,35386,34322,27106
48211,813,2521,48211,0,41671,6540,9.44461e+17,492.364,6640.01,48211,460,307,45690,44857,41209,35712,9624
39902,621,992,8708,31194,0,39902,1.85735e+13,463.113,3653.41,39902,293,208,38910,38720,37686,37448,28904
42433,50,672,39689,2744,42433,0,4.0141e+18,358.205,3420.99,42433,279,180,36931,33786,24520,20776,7757
43844,759,2899,39918,3926,0,43844,3.20066e+18,550.241,6774.85,43844,633,246,40785,40271,37834,37107,11257
39772,270,462,39772,0,39772,0,3.84801e+18,263.582,2636.47,39772,242,171,39273,39023,33115,33295,24527
11229,369,956,10296,933,10296,933,2.55161e+18,208.559,2144.79,11229,277,87,10273,10131,9531,9309,3698
43171,1207,1726,9615,33556,0,43171,2.67384e+13,256.838,4679.6,43171,379,196,41445,41344,41216,41445,32754
36461,40,57,0,36461,36201,260,2.72057e+16,23.5417,672.901,36461,28,27,36404,36389,36352,36277,31739
26103,5,45,0,26103,25916,187,2.59323e+16,35.6433,562.096,26103,29,31,25376,25064,23206,23477,14875
10381,292,913,1804,8577,0,10381,2.07022e+13,131.479,2024.8,10381,305,104,9468,9341,9030,8167,2541
15356,101,460,15356,0,15356,0,3.32439e+18,226.089,1918.62,15356,159,119,13673,11324,10897,8437,5239
26036,1341,1830,23710,2326,23707,2329,1.46803e+18,343.074,4206.41,26036,579,164,24206,24206,24176,24191,21389
32644,317,521,32644,0,32644,0,4.53445e+18,263.242,2671.72,32644,178,180,32101,31895,30234,29389,26399
23846,154,1117,21436,2410,0,23846,3.74474e+18,516.149,3081.08,23846,461,134,21259,19567,19027,19051,10828
38589,1542,2395,34808,3781,34808,3781,1.07588e+18,283.883,5662.9,38589,439,274,36194,36194,35608,35642,26903
2826,146,629,2618,208,2618,208,9.74016e+17,85.1054,1033.71,2826,124,80,2184,2030,1909,1904,620
33405,969,1392,5609,27796,0,33405,1.99302e+13,217.986,3939.26,33405,482,102,32013,32013,31565,31980,25036
26050,256,897,26050,0,22997,3053,1.16452e+18,409.015,3303.29,26050,281,177,24325,23487,21877,17337,7710
11116,499,965,10342,774,0,11116,2.50569e+18,343.618,2215.92,11116,231,146,10151,9825,9630,9591,5305
23857,26,54,0,23857,23753,104,2.05267e+16,25.1975,594.776,23857,31,31,23770,23656,20377,22082,15794
17916,710,1306,17916,0,16798,1118,8.25578e+17,353.927,3246.93,17916,320,150,16610,16414,16341,16233,11866
26813,1409,1499,24718,2095,24718,2095,2.45486e+18,366.523,4006.13,26813,465,133,25314,25294,25262,25232,24772
43540,465,914,32809,10731,0,43540,8.284e+18,352.716,3127.92,43540,222,178,42626,42356,41084,41108,26829
13117,931,1221,11806,1311,11803,1314,1.48971e+18,168.887,2435.06,13117,431,87,11896,11894,11843,11879,10051
44599,34,35,0,44599,42460,2139,2.46102e+16,31.2216,696.302,44599,30,31,44564,44564,44564,44563,44502
48064,541,2161,36715,11349,36621,11443,3.68096e+18,358.276,5227.78,48064,351,251,45903,45690,44846,45178,34248
29472,11,45,0,29472,29252,220,2.54202e+16,38.8337,600.645,29472,31,33,29046,28689,27475,27045,18167
28445,321,792,21463,6982,21463,6982,3.78031e+18,344.023,2593.68,28445,186,173,27436,26413,26465,26473,12837
47503,691,1372,44353,3150,44353,3150,2.04576e+18,697.068,4749.86,47503,423,233,45761,43846,43803,43006,36151
18122,405,543,18058,64,18122,0,3.30439e+18,253.008,2128.05,18122,205,118,17579,17551,17321,17265,15446
30769,235,1272,28711,2058,28711,2058,6.3523e+17,502.594,3781.15,30769,313,237,28475,27631,25566,25765,5226
27951,1,13,27725,226,27951,0,9.68765e+13,10.7034,328.507,27951,12,11,15672,15672,15672,15672,15672
31492,1498,1522,0,31492,7099,24393,6.85751e+15,213.769,3940.66,31492,307,179,29970,29970,29970,29970,29838
49598,835,925,0,49598,10843,38755,4.70146e+15,494.367,3871.89,49598,351,215,48673,48671,48543,48581,47736
13269,274,2541,12953,316,12953,316,3.59581e+18,13.9631,2876.74,13269,328,22,10728,10728,8462,1407,1992
26951,140,1204,0,26951,0,26951,1.92496e+18,281.165,3513.54,26951,254,154,24503,21614,20444,6960,7187
29617,679,2148,26633,2984,26633,2984,3.13508e+18,233.69,4757.37,29617,468,205,27469,27355,24748,20562,9598
22422,374,1466,20597,1825,0,22422,2.94827e+18,369.267,3688.81,22422,325,182,20697,20282,19579,19438,8593
23529,696,1069,22033,1496,22033,1496,1.97285e+18,483.046,3126.41,23529,268,179,22369,21714,21776,21625,19214
42984,624,1344,0,42984,9340,33644,4.79618e+15,371.621,4415.5,42984,336,206,41640,41363,40404,40385,29062
26434,17,860,26434,0,19926,6508,8.42494e+17,314.012,2608.63,26434,201,162,14205,8592,8096,8465,1198
25362,874,1165,25362,0,23744,1618,9.80918e+17,610.969,3420.93,25362,375,192,24187,23429,23293,23567,22299
35465,479,840,0,35465,0,35465,1.88925e+18,343.637,3616.95,35465,301,197,34625,34612,33208,33629,20645
3091,85,205,0,3091,713,2378,4.70873e+15,77.7713,563.082,3091,75,53,2861,2732,2686,2717,1888
13523,201,527,13459,64,13523,0,3.24968e+18,233.995,1818.36,13523,216,99,12829,12214,10980,9980,6854
28341,334,1164,26461,1880,26461,1880,2.06965e+18,495.653,3489.5,28341,319,204,26593,25828,25093,24037,5283
43905,1528,2778,40694,3211,40693,3212,1.26174e+18,521.901,6435.47,43905,970,151,41127,40876,39709,40241,29227
31338,169,764,23642,7696,23642,7696,3.78302e+18,368.946,2675.03,31338,198,185,29547,28826,23605,24461,7807
6566,258,565,6566,0,5772,794,1.17065e+18,223.956,1440.9,6566,161,106,5946,5836,5496,4724,2560
27027,544,1548,0,27027,0,27027,1.55307e+18,364.333,4034.19,27027,342,181,25436,24906,24085,19293,13578
49916,223,516,49916,0,49916,0,5.10937e+18,336.945,3067.29,49916,226,181,48812,47726,36721,33889,26622
49069,230,1925,0,49069,10173,38896,6.34466e+15,298.573,5356.76,49069,449,200,46805,45827,42700,25446,13102
23672,411,1787,23578,94,23522,150,3.40953e+18,88.6037,3501.98,23672,435,67,21885,21733,20374,21849,7628
11175,18,661,9869,1306,9869,1306,9.14518e+17,168.231,1475.57,11175,94,156,7428,2719,4695,5367,590
27877,260,1102,0,27877,0,27877,1.18315e+18,510.795,3385.65,27877,325,186,25852,25392,24047,21944,14391
45128,127,1574,39980,5148,0,45128,3.4666e+18,332.369,5182.24,45128,441,190,39957,35373,33071,33786,4044
42439,1908,2605,38149,4290,38149,4290,2.96244e+18,381.629,6289.9,42439,770,251,39834,39744,39739,39724,33445
8715,38,53,0,8715,8600,115,2.05879e+16,21.5804,370.751,8715,26,25,8662,8662,8054,8337,7411
46573,423,446,46573,0,46573,0,3.86879e+18,281.948,2954.91,46573,266,222,46127,46126,46067,46072,45339
4418,551,707,4118,300,4118,300,2.05087e+18,145.315,1327.67,4418,139,108,3711,3630,3681,3683,3213
36557,249,1877,31679,4878,0,36557,4.58119e+18,346.542,5189.5,36557,341,218,34084,33141,28141,28441,10362
13100,309,574,13100,0,11625,1475,7.05587e+17,399.316,2018.81,13100,264,129,11903,10184,10592,8929,10467
15615,63,86,0,15615,15495,120,1.92616e+16,21.7315,632.816,15615,33,30,15529,15528,15506,15526,12364
15475,115,1060,14441,1034,0,15475,2.42035e+18,371.165,2555.24,15475,312,155,13426,12132,11575,11240,4193
32631,22,64,0,32631,32411,220,2.61855e+16,45.3952,791.472,32631,36,40,32430,32343,30630,29556,25497
48058,17,101,0,48058,47826,232,2.33021e+16,39.7808,1213.23,48058,44,40,47522,46954,42562,40959,29953
21946,1147,1609,19518,2428,0,21946,4.04078e+18,210.646,3311.95,21946,400,190,20337,20337,19237,19264,13456
32815,67,493,32815,0,32815,0,3.32739e+18,293.883,2357.16,32815,180,141,30376,28549,19577,18903,5908
5596,260,407,5009,587,5009,587,3.2658e+18,161.367,959.207,5596,86,90,5189,4965,4989,4965,3722
32953,1061,2300,32953,0,29869,3084,1.23809e+18,395.482,5513.81,32953,432,271,30653,30551,28423,25242,14777
8836,1,8,8823,13,8836,0,4.87392e+13,5.68787,203.089,8836,7,6,4526,4526,4526,4526,4526
44947,588,1747,41906,3041,41906,3041,2.11536e+18,755.844,5260.58,44947,452,264,42695,41208,40336,38016,14155
44819,334,691,0,44819,10290,34529,7.36167e+15,231.45,3377.84,44819,265,149,44128,44113,42507,43329,25370
39053,582,849,0,39053,9404,29649,5.81595e+15,256.907,3460.39,39053,384,145,38204,38119,37498,37670,26774
2440,6,12,2425,15,2440,0,8.90571e+13,5.49057,100.261,2440,9,7,2426,2419,2306,2315,2067
8351,155,275,8351,0,8351,0,4.01381e+18,184.171,1039.32,8351,95,106,7915,7440,6841,6901,5000
41662,9,49,0,41662,41509,153,2.56566e+16,33.559,712.685,41662,25,29,41403,41270,37316,39213,26231
21629,57,61,0,21629,21312,317,2.43868e+16,41.1867,678.836,21629,36,37,21568,21558,21452,21349,20726
3998,6,225,3998,0,3998,0,3.209e+18,88.8827,669.851,3998,74,69,1516,1016,860,810,210
5265,272,347,5265,0,5265,0,3.17924e+18,204.503,1014.91,5265,124,82,4870,4536,4742,4693,4488
45873,1168,1976,0,45873,0,45873,3.23941e+18,298.647,5558.19,45873,304,200,43897,43882,39974,25734,17922
44212,435,1048,9805,34407,0,44212,2.2563e+13,423.095,4031.55,44212,451,146,42984,42570,39954,40670,19435
23361,7,13,23173,188,23361,0,9.54277e+13,11.0406,300.301,23361,12,11,23328,23322,22376,22374,21196
37755,105,195,0,37755,36439,1316,2.55805e+16,25.2528,1163.95,37755,75,39,37560,37551,37043,36479,29032
11043,1,11,10972,71,11043,0,1.08838e+14,7.02164,206.586,11043,10,9,5673,5673,5673,5673,5673
39467,533,2114,39467,0,35746,3721,1.62309e+18,347.497,5296.54,39467,400,308,37259,36601,32884,34272,16158
40636,635,917,8631,32005,0,40636,1.81903e+13,456.645,3567.3,40636,317,198,39719,39597,38681,38718,34343
8786,424,469,1467,7319,0,8786,1.93369e+13,144.022,1303.84,8786,176,61,8317,8315,8278,8310,7953
15868,150,664,0,15868,3387,12481,4.75465e+15,297.639,2081.62,15868,199,150,14793,14547,13816,13003,4488
18168,802,1012,16950,1218,16950,1218,2.05489e+18,454.582,2737.55,18168,254,181,17156,16765,16922,16838,15633
21011,1068,1444,21011,0,18833,2178,1.40701e+18,199.833,3193.01,21011,449,131,19567,19567,18238,18711,12597
30972,62,66,0,30972,30843,129,2.6839e+16,26.4135,662.61,30972,27,27,30906,30906,30886,30888,30826
22163,409,1996,17263,4900,17183,4980,3.50709e+18,205.747,3979.27,22163,295,220,20167,19716,19139,19538,11455
23438,40,44,0,23438,23355,83,2.69317e+16,16.1817,503.597,23438,21,21,23394,23394,23394,23394,23243
8310,4,34,0,8310,8079,231,2.45829e+16,9.37918,332.859,8310,16,13,8049,7895,6423,6997,3729
42995,646,886,0,42995,10209,32786,7.15921e+15,225.495,3674.98,42995,357,154,42109,42109,41784,41905,31286
13280,236,725,0,13280,3415,9865,6.88064e+15,178.107,1831.93,13280,259,92,12521,12056,10895,11336,6027
23374,7,12,23296,78,22450,924,7.84192e+13,6.73171,313.558,23374,10,8,23361,23357,22839,22838,22273
21411,153,1451,19980,1431,19980,1431,8.15093e+17,483.085,3625.88,21411,305,180,18777,17687,15614,16563,6482
23725,12,75,0,23725,23474,251,2.43159e+16,42.4245,757.351,23725,34,42,23058,22438,21245,20946,12365
41782,1622,2242,37809,3973,37809,3973,2.85664e+18,284.731,5576.56,41782,475,252,39540,39540,39411,39540,30633
35640,1146,1238,33251,2389,33251,2389,2.04849e+18,611.462,3998.67,35640,411,212,34402,34400,34307,34302,33885
28893,368,760,25471,3422,0,28893,3.82266e+18,344.734,3183.68,28893,263,169,28044,27324,25673,25706,14141
19285,36,483,0,19285,5380,13905,1.6198e+16,190.414,1551.79,19285,119,103,18019,17367,15119,15363,4165
20273,967,1320,2616,17657,0,20273,5.45403e+13,11.8879,2567.61,20273,663,12,18953,18953,18601,15285,15821
26887,255,642,25537,1350,26887,0,3.94599e+18,257.826,2557.73,26887,225,155,26141,25703,23728,22659,17864
29696,1119,1141,0,29696,6848,22848,6.18539e+15,274.338,3275.25,29696,394,133,28555,28523,28550,28551,28486
43347,70,85,0,43347,42798,549,2.11517e+16,24.8775,1054.97,43347,31,35,43262,43262,40790,41927,38034
38379,5234,6109,0,38379,2439,35940,1.25283e+14,12.2691,8734.23,38379,1234,18,32270,32270,31057,28456,29148
19573,480,1262,17624,1949,17624,1949,1.61682e+18,443.086,3002.14,19573,395,141,18087,17567,16444,16977,11642
4416,1,8,4333,83,4416,0,9.59287e+13,6.2038,122.165,4416,7,7,2247,2247,2247,2247,2247
11755,321,624,11755,0,8859,2896,8.18444e+17,207.828,1624.32,11755,136,123,11131,10901,10638,9985,6699
49431,364,662,46687,2744,49431,0,3.97212e+18,353.712,3659.46,49431,291,203,48627,48154,43486,42144,34353
18023,598,1176,4234,13789,0,18023,2.97188e+13,131.132,2467.59,18023,380,110,16847,16834,15317,15175,7765
35017,4,34,0,35017,33313,1704,2.46546e+16,30.6214,613.55,35017,30,30,31928,30483,23210,23130,15494
18447,448,937,0,18447,0,18447,1.353e+18,324.808,2864.14,18447,367,148,17510,17302,17214,15926,13664
33204,1810,2119,33204,0,25608,7596,9.65127e+17,291.996,4634.83,33204,260,290,31085,31085,30759,30106,30359
8864,238,655,7703,1161,7703,1161,1.74703e+18,179.148,1730.15,8864,188,107,8195,7997,7572,7622,4538
20825,423,584,0,20825,0,20825,8.16039e+17,373.743,2380.88,20825,221,149,20234,19943,19503,19519,19781
26901,21,40,0,26901,26691,210,2.74505e+16,18.6816,515.573,26901,23,22,26860,26838,26591,26461,23198
16370,551,577,0,16370,0,16370,4.15598e+18,267.1,1735.52,16370,148,124,15793,15788,15792,15790,15602
2532,1,7,2530,2,2532,0,8.28197e+13,6.82622,97.5835,2532,7,7,1461,1461,1461,1461,1461
46835,1149,2022,0,46835,11117,35718,7.33932e+15,208.828,4930.45,46835,474,158,44813,44807,40347,41099,20817
32803,1179,1335,30610,2193,30610,2193,6.93904e+17,672.072,4111.84,32803,332,229,31468,31450,31300,31330,30656
47516,947,2106,0,47516,0,47516,2.04426e+18,326.405,5073.05,47516,414,332,45410,45387,39313,40305,13908
44148,571,2401,40039,4109,40036,4112,1.28549e+18,328.005,6211.94,44148,649,165,41651,40938,39374,38258,13620
13769,600,672,12172,1597,12172,1597,3.61263e+18,241.654,1635.47,13769,102,175,13097,13095,13028,12997,12383
33268,326,684,0,33268,9268,24000,1.61132e+16,227.976,2265.62,33268,148,142,32584,32369,31332,31529,20393
45628,36,46,0,45628,45315,313,2.57432e+16,38.3539,734.03,45628,34,34,45547,45407,45209,45391,39712
6708,207,301,0,6708,1479,5229,7.1126e+15,140.655,1031.87,6708,130,66,6407,6351,6153,6222,4096
29396,1098,1556,26392,3004,26389,3007,1.11232e+18,237.458,3743.2,29396,417,158,27840,27840,27621,27794,15716
20956,19,472,20956,0,20956,0,4.77027e+18,253.559,2094.24,20956,165,146,14710,10199,8530,7507,2514
20810,271,423,20810,0,20810,0,4.8537e+18,239.13,1906.75,20810,178,131,20319,20015,18804,17812,16313
9278,212,527,0,9278,2041,7237,4.76842e+15,146.293,1362.87,9278,160,104,8741,8592,8402,8440,5874
10199,290,488,0,10199,2677,7522,5.36965e+15,103.53,1291.91,10199,207,58,9711,9642,9421,9652,7879
46299,1022,1551,0,46299,0,46299,1.45028e+18,658.915,5221.94,46299,558,186,44748,44042,43884,44086,28638
18415,575,940,16575,1840,16575,1840,2.4642e+18,310.526,2827.59,18415,367,147,17475,17433,17294,17194,15669
17959,458,1194,16551,1408,0,17959,2.92033e+18,290.73,3004.41,17959,408,104,16684,16321,15961,15927,9445
49323,33,49,0,49323,49143,180,2.64604e+16,32.439,773.227,49323,27,30,49261,49227,49004,49106,41936
33155,719,2266,27680,5475,0,33155,5.58229e+18,316.508,5454.46,33155,382,273,30875,30629,28235,28786,13397
13309,21,53,0,13309,13169,140,2.65296e+16,35.8199,477.638,13309,29,30,13204,13105,12491,12760,6722
23112,5,9,23062,50,15331,7781,6.93947e+13,7.44263,341.934,23112,9,9,23002,22920,20438,20465,16566
19796,16,58,0,19796,19661,135,2.53636e+16,40.816,615.035,19796,35,35,19454,19106,18378,18145,14438
40425,1024,5061,40425,0,35873,4552,1.81157e+18,15.4542,6757.76,40425,1153,27,35364,35364,32867,35363,6045
33277,1534,2491,33277,0,33267,10,1.24555e+18,29.0172,4715.34,33277,388,29,30786,30786,29314,30786,25911
33207,244,788,24990,8217,0,33207,8.34417e+18,336.644,2648.27,33207,203,175,31905,30797,26456,26768,14840
10776,119,498,9513,1263,0,10776,3.77589e+18,263.827,1729.26,10776,192,126,9608,8245,8122,8336,3808
22595,792,836,0,22595,5028,17567,5.76594e+15,224.907,2708.26,22595,363,121,21759,21757,21733,21758,21018
16220,392,728,0,16220,3468,12752,4.96905e+15,246.582,2138.87,16220,205,116,15478,15195,15002,14938,11822
5952,33,395,768,5184,0,5952,4.35224e+11,11.8569,832.448,5952,200,12,5557,5557,1972,3506,2336
37119,78,369,37110,9,37119,0,3.26797e+18,315.363,2649.52,37119,195,166,31970,28041,24925,18626,10147
39693,505,620,36920,2773,39693,0,3.6152e+18,338.34,3178.93,39693,280,149,39073,39041,37768,37565,35703
46869,883,2224,46869,0,42465,4404,1.62457e+18,406.464,5840.68,46869,432,335,44645,44109,41730,41208,26543
19251,4,34,0,19251,18363,888,2.45322e+16,29.578,454.708,19251,26,25,17527,16743,12772,12754,8487
15128,614,699,15128,0,13283,1845,1.1732e+18,297.905,2326.88,15128,199,140,14429,14428,14421,14405,13428
1067,126,187,1009,58,1009,58,4.86723e+17,70.7704,360.581,1067,65,42,880,827,842,846,715
29830,1409,1821,29830,0,26483,3347,1.65813e+18,253.945,4023.74,29830,424,189,28009,28009,26382,27175,20426
7953,594,783,7116,837,0,7953,3.93548e+18,224.123,1507.1,7953,200,92,7170,6960,6994,7072,6349
14453,149,561,10897,3556,0,14453,8.24933e+18,231.529,1600.08,14453,144,121,13612,13347,11337,11088,5728
6050,675,779,5621,429,5621,429,2.16137e+18,152.23,1565.8,6050,144,111,5271,5268,5263,5265,4935
5850,408,448,5850,0,4414,1436,8.24787e+17,108.845,1025.39,5850,113,90,5402,5379,5367,5289,5163
1074,8,29,0,1074,1072,2,2.10672e+16,14.0391,112.218,1074,18,17,991,952,854,900,713
39925,259,1055,8632,31293,0,39925,2.25146e+13,431.839,3799.87,39925,445,139,38501,37735,35234,32488,12249
42005,1481,1740,38617,3388,38617,3388,2.45299e+18,601.367,5237.73,42005,409,247,40265,40265,39968,39765,37029
19672,143,426,19672,0,19672,0,5.18892e+18,260.281,1886.51,19672,188,126,18820,18105,13180,12063,8845
1889,13,18,0,1889,1885,4,1.31223e+16,12.8232,116.959,1889,14,12,1866,1849,1852,1864,1785
23988,39,61,0,23988,23824,164,2.50496e+16,52.6035,694.51,23988,36,38,23886,23809,22914,22845,19944
29154,69,1175,0,29154,0,29154,1.23386e+18,599.055,3660.49,29154,345,209,23782,20105,19176,15872,5808
12231,326,603,9230,3001,9230,3001,3.7851e+18,211.675,1612.17,12231,141,125,11625,11344,11409,11388,6574
33901,100,594,33901,0,33901,0,3.46546e+18,292.435,3048.52,33901,214,168,30365,25486,23586,17671,7979
36653,1094,1609,32656,3997,32656,3997,3.38652e+18,284.899,3765.95,36653,300,176,35044,35043,33768,33578,24573
31808,285,1048,27947,3861,27947,3861,3.0846e+18,313.787,3842.88,31808,374,177,30279,28737,25046,22258,11041
25549,592,1216,0,25549,5405,20144,4.70453e+15,285.542,3440.14,25549,260,181,24333,24145,23625,23624,16728
18504,493,633,0,18504,0,18504,1.86857e+18,304.076,2422.32,18504,231,146,17871,17870,17669,17762,14512
34106,8,34,0,34106,32480,1626,2.4599e+16,31.3532,607.481,34106,29,30,32808,31499,24480,29299,20003
34762,537,1305,31022,3740,0,34762,3.84425e+18,294.944,3455.76,34762,180,171,33457,33351,31667,31800,22216
49298,989,1968,0,49298,12074,37224,7.49651e+15,319.36,4824.08,49298,330,165,47330,47209,46238,46429,36761
15236,447,665,0,15236,3438,11798,4.48819e+15,220.842,1966.48,15236,200,121,14571,14387,14258,14332,12382
21090,679,1091,19658,1432,19658,1432,2.09926e+18,484.446,3024.94,21090,292,183,19910,19319,19349,19213,13109
20617,410,584,0,20617,0,20617,7.8221e+17,341.744,2334.91,20617,227,146,20033,19781,19429,19479,19384
12441,8,11,12432,9,11173,1268,7.88248e+13,7.55968,242.554,12441,9,9,12430,12430,12244,12246,10507
18620,83,1002,0,18620,0,18620,1.18886e+18,451.565,2796.93,18620,254,177,15626,13641,13365,11943,2770
43026,3,14,42767,259,43026,0,9.59055e+13,10.9025,415.202,43026,13,11,41393,40671,37358,38311,30986
28656,178,961,6257,22399,0,28656,1.81524e+13,348.428,3111.38,28656,255,172,27173,26603,25627,20300,11557
19001,294,1039,17756,1245,0,19001,2.35108e+18,469.471,2857.07,19001,281,175,17438,16975,16268,16267,10695
33550,64,90,0,33550,33062,488,2.06616e+16,26.5876,924.319,33550,37,34,33460,33458,33444,33459,28245
27342,250,1596,0,27342,0,27342,1.19283e+18,433.865,4101.59,27342,357,183,25123,24700,23487,21670,12902
47857,3,56,0,47857,47258,599,1.96041e+16,22.4815,983.539,47857,32,27,43937,41724,35902,37149,25051
17966,1040,1368,16512,1454,16511,1455,1.40485e+18,235.355,3233.7,17966,449,103,16598,16598,16598,16598,11928
46656,245,1320,0,46656,9935,36721,4.87433e+15,397.942,4619.16,46656,357,228,44489,43177,41526,37131,17333
21290,20,681,0,21290,0,21290,4.12658e+18,305.566,2082.86,21290,186,140,13481,8326,8424,4707,1549
42306,402,1419,0,42306,0,42306,1.21021e+18,583.369,4603,42306,375,209,40048,38718,38226,36977,24440
20330,2500,3545,20330,0,19372,958,8.57268e+17,15.0952,4158.37,20330,521,27,16785,16785,15559,13240,10908
40122,1,17,39503,619,40122,0,9.85537e+13,10.9811,412.481,40122,13,12,21653,21653,21653,21653,21653
46389,85,872,34978,11411,34978,11411,7.0133e+18,390.505,3207.34,46389,253,177,43071,41738,28600,20752,9022
41061,568,1196,0,41061,0,41061,1.81439e+18,342.088,4514.66,41061,398,214,39865,39824,36660,35505,16861
48359,62,1579,48359,0,42544,5815,1.14203e+18,415.311,5385.18,48359,358,214,37592,32338,26184,6817,3673
33873,429,1623,6297,27576,0,33873,2.24869e+13,246.045,4246.48,33873,408,185,32250,31981,30910,30512,11933
33833,1256,2027,0,33833,0,33833,1.80523e+18,247.468,4830.77,33833,391,227,31806,31806,31723,31649,24763
3146,111,386,2983,163,2983,163,8.9174e+17,90.0973,773.552,3146,155,54,2707,2567,2134,2448,1103
30159,606,802,6676,23483,0,30159,1.81998e+13,421.3,2961.52,30159,302,166,29357,28891,28877,28737,26309
40777,9,12,40190,587,40777,0,9.61146e+13,11.4699,390.48,40777,12,12,40748,40725,39075,39076,36083
3143,48,300,2816,327,2816,327,3.23915e+18,93.1667,639.487,3143,65,70,2734,2642,2447,2115,618
7716,12,13,7665,51,7716,0,1.02726e+14,7.50972,171.86,7716,9,9,7703,7702,7672,7672,7700
28399,2,12,27788,611,24753,3646,7.45045e+13,6.80552,325.774,28399,9,8,25449,24447,22516,24647,18711
12769,500,649,0,12769,2762,10007,4.59362e+15,245.817,1852.55,12769,217,126,12120,12011,11957,11973,10307
44282,595,1649,0,44282,0,44282,1.69681e+18,485.327,5034.58,44282,603,183,42325,40860,38693,36758,28545
17211,735,800,15395,1816,15395,1816,8.91996e+17,238.791,2143.85,17211,131,156,16411,16411,16384,16407,15961
24144,296,679,18207,5937,18207,5937,7.00686e+18,316.976,2204.75,24144,179,146,23294,22321,21994,20819,13784
2385,31,269,529,1856,0,2385,2.01217e+13,72.018,576.34,2385,80,41,1910,1607,1602,1350,577
29331,1,28,0,29331,29303,28,1.01953e+16,5.99175,533.587,29331,13,10,14432,14432,14432,14432,14432
21325,113,620,21325,0,21325,0,3.3226e+18,253.372,2479.51,21325,177,147,19429,17108,14886,10902,6829
15064,146,1156,13657,1407,0,15064,3.41921e+18,178.72,2661.68,15064,211,136,13593,12873,11995,12125,3945
31698,28,63,0,31698,31473,225,2.62879e+16,51.4615,786.506,31698,37,39,31544,31499,30210,30090,24663
34610,280,1091,0,34610,0,34610,1.27539e+18,521.876,3595.69,34610,354,198,32573,31645,30182,28974,19079
11489,657,871,2728,8761,0,11489,2.3985e+13,106.165,2028.68,11489,200,124,10618,10610,10552,10557,8219
11775,276,554,0,11775,2558,9217,4.72414e+15,218.507,1591.59,11775,128,129,11174,10971,10740,10727,7049
1131,105,141,0,1131,314,817,7.89969e+15,44.84,306.988,1131,43,44,990,988,969,977,826
25772,1130,1373,24101,1671,0,25772,2.39781e+18,537.877,3735.01,25772,314,181,24399,24080,24180,24153,22752
45770,2,15,45643,127,45077,693,8.28992e+13,7.76268,438.468,45770,10,10,38172,35685,35307,36423,27760
27830,746,1118,26020,1810,0,27830,2.35579e+18,506.716,3405.86,27830,317,191,26650,25855,26043,25853,21240
30258,380,1025,28208,2050,28208,2050,2.10898e+18,447.967,3307.83,30258,327,186,28766,27804,27514,26753,20026
8542,217,616,7644,898,7644,898,9.11719e+17,181.233,1424.4,8542,113,115,7892,7310,7450,7421,3781
3722,425,464,3454,268,0,3722,2.64281e+18,108.941,947.114,3722,120,64,3258,3258,3244,3241,3203
5908,67,426,4469,1439,4469,1439,6.86896e+18,83.1139,950.977,5908,80,83,5420,5209,4228,3679,1696
37058,390,504,37058,0,37058,0,5.27729e+18,332.797,2668.59,37058,188,163,36553,36372,35550,34120,32776
13936,603,897,3360,10576,0,13936,2.67813e+13,129.795,1928.83,13936,308,82,13039,13013,12545,12552,10382
44132,1259,1664,39766,4366,39766,4366,2.80277e+18,584.012,5092.35,44132,624,192,42468,42324,42092,41850,38546
9839,454,713,0,9839,1845,7994,5.49997e+15,116.82,1667.78,9839,223,64,9126,9122,8841,8897,7039
8984,375,416,8874,110,8984,0,3.14362e+18,209.777,1310.42,8984,154,83,8568,8526,8528,8507,8197
37030,270,387,37025,5,37030,0,4.23597e+18,299.403,2727.34,37030,230,158,36476,36171,31620,30993,27439
42548,1341,3915,31545,11003,0,42548,6.35788e+18,22.9172,4873.9,42548,1225,733,38633,38633,22479,26307,26140
46874,626,742,13082,33792,0,46874,6.28913e+13,265.308,2725.84,46874,189,151,46132,46127,45943,45864,42483
29850,87,793,29850,0,22520,7330,8.17699e+17,349.802,2648.74,29850,199,169,27598,26344,21844,21881,4679
27927,7,10,27829,98,27863,64,1.01334e+14,8.01952,310.254,27927,8,10,27904,27879,27465,27464,25142
8831,452,500,0,8831,1427,7404,4.98615e+15,153.786,1330.46,8831,210,80,8331,8331,8311,8329,8024
36626,885,980,8708,27918,0,36626,2.96198e+13,219.541,3391.27,36626,244,132,35646,35646,35589,35644,34791
26331,1018,1303,5026,21305,0,26331,2.3669e+13,233.197,3447.57,26331,346,184,25028,24953,24910,25013,19436
38554,729,881,8452,30102,0,38554,1.82816e+13,467.534,3410.78,38554,332,196,37673,37621,37305,37229,35747
37751,1,8,37382,369,37751,0,1.06026e+14,7.418,358.516,37751,8,8,18994,18994,18994,18994,18994
19507,4,36,0,19507,19432,75,2.8399e+16,17.6676,453.588,19507,21,20,19015,18664,14786,16377,11704
39485,8,10,39344,141,39357,128,1.00293e+14,7.65468,367.386,39485,9,10,39473,39471,39431,39431,36175
12664,360,457,12664,0,12664,0,3.34687e+18,232.403,1737.45,12664,158,111,12207,12117,12015,11758,11015
18631,667,1240,17213,1418,17213,1418,2.39236e+18,266.641,3104.83,18631,398,101,17391,17247,16962,16594,11229
47723,362,875,35927,11796,0,47723,8.33211e+18,373.843,3227.99,47723,260,178,46711,44757,41579,41688,29092
28195,5,11,26849,1346,28195,0,9.61185e+13,10.5076,375.637,28195,11,11,27256,27126,24823,24048,22354
44266,308,703,10163,34103,0,44266,2.86261e+13,230.006,3373.52,44266,271,138,43563,43371,41917,42816,23205
3862,23,32,0,3862,3673,189,2.47595e+16,14.6479,205.183,3862,19,19,3830,3821,3735,3776,3600
27367,478,1192,24047,3320,24047,3320,3.29051e+18,264.071,3522.21,27367,254,160,26175,26129,24678,23902,17278
25339,39,40,0,25339,25313,26,2.06599e+16,26.4266,545.644,25339,29,27,25299,25299,25250,25219,25248
48066,339,947,48066,0,36196,11870,8.05207e+17,422.192,3521.28,48066,274,196,46695,44438,42672,38422,22223
46157,4,14,45840,317,46157,0,9.43395e+13,11.0005,430.693,46157,13,12,45342,44979,41414,41847,35929
41584,179,979,8834,32750,0,41584,1.82489e+13,408.244,3683.75,41584,285,208,39449,38332,36943,29889,16798
3354,1,8,3345,9,3354,0,1.16988e+14,6.13834,107.293,3354,8,6,1698,1698,1698,1698,1698
26254,1013,1134,23606,2648,0,26254,3.72026e+18,536.186,3255.38,26254,474,147,25120,25108,25055,25069,23826
22745,582,815,21202,1543,0,22745,2.48421e+18,388.237,2576.46,22745,221,163,21898,21267,21532,21554,19299
41367,648,1056,9049,32318,0,41367,2.21892e+13,430.73,3897.94,41367,447,145,40311,39927,39557,39742,26774
16777,264,313,16777,0,16777,0,4.88929e+18,201.84,1539.16,16777,143,126,16463,16360,15832,15745,14901
18340,141,748,4071,14269,0,18340,1.79263e+13,302.149,2260.98,18340,272,123,17147,16888,16024,13571,7780
48615,2009,2229,37487,11128,0,48615,7.64887e+18,336.879,5322.45,48615,395,226,46386,46386,46386,46386,45530
23686,6,43,0,23686,23540,146,2.60565e+16,33.8954,519.622,23686,28,29,23133,22812,21629,21453,14330
20029,10,11,19923,106,20029,0,1.03503e+14,7.83339,278.685,20029,10,10,20018,20018,20005,20005,19440
23279,534,1577,23279,0,21205,2074,1.40102e+18,297.259,3849.7,23279,367,193,21702,21404,20349,19607,13507
45617,13,93,0,45617,45361,256,2.05573e+16,30.2895,1067.98,45617,41,35,44849,43845,39845,41283,28759
46186,4,14,45566,620,43442,2744,8.03668e+13,7.80834,425.688,46186,10,9,45695,45416,41784,42256,30698
27299,493,1285,4444,22855,0,27299,2.12474e+13,261.828,3420.58,27299,504,99,26014,25616,25388,25074,13399
49449,820,1492,0,49449,0,49449,1.48586e+18,624.449,5374,49449,532,206,47857,47191,45891,45937,28029
11592,376,567,11592,0,10265,1327,7.26703e+17,387.098,1902.55,11592,248,119,10758,9253,9916,8752,10189
40979,842,1268,0,40979,0,40979,1.22713e+18,660.219,4351.25,40979,358,235,39680,38461,38426,35053,31195
5600,263,468,4948,652,0,5600,4.25928e+18,73.9789,940.856,5600,70,87,5132,5110,4885,4874,3057
33860,111,1331,31653,2207,31653,2207,2.03454e+18,480.033,4045.94,33860,338,183,30115,26431,25730,26110,9659
32547,199,623,31148,1399,31098,1449,7.7317e+17,457.137,3060.25,32547,253,176,29520,26108,23118,26791,14109
24815,776,1190,22394,2421,0,24815,3.00216e+18,339.441,3486.45,24815,330,142,23625,23588,22324,22390,13808
33083,130,480,33083,0,33083,0,4.97194e+18,314.609,2517.13,33083,193,166,31480,30051,21903,19707,14021
29659,918,2151,0,29659,0,29659,1.69294e+18,242.502,4778.02,29659,392,218,27508,27495,27277,23454,18164
24872,567,2216,24872,0,20483,4389,3.99125e+18,22.9717,2895.55,24872,748,745,22656,22656,19181,19546,20469
34085,6,11,33885,200,34085,0,1.02334e+14,8.93595,363.96,34085,10,10,33940,33807,32452,32431,25302
3068,180,225,3068,0,3068,0,4.66228e+18,98.6985,641.731,3068,84,74,2843,2814,2776,2758,2695
23024,62,830,20284,2740,20284,2740,1.71053e+18,379.817,3045.19,23024,271,166,17950,15342,12469,14141,3971
33940,1350,1871,30417,3523,30417,3523,1.47473e+18,532.645,4866.21,33940,435,171,32069,31909,31800,31958,28112
9155,1035,1084,8565,590,8565,590,1.11651e+18,178.492,2102.61,9155,349,102,8071,8071,8027,8071,7925
26985,190,686,20306,6679,0,26985,8.34448e+18,323.316,2315.91,26985,188,155,25652,24909,20304,20554,10850
40770,73,75,0,40770,40431,339,2.49312e+16,29.9681,871.144,40770,34,32,40695,40695,40695,40695,39953
12124,378,551,10690,1434,0,12124,3.80391e+18,267.106,1885,12124,197,131,11557,11358,11094,11153,7806
46269,85,1076,46269,0,34849,11420,8.50692e+17,400.496,3599.21,46269,259,185,42520,40562,33343,33561,6288
10189,131,849,9044,1145,9044,1145,2.70464e+18,240.788,2096.04,10189,290,120,8657,7895,7499,6580,2887
45333,102,269,45333,0,45333,0,3.0135e+18,219.288,2071.83,45333,230,52,44513,44466,39031,43007,27142
2816,59,189,2816,0,2816,0,3.34369e+18,71.1644,540.107,2816,66,67,2545,2108,1851,1763,1148
25378,52,65,0,25378,25082,296,2.46344e+16,39.4124,753.918,25378,34,39,25313,25297,24729,24971,23032
23436,110,438,23436,0,23436,0,3.28406e+18,262.503,1944.32,23436,171,123,22228,21573,16505,15831,6816
3967,466,618,3967,0,3664,303,6.25438e+17,153.644,1199.53,3967,155,84,3349,3299,3267,2703,2819
6117,205,325,0,6117,1458,4659,4.21692e+15,91.4643,883.837,6117,116,63,5792,5787,5686,5676,4639
48298,646,989,0,48298,0,48298,1.89401e+18,343.709,4414.42,48298,343,223,47309,47304,46404,46600,33397
32428,112,1820,32428,0,29299,3129,1.12919e+18,333.471,4501.51,32428,583,141,29187,27515,24242,7661,2780
21767,1,11,20722,1045,21767,0,9.62999e+13,10.818,330.747,21767,11,11,8506,8506,8506,8506,8506
18363,957,1527,18363,0,15150,3213,8.10716e+17,184.517,3642.98,18363,329,174,16836,16820,16489,16298,8084
24556,314,1342,5881,18675,0,24556,2.78529e+13,147.246,3142.35,24556,300,136,23214,23106,21360,21365,11136
11466,336,515,8645,2821,0,11466,8.286e+18,199.224,1402.84,11466,128,111,10951,10663,10796,10818,8246
33059,432,1410,0,33059,0,33059,1.21198e+18,579.4,4162.97,33059,327,193,31118,30139,29472,23494,15111
8158,208,289,8158,0,8158,0,4.90329e+18,139.832,1061.74,8158,104,94,7869,7830,7627,7579,7276
34885,7,14,34645,240,34885,0,9.54604e+13,10.728,372.491,34885,12,11,34844,34838,33409,33407,31046
11159,50,526,9770,1389,0,11159,3.98282e+18,228.829,1751.3,11159,191,131,8711,7484,7226,7191,1458
42257,54,65,0,42257,41922,335,2.50123e+16,50.8874,902.704,42257,40,43,42174,42081,41415,41413,39416
6847,410,449,6069,778,0,6847,3.63638e+18,216.795,1318.76,6847,151,91,6398,6358,6382,6383,6153
8633,264,290,8633,0,8633,0,3.45489e+18,139.829,995.447,8633,82,107,8343,8300,8321,8317,7789
7199,198,933,0,7199,0,7199,4.10487e+17,193.481,1665.38,7199,234,92,6177,5693,4707,2510,1813
34589,283,2058,0,34589,0,34589,1.7959e+18,250.1,4886.88,34589,401,225,32430,31714,28997,10762,9938
23685,201,806,0,23685,5247,18438,4.6122e+15,361.69,2608.84,23685,306,158,22356,21974,21098,19930,10790
41899,885,1930,0,41899,8388,33511,6.6574e+15,285.559,5014.42,41899,517,218,39969,39901,37862,37140,25148
38232,554,623,36645,1587,36595,1637,7.45741e+17,469.153,3310.78,38232,264,184,37582,37282,37488,37522,36908
13923,874,1105,12438,1485,0,13923,3.85766e+18,176.932,2392.83,13923,335,102,12818,12806,12656,12656,11143
45546,1249,1425,45546,0,42500,3046,9.50134e+17,749.372,4824.26,45546,381,245,44121,44024,43692,43798,42769
11544,235,486,3016,8528,0,11544,2.95256e+13,140.235,1310.1,11544,90,110,11058,10996,10605,10775,7987
13874,676,950,0,13874,0,13874,1.18466e+18,303.851,2348.25,13874,194,155,12924,12775,12751,12517,10586
31254,229,4975,0,31254,0,31254,3.20902e+16,12.2686,7146.46,31254,1004,17,26279,26279,12586,1944,9222
25539,1212,1347,25539,0,23871,1668,9.2356e+17,476.532,3754.29,25539,320,214,24192,24048,23885,23900,22845
43123,1202,1276,0,43123,0,43123,1.21404e+18,679.518,4460.11,43123,383,244,41847,41847,41767,41753,41412
11460,206,1073,0,11460,2235,9225,5.99217e+15,84.8553,2277.16,11460,283,119,10387,10281,9934,5957,4098
20244,14,1100,18857,1387,18857,1387,2.11017e+18,460.574,3000.67,20244,281,184,12362,9824,8130,8180,2156
42896,152,931,10200,32696,0,42896,2.29863e+13,271.708,3719.56,42896,385,146,40214,37235,36762,33341,11359
23155,115,469,0,23155,5273,17882,7.24604e+15,215.606,2189.33,23155,206,114,22233,21740,18814,19569,8286
29711,53,2028,26745,2966,26745,2966,3.09145e+18,226.995,4684.69,29711,485,155,25444,24056,22011,17922,3249
41626,2031,2126,37830,3796,37830,3796,7.91746e+17,377.961,5458.73,41626,428,253,39500,39500,39493,39479,39108
8345,107,468,7781,564,0,8345,2.50126e+18,105.942,1278.87,8345,207,76,7820,7398,7527,7596,3129
33256,1447,6177,0,33256,4731,28525,2.30569e+15,10.0646,6737.32,33256,813,22,27079,27079,21914,23176,11152
10126,448,861,0,10126,2225,7901,7.07674e+15,110.302,1649.05,10126,377,66,9265,9123,8930,9119,7501
25264,349,611,0,25264,7043,18221,1.60796e+16,208.959,1929.97,25264,129,126,24653,24552,24024,24112,17084
42171,2929,6650,0,42171,2679,39492,1.25295e+14,69.5855,9525.49,42171,1354,18,35521,35461,30298,16543,22052
6646,273,960,0,6646,1641,5005,1.53189e+16,69.4815,1786.19,6646,199,116,5686,5589,4789,3851,3506
29814,1366,1459,26647,3167,0,29814,3.86043e+18,228.151,3567.6,29814,366,147,28355,28355,28228,28215,27009
13807,7,17,13789,18,13802,5,7.66531e+12,12.2804,253.69,13807,14,13,13768,13757,13695,13681,8905
16867,71,887,3645,13222,0,16867,1.72564e+13,209.86,2402.28,16867,244,131,15303,14013,13979,9515,4120
16063,636,1219,16063,0,14041,2022,1.17605e+18,273.992,2871.97,16063,254,147,14844,14835,14435,14089,12904
42554,10,13,42227,327,42554,0,9.98664e+13,11.5435,401.967,42554,13,12,42526,42511,40988,40986,39659
20323,310,1472,20323,0,18381,1942,1.58769e+18,217.447,3364.15,20323,234,192,18844,18623,16311,17061,7351
37446,36,62,0,37446,36930,516,2.48082e+16,45.0626,883.868,37446,41,42,37328,37225,36022,35981,29049
11637,278,393,3247,8390,0,11637,6.26724e+13,161.497,1166.9,11637,91,90,11244,11089,11106,11122,8994
21055,218,542,20991,64,21055,0,3.33273e+18,261.023,2273.94,21055,223,133,20098,18819,18145,17280,14936
18387,75,304,18387,0,18387,0,4.73056e+18,211.572,1620.33,18387,160,126,16948,15299,10852,10441,7422
45406,2,12,45002,404,45406,0,8.59256e+13,6.60838,426.358,45406,8,9,38557,36684,36538,36802,30247
24310,169,1023,22647,1663,0,24310,2.51134e+18,414.627,3042.24,24310,246,190,22390,21490,19376,19516,3824
46718,399,405,0,46718,12193,34525,3.27996e+15,295.926,2796.26,46718,245,147,46313,46313,46313,46313,46265
9048,246,810,8382,666,8382,666,1.27583e+18,251.256,1776.49,9048,253,95,8134,7917,7332,7714,3355
42387,959,1002,0,42387,9122,33265,4.71067e+15,389.72,3710.8,42387,292,217,41385,41379,41324,41344,40843
43138,1591,2387,38375,4763,38372,4766,1.20007e+18,315.068,5403.48,43138,443,279,40751,40747,40528,40713,23102
30955,5,13,30727,228,30955,0,9.93871e+13,10.8477,345.234,30955,12,11,30749,30605,29057,28882,23616
29071,46,61,0,29071,28877,194,2.60435e+16,35.3463,646.181,29071,35,32,29010,29008,28997,28996,28074
9794,3,61,0,9794,9751,43,2.17188e+16,10.9219,382.307,9794,19,27,8999,8646,7864,7449,5598
30805,18,34,0,30805,29319,1486,2.45987e+16,30.9778,579.229,30805,27,29,30660,30561,27594,29248,23238
49461,544,1483,44746,4715,44746,4715,2.45914e+18,617.671,5319.58,49461,532,203,47608,46892,43743,42648,23383
41335,272,426,41335,0,41335,0,3.96099e+18,275.362,2669.48,41335,183,165,40863,40658,36994,34958,27596
35538,219,1351,33122,2416,33122,2416,6.94589e+17,714.499,4261,35538,380,234,32045,30932,29174,28937,14076
12736,326,465,3308,9428,0,12736,2.95025e+13,164.757,1328.6,12736,86,114,12271,12239,11905,12070,10065
30001,288,567,6826,23175,0,30001,2.86915e+13,227.852,2621.2,30001,234,135,29434,28961,28537,28975,18854
29148,14,55,0,29148,28998,150,2.67954e+16,27.3494,602.292,29148,24,27,29008,28896,26488,27472,21058
6261,7,10,6216,45,6261,0,9.98044e+13,7.75164,154.769,6261,9,9,6238,6215,6075,6075,6228
32259,1684,1826,32259,0,28457,3802,2.05682e+18,313.81,3871.8,32259,383,280,30433,30433,30308,30405,29614
44688,7,11,42578,2110,44688,0,9.60302e+13,10.7963,472.33,44688,11,11,44385,44093,40203,40169,40223
15654,408,455,0,15654,3480,12174,7.23292e+15,206.051,1786.38,15654,189,99,15199,15199,15163,15192,14713
5383,246,399,4758,625,0,5383,3.64806e+18,125.903,1128.14,5383,137,96,4984,4944,4919,4871,4325
42445,471,745,42317,128,42445,0,3.09765e+18,401.085,3515.51,42445,257,162,41596,41429,39781,39305,34258
28034,29,815,0,28034,6100,21934,4.69617e+15,411.667,2895.8,28034,321,171,22803,19275,18414,16137,5028
45653,108,1306,0,45653,11264,34389,1.03858e+16,237.567,4542.44,45653,291,185,43226,42394,36496,35171,10723
2795,78,182,0,2795,798,1997,1.62942e+16,38.068,464.696,2795,52,47,2613,2604,2566,2571,1846
47141,546,698,10859,36282,0,47141,2.87884e+13,235.223,3480.37,47141,269,154,46443,46443,46172,46383,40615
9181,1,10,9127,54,9181,0,1.043e+14,7.90034,189.335,9181,9,9,4748,4748,4748,4748,4748
7403,414,914,7403,0,6882,521,9.71955e+17,182.884,1832.79,7403,193,138,6489,6317,5793,4886,4464
47666,473,1560,44559,3107,44559,3107,6.49049e+17,708.442,5171.49,47666,398,272,45243,43482,42724,42657,22851
15248,42,43,0,15248,15148,100,2.59253e+16,30.6874,407.172,15248,25,26,15205,15196,15198,15201,15158
19793,41,43,0,19793,19773,20,2.08314e+16,26.5663,486.671,19793,29,27,19750,19750,19666,19670,19682
30188,73,1714,27907,2281,27906,2282,1.30899e+18,307.383,4563.22,30188,512,151,26152,23985,19693,22923,4910
4731,271,317,1043,3688,0,4731,2.72547e+13,89.5842,907.215,4731,138,66,4414,4405,4379,4414,3922
34025,1653,1727,6509,27516,0,34025,2.58254e+13,296.07,4340.81,34025,477,185,32298,32298,32298,32294,31684
17911,173,964,16294,1617,16294,1617,2.31392e+18,345.895,2843.49,17911,377,154,15755,14246,14087,12811,5933
24261,58,1142,22626,1635,22626,1635,6.47657e+17,499.312,3278.41,24261,269,195,18920,15808,14431,15051,5837
40328,920,1667,40328,0,36316,4012,7.48665e+17,705.26,5184.62,40328,512,205,38539,37989,36670,33075,24543
26735,410,774,6556,20179,0,26735,2.46171e+13,214.228,2810.37,26735,294,132,25961,25908,25230,25328,21932
39677,858,994,39677,0,29904,9773,8.35778e+17,381.865,3294.94,39677,245,180,38683,38662,38609,38636,35968
47985,682,1938,0,47985,0,47985,1.21327e+18,657.453,5852.03,47985,406,280,45827,44907,43600,39340,19293
44648,1389,1390,44648,0,41723,2925,9.71807e+17,702.226,4684.8,44648,416,251,43258,43258,43258,43256,43253
23599,575,649,17771,5828,17771,5828,7.05318e+18,304.512,2148.88,23599,178,139,22950,22941,22901,22876,21975
22303,33,639,0,22303,0,22303,1.88904e+18,311.011,2668.5,22303,233,165,16442,14677,12820,2771,2637
9488,55,730,8857,631,0,9488,2.50111e+18,215.089,1698.87,9488,293,74,7760,7009,6568,6623,2311
38359,154,572,36763,1596,38359,0,4.06195e+18,280.561,3041.65,38359,259,141,36733,34744,27421,24574,12145
41965,1284,1627,9997,31968,0,41965,2.82841e+13,248.438,4358.76,41965,330,177,40338,40335,40275,40338,36796
13024,445,1113,12049,975,12049,975,2.34492e+18,221.631,2444.25,13024,338,108,11911,11708,11227,10516,6369
23427,394,586,20670,2757,23427,0,3.54341e+18,314.903,2412.73,23427,262,138,22816,22582,21125,20706,17872
2591,12,16,2545,46,2583,8,9.75549e+13,9.03242,111.662,2591,11,10,2575,2570,2549,2547,2486
1637,45,148,1636,1,1636,1,3.66377e+18,7.26756,305.756,1637,124,13,1489,1489,1411,742,673
48208,580,1205,10678,37530,0,48208,2.29002e+13,471.963,4479.41,48208,357,237,46905,46591,43822,41443,30278
13758,751,1148,12269,1489,12269,1489,3.31503e+18,144.423,2399.63,13758,345,106,12610,12588,11788,11212,7344
27536,131,635,7699,19837,0,27536,6.33478e+13,205.863,2199.08,27536,147,130,26540,26012,22686,15216,7915
47419,2374,2925,42811,4608,42808,4611,1.32424e+18,409.436,7135.49,47419,672,229,44494,44467,44223,43723,32864
29510,751,1192,26619,2891,0,29510,2.97613e+18,379.866,3827.72,29510,406,161,28318,28139,26864,26911,16721
12199,226,491,12196,3,12199,0,3.1649e+18,246.131,1700.85,12199,160,116,11513,10775,10310,9476,6322
33810,461,2440,33810,0,31336,2474,3.74599e+18,514.206,5306.35,33810,854,174,31040,30390,22424,23723,10812
2917,227,269,2207,710,0,2917,8.09288e+18,54.3678,583.844,2917,69,58,2648,2648,2648,2648,2431
21481,147,742,4747,16734,0,21481,1.88036e+13,356.418,2456.93,21481,292,145,20103,19754,18651,15681,9065
40489,262,2359,33790,6699,33696,6793,2.69747e+18,405.645,5685.44,40489,540,252,36867,35665,32926,35241,9897
16269,42,63,0,16269,16058,211,2.42584e+16,35.4075,607.589,16269,30,35,16202,16170,15648,15701,13390
35354,1,13,35116,238,35354,0,1.03406e+14,11.137,367.636,35354,12,11,19293,19293,19293,19293,19293
38504,951,1381,38504,0,35917,2587,9.53529e+17,658.783,4401.47,38504,376,229,37123,36507,35155,35181,33140
35639,236,1360,33264,2375,0,35639,2.45454e+18,505.456,4153.6,35639,349,235,33074,32179,30480,30557,7200
13282,37,1348,12404,878,12404,878,7.77038e+17,180.043,2931.33,13282,227,193,9537,7724,6816,7171,2197
12444,143,639,0,12444,3064,9380,6.75847e+15,145.031,1841.5,12444,286,94,11642,11180,9966,8356,5535
4482,3,5,0,4482,4482,0,9.29257e+15,4.97791,126.848,4482,5,5,4094,3902,3902,3974,2746
8594,141,379,8594,0,8594,0,2.88755e+18,228.355,1313.72,8594,144,96,7723,7077,6610,5436,5204
3760,155,515,3489,271,3489,271,2.24365e+18,115.022,1004.07,3760,109,94,3218,3089,2887,2929,2170
4066,7,11,3872,194,4066,0,9.66409e+13,7.92769,143.008,4066,10,9,4032,4008,3848,3838,3502
10210,119,387,0,10210,2873,7337,1.62329e+16,119.228,1077.67,10210,87,89,9775,9583,9157,9180,5121
32484,52,67,0,32484,32395,89,2.23201e+16,21.6426,742.938,32484,30,33,32417,32417,29821,30746,29631
49902,112,1420,46577,3325,46577,3325,2.05889e+18,733.286,4913.66,49902,436,259,43653,39276,37284,38172,12287
29591,603,1191,0,29591,0,29591,1.14392e+18,592.75,3571.34,29591,391,191,28119,27310,27043,25101,16978
30564,271,1380,27037,3527,27037,3527,1.53921e+18,374.205,4275.89,30564,382,165,27986,25536,23022,24455,7761
30249,547,568,8399,21850,0,30249,6.32077e+13,233.324,2032.59,30249,156,125,29681,29680,29668,29661,29553
43084,38,46,0,43084,42781,303,2.56962e+16,36.9353,713.557,43084,32,34,43018,42889,42743,42886,41655
45293,1342,2006,9408,35885,0,45293,2.66915e+13,264.108,5175.84,45293,515,253,43287,43287,40947,41996,31570
15554,29,427,15554,0,15554,0,5.1397e+18,262.365,1709.69,15554,164,119,12136,9770,7318,5973,2548
36729,208,1896,36729,0,30628,6101,8.66185e+17,310.236,5338.9,36729,412,232,34136,33228,28425,28548,8522
8686,141,603,8686,0,7621,1065,1.16086e+18,225.37,1684.36,8686,165,115,7703,6355,6427,4634,3013
16854,43,975,0,16854,4213,12641,5.7122e+15,63.7976,2266.2,16854,284,89,15609,14920,14447,5367,2733
5622,354,708,5251,371,5251,371,6.78725e+17,107.402,1410.1,5622,96,132,4914,4912,4713,4726,1670
39703,1223,2961,39703,0,35903,3800,2.94118e+18,326.809,6437.41,39703,602,232,36742,36582,29319,30025,22789
2790,147,192,0,2790,360,2430,1.11459e+14,11.8129,428.908,2790,98,12,2598,2598,2553,2575,2224
36324,6,13,35987,337,36239,85,9.8614e+13,8.29856,430.933,36324,11,10,36195,36074,35071,34933,29704
38893,681,827,29301,9592,0,38893,8.30787e+18,370.873,2906.12,38893,232,166,38066,38040,37866,37865,35731
42827,759,1216,38597,4230,38597,4230,2.4987e+18,500.86,4634.43,42827,412,197,41611,41205,40233,39781,28354
39481,1829,2007,0,39481,0,39481,1.85998e+18,317.76,4969.88,39481,337,218,37474,37474,37409,37081,36794
2565,26,323,538,2027,0,2565,2.00272e+13,65.7103,672.403,2565,103,86,1959,1694,1568,1149,443
41931,1306,1793,37515,4416,37515,4416,3.26132e+18,277.826,4543.45,41931,400,169,40138,40138,38836,38437,30624
38938,244,609,36194,2744,38938,0,3.96543e+18,323.392,3162.95,38938,278,157,37944,37092,30372,28646,18887
27611,588,1363,25813,1798,25813,1798,2.03634e+18,492.464,3844.34,27611,342,182,26167,25179,25362,24859,17788
3315,372,561,3315,0,3315,0,4.76211e+18,8.4721,807.17,3315,282,10,2754,2754,2754,2754,1851
5014,251,354,0,5014,722,4292,5.59065e+15,118.367,936.487,5014,146,48,4660,4588,4588,4601,3616
21692,1,13,21511,181,21692,0,9.45691e+13,11.5751,292.156,21692,12,11,12301,12301,12301,12301,12301
23902,53,63,0,23902,23730,172,2.58904e+16,43.1929,674.554,23902,36,37,23832,23795,23510,23505,23213
4561,3,8,4550,11,4561,0,1.18922e+14,5.55383,125.158,4561,8,7,4321,4197,3992,4180,3244
45551,291,699,0,45551,12637,32914,1.6196e+16,273.574,2596.69,45551,213,136,44802,44454,42359,42166,26077
38365,157,954,28891,9474,28891,9474,3.81443e+18,360.286,3163.43,38365,228,182,36130,35140,29176,29775,10373
40466,788,875,0,40466,0,40466,1.89651e+18,333.542,3909.57,40466,308,188,39591,39591,39500,39561,37594
22731,298,717,0,22731,0,22731,1.92643e+18,267.402,2225.13,22731,138,147,21997,21660,19700,10460,11648
42755,710,1360,39863,2892,39863,2892,6.42039e+17,709.213,4561.9,42755,375,247,41020,39377,39726,39447,27277
40385,1371,1581,0,40385,9849,30536,7.35796e+15,243.719,4124.73,40385,287,219,38804,38804,38727,38798,36532
19834,448,570,0,19834,4821,15013,6.10354e+15,205.196,2125.87,19834,305,100,19264,19263,19185,19107,13494
12851,565,952,12017,834,0,12851,2.38288e+18,252.518,2250.56,12851,208,129,11899,11663,11635,11537,10308
44320,66,92,0,44320,44007,313,2.46333e+16,50.0072,1123.22,44320,48,41,44228,44215,42969,41312,31471
48088,42,1040,36244,11844,36244,11844,3.79947e+18,393.696,3619.12,48088,256,202,39629,20204,26666,26794,3432
8290,290,400,8290,0,8290,0,3.44272e+18,206.831,1354.47,8290,147,101,7890,7773,7624,7291,7035
28182,46,1770,25506,2676,0,28182,3.47533e+18,274.641,4215.65,28182,327,165,23245,20192,19286,18865,2107
21745,364,689,0,21745,0,21745,1.85479e+18,328.345,2674.35,21745,253,170,21000,20460,19492,19306,11668
31261,134,612,26367,4894,31261,0,3.90969e+18,300.568,2766.31,31261,276,147,29369,26189,21850,19119,12365
18021,231,1018,16789,1232,16789,1232,2.07818e+18,454.528,2776.93,18021,252,179,16307,15858,15114,14781,8840
32404,58,98,0,32404,32250,154,2.35827e+16,36.1458,994.904,32404,44,35,32306,32279,31678,31086,26223
20583,643,1148,20583,0,19242,1341,9.44449e+17,544.918,3154.01,20583,296,189,19272,18413,17796,17373,15453
11149,623,638,1934,9215,0,11149,2.0352e+13,159.604,1766.25,11149,213,84,10511,10511,10511,10511,10476
34491,364,1822,34491,0,30861,3630,8.34477e+17,398.094,4980.83,34491,500,154,32193,29120,26887,17023,10786
5419,109,347,5241,178,5419,0,9.06631e+18,122.539,909.267,5419,160,22,5003,4819,2433,3141,2536
4201,1,7,4192,9,4201,0,8.25466e+13,6.89717,126.593,4201,7,7,2417,2417,2417,2417,2417
13635,299,503,0,13635,2937,10698,4.98862e+15,240.537,1637.27,13635,168,132,13037,12799,12606,12616,9286
43192,317,1440,0,43192,0,43192,1.22381e+18,604.397,4647.99,43192,385,231,40533,39271,38070,36467,22669
45595,552,1800,0,45595,8192,37403,5.49096e+15,553.705,5198.62,45595,508,183,43489,42706,42224,40171,17259
36635,38,43,0,36635,36431,204,1.82883e+16,23.0628,721.17,36635,27,23,36592,36587,36561,36578,35784
36785,26,49,0,36785,36662,123,2.61139e+16,29.9816,666.451,36785,25,26,36721,36700,36180,36059,27944
40223,249,1262,0,40223,9586,30637,8.46829e+15,257.096,4271.1,40223,280,179,38627,37855,34327,32886,17169
9776,69,275,9776,0,9776,0,3.79841e+18,189.461,1119.33,9776,96,103,8796,8224,5977,5263,3007
28576,149,918,28576,0,25082,3494,1.17143e+18,367.592,3485.79,28576,264,173,25913,21579,21696,16252,8971
32170,984,1920,29001,3169,29001,3169,1.4699e+18,364.551,4658.17,32170,460,177,30250,30183,29768,29766,22092
34337,14,1153,30709,3628,30709,3628,2.94723e+18,493.383,3823.3,34337,499,168,22528,18973,15812,15484,3461
47507,725,1288,0,47507,12719,34788,1.40473e+16,232.707,4179.47,47507,248,154,46219,46212,43400,43466,21271
29925,1531,1924,29925,0,27305,2620,9.65105e+17,368.573,4676.18,29925,640,116,28001,28001,27998,27976,26207
6674,457,806,6674,0,6104,570,1.08288e+18,133.044,1542.11,6674,277,84,5868,5854,5622,5860,4339
42196,1318,1871,42196,0,33198,8998,7.98607e+17,339.156,5256.33,42196,365,225,40325,40320,39716,39113,21195
6648,457,623,6183,465,0,6648,2.56304e+18,141.77,1368.39,6648,153,81,6025,6013,5994,5978,5751
40247,449,2173,36165,4082,0,40247,3.60004e+18,260.05,5307.29,40247,396,241,38074,37755,35512,35486,17442
40426,2,11,38501,1925,40426,0,9.60723e+13,10.9264,449.964,40426,11,11,29236,24695,25946,25509,19657
5484,340,411,0,5484,0,5484,4.13413e+18,75.7265,916.127,5484,96,94,5073,5070,5073,5071,4114
8899,648,653,8899,0,7901,998,1.14396e+18,340.937,1779.16,8899,202,120,8246,8246,8246,8246,8242
19922,8,12,19675,247,19922,0,9.86196e+13,9.4105,274.83,19922,10,10,19903,19899,19167,19166,16833
7401,235,494,1749,5652,0,7401,2.61323e+13,105.779,1291.33,7401,157,72,6907,6853,6252,6373,3886
35560,218,482,35560,0,35560,0,5.0248e+18,306.767,2584.73,35560,201,161,34641,33760,26901,25638,20835
41162,238,1171,41162,0,36249,4913,1.16435e+18,427.285,4481.98,41162,332,202,38544,37087,34124,27083,10553
48543,1009,3629,48529,14,0,48543,7.21366e+18,25.0525,6727.9,48543,459,29,44914,44914,42238,36714,17874
25567,6,10,25389,178,25567,0,9.98765e+13,9.06047,311.748,25567,10,10,25442,25323,24198,24188,22921
12048,208,412,0,12048,3352,8696,1.61069e+16,147.438,1194.87,12048,93,93,11634,11400,11335,11371,7041
8499,161,539,8499,0,7510,989,7.42048e+17,320.705,1587.01,8499,228,93,7072,6419,5479,4331,4263
13907,199,699,13907,0,12215,1692,1.16309e+18,324.814,2253.05,13907,199,135,12792,12278,11289,8796,5108
27777,10,12,26473,1304,27777,0,9.58726e+13,10.5116,373.66,27777,12,11,27759,27751,26990,26991,27745
33331,223,623,31901,1430,31851,1480,7.71942e+17,456.999,3087.72,33331,251,174,30735,27181,24336,27718,21970
45674,150,1898,9849,35825,0,45674,2.67397e+13,226.625,5050.63,45674,534,171,43052,41536,38170,17403,9117
14025,446,942,3344,10681,0,14025,2.8558e+13,134.406,2019.29,14025,317,86,13083,12921,12282,12483,9227
36087,516,2477,32829,3258,32828,3259,1.32417e+18,401.696,5902.23,36087,556,238,33322,32649,30825,31301,9395
10185,4,12,10063,122,10185,0,1.02917e+14,6.80746,194.157,10185,9,9,10005,9932,9490,9435,7898
5359,18,27,0,5359,5216,143,2.15138e+16,8.82758,209.12,5359,14,12,5332,5332,5315,5302,4648
3932,15,26,0,3932,3893,39,1.59803e+16,12.9629,186.273,3932,17,14,3902,3878,3858,3884,3098
41982,1132,1720,38779,3203,0,41982,2.78157e+18,543.899,5109.8,41982,426,215,40262,40232,39230,38979,28587
5954,50,429,4500,1454,0,5954,8.17884e+18,100.21,969.826,5954,92,78,5315,4561,3612,3866,979
23931,7,13,23745,186,23931,0,9.96826e+13,10.0871,302.24,23931,11,10,23902,23897,22767,22765,20907
27106,2263,2284,0,27106,0,27106,1.53134e+18,220.584,4654.12,27106,739,210,24822,24822,24822,24822,24696
46071,7,10,45732,339,46007,64,1.02641e+14,7.89514,400.838,46071,9,10,46039,46002,45354,45354,45219
26596,840,1177,26596,0,23843,2753,8.92886e+17,565.788,3382.27,26596,442,148,25419,24701,24888,25221,23106
38869,754,1583,34592,4277,0,38869,3.21e+18,366.068,4953.91,38869,443,188,37286,37070,33330,33738,17808
42693,92,860,0,42693,0,42693,4.1483e+18,378.923,3079.63,42693,252,172,39606,38527,26400,12847,9153
29288,36,707,22084,7204,0,29288,8.27039e+18,335.083,2425.43,29288,196,159,23812,13199,16139,15628,3906
37540,892,2296,30878,6662,30784,6756,2.87315e+18,376.091,5510.09,37540,416,248,35244,35207,32074,33858,17937
46074,416,2997,38628,7446,38628,7446,6.11646e+18,14.8891,5751,46074,1497,17,43077,43077,26883,12598,12599
18265,233,625,13745,4520,13745,4520,3.82612e+18,293.245,1974.82,18265,163,142,17328,16751,16711,16321,7375
32263,248,1454,29252,3011,0,32263,3.41897e+18,300.301,3982.64,32263,480,175,30393,29483,27469,27288,10569
24255,357,676,0,24255,6334,17921,7.51126e+15,195.426,1988.4,24255,115,132,23579,23513,21885,22050,16777
46705,31,64,0,46705,46458,247,2.05489e+16,23.6468,929.264,46705,28,33,46640,46623,45709,46159,32349
49710,1527,2873,0,49710,0,49710,1.73838e+18,432.217,7031.91,49710,620,284,46837,46659,45661,41932,29775
5869,24,29,0,5869,5834,35,2.68881e+16,21.5089,263.846,5869,24,23,5840,5837,5755,5750,5574
19187,872,952,17236,1951,0,19187,3.79739e+18,487.233,2438.34,19187,418,107,18235,17962,18093,18173,17606
11882,597,980,0,11882,0,11882,1.21716e+18,219.665,2209.57,11882,237,144,10902,10748,10619,10663,7904
6383,163,585,6071,312,6071,312,1.57147e+18,104.56,1145.18,6383,214,59,5798,5608,5669,5303,3088
4145,453,458,0,4145,857,3288,5.02466e+15,91.2801,1035.94,4145,123,70,3687,3687,3687,3687,3687
25606,542,997,4915,20691,0,25606,2.14812e+13,257.602,3057.53,25606,392,103,24609,24411,24199,18087,17011
5845,19,27,0,5845,5842,3,2.08345e+16,16.7591,237.828,5845,18,20,5818,5812,4981,5379,5184
27999,396,1036,27999,0,26144,1855,1.03789e+18,478.457,3345.81,27999,263,203,26448,25508,22893,23517,7490
2489,37,232,1881,608,0,2489,8.13231e+18,52.0213,515.83,2489,60,55,2071,1107,1420,1404,663
7661,18,58,0,7661,7538,123,2.35897e+16,20.3335,403.046,7661,28,24,7560,7474,7259,7123,4498
21816,23,388,21816,0,21816,0,3.78421e+18,236.008,1855.42,21816,130,151,16244,9949,8909,7763,2077
16873,185,407,3828,13045,0,16873,2.79977e+13,201.171,1797.9,16873,182,102,16323,16064,15013,15318,9190
48365,244,716,11048,37317,0,48365,2.86623e+13,240.851,3534.29,48365,277,147,47516,46675,44485,45158,20795
33486,1665,1753,0,33486,7313,26173,6.58671e+15,199.054,4292.52,33486,398,180,31733,31733,31733,31733,31199
5593,559,611,5111,482,5111,482,2.70425e+18,47.9258,1096.48,5593,221,67,4982,4982,4954,4982,4600
24204,1140,1693,21519,2685,21519,2685,3.04327e+18,249.998,3984.62,24204,337,200,22511,22501,22511,22511,18282
19904,5,11,19028,876,19904,0,9.57961e+13,10.168,314.37,19904,11,11,19246,19160,17570,17417,13308
9657,923,978,8944,713,8944,713,1.28355e+18,246.787,2077.98,9657,352,115,8679,8679,8679,8679,8409
38012,2372,2430,38012,0,32430,5582,9.84976e+17,486.21,5714.77,38012,469,288,35582,35582,35575,35538,35412
17118,10,13,17002,116,17118,0,9.98269e+13,10.3089,260.136,17118,11,10,17101,17096,16434,16432,13935
1997,13,179,468,1529,0,1997,1.64899e+13,71.8508,439.953,1997,68,43,1370,1191,1032,585,376
32620,1115,3621,0,32620,4376,28244,9.52054e+15,11.1956,5095.39,32620,961,22,28999,28999,19826,20197,11879
28347,1463,2235,28347,0,26249,2098,4.12324e+18,443.097,4616.45,28347,799,154,26112,25939,24684,25113,19879
9409,304,492,8420,989,8420,989,3.25566e+18,201.528,1332.9,9409,97,111,8917,8843,8422,8366,5846
25547,830,1178,25547,0,23843,1704,1.02282e+18,542.67,3386.66,25547,356,191,24350,23622,22801,22792,19008
6104,115,559,0,6104,0,6104,1.26921e+18,129.047,1246.67,6104,155,80,5354,4933,4808,4781,2283
21605,1767,1918,19600,2005,19600,2005,1.15955e+18,262.886,4127.59,21605,390,238,19687,19687,19687,19644,19158
18983,875,1952,14838,4145,14744,4239,3.48102e+18,188.717,3775.23,18983,297,213,17031,17011,16522,16864,12998
43080,1591,1854,0,43080,9792,33288,7.10691e+15,207.878,4775.7,43080,473,150,41226,41226,40202,40294,35364
20479,494,1100,0,20479,0,20479,1.21245e+18,419.988,2986.1,20479,279,160,19159,18685,18292,15640,14750
18681,443,1265,4653,14028,0,18681,3.96206e+13,338.396,2933.66,18681,283,145,17259,16461,14747,16195,4541
26463,3,6,26441,22,26463,0,5.36083e+13,5.99331,322.727,26463,6,6,23940,23311,22681,23310,21420
12526,274,307,12526,0,12526,0,3.44099e+18,208.22,1235.69,12526,98,139,12200,12068,12135,12140,11356
46008,1,14,45320,688,44188,1820,8.29108e+13,6.61489,427.598,46008,9,10,26956,26956,26956,26956,26956
4869,214,447,4298,571,0,4869,4.2864e+18,70.0253,874.13,4869,67,78,4422,4387,4184,4147,2672
31975,156,1240,0,31975,0,31975,1.46596e+18,390.253,4029.13,31975,408,175,27855,25067,24740,8615,7096
30145,531,788,26561,3584,0,30145,3.83248e+18,343.171,3286.3,30145,281,185,29357,29350,28786,28875,21637
30158,903,1428,30158,0,26610,3548,2.15748e+18,333.441,3354.37,30158,172,284,28730,28711,26213,27529,20144
5443,2,8,5346,97,5443,0,1.09632e+14,5.57432,137.037,5443,6,7,4959,4826,4265,4724,3338
13918,134,417,3867,10051,0,13918,6.3444e+13,155.175,1278.43,13918,108,81,13372,13130,12482,12172,6413
37769,387,691,0,37769,10552,27217,1.61103e+16,236.552,2377.38,37769,157,135,37078,36970,36172,36288,24649
21115,345,417,21115,0,21115,0,5.0112e+18,239.903,1921.12,21115,159,138,20698,20543,20413,20171,19414
39019,461,748,38891,128,39019,0,3.1413e+18,479.556,3376.51,39019,254,157,38086,37889,36044,35343,27080
7807,593,773,6684,1123,0,7807,4.2666e+18,126.201,1578.97,7807,180,95,7034,7033,6942,7003,6613
2670,1,24,0,2670,2652,18,2.65021e+16,18.5423,169.597,2670,19,19,1015,1015,1015,1015,1015
23147,480,577,15710,7437,23147,0,4.36072e+18,297.167,2308.99,23147,292,108,22570,22549,22419,22368,21015
30611,968,1758,7039,23572,0,30611,3.07661e+13,201.045,3729.17,30611,392,230,28853,28851,25943,26655,15240
46474,1222,1482,41922,4552,0,46474,2.97636e+18,630.001,5202.44,46474,530,196,44992,44992,44850,44886,39036
8823,81,830,8246,577,8246,577,2.03954e+18,252.854,1842.5,8823,166,136,7238,6291,6183,6354,1554
10163,8,10,10112,51,10163,0,1.05522e+14,8.43147,199.171,10163,9,9,10151,10150,10118,10117,10145
13193,512,980,12302,891,0,13193,2.45698e+18,252.163,2300.04,13193,201,136,12213,11940,11814,11813,9884
29213,1265,2011,26333,2880,0,29213,3.6032e+18,229.378,4663.1,29213,486,147,27202,27202,25682,25271,19095
3365,101,355,3365,0,3365,0,4.32939e+18,135.598,858.737,3365,118,66,2882,2574,2168,1629,1369
44631,542,1213,39273,5358,39273,5358,1.7192e+18,410.602,4698.22,44631,333,214,43418,42974,40767,40644,23667
43235,349,1308,40309,2926,40309,2926,2.07935e+18,717.276,4506.86,43235,405,231,40420,39207,37713,36914,9689
22699,2,10,22613,86,22635,64,1.0229e+14,7.70959,280.36,22699,9,10,20245,19912,17461,19183,14343
43612,522,1324,0,43612,0,43612,1.18646e+18,681.85,4513.3,43612,405,238,41430,39760,39423,35849,16248
2692,406,479,0,2692,0,2692,1.08956e+18,68.2571,865.663,2692,79,93,2213,2213,2208,2205,1967
5497,116,454,5366,131,5497,0,3.2808e+18,170.922,905.783,5497,267,25,4853,4722,3937,3869,1752
7613,18,29,0,7613,7466,147,1.91763e+16,17.9144,273.475,7613,17,18,7579,7574,7537,7391,6122
45287,505,2080,9382,35905,0,45287,2.61455e+13,359.368,5467.56,45287,599,207,43043,42673,39198,22733,12187
18982,2962,3025,18982,0,0,18982,8.21593e+18,12.2576,4403.59,18982,615,17,15957,15957,15872,15898,15751
2914,12,463,0,2914,0,2914,1.12045e+18,148.306,898.089,2914,117,73,1762,1447,1205,619,165
30000,212,1602,30000,0,26367,3633,2.14565e+18,327.928,3472.95,30000,299,274,27836,27154,23083,21484,1983
5299,154,676,4936,363,0,5299,2.45902e+18,105.184,1381.86,5299,118,125,4623,4382,4060,4050,1425
38458,202,1886,35270,3188,35270,3188,2.57734e+18,359.855,4985.08,38458,394,188,35704,33991,31947,29916,6857
44353,2045,2337,0,44353,0,44353,2.84219e+18,455.912,5771.89,44353,593,242,42016,42016,42016,42016,40383
33023,577,783,0,33023,7632,25391,7.35709e+15,230.232,2985.85,33023,242,132,32240,32234,32193,32152,32012
9870,100,621,8670,1200,8670,1200,1.74673e+18,243.063,1800.87,9870,178,123,8252,6735,6411,7083,2270
34764,30,34,33509,1255,34756,8,9.9558e+13,9.96545,479.144,34764,20,18,34730,34728,34708,34706,34677
24307,13,62,0,24307,24149,158,2.67722e+16,44.4289,677.3,24307,34,36,23768,23283,22154,21662,15135
4584,429,450,4303,281,4303,281,1.90512e+18,114.433,991.956,4584,102,94,4134,4134,4134,4134,4095
21242,943,1386,21242,0,21242,0,1.65628e+17,14.8833,2731.34,21242,694,15,19856,19856,19856,19856,14838
8994,124,603,8994,0,7945,1049,2.26574e+18,171.612,1319.38,8994,92,128,8273,8057,6873,7741,2303
40889,1145,1289,0,40889,10940,29949,1.40704e+16,213.118,3951.82,40889,239,150,39600,39600,39469,39502,36332
9629,363,730,8981,648,0,9629,2.52571e+18,251.799,1720.44,9629,298,88,8899,8610,8556,8559,6086
26568,9,12,26256,312,26568,0,9.79358e+13,10.117,316.211,26568,11,11,26548,26537,25729,25728,23836
29619,324,1692,27379,2240,27379,2240,2.37894e+18,364.392,4558.95,29619,484,133,27472,26754,25534,23694,6092
6605,207,789,6191,414,0,6605,2.33643e+18,103.019,1600.83,6605,136,136,5816,5774,5564,5578,2538
35454,1048,1090,35454,0,31256,4198,1.15999e+18,422.755,4077.87,35454,305,190,34364,34364,34363,34357,34145
24747,627,718,18625,6122,18625,6122,3.8267e+18,336.352,2369.5,24747,185,155,24029,24022,24002,23999,23084
37770,616,626,36051,1719,36051,1719,1.43986e+18,491.46,3267.7,37770,272,192,37144,37144,37144,37144,37125
14402,607,845,12763,1639,0,14402,3.90396e+18,207.269,1968.73,14402,135,126,13557,13557,13539,13551,13266
23324,78,662,0,23324,0,23324,4.14756e+18,316.623,2143.8,23324,171,142,21586,20795,14402,8243,5331
14186,654,1330,13387,799,0,14186,2.15393e+18,153.388,2540.28,14186,357,84,12856,12774,12552,12356,9419
11596,244,390,2633,8963,0,11596,2.81627e+13,175.034,1478.52,11596,173,90,11192,11054,10844,10844,7735
9747,410,1023,9062,685,0,9747,2.6089e+18,115.276,2156.36,9747,194,90,8724,8717,8509,8547,5838
10022,261,549,2495,7527,0,10022,3.26054e+13,123.979,1178.1,10022,74,129,9473,9335,8807,8934,6411
1806,53,345,1643,163,1643,163,2.57398e+18,84.8942,604.99,1806,113,63,1401,1088,1208,1093,513
41723,1080,1361,41723,0,38896,2827,1.0036e+18,758.009,4570,41723,411,237,40362,40295,38927,39311,37496
1445,170,209,0,1445,306,1139,6.35931e+15,32.7315,440.031,1445,80,35,1236,1236,1221,1229,1108
34890,3,32,0,34890,33272,1618,2.46059e+16,28.7893,604.065,34890,28,27,29717,28215,22194,22999,14827
6949,6,16,0,6949,6943,6,1.37189e+16,9.91466,223.555,6949,12,10,6187,5458,5027,5983,4705
25737,595,2158,25737,0,20220,5517,1.0423e+18,240.395,4424.13,25737,293,273,23579,23368,22512,21235,16388
34531,845,925,0,34531,7450,27081,4.66601e+15,333.485,3310.27,34531,248,202,33606,33601,33524,33544,32435
16208,1222,1275,0,16208,0,16208,1.83687e+18,174.838,2684.75,16208,459,116,14933,14933,14916,14926,14584
23363,1,15,22428,935,23363,0,9.48899e+13,10.0748,345.43,23363,12,12,9737,9737,9737,9737,9737
33768,1477,1987,33768,0,25877,7891,9.29948e+17,291.533,4487.81,33768,267,275,31781,31781,31347,29845,29463
16660,422,429,16660,0,16660,0,3.22831e+18,232.382,1644.63,16660,143,113,16231,16231,16223,16228,16181
26006,439,968,22797,3209,0,26006,3.49057e+18,318.988,3447.63,26006,351,170,25038,24808,22604,22570,15649
5009,56,292,1387,3622,0,5009,6.2545e+13,63.5929,713.819,5009,61,60,4683,4610,4143,3764,1765
9599,28,33,0,9599,9550,49,2.49601e+16,12.9682,328.869,9599,17,18,9566,9566,9492,9566,9150
14534,150,676,0,14534,0,14534,2.14991e+18,234.962,1656.09,14534,92,181,13608,13332,11717,8300,4273
27457,12,62,0,27457,27261,196,2.50891e+16,46.1101,725.974,27457,37,38,26671,25785,24738,24363,16164
9429,381,509,8444,985,8444,985,8.96581e+17,213.963,1373.05,9429,105,120,8920,8897,8859,8879,7619
46524,365,687,12918,33606,0,46524,6.32798e+13,272.949,2612.09,46524,212,144,45837,45636,44458,44513,32349
17532,533,598,13203,4329,0,17532,8.32716e+18,264.824,1817.75,17532,156,130,16934,16931,16873,16894,16172
1204,90,131,279,925,0,1204,1.87014e+13,53.7517,311.352,1204,52,36,1073,1056,1046,1048,889
24552,255,511,0,24552,5593,18959,7.33571e+15,214.694,2292.05,24552,211,124,24022,23626,22990,23310,14854
43855,8,10,43670,185,43791,64,1.07969e+14,7.61088,391.116,43855,9,10,43844,43842,43801,43801,41216
21943,235,1430,21943,0,21943,0,3.30596e+17,14.8842,2814.59,21943,716,15,20513,20513,13519,17491,6835
21225,1068,1798,0,21225,0,21225,1.62086e+18,229.905,3903.76,21225,362,194,19427,19427,19286,18239,13444
46470,1176,1848,0,46470,0,46470,1.21472e+18,722.844,5525.48,46470,475,264,44622,44351,43520,41880,32934
24635,512,2160,22631,2004,22631,2004,1.26661e+18,354.322,4556.84,24635,512,199,22451,21537,20323,20622,3664
1243,191,309,1130,113,0,1243,3.28263e+18,32.1215,493.05,1243,67,40,934,916,911,897,769
16222,1065,1084,15111,1111,15111,1111,2.08618e+18,374.094,2679.76,16222,266,146,15138,15138,15138,15138,15075
28921,27,64,0,28921,28721,200,2.5613e+16,48.9774,754.173,28921,37,38,28763,28721,27673,27576,23745
14604,484,1007,0,14604,0,14604,1.23161e+18,419.223,2530.06,14604,255,159,13456,13035,12781,11223,9093
48875,366,1168,11722,37153,0,48875,2.56004e+13,438.347,4265.38,48875,596,138,47099,45854,43749,39497,26909
25461,568,711,22392,3069,22392,3069,3.23848e+18,320.494,2934.43,25461,250,161,24750,24750,24544,24330,20533
19239,69,1036,17981,1258,17981,1258,1.9935e+18,433.575,2834.46,19239,244,182,15815,13238,12940,13522,2687
9563,3,11,9133,430,9563,0,9.57487e+13,8.39726,216.813,9563,10,10,8567,8289,6821,6618,6033
31489,796,858,23752,7737,23752,7737,6.98629e+18,317.908,2669.56,31489,205,164,30631,30630,30594,30579,30027
37922,924,1271,35341,2581,35341,2581,2.07997e+18,663.977,4202.25,37922,375,230,36651,36288,35703,35553,32074
40096,97,680,11185,28911,0,40096,6.2694e+13,261.742,2424.55,40096,167,147,38503,37687,32431,28187,12034
23473,913,1012,5289,18184,0,23473,2.15247e+13,286.067,3025.07,23473,263,164,22461,22461,22411,22413,21455
17749,207,395,17749,0,17749,0,5.1274e+18,196.403,1695.97,17749,157,121,17279,17001,14862,14718,12731
21231,372,1824,0,21231,4711,16520,1.62651e+15,253.685,3334.54,21231,304,101,19294,18640,14700,6682,5182
28790,394,968,0,28790,6326,22464,4.95573e+15,392.325,3074.31,28790,314,162,27624,26993,26417,25834,18478
17474,561,611,13154,4320,13154,4320,3.81441e+18,283.953,1902.66,17474,161,138,16863,16856,16850,16850,16462
11800,3,11,11257,543,11800,0,9.56783e+13,9.06136,241.44,11800,11,10,10598,10266,8419,8122,7347
31865,802,1017,28049,3816,28049,3816,1.72079e+18,390.146,3787.19,31865,292,185,30848,30848,30612,30642,26997
15349,460,968,0,15349,0,15349,1.18683e+18,416.192,2528.38,15349,243,175,14191,13771,13552,13360,6580
24780,593,1655,24780,0,22202,2578,7.94346e+17,315.995,3995.85,24780,351,170,23125,23077,20187,18428,7986
19117,1,9,19071,46,11291,7826,6.2915e+13,8.47868,307.919,19117,8,9,10000,10000,10000,10000,10000
15482,998,1044,0,15482,0,15482,1.18202e+18,467.026,2610.24,15482,319,177,14438,14438,14423,14424,14309
11213,600,644,0,11213,2485,8728,4.47916e+15,173.208,1702.35,11213,216,123,10569,10560,10561,10559,10189
13682,827,2454,0,13682,0,13682,7.71622e+17,14.0403,2880.79,13682,347,26,11228,11228,9175,9409,4246
38180,1717,1993,29107,9073,29013,9167,3.72214e+18,326.575,4667.31,38180,330,237,36187,36187,36187,36187,34800
49152,38,68,0,49152,48830,322,2.52009e+16,53.6644,1007.87,49152,43,44,48990,48869,47132,47160,37430
1831,6,193,1619,212,1619,212,3.60533e+18,45.4227,406.574,1831,50,48,701,261,311,449,90
34827,441,633,31428,3399,34827,0,3.73691e+18,319.832,3047.15,34827,252,177,34194,33993,32987,32157,29530
19427,612,652,19427,0,14627,4800,8.86401e+17,289.278,2036.01,19427,172,143,18775,18774,18736,18434,18456
36152,708,824,27275,8877,0,36152,8.23971e+18,348.512,2805.78,36152,211,165,35328,35319,35226,35211,33486
27872,446,901,6660,21212,0,27872,2.95444e+13,192.964,2846.63,27872,222,126,26971,26967,26404,26847,24079
25274,1558,1895,0,25274,173,25101,1.29902e+14,15.5046,3574.27,25274,347,20,23379,23379,23045,20623,19964
34914,2046,2127,32378,2536,0,34914,2.72483e+18,425.097,5249.61,34914,643,138,32787,32787,32787,32787,32280
24520,849,1141,22924,1596,0,24520,2.37392e+18,453.819,3256.59,24520,331,186,23379,23139,22977,22949,18654
5046,35,542,5046,0,4477,569,7.0005e+17,284.999,1245.35,5046,192,88,3612,2685,2272,622,748
12302,938,2357,12009,293,12009,293,3.59712e+18,13.9579,2679.74,12302,305,22,9945,9945,8527,4122,4495
29024,705,1790,26976,2048,26976,2048,2.22468e+18,438.777,4128.8,29024,694,115,27234,26561,26436,26382,14114
27551,912,1584,27551,0,24835,2716,7.65509e+17,385.482,4163.7,27551,431,156,25967,25810,24545,22270,17006
23333,1425,1453,20450,2883,0,23333,4.50131e+18,261.999,2925.91,23333,331,246,21880,21880,21863,21872,21682
38186,782,1393,35639,2547,35639,2547,2.04406e+18,664.514,4338.91,38186,434,231,36723,35291,35186,34821,24275
21087,456,1547,21087,0,19067,2020,7.79226e+17,360.123,3689.28,21087,427,140,19540,18427,17225,13762,8649
48318,1405,2664,0,48318,0,48318,1.6476e+18,443.2,6881.31,48318,789,246,45654,45343,45171,44988,32764
38618,3,13,38365,253,38618,0,1.01612e+14,11.1868,385.631,38618,12,12,37190,36474,34922,35601,23578
41118,1197,3114,0,41118,9130,31988,1.56023e+15,283.273,5682.47,41118,394,119,38004,38004,32621,19660,17694
36740,700,1223,32604,4136,32604,4136,9.08089e+17,339.175,3412.64,36740,154,271,35517,35441,35230,35324,25750
2065,236,252,541,1524,0,2065,2.31726e+13,83.7153,545.795,2065,96,52,1813,1781,1813,1813,1784
5996,14,33,0,5996,5988,8,2.11871e+16,24.3366,260.734,5996,23,24,5888,5731,5166,5477,4858
34439,1083,1619,31082,3357,0,34439,3.14344e+18,484.666,4451.41,34439,458,178,32820,32668,32342,32429,27748
46655,750,1164,11136,35519,0,46655,2.51592e+13,418.288,4174.5,46655,593,142,45491,45349,44930,44434,38944
29145,272,605,27830,1315,27830,1315,1.42933e+18,442.316,2847.16,29145,252,168,27689,25005,24307,25262,22267
7543,137,586,6681,862,6681,862,1.64533e+18,257.836,1556.84,7543,168,120,6556,5590,5354,5652,2176
44394,1787,1941,40562,3832,40562,3832,2.67031e+18,422.472,5461.43,44394,389,214,42453,42453,42370,42366,41177
4445,302,423,3926,519,3926,519,9.23943e+17,73.0963,839.457,4445,76,86,4022,4011,3985,3976,3309
21473,1313,1557,21473,0,19129,2344,1.46342e+18,223.942,3334.66,21473,416,130,19916,19916,19534,19700,16859
37122,9,10,36853,269,37122,0,1.00437e+14,9.65182,376.728,37122,10,10,37104,37096,36923,36923,37101
5894,202,531,1283,4611,0,5894,1.7528e+13,104.597,1250.58,5894,157,104,5363,5277,5157,5031,2566
39361,1773,2119,35358,4003,0,39361,3.60555e+18,255.288,5197,39361,405,230,37242,37242,37242,37242,34125
9101,212,303,9101,0,9101,0,3.49802e+18,183.722,1058.65,9101,88,124,8762,8631,8197,8204,6570
38196,147,196,38180,16,38196,0,3.7503e+18,179.585,1604.87,38196,159,80,37626,36662,35487,35285,29751
9284,251,347,2578,6706,0,9284,6.28814e+13,120.498,1003.37,9284,85,76,8937,8842,8850,8860,7278
38308,1554,1831,38308,0,34746,3562,7.79943e+17,744.516,5152.18,38308,571,172,36477,36477,36415,36458,34165
24105,1043,1589,21723,2382,21723,2382,3.05609e+18,206.501,3593.25,24105,254,167,22516,22495,22381,22244,18407
48551,312,1269,42663,5888,0,48551,3.77579e+18,351.636,4916.09,48551,405,223,46757,44896,38202,39322,11250
27528,319,511,27528,0,27528,0,3.26644e+18,275.93,2164.65,27528,166,134,27001,26639,24676,24003,20028
4594,407,484,4368,226,0,4594,1.91232e+18,113.439,923.41,4594,159,64,4110,4110,4110,4110,3859
31025,158,572,31025,0,31025,0,3.52222e+18,293.431,2879.67,31025,198,178,29490,28474,23578,18534,10328
34622,1491,1667,27247,7375,0,34622,7.19657e+18,278.09,4446.34,34622,262,196,32955,32952,32824,32799,29898
44838,79,362,44832,6,44838,0,3.24052e+18,301.668,2887.86,44838,211,176,38558,33746,30177,25489,13006
24495,11,14,24362,133,24495,0,9.44917e+13,9.7081,315.246,24495,11,10,24478,24472,23909,23908,23931
24551,479,716,18485,6066,18485,6066,7.03828e+18,316.476,2246.77,24551,185,147,23835,23722,23488,23381,19376
37983,697,1930,0,37983,7487,30496,6.52915e+15,364.354,4930.29,37983,586,192,36053,35875,33803,33108,15694
4109,59,436,750,3359,0,4109,2.00764e+13,61.3945,921.442,4109,145,59,3633,3388,3341,1575,1123
19172,39,1546,0,19172,0,19172,1.60966e+18,193.999,3447.26,19172,361,171,15836,13690,11857,6785,1944
28299,700,841,0,28299,6282,22017,5.40079e+15,323.005,2998.12,28299,311,119,27458,27353,27326,27278,20825
49373,3,18,47805,1568,49373,0,9.61363e+13,10.8374,498.878,49373,16,12,45636,44445,39201,38986,28119
25723,810,1540,0,25723,0,25723,1.24996e+18,361.378,3967.3,25723,309,220,24183,23973,23388,23052,14507
33245,5,12,32752,493,33245,0,9.69183e+13,10.3883,352.559,33245,12,11,32981,32798,31428,31271,26586
1663,147,168,456,1207,0,1663,5.90716e+13,30.095,370.14,1663,42,54,1495,1495,1494,1491,1399
17834,6,13,17706,128,17834,0,1.00286e+14,9.53157,263.038,17834,11,9,17783,17753,16908,16826,15988
2661,76,588,2661,0,2469,192,8.92342e+17,63.3694,977.408,2661,85,115,1999,1769,1477,925,347
8196,401,735,0,8196,0,8196,2.01461e+18,275.136,1467.17,8196,223,76,7461,7179,6871,7190,6398
42454,665,1462,42454,0,39588,2866,9.64618e+17,739.715,4742.03,42454,434,243,40465,38403,34767,31314,24193
3000,60,181,840,2160,0,3000,6.46476e+13,37.9933,458.741,3000,46,46,2819,2794,2659,2631,1122
41177,7,14,41016,161,41177,0,8.78805e+13,8.30714,410.006,41177,11,10,41149,41144,40398,40390,39146
39100,571,678,38206,894,39100,0,3.32789e+18,353.836,3342.68,39100,248,173,38422,38389,37615,37148,35475
1499,140,338,1339,160,1339,160,3.37206e+18,14.8672,502.9,1499,66,33,1161,1152,1057,800,658
22019,6,11,21012,1007,22019,0,9.61054e+13,10.4816,331.085,22019,11,11,21755,21565,19766,19256,19398
15575,45,84,0,15575,15520,55,2.08008e+16,22.5613,635.227,15575,34,26,15491,15484,15473,15454,13775
4887,405,715,4560,327,4560,327,2.07075e+18,147.149,1376.98,4887,132,109,4172,4061,4046,4030,3327
25873,285,445,25873,0,25873,0,3.50946e+18,245.328,2295.26,25873,242,153,25394,25105,23035,22919,19747
28868,1534,1783,25728,3140,25728,3140,3.22926e+18,238.38,4025.41,28868,241,203,27085,27085,27085,27085,26146
28339,1418,1626,25355,2984,0,28339,3.67938e+18,312.92,4328.24,28339,332,169,26713,26709,26570,26573,24568
30661,276,1199,28612,2049,28612,2049,6.67503e+17,602.818,3777.66,30661,315,215,28180,27390,26365,26306,14636
27512,5,59,0,27512,27489,23,1.94864e+15,43.0297,702.687,27512,49,21,27201,27148,26943,26475,15710
18660,655,822,17394,1266,17394,1266,2.1128e+18,389.687,2403.71,18660,221,153,17838,17413,17652,17649,16093
17710,318,365,0,17710,4621,13089,3.17241e+15,220.624,1707.95,17710,191,107,17345,17312,17150,17179,16634
24966,341,1046,4542,20424,0,24966,2.14913e+13,268.479,3211.16,24966,343,108,23784,23378,22736,19248,10522
15882,633,693,3451,12431,0,15882,1.92655e+13,302.123,2104.02,15882,215,155,15189,15189,15136,15142,14760
27388,1,14,27045,343,24644,2744,7.47882e+13,6.7014,327.855,27388,10,8,17181,17181,17181,17181,17181
20955,6,9,20879,76,20891,64,1.01092e+14,6.24667,266.703,20955,8,8,20929,20905,20027,20028,14868
33518,552,819,33518,0,25242,8276,8.13556e+17,385.084,2875.29,33518,233,175,32699,32580,31545,28920,25898
7746,282,396,7746,0,7746,0,3.44258e+18,224.467,1315.85,7746,145,103,7344,7206,7087,6833,6463
48788,104,1972,0,48788,11910,36878,7.96628e+15,303.132,4582.73,48788,394,287,45647,44333,38870,38808,9652
35468,14,1363,33101,2367,33101,2367,6.55671e+17,503.686,4191.6,35468,274,245,21108,17055,12883,13858,3861
15358,11,13,15237,121,15358,0,9.80527e+13,10.1532,244.429,15358,11,9,15343,15339,14876,14875,15238
25694,343,716,0,25694,0,25694,4.1401e+18,313.295,2297.95,25694,195,141,24903,23896,23973,19239,16420
22982,487,739,5014,17968,0,22982,1.84697e+13,401.608,2556.59,22982,272,156,22166,21701,21536,20836,17163
18546,148,428,18546,0,18546,0,5.06537e+18,255.365,1837.03,18546,151,120,17773,17140,13713,12564,10055
33769,62,1455,6139,27630,0,33769,2.15479e+13,296.251,4037.87,33769,470,114,30794,29098,27734,16858,5244
10562,188,659,2347,8215,0,10562,1.96411e+13,149.897,1682.85,10562,169,122,9811,9695,9312,7858,5246
24049,585,1093,0,24049,0,24049,1.16209e+18,533.599,3198.5,24049,307,186,22712,21955,21907,20208,17453
46138,378,2478,41956,4182,41952,4186,1.26357e+18,343.627,6419.9,46138,732,205,43191,42438,40006,38946,9169
15273,1,8,15233,40,15273,0,1.1736e+14,7.50678,229.365,15273,8,8,7580,7580,7580,7580,7580
36488,538,1118,32171,4317,32171,4317,1.70395e+18,407.955,4154.21,36488,319,195,35370,34590,33145,33127,19416
11567,296,382,11567,0,11567,0,5.00872e+18,170.845,1386.82,11567,129,107,11185,11125,10961,10711,10583
12183,1,10,12174,9,12183,0,6.61702e+13,9.97472,307.831,12183,10,10,4662,4662,4662,4662,4662
23680,847,1295,21488,2192,0,23680,3.38944e+18,305.34,3329.08,23680,470,148,22385,22371,21614,21587,17019
39333,366,2453,36140,3193,0,39333,2.88135e+18,430.704,6050.94,39333,578,233,36382,35315,34353,33551,7589
13879,471,563,12206,1673,0,13879,3.88818e+18,261.096,2010.76,13879,208,141,13316,13299,13225,13242,11867
3283,101,258,3054,229,3054,229,2.17113e+18,114.452,680.331,3283,82,66,2900,2509,2683,2642,1590
34212,786,1205,32049,2163,0,34212,2.30457e+18,634.839,3906.58,34212,416,206,32913,31774,31977,31797,25537
20671,615,1463,0,20671,0,20671,2.09523e+18,207.96,3007.56,20671,335,197,19208,19123,16743,17298,6447
18996,238,620,18932,64,18996,0,3.13473e+18,278.38,2252.22,18996,223,120,18173,17442,15996,14980,9213
12643,295,671,11714,929,11714,929,2.3011e+18,155.377,1813.27,12643,231,96,11972,11879,11515,10872,7134
41415,1161,1843,37496,3919,37496,3919,1.35847e+18,757.139,5379.74,41415,568,178,39572,38915,38360,38529,25591
5930,159,412,4472,1458,0,5930,8.22736e+18,93.1845,946.375,5930,82,80,5518,5474,5270,5238,3189
41705,50,1315,38890,2815,38890,2815,2.08099e+18,662.725,4400.86,41705,381,236,32429,26467,25921,25016,5048
22853,470,2038,16804,6049,16804,6049,5.492e+18,21.9687,2664.4,22853,688,682,20815,20815,9877,6246,18736
7138,113,468,1232,5906,0,7138,1.84776e+13,154.355,1171.76,7138,178,76,6579,6424,6331,5583,2053
10502,5,13,10431,71,10502,0,1.01553e+14,7.34222,201.621,10502,9,9,10434,10390,9872,9813,8256
12833,319,363,0,12833,3285,9548,3.20135e+15,194.419,1462.71,12833,169,93,12470,12469,12376,12350,12251
37224,159,520,37224,0,37224,0,3.2432e+18,293.162,2506.64,37224,195,143,35880,34999,27921,26982,14583
7631,52,363,1799,5832,0,7631,1.81097e+13,107.05,998.271,7631,137,71,6724,5901,6104,6173,2462
42647,228,972,9446,33201,0,42647,2.22954e+13,428.935,3852.24,42647,449,147,41007,38798,38106,32823,15407
22074,1628,1718,19734,2340,19734,2340,3.09069e+18,197.135,3678.15,22074,275,208,20356,20356,20356,20356,20102
45855,1099,1316,12201,33654,0,45855,5.32517e+13,218.074,4197.94,45855,251,151,44539,44537,44199,44264,37163
16076,13,45,0,16076,15944,132,2.50561e+16,37.3889,442.821,16076,27,29,15887,15680,15114,15003,11343
23409,201,502,0,23409,6491,16918,1.62041e+16,204.122,1733.54,23409,135,119,22834,22265,21734,21715,12677
44923,1299,2383,37511,7412,37511,7412,4.81102e+18,459.864,5888.27,44923,592,246,42540,42532,41809,41514,19958
28799,2250,2701,0,28799,0,28799,2.87027e+18,14.6734,4259.88,28799,884,26,26098,26098,25647,25647,20982
27524,1417,2086,27524,0,24745,2779,1.26388e+18,210.072,4620.36,27524,553,128,25438,25438,24728,24960,17130
31509,1717,2573,31509,0,28721,2788,3.16488e+18,267.504,5325.27,31509,567,177,28936,28936,23793,26683,21770
49235,726,2707,0,49235,0,49235,1.73267e+18,427.432,6916.6,49235,809,252,46528,46006,44426,44838,23268
48381,107,2577,0,48381,0,48381,1.81032e+18,350.331,6438.61,48381,540,302,43579,40674,38016,24889,5246
21559,1,60,0,21559,21352,207,2.49039e+16,21.9264,589.494,21559,25,24,10961,10961,10961,10961,10961
29400,604,605,0,29400,0,29400,8.16504e+17,424.994,2832.86,29400,258,176,28795,28795,28795,28795,28795
32909,32,63,0,32909,32682,227,2.62227e+16,46.9056,795.539,32909,37,40,32773,32711,31593,31717,27308
33887,1148,2081,30804,3083,0,33887,3.3462e+18,325.147,5107.47,33887,539,187,31806,31806,30152,30343,19960
34087,169,1670,0,34087,6800,27287,5.8483e+15,251.782,4327.34,34087,417,185,32047,30901,29583,14026,8430
14027,371,1220,14027,0,12868,1159,9.02196e+17,264.025,2756.97,14027,370,91,12684,12343,11531,11879,7070
34349,6,14,33916,433,33670,679,8.19622e+13,6.74503,371.774,34349,9,10,34238,34021,31315,31320,28000
21435,128,1032,20010,1425,0,21435,2.43418e+18,470.827,2951,21435,261,187,19131,17498,16341,15953,3379
14720,48,659,14720,0,11109,3611,8.58413e+17,243.382,1818.66,14720,140,138,12660,9125,9352,9620,1871
45851,158,510,45851,0,45851,0,5.06414e+18,318.896,2935.94,45851,224,172,44272,42799,30645,27436,18119
31785,3,12,31337,448,31785,0,9.83061e+13,10.4517,344.405,31785,12,11,30658,30091,29207,29263,21398
19301,488,533,19237,64,19301,0,3.36079e+18,263.179,2167.44,19301,196,125,18768,18766,18742,18751,18455
16737,745,1232,16737,0,13670,3067,2.89321e+18,15.805,2355.49,16737,544,27,15505,15505,15505,15505,9982
24103,417,558,24103,0,24103,0,4.76046e+18,216.43,2396.73,24103,188,142,23545,23504,23087,22981,21108
21280,554,642,0,21280,0,21280,4.13977e+18,301.357,2032.12,21280,176,132,20638,20622,20569,20553,19659
1936,56,129,536,1400,0,1936,1.86107e+13,36.7577,362.196,1936,104,29,1807,1752,1755,1777,1117
31008,1873,2020,0,31008,0,31008,3.69348e+18,262.883,4430.4,31008,345,217,28988,28988,28988,28988,28462
5877,11,41,0,5877,5834,43,2.61894e+16,15.8246,248.667,5877,19,18,5789,5718,5531,5468,3717
31556,143,519,31556,0,31556,0,3.52545e+18,354.844,2285.15,31556,465,50,29716,28658,23919,20757,9645
2589,180,196,0,2589,643,1946,8.3352e+15,43.5666,435.424,2589,46,48,2393,2393,2386,2389,2327
10216,1,7,10201,15,10216,0,8.2988e+13,6.93128,197.833,10216,7,7,5864,5864,5864,5864,5864
38418,539,1362,35882,2536,35882,2536,6.77141e+17,689.102,4371.04,38418,376,234,36253,34601,34316,34402,25371
41367,36,907,36359,5008,0,41367,3.89584e+18,339.75,3986.13,41367,312,193,30961,27314,24300,24012,3674
24032,16,40,0,24032,23849,183,2.73994e+16,19.1987,490.746,24032,24,22,23956,23865,22719,23097,19687
48745,833,1491,43942,4803,43942,4803,2.49937e+18,618.379,5295.54,48745,488,197,47168,46526,44800,44090,23984
23523,420,1775,0,23523,0,23523,1.27867e+17,79.4204,3469.66,23523,434,63,21748,21625,20085,16756,7760
14126,1,7,14103,23,14126,0,8.22549e+13,6.94167,232.533,14126,7,7,8116,8116,8116,8116,8116
39502,1749,2489,36489,3013,36488,3014,1.31435e+18,483.57,5876.29,39502,811,144,37013,36947,36331,36321,28932
47421,790,3549,0,47421,0,47421,3.35784e+16,25.4594,6582.47,47421,538,31,43872,43872,41053,38310,15391
31698,995,1283,29555,2143,0,31698,2.45627e+18,648.865,3927.54,31698,360,215,30415,30344,29801,29694,27330
20478,208,584,19597,881,0,20478,1.6371e+18,312.996,2317.92,20478,210,144,18811,16884,17156,16100,13571
29969,8,13,29744,225,29969,0,1.01596e+14,11.2977,339.398,29969,12,11,29937,29931,28698,28729,28180
10965,237,987,10258,707,10258,707,6.22456e+17,192.861,2158.37,10965,224,127,9911,9635,9357,9335,5709
25138,7,8,24790,348,25138,0,1.02298e+14,7.62853,291.924,25138,8,8,25122,25115,25107,25107,25103
20048,627,745,0,20048,4455,15593,4.61152e+15,330.818,2376.01,20048,270,159,19303,19132,19139,19199,18067
46966,39,3596,0,46966,15341,31625,4.14893e+15,197.577,6758.03,46966,880,194,37147,33520,32153,29753,13289
22645,485,914,0,22645,4998,17647,4.84152e+15,327.526,2759.8,22645,304,125,21667,21315,21051,20865,17779
3476,2,6,3447,29,3412,64,8.22724e+13,4.31473,99.5707,3476,5,6,3255,3192,2462,3159,2349
32470,1741,1856,29737,2733,0,32470,3.05529e+18,403.749,4766.82,32470,524,150,30614,30614,30540,30576,30352
35068,728,1425,31857,3211,31857,3211,2.42647e+18,676.551,4406.38,35068,457,171,33480,32836,32010,31431,15720
42622,178,1322,39900,2722,0,42622,2.31682e+18,691.084,4468.31,42622,458,236,38674,36847,33986,33426,13925
16202,3,43,0,16202,16110,92,2.65246e+16,25.973,424.033,16202,23,26,14842,14213,12305,12727,8907
13103,221,463,13103,0,13103,0,3.33833e+18,235.21,1779.27,13103,162,112,12523,12225,10793,9055,6786
19264,39,473,5330,13934,0,19264,6.31962e+13,191.195,1562.89,19264,120,104,18040,17580,15104,8131,4662
23548,691,1119,22010,1538,0,23548,2.39387e+18,570.337,3219.34,23548,349,183,22319,21593,21718,21617,19015
16289,5,50,0,16289,16108,181,2.60291e+16,37.321,517.513,16289,31,33,14476,13139,10814,11956,5593
11936,910,1027,0,11936,0,11936,1.23492e+18,422.783,2385.31,11936,272,170,10909,10741,10813,10609,10339
33832,974,1151,30233,3599,30233,3599,3.06042e+18,536.024,3793.88,33832,488,169,32681,32607,32376,32314,29801
39436,264,1016,9269,30167,0,39436,2.92619e+13,223.931,3519.28,39436,250,137,38338,37545,35658,36949,19535
34093,2,14,33502,591,32441,1652,8.26272e+13,6.57616,366.184,34093,9,10,30042,29095,27674,28736,20822
25453,1571,1801,23681,1772,0,25453,2.6102e+18,306.189,4136.85,25453,584,138,23652,23649,23475,23428,22045
16522,30,37,0,16522,16228,294,2.7267e+16,12.4203,405.715,16522,18,13,16485,16484,16473,16480,15580
31249,4,8,31214,35,31249,0,3.63363e+13,4.99386,373.303,31249,6,6,29900,27217,27458,27458,17622
39248,665,1736,35196,4052,35194,4054,1.09831e+18,272.825,4482.17,39248,394,181,37512,37421,36915,37301,11235
43314,4,10,43151,163,43186,128,1.00902e+14,9.03722,386.551,43314,10,10,43197,43160,40866,40771,29911
39500,15,34,38289,1211,39496,4,9.87947e+13,9.63392,497.036,39500,19,18,39460,39451,38582,38564,31302
46110,926,1724,0,46110,0,46110,1.338e+18,619.526,5371.67,46110,438,237,44386,43317,42559,34133,21101
16428,144,1345,16428,0,14728,1700,1.29362e+18,174.121,2823.3,16428,438,117,14718,13942,12135,8391,4831
36010,1384,1681,36010,0,31979,4031,1.87087e+18,311.513,4135.82,36010,433,251,34329,34328,33223,33664,28527
6265,1,11,6006,259,6265,0,9.47093e+13,8.73392,176.004,6265,10,10,2487,2487,2487,2487,2487
40538,411,1645,9854,30684,0,40538,2.78249e+13,255.347,4285.31,40538,320,213,38893,38324,35646,27987,17695
22024,27,63,0,22024,21723,301,2.50618e+16,40.0189,690.449,22024,36,35,21908,21854,21062,20876,13535
1733,368,385,1326,407,0,1733,6.91595e+18,46.1339,659.218,1733,103,57,1348,1348,1346,1347,1333
13042,841,1257,12188,854,12188,854,1.14038e+18,172.898,2337.8,13042,387,109,11785,11713,11182,11517,9368
23701,829,866,21218,2483,21218,2483,3.26146e+18,261.128,2445.15,23701,147,155,22835,22835,22793,22785,22523
33305,804,2107,33305,0,29816,3489,1.65989e+18,259.436,4768.17,33305,305,286,31198,31173,29587,27859,23771
41886,140,846,41886,0,31587,10299,9.01104e+17,399.689,3158.82,41886,239,184,39390,38348,32416,31767,8429
31153,405,438,31153,0,31153,0,5.11698e+18,285.593,2323.14,31153,191,152,30715,30709,30547,30498,29801
19173,363,448,4350,14823,0,19173,2.84936e+13,209.438,1958.61,19173,194,107,18725,18725,18616,18700,16514
35750,192,1652,0,35750,0,35750,1.48347e+18,463.073,4757.33,35750,359,202,32630,31056,28984,22289,7934
29030,216,963,0,29030,0,29030,1.92938e+18,286.865,2796.41,29030,156,161,27711,25265,23992,13071,7370
18154,1377,1599,15187,2967,15187,2967,6.0341e+18,14.707,2696.67,18154,568,26,16555,16555,16333,14753,14078
33739,1182,1397,31531,2208,0,33739,2.41361e+18,573.009,4185.63,33739,366,202,32342,32171,32226,32228,30889
13399,175,1096,13399,0,12023,1376,8.60829e+17,257.772,2514.74,13399,348,115,11523,10514,9083,3125,1442
11014,270,679,9726,1288,9726,1288,1.67904e+18,315.653,1993.43,11014,192,133,10136,9763,9341,9356,4963
37477,5480,7154,37477,0,36584,893,4.89262e+17,14.9862,7751.78,37477,905,23,30323,30323,29752,26681,23493
35309,546,594,0,35309,8027,27282,7.27877e+15,230.795,2879.2,35309,237,128,34715,34715,34675,34702,33375
8852,491,564,7822,1030,7822,1030,3.62306e+18,198.922,1268.49,8852,92,132,8288,8197,8231,8207,7614
15810,115,1188,14448,1362,14448,1362,2.43762e+18,313.565,2881.67,15810,387,122,13451,12403,11829,10563,2381
16779,217,690,0,16779,3673,13106,4.83559e+15,273.061,2095.88,16779,201,127,15863,15607,15056,13910,9766
23007,115,998,21503,1504,21503,1504,5.97344e+17,425.804,2942.53,23007,232,180,20213,17732,16360,18020,2688
2960,36,294,745,2215,0,2960,3.25196e+13,38.4649,553.839,2960,50,50,2650,2548,2326,2458,646
38242,6175,7170,37358,884,37358,884,3.60342e+18,14.0058,7819.33,38242,932,22,31072,31072,30083,27025,27273
12932,288,512,11065,1867,12932,0,3.26987e+18,226.643,1725.23,12932,221,109,12393,12197,11375,10485,8660
17461,900,1065,16300,1161,16300,1161,2.0425e+18,446.733,2800.22,17461,257,180,16396,16382,16269,16265,15326
9529,321,390,2080,7449,0,9529,2.79046e+13,179.949,1335.22,9529,156,82,9139,9132,9104,9135,8818
16194,69,450,16194,0,16194,0,3.38375e+18,230.738,1948.45,16194,159,136,13655,11586,10641,7565,4961
32191,1723,2663,32191,0,31580,611,9.86691e+17,367.987,5124.9,32191,375,149,29528,29528,29298,29354,22078
30086,80,1002,26476,3610,26476,3610,1.71459e+18,403.463,3674.84,30086,292,203,24264,20353,17771,20118,3460
21064,95,617,5373,15691,0,21064,2.42613e+13,213.024,2313.47,21064,245,118,19049,17841,17016,16607,5873
36914,767,871,0,36914,0,36914,1.87482e+18,350.21,3739.52,36914,308,189,36043,36043,35945,36014,34182
30737,170,4300,0,30737,4217,26520,1.11146e+15,10.7569,5373.83,30737,848,18,26437,26437,17658,14455,8492
16481,129,697,3636,12845,0,16481,1.78815e+13,262.15,2067.63,16481,213,126,15425,15149,14326,12510,7309
8533,125,391,8533,0,8533,0,3.59661e+18,217.533,1371.32,8533,137,106,7817,6931,6333,5028,3207
2642,5,7,2642,0,1068,1574,5.04996e+13,6.6162,104.83,2642,7,7,2625,2617,2405,2409,2613
31341,435,2185,28024,3317,0,31341,3.87749e+18,228.607,4743.8,31341,452,240,29156,28481,25499,25248,6045
20450,524,991,18035,2415,18035,2415,3.65932e+18,287.525,2361.77,20450,109,249,19459,19401,17804,17331,10348
36886,553,1763,7117,29769,0,36886,2.62721e+13,290.972,4555.55,36886,502,186,35123,34757,34206,34329,17456
26584,396,584,0,26584,0,26584,7.70454e+17,375.355,2671.7,26584,231,159,25951,25444,24593,24532,24441
40834,81,93,0,40834,40532,302,2.49063e+16,51.8709,1060.58,40834,45,45,40741,40737,40336,40084,37664
42515,1362,1625,37962,4553,0,42515,3.24315e+18,382.794,5209.07,42515,449,195,40890,40887,40722,40728,35434
3965,113,328,3965,0,3965,0,5.12607e+18,130.56,861.579,3965,101,81,3534,3286,2927,2581,2056
5493,13,54,0,5493,5486,7,1.94148e+15,5.94903,299.031,5493,21,13,5439,5424,5386,5406,3877
25959,677,1209,25959,0,24203,1756,9.15286e+17,567.147,3509.31,25959,358,203,24578,23503,22683,22339,20677
36193,941,1314,9085,27108,0,36193,2.88047e+13,192.611,3392.74,36193,341,143,34879,34879,32625,33592,23708
45876,1988,2467,41193,4683,0,45876,3.74923e+18,301.731,5945.56,45876,480,307,43409,43409,41615,41461,33556
17079,6,44,0,17079,17046,33,2.11545e+16,29.9981,464.838,17079,31,32,15530,14824,12737,13874,9886
23697,137,345,23697,0,23697,0,3.84605e+18,231.278,1846.48,23697,136,138,22502,21158,18430,17669,11761
1863,146,303,1863,0,1681,182,8.02195e+17,39.0032,538.746,1863,62,53,1560,1498,1403,1537,1042
45048,333,2914,40901,4147,40898,4150,1.35184e+18,387.329,6866.83,45048,683,221,41447,39985,37534,37546,6565
41867,81,514,41867,0,41867,0,5.0009e+18,331.391,2841.59,41867,202,173,38322,34680,23921,21352,12038
9702,1,12,9645,57,9702,0,1.00846e+14,6.6543,191.435,9702,9,8,5370,5370,5370,5370,5370
6012,359,415,4534,1478,0,6012,8.22631e+18,88.6956,949.252,6012,94,90,5597,5582,5597,5593,5030
10516,41,499,9416,1100,0,10516,3.82665e+18,207.775,1371.48,10516,100,118,9000,7806,6958,7505,1227
23546,1289,1469,21720,1826,21720,1826,2.43555e+18,387.931,3540.47,23546,448,137,22077,22077,22004,22035,20964
7954,183,544,0,7954,0,7954,1.56549e+18,272.488,1530.37,7954,208,107,6902,6248,6395,6170,4621
17523,403,1473,15435,2088,15433,2090,1.26453e+18,193.131,2803.09,17523,320,183,16050,15669,15404,15601,3546
17391,1260,1646,15552,1839,15552,1839,1.09653e+18,189.923,3419.23,17391,301,217,15745,15745,15728,15706,13570
20770,75,1483,19004,1766,0,20770,3.08061e+18,310.042,3584.67,20770,327,171,17510,15730,14984,15057,3234
19047,9,60,0,19047,18930,117,2.65388e+16,44.8706,606.333,19047,33,35,18222,17595,16884,15843,10902
21629,59,650,0,21629,0,21629,4.12971e+18,296.025,2062.99,21629,177,139,19681,18252,13354,6707,4538
48902,287,360,48887,15,48902,0,3.25671e+18,309.646,3017.52,48902,213,176,48418,48275,46510,45979,43040
37384,899,1382,33422,3962,0,37384,3.86827e+18,301.909,3587.42,37384,161,178,36002,35982,34880,34940,26912
25624,6,8,25591,33,25624,0,8.07498e+13,6.95145,314.403,25624,7,8,25457,25120,21171,21170,23030
8303,163,366,0,8303,2171,6132,7.48038e+15,135.398,1007.98,8303,72,97,7923,7596,7322,7400,4336
11943,157,482,10360,1583,11943,0,3.51767e+18,238.715,1618.6,11943,231,102,11198,10689,9021,7982,5213
1836,143,391,1618,218,0,1836,4.40649e+18,22.2462,573.144,1836,89,33,1445,1417,1280,1194,744
32115,542,840,0,32115,7093,25022,4.72089e+15,425.059,3081.48,32115,331,174,31254,30631,30406,30366,26490
37465,450,1597,0,37465,7949,29516,6.56251e+15,258.17,4332.44,37465,366,193,35868,35666,34268,30397,17060
4602,19,34,0,4602,4593,9,2.11852e+16,22.6797,227.343,4602,22,25,4548,4518,3988,4241,3875
818,5,7,811,7,818,0,1.10113e+14,5.82029,53.5004,818,7,6,808,804,781,780,688
11179,273,932,10071,1108,0,11179,3.27922e+18,218.405,2121.1,11179,276,97,10108,9261,9224,9373,3143
46033,224,450,46005,28,46033,0,3.85152e+18,293.096,2963.28,46033,263,222,45160,44230,38080,38975,25749
43605,75,1023,10346,33259,0,43605,2.35681e+13,296.864,3868.81,43605,387,151,38592,36034,34924,20685,5735
40066,7,13,39807,259,40066,0,1.04213e+14,10.5784,387.267,40066,12,11,40029,40022,38520,38518,38261
6622,19,42,0,6622,6347,275,2.44837e+16,16.2286,307.236,6622,22,21,6579,6570,5957,6352,5370
16484,1,12,16023,461,14210,2274,7.45695e+13,6.67963,248.883,16484,9,8,10499,10499,10499,10499,10499
36153,1224,1679,36153,0,32421,3732,1.51194e+18,263.212,4225.77,36153,497,169,34474,34474,32033,33056,23589
7465,5,10,7422,43,7465,0,1.02485e+14,7.76102,169.202,7465,9,9,7404,7376,6897,7029,6476
6918,529,979,0,6918,0,6918,1.63483e+18,75.1123,1722.94,6918,229,149,5939,5939,5924,5938,3487
39592,827,1541,35162,4430,35162,4430,2.84591e+18,321.862,4849.47,39592,422,181,38051,38016,33566,31833,18398
11216,325,399,11216,0,11216,0,4.96141e+18,169.829,1395.36,11216,125,105,10817,10762,10571,10313,10026
4772,62,320,0,4772,616,4156,1.39675e+16,11.8491,684.732,4772,163,12,4452,4452,3167,3267,2166
39004,26,46,0,39004,38727,277,2.55908e+16,38.5828,699.07,39004,35,33,38867,38749,38010,38403,30092
9965,499,500,8923,1042,8923,1042,8.69487e+17,214.564,1381.93,9965,101,121,9465,9465,9465,9465,9465
10281,205,637,9078,1203,9078,1203,9.23784e+17,199.257,1431.86,10281,91,149,9541,9341,8943,8556,4692
33226,1,22,0,33226,33192,34,9.30382e+15,5.00518,554.572,33226,12,7,16077,16077,16077,16077,16077
48792,194,911,0,48792,10744,38048,4.60191e+15,486.432,3825.16,48792,339,209,46220,45252,43336,38613,20853
19490,379,1183,4645,14845,0,19490,3.19004e+13,136.941,2405.11,19490,333,122,18307,18266,15598,15967,4715
18430,639,1364,18430,0,16650,1780,1.59674e+18,204.685,3109.28,18430,206,171,17066,17030,16605,16838,13211
49510,636,1966,10026,39484,0,49510,2.39523e+13,373.71,5638.93,49510,542,201,47490,47185,45383,38034,21524
16446,397,422,16446,0,16446,0,4.96951e+18,239.165,1729.5,16446,154,116,16024,16024,16023,16023,16015
28314,1004,1238,26423,1891,26423,1891,6.89724e+17,570.237,3706.02,28314,288,213,27076,27004,26803,26729,25655
14852,6,342,14852,0,14852,0,3.74043e+18,223.916,1565.01,14852,205,85,8416,4956,5668,4110,1868
4560,237,244,1269,3291,0,4560,6.37661e+13,48.5566,622.4,4560,61,49,4316,4316,4314,4314,4308
31883,794,1856,28611,3272,28611,3272,1.41295e+18,396.248,4851.33,31883,530,160,30027,29796,28096,28144,12269
7203,355,433,5419,1784,0,7203,8.38114e+18,127.197,1056.96,7203,106,85,6770,6694,6765,6760,6151
10833,180,661,0,10833,2399,8434,4.66944e+15,116.283,1729.81,10833,160,77,10172,10033,9719,8603,5784
40017,561,1840,0,40017,9347,30670,6.90172e+15,200.474,4553.8,40017,375,170,38177,38089,36700,33517,22828
38611,1536,6142,0,38611,0,38611,3.20891e+16,12.2732,8781.92,38611,1237,17,32469,32469,22340,22411,15914
26038,395,605,24859,1179,24859,1179,1.43374e+18,425.019,2672.45,26038,235,166,25307,24703,23706,23519,23188
20298,1652,1816,20298,0,18957,1341,3.46401e+18,293.98,3694.58,20298,536,149,18482,18477,18482,18482,17832
994,151,194,843,151,843,151,1.96771e+18,94.2736,380.617,994,58,51,787,662,743,742,748
40795,825,1283,0,40795,0,40795,1.19152e+18,660.962,4349.38,40795,392,232,39461,38102,38204,35035,30464
30973,1538,2175,27831,3142,27831,3142,1.05266e+18,246.108,4946.8,30973,369,246,28798,28798,28482,28533,23477
48556,48,66,0,48556,48299,257,1.96602e+16,26.7504,975.213,48556,28,32,48490,48489,48302,48358,41334
41575,1170,1887,37246,4329,37246,4329,3.23502e+18,269.65,4596.81,41575,487,176,39688,39688,36776,35793,22650
49042,416,954,36924,12118,36924,12118,7.04905e+18,390.583,3357.31,49042,273,179,48031,47375,44423,42064,29960
30921,1122,1531,30921,0,27592,3329,1.6827e+18,260.33,3657.36,30921,396,168,29390,29390,27051,28140,19581
31965,1961,1981,28722,3243,28719,3246,1.28614e+18,238.461,4626.81,31965,463,149,29984,29984,29978,29982,29861
39606,336,691,11036,28570,0,39606,6.26343e+13,245.868,2432.04,39606,165,131,38915,38668,37495,37782,24214
21383,896,1335,0,21383,0,21383,1.44239e+18,379.981,3362.74,21383,455,130,20048,19895,19675,19480,15970
47418,29,38,0,47418,45178,2240,2.4647e+16,29.7651,724.08,47418,34,33,47352,47239,46114,45862,43721
37377,1337,1923,33690,3687,33690,3687,3.05928e+18,263.201,4658.44,37377,317,208,35454,35424,35133,34977,28060
21687,683,1117,18939,2748,18939,2748,1.7467e+18,336.833,3218.75,21687,285,156,20570,20564,20372,20491,18064
17864,730,1158,0,17864,4238,13626,8.13138e+15,130.586,2325.96,17864,333,115,16706,16697,14935,15191,7234
5716,543,868,0,5716,0,5716,1.41371e+18,104.492,1644.47,5716,194,104,4848,4832,4607,4480,3601
35856,1587,1892,35856,0,32712,3144,1.44612e+18,345.163,4973.4,35856,365,263,33964,33956,33919,33669,31577
42935,772,1428,42935,0,40090,2845,9.21419e+17,708.065,4728.19,42935,413,239,41334,39372,36541,35127,29644
10974,215,611,0,10974,2785,8189,8.02338e+15,101.102,1368.07,10974,80,104,10363,10290,9518,9662,4931
2554,24,25,0,2554,2549,5,2.74237e+16,11.9969,145.452,2554,14,12,2529,2523,2529,2529,2510
37889,5,11,36124,1765,37889,0,9.60717e+13,10.7469,434.869,37889,11,11,36645,36484,33415,32544,28679
1706,30,32,0,1706,1640,66,2.39067e+16,11.8224,141.428,1706,17,15,1674,1672,1646,1672,1553
19585,145,542,19521,64,19585,0,3.34689e+18,264.891,2186.44,19585,222,128,17968,16509,15170,13549,10171
40244,990,1097,9569,30675,0,40244,2.35925e+13,254.219,3887.8,40244,381,164,39147,39144,39142,39129,37935
8881,515,522,8881,0,6705,2176,8.18263e+17,229.888,1333.49,8881,133,113,8359,8359,8352,8342,8326
44360,739,990,33439,10921,33439,10921,7.00258e+18,371.857,3282.72,44360,237,182,43370,43332,42899,42769,37223
45142,582,633,42327,2815,45142,0,3.56879e+18,365.459,3469.34,45142,295,165,44509,44495,44400,44367,43773
37727,921,1785,7072,30655,0,37727,2.31295e+13,328.722,4846.1,37727,465,191,35942,35813,34972,35559,17864
40362,346,644,36716,3646,40362,0,3.79928e+18,329.437,3280.58,40362,271,183,39587,39097,37363,35449,30997
29923,925,1520,26964,2959,26964,2959,3.07173e+18,247.313,3776.32,29923,488,152,28403,28402,26102,24826,15715
40364,4,98,0,40364,39347,1017,2.10189e+16,29.9726,1024.72,40364,41,37,38618,37652,32331,31989,19855
1309,5,7,1307,2,1309,0,8.2142e+13,6.40642,70.8923,1309,7,7,1284,1263,1125,1124,1173
22639,753,1069,0,22639,0,22639,1.21409e+18,487.426,3092.58,22639,265,187,21517,20886,21081,20084,16586
27801,1055,1274,0,27801,4527,23274,5.4357e+15,222.261,3495.3,27801,494,99,26527,26527,26310,26515,24226
34215,418,1273,31219,2996,31219,2996,2.33715e+18,617.157,4216.9,34215,487,167,32510,31840,29662,27455,12111
1140,3,6,1098,42,1140,0,1.07899e+14,2.78596,60.8208,1140,4,5,1103,1088,1102,1102,655
19679,74,633,14832,4847,14832,4847,7.02098e+18,287.436,1950.12,19679,171,137,18166,17420,12387,9532,3904
39587,295,916,0,39587,8617,30970,5.54903e+15,422.89,3628.47,39587,431,141,38371,37960,35651,35868,16304
21661,948,1095,3898,17763,0,21661,1.80138e+13,173.906,2942.15,21661,334,96,20566,20566,20419,20554,18977
37552,582,870,0,37552,0,37552,1.88276e+18,348.706,3770.9,37552,308,201,36682,36672,36009,36192,25499
49357,857,1072,49357,0,37248,12109,8.12216e+17,404.241,3709.58,49357,258,201,48285,48268,47550,45695,42057
40134,674,703,0,40134,11224,28910,1.60353e+16,259.436,2454.39,40134,163,139,39431,39430,39404,39410,39091
3908,211,356,3908,0,3497,411,1.79889e+18,134.827,785.69,3908,79,81,3537,3329,3166,3417,2136
36539,757,1354,36539,0,34140,2399,1.0013e+18,706.68,4246.32,36539,428,224,34935,33669,31615,30770,24884
40525,337,499,40525,0,40525,0,4.99929e+18,311.744,2753.95,40525,202,168,39981,39528,37757,35893,33270
36341,1488,1585,0,36341,8148,28193,6.72886e+15,257.562,4170.9,36341,443,168,34756,34726,34756,34756,34090
39405,367,1198,35341,4064,0,39405,3.05479e+18,394.883,4361.63,39405,411,193,37855,35205,34826,35152,20387
30681,406,959,0,30681,6572,24109,4.69259e+15,362.638,3228.25,30681,257,185,29630,29001,28464,28625,19809
22875,466,560,0,22875,6401,16474,1.61492e+16,175.649,1761.93,22875,115,112,22315,22304,22218,22254,20325
1076,145,236,197,879,0,1076,2.48516e+13,24.513,393.431,1076,63,28,840,840,804,677,632
33000,555,2342,29862,3138,29859,3141,1.39775e+18,293.273,5332.47,33000,595,188,30627,30004,28781,28390,10933
37156,787,1103,8512,28644,0,37156,2.54158e+13,309.875,3845.67,37156,324,176,36053,36049,35558,32671,31250
22249,253,585,19975,2274,22249,0,3.89497e+18,263.354,2395.59,22249,226,150,21533,21046,19543,18346,14667
20717,1073,1438,18407,2310,18407,2310,3.45642e+18,191.138,3034.79,20717,337,194,19279,19279,18443,18206,13468
8951,631,767,8342,609,8342,609,2.11821e+18,180.605,1671.64,8951,170,124,8184,8149,8166,8122,7908
47900,16,94,0,47900,47613,287,2.51615e+16,47.0081,1179.59,47900,47,44,47224,46557,43351,40193,24686
19977,362,925,19977,0,18618,1359,1.14196e+18,456.41,2685.11,19977,285,170,18715,17987,16235,17218,12161
21589,428,803,0,21589,4837,16752,4.85971e+15,290.31,2481.02,21589,262,122,20734,20436,20162,20037,16236
15568,544,751,13941,1627,0,15568,3.82324e+18,217.341,1935.86,15568,128,133,14817,14802,14623,14644,12873
11521,1005,1272,10279,1242,10279,1242,1.013e+18,156.712,2477.02,11521,214,166,10249,10249,10233,10249,9202
2287,100,169,1968,319,1968,319,3.55177e+18,117.144,526.101,2287,90,62,1967,1598,1825,1819,1505
43736,128,1588,39062,4674,39062,4674,2.69022e+18,383.122,5223.48,43736,445,214,38099,34135,32503,28495,6891
34813,114,658,30719,4094,34813,0,3.90167e+18,335.71,3077.25,34813,272,157,32363,29269,24197,19481,9311
11260,63,1183,10410,850,10410,850,1.2816e+18,111.995,2315.07,11260,384,111,9274,8234,6340,7616,1436
6642,362,363,6642,0,6642,0,4.70316e+18,137.532,1095.3,6642,107,95,6279,6279,6278,6278,6278
13891,255,619,13891,0,12435,1456,1.76604e+18,233.308,1749.44,13891,114,136,13243,12575,11422,12495,8062
47320,50,59,0,47320,46700,620,2.12732e+16,22.8075,991.65,47320,32,28,47261,47261,47259,47255,46492
43774,1319,2844,5649,38125,0,43774,3.62592e+13,11.892,5426.74,43774,1423,13,40930,40930,36700,29482,25407
36436,419,1752,0,36436,6769,29667,5.74732e+15,321.529,4715.65,36436,468,188,34512,34160,32633,29006,9877
18565,6,7,18544,21,18565,0,8.12058e+13,6.97463,266.838,18565,7,7,18428,18149,15730,15731,18253
3080,19,161,0,3080,857,2223,4.45684e+15,44.5756,476.528,3080,136,28,2791,2709,2596,1842,497
31847,300,2036,25041,6806,0,31847,7.13915e+18,279.139,4543.2,31847,360,217,29532,28628,26612,26970,14285
3870,5,10,3823,47,3870,0,1.01826e+14,6.53101,120.172,3870,8,9,3826,3802,3630,3631,2815
4929,116,426,4423,506,4423,506,2.60394e+18,223.689,1084.65,4929,182,86,4120,3833,3743,3493,1561
25239,3,8,25112,127,25239,0,8.23272e+13,6.88129,312.001,25239,7,8,24101,23839,20317,20546,17479
9604,177,379,9604,0,9604,0,3.18171e+18,157.603,1208.82,9604,125,106,9162,8989,7641,7523,4463
49719,3227,3694,0,49719,11019,38700,1.60956e+15,291.252,6672.08,49719,435,127,46025,46025,45320,45488,42223
24850,1009,1156,0,24850,0,24850,1.94296e+18,274.633,3359.92,24850,250,152,23694,23694,23617,23686,22254
41917,2318,2557,38103,3814,38103,3814,2.83768e+18,365.958,6160.85,41917,597,233,39360,39360,39048,39001,36702
16968,22,60,0,16968,16836,132,2.54589e+16,39.3404,562.166,16968,30,33,16849,16810,15950,15314,8803
45309,1014,1034,10681,34628,0,45309,2.30297e+13,330.429,3970.54,45309,387,155,44275,44275,44275,44266,43665
39028,359,1405,0,39028,9865,29163,7.35805e+15,208.33,3625.13,39028,347,142,37623,37267,32749,33885,13450
39538,39,65,0,39538,39273,265,2.66448e+16,43.6345,865.174,39538,38,41,39424,39349,38173,38328,34637
2865,156,189,806,2059,0,2865,6.33221e+13,39.1839,478.179,2865,49,49,2676,2673,2674,2672,2392
9067,8,589,0,9067,0,9067,2.14421e+18,177.625,1283.74,9067,85,123,4041,2316,1833,2616,249
37388,637,1582,0,37388,0,37388,1.58808e+18,344.547,4816.48,37388,438,181,35806,35573,31220,27514,14799
14614,160,447,14614,0,14614,0,3.93737e+18,275.044,1867.78,14614,168,127,13734,13282,10900,8735,6066
19806,380,1498,19806,0,18461,1345,1.6848e+18,285.358,3392.65,19806,383,172,18175,17613,16439,14592,5947
21116,93,498,5877,15239,0,21116,6.31458e+13,197.851,1627.1,21116,121,107,20222,19839,17504,14247,6509
16344,9,33,0,16344,15584,760,2.45396e+16,25.3887,412.146,16344,24,24,15889,15275,12399,14218,10149
21054,558,634,18468,2586,18468,2586,3.28437e+18,292.876,2581.42,21054,232,153,20420,20420,20335,20275,18875
34094,1329,1671,30938,3156,30938,3156,1.36553e+18,715.959,4709.99,34094,548,173,32423,32035,32159,32297,28905
15778,9,31,0,15778,15749,29,2.13598e+16,26.4365,420.21,15778,27,28,14969,14339,12441,13404,10585
48316,304,934,0,48316,11651,36665,6.84786e+15,233.916,4054.75,48316,358,154,47381,47129,41299,42805,21337
6873,19,20,0,6873,6854,19,3.08444e+16,15.3848,240.339,6873,16,15,6851,6824,6848,6849,6848
47892,5410,5630,47403,489,47403,489,3.75193e+18,84.3036,7606.86,47892,1382,22,42262,42238,42046,41293,41399
8466,40,847,7862,604,0,8466,2.55079e+18,138.642,1790.26,8466,157,141,6195,4850,4890,4785,1156
16229,37,47,0,16229,15825,404,2.21159e+16,13.8632,508.516,16229,22,15,16182,16182,16173,16179,14700
2534,141,171,0,2534,0,2534,2.1188e+18,120.641,551.558,2534,86,65,2347,2102,2288,2297,2181
48039,146,1293,42322,5717,42322,5717,1.71341e+18,431.142,4965.23,48039,340,212,43228,36252,36108,36904,8879
30754,184,618,23178,7576,30754,0,3.87348e+18,348.187,2806.07,30754,300,147,29414,28651,23764,19737,13296
7600,819,825,6904,696,0,7600,3.41162e+18,59.2286,1428.66,7600,254,75,6775,6775,6775,6775,6756
25861,351,939,0,25861,5521,20340,4.67842e+15,340.464,2973.26,25861,285,153,24829,24252,23955,22335,15525
38261,1074,1256,35787,2474,0,38261,2.35046e+18,678.75,4222.22,38261,374,227,37005,36992,36717,36644,35606
22155,117,1421,19628,2527,19628,2527,3.53793e+18,218.865,2890.55,22155,343,143,19650,18530,17288,13757,1710
9429,79,610,0,9429,1594,7835,5.38075e+15,133.383,1623.9,9429,214,69,8568,8074,7924,3662,2423
12793,676,1069,0,12793,0,12793,1.27491e+18,238.471,2428.78,12793,324,111,11724,11659,11495,11495,8712
14940,859,958,13177,1763,13177,1763,3.08502e+18,292.126,2442.46,14940,286,143,13982,13982,13890,13922,12386
1881,11,18,0,1881,1879,2,2.89993e+16,15.3493,112.784,1881,16,12,1843,1815,1746,1813,1105
30608,1703,2070,0,30608,0,30608,1.82065e+18,224.078,4767.58,30608,487,155,28538,28538,27639,26527,22277
21300,687,802,18697,2603,18697,2603,1.73248e+18,340.941,2886.87,21300,241,163,20498,20498,20474,20459,18766
10078,280,503,0,10078,2193,7885,4.95471e+15,142.7,1369.75,10078,145,107,9575,9460,9255,9278,7719
10057,426,499,0,10057,0,10057,4.11794e+18,217.312,1338.34,10057,127,109,9558,9556,9500,9531,8824
19188,143,1128,19188,0,17894,1294,9.5446e+17,460.696,2999.96,19188,288,184,16933,15674,13345,13452,6641
43038,353,1433,43038,0,40226,2812,9.7738e+17,614.841,4768.1,43038,389,268,40457,38843,35397,35478,22609
29408,4,12,29315,93,28715,693,8.30511e+13,6.83596,351.553,29408,10,8,28652,28227,24811,24989,24286
24878,6,13,24675,203,24878,0,9.92484e+13,9.97295,309.909,24878,11,10,24795,24740,23494,23497,19877
41191,542,732,41063,128,41191,0,3.16147e+18,382.334,3481.01,41191,250,169,40459,40311,39228,39041,34650
1159,67,144,0,1159,271,888,4.97345e+15,55.9318,316.272,1159,49,37,997,900,945,944,617
27918,722,1163,0,27918,6990,20928,7.93103e+15,192.525,2677.31,27918,266,141,26755,26755,24310,24574,15258
39269,825,1999,36604,2665,36604,2665,6.99387e+17,545.535,5511.71,39269,387,268,37229,36235,36131,35934,22173
34306,77,2113,0,34306,0,34306,1.86688e+18,225.296,4922.35,34306,477,163,30132,28487,26506,8455,3066
38845,701,1762,38845,0,35031,3814,9.90781e+17,445.318,5256.26,38845,435,207,37080,36777,34643,35509,25509
44306,339,999,33399,10907,0,44306,8.28238e+18,361.545,3284.03,44306,241,182,43134,41453,38359,37886,23411
13166,6,35,0,13166,13143,23,2.13284e+16,27.6347,394.025,13166,27,30,11943,11435,9767,10674,6630
35163,1,13,34911,252,35163,0,9.78996e+13,11.8272,368.578,35163,13,12,19711,19711,19711,19711,19711
46678,11,13,46182,496,46678,0,9.53789e+13,11.4564,419.915,46678,12,13,46658,46639,45082,45083,46649
15740,1116,1385,15740,0,14139,1601,9.69558e+17,211.423,2813.75,15740,447,103,14355,14354,14351,14329,13075
12803,195,546,9650,3153,0,12803,8.30449e+18,244.13,1536.09,12803,133,117,12043,11715,10617,10437,5661
24590,816,1142,22123,2467,0,24590,2.95358e+18,353.357,3434.83,24590,334,156,23448,23404,23093,23173,16031
38156,17,95,0,38156,37275,881,2.0258e+16,30.3547,1006.26,38156,40,35,37963,37875,36152,36083,21828
33026,263,585,9181,23845,0,33026,6.3467e+13,232.386,2117.03,33026,166,127,32413,31881,31226,31356,19495
39644,1902,3121,38592,1052,38592,1052,3.15025e+18,354.625,5934.08,39644,400,156,36523,36523,33782,32594,24664
32039,553,591,29231,2808,32039,0,3.90055e+18,316.422,2807.1,32039,270,149,31448,31437,30960,30946,30592
12222,25,378,12222,0,12222,0,3.156e+18,267.719,1560.19,12222,157,106,8494,6438,6085,3644,1811
17254,606,1330,17149,105,0,17254,7.05171e+18,68.0057,2616.67,17254,418,58,15924,15924,15030,14093,8493
38820,2,47,0,38820,38671,149,2.61241e+16,28.8229,681.422,38820,25,27,30537,28547,25864,25420,18475
18983,997,1131,18983,0,17757,1226,9.06777e+17,417.62,2939.2,18983,286,169,17852,17755,17818,17781,17147
3472,55,338,3472,0,3472,0,3.15044e+18,139.651,813.258,3472,103,65,2875,2305,2203,1492,1182
32262,99,576,8960,23302,0,32262,6.33994e+13,229.585,2077.97,32262,158,122,30983,30351,26360,17272,9453
29711,40,439,29711,0,29711,0,3.50057e+18,241.847,2404.92,29711,247,152,25690,22933,16334,13520,5203
33719,49,62,0,33719,33552,167,2.71335e+16,28.722,680.968,33719,29,31,33657,33652,33512,33611,32061
44445,1,11,42398,2047,44445,0,9.60233e+13,10.7854,470.942,44445,11,11,17459,17459,17459,17459,17459
17839,7,11,17805,34,17839,0,7.87672e+13,6.51791,269.542,17839,7,9,17828,17827,15660,15658,13403
17418,983,1271,0,17418,4332,13086,1.0328e+16,321.683,2865.51,17418,284,145,16147,16147,16017,15671,12762
5151,4,7,5126,25,5151,0,7.81422e+13,3.01631,117.52,5151,7,4,5144,5143,4881,4880,4954
38052,967,1402,38052,0,35568,2484,9.70445e+17,536.938,4504.12,38052,389,229,36650,36336,36035,36283,32720
7040,43,584,6146,894,6146,894,1.8064e+18,172.435,1513.74,7040,154,108,5124,4547,3440,3849,771
31713,648,807,31713,0,23873,7840,8.50546e+17,384.876,2783.16,31713,217,166,30906,30877,30619,28782,27916
22292,39,65,0,22292,21952,340,2.45149e+16,38.807,686.667,22292,33,36,22214,22166,21467,21411,15807
17567,38,622,15463,2104,0,17567,3.83823e+18,309.905,2349.72,17567,226,156,13232,11673,10478,10016,2587
41472,244,1415,0,41472,0,41472,1.51055e+18,509.21,4709.36,41472,472,191,37822,33947,33962,16619,6766
2812,187,366,2678,134,2678,134,8.44215e+17,184.638,791.589,2812,121,69,2357,2129,1965,2176,1919
48175,2306,2509,0,48175,0,48175,1.40847e+18,530.75,6669.42,48175,857,148,45666,45666,45646,40042,42532
36017,325,579,36017,0,36017,0,3.29435e+18,297.159,2556.79,36017,196,143,35390,35077,32069,31130,25454
42438,723,1413,42438,0,39641,2797,9.51772e+17,717.252,4634,42438,427,249,40756,38831,36515,35150,30978
7966,102,590,7078,888,7078,888,1.64436e+18,303.489,1617.73,7966,168,123,6635,5572,5098,5645,1728
28273,1302,2372,25884,2389,25884,2389,1.14368e+18,308.868,5140.32,28273,509,240,25901,25899,24648,25267,15303
15127,288,701,13547,1580,13547,1580,3.25165e+18,222.893,1840.74,15127,129,131,14423,14209,13395,12985,8053
31912,1641,2234,0,31912,0,31912,1.9526e+18,232.178,4833.33,31912,468,242,29678,29678,27689,27998,18937
9163,752,978,8482,681,8482,681,1.29273e+18,205.71,2050.56,9163,351,103,8185,8162,8081,8057,6414
35049,235,384,9181,25868,0,35049,1.22825e+13,274.119,2399.92,35049,224,131,34528,33997,32435,32144,31372
35203,175,526,35203,0,35203,0,4.16069e+18,271.82,2731.49,35203,171,204,34085,32623,26826,26164,18287
40654,1305,1730,37664,2990,37664,2990,7.20534e+17,591.868,5177.01,40654,438,249,38924,38919,38435,38357,33762
25121,1716,1806,0,25121,0,25121,1.54988e+18,276.686,4174.49,25121,450,227,23315,23315,23315,23315,22605
15683,150,418,15683,0,15683,0,4.97076e+18,199.556,1721,15683,175,119,15075,14698,12265,11819,9622
10526,568,1017,10526,0,9871,655,8.24948e+17,157.774,2291.77,10526,253,114,9509,9477,9367,9344,6614
27538,2,11,27329,209,20862,6676,7.14268e+13,7.38013,378.544,27538,9,9,23878,22014,21222,21016,17536
24953,261,353,24953,0,24953,0,3.84292e+18,235.365,1944.74,24953,144,146,24591,24496,23653,23083,21185
3540,204,296,2672,868,2672,868,6.91748e+18,54.937,655.642,3540,71,66,3244,3242,3217,3170,2420
37393,1068,1289,34935,2458,34935,2458,6.33616e+17,593.98,4164.64,37393,345,229,36104,36020,35770,35585,34110
12221,482,614,10761,1460,10761,1460,1.7115e+18,291.373,2018.38,12221,209,143,11607,11382,11412,11460,9713
29291,270,5596,29291,0,29291,0,2.38053e+18,16.9832,6177.44,29291,712,25,23695,23695,18416,23250,1784
48665,308,471,48665,0,48665,0,5.00433e+18,272.132,2987.54,48665,209,173,48168,47932,44718,43267,37964
37453,201,2435,0,37453,4833,32620,1.29032e+16,11.8895,4645.97,37453,1219,13,35018,35018,21779,22296,14654
12522,467,637,0,12522,2784,9738,4.73594e+15,176.738,1777.05,12522,170,118,11885,11781,11744,11755,10276
49301,51,84,0,49301,48670,631,2.24646e+16,26.0672,1103.03,49301,31,38,49217,49213,46278,46764,41110
36138,258,517,36138,0,36138,0,3.65712e+18,328.988,2380.03,36138,514,59,35156,34495,33635,31389,22576
47463,246,368,47454,9,47463,0,3.25842e+18,317.434,2977.06,47463,219,176,46547,44669,42969,36512,35701
19695,11,56,0,19695,19427,268,2.52303e+16,27.4529,627.442,19695,29,33,19065,18574,17591,17218,9189
22112,1,11,21064,1048,22112,0,9.62613e+13,10.5457,332.403,22112,11,11,8669,8669,8669,8669,8669
17591,16,439,4888,12703,0,17591,6.36458e+13,176.304,1446.31,17591,111,93,14282,11547,12147,4866,2900
1598,7,242,1487,111,1487,111,5.15049e+17,98.0594,489.663,1598,67,52,676,442,305,327,159
47016,2095,2418,0,47016,0,47016,1.27176e+18,443.003,6541.37,47016,645,136,44598,44598,44377,44503,40157
19782,451,1001,18399,1383,18399,1383,6.38456e+17,417.938,2743.78,19782,247,172,18628,18026,17643,17654,12712
26857,754,1192,23616,3241,23616,3241,1.58423e+18,371.643,3845.42,26857,375,176,25665,25646,25126,25340,18805
1416,326,374,1329,87,1329,87,8.90915e+17,22.3792,577.179,1416,103,43,1042,1042,1042,1042,901
29707,379,748,29707,0,22393,7314,8.10798e+17,373.109,2604.43,29707,207,169,28871,27675,26889,24229,16031
22994,554,1530,22994,0,21155,1839,8.65688e+17,300.131,3746.44,22994,454,112,21425,20996,20068,20652,10204
23893,281,1123,22333,1560,22333,1560,6.30697e+17,512.188,3268.54,23893,274,191,21975,21443,20633,20551,12768
9140,560,565,8702,438,8702,438,1.50785e+18,262.253,1575.81,9140,181,105,8575,8575,8575,8575,8571
30498,23,1529,30498,0,27193,3305,1.65857e+18,256.602,3728.89,30498,417,166,22660,14942,13933,4139,2217
45606,11,13,45218,388,45521,85,9.98489e+13,8.76218,477.892,45606,11,10,45593,45593,45591,45593,45094
29437,8,13,29237,200,29437,0,1.00534e+14,11.0018,334.38,29437,12,11,29405,29400,28470,28493,28061
40531,2673,2779,37120,3411,37120,3411,1.44864e+18,399.936,6283.52,40531,723,236,37752,37752,37721,37724,36577
7546,209,561,6693,853,6693,853,1.64695e+18,274.452,1544.59,7546,169,121,6813,6634,5737,6209,2752
20328,28,35,0,20328,19395,933,2.45901e+16,28.8997,469.936,20328,25,27,20281,20232,19885,20001,18632
48924,37,76,0,48924,48707,217,2.25346e+16,26.293,939.86,48924,32,36,48848,48838,43249,45477,34489
34508,150,459,34508,0,34508,0,3.75046e+18,272.943,2456.63,34508,260,171,32894,30695,23062,21046,14533
14005,98,1125,12910,1095,12910,1095,2.37207e+18,298.116,2651.28,14005,381,108,11882,11066,10365,9212,2134
38062,597,1308,8898,29164,0,38062,2.37382e+13,310.407,4090.88,38062,323,171,36754,36499,35074,18191,19270
28957,357,1790,26909,2048,0,28957,2.64987e+18,437.154,4124.83,28957,706,113,26892,26472,24824,25249,11568
22774,539,894,0,22774,0,22774,1.67281e+18,292.794,3099.35,22774,318,162,21880,21831,20942,20976,17035
37757,342,641,30781,6976,37757,0,3.72428e+18,364.492,3183.38,37757,307,168,36871,36177,33464,32082,23944
1928,12,20,0,1928,1923,5,3.11702e+16,5.49015,126.083,1928,10,8,1908,1906,1810,1871,1249
14167,49,926,0,14167,1828,12339,1.11459e+14,11.8811,1837.5,14167,465,12,13241,13241,4344,4072,5388
38693,81,1077,0,38693,9457,29236,6.57054e+15,347.22,3697.57,38693,521,125,34587,32469,31026,32303,10772
33656,11,13,33070,586,33646,10,1.07268e+14,9.54712,333.899,33656,12,12,33639,33638,33602,33602,31524
17070,15,35,0,17070,17056,14,2.06465e+16,23.6578,422.236,17070,22,26,16967,16925,14420,14872,13538
38642,1130,2491,0,38642,0,38642,1.63739e+18,267.79,5765.06,38642,501,236,36151,36145,35651,31126,20966
35515,53,191,0,35515,34004,1511,2.48587e+16,26.9423,1083.56,35515,76,39,35324,35285,34651,34462,31679
22296,16,65,0,22296,22145,151,2.59713e+16,41.0623,660.199,22296,33,36,21963,21625,20596,19982,16116
2510,8,25,0,2510,2483,27,2.80767e+16,19.4729,171.47,2510,20,19,2354,2251,2052,2028,1341
14531,303,649,3139,11392,0,14531,1.84802e+13,286.419,1973.68,14531,194,148,13744,13461,13182,11898,8353
40205,252,745,11186,29019,0,40205,6.30317e+13,255.059,2522.74,40205,174,145,39373,38575,35805,35277,19958
46833,1265,2254,42013,4820,42013,4820,3.19303e+18,272.784,5449.95,46833,468,191,44579,44575,39825,36391,17173
35197,469,1272,31983,3214,31983,3214,2.40569e+18,633.501,4307.55,35197,489,165,33543,32958,30463,27924,13966
18624,3,9,18312,312,15880,2744,7.17745e+13,6.59729,236.779,18624,8,7,18436,18393,16848,17244,13125
37063,10,13,36812,251,37063,0,1.04789e+14,11.0451,376.263,37063,12,11,37040,37029,35913,35911,34948
9454,397,560,9454,0,8284,1170,7.35659e+17,399.259,1746.74,9454,240,117,8696,7624,8113,6418,6887
20209,20,44,0,20209,19883,326,1.86411e+16,22.5521,511.817,20209,25,24,20144,20124,19881,20081,17107
36472,712,1441,0,36472,9126,27346,7.67116e+15,199.77,3464.18,36472,352,144,35031,35019,30607,31289,12291
31928,602,1236,29841,2087,29841,2087,6.09504e+17,616.1,3845.78,31928,345,200,30331,29176,29002,28813,20908
31604,1987,2033,28355,3249,28355,3249,9.40388e+17,241.357,4443.88,31604,315,213,29571,29571,29571,29571,29425
5374,3,7,5368,6,5374,0,8.30705e+13,6.8329,142.619,5374,7,7,5138,5085,4318,4368,3620
37524,1207,1323,33491,4033,0,37524,3.90941e+18,283.875,3589.94,37524,211,175,36201,36201,36026,35987,34485
37248,1228,2392,0,37248,0,37248,1.61934e+18,333.715,5638.08,37248,753,229,34856,34825,34242,34044,23546
11774,362,811,2654,9120,0,11774,1.98671e+13,108.262,2035.25,11774,211,84,10963,10931,10647,8419,7516
30410,880,1208,28401,2009,28401,2009,2.01697e+18,624.683,3738.36,30410,370,218,29202,28333,28538,28358,24758
24953,3,32,0,24953,23471,1482,1.69107e+16,13.0446,634.169,24953,20,20,16902,14640,12444,13176,9805
40096,1608,1967,40096,0,35402,4694,2.03346e+18,337.816,4382,40096,387,317,38129,38128,37132,37692,32445
34646,240,2341,31865,2781,31865,2781,2.40556e+18,385.521,5549.96,34646,552,198,31472,30424,29266,25787,4323
33000,1296,1693,0,33000,0,33000,1.93122e+18,247.989,4061.21,33000,431,162,31307,31307,29707,27027,22007
8910,406,478,6732,2178,0,8910,8.17553e+18,197.413,1223,8910,109,113,8432,8341,8418,8416,7765
42154,9,35,0,42154,40131,2023,2.4612e+16,31.9049,678.943,42154,31,33,40925,39380,31402,36370,23491
40212,5,13,39919,293,40212,0,1.00762e+14,12.0404,396.089,40212,13,12,39942,39763,37907,37392,32984
34484,7,10,34272,212,34420,64,1.02962e+14,7.29025,346.293,34484,9,10,34459,34431,33883,33883,33938
37178,3,12,35455,1723,37178,0,9.60768e+13,10.419,433.162,37178,12,11,33330,32265,26391,25935,19908
39436,93,1491,35477,3959,0,39436,3.35354e+18,467.048,4599.25,39436,580,177,33886,30840,29823,30665,12181
27190,5,41,0,27190,26787,403,2.62154e+16,23.1419,507.963,27190,23,21,26652,26424,22827,24203,10851
15477,355,872,15477,0,13718,1759,2.13951e+18,204.546,2017.25,15477,103,198,14605,14309,13028,14015,9263
29622,262,564,0,29622,6727,22895,7.27234e+15,223.307,2592.04,29622,224,120,29049,28535,27531,28268,16441
14191,339,387,14191,0,14191,0,3.67744e+18,213.7,1238.15,14191,270,34,13804,13604,13711,13582,12371
20408,12,14,20321,87,20408,0,8.68371e+13,7.00196,290.395,20408,10,9,20394,20392,20229,20228,20194
49733,2097,2820,44866,4867,44866,4867,2.95074e+18,452.495,6989.49,49733,637,287,46913,46798,45849,45102,40668
24681,876,1036,0,24681,0,24681,2.04626e+18,230.155,2622.14,24681,122,179,23645,23643,23491,23512,21084
33266,594,954,7801,25465,0,33266,2.39968e+13,259.28,3344.03,33266,371,142,32312,32228,31560,31789,24562
17633,377,663,0,17633,4575,13058,7.58817e+15,153.342,1796.64,17633,105,128,16970,16955,16455,16537,12555
32951,230,516,32951,0,32951,0,3.37568e+18,439.167,2295.27,32951,516,40,30961,28596,29066,29213,15555
25027,340,1268,6235,18792,0,25027,3.0354e+13,158.976,2904.97,25027,183,156,23759,23604,21611,20897,9644
48721,212,1373,45539,3182,45539,3182,2.00908e+18,722.251,4817.99,48721,408,246,44417,43193,40217,39157,17550
22192,8,9,22143,49,14205,7987,6.5955e+13,8.34774,333.261,22192,9,9,22181,22178,22088,22088,22088
28587,178,1541,25499,3088,0,28587,3.94555e+18,248.644,3591.37,28587,339,242,26549,25823,23015,22664,7123
21948,960,1094,20519,1429,20519,1429,6.23929e+17,444.35,3069.28,21948,235,199,20854,20839,20715,20774,19548
33411,1275,1296,31219,2192,31219,2192,2.03287e+18,643.319,3978.03,33411,414,216,32115,32115,32114,32115,32088
28700,35,609,28700,0,28700,0,3.39826e+18,303.581,2832.73,28700,192,175,21725,19119,15515,10603,3793
27209,109,1144,24571,2638,0,27209,3.01435e+18,368.398,3609.38,27209,392,169,23006,21132,20248,20466,5693
40721,1773,1918,0,40721,0,40721,2.09909e+18,321.319,4419.96,40721,358,301,38803,38803,38709,38702,36744
5485,162,692,5188,297,0,5485,2.06855e+18,100.832,1257.05,5485,184,88,4793,4434,4586,4693,2355
3293,226,297,3293,0,3293,0,3.37758e+18,103.703,784.396,3293,84,74,2996,2983,2908,2811,2359
42336,3470,7967,6037,36299,0,42336,6.87874e+12,10.0307,8560.98,42336,1027,18,34369,34369,29875,21915,19777
13656,361,692,12062,1594,12062,1594,1.69017e+18,351.094,2212.24,13656,207,148,12858,12396,12167,12158,8975
36782,713,748,36718,64,36782,0,3.55468e+18,372.69,3296.14,36782,261,155,36034,36029,36017,36015,36031
2332,222,318,0,2332,475,1857,5.46927e+15,77.1132,644.538,2332,84,66,2014,1966,1983,1990,1853
39384,358,953,0,39384,0,39384,4.11904e+18,343.868,3045.47,39384,214,175,38330,37056,33945,23172,20457
47396,1333,2424,42854,4542,42850,4546,1.24454e+18,315.334,6209.21,47396,683,208,44972,44972,44610,44872,21086
33900,722,1616,0,33900,9156,24744,1.48017e+16,202.548,3756.12,33900,286,162,32284,32254,31640,32211,26951
37030,955,1873,33959,3071,33959,3071,7.68649e+17,489.757,5159.38,37030,456,229,35157,34682,34479,34285,18487
29582,17,562,0,29582,8213,21369,1.62428e+16,225.733,1994.22,29582,145,125,24390,19609,20627,18619,5131
49706,106,487,49706,0,49706,0,5.12134e+18,314.584,3009.39,49706,215,178,46991,44348,30189,26748,17739
39133,918,1854,39133,0,36493,2640,9.54583e+17,555.55,5439.78,39133,350,284,37279,36998,34786,33944,25196
23721,2065,2143,21817,1904,21817,1904,1.2407e+18,341.406,4477.54,23721,513,201,21578,21578,21578,21578,21213
3550,36,38,0,3550,3523,27,2.68745e+16,18.2273,232.053,3550,22,23,3512,3512,3509,3486,3417
3630,450,486,3206,424,3206,424,3.64646e+18,51.646,887.758,3630,181,63,3144,3144,3144,3144,3016
34868,386,519,34868,0,34868,0,3.47562e+18,379.677,2432.31,34868,516,51,34142,33076,33363,31916,26474
5193,178,307,1155,4038,0,5193,2.83532e+13,82.4165,927.856,5193,123,58,4886,4852,4396,4379,2642
14305,384,453,12652,1653,12652,1653,2.73012e+18,345.552,1917.92,14305,261,126,13777,12850,13554,13634,12952
9424,352,492,8447,977,8447,977,3.22574e+18,215.014,1321.96,9424,99,118,8932,8863,8687,8663,7118
40079,443,947,30208,9871,30208,9871,6.99898e+18,348.092,3045.26,40079,220,177,39132,38799,36462,33921,20679
18934,119,467,18934,0,18934,0,3.46695e+18,284.939,2144.91,18934,183,152,17315,14939,13355,10150,6333
28302,3,11,28179,123,28302,0,1.07609e+14,7.94774,322.229,28302,10,10,27057,26437,24298,26075,18346
1549,110,334,1549,0,1285,264,1.3909e+18,29.9348,521.559,1549,135,51,1215,1181,881,1107,537
39846,815,1108,35033,4813,0,39846,3.62754e+18,344.349,4400.68,39846,381,189,38738,38737,38391,38471,29413
46826,4,13,46310,516,46826,0,9.77584e+13,10.7737,421.432,46826,12,12,46119,45841,43442,43458,32690
40932,625,788,30794,10138,0,40932,8.34989e+18,359.16,2909.1,40932,223,176,40144,40129,39909,39880,36788
11202,708,1051,11202,0,10450,752,8.50746e+17,379.569,2349.65,11202,237,147,10151,9862,9523,9513,7520
4563,243,650,0,4563,0,4563,1.19658e+18,95.6114,1202.59,4563,238,46,3913,3777,3654,2626,1838
35108,6,14,34572,536,33694,1414,8.23389e+13,6.67064,372.784,35108,9,10,35017,34876,32627,32609,28692
48957,56,597,46875,2082,48957,0,3.71909e+18,305.159,3447.96,48957,273,189,43913,40763,28810,23014,7893
11994,168,436,11994,0,11994,0,3.51878e+18,237.713,1685.8,11994,155,113,11296,10961,9345,7850,6024
13888,291,746,12425,1463,12425,1463,8.8917e+17,216.403,1908.63,13888,127,141,13142,12988,12568,12608,7035
38313,585,684,38249,64,38313,0,3.89097e+18,337.318,3259.04,38313,237,154,37629,37604,37434,37441,36695
8566,61,590,0,8566,1858,6708,5.0053e+15,123.919,1510.27,8566,154,97,7543,6841,6714,5643,2588
7392,821,826,6867,525,0,7392,2.60352e+18,152.451,1720.68,7392,174,98,6566,6566,6566,6566,6560
16540,486,1403,16540,0,15118,1422,7.92654e+17,333.046,3172.11,16540,424,127,15137,14660,13721,10563,6768
44769,422,524,44321,448,44769,0,4.06596e+18,269.514,3106.64,44769,272,166,44245,44224,41649,39987,36701
18215,14,61,0,18215,18087,128,2.63783e+16,40.3775,586.472,18215,31,32,17862,17543,16522,16339,8175
39316,491,1962,35287,4029,35287,4029,3.18405e+18,281.054,4750.12,39316,312,238,37354,37015,34659,33122,18327
11835,476,991,11103,732,0,11835,2.24743e+18,228.039,2211.65,11835,225,134,10844,10634,10435,10421,8248
13312,9,10,12909,403,12864,448,9.43044e+13,5.59623,205.3,13312,8,7,13302,13302,13302,13301,13301
32033,293,543,31585,448,32033,0,4.12843e+18,265.146,2710.19,32033,259,137,31442,31188,25648,25123,18130
22804,1354,1682,0,22804,525,22279,5.6192e+14,59.4228,3289.09,22804,450,54,21122,21120,20729,18477,17782
8882,99,478,7774,1108,7774,1108,3.3252e+18,190.566,1522.13,8882,173,115,7710,6391,6454,5751,3388
22364,681,1120,0,22364,5396,16968,7.96501e+15,190.147,3142.59,22364,317,142,21244,21223,20514,20154,14225
15038,3,310,15038,0,15038,0,4.87705e+18,174.084,1400.61,15038,137,111,5794,4046,3688,2426,1750
37455,1041,1402,0,37455,9417,28038,6.99286e+15,213.392,3659.34,37455,463,141,36053,36053,34574,34666,27624
45881,110,740,12795,33086,0,45881,6.29888e+13,254.226,2690.48,45881,185,151,44190,43197,37469,21936,14724
31155,957,1742,0,31155,7147,24008,7.89587e+15,201.072,3746.74,31155,391,238,29413,29411,26384,26906,15365
23118,198,682,17417,5701,17417,5701,7.0211e+18,309.16,2157.76,23118,177,142,21929,21269,17556,15115,8511
27394,1,48,0,27394,27292,102,2.65935e+16,28.2879,576.328,27394,24,27,11732,11732,11732,11732,11732
16167,406,560,14160,2007,14160,2007,3.3139e+18,258.814,2164.53,16167,218,144,15607,15383,15164,14972,11200
40703,467,573,40703,0,40703,0,3.27724e+18,311.722,2708.08,40703,222,148,40130,40089,39611,39330,37990
39823,551,1109,34987,4836,34987,4836,1.73238e+18,398.898,4340.14,39823,299,199,38714,38480,36692,36648,22428
14885,435,935,0,14885,3162,11723,6.04655e+15,97.5949,2226.62,14885,326,70,13950,13950,13400,12853,6835
34044,1663,2064,30879,3165,0,34044,3.41604e+18,311.999,4982.24,34044,505,195,31980,31980,31159,31146,26335
11353,761,940,10302,1051,0,11353,3.44768e+18,292.413,1797.27,11353,403,79,10413,10171,10062,9796,9116
935,81,163,877,58,877,58,1.91376e+18,68.6995,315.091,935,49,40,746,651,683,703,520
5250,2,30,0,5250,5007,243,2.45958e+16,16.2962,230.427,5250,19,20,3599,3017,3112,3346,2220
29442,1209,2105,24343,5099,24249,5193,2.83762e+18,375.406,4846.91,29442,363,238,27337,27323,25759,26763,12952
31026,96,876,0,31026,0,31026,4.12723e+18,314.864,2673.9,31026,198,161,28885,28069,20055,10703,6288
40345,6,13,39749,596,37546,2799,8.65601e+13,6.09882,419.359,40345,10,9,40320,40305,38878,38878,30653
14224,977,1361,14224,0,12592,1632,1.6505e+18,148.987,2603.89,14224,394,132,12863,12863,12106,12525,8051
9774,525,621,9774,0,8658,1116,1.12245e+18,310.47,1833.15,9774,198,128,9153,8974,9006,9079,7744
14012,239,1973,14012,0,11323,2689,1.21578e+18,109.982,3469.77,14012,213,227,12039,11833,10652,10593,3283
5612,551,1085,5612,0,5612,0,2.664e+18,16.9275,1330.05,5612,146,26,4527,4527,4527,4500,2383
15067,11,12,14858,209,15067,0,9.74245e+13,8.20854,238.112,15067,9,10,15055,15052,14772,14772,15054
16245,145,314,16245,0,16245,0,3.43424e+18,202.728,1395.97,16245,107,152,15725,15375,13199,11984,8612
30099,605,932,0,30099,6516,23583,4.80965e+15,373.863,3149.18,30099,274,160,29167,28890,28711,28752,24825
37485,420,1426,32780,4705,32780,4705,1.75913e+18,378.361,4503.69,37485,349,206,35812,34751,33300,33461,16883
49156,13,14,48525,631,46412,2744,8.5652e+13,7.53265,432.282,49156,10,11,49142,49142,47628,47628,47966
12907,202,566,11464,1443,11464,1443,1.39657e+18,374.193,1967.55,12907,250,123,11183,9898,8891,10198,6477
17490,98,1585,0,17490,0,17490,2.95986e+18,14.6898,2636.42,17490,545,26,15905,15905,9906,8720,2425
26190,194,603,26190,0,26190,0,3.29042e+18,285.287,2670.03,26190,179,173,25081,24492,21075,17657,12808
29463,504,1111,26116,3347,0,29463,4.15581e+18,316.951,2930.64,29463,137,258,28352,27912,26519,26417,17690
16795,179,472,0,16795,4068,12727,5.49834e+15,208.883,1955.63,16795,261,112,15871,14708,15267,15703,11209
11964,414,556,11964,0,9015,2949,8.27335e+17,254.803,1561.13,11964,139,124,11408,11099,11008,10352,8896
4301,41,384,3237,1064,3237,1064,7.05059e+18,75.8307,813.322,4301,87,85,3650,2137,2290,1901,945
20732,603,828,20732,0,18312,2420,1.16042e+18,402.112,2885.17,20732,237,174,19904,19900,19460,19428,16218
19763,594,617,14888,4875,0,19763,8.29379e+18,285.03,1925.33,19763,161,137,19146,19145,19146,19144,19060
28836,323,393,28832,4,28836,0,4.26556e+18,274.565,2422.35,28836,186,141,28432,28328,27050,26465,24297
21534,500,756,5651,15883,0,21534,2.96696e+13,185.015,2003.93,21534,109,132,20778,20769,20068,20255,15651
647,163,170,0,647,0,647,2.02416e+18,22.3601,249.291,647,52,25,477,477,477,477,472
48096,1157,2574,48096,0,42841,5255,1.68583e+18,421.121,5777.18,48096,401,255,45522,45359,40255,43236,24274
779,14,184,779,0,665,114,1.31561e+18,82.9307,329.606,779,54,39,431,343,264,103,150
2825,295,336,2345,480,2825,0,3.82801e+18,99.5805,737.823,2825,86,61,2489,2484,2466,2474,2280
33575,578,848,0,33575,9269,24306,1.60972e+16,232.859,2524.35,33575,201,123,32727,32726,32573,32689,31901
44226,1662,2363,44226,0,39792,4434,1.59219e+18,280.494,5587.05,44226,377,256,41863,41862,41476,40897,36428
38352,186,1529,34154,4198,34154,4198,3.38752e+18,281.762,3817.68,38352,311,182,36041,33184,30806,25910,1984
7349,499,565,7349,0,6530,819,1.13686e+18,277.97,1529.4,7349,168,119,6784,6672,6739,6750,6467
14420,249,435,14420,0,14420,0,3.1007e+18,212.787,1511.71,14420,143,108,13949,13653,12402,12153,9529
44747,36,365,44738,9,44747,0,3.2569e+18,317.647,2904.53,44747,212,178,34842,29203,25081,17174,6653
4502,106,352,0,4502,0,4502,4.15699e+18,68.7981,799.238,4502,71,76,4150,4081,3813,2958,2400
15289,1,7,15265,24,15289,0,8.25152e+13,6.93636,241.696,15289,7,7,8793,8793,8793,8793,8793
34001,2575,3433,0,34001,0,34001,2.68939e+18,14.6265,5143.79,34001,1025,26,30568,30568,29012,29432,20775
27397,265,608,0,27397,0,27397,8.55314e+17,415.884,2755.91,27397,244,174,25930,23004,23234,24159,20455
7692,305,328,2133,5559,0,7692,6.17332e+13,88.9197,879.821,7692,73,65,7364,7362,7364,7358,7225
36103,875,943,27217,8886,27217,8886,7.00493e+18,340.996,2955.95,36103,213,174,35160,35157,35115,35098,34349
31600,164,1185,31600,0,29504,2096,9.56066e+17,602.966,3820.6,31600,316,225,28415,27061,22549,22389,6079
24968,17,59,0,24968,24803,165,2.6505e+16,33.335,591.745,24968,30,31,24819,24726,23676,23573,16486
22201,489,799,19889,2312,0,22201,3.80971e+18,261.47,2272.51,22201,147,153,21402,21363,20830,20874,17588
39833,1098,1572,35099,4734,35099,4734,1.76224e+18,375.422,4872.33,39833,348,196,38261,38261,37801,37838,32397
15217,2,11,14508,709,15217,0,9.60762e+13,10.146,275.876,15217,11,11,10999,9275,9742,9585,8108
31840,553,681,8856,22984,0,31840,6.29889e+13,232.911,2220.17,31840,146,135,31159,31141,30996,31030,28714
19838,421,1363,0,19838,0,19838,1.96287e+18,188.494,2959.06,19838,335,178,18475,18089,16627,17185,9107
9789,349,378,0,9789,2155,7634,7.12687e+15,175.798,1345.74,9789,165,80,9411,9411,9386,9404,8992
10814,768,878,9802,1012,9801,1013,1.61378e+18,169.873,1826.5,10814,256,101,9936,9936,9936,9936,9443
14299,398,701,14299,0,12616,1683,1.16645e+18,342.7,2277.72,14299,211,142,13516,13095,12868,11816,9663
25993,205,1395,23146,2847,23146,2847,9.30016e+17,264.674,3315.46,25993,224,184,24149,21975,21977,21142,6721
44037,235,1217,38831,5206,38831,5206,3.08252e+18,342.939,4635.8,44037,401,216,41768,39871,33730,29843,10944
16904,1378,1421,16904,0,15115,1789,1.58598e+18,199.313,2984.22,16904,200,206,15483,15483,15466,15442,15345
47436,76,1452,44286,3150,0,47436,2.44375e+18,627.383,4868.45,47436,371,217,39540,32760,33070,33485,10376
49436,1317,1390,46163,3273,46163,3273,6.4146e+17,707.084,4870.34,49436,407,255,48046,48042,47946,47985,47803
48692,1137,1369,10669,38023,0,48692,1.88683e+13,392.228,4680.13,48692,379,208,47323,47312,47101,46978,42569
1486,95,261,1135,351,1135,351,3.61536e+18,47.5013,475.052,1486,53,75,1225,1183,968,958,518
18872,1344,1612,18872,0,16796,2076,1.31122e+18,190.476,3211.99,18872,431,102,17260,17260,17018,17126,14229
47338,30,54,0,47338,45284,2054,2.44025e+16,30.4734,861.924,47338,32,34,47263,47135,43714,45317,35516
34002,620,1208,31770,2232,31770,2232,2.00345e+18,606.689,3909.56,34002,342,210,32383,31175,31272,30886,24128
2166,284,338,2166,0,1926,240,9.3041e+17,76.5734,608.349,2166,90,55,1828,1828,1775,1828,1761
32506,1894,2239,0,32506,0,32506,1.59408e+18,265.992,5177.32,32506,491,230,30267,30267,30267,30267,27590
17762,31,803,0,17762,0,17762,1.26178e+18,369.917,2331.77,17762,213,154,12371,9659,9155,9149,2953
3727,9,10,3693,34,3727,0,9.67453e+13,6.27341,117.763,3727,9,8,3717,3717,3716,3716,3716
40323,1028,1839,40323,0,35682,4641,9.17572e+17,561.167,5155.85,40323,453,256,38484,38422,36910,32195,25786
33499,1654,1846,0,33499,0,33499,1.79949e+18,257.979,4393.14,33499,332,184,31653,31647,31649,31653,29488
11206,1086,1136,10243,963,10243,963,1.30716e+18,244.449,2451.99,11206,360,115,10070,10070,10070,10070,9980
7271,1,7,7127,144,6167,1104,7.13077e+13,5.524,145.641,7271,7,6,4783,4783,4783,4783,4783
2385,111,356,0,2385,632,1753,8.83667e+15,45.3426,625.651,2385,72,67,2029,1981,1845,1915,334
43374,2888,3247,43362,12,43362,12,3.84191e+18,24.1195,6037.41,43374,427,27,40127,40127,39775,37266,36473
27229,276,679,0,27229,0,27229,4.10892e+18,332.245,2299.74,27229,180,156,26259,25346,24627,20625,12671
28344,16,34,0,28344,26973,1371,2.4627e+16,29.8534,553.023,28344,27,29,28187,28064,25218,26874,20184
30690,181,1180,0,30690,0,30690,1.18172e+18,603.534,3737.43,30690,365,211,27801,26596,24688,22829,12189
25569,2,10,25475,94,25505,64,1.04052e+14,7.55657,297.638,25569,9,10,22809,22469,19648,21605,16023
26324,411,1218,26324,0,24598,1726,1.01464e+18,582.173,3472.57,26324,375,193,24611,23933,21329,19793,15236
12524,540,559,11213,1311,11213,1311,8.88882e+17,235.566,1607.54,12524,112,135,11965,11965,11960,11965,11844
33230,1133,1305,29467,3763,0,33230,3.38592e+18,342.611,4180.87,33230,411,178,31925,31925,31855,31886,28982
49254,99,1335,46009,3245,46009,3245,2.03424e+18,738.871,4785.88,49254,458,247,42351,37409,36269,37362,6213
44595,1314,1858,40447,4148,40447,4148,1.35584e+18,735.425,5562.91,44595,570,192,42737,42217,41764,42115,32363
19501,486,1238,16982,2519,16982,2519,1.80277e+18,270.074,3145.1,19501,265,148,18263,17978,17289,17744,11919
35269,1870,2378,31703,3566,31703,3566,1.57628e+18,359.564,5496.49,35269,372,283,32891,32800,32368,32631,30714
40243,564,2533,40243,0,36138,4105,1.75938e+18,412.114,6106.05,40243,405,229,37614,37148,33183,32541,16442
24787,9,10,24612,175,24787,0,1.00385e+14,9.20055,307.777,24787,10,10,24773,24768,24680,24680,24770
34205,65,2145,31673,2532,0,34205,2.76716e+18,372.802,5015.97,34205,711,141,28488,25381,24037,24710,4351
21419,323,704,21415,4,21419,0,3.82137e+18,239.867,2386.67,21419,172,122,20715,20435,17862,17615,14151
45234,39,1722,0,45234,0,45234,1.63711e+18,357.85,5445.27,45234,440,191,34760,28140,26854,4471,3920
34964,190,274,34964,0,34964,0,3.38198e+18,246.801,1660.18,34964,156,156,34102,33208,32957,33261,32937
47372,1304,1456,44235,3137,0,47372,2.43701e+18,624.836,4874.58,47372,373,242,45916,45834,45746,45718,44165
1841,25,188,0,1841,465,1376,7.67103e+15,47.0826,401.404,1841,46,50,1600,1450,1422,1433,426
45493,6,10,45176,317,45493,0,1.0118e+14,9.73717,417.61,45493,10,10,45267,45049,42949,42920,35570
6208,388,471,0,6208,1292,4916,4.85197e+15,80.7131,1194.04,6208,133,61,5737,5737,5686,5735,5282
6664,620,646,6227,437,0,6664,2.40317e+18,129.185,1365.04,6664,144,109,6018,6018,6018,6018,5959
9095,2,10,9058,37,9095,0,7.71854e+13,6.29467,193.809,9095,7,8,7466,7000,7182,7061,6184
5681,259,261,5681,0,5681,0,4.75228e+18,121.217,888.881,5681,92,84,5420,5420,5420,5420,5417
40982,1775,2035,34406,6576,34403,6579,2.30535e+18,358.386,5792.49,40982,434,231,38947,38946,38860,38850,33206
21301,39,404,21301,0,21301,0,3.28253e+18,325.865,1461.23,21301,154,158,19472,19404,10058,9199,13626
32447,3,14,31598,849,28353,4094,7.70247e+13,6.6939,342.558,32447,10,8,31992,31835,29757,30187,20738
40343,118,2531,36848,3495,0,40343,3.09517e+18,388.382,6207.27,40343,577,240,35673,32557,31642,31454,5215
4558,3,12,4491,67,4558,0,9.44222e+13,6.80913,129.751,4558,9,9,4378,4278,4130,4106,3194
32114,271,517,32114,0,32114,0,4.73575e+18,304.351,2613.31,32114,185,153,31411,30933,27514,26084,20972
40685,2023,2084,37806,2879,0,40685,2.64753e+18,391.773,5702.1,40685,580,135,38601,38601,38601,38601,38163
30755,11,15,30202,553,30749,6,1.06971e+14,10.9636,326.347,30755,14,12,30732,30721,30337,30338,27438
15122,1230,1416,14707,415,14707,415,3.16114e+18,304.636,2768.04,15122,283,113,13706,13706,13563,13526,12835
35302,319,1231,0,35302,0,35302,1.15822e+18,613.493,3989.87,35302,373,211,32883,32059,30819,28800,18486
24959,55,1625,0,24959,0,24959,2.85289e+16,14.8875,3174.76,24959,813,15,23334,23334,5389,19512,5345
21074,426,616,17612,3462,21074,0,3.64857e+18,308.956,2403.05,21074,234,138,20458,20318,19397,18631,16060
41841,349,6611,41841,0,0,41841,8.21116e+18,60.4091,9463.79,41841,1343,19,35230,35180,17516,19005,6535
31599,25,83,0,31599,31062,537,2.12258e+16,22.8273,904.758,31599,29,36,31497,31431,29646,29494,21967
12706,208,436,12706,0,12706,0,3.41065e+18,240.499,1730.64,12706,140,122,12119,11818,10797,9428,7925
38619,1698,2120,35920,2699,0,38619,2.62368e+18,479.78,5634.87,38619,622,133,36499,36370,36395,36351,31184
6924,9,13,6864,60,6924,0,9.56139e+13,7.51531,165.79,6924,9,9,6909,6908,6751,6751,6495
9734,271,925,9084,650,0,9734,2.42058e+18,196.588,2007.78,9734,180,114,8732,8571,8215,8129,5560
5283,13,20,0,5283,5270,13,2.97069e+16,14.6818,203.343,5283,17,13,5251,5231,5134,5186,3824
46441,105,864,0,46441,0,46441,4.14398e+18,392.468,3199.02,46441,255,176,43373,42265,28582,14887,8760
43744,405,2028,37903,5841,37900,5844,1.83013e+18,372.616,5893.87,43744,448,224,41364,40280,39156,38333,18163
38508,1042,1909,38508,0,34531,3977,7.86138e+17,478.068,5182.74,38508,431,174,36599,36349,35267,32322,26243
36489,818,861,7861,28628,0,36489,1.83289e+13,435.909,3315.07,36489,297,190,35628,35628,35588,35600,35314
3753,168,255,0,3753,951,2802,7.00806e+15,159.406,730.013,3753,176,53,3441,3188,3341,3326,2615
47670,324,2240,42604,5066,42604,5066,2.98191e+18,421.992,6033.23,47670,514,243,44695,43368,40752,38660,15504
2765,19,193,2765,0,2765,0,2.46551e+17,14.7718,442.813,2765,98,15,2572,2572,1436,2075,639
31941,37,89,0,31941,31325,616,2.00059e+16,25.4242,904.841,31941,37,33,31852,31840,31321,31350,22760
34120,701,734,34116,4,34120,0,4.59835e+18,298.804,3075.02,34120,221,135,33386,33385,33269,33064,32770
49071,28,45,0,49071,46821,2250,2.46097e+16,29.8029,793.067,49071,33,33,48986,48862,46615,46816,38107
33075,316,571,7632,25443,0,33075,2.90168e+13,220.673,2762.65,33075,233,136,32504,32373,31448,31999,21747
709,66,92,628,81,0,709,3.92143e+18,40.2017,211.654,709,31,39,617,613,589,598,486
44250,1031,1201,44250,0,38975,5275,1.16804e+18,435.68,4672.81,44250,346,227,43049,43049,42761,42868,39753
5009,116,388,0,5009,1130,3879,6.34404e+15,101.46,985.361,5009,124,59,4545,4358,4322,4259,2500
8837,353,453,7919,918,0,8837,3.80234e+18,210.891,1243.26,8837,93,111,8384,8360,8222,8242,6999
31934,663,1087,28595,3339,28595,3339,3.25562e+18,297.877,3061.79,31934,160,169,30847,30794,30007,29879,24098
14117,1008,1077,14117,0,14112,5,4.40032e+18,29.9481,2110.34,14117,315,21,13040,13040,12914,13040,12837
42295,813,951,37243,5052,0,42295,3.83524e+18,360.556,4094.03,42295,311,199,41344,41343,41192,41233,38487
16891,189,348,16891,0,16891,0,3.77331e+18,214.902,1571.11,16891,125,127,16390,15415,14918,14185,11493
32665,9,13,32511,154,32558,107,9.87253e+13,8.63343,425.643,32665,11,10,32649,32645,32523,32523,30688
32847,774,2447,32715,132,32637,210,3.40983e+18,92.0202,4741.51,32847,465,74,30400,30396,28538,30354,13084
49144,2410,2525,45338,3806,0,49144,2.88845e+18,558.581,6784.24,49144,857,148,46619,46619,46619,46610,43637
33957,14,846,7597,26360,0,33957,1.79462e+13,436.457,3149.63,33957,361,181,24555,21431,18223,7953,5470
26446,1286,3428,0,26446,0,26446,2.47911e+17,14.4128,4543.55,26446,751,22,23018,23018,20881,21199,14778
36085,396,627,36078,7,36085,0,3.60292e+18,341.733,3015.97,36085,464,129,35389,34965,34668,34705,27945
16276,266,611,0,16276,0,16276,1.93114e+18,246.137,1819.54,16276,120,135,15630,15254,14097,8643,8311
30015,349,578,8332,21683,0,30015,6.33347e+13,233.217,2027.32,30015,151,123,29437,29304,28874,28877,20690
39462,8,18,38015,1447,39462,0,9.59797e+13,9.84565,450.259,39462,16,12,39371,39314,36400,36497,25785
5948,25,47,0,5948,5871,77,2.46654e+16,24.2984,314.695,5948,26,28,5898,5879,5647,5669,4587
39612,1114,1366,0,39612,10057,29555,1.09711e+16,219.711,4267.76,39612,274,173,38246,38241,37849,37893,32732
10310,37,57,0,10310,10223,87,2.565e+16,24.0323,435.867,10310,29,29,10253,10236,9975,9986,9554
27819,905,1416,0,27819,0,27819,1.26787e+18,528.182,3893.91,27819,305,213,26403,26256,25470,22617,16741
39032,256,2350,39032,0,35393,3639,1.12182e+18,318.429,5768.37,39032,754,150,36160,35164,31056,24863,5309
31231,602,1633,5765,25466,0,31231,2.28343e+13,244.736,4142.16,31231,411,193,29598,29500,28631,28607,11777
20386,71,452,4699,15687,0,20386,2.90423e+13,204.098,2032.77,20386,200,106,18918,17055,15801,7408,5377
45459,1110,1162,0,45459,10984,34475,6.06324e+15,355.969,4069.11,45459,525,148,44297,44179,44249,44280,42867
25836,265,707,0,25836,0,25836,1.85603e+18,341.439,2934.97,25836,246,165,24684,23880,20750,19434,8727
11164,45,513,0,11164,0,11164,1.94798e+18,219.311,1441.19,11164,100,119,9499,8539,8018,6633,1388
17796,258,677,15922,1874,15922,1874,3.27741e+18,252.706,1968.46,17796,132,141,17047,16623,15307,14484,8942
10739,240,658,9484,1255,9484,1255,1.68811e+18,324.059,1948.01,10739,196,135,9855,9456,8968,9072,5050
38662,596,1198,34726,3936,34726,3936,2.52991e+18,391.417,4319.88,38662,411,193,37464,37184,34803,34262,24421
49430,606,895,10803,38627,0,49430,1.87122e+13,468.641,3817.09,49430,339,203,48535,47959,47354,47082,42821
27374,77,1230,25558,1816,0,27374,2.39513e+18,597.74,3592.23,27374,369,198,22612,19553,18950,19072,5970
7696,1,13,7642,54,7696,0,1.03469e+14,6.36824,172.643,7696,8,9,4192,4192,4192,4192,4192
30170,483,546,6916,23254,0,30170,2.88154e+13,222.684,2601.11,30170,225,130,29624,29624,29543,29606,28179
32839,553,1311,0,32839,6002,26837,4.97082e+15,328.251,3982.57,32839,409,108,31512,31177,30399,27843,17740
41580,217,1425,41580,0,38838,2742,9.99315e+17,632.918,4700.81,41580,402,247,38414,37252,31822,32516,16303
6756,154,1343,6756,0,6075,681,1.12559e+18,59.8225,2154.27,6756,223,131,5408,5275,4303,2564,900
20690,33,47,0,20690,20446,244,2.61832e+16,32.6855,568.968,20690,31,33,20629,20593,20025,20307,18389
45550,395,923,45550,0,34328,11222,8.23335e+17,423.219,3404.85,45550,254,182,44465,42541,41228,36869,23490
33563,2250,2413,33563,0,33563,0,4.80597e+18,15.9356,4455.71,33563,1078,25,31150,31150,31021,31150,30540
15594,306,445,3466,12128,0,15594,2.81095e+13,212.395,1765.11,15594,189,99,15149,15103,14967,15112,12510
20627,408,1347,0,20627,0,20627,1.80015e+18,189.49,3040.96,20627,465,124,19280,19058,17569,16604,9292
40118,1694,1866,0,40118,9253,30865,6.80176e+15,192.158,4601.66,40118,398,174,38252,38252,38252,38252,36842
32791,171,772,8021,24770,0,32791,2.73097e+13,210.815,3137.52,32791,342,141,31515,30391,26745,26669,13323
33177,49,57,0,33177,32605,572,2.7327e+16,37.0335,601.143,33177,32,30,33114,33079,33068,33057,30977
21415,1535,3576,0,21415,0,21415,2.10595e+16,7.49666,4634.6,21415,1790,9,17839,17839,16819,15289,8072
7841,43,445,7841,0,7841,0,4.14948e+18,170.93,1262.41,7841,104,102,6656,5702,3970,3453,1440
44694,171,1777,10922,33772,0,44694,2.86158e+13,200.771,4369.24,44694,330,162,42659,40691,36791,37648,12425
7838,8,21,0,7838,7605,233,2.62103e+16,8.70235,252.841,7838,13,11,7810,7798,6932,7390,4724
4888,130,449,4319,569,0,4888,3.73771e+18,146.784,1140.86,4888,148,95,4304,3815,3833,3806,2631
33498,1773,1845,33498,0,27002,6496,8.31669e+17,270.277,4945.77,33498,375,224,31653,31652,31653,31653,30923
29260,9,33,0,29260,27861,1399,2.45677e+16,31.8902,560.044,29260,27,28,28411,27342,21505,25194,16311
47591,979,2461,0,47591,0,47591,1.8841e+18,259.324,5865.81,47591,531,188,45130,45118,40034,35474,14449
16429,31,1109,2733,13696,0,16429,2.25153e+13,180.396,2587.11,16429,315,138,13947,12794,11571,7529,1878
807,10,17,0,807,804,3,2.91088e+16,7.74102,70.6026,807,12,10,788,782,777,778,630
30546,1,14,30109,437,29132,1414,8.17815e+13,6.67999,346.993,30546,9,10,17809,17809,17809,17809,17809
46821,290,626,0,46821,0,46821,8.19301e+17,472.26,3586.64,46821,282,201,45072,40978,40238,41164,35681
27699,522,839,20880,6819,0,27699,8.27862e+18,297.172,2497.63,27699,189,170,26860,26797,26444,26460,22345
7838,1,41,0,7838,7813,25,2.09977e+16,8.55078,278.584,7838,17,13,3388,3388,3388,3388,3388
9213,562,861,9213,0,8452,761,7.26637e+17,96.1067,1834.52,9213,291,95,8352,8352,8232,8261,3724
9191,79,585,0,9191,1991,7200,4.93932e+15,146.952,1501.51,9191,141,124,8411,7890,7342,7303,1771
15989,478,586,0,15989,0,15989,4.11655e+18,262.761,1724.47,15989,153,117,15403,15366,15315,15301,14069
42169,1015,1278,0,42169,0,42169,1.47115e+18,606.806,4727.58,42169,495,190,40891,40488,40642,40531,32713
15905,65,516,15905,0,15905,0,3.41742e+18,349.212,1591.32,15905,516,31,14025,13720,7019,6671,2341
18995,15,74,0,18995,18692,303,2.19986e+16,18.2586,596.372,18995,23,30,18893,18871,17563,17458,10208
8822,29,53,0,8822,8762,60,2.54187e+16,19.7047,401.257,8822,28,23,8769,8769,8748,8717,8161
23573,14,34,0,23573,22444,1129,2.46379e+16,28.7974,502.528,23573,26,27,23387,23207,20170,21598,15652
48186,278,669,44092,4094,48186,0,3.71696e+18,350.028,3616.07,48186,280,196,47122,46321,42005,38567,30682
44865,299,605,44865,0,44865,0,3.23639e+18,310.248,2868.93,44865,219,149,44156,43246,38602,37303,28874
29362,285,773,25890,3472,25890,3472,3.20881e+18,345.586,3223.57,29362,285,188,28158,27280,24534,23524,11485
48788,1,11,46466,2322,48788,0,9.62508e+13,10.7013,493.913,48788,11,11,18985,18985,18985,18985,18985
43971,481,1066,9608,34363,0,43971,1.85838e+13,474.063,3940.52,43971,359,211,42683,41481,40615,35717,22677
865,93,154,198,667,0,865,2.96166e+13,17.4347,297.049,865,41,28,711,707,687,710,522
7308,117,324,1703,5605,0,7308,2.88155e+13,97.0271,1092.47,7308,149,78,6973,6849,6501,5494,4748
5424,10,18,5333,91,5423,1,9.79766e+13,12.2959,175.127,5424,14,13,5395,5387,5287,5293,4857
45048,67,92,0,45048,44041,1007,2.01563e+16,23.9404,1090.31,45048,32,40,44956,44955,43351,44081,41259
39493,301,520,39493,0,39493,0,5.11273e+18,289.178,2925.04,39493,196,162,38867,38439,35785,33967,30289
5037,180,387,0,5037,0,5037,1.89007e+18,114.871,1050.68,5037,136,87,4650,4607,4587,4385,3950
40331,691,1230,0,40331,0,40331,1.88707e+18,337.369,4252.97,40331,305,201,39101,39096,38596,38723,32303
11110,263,517,11110,0,11110,0,2.82764e+18,205.794,1622.66,11110,165,102,10531,10140,9895,9529,6975
21629,595,1264,5379,16250,0,21629,3.72659e+13,369.508,3110.02,21629,298,153,20346,19288,18470,19508,6292
34910,39,65,0,34910,34430,480,2.48311e+16,46.0629,857.503,34910,39,40,34811,34723,33727,33627,27491
1465,94,149,1086,379,1086,379,4.0318e+18,59.3099,369.463,1465,53,57,1316,1307,1276,1254,935
39210,19,88,0,39210,39108,102,2.11267e+16,30.3488,916.893,39210,37,33,38872,38576,33705,35785,31534
25692,486,1125,25692,0,24016,1676,9.88587e+17,512.595,3355.36,25692,319,204,24178,23390,21407,20350,17855
41825,111,726,0,41825,11679,30146,1.61142e+16,256.876,2562.67,41825,176,149,40264,39358,34208,34882,13977
33587,1577,1931,30279,3308,30279,3308,1.48007e+18,391.904,4779.06,33587,494,179,31656,31655,31554,31650,30147
1581,166,190,0,1581,240,1341,4.37637e+15,43.6205,372,1581,78,31,1391,1391,1391,1391,1312
45712,61,705,0,45712,10418,35294,7.30617e+15,236.955,3433.09,45712,272,137,41744,37458,34818,31935,8132
49367,597,1894,0,49367,0,49367,1.21856e+18,588.397,5737.41,49367,377,251,46994,44962,44475,39634,27492
5280,8,27,0,5280,5276,4,2.08258e+16,15.071,226.162,5280,18,17,4941,4670,4312,4667,3902
39775,324,2050,39775,0,35414,4361,9.38834e+17,389.2,5674.82,39775,554,182,36883,33849,30787,18576,5535
33727,92,2042,30212,3515,0,33727,3.68525e+18,256.607,4591.09,33727,392,181,29432,27541,26472,26045,4831
31238,6,13,31027,211,31238,0,1.04317e+14,9.27361,344.088,31238,11,10,31153,31101,29675,29590,26502
10456,161,968,10456,0,9756,700,9.12439e+17,271.509,2114.87,10456,173,155,9249,8911,7482,7414,3820
16111,178,1072,14222,1889,0,16111,4.23706e+18,188.135,2323.5,16111,288,128,14775,13816,12710,11864,1551
41321,20,1938,0,41321,0,41321,2.12262e+18,328.76,4464.48,41321,354,296,30432,15572,22810,19405,2042
37755,613,2152,34370,3385,34370,3385,2.79574e+18,335.749,5476.2,37755,541,190,35500,35116,32576,29012,11043
10984,183,558,9654,1330,9654,1330,1.46406e+18,390.179,1851.67,10984,249,118,9278,8270,7073,8244,6609
14592,565,595,10977,3615,10977,3615,3.8325e+18,271.668,1747.49,14592,151,130,13997,13997,13994,13994,13796
45423,6,11,45154,269,45423,0,1.0198e+14,8.98237,419.531,45423,10,10,45227,45040,43277,43253,42834
12241,7,9,12202,39,5845,6396,5.92799e+13,6.9558,242.304,12241,9,9,12229,12219,12156,12155,11613
41669,560,634,38905,2764,41669,0,3.82018e+18,336.913,3327.52,41669,278,157,41035,41011,40414,40427,38574
48077,325,2888,43607,4470,43607,4470,1.05618e+18,312.987,6799.34,48077,568,279,44885,43669,41242,41382,12866
48267,745,2122,44205,4062,0,48267,3.07195e+18,481.894,5852.37,48267,436,212,46046,44948,43763,43412,20373
45968,18,20,45358,610,45961,7,9.76419e+13,17.3494,506.929,45968,20,19,45947,45938,45642,45644,45556
7623,261,551,7623,0,7623,0,1.75333e+18,15.819,1142.07,7623,258,21,7072,7072,6811,6916,4207
42413,384,594,42413,0,42413,0,3.18518e+18,323.491,2770.81,42413,204,154,41799,41598,37747,36486,30857
13956,273,810,13956,0,13054,902,1.07549e+18,347.16,2162.06,13956,187,151,12882,12469,11060,11337,7515
27898,2,11,26569,1329,27898,0,9.63245e+13,10.2062,373.166,27898,11,11,20125,16958,17839,17551,13946
6567,429,444,0,6567,0,6567,1.94932e+18,167.149,1080.21,6567,89,95,6123,6123,6114,6118,6022
11672,28,47,0,11672,11510,162,2.50029e+16,27.5368,424.914,11672,31,29,11621,11602,11332,11436,10738
6072,359,883,5315,757,0,6072,4.49982e+18,90.8085,1438.56,6072,310,65,5189,5098,4749,4945,3442
13584,199,929,12675,909,12675,909,2.04895e+18,359.369,2305.65,13584,178,163,12280,12007,11168,10985,3235
22286,1017,1153,0,22286,0,22286,1.50317e+18,370.045,3346.96,22286,396,159,21133,21110,21083,21113,20152
46481,690,2979,42274,4207,42274,4207,2.74085e+18,543.545,7047.7,46481,646,263,43261,42685,40066,36335,11923
20728,61,1377,18572,2156,18572,2156,3.2256e+18,195.151,3073.44,20728,451,122,17997,17184,15803,13401,2481
37237,1,18,36730,507,37232,5,9.75945e+13,16.5854,434.011,37237,18,18,23107,23107,23107,23107,23107
11395,428,669,2435,8960,0,11395,1.95155e+13,233.863,1828.23,11395,206,126,10726,10597,10403,10017,8224
32512,51,890,0,32512,0,32512,4.10141e+18,325.025,2736.88,32512,206,157,29205,25280,20268,10278,4775
10587,464,800,9727,860,0,10587,2.61866e+18,249.059,2072.3,10587,362,122,9787,9718,9681,9644,8286
8179,140,621,7217,962,7215,964,9.53779e+17,175.949,1339.22,8179,92,127,7462,7307,6731,6457,930
9021,143,296,9021,0,9021,0,3.98235e+18,168.477,1108.82,9021,95,101,8534,8186,7027,7205,5210
24507,71,296,24507,0,24507,0,3.86623e+18,232.8,1794.1,24507,136,146,22266,20820,14380,12212,7499
28230,374,1908,26333,1897,0,28230,2.52931e+18,309.732,4389.78,28230,556,137,26260,25546,24925,24604,8619
49117,4,13,48859,258,48636,481,8.29235e+13,9.31618,450.303,49117,10,10,47950,47311,42241,42309,33053
39305,25,639,10897,28408,0,39305,6.34368e+13,266.518,2388.14,39305,186,136,35332,30568,29660,12134,6910
44732,568,1270,41693,3039,41693,3039,2.07822e+18,664.248,4493.48,44732,416,229,42732,40935,40892,40504,33864
3607,93,244,467,3140,0,3607,5.45664e+13,11.8345,535.019,3607,125,12,3363,3363,2875,1735,2035
31767,2944,6066,31011,756,31011,756,3.59664e+18,13.9801,6593.08,31767,768,22,25701,25701,22582,12860,13659
10724,44,1116,10007,717,10007,717,1.14036e+18,107.944,2195.34,10724,319,109,8598,7728,5721,7118,1154
19785,374,521,5524,14261,0,19785,6.23642e+13,195.784,1615.94,19785,113,115,19264,19218,19049,19090,15738
5269,290,654,4911,358,4911,358,2.01513e+18,109.238,1306.83,5269,117,121,4615,4609,4501,4468,1260
10275,321,403,0,10275,2638,7637,7.61551e+15,147.149,1144.08,10275,80,108,9872,9865,9740,9770,8902
43679,164,2297,43679,0,33973,9706,9.65904e+17,330.85,5414.87,43679,321,301,40118,39082,33264,33794,10299
45101,788,1325,42051,3050,0,45101,2.44579e+18,689.615,4558.93,45101,377,239,43638,42029,42145,41846,29095
14563,80,817,0,14563,2932,11631,5.32897e+15,203.576,2176.56,14563,353,90,13101,12285,11822,10239,3434
3161,499,546,0,3161,0,3161,1.23434e+18,71.6109,990.832,3161,86,110,2615,2615,2610,2613,2485
13028,1,34,0,13028,12402,626,2.45854e+16,22.3525,368.887,13028,23,22,4989,4989,4989,4989,4989
23840,21,44,0,23840,23677,163,2.56494e+16,34.9738,531.07,23840,29,30,23728,23671,23009,23131,17423
32001,286,1234,0,32001,0,32001,1.19268e+18,483.749,3803.84,32001,333,243,29927,28996,28102,27332,7881
3909,89,447,806,3103,0,3909,1.97325e+13,85.0732,992.326,3909,110,95,3414,3261,3044,2569,982
40564,522,3184,0,40564,0,40564,4.04495e+17,353.949,6047.83,40564,405,157,37380,35807,27805,9312,9584
11924,19,43,0,11924,11896,28,2.11629e+16,27.5761,385.623,11924,29,31,11796,11686,10158,10943,9873
8152,1,26,0,8152,8141,11,1.59991e+16,13.1819,289.366,8152,19,21,3772,3772,3772,3772,3772
41761,1026,1222,38934,2827,38934,2827,2.08212e+18,642.965,4307.46,41761,360,237,40539,40517,40124,40132,38250
13246,122,611,0,13246,2032,11214,5.2773e+15,192.208,1701.78,13246,248,87,12368,12017,11380,11806,4647
14181,127,415,14181,0,14181,0,3.20367e+18,266.528,1720.53,14181,163,116,12786,11788,10690,8855,4820
20513,787,1098,19164,1349,19164,1349,2.02096e+18,423.417,2965.38,20513,276,151,19415,18975,18977,18866,17473
4896,141,219,4896,0,4896,0,5.13722e+18,106.095,735.282,4896,81,71,4677,4621,4479,4323,3786
31190,599,2135,31190,0,24111,7079,9.57183e+17,272.099,4581.7,31190,259,274,29055,29003,28037,25786,22415
33283,1810,2244,30095,3188,0,33283,3.525e+18,282.647,5138.73,33283,493,193,31039,31039,30285,30307,25508
41444,896,1506,41444,0,36439,5005,1.07148e+18,409.768,5109.21,41444,384,211,39938,39935,38162,34428,24024
32768,320,588,32768,0,32768,0,4.76856e+18,304.375,2691.82,32768,187,155,32123,31689,30185,28816,25945
38644,212,491,38644,0,38644,0,5.09814e+18,297.94,2681.93,38644,213,163,37685,36745,29737,28232,23539
11124,21,536,9950,1174,0,11124,3.86086e+18,213.234,1444.58,11124,106,121,8167,3782,5531,5324,736
22299,763,1001,22299,0,19750,2549,2.16111e+18,278.107,2510.94,22299,120,250,21298,21281,20818,21171,18974
34711,639,720,34647,64,34711,0,3.09972e+18,330.215,3186.39,34711,250,157,33991,33985,33684,33679,33166
21175,3,11,20875,300,18376,2799,7.40942e+13,6.45195,312.549,21175,8,8,20916,20845,18777,19053,15896
3277,11,189,2450,827,2450,827,3.75365e+18,94.7135,604.914,3277,69,79,1403,871,348,498,336
3371,6,7,3361,10,1408,1963,4.82627e+13,6.61554,118.55,3371,7,7,3358,3351,3346,3345,2907
11653,298,537,3174,8479,0,11653,1.99285e+13,65.2233,1437.65,11653,217,75,11116,11107,10939,10977,7317
41861,1534,1955,0,41861,0,41861,1.94104e+18,299.459,4775.22,41861,286,265,39906,39895,39845,39449,35922
39450,1681,2225,0,39450,0,39450,2.98918e+18,343.241,5322.22,39450,484,226,37225,37225,37067,35544,30710
45668,444,1664,41152,4516,41152,4516,2.81208e+18,591.035,5174.82,45668,626,192,43249,42013,37846,33947,20355
6654,340,466,6654,0,5015,1639,8.79898e+17,110.533,1089.61,6654,100,99,6188,6137,6005,5678,4795
6819,285,1038,6819,0,6133,686,1.06867e+18,148.007,1898.62,6819,230,119,5781,5587,5026,3268,1301
14319,359,451,10319,4000,9325,4994,4.74645e+18,47.2832,1166.57,14319,51,228,13868,13868,13522,13000,12380
17209,219,1063,16085,1124,0,17209,2.36419e+18,466.75,2793.61,17209,290,180,15493,15027,14096,13773,5523
48029,7,13,47698,331,48029,0,1.00403e+14,12.5716,431.529,48029,13,13,47972,47961,45681,45677,41802
27304,546,683,20597,6707,20597,6707,7.00113e+18,332.962,2338.78,27304,197,151,26621,26581,26413,26377,24560
12109,38,75,0,12109,11657,452,2.02802e+16,19.1193,492.677,12109,27,27,12034,12028,11738,11963,6382
46272,21,60,0,46272,45991,281,2.71244e+16,33.9088,808.679,46272,33,36,46103,46002,44710,45150,35935
2818,10,19,0,2818,2811,7,3.18097e+16,9.70972,149.751,2818,12,11,2796,2787,2684,2734,1999
5323,204,380,5323,0,5323,0,2.90656e+18,213.164,1042.74,5323,137,80,4831,4536,4531,4145,2841
41340,2,9,40964,376,41276,64,1.02118e+14,7.15085,378.459,41340,8,8,37330,36689,32466,35668,26371
21653,700,1180,20202,1451,20202,1451,6.3472e+17,476.452,3187.57,21653,303,177,20368,19851,19938,19922,17446
5358,583,717,4961,397,4961,397,2.29532e+18,103.519,1398.16,5358,148,72,4641,4641,4610,4613,4258
14571,142,1173,13254,1317,0,14571,3.32871e+18,223.568,2581.6,14571,551,95,13248,11771,10679,11598,3275
6282,157,397,6282,0,6282,0,3.64412e+18,168.614,1153.18,6282,142,89,5764,5369,4945,4266,2935
31482,1192,1683,27931,3551,27931,3551,3.31668e+18,354.538,4619.63,31482,335,203,29799,29786,29290,28934,23587
28121,22,62,0,28121,27915,206,2.54807e+16,49.0983,743.32,28121,36,37,27925,27847,26457,25748,21437
1559,352,457,1307,252,1307,252,2.73361e+18,42.0815,694.403,1559,118,69,1102,1090,1038,1094,887
42090,1491,1654,9257,32833,0,42090,2.68366e+13,251.176,4563.35,42090,372,195,40436,40436,40436,40436,38160
27601,14,69,0,27601,27357,244,2.47024e+16,38.8865,775.485,27601,35,35,27063,26528,25478,25227,17945
49054,33,91,0,49054,47357,1697,2.44816e+16,33.1001,1174.37,49054,45,37,48938,48875,45351,46950,29869
30697,45,51,0,30697,30135,562,2.32016e+16,16.5128,711.799,30697,25,24,30646,30646,30644,30646,30058
12290,7,12,12136,154,12290,0,9.75889e+13,10.0486,214.735,12290,10,10,12269,12264,11707,11710,11392
49464,750,1310,46230,3234,46230,3234,2.01486e+18,661.733,4731.97,49464,403,234,47865,46146,46295,45685,39908
26401,11,12,25926,475,25051,1350,8.11451e+13,6.64456,332.023,26401,9,8,26389,26389,26388,26388,26262
24487,1560,1841,24317,170,0,24487,7.03289e+18,87.2919,3603.67,24487,450,67,22646,22646,22327,22355,19799
49819,109,2181,45166,4653,0,49819,3.41e+18,374.594,5810.84,49819,406,230,44815,41820,38613,38174,6331
3551,164,231,3551,0,3551,0,2.79716e+18,128.278,726.165,3551,85,73,3319,3296,3215,3041,3138
28245,530,1183,26465,1780,26465,1780,5.93285e+17,559.714,3575.23,28245,330,196,26629,25766,25501,25698,21532
37133,130,1458,0,37133,0,37133,3.7515e+18,299.614,4151.57,37133,231,203,34558,33538,23742,13039,2307
32660,416,702,32556,104,32660,0,3.19247e+18,374.406,3032.24,32660,241,154,31865,31710,30083,29271,22129
41363,592,1428,36424,4939,36424,4939,1.60457e+18,399.3,5034.45,41363,383,211,39935,39863,37883,37874,21876
7724,29,30,0,7724,7332,392,2.48714e+16,22.942,282.944,7724,20,21,7694,7685,7691,7679,7533
37834,1052,1467,37834,0,35338,2496,9.90612e+17,624.487,4623.14,37834,361,267,36367,35940,34398,35294,32239
19227,1,10,19176,51,19175,52,1.04336e+14,6.41385,260.214,19227,8,8,10271,10271,10271,10271,10271
23987,4,13,23793,194,23987,0,1.0026e+14,10.7162,301.118,23987,11,10,23675,23551,21809,22302,17176
33354,465,1511,0,33354,6587,26767,6.39937e+15,321.792,4262.57,33354,408,193,31710,31460,30494,27932,13921
19503,700,1858,17714,1789,17714,1789,1.26161e+18,282.677,3896.42,19503,407,215,17645,17527,16162,16389,5496
701,27,167,626,75,626,75,3.3304e+18,30.8673,277.763,701,38,45,500,417,366,362,150
44364,124,197,0,44364,42633,1731,2.51985e+16,26.1971,1218.43,44364,76,40,44167,44163,43838,43376,38130
8395,48,718,2126,6269,0,8395,3.0078e+13,140.861,1493.04,8395,228,74,7253,6750,6463,6377,2183
46350,2744,3007,46350,0,41857,4493,1.23205e+18,493.384,7176.32,46350,676,250,43343,43309,43343,43237,40224
17545,428,459,0,17545,3980,13565,7.2749e+15,202.619,1895.45,17545,194,104,17086,17086,17066,17082,16729
16792,161,1001,15659,1133,15659,1133,2.07451e+18,389.595,2599.19,16792,276,149,15214,14563,13329,13451,6880
11259,334,378,0,11259,3134,8125,1.62084e+16,141.773,1120.82,11259,89,80,10881,10876,10877,10872,10223
47291,335,785,0,47291,13160,34131,1.60892e+16,271.271,2786.53,47291,198,163,46492,46189,44171,44203,27327
6594,35,56,0,6594,6547,47,2.58332e+16,18.8822,350.518,6594,23,27,6538,6538,6274,6294,4440
36101,482,2344,0,36101,4661,31440,1.39571e+16,11.8935,4434.31,36101,1173,13,33757,33757,24941,25632,17038
14547,80,1306,13692,855,13692,855,6.94553e+17,287.655,2920.05,14547,241,176,11996,10195,9620,10364,2677
38602,2443,2807,835,37767,0,38602,1.98979e+12,56.2836,5373.16,38602,482,56,35795,35795,35376,34956,32076
37806,748,964,8112,29694,0,37806,1.83452e+13,399.059,3507.67,37806,335,177,36842,36710,36556,36636,33987
13277,16,61,0,13277,13167,110,2.47863e+16,39.2617,510.599,13277,31,30,13063,12857,12247,12085,8930
27844,945,1808,0,27844,3595,24249,1.39599e+16,11.8931,3462.38,27844,907,12,26036,26036,25173,25173,18300
45884,318,1021,34578,11306,0,45884,8.30354e+18,374.744,3340.26,45884,253,188,44552,42837,38675,38760,21960
33741,1670,3157,0,33741,0,33741,4.50608e+17,321.519,5637.86,33741,378,142,30584,30584,28168,24081,21333
1011,70,101,0,1011,269,742,7.69899e+15,53.9159,268.398,1011,54,36,893,822,869,882,705
9510,211,578,0,9510,1102,8408,7.75458e+15,85.8977,1412.65,9510,272,49,8932,8932,8326,8596,4263
43827,405,691,43763,64,43827,0,3.78379e+18,387.625,3529.55,43827,259,156,43004,42741,40682,39586,34475
34887,7,14,34763,124,34887,0,8.72578e+13,8.16092,378.665,34887,11,10,34863,34859,34324,34313,33449
18693,14,18,18288,405,18693,0,9.65508e+13,8.28476,302.555,18693,14,12,18675,18674,18459,18456,17727
49567,1675,1749,43447,6120,43447,6120,1.75941e+18,395.728,5508.88,49567,380,214,47818,47818,47818,47817,47691
15334,479,1108,0,15334,0,15334,1.77092e+18,374.457,2452.27,15334,420,121,14125,13673,12997,13649,9642
41494,985,2294,41494,0,32400,9094,1.004e+18,334.432,5383.87,41494,320,299,39200,39184,38318,35742,30628
2600,364,501,2251,349,2251,349,2.17472e+18,153.253,903.717,2600,154,70,2099,2069,1894,1966,1463
25655,147,1344,25655,0,23991,1664,9.08241e+17,460.377,3750.6,25655,337,210,23193,21472,18605,18746,8042
4646,275,342,4583,63,4646,0,3.25906e+18,103.94,812.022,4646,117,67,4304,4304,4276,4269,3998
6211,41,489,5786,425,5786,425,5.51372e+17,145.372,1187.89,6211,135,83,4535,3174,3204,3242,1159
35296,30,34,0,35296,33611,1685,2.46577e+16,30.6424,615.06,35296,28,29,35244,35136,35027,35217,32561
30540,1700,2494,30540,0,29927,613,2.56981e+18,390.774,4901.55,30540,371,143,28046,28046,27750,27691,21839
8845,13,84,0,8845,8799,46,2.05053e+16,20.1559,500.449,8845,33,28,8688,8549,8061,8230,5393
39330,108,1660,0,39330,10414,28916,1.33034e+16,273.356,4281.15,39330,336,168,36401,35203,30574,23371,8832
31751,20,98,0,31751,31646,105,2.23247e+16,28.637,911.672,31751,42,32,31535,31377,27786,28090,22744
43185,113,497,43185,0,43185,0,4.17133e+18,273.778,3000.65,43185,192,216,40976,39070,27486,24689,14709
32918,536,801,0,32918,7161,25757,4.75018e+15,390.659,3030.32,32918,262,172,32105,31520,31134,31186,27776
45359,392,1998,0,45359,11154,34205,7.73451e+15,319.252,4448.81,45359,391,163,43325,43040,36570,37430,5779
19901,1,33,0,19901,18947,954,2.46325e+16,28.3299,456.527,19901,25,25,7593,7593,7593,7593,7593
31167,796,1852,0,31167,3666,27501,1.27128e+16,20.0136,2933.2,31167,932,926,29315,29315,18800,20372,21446
28970,133,1083,27066,1904,27066,1904,2.02466e+18,596.581,3515.65,28970,325,210,25746,23779,21746,22530,9355
48273,706,1360,45053,3220,45053,3220,2.05864e+18,695.766,4756.08,48273,440,257,46605,44549,44808,44116,30279
17603,144,424,17603,0,17603,0,4.96027e+18,253.228,1794.34,17603,171,123,16826,16193,12954,11612,9177
35042,1572,2041,28313,6729,0,35042,6.49376e+18,359.534,4919.57,35042,377,229,33001,33001,32909,33001,26434
40553,1002,1071,9943,30610,0,40553,2.61688e+13,363.742,3783.95,40553,528,124,39482,39482,39482,39482,39453
37854,105,785,28514,9340,28514,9340,7.01191e+18,354.646,2789.29,37854,209,167,35537,34711,25230,18459,9794
24748,4,11,23581,1167,24748,0,9.64947e+13,10.2301,351.253,24748,11,11,23357,22920,21023,18891,17736
28484,962,1836,26291,2193,26290,2194,1.33338e+18,374.234,4584.1,28484,505,137,26648,26541,25676,25742,15885
43643,609,2843,43643,0,43643,0,2.66169e+18,16.1599,5566.63,43643,1422,17,40800,40800,33850,36679,10114
41071,419,1372,41071,0,38384,2687,9.53729e+17,686.212,4507.8,41071,406,237,38403,36852,32721,31104,23948
25298,432,1575,0,25298,0,25298,2.13672e+18,494.951,3610.83,25298,471,201,23091,21997,20069,16543,3070
31546,560,605,23428,8118,31546,0,4.24321e+18,317.743,2691.9,31546,292,140,30941,30941,30883,30868,29912
40009,800,1389,10049,29960,0,40009,4.12066e+13,217.802,4344.66,40009,274,161,38620,38600,36923,32828,22578
45966,74,1897,0,45966,11288,34678,7.47569e+15,203.846,4529.38,45966,424,164,42470,40979,37291,30673,5276
37350,4,55,0,37350,36688,662,2.74706e+16,34.8586,631.916,37350,34,30,35876,35029,28069,30608,19541
15262,113,305,15262,0,15262,0,4.8147e+18,188.788,1453.65,15262,139,117,14637,14186,10996,10690,8458
16764,1222,1354,15451,1313,15450,1314,1.35477e+18,117.147,3046.82,16764,315,138,15410,15410,15410,15410,13975
45622,1464,1811,41063,4559,41063,4559,1.40549e+18,599.259,5493.77,45622,452,181,43811,43786,43647,43716,36104
45270,845,1649,40400,4870,40400,4870,2.71624e+18,389.703,5389.53,45270,454,220,43621,43446,39783,37917,24447
3750,3,11,3574,176,3750,0,9.62276e+13,7.91147,137.642,3750,10,9,3352,3243,2657,2651,2318
34410,1098,1437,0,34410,0,34410,1.2298e+18,529.615,4284.45,34410,385,239,32973,32813,32373,31951,25549
34397,79,795,30216,4181,0,34397,3.88975e+18,320.57,3511.37,34397,274,181,28927,24274,23777,24219,6229
20146,281,970,17737,2409,17737,2409,3.70602e+18,288.06,2321.94,20146,111,244,18980,18457,15943,12949,2901
29800,114,193,0,29800,28536,1264,2.4698e+16,27.4452,1012.56,29800,76,39,29607,29602,29352,29325,27629
35737,384,2069,32097,3640,0,35737,3.71888e+18,235.987,4845.44,35737,449,167,33630,33161,29118,28377,5041
16137,952,1189,14639,1498,0,16137,3.48416e+18,269.032,2718.73,16137,273,181,14948,14948,14948,14948,14068
19314,446,489,0,19314,4720,14594,5.91168e+15,223.563,2122.07,19314,257,117,18825,18825,18825,18825,18601
18785,303,928,0,18785,0,18785,1.22254e+18,455.46,2587.59,18785,283,165,17447,16867,16402,16049,7128
30232,252,842,6582,23650,0,30232,2.18893e+13,388.573,3121.14,30232,400,125,29137,28405,26593,24314,9521
18911,522,1257,17195,1716,0,18911,3.32094e+18,251.085,2917.05,18911,470,133,17654,17398,16954,15888,13041
28758,405,1335,26906,1852,26906,1852,6.45221e+17,636.503,3843.6,28758,397,204,26630,25692,24890,24963,16223
11755,1029,2015,11522,233,0,11755,6.42709e+18,14.0967,2441.75,11755,309,22,9740,9740,8759,8717,5972
8781,314,353,0,8781,2443,6338,1.61336e+16,122.492,986.173,8781,82,74,8428,8426,8422,8419,8036
4126,5,25,0,4126,4106,20,2.82398e+16,20.9147,213.952,4126,22,22,3665,3431,3040,3314,2168
11752,236,1050,11752,0,10933,819,9.32727e+17,392.136,2370.69,11752,230,151,10409,10104,8834,8490,4291
29296,662,925,29296,0,25750,3546,1.16533e+18,393.107,3551.69,29296,264,182,28371,28367,27572,26833,21872
4295,47,226,0,4295,1209,3086,1.61902e+16,49.4938,601.756,4295,53,54,4047,3952,3743,3757,1613
29953,670,750,29953,0,22569,7384,8.73114e+17,372.742,2642.65,29953,214,162,29203,29196,29127,27993,28245
22495,451,828,0,22495,5027,17468,5.6106e+15,223.657,2691.26,22495,361,108,21667,21541,20316,20616,12090
44279,732,2972,44279,0,39758,4521,2.38013e+18,378.896,6864.23,44279,489,242,41307,40939,34245,35361,19794
39295,796,842,8524,30771,0,39295,1.856e+13,450.815,3380.7,39295,294,206,38453,38452,38389,38369,37980
37446,1761,2882,36401,1045,36401,1045,3.16603e+18,378.318,5617.45,37446,409,154,34564,34554,32184,31157,23632
33624,680,3608,33624,0,33624,0,1.18104e+18,16.2431,5305.59,33624,1000,25,30016,30016,26442,29731,11918
12079,159,580,0,12079,0,12079,4.08377e+18,176.723,1497.69,12079,131,128,11385,11051,9882,6068,4781
23240,444,463,23240,0,23240,0,3.33532e+18,266.605,1953.88,23240,161,122,22777,22777,22748,22751,22612
14057,37,61,0,14057,13937,120,2.53332e+16,32.9126,509.107,14057,32,31,13986,13962,13653,13643,12514
40451,604,878,35514,4937,0,40451,3.88319e+18,345.792,3935.69,40451,305,189,39573,39564,39135,39169,29404
19575,1005,1100,18224,1351,0,19575,2.48081e+18,522.937,3016.87,19575,301,178,18475,18475,18432,18411,18104
5629,227,354,1284,4345,0,5629,1.88504e+13,94.0643,896.938,5629,107,74,5275,5263,5185,5186,4125
40741,248,1746,35891,4850,35891,4850,3.34882e+18,539.612,4960.79,40741,552,259,36674,34261,31162,26271,3395
22809,705,1135,22809,0,21354,1455,9.81608e+17,546.2,3219.52,22809,323,185,21510,20894,19604,18765,14705
18332,419,721,3978,14354,0,18332,1.90091e+13,328.998,2286.42,18332,257,149,17567,17234,17006,15871,12736
25452,1049,1596,25452,0,23721,1731,9.11631e+17,401.496,4148.54,25452,338,228,23856,23740,23191,22708,19748
49556,1122,1422,49556,0,46232,3324,9.17516e+17,727.473,5005.96,49556,389,259,48134,48096,46937,47260,45207
23128,505,548,22435,693,23128,0,3.99273e+18,254.438,2291.48,23128,173,149,22580,22574,22551,22554,22364
19337,22,40,0,19337,19224,113,2.06332e+16,20.6361,493.626,19337,20,20,19293,19282,19110,18983,16200
29240,35,62,0,29240,28944,296,2.5755e+16,29.0936,650.302,29240,33,32,29164,29113,28515,28334,21785
46102,457,1528,43048,3054,43048,3054,6.70183e+17,799.424,5028.48,46102,457,258,43066,41179,39858,40046,20777
19038,274,673,4964,14074,0,19038,2.93905e+13,170.125,1832.02,19038,105,130,18365,18260,16926,17545,11015
39267,8,14,39226,41,39259,8,7.84207e+12,13.5749,395.617,39267,14,14,39198,39168,39045,39057,25404
46937,490,1278,46937,0,41316,5621,1.16658e+18,431.918,4905.05,46937,353,226,45648,44031,42013,32720,21253
4925,267,387,0,4925,0,4925,4.12205e+18,77.2028,855.679,4925,87,78,4538,4511,4512,4528,3773
25089,14,42,0,25089,25063,26,2.08284e+16,28.722,549.567,25089,29,28,24792,24225,20782,21495,18780
40852,8,10,40564,288,40852,0,1.00396e+14,9.56768,395.144,40852,10,10,40825,40819,40622,40620,40686
14324,916,924,13153,1171,13153,1171,2.26944e+18,285.712,2509.03,14324,363,127,13400,13400,13400,13400,13339
40615,492,744,40611,4,40615,0,3.75595e+18,314.065,3239.59,40615,223,149,39871,39757,37584,37792,35640
40111,936,1063,0,40111,8705,31406,5.72714e+15,428.582,3813.73,40111,449,133,39048,39048,39009,39047,38217
37764,123,159,0,37764,36025,1739,2.45384e+16,29.1442,919.783,37764,75,37,37605,37605,37537,37555,37446
39302,265,269,39302,0,39302,0,3.03938e+18,208.079,1929.96,39302,200,50,39025,38921,39017,38994,38861
36901,401,618,36901,0,36901,0,4.0325e+18,317.088,3095.64,36901,210,144,36255,36134,34695,34043,31499
18681,478,1060,4671,14010,0,18681,2.95613e+13,139.443,2461.15,18681,169,135,17621,17605,17099,15601,12332
46527,1606,1711,11747,34780,0,46527,2.97509e+13,224.281,4119.01,46527,375,170,44816,44815,44715,44648,43868
37812,1944,2121,29924,7888,0,37812,7.00979e+18,331.969,5018.45,37812,388,228,35691,35691,35691,35691,34434
18489,3,6,18473,16,18489,0,5.3634e+13,5.99145,269.775,18489,6,6,16726,16286,15846,16286,11740
21175,453,689,0,21175,5198,15977,5.97916e+15,211.052,2353.64,21175,257,111,20486,20473,20334,20219,17756
46197,1090,1288,0,46197,10931,35266,7.87693e+15,310.443,4549.21,46197,308,200,44909,44907,44755,44799,42537
2427,6,7,2420,7,1734,693,7.60806e+13,5.10672,83.1293,2427,6,7,2420,2420,2419,2419,2419
1260,161,301,1153,107,0,1260,2.8609e+18,32.6357,479.023,1260,104,40,959,935,931,903,557
40638,18,727,11367,29271,0,40638,6.26819e+13,260.344,2497.9,40638,168,147,34059,27214,29326,11473,5819
29099,1438,1553,26191,2908,26191,2908,1.47661e+18,381.389,4109.32,29099,334,177,27546,27546,27505,27535,27089
19520,8,11,18619,901,19520,0,9.58204e+13,10.4075,311.586,19520,11,11,19460,19416,18862,18863,17053
46539,1298,3079,45387,1152,0,46539,7.39629e+18,26.1162,5855.13,46539,1512,23,43460,43447,37352,41022,23676
11105,592,986,10365,740,10365,740,6.4239e+17,214.626,2182.22,11105,219,139,10119,9944,9865,9942,8891
20861,510,1022,19431,1430,0,20861,2.4766e+18,460.999,2948.24,20861,278,175,19574,19091,18798,18680,9198
37359,27,1227,34947,2412,0,37359,2.34349e+18,594.272,4028.93,37359,316,212,26094,20607,18417,17324,4769
32774,463,1563,30532,2242,30532,2242,6.9796e+17,484.045,4433.28,32774,272,268,30891,29832,29227,29178,11368
29683,1290,1768,0,29683,3493,26190,1.27209e+16,20.009,2814.31,29683,889,883,27915,27915,23186,25301,24393
47002,565,2490,47002,0,42867,4135,1.05835e+18,384.601,6606.76,47002,783,155,44272,43457,40059,42212,13475
20043,189,1385,4552,15491,0,20043,2.90695e+13,156.745,2900.45,20043,394,114,18498,18263,16437,10514,4416
47115,875,3317,39292,7823,39292,7823,6.15257e+18,15.701,6074.81,47115,1468,26,43798,43797,29856,16202,15254
1848,90,393,1848,0,1745,103,8.58345e+17,48.4475,670.646,1848,103,41,1443,1367,1173,1292,617
25802,161,1447,23307,2495,23304,2498,1.28335e+18,288.553,3699.44,25802,495,138,23615,22268,21359,21620,6245
17813,838,1078,0,17813,0,17813,1.20545e+18,423.43,2808.71,17813,260,172,16735,16397,16455,15717,14110
3649,136,245,0,3649,1005,2644,1.57485e+16,44.0332,587.642,3649,54,60,3404,3389,3349,3375,2494
38896,7,13,38604,292,38896,0,9.72963e+13,12.4028,388.661,38896,13,13,38842,38831,36925,36919,29682
19345,4,7,19311,34,19345,0,8.26022e+13,6.95492,272.363,19345,7,7,18813,18537,16135,16138,16999
36338,210,625,36338,0,34754,1584,4.98855e+17,436.2,3211.59,36338,267,181,33334,29539,26503,16817,24342
30274,742,954,0,30274,7090,23184,7.45608e+15,214.217,3030.39,30274,228,125,29320,29320,29147,29103,27612
34726,1569,2341,31464,3262,0,34726,3.31287e+18,425.032,5522.42,34726,578,216,32385,32315,31705,30806,23088
30409,3,13,30209,200,30409,0,1.04763e+14,10.1796,338.394,30409,11,10,29341,28798,27597,28121,21212
18308,4,12,18074,234,18308,0,9.56598e+13,10.0613,261.617,18308,10,11,18026,17915,17163,17027,12920
36130,307,1507,5896,30234,0,36130,2.07058e+13,280.602,4221.54,36130,582,102,34488,33910,32890,26790,11548
23627,142,715,17825,5802,17825,5802,3.78656e+18,334.723,2326.49,23627,185,158,22031,21366,18117,18466,7203
35336,1127,2569,32135,3201,32135,3201,1.11662e+18,315.837,5782.29,35336,544,254,32767,32742,31217,31089,15911
8185,193,458,1339,6846,0,8185,1.97767e+13,143.985,1257.45,8185,176,59,7692,7507,7434,7553,4682
12311,324,742,10969,1342,0,12311,4.08238e+18,416.83,1817.71,12311,240,89,11181,10819,10231,10336,8534
16821,320,588,14761,2060,14761,2060,3.27013e+18,274.946,2235.8,16821,211,147,16153,15784,14716,14350,10468
11467,215,627,2447,9020,0,11467,1.78949e+13,250.376,1748.36,11467,226,126,10734,10501,10160,9357,5941
3056,68,228,0,3056,716,2340,4.79802e+15,78.5069,579.665,3056,79,49,2757,2482,2544,2554,1376
24874,669,967,6640,18234,0,24874,5.39453e+13,167.764,2879.69,24874,181,132,23907,23905,23259,23350,15558
38958,10,34,0,38958,37084,1874,2.46409e+16,30.5503,646.766,38958,30,31,38154,37182,29874,33870,22306
11230,335,968,10481,749,10481,749,6.57402e+17,222.467,2176.01,11230,221,129,10247,10022,9820,9835,7267
27971,569,1584,25532,2439,0,27971,3.17558e+18,330.941,4121.29,27971,307,182,26337,25794,25144,24938,14849
49950,1396,1681,44574,5376,0,49950,3.28952e+18,381.613,5695.59,49950,459,212,48269,48266,48042,48062,40578
9431,168,380,9431,0,9431,0,3.38201e+18,175.662,1205.56,9431,126,98,8963,8769,7914,7827,5212
30791,268,453,30791,0,30791,0,5.12417e+18,247.902,2496.61,30791,181,147,30294,29934,27754,26684,22007
13507,82,348,13507,0,13507,0,3.9741e+18,203.01,1400.42,13507,119,122,12319,11543,7605,6860,3709
30797,1109,1158,23503,7294,23503,7294,6.741e+18,301.243,3358.4,30797,212,196,29639,29639,29632,29632,29237
23998,683,867,23998,0,22328,1670,1.12623e+18,455.751,2820.73,23998,263,186,23131,22819,22561,22784,21755
14898,205,943,0,14898,3539,11359,6.53913e+15,171.274,2075.65,14898,444,91,13813,13648,12698,13441,8691
22293,56,1209,22293,0,20827,1466,9.74109e+17,510.678,3272.5,22293,304,191,17375,14321,12176,11563,3158
16215,263,447,0,16215,4524,11691,1.62296e+16,173.962,1410.78,16215,112,101,15768,15550,15423,15483,10802
11359,865,883,10588,771,10588,771,2.072e+18,236.244,2084.43,11359,170,129,10476,10462,10472,10475,10356
36396,58,815,27422,8974,0,36396,8.31142e+18,358.919,2804.21,36396,218,167,33137,30878,22022,23288,6405
35608,679,1594,8632,26976,0,35608,2.6702e+13,258.43,4026.24,35608,455,165,34014,33982,31098,29429,15398
18578,183,451,5162,13416,0,18578,6.30676e+13,189.505,1509.69,18578,118,103,18037,17588,17172,17077,10160
1830,135,355,1522,308,0,1830,6.18472e+18,23.694,506.335,1830,131,40,1475,1446,1336,1441,783
23659,346,858,20806,2853,20806,2853,1.73523e+18,372.553,3105.83,23659,240,172,22453,21718,21106,20863,9191
4628,274,429,0,4628,972,3656,5.02918e+15,68.8544,993.509,4628,118,52,4199,4199,4111,4169,3460
2674,247,606,2674,0,2465,209,6.25109e+17,56.2498,997.345,2674,134,61,2068,2021,2027,1951,956
12157,856,950,11344,813,11344,813,2.09545e+18,231.767,2212.11,12157,320,101,11207,11204,11157,11197,10693
35088,238,1278,30845,4243,30845,4243,3.29212e+18,320.406,4105.19,35088,287,176,32942,31604,26809,24007,9639
4649,201,358,4164,485,0,4649,3.81251e+18,150.566,850.016,4649,76,84,4278,3979,4071,4067,2739
17107,293,333,17107,0,17107,0,4.94928e+18,207.496,1585.93,17107,179,123,16774,16723,16494,16506,16552
13525,64,65,0,13525,13413,112,2.45982e+16,34.8801,517.845,13525,34,33,13460,13460,13460,13460,13459
40509,22,64,0,40509,40221,288,2.65256e+16,46.7925,874.354,40509,39,39,40277,40166,38209,36846,26468
30053,889,1203,28094,1959,28094,1959,2.01961e+18,596.04,3675.3,30053,315,202,28850,28387,28162,28084,25772
20173,1340,1485,18574,1599,18574,1599,2.48341e+18,287.829,3287.66,20173,591,113,18688,18688,18688,18688,17744
14196,109,653,3105,11091,0,14196,1.79052e+13,268.322,1935.11,14196,178,147,13159,12849,12069,10508,3406
19094,313,1156,17884,1210,17884,1210,6.55381e+17,408.583,2974.53,19094,293,168,17557,17147,16645,16631,10702
10450,39,383,2328,8122,0,10450,2.80182e+13,173.907,1393.84,10450,169,85,9062,8118,7623,2957,1830
12185,15,47,0,12185,12032,153,2.59372e+16,25.9861,432.952,12185,29,29,11917,11632,11157,10847,7517
27601,324,1686,25739,1862,0,27601,2.46719e+18,424.974,4288.49,27601,335,193,25488,24974,23792,23769,12396
1415,214,378,0,1415,0,1415,2.41875e+18,26.882,592.828,1415,89,65,1037,1037,862,837,733
29914,23,498,29914,0,29914,0,3.2531e+18,287.354,2241.81,29914,184,134,19147,11013,11492,10677,2052
7372,79,674,6574,798,0,7372,3.96244e+18,110.82,1397.37,7372,382,58,6167,5510,5053,5600,1695
32813,345,571,0,32813,7554,25259,7.41734e+15,221.397,2752.28,32813,233,139,32242,32228,31667,31933,23203
49784,175,885,0,49784,0,49784,4.12713e+18,388.181,3317.98,49784,275,185,47246,45921,33554,18543,15863
45903,908,1351,0,45903,0,45903,1.23977e+18,730.855,4663.03,45903,434,249,44552,43594,43062,39909,38806
7419,546,606,1699,5720,0,7419,2.64823e+13,48.5773,1239.32,7419,251,62,6813,6813,6783,6813,6295
26191,306,1524,26191,0,24430,1761,9.80737e+17,428.286,4093.71,26191,307,239,24160,23397,21174,21193,9222
8703,350,871,8703,0,8132,571,9.04314e+17,174.181,1865.96,8703,198,146,7832,7655,7035,6468,5426
44071,124,644,44071,0,42160,1911,4.92173e+17,506.792,3586.27,44071,271,200,37922,32617,30304,6700,18500
27247,638,761,6069,21178,0,27247,1.86878e+13,353.524,2705.21,27247,244,160,26486,26246,26285,26173,24614
27953,930,933,27953,0,24537,3416,1.18086e+18,374.725,3465.83,27953,262,176,27020,27020,27020,27020,27014
6088,283,684,5673,415,0,6088,2.56279e+18,104.505,1338.96,6088,222,68,5404,5394,5302,5232,3366
22941,372,642,20898,2043,22941,0,3.92964e+18,254.977,2467.89,22941,221,153,22296,22035,21190,20680,18719
28879,1431,1807,0,28879,6391,22488,6.31759e+15,245.399,4291.41,28879,501,172,27072,27072,26804,25891,21258
29569,816,1162,27661,1908,27661,1908,1.99423e+18,589.954,3634.9,29569,351,208,28395,27470,27605,27378,22188
35849,23,33,35317,532,35845,4,1.03195e+14,8.49792,434.225,35849,18,17,35816,35810,35038,35038,29485
11169,102,433,11169,0,11169,0,3.47505e+18,239.346,1619.49,11169,163,111,9941,8453,7602,5702,3484
4036,375,413,890,3146,0,4036,1.86216e+13,66.7163,920.253,4036,95,103,3623,3623,3621,3620,3505
36464,1740,1896,0,36464,0,36464,2.68936e+18,285.825,5157.07,36464,311,197,34568,34567,34514,34507,32595
4077,164,361,4077,0,3652,425,1.79995e+18,160.895,830.937,4077,82,84,3646,3392,3153,3503,1674
33227,496,2195,33227,0,29880,3347,1.54836e+18,245.309,5082.31,33227,323,285,31032,30777,27279,22502,14291
12720,196,1108,0,12720,0,12720,1.76429e+18,293.244,2220.67,12720,401,119,11366,10956,10298,9649,5312
2581,4,11,2439,142,2581,0,9.74973e+13,7.97094,114.926,2581,10,9,2439,2394,2125,1991,1429
37542,600,1559,33459,4083,0,37542,3.9699e+18,280.996,3737.31,37542,274,178,35983,35908,30872,30919,8756
2855,8,11,2716,139,2855,0,9.67177e+13,7.81226,120.605,2855,10,9,2837,2828,2776,2777,2502
2183,202,209,2183,0,2183,0,4.56396e+18,78.6587,519.319,2183,69,59,1974,1974,1971,1971,1960
3369,1,7,3368,1,3369,0,8.0207e+13,6.78124,113.043,3369,7,7,1867,1867,1867,1867,1867
24596,17,705,21638,2958,21638,2958,3.23152e+18,322.048,2871.6,24596,247,160,16580,13154,12350,9570,1789
42606,29,64,0,42606,42315,291,2.56817e+16,51.256,913.435,42606,41,42,42415,42348,40518,40675,31505
12808,23,27,0,12808,12797,11,1.77219e+16,12.7242,350.866,12808,19,21,12781,12779,12739,12741,12433
30525,1257,1546,8218,22307,0,30525,5.86884e+13,178.618,3519.12,30525,259,156,28979,28979,28911,28979,27030
41851,9,13,41568,283,41851,0,1.01302e+14,11.6105,403.301,41851,13,12,41819,41809,40057,40055,37172
33934,295,1171,7416,26518,0,33934,1.82946e+13,385.181,3718.44,33934,334,178,32305,31600,30810,24988,19171
43564,486,1836,38766,4798,38764,4800,1.05567e+18,295.831,4442.16,43564,296,192,41728,41524,40202,40500,3430
42482,585,1230,39596,2886,39596,2886,2.09302e+18,682.741,4391.3,42482,355,237,40609,38635,39071,38313,31014
1035,55,206,1035,0,971,64,9.45386e+16,55.9092,347.125,1035,78,42,784,743,696,642,309
40879,43,60,0,40879,40580,299,2.60334e+16,37.1901,760.258,40879,35,37,40816,40800,40248,40574,37281
12540,8,12,12309,231,11190,1350,8.12105e+13,6.0126,233.53,12540,9,8,12528,12528,12493,12493,11997
42629,718,1123,0,42629,9567,33062,4.96121e+15,469.456,3980.45,42629,360,211,41506,41416,40071,40060,29915
24709,168,576,21894,2815,24709,0,3.27993e+18,320.38,2490.08,24709,272,144,23447,22668,19271,16210,10531
19962,853,1131,17796,2166,17796,2166,3.37447e+18,443.95,2736.26,19962,331,151,18831,18816,18713,18822,15956
24406,608,677,24402,4,24406,0,4.85851e+18,242.799,2572.89,24406,193,126,23729,23728,23729,23729,23168
11954,26,381,3344,8610,0,11954,6.27525e+13,141.502,1142.43,11954,85,87,10857,9643,9346,4640,2679
43029,352,2282,0,43029,0,43029,1.8001e+18,269.442,5710.82,43029,499,173,40568,39781,35562,18547,8473
18264,58,456,0,18264,5072,13192,1.62455e+16,177.897,1499.3,18264,113,97,17277,16895,14469,14919,5601
26582,651,1299,0,26582,0,26582,4.12801e+18,267.693,3127.63,26582,282,147,25283,25265,24645,23745,23341
31626,41,67,0,31626,31267,359,2.5359e+16,40.684,827.154,31626,35,41,31543,31477,30580,30753,27926
49017,7,12,48757,260,46721,2296,8.10025e+13,6.83667,447.549,49017,10,8,49004,49000,48198,48197,46836
17926,316,518,17926,0,17926,0,3.40054e+18,325.317,1746.34,17926,424,35,17166,16028,16586,16445,12478
11084,28,32,0,11084,11065,19,2.12325e+16,26.822,356.053,11084,27,28,11047,11027,10555,10642,10329
25915,1596,1785,0,25915,0,25915,1.51413e+18,284.456,4187.23,25915,464,225,24130,24130,24130,24130,23066
4963,209,464,4732,231,4963,0,4.22394e+18,146.788,1135.6,4963,126,79,4476,4268,3792,3453,2906
2124,199,297,2124,0,2006,118,2.46889e+18,87.3785,553.827,2124,93,47,1827,1827,1758,1815,1534
22078,73,1319,20680,1398,20680,1398,6.82437e+17,392.3,3409.97,22078,229,206,18016,14795,14355,15287,2480
5652,481,539,5120,532,0,5652,3.46053e+18,105.485,1160,5652,254,57,5113,5113,5111,5111,4694
26841,1680,2058,26841,0,23165,3676,1.0245e+18,363.637,4537.8,26841,434,244,24783,24783,24461,20488,20825
3153,271,459,2953,200,0,3153,2.34102e+18,82.0495,900.11,3153,120,55,2694,2694,2633,2615,2194
10041,8,15,9740,301,10041,0,9.22838e+13,8.3177,227.023,10041,10,12,10011,10000,9143,9216,7688
27632,1298,1704,25499,2133,25498,2134,1.34055e+18,420.344,4472.95,27632,580,127,25928,25864,25928,25928,20126
26394,431,1143,24672,1722,0,26394,2.3606e+18,549.7,3397.07,26394,316,187,24717,24046,23604,23586,16637
25290,813,1264,22047,3243,22047,3243,1.77937e+18,322.756,3572.99,25290,292,169,24026,24023,23814,24011,23215
48967,1142,1678,0,48967,11568,37399,6.61151e+15,314.207,4911.9,48967,363,204,47289,47260,46552,46824,33684
39612,412,2216,35720,3892,35720,3892,2.95197e+18,264.487,5399.8,39612,441,250,37375,36866,34876,32858,15069
37945,2452,2491,34737,3208,0,37945,3.01407e+18,396.934,6011.62,37945,571,232,35454,35454,35454,35454,35265
23282,8,422,23282,0,23282,0,5.21151e+18,268.303,2022.72,23282,193,128,13002,8955,7122,5894,2456
26518,73,89,0,26518,25670,848,2.43581e+16,30.3189,894.557,26518,40,32,26429,26426,25991,26274,22031
29696,350,569,29696,0,29696,0,3.50517e+18,306.231,2832.45,29696,208,173,29121,28701,27474,25555,20907
35441,523,1560,32570,2871,0,35441,2.91302e+18,456.265,4515.75,35441,361,205,33644,32599,31747,31205,19428
25717,407,721,19388,6329,19388,6329,3.7906e+18,324.734,2367.44,25717,186,158,24972,24130,24541,24458,16973
10856,385,682,1542,9314,0,10856,2.41394e+13,86.3539,1736.8,10856,264,62,10174,10164,10095,10085,6824
1008,6,9,995,13,1008,0,1.04436e+14,5.19643,60.3431,1008,8,8,996,993,973,971,873
7570,285,543,6620,950,6620,950,1.49055e+18,341.482,1536.54,7570,218,90,6627,5716,5741,5953,5269
6929,396,470,6929,0,6929,0,3.40995e+18,213.449,1025.2,6929,180,26,6459,6410,6414,6424,5781
26337,26,62,0,26337,26045,292,2.58715e+16,26.3506,612.116,26337,31,32,26256,26204,25393,25325,19859
10178,438,525,7686,2492,7686,2492,6.96689e+18,198.502,1349.64,10178,126,98,9653,9646,9594,9582,8775
17806,1322,1744,17806,0,13360,4446,3.59035e+18,25.001,2406.43,17806,607,474,16062,16062,15048,15250,15511
17250,912,1337,15747,1503,0,17250,3.17678e+18,192.051,3021.64,17250,288,147,15913,15872,15749,15774,10819
31151,29,68,0,31151,30999,152,2.68583e+16,27.4535,680.641,31151,28,27,31074,31036,30525,30445,22905
43282,8,11,41230,2052,43282,0,9.62037e+13,10.7091,465.337,43282,11,11,43143,43048,41801,41802,39230
19041,547,1040,0,19041,0,19041,1.23039e+18,482.805,2821.25,19041,300,181,17860,17214,17194,16429,11892
1532,160,254,1532,0,1532,0,2.9839e+18,60.0046,487.544,1532,90,48,1278,1268,1234,1181,1004
37575,676,2149,34303,3272,34303,3272,2.71722e+18,343.654,5458.82,37575,536,188,35386,34986,32751,29589,12660
49298,1769,1803,7991,41307,0,49298,2.13222e+13,426.103,5348.31,49298,623,106,47495,47495,47495,47495,47405
1129,77,196,1091,38,1129,0,3.50523e+18,27.5492,335.984,1129,83,28,933,911,866,787,499
48615,111,928,48615,0,36618,11997,8.10379e+17,425.322,3524.77,48615,274,194,45076,43630,35721,36539,6630
14170,280,976,13230,940,0,14170,2.4115e+18,239.175,2363.44,14170,233,144,13061,12878,12330,12319,8693
2023,120,253,1525,498,1525,498,3.76175e+18,66.7553,536.696,2023,62,62,1770,1742,1723,1713,1504
20690,90,1055,0,20690,0,20690,1.70032e+18,297.505,2882.15,20690,306,152,17365,15971,15404,7264,2292
26588,110,458,26588,0,26588,0,4.85525e+18,284.111,2233.66,26588,185,148,25009,23746,17200,15197,10043
3604,3,5,3604,0,3604,0,3.62387e+13,4.9667,113.726,3604,5,5,3292,3138,3138,3023,3138
9158,456,464,8204,954,8204,954,8.90821e+17,209.868,1301.79,9158,101,116,8694,8694,8686,8691,8669
38392,1005,1321,0,38392,0,38392,1.16809e+18,713.816,4315.26,38392,429,232,37071,36908,36347,34535,32115
30530,497,1800,0,30530,0,30530,2.34076e+18,264.306,4730.53,30530,314,185,28718,28238,24478,18531,12964
44571,1093,1811,10861,33710,0,44571,3.16372e+13,265.059,4108.68,44571,331,279,42760,42759,38957,40659,25331
42939,378,2022,38316,4623,38316,4623,1.42558e+18,444.487,5741.94,42939,536,175,40213,36541,34168,35465,13683
8426,290,423,8067,359,0,8426,1.63926e+18,296.702,1425.46,8426,172,104,7838,6941,7215,7403,6830
48952,671,1029,36859,12093,36859,12093,7.03518e+18,367.873,3458.94,48952,255,193,47923,47872,47226,46683,41300
20692,342,450,4797,15895,0,20692,2.88034e+13,198.03,2036.48,20692,202,116,20242,20234,20059,20179,17258
13153,32,316,13153,0,13153,0,4.801e+18,188.719,1376.16,13153,135,114,10212,7942,6169,5499,3159
43276,994,1034,43276,0,32604,10672,8.57351e+17,390.909,3468.46,43276,262,179,42242,42242,42197,41991,41858
13215,56,484,3429,9786,0,13215,2.92212e+13,169.781,1354.35,13215,88,117,12083,11705,10811,10741,3186
19277,291,621,0,19277,0,19277,1.8568e+18,321.072,2445.48,19277,235,154,18454,17926,16511,16322,7614
38512,416,1538,0,38512,0,38512,1.75878e+18,338.069,4407.89,38512,488,201,36690,36291,33087,30070,13513
9728,593,787,9099,629,9099,629,5.83337e+17,188.315,1837.3,9728,181,100,8941,8889,8907,8909,8309
39773,694,1322,37046,2727,37046,2727,2.10665e+18,684.949,4351,39773,386,236,38142,36554,36566,36102,24063
28768,1034,1170,26883,1885,0,28768,2.38325e+18,518.143,3499.74,28768,302,188,27598,27541,27439,27418,26097
20773,303,1584,20638,135,20638,135,3.81981e+18,83.3554,3103.52,20773,434,63,19189,18897,17597,8703,5988
2557,4,10,2523,34,2557,0,8.16796e+13,4.85647,93.5158,2557,8,8,2537,2532,2044,2382,1830
39112,504,2169,35118,3994,0,39112,3.72908e+18,238.969,5194.07,39112,483,172,36943,36664,32193,31429,6875
13705,7,15,13146,559,13705,0,9.48663e+13,9.76855,269.415,13705,11,11,13604,13544,12187,12261,9453
35903,592,1129,0,35903,7560,28343,4.91313e+15,340.802,3690.69,35903,295,214,34774,34651,32844,32750,17790
21951,544,1159,0,21951,5455,16496,7.41524e+15,157.223,2749.46,21951,193,143,20792,20753,20273,20444,14922
44326,244,2325,34278,10048,34184,10142,3.56484e+18,339.683,5437.23,44326,395,254,41205,39817,38357,38066,13345
26566,1972,2368,19531,7035,19531,7035,5.49229e+18,21.9711,3045.05,26566,796,792,24198,24198,21477,20576,23679
45007,5,11,42884,2123,45007,0,9.60501e+13,10.7216,474.123,45007,11,11,43535,43344,39534,38856,31647
13845,391,558,10425,3420,0,13845,8.32694e+18,249.185,1596.48,13845,142,116,13287,12980,13102,13114,10830
13684,148,1071,13684,0,12783,901,9.08038e+17,389.524,2532.79,13684,256,159,11995,11186,9536,9826,5334
6888,494,537,6886,2,6886,2,3.83975e+18,16.9364,1068.76,6888,268,17,6351,6351,6322,6142,5946
15901,6,8,15842,59,15901,0,1.13751e+14,6.78442,230.662,15901,8,8,15876,15851,15381,15380,13240
10778,819,1176,9587,1191,0,10778,4.01924e+18,133.99,2170.33,10778,384,88,9602,9600,9327,9307,7009
24446,934,1851,0,24446,0,24446,1.20437e+17,69.5909,3598.27,24446,434,63,22595,22595,21508,19640,13174
7229,850,1161,7229,0,7229,0,1.42251e+18,13.2154,1764.99,7229,242,18,6068,6068,5907,5920,4767
21760,418,1406,20066,1694,0,21760,2.80932e+18,363.363,3572.96,21760,290,183,20110,19674,19018,18743,7585
2675,250,463,0,2675,0,2675,2.36554e+18,72.8819,770.458,2675,135,69,2212,2187,2074,2212,1541
30811,643,905,6436,24375,0,30811,2.17519e+13,452.165,3223.1,30811,363,124,29906,29605,29699,29709,20212
15382,542,1052,14309,1073,0,15382,2.52608e+18,474.944,2640.97,15382,286,173,14239,13690,13518,13427,8908
35328,759,809,31010,4318,31010,4318,3.27482e+18,320.542,3577.78,35328,298,183,34519,34519,34481,34440,33147
37559,409,697,10491,27068,0,37559,6.30616e+13,246.766,2380.16,37559,159,136,36862,36759,36016,36182,25982
7649,94,539,0,7649,1633,6016,4.92713e+15,118.387,1390.15,7649,131,107,6960,6724,6297,5287,3428
13003,428,967,12152,851,12152,851,6.37985e+17,265.215,2307.27,13003,197,159,12017,11728,11549,11619,9442
29314,203,385,7681,21633,0,29314,1.287e+13,270.569,2209.58,29314,217,127,28635,27048,26941,26876,24966
41347,544,790,31194,10153,31194,10153,6.96204e+18,375.358,2913.22,41347,220,175,40557,40478,40051,39880,34160
39615,2319,2494,39615,0,36020,3595,1.17704e+18,368.911,6172.24,39615,511,276,37121,37121,37121,37121,35345
46133,871,2299,41767,4366,0,46133,3.47535e+18,313.016,5983.24,46133,553,212,43834,43816,39593,38993,11304
733,24,153,733,0,733,0,5.09495e+18,42.8813,274.448,733,32,41,527,434,319,329,145
2284,99,162,2284,0,0,2284,7.29406e+18,14.7496,377.263,2284,81,15,2122,2122,2059,2059,1474
34764,274,1272,32447,2317,32447,2317,6.40765e+17,659.194,4072.79,34764,353,219,32042,31201,29869,29921,17447
16961,626,787,15173,1788,15173,1788,3.28188e+18,233.496,2049.63,16961,115,139,16174,16149,15833,15833,13701
33595,10,17,32202,1393,33595,0,9.54064e+13,10.3327,416.311,33595,15,12,33569,33559,32537,30991,23121
33901,65,68,0,33901,33831,70,2.01544e+16,30.4064,712.381,33901,34,36,33833,33833,33572,33596,33558
1694,82,208,0,1694,0,1694,1.11065e+18,90.0159,462.699,1694,67,49,1414,1184,1274,1335,824
26816,536,560,26816,0,26816,0,3.52338e+18,306.533,2688.09,26816,202,160,26256,26256,26212,26110,25964
29992,215,843,6977,23015,0,29992,2.30123e+13,242.096,3080.7,29992,376,129,28790,27004,26688,24992,12456
28669,9,13,28450,219,28669,0,1.02108e+14,10.2693,329.77,28669,11,10,28647,28641,27715,27715,27588
8728,118,211,8728,0,8728,0,2.03403e+18,59.6668,716.359,8728,68,62,8517,8512,8342,8441,6482
31390,98,465,31390,0,31390,0,5.07767e+18,251.821,2455.47,31390,194,163,29657,27871,20105,19323,13520
13874,8,10,13833,41,13810,64,9.72402e+13,6.37459,220.31,13874,8,8,13864,13864,13846,13845,12704
10840,7,11,10784,56,10840,0,1.0493e+14,7.53745,208.543,10840,10,10,10809,10773,10436,10437,9487
35120,401,770,26478,8642,26478,8642,6.9892e+18,354.536,2683.05,35120,203,176,34321,33387,33254,32473,23176
29329,9,357,29329,0,29329,0,3.78914e+18,243.304,2102.12,29329,153,156,12929,6694,4890,4583,1631
37294,1334,2056,0,37294,0,37294,1.73546e+18,320.869,5140.53,37294,446,225,35238,35186,35226,35226,28427
4082,5,7,4048,34,4082,0,9.60547e+13,6.66169,116.856,4082,7,7,4052,4033,3883,3882,3689
46246,1897,3777,38039,8207,37959,8287,2.58765e+18,406.167,7972.08,46246,782,314,42469,42453,42287,41539,19808
40180,937,1030,8721,31459,0,40180,2.25713e+13,417.489,3796.08,40180,432,139,39150,39150,39080,39142,36837
16965,258,920,15054,1911,0,16965,4.12082e+18,206.014,2132.33,16965,114,159,15997,15683,14298,14250,6733
12020,198,787,0,12020,1552,10468,1.39529e+16,11.8797,1577.81,12020,397,12,11233,11233,8646,8843,5975
33665,613,805,0,33665,8356,25309,6.88009e+15,213.995,3230.96,33665,328,145,32860,32860,32662,32780,27304
3611,4,7,3569,42,3611,0,1.03205e+14,6.66713,112.54,3611,7,7,3534,3503,3400,3380,2718
21465,383,1227,20046,1419,20046,1419,6.95762e+17,577.533,3317.24,21465,320,184,19685,18976,18298,18330,9967
19709,1917,2092,19709,0,17942,1767,1.17227e+18,237.566,4206.16,19709,421,222,17617,17617,17603,17593,16763
2057,30,110,582,1475,0,2057,6.63019e+13,36.6451,327.19,2057,44,41,1900,1774,1684,1446,948
3665,67,258,3665,0,3665,0,4.74011e+18,93.8778,739.192,3665,91,70,3219,2784,2389,2193,1553
31905,48,759,24033,7872,24033,7872,3.8091e+18,379.742,2717.65,31905,208,178,27416,18492,18617,18802,3949
12228,742,1351,11015,1213,11015,1213,1.68429e+18,134.366,2463.35,12228,600,67,10877,10848,9646,10075,6668
13785,960,1080,12868,917,12868,917,2.0305e+18,380.627,2507.67,13785,297,152,12705,12627,12668,12653,12214
33839,1086,1589,0,33839,8869,24970,1.27992e+16,270.659,4013.3,33839,318,162,32250,32250,31950,31823,21222
1038,89,225,1038,0,1038,0,5.22244e+18,38.6782,388.956,1038,54,40,813,772,590,511,442
46387,399,896,34924,11463,34924,11463,3.81758e+18,399.807,3391.69,46387,277,187,45373,43508,43970,43858,27629
2609,110,180,0,2609,599,2010,4.61205e+15,73.2959,491.012,2609,69,48,2429,2406,2367,2368,1945
24398,491,1092,22704,1694,0,24398,2.54612e+18,450.804,3141.13,24398,290,171,23156,22497,22275,21997,13819
10863,1007,1062,10161,702,10161,702,2.01357e+18,190.034,2175.6,10863,275,75,9801,9801,9801,9801,9694
9626,89,449,8615,1011,9626,0,2.97698e+18,192.413,1408.15,9626,135,93,8627,7512,7229,6211,3213
42700,2215,2615,42700,0,38582,4118,1.31061e+18,356.031,6332.34,42700,682,152,40085,40085,40076,40085,33394
3333,297,370,3333,0,3181,152,6.0578e+17,76.0036,774.532,3333,112,46,2963,2962,2892,2963,2583
8783,8,13,8703,80,8783,0,1.04027e+14,6.06296,181.287,8783,8,9,8770,8770,8405,8403,6742
23873,685,1280,0,23873,0,23873,1.23329e+18,567.267,3464.72,23873,310,209,22513,21639,21288,19845,12620
2808,168,428,0,2808,0,2808,1.72781e+18,180.021,864.104,2808,129,86,2275,2075,2089,2066,1131
7768,119,262,1995,5773,0,7768,1.09105e+13,185.643,1047.26,7768,154,75,7163,6620,6770,6849,4979
35498,38,53,0,35498,34902,596,2.24833e+16,20.995,790.443,35498,29,25,35445,35442,35384,34828,31800
23267,10,66,0,23267,22951,316,2.49246e+16,17.4963,579.676,23267,22,31,23079,22924,21601,21936,14628
813,93,182,813,0,813,0,6.48261e+18,18.4895,300.535,813,65,30,631,623,495,494,406
6787,113,343,6787,0,6787,0,3.33367e+18,154.011,1006.22,6787,102,87,6346,6162,5049,4947,2785
43648,185,1212,0,43648,10158,33490,6.32673e+15,243.934,4258.49,43648,390,153,41640,39592,36439,32110,11214
18452,1,11,17610,842,18452,0,9.59969e+13,10.4793,303.344,18452,11,11,7217,7217,7217,7217,7217
22174,845,1055,20742,1432,20742,1432,2.00489e+18,445.998,3015.44,22174,255,184,21119,20995,20791,20747,19259
46285,1688,1942,46285,0,43145,3140,9.66962e+17,558.611,5769.84,46285,413,291,44343,44337,43205,43548,40557
16385,10,60,0,16385,16296,89,2.66198e+16,34.4623,554.929,16385,32,30,15743,15096,14526,14010,9443
32298,654,756,24288,8010,24288,8010,7.06582e+18,337.325,2570.18,32298,208,152,31542,31528,31452,31427,30261
27136,821,1538,5316,21820,0,27136,2.3671e+13,190.019,3832.32,27136,407,174,25598,25573,25089,25559,14319
22322,637,1181,3245,19077,0,22322,2.17029e+13,231.331,2907.56,22322,427,85,21141,20844,20672,20788,13177
49691,99,1045,37482,12209,37482,12209,3.7876e+18,390.723,3675.57,49691,264,207,46119,44654,35041,36111,7572
24578,1013,1249,22948,1630,22948,1630,6.9959e+17,630.496,3523.99,24578,310,202,23329,23278,23108,23160,21632
32578,738,1147,7453,25125,0,32578,2.37098e+13,232.694,3591.56,32578,352,134,31431,31421,30732,31096,24173
43356,739,2295,43356,0,33440,9916,9.20197e+17,320.178,5291.95,43356,316,298,41061,41016,40160,38507,34347
17738,532,742,0,17738,4022,13716,4.20045e+15,322.047,2185.33,17738,279,138,16996,16729,16665,16768,14759
18491,29,45,0,18491,18360,131,2.57897e+16,32.1297,471.095,18491,27,27,18419,18375,18190,18243,14528
48606,1057,1319,45372,3234,45372,3234,2.04707e+18,690.865,4778.65,48606,403,251,47287,47258,46657,46623,43539
44308,316,1200,38935,5373,38935,5373,3.05528e+18,348.997,4739.47,44308,400,215,42442,40164,35643,32146,14370
28785,161,817,0,28785,6264,22521,5.67501e+15,310.4,2952.8,28785,368,129,27020,25379,24523,24474,10276
35921,31,55,0,35921,35754,167,2.74742e+16,26.0173,659.014,35921,26,27,35864,35838,35494,35429,30093
49407,13,55,0,49407,49195,212,2.65263e+16,30.6174,773.677,49407,26,29,49179,48988,44608,46207,31893
23700,5,9,23651,49,15676,8024,6.81243e+13,8.14418,345.363,23700,9,9,23577,23497,21385,21415,19775
24681,119,823,18610,6071,0,24681,8.29039e+18,291.578,2359.91,24681,183,156,23070,22413,17055,17349,7420
32354,169,1181,0,32354,0,32354,1.22644e+18,644.267,3865.7,32354,350,227,28872,27655,25179,22692,11519
47521,51,68,0,47521,47250,271,2.6551e+16,32.361,854.439,47521,32,33,47453,47444,47106,47294,41964
39527,327,734,39463,64,39527,0,3.13947e+18,364.128,3369.46,39527,252,158,38575,37734,34804,33150,24146
11146,75,539,11146,0,8405,2741,8.95872e+17,251.39,1512.94,11146,138,123,10077,9433,7879,7866,2214
6164,27,41,0,6164,6121,43,2.57182e+16,15.2481,255.514,6164,20,18,6123,6120,6080,6123,5857
35419,6,57,0,35419,34841,578,2.74771e+16,35.5805,616.784,35419,34,30,34748,34277,29258,31403,19400
12009,40,947,10841,1168,10841,1168,3.05506e+18,340.012,1892.06,12009,401,96,10050,9228,8442,7856,3175
41620,30,75,0,41620,41238,382,2.61672e+16,45.0015,967.119,41620,36,45,41469,41400,39735,39702,31848
34859,1331,1378,34859,0,32608,2251,9.51629e+17,498.522,4330.39,34859,311,239,33481,33480,33435,33382,33187
25966,2,10,25877,89,25845,121,9.9274e+13,7.58076,300.549,25966,8,8,23226,22903,20280,22030,15057
25824,7,10,25735,89,25760,64,1.04507e+14,7.8046,300.658,25824,9,10,25801,25776,25118,25118,22238
44543,746,2296,39921,4622,0,44543,3.51503e+18,410.195,5982.44,44543,502,240,42247,41948,40643,40621,25594
10423,808,1129,9504,919,9504,919,8.23549e+17,131.431,2334.75,10423,198,166,9294,9274,9180,9166,5840
20477,23,43,0,20477,20348,129,2.59453e+16,31.7689,482.381,20477,27,29,20393,20336,20000,20202,17683
46583,1181,1406,46583,0,43547,3036,9.56592e+17,712.585,4775.64,46583,436,249,45177,45166,44265,44596,43298
29487,437,781,29487,0,22207,7280,8.0898e+17,364.775,2651.01,29487,217,165,28691,28283,27118,24555,18254
12391,258,663,0,12391,2763,9628,4.65808e+15,167.006,1793.7,12391,185,111,11703,11536,11266,10734,7989
48926,862,1297,0,48926,0,48926,1.19407e+18,690.096,4672.4,48926,416,236,47573,46326,46156,42551,41039
48934,973,1334,13460,35474,0,48934,6.27967e+13,265.81,3612.58,48934,302,142,47600,47598,47418,47529,46904
25522,23,35,0,25522,25472,50,1.75048e+16,15.5062,545.029,25522,24,21,25487,25480,25303,25366,23191
17775,570,624,13382,4393,13382,4393,3.81765e+18,276.906,1932.06,17775,167,137,17151,17147,17142,17140,16680
21622,1,12,21155,467,19810,1812,8.07378e+13,6.86694,299.85,21622,9,8,12990,12990,12990,12990,12990
38824,459,726,10812,28012,0,38824,6.29318e+13,251.271,2486.31,38824,167,143,38098,38017,37424,37587,30253
40424,744,920,35658,4766,0,40424,3.80928e+18,356.519,3950.46,40424,314,203,39504,39504,39281,39334,35079
37991,109,663,37991,0,37991,0,3.48074e+18,324.139,3348.17,37991,209,187,34589,29497,26253,18810,7195
48469,924,1936,45283,3186,0,48469,2.39434e+18,555.053,5806.32,48469,477,246,46533,46010,45353,45076,33960
36581,656,1290,34104,2477,34104,2477,2.06733e+18,672.761,4182.55,36581,396,228,34929,33388,33645,33090,21870
31153,893,1208,0,31153,0,31153,1.9165e+18,291.949,3692.67,31153,265,178,29945,29945,29746,29945,29134
3508,173,393,3082,426,3082,426,1.69711e+18,117.468,917.885,3508,110,85,3114,3046,2935,2931,2539
31513,569,1254,31513,0,29347,2166,9.76679e+17,659.921,3925.9,31513,343,227,29762,28219,25974,24715,18322
3839,479,533,0,3839,0,3839,1.2781e+18,109.715,972.969,3839,205,45,3306,3296,3275,3259,3151
32922,413,1282,32922,0,28973,3949,1.12644e+18,386.987,4197.07,32922,303,192,31408,30376,28615,22592,9919
1645,104,269,1645,0,1470,175,6.13591e+18,82.7945,479.16,1645,120,39,1360,1202,789,723,747
36520,1056,1446,34086,2434,34086,2434,6.67179e+17,631.44,4540.31,36520,326,239,35074,34882,34673,34822,30727
45099,261,605,0,45099,0,45099,7.88825e+17,444.766,3490.08,45099,274,195,42790,37750,37540,39323,32669
25663,237,1026,22706,2957,22706,2957,3.58773e+18,315.212,2602.75,25663,141,250,24304,23558,21064,18025,8659
33097,396,518,33097,0,33097,0,3.20956e+18,299.217,2346.09,33097,181,141,32579,32507,30770,29649,27801
9590,76,331,2301,7289,0,9590,3.00905e+13,109.394,1245.04,9590,158,87,9006,8113,7925,5597,4072
46931,44,65,0,46931,46286,645,2.53033e+16,44.9247,981.409,46931,40,44,46844,46743,45738,45712,39314
15634,1146,1184,0,15634,0,15634,1.94621e+18,211.033,2475.76,15634,192,136,14450,14450,14450,14450,14442
16290,135,315,16287,3,16290,0,2.48945e+18,155.289,1342.91,16290,118,64,15873,15721,15333,15339,10747
14555,736,846,12885,1670,12885,1670,3.57248e+18,218.709,1888.24,14555,120,180,13709,13703,13697,13698,13163
33019,405,1018,33019,0,29031,3988,1.16651e+18,392.787,3860.62,33019,278,182,31674,30602,29330,22561,14134
23548,8,59,0,23548,23382,166,2.63346e+16,34.7111,577.148,23548,30,31,23082,22826,21557,21351,14530
13142,160,304,13142,0,13142,0,3.85106e+18,199.988,1340.74,13142,110,118,12592,11844,11137,10759,8135
42759,38,1383,0,42759,10767,31992,1.05647e+16,221.382,4460.7,42759,278,172,38006,34973,31449,30612,6124
40316,54,97,0,40316,40219,97,2.15373e+16,29.1193,974.908,40316,40,33,40219,40210,39918,39776,37643
37807,228,881,0,37807,0,37807,4.11472e+18,334.432,2903.56,37807,215,166,36282,35163,28305,16493,12735
12546,67,308,12546,0,12546,0,3.44472e+18,199.109,1233.91,12546,101,141,11691,11165,7572,6381,3349
31098,981,1129,29006,2092,29006,2092,2.08442e+18,597.801,3646.63,31098,339,194,29969,29899,29789,29772,28840
28494,181,1411,7100,21394,0,28494,2.83399e+13,174.05,3362.67,28494,232,154,26989,26337,23794,19178,8239
26518,418,644,26502,16,26518,0,3.09144e+18,319.696,2763.95,26518,221,147,25833,25762,24575,23738,22225
14738,340,686,0,14738,3185,11553,4.50792e+15,200.174,2033.78,14738,199,111,14052,13840,13727,13504,10149
23293,424,507,0,23293,5278,18015,7.23256e+15,222.821,2238.49,23293,217,114,22786,22786,22682,22750,21110
30809,103,442,30809,0,30809,0,5.16948e+18,278.51,2315.69,30809,191,146,29059,27374,18262,16356,9410
24024,53,1991,21798,2226,21798,2226,2.73233e+18,234.036,4351.24,24024,453,212,19967,18543,16681,14295,2555
21891,1624,1660,21891,0,20566,1325,1.95051e+18,245.384,3597.85,21891,338,191,20231,20231,20215,20194,20120
20953,754,1771,0,20953,0,20953,2.86879e+18,338.205,3833.25,20953,315,192,19182,19128,17797,11016,6980
17737,641,1093,16506,1231,16506,1231,7.42014e+17,503.987,2903.35,17737,252,167,16537,15857,16135,16253,13289
11415,23,33,0,11415,11412,3,2.03011e+16,11.4505,310.612,11415,15,16,11382,11381,11302,11375,10933
44298,25,534,44298,0,44298,0,5.0211e+18,310.783,3108.68,44298,212,171,33298,26616,20482,17316,6627
29348,968,1386,29348,0,26202,3146,7.88721e+17,447.014,3903.55,29348,377,168,27962,27891,27571,26997,22611
10127,789,884,9488,639,9488,639,1.91408e+18,160.66,1959.8,10127,226,146,9243,9243,9230,9230,8677
43969,16,42,0,43969,43930,39,1.21765e+16,9.11444,794.105,43969,17,10,43927,43926,39305,40789,32028
20162,1,28,0,20162,20127,35,9.57473e+15,5.29422,444.292,20162,18,12,9804,9804,9804,9804,9804
40439,1660,1927,35948,4491,35946,4493,1.13758e+18,332.996,4678.2,40439,371,281,38512,38512,38435,38486,36478
19001,104,633,0,19001,0,19001,1.87017e+18,300.8,2454.15,19001,229,150,16663,13934,13652,5980,5430
41448,9,14,41195,253,41448,0,1.00881e+14,10.2952,405.293,41448,12,11,41420,41413,39948,39946,38693
30800,1156,1271,27932,2868,27932,2868,2.41466e+18,655.707,4035.92,30800,435,159,29529,29507,29515,29519,28103
32800,1239,1272,29875,2925,29875,2925,2.37827e+18,626.381,4140.02,32800,485,160,31528,31528,31528,31527,31051
32791,67,1404,30650,2141,0,32791,2.40778e+18,531.814,4097.15,32791,360,218,26774,21866,22500,22685,6545
676,24,215,676,0,616,60,1.88731e+17,8.21006,307.415,676,61,35,461,452,375,268,54
9780,543,820,9780,0,9125,655,8.49754e+17,238.562,1841.33,9780,315,102,8960,8823,8524,8863,7290
42125,129,1265,39236,2889,39236,2889,2.12036e+18,681.542,4408.36,42125,385,233,37367,34698,31856,32391,11671
45700,9,68,0,45700,45375,325,2.60716e+16,49.6646,947.174,45700,41,42,43617,42105,40321,37959,25425
48663,432,1322,48663,0,42834,5829,1.16446e+18,435.008,5056.38,48663,366,210,46954,45199,42843,31257,17630
20830,771,1360,19208,1622,0,20830,2.89987e+18,250.678,3346.6,20830,397,95,19470,19340,18887,18489,11913
27821,1731,2244,0,27821,0,27821,1.98352e+18,345.357,5036.31,27821,463,262,25577,25576,25577,25499,21127
27126,677,1654,0,27126,0,27126,1.20301e+18,418.583,4276.03,27126,355,202,25472,24798,24544,21051,14545
47871,1043,1467,47871,0,44629,3242,9.52417e+17,719.46,4958.04,47871,405,257,46404,46236,43824,43837,39288
2561,61,297,2561,0,2399,162,1.06161e+18,111.163,661.878,2561,80,58,2001,1663,1471,1578,881
40750,67,1796,0,40750,0,40750,1.23404e+18,551.718,5260.94,40750,395,229,33128,27829,27105,21530,7489
8359,705,851,7829,530,7829,530,1.9741e+18,167.1,1818.52,8359,153,127,7508,7486,7466,7475,6656
28635,1200,1587,0,28635,7648,20987,1.43424e+16,187.294,3597.9,28635,300,158,27048,27048,26851,27048,23534
10874,334,565,0,10874,2702,8172,8.3854e+15,156.02,1252.5,10874,73,140,10309,10154,9791,9876,7089
28054,43,65,0,28054,27882,172,2.61837e+16,51.775,749.09,28054,37,37,27957,27900,26972,27051,24300
9634,159,537,7262,2372,7262,2372,3.79942e+18,217.769,1395.51,9634,133,114,8906,8707,7719,7725,3865
43787,1729,1855,43787,0,34276,9511,8.15947e+17,350.126,5258.45,43787,392,223,41932,41932,41932,41925,39613
42605,1224,1248,39739,2866,0,42605,2.44568e+18,628.13,4346.89,42605,350,233,41357,41301,41357,41353,41283
5513,44,47,0,5513,5482,31,2.88858e+16,15.4907,281.02,5513,23,19,5466,5464,5455,5465,5175
2864,405,556,0,2864,408,2456,1.79305e+15,9.88268,687.485,2864,79,18,2308,2308,2160,2216,1834
10164,579,788,219,9945,0,10164,1.98628e+12,36.5354,1574.5,10164,354,44,9376,9376,9200,8984,7308
31375,12,798,27621,3754,0,31375,3.83736e+18,333.913,3367.43,31375,289,172,19651,15913,14342,13653,2268
15563,1,26,0,15563,15281,282,2.75535e+16,16.678,365.299,15563,19,18,5270,5270,5270,5270,5270
34196,1573,1617,6255,27941,0,34196,2.29249e+13,304.553,4315.13,34196,425,186,32579,32575,32579,32579,32365
26281,1589,1794,24645,1636,0,26281,2.35112e+18,272.259,4043.44,26281,520,130,24487,24487,24336,24415,23591
35830,156,1002,0,35830,7955,27875,4.68387e+15,409.326,3499.68,35830,305,205,33797,33105,31525,28746,12854
16868,3,8,16727,141,16868,0,1.12804e+14,7.01476,242.454,16868,8,8,16211,15890,14975,15735,11181
39405,17,34,0,39405,37550,1855,2.46119e+16,30.7843,648.835,39405,30,30,39220,39084,35360,37448,29776
20055,72,1465,0,20055,0,20055,2.26074e+18,217.181,2818.77,20055,339,208,17984,17396,15195,14698,1734
24509,488,832,5526,18983,0,24509,2.26708e+13,228.381,2798.1,24509,365,107,23677,23556,22502,22762,14044
12139,4,7,12109,30,12139,0,8.23629e+13,6.93006,215.831,12139,7,7,11815,11653,10171,10172,10570
39087,205,2106,0,39087,0,39087,3.37586e+18,359.099,5145.93,39087,386,231,35747,34677,29783,12816,8180
40525,323,665,36431,4094,40525,0,3.86475e+18,351.14,3330.53,40525,281,168,39606,38995,33661,31363,23540
23657,411,776,0,23657,5350,18307,5.96095e+15,222.814,2618.35,23657,308,111,22881,22853,20979,21273,12780
21754,968,1229,19774,1980,19774,1980,2.8283e+18,369.525,3066.26,21754,458,154,20525,20525,20389,20313,19074
27107,177,2238,27107,0,24324,2783,1.32379e+18,217.327,4705.5,27107,616,137,24476,23786,20120,17332,4113
40672,7,10,40454,218,40608,64,1.07913e+14,7.67798,378.906,40672,9,10,40640,40598,39726,39726,39181
44422,3270,3565,43223,1199,43223,1199,3.16978e+18,351.524,6598.62,44422,421,162,40857,40857,40515,40415,39406
18522,62,614,0,18522,0,18522,4.11531e+18,288.179,1868.64,18522,163,140,16966,15957,12253,6455,3679
13727,67,493,3563,10164,0,13727,2.9382e+13,154.797,1389.06,13727,92,115,12650,12194,11179,12037,2607
32374,522,1926,0,32374,0,32374,1.81419e+18,288.677,4572.77,32374,318,179,30448,29993,28387,20841,13714
29417,446,515,6833,22584,0,29417,2.87206e+13,212.31,2526.74,29417,224,132,28902,28902,28804,28881,26912
34373,262,562,34373,0,34373,0,3.1652e+18,293.174,2494.93,34373,183,143,33634,32837,28687,27796,18478
2327,114,214,0,2327,599,1728,7.4468e+15,48.2454,454.756,2327,46,55,2113,2074,1999,2024,1335
1353,27,114,363,990,0,1353,5.91828e+13,27.2809,271.292,1353,35,34,1225,1097,1066,1044,533
35901,1203,1211,33561,2340,0,35901,2.35056e+18,643.687,4016.26,35901,400,227,34690,34690,34690,34690,34640
40013,526,952,30172,9841,30172,9841,6.98684e+18,351.138,3083.22,40013,229,178,39061,38880,37655,36502,26185
48972,306,654,46698,2274,48972,0,3.79739e+18,295.326,3416.24,48972,258,185,48201,47752,46057,44470,39630
12901,2,13,12805,96,12901,0,9.95342e+13,11.2477,225.278,12901,10,10,11682,11341,8986,11240,8023
6041,159,328,6041,0,6041,0,3.25634e+18,104.546,916.87,6041,98,86,5713,5622,4979,5014,3617
44851,2570,3562,43643,1208,43643,1208,3.15734e+18,353.526,6632.91,44851,426,165,41289,41289,39488,38652,33250
47805,483,1537,42013,5792,42013,5792,1.64984e+18,400.541,5526.32,47805,380,220,46231,45028,43016,42918,20936
36126,61,63,0,36126,35848,278,2.51602e+16,54.3142,849.867,36126,40,42,36061,36039,36056,35896,35969
6685,151,577,5878,807,5878,807,1.72477e+18,169.859,1462.78,6685,152,111,5954,5014,5123,5273,3237
31397,137,2325,28630,2767,0,31397,3.28375e+18,264.481,5078.01,31397,746,223,28336,24483,24621,25702,6590
13005,7,11,12996,9,13005,0,6.62733e+13,10.9775,329.522,13005,11,11,11298,9178,10704,10324,9942
9247,333,538,0,9247,2091,7156,4.60519e+15,126.477,1357.49,9247,185,110,8709,8665,8538,8527,6599
48622,1411,2009,41440,7182,0,48622,5.06222e+18,355.706,5917.98,48622,363,225,46613,46588,45323,45440,31738
48801,1,10,48359,442,48737,64,1.02333e+14,7.90746,412.495,48801,9,10,25364,25364,25364,25364,25364
13706,653,865,3211,10495,0,13706,2.55677e+13,178.616,1912.53,13706,444,84,12841,12819,12706,12735,11778
22559,574,655,19834,2725,0,22559,3.86606e+18,321.919,2699.53,22559,235,161,21904,21904,21816,21829,20223
28424,147,538,0,28424,7934,20490,1.60653e+16,236.302,1918.66,28424,134,123,27512,26894,24857,24639,11061
1305,13,250,251,1054,0,1305,2.11377e+13,31.1648,442.793,1305,69,30,910,820,702,316,216
7181,604,831,6703,478,0,7181,2.41001e+18,152.899,1713.44,7181,163,121,6350,6287,6286,6284,5456
29720,1146,1493,27808,1912,27808,1912,6.60318e+17,543.525,4189.71,29720,327,228,28227,27916,27931,28076,25522
32168,80,778,32168,0,24243,7925,8.06344e+17,363.509,2756.05,32168,216,172,29525,28216,22706,23288,4875
25651,446,710,19326,6325,19326,6325,3.80616e+18,341.451,2403.89,25651,194,161,24941,24779,24610,24564,19053
40530,1042,1294,36249,4281,36249,4281,3.27656e+18,286.851,3712.01,40530,180,178,39236,39233,38920,38883,36902
31909,404,2199,29022,2887,29019,2890,1.44755e+18,340.011,5141.45,31909,634,152,29434,28396,27013,27515,10563
43118,636,666,43118,0,43118,0,3.48461e+18,323.191,3526.72,43118,233,190,42452,42452,42450,42450,42244
20964,77,491,20964,0,20964,0,3.2288e+18,250.592,1894.86,20964,164,131,19569,18637,13368,12658,4284
5942,126,263,5942,0,5942,0,5.05943e+18,128.048,888.25,5942,96,77,5651,5499,5128,4822,3932
4879,199,428,3670,1209,3670,1209,3.84882e+18,159.171,967.832,4879,92,100,4440,4302,4325,4257,2199
46126,657,694,0,46126,12791,33335,1.62465e+16,269.835,2604.31,46126,208,142,45432,45431,45405,45409,45011
34270,207,657,9511,24759,0,34270,6.35206e+13,244.467,2235,34270,173,135,33451,32518,30760,30397,15614
1710,60,200,1710,0,1445,265,1.30267e+18,130.831,502.08,1710,83,57,1227,1027,834,632,539
24985,824,1181,24985,0,23365,1620,9.47766e+17,576.621,3402.52,24985,348,194,23804,22994,22361,22446,18802
17083,1,11,16288,795,17083,0,9.59952e+13,10.2223,291.277,17083,11,11,6720,6720,6720,6720,6720
43645,341,738,43517,128,43645,0,3.1456e+18,413.332,3584.25,43645,269,170,42621,42162,38309,36537,26508
14783,1,40,0,14783,14238,545,1.8971e+16,14.9468,414.14,14783,19,19,6633,6633,6633,6633,6633
21717,326,466,21717,0,21717,0,4.96919e+18,298.66,2055.33,21717,173,130,21221,20990,20514,19748,18001
33122,2,36,0,33122,33067,55,9.72692e+15,5.47974,640.494,33122,20,12,28388,26306,23843,26305,16281
25407,1175,1568,23627,1780,23627,1780,6.9881e+17,437.389,4051.55,25407,273,239,23839,23776,23490,23677,17971
30907,3,8,30881,26,30907,0,5.35047e+13,5.98538,353.993,30907,7,6,27964,27225,26489,27217,24946
8486,8,577,2008,6478,0,8486,3.03223e+13,101.233,1431.81,8486,159,87,5886,4878,4596,1112,974
16535,19,42,0,16535,16498,37,2.12317e+16,26.9959,452.52,16535,29,29,16390,16244,14254,15343,13221
44373,336,1148,0,44373,10679,33694,6.1775e+15,343.044,3996,44373,465,146,43091,42558,38878,37315,21906
36562,854,1220,34254,2308,0,36562,2.29529e+18,639.864,4051.73,36562,374,223,35320,34275,34466,34303,28264
25485,275,701,19211,6274,19211,6274,7.01099e+18,318.821,2266.17,25485,185,154,24505,23612,22589,21188,11741
14054,271,1002,13130,924,13130,924,6.18996e+17,232.853,2368.96,14054,190,164,12939,12726,12287,12215,7945
17290,356,659,0,17290,3728,13562,5.21368e+15,195.584,2192.23,17290,323,110,16631,16548,16341,16580,12870
9328,6,30,0,9328,8890,438,2.45807e+16,22.0406,310.217,9328,20,21,8733,8491,6412,7884,5631
37764,265,1645,33273,4491,33273,4491,3.27984e+18,323.373,4715.68,37764,295,196,35305,34018,30183,28334,12745
27025,40,44,0,27025,26998,27,2.08215e+16,28.4115,572.396,27025,30,30,26981,26980,26670,26773,26806
17199,670,814,17199,0,16030,1169,1.0955e+18,411.326,2371.89,17199,218,166,16385,16027,16099,16143,15476
3954,4,7,3921,33,3954,0,9.76693e+13,6.76227,116.734,3954,7,7,3876,3847,3707,3691,3156
20954,42,85,0,20954,20890,64,2.17095e+16,26.7945,707.316,20954,35,33,20869,20864,20834,20829,18622
17054,187,561,16130,924,17054,0,3.88687e+18,221.369,2060.27,17054,177,137,16250,15337,14256,12671,9254
770,147,159,738,32,738,32,7.37387e+17,36.5818,273.387,770,45,21,611,588,611,611,575
2327,58,445,1944,383,0,2327,6.035e+18,23.355,653.262,2327,150,49,1882,1841,1642,1563,627
42900,1454,2323,36428,6472,0,42900,5.20843e+18,465.489,5856.67,42900,577,255,40577,40577,40194,40527,21654
46009,242,898,34649,11360,34649,11360,7.03888e+18,386.453,3214.87,46009,256,180,44235,42534,33738,27906,16927
37798,53,1425,37798,0,35363,2435,9.42627e+17,768.051,4461.48,37798,420,226,29247,24420,20065,19172,7662
30655,469,1260,28594,2061,28594,2061,6.99125e+17,602.128,3835.57,30655,337,209,28743,27499,26853,27017,18651
10757,8,14,10690,67,10757,0,9.92243e+13,6.99944,211.19,10757,10,9,10740,10739,10403,10400,9645
45550,2286,2476,41464,4086,41460,4090,1.27443e+18,353.008,6416.56,45550,732,198,43074,43074,43033,43063,40495
27765,1273,1509,24859,2906,0,27765,3.80659e+18,242.254,3647.9,27765,419,154,26256,26256,25669,25711,22019
44483,605,1937,44483,0,39887,4596,1.53665e+18,294.781,4958.87,44483,533,182,42546,42376,36992,40291,12040
7873,504,847,7873,0,7360,513,9.65549e+17,147.699,1831.69,7873,169,111,7026,6997,6913,6943,5654
38098,138,1175,0,38098,8283,29815,4.87401e+15,352.178,3858.23,38098,311,211,35825,35069,33058,28177,10608
36070,1646,1906,30811,5259,30811,5259,4.22172e+18,298.836,5178.13,36070,340,192,34164,34162,33971,33931,29529
33628,1353,2186,33628,0,30127,3501,1.411e+18,296.106,5175.71,33628,380,206,31442,31432,30672,31012,24847
21000,461,1037,18680,2320,18680,2320,3.44119e+18,213.519,2476.35,21000,150,162,19963,19853,18631,17954,9200
20174,887,1405,4460,15714,0,20174,2.7779e+13,152.089,2999.96,20174,397,106,18769,18766,17967,18283,15202
44134,1200,1303,0,44134,0,44134,1.22759e+18,647.805,4508.46,44134,367,232,42831,42831,42690,42632,42223
2456,240,444,2288,168,0,2456,2.47087e+18,129.277,803.013,2456,114,68,2012,1858,1936,1935,1591
47782,1308,1368,0,47782,10455,37327,4.74893e+15,426.056,4683.01,47782,341,225,46414,46414,46411,46396,46056
24024,203,1691,24024,0,20998,3026,9.061e+17,259.166,4294.33,24024,368,189,21982,21499,18707,18892,7407
1331,111,221,1190,141,1190,141,3.298e+18,37.169,397.282,1331,54,50,1110,1097,1091,1081,906
15510,231,914,0,15510,0,15510,2.16247e+18,494.46,2265.05,15510,254,139,13709,13293,12140,13406,1264
22040,434,1439,3819,18221,0,22040,2.02758e+13,179.348,3345.74,22040,380,145,20601,20465,19647,19825,4876
36772,28,64,0,36772,36473,299,2.52864e+16,54.2485,858.75,36772,42,43,36570,36514,35008,35009,29913
47707,11,15,47566,141,46783,924,8.04183e+13,8.27822,447.786,47707,10,10,47692,47690,42982,42981,43541
22946,701,1105,21433,1513,21433,1513,6.69956e+17,461.821,3168.47,22946,261,185,21738,21137,21253,21287,18462
28987,712,1324,0,28987,7217,21770,7.52425e+15,172.937,3043.95,28987,338,134,27663,27654,24442,24971,10735
15383,1086,1539,0,15383,0,15383,4.03405e+17,284.313,2873.73,15383,270,110,13844,13844,13113,12313,10931
12208,49,74,0,12208,12056,152,2.50266e+16,45.366,502.29,12208,51,37,12121,12063,11827,11818,11309
6140,12,74,0,6140,6107,33,2.33777e+16,13.2228,403.776,6140,27,22,6014,5883,5061,4988,3389
31525,855,1192,0,31525,0,31525,1.17499e+18,605.114,3777.34,31525,356,205,30325,29327,29579,27575,24793
4052,172,379,0,4052,0,4052,4.12695e+18,68.2924,791.688,4052,73,73,3673,3646,3579,2936,2636
16759,774,1310,14642,2117,0,16759,4.59712e+18,202.468,2458.57,16759,301,196,15449,15449,13778,13698,5765
2764,180,217,0,2764,721,2043,7.44251e+15,67.6831,508.653,2764,50,60,2547,2546,2521,2533,2184
32381,2027,2256,27249,5132,27155,5226,2.60643e+18,346.211,5116.47,32381,488,231,30125,30125,30125,30123,27876
2078,282,340,1843,235,1843,235,1.62456e+18,83.3263,686.65,2078,101,56,1738,1734,1722,1720,1567
49425,11,51,0,49425,49382,43,1.30251e+16,9.17339,897.791,49425,19,10,49374,49374,39886,43263,30270
3893,1,7,3886,7,3893,0,8.22809e+13,6.82045,122.64,3893,7,7,2233,2233,2233,2233,2233
38254,8,13,37957,297,37827,427,9.52134e+13,9.0006,462.919,38254,11,10,38235,38233,38010,38047,34878
29068,65,71,0,29068,28867,201,2.53248e+16,41.2452,781.667,29068,36,38,28997,28997,28996,28997,28890
36230,643,861,0,36230,8027,28203,4.71969e+15,458.164,3265.61,36230,333,183,35369,34906,34742,34842,31543
44237,316,496,44237,0,44237,0,5.04975e+18,303.558,2830.71,44237,210,175,43624,43110,40274,38000,33726
42830,2,18,41915,915,42830,0,9.97619e+13,10.1122,446.766,42830,15,12,36616,34375,28900,34463,23621
4479,761,770,4169,310,4169,310,8.49976e+17,151.833,1394.8,4479,126,116,3709,3709,3708,3708,3696
33476,24,70,0,33476,33161,315,2.15726e+16,20.4995,764.134,33476,25,32,33397,33359,29642,30140,22642
18329,154,499,18329,0,18329,0,3.43766e+18,278.486,2148.45,18329,172,150,17243,16171,13889,11164,7782
34245,7,9,33957,288,34233,12,1.05653e+14,7.58265,343.044,34245,8,8,34221,34194,34188,34188,30280
45424,37,1997,45424,0,42430,2994,9.32356e+17,664.677,5878.88,45424,481,262,32811,25449,20579,17436,5700
24938,209,420,24938,0,24938,0,4.40198e+18,247.029,2202.49,24938,249,130,24322,23704,20008,19801,14088
41659,11,13,41352,307,39359,2300,9.22418e+13,8.83379,481.21,41659,11,10,41646,41645,41624,41626,39550
16460,27,411,16460,0,16460,0,5.29001e+18,210.199,1673.31,16460,171,113,12523,9584,7122,5769,2830
17030,12,13,16906,124,17030,0,9.76487e+13,9.58902,254.557,17030,11,9,17016,17013,16638,16638,16964
38355,1385,1453,38355,0,35799,2556,9.93411e+17,608.822,4608.96,38355,391,264,36902,36892,36823,36735,36375
35462,57,1229,33168,2294,33168,2294,2.00127e+18,570.416,3925.35,35462,384,210,28325,24093,22707,23502,6621
10650,17,20,0,10650,10403,247,2.74495e+16,17.1086,295.597,10650,19,17,10621,10574,10614,10571,10030
15281,192,720,0,15281,0,15281,4.06222e+18,225.352,1828.9,15281,149,141,14369,13873,12324,7378,5326
25045,361,1894,0,25045,0,25045,1.18203e+17,71.614,3679.51,25045,434,63,23151,23025,21290,12981,7490
49373,73,886,37218,12155,37218,12155,7.01855e+18,391.152,3317.86,49373,265,182,45619,43768,30306,22372,9401
39856,1234,1685,10727,29129,0,39856,5.67219e+13,229.676,4143.02,39856,338,162,38171,38171,37924,38171,32525
42446,3,11,42295,151,42382,64,1.07926e+14,8.43295,391.571,42446,10,10,40763,39886,37005,39085,28078
5775,513,532,0,5775,0,5775,3.25473e+18,21.8713,835.921,5775,186,180,5243,5243,5156,5183,5228
32494,148,1369,0,32494,5317,27177,5.44241e+15,233.051,3869.36,32494,541,100,30719,30346,28269,23296,7674
27878,660,841,0,27878,6049,21829,4.71986e+15,400.524,2910.16,27878,320,179,27037,26832,26579,26674,24474
38373,562,1714,6762,31611,0,38373,2.07943e+13,395.303,4485.34,38373,477,168,36570,35855,35432,35383,12721
25865,76,955,25865,0,24122,1743,1.10594e+18,472.182,3000.46,25865,301,198,21275,17212,15797,16677,7467
35807,1129,1247,33407,2400,33407,2400,6.56584e+17,682.084,4120.01,35807,351,223,34560,34526,34446,34467,33840
12793,203,697,11254,1539,11254,1539,1.71774e+18,304.673,2150.99,12793,200,134,11771,11321,10341,10474,4347
28907,119,615,28907,0,28907,0,3.29198e+18,291.749,2844.59,28907,196,180,26523,23060,20488,15703,7548
29989,102,1292,26792,3197,26789,3200,9.68893e+17,293.544,3228.71,29989,164,177,26506,24640,23726,23006,1215
7624,188,337,0,7624,2102,5522,1.6153e+16,117.506,912.043,7624,70,78,7287,7162,7102,7141,4627
44693,906,994,0,44693,9682,35011,4.82635e+15,419.769,3774.15,44693,300,196,43699,43691,43582,43631,42885
27735,1182,1206,25116,2619,25116,2619,2.49487e+18,559.364,3713.42,27735,433,158,26529,26529,26529,26528,26358
22767,325,365,0,22767,5985,16782,3.15322e+15,222.695,1907.31,22767,197,112,22402,22367,22229,22264,21620
43124,667,1423,40304,2820,0,43124,2.40741e+18,574.735,4636.48,43124,365,233,41510,40704,40374,39629,31330
2071,100,232,1922,149,1922,149,1.21977e+18,29.7088,419.334,2071,99,33,1839,1811,1747,1765,670
33356,1263,1421,8387,24969,0,33356,2.90949e+13,216.24,3537.01,33356,236,154,31935,31935,31935,31935,31295
7998,384,394,7998,0,7998,0,2.88967e+18,188.891,1188.06,7998,113,82,7604,7578,7599,7601,7544
21849,72,1507,19882,1967,19882,1967,1.36496e+18,348.228,3657.65,21849,428,141,17776,16871,12780,14696,2531
25833,549,669,19467,6366,19467,6366,7.00115e+18,314.998,2223.16,25833,173,147,25164,25139,25053,25012,22843
31339,1166,1238,0,31339,0,31339,1.19609e+18,616.511,3790.37,31339,389,213,30101,30101,30023,30028,29597
21480,73,649,18885,2595,0,21480,3.85117e+18,312.319,2634.36,21480,247,158,17764,14952,14653,14899,4039
26862,23,34,0,26862,25583,1279,2.46042e+16,29.9394,537.73,26862,27,29,26779,26688,25484,25739,21163
15286,10,48,0,15286,15090,196,2.45975e+16,19.03,455.537,15286,22,22,15163,15093,14299,14252,11920
39907,567,6354,39907,0,39907,0,1.69651e+18,13.2704,9118.99,39907,1283,20,33553,33553,23863,18710,7941
9373,95,1020,8369,1004,8369,1004,1.81367e+18,112.417,1830.53,9373,487,65,7962,6947,4967,6094,1915
39704,9,12,39137,567,39704,0,9.68192e+13,10.7054,386.102,39704,12,12,39679,39660,38202,38201,37036
20725,717,780,0,20725,4614,16111,4.85721e+15,305.064,2451.3,20725,241,156,19945,19941,19923,19929,19376
13903,160,1178,12696,1207,12696,1207,1.24986e+18,280.901,2735.82,13903,368,138,11841,10803,9224,10157,3621
34595,1049,1820,28325,6270,0,34595,6.14401e+18,280.534,4884.46,34595,313,194,32775,32761,28960,28813,13009
47079,1543,1995,41012,6067,41009,6070,1.7573e+18,388.874,6039.67,47079,433,235,45084,45068,44957,44995,36902
47406,72,2677,44005,3401,0,47406,2.69274e+18,678.703,6597.35,47406,746,209,39947,35643,34354,35434,5363
6333,410,562,5368,965,6311,22,2.53969e+18,23.8156,1102.09,6333,257,41,5771,5771,5701,5278,5318
37795,1257,1866,7102,30693,0,37795,2.47335e+13,290.505,4742.92,37795,573,161,35929,35928,35132,35530,32468
24683,132,1607,24683,0,24683,0,3.87258e+18,14.8862,3142.4,24683,804,15,23076,23076,7081,5172,6186
44954,249,1235,44954,0,39607,5347,1.16206e+18,437.708,4757.5,44954,357,212,42134,40519,37781,28688,9466
26554,250,1337,0,26554,6721,19833,9.43142e+15,351.941,3440.84,26554,443,155,24412,23523,20594,11397,6400
36260,910,1138,31689,4571,0,36260,3.90926e+18,318.943,3944.73,36260,283,189,35122,35122,35077,35101,34798
22261,4,11,21831,430,21125,1136,9.47313e+13,5.7828,264.303,22261,10,8,22207,22186,21427,21430,17557
33994,211,1639,30691,3303,0,33994,3.05235e+18,349.864,4388.01,33994,522,179,30646,28116,27122,27753,9577
18801,972,1116,0,18801,4124,14677,4.79475e+15,239.869,2841.78,18801,301,137,17685,17661,17670,17659,16594
26833,103,623,25655,1178,25605,1228,7.93163e+17,441.525,2807.63,26833,253,175,22341,19365,17649,20188,5490
4925,41,356,0,4925,0,4925,1.91759e+18,160.899,880.521,4925,79,88,4119,3646,3152,3247,914
1104,34,150,994,110,994,110,3.10226e+18,33.2636,292.879,1104,42,37,943,799,880,784,279
30414,1090,1166,8029,22385,0,30414,5.23559e+13,173.248,3431.44,30414,230,135,29248,29248,29216,29224,28198
5427,141,339,1342,4085,0,5427,2.91487e+13,149.262,983.739,5427,180,71,4914,4628,4599,4723,1935
8784,356,503,8784,0,6632,2152,8.48362e+17,172.092,1264.26,8784,116,111,8281,8157,8060,7703,6915
15755,668,732,0,15755,0,15755,1.20591e+18,262.014,2061.4,15755,230,128,15023,14977,15003,15021,14413
22575,588,815,0,22575,5004,17571,4.70502e+15,381.847,2618.11,22575,279,152,21760,21403,21353,21462,19275
33600,704,837,0,33600,7929,25671,5.89658e+15,246.631,3230.91,33600,370,137,32763,32730,32668,32655,27852
6563,20,32,0,6563,6510,53,2.66689e+16,20.9209,284.733,6563,23,23,6515,6494,6286,6318,5969
49709,74,2442,44722,4987,44722,4987,3.11473e+18,279,6105.39,49709,533,185,43546,40985,38408,32459,4504
26493,298,1159,23974,2519,0,26493,2.93028e+18,363.581,3560.76,26493,398,167,24652,22016,23207,23114,14201
595,92,96,595,0,595,0,2.60279e+18,48.3916,209.357,595,33,44,499,499,497,499,495
33776,691,822,25437,8339,25437,8339,7.03491e+18,349.751,2711.1,33776,218,164,32954,32948,32854,32833,31612
37411,659,1100,8350,29061,0,37411,1.92088e+13,458.829,3758.05,37411,371,190,36311,36052,34885,30675,23980
41117,37,49,0,41117,40960,157,2.55638e+16,34.6208,708.221,41117,27,27,41059,41028,40860,40943,38057
24101,524,739,6111,17990,0,24101,2.88378e+13,458.195,2452.75,24101,451,92,23192,22207,22691,22929,19726
47704,692,1427,0,47704,0,47704,1.2144e+18,593.486,4841.58,47704,385,232,46166,45378,45029,36899,37328
18294,2,63,0,18294,18176,118,2.63314e+16,32.6677,580.465,18294,33,33,12931,11537,9669,9689,7637
42829,2130,2655,42829,0,38638,4191,1.50726e+18,276.996,6040.84,42829,405,296,40174,40174,39835,40165,36638
48729,1735,2190,38928,9801,38928,9801,5.77388e+18,375.789,5696.11,48729,418,245,46539,46539,46464,46374,40964
42611,500,1919,39737,2874,0,42611,2.45699e+18,598.321,5570.16,42611,369,253,40102,38424,37759,37550,13056
33716,1168,2078,28942,4774,0,33716,4.89999e+18,466.406,4868.52,33716,511,215,31638,31620,30852,31060,10149
15084,119,428,4194,10890,0,15084,6.30736e+13,174.496,1346.37,15084,107,96,14465,14179,13146,12822,7225
49605,291,665,38802,10803,49605,0,4.20258e+18,361.362,3662.62,49605,311,177,48412,47429,40368,36702,27391
23357,129,1116,5703,17654,0,23357,2.55899e+13,298.162,2802.38,23357,447,124,21753,21501,20121,15179,3956
31208,1170,1607,28226,2982,28226,2982,2.58614e+18,295.935,4175.4,31208,454,165,29601,29601,29431,29262,26260
33525,385,1163,31461,2064,31461,2064,1.90377e+18,635.341,3858.99,33525,366,217,31372,30287,29526,29425,14149
23363,705,1441,0,23363,0,23363,1.84565e+18,256.204,3721.54,23363,302,166,21922,21889,20612,16246,14833
13133,6,44,0,13133,13036,97,2.54696e+16,33.7768,391.33,13133,26,26,12809,12637,11883,11889,7897
7779,666,945,1594,6185,0,7779,3.71587e+13,50.1437,1511.77,7779,321,71,6834,6830,6460,6630,3890
22249,77,448,22249,0,22249,0,5.19019e+18,261.013,1997.63,22249,174,129,20266,18257,12257,10742,6632
12443,255,441,12443,0,11937,506,4.40118e+17,313.272,1752.1,12443,183,117,11551,10214,9682,10901,9498
12688,41,532,0,12688,2844,9844,5.09966e+15,194.622,1563.34,12688,161,103,10706,9466,9389,9273,3358
39097,396,1767,36517,2580,36517,2580,2.04805e+18,609.268,5042.87,39097,432,229,36379,35087,34108,33405,18114
6782,3,10,6737,45,6782,0,1.01932e+14,7.68741,161.282,6782,9,9,6437,6287,5434,6103,5038
27681,761,2056,27681,0,23094,4587,1.06781e+18,367.713,4664.57,27681,288,260,25625,25587,24174,22533,9736
17513,311,708,15394,2119,15394,2119,1.72999e+18,334.532,2515.16,17513,225,151,16575,16063,15635,15491,9269
40109,49,63,0,40109,39870,239,1.95734e+16,19.0085,836.897,40109,27,30,40046,40046,39947,39953,33860
45902,60,702,10570,35332,0,45902,2.89215e+13,234.488,3432.34,45902,270,155,41855,37453,34750,16779,8228
34838,1362,2185,34838,0,28047,6791,1.03481e+18,348.595,5154.02,34838,302,288,32653,32653,31850,30361,20861
14095,598,684,0,14095,3188,10907,4.3761e+15,164.066,1872.72,14095,195,114,13411,13382,13400,13381,12575
2306,51,152,0,2306,628,1678,5.39076e+15,48.9861,420.408,2306,110,33,2140,2073,2079,2057,1211
17102,579,704,0,17102,0,17102,1.91768e+18,232.39,1958.39,17102,132,141,16398,16390,16360,16360,15842
8934,672,902,8316,618,8316,618,2.10139e+18,174.857,1919.17,8934,198,142,8032,7995,7982,7998,5890
41702,17,75,0,41702,41317,385,2.54056e+16,33.6408,867.342,41702,36,32,41486,41361,39428,39884,23896
8418,428,466,6314,2104,6314,2104,3.86448e+18,184.629,1234.37,8418,121,106,7952,7917,7946,7946,7585
24747,442,1214,5787,18960,0,24747,2.76887e+13,230.376,3181,24747,305,151,23533,23482,22219,22990,12327
35293,44,83,0,35293,34816,477,2.50312e+16,65.0765,909.52,35293,67,53,35063,34768,33668,33584,30968
34905,1395,1541,30758,4147,30758,4147,3.29789e+18,334.184,4382.28,34905,291,174,33364,33364,33364,33364,33071
46099,643,744,0,46099,12876,33223,1.60988e+16,274.005,2666.94,46099,192,141,45355,45349,45203,45247,42641
46275,606,1554,9420,36855,0,46275,2.15953e+13,434.382,5016.74,46275,573,125,44611,44203,42148,29024,25409
38996,514,629,0,38996,10841,28155,1.61846e+16,266.543,2349.69,38996,191,138,38367,38346,38181,38235,35476
6426,43,258,6426,0,6426,0,5.27963e+18,117.519,893.064,6426,107,78,5362,4319,3068,2726,1805
31609,261,1512,28729,2880,28729,2880,1.33239e+18,721.864,4434.99,31609,503,173,28259,25316,22678,24180,7888
25786,424,1548,23819,1967,0,25786,2.83448e+18,211.856,3939.61,25786,387,134,24238,23956,23073,23370,7738
45839,494,1490,42768,3071,42768,3071,6.62111e+17,761.023,4899.08,45839,436,246,43195,41550,40330,40179,15846
18265,388,442,5088,13177,0,18265,6.35245e+13,189.698,1484.57,18265,114,100,17823,17812,17783,17789,17112
12232,446,639,9197,3035,9197,3035,6.99548e+18,161.823,1764.45,12232,136,137,11593,11568,11504,11489,9300
48757,358,2743,43431,5326,0,48757,3.88785e+18,326.145,5973.76,48757,461,237,45920,45477,39049,38623,3418
12174,178,686,10904,1270,0,12174,3.81333e+18,187.147,1684.81,12174,109,127,11318,10517,10207,10293,3677
26151,493,1563,23545,2606,23545,2606,1.38512e+18,388.781,4055.06,26151,434,146,24566,24015,20978,21835,9529
42582,1473,1658,37986,4596,37986,4596,2.77372e+18,353.688,5241.51,42582,452,193,40924,40924,40808,40757,36394
17197,72,735,4362,12835,0,17197,2.79909e+13,421.3,2059.83,17197,442,90,15402,14600,13760,12606,6275
49089,1549,2587,44037,5052,44034,5055,1.19091e+18,271.64,6190.53,49089,512,192,46502,46499,45928,46354,18953
21341,234,803,21341,0,16128,5213,8.17231e+17,276.718,2286.25,21341,180,143,20239,19526,18515,16925,8920
48929,75,639,48929,0,48929,0,4.17281e+18,295.281,3540.72,48929,245,191,45231,41459,29141,27858,11469
47047,566,1434,10907,36140,0,47047,2.20257e+13,366.395,4629.54,47047,380,189,45613,44995,43399,18810,20184
1183,2,3,1183,0,1183,0,9.2556e+13,1.99493,46.479,1183,3,2,1180,1179,1180,1180,1180
13966,9,33,0,13966,13285,681,2.4709e+16,27.719,384.103,13966,24,24,13531,13018,10489,12156,9717
38022,33,605,36371,1651,36371,1651,1.37912e+18,422.195,3191.16,38022,255,189,28825,24722,23926,23856,7339
3305,176,226,2834,471,2834,471,1.93115e+18,152.772,712.715,3305,99,79,3065,2946,2922,2971,2873
27513,842,1273,27513,0,25635,1878,9.62508e+17,583.045,3689.59,27513,319,200,26240,25247,24662,24841,21955
16413,13,32,0,16413,15631,782,2.46955e+16,26.4852,413.186,16413,24,24,16224,15986,13755,14998,11920
26503,1490,1499,23897,2606,23897,2606,1.40107e+18,378.395,4009.6,26503,435,139,25004,25001,25004,25004,24974
48097,344,701,0,48097,13356,34741,1.62391e+16,280.035,2665.73,48097,213,143,47396,47052,45664,45837,31517
11108,125,622,11108,0,9779,1329,1.13709e+18,305.527,1954.38,11108,199,137,9622,7782,7783,4649,3372
17675,154,860,16455,1220,16455,1220,2.14901e+18,394.584,2407.93,17675,246,159,16148,15154,13551,14166,5034
32966,445,792,28979,3987,28979,3987,3.24746e+18,331.082,3433.81,32966,287,195,32174,31659,30856,30214,19789
9615,7,9,9569,46,9589,26,1.04305e+14,6.27353,179.172,9615,8,8,9603,9596,9594,9594,8839
11753,343,886,0,11753,2451,9302,4.8928e+15,120.136,2080.02,11753,210,104,10867,10799,10554,10646,7212
15797,18,396,15797,0,15797,0,4.97134e+18,185.645,1600.63,15797,141,118,11013,8641,6546,5541,2705
47604,706,2313,42208,5396,0,47604,4.13182e+18,371.291,5258.19,47604,423,295,45291,45081,38373,38399,9317
16569,558,584,15829,740,0,16569,1.69554e+18,295.03,2125.69,16569,204,136,15985,15976,15982,15967,15945
18407,1088,1129,18407,0,17188,1219,9.57352e+17,465.842,2925.41,18407,299,171,17278,17278,17269,17266,17189
29848,1175,1892,29848,0,26867,2981,7.82976e+17,313.956,4463.03,29848,379,171,27956,27942,27705,27864,24712
49616,692,1934,10973,38643,0,49616,2.54437e+13,275.168,5432.83,49616,587,174,47682,47657,44221,30856,19165
20080,597,1294,18444,1636,18444,1636,2.55696e+18,280.701,3269.14,20080,446,110,18786,18566,18157,17671,11797
39352,9,35,37785,1567,39346,6,9.80648e+13,10.6796,513.36,39352,20,18,39282,39242,37603,37576,35404
27132,133,1221,6698,20434,0,27132,2.95238e+13,172.627,2966.98,27132,336,120,25584,24498,22285,19146,7677
27747,383,1058,27747,0,24583,3164,2.1614e+18,324.17,2842.23,27747,133,275,26628,25852,22846,25069,13117
1608,29,39,0,1608,1566,42,2.47362e+16,10.5205,154.951,1608,20,18,1569,1569,1552,1554,1391
9828,7,9,9782,46,9764,64,8.71233e+13,4.70828,175.115,9828,7,7,9819,9817,9549,9549,8392
28678,211,1744,0,28678,0,28678,1.89103e+18,244.373,3974.61,28678,254,177,26634,25269,23540,12730,6860
17593,845,1047,0,17593,0,17593,1.22786e+18,450.239,2782.87,17593,248,180,16546,16197,16335,16206,15068
22594,1042,1838,22594,0,20557,2037,1.08894e+18,421.161,4100.67,22594,404,195,20756,20683,18953,16407,9836
42478,98,2390,38617,3861,38617,3861,2.73554e+18,357.486,6091.36,42478,563,249,37367,34178,33456,28729,5096
19299,266,634,16957,2342,0,19299,3.87725e+18,300.4,2476.37,19299,230,152,18410,17848,15871,15884,9115
41097,879,2074,41097,0,37690,3407,1.33776e+18,491.928,5582.36,41097,459,267,39004,38115,36294,36013,20041
3870,161,383,0,3870,0,3870,1.95894e+18,108.566,806.15,3870,74,78,3465,3322,3222,2886,1494
21097,222,1463,4114,16983,0,21097,2.38555e+13,145.316,3362.35,21097,368,165,19634,19286,18483,15265,6308
47107,3,13,46780,327,47107,0,1.02828e+14,10.9929,423.732,47107,13,12,45458,44602,42745,43539,31851
47214,752,1325,44082,3132,44082,3132,2.03433e+18,689.26,4643.54,47214,421,233,45685,44063,44011,43527,37343
48411,251,1321,45236,3175,0,48411,2.38212e+18,759.541,4761.65,48411,449,243,44562,43470,40765,40681,8745
48808,166,1362,45568,3240,45568,3240,2.0476e+18,724.252,4813.18,48808,402,249,44054,41953,37863,38598,16275
14303,696,829,0,14303,0,14303,1.22131e+18,365.648,2166.19,14303,233,145,13474,13205,13418,13207,12643
47205,379,1935,0,47205,9761,37444,6.27389e+15,297.974,5265.63,47205,450,199,45188,44658,42156,26751,16408
35568,581,784,26776,8792,0,35568,8.33856e+18,354.606,2756.14,35568,226,164,34784,34755,34424,34433,30606
947,65,185,884,63,884,63,2.05483e+18,58.4129,336.364,947,46,39,742,642,639,649,341
13035,232,663,9853,3182,0,13035,8.21951e+18,205.463,1658.98,13035,137,130,12324,11987,10595,10474,4994
29088,1723,2384,28523,565,28298,790,8.86205e+17,361.696,4644.77,29088,350,139,26704,26704,26628,26579,21301
5806,124,470,5122,684,5122,684,3.17318e+18,148.832,1250.33,5806,162,101,5150,4492,4382,4013,2365
29961,1181,2668,29961,0,22032,7929,3.83428e+18,24.2576,3421.61,29961,898,890,27293,27293,21860,19392,25322
12780,40,299,12780,0,12780,0,4.97891e+18,168.06,1316.88,12780,134,109,10454,7987,6202,5793,3406
42855,1019,1302,40015,2840,0,42855,2.4174e+18,667.455,4399.85,42855,437,229,41553,41129,41056,40878,37685
12043,45,598,2051,9992,0,12043,2.06407e+13,223.394,1677.76,12043,208,78,10678,9911,9458,6985,2294
45616,457,1091,10641,34975,0,45616,2.93893e+13,238.802,3898.3,45616,272,145,44525,44506,43455,44238,32670
13326,110,420,13326,0,13326,0,3.36251e+18,208.778,1453.12,13326,125,104,12609,12237,9577,9301,4162
4448,468,478,829,3619,0,4448,3.0311e+13,44.6221,840.867,4448,179,34,3970,3966,3970,3970,3946
10910,1141,2088,0,10910,1560,9350,1.79932e+15,9.97699,2354.28,10910,271,18,8822,8822,7878,8217,5766
3725,210,226,1052,2673,0,3725,6.22289e+13,68.7584,581.257,3725,57,63,3499,3499,3499,3497,3362
30386,644,1491,0,30386,0,30386,1.53782e+18,322.073,4232.9,30386,362,167,28895,28823,25239,25180,14085
4678,182,307,3513,1165,3513,1165,7.08403e+18,69.2332,761.983,4678,86,71,4371,4369,4304,4184,3007
47607,475,1482,0,47607,0,47607,1.47128e+18,615.803,5222.58,47607,528,199,45688,44946,40657,37466,15309
2684,154,189,2684,0,0,2684,7.28571e+18,14.7489,432.486,2684,95,15,2495,2495,2461,2495,2174
10684,326,530,9445,1239,9445,1239,3.14716e+18,254.628,1738.06,10684,186,126,10109,9921,9449,9257,5588
5702,245,432,5333,369,0,5702,2.361e+18,133.367,1070.89,5702,107,92,5270,5253,5029,5032,3584
29357,42,45,0,29357,29150,207,2.56081e+16,36.4371,586.688,29357,30,30,29311,29269,29262,29300,28935
42425,1289,3806,5589,36836,0,42425,1.72642e+12,12.5164,5937.22,42425,1308,18,38619,38618,36111,33542,24811
3962,480,584,3708,254,3708,254,1.99561e+18,93.709,1064.26,3962,213,45,3378,3377,3320,3355,3088
562,45,104,135,427,0,562,1.30211e+13,34.1868,197.612,562,34,26,452,411,420,425,280
41370,93,1322,0,41370,0,41370,1.22625e+18,687.828,4435.46,41370,384,232,35195,30838,30120,26890,4958
9935,384,389,2501,7434,0,9935,2.58387e+13,185.072,1381.16,9935,215,89,9546,9546,9546,9546,9541
37895,482,2728,37895,0,34286,3609,1.11821e+18,433.601,6327.93,37895,668,178,34833,33891,30930,25437,6197
10548,420,661,10548,0,9440,1108,1.79364e+18,211.778,1615.12,10548,114,127,9887,9861,9388,9748,8251
15204,41,344,15204,0,15204,0,4.89597e+18,188.908,1513.98,15204,149,115,12581,9962,7591,7166,3922
35946,337,1213,0,35946,0,35946,1.4726e+18,392.759,4218.39,35946,408,191,34122,30757,31257,23675,18339
45409,5699,7576,45409,0,45409,0,1.63681e+18,7.49816,9612.01,45409,3790,9,37833,37833,37833,37833,29300
18960,506,628,4790,14170,0,18960,2.86921e+13,448.173,1928.87,18960,409,74,18184,17471,17820,18102,15864
47039,225,922,10181,36858,0,47039,1.85414e+13,474.613,3787.38,47039,336,212,44719,43562,42139,35729,22690
39313,389,1566,6448,32865,0,39313,2.0043e+13,358.565,4428.22,39313,550,101,37566,36947,36230,31863,15007
48941,2926,3044,45207,3734,45207,3734,1.31765e+18,758.225,7348,48941,935,245,45897,45869,45897,45848,45012
6529,140,416,0,6529,0,6529,4.16896e+18,157.418,1026.7,6529,106,91,6047,5937,5268,3471,3267
7617,259,748,6810,807,6810,807,1.84028e+18,230.175,1446.19,7617,196,83,6824,6603,5919,6679,5448
3090,9,12,3071,19,3090,0,8.74487e+13,5.98964,109.721,3090,9,8,3078,3078,3042,3042,2635
10221,383,391,0,10221,2856,7365,1.61307e+16,123.79,1089.03,10221,89,77,9830,9830,9830,9830,9776
27564,12,13,27330,234,27564,0,9.695e+13,11.1187,328.436,27564,12,11,27548,27539,26576,26576,27479
12326,7,10,12237,89,12326,0,1.0025e+14,8.40492,217.188,12326,10,9,12289,12240,11891,11892,10983
6317,288,498,1374,4943,0,6317,1.7958e+13,88.5525,1231.58,6317,161,56,5819,5819,5663,4499,4478
20900,6,34,0,20900,19897,1003,2.46859e+16,29.6249,475.747,20900,26,28,19629,19079,14378,17690,9492
23655,234,1161,5791,17864,0,23655,2.69093e+13,223.51,2875.59,23655,453,118,22251,22003,20296,18335,8720
47955,8,11,47793,162,47827,128,1.04214e+14,8.55012,414.696,47955,10,10,47940,47936,47817,47816,43112
42575,360,1950,37767,4808,37767,4808,3.1451e+18,318.144,5361.1,42575,391,225,40262,38970,36698,34971,15784
24733,1203,1430,23132,1601,23132,1601,6.9181e+17,486.441,3825.55,24733,318,177,23303,23224,23275,23299,21963
44623,450,1429,41690,2933,41690,2933,2.05172e+18,616.034,4679.32,44623,367,227,42467,40918,40505,39667,22619
12452,479,667,9381,3071,9379,3073,3.80611e+18,246.279,1824.24,12452,141,141,11785,11763,11663,11666,9080
27271,954,1212,25471,1800,25471,1800,2.03906e+18,575.272,3580.55,27271,360,206,26059,26020,25574,25516,23085
2680,315,320,509,2171,0,2680,2.61524e+13,106.037,677.161,2680,144,41,2360,2360,2360,2360,2346
11606,144,449,10215,1391,10215,1391,2.70235e+18,347.632,1747.95,11606,253,116,9849,8774,8795,8357,4762
48884,830,3046,48884,0,45242,3642,2.9958e+18,755.976,7316.99,48884,857,210,45414,44320,34940,41128,14524
32792,34,62,0,32792,32756,36,1.95131e+15,43.9321,769.568,32792,49,22,32641,32511,32386,32240,27680
26940,72,545,26940,0,26940,0,3.47629e+18,308.031,2667.67,26940,214,157,22882,19481,17026,11873,5285
35682,1122,2039,32354,3328,0,35682,3.42685e+18,316.14,4980.95,35682,496,199,33643,33640,31395,31499,19061
41910,711,1323,39081,2829,0,41910,2.4516e+18,701.607,4363.55,41910,436,220,40198,38870,38852,38807,23109
20395,399,1124,20395,0,19014,1381,9.87062e+17,523.479,3079.34,20395,289,196,18808,18129,16337,15404,11899
37676,19,65,0,37676,37412,264,2.63073e+16,46.1231,845.299,37676,38,41,37338,37052,35284,34420,24111
22256,911,1072,22256,0,19837,2419,1.75709e+18,255.976,2645.83,22256,145,153,21184,21184,20339,20621,18818
44475,127,1994,44475,0,38268,6207,9.64379e+17,398.154,5941.85,44475,440,237,40317,37539,31163,29934,9709
44941,1667,2041,0,44941,9899,35042,7.43153e+15,240.847,5006.8,44941,458,276,42900,42900,41511,41614,35459
7835,1,8,7829,6,7696,139,8.69395e+13,6.83944,179.577,7835,7,7,4353,4353,4353,4353,4353
1775,64,178,1307,468,0,1775,6.44973e+18,21.6451,336.832,1775,68,63,1597,1597,838,1014,1454
39626,31,45,0,39626,39351,275,2.56673e+16,38.4853,692.708,39626,33,34,39522,39399,39038,39370,34900
36643,990,1126,36643,0,32811,3832,1.78048e+18,307.692,3365.73,36643,166,178,35517,35512,35039,35331,33820
35322,104,2624,35322,0,32310,3012,1.06342e+18,435.231,6054.55,35322,559,248,30335,27654,23509,10902,4558
32395,97,1070,30196,2199,0,32395,2.48904e+18,522.345,3532.92,32395,289,203,28084,24565,23820,24051,4568
12514,862,1005,0,12514,0,12514,2.25226e+18,167.763,1960.85,12514,168,175,11509,11509,11374,11286,10252
29687,327,833,22354,7333,22354,7333,7.04119e+18,287.267,2569.77,29687,192,158,28794,27828,25165,22556,15360
35437,947,986,8380,27057,0,35437,2.91556e+13,228.491,3373.64,35437,242,128,34451,34451,34445,34448,34132
8420,10,16,0,8420,8414,6,1.36927e+16,9.92993,252.729,8420,13,10,8404,8404,7812,7880,7098
4355,10,13,4318,37,4355,0,9.37821e+13,7.9178,131.492,4355,9,9,4341,4339,4235,4233,4132
6656,222,575,5842,814,5842,814,1.71547e+18,171.654,1458.96,6656,150,111,6067,5859,5669,5713,4197
10287,9,445,9021,1266,0,10287,3.21341e+18,342.308,1639.03,10287,251,112,5393,3491,3545,3147,839
38811,366,631,38811,0,38811,0,3.45276e+18,321.845,3316.66,38811,228,191,38176,37706,35782,32276,26964
5650,83,318,0,5650,1457,4193,7.47309e+15,106.25,797.993,5650,70,82,5225,5042,4691,4789,2265
41125,718,1371,41125,0,38404,2721,9.63758e+17,696.616,4512.49,41125,409,238,39424,37835,35140,33429,27964
13789,143,422,13789,0,13789,0,3.2079e+18,220.37,1487.46,13789,128,111,13122,12810,10182,9855,5056
20124,148,466,0,20124,4591,15533,7.27737e+15,211.856,2028.48,20124,202,117,19396,19005,16699,18093,9676
19811,1200,1477,3339,16472,0,19811,2.24657e+13,157.904,3038.63,19811,420,148,18334,18334,18292,18295,15688
2406,247,369,2133,273,2133,273,1.59339e+18,95.18,759.899,2406,89,70,2037,2031,1989,2024,1742
44399,829,1006,33451,10948,33451,10948,7.01721e+18,363.524,3263.4,44399,246,176,43393,43382,43150,43097,40036
44278,94,516,44278,0,44278,0,5.03666e+18,323.642,2905.96,44278,217,172,41233,38394,26841,23420,14439
9870,117,759,9870,0,8744,1126,2.12718e+18,160.329,1594.18,9870,92,144,8951,8532,7198,8307,2177
33364,2168,2238,33364,0,26325,7039,1.00268e+18,304.812,4983.42,33364,289,291,31126,31126,31050,30407,30938
32666,114,2128,0,32666,4214,28452,3.77857e+15,11.8856,4111.96,32666,1065,13,30538,30538,11879,11481,9432
14869,6,11,14757,112,14869,0,7.85989e+13,6.2442,245.387,14869,8,8,14804,14694,13210,13216,11109
38169,82,1298,0,38169,0,38169,1.21405e+18,663.454,4234.73,38169,392,222,31906,27840,27175,23551,8067
21243,782,872,18762,2481,18762,2481,3.6292e+18,296.255,2221.26,21243,118,234,20371,20370,20290,20255,19456
3824,10,11,3654,170,3824,0,9.49543e+13,8.28583,137.646,3824,9,10,3813,3813,3751,3751,3429
20715,165,562,17948,2767,20715,0,3.01354e+18,323.011,2205.76,20715,252,123,19607,18989,16177,13148,7505
11135,29,59,0,11135,11067,68,2.61116e+16,24.4489,455.222,11135,30,30,11068,11055,10778,10765,9667
31179,142,1170,0,31179,0,31179,1.20696e+18,601.481,3691.64,31179,321,215,27991,26230,23626,21839,10279
21265,387,644,0,21265,0,21265,4.13924e+18,291.313,2016.74,21265,162,143,20621,19976,20246,20005,14595
20334,329,693,0,20334,4754,15580,7.25522e+15,198.538,2308.79,20334,257,110,19641,19601,17061,18011,8980
1903,237,258,1903,0,1656,247,1.29662e+18,99.2139,573.948,1903,92,64,1645,1645,1645,1643,1636
35603,304,847,8441,27162,0,35603,2.3402e+13,254.707,3332.02,35603,381,142,34756,34519,32671,31541,20139
17681,640,1365,16201,1480,0,17681,3.09668e+18,275.214,3042.44,17681,637,84,16316,16070,15759,15532,9237
36889,458,859,32482,4407,32482,4407,3.22688e+18,346.868,3721.46,36889,309,188,36030,35855,34586,33980,21081
35393,355,622,8032,27361,0,35393,2.87073e+13,235.767,2913.2,35393,240,135,34771,34758,34247,34487,24044
37338,608,1788,33628,3710,33628,3710,1.41777e+18,608.709,4999.5,37338,446,176,35255,34830,31202,31630,13560
6632,466,782,6204,428,0,6632,2.36681e+18,156.026,1607.17,6632,156,108,5850,5741,5709,5713,4859
49639,3,11,47379,2260,49639,0,9.58708e+13,10.7766,496.986,49639,11,11,44522,43086,35332,34895,29412
15223,3,11,14526,697,15223,0,9.56131e+13,10.1967,275.273,15223,11,11,13674,13238,10853,10439,9016
40914,281,704,40914,0,40914,0,3.42308e+18,331.379,3574.97,40914,205,194,39828,38692,33737,28683,17768
15142,349,462,15142,0,15142,0,3.28277e+18,232.904,1904.17,15142,145,131,14674,14534,14338,13785,12802
25289,7,12,24923,366,25289,0,9.61662e+13,9.94721,306.263,25289,11,10,25263,25257,24492,24494,23168
41575,2284,2437,37682,3893,0,41575,3.45007e+18,364.402,5990.32,41575,534,239,39138,39138,38918,38911,37495
9854,4,12,9638,216,9854,0,8.47797e+13,5.44794,194.74,9854,8,9,9755,9694,9316,9362,7883
4195,55,353,4193,2,4195,0,3.93333e+18,137.236,914.739,4195,131,69,3557,3204,2567,2108,1013
43916,939,1239,38556,5360,38556,5360,3.18654e+18,341.867,4602.9,43916,402,221,42677,42673,42275,41924,31936
29799,3,10,29579,220,29799,0,1.00031e+14,9.51341,336.86,29799,10,10,28363,27736,23790,26839,22905
34415,4,55,0,34415,33844,571,2.737e+16,35.8464,606.443,34415,34,29,33076,32312,25877,28430,17627
32028,330,1095,24064,7964,0,32028,8.30978e+18,309.519,3028.08,32028,243,155,30826,29746,29039,29084,17387
31039,37,60,0,31039,31009,30,1.90365e+15,43.8233,743.079,31039,48,21,30912,30772,30678,30686,24729
15003,320,1048,0,15003,3528,11475,7.33161e+15,121.735,2352.39,15003,203,150,13955,13932,13541,12833,9473
24081,583,1137,0,24081,4342,19739,4.61798e+15,182.63,3133.58,24081,350,97,22944,22850,22505,22312,15251
32255,59,795,28380,3875,0,32255,3.85576e+18,329.773,3405.03,32255,272,180,25954,22068,21579,21920,4863
4775,71,345,4775,0,4775,0,3.67903e+18,133.644,1005.49,4775,112,80,3932,3376,2993,2273,1127
1898,6,9,1825,73,1898,0,9.29853e+13,6.0785,93.1256,1898,9,8,1883,1877,1843,1844,1772
43299,627,2180,0,43299,0,43299,1.80442e+18,274.018,5428.86,43299,402,244,41119,40987,39476,28197,24677
28756,4,11,28449,307,25829,2927,7.67607e+13,6.49562,379.398,28756,8,8,28612,28522,26441,26450,22147
10074,9,19,0,10074,10068,6,1.69524e+16,12.9443,354.623,10074,15,15,8772,6516,7610,8579,7459
1115,17,217,1115,0,1051,64,2.76774e+18,58.0771,366.544,1115,77,40,808,748,698,554,148
43907,2478,2570,43907,0,39221,4686,1.65686e+18,287.718,5919.98,43907,646,239,41337,41337,41337,41337,40446
7848,110,739,1314,6534,0,7848,1.8046e+13,81.3962,1283.6,7848,304,93,7107,7014,6849,6331,1032
3268,14,368,3268,0,2476,792,8.39623e+17,76.0569,745.227,3268,72,86,1590,1000,914,889,208
36462,5395,6087,36462,0,36462,0,8.54759e+17,9.01333,7803.41,36462,3044,11,30375,30375,29684,28997,26950
16090,268,581,12104,3986,0,16090,8.34922e+18,254.345,1713.22,16090,143,121,15392,14922,14845,14925,9375
44489,712,1879,44489,0,39620,4869,8.16797e+17,440.584,5629.68,44489,500,172,42610,42264,39912,34251,24379
25564,883,1326,23203,2361,0,25564,3.38474e+18,304.926,3480.95,25564,474,159,24238,24237,23315,23244,18150
21504,717,1619,19131,2373,0,21504,3.8103e+18,199.189,3437.05,21504,226,194,19885,19882,19791,19707,16619
17178,533,1647,17178,0,15718,1460,5.07221e+18,262.504,3231.62,17178,678,117,15531,15302,10192,9817,6633
21643,833,899,20186,1457,20186,1457,2.09576e+18,420.879,2719.57,21643,222,178,20744,20744,20716,20724,20418
35249,1149,1260,32889,2360,32889,2360,2.06677e+18,545.917,3940.04,35249,323,212,33989,33969,33887,33889,33074
3683,170,299,3683,0,3683,0,3.89381e+18,111.789,735.737,3683,76,72,3384,3282,3099,3003,2387
7455,424,456,0,7455,1624,5831,4.63935e+15,144.141,1168.96,7455,121,102,6999,6999,6984,6989,6850
3307,217,275,2471,836,2471,836,7.29493e+18,73.2189,644.049,3307,75,66,3032,3031,3023,3020,2992
32287,251,619,23818,8469,32287,0,3.97306e+18,347.868,2868.91,32287,300,147,31230,30466,26664,22720,17157
40747,329,733,11349,29398,0,40747,6.28701e+13,240.94,2532.75,40747,173,145,40014,39770,38369,38584,24321
29752,281,789,26226,3526,0,29752,3.81269e+18,342.47,3261.29,29752,278,183,28515,27625,24264,24937,10442
47525,156,1551,47525,0,44409,3116,9.53224e+17,753.225,5032.92,47525,456,249,42556,39785,32631,32174,7901
13904,16,43,0,13904,13888,16,2.06679e+16,24.0212,415.626,13904,27,27,13787,13719,11675,12205,10632
43914,484,891,0,43914,9465,34449,4.67991e+15,462.87,3651.19,43914,363,199,42834,41656,41178,40136,32609
41395,349,2817,41395,0,37989,3406,3.15867e+18,435.995,6377.62,41395,718,189,38039,36966,28963,29689,11148
19581,514,623,18719,862,18669,912,8.0022e+17,442.195,2422.27,19581,219,144,18946,18781,18469,18678,17691
32551,1348,1974,0,32551,0,32551,1.74687e+18,276.317,4715.61,32551,425,221,30577,30564,30577,30577,25639
28608,765,1785,26569,2039,26569,2039,2.24607e+18,432.362,4101.05,28608,706,113,26823,26174,26064,26037,14566
41969,319,992,31657,10312,31657,10312,6.97822e+18,355.198,3194.72,41969,239,178,40728,39249,33507,28619,19060
39713,23,63,0,39713,39407,306,2.50105e+16,48.2471,877.107,39713,40,41,39476,39401,37610,36269,28225
42703,1343,2134,7935,34768,0,42703,2.42474e+13,433.58,5443.65,42703,604,208,40569,40398,39644,40156,30169
32348,681,789,32348,0,24315,8033,8.28913e+17,363.628,2776.26,32348,236,168,31559,31553,31519,31527,29825
31083,508,2270,707,30376,0,31083,2.09017e+12,56.4055,4382.56,31083,466,55,28813,28811,26640,26213,10671
22505,983,1119,19807,2698,19807,2698,1.53618e+18,345.962,3406.19,22505,363,157,21386,21386,21375,21367,20454
4879,24,32,0,4879,4658,221,2.45314e+16,15.4915,225.403,4879,20,19,4847,4841,4768,4746,4517
28434,1271,1712,0,28434,0,28434,2.15195e+18,270.208,4500.68,28434,316,176,26722,26715,26238,24281,20804
23781,3,10,23696,85,23717,64,1.03223e+14,7.67268,287.878,23781,9,10,22961,22529,21294,22046,17819
22042,649,872,19473,2569,19473,2569,1.6797e+18,400.773,3016.46,22042,255,172,21170,21166,20838,20794,17413
40140,6,68,0,40140,39663,477,2.53961e+16,40.9057,921.191,40140,36,42,37010,35165,29523,30450,15278
15656,254,336,15656,0,15656,0,4.98673e+18,189.822,1488.36,15656,161,112,15320,15217,14722,14633,13659
13752,145,403,13752,0,13752,0,5.05544e+18,248.9,1592.82,13752,160,121,13065,12520,9672,8951,6662
40465,1278,2131,36331,4134,36331,4134,8.57778e+17,301.609,5138.2,40465,367,239,38334,38299,38124,38160,31756
22864,269,1310,22864,0,21423,1441,8.50062e+17,452.408,3534.89,22864,315,218,20995,20418,18435,18161,9512
21576,8,11,20545,1031,21576,0,9.62261e+13,10.2999,327.814,21576,11,11,21508,21458,20889,20890,19617
14376,232,1108,0,14376,0,14376,1.89969e+18,191.12,2437.3,14376,214,150,13236,12256,11963,8366,5771
27118,1316,1564,25031,2087,25031,2087,2.41369e+18,250.069,4052.16,27118,388,134,25554,25554,25245,25116,21770
16958,334,426,16958,0,16958,0,3.1767e+18,241.877,1640.25,16958,141,111,16532,16486,15635,15264,14610
45059,640,1036,33970,11089,33970,11089,3.79983e+18,391.433,3511.43,45059,244,202,44023,43938,43513,43457,30290
10121,332,536,0,10121,0,10121,9.11513e+17,270.011,1632.48,10121,184,122,9564,9092,9211,9242,8614
23733,9,13,23410,323,23621,112,8.52978e+13,6.65394,309.497,23733,8,9,23720,23719,21941,21939,21486
45896,1526,1890,0,45896,0,45896,2.92367e+18,337.302,5596.1,45896,327,227,44006,43998,43475,43112,34096
46637,1951,2896,42410,4227,42410,4227,2.68951e+18,507.634,6980,46637,625,264,43741,43635,42624,41163,32541
36670,517,1230,0,36670,0,36670,1.53784e+18,414.428,4286.83,36670,412,191,35440,35025,33256,30857,22913
41355,713,1859,0,41355,0,41355,1.94471e+18,317.975,4412.36,41355,249,180,39496,39407,37234,28165,24040
45768,1184,1201,10357,35411,0,45768,1.98647e+13,446.077,4264.82,45768,373,205,44567,44567,44567,44567,44449
21181,571,824,4684,16497,0,21181,2.17544e+13,219.74,2616.02,21181,362,110,20357,20293,19974,20125,14586
8539,114,355,0,8539,1957,6582,7.22913e+15,147.029,1219.64,8539,157,79,8099,7944,6737,7293,3564
1049,11,103,294,755,0,1049,6.14465e+13,25.6034,238.908,1049,35,34,753,657,650,487,186
4199,394,547,3757,442,3757,442,1.60228e+18,148.153,1167.94,4199,146,73,3652,3598,3625,3608,2823
25093,611,794,18925,6168,0,25093,8.26064e+18,279.449,2336.17,25093,179,148,24299,24281,24099,24087,20313
21572,605,872,3670,17902,0,21572,2.03712e+13,279.653,2679.2,21572,301,100,20700,20628,20312,20046,16678
9708,127,539,8679,1029,9708,0,3.72051e+18,216.001,1600.41,9708,205,92,8833,7981,6952,5112,3154
30223,1602,2322,27241,2982,27241,2982,1.03216e+18,242.831,4964.46,30223,425,223,27901,27900,27727,27741,23214
34000,1474,1612,0,34000,8124,25876,6.65679e+15,255.09,4047.39,34000,458,151,32388,32388,32242,32268,30381
1604,208,216,1493,111,1493,111,5.60496e+17,101.627,473.157,1604,68,51,1388,1388,1388,1387,1379
10580,606,647,9366,1214,9366,1214,1.66983e+18,284.436,1904.72,10580,181,125,9933,9933,9927,9931,9685
32159,478,790,28281,3878,0,32159,3.86955e+18,334.131,3402.1,32159,286,190,31369,31356,30134,30398,19621
30234,749,973,27060,3174,27060,3174,3.26827e+18,287.091,2839.68,30234,154,166,29261,29244,28876,28884,26288
6394,1,10,6324,70,6394,0,1.05916e+14,6.62371,152.464,6394,8,9,3409,3409,3409,3409,3409
43992,157,957,0,43992,9508,34484,4.77646e+15,459.842,3703.56,43992,352,210,41276,40415,38032,33732,15812
8805,51,58,0,8805,8753,52,2.68344e+16,18.6815,409.919,8805,24,26,8747,8747,8676,8629,8184
7817,497,557,0,7817,1991,5826,6.27778e+15,153.59,1109.93,7817,347,58,7260,7260,7233,7260,7150
12240,374,550,10801,1439,10801,1439,3.19081e+18,262.165,1879.76,12240,193,130,11672,11478,11131,10932,7147
12405,598,646,12405,0,10960,1445,7.99861e+17,367.495,2042.09,12405,246,120,11759,11755,11706,11522,11632
44762,1299,1603,0,44762,0,44762,1.59929e+18,383.064,5297.17,44762,446,216,43159,43156,42904,42893,37079
47633,816,2546,42987,4646,0,47633,3.47415e+18,272.832,6168.07,47633,511,241,45087,44997,43853,43713,27992
13576,429,1022,0,13576,0,13576,1.16583e+18,236.75,2352.36,13576,212,141,12554,12315,12031,10617,8946
20513,748,907,18019,2494,0,20513,3.54848e+18,294.757,2984.39,20513,331,154,19606,19606,19501,19496,16911
40661,2446,2650,40661,0,40661,0,9.84565e+17,16.5994,5221.41,40661,1325,17,38011,38011,38011,38011,35639
24795,77,616,24795,0,24795,0,4.04995e+18,252.261,2565.65,24795,191,160,22889,21237,15715,14611,5325
15504,522,579,11659,3845,11659,3845,7.08732e+18,250.313,1691.13,15504,151,122,14925,14921,14916,14915,14385
10603,7,10,10551,52,10539,64,8.30383e+13,6.62595,184.73,10603,9,9,10592,10591,10534,10541,10295
14652,563,1001,0,14652,0,14652,1.26401e+18,230.854,2372.54,14652,212,147,13651,13430,13245,12836,10470
45808,1071,1263,0,45808,10486,35322,6.38653e+15,412.175,4486.77,45808,353,208,44545,44542,44363,44408,42506
44665,1288,2915,40486,4179,40486,4179,1.02935e+18,292.605,6624.76,44665,520,274,41750,41746,40164,40318,25651
797,9,17,0,797,755,42,2.5044e+16,11.5496,78.633,797,14,12,766,743,638,720,597
12447,578,1054,11571,876,11571,876,7.59476e+17,471.851,2492.5,12447,230,166,11306,10719,10814,10834,8155
4510,137,473,4144,366,0,4510,2.99747e+18,152.728,1029.85,4510,179,70,3932,3617,3505,3627,1529
42584,849,1886,37002,5582,37002,5582,3.83042e+18,353.485,5541.56,42584,365,216,40698,40624,36150,33467,25251
36977,1029,1079,32564,4413,32564,4413,1.72398e+18,410.21,4149.06,36977,298,197,35898,35898,35894,35897,35570
3365,3,7,3364,1,3365,0,8.13061e+13,6.53908,112.604,3365,7,7,3228,3194,2687,2698,2803
7958,51,282,7958,0,7958,0,4.84539e+18,131.723,1031.37,7958,122,92,6803,5598,4165,3799,2931
33415,695,1263,0,33415,8291,25124,1.05236e+16,195.545,3904.76,33415,257,163,32152,32137,30715,30550,18826
29635,1606,1938,29635,0,24067,5568,2.96793e+18,15.8511,3810.04,29635,970,16,27697,27697,27697,27697,23966
45635,74,511,45635,0,45635,0,5.15011e+18,315.249,2901.99,45635,219,171,41472,37065,25049,21455,12398
28856,445,548,6585,22271,0,28856,2.84495e+13,224.712,2542.46,28856,224,121,28308,28308,28165,28275,25673
47988,565,1961,44726,3262,44726,3262,2.1104e+18,591.501,5890.91,47988,382,260,45521,43643,43055,41545,20084
41597,157,460,41597,0,41597,0,5.33965e+18,336.606,2763.05,41597,224,169,40115,38707,26611,23951,18916
17237,449,707,3718,13519,0,17237,1.86246e+13,291.033,2203.02,17237,218,140,16526,16224,16039,15634,13757
17588,584,671,0,17588,3906,13682,4.73209e+15,317.887,2147.48,17588,202,153,16917,16720,16825,16850,16106
40412,191,1315,9510,30902,0,40412,2.86455e+13,241.021,4104.15,40412,341,149,38408,37376,33999,33172,15800
8027,97,530,7093,934,7093,934,1.54363e+18,323.907,1517.26,8027,230,98,6434,6027,4798,5496,1078
4675,682,823,4006,669,4006,669,4.38484e+18,41.3784,1196.04,4675,254,71,3852,3852,3824,3828,3196
30928,536,673,30928,0,30928,0,3.42693e+18,300.857,3035.43,30928,185,184,30255,30239,29691,28909,26115
38566,1395,2362,35103,3463,35103,3463,2.63247e+18,367.196,5723.53,38566,516,243,36204,36177,35611,35702,22332
11416,382,522,8593,2823,8593,2823,3.81773e+18,235.965,1488.1,11416,129,124,10894,10568,10798,10789,9166
40805,6,48,0,40805,40675,130,2.74245e+16,24.9199,691.788,40805,25,26,40398,40259,33998,37250,22531
32482,84,1141,32482,0,30319,2163,1.0956e+18,511.965,3682.1,32482,316,208,27053,22933,19977,20587,8817
3244,288,289,2862,382,0,3244,4.30784e+18,53.4516,603.613,3244,59,60,2955,2955,2955,2955,2955
38653,482,631,38653,0,38653,0,3.5347e+18,300.139,3302.59,38653,222,176,38022,38020,37341,36421,34038
24458,1644,1823,24458,0,22003,2455,1.2208e+18,215.022,4049.04,24458,486,130,22635,22635,22635,22635,20485
32240,341,711,32176,64,32240,0,3.18142e+18,358.253,3052.21,32240,241,155,31380,30993,28499,27156,19139
28139,7,9,27552,587,25395,2744,8.30352e+13,6.03991,292.506,28139,9,7,28130,28129,28129,28128,27302
18356,2928,3067,18356,0,0,18356,5.39089e+18,7.49564,3995.74,18356,1536,9,15289,15289,15220,14992,14823
17962,96,415,0,17962,4550,13412,6.27441e+15,228.598,1937.85,17962,246,113,16067,14888,14636,15533,4507
12226,190,375,2818,9408,0,12226,2.84729e+13,164.944,1485.49,12226,173,90,11788,11659,10794,10574,6677
21894,34,44,0,21894,21722,172,2.53587e+16,37.3746,507.314,21894,28,29,21826,21761,21665,21629,18868
29441,669,717,25840,3601,25840,3601,3.27527e+18,314.08,3155.87,29441,273,186,28724,28724,28679,28639,27433
19325,372,517,19325,0,19325,0,3.53094e+18,295.865,1786.06,19325,514,37,18668,18179,18424,17934,15094
10112,474,595,2144,7968,0,10112,2.23106e+13,169.541,1689.44,10112,289,83,9517,9514,9489,9517,9165
15559,421,1427,13455,2104,13389,2170,2.35641e+18,433.23,2981.04,15559,308,203,13789,13125,10996,12915,1797
31958,185,491,31958,0,31958,0,3.23061e+18,294.122,2319,31958,189,135,30885,30046,24696,24019,15351
29770,1,14,29579,191,29770,0,9.75284e+13,11.3001,345.655,29770,12,11,16526,16526,16526,16526,16526
32246,751,1357,28955,3291,28955,3291,2.60859e+18,432.652,4131.63,32246,407,179,30889,30614,30175,29780,24181
18853,370,837,16864,1989,16864,1989,8.93209e+17,256.627,2272.89,18853,136,157,18016,17857,17297,17311,10231
6369,27,397,1423,4946,0,6369,1.73231e+13,92.8884,993.588,6369,114,76,5110,4230,4127,3081,1052
3567,476,673,3314,253,0,3567,2.47242e+18,128.531,1186.17,3567,127,100,2894,2833,2848,2860,2443
38752,541,911,8424,30328,0,38752,1.86276e+13,410.532,3418,38752,302,188,37841,37125,36505,34961,30221
23836,512,892,21022,2814,21022,2814,1.69738e+18,388.889,3153.65,23836,248,170,22944,22373,22045,22138,14233
41090,337,909,0,41090,0,41090,1.89622e+18,340.786,3979.13,41090,316,212,39889,38866,36475,36009,16772
13087,444,514,13087,0,13087,0,3.22238e+18,212.702,1404.67,13087,443,21,12573,12245,12566,12570,11745
41344,26,196,0,41344,39652,1692,2.49739e+16,29.1498,1171.88,41344,76,41,41098,40937,39299,38905,31941
1706,97,356,1593,113,1593,113,2.06328e+18,61.0868,602.446,1706,55,90,1333,1206,1130,1207,333
928,85,342,928,0,884,44,1.14817e+18,13.8308,465.628,928,53,65,586,569,468,413,316
45145,377,676,42401,2744,45145,0,4.00245e+18,351.562,3520.09,45145,279,176,44359,43964,37977,36904,26803
27379,59,67,0,27379,27187,192,2.0747e+16,25.7422,695.967,27379,31,33,27312,27312,26301,26545,25677
10691,1,12,10560,131,10691,0,9.66511e+13,8.60789,198.719,10691,9,10,5958,5958,5958,5958,5958
38706,103,504,38706,0,38706,0,5.05018e+18,319.168,2686.25,38706,210,165,36415,34386,23551,20710,12974
48781,383,1051,11016,37765,0,48781,2.24578e+13,408.703,4211.69,48781,451,159,47492,47083,42925,44607,18968
41917,561,1152,41917,0,36894,5023,1.16574e+18,422.635,4515.04,41917,310,204,40765,40518,37947,31724,22780
21758,537,729,5659,16099,0,21758,2.9513e+13,178.809,2020.81,21758,111,138,21029,21014,20774,20859,18631
10787,86,734,2503,8284,0,10787,2.35902e+13,61.1299,1661.01,10787,263,66,10044,9787,9424,3592,2701
19461,137,912,17334,2127,0,19461,3.99833e+18,205.363,2262.81,19461,129,156,17947,16993,15954,16214,3143
31713,479,1305,29612,2101,29612,2101,6.41654e+17,656.396,3940.68,31713,382,219,29709,28613,27763,27702,15804
7793,501,589,1696,6097,0,7793,1.87104e+13,152.184,1466.59,7793,164,112,7204,7162,7193,7177,6471
18833,1484,1536,18833,0,15314,3519,7.74806e+17,201.283,3643.72,18833,312,174,17297,17297,17297,17297,16949
49835,2349,2454,49835,0,40713,9122,9.66528e+17,388.867,6206.71,49835,501,304,47381,47381,47211,46633,46563
2855,396,443,2536,319,2536,319,3.51239e+18,72.6074,783.633,2855,116,59,2412,2412,2383,2406,2296
37215,541,793,28039,9176,0,37215,8.31063e+18,361.175,2811.97,37215,227,167,36422,36334,35928,35948,30506
11072,534,619,9748,1324,9748,1324,1.68141e+18,299.462,1942.67,11072,208,136,10453,10297,10337,10400,9336
40666,342,1890,35797,4869,35797,4869,3.38504e+18,532.549,5177.75,40666,537,263,37411,35254,31163,26468,4799
8062,466,859,0,8062,0,8062,4.80608e+17,308.185,1724.06,8062,253,97,7177,6887,6219,5302,4307
20755,694,1840,19054,1701,19054,1701,2.57935e+18,216.279,3663.32,20755,638,184,18915,18700,18349,18280,9845
31181,496,1853,0,31181,6912,24269,7.60973e+15,183.545,4053.18,31181,431,218,29328,29179,25937,24569,8305
32849,1134,1706,30185,2664,30185,2664,7.45272e+17,426.937,4666.5,32849,412,214,31143,31120,30800,30550,22470
16063,123,1211,0,16063,0,16063,1.1565e+18,258.875,2901.76,16063,288,136,14314,12944,12392,12609,4966
35981,386,806,31656,4325,31656,4325,3.23743e+18,332.466,3607.48,35981,293,184,35147,34358,33314,32336,18218
32186,611,678,32122,64,32186,0,3.63504e+18,335.271,2991.06,32186,198,150,31508,31496,31424,31420,31194
5888,189,458,5888,0,5888,0,3.51545e+18,170.132,940.211,5888,229,25,5338,5115,5133,5074,2305
26854,619,1409,4844,22010,0,26854,2.52521e+13,334.225,3711.23,26854,370,184,25445,25272,24550,23946,10325
4751,296,525,906,3845,0,4751,2.84392e+13,45.6035,1034.84,4751,179,51,4226,4194,4064,4120,2670
24946,536,844,0,24946,6533,18413,7.58481e+15,202.278,2218.11,24946,115,140,24102,24090,23098,23170,17929
13741,271,2630,0,13741,0,13741,4.60005e+17,13.9736,2971.98,13741,339,22,11111,11111,8753,9043,2025
19016,6,12,18787,229,19016,0,9.67609e+13,9.31663,262.349,19016,10,10,18947,18902,18064,18026,16971
23785,464,471,0,23785,5530,18255,7.3814e+15,204.047,2207.72,23785,213,113,23314,23314,23313,23314,23249
16749,32,36,0,16749,16586,163,1.87576e+16,18.7466,470.795,16749,21,25,16713,16713,16667,16689,16005
2520,259,344,523,1997,0,2520,2.0332e+13,48.8917,718.973,2520,70,95,2176,2176,2169,2166,1748
10018,10,14,9935,83,10018,0,9.73841e+13,10.6266,201.777,10018,11,9,10002,9998,9613,9612,8671
35075,38,65,0,35075,35005,70,2.0772e+16,29.7372,713.068,35075,32,32,35010,35000,30633,32290,25603
35381,1141,2806,0,35381,7854,27527,1.62186e+15,275.027,5062.73,35381,375,118,32575,32575,28264,28907,15319
15939,425,622,0,15939,0,15939,1.84687e+18,309.485,2225.4,15939,229,146,15317,15047,14937,15002,11290
7411,214,733,0,7411,0,7411,1.49113e+18,204.877,1612.21,7411,260,87,6573,6401,6151,4310,1937
37739,1537,1602,37739,0,33937,3802,7.35463e+17,565.515,4919.27,37739,437,195,36137,36123,36132,36118,35815
3330,59,272,0,3330,66,3264,3.21618e+14,13.2123,568.433,3330,205,22,3058,3034,2861,2031,1084
25053,1118,1854,22596,2457,0,25053,3.41481e+18,205.425,4080.79,25053,375,171,23199,23198,23172,23199,17318
37266,1033,2506,34486,2780,0,37266,2.79498e+18,452.911,5570.47,37266,741,219,34760,34255,33712,33414,17920
10945,56,992,0,10945,0,10945,1.96043e+18,173.478,2136.26,10945,196,99,8674,7643,7325,1612,1655
33636,494,1145,0,33636,7840,25796,6.28564e+15,346.083,3495.99,33636,396,137,32491,32149,30094,27178,16259
20403,364,640,15361,5042,0,20403,8.32499e+18,286.236,1985.92,20403,176,129,19755,19035,19277,19297,14023
34465,330,916,34465,0,25971,8494,8.10258e+17,350.801,2988.87,34465,219,169,33321,32078,30665,27948,15552
28433,11,62,0,28433,28216,217,2.56598e+16,40.2771,737.053,28433,37,37,27476,26483,25547,25082,17797
41755,150,864,31486,10269,0,41755,8.28179e+18,371.163,3046.21,41755,244,174,39373,38343,27624,28808,11698
6192,465,519,5760,432,5760,432,6.30408e+17,132.469,1218.92,6192,139,82,5673,5673,5673,5673,5581
24779,911,1480,22803,1976,22803,1976,2.44955e+18,430.085,3885.49,24779,343,184,23299,23284,22548,22261,14399
36714,363,618,36714,0,36714,0,3.37868e+18,306.579,3197,36714,224,177,36094,35660,34050,31475,26141
21427,294,1120,18867,2560,18867,2560,3.29038e+18,261.724,3018.46,21427,228,135,20007,19189,17379,15893,9237
14285,84,715,3241,11044,0,14285,1.82066e+13,196.399,1958.8,14285,188,114,13067,12023,11759,10580,4746
46829,2313,3759,46829,0,46829,0,1.84127e+17,155.933,6352.96,46829,1462,25,43070,42915,42838,43070,34958
33066,34,62,0,33066,32845,221,2.61331e+16,47.6312,801.065,33066,37,38,32943,32872,31867,31977,28467
13087,3,9,12753,334,12639,448,8.5645e+13,5.414,201.592,13087,9,6,12908,12840,12248,12357,8493
23889,591,878,22212,1677,0,23889,2.57163e+18,437.922,2753.06,23889,246,181,22994,22251,22571,22579,19371
46707,7,13,46407,300,38651,8056,8.38334e+13,8.80155,506.272,46707,11,10,46639,46530,44306,44201,39338
9621,941,1029,8743,878,8743,878,2.85761e+18,105.144,2116.97,9621,262,82,8592,8592,8580,8552,8003
11017,124,377,0,11017,3074,7943,1.61523e+16,133.167,1100.78,11017,78,85,10561,10389,10037,9762,4951
7498,365,649,0,7498,1239,6259,3.69167e+15,62.0379,1134.47,7498,231,65,6849,6849,6849,6849,4597
36646,1805,2368,33168,3478,33167,3479,1.23617e+18,387.295,5821.65,36646,490,261,34278,34235,34268,34067,29161
42572,1166,1362,39720,2852,0,42572,2.43647e+18,698.434,4533.6,42572,423,240,41210,41196,40997,40930,39253
1455,182,225,1361,94,0,1455,2.36342e+18,79.9629,451.444,1455,65,45,1230,1226,1213,1221,1133
32446,636,2885,32446,0,26720,5726,3.8245e+18,22.9774,3664.4,32446,972,963,29561,29561,21331,17616,26574
4432,83,432,4432,0,4231,201,3.20609e+18,100.142,885.111,4432,145,52,3837,3334,3621,3263,1219
37135,52,615,37135,0,37135,0,3.58939e+18,306.392,3229.74,37135,212,178,30080,25983,22425,14595,5475
47516,62,68,0,47516,47324,192,2.74424e+16,30.7648,809.626,47516,28,31,47448,47444,47448,47444,46587
40911,11,14,40172,739,38167,2744,7.99479e+13,6.50554,391.759,40911,9,10,40897,40897,39629,39628,39640
41785,1577,1743,8776,33009,0,41785,2.59386e+13,326.338,4941.86,41785,432,198,40042,40042,40042,40042,37607
13652,245,867,0,13652,3229,10423,5.83232e+15,106.325,2128.24,13652,195,124,12785,12731,12148,12016,5669
23700,673,837,0,23700,0,23700,1.91265e+18,258.362,2363.14,23700,135,146,22863,22861,22624,22490,19611
21702,76,668,21702,0,16329,5373,8.80632e+17,324.246,2194.9,21702,188,148,19820,18581,15378,15445,4333
18534,35,607,13964,4570,0,18534,8.32017e+18,290.042,1898.33,18534,166,135,14785,8457,9729,9815,2934
26927,312,455,26927,0,26927,0,5.0433e+18,290.398,2248.79,26927,190,146,26417,26109,25255,24239,23053
1152,99,122,0,1152,0,1152,2.56407e+17,33.9696,287.57,1152,39,34,1030,1030,1029,1021,1005
14358,294,913,13419,939,13419,939,6.53035e+17,370.767,2367.23,14358,182,161,13197,12860,12382,12421,6437
38842,724,1497,36316,2526,36316,2526,6.43134e+17,588.874,4629.17,38842,318,256,37304,36491,35874,35825,25785
22944,10,13,22784,160,22944,0,1.0148e+14,11.0011,299,22944,11,10,22926,22918,21961,21960,20323
39042,1498,2848,0,39042,0,39042,5.4991e+16,14.8305,5102.92,39042,1250,22,36194,36194,34858,35469,24264
11390,26,375,3178,8212,0,11390,6.26227e+13,135.191,1112.32,11390,88,81,10330,9197,8833,4290,2564
22835,315,1052,21325,1510,21325,1510,2.03689e+18,483.045,3085.01,22835,269,172,21141,20626,19901,19594,13486
42682,1,55,0,42682,42046,636,2.75386e+16,42.8625,680.595,42682,34,31,18959,18959,18959,18959,18959
13502,296,551,0,13502,0,13502,1.91376e+18,259.268,1983.8,13502,202,133,12851,12563,11702,11624,7596
19475,55,1280,18247,1228,0,19475,2.33763e+18,424.306,3242.27,19475,301,173,15252,12723,12561,12352,3465
11987,2,13,11900,87,11987,0,9.75901e+13,7.3377,216.242,11987,9,9,10825,10480,8453,10411,7417
27720,801,1145,25937,1783,25937,1783,6.12371e+17,580.687,3493.74,27720,330,199,26537,25686,26067,25933,24382
10941,6,7,10788,153,9385,1556,7.13144e+13,5.84014,179.898,10941,7,7,10933,10932,10927,10927,10927
35796,571,1987,27297,8499,27203,8593,3.71579e+18,305.795,4556.98,35796,322,234,33809,33729,33096,33427,26761
20057,415,625,15104,4953,0,20057,8.33461e+18,286.34,1970.57,20057,180,137,19432,19222,19104,19115,15569
16638,279,761,0,16638,0,16638,2.15187e+18,265.869,1903.97,16638,109,194,15764,15309,13868,5746,6145
35186,177,412,35186,0,35186,0,4.97482e+18,263.467,2468.47,35186,212,145,34375,33796,27891,26528,17598
1254,15,17,0,1254,1176,78,2.55134e+16,12.4952,97.4967,1254,15,13,1235,1229,1221,1230,1171
30523,398,1652,27041,3482,0,30523,3.81315e+18,306.781,4321.71,30523,296,193,28719,27624,26133,26386,11689
49846,210,1527,46483,3363,46483,3363,6.68524e+17,771.284,5124.13,49846,460,264,45300,43714,40659,40818,19101
25667,635,1116,24024,1643,0,25667,2.34392e+18,528.759,3299.25,25667,343,189,24391,23610,23622,23446,17645
22462,461,522,0,22462,6247,16215,1.61846e+16,193.986,1775.34,22462,122,126,21940,21940,21918,21917,21038
11463,247,742,0,11463,2170,9293,4.48932e+15,97.9839,1803.58,11463,240,66,10721,10589,10416,10174,5746
19307,73,528,5406,13901,0,19307,6.2691e+13,177.494,1610.59,19307,112,109,18362,17992,15832,11912,4651
43464,4,36,0,43464,41459,2005,2.45864e+16,29.0001,683.024,43464,30,29,39491,37630,28548,28783,19519
2338,45,207,542,1796,0,2338,1.90206e+13,64.586,498.201,2338,68,50,2009,1754,1827,1753,821
38671,475,630,10736,27935,0,38671,6.31626e+13,257.185,2347.45,38671,185,140,38041,38014,37748,37669,33226
1381,10,11,0,1381,1377,4,1.25227e+16,6.04996,78.7043,1381,8,5,1370,1369,1370,1370,1369
25595,985,1176,23867,1728,0,25595,2.44583e+18,571.14,3456.7,25595,343,200,24419,24404,24186,24127,22728
5676,386,805,5676,0,5273,403,8.85596e+17,159.734,1561.74,5676,184,129,4871,4726,4501,4012,3731
11354,120,391,0,11354,2559,8795,7.16654e+15,175.384,1455.8,11354,173,87,10821,10572,9000,9429,4204
12337,502,756,12337,0,11489,848,1.11996e+18,354.795,1991.68,12337,204,145,11567,11214,10836,11208,9270
8942,9,10,8846,96,8942,0,7.94188e+13,6.13219,191.483,8942,7,8,8932,8932,8341,8341,8485
38714,318,522,38714,0,38714,0,3.38559e+18,311.339,2728.97,38714,174,160,38121,37665,34460,33098,25632
49353,1547,2088,49353,0,44339,5014,7.71008e+17,569.747,5938.1,49353,462,186,47265,47058,46965,47136,41332
21227,10,495,21227,0,21227,0,3.59734e+18,291.933,2300.58,21227,172,166,12915,10280,8145,5084,1408
39670,1108,1460,37114,2556,0,39670,2.37367e+18,604.738,4536.61,39670,419,209,38210,37904,37880,37899,35476
16501,70,431,0,16501,4603,11898,1.61884e+16,169.666,1393.41,16501,101,99,15714,15411,13420,13691,6223
48010,16,66,0,48010,47649,361,2.5308e+16,52.8147,972.232,48010,43,42,47278,46459,44438,43425,32193
18216,211,727,3993,14223,0,18216,1.87436e+13,307.175,2242.73,18216,253,128,17200,16934,16261,13927,9788
9560,9,34,0,9560,9283,277,2.51674e+16,9.78452,347.704,9560,17,12,9517,9496,9302,8910,4690
30108,229,1228,0,30108,0,30108,1.2499e+18,597.795,3750.07,30108,373,214,27412,26677,25003,21922,12133
14635,543,658,3269,11366,0,14635,1.92905e+13,224.707,1916.56,14635,206,118,13977,13846,13916,13879,12885
24253,828,1177,0,24253,0,24253,1.20632e+18,559.068,3324.83,24253,326,188,23076,22388,22422,21117,17989
15731,475,1014,13783,1948,13783,1948,1.69519e+18,308.846,2743.51,15731,217,155,14717,14351,13788,13826,5937
25445,675,913,22392,3053,22392,3053,1.72479e+18,376.346,3284.42,25445,270,173,24532,24532,24185,24192,20058
7540,298,679,7540,0,7025,515,1.11565e+18,158.717,1504.48,7540,152,125,6861,6705,6205,6277,5153
41337,24,45,0,41337,41026,311,2.54434e+16,40.5851,711.361,41337,35,35,41174,41031,40200,40725,30766
33649,830,1357,30426,3223,0,33649,2.97075e+18,472.14,4197.71,33649,407,179,32292,31993,31718,31717,26406
3236,148,205,3236,0,2422,814,8.6273e+17,92.2617,608.324,3236,68,76,3031,3020,2973,2899,2622
48443,574,1541,48443,0,42622,5821,1.04277e+18,412.299,5581.44,48443,402,217,46902,46752,43803,34812,23331
3682,8,9,0,3682,3679,3,1.94333e+16,4.77213,130.656,3682,6,7,3673,3673,3659,3660,3576
29262,561,952,0,29262,6248,23014,4.66653e+15,350.521,3126.01,29262,292,161,28310,28035,27853,27834,22994
622,144,168,0,622,0,622,9.49372e+17,13.7958,252.98,622,62,22,454,448,454,450,400
47646,1956,2428,42505,5141,0,47646,3.82613e+18,337.087,5464.82,47646,466,192,45218,45216,45197,45205,44192
30143,978,1205,28090,2053,0,30143,2.45485e+18,576.367,3724.83,30143,323,211,28938,28855,28660,28583,26963
13072,344,533,9850,3222,0,13072,8.3253e+18,238.306,1524.28,13072,147,109,12531,12143,12308,12320,9403
6213,7,10,6168,45,6213,0,1.00983e+14,6.76952,154.224,6213,9,8,6192,6168,6088,6089,5506
43123,1450,2895,38961,4162,38958,4165,1.36246e+18,478.914,6848.2,43123,689,269,40228,40015,39393,39334,23622
15043,43,50,0,15043,14830,213,2.45781e+16,34.9343,493.915,15043,32,32,14989,14962,14724,14781,13528
18352,51,955,0,18352,3854,14498,4.91991e+15,235.079,2584.76,18352,240,171,15919,13851,14087,10954,3190
47221,241,1824,0,47221,0,47221,1.79826e+18,307.286,5012.89,47221,522,196,44848,42840,39445,34626,10541
43095,1058,2697,43095,0,38957,4138,1.31231e+18,359.999,6576.7,43095,505,297,40398,40285,37710,37147,20438
48010,7,11,45714,2296,48010,0,9.60575e+13,10.8023,489.722,48010,11,11,47694,47395,42965,43126,42653
10829,152,417,10829,0,10829,0,3.02629e+18,186.532,1543.62,10829,134,114,10237,9951,8666,7226,4615
26040,1312,1794,26040,0,22281,3759,9.22221e+17,268.116,4573.5,26040,371,201,24246,24237,24175,24170,17621
12331,825,1195,11621,710,11621,710,7.0156e+17,265.219,2661.03,12331,227,165,11136,10964,11008,11088,9031
44246,1427,1485,44246,0,38901,5345,1.14331e+18,399.42,5064.53,44246,331,202,42761,42761,42756,42742,41894
46563,169,2214,8938,37625,0,46563,2.46038e+13,456.973,5751.39,46563,630,217,43331,42176,40102,23897,9459
2483,128,175,2166,317,0,2483,4.01077e+18,114.699,548.6,2483,88,65,2266,1991,2163,2207,2040
20764,4,13,20619,145,20764,0,1.02537e+14,10.2805,284.59,20764,11,10,20468,20348,19311,19389,14388
30098,21,1254,28133,1965,28133,1965,2.02455e+18,632.461,3753.93,30098,443,201,19983,16156,13648,14012,3545
45061,196,1842,40282,4779,0,45061,3.86474e+18,284.05,4665.51,45061,398,183,42472,39249,36612,35672,7122
23687,435,757,5049,18638,0,23687,1.8776e+13,374.505,2636.28,23687,265,169,22859,22263,22114,21243,16973
19393,734,1078,18082,1311,18082,1311,2.08786e+18,465.705,2919.12,19393,282,179,18296,17717,17772,17637,15248
13248,805,1280,12129,1119,0,13248,3.05641e+18,184.341,2710.49,13248,243,152,11968,11925,11700,11679,6852
44831,38,45,0,44831,44509,322,2.57492e+16,39.9139,735.965,44831,36,35,44759,44616,44451,44616,42798
44186,519,625,44186,0,44186,0,3.22754e+18,323.121,2870.95,44186,231,155,43561,43531,43005,42779,41682
7583,326,425,0,7583,1618,5965,3.58365e+15,53.9736,1017.18,7583,129,49,7158,7158,7158,7110,6142
42115,380,440,42115,0,42115,0,3.83132e+18,272.552,2794.16,42115,258,215,41675,41661,41255,41043,38277
37091,2061,2471,33559,3532,0,37091,3.35462e+18,439.577,5850.14,37091,587,246,34620,34582,34212,34370,32623
22560,918,1629,22560,0,19932,2628,1.13479e+18,301.644,3788.52,22560,336,193,20931,20916,20487,19679,15841
5681,303,524,781,4900,0,5681,1.68451e+13,75.1605,1143.79,5681,197,39,5157,5139,4940,5151,3295
42072,650,1277,39246,2826,39246,2826,2.08025e+18,674.493,4404.97,42072,392,234,40317,38680,38899,38343,26759
48693,8,9,48650,43,48693,0,3.67879e+13,5.84696,474.948,48693,7,7,48684,48683,48622,48623,48602
48510,281,716,11079,37431,0,48510,2.8562e+13,239.873,3551.45,48510,276,153,47794,46922,45487,46504,23955
9560,303,550,8938,622,8938,622,2.01915e+18,164.385,1446.21,9560,166,101,9010,8984,8692,8655,6042
24861,26,32,0,24861,23710,1151,2.45788e+16,26.6773,505.759,24861,25,26,24813,24768,24343,24037,22117
12387,26,367,2836,9551,0,12387,2.86371e+13,172.381,1487.93,12387,162,96,10302,9329,8502,2613,2122
45984,691,749,45920,64,45984,0,3.48184e+18,396.718,3706.99,45984,268,180,45235,45232,44962,44869,44424
19624,93,579,0,19624,5115,14509,7.49388e+15,185.221,1729.89,19624,103,128,18419,17471,16097,16549,6168
38447,7,9,38280,167,29177,9270,7.19668e+13,8.26088,440.473,38447,9,9,38416,38359,37032,36627,37042
25086,305,1823,23275,1811,0,25086,2.70156e+18,321.269,4105.51,25086,609,139,23099,22610,21514,21413,6388
28256,1052,1661,0,28256,0,28256,1.37244e+18,376.49,4376.19,28256,485,131,26595,26547,25987,20773,19026
30655,745,2205,23985,6670,23891,6764,3.44997e+18,274.998,4737.37,30655,364,242,28450,28396,26962,27988,21144
37148,3531,4050,0,37148,0,37148,1.78852e+17,14.573,5774.69,37148,1101,22,33098,33098,32584,32941,31140
12711,105,1194,11959,752,11959,752,7.52508e+17,208.747,2672.03,12711,251,122,10941,9336,9164,9897,3050
25604,188,362,25598,6,25604,0,3.25548e+18,297.446,2193.58,25604,180,136,24355,22462,21649,16306,15353
10864,144,476,9522,1342,0,10864,3.89269e+18,227.265,1679.89,10864,177,130,10089,8867,8656,8875,5487
37368,338,811,28142,9226,28142,9226,7.03335e+18,363.98,2824.31,37368,231,163,36373,34805,33491,31360,20948
34859,15,598,34859,0,34859,0,3.34805e+18,292.075,3096.47,34859,208,173,22905,18063,14694,9066,3207
1127,154,186,1084,43,1084,43,6.87371e+17,62.984,352.629,1127,59,36,941,872,906,935,818
39021,776,1792,9126,29895,0,39021,2.7143e+13,195.363,4443.39,39021,371,165,37229,37221,36732,36298,27531
531,1,5,529,2,531,0,1.11848e+14,2.93597,39.4857,531,4,5,283,283,283,283,283
49709,1133,1479,0,49709,11490,38219,5.72872e+15,389.832,4818.57,49709,386,202,48230,48218,47563,47784,40004
34495,630,926,8297,26198,0,34495,2.94862e+13,229.884,3273.72,34495,254,126,33569,33569,33096,33327,26946
42133,168,1181,42133,0,37069,5064,1.17122e+18,415.417,4543.98,42133,334,201,38639,33922,32307,24513,7256
24097,647,904,21230,2867,21230,2867,1.71681e+18,385.67,3190.39,24097,267,171,23193,23192,22795,22717,18500
45483,1203,2424,0,45483,0,45483,1.55909e+18,423.823,6473.74,45483,601,187,43059,42992,41101,24422,23323
38408,298,1306,0,38408,0,38408,2.08237e+18,352.612,3525.01,38408,156,293,36789,35806,31246,16656,9989
561,3,4,548,13,351,210,1.07372e+14,2.12299,36.7254,561,4,3,557,557,557,557,360
27239,23,57,0,27239,27026,213,2.53613e+16,26.0092,590.864,27239,28,27,27169,27124,26814,26767,18934
34815,282,627,0,34815,7879,26936,7.28684e+15,237.769,2889.7,34815,243,142,34188,33562,32825,33436,19725
49650,1590,2420,0,49650,0,49650,1.77294e+18,291.137,5997.6,49650,413,257,47230,47230,47076,47090,37984
26727,679,782,5621,21106,0,26727,1.8588e+13,319.642,2724.89,26727,219,180,25945,25945,25837,25730,24140
23771,565,679,0,23771,6047,17724,7.25016e+15,470.204,2212.07,23771,433,83,23017,21926,22841,22972,21035
39062,1179,1317,34285,4777,0,39062,3.93706e+18,308.426,4362.22,39062,294,184,37745,37745,37690,37735,36382
18752,650,1190,18752,0,16839,1913,7.56121e+17,357.126,3168.29,18752,390,157,17562,17484,17401,15612,14264
10670,43,55,0,10670,10656,14,1.98547e+15,29.098,421.514,10670,36,16,10606,10571,10571,10591,8625
6170,67,329,1443,4727,0,6170,1.8338e+13,95.6634,903.898,6170,109,66,5596,4992,5087,5114,2328
39693,276,1798,36972,2721,36972,2721,2.13163e+18,524.078,5173.29,39693,370,274,36647,35395,33837,32192,11881
29928,1,14,29514,414,29922,6,1.07321e+14,10.5161,320.526,29928,13,12,17042,17042,17042,17042,17042
30686,154,519,30430,256,30686,0,3.44731e+18,413.272,2265.38,30686,516,42,28190,26737,23413,23101,10036
36435,1290,1507,36435,0,32668,3767,1.51994e+18,272.526,4175.33,36435,438,163,34928,34928,34349,34354,30678
20265,846,1080,0,20265,0,20265,1.17883e+18,502.508,2975.9,20265,300,183,19185,18779,18857,18152,17419
19474,674,1298,0,19474,4133,15341,6.48259e+15,140.473,3014.1,19474,339,140,18176,18175,17839,18172,11403
7410,188,264,7410,0,7410,0,4.04322e+18,178.33,967.768,7410,91,100,7107,6679,6756,6387,5556
38380,216,839,28907,9473,0,38380,8.3258e+18,373.358,2905.86,38380,228,172,36635,35329,27790,28270,13186
18677,774,817,0,18677,4740,13937,8.04938e+15,169.548,1934.08,18677,89,154,17860,17860,17854,17845,17431
43490,170,1849,0,43490,0,43490,1.23345e+18,545.859,5422.61,43490,416,267,39736,38029,34585,32142,12560
6591,1,43,0,6591,6545,46,2.59434e+16,17.0736,272.114,6591,21,20,3164,3164,3164,3164,3164
30953,182,831,0,30953,7028,23925,4.53028e+15,428.595,2981.95,30953,325,178,29232,28790,27295,25574,8336
6986,491,758,0,6986,0,6986,2.04105e+18,128.021,1353.8,6986,302,56,6228,6114,6042,6217,5668
6440,68,779,5989,451,5989,451,2.17089e+18,175.021,1604.12,6440,166,121,5098,4330,4261,4352,1537
23631,39,385,0,23631,6157,17474,3.3184e+15,275.993,1996.26,23631,205,120,20023,18567,18704,15318,5562
525,49,96,0,525,0,525,4.04045e+18,34.4324,186.425,525,32,33,429,389,393,390,287
40362,93,1054,8808,31554,0,40362,2.21628e+13,433.345,3800.05,40362,448,142,36533,34009,33047,27839,7960
34005,2121,2251,30636,3369,0,34005,3.4534e+18,314.37,5194.49,34005,542,242,31754,31754,31754,31754,30555
20364,288,1066,0,20364,0,20364,1.16857e+18,461.081,2955.32,20364,302,174,18733,18279,17490,16225,11609
25027,268,593,25027,0,25027,0,3.43403e+18,266.663,2502.24,25027,181,135,24234,23315,21082,20010,14875
14525,433,1433,14525,0,13308,1217,5.07197e+18,165.337,2785.47,14525,588,76,13092,13009,9317,8717,5427
4250,354,678,4250,0,3964,286,1.37063e+18,82.9294,1221.21,4250,115,111,3572,3566,3310,3442,1565
49530,1519,1692,0,49530,12497,37033,7.47522e+15,219.58,4310.15,49530,381,157,47838,47838,47530,47575,44438
37842,268,1585,0,37842,0,37842,1.23377e+18,465.654,4640.66,37842,354,262,35209,34247,32869,29674,13578
49731,422,1289,11371,38360,0,49731,2.53028e+13,244.445,4590.26,49731,405,151,48442,48251,41543,44306,16534
42085,643,1212,0,42085,0,42085,1.82615e+18,341.944,4501.83,42085,399,215,40873,40867,38040,37392,18358
45143,258,1221,39727,5416,39727,5416,1.71824e+18,409.432,4740.64,45143,346,226,42594,40986,39486,38970,14241
9893,31,734,0,9893,0,9893,1.40884e+18,237.548,1743.24,9893,335,98,7728,7147,6304,1345,1458
18171,411,439,18171,0,18171,0,5.27278e+18,261.926,1844.33,18171,171,130,17732,17731,17695,17674,17444
22896,825,851,5754,17142,0,22896,2.40598e+13,198.675,2626.46,22896,282,117,22045,22045,22045,22045,21907
36352,254,897,27383,8969,0,36352,8.30964e+18,341.562,2886.11,36352,217,174,34970,33763,29419,29058,16975
48519,1206,1347,10495,38024,0,48519,1.84312e+13,413.258,4682.69,48519,352,224,47172,47170,47071,47056,45587
8729,454,472,0,8729,0,8729,1.93352e+18,195.006,1245.67,8729,93,107,8257,8257,8254,8254,8177
1703,60,122,0,1703,220,1483,1.39357e+16,11.7046,282.962,1703,64,12,1581,1581,1464,1467,1062
44777,851,1383,40414,4363,40414,4363,2.48069e+18,640.093,4973.63,44777,517,192,43340,42688,42124,42074,29466
3913,105,358,3913,0,3508,405,1.74974e+18,128.036,792.409,3913,76,84,3432,3253,2793,3231,1372
16132,691,1019,15034,1098,15034,1098,2.0745e+18,393.578,2616.19,16132,240,145,15113,14710,14677,14573,12884
43285,832,2057,43285,0,38902,4383,7.73735e+17,532.393,5549.69,43285,429,175,41228,40626,38070,32791,25849
35512,925,1288,35512,0,33100,2412,1.00707e+18,637.196,4067.12,35512,370,227,34224,33271,32043,32481,28047
6156,93,425,5749,407,0,6156,2.41568e+18,165.219,1098.63,6156,146,78,5278,4613,4686,4530,2116
41435,30,65,0,41435,41140,295,2.56111e+16,51.3284,901.386,41435,39,42,41251,41174,39445,39609,31052
34201,748,2223,30527,3674,30527,3674,3.34067e+18,248.489,4863.36,34201,446,262,31978,31939,28003,22116,6894
30246,931,2017,0,30246,3909,26337,1.30097e+14,11.8633,3802.27,30246,983,18,28229,28229,26343,26927,18947
11303,18,60,0,11303,11225,78,2.57809e+16,24.9683,459.648,11303,32,29,11156,11010,10605,10581,8850
10953,242,369,10953,0,10953,0,5.09349e+18,166.101,1347.22,10953,135,99,10584,10457,10087,9703,8934
14792,424,572,13029,1763,0,14792,3.82008e+18,312.035,2106.49,14792,207,140,14220,13957,14020,14021,10364
13945,230,584,10528,3417,10528,3417,3.77338e+18,273.33,1682.25,13945,132,134,13195,12834,12671,12445,5379
12797,238,583,3171,9626,0,12797,3.28919e+13,183.936,1358.39,12797,73,155,12157,11943,11083,11703,6536
21161,1109,1548,19033,2128,0,21161,3.48682e+18,289.425,3428.54,21161,359,216,19613,19597,19613,19613,17475
22199,1151,1888,0,22199,0,22199,3.12657e+18,301.224,4023.11,22199,335,202,20311,20292,20018,15515,10414
40568,320,2031,0,40568,8149,32419,6.59177e+15,371.509,5185.88,40568,596,199,38167,37501,34640,27268,7964
32983,157,582,32983,0,32983,0,3.14117e+18,291.868,2460.92,32983,181,140,31714,30865,24322,23376,11407
9019,602,633,1518,7501,0,9019,2.0882e+13,102.471,1585.69,9019,214,68,8386,8386,8374,8382,8215
24990,1934,1958,24990,0,21819,3171,1.02172e+18,419.228,4257.27,24990,445,231,23032,23032,23022,23029,22867
32186,235,1642,6615,25571,0,32186,2.56182e+13,267.324,4066.11,32186,475,179,30106,29211,28016,25061,10174
31383,415,494,31383,0,31383,0,4.92266e+18,256.557,2575.53,31383,181,153,30889,30859,29861,29641,27985
26622,727,1903,0,26622,0,26622,1.71568e+18,253.875,4391.52,26622,470,136,24719,24572,22903,15991,11334
46432,2577,2854,46432,0,42150,4282,1.36975e+18,314.574,6697.37,46432,498,315,43578,43578,43423,43426,41742
31484,51,1303,29391,2093,29391,2093,6.32213e+17,627.871,3939.17,31484,373,201,24259,19657,17476,17669,6101
21477,4,11,21424,53,20639,838,8.26722e+13,6.7157,300.18,21477,9,8,20901,20575,18189,18202,17402
18596,1194,1570,17462,1134,17462,1134,1.06532e+18,215.931,3278.67,18596,391,103,17026,17019,16736,16778,14842
2121,293,406,2121,0,1833,288,1.10719e+18,58.3428,671.644,2121,84,62,1715,1715,1595,1713,1548
37989,2138,2158,0,37989,0,37989,2.72492e+18,426.72,5216.66,37989,532,226,35831,35831,35831,35831,35675
30761,1161,1351,0,30761,5176,25585,5.0628e+15,204.439,3745.29,30761,451,102,29410,29410,29218,29396,27369
13330,703,1023,12390,940,12390,940,7.65991e+17,454.229,2524.6,13330,215,172,12307,11841,11944,11973,9249
36152,9,13,35719,433,35704,448,8.37607e+13,6.77329,382.128,36152,8,9,36139,36138,32587,32585,32015
8483,16,21,0,8483,8462,21,3.06816e+16,17.0223,264.47,8483,19,15,8448,8405,8325,8378,6299
34478,6,55,0,34478,34272,206,2.56041e+16,18.2518,645.364,34478,23,24,34173,34073,29155,32033,22373
25171,547,1564,25171,0,22793,2378,7.5027e+17,369.766,3967.24,25171,433,145,23607,23220,20723,18165,9812
7836,15,1066,7836,0,6932,904,1.12953e+18,85.64,1810.05,7836,371,63,5713,4577,4168,2484,1259
42387,61,70,0,42387,41807,580,2.51463e+16,44.825,939.95,42387,43,41,42317,42307,42104,41908,40194
36064,236,1676,32211,3853,32211,3853,3.30695e+18,254.223,4090.05,36064,396,162,34136,31970,29419,24559,7176
30099,33,799,6621,23478,0,30099,1.83763e+13,421.744,2962.78,30099,304,169,24886,21701,20769,14518,5782
13481,436,498,10172,3309,13481,0,3.88201e+18,208.034,1664.58,13481,250,81,12983,12980,12883,12892,12207
29784,29,1006,26674,3110,26674,3110,8.87214e+17,297.178,2957.14,29784,170,172,23172,17835,15406,16481,1646
49684,76,87,0,49684,49054,630,2.21812e+16,25.793,1120.36,49684,35,38,49597,49597,47936,48396,47226
35825,611,618,33081,2744,35825,0,3.81869e+18,323.387,3044.08,35825,278,154,35207,35207,35203,35205,35137
3947,65,532,3947,0,3392,555,1.89521e+18,39.7454,903.58,3947,157,59,3399,3328,2863,1812,666
47115,24,94,0,47115,46811,304,2.49354e+16,50.1119,1169.51,47115,49,44,46836,46717,43583,42543,27000
47735,23,31,46975,760,47731,4,1.05102e+14,8.46574,502.626,47735,17,17,47704,47699,46734,46733,42047
28558,926,1129,26658,1900,26658,1900,2.05768e+18,571.735,3519.83,28558,315,209,27429,27404,27068,27081,25631
12025,178,387,0,12025,2735,9290,7.27009e+15,175.223,1500.88,12025,175,90,11551,11371,10347,10847,6599
9196,195,329,0,9196,2207,6989,7.5551e+15,104.245,1218.06,9196,155,88,8867,8808,8154,8396,6226
15105,1,7,15068,37,15105,0,8.31849e+13,6.96293,240.209,15105,7,7,8672,8672,8672,8672,8672
19214,453,646,19214,0,14460,4754,8.10182e+17,317.381,2076.06,19214,175,141,18568,18457,17905,16478,14899
8926,8,57,0,8926,8862,64,2.54374e+16,22.515,399.598,8926,25,26,8443,8145,7787,7320,5075
34093,169,2363,34093,0,31707,2386,3.86225e+18,541.629,5088.08,34093,801,173,30846,29018,22185,21590,10057
32157,1246,1395,30051,2106,30051,2106,6.53793e+17,516.041,4073.2,32157,314,230,30762,30732,30554,30630,29147
31944,1076,1606,29838,2106,0,31944,2.42502e+18,540.204,4382.14,31944,415,198,30338,30278,30160,30152,27554
10049,36,41,0,10049,9895,154,1.75107e+16,15.5491,367.813,10049,20,20,10008,10004,10004,10005,9950
46913,141,5607,0,46913,0,46913,2.18291e+17,55.1046,7522.77,46913,1351,22,41306,41264,20332,21520,7216
35633,448,461,35633,0,35633,0,5.07936e+18,298.258,2533.43,35633,187,163,35172,35172,35133,35128,35042
7749,9,12,7657,92,7749,0,1.00836e+14,6.77868,169.822,7749,9,9,7737,7734,7640,7640,7497
39898,292,2350,39898,0,36380,3518,1.01025e+18,345.197,5928.14,39898,763,150,36905,36217,32505,29376,8020
48799,1,12,48199,600,48799,0,9.78609e+13,11.7037,428.144,48799,12,12,27277,27277,27277,27277,27277
48986,834,1333,45744,3242,0,48986,2.4108e+18,694.272,4740.9,48986,437,238,47588,45788,45971,45645,35554
2136,261,300,0,2136,0,2136,1.79655e+18,72.0389,559.363,2136,83,50,1836,1836,1824,1836,1774
30224,606,736,26560,3664,26560,3664,3.25166e+18,327.756,3220.09,30224,272,190,29488,29487,29336,29213,26145
28208,399,519,28208,0,28208,0,3.41297e+18,279.63,2362.64,28208,167,151,27689,27640,26409,25792,23394
35109,563,1600,35109,0,31466,3643,7.57534e+17,431.283,4682.73,35109,434,168,33509,33105,29628,27016,17018
12402,468,541,9348,3054,9348,3054,6.97857e+18,214.798,1468.84,12402,126,103,11861,11846,11804,11793,11062
45878,7,15,45170,708,43134,2744,8.09615e+13,9.4973,427.882,45878,10,11,45857,45850,43062,43068,39268
39186,1047,1583,0,39186,9872,29314,7.65652e+15,212.716,3614.81,39186,357,152,37603,37603,34832,35053,24013
21263,2,13,21104,159,21263,0,9.96012e+13,11.5459,287.578,21263,11,10,19288,18717,14679,18568,11821
12547,668,826,10929,1618,10929,1618,1.90877e+18,275.208,2122.49,12547,200,146,11721,11720,11536,11656,10567
3669,330,338,0,3669,0,3669,4.16059e+18,62.0602,726.753,3669,65,71,3331,3331,3331,3330,3310
9982,2,12,9936,46,9314,668,8.19162e+13,6.60258,208.696,9982,10,8,8504,8036,7501,8114,6549
9718,295,1057,9144,574,0,9718,2.21982e+18,234.046,2213.66,9718,232,148,8638,8401,8162,8141,3286
16888,193,1531,0,16888,0,16888,3.9631e+17,308.986,2993.44,16888,280,114,14743,13005,10936,6252,2782
22642,463,898,5060,17582,0,22642,1.9207e+13,371.227,2716.57,22642,297,165,21645,21240,20734,19120,11805
39035,515,1129,39035,0,34346,4689,1.16535e+18,419.016,4329.91,39035,310,201,37906,36734,35001,28200,18358
9870,1033,1298,8834,1036,0,9870,3.33834e+18,127.813,2464.82,9870,243,185,8572,8572,8572,8572,6734
39587,290,1659,35658,3929,35658,3929,1.35629e+18,722.176,5124.62,39587,546,193,35759,31484,29141,30890,12039
6185,53,452,5111,1074,6185,0,3.82038e+18,156.465,1172.89,6185,119,93,5308,4924,3474,3217,1492
35556,10,13,35294,262,33459,2097,9.14344e+13,8.6526,445.898,35556,11,10,35543,35542,35502,35504,31603
1953,197,236,0,1953,312,1641,3.98575e+15,43.6943,460.271,1953,100,34,1717,1717,1717,1717,1641
5287,282,363,5287,0,4963,324,5.18137e+17,91.2043,927.396,5287,173,54,4924,4924,4924,4924,4704
24879,130,1334,24879,0,22260,2619,7.74424e+17,331.029,3493.56,24879,270,157,21198,19435,16935,9372,3623
36861,285,642,0,36861,8416,28445,7.336e+15,228.901,3000.72,36861,253,131,36219,35598,34801,35566,20682
15146,840,1215,13781,1365,13781,1365,2.80096e+18,172.455,2742.18,15146,229,144,13931,13905,13836,13839,10044
36742,606,1446,0,36742,0,36742,2.10302e+18,318.297,3576.77,36742,183,271,35296,35135,33163,16918,22737
3836,123,312,0,3836,0,3836,1.33677e+18,112.268,785.527,3836,88,68,3492,3244,3181,3187,1919
6220,182,323,6219,1,6220,0,4.19058e+18,160.8,1047.19,6220,131,80,5855,5637,5113,5091,4297
31435,953,1243,31435,0,29276,2159,1.07064e+18,521.457,3789.47,31435,316,210,30192,30148,28718,29285,26532
20933,70,324,20933,0,20933,0,4.83393e+18,226.324,1729.53,20933,166,133,19037,16859,11987,11257,7760
4592,226,272,0,4592,1253,3339,6.1515e+15,179.621,848.025,4592,184,72,4295,4062,4241,4257,3859
13961,461,616,13961,0,12508,1453,1.76561e+18,254.176,1745.43,13961,116,138,13345,13331,12839,13148,11858
3603,175,248,3603,0,3603,0,4.62005e+18,91.3533,716.57,3603,89,77,3355,3335,3228,3204,2934
947,175,225,947,0,880,67,9.85225e+17,20.397,362.881,947,57,41,722,721,682,722,614
7972,334,428,0,7972,0,7972,1.92392e+18,192.538,1162.27,7972,92,104,7544,7533,7443,7432,6488
14322,8,11,14234,88,14322,0,1.08762e+14,7.53575,234.011,14322,10,10,14309,14306,14262,14261,13421
27258,11,13,27049,209,27258,0,9.91845e+13,10.6119,325.92,27258,12,10,27240,27230,26450,26449,27043
24923,290,658,18799,6124,0,24923,8.23727e+18,308.815,2177.63,24923,175,140,24072,23249,23039,22931,13880
3457,25,38,0,3457,3418,39,2.86605e+16,13.8638,199.835,3457,16,15,3419,3412,3402,3402,2876
19764,335,1040,18438,1326,18438,1326,2.06678e+18,440.81,2881.7,19764,283,166,18323,17910,17334,17140,12633
29053,645,1228,25509,3544,25509,3544,1.59628e+18,371.676,4047.32,29053,379,183,27825,27773,27100,27105,19140
4693,257,326,0,4693,0,4693,1.2656e+18,150.338,879.077,4693,101,74,4367,4365,4318,4328,3954
40654,208,1292,9725,30929,0,40654,3.36286e+13,257.89,4327.66,40654,304,172,38906,38099,34299,23929,14518
13071,372,823,12101,970,12101,970,2.33566e+18,307.383,2065.59,13071,360,107,12230,11727,11801,11813,7896
859,188,210,740,119,0,859,5.12191e+18,34.1979,333.676,859,49,30,649,649,649,649,628
6955,612,640,0,6955,0,6955,9.78671e+17,138.157,1409.77,6955,149,122,6315,6315,6313,6313,6204
7485,1,7,7483,2,7485,0,8.04379e+13,6.90114,168.598,7485,7,7,4146,4146,4146,4146,4146
24331,648,991,5482,18849,0,24331,2.3791e+13,265.03,3072.98,24331,299,156,23340,23307,22965,21577,19288
10468,1043,1093,10468,0,9748,720,3.61791e+18,121.994,2047.75,10468,293,119,9375,9366,9191,9289,9253
3120,138,284,838,2282,0,3120,5.15608e+13,35.8654,671.146,3120,85,67,2836,2836,2312,1286,1028
28540,1138,2108,0,28540,0,28540,1.63768e+18,261.85,4647.52,28540,589,218,26432,26431,26033,26020,19157
1124,12,122,274,850,0,1124,3.30536e+13,27.323,254.705,1124,35,30,845,649,671,729,191
37964,3,64,0,37964,37654,310,2.4836e+16,54.7458,879.115,37964,41,41,32059,30039,23584,20065,16000
14250,1035,1238,13322,928,0,14250,2.44789e+18,166.213,2625.2,14250,418,96,13012,13005,12849,12855,11835
20823,343,634,18265,2558,0,20823,3.9366e+18,294.501,2568.22,20823,232,155,20084,19686,18389,18390,11240
43518,996,2067,0,43518,0,43518,1.60735e+18,457.754,5586.58,43518,427,203,41451,41378,39869,24403,24324
2130,81,206,1816,314,1816,314,1.93861e+18,141.285,562.044,2130,88,66,1651,1338,1260,1443,859
30670,1477,2187,30670,0,23869,6801,9.60216e+17,260.196,4623.57,30670,267,277,28483,28483,27786,26856,24231
13083,362,837,11710,1373,11710,1373,3.30268e+18,381.183,1978.62,13083,254,103,11878,11521,11014,10168,8456
13694,679,924,12871,823,0,13694,2.16375e+18,308.746,2280.6,13694,207,150,12770,12539,12572,12604,11609
23665,635,651,0,23665,0,23665,1.89143e+18,304.473,2752.08,23665,251,162,23014,23014,23010,23009,22698
28175,1542,1602,25989,2186,0,28175,2.88423e+18,245.646,4208.92,28175,459,128,26573,26573,26573,26573,26281
8725,44,59,0,8725,8658,67,2.51232e+16,25.5683,413.481,8725,29,29,8666,8653,8479,8568,7770
37305,314,621,10360,26945,0,37305,6.31742e+13,255.976,2293.5,37305,169,123,36677,36415,35422,35590,23310
32091,750,1503,29046,3045,29044,3047,1.21217e+18,310.794,4123.44,32091,508,150,30588,30545,30320,30496,17482
10869,303,728,9461,1408,9461,1408,3.53712e+18,272.503,1815.41,10869,191,115,9902,9433,9074,8541,6186
21981,621,763,5095,16886,0,21981,2.31011e+13,201.463,2425.84,21981,307,102,21218,21216,21149,21175,18410
35828,387,1242,33404,2424,0,35828,2.44556e+18,638.317,4024.45,35828,342,212,33570,32548,31653,31603,18515
31159,300,1303,0,31159,7911,23248,7.59874e+15,192.494,3130.97,31159,208,149,29856,29619,26785,26250,15191
28358,90,1149,26605,1753,0,28358,2.26201e+18,623.318,3503.09,28358,338,206,24224,21056,20703,20054,3580
1962,165,192,1962,0,1962,0,5.1169e+18,68.7936,468.204,1962,64,52,1770,1769,1770,1770,1712
27000,11,12,26605,395,27000,0,9.7328e+13,9.70496,318.058,27000,11,10,26987,26981,26189,26189,25675
4339,314,366,0,4339,0,4339,1.67721e+18,92.5013,868.256,4339,147,70,3973,3973,3973,3973,3787
4487,164,378,3386,1101,0,4487,8.27025e+18,66.2429,820.059,4487,77,79,4109,4097,4021,4038,2657
46412,7,12,45797,615,46412,0,9.8588e+13,11.3974,416.288,46412,12,12,46365,46351,44491,44496,42793
43180,766,1245,9460,33720,0,43180,1.79398e+13,443.24,4195.66,43180,372,193,41935,41866,41551,41678,38013
15885,1114,1231,13891,1994,0,15885,4.56679e+18,185.863,2346.12,15885,265,194,14654,14654,14553,14562,13580
5453,27,31,0,5453,5187,266,2.47374e+16,16.7249,236.719,5453,19,20,5422,5416,5339,5394,5040
18125,9,10,18017,108,18125,0,1.02216e+14,8.65782,263.638,18125,10,10,18113,18110,18050,18050,18112
9568,137,321,9568,0,9568,0,3.88542e+18,161.036,1161.26,9568,104,106,9044,8608,7544,7006,5042
49274,729,1350,0,49274,0,49274,1.19576e+18,694.154,4827.53,49274,422,244,47683,45616,45844,39266,37937
33498,55,654,33434,64,33498,0,3.63928e+18,350.287,3053.03,33498,250,152,28433,23623,20111,15488,6467
47234,673,955,35539,11695,35539,11695,7.05606e+18,374.807,3452.39,47234,271,207,46279,46259,45700,45523,40040
36648,722,784,27611,9037,27611,9037,7.02417e+18,363.178,2788.54,36648,218,173,35864,35863,35793,35776,35188
10759,40,537,10759,0,8107,2652,9.17975e+17,264.43,1485.14,10759,140,116,8512,4316,6004,6456,1196
45713,6,11,45392,321,36486,9227,7.45298e+13,8.17748,487.058,45713,10,9,45597,45484,42284,42191,38635
40586,237,1057,0,40586,9701,30885,6.0474e+15,260.242,3872.7,40586,382,164,39274,37255,35725,33272,17519
26283,240,711,6510,19773,0,26283,2.63269e+13,209.566,2748.78,26283,319,138,25495,24534,22962,23811,16559
48365,406,731,0,48365,11017,37348,7.31817e+15,239.734,3559.99,48365,281,139,47634,47629,47052,47393,32031
27559,461,723,0,27559,0,27559,4.12031e+18,314.596,2350.48,27559,176,158,26836,26720,26393,26339,19855
45331,46,60,0,45331,45024,307,2.6384e+16,37.5729,794.368,45331,35,37,45271,45266,44767,45096,42224
18896,630,936,17115,1781,17115,1781,2.30185e+18,312.982,2869.94,18896,366,147,17960,17916,17733,17610,15583
37184,257,811,0,37184,8274,28910,4.73034e+15,436.513,3240.02,37184,305,180,35542,34802,33851,31492,20344
40680,2372,2598,37237,3443,37237,3443,2.54784e+18,452.259,6259.57,40680,580,232,38082,38080,38082,38082,37023
2189,51,236,2189,0,2043,146,1.08922e+18,116.183,560.361,2189,78,59,1645,1291,1189,1251,807
8273,7,10,8227,46,8273,0,1.04316e+14,7.77469,178.832,8273,9,9,8245,8211,7967,7967,8232
40629,530,587,38837,1792,40629,0,4.03674e+18,284.948,3139.46,40629,262,147,40042,40038,39509,39383,37391
13083,656,1051,12165,918,12165,918,7.72667e+17,484.13,2529.84,13083,236,170,12023,11420,11569,11638,8435
16075,254,1040,0,16075,0,16075,1.17512e+18,439.421,2633.72,16075,278,181,14580,14291,13573,12607,3363
47802,1679,1931,11278,36524,0,47802,2.72266e+13,198.681,4896.13,47802,398,174,45871,45871,45871,45871,43183
47446,817,2594,42031,5415,42029,5417,1.06135e+18,375.94,5588.23,47446,350,304,44852,44701,44262,44116,7928
42983,486,626,41030,1953,0,42983,1.7215e+18,478.608,3458.36,42983,278,196,42244,41830,40389,40618,39544
47613,55,65,0,47613,47450,163,2.66192e+16,32.9119,776.461,47613,26,30,47548,47547,47536,47543,47402
46061,561,773,45997,64,46061,0,3.19019e+18,416.611,3876.46,46061,257,171,45262,45113,43569,41923,38334
7118,6,8,6901,217,6688,430,8.78276e+13,5.09947,150.096,7118,8,6,7109,7107,6993,6994,6666
11136,232,478,11048,88,11136,0,3.03689e+18,222.98,1537.55,11136,150,84,10580,10289,9171,8452,6858
34238,100,2191,34238,0,30799,3439,1.58835e+18,243.822,4889.95,34238,368,236,29816,27863,22904,22663,3884
24643,384,648,0,24643,0,24643,4.10444e+18,300.999,2139.81,24643,174,145,23990,23251,23516,23473,17265
21327,172,1688,0,21327,0,21327,1.2509e+18,278.574,3650.35,21327,520,136,19357,18979,17855,14634,4091
17539,382,1570,12898,4641,12898,4641,2.204e+18,22.9582,2136.95,17539,531,526,15969,15969,14783,13691,14394
7268,42,43,0,7268,7202,66,2.45381e+16,24.1749,288.438,7268,21,20,7225,7215,7225,7225,7194
18127,232,449,0,18127,4125,14002,7.26008e+15,201.456,1914.28,18127,198,100,17614,17371,16786,17201,10362
18834,4,9,18670,164,16451,2383,7.56669e+13,6.44722,302.277,18834,7,8,18738,18684,17364,17371,15508
32564,1985,2192,29430,3134,29430,3134,2.99857e+18,260.686,5019.07,32564,470,200,30372,30372,30102,30041,28066
15555,215,462,0,15555,0,15555,1.57374e+18,352.795,2006.45,15555,265,128,13892,12241,12895,13037,6994
30057,817,1209,27055,3002,0,30057,2.95605e+18,378.052,3889.31,30057,407,161,28848,28692,27790,28098,18284
32138,387,996,32138,0,28330,3808,1.15913e+18,418.523,3791.07,32138,306,190,30760,29629,28344,20931,14365
19547,51,628,19547,0,14710,4837,8.11775e+17,285.374,1991.2,19547,165,142,17170,13027,12484,13036,2563
47055,824,1481,42467,4588,42467,4588,2.51711e+18,623.946,5216.84,47055,530,193,45488,44823,43528,43195,24817
2807,7,8,2800,7,2807,0,1.20933e+14,4.41967,98.6294,2807,7,6,2799,2798,2799,2798,2798
33170,8,44,0,33170,32931,239,2.57035e+16,37.9848,630.503,33170,31,33,32535,32170,30637,30149,19282
10238,186,565,0,10238,0,10238,1.47841e+18,299.875,1805.8,10238,226,126,8961,8047,8241,8053,5598
16744,9,13,16640,104,16744,0,1.01233e+14,11.9003,257.132,16744,11,10,16724,16720,16039,16036,15782
1680,10,12,0,1680,1678,2,1.37253e+16,9.74702,101.542,1680,11,10,1668,1668,1658,1662,1659
43279,167,1371,40455,2824,40455,2824,6.37041e+17,709.741,4622.4,43279,421,246,38980,36520,33149,34652,15573
20553,10,13,20046,507,20105,448,8.34032e+13,6.27874,273.945,20553,9,9,20540,20540,20219,20217,19942
7991,301,353,0,7991,2092,5899,7.44784e+15,125.475,980.911,7991,75,95,7638,7637,7593,7622,6997
44928,305,648,44928,0,44928,0,4.41896e+18,268.99,3376.52,44928,235,186,44263,43798,40864,40217,33292
4760,80,147,4760,0,4760,0,2.82336e+18,48.6903,519.035,4760,88,22,4613,4613,4409,4579,4150
1013,2,4,0,1013,983,30,3.22232e+16,3.90424,61.0248,1013,4,4,768,630,738,705,580
23080,7,12,22878,202,21504,1576,7.87108e+13,6.80251,308.76,23080,10,8,23067,23063,22289,22288,20790
14568,464,1366,14568,0,12951,1617,1.59016e+18,137.079,2635.05,14568,400,125,13202,13001,11717,12797,5599
47657,2456,3667,10617,37040,0,47657,6.40089e+12,285.615,6515.85,47657,429,125,43990,43990,41681,38017,32885
14859,148,693,0,14859,3322,11537,4.94878e+15,224.029,1971.25,14859,198,124,13929,13707,12909,12130,6815
2025,63,149,2025,0,2025,0,3.27401e+18,61.442,420,2025,57,59,1853,1771,1415,1382,895
4433,19,23,0,4433,4424,9,1.61898e+16,11.0636,195.316,4433,15,15,4410,4410,4395,4401,4013
25967,672,700,19545,6422,19545,6422,7.05885e+18,319.941,2294.31,25967,199,147,25267,25267,25248,25232,25109
7385,328,531,6520,865,6520,865,2.93153e+18,281.484,1464.32,7385,225,111,6781,6239,6445,6388,3836
39409,694,2007,0,39409,8747,30662,7.65002e+15,217.97,4648.05,39409,455,262,37402,37382,33259,33682,12653
34388,440,1673,8007,26381,0,34388,2.61353e+13,252.706,4208.01,34388,486,153,32526,32253,29567,20138,8620
8618,284,326,8617,1,8618,0,4.38923e+18,174.33,1234.32,8618,142,94,8292,8286,8099,8043,7702
10245,205,506,0,10245,0,10245,4.07295e+18,200.434,1326.68,10245,114,114,9635,9449,9220,6524,4332
15318,407,678,3237,12081,0,15318,1.83939e+13,250.902,2001.04,15318,170,136,14640,14408,14206,14162,10455
41731,100,490,41731,0,41731,0,4.94742e+18,271.64,2919.08,41731,194,160,39377,37115,25983,24478,14166
18632,337,415,18632,0,18632,0,4.99952e+18,255.068,1821.4,18632,155,125,18214,18080,17891,17547,17332
3572,295,356,3572,0,3572,0,4.00267e+18,127.445,878.53,3572,111,72,3216,3182,3187,3152,2758
27191,294,571,25216,1975,27191,0,3.86233e+18,302.654,2487.38,27191,273,124,26476,26125,22124,21621,17116
3010,1,23,0,3010,2970,40,1.49383e+16,10.9169,160.748,3010,15,13,1436,1436,1436,1436,1436
18743,84,600,18679,64,18743,0,3.13476e+18,267.058,2227.16,18743,222,121,16532,15277,12513,9892,4714
34533,326,778,26008,8525,0,34533,8.31297e+18,354.437,2703.59,34533,219,155,33569,32126,30154,30200,20651
49479,200,7582,49479,0,49479,0,4.3692e+18,250.006,10957,49479,1586,19,41790,41605,19472,1938,8072
26325,1394,1677,23951,2374,23951,2374,1.38502e+18,418.375,4137.44,26325,432,151,24648,24648,24548,24647,21178
12974,298,559,3339,9635,0,12974,2.9396e+13,140.684,1476.78,12974,108,107,12415,12393,12077,12071,9654
12622,533,824,2849,9773,0,12622,2.39962e+13,111.007,1839.95,12622,277,70,11798,11798,11410,11724,7010
9316,1,11,8929,387,9316,0,9.52357e+13,9.27125,214.118,9316,11,11,3709,3709,3709,3709,3709
22040,214,733,0,22040,5582,16458,7.16059e+15,436.129,2341.65,22040,444,89,20436,19623,18738,19906,11280
22525,397,474,0,22525,5098,17427,7.26955e+15,214.056,2166.98,22525,204,118,22051,22051,21956,22009,20059
14514,386,878,13267,1247,13265,1249,1.47178e+18,282.913,2184.14,14514,487,94,13538,13262,13054,13433,11107
20600,389,1444,18441,2159,18439,2161,1.19026e+18,190.046,3094,20600,375,140,19156,19011,18422,18250,5527
24531,102,513,24531,0,24531,0,3.52805e+18,286.274,2504.24,24531,197,146,22035,18587,17061,12973,6946
7398,1,7,7384,14,3057,4341,4.9538e+13,6.69803,175.242,7398,7,7,3490,3490,3490,3490,3490
21883,163,1282,19595,2288,19595,2288,1.59672e+18,437.364,3256.36,21883,374,148,19136,18188,15987,17919,8019
13875,348,701,13875,0,12196,1679,1.15867e+18,301.847,2239.73,13875,205,139,13041,12676,12189,10643,8280
5798,380,491,5118,680,5118,680,9.24507e+17,95.4552,1000.5,5798,79,103,5307,5283,5300,5277,4312
47159,1051,1297,10263,36896,0,47159,1.82465e+13,430.119,4487.09,47159,395,207,45862,45859,45783,45784,43757
15803,274,457,15355,448,15803,0,4.28711e+18,195.769,1790.26,15803,191,93,15346,15222,12504,12284,10392
24173,451,798,0,24173,0,24173,1.92292e+18,264.542,2363.2,24173,134,150,23375,23302,21989,16022,14895
45486,96,1089,10080,35406,0,45486,2.28377e+13,419.361,4118.65,45486,456,151,41244,38342,37276,24038,7397
34835,371,1559,0,34835,0,34835,1.62148e+18,404.308,4530.68,34835,344,205,32764,31753,30033,25775,16782
1204,67,154,317,887,0,1204,2.9221e+13,24.9992,306.066,1204,42,45,1050,1039,1018,1025,695
20468,306,1102,0,20468,0,20468,1.13018e+18,483.546,2961.58,20468,322,181,18872,18576,17742,16815,4226
24502,13,1065,0,24502,0,24502,1.18125e+18,487.41,3193.7,24502,274,188,14864,12074,9828,7448,2976
21060,64,89,0,21060,20584,476,1.95507e+16,22.6443,738.817,21060,34,33,20971,20970,20932,20956,14890
42523,392,1816,38179,4344,0,42523,3.73474e+18,268.718,4598.01,42523,511,171,40707,40245,34996,34149,10321
20226,221,729,0,20226,5105,15121,7.23272e+15,451.478,2202.7,20226,440,83,18682,18001,17280,18364,10947
2669,206,305,2538,131,0,2669,1.88038e+18,159.142,684.909,2669,135,65,2334,2188,2248,2269,1955
8722,140,512,8722,0,6555,2167,8.95855e+17,186.572,1307.3,8722,125,110,8054,7860,6987,6639,3497
22601,39,51,0,22601,22303,298,2.53466e+16,42.1854,610.186,22601,34,34,22530,22474,21787,22108,19452
29253,386,429,29253,0,29253,0,5.22691e+18,271.741,2230.38,29253,196,145,28824,28731,28601,28154,27847
9997,137,628,0,9997,2504,7493,7.06426e+15,235.382,1378.27,9997,301,69,9111,8894,8198,8566,4731
21622,10,13,21464,158,21622,0,1.00994e+14,9.63445,289.052,21622,11,10,21603,21597,20892,20890,20857
49126,753,1057,0,49126,11691,37435,7.39096e+15,243.809,4042.11,49126,294,145,48069,48069,47794,46665,41081
38746,1,13,38414,332,38746,0,1.00673e+14,10.3983,385.381,38746,12,11,21407,21407,21407,21407,21407
22338,24,1317,0,22338,0,22338,1.20282e+18,438.375,3442.93,22338,310,171,15261,12939,11160,10478,3095
45211,306,1880,45211,0,40890,4321,7.72806e+17,722.77,5634.98,45211,576,178,41261,36455,32890,12318,6371
36281,41,63,0,36281,36112,169,2.73426e+16,29.9508,712.488,36281,29,31,36215,36163,35857,36103,32919
9929,63,844,9042,887,9042,887,2.44308e+18,247.205,2072.81,9929,361,121,7994,7581,6662,5700,1406
47772,1053,1319,44639,3133,0,47772,2.36117e+18,707.174,4758.61,47772,417,239,46453,46367,45793,45674,43509
14268,140,630,10782,3486,0,14268,8.19792e+18,211.19,1678.23,14268,143,125,13351,13015,10730,10681,4430
10056,349,687,9343,713,9343,713,2.20405e+18,193.572,1666.5,10056,162,117,9369,9184,9011,8919,7117
21771,194,638,0,21771,0,21771,1.8941e+18,284.229,2615.45,21771,234,166,20624,20015,17431,11122,9612
44604,1919,2055,40090,4514,40090,4514,1.46189e+18,538.469,5617.38,44604,442,177,42549,42521,42539,42541,42203
17960,932,1417,0,17960,0,17960,1.2521e+18,363.311,3225.29,17960,353,157,16543,16398,16359,14190,13655
30810,707,844,7251,23559,0,30810,2.22826e+13,242.48,3111.7,30810,378,130,29966,29943,29863,29843,24378
28778,456,1578,25844,2934,25844,2934,1.38773e+18,394.789,4256.64,28778,434,163,27166,25005,23883,24534,13518
28899,4,10,28803,96,28835,64,1.06175e+14,7.83719,317.838,28899,9,10,28814,28786,27230,27184,24709
2451,34,234,633,1818,0,2451,2.99715e+13,64.5704,498.954,2451,49,56,2148,2081,1937,1753,563
2681,198,251,0,2681,715,1966,4.83812e+15,86.6266,597.43,2681,115,48,2430,2374,2425,2428,2295
13007,109,563,2087,10920,0,13007,2.06469e+13,181.176,1652.94,13007,248,83,12177,11609,11450,8989,3700
20229,219,1296,4303,15926,0,20229,2.54348e+13,139.378,3041.93,20229,340,140,18933,18701,17650,15653,7156
39624,221,999,0,39624,8798,30826,4.9365e+15,446.743,3618.64,39624,317,202,37603,36833,35127,31684,7057
30857,1172,1242,30857,0,27139,3718,9.76932e+17,365.563,4174.19,30857,389,174,29615,29615,29612,29596,28630
38804,9,56,0,38804,38227,577,2.19772e+16,19.8205,868.301,38804,28,26,38610,38491,37605,37326,23654
13938,131,279,13936,2,13938,0,2.49013e+18,134.419,1176.01,13938,114,62,13583,13438,13177,13220,9073
22437,988,1008,19893,2544,19893,2544,9.12375e+17,279.416,2544.54,22437,128,216,21429,21429,21423,21429,21304
26026,1096,1118,23320,2706,0,26026,3.85956e+18,565.764,3166.91,26026,468,133,24908,24908,24908,24907,24667
10584,411,666,0,10584,2705,7879,7.94633e+15,140.771,1587.47,10584,170,79,9918,9917,9450,9129,7440
19259,147,494,0,19259,5351,13908,1.61843e+16,199.673,1584.72,19259,127,105,18550,18093,16954,16799,8465
20514,27,757,4437,16077,0,20514,1.7749e+13,369.935,2447.75,20514,271,154,16585,14152,13252,8999,2968
2367,186,282,0,2367,353,2014,4.64323e+15,47.9455,575.888,2367,111,36,2085,2080,2046,2082,1575
44539,393,919,0,44539,9841,34698,4.72418e+15,472.588,3671.04,44539,312,195,43088,42102,41537,40438,29078
37187,285,1094,37187,0,32739,4448,1.1613e+18,405.099,4179.06,37187,324,190,35119,33871,32244,25163,10277
46389,1198,1924,41785,4604,41782,4607,1.07754e+18,305.293,5177.19,46389,505,186,44465,44465,44020,44363,26887
48730,1260,1433,48730,0,45428,3302,9.29502e+17,751.208,4994.73,48730,380,262,47297,47292,46896,46971,46395
24473,232,406,24473,0,24473,0,5.03592e+18,247.803,2032.63,24473,182,139,23936,23548,21462,20502,17664
7857,399,762,7857,0,7063,794,6.52767e+17,292.546,1836.39,7857,216,114,7033,6444,6462,5018,5903
47824,1727,1735,10449,37375,0,47824,2.65385e+13,316.464,5003.41,47824,408,202,46089,46089,46089,46089,46067
15858,24,696,11939,3919,11939,3919,7.04499e+18,208.986,1802.95,15858,142,130,10795,6345,7115,6429,1851
16439,178,721,3572,12867,0,16439,1.82531e+13,335.002,2201.29,16439,251,150,15310,15026,14285,12347,7326
2316,17,296,2072,244,2072,244,9.01041e+17,115.272,598.061,2316,68,64,1423,581,867,1006,201
45957,444,2525,41447,4510,41447,4510,2.97549e+18,278.168,6019.8,45957,481,240,43432,42864,40006,36641,18892
46243,820,1701,0,46243,10295,35948,6.78142e+15,267.295,4806.34,46243,382,197,44542,44373,44078,44284,32269
11618,747,1422,10555,1063,10555,1063,2.52239e+18,122.748,2732.74,11618,351,141,10196,10194,10061,9803,5721
13499,650,941,12669,830,0,13499,2.24953e+18,261.924,2259.49,13499,213,130,12558,12385,12352,12344,11571
36656,647,1040,36656,0,32278,4378,1.1526e+18,410.129,4097.68,36656,305,199,35616,35606,34289,32504,24794
48693,242,502,48693,0,48693,0,5.02619e+18,310.138,2995.03,48693,210,174,47757,46809,41056,38981,31443
23136,35,40,0,23136,22953,183,1.98832e+16,23.4597,557.556,23136,25,22,23096,23089,23065,23080,22638
15413,570,1006,0,15413,1990,13423,1.11415e+14,11.8833,1986.74,15413,505,12,14407,14407,13971,14189,10519
30150,10,13,29902,248,30150,0,9.40772e+13,9.36866,338.513,30150,12,10,30130,30121,29464,29462,28726
26909,993,1820,24609,2300,24609,2300,2.50262e+18,370.561,4424.55,26909,511,178,25089,25056,24435,24115,13865
9168,4,431,7334,1834,9168,0,3.31943e+18,215.274,1351.37,9168,212,90,4567,3102,1963,1616,783
16638,1,15,15960,678,16638,0,9.47223e+13,10.4549,295.517,16638,11,12,6712,6712,6712,6712,6712
4319,265,364,0,4319,0,4319,4.08749e+18,61.4063,799.723,4319,71,76,3955,3953,3946,3946,3488
44630,42,89,0,44630,44024,606,2.05598e+16,24.7141,1078.99,44630,32,41,44541,44536,41832,42209,36562
48858,2347,2831,0,48858,0,48858,1.73075e+18,462.568,6951.9,48858,640,291,46027,45933,45146,44147,39974
24328,715,767,6325,18003,0,24328,2.93859e+13,192.849,2146.7,24328,110,139,23561,23561,23496,23536,22943
34139,328,1471,30489,3650,0,34139,3.14333e+18,396.79,4479.91,34139,410,180,32056,29188,28421,28455,9898
48955,40,76,0,48955,48683,272,2.27426e+16,27.2168,942.397,48955,33,36,48879,48871,43532,45749,36327
22255,2,28,0,22255,22240,15,1.69501e+16,12.9622,581.914,22255,18,18,14397,13089,11124,11126,7985
12472,244,530,10969,1503,10969,1503,3.22884e+18,264.481,1872.85,12472,205,133,11806,11506,9748,9257,4932
24980,47,59,0,24980,24836,144,2.63394e+16,30.4507,591.315,24980,31,30,24921,24919,24912,24911,24249
36541,242,556,36541,0,36541,0,3.20569e+18,307.1,2553.94,36541,201,144,35686,34741,31031,30238,19908
43088,971,1193,37923,5165,37923,5165,1.72071e+18,417.421,4603.5,43088,346,203,41895,41895,41613,41526,37908
27527,120,1857,23191,4336,23188,4339,2.26929e+18,254.335,4755.48,27527,375,194,24740,23091,20052,20705,4507
41459,45,101,0,41459,40688,771,1.99841e+16,33.433,1048.67,41459,45,36,41358,41340,40994,40684,30404
8056,832,836,0,8056,0,8056,1.2686e+18,178.246,1793.88,8056,178,137,7220,7219,7220,7220,7214
6013,56,371,5208,805,6013,0,3.26497e+18,151.893,1047.19,6013,190,70,5112,4588,3953,2888,1530
45924,738,956,0,45924,0,45924,1.89228e+18,343.174,4281.01,45924,329,196,44968,44967,44645,44757,37464
23446,16,53,0,23446,23336,110,2.67074e+16,18.1877,538.05,23446,22,24,23354,23252,21866,22683,17482
12807,689,699,0,12807,0,12807,1.27756e+18,329.48,1927.24,12807,188,151,12108,12107,12108,12106,12053
49119,945,1060,11066,38053,0,49119,2.27502e+13,408.726,4252.36,49119,455,153,48059,48059,47980,48049,44342
48324,16,63,0,48324,47667,657,2.51003e+16,44.1307,990.525,48324,42,42,47379,46276,44636,42642,27618
4164,265,357,4164,0,4164,0,3.84996e+18,138.163,949.282,4164,107,68,3807,3746,3659,3501,3200
47505,358,372,47496,9,47505,0,3.25145e+18,315.66,2984.6,47505,208,179,47133,47036,46811,46681,46415
23762,286,1946,19016,4746,19016,4746,5.66932e+18,257.9,4097.97,23762,336,206,21540,20931,19050,17559,7632
12620,170,466,3285,9335,0,12620,2.92162e+13,154.196,1307.59,12620,89,112,12130,11619,10881,11509,6009
36401,51,622,36401,0,36401,0,3.24733e+18,297.659,2608.87,36401,215,138,32486,26909,19391,18333,3954
46755,528,1008,0,46755,0,46755,4.13668e+18,373.068,3373.1,46755,242,187,45747,45500,43944,32488,33854
29053,448,933,29053,0,25595,3458,1.14577e+18,413.079,3556.38,29053,267,183,27991,26991,25783,21098,14467
20210,467,614,0,20210,0,20210,4.15082e+18,270.813,1923.55,20210,158,128,19596,19543,19465,19420,16557
4400,117,508,4400,0,4106,294,1.11553e+18,124.697,1069.15,4400,148,67,3747,3344,3096,3460,1984
47154,798,1391,44015,3139,44015,3139,6.99339e+17,706.099,4850.79,47154,377,262,45640,43582,44463,44319,33394
43657,4651,6838,2773,40884,0,43657,4.89425e+11,111.003,9815.37,43657,1401,18,36819,36712,33725,34637,28797
4072,328,459,3844,228,3844,228,1.78923e+18,98.014,894.141,4072,166,62,3613,3613,3613,3613,3146
16562,164,824,0,16562,3485,13077,5.51249e+15,215.764,2330.28,16562,356,104,15418,14537,14553,14265,6191
35838,568,2359,0,35838,0,35838,1.357e+18,542.001,5243.06,35838,745,198,33209,32510,31787,31169,8591
25244,1298,1417,5796,19448,0,25244,3.47305e+13,218.26,2743.19,25244,319,234,23827,23827,23684,23795,22062
49894,98,1914,45345,4549,45345,4549,2.72878e+18,632.821,5962.99,49894,441,279,43791,39184,36675,35437,8816
47521,54,1123,13095,34426,0,47521,6.29836e+13,274.204,3258.57,47521,246,144,44686,43539,36758,16850,10849
1545,27,229,0,1545,0,1545,9.55108e+17,37.49,437.873,1545,53,41,1225,1075,915,907,224
5112,49,53,0,5112,5026,86,2.39629e+16,21.0628,326.918,5112,27,23,5059,5059,5055,4925,4519
19260,527,560,5398,13862,0,19260,6.34356e+13,163.231,1804.95,19260,117,108,18700,18700,18700,18698,18302
11860,594,626,8939,2921,8939,2921,6.92123e+18,158.377,1731.39,11860,135,135,11234,11234,11233,11231,11026
29137,6,14,28707,430,28689,448,8.47412e+13,6.66102,342.06,29137,9,9,29056,28922,26543,26544,23608
10436,408,667,2305,8131,0,10436,1.79364e+13,148.598,1691.91,10436,184,100,9769,9692,9557,9371,7884
8931,760,892,7335,1596,0,8931,5.9956e+18,119.499,1926.24,8931,189,105,8039,8038,8008,8025,7488
4903,1,7,4805,98,4532,371,6.62499e+13,5.17969,119.426,4903,6,6,3281,3281,3281,3281,3281
1492,7,11,1447,45,1492,0,9.20649e+13,6.07641,86.0009,1492,9,8,1480,1476,1424,1379,1250
34432,843,1357,31133,3299,0,34432,2.98287e+18,453.673,4233,34432,407,179,33075,32797,32479,32619,26701
9929,7,625,2148,7781,0,9929,1.86818e+13,187.402,1654.16,9929,162,114,6289,5202,4410,1920,1487
39476,724,1910,36813,2663,0,39476,2.45512e+18,503.264,5344.39,39476,360,241,37496,36487,36010,35493,20883
33990,1007,1316,33990,0,29937,4053,9.9779e+17,394.875,4472.09,33990,392,194,32674,32674,32082,31905,26606
24892,331,718,18796,6096,18796,6096,6.9618e+18,314.652,2278.83,24892,184,168,24068,23246,23054,22204,13779
37723,608,3349,27740,9983,27740,9983,5.49143e+18,21.9855,4160.11,37723,1125,1120,34374,34374,15217,8840,30730
32062,1011,1184,29980,2082,0,32062,2.36204e+18,547.125,3654.99,32062,366,187,30878,30682,30685,30635,29048
11191,7,10,11113,78,11191,0,1.00809e+14,8.59494,206.815,11191,10,9,11157,11113,10760,10761,9803
47554,1876,2506,47554,0,43007,4547,1.30986e+18,318.696,6444.05,47554,683,166,45048,45048,44592,44588,29468
35692,262,1470,8898,26794,0,35692,3.10223e+13,202.775,3278.72,35692,341,153,34190,33836,28682,13292,3768
23658,290,1144,22158,1500,0,23658,2.29032e+18,459.088,3228.47,23658,338,184,21868,21377,20281,20217,10776
1996,123,243,1889,107,0,1996,1.9611e+18,102.622,534.809,1996,75,53,1740,1605,1623,1621,1143
43740,298,2299,0,43740,0,43740,1.75568e+18,267.594,5685.28,43740,479,255,41255,40288,37306,17875,13268
47843,497,2682,42875,4968,42872,4971,1.22488e+18,324.965,6344.65,47843,592,286,45161,43891,42493,39057,9452
38482,123,1348,38482,0,35909,2573,9.68755e+17,677.924,4375.22,38482,422,238,33579,30346,25162,26302,12743
3434,74,444,3434,0,3051,383,1.0027e+18,144.322,858.312,3434,114,65,2813,2514,2312,1595,999
43264,1580,1912,35344,7920,0,43264,6.21989e+18,298.488,5428.82,43264,318,203,41352,41351,40916,40929,32221
19450,104,1000,18153,1297,0,19450,2.41704e+18,331.036,2697.37,19450,235,151,17091,14965,15039,14448,5949
41649,1227,1558,0,41649,10241,31408,7.40625e+15,247.243,4088.98,41649,248,244,40091,40085,39926,39999,34936
12808,1,12,12357,451,11248,1560,7.88958e+13,6.89179,226.514,12808,9,8,7869,7869,7869,7869,7869
38588,247,1309,9385,29203,0,38588,3.70049e+13,258.505,4272.61,38588,299,184,36995,36227,32067,21179,13426
9743,743,911,0,9743,0,9743,1.1985e+18,168.426,1980.55,9743,196,109,8832,8827,8803,8811,8415
5784,77,292,0,5784,1637,4147,1.58473e+16,78.4241,768.756,5784,60,87,5452,5326,5167,4840,2288
6715,259,280,1809,4906,0,6715,2.23218e+13,192.796,1008.9,6715,202,73,6435,6415,6427,6431,6370
42647,1876,2467,42647,0,42647,0,9.25716e+17,222.063,5008.62,42647,1383,21,40180,40041,40029,40079,33736
38257,312,824,28875,9382,0,38257,8.24466e+18,370.081,2888.18,38257,228,175,37133,35547,32710,32744,17901
17170,8,444,4788,12382,0,17170,6.27225e+13,176.51,1422.26,17170,98,107,11517,9589,10099,4444,1698
32714,417,1432,8105,24609,0,32714,2.99581e+13,229.886,3514.42,32714,211,209,31282,30869,28749,26611,16377
31589,1360,1591,31589,0,28342,3247,7.54931e+17,414.767,4464.37,31589,431,166,29998,29974,29926,29934,26675
13965,623,1142,12947,1018,12947,1018,7.41239e+17,487.97,2688.59,13965,242,170,12790,12168,12175,12191,8263
10015,596,609,1177,8838,0,10015,4.96589e+13,19.9828,1120.4,10015,310,304,9406,9406,9328,9379,9364
13852,9,13,13752,100,13852,0,9.92439e+13,7.28537,229.828,13852,9,9,13837,13836,13551,13551,13413
39804,280,2497,39804,0,35860,3944,1.41062e+18,299.844,5842.57,39804,649,184,36795,35703,31512,31378,7406
47689,721,1667,0,47689,0,47689,1.69434e+18,551.799,5282.91,47689,631,194,45951,44326,43256,37809,31788
42915,332,685,35734,7181,42915,0,4.01807e+18,378.417,3455.57,42915,279,165,41998,41014,34692,30587,24212
35988,7,14,35385,603,35982,6,1.072e+14,9.7931,348.497,35988,13,12,35951,35938,35389,35383,27457
4348,207,560,4058,290,4058,290,6.15968e+17,129.675,1115.87,4348,137,79,3788,3634,3560,3622,2859
40261,144,648,0,40261,11188,29073,1.62121e+16,259.368,2395.63,40261,184,136,39005,38070,33831,34310,17184
30532,207,1316,5085,25447,0,30532,2.06621e+13,225.33,3709.97,30532,494,99,29030,28525,27366,20720,8619
40006,26,44,0,40006,39740,266,2.59387e+16,36.9605,681.09,40006,33,34,39877,39763,39126,39633,32154
24910,4,47,0,24910,24818,92,2.62312e+16,19.5719,531.152,24910,21,24,24378,24006,19862,19338,14335
15653,35,735,14624,1029,0,15653,2.40847e+18,344.721,2144.71,15653,212,151,11212,8731,8563,8359,2927
24955,410,448,24955,0,24955,0,5.1081e+18,278.674,2121.06,24955,182,135,24507,24495,24338,24228,24065
2940,171,276,2776,164,2776,164,1.73615e+18,113.176,663.554,2940,88,60,2664,2591,2605,2575,2116
3086,121,323,3086,0,2881,205,1.13711e+18,134.408,743.538,3086,97,63,2670,2399,2199,2435,1421
11693,901,1221,10903,790,10903,790,2.1166e+18,163.298,2632.22,11693,208,173,10472,10424,10395,10415,7555
13597,35,400,0,13597,3133,10464,7.4632e+15,170.451,1595.56,13597,177,99,11660,10428,9796,8422,2119
11163,855,1252,0,11163,0,11163,2.09193e+18,115.335,2179.24,11163,327,103,9911,9910,9294,9362,5384
27714,201,724,20854,6860,20854,6860,3.82824e+18,342.174,2517.47,27714,198,157,26227,25355,25215,24412,9841
13309,162,559,13309,0,12695,614,5.30048e+17,290.529,1913.6,13309,211,134,11661,10327,9407,8655,4423
20375,183,580,14735,5640,20375,0,4.06397e+18,277.406,2179.95,20375,284,113,19433,19038,15784,13988,9793
12454,826,913,11532,922,11532,922,2.33255e+18,304.697,2126.86,12454,328,98,11541,11504,11489,11492,11352
25505,40,45,0,25505,25315,190,2.55401e+16,36.702,556.942,25505,29,30,25453,25382,25357,25390,24825
15610,773,864,0,15610,3312,12298,4.4272e+15,192.299,2311.6,15610,239,125,14746,14733,14724,14731,14237
20489,15,43,0,20489,20460,29,2.08377e+16,27.3455,508.003,20489,30,31,20277,20174,17099,17682,15690
6037,445,480,5313,724,5313,724,3.25037e+18,147.552,1282.13,6037,162,104,5557,5555,5539,5534,5333
44742,8,405,11590,33152,0,44742,1.26608e+13,306.291,2746.56,44742,247,149,31119,27184,24653,11365,5388
49668,689,2294,44869,4799,44865,4803,1.18289e+18,325.489,5981.42,49668,594,209,47343,47023,46158,45974,9527
16908,780,1108,16908,0,16908,0,1.48262e+18,16.8722,2255.66,16908,556,17,15800,15800,15800,15800,11952
10983,797,947,10983,0,10272,711,9.56035e+17,215.413,2123.91,10983,225,158,10036,9964,9716,9900,8773
31503,25,1253,0,31503,0,31503,1.91447e+18,321.9,3832.33,31503,270,166,23102,17899,17874,2584,2575
6749,233,556,0,6749,1489,5260,4.68738e+15,110.113,1329.28,6749,155,113,6193,6110,5967,5996,3199
30253,809,1192,27122,3131,0,30253,2.99131e+18,380.848,3890.87,30253,404,175,29061,28916,28284,28282,21506
40781,681,2479,40781,0,36910,3871,1.30615e+18,328.757,5986.37,40781,689,146,38302,37880,34904,36584,14709
6975,1249,1339,996,5979,0,6975,7.01996e+12,9.95613,1549.87,6975,177,18,5636,5636,5548,5296,5362
23370,941,1475,0,23370,0,23370,2.01899e+18,209.876,3052.84,23370,343,142,21895,21895,19672,14231,9027
28498,63,1431,28498,0,22219,6279,7.719e+17,290.153,3917.48,28498,309,202,24935,21913,18803,18215,1084
14424,27,44,0,14424,14334,90,2.62972e+16,28.3595,411.16,14424,25,26,14364,14332,14163,14282,12683
48675,748,1439,45413,3262,45413,3262,2.05733e+18,744.978,4972.56,48675,421,251,47024,44830,44884,43988,31585
11355,193,540,10149,1206,10149,1206,3.30648e+18,208.958,1491.23,11355,99,116,10680,9847,9502,8981,4079
22208,117,193,0,22208,21526,682,2.59834e+16,21.2763,965.047,22208,74,35,22015,22012,21641,21145,15325
44782,7,12,44594,188,44782,0,8.2214e+13,6.64792,422.404,44782,8,9,44770,44768,38505,38505,36853
40500,1325,1448,0,40500,0,40500,1.25667e+18,644.769,4510.02,40500,412,219,39052,39052,39052,39048,38722
16949,241,1198,0,16949,3920,13029,7.81377e+15,130.239,2382.96,16949,316,134,15751,15450,13992,14613,7625
15370,436,1180,15370,0,14334,1036,8.58227e+17,306.934,2731.35,15370,357,129,14151,13637,12852,11505,6726
31611,32,68,0,31611,31143,468,2.46826e+16,42.7232,815.915,31611,37,40,31490,31412,30599,30320,22531
27419,525,656,27413,6,27419,0,4.76683e+18,260.297,2723.99,27419,197,128,26763,26732,24547,24205,22211
49951,22,94,0,49951,49555,396,2.01844e+16,32.2491,1124.29,49951,44,33,49696,49385,45537,46878,35491
26642,395,1268,26642,0,24830,1812,9.58599e+17,606.468,3672.46,26642,335,205,24579,23665,21242,18987,15371
13825,1,64,0,13825,13681,144,2.47889e+16,26.7738,555.596,13825,28,31,5013,5013,5013,5013,5013
1418,272,376,1313,105,1313,105,8.69786e+17,47.335,585.708,1418,93,49,1042,1032,1041,1042,938
37211,500,714,37147,64,37211,0,3.23521e+18,364.259,3419.8,37211,249,165,36476,36347,35027,33571,32495
9246,551,833,8633,613,0,9246,2.37425e+18,184.875,1854.53,9246,155,128,8413,8265,8271,8271,7377
9480,382,446,2468,7012,0,9480,2.94817e+13,140.77,1155.82,9480,79,101,9034,9031,8964,9011,8351
5749,249,612,5360,389,5360,389,6.67815e+17,140.69,1283.8,5749,108,118,5137,4993,4820,4763,3670
44402,1944,1963,38477,5925,38474,5928,1.81219e+18,380.146,5904.83,44402,430,226,42439,42439,42439,42438,42373
45826,1100,1288,42816,3010,0,45826,2.38999e+18,715.207,4604.67,45826,402,253,44538,44522,44087,44072,42842
46515,860,871,35016,11499,0,46515,8.3318e+18,384.747,3196.42,46515,257,180,45644,45644,45644,45641,45620
28979,195,831,7502,21477,0,28979,2.95743e+13,210.994,2384.27,28979,117,144,28054,27590,24303,26149,10439
26263,20,337,26263,0,26263,0,4.81414e+18,236.022,1994.92,26263,187,139,18652,14770,11449,10186,4601
6574,517,548,0,6574,1010,5564,6.7468e+15,88.3375,1223.49,6574,167,61,6026,6026,6013,6026,5954
26063,72,903,0,26063,0,26063,1.25342e+18,445.438,2916.64,26063,265,179,21522,17468,17898,17571,6298
8906,229,790,8313,593,8313,593,6.39502e+17,144.354,1746.36,8906,221,90,8116,8050,7830,7828,5135
39541,44,46,0,39541,39263,278,2.5728e+16,37.2904,703.505,39541,33,34,39495,39495,39476,39494,39375
49035,601,2229,39388,9647,0,49035,6.65851e+18,376.718,5768.56,49035,417,245,46567,45419,43077,42995,27504
48836,965,1013,42946,5890,42946,5890,3.2436e+18,347.742,4462.34,48836,342,202,47823,47823,47790,47756,46506
42372,55,88,0,42372,41298,1074,2.47812e+16,36.5677,1132.97,42372,47,36,42284,42278,41564,41698,34952
42711,1927,2328,39019,3692,39019,3692,2.70046e+18,407.274,6090.37,42711,597,183,40383,40383,39888,39695,36551
20613,393,425,20613,0,20613,0,5.12105e+18,246.724,1914.98,20613,161,134,20188,20148,20115,20073,19733
7415,353,596,0,7415,128,7287,4.0721e+14,12.7184,1184.2,7415,339,30,6819,6819,6594,5188,4625
39852,280,947,0,39852,0,39852,4.12763e+18,343.024,3085.57,39852,220,174,38516,37150,32387,18521,18859
23486,363,840,5279,18207,0,23486,2.25977e+13,230.519,2766.72,23486,370,111,22646,22478,20636,21261,10234
28518,393,1969,25837,2681,25837,2681,2.91515e+18,255.415,4600.41,28518,478,135,26429,25888,23944,20650,8758
8545,310,355,8539,6,8545,0,3.25496e+18,206.404,1250.01,8545,115,94,8190,8189,7971,7984,7747
29871,644,1292,0,29871,5017,24854,5.23045e+15,223.869,3653.64,29871,481,99,28579,28365,28016,28153,17432
23165,41,48,0,23165,22772,393,1.93917e+16,21.6692,604.576,23165,27,24,23117,23116,23112,22996,22672
42708,6,17,42093,615,42708,0,9.86364e+13,10.8469,421.837,42708,13,12,42528,42440,40409,40299,31191
13212,64,676,0,13212,0,13212,4.10214e+18,171.157,1644,13212,129,114,12055,11432,8858,4657,2756
5273,866,982,4720,553,4720,553,2.48145e+18,57.5119,1687.94,5273,190,115,4291,4291,4291,4291,3658
16183,121,1053,15085,1098,15085,1098,6.94772e+17,466.134,2689.78,16183,213,176,14131,12687,11392,12342,3036
32842,805,871,24728,8114,0,32842,8.30774e+18,320.157,2932.76,32842,217,192,31971,31969,31930,31937,31273
27475,186,2253,26971,504,26769,706,8.69163e+17,354.044,4425.09,27475,341,133,23904,20563,18936,22694,3464
2355,19,449,0,2355,0,2355,1.3003e+18,97.1397,780.115,2355,104,67,1509,1328,1099,832,383
48107,56,646,48107,0,46042,2065,5.09175e+17,507.702,3746.86,48107,279,205,37570,34201,28529,4778,15798
11025,180,728,11025,0,11025,0,1.15528e+18,15.8572,1515.65,11025,364,16,10297,10297,7478,9072,3805
15215,1247,1933,13937,1278,13937,1278,1.19811e+18,239.563,3652.04,15215,437,196,13282,13279,12871,12898,8306
3102,33,48,0,3102,3055,47,2.41819e+16,23.0184,236.167,3102,25,23,3054,3041,3020,3032,2802
39948,43,705,36533,3415,39948,0,3.79868e+18,330.005,3331.41,39948,274,187,33884,29427,20401,16519,5687
26728,8,13,26657,71,26728,0,8.3933e+13,6.33912,329.707,26728,7,10,26715,26715,23948,23945,21405
33165,2061,2488,0,33165,0,33165,3.36901e+16,25.2854,4667.46,33165,395,25,30677,30677,30251,27183,26316
43244,1047,2326,38685,4559,38685,4559,1.00437e+18,284.814,5524.23,43244,365,254,40918,40912,40138,40551,34044
20575,9,28,19672,903,20571,4,9.52849e+13,10.25,368.614,20575,15,15,20536,20522,19718,19680,19964
25040,614,907,22424,2616,22424,2616,3.25241e+18,262.663,2503.73,25040,150,155,24133,24118,23797,23731,21074
8074,17,32,0,8074,7700,374,2.45162e+16,24.9952,291.997,8074,21,21,8019,7995,7366,7685,6673
16598,317,435,16200,398,16598,0,4.47664e+18,233.758,1729.36,16598,239,97,16163,16107,14535,14440,13138
49160,258,3787,0,49160,0,49160,4.16603e+17,363.184,7104.75,49160,448,164,43808,40310,31360,8796,6229
22588,18,36,0,22588,22425,163,2.04038e+16,14.5955,535.638,22588,20,21,22541,22534,22395,22493,19593
1881,72,158,0,1881,466,1415,8.38893e+15,36.841,349.335,1881,39,39,1723,1705,1607,1629,922
27798,505,934,24468,3330,24468,3330,1.72026e+18,402.517,3466.22,27798,281,179,26864,26083,25274,25207,15071
29981,288,1235,29981,0,26814,3167,1.77256e+18,292.932,3172.8,29981,151,169,28652,28169,23212,12649,4360
21597,67,412,21597,0,21597,0,5.24521e+18,270.253,1946.43,21597,186,127,19269,17080,11566,10006,5596
16244,352,1583,14786,1458,14786,1458,2.53346e+18,220.812,3290.73,16244,357,192,14586,14215,14037,13298,3536
23145,34,53,0,23145,22862,283,2.4947e+16,38.8284,622.247,23145,33,35,23061,23003,22262,22684,19223
40085,575,2614,40085,0,40085,0,1.02997e+18,16.779,5121.74,40085,1300,21,37471,37471,37471,34861,12680
1727,39,191,1727,0,1297,430,8.26429e+17,63.044,447.184,1727,62,60,1303,697,829,883,440
21240,639,1210,19204,2036,19204,2036,1.31612e+18,352.16,3351.33,21240,397,160,20030,19941,19689,19747,16111
5671,216,361,5316,355,5316,355,5.01588e+17,148.474,997.402,5671,121,83,5310,5238,5145,5142,4269
19712,79,89,0,19712,19261,451,2.07853e+16,23.4738,716.521,19712,33,30,19623,19623,19622,19623,17007
11093,529,645,0,11093,2824,8269,8.15166e+15,128.107,1396.77,11093,82,123,10448,10439,10389,10405,9346
4593,92,364,4593,0,4291,302,1.08412e+18,142.874,926.933,4593,110,78,3908,3294,3029,3342,1646
1540,145,247,1506,34,1506,34,3.96783e+17,31.5649,459.463,1540,82,33,1293,1250,1280,1285,826
44942,110,495,44942,0,44942,0,5.10035e+18,310.404,2881.06,44942,206,175,42538,40405,27544,25009,17101
41035,257,925,8957,32078,0,41035,1.81983e+13,459.993,3561.79,41035,307,200,39179,38170,37042,31896,19319
17716,303,594,0,17716,4613,13103,7.52211e+15,174.586,1674.39,17716,104,130,17122,17053,16190,16301,12391
43264,309,1627,37995,5269,37995,5269,1.75182e+18,386.189,5096.22,43264,350,215,40689,39154,37162,37531,12854
45960,366,963,0,45960,9987,35973,4.76476e+15,480.831,3809.69,45960,355,209,44385,43099,42403,38319,25875
9334,850,969,8621,713,8621,713,1.32796e+18,238.692,2035.52,9334,348,115,8365,8365,8353,8365,7662
14222,6,13,14116,106,14222,0,9.76317e+13,10.3855,235.134,14222,10,10,14175,14148,13434,13428,10739
45834,208,998,0,45834,9929,35905,4.751e+15,433.203,3851.92,45834,305,200,43769,42629,41102,36291,19285
38266,11,65,0,38266,37995,271,2.67396e+16,43.695,852.026,38266,36,40,37017,35748,34250,33617,22028
47953,667,2341,43608,4345,43608,4345,2.82576e+18,333.158,6237.82,47953,549,205,45563,45153,41201,36863,12837
10460,10,12,10311,149,10460,0,9.7763e+13,6.89082,195.533,10460,9,9,10448,10445,10119,10120,10443
27201,37,1181,27201,0,25446,1755,9.3678e+17,542.31,3516.04,27201,305,204,19471,15134,12417,10880,4495
37876,23,54,0,37876,37739,137,2.77455e+16,25.5437,665.762,37876,26,27,37812,37784,37150,37121,23668
11512,413,449,10207,1305,10207,1305,2.49237e+18,335.473,1731.03,11512,254,116,11058,10986,11028,11040,10893
38963,381,2535,35288,3675,35285,3678,1.38597e+18,365.022,6047.86,38963,639,208,35984,34757,32773,32632,9540
10685,214,591,10685,0,9911,774,6.21161e+17,110.64,1641.78,10685,228,93,10094,10059,9316,9846,6001
44178,7,68,0,44178,43871,307,2.56144e+16,50.975,934.722,44178,41,44,41397,39612,37758,33737,21311
13999,19,61,0,13999,13895,104,2.64059e+16,25.1445,510.267,13999,30,31,13850,13740,13094,12666,10951
43886,663,2462,0,43886,0,43886,1.45973e+18,482.367,6241.61,43886,831,148,41348,40482,39279,32216,18441
8241,116,408,8241,0,8241,0,5.17127e+18,156.357,1334.84,8241,134,102,7647,7055,6126,5004,3773
9992,432,439,9992,0,9614,378,4.17729e+17,283.609,1552.53,9992,180,102,9553,9553,9546,9551,9536
39215,1049,1644,35396,3819,35396,3819,2.71704e+18,443.889,4749.01,39215,594,182,37571,37527,37109,36896,29701
27536,1185,1356,24575,2961,24575,2961,1.53362e+18,423.327,3724.69,27536,354,167,26180,26168,26106,26135,25477
26351,1097,1281,24534,1817,24534,1817,6.97366e+17,632.522,3614.92,26351,325,201,25070,25061,24943,24975,24126
21946,443,803,19389,2557,0,21946,4.26071e+18,314.212,2142.25,21946,115,224,21140,20496,19736,19474,13651
43606,486,1075,0,43606,11906,31700,1.48759e+16,242.837,3566.16,43606,187,165,42531,42475,37769,37728,14963
35821,54,63,0,35821,35575,246,2.66357e+16,47.8778,823.51,35821,38,39,35746,35687,35270,35219,33754
43561,162,194,0,43561,41707,1854,2.47996e+16,27.0504,1158.95,43561,76,40,43367,43367,43356,43288,41516
896,27,74,896,0,722,174,3.04287e+18,15.3728,185.614,896,38,16,822,822,822,822,348
33087,335,578,33087,0,33087,0,3.23976e+18,305.504,2470.19,33087,202,142,32463,32213,29654,28472,22928
16300,9,649,16300,0,14606,1694,1.75903e+18,254.407,1909.1,16300,121,141,7003,3630,3392,615,635
37958,841,2506,0,37958,0,37958,1.34682e+18,494.851,5549.62,37958,739,211,35452,34528,34166,33788,15208
17410,340,979,16309,1101,16309,1101,1.96535e+18,328.043,2569.9,17410,243,140,16217,15999,15495,15455,11460
3243,171,494,3243,0,2933,310,1.10824e+18,97.2849,992.959,3243,139,60,2749,2618,2374,2207,1132
12713,81,449,11242,1471,11242,1471,2.6625e+18,341.534,1811.38,12713,253,116,10282,9564,8920,8064,3591
35121,312,614,35121,0,35121,0,3.49697e+18,309.551,3136.57,35121,221,186,34314,33637,31120,26963,21365
20701,15,62,0,20701,20584,117,2.64268e+16,37.4307,628.749,20701,34,32,20362,20032,19157,18843,15049
3607,14,27,0,3607,3597,10,2.79281e+16,12.3745,175.731,3607,18,15,3572,3518,3484,3508,2313
47222,1822,1852,41734,5488,0,47222,3.8297e+18,349.652,5493.24,47222,343,214,45370,45370,45370,45370,45298
8738,41,346,0,8738,2418,6320,1.6246e+16,115.26,975.55,8738,82,72,8188,7977,6880,6959,2445
27301,386,1138,25466,1835,0,27301,2.44575e+18,602.572,3502.98,27301,344,201,25418,24487,23910,23853,14000
29445,162,762,22200,7245,22200,7245,6.9954e+18,314.142,2485.97,29445,188,154,27935,27155,21431,16861,9154
47925,68,72,0,47925,47284,641,2.42884e+16,49.3388,1039.99,47925,40,41,47853,47853,47762,47762,47554
4051,134,347,3632,419,3632,419,3.21242e+18,127.786,771.296,4051,72,81,3632,3482,3362,3263,1935
38041,29,1274,35526,2515,35526,2515,2.03795e+18,627.809,4222.25,38041,365,208,26884,21319,19131,19937,5469
29491,671,1237,29491,0,27520,1971,1.00096e+18,641.618,3762.01,29491,363,218,27938,26839,25246,24229,18948
13297,19,1053,12349,948,0,13297,2.56929e+18,422.857,2471.37,13297,280,161,8608,6921,5872,5046,1242
15270,8,34,0,15270,14557,713,2.45054e+16,25.1511,402.832,15270,24,24,14705,14148,11245,13256,9282
21710,120,1952,19529,2181,19526,2184,1.5843e+18,197.559,4014.55,21710,530,137,19307,18173,16358,17680,3180
49710,6243,8599,49710,0,49710,0,4.04468e+18,16.8254,9756.68,49710,1253,27,41111,41111,41111,41111,31454
44393,443,2067,9802,34591,0,44393,2.96348e+13,246.3,4971.97,44393,458,281,42326,41797,36745,12685,12134
39173,1176,1234,0,39173,0,39173,1.19895e+18,649.304,4210.03,39173,361,230,37939,37939,37883,37880,37706
12603,6,7,12576,27,12603,0,8.2502e+13,6.93819,219.781,12603,7,7,12510,12344,11058,11057,12361
19411,4,7,19370,41,19411,0,8.30029e+13,6.96718,272.704,19411,7,7,18881,18609,16221,16227,16567
25585,1413,1793,23568,2017,23567,2018,1.36549e+18,427.599,4253.56,25585,488,137,23792,23792,23684,23677,21435
28020,125,480,28020,0,28020,0,4.29338e+18,229.029,2351.48,28020,156,172,26698,25527,18790,17729,10402
19227,1544,1689,18692,535,18692,535,3.17601e+18,336.983,3330.03,19227,313,128,17538,17538,17294,17202,17005
30025,2,13,29792,233,30025,0,9.71969e+13,11.5231,341.4,30025,12,11,27144,26267,21125,26161,18692
37155,1367,2048,0,37155,0,37155,1.74642e+18,300.578,5128.4,37155,439,223,35107,35079,35107,35107,28666
26488,2,12,26112,376,26488,0,8.60005e+13,6.13191,325.239,26488,8,9,22918,22204,21892,21771,17474
27936,160,415,27936,0,27936,0,4.03634e+18,238.668,2282.49,27936,239,173,27022,26164,21477,20716,14129
671,233,267,671,0,525,146,2.70029e+18,21.2906,367.223,671,57,67,404,404,386,388,377
29819,2943,3568,0,29819,4029,25790,8.69033e+15,11.0639,4846.66,29819,862,22,26251,26251,24852,24852,20670
11286,23,26,0,11286,11254,32,1.3127e+16,17.5701,343.512,11286,21,19,11260,11260,11260,11260,10985
28083,44,64,0,28083,27886,197,2.551e+16,47.7983,747.417,28083,37,37,27990,27925,26970,27075,24642
17491,945,1550,0,17491,0,17491,1.69593e+18,201.748,3412.47,17491,366,201,15941,15941,15793,15929,10551
16086,495,634,0,16086,3482,12604,4.85116e+15,261.686,1957.1,16086,173,139,15452,15446,15403,15414,14117
33755,1892,1897,0,33755,7464,26291,7.68476e+15,185.989,4216.63,33755,438,231,31858,31858,31856,31858,31819
21664,557,860,19392,2272,19392,2272,8.89225e+17,257.41,2433.02,21664,138,165,20804,20767,20619,20638,14978
16947,358,387,16947,0,16947,0,4.99941e+18,204.021,1724.01,16947,176,120,16560,16559,16522,16481,16365
9713,9,17,9522,191,9713,0,9.36901e+13,8.1708,211.025,9713,13,11,9694,9689,9390,9410,8768
10380,325,575,0,10380,0,10380,1.37556e+18,112.388,1580.51,10380,220,97,9805,9804,9689,9598,7375
43502,194,195,0,43502,41815,1687,2.53036e+16,26.2589,1207.96,43502,76,41,43307,43307,43307,43307,43306
36423,778,1086,36423,0,32138,4285,1.15603e+18,418.43,4127.67,36423,294,192,35337,35337,34509,33925,28725
36469,1058,1413,34044,2425,34044,2425,6.75482e+17,701.327,4383.7,36469,408,230,35056,34825,34682,34502,32182
40365,576,636,0,40365,11253,29112,1.60784e+16,262.798,2376.93,40365,165,147,39729,39729,39662,39672,38715
38631,11,34,0,38631,36758,1873,2.46536e+16,30.4314,642.611,38631,30,31,37999,36931,30898,33843,24195
9948,345,518,7489,2459,0,9948,8.34138e+18,198.949,1331.7,9948,119,101,9430,9169,9297,9303,7384
3155,125,259,2374,781,2374,781,7.03256e+18,56.1055,599.323,3155,70,61,2896,2892,2753,2636,1687
25683,62,441,25683,0,25683,0,5.07382e+18,278.831,2152.63,25683,185,140,22671,19774,13976,12116,7316
42209,144,866,0,42209,0,42209,4.13882e+18,379.713,3068.95,42209,247,171,39699,38674,28002,15657,11784
33461,306,1042,33461,0,29470,3991,1.16732e+18,412.755,3909.29,33461,293,190,31656,30462,29289,23467,12951
6789,115,438,1757,5032,0,6789,3.0119e+13,94.9309,1015.08,6789,73,90,6327,6108,5676,5985,2632
27367,545,546,27367,0,27367,0,3.49174e+18,304.654,2690.47,27367,183,169,26821,26821,26821,26821,26819
43266,1,12,42772,494,43266,0,9.8184e+13,10.5557,402.825,43266,12,12,24148,24148,24148,24148,24148
12891,548,727,2328,10563,0,12891,1.8476e+13,130.79,1976.39,12891,239,69,12164,12162,11980,12147,10025
48664,673,1367,11905,36759,0,48664,3.70444e+13,275.724,4753,48664,305,195,47297,47260,44218,33327,29839
31750,630,881,23929,7821,23929,7821,3.79959e+18,318.309,2818.42,31750,204,166,30869,30842,30690,30671,24748
48799,1070,1759,13301,35498,0,48799,5.9628e+13,242.456,4354.81,48799,339,164,47040,47040,46663,47033,42436
39759,871,906,0,39759,8775,30984,4.64336e+15,484.06,3504.41,39759,365,200,38853,38853,38822,38834,38617
35901,340,1031,8540,27361,0,35901,2.34828e+13,245.67,3631.11,35901,379,142,34870,34620,31332,31894,16136
29511,1046,1577,27512,1999,27512,1999,7.03151e+17,447.722,4308.06,29511,268,259,27934,27841,27318,27312,14967
31483,117,1147,0,31483,0,31483,1.1956e+18,563.092,3674.85,31483,334,212,27852,25230,23594,21388,8853
8888,167,490,8888,0,6678,2210,8.18372e+17,140.84,1247.31,8888,107,111,8369,8243,7516,6895,4416
33463,7,11,31875,1588,33463,0,9.60688e+13,10.6367,408.528,33463,11,11,33233,33011,30112,30207,30169
40307,224,445,40307,0,40307,0,3.9769e+18,264.169,2688.27,40307,267,171,39668,39195,32295,32490,23133
9229,3,10,9141,88,9229,0,9.46384e+13,8.93585,186.41,9229,10,10,8830,8666,7350,8359,7006
32555,1068,1110,0,32555,0,32555,1.83422e+18,322.874,3897.98,32555,386,195,31445,31445,31443,31437,30822
20172,1,13,20050,122,20172,0,1.08644e+14,7.23929,275.603,20172,9,9,10719,10719,10719,10719,10719
6502,45,62,0,6502,6452,50,2.51349e+16,24.5446,368.594,6502,30,29,6440,6426,6367,6414,6138
28400,625,842,6564,21836,0,28400,2.23696e+13,235.563,2997.95,28400,367,132,27558,27506,27387,27347,21735
32196,298,1853,29052,3144,0,32196,3.57346e+18,229.177,4313.39,32196,329,176,30318,29838,27156,27198,9263
5100,38,41,0,5100,5059,41,2.51495e+16,12.378,235.21,5100,20,16,5059,5059,5046,5034,4460
31289,544,1670,27894,3395,27894,3395,9.43349e+17,266.826,3970.24,31289,274,193,29619,29560,28929,29006,19022
19405,1478,1527,17806,1599,17806,1599,2.60609e+18,228.54,3204.37,19405,390,196,17878,17878,17878,17878,17735
17903,840,1325,0,17903,4505,13398,1.12436e+16,280.197,2964.96,17903,288,143,16578,16559,16065,15973,8251
24849,561,1381,0,24849,0,24849,4.11075e+18,271.408,3158.95,24849,283,145,23468,23426,22632,22143,20480
48977,141,766,48913,64,48977,0,3.4839e+18,396.404,3843.97,48977,270,170,45311,41943,34665,30075,16111
18328,9,10,18130,198,18237,91,9.4204e+13,7.54114,308.698,18328,9,8,18318,18318,18317,18318,17859
48547,762,2011,48547,0,43589,4958,1.52983e+18,291.857,5249.95,48547,530,181,46536,46466,40625,44065,13082
5308,31,388,4912,396,4912,396,2.32286e+18,133.797,997.793,5308,109,78,3766,2627,2637,2681,741
20748,549,832,4516,16232,0,20748,2.24932e+13,216.926,2590.16,20748,360,103,19916,19844,19203,19571,11904
16844,771,1785,16844,0,14199,2645,1.17085e+18,339.708,3640.81,16844,252,227,15059,15039,13750,12172,4565
12630,524,718,2133,10497,0,12630,2.39152e+13,219.282,1934.25,12630,236,71,11912,11800,11794,11859,10880
16499,943,1714,0,16499,0,16499,1.51553e+18,212.529,3499.74,16499,357,186,14785,14781,14655,13956,8231
38556,441,1186,8884,29672,0,38556,2.76467e+13,298.381,4038.38,38556,325,195,37331,36738,34978,29538,25013
12756,489,588,12756,0,9641,3115,8.20055e+17,270.091,1645.81,12756,137,121,12168,12147,12078,11759,11047
19553,12,48,0,19553,19478,75,2.51223e+16,18.8039,482.202,19553,23,24,19453,19397,18468,18785,14375
31076,168,604,22438,8638,31076,0,4.02357e+18,344.64,2800.75,31076,300,140,29595,28898,23001,19596,13214
27102,216,587,0,27102,7576,19526,1.60113e+16,216.277,1950.56,27102,137,118,26421,25862,25051,25018,13398
15913,18,952,2108,13805,0,15913,2.48526e+13,169.128,2269.84,15913,385,81,12876,12119,10529,4288,1735
21823,459,493,0,21823,6058,15765,1.62112e+16,207.341,1670.98,21823,128,114,21330,21326,21302,21308,20919
15997,394,744,15997,0,12048,3949,8.96821e+17,231.074,1959.79,15997,159,130,15253,14950,14482,13470,9255
15932,47,615,15932,0,14260,1672,1.76377e+18,270.653,1855.51,15932,120,143,13423,11992,9180,2501,1294
26531,2,44,0,26531,26345,186,2.57366e+16,36.9913,561.83,26531,30,32,21355,20103,18519,19379,12907
23174,1005,1472,0,23174,0,23174,2.03053e+18,225.914,3253.53,23174,339,208,21702,21702,20467,17269,13928
32181,91,524,32181,0,32181,0,3.25915e+18,297.169,2356.71,32181,195,135,30310,29352,21330,20216,6396
1575,57,207,349,1226,0,1575,1.82277e+13,55.8667,427.864,1575,66,36,1327,1206,1188,1233,696
35686,1224,1815,31856,3830,31856,3830,3.34086e+18,285.951,4281.31,35686,251,239,33871,33843,33732,33498,30978
7636,22,29,0,7636,7631,5,2.06662e+16,16.2228,273.724,7636,19,21,7607,7602,6837,7189,6997
15491,73,541,11664,3827,11664,3827,7.04097e+18,246.982,1656.98,15491,139,121,14340,13758,9557,7433,4047
16117,12,542,16053,64,16117,0,3.34505e+18,244.813,2008.31,16117,216,120,10482,8972,6436,4464,899
9709,414,485,9689,20,9709,0,3.47134e+18,190.041,1492.27,9709,150,104,9224,9221,9184,9184,8917
17911,622,1350,16390,1521,0,17911,3.10054e+18,314.782,3263.66,17911,274,170,16561,16197,15717,15643,8706
48718,1122,1467,42874,5844,42874,5844,3.27927e+18,334.679,5000.48,48718,317,200,47251,47251,46980,46799,42994
49485,433,2106,44979,4506,44976,4509,1.14924e+18,684.302,6383.92,49485,419,284,46431,44930,43408,42768,18607
34865,2739,3097,25637,9228,25637,9228,5.49102e+18,21.9811,3875.89,34865,1041,1035,31768,31768,29306,28488,31301
17866,783,1178,0,17866,0,17866,1.37944e+18,308.869,3003.99,17866,388,128,16688,16605,16139,15989,12091
38089,1490,2481,37849,240,0,38089,7.33061e+18,14.8845,4770.93,38089,1240,17,35608,35608,34619,34766,24286
26489,51,67,0,26489,26310,179,2.54837e+16,49.3073,735.82,26489,35,38,26405,26333,25829,25939,24116
26111,752,968,22918,3193,22918,3193,2.933e+18,320.178,3443.03,26111,350,169,25143,25143,24963,24822,21282
11255,261,703,2851,8404,0,11255,3.34972e+13,141.472,1488.79,11255,80,149,10552,10381,9350,9788,3753
29851,548,554,8296,21555,0,29851,6.30272e+13,232.64,2002.35,29851,149,130,29297,29297,29297,29297,29285
16968,84,322,16968,0,16968,0,4.96669e+18,222.046,1571.72,16968,156,117,15744,14241,9616,9095,5880
36228,26,76,0,36228,35826,402,2.34743e+16,23.5806,865.252,36228,29,35,36134,36044,33618,34135,27330
4630,275,574,4630,0,4130,500,5.59984e+18,106.359,1052.65,4630,275,54,4056,4056,2624,2740,2316
9866,227,969,0,9866,2183,7683,1.73053e+15,231.836,1824.72,9866,240,81,8702,8215,6737,3124,2546
4854,170,351,4543,311,4543,311,5.19857e+17,143.186,930.497,4854,114,76,4492,4280,4270,4201,2985
10531,501,954,9836,695,9836,695,2.02969e+18,196.674,2096.33,10531,225,147,9577,9427,9240,9325,5862
38969,1,13,38668,301,38969,0,9.94977e+13,11.8815,389.892,38969,13,12,21623,21623,21623,21623,21623
33385,1031,2504,0,33385,0,33385,3.36555e+16,25.1679,4696.63,33385,395,25,30881,30881,29377,22004,15706
42482,274,2611,39286,3196,39286,3196,2.37254e+18,681.613,6208.71,42482,750,222,38926,38307,35296,34384,6354
26090,1,12,25739,351,26090,0,9.57168e+13,10.645,314.688,26090,11,12,14635,14635,14635,14635,14635
2025,24,25,0,2025,2009,16,2.56205e+16,19.6123,152.163,2025,20,20,1999,1998,1988,1989,1965
6920,66,609,1129,5791,0,6920,1.48924e+13,59.923,1069.99,6920,213,61,6309,5660,5900,6061,1897
31792,7,10,31567,225,31792,0,1.00932e+14,9.51161,348.688,31792,10,10,31704,31579,30214,30215,28189
12302,673,1229,11472,830,11472,830,2.11528e+18,160.994,2675.3,12302,212,173,11073,10980,10901,10884,6443
33741,554,604,32272,1469,32272,1469,1.38245e+18,438.839,3033.72,33741,256,172,33137,32908,32891,32927,32654
5262,191,450,4620,642,4620,642,3.28517e+18,145.684,1171.46,5262,147,105,4795,4636,4656,4454,3705
26803,563,1221,24173,2630,0,26803,3.06579e+18,412.18,3635.25,26803,393,169,25582,25270,24565,24626,18012
31089,14,33,0,31089,29562,1527,2.46545e+16,29.3507,572.047,31089,29,29,30866,30636,26595,28675,21915
12280,118,994,12280,0,11455,825,8.52658e+17,433.11,2360.61,12280,213,153,10555,9246,7813,7766,2706
35079,1030,1269,35079,0,32704,2375,9.96146e+17,660.273,4065.53,35079,384,228,33810,33768,32631,33095,31864
1380,306,511,0,1380,0,1380,2.07233e+18,26.0319,692.582,1380,83,78,869,868,868,865,680
18780,699,905,17182,1598,17182,1598,2.65836e+18,332.087,2459.27,18780,347,126,17875,17736,17492,17368,15299
14832,272,714,0,14832,3759,11073,8.10303e+15,142.267,1658.89,14832,85,135,14118,13963,12969,13152,7532
4709,36,293,1126,3583,0,4709,1.96643e+13,97.8919,770.169,4709,99,59,3930,3444,3392,3130,1353
38147,586,2187,0,38147,0,38147,2.80502e+18,401.655,5252.64,38147,532,229,35680,34277,31956,28794,14080
29857,617,776,6472,23385,0,29857,1.91191e+13,404.338,2907.04,29857,272,181,29081,28908,28668,28575,26678
6101,1,5,6088,13,6101,0,3.63558e+13,4.98787,148.023,6101,5,5,2953,2953,2953,2953,2953
19786,620,1230,0,19786,4474,15312,7.07068e+15,164.231,2870.24,19786,262,166,18556,18526,18298,18391,13882
33535,4,13,33326,209,33535,0,1.03458e+14,11.3464,359.11,33535,12,11,33091,32908,30649,31271,25261
36546,1479,1592,6894,29652,0,36546,2.33068e+13,320.941,4366.77,36546,515,136,34954,34954,34896,34921,34320
30759,502,1892,30759,0,27966,2793,1.51264e+18,345.904,4640.51,30759,394,231,28797,28292,25456,26096,12903
9155,297,528,9155,0,6899,2256,8.14459e+17,157.096,1301.93,9155,118,115,8627,8465,8233,7771,6465
27132,632,1221,24124,3008,0,27132,4.02542e+18,254.262,2998.2,27132,280,154,25911,25905,22682,22095,8698
41589,228,2521,41589,0,35829,5760,9.66033e+17,486.275,6164.08,41589,459,302,37105,35411,31627,30479,5514
17649,722,754,17649,0,15546,2103,1.17382e+18,350.24,2582.48,17649,218,147,16895,16895,16891,16883,16704
24361,9,13,24193,168,24361,0,9.91594e+13,10.6123,305.675,24361,11,11,24338,24332,23313,23311,21324
41724,677,2543,38064,3660,0,41724,3.05389e+18,427.517,6354.2,41724,583,235,39078,38504,36933,36156,11605
19600,263,735,0,19600,4309,15291,4.94852e+15,292.383,2326.54,19600,241,144,18669,18275,17839,16933,11807
9840,29,522,7412,2428,7412,2428,3.80584e+18,195.713,1374.39,9840,128,114,6722,3555,3951,4006,1023
2507,379,455,2201,306,0,2507,4.14304e+18,50.4124,739.174,2507,81,74,2052,2052,2052,2052,1963
14576,384,1063,0,14576,0,14576,1.17951e+18,375.737,2521.3,14576,320,155,13423,13143,12685,12026,5845
44498,5,10,44466,32,44498,0,6.62419e+13,9.99339,588.32,44498,10,10,37016,32718,34679,34026,27915
23700,1238,1658,23700,0,22108,1592,9.19872e+17,372.244,4111.64,23700,347,223,22042,22001,21387,21320,18882
23647,378,887,6010,17637,0,23647,3.122e+13,205.23,2219.66,23647,108,194,22760,22484,20992,21734,12658
17977,343,458,17641,336,17977,0,4.31283e+18,246.394,1908.93,17977,235,92,17519,17472,16536,16485,14987
44555,834,2520,40378,4177,40378,4177,2.9236e+18,359.796,6247.92,44555,534,267,42035,41849,38355,33298,19033
49656,988,3227,0,49656,0,49656,1.65991e+18,14.8897,6196.58,49656,1613,17,46429,46429,30296,42777,17401
32059,1,12,31835,224,30609,1450,8.01169e+13,6.86422,364.317,32059,10,8,19079,19079,19079,19079,19079
17402,1103,1164,15990,1412,0,17402,3.02128e+18,306.384,2894.03,17402,422,112,16238,16238,16238,16238,15620
28508,916,1040,0,28508,6372,22136,5.21585e+15,361.051,3301.75,28508,287,175,27468,27459,27357,27428,26142
16945,151,614,0,16945,0,16945,1.9213e+18,245.402,1859.05,16945,119,135,15679,14379,13953,9202,5189
37456,3209,5965,37456,0,37456,0,4.36888e+18,12.2688,8531.53,37456,1204,19,31491,31491,27658,18572,20722
43295,3323,4382,37027,6268,37027,6268,5.70814e+18,14.6286,6473.6,43295,1302,26,38913,38913,37244,29586,26808
9112,20,303,9112,0,9112,0,4.81982e+18,146.949,1128.43,9112,126,97,6443,5018,3933,3661,1520
44375,3,11,44072,303,44375,0,1.02581e+14,9.30948,414.287,44375,10,10,42189,41212,35977,40117,28883
14603,30,48,0,14603,14542,61,2.3483e+16,18.0809,421.534,14603,21,22,14555,14547,14535,14544,13274
31237,122,727,23525,7712,23525,7712,7.0102e+18,326.072,2470.64,31237,188,151,29498,28825,21687,16440,8268
14621,639,1267,13416,1205,13415,1206,1.42444e+18,114.293,2749.8,14621,378,109,13354,13354,13150,13083,5804
23628,146,803,5360,18268,0,23628,2.29444e+13,209.99,2662.38,23628,309,124,21925,20279,19786,18218,5411
47420,550,852,0,47420,0,47420,4.14266e+18,391.422,3221.2,47420,262,176,46568,46457,45675,42913,39359
35382,71,841,31192,4190,31192,4190,3.20691e+18,345.089,3605.26,35382,301,198,29312,24794,24023,20884,4658
20642,528,735,0,20642,4497,16145,4.58353e+15,325.705,2410.49,20642,253,155,19907,19591,19494,19537,16685
13859,27,44,0,13859,13837,22,2.09586e+16,25.026,419.791,13859,28,28,13807,13762,12834,13205,12519
12921,440,563,0,12921,0,12921,1.95005e+18,215.966,1602.91,12921,107,124,12358,12354,12090,12076,10601
48155,122,930,10656,37499,0,48155,1.82781e+13,484.266,3831.28,48155,369,213,45033,43944,41141,34665,10780
43062,1469,1478,0,43062,0,43062,1.46613e+18,629.328,4959.65,43062,525,187,41584,41584,41584,41584,41559
12536,258,627,11220,1316,11220,1316,3.26805e+18,211.878,1632.7,12536,116,124,11896,11582,10987,10624,6859
13138,256,553,11564,1574,0,13138,3.82615e+18,289.878,1962.16,13138,197,134,12450,12024,10241,10638,5207
5989,541,835,5989,0,5517,472,9.47842e+17,98.0409,1485.92,5989,247,74,5154,5145,5021,5149,4270
30953,448,485,30953,0,30953,0,5.01547e+18,312.089,2419.56,30953,191,164,30468,30467,30433,30393,30304
1823,233,305,0,1823,0,1823,2.00854e+18,13.4685,477.681,1823,102,31,1518,1518,1464,1518,1288
29285,852,919,6284,23001,0,29285,1.80605e+13,340.613,3076.27,29285,254,179,28366,28342,28345,28319,27696
39295,1060,1544,35542,3753,0,39295,3.49792e+18,318.241,4432.85,39295,490,179,37751,37751,35647,35543,25237
29965,208,584,6813,23152,0,29965,2.8477e+13,224.253,2634.72,29965,235,123,29165,28682,27310,27864,12790
40820,62,83,0,40820,39250,1570,2.45089e+16,29.3416,1035.19,40820,41,34,40737,40734,39944,40417,31357
36946,79,928,8542,28404,0,36946,2.29016e+13,272.057,3486.79,36946,373,140,32999,30841,29877,24890,8673
26227,192,1661,23327,2900,0,26227,3.84769e+18,222.449,3701.19,26227,230,186,24250,22242,21154,21409,6654
30410,60,62,0,30410,30176,234,2.59559e+16,47.6081,765.058,30410,35,38,30348,30347,30345,30219,30296
1051,13,183,1007,44,0,1051,1.53153e+18,60.5195,342.42,1051,65,37,635,449,384,397,199
13603,337,411,0,13603,3125,10478,7.45987e+15,180.888,1605.43,13603,176,98,13192,13192,13130,13168,12356
16695,8,603,16680,15,16695,0,3.39193e+18,273.004,1988.96,16695,448,80,9724,6362,5512,5114,807
20985,322,729,0,20985,4574,16411,4.74038e+15,304.68,2388.29,20985,237,155,20059,19599,19283,18657,13006
11589,702,752,10796,793,10796,793,2.12613e+18,273.357,1857.38,11589,179,122,10837,10738,10830,10830,10764
44289,9,10,43954,335,44289,0,9.93352e+13,9.60243,410.617,44289,10,10,44270,44260,44097,44096,44252
19449,187,1538,16722,2727,16722,2727,4.04019e+18,146.871,3642.9,19449,252,135,17864,17490,14643,12909,4732
21858,630,759,16532,5326,0,21858,8.16079e+18,266.834,2151.77,21858,162,134,21099,21090,20963,20959,18351
26701,238,532,0,26701,7394,19307,1.62385e+16,219.965,1871.2,26701,144,117,26125,25519,24998,25124,15141
42386,446,1035,0,42386,0,42386,1.87786e+18,340.936,4194.24,42386,327,214,41351,40654,37456,37004,16853
599,1,7,589,10,599,0,1.13718e+14,5.61102,46.4323,599,6,6,301,301,301,301,301
18664,229,1587,17503,1161,17503,1161,1.97415e+18,237.934,3319.9,18664,460,124,16985,16738,16146,15185,4342
27082,870,1135,0,27082,0,27082,1.24925e+18,588.758,3460.02,27082,326,207,25947,25239,25381,23972,23027
42549,239,612,40261,2288,42549,0,3.83338e+18,299.738,3226.32,42549,259,183,41613,40829,37848,35493,27520
11868,71,303,11868,0,11868,0,4.01391e+18,199.835,1267.24,11868,103,123,10734,10082,6665,5884,3018
8661,7,10,8554,107,8661,0,7.72831e+13,5.96836,189.127,8661,7,8,8651,8651,7748,7746,7754
19034,476,794,16764,2270,16764,2270,1.713e+18,352.722,2726.39,19034,237,159,18235,17733,17407,17284,11881
43651,147,504,43651,0,43651,0,5.05775e+18,312.826,2845.19,43651,223,172,42095,40662,28968,26246,19657
21620,336,1151,4915,16705,0,21620,2.19644e+13,95.3013,2937.03,21620,349,89,20469,20390,19724,8764,7923
12695,157,621,0,12695,3223,9472,6.68129e+15,341.378,1512.89,12695,395,66,11652,11393,10657,10496,6287
42437,778,1266,39674,2763,39674,2763,2.0021e+18,665.377,4402.34,42437,401,239,41087,39447,39812,39512,32215
34897,585,1233,0,34897,0,34897,1.21371e+18,667.194,4043.36,34897,365,217,33163,31551,31730,27675,22592
35417,10,11,33710,1707,35417,0,9.61331e+13,10.8498,420.488,35417,11,11,35395,35382,34634,34634,35391
31965,11,57,0,31965,31407,558,2.7466e+16,18.9284,564.822,31965,31,27,31722,31582,30563,30830,21953
10149,650,714,9446,703,0,10149,2.53996e+18,258.665,1736.33,10149,196,122,9435,9399,9406,9389,9201
33838,1827,2118,33838,0,30394,3444,1.37659e+18,242.596,4927.63,33838,507,154,31720,31720,31720,31720,25771
12641,4,10,12549,92,12641,0,1.00958e+14,8.74962,219.618,12641,10,10,12500,12451,10951,11624,8263
19170,653,836,17851,1319,0,19170,2.52098e+18,385.04,2419.52,19170,227,149,18334,17922,18140,18168,16295
16469,82,929,2658,13811,0,16469,1.90578e+13,168.958,2364.2,16469,286,90,15106,14222,13750,7817,2836
9533,488,1525,605,8928,0,9533,4.89775e+11,12.2313,2271.93,9533,315,17,8008,8008,6062,6845,4300
21980,254,1915,21980,0,19659,2321,1.59484e+18,199.101,3987.54,21980,294,252,20020,18846,16849,14017,5116
13128,306,2515,13128,0,12815,313,5.39367e+17,14.968,2862.73,13128,325,23,10613,10613,8458,10613,1574
48149,577,1035,0,48149,0,48149,1.87764e+18,361.704,4461.54,48149,344,221,47114,47107,45820,46052,28987
49632,770,3593,1098,48534,0,49632,2.01749e+12,58.5781,6811.91,49632,514,58,46039,46034,42549,41968,16882
48887,1614,2580,44219,4668,44219,4668,2.90026e+18,285.76,6315.07,48887,515,241,46307,46306,46023,46044,35337
48105,97,932,0,48105,10454,37651,4.76649e+15,475.881,3863.97,48105,360,213,44523,42665,39138,32978,14821
16512,170,1053,16512,0,15405,1107,1.03535e+18,343.495,2647.57,16512,269,164,14916,14077,11951,11896,6724
1617,91,246,1525,92,1525,92,4.54561e+17,85.6506,494.066,1617,65,49,1330,1182,1140,1199,574
30722,134,1417,30722,0,27082,3640,9.5653e+17,380.87,4354.58,30722,384,177,26195,22838,20043,5377,3522
15425,20,1065,14354,1071,14354,1071,2.14159e+18,397.993,2647.09,15425,273,168,10173,8495,7097,7122,2218
41442,347,3443,0,41442,0,41442,1.46375e+18,499.734,6965.55,41442,878,232,37439,36829,33947,29004,8713
23588,410,470,23588,0,23588,0,3.3297e+18,260.186,1968.3,23588,167,130,23118,23111,22885,22899,22260
18087,181,623,13616,4471,13616,4471,7.05879e+18,275.626,1874.66,18087,157,131,17060,16603,13683,11711,6281
12528,26,281,12528,0,12528,0,3.83657e+18,196.038,1268.84,12528,104,119,9722,7225,5563,4746,1496
37421,7,11,35674,1747,37421,0,9.60321e+13,10.7583,432.347,37421,11,11,37168,36940,33780,33712,32807
23599,1,14,23423,176,23599,0,9.56461e+13,11.6818,309.092,23599,12,11,13200,13200,13200,13200,13200
18249,1,11,17390,859,18249,0,9.6093e+13,10.7065,302.315,18249,11,11,7156,7156,7156,7156,7156
45952,6,15,44947,1005,43186,2766,7.94958e+13,6.53676,422.033,45952,9,10,45865,45720,42497,42499,38225
8224,13,26,0,8224,8213,11,1.75238e+16,12.0694,278.582,8224,17,20,8176,8140,7976,8140,6669
47851,502,675,38288,9563,47851,0,3.85907e+18,404.454,3603.24,47851,301,166,47153,46976,45112,43907,40642
25853,621,712,0,25853,0,25853,1.88621e+18,318.029,2951.63,25853,252,173,25141,25141,25064,25111,24002
19674,1841,3142,19674,0,0,19674,8.20565e+18,12.2528,4565.76,19674,639,19,16532,16532,14736,13643,10857
6077,437,594,5640,437,0,6077,2.63531e+18,130.792,1272.56,6077,132,92,5483,5469,5446,5447,5114
49060,267,879,36995,12065,0,49060,8.28131e+18,399.345,3298.82,49060,258,195,47387,45451,37581,37730,20830
48211,559,709,13385,34826,0,48211,6.3109e+13,278.847,2692.36,48211,217,144,47502,47484,47250,47168,43047
38417,673,1452,35965,2452,0,38417,2.35206e+18,590.284,4478.01,38417,368,236,36785,35836,35661,35118,26464
3158,333,567,2898,260,2898,260,1.42211e+18,52.8797,967.666,3158,108,74,2591,2576,2429,2512,1932
42475,593,2551,0,42475,0,42475,1.50315e+18,414.904,6387.31,42475,586,251,39737,39115,37635,14236,11754
35117,1449,2203,0,35117,0,35117,1.56232e+18,376.835,5454.9,35117,552,231,32914,32844,32480,32582,23511
37872,698,2057,34100,3772,34100,3772,3.09162e+18,304.296,4942.04,37872,346,214,35815,35551,34200,33337,20127
33042,2,11,31468,1574,33042,0,9.61939e+13,10.3969,405.65,33042,11,11,23886,20137,21183,20825,15736
10755,256,983,0,10755,0,10755,1.15605e+18,191.484,2131.19,10755,198,131,9690,9471,9028,8802,5454
27413,40,61,0,27413,27193,220,1.79376e+16,17.7642,712.806,27413,23,29,27352,27351,26637,27245,18328
20807,805,1089,0,20807,0,20807,1.19865e+18,457.248,2999.63,20807,274,182,19718,19201,19352,18727,15788
24800,710,1678,22976,1824,22976,1824,2.31346e+18,343.895,3739.33,24800,613,123,23122,22675,22676,22572,12973
1793,117,242,1793,0,1670,123,1.16134e+18,97.5499,512.937,1793,74,55,1523,1394,1295,1430,998
5156,180,372,4624,532,0,5156,3.77464e+18,165.45,911.661,5156,81,88,4744,4337,4436,4442,2586
32837,337,522,31567,1270,32837,0,3.88273e+18,254.76,2525.44,32837,176,156,32315,32194,31960,31833,30644
27115,21,1961,24552,2563,24552,2563,2.78051e+18,311.978,4263.36,27115,473,234,19930,16875,15318,14620,2945
30081,1077,1795,30081,0,27011,3070,7.93366e+17,402.618,4586.66,30081,493,155,28286,28171,27661,26088,18421
11364,935,984,11364,0,10614,750,9.51537e+17,213.445,2193.58,11364,240,149,10380,10341,10350,10359,10155
29267,583,925,29267,0,25707,3560,1.16608e+18,379.665,3542.52,29267,264,181,28342,28281,27137,25539,19510
20851,806,885,18168,2683,0,20851,3.92585e+18,293.024,2821.75,20851,243,162,19966,19966,19966,19966,19836
24239,267,780,6631,17608,0,24239,5.86564e+13,176.673,2428.29,24239,134,126,23459,23190,20315,19989,6591
13189,283,674,11587,1602,11587,1602,1.74817e+18,315.418,2159.22,13189,213,149,12334,11914,11605,11670,7629
19816,886,933,0,19816,0,19816,2.10975e+18,258.399,2241.03,19816,119,204,18883,18883,18877,18877,18520
48873,379,959,42955,5918,0,48873,3.86658e+18,350.728,4420.27,48873,337,218,47817,46664,44732,45106,21227
48768,451,768,48704,64,48768,0,3.09513e+18,384.801,3935.49,48768,262,174,47895,47719,45186,43626,35146
28805,362,1134,0,28805,0,28805,1.84835e+18,552.483,3435.7,28805,474,152,26772,25602,23992,25468,15574
29915,21,365,29909,6,29915,0,3.23618e+18,299.957,2346.25,29915,190,146,21429,16099,14548,8332,3568
18538,154,942,0,18538,0,18538,2.0552e+18,212.786,2239.83,18538,115,160,17238,16398,15156,11323,4546
42974,10,16,42359,615,40223,2751,8.59871e+13,7.5733,416.503,42974,10,11,42958,42957,42153,42157,38698
18091,149,430,18091,0,18091,0,4.79647e+18,248.457,1806.92,18091,162,130,17331,16697,13386,12395,9519
29051,804,967,0,29051,0,29051,1.93084e+18,265.794,2807.12,29051,142,164,28084,28083,27691,27701,25281
35042,631,1237,0,35042,8261,26781,5.78846e+15,298.985,3836.37,35042,350,159,33805,33602,32529,31823,17931
42449,353,1852,0,42449,0,42449,1.95336e+18,401.119,5418.85,42449,370,219,39973,38781,35293,28405,19617
34283,724,787,25845,8438,25845,8438,3.79952e+18,369.051,2842.18,34283,227,176,33496,33496,33474,33472,33022
6066,473,504,1298,4768,0,6066,2.00005e+13,98.3561,1239.31,6066,140,75,5562,5561,5562,5562,5526
18199,294,1274,16383,1816,16383,1816,3.10264e+18,209.377,2918.08,18199,222,140,16915,16711,15608,15101,7935
40629,9,34,0,40629,38724,1905,2.45816e+16,31.4025,661.979,40629,30,31,39494,38050,29980,35062,23477
39819,17,696,11064,28755,0,39819,6.33248e+13,244.885,2447.93,39819,184,149,32810,26338,28033,10850,4491
26861,221,1905,0,26861,0,26861,3.85575e+18,234.066,4008.11,26861,306,206,24703,24041,21148,10416,10497
15919,581,597,14262,1657,0,15919,3.80788e+18,246.149,1784.14,15919,111,134,15322,15322,15315,15310,15195
560,37,96,424,136,0,560,8.0853e+18,37.3214,194.009,560,31,33,438,239,331,324,242
15370,589,707,0,15370,3506,11864,4.56157e+15,187.814,1956.44,15370,194,124,14663,14601,14629,14613,13362
3120,466,550,2661,459,2661,459,2.52001e+18,11.2106,729.408,3120,264,22,2570,2570,2546,2570,2288
19652,191,878,0,19652,4154,15498,4.46627e+15,301.181,2622.44,19652,248,154,18489,18022,17589,15531,8192
1502,84,255,0,1502,413,1089,6.90852e+15,46.1345,472.441,1502,92,54,1247,1189,1169,1231,627
3499,229,322,3499,0,3499,0,4.80288e+18,91.1166,777.391,3499,87,79,3177,3169,2988,2877,2208
34404,346,1183,34404,0,30518,3886,2.09838e+18,330.815,3284.16,34404,136,308,33062,32216,28065,30996,14644
41100,690,1369,38395,2705,38395,2705,6.56682e+17,668.221,4502.43,41100,416,230,39338,37777,37939,37934,31958
46945,304,478,46945,0,46945,0,3.67351e+18,272.495,3039.85,46945,270,177,46458,46184,40941,40810,33756
41588,771,1883,41588,0,37356,4232,1.49445e+18,291.404,4791.17,41588,528,169,39705,39655,34898,37730,13025
925,3,8,917,8,925,0,7.82046e+13,2.97081,53.6338,925,4,6,914,912,868,864,701
23369,614,1087,21885,1484,0,23369,2.31395e+18,512.658,3157.25,23369,331,180,22051,21432,21354,21234,17427
18950,17,18,18668,282,18948,2,9.77662e+13,14.2327,307.219,18950,17,17,18932,18931,18899,18900,18928
2526,45,240,2353,173,0,2526,2.50547e+18,108.779,591.2,2526,74,57,1929,1495,1592,1541,813
48368,3870,4049,40422,7946,0,48368,7.83066e+18,15.5831,6651.29,48368,1480,26,44319,44319,44147,44079,42289
28060,355,1009,25038,3022,0,28060,3.90989e+18,265.425,2829.88,28060,170,159,27051,26851,23225,22530,6617
37582,553,725,37518,64,37582,0,3.00901e+18,308.695,3266.45,37582,249,157,36857,36837,36211,36070,33227
20241,18,457,20241,0,20241,0,3.42101e+18,237.435,1972.06,20241,137,150,11527,7040,6836,6318,1417
14127,50,407,14127,0,14127,0,3.12539e+18,223.625,1487.78,14127,134,108,12584,9886,7422,6931,2062
47024,539,1393,10339,36685,0,47024,1.83288e+13,406.742,4635.3,47024,351,203,45567,44663,43946,39408,29192
38297,765,1421,0,38297,0,38297,1.45708e+18,608.955,4591.34,38297,469,179,36772,36277,34845,34794,19862
19940,163,486,0,19940,5539,14401,1.61248e+16,193.137,1596.15,19940,124,110,19287,18837,18149,18207,10600
20219,652,1048,18835,1384,0,20219,2.50492e+18,547.026,2987.4,20219,272,195,19085,18313,18446,18376,14900
42797,622,920,37622,5175,0,42797,3.86594e+18,342.933,4079.75,42797,318,193,41877,41877,41348,41340,30377
12602,415,563,0,12602,2770,9832,4.87725e+15,253.643,1623.09,12602,187,127,12039,11863,11866,11903,10809
45446,1036,2449,45446,0,37347,8099,9.42862e+17,390.59,6022.51,45446,493,300,42997,42981,41785,36251,23163
19378,423,1010,18127,1251,18127,1251,2.00182e+18,452.515,2842.98,19378,270,173,18044,17480,17232,17179,13863
26098,818,1688,22458,3640,22458,3640,4.05416e+18,244.519,4323.11,26098,304,178,24410,24378,21574,19880,13127
11030,3,8,11004,26,11030,0,1.19123e+14,7.5117,196.152,11030,8,8,10488,10191,9600,9989,6982
7899,21,32,0,7899,7516,383,2.46123e+16,26.5954,291.394,7899,22,22,7855,7829,7506,7585,6898
25110,630,688,18920,6190,0,25110,8.30312e+18,309.525,2242.28,25110,188,138,24422,24419,24387,24386,23911
36191,16,40,0,36191,36152,39,1.2237e+16,8.28543,714.28,36191,20,12,36151,36151,34263,33841,24530
30518,5,10,30298,220,30518,0,9.98325e+13,9.57176,341.383,30518,10,10,30288,30185,28043,28716,20154
34637,103,612,7846,26791,0,34637,2.83789e+13,235.015,2875.06,34637,246,129,33134,32233,27488,15443,8811
21383,253,701,0,21383,0,21383,4.09868e+18,295.829,2162.91,21383,181,152,20438,19681,18078,11662,8259
1134,18,190,0,1134,96,1038,1.1564e+16,7.07848,254.71,1134,94,10,944,932,773,704,418
35187,419,491,35187,0,35187,0,3.24266e+18,294.826,2417.76,35187,193,138,34696,34679,33848,33582,32461
32365,869,1666,29961,2404,29961,2404,2.33135e+18,267.362,4527.73,32365,459,131,30699,30654,30174,29244,17035
32963,10,13,32746,217,32963,0,1.00933e+14,10.812,356.527,32963,12,11,32940,32929,31926,31924,31823
10364,358,404,10364,0,10364,0,3.27804e+18,195.644,1509.96,10364,137,103,9960,9928,9888,9801,9229
22626,845,1098,3835,18791,0,22626,2.03671e+13,205.018,2918.83,22626,415,92,21528,21528,21372,21431,19417
36072,1019,1286,33703,2369,33703,2369,6.28488e+17,628.607,4124.51,36072,367,228,34786,34714,34494,34457,32322
12702,22,31,0,12702,12139,563,2.44335e+16,26.8267,364.797,12702,20,23,12654,12620,12063,12105,10217
19478,27,59,0,19478,19458,20,1.93851e+15,37.2643,575.489,19478,46,18,19364,19304,19205,19076,15468
49956,155,981,10939,39017,0,49956,1.80475e+13,503.168,3954.31,49956,370,214,46940,46062,43440,35865,17491
16671,471,513,15321,1350,16671,0,4.2125e+18,226.122,1937.3,16671,197,134,16158,16145,16139,16134,15857
29584,982,1213,29584,0,27613,1971,9.72676e+17,603.929,3663.34,29584,361,205,28371,28008,27803,27957,26799
41082,9,12,40960,122,41082,0,8.28149e+13,6.92926,411.143,41082,10,8,41070,41070,41066,41065,40663
35995,1317,1758,35995,0,33240,2755,1.19589e+18,572.175,4932.54,35995,474,229,34237,34233,33958,33731,29494
28344,471,929,0,28344,0,28344,1.93019e+18,277.922,2725.49,28344,154,163,27415,27330,26050,19935,19549
37882,422,518,37882,0,37882,0,5.13562e+18,321.965,2792.35,37882,206,173,37364,37335,36684,35953,34915
39367,1375,1891,33855,5512,0,39367,4.81017e+18,330.15,5368.11,39367,329,217,37476,37457,36626,36768,27616
22377,168,362,22374,3,22377,0,3.23086e+18,252.615,2008.28,22377,171,125,21085,19563,18671,14543,13404
48176,153,1473,48176,0,44982,3194,9.61438e+17,751.635,4985.12,48176,425,254,43092,40270,32892,33669,12210
28104,503,568,28104,0,28104,0,3.45639e+18,300.102,2744.02,28104,199,180,27536,27535,27393,27101,26363
29961,373,1984,24749,5212,0,29961,5.91337e+18,361.697,4621.03,29961,357,210,27288,26412,23884,24630,9429
13129,138,191,0,13129,12710,419,2.55433e+16,18.7503,811.119,13129,73,34,12938,12938,12769,12515,10221
9316,111,540,8257,1059,8257,1059,3.11847e+18,283.998,1647.06,9316,186,117,8116,6947,6655,5910,2842
14772,19,943,13085,1687,0,14772,4.12088e+18,181.712,2138.65,14772,221,133,10573,5454,7616,7599,735
8054,429,433,0,8054,1312,6742,5.04665e+15,158.622,1231.09,8054,169,70,7621,7621,7621,7621,7617
6351,390,563,0,6351,1050,5301,3.80232e+15,62.1115,1004.8,6351,207,61,5788,5788,5788,5788,4582
7310,66,318,0,7310,2038,5272,1.62109e+16,92.0498,861.88,7310,72,66,6924,6835,6154,6248,2344
22690,495,855,0,22690,5677,17013,8.31672e+15,243.057,2110.9,22690,103,225,21835,21738,21000,21188,16978
45380,1041,1151,0,45380,10807,34573,5.9912e+15,294.89,4057.03,45380,386,151,44229,44229,44142,44209,38542
49210,415,2013,43850,5360,43850,5360,3.38535e+18,320.323,5018.87,49210,360,307,47118,45968,40046,31091,10815
20482,2,48,0,20482,20406,76,2.55801e+16,19.5605,501.395,20482,23,24,16100,15024,13727,13115,9957
4741,62,417,3564,1177,3564,1177,3.84622e+18,99.4693,914.649,4741,98,92,4204,3891,3160,3259,1228
14821,621,1233,2928,11893,0,14821,1.96795e+13,95.9601,2299.79,14821,398,145,13588,13572,13534,13588,8297
28995,31,36,0,28995,27606,1389,2.46531e+16,29.8228,566.476,28995,30,30,28954,28898,28796,28884,28490
33266,295,2086,0,33266,0,33266,1.37147e+18,397.275,4911.76,33266,712,142,30739,30096,27811,21456,9352
31353,301,578,7185,24168,0,31353,2.87115e+13,221.536,2694.88,31353,236,121,30775,30572,29814,30332,18862
33272,4270,5313,33272,0,33272,0,3.0676e+18,16.702,6380.01,33272,874,29,27959,27959,27959,27959,23714
5577,238,754,5577,0,5041,536,8.6247e+17,82.8627,1405.88,5577,224,76,4823,4759,4382,4692,2443
47043,71,76,0,47043,46747,296,2.29639e+16,26.3363,921.402,47043,32,35,46967,46967,46260,46305,45831
43760,29,34,0,43760,41639,2121,2.46605e+16,30.4423,686.479,43760,30,31,43698,43573,43057,43456,39516
8327,14,21,0,8327,8301,26,3.03391e+16,17.2102,264.834,8327,19,17,8284,8242,8152,8176,6203
25747,33,65,0,25747,25592,155,2.6274e+16,37.2054,689.923,25747,33,34,25647,25605,24875,24940,21769
31435,10,11,29985,1450,31435,0,9.60792e+13,10.5165,395.89,31435,11,11,31415,31405,30816,30816,31411
20400,284,290,20400,0,20400,0,3.79108e+18,228.645,1662.19,20400,128,144,20110,20110,20082,20094,19939
20000,1405,1455,0,20000,0,20000,1.50987e+18,313.239,3496,20000,312,169,18545,18545,18545,18545,18376
40040,1489,1658,37352,2688,37352,2688,6.96524e+17,660.397,5006.94,40040,365,279,38382,38376,38358,38368,37284
3130,451,506,2934,196,2934,196,6.54208e+17,78.0272,948.119,3130,72,105,2624,2624,2615,2616,2439
21130,400,415,21130,0,21130,0,4.9773e+18,251.279,1920.38,21130,159,138,20715,20713,20689,20668,20604
47866,2456,3112,43510,4356,43510,4356,5.13548e+18,14.8893,5985.62,47866,1555,17,44754,44754,44100,39268,37281
4275,208,549,4275,0,3792,483,1.14801e+18,157.608,1183.95,4275,148,88,3720,3508,3360,2543,2418
17021,88,602,16281,740,16256,765,7.81224e+17,311.772,2195.32,17021,213,131,13978,12256,11142,12685,5180
3108,271,325,2788,320,2788,320,8.78411e+17,131.578,701.511,3108,75,70,2783,2674,2776,2776,2512
30094,115,563,0,30094,8351,21743,1.62107e+16,233.348,2019.07,30094,156,126,28946,28312,24852,25203,10536
2187,92,343,2045,142,0,2187,2.47687e+18,81.6959,605.36,2187,101,65,1786,1562,1635,1672,557
25746,17,45,0,25746,25657,89,2.65325e+16,19.0399,532.498,25746,24,24,25677,25591,25184,25273,19414
39700,441,2318,0,39700,0,39700,1.43778e+18,458.878,5735,39700,736,144,37085,36109,34818,23492,13253
21677,255,1294,0,21677,0,21677,1.44677e+18,304.505,3378.75,21677,446,114,19976,19406,18713,13609,7613
5939,493,940,5513,426,5513,426,2.26163e+18,102.142,1730.16,5939,179,143,4999,4973,4955,4962,3184
7267,689,842,6743,524,6743,524,2.18509e+18,158.687,1737.33,7267,170,135,6425,6415,6400,6408,5323
18369,54,787,17168,1201,17168,1201,2.03524e+18,375.369,2334.84,18369,226,154,14443,11882,11668,11082,3725
2918,9,10,2805,113,2918,0,9.45331e+13,7.75531,118.804,2918,9,10,2908,2908,2891,2891,2788
19034,94,1121,19034,0,17786,1248,9.56845e+17,511.568,2978.36,19034,308,171,15936,13763,12094,12499,5199
43482,1021,1914,38678,4804,38678,4804,3.27245e+18,438.315,5564.69,43482,377,221,41568,41507,39355,38175,31150
14047,890,1068,14047,0,13065,982,1.06564e+18,248.167,2460.1,14047,272,155,12979,12911,12703,12826,12419
48156,1365,2218,43539,4617,43539,4617,2.98517e+18,315.666,5730.74,48156,499,217,45938,45938,42222,39560,24230
13917,1019,1250,10234,3683,10234,3683,2.18736e+18,22.9528,1752.54,13917,425,419,12667,12667,12439,12212,12368
38378,1130,1580,0,38378,7936,30442,6.3164e+15,315.143,4594.09,38378,476,197,36798,36651,36499,36798,27895
39319,581,711,39315,4,39319,0,4.46331e+18,327.064,3309.72,39319,206,134,38608,38596,38222,38142,37286
16197,11,31,0,16197,15449,748,2.46111e+16,25.6591,406.249,16197,22,23,15893,15447,12822,14098,10655
12688,99,973,11826,862,11826,862,2.10786e+18,225.132,2249.75,12688,205,122,10903,9577,9566,9656,3390
792,129,197,730,62,0,792,2.90462e+18,22.7664,306.877,792,69,23,595,594,590,584,428
10504,201,278,10504,0,10504,0,3.73295e+18,200.652,1180.95,10504,106,112,10168,9645,9572,9111,7602
23579,243,827,0,23579,5271,18308,5.8981e+15,208.188,2703.98,23579,306,100,22697,21788,20274,19578,7016
41253,86,88,0,41253,40252,1001,2.00367e+16,22.7801,1031.76,41253,32,38,41165,41165,41047,40932,40938
15100,400,1002,14190,910,0,15100,2.17697e+18,245.459,2405.9,15100,221,148,14082,13837,13491,13449,9497
41875,963,2494,41875,0,37875,4000,1.4253e+18,330.511,5998.73,41875,397,310,39381,39316,36859,30687,23099
35315,694,1544,0,35315,7451,27864,6.14186e+15,304.021,4269.88,35315,541,128,33771,33746,32395,31003,17663
36133,20,32,35312,821,36129,4,9.96653e+13,9.11258,456.016,36133,18,18,36100,36093,35426,35392,27625
22132,6,12,21821,311,22132,0,9.65553e+13,9.75614,285.071,22132,12,11,22044,21986,21030,20981,19330
29703,1114,1430,0,29703,0,29703,1.94872e+18,250.43,3420.39,29703,178,168,28273,28273,28273,28273,27702
42460,41,3123,42180,280,0,42460,7.03584e+18,89.8712,5997.44,42460,498,76,38669,37829,35472,31853,6872
3500,65,285,2644,856,2644,856,6.88906e+18,56.6371,643.677,3500,76,61,3207,3114,2353,1980,1334
30550,236,1719,27255,3295,27255,3295,3.34246e+18,271.015,3894.07,30550,225,218,28565,27214,24899,22145,7782
42969,1468,1881,42969,0,40030,2939,9.46915e+17,620.069,5656.97,42969,391,269,41088,41038,39976,39991,36502
26802,275,1171,25068,1734,25068,1734,6.15304e+17,517.65,3452.06,26802,302,194,24816,24253,23241,23354,14654
16800,172,466,16800,0,16800,0,3.62101e+18,276.81,2024.17,16800,167,143,15886,15353,13192,10834,7803
10856,5,12,10715,141,10856,0,1.00134e+14,6.93137,199.323,10856,9,9,10759,10693,10263,10195,8725
44698,1725,2103,10065,34633,0,44698,3.02824e+13,241.439,4932.83,44698,459,300,42595,42594,41234,41943,34868
10196,9,10,10096,100,10196,0,7.3378e+13,5.69616,203.796,10196,7,8,10186,10186,9660,9660,9832
40845,19,42,0,40845,40816,29,1.69556e+16,12.9669,869.615,40845,23,22,40803,40803,34369,37167,37468
42014,834,1388,42014,0,39353,2661,9.40781e+17,701.84,4519,42014,403,226,40538,39045,37250,36553,32242
1865,102,135,0,1865,0,1865,3.5646e+18,14.7013,319.158,1865,69,15,1730,1730,1697,1697,1414
23268,3,9,22748,520,20986,2282,8.14861e+13,6.32126,266.941,23268,9,7,22955,22849,21709,21980,16217
28514,1350,1690,25917,2597,0,28514,3.32679e+18,335.113,4241.26,28514,341,179,26824,26816,26623,26598,24174
34993,458,758,0,34993,0,34993,4.13406e+18,345.339,2692.46,34993,217,164,34235,34059,33512,33269,26331
39519,426,649,35649,3870,39519,0,3.70062e+18,335.442,3273.4,39519,257,185,38856,38561,37020,35581,31897
4629,61,718,0,4629,0,4629,1.31519e+18,150.753,1369,4629,139,98,3539,3047,2906,2289,988
22452,9,10,22305,147,22452,0,1.00933e+14,9.1358,293.056,22452,10,10,22438,22434,22356,22355,22431
40869,114,2309,36934,3935,36934,3935,2.90109e+18,339.121,5671.57,40869,497,253,36090,32907,32168,27073,5972
876,104,128,876,0,652,224,8.356e+17,55.0811,280.175,876,46,47,748,746,726,706,705
11246,661,741,11246,0,11246,0,9.25555e+17,15.8661,1542.05,11246,372,16,10505,10505,10426,10505,9625
35501,195,479,35501,0,35501,0,5.0011e+18,295.157,2538.99,35501,201,153,34554,33674,26611,24922,20550
6726,95,442,5075,1651,0,6726,8.18521e+18,88.1084,1011.52,6726,93,84,6267,6163,5254,5122,2340
13162,671,1104,0,13162,0,13162,2.15889e+18,164.89,2101.49,13162,262,119,12058,12058,10980,10743,5146
16510,259,1052,0,16510,3564,12946,4.76836e+15,200.725,2626.89,16510,276,152,15453,15123,14486,13903,6053
35003,923,1145,0,35003,8220,26783,6.20072e+15,339.813,3579.14,35003,402,140,33858,33730,33478,33617,30146
47630,347,903,35850,11780,35850,11780,3.8246e+18,408.621,3426.72,47630,266,190,46409,44206,44674,44572,24815
6510,283,467,1447,5063,0,6510,1.85914e+13,101.911,1156.01,6510,115,67,6043,6020,5951,5732,5098
15647,855,1024,15647,0,0,15647,7.30313e+18,14.8807,2056.79,15647,512,15,14623,14623,14454,14581,12756
31244,1443,1729,0,31244,0,31244,1.23164e+18,479.858,4698.55,31244,364,232,29515,29511,29375,29402,26584
49135,1462,1478,0,49135,0,49135,1.20289e+18,701.201,4966.85,49135,426,249,47657,47657,47657,47657,47564
7550,532,1453,0,7550,0,7550,4.60824e+17,13.9252,1702.75,7550,192,22,6097,6097,5180,5298,2583
43217,26,507,43217,0,43217,0,4.01512e+18,262.024,2888.98,43217,162,225,33403,24503,18796,13975,4670
31817,1224,1433,29727,2090,29727,2090,6.62293e+17,519.255,4226.1,31817,273,241,30384,30375,30093,30237,28347
29893,15,757,6611,23282,0,29893,1.87373e+13,363.919,2746.62,29893,303,159,21499,18524,16011,7576,5104
1662,55,247,0,1662,0,1662,1.93112e+18,38.3081,451.628,1662,57,51,1415,1369,1317,1027,566
44810,66,2514,0,44810,0,44810,1.6323e+18,347.935,6343.52,44810,569,250,38257,35437,33382,13254,4290
16629,14,24,0,16629,16615,14,1.37191e+16,9.94161,404.17,16629,14,10,16605,16605,15829,16094,13745
10880,88,730,10880,0,10880,0,4.03702e+18,15.9404,1551.14,10880,366,17,10150,10150,6698,8268,1384
44990,390,644,43059,1931,42984,2006,7.73652e+17,505.314,3618.64,44990,278,200,43960,42650,38372,40824,35693
42291,423,1661,42291,0,37254,5037,1.1268e+18,376.866,5128.85,42291,345,210,40313,38637,36375,32104,15440
37325,28,62,0,37325,36947,378,2.57381e+16,31.0182,728.806,37325,35,32,37221,37141,36236,36039,26918
11365,252,431,11365,0,11365,0,4.13295e+18,231.691,1383.49,11365,159,88,10835,10694,9681,9805,7892
8874,7,469,7502,1372,8874,0,3.28131e+18,184.071,1342.46,8874,169,91,5727,4185,3244,2493,803
39711,524,1217,9167,30544,0,39711,2.24229e+13,325.359,4052.3,39711,331,177,38458,37813,36712,16911,17813
19323,724,1144,19323,0,18009,1314,9.55228e+17,473.402,3024.39,19323,240,192,18112,17581,16747,16250,12843
29181,491,528,0,29181,6754,22427,7.38845e+15,219.607,2532.28,29181,232,128,28653,28649,28617,28630,27602
9342,662,942,0,9342,0,9342,1.04289e+18,114.651,1705.31,9342,256,91,8400,8400,8397,8397,7270
35331,70,90,0,35331,35247,84,2.11966e+16,27.3443,876.328,35331,37,33,35241,35240,35237,35241,33187
25799,199,521,5927,19872,0,25799,2.89724e+13,211.886,2385.09,25799,217,114,25085,24684,23251,23623,11207
8009,154,359,2220,5789,0,8009,1.82058e+13,56.0104,1044.34,8009,128,53,7650,7648,7501,7511,4778
4280,20,27,0,4280,4262,18,2.86547e+16,20.1528,223.177,4280,22,22,4242,4222,4091,4125,3931
34871,539,1180,32542,2329,0,34871,2.42265e+18,595.881,3941.78,34871,336,221,33126,31517,31520,31461,23372
10808,359,634,0,10808,2393,8415,4.44034e+15,141.874,1664.22,10808,181,97,10174,10094,9980,10055,8325
21564,77,716,0,21564,6000,15564,1.5537e+16,173.057,2203.34,21564,128,129,20441,20076,16079,17187,2064
7763,38,361,0,7763,1744,6019,7.21356e+15,149.808,1166.21,7763,145,75,6709,6032,5648,4442,1327
30335,704,1566,30335,0,27124,3211,7.79095e+17,427.877,4359.31,30335,427,167,28769,28495,27374,23773,19322
776,81,165,776,0,776,0,2.99485e+18,44.7964,305.724,776,37,55,611,573,513,506,385
48099,5,34,0,48099,48055,44,9.4561e+15,5.91779,747.383,48099,15,11,47818,47603,44406,44951,24905
1960,34,382,281,1679,0,1960,7.06893e+12,9.88878,489.212,1960,58,18,1578,1578,1232,662,468
15148,327,1286,0,15148,0,15148,1.97029e+18,208.403,2557.89,15148,378,118,13777,13511,12622,9942,3640
2706,151,170,606,2100,0,2706,1.83581e+13,69.1922,485.38,2706,69,50,2536,2536,2527,2530,2499
37292,937,1457,0,37292,0,37292,3.81541e+18,305.221,4118.28,37292,241,202,35835,35834,34333,25875,18831
29182,26,32,28007,1175,29178,4,9.75359e+13,10.3473,447.009,29182,18,18,29150,29146,29026,29025,28137
30066,114,758,30066,0,22654,7412,8.22428e+17,352.265,2639.86,30066,210,171,27987,27183,22741,22381,6759
13324,30,1052,12441,883,12441,883,6.06351e+17,245.101,2393.05,13324,218,146,9210,6862,5514,6393,1887
19324,859,940,17130,2194,17130,2194,3.53509e+18,243.735,2254.53,19324,117,205,18384,18382,18367,18363,17594
9477,21,532,8422,1055,8422,1055,3.07844e+18,266.559,1645.8,9477,170,116,6703,5428,5057,4340,825
9167,148,465,8198,969,0,9167,3.86499e+18,200.755,1268.74,9167,96,113,8432,7877,7574,7771,3133
20559,66,484,20559,0,20559,0,4.58438e+18,290.348,2042.24,20559,181,112,18118,16551,10929,9768,5542
21360,37,44,0,21360,21141,219,2.39349e+16,39.9572,514.762,21360,31,33,21292,21205,21153,21232,19394
18258,1105,1411,16682,1576,0,18258,3.24987e+18,243.688,3055.47,18258,353,196,16847,16847,16847,16847,15690
18984,377,474,0,18984,5263,13721,1.61075e+16,193.185,1563.7,18984,120,105,18510,18498,18383,18416,16432
46933,1639,1736,0,46933,8761,38172,5.74285e+15,509.557,5182.46,46933,498,180,45197,45098,45197,45180,43500
25309,100,898,22645,2664,22645,2664,3.27696e+18,266.637,2595.39,25309,139,155,22686,21312,20531,17667,4213
43011,329,496,43011,0,43011,0,3.29936e+18,331.638,2702.06,43011,206,150,42441,42106,38935,36881,31861
43146,1796,6613,0,43146,0,43146,3.30676e+17,14.2545,7878.74,43146,1148,22,36533,36533,31722,33564,17921
41035,19,1456,10492,30543,0,41035,2.93978e+13,252.757,3688.34,41035,232,158,34760,31132,27558,23260,4944
42497,1137,2115,0,42497,0,42497,1.76552e+18,375.181,5375.9,42497,361,211,40382,40334,39436,28312,29237
13225,60,407,13225,0,13225,0,5.03694e+18,248.874,1561.66,13225,147,119,11507,9991,7098,5977,2855
47526,30,46,0,47526,47214,312,2.59114e+16,37.2002,746.742,47526,33,35,47407,47265,46832,47216,40329
31397,684,2054,29095,2302,0,31397,2.74298e+18,468.841,4717.55,31397,648,141,29323,28527,28167,27794,15219
12464,8,24,0,12464,12431,33,3.03054e+16,19.228,329.229,12464,20,19,12346,12296,10364,11256,7204
27107,8,34,0,27107,25788,1319,2.46583e+16,28.2399,537.315,27107,27,28,26057,25040,19445,23340,16052
32571,477,847,0,32571,7086,25485,4.63712e+15,433.059,3138.93,32571,305,179,31561,30784,30413,30079,21827
37575,7,11,37331,244,29495,8080,7.79667e+13,8.1221,445.629,37575,10,9,37532,37459,36166,36228,34352
14485,424,450,14485,0,14485,0,3.58422e+18,227.503,1856.16,14485,166,117,14035,14035,13981,13972,13842
24694,651,747,5340,19354,0,24694,1.88134e+13,395.09,2650.55,24694,266,158,23947,23905,23781,23812,22941
3657,223,465,3657,0,3269,388,1.75624e+18,71.6369,866.69,3657,83,76,3192,3169,2779,3083,1722
21334,201,629,0,21334,0,21334,4.15052e+18,303.138,2039.09,21334,172,144,20258,19630,16730,10175,8397
3010,236,241,0,3010,355,2655,7.64813e+15,75.491,583.811,3010,115,38,2769,2769,2769,2769,2753
46921,997,7900,46921,0,46921,0,1.53122e+18,16.9642,9121.34,46921,1202,29,39021,39021,32835,38581,5270
27743,34,83,0,27743,27308,435,2.11605e+16,21.2465,828.629,27743,28,32,27660,27652,26063,26274,21222
13092,938,1167,13092,0,12066,1026,7.30959e+17,266.281,2625.42,13092,356,112,11925,11901,11883,11921,9781
41403,1951,2283,36281,5122,36188,5215,1.98877e+18,527.413,5910.75,41403,502,274,39120,39115,39113,39114,35739
39792,301,7589,5684,34108,0,39792,7.02669e+12,9.99485,8106.6,39792,959,18,32203,32203,24917,13019,8535
8241,643,845,0,8241,0,8241,1.16399e+18,136.655,1850.66,8241,168,85,7396,7396,7396,7287,6491
1502,9,19,0,1502,1491,11,2.69616e+16,7.62517,104.226,1502,11,11,1481,1472,1442,1439,1334
12601,1103,1340,12601,0,12350,251,1.73043e+18,313.108,2544.41,12601,243,109,11261,11261,11215,11236,10149
16033,377,1302,0,16033,0,16033,1.6315e+18,193.133,2820.59,16033,634,82,14731,14604,13156,13337,5479
13166,1002,1018,11556,1610,11556,1610,3.77046e+18,444.13,2242.88,13166,258,155,12148,12148,12148,12148,12080
47633,1129,2327,37428,10205,37335,10298,3.38847e+18,381.441,5818.03,47633,412,267,45306,45287,43886,44707,34294
23372,7,8,23338,34,23372,0,4.28022e+13,5.36214,331.028,23372,7,6,23364,23364,22419,22418,22417
14345,2,13,14239,106,14345,0,1.00621e+14,9.4398,230.406,14345,10,10,13096,12759,10046,12637,8216
48875,550,923,10943,37932,0,48875,1.83542e+13,494.147,3778.99,48875,349,212,47827,46850,46264,42578,36853
10458,283,687,1348,9110,0,10458,5.4561e+13,11.8717,1389.02,10458,347,12,9771,9771,8726,5404,6180
10915,391,524,8235,2680,0,10915,8.2517e+18,211.873,1388.08,10915,124,108,10391,10158,10317,10314,8321
2302,44,268,0,2302,288,2014,5.24277e+15,48.1064,525.39,2302,159,37,1985,1903,1592,1788,448
12273,527,970,11478,795,11478,795,6.46289e+17,355.726,2298.39,12273,203,151,11303,10893,10959,10985,9031
40763,854,946,0,40763,0,40763,4.12815e+18,345.835,3094.79,40763,231,179,39817,39813,39728,39715,38792
6991,548,637,6513,478,6513,478,5.91376e+17,156.227,1419.57,6991,165,94,6354,6354,6350,6349,6241
16605,376,959,0,16605,4020,12585,8.71317e+15,188.767,1975.31,16605,144,187,15646,15354,13356,13566,4469
39299,35,46,0,39299,39031,268,2.58827e+16,36.8929,697.765,39299,33,34,39218,39103,38946,39096,35127
25549,573,1510,25549,0,23577,1972,8.62419e+17,369.887,3974.51,25549,511,119,23906,23334,22133,23025,11670
12981,44,1034,12123,858,12123,858,6.99975e+17,357.718,2397.01,12981,230,159,9589,7538,6967,7180,2679
25328,1296,2199,23178,2150,0,25328,3.1641e+18,219.563,4417.07,25328,739,203,23129,23129,22692,22539,14578
11441,52,411,11441,0,11441,0,3.35871e+18,182.989,1332.48,11441,124,109,10213,8473,6230,5975,1945
37326,1201,1503,33023,4303,33023,4303,1.56462e+18,390.105,4871.2,37326,384,192,35823,35823,35443,35613,29756
20606,333,722,4685,15921,0,20606,1.81402e+13,352.743,2346.49,20606,237,149,19665,19318,18948,17459,11061
11360,380,499,7773,3587,11360,0,4.72368e+18,208.44,1503.94,11360,204,103,10861,10762,9917,9732,10014
1603,150,171,1603,0,1603,0,3.03235e+18,92.7461,433.411,1603,67,51,1432,1411,1397,1362,1398
41258,4,12,41162,96,39934,1324,8.3096e+13,6.75353,413.255,41258,9,8,40209,39646,35120,35144,35780
27827,98,594,27827,0,27827,0,4.59259e+18,235.083,2661.09,27827,197,160,26234,24814,18297,17365,8886
30061,682,1188,0,30061,0,30061,1.17822e+18,607.077,3682.96,30061,337,204,28660,27606,27644,25233,21582
6434,390,407,5757,677,5757,677,3.27592e+18,172.881,1024.87,6434,89,96,6027,6027,6013,6013,5944
6795,240,410,6731,64,6795,0,3.6573e+18,184.012,1180.22,6795,197,72,6368,6139,5851,5617,4715
14610,482,571,0,14610,0,14610,1.81978e+18,315.545,2090.11,14610,208,139,14039,14038,13937,13992,11995
13329,66,505,11790,1539,11790,1539,2.66447e+18,343.637,1948.07,13329,255,132,10567,9949,9074,8268,2611
29583,668,1838,26396,3187,0,29583,3.61845e+18,269.181,4401.78,29583,375,217,27745,27704,26519,26637,16369
13954,90,193,0,13954,13497,457,2.50452e+16,22.6393,829.38,13954,74,34,13761,13748,13361,13287,10405
48787,1410,1551,45666,3121,45666,3121,1.99891e+18,776.569,5180.31,48787,434,261,47236,47165,47124,47128,46152
7581,10,588,7081,500,7081,500,5.53268e+17,143.242,1380.37,7581,124,123,3975,2847,2178,2292,769
49521,167,956,0,49521,10838,38683,4.7757e+15,492.613,3926.88,49521,320,222,46668,45846,43138,39906,14859
44257,404,1684,41261,2996,41261,2996,7.12999e+17,721.91,5140.11,44257,432,246,41033,39446,38143,38285,22039
44060,275,1659,7178,36882,0,44060,2.20166e+13,359.19,4995.43,44060,633,106,41946,41199,39057,27609,12547
23500,44,510,0,23500,6510,16990,1.62011e+16,205.108,1742.19,23500,139,111,22125,21577,18356,18864,5573
29106,770,2025,0,29106,0,29106,1.83729e+18,223.676,4636.17,29106,487,152,27081,27033,24603,16662,8862
37131,40,841,9020,28111,0,37131,2.64251e+13,234.681,3451.75,37131,336,145,31930,28956,27524,17036,5730
46619,46,48,0,46619,46453,166,2.62594e+16,31.826,737.99,46619,26,26,46571,46565,46569,46554,42535
5587,126,457,4209,1378,4209,1378,3.80943e+18,104.353,1010.67,5587,108,90,5122,5008,4503,4524,2048
41282,1090,2545,0,41282,0,41282,1.63144e+18,281.459,5983.43,41282,497,250,38737,38729,38067,32554,20786
25281,418,696,25217,64,25281,0,3.15714e+18,276.412,2669.6,25281,233,135,24585,24496,23600,23274,18581
47361,973,1920,47361,0,42551,4810,7.6374e+17,667.282,5825.8,47361,494,208,45419,44750,42793,37049,26326
47438,27,715,0,47438,10931,36507,7.35181e+15,235.355,3504.93,47438,280,141,39691,35874,32870,22570,7471
45247,10,90,0,45247,45131,116,2.09212e+16,29.3868,1018.52,45247,39,31,43482,41746,36615,39016,27290
34437,1097,1294,32222,2215,32222,2215,6.16954e+17,660.756,4068.66,34437,399,220,33143,33104,32926,32887,31411
1100,44,140,987,113,0,1100,3.75805e+18,36.1727,285.794,1100,43,37,960,884,881,865,375
26159,746,1002,0,26159,5971,20188,5.72414e+15,231.076,3014.64,26159,335,112,25157,25149,25021,25036,22060
21989,27,68,0,21989,21734,255,2.54098e+16,37.5274,701.723,21989,31,37,21887,21855,21062,19964,15897
11370,695,921,0,11370,0,11370,1.19816e+18,196.488,2109.94,11370,186,123,10449,10394,10350,10341,9693
45645,954,1875,39396,6249,39396,6249,3.99315e+18,399.229,5695.84,45645,346,239,43770,43715,38771,36198,27290
48136,2497,2641,0,48136,0,48136,1.68461e+18,284.794,6367.3,48136,511,248,45495,45495,45495,45495,44703
27556,494,821,6080,21476,0,27556,1.81519e+13,423.216,2860.77,27556,331,168,26656,26064,25817,24625,20344
45154,505,948,39745,5409,0,45154,3.84649e+18,344.319,4221.24,45154,328,212,44206,44192,42480,42913,26197
40533,665,856,30541,9992,30541,9992,7.01983e+18,374.349,2986.39,40533,236,176,39677,39640,39386,39301,36189
19240,1073,1088,17967,1273,17967,1273,2.01883e+18,476.733,2902.91,19240,300,175,18152,18152,18151,18152,18109
21784,439,818,16423,5361,16423,5361,3.8072e+18,287.433,2343.07,21784,181,160,20966,20758,20691,20711,15520
45404,24,85,0,45404,44632,772,2.04759e+16,23.4444,1076.68,45404,32,38,45302,45255,42711,42827,30996
21727,38,53,0,21727,21432,295,2.51723e+16,39.6346,600.777,21727,33,34,21652,21608,21009,21324,19129
49079,1632,2229,0,49079,11353,37726,7.81194e+15,249.022,5200.55,49079,445,309,46850,46844,44352,44509,33712
49211,991,1270,11413,37798,0,49211,2.54671e+13,239.813,4570.14,49211,403,156,47941,47938,47598,47701,37396
18211,258,901,16211,2000,16211,2000,3.41926e+18,210.158,2206.25,18211,114,152,17287,16939,15278,14091,5622
6207,583,594,6207,0,5467,740,1.17312e+18,164.573,1438.07,6207,147,87,5613,5613,5613,5613,5586
46223,1769,3017,41747,4476,41744,4479,1.33015e+18,485.143,7162.45,46223,684,265,43206,43003,42909,42930,27027
2645,61,411,2645,0,2450,195,7.6275e+17,64.2374,728.421,2645,119,42,2132,1991,1652,1041,602
27458,682,922,24533,2925,24533,2925,3.29072e+18,282.886,2737.35,27458,146,155,26536,26530,25781,25670,21480
41976,1003,2113,41976,0,37433,4543,9.08118e+17,424.521,5870.55,41976,551,183,39863,39685,38065,35198,18044
21897,812,914,3843,18054,0,21897,1.89121e+13,192.768,2673.65,21897,289,101,20983,20983,20867,20968,19727
37865,826,1602,37865,0,34007,3858,7.47258e+17,526.792,4884.94,37865,437,189,36263,35878,34091,29504,22807
10026,404,988,0,10026,0,10026,2.00212e+18,163.135,2067.48,10026,196,99,9038,8914,8467,8523,5775
15863,49,681,11964,3899,11964,3899,3.79618e+18,293.456,1943.76,15863,163,140,13632,9372,9322,9650,858
35447,655,2081,35447,0,31278,4169,9.78137e+17,551.461,5139.07,35447,452,272,33093,31253,29135,25583,4112
15694,24,487,15694,0,15694,0,3.30405e+18,195.714,1636.08,15694,144,115,10230,5847,6165,5679,1231
11601,115,389,11601,0,11601,0,4.81081e+18,162.771,1387.53,11601,127,103,10978,10552,8411,7767,6611
46505,118,886,35011,11494,35011,11494,3.81807e+18,411.332,3368.93,46505,252,190,43446,42204,32981,34603,7615
15706,1,10,15618,88,15706,0,1.03371e+14,8.66943,246.011,15706,10,10,8223,8223,8223,8223,8223
37015,25,34,0,37015,35262,1753,2.4595e+16,30.8261,630.897,37015,30,30,36926,36814,35367,35452,31296
32297,328,665,32233,64,32297,0,3.03763e+18,349.764,2949.95,32297,237,149,31450,30931,28884,27752,19523
46103,632,1781,42265,3838,42265,3838,2.52283e+18,633.688,5501.38,46103,421,274,44021,42676,40784,38448,16215
13907,190,360,0,13907,3633,10274,3.30132e+15,207.042,1534.09,13907,187,101,13358,12497,12675,12663,11953
6904,509,612,6424,480,6424,480,2.16898e+18,143.191,1369.93,6904,170,84,6292,6292,6262,6263,6111
20008,1272,1304,18457,1551,18457,1551,2.43589e+18,259.305,3268.27,20008,404,101,18704,18704,18704,18704,18551
29635,39,72,0,29635,29419,216,2.17377e+16,20.8495,773.463,29635,27,34,29563,29559,29182,29401,23002
12247,295,571,12247,0,9233,3014,8.50859e+17,260.953,1604.07,12247,149,122,11595,11174,10890,10063,6628
15419,6,32,0,15419,15361,58,2.80585e+16,15.8385,409.208,15419,20,20,15264,15220,12814,14067,10145
45219,1928,2054,40626,4593,40626,4593,1.44777e+18,531.902,5661.19,45219,442,178,43165,43149,43157,43156,42742
25524,130,2084,0,25524,5659,19865,1.65289e+15,270.137,3841.36,25524,325,107,22399,20197,16502,14571,2980
21155,28,48,0,21155,21079,76,2.58393e+16,18.8251,506.41,21155,22,23,21107,21094,20949,21072,19502
21884,7,13,21722,162,21884,0,9.55401e+13,12.0789,292.377,21884,12,11,21847,21841,20847,20845,19473
14350,6,9,14307,43,6909,7441,5.68248e+13,8.57143,260.866,14350,8,9,14305,14268,13090,13103,12743
12994,472,705,11505,1489,11505,1489,1.65558e+18,336.815,2191.4,12994,207,139,12289,11932,11880,11886,8591
25325,335,698,19110,6215,0,25325,8.26986e+18,334.117,2283.44,25325,188,153,24525,23460,23583,23531,13900
26390,64,469,26390,0,26390,0,4.95395e+18,290.18,2233.54,26390,191,156,23325,20323,14721,12928,7287
6930,1,14,6880,50,6930,0,8.72047e+13,7.15873,173.351,6930,10,9,3887,3887,3887,3887,3887
48864,1224,1907,9639,39225,0,48864,2.64662e+13,378.585,5543.96,48864,545,189,46957,46741,46499,46711,37439
8918,199,371,8918,0,8918,0,5.07173e+18,153.624,1245.61,8918,134,91,8528,8354,7307,7050,5947
20543,1649,1655,0,20543,0,20543,3.98465e+18,204.909,3400.8,20543,276,176,18888,18888,18888,18888,18882
19634,1076,1290,16932,2702,0,19634,7.88639e+18,14.8731,2604.86,19634,644,17,18344,18344,18132,17988,15952
18006,16,86,0,18006,17814,192,1.98853e+16,23.5393,688.858,18006,36,30,17842,17774,16539,16791,11714
19654,841,1255,17868,1786,17868,1786,2.81988e+18,252.228,2975.19,19654,470,133,18399,18384,17890,17598,14526
3273,9,193,883,2390,0,3273,2.20167e+13,52.1445,532.906,3273,168,35,2614,2336,2261,1563,414
36775,41,51,0,36775,36065,710,2.70596e+16,32.4701,615.258,36775,33,28,36716,36679,36620,36623,33111
29799,137,1548,0,29799,8011,21788,1.50191e+16,180.074,3506.1,29799,261,157,27966,27274,24084,20827,10701
21042,432,496,20594,448,21042,0,4.42016e+18,255.739,2113.43,21042,245,101,20546,20534,20108,20061,19624
31949,1494,2402,31949,0,31939,10,2.61738e+18,29.895,4550.68,31949,426,30,29547,29547,29547,29547,26824
34408,760,1769,7083,27325,0,34408,2.37565e+13,221.724,4428.03,34408,413,188,32639,32565,31940,32300,17606
45206,151,587,45206,0,45206,0,3.24807e+18,331.653,2840.34,45206,223,157,43418,42250,32410,31408,14429
7610,615,735,6771,839,6771,839,3.47366e+18,248.914,1417.98,7610,223,75,6875,6650,6697,6648,6522
25144,388,1130,23458,1686,0,25144,2.44595e+18,519.294,3249.72,25144,348,183,23580,22977,22434,22468,16273
31879,741,793,0,31879,6987,24892,4.59761e+15,403.339,2976.65,31879,286,178,31086,31086,31032,31054,30681
19491,449,1024,19491,0,14784,4707,8.32741e+17,246.776,2773.43,19491,181,181,18467,18339,17014,15604,6188
20637,580,800,18168,2469,18168,2469,1.71792e+18,343.733,2832.35,20637,242,166,19837,19813,19549,19440,16099
24629,401,808,0,24629,5328,19301,4.75447e+15,389.888,2725.9,24629,296,174,23649,23055,22736,21964,15605
42806,1368,1918,42806,0,38323,4483,7.87949e+17,498.76,5432.62,42806,434,176,40888,40764,40503,40482,33091
25543,196,442,25543,0,25543,0,5.12064e+18,252.456,2107.82,25543,179,136,24857,24281,19872,19155,16248
1878,1,5,1871,7,1878,0,3.6271e+13,4.94782,82.0959,1878,5,5,908,908,908,908,908
28303,844,1104,25026,3277,25026,3277,2.85506e+18,321.307,3668.09,28303,322,171,27199,27176,26870,26763,22546
48310,33,896,36406,11904,36406,11904,7.02163e+18,395.057,3295.59,48310,265,176,37627,21253,24800,20654,3987
36461,1135,1826,8492,27969,0,36461,3.06314e+13,221.836,4078.59,36461,392,268,34635,34635,31102,32508,18112
31940,270,464,31940,0,31940,0,5.23008e+18,295.595,2406.4,31940,196,148,31300,30875,27480,26032,21938
16585,333,670,0,16585,4116,12469,8.38915e+15,211.196,1611.65,16585,85,183,15915,15561,14721,14859,9655
24969,332,1577,24969,0,22508,2461,7.80029e+17,380.269,3991.89,24969,427,154,22944,20492,19279,12252,10319
43099,957,1326,40214,2885,0,43099,2.42444e+18,672.207,4505.33,43099,444,227,41773,41212,40759,40524,36507
37440,1615,2796,0,37440,262,37178,1.31064e+14,16.6452,5207.45,37440,411,24,34644,34644,33437,24351,22537
34366,239,926,8258,26108,0,34366,2.93511e+13,234.578,3266.65,34366,254,124,33065,32091,29820,30244,16287
46739,9,14,46105,634,43995,2744,8.0512e+13,6.58431,424.895,46739,9,10,46725,46724,44228,44227,43301
34472,626,864,25993,8479,25993,8479,7.00286e+18,337.086,2797.31,34472,220,182,33608,33586,33314,33245,30687
35294,64,70,0,35294,35043,251,2.5692e+16,53.1653,849.453,35294,40,38,35224,35220,34909,34886,34559
48597,25,46,0,48597,48243,354,2.55909e+16,39.6421,760.099,48597,35,36,48427,48269,47335,47985,40635
850,192,255,676,174,0,850,5.8267e+18,36.34,371.345,850,78,42,595,594,595,595,487
11137,588,614,9842,1295,9842,1295,3.62066e+18,204.397,1437.34,11137,91,148,10523,10519,10509,10504,10332
12710,150,449,0,12710,0,12710,1.59362e+18,342.418,1813.8,12710,253,117,10871,9714,9781,9623,6621
35540,52,55,0,35540,35326,214,2.63982e+16,25.027,658.837,35540,25,27,35485,35485,35481,35483,35332
18875,10,11,17966,909,18875,0,9.63658e+13,10.3007,307.532,18875,11,11,18858,18851,18490,18490,18855
32638,418,1841,30236,2402,30236,2402,2.3089e+18,381.597,4777.08,32638,516,142,30506,29759,28607,26849,8155
12574,2,35,0,12574,12558,16,2.05732e+16,10.8934,381.195,12574,15,17,10775,10199,8961,9817,7838
35592,286,812,31309,4283,0,35592,3.85063e+18,345.977,3604.25,35592,290,195,34270,33271,29717,29725,13906
8703,350,468,6284,2419,8703,0,4.62455e+18,163.825,1300.48,8703,175,96,8235,8178,7503,7509,7416
41275,328,1563,0,41275,10468,30807,7.41919e+15,208.821,3809.3,41275,355,148,39712,39305,34144,35433,11324
34535,1006,1274,32200,2335,32200,2335,2.06858e+18,665.111,4084.34,34535,391,226,33261,33192,32787,32747,30246
7924,479,721,5826,2098,0,7924,6.45414e+18,21.9096,1080.79,7924,249,243,7203,7203,5548,5421,6892
11517,10,13,11422,95,11517,0,1.00644e+14,9.65477,209.331,11517,10,10,11501,11497,11152,11151,10711
43444,620,1922,40564,2880,40564,2880,2.05442e+18,568.172,5585.85,43444,420,264,41305,39676,39249,37973,18096
1932,1,17,0,1932,1931,1,2.97629e+16,13.1273,111.416,1932,16,11,900,900,900,900,900
30529,900,1614,28447,2082,0,30529,2.51032e+18,424.237,4277.65,30529,366,241,28915,28746,27870,27693,16050
15547,792,1196,0,15547,0,15547,3.32472e+18,163.991,2807.94,15547,193,146,14351,14347,13923,12601,9432
16091,161,1022,15085,1006,15085,1006,1.92911e+18,269.014,2493.05,16091,250,130,14704,13805,13427,13182,6305
13217,66,706,13217,0,11828,1389,1.78588e+18,221.522,1824.37,13217,125,133,11364,10649,8217,3790,1898
14400,338,699,12750,1650,12750,1650,1.67021e+18,376.55,2291.09,14400,217,151,13468,13023,12714,12671,6531
32061,1,10,31931,130,31997,64,1.04141e+14,7.43102,331.681,32061,9,10,17426,17426,17426,17426,17426
11780,19,43,0,11780,11693,87,2.54098e+16,29.3292,367.186,11780,24,24,11709,11674,11174,11411,9522
24272,427,670,0,24272,5343,18929,4.9873e+15,302.857,2332.85,24272,223,141,23602,23207,23013,23097,20302
43585,1412,2364,35711,7874,35617,7968,2.90829e+18,361.488,5828.73,43585,528,263,41221,41214,40389,40889,23922
44145,1680,3282,0,44145,0,44145,1.07593e+18,201.806,6983.1,44145,995,254,40863,40863,36755,21896,21165
16729,446,816,0,16729,3465,13264,5.52419e+15,205.412,2316.64,16729,357,90,15913,15794,15232,15491,10036
46489,184,1037,0,46489,10181,36308,4.68329e+15,460.37,3935.28,46489,327,198,44110,43028,41306,36647,18551
7304,162,282,7304,0,7304,0,4.91872e+18,126.579,1002.32,7304,108,92,7002,6914,6316,6221,5563
41671,1564,2575,38743,2928,38743,2928,1.21209e+18,719.276,5917.67,41671,929,158,39096,38456,36248,37258,28172
38494,642,2658,31249,7245,31249,7245,6.46693e+18,14.8564,4929.16,38494,1241,26,35836,35836,25715,12383,12728
10771,930,950,0,10771,0,10771,1.12607e+18,192.183,2088.58,10771,184,133,9821,9805,9820,9820,9682
762,17,18,0,762,761,1,2.818e+16,5.66667,67.1349,762,10,8,744,740,743,743,636
49707,1201,1704,44031,5676,44031,5676,1.58363e+18,411.266,5778.51,49707,386,222,48003,48003,47004,47447,37067
47773,259,710,11027,36746,0,47773,2.89467e+13,233.699,3512.58,47773,274,154,47020,46192,44040,45313,21326
3149,7,21,0,3149,3068,81,2.54685e+16,4.79835,157.905,3149,9,9,3128,3126,3081,2999,2729
26599,316,355,26599,0,26599,0,3.7904e+18,243.65,1995.4,26599,150,153,26244,26224,26181,26182,25828
24432,339,363,24432,0,24432,0,3.53673e+18,246.242,1835.49,24432,132,196,24069,24065,24044,24043,23910
38712,433,649,38712,0,38712,0,4.37931e+18,329.512,3192.25,38712,215,137,38050,38002,36489,35940,33431
30468,282,541,6955,23513,0,30468,2.8566e+13,218.192,2599.28,30468,230,124,29927,29438,29043,29529,18935
39690,1517,2493,39690,0,36036,3654,1.22363e+18,363.203,6161.67,39690,503,285,37197,37140,35885,35233,25055
30100,25,605,28700,1400,28700,1400,1.47508e+18,412.982,2865.05,30100,244,179,21637,16019,16876,17263,2788
4936,487,740,4575,361,0,4936,2.639e+18,109.147,1421.4,4936,161,117,4196,4186,4158,4142,2451
5205,119,315,0,5205,1153,4052,7.44943e+15,91.6978,940.303,5205,139,72,4888,4769,4633,4520,3313
10259,458,482,9199,1060,0,10259,3.77631e+18,218.429,1351.46,10259,100,114,9777,9772,9757,9759,9570
44042,29,1458,41145,2897,41145,2897,2.05453e+18,681.186,4721.9,44042,407,224,30749,24885,22658,23248,5185
49224,262,1585,11884,37340,0,49224,2.86277e+13,386.857,4886.69,49224,580,182,46442,45084,39244,6064,7136
40341,715,869,0,40341,0,40341,4.12057e+18,350.621,2986.83,40341,226,179,39472,39468,39295,39271,36483
32704,3,7,32630,74,32704,0,8.28058e+13,6.96841,353.854,32704,7,7,31263,30942,26224,26555,25143
49083,1938,2504,44072,5011,44072,5011,3.17976e+18,314.451,6145.56,49083,496,326,46579,46579,43774,43044,32611
7172,250,616,0,7172,0,7172,2.06651e+18,100.47,1255.49,7172,98,98,6556,6464,6250,3745,3676
32799,1704,2248,0,32799,0,32799,1.45813e+18,301.597,5173.45,32799,488,232,30551,30551,30359,30536,23866
7833,509,566,1671,6162,0,7833,1.88304e+13,93.772,1407.62,7833,146,120,7267,7265,7258,7249,6840
39496,410,1726,0,39496,0,39496,2.15251e+18,339.233,3990.22,39496,286,303,37666,36721,31154,29544,3001
47811,1527,1580,44664,3147,44664,3147,6.6876e+17,762.718,5220.47,47811,423,271,46231,46231,46231,46231,45875
48650,916,1883,0,48650,0,48650,1.80933e+18,306.985,5156.33,48650,524,195,46767,46755,42046,39976,20966
40432,4,12,39865,567,37969,2463,7.95723e+13,6.89857,408.455,40432,9,8,39692,39281,35423,35436,33012
9725,268,505,2149,7576,0,9725,1.95361e+13,209.694,1381.51,9725,134,114,9220,9059,8870,8643,6400
22610,411,1372,21216,1394,21216,1394,1.92914e+18,417.258,3517.37,22610,317,156,21089,20440,20069,19555,11452
48263,2369,2566,44853,3410,0,48263,2.65107e+18,512.44,6340.42,48263,778,145,45697,45697,45600,45604,44446
36243,232,420,36243,0,36243,0,4.22723e+18,255.299,2625.64,36243,260,157,35674,35242,30145,29776,22519
21149,6,491,21149,0,21149,0,3.47965e+18,291.344,2284.6,21149,188,153,10569,6880,6009,3786,1410
28120,1388,1935,0,28120,0,28120,1.41708e+18,358.547,4381.16,28120,692,141,26185,26081,25714,25991,23215
32410,447,625,32410,0,31021,1389,4.9675e+17,447.976,3070.1,32410,262,175,31649,31155,29717,25504,30946
29029,216,535,0,29029,8071,20958,1.61425e+16,228.38,1954.14,29029,153,113,28384,27665,26939,26728,15084
41588,855,1288,0,41588,0,41588,1.20783e+18,705.299,4387.95,41588,368,237,40275,38809,38937,35654,31583
32586,710,1460,0,32586,0,32586,1.58229e+18,485.761,4230.71,32586,430,175,31126,30692,29084,24396,16472
21700,275,686,0,21700,0,21700,1.84757e+18,333.047,2674.82,21700,241,158,20684,20029,17569,16941,8112
38610,10,11,38114,496,32390,6220,7.83699e+13,7.30142,438.221,38610,9,9,38599,38599,38598,38598,37964
28842,1690,1946,25648,3194,0,28842,4.05184e+18,244.511,4082.88,28842,413,248,26896,26896,26441,26352,23625
10815,19,45,0,10815,10811,4,2.19937e+16,10.3106,354.431,10815,19,18,10770,10763,10554,10644,8123
32485,401,1021,0,32485,0,32485,1.72878e+18,336.732,3888.3,32485,368,175,31429,30102,27555,24185,17755
22994,285,662,17303,5691,0,22994,8.34865e+18,298.538,2130.51,22994,182,138,22173,21282,21043,21060,12547
48747,255,1481,48747,0,45571,3176,9.56604e+17,786.953,5025.18,48747,437,253,44662,43318,37643,35086,20442
19338,6,13,19213,125,19338,0,1.00855e+14,9.47937,273.828,19338,10,10,19280,19246,18353,18287,13992
36994,1025,1832,0,36994,0,36994,2.14967e+18,347.735,5162.49,36994,354,206,35162,35117,32914,27145,23759
15603,180,489,15603,0,15603,0,3.37621e+18,261.621,1904.12,15603,164,124,14500,13418,12569,10683,6789
24406,762,4666,24406,0,24406,0,3.57876e+18,16.9761,5195.25,24406,596,25,19740,19740,17095,19531,3697
27863,1247,1407,24483,3380,24483,3380,3.76383e+18,305.317,3076.48,27863,262,275,26456,26456,26238,26155,24205
19525,1046,1290,17095,2430,17095,2430,3.85434e+18,227.433,2571.62,19525,274,219,18235,18235,17740,17617,14735
40319,702,1613,0,40319,0,40319,1.91914e+18,350.149,4769.33,40319,305,183,38706,38670,37362,37193,30315
7594,39,41,0,7594,7536,58,2.58095e+16,20.7264,336.637,7594,26,22,7553,7553,7552,7553,7505
6953,343,511,0,6953,0,6953,2.14353e+18,126.526,1076.76,6953,83,101,6442,6377,6327,5904,5343
29983,1352,2190,27066,2917,27066,2917,1.54393e+18,306.79,4829.42,29983,312,275,27793,27724,26952,26913,19882
29871,2089,2228,29871,0,27190,2681,1.11182e+18,399.883,5248.99,29871,439,244,27643,27643,27643,27643,25839
20938,182,1317,19268,1670,19268,1670,2.50992e+18,395.819,3365.77,20938,426,131,18815,18311,17207,15968,3380
28893,821,1579,25825,3068,25825,3068,1.41205e+18,412.337,4306.19,28893,435,165,27314,27106,25687,25840,18403
6886,233,601,6886,0,5442,1444,7.21627e+17,112.594,1415.29,6886,170,103,6285,6256,5325,5243,1361
39930,76,629,9228,30702,0,39930,2.87946e+13,224.704,3110.43,39930,252,147,37442,33843,31122,17118,9563
15046,451,912,3107,11939,0,15046,2.35911e+13,101.096,2275.01,15046,328,69,14134,14118,13722,13422,7722
31009,1,14,30837,172,31009,0,9.32412e+13,10.5178,355.317,31009,12,11,17471,17471,17471,17471,17471
8933,278,554,8933,0,7897,1036,7.3899e+17,358.813,1663.02,8933,248,124,7889,6863,6899,5608,3677
16548,651,1003,0,16548,0,16548,1.18607e+18,278.662,2510.64,16548,243,150,15545,15345,15200,15195,12559
36753,98,504,36753,0,36753,0,4.22551e+18,259.585,2736.82,36753,175,188,34586,32769,22238,20121,11994
38198,183,1391,38198,0,35643,2555,9.65937e+17,699.975,4414.67,38198,422,230,34392,32829,27876,26031,14578
25195,310,316,25195,0,25195,0,4.93455e+18,218.476,1877.01,25195,184,131,24879,24879,24868,24870,24849
7510,9,11,7184,326,7510,0,9.47502e+13,10.0073,193.402,7510,10,11,7495,7491,7288,7289,7493
728,175,200,686,42,686,42,1.7531e+18,26.3393,303.232,728,40,38,528,527,527,527,447
31852,294,556,30748,1104,31852,0,4.13163e+18,270.207,2759.59,31852,254,133,31246,30937,25189,25211,19032
8997,390,713,8381,616,8381,616,5.99962e+17,178.119,1640.11,8997,150,128,8284,8174,8095,8066,6853
14864,4,9,14818,46,6982,7882,5.78707e+13,8.67848,266.201,14864,9,9,14742,14700,13128,13165,9467
9518,190,376,9518,0,9518,0,3.1835e+18,146.366,1166.56,9518,116,94,9123,8983,7943,7824,5900
15908,435,1151,14903,1005,14903,1005,1.97646e+18,285.407,2815.45,15908,252,132,14725,14388,14136,13917,8893
1724,113,161,0,1724,0,1724,2.00128e+18,101.746,445.169,1724,73,54,1510,1288,1435,1466,1261
38963,1711,2537,32771,6192,32771,6192,6.0792e+18,14.8867,4911.79,38963,1268,17,36426,36426,35158,29265,26203
24163,575,710,0,24163,0,24163,1.8742e+18,328.488,2863.4,24163,260,174,23453,23453,23263,23376,20158
48957,593,1876,12147,36810,0,48957,2.95792e+13,225.828,4462.58,48957,416,162,47081,46991,40887,42077,15645
14855,510,590,13304,1551,13304,1551,8.88767e+17,255.479,1762.3,14855,120,136,14265,14259,14220,14248,13327
29596,84,1041,0,29596,0,29596,1.81841e+18,299.884,3673.32,29596,373,173,24898,21332,20568,5890,4017
40192,291,518,40192,0,40192,0,5.09048e+18,306.022,2754.3,40192,215,166,39492,38979,36151,34251,31160
42189,1105,1917,8597,33592,0,42189,2.57402e+13,269.108,5091.84,42189,547,177,40272,40252,38325,38868,30293
2015,18,19,0,2015,1944,71,2.36379e+16,11.4218,124.178,2015,14,13,1996,1996,1996,1996,1995
48279,1508,1783,48279,0,45088,3191,9.33426e+17,734.739,5680.24,48279,404,279,46496,46490,46195,46310,44312
45978,1473,2592,41716,4262,41716,4262,2.79975e+18,276.717,6225.02,45978,503,256,43386,43385,43035,42965,30195
16998,4,7,16960,38,16998,0,8.27637e+13,6.97453,255.535,16998,7,7,16536,16296,14214,14219,13541
45935,315,951,40373,5562,40373,5562,3.25466e+18,347.665,4275.46,45935,318,202,44501,43189,39583,37850,17444
32223,712,1414,0,32223,0,32223,1.54345e+18,363.006,4325.19,32223,410,176,30809,30598,27933,27187,15801
6803,321,326,0,6803,1773,5030,7.4563e+15,115.612,873.629,6803,68,88,6477,6477,6477,6474,6447
25945,408,470,25945,0,25945,0,3.20697e+18,260.952,2061.38,25945,165,130,25475,25466,25157,24947,24292
5828,306,388,752,5076,0,5828,5.45135e+13,11.8495,817.694,5828,197,12,5440,5440,5358,4618,4749
48629,347,1879,43928,4701,43928,4701,1.36917e+18,713.56,5840.12,48629,567,182,45175,40194,36197,38523,11905
4863,69,417,4863,0,4353,510,1.73756e+18,170.968,978.917,4863,88,95,4087,3853,3027,1153,649
866,47,220,866,0,804,62,6.60359e+17,35.948,347.429,866,52,30,634,612,488,575,209
40172,1204,2547,40172,0,36082,4090,1.76773e+18,412.591,6117.51,40172,405,229,37625,37452,35156,36227,25976
8856,355,380,8856,0,8856,0,5.10838e+18,144.498,1246.89,8856,127,100,8476,8466,8459,8457,8278
3054,79,433,2683,371,0,3054,4.5168e+18,130.448,797.197,3054,103,62,2513,2267,2255,2352,822
24727,823,1026,21877,2850,0,24727,4.21648e+18,306.554,2563.68,24727,129,241,23701,23693,23624,23628,22150
44097,343,1326,41100,2997,41100,2997,2.07985e+18,663.989,4564.88,44097,383,246,41124,39575,38069,37494,18376
46848,62,574,45498,1350,46848,0,3.9819e+18,303.283,3144.6,46848,223,176,41859,39059,24039,22084,7527
40728,15,37,0,40728,38822,1906,2.46386e+16,28.8216,669.634,40728,30,29,40442,40151,34986,37438,29820
6109,634,700,5706,403,0,6109,2.42641e+18,109.038,1469.64,6109,150,133,5409,5409,5400,5399,5160
38532,7,13,38272,260,38532,0,1.01495e+14,11.6502,387.133,38532,13,11,38490,38479,36859,36856,33821
32944,406,1337,0,32944,8365,24579,7.64632e+15,213.108,3197.2,32944,216,149,31607,31487,29276,28903,18977
43660,1043,1057,9633,34027,0,43660,2.23454e+13,420.703,3997.49,43660,449,146,42603,42603,42602,42599,42335
10529,566,960,9825,704,9825,704,6.45878e+17,216.851,2112.04,10529,187,148,9569,9371,9303,9283,7906
12984,1,9,12946,38,7151,5833,6.41689e+13,7.00416,254.3,12984,9,9,6465,6465,6465,6465,6465
12157,866,919,11119,1038,11119,1038,2.19068e+18,264.678,2323.18,12157,363,104,11238,11238,11238,11238,10924
2406,403,457,2176,230,2176,230,1.52801e+18,130.007,831.607,2406,124,80,1949,1922,1949,1866,1789
17874,10,34,0,17874,17018,856,2.46241e+16,28.9241,437.7,17874,26,25,17470,17021,13786,15659,10860
31642,83,84,0,31642,31131,511,2.49226e+16,39.939,931.673,31642,39,37,31558,31558,31558,31558,31284
40511,6,491,40511,0,40511,0,5.10597e+18,322.601,2765.6,40511,207,167,21085,14739,11728,8962,4081
6187,268,324,0,6187,1414,4773,7.35044e+15,92.4469,1025.47,6187,150,75,5863,5852,5820,5857,4889
49968,1071,1400,11135,38833,0,49968,1.80009e+13,452.877,4709.09,49968,421,208,48568,48522,48357,48326,45107
44538,748,2728,44538,0,40286,4252,1.44553e+18,304.396,6419.33,44538,431,293,41810,41484,38710,33272,24056
45501,92,397,45495,6,45501,0,4.13646e+18,314.544,3033.78,45501,248,164,41225,37148,27415,25980,12858
13689,701,985,10584,3105,10581,3108,3.47519e+18,187.733,2435.74,13689,212,172,12704,12703,12609,12605,8226
13100,879,1299,13100,0,12072,1028,4.13958e+18,166.264,2486.2,13100,350,129,11801,11736,9570,10629,8766
45425,1,13,45086,339,45425,0,9.915e+13,11.5726,416.071,45425,13,13,25269,25269,25269,25269,25269
24229,41,892,0,24229,0,24229,1.29196e+18,445.846,2813.77,24229,276,165,17889,13513,13995,13238,3737
4396,1,7,4391,5,4396,0,8.34311e+13,6.8146,129.62,4396,7,7,2519,2519,2519,2519,2519
4691,228,351,4691,0,4691,0,4.93635e+18,119.691,931.481,4691,102,73,4340,4268,4237,4092,3934
24636,3,12,24261,375,24636,0,8.58731e+13,6.06235,313.166,24636,8,9,23865,23633,21593,22203,17539
39942,891,2852,39942,0,36947,2995,3.40006e+18,481.801,6160.11,39942,797,175,37090,36223,28135,33622,16564
2655,5,13,0,2655,2640,15,2.01381e+16,3.90169,120.55,2655,7,8,2642,2640,2575,2639,2273
18445,126,802,18445,0,16223,2222,1.17936e+18,363.418,2707.06,18445,239,149,16077,12971,12785,7274,3792
8403,219,715,0,8403,1545,6858,6.74044e+15,77.8092,1607.59,8403,227,63,7688,7592,7255,5015,3732
8477,8,9,8443,34,3382,5095,5.36588e+13,6.75369,190.283,8477,8,7,8468,8468,8467,8468,8467
36176,1502,1597,32454,3722,32454,3722,1.37701e+18,467.054,4757.02,36176,443,186,34579,34564,34543,34542,34120
17185,14,1080,17185,0,16043,1142,9.73137e+17,466.613,2795.78,17185,263,175,10155,7771,5777,3985,1577
26138,139,1677,23410,2728,23410,2728,1.52665e+18,335.382,4096.17,26138,362,169,22090,19967,17231,19405,6670
29327,1,9,29265,62,20325,9002,7.08896e+13,8.57578,385.577,29327,9,9,15729,15729,15729,15729,15729
3207,232,260,0,3207,0,3207,2.14536e+18,58.41,582.896,3207,60,61,2947,2947,2935,2935,2813
32331,658,763,0,32331,8339,23992,6.75801e+15,375.049,2935.93,32331,471,108,31568,31435,31339,31383,27992
17262,723,839,16062,1200,16062,1200,6.02442e+17,367.727,2358.99,17262,237,164,16423,16420,16333,16347,15813
44358,66,79,0,44358,44080,278,2.20114e+16,29.4305,999.099,44358,32,36,44279,44270,44247,44173,38556
3626,14,253,0,3626,998,2628,1.60575e+16,47.6111,592.811,3626,53,58,2817,2326,2439,2152,501
9348,21,33,0,9348,9328,20,2.12289e+16,24.8787,322.815,9348,25,27,9280,9206,8367,8789,8590
13823,311,962,0,13823,0,13823,1.14633e+18,232.166,2302.84,13823,229,132,12763,12572,12122,11431,8291
5294,114,319,0,5294,1371,3923,7.47205e+15,102.832,772.884,5294,65,86,4933,4721,4472,4540,2349
46616,670,754,10526,36090,0,46616,2.83306e+13,243.861,3531.34,46616,289,142,45862,45862,45752,45836,43277
27174,1208,1467,24453,2721,24453,2721,1.43813e+18,428.25,4024.04,27174,430,165,25707,25638,25587,25701,24116
7954,305,682,7414,540,0,7954,2.48485e+18,152.551,1519,7954,148,101,7272,7135,7078,7042,5858
30640,295,982,30640,0,26963,3677,1.1712e+18,408.732,3701.5,30640,272,183,28898,27810,26552,20815,11174
36699,172,1866,32709,3990,32709,3990,9.64277e+17,272.618,4448.69,36699,286,222,33686,30785,30549,29362,7924
23408,413,1163,21884,1524,0,23408,2.36491e+18,570.775,3328.2,23408,354,197,21655,20778,20403,20408,12365
24559,7,11,24462,97,17993,6566,6.99821e+13,7.05143,356.338,24559,9,9,24527,24467,23330,23383,21647
29450,732,1211,7019,22431,0,29450,3.33954e+13,238.026,3758.46,29450,300,171,28239,28229,27412,24370,20032
24635,766,1460,24635,0,22206,2429,1.23772e+18,267.21,3597.05,24635,524,132,23175,23132,21349,22517,13226
43114,44,63,0,43114,42793,321,2.62064e+16,50.4162,913.641,43114,41,42,43004,42907,41438,41436,35860
32716,1222,1471,28780,3936,28780,3936,1.77361e+18,349.44,4343.84,32716,338,173,31245,31245,31196,31218,28937
16186,415,1289,14490,1696,14488,1698,1.39042e+18,156.571,2722.51,16186,370,135,14897,14656,14457,14637,8395
31955,5,10,31722,233,31955,0,1.00258e+14,9.45448,349.644,31955,10,10,31715,31607,29437,30109,24849
24504,566,1063,21608,2896,0,24504,4.30785e+18,303.469,2602.55,24504,117,267,23441,23348,21290,21137,12023
36374,123,331,36365,9,36374,0,2.50717e+18,237.406,2052.37,36374,172,91,35560,35108,34099,34089,14861
44068,32,64,0,44068,43447,621,2.4918e+16,43.4767,946.121,44068,39,42,43922,43823,42427,42089,34370
18791,112,764,3141,15650,0,18791,1.96249e+13,205.253,2253.11,18791,254,101,17564,16930,16299,16556,5781
39099,102,726,10899,28200,0,39099,6.28059e+13,256.046,2476.99,39099,164,144,37545,36741,31640,20755,11004
3204,339,401,0,3204,819,2385,7.79362e+15,45.0655,682.563,3204,118,50,2803,2799,2756,2803,2598
23617,716,776,0,23617,5394,18223,5.77579e+15,215.593,2629.8,23617,308,111,22841,22825,22824,22837,22222
42345,53,1932,37989,4356,37986,4359,1.05839e+18,279.513,4757.38,42345,422,181,36125,34129,28879,30251,3210
13140,1117,1365,12214,926,12213,927,8.30888e+17,255.538,2918.99,13140,277,137,11775,11775,11772,11772,11417
3407,69,289,3011,396,3011,396,3.61927e+18,58.5991,620.048,3407,61,62,3112,3024,2749,2328,782
32708,456,623,32708,0,32708,0,4.05131e+18,267.862,2917.69,32708,206,170,32085,32025,30296,29528,24874
41452,55,691,0,41452,9414,32038,7.28854e+15,241.702,3250.83,41452,264,138,37399,33532,31188,27713,6409
36099,1,49,0,36099,35958,141,2.52209e+16,33.5007,662.595,36099,25,26,15363,15363,15363,15363,15363
31559,367,6022,4508,27051,0,31559,7.02799e+12,9.99144,6481.84,31559,763,18,25537,25537,19885,10630,7176
15948,237,344,15948,0,15948,0,4.74899e+18,210.341,1559.29,15948,147,117,15578,15422,14718,14536,13600
43790,2058,2456,43790,0,39886,3904,1.05596e+18,366.317,6340.87,43790,769,154,41334,41334,41334,41190,35643
1106,4,6,0,1106,1106,0,2.30637e+16,4.05606,64.6628,1106,5,5,1099,1098,1098,1098,1074
47347,35,62,0,47347,47027,320,2.61037e+16,47.4568,947.839,47347,41,43,47203,47103,45557,45680,39185
37282,140,1356,34851,2431,0,37282,2.40305e+18,550.332,4287.74,37282,346,227,33852,31511,29046,29136,11404
26189,938,1118,24485,1704,24485,1704,2.02093e+18,540.853,3342.58,26189,320,186,25071,24907,24836,24847,23334
11274,62,863,10512,762,10512,762,1.17577e+18,301.723,1994.53,11274,306,94,9250,8276,6367,7879,1702
44926,2394,2923,39106,5820,0,44926,7.85259e+18,14.8891,5633.64,44926,1460,17,42003,42003,41476,41431,35996
32091,714,736,24185,7906,24185,7906,7.0029e+18,328.504,2530.23,32091,196,162,31355,31355,31354,31354,31242
47715,817,836,47711,4,47715,0,4.23579e+18,351.082,3900.55,47715,245,144,46879,46879,46860,46872,46784
35344,190,964,35344,0,26619,8725,8.11636e+17,350.053,3068.7,35344,219,169,33392,32257,28278,27532,9942
38400,476,1416,34221,4179,0,38400,3.08564e+18,374.776,4678.24,38400,413,208,36984,36520,33105,33339,19650
25677,364,503,0,25677,5802,19875,7.33427e+15,231.818,2342.14,25677,219,125,25174,25168,24957,25082,20693
32742,4,11,31230,1512,32742,0,9.6207e+13,10.5778,404.082,32742,11,11,30908,30342,27937,25157,19240
13938,215,359,13938,0,13938,0,3.64893e+18,203.122,1429,13938,103,143,13541,13337,11932,12139,9253
29726,745,1425,29726,0,27797,1929,9.53386e+17,510.829,4052.75,29726,329,229,28286,27580,25980,26152,20937
42917,944,1027,9415,33502,0,42917,1.81869e+13,422.574,3799.29,42917,331,221,41890,41859,41842,41836,41082
10865,423,532,8195,2670,8195,2670,6.99007e+18,208.414,1394.28,10865,126,101,10333,10321,10264,10248,8950
15902,212,420,15902,0,15902,0,3.28034e+18,241.911,1600.07,15902,144,111,15348,14930,13301,13089,8983
5064,364,398,1082,3982,0,5064,2.00095e+13,91.9506,945.182,5064,104,82,4666,4664,4665,4660,4564
14363,49,63,0,14363,14274,89,2.64641e+16,24.0926,510.009,14363,31,30,14300,14288,13902,14063,13431
8312,218,378,8312,0,8312,0,3.28375e+18,158.968,1120.96,8312,112,91,7928,7775,7072,6952,5190
39231,47,1365,0,39231,10004,29227,7.46051e+15,245.902,3561.89,39231,233,153,35436,34039,31482,31530,6473
20300,806,819,0,20300,0,20300,1.27849e+18,425.79,2505.95,20300,232,154,19481,19477,19474,19481,19458
33920,4,13,33658,262,33920,0,1.00375e+14,12.0581,362.323,33920,12,12,33482,33305,31255,31628,22881
27328,151,2055,27328,0,25352,1976,4.16078e+18,403.23,4292.28,27328,704,158,24712,21342,16900,15757,7576
23292,60,390,23124,168,23292,0,3.98951e+18,251.305,2160.52,23292,187,126,19828,17526,13166,12586,4337
14472,297,1054,3838,10634,0,14472,6.26159e+13,116.933,2211.23,14472,209,93,13418,13301,12504,11333,9652
5725,389,451,5044,681,5044,681,3.18497e+18,147.524,1209.31,5725,148,105,5274,5253,5269,5265,5161
47446,464,958,10319,37127,0,47446,1.87531e+13,489.646,3848.36,47446,368,210,46221,44924,44313,38465,31766
46967,1459,2702,0,46967,0,46967,1.49032e+18,502.304,6551.69,46967,788,252,44265,43950,43645,43291,28779
19484,634,721,4234,15250,0,19484,1.81163e+13,295.062,2311.17,19484,219,153,18763,18738,18681,18645,17930
12939,82,567,2920,10019,0,12939,1.90991e+13,186.094,1582.66,12939,167,102,11946,11011,10861,10542,4944
23496,166,1118,21076,2420,0,23496,3.81472e+18,547.928,3050.23,23496,468,135,20960,20297,18731,18815,5175
24689,98,1401,0,24689,0,24689,1.94476e+18,220.844,3264.18,24689,366,143,22036,21005,19583,13052,4186
4128,4,22,0,4128,4127,1,2.07551e+16,15.1265,188.15,4128,18,16,3412,3107,3027,3001,2060
30322,1,7,30261,61,30322,0,8.30541e+13,6.97757,340.388,30322,7,7,17424,17424,17424,17424,17424
874,80,85,0,874,232,642,1.5335e+16,25.2059,205.104,874,32,31,789,789,789,789,768
15509,231,758,3367,12142,0,15509,1.88759e+13,316.669,2173.65,15509,264,147,14559,14192,13680,12312,7477
23222,717,1124,0,23222,0,23222,1.25351e+18,478.886,3171.75,23222,297,181,22028,21432,21360,20053,18524
41323,483,646,0,41323,9567,31756,7.43861e+15,227.246,3184.18,41323,265,139,40677,40668,40415,40561,34817
41178,14,64,0,41178,40855,323,2.52652e+16,48.0726,893.637,41178,39,43,40315,39493,37648,37101,26140
40145,496,542,40145,0,40145,0,5.03297e+18,322.437,2907.38,40145,192,169,39603,39596,39486,39414,39199
16604,3,40,0,16604,16032,572,1.83877e+16,16.6035,443.264,16604,21,22,15311,14591,12872,12906,8400
43557,1169,1788,39044,4513,39044,4513,3.21017e+18,272.138,4566.08,43557,400,178,41769,41769,39225,38430,27029
34693,622,1270,32384,2309,32384,2309,2.04238e+18,638.279,4064.52,34693,384,230,33063,31602,31565,31220,18439
28999,38,45,0,28999,28785,214,2.57926e+16,35.7699,585.897,28999,29,30,28943,28860,28806,28858,28122
27896,1020,1458,25252,2644,25249,2647,1.22734e+18,282.833,3811.03,27896,502,140,26438,26438,26268,26389,18469
41764,1335,1501,36760,5004,36760,5004,1.66742e+18,377.467,5014.06,41764,333,210,40263,40263,40197,40168,37045
537,103,122,537,0,521,16,2.44473e+17,31.1117,220.369,537,36,25,415,415,396,415,356
19718,1,11,19646,72,15907,3811,7.44872e+13,7.06831,319.965,19718,9,9,10898,10898,10898,10898,10898
23264,833,1121,21814,1450,21814,1450,1.91035e+18,502.853,3192.15,23264,329,183,22143,21589,21734,21702,18021
20209,688,844,18090,2119,0,20209,3.83405e+18,236.005,2292.19,20209,125,146,19365,19359,19090,19090,17014
6462,118,526,5707,755,0,6462,4.26856e+18,80.4008,1047.53,6462,76,92,5936,5837,5287,5199,1380
18204,109,516,18204,0,18204,0,3.3983e+18,371.008,1702.8,18204,516,32,16328,15735,11805,11957,4241
30574,1498,1569,27548,3026,27548,3026,1.4056e+18,455.949,4355.18,30574,439,172,29005,29001,28977,28984,28659
43309,440,704,43309,0,43309,0,3.28393e+18,319.747,3691.79,43309,209,194,42605,42535,40499,37106,30458
16609,54,59,0,16609,16581,28,2.12152e+16,29.5261,496.531,16609,31,32,16550,16550,16550,16550,16525
24793,4228,4736,0,24793,0,24793,4.60747e+17,13.9798,5200.05,24793,603,22,20057,20057,19552,19714,18136
13226,820,1089,13226,0,11534,1692,1.15351e+18,237.063,2518.17,13226,236,147,12137,12137,11930,11092,10301
6105,127,1081,6105,0,5591,514,8.53889e+17,127.741,1758.01,6105,356,67,4941,4604,3764,2616,1044
6987,285,417,6987,0,6987,0,5.29614e+18,128.916,1220.95,6987,122,85,6570,6539,6253,6210,5527
49599,336,621,48451,1148,49599,0,3.81552e+18,300.995,3364.33,49599,253,186,48952,48663,47464,45683,42135
20727,623,1556,17100,3627,0,20727,5.92152e+18,182.175,3746.97,20727,264,146,19171,19115,15564,15305,6201
48224,709,1439,44982,3242,44982,3242,6.8697e+17,738.204,4961.57,48224,410,254,46308,44185,44725,44826,36219
14294,307,1048,14294,0,13361,933,1.01834e+18,275.2,2469.4,14294,225,162,13137,12881,11590,10844,8283
16860,717,969,15750,1110,15750,1110,2.02013e+18,320.306,2516.47,16860,217,137,15891,15628,15675,15672,15075
25101,120,738,25101,0,18891,6210,8.97668e+17,332.661,2395.6,25101,190,156,23382,22751,19307,18704,5212
29413,648,744,25836,3577,0,29413,3.84946e+18,333.367,3203.4,29413,273,172,28669,28669,28572,28579,26541
12860,231,550,11310,1550,0,12860,3.84234e+18,262.621,1931.92,12860,197,134,12147,11753,9895,9937,5539
49099,2073,2361,49099,0,44053,5046,1.50315e+18,278.559,5799.85,49099,526,184,46738,46738,46698,46613,43483
31107,735,1448,0,31107,7930,23177,9.83814e+15,354.275,3806.2,31107,480,157,29659,29628,28227,29026,11604
37227,2803,6053,37227,0,37227,0,3.64783e+18,16.7257,7165.08,37227,967,25,31174,31174,28304,31174,17828
8459,255,451,6382,2077,6382,2077,6.99867e+18,180.319,1176.2,8459,116,97,8005,7808,7797,7714,5956
44614,77,2310,0,44614,0,44614,1.73108e+18,408.264,6009.39,44614,501,240,37398,32608,32048,12152,5139
12406,859,1030,0,12406,0,12406,1.35234e+18,205.504,2384.38,12406,255,88,11376,11372,11317,11256,9287
49134,968,2655,49134,0,45667,3467,1.81353e+18,483.648,7106.67,49134,586,222,46479,45860,43289,44793,21179
18102,267,646,0,18102,4580,13522,6.54882e+15,181.632,2206.71,18102,289,126,17456,17363,16339,14915,13327
38342,248,817,0,38342,8552,29790,4.74345e+15,425.533,3266.19,38342,320,184,36691,35961,34925,32622,21026
9881,246,509,0,9881,0,9881,1.95128e+18,189.403,1616.8,9881,183,129,9352,9156,8443,7280,6164
30430,580,619,28596,1834,30430,0,3.78793e+18,293.36,2792.82,30430,253,169,29811,29792,29703,29620,29358
3720,163,447,3450,270,0,3720,2.71605e+18,107.744,916.431,3720,193,54,3271,2995,2989,2989,1615
39966,62,2307,35796,4170,35796,4170,1.59356e+18,365.739,5705.83,39966,354,287,31951,28225,24420,27179,4718
4126,208,323,1034,3092,0,4126,3.26751e+13,47.483,659.32,4126,49,63,3803,3795,3696,3760,2822
26877,530,1316,0,26877,4086,22791,5.48185e+15,333.084,3290.37,26877,447,104,25561,25034,24757,25007,13436
48639,682,1405,45389,3250,0,48639,2.42832e+18,681.59,4837.26,48639,453,239,46786,44957,45070,44674,33482
22996,794,1048,4097,18899,0,22996,1.8584e+13,176.826,2843.93,22996,327,100,21948,21946,21693,21920,18640
8789,476,552,7858,931,7858,931,9.21009e+17,203.812,1390.98,8789,106,119,8237,8237,8223,8224,7966
21615,217,687,19048,2567,0,21615,3.81736e+18,331.23,2664.35,21615,241,161,20410,19713,16479,16324,7106
46181,975,1657,12199,33982,0,46181,4.8783e+13,290.822,4625.6,46181,433,174,44524,44524,44122,44390,28767
46765,146,751,46637,128,46765,0,3.11938e+18,466.504,3696.8,46765,267,166,43351,40024,33933,28479,14723
1908,1,18,0,1908,1825,83,2.40949e+16,12.2594,122.931,1908,14,14,734,734,734,734,734
8835,440,919,0,8835,0,8835,1.19015e+18,164.353,1938.17,8835,203,108,7916,7813,7620,6524,6201
6005,197,657,5646,359,0,6005,2.29477e+18,111.715,1179.35,6005,223,94,5348,5330,5251,5272,2877
40331,706,1795,9313,31018,0,40331,2.63667e+13,253.298,4710.02,40331,522,160,38536,38516,35397,31101,13358
45110,7,34,0,45110,45075,35,1.08079e+16,7.48925,735.197,45110,14,10,43831,41788,40042,42349,30522
29840,1,12,29225,615,26393,3447,7.84057e+13,6.83107,345.383,29840,9,8,18480,18480,18480,18480,18480
29476,5,13,29118,358,29252,224,9.35832e+13,7.99671,337.502,29476,9,11,29319,29158,27801,27808,23498
13635,5,7,13610,25,13635,0,8.33177e+13,6.94969,228.329,13635,7,7,13404,13159,11689,11688,12013
44944,1185,2793,44944,0,40762,4182,1.22368e+18,375.966,6783,44944,515,290,42151,42055,39514,36204,19915
23989,10,11,23866,123,23989,0,1.03736e+14,8.32165,306.394,23989,10,10,23978,23978,23965,23965,23465
17650,291,520,16300,1350,17650,0,4.13651e+18,226.494,2000.42,17650,203,142,17130,16875,16233,15934,14799
28635,23,51,0,28635,28055,580,2.4062e+16,17.162,688.602,28635,27,23,28580,28560,28320,27925,21764
11921,572,639,2632,9289,0,11921,1.92199e+13,172.197,1743.21,11921,184,96,11282,11236,11249,11260,11002
30761,359,2573,28046,2715,28046,2715,1.51909e+18,263.356,5264.68,30761,638,219,28067,27383,23052,24718,8929
8911,744,814,8911,0,8086,825,7.95866e+17,94.34,1686.01,8911,265,100,8097,8097,8097,8096,7746
49092,3185,9165,47644,1448,0,49092,6.3242e+18,14.0177,9926.02,49092,1192,26,39927,39927,33433,33413,15926
11280,92,637,11280,0,9863,1417,1.17954e+18,255.232,1933.97,11280,171,129,9255,7579,6825,3733,1383
25192,12,32,24465,727,25188,4,1.01788e+14,9.458,404.324,25192,18,18,25152,25137,24248,24200,19890
3133,159,250,2769,364,0,3133,4.25612e+18,61.8474,567.186,3133,58,58,2883,2873,2805,2783,2113
47942,12,14,47636,306,47942,0,9.45845e+13,10.8017,439.782,47942,13,12,47924,47911,46443,46442,45301
34468,70,2006,34468,0,31890,2578,1.07203e+18,386.612,5352.36,34468,527,194,29595,27149,23017,7407,3293
31426,2409,6000,30678,748,0,31426,6.26254e+18,13.9819,6524.19,31426,760,22,25426,25426,21838,21858,11561
31195,1991,2335,218,30977,0,31195,5.10378e+11,16.2426,4372.67,31195,619,21,28860,28860,28512,28451,25360
3611,172,248,3611,0,3611,0,3.87039e+18,14.7679,555.685,3611,125,15,3363,3363,3287,2748,2568
1938,3,5,1917,21,959,979,8.22059e+13,3.22755,73.9234,1938,5,5,1914,1907,1868,1876,1770
14970,303,355,14967,3,14970,0,3.29017e+18,236.007,1666.54,14970,147,115,14615,14601,14137,14106,13401
34505,2,13,34251,254,34505,0,1.00077e+14,11.5872,363.729,34505,12,12,31296,30345,23947,30124,20501
29496,571,876,22222,7274,22222,7274,6.99522e+18,308.09,2870.38,29496,206,188,28620,28547,28276,28118,20889
36445,11,12,36364,81,36445,0,8.12878e+13,6.54559,381.841,36445,7,9,36433,36433,32570,32570,33414
19495,739,1290,0,19495,4516,14979,8.06472e+15,137.373,2581.53,19495,316,172,18205,18204,16539,16685,9354
13891,437,772,13891,0,12257,1634,7.8889e+17,367.059,2316.01,13891,252,123,13025,11905,11376,10225,7188
40429,608,832,0,40429,0,40429,4.10976e+18,370.567,2941.49,40429,216,175,39597,39538,39158,39078,34843
33425,35,811,7364,26061,0,33425,1.80845e+13,409.501,3071.14,33425,326,179,27848,24118,23459,17014,7160
4727,37,248,4727,0,4727,0,4.14526e+18,141.973,759.866,4727,78,80,3978,3135,2191,1625,731
31309,2140,2301,31309,0,28974,2335,3.46873e+18,423.787,5044.29,31309,817,185,29008,29004,28972,29008,27831
44555,4,11,42440,2115,44555,0,9.60895e+13,10.6658,471.21,44555,11,11,42109,41354,37855,34521,30486
39712,460,948,0,39712,0,39712,4.1229e+18,351.606,3068.03,39712,226,183,38764,38503,36523,23036,23008
25271,249,1520,25271,0,22440,2831,1.75682e+18,242.794,3400.8,25271,233,204,23616,21706,19336,20704,7536
15957,55,421,15957,0,15957,0,3.09235e+18,224.97,1570.37,15957,150,108,14487,12545,8725,8385,2971
14435,11,13,14341,94,14435,0,1.01222e+14,11.1573,238.329,14435,11,10,14420,14416,13912,13911,12521
4293,165,387,3833,460,3833,460,3.27742e+18,127.09,892.765,4293,76,89,3872,3633,3557,3419,1682
34113,1032,1469,0,34113,8176,25937,6.7191e+15,248.682,3961.07,34113,287,166,32644,32622,32259,32411,24497
45596,8,32,43732,1864,45592,4,9.81736e+13,10.5261,542.18,45596,18,18,45438,45335,43562,43526,39778
28774,267,1185,0,28774,6234,22540,4.9636e+15,335.778,3527.01,28774,273,181,27262,26697,25685,21710,11438
38134,415,626,10594,27540,0,38134,6.32956e+13,250.89,2319.45,38134,180,135,37508,37441,37036,37002,30190
46828,393,633,44029,2799,46828,0,3.5994e+18,359.546,3554.42,46828,285,160,46124,45813,41530,41382,33730
45490,1690,1799,42496,2994,0,45490,2.43137e+18,723.674,5422.8,45490,467,274,43691,43691,43666,43675,43280
19909,456,864,3537,16372,0,19909,2.22267e+13,237.706,2573.41,19909,320,94,19045,18892,18637,15417,14158
30399,364,1391,0,30399,0,30399,1.22337e+18,493.704,3952.32,30399,328,208,28458,27691,26972,21855,16354
17879,556,634,15743,2136,0,17879,3.82217e+18,310.37,2385.59,17879,229,149,17245,17245,17163,17215,16230
27664,566,1758,5862,21802,0,27664,2.89263e+13,162.844,3848.89,27664,452,166,25906,25833,23640,15483,9547
6115,260,320,6115,0,6115,0,5.13208e+18,123.866,968.447,6115,113,88,5795,5791,5695,5625,4991
43325,93,1235,0,43325,9463,33862,6.01084e+15,482.126,4144.23,43325,450,149,39087,36354,35258,30094,5393
11260,98,577,2656,8604,0,11260,1.79476e+13,114.151,1486.16,11260,174,116,10548,9958,9304,9290,2338
44370,546,2623,40376,3994,0,44370,3.13904e+18,302.464,6265.37,44370,515,251,41747,40954,39304,38920,14609
4627,2,8,4508,119,4403,224,8.11516e+13,3.89885,121.051,4627,8,6,4155,4119,3902,3950,3425
48150,1111,1362,0,48150,12813,35337,1.31847e+16,213.99,4416.04,48150,260,153,46788,46788,46247,46323,37137
25714,82,910,25714,0,22596,3118,1.16876e+18,384.311,3317.52,25714,254,180,20755,17313,14935,5570,3926
44568,838,951,39205,5363,0,44568,3.8595e+18,348.585,4206.62,44568,327,213,43617,43617,43488,43484,40570
25067,1140,1245,23400,1667,23400,1667,6.99692e+17,578.208,3483.19,25067,338,187,23822,23822,23822,23822,23425
43981,926,1277,39817,4164,0,43981,2.83188e+18,604.631,4801.8,43981,495,189,42704,42277,42251,42167,31926
16593,654,1244,359,16234,0,16593,1.98502e+12,48.5363,2453.46,16593,418,49,15349,15349,14674,14366,9296
40000,680,1018,10430,29570,0,40000,2.94896e+13,230.208,2995.28,40000,132,161,38982,38959,37799,38130,31777
15150,731,873,15150,0,13474,1676,2.00273e+18,204.754,2057.83,15150,112,182,14277,14275,13949,14180,12624
1390,3,256,1228,162,0,1390,4.28684e+18,12.0583,393.955,1390,84,26,616,417,368,354,286
36873,460,889,0,36873,8288,28585,4.69989e+15,466.002,3308.79,36873,344,181,35711,34859,34391,33794,24583
2302,230,376,2071,231,2071,231,1.59465e+18,142.877,723.837,2302,130,64,1926,1769,1616,1732,1605
38701,577,908,8478,30223,0,38701,2.16558e+13,421.343,3615.05,38701,420,138,37780,37445,36884,37188,23590
16838,105,616,0,16838,0,16838,4.13138e+18,263.514,1783.04,16838,152,120,15689,15347,11067,6104,4911
9387,1,10,9308,79,9387,0,1.00152e+14,8.82806,189.612,9387,9,9,5042,5042,5042,5042,5042
39811,6,62,0,39811,39428,383,2.58902e+16,31.6261,750.496,39811,35,33,38963,38503,35935,36048,21097
10299,5,56,0,10299,10180,119,1.95484e+16,17.8413,419.193,10299,24,28,9497,9138,8214,8232,5888
11602,514,872,10435,1167,10435,1167,1.40536e+18,271.373,2181.65,11602,289,108,10730,10689,9900,10029,6299
16385,84,361,16382,3,16385,0,3.25923e+18,265.26,1754.42,16385,152,122,14169,12427,11207,9721,5250
36199,70,82,0,36199,36119,80,2.13472e+16,32.167,801.325,36199,37,33,36117,36116,36116,36117,35994
25468,821,1316,23848,1620,23848,1620,1.99013e+18,442.375,3612.94,25468,309,220,24152,23983,23375,23402,14032
47372,2202,2241,43134,4238,43134,4238,7.99891e+17,480.328,6048.93,47372,463,284,45131,45131,45130,45126,45024
19410,260,810,0,19410,0,19410,1.46836e+18,316.344,2736.7,19410,366,153,17778,15721,16694,16287,12003
41383,60,1199,0,41383,9795,31588,7.46327e+15,262.071,3976.78,41383,286,137,37197,33751,31429,25292,7593
6491,69,327,0,6491,1504,4987,7.32278e+15,110.673,1038.2,6491,130,72,5930,5393,4971,4307,1781
45041,726,810,45031,10,45041,0,4.31413e+18,334.095,3740.28,45041,231,145,44231,44222,44087,44055,43719
28992,1173,1292,28992,0,27064,1928,9.53977e+17,638.801,3794.71,28992,392,200,27700,27694,27538,27599,27070
37869,910,6870,37869,0,37037,832,4.53228e+17,14.9743,7635.41,37869,939,23,30999,30999,26713,7348,6490
41719,14,74,0,41719,41342,377,2.50619e+16,47.8286,977.815,41719,41,45,40865,40160,38278,37409,24372
32009,435,1226,6744,25265,0,32009,1.8889e+13,307.854,3793.82,32009,295,184,30755,30223,29273,28011,18577
27812,70,90,0,27812,27595,217,2.04007e+16,28.5359,858.171,27812,39,31,27722,27719,27703,27719,24372
37098,10,11,37000,98,37098,0,8.31575e+13,6.97027,382.325,37098,7,9,37087,37087,32562,32562,33443
29095,67,1314,7288,21807,0,29095,3.08791e+13,212.386,3084.24,29095,191,199,26755,25848,22993,23281,5007
47511,1359,1408,44291,3220,44291,3220,6.49333e+17,705.279,4838.4,47511,431,246,46103,46103,46067,46084,45939
45376,381,2365,42225,3151,0,45376,2.60096e+18,453.328,6412.01,45376,655,138,42451,41632,40180,38998,9546
40130,551,2239,36272,3858,36272,3858,2.88254e+18,263.164,5485.09,40130,488,250,37891,37432,36014,34993,16450
9270,60,357,9270,0,9270,0,3.05482e+18,152.175,1144.31,9270,117,96,8518,7752,5272,4903,2101
24243,396,1311,0,24243,0,24243,1.18173e+18,421.204,3541.32,24243,289,205,22648,22023,21598,16321,11715
14249,554,569,3928,10321,0,14249,1.8293e+13,74.6484,1571.56,14249,213,66,13680,13678,13680,13680,13643
47042,692,1964,43874,3168,0,47042,2.45841e+18,573.97,5820.01,47042,399,269,44955,43706,42870,42559,22673
46399,51,611,46399,0,46399,0,3.24249e+18,344.259,2955.32,46399,230,156,41417,34429,24753,23450,5133
16104,612,674,14267,1837,14267,1837,1.52019e+18,394.39,2349.71,16104,271,151,15430,15430,15428,15405,15300
19266,213,760,0,19266,0,19266,2.14891e+18,293.52,1984.9,19266,109,203,18191,17725,15901,5010,7444
41688,1075,1366,0,41688,0,41688,1.5554e+18,437.394,4679.94,41688,416,202,40322,40242,39806,39712,31682
46655,807,894,35138,11517,35138,11517,3.81386e+18,411.593,3381.08,46655,259,191,45761,45756,45725,45724,44677
18625,570,1116,0,18625,0,18625,1.92266e+18,258.277,2839.26,18625,219,123,17509,17500,16429,16907,11931
10795,246,306,10795,0,10795,0,3.4703e+18,193.806,1149.07,10795,95,137,10468,10336,10321,10338,8841
18609,1152,1222,17487,1122,0,18609,2.23653e+18,301.95,3014.01,18609,269,197,17387,17386,17379,17361,16867
27093,234,1989,24905,2188,24904,2189,1.32761e+18,456.846,4498.45,27093,534,162,24153,23192,20446,20915,2863
36219,840,1411,33871,2348,0,36219,2.38975e+18,555.003,4335.64,36219,393,253,34808,34456,33282,33068,22477
16738,21,912,14730,2008,14730,2008,1.82838e+18,315.167,2467.58,16738,234,149,11723,8954,7670,8243,1958
29801,1262,1510,6529,23272,0,29801,2.59369e+13,209.458,3818.43,29801,336,180,28291,28286,28291,28291,25190
10685,8,63,0,10685,10597,88,2.55456e+16,26.5216,454.685,10685,29,30,10137,9815,9387,8536,5581
21824,9,10,21660,164,21824,0,9.92592e+13,9.44483,288.173,21824,10,10,21810,21805,21719,21719,21807
41973,389,734,41965,8,41973,0,4.00487e+18,309.273,3347.86,41973,216,146,41239,41024,35836,36072,30904
10055,48,545,10055,0,7589,2466,8.22529e+17,215.863,1428.7,10055,128,114,8588,5780,6051,6549,1331
8027,787,880,7500,527,7500,527,2.00913e+18,149.374,1829.43,8027,185,138,7147,7143,7140,7141,6699
9039,5,9,8867,172,7555,1484,7.26188e+13,5.83118,165.196,9039,8,7,9021,9011,8510,8511,8597
19653,996,1033,18358,1295,0,19653,2.39407e+18,473.082,2866.49,19653,280,179,18620,18620,18612,18602,18417
1444,98,131,1066,378,0,1444,9.02671e+18,56.8476,335.821,1444,46,50,1313,1309,1306,1307,1196
34686,1594,2197,31485,3201,31485,3201,2.87954e+18,332.882,5258.62,34686,524,198,32489,32488,31678,30735,27896
41905,23,127,0,41905,39988,1917,2.45536e+16,28.4658,879.757,41905,47,36,41718,41597,39516,39810,34167
44371,52,63,0,44371,44035,336,2.56167e+16,51.8823,935.553,44371,43,41,44282,44173,43381,43415,40564
42948,1272,1556,38328,4620,0,42948,3.10736e+18,394.042,5074.09,42948,438,219,41392,41389,41278,41347,38870
5383,253,392,1168,4215,0,5383,1.62109e+13,135.41,1070.41,5383,223,71,4991,4824,4984,4946,3919
39322,40,46,0,39322,39021,301,2.54095e+16,39.765,691.174,39322,34,34,39264,39132,39088,39204,38731
6929,5,50,0,6929,6825,104,2.47611e+16,24.8381,339.144,6929,27,27,6181,5623,4557,5082,2467
44925,260,1027,33880,11045,0,44925,8.28311e+18,362.479,3326.48,44925,253,192,43288,41601,34998,34914,18969
18417,49,791,16487,1930,16487,1930,3.26245e+18,246.459,2130.54,18417,123,147,15840,15076,14154,12402,1907
33108,1,7,33068,40,33108,0,8.13023e+13,6.97433,356.118,33108,7,7,18546,18546,18546,18546,18546
3189,467,576,2958,231,2958,231,2.15822e+18,81.9269,1050.69,3189,95,108,2613,2613,2600,2611,2162
47076,212,1575,11012,36064,0,47076,2.33601e+13,331.411,4725.64,47076,381,182,44771,43943,40555,19569,10808
3219,344,347,3015,204,3015,204,6.02205e+17,108.415,768.944,3219,92,64,2872,2872,2872,2872,2871
20476,519,702,0,20476,4504,15972,4.85272e+15,301.667,2278.69,20476,236,141,19774,19667,19661,19684,17553
27180,1369,1612,25117,2063,25117,2063,2.38326e+18,225.278,4128.84,27180,411,131,25568,25568,25469,25329,22471
2622,45,205,652,1970,0,2622,3.26863e+13,39.3722,441.989,2622,43,47,2411,2342,2107,2279,757
1729,144,222,1595,134,1595,134,6.04352e+17,102.28,492.905,1729,70,55,1507,1445,1432,1419,1175
47909,16,92,0,47909,46799,1110,2.54186e+16,36.7254,1193.78,47909,45,36,47234,46526,43151,41578,24271
12451,101,410,12451,0,12451,0,3.32642e+18,194.903,1400.5,12451,138,109,11736,11387,8676,8407,3894
43074,1147,1330,40207,2867,0,43074,2.41801e+18,699.626,4494.52,43074,433,237,41744,41733,41332,41305,39930
19188,1016,1150,0,19188,4543,14645,8.21991e+15,146.905,2269.15,19188,284,118,18038,18038,17912,17952,16163
22947,120,451,0,22947,5339,17608,7.36516e+15,198.824,2146.04,22947,208,112,22138,21718,18814,19652,9061
33928,15,19,33580,348,33923,5,9.81446e+13,15.0499,413.376,33928,18,18,33898,33859,33403,33404,33873
641,18,56,641,0,0,641,7.26712e+18,14.3557,138.58,641,28,15,585,585,251,375,222
37954,383,1017,8219,29735,0,37954,2.2182e+13,423.004,3678.51,37954,430,136,36722,36401,33335,33393,15236
13342,2,10,13281,61,13278,64,8.96198e+13,7.44656,211.133,13342,9,10,11987,11759,10553,11478,8255
49926,524,688,49926,0,49926,0,3.41871e+18,340.067,3832.35,49926,245,198,49238,49204,48350,47127,42755
12010,7,15,0,12010,11995,15,9.29971e+15,4.98959,271.286,12010,9,7,11995,11995,11284,11276,6514
17658,372,449,17658,0,17658,0,3.54534e+18,261.908,2063.83,17658,169,123,17209,17201,16858,16748,15656
48229,1748,2052,44288,3941,0,48229,2.97728e+18,482.952,5773.33,48229,485,213,46177,46171,45941,45860,42538
41541,9,64,0,41541,41498,43,1.90114e+15,45.2089,885.21,41541,51,23,41180,41047,40711,40043,26331
39864,2116,2597,39864,0,36356,3508,1.50081e+18,15.3418,5082.38,39864,1299,16,37267,37267,37267,37267,31810
23086,897,954,21545,1541,0,23086,2.44538e+18,460.239,2894.53,23086,269,176,22132,22132,22129,22130,21943
20362,320,450,20362,0,20362,0,5.19648e+18,226.599,2025.16,20362,162,148,19912,19757,18734,18271,16970
14599,1018,1375,13657,942,13657,942,1.1284e+18,190.667,2800.59,14599,328,87,13224,13216,12960,12999,11556
37534,91,1372,35033,2501,35033,2501,6.93066e+17,679.786,4360.23,37534,383,234,31345,26962,25340,26938,9558
3683,180,240,870,2813,0,3683,1.66597e+13,93.8026,638.634,3683,95,54,3443,3435,3405,3410,3120
34012,377,687,9445,24567,0,34012,6.29636e+13,248.942,2379.65,34012,176,141,33325,33212,32444,32488,22202
9266,360,397,9266,0,9266,0,3.61374e+18,239.33,1439.98,9266,147,111,8869,8788,8784,8603,8480
11357,62,1267,10289,1068,10289,1068,1.60061e+18,120.419,2337.39,11357,522,65,9124,8008,6235,7589,1546
6274,568,582,5522,752,5522,752,1.73599e+18,162.208,1429.14,6274,153,91,5692,5692,5692,5692,5661
22551,538,822,19864,2687,19864,2687,1.71899e+18,383.786,2998.46,22551,253,166,21729,21272,21134,21226,15254
14397,138,399,14397,0,14397,0,5.27567e+18,204.627,1567.74,14397,156,111,13753,13326,10206,9705,7719
2688,281,467,2688,0,2310,378,8.95304e+17,169.926,871.835,2688,144,70,2221,2034,1969,1204,1419
18690,243,632,16447,2243,16447,2243,3.24026e+18,307.004,2435.9,18690,239,160,17754,17156,14751,13699,7811
25726,1007,1098,24044,1682,24044,1682,2.01431e+18,502.106,3284.88,25726,290,183,24628,24604,24520,24561,24140
6622,148,340,1728,4894,0,6622,2.92847e+13,120.38,891.609,6622,69,90,6274,5938,5723,5971,3498
7091,36,671,7091,0,6614,477,1.09631e+18,156.833,1456.44,7091,153,122,4943,3797,3120,2803,1934
42004,1774,2158,42004,0,38173,3831,1.49868e+18,430.776,5680.02,42004,393,301,39846,39846,39811,39751,36721
43877,36,85,0,43877,43177,700,2.51546e+16,40.7056,1089.22,43877,41,38,43740,43642,42048,42470,29582
46982,5,11,44728,2254,46982,0,9.62062e+13,10.7571,484.456,46982,11,11,45447,45246,41299,40306,32692
48545,197,7155,0,48545,0,48545,3.10891e+17,15.2985,8641.76,48545,1310,22,41390,41389,26788,15447,6158
11658,210,547,3024,8634,0,11658,2.9599e+13,136.591,1375.7,11658,88,117,11111,10987,10135,10473,5026
27596,47,48,0,27596,27407,189,2.70987e+16,17.6063,578.14,27596,22,24,27548,27548,27548,27548,27548
24571,857,1291,21580,2991,21580,2991,3.77531e+18,289.395,2832.24,24571,230,267,23280,23280,21676,21221,14305
19350,1680,1996,17544,1806,17544,1806,1.09154e+18,224.803,4029.96,19350,400,214,17354,17354,17304,17354,15876
31218,521,1431,29215,2003,0,31218,2.36649e+18,465.179,4013.38,31218,314,205,29576,28771,28466,28105,20619
28763,1133,1219,0,28763,6231,22532,4.6261e+15,373.962,3586.73,28763,342,184,27544,27543,27538,27536,27074
12354,385,812,12354,0,12354,0,3.87102e+18,14.8753,1656.02,12354,406,15,11542,11542,10583,7762,6708
3495,7,21,0,3495,3486,9,3.03075e+16,11.6873,167.776,3495,13,11,3457,3443,2912,3176,2481
14792,152,341,14792,0,14792,0,3.8683e+18,206.663,1467.94,14792,116,121,14103,13273,12197,11952,8362
30168,615,1191,28206,1962,0,30168,2.37339e+18,620.83,3694.42,30168,391,213,28660,27632,27615,27378,15600
49374,244,1770,0,49374,0,49374,1.33307e+18,671.741,5615.26,49374,436,239,45200,43749,41325,36447,9306
17451,4,6,17436,15,17451,0,5.36628e+13,5.99209,262.097,17451,6,6,16339,15371,15785,16200,15231
11638,369,387,0,11638,2631,9007,7.38793e+15,174.892,1468.99,11638,171,94,11251,11251,11242,11250,11168
48843,278,720,11163,37680,0,48843,2.84998e+13,238.691,3565.98,48843,278,147,48123,47233,45746,46992,23383
33075,724,1553,0,33075,7958,25117,6.81895e+15,262.813,3868.66,33075,455,159,31522,31503,29061,29740,15855
34804,467,1743,0,34804,6581,28223,6.31916e+15,339.89,4511.3,34804,507,176,32909,32602,30920,28393,9331
4752,624,709,4419,333,4419,333,2.08349e+18,149.847,1366.96,4752,132,101,4043,4023,4036,4039,3861
39723,9,11,37836,1887,39723,0,9.61145e+13,10.732,445.614,39723,11,11,39687,39665,38557,38558,39678
664,49,55,84,580,0,664,5.51654e+13,11.4262,134.446,664,31,12,609,609,603,570,589
2358,17,211,0,2358,599,1759,7.05924e+15,42.4088,501.226,2358,118,44,2051,1854,1889,1163,297
48424,1640,2302,0,48424,0,48424,2.39525e+18,471.184,6237.29,48424,583,269,46122,46122,45955,45313,34714
16955,233,657,3642,13313,0,16955,1.89752e+13,286.295,2080.85,16955,205,123,16077,15792,15297,13026,10415
13197,431,978,12347,850,12347,850,1.99844e+18,207.697,2267.74,13197,279,157,12219,12146,11799,11741,3845
34729,1,12,34286,443,34729,0,9.9431e+13,10.4018,360.927,34729,11,12,19388,19388,19388,19388,19388
46449,801,987,10139,36310,0,46449,1.84891e+13,487.354,3861.01,46449,398,214,45462,45453,45101,44757,43021
13320,455,635,10050,3270,10050,3270,3.78531e+18,221.033,1720.94,13320,145,129,12685,12622,12591,12592,10268
21582,1049,1386,20210,1372,20210,1372,1.99094e+18,428.714,3482.96,21582,350,159,20196,20082,19986,19970,18032
35247,899,1639,31890,3357,0,35247,3.0905e+18,375.829,4485.5,35247,547,176,33608,33248,32045,32186,24653
14140,283,628,12664,1476,12664,1476,3.24978e+18,222.664,1711.73,14140,114,127,13511,13315,12272,11977,6501
44737,705,878,33716,11021,33716,11021,7.01689e+18,381.277,3160.87,44737,254,173,43859,43846,43585,43514,40814
45440,226,1665,40989,4451,40989,4451,2.7802e+18,571.975,5149.3,45440,624,193,41208,37958,36750,31668,14311
25511,530,921,0,25511,5420,20091,4.61833e+15,370.214,2955.88,25511,265,165,24590,24223,23837,23913,19161
28232,36,716,0,28232,0,28232,4.15739e+18,326.249,2399.66,28232,195,148,22920,12792,15017,7924,3097
30593,49,192,0,30593,29358,1235,2.49717e+16,26.4704,1050.71,30593,76,39,30401,30357,29671,29414,25867
977,1,6,975,2,615,362,8.21089e+13,3.50665,51.5713,977,5,5,639,639,639,639,639
1773,29,107,466,1307,0,1773,3.14404e+13,68.9069,360.102,1773,78,44,1466,1322,1255,1312,827
14725,1252,1776,11611,3114,11611,3114,5.90478e+18,121.402,3255.33,14725,254,183,12949,12943,12916,12920,9665
46187,117,1856,0,46187,0,46187,3.48719e+18,295.493,5293.9,46187,285,203,42723,41067,30058,18147,3625
26263,74,535,6036,20227,0,26263,2.89966e+13,214.76,2399.69,26263,226,121,24484,22118,20157,12506,5847
34551,87,532,34551,0,34551,0,3.38839e+18,284.997,2624.33,34551,170,168,32583,31420,22720,21773,6444
13332,241,391,3079,10253,0,13332,2.86556e+13,169.595,1570.74,13332,175,99,12921,12779,12580,12611,9221
34263,752,847,0,34263,0,34263,1.85618e+18,349.298,3553.51,34263,287,189,33416,33416,33346,33400,32391
34020,95,2247,31651,2369,31650,2370,1.20845e+18,458.428,5448.96,34020,531,137,29486,25910,23324,26415,4398
3287,31,409,0,3287,0,3287,1.95847e+18,82.3931,774.711,3287,78,77,2582,2129,1808,1658,238
13414,36,724,12016,1398,12016,1398,9.02429e+17,228.363,1839.51,13414,129,130,10928,8837,7800,8125,1186
21540,124,191,0,21540,20991,549,2.63978e+16,21.4473,930.464,21540,73,34,21349,21346,20937,20242,13822
37519,1377,1644,0,37519,0,37519,1.60143e+18,430.056,4636.4,37519,594,179,35875,35875,35769,35817,33772
27369,1467,1853,24534,2835,24534,2835,2.96012e+18,274.967,4277.27,27369,386,216,25516,25515,25516,25516,24004
20564,861,1600,18874,1690,18874,1690,1.4294e+18,236.711,3415.14,20564,283,219,18964,18964,18218,18576,13239
46832,479,3110,46832,0,42786,4046,3.01485e+18,475.371,7062.23,46832,781,223,43427,42526,32969,32598,11836
28805,376,688,21678,7127,0,28805,8.32256e+18,307.47,2355.36,28805,182,161,28103,27125,27351,27294,18589
2483,94,354,2314,169,0,2483,2.28023e+18,94.8441,695.992,2483,104,61,2082,1993,1937,2006,1267
22955,5,12,22504,451,21605,1350,8.14447e+13,6.09514,310.044,22955,9,8,22689,22415,20425,20421,19165
26328,382,1196,6668,19660,0,26328,4.22148e+13,137.084,3427.6,26328,225,127,25132,25059,21980,12214,9868
2694,62,357,0,2694,0,2694,1.43789e+18,28.3393,639.089,2694,100,37,2337,2299,2012,1556,1060
45704,1799,2471,40733,4971,40730,4974,1.18055e+18,317.908,5671.84,45704,448,289,43233,43231,43019,43194,30964
42000,2976,3300,40850,1150,40850,1150,3.17172e+18,359.033,6232.75,42000,417,157,38700,38700,38234,38094,36796
11228,951,987,1949,9279,0,11228,2.39687e+13,124.692,2178.73,11228,267,124,10241,10241,10241,10241,9872
20152,584,956,20152,0,17917,2235,2.01017e+18,228.311,2401.52,20152,124,215,19196,19166,17862,18700,12814
38190,332,1637,0,38190,9413,28777,7.86375e+15,210.763,3568.28,38190,332,158,36553,36309,30770,31962,4701
47508,498,1492,44392,3116,44392,3116,6.43584e+17,615.906,5048.12,47508,399,252,45304,43586,43229,43411,25793
17399,858,1343,15856,1543,15856,1543,1.31181e+18,351.857,3196.12,17399,369,140,16056,15925,15779,15901,12869
49073,444,992,10993,38080,0,49073,1.88769e+13,526.351,3942.76,49073,421,214,47608,46352,45577,40799,29492
30730,674,798,27068,3662,0,30730,3.85568e+18,336.269,3327.33,30730,286,172,29932,29932,29793,29836,27500
31797,14,15,31767,30,31792,5,7.41821e+12,12.1711,353.358,31797,15,15,31777,31751,31765,31765,31773
10208,59,1234,10208,0,9408,800,1.61238e+18,97.2695,2222.84,10208,248,120,8386,7773,7440,5726,2105
43348,1266,1765,38545,4803,38524,4824,1.75308e+18,552.984,5215.11,43348,499,246,41583,41576,41363,41208,35675
17704,359,616,13364,4340,0,17704,8.21773e+18,274.378,1833.14,17704,162,120,17073,16492,16719,16722,12620
21052,7,13,20901,151,21052,0,9.91823e+13,9.84106,285.523,21052,11,10,21025,21020,20298,20297,19186
26204,872,1097,4636,21568,0,26204,2.1313e+13,261.62,3255.66,26204,356,109,25107,25107,24954,21297,21845
14971,2,34,0,14971,14804,167,1.81023e+16,20.591,408.765,14971,21,24,12296,11391,10600,10896,8431
11920,56,78,0,11920,11886,34,2.15206e+16,25.0191,511.048,11920,34,28,11842,11839,11835,11842,11500
1364,246,302,1364,0,1364,0,2.91611e+18,42.8629,499.096,1364,69,42,1062,1058,1060,1061,953
24128,257,802,0,24128,0,24128,4.10185e+18,269.858,2306.77,24128,187,152,23171,22437,20580,12710,12167
45472,170,1476,42536,2936,42536,2936,6.23146e+17,725.971,4838.7,45472,464,243,40999,38532,35020,36529,14688
21888,192,671,16498,5390,0,21888,8.28318e+18,316.495,2099.43,21888,171,141,20687,20093,16683,16636,7154
27290,577,1343,27290,0,23994,3296,2.20093e+18,333.969,3093.56,27290,209,253,25947,25815,21609,24086,5537
30563,2,12,29946,617,27344,3219,7.83837e+13,6.86186,348.534,30563,9,8,26986,25816,24029,26124,21309
7673,889,1117,7147,526,7147,526,8.99641e+17,131.43,2130.2,7673,157,171,6556,6544,6484,6526,5073
41596,1,13,41304,292,41596,0,1.01855e+14,11.8216,401.263,41596,13,12,22835,22835,22835,22835,22835
27267,378,722,23974,3293,0,27267,3.87698e+18,308.797,3040.85,27267,270,166,26502,25937,25128,25355,15135
26251,1007,1697,23557,2694,23557,2694,1.49695e+18,324.523,4113.09,26251,403,168,24554,24553,24249,24353,21253
1935,95,293,1823,112,0,1935,2.21774e+18,81.6083,547.447,1935,96,48,1617,1424,1493,1503,766
33296,668,1609,7359,25937,0,33296,2.49556e+13,273.708,4215.28,33296,513,139,31687,31654,29883,25765,13429
6938,13,14,0,6938,6932,6,9.13962e+15,10.9311,248.506,6938,12,11,6924,6924,6823,6824,6220
6088,279,553,5654,434,5654,434,2.21908e+18,120.615,1234.72,6088,126,80,5535,5526,5383,5306,4390
2927,5,9,0,2927,2924,3,1.98916e+16,4.63,115.291,2927,6,7,2912,2900,2898,2854,2558
18031,197,1211,15974,2057,0,18031,4.15413e+18,185.283,2456.8,18031,296,133,16657,15364,14251,13447,1729
8337,19,32,0,8337,7937,400,2.4633e+16,22.3295,296.803,8337,21,22,8287,8266,7721,7993,6777
6983,115,320,0,6983,1619,5364,7.30219e+15,97.3403,1057.7,6983,144,76,6650,6517,6345,5991,4893
19786,304,682,5160,14626,0,19786,2.94458e+13,180.38,1891.89,19786,106,131,19104,19002,17819,18341,12041
29829,828,1171,27817,2012,27817,2012,6.94056e+17,582.761,3697.7,29829,300,219,28658,27597,28112,27797,23416
39080,346,491,39080,0,39080,0,5.03704e+18,315.617,2696.64,39080,209,162,38559,38181,36660,34930,33484
47629,883,1490,42904,4725,42904,4725,2.51844e+18,623.39,5279.92,47629,529,201,46105,45525,44269,43929,26827
11841,91,810,0,11841,2530,9311,5.95187e+15,72.5967,1912.69,11841,290,65,10988,10703,10326,5203,2626
40068,45,102,0,40068,39938,130,2.20177e+16,34.3666,1064.31,40068,45,33,39957,39919,39251,38795,35481
34432,572,1253,30137,4295,0,34432,3.98347e+18,312.232,4030.32,34432,283,178,33179,33168,32169,32229,23868
34705,30,39,0,34705,34678,27,1.33568e+16,9.54093,697.297,34705,18,10,34666,34666,34446,34507,32141
39877,325,1837,7504,32373,0,39877,2.50816e+13,332.866,4886,39877,527,189,37761,36753,35612,36026,11555
21604,470,1118,18897,2707,0,21604,3.8942e+18,272.862,3033.29,21604,238,159,20486,20446,19867,19779,14185
47009,941,1477,0,47009,10867,36142,7.17035e+15,247.47,4592.05,47009,395,159,45532,45520,45492,45525,40474
17999,958,1402,0,17999,0,17999,1.81089e+18,190.393,2973.71,17999,226,156,16597,16597,16597,16590,14689
47519,467,491,47519,0,47519,0,5.14478e+18,313.181,2940.4,47519,223,166,47028,47021,46966,46939,46828
21311,3980,4073,20804,507,0,21311,6.26061e+18,13.9858,4502.3,21311,520,22,17238,17238,17147,17153,16930
39465,355,1326,8650,30815,0,39465,1.81948e+13,401.005,4270.51,39465,356,211,37839,36886,35852,31120,18208
20697,137,629,0,20697,0,20697,4.1499e+18,291.966,1991.22,20697,169,129,19423,18986,14612,8541,8370
40237,952,983,9696,30541,0,40237,2.31728e+13,264.518,3641.35,40237,383,155,39254,39254,39253,39251,39217
18016,621,966,18016,0,16240,1776,8.42567e+17,490.354,2400.74,18016,431,104,16930,16053,16077,16799,13606
35040,1306,2204,0,35040,0,35040,1.54206e+18,372.059,5448.89,35040,550,233,32836,32740,32303,29475,19917
48769,82,98,0,48769,48581,188,2.21024e+16,34.0388,1165.02,48769,43,35,48671,48667,48302,47980,45689
12640,719,1086,2463,10177,0,12640,2.32926e+13,96.091,2364.25,12640,293,122,11554,11554,11415,11554,7816
15883,302,683,14220,1663,0,15883,3.82803e+18,243.642,1879.85,15883,125,138,15197,14972,13994,13731,9142
11360,4,12,11216,144,11360,0,1.00697e+14,6.91004,204.085,11360,9,9,11159,11079,10597,10537,8259
2793,40,371,2636,157,0,2793,2.16564e+18,83.6699,698.054,2793,126,63,2211,2089,1776,1669,348
39177,9,78,0,39177,38738,439,2.50658e+16,46.056,943.61,39177,35,44,37388,36253,33659,32434,14909
44345,925,932,0,44345,10737,33608,6.92799e+15,233.409,3875.37,44345,352,153,43413,43413,43413,43413,43375
49028,38,45,0,49028,48669,359,2.57613e+16,39.0778,771.855,49028,35,35,48954,48807,48655,48803,46899
31220,380,889,31220,0,23481,7739,8.96626e+17,353.172,3030.37,31220,227,178,30243,28942,27796,25088,12341
20953,531,633,18405,2548,18405,2548,3.27435e+18,295.136,2564.5,20953,247,168,20320,20315,20195,20111,18215
27561,15,816,6033,21528,0,27561,1.8935e+13,423.577,2876.29,27561,310,174,20210,17613,14997,6563,4394
26944,5,8,26724,220,26944,0,1.07298e+14,7.43442,303.374,26944,8,8,26881,26830,26215,26215,21819
22254,157,849,19926,2328,0,22254,3.82694e+18,254.313,2351.85,22254,149,149,20686,19078,18310,17636,6511
26241,965,1183,24598,1643,24598,1643,5.94525e+17,548.038,3455.74,26241,335,197,25058,24428,24852,24808,22981
47741,578,9071,47741,0,47741,0,2.93959e+18,16.9699,9853.71,47741,1149,25,38670,38670,30272,38097,3701
3050,25,197,0,3050,853,2197,1.60895e+16,44.4679,499.429,3050,49,51,2723,2412,2353,2313,835
34045,455,504,34045,0,34045,0,3.15408e+18,291.962,2398.13,34045,198,138,33541,33532,33262,33288,32053
34273,1,11,34076,197,34273,0,1.02594e+14,8.97701,365.475,34273,10,10,17609,17609,17609,17609,17609
17147,298,738,3733,13414,0,17147,1.82874e+13,282.764,2234.97,17147,233,134,16255,15941,15522,12973,10336
47900,56,1783,0,47900,0,47900,1.27011e+18,721.961,5465.18,47900,490,266,38020,31987,30594,28900,7478
38058,135,1646,34578,3480,34578,3480,1.29626e+18,734.927,4976.54,38058,570,184,32248,29557,24281,27679,6122
16562,340,423,0,16562,4260,12302,6.24349e+15,214.03,1811.56,16562,244,100,16139,16125,15708,15802,12611
31921,265,973,28111,3810,28111,3810,1.71524e+18,393.703,3735.28,31921,279,190,30099,28975,28025,27807,12236
28210,26,824,0,28210,6128,22082,4.85843e+15,382.629,2884.19,28210,300,169,22581,19074,18264,15783,4975
7225,350,567,7225,0,6344,881,1.21576e+18,185.376,1502.75,7225,145,116,6658,6536,6455,6284,5536
28375,1342,1656,25279,3096,0,28375,3.97602e+18,243.634,3664.95,28375,210,197,26719,26719,26711,26714,25742
12159,435,608,0,12159,3088,9071,7.69907e+15,218.697,1619.54,12159,190,92,11551,11547,11196,10478,8848
31276,365,376,31276,0,31276,0,3.54872e+18,260.179,2110.6,31276,139,215,30900,30900,30879,30875,30714
13781,748,1442,13407,374,13407,374,3.1558e+18,277.681,2673.5,13781,272,109,12339,12277,11014,10480,6919
29255,207,1281,29255,0,27296,1959,1.02021e+18,529.212,3685.53,29255,342,209,26812,25817,22139,20821,13636
2278,19,91,2278,0,2278,0,2.77577e+18,45.7252,297.836,2278,70,16,2106,2052,1682,1747,1439
44805,267,2317,44805,0,34529,10276,9.22637e+17,325.159,5320.52,44805,303,305,41876,40594,36131,35326,15179
11671,638,1401,10491,1180,0,11671,3.30167e+18,181.183,2774.13,11671,354,176,10270,10223,10032,10072,4045
24196,1490,1939,20407,3789,20313,3883,2.61518e+18,376.401,4308.42,24196,348,222,22257,22257,22104,21915,17127
19380,304,763,0,19380,0,19380,4.11257e+18,257.902,2076.73,19380,163,144,18564,17982,17175,12903,9543
35913,1103,1190,33522,2391,33522,2391,2.0511e+18,605.817,3971.39,35913,330,211,34723,34719,34622,34642,34166
27955,699,1630,0,27955,0,27955,1.41453e+18,231.366,4203.54,27955,427,131,26325,26195,25661,13668,12673
34613,618,1119,30985,3628,30985,3628,8.87689e+17,307.001,3283.71,34613,171,176,33494,33436,33197,33340,25136
36465,1489,2053,31647,4818,0,36465,4.61552e+18,503.377,5188.24,36465,533,234,34412,34412,34284,34373,27260
39562,23,75,0,39562,39210,352,2.53901e+16,44.8054,942.664,39562,40,43,39344,39238,37601,36367,28170
24697,398,674,5476,19221,0,24697,1.93743e+13,330.037,2372.98,24697,224,140,23949,23438,23263,22726,20677
11959,582,921,11127,832,0,11959,2.53025e+18,422.466,2272.99,11959,243,168,11025,10504,10618,10493,7482
12014,1008,1083,0,12014,0,12014,1.59233e+18,178.441,2437.54,12014,297,89,10931,10931,10922,10931,10476
43920,1841,2425,0,43920,0,43920,1.89042e+18,300.585,5805.14,43920,482,298,41495,41495,38796,30885,27909
12767,312,425,0,12767,3564,9203,1.6055e+16,137.084,1253.19,12767,89,94,12342,12330,12224,12250,9654
38881,28,88,0,38881,38303,578,2.49527e+16,42.0473,1013.82,38881,42,38,38695,38607,36591,37184,22791
14481,550,597,10884,3597,10884,3597,3.84444e+18,260.133,1741.37,14481,143,132,13884,13882,13876,13876,13276
34839,1008,1292,31105,3734,31103,3736,9.58982e+17,311.723,3574.05,34839,169,182,33547,33546,33396,33502,30210
38505,2084,2527,34838,3667,0,38505,3.36872e+18,442.947,6010.2,38505,592,255,35978,35928,35560,35703,33795
49376,935,1664,44409,4967,0,49376,3.19909e+18,584.204,5363.2,49376,627,207,47712,46800,45037,44920,34683
36003,9,12,35624,379,36003,0,9.74293e+13,9.94956,366.773,36003,11,11,35981,35970,34880,34879,32224
20689,322,499,5766,14923,0,20689,6.29246e+13,198.104,1600.62,20689,109,105,20190,20109,19917,19992,15796
29879,486,730,26252,3627,26252,3627,3.25319e+18,331.21,3198.16,29879,274,189,29149,29140,28489,28055,20766
15940,615,707,14089,1851,14089,1851,3.61584e+18,246.567,1758.01,15940,101,175,15233,15229,15153,15116,14289
49189,4,12,48536,653,45543,3646,7.96778e+13,6.94155,448.37,49189,9,8,48362,47905,43392,43412,39209
5387,467,712,0,5387,0,5387,1.18492e+18,127.853,1422.75,5387,145,126,4675,4620,4623,4602,3217
29722,1514,2631,21898,7824,0,29722,6.42116e+18,22.171,3358.25,29722,885,880,27091,27091,19314,18200,25609
48850,822,2083,48850,0,40767,8083,9.11994e+17,389.28,6209.3,48850,454,249,46767,46664,43499,42455,21080
37912,409,633,8698,29214,0,37912,2.87678e+13,229.7,3042.09,37912,249,141,37279,37274,36895,37193,28791
14869,22,535,14869,0,14869,0,3.2475e+18,242.527,1965.75,14869,159,134,10477,7935,7478,5136,1604
17802,548,711,0,17802,3815,13987,4.67121e+15,328.4,2257.91,17802,220,153,17091,16841,16808,16935,15263
14373,4,7,14363,10,14373,0,8.05085e+13,6.97001,234.187,14373,7,7,13984,13700,11643,11663,12466
40266,223,2066,40266,0,35949,4317,8.9743e+17,428.054,5694.17,40266,546,173,35964,33007,29037,12360,5323
32027,306,1694,0,32027,6703,25324,6.54932e+15,216.224,4209.7,32027,415,174,30333,29975,28083,17650,10136
27862,229,404,27862,0,27862,0,3.26256e+18,343.844,1672.67,27862,156,159,26583,25391,24760,24979,18441
26349,396,528,26349,0,26349,0,3.15057e+18,277.909,2163.12,26349,163,138,25821,25765,24438,23683,21421
49376,101,1663,43976,5400,0,49376,3.30369e+18,383.151,5657.5,49376,459,213,42054,37291,35603,35990,5986
26142,1098,1194,23546,2596,23546,2596,2.61965e+18,409.66,3575.47,26142,392,169,24948,24945,24948,24948,24652
19127,1,13,19009,118,19127,0,1.04426e+14,7.18665,266.912,19127,9,9,10375,10375,10375,10375,10375
49539,152,778,0,49539,13818,35721,1.60442e+16,270.826,2788.89,49539,194,143,48105,46975,41100,41831,16303
29522,4,15,28233,1289,29522,0,9.54783e+13,10.4098,390.278,29522,12,12,27918,27385,25258,23743,12042
6868,14,346,6868,0,6868,0,3.03454e+18,129.123,988.49,6868,104,92,3581,2217,2090,2006,418
3409,242,382,657,2752,0,3409,1.99858e+13,40.4843,810.46,3409,119,51,3027,3027,3027,3026,2251
35366,2148,2752,32475,2891,32475,2891,1.40526e+18,375.468,5859.86,35366,722,224,32614,32614,31503,31862,27361
33014,3,12,32580,434,33014,0,9.89691e+13,10.9935,352.975,33014,12,11,31803,31230,30316,30409,22046
44071,60,62,0,44071,43781,290,2.68587e+16,44.7304,893.965,44071,40,38,44008,43986,44003,43645,42200
34271,65,81,0,34271,33603,668,2.05423e+16,23.2694,926.781,34271,32,35,34190,34188,33702,33843,33111
34581,1,12,34091,490,32307,2274,7.96868e+13,6.83433,378.12,34581,9,8,20793,20793,20793,20793,20793
35307,68,94,0,35307,34900,407,1.98783e+16,31.7684,980.936,35307,44,33,35213,35210,35179,35203,29319
19711,33,34,0,19711,18822,889,2.45336e+16,28.0658,455.432,19711,25,25,19677,19677,19668,19674,19670
29271,1199,1255,29271,0,25656,3615,1.01914e+18,386.052,4131.68,29271,375,179,28016,28016,27999,27978,27604
34369,466,863,30349,4020,0,34369,3.8092e+18,352.818,3578.24,34369,298,182,33506,33410,32222,32405,19216
17112,14,63,0,17112,16998,114,2.63605e+16,33.8636,557.553,17112,32,32,16751,16449,15534,15249,9266
46824,108,729,0,46824,10680,36144,7.32812e+15,243.339,3493.96,46824,272,155,44922,43892,36837,38974,11059
11382,446,628,2848,8534,0,11382,2.91103e+13,313.607,1507.66,11382,234,69,10624,10210,10340,9990,9042
35380,1574,1770,0,35380,0,35380,1.22788e+18,441.235,4904.31,35380,353,246,33610,33600,33513,33514,32041
18329,44,50,0,18329,18090,239,2.53061e+16,39.7771,551.558,18329,34,36,18273,18232,18005,18095,17776
15788,806,1234,0,15788,3600,12188,8.17381e+15,111.392,2314.85,15788,316,139,14554,14554,13633,13603,8604
48912,676,1482,44134,4778,44134,4778,2.51055e+18,620.387,5319.55,48912,531,203,47194,46505,44605,44016,24747
31153,556,1058,0,31153,0,31153,1.25527e+18,499.479,3414.78,31153,317,193,29909,28939,28927,28436,19583
26210,69,1063,6147,20063,0,26210,2.37978e+13,242.494,3201.59,26210,261,153,23825,22389,20886,11899,4909
2418,221,291,2162,256,0,2418,3.87311e+18,100.053,583.667,2418,63,63,2127,2026,2085,2084,1693
10586,547,565,7989,2597,0,10586,8.25468e+18,222.603,1454.24,10586,128,115,10021,10021,10021,10017,9935
5466,176,485,5431,35,0,5466,7.04303e+18,23.8562,951.058,5466,281,36,4981,4980,4722,4157,2583
10500,339,552,0,10500,0,10500,1.81166e+18,275.373,1755.96,10500,193,120,9907,9677,9378,9161,6409
16307,1793,1799,14128,2179,14128,2179,5.51284e+18,14.5389,2689.85,16307,487,26,14508,14508,14502,14505,14494
13460,248,984,12558,902,0,13460,2.4166e+18,422.251,2438.66,13460,268,166,12065,11659,11039,10898,6394
2240,85,160,2240,0,2240,0,5.47686e+18,15.6839,381.137,2240,81,16,2080,2080,2005,2077,1263
1533,70,149,337,1196,0,1533,1.43207e+13,62.6106,363.902,1533,56,36,1369,1255,1293,1251,867
31200,638,1812,31200,0,27895,3305,1.43366e+18,251.21,4252.71,31200,465,153,29388,29277,26117,28213,10109
31003,32,1396,0,31003,7596,23407,7.6648e+15,182.103,3162.34,31003,382,145,27437,26172,23095,23521,4121
27044,1226,1305,25210,1834,25210,1834,6.66597e+17,652.139,3718.25,27044,361,206,25739,25739,25724,25730,25244
26186,378,804,0,26186,5720,20466,4.81296e+15,410.34,2776.96,26186,304,163,25169,24546,24141,22689,17060
21180,44,1577,19787,1393,0,21180,2.40336e+18,403.294,3773.83,21180,336,185,16206,13013,12421,12279,2980
4920,213,354,4405,515,0,4920,3.83301e+18,145.882,863.266,4920,80,86,4566,4247,4312,4310,2957
22375,158,1465,0,22375,0,22375,1.51376e+18,278.656,3540.86,22375,402,96,20302,19332,18688,9372,5778
3530,4,358,3167,363,3167,363,3.20145e+18,104.514,740.048,3530,76,75,1048,368,517,624,91
34234,37,60,0,34234,34015,219,2.67675e+16,34.2831,694.323,34234,31,34,34155,34064,33508,33967,27780
26298,663,841,0,26298,5842,20456,5.7939e+15,273.475,2853.45,26298,313,112,25457,25390,25332,25391,18012
32060,9,13,31836,224,32060,0,1.01651e+14,11.6234,349.755,32060,12,11,32033,32026,30857,30857,30477
22117,1045,1507,0,22117,4666,17451,7.22621e+15,154.085,3306.46,22117,452,108,20610,20608,19896,20228,17200
40017,352,992,30186,9831,0,40017,8.26955e+18,355.244,3127.97,40017,227,182,38900,37446,35573,35293,20583
49104,1445,1931,0,49104,0,49104,1.22431e+18,598.49,5938.86,49104,470,276,47173,47150,46432,45785,37715
21022,449,1787,21022,0,20648,374,9.28885e+17,350.429,3595.67,21022,299,122,19119,18066,17569,10647,6958
6523,814,841,0,6523,0,6523,1.13975e+18,161.946,1667.54,6523,154,110,5682,5682,5681,5682,5623
48805,1985,2549,0,48805,0,48805,1.74566e+18,355.253,6503.89,48805,550,262,46256,46252,46127,46201,41062
6984,589,638,1400,5584,0,6984,2.49897e+13,69.6594,1379.99,6984,200,60,6346,6346,6344,6345,5527
42119,2,8,42063,56,42119,0,4.44414e+13,5.46278,446.315,42119,7,6,36409,34025,27891,28258,25863
15908,412,583,14000,1908,14000,1908,3.2375e+18,301.247,2195.61,15908,210,146,15325,15045,14882,14796,10554
31020,7,34,0,31020,29576,1444,2.45118e+16,31.0348,579.95,31020,28,30,29469,28363,21556,26516,15968
29396,35,74,0,29396,29102,294,2.55815e+16,31.023,721.093,29396,32,32,29314,29266,28537,28328,21829
47785,1,11,47263,522,36979,10806,7.43082e+13,7.71799,486.609,47785,9,9,27010,27010,27010,27010,27010
45717,1281,2029,41806,3911,41803,3914,1.0404e+18,647.936,5980.49,45717,408,275,43688,43542,43373,43401,35906
37117,165,1249,34589,2528,34589,2528,2.09452e+18,640.862,4081.47,37117,399,218,33730,31846,29132,29696,12311
32807,326,1336,32807,0,30648,2159,9.99102e+17,651.97,4024.39,32807,414,221,30366,29438,25835,23574,17043
22671,973,1153,22671,0,19959,2712,9.03759e+17,364.892,3456.81,22671,365,151,21518,21510,21447,21514,20871
35724,425,1449,0,35724,5831,29893,5.23485e+15,327.133,4147.69,35724,542,101,34184,33663,33066,30730,14434
38380,1257,1380,34510,3870,0,38380,3.36098e+18,476.042,4434.94,38380,501,177,37000,37000,37000,37000,36393
29523,58,1608,7876,21647,0,29523,5.51123e+13,204.171,3693.42,29523,313,159,26925,25843,22192,12286,6015
3050,218,282,2834,216,0,3050,2.59678e+18,117.081,685.208,3050,83,64,2768,2759,2723,2725,2446
30233,678,756,22768,7465,22768,7465,3.81527e+18,353.095,2644.73,30233,207,168,29477,29475,29448,29447,28641
38430,300,2157,8084,30346,0,38430,2.41487e+13,315.486,5201.74,38430,609,189,35833,35049,30671,9954,7001
25131,7,13,24880,251,25131,0,9.66924e+13,11.1605,311.886,25131,11,11,25099,25094,23992,23986,21424
21774,513,1094,0,21774,3915,17859,4.57767e+15,174.048,2948.25,21774,334,96,20680,20543,20221,19898,13139
10128,101,507,10128,0,7626,2502,8.92334e+17,149.584,1327.26,10128,114,117,9511,9275,8057,7624,2810
12032,359,730,0,12032,3053,8979,7.03723e+15,246.213,1716.34,12032,352,88,11247,10923,10781,11055,9223
44192,1980,2517,40095,4097,40095,4097,2.79496e+18,350.84,6314.4,44192,563,251,41675,41670,41511,41586,34784
26065,568,1142,23569,2496,23569,2496,2.40738e+18,403.148,3520.38,26065,372,158,24923,24712,23563,22777,14781
20186,690,909,0,20186,3328,16858,5.90479e+15,308.674,2676.38,20186,308,106,19277,19277,19131,17529,17481
9092,1036,1089,8218,874,8217,875,1.66122e+18,105.202,2150.64,9092,273,91,8003,8003,8003,8003,7794
11925,34,722,0,11925,1612,10313,6.41715e+15,92.8677,1846.68,11925,292,58,10301,9321,8710,9753,1914
48868,1,14,48031,837,48861,7,1.07157e+14,11.0252,404.486,48868,13,12,27920,27920,27920,27920,27920
10561,170,756,9878,683,9878,683,2.04421e+18,223.281,1793,10561,293,83,9569,9368,8936,8553,4257
46934,760,1023,10654,36280,0,46934,2.31138e+13,408.107,4066.95,46934,427,155,45911,45639,45635,45487,34377
18275,224,592,16210,2065,18275,0,3.74957e+18,263.527,2209.42,18275,226,140,17499,16969,15175,12888,10404
49992,1,13,49406,586,49992,0,9.79241e+13,11.2651,434.279,49992,12,12,27901,27901,27901,27901,27901
3989,4,7,3985,4,3989,0,8.35466e+13,6.74054,122.934,3989,7,7,3877,3820,3328,3329,3025
21513,899,945,0,21513,0,21513,1.50918e+18,343.072,3040.02,21513,306,156,20568,20568,20568,20568,20480
38681,533,847,0,38681,9013,29668,5.63529e+15,326.152,3514.8,38681,382,144,37834,37620,36418,36785,24249
33841,780,1210,0,33841,0,33841,1.43309e+18,572.686,4190.32,33841,446,167,32631,32184,31042,31067,19314
40653,1600,3608,40653,0,29895,10758,4.02349e+18,22.9858,4483.21,40653,1212,1205,37045,37045,33700,33701,34377
48854,1246,1905,45721,3133,45721,3133,6.82142e+17,755.004,5791.23,48854,437,290,46949,46701,45998,46457,36327
3337,1,19,0,3337,3334,3,1.96718e+16,3.59994,134.556,3337,8,9,2097,2097,2097,2097,2097
33505,611,901,8714,24791,0,33505,2.94813e+13,210.107,2632.96,33505,124,151,32604,32575,31730,31990,26583
15767,111,579,13853,1914,0,15767,3.89109e+18,301.493,2182.77,15767,225,147,13914,11643,11391,11320,4136
32750,1113,1791,32750,0,30205,2545,8.12164e+17,340.64,4785.3,32750,572,153,30959,30959,30733,30840,17215
28351,1518,1562,25357,2994,25357,2994,3.26405e+18,238.13,3730.11,28351,419,157,26789,26789,26759,26750,26230
46423,269,908,35003,11420,35003,11420,3.79853e+18,408.75,3397.72,46423,266,197,44606,42870,42718,41746,20083
42305,130,1653,9986,32319,0,42305,2.79239e+13,228.3,4441.58,42305,327,177,40012,38046,34775,34326,11053
22439,293,437,22439,0,22439,0,5.02548e+18,292.353,2067.21,22439,187,148,21928,21633,20610,19661,17591
17963,39,66,0,17963,17784,179,2.55209e+16,27.1144,628.332,17963,31,35,17897,17876,17585,17588,16060
27566,247,510,26529,1037,27566,0,3.91167e+18,250.947,2296.3,27566,178,154,26998,26700,25465,24432,21115
37657,398,1430,35192,2465,35192,2465,2.04277e+18,613.108,4386.31,37657,322,204,35458,34299,33745,32150,12978
10606,59,590,0,10606,0,10606,1.94612e+18,190.515,1485.58,10606,96,113,9186,8704,8258,6582,1527
27753,286,1134,5972,21781,0,27753,1.92092e+13,314.164,3380.38,27753,292,182,26407,25879,24802,20538,11429
32809,140,625,32809,0,31412,1397,4.98679e+17,448.488,3075.94,32809,266,176,28545,24293,22688,13048,17618
11554,341,515,8727,2827,0,11554,8.22362e+18,239.015,1438.71,11554,127,114,11039,10687,10853,10824,7973
16213,744,975,0,16213,0,16213,1.45307e+18,372.001,2481.81,16213,384,111,15238,15109,15103,14383,14026
15575,461,1106,13754,1821,13754,1821,1.68445e+18,301.764,2694.32,15575,240,130,14469,13553,12506,12869,10624
34195,168,738,34131,64,34195,0,3.03852e+18,335.409,3215.4,34195,242,153,31973,29666,25612,21363,13555
4876,274,327,4876,0,4876,0,4.83676e+18,127.044,928.674,4876,108,80,4549,4518,4467,4415,4205
49667,700,1444,44844,4823,0,49667,2.98723e+18,617.528,5288.61,49667,526,195,48007,47318,45559,45405,28179
48946,141,1042,36915,12031,36915,12031,6.99057e+18,372.778,3481.33,48946,257,189,46171,44970,33092,24610,12721
31945,4,91,0,31945,31294,651,1.95229e+16,24.9058,890.472,31945,37,36,30053,29132,25625,24371,15203
37824,989,1259,0,37824,8260,29564,4.84278e+15,374.844,4014.15,37824,343,184,36565,36556,36471,36452,34142
963,86,184,911,52,911,52,5.15232e+17,67.7549,342.314,963,51,40,758,656,678,705,502
47305,1380,2055,0,47305,0,47305,2.03739e+18,327.136,5019.61,47305,402,327,45250,45248,42920,30399,31149
6849,65,467,1466,5383,0,6849,1.96437e+13,116.209,1155.17,6849,139,102,6070,5429,5303,4997,2371
33427,1281,1566,29872,3555,29872,3555,1.41166e+18,424.89,4536.47,33427,437,169,31861,31818,31751,31851,27603
10227,363,478,9172,1055,9172,1055,3.20847e+18,202.294,1348.39,10227,103,114,9749,9729,9579,9576,8129
17716,1015,1319,15915,1801,0,17716,3.70952e+18,167.119,2804.66,17716,399,114,16397,16397,15853,15863,12138
29954,71,537,29954,0,29954,0,3.13888e+18,282.583,2264.56,29954,177,134,27962,26397,17917,17229,5301
45234,612,674,45234,0,45234,0,3.41163e+18,323.683,3627.99,45234,229,201,44560,44555,44494,44442,43823
24649,670,972,21663,2986,0,24649,3.73678e+18,291.892,3201.51,24649,307,168,23677,23676,22899,22983,15033
3631,19,234,1005,2626,0,3631,6.18622e+13,41.0069,568.668,3631,51,55,3072,2426,2629,1667,850
15914,129,280,15914,0,15914,0,3.76973e+18,218.755,1450.98,15914,120,139,14920,13938,12293,11348,7495
42764,198,2343,39789,2975,39789,2975,2.19355e+18,528.003,5788.87,42764,742,144,39262,38749,35505,34425,12185
38271,4,13,37997,274,38271,0,9.87823e+13,11.2446,384.593,38271,13,12,37736,37519,34934,35583,26469
7549,458,899,7091,458,7091,458,1.06985e+18,96.6393,1633.5,7549,198,70,6650,6643,6365,6603,5056
43025,691,1302,40100,2925,40100,2925,2.09702e+18,641.21,4464.51,43025,396,229,41406,39818,39753,39287,29949
6209,214,629,0,6209,1338,4871,5.35075e+15,73.2517,1440.5,6209,186,81,5580,5519,5262,3589,2438
41356,2502,2688,5337,36019,0,41356,4.49755e+12,11.8904,5104.81,41356,1345,13,38668,38668,38483,37451,37034
8699,262,611,1922,6777,0,8699,1.92854e+13,128.843,1518.89,8699,168,89,8088,7975,7853,6623,5898
16676,571,866,0,16676,3489,13187,4.54602e+15,196.148,2406.7,16676,269,117,15810,15795,15666,15738,12123
41106,251,1107,0,41106,0,41106,1.8654e+18,344.871,4241.47,41106,322,215,39247,37853,31234,18235,8883
19742,152,898,18404,1338,18404,1338,5.96709e+17,383.684,2575.6,19742,265,174,18098,16972,14951,16040,8599
8899,87,482,0,8899,0,8899,4.15315e+18,187.622,1235.87,8899,114,99,8192,7970,5992,3780,2823
31880,291,1935,28946,2934,28946,2934,8.28663e+17,336.838,4741.13,31880,358,227,29586,29021,27636,27066,7593
9468,578,606,8464,1004,0,9468,3.88122e+18,172.889,1426.92,9468,95,111,8862,8862,8820,8808,8573
13807,130,902,0,13807,1782,12025,1.39678e+16,11.8845,1794.21,13807,454,12,12905,12905,8876,9199,5993
23990,19,53,0,23990,23861,129,2.06772e+16,25.5434,594.876,23990,30,30,23807,23652,20334,20942,13637
25807,21,41,0,25807,25754,53,1.84731e+16,21.7642,598.173,25807,25,20,25760,25749,25479,25700,21376
20503,72,84,0,20503,20240,263,1.90697e+16,24.0777,684.996,20503,36,33,20419,20419,20414,20416,17339
4127,13,600,0,4127,0,4127,3.27439e+17,165.179,1073.74,4127,158,75,2637,1529,1859,957,228
13553,816,997,13553,0,13553,0,4.3748e+18,15.8924,1942.47,13553,440,25,12556,12556,12388,12556,11760
41245,323,1880,37024,4221,37021,4224,1.10858e+18,294.551,4760.27,41245,477,178,39212,38560,36313,35600,10061
26448,959,1148,24621,1827,24621,1827,2.10474e+18,568.546,3501.22,26448,334,189,25300,25191,24994,24957,23877
39166,4,15,38164,1002,36026,3140,7.90684e+13,6.42948,377.772,39166,9,10,38982,38882,36824,36831,29844
27419,1551,1584,27419,0,24732,2687,7.5755e+17,388.039,4158.18,27419,431,156,25835,25829,25833,25829,25739
16624,250,308,16624,0,16624,0,4.88412e+18,195.976,1520.53,16624,151,120,16310,16183,15638,15523,14922
30436,295,784,6827,23609,0,30436,1.85972e+13,384.784,2745.88,30436,274,170,29344,28682,27809,27120,15937
5791,201,510,5791,0,5211,580,7.1356e+17,271.653,1281.26,5791,218,95,4971,4464,4053,4103,3160
39166,52,582,36311,2855,39166,0,3.56697e+18,315.346,3138.26,39166,281,157,34120,31342,25288,19693,6828
46305,1010,7178,46305,0,46305,0,5.2069e+18,178.434,10336,46305,1485,19,39127,38936,37018,18499,14046
17348,430,445,17348,0,17348,0,4.25431e+18,217.062,1833.08,17348,130,144,16903,16903,16885,16886,16739
35583,32,36,0,35583,33910,1673,2.46289e+16,29.8368,623.174,35583,30,29,35545,35534,35403,35463,34871
31097,641,1381,4999,26098,0,31097,2.0884e+13,317.094,3768.65,31097,524,100,29716,29241,29036,28897,18175
39426,52,385,10326,29100,0,39426,1.23401e+13,274.428,2541.04,39426,230,138,34224,31444,32387,18036,10129
22642,617,893,19836,2806,0,22642,3.45158e+18,306.001,3123.21,22642,323,164,21749,21740,21270,21361,16148
39902,70,91,0,39902,39621,281,2.47584e+16,50.2641,1065.18,39902,46,43,39811,39801,38660,37404,31145
2816,284,553,2816,0,2816,0,1.46554e+18,16.8033,721.553,2816,81,25,2263,2263,2042,2263,1210
4845,55,429,3645,1200,3645,1200,3.83068e+18,88.04,930.092,4845,89,82,4242,3550,3249,3355,1018
28344,430,842,6513,21831,0,28344,2.31784e+13,237.124,3011.49,28344,367,133,27502,27367,26160,26521,18509
45249,408,482,45249,0,45249,0,5.15338e+18,315.086,2879.12,45249,215,169,44767,44747,44321,43785,43173
33867,12,66,0,33867,33648,219,2.64086e+16,46.7616,810.604,33867,38,39,32992,32037,30460,30136,21348
40039,742,754,39975,64,40039,0,3.07169e+18,354.189,3508.88,40039,247,168,39285,39285,39285,39284,39229
11008,268,1043,11008,0,10205,803,9.4626e+17,245.607,2214.56,11008,322,141,9813,9547,8411,5330,2603
24583,586,698,21621,2962,21621,2962,3.223e+18,328.061,2861.91,24583,264,182,23885,23884,23766,23732,22011
636,8,15,0,636,636,0,2.93442e+16,4.1195,59.2564,636,8,7,621,618,599,615,533
28805,4529,5505,28805,0,28805,0,2.01268e+18,16.9755,6081.39,28805,698,26,23300,23300,23300,23300,19336
17541,181,604,13223,4318,0,17541,8.26025e+18,263.456,1789.13,17541,147,131,16614,16255,14214,14200,6794
22195,266,691,19615,2580,0,22195,3.7751e+18,330.409,2698.72,22195,256,162,21143,20452,17962,18502,8063
36303,802,1607,33872,2431,33872,2431,2.0746e+18,601.614,4634.36,36303,379,205,34640,33583,33602,33195,28966
4580,71,212,0,4580,1095,3485,7.62423e+15,80.6924,738.787,4580,111,64,4240,3799,3998,4051,2647
26496,170,822,0,26496,5819,20677,4.7485e+15,427.367,2838.67,26496,342,164,24808,24371,22986,20859,11390
33770,1587,1713,0,33770,0,33770,4.07418e+18,293.354,3964.07,33770,300,190,32057,32057,32057,32057,31691
23501,1776,2080,21151,2350,21151,2350,9.82773e+17,202.045,4247.58,23501,412,198,21421,21420,21421,21421,19124
44606,7,12,44003,603,44606,0,9.83075e+13,10.2947,407.874,44606,12,12,44566,44553,42933,42937,40815
46332,449,1639,46332,0,40767,5565,1.0293e+18,395.02,5584.93,46332,402,209,44468,42283,39815,31694,14404
38024,509,1603,38024,0,34110,3914,7.55984e+17,522.537,4887.92,38024,437,187,36239,35679,31807,28466,17932
21037,10,47,0,21037,20953,84,2.58266e+16,19.7545,500.466,21037,22,23,20909,20842,18906,20230,13861
48212,3461,6016,0,48212,6545,41667,8.05269e+15,70.0608,7816.25,48212,1367,22,42196,42134,31534,32034,23773
4069,200,258,4069,0,4069,0,3.78298e+18,137.354,737.764,4069,77,78,3811,3746,3682,3657,3351
34193,1526,4576,34193,0,34193,0,5.62663e+17,16.5214,5984.52,34193,960,25,29617,29617,27396,29244,17095
29462,1233,1312,29462,0,26385,3077,7.87152e+17,461.403,3791.3,29462,403,154,28150,28145,28054,28138,27812
3615,120,279,3615,0,3615,0,5.01011e+18,121.128,762.182,3615,98,66,3284,3202,2559,2401,1792
16318,267,409,16318,0,16318,0,4.95659e+18,246.416,1700.43,16318,165,131,15852,15625,14773,14176,12729
25163,57,77,0,25163,24908,255,2.47705e+16,45.1355,773.666,25163,35,43,25086,25056,24723,24700,22173
15971,2,33,0,15971,15200,771,2.46886e+16,26.6882,407.158,15971,25,24,11043,9259,9495,10232,6802
24686,299,787,0,24686,5354,19332,4.47496e+15,395.264,2732.58,24686,310,170,23501,22783,22387,20674,13929
49444,661,1047,0,49444,0,49444,4.13202e+18,375.484,3486.77,49444,254,191,48397,48311,47441,37040,38484
6437,421,1033,5853,584,5853,584,1.33996e+18,158.169,1823.74,6437,308,69,5404,5111,5060,4941,2942
5676,244,403,0,5676,0,5676,1.9336e+18,171.419,978.784,5676,85,90,5273,4917,5032,4952,3510
48181,636,1249,48181,0,42324,5857,1.16982e+18,417.568,4947.03,48181,340,232,46932,46909,44371,38763,27532
48001,1947,2497,0,48001,0,48001,1.811e+18,334.841,6237.96,48001,540,300,45504,45504,43316,37097,34012
36288,1235,2672,33169,3119,33168,3120,1.25601e+18,436.663,6189.29,36288,594,249,33616,33539,31684,32203,16091
18566,16,63,0,18566,18457,109,2.74088e+16,25.7445,572.181,18566,31,30,18312,18025,17282,16784,13645
4875,383,403,4362,513,4362,513,8.65095e+17,159.356,921.193,4875,85,87,4472,4472,4468,4467,4419
30071,306,825,6489,23582,0,30071,1.84543e+13,407.536,2985.92,30071,277,175,28794,27959,27453,24441,16965
19213,549,829,0,19213,4123,15090,5.63323e+15,211.244,2495.33,19213,359,100,18384,18313,17789,18019,11401
28422,2428,2560,0,28422,0,28422,1.12722e+17,14.7036,4124.18,28422,881,22,25862,25862,25734,25734,25403
34688,1643,2335,34688,0,31608,3080,1.01074e+18,411.827,5586.72,34688,664,133,32353,32352,32204,32268,28609
48395,2452,2490,44853,3542,0,48395,2.73217e+18,477.229,6795.61,48395,767,150,45905,45905,45905,45905,45626
11557,18,27,0,11557,11537,20,1.34801e+16,17.3488,360.111,11557,21,20,11517,11363,11394,11385,9534
32135,265,1738,29027,3108,29023,3112,1.33898e+18,337.323,4361.16,32135,524,180,29930,29305,27055,27403,3447
36703,196,987,27659,9044,27659,9044,3.80946e+18,376.462,3165.11,36703,233,182,34669,33434,30184,30981,12530
10775,107,518,8108,2667,8108,2667,7.06453e+18,214.082,1376.87,10775,125,106,10004,9787,7557,6292,3628
33134,1652,1715,33134,0,29528,3606,1.73686e+18,274.387,3982.3,33134,238,233,31419,31419,31386,31329,31262
48840,169,516,48840,0,48840,0,5.11286e+18,301.051,2968.22,48840,215,165,47419,46119,34958,32163,25382
31363,158,469,31363,0,31363,0,5.04099e+18,248.465,2445.96,31363,203,164,30436,29752,24488,23013,18794
17803,182,729,0,17803,3934,13869,4.75173e+15,228.954,2225.29,17803,213,116,16871,16562,15929,14842,9519
18111,165,806,0,18111,3991,14120,4.70283e+15,239.148,2365.12,18111,250,113,17044,16707,16060,13683,7941
45481,12,13,45168,313,45481,0,1.00352e+14,12.1283,420.219,45481,13,12,45463,45451,43729,43729,45325
10781,842,1077,10002,779,0,10781,2.47444e+18,271.207,2282.01,10781,296,103,9704,9638,9618,9651,8685
26745,1231,2002,188,26557,0,26745,5.13437e+11,16.4326,3771.46,26745,363,21,24743,24743,23958,23878,16851
45475,407,1649,9338,36137,0,45475,1.97969e+13,356.044,5148.58,45475,445,112,43497,43139,41537,25735,16176
18468,279,752,16216,2252,16216,2252,1.74505e+18,353.981,2638.2,18468,219,158,17364,16802,16309,16036,6597
46387,355,1529,40650,5737,40650,5737,1.73267e+18,409.135,5119.2,46387,378,216,44100,42473,40586,40506,15248
24115,498,506,0,24115,5495,18620,7.34015e+15,213.65,2277.02,24115,210,119,23609,23609,23609,23609,23476
45292,1106,2149,0,45292,10600,34692,7.80412e+15,252.384,4876.01,45292,413,303,43143,43137,37969,38759,19042
22243,71,687,22239,4,22243,0,4.3107e+18,254.213,2504.35,22243,182,118,19975,18101,12510,11797,3422
7547,325,392,7547,0,7547,0,3.39577e+18,188.181,1282.7,7547,134,102,7155,7100,7066,7018,6735
7390,465,492,5962,1428,5962,1428,6.55193e+18,14.8487,1040.63,7390,247,15,6898,6898,6872,6690,6664
16331,502,538,16331,0,16331,0,2.92359e+18,248.534,1996.86,16331,182,120,15793,15787,15759,15752,15592
34267,619,2209,26767,7500,26673,7594,3.46656e+18,296.104,4926.31,34267,369,244,32058,31762,30470,31383,23555
48547,186,1480,45415,3132,45415,3132,2.01397e+18,687.313,4978.76,48547,421,267,44761,43099,39370,39386,17642
23304,573,2062,21397,1907,0,23304,3.05805e+18,204.667,4105.21,23304,549,211,21242,21074,20534,20119,6739
12323,641,1108,11171,1152,11171,1152,2.89248e+18,265.85,2167.14,12323,390,117,11215,10943,10660,10367,9534
3206,127,380,630,2576,0,3206,2.0371e+13,52.6569,842.409,3206,107,42,2826,2789,2675,1612,1485
4934,181,275,4934,0,4934,0,3.32099e+18,94.2815,756.451,4934,69,82,4659,4609,4313,4390,3224
7281,381,429,6378,903,6378,903,2.68087e+18,295.346,1343.75,7281,208,97,6820,6141,6737,6773,6440
21708,366,1117,0,21708,5321,16387,7.33722e+15,145.998,2619.45,21708,331,105,20591,20388,18479,19126,10228
8052,233,597,1787,6265,0,8052,1.83183e+13,115.172,1467.96,8052,166,104,7455,7339,7181,5870,4681
41151,2,12,40665,486,41151,0,9.83122e+13,10.3078,392.16,41151,12,12,37233,36072,28694,35788,24027
33299,509,2169,28820,4479,28726,4573,2.27274e+18,513.776,5091.95,33299,513,240,30434,29038,25448,28613,6652
35474,127,385,0,35474,9246,26228,3.18996e+15,274.365,2416.25,35474,226,137,33205,30640,31094,31283,22331
39597,410,1378,39597,0,36996,2601,9.3338e+17,659.831,4457.19,39597,425,230,37040,35569,31354,29164,20726
11299,196,269,2935,8364,0,11299,1.15751e+13,190.955,1257.83,11299,162,86,10945,10425,10584,10581,10096
46178,2130,2393,0,46178,0,46178,1.26847e+18,438.536,6452.81,46178,624,135,43785,43785,43635,43785,40452
15173,881,1089,13383,1790,0,15173,4.03157e+18,335.612,2460.33,15173,245,161,14084,14076,14084,14084,13642
14644,498,1152,13578,1066,0,14644,2.62312e+18,424.849,2741.61,14644,267,182,13364,12917,12603,12520,4302
18424,463,1639,18424,0,16962,1462,4.18607e+18,226.643,3179.58,18424,484,143,16785,16592,11363,13039,8421
29085,206,557,8070,21015,0,29085,6.34484e+13,217.94,1966.29,29085,153,120,28427,27700,26679,26272,14743
4115,320,727,3825,290,3825,290,8.57671e+17,155.203,1320.1,4115,139,110,3388,3244,3154,3179,2194
25120,874,898,6265,18855,0,25120,3.24594e+13,255.657,2276.21,25120,107,242,24222,24220,24221,24214,23994
12237,238,927,0,12237,80,12157,1.27745e+14,12.6579,1799.01,12237,283,16,11310,11288,10615,4874,4270
28783,153,447,28783,0,28783,0,5.09583e+18,298.622,2280.03,28783,201,144,27691,26749,19292,17194,13762
42560,2603,3779,42560,0,31292,11268,4.08978e+18,22.9805,4674.97,42560,1268,1269,38781,38781,37217,37217,37222
21665,39,709,0,21665,5060,16605,7.38677e+15,195.584,2349.15,21665,211,113,18699,16724,15619,12441,4229
10442,43,55,0,10442,10369,73,2.78169e+16,16.6807,340.356,10442,30,25,10387,10381,10357,10368,9817
30194,559,1328,28258,1936,28258,1936,2.00436e+18,460.956,3910.69,30194,345,172,28764,27728,27863,27367,21721
48059,861,925,10419,37640,0,48059,1.87482e+13,463.666,3846.47,48059,348,208,47134,47134,47066,47101,46667
39862,124,1139,35146,4716,35146,4716,1.70697e+18,423.444,4358.26,39862,320,224,34878,28292,28213,28986,6568
5468,195,282,0,5468,1517,3951,1.62028e+16,63.457,726.013,5468,64,63,5186,5161,5150,5158,4316
1555,30,248,1527,28,1555,0,3.0305e+18,62.4785,488.886,1555,77,42,1190,999,865,523,440
44908,1436,1731,8245,36663,0,44908,2.17898e+13,516.356,5053.81,44908,493,178,43177,43053,42953,43124,37763
9084,189,641,9084,0,8129,955,1.78242e+18,187.677,1502.31,9084,112,115,8345,7688,6912,7854,3218
18639,323,1054,0,18639,0,18639,1.18963e+18,441.35,2841.68,18639,286,174,17139,16656,16079,14604,10745
31487,659,1205,29373,2114,0,31487,2.42063e+18,592.139,3773.57,31487,366,214,30044,29035,29012,28683,19987
3576,40,193,856,2720,0,3576,2.92079e+13,76.6502,647.369,3576,104,61,3081,2736,2651,2029,1542
15848,94,712,15848,0,13925,1923,1.15442e+18,346.634,2418.9,15848,212,142,13053,10777,9760,4475,3895
11098,270,382,3093,8005,0,11098,6.35606e+13,130.834,1112.38,11098,89,89,10716,10604,10596,10643,8346
46089,519,706,0,46089,10591,35498,7.40434e+15,230.501,3456.56,46089,275,138,45383,45383,45056,45250,37856
7934,486,517,5995,1939,5995,1939,6.96226e+18,153.589,1212.65,7934,119,105,7417,7417,7404,7395,7182
35298,824,872,0,35298,7676,27622,4.83418e+15,458.022,3280.71,35298,338,192,34426,34426,34388,34416,34114
40494,114,847,8790,31704,0,40494,1.84136e+13,444.661,3471.04,40494,327,204,37679,36554,34101,28618,13900
46663,192,1266,0,46663,0,46663,1.85477e+18,342.601,4822.53,46663,403,221,43763,41957,34781,19553,8560
39904,140,495,39904,0,39904,0,3.76386e+18,261.259,2646.07,39904,151,225,38366,36866,29785,26683,17712
17470,365,1228,17470,0,15715,1755,1.26934e+18,190.997,2846.48,17470,412,122,16242,15978,14603,15766,8773
49101,419,2331,0,49101,0,49101,1.77549e+18,290.409,5899,49101,413,256,46757,46248,42937,18085,19485
5134,32,704,4593,541,4593,541,1.19631e+18,222.36,1437.13,5134,199,92,3650,2930,2425,2646,740
45938,115,779,0,45938,12788,33150,1.61577e+16,262.959,2725.36,45938,194,159,44283,43303,37492,38305,13821
45133,281,646,45133,0,43195,1938,5.06068e+17,490.729,3611.2,45133,279,199,43149,39086,34227,12610,33767
20315,251,639,15293,5022,15293,5022,3.81573e+18,314.877,2070.19,20315,165,142,19367,18745,18630,18444,10725
49414,6,11,49120,294,49414,0,1.01747e+14,9.23174,438.255,49414,10,10,49189,48972,46956,46928,47197
42947,304,1660,38852,4095,38852,4095,1.30972e+18,710.545,5307.55,42947,572,195,39220,34474,32357,33850,11983
38247,1050,1881,34145,4102,0,38247,3.78985e+18,271.621,4545.36,38247,259,212,36366,36365,36359,36342,33215
3212,274,306,3027,185,3027,185,1.79807e+18,128.835,724.352,3212,94,61,2906,2906,2892,2894,2835
46635,1160,1230,41045,5590,41045,5590,1.72043e+18,419.79,4830.84,46635,348,209,45405,45405,45385,45390,44076
29461,11,18,28517,944,29461,0,9.65548e+13,9.69468,388.935,29461,16,12,29442,29439,28668,27872,21999
35782,4,13,35505,277,35782,0,9.92346e+13,11.9291,371.095,35782,13,12,35317,35130,32441,33230,25233
47949,9,13,47586,363,47949,0,9.89147e+13,12.0009,430.062,47949,13,13,47910,47897,45958,45958,44364
24222,1054,1147,22623,1599,0,24222,2.39859e+18,470.532,3212.82,24222,296,183,23075,23073,23000,23019,22576
48225,1299,1312,44933,3292,44933,3292,2.09699e+18,725.231,4740.19,48225,381,250,46913,46913,46913,46913,46887
45200,147,1394,0,45200,0,45200,1.92544e+18,324.01,4650.34,45200,321,214,41926,37396,33594,14771,10681
42669,147,2152,33272,9397,33272,9397,6.26204e+18,317.207,5125.29,42669,398,226,39231,37662,29747,23194,11279
18201,347,406,18201,0,18201,0,5.23535e+18,227.739,1754.89,18201,169,123,17795,17700,17508,17126,17062
13711,137,409,13711,0,13711,0,5.42253e+18,199.911,1535.79,13711,143,109,13097,12598,8575,8084,6106
37051,1158,1453,0,37051,0,37051,1.89221e+18,311.482,4400.06,37051,294,177,35598,35598,35532,35597,33522
8346,144,384,8346,0,8346,0,3.61051e+18,160.642,1200.43,8346,229,93,7845,7560,6136,5836,4044
40342,3,11,38407,1935,40342,0,9.62794e+13,10.6851,448.453,40342,11,11,36208,35070,28617,27736,24884
1043,125,153,268,775,0,1043,3.26522e+13,20.7373,282.32,1043,37,39,890,890,883,890,804
45786,718,1428,45786,0,42708,3078,9.38272e+17,702.971,4819.61,45786,393,250,43983,41894,38585,36983,29516
14013,562,689,12540,1473,0,14013,3.84546e+18,186.937,1807.66,14013,114,133,13324,13320,13116,13122,11684
15553,125,645,3861,11692,0,15553,2.71148e+13,151.491,2024.4,15553,301,103,14697,14230,12180,12959,5169
10584,252,551,2636,7948,0,10584,3.27355e+13,154.957,1234.4,10584,74,131,10033,9832,9254,9661,5794
26765,689,1334,4884,21881,0,26765,2.31384e+13,319.777,3626.72,26765,413,150,25431,25380,24766,22374,12913
41747,831,944,36776,4971,0,41747,3.83605e+18,348.59,4048,41747,323,194,40803,40803,40694,40693,38352
823,158,186,184,639,0,823,4.10386e+13,22.2758,293.485,823,81,27,637,636,634,633,581
26961,360,1199,6654,20307,0,26961,3.0911e+13,187.881,2626.59,26961,252,136,25762,25680,21805,10566,3378
35659,921,1653,33289,2370,33289,2370,7.32182e+17,600.927,4690.59,35659,381,224,34006,33663,33558,33297,28166
45505,424,934,34276,11229,34276,11229,3.81367e+18,419.879,3406.54,45505,260,193,44485,43479,43402,43233,27314
18141,143,1150,4321,13820,0,18141,3.18057e+13,131.576,2315.81,18141,335,113,16884,16152,14312,15003,3981
4295,97,348,4029,266,4029,266,1.92843e+18,152.282,861.507,4295,112,67,3729,3288,3323,3428,1681
2115,47,213,1830,285,1830,285,3.62023e+18,100.954,551.821,2115,80,66,1604,1411,1397,1279,779
43980,485,2636,40112,3868,0,43980,3.24135e+18,378.764,6379.6,43980,598,214,41087,40113,37192,36031,11449
31862,1122,1596,0,31862,0,31862,1.76959e+18,358.212,4429.5,31862,353,201,30266,30254,29678,26321,24383
29760,835,1740,27667,2093,0,29760,2.58143e+18,456.016,4547.81,29760,340,241,28020,27665,26944,26540,16236
24487,37,44,0,24487,24306,181,2.56691e+16,35.9103,531.929,24487,28,31,24427,24355,24256,24346,22859
24420,90,1071,22802,1618,22802,1618,2.06508e+18,410.07,3119.88,24420,267,158,20866,18062,17956,17926,7573
30217,436,1969,0,30217,3901,26316,4.1421e+15,11.886,3822.84,30217,985,13,28248,28248,15906,15992,11810
15491,47,1343,15491,0,14213,1278,7.52978e+17,322.953,3030.97,15491,370,124,12325,10017,7798,3348,2182
20939,202,1213,0,20939,4617,16322,7.09943e+15,172.896,2963.92,20939,282,168,19682,19411,18009,13895,9066
1629,18,20,0,1629,1624,5,3.14948e+16,5.88214,119.404,1629,10,8,1609,1609,1609,1609,1483
46423,1869,2056,41325,5098,41325,5098,1.46603e+18,432.63,6010.03,46423,536,176,44367,44367,44348,44349,42380
26290,2015,2145,26290,0,24309,1981,3.93875e+18,371.782,4432.09,26290,788,149,24145,24145,24145,24145,23547
47947,22,48,0,47947,47778,169,2.6554e+16,29.0645,735.254,47947,25,26,47876,47849,47042,46933,30665
12416,15,560,9372,3044,0,12416,8.23323e+18,248.518,1522,12416,132,118,7028,4737,4247,4436,1155
24031,356,1184,0,24031,0,24031,1.18257e+18,619.019,3405.6,24031,366,199,22105,21302,20561,19358,9915
39577,43,654,0,39577,8986,30591,7.30967e+15,239.428,3126.46,39577,255,133,34781,30982,29078,23038,6165
3316,12,20,0,3316,3306,10,3.00964e+16,13.4946,168.323,3316,14,11,3288,3277,3141,3216,2272
5906,186,468,5204,702,0,5906,3.87032e+18,148.844,1256.96,5906,162,97,5399,5225,4718,4614,2994
3969,137,276,3969,0,3969,0,3.33593e+18,77.4036,727.084,3969,86,73,3693,3654,3380,3377,2910
15867,471,1006,0,15867,0,15867,1.17538e+18,313.46,2502.05,15867,283,146,14845,14473,14317,13426,10904
29347,807,1360,4867,24480,0,29347,2.17542e+13,269.202,3726.11,29347,390,112,27987,27984,27401,25013,18876
42375,1529,3185,9432,32943,0,42375,6.31574e+12,289.045,5820.42,42375,410,128,39190,39190,34947,30550,21619
16713,314,1031,15647,1066,15647,1066,1.98932e+18,308.533,2622.5,16713,215,132,15499,15073,14842,14368,10818
34734,932,1612,0,34734,9214,25520,1.3602e+16,252.589,4017.04,34734,329,166,33122,33122,32672,32559,24003
39145,179,645,35499,3646,39145,0,3.7e+18,340.362,3252.98,39145,266,185,37528,35581,30374,28038,16386
41217,30,64,0,41217,40971,246,2.01119e+16,20.7326,879.884,41217,28,31,41153,41138,40250,40736,27411
42570,1859,1887,38060,4510,38058,4512,1.05408e+18,279.647,4681.66,42570,381,186,40683,40683,40674,40682,40526
12239,23,51,0,12239,12090,149,2.55755e+16,36.8104,455.441,12239,31,29,12151,12099,11591,11577,8042
36165,1050,1789,32404,3761,0,36165,3.6414e+18,411.551,5029.1,36165,383,222,34376,34331,33305,32445,26811
7607,317,435,6689,918,0,7607,3.05892e+18,306.307,1399.01,7607,217,97,6974,6185,6709,6802,5941
43138,1268,1503,0,43138,9943,33195,7.12715e+15,241.802,4429.25,43138,405,164,41635,41626,41635,41635,39876
39409,2,14,39139,270,39409,0,9.51584e+13,11.2639,397.464,39409,13,12,35079,33747,28241,33725,23623
8625,395,693,8625,0,8034,591,1.1201e+18,195.715,1596.23,8625,146,134,7932,7794,7296,7522,5715
20249,141,576,20221,28,20249,0,3.15223e+18,277.649,2267.9,20249,163,138,18935,17120,14557,12374,6025
40580,1679,1888,37843,2737,37843,2737,2.09769e+18,468.62,5295.73,40580,368,253,38692,38690,38587,38585,36734
44101,26,72,0,44101,43887,214,2.09355e+16,28.6416,873.908,44101,35,36,43953,43734,37616,38564,25939
981,96,188,920,61,920,61,1.0846e+18,34.8206,316.102,981,67,30,793,749,695,744,464
3711,1,11,3559,152,3711,0,9.45842e+13,7.49852,135.93,3711,10,9,1487,1487,1487,1487,1487
44376,294,1430,44376,0,41440,2936,9.51042e+17,758.587,4823.83,44376,429,243,40713,39306,33924,29744,14393
24274,293,679,21340,2934,21340,2934,3.23139e+18,324.951,2837.82,24274,262,164,23305,22647,21092,20625,11617
27451,363,1221,27451,0,25608,1843,9.48417e+17,628.208,3614.02,27451,341,207,25420,24655,21455,18487,6493
27947,68,1514,0,27947,0,27947,1.23432e+18,392.929,3992.4,27947,340,233,22848,18793,18824,16468,4601
7430,445,588,7006,424,7006,424,1.77875e+18,149.775,1350.38,7430,171,81,6842,6840,6827,6808,6632
16317,198,508,14846,1471,16317,0,2.88148e+18,256.768,1860.5,16317,202,114,15562,15221,14307,12767,9002
21473,64,441,21473,0,21473,0,5.02377e+18,252.755,1960.23,21473,161,139,19067,16598,11901,10503,6148
7284,446,657,7284,0,6793,491,1.07371e+18,153.099,1448.43,7284,118,126,6627,6604,6213,6487,4808
41000,602,2458,0,41000,0,41000,1.75066e+18,349.565,5940.37,41000,540,249,38479,38011,34938,26002,13820
30216,233,1496,26766,3450,26766,3450,1.53876e+18,344.33,4324.44,30216,402,163,27291,25068,22024,23319,6095
4825,22,386,4505,320,4505,320,4.9642e+17,139.514,968.512,4825,110,78,3006,2244,1722,2037,1003
9031,8,13,8956,75,9031,0,9.66199e+13,7.42852,186.574,9031,9,9,9015,9014,8830,8835,8589
21901,52,62,0,21901,21732,169,2.53539e+16,39.6958,644.732,21901,35,35,21833,21800,21438,21463,19959
31207,535,1179,29122,2085,0,31207,2.45398e+18,485.472,3689.93,31207,302,187,29867,28789,28836,28663,20336
13539,164,492,11964,1575,11964,1575,2.5199e+18,352.651,1936.86,13539,255,133,11655,10370,10477,10243,6333
5754,391,469,0,5754,1276,4478,4.98436e+15,77.1182,1146.88,5754,105,116,5285,5285,5272,5263,4706
28656,8,13,28404,252,28656,0,9.85007e+13,11.1292,333.705,28656,11,11,28629,28624,27369,27386,21218
15141,389,2532,0,15141,0,15141,2.10605e+16,7.49363,3321.96,15141,1268,9,12609,12609,11538,12609,2085
24689,166,952,0,24689,0,24689,1.88866e+18,563.454,2759.91,24689,432,110,22170,21664,19785,17743,7363
22832,387,517,0,22832,5153,17679,7.26649e+15,220.975,2236.47,22832,208,114,22315,22309,22116,22250,19068
26655,780,947,0,26655,6768,19887,8.0284e+15,222.621,2391.84,26655,113,202,25708,25698,25453,25533,22550
39162,935,1345,36582,2580,36582,2580,2.02494e+18,690.726,4339.98,39162,403,224,37817,37200,36647,36364,30877
22902,612,869,22902,0,20205,2697,1.15285e+18,388.74,3079.81,22902,252,164,22033,22030,21547,21526,17329
13157,55,576,13157,0,11623,1534,7.65295e+17,397.366,2029.74,13157,252,124,10122,7835,6901,1380,3056
10905,31,433,2824,8081,0,10905,2.93587e+13,156.387,1205.59,10905,87,109,9726,9144,8626,7845,2086
1533,107,216,232,1301,0,1533,1.13844e+13,30.9374,404.271,1533,89,30,1317,1292,1213,1276,850
1156,1,5,1120,36,1156,0,8.71698e+13,3.33131,60.9306,1156,5,5,549,549,549,549,549
19048,624,804,19048,0,16730,2318,1.17519e+18,361.012,2755.45,19048,239,159,18244,18243,18050,18098,15361
4881,101,505,4634,247,4634,247,1.62749e+18,112.466,960.201,4881,163,66,4231,3522,3837,3987,2690
24719,495,623,23680,1039,23630,1089,7.60807e+17,464.092,2687.34,24719,243,160,24018,23813,22993,23490,21478
46885,1870,2141,0,46885,0,46885,1.7598e+18,383.399,5801.17,46885,477,237,44744,44670,44744,44744,43644
17652,216,619,13257,4395,13257,4395,7.11403e+18,267.011,1837.6,17652,150,128,16776,16235,14309,12873,7553
30886,1339,2226,0,30886,0,30886,1.92072e+18,213.614,4792.5,30886,468,230,28660,28660,26548,27264,17585
22044,2255,3285,3047,18997,0,22044,2.29486e+13,10.615,4054.05,22044,597,22,18759,18759,15359,11279,12245
13305,234,346,13300,5,13305,0,3.23727e+18,256.354,1561.85,13305,147,116,12834,12304,11870,10090,9763
4494,7,13,4453,41,4494,0,9.26352e+13,7.15932,131.564,4494,9,9,4478,4476,4360,4359,3908
9890,310,362,9890,0,9890,0,5.1096e+18,149.109,1243.87,9890,137,100,9528,9518,9386,9266,8821
46779,126,626,44698,2081,44698,2081,1.41019e+18,483.498,3608.68,46779,282,206,40542,34913,36318,37061,23300
41872,6,536,41872,0,41872,0,5.06471e+18,306.184,2928.93,41872,222,159,22266,15974,12039,9796,4409
27194,1045,1201,25399,1795,25399,1795,6.7681e+17,605.676,3594.94,27194,336,208,25993,25977,25855,25889,25052
6242,297,545,1362,4880,0,6242,1.83544e+13,114.46,1279.5,6242,155,108,5697,5628,5523,5526,3750
13576,987,1127,0,13576,0,13576,1.34791e+18,325.508,2624.31,13576,381,110,12449,12421,12394,12439,11902
10953,554,657,9798,1155,9798,1155,3.28287e+18,182.875,1580.35,10953,104,124,10296,10294,10124,10125,8943
12218,385,997,12218,0,11438,780,9.21118e+17,231.523,2271.17,12218,240,155,11221,10974,10377,9332,8546
32962,609,655,24834,8128,32962,0,4.25052e+18,323.342,2868.49,32962,288,156,32307,32307,32283,32292,31700
26839,472,809,20235,6604,0,26839,8.26374e+18,291.032,2426.68,26839,187,160,26030,25887,25503,25555,20285
45288,1023,1439,0,45288,0,45288,1.47187e+18,634.22,5031.7,45288,522,191,43849,43420,43547,43526,33831
21953,981,1127,19164,2789,19164,2789,3.33383e+18,270.481,3080.63,21953,247,161,20826,20826,20760,20719,20413
17829,104,774,0,17829,0,17829,2.14934e+18,268,1926.58,17829,108,190,16564,16078,14144,14331,3130
14616,858,940,0,14616,0,14616,1.18005e+18,303.36,2368.52,14616,195,139,13676,13460,13634,13663,13167
12311,683,873,11121,1190,0,12311,3.504e+18,169.715,1959.15,12311,311,94,11438,11414,11150,11170,9924
3728,281,304,3728,0,3473,255,1.04003e+18,118.021,776.013,3728,89,73,3424,3424,3422,3419,3387
36262,49,60,0,36262,36033,229,2.70132e+16,33.7595,720.047,36262,31,35,36202,36199,36006,36104,34958
38426,6,12,38228,198,37278,1148,8.07743e+13,6.87194,398.786,38426,10,8,38206,37787,34179,34192,36124
9580,299,408,9580,0,9580,0,3.73173e+18,246.645,1494.59,9580,144,115,9137,8994,8683,8218,6928
35534,1202,1365,35534,0,33243,2291,9.1767e+17,682.991,4287.45,35534,386,229,34169,34129,33881,33935,32956
18473,4,88,0,18473,18094,379,2.42e+16,34.2848,763.705,18473,40,33,16452,15559,12253,12031,6414
43205,154,2319,0,43205,0,43205,1.72966e+18,397.004,5956.28,43205,495,241,39330,35705,34207,16161,8945
5158,38,305,0,5158,1433,3725,1.61499e+16,66.5366,728.676,5158,58,64,4783,4662,4056,4127,1268
28525,2007,2019,24657,3868,24563,3962,2.29459e+18,430.649,4602.82,28525,496,223,26506,26506,26506,26506,26427
19084,603,1603,0,19084,0,19084,1.6641e+18,217.69,3583.72,19084,366,209,17481,17412,17134,16720,8560
25992,359,906,22857,3135,22857,3135,1.71532e+18,387.731,3314.36,25992,249,174,24729,23843,22942,22805,10447
39772,525,1182,35581,4191,35581,4191,3.26412e+18,300.747,3544.2,39772,166,174,38590,38449,35433,33941,22903
45484,346,503,45484,0,45484,0,4.95821e+18,326.468,2928.53,45484,213,168,44938,44394,42382,40457,37604
38827,1435,2229,36070,2757,36070,2757,2.23982e+18,517.367,5434.01,38827,712,142,36598,36335,35948,35436,29984
43841,445,481,43841,0,43841,0,5.13946e+18,307.65,2834.24,43841,213,166,43360,43358,43233,43200,42537
35172,349,2292,31777,3395,31777,3395,3.0072e+18,280.916,5310.49,35172,534,211,32616,31668,29446,24383,9168
20797,1070,1387,20797,0,19103,1694,9.3173e+17,307.844,3575.6,20797,333,166,19410,19406,19405,19374,17779
48012,348,1240,48012,0,42191,5821,1.15926e+18,421.877,4942.7,48012,349,231,45928,44224,42277,33174,16909
25552,871,1142,23804,1748,23804,1748,2.09339e+18,470.226,3314.17,25552,283,179,24410,24061,23931,23857,21637
36805,3,13,36548,257,36805,0,9.93825e+13,11.8976,379.638,36805,13,12,35462,34793,33086,33787,24898
9890,197,733,9193,697,0,9890,2.58201e+18,339.472,1791.7,9890,203,148,8890,8640,7981,7951,2773
27740,219,800,0,27740,6143,21597,4.57447e+15,406.023,2809.96,27740,286,156,26328,25836,24910,23019,14353
29616,36,1444,0,29616,7169,22447,7.26498e+15,182.64,3521.26,29616,273,168,26237,25034,22951,21148,4426
13649,716,930,12345,1304,12345,1304,2.32035e+18,291.14,2486.72,13649,365,136,12719,12712,12614,12632,11659
12620,90,738,0,12620,2211,10409,5.93302e+15,193.67,1988.85,12620,249,73,11546,11045,10575,8579,4029
22916,427,707,0,22916,5636,17280,6.95964e+15,194.675,2568.04,22916,321,128,22209,22190,21475,21862,13821
43640,427,661,43640,0,43640,0,3.41291e+18,322.672,3555.11,43640,237,195,42979,42945,41239,38890,33812
25421,48,55,0,25421,24918,503,2.71098e+16,24.9176,515.279,25421,31,27,25366,25351,25353,25345,24884
34654,298,527,34654,0,34654,0,3.20134e+18,295.406,2428.71,34654,188,146,34056,33222,30540,29606,22865
41484,45,70,0,41484,40893,591,2.44917e+16,51.0342,962.734,41484,39,42,41387,41288,39828,40008,32975
14731,117,389,3413,11318,0,14731,2.9355e+13,178.75,1653.51,14731,180,95,14157,13854,11892,7719,5881
18506,17,62,0,18506,18383,123,2.6166e+16,38.5756,599.769,18506,30,33,18281,18030,17205,16705,9267
4009,281,376,0,4009,0,4009,1.68715e+17,29.9199,742.35,4009,140,36,3633,3633,3600,3488,2696
26711,9,11,26541,170,26711,0,1.04208e+14,8.70922,321.302,26711,10,10,26697,26693,26617,26616,26684
27540,193,520,0,27540,6342,21198,7.32494e+15,215.648,2456.41,27540,227,115,26806,26343,24529,25040,12061
23854,247,379,6139,17715,0,23854,1.20807e+13,245.746,1972.53,23854,213,116,23431,23162,22427,22417,21786
27182,7,10,26972,210,27182,0,9.91408e+13,9.60194,321.444,27182,10,10,27108,27005,25805,25806,23863
4003,37,341,3721,282,3721,282,5.41018e+17,126.129,851.219,4003,98,76,2830,1966,2019,1999,1084
19774,1189,1858,0,19774,0,19774,1.51454e+18,227.811,3922.14,19774,461,210,17916,17916,17618,17869,11962
44910,1,13,44613,297,44910,0,1.03233e+14,11.088,413.894,44910,13,11,24561,24561,24561,24561,24561
21909,1057,1345,5024,16885,0,21909,3.46987e+13,196.003,2539.03,21909,300,222,20564,20564,19856,20242,15786
2594,169,227,2402,192,2402,192,1.2855e+18,82.6627,572.917,2594,103,43,2367,2317,2307,2331,2069
4899,446,776,4573,326,4573,326,7.86508e+17,108.566,1444.14,4899,165,86,4123,4105,4079,4067,3266
21430,586,846,21430,0,18882,2548,1.17649e+18,390.491,2948.38,21430,256,163,20584,20562,20027,19562,15383
16688,216,1006,15607,1081,15607,1081,5.9963e+17,300.034,2547.41,16688,223,166,15403,15023,14428,14382,8791
14187,132,558,12713,1474,12713,1474,3.23456e+18,233.819,1665.24,14187,113,131,12949,12025,11609,10332,4055
9238,267,298,9238,0,9238,0,4.79993e+18,179.74,1159.63,9238,139,105,8940,8897,8835,8839,8722
18001,320,450,0,18001,4095,13906,7.25081e+15,202.013,1905.15,18001,196,103,17551,17506,17364,17485,14522
44354,7,98,0,44354,43728,626,2.09282e+16,31.06,1117.43,44354,45,34,42947,42309,38681,39858,23751
28515,203,1321,0,28515,0,28515,1.2259e+18,407.947,3746,28515,295,165,26375,25708,23663,20929,12363
2330,23,143,646,1684,0,2330,6.64465e+13,37.2991,378.092,2330,43,41,2066,1737,1786,1191,707
27368,1555,2052,27193,175,0,27368,7.04152e+18,85.1226,3991.51,27368,454,67,25316,25316,24748,24335,20207
715,68,231,715,0,609,106,1.18369e+18,36.6294,351.831,715,44,50,484,441,385,283,208
25813,40,47,0,25813,25720,93,2.60589e+16,24.739,554.12,25813,25,22,25766,25757,25727,25690,23529
8988,434,530,7933,1055,0,8988,3.83027e+18,250.668,1589.49,8988,188,117,8458,8379,8376,8381,7743
25684,24,74,0,25684,25421,263,2.52191e+16,36.9836,766.668,25684,36,40,25546,25503,24359,23595,17974
35103,410,1601,35103,0,31413,3690,7.69318e+17,440.995,4685.33,35103,431,170,33081,29976,28790,20891,18839
47705,1643,2543,43000,4705,43000,4705,2.99363e+18,269.061,6110.3,47705,517,243,45162,45161,44935,44961,36774
30026,5,65,0,30026,29807,219,2.59951e+16,43.8115,747.06,30026,37,37,26978,25225,22643,22936,13455
12037,945,1105,9037,3000,0,12037,8.00992e+18,144.787,2221.79,12037,230,107,10932,10929,10932,10932,10468
13672,58,61,0,13672,13589,83,2.60308e+16,26.5289,503.36,13672,31,30,13611,13606,13603,13488,13384
43418,323,1004,32709,10709,32709,10709,3.80929e+18,371.438,3405.65,43418,234,193,42082,40465,40340,40089,17448
23250,7,59,0,23250,23046,204,2.18312e+16,17.4021,625.265,23250,23,27,23015,22865,19971,22020,14002
7987,212,558,0,7987,0,7987,1.95148e+18,156.003,1285.03,7987,89,103,7406,6942,6812,5530,2718
47035,975,1876,0,47035,0,47035,1.85833e+18,342.127,5519.03,47035,359,218,45159,45125,44653,44917,36808
11082,554,785,0,11082,2513,8569,6.12544e+15,66.4239,1781.49,11082,261,65,10297,10297,10121,10291,6002
24372,367,840,5495,18877,0,24372,2.26019e+13,223.69,2755.07,24372,309,104,23532,23384,21198,21979,10503
27376,280,847,27376,0,20633,6743,8.91364e+17,319.077,2607.48,27376,199,157,26241,25369,24039,21930,12958
13642,2,11,13024,618,13642,0,9.55933e+13,10.2516,260.13,13642,11,11,9860,8309,8768,8616,6479
1885,6,7,1880,5,1885,0,8.42188e+13,6.52467,85.1799,1885,7,7,1868,1849,1661,1661,1651
14991,514,588,0,14991,0,14991,4.09895e+18,249.076,1682.81,14991,144,115,14403,14398,14340,14352,13441
44812,788,840,33727,11085,0,44812,8.3428e+18,374.758,3108.29,44812,243,176,43972,43970,43960,43957,43440
48145,142,614,48145,0,48145,0,4.8852e+18,300.21,3303.26,48145,239,169,46554,45119,32154,30409,17861
33288,1264,1333,30173,3115,30173,3115,2.52964e+18,473.708,4138.75,33288,423,171,31955,31955,31944,31944,30869
21595,147,848,0,21595,0,21595,1.91886e+18,235.961,2369.13,21595,128,141,20007,18423,17700,12111,5376
36298,292,597,0,36298,8402,27896,7.38132e+15,224.932,2923.08,36298,250,129,35701,35178,34367,35045,20979
10510,118,955,0,10510,0,10510,1.14441e+18,162.964,2182.77,10510,202,91,9287,8363,8315,8382,3179
2635,422,503,2425,210,0,2635,3.02598e+18,62.2258,855.866,2635,130,76,2132,2129,2132,2132,1872
20274,105,533,18454,1820,20274,0,3.81698e+18,263.86,2133.12,20274,262,118,18780,16900,13990,11095,6014
23545,734,1955,0,23545,0,23545,1.50673e+18,231.789,3999.53,23545,715,171,21590,21320,20939,20659,10420
31435,883,2280,31435,0,28670,2765,1.036e+18,401.666,5404.2,31435,511,227,29155,28840,26647,25989,9396
38256,92,1389,35765,2491,0,38256,2.39925e+18,566.411,4378.52,38256,357,209,32835,28629,28111,28524,9343
48541,635,1961,0,48541,0,48541,1.88235e+18,284.091,5062.59,48541,522,183,46580,46435,40646,37074,12771
28164,480,628,28036,128,28164,0,3.41389e+18,358.287,2754.55,28164,234,141,27524,27400,26615,26491,25073
35803,440,919,27011,8792,0,35803,8.25243e+18,343.001,2904.91,35803,218,174,34884,34607,33125,33058,22192
26658,760,1730,0,26658,0,26658,1.33496e+18,387.519,3923.78,26658,650,121,24928,24397,24386,23863,14278
15847,184,1431,14263,1584,14260,1587,1.67108e+18,220.514,2888.41,15847,442,113,14178,13808,12503,13605,3112
2944,311,313,2251,693,2944,0,3.31915e+18,86.5635,720.381,2944,78,65,2631,2631,2631,2631,2628
6638,636,680,6638,0,6081,557,6.85229e+17,41.9254,1183.44,6638,257,68,5958,5958,5931,5958,5910
47640,730,767,47576,64,47640,0,3.26472e+18,411.522,3929.87,47640,256,188,46873,46854,46822,46749,45915
19457,41,55,0,19457,19148,309,2.71091e+16,49.1732,478.105,19457,29,26,19388,19355,19240,19302,15005
3781,113,267,987,2794,0,3781,2.92548e+13,90.9595,638.589,3781,60,70,3494,3331,3225,3346,1871
12599,330,496,3344,9255,0,12599,2.57167e+13,169.379,1694.23,12599,237,108,12103,12087,11799,11950,10508
34722,432,1646,0,34722,0,34722,1.45674e+18,511.586,4674.58,34722,396,201,32538,31738,30727,28494,13567
29717,512,1314,29717,0,27765,1952,9.37949e+17,547.636,4041.98,29717,361,214,28128,26904,25708,26122,17471
38396,736,1395,0,38396,0,38396,1.21455e+18,642.287,4421.49,38396,339,235,36853,36609,35256,32510,21937
25362,366,895,25362,0,22334,3028,1.16213e+18,395.536,3270.68,25362,263,174,24116,23266,22334,17385,9543
31052,230,439,31052,0,31052,0,5.01529e+18,240.988,2458.09,31052,185,147,30473,30027,26695,25680,19939
9103,236,495,8076,1027,0,9103,3.61851e+18,271.14,1588.11,9103,177,105,8482,8183,7274,7139,4476
18409,170,317,18409,0,18409,0,4.03846e+18,218.527,1668.87,18409,134,139,17759,16683,15313,15409,9941
5487,100,346,5368,119,5487,0,4.58868e+18,137.939,946.242,5487,117,54,4997,4658,3531,3544,1961
15489,91,1603,0,15489,0,15489,1.35676e+18,155.326,2966.5,15489,416,176,13188,11335,11691,10600,2163
20286,341,462,5644,14642,0,20286,6.28152e+13,202.266,1588.4,20286,128,99,19824,19760,19603,19578,16384
11963,36,61,0,11963,11901,62,2.70088e+16,21.6503,419.978,11963,27,27,11902,11888,11622,11669,10163
26881,1,31,0,26881,26843,38,1.03232e+16,6.14345,552.398,26881,19,12,13252,13252,13252,13252,13252
8076,359,618,6084,1992,6082,1994,3.75752e+18,149.252,1544.25,8076,125,137,7458,7332,7358,7357,4771
47538,126,955,41762,5776,41762,5776,3.2605e+18,345.612,4348.49,47538,321,206,43389,37285,34903,30459,11076
5255,285,615,4717,538,4716,539,1.77207e+18,70.4894,1169.48,5255,174,87,4640,4639,4229,4481,1455
49680,457,2285,45030,4650,45030,4650,8.29782e+17,439.087,6179.53,49680,449,264,46927,45605,44503,44389,17215
12578,782,866,11755,823,0,12578,2.39388e+18,249.606,2123.18,12578,186,141,11712,11605,11688,11671,10904
32024,523,1464,7877,24147,0,32024,3.02429e+13,188.886,3261.18,32024,390,146,30560,30493,26288,25824,6632
7049,428,437,6315,734,6315,734,8.91382e+17,193.317,1146.3,7049,96,105,6612,6612,6612,6612,6541
44760,6,10,44596,164,44632,128,1.01679e+14,8.50824,393.005,44760,9,10,44704,44649,42759,42742,39837
16272,10,11,15867,405,15824,448,8.60756e+13,5.33745,228.003,16272,9,7,16261,16261,16261,16260,16260
34049,1027,2545,30769,3280,30769,3280,1.06027e+18,265.646,5573.54,34049,494,246,31504,31437,30393,30871,20341
46637,5,14,45954,683,44124,2513,8.09838e+13,6.76883,427.13,46637,9,10,46310,45998,42482,42467,34173
4951,319,430,4377,574,0,4951,4.24127e+18,66.2541,900.562,4951,78,75,4521,4520,4502,4507,4126
31348,4,36,0,31348,29903,1445,2.45496e+16,31.3725,586.096,31348,30,32,28518,27231,20739,20691,14959
36271,1137,1276,33835,2436,0,36271,2.43605e+18,681.53,4174.24,36271,411,224,34995,34984,34802,34782,34031
27652,410,853,6081,21571,0,27652,1.79973e+13,403.694,2873.72,27652,320,175,26658,26027,25716,22703,16307
13763,71,389,3082,10681,0,13763,2.81265e+13,198.024,1599.51,13763,177,96,12719,11528,10652,5005,3584
44452,834,1163,10630,33822,0,44452,2.47249e+13,418.428,4056.43,44452,587,138,43289,43155,42863,43094,38499
7280,735,861,6818,462,0,7280,2.29684e+18,169.083,1753.68,7280,163,115,6419,6395,6388,6396,5872
39656,643,1560,0,39656,9431,30225,6.43403e+15,280.869,4335.05,39656,323,168,38096,38004,36451,35935,19248
47337,643,1770,11334,36003,0,47337,2.76549e+13,250.398,4750.4,47337,374,178,45567,45427,43907,43637,29454
45633,782,1621,40747,4886,40747,4886,2.70208e+18,388.207,5375.13,45633,451,219,44012,43813,39885,38003,22568
31418,35,1574,28501,2917,28501,2917,1.36198e+18,689.34,4422.9,31418,506,173,23777,18885,14793,17054,2157
4876,156,323,0,4876,0,4876,4.14261e+18,65.7196,776.283,4876,84,67,4553,4534,4369,3168,2487
48615,1378,1855,0,48615,9675,38940,6.14664e+15,361.759,5378.61,48615,699,200,46760,46710,46424,46632,39446
42418,603,652,42418,0,42418,0,3.99809e+18,286.52,3317.91,42418,231,181,41766,41764,41256,41246,40075
5556,39,411,4178,1378,4178,1378,7.06453e+18,79.4343,922.666,5556,82,80,4665,2650,3081,2405,972
14787,316,1129,13272,1515,0,14787,3.71829e+18,192.48,2476.51,14787,187,132,13658,13553,12933,12902,8555
16759,306,567,16729,30,16759,0,2.95299e+18,237.792,2042.82,16759,220,120,16142,15582,15044,14350,11076
31659,1529,2021,28584,3075,0,31659,3.55423e+18,242.329,4859.52,31659,491,153,29638,29638,28184,28094,21053
22893,147,697,22893,0,17269,5624,8.85288e+17,332.415,2260.16,22893,179,147,21406,20850,17658,17284,4597
8075,12,17,0,8075,8068,7,1.37066e+16,9.92136,248.8,8075,14,10,8058,8058,7914,7959,7394
9842,346,455,9840,2,9842,0,5.65995e+18,211.286,1451.88,9842,134,94,9387,9373,8153,8150,7981
30273,1207,1907,25557,4716,25554,4719,2.23987e+18,263.206,4985.8,30273,398,199,28366,28362,27833,27834,15251
24931,12,64,0,24931,24872,59,2.07638e+16,23.9395,640.267,24931,29,30,24376,23470,20424,21885,13926
32289,1,13,32064,225,32289,0,1.01244e+14,10.2453,351.007,32289,12,11,17822,17822,17822,17822,17822
48454,335,917,36527,11927,0,48454,8.29332e+18,391.47,3319.63,48454,265,181,47264,45069,40501,40827,24458
3824,191,456,3417,407,3417,407,2.96254e+18,138.325,1022.36,3824,135,70,3348,3182,2929,2568,1667
24116,696,1190,21776,2340,21776,2340,2.50921e+18,365.469,3499.88,24116,401,167,22926,22719,22217,22032,16666
24855,396,699,24791,64,24855,0,3.22165e+18,297.064,2671.85,24855,238,134,24156,24030,23458,23070,19334
2412,57,353,2412,0,2137,275,1.03012e+18,102.22,748.47,2412,85,72,1801,1570,1259,662,990
46411,2232,3463,0,46411,319,46092,1.30122e+14,16.3168,6406.23,46411,443,26,42948,42948,41687,32213,30328
25641,382,1986,25641,0,21091,4550,2.80639e+18,15.7848,3571.54,25641,818,27,23655,23655,23619,23654,3127
22296,6,7,22258,38,22296,0,8.2842e+13,6.96995,291.375,22296,7,7,22153,21903,19530,19530,20245
28111,10,36,0,28111,26781,1330,2.46491e+16,30.5165,554.961,28111,29,29,27433,26701,21060,24455,16128
27112,11,46,0,27112,26808,304,1.98908e+16,19.7624,628.871,27112,24,25,26988,26928,26407,26446,20980
10810,389,528,9684,1126,9684,1126,8.92361e+17,232.476,1474.72,10810,108,122,10282,10246,10223,10249,8770
16049,162,1041,15045,1004,15045,1004,6.51883e+17,310.884,2695.97,16049,241,151,14519,13954,12354,12912,7007
40938,13,61,0,40938,40360,578,2.49398e+16,43.9684,913.564,40938,38,43,39771,38810,36870,36211,19353
15691,317,1020,14717,974,0,15691,2.27288e+18,437.397,2558.71,15691,277,172,14418,14104,13524,13531,3591
26350,200,742,26350,0,19838,6512,8.0805e+17,341.847,2459.53,26350,193,162,24923,24189,20539,20709,9861
1364,276,368,1199,165,1199,165,1.00986e+18,53.1327,569.251,1364,85,42,996,970,918,943,910
13952,3,8,13824,128,13952,0,1.04807e+14,5.95234,218.074,13952,8,8,13537,13348,12749,13308,10273
43679,1810,2673,39402,4277,39402,4277,9.98003e+17,269.869,6098.04,43679,485,261,41006,41005,40700,40991,35155
34897,139,493,34897,0,34897,0,3.26614e+18,300.464,2427.15,34897,187,143,33430,32498,25655,24693,11586
18964,171,660,0,18964,0,18964,4.08844e+18,263.37,1923.09,18964,147,131,17950,17501,14472,8749,5792
12381,1054,1082,11787,594,11787,594,1.53834e+18,118.425,2093.18,12381,265,102,11299,11299,11293,11296,11156
25967,741,899,22898,3069,22898,3069,1.71169e+18,408.626,3296.72,25967,268,176,25068,25067,24941,24828,22598
35782,192,332,35775,7,35782,0,2.49718e+18,235.906,2038.04,35782,167,95,35260,35025,34135,34099,22281
47906,887,941,10341,37565,0,47906,1.85378e+13,456.178,3843.12,47906,319,207,46965,46965,46913,46934,46643
7118,9,12,7050,68,7118,0,9.44315e+13,7.17238,162.171,7118,8,9,7106,7105,6813,6812,6065
43865,1804,2172,34059,9806,0,43865,7.47457e+18,330.124,5156.15,43865,393,227,41693,41693,41688,41693,39941
22201,1182,1185,20122,2079,20122,2079,2.49185e+18,328.99,3341.12,22201,400,136,21016,21016,21016,21016,21014
27077,19,1921,24348,2729,0,27077,3.67747e+18,212.39,4247.35,27077,439,153,20458,14479,15764,14334,2309
27336,312,751,24122,3214,24122,3214,3.20306e+18,345.589,3066.65,27336,273,172,26296,25480,23908,23258,10424
16176,1053,1059,0,16176,0,16176,2.85245e+16,14.8784,2121.22,16176,530,15,15117,15117,15112,15117,15105
25502,595,786,6662,18840,0,25502,2.93464e+13,195.753,2175.84,25502,123,145,24716,24711,24568,24663,22482
20557,123,1072,19163,1394,19163,1394,2.07493e+18,488.305,2997.19,20557,293,185,18114,16454,15384,15695,4695
6428,82,636,6428,0,5978,450,1.11166e+18,135.207,1390.85,6428,154,86,5283,4334,4050,4434,2369
45397,81,82,0,45397,44970,427,2.15807e+16,27.278,991.298,45397,34,35,45315,45315,45283,45258,45248
42681,498,672,11847,30834,0,42681,6.33718e+13,266.266,2483.37,42681,196,136,42009,41976,41702,41630,37296
6039,187,405,5651,388,5651,388,2.00041e+18,154.079,1069.08,6039,139,78,5632,5425,5332,5303,3511
21681,833,1054,20274,1407,0,21681,2.37599e+18,475.163,2988.63,21681,307,174,20627,20225,20367,20316,18102
23266,11,12,22211,1055,23266,0,9.57937e+13,10.1778,342.814,23266,12,11,23254,23254,22907,22908,23247
7139,43,462,6626,513,6626,513,1.24009e+18,121.347,1168.83,7139,172,62,6271,6098,4895,5338,2534
31555,863,1226,29512,2043,29512,2043,1.99303e+18,621.067,3817.8,31555,370,214,30329,29550,29503,29338,24818
3024,340,365,0,3024,637,2387,4.69425e+15,62.335,773.058,3024,92,41,2659,2659,2659,2659,2608
37140,12,63,0,37140,36862,278,2.51989e+16,51.6992,858.779,37140,41,40,36073,34824,33347,32997,22421
44145,441,893,11112,33033,0,44145,2.65044e+13,400.219,3739.81,44145,485,123,42761,41430,40784,39933,28293
7646,162,482,6786,860,6786,860,3.09286e+18,244.66,1429.95,7646,153,93,6994,6770,5681,4976,2408
30149,1211,1421,0,30149,0,30149,1.54439e+18,335.4,4165.36,30149,361,164,28728,28725,28660,28581,26875
2808,7,10,2768,40,2808,0,8.26985e+13,5.74964,99.2042,2808,8,8,2796,2792,2748,2749,2776
12503,349,1123,11412,1091,0,12503,3.23872e+18,159.803,2509.5,12503,290,89,11380,11146,10806,10375,4894
21973,654,1455,21973,0,19811,2162,7.67822e+17,388.814,3675.33,21973,421,154,20518,20233,19735,16358,13914
47577,91,97,0,47577,47455,122,2.12613e+16,40.9227,1008.78,47577,37,35,47480,47480,47480,47480,47304
19053,338,584,18234,819,18234,819,1.36674e+18,342.87,2272.8,19053,218,142,18396,17366,16852,16872,16597
13007,39,984,0,13007,299,12708,5.02752e+14,42.225,1959.51,13007,406,44,11996,11806,10956,2804,2411
49021,2256,2719,0,49021,0,49021,1.54492e+18,480.703,6752.82,49021,795,252,46302,46301,46262,46270,40952
31683,2,12,31188,495,29640,2043,8.13164e+13,6.91601,363.344,31683,9,8,27146,25712,24861,26076,20866
27543,652,1486,0,27543,6202,21341,6.48295e+15,274.565,3630.94,27543,493,129,26057,26022,24648,23407,10471
31296,338,1171,0,31296,0,31296,1.21364e+18,612.551,3708.71,31296,306,221,29224,28507,27326,26267,6708
20958,910,1052,0,20958,0,20958,1.13188e+18,377.548,2846.79,20958,291,150,19906,19559,19821,19861,19324
22173,34,65,0,22173,22102,71,2.29923e+16,18.3414,605.63,22173,25,31,22108,22105,20380,21095,17847
8771,394,596,7724,1047,7724,1047,1.70043e+18,269.964,1701.3,8771,181,114,8175,7981,7901,7783,5391
24965,175,756,5520,19445,0,24965,1.866e+13,379.779,2644.45,24965,248,162,23479,23101,21853,19308,8299
38857,18,801,29281,9576,0,38857,8.29768e+18,373.909,2881.11,38857,233,163,23647,15106,14832,15126,3288
4413,232,536,979,3434,0,4413,5.31642e+12,146.615,982.399,4413,158,66,3877,3692,3240,2803,2392
1983,16,20,0,1983,1977,6,2.91428e+16,6.54917,123.384,1983,10,8,1963,1960,1958,1960,1635
9872,109,806,9872,0,9079,793,6.05785e+17,271.174,2042.12,9872,234,125,8171,7635,6194,2622,3082
35868,716,1286,33493,2375,33493,2375,6.23779e+17,666.898,4129.03,35868,393,223,34235,33037,33181,32936,22022
15301,27,453,15301,0,15301,0,3.68769e+18,282.527,1925.37,15301,163,138,11272,9293,7712,4910,1505
20845,186,1130,18813,2032,18813,2032,3.03983e+18,483.16,2903.89,20845,465,137,18694,17877,16769,14993,8891
37791,1983,2464,37791,0,32291,5500,2.37841e+18,15.6368,4831.43,37791,1232,16,35327,35327,35327,35327,29876
23209,147,1361,0,23209,5448,17761,8.14948e+15,175.675,2831.84,23209,319,192,21615,21187,18588,18062,7122
48813,550,723,0,48813,13556,35257,1.61773e+16,281.248,2717.71,48813,216,152,48090,48073,47763,47841,43617
44821,455,1057,9925,34896,0,44821,2.26646e+13,419.264,4066.53,44821,451,145,43606,43172,40756,41296,19760
16291,47,657,12292,3999,0,16291,8.21641e+18,222.772,1789.36,16291,137,131,14522,11643,10541,10154,2372
37510,8,40,0,37510,37483,27,1.69551e+16,12.9642,823.724,37510,22,22,31482,24271,27621,28679,27575
32028,219,781,0,32028,0,32028,4.1159e+18,324.481,2604.31,32028,191,163,30640,29728,24478,14225,11520
46884,1,13,46535,349,46884,0,9.85921e+13,11.9721,426.768,46884,13,13,26152,26152,26152,26152,26152
44515,1,10,44301,214,44451,64,1.07329e+14,7.67287,394.575,44515,9,10,23338,23338,23338,23338,23338
18295,355,646,13760,4535,13760,4535,3.82651e+18,287.518,1972.31,18295,158,140,17628,16959,17266,17206,11754
28284,278,2438,28284,0,27737,547,1.33756e+18,366.434,4676.15,28284,356,145,25036,22866,21824,13118,4649
5199,6,11,4968,231,5199,0,9.51792e+13,8.65205,160.237,5199,10,10,5142,5105,4689,4686,3851
40653,884,1151,9628,31025,0,40653,2.37604e+13,249.717,3984.86,40653,381,160,39502,39498,39293,39435,36272
41649,715,1562,38894,2755,38894,2755,2.049e+18,641.415,4821.25,41649,379,227,39861,38284,38342,37849,30805
13865,309,1191,0,13865,0,13865,1.63518e+18,128.654,2638.25,13865,330,89,12674,12496,12085,6353,4431
7719,10,45,0,7719,7532,187,2.37672e+16,17.1492,312.521,7719,16,18,7647,7612,6992,7092,6687
35381,490,1239,35381,0,33066,2315,9.61673e+17,641.234,4037.5,35381,353,232,33401,32157,28897,26769,22545
19549,637,820,4187,15362,0,19549,2.21809e+13,213.875,2510.07,19549,317,101,18729,18703,18515,18532,13844
6428,4,7,6415,13,6428,0,8.24986e+13,6.92626,157.374,6428,7,7,6250,6155,5348,5353,5015
24895,769,818,0,24895,0,24895,4.14074e+18,278.871,2357.64,24895,177,155,24077,24076,24075,24071,23706
12364,81,275,12364,0,12364,0,3.68496e+18,197.612,993.02,12364,153,152,11584,11449,7973,7041,9728
24034,178,599,24034,0,24034,0,4.5146e+18,246.024,2521.11,24034,201,155,23188,22697,18357,17956,11075
4681,53,568,4681,0,4298,383,1.157e+18,106.489,1123.21,4681,216,76,3787,3388,2510,906,884
17496,17,45,0,17496,17372,124,2.58808e+16,31.1981,458.235,17496,25,27,17396,17342,16768,17034,14386
23417,461,1299,21124,2293,21124,2293,1.37873e+18,367.022,3596.12,23417,402,165,22053,20804,20285,20448,16128
21379,281,1392,0,21379,2757,18622,1.11447e+14,11.8884,2699.06,21379,698,12,19987,19987,10831,10679,10027
1640,247,292,1497,143,0,1640,3.20954e+18,52.447,513.117,1640,92,40,1348,1348,1348,1348,1254
49493,227,909,37231,12262,37231,12262,7.06956e+18,382.603,3325.15,49493,270,177,47524,45737,35596,28765,21815
41716,1511,1952,0,41716,0,41716,2.8372e+18,309.92,5472.09,41716,352,199,39764,39756,38882,37267,28994
30214,1371,2207,30214,0,27102,3112,1.56422e+18,231.946,4708.04,30214,357,227,28007,28006,27521,25019,23151
6154,2,8,6136,18,6154,0,1.04558e+14,5.94475,143.293,6154,8,7,5409,5367,4685,5033,4106
17411,273,590,15290,2121,15290,2121,3.25671e+18,277.035,2275.65,17411,220,149,16666,16234,14451,14163,8089
32322,356,670,32322,0,32322,0,3.18528e+18,335.852,3138.18,32322,207,156,31538,31328,28608,26565,23521
33176,113,2152,30108,3068,30104,3072,1.38024e+18,316.023,5128.72,33176,621,185,29800,27839,25610,27340,3437
33564,1340,2228,0,33564,0,33564,1.69566e+18,282.399,5145.54,33564,694,229,31336,31336,30927,30819,23545
6597,228,324,1528,5069,0,6597,2.8934e+13,96.5008,1052.03,6597,144,75,6273,6242,6067,6085,4303
10330,408,809,10330,0,9701,629,1.0254e+18,171.18,1856.49,10330,228,94,9521,9506,9140,9307,7763
2012,117,317,0,2012,503,1509,8.75642e+15,65.6541,605.608,2012,129,58,1695,1629,1591,1644,491
19886,565,665,17819,2067,17819,2067,3.2352e+18,257.608,2036.18,19886,125,143,19221,19212,19106,19067,17870
10220,5,11,9760,460,10220,0,9.58454e+13,9.65088,225.351,10220,11,11,9885,9840,9003,8964,7226
26339,22,693,19842,6497,19842,6497,7.03171e+18,323.117,2303.68,26339,194,150,17310,10482,11167,10358,3098
4979,178,503,0,4979,1030,3949,5.20324e+15,112.955,1162.49,4979,131,100,4451,4361,4161,4064,2328
33675,21,37,0,33675,32104,1571,2.45993e+16,28.9594,609.019,33675,31,30,33560,33448,30456,32165,27224
35717,787,1552,33284,2433,33284,2433,2.12074e+18,560.834,4480.13,35717,380,215,34153,33125,32970,32568,25219
19011,116,771,16738,2273,16738,2273,1.72994e+18,377.644,2698.63,19011,223,157,16351,13304,12988,13754,3476
9813,375,630,9813,0,8598,1215,1.20524e+18,215.278,1791.18,9813,171,117,9183,9023,8846,8369,6783
21304,1120,1148,4550,16754,0,21304,1.9535e+13,220.6,3074.93,21304,234,159,20156,20156,20156,20152,20049
5239,21,29,0,5239,5227,12,2.12776e+16,22.6986,236.677,5239,22,23,5197,5170,4771,4948,4830
37672,878,991,0,37672,8486,29186,5.88465e+15,329.595,3588.59,37672,431,138,36681,36681,36604,36673,33506
7549,703,743,6851,698,0,7549,3.41679e+18,83.3136,1489.51,7549,259,86,6806,6806,6806,6806,6572
41293,1202,3034,41013,280,41013,280,3.80934e+18,93.2502,5840.07,41293,498,76,38259,38254,35902,23771,19255
30291,9,14,29844,447,29612,679,8.20332e+13,6.72276,347.246,30291,9,10,30277,30276,28345,28344,27490
46298,10,12,46106,192,46234,64,1.07597e+14,8.37628,412.182,46298,11,11,46286,46285,46243,46242,45517
28138,436,700,21208,6930,0,28138,8.26493e+18,320.285,2332.48,28138,179,148,27438,27258,26963,26945,19892
10827,492,545,10827,0,9694,1133,1.75624e+18,233.749,1505.58,10827,111,127,10282,10282,10144,10226,9833
37773,308,1714,9108,28665,0,37773,3.23498e+13,262.191,3747.44,37773,329,269,35924,35075,30037,31527,8232
6885,244,337,1545,5340,0,6885,2.68859e+13,110.428,1098.44,6885,145,76,6548,6505,6447,6463,5034
5079,16,485,4833,246,4808,271,8.97791e+17,206.644,1156.59,5079,159,97,3272,2589,2212,2415,1198
48715,1294,1856,48715,0,45481,3234,9.24936e+17,709.203,5841.29,48715,405,283,46859,46762,44896,45385,38048
24935,531,601,24935,0,24935,0,3.92199e+18,261.376,2523.89,24935,191,156,24334,24318,23711,23501,22447
4809,123,272,0,4809,1328,3481,5.63419e+15,168.546,856.815,4809,184,72,4335,4036,4071,4275,2522
15183,220,994,14190,993,14190,993,2.03221e+18,240.81,2406.28,15183,224,142,13993,13632,13083,12847,7334
39507,1678,1756,0,39507,0,39507,1.87967e+18,317.597,4972.67,39507,322,206,37751,37750,37751,37751,37499
8512,633,1021,7860,652,0,8512,2.80197e+18,104.483,1981.41,8512,173,142,7491,7470,7329,7335,3300
43520,39,86,0,43520,42912,608,2.58428e+16,38.0158,1055.48,43520,40,37,43407,43313,42242,42412,36467
30040,9,12,29593,447,30040,0,9.52744e+13,10.4637,335.881,30040,11,12,30019,30004,29097,29096,27611
37427,728,870,0,37427,8044,29383,4.64873e+15,453.613,3370.59,37427,287,199,36557,36510,36160,36290,34690
31149,30,576,0,31149,7123,24026,7.33466e+15,227.826,2684.76,31149,238,129,26350,23688,21935,15739,4542
36247,159,1213,32463,3784,32463,3784,2.58098e+18,393.076,4233.43,36247,409,190,31613,28299,28130,25625,9123
23166,1573,2082,20807,2359,20807,2359,9.81175e+17,201.448,4197.07,23166,409,198,21084,21084,21035,21084,17795
30680,247,352,30677,3,30680,0,3.22071e+18,272.016,2359.88,30680,184,151,30034,28728,28448,26691,24612
4165,164,270,1155,3010,0,4165,6.25477e+13,51.558,640.386,4165,57,64,3895,3879,3839,3872,2680
13358,775,1238,13358,0,12482,876,1.86913e+18,202.202,2673.47,13358,317,149,12120,12053,11247,11822,9038
29868,636,670,29868,0,29868,0,3.2669e+18,269.151,2982.88,29868,189,173,29198,29198,29191,29193,28813
44000,509,933,0,44000,10996,33004,6.69531e+15,389.219,3773.73,44000,489,123,42782,41550,41165,41428,32081
41751,161,1278,8921,32830,0,41751,1.86006e+13,392.466,4254.9,41751,334,214,39387,38466,36466,29817,12543
34090,293,1560,30522,3568,30522,3568,3.23853e+18,255.769,3988.71,34090,409,162,32396,31815,28175,23958,7131
13579,539,741,2849,10730,0,13579,1.79104e+13,192.407,1986.06,13579,170,145,12838,12821,12628,12633,10558
15135,7,43,0,15135,15036,99,2.58998e+16,31.0812,413.446,15135,26,26,14820,14636,13960,13748,10032
39733,880,1232,37127,2606,37127,2606,2.01568e+18,612.121,4154.27,39733,394,220,38501,37342,37661,37446,32868
30029,77,606,27482,2547,30029,0,3.80341e+18,297.425,2809.72,30029,244,171,26891,24754,18418,14868,6900
20540,1324,1515,20540,0,18912,1628,8.06642e+17,188.454,3643.99,20540,451,138,19025,19025,19023,19022,17487
9951,13,326,2380,7571,0,9951,2.95933e+13,122.64,1263.52,9951,158,90,7628,6485,6174,2647,1644
32358,48,83,0,32358,31086,1272,2.44536e+16,29.8975,878.922,32358,34,34,32275,32267,31009,30978,20628
23827,120,319,23827,0,23827,0,3.45869e+18,235.834,1706.77,23827,118,186,22955,22304,17220,14960,10010
1142,177,265,1142,0,1142,0,4.16723e+18,40.0298,433.141,1142,56,48,877,867,804,813,689
20719,398,1858,18992,1727,0,20719,3.11329e+18,217.288,3675.03,20719,638,185,18861,18644,17640,17777,2953
18436,49,72,0,18436,18271,165,2.49833e+16,45.2554,660.4,18436,32,36,18359,18319,17855,17934,15679
33019,1089,1561,29806,3213,29803,3216,1.18785e+18,295.677,4190.16,33019,508,154,31458,31458,31240,31410,20939
11703,782,944,10860,843,10860,843,2.26796e+18,253.646,2181.6,11703,274,112,10759,10756,10741,10752,9762
13719,19,36,0,13719,13684,35,2.11252e+16,25.9786,400.759,13719,27,28,13609,13502,11854,12548,11345
35356,1678,1868,0,35356,0,35356,1.42446e+18,355.803,5042.6,35356,466,136,33488,33488,33369,33460,31469
18116,1177,1456,16249,1867,16248,1868,1.33198e+18,242.233,3488.28,18116,287,157,16660,16660,16625,16621,13498
21881,334,859,21881,0,19338,2543,1.16166e+18,392.952,2990.15,21881,266,164,20611,19887,19080,14277,8450
14409,174,193,0,14409,13924,485,2.51545e+16,21.1966,837.809,14409,73,34,14216,14216,14208,14215,12687
33144,22,48,0,33144,33033,111,2.65238e+16,26.8017,622.056,33144,24,26,33083,33056,32573,32468,24450
15524,39,43,0,15524,15318,206,2.63324e+16,20.123,410.843,15524,23,23,15481,15481,15474,15476,15346
27985,2507,2628,27985,0,25643,2342,3.6302e+18,226.381,5039.77,27985,582,172,25357,25357,24878,24727,24755
1785,153,183,1780,5,0,1785,7.06159e+18,7.33221,352.537,1785,134,19,1602,1602,1601,1602,1527
44962,60,66,0,44962,44339,623,2.4945e+16,44.4862,960.381,44962,40,44,44896,44882,44566,44649,44535
49738,194,943,37494,12244,37494,12244,7.01157e+18,391.902,3429.39,49738,269,192,47362,45860,33170,26141,12820
4398,448,549,4090,308,4090,308,2.17282e+18,119.516,1094.63,4398,127,109,3849,3835,3839,3840,3350
7334,79,328,0,7334,1722,5612,7.27208e+15,100.536,1094.73,7334,146,80,6861,6242,6282,5949,4105
24971,105,774,0,24971,5374,19597,4.77303e+15,362.498,2686.15,24971,307,167,23020,22143,20656,17516,8511
33401,903,2068,31041,2360,31041,2360,2.23243e+18,444.148,5128.74,33401,591,131,31333,31026,30053,29149,16665
46100,1012,1569,40875,5225,0,46100,3.46297e+18,342.753,5217.78,46100,443,189,44531,44529,42947,43171,29254
34747,1299,1963,34747,0,32285,2462,1.50456e+18,504.813,5213.55,34747,526,187,32784,32554,31984,32161,23823
7337,1,13,7291,46,7337,0,1.02086e+14,7.13003,169.694,7337,9,9,4041,4041,4041,4041,4041
20924,232,764,4405,16519,0,20924,1.91301e+13,369.483,2515.2,20924,262,164,19741,19127,18534,15856,10320
25321,1103,1739,0,25321,0,25321,3.96859e+18,241.224,3731.29,25321,292,196,23582,23577,23575,22215,21314
38642,629,1735,34683,3959,0,38642,3.74703e+18,277.191,4382.57,38642,518,176,36907,36800,32549,31681,12502
21465,311,661,16183,5282,0,21465,8.28575e+18,303.531,2073.18,21465,177,145,20721,19877,19936,19999,11648
32274,561,2080,29264,3010,0,32274,3.41984e+18,279.512,4996.44,32274,512,156,30194,29721,27600,26915,11641
38633,1373,2372,38633,0,35803,2830,2.23186e+18,525.075,6013.51,38633,570,195,36261,35952,34896,35379,23778
12736,118,526,9585,3151,9585,3151,7.07224e+18,242.06,1507.09,12736,140,114,11861,11593,9260,7528,4647
49409,1102,2541,45652,3757,45652,3757,2.39154e+18,546.642,6803.92,49409,857,148,46868,46435,45052,43547,27538
25384,651,1137,23745,1639,0,25384,2.344e+18,605.839,3356.2,25384,315,203,24089,23187,23271,23064,17027
20624,557,714,4498,16126,0,20624,1.80702e+13,317.643,2372.78,20624,235,151,19910,19642,19684,19654,17994
20210,742,1037,18825,1385,0,20210,2.46566e+18,434.228,2911.19,20210,262,179,19173,18658,18787,18676,15080
19615,1174,3747,2803,16812,0,19615,7.02234e+12,9.98384,4107.41,19615,478,18,15868,15868,13297,8889,7525
676,88,156,676,0,676,0,3.14623e+18,27.4172,277.273,676,43,36,520,510,469,377,381
2934,18,375,2934,0,2668,266,7.65154e+17,170.557,795.988,2934,145,62,1842,1511,1132,266,240
13227,93,616,2934,10293,0,13227,1.9407e+13,257.022,1733.15,13227,214,126,12140,11386,10797,10377,5026
46653,1968,2775,42246,4407,42246,4407,2.79535e+18,454.739,6843.16,46653,800,253,43878,43788,43752,43750,34826
41168,135,829,9990,31178,0,41168,2.71067e+13,225.825,3586.52,41168,350,148,39166,37542,33076,27902,14023
28646,9,14,28452,194,28646,0,9.89773e+13,11.2811,338.981,28646,12,11,28618,28611,27568,27566,27118
2524,98,276,311,2213,0,2524,2.48695e+13,59.6406,599.836,2524,122,32,2244,2126,1988,1666,799
3968,66,226,0,3968,1094,2874,5.0488e+15,54.8369,616.55,3968,125,48,3741,3625,3629,3638,896
14855,666,1084,14855,0,13885,970,1.01026e+18,280.422,2535.86,14855,275,165,13771,13552,13062,12309,11719
36949,277,1783,34450,2499,34450,2499,7.3376e+17,623.959,5017.79,36949,382,237,33642,32616,31129,31221,14667
34698,280,939,26126,8572,26126,8572,7.04637e+18,328.258,2885,34698,221,171,33460,32209,28823,25816,16751
11705,579,1083,10637,1068,0,11705,3.38452e+18,197.867,2416.88,11705,298,89,10622,10575,10282,10253,7704
16131,841,933,0,16131,0,16131,1.76403e+18,281.36,2491.38,16131,286,135,15198,15198,15121,15098,14259
24990,240,2242,24990,0,24876,114,2.32202e+17,14.8914,3657.42,24990,775,23,22748,22748,15705,19982,6677
2202,104,270,2202,0,2078,124,9.77746e+17,98.7607,591.18,2202,78,54,1896,1726,1544,1723,1042
39701,45,65,0,39701,39444,257,2.5421e+16,52.8145,890.486,39701,41,42,39588,39488,38140,38400,31743
31034,745,1112,27496,3538,0,31034,4.17117e+18,317.32,2955.75,31034,143,263,29922,29889,29406,29423,25144
25684,3,7,25658,26,25684,0,8.07474e+13,6.97516,313.356,25684,7,7,24622,24350,20509,20637,19614
27838,176,969,0,27838,0,27838,1.93149e+18,263.717,2754.14,27838,142,164,26189,24034,22897,13831,6987
2154,9,13,0,2154,2141,13,2.26142e+16,3.89369,108.365,2154,7,8,2141,2141,2141,2140,1919
41711,177,1322,38886,2825,0,41711,2.45776e+18,687.171,4451.55,41711,416,242,37938,36151,32743,31645,6681
18022,179,648,4570,13452,0,18022,2.57026e+13,192.571,2213.85,18022,286,124,17026,16097,15277,14986,9053
19875,174,616,0,19875,0,19875,4.11036e+18,288.344,1927.69,19875,155,137,18809,18350,15524,8520,7388
36874,1916,2457,33281,3593,33278,3596,1.35436e+18,293.292,5687.2,36874,596,207,34417,34417,34326,34403,25827
9973,5,11,0,9973,9959,14,9.28447e+15,5.0008,228.851,9973,8,6,9954,9926,9342,9337,6273
13205,204,408,13205,0,13205,0,5.27976e+18,167.311,1497.34,13205,172,108,12759,12519,11160,10801,9537
12974,709,951,12974,0,12112,862,9.84953e+17,284.509,2308.04,12974,174,147,12023,12020,11496,11816,10586
32265,522,1117,28416,3849,0,32265,3.64857e+18,332.596,3964.2,32265,386,200,31148,31065,27370,27696,14143
25477,226,845,25477,0,19171,6306,8.58367e+17,320.896,2764.31,25477,209,183,24076,23333,21368,19706,6143
17308,213,1288,0,17308,4338,12970,1.08745e+16,286.675,2886.32,17308,294,143,15604,15080,12857,6672,4454
42389,27,72,0,42389,42015,374,2.53151e+16,48.5938,975.982,42389,41,42,42186,42130,40382,40203,32221
7718,3,36,0,7718,7294,424,1.94009e+16,8.12037,288.457,7718,16,13,7227,6921,6166,6206,4670
13359,361,873,1724,11635,0,13359,4.35307e+11,11.8814,1739.57,13359,439,12,12486,12486,10462,11174,7913
15611,320,445,15142,469,15611,0,3.91727e+18,211.049,1666.98,15611,125,133,15166,15137,15117,15096,14579
32606,999,1689,6200,26406,0,32606,2.56629e+13,269.933,4196.92,32606,467,183,30917,30889,30457,30813,22839
47592,687,2374,43020,4572,43020,4572,2.90728e+18,288.567,5983.16,47592,487,258,45218,45133,43628,42636,23011
38004,875,1146,8968,29036,0,38004,2.46643e+13,351.292,3732.23,38004,409,142,36858,36730,36251,36524,32501
15349,419,446,15349,0,15349,0,3.41149e+18,228.898,1895.6,15349,153,137,14903,14902,14896,14897,14707
9294,467,913,8659,635,8659,635,2.08027e+18,211.477,1948.91,9294,172,131,8381,8271,8064,8036,5976
14794,26,62,0,14794,14503,291,2.26928e+16,13.9217,478.928,14794,19,28,14732,14727,14348,14365,13520
15658,662,746,0,15658,3566,12092,4.60658e+15,263.511,2065.05,15658,249,133,14912,14838,14833,14876,14351
26126,1015,1538,24068,2058,0,26126,2.92873e+18,252.007,4012.96,26126,459,120,24588,24588,24282,24345,15840
30629,109,577,30629,0,30629,0,3.1725e+18,275.315,2357.91,30629,175,141,29077,28264,21711,20435,6276
12032,13,15,12012,20,12030,2,7.76679e+12,10.3191,218.189,12032,12,12,12015,12008,12007,12007,12010
5292,84,441,0,5292,1134,4158,4.80681e+15,71.7251,1055.07,5292,97,116,4835,4630,4253,4360,1305
28181,411,899,0,28181,6282,21899,5.84012e+15,258.817,2976.96,28181,356,130,27282,27099,26807,26868,22281
8056,1,13,7996,60,8056,0,1.01361e+14,7.37053,176.828,8056,9,9,4438,4438,4438,4438,4438
21015,6,10,20850,165,21015,0,9.858e+13,9.43041,282.087,21015,10,10,20913,20820,19842,19829,16394
24871,410,522,23275,1596,24871,0,3.92362e+18,261.41,2384.7,24871,240,114,24349,24285,22740,22429,20416
48379,7,18,46664,1715,48379,0,9.52607e+13,10.578,498.214,48379,16,12,48126,47916,43853,44466,30681
4481,15,539,4481,0,4191,290,8.4568e+17,92.8371,1040.27,4481,189,58,3271,3091,1352,994,308
25056,20,63,0,25056,24850,206,2.55837e+16,39.329,688.854,25056,35,36,24842,24699,23669,23141,18623
43425,102,633,36734,6691,43425,0,3.89334e+18,352.706,3398.82,43425,309,169,40236,35730,29953,25197,11383
15841,133,690,0,15841,3400,12441,4.52626e+15,312.512,2120.74,15841,246,142,14653,14377,13541,11655,6726
3691,50,319,2782,909,0,3691,8.32658e+18,59.9526,709.619,3691,69,72,3269,2836,2468,2571,993
8383,376,619,7613,770,7613,770,1.58652e+18,163.35,1393.27,8383,356,61,7764,7636,7660,7764,7055
31051,264,465,31051,0,31051,0,5.17032e+18,296.782,2376.24,31051,184,156,30409,29954,27274,25777,22464
37447,1405,1894,34295,3152,0,37447,3.1145e+18,432.541,5196.2,37447,573,150,35553,35552,35010,34080,29870
44557,23,27,42555,2002,44553,4,9.56682e+13,10.6405,523.911,44557,15,16,44530,44529,44498,44496,44410
40356,579,1442,40356,0,35447,4909,1.06043e+18,394.161,4990.31,40356,386,209,38914,38777,36228,28566,17622
2738,423,499,2549,189,2549,189,2.14351e+18,69.8857,897.205,2738,82,101,2239,2239,2230,2234,1955
27898,34,1153,0,27898,0,27898,1.17169e+18,548.855,3476.77,27898,352,185,20445,15774,14816,13620,3756
46581,364,476,46581,0,46581,0,5.06025e+18,287.758,2943.57,46581,213,177,46105,45933,43663,43087,39070
38759,6,18,38060,699,38759,0,9.91654e+13,10.0495,420.87,38759,14,12,38536,38425,36187,36125,31763
11899,303,976,11095,804,11095,804,2.04114e+18,427.27,2296.12,11899,238,169,10669,10384,9978,9737,3204
35079,535,721,34951,128,35079,0,3.16551e+18,381.861,3156.06,35079,246,151,34358,34205,33270,33031,28523
41452,5,14,40711,741,41443,9,1.05577e+14,12.5372,377.846,41452,14,13,41317,41196,40543,40491,30789
45343,27,37,0,45343,43179,2164,2.4645e+16,30.4074,705.357,45343,32,33,45261,45132,43742,43626,40232
43259,10,13,42945,314,43259,0,1.02742e+14,11.4788,405.238,43259,13,12,43233,43219,41475,41473,36501
13692,192,431,13692,0,13692,0,3.64366e+18,267.394,1796.13,13692,166,129,12991,12694,11127,9356,6427
38210,400,404,9967,28243,0,38210,1.27655e+13,305.209,2553.95,38210,236,140,37806,37806,37806,37806,37799
6398,319,552,5953,445,5953,445,5.71697e+17,137.264,1275.98,6398,112,121,5846,5835,5651,5629,3538
30887,5,10,30669,218,30887,0,1.00317e+14,9.51183,343.334,30887,10,10,30657,30554,28428,29103,20158
7042,496,792,6554,488,0,7042,2.5407e+18,142.342,1651.64,7042,161,97,6250,6170,6125,6133,5345
10782,489,509,9424,1358,9424,1358,3.36403e+18,191.232,1682.3,10782,185,132,10273,10273,10266,10254,9856
20374,1037,1340,19002,1372,19002,1372,7.5102e+17,393.122,3359.44,20374,204,236,19034,19024,18724,18904,15569
21690,984,1903,19547,2143,19547,2143,9.81846e+17,196.845,3909.51,21690,409,193,19787,19787,19446,19629,14827
24507,638,691,24507,0,18456,6051,8.55417e+17,329.643,2296.21,24507,176,153,23816,23811,23758,23372,23269
33422,755,1297,33422,0,31303,2119,9.56983e+17,676.697,3998.88,33422,382,221,31930,30750,28837,28239,20861
36092,21,36,0,36092,34431,1661,2.45771e+16,30.8419,627.69,36092,30,30,35962,35840,32564,34474,30422
20706,1014,1442,19138,1568,19137,1569,1.31331e+18,262.144,3481.46,20706,453,110,19264,19264,19264,19264,12374
23079,407,1513,20053,3026,0,23079,7.85762e+18,14.8789,3025.14,23079,755,17,21566,21566,14239,17905,8075
4776,291,353,4462,314,4462,314,5.02768e+17,140.542,915.968,4776,107,74,4423,4422,4413,4404,4167
32830,224,1586,0,32830,0,32830,1.71714e+18,356.138,4490.85,32830,341,192,30534,29809,26699,22212,13255
17659,7,12,17601,58,17659,0,8.25189e+13,6.74863,275.538,17659,10,8,17646,17642,17397,17397,16973
755,1,13,753,2,754,1,8.76122e+13,5.22384,66.3308,755,11,7,275,275,275,275,275
21388,362,1162,20018,1370,20018,1370,6.836e+17,379.517,3180.43,21388,203,205,19882,19221,18723,18847,5685
32568,497,735,8008,24560,0,32568,2.64759e+13,221.116,3077.58,32568,328,143,31833,31833,31494,31480,24482
28198,1947,2016,25360,2838,25357,2841,1.35813e+18,219.235,4529.04,28198,458,152,26182,26182,26151,26181,25280
11052,323,408,11052,0,11052,0,2.98618e+18,196.845,1521.66,11052,118,110,10644,10618,10396,9774,9629
38011,919,1555,0,38011,6202,31809,5.23464e+15,312.033,4369.33,38011,582,102,36456,36374,35889,36336,25966
48058,1374,1979,48058,0,43727,4331,9.47198e+17,630.826,6014.57,48058,477,229,46079,46008,46007,45947,40124
22217,1238,1338,19753,2464,0,22217,4.02374e+18,206.267,3053.61,22217,358,138,20879,20879,20728,20743,19333
16424,4,10,16292,132,16424,0,9.95549e+13,8.78349,249.858,16424,10,10,16241,16175,14429,15078,12590
42628,2753,6711,42628,0,42628,0,1.85622e+18,84.1441,9662.93,42628,1368,20,35917,35842,35917,35580,18893
42213,70,92,0,42213,41736,477,2.76005e+16,25.791,770.742,42213,31,26,42121,42121,42065,41948,28204
34005,3715,6490,33195,810,0,34005,6.26143e+18,13.989,7035.91,34005,822,22,27515,27515,24743,24576,16814
22380,10,65,0,22380,22292,88,2.32562e+16,18.1385,604.383,22380,24,31,21930,21497,19974,20464,13291
28292,10,758,7123,21169,0,28292,2.64963e+13,209.317,2893.56,28292,307,133,20392,17868,15373,6160,2820
26391,1478,2126,23864,2527,23861,2530,1.47322e+18,246.914,4638.54,26391,590,152,24265,24265,24217,24248,19755
29866,1271,1536,27870,1996,27870,1996,7.19906e+17,552.028,4177.23,29866,389,197,28330,28330,28330,28330,26772
13014,619,1960,12807,207,12807,207,3.68367e+18,14.2498,2516.73,13014,358,22,11054,11054,9719,5585,5907
1379,64,103,1379,0,1379,0,4.93012e+18,16.108,255.974,1379,55,18,1276,1276,1276,1275,842
32483,31,48,0,32483,32378,105,2.73741e+16,19.6593,621.701,32483,24,25,32435,32424,32258,32295,29398
25979,552,562,7199,18780,0,25979,6.30272e+13,225.314,1880.67,25979,141,113,25417,25417,25417,25417,25331
25195,29,61,0,25195,25145,50,1.77435e+16,18.9494,642.323,25195,25,27,25134,25124,24248,24834,14352
21655,1384,1810,21655,0,19487,2168,1.14029e+18,201.405,3854.74,21655,478,105,19845,19845,19706,19634,15443
12024,362,387,3344,8680,0,12024,6.37812e+13,139.782,1158.19,12024,91,79,11637,11637,11637,11636,11210
4300,1,9,4260,40,4300,0,9.832e+13,6.36814,126.044,4300,8,8,2339,2339,2339,2339,2339
17976,1859,1991,14163,3813,14069,3907,3.40868e+18,177.255,3779.41,17976,290,214,15985,15985,15985,15985,15777
36139,1732,1838,33123,3016,33123,3016,7.38024e+17,424.435,4977.8,36139,380,215,34301,34301,34277,34278,34014
1293,145,197,1082,211,1082,211,2.16078e+18,116.356,437.243,1293,74,51,1071,853,973,990,843
46078,1202,1747,41514,4564,41514,4564,1.39373e+18,675.982,5540.77,46078,500,203,44331,43838,42777,42560,31333
30387,713,725,0,30387,0,30387,4.13934e+18,332.109,2485.47,30387,212,159,29662,29662,29662,29660,29632
28275,360,605,26995,1280,26995,1280,1.43426e+18,450.889,2825.79,28275,244,177,27441,26660,25400,25344,24107
23181,606,1196,21634,1547,21634,1547,6.50089e+17,520.496,3313.8,23181,304,191,21784,20960,21036,20937,14560
37698,314,1733,37698,0,33825,3873,7.81323e+17,467.367,4939.83,37698,431,172,34621,30195,27470,17484,8090
37486,592,667,35583,1903,37486,0,3.38476e+18,352.7,3238.52,37486,249,154,36819,36795,36383,36450,35273
20124,17,88,0,20124,19777,347,2.50111e+16,32.5373,761.292,20124,38,33,19831,19528,18543,17881,11029
4634,58,266,1085,3549,0,4634,1.90715e+13,102.08,739.784,4634,94,59,4095,3657,3714,3787,1697
15438,921,1054,14383,1055,0,15438,2.49085e+18,454.19,2628.05,15438,301,171,14384,14198,14279,14286,13660
48100,706,1021,36265,11835,36265,11835,6.99982e+18,370.477,3435.95,48100,248,190,47079,47022,46427,46152,38972
43800,944,1288,11648,32152,0,43800,5.35332e+13,218.714,4079.72,43800,248,156,42512,42509,41612,41651,30663
16441,23,104,0,16441,16119,322,2.71822e+16,20.0232,571.39,16441,36,23,16332,16261,15667,15157,8081
12106,683,947,11355,751,11355,751,1.90813e+18,238.88,2200.95,12106,233,137,11159,11025,11045,11060,9356
26300,94,1243,0,26300,4687,21613,4.62022e+15,196.902,3349.73,26300,389,98,24502,23658,23330,15667,4889
14279,181,575,12642,1637,12642,1637,3.1351e+18,313.421,2063.6,14279,206,139,13260,12807,10863,9453,4805
27060,46,63,0,27060,26851,209,2.5159e+16,49.7312,731.815,27060,37,36,26971,26904,26255,26489,23860
1527,6,19,0,1527,1496,31,1.98194e+16,4.99018,101.891,1527,9,10,1507,1502,1434,1469,1110
16539,1712,2761,0,16539,5505,11034,8.22674e+13,4.49797,3544.17,16539,1381,6,13778,13778,13254,13254,9603
32322,1562,5149,32322,0,32322,0,5.19995e+18,12.2657,7389.19,32322,1041,19,27173,27173,26888,24397,14282
23669,328,1011,17742,5927,17742,5927,7.07878e+18,257.292,2629.22,23669,211,140,22632,21851,21414,20844,13500
28470,256,470,28470,0,28470,0,5.10562e+18,261.533,2372.94,28470,209,156,27910,27559,25485,24676,22517
5093,190,250,5093,0,5093,0,4.00772e+18,145.919,786.369,5093,78,80,4831,4628,4587,4406,3835
4996,544,966,0,4996,0,4996,4.60424e+17,13.8949,1166.58,4996,131,22,4030,4030,3611,3949,2457
35731,372,724,35727,4,35731,0,4.37349e+18,290.229,3149.1,35731,213,136,35007,34837,28702,29457,22403
6484,201,827,6144,340,6144,340,1.67179e+18,157.055,1557.38,6484,195,119,5657,5531,5334,5193,2121
867,194,201,867,0,833,34,3.81847e+17,16.3045,333.229,867,47,40,666,666,657,666,648
19529,153,682,14696,4833,14696,4833,3.82345e+18,298.49,2088.57,19529,177,145,18260,17814,15157,15464,6458
44807,580,3295,44807,0,44627,180,1.18063e+18,95.488,6365.3,44807,675,79,41512,41510,40439,41363,33219
48493,388,1312,0,48493,0,48493,1.19256e+18,697.714,4676.44,48493,439,241,45767,44397,43089,37041,29084
20941,152,667,20941,0,15771,5170,8.38687e+17,315.368,2130.92,20941,171,149,19647,19129,16549,16126,6451
45007,141,1021,0,45007,9762,35245,4.71583e+15,442.687,3844.13,45007,340,200,42405,41475,39286,34615,10821
42688,105,484,42688,0,42688,0,5.05209e+18,325.512,2795.12,42688,201,168,40304,38172,26111,23681,13844
6142,184,1293,4921,1221,4921,1221,5.30255e+18,89.9769,2090.59,6142,209,160,4849,4714,3559,3030,1046
38453,417,1226,0,38453,0,38453,1.22044e+18,640.737,4174.23,38453,356,232,36218,34832,34213,30270,20187
3696,466,1066,2897,799,2807,889,3.84144e+18,60.9286,1601.87,3696,181,157,2630,2616,2309,2446,1339
41206,5,10,41075,131,41112,94,1.03926e+14,8.53065,378.891,41206,9,10,41126,41087,39551,39530,33880
43829,411,1435,41001,2828,41001,2828,6.76196e+17,736.423,4863.94,43829,364,271,41304,39859,38850,38912,22528
7933,445,937,7933,0,7403,530,9.51849e+17,182.307,1893.58,7933,210,136,6996,6825,6383,5783,5227
30076,1112,2168,27107,2969,27107,2969,1.06773e+18,240.124,4898.73,30076,372,263,27908,27908,26723,27145,18457
7703,300,541,7699,4,7703,0,4.76529e+18,137.539,1471.37,7703,127,98,7162,7075,6015,6119,5695
7797,532,599,7797,0,6893,904,1.17129e+18,266.933,1603.03,7797,173,117,7198,7147,7198,7190,6912
36831,817,2123,34178,2653,0,36831,2.70273e+18,481.029,5504.73,36831,643,134,34708,34132,33036,32479,18449
6649,607,659,0,6649,0,6649,1.44542e+18,170.462,1460.61,6649,159,76,5990,5988,5966,5964,5508
39604,152,1392,39604,0,37016,2588,9.36115e+17,684.774,4484.09,39604,411,243,35229,32797,27080,27330,13127
7191,43,51,0,7191,7083,108,2.47608e+16,25.8053,344.471,7191,28,26,7140,7135,7129,7133,7070
27943,74,1141,0,27943,5165,22778,5.42117e+15,295.248,3511.98,27943,359,108,25731,24176,23940,11442,5014
46197,37,745,46095,102,46197,0,3.43512e+18,398.721,3693.3,46197,266,178,36666,27275,25542,19314,5441
1607,152,253,1391,216,0,1607,4.67812e+18,42.4113,468.242,1607,74,52,1354,1352,1253,1275,434
34820,461,1910,7504,27316,0,34820,2.88018e+13,198.502,4400.75,34820,454,218,32910,32674,29261,17512,11229
15917,340,752,0,15917,3467,12450,4.90527e+15,329.502,2174.19,15917,264,144,15072,14723,14338,13577,8996
10067,747,949,10067,0,9363,704,1.01295e+18,193.877,2066.17,10067,198,153,9118,9067,8611,8901,7180
26702,1372,1739,26702,0,21534,5168,3.02534e+18,15.8854,3418.9,26702,871,16,24963,24963,24963,24963,20823
13152,262,360,3372,9780,0,13152,1.29082e+13,202.921,1476.1,13152,182,99,12792,12653,12247,12294,11853
39015,6,13,38710,305,39015,0,9.72809e+13,11.532,388.488,39015,13,12,38879,38785,36949,36727,33715
24840,1311,1577,0,24840,0,24840,1.59077e+18,296.156,3812.98,24840,448,109,23263,23263,23041,23263,22482
30456,32,62,0,30456,30334,122,2.76297e+16,25.2585,640.107,30456,27,27,30391,30352,30127,30261,27932
45109,789,1926,45109,0,42008,3101,1.00507e+18,533.167,5676.63,45109,403,297,43183,42657,38282,38045,19709
13852,2,43,0,13852,13763,89,2.60411e+16,28.3833,397.436,13852,25,26,11181,10556,9673,10158,7033
13273,299,926,0,13273,0,13273,1.16467e+18,271.338,2263.22,13273,196,162,12207,11920,11674,11328,3284
18310,864,1085,17153,1157,17153,1157,6.1819e+17,458.11,2860.74,18310,251,181,17225,16820,17069,16930,15727
33356,10,14,32788,568,33350,6,1.07051e+14,10.3486,336.562,33356,12,12,33334,33326,33060,33030,29039
40391,2677,2712,36860,3531,36857,3534,1.38703e+18,398.782,6387.9,40391,718,180,37679,37679,37679,37679,37521
6162,232,398,1532,4630,0,6162,3.27041e+13,64.4684,843.874,6162,57,83,5764,5739,5499,5618,4001
49820,79,920,37553,12267,37553,12267,7.02062e+18,394.768,3364.33,49820,277,184,46123,44414,30792,22500,9474
4666,24,400,0,4666,0,4666,4.15122e+18,78.1333,847.472,4666,94,84,3172,1880,2030,1367,622
28967,29,62,0,28967,28575,392,2.46917e+16,42.1642,782.698,28967,37,38,28835,28759,27786,27768,21784
3303,14,298,3303,0,3105,198,1.05031e+18,130.024,733.484,3303,98,66,1863,1341,1012,683,469
31495,199,592,0,31495,8772,22723,1.60546e+16,235.965,2075.54,31495,143,132,30722,29967,28543,28558,14250
3032,142,273,2610,422,2610,422,1.93793e+18,130.862,739.456,3032,105,73,2688,2285,2352,2430,1212
21510,103,698,0,21510,5586,15924,7.54026e+15,191.499,1929.8,21510,112,134,20266,19255,17685,18175,6051
47849,623,1433,47849,0,44675,3174,9.91149e+17,702.641,4898.61,47849,441,244,45595,43635,39989,35638,32786
6936,171,326,0,6936,1613,5323,7.36213e+15,115.17,1074.59,6936,145,74,6610,6532,5683,6076,3666
13358,1095,1105,12481,877,12481,877,7.1968e+17,445.786,2572.3,13358,253,160,12253,12253,12253,12253,12235
49356,396,1423,0,49356,11403,37953,5.69232e+15,375.532,4734.76,49356,402,200,47618,46717,45089,41590,17240
4060,2,7,4038,22,4060,0,1.12798e+14,6.62783,117.666,4060,7,7,3695,3564,2537,3527,2526
16544,350,786,16544,0,14604,1940,1.15968e+18,380.741,2548.96,16544,227,149,15491,14932,14445,12256,6529
39777,22,653,39777,0,39777,0,3.38903e+18,313.383,3368.6,39777,231,186,28185,22017,19169,12149,3155
12504,3,14,12390,114,12504,0,9.69767e+13,10.9111,224.757,12504,11,10,12019,11758,11140,11436,8835
19120,8,37,0,19120,19051,69,2.66071e+16,15.2361,466.756,19120,20,22,18981,18922,16873,17701,12903
33401,1229,1522,29914,3487,0,33401,3.80172e+18,249.566,3918.62,33401,407,159,31879,31879,30787,30807,24648
6611,61,411,6611,0,6212,399,1.05661e+18,159.593,1121.91,6611,136,86,5373,4694,4047,4183,1916
18009,642,754,15813,2196,15813,2196,1.74561e+18,339.955,2596.59,18009,218,153,17255,17255,17231,17211,15416
19928,7,27,0,19928,19911,17,1.3726e+16,9.94686,459.332,19928,15,10,18292,15656,14728,17100,12887
3456,94,342,3456,0,3456,0,2.916e+18,149.466,817.609,3456,113,73,2951,2726,2414,1961,1544
8751,191,782,7568,1183,7568,1183,1.99309e+18,274.112,1748.47,8751,174,128,7615,7151,5999,7074,4225
25774,961,1869,0,25774,0,25774,1.5848e+18,254.778,4124.72,25774,433,216,23905,23851,23651,23889,19169
19262,3,40,0,19262,19212,50,2.67065e+16,13.924,430.469,19262,20,19,17762,17147,14614,15092,8691
45680,1441,2462,45680,0,41084,4596,1.58169e+18,283.713,5798.82,45680,375,277,43218,43217,42446,40325,36472
46250,3,11,44108,2142,46250,0,9.60004e+13,10.8581,480.434,46250,11,11,41488,40154,32894,32663,26162
1862,27,172,443,1419,0,1862,2.0104e+13,71.6069,421.755,1862,62,45,1491,1230,1210,1008,480
43053,5,10,42742,311,43053,0,1.00082e+14,9.69034,405.377,43053,10,10,42731,42584,39586,40528,38066
24134,321,496,24134,0,24134,0,5.08024e+18,245.798,2290.45,24134,166,142,23638,23486,21829,20771,17831
48309,639,893,0,48309,10798,37511,4.45693e+15,484.848,3781.45,48309,341,203,47416,46841,46484,46547,41967
47307,970,1836,44126,3181,44126,3181,6.53799e+17,709.096,5638.06,47307,414,283,45471,45083,44045,43756,20145
26330,24,44,0,26330,26149,181,2.59495e+16,34.4082,553.107,26330,28,31,26229,26152,25688,25977,22167
27821,303,764,24488,3333,0,27821,3.8417e+18,336.012,3119.64,27821,273,182,26766,25934,23612,23955,10844
24134,771,898,24134,0,21271,2863,1.16908e+18,394.845,3190,24134,257,168,23236,23236,23163,23162,22129
36609,12,69,0,36609,36093,516,2.45212e+16,45.4935,881.097,36609,40,41,35414,34489,32703,31981,16665
31064,649,972,27356,3708,27356,3708,2.93548e+18,314.75,3727.12,31064,355,178,30092,30079,29297,28891,22124
3859,59,360,3859,0,3457,402,1.7666e+18,154.569,807.718,3859,78,82,3241,3038,2319,1196,873
7352,205,323,0,7352,2059,5293,1.63585e+16,82.715,854.061,7352,66,72,7029,6977,6938,6960,5283
12677,490,756,11271,1406,11271,1406,1.92538e+18,446.233,1906.94,12677,245,101,11685,11099,10777,11436,10387
31553,1886,2207,0,31553,0,31553,1.52884e+18,279.928,5077.66,31553,478,233,29346,29346,29346,29345,26653
44577,356,476,44577,0,44577,0,5.01956e+18,278.526,2885.05,44577,214,170,44101,43931,42158,41674,39001
48362,12,18,46532,1830,48362,0,9.57715e+13,10.3315,499.801,48362,16,12,48344,48341,47066,47068,37557
10464,16,1092,10158,306,0,10464,5.49246e+18,291.465,2119.57,10464,263,107,7062,4336,5054,4135,493
44127,9,10,43763,364,44063,64,1.01448e+14,7.70637,391.453,44127,9,10,44117,44115,44112,44112,43909
6523,5,8,6504,19,6523,0,1.18666e+14,6.07497,149.369,6523,8,7,6507,6501,6258,6261,5664
11665,8,9,11615,50,11660,5,1.1066e+14,6.53956,197.25,11665,8,8,11656,11656,11656,11656,11647
26676,15,58,0,26676,26252,424,2.77793e+16,40.998,548.167,26676,32,30,26502,26344,25625,25942,19176
33499,876,1019,33499,0,29463,4036,1.16716e+18,393.91,3894.42,33499,290,182,32480,32476,32374,32382,30191
36691,1312,1816,34270,2421,0,36691,2.4074e+18,495.71,4985.84,36691,393,220,34875,34817,34672,34655,30899
12287,65,82,0,12287,12109,178,1.95055e+16,18.9211,542.085,12287,30,29,12205,12205,12186,12203,9615
23678,487,1188,23678,0,22169,1509,9.54647e+17,509.586,3321.5,23678,345,194,22129,21385,19546,17732,15150
24823,757,1208,24823,0,23195,1628,9.25309e+17,583.375,3467.79,24823,305,198,23525,22666,21992,21517,19334
2521,157,417,0,2521,0,2521,1.21473e+18,135.948,793.066,2521,128,84,2053,1912,1921,1963,1151
36264,809,1800,0,36264,0,36264,1.21781e+18,504.533,5004.75,36264,383,218,34452,33494,33227,29173,24624
2225,28,46,0,2225,2203,22,2.33823e+16,21.6171,202.341,2225,22,21,2179,2165,2105,2148,1880
39988,1429,1841,36595,3393,0,39988,3.10599e+18,419.215,5140.51,39988,363,204,38147,38141,37676,37567,32876
47055,277,1712,47055,0,41248,5807,1.17552e+18,410.339,5329.57,47055,368,211,44068,42360,40218,28379,12086
44464,527,681,44464,0,44464,0,3.39811e+18,322.847,3597.59,44464,238,198,43783,43770,43176,42141,39484
17067,211,602,16343,724,16318,749,7.63162e+17,336.838,2193.09,17067,222,144,15530,13833,12535,14205,11451
48580,760,1665,0,48580,0,48580,1.65262e+18,577.581,5309.15,48580,626,193,46892,45747,43927,35428,32644
45108,458,647,45108,0,45108,0,3.70141e+18,336.892,3322.17,45108,204,177,44461,44330,40946,39728,33030
17583,990,1005,15250,2333,15250,2333,1.80006e+18,289.062,2800.44,17583,261,150,16578,16578,16578,16578,16566
37260,722,853,0,37260,0,37260,1.88167e+18,349.993,3722.69,37260,299,189,36407,36407,36251,36349,32562
13726,10,34,0,13726,13703,23,2.10724e+16,27.5273,397.971,13726,28,29,13111,12510,10952,11780,8373
41773,219,1155,41773,0,36693,5080,1.17169e+18,403.583,4497.69,41773,326,213,39118,37713,34680,26913,11919
26989,6,9,26928,61,18568,8421,7.02934e+13,7.29382,369.975,26989,9,9,26928,26876,26476,26504,22788
35234,2066,5612,35234,0,0,35234,8.20983e+18,12.2669,8037.47,35234,1133,19,29622,29622,24116,22282,16884
9529,542,864,2282,7247,0,9529,2.98927e+13,92.3704,1726.43,9529,177,111,8665,8665,8665,8665,7519
28612,183,561,7949,20663,0,28612,6.33612e+13,219.266,1960.39,28612,156,116,27860,27154,25465,23811,13416
9762,11,63,0,9762,9687,75,2.57096e+16,25.0113,440.817,9762,29,31,9418,9117,8750,8745,5826
41553,816,2101,41553,0,37904,3649,1.44009e+18,442.23,5623.78,41553,416,297,39435,38604,36467,35749,22339
17730,357,808,16496,1234,16496,1234,6.2591e+17,382.76,2364.49,17730,209,166,16685,16164,15976,16064,13166
47147,1109,1869,0,47147,10507,36640,6.4879e+15,274.201,5232.96,47147,569,165,45278,45278,42979,43567,31428
8996,285,862,8406,590,8406,590,2.01061e+18,171.452,1875.81,8996,183,136,8101,7930,7607,7512,4785
32426,17,37,0,32426,32399,27,1.37244e+16,9.95312,656.747,32426,18,10,32389,32389,30753,30835,24165
5586,12,410,0,5586,1374,4212,8.45518e+15,62.9062,820.149,5586,60,78,4218,3228,3344,3340,372
27500,823,834,0,27500,6338,21162,5.72277e+15,235.539,2955.83,27500,367,133,26666,26661,26666,26665,26629
36342,758,1649,33331,3011,33330,3012,9.33736e+17,440.144,4786.53,36342,366,221,34693,34561,34078,33808,26959
4410,117,260,0,4410,1221,3189,1.64874e+16,52.4254,644.027,4410,58,58,4150,4116,4022,4079,2645
36240,1458,1520,7567,28673,0,36240,2.52667e+13,292.155,4239.03,36240,368,195,34720,34720,34720,34720,34275
27665,16,521,0,27665,6420,21245,7.40513e+15,205.6,2458.56,27665,222,118,21851,18875,17674,11819,3704
38235,109,2169,34917,3318,34917,3318,2.70817e+18,349.253,5530.39,38235,540,189,34416,31851,31373,26689,5287
20489,1458,1698,18309,2180,18309,2180,3.30332e+18,185.59,3427.76,20489,393,159,18791,18791,18464,18404,16004
30391,3221,10774,16519,13872,16519,13872,3.02971e+18,573.077,13312,30391,10192,91,19617,19617,9015,13834,11702
22771,729,1152,21326,1445,21326,1445,6.42271e+17,507.754,3241.44,22771,258,187,21512,20856,21069,21131,16939
5219,50,710,4713,506,0,5219,3.59638e+18,69.7358,1306.61,5219,188,68,4373,4179,3741,3138,1047
34773,1569,2314,31787,2986,31784,2989,1.45152e+18,421.91,5544.2,34773,639,147,32459,32421,32447,32446,25595
11042,279,541,8313,2729,8313,2729,3.81988e+18,249.235,1494.98,11042,136,122,10442,10063,10191,10173,5859
8941,358,389,8941,0,8941,0,5.14401e+18,163.248,1266.41,8941,128,92,8552,8544,8496,8489,8097
21206,75,362,21206,0,21206,0,3.50609e+18,238.621,1705.52,21206,121,196,19854,18881,12363,9812,6132
12569,68,504,11238,1331,12569,0,3.0599e+18,225.742,1707.21,12569,225,106,10946,9744,8713,6992,3131
27072,415,1564,24205,2867,24202,2870,1.16834e+18,234.554,3624.16,27072,407,156,25508,25258,24611,24217,6999
33613,678,686,9341,24272,0,33613,6.31125e+13,228.858,2274,33613,166,131,32927,32927,32927,32926,32909
7812,5,10,7757,55,7812,0,9.91217e+13,7.35049,171.897,7812,9,9,7751,7726,7251,7383,6872
14402,319,453,14402,0,14402,0,3.34214e+18,234.166,1840.48,14402,146,125,13916,13758,13482,12824,11320
14532,10,66,0,14532,14425,107,2.48622e+16,37.6658,537.383,14532,31,31,13973,13533,13019,12769,6759
47428,85,763,47364,64,47428,0,3.46735e+18,380.779,3755.99,47428,269,174,41902,38617,31123,24294,7554
15437,27,61,0,15437,15341,96,2.67515e+16,26.5521,527.666,15437,30,30,15363,15350,14958,14555,13359
36734,445,650,27667,9067,36734,0,3.99719e+18,369.6,3059.19,36734,292,143,36046,35856,34720,33965,29649
31426,225,459,31426,0,31426,0,5.08571e+18,283.815,2386.52,31426,185,154,30700,30096,26727,25366,21447
15479,1,12,15318,161,15479,0,1.02778e+14,9.82925,236.48,15479,10,10,8438,8438,8438,8438,8438
15096,313,599,15032,64,15096,0,3.3522e+18,249.873,2008.41,15096,228,103,14457,14138,13462,12725,8769
3907,459,633,0,3907,0,3907,3.20841e+16,12.1459,979.54,3907,135,17,3274,3274,3034,2701,2673
49913,279,912,0,49913,11906,38007,6.98265e+15,235.552,4041.56,49913,361,162,49001,48294,43067,42665,23820
25819,773,1166,25819,0,24112,1707,9.82054e+17,541.663,3409.92,25819,362,195,24566,23784,22839,22390,21000
10996,325,384,0,10996,3037,7959,1.60752e+16,147.45,1136.85,10996,88,87,10612,10598,10561,10574,9627
18477,111,916,0,18477,0,18477,2.03353e+18,217.149,2214.8,18477,116,158,16873,16111,14861,11955,3302
39449,1123,1268,34901,4548,0,39449,3.4503e+18,349.482,4547.44,39449,375,188,38181,38181,38152,38142,35446
10150,101,279,10150,0,10150,0,3.75161e+18,196.243,1160.56,10150,105,110,9315,8689,7082,6542,4454
25526,662,1564,25526,0,23024,2502,7.69581e+17,372.273,4006.52,25526,431,147,23962,23718,21877,17501,11830
7338,3,8,7299,39,7274,64,7.66405e+13,4.09321,147.097,7338,6,7,7307,7299,6985,6986,5806
40530,178,648,9294,31236,0,40530,2.86705e+13,234.763,3155.35,40530,257,149,39421,38680,34116,34995,16934
23028,627,820,23028,0,20248,2780,1.15983e+18,370.273,3038.05,23028,237,168,22208,22206,21830,21626,17894
17914,743,862,17914,0,16700,1214,1.11475e+18,384.091,2437.82,17914,241,163,17052,16990,16822,16843,16376
39422,952,1367,0,39422,10164,29258,7.58335e+15,225.144,3427.66,39422,188,163,38055,38052,37962,38013,36474
17090,553,616,17090,0,12881,4209,8.87348e+17,275.776,1877.7,17090,150,134,16474,16473,16409,16214,15666
13966,27,1092,0,13966,0,13966,1.9046e+18,185.669,2354.02,13966,205,137,10839,8665,7549,4689,1168
7878,313,352,7878,0,7878,0,3.26306e+18,136.847,1052.96,7878,112,94,7526,7483,7322,7225,7097
36586,79,876,32233,4353,32233,4353,3.21277e+18,350.038,3722.68,36586,305,203,30682,25874,25175,22036,5195
15605,11,13,15498,107,15605,0,1.00487e+14,7.27985,242.512,15605,9,9,15592,15589,15217,15216,14923
28504,92,1369,26674,1830,26674,1830,2.00642e+18,467.432,3856.56,28504,366,174,24395,21187,21044,20917,6906
3514,3,7,3489,25,3514,0,1.07656e+14,6.6218,107.525,3514,7,7,3385,3315,3291,3279,2489
25149,346,618,25085,64,25149,0,3.26377e+18,298.145,2569.93,25149,206,135,24452,24338,22787,22151,17925
36145,6,10,35880,265,36145,0,9.99979e+13,9.65649,371.368,36145,10,10,35968,35801,34108,34083,28364
7597,2,11,7238,359,7597,0,9.5703e+13,9.56628,194.869,7597,11,10,5499,4642,4886,4804,3799
33175,148,1042,33175,0,29248,3927,1.16654e+18,415.839,3890.17,33175,298,187,29871,25200,24502,17411,6820
30622,204,760,0,30622,0,30622,1.87805e+18,333.569,3268.74,30622,274,178,29041,28076,23592,17063,7526
23054,62,482,23054,0,23054,0,4.76708e+18,300.766,2129.89,23054,186,117,20135,18375,11730,10423,6069
14305,179,563,3685,10620,0,14305,3.02411e+13,147.062,1497.51,14305,85,119,13733,13340,12114,12748,5488
8694,753,996,7901,793,0,8694,3.38514e+18,99.2294,1983.13,8694,242,79,7698,7698,7615,7649,5114
6599,522,549,6126,473,6126,473,6.39054e+17,134.835,1297.7,6599,147,84,6050,6050,6050,6050,6027
45733,559,7247,42642,3091,0,45733,6.74163e+18,14.217,8491.13,45733,1198,26,38486,38486,28010,27469,6102
30804,53,946,6623,24181,0,30804,1.84126e+13,358.044,3213.6,30804,304,161,27067,23753,23971,18054,7760
10921,32,344,2475,8446,0,10921,2.88979e+13,165.153,1368.9,10921,157,92,9286,8296,7775,4295,2517
7544,5,9,7349,195,7096,448,7.48089e+13,4.6926,153.693,7544,9,6,7532,7530,7327,7329,6390
33349,990,1387,6164,27185,0,33349,2.06631e+13,285.979,3958.38,33349,470,114,31962,31898,31617,25037,24896
26602,699,2064,23926,2676,23926,2676,1.08774e+18,243.001,4562.88,26602,374,257,24538,24469,23024,23756,15195
5815,27,34,0,5815,5800,15,2.14129e+16,25.4258,261.602,5815,22,25,5780,5754,5687,5697,5509
7437,188,604,7437,0,6962,475,1.04631e+18,147.978,1412.41,7437,182,87,6822,6602,6023,6365,3842
34433,444,980,0,34433,8115,26318,7.60823e+15,224.899,3305.07,34433,240,127,33453,33442,32457,29210,26648
39179,624,1120,39179,0,34564,4615,1.1582e+18,435.122,4319.94,39179,323,208,38059,38045,36059,32525,23035
49699,7,10,49343,356,49699,0,1.00421e+14,9.66404,435.573,49699,10,10,49566,49368,47275,47275,49486
7774,6,10,7751,23,7711,63,7.96923e+13,4.76357,161.691,7774,8,6,7761,7756,7650,7634,7221
8204,292,539,0,8204,0,8204,4.13843e+18,84.7332,1388.63,8204,115,121,7665,7646,7529,7050,5090
41458,532,1850,38588,2870,0,41458,2.53935e+18,527.454,5351.31,41458,410,273,39351,37703,36935,36793,18437
2659,1,13,2637,22,2659,0,9.7389e+13,5.82587,105.823,2659,8,9,1484,1484,1484,1484,1484
1209,125,198,1125,84,1125,84,6.13012e+17,77.9934,397.891,1209,57,47,1011,943,970,971,816
5394,167,305,1263,4131,0,5394,1.77932e+13,92.9707,829.29,5394,102,65,5089,5081,4927,4956,3832
29885,358,1209,26910,2975,26910,2975,2.55939e+18,375.161,3842.75,29885,404,177,28436,26441,26715,25063,17799
10754,546,920,10048,706,10048,706,2.03836e+18,182.485,2059.32,10754,223,111,9834,9725,9647,9578,8422
11910,993,1251,11000,910,11000,910,2.15198e+18,252.521,2542.99,11910,344,116,10659,10655,10597,10567,9414
1133,158,256,0,1133,0,1133,1.44939e+18,46.3116,442.402,1133,85,42,877,831,876,849,640
5576,565,639,5209,367,0,5576,2.41208e+18,117.313,1306.16,5576,122,117,4937,4937,4924,4925,4641
1753,116,179,1753,0,1298,455,8.93546e+17,66.1865,428.543,1753,56,59,1574,1563,1486,1375,1111
37450,304,471,37450,0,37450,0,5.03488e+18,269.703,2657.24,37450,209,171,36948,36652,34667,33794,31504
24152,356,1079,22584,1568,22584,1568,6.58142e+17,487.872,3185.47,24152,262,193,22516,21918,21261,21433,15881
40642,754,2504,36997,3645,36994,3648,1.36467e+18,381.941,6253.86,40642,648,184,38119,37652,35990,35976,15701
25436,2,11,24232,1204,25436,0,9.61533e+13,10.7977,356.774,25436,11,11,18399,15522,16319,16053,12859
16812,18,47,0,16812,16740,72,2.45293e+16,19.7829,444.657,16812,24,22,16754,16709,16442,16522,12081
15430,962,1164,0,15430,103,15327,1.28677e+14,13.8511,2237.31,15430,299,17,14266,14266,14067,12690,12231
30957,469,574,8612,22345,0,30957,6.34309e+13,226.673,2046.25,30957,156,123,30383,30376,30218,30184,28029
30803,44,45,0,30803,30762,41,2.08597e+16,27.96,624.257,30803,31,33,30758,30758,30582,30488,30689
9445,50,60,0,9445,9338,107,2.43524e+16,26.1448,467.42,9445,26,30,9385,9376,9229,9299,8822
41872,49,66,0,41872,41545,327,2.58411e+16,50.2593,912.767,41872,42,41,41773,41668,40502,40845,36348
21623,568,865,21623,0,19365,2258,1.78673e+18,260.385,2430.81,21623,140,154,20758,20728,19887,20460,17544
31627,657,1611,6485,25142,0,31627,2.58989e+13,214.521,4084.69,31627,489,135,30016,29989,28446,22909,16353
23146,11,13,22990,156,23146,0,1.01713e+14,9.77862,298.954,23146,11,10,23129,23123,22406,22405,23013
30446,381,961,28322,2124,0,30446,2.55595e+18,487.38,3178.49,30446,304,187,28997,28146,27651,27452,19116
20603,46,1087,0,20603,0,20603,1.25529e+18,475.314,3016.02,20603,288,170,15718,12751,12246,10578,2406
23329,963,1095,0,23329,0,23329,1.48104e+18,311.355,3307.43,23329,371,161,22234,22234,22230,22234,20855
1257,3,4,1253,4,1257,0,1.17337e+14,2.89578,60.3564,1257,4,4,1204,1180,1203,1204,1154
4978,400,428,3753,1225,3753,1225,3.81076e+18,105.684,947.555,4978,101,85,4550,4535,4545,4545,4402
43485,277,1703,39702,3783,39699,3786,9.88937e+17,552.012,5292.16,43485,410,240,40539,39401,37577,37165,10841
39652,503,1645,35410,4242,35410,4242,2.74684e+18,354.062,5048.34,39652,423,184,38007,37636,32067,28680,12432
47998,4,14,47378,620,46178,1820,8.68095e+13,7.4964,430.659,47998,10,11,47514,47270,44414,44438,37801
12639,52,953,11792,847,0,12639,2.44601e+18,274.307,2254.62,12639,231,123,9892,8109,7860,7384,1808
9050,158,369,9050,0,9050,0,5.01865e+18,149.374,1248.08,9050,123,97,8629,8349,7336,7135,6076
15816,783,925,0,15816,0,15816,1.1815e+18,392.105,2449.14,15816,235,163,14891,14672,14726,14717,14353
46944,151,634,44145,2799,46944,0,3.59037e+18,360.29,3556.09,46944,290,161,44781,42314,35193,30042,15652
24122,98,641,24058,64,24122,0,3.08306e+18,280.498,2551.21,24122,234,134,21436,19693,15975,12420,5418
5825,194,584,0,5825,977,4848,4.56472e+15,88.1145,1234.5,5825,216,65,5241,5117,5005,5065,2699
13989,519,1263,13989,0,12685,1304,8.02618e+17,255.138,2777.62,13989,409,109,12726,12589,11242,10980,4807
22631,20,548,14674,7957,22631,0,4.60946e+18,273.794,2204.38,22631,292,102,17632,16223,10384,8848,3070
6304,17,44,0,6304,6118,186,1.9729e+16,10.112,328.012,6304,19,13,6260,6255,6141,5991,4322
36731,516,625,36731,0,35165,1566,4.94894e+17,452.938,3243.28,36731,257,187,36039,35722,34827,30284,33816
7164,391,495,0,7164,1358,5806,3.64217e+15,54.6707,1201.68,7164,130,65,6669,6669,6668,6667,5722
5990,358,607,5360,630,5360,630,3.20636e+18,177.84,1369.35,5990,178,81,5383,5339,5119,5082,2893
37012,325,2203,34284,2728,34284,2728,2.31841e+18,383.382,5260.51,37012,746,145,34453,33637,31566,30741,10391
6433,624,656,0,6433,0,6433,2.20211e+18,105.967,1273.48,6433,93,129,5777,5777,5771,5771,5638
20304,178,698,18188,2116,18188,2116,8.93284e+17,283.147,2153.75,20304,129,145,18926,17203,17582,17043,5946
4854,340,536,4348,506,4348,506,1.79358e+18,167.482,1105.44,4854,169,84,4318,4179,4084,4258,3625
22864,869,972,20563,2301,20563,2301,1.74595e+18,530.948,2724.44,22864,440,111,21892,21516,21734,21743,21072
1888,35,193,1888,0,1669,219,2.26903e+18,49.7654,424.083,1888,54,49,1584,1276,1261,1538,399
45113,1098,1282,42074,3039,42074,3039,2.05645e+18,698.555,4611.52,45113,388,256,43831,43816,43435,43456,42047
29686,1158,1604,29686,0,26825,2861,7.76114e+17,463.176,4284.53,29686,421,168,28082,27981,27808,27591,23977
9977,273,661,9977,0,8853,1124,1.1307e+18,326.315,1885.48,9977,194,126,9121,8767,8255,6624,4341
46555,2172,3000,42042,4513,42039,4516,1.32993e+18,518.996,7172.52,46555,686,267,43555,43385,43232,43208,34264
41464,21,76,0,41464,41041,423,2.1942e+16,25.5744,884.082,41464,35,35,41231,40990,36328,37039,25500
1417,26,117,0,1417,379,1038,1.56625e+16,27.7085,280.292,1417,37,35,1276,1144,1102,1105,602
5836,2,33,0,5836,5800,36,1.95084e+16,9.58653,247.452,5836,15,14,4793,4360,4045,3962,3168
45242,51,1391,42212,3030,42212,3030,6.34428e+17,727.449,4708.07,45242,418,241,34844,28205,25526,25284,8631
2142,158,236,2142,0,2013,129,9.11487e+17,106.812,548.513,2142,71,59,1906,1872,1787,1848,1533
2500,90,283,357,2143,0,2500,1.261e+13,44.3032,596.245,2500,134,34,2217,2142,1957,2079,1250
15166,16,30,0,15166,15122,44,3.0028e+16,17.9345,361.455,15166,20,19,15113,15025,14804,14752,9951
45124,95,654,12591,32533,0,45124,6.27726e+13,273.97,2511.33,45124,168,147,43369,42521,36465,27876,11698
48347,1401,2103,43216,5131,43216,5131,1.44525e+18,484.388,6052.58,48347,530,181,46244,46198,45952,46078,35987
44133,6943,7787,42219,1914,0,44133,6.47628e+18,14.092,8691.84,44133,1103,26,36346,36346,33878,34296,30333
5213,355,436,5213,0,3933,1280,8.20891e+17,87.276,958.276,5213,96,94,4777,4769,4662,4439,3874
7480,389,556,1616,5864,0,7480,2.01136e+13,92.8678,1348.59,7480,149,67,6924,6924,6824,6766,5998
21868,1393,1479,19505,2363,19505,2363,3.08972e+18,282.174,3437.08,21868,332,207,20389,20389,20389,20389,20101
48358,369,628,46232,2126,0,48358,1.66621e+18,473.214,3660.91,48358,288,203,47338,46203,43847,44377,42428
2404,22,29,0,2404,2401,3,2.12517e+16,17.4493,158.953,2404,18,19,2372,2362,2302,2301,2308
752,31,116,0,752,0,752,1.86418e+18,31.3816,225.824,752,40,32,622,520,590,525,239
35626,327,1210,33264,2362,0,35626,2.43664e+18,603.374,3981.07,35626,300,207,33431,32286,31487,31236,8429
45289,12,51,0,45289,45247,42,1.33841e+16,9.56457,877.148,45289,20,12,45238,45238,36953,40028,27394
39945,1334,1428,9227,30718,0,39945,2.77506e+13,242.333,4225.09,39945,381,159,38517,38512,38517,38517,37936
30942,1695,2038,28587,2355,28587,2355,2.39279e+18,431.841,4722.21,30942,712,142,28904,28896,28587,28484,27237
14220,9,966,14220,0,12860,1360,8.21379e+17,449.792,2122.81,14220,401,100,8917,6447,5420,1330,2392
16834,473,1210,15205,1629,0,16834,3.53777e+18,254.686,2727.36,16834,465,122,15618,15322,14591,14011,11222
2605,306,431,285,2320,0,2605,4.07336e+13,8.02035,574.26,2605,190,18,2174,2174,2059,2174,1800
47400,164,538,47400,0,47400,0,3.29058e+18,329.746,2854,47400,207,155,45735,44567,36020,35097,16582
18038,18,28,0,18038,18024,14,1.6934e+16,13.0131,515.725,18038,19,17,18010,18010,16707,16825,16907
22394,35,53,0,22394,22123,271,2.57482e+16,42.9005,614.072,22394,34,34,22311,22258,21532,21887,19558
26538,454,1053,24739,1799,24739,1799,2.09068e+18,519.11,3256.07,26538,304,184,25081,24365,24089,23867,19079
48757,896,1018,10700,38057,0,48757,1.87679e+13,456.687,3946.51,48757,303,197,47739,47675,47552,47402,46579
21907,66,683,0,21907,0,21907,1.85455e+18,332.777,2679.76,21907,258,162,17900,15157,14675,3434,3061
29067,523,835,0,29067,6720,22347,5.77123e+15,238.741,3002.27,29067,368,132,28232,28124,27599,27838,21584
7626,1,20,0,7626,7608,18,3.03783e+16,17.7506,250.673,7626,18,16,3390,3390,3390,3390,3390
39088,6,7,39053,35,39088,0,4.67061e+13,5.59466,404.461,39088,6,6,39081,39081,37966,37966,37594
8126,171,554,8126,0,7122,1004,7.71222e+17,367.076,1608.79,8126,230,115,6702,6053,5035,3641,1792
32469,17,46,0,32469,30945,1524,2.45498e+16,29.7822,640.252,32469,32,30,32297,32184,28894,30512,21741
7402,20,22,0,7402,7199,203,2.59532e+16,7.97095,242.774,7402,11,10,7380,7380,7379,7380,7154
33041,386,448,33041,0,33041,0,3.66055e+18,251.071,2604.21,33041,248,161,32593,32570,31996,31623,30136
38092,554,1347,0,38092,10419,27673,1.60991e+16,226.544,3372.12,38092,264,138,36745,36703,36025,35752,33460
41851,7,13,41528,323,41851,0,9.92303e+13,11.3914,398.521,41851,13,12,41804,41793,40087,40084,38095
28194,306,406,28194,0,28194,0,3.17934e+18,346.108,1713.52,28194,159,163,27292,25696,26606,26857,21272
13481,75,840,13481,0,12035,1446,9.30635e+17,418.826,2068.59,13481,256,102,11421,10246,9672,4503,2552
37260,50,51,0,37260,36917,343,1.87261e+16,25.0576,787.931,37260,32,27,37209,37209,37208,37207,37192
20201,225,1326,0,20201,0,20201,1.98966e+18,184.81,2940.71,20201,358,133,18796,17678,16314,14625,5473
12831,1,12,12668,163,12831,0,9.88488e+13,9.84779,216.909,12831,10,10,7080,7080,7080,7080,7080
34970,1031,1195,31348,3622,0,34970,2.9909e+18,393.325,4156.53,34970,409,184,33775,33731,33668,33625,28315
47197,1308,2274,0,47197,0,47197,3.46005e+18,350.069,5863.19,47197,427,270,44923,44915,44502,37438,31405
45912,215,735,12775,33137,0,45912,6.32095e+13,266.964,2771.75,45912,201,163,44949,43781,39545,38278,19448
30803,37,44,0,30803,30584,219,2.56622e+16,36.6491,599.131,30803,30,31,30740,30650,30559,30466,29278
34218,616,771,0,34218,8412,25806,6.87341e+15,211.091,3207.58,34218,340,142,33447,33447,33288,33337,27772
11031,327,381,0,11031,3067,7964,1.61549e+16,140.454,1130.72,11031,92,88,10650,10644,10609,10621,9997
17608,410,1190,0,17608,0,17608,1.43422e+18,344.46,3062.92,17608,387,134,16404,15838,15102,11337,7214
13440,23,62,0,13440,13346,94,2.6834e+16,26.1854,502.592,13440,31,31,13350,13302,12832,12627,10732
43162,362,1441,40318,2844,0,43162,2.42553e+18,627.981,4670.02,43162,371,232,40678,39139,38253,37942,19776
6207,42,766,5790,417,5790,417,7.21117e+17,115.685,1562.43,6207,99,139,4510,3563,3137,3185,921
37715,63,91,0,37715,37614,101,2.12687e+16,29.9509,896.429,37715,38,34,37624,37621,37610,37623,36502
30499,959,978,26839,3660,26839,3660,1.71324e+18,401.709,3675.51,30499,295,201,29521,29521,29520,29521,29436
13700,3,10,13613,87,13700,0,1.0168e+14,8.79358,229.402,13700,10,10,13005,12700,11002,12311,8821
25986,1293,2035,23782,2204,0,25986,3.17369e+18,244.136,4348.92,25986,522,216,23951,23951,23730,23773,18733
46105,1,12,45478,627,46105,0,9.72847e+13,11.1028,414.893,46105,12,12,25852,25852,25852,25852,25852
14619,521,624,0,14619,3203,11416,4.39175e+15,219.03,1883.22,14619,188,120,13995,13831,13944,13945,12984
21392,1034,1204,19330,2062,19330,2062,2.43864e+18,350.589,3329.91,21392,390,137,20188,20160,20086,19964,16620
21161,180,816,0,21161,0,21161,2.15478e+18,295.385,2114.02,21161,111,223,19944,19442,17024,14797,6105
10923,250,307,10923,0,10923,0,4.76506e+18,211.562,1214.71,10923,169,71,10594,10501,9733,9676,8259
14647,39,549,0,14647,0,14647,4.13103e+18,236.515,1601.96,14647,140,121,12423,6962,8513,3944,2565
33377,145,1369,30386,2991,30386,2991,2.42037e+18,637.151,4212.98,33377,461,167,29107,26422,25585,22624,6654
34694,33,583,9672,25022,0,34694,6.29671e+13,249.388,2151.06,34694,154,127,32330,30773,27150,11755,6559
18393,524,1050,17160,1233,0,18393,2.40493e+18,443.163,2855.06,18393,269,180,17130,16537,16511,16408,9548
21145,311,766,0,21145,4694,16451,4.74029e+15,344.471,2442.69,21145,279,147,20180,19731,19360,18888,13148
22305,3,62,0,22305,22138,167,2.59091e+16,42.4979,655.883,22305,33,35,18781,17597,13557,12095,9290
9799,610,1027,8570,1229,0,9799,4.48468e+18,318.22,2005.79,9799,244,152,8772,8339,8201,8597,6523
10070,467,601,0,10070,2193,7877,4.75144e+15,135.574,1580.15,10070,163,91,9469,9443,9362,9432,8860
13651,59,391,13651,0,13651,0,5.05161e+18,180.407,1505.36,13651,139,109,11976,10252,7486,6774,3785
3104,179,576,3104,0,2780,324,9.27292e+17,75.1198,1011.27,3104,136,70,2528,2440,2123,1371,1364
46061,1106,1317,43014,3047,0,46061,2.39641e+18,694.919,4596.38,46061,406,243,44744,44714,44293,44222,42716
24636,167,653,18554,6082,0,24636,8.29263e+18,298.506,2149.61,24636,166,143,23427,22917,18638,18624,10237
38372,1705,2257,38372,0,34532,3840,1.58792e+18,264.535,5187.58,38372,357,262,36115,36114,35882,35234,32465
40979,544,602,40979,0,40979,0,3.10105e+18,313.697,2731.67,40979,203,155,40377,40370,39925,39728,39008
14397,2,10,14209,188,14268,129,8.59461e+13,7.70369,275.065,14397,9,8,12920,12372,10945,12178,8993
16545,327,638,0,16545,4279,12266,7.58199e+15,165.699,1709.29,16545,95,125,15907,15858,15143,15233,10805
22411,602,836,0,22411,4954,17457,5.78113e+15,225.629,2705.78,22411,364,104,21575,21525,21325,21307,15266
30612,1273,1325,0,30612,0,30612,1.19678e+18,529.928,3925.28,30612,310,213,29287,29235,29285,29274,28646
886,178,230,858,28,0,886,5.55397e+18,68.7675,350.448,886,51,53,656,582,620,637,511
15782,698,956,0,15782,0,15782,1.20508e+18,280.983,2465.2,15782,203,164,14826,14811,14612,14500,12137
39037,967,1881,35020,4017,35017,4020,1.06421e+18,264.24,4535.4,39037,422,179,37156,37152,36634,37005,14331
37758,624,2008,37758,0,33462,4296,1.22673e+18,351.687,5350.65,37758,406,211,35750,35702,33202,31301,19478
39564,2028,3513,29091,10473,29091,10473,5.49272e+18,21.9827,4344.11,39564,1179,1175,36051,36051,25693,22244,34079
17739,82,450,0,17739,4030,13709,7.28476e+15,205.961,1895.16,17739,195,104,16670,15351,14109,13448,5737
37375,462,907,8020,29355,0,37375,2.1396e+13,424.19,3516.57,37375,419,135,36344,35969,34735,34818,19005
15381,481,755,15381,0,13599,1782,2.24764e+18,262.095,1866.97,15381,106,192,14626,14344,13714,14289,11271
16126,1,33,0,16126,15369,757,2.46703e+16,27.0647,409.32,16126,25,24,6166,6166,6166,6166,6166
9537,434,534,0,9537,2223,7314,5.9311e+15,126.824,1221.11,9537,194,44,9003,8926,8915,9003,8769
2063,3,220,2063,0,1887,176,7.2736e+17,58.6491,511.997,2063,93,37,785,592,206,170,123
12086,7,20,0,12086,11835,251,2.76759e+16,16.8502,314.155,12086,19,18,11942,11858,10773,11389,7823
12881,95,343,12881,0,12881,0,3.93154e+18,189.61,1386.23,12881,115,120,11857,11074,7876,6988,4622
38617,1864,1869,38617,0,35966,2651,9.65996e+17,571.812,5393.52,38617,386,271,36748,36748,36746,36743,36731
6920,340,650,0,6920,0,6920,1.9805e+18,110.548,1334.81,6920,377,56,6270,6270,5862,5904,3793
25354,528,758,6598,18756,0,25354,2.50577e+13,258.266,2509.03,25354,389,107,24596,24360,23383,23134,20114
5851,79,324,5851,0,5851,0,3.2712e+18,115.552,901.943,5851,106,83,5433,5229,4036,3796,1696
30170,541,578,30170,0,30170,0,3.4208e+18,306.551,2865.98,30170,213,171,29592,29590,29539,29451,29189
49715,2013,2743,45446,4269,0,49715,3.07699e+18,547.338,6804.95,49715,798,259,46972,46941,46757,46702,37571
45682,3,11,45254,428,45682,0,1.00773e+14,8.87625,418.527,45682,10,10,43777,42956,37919,41669,34740
26115,1475,1735,24190,1925,0,26115,2.7541e+18,384.547,3906.33,26115,711,124,24380,24299,24297,24211,21882
23702,686,835,17859,5843,17859,5843,3.80662e+18,296.653,2448.42,23702,185,162,22867,22844,22825,22817,20112
40722,171,965,30691,10031,0,40722,8.29033e+18,345.357,3108.75,40722,228,183,38693,37551,28765,29158,11691
33497,1,10,33262,235,33497,0,1.00844e+14,9.42028,358.49,33497,10,10,17824,17824,17824,17824,17824
49603,5,38,0,49603,47318,2285,2.45593e+16,31.471,745.081,49603,33,32,45846,44831,33707,32848,25026
29574,677,1763,29574,0,27338,2236,7.94846e+17,247.629,4516.18,29574,462,151,27811,27541,26683,26875,12097
4010,333,700,3729,281,3729,281,2.15118e+18,153.984,1274.62,4010,130,93,3310,3182,3099,3105,2105
47813,6,12,47182,631,47813,0,9.83601e+13,10.9247,422.247,47813,12,12,47644,47531,45447,45323,39007
3006,135,393,3006,0,2789,217,1.10242e+18,95.4614,809.939,3006,118,64,2607,2472,2284,2417,1770
3676,120,290,25,3651,0,3676,5.06152e+11,6.39799,595.885,3676,179,13,3386,3386,3226,3201,1677
15604,63,1327,14363,1241,14363,1241,1.32563e+18,315.565,3012.98,15604,426,117,12692,11980,8949,10314,1706
31892,168,816,0,31892,6960,24932,4.8319e+15,429.233,3052.63,31892,326,178,30026,29556,27867,25615,8271
19492,785,1485,17875,1617,0,19492,3.08124e+18,235.581,3169.93,19492,694,108,18007,17783,17532,17212,10679
48231,230,1962,43254,4977,0,48231,3.77421e+18,293.465,5047.07,48231,526,182,45701,42474,39377,38880,8423
969,341,357,969,0,890,79,1.33253e+18,22.6285,481.02,969,82,57,612,612,612,612,604
7263,207,396,6594,669,7263,0,4.23732e+18,154.344,1179.48,7263,198,71,6864,6693,6041,5814,4620
24020,1467,1596,22417,1603,22417,1603,7.47509e+17,416.479,4116.59,24020,283,220,22424,22415,22380,22399,21454
1659,112,275,0,1659,0,1659,3.19907e+16,12.0277,445.713,1659,65,17,1384,1384,1157,770,821
37172,551,611,37172,0,37172,0,3.39995e+18,309.174,3206,37172,219,188,36561,36557,36437,36184,35563
34902,32,47,0,34902,34784,118,2.526e+16,31.6453,624.994,34902,24,25,34844,34823,34641,34421,26051
21061,213,875,0,21061,5378,15683,7.93194e+15,169.568,2144.73,21061,170,132,20171,19913,16951,17587,2440
47178,1132,2135,42111,5067,0,47178,3.5852e+18,385.64,5822.39,47178,471,236,45043,44928,44854,44965,35749
44348,725,889,10646,33702,0,44348,2.74773e+13,225.898,3780.97,44348,359,156,43459,43459,43296,43394,37953
9841,23,43,0,9841,9794,47,2.70994e+16,16.5382,316.973,9841,21,22,9798,9781,9691,9729,9051
4660,156,384,0,4660,0,4660,4.10312e+18,73.6152,840.309,4660,87,75,4276,4246,4137,3311,2411
28666,634,1309,7783,20883,0,28666,6.14629e+13,189.527,3119.45,28666,244,138,27357,27319,26865,27025,25363
15101,399,1360,13006,2095,0,15101,4.83583e+18,412.055,2814.97,15101,290,185,13422,12807,11461,11873,1854
44114,5,74,0,44114,43996,118,2.20956e+16,27.437,883.11,44114,33,35,40453,38734,34007,33619,21662
20548,697,1142,20548,0,19168,1380,9.61642e+17,470.81,3067.39,20548,305,173,19324,18799,18286,18356,17206
43489,4,13,43204,285,36355,7134,8.32602e+13,8.86387,486.677,43489,11,10,43110,42957,36952,40394,27246
22460,868,1375,0,22460,0,22460,1.4407e+18,398.728,3506.82,22460,417,133,21085,20997,20628,19172,17251
16485,822,893,14851,1634,14851,1634,1.29257e+18,352.315,2690.24,16485,285,156,15592,15592,15592,15592,15373
18622,4,10,18489,133,18622,0,1.00561e+14,9.25046,266.944,18622,10,10,18412,18338,16096,17110,12406
35482,55,785,26764,8718,26764,8718,6.96915e+18,328.463,2719.3,35482,200,162,32251,28752,22363,16265,4396
28828,1,10,28618,210,28828,0,9.98071e+13,9.53313,331.701,28828,10,10,15491,15491,15491,15491,15491
30660,34,44,0,30660,30438,222,2.55986e+16,37.8594,599.564,30660,31,33,30583,30484,30367,30489,26527
37765,14,68,0,37765,37600,165,2.68807e+16,30.3232,758.734,37765,30,30,37552,37293,36375,35847,24256
8363,131,582,0,8363,1828,6535,4.60124e+15,109.59,1472.21,8363,165,81,7765,7597,7195,6261,3842
39568,418,765,39504,64,39568,0,3.14428e+18,385.333,3535.37,39568,246,166,38685,38509,35892,34285,25930
1387,118,150,0,1387,326,1061,5.40267e+15,56.093,345.235,1387,56,38,1237,1228,1228,1225,1099
7410,3,10,7370,40,7410,0,1.03929e+14,6.30432,161.614,7410,8,7,7137,7010,6862,6860,5336
15929,409,957,14902,1027,14902,1027,2.00355e+18,285.892,2431.13,15929,241,144,14913,14659,14370,14310,11584
23610,535,1360,0,23610,0,23610,1.26031e+18,471.959,3575.78,23610,326,179,22061,21125,20979,17849,14525
18873,437,666,0,18873,4271,14602,4.83341e+15,278.817,2091.73,18873,208,118,18207,17920,17872,17886,15610
2823,170,171,676,2147,0,2823,1.49552e+13,78.4764,496.755,2823,75,47,2652,2652,2652,2652,2651
12622,12,21,0,12622,12614,8,1.69441e+16,12.9422,402.571,12622,16,15,12202,8168,10790,11339,11516
10598,866,952,0,10598,0,10598,3.14883e+18,116.208,2121.51,10598,192,114,9646,9646,9640,9640,9130
38632,1138,1962,38632,0,32991,5641,9.08302e+17,353.846,5592.64,38632,413,233,36670,36638,36021,35665,22058
39361,9,11,39072,289,39361,0,1.01553e+14,9.41772,391.653,39361,10,10,39343,39335,39175,39174,39316
40330,1036,1247,37673,2657,37673,2657,2.02146e+18,656.784,4256.24,40330,358,222,39083,38921,38677,38646,36857
17356,439,522,15536,1820,17356,0,3.88341e+18,248.161,1970.52,17356,253,106,16834,16748,15950,15856,15240
20186,964,1265,18923,1263,18923,1263,1.96021e+18,375.013,3258.75,20186,267,204,18921,18818,18633,18635,13618
42087,283,517,42087,0,42087,0,3.46173e+18,394.546,2642.26,42087,514,52,40771,39679,38478,37759,24435
13121,549,758,11716,1405,11716,1405,2.64816e+18,277.348,2159.93,13121,240,119,12363,12336,11822,11820,8016
12636,204,391,2891,9745,0,12636,2.89303e+13,170.651,1538.77,12636,173,95,12188,12034,11614,11791,7723
41634,839,1589,0,41634,0,41634,1.99966e+18,285.18,3995.58,41634,313,176,40045,40040,36025,20254,19710
1256,3,93,0,1256,160,1096,1.40132e+16,11.6537,220.761,1256,50,12,688,688,404,444,281
34801,11,18,33404,1397,34801,0,9.53677e+13,10.3331,424.654,34801,16,12,34782,34779,33686,32122,23844
9877,246,586,0,9877,1184,8693,7.20398e+15,87.5631,1470.73,9877,273,48,9291,9283,9018,9000,4768
33179,932,1050,0,33179,7164,26015,4.68894e+15,364.893,3452.75,33179,337,199,32129,32129,32064,32070,30591
26620,5,36,0,26620,25361,1259,2.466e+16,26.8103,536.194,26620,29,28,24606,24066,18031,18592,13009
34768,59,88,0,34768,33794,974,2.06569e+16,29.8042,889.955,34768,37,35,34680,34676,34596,34620,23091
36149,169,1721,32544,3605,32544,3605,1.37383e+18,473.26,4827.06,36149,440,172,31107,28194,24107,26743,7451
2775,284,360,2624,151,0,2775,2.10718e+18,92.1856,700.003,2775,113,57,2415,2415,2415,2415,2176
49087,6,15,48086,1001,46095,2992,7.87653e+13,6.59979,440.052,49087,9,10,48980,48782,45324,45327,39633
2033,37,354,0,2033,0,2033,1.27943e+18,64.5676,641.916,2033,100,61,1582,1170,1244,1305,548
18637,159,626,16413,2224,16413,2224,3.21273e+18,302.929,2424.54,18637,228,162,17343,16657,14451,12858,7151
663,6,50,0,663,651,12,2.18456e+16,8.99548,123.281,663,21,15,591,571,502,529,299
44789,887,1312,39332,5457,39332,5457,1.72178e+18,412.885,4800.9,44789,336,214,43477,43475,42384,42692,32746
687,53,59,0,687,0,687,2.86017e+16,14.2955,146.051,687,30,15,628,628,622,622,610
30590,60,1617,30590,0,27374,3216,1.54441e+18,251.399,3843.61,30590,457,156,26180,24789,19161,5168,3317
40669,553,1793,37933,2736,0,40669,2.47098e+18,473.699,5218.79,40669,381,252,38658,37291,36715,36475,20409
522,1,16,0,522,521,1,2.95409e+16,7.77586,57.9572,522,9,9,240,240,240,240,240
8760,1,50,0,8760,8669,91,2.64129e+16,21.8546,376.473,8760,26,27,2239,2239,2239,2239,2239
10753,602,790,0,10753,0,10753,4.12203e+18,145.06,1718.64,10753,163,94,9963,9963,9862,9802,9552
23454,150,1950,21248,2206,21245,2209,1.53994e+18,260.561,4234.07,23454,590,128,20893,19439,17769,19495,4683
44947,1521,1938,39742,5205,39742,5205,3.41253e+18,439.599,5719.81,44947,402,232,43009,42996,42546,42213,37156
42998,1196,1289,10115,32883,0,42998,2.91765e+13,312.101,4425.07,42998,313,192,41709,41706,41696,41683,40930
6110,105,562,6110,0,5707,403,1.09115e+18,136.621,1281.2,6110,166,80,5241,4608,4126,4821,2318
25172,547,1471,22705,2467,22705,2467,1.40237e+18,410.901,3885.7,25172,435,159,23660,23419,20100,20843,8422
41861,130,685,41797,64,41861,0,3.7864e+18,389.051,3464.42,41861,255,156,38661,35417,28973,27295,13260
47851,59,913,0,47851,11498,36353,7.04547e+15,238.601,3967.83,47851,363,160,42710,38891,36434,32294,6811
39586,3,10,39460,126,39522,64,1.06316e+14,8.06783,371.121,39586,9,10,38169,37425,34915,36693,28318
17140,445,1614,16689,451,16689,451,3.15234e+18,302.085,3082.88,17140,289,115,15463,14851,11996,10836,4935
45887,1183,1662,41327,4560,0,45887,3.25694e+18,607.26,5180.1,45887,630,197,44225,44029,43630,43754,38671
16910,30,912,0,16910,3492,13418,5.64647e+15,130.242,2407.53,16910,328,69,14964,14231,13119,7372,2853
13563,748,1350,12421,1142,12421,1142,1.29715e+18,241.329,2839.42,13563,423,101,12213,12142,11624,11755,7042
46102,239,527,45654,448,46102,0,3.80383e+18,287.343,3253.8,46102,261,172,45301,44620,36893,35133,21684
25652,379,644,22908,2744,25652,0,3.66756e+18,329.237,2655.6,25652,263,153,24951,24615,22299,21229,16051
11621,183,760,10568,1053,0,11621,2.68714e+18,279.652,2154.3,11621,335,133,10156,9200,9235,9527,4510
47826,647,2268,42999,4827,0,47826,3.59081e+18,283.708,5743.88,47826,408,246,45558,45436,43777,43494,27019
41114,66,505,41114,0,41114,0,5.07914e+18,273.792,2936.31,41114,190,160,36762,31824,22427,20597,10406
48750,63,527,48750,0,48750,0,3.31846e+18,349.878,2888.58,48750,212,153,45017,41898,27842,26988,6469
22724,117,874,20051,2673,20051,2673,1.7041e+18,396.616,3068.67,22724,269,172,19552,15935,15593,16425,5434
43021,2366,2367,38645,4376,38645,4376,1.01778e+18,290.237,5729.22,43021,397,276,40654,40654,40654,40654,40654
16272,764,1371,4132,12140,0,16272,4.56929e+13,215.553,2884.81,16272,282,139,14901,14875,14239,14715,7521
8558,41,662,2174,6384,0,8558,3.02586e+13,107.916,1363.93,8558,131,97,7558,7314,6608,6115,1786
10066,72,847,9203,863,9203,863,2.69512e+18,262.628,1922.29,10066,275,86,8380,7613,7146,5651,1805
43387,669,1647,38644,4743,38644,4743,2.73131e+18,385.169,5308.97,43387,453,207,41740,41462,36814,34545,19154
29747,267,910,7169,22578,0,29747,2.53988e+13,211.222,3103.88,29747,360,133,28792,28633,24817,24447,10737
15805,1504,1702,14159,1646,14159,1646,1.21099e+18,195.868,3454.79,15805,301,205,14103,14103,14080,14064,13020
25690,592,957,0,25690,5459,20231,4.61981e+15,369.888,2997.99,25690,265,169,24733,24417,24030,23994,19715
3859,151,400,2916,943,2916,943,3.7652e+18,71.4651,826.163,3859,74,89,3459,3429,3057,3057,972
45267,805,1742,10468,34799,0,45267,2.68558e+13,256.962,4717.22,45267,373,191,43525,43402,43014,43098,32201
3223,72,409,0,3223,0,3223,1.22474e+18,95.6581,764.456,3223,197,48,2687,2527,2146,2022,600
33853,428,839,25507,8346,25507,8346,3.81176e+18,369.045,2875.23,33853,225,168,32978,31994,32326,32208,21835
32022,666,1203,29945,2077,0,32022,2.37307e+18,611.621,3773.9,32022,398,207,30584,29503,29410,29167,22805
31037,173,350,31037,0,31037,0,3.90304e+18,240.133,2123.83,31037,153,154,30123,28126,25977,25766,19156
21074,536,944,18686,2388,18686,2388,3.52814e+18,256.307,2363.45,21074,121,206,20130,20037,19417,19121,14516
2196,67,280,2116,80,0,2196,1.33269e+18,49.209,563.877,2196,56,42,1913,1869,1582,1680,650
14525,144,393,0,14525,3297,11228,7.23447e+15,193.154,1647.16,14525,179,97,13964,13693,11809,12845,6097
16599,836,1328,16599,0,15061,1538,1.52909e+18,195.28,2988.64,16599,230,180,15271,15243,15011,15107,11438
24882,1522,2066,0,24882,0,24882,1.54666e+18,231.142,4272.25,24882,556,211,22816,22816,22703,22777,18030
13480,302,984,13480,0,10991,2489,2.86734e+18,15.7933,1924.74,13480,441,27,12496,12496,12496,12496,4727
22207,636,833,4955,17252,0,22207,2.19343e+13,220.32,2651.12,22207,358,124,21374,21327,21241,21323,18966
7417,322,455,0,7417,0,7417,1.93234e+18,177.887,1142.49,7417,89,102,6962,6953,6730,6748,5244
5082,8,12,0,5082,4912,170,2.98468e+16,6.31562,173.376,5082,9,8,5068,5066,5004,4846,4822
21007,409,1298,0,21007,0,21007,1.13723e+18,419.982,3344.92,21007,300,179,19492,18912,18585,15827,9294
13759,13,55,0,13759,13548,211,2.71388e+16,18.3406,390.629,13759,30,27,13640,13566,13427,13488,10510
27965,44,55,0,27965,27541,424,2.76609e+16,39.9535,557.742,27965,31,30,27899,27866,27792,27819,23621
40196,503,640,11137,29059,0,40196,6.32907e+13,256.378,2392.47,40196,192,136,39556,39535,39333,39289,36538
34610,15,89,0,34610,34360,250,2.55939e+16,53.747,936.75,34610,44,42,33986,33391,31663,27715,16419
9852,266,388,2175,7677,0,9852,2.74472e+13,181.648,1355.46,9852,161,86,9464,9333,9322,9352,7253
8674,37,50,0,8674,8556,118,2.49469e+16,24.8525,372.345,8674,28,27,8624,8609,8435,8474,7481
22454,7,13,22314,140,22454,0,1.04447e+14,10.3219,294.16,22454,11,10,22427,22422,21605,21604,21193
32919,43,45,0,32919,32662,257,2.55296e+16,39.0046,633.203,32919,31,32,32873,32867,32781,32859,32348
28480,17,46,0,28480,28261,219,2.53087e+16,38.401,581.935,28480,31,32,28310,28216,26823,27491,21956
42089,611,903,0,42089,9020,33069,4.72707e+15,469.664,3619.14,42089,349,210,41186,40890,40098,40114,35663
5649,23,528,0,5649,0,5649,2.07508e+18,88.7447,1066.53,5649,84,83,4206,2536,3220,2818,288
9586,203,688,0,9586,1969,7617,4.37541e+15,97.2464,1727.99,9586,206,70,8898,8770,8620,6634,4112
19900,502,1101,0,19900,0,19900,1.20506e+18,403.264,2938.07,19900,266,179,18722,18166,17846,17523,8100
8387,18,19,0,8387,8369,18,3.03713e+16,16.303,257.782,8387,18,16,8365,8334,8362,8362,8121
36364,2,13,35979,385,36266,98,8.43947e+13,6.7671,383.843,36364,8,9,31101,29869,29659,29630,20728
42605,1385,1524,0,42605,0,42605,1.53794e+18,432.981,4873.29,42605,415,206,41081,41081,41076,41074,41010
38467,151,1765,0,38467,9281,29186,7.30721e+15,192.215,4163.12,38467,409,151,36301,34837,31436,24515,6313
18307,130,1330,16357,1950,16357,1950,3.29908e+18,210.258,2860.14,18307,329,165,16673,16092,14888,11346,3099
19732,8,49,0,19732,19661,71,2.98134e+16,23.8008,490.856,19732,23,25,19486,19366,17329,17860,12241
38459,1029,1182,0,38459,8882,29577,6.47899e+15,323.77,3982.75,38459,318,188,37277,37277,37090,37154,35264
2818,162,246,2783,35,2818,0,3.3863e+18,112.183,588.815,2818,83,55,2572,2544,2416,2317,2140
47084,1147,1252,41455,5629,41455,5629,1.71488e+18,416.806,4865.96,47084,322,211,45832,45832,45812,45808,44592
46367,1551,2336,0,46367,0,46367,1.57987e+18,412.84,6355.42,46367,601,195,44031,44030,42843,42860,34530
32652,588,1655,32652,0,29103,3549,1.73934e+18,264.575,3894.03,32652,233,227,30997,30945,28401,29018,21362
4559,120,366,3435,1124,3435,1124,7.04702e+18,64.925,818.134,4559,91,66,4193,4169,3700,3498,1967
31601,1353,2628,31601,0,30994,607,2.27616e+18,376.604,5074.81,31601,374,145,28973,28960,27778,26840,17873
26155,1595,2330,21539,4616,19232,6923,1.92141e+18,22.9716,3027.41,26155,785,780,23825,23825,23092,17465,22854
48759,2765,3530,0,48759,1069,47690,5.16534e+14,60.3924,6699.59,48759,514,58,45229,45229,44311,38790,37381
28968,247,385,7538,21430,0,28968,1.26932e+13,271.687,2184.14,28968,223,125,28495,28074,26823,26762,26106
36686,12,14,36487,199,36686,0,9.52625e+13,9.53475,385.051,36686,11,10,36671,36665,35717,35716,34963
27468,468,719,20707,6761,20707,6761,7.01761e+18,311.481,2368.33,27468,198,155,26749,26648,26372,26180,21741
7803,197,522,0,7803,0,7803,1.29778e+18,140.086,1304.33,7803,121,95,7281,7202,6684,6658,3348
15665,739,794,3347,12318,0,15665,1.74664e+13,200.5,2183.35,15665,193,142,14871,14871,14851,14863,14603
46562,4,9,46246,316,35903,10659,7.22036e+13,8.0265,483.464,46562,9,9,46252,46114,42436,40923,35279
34221,447,766,25807,8414,0,34221,8.25456e+18,348.989,2652.7,34221,204,179,33455,33306,32764,32736,24694
27230,399,516,27230,0,27230,0,3.39777e+18,418.993,2085.31,27230,516,37,26537,26028,25867,25654,21544
44557,319,1440,41569,2988,41569,2988,6.91757e+17,728.772,4823.59,44557,390,255,41075,39600,38001,38339,11408
18620,940,1361,17178,1442,17177,1443,1.34397e+18,224.88,3256.83,18620,449,109,17259,17259,17259,17227,10752
613,106,109,541,72,541,72,3.60664e+18,31.7928,204.5,613,36,32,504,504,504,504,502
28584,520,1357,26620,1964,26620,1964,7.11926e+17,476.787,3836.46,28584,251,246,27054,26053,25717,25566,6919
47451,5395,7323,47451,0,0,47451,8.21117e+18,205.833,10559.4,47451,1521,19,40128,39900,37353,36363,32847
37491,728,1095,37491,0,32991,4500,1.16036e+18,413.924,4199.51,37491,318,212,36396,36391,35171,33815,27929
14822,355,389,0,14822,3467,11355,7.47368e+15,174.286,1652.59,14822,181,97,14433,14432,14390,14400,13193
48592,7,102,0,48592,47884,708,2.07074e+16,46.4238,1197,48592,47,45,46983,46056,42382,43368,26291
26731,2,10,26633,98,26667,64,1.04362e+14,7.72362,304.459,26731,9,10,23900,23541,20671,22656,17154
7030,537,555,1498,5532,0,7030,2.04208e+13,128.388,1356.83,7030,133,102,6475,6475,6475,6473,6413
8220,76,393,8220,0,8220,0,5.11868e+18,146.011,1232.21,8220,128,97,7341,6634,4830,4243,3331
18086,466,1425,4666,13420,0,18086,4.85569e+13,188.779,3036.88,18086,287,139,16661,16271,14886,16039,8728
40234,929,1154,40234,0,35429,4805,1.16045e+18,419.492,4409.37,40234,319,210,39080,39080,38727,38899,35291
46934,27,62,0,46934,46567,367,2.57163e+16,48.4901,945.622,46934,41,42,46734,46676,44652,44551,36342
26811,1055,1080,0,26811,0,26811,1.13112e+18,522.91,3339.51,26811,311,184,25731,25711,25726,25729,25606
49785,110,1129,0,49785,0,49785,1.85782e+18,352.289,4670.92,49785,342,222,44203,36870,35261,9874,6844
15556,862,943,14570,986,14570,986,1.96762e+18,386.911,2443.46,15556,234,164,14613,14424,14555,14572,14172
37310,47,71,0,37310,36864,446,2.51613e+16,42.0597,901.698,37310,37,41,37228,37156,36057,36543,31690
14661,837,1460,14661,0,13385,1276,5.17634e+18,178.912,2817.15,14661,645,77,13201,13122,11021,12304,8605
43191,764,1278,0,43191,0,43191,1.4624e+18,601.146,4765.13,43191,496,191,41816,41310,40099,40031,27371
16196,537,591,0,16196,0,16196,4.18471e+18,242.567,1727.4,16196,146,118,15605,15589,15603,15597,15110
45598,813,2431,45598,0,41116,4482,1.37029e+18,286.251,6127.73,45598,659,161,43167,43039,39142,41181,11551
45166,170,1310,0,45166,0,45166,1.1636e+18,680.225,4550.68,45166,380,234,41031,39074,36009,33583,15176
48163,620,2272,41582,6581,41582,6581,3.828e+18,481.507,6184.42,48163,585,274,45520,43703,38855,35004,10309
32624,1124,1260,0,32624,7733,24891,7.66651e+15,268.589,3883.09,32624,300,173,31364,31362,31338,31343,30284
43605,6,13,43284,321,43605,0,1.01307e+14,11.5489,411.635,43605,13,12,43477,43395,41167,41060,38850
8555,207,338,0,8555,2367,6188,1.6223e+16,121.788,957.37,8555,78,78,8217,8097,8067,8097,6168
45353,762,1135,12336,33017,0,45353,5.78445e+13,233.355,3723.13,45353,212,162,44218,44214,42949,43022,29310
9543,429,1121,0,9543,0,9543,1.21237e+18,107.288,1906.27,9543,348,142,8422,8422,8396,8422,2988
22987,665,1102,0,22987,4436,18551,4.2672e+15,165.413,2980.92,22987,334,96,21885,21850,21428,21064,16205
28172,76,859,0,28172,6273,21899,4.7857e+15,414.532,2920.7,28172,336,166,25495,23408,22430,18965,8088
30148,34,872,22698,7450,0,30148,8.336e+18,316.192,2638.65,30148,203,156,23803,13381,15741,15302,3447
23868,16,563,22048,1820,23868,0,4.00052e+18,279.352,2311.63,23868,262,118,18549,16146,11287,10396,3161
21889,2,8,21863,26,21889,0,3.63406e+13,4.99191,319.549,21889,6,6,19062,17650,16241,12011,12003
43819,385,1295,0,43819,0,43819,1.16021e+18,671.686,4419.59,43819,441,220,41314,40156,38937,35873,26207
41477,60,66,0,41477,40926,551,2.52863e+16,44.3318,924.191,41477,39,39,41411,41405,41025,40911,39739
47841,216,597,46021,1820,47841,0,3.71945e+18,306.972,3404.51,47841,273,184,46624,45335,36702,33386,19587
17614,1193,1232,0,17614,3640,13974,6.84017e+15,147.046,2854.05,17614,289,165,16382,16369,16382,16382,16020
35158,1363,1578,31511,3647,31511,3647,1.38769e+18,432.624,4663.64,35158,440,168,33580,33547,33522,33569,30552
15679,755,778,14033,1646,14033,1646,3.2682e+18,213.675,1975.89,15679,118,134,14901,14901,14881,14876,14720
49013,1476,1675,0,49013,11875,37138,6.57141e+15,314.815,4817.57,49013,375,213,47338,47335,47211,47301,43886
39072,1778,2467,39072,0,35518,3554,1.12088e+18,378.833,6003.97,39072,676,138,36605,36604,36410,36307,30278
17126,78,1385,17126,0,15727,1399,8.43983e+17,188.145,3126.56,17126,447,109,14891,13818,11730,4857,2759
35304,42,1214,32968,2336,32968,2336,2.04642e+18,640.815,3952.01,35304,336,217,26553,20677,20578,19869,4044
43877,818,2227,33685,10192,33591,10286,3.63879e+18,318.502,5167.28,43877,359,251,41650,41609,40827,41545,36103
39285,1235,1778,39285,0,36598,2687,9.79273e+17,503.824,5242.23,39285,393,290,37507,37460,35001,35315,25507
35715,366,1337,33312,2403,33312,2403,2.05389e+18,668.024,4189.03,35715,442,216,33231,32147,31072,30673,16742
16179,1077,2699,16179,0,15246,933,1.12905e+18,15.1456,3284.82,16179,424,27,13480,13480,12252,13479,4953
30604,245,1005,0,30604,6878,23726,5.27407e+15,318.885,3317.25,30604,305,156,29197,28576,27251,24997,15650
23740,820,1047,21346,2394,21346,2394,2.5097e+18,336.403,3302.11,23740,372,165,22693,22657,22613,22644,20560
14007,6,12,13838,169,14007,0,9.93514e+13,9.42736,228.233,14007,10,10,13943,13901,13279,13243,12384
33712,208,385,8766,24946,0,33712,1.25482e+13,277.018,2366.69,33712,232,133,33037,31317,30814,30609,26634
3289,271,288,3289,0,3289,0,3.11327e+18,136.015,733.362,3289,101,61,3001,3000,2981,2986,2947
37487,3716,3722,0,37487,0,37487,1.45082e+17,14.6413,5584.96,37487,1136,22,33765,33765,33762,33764,33758
19237,9,13,19081,156,19237,0,1.01224e+14,9.99173,270.534,19237,11,10,19216,19212,18529,18529,17924
4067,80,239,4067,0,4067,0,5.58715e+18,103.142,702.155,4067,97,67,3693,3392,2485,2256,1838
49623,5211,9374,0,49623,0,49623,4.53106e+17,14.0017,10090.2,49623,1200,22,40249,40249,36093,37176,24177
48182,1571,1701,0,48182,12560,35622,1.11697e+16,371.436,4965.46,48182,548,184,46481,46481,46481,46481,44177
31671,668,1392,0,31671,5319,26352,5.2471e+15,301.627,3797.39,31671,542,101,30279,29867,29632,28422,18896
42346,479,528,42346,0,42346,0,5.08242e+18,327.146,2922.35,42346,206,175,41818,41814,41663,41567,41395
41232,407,844,9031,32201,0,41232,1.87359e+13,451.179,3447.23,41232,336,193,40020,39021,38448,34198,28111
2258,20,27,0,2258,2225,33,2.6519e+16,20.275,166.065,2258,20,21,2219,2197,2165,2154,1904
6805,10,11,6466,339,6805,0,9.6211e+13,10.2764,185.079,6805,11,10,6792,6790,6660,6660,6791
12342,145,491,3232,9110,0,12342,2.93725e+13,150.021,1332.47,12342,89,113,11788,11146,10483,11091,5044
34942,36,1875,29439,5503,0,34942,5.36202e+18,282.752,5058.82,34942,319,197,26848,18063,19402,18936,3103
28573,675,1184,26635,1938,0,28573,2.47609e+18,569.912,3571.51,28573,351,186,27225,26253,26272,26086,20772
9833,651,903,9187,646,9187,646,6.87753e+17,133.902,1988.35,9833,115,155,8930,8930,8836,8848,6569
17050,135,426,4760,12290,0,17050,6.29328e+13,180.164,1403.93,17050,101,104,16450,16131,15306,14992,8619
9883,8,31,0,9883,9425,458,2.45346e+16,23.1089,318.366,9883,20,22,9490,9068,6879,8456,5999
37096,114,1898,32776,4320,0,37096,4.24926e+18,314.899,4202.18,37096,352,287,33927,32696,28952,28560,3231
17214,21,63,0,17214,17088,126,2.50867e+16,33.5323,571.632,17214,33,30,17092,17042,16447,16061,13676
17085,1,7,17048,37,17085,0,8.26388e+13,6.95042,256.215,17085,7,7,9811,9811,9811,9811,9811
35402,397,793,31097,4305,31097,4305,3.2398e+18,334.331,3569.79,35402,290,193,34602,33829,32148,31404,18198
17747,658,846,0,17747,3184,14563,5.85127e+15,221.659,2434.01,17747,304,89,16901,16901,16790,16691,14195
16046,603,630,0,16046,3560,12486,4.93956e+15,257.746,1911.19,16046,154,135,15416,15416,15411,15406,15244
48178,197,519,48178,0,48178,0,3.46382e+18,395.207,2849.39,48178,516,61,45816,43514,40513,38851,18789
8517,503,530,8517,0,6411,2106,8.20599e+17,157.151,1286.31,8517,122,107,7987,7987,7958,7765,7789
27909,1062,1597,27909,0,25818,2091,1.1429e+18,515.097,4294.66,27909,408,216,26312,26294,25569,25848,19492
19841,311,1103,0,19841,3825,16016,6.29045e+15,194.972,2757.42,19841,342,71,18719,18361,17431,10271,8866
29028,20,830,6372,22656,0,29028,1.83561e+13,404.094,2928.61,29028,309,179,22291,18999,17163,7164,3704
14191,25,1106,0,14191,0,14191,1.20317e+17,63.9199,2186.58,14191,406,53,12823,12647,11757,11412,2324
6651,4,6,6467,184,6651,0,9.87766e+13,4.59314,142.841,6651,6,6,6639,6637,6546,6546,5478
14997,176,291,14997,0,14997,0,4.78628e+18,202.373,1430.75,14997,128,125,14600,14400,13192,12814,11085
48354,246,702,11133,37221,0,48354,2.86514e+13,233.857,3524.58,48354,278,146,47535,46743,44881,45491,20901
21153,11,89,0,21153,20949,204,2.00507e+16,24.1949,751.953,21153,37,30,20672,20143,18980,19265,12476
26807,401,468,26807,0,26807,0,5.02252e+18,277.765,2243.76,26807,182,146,26339,26320,26019,25811,25372
35694,27,46,0,35694,35424,270,2.55192e+16,38.4827,664.574,35694,33,34,35573,35460,34804,35350,29860
2983,1,6,2926,57,2983,0,1.06061e+14,5.50654,99.2153,2983,6,6,1369,1369,1369,1369,1369
20419,406,636,0,20419,0,20419,1.87675e+18,313.68,2550.11,20419,238,152,19783,19402,18962,19167,11668
21694,331,664,0,21694,5046,16648,6.21468e+15,209.696,2342.23,21694,307,111,21030,21011,19775,20072,10001
5192,160,221,5192,0,5192,0,4.95762e+18,101.263,759.075,5192,84,82,4971,4959,4752,4714,4346
11318,8,435,4683,6635,11318,0,5.85546e+18,238.897,1433.75,11318,264,82,7889,6687,3380,3339,1222
34563,968,1757,32223,2340,32223,2340,2.09947e+18,459.764,4858.28,34563,353,232,32806,32612,31876,31799,23354
16419,65,740,0,16419,3427,12992,5.6241e+15,220.408,2248.62,16419,355,114,14517,13671,12966,10533,2965
26447,40,63,0,26447,26269,178,2.64123e+16,37.5467,706.024,26447,35,35,26366,26317,25616,25618,23230
46059,80,100,0,46059,45933,126,2.2059e+16,27.9065,1071.7,46059,42,33,45959,45958,45656,45204,42859
11071,345,389,3074,7997,0,11071,6.31563e+13,137.67,1124.62,11071,92,78,10682,10670,10672,10669,9962
11070,301,401,11070,0,11070,0,5.21559e+18,163.652,1400.02,11070,170,101,10669,10600,10389,10074,9683
45811,902,1237,0,45811,0,45811,1.87095e+18,340.414,4695.48,45811,403,219,44574,44570,44044,44203,30697
26312,861,1367,0,26312,5782,20530,6.75345e+15,210.173,3502.19,26312,295,176,24945,24865,24787,24945,18043
37767,45,70,0,37767,37486,281,2.13615e+16,26.5602,820.309,37767,34,33,37697,37697,33835,35738,29808
10128,538,1103,0,10128,2105,8023,9.1276e+15,50.1892,1786.8,10128,311,105,9025,9000,8046,8272,3944
25532,58,1089,23828,1704,0,25532,2.43357e+18,548.614,3313.11,25532,274,206,20350,17246,16453,16282,3033
10580,293,717,10580,0,9393,1187,7.44716e+17,349.672,2021.22,10580,249,143,9400,8128,8201,5911,4420
36104,11,13,35825,279,36104,0,1.0118e+14,10.5997,371.971,36104,12,11,36086,36077,35070,35069,34759
38330,50,55,0,38330,37699,631,2.76049e+16,34.4065,637.31,38330,34,30,38270,38233,38259,38254,36956
9727,381,521,7325,2402,7325,2402,3.80769e+18,209.928,1372.85,9727,131,113,9206,8987,9111,9102,7795
6553,6,59,0,6553,6502,51,2.52801e+16,24.3635,361.49,6553,28,27,6093,5741,5448,4967,2968
25597,801,1039,4584,21013,0,25597,2.14886e+13,265.336,3177.21,25597,328,108,24558,24558,24413,23094,21151
33391,107,819,9276,24115,0,33391,6.17825e+13,223.24,2702.36,33391,166,147,31960,31335,25467,8843,2862
22564,350,817,19800,2764,19800,2764,1.75509e+18,345.164,2977.85,22564,235,167,21486,20845,20188,20053,11205
39492,506,629,0,39492,10977,28515,1.61811e+16,258.76,2345.83,39492,174,134,38863,38841,38662,38715,35480
6029,86,731,0,6029,0,6029,1.66762e+18,102.821,1397.27,6029,189,79,5112,4638,4493,3985,1490
9153,10,23,0,9153,9116,37,2.65463e+16,9.65902,249.036,9153,12,11,9128,9123,9061,8967,5803
8954,320,642,8954,0,7966,988,1.12267e+18,339.29,1769.02,8954,203,121,8170,7879,7415,6546,4399
44749,951,1444,0,44749,9319,35430,5.29663e+15,390.448,4812.78,44749,432,117,43305,43125,42571,31346,32389
3239,61,191,3239,0,3239,0,5.2774e+18,98.1006,587.05,3239,76,63,2833,2483,1777,1683,1503
18873,401,467,0,18873,4725,14148,5.983e+15,228.152,2075.13,18873,247,117,18406,18406,18406,18406,17893
3188,16,24,0,3188,3184,4,2.81404e+16,12.9987,167.08,3188,17,14,3163,3157,3151,3149,3043
42258,31,62,0,42258,41702,556,2.53322e+16,43.9298,927.427,42258,39,39,42119,42027,40577,40615,33787
3401,116,365,0,3401,713,2688,8.49593e+15,37.4951,721.481,3401,173,48,3036,3013,2874,2730,924
14789,438,683,0,14789,3362,11427,4.55566e+15,259.936,1972.86,14789,213,114,14106,13900,13827,13890,11922
13604,21,1060,12662,942,0,13604,2.50665e+18,433.321,2534.73,13604,279,163,9080,7648,6295,5613,1752
39330,10,13,39021,309,39330,0,1.00953e+14,10.2912,387.631,39330,12,11,39309,39297,38076,38074,37378
19973,850,867,17911,2062,0,19973,3.0708e+18,319.402,2836.21,19973,367,154,19106,19106,19106,19106,19106
2339,278,282,1768,571,1768,571,6.88684e+18,53.5712,558.54,2339,57,73,2057,2057,2057,2057,2050
5120,410,582,0,5120,0,5120,1.11517e+18,189.457,1323.45,5120,235,93,4538,4464,4538,4483,3649
40154,183,875,0,40154,8793,31361,4.79327e+15,453.409,3440.43,40154,314,206,37931,37235,35350,32425,16441
2933,58,239,759,2174,0,2933,2.96043e+13,67.4255,540.291,2933,52,62,2645,2580,2414,2426,1102
13655,1047,1072,0,13655,0,13655,1.88921e+18,186.942,2322.3,13655,204,144,12583,12583,12583,12583,12552
27781,376,492,27781,0,27781,0,3.11124e+18,271.288,2128.43,27781,173,136,27289,27239,25885,25130,23802
3831,236,375,3429,402,3429,402,1.7281e+18,220.325,914.645,3831,190,68,3375,3012,3022,3156,3064
21229,919,1249,18491,2738,18491,2738,1.82167e+18,281.979,3282.33,21229,274,153,19980,19980,19816,19901,18680
40358,1619,1726,40358,0,36113,4245,7.84254e+17,465.113,5112.37,40358,434,177,38632,38632,38628,38616,38165
44534,238,706,10210,34324,0,44534,2.88174e+13,237.3,3374.93,44534,274,139,43668,42943,41088,41967,19251
17028,488,662,17028,0,15248,1780,1.76904e+18,263.364,1939.24,17028,126,146,16366,16340,15544,16019,14000
7856,76,519,5901,1955,5901,1955,3.8541e+18,131.913,1227.31,7856,116,109,7186,6800,5728,5824,2069
34398,159,1261,0,34398,0,34398,1.20906e+18,671.745,4050.2,34398,384,219,30879,28972,26238,24038,6133
18174,434,540,18108,66,18174,0,3.00496e+18,259.667,2082.95,18174,170,112,17634,17610,17215,16804,16362
15115,497,699,0,15115,3330,11785,4.67673e+15,241.871,1976.1,15115,231,125,14416,14290,14177,14138,12213
9763,554,962,0,9763,0,9763,1.8122e+18,254.928,1978.73,9763,204,157,8801,8535,8773,8792,7431
6032,221,248,6032,0,6032,0,3.75844e+18,159.364,866.682,6032,84,90,5784,5764,5718,5698,5412
8938,166,329,0,8938,2141,6797,7.56359e+15,104.774,1204.86,8938,155,86,8609,8532,7757,8181,5981
17730,383,958,0,17730,0,17730,1.16735e+18,388.858,2576.93,17730,229,167,16556,16200,15861,15571,9018
553,4,156,457,96,457,96,2.98234e+18,32.2224,239.089,553,62,25,209,119,0,77,3
25709,1462,4911,25097,612,0,25709,6.26188e+18,13.9825,5383.82,25709,624,22,20798,20798,17350,17359,7485
47454,981,1290,10404,37050,0,47454,1.85186e+13,458.184,4472.88,47454,373,198,46164,46129,45992,45977,43556
28855,316,1914,0,28855,0,28855,1.85519e+18,204.808,4343.94,28855,377,220,26941,26608,24379,12081,9836
17449,43,621,15636,1813,15636,1813,8.82528e+17,254.872,1934.79,17449,125,139,14582,12712,10588,11142,1653
20670,89,457,20670,0,20670,0,4.67009e+18,252.799,2093.79,20670,153,150,19017,17639,12341,10918,6615
17705,502,1013,4334,13371,0,17705,2.38624e+13,138.006,2523.41,17705,244,129,16692,16642,16162,13526,10258
11007,147,335,0,11007,2890,8117,6.622e+15,219.634,1395.04,11007,226,95,10160,9335,9336,9862,4054
37774,310,664,29789,7985,37774,0,4.13312e+18,344.204,3151.55,37774,278,164,36870,36004,29975,25737,22370
43402,234,625,43402,0,41553,1849,4.92181e+17,459.496,3519.61,43402,277,197,40304,35267,31215,14433,28934
47636,848,1358,0,47636,11434,36202,9.123e+15,285.02,4703.25,47636,314,199,46278,46260,44903,45227,32647
13173,5,45,0,13173,13083,90,2.58626e+16,28.921,394.589,13173,25,26,12795,12638,11731,11848,7606
7300,42,60,0,7300,7184,116,2.371e+16,21.3553,396.374,7300,28,24,7240,7223,7173,6977,5854
15202,43,663,0,15202,3297,11905,6.30892e+15,172.195,1962.77,15202,285,92,13037,12459,11371,10834,1479
25091,151,790,5647,19444,0,25091,1.92279e+13,394.482,2651.08,25091,311,161,23589,23148,21738,18569,10464
9849,200,368,9849,0,9849,0,5.1398e+18,158.619,1287.35,9849,136,99,9454,9257,8394,8046,6703
28515,624,1113,5273,23242,0,28515,2.01593e+13,272.525,3456.66,28515,387,110,27402,27324,26653,24897,19657
15983,614,788,14891,1092,14891,1092,2.12763e+18,396.891,2231.03,15983,229,156,15195,14792,15003,15019,13560
14715,509,999,13783,932,0,14715,2.30698e+18,303.735,2413.46,14715,265,145,13716,13374,13253,13222,10406
41996,2095,2358,37832,4164,37829,4167,1.25818e+18,270.647,5862.96,41996,609,170,39638,39638,39483,39616,35005
38592,1115,1402,38592,0,36071,2521,9.42488e+17,678.165,4419.71,38592,435,228,37190,37115,36121,36388,34551
10316,171,894,0,10316,0,10316,1.1373e+18,148.78,2070.23,10316,181,92,9372,9189,8653,7267,4613
17781,708,925,0,17781,0,17781,2.11054e+18,242.678,2145.89,17781,119,199,16856,16837,16734,16667,15072
4525,97,239,4525,0,4525,0,3.23665e+18,157.733,806.548,4525,113,76,4053,3840,3495,3018,1917
32256,1165,1791,32256,0,29687,2569,8.27084e+17,337.289,4744.5,32256,588,153,30465,30465,30291,30326,17613
1714,22,28,0,1714,1702,12,2.61493e+16,10.4125,131.138,1714,18,12,1686,1684,1676,1682,1259
23256,682,1724,0,23256,483,22773,4.88864e+14,46.9298,3352.27,23256,434,52,21532,21530,20290,12069,10878
35517,919,1823,31757,3760,0,35517,3.87381e+18,284.841,4348.5,35517,260,233,33694,33640,33152,33113,26208
42801,146,791,42797,4,42801,0,4.39958e+18,328.491,3556.49,42801,240,144,40483,38466,28626,28540,12008
9741,9,386,9741,0,9741,0,2.871e+18,279.483,1422.8,9741,154,101,5223,3185,3282,1710,950
29291,561,1153,27449,1842,27449,1842,1.95037e+18,572.85,3605.74,29291,349,201,27747,26521,26662,26485,21514
17287,185,631,15234,2053,0,17287,3.8239e+18,307.367,2340.48,17287,225,143,16159,15590,12971,13099,4814
38924,46,838,8634,30290,0,38924,1.82557e+13,451.913,3329.71,38924,293,184,33585,29922,29328,21966,8367
15844,275,612,0,15844,4116,11728,7.58092e+15,164.141,1641.18,15844,96,127,15232,15143,14010,14128,7999
4873,133,435,1069,3804,0,4873,1.91781e+13,71.8906,1018.34,4873,119,55,4438,4402,4222,3519,2962
48081,3,10,47801,280,48017,64,1.0455e+14,7.78135,409.466,48081,9,10,46546,45782,42766,44502,29716
24370,996,1182,0,24370,5435,18935,4.54625e+15,290.228,3220.23,24370,367,150,23188,23167,23155,23145,22246
47236,172,482,47236,0,47236,0,3.66555e+18,269.306,3057.85,47236,267,174,45784,42987,35546,31879,20596
44007,93,672,39913,4094,44007,0,3.85141e+18,378.518,3492.12,44007,285,178,40203,36640,29588,25118,10597
16732,8,33,0,16732,16684,48,1.58353e+16,17.6945,445.486,16732,24,20,16503,16385,15488,16167,9430
48520,7,63,0,48520,48171,349,2.61024e+16,55.3359,975.014,48520,43,43,45607,43649,41328,36696,23956
14285,11,32,0,14285,13619,666,2.45961e+16,25.1306,388.048,14285,22,23,14049,13677,11406,12441,8914
40283,8,46,0,40283,40238,45,1.23606e+16,8.42038,783.665,40283,21,12,38742,34310,32214,34875,22629
32248,727,1209,0,32248,0,32248,1.42037e+18,567.775,4080.19,32248,431,162,31039,30568,29159,28861,17397
31603,951,1430,0,31603,0,31603,1.17851e+18,485.768,4046.86,31603,369,179,30173,29830,29709,27052,26344
25609,710,840,5810,19799,0,25609,2.26092e+13,223.693,2820.19,25609,356,104,24769,24758,24680,24681,19618
47842,34,64,0,47842,47483,359,2.52176e+16,55.6354,974.651,47842,42,45,47657,47537,45707,45852,38866
10106,8,34,0,10106,10090,16,2.12052e+16,26.0761,341.773,10106,27,28,9442,9063,7939,8465,5306
17458,436,483,4869,12589,0,17458,6.30265e+13,181.291,1511.44,17458,114,104,16975,16972,16946,16972,16573
30784,251,1619,27263,3521,0,30784,4.17432e+18,278.152,3654.4,30784,347,270,28851,28082,24400,24072,6257
31616,468,754,23830,7786,23830,7786,7.01076e+18,347.853,2568.72,31616,210,150,30862,30641,30226,29890,23646
47085,607,1649,11174,35911,0,47085,2.57556e+13,299.488,4775.99,47085,348,186,45436,45194,43068,27913,22083
40395,530,1649,36214,4181,36214,4181,1.42605e+18,462.099,5019.68,40395,445,176,38690,38157,34220,35006,21063
30691,1125,1698,26962,3729,26962,3729,3.77064e+18,308.213,3508.56,30691,341,283,28993,28991,27255,26651,18975
29778,31,34,0,29778,28328,1450,2.4634e+16,30.2709,565.809,29778,28,29,29734,29670,29602,29695,27632
28946,740,1102,0,28946,0,28946,4.00541e+18,295.063,3186.57,28946,199,195,27844,27836,27368,27248,18876
4907,290,582,0,4907,0,4907,1.30067e+18,122.406,1177.17,4907,123,95,4325,4221,4214,4019,3570
38887,69,1384,0,38887,9847,29040,8.49164e+15,419.591,4265.54,38887,521,174,34403,32333,29684,18090,5188
39048,185,2284,35363,3685,35363,3685,2.83366e+18,348.861,5766.64,39048,544,245,35629,33879,32083,29179,6758
39616,619,661,39616,0,39616,0,3.30449e+18,320.387,3398.28,39616,228,198,38955,38953,38878,38699,38198
9894,1,8,9467,427,8920,974,6.78796e+13,4.7354,173.92,9894,7,7,6554,6554,6554,6554,6554
7186,278,677,6711,475,6711,475,6.07287e+17,153.498,1465.72,7186,137,116,6509,6353,6218,6268,5018
3154,71,264,2964,190,0,3154,2.20378e+18,113.225,672.651,3154,81,65,2629,2120,2295,2296,1246
20905,130,761,20905,0,18746,2159,1.76987e+18,266.312,2245.61,20905,133,148,18880,17550,15045,17679,3332
2092,75,201,1851,241,1851,241,9.23272e+17,52.7385,446.516,2092,55,52,1891,1854,1772,1630,833
32433,1,18,31960,473,32245,188,9.77912e+13,16.4321,425.816,32433,18,18,20124,20124,20124,20124,20124
49267,82,87,0,49267,48646,621,2.21788e+16,23.7068,1102.74,49267,33,36,49180,49180,49094,49085,49099
3731,158,251,3731,0,3731,0,5.14295e+18,104.273,715.468,3731,96,72,3480,3441,3221,3023,2486
6310,248,321,1627,4683,0,6310,2.935e+13,117.886,853.986,6310,72,84,5989,5977,5896,5954,5263
23601,226,422,23601,0,23601,0,5.05733e+18,255.305,2025.59,23601,178,133,23012,22584,19340,18930,15999
9596,212,580,2339,7257,0,9596,2.67107e+13,130.916,1575.94,9596,260,85,8992,8780,7781,7863,5566
23746,858,1068,23746,0,18010,5736,8.13729e+17,289.098,3045.36,23746,191,189,22678,22678,21995,20467,18270
48746,38,1164,11670,37076,0,48746,2.52696e+13,419.096,4261.49,48746,593,142,41973,38736,36639,26665,9085
33906,177,2125,0,33906,0,33906,2.43009e+18,508.531,4995.07,33906,537,210,29999,29204,25620,5969,4289
5103,1,8,5090,13,5103,0,1.18205e+14,6.47599,132.578,5103,8,7,2482,2482,2482,2482,2482
11658,115,759,10193,1465,10193,1465,3.45242e+18,270.629,1917.62,11658,199,117,10141,8841,8901,7717,4023
35503,903,937,35503,0,26738,8765,8.0986e+17,363.431,3049.55,35503,230,169,34566,34566,34541,34065,34179
9891,885,1116,0,9891,0,9891,1.91174e+18,116.833,2391.16,9891,247,118,8775,8775,8503,7211,6633
42897,165,195,0,42897,41458,1439,2.5474e+16,26.7138,1221.56,42897,76,40,42702,42702,42679,42394,37496
34453,51,68,0,34453,34365,88,2.17619e+16,26.4181,769.48,34453,30,33,34385,34385,31210,32360,29630
31591,1067,1317,31591,0,28219,3372,8.15366e+17,504.658,3959.92,31591,426,158,30274,30245,30041,30249,26091
46363,330,765,46299,64,46363,0,3.10061e+18,376.382,3782.43,46363,253,173,45320,44352,40768,38364,29022
12909,290,368,0,12909,2919,9990,7.11841e+15,186.823,1520.83,12909,162,95,12541,12408,12441,12493,10273
10794,460,696,0,10794,2811,7983,1.22404e+16,80.1425,1786.05,10794,139,91,10098,10092,9789,9884,6929
29922,302,1345,29922,0,28002,1920,9.14588e+17,511.14,4031.83,29922,326,234,27734,26832,24540,24302,13883
7712,3,16,0,7712,7706,6,1.37257e+16,9.92142,238.621,7712,12,10,6241,6058,5141,6240,4827
36250,1670,2299,32806,3444,32803,3447,1.30999e+18,267.49,5538.26,36250,605,155,33951,33951,33688,33867,22963
19117,570,1032,0,19117,0,19117,1.2062e+18,442.182,2835.76,19117,255,183,17921,17297,17393,15876,10641
45100,867,2092,45100,0,40164,4936,8.78426e+17,443.99,6026.82,45100,545,178,43008,42742,40656,37147,21529
8250,14,535,7842,408,7842,408,1.55174e+18,237.778,1472.72,8250,176,116,5208,4214,3721,3753,940
33575,141,802,29512,4063,29512,4063,3.24889e+18,332.155,3478.63,33575,292,200,31120,27489,25088,22134,8274
15022,112,474,14013,1009,15022,0,3.89562e+18,209.959,1702.92,15022,142,133,13868,13025,10708,9616,6388
17129,15,59,0,17129,17011,118,2.64353e+16,31.7603,494.331,17129,28,29,16978,16737,16145,15733,11306
39059,1494,1693,8676,30383,0,39059,2.44986e+13,280.684,4644.3,39059,516,151,37366,37366,37096,37173,34357
9572,254,635,8463,1109,8463,1109,1.68471e+18,292.079,1807.73,9572,176,126,8767,8515,7967,8063,3884
25039,684,2067,25039,0,24959,80,2.11143e+17,14.8826,3538.29,25039,791,23,22972,22972,22828,21943,12020
15739,572,1263,0,15739,0,15739,1.28401e+18,266.773,2863.37,15739,397,111,14476,14217,13732,13246,7222
32354,1,10,32127,227,32354,0,1.01023e+14,9.48983,351.76,32354,10,10,17266,17266,17266,17266,17266
35667,106,888,0,35667,0,35667,4.10972e+18,359.839,2942.55,35667,217,187,33207,32338,22386,11618,5249
43099,26,100,0,43099,42387,712,2.0705e+16,49.5666,1121.02,43099,46,43,42952,42873,40987,40606,28801
31981,425,1323,8126,23855,0,31981,2.90341e+13,184.18,3307.2,31981,214,147,30658,30608,28603,29245,19217
24529,1098,1717,22846,1683,0,24529,2.52826e+18,387.967,4185.21,24529,333,216,22812,22717,22362,22252,17058
45549,251,1297,42560,2989,42560,2989,2.02809e+18,708.898,4581.47,45549,427,246,42024,41011,38533,37675,14154
6075,163,303,6075,0,6075,0,4.9537e+18,124.203,1009.99,6075,108,92,5762,5658,5143,5017,4576
18957,670,1448,0,18957,0,18957,3.221e+18,179.84,3382.39,18957,252,147,17509,17491,14090,8527,5239
7020,367,505,0,7020,1602,5418,5.9637e+15,61.7148,1036.34,7020,166,40,6515,6484,6388,6515,6115
20539,503,1141,20539,0,18240,2299,8.098e+17,348.821,3089.93,20539,252,133,19391,19153,16624,15941,13638
16329,72,769,14622,1707,14622,1707,3.25446e+18,212.977,2020,16329,117,137,14318,13418,13027,11494,2862
36999,681,1978,33103,3896,0,36999,3.71788e+18,253.004,4701.65,36999,304,226,35021,34980,33957,33669,24346
26574,902,1133,4950,21624,0,26574,2.28697e+13,257.21,3208.97,26574,406,96,25441,25441,25226,25441,24093
45006,1198,1734,0,45006,11270,33736,7.70392e+15,297.771,4353.39,45006,261,282,43272,43258,43063,43136,38548
31867,208,1281,6595,25272,0,31867,2.1823e+13,221.394,3753.63,31867,413,106,30236,29662,28856,17802,9683
2654,261,305,2344,310,0,2654,4.27304e+18,49.321,592.272,2654,65,54,2349,2349,2347,2347,2230
46559,133,2485,41779,4780,41779,4780,3.19806e+18,298.14,5992.28,46559,480,318,42617,40295,37215,27894,5646
4356,21,25,0,4356,4326,30,2.60043e+16,16.1566,183.557,4356,15,14,4330,4319,4322,4329,4323
14345,191,387,0,14345,3584,10761,5.44027e+15,213.969,1739.45,14345,231,107,13631,12640,13226,13513,10128
38994,568,1016,0,38994,9159,29835,7.53717e+15,219.596,3476.97,38994,253,140,37978,37968,37552,36636,35623
37151,2213,2635,37151,0,34526,2625,3.64737e+18,611.982,5680.37,37151,810,190,34516,34494,33955,34036,32187
6475,28,396,6034,441,6034,441,5.53728e+17,152.476,1108.1,6475,124,86,4252,3129,2641,2956,1437
14600,6,8,14034,566,12897,1703,7.03689e+13,5.93116,211.98,14600,7,7,14590,14588,14070,14069,13154
27372,403,1264,27372,0,25573,1799,9.44706e+17,686.183,3715.89,27372,356,202,25234,24277,21417,18417,13752
46848,843,1290,41328,5520,41328,5520,1.69869e+18,432.356,4885.69,46848,374,219,45558,45554,44103,44015,34084
39738,1392,1923,37045,2693,37045,2693,7.07899e+17,582.664,5407.23,39738,395,249,37815,37803,37574,37598,33626
36186,66,502,36186,0,36186,0,3.12897e+18,306.542,2440.98,36186,191,138,33647,31401,20698,19321,5346
5400,249,294,1227,4173,0,5400,2.82567e+13,78.8289,919.745,5400,111,55,5106,5106,5065,5055,4293
29372,610,1199,29372,0,26206,3166,1.79614e+18,282.146,3208.43,29372,159,180,28173,28139,24752,26569,15449
46415,651,1026,35012,11403,35012,11403,6.9872e+18,365.34,3372.15,46415,241,188,45389,45303,44566,44117,35288
11429,645,684,10093,1336,10093,1336,1.68519e+18,312.372,2028.69,11429,202,134,10745,10745,10738,10743,10566
38021,327,874,28648,9373,28648,9373,3.80944e+18,379.526,3102.82,38021,233,185,36850,35119,35627,35472,19618
48161,386,2483,0,48161,0,48161,1.74339e+18,406.129,6492.19,48161,613,245,45288,43979,41524,40453,16912
47381,785,983,10487,36894,0,47381,1.79829e+13,485.775,3871.78,47381,414,216,46398,46351,45823,45661,42900
23824,646,806,5132,18692,0,23824,1.84318e+13,386.727,2674.6,23824,309,162,23018,22921,22803,22524,21086
35982,364,2503,35982,0,32812,3170,1.24522e+18,322.935,5763.5,35982,499,275,33228,32163,30029,17982,10927
25789,758,1271,24027,1762,24027,1762,6.84741e+17,627.657,3600.34,25789,322,208,24444,23534,23812,23840,17568
26182,880,1090,24459,1723,24459,1723,2.01202e+18,513.398,3299.79,26182,305,191,25092,24551,24807,24769,22011
30985,2350,2446,28332,2653,28332,2653,1.12165e+18,310.219,5425.58,30985,533,262,28539,28539,28539,28539,28163
16897,564,609,12723,4174,0,16897,8.33966e+18,276.493,1804.07,16897,162,131,16288,16285,16255,16253,15831
17310,568,1336,15918,1392,15917,1393,1.39398e+18,212.766,3147.53,17310,447,109,15974,15792,15348,15389,7942
8617,448,642,8091,526,0,8617,2.23635e+18,138.316,1510.19,8617,138,134,7975,7974,7911,7911,6005
2873,65,181,788,2085,0,2873,6.13784e+13,33.1712,442.139,2873,41,49,2692,2677,2537,2480,1501
12558,45,61,0,12558,12473,85,2.48455e+16,25.6286,484.346,12558,30,32,12497,12483,12255,12324,11641
42948,85,1884,42948,0,38720,4228,1.41277e+18,306.889,4969.05,42948,562,176,37887,35530,29591,7696,5242
26616,909,1176,6332,20284,0,26616,2.46509e+13,243.687,3332.95,26616,285,150,25440,25432,25207,24696,22114
10149,11,13,10070,79,10149,0,9.66541e+13,8.52586,197.368,10149,10,9,10136,10134,10133,10134,10128
16317,1,11,16218,99,16317,0,1.03986e+14,8.71919,255.899,16317,10,10,8491,8491,8491,8491,8491
30869,848,1761,0,30869,0,30869,1.63166e+18,335.75,4446.53,30869,373,179,29108,28820,28140,18238,18997
5627,5,381,5627,0,5305,322,9.76356e+17,155.548,1015.15,5627,131,80,2411,1872,1259,653,588
15821,256,604,15821,0,11890,3931,9.0784e+17,272.777,1818.07,15821,166,132,15004,14565,13917,12562,6674
24790,38,520,24790,0,24790,0,3.52125e+18,285.986,2532.1,24790,174,168,19068,16808,13749,8980,3112
35675,218,1187,0,35675,0,35675,1.22031e+18,568.45,3940.82,35675,341,209,32804,31912,30019,26812,16446
21592,6,49,0,21592,21109,483,2.12649e+16,15.5072,607.77,21592,24,23,21407,21332,19166,19809,11954
35492,749,1225,33096,2396,0,35492,2.4452e+18,612.849,4043.8,35492,368,213,34196,32804,32923,32649,29186
7906,3,259,7906,0,7906,0,3.78679e+18,174.918,995.577,7906,93,103,1465,419,492,581,264
49973,15,34,48827,1146,49969,4,1.02039e+14,9.13403,536.504,49973,19,18,49933,49924,48626,48608,36320
15771,585,1026,15771,0,14694,1077,9.39615e+17,458.123,2681.05,15771,227,176,14609,13985,13145,12454,8990
28249,1380,1939,25261,2988,25261,2988,3.14131e+18,208.518,4337.13,28249,395,219,26310,26310,26296,26310,22501
19864,335,1119,18537,1327,18537,1327,6.64918e+17,510.874,3012.72,19864,293,182,18282,17747,17284,17292,12277
41001,774,1131,41001,0,36022,4979,1.17963e+18,405.162,4433.84,41001,315,199,39870,39865,38797,37529,30712
49473,71,1872,0,49473,10850,38623,6.58422e+15,321.179,5446.07,49473,499,202,45396,43081,40751,25783,8302
34695,134,631,34695,0,34695,0,3.90023e+18,284.181,2986.25,34695,205,171,33216,32202,24902,24054,11133
24191,229,1407,21830,2361,21830,2361,1.38359e+18,364.23,3732.15,24191,349,170,21344,19157,16764,18094,3185
28995,30,33,28075,920,28991,4,1.00757e+14,9.86329,435.437,28995,19,18,28962,28961,28936,28934,28920
26600,11,12,25394,1206,26600,0,9.61255e+13,10.1183,367.718,26600,12,11,26588,26588,26209,26210,26581
17885,1,7,17848,37,17885,0,8.27352e+13,6.9551,261.982,17885,7,7,10271,10271,10271,10271,10271
21034,274,1534,19386,1648,0,21034,2.91235e+18,294.201,3426.06,21034,650,103,19311,19135,17121,17991,6397
16168,506,1317,16168,0,14437,1731,1.61705e+18,203.618,2785.06,16168,201,197,14851,14837,14214,13859,12327
652,51,200,625,27,625,27,7.38889e+17,10.0368,305.552,652,32,45,452,446,318,379,134
19270,155,1084,18030,1240,18030,1240,1.97346e+18,427.463,2908.08,19270,287,178,17290,16396,15081,15267,7085
36427,90,366,36421,6,36427,0,3.25595e+18,305.654,2612.57,36427,199,166,31874,27816,25352,19817,11323
7070,187,456,6267,803,6267,803,3.09199e+18,223.421,1347,7070,148,91,6505,6353,5305,4710,2259
19826,1045,1690,18011,1815,18011,1815,2.62399e+18,254.99,3698.5,19826,410,213,18136,18136,17941,17954,9661
49886,873,2062,41074,8812,41071,8815,2.59496e+18,354.553,6177.76,49886,445,250,47824,47778,45990,44590,18328
19233,6,12,19109,124,18188,1045,7.69803e+13,6.78428,279.443,19233,10,8,19159,19035,17386,17382,16799
18535,6,50,0,18535,18303,232,2.49277e+16,41.4515,559.786,18535,32,35,17005,16083,13283,13733,5568
46453,51,75,0,46453,46218,235,2.26863e+16,26.7792,914.059,46453,32,34,46378,46378,42008,43712,37090
5763,55,285,5763,0,5763,0,3.32353e+18,107.897,817.401,5763,76,91,5293,5033,3534,2993,1518
17363,6,11,17321,42,14685,2678,7.77166e+13,7.18004,299.913,17363,9,9,17300,17235,16733,16617,13910
45318,1520,1901,11337,33981,0,45318,3.08116e+13,301.175,4264.11,45318,378,160,43417,43380,43081,43053,39766
46863,13,18,45273,1590,46863,0,9.58496e+13,10.482,489.7,46863,16,12,46845,46842,45904,45901,38920
18524,494,760,18524,0,16283,2241,1.16917e+18,361.786,2656.94,18524,240,154,17764,17292,17006,16743,11886
29656,333,1230,27713,1943,27713,1943,2.00525e+18,597.215,3675.64,29656,351,198,27570,26758,25623,25301,15645
21424,244,1127,19997,1427,19997,1427,6.63269e+17,537.46,3136.74,21424,298,175,19529,19061,18123,18050,5735
40799,7,583,40799,0,40799,0,3.18468e+18,322.215,2713.4,40799,206,148,16551,11073,9363,8475,970
45345,60,86,0,45345,44658,687,2.06806e+16,24.8505,1096.36,45345,34,39,45259,45257,43018,43815,39683
46397,462,466,46397,0,46397,0,4.99268e+18,269.611,2905.84,46397,215,176,45931,45930,45918,45918,45838
39568,671,1276,0,39568,0,39568,1.47928e+18,595.472,4575.16,39568,493,189,38140,37665,35948,35226,23542
19063,916,1087,19063,0,17791,1272,9.56136e+17,444.107,2914.67,19063,236,186,17976,17948,17546,17706,16658
24404,43,62,0,24404,24240,164,2.56147e+16,42.9364,688.118,24404,37,35,24321,24272,23571,23705,21514
43861,50,91,0,43861,42854,1007,2.48221e+16,38.8225,1151.74,43861,47,37,43770,43762,43064,42972,36266
23390,965,1358,21846,1544,0,23390,2.4406e+18,390.912,3570.07,23390,315,164,22032,21986,21933,21951,18930
22000,639,1040,0,22000,4671,17329,4.87707e+15,269.561,2948.44,22000,275,174,20960,20880,20271,20198,12245
41911,2,18,41326,585,41905,6,9.74696e+13,16.4778,460.187,41911,18,18,39971,39599,35623,39230,35011
19080,273,480,19080,0,19080,0,3.43754e+18,273.87,2174.98,19080,162,147,18442,18090,17062,14897,12908
9914,5,10,9835,79,9914,0,9.74971e+13,8.3959,192.64,9914,10,9,9844,9815,9054,9326,8644
47638,10,35,0,47638,45363,2275,2.46254e+16,31.483,719.398,47638,31,32,46694,45576,36625,41203,28709
12791,195,966,1992,10799,0,12791,2.0763e+13,164.358,2179.94,12791,318,98,11800,11470,11081,9023,3028
36512,40,64,0,36512,36225,287,2.59086e+16,56.8261,855.731,36512,39,40,36390,36288,34973,35035,31405
38782,271,1126,38782,0,34070,4712,1.16577e+18,410.798,4327.67,38782,327,202,36573,35195,33673,24844,11894
39063,123,639,0,39063,8986,30077,7.39296e+15,228.655,3085.8,39063,252,145,37691,36867,31756,34019,12586
49565,324,960,0,49565,10888,38677,4.64498e+15,498.931,3926.57,49565,366,218,47711,46359,45606,41814,26656
46885,3,11,46566,319,46885,0,1.01195e+14,9.522,428.179,46885,10,10,44548,43518,37360,42195,35347
16880,200,407,0,16880,3822,13058,7.19435e+15,199.119,1796.38,16880,182,102,16361,16127,15468,15644,9479
16163,319,411,3672,12491,0,16163,2.87747e+13,197.241,1762.05,16163,182,102,15752,15710,15634,15720,13694
26613,13,35,0,26613,25408,1205,2.45582e+16,28.6008,536.118,26613,25,27,26363,26062,22316,24201,15965
39263,834,881,34656,4607,0,39263,3.79015e+18,358.918,3847.09,39263,302,208,38382,38382,38372,38375,37448
16823,1239,1516,16823,0,15791,1032,2.41982e+18,191.671,3043.31,16823,311,145,15307,15303,15202,15218,14030
42591,536,879,9396,33195,0,42591,1.8029e+13,466.741,3568.93,42591,358,198,41617,40586,40126,39236,31469
42906,824,976,0,42906,0,42906,4.14768e+18,353.802,3428.4,42906,258,208,41930,41925,41755,41705,39405
8767,352,832,0,8767,0,8767,1.20148e+18,139.469,1827.35,8767,193,100,7935,7906,7680,6601,6013
47279,41,89,0,47279,46624,655,2.50165e+16,64.537,1058.22,47279,70,57,46930,46316,44745,44628,39494
25995,505,938,23269,2726,23269,2726,3.26473e+18,255.375,2656.43,25995,141,157,25057,24991,23921,23636,17076
3919,137,265,886,3033,0,3919,1.83855e+13,86.2092,685.949,3919,97,56,3654,3609,3541,3556,2573
49600,786,932,37335,12265,37335,12265,7.05676e+18,402.742,3384.74,49600,284,186,48668,48650,48456,48384,46524
47724,1127,1631,12055,35669,0,47724,2.8132e+13,249.739,4364.59,47724,480,163,46093,46093,44090,44754,34685
35465,685,838,0,35465,8440,27025,5.90346e+15,251.587,3310.35,35465,380,140,34627,34591,34508,34411,27968
24462,1014,3293,24143,319,0,24462,6.73007e+18,14.3757,4300.17,24462,688,22,21169,21169,18897,18685,12391
8656,102,360,0,8656,1914,6742,7.26871e+15,162.172,1236.79,8656,158,78,8158,7984,6829,6188,2925
43657,828,1220,43657,0,38425,5232,1.16079e+18,420.952,4672.96,43657,327,212,42437,42437,41308,39825,33087
19903,151,1083,18589,1314,18589,1314,2.05982e+18,381.047,2951.99,19903,246,159,18004,17166,15338,15722,7708
31847,1204,2013,28994,2853,0,31847,3.29838e+18,331.059,4889.71,31847,534,179,29834,29834,28717,28986,20854
28445,1543,1976,28445,0,25842,2603,1.04335e+18,308.652,4640.18,28445,606,114,26469,26469,26463,26425,23598
7688,11,13,7631,57,7688,0,1.01196e+14,7.57492,173.221,7688,9,9,7675,7672,7409,7408,7273
45288,2550,3202,45288,0,40826,4462,2.72556e+18,392.847,7219.28,45288,602,245,42086,42067,38323,38392,36550
31409,151,821,27750,3659,27750,3659,3.13196e+18,350.199,3399.26,31409,287,181,29060,27125,23324,20369,7665
30283,68,1456,0,30283,0,30283,1.35109e+18,451.876,4088.62,30283,352,194,24709,20235,19901,17734,6276
25130,565,1563,25130,0,22350,2780,1.77209e+18,236.099,3475.72,25130,425,187,23567,23367,20573,22430,8099
7545,106,404,7545,0,7545,0,3.33522e+18,157.551,1292.45,7545,118,93,6711,5586,5425,4442,3592
27804,5,8,27770,34,27804,0,3.63439e+13,4.9941,368.486,27804,6,6,27796,27796,25930,25930,21261
1314,86,156,340,974,0,1314,3.02019e+13,27.277,322.182,1314,35,44,1158,1151,1091,1120,653
1144,5,10,0,1144,1078,66,2.22346e+16,6.8479,80.9148,1144,8,7,1128,1124,1027,1063,788
1306,1,7,1300,6,1306,0,1.03021e+14,6.24349,66.9105,1306,6,7,717,717,717,717,717
9219,470,514,6934,2285,6934,2285,3.8322e+18,196.415,1346.32,9219,127,116,8705,8703,8703,8703,8379
31414,725,1192,0,31414,0,31414,1.19089e+18,604.189,3766.34,31414,364,217,30043,28972,29144,26883,20407
4651,12,38,0,4651,4581,70,2.12409e+16,17.6568,253.664,4651,21,23,4532,4330,4045,4146,3115
35526,4,14,34953,573,35520,6,1.07358e+14,9.83415,346.389,35526,13,12,35330,35236,34789,34761,23271
48414,2650,4295,39870,8544,35598,12816,1.91789e+18,22.9856,5252.16,48414,1439,1435,44119,44119,42477,29895,41936
47422,443,637,47422,0,47422,0,4.94694e+18,313.846,3362.5,47422,252,171,46785,46725,45755,45412,42749
11181,396,564,11177,4,11181,0,3.64211e+18,168.341,1642.34,11181,139,108,10617,10598,10079,10099,9792
41998,41,98,0,41998,41117,881,2.02063e+16,31.2001,1072.82,41998,43,36,41899,41881,41377,40953,29597
19284,119,539,19280,4,19284,0,5.47907e+18,267.003,2121.41,19284,160,117,17800,15767,10831,12009,3692
31526,404,798,27733,3793,27733,3793,3.24572e+18,333.585,3377.11,31526,289,173,30728,30036,29090,28397,14983
24612,278,1413,24612,0,22251,2361,7.57187e+17,375.299,3770.45,24612,400,169,22159,19645,17976,10454,6778
3346,192,379,3346,0,3346,0,3.69591e+18,71.8527,664.387,3346,166,25,2967,2905,2915,2867,1641
33001,404,1118,29531,3470,29531,3470,3.26116e+18,302.259,3172.45,33001,161,166,31883,31605,28451,26586,14737
3402,41,663,3402,0,3402,0,4.91277e+17,16.8363,850.037,3402,95,25,2739,2739,2279,2661,225
21877,37,49,0,21877,21444,433,2.54542e+16,16.1028,558.924,21877,22,16,21828,21828,21794,21820,20260
41873,12,15,41746,127,41873,0,8.2373e+13,7.75151,418.902,41873,10,10,41858,41858,41855,41854,41673
9316,251,501,0,9316,1982,7334,4.85736e+15,216.339,1380.1,9316,171,117,8784,8581,8380,8184,6351
7017,1032,1173,2334,4683,0,7017,3.2122e+11,4.49594,1551.86,7017,587,6,5844,5844,5774,5704,5296
38758,154,606,37048,1710,37048,1710,1.40189e+18,438.112,3239.48,38758,265,182,34386,29618,30867,31629,20087
10928,325,567,0,10928,2563,8365,4.75394e+15,130.354,1446.92,10928,183,80,10361,10341,10182,10180,8565
36028,1878,2354,0,36028,0,36028,1.64856e+18,280.155,5484.35,36028,754,228,33674,33674,33567,33548,28754
38971,411,738,38907,64,38971,0,3.25578e+18,376.16,3521.31,38971,249,165,38111,37981,35034,32470,26942
3268,2,10,3237,31,3268,0,9.12987e+13,5.8418,107.065,3268,8,7,2947,2839,2360,2843,2088
45206,23,80,0,45206,45032,174,2.07474e+16,33.417,870.228,45206,35,37,44971,44647,38185,40522,27131
30198,432,2227,30198,0,25611,4587,1.0042e+18,348.236,4957.17,30198,408,256,27363,26512,24913,25024,8130
42441,328,926,37308,5133,37308,5133,3.24902e+18,350.532,4064.46,42441,308,195,41156,40045,36691,34960,14440
23581,167,1538,21576,2005,21576,2005,7.9399e+17,349.302,3896.06,23581,331,191,21173,19943,18600,18857,4878
38351,754,1385,38351,0,35893,2458,9.61835e+17,560.999,4458.71,38351,387,260,36857,36296,34528,34954,28966
3221,67,329,2883,338,2883,338,8.69744e+17,122.523,702.284,3221,71,73,2763,2643,2305,2325,825
38972,1126,1399,36427,2545,0,38972,2.40752e+18,590.123,4457.15,38972,354,211,37573,37257,37222,37228,35672
34789,809,887,7523,27266,0,34789,1.84074e+13,439.043,3267.72,34789,341,179,33902,33902,33854,33832,33301
20456,1094,2033,16727,3729,16633,3823,2.98439e+18,245.77,4084.59,20456,323,218,18423,18401,17385,18105,9855
38309,375,533,38309,0,38309,0,3.27067e+18,304.9,2565.77,38309,209,143,37776,37637,35436,34418,31239
30570,554,742,23022,7548,0,30570,8.32159e+18,331.423,2513.7,30570,209,157,29828,29800,29533,29520,26182
5746,401,787,5339,407,5339,407,2.16191e+18,144.829,1539.43,5746,147,122,4959,4846,4802,4784,3520
34015,1,10,33993,22,34015,0,6.62339e+13,9.99103,514.384,34015,10,10,13002,13002,13002,13002,13002
18227,545,918,0,18227,4565,13662,8.44555e+15,408.535,2356.69,18227,258,133,17190,16241,16127,15901,10588
46264,652,776,46260,4,46264,0,3.68147e+18,334.271,3445.08,46264,250,157,45488,45447,44498,44320,43613
6317,659,1219,6317,0,6317,0,3.87066e+18,16.934,1480.03,6317,165,25,5098,5098,4650,5098,2849
26964,397,1766,25194,1770,25194,1770,7.17877e+17,414.731,4481.06,26964,309,241,24898,24053,23388,23361,13522
14348,385,747,14348,0,13398,950,1.0708e+18,267.007,2028.37,14348,206,150,13592,13305,12608,12677,11252
36891,407,1206,36891,0,33016,3875,1.78879e+18,321.675,3512.15,36891,163,189,35685,35355,30638,33383,15570
25596,389,722,22530,3066,22530,3066,3.2171e+18,317.093,2948.75,25596,262,162,24864,24318,23550,22867,12658
14404,322,788,13393,1011,13393,1011,2.18489e+18,351.652,2121.27,14404,211,155,13410,12977,12637,12287,6587
39593,978,1213,35649,3944,35649,3944,2.46806e+18,489.266,4488.16,39593,410,186,38380,38167,38004,37855,30384
12655,494,842,12655,0,12214,441,7.32822e+17,15.0288,1758.23,12655,421,16,11813,11813,11545,11718,7886
44352,1059,1799,39809,4543,0,44352,3.11806e+18,468.427,5442.95,44352,502,191,42553,42276,40821,40789,26997
26251,389,507,26251,0,26251,0,3.33326e+18,273.078,2102.7,26251,165,130,25744,25698,24647,24144,22110
24081,37,1493,21824,2257,21824,2257,1.33357e+18,376.06,3832.63,24081,430,160,18321,14041,11681,13390,2603
43703,447,2336,43703,0,39533,4170,1.22144e+18,315.217,5874.49,43703,651,150,41097,40709,36464,38948,5870
8687,452,676,8687,0,8685,2,4.66386e+18,17.1496,1344.83,8687,282,19,8011,8011,7687,8011,7341
48885,420,556,48885,0,48885,0,3.26416e+18,352.714,2940.62,48885,218,164,48326,48200,46217,45004,42901
43449,641,1401,43449,0,40538,2911,9.73571e+17,710.394,4658.45,43449,371,246,41421,39486,35678,33474,25186
42920,11,15,41029,1891,42920,0,9.54149e+13,10.3983,467.442,42920,12,12,42904,42903,41525,41531,31057
21641,821,1222,21641,0,16881,4760,7.93748e+17,249.623,3233.2,21641,266,178,20419,20413,19443,18370,11528
17828,242,609,15649,2179,15649,2179,3.27227e+18,288.062,2327.6,17828,229,151,16981,16484,14063,13301,6070
6944,561,1144,6198,746,6198,746,1.44898e+18,144.056,2018.21,6944,247,136,5800,5749,5418,5238,2625
4858,153,219,1193,3665,0,4858,2.99612e+13,77.3024,774.138,4858,94,57,4639,4631,4364,4384,3053
31061,143,1764,28783,2278,28783,2278,2.31305e+18,433.564,4686,31061,549,131,28086,25340,26103,23057,5650
7937,488,559,1834,6103,0,7937,1.96825e+13,88.7882,1349.43,7937,135,117,7378,7378,7369,7365,6891
44700,1484,2401,40842,3858,40842,3858,2.6977e+18,408.06,6330.35,44700,599,187,42299,42280,40816,39513,31049
2148,1,8,0,2148,2146,2,2.19394e+16,4.54376,95.6697,2148,6,7,922,922,922,922,922
12731,22,61,0,12731,12658,73,2.64945e+16,23.8239,487.761,12731,30,30,12647,12620,12152,12069,10402
17628,933,1196,17628,0,16419,1209,9.76213e+17,453.857,2898.24,17628,310,170,16432,16178,15968,16177,14393
38708,2118,2428,35216,3492,35215,3493,1.23652e+18,376.437,6051.24,38708,562,256,36280,36280,36280,36280,31138
24367,465,718,21472,2895,0,24367,3.83528e+18,324.685,2878.79,24367,264,161,23649,23580,22967,23024,15744
6168,62,474,5503,665,5503,665,3.31585e+18,162.074,1116.52,6168,86,95,5304,5074,4811,4203,812
16152,435,695,0,16152,4026,12126,8.39546e+15,218.87,1638.85,16152,88,186,15457,15329,14792,14899,11220
20862,634,1075,19426,1436,0,20862,2.51135e+18,469.624,2978.04,20862,307,169,19679,19178,19046,19022,16409
34989,1696,3110,25728,9261,25728,9261,2.16303e+18,22.9798,3920.26,34989,1045,1039,31879,31879,30468,29057,30004
15997,4,10,15809,188,15890,107,8.31916e+13,7.21367,286.602,15997,9,8,15907,15886,13490,14981,13259
14311,1317,1442,12770,1541,12770,1541,1.06042e+18,170.781,2951.13,14311,248,214,12869,12869,12869,12869,12275
31351,811,1264,31351,0,29320,2031,9.23668e+17,661.914,3903.09,31351,332,221,30040,28875,27696,27674,23213
23387,740,859,20947,2440,20947,2440,3.248e+18,257.247,2392.36,23387,149,147,22528,22526,22470,22473,21912
9226,63,344,2164,7062,0,9226,2.83179e+13,137.486,1251.9,9226,158,83,8418,7611,6980,4423,2633
11630,146,538,8749,2881,0,11630,8.36115e+18,212.076,1434.65,11630,126,103,10899,10669,9025,8703,5170
4201,128,363,3155,1046,3155,1046,7.12966e+18,67.1276,786.177,4201,85,70,3838,3814,3642,3425,1843
47562,404,2036,0,47562,10384,37178,6.45014e+15,240.739,5287.13,47562,446,202,45526,45163,42404,28599,18656
43229,58,592,43229,0,43229,0,4.92749e+18,289.623,3070.49,43229,203,170,38047,33022,23365,20404,10845
30644,482,2287,30644,0,27414,3230,1.47029e+18,212.801,4894.15,30644,568,155,28357,27873,24887,26426,5818
42579,176,741,42451,128,42579,0,3.18247e+18,391.844,3530.14,42579,258,170,40021,37176,32372,27942,13259
36821,278,2439,34133,2688,0,36821,2.739e+18,498.504,5422.98,36821,739,206,33759,33374,30926,31734,5601
48526,375,405,12643,35883,0,48526,1.24569e+13,304.159,2855.73,48526,247,151,48121,48121,48027,47987,47279
24651,892,1066,0,24651,0,24651,1.20854e+18,537.157,3240.72,24651,293,190,23585,23179,23375,23042,21906
25591,6,8,25416,175,25591,0,1.0746e+14,7.72182,295.899,25591,8,8,25557,25526,24894,24893,22589
43599,285,682,43535,64,43599,0,4.16228e+18,337.09,3446.91,43599,240,155,42513,41257,37384,35485,28900
6283,86,459,6283,0,4739,1544,8.7813e+17,99.1744,1051.95,6283,98,99,5784,5532,4959,4654,2110
9755,284,413,9755,0,9755,0,3.56138e+18,235.086,1505.4,9755,138,112,9307,9167,8777,8275,6976
5777,76,400,2362,3415,5777,0,6.08759e+18,121.327,965.581,5777,247,60,5080,4558,2771,2639,1996
42381,824,2254,39272,3109,0,42381,2.7424e+18,514.565,6064.09,42381,752,144,40082,39361,38200,37682,19049
26091,2,13,25889,202,26091,0,9.87338e+13,11.491,318.394,26091,12,11,23660,22932,18227,22813,16620
48016,1037,1040,0,48016,10435,37581,4.80371e+15,439.191,3950.33,48016,345,193,46976,46976,46976,46976,46932
13153,167,994,317,12836,0,13153,2.3296e+12,52.2558,1988.67,13153,420,49,12159,12053,11177,10888,3692
6445,183,407,6445,0,5767,678,1.79897e+18,180.505,1053.62,6445,87,104,5952,5519,5175,5697,2722
41948,15,66,0,41948,41883,65,2.03455e+16,29.868,789.585,41948,32,36,41596,41439,34774,35807,22340
17383,315,792,0,17383,0,17383,2.14772e+18,273.572,1947.87,17383,106,204,16524,16010,14640,6219,6916
49570,5157,6278,49570,0,48976,594,4.17419e+17,100.736,8168.71,49570,1397,23,43292,43200,42775,43292,38551
24258,1059,1881,24258,0,22696,1562,2.76071e+18,348.743,4175.43,24258,479,185,22377,22155,21043,21924,16236
46923,486,496,46923,0,46923,0,5.107e+18,303.978,2916.04,46923,203,177,46427,46427,46419,46407,46267
4805,107,350,4805,0,4805,0,3.74879e+18,130.58,1008.18,4805,110,93,4236,3566,3500,2939,1672
12428,164,362,2851,9577,0,12428,2.87011e+13,171.948,1483.48,12428,162,94,11979,11832,10891,9379,7614
4594,247,404,3467,1127,0,4594,8.27272e+18,75.7906,851.308,4594,81,77,4190,4165,4146,4171,3085
6248,280,736,0,6248,0,6248,1.12482e+18,121.431,1468.33,6248,279,49,5512,5371,5236,3226,2273
2920,108,273,2716,204,0,2920,2.55578e+18,107.57,657.352,2920,78,63,2585,2279,2379,2412,1412
22070,32,43,0,22070,22042,28,2.10427e+16,26.8193,531.233,22070,30,31,22025,22018,20610,21260,20912
38229,578,848,0,38229,9148,29081,5.92244e+15,255.121,3421.27,38229,382,143,37381,37299,36670,36913,26908
35370,7,35,0,35370,33660,1710,2.46611e+16,30.3864,617.622,35370,30,29,33635,32371,24484,30142,17467
39503,308,1597,35471,4032,35471,4032,1.36029e+18,572.274,5014.32,39503,445,196,36112,31388,29509,31267,15490
23384,12,794,6096,17288,0,23384,2.94407e+13,188.508,2167.69,23384,118,138,17882,14030,13267,11391,2929
37027,763,834,0,37027,0,37027,4.14588e+18,346.279,2861.68,37027,230,168,36193,36191,36147,36109,35469
13943,342,760,0,13943,2355,11588,4.99802e+15,113.492,1987.56,13943,260,76,13183,13129,13100,13004,7027
19640,492,1057,0,19640,0,19640,1.18911e+18,419.521,2903.96,19640,264,183,18348,17719,17625,15803,11953
45428,1003,2020,45428,0,40055,5373,1.17434e+18,379.791,5786.71,45428,408,242,43408,43383,41838,42221,35319
45931,1,13,45599,332,45931,0,1.0201e+14,11.4679,417.541,45931,13,12,25237,25237,25237,25237,25237
28596,8,11,27221,1375,28596,0,9.63259e+13,10.6087,377.888,28596,11,11,28507,28440,27636,27637,27934
46582,129,519,46582,0,46582,0,5.06326e+18,291.338,3154,46582,208,168,44739,42905,30569,27749,18335
24293,280,679,18291,6002,0,24293,8.3186e+18,316.014,2191.99,24293,176,140,23412,22533,21913,21932,12041
23480,314,649,23480,0,23480,0,3.28478e+18,264.686,2644.85,23480,183,152,22785,22314,20280,18182,13581
23358,460,1016,21810,1548,0,23358,2.39648e+18,488.039,3078.7,23358,279,184,21943,21217,21088,21115,17666
22515,19,74,0,22515,22264,251,2.52578e+16,28.0716,632.929,22515,29,27,22398,22318,21298,21396,15303
1154,113,234,1154,0,1044,110,1.20247e+18,6.57192,331.403,1154,113,10,920,920,887,880,518
36650,19,63,0,36650,36354,296,2.48634e+16,51.7901,846.974,36650,40,41,36256,35973,34242,33033,24965
884,162,177,884,0,817,67,1.15137e+18,69.6821,331.177,884,50,44,707,707,699,704,687
34348,659,1724,30639,3709,30639,3709,9.4184e+17,280.943,4064.9,34348,266,201,32624,32586,32185,32439,23570
10375,194,518,7825,2550,0,10375,8.26158e+18,205.32,1345.2,10375,123,112,9734,9534,9072,9009,4440
29571,310,1213,27635,1936,27635,1936,6.31608e+17,631.062,3698.71,29571,345,206,27347,26626,25437,25519,9654
23405,487,573,15379,8026,23405,0,4.69159e+18,300.704,2298.34,23405,283,115,22832,22791,22726,22705,21464
48383,467,893,36457,11926,36457,11926,3.80771e+18,410.68,3447.87,48383,267,197,47467,47152,46593,46404,32931
1856,327,355,0,1856,0,1856,1.97793e+18,33.7538,590.416,1856,76,50,1501,1501,1501,1501,1454
41807,1,12,39857,1950,41807,0,9.61103e+13,10.513,459.892,41807,12,11,16269,16269,16269,16269,16269
4210,480,519,4210,0,3758,452,5.84427e+18,103.221,962.809,4210,241,51,3691,3691,3659,3674,3566
30730,1054,2398,0,30730,0,30730,1.48644e+18,324.412,5062.52,30730,741,218,28332,28157,27570,27358,15393
4657,50,505,4657,0,3519,1138,8.71049e+17,71.8763,1117.08,4657,83,119,3931,2895,2951,3078,822
32776,86,458,32776,0,32776,0,5.08823e+18,278.148,2424.48,32776,200,154,30399,27887,19208,16814,10794
29833,261,400,29833,0,29833,0,4.97889e+18,257.79,2255.34,29833,189,136,29368,28976,26498,25703,20463
46999,1484,3206,45920,1079,45920,1079,4.17043e+18,45.7797,5983.27,46999,1519,23,43793,43757,42002,30166,25807
30722,71,89,0,30722,30074,648,2.45619e+16,37.5329,969.208,30722,42,36,30633,30630,30345,30532,27917
44139,1290,1838,0,44139,0,44139,1.97206e+18,278.914,4441.77,44139,398,190,42301,42301,40346,32329,29562
5558,328,425,0,5558,1252,4306,4.48566e+15,83.2337,1031.13,5558,104,102,5133,5133,5117,5109,4333
18927,24,584,18087,840,18087,840,1.41031e+18,332.869,2254.05,18927,214,146,13572,10098,10639,10747,4172
6359,277,289,6359,0,6359,0,4.94923e+18,124.072,955.657,6359,120,87,6070,6069,6059,6062,6033
13530,41,44,0,13530,13200,330,2.17664e+16,13.1228,479.219,13530,23,17,13486,13486,13486,13486,13051
8289,28,56,0,8289,8198,91,1.81948e+16,16.3553,364.564,8289,22,25,8233,8228,7547,7749,6418
45005,54,61,0,45005,44759,246,2.75822e+16,30.8863,794.299,45005,31,35,44944,44942,44750,44847,43912
16750,25,31,0,16750,16719,31,2.13592e+16,25.9886,432.573,16750,28,28,16692,16613,15881,15813,15413
42084,3,10,41797,287,42084,0,1.00687e+14,9.50178,401.293,42084,10,10,40006,39103,33701,37840,31741
9093,350,423,9093,0,9093,0,3.02054e+18,170.273,1368.87,9093,199,93,8670,8653,8563,8545,7484
28823,392,1268,0,28823,5266,23557,6.13287e+15,288.668,3494.14,28823,418,110,27460,27052,25964,18761,13100
14527,4,11,13884,643,14527,0,9.54856e+13,10.4549,268.28,14527,11,11,13713,13465,12505,11179,8610
41016,394,970,30942,10074,30942,10074,3.78643e+18,376.513,3271.47,41016,231,189,39945,38467,38615,38683,17900
10391,232,302,10391,0,10391,0,4.86631e+18,150.603,1194.2,10391,119,102,10089,10044,9685,9641,8790
36967,198,1768,36967,0,33471,3496,7.93141e+17,686.189,4960.45,36967,552,172,32328,29237,25506,8174,6204
33808,540,898,0,33808,0,33808,4.13001e+18,330.549,2814.2,33808,218,171,32910,32822,32090,26007,24891
13799,41,1076,12213,1586,12213,1586,9.43231e+17,201.009,2275.25,13799,204,148,11369,9751,8176,8408,1585
48680,861,873,36653,12027,36653,12027,7.03955e+18,387.264,3264.8,48680,263,174,47807,47807,47806,47806,47741
10999,366,794,10999,0,10248,751,1.09966e+18,279.472,1911.53,10999,205,138,10183,9864,9108,9268,7240
32964,1985,2108,32964,0,29390,3574,1.61672e+18,257.647,4639.56,32964,497,197,30856,30856,30851,30856,29867
38127,995,1314,38127,0,33993,4134,8.52426e+17,554.321,4334.01,38127,452,165,36813,36750,36514,36786,32846
35001,1294,1434,32786,2215,0,35001,2.3331e+18,515.932,4279.96,35001,388,178,33567,33496,33523,33533,33028
12861,5,9,12534,327,12413,448,8.51365e+13,5.47422,200.044,12861,9,6,12845,12838,12534,12535,10589
13823,9,13,13720,103,13823,0,9.9391e+13,8.38834,228.799,13823,9,9,13807,13805,13380,13380,12801
24134,9,11,23937,197,24134,0,1.00815e+14,8.92915,304.485,24134,10,10,24119,24114,24034,24033,24101
20096,501,907,0,20096,0,20096,1.71492e+18,293.684,2951.2,20096,331,154,19189,19133,17656,17519,12525
2853,221,357,0,2853,0,2853,1.7072e+18,75.8395,671.334,2853,105,55,2496,2496,2379,2496,2176
28152,790,1750,28152,0,26314,1838,9.5908e+17,467.234,4521.12,28152,384,238,26402,25864,24241,23186,15906
16322,557,595,14633,1689,14633,1689,3.22158e+18,253.107,1802.35,16322,118,138,15727,15727,15704,15697,15343
35779,258,667,9991,25788,0,35779,6.31546e+13,233.892,2315.12,35779,154,138,35066,34366,32499,32087,19236
25548,11,81,0,25548,25031,517,2.17234e+16,21.1608,794.445,25548,27,31,25186,24761,23266,23137,14034
14249,640,846,13296,953,13296,953,2.08208e+18,325.361,2163.19,14249,239,132,13403,13148,13292,13279,11942
2692,5,6,2620,72,1894,798,8.06158e+13,4.74814,88.3548,2692,6,6,2684,2681,2668,2667,2509
42406,1813,2603,38645,3761,0,42406,3.16982e+18,341.008,6132.52,42406,524,250,39803,39778,39520,39761,29272
30968,135,1608,28404,2564,28404,2564,2.55417e+18,398.505,4378.73,30968,363,188,27733,25925,23771,23236,5781
49274,650,800,13694,35580,0,49274,6.29157e+13,278.33,2857.74,49274,207,158,48474,48466,48288,48361,46131
21385,290,1130,21385,0,19953,1432,9.83454e+17,529.194,3137.71,21385,323,192,19603,19001,16646,15934,9578
19824,652,1066,18485,1339,18485,1339,2.09362e+18,525.616,2950.92,19824,280,181,18648,17998,18012,17756,14032
40172,1121,1566,0,40172,8173,31999,5.94474e+15,368.817,4700.17,40172,573,135,38606,38605,38071,38424,32305
47804,479,579,47804,0,47804,0,5.01633e+18,295.115,3223.79,47804,207,163,47225,47194,46495,46228,43667
15213,487,900,15213,0,13654,1559,8.85968e+17,396.871,2208.09,15213,338,103,14058,13439,13129,13919,10876
13714,245,924,12651,1063,0,13714,2.51906e+18,260.314,2445.58,13714,363,124,12470,11417,11621,11674,6486
27658,229,814,0,27658,6054,21604,4.88502e+15,406.805,2843.59,27658,288,154,26224,25701,24664,22355,14231
29958,346,1968,27354,2604,27350,2608,1.45084e+18,350.389,4785.18,29958,719,164,27608,26997,25215,26046,7060
23371,50,1509,21506,1865,21506,1865,7.44063e+17,382.826,3851.86,23371,319,196,18383,15724,13923,13777,2468
49388,1122,1638,49388,0,43266,6122,1.17921e+18,402.545,5387.95,49388,368,211,47750,47747,47440,47386,45034
49652,23,1515,43569,6083,0,49652,3.91992e+18,362.805,5063.55,49652,339,215,35083,27398,26713,24719,3811
26062,584,707,22951,3111,0,26062,3.85632e+18,315.442,2952.15,26062,268,168,25355,25355,25215,25244,22909
34157,77,828,34157,0,25725,8432,8.5407e+17,375.783,2889.1,34157,233,172,31205,29677,23924,24379,3163
42088,424,838,31679,10409,0,42088,8.33244e+18,360.592,3012.87,42088,241,169,41225,40903,39615,39664,27607
43216,1445,1464,0,43216,0,43216,1.2012e+18,680.362,4675.32,43216,409,249,41752,41752,41752,41752,41666
2853,115,200,2705,148,0,2853,1.91399e+18,82.7203,550.176,2853,112,44,2653,2541,2588,2634,2187
20351,137,605,19407,944,19407,944,1.4632e+18,418.583,2399.38,20351,229,145,17717,15219,15948,16155,10083
48182,25,1811,43400,4782,43400,4782,1.37574e+18,721.029,5745.11,48182,540,204,33452,27248,20474,23770,3473
20951,554,604,20951,0,20061,890,4.82948e+17,341.373,2411.75,20951,228,152,20347,20310,20267,19967,20091
21203,233,583,21203,0,21203,0,4.4102e+18,212.726,2358.68,21203,180,146,20568,20243,17790,17538,12544
40118,615,905,9007,31111,0,40118,1.81651e+13,475.023,3446.6,40118,352,195,39213,38620,38340,37109,33558
24024,423,1531,22339,1685,0,24024,2.58704e+18,406.687,3865.44,24024,341,216,22296,21653,21044,21021,8736
13188,322,899,12177,1011,12177,1011,2.41343e+18,290.275,2174.96,13188,341,122,12182,11738,11655,11546,5979
25939,175,685,19547,6392,19547,6392,7.0049e+18,311.867,2235.83,25939,178,149,24651,24104,19603,16437,10156
14014,428,1041,13055,959,13055,959,7.51929e+17,439.435,2575.36,14014,243,173,12716,12289,12096,12198,8902
48682,681,1016,42877,5805,42877,5805,3.21838e+18,360.754,4470.98,48682,348,224,47666,47661,47093,46661,35420
21698,510,743,0,21698,4718,16980,4.70582e+15,317.626,2442.69,21698,241,152,20955,20569,20458,20424,16751
35928,44,633,35928,0,35928,0,3.36194e+18,298.684,3187.11,35928,218,181,28118,24403,20768,14768,4000
37086,105,491,37086,0,37086,0,5.12427e+18,321.02,2662.8,37086,218,166,34856,32867,22724,20030,13158
28215,26,1906,25364,2851,25364,2851,3.12744e+18,220.239,4277.59,28215,426,157,22641,18753,17266,15436,2349
23494,33,58,0,23494,23417,77,2.77109e+16,21.151,542.874,23494,23,24,23436,23422,23300,23301,19163
26043,456,693,19610,6433,19610,6433,7.04607e+18,323.613,2296.95,26043,189,151,25350,25219,24891,24685,19922
33868,12,13,33658,210,33868,0,1.02308e+14,11.0449,358.711,33868,12,11,33852,33845,32797,32797,32790
15286,869,949,0,15286,0,15286,1.18504e+18,271.251,2377.39,15286,226,149,14337,14228,14307,14304,13263
12381,53,764,11575,806,11575,806,2.02652e+18,230.353,1914.36,12381,195,127,9725,8077,7767,7600,3030
42456,19,32,40735,1721,42452,4,9.80886e+13,10.5521,525.567,42456,18,18,42423,42415,41880,41881,39820
47801,47,97,0,47801,46853,948,2.49363e+16,40.4366,1209,47801,46,38,47694,47649,46410,46456,38326
28062,7,11,26735,1327,28062,0,9.63534e+13,10.455,373.917,28062,11,11,27873,27706,25356,25245,24119
49555,253,1838,0,49555,10825,38730,6.54495e+15,326.791,5420.23,49555,484,201,47201,46376,43269,27386,14238
7263,306,444,0,7263,0,7263,4.13748e+18,133.373,1070.76,7263,105,86,6819,6714,6754,6773,5464
33485,1057,1884,0,33485,0,33485,1.31572e+18,471.415,4909.99,33485,589,131,31601,31403,30442,25511,19307
1794,468,474,1794,0,1646,148,6.96546e+17,26.801,737.466,1794,109,53,1320,1320,1320,1320,1320
38715,1,13,38121,594,35884,2831,8.9332e+13,6.24815,422.846,38715,10,9,22348,22348,22348,22348,22348
48797,795,1541,42907,5890,42907,5890,1.6399e+18,394.64,5574.23,48797,380,219,47256,47241,45563,45927,26348
37224,2221,2737,33891,3333,33891,3333,1.08285e+18,297.306,6047.08,37224,524,269,34487,34487,34373,34441,30019
38926,91,1945,38926,0,34403,4523,1.99142e+18,337.689,4468.52,38926,425,309,35105,33629,25597,8131,2924
2193,1,7,2181,12,2193,0,1.12564e+14,6.56316,87.4527,2193,7,7,1123,1123,1123,1123,1123
33734,782,1993,30498,3236,30498,3236,8.48785e+17,330.956,4872.66,33734,340,243,31741,31371,31036,31090,19468
26768,4854,5107,3826,22942,0,26768,7.0191e+12,9.99215,5529.75,26768,648,18,21661,21661,21409,20663,20856
43589,293,571,41993,1596,43589,0,4.01588e+18,277.537,3212.98,43589,265,156,42947,42575,35041,34768,23665
29399,286,4687,29399,0,29399,0,5.14324e+18,12.2635,6739.57,29399,948,19,24712,24712,20196,5454,5080
46802,34,1016,41290,5512,0,46802,3.81894e+18,365.838,4362.05,46802,341,219,34862,31069,27123,25965,4262
15841,2163,3032,15841,0,15463,378,4.78288e+17,14.9677,3415.4,15841,389,23,12809,12809,12302,12809,9291
44458,27,60,0,44458,44155,303,2.62602e+16,37.569,780.885,44458,35,35,44308,44181,43169,43810,34091
6010,250,422,0,6010,0,6010,1.91821e+18,179.584,1032.11,6010,86,99,5588,5423,5359,5262,3650
16420,117,695,12387,4033,0,16420,8.22872e+18,199.726,1825.93,16420,142,140,15357,14970,11802,11736,4319
5140,101,425,4409,731,0,5140,3.26186e+18,286.371,1153.45,5140,187,89,4094,3731,3543,3650,930
9963,32,33,0,9963,9476,487,2.46414e+16,24.5261,322.941,9963,23,22,9930,9927,9929,9930,9929
46298,199,676,0,46298,12859,33439,1.61425e+16,280.666,2600.87,46298,201,143,45299,44038,40190,40382,18678
14263,396,602,0,14263,3175,11088,4.8397e+15,234.394,1787.86,14263,175,132,13661,13450,13379,13417,10735
43367,387,1248,37983,5384,0,43367,3.91616e+18,329.981,4405.3,43367,319,211,42073,41098,38502,38540,19497
6391,15,405,0,6391,1529,4862,7.29481e+15,141.52,1128.94,6391,179,71,4980,4285,3933,3489,598
10261,415,477,7731,2530,0,10261,8.29454e+18,194.338,1293.95,10261,121,100,9784,9644,9747,9724,9171
41102,3161,6949,41102,0,40295,807,4.08064e+17,14.9638,7948.84,41102,1051,23,34153,34153,31883,21278,18605
20238,389,1039,0,20238,0,20238,1.20501e+18,440.17,2907.13,20238,269,180,18840,18231,17795,16328,12520
47492,3,14,46860,632,44748,2744,8.24715e+13,7.8266,436.546,47492,10,9,46244,45882,41398,42362,32634
48770,752,916,36687,12083,36687,12083,3.83179e+18,416.623,3487.49,48770,269,191,47854,47834,47773,47756,45235
34796,17,60,0,34796,34570,226,2.68715e+16,34.0284,703.743,34796,31,35,34609,34472,33230,33021,25227
24127,885,1447,0,24127,5570,18557,7.15578e+15,155.183,3241.27,24127,397,119,22680,22677,21230,21686,15407
4891,310,366,4891,0,4603,288,1.02766e+18,158.8,945.785,4891,114,76,4525,4525,4455,4492,4323
39113,60,64,0,39113,38830,283,2.5326e+16,50.4392,878.742,39113,39,44,39046,39015,38962,38664,37299
17095,600,610,0,17095,0,17095,4.15024e+18,271.632,1806.58,17095,154,130,16485,16485,16485,16485,16451
20921,4,7,20886,35,20921,0,8.23937e+13,6.97166,282.38,20921,7,7,20360,20072,17471,17483,18227
17487,455,1085,16282,1205,16282,1205,2.10281e+18,484.496,2807.92,17487,317,175,16182,15665,15311,15239,10055
17027,72,346,17027,0,17027,0,3.49693e+18,223.812,1512.77,17027,112,168,15916,15138,10291,8431,4967
21494,93,193,0,21494,20584,910,2.45468e+16,28.4734,900.893,21494,75,38,21301,21288,20959,21019,19878
8780,21,306,8780,0,8780,0,3.97881e+18,175.72,1118.41,8780,99,104,6196,2675,3431,2627,680
36112,673,1870,0,36112,7368,28744,6.97191e+15,213.5,4521.68,36112,499,207,34242,34223,31943,30625,17085
34898,991,1457,0,34898,0,34898,1.6652e+18,337.21,4416.52,34898,413,179,33441,33440,32652,32601,26202
17349,315,1673,17349,0,13216,4133,1.09139e+18,208.804,3299.26,17349,227,217,15627,15194,14395,13193,7765
1982,184,213,1982,0,1982,0,4.16807e+18,67.4057,466.962,1982,54,56,1769,1753,1754,1720,1600
41445,1045,2184,38547,2898,0,41445,2.62121e+18,519.314,5916.43,41445,656,141,39261,38907,37643,36970,21789
28604,644,1213,26682,1922,26682,1922,6.16294e+17,518.212,3557.62,28604,302,199,27167,26349,26237,26033,20303
3188,19,118,0,3188,836,2352,8.05952e+15,80.3184,491.743,3188,89,52,2525,2193,2089,1981,862
15169,1106,1153,0,15169,0,15169,3.30207e+16,20.4185,2222.26,15169,299,19,14016,14016,13983,13785,13572
9442,1038,1066,9442,0,8719,723,9.73823e+17,168.692,2118.41,9442,289,100,8376,8376,8376,8376,8340
26751,72,1052,23686,3065,23686,3065,9.14771e+17,327.988,2797.04,26751,144,244,24203,23067,20855,19771,2981
8136,421,491,7186,950,7186,950,3.15168e+18,269.983,1495.51,8136,171,97,7645,7530,7595,7542,6544
44663,719,1335,0,44663,0,44663,1.20149e+18,712.029,4600.77,44663,427,236,42967,41229,41352,37170,26888
43006,2024,2554,38834,4172,38831,4175,1.30958e+18,337.534,6179.59,43006,634,241,40452,40452,40372,40447,30400
45175,899,2092,9319,35856,0,45175,2.61885e+13,435.075,5505.67,45175,610,240,43083,42762,40918,41260,22271
29235,391,1185,27259,1976,0,29235,2.45039e+18,533.746,3626.31,29235,321,206,27328,26363,25755,25748,14529
45673,102,1242,45673,0,40170,5503,1.17386e+18,421.132,4801.22,45673,315,207,38418,31286,28921,12511,5005
27980,194,494,27980,0,27980,0,4.30224e+18,242.314,2405.7,27980,161,166,27237,26164,21657,21478,15457
30086,517,767,0,30086,0,30086,4.12742e+18,344.792,2525.75,30086,202,155,29319,29230,28887,27821,24374
15315,619,1450,0,15315,0,15315,3.99018e+17,298.598,2803,15315,280,113,13865,13747,12008,8348,7051
13902,200,981,0,13902,0,13902,2.01718e+18,234.259,2377.69,13902,205,115,12537,11969,10154,6057,3200
3120,394,407,2762,358,2762,358,2.6094e+18,153.033,837.003,3120,154,62,2713,2587,2713,2713,2668
39189,469,1314,36579,2610,0,39189,2.41803e+18,709.443,4330.05,39189,420,233,36865,35495,34929,34862,14547
9987,384,936,9329,658,0,9987,2.36293e+18,201.323,2036.1,9987,175,131,9051,8849,8597,8577,6258
12405,51,1115,0,12405,2632,9773,6.74432e+15,98.0475,2336.78,12405,245,155,10907,10379,9575,6771,2274
40529,112,466,40529,0,40529,0,5.02675e+18,265.061,2761.95,40529,204,167,38735,36811,25780,24577,14354
36739,7,10,36592,147,36739,0,8.22769e+13,6.83516,380.835,36739,7,8,36729,36729,31738,31736,29707
9222,55,511,0,9222,0,9222,4.14273e+18,182.984,1281.12,9222,122,97,8306,7304,5458,3320,1786
13373,482,808,12048,1325,12048,1325,1.31518e+18,336.933,2377.49,13373,254,152,12565,12389,12231,11987,10968
10732,135,952,10732,0,10044,688,8.97328e+17,189.705,2088.74,10732,208,157,9524,8807,7505,7963,4395
3719,25,40,0,3719,3694,25,2.46845e+16,18.1433,248.417,3719,25,21,3678,3674,3651,3648,3351
30443,1,13,30203,240,30443,0,9.86824e+13,11.8835,341.778,30443,12,11,17053,17053,17053,17053,17053
6668,224,429,5832,836,5832,836,2.61988e+18,292.442,1292.46,6668,208,97,5829,5154,5467,5532,4107
36071,825,908,8098,27973,0,36071,1.89154e+13,473.168,3308.25,36071,377,178,35163,35157,35087,35025,34463
38032,67,68,0,38032,37812,220,2.60383e+16,31.1934,758.126,38032,32,33,37964,37964,37964,37958,37893
10740,1,13,10673,67,10740,0,1.02474e+14,7.33994,202.716,10740,9,9,5891,5891,5891,5891,5891
45016,299,1245,0,45016,9992,35024,5.30486e+15,387.645,4325.92,45016,345,206,43144,41995,40483,36239,13030
1039,1,6,1015,24,1039,0,1.07551e+14,3.61309,58.2217,1039,5,5,461,461,461,461,461
17938,52,75,0,17938,17511,427,2.20174e+16,19.3485,617.169,17938,26,26,17863,17862,17692,17662,17407
37303,1866,2430,31511,5792,0,37303,7.96071e+18,14.8878,4717.12,37303,1214,17,34873,34873,33841,34391,27611
14082,704,1322,0,14082,0,14082,1.06134e+18,158.94,2521.27,14082,303,116,12760,12689,12604,12398,9474
47545,329,2637,43105,4440,0,47545,3.33106e+18,349.831,6616.28,47545,572,253,44405,43440,40868,40476,10028
38086,458,4830,0,38086,5176,32910,7.98668e+15,10.9584,6293.48,38086,1080,22,33256,33256,22647,23605,10652
3860,291,351,3603,257,3603,257,2.07297e+18,128.973,827.12,3860,97,66,3509,3507,3486,3484,3314
45397,652,2310,0,45397,0,45397,1.75356e+18,287.514,5800.35,45397,486,255,43087,42992,41531,29723,22711
28263,719,770,24948,3315,24948,3315,3.17785e+18,350.735,3152.53,28263,283,188,27493,27493,27466,27454,27108
25408,44,47,0,25408,25222,186,2.77675e+16,18.3996,546.214,25408,21,23,25361,25361,25361,25361,25117
1755,208,444,1656,99,1656,99,6.64992e+17,40.9915,704.379,1755,61,84,1311,1308,1206,1229,700
3433,4,7,3330,103,3173,260,7.15783e+13,4.16167,99.3861,3433,6,5,3421,3416,3326,3328,3062
41569,330,1185,41569,0,36643,4926,1.15847e+18,429.054,4514.87,41569,333,218,39465,38043,36313,29307,12737
790,2,5,788,2,790,0,4.48937e+13,3.40253,46.4276,790,4,4,688,640,671,649,678
10856,307,644,9550,1306,9550,1306,1.73154e+18,280.801,1917.09,10856,169,125,10097,9848,9632,9579,4535
46295,362,491,46295,0,46295,0,3.54914e+18,343.89,2545.02,46295,345,73,45686,44560,45208,44769,39487
33018,1665,1714,30554,2464,30554,2464,7.15297e+17,556.317,4728.74,33018,429,230,31304,31304,31303,31289,31202
24836,774,798,21724,3112,21724,3112,3.2403e+18,314.779,2963.8,24836,261,169,24038,24038,24037,24038,23798
4843,13,542,4843,0,4277,566,7.14555e+17,282.376,1227.39,4843,185,88,2835,2435,1592,515,706
9567,46,632,0,9567,0,9567,2.85494e+16,14.86,1312.91,9567,317,15,8935,8935,2469,2540,2265
38574,1729,2071,34650,3924,34650,3924,3.15351e+18,245.471,4964.2,38574,453,172,36503,36503,34924,34591,27763
42843,2,10,42532,311,42843,0,1.00113e+14,9.70929,404.432,42843,10,10,37259,36178,31810,34905,27995
14229,5,33,0,14229,14032,197,1.80537e+16,22.5097,391.531,14229,21,24,13976,13874,12028,12894,8252
27699,75,1207,25075,2624,0,27699,2.96235e+18,440.505,3729.92,27699,399,151,22807,21448,19427,19618,2707
14141,316,1000,0,14141,0,14141,1.23208e+18,253.644,2367.48,14141,265,150,13046,12846,12290,10621,8003
48111,1029,1875,43105,5006,0,48111,3.79369e+18,294.87,4916.89,48111,408,183,46236,46231,41620,41479,22865
32404,316,834,7154,25250,0,32404,1.82245e+13,436.878,3079.07,32404,314,176,31116,30269,29756,25763,19019
40191,1843,2492,36062,4129,36059,4132,1.28414e+18,279.509,5779.76,40191,590,260,37699,37699,37564,37685,23202
21943,1878,1938,17402,4541,17402,4541,5.86164e+18,235.71,3958.26,21943,323,200,20005,20005,20005,20005,19788
7000,6,389,5852,1148,7000,0,3.31041e+18,174.773,1154.79,7000,201,81,4284,3025,2255,1592,651
10477,640,933,2740,7737,0,10477,6.32271e+13,91.2832,1879.43,10477,200,86,9544,9539,9462,9471,8967
43059,477,1303,10972,32087,0,43059,3.01788e+13,413.833,4252.32,43059,529,177,41351,39942,35508,35302,9312
31700,965,2197,28500,3200,28500,3200,1.04617e+18,253.796,5007.18,31700,367,245,29503,29499,28353,28857,20836
1490,12,165,0,1490,166,1324,7.66468e+15,54.8584,357.991,1490,89,32,1180,1141,1004,876,278
732,54,79,187,545,0,732,2.88378e+13,22.623,178.236,732,28,26,653,653,642,647,506
32911,1010,1429,5319,27592,0,32911,2.04431e+13,351.858,3892.1,32911,518,100,31482,31354,31112,31301,26211
32302,1511,1670,0,32302,6219,26083,6.50949e+15,236.173,4139.51,32302,510,145,30632,30632,30451,30482,29124
18913,28,32,0,18913,18836,77,2.79079e+16,17.0194,451.92,18913,21,21,18881,18881,18881,18881,18504
9086,529,706,9086,0,8468,618,1.12054e+18,183.582,1651.53,9086,152,134,8380,8323,8004,8218,6464
40911,2331,2351,0,40911,0,40911,1.30011e+18,495.593,5680.42,40911,712,142,38560,38560,38560,38560,38509
16956,635,677,16952,4,16956,0,3.92351e+18,227.726,2150.15,16956,163,116,16279,16277,16245,16233,16195
34013,51,195,0,34013,32961,1052,2.57551e+16,24.4654,1122.33,34013,74,37,33818,33772,32753,31812,21959
33362,1875,2261,29811,3551,29811,3551,3.30902e+18,229.571,4944.59,33362,474,247,31101,31101,30154,29836,25093
28101,136,985,25174,2927,25174,2927,3.24274e+18,270.737,2722.15,28101,155,161,25810,23985,22968,20143,4262
17408,616,1138,0,17408,0,17408,2.85455e+16,14.8776,2270.6,17408,570,15,16270,16270,15748,15748,10338
48358,4,15,47656,702,45614,2744,8.08723e+13,9.35756,441.345,48358,10,11,47762,47417,43599,44115,33495
41652,11,14,41208,444,41204,448,8.28777e+13,6.75154,411.698,41652,9,9,41638,41638,37678,37677,38523
23779,42,604,23779,0,23779,0,3.12555e+18,263.094,2585.82,23779,186,138,18860,14276,13201,8540,4345
23696,232,752,17854,5842,17854,5842,7.00116e+18,303.115,2375.18,23696,188,175,22569,21873,18596,16319,6730
42185,1401,1740,8901,33284,0,42185,2.61163e+13,326.165,4939.22,42185,422,199,40445,40440,40305,40445,35010
29754,100,1210,0,29754,5301,24453,4.9449e+15,272.845,3530.15,29754,379,106,27675,26758,25989,16294,5554
17962,331,631,16029,1933,0,17962,2.97719e+18,339.155,2475.29,17962,266,149,17003,15153,16392,16668,14069
37391,228,1267,34821,2570,34821,2570,2.11081e+18,665.628,4196.29,37391,408,231,34135,33175,30972,30363,10044
32377,588,2113,29230,3147,0,32377,3.41097e+18,252.378,4925.53,32377,429,243,30264,30082,29267,28949,14307
3955,62,327,0,3955,832,3123,5.01025e+15,80.7755,781.473,3955,98,53,3496,3209,3100,2947,1813
11947,355,662,0,11947,2569,9378,4.73478e+15,231.277,1786.34,11947,217,126,11285,11052,10803,10720,8004
16959,700,1245,0,16959,0,16959,1.16827e+18,263.536,2998.79,16959,277,131,15714,15687,15529,12307,12011
19983,22,89,0,19983,19851,132,2.54797e+16,37.6251,755.348,19983,38,35,19828,19757,18549,17861,10805
19242,474,937,17040,2202,17040,2202,3.56316e+18,252.276,2219.41,19242,117,204,18305,17967,17467,17016,12573
8090,6,9,8062,28,8090,0,1.14469e+14,7.25377,170.021,8090,8,8,8070,8056,7774,7773,5841
40773,624,650,40773,0,40773,0,3.47567e+18,330.75,3416.86,40773,238,191,40123,40123,40089,40064,39872
13529,574,713,13529,0,10178,3351,8.37502e+17,224.415,2024.6,13529,154,161,12816,12807,12647,12018,11057
41859,159,534,41859,0,41859,0,4.94028e+18,287.661,3023.43,41859,197,166,40451,39245,29305,27077,17781
24209,539,1434,3923,20286,0,24209,2.11449e+13,204.931,3411.75,24209,380,154,22775,22689,21867,22609,6846
46043,253,2381,41247,4796,0,46043,3.53329e+18,406.726,6212.78,46043,528,242,42704,41397,37280,37253,11180
2593,3,8,2586,7,2593,0,1.18756e+14,5.7501,94.1702,2593,7,6,2481,2419,2080,2371,1872
21371,149,604,21371,0,20455,916,4.86789e+17,350.508,2446.54,21371,227,153,18684,16107,14772,7460,6471
36223,141,592,0,36223,8414,27809,7.39559e+15,226.037,2913.24,36223,251,141,35086,34375,29267,32376,12999
3548,291,333,3318,230,3318,230,2.01815e+18,123.136,792.241,3548,99,68,3215,3215,3197,3196,3089
8167,19,610,8167,0,7239,928,1.13289e+18,309.245,1663.88,8167,187,114,5507,4475,3421,752,587
42691,2939,3103,922,41769,0,42691,2.00616e+12,56.3903,5911.71,42691,498,57,39588,39588,39379,38918,37933
12020,97,1046,0,12020,0,12020,1.42569e+18,207.212,2376.93,12020,260,88,10231,9523,8793,1994,1785
28552,14,37,0,28552,27266,1286,2.45409e+16,28.9174,555.897,28552,28,29,28298,28051,24811,26147,19490
28285,654,831,6454,21831,0,28285,2.62461e+13,219.887,2970.86,28285,341,129,27454,27450,27294,27403,22348
24065,602,982,18117,5948,0,24065,8.22566e+18,287.567,2601.48,24065,209,146,23083,23081,22849,22783,21700
35742,1544,2284,32413,3329,32410,3332,1.38599e+18,316.858,5566.17,35742,630,150,33458,33458,33275,33381,25417
5283,119,281,1191,4092,0,5283,1.84867e+13,77.379,776.458,5283,85,64,5002,4982,4752,4799,3427
44327,40,61,0,44327,44074,253,2.73896e+16,33.6978,789.51,44327,32,35,44256,44163,43637,44085,38487
47603,145,731,13242,34361,0,47603,6.29274e+13,288.024,2733.82,47603,206,155,46030,44877,39270,35559,15651
34914,1155,1307,34914,0,32514,2400,1.02682e+18,674.793,4120.91,34914,385,217,33607,33488,33434,33427,32678
11231,86,269,0,11231,2932,8299,2.90747e+15,190.259,1252.36,11231,162,85,10121,9277,9669,9835,5891
9134,180,383,2305,6829,0,9134,3.14355e+13,247.898,1201.99,9134,149,73,8421,8049,7806,8343,5879
19691,54,67,0,19691,19524,167,2.54293e+16,44.6283,624.412,19691,34,35,19617,19582,19204,19305,17902
29057,6,10,28997,60,29057,0,8.29985e+13,6.96252,340.688,29057,9,7,28860,28513,25471,25467,26255
32556,439,854,0,32556,7231,25325,4.60381e+15,440.21,3117.22,32556,313,163,31476,30727,30510,30185,23104
28192,17,74,0,28192,27975,217,2.52785e+16,42.9423,790.2,28192,36,37,27836,27423,26275,25586,19024
3748,247,292,3748,0,3748,0,3.172e+18,88.2468,719.278,3748,76,74,3456,3443,3416,3403,3162
4325,112,230,1172,3153,0,4325,1.30202e+13,152.568,735.349,4325,139,59,3913,3668,3760,3790,1903
12740,893,987,12740,0,11914,826,9.64833e+17,278.056,2300.82,12740,260,150,11753,11645,11628,11686,11561
36682,491,834,8095,28587,0,36682,1.87232e+13,447.916,3253.62,36682,329,180,35677,34839,34432,33158,27875
37140,310,478,37140,0,37140,0,5.10354e+18,295.727,2584.74,37140,212,157,36555,36145,33918,32178,28961
29433,912,1672,26317,3116,26315,3118,1.30887e+18,243.735,3982.91,29433,386,150,27761,27748,27381,27663,13389
3691,9,30,0,3691,3509,182,2.48719e+16,15.2295,196.22,3691,18,18,3575,3463,2906,3295,2591
31507,73,92,0,31507,31036,471,2.0254e+16,29.6934,920.081,31507,43,32,31415,31415,31394,31412,26862
28064,47,577,25225,2839,28064,0,3.42295e+18,319.218,2657.16,28064,277,146,23862,21691,17093,13882,4874
27072,51,1797,25371,1701,0,27072,2.37623e+18,280.029,4106.28,27072,522,124,22141,20073,18447,18819,3063
10283,69,491,2188,8095,0,10283,1.9051e+13,231.026,1437.17,10283,173,119,9190,8434,8121,7874,3880
11924,112,516,8990,2934,0,11924,8.24456e+18,218.862,1430.02,11924,135,105,11125,10925,8744,8851,3510
40175,333,982,0,40175,0,40175,4.1337e+18,350.523,3120.83,40175,228,180,39022,37569,34613,21705,19943
20318,5,36,0,20318,19365,953,2.45951e+16,28.2728,471.926,20318,27,28,18758,18337,13770,13710,10264
43309,303,1349,43309,0,40458,2851,1.02289e+18,699.321,4538.81,43309,410,232,40260,39274,34281,33261,22323
29701,42,44,0,29701,29508,193,2.59181e+16,37.1887,595.806,29701,31,31,29654,29604,29564,29642,29131
43240,712,1290,0,43240,9909,33331,5.41931e+15,378.462,4303.14,43240,378,190,41950,41910,40492,40003,22601
34367,54,93,0,34367,33767,600,2.04681e+16,27.6247,928.201,34367,39,34,34274,34265,34093,34193,25738
37676,20,1287,0,37676,7528,30148,5.07277e+15,399.838,4245.15,37676,409,110,32285,30764,26662,17894,5397
45409,1034,2345,40908,4501,0,45409,3.52851e+18,275.753,5815.97,45409,486,256,43064,43064,42558,42389,29383
44672,89,675,0,44672,12466,32206,1.59928e+16,276.212,2538.03,44672,181,154,42826,41986,36016,37126,12026
8777,5,8,8757,20,8777,0,1.18593e+14,7.16885,174.669,8777,8,8,8753,8743,8430,8416,7492
34031,129,809,7567,26464,0,34031,1.74192e+13,435.5,3129.14,34031,310,179,31852,31188,29445,24737,12784
3856,28,215,1081,2775,0,3856,6.2852e+13,44.2967,560.027,3856,52,51,3512,3274,3052,2458,1040
14772,169,1002,13755,1017,13755,1017,2.11189e+18,233.225,2386.44,14772,210,137,13475,12792,12290,12004,6005
48161,6,12,47504,657,44515,3646,7.95433e+13,6.93339,443.641,48161,9,8,47953,47551,43751,43746,41631
6796,445,639,6318,478,6318,478,2.18974e+18,145.082,1393.51,6796,152,92,6157,6153,6098,6091,5814
24645,172,717,0,24645,0,24645,1.88733e+18,322.227,2886.54,24645,260,160,23061,22302,18481,9581,6762
3523,165,428,3219,304,3219,304,2.6997e+18,90.4596,770.947,3523,123,55,3095,3015,2923,2921,1350
24310,1137,1241,6592,17718,0,24310,6.21244e+13,166.447,2858.89,24310,231,128,23069,23069,23069,23069,22689
8352,23,51,0,8352,8234,118,2.44765e+16,26.0097,368.081,8352,28,30,8282,8237,7966,7881,5936
18547,407,574,0,18547,4068,14479,4.88345e+15,296.671,1981.57,18547,179,149,17973,17641,17647,17730,16118
5921,320,469,5210,711,5210,711,3.26655e+18,149.612,1260.68,5921,162,101,5452,5381,5180,5145,4205
7982,89,438,1298,6684,0,7982,1.99971e+13,153.169,1229.87,7982,176,60,7351,6945,6799,6071,2566
19542,496,573,5061,14481,0,19542,2.93814e+13,185.086,1711,19542,103,128,18969,18969,18857,18920,17938
26713,19,43,0,26713,26675,38,2.07167e+16,26.3877,579.676,26713,30,31,26568,26442,22857,24564,22683
7446,413,915,0,7446,1652,5794,1.64847e+15,132.094,1553.41,7446,218,73,6531,6483,5672,4036,3583
1306,7,23,0,1306,1296,10,2.82493e+16,15.941,118.209,1306,17,16,1210,1155,1134,1123,749
24083,30,55,0,24083,23688,395,2.79278e+16,18.5028,498.419,24083,30,27,24027,24012,23862,23890,19580
25162,219,894,0,25162,5508,19654,4.57206e+15,318.328,2808.88,25162,234,172,23897,23417,22497,22283,6793
24281,152,912,0,24281,0,24281,1.92804e+18,258.689,2557.45,24281,146,152,22500,20718,19906,13680,5811
24785,576,1189,22427,2358,0,24785,2.91133e+18,364.481,3540.48,24785,402,162,23596,23326,22097,22416,15370
21796,238,1016,20361,1435,0,21796,2.38366e+18,548.781,3026.67,21796,279,196,19834,19319,18252,18415,4887
42807,1333,2943,42807,0,39120,3687,9.34191e+17,591.577,6875.16,42807,762,214,39864,39620,37783,33685,16503
28431,10,12,28301,130,28367,64,1.05498e+14,6.99648,325.477,28431,9,9,28419,28419,28386,28385,27681
19513,486,918,0,19513,4127,15386,4.6901e+15,282.463,2624.32,19513,282,127,18595,18337,18173,18339,13115
4636,290,502,4250,386,4250,386,2.61194e+18,113.279,1067.72,4636,233,56,4134,4100,3980,3998,2388
49113,1408,2617,44373,4740,0,49113,3.55145e+18,366.389,6560.75,49113,542,302,46496,46435,43076,42252,28297
4824,363,403,652,4172,0,4824,1.93706e+13,60.3912,878.133,4824,183,45,4421,4421,4405,4421,4190
16946,21,1100,15866,1080,0,16946,2.28215e+18,490.813,2810.18,16946,313,174,11389,9396,7721,6956,2273
41268,9,13,40951,317,41268,0,9.78289e+13,12.559,401.242,41268,13,13,41229,41216,39569,39569,37342
25416,591,840,0,25416,5750,19666,5.92264e+15,229.644,2828.77,25416,370,104,24576,24528,24125,24031,14769
33369,1093,1184,0,33369,0,33369,1.16451e+18,580.872,3826.06,33369,329,209,32185,32185,32137,32158,31614
48361,2144,2495,44851,3510,0,48361,2.71332e+18,456.142,6784.05,48361,704,146,45866,45866,45719,45840,39554
12448,332,696,11145,1303,11145,1303,8.98606e+17,207.395,1758.6,12448,119,134,11752,11682,11389,11403,7217
16962,13,714,0,16962,0,16962,4.1289e+18,230.5,2093.91,16962,166,153,9065,6092,5578,2665,850
47402,1164,1665,47402,0,41576,5826,1.17536e+18,408.77,5300.36,47402,369,210,45737,45734,45437,45406,43849
13063,73,426,13063,0,13063,0,3.54727e+18,259.48,1736.91,13063,166,122,11092,9431,8422,5598,2706
7339,307,446,6566,773,6566,773,3.27042e+18,179.694,1147.41,7339,90,103,6893,6864,6626,6646,4950
34981,1469,2155,32263,2718,32262,2719,1.34388e+18,432.932,5352.35,34981,634,137,32826,32762,32730,32721,24068
26572,786,840,5870,20702,0,26572,2.21183e+13,282.555,2900.21,26572,310,114,25732,25726,25699,25717,24578
39190,230,1965,39190,0,35213,3977,1.83948e+18,285.396,4831.91,39190,285,303,36789,34968,31046,33650,10174
49175,484,1983,49175,0,44741,4434,7.68106e+17,843.626,6007.06,49175,652,209,45964,44628,39009,31064,13347
45387,1093,1572,40482,4905,0,45387,3.15753e+18,392.351,5212.97,45387,442,220,43815,43768,43165,43261,36957
1480,237,255,1324,156,1324,156,8.97882e+17,39.9709,450.551,1480,59,50,1225,1225,1225,1225,1197
34416,1084,2445,32014,2402,32014,2402,1.20265e+18,494.836,5244.62,34416,910,142,31971,31174,29460,30649,18621
49333,5042,9113,7011,42322,0,49333,6.69953e+12,10.0816,9829.82,49333,1206,18,40220,40220,36153,28590,27003
42282,189,884,42282,0,31813,10469,9.0013e+17,385.832,3226.65,42282,252,182,40016,38748,33402,32955,12242
30458,736,1223,28407,2051,28407,2051,6.83889e+17,618.558,3794.85,30458,366,222,29114,27925,28310,28208,23824
22040,5,500,22040,0,22040,0,3.48202e+18,261.097,2365.24,22040,190,132,10012,6630,5330,3278,1362
19810,675,1115,18474,1336,18474,1336,7.36534e+17,565.853,3077.03,19810,277,190,18604,17825,18091,18180,13863
599,4,7,599,0,599,0,8.17643e+13,6.47746,47.7904,599,7,7,578,570,498,498,561
37884,309,975,0,37884,8200,29684,4.66103e+15,395.017,3503.56,37884,293,208,36502,35646,34667,33851,18946
15904,107,514,15904,0,15904,0,3.4849e+18,267.303,1565.3,15904,514,26,14983,14881,9682,11100,3557
36053,1603,2134,32071,3982,32068,3985,1.25894e+18,278.45,4780.04,36053,442,259,33919,33919,33813,33916,22833
35566,3,13,35323,243,35566,0,1.03027e+14,10.7509,367.028,35566,12,11,34324,33683,32073,32861,24529
1699,158,317,1534,165,0,1699,3.59082e+18,73.528,561.39,1699,103,42,1382,1334,1351,1348,837
49779,15,32,48202,1577,49773,6,9.75349e+13,9.54621,548.142,49779,18,18,49742,49734,49016,49004,43571
27186,312,764,0,27186,6319,20867,7.20283e+15,212.183,2726,27186,275,128,26422,26283,22765,23168,10979
27661,345,1357,0,27661,7476,20185,1.5608e+16,177.601,3159.8,27661,254,147,26304,26183,25014,23568,18870
43427,1,8,43373,54,43427,0,3.57394e+13,6.99348,422.321,43427,8,8,18620,18620,18620,18620,18620
38790,1231,1645,34996,3794,0,38790,3.12803e+18,532.266,4728.18,38790,528,187,37145,36953,36654,36690,32614
30632,40,869,23108,7524,23108,7524,6.99033e+18,312.748,2663.08,30632,203,160,26075,14862,17509,13517,4510
34758,1,12,34661,97,33834,924,8.23745e+13,6.9212,380.314,34758,10,8,20199,20199,20199,20199,20199
5823,233,343,0,5823,1497,4326,7.52329e+15,97.1029,823.451,5823,65,85,5480,5459,5318,5353,4121
30899,329,1903,26649,4250,0,30899,4.76695e+18,456.94,4516.33,30899,490,206,27952,27047,23993,24643,6232
43208,2155,2257,0,43208,0,43208,1.33473e+18,502.23,6119.2,43208,731,143,40951,40951,40951,40473,37506
21615,1016,1931,15891,5724,0,21615,6.45761e+18,21.9668,2539.53,21615,651,647,19684,19684,13315,13687,18471
4184,254,613,3833,351,3833,351,2.65046e+18,101.085,1135.08,4184,191,83,3571,3525,3456,3069,1470
7015,778,908,6593,422,6593,422,7.64007e+17,128.82,1844.39,7015,218,93,6107,6107,6107,6107,5484
1612,120,155,452,1160,0,1612,6.09405e+13,30.379,358.384,1612,41,48,1457,1455,1455,1449,1239
15814,798,1014,13799,2015,13799,2015,3.43593e+18,229.193,2560.9,15814,212,127,14800,14800,14638,14472,13197
25689,591,840,0,25689,5697,19992,5.88075e+15,261.859,2857.1,25689,309,111,24849,24784,24048,24187,15746
25235,644,751,0,25235,6447,18788,6.84216e+15,383.221,2577.98,25235,456,102,24484,24344,24305,24311,22378
7532,161,329,1769,5763,0,7532,2.93043e+13,98.353,1118.79,7532,152,81,7203,7132,6359,6484,4566
20443,939,1504,19049,1394,19049,1394,1.1884e+18,312.541,3457.33,20443,446,123,18939,18925,18131,18262,13717
38059,444,646,38059,0,36382,1677,5.14585e+17,491.994,3347.1,38059,271,192,37185,36623,34112,26440,30279
3518,60,272,0,3518,767,2751,7.35457e+15,65.2322,733.355,3518,103,49,3145,2875,2649,2349,796
46061,19,41,0,46061,45994,67,9.50542e+15,6.89364,811.074,46061,23,12,46020,46018,44031,43914,30367
8713,91,608,1432,7281,0,8713,2.08394e+13,118.329,1556.26,8713,214,69,7953,7558,7308,4192,2716
21191,6,11,20176,1015,21191,0,9.63671e+13,10.6804,325.805,21191,11,11,20904,20708,19101,18403,16701
19646,1947,2957,18091,1555,18091,1555,4.56208e+18,14.2628,3705.85,19646,532,26,16689,16689,13630,9132,9303
42942,876,2387,39955,2987,39955,2987,2.1963e+18,529.776,5816.33,42942,717,142,40555,39481,39163,38719,20679
32280,615,1678,0,32280,0,32280,2.02802e+18,277.49,3810.29,32280,217,218,30602,30524,29193,18263,19942
20322,80,921,18028,2294,18028,2294,2.67927e+18,322.865,2867.67,20322,270,145,16652,15449,14405,12980,2859
29904,641,1189,27910,1994,0,29904,2.42003e+18,579.756,3622.44,29904,360,188,28526,27553,27478,27201,21427
29454,380,1036,6592,22862,0,29454,1.98681e+13,365.168,3358.41,29454,285,178,28170,27563,26397,15920,7897
29350,1522,2001,26960,2390,26960,2390,2.42252e+18,396.018,4708.45,29350,512,168,27349,27340,27159,27042,23359
12087,345,447,5324,6763,12087,0,5.78636e+18,239.134,1510.22,12087,264,82,11627,11376,11031,10721,10495
26641,425,543,0,26641,7405,19236,1.61343e+16,225.417,1891.84,26641,143,128,26098,26067,25938,25966,23538
11112,220,914,10426,686,10426,686,1.91093e+18,196.922,2079.79,11112,200,138,10079,9896,9461,9217,5572
