"data_size","cache_size","unique_size","reads","writes","avg_step","avg_reuse_dist","sum_sqrt_count","sum_count","lis","lds","belady","lru","pivot","ld","mru"
87799,3647,3980,57024,30775,2.92402e+13,695.508,12493.1,87799,1254,396,83819,83819,83819,83819,80629
38782,2640,2877,27562,11220,4.64886e+13,1081.75,8769.42,38782,1048,314,35905,35749,35406,35391,34728
7672,510,617,4473,3199,3.17925e+13,186.867,1337.51,7672,134,104,7055,7045,6827,6916,6337
62613,659,3661,42741,19872,4.52209e+13,1037.3,10560.3,62613,1188,426,56960,55708,39424,11447,10184
24542,221,1650,17651,6891,3.10043e+13,520.449,5017.71,24542,513,194,21735,19838,12296,4232,3954
28725,6763,13032,23507,5218,2.53077e+13,1081.88,17341.2,28725,3379,15,15693,13930,13095,14385,10125
14277,602,940,9249,5028,3.01732e+13,385.414,2606.13,14277,316,171,13337,13281,13159,13142,12431
34084,226,1160,21938,12146,2.91594e+13,508.629,4029.52,34084,395,260,30463,28474,26383,24636,13238
12536,1185,1568,8434,4102,2.20861e+13,304.792,3403.34,12536,550,152,10968,10968,10902,10964,9294
54625,1316,2315,35822,18803,3.63008e+13,553.928,6660.04,54625,548,334,52310,52290,47202,43965,25466
20835,1159,2817,15115,5720,6.23737e+13,992.878,6056.12,20835,901,245,17719,16428,11900,12458,11760
32950,1112,1885,19769,13181,3.16322e+13,340.155,4605.96,32950,415,223,31065,31015,25334,24216,18467
61370,258,2161,39863,21507,3.27631e+13,579.547,6641.49,61370,558,321,54910,50833,45346,5223,4369
10140,574,2361,7785,2355,6.88516e+13,362.303,3905.19,10140,492,174,7779,7447,3050,3242,1279
64988,1211,3573,46414,18574,3.92471e+13,1122.02,11992.4,64988,1226,369,60507,58040,51651,51520,32096
32960,465,3610,23895,9065,6.40597e+13,1217.2,8458.27,32960,1115,455,26570,25005,12991,9507,8107
47678,1089,3205,33724,13954,2.71683e+13,796.689,8819.13,47678,848,278,44415,42979,34347,31275,15723
91588,6601,16745,64399,27189,2.58574e+13,367.563,23819.7,91588,1862,313,74843,74791,61840,62820,60433
3543,706,737,2361,1182,5.1525e+13,197.649,1342.24,3543,247,88,2806,2806,2806,2799,2779
25932,712,2057,18829,7103,2.88896e+13,409.833,5476.44,25932,470,183,23875,23516,17276,18889,9693
84576,4002,4171,58321,26255,4.92911e+13,1309.56,13695.2,84576,1815,475,80405,80397,79819,77839,75952
32096,406,3221,27293,4803,4.21173e+13,17.8981,3908.84,32096,1614,1608,28875,28874,12016,21846,19556
22737,1028,1479,14538,8199,3.08591e+13,463.049,3988.19,22737,386,240,21258,21250,20328,20608,17847
94789,2908,2974,60037,34752,3.02596e+13,730.77,10246.5,94789,687,453,91815,91815,91800,91815,91562
6491,116,1012,4189,2302,2.97477e+13,222.813,1973.65,6491,257,166,5134,4772,4070,3543,1264
17111,912,1582,10054,7057,3.18418e+13,249.996,2940.05,17111,360,139,15529,15529,15419,15516,15222
33810,762,1132,21733,12077,2.84179e+13,495.577,3968.37,33810,414,261,32678,32630,30771,30537,29263
19531,686,907,12616,6915,2.89529e+13,464.789,2919.41,19531,334,209,18624,18524,17946,17922,17432
52749,396,3428,37708,15041,3.88673e+13,940.567,10552.4,52749,1013,335,45885,43751,27231,18227,5021
13063,503,1271,8603,4460,3.83429e+13,370.883,2962.06,13063,385,185,11771,11133,10067,2449,2806
19905,2164,2489,13683,6222,4.01727e+13,846.78,5848.93,19905,803,245,17416,17383,17075,17185,16905
54474,1971,2103,35060,19414,2.95402e+13,596.509,6801.76,54474,549,336,52371,52371,52281,52323,52239
26381,966,2975,19437,6944,6.63733e+13,1233.01,7076.67,26381,909,263,22209,20751,12274,13596,6981
98174,3540,4412,70070,28104,4.53309e+13,1651.72,16417,98174,1887,580,93762,93534,90487,83982,84885
3690,137,686,2460,1230,5.07321e+13,208.301,1315.72,3690,243,76,2698,2264,1939,1817,467
69154,2978,3611,49737,19417,4.1264e+13,1245.88,12520.9,69154,1321,388,65543,65530,61571,61577,60962
25898,287,1099,16733,9165,3.00074e+13,517.831,3596.03,25898,356,234,23529,21810,20475,18727,11937
31888,657,1714,20488,11400,3.00114e+13,542.878,5147.26,31888,478,282,30101,29436,26701,26251,16673
10196,572,748,6600,3596,2.9456e+13,363.406,2025.16,10196,296,168,9448,9176,9099,8791,8315
35536,2085,2543,22960,12576,2.8637e+13,403.886,6537.99,35536,977,190,32993,32992,32763,32985,30300
70923,1093,2520,45725,25198,2.94396e+13,610.558,8260.67,70923,604,385,68403,68307,62708,61384,46859
15757,2886,6269,12787,2970,1.70991e+12,88.9963,6994.23,15757,594,98,9488,9487,4633,8642,4857
17699,205,923,11344,6355,2.8721e+13,493.558,2815.71,17699,382,192,15404,14544,13373,12846,6512
57745,338,3622,39639,18106,2.81981e+13,731.42,10014.5,57745,964,282,51146,48130,31717,15647,7333
93216,1111,4519,66587,26629,4.47362e+13,1739.62,15843.4,93216,1685,612,85199,80547,56893,49713,22817
7480,445,765,6358,1122,4.22173e+13,16.9556,1084.77,7480,386,381,6715,6715,4822,5921,5774
60549,605,4119,42770,17779,5.66158e+13,1415.51,12252.8,60549,1698,462,51560,48596,30827,20862,11109
38103,1318,2718,25618,12485,2.78944e+13,501.198,7229.84,38103,949,235,35385,35262,32742,29129,15074
15305,104,1208,10942,4363,2.35194e+13,514.448,3593.98,15305,682,126,9273,4472,4706,3162,3495
89936,314,770,61012,28924,3.35877e+13,304.787,5164.41,89936,313,274,89166,87095,62011,57500,51099
63888,1298,2183,41182,22706,2.93003e+13,549.969,7312.62,63888,592,353,61705,61696,59552,58509,50245
25906,1613,2062,16071,9835,2.78118e+13,310.121,4718.58,25906,727,145,23844,23844,23747,23842,21938
26592,802,3409,18741,7851,5.96857e+13,657.796,7312.84,26592,891,414,22668,22032,14878,8665,8295
54290,2341,3776,38986,15304,5.5174e+13,1495.96,11384.7,54290,1459,474,50514,47988,40374,41791,40724
22589,27,2139,14756,7833,2.61717e+13,317.347,4922.46,22589,736,176,12076,9129,5805,1887,790
96256,3109,4883,64238,32018,3.77024e+13,1320.72,15750.9,96256,1429,475,91373,90896,86675,87668,70220
41572,573,1524,26970,14602,3.12836e+13,559.874,4899.02,41572,480,289,39887,37854,33954,28861,11050
20096,714,1001,12980,7116,2.96448e+13,443.429,3048.38,20096,335,214,19095,19050,18229,17759,17323
72439,3323,3894,52215,20224,5.01407e+13,1658.56,13331.8,72439,1496,549,68545,68341,66117,66468,66159
32730,902,1604,21115,11615,2.9295e+13,519.858,4842.01,32730,488,286,31126,30898,28878,27114,17031
67177,3683,3768,45486,21691,3.08329e+13,816.967,11202.2,67177,1138,285,63409,63409,63409,63409,62978
78080,801,3991,51632,26448,3.76837e+13,1051.3,11048.6,78080,1012,432,73262,72240,56689,9853,8766
34340,936,1813,24753,9587,2.99605e+13,633.136,5977.13,34340,627,225,32436,31587,28013,29504,21330
57549,404,2180,36996,20553,2.94268e+13,580.52,7153.24,57549,566,355,53896,49788,46176,44632,19760
78591,3959,3987,52709,25882,3.17946e+13,975.634,12640.9,78591,1232,307,74604,74604,74604,74604,74435
20983,159,1529,13136,7847,3.04113e+13,382.843,3888.99,20983,321,241,18156,16618,14003,9252,1826
44683,1063,2656,31881,12802,3.1515e+13,836.859,8347.03,44683,925,236,41857,40168,38155,39083,26005
55723,1937,3453,39779,15944,4.19451e+13,1137.16,11093.4,55723,1177,347,52270,50863,46946,45295,37682
93003,1849,4045,61104,31899,2.97463e+13,757.657,13033.8,93003,1254,406,88958,88563,84890,83779,53199
31505,9457,13744,25576,5929,2.63354e+13,2829.16,18757.5,31505,3127,13,17761,16001,16866,17081,10425
48446,1823,2091,29828,18618,3.10489e+13,516.764,6220.29,48446,429,329,46355,46272,45285,45672,44145
18813,450,930,10994,7819,3.22848e+13,272.301,2297.62,18813,279,141,17883,17706,15146,14481,13349
34145,1963,2917,24306,9839,4.99132e+13,1390.14,8341.67,34145,1139,312,31144,29313,25795,26954,24040
7469,54,710,4759,2710,2.86975e+13,304.501,1731.59,7469,264,143,5180,3466,3963,3086,969
69260,2481,2544,44579,24681,2.95508e+13,605.217,8266.47,69260,594,399,66716,66716,66697,66716,66562
99281,1239,4829,66092,33189,3.23374e+13,1214.75,15589.1,99281,1409,453,93550,91406,70941,63702,31015
5371,699,1063,3723,1648,1.63711e+13,408.089,2020.79,5371,434,108,4308,4277,3149,3669,3063
57065,514,3834,40286,16779,5.44013e+13,1251.96,11055.5,57065,1322,465,49301,46233,28376,11368,6005
91795,2873,4386,65446,26349,4.69964e+13,1619.24,15866.9,91795,1803,565,87409,86780,74670,68217,68784
69167,1751,2474,44711,24456,3.05636e+13,580.418,7753.99,69167,574,358,66693,66640,65346,65055,59976
73105,1284,4222,50808,22297,3.56267e+13,1103.66,13076.8,73105,1114,407,68346,66348,54325,47667,21588
30702,1362,1942,20403,10299,4.22395e+13,478.16,5070.98,30702,441,259,28760,28749,27257,25770,18721
58613,180,3333,39721,18892,2.91157e+13,668.561,9387.04,58613,1035,278,50070,40890,30147,9409,5886
49029,271,2060,31912,17117,3.32712e+13,535.528,5983.76,49029,468,309,44031,40569,36933,4389,3425
52478,1124,2064,33883,18595,2.96956e+13,582.506,6726.43,52478,544,334,50414,50379,47856,47058,38734
54505,1861,1961,35138,19367,2.90457e+13,536.328,6425.36,54505,538,327,52544,52544,52409,52346,52153
75219,3844,4260,49478,25741,3.3799e+13,984.219,12457.9,75219,1134,302,70959,70956,70959,70959,68251
11072,5229,6069,9698,1374,8.70496e+11,14.7739,6282.42,11072,754,47,5003,5003,4411,4999,4366
5365,349,856,3164,2201,3.2368e+13,142.153,1385.29,5365,199,76,4509,4484,4358,4357,3955
27218,716,1122,17500,9718,2.91372e+13,530.143,3686.12,27218,395,249,26096,25945,24472,23803,22693
35917,1062,1706,23217,12700,2.98069e+13,498.555,5323.84,35917,419,298,34211,34193,32922,32170,26037
78951,3792,4289,56164,22787,4.9582e+13,1365.69,14455.1,78951,1747,531,74662,74646,73955,66531,67753
72452,1750,3535,45142,27310,2.9609e+13,751.52,10052.9,72452,886,407,68917,68585,61245,49791,44875
21733,351,1011,13950,7783,2.91148e+13,485.995,3198.7,21733,386,229,19948,18390,17608,16905,12686
69271,1866,3731,46796,22475,4.23391e+13,1077.29,10795.4,69271,1143,431,65324,63465,52617,17951,27173
18635,454,1445,11325,7310,3.08778e+13,238.417,3392.93,18635,261,203,17190,17112,13228,7253,5831
87970,2449,2479,56706,31264,2.93261e+13,594.477,8767.7,87970,681,381,85491,85491,85490,85484,85464
77755,1566,4335,53713,24042,3.6203e+13,1121.27,13564.6,77755,1167,409,73132,71534,64332,56289,32118
42342,475,1244,27356,14986,2.95684e+13,541.246,4549.47,42342,464,275,40532,37591,35665,33762,23736
27883,692,1663,17648,10235,3.04867e+13,446.636,4537.03,27883,381,256,26208,25788,22743,18316,18166
97887,2192,3497,63204,34683,3.28623e+13,900.009,11100.6,97887,772,443,94390,94021,90258,85891,73430
40550,758,1244,26209,14341,2.99934e+13,552.203,4485.58,40550,438,276,39306,39166,36556,34720,33296
3066,313,1243,2349,717,2.35064e+13,143.04,1743.21,3066,361,96,1776,1526,1072,556,414
21902,926,2801,15877,6025,5.80631e+13,1149.87,6277.93,21902,947,244,18294,17016,12000,11396,8644
38251,768,2802,23267,14984,2.94533e+13,422.996,6266.43,38251,862,193,35449,35222,25660,16864,10112
15040,774,2645,11123,3917,6.12059e+13,759.989,5155.51,15040,689,160,12093,11518,6311,6271,3289
31665,2977,3556,22730,8935,5.96659e+13,1091.21,8296.31,31665,1051,410,28109,28053,27085,22123,22648
40436,1084,1690,25977,14459,2.91315e+13,548.544,5153.97,40436,517,272,38746,38744,38238,38220,37279
71218,2504,3807,46589,24629,2.96633e+13,654.269,11040.7,71218,1237,334,67411,67240,66714,67094,45530
88556,1778,4453,62311,26245,4.1187e+13,1565.93,15141.7,88556,1514,460,83181,79719,70007,68604,44150
94381,6519,24638,77557,16824,2.31074e+13,5250.48,40875.6,94381,7796,25,67151,50248,55646,60621,28314
12245,360,1878,8511,3734,3.81309e+13,383.279,3969.45,12245,538,138,10031,9591,8087,8199,5571
37332,837,3648,26673,10659,5.98147e+13,1155.61,8996.33,37332,1215,442,32002,30497,19108,12276,11538
39852,1268,2712,24925,14927,2.90238e+13,353.072,6496.72,39852,969,175,37140,37132,35903,34789,26486
57795,1082,3868,40818,16977,5.41553e+13,1325.11,11329,57795,1420,457,51733,48996,32779,19955,17502
64091,753,2640,39771,24320,3.06804e+13,604.909,8173.54,64091,527,399,61274,60447,48577,33538,23590
50727,674,1895,32596,18131,2.90672e+13,522.991,6150.52,50727,500,317,48832,48383,43009,42861,35117
62355,32,2036,40348,22007,3.01173e+13,543.413,6761.89,62355,513,325,36058,20762,24169,13696,3839
74877,14375,21851,60840,14037,2.48514e+13,6102.88,35137.8,74877,6651,25,53026,53026,47978,49413,42823
86851,2965,4300,58169,28682,3.26911e+13,1099.2,13618.3,86851,1338,368,82551,82068,81345,80228,70394
61310,599,2580,38354,22956,3.02973e+13,625.376,7971.31,61310,521,398,58332,57348,45944,35318,21190
17955,625,2569,13525,4430,7.17255e+13,778.132,5453.65,17955,660,260,14655,14124,8790,8059,7442
68222,451,3672,49189,19033,4.56287e+13,1535.2,12703,68222,1343,386,58596,55551,33702,31106,10431
82489,2665,3942,54402,28087,3.76587e+13,1124.68,11476.1,82489,1039,422,78547,78176,72384,22410,30454
37554,770,1234,24147,13407,2.89013e+13,555.025,4340.75,37554,461,281,36320,36190,33754,33751,31225
6004,374,938,4258,1746,3.38288e+13,367.24,2038.09,6004,385,87,4917,4644,3101,2678,1591
25858,181,1071,16618,9240,2.9423e+13,503.879,3505.74,25858,396,236,22305,20885,18651,17273,7608
62579,2963,3715,43442,19137,3.14626e+13,966.366,11391.6,62579,1047,304,58864,58775,58863,57913,53531
41492,2504,2780,25943,15549,2.9718e+13,373.095,6734.63,41492,1059,177,38712,38712,38618,38712,37701
3894,319,573,2510,1384,2.90218e+13,150.325,1154.05,3894,141,100,3321,3198,3116,2994,2765
92620,3478,3542,58089,34531,2.96848e+13,956.89,11173.3,92620,744,458,89078,88931,89078,89078,89010
27516,1045,1604,17777,9739,2.95934e+13,489.483,4491.71,27516,434,264,25912,25898,24778,23741,18074
45911,1583,1637,29872,16039,3.19564e+13,574.218,5255.37,45911,510,302,44274,44274,44247,44237,44070
35635,1206,1650,23011,12624,2.98181e+13,517.448,4877.8,35635,448,269,33985,33981,33782,33754,32831
33420,1667,1675,21598,11822,2.97639e+13,471.502,5018.67,33420,427,287,31745,31745,31745,31745,31737
20508,691,1053,13256,7252,3.01053e+13,511.284,3159.94,20508,320,230,19455,19046,18537,18295,17915
82250,2628,4288,59139,23111,4.8809e+13,1696.58,14855.1,82250,1706,561,77834,76428,63724,65227,60233
60746,2776,3507,43818,16928,4.45069e+13,1265.43,11695.5,60746,1235,369,57239,57164,50967,52583,51388
58228,2506,3517,41946,16282,4.8625e+13,1404.03,11539.7,58228,1222,383,54711,54337,45775,48087,44292
41934,266,1822,27077,14857,2.93932e+13,527.807,5416.99,41934,472,284,37664,34630,32566,31112,15449
97840,3292,9779,83200,14640,4.21138e+13,17.6101,10993.1,97840,4892,4887,88061,88060,49165,71850,68622
6066,449,669,3923,2143,2.9512e+13,299.059,1552.95,6066,245,134,5397,5092,5084,4867,4487
90797,3146,3196,59149,31648,3.3661e+13,750.083,10061.8,90797,712,389,87601,87601,87574,87513,87170
37315,1822,3735,27321,9994,6.77312e+13,1246.38,9120.14,37315,1203,450,33173,30928,23318,21730,24533
19028,410,2862,13855,5173,5.91693e+13,1154.08,6001.54,19028,836,235,14552,13443,6910,5964,3900
13706,698,1357,8604,5102,3.11983e+13,244.84,3050.64,13706,292,186,12349,12325,10953,9756,7715
72569,1279,2719,45887,26682,2.98895e+13,638.721,8871.44,72569,575,420,69850,69652,61836,51851,44107
41613,1892,3242,29619,11994,5.76339e+13,1555.13,9340.19,41613,1418,272,38093,34896,28949,29333,29716
71274,483,3650,45115,26159,2.98837e+13,599.615,10187.8,71274,1083,329,66548,62911,49417,32072,24609
26087,411,1786,17347,8740,4.02826e+13,439.267,4523.9,26087,403,233,23874,22193,18955,4050,3250
74074,2168,4044,50414,23660,3.1702e+13,1037.37,12574.1,74074,1167,340,70030,69654,67528,67136,48427
55892,1649,3537,39909,15983,4.04913e+13,1068.7,11111.8,55892,1091,353,52191,50672,46355,45004,36847
23541,2400,11829,18437,5104,1.20498e+11,442.008,15829.6,23541,2090,29,11712,10910,10766,3624,731
56728,202,2046,36637,20091,2.96862e+13,550.029,6914.66,56728,543,361,49861,46216,41058,36816,11188
28763,757,3345,19591,9172,4.92026e+13,589.278,7339.98,28763,906,392,25129,24546,16792,6535,4439
36908,2077,3078,26516,10392,5.80181e+13,1439.52,8794.25,36908,1155,323,33696,31455,25232,26678,27003
21370,197,1526,13272,8098,3.12014e+13,285.739,3809.33,21370,327,218,19142,17504,14374,8353,5372
65028,1017,2652,42588,22440,3.52311e+13,570.426,7497.4,65028,608,326,62376,62300,54191,10477,13632
42160,3693,3828,30413,11747,6.30389e+13,1247.51,9871.87,42160,1291,450,38332,38330,38191,37830,37127
75200,1158,2819,48221,26979,2.98659e+13,615.985,9017.51,75200,670,423,72381,72251,65547,61857,48587
80427,1463,2893,51312,29115,2.98102e+13,669.535,9423.96,80427,647,439,77534,77374,71244,64080,53304
56455,1807,3574,36331,20124,2.90596e+13,535.55,9348.32,56455,1194,247,52881,52840,52012,52327,31705
32816,1852,2486,21591,11225,2.85731e+13,468.701,6445.94,32816,947,197,30330,30330,29901,29005,26174
52405,2013,3437,36561,15844,2.79577e+13,770.91,9459.94,52405,920,281,48968,48873,47730,48535,36004
18138,684,883,11729,6409,2.92827e+13,448.908,2776.89,18138,331,197,17255,17159,16611,16347,16294
5768,1048,1385,4355,1413,8.27587e+13,158.011,2293.88,5768,233,125,4383,4383,4376,4383,4052
59989,3621,3971,42262,17727,5.38316e+13,1322.5,11680.3,59989,1515,459,56018,56015,55356,53886,48952
37741,1606,3637,27039,10702,5.99721e+13,1158.26,9030.76,37741,1234,445,33686,31709,21977,18730,19409
74585,1522,4229,51942,22643,3.71239e+13,1211.66,13405.9,74585,1231,411,69919,67673,60595,52562,33344
49426,418,3324,35270,14156,5.19825e+13,1428.81,10354.1,49426,1407,340,40417,37813,24789,21776,10674
91775,16637,24266,75323,16452,2.57552e+13,5325.4,39608.3,91775,8451,26,67509,67509,61762,61663,55798
88161,1350,3956,58034,30127,2.9736e+13,749.934,12664,88161,1255,405,84205,83461,68696,59978,34497
37542,1200,3021,25240,12302,4.11492e+13,597.581,6963.21,37542,761,323,34521,34208,25479,6214,5166
83422,269,4131,55197,28225,2.92745e+13,790.058,12561.9,83422,1245,367,75127,70401,47409,16761,7940
28841,519,1729,17478,11363,3.14819e+13,315.488,4320.56,28841,358,236,27112,26915,20077,10145,7954
62440,3504,3914,43709,18731,5.21504e+13,1236.78,11576.4,62440,1401,460,58526,58420,57326,51096,45632
15405,956,2435,11603,3802,6.9658e+13,595.137,5003.18,15405,636,223,12827,12277,10182,9364,8489
93252,1158,4252,60720,32532,2.96131e+13,821.566,13401.4,93252,1268,429,88924,87769,70380,46269,33735
30734,300,2388,21310,9424,2.72145e+13,564.028,6387.01,30734,846,236,26189,24154,16162,8551,3863
32688,677,1861,19588,13100,3.15928e+13,350.225,4611.59,32688,410,244,30827,30688,22886,10680,8009
86683,767,4032,57395,29288,3.86842e+13,1163.94,12056.2,86683,1115,431,81320,80138,63097,12032,16136
14177,2390,2645,10058,4119,6.36708e+13,514.228,4945.99,14177,639,359,11532,11497,10724,11146,10395
50184,2289,3038,31947,18237,2.94423e+13,480.893,7995.5,50184,1176,207,47146,47143,46773,47090,41291
46877,2523,2775,32708,14169,2.87527e+13,577.577,8003.07,46877,900,277,44102,44102,44075,44102,41492
84493,1229,4252,60360,24133,4.25114e+13,1593.27,14674,84493,1590,439,78028,73813,57360,49444,30066
50236,769,1380,32432,17804,2.91353e+13,576.847,5026.61,50236,496,303,48856,48647,44937,43169,39843
45274,746,1958,29185,16089,2.97426e+13,546.099,6244.84,45274,483,334,43316,42771,38590,38368,27618
80634,1078,4275,56863,23771,3.89332e+13,1322.57,14154.2,80634,1403,428,74240,70705,53028,43778,16889
83614,1204,2762,53650,29964,3.00377e+13,647.652,9355.38,83614,653,421,80852,80703,73893,68688,55569
34940,835,2447,24592,10348,2.76871e+13,580.763,6796.03,34940,848,260,32283,31667,21811,15936,7216
10161,118,770,6520,3641,2.89201e+13,358.219,2042.25,10161,250,171,8451,7790,6775,5713,1242
86917,3399,4260,60502,26415,4.77726e+13,1336.48,14689.7,86917,1808,529,82657,82492,78181,57076,63245
65079,2413,3977,45938,19141,3.51934e+13,1066.68,12151.5,65079,1065,394,61102,60933,57938,57022,47691
69044,4205,6909,58709,10335,4.21231e+13,17.0444,7925.74,69044,3457,3452,62135,62135,45945,55385,53202
4001,791,1496,3015,986,3.71121e+13,131.542,2191.57,4001,414,100,2505,2501,2110,2204,1813
18287,911,2085,11841,6446,2.65183e+13,289.983,4436.79,18287,675,155,16202,16191,14086,14468,8753
80772,444,4092,51466,29306,2.95255e+13,719.502,11930.2,80772,1191,396,74763,70535,53798,36635,13580
13733,533,1208,8761,4972,3.0402e+13,280.21,2905.31,13733,302,192,12525,12454,11566,10514,9424
70335,2021,2712,44192,26143,3.01571e+13,629.699,8664.52,70335,545,415,67623,67501,62896,63827,55064
25865,1085,1566,18618,7247,2.62074e+13,621.269,5058.84,25865,751,195,24299,23722,23632,23663,20225
72948,1846,4112,50907,22041,5.15905e+13,1375.04,13211,72948,1708,516,68246,63958,49804,34805,35861
15083,813,1745,9959,5124,2.41949e+13,295.517,3784.73,15083,583,153,13338,13309,11133,11696,6589
10646,464,2292,7954,2692,7.32062e+13,273.607,3829.74,10646,413,302,8354,7934,2779,2123,1110
35691,1228,1879,21976,13715,3.1174e+13,402.245,5161.95,35691,378,278,33812,33806,29710,30113,22336
8929,34,348,6035,2894,3.31145e+13,254.999,1512.36,8929,215,117,3462,1693,1583,1941,1435
56502,2908,3042,38006,18496,2.937e+13,598.545,8869.75,56502,1054,272,53460,53378,53454,53460,52071
39495,974,1736,25384,14111,2.907e+13,520.046,5364.73,39495,483,289,37759,37677,36651,36042,32763
79205,2690,3510,49319,29886,3.02401e+13,880.716,10187.7,79205,681,447,75695,75517,75597,75669,74352
94831,584,4443,65205,29626,3.81376e+13,1323.15,15186.2,94831,1441,430,85155,80602,55414,34902,21874
56883,795,2043,36670,20213,2.96523e+13,557.7,6677.43,56883,570,337,54840,54582,48866,49408,40843
11810,562,791,7606,4204,2.85881e+13,415.965,2210.77,11810,312,173,11016,10461,10435,10075,9424
28904,830,1656,18629,10275,2.95166e+13,496.8,4838.31,28904,473,283,27248,26957,24932,24384,17360
53932,1942,3052,38955,14977,4.7997e+13,1272.73,10617.9,53932,1174,348,50550,48386,42237,43256,39616
67294,169,2220,43364,23930,2.93354e+13,577.023,7584.81,67294,568,370,58212,54573,47231,39438,8142
22063,864,980,14135,7928,2.92278e+13,511.396,3194.56,22063,393,223,21083,21082,20858,20828,20821
3419,856,916,2492,927,7.66824e+13,104.56,1479.19,3419,141,100,2503,2501,2501,2503,2365
85441,1494,2530,55130,30311,2.97643e+13,605.118,8779.11,85441,664,394,82911,82894,79111,78042,65221
38188,1190,3573,26954,11234,5.53638e+13,1049.6,8950.69,38188,1155,414,33848,32145,21261,13070,12128
71289,2852,3586,46933,24356,3.69303e+13,842.004,9971.14,71289,992,395,67703,67696,63937,50608,30637
77010,2828,4072,51063,25947,2.91883e+13,805.234,11895.1,77010,1228,329,72938,72637,72723,72564,59364
7559,619,665,4856,2703,2.79649e+13,306.22,1689.14,7559,225,151,6894,6891,6838,6812,6808
47284,1008,3056,33175,14109,2.80716e+13,658.131,8421.6,47284,878,276,44102,43125,33870,27299,10883
82129,2518,3891,56493,25636,4.66537e+13,1269.72,12688.3,82129,1443,480,78238,76811,68761,35903,49543
18797,230,1484,13571,5226,2.79866e+13,642.287,4344.47,18797,548,184,15932,14659,8343,3133,4813
60270,2045,3780,41533,18737,4.92112e+13,1143.45,10856.8,60270,1354,458,56379,53930,43413,23112,28878
69450,750,3451,45723,23727,3.54238e+13,958.514,9255.42,69450,800,333,65509,64845,50778,7316,6124
75299,3179,7534,64027,11272,4.213e+13,17.041,8596.14,75299,3769,3765,67765,67765,41665,56886,52501
26048,841,2889,19086,6962,6.51693e+13,1118.59,6894.85,26048,992,257,22044,20733,15347,13149,11193
23723,891,991,15291,8432,2.93423e+13,503.236,3305.75,23723,391,227,22732,22732,22551,22551,22495
73871,1856,2677,47639,26232,3.02417e+13,609.133,8702.57,73871,656,418,71194,71169,69188,66570,65227
24596,1203,1678,16387,8209,4.07903e+13,435.092,4291.39,24596,376,232,22918,22905,21762,20557,16084
36174,402,1929,22284,13890,3.0956e+13,420.327,5260.19,36174,372,279,33850,32498,25383,15421,11340
65869,2059,3609,44014,21855,4.14493e+13,856.532,10004.5,65869,999,424,62260,61237,50596,15708,21989
31065,391,3591,22347,8718,6.15842e+13,1100.71,8239.46,31065,1136,403,25048,22873,12130,8323,6194
45515,638,2935,32302,13213,3.43901e+13,803.926,8996.09,45515,919,240,41448,39302,30182,29935,9987
84979,3220,4368,60793,24186,4.89288e+13,1718.03,15281.1,84979,1850,558,80611,80148,73844,69104,70322
41646,580,2675,29968,11678,2.7498e+13,723.615,7598.61,41646,808,257,38147,35509,21346,9226,5112
14274,715,988,9200,5074,2.98448e+13,400.992,2658.71,14274,303,184,13286,13027,12838,12186,12616
31630,1426,1671,20393,11237,2.99578e+13,486.505,4983.99,31630,433,288,29959,29959,29651,29528,28854
67772,1210,2546,43743,24029,2.98838e+13,619.632,8250.8,67772,608,391,65226,65131,60813,58069,44952
17322,815,881,11199,6123,2.95254e+13,438.328,2763.24,17322,317,206,16441,16439,16371,16368,16286
68038,2720,4174,48484,19554,5.28542e+13,1408.01,13334.3,68038,1661,526,63864,63560,56540,52082,52835
43292,2093,2955,31038,12254,4.76561e+13,1276.91,9428.86,43292,1147,331,40303,38379,34290,35664,34056
21403,622,2594,15079,6324,5.29092e+13,910.359,6245.83,21403,813,269,17653,16563,12175,11247,5367
44707,951,1339,28805,15902,2.89047e+13,557.479,4775.84,44707,436,298,43368,43364,41511,41393,39920
9980,885,1717,7306,2674,7.48652e+13,243.538,3347.44,9980,369,151,8263,8114,7832,7620,5710
77086,2372,4219,51182,25904,2.89645e+13,866.621,12047.3,77086,1224,294,72867,72545,71506,72335,43704
26421,625,2080,16118,10303,2.82857e+13,318.222,4613.41,26421,732,155,24341,24217,20982,21404,15998
22407,127,424,15189,7218,3.35366e+13,291.183,2455.3,22407,267,183,17296,10324,11124,10576,11489
32818,472,2216,23733,9085,2.80654e+13,561.57,6435.02,32818,585,211,30137,29283,18733,17887,9533
6296,408,1474,4637,1659,7.08102e+13,206.233,2349.23,6296,308,262,4822,4374,1855,1899,1337
75657,3649,3932,48761,26896,2.91845e+13,641.796,11553.5,75657,1249,364,71725,71725,71725,71725,70073
11048,753,979,7171,3877,3.05219e+13,350.354,2356.97,11048,330,154,10069,10028,9910,9973,9772
81526,1066,4047,51517,30009,2.93419e+13,772.095,11765.3,81526,1083,415,77385,76682,63374,41627,31361
14989,1478,2810,10957,4032,6.6371e+13,453.314,5216.7,14989,666,241,12179,11887,10900,11127,8167
57157,961,2108,36915,20242,3.00987e+13,527.302,6785.81,57157,558,323,55049,54961,50665,51321,43394
80270,1653,3781,54262,26008,4.2492e+13,1181.95,11755,80270,1363,465,75921,73577,58281,21178,27740
83766,452,3964,54493,29273,2.9658e+13,668.419,12173.9,83766,1250,383,77759,73805,54266,35168,19927
46592,2801,3407,31153,15439,4.18107e+13,695.693,8570.21,46592,930,397,43185,43183,41038,33017,21368
1358,192,215,876,482,2.41449e+13,70.6664,442.068,1358,71,51,1143,1143,1141,1141,1116
19036,360,957,12288,6748,2.91734e+13,469.376,2936.43,19036,346,208,17490,16267,15527,14964,8707
15261,1173,1376,9665,5596,3.10451e+13,275.411,3230.31,15261,332,201,13885,13884,13638,13765,12565
78229,147,3896,51969,26260,3.10259e+13,867.617,11895.6,78229,1303,292,64306,52919,39399,10569,6747
7600,1167,1480,4705,2895,2.74403e+13,169.636,2352.66,7600,303,109,6120,6120,6062,6120,6002
48102,224,3415,30117,17985,2.89312e+13,427.995,8194.05,48102,1039,234,42404,38392,27408,7137,4206
13126,444,966,8429,4697,2.88745e+13,425.239,2565.16,13126,332,182,12043,11586,11287,10836,9207
21270,1076,2144,18079,3191,4.22173e+13,16.9845,2694.9,21270,1075,1070,19126,19126,12744,16462,15941
48875,863,1968,31469,17406,2.91348e+13,555.864,6383.95,48875,512,339,46907,46624,42847,42330,30648
26759,735,3399,19559,7200,6.65658e+13,1181.5,7516.86,26759,935,423,21927,20909,10149,9873,7020
68158,137,3442,42312,25846,3.01259e+13,731.011,9319.07,68158,713,392,58730,53498,42837,22960,7632
93397,16173,24532,76680,16717,2.34707e+13,5353.41,40559.6,93397,7799,26,68865,68865,63937,60812,55228
65595,145,3599,47373,18222,4.44611e+13,1256.77,12267.8,65595,1327,375,50270,40708,27469,12503,1924
50078,486,1827,32128,17950,2.86542e+13,547.21,5807.69,50078,520,303,47531,44127,41113,40019,26467
92159,126,3866,62406,29753,4.36452e+13,1228.77,12640,92159,1379,466,73145,64792,48841,9664,4536
63346,2420,3726,43305,20041,3.07969e+13,806.426,10943.4,63346,1095,285,59620,59566,58862,59303,45411
11551,250,776,7506,4045,3.02403e+13,370.604,2165.01,11551,290,162,10253,9563,9182,8771,5989
93804,408,3947,63893,29911,4.41685e+13,1265.85,13106.6,93804,1421,474,83227,76595,57751,13785,8593
84022,1475,4230,58554,25468,4.79194e+13,1330.19,14439.9,84022,1787,529,78144,73860,58542,36677,33249
41641,714,1706,26795,14846,2.85721e+13,516.201,5413.73,41641,462,297,39935,39553,36668,36663,31186
16959,820,1068,12347,4612,3.17643e+13,203.461,3385.81,16959,354,150,15891,15891,15554,15795,13415
46212,1011,3293,32840,13372,3.83833e+13,921.881,9657.58,46212,984,309,42327,40241,36009,35251,17524
94537,21851,25066,77284,17253,2.66121e+13,5905.51,40786.6,94537,8518,27,69471,69471,66827,67543,68031
3304,576,703,2377,927,1.78558e+13,359.044,1350.57,3304,441,65,2582,2160,2414,2436,2427
24533,1574,2054,17770,6763,2.96761e+13,416.469,5308.58,24533,466,182,22479,22478,22281,22425,21216
21681,1651,2678,15212,6469,5.87729e+13,998.776,6321.29,21681,896,238,19003,18027,14323,14515,14877
43243,2358,3293,30877,12366,5.6422e+13,1490.87,9578.98,43243,1371,331,39950,38116,35260,35567,35076
86108,1249,4111,54921,31187,2.93875e+13,740.263,12463.9,86108,1192,392,81997,81474,68324,46195,39740
33913,1784,2446,23795,10118,2.77234e+13,575.837,6715,33913,851,255,31467,31465,30724,31251,24829
73087,1143,2810,45411,27676,3.04388e+13,645.829,8897.66,73087,564,430,70277,69915,58673,40290,33790
49027,910,2930,32430,16597,2.88336e+13,491.643,8146.23,49027,1045,255,45972,45370,38817,30123,19665
39629,1984,3443,29115,10514,6.56377e+13,1528.17,9088.06,39629,1152,459,35975,32537,25238,27231,27396
56606,138,2523,35691,20915,3.04146e+13,565.752,7655.15,56606,552,385,48676,44938,37308,24810,7704
20887,729,1880,14948,5939,2.93967e+13,468.729,4841.95,20887,574,156,18853,18431,17899,18052,13156
61352,1753,2178,39551,21801,2.94402e+13,548.205,7236.23,61352,534,355,59174,59174,58238,57998,55355
50155,1867,3282,35595,14560,3.57261e+13,930.847,10019.3,50155,998,303,46873,46293,45098,43578,37996
1622,91,248,1032,590,2.53339e+13,82.2189,508.813,1622,80,55,1361,1163,1177,1189,799
52341,1281,3396,37510,14831,5.14547e+13,1354.05,10777.6,52341,1307,350,47482,44289,36128,33410,26090
24412,410,1601,14525,9887,3.18032e+13,293.907,3599.18,24412,341,175,22811,22475,15328,4576,3110
26113,2658,2853,17952,8161,4.88658e+13,496.283,6377.29,26113,742,325,23260,23260,22921,22538,21049
39170,618,1306,25170,14000,2.91534e+13,570.873,4504.94,39170,461,271,37820,37008,33399,32444,28401
29668,205,1108,19082,10586,2.8818e+13,509.575,3762.03,29668,405,245,26048,24272,22253,19848,10453
97686,243,4374,69274,28412,4.58826e+13,1623.87,16348.1,97686,1876,570,80899,72906,46368,20862,8564
10171,498,702,6552,3619,2.82546e+13,319.964,1927.43,10171,257,148,9446,9011,9062,8855,7861
33932,502,2237,24298,9634,2.7612e+13,632.277,6444.15,33932,799,242,30570,28203,17282,7572,3372
12677,80,1285,8185,4492,2.98413e+13,323.02,2965.58,12677,316,199,9833,7494,7392,6782,1583
86553,4450,4616,57412,29141,3.14489e+13,1002.77,13919.7,86553,1341,343,81937,81926,81937,81937,81179
9684,343,598,6263,3421,3.0808e+13,314.815,1751.24,9684,223,152,8956,8400,8396,8291,6496
43833,1833,2128,26638,17195,3.13068e+13,484.687,5862.61,43833,464,304,41705,41637,40408,40844,38605
16246,622,1262,10399,5847,2.98748e+13,332.267,3167.24,16246,329,191,14984,14925,14280,13593,12330
13264,129,1123,9717,3547,3.02529e+13,206.875,3073.05,13264,312,151,11149,9697,6786,3235,1069
61185,2249,3923,43001,18184,5.35263e+13,1316.28,11642.7,61185,1526,466,57218,53904,46072,33057,37628
10181,412,1237,6229,3952,3.16449e+13,167.808,2442.39,10181,231,136,8944,8882,6750,3435,2509
25562,1441,1650,15817,9745,3.16597e+13,325.639,4234.03,25562,354,228,23912,23911,23483,23651,22314
34125,1283,2552,21930,12195,2.84637e+13,391.138,6350.66,34125,955,183,31573,31564,30102,28566,19123
97800,1288,3691,61615,36185,2.93057e+13,982.171,12032.4,97800,969,481,93981,93239,81133,60319,51796
85945,2365,4207,59363,26582,4.7773e+13,1367.85,14147.6,85945,1815,542,81738,78889,66370,41730,47170
77136,14364,42213,67585,9551,8.59164e+11,17.8256,42801.2,77136,2924,50,34923,34917,15106,14089,13157
79263,955,4201,55617,23646,4.97262e+13,1364.75,14248.1,79263,1717,537,71438,67714,50123,32447,24178
14064,318,979,9122,4942,3.1001e+13,401.07,2648.1,14064,287,174,12668,11740,11446,10607,7703
44060,35,1367,28333,15727,2.91822e+13,547.209,4820.54,44060,501,288,26549,15782,18032,10281,2994
77357,1565,3877,51073,26284,2.977e+13,717.089,11426,77357,1225,325,73480,73146,66635,65119,35847
48153,645,3971,34680,13473,6.07331e+13,1466.08,10709,48153,1400,456,40058,38342,21310,17646,8028
55812,2870,3325,38291,17521,2.8304e+13,634.73,9397.71,55812,973,281,52487,52458,52445,52484,50227
86049,423,2852,54318,31731,3.00275e+13,694.185,9693.27,86049,646,444,81191,76312,64518,52645,24758
73087,403,3898,50653,22434,4.8915e+13,1283.9,12238.3,73087,1407,468,62961,58055,40123,12234,8754
2464,318,489,1653,811,4.76445e+13,177.303,950.049,2464,165,57,1975,1839,1758,1922,1462
80160,2737,2773,51386,28774,2.97924e+13,633.212,9185.6,80160,654,434,77387,77374,77385,77387,77284
45688,2750,2791,31549,14139,2.8606e+13,554.053,7928.03,45688,924,267,42897,42897,42897,42897,42677
66188,385,2320,42743,23445,3.00129e+13,577.912,7647.89,66188,600,345,61643,56814,52568,50647,22221
28336,431,1532,18252,10084,2.90649e+13,453.487,4416.16,28336,402,257,26369,24599,23057,22426,16321
14103,262,386,9593,4510,3.40446e+13,277.999,1928.71,14103,244,145,13583,12913,10503,11220,11435
91491,3839,4400,62635,28856,3.64382e+13,1314.36,14809.2,91491,1438,418,87091,87021,85351,85320,82845
96108,744,3691,62916,33192,3.39856e+13,1177.08,11395.6,96108,837,387,91570,90248,72161,8687,8363
59239,2605,3909,41435,17804,5.28896e+13,1256.92,11335.6,59239,1415,470,55330,54308,48229,30779,37096
66425,1361,2127,42948,23477,2.97383e+13,555.195,7048.77,66425,535,336,64298,64292,63073,62979,59053
68044,351,20102,55756,12288,2.30048e+13,4820.28,32197.7,68044,6306,21,33156,31416,26864,18465,2675
94138,3329,4578,66627,27511,4.27726e+13,1700.09,15886.4,94138,1707,524,89560,89065,80534,82161,75446
46299,500,1312,29875,16424,2.92327e+13,553.113,4772.69,46299,490,289,44530,41495,39308,37487,29664
50894,1842,1974,32640,18254,2.8817e+13,524.845,6331.25,50894,486,321,48920,48920,48730,48712,48239
83786,341,3871,57037,26749,4.48592e+13,1227.67,12291.2,83786,1389,461,73189,66539,52202,11728,9229
23337,1409,1567,15046,8291,3.02858e+13,526.668,4216.02,23337,396,257,21770,21770,21577,21505,21508
67286,2454,3208,44370,22916,3.60315e+13,820.674,8729.13,67286,760,336,64078,63880,60025,45997,26958
91600,2827,4160,62941,28659,4.76213e+13,1395.44,14168.7,91600,1770,524,87440,87091,78668,45789,58224
51262,1816,3414,32435,18827,2.92431e+13,450.088,8573.44,51262,1139,200,47848,47843,47336,47786,32340
4802,394,827,3097,1705,2.84313e+13,170.893,1578.68,4802,224,104,3975,3802,3712,3516,2856
73173,3047,4247,51451,21722,5.12329e+13,1409.11,13732.8,73173,1799,523,68926,68746,63050,50683,54640
37435,1745,2691,25198,12237,2.78923e+13,505.454,7154.33,37435,949,236,34744,34743,33933,31640,26481
35679,926,1483,23154,12525,3.17766e+13,529.408,4600.69,35679,451,274,34196,34177,31706,30213,26635
22301,1935,2893,16372,5929,6.78138e+13,979.225,6354.21,22301,879,251,19408,18222,15716,15802,17385
58630,706,2061,37773,20857,2.94987e+13,534.085,6486.11,58630,522,319,56569,56284,50364,49320,43671
70504,3108,3895,50673,19831,4.90857e+13,1466.86,13081.1,70504,1468,508,66609,66506,64348,64331,64112
16864,41,1517,12172,4692,3.08309e+13,298.785,3985.69,16864,385,158,9832,4602,5243,1078,462
11912,2047,2448,8791,3121,6.31004e+13,527.871,4420.26,11912,567,183,9464,9183,9115,9164,8770
62456,4005,4111,44789,17667,5.48803e+13,1458.96,12647.6,62456,1584,519,58345,58345,58327,58331,57926
51078,552,1949,32838,18240,2.96305e+13,566.044,6515.17,51078,534,351,48831,47172,42225,41337,25763
60595,1597,3527,40383,20212,4.03122e+13,800.258,9511.06,60595,1001,420,57068,56105,45574,12044,14482
27575,1910,2260,19171,8404,3.63075e+13,689.349,6461.62,27575,731,205,25315,25315,25223,25293,22986
31197,1163,1554,20119,11078,3.06742e+13,526.862,4532.85,31197,432,261,29643,29639,29093,29235,27395
49073,566,3118,35413,13660,5.11158e+13,1309.2,10234.9,49073,1185,349,41890,39563,28182,26241,15462
70353,2557,4176,49592,20761,5.19502e+13,1431.9,13483.1,70353,1721,528,66177,64745,55535,45990,47455
95055,2447,4382,67782,27273,4.61711e+13,1641.59,16200.2,95055,1876,581,90285,88007,74544,68433,62233
80549,1084,2876,51005,29544,3.04831e+13,666.312,9418.99,80549,602,438,77673,77368,67223,56481,45207
38682,1034,1910,23398,15284,3.14996e+13,391.49,5170.91,38682,446,276,36772,36674,30010,25596,19740
62057,2695,3814,43294,18763,5.2021e+13,1167.24,11223.9,62057,1359,460,58243,57834,51043,30550,38132
90799,2364,4321,65263,25536,4.63888e+13,1702.06,15579.3,90799,1782,584,86002,83120,71220,69457,62437
66197,918,3690,41888,24309,2.95715e+13,576.968,10190.4,66197,1174,312,62507,61814,48931,31044,24278
55061,101,2295,35414,19647,2.97847e+13,617.651,7296.37,55061,596,370,44828,39484,34107,29263,6574
82056,2163,4017,52133,29923,2.94511e+13,791.574,11895.9,82056,1082,408,78039,77789,73212,74654,59468
98083,403,4251,67784,30299,4.62986e+13,1394.86,15246.2,98083,1790,541,85105,78515,57893,25550,13599
54756,1927,1986,35251,19505,2.92286e+13,539.742,6463.87,54756,514,313,52770,52770,52736,52718,52648
6926,654,711,5886,1040,4.22214e+13,16.9495,1018.03,6926,359,354,6215,6215,5903,6080,6067
33077,1451,2836,23373,9704,4.96407e+13,1188.82,8062.72,33077,1073,303,29895,28098,24307,23455,18639
60986,2672,4122,42970,18016,5.65379e+13,1473.51,12343.9,60986,1696,498,56864,56517,49308,41941,44517
97524,559,4682,64467,33057,3.1168e+13,1090.58,15042.6,97524,1368,415,90235,85860,60467,40754,14588
30937,595,1105,19983,10954,2.97329e+13,519.221,3809.57,30937,409,252,29816,28760,27127,26457,24098
73344,144,2332,47268,26076,2.94811e+13,593.149,7906.8,73344,608,363,62561,58317,50459,42392,13111
57289,1338,2577,35970,21319,3.03684e+13,561.539,7800.87,57289,590,375,54712,54602,48235,38430,37087
72169,1978,3992,50032,22137,5.00422e+13,1299.6,12337.5,72169,1487,477,67845,64068,51754,30665,34859
81029,3289,3963,52795,28234,2.9811e+13,695.763,12108.9,81029,1252,388,77066,77064,77064,76906,71092
23874,1481,1579,15334,8540,2.86204e+13,498.321,4301.47,23874,401,264,22295,22289,22243,22238,22190
18169,880,1886,11076,7093,2.82406e+13,265.073,3672.42,18169,441,137,16283,16272,15893,15987,13696
12731,42,945,8214,4517,2.97589e+13,380.838,2496.67,12731,286,163,8208,4428,5899,2996,1330
27422,895,1031,17658,9764,2.86173e+13,514.927,3546.38,27422,421,239,26391,26389,26072,25983,25884
68378,1291,2712,43345,25033,3.04106e+13,620.502,8660.62,68378,621,412,65666,65527,58945,49322,40451
16923,106,2450,12207,4716,5.87628e+13,879.437,5244.55,16923,751,195,11700,8431,5340,4012,1272
59482,6667,25081,47589,11893,128596000,1010.25,36755.3,59482,5975,11,34401,34401,26463,34401,8089
97735,3378,4265,63829,33906,2.98491e+13,855.648,13847.9,97735,1258,449,93470,93410,93470,93232,83734
65683,187,3613,47053,18630,4.03656e+13,1237.1,12208.8,65683,1318,375,52618,43552,30005,12366,7990
89654,980,3871,60401,29253,4.19059e+13,1225.95,12332.6,89654,1373,464,83893,81717,63683,16607,20268
72892,4095,4144,50600,22292,5.06067e+13,1327.03,12923.6,72892,1658,468,68748,68748,68730,68545,68648
23038,1452,1647,15201,7837,3.81857e+13,425.696,4123.01,23038,369,227,21391,21390,21096,21093,20453
62151,1499,3544,41592,20559,4.17572e+13,820.827,9641.74,62151,1016,428,58607,57555,46138,12567,15232
49009,3254,3642,33909,15100,4.88224e+13,1038.27,9722.62,49009,1178,416,45367,45258,44282,40679,33941
24171,543,2079,17226,6945,3.70069e+13,703.026,5596.66,24171,718,173,21439,20601,17067,18387,9140
92327,2137,4473,63507,28820,3.74756e+13,1323.38,15036.3,92327,1439,436,87793,85462,78941,76982,56066
57634,1862,3486,41242,16392,3.81691e+13,980.169,11050,57634,1025,351,54148,53267,49712,48311,42342
56479,555,2535,34940,21539,3.09734e+13,584.754,7357.46,56479,515,370,53470,52461,40525,26699,13880
48463,2715,2979,35000,13463,4.98458e+13,1272.56,10018.7,48463,1168,348,45484,45368,43923,43692,43528
6338,1516,1594,4687,1651,5.056e+13,240.093,2635.14,6338,405,144,4744,4744,4714,4706,4638
70442,215,675,47805,22637,3.36761e+13,303.643,4523.84,70442,308,264,67775,63065,46191,32918,37478
99330,2422,4374,64354,34976,3.07193e+13,919.667,14118.6,99330,1064,436,94956,94429,91633,92922,71219
50379,360,3656,34687,15692,4.78186e+13,982.843,9636.27,50379,1087,425,43475,39638,28327,7260,3947
44349,4032,15263,36900,7449,2.32497e+13,1540.46,22501.8,44349,4987,16,29086,24695,21923,26685,12438
58461,945,3368,39659,18802,2.91239e+13,683.084,9459.93,58461,1045,277,54799,53852,45141,32359,18699
47931,1993,3514,34301,13630,5.33035e+13,1569.82,10456.8,47931,1442,333,44113,40711,34455,36590,32080
94812,3268,4306,61861,32951,2.94541e+13,796.101,13538.4,94812,1254,419,90506,90471,90506,90230,77364
41267,2293,2469,29633,11634,2.73578e+13,756.717,7459.01,41267,759,231,38798,38798,38798,38798,38559
66933,628,4117,46865,20068,5.39703e+13,1370.47,12696.6,66933,1764,469,58007,55174,36122,21293,12300
26610,297,1717,19248,7362,3.1062e+13,477.992,5152.43,26610,493,190,24281,23800,13789,6155,3250
58551,173,2428,36316,22235,3.09442e+13,612.841,7213.13,58551,478,370,52106,47663,37753,20780,5088
26901,1983,2034,16268,10633,2.90771e+13,301.055,4473.02,26901,711,150,24867,24867,24867,24867,24782
36303,429,1206,23473,12830,2.98662e+13,526.438,4225.83,36303,447,280,34314,31640,29410,28732,18388
4782,1064,1937,3870,912,1.75246e+12,78.6129,2298.87,4782,440,60,2845,2845,1581,2751,1596
31456,1113,1812,19554,11902,3.07518e+13,425.005,4893.53,31456,433,263,29644,29627,26077,24897,18902
54394,2735,3164,33711,20683,2.91105e+13,548.343,8312.69,54394,931,322,51230,51230,51230,51230,49535
26503,2605,3169,19398,7105,6.36416e+13,1249.39,7301.12,26503,1014,298,23334,22691,22573,22707,22031
25539,238,1089,14909,10630,3.20767e+13,309.566,2786.03,25539,369,151,24123,22689,16868,11049,9930
24367,538,1488,15716,8651,3.01025e+13,434.018,4207.03,24367,409,251,22808,21858,20412,19602,13073
68711,2250,4234,48085,20626,5.20355e+13,1422.97,13159.6,68711,1787,517,64387,60846,49374,38687,39718
41085,2611,3274,29272,11813,5.67515e+13,1449.35,9362.71,41085,1317,320,37811,37527,36379,36334,36022
32775,451,2477,20814,11961,2.8287e+13,345.26,6009.9,32775,916,177,29745,27860,21753,18105,13088
69751,3881,4188,50087,19664,5.24128e+13,1407.97,13423.9,69751,1631,529,65563,65563,65494,65089,64281
43036,869,1933,27743,15293,2.89478e+13,533.842,6022.29,43036,491,325,41103,40896,38286,37235,29148
46722,2365,3855,33672,13050,6.04114e+13,1426.53,10397,46722,1368,453,42867,40352,35116,31872,34339
13990,975,1893,9778,4212,3.72094e+13,410.587,4227.95,13990,558,138,12097,11726,11438,11325,9805
59529,1601,3044,39667,19862,2.95186e+13,617.836,9024.68,59529,1109,269,56485,56334,54643,48469,29538
98588,381,4203,64816,33772,2.98729e+13,840.497,13700,98588,1271,433,90806,85812,60951,35190,9674
14529,500,945,10613,3916,3.17278e+13,201.846,2987.88,14529,324,132,13584,13579,12927,13394,8451
86054,3942,4148,59171,26883,4.78841e+13,1393.71,14015.4,86054,1742,509,81906,81880,81158,78575,74611
28757,696,1663,18603,10154,2.98779e+13,513.651,4820.59,28757,473,281,27062,26628,23930,23756,14998
81942,4121,4188,54317,27625,3.09769e+13,927.686,12598.4,81942,1321,297,77754,77754,77754,77754,77565
79745,3794,4241,56313,23432,3.90516e+13,1315.48,14052.8,79745,1398,432,75504,75470,74396,73448,72721
57108,1732,2531,35396,21712,3.08098e+13,591.741,7470.84,57108,478,379,54577,54437,48532,46679,39934
99002,467,823,67184,31818,3.36408e+13,306.749,5453.78,99002,316,279,98179,98179,78664,80209,72262
33457,191,1983,22158,11299,4.06291e+13,474.093,5281.63,33457,455,266,28630,26484,21255,4251,2255
22161,141,1699,16151,6010,2.8375e+13,342.749,4710.23,22161,426,176,18624,16143,11259,5715,2845
79510,1035,4323,54958,24552,3.70612e+13,1222.08,13896.9,79510,1277,421,73540,70539,54010,43022,17984
60596,2503,3573,38241,22355,2.91393e+13,524.303,9547.27,60596,1073,316,57023,57022,56909,57002,47317
15740,653,1477,9551,6189,3.20603e+13,204.236,3071.99,15740,249,150,14263,14250,10769,5880,3658
9938,1216,2188,7675,2263,7.03365e+13,266.298,3741.36,9938,462,168,7750,7656,3744,3907,2445
79446,2363,3990,52170,27276,2.96812e+13,717.742,12006.3,79446,1240,381,75456,75241,74327,74887,47007
4038,349,597,2608,1430,2.84399e+13,143.443,1180.81,4038,177,106,3441,3333,3244,3173,2531
1939,20,361,1265,674,3.1572e+13,86.7741,673.802,1939,109,63,833,277,454,243,242
80493,3250,4243,56367,24126,4.93193e+13,1364.71,14301.3,80493,1776,532,76250,76063,71196,54922,59593
50550,910,3567,34217,16333,4.52156e+13,767.463,9192.75,50550,947,426,46587,45569,35133,10476,11056
67063,1117,3685,44067,22996,2.9655e+13,677.169,10411.1,67063,1208,279,63262,62371,47655,41964,23277
41365,1278,2765,27859,13506,2.8325e+13,502.993,7518.5,41365,961,250,38600,38370,35017,30556,16323
49042,365,3607,33514,15528,4.80777e+13,791.861,9219.5,49042,1008,422,42971,39363,29938,8128,6907
5125,1030,1355,3775,1350,7.74363e+13,141.207,2218.84,5125,255,132,3770,3738,3716,3770,3266
46793,2633,3387,33457,13336,4.20359e+13,1021.28,10028.9,46793,923,340,43406,43228,39207,40774,39491
64309,768,2116,41393,22916,2.91738e+13,570.809,7332.04,64309,537,358,62193,61560,55867,53829,40055
85783,3756,4369,61288,24495,4.82965e+13,1681,15351.2,85783,1799,564,81414,81289,80759,74923,76373
8610,303,586,5020,3590,3.13331e+13,210.49,1333.86,8610,136,110,8024,7836,6956,7423,5423
5155,317,488,3740,1415,3.34298e+13,184.327,1339.83,5155,192,111,4667,4663,4461,4581,3416
65044,6578,19333,53525,11519,2.63016e+13,4157.86,30231,65044,7415,21,44474,34754,35288,39635,22976
14153,1039,1434,12029,2124,4.22382e+13,16.9762,1880.21,14153,720,715,12719,12719,10372,11738,11556
20424,591,972,11921,8503,3.18048e+13,283.38,2432.43,20424,278,149,19452,19387,17371,18328,15225
56512,2343,2474,35302,21210,3.02375e+13,553.433,7497.22,56512,480,383,54038,54004,53892,53892,53184
58743,1292,3336,38994,19749,3.91492e+13,757.369,8989.6,58743,913,356,55407,54748,43672,9901,11875
12450,1096,1989,8391,4059,4.69975e+13,626.936,4073.76,12450,605,167,10461,9957,9919,10241,4807
72050,6002,7207,61268,10782,4.21216e+13,17.0434,8245.83,72050,3607,3602,64843,64843,57633,61835,61247
14057,63,1511,8255,5802,3.1775e+13,225.277,2679.2,14057,327,128,11247,10180,7319,2926,1341
63179,1073,3854,44321,18858,5.28618e+13,1308.93,11728.3,63179,1487,469,57058,54272,37308,21356,19815
7853,582,727,5082,2771,2.90324e+13,283.342,1745.81,7853,240,140,7126,7066,6909,6803,6372
43294,3042,3054,28991,14303,4.13061e+13,655.472,7726.09,43294,846,336,40240,40240,40236,40236,40204
39006,1665,1810,25176,13830,2.94131e+13,513.605,5650.14,39006,441,320,37196,37196,36977,36953,36957
12636,2374,2394,9387,3249,6.35956e+13,463.209,4565.23,12636,608,217,10242,10242,10237,10233,10233
56038,2665,3728,40050,15988,5.29164e+13,1489.53,11500.8,56038,1452,415,52310,51665,47967,48406,47407
8813,1597,1672,6466,2347,7.63143e+13,235.591,3137.84,8813,363,148,7141,7141,7141,7141,7072
2008,204,273,1299,709,2.52295e+13,71.9049,573.384,2008,76,60,1735,1733,1707,1716,1552
57329,6306,18253,46890,10439,2.54832e+13,4604.46,28215.7,57329,6480,18,37567,28507,30030,33775,21226
18408,1252,1486,13159,5249,2.58296e+13,629.829,4255.34,18408,753,163,16922,16806,16730,16869,15312
92176,1835,4413,65818,26358,4.69107e+13,1656.49,15932.3,92176,1882,575,86567,82158,69628,61378,50096
26901,316,1633,17434,9467,3.05841e+13,508.759,4629.09,26901,407,270,24219,22483,20280,19068,6755
87072,21237,23593,71293,15779,2.54119e+13,5465.47,38436.7,87072,7912,26,63479,63479,61530,60521,60725
86005,863,3111,55878,30127,3.25798e+13,764.644,9699.34,86005,710,390,82870,82071,69064,9919,15474
84328,1079,4175,58090,26238,4.84801e+13,1370.62,13824.2,84328,1795,509,77293,73609,55091,26160,22078
73066,314,3339,45470,27596,3.07371e+13,721.897,9489.26,73066,644,419,67130,63182,50945,30775,15723
99240,2724,3153,63523,35717,3.07831e+13,907.922,10749.8,99240,784,459,96087,95952,94328,93174,90763
96169,1641,2974,61392,34777,2.9909e+13,731.146,10202.5,96169,729,450,93195,92965,86520,78831,69180
25380,1027,1138,14825,10555,3.20499e+13,293.364,2820.75,25380,378,168,24242,24242,24175,24182,24016
33932,1264,1622,21858,12074,2.91414e+13,502.508,4711.47,33932,429,262,32310,32309,32209,32197,31561
72824,1213,3674,45734,27090,2.94119e+13,719.195,10456.8,72824,964,395,69150,68692,57600,37679,35321
5834,151,814,4299,1535,2.4737e+13,170.082,1855.38,5834,285,106,4565,3327,2575,1399,776
85882,15918,33972,69772,16110,2.11294e+13,376.086,41360.2,85882,4074,172,51910,51910,45077,44009,32731
63097,1025,4234,45104,17993,5.45612e+13,1460.08,12845,63097,1699,518,55681,51978,36895,30793,22467
44153,236,2935,31218,12935,3.45233e+13,789.174,8854.75,44153,920,237,38078,34198,23101,10514,2536
42777,1444,2891,30438,12339,4.52672e+13,1060.3,9173.73,42777,1035,316,39508,37529,34100,32234,27305
81014,467,4407,56093,24921,4.2043e+13,1350.96,14316.1,81014,1444,437,70322,66348,43917,25754,13494
57331,153,3348,39018,18313,2.89325e+13,665.085,9343.17,57331,1017,276,47161,37953,29138,8239,5514
5543,207,571,4712,831,4.21946e+13,16.9403,843.912,5543,289,284,4972,4972,2810,4068,3899
43375,716,3316,31030,12345,5.45672e+13,1433.78,9769.07,43375,1296,340,36733,34642,23664,21885,12726
33526,343,2179,24239,9287,2.97014e+13,559.919,6362.43,33526,593,218,30388,29513,17765,15605,6828
17853,797,1368,11475,6378,2.83082e+13,373.692,3527.4,17853,330,231,16485,16389,15884,15803,13082
53663,1578,2085,34591,19072,2.93601e+13,561.423,6694.98,53663,515,337,51578,51575,50758,49833,44769
9514,614,710,6135,3379,2.93768e+13,326.813,1873.69,9514,199,159,8804,8774,8688,8516,8485
4340,202,552,2792,1548,2.73025e+13,128.765,1104.28,4340,212,75,3788,3726,3457,3490,2357
4614,48,602,2946,1668,2.98311e+13,257.309,1297.2,4614,177,132,3030,1854,2227,436,279
7187,418,987,4669,2518,3.63044e+13,241.67,2012.15,7187,266,155,6181,5892,5395,1599,1387
26730,211,1068,17253,9477,2.9232e+13,515.597,3585.76,26730,365,241,23480,21848,19878,19061,8951
85267,3288,3977,61276,23991,4.48598e+13,1690.86,14567.3,85267,1632,524,81290,80918,77833,76515,76629
93866,1264,3657,61730,32136,3.50612e+13,1184.19,11347.6,93866,831,378,89866,89070,71666,10668,14615
52191,2020,3047,37737,14454,4.85191e+13,1278.8,10455,52191,1173,352,48868,46689,40630,41853,39214
88938,1901,3678,58493,30445,3.54233e+13,1089.69,11367.9,88938,942,377,85260,84241,72417,16044,23982
80676,1864,4233,57367,23309,4.97237e+13,1365,14534.1,80676,1748,543,75792,71439,58956,50513,45755
33645,73,1821,22081,11564,3.55965e+13,478.064,4926.14,33645,437,271,25852,19376,18157,2302,1124
7443,267,348,5043,2400,3.32947e+13,251.714,1385.5,7443,212,111,7052,6732,6240,6498,6687
87311,8468,8923,74107,13204,4.21445e+13,17.8191,10113.8,87311,4368,2871,78388,78388,76153,77363,77042
21897,214,1469,14179,7718,3.01047e+13,495.706,3904.59,21897,419,235,19130,17790,15949,13040,4625
59348,3843,3944,42686,16662,5.67371e+13,1476.8,12103.8,59348,1529,529,55404,55404,55404,55396,55233
37471,1225,1704,24491,12980,3.42455e+13,513.483,5011.71,37471,464,283,35767,35763,34143,32820,29758
63053,698,2618,39306,23747,3.05791e+13,615.309,8151.89,63053,500,402,60176,59350,47995,34413,23973
99991,715,4282,69557,30434,4.52264e+13,1328.32,15773.8,99991,1805,547,90245,87225,65044,37459,25507
58049,3341,3534,37600,20449,2.94042e+13,578.263,9430.72,58049,1199,252,54515,54513,54515,54515,53526
35440,1583,2305,21653,13787,2.89508e+13,340.385,5419.71,35440,848,164,33135,33135,32920,32908,27803
63636,841,2690,40492,23144,2.98628e+13,584.577,8320.43,63636,598,409,60928,60292,52556,46990,33284
59276,1104,3038,39618,19658,2.95216e+13,622.428,9027.9,59276,1091,274,56168,55357,48016,40593,24409
63532,1763,3561,39850,23682,2.96331e+13,569.969,9580.7,63532,1064,322,59971,59840,57136,58356,47499
90182,1995,3137,58311,31871,3.14091e+13,836.142,10103,90182,726,417,87045,86754,83861,80279,69943
19687,1529,2997,14372,5315,7.18055e+13,730.977,6026.15,19687,704,402,16690,15930,10853,10914,11186
69498,3290,3660,45920,23578,2.96938e+13,690.715,10558.2,69498,1213,286,65838,65836,65838,65838,61337
32897,2667,3307,27962,4935,4.22212e+13,16.9896,3996.26,32897,1657,1652,29590,29590,25777,27996,27689
35954,277,3232,24266,11688,4.38633e+13,584.562,7587.39,35954,904,350,30594,27661,21083,4443,2302
24023,873,1006,15514,8509,2.9573e+13,504.341,3285.29,24023,382,214,23017,22987,22775,22781,22602
60142,1649,3519,43196,16946,4.31827e+13,1264.83,11692.4,60142,1249,365,56086,53544,48272,45845,36322
98648,3305,3977,64839,33809,3.59897e+13,1242.81,12552.7,98648,1034,439,94671,94510,92650,89727,76786
28948,2109,2133,18039,10909,2.76256e+13,322.204,5032.33,28948,758,157,26815,26815,26815,26815,26768
70102,1982,4109,48726,21376,5.10387e+13,1281.11,12641.5,70102,1631,469,65661,61725,48161,31122,33243
98018,298,4165,66568,31450,4.36366e+13,1457.82,13805,98018,1395,480,84581,76740,59464,11282,6603
80272,2935,4025,55220,25052,4.72742e+13,1276.9,12936.5,80272,1521,474,76247,75963,69670,40636,50835
32000,391,1208,20634,11366,2.92293e+13,501.107,3975.75,32000,386,271,29901,27624,25821,25397,16521
92974,1578,3668,60969,32005,3.48363e+13,1174.09,11575.5,92974,941,377,89274,88125,74274,13933,19688
43053,359,1303,27741,15312,2.92928e+13,534.203,4654.31,43053,463,285,40118,36897,35069,33769,24442
24896,1141,3232,17359,7537,5.66465e+13,620.95,6895.83,24896,867,413,21613,20783,14554,8604,8826
62557,217,2019,40637,21920,3.17568e+13,581.338,6487.63,62557,556,338,55232,51352,45834,4831,3504
67745,1100,3655,48675,19070,4.58004e+13,1558.36,12664.3,67745,1406,374,61617,58084,46976,46899,23932
65178,3826,4055,46843,18335,5.43533e+13,1454.05,12831,65178,1557,538,61123,61123,61080,60538,60433
12041,69,1634,8480,3561,2.25092e+13,399.561,3564.69,12041,612,147,6117,2592,2359,571,335
96533,1400,3044,61295,35238,3.02793e+13,752.749,10400.3,96533,702,446,93489,93186,84153,74219,64501
73759,3485,4168,52799,20960,5.10628e+13,1381.28,13860.4,73759,1642,532,69591,69550,67552,63620,64127
10326,361,367,7071,3255,3.37892e+13,274.817,1648.7,10326,226,129,9959,9959,9959,9958,9933
87845,1876,4262,61973,25872,4.77664e+13,1360.19,15139.6,87845,1770,548,82856,78659,65344,51843,47957
99670,95,4400,70894,28776,4.43075e+13,1621.67,16567.6,99670,1932,585,70321,50954,36620,14723,5589
88579,3939,4331,63425,25154,4.81466e+13,1718.13,15570.5,88579,1804,565,84248,84242,83888,80522,81043
70978,1183,3888,46076,24902,2.96202e+13,654.238,11302.6,70978,1233,375,67090,66390,53042,42462,23190
91059,1352,4323,64402,26657,4.67531e+13,1492.02,15562.3,91059,1763,563,84330,79794,64774,49033,37769
50367,430,3347,31393,18974,2.9597e+13,451.556,8280.39,50367,995,260,46292,43970,32333,16582,10771
1559,202,319,1125,434,3.61225e+13,116.588,600.95,1559,144,58,1240,1186,1167,1232,1108
87650,642,4269,58777,28873,3.3538e+13,1107.7,13748.9,87650,1319,382,80629,77810,56243,36496,27643
24681,277,1552,15774,8907,2.89673e+13,435.405,4351.48,24681,420,271,22038,20304,18794,17025,5622
11372,333,1434,7700,3672,4.79411e+13,292.101,2959.41,11372,360,163,9774,9256,7284,2110,1753
40782,3114,3606,28612,12170,5.36642e+13,1025.92,9141.61,40782,1150,422,37176,37121,36257,25898,27812
3220,153,386,1883,1337,3.31133e+13,118.968,730.135,3220,79,66,2816,2558,2322,2348,1284
67403,835,2134,43453,23950,2.95364e+13,579.727,7019.9,67403,571,327,65269,65047,59211,56915,50629
59099,1512,3527,42090,17009,4.03972e+13,1088.8,11461.7,59099,1168,360,55239,53148,48406,47467,34970
99630,3108,3581,62872,36758,2.98226e+13,997.168,11845.5,99630,929,477,96049,95776,96024,96047,93178
77164,148,3979,50470,26694,2.95446e+13,692.859,11872.1,77164,1236,380,64354,53531,42060,13219,2661
56402,2218,3066,36925,19477,2.93985e+13,566.222,8702.08,56402,1139,260,53336,53251,52471,52001,45006
70714,1574,3777,45223,25491,2.99776e+13,613.084,10883.4,70714,1238,327,66937,66750,60958,60972,41841
32950,424,1166,21152,11798,2.88093e+13,557.993,4016.56,32950,455,259,31012,28662,27129,26149,18377
3427,338,682,2704,723,9.36246e+13,142.611,1240.93,3427,83,106,2745,2672,1872,2070,1826
34928,677,1152,22549,12379,2.95388e+13,545.755,4090.52,34928,466,265,33776,33525,30879,30361,27255
99566,2326,4043,66038,33528,3.87545e+13,1310.26,12967.1,99566,1056,453,95523,94129,80617,20106,39201
91014,2556,4682,60408,30606,3.19052e+13,1030.33,14463.1,91014,1353,351,86332,85833,84910,85556,53396
12213,471,744,7134,5079,3.22262e+13,236.78,1770.12,12213,189,134,11469,11390,10283,10839,8836
90214,1600,2883,57861,32353,2.97499e+13,683.095,9749,90214,707,444,87331,87184,82255,76450,65576
80867,1442,4138,57883,22984,4.2197e+13,1561.48,14241.8,80867,1490,430,75234,71407,60857,59393,34892
4077,190,398,2388,1689,3.27061e+13,138.624,815.635,4077,96,74,3674,3353,3098,3392,2307
69407,25110,27295,56325,13082,1.70458e+12,101.775,28928.5,69407,1560,157,42112,42112,38978,41887,39275
57815,9963,18300,47329,10486,2.56225e+13,4464.42,28296.4,57815,6594,21,39515,32962,33694,35871,26780
93791,2575,2895,59999,33792,2.99532e+13,709.358,9975.66,93791,753,440,90896,90760,89444,89763,86716
34537,146,1210,22292,12245,2.9845e+13,531.595,4158.78,34537,449,264,29165,27526,23606,20579,8464
89207,3855,4394,60605,28602,3.63828e+13,1215.89,14418.9,89207,1312,417,84813,84757,83075,83210,81304
24125,1253,1622,14119,10006,3.23214e+13,305.051,3330.08,24125,454,156,22503,22503,22456,22501,22421
45642,1212,3073,32917,12725,5.26969e+13,1340.56,9812.5,45642,1179,348,40966,38600,30173,28216,22202
7756,503,998,5548,2208,3.13783e+13,362.462,2418.67,7756,418,103,6694,6296,5091,5853,2993
47607,2553,2917,31453,16154,2.88124e+13,488.124,8020.16,47607,1052,250,44690,44689,44613,44690,41726
5244,724,800,3754,1490,2.06454e+13,270.576,1760.18,5244,420,85,4444,4444,4443,4443,4434
97493,1495,3580,61483,36010,2.97212e+13,965.905,11630.2,97493,756,467,93913,93116,83782,64140,58358
43585,14519,18516,35077,8508,1.96744e+13,110.385,21338.3,43585,1574,155,25069,25069,25069,25069,25069
59045,3504,18476,48383,10662,2.59231e+13,4361.98,28600.7,59045,6769,21,36258,27724,26086,24113,11781
48405,294,3038,30052,18353,2.97438e+13,460.976,7683.1,48405,928,279,43629,40701,30441,14798,6904
16226,1102,1228,10512,5714,2.94282e+13,351.137,3107.13,16226,323,212,14998,14995,14813,14660,14316
17738,206,1033,11470,6268,2.97606e+13,442.738,2963.47,17738,338,195,15568,14467,13312,12521,5918
18630,262,966,12010,6620,2.9371e+13,476.252,2935.28,18630,356,204,16624,15364,14529,14129,7829
4986,430,454,2915,2071,3.20489e+13,158.398,951.159,4986,107,83,4532,4532,4527,4531,4428
65897,85,1985,42403,23494,2.96135e+13,611.597,6463.71,65897,611,347,52125,40898,38524,4852,1144
96365,1966,3090,60544,35821,3.03725e+13,732.661,10524.8,96365,635,479,93275,92992,85181,69868,72635
1421,316,326,872,549,2.60475e+13,72.0809,569.917,1421,79,82,1095,1095,1095,1095,1086
92340,858,4349,59717,32623,2.94203e+13,821.856,13548.7,92340,1255,421,87498,86250,66029,45019,26096
74977,2261,3719,50747,24230,4.25333e+13,1131.15,11214.8,74977,1214,429,71258,69349,59482,22647,37519
24754,1783,4638,16563,8191,2.82713e+13,205.076,6700.09,24754,729,139,20116,20103,16921,18842,16825
89138,502,2948,56492,32646,2.98815e+13,710.777,9952.5,89138,651,452,85033,81100,69198,58268,33294
8413,185,348,5665,2748,3.29033e+13,248.565,1464.06,8413,210,115,7666,5653,5544,5126,6395
51326,260,2442,32043,19283,3.04382e+13,532.85,7036.81,51326,536,367,46813,43976,35581,21353,9342
57293,1346,3534,39691,17602,3.07088e+13,801.389,10307.8,57293,1023,284,53759,52590,47455,42904,23734
43498,1089,3884,31441,12057,6.17694e+13,1340,10061.5,43498,1320,462,37689,35483,22396,17159,12566
55153,2729,3888,38919,16234,5.44909e+13,1260.93,11012.3,55153,1376,467,51265,51041,45163,30698,35264
27910,561,2972,20412,7498,6.29394e+13,1364.18,7311.82,27910,953,277,22379,21153,10749,9822,7140
66654,2492,3206,44264,22390,2.95811e+13,711.527,9673.69,66654,1145,279,63448,63230,62928,63123,55126
96063,1180,4148,65257,30806,4.43972e+13,1415.75,13457.4,96063,1423,475,89866,87228,68851,21025,27382
99430,1336,4330,65424,34006,2.98536e+13,894.851,13939.4,99430,1270,435,95028,94116,76560,54432,36251
46421,2299,2335,30709,15712,3.91689e+13,521.291,6382.81,46421,495,293,44086,44086,44062,44074,44041
45356,790,2589,30271,15085,3.99892e+13,718.99,6803.1,45356,662,313,42648,42254,31373,5819,3883
86660,2066,4086,62538,24122,4.77451e+13,1752.5,14905.2,86660,1687,576,81819,77862,66655,63754,54451
53499,3291,3948,38270,15229,6.08987e+13,1478.82,11428.9,53499,1593,462,49551,49497,47302,44607,44932
15538,415,787,9982,5556,2.81599e+13,420.561,2482.29,15538,313,193,14453,13520,13247,12571,10037
28261,558,1725,20458,7803,3.09299e+13,537.232,5401.76,28261,517,200,26212,25258,17280,17527,7670
30828,60,2414,20441,10387,2.80932e+13,479.388,6253.95,30828,919,197,18847,12534,9840,3663,1416
31151,1484,2288,21791,9360,3.69214e+13,682.452,6821.75,31151,889,206,28863,28034,28339,27876,24690
70309,660,671,47767,22542,3.37278e+13,303.969,4517.08,70309,308,264,69638,69638,69637,69621,69603
28688,2448,3235,20849,7839,6.5657e+13,1233.63,7605.7,28688,1027,377,25453,24485,23092,23538,23063
20874,789,1019,13361,7513,2.87151e+13,491.404,3151.55,20874,403,221,19855,19843,19275,19061,18986
43729,765,2665,30871,12858,2.86448e+13,600.416,7664.56,43729,861,274,40762,39885,25870,16696,7051
36512,88,1758,23201,13311,3.0254e+13,502.873,5173.98,36512,467,291,30069,25798,22675,16985,5036
13732,3853,7529,12034,1698,8.55235e+11,14.6293,7766.83,13732,614,47,6203,6203,3601,5365,3363
28505,2070,2835,20896,7609,6.25151e+13,1280.31,7258.07,28505,898,272,25597,23666,20395,21208,22202
59480,1101,3144,39492,19988,3.76252e+13,743.55,8519.03,59480,811,341,56336,55802,44025,7983,9499
3285,646,1205,2471,814,5.75335e+13,120.791,1675.63,3285,301,149,2080,2071,1020,1349,851
55450,3092,3652,39822,15628,5.27339e+13,1480.21,11348.5,55450,1453,402,51798,51791,51106,51028,50370
38372,381,2559,27321,11051,3.29531e+13,758.566,7694.96,38372,857,207,34220,32875,21211,18388,7338
32839,112,480,22256,10583,3.34821e+13,297.778,3007.34,32839,288,215,24017,14134,15023,12862,13460
8926,882,1107,5380,3546,3.2089e+13,163.847,2084.63,8926,210,130,7819,7819,7270,7501,6320
7216,258,788,5348,1868,2.52104e+13,179.235,2022.92,7216,303,115,6428,6266,4375,3530,2644
73950,3345,4193,52784,21166,5.13873e+13,1386.71,13932.9,73950,1695,537,69757,69667,66321,60942,62624
81820,603,699,55457,26363,3.35466e+13,298.677,4854.63,81820,306,265,81121,81121,78371,78978,78218
6335,15,540,4633,1702,3.12714e+13,175.661,1574.86,6335,217,102,2358,619,548,614,244
5138,303,754,3311,1827,3.05419e+13,244.385,1507.27,5138,237,113,4370,4096,3713,3808,2256
54700,993,2153,35359,19341,2.94337e+13,547.047,6830.48,54700,600,328,52547,52475,48979,48415,40446
4141,614,621,2732,1409,3.21507e+13,199.744,1252.61,4141,195,107,3520,3520,3520,3520,3520
94578,2683,3023,59816,34762,3.0669e+13,730.768,10362.1,94578,666,466,91555,91490,89487,90179,86112
38811,290,2940,23585,15226,2.97604e+13,407.221,6454.68,38811,772,197,34921,32942,23335,8649,4929
24361,1777,2775,17129,7232,5.60342e+13,1137.52,6830.56,24361,963,275,21586,20289,16972,17837,16318
5908,370,512,3449,2459,3.19518e+13,166.536,1068.05,5908,120,92,5396,5371,5109,5259,4660
3860,568,582,2502,1358,2.88035e+13,134.941,1166.06,3860,143,90,3278,3278,3278,3278,3244
89589,4109,4204,59242,30347,2.93081e+13,930.543,13300.2,89589,1256,409,85385,85311,85385,85385,84924
24169,282,1464,15476,8693,2.84804e+13,423.815,4139.55,24169,365,253,21697,19981,18721,18338,9493
17273,186,911,10093,7180,3.21912e+13,277.734,2177.87,17273,267,135,15974,14292,11081,7408,5861
65531,625,2625,41756,23775,2.98517e+13,564.426,8339.36,65531,583,409,62668,61360,52496,46661,29336
53827,102,1923,34696,19131,2.92939e+13,551.23,6649.24,53827,509,354,44443,39823,34229,30139,7579
23076,1179,3206,16189,6887,5.88338e+13,650.458,6759.86,23076,828,403,19870,19007,12796,8290,8366
2933,965,1241,2389,544,1.71558e+12,70.417,1500.65,2933,411,48,1692,1692,1507,1688,1511
76553,1362,4255,54610,21943,5.07655e+13,1384.42,14202.2,76553,1715,538,70298,65931,52295,42750,35838
15906,1104,1503,9725,6181,3.15857e+13,225.72,3238.22,15906,282,185,14403,14399,12969,13576,9979
8103,465,998,5792,2311,3.08339e+13,356.01,2394.45,8103,416,107,7000,6596,5712,6129,3710
74394,1772,3936,51330,23064,4.79779e+13,1235.82,12284.6,74394,1419,477,69711,66643,53811,26297,31959
41379,1692,2225,26156,15223,3.0222e+13,522.296,6222.44,41379,460,346,39154,39138,37119,37694,33181
21809,306,1889,14878,6931,5.14033e+13,415.598,4480.08,21809,432,273,19167,17368,13080,4292,2560
59521,939,1950,38400,21121,2.97452e+13,586.585,6220.64,59521,552,325,57571,57523,53467,53966,49681
90139,1991,2925,56755,33384,3.00216e+13,707.763,9994.14,90139,621,457,87214,86949,80845,69905,71971
26284,871,3347,19308,6976,6.66125e+13,1197.02,7373.02,26284,908,418,21749,20533,10641,10615,8054
2203,336,507,1366,837,2.86731e+13,39.5293,770.908,2203,82,84,1696,1696,1584,1643,1282
77520,392,3922,56037,21483,5.00787e+13,1660.96,13812.1,77520,1506,571,65610,61632,35106,29913,11272
20655,2169,10703,16797,3858,2.0349e+13,686.591,13472.7,20655,2805,12,9952,8686,8687,8686,6892
9788,337,725,6321,3467,2.90295e+13,361.072,1928.22,9788,280,146,8835,8327,8103,7696,6314
84750,1079,4305,59552,25198,3.96588e+13,1317.56,14511.6,84750,1414,438,78161,74607,55627,45072,19506
86816,2495,4326,55693,31123,2.91793e+13,728.194,12963.6,86816,1253,394,82490,82392,81403,81789,62269
1967,129,230,1342,625,3.35698e+13,164.785,627.08,1967,136,62,1462,906,1204,1288,1233
86502,2610,4258,61109,25393,4.80131e+13,1337.06,14978.2,86502,1767,536,82244,81009,71662,58715,60294
55634,1972,2186,34224,21410,3.08156e+13,547.242,6670.68,55634,470,354,53448,53384,52702,52925,51457
13333,287,2382,9946,3387,6.55273e+13,517.791,4587.23,13333,609,240,10168,9308,5306,4303,2984
83290,3351,3976,55500,27790,4.01908e+13,1208.68,11707.9,83290,1045,428,79314,79070,76932,73221,63001
18860,950,1839,12075,6785,2.51662e+13,303.327,4104.52,18860,624,154,17021,17013,16130,16106,10573
63568,117,2636,39712,23856,3.02391e+13,610.419,8224.49,63568,522,401,54013,49688,40586,24543,3325
86914,2556,4261,55943,30971,2.93409e+13,794.231,12887.8,86914,1255,403,82653,82516,82279,82445,62021
60493,42274,56209,29870,30623,1.89457e+12,9.791,57514.3,60493,28382,66,4284,4284,3767,4091,3425
72359,3226,3909,50061,22298,4.92727e+13,1241.08,12041.4,72359,1398,467,68450,68230,65342,38130,45669
95020,4378,4616,67121,27899,4.24288e+13,1686.38,15963.3,95020,1709,515,90404,90401,90393,90142,89869
86277,867,2900,54527,31750,3.00056e+13,704.652,9787.34,86277,630,453,83220,82476,69701,59279,43984
22786,815,926,14738,8048,2.9548e+13,449.939,3127.1,22786,350,218,21860,21860,21611,21539,21594
48181,39,1356,31152,17029,2.98932e+13,589.79,4962.78,48181,500,288,30328,18425,21638,5169,1009
86378,531,3986,62256,24122,4.74285e+13,1724.06,14733.8,86378,1672,578,74736,70395,41587,27466,23195
85115,578,3659,55930,29185,3.54007e+13,1044.28,11093.7,85115,927,369,80444,77516,62333,8921,8461
21933,1164,1606,15829,6104,3.10222e+13,453.884,4670.75,21933,449,179,20327,20107,19486,20062,14654
35105,257,1230,22547,12558,2.92659e+13,528.288,4220.63,35105,400,261,31546,29029,27501,26393,13651
72105,1078,2712,46235,25870,2.97112e+13,605.55,8702.04,72105,641,407,69393,69259,63093,59065,45900
82462,1597,4259,57858,24604,4.92531e+13,1358.49,14531,82462,1789,548,76924,72615,57718,40375,37134
51855,3091,3394,37295,14560,4.98803e+13,1286.72,10770.3,51855,1237,352,48461,48459,48461,48461,48007
1859,228,268,1191,668,2.60404e+13,92.3394,547.899,1859,93,52,1591,1591,1588,1586,1555
81208,488,3531,50989,30219,2.96662e+13,849.312,10840.7,81208,923,433,76205,72690,58368,41099,22281
85997,528,3919,58950,27047,4.5799e+13,1308.4,12885.4,85997,1372,473,77099,72450,50753,15410,9486
9175,944,1766,6199,2976,4.08534e+13,367.225,3346.76,9175,497,141,7409,7206,6760,6932,4162
48890,1851,3633,33761,15129,4.83738e+13,992.004,9624.12,48890,1082,419,45121,43519,35233,15843,20546
21517,30,2151,14983,6534,3.72787e+13,581.294,5520.59,21517,612,187,11376,5321,4793,3052,620
43984,491,519,29804,14180,3.34395e+13,296.684,3488.15,43984,295,235,43465,43465,43350,43223,43063
53809,1748,3262,38196,15613,3.37009e+13,956.827,10212.2,53809,1005,310,50547,49793,48980,47676,40906
65147,242,3855,45705,19442,5.26452e+13,1312.61,11839.7,65147,1465,462,52770,47503,31505,11851,7339
5316,603,973,3735,1581,1.85432e+13,214.071,1911.42,5316,240,101,4343,4333,4150,4201,3628
9296,136,707,6800,2496,3.22609e+13,197.564,2111.33,9296,247,128,8007,7205,5091,4567,1807
85362,3936,3973,61622,23740,4.82714e+13,1711.91,14660.2,85362,1633,572,81389,81389,81389,81363,81299
79564,1539,3923,54772,24792,4.75936e+13,1279.74,12721.3,79564,1504,456,74403,71020,54048,27454,30461
6436,1147,3533,5636,800,8.72495e+11,14.5508,3691.64,6436,404,42,2903,2903,1214,2714,1061
2356,90,309,1727,629,3.17329e+13,130.461,742.562,2356,139,75,1923,1763,1419,1073,997
53905,1941,3154,35827,18078,3.88016e+13,723.378,8455.1,53905,875,338,50751,50255,43192,13541,16450
95921,3712,4492,64660,31261,3.6255e+13,1223.97,14899.4,95921,1378,414,91429,91295,88459,89150,85520
35234,2148,2635,21884,13350,2.92259e+13,345.778,6021.26,35234,942,165,32599,32599,32384,32426,31511
80296,442,4314,56890,23406,4.96975e+13,1360.72,14548.6,80296,1789,542,68479,64585,44263,32684,15142
72749,1957,3908,49278,23471,3.17703e+13,955.948,12230.3,72749,1150,306,68841,68496,66397,62828,45860
82524,1055,3846,56287,26237,4.60054e+13,1163.96,12241.5,82524,1409,465,76854,74644,58494,18445,25103
28068,128,1111,18139,9929,2.99995e+13,518.488,3703.75,28068,388,240,23439,21694,18570,15793,6474
96901,1372,4523,67904,28997,4.08712e+13,1582.93,15839.8,96901,1686,456,90263,85990,71547,60347,28480
77895,2613,3796,52743,25152,4.3166e+13,1149.02,11626.8,77895,1328,458,74099,73091,63701,27034,41745
21614,1337,2147,14236,7378,2.59268e+13,319.682,4885.83,21614,727,173,19467,19462,19034,18867,15238
93971,423,3015,60282,33689,2.98445e+13,721.778,10004.7,93971,718,429,88031,81396,73814,67172,22955
91427,3472,4563,65066,26361,4.32394e+13,1710.65,15690.9,91427,1692,521,86864,86437,78957,80127,75219
20315,826,1548,14824,5491,2.92743e+13,317.073,4362.51,20315,394,175,18767,18610,14846,16732,9682
50383,1930,3612,34836,15547,4.84352e+13,1040.92,9750.7,50383,1125,419,46712,44743,36462,18712,22628
72402,3153,3803,48172,24230,2.89416e+13,818.811,10995,72402,1184,283,68599,68599,68594,68599,66649
58138,14,595,39418,18720,3.35304e+13,299.509,4057.3,58138,302,252,11812,3425,5048,1141,1686
66027,3656,3666,43226,22801,2.97086e+13,665.123,10259.2,66027,1211,274,62361,62361,62361,62361,62327
19933,1879,2807,14403,5530,6.37413e+13,919.879,5887.78,19933,866,250,17126,16182,13070,14153,13528
19299,927,1509,12360,6939,2.89505e+13,392.576,3803.79,19299,401,230,17790,17718,17222,16804,13007
73914,1771,3662,53182,20732,4.09545e+13,1235.7,12977,73914,1353,391,69777,67118,60687,58574,48220
15216,1096,1156,11119,4097,2.98141e+13,209.963,3377.24,15216,324,155,14060,14060,14044,14041,13665
36734,1322,1766,23611,13123,2.86422e+13,521.475,5455.25,36734,454,308,34968,34958,34053,33779,31073
86158,1437,3938,57750,28408,4.01436e+13,1333.6,12322.8,86158,1213,445,81451,79147,62889,18050,24509
78730,2117,2811,50094,28636,3.03985e+13,650.155,9263.64,78730,618,424,75919,75811,72442,71279,66545
10635,467,739,6821,3814,2.87032e+13,375.675,2068.16,10635,249,171,9841,9296,9075,8807,7223
6706,916,1049,4330,2376,2.88359e+13,189.689,2060.28,6706,239,149,5657,5655,5570,5619,5250
37391,223,2067,24797,12594,3.97083e+13,481.275,5563.51,37391,447,275,32681,29956,24721,4544,2615
62978,673,3374,42299,20679,2.92306e+13,707.672,9744.17,62978,1096,280,58875,57495,42130,28040,20233
73582,3277,3614,48612,24970,3.79942e+13,857.806,10195.8,73582,997,429,69968,69966,68849,67044,61840
68805,17748,20775,55844,12961,2.73049e+13,6041.81,32643.1,68805,6957,22,48030,48030,45835,46290,47110
76232,2944,3973,52754,23478,4.90002e+13,1293.68,12643.8,76232,1509,465,72259,72002,65810,40427,49797
49776,509,1901,32028,17748,2.90655e+13,548.462,5995.15,49776,481,296,47379,44276,40900,39508,31655
72813,674,3930,52316,20497,4.65207e+13,1649.29,13416.2,72813,1551,415,63504,60380,39371,37484,12816
3649,155,763,2552,1097,1.74815e+13,183.583,1443.55,3649,188,77,2462,1873,1424,1309,642
38758,553,3724,28165,10593,6.49737e+13,1234.11,9326.83,38758,1227,456,32247,30683,17336,11753,9975
37449,3196,3212,26823,10626,5.96751e+13,1408.62,8703.34,37449,1273,277,34237,34236,34237,34237,34217
46092,2568,2658,32937,13155,3.04877e+13,826.7,8422.84,46092,926,236,43434,43434,43434,43434,43200
55686,6066,17997,45503,10183,2.50764e+13,4440.84,27733.6,55686,6290,21,35940,27277,28664,32167,18747
25112,4582,12996,19922,5190,2.23503e+13,90.9098,14557.3,25112,1300,122,12116,12116,9739,10220,9879
88621,2390,3812,59896,28725,4.28469e+13,1173.74,12225,88621,1372,469,84809,82933,73132,28028,45460
40374,2947,3124,28828,11546,4.18268e+13,900.827,8859.89,40374,859,314,37250,37250,37199,36673,36763
39383,1358,2674,24971,14412,2.89353e+13,397.13,6703.6,39383,1012,186,36709,36699,35469,33843,24190
77338,1136,3946,51080,26258,2.98083e+13,748.667,11631.5,77338,1238,328,73183,72108,55749,46349,22838
94961,894,4032,63576,31385,3.96396e+13,1311.46,13062.3,94961,1281,435,88974,87171,67754,15253,16270
13149,1072,1621,9330,3819,2.27861e+13,408.401,3689.84,13149,613,153,11528,11405,10516,9946,9625
80615,70,2796,51369,29246,3.0316e+13,661.59,9300.06,80615,647,441,62572,47407,47267,36861,8021
93516,2243,2957,59441,34075,2.98176e+13,709.669,10082.1,93516,699,441,90559,90362,86727,85013,80408
86894,2466,4392,60186,26708,3.73661e+13,1316.57,14604.7,86894,1422,427,82502,81876,76007,74239,56093
52160,1436,3016,37639,14521,4.7496e+13,1259.13,10402.1,52160,1171,341,48208,45371,39553,36485,32045
53586,1278,2460,33567,20019,3.08277e+13,554.253,7307.02,53586,502,377,51126,51033,44458,34071,33906
7804,224,1387,5591,2213,7.16074e+13,178.923,2520.16,7804,225,200,6340,5793,3086,2353,1410
48888,2883,3091,32627,16261,3.98757e+13,707.235,8024.83,48888,808,329,45797,45797,45247,45176,42806
49626,2205,2997,32567,17059,2.9012e+13,487.832,8177.09,49626,1076,252,46629,46626,45932,46442,39934
88678,3908,4055,63907,24771,4.70063e+13,1726.69,14971.3,88678,1676,584,84623,84612,84592,84358,84431
55706,2111,3507,35928,19778,2.92811e+13,559.118,9175.9,55706,1190,243,52199,52142,51561,51986,33105
55291,1699,3369,38009,17282,2.77825e+13,674.242,9500.18,55291,945,280,51922,51807,49909,43713,33838
48954,1117,2148,29973,18981,3.13982e+13,513.521,6227.53,48954,454,309,46806,46660,39161,31720,24263
90603,1622,4487,59985,30618,3.07572e+13,986.535,14078,90603,1348,399,86116,85284,76739,76575,41572
69884,1012,6972,59452,10432,4.20176e+13,17.094,7999.09,69884,3490,3485,62912,62912,27177,48019,44282
88292,1838,3850,60002,28290,4.46705e+13,1187.67,12464.9,88292,1386,468,83971,81138,66404,25718,36681
85197,130,4382,59770,25427,3.9426e+13,1324.9,14597.2,85197,1417,441,64325,50573,36831,10125,3960
66164,2100,3418,40988,25176,3.04804e+13,683.332,8985.98,66164,636,383,62746,62583,58534,60150,54292
25775,1017,1055,16619,9156,2.97911e+13,474.166,3500.62,25775,373,245,24720,24720,24675,24680,24666
30530,761,1788,22079,8451,3.08867e+13,532.173,5626.49,30530,557,208,28696,28158,22509,23701,11308
85913,34,2924,54650,31263,2.99897e+13,688.737,9718.94,85913,702,438,53661,34024,35507,7822,2486
63016,4049,4123,44238,18778,5.45666e+13,1320.85,12225,63016,1670,456,58893,58893,58840,58568,57788
75882,2547,3973,52328,23554,4.77455e+13,1252.53,12312.2,75882,1415,466,71909,70525,62770,32142,43725
87006,2797,3659,54900,32106,2.90497e+13,832.54,11417.3,87006,961,439,83347,83171,83290,83333,77756
21396,245,1214,13838,7558,3.01125e+13,483.654,3390.17,21396,413,206,18868,17736,16479,15819,9719
74489,532,3954,47832,26657,2.96095e+13,621.322,11411.5,74489,1239,349,69452,66109,49357,30664,19719
81445,2844,4127,54115,27330,3.14841e+13,953.725,12644,81445,1310,303,77318,76971,77129,77236,65084
65673,2911,3579,47234,18439,4.61544e+13,1573.43,12350.8,65673,1347,379,62094,61776,56783,56899,56262
23690,525,2975,16325,7365,5.13387e+13,466.363,6397.71,23690,766,334,20491,19430,13136,5438,4021
19990,661,922,12906,7084,2.95903e+13,470.193,2948.52,19990,372,213,19068,18947,18136,17822,17249
54807,1100,3503,36508,18299,4.05867e+13,793.606,9148.86,54807,1006,419,51304,50301,39357,9514,9264
70621,1721,3334,46556,24065,3.55497e+13,989.341,9077.01,70621,784,347,67287,66599,57569,12466,15781
36279,1118,3620,25613,10666,5.53046e+13,890.087,8559.26,36279,1010,428,31956,30889,22041,10495,10072
56570,3429,3531,40273,16297,4.02697e+13,1061.4,11174.3,56570,1092,349,53039,53039,53013,52959,52756
71196,563,3673,51102,20094,4.52372e+13,1539.61,12968,71196,1434,382,62079,58801,37316,36506,13160
61428,565,3794,44107,17321,5.30369e+13,1439.08,12140.4,61428,1463,503,51874,49123,32592,29580,16935
91627,1457,4267,59842,31785,2.98529e+13,797.115,13376.5,91627,1261,420,87360,86764,72454,52240,36602
84233,3267,4048,56008,28225,3.17771e+13,987.002,12930.9,84233,1311,309,80185,80030,80180,79925,74777
61469,8289,25875,49179,12290,124535000,1018.89,37947,61469,6173,11,35594,35594,28070,35594,10522
80175,2323,4241,56540,23635,4.93876e+13,1351.06,14417.9,80175,1715,543,75919,72954,60342,50091,51309
76474,333,3719,51418,25056,4.12128e+13,1097.76,11071.9,76474,1139,429,67411,61462,49169,8575,5762
97546,6060,25378,79982,17564,2.70438e+13,5582.28,41287.2,97546,9094,27,68658,50224,53648,60775,21392
40994,1188,3105,29473,11521,5.4839e+13,1409.37,9335.32,40994,1176,342,36301,33967,25479,23753,18311
2189,406,469,1387,802,2.89334e+13,101.902,844.802,2189,116,83,1720,1712,1716,1713,1617
27318,396,1020,17574,9744,2.88859e+13,507.46,3533.16,27318,412,235,25539,23752,22583,21810,16312
19875,295,1041,12885,6990,3.06038e+13,449.821,3120.32,19875,345,208,18057,16771,15902,15316,9814
24301,157,1648,17559,6742,3.09005e+13,521.242,4996.16,24301,513,193,19831,14834,11621,2622,2721
96558,1944,3070,61757,34801,3.0089e+13,818.416,10398.8,96558,725,463,93488,93211,88770,80684,72259
78483,163,4108,51912,26571,2.91408e+13,853.925,12147.4,78483,1234,329,66047,54543,41221,8199,3931
1074,112,200,699,375,2.86952e+13,75.9134,391.343,1074,72,46,874,793,798,827,710
65145,1509,2266,41927,23218,2.93204e+13,583.087,7459.1,65145,636,351,62879,62865,61255,60106,53050
83366,1737,3978,54656,28710,2.9798e+13,725.946,12311.7,83366,1247,393,79388,79075,74189,72946,45855
32609,1356,1595,21013,11596,2.91881e+13,460.26,4803.71,32609,412,273,31014,31012,30759,30637,29413
28996,1428,2300,19521,9475,2.75057e+13,485.542,6036.54,28996,898,195,26696,26683,26145,24946,18588
23140,1518,1572,14923,8217,3.01725e+13,441.878,4225.44,23140,372,248,21568,21568,21544,21522,21462
78575,1801,3802,53151,25424,4.32636e+13,1161.67,11704.5,78575,1306,463,74349,71927,57265,22155,28501
29934,283,462,20344,9590,3.36174e+13,295.758,2858.63,29934,284,204,29278,28552,21620,23366,22346
87888,46,4254,61089,26799,4.72946e+13,1330.59,14757.5,87888,1759,539,53428,33423,27806,12378,2881
6587,256,667,4223,2364,2.80323e+13,317.602,1592.06,6587,256,141,5704,5319,5061,4858,3161
12146,613,1297,7560,4586,3.11489e+13,200.614,2784.37,12146,256,170,10849,10813,9194,6772,5439
30905,1019,1656,19822,11083,2.86346e+13,451.336,4829.11,30905,415,296,29249,29212,28396,28123,24214
25036,1787,2335,17398,7638,3.66481e+13,788.586,6289.27,25036,811,218,22701,22191,22463,22626,19733
6694,105,1750,5029,1665,5.18677e+13,192.558,2948.06,6694,441,129,4262,3072,2144,1641,748
13221,1551,1755,9306,3915,2.24798e+13,374.296,3809.35,13221,623,150,11466,11466,11374,11450,10829
40285,1116,2378,28985,11300,2.7476e+13,728.311,7287.24,40285,760,231,37907,36887,35755,36543,26152
94279,2932,4321,66399,27880,4.64787e+13,1399.88,15686.4,94279,1765,560,89958,89607,82146,65259,68940
91610,3177,4254,59110,32500,2.92535e+13,794.705,13274.1,91610,1258,410,87356,87281,87356,87204,74672
17845,889,1865,12561,5284,3.4648e+13,469.535,4619.98,17845,731,144,15980,15546,15216,15242,13037
2503,105,267,2128,375,4.22792e+13,16.8726,444.831,2503,138,133,2236,2236,1282,1834,1765
69093,178,2263,44530,24563,2.91807e+13,585.627,7607.93,69093,627,341,59841,56069,49352,44242,17148
1141,231,311,777,364,9.31173e+13,60.2612,551.344,1141,149,22,830,830,782,760,752
45934,1746,2661,32675,13259,3.15087e+13,836.301,8459.66,45934,1100,235,43273,43024,42701,42886,38964
41360,1016,2575,29640,11720,2.9358e+13,810.436,7720.37,41360,813,233,38734,37150,34656,35754,24613
58217,16602,18475,47557,10660,2.56282e+13,4801.06,28606.9,58217,6388,18,39742,39742,39062,39062,39742
44964,403,2578,29900,15064,3.89889e+13,687.38,6761.83,44964,633,315,40845,37450,30434,4001,3172
2684,863,1018,1825,859,6.22422e+13,72.633,1476.66,2684,239,129,1666,1666,1637,1665,1266
59581,3062,3724,40796,18785,4.66035e+13,1086.82,10655.5,59581,1267,426,55857,55640,52847,28967,35538
5654,547,1398,4261,1393,8.24611e+13,155.951,2294.33,5654,236,126,4256,4201,3334,3603,2884
40115,1162,3624,27528,12587,5.11251e+13,737.22,8699.57,40115,1017,422,36289,35293,26885,11804,12126
61669,2357,4152,44158,17511,5.51149e+13,1441.87,12566.4,61669,1621,519,57517,54991,45185,44342,44107
32501,120,1096,20990,11511,2.93543e+13,534.47,3878.44,32501,421,251,27376,25192,21655,18780,7633
47122,620,2156,28751,18371,3.11284e+13,492.563,6093.86,47122,458,300,44814,44146,33753,18489,17050
19368,1470,1875,13779,5589,3.19327e+13,488.975,4750.59,19368,546,151,17493,17112,17413,17469,16820
48280,1745,3002,34562,13718,4.68175e+13,1256.84,9986.26,48280,1162,326,44878,42554,38107,36914,33312
90556,1304,4059,57742,32814,2.97452e+13,836.486,12639.2,90556,1190,432,86497,85835,74478,51892,42325
51754,1575,2511,32566,19188,3.06937e+13,543.087,7302.73,51754,548,366,49243,49196,44337,38592,37720
16242,339,2667,11873,4369,6.15813e+13,757.592,5301.17,16242,729,161,12608,11475,6076,5033,3442
3772,140,412,2762,1010,3.10942e+13,154.401,1079.59,3772,171,83,3205,2941,2114,1859,1095
21334,7169,11975,17173,4161,2.05214e+13,803.515,14547,21334,2867,16,9359,8544,8991,9079,9174
21202,1228,1582,13333,7869,3.02041e+13,391.423,3975.76,21202,370,239,19620,19616,18662,18997,16675
33850,73,1657,21858,11992,2.99598e+13,470.46,5036.01,33850,426,297,25945,19151,19523,18396,4229
16403,78,1329,10545,5858,2.99589e+13,349.402,3171.55,16403,401,195,13073,10048,10121,8389,3004
74698,1474,2477,48125,26573,2.95461e+13,591.786,8196.08,74698,639,368,72221,72201,69511,68508,59262
46954,462,2290,30104,16850,2.95914e+13,589.321,6842.29,46954,562,361,43889,41748,36944,33732,15243
33345,1293,1682,21511,11834,2.94467e+13,503.244,4937.76,33345,430,288,31663,31660,30834,30181,28996
37489,1938,2040,24746,12743,3.84934e+13,494.476,5547.14,37489,424,272,35449,35449,35334,35369,35104
84040,23640,34904,67238,16802,127450000,1090.76,51489.3,84040,8437,11,49136,49136,44776,49136,33542
59718,423,3864,41996,17722,5.29581e+13,1317.82,11399.4,59718,1346,472,50532,46916,28996,11820,8458
70105,139,2302,45237,24868,2.93958e+13,582.914,7788.85,70105,620,356,59536,55632,47686,40604,12577
15887,749,1166,10407,5480,3.45655e+13,401.029,2983.96,15887,358,202,14721,14697,13842,13068,11152
27785,1132,1644,16974,10811,3.15555e+13,302.759,4236.94,27785,338,230,26141,26133,22703,24092,18660
54281,3581,3654,37290,16991,4.65385e+13,1031.88,9929.27,54281,1091,439,50627,50540,50519,50453,49773
26681,1756,2213,18882,7799,2.64395e+13,599.55,5849.69,26681,809,221,24468,24468,24148,24361,21091
29156,1257,1606,18739,10417,2.93287e+13,457.087,4610.6,29156,465,264,27550,27550,27211,26932,24674
96510,726,4663,64012,32498,3.16533e+13,1140.48,15141.1,96510,1365,426,90018,87719,62272,40693,14662
6219,772,1150,4858,1361,9.20294e+13,187.119,2037.63,6219,154,131,5069,5056,4653,4784,4353
12172,4430,4912,10176,1996,9.16468e+12,233.804,6991.06,12172,1701,12,7260,7260,7260,7260,7260
98826,1358,4218,64955,33871,2.98082e+13,826.752,13712,98826,1260,436,94608,93728,75897,55761,34699
72080,491,2325,46533,25547,2.97131e+13,570.264,7968.2,72080,618,373,68980,64869,58313,56525,27063
48697,2424,3650,33127,15570,4.67422e+13,741.122,9182.01,48697,1023,416,45047,44723,36735,15974,20691
91102,2800,2963,57686,33416,3.03969e+13,746.345,10121.4,91102,659,448,88139,88139,88045,88038,86978
56003,2861,3604,37595,18408,4.33261e+13,830.825,9533.81,56003,1012,423,52399,52391,49430,22127,24977
87111,3310,4216,60834,26277,4.83385e+13,1338.95,14678.3,87111,1738,541,82895,82706,77816,57892,65358
85501,3860,3990,55727,29774,2.9751e+13,702.421,12375.6,85501,1253,390,81511,81511,81511,81511,80111
75884,63,4226,54476,21408,5.06126e+13,1500.48,14194.2,75884,1641,554,49961,35840,23818,12780,3111
6833,506,1195,4610,2223,4.0544e+13,393.774,2355.52,6833,388,102,5452,5216,4768,4908,2475
96684,849,4244,67421,29263,4.57572e+13,1314.43,15514,96684,1774,543,88103,84519,64396,37716,28257
6106,495,618,3917,2189,2.6782e+13,216.488,1423.21,6106,201,111,5488,5330,5397,5308,5064
94434,3325,4135,63420,31014,4.09831e+13,1404.55,13087.7,94434,1382,467,90299,89946,87083,67700,56411
59123,1725,1894,38196,20927,2.95384e+13,577.119,6031.46,59123,555,323,57229,57229,57217,57218,57136
42700,853,1763,27514,15186,2.9584e+13,502.708,5565.26,42700,456,295,40937,40848,38747,38559,34151
93077,7633,24551,76341,16736,2.378e+13,5473.81,40500,93077,7799,26,68162,50788,55236,60035,29567
59876,2058,2557,36999,22877,3.08464e+13,593.241,7511.71,59876,519,376,57319,57238,53757,54992,50463
33903,1593,3378,24968,8935,6.55031e+13,1397.84,8411.88,33903,1048,402,29889,27573,21052,20729,19102
81693,1120,2837,51743,29950,3.01101e+13,676.939,9455.31,81693,636,435,78856,78555,68587,59123,49265
76368,164,690,51809,24559,3.35685e+13,304.032,4712.97,76368,309,266,66706,43712,44677,23534,35756
13725,588,794,8807,4918,2.80959e+13,391.979,2334.63,13725,314,193,12931,12879,12517,12372,12107
55012,2554,2756,33869,21143,3.13435e+13,591.616,7251.58,55012,610,315,52256,52256,52256,52256,52200
89665,3703,4055,59754,29911,4.0207e+13,1257.96,12243.8,89665,1074,438,85610,85610,85370,85214,82618
41062,1566,1779,26392,14670,2.92357e+13,519.811,5598.02,41062,452,296,39283,39283,38972,38854,37673
3541,152,329,2396,1145,3.30035e+13,190.201,950.512,3541,173,82,2845,1818,2036,2212,2133
24150,191,1042,15594,8556,2.90856e+13,512.697,3378.27,24150,385,235,21015,19671,17579,17561,6857
81164,1040,3926,52423,28741,2.94275e+13,673.49,11949.6,81164,1252,372,77184,76270,61362,42575,30017
36905,888,3212,26424,10481,5.96091e+13,1398.85,8695.57,36905,1280,270,31454,29482,19843,18918,11045
15138,810,1193,8976,6162,3.14923e+13,239.307,2546.16,15138,242,145,13945,13943,12157,12900,9867
99858,946,4539,68458,31400,3.90456e+13,1334.58,15627.9,99858,1474,445,92054,88683,68047,47548,31495
57874,252,1968,37158,20716,2.89624e+13,568.481,6231.54,57874,570,332,51803,47833,44899,43137,18543
54550,779,2196,35122,19428,2.96335e+13,560.225,6942.57,54550,543,343,52354,51759,46381,46525,34312
44175,819,2588,31723,12452,2.88257e+13,814.961,7996.48,44175,814,232,41085,39777,32238,35303,25490
14355,916,1371,8729,5626,3.17627e+13,204.452,2883.27,14355,230,148,12984,12972,10916,11662,7286
83261,1469,4166,53611,29650,2.9232e+13,733.937,12395.1,83261,1252,394,79095,78734,67068,54490,36079
80873,119,3921,55592,25281,4.74196e+13,1248.11,12472.1,80873,1384,474,62666,52905,38829,10250,2993
10267,568,1212,7508,2759,2.74247e+13,211.142,2919.05,10267,374,145,9055,8963,6945,6884,4376
42103,2235,2716,28806,13297,2.82986e+13,532.096,7578.91,42103,928,261,39387,39387,39196,39273,34274
79198,3643,4258,56811,22387,4.93373e+13,1470.95,14483,79198,1652,565,74940,74915,73679,69413,69817
75890,9189,21255,62448,13442,2.5547e+13,4637.82,34034.2,75890,7793,22,54635,44856,45813,49240,33995
26301,254,11311,21671,4630,2.46335e+13,1078.4,15470,26301,3113,13,13447,12951,3,6476,189
63882,1103,2554,40948,22934,2.91916e+13,589.732,8100.32,63882,601,397,61328,61211,55869,52327,39065
41411,1547,2818,29315,12096,3.3927e+13,806.026,8492.9,41411,834,239,38593,37742,37409,36293,29452
99288,3708,4658,65688,33600,3.15316e+13,1129.86,15236.8,99288,1370,424,94630,94471,94630,94630,85616
25898,2793,2893,17825,8073,4.85533e+13,477.936,6233.82,25898,742,318,23005,23005,22902,22646,22039
39140,306,2939,23758,15382,3.04841e+13,420.981,6394.01,39140,714,229,35546,33801,24270,8886,6024
72714,1178,3802,49474,23240,4.48444e+13,1179.9,11504.3,72714,1316,473,67682,65405,49975,17570,21624
27918,1097,1990,19724,8194,3.52328e+13,659.305,6008.57,27918,901,167,25804,25019,24980,24539,21737
64891,2307,3762,41932,22959,2.94702e+13,580.543,10439.4,64891,1226,308,61129,61057,60506,60863,40678
70989,991,3763,44664,26325,2.9177e+13,691.11,10500.9,70989,957,390,67216,66626,53853,33244,22606
90191,2367,4082,60282,29909,3.96464e+13,1331.92,12552.1,90191,1126,449,86109,84298,71922,21075,39866
73728,430,3766,49987,23741,4.3617e+13,1164.19,11464.3,73728,1300,446,65649,60511,45943,10591,6916
50762,1574,1877,32799,17963,2.95542e+13,520.283,6238.5,50762,473,318,48885,48883,48406,48040,46030
2670,244,377,2022,648,1.84573e+13,169.248,903.435,2670,170,65,2293,2266,1534,1764,1132
38816,983,2652,26306,12510,2.79818e+13,519.609,7249.17,38816,929,250,36115,35488,28890,23942,12642
13278,2071,9842,10408,2870,3.65874e+13,331.751,10798.4,13278,1739,12,3436,2997,0,2992,777
64085,2320,3564,46195,17890,4.62132e+13,1372.96,12163,64085,1282,385,60440,58847,51058,51824,46123
38113,2058,3615,26502,11611,5.40024e+13,737.882,8551.03,38113,965,411,34498,33618,27168,15145,18442
77905,1171,3913,50176,27729,2.95108e+13,629.323,11597.4,77905,1243,351,73992,73314,61232,48830,31293
35688,636,2829,25459,10229,4.41859e+13,848.58,8242.35,35688,837,310,31316,29967,24386,22922,15382
68602,2851,3749,44677,23925,2.94299e+13,614.298,10775,68602,1226,328,64853,64735,64811,64665,55836
46919,690,1333,30217,16702,2.87537e+13,549.432,4844.81,46919,469,293,45586,45240,41150,41870,37904
91978,1261,3805,61667,30311,4.04111e+13,1205.16,12271.7,91978,1380,464,87147,84658,66891,18454,25112
54308,1328,2349,34876,19432,3.02016e+13,617.515,7356.42,54308,587,370,51959,51889,49037,44803,39209
60450,1034,3518,43376,17074,4.37891e+13,1256.3,11695.9,60450,1262,363,54951,52072,42375,41574,20005
76745,3529,3843,50585,26160,3.65752e+13,1075.62,10759.2,76745,968,383,72902,72882,72734,72671,71340
59746,1040,3682,37818,21928,2.94789e+13,552.402,9758.44,59746,1164,296,56064,55561,43456,28194,19163
78611,1896,4290,56339,22272,4.96895e+13,1463.17,14466.2,78611,1681,567,73624,69652,57536,51557,46305
81185,761,3535,50896,30289,2.99864e+13,836.383,10679.5,81185,887,430,77232,76204,61569,43852,31409
94268,2821,24829,77254,17014,2.38537e+13,5596.56,40995.5,94268,7799,26,58693,43814,44842,27908,18269
32268,307,1711,20741,11527,2.86771e+13,466.327,4832.46,32268,420,267,29165,26551,25576,24131,10681
20139,790,888,13005,7134,2.87844e+13,453.453,2912.37,20139,362,213,19251,19250,19073,19058,19021
17849,696,1464,12878,4971,2.87079e+13,455.042,4219.86,17849,508,175,16368,15572,14047,13893,8178
47248,1379,3065,33920,13328,5.13085e+13,1298.83,9980.81,47248,1190,346,43077,40452,33311,30778,25722
46349,2544,3066,28757,17592,2.90503e+13,439.055,7550.72,46349,931,263,43283,43283,43283,43283,39927
43061,222,2841,28426,14635,2.86186e+13,485.997,7607.85,43061,1019,232,37248,33543,23121,11203,7835
58095,3342,3696,39880,18215,4.68022e+13,1045.55,10459.2,58095,1268,419,54399,54240,53427,49618,41675
60539,2870,4151,42844,17695,5.52285e+13,1453.36,12409.9,60539,1704,505,56388,56242,50464,44328,46544
39712,230,2776,28169,11543,3.36947e+13,777.871,8152.03,39712,857,220,34187,30776,20907,9724,5744
84916,1592,2499,54631,30285,2.94478e+13,592.201,8665.96,84916,651,384,82417,82415,79562,78224,66574
11261,5203,5637,9010,2251,136027000,3.39481,7693.86,11261,1138,11,5624,5624,5539,5624,5194
13540,1826,9815,4835,8705,1.51764e+12,32.5747,10448.4,13540,7539,161,3725,3710,3525,3347,371
1022,105,119,869,153,4.22724e+13,16.6732,226.481,1022,63,58,903,903,840,873,879
47459,1237,3449,31751,15708,4.31549e+13,729.592,8745.66,47459,989,417,44010,42957,33583,9933,10965
87006,4056,4134,59825,27181,4.85033e+13,1305.52,13778.4,87006,1769,473,82872,82863,82767,82449,81763
68251,3686,3803,46186,22065,3.0892e+13,823.842,11314.8,68251,1150,286,64448,64448,64448,64448,63917
29948,255,3559,21192,8756,6.09059e+13,677.467,7830.23,29948,943,405,24310,21822,13173,6282,3807
94483,1901,4240,65248,29235,4.62155e+13,1364.46,14967.4,94483,1788,529,89494,85290,69319,42095,42268
74202,3572,4222,51944,22258,3.78322e+13,1202.98,13432.5,74202,1277,416,69980,69853,67848,68080,65377
15727,742,820,9177,6550,3.16884e+13,260.333,2042.32,15727,221,148,14907,14903,14799,14813,14532
75691,50,3824,51953,23738,4.76411e+13,1167.94,11935.5,75691,1394,466,48276,32064,27951,7632,2142
17595,555,1165,11357,6238,2.90914e+13,439.85,3081.95,17595,360,194,16415,15609,15192,14889,13347
97014,8032,9895,82352,14662,4.21563e+13,17.7367,11150.7,97014,4853,2455,87119,87119,76447,82576,81552
61237,1784,3672,41811,19426,2.96505e+13,770.276,10498.3,61237,1004,282,57565,57274,55349,48889,36562
62947,1517,4093,44433,18514,5.47389e+13,1434.74,12545.6,62947,1706,503,57577,53632,40096,30371,26934
86889,2677,4118,55336,31553,2.95849e+13,757.203,12464.7,86889,1193,415,82771,82664,82671,82719,69435
94515,2644,3392,59207,35308,3.05158e+13,809.958,10805.3,94515,677,458,91123,90997,88000,89209,84921
67885,2155,2245,43613,24272,2.88003e+13,617.806,7556.66,67885,632,340,65640,65640,65597,65638,65545
16947,958,2438,12291,4656,5.98262e+13,718.193,5215.51,16947,699,190,14286,13703,8909,9697,7376
22664,1996,2089,15411,7253,2.60704e+13,419.552,5192.12,22664,797,186,20575,20575,20574,20575,19858
69930,2080,3681,46294,23636,2.9559e+13,707.569,10632.1,69930,1207,287,66249,66007,64827,65570,36406
89913,3900,4222,64725,25188,4.66331e+13,1705.72,15303.3,89913,1713,582,85691,85691,85636,85093,85106
58213,2731,3568,41735,16478,3.95396e+13,1028.83,11312.3,58213,1047,371,54645,54524,50268,51841,50117
27153,876,2645,19185,7968,4.50673e+13,841.143,7034.96,27153,820,280,23814,22683,19282,17603,12696
11800,710,1020,6926,4874,3.15031e+13,227.891,2004.81,11800,237,119,10780,10776,10741,10780,10683
41307,942,1321,26538,14769,2.85311e+13,539.892,4558.93,41307,451,292,39986,39958,38163,38180,36966
98051,1482,4760,65193,32858,3.16781e+13,1141.45,15396.3,98051,1405,429,92957,91066,78550,75560,38911
30168,6416,11939,24518,5650,1.70712e+12,92.5861,12977.2,30168,1012,125,18229,18229,10122,15318,10761
31433,1919,2389,20995,10438,2.75797e+13,476.952,6311.17,31433,919,195,29044,29044,28742,29014,25532
41927,222,1724,26937,14990,2.87197e+13,505.655,5447.6,41927,459,288,37139,34514,31586,30176,15011
19970,692,1512,14436,5534,2.90361e+13,466.47,4477.34,19970,510,185,18383,17592,15360,15058,8858
44025,30,2183,28030,15995,2.99664e+13,573.347,6422.64,44025,508,343,26369,16428,16946,5818,1323
36468,419,2511,25459,11009,2.77806e+13,568.655,6977.85,36468,859,258,32423,30091,20540,9839,5073
70257,1903,2699,44214,26043,3.03191e+13,644.514,8683.29,70257,546,420,67558,67430,62550,60751,53895
84404,772,3948,57521,26883,4.57979e+13,1195.58,12481.7,84404,1416,467,77678,75805,57192,16633,18655
66600,637,2685,41591,25009,3.00351e+13,614.237,8448.33,66600,548,407,63594,62224,51159,39017,26992
2955,723,774,2060,895,3.63898e+13,161.373,1355.77,2955,272,66,2181,2175,2159,2180,1986
73254,300,2276,47119,26135,2.92828e+13,598.029,7906.35,73254,617,371,66940,61772,57997,54664,25991
77006,1976,3866,50704,26302,3.65535e+13,1066.9,10886.1,77006,953,382,73140,72137,59448,14375,20660
30577,3089,3592,22014,8563,6.06655e+13,950.434,8091.29,30577,997,421,26985,26935,26396,21205,22014
72061,3114,3782,48920,23141,4.38836e+13,1137.95,11378.1,72061,1334,449,68279,68027,64951,31898,42552
72871,967,4111,50752,22119,5.18861e+13,1310.58,12996.6,72871,1741,466,65817,62651,44396,23854,17879
45356,420,1757,29221,16135,2.93042e+13,526.593,5433.03,45356,468,297,42495,39100,36800,35715,23572
51483,14316,21880,41190,10293,118973000,967.014,31955.1,51483,5171,11,29603,29603,27098,29603,19552
96525,1843,3897,61234,35291,2.94351e+13,922.503,12368.1,96525,1045,459,92628,91998,84332,68139,65524
31032,638,2300,22110,8922,2.72152e+13,609.982,6302.74,31032,813,240,28194,27050,16369,9898,3940
78362,820,3757,56379,21983,4.36044e+13,1594.23,13666.1,78362,1610,399,70239,66606,47433,47857,23605
61639,2666,3703,42827,18812,3.17415e+13,941.366,11274.4,61639,1033,307,57936,57846,57865,57273,50458
48441,1677,1986,31260,17181,2.94717e+13,543.109,6383.69,48441,531,325,46455,46455,46012,45994,45085
53962,1074,3567,36173,17789,4.24716e+13,801.977,9296.01,53962,1004,412,50192,49096,38544,11153,12367
21277,1450,1452,13699,7578,2.88782e+13,409.102,3856.87,21277,348,235,19825,19825,19825,19825,19824
5710,325,1516,4173,1537,4.43408e+13,243.033,2475.07,5710,404,136,3897,3621,1975,917,444
53983,66,3510,38733,15250,4.0716e+13,966.628,10849,53983,1039,346,35528,24535,17259,7231,775
91303,2178,4043,61700,29603,4.32577e+13,1358.13,12940.6,91303,1381,471,87139,84315,71607,28143,41443
96256,2935,4135,64940,31316,4.2757e+13,1361.21,13678.7,96256,1392,473,92121,91550,84580,35082,55088
13445,1018,1989,9037,4408,4.50479e+13,674.771,4250.86,13445,655,169,11456,10701,10689,10591,5207
34108,467,1663,22011,12097,2.91306e+13,521.359,5073.99,34108,415,293,32035,30222,27686,27212,13286
77090,1407,3449,50789,26301,3.51935e+13,975.091,9854.99,77090,745,353,73641,72850,59823,10445,12957
54745,1115,2426,34694,20051,3.01689e+13,540.219,7422.42,54745,532,375,52319,52237,46038,37610,30098
32439,619,1244,20869,11570,2.95628e+13,567.189,4122.09,32439,466,263,31159,30428,27779,27051,23771
9942,410,767,6399,3543,2.90762e+13,383.438,2039.62,9942,305,154,9054,8482,8254,7884,6688
48561,1569,1888,31297,17264,2.92452e+13,556.129,5748.66,48561,535,309,46673,46673,46582,46543,45607
48849,1271,2953,34601,14248,3.3602e+13,820.783,9387.99,48849,952,249,45896,44446,43047,43409,28338
43435,1059,3753,31416,12019,6.21248e+13,1357.62,9969.65,43435,1210,454,37634,35469,22125,17742,12623
61410,218,2636,39210,22200,3.03403e+13,579.965,8133.7,61410,569,402,54513,50286,43593,34458,12217
31592,11159,13924,25276,6316,145421000,767.111,20021,31592,3179,11,17668,17668,16976,17668,14222
65761,26,2183,42248,23513,2.89301e+13,553.488,7205.19,65761,555,342,34968,17966,21562,9949,3497
15075,222,1278,9730,5345,2.92768e+13,367.361,3157.22,15075,348,204,13084,12226,11249,10292,5866
89659,4335,4449,61927,27732,3.77075e+13,1328.95,14903.5,89659,1429,421,85210,85209,85197,85154,84775
23016,1664,2135,15688,7328,2.73173e+13,464.283,5344.21,23016,811,187,20881,20881,20604,20838,17858
45066,1628,2862,30015,15051,2.87425e+13,489.901,7847.14,45066,1002,250,42204,42198,41098,38246,27190
65772,1633,2383,42769,23003,3.38867e+13,565.254,7176.15,65772,601,336,63389,63383,60448,58571,50925
41096,3482,3736,29921,11175,6.37567e+13,1404.04,9745.02,41096,1220,465,37360,37333,37169,36429,35628
43027,1365,2243,27137,15890,3.04443e+13,520.839,6376.34,43027,483,339,40784,40750,37078,32414,31551
4056,214,582,2642,1414,3.15053e+13,196.491,1218.14,4056,174,111,3422,3188,2947,3030,1600
25418,539,1082,14841,10577,3.19528e+13,316.505,2786.18,25418,361,160,24336,24173,20442,19218,17933
58949,2178,3012,39015,19934,3.67467e+13,793.611,8089.25,58949,712,326,55937,55541,51473,14409,19884
50982,1098,3147,31434,19548,2.93529e+13,541.442,7963.59,50982,919,318,47835,47583,39138,30706,21205
87154,2743,4467,57695,29459,3.06548e+13,884.627,13587.1,87154,1340,353,82687,82385,82093,82187,61877
52228,785,2435,33199,19029,2.98889e+13,563.702,7365.18,52228,537,376,49766,49032,42447,36893,24804
66519,3119,3609,47686,18833,4.72177e+13,1622.3,12431.3,66519,1424,381,62910,62618,60516,60079,59099
41932,1009,3795,30024,11908,6.11765e+13,1190.13,9664.07,41932,1290,461,36415,34579,23590,15019,16107
73810,14575,24158,60187,13623,2.38648e+13,3545.36,35452.2,73810,5576,121,49652,49650,45743,45436,33264
24544,805,1080,14334,10210,3.19448e+13,308.763,2741.82,24544,350,150,23464,23454,22018,22697,21015
67548,222,2653,41915,25633,3.05578e+13,640.112,8365.23,67548,500,412,61307,56663,45649,26958,10539
76321,387,2805,47911,28410,3.0581e+13,653.961,9118.61,76321,587,436,71683,67584,55823,41738,21301
59436,337,3536,42378,17058,4.08571e+13,1089.66,11499.1,59436,1198,364,51042,47993,30122,26105,8270
63798,2076,2192,41208,22590,2.93217e+13,525.931,7035.66,63798,568,345,61606,61606,61500,61469,61163
51729,3076,4007,37017,14712,5.93612e+13,1399.87,11099.1,51729,1432,466,47722,47620,43679,39552,40872
9396,173,563,5481,3915,3.19161e+13,206.164,1345.57,9396,147,123,8674,7793,6758,5237,4038
90477,1574,4084,60158,30319,3.95958e+13,1225.98,12429.1,90477,1096,438,86088,84461,70480,16959,28859
53981,932,2561,34082,19899,3.0408e+13,547.68,7548.4,53981,512,377,51420,51081,43651,34951,23362
71540,9412,20840,58514,13026,2.29684e+13,5162.16,33616.3,71540,6487,21,50700,40740,42507,45236,30456
36509,3661,5196,24954,11555,8.88601e+12,312.743,8113.37,36509,1694,1242,31313,31313,30530,27278,22992
77630,2390,3813,51253,26377,2.97323e+13,707.791,11641.9,77630,1237,360,73817,73578,72691,73330,45520
95688,843,4570,66751,28937,4.06289e+13,1563.27,15813.6,95688,1673,449,86677,82890,57766,38310,18011
19026,511,1815,13602,5424,2.79142e+13,444.744,4538.9,19026,556,148,16886,16645,15127,15897,9256
4792,769,952,3098,1694,3.05105e+13,81.5259,1677.4,4792,196,97,3840,3836,3712,3778,3433
85288,678,2765,55224,30064,3.10322e+13,768.817,9302.92,85288,714,409,82282,81067,68455,38963,14253
74969,4038,4061,50899,24070,3.17361e+13,1041.01,12645.8,74969,1180,338,70908,70908,70908,70908,70896
62357,1651,4102,43780,18577,5.51052e+13,1366.33,12379.8,62357,1745,453,57286,53634,40141,28666,29529
97312,3511,4523,66451,30861,3.73138e+13,1330.33,15321.5,97312,1446,427,92789,92519,88204,88319,82739
6166,371,509,3603,2563,3.18694e+13,176.5,1084.9,6166,114,93,5657,5627,5356,5500,4746
16193,380,1035,10480,5713,3.05057e+13,420.238,2871.87,16193,315,200,14863,13797,13001,12795,9711
52219,1042,3470,35023,17196,4.23529e+13,742.473,9031.54,52219,981,414,48580,47551,37305,9829,10009
57319,2510,3224,35773,21546,2.95748e+13,573.359,8578.31,57319,944,313,54095,54094,54086,54095,49503
23410,1004,1346,15204,8206,3.32872e+13,470.304,3772.16,23410,418,240,22064,22059,21301,21257,20319
55842,843,3546,39308,16534,3.17793e+13,922.569,10553.9,55842,962,287,51467,49510,33952,25789,8424
37030,52,2541,24263,12767,2.84026e+13,456.486,6826.46,37030,993,200,22897,16392,11890,3801,1822
69362,272,2355,44843,24519,3.00659e+13,577.065,7700.97,69362,622,352,62750,57883,53872,49515,13158
10069,199,629,5887,4182,3.26607e+13,221.072,1471.95,10069,190,107,9318,8473,7001,5685,4651
42784,225,3275,30477,12307,5.73792e+13,1487.43,9521.52,42784,1336,324,32409,28324,17833,13641,4758
63501,2273,3644,40182,23319,2.95417e+13,566.986,10029.7,63501,1172,319,59857,59836,59538,59814,46745
44380,2874,2897,31640,12740,4.492e+13,1069.78,9364.82,44380,1051,324,41483,41483,41483,41483,41397
15496,2203,2824,11445,4051,6.50895e+13,637.39,5363.81,15496,672,221,12672,12433,12191,12230,11493
52385,3099,3407,37448,14937,5.19862e+13,1354.2,10779.4,52385,1324,353,48978,48976,48978,48978,48150
68285,2715,2749,42965,25320,3.05207e+13,600.557,8609.76,68285,573,413,65536,65536,65536,65536,65417
91376,1964,4418,62020,29356,3.66513e+13,1221.87,14661.1,91376,1332,417,86897,85168,78887,69915,52501
18243,474,1018,11754,6489,2.96698e+13,459.731,2990.19,18243,323,206,17096,16348,15372,14928,12858
5607,409,681,3601,2006,2.95185e+13,273.619,1514.46,5607,218,135,4926,4645,4607,4379,3374
52942,1414,2018,34281,18661,3.05331e+13,579.634,6750.14,52942,520,351,50924,50919,49298,47796,41163
29981,783,1536,19183,10798,2.91065e+13,498.457,4447.76,29981,432,262,28445,28011,26666,24471,24679
58512,3446,3522,37153,21359,2.90422e+13,489.973,9479.86,58512,1166,287,54990,54990,54990,54990,54363
11684,1292,2232,8442,3242,6.65692e+13,251.047,3831.04,11684,456,290,9452,9411,7111,5819,4781
46548,1471,2248,29862,16686,2.96437e+13,584.881,6729.43,46548,526,354,44300,44256,42471,40475,39826
45022,2368,3734,32553,12469,6.10481e+13,1437.07,10149.5,45022,1280,462,41288,38932,33928,30807,33090
73679,3028,4220,51246,22433,5.12127e+13,1427.29,13574.1,73679,1747,529,69459,69270,63015,48244,53056
15730,4657,10589,12454,3276,2.13725e+13,491.078,12008,15730,2079,11,5141,4363,4998,5141,5141
75510,373,4057,52362,23148,5.07773e+13,1315.97,13093.6,75510,1723,471,64004,58449,41015,17956,8883
40566,1314,2239,29279,11287,2.69665e+13,638.743,7083.9,40566,765,230,38327,38019,37003,37886,30294
23575,12039,12296,19093,4482,3.08363e+13,978.511,15394.4,23575,2718,15,11279,11279,11279,11279,10767
10540,247,604,6157,4383,3.25355e+13,216.062,1464.3,10540,179,113,9907,9626,8009,7248,6047
25798,1671,2968,17726,8072,4.85942e+13,479.485,6281.34,25798,766,321,22830,22623,17115,7699,7094
63207,1888,2271,40822,22385,2.93823e+13,555.204,7373.29,63207,601,339,60936,60936,60349,60228,58868
73182,786,2881,47672,25510,3.35017e+13,629.163,8405.05,73182,604,343,70301,69801,59247,8830,12589
28646,530,3249,20896,7750,6.58613e+13,1241.59,7542.19,28646,984,444,23124,21845,10660,9080,5807
49996,1887,3067,30900,19096,2.93683e+13,469.295,7751.58,49996,929,285,46929,46906,46787,46843,40855
32075,466,1119,20660,11415,2.95467e+13,542.242,3914.69,32075,443,248,30411,28179,26827,25583,18130
93278,25700,36653,75709,17569,1.70527e+12,101.56,38563.5,93278,1898,159,56625,56624,40518,46294,41533
71464,264,4208,50422,21042,5.18185e+13,1371.69,13584.2,71464,1798,522,57834,52479,34955,22243,8462
93188,3034,4017,61042,32146,2.97411e+13,738.473,12945.6,93188,1260,400,89171,89167,89135,88878,77410
79190,2293,2827,50021,29169,3.05333e+13,669.347,9322.21,79190,615,439,76363,76227,72670,73404,67286
30877,234,2289,21669,9208,3.62505e+13,714.226,6844.01,30877,716,207,26118,23054,18436,19765,6772
43673,438,1781,28401,15272,3.24954e+13,512.504,5386.89,43673,468,296,41188,38215,35029,4679,5779
80780,1122,3933,58120,22660,4.56526e+13,1668.96,14135.4,80780,1627,472,73783,69615,56714,55551,29681
18737,67,2547,14082,4655,6.63813e+13,1024.27,5695.01,18737,727,240,11443,7475,4435,3657,744
32025,1951,2290,22399,9626,3.57774e+13,751.791,6990.16,32025,734,211,29735,29735,29658,29722,27453
15960,325,1400,9908,6052,3.05555e+13,242.907,3238.22,15960,275,195,14470,13948,11697,7172,5286
98146,2220,4262,64101,34045,2.96814e+13,846.932,13877.6,98146,1259,434,93884,93523,90621,90730,61732
3448,75,558,2210,1238,2.74288e+13,154.126,1071.81,3448,179,105,2644,2015,2050,1444,290
17099,1587,2858,12159,4940,6.04116e+13,406.455,5543.28,17099,740,326,14241,14030,9149,8134,7148
81368,3548,4236,58133,23235,4.22947e+13,1568.41,14393.7,81368,1505,437,77132,77097,73440,72534,71372
1748,45,255,1107,641,2.30247e+13,74.0932,523.974,1748,80,56,1211,667,959,696,471
78836,1127,2793,50533,28303,2.98806e+13,630.871,9130.95,78836,700,418,76043,75869,68754,63890,50665
14555,647,841,9404,5151,2.9394e+13,440.809,2457.01,14555,328,168,13714,13333,13279,12982,12995
17827,505,938,11454,6373,2.94864e+13,447.162,2851.99,17827,369,198,16846,15834,15334,14973,13620
53885,1147,2083,34666,19219,2.92886e+13,545.81,6725.22,53885,589,324,51802,51775,49171,49136,42743
83045,3914,4101,53135,29910,2.99257e+13,717.774,12352.5,83045,1211,418,78944,78944,78944,78944,77927
27221,935,1775,16565,10656,3.17801e+13,314.167,4294.51,27221,351,238,25446,25425,20334,17774,11221
84423,1674,2821,53227,31196,3.06372e+13,687.499,9618.54,84423,593,461,81602,81360,73979,59632,61532
67384,455,2637,42477,24907,3.03509e+13,628.638,8485.26,67384,583,410,63600,60367,50639,41014,20392
58460,3173,3539,41970,16490,4.96085e+13,1440.66,11553.2,58460,1452,355,54921,54918,54761,54690,54023
30396,307,1568,19512,10884,2.85814e+13,522.116,4455.41,30396,466,245,27447,25493,24142,23149,13421
66197,9694,20469,53542,12655,2.67568e+13,6376.85,32121.9,66197,6378,18,45728,34232,31116,34508,20522
30476,1211,2134,18294,12182,2.98657e+13,311.925,4561.45,30476,599,159,28342,28342,28070,28331,25775
41428,2848,2864,29362,12066,3.4718e+13,783.889,8518.16,41428,855,233,38564,38564,38564,38564,38553
13365,505,796,7803,5562,3.21106e+13,254.432,1880.38,13365,203,127,12569,12501,11531,12024,10471
48316,2673,3673,34646,13670,5.63032e+13,1578.06,10589.1,48316,1446,423,44643,44486,40913,41288,40655
31719,815,2288,22163,9556,3.57541e+13,755.13,6947.4,31719,725,210,28812,27537,26567,24862,18459
66527,377,4060,46669,19858,5.34075e+13,1417.62,12791,66527,1700,509,55162,50266,33518,18214,7715
75965,397,2728,48617,27348,2.97112e+13,597.093,8961.18,75965,645,412,71088,66107,59733,53971,26176
17322,909,951,11140,6182,2.92816e+13,480.728,2819.64,17322,342,204,16371,16371,16326,16357,16338
54085,880,2055,34871,19214,2.96435e+13,552.623,6516.91,54085,513,328,52030,51799,47034,47887,39715
48531,2815,3008,34737,13794,4.72075e+13,1253.58,10017.9,48531,1167,338,45523,45491,45175,44974,44629
5482,134,484,3206,2276,3.26646e+13,168.848,1017.97,5482,116,89,4846,4354,3771,3141,1981
75836,915,3698,54791,21045,4.24273e+13,1322.82,13225.8,75836,1359,396,69193,65717,50090,50399,31224
19187,595,1474,12322,6865,2.98172e+13,509.896,3830.2,19187,412,241,17607,17097,15161,14904,7999
3630,683,837,2585,1045,6.39677e+13,104.497,1430.99,3630,155,103,2793,2792,2773,2776,2129
36730,1958,2018,22541,14189,3.13374e+13,434.261,5352.85,36730,385,289,34712,34712,34702,34712,34496
31405,1257,2269,19106,12299,2.90599e+13,338.017,5066.26,31405,817,159,29136,29136,28849,29053,24279
73712,3455,3872,48348,25364,2.97518e+13,658.194,11345.1,73712,1238,339,69840,69840,69840,69840,65161
26889,32,1077,17361,9528,2.97602e+13,521.275,3575.06,26889,377,238,15677,9424,10543,4327,2190
66065,1687,2387,42487,23578,2.95576e+13,560.343,7425.35,66065,585,348,63678,63657,62613,62390,58189
58183,2195,3054,39154,19029,2.93324e+13,612.881,9025.1,58183,1046,278,55129,55026,53874,54755,45244
13750,9780,10453,10735,3015,3.64105e+13,361.806,11364.1,13750,1792,12,3297,3268,0,0,1476
95739,2020,4053,64840,30899,4.32892e+13,1370.74,13145.6,95739,1409,465,91408,88313,73433,26964,42331
90721,1682,4209,59815,30906,2.99193e+13,823.663,13139.1,90721,1258,410,86512,86032,78362,75705,44444
78884,85,3931,54264,24620,4.68706e+13,1253.41,12384.4,78884,1380,468,57875,43954,34098,10110,2734
27968,1961,12561,22922,5046,2.52521e+13,1225.28,16801.9,27968,3206,13,15407,12951,3,7575,1470
75047,2388,3922,48332,26715,2.9457e+13,625.303,11451.8,75047,1243,355,71125,71084,70633,70964,52130
89500,2339,4268,62890,26610,4.80428e+13,1329.17,15090.6,89500,1798,544,85210,82249,68449,53529,55607
45511,2596,3105,32741,12770,4.21068e+13,996.383,9609.43,45511,887,342,42406,42226,40348,40133,40374
60881,2259,4123,42984,17897,5.60229e+13,1468,12353.8,60881,1678,497,56720,53394,43835,37258,37563
86728,681,4273,60802,25926,4.74623e+13,1350.29,14937.7,86728,1772,538,76942,74016,53352,33462,21276
51942,754,3676,35573,16369,4.72575e+13,929.971,9652.5,51942,1022,429,47166,46220,33490,9789,10163
72995,2308,3900,46252,26743,2.93647e+13,684.028,11103.1,72995,1125,396,69095,68987,68062,68425,55855
14243,256,1186,9123,5120,2.84865e+13,345.765,2947.9,14243,306,206,12588,11735,10772,9088,4287
53640,3647,5381,45594,8046,4.22173e+13,16.9938,6265.85,53640,2694,2689,48259,48259,37882,43930,43076
27268,874,1121,17531,9737,2.94811e+13,535.476,3678.86,27268,432,246,26147,26129,25510,25134,25136
33871,2671,2881,24031,9840,4.79326e+13,1335.54,8248.99,33871,1139,303,30990,30877,30718,30632,30075
64073,1849,3070,42404,21669,3.63975e+13,791.31,8344.35,64073,718,340,61003,60542,52416,12603,15693
40296,319,1255,26056,14240,2.9456e+13,535.954,4454.82,40296,443,270,37087,34217,33072,31317,19476
73998,345,2777,46172,27826,3.03482e+13,652.051,8999.02,73998,537,427,68994,64995,53384,37421,17014
35818,1699,1829,21893,13925,3.10578e+13,362.735,4979.48,35818,382,257,33989,33987,33905,33914,33239
89423,2326,4358,60168,29255,3.48432e+13,1137.82,14052.9,89423,1351,407,85065,84376,79637,78739,63984
37651,142,1264,24262,13389,2.95669e+13,564.968,4380.03,37651,457,274,31752,29782,25550,21524,5284
25014,1715,2612,18324,6690,6.00328e+13,1187.01,6597.14,25014,866,248,22157,20619,16226,17381,16375
49261,3050,3644,33611,15650,4.79355e+13,807.727,9319.32,49261,988,424,45617,45503,43655,22349,26225
14778,561,1426,10587,4191,2.9376e+13,430.508,3829.89,14778,503,153,13272,12491,9689,11059,5008
90129,2170,4191,61969,28160,4.70029e+13,1388.21,14406.2,90129,1800,544,85747,81663,66241,40426,45944
27500,1125,2242,19301,8199,3.83262e+13,676.879,6376.04,27500,686,206,25236,24120,24373,23170,18880
97025,1516,4160,66172,30853,4.51905e+13,1302.97,13971.8,97025,1615,474,91406,87853,68451,28780,31176
38273,866,3739,27769,10504,6.45175e+13,1240.41,9303.83,38273,1270,456,32540,30930,19888,14310,15247
29552,651,1239,17271,12281,3.20003e+13,323.046,3127.91,29552,411,166,28313,28220,23952,22627,21790
10522,569,944,6788,3734,2.95334e+13,346.782,2310.92,10522,273,162,9578,9261,9200,9068,8430
82334,860,2839,51516,30818,3.03132e+13,676.47,9537.76,82334,604,442,79305,78781,65564,51509,40900
56884,248,3335,38884,18000,2.84358e+13,633.812,9453.53,56884,983,279,50216,45738,30646,12607,7300
41457,1415,2047,27315,14142,3.73517e+13,513.447,5720.19,41457,485,287,39410,39404,37432,35226,31145
43141,704,2941,31055,12086,5.05425e+13,1306.66,9415.7,43141,1158,331,37139,35467,26419,24002,15738
28145,351,1423,18195,9950,2.98327e+13,490.414,4093.74,28145,402,241,25644,23618,22231,21359,14066
72764,2375,3642,52315,20449,4.52818e+13,1557.33,13069.8,72764,1504,392,68904,66876,59573,60727,52219
75701,1278,2377,48783,26918,2.94055e+13,619.323,8009.21,75701,653,349,73324,73289,69655,69240,61429
34449,1322,3214,24731,9718,5.91527e+13,1321.37,8242.3,34449,1057,268,30360,28066,20266,21190,17439
67532,2313,2750,44314,23218,3.58377e+13,597.689,7770.23,67532,616,343,64782,64782,64317,64514,63356
82987,3447,4233,58246,24741,4.88144e+13,1340.5,14528.5,82987,1798,531,78754,78628,75557,59626,63743
55762,577,1973,35945,19817,2.91959e+13,541.964,6420.23,55762,515,316,53654,51142,46269,45730,34717
89032,2259,4184,57146,31886,2.99038e+13,801.804,12981.1,89032,1263,418,84848,84627,80761,82120,62238
98541,19140,25232,81123,17418,2.40848e+13,5144.21,41777.3,98541,8486,26,73309,73309,69408,70698,65292
58762,185,2606,37365,21397,3.07436e+13,546.754,7892.01,58762,539,389,51614,47695,39814,29163,11489
37053,652,1246,23917,13136,2.97402e+13,546.642,4318.82,37053,479,271,35807,35294,32252,32030,29935
96062,4358,4419,68898,27164,4.55454e+13,1683.43,16197.1,96062,1817,612,91643,91643,91614,91588,91257
65490,660,2725,43086,22404,3.59881e+13,813.851,7952.46,65490,657,333,62304,61416,47562,7235,7274
11970,1408,1817,8175,3795,2.38731e+13,308.229,3649.5,11970,589,147,10153,10153,10098,10143,9633
2767,194,346,1823,944,3.02097e+13,112.7,735.169,2767,123,59,2421,2402,2362,2342,2018
93723,1609,3984,63783,29940,4.39155e+13,1290.21,13192.9,93723,1392,470,88535,85519,69285,26108,34980
35510,475,2509,23795,11715,4.21914e+13,623.721,6078.52,35510,656,310,32332,30027,22830,3348,2441
97609,64,4687,64648,32961,3.15433e+13,1037.22,15223.6,97609,1378,391,69090,52181,41298,12700,3785
3660,322,864,2307,1353,3.07185e+13,62.0667,1387.1,3660,189,114,2796,2771,2307,1350,916
20311,2309,2933,14879,5432,5.96586e+13,1139.53,6219.62,20311,843,258,17378,16358,16135,16543,15980
16890,746,1368,10599,6291,3.00659e+13,281.751,3320.87,16890,312,205,15522,15511,13968,12793,10753
8054,291,1172,5531,2523,5.10745e+13,226.173,2360.32,8054,231,154,6774,6405,5058,1791,1417
74541,1459,4012,53606,20935,4.06804e+13,1306.34,13418.6,74541,1339,410,69605,66475,57325,55487,33644
97842,1841,4342,63405,34437,2.97581e+13,855.591,13906.7,97842,1267,436,93500,92994,84148,70602,50176
56692,6653,18140,46366,10326,2.534e+13,4482.7,28007.9,56692,6433,21,37390,28197,30212,33533,20792
33814,839,2301,23707,10107,3.53957e+13,805.208,7197.85,33814,757,212,30801,29518,28248,26395,19402
57361,2439,3486,40886,16475,4.11009e+13,1118.69,11253.2,57361,1197,344,53875,53316,49274,50366,45271
42791,1291,2820,30357,12434,3.32276e+13,840.719,8634.16,42791,845,240,39798,38518,36786,35955,25345
95288,3191,4298,61728,33560,2.93934e+13,816.031,13590.7,95288,1263,423,90990,90919,90990,90785,76562
57264,159,1846,36858,20406,2.94504e+13,580.925,5908.74,57264,582,326,48843,45916,39716,34740,12855
13961,303,386,9485,4476,3.37253e+13,284.92,1926.42,13961,243,151,13555,13246,11818,12403,12075
17122,279,1497,12258,4864,3.05432e+13,479.175,4204.06,17122,501,166,14877,14154,8373,5384,3374
19417,1346,2549,14607,4810,6.67889e+13,1050.07,5774.54,19417,745,248,16337,15558,11983,11564,10328
37154,2692,3319,27079,10075,6.17535e+13,1475.9,8694.2,37154,1172,367,33835,33785,32340,32569,32096
18273,734,2032,12379,5894,2.6528e+13,385.041,4660.26,18273,742,174,16241,16019,11623,10725,5292
89537,2161,2788,57978,31559,3.10164e+13,745.89,9369.97,89537,717,398,86749,86559,85455,83533,72761
3067,313,823,1969,1098,2.99668e+13,82.9107,1300.35,3067,189,131,2244,2204,2086,2061,438
9170,899,1148,6512,2658,2.91962e+13,361.524,2759.89,9170,424,118,8022,8014,7930,7980,6927
15997,131,1050,10331,5666,3.10383e+13,440.713,2838.6,15997,348,210,13150,12204,10516,1121,1107
27060,1950,2281,18950,8110,2.64057e+13,572.905,5963.81,27060,831,229,24779,24779,24742,24737,22700
34600,1844,2411,24335,10265,3.53238e+13,825.085,7398.73,34600,818,233,32189,31676,31941,31950,29086
64602,1084,3859,46581,18021,5.39713e+13,1466.24,12506.9,64602,1501,534,57745,53964,40259,36430,27175
49185,271,3007,35420,13765,4.82621e+13,1276.53,10110.7,49185,1169,347,40245,36877,25057,24206,8874
22993,317,1506,14770,8223,2.92816e+13,389.626,4127.53,22993,407,255,20862,19332,18034,16178,9384
50365,1752,3761,35375,14990,5.56977e+13,1139.84,10352.6,50365,1332,461,46139,43800,34253,22547,26366
81137,122,4164,58279,22858,4.95965e+13,1732.49,14511.9,81137,1626,561,59549,46919,30540,13762,4863
27776,1215,2081,20003,7773,3.1142e+13,666.333,5968.35,27776,666,190,25695,24919,25117,25137,22119
50341,1769,3455,31631,18710,2.97021e+13,435.167,8567.59,50341,1117,245,46886,46867,46158,46341,33711
90680,4156,4440,61618,29062,3.68103e+13,1216.33,14665.7,90680,1324,423,86240,86234,86157,85361,84837
39370,1703,2081,25143,14227,2.98288e+13,586.063,5976.26,39370,505,330,37289,37268,36429,36669,34336
42587,324,1768,27364,15223,2.86913e+13,528.611,5354.33,42587,434,290,38847,35806,33838,32586,13344
37856,1249,2679,23340,14516,2.95905e+13,339.502,6129.58,37856,965,161,35177,35169,34599,34160,27153
17482,550,1480,12733,4749,2.88473e+13,301.204,4066.62,17482,390,171,16002,15778,10467,10525,5660
25059,111,2039,18166,6893,2.94801e+13,413.499,5328.27,25059,463,182,19911,16438,11794,1830,1688
44576,1620,4475,37889,6687,4.22211e+13,16.9923,5280.12,44576,2241,2236,40101,40101,22999,32970,31558
3280,152,572,2110,1170,2.95206e+13,125.498,1086.01,3280,180,104,2677,2542,2247,2200,800
87747,1135,3619,55135,32612,2.93592e+13,876.118,11234,87747,948,443,83998,83392,70877,50341,40736
45308,2228,3193,32305,13003,3.6609e+13,884.252,9416.13,45308,876,311,42115,41978,40329,40435,36967
51433,3161,3286,34257,17176,3.99741e+13,719.143,8600.06,51433,896,361,48147,48147,47894,47917,46392
58207,3024,3702,41806,16401,5.18157e+13,1456.68,11708.1,58207,1456,416,54505,54488,53308,53228,52713
11726,551,1217,7521,4205,2.98222e+13,269.774,2697.06,11726,320,176,10509,10439,9927,9353,8288
38492,3042,13515,31416,7076,1.73396e+13,126.161,16316.8,38492,976,157,24977,24976,10029,8269,10028
1888,10,401,1229,659,3.26485e+13,85.0254,712.737,1888,103,70,585,220,192,147,137
38545,1323,1779,24851,13694,2.94504e+13,547.818,5517.33,38545,480,309,36766,36738,35758,34959,32653
56231,2987,3499,40235,15996,3.82929e+13,949.829,10957.1,56231,1054,352,52732,52731,51200,50859,50748
73774,1698,3569,46414,27360,2.99164e+13,775.617,10412.7,73774,964,407,70205,69858,62518,50561,44436
90447,1640,4344,63766,26681,4.77722e+13,1575.49,15443.9,90447,1829,571,84568,80122,65000,47857,38910
17150,772,1397,11094,6056,2.98461e+13,395.04,3490.7,17150,384,223,15753,15708,15299,15043,13194
10951,305,649,7057,3894,2.9531e+13,334.892,1897.18,10951,240,157,10042,9449,9172,9193,6171
42808,2060,2198,27241,15567,3.07789e+13,624.661,6331.17,42808,535,342,40610,40610,40501,40548,39787
46372,222,3165,32865,13507,3.46981e+13,903.484,9451.65,46372,935,288,38802,34748,23791,10900,5850
42389,2328,3359,30321,12068,5.42495e+13,1445.46,9718.53,42389,1264,333,39030,37318,32432,33109,32963
15013,396,863,9731,5282,3.03163e+13,458.839,2567.8,15013,338,189,13802,12828,12312,11824,8654
45565,1104,3037,32525,13040,4.33757e+13,1099.12,9608.49,45565,997,333,41553,39528,34359,33468,24834
66407,4102,4171,46785,19622,5.3604e+13,1468.19,13076,66407,1707,526,62236,62235,62180,61913,61254
20438,597,941,13097,7341,2.86463e+13,454.727,3020.29,20438,331,226,19497,19326,18175,17713,17089
91824,348,2953,57960,33864,3.01114e+13,726.888,10114.1,91824,681,461,85516,79921,68931,53211,29861
80075,2422,3985,53590,26485,3.17797e+13,973.201,12703.8,80075,1254,306,76090,75734,74542,74571,58233
92085,1676,4487,63157,28928,3.68145e+13,1321.84,14949.3,92085,1437,423,86995,84213,76874,67618,40788
34064,2342,3344,23106,10958,4.66109e+13,630.138,7727.62,34064,884,389,30720,30600,25948,13168,14283
39603,701,2151,25149,14454,2.96667e+13,543.909,6051.68,39603,456,336,37370,36685,31362,26559,14829
74568,3776,4181,53676,20892,5.08397e+13,1484.93,13856.8,74568,1587,557,70387,70384,70296,68866,68675
50026,923,17137,40704,9322,2.34315e+13,4681.28,26091.7,50026,5490,17,23932,21171,19688,11056,4037
32195,1236,3455,22366,9829,5.46753e+13,668.965,7850.59,32195,954,404,28668,27685,20650,11039,11063
1388,130,267,809,579,3.2933e+13,53.0879,424.637,1388,52,44,1121,1070,994,1058,683
35337,365,2572,23973,11364,2.7773e+13,516.935,6889.51,35337,909,235,31064,28789,20399,12466,7128
6910,101,942,4946,1964,3.01283e+13,263.402,2168.92,6910,387,100,4256,1923,2372,998,600
69131,1613,4125,49721,19410,5.29379e+13,1433.12,13311,69131,1574,529,63866,59619,47769,43779,38236
14856,456,810,9529,5327,2.90542e+13,434.779,2453.42,14856,310,180,13842,12959,12797,12128,11471
23375,2054,10636,18702,4673,130869000,584.854,15089.8,23375,2353,11,12739,11676,10162,11924,2460
30779,477,1650,19589,11190,3.08196e+13,492.945,4727.68,30779,426,269,28769,27612,24764,20622,17544
76079,3982,4250,53125,22954,5.0034e+13,1395.25,13808.4,76079,1803,524,71829,71812,71342,69835,65076
60358,631,3540,37800,22558,2.95546e+13,540.111,9292.66,60358,1023,315,56656,55630,42272,25105,21188
79848,607,2747,51162,28686,2.99492e+13,638.719,9117.18,79848,641,426,76671,74316,64200,58498,38702
24483,1250,2783,17268,7215,5.45193e+13,1126.6,6869.85,24483,932,289,21300,20141,15768,15580,11671
18719,534,932,10930,7789,3.22513e+13,266.436,2302.24,18719,282,147,17787,17728,15907,16382,14436
61250,1062,3802,44058,17192,5.35952e+13,1443.24,12099.2,61250,1464,511,54564,50970,37949,34326,25642
55341,1017,3864,39177,16164,5.49824e+13,1319.21,11125.5,55341,1379,468,49276,46680,30393,17557,13325
25821,324,1817,17358,8463,4.58689e+13,433.797,4604.15,25821,403,263,23120,21255,17320,4635,3180
67007,773,2602,43100,23907,3.02706e+13,600.3,8359.77,67007,628,402,64344,63565,55895,52831,35569
79985,1145,4291,53109,26876,3.54412e+13,1081.2,13057.8,79985,1168,382,74798,72512,61127,52922,35381
58077,2442,3606,36503,21574,2.95745e+13,536.373,9322.84,58077,1052,307,54471,54469,54357,54465,46600
15896,985,1733,9438,6458,3.0781e+13,230.685,3048.69,15896,349,138,14163,14163,13990,14157,13655
14671,2545,3270,10757,3914,1.86393e+13,283.105,5853.48,14671,1158,145,11401,11401,9404,9310,8933
98103,2691,3054,62082,36021,3.01325e+13,749.609,10491.3,98103,691,468,95049,94981,93161,93844,89753
34568,322,2430,24316,10252,3.54957e+13,760.315,7392.03,34568,782,216,30036,28294,21464,22008,5889
61742,1675,3810,43189,18553,5.14612e+13,1235.76,11251.3,61742,1310,468,57057,54210,42870,22076,26129
28792,673,1060,18625,10167,2.98411e+13,519.863,3654.74,28792,423,243,27732,27477,25900,25401,24524
65377,1743,2664,40694,24683,3.09895e+13,635.584,8223.63,65377,524,393,62713,62535,55592,47603,43540
34675,601,1663,22380,12295,2.92228e+13,462.21,5047.72,34675,414,289,33012,32445,29282,28165,21943
16493,712,1300,10659,5834,2.96696e+13,390.811,3293.43,16493,339,197,15193,15093,14765,14834,13438
4342,613,1205,2978,1364,5.78603e+13,164.584,1946.31,4342,303,140,3137,3118,2734,2964,1270
75152,2058,2754,48744,26408,3.17869e+13,701.101,8734.12,75152,665,363,72398,72229,71249,69844,62834
94913,4393,9483,80717,14196,4.20959e+13,18.3593,10680.2,94913,4744,4739,85430,85429,54918,72711,70179
76519,296,4257,54941,21578,5.04612e+13,1455.21,14131.4,76519,1629,566,63348,58504,35105,27977,9843
94367,2105,3959,64035,30332,4.37514e+13,1269.64,13182.2,94367,1447,476,90238,86775,73556,30691,45355
91346,3222,3464,59873,31473,3.43492e+13,1064.4,10868.6,91346,761,392,87882,87769,87407,86917,83092
6383,333,530,3720,2663,3.17327e+13,168.066,1132.63,6383,106,95,5853,5817,5256,5496,3993
88835,20169,21335,65082,23753,2.29035e+13,227.082,27683.8,88835,1858,190,67500,67500,66577,67347,66518
89375,513,4396,59858,29517,3.33486e+13,1139.55,13988.6,89375,1359,390,81147,76844,52934,31433,19676
81628,1229,4046,54130,27498,3.14115e+13,931.372,12464,81628,1315,304,77316,75536,67318,57273,35166
85458,709,3951,58393,27065,4.62735e+13,1217.83,12563,85458,1414,476,78402,76338,55537,15605,14543
68057,3446,3801,46752,21305,3.1181e+13,969.014,11879.1,68057,1096,310,64256,64121,64256,64256,61572
46303,2127,3369,33183,13120,4.18637e+13,942.05,9900.29,46303,888,344,42934,42520,38682,37598,34666
67035,2410,3820,48305,18730,5.11675e+13,1392.99,12631.8,67035,1466,493,63215,61024,52979,54298,53284
4511,327,892,3048,1463,4.6889e+13,115.377,1563.37,4511,217,117,3619,3564,3032,1097,1181
89054,1151,4314,63043,26011,4.72682e+13,1407.03,15270.4,89054,1766,560,81692,77465,60957,45042,33667
33390,5809,13156,27089,6301,1.71399e+12,93.5159,14257.4,33390,1056,132,20234,20232,9327,15011,10155
22977,1328,2467,15713,7264,4.91272e+13,490.749,5213.88,22977,638,289,20510,20335,16610,6891,6401
7918,165,1167,5014,2904,3.02472e+13,161.335,2270.35,7918,254,149,6606,6176,5271,3283,2031
83085,1880,4382,57358,25727,3.6947e+13,1252.63,14263.1,83085,1373,412,78577,76667,70444,63200,45705
72259,499,4011,45491,26768,3.05551e+13,706.208,11010.8,72259,990,395,67106,64437,49119,31879,13105
91048,2604,4689,60791,30257,3.22784e+13,1212.14,14589,91048,1374,378,86359,85697,84114,84822,59473
32895,2098,2852,23626,9269,5.83106e+13,1435,8044.94,32895,1139,306,30038,28026,23218,24351,24811
64369,2877,3786,44401,19968,3.17062e+13,940.191,11531.9,64369,1054,302,60583,60444,60562,60282,54457
42098,495,1932,27148,14950,2.96097e+13,544.52,5981.05,42098,487,312,39700,37132,33928,32719,19593
96531,149,4704,63889,32642,3.12541e+13,1090.44,15050,96531,1367,412,79456,66899,51655,14390,5153
29521,2406,2507,20720,8801,3.82761e+13,786.859,6952.2,29521,817,253,27014,27014,27014,26996,26938
99964,3339,4389,65283,34681,2.95623e+13,841.599,14157.6,99964,1258,446,95575,95480,95575,95291,81159
4406,410,658,2798,1608,2.76615e+13,137.645,1281.71,4406,172,98,3748,3682,3573,3507,3121
44175,1809,1829,28539,15636,2.99092e+13,538.21,5576.11,44175,480,300,42346,42346,42346,42346,42318
72932,361,671,49494,23438,3.35901e+13,301.995,4590.68,72932,308,264,72261,72261,54769,56188,49722
44971,1101,2227,28774,16197,2.95724e+13,578.214,6613.73,44971,533,351,42744,42661,39768,35642,26128
93964,1085,3649,61612,32352,3.46143e+13,1193.07,11412.8,93964,853,381,89781,89109,71568,9505,13290
58068,1339,1744,37478,20590,3.02663e+13,575.685,5839.66,58068,545,339,56324,56318,54819,54186,52488
66462,19466,19535,54741,11721,2.28512e+13,4125.68,31188.9,66462,6729,21,46927,46927,46927,46927,46790
41697,1236,1359,26717,14980,2.90606e+13,576.445,4716.66,41697,520,286,40338,40338,40094,40061,40050
80555,625,728,54688,25867,3.36748e+13,305.597,4871.36,80555,311,270,79827,79827,77028,77677,77028
86686,2294,4375,62146,24540,4.79577e+13,1709.71,15380.1,86686,1817,562,81787,78614,66713,62610,56559
51965,1437,3114,37068,14897,4.19775e+13,1159.98,10310.4,51965,1124,344,48398,45984,42106,39857,32018
1698,145,452,1151,547,9.42306e+13,61.8875,794.697,1698,212,24,1246,1246,775,957,893
94034,1667,4494,65648,28386,4.11938e+13,1550.42,15589.5,94034,1576,451,88354,84809,74116,64111,42216
1367,204,254,803,564,3.32375e+13,51.9685,408.404,1367,46,46,1113,1085,1087,1097,923
49271,2221,4935,41897,7374,4.21279e+13,17.0423,5791.08,49271,2472,2466,44336,44336,28076,37557,36091
87328,643,3954,56795,30533,2.94493e+13,695.768,12411.3,87328,1257,388,82485,80481,59014,39907,27065
31997,1276,1665,20673,11324,2.9575e+13,499.676,5049.65,31997,453,284,30332,30317,29619,29358,27559
5081,514,881,3303,1778,3.05537e+13,175.891,1671.37,5081,223,109,4200,4050,4000,3957,3379
44454,2560,2706,31187,13267,2.86963e+13,581.508,7758.98,44454,873,272,41748,41748,41745,41748,40529
14086,77,791,9075,5011,2.93539e+13,410.3,2367.25,14086,284,187,11060,8385,8392,7840,2025
76619,724,2403,49213,27406,2.87115e+13,577.096,8209.14,76619,633,365,74216,73453,64692,64655,47190
29311,1232,1485,18972,10339,3.05512e+13,558.02,4379.7,29311,421,266,27826,27821,27256,26724,26659
67089,1222,3991,47754,19335,3.79452e+13,1183.62,12566.3,67089,1179,396,62202,59725,47352,42085,28176
29840,423,1119,19247,10593,2.93452e+13,522.974,3760.73,29840,438,246,28081,26056,24621,23503,16089
55325,2860,3306,37988,17337,2.83598e+13,637.86,9301.61,55325,969,279,52019,51987,51984,52017,50118
38006,1013,2914,22977,15029,3.04644e+13,429.387,6228.48,38006,689,231,35092,34917,27663,22661,15311
2155,27,490,1379,776,3.08918e+13,104.207,870.518,2155,137,85,1080,552,636,327,223
14157,728,792,9164,4993,2.9286e+13,395.157,2351.41,14157,307,173,13365,13365,13288,13282,13199
54262,2003,2064,35010,19252,2.93576e+13,564.278,6720.44,54262,537,331,52198,52198,52177,52179,52168
66851,2032,2828,43551,23300,3.33589e+13,604.916,7864.33,66851,594,343,64023,63986,62979,63018,59703
18845,1509,2555,14076,4769,6.46942e+13,995.903,5726.14,18845,733,234,16036,15150,12718,12743,11520
78276,667,2753,49533,28743,2.99699e+13,663.638,9182.55,78276,594,425,75221,73837,62287,51746,36792
25110,911,3043,18361,6749,6.21844e+13,1247.64,6980.14,25110,1011,264,20889,19427,13724,12104,10269
80788,903,4251,55056,25732,3.45277e+13,1094.84,13451.7,80788,1203,394,74960,72646,56812,39112,22950
45077,330,1419,29082,15995,2.96791e+13,577.707,4940.23,45077,532,296,41560,38171,36497,34706,19009
5533,29,752,3582,1951,3.16428e+13,262.816,1569.24,5533,284,122,3081,2022,2030,940,606
13503,462,911,9856,3647,3.23237e+13,204.04,2815.71,13503,299,139,12592,12582,11924,12359,7301
86632,450,4328,61451,25181,4.75599e+13,1601.72,15274.3,86632,1787,565,74388,70161,43129,25634,7051
55311,2991,3599,34736,20575,2.93461e+13,519.063,9121.81,55311,1053,306,51712,51712,51712,51708,49902
16703,65,873,10777,5926,2.93299e+13,442.687,2663.96,16703,328,191,12442,8823,9624,7930,2453
71503,27,2737,45290,26213,3.01049e+13,644.832,8859.26,71503,589,414,42061,26256,26021,7591,3179
22115,2090,2131,15159,6956,2.76095e+13,471.517,5259.22,22115,807,186,19984,19984,19984,19984,19934
1148,254,470,787,361,4.38897e+13,68.6359,687.834,1148,183,43,678,656,574,561,441
28760,6544,13057,23516,5244,2.55203e+13,1415.89,17377,28760,3899,13,15703,13930,14374,14640,15703
78877,1667,4116,54557,24320,4.9941e+13,1372.72,13484.1,78877,1734,494,73687,69583,54279,32280,31901
39102,2821,3219,28011,11091,5.98519e+13,1448.26,9011.96,39102,1332,283,35883,35879,35869,35883,34990
8387,496,740,5391,2996,2.86612e+13,366.541,1867.08,8387,297,149,7647,7228,7206,6975,6423
20918,358,1959,12455,8463,3.05865e+13,270.29,3675.72,20918,463,145,18959,18346,14427,12104,10667
16919,112,883,10950,5969,3.03035e+13,439.206,2709.41,16919,305,201,13901,12754,10905,9584,4366
10943,670,792,6977,3966,2.8204e+13,403.405,2147.56,10943,331,169,10151,10132,9918,9945,9797
6813,311,879,4923,1890,2.67569e+13,245.864,2091.86,6813,326,102,5912,5676,3788,3259,2514
91357,4131,4516,60536,30821,2.99735e+13,999.748,14009.3,91357,1264,405,86841,86841,86841,86841,85802
68474,564,2259,44223,24251,2.98513e+13,595.455,7734.84,68474,594,376,65851,63106,55625,54408,31833
16239,1960,2548,11621,4618,5.87864e+13,558.671,5228.68,16239,640,215,13691,13444,12087,12318,11875
88306,592,3989,58103,30203,3.645e+13,1254.32,12038.2,88306,1055,436,82570,79323,63556,9404,8830
9508,552,993,6272,3236,3.62041e+13,298.834,2218.35,9508,274,161,8515,8211,7686,7359,3600
96968,3425,4027,61505,35463,2.97214e+13,950.658,12666.7,96968,1086,469,92941,92777,92941,92941,90835
53045,1712,2420,33848,19197,2.98912e+13,582.45,7406.68,53045,571,375,50625,50590,48626,47342,46188
31443,1005,2660,22236,9207,4.05415e+13,803.882,7492.05,31443,818,277,28284,26924,24715,23030,18417
93445,2773,4130,62957,30488,4.18129e+13,1398.15,13242.4,93445,1372,473,89315,88697,80107,31075,48564
87548,3740,4506,57977,29571,2.97164e+13,893.772,13550.2,87548,1254,385,83042,83026,83042,83042,78280
92342,1331,3662,60568,31774,3.40169e+13,1167.77,11229.8,92342,810,385,88400,87593,71939,10917,14792
6842,70,684,4381,2461,2.88386e+13,322.221,1645.52,6842,245,144,5074,3759,3899,3643,1173
92695,1712,4448,62654,30041,3.6281e+13,1230.59,14654,92695,1363,420,87929,85800,78420,67917,41682
8206,1057,1857,6121,2085,5.76596e+13,197.752,3258.27,8206,503,140,6349,6349,4579,4528,3978
37352,1573,1967,22357,14995,3.14557e+13,377.433,4989.21,37352,454,254,35385,35337,33254,34127,31553
34199,585,2458,24197,10002,3.52781e+13,777.83,7360.85,34199,755,222,30688,29314,25351,26361,12038
63779,25754,34904,55879,7900,8.60878e+11,18.4478,35438,63779,2532,51,28875,28875,22380,24638,21781
30378,304,2825,21616,8762,5.44609e+13,1402.46,7708.04,30378,1119,285,23345,21134,13994,10906,3326
47213,1723,3356,29665,17548,2.97442e+13,458.038,8085.95,47213,1131,195,43857,43852,43291,43469,30757
41199,885,2949,25429,15770,2.89345e+13,389.96,6850.46,41199,913,189,38250,38101,29248,21856,14696
3469,146,996,2973,496,301318,5.13116,1714.01,3469,498,5,2473,2473,2118,2473,778
76002,111,3896,52237,23765,4.80719e+13,1173.19,12012.6,76002,1401,464,58798,48954,35508,8610,1772
46082,200,557,31265,14817,3.36588e+13,303.51,3612.99,46082,298,243,43813,40304,30074,23713,27112
43136,1304,1965,26120,17016,3.11659e+13,412.566,5463.1,43136,469,272,41171,41069,35974,36652,31220
13087,864,1291,7858,5229,3.19799e+13,205.596,2615.76,13087,225,145,11796,11791,9815,10545,6554
80126,1428,3753,53530,26596,4.09716e+13,1185.59,11081.8,80126,1034,432,76001,74573,61476,16417,26573
76707,3296,4215,53835,22872,5.08562e+13,1402.66,14065.2,76707,1763,522,72492,72353,67902,55629,59451
63310,1576,3615,40012,23298,2.94083e+13,550.897,9805.51,63310,1081,316,59695,59543,54091,54607,40777
96712,4024,4405,65585,31127,3.62848e+13,1279.7,14998.8,96712,1447,417,92307,92281,91653,91085,90425
34478,2278,2320,24731,9747,2.75585e+13,620.225,6569.08,34478,806,242,32158,32158,32158,32158,31916
90163,528,2837,57849,32314,2.94798e+13,673.487,9668.99,90163,695,431,86431,82107,72666,67400,38981
84818,1262,3974,55698,29120,2.97263e+13,740.353,12381.9,84818,1253,396,80820,79932,64376,52284,28140
88607,256,3972,58312,30295,2.97021e+13,741.214,12673.7,88607,1253,404,79833,74738,52516,20195,11398
57786,1001,1706,37444,20342,3.07596e+13,607.428,5823.53,57786,535,323,56080,56039,51380,51747,45512
2798,254,704,2140,658,9.03308e+13,106.741,1130.53,2798,107,97,2094,2013,1062,1288,975
59227,1961,3572,37256,21971,2.97152e+13,551.532,9359.24,59227,1059,310,55655,55593,54825,55234,45150
84130,2258,3597,55281,28849,3.49219e+13,1149.3,10896.9,84130,833,361,80533,79675,73239,17570,26540
81430,1121,4235,57892,23538,4.11349e+13,1335.87,14291.3,81430,1414,446,74961,71539,52690,45873,19470
56004,3138,3829,39638,16366,5.53665e+13,1232.61,10918.7,56004,1338,467,52175,52029,49386,33821,37487
12433,835,2622,9158,3275,6.91939e+13,347.598,4568.06,12433,603,161,9811,9473,4905,5831,2159
66337,516,2667,41893,24444,3.06794e+13,646.781,8503.04,66337,566,415,62881,60431,50023,40672,22595
1637,805,839,1047,590,6.31878e+13,42.6347,1088.31,1637,228,70,798,798,798,798,764
71562,525,3861,51630,19932,4.99666e+13,1465.43,13129.8,71562,1467,538,61375,58332,36981,37032,14437
81804,2879,3906,53164,28640,2.9602e+13,679.218,12017.8,81804,1238,384,77898,77780,77693,77671,66213
80019,787,3798,53956,26063,4.23686e+13,1170.67,11774.2,80019,1335,446,74112,72399,53999,14064,13383
91782,1569,3943,60282,31500,3.5669e+13,1219.97,11932.1,91782,1013,381,87809,86604,71466,12984,18868
18839,295,1435,12150,6689,2.91348e+13,416.145,3634.75,18839,396,216,16761,15612,14758,13612,8129
88451,951,3823,59365,29086,4.09851e+13,1213.66,12150.5,88451,1351,476,82770,80725,62575,15994,18018
9835,53,702,5740,4095,3.20948e+13,218.492,1575.78,9835,166,108,8095,7434,5243,2579,1053
30214,704,1091,19479,10735,2.89913e+13,498.598,3736.54,30214,379,254,29123,29025,27230,26594,25342
82843,2185,2468,53445,29398,2.96241e+13,597.062,8536.04,82843,644,384,80375,80375,79772,79330,78753
73135,1955,3693,49285,23850,4.23689e+13,1063.97,10860.9,73135,1086,438,69276,67612,56507,19433,30542
28475,126,1752,17180,11295,3.17772e+13,323.691,4282.79,28475,370,232,24979,22586,17370,5990,2651
5749,524,668,3699,2050,3.01846e+13,287.811,1514.27,5749,242,135,5081,4905,4868,4803,4523
96244,2929,4281,63136,33108,2.97959e+13,856.893,13737.6,96244,1260,436,91963,91671,91501,91566,66322
62800,2434,3587,45201,17599,4.88948e+13,1420.72,11975.8,62800,1455,358,59213,57427,52119,52682,52052
78451,3321,3511,48832,29619,3.012e+13,785.198,10160.6,78451,652,434,74940,74886,74940,74940,74923
94614,426,4444,65357,29257,3.89719e+13,1331.45,15227.1,94614,1445,437,83169,78408,51532,27238,17372
63162,232,3856,44218,18944,5.23451e+13,1230.86,11475,63162,1364,468,51470,46428,31066,10386,4486
89280,1596,4384,63355,25925,4.14468e+13,1626.27,15219.4,89280,1682,451,83455,79541,69335,67073,39742
9939,435,675,6384,3555,2.99046e+13,324.896,1923.69,9939,238,159,9264,8893,8911,8816,7859
34620,1194,1215,22309,12311,2.95458e+13,546.744,4181.38,34620,452,273,33405,33405,33384,33387,33393
28809,522,2812,20908,7901,6.06544e+13,1258.65,7363.78,28809,1023,258,23317,22016,13291,12009,6306
11355,29,987,7356,3999,3.08617e+13,388.24,2417.34,11355,326,154,6252,3644,4089,1786,869
39815,3575,3791,28211,11604,5.86011e+13,1153.25,9356.1,39815,1337,455,36024,36003,35840,35701,35076
68107,2215,3892,47533,20574,5.10286e+13,1279.83,11994.3,68107,1439,465,64133,60651,51816,32249,38142
35440,2934,3380,23993,11447,4.69257e+13,686.692,7913.99,35440,972,413,32060,32058,31031,29716,22851
96345,2411,4549,63688,32657,3.08436e+13,1008.65,14565.3,96345,1367,404,91796,91366,90016,90840,55802
83442,3066,4024,52676,30766,2.96228e+13,795.932,11774.9,83442,1035,431,79418,79286,79410,79418,72979
75773,441,3667,50630,25143,4.1117e+13,1001.6,10639.6,75773,1007,434,69205,63866,51826,9738,13104
48149,1366,2953,34138,14011,3.35381e+13,810.978,9305.24,48149,938,249,45196,43886,42854,43440,29161
16462,60,843,9625,6837,3.2299e+13,258.43,2071.11,16462,250,138,13832,12601,9302,3245,2212
18597,530,2543,14129,4468,6.97714e+13,1120.69,5646.19,18597,687,249,14647,13986,5929,5514,2106
14360,641,1263,10154,4206,2.91229e+13,547.296,3571.05,14360,697,129,12969,12044,10591,8856,9374
69738,2482,3679,50136,19602,4.51777e+13,1543.64,12836.3,69738,1411,379,65956,65201,56922,58872,52547
27079,2962,3479,19603,7476,6.36326e+13,973.255,7661.63,27079,889,404,23600,23569,22782,20101,20395
47479,1862,1882,30542,16937,2.88475e+13,542.674,5845.82,47479,479,303,45597,45597,45594,45590,45571
18865,518,1854,13297,5568,2.66847e+13,536.149,4673.34,18865,776,171,16440,14244,9453,6114,2330
90945,648,3705,59800,31145,3.53691e+13,1208.6,11613.1,90945,970,372,86199,83962,66944,9909,10974
56845,1409,3420,40755,16090,4.89019e+13,1312.51,11261.1,56845,1307,355,52256,48806,41949,38585,32286
65585,2222,2719,40963,24622,3.02505e+13,632.711,8417.14,65585,529,395,62866,62815,59751,60955,56111
60763,2061,2147,39119,21644,2.95723e+13,576.901,7222.73,60763,554,368,58616,58616,58515,58532,58507
33142,458,1877,20724,12418,3.13363e+13,446.511,5090.1,33142,393,268,30910,29781,24778,17282,14656
31669,509,1737,22813,8856,2.93576e+13,638.171,5702.66,31669,696,217,29154,27804,18122,10616,14400
47878,2429,18792,38864,9014,1.71465e+12,96.8195,20132.8,47878,1265,146,29086,29068,4836,9927,6394
15783,1149,1282,9377,6406,3.19884e+13,243.267,2660.85,15783,250,152,14501,14501,14277,14331,13721
59293,796,4046,42534,16759,5.59965e+13,1497.21,12249.5,59293,1567,524,50985,48118,31938,27790,17428
26128,601,1707,15539,10589,3.15232e+13,305.642,3851.77,26128,369,183,24421,24287,17283,6369,4156
33227,329,1377,21506,11721,3.15084e+13,547.215,4326.33,33227,454,267,30395,28000,25713,3682,4180
64990,1370,3666,43599,21391,4.26377e+13,908.636,10092,64990,1030,429,61285,59939,48010,13951,17012
56276,975,4121,39953,16323,5.74689e+13,1518.2,11979.8,56276,1660,493,48965,45571,30470,24254,16262
63361,2397,3929,44209,19152,5.10615e+13,1281.07,11715.6,63361,1426,466,59432,57133,50377,31657,37421
25418,1497,1948,17141,8277,4.74266e+13,406.187,4755.92,25418,376,267,23470,23462,22658,21695,16867
62134,1657,3782,44517,17617,5.0836e+13,1424.17,12165.6,62134,1460,437,57405,53561,45406,42749,37493
27351,996,1092,17559,9792,2.89488e+13,536.13,3632.06,27351,407,238,26259,26259,26089,26069,26001
38789,931,1775,24992,13797,2.97117e+13,514.069,5575.84,38789,453,317,37014,36955,34309,33079,22229
83036,3352,4009,52589,30447,2.96522e+13,771.759,11756.5,83036,1075,421,79027,78939,79027,79024,76796
95932,328,4496,63273,32659,2.97688e+13,996.94,14221.1,95932,1273,414,86752,81635,56965,27844,12231
75107,3708,4165,52763,22344,3.71915e+13,1262.63,13498,75107,1373,409,70942,70900,70118,69538,68775
89829,4516,4629,59574,30255,3.1831e+13,1035.42,14292.9,89829,1350,350,85200,85194,85200,85200,84384
17096,713,1285,12125,4971,2.70319e+13,612.052,3961.17,17096,737,143,15627,14774,13219,12532,11922
12790,493,809,8278,4512,3.02587e+13,386.449,2267,12790,254,182,11966,11661,11169,10616,8176
64569,1550,2132,41488,23081,2.91001e+13,541.185,7107.17,64569,528,338,62437,62427,61440,61008,55817
77183,1334,2744,48014,29169,3.03698e+13,658.5,9071.93,77183,550,433,74439,74125,64247,46322,45610
9350,585,1545,6277,3073,5.10921e+13,403.002,3171.8,9350,590,118,7632,7252,6768,6741,3186
66576,3577,3815,46007,20569,3.14205e+13,992.767,11780.5,66576,1092,323,62761,62674,62761,62761,61161
99045,4059,4667,65605,33440,3.14099e+13,1069.7,15263.4,99045,1368,409,94378,94292,94378,94378,90425
26114,385,1294,16906,9208,3.16403e+13,490.882,3830.09,26114,385,252,24034,22250,20277,5698,3656
44188,583,3846,31846,12342,6.13431e+13,1266.29,10032.6,44188,1297,446,37276,35490,19378,11286,5743
28078,18,1109,18169,9909,2.97382e+13,529.717,3682.52,28078,404,238,13207,5294,7400,2176,852
58831,3217,4160,42057,16774,5.68085e+13,1517.96,12299,58831,1662,515,54671,54574,50934,48429,49158
87360,393,747,59245,28115,3.3553e+13,304.068,5071.71,87360,312,272,86613,86613,66260,66707,59211
11311,932,1216,8132,3179,3.17828e+13,427.141,3169.01,11311,489,117,10095,10095,9930,10066,8415
39349,1801,2616,27850,11499,3.36228e+13,871.697,8092.89,39349,830,257,36733,36107,36323,34327,32122
1670,163,290,975,695,3.18398e+13,50.4467,482.465,1670,49,57,1380,1360,1270,1338,958
21204,1170,1563,15372,5832,2.99176e+13,412.666,4578.08,21204,453,185,19641,19481,18959,19426,14802
94025,128,4289,60832,33193,2.94109e+13,808.467,13471.2,94025,1254,422,77196,65828,53402,24237,4129
34859,195,1666,22451,12408,2.94881e+13,470.144,5159.82,34859,423,299,30399,28355,25012,22199,9650
20879,6027,20879,10439,10440,5807870,0,20879,20879,10440,2,0,0,0,0,0
62134,3650,4243,44109,18025,5.42103e+13,1469.98,12802.6,62134,1697,518,57891,57872,57228,51559,52458
93984,130,4144,61995,31989,2.93599e+13,912.342,13465.3,93984,1253,410,76989,64576,51162,16706,7095
66075,2084,2166,42622,23453,2.94804e+13,558.118,7213.32,66075,584,343,63909,63909,63819,63810,63682
6369,348,1064,4301,2068,4.68224e+13,233.839,2030.27,6369,282,145,5305,4997,4436,1603,1627
1670,16,245,975,695,3.19186e+13,59.5521,430.946,1670,50,47,1280,1101,852,490,155
22388,184,1583,13864,8524,3.11715e+13,313.144,3959.12,22388,337,221,19871,18223,14916,9449,3834
91932,1363,4320,65467,26465,4.69142e+13,1624.17,15832.6,91932,1845,567,85110,80458,64791,54793,37435
98604,4369,4556,66957,31647,3.65132e+13,1305.48,15329.7,98604,1452,422,94048,94040,93993,93669,93229
36603,266,1793,23660,12943,3.01907e+13,512.714,5511.09,36603,463,314,32790,30059,27897,25112,9791
11082,735,800,7097,3985,2.81296e+13,368.639,2150.61,11082,323,157,10282,10282,10238,10270,10165
82325,2947,4304,58656,23669,4.19978e+13,1568.09,14563,82325,1522,446,78021,77589,69360,68977,61551
13253,471,1607,9046,4207,5.41234e+13,327.92,3436.45,13253,335,206,11592,10950,8749,3772,3173
19265,2285,2545,14096,5169,5.59076e+13,1152.53,5777.22,19265,797,211,16720,15719,16606,16573,16392
6329,592,657,4105,2224,3.0063e+13,212.865,1485.05,6329,235,115,5672,5582,5657,5641,5388
17789,1224,2836,12605,5184,5.9239e+13,403.634,5591.53,17789,706,329,14953,14731,9038,5901,5415
79362,2758,2833,49779,29583,3.02268e+13,664.571,9316.62,79362,588,455,76529,76529,76504,76529,75897
80003,669,2857,49977,30026,3.03901e+13,663.988,9375.04,80003,544,446,76827,75814,61530,45964,33511
65359,378,3529,43387,21972,3.93657e+13,832.868,9749.01,65359,976,420,58690,53731,45412,7457,6839
54132,1160,2055,34834,19298,2.91991e+13,529.449,6787.54,54132,533,360,52077,52056,48957,47898,36179
65065,1129,3765,42112,22953,2.94238e+13,596.812,10453.8,65065,1223,323,61300,60521,47816,39739,22234
91903,3767,4284,64428,27475,4.73105e+13,1330.44,15296.5,91903,1814,551,87619,87587,86208,67705,72381
27378,503,2576,19169,8209,3.87156e+13,792.117,6887.3,27378,816,257,23193,21807,18699,17384,11000
51130,790,2210,31381,19749,3.10697e+13,538.082,6469.29,51130,455,309,48859,48215,39057,23877,24984
68769,317,3143,45187,23582,3.58296e+13,883.441,8627.72,68769,695,341,61738,56205,48765,5259,4753
25050,153,1043,16228,8822,3.04676e+13,507.543,3427.76,25050,388,239,21230,20111,17098,16205,6219
93566,3436,3642,61327,32239,3.49492e+13,1044,11187.1,93566,763,426,89924,89914,89801,89869,89105
58225,2000,2541,36260,21965,3.02776e+13,590.075,7638.12,58225,512,380,55684,55632,51759,53219,47932
9528,510,798,6220,3308,3.07677e+13,315.035,1994.53,9528,275,139,8730,8553,8212,7863,7072
35648,162,2733,21272,14376,3.25011e+13,380.729,5542.69,35648,746,209,31572,28325,21248,6245,2530
28871,75,447,19536,9335,3.33969e+13,289.625,2787.91,28871,279,197,17064,6752,11629,7948,9192
67001,3138,3766,45612,21389,4.49588e+13,1136.94,11139.8,67001,1319,456,63235,62974,60374,31219,40474
44225,716,17448,35327,8898,2.7147e+13,5072.32,24931.4,44225,4050,77,17786,16309,13775,8716,2052
75658,1489,3954,52189,23469,4.82663e+13,1235.15,12290.1,75658,1421,459,70396,67673,52702,22618,26257
6695,297,1097,4814,1881,2.63667e+13,321.953,2269.55,6695,371,96,5452,4997,2824,2309,2903
30660,171,1635,19793,10867,2.946e+13,493.538,4827.51,30660,419,288,26442,24576,21392,17843,5635
43716,741,3154,31096,12620,3.65416e+13,894.291,9218.22,43716,872,303,39312,37765,27591,29004,12694
89862,2701,3600,56724,33138,2.93653e+13,924.837,11530.8,89862,975,450,86262,86043,86149,86197,81096
14775,398,732,8633,6142,3.2274e+13,257.42,1834.16,14775,243,122,14043,13902,12252,12934,10773
68667,2332,4038,48708,19959,3.84565e+13,1191.77,12779.6,68667,1224,393,64629,63937,59683,58817,47755
77315,2551,2794,48602,28713,3.00138e+13,676.305,9210.24,77315,588,445,74521,74453,73529,73857,72284
9235,454,768,5980,3255,2.89858e+13,373.354,1967.32,9235,285,149,8389,7887,7804,7400,5851
7337,215,1090,5310,2027,2.68619e+13,208.601,2356.92,7337,340,126,6162,5785,4045,2492,2540
18070,949,2838,13452,4618,7.02801e+13,789.742,5737.13,18070,764,258,14925,14028,9615,9035,9032
45695,1432,2922,32541,13154,4.40614e+13,1213.6,9554.43,45695,1149,314,42116,39836,36656,33943,29159
59121,1974,3651,40354,18767,4.53944e+13,995.58,10056.4,59121,1052,427,55385,53807,44143,18133,24632
83297,1033,3639,52428,30869,2.88295e+13,805.286,11210.6,83297,955,422,79520,78950,65355,45493,36231
22568,1061,2902,15654,6914,5.07599e+13,441.932,5951.57,22568,739,320,19666,19437,12849,4708,4186
75374,2090,2734,48401,26973,3.0254e+13,586.902,8877.07,75374,651,412,72640,72635,70609,70072,67957
85471,1015,5813,54569,30902,2.99692e+13,638.483,12949.4,85471,973,432,79658,79113,63138,45112,36539
5901,970,1521,3939,1962,5.72406e+13,209.683,2490.9,5901,388,144,4380,4330,3859,4301,2238
95852,2459,3703,62989,32863,3.49267e+13,1190.96,11737.5,95852,900,388,92149,91350,85214,63458,36769
34012,1333,1924,20226,13786,3.17309e+13,359.949,4569.67,34012,448,235,32088,32030,28334,29768,25294
45329,3315,3363,32460,12869,5.28461e+13,1402.45,10059.3,45329,1267,347,41966,41966,41966,41966,41914
21877,691,1710,14526,7351,4.08936e+13,423.163,4146.88,21877,397,221,20167,20055,17369,4485,4833
21362,239,405,14485,6877,3.34172e+13,282.599,2373.89,21362,263,171,20620,19805,15069,15941,17069
23581,7421,9271,19633,3948,2.3433e+13,798.066,13296.6,23581,2959,13,14310,14310,14014,14012,14310
72587,1133,2735,45908,26679,2.99612e+13,640.974,8884.7,72587,596,431,69852,69619,61333,51148,40420
87138,1919,2812,55834,31304,2.97036e+13,674.67,9515,87138,693,431,84326,84233,81444,76776,74144
31433,106,1124,20237,11196,2.88701e+13,499.455,3842.26,31433,385,260,25847,23428,19892,17527,6174
49780,2342,2379,31592,18188,3.00889e+13,541.798,7124.71,49780,495,374,47401,47401,47398,47401,47255
60729,2074,3827,41895,18834,4.91382e+13,1124.1,10934,60729,1376,462,56825,54377,43983,23405,29069
2444,203,506,1560,884,2.85613e+13,80.115,876.684,2444,109,104,1938,1912,1783,1801,470
74868,2022,2708,47699,27169,3.03766e+13,654.198,8966.37,74868,635,425,72160,72081,69190,68210,64008
12013,932,4142,10172,1841,9.26267e+12,118.117,6412.61,12013,1700,12,7871,7722,7100,4622,3531
33661,1770,3582,24606,9055,6.75334e+13,1289.19,8583.2,33661,1127,447,29749,27523,19887,20714,22073
38847,1795,2509,23916,14931,2.88823e+13,382.273,5947.9,38847,892,172,36338,36338,36227,36325,29864
91787,146,4089,58662,33125,2.94308e+13,814.115,12850.4,91787,1204,436,76987,66964,54854,28813,8972
20637,1012,1508,14819,5818,2.77084e+13,629.93,4549.66,20637,734,181,19129,18598,18147,18460,15662
71016,2822,3862,44705,26311,2.95781e+13,658.729,10526.3,71016,1068,370,67154,67142,67153,67150,59582
59968,2969,3787,43275,16693,5.60637e+13,1476.82,11950.2,59968,1460,527,56181,56136,51453,52279,52687
60321,391,3038,39681,20640,2.95981e+13,605.997,8966.01,60321,1143,264,55462,52722,36687,20126,18737
31278,201,1893,18892,12386,3.1435e+13,337.109,4627.42,31278,380,218,28590,26139,20187,8579,5018
46355,7527,19829,37087,9268,99211800,931.009,28878.7,46355,4655,11,26526,26526,21651,26526,9370
23993,371,2649,16876,7117,4.52942e+13,847.42,6649.12,23993,815,276,19285,18082,13481,11996,6452
87098,2059,4156,59894,27204,4.78769e+13,1316.12,13685.1,87098,1672,482,82617,78398,63003,34605,40326
89141,3370,3598,56096,33045,2.99246e+13,959.066,11230.1,89141,750,450,85543,85341,85543,85543,83869
85397,1675,2868,54064,31333,2.96681e+13,686.772,9688.74,85397,630,445,82529,82308,76617,66463,61404
51308,1538,1930,33058,18250,2.9454e+13,509.451,6244.13,51308,492,318,49378,49373,48830,48403,44184
68089,2302,3489,42462,25627,3.03384e+13,760.087,9542.45,68089,714,394,64600,64431,62158,63075,58157
76101,2991,3814,49871,26230,2.96578e+13,681.382,11445.9,76101,1229,346,72287,72123,72252,72038,63384
83628,2937,3877,56815,26813,4.43214e+13,1214.61,12218.9,83628,1393,472,79751,79407,72968,32503,48431
77092,3642,3842,50818,26274,3.6719e+13,1009.06,10618,77092,951,369,73250,73250,73213,73240,72421
65201,742,2643,41346,23855,2.98964e+13,570.006,8360.51,65201,565,412,62502,61800,53027,44901,31521
73758,1340,3683,49950,23808,4.31411e+13,1128.94,11250.8,73758,1242,427,69268,67111,51741,17496,18746
91788,1750,3006,57818,33970,3.04787e+13,729.993,10201.9,91788,639,455,88782,88478,81135,65415,64061
10100,1099,1660,6712,3388,4.40802e+13,397.691,3324.61,10100,540,122,8440,8294,8036,8055,6072
38583,1165,2712,24248,14335,2.9531e+13,358.179,6576.03,38583,1013,178,35871,35863,34461,32786,24117
30139,702,3527,21924,8215,6.52464e+13,1261.84,8039.81,30139,1064,451,24749,23573,12086,9902,7668
34987,51,1933,22345,12642,3.03916e+13,545.785,5406.83,34987,453,316,24736,17622,18373,11194,2228
5213,193,578,3378,1835,2.9479e+13,168.364,1259.73,5213,191,106,4565,4408,4037,3716,2567
65138,3115,3603,47033,18105,4.62027e+13,1360.58,12265.4,65138,1348,384,61535,61530,58034,57153,57224
85516,589,3866,58136,27380,4.49555e+13,1201.64,12390.9,85516,1385,474,78260,75289,55840,14579,15575
96244,687,4353,68721,27523,4.55338e+13,1661.83,16209.1,96244,1824,585,85463,81438,53909,39814,29659
54735,909,2041,35218,19517,2.94945e+13,570.234,6818.53,54735,594,353,52694,52402,47937,47672,35897
46615,516,3365,33301,13314,4.12636e+13,936.059,9922.3,46615,922,341,40925,38991,24382,22500,6729
87312,1539,2851,56063,31249,2.97848e+13,660.659,9519.98,87312,706,433,84461,84343,79366,75183,63257
19980,1671,1869,12668,7312,2.58532e+13,301.792,4184.85,19980,633,148,18111,18111,18106,18111,17485
32334,2796,3352,21985,10349,4.76815e+13,648.781,7653.17,32334,912,398,28982,28980,27744,18707,17294
63510,866,2480,40776,22734,2.94336e+13,612.861,7969.77,63510,600,397,61024,60288,54607,51796,37932
80075,2696,2808,51195,28880,3.00575e+13,658.338,9246.26,80075,709,417,77267,77216,77199,77223,76520
69687,4280,6971,59259,10428,4.21162e+13,17.0447,7992.52,69687,3488,3483,62716,62716,46597,55997,53345
38249,2094,2110,27551,10698,2.78474e+13,637.721,6573.85,38249,785,252,36139,36139,36139,36129,36070
36696,943,1940,24206,12490,3.73845e+13,473.743,5316.42,36696,439,272,34756,34701,30266,6956,8311
36578,28,1675,23560,13018,2.98108e+13,474.96,5176.7,36578,456,280,20126,11643,12951,6052,1870
78340,2545,3953,50935,27405,2.95493e+13,665.391,11857.5,78340,1241,388,74387,74282,73701,74145,52324
40816,2452,2640,26484,14332,2.85906e+13,442.071,7125.15,40816,1039,198,38176,38176,38147,38176,36415
12810,713,967,8299,4511,2.97953e+13,362.963,2505.83,12810,321,166,11843,11651,11547,11538,11446
92057,740,4472,63617,28440,3.83745e+13,1331.96,15087.6,92057,1436,438,83506,80812,56576,36170,22207
93488,138,4167,63675,29813,4.46492e+13,1450.5,13577.3,93488,1425,478,73631,65684,48391,10707,4075
92182,2477,3958,62991,29191,4.5201e+13,1318.54,13285.4,92182,1469,483,88224,86540,77140,36672,50996
41635,643,3072,28009,13626,4.27627e+13,652.873,7786.74,41635,849,358,38333,37071,27555,6541,5751
15639,2058,2653,11454,4185,6.16788e+13,833.959,5208.93,15639,715,170,12986,12331,12556,12742,11417
47296,885,3323,33831,13465,3.9917e+13,913.482,9883.57,47296,892,336,42941,41233,31293,32014,15120
76951,1720,3874,53004,23947,4.77315e+13,1219.49,12304.4,76951,1376,474,72234,69206,56413,26322,33607
83089,856,2750,53275,29814,3.00142e+13,663.38,9308.51,83089,662,431,80299,79760,69596,64991,49140
55683,1118,1484,35796,19887,2.90733e+13,583.735,5445.96,55683,526,326,54199,54195,52627,52222,51009
87324,2829,8733,74253,13071,4.21251e+13,17.6731,9878.6,87324,4368,4364,78591,78590,43194,63837,60898
62688,417,3777,43127,19561,3.12674e+13,869.931,11214.1,62688,1046,297,55725,52403,36654,18880,9012
23081,2263,2655,16223,6858,4.72962e+13,877.911,6525.14,23081,814,282,20426,20261,18545,19031,18888
5530,415,457,3225,2305,3.22525e+13,164.971,994.539,5530,111,82,5073,5067,5041,5052,4906
2300,264,332,1340,960,3.02132e+13,98.7087,584.951,2300,56,60,1968,1964,1914,1942,1771
53705,18757,53705,26852,26853,5808040,0,53705,53705,26853,2,0,0,0,0,0
27826,3400,3511,19730,8096,6.14339e+13,666.151,7601.79,27826,898,403,24315,24315,24183,24240,23732
59946,2190,3423,42947,16999,4.87834e+13,1347.1,11521.8,59946,1406,353,56446,53706,47420,49557,47192
30770,819,2152,21998,8772,3.30066e+13,695.444,6466.67,30770,752,192,28213,27377,25777,26512,17142
34089,2529,2600,20530,13559,3.03074e+13,393.989,5378.44,34089,660,173,31489,31489,31489,31489,31426
91742,536,4659,60768,30974,3.1287e+13,976.754,14472.4,91742,1361,366,84496,80553,56314,37035,12552
4191,308,538,2736,1455,3.14967e+13,143.851,1110.26,4191,142,89,3653,3570,3510,3503,3036
85938,334,2905,54386,31552,3.01028e+13,667.936,9664.51,85938,672,453,79863,74717,64853,52500,25964
67573,951,3671,48787,18786,4.54088e+13,1465.72,12641,67573,1314,388,61045,57838,43426,43655,22494
11091,2170,2360,7891,3200,6.06411e+13,297.332,4092.13,11091,573,287,8731,8717,8283,8544,8048
55377,664,3309,35777,19600,2.92142e+13,549.865,8823.53,55377,1179,248,51656,50410,35359,28108,15935
93501,2808,4468,63436,30065,3.64505e+13,1229.22,14833.3,93501,1346,419,89033,88485,84208,83163,69266
53738,1803,1968,34773,18965,2.98192e+13,500.871,6415.75,53738,502,330,51770,51770,51503,51343,50594
35266,822,1450,22773,12493,2.94197e+13,531.301,4471.1,35266,440,269,33816,33787,32081,31745,30688
14288,757,2649,10497,3791,6.41512e+13,652.261,4990.26,14288,704,172,11438,10902,6168,6601,4768
4036,106,597,2591,1445,2.85934e+13,146.25,1189.91,4036,177,102,3268,2938,2630,2443,1499
33072,2418,3315,24325,8747,6.45279e+13,1412.86,8273.26,33072,1048,374,29757,28169,26777,27316,26949
67635,868,2239,43650,23985,2.95475e+13,562.934,7617.92,67635,607,364,65396,65077,59026,58257,44228
87392,3255,3921,59460,27932,4.50823e+13,1229.83,12874.6,87392,1402,473,83471,83204,80277,42180,55746
60550,3944,4134,43372,17178,5.59355e+13,1482.96,12468.2,60550,1616,521,56416,56416,56385,56402,55248
90960,2382,4333,64316,26644,4.72139e+13,1588.45,15612.2,90960,1772,563,86290,83637,69470,59445,54381
57033,1875,2556,35488,21545,3.07721e+13,610.597,7510.07,57033,510,379,54477,54393,49928,51442,43601
43426,190,1325,27969,15457,2.88886e+13,552.445,4681.47,43426,457,292,38104,35743,31870,29116,12746
51223,1003,5139,43540,7683,4.22203e+13,16.9938,6003.3,51223,2574,2569,46084,46084,21286,35747,33691
6959,1552,1652,4815,2144,6.47352e+13,237.47,2813.21,6959,394,140,5307,5307,5307,5307,5219
41033,2508,3391,29286,11747,5.56095e+13,1485.63,9579.09,41033,1289,345,37642,37163,33932,33994,33565
6697,311,782,4308,2389,2.88527e+13,241.689,1671.05,6697,195,154,5816,5549,4984,5142,959
11933,953,1574,7926,4007,2.2882e+13,309.952,3313.78,11933,548,145,10359,10351,9881,10031,5176
98022,1543,4501,67502,30520,3.93394e+13,1327.53,15528.4,98022,1458,453,92409,89229,78116,64871,36009
92110,544,4504,62231,29879,3.5897e+13,1201.29,14569.6,92110,1358,418,83393,78984,54901,31549,25311
87203,1098,2837,56233,30970,2.98821e+13,640.555,9432.33,87203,706,421,84366,84225,76738,74265,58201
67221,2659,3589,48385,18836,4.67645e+13,1565.34,12495.8,67221,1370,387,63632,63169,54925,57499,54018
72048,3294,3619,51828,20220,3.99038e+13,1224.69,12729.9,72048,1326,379,68429,68429,67676,66782,66444
98039,3259,4019,62419,35620,2.96293e+13,871.985,12834.5,98039,1098,456,94020,93847,94020,94000,87099
40755,238,3747,29729,11026,6.42763e+13,1413.5,9722.86,40755,1205,453,31300,27670,13980,9967,3439
17332,905,1437,11047,6285,2.88339e+13,351.044,3554.17,17332,359,235,15895,15830,15275,14770,10534
42849,2040,2988,30766,12083,5.25316e+13,1336.55,9456.45,42849,1175,338,39674,37516,31276,32956,31109
16825,138,1484,12217,4608,2.92708e+13,246.394,3992.22,16825,389,168,13688,10578,8390,2673,2182
11891,283,801,7654,4237,2.97776e+13,384.887,2225.56,11891,270,181,10705,9916,9313,9505,5452
10608,18,684,6188,4420,3.21815e+13,234.73,1557.15,10608,185,113,8016,7051,4792,1201,645
14638,150,1271,8723,5915,3.19915e+13,226.317,2597.2,14638,235,140,12924,11583,8726,1834,572
18845,1510,1912,13184,5661,3.61108e+13,541.258,4868.69,18845,600,150,16933,16601,16618,16732,15217
18964,1155,1394,12235,6729,3.02994e+13,481.632,3582.02,18964,352,221,17570,17569,17397,17481,16807
88509,2307,36692,70813,17696,1.21e+08,1100.43,54171,88509,8884,11,51817,44223,36288,48168,2766
86215,1128,2721,55635,30580,2.99688e+13,681.777,9023.88,86215,686,394,83494,83341,74790,74784,57645
47529,2026,3644,32999,14530,4.99284e+13,1028.22,9717.69,47529,1208,417,43885,41823,34933,20812,23645
57980,15088,20253,47293,10687,1.72528e+13,128.811,24260.5,57980,1411,169,37727,37727,31601,32162,31087
49386,770,1947,31805,17581,2.93807e+13,530.124,6000.52,49386,521,314,47439,47216,42620,42943,37004
88166,1207,4407,62817,25349,4.84629e+13,1669.89,15576.1,88166,1809,578,80586,76390,59102,51217,31217
67481,3675,4107,47460,20021,3.57337e+13,1081.18,12521.4,67481,1093,398,63374,63334,62816,62248,61894
29970,1578,1762,18398,11572,3.16214e+13,316.247,4536.13,29970,391,236,28208,28208,27879,27999,26896
23449,563,1079,15161,8288,2.98163e+13,458.45,3348.33,23449,338,226,22323,21786,20707,20227,18410
26649,862,1020,17288,9361,2.99227e+13,474.572,3479.57,26649,366,244,25629,25626,25206,25174,24976
36928,1206,1584,23843,13085,2.98067e+13,546.509,4766.82,36928,470,264,35344,35344,35202,35263,34892
12568,614,1249,8083,4485,2.85997e+13,305.038,2944.84,12568,296,203,11319,11216,10431,10367,7052
28304,261,1343,18246,10058,3.0878e+13,527.503,4037.5,28304,422,253,25229,23325,20699,2420,2809
91525,3277,4271,63561,27964,4.68528e+13,1343.12,14959.6,91525,1809,543,87254,87033,81682,56920,65432
8836,32,589,5162,3674,3.15846e+13,206.087,1356.41,8836,132,115,7133,6521,4394,1637,877
64083,1317,4111,44980,19103,5.51317e+13,1348.73,12460,64083,1753,460,58076,54835,39415,26549,23454
34531,2092,2408,24235,10296,3.54155e+13,752.555,7375.83,34531,813,214,32123,32123,32073,32113,30004
94071,3085,4031,62941,31130,3.95612e+13,1339.27,12922.4,94071,1245,439,90040,89590,85861,33271,49923
47775,2155,2208,30716,17059,2.95546e+13,612.104,6784.09,47775,546,354,45567,45567,45554,45567,45454
51014,3401,3648,36596,14418,5.47719e+13,1540.36,10898.5,51014,1448,404,47366,47365,46902,47134,46802
49577,284,2988,33004,16573,2.89544e+13,493.445,8277.43,49577,1046,258,44140,41502,27854,14527,8651
54277,2559,2969,36059,18218,3.77703e+13,765.177,7731.04,54277,743,332,51308,51284,49842,47710,42192
82126,56,4161,54535,27591,3.14562e+13,957.46,12741.5,82126,1315,307,56569,40461,31964,5601,1095
51846,219,580,35165,16681,3.35803e+13,302.474,3837.14,51846,300,247,49889,46452,33950,27882,29774
49079,1548,3817,35029,14050,5.75786e+13,1292.81,10527.7,49079,1305,458,44187,41620,31085,21401,20826
58472,1128,3578,36830,21642,2.92616e+13,532.438,9348.38,58472,1052,308,54894,54640,44295,34767,22793
23910,590,2904,17480,6430,6.50815e+13,1071.41,6599.65,23910,956,256,19578,18649,11855,10334,7495
65345,2473,3626,43533,21812,4.03625e+13,845.821,9926.14,65345,1024,425,61719,61429,53393,17820,23606
2791,340,360,2028,763,3.46045e+13,163.535,865.795,2791,155,77,2431,2431,2431,2431,2406
85263,2564,3985,55508,29755,2.98043e+13,701.146,12350.5,85263,1262,386,81278,81140,80548,80998,58173
31740,901,1717,22898,8842,2.85558e+13,636.543,5686.19,31740,751,216,29897,29164,25284,27116,20761
72144,13521,16996,54876,17268,2.79047e+13,1071.58,27470.9,72144,3828,249,55148,55148,38674,22850,19641
59315,1027,3731,38236,21079,2.93289e+13,544.526,9893.08,59315,1214,281,55567,54828,41387,32884,16721
4584,149,440,3328,1256,3.20357e+13,170.556,1217.49,4584,189,89,3948,3640,2532,1953,1015
49206,1109,3082,35108,14098,4.33126e+13,1161.68,10034.8,49206,1115,341,45037,42634,37354,36101,25582
34789,2490,2928,24824,9965,5.10643e+13,1392.86,8452.98,34789,1138,317,31861,31665,30055,29931,29759
20472,152,2364,14123,6349,5.12956e+13,457.48,4945.77,20472,576,298,16168,14662,9672,2242,724
64114,431,633,43512,20602,3.3596e+13,302.938,4291.08,64114,306,258,63481,63481,53508,56789,52382
22789,1364,1608,16450,6339,3.08378e+13,518.17,4828.19,22789,510,191,21181,20992,20723,20987,18431
34193,2178,2180,24642,9551,2.95133e+13,554.305,6433.18,34193,594,216,32013,32013,32013,32013,32011
85454,3660,4233,54921,30533,2.94152e+13,759.46,12682.2,85454,1248,396,81221,81184,81221,81212,77398
78098,427,2845,48865,29233,3.06127e+13,683.916,9244.97,78098,621,430,73533,69507,57065,43037,22640
29835,297,1208,19360,10475,3.01657e+13,575.394,3955,29835,432,235,27119,25301,23852,22499,14852
27608,1620,1658,19921,7687,2.89637e+13,626.628,5301.76,27608,699,211,25950,25950,25945,25940,25780
77906,702,3739,51368,26538,3.61728e+13,1032.57,10464,77906,969,364,73513,72510,56629,8731,7470
23917,247,1045,15420,8497,2.88041e+13,479.025,3359.7,23917,371,229,21331,19721,18684,17204,10422
90387,1369,3754,57217,33170,2.93818e+13,900.31,11901.2,90387,971,456,86633,85898,75867,53848,45002
72799,2287,2828,47402,25397,3.31523e+13,645.948,8482.34,72799,598,358,69971,69907,69379,68997,64411
37337,506,1790,24041,13296,2.92801e+13,523.823,5427.36,37337,459,315,35266,33737,30473,29805,15540
94046,3195,4013,61710,32336,2.97693e+13,742.396,13002.4,94046,1255,397,90033,90031,90015,89738,80908
67865,890,3170,44905,22960,2.97801e+13,695.259,9626.46,67865,1185,281,64302,63397,50947,38628,28957
46194,617,1384,29855,16339,3.03565e+13,574.473,4886.1,46194,466,296,44743,43455,39181,37630,33318
56769,861,3712,38831,17938,4.62241e+13,1070.3,10273.7,56769,1239,434,51705,50149,35540,11678,10948
22034,1786,1980,14025,8009,2.65215e+13,307.612,4482.57,22034,657,157,20054,20054,20053,20053,19618
10355,658,683,6044,4311,3.20172e+13,211.621,1589.58,10355,171,128,9672,9672,9658,9668,9613
11595,272,2339,8481,3114,6.00207e+13,382.544,4300.02,11595,572,210,8684,7750,4156,3454,1348
88117,328,3507,55277,32840,3.0424e+13,977.557,10767.5,88117,666,446,81054,75936,62643,45323,14644
68244,3161,3563,48755,19489,3.80616e+13,1128.72,12195.6,68244,1281,369,64681,64681,63839,62903,62625
93316,3943,4346,65934,27382,4.66191e+13,1569.09,15731.6,93316,1767,574,88970,88940,88027,74153,77834
83498,21351,83497,41749,41749,5808010,1.19763e-05,83497.4,83498,41749,2,1,1,1,1,1
5653,827,949,4115,1538,2.657e+13,199.966,1977.77,5653,325,105,4704,4704,4695,4693,4611
12321,955,1047,9006,3315,3.04087e+13,202.598,2827.18,12321,295,143,11274,11274,11201,11235,10376
83673,1147,3936,57264,26409,4.60733e+13,1245.89,12691.5,83673,1425,470,77699,75087,57251,20954,21495
20067,723,2678,14238,5829,6.10798e+13,854.124,6092.14,20067,896,237,16657,16068,10985,10276,7467
24437,490,2225,16150,8287,2.75561e+13,415.313,5353.91,24437,834,183,21586,19730,16149,13014,8764
92447,798,4030,60736,31711,2.99068e+13,748.206,12951.6,92447,1256,401,87857,86405,64972,42241,27365
3200,199,365,2368,832,2.95693e+13,136.417,935.675,3200,160,81,2814,2673,2160,2501,1705
96335,2950,3882,65198,31137,4.34784e+13,1222.56,12836.3,96335,1447,466,92453,92106,84585,35124,55094
8784,200,1098,6211,2573,2.12197e+13,350.754,2570.08,8784,539,95,6430,5009,3487,3521,3311
10307,219,798,6704,3603,2.98214e+13,385.249,2085.93,10307,286,153,8967,8409,7590,6930,4242
64479,2007,3701,41122,23357,2.97336e+13,590.148,10353.8,64479,1222,318,60778,60730,60220,60669,43580
64069,2403,4155,45447,18622,5.47237e+13,1483.22,12941.6,64069,1680,524,59914,57463,47637,43708,43827
48710,1964,2176,29926,18784,3.1111e+13,519.217,6289.43,48710,453,314,46534,46456,45838,46109,44857
29544,1472,13148,24210,5334,2.52647e+13,960.566,17603.6,29544,3970,16,16396,13640,14941,13294,5022
24345,509,1592,15366,8979,3.04833e+13,431.728,4245.21,24345,374,249,22580,22123,18382,14786,12093
39438,1194,1271,25447,13991,2.95298e+13,543.642,4469.97,39438,456,285,38167,38167,38046,38012,37956
44764,1259,3066,27830,16934,2.89442e+13,414.249,7388.31,44764,928,233,41698,41565,36167,33768,25031
46390,2079,2948,32844,13546,3.41542e+13,814.877,9136.12,46390,927,241,43442,43442,43341,43181,38123
29033,987,1407,18750,10283,2.97823e+13,549.077,4214.26,29033,430,274,27626,27606,26469,25552,23762
42993,1701,2687,30133,12860,2.85808e+13,579.083,7633.4,42993,879,272,40306,40297,38932,39849,29062
2184,104,235,1857,327,4.22689e+13,16.8553,400.001,2184,122,117,1949,1949,1182,1625,1574
48165,956,3395,30282,17883,2.90834e+13,411.854,8206.17,48165,1032,224,44770,44450,33680,25513,15124
52789,14677,20785,42812,9977,1.70543e+12,98.3713,22194.5,52789,1324,150,32004,32002,23024,28430,23724
13311,391,709,7775,5536,3.24842e+13,245.085,1738.45,13311,218,117,12602,12478,11004,11689,9443
17630,1132,1459,12652,4978,2.81376e+13,645.775,4188.61,17630,594,169,16171,15827,15903,16053,14524
52139,1160,2424,32684,19455,3.06038e+13,536.359,7062.62,52139,497,356,49715,49605,42271,31679,29001
77413,2253,2815,48346,29067,3.05345e+13,677.045,9235.77,77413,580,438,74598,74495,69994,71703,64669
39100,418,2420,28091,11009,2.81896e+13,747.907,7252.08,39100,720,229,35303,33812,20314,9727,14490
83681,2863,4094,57567,26114,4.79264e+13,1262.58,13335.6,83681,1638,473,79587,79302,71272,41440,52871
92186,2337,4231,63366,28820,4.6548e+13,1397,14623.6,92186,1788,545,87911,84638,70459,42046,48142
20451,740,1342,13226,7225,2.97281e+13,378.104,3742.74,20451,377,241,19109,18979,17869,17729,13320
1367,532,555,993,374,7.84466e+13,60.3043,760.957,1367,114,71,812,812,812,812,810
37622,2212,2535,27008,10614,2.85712e+13,695.725,7253.85,37622,809,220,35087,35087,35085,35087,34371
45323,1421,3810,32531,12792,6.0223e+13,1255.12,10103.7,45323,1296,461,40350,38012,27733,18377,20012
60447,3744,3896,42504,17943,5.30789e+13,1301.97,11609.9,60447,1474,461,56551,56551,56270,55543,54203
14649,254,386,9952,4697,3.36408e+13,282.631,1968.88,14649,243,153,14095,13414,10293,11061,11432
1561,583,746,1048,513,5.88768e+13,42.9526,984.338,1561,170,109,815,815,814,815,748
29568,1082,1100,19021,10547,2.8949e+13,516.658,3782.39,29568,401,254,28468,28468,28452,28455,28459
78237,1533,4111,51917,26320,2.91966e+13,795.168,12131.9,78237,1226,347,74126,73619,66088,63917,34988
42075,80,519,28511,13564,3.35178e+13,297.741,3417.64,42075,294,234,25724,10269,17302,8659,14183
87831,2727,4417,62335,25496,4.78592e+13,1630.81,15515.8,87831,1786,559,83392,82655,68676,62309,61862
46606,1193,2204,28396,18210,3.13584e+13,511.073,6094.32,46606,479,311,44402,44270,36467,30177,23409
15071,4581,5960,12226,2845,1.73648e+12,89.8839,6670.39,15071,592,98,9111,9110,7148,8957,7190
80061,3190,4105,53861,26200,3.17786e+13,1047.15,12943.2,80061,1251,341,75956,75756,75776,74765,69894
58125,1864,2478,37090,21035,2.98763e+13,576.929,7735.12,58125,553,390,55647,55639,53634,53018,50170
91942,3404,4311,65890,26052,4.68803e+13,1671.6,15874.9,91942,1849,573,87631,87164,83769,77557,79379
57119,286,3676,39888,17231,3.12697e+13,852.723,10694.6,57119,992,293,49055,45540,30639,13264,3919
61250,954,3388,38422,22828,2.93172e+13,552.795,9182.41,61250,997,309,57862,57516,46817,30468,25317
12680,601,783,8087,4593,2.78807e+13,410.582,2271.62,12680,306,167,11897,11549,11502,11184,11109
80316,2433,3697,53954,26362,4.11566e+13,1114.06,11098.2,80316,1090,443,76619,75328,64180,20499,38511
17392,917,1279,11259,6133,2.99237e+13,493.946,3340.75,17392,346,224,16113,16079,15769,15842,14906
7128,401,715,4573,2555,3.04455e+13,321.474,1706.17,7128,253,144,6322,5980,5898,5561,3917
1961,9,741,1320,641,4.55717e+13,133.891,1091.95,1961,290,52,516,392,167,181,67
71407,114,675,48432,22975,3.3572e+13,303.624,4553.23,71407,308,263,52852,31033,33346,14756,28986
71119,2328,3206,46768,24351,3.61554e+13,837.822,8822.06,71119,624,353,67913,67570,66036,65947,58679
67387,461,2264,43472,23915,2.93389e+13,578.98,7498.45,67387,587,335,63883,59354,54675,52625,35249
8059,294,613,4696,3363,3.18006e+13,194.34,1362.53,8059,133,109,7446,7252,6183,6350,4592
71317,1229,7133,60646,10671,4.21165e+13,17.0477,8166.95,71317,3571,3565,64184,64184,28785,49431,46301
45568,1907,2233,29361,16207,3.01366e+13,588.246,6667.65,45568,534,351,43335,43330,43015,43109,41806
13627,60,386,9251,4376,3.35601e+13,284.1,1906.85,13627,243,153,7134,3012,5108,4143,4803
10428,540,7984,8178,2250,3.66011e+13,65.396,8687.62,10428,1367,12,2444,2377,0,2372,199
89150,3650,4252,62250,26900,4.74179e+13,1351.86,14903.6,89150,1778,537,84898,84848,83146,61607,67298
75185,1755,4000,51018,24167,3.15009e+13,1021.74,12566.6,75185,1185,326,71185,70133,67048,58994,39557
10810,721,725,6313,4497,3.19711e+13,221.03,1637.23,10810,178,123,10085,10085,10085,10085,10082
39271,2360,2998,26309,12962,4.09864e+13,608.096,7378.71,39271,793,335,36273,36182,34219,15451,15889
37746,267,1839,24333,13413,2.92094e+13,512.571,5620.7,37746,469,311,33788,31060,28947,26157,11279
87860,7282,23706,71968,15892,2.56078e+13,5441.04,38605,87860,8045,26,63088,46746,50226,55483,30487
47031,1810,1864,30310,16721,2.97925e+13,561.063,5734.8,47031,525,299,45167,45167,45163,45161,45102
6919,355,690,4412,2507,2.71753e+13,289.286,1622.21,6919,233,142,6141,5812,5649,5514,3865
65531,145,652,44525,21006,3.37419e+13,304.303,4355.39,65531,307,260,53881,33579,35251,19461,29505
87626,796,8748,74531,13095,4.2057e+13,17.0746,9898.62,87626,4376,4371,78878,78878,31193,59006,52035
84890,1809,2705,54779,30111,2.97666e+13,644.125,9107.47,84890,708,404,82185,82160,80096,76654,66138
59140,3426,3478,42364,16776,4.22772e+13,1259.45,11503.9,59140,1246,357,55662,55662,55650,55661,55501
41886,2863,3004,27949,13937,3.93445e+13,651.879,7205.27,41886,738,324,38882,38882,38635,38551,37861
71360,1793,3251,47016,24344,3.60137e+13,854.534,9117.7,71360,845,340,68109,67543,56808,12413,16753
70070,3443,3613,43883,26187,2.93627e+13,726.238,10080.8,70070,953,386,66457,66426,66457,66457,66083
53917,1478,3119,33243,20674,3.04377e+13,582.263,7821.47,53917,698,310,50798,50589,45160,47101,37915
27553,281,1424,17731,9822,2.90839e+13,546.839,4146.72,27553,399,280,24738,22897,20958,18874,6282
24987,868,3060,18213,6774,6.45736e+13,1161.98,6927.16,24987,879,401,20796,19729,10984,11135,8703
63349,319,3720,40568,22781,2.89979e+13,557.339,10317,63349,1223,324,57057,53476,37384,17919,3803
76124,2879,4042,50546,25578,2.94429e+13,800.078,11736,76124,1232,329,72082,71784,71917,71727,60715
10236,908,1275,6885,3351,4.59483e+13,305.568,2726.24,10236,289,162,8961,8947,8502,8186,6483
94688,4044,9655,80386,14302,4.21203e+13,18.0626,10898,94688,4733,3043,85033,85033,51881,71120,68222
92903,2872,4565,64771,28132,4.05782e+13,1501.04,15488.1,92903,1480,455,88338,87712,78970,77503,67667
75302,16679,18406,55173,20129,2.31682e+13,219.64,23582.7,75302,1774,186,56896,56894,55346,56527,55161
83341,813,3929,57119,26222,4.62535e+13,1270.53,12549.3,83341,1401,472,76319,74272,52589,15425,12442
71657,3631,3965,48404,23253,3.16588e+13,919.02,12013.6,71657,1158,302,67692,67598,67692,67692,65718
93524,13120,24783,76554,16970,2.65367e+13,5728.3,40320.6,93524,8558,27,68741,68741,59995,57798,47013
57638,4456,5748,49043,8595,4.19771e+13,17.1138,6680.31,57638,2878,2873,51890,51890,44162,48666,47520
8427,341,835,6178,2249,2.80033e+13,181.415,2215.35,8427,304,134,7592,7565,5523,5218,2370
19025,1649,3060,14025,5000,6.48288e+13,904.938,6121.23,19025,735,337,15965,15165,12850,12354,10975
49546,1460,2284,32564,16982,3.78915e+13,559.923,6447.62,49546,562,306,47262,47245,44338,41464,31459
65671,987,3393,43844,21827,2.95183e+13,716.484,9821.19,65671,1136,279,61955,60978,52437,39096,26745
86615,1803,4258,60118,26497,4.78787e+13,1376.41,14573.1,86615,1805,532,81464,77041,62226,39638,36874
59355,2523,2554,37720,21635,3.03016e+13,568.945,7911.47,59355,566,409,56801,56801,56801,56801,56700
39092,1586,1669,25157,13935,2.82826e+13,489.353,5161.33,39092,439,281,37423,37423,37388,37346,37192
53403,119,3537,34256,19147,2.91676e+13,506.321,9095.4,53403,1201,222,41811,32992,26850,5104,2274
3389,1361,1702,2712,677,450728000,3.37976,2319.15,3389,351,11,1687,1687,1618,1633,1358
16766,378,908,10836,5930,2.90944e+13,424.184,2691.77,16766,356,195,15526,14480,13687,13409,8933
64212,2599,4081,45063,19149,5.48699e+13,1370.35,12480,64212,1739,463,60131,59044,51917,39734,43642
72014,2809,2882,46932,25082,3.33709e+13,652.507,8431.2,72014,592,358,69132,69132,69095,69092,68789
12518,112,367,8523,3995,3.37996e+13,265.781,1796.72,12518,227,139,9117,5385,5853,5836,6836
86469,1629,3940,56324,30145,2.98168e+13,692.83,12382.3,86469,1254,387,82529,82210,74455,73450,48718
62965,617,3837,43001,19964,4.66311e+13,1107.02,10954.1,62965,1377,464,56596,54392,38315,11500,10589
9022,956,1100,5842,3180,2.94197e+13,246.734,2339.33,9022,298,170,7922,7898,7880,7806,7418
30728,1522,2283,21484,9244,3.61236e+13,743.556,6844.02,30728,718,210,28445,27570,27892,26482,23832
87778,1506,2896,55574,32204,3.02236e+13,699.885,9807.87,87778,657,457,84882,84594,76855,63405,56429
23280,460,1074,14948,8332,2.87459e+13,489.248,3355.6,23280,420,230,21952,20362,19378,18721,15658
89730,3958,3977,58968,30762,3.61445e+13,1220.87,12094.4,89730,1057,436,85753,85753,85751,85737,85662
42405,169,2818,29921,12484,3.36163e+13,846.557,8589.53,42405,838,239,34480,29101,21336,10968,3869
14147,1152,1456,10155,3992,2.71512e+13,247.904,3599.02,14147,362,137,12691,12681,12684,12685,12336
43454,156,2818,29109,14345,2.86435e+13,494.664,7703.7,43454,979,251,35295,27216,21792,7477,4767
58817,2003,2693,38801,20016,3.65512e+13,783.313,7479.13,58817,676,316,56124,55708,53003,43379,25303
17986,369,919,11605,6381,2.96869e+13,475.564,2818.27,17986,405,203,16532,15402,14511,14187,9344
32453,1946,2424,23297,9156,3.07051e+13,709.365,6776.93,32453,690,194,30029,30021,29856,29984,28627
22219,325,1537,14314,7905,2.9618e+13,496.129,4184.25,22219,422,224,19933,18612,17189,16190,8241
64907,558,3887,46314,18593,3.75252e+13,1160.68,12219.5,64907,1132,400,57373,53090,32426,16017,6669
51368,753,3017,33546,17822,2.90002e+13,489.61,8310.4,51368,1094,253,48064,47467,37512,29041,20363
41124,269,2902,29426,11698,4.43558e+13,991.168,8964.1,41124,898,319,34506,31896,22490,22607,8462
2714,76,439,1740,974,2.92971e+13,110.684,853.048,2714,131,90,2118,1606,1651,1607,906
34312,3287,3563,25191,9121,6.85365e+13,1304.79,8618.18,34312,1123,444,30749,30746,30693,30074,30140
6463,638,818,4180,2283,2.91372e+13,235.975,1737.41,6463,187,147,5645,5639,5466,5369,4727
30799,1544,2056,22311,8488,3.05212e+13,539.389,5902.33,30799,575,207,28743,28742,28255,28523,26101
21197,263,3060,15698,5499,7.25788e+13,762.442,6256.37,21197,685,410,16498,14642,5982,5119,1657
39823,463,1854,25697,14126,2.96578e+13,534.648,5770.86,39823,484,308,37440,35097,32224,30807,19268
86975,874,4236,60878,26097,4.73921e+13,1331.62,14823.1,86975,1750,532,78651,75106,56305,34465,24991
48538,2650,3050,32314,16224,3.96587e+13,675.379,8076.74,48538,861,334,45488,45486,44229,42235,34584
39436,128,2496,28149,11287,2.82735e+13,610.667,7142.29,39436,828,262,29722,22242,17806,4631,1364
51666,1672,2147,33730,17936,3.41606e+13,539.991,6229.65,51666,519,314,49519,49516,48130,48030,42799
71857,1131,2731,44796,27061,3.04239e+13,633.424,8747.97,71857,542,434,69126,68805,58245,41253,32734
64892,1058,2256,41831,23061,2.97534e+13,582.728,7494.18,64892,602,360,62636,62584,58322,57625,47071
18786,1237,2190,12781,6005,3.86711e+13,720.657,5304.45,18786,690,196,16596,15928,15683,14603,11165
93835,2958,4681,67237,26598,4.56021e+13,1756.11,16127,93835,1735,612,89154,88500,75252,75272,68078
55015,2366,3736,38138,16877,5.04481e+13,1107.47,10441.8,55015,1317,458,51279,49737,42651,24841,31108
94325,1496,4179,64096,30229,4.38069e+13,1448.81,13616.1,94325,1397,479,88774,85721,69616,22239,33167
47769,624,1855,30764,17005,2.9179e+13,540.343,5847.64,47769,513,299,45901,44734,40349,39748,33560
44515,31,1351,28646,15869,2.90357e+13,564.419,4811.49,44515,467,296,25640,14803,16895,7039,3114
22498,202,1927,13757,8741,2.7941e+13,300.219,4195.45,22498,642,152,19145,16762,13330,9008,6700
64489,1165,3708,43279,21210,4.26089e+13,895.263,10063.1,64489,1057,432,60543,59339,47171,12862,14371
91004,2840,2868,58456,32548,2.9894e+13,673.576,9707.07,91004,694,424,88136,88136,88136,88136,88024
57260,230,3448,41221,16039,4.36306e+13,1254.08,11259.7,57260,1188,358,47044,42024,26809,13941,5308
66897,3222,4111,47013,19884,5.31815e+13,1449.56,12937.4,66897,1702,530,62786,62632,58541,47550,51039
56984,1600,3331,37860,19124,3.91427e+13,770.448,8939.1,56984,893,369,53653,53007,41764,11325,13478
79945,3012,4253,55546,24399,3.71876e+13,1236.78,13915.5,79945,1366,421,75692,75438,71236,70107,63396
76219,2139,3760,54737,21482,4.46253e+13,1525.71,13512.4,76219,1534,403,71996,69141,62600,60378,50779
79824,1001,4015,51111,28713,2.95943e+13,687.747,11880.2,79824,1247,384,75809,74919,60770,38934,29305
36684,57,2631,26110,10574,3.26892e+13,770.079,7611.2,36684,796,215,24220,14708,12566,4904,1081
3187,254,534,2081,1106,2.93213e+13,92.3119,1000.72,3187,147,68,2653,2639,2543,2485,2259
61726,1430,3642,42258,19468,4.55538e+13,1063.85,10468.9,61726,1185,437,57431,55508,42114,16232,18726
8419,1549,1595,5615,2804,5.8947e+13,209.265,3011.46,8419,582,119,6824,6824,6824,6824,6773
74949,702,2688,47561,27388,3.00954e+13,634.112,8915.38,74949,600,431,72046,71160,59968,51735,36340
89866,17232,49164,78733,11133,8.62006e+11,19.9596,49802.3,89866,3526,52,40702,40690,17971,17631,15894
42064,1558,2052,26056,16008,3.09305e+13,464.326,5754.84,42064,443,297,40012,39987,37563,38623,34585
30440,979,3028,25925,4515,4.1755e+13,17.2156,3703.83,30440,1518,1513,27412,27412,15142,22296,20797
72896,2356,2765,45627,27269,3.04462e+13,654.197,8870.53,72896,593,430,70131,70046,67403,68372,64821
75761,1613,3629,47601,28160,2.92988e+13,760.408,10694.7,75761,964,402,72132,71735,63579,50493,45515
65782,1314,3989,46180,19602,3.45795e+13,1063.86,12180.1,65782,1073,384,61416,59555,50772,44975,26044
64472,3315,3882,44026,20446,3.13203e+13,872.59,11367.2,64472,1083,292,60590,60504,60590,60590,57753
44375,526,2596,31763,12612,3.08616e+13,836.974,8195.91,44375,909,232,40216,37868,25653,16471,18806
76889,1018,4079,50937,25952,2.94484e+13,805.182,11891.1,76889,1234,347,72393,71225,52519,41483,17031
42588,3487,3631,29650,12938,5.10974e+13,967.739,9184.14,42588,1073,418,38957,38884,38673,38176,37362
52105,3496,3521,34796,17309,4.13653e+13,769.94,9063.24,52105,991,408,48584,48584,48567,48556,48499
86850,449,4279,60841,26009,4.81699e+13,1332.57,14909.6,86850,1801,548,74843,70081,49760,30410,15490
75441,1430,3529,47182,28259,3.00049e+13,823.158,10248,75441,730,419,71912,71379,62452,43956,45341
73124,2791,3552,45652,27472,2.99932e+13,773.846,9984.16,73124,732,409,69572,69491,69533,69566,67408
92535,4115,4642,61546,30989,3.13279e+13,1069.02,14709.6,92535,1366,357,87893,87855,87893,87893,84062
22120,989,1002,14277,7843,3.01832e+13,477.569,3201.21,22120,410,221,21118,21118,21109,21102,21112
2950,436,506,1860,1090,2.61911e+13,87.2492,941.727,2950,124,108,2444,2444,2436,2433,2301
22107,1310,1511,16104,6003,3.07929e+13,348.815,4399.42,22107,428,177,20596,20596,20310,20462,18554
50206,736,2123,30763,19443,3.15904e+13,529.518,6300.26,50206,475,310,48012,47455,37392,21529,22083
45437,305,2769,31209,14228,2.8466e+13,548.591,7880.94,45437,928,268,40325,37995,25106,13754,6729
77453,1154,3878,53095,24358,4.74349e+13,1169.18,12018.9,77453,1419,467,71931,69705,53928,18973,24304
21959,197,1438,14122,7837,2.9046e+13,457.51,3807.09,21959,447,225,18921,17742,15736,13169,4158
64566,1924,2698,40068,24498,3.09646e+13,627.413,8171.05,64566,535,408,61868,61734,55406,56837,46020
78081,95,4235,54671,23410,4.96426e+13,1368.53,14208.6,78081,1777,534,56328,42771,30163,15030,3561
6097,221,626,5184,913,4.21919e+13,16.9493,913.077,6097,317,312,5471,5471,3065,4464,4274
63191,765,3687,42768,20423,4.43659e+13,893.763,10119.8,63191,1047,433,58557,57604,44052,11744,15328
53686,921,3503,33513,20173,2.97126e+13,520.384,8837.2,53686,1000,309,50183,49877,38831,22745,16769
35074,1230,2530,22987,12087,2.82336e+13,455.472,6668.2,35074,970,196,32544,32410,30577,27836,16797
50500,947,2894,35829,14671,3.14031e+13,854.303,9257.07,50500,926,245,47229,45188,40265,42260,27080
85719,2017,3622,53757,31962,2.96564e+13,904.859,11019.4,85719,741,453,82097,81648,75004,69575,58737
6457,1523,1625,4714,1743,4.75807e+13,229.264,2703.18,6457,407,145,4832,4832,4753,4749,4618
46889,6855,15886,38818,8071,2.31246e+13,2386.3,23774.2,46889,5176,17,31003,26654,26430,28172,19394
91504,406,4342,65641,25863,4.63943e+13,1702.33,15741.4,91504,1808,580,77690,72535,42243,24613,18553
62741,484,3785,43565,19176,5.09828e+13,1122.82,11149.1,62741,1334,464,55227,51595,36505,12217,10687
63199,976,2094,40860,22339,2.97998e+13,551.335,7020.78,63199,551,334,61105,61023,56577,56564,48288
15970,457,1615,13573,2397,4.22349e+13,16.9781,2090.07,15970,811,806,14355,14355,7434,11466,10900
77981,3079,3999,50932,27049,2.9668e+13,706.673,11949.4,77981,1242,387,73982,73978,73956,73766,64327
44279,3672,3773,32032,12247,6.18699e+13,1444.42,9992.1,44279,1300,435,40506,40506,40496,40498,40162
17990,960,1646,12068,5922,4.41983e+13,392.325,3782.15,17990,343,203,16344,16303,15008,5928,6092
39796,891,2562,28505,11291,3.14448e+13,762.947,7733.83,39796,849,222,36964,35865,30609,32774,16799
68852,3268,4119,48167,20685,5.27361e+13,1406.48,12972.2,68852,1702,511,64733,64603,60456,47046,50881
31344,2356,3582,22460,8884,5.95625e+13,906.379,8112.9,31344,968,421,27762,26876,21520,16791,18369
72851,1000,3724,48942,23909,4.27736e+13,987.589,10617.2,72851,1014,425,68493,67285,54602,14264,22533
39267,1030,2078,24910,14357,3.03674e+13,529.741,5841.17,39267,480,326,37189,37140,33510,27826,26899
18537,1347,2834,13562,4975,6.62099e+13,861.892,5753.38,18537,848,256,15703,14542,10331,11103,11261
51844,3270,4052,37123,14721,5.99543e+13,1429.63,11195.5,51844,1500,457,47792,47715,44932,41373,41982
95225,1734,4139,60774,34451,2.93656e+13,825.388,13072.3,95225,1197,448,91086,90585,81256,64935,57177
48354,840,1402,31313,17041,2.97544e+13,558.964,4988.86,48354,482,310,46952,46844,43199,42968,39745
22133,783,1092,14361,7772,3.06607e+13,463.485,3309.83,22133,349,220,21041,20761,20420,20104,20156
2808,472,516,1798,1010,2.94712e+13,104.132,978.874,2808,123,88,2292,2292,2286,2286,2198
78321,1993,4274,56330,21991,5.04646e+13,1695.67,14422.1,78321,1619,563,73330,69273,57146,52241,44301
34884,933,2843,24717,10167,4.77959e+13,1293.06,8327.61,34884,1140,301,30528,28514,23203,21443,14246
68332,3360,3838,49330,19002,5.33943e+13,1437.27,12789.4,68332,1503,531,64494,64479,61679,62141,62538
73029,2640,3784,47965,25064,2.95797e+13,665.473,11176.8,73029,1229,337,69245,69059,68611,68899,52765
83686,325,732,56715,26971,3.35085e+13,304.726,4960.05,83686,311,268,82954,81737,59660,57913,50655
49566,866,3008,31863,17703,2.90131e+13,463.978,8006.69,49566,1148,226,46438,45975,39719,33309,23653
50279,1788,3791,35041,15238,5.25241e+13,1131.26,10253.9,50279,1346,457,46173,43936,32979,20379,22569
86449,217,3982,62256,24193,4.65204e+13,1709.23,14686.9,86449,1634,560,69715,61714,36571,15576,10827
64993,583,2795,42679,22314,3.62114e+13,554.057,7722.79,64993,605,337,62108,59977,50444,8881,7417
24825,265,1045,16058,8767,2.97516e+13,523.494,3420.02,24825,385,230,22282,20630,19295,18875,8769
2396,131,324,1659,737,3.40843e+13,177.921,792.353,2396,177,72,1727,1070,1210,1175,1448
38435,807,1937,24821,13614,2.97433e+13,591.015,5728,38435,511,313,36498,35800,32254,30728,17232
68148,949,2669,42507,25641,3.00257e+13,618.424,8447.82,68148,523,420,65479,65094,53592,39665,30910
81272,3077,3950,55752,25520,4.66777e+13,1201.26,12567.1,81272,1431,471,77322,77069,72004,38118,50319
68711,2393,2816,44614,24097,3.26117e+13,640.186,8171.89,68711,597,350,65895,65859,65569,65469,62486
27498,678,2322,19151,8347,2.67008e+13,567.769,6036.74,27498,841,228,24849,23872,16105,12138,5092
86759,3058,4336,61902,24857,4.74678e+13,1609.98,15360,86759,1751,566,82423,81904,73902,66690,67952
4951,452,791,3566,1385,2.84314e+13,190.559,1724.03,4951,318,90,4160,4046,3168,3400,2070
60568,2315,4092,42750,17818,5.68255e+13,1377.57,12200,60568,1736,457,56476,53682,44387,35900,38692
94895,250,3871,64238,30657,4.4331e+13,1235.92,12851.7,94895,1411,472,81297,74216,57168,11254,9924
81629,2473,3968,52906,28723,2.94291e+13,679.46,12057.7,81629,1254,389,77661,77553,76951,77325,55369
6022,372,636,3916,2106,2.88848e+13,195.844,1412.56,6022,227,111,5386,5206,5024,4956,3898
60157,139,3493,43294,16863,4.76254e+13,1412.86,11707.5,60157,1310,369,45845,38573,24632,17832,4728
43039,3044,3854,31154,11885,6.20749e+13,1320.1,9941.84,43039,1292,460,39185,39086,36286,30850,32097
76344,3498,3694,51062,25282,4.1423e+13,984.081,10656.8,76344,1052,428,72650,72467,71504,70688,67687
24245,962,995,15594,8651,2.91861e+13,507.447,3345.44,24245,393,219,23250,23250,23232,23229,23218
5259,457,822,3664,1595,3.60507e+13,383.686,1771.6,5259,377,80,4373,4072,3163,3198,1750
58587,1788,3530,42097,16490,4.93354e+13,1426.25,11551.8,58587,1451,355,54439,50683,44649,44680,37960
93703,2370,4520,65578,28125,4.14114e+13,1555.19,15609.7,93703,1595,447,88941,86801,78107,76768,54308
28310,3006,3241,19491,8819,5.17496e+13,635.727,7252.69,28310,863,402,25069,25067,24742,23966,21959
35757,1231,2258,25719,10038,2.79275e+13,641.409,6590.94,35757,798,244,33499,33010,28767,30562,21894
30546,1804,2851,21882,8664,5.74827e+13,1372.75,7724.85,30546,1123,269,27488,25324,21033,21904,20839
79965,813,4391,53148,26817,3.05124e+13,909.808,12837.6,79965,1284,327,74572,73017,50179,36256,9652
7304,754,1634,5122,2182,4.20078e+13,278.898,2938.06,7304,512,120,5670,5661,4438,4187,3206
89302,856,2965,56212,33090,3.07656e+13,729.804,10069.4,89302,644,459,86077,85344,70881,56792,43941
24444,351,2621,17765,6679,5.73054e+13,1174.33,6516.82,24444,865,242,19136,17620,10229,9736,3819
26154,555,1554,16735,9419,3.03197e+13,488.24,4281.3,26154,432,253,24439,23826,21329,18944,17360
43659,1675,1799,28199,15460,2.99236e+13,551.57,5880.44,43659,463,325,41860,41858,41669,41527,41657
79159,1972,2382,50952,28207,2.92924e+13,599.145,8278.5,79159,621,379,76777,76775,75793,74957,71948
20842,666,1930,12913,7929,2.7516e+13,310.053,4173.49,20842,663,137,18912,18822,17236,17007,12877
32836,358,2551,20949,11887,2.88182e+13,398.548,6183.38,32836,943,183,29089,26923,20411,14976,10598
50952,1750,2969,34538,16414,2.88311e+13,533.043,8462.62,50952,973,269,47983,47974,46482,41912,32290
86375,1541,3863,58682,27693,4.53392e+13,1199.86,12478.2,86375,1414,466,81654,79061,63184,23404,34382
91705,3511,3991,60521,31184,3.75788e+13,1241.26,12377.6,91705,1063,449,87714,87663,86564,85607,77625
43386,588,2089,26831,16555,3.06206e+13,438.502,5861.3,43386,480,300,41154,40367,32904,22272,20297
13120,308,858,8485,4635,2.99711e+13,436.746,2422.4,13120,349,180,11751,10893,10242,9977,5792
83797,1249,4224,58101,25696,4.8249e+13,1380.19,14244.1,83797,1755,530,77178,73209,55778,31130,27840
57501,310,3554,39829,17672,3.0698e+13,798.247,10344,57501,1031,285,50265,46828,31524,15078,6174
10843,183,1216,6582,4261,3.13199e+13,164.735,2437.83,10843,219,138,9526,8735,6955,2431,1515
46944,522,1781,30350,16594,2.95121e+13,533.006,5515.12,46944,457,296,44914,41900,38791,37462,27882
8010,452,620,5169,2841,2.89026e+13,283.698,1671.81,8010,213,150,7390,6982,7067,7001,6707
27436,889,2739,19687,7749,5.86171e+13,1219.86,7129.35,27436,1007,246,23271,22103,15262,14073,8923
46278,862,2063,28354,17924,3.08424e+13,469.55,5944.01,46278,422,310,44215,43969,35926,22490,21251
13679,584,1322,8592,5087,3.01394e+13,238.116,2979.53,13679,279,183,12357,12303,10944,9184,7790
14935,1698,1961,9950,4985,2.5671e+13,307.586,4079.44,14935,661,161,12974,12974,12832,12972,12576
43954,1262,2006,27396,16558,3.09554e+13,459.465,5835.03,43954,462,307,41948,41940,37528,37032,30598
17964,341,1827,11196,6768,2.65762e+13,304.476,3866.37,17964,622,137,15342,13888,11753,12467,6476
80689,8169,19649,59096,21593,2.31761e+13,228.953,25141.1,80689,1888,189,61040,60985,46463,46838,44559
50272,2266,3710,34632,15640,4.80071e+13,966.756,9723.8,50272,1154,428,46562,45242,38116,18584,23810
55430,516,1974,35744,19686,2.96779e+13,543.532,6517.46,55430,510,322,52905,49736,45234,44223,30886
25718,1588,2776,18389,7329,5.6667e+13,1223.58,6990.68,25718,1067,240,22599,21125,17456,17816,16661
81597,3630,3878,55820,25777,4.62849e+13,1176.73,12229.8,81597,1372,472,77719,77664,76463,73275,68518
49909,895,2449,31511,18398,3.03712e+13,552.479,7121.74,49909,532,367,47460,46999,39949,32016,21429
65701,2293,3656,44557,21144,4.32689e+13,1027.52,10387.7,65701,1055,430,62045,60687,51598,18996,30169
46076,2490,3597,32086,13990,5.15302e+13,1017.28,9545.35,46076,1225,419,42479,41248,35858,22799,26373
87737,3310,3976,55828,31909,2.93039e+13,799.424,12195.6,87737,1080,437,83761,83621,83761,83753,80151
13388,757,1876,8914,4474,4.63847e+13,657.563,4046.74,13388,672,125,11239,10612,10018,9089,5422
90370,21952,24065,74119,16251,2.4133e+13,5410.08,39512.9,90370,7796,25,66305,66305,66305,66305,62084
33670,690,1750,21202,12468,3.03496e+13,454.6,4992.85,33670,399,283,31907,31421,27775,22517,21968
65230,3253,3993,45581,19649,3.31957e+13,1057.92,12062.9,65230,1077,368,61237,61106,60195,60471,57173
17344,1267,1377,11116,6228,3.00213e+13,454.742,3475.22,17344,317,219,15967,15967,15930,15953,15591
59287,1657,3684,40748,18539,3.06718e+13,788.552,10588.4,59287,1064,284,55603,55237,52760,46232,31536
18066,847,1426,11593,6473,2.95559e+13,388.01,3672.79,18066,341,246,16640,16567,15963,15767,12701
32568,434,3147,23902,8666,6.06573e+13,1529.69,8066,32568,1041,282,25609,23827,11798,9666,5929
89802,2357,3434,58855,30947,3.44586e+13,925.982,10647.4,89802,719,384,86368,85860,82619,78370,61633
99242,3930,4340,64815,34427,2.96384e+13,837.024,14069.4,99242,1258,440,94902,94864,94902,94902,90634
34900,2426,2874,24662,10238,4.86132e+13,1163.95,8318.74,34900,1075,312,32026,31518,30022,30133,29906
83771,1921,4041,52749,31022,2.94054e+13,804.896,11723.3,83771,1040,412,79730,79376,72385,68249,53228
41857,485,1793,26904,14953,2.88016e+13,511.515,5571.08,41857,440,300,39678,37253,34285,33175,21220
1312,199,281,953,359,3.0907e+13,62.7782,533.097,1312,125,60,1031,1019,983,968,654
96293,8515,39806,77040,19253,111425000,1115.19,58841.6,96293,9662,11,56487,56487,42102,56487,10872
44108,1952,2677,31028,13080,2.85322e+13,581.173,7711.16,44108,873,273,41431,41427,40437,41072,32243
81004,3096,3949,52720,28284,2.95124e+13,684.178,12021.4,81004,1249,389,77055,77051,77032,76892,68723
69028,243,671,46849,22179,3.36704e+13,305.385,4482.37,69028,308,263,67110,63898,45451,38209,37733
38822,2308,3286,27737,11085,5.78404e+13,1461.78,9145.7,38822,1277,318,35536,33788,30278,30998,30786
19551,1294,1916,12299,7252,2.66857e+13,309.836,4134.65,19551,643,139,17635,17635,17482,17603,13032
21300,2424,3058,15763,5537,6.91427e+13,980.843,6355.72,21300,738,389,18242,17526,14526,15081,15207
24375,55,1042,15743,8632,3.00296e+13,517.213,3425.56,24375,389,235,17116,11495,13010,9667,2782
49463,883,2081,30534,18929,3.09824e+13,507.614,6245.8,49463,429,300,47382,47081,39082,26825,26457
83794,2892,4233,54082,29712,2.92849e+13,749.034,12654.1,83794,1249,391,79561,79447,79359,79397,59938
89601,1874,2898,57422,32179,2.99469e+13,677.937,9764.35,89601,716,435,86703,86602,83109,77207,74325
22518,6921,8902,18288,4230,1.70504e+12,90.9586,9788.42,22518,691,112,13616,13616,10902,13371,11013
53198,2444,3820,37863,15335,5.60253e+13,1339.19,10873.7,53198,1344,451,49378,47655,42321,32272,35678
15806,682,1624,11371,4435,2.70631e+13,341.168,3966.34,15806,442,141,14182,14004,13610,13546,10547
12371,153,367,8337,4034,3.30291e+13,274.721,1797.02,12371,234,138,10340,6474,6938,6513,7032
63376,299,621,42972,20404,3.35051e+13,302.436,4255.31,63376,306,256,62577,60948,44886,46066,39982
68893,2293,4119,49549,19344,5.3188e+13,1422.6,13234.5,68893,1578,535,64740,61695,50754,52182,50949
76185,672,3700,50500,25685,3.92119e+13,950.085,10528.3,76185,1041,431,71392,70111,55446,10424,12499
56247,2297,3641,36033,20214,2.91289e+13,488.089,9435.56,56247,1219,225,52606,52603,52270,52494,35558
62283,1322,3113,41707,20576,2.96218e+13,657.322,9314.05,62283,1100,278,59170,58683,53123,45909,26410
53247,2985,3003,38507,14740,4.91585e+13,1272.92,10505.3,53247,1173,349,50244,50244,50244,50233,50219
19395,846,2549,13449,5946,5.15244e+13,398.607,5107.92,19395,600,323,16846,16667,10264,4152,2116
77312,143,3986,51967,25345,3.19128e+13,977.842,12520.2,77312,1221,303,61950,50518,38633,10930,6186
58681,187,5854,49927,8754,4.19864e+13,17.111,6794.74,58681,2930,2925,52827,52827,18857,38668,33315
70410,422,4117,48676,21734,3.32629e+13,1057.08,12561.7,70410,1098,374,61913,58090,39940,20011,9584
49687,1911,3108,30429,19258,3.07346e+13,547.003,7431.02,49687,699,316,46579,46497,45383,45874,42457
36106,632,1925,21903,14203,3.12767e+13,357.653,5008.52,36106,403,262,34181,33984,26179,14322,12930
50215,2469,3904,35531,14684,5.73044e+13,1182.18,10549.2,50215,1376,462,46311,44874,38807,27554,30675
39885,109,1242,25724,14161,2.93679e+13,543.882,4440.33,39885,468,280,33165,29245,25478,22475,7562
60241,1718,3736,43321,16920,5.16807e+13,1422.11,11926.8,60241,1459,454,55737,51913,43529,42502,36795
77579,67,690,52618,24961,3.35255e+13,302.431,4743.84,77579,309,266,43406,17577,30719,8537,26043
81659,914,2888,51022,30637,3.02873e+13,695.357,9490.41,81659,568,447,78642,77974,64517,48341,38307
14712,1068,1342,8802,5910,3.16788e+13,224.071,2772.29,14712,234,148,13370,13368,12447,12822,11104
44397,1368,1999,28610,15787,2.96771e+13,577.162,6179.36,44397,576,322,42398,42376,41364,39937,34380
3402,295,1263,2535,867,4.64549e+13,131.385,1760.6,3402,359,143,2078,1856,941,1277,660
98568,1656,4882,66370,32198,3.57408e+13,1364.3,15786.4,98568,1422,426,93197,90960,82208,80732,39947
40556,1060,1790,26394,14162,3.30253e+13,528.381,5277.63,40556,453,290,38766,38745,35450,33548,26868
13340,1122,1200,9611,3729,2.75059e+13,222.868,3225.59,13340,338,136,12140,12140,12129,12135,11955
31649,1530,1651,20433,11216,2.96555e+13,527.661,4903.26,31649,437,296,29998,29998,29822,29721,29829
36996,731,2933,26454,10542,5.0305e+13,1354.5,8730.47,36996,1141,313,31406,29805,22027,20418,12451
37535,1113,1229,24291,13244,2.9512e+13,521.072,4248.96,37535,434,280,36306,36306,36094,36059,35614
99584,323,4200,68065,31519,4.55318e+13,1378.58,14754.4,99584,1775,526,84937,76568,58565,18740,8563
72629,2293,3740,48248,24381,2.88606e+13,810.045,10907.1,72629,1167,284,68889,68608,67453,67548,55994
54985,1183,3042,35781,19204,2.93618e+13,540.404,8523.58,54985,1161,251,51943,51489,47711,42455,27864
32422,700,1156,20916,11506,2.97473e+13,537.083,3975.41,32422,413,262,31266,31107,28735,28411,26701
67065,2167,2697,41726,25339,3.05959e+13,634.379,8404.8,67065,537,402,64368,64304,60553,61965,56399
71561,2959,4112,49663,21898,5.18784e+13,1406.02,13081.9,71561,1755,500,67449,67235,61063,44636,49975
28542,1065,1593,18378,10164,2.91855e+13,508.532,4587.07,28542,418,272,26949,26912,25745,24858,20485
9928,594,596,5804,4124,3.27695e+13,228.293,1442.74,9928,189,101,9332,9332,9332,9332,9332
23196,1768,1992,13822,9374,3.03362e+13,283.693,3894.1,23196,500,153,21204,21204,21180,21204,21123
18285,532,1140,11828,6457,2.98176e+13,455.158,3105.29,18285,371,192,17094,16046,15638,14777,13312
8647,238,1158,5568,3079,3.00292e+13,258.44,2426.53,8647,249,181,7324,6893,6005,5541,1742
59176,40,1762,38212,20964,2.99186e+13,569.493,5882.1,59176,539,341,37490,22389,26506,2803,1339
86522,1749,3961,59277,27245,4.59828e+13,1265.5,12837.6,86522,1423,484,81730,78583,63729,26915,35323
85896,1717,3194,56028,29868,3.38367e+13,724.16,9807.29,85896,670,383,82702,82531,76829,74456,60268
96591,1106,4085,64924,31667,4.14709e+13,1375.74,13303.9,96591,1388,480,90701,88285,69497,18674,23660
44475,2115,2307,26974,17501,3.13308e+13,499.895,6018.33,44475,551,283,42168,42168,42148,42168,42098
18107,1122,1370,11732,6375,2.95199e+13,355.013,3554.68,18107,321,229,16737,16733,16506,16367,14719
44444,128,1892,28607,15837,2.95222e+13,540.662,6073.06,44444,488,332,37313,34802,29704,24687,6085
60433,2377,3114,37522,22911,2.98015e+13,604.063,8387.65,60433,723,341,57319,57308,57283,57318,54573
69544,1008,3677,43742,25802,2.93763e+13,655.063,10127.5,69544,1021,387,65867,65451,53290,33392,29140
66076,517,2569,41529,24547,3.0625e+13,606.726,8269.6,66076,530,403,62785,60568,50123,38564,22647
36704,1473,2851,21954,14750,3.12301e+13,418.071,5802.5,36704,598,238,33853,33775,31196,32278,28256
2695,48,347,1573,1122,3.32974e+13,97.6289,637.459,2695,70,56,2205,2062,1557,1040,403
69490,2125,3795,44587,24903,2.91998e+13,587.597,10878.3,69490,1233,339,65695,65665,65121,65578,46616
99602,4100,4128,63747,35855,2.94192e+13,869.983,13516.4,99602,1251,453,95474,95473,95474,95474,95348
24705,581,1477,14578,10127,3.19544e+13,290.617,3384.21,24705,357,179,23228,23153,16279,9889,6710
35188,1827,2699,21099,14089,3.05723e+13,385.169,5529,35188,663,199,32489,32487,32437,32483,30813
48875,1965,2109,30099,18776,3.11217e+13,515.274,6223.05,48875,453,319,46766,46702,46452,46481,45702
58741,1150,2385,37812,20929,2.88389e+13,585.698,7485.83,58741,581,380,56356,56263,52464,50180,36886
60425,2111,2305,39140,21285,3.1578e+13,592.595,6789.25,60425,612,329,58120,58120,58108,58108,57991
6958,828,1308,4665,2293,3.73029e+13,275.217,2459.03,6958,395,93,5650,5631,5096,4763,4058
31147,999,1129,20105,11042,2.9668e+13,516.684,3858.69,31147,420,247,30018,30017,29748,29767,29560
50229,1784,2981,33305,16924,2.89622e+13,497.244,8298.55,50229,1057,257,47248,47243,46060,42810,33082
94491,2125,4169,64527,29964,4.6669e+13,1319.08,14266.4,94491,1823,482,90144,85948,70646,36543,44860
68621,1747,3328,45430,23191,2.98726e+13,719.968,9953.13,68621,1198,291,65293,65030,63239,64041,36088
49369,1865,3622,35386,13983,5.53137e+13,1569.53,10685.9,49369,1447,403,45285,41528,34069,34812,29111
97839,1257,4876,65783,32056,3.54864e+13,1331.87,15609.7,97839,1423,432,91696,89001,68446,64546,32726
77342,740,4069,49238,28104,2.95867e+13,706.316,11684.8,77342,1175,394,72967,71647,54174,35735,18031
52020,49,1993,33474,18546,2.91022e+13,574.562,6562.97,52020,521,333,35421,23040,26715,15426,3506
81775,2118,2421,52760,29015,2.95531e+13,585.868,8468.86,81775,653,380,79354,79354,78687,78293,77736
76180,954,4193,53240,22940,3.75554e+13,1186.37,13545.3,76180,1299,414,70153,67169,47681,37709,15889
42910,1687,2855,30453,12457,3.3857e+13,791.361,8625.81,42910,860,236,40055,39614,39449,39517,33155
22077,744,1479,13688,8389,3.02666e+13,298.092,3831.16,22077,305,220,20598,20570,17920,14794,12410
28898,463,2150,20695,8203,3.32443e+13,690.626,6284.55,28898,751,191,25987,25257,19103,21718,8643
84574,1511,3608,53101,31473,2.97997e+13,875.488,10895.2,84574,735,451,80966,80389,71133,51506,52261
34723,910,1606,22405,12318,2.95635e+13,538.425,4743.76,34723,462,257,33117,33087,32071,31838,30597
25878,333,443,17519,8359,3.34727e+13,292.846,2650.69,25878,278,197,25435,25435,21571,22638,21456
91318,1031,4294,63286,28032,4.71024e+13,1330.59,14993.6,91318,1810,539,83738,79779,60874,33802,27059
73472,2536,3908,50896,22576,4.9542e+13,1290.05,12450.4,73472,1498,471,69564,68296,60838,37271,46266
62599,961,2554,39270,23329,3.05052e+13,607.131,8044.44,62599,507,390,60045,59728,50092,38066,29130
17057,1802,1884,11987,5070,2.49416e+13,485.992,4481.36,17057,734,169,15173,15173,15172,15173,14666
33855,2347,2554,23954,9901,3.11819e+13,570.195,6757.53,33855,644,254,31301,31301,31289,31298,29359
32868,3180,3622,23226,9642,5.83508e+13,782.516,8216.21,32868,965,418,29246,29191,28495,22958,21691
74026,2243,2755,46758,27268,3.00973e+13,656.663,8990.78,74026,592,437,71271,71133,67999,68700,62897
72389,3214,3879,50239,22150,4.97017e+13,1299.86,12279.2,72389,1514,473,68510,68310,65765,42282,48692
32167,1477,1852,19442,12725,3.15023e+13,348.556,4669.66,32167,397,244,30315,30286,28628,29316,26772
31041,2988,3066,22500,8541,6.07042e+13,1331.43,7734.42,31041,985,276,27975,27975,27975,27975,27847
1551,440,611,1017,534,2.16029e+13,141.12,859.526,1551,346,49,940,897,777,940,871
51082,478,2029,33073,18009,3.01106e+13,551.4,6551.17,51082,516,328,48415,45275,41198,39661,22093
9401,826,2300,6519,2882,4.94037e+13,365.099,3878.1,9401,590,215,7101,6896,5218,4795,2673
77383,295,3699,52282,25101,4.25461e+13,1142.74,11490.8,77383,1253,440,66848,60114,48468,9494,4653
98633,3003,4663,69573,29060,4.3578e+13,1711.11,16372.3,98633,1713,605,93970,93246,81338,79621,72308
80508,472,4195,57997,22511,4.95365e+13,1716.01,14500.9,80508,1646,568,68680,64927,37205,34520,10203
15247,1218,1441,11139,4108,2.87544e+13,218.496,3798.54,15247,388,168,13806,13806,13594,13724,11785
48836,426,1928,31382,17454,2.89682e+13,542.514,5949.34,48836,514,304,45701,42127,39296,38046,21805
76822,485,3740,55102,21720,4.46743e+13,1590.52,13536.9,76822,1592,391,66153,62241,38959,36978,10488
21099,165,933,13587,7512,2.94423e+13,471.463,3035.26,21099,402,211,18216,17320,15154,12819,7317
9674,295,755,6240,3434,2.97934e+13,372.386,1961.77,9674,295,149,8593,8103,7597,7479,5033
79173,3108,4353,53477,25696,3.87764e+13,1180.17,13601.3,79173,1295,401,74820,74534,70444,69521,63962
18596,543,1022,12001,6595,2.94091e+13,432.983,3002.95,18596,331,204,17552,17043,15957,15648,14910
33443,602,1629,21518,11925,2.98192e+13,475.936,5012.28,33443,426,289,31787,30980,28200,27585,20001
14168,519,1374,8644,5524,3.09617e+13,209.474,2963.77,14168,254,182,12794,12745,10006,5823,4302
73103,980,3880,47309,25794,2.94231e+13,652.093,11378,73103,1231,373,69089,68215,52267,34070,20034
62566,211,3555,44917,17649,4.28528e+13,1236.02,11913.7,62566,1255,366,51170,45653,29546,14490,6915
26521,427,1602,17149,9372,3.05075e+13,528.874,4490.55,26521,398,266,24512,23033,20849,20196,8751
75450,333,4205,52943,22507,5.06137e+13,1391.05,13812.5,75450,1764,536,62511,56488,38954,21825,9768
14107,209,2411,10290,3817,6.24809e+13,452.339,4761.29,14107,603,201,10616,9519,5150,3843,1578
65659,3637,3750,43027,22632,2.938e+13,638.249,10440,65659,1223,279,61909,61909,61909,61909,60786
63854,1203,2318,41309,22545,3.05941e+13,601.383,6977.36,63854,568,344,61536,61505,57073,57529,51153
84577,496,3965,55349,29228,2.96841e+13,718.263,12347.8,84577,1246,393,78905,75531,53447,33924,17529
20702,223,2085,13897,6805,2.70308e+13,436.415,4932.51,20702,790,180,16641,14576,10729,8437,3688
67632,1453,3580,48422,19210,3.83268e+13,1201.44,12213.8,67632,1319,373,63392,60723,55943,54215,38667
32111,1157,1195,20733,11378,2.97812e+13,538.267,4014.09,32111,457,258,30916,30916,30875,30895,30887
71571,2401,3734,47289,24282,2.97364e+13,702.714,10778.3,71571,1221,287,67837,67598,66711,67396,42649
90466,878,4249,62349,28117,4.70023e+13,1398.9,14574,90466,1793,531,82197,78760,58136,27367,20461
56530,1627,3896,40048,16482,5.49216e+13,1345.94,11283.2,56530,1440,460,51671,48471,35701,26728,25272
25108,2385,2720,17740,7368,4.7223e+13,869.726,6896.4,25108,829,288,22388,22375,21370,21326,21297
31723,106,2718,22532,9191,4.36652e+13,830.997,7645.39,31723,828,295,23435,19022,12909,9102,3166
23045,128,1017,14930,8115,3.03582e+13,474.91,3281.28,23045,335,220,19128,17930,15172,13289,5702
7596,361,1689,5240,2356,3.23564e+13,295.911,2980.26,7596,394,129,5737,5534,4187,4480,2569
74107,1088,3037,48203,25904,3.42629e+13,645.856,8916.1,74107,644,364,71070,70843,60712,19430,14780
40501,388,1877,25495,15006,3.11187e+13,456.512,5531.05,40501,436,299,37896,35926,30914,23045,15799
33875,865,1157,21834,12041,2.95515e+13,541.731,4058.21,33875,444,268,32718,32667,31664,31560,30884
15719,67,1437,11402,4317,2.85694e+13,331.053,3950.77,15719,443,168,9393,5598,4228,1692,1339
3133,61,1184,2552,581,1.75894e+13,106.03,1551.39,3133,172,65,1701,1137,309,328,569
9212,160,616,5387,3825,3.24474e+13,210.45,1398.36,9212,160,105,8392,7470,6167,4497,3261
62788,727,3805,45194,17594,5.16132e+13,1424.16,12228.9,62788,1460,462,54381,51829,37045,33570,21138
93903,955,24827,76889,17014,2.65965e+13,5692.57,40390.1,93903,8627,27,49205,42998,29506,24117,2383
9008,454,630,5262,3746,3.21056e+13,203.311,1420.51,9008,158,109,8378,8362,8072,8198,7575
47142,6471,20144,37716,9426,97578600,937.221,29351,47142,4733,11,26998,26998,21437,26998,7785
74492,2049,3015,48474,26018,3.3793e+13,649.298,8856.05,74492,606,364,71477,71360,69294,68119,60791
71926,3500,3878,49552,22374,4.84385e+13,1257.59,12099.3,71926,1393,469,68048,67869,66577,60016,52274
54669,1866,3569,35050,19619,2.91073e+13,492.194,9174.01,54669,1206,225,51100,51095,50454,50957,31792
65341,170,3117,43439,21902,2.98888e+13,674.69,9465.01,65341,1150,278,56111,46015,34382,11466,8757
18930,940,982,12133,6797,2.93669e+13,499.294,3011.7,18930,361,208,17948,17948,17910,17943,17917
69063,604,2526,44733,24330,3.12249e+13,635.886,7757.87,69063,597,352,66401,64778,55265,19273,10840
37275,1097,1262,24019,13256,2.95028e+13,513.269,4337.28,37275,485,282,36013,36013,35772,35598,35483
16901,1221,1977,11592,5309,2.63846e+13,398.301,4487.04,16901,729,172,14924,14918,13961,14017,11621
50768,1040,2002,32791,17977,2.95399e+13,551.988,6562.27,50768,507,353,48766,48711,45065,44436,31926
47715,2078,3000,34400,13315,4.84509e+13,1267.86,9936.09,47715,1157,338,44608,42572,37346,39034,36828
40724,3254,3653,28887,11837,5.79534e+13,1147.77,9383.01,40724,1240,455,37071,36979,36346,29228,30420
40358,660,3232,28579,11779,5.82859e+13,1473.44,9225.54,40358,1299,315,33606,31612,20604,19373,9479
88210,4261,4420,61025,27185,3.75695e+13,1321.25,14742.2,88210,1426,428,83790,83788,83748,83501,82924
91944,2642,3444,60295,31649,3.47609e+13,915.383,10609.2,91944,732,396,88500,88492,86790,84840,72950
43522,998,2574,31272,12250,2.70111e+13,777.196,7755.54,43522,814,232,40913,39375,36493,37680,26771
37988,292,3564,26845,11143,5.50068e+13,1048.16,8902.24,37988,1107,417,30938,27762,17109,6921,3777
5361,247,674,3473,1888,3.16605e+13,300.463,1479.54,5361,249,138,4519,4156,3893,3842,2462
64105,2045,3324,42126,21979,2.97017e+13,665.608,9588.42,64105,1189,277,60781,60595,59520,60294,40133
42445,782,2917,25863,16582,2.98682e+13,422.134,6836.06,42445,878,236,39528,39277,29520,15224,9607
72851,2139,4251,51304,21547,5.11755e+13,1399.4,13743.9,72851,1757,524,68371,64375,51647,43267,42963
66223,1340,2685,42456,23767,2.99342e+13,592.826,8395.13,66223,634,408,63538,63454,58631,54370,43172
34120,1090,1137,21963,12157,2.89555e+13,533.584,4025.57,34120,435,261,32983,32983,32922,32933,32922
49207,1916,3233,34541,14666,2.73216e+13,772.928,8971.24,49207,865,281,45974,45875,44667,45561,33488
71076,2922,4081,50339,20737,3.78104e+13,1233.72,13065.4,71076,1311,409,66995,66878,62609,62492,56195
97218,2406,4437,68666,28552,4.57846e+13,1562.92,16204.1,97218,1876,568,92418,89771,75375,62809,57818
82655,1072,3992,54328,28327,2.97977e+13,729.543,12325.6,82655,1253,397,78485,77344,59348,41721,22614
22872,1266,1448,14651,8221,2.83168e+13,403.127,4032.9,22872,336,246,21424,21407,21179,21120,20094
90234,655,4491,64565,25669,4.43794e+13,1749.72,15586.2,90234,1664,582,79157,75328,43341,26388,9070
89138,2207,2863,56956,32182,2.91934e+13,690.056,9718.44,89138,685,430,86275,86163,84082,83199,80987
98658,1247,4387,70441,28217,4.48576e+13,1626.9,16410.7,98658,1848,582,91312,86670,70721,62607,40224
47322,1503,3773,33531,13791,5.68525e+13,1129.23,10093.6,47322,1306,461,42882,40695,29777,19594,23425
37175,2674,3574,26249,10926,5.54828e+13,1057.43,8852.5,37175,1114,422,33601,33388,29255,21294,23097
31211,2679,3536,21914,9297,5.78373e+13,681.277,7935.56,31211,917,407,27675,27525,24263,17106,17854
52475,363,3142,37767,14708,4.44118e+13,1278.7,10528.9,52475,1153,356,44292,42023,27577,26544,7693
80995,1328,3845,53327,27668,3.64212e+13,1056.04,10968.8,80995,970,386,77076,76016,61991,11663,13575
68631,3387,3790,46263,22368,3.09413e+13,842.896,11264.4,68631,1197,284,64841,64824,64841,64841,63472
24140,1516,2611,16912,7228,4.46455e+13,847.046,6623.42,24140,815,273,21529,20614,18994,18210,15611
99086,4136,4313,68304,30782,4.54135e+13,1327.86,15304.4,99086,1808,542,94773,94756,94068,92051,88636
57385,290,2151,37095,20290,3.01117e+13,563.149,7049.39,57385,579,337,51996,47753,44646,39747,18726
75675,1804,4305,52614,23061,3.67376e+13,1184.05,13463.5,75675,1158,415,71177,69651,62963,55020,40334
35147,1597,1771,22146,13001,3.06548e+13,459.815,5123.87,35147,420,274,33376,33375,33083,33204,32035
40627,1474,1769,26260,14367,2.99782e+13,488.236,5517.35,40627,425,301,38858,38853,38499,38122,35322
77508,909,4231,53899,23609,4.97502e+13,1388.67,13746.7,77508,1786,535,69510,66201,46928,26410,17309
61274,3563,3862,42994,18280,5.2766e+13,1254.36,11344.1,61274,1360,465,57412,57345,56725,54402,48069
65848,829,3583,47189,18659,4.73846e+13,1587.29,12345.8,65848,1363,377,58678,55617,37555,39784,16176
44789,826,2710,32125,12664,2.79713e+13,835.704,8106.16,44789,815,248,41596,40276,31287,27125,23867
16402,2096,2497,12062,4340,5.77885e+13,872.184,5275.01,16402,728,190,13905,13270,13671,13726,12047
69644,588,2655,43542,26102,3.05281e+13,630.301,8530.57,69644,553,414,66538,65153,52215,38670,24588
42061,775,3250,26008,16053,2.96534e+13,400.958,7250.28,42061,990,186,38811,38572,27576,18985,9779
86589,2639,2799,54893,31696,2.99937e+13,687.97,9595.64,86589,617,429,83790,83758,83465,83525,82295
72953,1219,3620,45890,27063,2.90513e+13,726.929,10412.7,72953,961,402,69333,68878,57848,38211,37280
82329,1399,4009,53778,28551,2.96806e+13,706.745,12248.6,82329,1245,387,78320,77714,64769,57911,34773
19119,372,1325,12278,6841,2.93407e+13,382.473,3585.52,19119,325,238,17486,16335,15119,14965,8230
53691,2453,2468,33609,20082,3.05182e+13,540.884,7237.94,53691,487,356,51223,51223,51223,51223,51180
95564,1869,3012,60549,35015,2.98867e+13,743.748,10329.7,95564,748,461,92552,92251,86680,74068,71541
76442,2224,4204,54375,22067,3.92797e+13,1320.2,13772.5,76442,1373,421,72238,70281,64350,63055,45830
82471,1027,4262,57583,24888,4.83752e+13,1346.85,14400.6,82471,1811,532,74922,71049,53373,31946,24587
9106,801,894,6656,2450,2.95175e+13,189.283,2321.87,9106,304,137,8212,8212,8170,8172,7432
42287,489,2617,30424,11863,2.69918e+13,723.981,7672.64,42287,799,258,38329,35807,21287,7010,4856
85361,3279,4143,58429,26932,4.63948e+13,1296.05,13468.7,85361,1603,472,81218,80986,75791,44496,55162
67295,1694,2758,44319,22976,3.5602e+13,843.037,7969.25,67295,689,333,64537,64022,57780,12903,18471
76880,2730,3681,51456,25424,4.13779e+13,1011.16,10702.3,76880,1021,424,73199,72957,65816,22625,35686
55516,872,3062,36394,19122,2.93483e+13,550.819,8629.3,55516,1125,257,52216,51599,42810,34003,23745
45854,372,537,31078,14776,3.3596e+13,296.541,3569.21,45854,295,238,45317,45317,38370,40640,37973
37455,144,500,25406,12049,3.35246e+13,298.595,3219,37455,291,225,30671,19125,20164,17493,19193
87704,3585,4005,56951,30753,3.11315e+13,722.002,12448.6,87704,1063,383,83699,83699,83699,83699,78764
97021,964,4011,64437,32584,3.87714e+13,1276.94,12462.5,97021,1097,448,91827,90557,74136,15437,27399
17790,800,904,11477,6313,2.9951e+13,444.075,2812.7,17790,361,207,16886,16886,16719,16705,16514
58718,1284,3795,42201,16517,5.42928e+13,1463.68,11859.6,58718,1458,500,52942,49141,37605,35051,27137
96807,988,4361,63205,33602,2.95654e+13,835.503,13847,96807,1264,432,92165,90846,70521,45773,24615
90155,3360,4116,57621,32534,2.97558e+13,810.154,12758.5,90155,1184,425,86039,85921,86039,86033,80234
58898,437,2409,37916,20982,3.0238e+13,641.403,7642.65,58898,593,379,55024,51290,46226,43339,19641
3681,315,615,2378,1303,2.94013e+13,131.164,1169.42,3681,187,108,3066,2975,2807,2843,1570
10511,676,936,6775,3736,2.95375e+13,326.631,2285.9,10511,290,155,9575,9464,9382,9374,9081
97203,28598,29534,78918,18285,2.59712e+13,4738.58,44011,97203,8118,132,67669,67669,67669,67669,65800
85057,697,2945,54107,30950,2.9815e+13,702.145,9712.69,85057,685,442,81804,80622,68226,60232,41088
18612,66,927,11977,6635,2.8908e+13,443.356,2871.26,18612,345,201,13888,9893,10647,9584,2873
24730,1391,3486,17931,6799,6.83165e+13,684.372,7190.56,24730,839,410,21244,20262,14330,12389,12286
39113,1691,1911,25195,13918,2.96061e+13,519.166,5749.4,39113,482,309,37202,37202,37026,37094,36730
19494,93,961,12555,6939,2.91378e+13,483.484,2986.98,19494,380,209,15699,13285,11739,10763,3658
40549,2666,3562,29353,11196,6.03673e+13,1450.88,9274.3,40549,1172,382,36987,36536,34022,34524,34241
51022,2444,2483,32230,18792,3.0109e+13,539.77,7281.21,51022,538,371,48539,48539,48533,48539,48413
37422,1005,1240,24151,13271,2.95974e+13,547.449,4347.2,37422,461,272,36182,36179,35476,35157,35032
29999,892,2414,21504,8495,3.13632e+13,704.216,6530.63,29999,678,190,27353,26549,21765,23629,11798
68372,2408,2649,43666,24706,2.92915e+13,584.21,8469.4,68372,645,410,65723,65723,65313,65508,63966
28774,744,2839,20287,8487,5.08073e+13,1165.08,7529.98,28774,988,305,24344,23037,17135,16290,9526
72088,1729,3870,50058,22030,4.9423e+13,1297.09,12200.9,72088,1438,473,67394,63923,50267,28306,29392
25134,538,995,16137,8997,2.89488e+13,483.31,3357.99,25134,413,228,24047,22717,22010,20926,18037
74322,2076,4149,52608,21714,3.7255e+13,1300.05,13451.3,74322,1382,419,70145,68098,63573,62039,42688
95089,2174,4483,64430,30659,3.65815e+13,1239.6,14965.5,95089,1363,427,90606,88975,83260,74103,60734
39534,624,1254,25449,14085,2.89882e+13,537.846,4441.06,39534,426,286,38280,37703,33613,33427,27902
31296,2016,2283,21861,9435,3.58369e+13,756.322,6906.03,31296,722,210,29013,29013,28964,29000,27289
76448,2181,2728,48871,27577,2.95984e+13,618.273,8941.99,76448,671,414,73720,73687,71680,70995,67460
50762,494,2999,34648,16114,2.91083e+13,541.558,8478.08,50762,977,272,46593,44072,30941,17925,10158
3291,221,468,2414,877,2.19453e+13,195.323,1115.74,3291,210,68,2801,2624,1903,2161,1297
33349,320,1397,21512,11837,3.08866e+13,548.736,4357.51,33349,479,263,30268,27993,25398,3137,3876
39365,1899,3059,26508,12857,4.25651e+13,613.55,7583.56,39365,864,350,36306,35973,30080,12184,13259
39006,1580,2735,23821,15185,2.91393e+13,412.328,6201.38,39006,889,181,36271,36247,36027,36168,29995
42837,1238,1322,27650,15187,2.98838e+13,572.482,4734.04,42837,486,278,41515,41515,41390,41374,41316
28980,643,1638,18453,10527,3.06931e+13,457.672,4567.98,28980,411,256,27290,26790,24135,20496,19495
3976,49,398,2322,1654,3.24766e+13,136.23,808.983,3976,89,74,3255,2998,2292,1193,758
10950,1503,1561,7205,3745,2.32131e+13,314.903,3147.68,10950,548,134,9389,9389,9389,9389,9336
70713,1451,3878,50936,19777,4.89287e+13,1538.98,13093.2,70713,1468,500,65233,60975,50768,47864,36492
35028,1830,2841,24823,10205,4.47488e+13,851.81,8180.78,35028,884,309,32187,31347,28447,28989,27026
59021,2808,4164,42219,16802,5.62827e+13,1546.25,12441.7,59021,1627,516,54857,54668,48488,46681,47348
65404,669,3712,44159,21245,2.89029e+13,789.331,10639.4,65404,1067,284,60618,58893,42297,27760,18925
23424,259,2908,17125,6299,6.49539e+13,1086.2,6551.07,23424,939,261,17854,15984,8849,6987,3474
30463,439,2279,21775,8688,2.72432e+13,618.758,6222,30463,805,235,26758,24470,15456,6721,2372
20220,1214,2536,15409,4811,7.18337e+13,1139.61,5837.24,20220,688,258,16854,16091,10229,10154,8392
79754,581,713,54115,25639,3.35752e+13,303.355,4828.5,79754,310,268,79041,79041,73861,75509,73741
96421,2405,4864,64976,31445,3.58785e+13,1331.44,15563.7,96421,1415,427,91557,90522,84558,85795,53839
20901,1689,1914,12767,8134,2.8016e+13,303.657,4077.27,20901,626,140,18987,18987,18967,18987,18363
50935,3809,3881,36354,14581,5.73154e+13,1371.74,10832,50935,1359,458,47054,47054,46990,46865,46417
26561,1114,1130,17157,9404,2.96084e+13,518.786,3581.33,26561,440,225,25431,25431,25431,25431,25426
59819,3311,3644,43020,16799,5.00531e+13,1434.39,11777,59819,1454,381,56175,56173,55820,55949,55547
10544,404,712,6775,3769,2.73351e+13,311.858,1960.36,10544,299,146,9725,9227,9163,8689,8012
20203,699,2545,14968,5235,6.0451e+13,1211.32,5921.91,20203,767,239,16232,15703,8314,9603,5382
38653,388,2901,27583,11070,4.48094e+13,1019.37,8729.54,38653,929,315,32699,31184,22961,22534,10945
69265,3628,4112,49727,19538,5.2687e+13,1418.55,13369.3,69265,1614,533,65153,65141,64513,62104,62099
84511,2604,3885,57318,27193,4.42646e+13,1226.24,12325.7,84511,1397,458,80626,79284,70592,29931,45702
42274,940,2045,27883,14391,3.76447e+13,545.11,5737.26,42274,489,278,40229,40120,34806,8079,10419
76308,2002,3251,49922,26386,3.50652e+13,744.341,9272.55,76308,694,369,73057,72789,69117,66878,54825
71060,2235,3655,51115,19945,4.59514e+13,1632.93,12912.5,71060,1514,381,67033,64125,57476,55804,48077
95702,1089,9737,81254,14448,4.2168e+13,17.515,10971.6,95702,4790,3185,85965,85964,35233,61549,57223
24154,286,1589,14872,9282,3.10758e+13,302.667,4034.01,24154,310,239,22189,21115,16847,10142,5369
97083,209,4349,63469,33614,2.97451e+13,839.002,13863.9,97083,1256,431,85593,77470,57473,23977,8951
99053,915,4139,63073,35980,2.93518e+13,865.851,13235.9,99053,1199,454,94520,93631,76353,56665,41396
53560,858,1984,34526,19034,2.91297e+13,561.375,6648.06,53560,491,356,51576,51189,46911,46374,32913
65398,1759,2664,43129,22269,3.61354e+13,843.608,7696.14,65398,670,331,62734,62273,57198,13635,20344
66847,85,3821,48254,18593,5.31339e+13,1422.29,12659.1,66847,1465,526,46666,35492,22237,17993,3686
12227,466,996,7870,4357,2.97658e+13,372.615,2513.69,12227,329,171,11224,10709,10629,9914,8877
5995,426,694,3864,2131,3.08951e+13,300.973,1589.66,5995,253,144,5301,4972,4942,4753,4240
75228,3125,4275,52542,22686,5.03623e+13,1415.64,13781.8,75228,1807,538,70953,70757,65607,49495,54533
64928,790,3746,44196,20732,3.07871e+13,810.918,11045.5,64928,1111,285,60302,58795,45067,29438,16530
42318,58,1309,27310,15008,2.92994e+13,536.167,4630.15,42318,425,295,30293,20563,23375,21045,2533
38674,3006,3370,28341,10333,6.44494e+13,1498.55,8934.93,38674,1114,439,35304,35287,33363,33762,33734
79341,2826,4016,52925,26416,3.19636e+13,955.867,12535.3,79341,1246,303,75325,74968,75161,75278,64010
57864,1732,2538,36978,20886,3.01448e+13,571.352,7812.83,57864,542,402,55326,55290,52746,50690,49184
2013,91,366,1289,724,3.01318e+13,94.468,690.477,2013,104,71,1591,1436,1285,1339,1013
19973,873,958,11669,8304,3.20861e+13,281.624,2366.41,19973,298,149,19015,19013,18902,18916,18583
17025,553,1600,11524,5501,4.77775e+13,351.799,3661.76,17025,349,209,15407,14729,12404,4048,4014
96412,2046,4316,67731,28681,4.66223e+13,1543.15,15833.4,96412,1816,563,91409,87182,72557,51556,47459
49329,512,2374,31514,17815,3.00286e+13,558.861,7087.92,49329,510,373,46484,44710,38930,34680,18339
93256,3279,4086,59583,33673,2.93851e+13,802.168,12929.3,93256,1214,430,89170,89054,89170,89131,81482
25927,2442,2752,18217,7710,5.44416e+13,1150.42,7016.12,25927,986,283,23175,23086,22686,22754,22245
2073,177,525,1625,448,9.32053e+13,101.431,872.591,2073,57,93,1548,1443,664,772,486
55993,462,1999,36117,19876,2.94753e+13,537.717,6406.36,55993,521,315,53216,49330,45640,44798,31595
1355,286,609,1000,355,8.11087e+12,115.418,789.369,1355,160,44,746,656,524,714,670
18833,904,2040,12911,5922,2.61813e+13,455.168,4783.12,18833,767,179,16793,16507,13124,12615,5350
40239,859,3694,28507,11732,5.82985e+13,1160.17,9339.93,40239,1276,447,34804,33192,21644,13360,12965
36985,1058,1224,23888,13097,2.94562e+13,543.183,4262.81,36985,476,268,35761,35761,35379,35194,34962
4128,120,456,2413,1715,3.26777e+13,144.844,879.84,4128,98,74,3548,3208,2752,2277,1041
98653,364,4882,66444,32209,3.6251e+13,1339.4,15794.3,98653,1421,424,87061,82372,52404,24268,4650
87098,1627,3696,57174,29924,3.51991e+13,1170.03,11257.1,87098,885,369,83402,82320,69490,13651,19271
70523,3642,3746,44702,25821,2.96792e+13,603.642,10548.2,70523,1178,321,66777,66777,66777,66777,66275
72625,158,2530,47149,25476,3.12379e+13,666.397,8079.31,72625,635,362,62187,58298,49721,4901,3318
42161,391,519,28625,13536,3.36097e+13,298.121,3421.01,42161,295,234,41642,41642,37117,38478,37107
90460,214,4142,59609,30851,2.91874e+13,917.638,13072.1,90460,1250,404,80339,72727,52026,16411,10113
55401,56,2068,35813,19588,2.97649e+13,539.104,6852.27,55401,511,355,39160,26796,30407,28449,4862
37294,544,2595,23859,13435,2.86478e+13,386.708,6583.58,37294,991,185,34288,32286,25812,21315,15899
37539,490,2243,27091,10448,2.79932e+13,663.11,6904.6,37539,649,230,34395,33145,20425,11824,14330
40143,3402,14782,22365,17778,3.76599e+13,548.399,17654.8,40143,14216,76,25361,25361,11496,5368,15105
19576,735,1276,14331,5245,2.97119e+13,289.647,3933.1,19576,369,177,18300,18194,17454,17961,11515
36206,2646,2892,25710,10496,4.73271e+13,1074.68,8473.54,36206,988,318,33314,33151,32793,32798,32376
76947,1444,3596,50697,26250,3.61462e+13,990.249,10445.8,76947,874,359,73351,72398,59413,12051,16120
46956,2468,3094,33593,13363,4.32149e+13,1109.65,9792.56,46956,1019,342,43862,43597,40411,41316,40995
20704,427,944,13263,7441,2.85229e+13,465.493,3040.5,20704,354,226,19497,18059,17269,16541,14079
94725,3388,4487,66311,28414,4.11342e+13,1557,15656.3,94725,1656,454,90238,89793,83185,84116,76344
27968,270,2265,19524,8444,3.65625e+13,678.369,6494.29,27968,689,204,23597,21646,17894,18074,7292
91275,11074,24599,74490,16785,2.6134e+13,6063.26,40032.5,91275,8054,27,66676,53733,56261,59058,41114
62123,3083,3760,40299,21824,2.93724e+13,600.869,10175.3,62123,1211,297,58363,58359,58351,58257,52840
72760,472,2879,47346,25414,3.27019e+13,659.144,8318.8,72760,623,359,68581,63355,56668,6904,6505
69170,196,4059,49607,19563,5.29346e+13,1425.5,13160.9,69170,1538,535,54193,47688,29285,26256,7526
64323,662,3461,42500,21823,3.74225e+13,794.652,9445.66,64323,930,352,60383,59342,46132,7845,5342
97685,4014,4870,65811,31874,3.59329e+13,1343.79,15660.7,97685,1419,427,92815,92674,92404,91450,86206
2657,369,406,1669,988,2.63765e+13,98.4712,792.466,2657,118,75,2251,2249,2247,2247,2213
78052,772,2844,49646,28406,2.99631e+13,655.275,9253.44,78052,641,435,75066,74225,63204,55939,39790
40657,3345,3575,29349,11308,5.99335e+13,1456.44,9337.3,40657,1188,391,37082,37082,36609,36813,36322
2607,120,362,1696,911,2.83932e+13,90.8147,743.529,2607,108,67,2245,2130,1927,1956,1104
98600,887,4069,65952,32648,4.00194e+13,1370.35,13287.4,98600,1373,475,92191,90261,69669,16316,19669
2280,723,1089,1834,446,5.84513e+13,76.2886,1425.86,2280,335,96,1191,1191,588,716,459
88212,6620,8806,75030,13182,4.20616e+13,17.0743,9960.48,88212,4407,4402,79406,79406,66308,73944,72863
91300,219,4465,62320,28980,3.65052e+13,1269.79,14802,91300,1410,421,76966,68611,46285,16360,10388
42494,1398,2652,30376,12118,3.22505e+13,810.903,8190.96,42494,924,233,39842,38869,37993,38746,29093
31582,1267,1642,20376,11206,2.98964e+13,470.4,4912.65,31582,423,294,29940,29927,29330,28708,24264
9034,1439,1823,6219,2815,4.44512e+13,329.825,3381.35,9034,490,130,7211,7071,6990,7166,6522
84859,2871,2873,53724,31135,2.99782e+13,702.28,9645.94,84859,650,438,81986,81986,81986,81986,81984
81518,1772,3704,54761,26757,4.11195e+13,1125.68,11223.5,81518,1091,433,77424,75808,62522,18236,32560
92423,14955,24358,75879,16544,2.35969e+13,5324.28,40214.3,92423,7796,25,68065,68065,61114,63692,53626
94789,3974,4168,64861,29928,4.68104e+13,1331.6,14189.5,94789,1804,472,90621,90607,89962,88103,86712
63457,1085,2633,39282,24175,3.08577e+13,647.072,7919.35,63457,527,407,60824,60501,50054,32377,29298
15874,882,908,10193,5681,2.96033e+13,436.324,2680.5,15874,342,202,14966,14966,14939,14947,14942
44524,453,2856,30148,14376,2.86394e+13,518.014,7866.17,44524,964,260,40305,37937,26627,16596,9766
63388,232,633,43061,20327,3.36365e+13,303.905,4269.75,63388,306,258,61362,57524,41693,34557,35437
85695,135,4320,61592,24103,4.85155e+13,1672.91,15208.1,85695,1765,567,64611,52163,34440,15737,5467
11365,310,2289,8420,2945,6.06035e+13,348.172,4210.45,11365,568,189,8693,7907,4100,3538,1118
85084,1749,4269,59107,25977,4.75379e+13,1358.97,14524.7,85084,1802,532,79842,75462,60917,40210,37388
61240,826,2140,39539,21701,2.95812e+13,562.127,7249.81,61240,580,362,59100,58578,52414,51859,38055
59931,2990,3673,41404,18527,3.06792e+13,813.123,10714.4,59931,1035,282,56258,56258,56253,56258,53197
33704,1177,3572,24590,9114,6.64619e+13,1239.78,8527.26,33704,1123,445,28987,27131,17493,16066,16110
19777,1731,1795,13954,5823,2.60459e+13,610.201,4752.38,19777,782,176,17982,17982,17981,17976,17632
42386,1287,1823,27245,15141,2.90034e+13,540.175,5533.71,42386,464,286,40563,40563,40197,40073,38101
84015,1258,2750,54444,29571,3.10869e+13,710.516,9064.41,84015,669,385,81265,81046,73100,72711,54510
67448,1984,2236,43447,24001,2.95167e+13,597.385,7564.69,67448,625,349,65212,65212,64884,64819,64542
33775,400,1195,21741,12034,2.93473e+13,525.272,4084.4,33775,418,266,31633,29226,27710,26539,14747
76242,1037,3750,51488,24754,4.24869e+13,1153.24,11480.6,76242,1302,432,71241,69216,52959,15825,17254
81341,1748,3569,53441,27900,3.5294e+13,1006.58,10723.6,81341,861,359,77772,76861,65005,13689,19264
18160,136,878,10608,7552,3.2323e+13,271.139,2175.66,18160,289,131,16452,14682,11030,6580,5071
15466,695,893,9922,5544,2.85731e+13,442.88,2616.68,15466,379,184,14573,14545,14201,13995,13926
71992,1314,4238,51106,20886,5.15935e+13,1401.21,13770.3,71992,1754,534,65642,61508,47109,37718,30441
25561,72,443,17346,8215,3.36235e+13,295.222,2635.74,25561,278,192,14807,5932,10383,8317,5079
96984,1848,4245,63329,33655,2.97958e+13,854.078,13822.7,96984,1252,444,92739,92197,84124,81913,50021
76973,3272,3892,50678,26295,3.6476e+13,1057.62,10881.4,76973,994,392,73081,73044,71792,71298,63422
42924,938,2879,30400,12524,3.4292e+13,788.265,8701.47,42924,865,235,39735,38143,33141,35170,17977
69070,2248,3872,49797,19273,4.96829e+13,1485.01,12904.2,69070,1465,485,65042,61978,52940,56186,50784
46800,1385,1455,30144,16656,2.94224e+13,577.542,5031.52,46800,493,302,45345,45345,45282,45306,45199
96966,2711,4075,63705,33261,2.98456e+13,767.031,13312.7,96966,1262,410,92891,92637,92021,92439,66260
77969,370,3926,49161,28808,2.96028e+13,740.364,11327.4,77969,1070,405,71491,66778,52110,35212,17605
23294,1313,3252,16374,6920,5.8464e+13,626.579,6721.73,23294,903,404,20042,19224,13233,8760,9324
76766,1346,3907,55181,21585,4.58377e+13,1678.33,13775.3,76766,1615,411,70737,66396,56179,54567,32991
95413,3350,4295,66508,28905,4.57178e+13,1342.38,15528.4,95413,1811,548,91118,90898,85847,64089,71485
36424,494,1806,22919,13505,3.04185e+13,473.345,5245.87,36424,444,286,34278,33159,28753,22150,18695
10983,666,1019,7112,3871,3.23166e+13,344.754,2404.45,10983,282,181,9964,9935,9317,8794,6900
66215,1111,2698,41336,24879,3.07445e+13,635.942,8446.6,66215,536,414,63517,63203,53493,37916,29816
51167,2774,3777,36595,14572,5.80954e+13,1372.58,10761.1,51167,1407,455,47390,47219,42654,35807,37675
49758,1660,2933,33857,15901,2.89176e+13,537.941,8326.76,49758,968,269,46825,46816,45299,40932,30166
64895,1603,2594,41076,23819,3.00801e+13,591.871,8270.05,64895,554,407,62301,62189,57072,49140,49634
79997,572,4058,53168,26829,3.09791e+13,918.542,12321.5,79997,1313,296,73878,70040,49640,32254,19064
40856,1554,2642,28377,12479,2.82517e+13,560.098,7425.66,40856,893,263,38214,38199,36869,32883,26263
2003,250,351,1273,730,2.82432e+13,84.5676,666.192,2003,93,64,1652,1642,1639,1617,1415
32556,158,1653,20992,11564,2.97845e+13,532.288,4877.58,32556,435,302,27887,25857,22142,18547,3724
39700,70,1198,25566,14134,2.91893e+13,530.136,4376.76,39700,454,268,30306,22253,22959,21566,4823
72678,1830,3916,50330,22348,4.90397e+13,1268.08,12368.1,72678,1516,465,68130,64451,51263,30730,33548
57939,2064,2449,37116,20823,2.97664e+13,574.112,7716.77,57939,556,387,55490,55489,54636,54870,52361
68098,2805,3210,44951,23147,3.69704e+13,841.227,9234.68,68098,870,354,64888,64888,63046,60453,52335
5885,421,656,3840,2045,3.00355e+13,204.326,1436.67,5885,234,111,5229,5058,5027,4864,3955
19303,726,1056,12570,6733,3.13358e+13,490.69,3128.85,19303,347,208,18247,17875,17290,16673,16925
15585,128,851,10013,5572,2.88701e+13,428.181,2580.78,15585,299,205,12981,12208,10442,8683,1806
99312,1461,4072,67581,31731,4.40663e+13,1303.48,13826.2,99312,1567,476,93709,90121,70461,28649,31833
53271,2533,3204,36563,16708,2.86659e+13,606.234,8905.31,53271,956,278,50067,50060,49789,50005,44158
57278,641,2519,36011,21267,3.0669e+13,571.459,7698.75,57278,509,385,54509,53594,43755,34068,20549
94286,297,4481,64114,30172,4.15976e+13,1290.73,14997.2,94286,1468,437,81451,76537,49017,24910,16697
81274,1037,4226,58534,22740,4.97344e+13,1719.7,14625.8,81274,1660,573,73341,68953,51055,49343,26123
64685,3750,4121,45484,19201,5.4458e+13,1440.29,12626.8,64685,1743,499,60564,60553,59927,56327,52048
17427,594,1059,10194,7233,3.2138e+13,267.406,2374.1,17427,302,141,16368,16325,14846,15522,13474
95248,3078,4700,63182,32066,3.16706e+13,1025.9,14946.1,95248,1373,391,90548,90296,90413,90122,73587
18978,1085,1919,13305,5673,3.62951e+13,516.003,4894.74,18978,611,149,17059,16420,16373,16060,14051
40202,1537,3721,28849,11353,6.07218e+13,1182.39,9411.38,40202,1261,445,35900,33786,23912,18683,21637
17903,971,1803,11150,6753,2.63368e+13,310.918,3841.35,17903,620,137,16100,16094,15709,15897,11680
75067,3404,4112,51884,23183,5.00982e+13,1279.34,13002.4,75067,1688,467,70955,70801,68070,45701,52249
34737,2098,2890,24910,9827,5.43483e+13,1400.11,8355.43,34737,1133,323,31826,29845,24746,26016,26394
87024,1571,4402,62026,24998,4.74074e+13,1606.85,15446.1,87024,1771,565,80910,76497,62846,53147,40698
83186,1040,2725,53591,29595,2.92734e+13,619.654,9013.7,83186,665,404,80461,80291,72927,71770,55666
85461,395,4256,59389,26072,4.78666e+13,1370.2,14553,85461,1800,524,72855,67211,47834,24160,12308
72573,425,2713,45798,26775,3.01238e+13,646.582,8851.73,72573,577,425,68387,64610,54679,43552,19903
74149,2345,4171,53346,20803,5.14666e+13,1417.73,13864.7,74149,1620,537,69978,67114,55812,56265,55114
4527,523,716,3249,1278,1.66402e+13,357.109,1586.3,4527,444,78,3729,3109,3083,3290,3480
42451,225,2822,30438,12013,2.75565e+13,711.421,7818.75,42451,821,263,36216,32294,20415,5819,1243
64626,746,2218,41596,23030,2.94403e+13,585.15,7500.84,64626,588,362,62408,61721,55011,54396,41567
70838,1947,3441,44048,26790,3.01841e+13,802.383,9561.57,70838,691,416,67397,67108,61338,62715,53536
34419,418,1700,22271,12148,3.03884e+13,544.145,5144.45,34419,464,298,32016,29648,26840,26548,10867
81700,1599,3865,56300,25400,4.72655e+13,1270.32,12645,81700,1415,485,76731,73329,56742,28301,30500
13326,51,1288,8619,4707,3.08377e+13,320.842,2993.62,13326,296,207,9007,5946,6887,3741,505
57737,1766,3023,35504,22233,3.05977e+13,590.249,7734.19,57737,643,331,54714,54567,51851,52995,49372
45470,273,3071,32855,12615,5.27849e+13,1326.02,9799.64,45470,1181,346,36501,33141,21546,19677,7833
8668,197,697,5615,3053,2.90626e+13,337.971,1805.31,8668,259,145,7482,7075,6567,5921,3777
18559,963,2918,13497,5062,7.03843e+13,750.643,5808.69,18559,701,405,15309,14620,9031,8546,7936
12546,1360,1878,8717,3829,3.77886e+13,385.882,4010.34,12546,540,138,10668,10448,10308,10494,9506
82175,3950,4257,58190,23985,4.94637e+13,1343.79,14618.3,82175,1748,543,77918,77905,77446,74982,71097
13009,163,1598,8233,4776,2.50629e+13,298.104,3267.56,13009,542,131,9883,8379,6674,6040,2774
20818,2489,2641,14701,6117,5.69715e+13,837.886,5957.87,20818,807,231,18177,18122,18177,18156,18053
37674,2166,2719,25839,11835,3.10659e+13,514.505,7200.4,37674,709,252,34955,34955,34558,34772,28544
70454,2822,3789,47388,23066,3.10099e+13,844.047,11432.3,70454,1199,283,66665,66496,66500,66646,58514
79759,1361,2810,50544,29215,2.9856e+13,685.187,9309.08,79759,604,425,76949,76722,68653,58970,50467
34637,1775,1930,21131,13506,3.10044e+13,414.904,5112.13,34637,373,286,32707,32703,32571,32567,31957
35703,1753,1838,22362,13341,3.07605e+13,442.607,5207.37,35703,427,287,33865,33865,33816,33863,33415
69385,1739,3758,44224,25161,3.00831e+13,584.406,10697.4,69385,1204,319,65627,65509,62172,62367,44677
62164,933,3574,44884,17280,4.63417e+13,1470.66,12025.8,62164,1227,382,55695,52690,38986,38620,17893
28414,269,1083,18334,10080,2.98918e+13,495.387,3656.99,28414,351,251,25695,23732,22430,21478,7471
74247,609,2717,46888,27359,2.99357e+13,656.018,8927.9,74247,617,424,71100,69185,58194,47719,32942
44764,838,1355,28862,15902,2.94778e+13,546.742,4818.44,44764,441,294,43409,43367,40323,40714,37620
53506,527,2453,33248,20258,3.09725e+13,589.062,7121.52,53506,463,384,50569,49501,38265,26330,12725
75674,11126,11771,51525,24149,2.69807e+13,401.846,17837.2,75674,1388,312,63903,63903,63506,63875,63448
45940,2119,2866,29549,16391,2.89289e+13,456.189,7609.95,45940,1118,209,43074,43072,42595,41206,38100
84503,3110,4184,58247,26256,4.91057e+13,1327.99,13752.6,84503,1786,477,80319,80068,73596,45458,54629
21253,637,2143,18064,3189,4.22312e+13,16.9834,2693.66,21253,1075,1070,19110,19110,10101,15351,14611
28357,957,2154,17719,10638,2.7815e+13,305.718,5011.58,28357,737,158,26203,26193,25759,24775,18864
90151,1399,4469,63084,27067,4.05731e+13,1461.84,15207.9,90151,1457,459,83960,80485,67123,58784,28872
92004,591,4064,61586,30418,3.939e+13,1316.41,12800.4,92004,1190,450,85228,82376,62405,11730,9539
63564,878,4072,44617,18947,5.31334e+13,1313.45,12091.4,63564,1523,473,56401,53824,35997,20803,13098
59771,1309,3646,37413,22358,3.11348e+13,573.042,9403.58,59771,971,313,56125,55877,47700,43409,31511
92984,1303,4439,66807,26177,4.59991e+13,1736.38,15811.4,92984,1725,607,85826,81186,64941,61160,36776
97963,769,3681,62027,35936,2.9365e+13,958.754,12181.1,97963,977,462,93666,92575,74932,56243,39439
78161,532,4177,56356,21805,4.97275e+13,1685.04,14206,78161,1570,560,67060,63501,37111,34645,12043
79963,2527,3925,52352,27611,2.9461e+13,701.351,12011.7,79963,1240,389,76038,75867,75147,75696,50905
66828,2475,2733,42211,24617,3.00038e+13,609.323,8532.1,66828,582,418,64095,64027,63105,63375,61079
84252,453,4087,55593,28659,2.91563e+13,799.669,12557,84252,1237,368,78135,74832,50751,30918,12349
13623,621,803,8782,4841,2.90497e+13,385.848,2347.3,13623,304,173,12820,12618,12398,12068,12103
28829,2267,2538,20187,8642,3.74856e+13,793.329,6961.8,28829,815,251,26291,26289,26103,26137,25954
88297,3266,3925,57900,30397,3.56855e+13,1208.92,11866.1,88297,1023,403,84372,84214,82449,81194,69555
92181,3242,3942,62775,29406,4.44196e+13,1271.06,13016.1,92181,1433,476,88239,87934,84686,41282,56887
16930,851,1910,11888,5042,3.63365e+13,466.532,4646.18,16930,590,147,15020,14483,14014,13979,11545
49173,1872,1979,31702,17471,2.93818e+13,558.344,6375.56,49173,498,324,47194,47194,47121,47097,47114
6856,337,529,4011,2845,3.26016e+13,188.486,1163.29,6856,141,94,6327,6246,5789,6040,5004
86969,172,3968,59417,27552,4.55571e+13,1235.19,12666.3,86969,1409,474,70742,64536,46815,7304,3254
23325,1803,2352,19825,3500,4.22264e+13,16.9854,2929.66,23325,1179,1174,20973,20973,17716,19610,19125
19160,1779,2197,13038,6122,3.89304e+13,676.769,5352.59,19160,723,194,16963,16793,16810,16936,14281
37065,2387,2935,26318,10747,4.91978e+13,1344.76,8751.34,37065,1152,323,34130,33233,31023,31092,30951
32137,1891,2930,23252,8885,6.3083e+13,1298.21,7973.58,32137,1123,277,28942,26872,20156,21117,21842
20154,585,1941,12041,8113,3.03507e+13,272.564,3651.64,20154,463,146,18213,17915,16061,16821,13821
69979,2084,4038,50499,19480,5.29242e+13,1429.41,13197.4,69979,1524,535,65696,61789,50712,53600,48118
71429,1876,3662,47702,23727,4.06858e+13,911.217,10329.9,71429,1041,421,67767,66614,55382,15945,20616
33878,706,2237,20285,13593,2.99182e+13,363.493,4853.84,33878,658,167,31641,31481,27121,26382,23589
58851,366,2515,36635,22216,3.06007e+13,595.031,7653.2,58851,509,386,55100,52239,41802,28448,12047
81538,3402,4374,56414,25124,3.72563e+13,1221.95,14115.6,81538,1318,421,77164,76901,73530,73856,68411
16702,1153,1879,10931,5771,2.49075e+13,286.168,4082.37,16702,636,157,14823,14823,14665,14783,10645
4778,277,630,3073,1705,2.86301e+13,231.059,1324.44,4778,234,111,4105,3858,3633,3667,2668
55351,1565,2042,35659,19692,2.92118e+13,558.635,6834.17,55351,508,355,53309,53304,52185,50971,47851
18063,180,405,12261,5802,3.39238e+13,284.008,2192,18063,258,163,16429,11530,11566,9950,12754
9614,164,977,8173,1441,4.21997e+13,16.9682,1341.83,9614,492,487,8637,8637,3781,6610,6219
59498,2112,2454,38036,21462,2.99629e+13,574.774,7806.75,59498,563,389,57044,57042,56125,56379,54045
48275,2755,2958,31374,16901,2.88603e+13,463.204,7937.34,48275,1097,233,45317,45317,45315,45317,44670
55359,1571,4038,39455,15904,5.92746e+13,1463.62,11719.9,55359,1636,460,50203,46550,33705,28858,27149
62366,1953,2389,40097,22269,2.97413e+13,615.339,7796.19,62366,579,382,59977,59973,59195,59113,57935
40726,1645,1708,26255,14471,2.91662e+13,491.645,5189.47,40726,443,282,39018,39018,39005,39000,38829
65636,432,2575,42257,23379,3.00866e+13,598.567,8194.41,65636,629,398,61695,57509,51710,48911,20991
15075,4742,10379,11910,3165,2.19297e+13,454.396,11677.4,15075,1988,11,4696,4008,4696,4696,4696
83965,1565,3046,54486,29479,3.23891e+13,749.518,9516.8,83965,680,383,80919,80731,74246,71664,54834
34296,620,1201,22126,12170,2.93285e+13,503.667,4105.5,34296,431,273,33095,32683,29359,29337,25231
58783,467,2046,37833,20950,2.88255e+13,573.499,6960.54,58783,544,362,55876,52690,47971,46601,25114
42039,1134,1261,27141,14898,2.93664e+13,547.122,4554.92,42039,458,285,40778,40778,40491,40385,40255
91309,3436,4273,59565,31744,2.96761e+13,825.485,13350.4,91309,1252,431,87036,86999,87036,86837,78796
77315,3723,4284,55127,22188,4.99704e+13,1369.25,14306.7,77315,1707,534,73031,73019,72341,66188,66932
52701,3704,3751,37815,14886,5.53632e+13,1514.92,11175.8,52701,1451,458,48950,48950,48950,48944,48867
89277,4327,4355,58989,30288,2.91301e+13,979.824,13454.1,89277,1249,403,84922,84922,84922,84922,84904
54599,384,3470,37874,16725,2.89216e+13,775.146,9750.09,54599,937,282,48451,45788,30540,14493,7333
89607,1394,3597,56386,33221,2.90734e+13,869.702,11356.4,89607,967,456,86010,85335,75646,55245,53114
31834,2686,2824,22470,9364,5.03409e+13,1126.86,7918.17,31834,1024,310,29010,28924,28922,28849,28448
20193,715,1025,13015,7178,2.96063e+13,454.848,3095.99,20193,325,214,19168,18877,18242,17873,18265
47341,2120,2306,30359,16982,2.98069e+13,573.603,6881.97,47341,575,361,45035,45034,44816,44912,43888
95282,932,4504,64361,30921,3.65824e+13,1224.4,14950.8,95282,1375,417,88505,85598,67248,47671,33047
76226,12190,29113,61751,14475,2.17719e+13,1805.4,37793.4,76226,4219,162,47113,44440,43434,42441,24582
92926,1946,3886,62924,30002,4.36363e+13,1234.67,12713.3,92926,1391,470,88670,85753,71051,26507,42137
57902,433,4131,40972,16930,5.6936e+13,1360.96,11875,57902,1638,464,48033,44801,27284,17342,8291
72931,1539,2705,45438,27493,3.07164e+13,646.228,8865.72,72931,551,431,70226,69926,61545,45185,49483
71599,1665,2419,46065,25534,2.92564e+13,576.843,7854.73,71599,622,343,69180,69177,68193,66897,61540
65325,194,3960,45425,19900,3.21541e+13,1049.26,11939.8,65325,1083,356,53363,45156,32577,14481,3883
41691,2073,3783,30279,11412,6.3316e+13,1358.94,9792.51,41691,1262,457,37756,34870,27329,26153,26581
86439,2529,4553,57270,29169,3.09821e+13,919.265,13639.2,86439,1334,333,81886,81566,80370,81177,51784
25197,1024,3095,18376,6821,6.38737e+13,1129.47,6956.32,25197,912,393,21321,19979,12026,12060,10430
23550,1882,3414,17287,6263,6.96597e+13,828.977,7008.11,23550,783,412,20136,19280,14379,13494,13839
31825,196,3274,23343,8482,6.31916e+13,1435.21,8102.02,31825,1039,321,23399,20355,10310,8883,2740
62058,1440,3609,39183,22875,2.91015e+13,545.379,9661.16,62058,1064,306,58449,58259,51909,50416,36559
90527,2604,2980,57646,32881,3.02674e+13,698.165,9966.47,90527,666,441,87547,87394,85515,85823,81704
19669,1654,2409,13681,5988,4.63126e+13,865.96,5771.55,19669,793,257,17260,16539,15291,15022,13729
64448,2358,4020,46319,18129,5.40891e+13,1462.36,12699.4,64448,1539,517,60428,57747,48304,49537,48473
26939,1166,2065,19485,7454,2.81809e+13,406.911,5649.37,26939,503,183,24874,24666,23661,24139,16683
48509,1184,3309,34485,14024,4.43086e+13,1146.09,10145.8,48509,1136,350,44268,42100,35801,35224,20658
95319,3326,4411,67876,27443,4.63695e+13,1672.74,16253.9,95319,1889,580,90908,90431,85179,77610,78934
23681,1492,1523,17067,6614,2.56874e+13,635.823,4830.03,23681,750,188,22158,22158,22147,22137,22036
94411,4100,4260,61051,33360,2.93964e+13,826.527,13527.9,94411,1256,419,90151,90137,90151,90151,89470
52660,714,3873,37383,15277,5.56063e+13,1327.76,10970.7,52660,1387,461,45450,43744,26050,15664,10221
95431,3558,25667,77577,17854,2.65065e+13,6624.84,41788.8,95431,8015,27,58097,40906,29880,50273,8893
4055,619,887,2410,1645,3.36293e+13,99.4639,1302.28,4055,195,80,3168,3168,3124,3166,3136
26477,1443,2243,18626,7851,2.65839e+13,585.74,5873.28,26477,820,221,24234,24201,23499,23630,18160
42120,1503,1656,27376,14744,3.20565e+13,527.872,5164.5,42120,476,299,40464,40464,40236,40274,39864
49779,375,3255,35412,14367,3.59619e+13,911.245,9950.1,49779,940,310,43306,41367,27111,17600,9915
32556,1482,2491,23254,9302,3.32834e+13,717.948,7019.19,32556,792,195,30065,29326,29074,29249,24800
55502,200,595,37645,17857,3.35475e+13,303.39,3978.23,55502,302,251,52855,48565,36361,30649,30432
88867,1072,3975,60864,28003,4.60002e+13,1306.18,13148.9,88867,1485,470,82532,79498,58584,22117,21493
3951,102,802,2944,1007,9.24628e+13,187.488,1366.9,3951,80,180,2841,2365,737,923,680
11817,769,2021,8055,3762,4.48328e+13,445.848,4015.01,11817,687,155,9726,9419,8459,7365,4919
98246,299,9810,83558,14688,4.20744e+13,17.0665,11028.6,98246,4907,4903,88436,88436,31391,64663,59923
54765,649,2480,34729,20036,3.01842e+13,542.962,7574.89,54765,522,387,52128,50876,43365,36671,23458
36970,1111,3644,27297,9673,6.77124e+13,1457.68,9090.48,36970,1140,452,31487,29326,17493,16077,11775
53159,298,1981,34263,18896,2.93075e+13,543.54,6150.85,53159,514,328,48453,44332,41544,40571,19254
14529,1309,1871,10101,4428,2.33219e+13,353.894,4056.58,14529,647,161,12658,12653,12374,12038,10819
2520,45,747,1646,874,3.19622e+13,38.081,1083.69,2520,156,73,1757,1137,1459,1362,366
6391,581,1307,4731,1660,5.8771e+13,218.628,2334.07,6391,402,142,5084,4897,3013,3099,2477
98705,1098,4878,66459,32246,3.58411e+13,1345.42,15764.5,98705,1425,432,91994,89094,64185,57310,26225
45744,809,2073,27808,17936,3.09801e+13,466.044,5893.29,45744,461,309,43671,43279,34202,18705,16661
73346,3209,3942,49678,23668,3.15981e+13,972.847,12347.8,73346,1148,309,69404,69248,69400,68654,64188
76075,643,4364,52834,23241,4.13363e+13,1325.84,13816.7,76075,1419,418,67201,64048,43930,27160,14991
91853,2174,3987,60059,31794,2.9628e+13,726.323,12849.9,91853,1256,401,87866,87660,86440,87296,58199
41074,1150,1284,26476,14598,2.92958e+13,520.713,4517.41,41074,439,279,39790,39787,39444,39384,39240
95195,276,3039,59638,35557,2.99281e+13,723.987,10400.3,95195,655,466,87358,81503,68856,48468,24049
6387,856,1255,4325,2062,1.93794e+13,355.16,2337.13,6387,452,110,5132,5124,4553,4669,3750
78599,3798,3972,54161,24438,4.73843e+13,1292.94,12583.8,78599,1438,484,74627,74627,74205,73402,72140
37270,2694,3033,25070,12200,4.31189e+13,618.442,7427.59,37270,853,346,34237,34235,33502,31948,27616
32255,1290,3570,23229,9026,6.22055e+13,1233.27,8439.57,32255,1131,437,27957,25986,16398,15374,14485
80938,1854,2444,52244,28694,2.95805e+13,597.137,8411.16,80938,695,375,78494,78494,77193,75657,70163
61107,1641,2100,39365,21742,2.91644e+13,526.584,6730.98,61107,536,333,59007,59007,58660,58368,55584
67942,2491,3493,42513,25429,2.95657e+13,730.25,9879.02,67942,947,408,64449,64369,64371,64434,59452
62490,585,3543,44952,17538,4.76717e+13,1550.46,11968,62490,1336,375,54097,51551,33209,31664,12153
37005,1477,1686,23798,13207,2.93679e+13,501.057,5260.51,37005,464,301,35319,35319,34991,34725,33602
49233,457,3348,34920,14313,5.25318e+13,1461.52,10374.6,49233,1406,337,40487,37772,24576,21582,10942
75661,1954,3272,49822,25839,3.54786e+13,868.951,9388.45,75661,703,355,72389,71840,66914,50095,28289
23820,1242,1779,15934,7886,4.3448e+13,431.321,4389.87,23820,400,222,22041,22025,20864,19719,13333
24989,322,1121,16175,8814,2.98604e+13,567.651,3592.47,24989,432,234,22878,21185,20160,19466,11927
52575,2499,3399,37689,14886,5.08511e+13,1347.83,10813.7,52575,1307,344,49176,48563,44461,44403,43826
77534,2489,4309,53823,23711,3.69985e+13,1213.09,13662.7,77534,1262,419,73225,72693,68010,67183,50999
3348,106,401,1954,1394,3.28538e+13,120.824,757.658,3348,86,65,2853,2615,2228,1743,918
64092,1528,3587,40894,23198,2.95616e+13,539.162,10160,64092,1220,301,60505,60401,55968,55488,37758
18790,737,1553,13569,5221,3.04628e+13,441.072,4380.01,18790,503,182,17207,16948,14153,13808,7634
2583,157,324,1666,917,2.50613e+13,88.8208,692.723,2583,98,61,2259,2236,2095,2144,1538
81953,16544,22862,66905,15048,2.47876e+13,5709.66,37149.6,81953,7263,26,59091,59091,55536,51612,49543
15192,431,883,9809,5383,2.92644e+13,418.838,2553.05,15192,327,193,14132,13240,12852,12108,9075
62163,3152,4171,44432,17731,5.50029e+13,1454.75,12641.3,62163,1658,515,57992,57929,54347,52236,52934
98519,15787,40697,78821,19698,124325000,1119.27,60177.4,98519,9889,11,57822,57822,46632,57822,21772
62115,945,4211,44050,18065,5.53207e+13,1516.87,12740.2,62115,1715,525,54381,50930,34407,26794,17448
7916,93,545,4629,3287,3.25354e+13,205.81,1253.19,7916,152,100,6814,6199,4821,2778,1374
98503,2560,3438,64488,34015,3.43121e+13,937.826,11037.3,98503,756,400,95065,94895,93211,90889,76489
34984,1214,1667,22591,12393,2.96322e+13,518.522,5141.34,34984,435,290,33317,33316,32168,31552,28834
21288,657,919,13732,7556,2.9128e+13,464.925,3026.25,21288,379,208,20369,20309,19559,18972,18398
25399,428,429,17196,8203,3.34777e+13,288.536,2604.62,25399,278,191,24970,24970,24970,24970,24961
53194,3346,3478,38174,15020,5.16634e+13,1490.08,10947.4,53194,1447,345,49716,49715,49667,49686,49592
97067,2545,4140,66061,31006,4.51492e+13,1318.58,14060.9,97067,1678,483,92927,91406,80126,39984,53916
40165,2165,3643,28144,12021,5.35286e+13,1030.28,9174.24,40165,1192,416,36522,34756,29209,20728,22441
18935,546,2198,13000,5935,3.90069e+13,625.188,5309.91,18935,667,192,16067,14880,13632,13475,7392
51474,3098,3372,36469,15005,3.0905e+13,906.39,9765.53,51474,944,264,48102,48102,48102,48102,47261
63488,2100,2592,40248,23240,3.04075e+13,581.094,8197.73,63488,575,408,60896,60862,58183,58919,54044
4562,212,949,3128,1434,4.51081e+13,306.194,1774.4,4562,303,81,3274,2688,2548,2397,843
97979,3031,4897,69770,28209,4.4963e+13,1737.99,16801.2,97979,1841,626,93082,92377,78667,76826,70268
38798,184,3652,27142,11656,5.30745e+13,934.808,8903.04,38798,1062,423,30668,27319,17598,6346,1989
56025,1173,2087,35915,20110,2.89032e+13,587.058,6944.36,56025,582,344,53938,53887,51193,50170,40399
4709,692,937,3208,1501,4.37591e+13,250.824,1790.67,4709,333,73,3772,3772,3522,3277,3209
77304,4154,4233,52578,24726,3.27599e+13,1087.46,13101.3,77304,1194,369,73071,73069,73071,73028,72954
15543,1413,2453,11316,4227,5.96339e+13,773.058,5049.5,15543,668,181,13090,12472,9165,10185,8165
26260,398,2109,16149,10111,2.82347e+13,329.959,4690.2,26260,737,150,23543,21847,17700,15445,12067
8167,915,1238,5788,2379,2.25692e+13,210.994,2602.56,8167,298,110,6929,6924,6929,6929,6565
4399,449,458,2563,1836,3.10499e+13,132.992,912.255,4399,88,88,3941,3941,3941,3940,3924
72860,2904,3121,47784,25076,3.58439e+13,674.574,8909.82,72860,593,345,69739,69735,69509,69420,66006
39609,4752,15184,32239,7370,2.88024e+13,3644.36,21607.6,39609,4680,17,23780,17567,4002,20420,6486
23871,1056,1543,17182,6689,2.68511e+13,631.51,4875.76,23871,745,192,22328,21737,21449,21553,18410
38044,569,1881,24532,13512,2.94615e+13,516.039,5685.52,38044,485,309,36064,34816,31098,29938,19611
29020,420,1530,18712,10308,2.89814e+13,427.921,4574.24,29020,384,280,27156,25340,23436,22786,13244
65160,891,3659,41433,23727,2.94183e+13,551.984,10234.3,65160,1169,320,61501,60862,47458,29193,20010
49371,1168,3048,32807,16564,3.8502e+13,691.346,7650.58,49371,725,341,46323,45922,35254,7104,6253
44005,155,2240,27634,16371,3.04317e+13,517.32,6268.97,44005,465,340,38359,35075,28913,18185,5577
3274,564,940,2807,467,300598,5.13164,1617.64,3274,470,5,2334,2334,2334,2334,1586
67580,1053,3989,48047,19533,3.78173e+13,1185.44,12593.7,67580,1206,394,62219,59221,43563,39215,21892
46132,1483,3347,28770,17362,2.92512e+13,425.64,7883.81,46132,1036,230,42785,42710,39813,39908,28798
26105,323,1026,16831,9274,2.93602e+13,507.635,3468.45,26105,370,238,23873,22053,20883,20245,11256
6367,388,1852,4652,1715,5.61656e+13,169.712,2887.67,6367,440,199,4515,4112,2418,1821,1476
79100,2869,4034,54644,24456,4.8722e+13,1286.09,12896.5,79100,1528,475,75066,74774,67108,41087,51607
13474,32,736,7881,5593,3.2415e+13,251.176,1785.62,13474,223,119,10769,9846,6452,2024,1360
1846,21,312,1312,534,2.53181e+13,163.454,698.376,1846,187,53,387,125,81,169,183
96523,3332,4325,62704,33819,2.95482e+13,835.581,13804.6,96523,1250,445,92198,92103,92198,91981,80355
43325,731,3060,28987,14338,4.02075e+13,642.036,7394.81,43325,768,332,40142,39655,29572,5192,3573
48398,34,1396,31238,17160,2.98175e+13,551.654,4998.31,48398,483,303,28690,16711,19607,11424,3352
49631,1968,1991,31948,17683,2.95021e+13,538.466,6472.54,49631,529,344,47640,47640,47631,47623,47621
96478,3983,4238,67044,29434,4.6181e+13,1355.27,15332.5,96478,1796,540,92240,92192,91514,88746,81284
80552,3251,4225,57495,23057,4.93605e+13,1634.48,14617.8,80552,1688,566,76327,76009,72006,67373,68217
24509,489,1056,14307,10202,3.2013e+13,298.676,2717.19,24509,341,156,23453,23266,19304,17338,16693
70722,2102,4166,50442,20280,5.17564e+13,1416.88,13668.6,70722,1658,528,66312,62265,50815,49108,45324
14305,217,1391,8860,5445,3.10798e+13,200.73,3030.54,14305,269,178,12756,11935,9885,5532,3585
82088,442,3304,53766,28322,3.50652e+13,795.473,9827.14,82088,698,363,76908,71306,60956,7904,4618
85428,1079,2642,55178,30250,3.0095e+13,647.413,8883.05,85428,657,381,82786,82652,74340,72956,55504
16654,214,3010,12210,4444,6.76784e+13,518.193,5653.07,16654,674,289,12455,10852,5219,4410,2333
86590,633,4113,59573,27017,4.84178e+13,1301.16,13687.7,86590,1786,467,77579,74893,52596,21497,14344
66932,197,2231,43156,23776,2.9471e+13,548.293,7252.42,66932,571,341,58774,54689,49105,44268,18157
62968,1807,2654,39728,23240,3.00531e+13,620.87,8269.34,62968,566,404,60314,60247,56123,52802,49722
91329,2226,4021,59940,31389,2.99213e+13,741.874,12904.6,91329,1260,394,87308,87081,86003,86706,57257
85482,115,2460,55099,30383,2.97565e+13,596.426,8598.81,85482,641,377,71462,64899,55931,47928,13680
18867,587,2633,13732,5135,5.652e+13,1029.41,5709.32,18867,831,166,15214,14555,8551,7502,6066
36302,1621,1940,22349,13953,3.075e+13,424.205,5264.55,36302,387,277,34362,34356,33460,33837,31910
17536,1061,1303,11242,6294,2.89646e+13,448.012,3341.52,17536,388,207,16233,16231,16190,16201,15711
11589,424,795,7455,4134,2.90725e+13,398.261,2203.35,11589,280,168,10610,9992,9705,9274,6962
58238,1858,2169,37522,20716,2.92648e+13,558.849,7061.55,58238,597,333,56069,56065,55613,55631,54617
19049,8,405,12947,6102,3.36166e+13,285.969,2250.92,19049,256,171,2504,855,760,339,413
89290,2608,3668,58613,30677,3.49782e+13,1198.09,11536.7,89290,918,381,85622,85202,80912,71085,42318
13950,552,852,8980,4970,2.97414e+13,401.719,2475.92,13950,288,193,13098,12686,12255,12092,11386
83153,1029,4358,56765,26388,3.5595e+13,1129.53,13829.5,83153,1229,417,77525,74900,59314,46203,25762
44810,1563,2782,28677,16133,2.91713e+13,439.759,7411.49,44810,1102,198,42028,42021,41329,37697,26411
32490,737,1846,20144,12346,3.09033e+13,418.723,4977.58,32490,429,271,30644,30364,24992,16806,13563
31108,1512,2401,21469,9639,2.7135e+13,544.513,6420.74,31108,862,233,28707,28697,27884,25641,21465
85436,1032,23333,69917,15519,2.54218e+13,5606.39,37768.9,85436,7796,23,44044,38853,24835,19428,2580
43247,93,538,29331,13916,3.36318e+13,301.07,3485.55,43247,296,239,28643,11558,18859,11023,8506
28036,15,1091,18011,10025,2.91353e+13,489.908,3681.49,28036,358,241,11806,4562,5604,1951,1215
6398,430,657,5438,960,4.22304e+13,16.9472,951.459,6398,332,327,5741,5741,4404,5180,5082
37683,1200,2854,26726,10957,4.73768e+13,1127.44,8621.48,37683,1076,324,34081,32328,27589,26333,20222
86595,1262,2933,54461,32134,3.05622e+13,693.818,9886.21,86595,633,456,83662,83275,71946,57117,48930
66969,2994,3870,46747,20222,5.10615e+13,1295.67,11945.7,66969,1447,471,63099,62885,58176,37727,44443
95965,1143,16677,71513,24452,3.92574e+13,1341.14,29844.9,95965,3344,425,75942,71367,33141,12448,1600
53922,3047,3117,35846,18076,3.80478e+13,693.194,8013.36,53922,774,333,50805,50805,50737,50735,50423
25783,281,2029,18117,7666,3.47543e+13,659.133,5823.43,25783,686,177,22283,20927,16770,18219,7562
24875,2403,2862,18180,6695,6.3479e+13,1120.37,6760.86,24875,985,251,22013,21135,21880,21856,20861
79612,1832,3982,50405,29207,2.90345e+13,721.029,11511.2,79612,1081,407,75630,75303,68006,64707,47786
38043,177,1727,24533,13510,2.97355e+13,524.439,5464.62,38043,482,304,32935,30579,26553,22683,7821
23691,274,2897,16413,7278,5.08135e+13,442.66,6166.36,23691,764,319,19684,17777,12468,3981,2787
53114,718,3079,34321,18793,2.93724e+13,531.608,8346.46,53114,1167,239,49679,48558,38745,30240,22964
2778,30,363,1623,1155,3.15966e+13,117.717,668.934,2778,73,63,2149,1943,1339,711,420
85967,1881,3986,56130,29837,2.98257e+13,702.975,12399.8,85967,1253,390,81981,81745,79176,78745,51451
65349,653,2630,41184,24165,3.05226e+13,603.062,8324.03,65349,568,404,62483,61532,50848,40639,26780
41142,232,1866,25860,15282,3.06236e+13,470.974,5537.29,41142,465,291,37264,34979,29894,21920,12806
73963,2916,3948,49617,24346,3.14243e+13,899.046,11994.9,73963,1208,289,70015,69782,69941,70011,63535
49390,2401,3006,31884,17506,2.91256e+13,466.932,8013.95,49390,1130,229,46384,46381,46024,46328,42178
57090,386,2363,36746,20344,3.00738e+13,626.32,7511.85,57090,575,378,52845,49089,44389,41358,18974
4027,785,1188,2734,1293,5.48381e+13,152.892,1864.96,4027,298,136,2839,2838,2639,2821,1565
24798,1482,2055,17661,7137,2.62338e+13,616.267,5517,24798,791,211,22743,22730,22165,22421,18383
31852,1016,2375,22295,9557,2.72325e+13,569.196,6481.25,31852,848,249,29461,28812,23647,20512,9588
85846,319,4005,57255,28591,4.0217e+13,1224.21,11986.4,85846,1059,434,76374,69596,58169,9690,11863
52398,9592,17507,42705,9693,2.76196e+13,4671.64,26470.8,52398,5197,17,34891,28156,22473,27292,17471
80510,957,3713,54387,26123,4.19791e+13,1132.57,11601,80510,1299,433,75387,73461,56626,15634,16561
19129,2005,2198,13126,6003,3.89938e+13,648.817,5346.58,19129,681,192,16931,16931,16903,16916,15770
50841,664,3888,36123,14718,5.67845e+13,1303.74,10694.6,50841,1386,467,43750,42013,24606,11559,6162
70867,2770,3665,44809,26058,2.96145e+13,594.33,10244,70867,1079,337,67202,67202,67201,67186,61556
28200,10712,12566,22562,5638,108768000,703.908,17984.8,28200,2835,11,15634,15634,15172,15634,13320
39105,526,1925,24351,14754,3.12853e+13,436.943,5463.65,39105,412,282,36982,36380,29539,20193,18466
88228,911,4176,60653,27575,4.77986e+13,1383.18,14243,88228,1773,522,80341,76920,56576,27200,20391
77002,599,2816,48312,28690,3.02342e+13,662.956,9247.3,77002,567,438,73738,71982,58766,45413,31199
49271,2159,3771,34762,14509,5.58262e+13,1135.89,10232.5,49271,1344,449,45495,43300,34862,23879,27531
99179,4131,4163,67597,31582,4.44514e+13,1429.67,14026.2,99179,1542,478,95016,95016,95011,95010,94967
5073,135,855,3284,1789,2.91272e+13,102.007,1610.18,5073,201,96,4189,4019,3593,2711,1764
30364,113,1069,19526,10838,2.91121e+13,539.448,3761.35,30364,420,250,25399,23081,19833,16780,2217
25606,517,1228,16640,8966,3.07291e+13,593.001,3789.02,25606,426,215,24007,23033,22024,20508,18101
13115,294,737,7660,5455,3.22827e+13,242.181,1771.82,13115,217,124,12361,11972,10020,9588,8092
88709,2164,2868,55576,33133,2.99384e+13,694.483,9860.05,88709,622,465,85841,85703,79913,80794,70503
5309,16,510,3418,1891,2.93441e+13,232.909,1239.91,5309,171,125,2062,661,828,519,306
85634,12,747,58105,27529,3.36078e+13,305.666,5028.92,85634,312,272,15428,4746,4544,1318,8545
10699,35,1608,7582,3117,7.00547e+13,267.39,3160.45,10699,285,252,6502,4607,2364,1429,454
65528,908,3717,41591,23937,2.9251e+13,567.025,10309.6,65528,1177,319,61811,61057,48085,29935,22352
87032,1282,3611,57175,29857,3.4849e+13,1127.25,11040.7,87032,855,361,83203,82364,66480,11287,14775
77181,2268,4312,51232,25949,2.96017e+13,897.286,12161.5,77181,1230,294,72869,72516,71363,72166,39766
66280,2396,2511,42746,23534,2.97499e+13,606.297,8063.63,66280,596,387,63769,63769,63733,63751,63450
1029,240,359,756,273,9.31325e+13,32.4325,485.401,1029,41,66,670,670,562,637,501
76388,2389,2748,47618,28770,3.04465e+13,662.163,9070.7,76388,547,439,73640,73589,71435,72253,69346
14922,224,1430,10767,4155,2.9489e+13,455.76,3862.04,14922,503,157,12642,11677,7246,3416,2560
90741,2713,2924,57888,32853,2.95889e+13,685.452,9876.69,90741,699,430,87817,87731,87220,87452,85331
35699,338,1263,23077,12622,2.99223e+13,526.803,4282.71,35699,429,274,32909,30098,28495,27476,15447
46428,1684,2663,33208,13220,3.04734e+13,827.811,8463.85,46428,926,236,43765,43514,43075,43264,38799
23763,44,982,15293,8470,2.86766e+13,467.059,3261.74,23763,376,226,15748,9326,11402,7232,2228
34862,541,1170,22499,12363,2.92759e+13,525.389,4104.92,34862,413,260,33561,31647,29855,28422,24773
68481,3722,4134,48419,20062,5.19075e+13,1410.28,13307,68481,1694,525,64347,64336,63666,55058,56661
92769,4138,4360,61344,31425,2.93564e+13,966.277,13744.4,92769,1265,415,88409,88321,88409,88409,87673
6208,1120,1380,4174,2034,4.24443e+13,305.3,2465,6208,428,121,4828,4802,4747,4645,4095
40320,1574,2630,28826,11494,3.28125e+13,776.247,7979.11,40320,921,224,37690,37321,36752,36949,31854
50050,325,1558,32312,17738,2.99891e+13,573.749,5267.64,50050,486,327,45957,42243,39423,37754,12307
36514,2166,2314,26239,10275,2.85166e+13,620.7,6925.47,36514,655,222,34200,34200,34194,34197,33953
5272,267,666,3922,1350,2.32897e+13,163.432,1610.61,5272,282,107,4606,4528,3516,3434,2856
60791,1319,2049,39224,21567,2.96099e+13,535.02,6749.13,60791,529,335,58742,58738,57403,57300,53605
99061,2652,3020,62269,36792,3.04152e+13,727.757,10553.2,99061,635,472,96041,95992,93067,94195,89566
74573,188,671,50574,23999,3.35024e+13,301.346,4637.12,74573,308,264,69780,53269,48482,28308,37784
83672,1944,2862,53299,30373,2.9515e+13,678.404,9484.1,83672,657,428,80810,80684,76672,70982,70466
79940,2738,2798,50893,29047,2.98859e+13,656.816,9288.92,79940,703,432,77142,77142,77127,77142,76774
44656,5491,15609,36862,7794,2.22374e+13,2503.26,23224.7,44656,4850,17,29047,23849,22792,26100,16472
34919,1420,1852,21511,13408,3.10777e+13,416.222,5127.19,34919,377,280,33067,33064,30772,31662,27576
9102,1039,1092,5864,3238,2.9919e+13,307.042,2307.93,9102,333,181,8010,8010,7990,7962,7920
78975,3568,3904,54257,24718,4.65049e+13,1297.05,12532.3,78975,1377,485,75071,74918,73715,69991,61308
77624,1361,3927,55831,21793,4.88587e+13,1725.9,13938.1,77624,1562,547,71415,67018,54229,52086,34403
74315,3227,4389,50441,23874,3.85184e+13,1205.61,13336.1,74315,1232,409,69926,69609,65767,65470,61335
28638,1568,2156,20585,8053,3.11433e+13,690.419,6139.61,28638,672,190,26482,26194,26260,26294,24482
63422,2948,3106,42000,21422,2.9652e+13,646.262,9282.65,63422,1139,272,60316,60142,60304,60316,58335
97329,2804,2998,61341,35988,3.02184e+13,728.879,10441.4,97329,700,466,94331,94330,93952,94050,92618
61997,1966,3584,44576,17421,4.74628e+13,1583.33,12034.8,61997,1247,380,57782,55386,48151,45859,39776
18382,306,933,10723,7659,3.18326e+13,277.668,2290.69,18382,258,143,17413,16838,13166,10388,9289
91307,2160,4150,59696,31611,2.97293e+13,777.827,13114.2,91307,1252,418,87157,86915,84775,84434,57181
33418,168,2433,24059,9359,2.83071e+13,656.419,6733.85,33418,733,203,27610,22237,16725,4789,4244
21662,1570,2138,14557,7105,2.69047e+13,428.879,5100.1,21662,802,181,19524,19524,19183,18621,16790
74226,1147,2706,47759,26467,3.0004e+13,618.889,8735.32,74226,681,407,71520,71386,65778,62706,50612
68062,155,2286,43852,24210,2.93478e+13,610.218,7811.75,68062,599,369,58254,54371,47247,40935,14169
58112,1315,1469,37452,20660,2.93811e+13,590.106,5507.85,58112,541,313,56643,56643,56162,55938,55952
30526,880,1909,20337,10189,4.19806e+13,485.476,4989.87,30526,457,244,28617,28551,25103,7130,7735
70320,673,2709,43728,26592,3.09e+13,658.423,8588.34,70320,534,418,67267,66238,52510,36228,23817
84775,1768,2397,54683,30092,2.98137e+13,591.311,8547.98,84775,651,389,82378,82378,80687,78472,69088
76436,26344,31862,61154,15282,120099000,1071.13,46927.1,76436,7673,11,44574,44574,43094,44574,37586
3846,93,871,2644,1202,4.48686e+13,223.274,1589.79,3846,307,67,2524,1865,1676,1429,678
34648,309,2315,21381,13267,2.84117e+13,329.521,5510.19,34648,822,162,31272,29267,21734,15721,12976
79291,464,3542,49661,29630,2.9416e+13,826.982,10658.4,79291,931,418,74072,69907,56425,39817,20893
76083,3157,4207,54059,22024,5.04736e+13,1354.62,14093.1,76083,1700,539,71876,71753,67534,59784,61610
25886,742,2184,18162,7724,3.629e+13,655.223,6101.35,25886,663,197,23201,22268,21753,21277,14979
66623,1217,3921,48046,18577,5.35659e+13,1445.34,12755.8,66623,1520,531,60252,56347,43023,38968,30612
46453,2036,3660,32096,14357,4.95392e+13,960.194,9406.51,46453,1072,421,42793,41327,33358,16914,20163
3806,270,594,2458,1348,2.98777e+13,148.157,1167.05,3806,157,95,3212,3066,2992,2871,2451
72535,473,3703,51992,20543,4.56768e+13,1534.04,13128.6,72535,1489,386,62583,59184,36071,27825,7056
82816,2284,2885,52572,30244,2.98672e+13,691.647,9574.43,82816,633,436,79931,79805,76941,75730,71671
62737,757,3710,42870,19867,3.07793e+13,804.579,10884.5,62737,1095,285,58085,56530,41941,27050,14265
60477,2626,3719,41823,18654,3.13289e+13,850.453,10947.5,60477,1029,290,56758,56709,56651,56677,49536
99068,3632,4654,69652,29416,4.28724e+13,1701.42,16333.8,99068,1722,568,94414,94104,87232,87952,84194
98125,3199,3604,61764,36361,2.9689e+13,1021.8,11809.4,98125,915,463,94521,94269,94508,94521,92141
19496,1454,1492,11657,7839,3.16621e+13,253.107,3256.7,19496,301,157,18004,18004,17998,18003,17888
32875,2949,3008,23852,9023,6.05751e+13,1415.22,7893.8,32875,1099,275,29867,29867,29867,29867,29803
84465,2357,3830,56955,27510,4.22861e+13,1195.19,12003.1,84465,1338,467,80635,78612,68583,26110,43709
19482,1859,2857,13663,5819,5.51384e+13,401.926,5713.56,19482,707,320,16625,16482,13270,9390,8785
51063,1763,3032,33083,17980,2.93263e+13,485.227,8166.81,51063,1135,234,48031,48012,47076,44528,31998
41388,1207,3770,29308,12080,5.73057e+13,1163.16,9534.59,41388,1337,458,36532,34575,23638,15841,17076
72541,999,4104,50522,22019,5.22228e+13,1302.58,12916.4,72541,1735,466,65613,62622,44363,23081,17757
58569,257,3586,37042,21527,2.95928e+13,495.209,9608.67,58569,1184,279,52045,48443,34402,12925,5884
29831,1177,2790,21476,8355,5.92798e+13,1299.09,7538.52,29831,1119,255,26054,24682,18251,16976,13680
21101,64,2118,13959,7142,2.58643e+13,335.034,4872.8,21101,726,173,13089,8729,7568,2660,1615
30464,599,1556,19644,10820,2.92703e+13,444.942,4700.34,30464,415,280,28908,28252,25973,25925,18848
59353,1638,3768,42776,16577,5.54947e+13,1484.15,11892.1,59353,1458,520,54591,50469,39358,38904,32918
71804,153,4240,50624,21180,5.09563e+13,1395.76,13759.4,71804,1748,528,54473,47227,30472,20374,5426
92799,852,4167,60415,32384,2.95134e+13,772.325,13157.5,92799,1259,423,88185,86877,65893,43475,25898
75590,3155,3730,50955,24635,4.20318e+13,1099.11,10932.1,75590,1097,435,71860,71600,68773,31811,40752
90482,1304,4267,63749,26733,4.74162e+13,1344.53,15279,90482,1775,553,83833,79437,63623,43838,37323
19705,605,1956,16798,2907,4.15138e+13,17.3318,2498.15,19705,981,976,17749,17749,9668,14378,13718
61854,930,2099,39995,21859,2.96061e+13,577.98,6591.38,61854,591,336,59755,59655,55167,55211,49980
54150,13741,17458,44506,9644,2.49244e+13,3815.01,26733.5,54150,5813,18,36692,36692,36074,36074,30615
58116,707,2544,36738,21378,3.09031e+13,576.989,7855.41,58116,566,387,55391,54621,45665,37064,24597
17672,870,887,11471,6201,2.98241e+13,457.922,2774.89,17672,368,194,16785,16785,16782,16785,16780
92204,452,4161,63022,29182,4.56302e+13,1314.35,13770,92204,1589,474,81097,75225,55199,18230,8861
96089,1233,4345,67544,28545,4.5823e+13,1388.16,15770.1,96089,1796,563,88995,84696,67848,47066,36848
97326,2355,4157,66442,30884,4.6108e+13,1334.09,14368.2,97326,1802,473,93169,90256,76866,41007,52924
43260,1689,2181,27784,15476,3.01071e+13,576.248,6419.51,43260,506,344,41079,41058,39979,39738,37693
3281,192,761,2246,1035,1.12476e+13,260.936,1361.64,3281,223,101,2054,1442,1164,1243,539
39633,541,1727,25605,14028,2.97181e+13,503.136,5411.42,39633,438,297,37719,35825,32279,31992,22730
19219,867,1494,13941,5278,2.92385e+13,229.543,4173.84,19219,391,154,17725,17710,17284,17517,14426
54688,2464,3359,39088,15600,3.6018e+13,959.425,10524.5,54688,1006,332,51329,51296,49245,49625,46579
51895,2582,17438,42410,9485,2.30315e+13,2063.86,25997.3,51895,5481,92,33515,27905,27468,14088,6877
88666,2919,4020,58211,30455,2.99852e+13,732.813,12705.4,88666,1252,393,84646,84447,84455,84297,69571
85701,347,4483,56860,28841,3.09135e+13,903.031,13555.5,85701,1347,356,77437,73286,49065,21214,7100
50539,752,3831,36000,14539,5.63584e+13,1354.84,10734.2,50539,1343,463,43519,41732,24428,15966,10728
5976,926,1503,4411,1565,6.70665e+13,213.846,2363.13,5976,335,256,4473,4473,2215,2904,2211
93130,2179,4387,66449,26681,4.67098e+13,1666.25,16050.1,93130,1857,580,88074,84246,71822,62596,56423
53101,1953,3448,35485,17616,4.16523e+13,761.783,9051.92,53101,977,418,49653,48809,39818,13023,18129
15069,355,2667,10991,4078,6.22928e+13,588.579,5106.74,15069,667,159,11813,10837,5601,5360,2027
79108,3653,3972,56945,22163,4.74087e+13,1747.69,14129.1,79108,1624,511,75136,74968,74140,74554,74018
13096,2231,2396,9364,3732,6.49824e+13,380.157,4474.53,13096,527,323,10700,10647,10455,10507,10287
93031,687,3814,62660,30371,4.17295e+13,1208.13,12331.8,93031,1372,467,86510,84546,62759,13824,15249
18923,6389,10669,15265,3658,3.56507e+13,569.43,12959.9,18923,2415,12,8254,7772,0,7135,2394
54601,2394,3642,37399,17202,4.6348e+13,964.957,9844.33,54601,1043,426,50959,49897,42451,18958,26079
19938,157,1920,12779,7159,2.5605e+13,296.539,4302.1,19938,644,155,15819,12742,9826,5105,2646
54121,263,576,36706,17415,3.3584e+13,299.27,3905.57,54121,300,248,52911,50313,36601,34801,33088
99323,3601,4691,69511,29812,4.13535e+13,1641.66,16243.7,99323,1725,479,94632,94355,87709,89536,82735
44180,2671,3602,31870,12310,6.24644e+13,1488.34,9887.05,44180,1340,439,40578,40453,36254,36889,36862
21262,1118,1489,13656,7606,3.00684e+13,463.825,3878.55,21262,382,238,19773,19768,19200,19395,17600
11259,447,860,7224,4035,2.93001e+13,388.578,2256.85,11259,338,171,10350,9679,9327,9190,7878
31295,1766,1777,19053,12242,3.18643e+13,347.018,4594.09,31295,368,247,29518,29518,29518,29518,29503
54503,1825,3030,36958,17545,2.93279e+13,577.03,8765.85,54503,1006,276,51473,51412,49892,45008,35375
77252,1769,2355,49811,27441,2.91666e+13,588.214,8100.23,77252,617,368,74897,74897,73758,72063,65298
72170,1783,3690,51778,20392,4.59019e+13,1540.29,13065.7,72170,1434,392,67684,64324,57129,54895,42739
30180,1661,2817,21463,8717,5.34241e+13,1394.95,7696.84,30180,1119,297,27055,24939,21620,21046,18442
19464,421,934,12548,6916,2.95007e+13,469.618,2942.88,19464,366,209,18167,16898,16213,15428,10014
56576,2232,3047,37849,18727,2.94529e+13,591.213,8843.9,56576,1070,265,53529,53443,52422,53212,44521
20976,2729,2878,15510,5466,7.02785e+13,959.977,6187.5,20976,864,252,18098,18098,18098,18098,17638
95477,1558,4063,63500,31977,3.93837e+13,1259.37,12687,95477,1111,457,91036,89351,74444,18415,32092
4921,68,666,3217,1704,3.16603e+13,262.141,1397.93,4921,250,108,3567,2554,2658,2310,998
76843,987,3889,50525,26318,2.99427e+13,679.086,11635.1,76843,1251,352,72691,71658,54249,41694,18453
98431,1579,4275,68790,29641,4.58861e+13,1335.39,15697.1,98431,1783,544,92680,88127,72287,46611,44141
61566,149,2187,39692,21874,2.95985e+13,566.844,7259.5,61566,603,354,52285,49080,42301,35981,11815
52138,337,3362,37246,14892,3.83025e+13,930.617,10389.4,52138,1001,324,44971,42561,26543,15023,4494
24588,196,1429,15810,8778,2.86358e+13,404.881,4165.07,24588,349,262,21511,20005,17870,15947,6600
6003,773,1567,4092,1911,6.05103e+13,199.032,2564.05,6003,380,146,4436,4382,3803,4191,2037
46392,2731,3641,31672,14720,4.83244e+13,757.842,9072.94,46392,1011,420,42751,42653,38498,18981,21193
34022,479,2526,22113,11909,2.91015e+13,413.627,6468.46,34022,954,191,30761,28573,22173,18476,11831
25576,1396,2227,17352,8224,4.77887e+13,426.235,5062.85,25576,443,278,23349,23337,21450,8415,9486
90547,740,3648,59489,31058,3.4657e+13,1166.12,11019.5,90547,787,367,86041,84863,67485,8575,6072
71982,1496,2701,44857,27125,3.06757e+13,639.894,8737.6,71982,536,418,69281,68975,60640,45062,48464
56475,2406,2508,35269,21206,3.07927e+13,568.747,7566.51,56475,473,384,53967,53937,53928,53961,53375
58240,15138,18362,47692,10548,2.49645e+13,4416.37,28512.1,58240,5934,20,39878,39878,37467,38075,35852
98439,1926,4507,67073,31366,3.70922e+13,1306.42,15343.5,98439,1450,436,93672,91195,83852,74279,54161
2639,13,658,1994,645,9.24653e+13,99.695,1056.77,2639,62,122,1353,821,237,473,96
58152,375,2210,37397,20755,2.95065e+13,584.018,7109.76,58152,597,336,53903,49596,46369,44443,26207
56611,831,2486,35946,20665,3.01872e+13,568.453,7711.77,56611,544,389,54125,53481,46877,40374,27481
83493,1864,4046,52614,30879,2.96684e+13,773.7,11737.5,83493,1038,422,79447,79076,71558,60440,52209
66306,942,3709,42892,23414,2.94312e+13,602.819,10495.4,66306,1217,321,62423,61634,45967,35082,17347
50886,2946,3120,36552,14334,4.38129e+13,1286.88,10306.9,50886,1153,337,47766,47759,47666,47396,47190
28549,454,1092,18305,10244,2.81185e+13,534.199,3687.86,28549,445,239,26918,24951,23957,23003,17852
43957,115,3374,31422,12535,5.54453e+13,1471.94,9857.39,43957,1299,340,30941,24187,15046,12276,2723
88896,4066,4396,62753,26143,4.19087e+13,1553.01,15169.8,88896,1588,459,84500,84489,84397,83365,81971
16224,474,781,9487,6737,3.24868e+13,259.821,1959.54,16224,261,124,15443,15382,13858,14515,12667
79643,81,4144,54943,24700,4.90611e+13,1308.29,13232.4,79643,1629,471,56936,42243,33195,11107,3276
40222,2226,2766,26740,13482,2.81799e+13,491.753,7391.1,40222,971,234,37456,37456,37195,37394,33008
48958,2996,3098,35025,13933,4.26007e+13,1105.89,10004.5,48958,1022,350,45860,45860,45832,45736,45434
50334,107,3673,36210,14124,6.00564e+13,1569.76,10749.5,50334,1436,488,34742,26396,15488,13224,2696
46935,2098,3609,33848,13087,6.24292e+13,1525.68,10240.2,46935,1431,444,43225,39602,31053,31979,32696
25768,3418,15304,20284,5484,2.71973e+13,208.055,17057.8,25768,2030,109,10464,10088,9208,9213,7155
90343,2249,2929,57152,33191,3.03607e+13,684.817,9958.45,90343,627,458,87414,87240,82632,83354,73393
93194,597,3534,58474,34720,3.03037e+13,982.372,11054,93194,665,468,88693,87150,70194,54155,37263
52160,2515,3020,34735,17425,2.91153e+13,522.465,8503.92,52160,1049,265,49140,49122,48914,49050,43381
49296,569,576,33454,15842,3.36637e+13,304.334,3749.26,49296,300,247,48720,48720,48720,48720,48713
47582,593,2218,29586,17996,3.04727e+13,506.363,6327.18,47582,440,354,45152,44427,35062,23988,9764
79831,2145,3965,54923,24908,4.71048e+13,1254.37,12754.8,79831,1560,470,75756,72087,61548,33235,40669
42460,1023,2799,28399,14061,2.85414e+13,504.816,7617.44,42460,981,249,39655,39003,34016,28153,16147
63737,16088,18865,50897,12840,2.49318e+13,2715.35,29597.1,63737,5609,148,44872,44872,39843,35491,33516
54259,77,3750,39026,15233,5.74975e+13,1545.34,11303.6,54259,1453,506,35578,25138,15957,11600,2951
4477,67,729,3144,1333,3.00569e+13,275.546,1557.12,4477,289,68,2319,986,1044,632,256
90487,1000,4512,59994,30493,3.05774e+13,980.195,14009.4,90487,1311,398,85247,83450,62442,47998,19313
55359,1902,3249,34609,20750,2.89773e+13,532.281,8625.91,55359,944,304,52110,52037,51127,51513,42322
26073,1035,1668,16061,10012,3.126e+13,316.798,4263.98,26073,343,234,24405,24389,21192,22079,15645
4552,594,722,3271,1281,1.82189e+13,290.693,1583.94,4552,441,81,3827,3485,3422,3360,3383
68603,1705,2305,44322,24281,2.99758e+13,583.159,7777.17,68603,654,365,66298,66287,64974,63071,56545
56928,1276,2480,35153,21775,3.03728e+13,572.513,7281.49,56928,463,371,54448,54247,46108,31860,33741
55897,2606,3766,40166,15731,5.84108e+13,1527.14,11456.8,55897,1454,511,52131,51107,44038,44935,44722
30999,1082,2416,21375,9624,2.71445e+13,547.138,6430.96,30999,863,231,28583,28006,24239,22232,10240
55625,333,3020,37576,18049,2.93583e+13,597.172,8828.78,55625,1033,271,50366,47758,31779,15385,10400
74475,38,694,50524,23951,3.35862e+13,304.576,4662.55,74475,309,266,30763,14546,15020,3377,19273
60060,1448,3490,43432,16628,4.70136e+13,1386.56,11680.6,60060,1219,382,55389,52315,44143,41913,30148
76159,3461,3897,49357,26802,2.94453e+13,649.088,11629.9,76159,1233,368,72262,72262,72262,72262,68625
37552,1364,1909,24246,13306,2.96107e+13,599.686,5669.41,37552,464,316,35643,35606,34577,33683,33028
9472,176,2054,6821,2651,6.01158e+13,245.976,3569.27,9472,507,259,6709,5697,3519,2780,1175
86941,4117,4347,62427,24514,4.84515e+13,1718.83,15373.1,86941,1837,569,82594,82592,82469,82381,80939
65737,832,4124,46221,19516,5.33535e+13,1460.75,12888.8,65737,1719,530,57547,54611,36844,24701,15371
93949,453,4255,64596,29353,4.60539e+13,1380.75,14931.2,93949,1827,535,81805,75838,54906,23660,13128
85052,1007,3848,55949,29103,3.60324e+13,1068.04,11106.2,85052,965,370,80790,79981,64295,10517,10250
43414,2824,3003,31131,12283,4.05489e+13,899.242,9176.99,43414,849,326,40411,40407,40328,40199,40052
12947,273,2310,9542,3405,6.39369e+13,367.101,4452.94,12947,544,183,10005,9252,4686,3470,2151
43012,2615,3121,26652,16360,2.8929e+13,408.557,7230.88,43012,931,194,39891,39891,39891,39891,38067
48396,718,1383,31235,17161,2.93855e+13,553.442,4982.1,48396,489,302,47013,46798,41974,42112,37203
19637,1139,1933,13929,5708,3.61022e+13,519.499,4980.42,19637,642,150,17704,17140,17053,16834,15737
84072,2838,4353,60314,23758,4.84878e+13,1666.36,15057,84072,1755,574,79719,79159,67224,66908,66292
16665,561,1024,10825,5840,3.03256e+13,431.796,2878.17,16665,365,181,15641,15198,14934,14354,13614
51017,4707,5293,43257,7760,4.20905e+13,17.9996,6204.99,51017,2552,1817,45724,45724,42705,44372,43985
54314,516,3218,33764,20550,2.91537e+13,545.597,8398.04,54314,937,308,50541,48212,36074,19488,13773
90907,1172,4011,60529,30378,4.00137e+13,1227.93,12282.3,90907,1066,436,86185,84733,69055,15856,27756
44996,1111,3542,32169,12827,5.71887e+13,1597.3,10069.8,44996,1429,358,39228,36069,25943,24574,17388
49651,1603,3529,35436,14215,5.30615e+13,1535.25,10642.7,49651,1443,349,45164,41614,34622,34903,27855
92264,2402,4146,63174,29090,4.68267e+13,1289.28,13849.5,92264,1704,478,88118,85412,72725,38565,48793
85951,1703,4353,57132,28819,3.16612e+13,1042.05,13567.9,85951,1322,318,81598,80529,77582,77620,38081
1830,78,414,1167,663,3.19915e+13,92.6426,724.753,1830,127,87,1311,996,1010,975,532
10036,770,1481,6510,3526,2.29717e+13,304.512,2928.01,10036,500,132,8555,8519,7205,7949,4558
16545,216,1431,9949,6596,3.17915e+13,228.946,3087.55,16545,256,172,14934,13796,10475,3605,2089
12427,64,808,7965,4462,2.82218e+13,399.38,2287.79,12427,339,168,9150,6346,7109,6460,2158
63406,2200,3202,41977,21429,3.67582e+13,797.558,8503.16,63406,761,333,60204,59804,54714,14259,19701
28993,3207,3533,20913,8080,6.03933e+13,1073.66,7953.89,28993,980,411,25460,25442,25192,24210,22715
71574,3497,3960,45974,25600,2.91992e+13,618.439,11225.5,71574,1232,349,67614,67614,67614,67614,64189
46994,2070,2139,28689,18305,3.11418e+13,497.641,6059.39,46994,454,310,44855,44850,44826,44855,44533
35575,2718,3369,24305,11270,4.90496e+13,654.918,7903.85,35575,986,407,32206,32198,30822,17477,18775
49398,199,3386,30991,18407,2.89986e+13,428.285,8365.48,49398,1043,258,43193,37709,28237,8543,5186
18850,853,1002,12167,6683,2.94159e+13,421.529,2991.75,18850,335,200,17848,17788,17551,17446,17054
36435,978,2653,24402,12033,2.77187e+13,498.303,7023.55,36435,944,232,33755,33214,28802,24040,13094
80283,1361,3887,52994,27289,2.98771e+13,721.893,11899.1,80283,1239,368,76396,75713,63241,59028,32260
87998,3551,4048,60247,27751,4.58042e+13,1267.04,13313,87998,1503,472,83950,83810,81541,50164,59442
43489,844,1691,27994,15495,2.93256e+13,569.666,5275.99,43489,509,282,41798,41651,39650,39179,37286
92551,2910,2947,58338,34213,3.01121e+13,715.049,10171.2,92551,650,461,89604,89604,89604,89604,89407
57784,627,2504,36641,21143,2.98418e+13,531.851,7716.91,57784,522,403,55106,54207,45944,39284,23628
58361,2297,3759,42006,16355,5.50443e+13,1468.57,11757.7,58361,1458,506,54599,51710,42705,44625,43472
69739,117,3783,46997,22742,3.09386e+13,830.049,11358.7,69739,1176,286,54117,44006,33010,9136,5094
58374,617,2065,37707,20667,2.95723e+13,558.694,6991.62,58374,551,362,56170,54683,48484,48097,30301
42844,2402,3724,30052,12792,5.51022e+13,1146.28,9633.81,42844,1290,455,39120,37735,32231,23495,26754
96099,2489,3650,60931,35168,2.9359e+13,963.337,12050,96099,974,456,92449,92012,88931,90213,79677
72760,1499,3888,52335,20425,5.0109e+13,1558.31,13299.2,72760,1467,537,67377,63161,51852,48915,37866
11686,656,1135,8420,3266,2.73026e+13,214.956,2953.02,11686,288,131,10551,10544,10311,10167,8957
51723,1526,3414,37035,14688,3.91811e+13,922.388,10451.8,51723,957,343,48267,46734,42910,41494,33312
19912,847,2508,14565,5347,5.77869e+13,1187.54,5859.65,19912,808,227,16337,15554,9446,10586,7196
72519,294,3949,48891,23628,3.19249e+13,941.762,12108.8,72519,1159,303,63925,59771,41274,19936,11219
99741,2682,4419,70863,28878,4.55962e+13,1602.68,16535.8,99741,1945,580,95176,94349,79288,71358,67800
92313,3700,4453,66355,25958,4.58724e+13,1756.68,15677.3,92313,1705,602,87860,87686,84162,82398,81740
13960,213,2501,10448,3512,6.68986e+13,502.317,4857.45,13960,633,206,10418,9271,5042,4814,2125
5423,361,831,3544,1879,3.59951e+13,243.204,1652.67,5423,218,145,4592,4315,3769,2415,1011
47071,184,1528,30372,16699,2.96625e+13,554.907,5104.26,47071,525,323,40896,38301,33593,2964,3291
33290,1678,2865,23856,9434,5.42501e+13,1356.46,8158.53,33290,1128,305,30084,27831,23354,22840,20534
69686,293,4229,48990,20696,5.22329e+13,1451.05,13401,69686,1769,524,56329,50496,33717,18641,8007
41266,424,2543,29619,11647,2.76381e+13,771.747,7537.78,41266,800,231,36983,35107,21740,11228,14983
98672,3468,4060,62570,36102,2.96745e+13,949.613,12737,98672,1077,468,94612,94548,94612,94612,92569
29343,381,1476,18890,10453,2.93237e+13,541.951,4342.62,29343,445,282,27085,25208,22661,22803,8153
59583,256,3453,43109,16474,4.73095e+13,1297.55,11570.2,59583,1203,380,49326,45229,26725,15226,4905
67032,2781,19617,55229,11803,2.24021e+13,4111.83,31427.6,67032,6668,21,42381,33090,31971,22495,14492
72643,3207,3932,52382,20261,4.7294e+13,1634.85,13346.3,72643,1499,452,68711,68505,65968,65314,64354
53993,1539,3084,33229,20764,3.03429e+13,580.069,7758.85,53993,703,313,50909,50732,45842,47569,40251
52049,1414,1475,33560,18489,2.98323e+13,573.908,5284.54,52049,503,303,50574,50574,50534,50547,50462
27548,1618,1705,19901,7647,3.08156e+13,546.513,5326.7,27548,517,200,25843,25843,25818,25787,25261
39024,644,2612,24993,14031,2.8676e+13,385.212,6694.78,39024,1008,189,36274,35496,28462,24708,17912
6585,178,650,4269,2316,2.88742e+13,273.834,1553.55,6585,233,115,5619,5334,4781,4566,3107
20787,1622,2812,15125,5662,6.25651e+13,955.441,6031.26,20787,886,249,17975,16865,13323,14161,14461
35619,521,1817,25727,9892,2.77546e+13,632.133,6064.15,35619,769,229,32812,30443,21486,14277,17128
54751,1685,2986,36334,18417,3.77645e+13,719.553,7725.29,54751,750,337,51765,51366,43393,10473,13535
27564,675,1046,17746,9818,2.82554e+13,500.841,3516.05,27564,377,242,26518,26341,24830,24637,22563
18654,74,393,12630,6024,3.34832e+13,281.581,2211.19,18654,260,162,10934,4340,7472,5993,4360
72726,1721,2406,46996,25730,2.98402e+13,607.503,7971.47,72726,676,347,70320,70320,69161,67675,62114
73525,437,3021,47951,25574,3.49283e+13,640.225,8783.87,73525,565,352,68892,63786,56056,8371,6153
30071,2870,3000,21918,8153,6.27129e+13,1331.89,7554.16,30071,1017,270,27071,27071,27071,27071,26527
56366,3695,4026,40444,15922,5.78772e+13,1551.2,11880.6,56366,1576,520,52340,52340,52248,50969,51108
44179,698,3592,31926,12253,6.25296e+13,1482.37,9850.85,44179,1306,443,36819,35269,19646,18476,9086
95794,2015,2903,60874,34920,2.98487e+13,710.49,10110.3,95794,667,453,92891,92709,87846,79375,80788
73257,2948,3693,49534,23723,4.29001e+13,1101.16,11249.3,73257,1283,430,69564,69338,65824,30022,39819
55171,1784,2023,35580,19591,2.98225e+13,531.354,6641.56,55171,524,331,53148,53148,52844,52677,51905
35850,561,1223,23150,12700,2.99688e+13,550.38,4252.03,35850,437,265,34512,32362,30327,29425,24888
73235,1447,3930,46197,27038,2.92047e+13,671.798,10862.9,73235,1077,386,69305,68973,59303,44377,37203
63025,1019,3616,39721,23304,2.94723e+13,562.883,9800.9,63025,1081,317,59409,58995,46818,30242,22042
34553,479,2484,24804,9749,3.13603e+13,739.428,7116.24,34553,759,200,31102,30029,19227,19418,6931
98282,1486,4419,63615,34667,2.95603e+13,843.876,14009,98282,1263,431,93863,93253,79106,55008,47533
64837,1796,2628,40825,24012,3.01995e+13,604.545,8311.99,64837,553,409,62209,62088,57053,51093,48846
92272,4556,24336,75750,16522,2.56848e+13,5311.62,39753.8,92272,8474,26,61418,45505,46792,54214,24867
92503,806,4065,60503,32000,2.97222e+13,736.384,12928.8,92503,1261,400,87938,86502,66043,43045,30168
89031,2042,4109,56776,32255,2.96193e+13,759.921,12792.8,89031,1250,415,84922,84674,79136,79777,58682
58325,5454,24617,46664,11661,131212000,1005.02,36060.2,58325,5859,11,33708,29139,25489,33708,6554
81458,3892,4206,58546,22912,4.93734e+13,1715.85,14658.5,81458,1667,557,77252,77237,77194,76363,76388
81709,2494,3900,56138,25571,4.60995e+13,1275.74,12611.3,81709,1374,464,77809,76300,68349,34412,47021
93240,2211,4260,64218,29022,4.68144e+13,1366.92,14784.7,93240,1803,531,88829,84851,69161,43246,47968
6940,1338,1576,5123,1817,7.11539e+13,230.257,2541.16,6940,348,284,5364,5364,4719,5074,4445
57321,2565,3454,36991,20330,2.92936e+13,557.786,9176.19,57321,1199,251,53867,53813,53649,53746,45947
59102,1248,2562,37456,21646,3.02118e+13,556.191,7862.99,59102,531,387,56540,56449,50643,42542,34439
26208,417,1481,16802,9406,3.0193e+13,499.533,4183.8,26208,414,240,24263,22971,21365,18269,14779
11879,50,949,7656,4223,2.99389e+13,381.768,2437.03,11879,280,171,8001,5232,5942,4128,1527
6781,1280,1558,4635,2146,3.87738e+13,206.191,2718.18,6781,401,118,5223,5223,5083,5168,4174
16918,5242,7395,14039,2879,1.7241e+13,303.255,10107.7,16918,2345,12,9523,9422,9523,9523,9523
93102,1814,4160,62953,30149,4.32865e+13,1378.28,13361.7,93102,1437,466,88450,85319,71078,26429,39191
98805,1702,4762,65811,32994,3.17202e+13,1272.6,15622.8,98805,1389,459,93865,92329,84941,84242,43554
68875,3335,4059,48040,20835,3.44889e+13,1074.87,12487.5,68875,1090,385,64816,64640,62886,63429,60694
17973,891,926,11582,6391,2.93015e+13,466.169,2828.29,17973,355,210,17047,17047,17001,17019,16992
34569,1030,1231,22303,12266,2.89867e+13,514.83,4131.03,34569,407,265,33338,33338,32765,32721,32219
50465,1185,2047,32563,17902,2.96115e+13,549.843,6566.56,50465,521,332,48418,48403,46432,45349,37750
4111,325,412,2411,1700,3.28467e+13,140.606,831.234,4111,97,73,3699,3684,3586,3640,3153
85028,962,3887,58362,26666,4.61587e+13,1297.94,12806.6,85028,1459,478,78409,75649,54582,20251,17972
35537,736,3587,24628,10909,5.42814e+13,689.536,8305.91,35537,998,422,31341,30636,21753,9748,8980
91710,1533,4311,59237,32473,2.94918e+13,826.653,13418.8,91710,1257,417,87399,86869,74297,53448,44526
27104,929,1010,17518,9586,2.99862e+13,482.164,3476.38,27104,389,237,26094,26094,25937,25933,25837
58095,908,3660,39117,18978,4.41227e+13,866.592,9770.61,58095,1015,423,53873,52888,41200,11546,13903
75156,166,2723,46976,28180,3.06799e+13,648.676,8957.08,75156,566,425,66331,60906,49319,30521,11267
70138,3459,3852,48338,21800,4.86158e+13,1131.24,11604.6,70138,1408,461,66286,66096,65029,59447,50488
39343,2659,2785,27844,11499,3.43076e+13,803.531,8205.43,39343,852,226,36558,36558,36558,36558,35958
19392,979,1468,13891,5501,2.64018e+13,632.24,4370.98,19392,741,169,17924,17450,17204,17481,14698
65884,1460,3725,44522,21362,2.97859e+13,806.305,10833.5,65884,1065,282,62159,61196,57188,48642,26021
79517,2485,3574,52278,27239,3.54928e+13,1024.6,10398.2,79517,859,350,75943,75600,71379,60624,35729
66831,1110,2660,42212,24619,3.04778e+13,615.179,8476.96,66831,579,407,64171,63992,55174,44476,33988
41362,490,2047,25438,15924,3.11753e+13,478.741,5734.46,41362,403,295,39029,37995,29308,17490,14575
50388,304,2323,32162,18226,2.95121e+13,574.96,7082.95,50388,529,362,45830,42760,38320,32754,15300
76779,203,3856,53160,23619,4.88269e+13,1275.91,12463.6,76779,1508,466,62266,55890,39582,12239,5798
28960,685,1852,19200,9760,4.02512e+13,487.609,4818.25,28960,429,247,27108,26643,22422,5559,5881
98724,2969,4186,67256,31468,4.58455e+13,1340.99,14379.4,98724,1815,472,94538,94188,85790,46031,60981
1141,62,228,668,473,3.30375e+13,42.0578,361.308,1141,45,40,913,847,739,610,377
64512,1250,4183,46143,18369,5.4883e+13,1478.77,13000.9,64512,1643,519,58005,54153,39905,34610,26702
12550,15,1269,8100,4450,2.9829e+13,296.149,2938.33,12550,320,191,5240,1981,2433,996,433
32141,2046,13519,26436,5705,2.2618e+13,1229.94,18631.6,32141,3454,15,18403,15502,13918,10726,7588
66935,2022,3767,43778,23157,2.95091e+13,627.253,10569,66935,1220,310,63168,63027,61824,62722,37185
76615,1152,4231,50877,25738,2.89645e+13,869.318,12124.1,76615,1226,332,72087,70724,54182,46220,23384
77539,999,3905,51571,25968,3.10919e+13,874.712,11915.8,77539,1293,288,72987,71148,60133,45435,30557
2817,259,345,2048,769,3.10385e+13,153.018,860.792,2817,157,76,2472,2430,2369,2441,1781
62313,401,2333,40212,22101,3.03187e+13,580.694,7034.63,62313,542,341,58171,53635,48742,16493,7175
11226,759,2176,8149,3077,6.8809e+13,266.529,3807.43,11226,422,303,9050,8938,3920,3778,1962
90442,3919,4029,59129,31313,2.94989e+13,735.252,12790.9,90442,1252,400,86413,86413,86413,86413,85324
62425,2084,4050,43739,18686,5.25654e+13,1318.11,12001,62425,1492,463,58219,54429,43804,32037,33268
70597,6858,7077,60007,10590,4.22151e+13,16.9952,8094.62,70597,3542,3537,63520,63520,62235,62980,62885
21502,1450,1483,13852,7650,2.99768e+13,409.461,3990.94,21502,368,255,20019,20019,20017,19988,19990
36952,1190,2335,22571,14381,2.8889e+13,367.997,5531.29,36952,881,172,34617,34573,34310,34224,28298
58543,1276,3129,36216,22327,3.00639e+13,585.419,8380.17,58543,887,327,55414,55124,47915,42522,32785
9964,448,5440,8143,1821,3.8137e+13,62.352,6747.3,9964,1361,12,4524,4462,0,4457,168
50108,110,3839,35801,14307,5.78905e+13,1368.93,10670.6,50108,1369,464,36248,28190,17912,8101,3265
54479,6499,17824,44469,10010,2.47457e+13,4620.35,27403.2,54479,6118,21,35339,26480,28702,31791,19943
33451,1361,2699,23741,9710,4.19871e+13,830.756,7782.78,33451,823,287,30601,29370,27224,25362,22274
96689,2791,4872,64422,32267,3.32535e+13,1229.21,15365.2,96689,1397,428,91817,91127,89442,89592,65428
54047,703,3442,37548,16499,2.87042e+13,778.694,9672.76,54047,922,281,49717,47914,32393,20224,9909
84732,1113,2871,54296,30436,2.99488e+13,665.711,9546.56,84732,686,440,81861,81660,73373,68415,54595
40446,1265,2877,28981,11465,4.29459e+13,860.66,8792.92,40446,846,323,37301,35819,32237,30186,26368
98203,1464,3688,62002,36201,2.93833e+13,979.684,12017.1,98203,967,460,94515,93713,84270,62983,55408
76139,2146,4242,53254,22885,3.7681e+13,1205.55,13603,76139,1303,421,71897,70562,65429,64737,44116
35057,2262,2317,21489,13568,2.88741e+13,328.234,5422.95,35057,851,160,32740,32740,32740,32740,32578
25393,1086,2742,18373,7020,5.62562e+13,1168.55,6745.85,25393,877,248,21862,20545,14325,14933,11266
68816,3213,3573,49359,19457,4.56113e+13,1577.86,12608.3,68816,1454,387,65243,65043,64446,63542,62027
50583,2130,2911,35900,14683,3.15492e+13,853.929,9297.76,50583,927,250,47672,47667,47621,47599,43494
45413,704,3754,32047,13366,5.57222e+13,1133.26,9884.74,45413,1256,462,39466,37989,24760,12407,12419
79615,2338,4157,50807,28808,2.96013e+13,720.029,12128.4,79615,1235,389,75458,75344,73802,74439,56346
32423,135,1595,20860,11563,2.90083e+13,454.527,4869.31,32423,395,282,27239,25696,21915,18777,6759
7103,558,611,4144,2959,3.19619e+13,175.733,1279.41,7103,123,106,6492,6491,6460,6463,6295
34099,444,1843,20705,13394,3.15248e+13,352.062,4848.62,34099,391,254,32202,31431,24036,12260,10087
35116,1717,1761,22669,12447,3.01299e+13,515.409,5245.04,35116,441,298,33355,33355,33320,33299,33287
5953,249,670,3831,2122,2.73285e+13,200.755,1449.66,5953,223,110,5187,5015,4682,4597,3201
82667,1797,2482,53375,29292,2.97859e+13,578.375,8586.84,82667,660,384,80185,80179,78395,76643,66727
30806,279,2462,20229,10577,2.85554e+13,432.979,6218.06,30806,922,193,26369,24098,17316,11488,5600
32314,2808,3000,21940,10374,4.52068e+13,534.823,7035.44,32314,804,338,29314,29314,29015,28411,26833
83219,548,2959,52258,30961,2.97229e+13,695.64,9723.59,83219,624,452,79459,76585,63728,51043,32813
4272,315,399,2493,1779,3.2003e+13,136.82,823.98,4272,84,82,3873,3853,3786,3819,3434
19067,445,917,12300,6767,2.94507e+13,468.282,2910.05,19067,380,204,17852,16642,16161,15394,12579
19475,2062,2087,12802,6673,2.63396e+13,324.844,4616.54,19475,712,166,17388,17388,17388,17388,17338
3245,242,1790,2842,403,8.67821e+11,13.8783,1898.13,3245,306,28,1455,1407,354,1414,268
89496,2685,4343,63638,25858,4.73307e+13,1588.15,15559.3,89496,1748,566,85110,84268,69985,63210,61720
95067,1220,3677,60011,35056,2.91462e+13,959.984,12022.4,95067,981,449,91199,90581,77953,57188,46142
87855,3410,4353,62446,25409,4.76923e+13,1467.23,15338.1,87855,1765,567,83502,83321,79280,69090,71648
65615,3233,3446,40925,24690,2.94794e+13,675.493,9425.17,65615,952,377,62169,62169,62169,62169,61611
32646,883,1453,21161,11485,3.17246e+13,506.421,4408.56,32646,425,271,31193,31161,28690,27966,24524
3766,57,1075,2473,1293,5.53471e+13,194.694,1662.69,3766,356,58,2256,1416,947,1224,170
12925,1118,1222,9211,3714,3.00797e+13,408.771,3410.6,12925,499,129,11703,11703,11664,11692,11119
28461,1378,1639,17392,11069,3.08407e+13,297.833,4301.97,28461,322,237,26822,26822,26025,26330,24818
30787,2439,3084,22356,8431,6.06155e+13,1315.03,7737.78,30787,959,275,27703,26770,26003,26027,26328
87294,1018,4006,57136,30158,2.95646e+13,717.399,12569.8,87294,1256,394,83073,81947,63460,43602,26384
84280,557,3360,55330,28950,3.54839e+13,887.98,10017.6,84280,701,363,79957,75540,62057,8118,6489
14495,687,945,10568,3927,3.17924e+13,202.768,2982.13,14495,324,132,13550,13550,13206,13458,11105
19285,1946,2947,14125,5160,7.20324e+13,699.301,5914.11,19285,669,393,16338,15754,11547,12178,13244
14918,688,827,9651,5267,2.967e+13,432.76,2500.89,14918,294,192,14091,14087,13729,13723,13440
3754,86,424,2195,1559,3.28602e+13,134.841,815.169,3754,98,73,3142,2854,2356,1533,929
64156,3315,4199,45590,18566,5.39036e+13,1456.84,12964.3,64156,1671,515,59957,59888,56464,51004,52713
37649,721,2739,26817,10832,4.14821e+13,850.566,8291.04,37649,827,298,33576,32386,27687,26153,17927
27264,545,1028,17564,9700,2.89793e+13,495.52,3537,27264,367,244,26178,24548,23341,22894,20652
15118,36,2106,10348,4770,3.92093e+13,513.007,4645.17,15118,527,179,8318,4532,3585,3530,1092
30195,1272,1739,19868,10327,3.6937e+13,489.96,4701.59,30195,405,259,28456,28452,27125,27105,23593
97604,122,3023,61079,36525,3.00268e+13,722.319,10465.1,97604,611,480,83519,76002,62866,41746,9247
48539,1398,1911,31209,17330,2.96408e+13,502.366,6150,48539,487,317,46628,46626,45893,45264,39849
50527,2822,2992,32365,18162,2.89922e+13,473.511,7998.81,50527,1177,213,47535,47535,47534,47535,46841
41219,15439,22564,36112,5107,8.61568e+11,20.3526,22991.1,41219,1860,50,18655,18649,13583,16117,13135
3479,208,488,2244,1235,2.92869e+13,170.885,989.941,3479,154,101,2985,2879,2565,2688,1685
51384,1764,2484,32405,18979,3.02469e+13,547.099,7293.47,51384,514,372,48900,48880,45880,46390,39362
63173,5964,6319,53722,9451,4.21128e+13,17.0495,7291.24,63173,3163,3158,56854,56854,54744,55971,55808
37807,386,2062,24249,13558,2.99677e+13,562.603,5841.51,37807,480,330,34811,32652,28774,25669,10113
38880,1239,1808,25073,13807,2.95517e+13,515.98,5665.36,38880,474,312,37072,37058,35953,35040,29094
36417,1381,2663,24205,12212,2.77776e+13,488.296,6977.88,36417,952,223,33754,33722,32433,29899,17510
2137,402,712,1455,682,6.78978e+13,50.2681,1082.47,2137,230,51,1425,1425,1309,1349,800
17438,403,891,11225,6213,2.97402e+13,454.805,2749.49,17438,347,196,16173,14994,14221,14008,11720
12507,27,2648,9156,3351,6.77155e+13,348.616,4627.8,12507,604,158,5820,3930,1896,2503,254
8901,631,657,6514,2387,3.13519e+13,186.443,2026.61,8901,248,109,8244,8244,8226,8235,8004
58667,1749,3503,42018,16649,4.15075e+13,1245.3,11466.1,58667,1247,356,54807,52465,48654,46218,37609
7935,219,865,5115,2820,2.9053e+13,274.932,1975.61,7935,276,134,6812,6228,5808,5564,2994
46001,98,2173,28097,17904,3.1202e+13,496.572,6080.14,46001,447,318,38996,35033,27959,12690,4705
58623,1164,3756,42215,16408,5.61734e+13,1480.33,11775.1,58623,1457,518,52416,48878,35123,32806,23994
9738,620,1826,6702,3036,4.345e+13,358.764,3502.71,9738,493,132,7912,7205,6917,6879,4976
26034,1235,2566,19304,6730,6.43663e+13,1243.31,6673.15,26034,882,274,22612,21245,13528,13899,12555
27639,200,1764,16920,10719,3.16609e+13,307.863,4350.31,27639,383,221,25055,22839,18280,8926,5116
93426,164,4221,61354,32072,2.97757e+13,800.875,13462.6,93426,1257,430,79789,67744,53044,20346,6894
24308,325,3084,17910,6398,6.72218e+13,1177.46,6839.29,24308,847,409,18810,16753,7553,5937,4194
48317,563,3891,34801,13516,6.0655e+13,1442.9,10610.3,48317,1343,454,40002,37947,20951,17145,7733
30426,27622,30426,15213,15213,5807960,0,30426,30426,15213,2,0,0,0,0,0
57222,872,3365,40679,16543,3.47726e+13,954.826,10704,57222,1039,328,52757,50554,40374,42181,27198
42396,481,2933,25784,16612,3.00122e+13,444.954,6824.18,42396,848,261,39139,37626,27627,11593,8592
31486,1430,1777,19186,12300,3.16935e+13,332.198,4638.09,31486,365,250,29709,29707,28373,28904,26514
8706,514,1822,5798,2908,5.18643e+13,391.399,3196.1,8706,505,136,6740,6001,5851,6121,1753
21928,143,1479,13761,8167,3.00953e+13,390.237,3852.15,21928,346,231,18970,17580,14673,9235,1658
43841,2448,2857,31077,12764,3.38572e+13,819.093,8722.07,43841,917,232,40984,40984,40984,40976,38920
40695,1406,2628,29000,11695,3.29393e+13,787.181,8020.98,40695,919,221,38067,37114,36298,36958,28203
68769,497,4245,48479,20290,5.26512e+13,1434,13323.5,68769,1740,523,58147,54270,35091,22562,10740
34181,768,1767,24717,9464,2.84279e+13,628.978,5910.85,34181,752,219,32154,31409,25215,26982,21363
63203,1508,3566,39876,23327,2.96362e+13,559.211,9667.84,63203,1060,312,59637,59452,53983,54350,41408
43546,8330,16263,35097,8449,2.6102e+13,5280.17,24010.9,43546,4554,20,27283,19517,22512,24267,15882
32929,1165,2892,22275,10654,4.31271e+13,566.79,6540.6,32929,696,327,30037,29751,21616,5879,4255
16867,995,2923,11966,4901,6.21937e+13,462.188,5641.93,16867,721,334,13944,13581,8048,5990,5933
52079,1790,2416,33230,18849,2.9802e+13,575.431,7289.07,52079,545,375,49663,49636,47844,47358,44753
27489,930,2265,19424,8065,2.65068e+13,585.975,5988.55,27489,823,229,25131,24607,18927,15915,6707
53647,1676,1991,34687,18960,2.98696e+13,546.942,6338.68,53647,517,323,51656,51652,51321,51115,48959
96305,587,4285,67729,28576,4.59613e+13,1396.78,15735.8,96305,1766,574,85446,81812,58276,38867,19685
70241,2436,3867,50718,19523,5.24686e+13,1434.19,13008,70241,1506,531,66374,64316,55049,55973,55185
34208,1166,14121,27901,6307,2.4189e+13,2701.2,19771.9,34208,3355,16,17207,14922,14655,8447,5411
55935,2972,3664,37947,17988,4.59042e+13,819.674,9652.96,55935,1006,427,52271,52183,49389,22941,27621
20093,1279,1690,13399,6694,4.34809e+13,417.912,4043.25,20093,372,210,18403,18395,17662,16760,14013
73302,21481,30608,58646,14656,104428000,1061.49,45046.6,73302,7357,11,42694,42694,39409,42694,30293
49381,2030,2106,30256,19125,3.12832e+13,520.395,6238.5,49381,466,302,47275,47275,47256,47275,46892
29179,512,1549,18812,10367,2.94119e+13,564.207,4474.31,29179,422,286,27305,26545,23348,22546,8662
90714,10596,35666,73661,17053,1.70482e+12,103.268,37548.9,90714,1867,159,55048,55034,17999,22714,20419
56459,4361,22257,45841,10618,1.70173e+12,96.8566,23716.9,56459,1378,151,34202,34185,7690,12760,9507
21401,1952,7524,17440,3961,1.72958e+13,125.493,9261.22,21401,587,133,13877,13876,5956,5408,6438
51828,745,3582,32938,18890,3.00859e+13,452.414,8900.85,51828,1199,203,48203,47657,33887,17462,6355
27436,1007,1628,17371,10065,2.97997e+13,444.676,4451.86,27436,402,250,25808,25782,24205,23996,20514
61654,2529,3773,42381,19273,4.76341e+13,1135.89,10860.7,61654,1340,452,57881,56570,49068,25334,34383
66717,3851,3954,46614,20103,5.17529e+13,1327.73,12173,66717,1464,465,62763,62763,62581,61931,61823
91897,418,4458,62481,29416,3.6508e+13,1248.69,14795.3,91897,1378,412,81399,76778,52116,28005,18821
1580,179,429,1022,558,3.20696e+13,88.0063,720.364,1580,124,83,1151,1061,1005,1002,611
8831,59,645,6416,2415,3.12497e+13,185.798,2001.88,8831,247,123,6931,4791,3995,1783,1324
53587,1641,3301,38635,14952,4.97972e+13,1427.69,10869.8,53587,1213,367,49542,46660,39877,37579,32330
38967,282,2599,26945,12022,2.80564e+13,545.244,7231.34,38967,891,260,33945,31770,21094,10895,5624
86154,631,747,58477,27677,3.36109e+13,305.195,5041.63,86154,312,272,85407,85407,81468,82601,81510
62090,1439,3571,44286,17804,3.93537e+13,1109.12,11688.6,62090,1162,364,58108,55863,50720,50218,35602
57299,643,3912,40598,16701,5.59308e+13,1328.73,11392.8,57299,1514,468,49487,47664,28640,15342,14005
70562,1213,3813,46422,24140,2.96644e+13,667.258,10923,70562,1224,314,66729,65930,50766,44161,22673
29869,415,1080,19264,10605,2.93211e+13,540.951,3757.45,29869,431,248,27973,25932,24482,23786,19759
43494,968,2119,26600,16894,3.10568e+13,479.93,5871.91,43494,439,306,41375,41228,33749,22092,19512
61098,1294,3891,42923,18175,5.33698e+13,1302.35,11614.3,61098,1498,459,55565,52443,37021,23079,21928
76386,2282,4216,54960,21426,5.03723e+13,1588.51,14116.5,76386,1633,560,71913,68865,57143,58210,51118
75821,3470,3897,49068,26753,2.94245e+13,646.664,11577.1,75821,1238,375,71924,71924,71924,71924,68431
50705,431,576,34449,16256,3.36668e+13,302.736,3794.54,50705,300,248,50129,50129,44447,46339,44429
29015,166,1094,18700,10315,2.89429e+13,478.816,3700.85,29015,425,254,24874,23292,20470,17605,8929
10809,526,1188,7640,3169,2.86501e+13,514.376,3019.34,10809,567,116,9383,8706,6091,5234,6587
90713,19827,24555,73971,16742,2.60305e+13,6153.63,39964.4,90713,7925,27,66158,66158,64594,64716,59916
96044,72,3577,62406,33638,3.37777e+13,894.399,11093.8,96044,778,441,73748,55193,53051,6057,2354
84120,1129,2808,53128,30992,2.99517e+13,692.182,9528.84,84120,649,431,81312,80961,70205,58794,47943
98626,1788,4843,65738,32888,3.23667e+13,1216.84,15548.5,98626,1398,442,93642,92159,87147,86814,44997
39676,932,1723,25535,14141,2.93988e+13,539.058,5153.63,39676,500,283,37953,37913,36338,35668,34293
50238,1735,2067,32497,17741,3.00842e+13,605.982,6710.38,50238,545,357,48171,48170,47490,47175,47202
79333,1986,3972,51329,28004,2.9493e+13,668.064,11915.3,79333,1240,383,75361,75195,73619,73689,49461
6530,478,659,4220,2310,2.96778e+13,274.705,1571.49,6530,216,143,5871,5639,5581,5454,4888
10373,2312,2461,7803,2570,7.24754e+13,271.261,4084.95,10373,528,152,7912,7912,7912,7912,7648
61682,981,3098,40796,20886,3.69528e+13,796.849,8421.72,61682,782,337,58523,57982,45557,6876,6684
69823,1849,3174,46173,23650,3.67986e+13,818.991,9119.3,69823,835,342,66649,66042,55496,13694,18254
2733,601,1183,2188,545,6.81232e+13,89.723,1582.81,2733,337,100,1550,1533,496,590,260
58601,1038,1546,37682,20919,2.97221e+13,613.328,5676.65,58601,559,319,57055,57047,53816,53145,51210
21721,1392,1522,13795,7926,3.00992e+13,444.252,3958.86,21721,378,237,20199,20199,20124,20167,19474
73341,2484,4181,51238,22103,3.73185e+13,1197.7,13267.3,73341,1272,416,69160,68708,64533,63633,51765
10284,694,759,6605,3679,2.90808e+13,349.168,2035.51,10284,286,163,9525,9525,9457,9437,9385
48756,1949,2058,31401,17355,2.97514e+13,594.238,6626.75,48756,527,338,46698,46698,46665,46692,46465
83850,205,2834,53755,30095,3.00069e+13,650.988,9433.88,83850,635,428,74134,68720,60190,52345,15514
47619,2476,3318,34021,13598,3.92238e+13,907.488,9874.98,47619,925,338,44301,44247,41041,42094,40217
10256,621,1260,6620,3636,3.06832e+13,273.852,2685.02,10256,286,193,8996,8849,8402,8315,5489
32487,9094,13616,26685,5802,2.71377e+13,1548.19,18477.7,32487,4396,17,18871,17685,17256,17773,17881
42940,385,1327,27582,15358,2.88488e+13,551.464,4698.58,42940,445,294,40070,36881,35023,33831,17841
8572,529,597,5010,3562,3.24906e+13,197.704,1338.28,8572,162,96,7975,7969,7901,7917,7729
71974,1918,3962,49989,21985,4.97636e+13,1269.92,12383.8,71974,1534,465,67532,63754,51327,31162,33778
52039,2381,3912,37377,14662,6.01846e+13,1563.76,11229.9,52039,1516,498,48127,45830,38349,38893,39101
94400,30390,39225,76226,18174,1.92977e+13,118.975,44772.7,94400,3213,178,55175,55175,55175,55175,55175
27107,997,1504,15969,11138,3.18881e+13,303.776,3420.84,27107,391,168,25603,25597,22664,23183,20184
83723,2789,3591,55002,28721,3.48429e+13,1100.5,10737.4,83723,770,362,80132,79862,77706,75616,60589
53702,2388,3816,38092,15610,5.6684e+13,1359.99,10991.9,53702,1391,464,49886,47546,41672,31860,35981
2160,344,555,1695,465,9.34253e+13,100.919,926.012,2160,66,93,1605,1586,1271,1320,1210
97567,3265,4369,68632,28935,4.64556e+13,1555.61,16045,97567,1905,579,93198,92730,87170,68310,72620
41235,2563,3743,29680,11555,6.37566e+13,1197.38,9608.55,41235,1232,468,37492,36566,31862,27585,29523
89402,3303,4014,56649,32753,2.93008e+13,789.807,12210.3,89402,1094,429,85388,85271,85388,85383,81889
15997,866,1162,10357,5640,3.00265e+13,479.322,3120.57,15997,347,216,14835,14789,14238,13751,12217
24683,832,1482,15818,8865,2.98579e+13,487.976,4092.81,24683,427,233,23201,23017,21934,20718,19733
51287,812,1958,33034,18253,2.90766e+13,516.544,6116.46,51287,474,314,49329,49180,44706,44346,38981
75159,3392,4231,52571,22588,3.77942e+13,1194.65,13513.3,75159,1280,420,70928,70762,67301,68469,63901
27217,697,2327,18767,8450,2.64734e+13,535.993,5979.32,27217,857,215,24620,23668,16802,13452,6241
35539,1098,1909,21994,13545,3.11179e+13,429.743,5240.57,35539,398,283,33630,33615,29050,26777,20159
41796,2507,2899,29508,12288,4.58877e+13,1130.87,9101.57,41796,1102,323,38897,38693,37413,37335,36901
35186,1852,12303,28711,6475,1.72917e+13,127.19,14938.1,35186,896,152,22883,22880,7269,5590,7880
37020,917,1170,23933,13087,2.99263e+13,538.7,4202.14,37020,414,277,35850,35822,34848,34613,34254
60534,3481,3562,43661,16873,4.74242e+13,1519.2,11829.8,60534,1241,386,56972,56840,56972,56972,56970
60258,1710,2622,38060,22198,3.06262e+13,585.033,7968.12,60258,555,388,57636,57568,52756,47440,45278
75315,2155,2429,48625,26690,2.9588e+13,585.405,8104.61,75315,651,358,72886,72886,72441,72385,71972
15348,1012,1874,10673,4675,2.56543e+13,422.633,4235.73,15348,705,160,13474,13340,12223,11756,8512
56156,283,3612,37835,18321,4.40048e+13,818.211,9585.48,56156,997,427,48479,44010,35290,7157,5714
43429,1002,3640,30324,13105,5.21599e+13,1053.91,9474.5,43429,1239,418,38648,37026,25386,13603,13063
14800,189,901,9568,5232,3.04294e+13,415.913,2559.45,14800,313,186,12802,12019,10933,10255,5546
97241,670,4328,63154,34087,3.07113e+13,871.342,13888.7,97241,1069,435,91752,89494,66281,47877,25274
72002,3661,3694,47812,24190,2.93653e+13,813.103,10658.2,72002,1193,289,68308,68308,68308,68308,68292
11220,369,753,7206,4014,2.76961e+13,371.954,2100.51,11220,296,169,10281,9588,9260,9103,7058
72167,3949,4211,51284,20883,5.17514e+13,1399.26,13797.4,72167,1709,536,67956,67945,67641,66724,64016
73764,1309,4300,52333,21431,5.1945e+13,1387.38,13921,73764,1792,540,67324,63206,48028,37043,30029
32715,1044,3183,23577,9138,6.08289e+13,1346.95,8138.79,32715,1067,277,28072,26052,17133,18066,11512
95993,2459,4032,63788,32205,3.89667e+13,1244.57,12473,95993,1063,438,91961,90978,77740,20603,39541
42511,19846,24729,32620,9891,2.20445e+13,298.477,26420.2,42511,24434,88,17782,17782,14815,14648,17101
83092,507,3963,52608,30484,2.96646e+13,783.962,11813.6,83092,1082,424,77879,74010,58297,40805,21929
59930,9500,23551,48637,11293,1.70857e+12,99.4079,25061.5,59930,1433,153,36379,36371,15611,20994,17070
31594,973,2366,22374,9220,3.49657e+13,751.14,6906.42,31594,746,210,28971,27757,27237,27556,18672
40529,627,2027,26130,14399,2.94911e+13,600.135,5944.7,40529,513,324,38274,37467,33321,31418,17018
31585,1533,1536,20379,11206,2.92217e+13,477.569,4447.02,31585,422,252,30049,30049,30049,30049,30048
63162,473,4074,44602,18560,5.59604e+13,1407.78,12421.1,63162,1705,461,53163,49364,31133,19719,9431
26670,258,1655,16902,9768,3.10715e+13,453.041,4476.65,26670,398,252,23841,22334,19264,14444,8510
58318,1331,3438,41766,16552,4.95295e+13,1344.86,11406.3,58318,1366,355,53468,49889,42125,38690,31232
86705,2518,4038,57015,29690,2.97336e+13,742.589,12641.7,86705,1252,404,82667,82445,81544,82205,54644
73478,1008,3733,53028,20450,4.3844e+13,1360.01,13132,73478,1353,408,67182,63398,50448,49923,29513
36107,1158,2536,23674,12433,2.81354e+13,459.151,6769.73,36107,974,199,33571,33302,30780,28272,16552
15864,614,1605,13483,2381,4.22067e+13,16.9776,2078.42,15864,805,800,14259,14259,8343,11789,11309
70998,262,3681,47660,23338,4.26989e+13,1019.28,10522.6,70998,1019,440,61423,55699,44318,7994,10762
58059,1504,4048,41324,16735,5.6429e+13,1521.79,12134.1,58059,1601,526,52624,48741,35709,30793,25886
8450,282,758,5019,3431,3.15464e+13,182.506,1558.7,8450,155,114,7692,7505,5468,3342,2609
14724,45,2401,10477,4247,5.48478e+13,441.582,4822.06,14724,594,220,8434,5221,3983,3222,497
84461,2180,2795,53887,30574,2.96724e+13,652.511,9455.09,84461,668,428,81666,81578,78991,78027,73827
24489,1186,2883,17826,6663,6.45427e+13,1087.91,6673.13,24489,969,254,21017,19633,15137,14414,12079
11206,852,1291,8052,3154,2.91949e+13,317.049,3180.09,11206,419,144,9915,9887,9044,9359,6818
33849,2149,3002,22889,10960,4.4221e+13,557.759,7032.46,33849,803,327,30847,30595,28351,12438,13760
32754,1077,1913,21629,11125,3.85624e+13,505.276,5087.68,32754,454,255,30841,30785,28029,21357,10564
9025,632,1643,6021,3004,5.697e+13,258.604,3139.83,9025,582,119,7382,6992,6743,7143,3676
9197,1252,2115,6676,2521,5.21831e+13,396.055,3749.98,9197,573,202,7082,6930,5837,5861,5371
79990,3593,4221,56207,23783,4.98548e+13,1367.62,14273.5,79990,1771,533,75769,75724,73922,59113,61776
19840,900,1302,12749,7091,2.86724e+13,455.186,3381.04,19840,363,205,18538,18531,18382,18459,18045
50233,2958,3967,36031,14202,6.14765e+13,1482.46,11080,50233,1587,454,46266,46169,41864,41056,41532
60984,2857,3691,41224,19760,4.46701e+13,921.871,10020.1,60984,1055,419,57293,57078,52704,22139,30709
29349,680,1690,18365,10984,3.08222e+13,428.614,4657.08,29349,368,259,27655,27233,23089,16616,15679
24723,518,2240,16230,8493,2.76126e+13,414.889,5360.48,24723,841,181,21968,20073,16750,13513,9251
14542,1304,11275,11147,3395,3.57472e+13,319.041,12126.7,14542,1839,45,3267,2815,3265,2810,1361
45041,1451,2248,28222,16819,3.05314e+13,529.013,6393.92,45041,507,349,42793,42769,38633,35359,31364
7136,715,749,4620,2516,3.0293e+13,321.936,1725.65,7136,291,130,6387,6387,6367,6387,6369
18738,7844,10891,15058,3680,3.68691e+13,606.484,13058.5,18738,2473,12,7847,7550,200,6670,2940
97902,3445,4563,67825,30077,4.0474e+13,1529.48,15851.2,97902,1587,450,93339,92877,86433,87002,80080
69722,1487,2355,45017,24705,2.94684e+13,607.495,7999.26,69722,580,386,67367,67344,64782,62282,50732
19006,976,1534,13731,5275,3.0199e+13,382.729,4356.01,19006,448,178,17472,17341,15523,16132,11602
26949,1569,1674,19563,7386,2.9898e+13,459.987,5173.11,26949,468,200,25275,25275,25236,25205,24519
41826,99,2625,29483,12343,2.82721e+13,587.284,7484.35,41826,856,270,30161,21589,17174,4087,1535
51106,558,2384,32185,18921,2.98304e+13,563.217,7147.38,51106,513,366,48270,46868,39546,32085,16858
81489,16010,34880,65714,15775,2.01482e+13,137.23,39927.1,81489,3164,173,46609,46609,36557,35902,33690
72457,25853,27224,58364,14093,2.34216e+13,3151.53,36672.3,72457,4723,148,45233,45233,45060,44725,45067
70757,1855,4186,49954,20803,5.14333e+13,1407.55,13601.1,70757,1707,536,65861,61539,49336,40793,36231
79936,716,4271,56690,23246,4.99072e+13,1366.26,14480.4,79936,1764,541,70487,67613,47898,35202,22626
5594,257,1257,3899,1695,6.38286e+13,226.711,2219.1,5594,332,143,4206,3836,3227,2919,1469
27466,615,1539,17753,9713,2.9668e+13,471.158,4436.93,27466,405,263,25924,25092,23358,23102,19093
26237,1104,1978,18646,7591,3.50329e+13,642.643,5803.17,26237,709,164,24183,23342,23389,22936,20357
94986,223,4461,67591,27395,4.65791e+13,1636.87,16162,94986,1967,576,77903,70051,43939,17470,4362
17599,580,869,10288,7311,3.22505e+13,271.715,2180.14,17599,264,139,16730,16700,15566,16091,14879
8917,124,694,5738,3179,2.74936e+13,317.509,1805.96,8917,237,147,7510,7169,6183,5545,2843
95260,2886,3702,62440,32820,3.42957e+13,1163.33,11622.8,95260,860,400,91558,91255,89099,86349,71004
22413,603,2561,16646,5767,6.30545e+13,1233.25,6218.96,22413,808,258,18020,17339,8823,7894,5402
45183,166,2343,28508,16675,3.01282e+13,530.862,6651.43,45183,484,346,39415,36187,30056,20262,6658
36613,1460,3590,25812,10801,5.51039e+13,914.024,8629.17,36613,1011,420,32557,31484,24063,14000,13417
4177,768,850,2775,1402,4.99056e+13,197.654,1549.16,4177,278,96,3327,3327,3247,3314,3089
78487,1784,3977,49415,29072,2.94505e+13,727.508,11324.9,78487,1035,400,74510,74175,67087,62890,49160
66151,3026,3637,44436,21715,2.86036e+13,772.516,10474.3,66151,1094,282,62514,62442,62498,62514,59957
34728,24,1738,22343,12385,2.95593e+13,503.94,5331.74,34728,464,312,17161,7542,9974,3542,1396
82107,3181,3524,51594,30513,3.00919e+13,880.886,10692.1,82107,745,441,78583,78440,78583,78583,76611
29552,520,1741,18985,10567,2.93076e+13,518.522,4994.31,29552,480,280,27604,26111,24124,23193,13522
30487,38,1117,19547,10940,2.89347e+13,553.399,3840.39,30487,446,245,19014,11295,13146,6275,2257
42745,2912,3057,28617,14128,4.07464e+13,654.043,7449.06,42745,775,331,39688,39688,39444,39473,38314
72379,135,4163,50189,22190,3.49069e+13,1085.45,12883.2,72379,1115,395,55701,44580,33353,8447,4123
78338,2646,2900,48803,29535,3.06295e+13,692.986,9312.94,78338,596,432,75438,75430,75032,75132,73827
7289,66,585,4248,3041,3.18592e+13,177.651,1250.88,7289,126,98,6151,5645,4377,2544,1272
53291,247,2983,37820,15471,3.16682e+13,859.186,9692.08,53291,939,253,45060,40052,27029,11450,11508
70418,449,2309,45450,24968,2.96649e+13,550.697,7837.98,70418,608,379,67003,62685,56658,55213,26664
4460,192,684,3108,1352,1.37343e+13,440.054,1517.02,4460,410,90,2747,2000,1440,2450,2033
83506,4023,4342,59350,24156,4.19007e+13,1569.97,14674.1,83506,1514,452,79164,79159,79070,78083,76977
49108,1529,2856,33846,15262,2.87979e+13,554.461,8240.35,49108,937,275,46252,46215,44511,39524,27473
72952,3369,3471,45580,27372,2.9495e+13,791.608,10051.5,72952,726,416,69481,69441,69481,69481,69295
45844,645,1901,29527,16317,2.92743e+13,518.842,6101.63,45844,489,332,43911,42778,39087,37481,24882
78268,2236,2951,51134,27134,3.38582e+13,704.112,9012.81,78268,649,358,75317,75213,74363,73657,67095
46035,1744,3597,32013,14022,5.02278e+13,1031.24,9489.04,46035,1129,420,42189,40391,31256,17024,19309
34597,2020,3556,24653,9944,5.79577e+13,1062.3,8616.02,34597,1130,405,31041,29166,23775,19774,20197
45511,693,1725,29303,16208,2.97516e+13,546.521,5296.26,45511,512,287,43786,43475,39519,39811,36188
54814,1458,2352,35196,19618,3.00641e+13,610.908,7359.91,54814,575,374,52462,52416,50121,46519,45070
38079,1660,2730,26905,11174,3.38239e+13,756.293,7935.32,38079,970,223,35349,34976,34795,34787,30038
1926,235,292,1250,676,2.6742e+13,81.0384,589.062,1926,93,59,1634,1634,1630,1627,1564
93804,1881,4318,66398,27406,4.64099e+13,1620.46,15963.6,93804,1828,566,88412,84238,70744,56576,47613
22404,1673,1987,14172,8232,2.63964e+13,304.941,4515.68,22404,672,153,20417,20417,20384,20416,19176
69651,70,2689,43222,26429,3.04452e+13,638.465,8446.84,69651,536,405,55788,45044,40419,22616,4287
29055,1458,2386,19675,9380,4.56894e+13,508.32,5487.59,29055,585,288,26669,26544,24006,8536,8772
4293,356,645,2811,1482,3.25199e+13,145.399,1260.9,4293,164,96,3648,3535,3422,3264,2842
85185,1867,4338,59802,25383,3.96231e+13,1339.49,14597.5,85185,1435,443,80478,77623,69449,67668,45718
69375,1145,2700,43550,25825,3.0548e+13,649.452,8658.92,69375,537,422,66675,66358,56399,43403,35416
58381,1466,3439,42073,16308,4.33305e+13,1246.05,11352.2,58381,1193,360,54164,51282,45352,43070,31832
18394,1126,2352,12808,5586,5.38617e+13,390.757,4810.01,18394,559,308,16042,15897,11535,6023,4968
80982,3404,3639,51095,29887,2.9261e+13,812.509,11134.4,80982,966,433,77343,77266,77343,77343,76589
30999,712,2850,21996,9003,5.14959e+13,1424.47,7848.19,30999,1130,307,25762,24258,17726,15964,8534
64189,2868,3647,43850,20339,4.48582e+13,1092.79,10546.9,64189,1134,437,60542,60312,55573,25808,34092
62300,1394,2508,40060,22240,2.9511e+13,618.367,7942.56,62300,616,402,59792,59715,56652,52953,42695
85461,2525,8553,72659,12802,4.21608e+13,18.4956,9685.89,85461,4279,4274,76908,76906,40773,61844,58843
22967,563,1607,16541,6426,3.04699e+13,498.712,4847.66,22967,512,193,21054,20256,14130,15136,7514
19066,2601,2636,14333,4733,7.21516e+13,821.123,5698.23,19066,716,253,16430,16430,16430,16430,16428
71403,1096,3807,49007,22396,4.75418e+13,1154.56,11593.1,71403,1365,464,66007,63808,48598,17598,21043
65794,511,3128,43495,22299,2.96373e+13,675.045,9455.24,65794,1167,278,61368,58702,41730,24519,22027
30624,1194,2096,22201,8423,2.9239e+13,523.057,5902.3,30624,527,209,28528,28158,27165,28107,20382
52816,184,2474,33512,19304,3.03711e+13,574.187,7439.54,52816,525,361,46265,42700,36236,26565,9908
68609,2210,3656,49329,19280,4.57488e+13,1544.71,12711.6,68609,1408,386,64589,62277,55634,54041,47169
80892,995,4226,57012,23880,4.9209e+13,1348.09,14449.9,80892,1721,538,73176,69248,52353,35392,26524
10491,44,1048,6767,3724,3.02773e+13,336.919,2402.18,10491,288,197,6649,3589,4736,3631,630
14790,3073,11040,11563,3227,3.4437e+13,437.839,12071.9,14790,1930,15,3750,3114,3637,3109,2216
99915,2703,4319,65456,34459,2.98631e+13,863.386,14038.8,99915,1257,444,95596,95296,94767,95071,67515
4223,205,966,2882,1341,4.36293e+13,211.253,1735.15,4223,328,67,3060,2631,2400,1945,1340
43204,1377,3518,31413,11791,6.27094e+13,1464.04,9505.8,43204,1175,451,38378,35412,23436,23628,21211
64813,1651,2226,41749,23064,2.92816e+13,581.431,7420.11,64813,586,346,62587,62587,61681,60293,55369
45198,1400,2041,29137,16061,2.93687e+13,577.105,6384.38,45198,500,336,43157,43146,41724,40675,37394
30887,2066,2377,21378,9509,2.70018e+13,547.273,6383.04,30887,857,235,28510,28510,28485,28469,26457
84046,1360,4369,57554,26492,3.66405e+13,1217.18,14148,84046,1274,423,78892,76442,64198,54387,28102
97462,257,4283,63215,34247,2.95523e+13,841.971,13789.5,97462,1260,442,87264,81244,60224,31023,10223
97933,23112,38497,79499,18434,1.70645e+12,104.163,40456.9,97933,2176,159,59436,59432,36770,42095,38343
97089,3546,4032,64172,32917,3.82025e+13,1303.15,12814.6,97089,1063,454,93057,92909,91810,90028,81855
25824,418,2563,18801,7023,6.05038e+13,1221.31,6637.91,25824,890,259,20715,19324,10805,9382,4381
67388,481,3668,45004,22384,4.11228e+13,860.806,10126.7,67388,1013,427,61720,57102,46217,9207,7934
24138,750,998,15621,8517,2.96188e+13,471.372,3306.49,24138,386,227,23140,23132,22426,21975,21905
52892,3232,3279,37541,15351,3.37636e+13,952.838,10168.9,52892,1038,306,49613,49613,49613,49611,49569
97397,738,3366,61016,36381,3.03153e+13,809.242,10910.9,97397,642,456,93581,92496,75262,58782,44668
36769,683,2543,25487,11282,2.78847e+13,547.694,7020.76,36769,882,257,33778,32750,22491,15277,7966
24804,164,1038,16080,8724,2.99922e+13,474.355,3372.86,24804,410,232,21295,20107,17542,15295,7773
67037,2816,3541,42147,24890,2.9843e+13,570.236,9695.63,67037,1009,336,63496,63496,63496,63496,61299
64646,3036,3557,42659,21987,3.79801e+13,797.994,9647.05,64646,972,393,61089,61083,58853,55550,42985
87925,1499,4010,58080,29845,2.97713e+13,760.143,12742.5,87925,1248,405,83915,83400,70607,68603,38398
35918,985,1715,23159,12759,2.93245e+13,484.633,5136.9,35918,400,285,34203,34180,33142,33095,29901
25509,733,2594,17907,7602,4.19641e+13,808.545,6746.95,25509,812,265,22070,20987,18105,16754,11129
45561,379,2941,32278,13283,2.73861e+13,681.678,8313.43,45561,847,279,40600,38182,24119,8901,3459
25461,2092,2897,17520,7941,4.81488e+13,435.396,6232.71,25461,730,319,22564,22431,20641,11086,11549
25880,942,3435,18344,7536,6.13875e+13,678.514,7301.65,25880,871,407,22035,21294,14683,9230,8984
94543,633,4098,59943,34600,2.96634e+13,874.144,12555.9,94543,1102,442,89625,87603,69348,52288,32492
55598,1556,3287,40259,15339,4.8981e+13,1297.38,10975,55598,1203,380,51498,48763,41399,38978,31690
45050,1699,2872,30226,14824,2.85948e+13,509.373,7907.13,45050,979,256,42178,42175,41005,37824,28656
34647,1292,1772,21755,12892,3.10116e+13,451.347,5087.96,34647,414,272,32875,32870,30654,31301,26468
46733,3900,4683,39735,6998,4.21423e+13,17.0304,5515.24,46733,2344,2339,42050,42050,37380,40099,39723
24218,1774,1962,17154,7064,3.50816e+13,597.114,5563.07,24218,681,159,22256,22066,22256,22256,21545
42021,1937,15825,34336,7685,2.07567e+13,1396.86,22746.8,42021,4579,71,25515,21842,22310,15084,6546
66272,8752,20432,53653,12619,2.68068e+13,6262.09,32055.8,66272,6569,22,45840,33215,37971,33599,19929
68826,880,4163,49301,19525,5.26219e+13,1422.83,13433.9,68826,1629,534,60688,57284,41257,34228,24236
8671,810,1463,5751,2920,4.73354e+13,423.721,2973.35,8671,554,118,7208,6926,6726,6470,4029
49818,872,3116,35271,14547,3.08641e+13,893.914,9284.43,49818,1115,264,46068,44540,30718,24128,14116
34330,707,1190,22142,12188,2.95575e+13,507.789,4083.93,34330,432,259,33140,32958,30680,30142,28042
10748,232,1546,6901,3847,2.41839e+13,292.6,3033.3,10748,514,127,8166,6901,5986,5976,2855
77764,1304,4211,55918,21846,5.00625e+13,1463.61,14311.9,77764,1647,565,71218,66934,53315,46953,35802
77452,2247,4273,54080,23372,5.00773e+13,1403.9,13904,77452,1776,532,73062,69326,56158,41384,43055
11735,132,1155,8419,3316,3.01313e+13,413.549,3136.47,11735,497,123,8127,4209,4983,3609,548
43023,1263,1873,27788,15235,3.00293e+13,540.697,5976.85,43023,486,338,41150,41116,39545,38097,30243
3211,1005,1127,2151,1060,1.95572e+13,114.99,1581.6,3211,305,97,2084,2084,2084,2084,1997
22241,233,1395,14618,7623,3.58779e+13,433.706,3770.04,22241,347,236,19461,18057,15704,2509,2049
82227,4096,4166,56817,25410,4.95509e+13,1319.02,13569,82227,1796,484,78061,78057,78028,77448,77947
90483,3944,4485,61704,28779,4.15066e+13,1319.65,14851.5,90483,1472,435,85998,85945,83459,83138,81643
74264,1271,2721,47379,26885,3.00951e+13,632.231,8888.75,74264,646,420,71543,71376,64348,56661,45860
3408,603,658,2692,716,9.41466e+13,147.082,1199.09,3408,86,108,2750,2750,2692,2711,2672
51773,3185,3263,33077,18696,2.91425e+13,474.83,8466.74,51773,1187,211,48510,48510,48510,48510,47971
91565,1664,2901,57775,33790,3.00368e+13,704.247,9990.68,91565,637,459,88664,88406,81387,67630,65335
95818,1660,4460,63261,32557,2.91714e+13,975.66,14015.7,95818,1273,410,91358,90671,82715,82075,48070
23810,1110,1487,15342,8468,2.96425e+13,441.915,4155.82,23810,373,261,22323,22306,21958,21656,19025
84991,2113,3945,58444,26547,4.6732e+13,1300.3,12944,84991,1486,476,80881,77009,65334,32818,42704
84290,495,4256,59732,24558,4.87439e+13,1350.38,14825.3,84290,1767,553,72963,68921,48675,35687,17315
90262,1795,4309,58453,31809,2.95097e+13,806.614,13195.3,90262,1266,418,85953,85556,76602,73548,45512
71556,1939,2673,45118,26438,3.01052e+13,635.214,8738.52,71556,560,418,68883,68758,64305,61614,56337
65670,346,3613,44191,21479,2.85324e+13,777.077,10438.2,65670,1077,283,59210,56051,37509,18766,13322
47627,1391,1640,30828,16799,3.07345e+13,564.509,5316.01,47627,515,317,45987,45986,45428,45270,44364
54380,3182,3692,37481,16899,4.84235e+13,1050.23,10295.6,54380,1282,417,50688,50537,49139,30370,34101
18164,1280,2028,11780,6384,2.63799e+13,290.388,4335.76,18164,667,155,16136,16136,15944,16095,13640
88085,3871,4355,58193,29892,2.90032e+13,927.176,13266.1,88085,1253,395,83730,83660,83730,83730,81526
41812,2453,3030,27962,13850,4.02489e+13,646.416,7401,41812,754,328,38782,38780,36877,30203,19684
54428,13408,29791,47687,6741,8.60597e+11,14.9105,30280.6,54428,2042,50,24637,24637,12989,13138,11834
80493,2317,3699,54230,26263,4.1596e+13,1147,11398.5,80493,1195,441,76794,74933,63795,22515,37679
48895,88,2940,34716,14179,3.28509e+13,856.681,9228.97,48895,925,252,34133,24199,18221,6362,3685
5398,407,477,3158,2240,3.24687e+13,172.048,1004.76,5398,109,86,4921,4917,4840,4862,4561
43174,2515,3358,30773,12401,5.59127e+13,1486.01,9733.48,43174,1312,342,39816,39242,36101,36004,35437
35956,952,2003,23029,12927,2.95069e+13,599.825,5588.51,35956,465,321,33953,33728,30900,27733,20242
69395,2129,3908,47900,21495,4.92924e+13,1147.81,11703.3,69395,1406,467,65399,62909,52442,25952,35454
31763,493,1635,20302,11461,3.07555e+13,496.657,4735.32,31763,454,277,29786,28834,26508,22142,19115
88668,3520,4169,56674,31994,2.97375e+13,755.906,12812.3,88668,1248,407,84499,84499,84499,84496,80181
48947,2062,2919,33184,15763,2.88961e+13,533.753,8248.02,48947,972,265,46028,46027,44899,45725,36991
25938,2413,3159,18908,7030,6.31724e+13,1246.12,7192.23,25938,1007,316,22779,21744,21206,21497,20853
51983,3258,3754,37303,14680,5.57865e+13,1529.65,11080.7,51983,1451,455,48229,48225,46935,47148,46645
74756,1452,2314,48263,26493,2.96227e+13,565.732,8007.72,74756,657,375,72442,72428,69583,68374,57137
1846,41,254,1182,664,2.37082e+13,85.6327,535.146,1846,88,54,1262,759,976,724,498
69665,159,2995,45623,24042,3.55303e+13,591.76,8225.13,69665,579,342,59168,55433,45225,6177,3218
23223,59,2690,16331,6892,5.84464e+13,1011.11,6499.83,23223,982,234,14315,9082,6646,6645,1251
61737,83,614,41862,19875,3.34709e+13,301.993,4196.38,61737,305,255,38504,15419,25583,10143,19496
9742,343,637,6247,3495,2.94839e+13,340.041,1814.61,9742,221,172,8995,8399,8272,8038,5887
33822,1278,1781,21893,11929,3.00347e+13,518.19,5299.71,33822,466,291,32041,32032,31162,30659,27082
27757,57,1700,20175,7582,3.00777e+13,472.556,5263.59,27757,477,204,18009,10514,9103,2419,1229
38139,14320,14998,30927,7212,1.71286e+12,93.8838,16182.9,38139,1125,137,23141,23141,22268,23077,22230
48638,1122,2973,31424,17214,2.89739e+13,461.169,7914.56,48638,1124,223,45665,45281,42198,37793,25183
30855,93,1779,18691,12164,3.14607e+13,345.085,4528.86,30855,360,247,26165,23550,18365,7131,2696
42080,1251,2144,26480,15600,3.03127e+13,520.093,6055.53,42080,475,332,39936,39912,35852,30264,29307
92049,16531,24620,75244,16805,2.48119e+13,5877.45,40315,92049,7799,26,67429,67429,63155,64443,53947
42570,614,7820,32782,9788,2.5289e+13,363.385,14911.2,42570,3135,224,34193,33010,22143,7830,2355
55147,4906,20638,44351,10796,2.64238e+13,4163.64,29116.2,55147,4649,107,31597,24387,25572,28472,11936
7170,954,984,4708,2462,3.7784e+13,281.67,1974.5,7170,272,156,6186,6186,6179,6177,6168
20331,431,1031,13166,7165,3.04711e+13,452.4,3131.21,20331,338,206,19038,17694,17506,16741,14752
22136,560,966,14344,7792,2.90297e+13,476.503,3129.2,22136,356,216,21147,20365,19455,18458,18186
20401,1916,2813,14744,5657,6.37347e+13,895.588,5937.93,20401,869,249,17588,16650,13858,14814,14227
37463,584,1756,24133,13330,2.94071e+13,521.156,5450.72,37463,438,299,35662,34334,30791,30579,21966
79612,1545,3742,53706,25906,4.14428e+13,1156.21,11341,79612,1151,437,75254,73407,58043,17434,26816
37535,136,2390,26888,10647,2.80972e+13,633.974,6860.15,37535,808,248,28422,21138,16838,3815,820
87497,868,4489,57964,29533,3.08517e+13,896.626,13712.9,87497,1347,354,82046,80368,57423,43462,16474
41333,1046,2179,24969,16364,3.16696e+13,460.057,5593.41,41333,546,261,39154,38960,31242,26188,19981
78117,182,3924,53745,24372,4.7392e+13,1244.3,12381.5,78117,1381,473,63081,57133,40800,10492,4245
26060,1984,2253,18228,7832,3.71596e+13,655.863,6252.15,26060,672,203,23807,23807,23760,23791,22122
46450,2231,2945,32827,13623,3.41917e+13,850.353,9186.2,46450,953,242,43505,43505,43454,42375,39032
45106,1516,3577,32282,12824,6.22897e+13,1472.08,10045.6,45106,1431,430,40500,37469,26695,26607,25070
75515,577,4215,52971,22544,3.76572e+13,1220.9,13554.2,75515,1304,416,67335,62868,42008,24286,9540
57355,3470,3518,36296,21059,2.95468e+13,481.537,9308.91,57355,1162,272,53837,53837,53837,53837,53573
51936,1864,3208,36885,15051,3.35504e+13,932.119,9973,51936,1003,297,48728,48213,47720,46311,40469
6633,248,329,4462,2171,3.27747e+13,218.105,1275.82,6633,196,101,6282,6127,5339,5612,6000
92803,5120,25141,75477,17326,2.60672e+13,6524.21,40899.8,92803,7799,26,61376,41585,46246,53106,19488
55148,268,2146,34288,20860,3.10703e+13,546.318,6607.38,55148,497,325,50841,48157,38967,25471,15525
83515,4325,4466,55358,28157,3.10256e+13,933.627,13316.8,83515,1336,331,79049,79049,79049,79049,78545
92981,1818,4435,66529,26452,4.64533e+13,1687.82,16019.4,92981,1871,577,87301,82863,70201,62869,51539
99098,2223,4249,67299,31799,4.40329e+13,1410.01,13759,99098,1443,488,94740,91513,78114,30064,47455
97577,549,4827,69523,28054,4.52446e+13,1748.06,16645,97577,1791,630,84707,79091,47172,26455,9732
81133,2824,3923,53339,27794,2.96834e+13,686.417,11905,81133,1243,357,77210,76974,77164,76811,61414
53647,205,3090,33238,20409,2.99353e+13,566.484,7954.83,53647,725,308,47496,42969,33420,14723,8258
11758,513,721,6864,4894,3.19771e+13,228.39,1696.54,11758,181,125,11037,11010,10176,10528,9059
49159,304,3609,35127,14032,5.34263e+13,1562.36,10675.9,49159,1443,359,38259,34370,22036,18537,7375
41896,3386,3707,29507,12389,5.54186e+13,1130.7,9512.43,41896,1243,457,38189,38105,37727,35153,31824
20219,462,943,11795,8424,3.19322e+13,281.867,2405.27,20219,288,141,19276,19123,16202,14961,13574
83476,3138,3969,55422,28054,3.90307e+13,1187.57,11619,83476,1054,431,79507,79287,75905,69485,47991
25096,19,1629,18209,6887,2.91251e+13,618.871,5061.05,25096,541,205,8082,3064,2221,1247,649
52886,1528,2003,34173,18713,2.96952e+13,573.54,6658.46,52886,527,338,50883,50883,49827,48929,45672
16100,265,846,10387,5713,2.88202e+13,426.047,2587.72,16100,322,196,14454,13462,12877,12358,7238
91394,1845,4573,60670,30724,3.15109e+13,1047.51,14490.4,91394,1353,372,86821,85968,83251,83867,43213
74618,2445,4122,51551,23067,5.04506e+13,1294.8,12963.3,74618,1675,465,70496,69012,58858,37980,43989
80960,2066,4238,57624,23336,4.15528e+13,1343.56,14262.1,80960,1411,446,76496,74020,65692,63826,43559
89435,2009,3990,58380,31055,2.9708e+13,718.232,12642,89435,1246,395,85445,85180,83501,83634,55277
65704,141,2728,41645,24059,2.97813e+13,599.409,8492.34,65704,585,409,55882,51735,43272,30851,8369
12496,1449,2394,9281,3215,6.33734e+13,419.872,4537.14,12496,616,191,10102,9921,9522,9675,7698
8746,236,1124,5128,3618,3.3009e+13,189.19,1909.81,8746,255,114,7585,7077,6194,6624,4110
44192,1620,3408,29605,14587,4.33711e+13,704.281,8482.09,44192,940,410,40784,40069,31729,11068,12155
67412,1767,2180,43367,24045,2.88935e+13,570.474,7512.56,67412,558,370,65232,65232,64254,63472,61885
82466,2282,4302,59020,23446,4.93089e+13,1657.48,14924.1,82466,1677,567,77721,74475,62175,58742,51290
17842,651,896,11452,6390,2.90981e+13,461.373,2789.87,17842,382,197,16946,16623,16305,15802,15822
13755,454,1182,8888,4867,3.00587e+13,311.646,2831.39,13755,283,186,12538,12097,11769,10523,9481
55997,2761,3469,40161,15836,3.85233e+13,932.97,10906.2,55997,1022,350,52528,52515,49144,50407,49242
7007,530,719,5955,1052,4.22153e+13,16.9505,1027.92,7007,363,358,6288,6288,5184,5823,5744
81400,38,3740,54662,26738,4.04807e+13,1163.63,11432.4,81400,1154,440,48709,30553,28801,6256,1711
31780,153,1197,20478,11302,2.94582e+13,533.612,3988.21,31780,452,260,27025,25425,21896,20770,6684
69232,826,2318,44603,24629,2.91831e+13,580.168,7820.66,69232,597,361,66914,66297,59134,59608,44258
40537,381,1234,26188,14349,2.96626e+13,576.303,4448,40537,501,280,37841,35248,32979,32079,20193
43525,113,2048,26805,16720,3.09776e+13,473.81,5837.1,43525,416,297,37426,34154,27200,14185,4970
28839,1786,2926,21051,7788,6.2093e+13,1279.76,7358.29,28839,979,262,25598,23716,20541,21034,18622
86499,1576,4136,55043,31456,2.95555e+13,772.734,12428.3,86499,1182,418,82363,81893,71835,52794,47131
87905,3934,3979,59117,28788,4.16737e+13,1359.93,12452.6,87905,1361,464,83926,83926,83926,83926,83865
43115,2692,3117,30956,12159,5.43091e+13,1383.38,9632.21,43115,1176,337,39998,39889,38132,38123,38007
5910,476,2557,4938,972,7.10491e+12,4.08359,3530.12,5910,827,11,3353,3353,3152,3352,1612
83914,740,2897,53357,30557,2.98539e+13,679.822,9626.57,83914,672,441,80790,79873,67862,60323,41674
27163,574,1664,16709,10454,3.03792e+13,365.401,4405.12,27163,347,253,25467,25262,20619,13371,11607
78451,755,4124,54395,24056,5.0578e+13,1342.47,13412,78451,1745,471,70056,67425,46540,22946,16012
8840,616,655,6440,2400,3.11224e+13,185.766,2017.67,8840,246,111,8185,8185,8168,8170,7895
76226,3640,3889,52557,23669,4.74343e+13,1280.01,12360,76226,1427,467,72337,72335,71528,68877,64247
75787,3389,3752,48292,27495,2.95438e+13,629.295,11096.2,75787,1232,358,72035,72035,72035,72035,69282
90413,3763,4128,61908,28505,4.64205e+13,1289.88,13668,90413,1579,475,86285,86284,84659,77034,67171
24940,67,1674,15620,9320,3.06243e+13,414.993,4357.76,24940,350,255,19505,15549,14556,9535,1386
52397,1754,1990,33794,18603,2.96475e+13,532.371,6582.66,52397,519,343,50407,50407,50067,49850,49526
3668,121,776,2643,1025,3.21577e+13,174.102,1487.86,3668,312,77,2345,1190,1431,1085,1142
42245,15967,15990,34069,8176,2.51498e+13,5075.12,23536.6,42245,4383,16,26255,26255,26255,26255,26255
44104,47,2012,28766,15338,3.40062e+13,507.85,5691.64,44104,462,293,29506,19212,20655,2611,1121
66021,890,3767,42544,23477,2.94043e+13,571.956,10576.4,66021,1232,321,62084,61379,46379,33975,15897
57782,2399,3854,40514,17268,5.36166e+13,1131.22,10954.2,57782,1356,458,53928,52248,45122,27482,33344
78848,1970,4253,55680,23168,4.97959e+13,1350.77,14364.9,78848,1762,542,74131,70030,57143,48015,43328
21466,777,2700,15205,6261,6.15182e+13,885.793,6284.72,21466,950,248,17984,17321,11875,11584,7478
36601,95,3353,26788,9813,6.26094e+13,1485.97,8676.6,36601,1112,385,24536,17212,10659,8046,2523
32418,658,3053,21959,10459,4.49706e+13,553.001,7128.64,32418,816,341,29292,28742,20463,6181,5260
73789,2774,3924,53066,20723,4.79021e+13,1660.13,13491.3,73789,1502,498,69865,69395,60376,62098,59910
32050,180,2090,22994,9056,2.72269e+13,641.689,6114.59,32050,783,238,25864,19137,14177,2325,1042
64570,3595,4008,45794,18776,3.60683e+13,1079.68,12193,64570,1059,396,60562,60531,60077,59313,59137
60746,848,3631,38656,22090,2.9353e+13,543.11,9875.43,60746,1169,310,57115,56416,42992,25132,16731
59710,2112,3102,39301,20409,2.9524e+13,600.349,8967.83,59710,1132,262,56608,56475,55473,51495,45580
19590,2329,3217,13725,5865,5.88218e+13,572.799,6304.6,19590,840,385,16373,16265,13522,11731,11401
21375,326,1045,13740,7635,2.91091e+13,469.71,3216.27,21375,353,229,19491,17784,17002,16417,9372
19768,780,1020,12777,6991,2.96589e+13,412.987,3048.04,19768,313,217,18748,18524,18338,18026,18174
53135,2925,3497,33206,19929,3.10134e+13,482.874,8870.96,53135,1009,275,49638,49638,49637,49638,46539
32818,1007,1804,20489,12329,3.06341e+13,422.194,5001.07,32818,390,273,31014,31000,27241,23397,19753
86119,2754,3951,58893,27226,4.53173e+13,1294.28,12908.5,86119,1410,472,82168,81799,73135,36185,50977
21409,1657,1741,12579,8830,3.18362e+13,282.336,3337.15,21409,423,154,19668,19668,19668,19668,19668
80930,2641,4257,57288,23642,4.9143e+13,1321.69,14476.1,80930,1767,543,76673,76244,67010,57150,58634
65182,38,3559,46594,18588,3.91992e+13,1190.77,12019.3,65182,1289,360,33495,17216,14695,5940,3027
16530,1588,7898,13225,3305,92686400,292.686,10982.4,16530,1665,11,8632,8258,7236,7538,1902
29782,1165,1762,18086,11696,3.12199e+13,330.199,4462.14,29782,361,229,28020,27983,24587,25839,19434
20620,992,1527,14903,5717,2.83801e+13,624.129,4564.16,20620,544,185,19089,18529,17700,18228,14832
67343,312,2139,43378,23965,2.9011e+13,573.287,7077.87,67343,542,331,61842,57025,53707,52027,28946
49332,2169,2933,33180,16152,2.8883e+13,506.557,8248.99,49332,1003,263,46399,46397,45496,46145,38574
13944,677,933,8992,4952,2.95824e+13,377.509,2561.91,13944,296,184,13011,12763,12612,12449,12536
58349,842,2616,36804,21545,3.06587e+13,578.767,7881.6,58349,535,385,55712,55003,46224,36771,24867
6661,359,676,4331,2330,2.96645e+13,285.545,1600.34,6661,261,127,5892,5566,5424,5160,4597
37810,3437,3661,27796,10014,6.66957e+13,1427.14,9189.38,37810,1153,455,34149,34149,34106,33888,33329
94191,17009,38964,75359,18832,113808000,1111.36,57579.7,94191,9453,11,55227,55227,45517,55227,23602
46872,611,3205,33277,13595,3.53277e+13,906.149,9573.52,46872,938,296,41952,39779,28787,27078,9832
28931,1454,2856,20503,8428,4.97976e+13,936.736,7579.11,28931,860,309,25913,24717,20897,19740,17415
43910,1501,1816,28215,15695,2.88714e+13,481.035,5778.25,43910,436,311,42094,42088,41610,41138,37291
65160,135,2474,41988,23172,2.97534e+13,611.377,8001.4,65160,620,389,55134,51558,43833,35638,11824
34903,331,1198,22391,12512,2.91488e+13,525.501,4173.83,34903,460,277,32064,29436,28307,27022,15302
24453,1441,1635,15178,9275,3.06052e+13,378.176,4204.5,24453,327,241,22818,22818,22498,22628,21553
17494,854,1071,11287,6207,2.93155e+13,453.578,2972.68,17494,353,193,16423,16423,16358,16393,16258
83268,656,4452,55208,28060,3.07689e+13,899.699,13245.2,83268,1346,333,77323,75038,50763,31212,9438
38875,342,3596,27235,11640,5.25277e+13,928.47,8783.62,38875,995,424,32610,29562,19278,6324,3170
51407,2423,3410,36526,14881,4.16967e+13,1097.53,10551.7,51407,1064,346,47997,47579,43564,44786,40905
14111,938,1649,9378,4733,2.28302e+13,299.092,3602.15,14111,562,152,12462,12452,11375,11649,6323
3153,457,1105,2248,905,6.80694e+13,80.8668,1598.45,3153,220,128,2048,2047,1792,1959,1289
27274,1273,1557,17596,9678,2.92267e+13,504.274,4572.89,27274,404,271,25717,25705,25216,24987,23597
77717,1184,4012,51902,25815,3.15194e+13,924.755,12355.8,77717,1256,300,73387,71492,62627,52914,30375
99107,3997,4279,69551,29556,4.54018e+13,1406.44,15914.9,99107,1756,568,94828,94785,94109,87946,83146
36176,763,1248,23352,12824,2.96209e+13,571.007,4287.18,36176,459,261,34928,34752,32274,32463,30282
81302,2038,4182,52184,29118,2.95515e+13,687.321,12276.2,81302,1245,380,77120,76969,72820,72890,52272
84451,1499,3966,57732,26719,4.56039e+13,1251.87,12673.5,84451,1442,472,79180,76399,61317,23533,30014
36019,368,1744,23143,12876,2.89803e+13,529.186,5412.55,36019,462,299,33041,30531,28532,27572,14707
32426,1375,2850,23200,9226,5.48579e+13,1380.1,8028.91,32426,1124,298,28844,26830,21706,20878,17028
47247,2758,2899,31994,15253,2.86727e+13,531.112,8114.73,47247,961,266,44348,44348,44345,44348,43133
94932,3730,4107,60466,34466,2.95659e+13,840.759,13028.7,94932,1182,443,90825,90825,90825,90825,88893
8669,925,1117,6188,2481,2.35303e+13,368.365,2602.63,8669,566,101,7552,7424,7273,7299,6982
49384,3541,3703,35455,13929,5.92883e+13,1557.5,10709.8,49384,1436,487,45681,45681,45375,45261,44859
37949,1567,2675,26853,11096,3.7473e+13,834.87,8150.53,37949,847,276,35274,34212,33562,31241,28928
67283,2786,3888,46821,20462,5.00703e+13,1287.9,11904.8,67283,1431,469,63395,63152,56973,35926,43163
35914,1371,1807,23213,12701,2.96647e+13,504.086,5463.9,35914,461,299,34107,34102,33320,33058,30963
54434,2310,5444,46295,8139,4.20824e+13,17.0572,6345.94,54434,2725,2720,48990,48990,30208,41161,39607
85635,483,4339,61030,24605,4.90797e+13,1638.04,15279.1,85635,1794,563,73578,69187,42476,34365,11162
41214,1059,1358,26539,14675,2.97086e+13,576.338,4710.87,41214,477,286,39856,39852,38875,38711,37986
27561,1010,1117,17728,9833,2.9183e+13,511.299,3677.65,27561,364,245,26444,26442,26264,26347,26138
86432,3240,4335,60679,25753,4.02775e+13,1340.18,14728.1,86432,1444,444,82097,81854,74523,74618,69228
28155,2041,2704,20612,7543,6.05538e+13,1213.23,7023.02,28155,881,264,25422,23645,20058,20676,21043
3199,555,920,2742,457,301058,5.12629,1581.72,3199,460,5,2279,2279,2279,2279,1555
90114,3044,4029,56966,33148,2.96799e+13,832.371,12163.8,90114,1072,441,86085,85923,86069,86085,79515
60457,122,2200,38981,21476,2.92431e+13,544.511,7144.77,60457,586,326,50128,46663,39908,33583,9813
49288,1584,1890,31706,17582,2.91079e+13,539.429,5862.21,49288,493,308,47398,47398,47200,47152,45839
95694,2314,4390,68509,27185,4.51367e+13,1654.73,16098.8,95694,1842,575,90804,87711,75512,70290,64436
22454,412,942,14518,7936,2.94832e+13,493.385,3150.19,22454,353,210,20924,19443,18572,17798,15059
73171,1897,2353,47136,26035,2.91316e+13,578.413,7978.75,73171,609,373,70818,70818,69792,69313,66342
89746,1221,3950,61245,28501,4.49818e+13,1251.21,13002.2,89746,1402,481,83853,81106,62789,22184,25487
69099,2359,3608,49263,19836,4.60048e+13,1590.59,12672.2,69099,1444,383,65273,63164,56046,57195,49285
54029,606,1959,34753,19276,2.94501e+13,551.45,6577.99,54029,518,324,52022,50356,45063,45118,34961
29234,3293,3558,21006,8228,6.03137e+13,949.449,7890.91,29234,962,417,25676,25641,25435,25138,22851
84878,1003,4140,58508,26370,4.75065e+13,1380.42,13957.8,84878,1752,514,77540,73810,55120,26843,20849
75789,2750,3871,50449,25340,3.08621e+13,868.797,11651.9,75789,1285,287,71918,71669,71665,71829,61714
19129,1065,1788,12991,6138,5.11449e+13,392.859,4119.06,19129,378,250,17341,17308,15998,7030,7645
47620,521,2151,31155,16465,3.57655e+13,534.36,6140.87,47620,525,307,45109,42011,36732,6100,6144
96055,3127,4624,63503,32552,3.08023e+13,1021.35,14724.7,96055,1368,404,91431,91258,91353,91011,75713
30291,1292,1926,20052,10239,4.02157e+13,516.453,5002.99,30291,467,244,28365,28353,26629,25154,18317
90854,2281,4277,62273,28581,4.61555e+13,1375.24,14600.3,90854,1835,530,86490,82846,68553,42098,47813
31185,61,1939,20709,10476,4.12378e+13,483.594,5084.07,31185,447,256,22431,15779,14844,3035,1005
41747,364,519,28309,13438,3.35721e+13,298.464,3406.09,41747,294,234,41228,41228,34681,36936,34582
12770,562,835,8265,4505,2.96457e+13,433.235,2323.74,12770,319,168,11902,11274,11320,10758,9820
95794,2696,4699,63532,32262,3.1233e+13,1073.32,15059.7,95794,1367,382,91095,90586,90199,90468,61328
80667,3831,4359,53615,27052,3.09763e+13,928.234,12839.2,80667,1326,298,76308,76308,76308,76308,74074
39546,829,1282,25485,14061,2.92178e+13,545.681,4497.01,39546,467,281,38264,38235,36055,35622,34250
55168,3285,4020,39246,15922,5.75104e+13,1371.17,11492.9,55168,1491,467,51148,51074,48243,41562,42878
67530,812,3825,46727,20803,4.98472e+13,1158.68,11512.5,67530,1369,466,61313,59495,43605,15966,17709
47309,13824,20210,37851,9458,129307000,939.331,29450.6,47309,4753,11,27099,27099,25182,27099,18814
6225,348,585,3974,2251,2.69032e+13,263.514,1415.38,6225,178,133,5551,5316,5239,5136,4670
76180,646,3736,51417,24763,4.21963e+13,1128.49,11427,76180,1291,432,70110,67838,50098,12321,12122
24827,1477,1542,15954,8873,2.90124e+13,492.07,4238.94,24827,402,266,23285,23285,23251,23207,23225
20046,269,934,11698,8348,3.17522e+13,270.934,2380.87,20046,277,163,19027,18426,14306,10652,9248
32850,57,1221,21211,11639,2.94114e+13,511.286,4043.76,32850,444,261,23320,15890,17914,17290,4093
67901,2808,3614,45281,22620,4.09282e+13,890.134,10133.4,67901,1014,414,64287,64204,60148,22316,29044
20532,56,405,13863,6669,3.3328e+13,283.492,2332.02,20532,258,174,10387,4469,7175,5748,2523
55887,1440,3364,39924,15963,4.98601e+13,1373.27,11089.1,55887,1403,356,51441,47807,40729,37903,31114
88989,1491,4421,63092,25897,4.76097e+13,1608.6,15577.6,88989,1837,566,82539,77912,62928,49805,36493
52832,1639,3425,37763,15069,4.14113e+13,1094.17,10704.3,52832,1075,349,49188,47401,43404,42018,33474
25513,274,2246,17564,7949,2.63767e+13,551.714,5766.41,25513,844,204,21083,19092,13044,7197,3295
88795,3888,4250,61346,27449,4.71928e+13,1358.04,14631.5,88795,1800,540,84545,84524,83267,75942,69308
59481,3160,3649,40199,19282,4.45521e+13,888.354,9839.27,59481,1023,422,55832,55693,53762,48385,36231
68879,582,3705,46753,22126,4.39167e+13,1113.34,11033.9,68879,1252,428,62676,59702,43810,11282,10191
99052,242,4558,68281,30771,4.04525e+13,1533.68,15906.3,99052,1586,453,83045,74911,48240,22647,11293
17666,329,1333,11377,6289,2.89502e+13,389.384,3397.22,17666,331,198,15837,14797,14327,13479,9214
59815,1023,3782,43083,16732,5.50757e+13,1476.89,11957.2,59815,1459,515,52923,49307,35616,32033,23134
93809,3079,4084,59196,34613,2.92986e+13,902.466,12450,93809,1039,457,89725,89502,89697,89721,83527
46485,1716,1881,30066,16419,2.97487e+13,531.205,6045.34,46485,480,308,44604,44601,44406,44402,44094
48127,2080,3364,34394,13733,3.93069e+13,923.605,9980.45,48127,943,329,44763,44430,41455,39837,36266
5063,647,992,3148,1915,3.02355e+13,86.175,1709.7,5063,201,116,4071,4068,3580,3757,2341
63890,1912,3918,44631,19259,5.16144e+13,1257.38,11631.1,63890,1382,476,59535,56366,44687,25524,28910
36042,2006,3698,26152,9890,6.48995e+13,1263.05,9060.88,36042,1221,451,32184,29899,22454,21652,23915
57946,763,3899,40934,17012,5.46167e+13,1345.36,11455.7,57946,1392,476,50707,48779,30136,18412,14108
37346,392,1725,23709,13637,3.06296e+13,488.763,5187.57,37346,449,295,34857,32873,29434,24074,20000
98224,3547,4578,68116,30108,4.07037e+13,1547.31,15915.6,98224,1582,451,93646,93397,86813,87790,81495
82791,2902,3938,54073,28718,2.95591e+13,692.677,12177.3,82791,1244,394,78853,78703,78701,78578,66406
50406,1636,2902,34656,15750,2.8863e+13,549.241,8369.36,50406,941,278,47504,47491,45804,40751,30431
26387,157,2219,18491,7896,3.66677e+13,648.274,6198.78,26387,664,202,21180,18887,13736,13994,4171
92728,1426,4191,64439,28289,4.70663e+13,1320.16,14890.7,92728,1791,538,86732,82291,65616,37992,34646
72595,1517,4197,50858,21737,5.11576e+13,1420.71,13506.5,72595,1783,532,66903,62819,47957,33696,29466
18658,569,928,12089,6569,2.91308e+13,472.427,2867.57,18658,359,199,17710,16894,16471,15541,14262
32596,2866,3570,23303,9293,5.85314e+13,961.453,8272.85,32596,979,424,29026,28948,26629,19930,20861
52362,2042,2434,33180,19182,3.00056e+13,572.301,7339.59,52362,568,376,49928,49925,48543,48943,45534
48491,1803,2284,31107,17384,3.01505e+13,594.698,6972.47,48491,545,368,46207,46186,45166,44915,42694
87279,3918,3977,59702,27577,4.53583e+13,1293.34,12850.7,87279,1414,475,83302,83302,83176,83101,82939
33092,1287,1918,19729,13363,3.15892e+13,328.461,4578.92,33092,440,238,31174,31134,27253,28698,23292
62363,23,2227,40167,22196,2.92902e+13,573.289,7370.08,62363,564,351,31426,14316,18740,5931,2375
90049,3449,4268,62477,27572,4.7233e+13,1368,14818.9,90049,1794,534,85781,85576,81659,56654,64776
85186,284,2917,53201,31985,3.05117e+13,685.758,9747.58,85186,631,443,78453,73521,60416,39818,12357
14846,58,876,9588,5258,2.97474e+13,436.262,2527.96,14846,364,190,10624,7305,8298,5179,2216
97076,694,808,65839,31237,3.35975e+13,305.494,5387.59,97076,315,277,96268,96268,93057,93745,92936
73604,10594,21183,60236,13368,2.33721e+13,5187.63,34221.7,73604,6720,22,52421,43386,44816,46992,33144
82173,3346,3934,56556,25617,4.67795e+13,1291.32,12800.6,82173,1468,465,78239,78006,75674,43957,54153
40851,1513,2684,27893,12958,2.80566e+13,524.51,7435.37,40851,924,260,38167,38153,36944,33731,24616
93292,2625,4246,60259,33033,2.94172e+13,833.072,13483,93292,1248,417,89046,88823,88642,88774,68711
49038,272,1446,31551,17487,2.94111e+13,581.456,5116.61,49038,512,296,44307,40778,39075,37319,18690
84514,2288,2871,54243,30271,2.98465e+13,668.978,9456.91,84514,679,432,81643,81588,80016,79526,77382
67130,3761,3947,47842,19288,3.8029e+13,1181.25,12539.3,67130,1200,397,63183,63183,63144,62819,62385
6560,39,633,4238,2322,2.92841e+13,272.667,1531.82,6560,198,146,4134,2423,2915,757,253
94344,103,2988,59508,34836,3.0275e+13,725.84,10307.9,94344,660,457,78803,70175,58244,40996,10407
57170,238,3305,41154,16016,4.83459e+13,1395.73,11232.9,57170,1213,368,46571,41565,25459,16517,5328
57540,1465,3770,41374,16166,5.31031e+13,1459.73,11715.6,57540,1458,463,52431,48469,38909,36310,30148
68202,2658,4064,47689,20513,3.50648e+13,1071.29,12471.9,68202,1087,392,64138,63953,61149,60242,53415
66770,3473,3607,42079,24691,2.91912e+13,560.938,9858.21,66770,1066,329,63163,63163,63163,63163,62735
49935,2402,2964,33125,16810,2.89668e+13,493.184,8278.45,49935,1029,258,46971,46968,46697,46835,41298
7612,416,657,4912,2700,2.85836e+13,314.567,1658.74,7612,236,148,6888,6538,6476,6252,4621
44260,720,1782,28480,15780,2.93235e+13,526.81,5773,44260,480,315,42478,42020,37934,38384,30081
57110,155,1987,36826,20284,2.96947e+13,564.435,6454.61,57110,551,323,48710,45794,39549,33939,13114
69803,155,4221,49483,20320,5.22994e+13,1404.58,13478.6,69803,1688,523,53015,46215,29367,19105,4922
45503,1030,1878,29324,16179,2.91752e+13,530.626,6098.75,45503,509,316,43625,43582,41410,40274,32045
58064,376,2082,37480,20584,2.96091e+13,567.94,6972.49,58064,547,338,53983,49905,46527,44382,26225
75588,228,2423,48707,26881,2.94737e+13,573.198,8178.49,75588,660,374,67089,61954,56235,52537,13128
8780,1023,1559,6021,2759,3.72737e+13,420.436,3078.55,8780,528,128,7221,7076,6665,6773,5830
82170,379,3559,53980,28190,3.50491e+13,1021.12,10586.4,82170,843,359,75158,69076,59816,6940,5161
43230,109,1848,27931,15299,2.96901e+13,525.426,5907.11,43230,501,325,35960,32712,28209,24366,5859
49408,2139,2310,31737,17671,2.93606e+13,593.135,6967.42,49408,522,359,47098,47098,46955,47040,46290
45827,1808,2068,28748,17079,3.06864e+13,545.89,6074.52,45827,467,335,43759,43759,43135,43349,41705
21043,1468,2525,15419,5624,5.7992e+13,1163.44,5994.08,21043,811,237,18226,16958,12983,14064,12290
59743,2275,2566,38240,21503,3.00706e+13,589.304,7989.69,59743,575,395,57177,57177,56551,56824,54609
56872,16454,18165,46521,10351,2.53828e+13,4538.33,28056.5,56872,6459,21,38707,38707,38075,38283,38282
14682,316,964,9488,5194,2.97919e+13,388.079,2647.16,14682,295,188,13272,12352,12085,11309,7483
37185,1449,1705,24012,13173,2.95587e+13,502.887,5363.42,37185,456,304,35480,35479,34985,34629,34234
20643,371,2175,13242,7401,2.71785e+13,291.393,4680.17,20643,701,157,17748,16253,12970,12176,6887
1575,511,1575,1181,394,3.50126e+13,0,1575,1575,201,8,0,0,0,0,0
40343,950,1259,25990,14353,2.87383e+13,519.873,4462.18,40343,437,275,39084,39081,37825,37564,36240
39082,1011,2741,27861,11221,4.0628e+13,865.554,8415.6,39082,829,292,35652,34118,31167,29126,23590
16465,1957,2800,12077,4388,6.60542e+13,681.56,5431.39,16465,764,242,13665,13211,10383,11379,11441
10465,201,1604,7375,3090,2.28591e+13,422.671,3316.82,10465,603,139,7268,5681,3774,2283,698
35035,579,2720,21036,13999,3.05211e+13,396.875,5583.99,35035,661,194,32315,31571,22103,10643,3285
43055,2411,2681,30339,12716,2.8436e+13,591.39,7636.13,43055,865,272,40374,40374,40319,40374,37501
81323,3555,4065,52136,29187,2.96303e+13,691.433,12073,81323,1252,379,77258,77258,77258,77258,73732
21696,692,1006,12674,9022,3.23192e+13,292.442,2540.51,21696,335,144,20690,20667,19211,19926,18336
55887,2297,3688,39858,16029,5.14482e+13,1465.85,11465.1,55887,1454,396,52199,49552,42873,44921,43676
15889,590,813,9295,6594,3.24104e+13,281.414,1985.44,15889,259,130,15076,15037,14206,14593,13424
56594,2450,3033,36907,19687,2.94774e+13,566.92,8662.17,56594,1144,257,53561,53461,53110,53393,47919
34205,616,1915,21066,13139,3.07557e+13,416.872,5107.59,34205,415,283,32198,31781,25261,15637,11796
15974,523,1458,11422,4552,2.99002e+13,466.464,4025.06,15974,502,171,14293,13546,9743,11098,4831
64951,622,2230,42020,22931,2.98367e+13,616.434,7468.24,64951,641,343,62487,60812,53101,52901,33686
89847,3984,4131,61674,28173,4.76841e+13,1310.05,13925.7,89847,1784,467,85716,85707,85326,83095,83006
14614,659,2492,10889,3725,6.05252e+13,888.598,5036.51,14614,673,186,11469,11054,6064,5828,2863
54912,470,3449,39154,15758,4.24106e+13,1107.73,10990,54912,1130,347,47889,45536,28611,21648,7515
5663,212,5663,4247,1416,3.49719e+13,0,5663,5663,712,8,0,0,0,0,0
70777,1685,2261,45668,25109,2.95958e+13,575.244,7812.12,70777,581,368,68516,68511,67165,66051,58197
80830,3965,4299,56532,24298,4.9408e+13,1361.66,14443.8,80830,1817,539,76531,76513,75838,74307,68396
80108,3791,4047,50971,29137,2.95241e+13,696.718,11886.8,80108,1180,395,76061,76061,76061,76061,74330
71311,537,3940,51313,19998,4.77115e+13,1661.84,13264,71311,1495,441,60963,57774,34883,32174,9640
65928,2976,4027,46482,19446,3.54978e+13,1065.91,12286,65928,1084,395,61901,61773,58958,58674,54562
39646,1806,2075,25070,14576,3.04494e+13,511.444,5875.9,39646,458,334,37571,37571,36944,37210,35508
43586,3567,3619,29880,13706,5.04021e+13,785.995,8966.71,43586,984,421,39967,39922,39911,39881,39870
1023,318,362,691,332,3.2065e+13,75.6149,530.484,1023,120,48,661,661,661,661,646
43495,2718,3067,29130,14365,4.13515e+13,671.765,7816.68,43495,863,340,40428,40428,39412,37961,33841
39851,653,1234,25734,14117,2.92129e+13,534.285,4425.71,39851,461,273,38617,38209,34988,34927,30127
44339,527,2944,31985,12354,5.20047e+13,1318.44,9559.18,44339,1164,339,37332,35217,24539,22479,12985
53222,936,1507,34352,18870,2.96668e+13,547.526,5359.74,53222,533,316,51715,51688,48601,48251,45978
32814,882,2177,23695,9119,2.99898e+13,566.235,6299.01,32814,591,213,30637,30031,25420,27378,14638
96510,2338,3499,62870,33640,3.37488e+13,844.552,10938.3,96510,738,424,93011,92753,90223,87512,74490
59955,3417,3598,41315,18640,3.07535e+13,790.748,10560,59955,1039,285,56357,56357,56357,56357,55467
77449,2001,2733,49870,27579,2.96025e+13,606.124,8868.84,77449,649,396,74716,74697,73006,72077,70031
62615,2851,3345,39229,23386,2.89433e+13,555.014,9233.73,62615,964,312,59270,59270,59270,59270,57540
24284,332,1932,17504,6780,2.76918e+13,544.488,5253.7,24284,563,175,21864,21023,14507,13237,5661
19590,666,1540,14220,5370,3.00285e+13,233.745,4221.36,19590,404,156,18050,18014,16962,17562,11480
29246,325,1105,18789,10457,2.95177e+13,529.686,3759.81,29246,393,249,26732,24652,23581,22575,12450
40752,1945,2685,25439,15313,2.89558e+13,345.338,6531.74,40752,993,177,38067,38067,37722,37443,34891
13236,77,799,8529,4707,2.95808e+13,416.183,2365.45,13236,300,180,10193,7960,7561,7095,2470
80287,3338,4180,55499,24788,4.95792e+13,1361.83,13604.2,80287,1761,496,76107,75924,71523,47604,54977
4952,187,463,3598,1354,3.24125e+13,178.885,1293.15,4952,193,93,4414,4098,3318,3846,1765
83204,11361,45522,72892,10312,8.62794e+11,20.3658,46135.9,83204,3330,51,37682,37670,13368,12712,11140
14326,1045,1204,10149,4177,2.59508e+13,524.447,3499.79,14326,677,128,13122,12866,12956,13074,12071
60689,1127,3574,38072,22617,3.09052e+13,564.122,9572.02,60689,990,331,57115,56723,47015,37522,26592
80786,529,4322,57716,23070,4.20503e+13,1507.79,14425.9,80786,1432,449,70306,65361,39851,21559,7102
21918,945,1588,15819,6099,3.02533e+13,433.695,4662.53,21918,453,187,20330,20089,17339,18538,12974
23195,428,1598,16892,6303,2.97229e+13,446.472,4792.59,23195,457,194,21265,20629,13480,12016,7562
52019,2592,3883,36964,15055,5.66779e+13,1287.04,10810.1,52019,1369,463,48136,47108,41436,30269,34224
22953,1559,1562,16538,6415,2.85624e+13,638.251,4814.58,22953,689,199,21391,21391,21390,21388,21388
82144,2169,3573,51561,30583,3.02719e+13,896.232,10631.5,82144,740,447,78571,78218,72301,74162,63756
41214,39,1771,26526,14688,2.95512e+13,549.13,5725.38,41214,533,326,25661,13553,17786,9595,2123
59833,226,3458,42991,16842,4.83161e+13,1435.47,11620.7,59833,1310,373,48441,43020,26536,17732,6949
56578,2374,2420,35129,21449,3.12251e+13,592.077,7159.19,56578,468,366,54158,54158,54144,54158,53997
82572,6099,8265,70203,12369,4.216e+13,18.4002,9377.9,82572,4135,4130,74307,74307,61341,68898,67828
59823,2750,3646,38255,21568,2.9467e+13,511.296,9846.26,59823,1227,267,56177,56177,56145,56121,47447
66840,1464,3554,48082,18758,4.65025e+13,1677.71,12427.9,66840,1476,378,61620,57587,49510,46800,33427
56223,450,3421,36329,19894,2.93326e+13,565.309,9049.54,56223,1186,247,51460,48824,32399,19902,5169
64519,1581,3824,46265,18254,5.06738e+13,1399.4,12436.1,64519,1464,477,59592,55711,46420,43826,37467
23480,599,1620,14028,9452,3.16818e+13,277.244,3636.03,23480,343,171,21860,21786,15536,6293,4064
17417,112,2457,12579,4838,5.82841e+13,885.533,5321.21,17417,757,184,12106,8952,5619,3919,1375
49846,1832,2637,32990,16856,3.84595e+13,745.073,7157.22,49846,689,324,47209,46887,43696,13029,16532
94620,649,3714,62028,32592,3.44577e+13,1181.9,11546.7,94620,857,407,89794,87758,69984,8049,7501
63946,555,3813,46041,17905,5.256e+13,1414.13,12384.6,63946,1464,507,54232,51414,34819,31692,17073
23725,422,1000,13861,9864,3.2057e+13,301.126,2602,23725,333,154,22725,22434,18179,16575,15935
9609,1481,1974,6589,3020,5.69895e+13,368.645,3662.36,9609,499,148,7635,7558,7459,7500,5667
10100,628,676,6483,3617,3.00828e+13,355.29,1907.11,10100,228,168,9424,9424,9387,9386,9312
72000,3540,3627,51635,20365,4.12514e+13,1245.85,12779.7,72000,1349,391,68373,68373,68354,68325,68066
81064,497,3986,51372,29692,2.94884e+13,764.634,11682.9,81064,1084,405,75772,71954,56281,39121,19629
1701,132,662,1217,484,7.38e+13,60.1364,930.508,1701,152,83,1039,875,641,730,429
15467,1165,1378,9509,5958,3.13093e+13,226.427,3123.31,15467,269,183,14089,14083,13586,13764,12162
29569,704,1109,18997,10572,2.89951e+13,557.191,3769.98,29569,447,234,28460,28058,26811,25443,25645
82720,1425,4468,54897,27823,2.93379e+13,873.737,13032.1,82720,1247,353,78228,77014,65747,62863,33654
96791,2186,4244,63652,33139,2.98009e+13,822.29,13706.9,96791,1261,429,92547,92197,89787,89838,58366
1507,333,455,1112,395,9.19798e+13,76.7565,645.493,1507,55,86,1052,1014,923,961,908
3970,516,1642,3225,745,1.76852e+12,81.5395,1961.01,3970,427,55,2328,2325,772,2235,894
70035,2199,3686,47360,22675,4.28661e+13,1113.27,10951.2,70035,1211,431,66349,64263,54462,21629,34028
32829,468,1762,20743,12086,2.96326e+13,550.809,4980.22,32829,407,303,30566,29772,25367,21189,8748
93801,667,4293,65467,28334,4.65631e+13,1334.67,15344.7,93801,1809,546,83823,80705,58984,34048,22142
59895,1799,2093,38594,21301,2.92914e+13,549.888,7082.38,59895,515,352,57802,57802,57227,56868,56301
97908,1714,3513,64225,33683,3.43553e+13,1092.82,11215.3,97908,787,399,94395,93488,81392,15438,23202
60363,1602,3684,38080,22283,2.98766e+13,554.621,9802.04,60363,1157,311,56679,56545,51818,52300,37806
55296,673,2708,36666,18630,3.79345e+13,782.777,7475.3,55296,660,315,52258,51595,39069,6602,5412
74449,400,2791,46680,27769,3.01159e+13,659.96,9019.61,74449,584,431,69946,65903,54910,41752,19389
62756,189,4031,44152,18604,5.47861e+13,1310.59,12125.6,62756,1619,460,49117,43880,29048,13726,4579
45516,763,3000,32473,13043,4.39324e+13,1059.78,9570.3,45516,997,329,40557,38971,31978,31315,18256
11286,1022,1193,8040,3246,2.77015e+13,523.084,3110.04,11286,614,117,10093,9835,9936,10061,9350
91653,3266,4368,65336,26317,4.70432e+13,1678.69,15915.4,91653,1880,571,87285,86803,80535,73009,75478
48845,2006,3373,34854,13991,5.24369e+13,1359.59,10414.1,48845,1300,343,45223,42598,36162,37982,33758
20207,97,7135,16488,3719,1.72758e+13,123.855,8790.12,20207,562,128,11817,8736,1848,907,2507
16742,154,1443,10162,6580,3.14696e+13,239.932,3177.81,16742,273,194,14751,13373,10434,4166,1565
13320,466,1215,9703,3617,3.01579e+13,205.261,3103.48,13320,315,139,12105,12068,11420,11865,7710
40003,1370,2745,26918,13085,2.82479e+13,502.614,7403.28,40003,949,249,37258,37139,34676,31842,17423
44957,1646,2039,29409,15548,3.47101e+13,521.47,5817.23,44957,506,298,42918,42918,41969,41526,39177
88526,1752,3977,63719,24807,4.57407e+13,1690.39,14836.1,88526,1636,574,83304,79111,68017,65190,52307
2557,188,536,1656,901,3.10433e+13,101.094,963.157,2557,145,89,2006,1892,1804,1646,1214
11039,635,846,7149,3890,3.10318e+13,409.18,2268.45,11039,311,166,10193,10147,9803,9555,9378
62982,3004,3836,43937,19045,3.16792e+13,1019.68,11576.9,62982,1076,340,59146,59038,58987,58024,53946
30753,96,447,20800,9953,3.3441e+13,287.35,2867.15,30753,284,201,20770,8758,13543,10421,8198
27203,69,1622,19623,7580,2.76614e+13,627.548,5236.48,27203,748,207,16618,10142,7599,3557,2624
59543,1505,2173,38359,21184,2.96679e+13,590.772,7180.99,59543,594,347,57370,57366,56201,54537,47776
20021,1738,2657,14188,5833,5.72568e+13,841.172,5882.02,20021,764,232,17364,16609,13432,13916,12656
60769,593,637,41253,19516,3.37029e+13,305.24,4193.69,60769,305,257,60132,60132,60060,59891,59753
2019,103,266,1294,725,2.62072e+13,93.4903,569.825,2019,99,54,1741,1546,1505,1531,1139
41167,88,2914,29411,11756,4.44496e+13,1029.19,9009.62,41167,938,317,30142,23727,15947,9854,3361
15480,1163,1568,13155,2325,4.22537e+13,16.977,2035.42,15480,787,782,13912,13912,11517,12908,12506
56345,2979,4112,39977,16368,5.77476e+13,1384.97,11744.5,56345,1594,466,52233,52095,46770,40241,42033
5447,1549,2058,4446,1001,1.71267e+13,110.202,2613.35,5447,230,80,3389,3389,2822,3135,3132
91997,1852,4413,60731,31266,2.91957e+13,963.984,13658.4,91997,1254,405,87584,86981,83235,81145,47113
84742,3200,3961,55631,29111,3.65396e+13,1156.09,11456,84742,1048,443,80781,80706,78248,74606,65188
48455,490,3058,30891,17564,3.14288e+13,551.241,7924.62,48455,973,233,44427,42614,31430,21284,19263
50304,2234,3102,34872,15432,2.85393e+13,618.613,8587.73,50304,926,278,47202,47176,46628,46962,39368
98759,2026,4666,70078,28681,4.49492e+13,1743.85,16448.3,98759,1766,642,93303,89023,76192,73313,49465
18985,699,850,12314,6671,2.93259e+13,420.338,2784.86,18985,332,208,18135,18125,17771,17671,17471
6602,391,509,3854,2748,3.21502e+13,180.065,1116.21,6602,121,100,6093,6079,5895,5981,5557
30295,516,2366,21232,9063,2.69595e+13,566.576,6337.13,30295,839,241,26985,24717,16678,9583,4719
7860,199,667,5090,2770,2.90424e+13,308.073,1701.43,7860,234,143,6755,6364,5994,5679,3841
91181,2408,9121,77527,13654,4.21474e+13,17.034,10290.6,91181,4563,4558,82060,82060,41817,65286,60527
11982,218,736,6990,4992,3.16263e+13,230.471,1720.95,11982,176,133,11141,10251,8387,5847,4324
17183,631,2664,12423,4760,5.91919e+13,899.495,5429.39,17183,788,164,13866,13172,7294,7124,5072
6837,159,1541,4688,2149,4.64432e+13,310.643,2751.83,6837,444,141,4706,4062,3181,2429,655
99517,2068,3540,62780,36737,2.95738e+13,1059.1,11688.5,99517,749,468,95977,95314,88033,76042,74863
24781,224,2682,17496,7285,5.84917e+13,1060.19,6693.06,24781,1061,233,18890,16871,11096,9855,2917
60496,3264,3837,42668,17828,5.42011e+13,1311.87,11517.9,60496,1472,452,56659,56534,55168,40596,43804
79153,1613,4315,56900,22253,4.97566e+13,1671.25,14562.3,79153,1668,566,73284,68994,55912,51191,38817
68919,2963,3416,45968,22951,2.90542e+13,723.828,10191.9,68919,1149,280,65503,65364,65475,65503,63370
22231,651,1205,14338,7893,2.94316e+13,464.408,3458.34,22231,364,223,21026,20878,19678,19266,18390
63667,478,2679,39732,23935,3.0585e+13,620.912,8211.52,63667,554,414,60227,58144,46817,33801,16795
51109,1935,3357,36634,14475,3.82944e+13,917.554,10267.7,51109,952,330,47752,47388,44276,42776,38161
57970,1819,3604,40642,17328,3.16757e+13,926.191,10866.4,57970,1000,300,54366,53919,52278,52504,33964
53809,583,3885,38171,15638,5.58472e+13,1348.81,11077.6,53809,1483,463,45682,43320,25946,15646,12355
71318,1227,2648,45776,25542,2.96526e+13,607.538,8538.84,71318,664,397,68670,68577,63973,59898,47782
71440,655,2775,44882,26558,3.06952e+13,658.547,8882.79,71440,549,434,68344,67165,54688,42661,29058
4692,105,620,3014,1678,3.09228e+13,170.204,1242.41,4692,175,88,3855,3175,3137,3106,1859
30093,1207,2794,21547,8546,5.745e+13,1341.59,7598.49,30093,1119,245,26329,24853,19362,17704,14788
90360,480,4019,60576,29784,4.03545e+13,1328.92,12743.5,90360,1289,435,82210,76279,60230,12090,9826
13838,213,953,8904,4934,2.88225e+13,361.017,2555.74,13838,288,195,12154,11235,10457,9420,5314
73652,857,2405,47487,26165,2.92088e+13,604.17,8054.52,73652,679,361,71247,70742,63688,64114,49722
94729,1977,3945,64538,30191,4.45158e+13,1277.49,13207.8,94729,1401,487,90350,86850,71254,29497,44068
54802,709,3103,33787,21015,3.07628e+13,572.894,7711.53,54802,653,317,51546,50865,40457,24698,24573
25604,1182,1786,17066,8538,4.15038e+13,448.012,4476.7,25604,433,227,23818,23809,22393,20944,13095
3752,115,404,2753,999,3.13346e+13,157.571,1072.75,3752,172,84,3139,2859,2024,1281,1146
10833,1855,3894,8842,1991,1.7429e+13,118.18,4874.14,10833,351,102,6939,6939,4269,4638,4825
53485,2329,3030,36184,17301,2.92674e+13,558.081,8674.75,53485,1005,273,50455,50418,49755,50175,41639
15252,2259,2658,11142,4110,6.21365e+13,706.592,5112.97,15252,694,162,12594,12174,12560,12592,11753
2950,9,540,1914,1036,3.06285e+13,111.198,1018.43,2950,129,88,927,366,321,210,154
32781,923,1652,21057,11724,2.9443e+13,469.709,4929.61,32781,417,285,31129,31057,29853,30057,26676
32509,3745,13572,26751,5758,2.2362e+13,1298.99,18771,32509,3257,15,18937,15956,16339,17629,8228
69312,3574,3709,44954,24358,2.94791e+13,604.17,10818.9,69312,1231,336,65603,65603,65603,65603,64559
47928,79,3003,34114,13814,4.35777e+13,1113.65,9828.89,47928,1098,322,34300,26626,18067,11837,2882
35018,68,2572,22427,12591,2.87742e+13,385.747,6398.71,35018,970,183,24400,18292,14031,4441,2973
63068,413,2254,40658,22410,2.93979e+13,574.164,7349.79,63068,607,340,59082,54537,50364,48654,25715
72996,354,3859,52463,20533,4.62711e+13,1654.65,13348.8,72996,1553,391,60864,57107,33333,27994,8254
33108,1193,2666,23391,9717,3.85634e+13,806.088,7642.55,33108,820,273,30129,29020,27603,25748,21939
18358,264,931,11851,6507,2.94536e+13,460.078,2883.66,18358,378,200,16360,15104,14397,13828,9053
49494,302,3017,35739,13755,5.01894e+13,1288.93,10151.8,49494,1169,351,40777,37724,25338,24018,9214
13808,141,877,8888,4920,2.92727e+13,393.822,2463.95,13808,306,195,11590,10899,9357,8495,3155
60570,2644,6075,51484,9086,4.2222e+13,16.9948,7016.32,60570,3041,3036,54495,54495,33933,45923,44220
36035,214,1183,23205,12830,3.0174e+13,558.302,4211.07,36035,461,266,31731,29620,27232,24663,13631
65892,1222,3608,43306,22586,2.97163e+13,675.708,10188.4,65892,1199,277,62273,61508,49792,46895,26942
74792,2799,3909,48388,26404,2.93002e+13,638.122,11505.1,74792,1245,365,70883,70814,70609,70713,57909
87277,1450,3861,59439,27838,4.51061e+13,1185.56,12453.4,87277,1411,471,82334,79817,63423,22447,32830
21885,2814,2878,15159,6726,5.06848e+13,409.808,5779.86,21885,700,322,19007,19007,18977,18850,18858
20194,173,2207,13891,6303,3.86595e+13,650.707,5495.45,20194,682,192,15344,13407,10276,10293,3246
22086,1434,1485,14241,7845,2.99241e+13,507.792,3993.09,22086,394,249,20601,20601,20585,20564,20508
7796,334,610,5651,2145,3.23995e+13,195.502,1826.88,7796,229,109,7186,7175,6798,7039,4439
3520,117,432,2050,1470,3.11311e+13,94.7472,803.088,3520,72,78,3063,2829,2423,2156,1101
74552,1162,2400,48131,26421,2.98681e+13,581.068,8081.37,74552,643,359,72152,72130,67466,66872,56759
80934,386,4299,57032,23902,3.89801e+13,1312.83,14206.9,80934,1410,431,69512,65006,41901,20282,8876
66145,2589,3739,45744,20401,5.02954e+13,1157.35,11302.6,66145,1352,463,62406,61567,53898,29903,39634
49648,559,2008,32006,17642,2.92028e+13,569.444,6499.94,49648,589,326,47353,45170,40867,39706,25328
6995,465,590,4084,2911,3.18125e+13,187.35,1248.92,6995,115,103,6405,6379,6237,6285,5739
10187,91,1204,6461,3726,2.98769e+13,202.818,2532.49,10187,257,157,8367,7504,6504,4107,1983
6337,301,647,4076,2261,2.84276e+13,268.74,1553.81,6337,196,142,5543,5161,5027,4897,3627
41423,250,1816,26710,14713,2.95752e+13,546.951,5720.95,41423,481,304,37052,34432,31641,29365,13977
22361,32,1596,13439,8922,3.18715e+13,265.109,3651.83,22361,320,201,16637,14085,10188,2324,781
86689,1553,4181,59627,27062,4.71957e+13,1341.06,14082.8,86689,1803,514,81194,76985,60999,32465,31573
72384,307,671,49080,23304,3.35468e+13,302.712,4576.39,72384,308,264,71627,69768,50707,49771,44247
67949,834,2664,42467,25482,3.03437e+13,632.292,8505.78,67949,559,423,65137,64548,52825,40169,29708
36303,242,1243,23387,12916,2.95562e+13,518.345,4282.63,36303,410,279,32385,29810,27502,27092,9742
41156,79,1932,25629,15527,3.07792e+13,433.164,5589.83,41156,429,285,33820,28311,24723,14516,4357
69556,2726,4104,48386,21170,5.06199e+13,1286.13,12437.4,69556,1488,480,65452,65207,57950,38697,45215
39602,784,2516,28192,11410,2.82505e+13,608.168,7196.03,39602,838,265,36820,36011,23046,15147,6627
78346,415,3899,51758,26588,2.97336e+13,694.546,11671.5,78346,1234,348,72407,69068,46806,25983,9211
4922,362,669,3156,1766,3.03672e+13,274.663,1408.2,4922,246,136,4253,3998,3888,3674,2697
84136,1957,4294,59991,24145,4.86429e+13,1624.3,15043.5,84136,1739,565,79011,74923,62126,52096,44247
2710,29,344,1989,721,3.03427e+13,131.364,843.133,2710,158,76,1495,477,696,316,257
60494,3140,3656,42210,18284,3.16656e+13,944.509,11153.4,60494,1025,305,56838,56772,56838,56838,53313
57866,2223,3584,40039,17827,3.07106e+13,787.739,10365,57866,1038,285,54282,54221,53238,53795,40605
36894,970,2956,26576,10318,5.7205e+13,1406.1,8647.94,36894,1160,334,31863,29816,20626,19322,13382
52527,2463,3129,34880,17647,3.78821e+13,711.252,7941.22,52527,787,335,49398,49351,46691,37045,23427
90881,3150,3282,59255,31626,3.4178e+13,743.582,10187.4,90881,708,383,87599,87599,87435,87390,87302
72963,2824,3727,52440,20523,4.54204e+13,1632.39,13193.6,72963,1552,380,69236,68894,61848,63223,61101
84267,603,4206,60216,24051,4.22598e+13,1583.59,14571.7,84267,1596,428,73985,69305,41484,23326,8183
35631,186,2865,25424,10207,4.59148e+13,939.853,8353.76,35631,866,318,28318,25307,17057,16566,5466
29843,8708,13329,24329,5514,2.58604e+13,1983.6,17921.8,29843,3337,13,16514,15818,15617,15776,14652
11166,962,2298,8248,2918,6.94324e+13,279.628,4028.48,11166,447,309,8868,8826,4279,4276,3442
81933,3768,3935,53879,28054,3.62207e+13,1053.42,11296.2,81933,964,401,77998,77998,77857,77804,75280
97029,22761,40100,77629,19400,110649000,1116.37,59283,97029,9736,11,56929,56929,49532,56929,32223
81665,997,4227,55162,26503,3.34553e+13,1087.1,13369.7,81665,1269,378,76227,73780,60681,45205,26142
31854,843,2319,22956,8898,2.86362e+13,636.056,6489.08,31854,647,199,29535,28747,22628,25621,12950
23707,4270,12314,19207,4500,3.06646e+13,981.368,15443.9,23707,2739,15,11393,9756,9985,10085,5467
48305,3040,3362,34410,13895,5.30837e+13,1433.19,10330.9,48305,1356,340,44943,44941,44943,44943,44081
41876,1021,1230,27113,14763,2.99174e+13,544.498,4470.27,41876,462,273,40646,40634,40004,39819,39653
55256,432,3648,37179,18077,4.45889e+13,801.544,9566.94,55256,1011,420,49370,45790,35746,8362,6429
15091,514,850,9743,5348,3.02063e+13,445.336,2562.82,15091,354,185,14163,13224,13157,12434,10039
82266,686,2880,51355,30911,3.03254e+13,682.337,9541.76,82266,600,447,79033,78029,62970,46602,34001
40359,1033,2072,24617,15742,3.14121e+13,456.038,5640.37,40359,419,292,38287,38216,31151,24190,17168
33241,2728,2866,23611,9630,4.77287e+13,1077.93,8130.83,33241,958,302,30375,30289,30277,30242,29990
18470,1269,1891,13055,5415,3.76134e+13,484.043,4744.17,18470,609,148,16579,16066,16087,15944,14801
24568,262,3113,18030,6538,6.54513e+13,1165.22,6913.81,24568,850,397,18590,16327,7696,6210,3209
18642,685,1507,13466,5176,2.98961e+13,479.539,4356.01,18642,505,179,17053,16282,13871,13642,7599
96180,322,4107,61250,34930,2.95511e+13,835.733,13029.7,96180,1192,442,87537,81343,65190,43940,21876
50925,2433,3489,33851,17074,4.0381e+13,729.323,8890.57,50925,982,409,47436,47229,41645,15571,18790
32398,306,1748,20908,11490,2.93741e+13,516.712,5186.83,32398,452,285,29257,26940,24894,22766,10496
49242,266,557,33431,15811,3.36518e+13,300.305,3720.7,49242,299,243,48147,45714,33977,33948,33028
26581,129,1270,15588,10993,3.18461e+13,308.231,3072.24,26581,389,168,23832,21268,15906,4113,1326
59366,2281,3636,37454,21912,2.93948e+13,532.325,9641.48,59366,1163,305,55730,55709,55433,55693,43294
75669,2279,3938,52243,23426,4.79379e+13,1255.86,12443.5,75669,1467,467,71731,68622,59188,33054,40624
64480,1238,3565,46138,18342,3.93706e+13,1181.02,11964.7,64480,1289,363,60009,57263,51244,50038,31375
86998,4024,4313,62199,24799,4.74801e+13,1703.76,15319.3,86998,1771,564,82685,82685,82596,82135,81043
27602,994,1064,17717,9885,2.82624e+13,498.787,3568.33,27602,416,241,26538,26536,26429,26418,26354
95137,437,4315,61865,33272,2.95825e+13,855.161,13813,95137,1261,445,87932,83112,61590,43746,16343
54858,955,3320,37557,17301,2.87472e+13,641.445,9157.15,54858,980,280,51329,50380,40766,30509,15701
53227,3029,3768,37534,15693,5.56509e+13,1153.96,10610.8,53227,1339,464,49459,49284,46143,32054,35724
71543,3221,3702,51485,20058,4.43549e+13,1443.09,13023.5,71543,1378,401,67841,67706,65414,64033,64506
2564,482,614,1872,692,8.13245e+12,339.994,1089.82,2564,223,55,1844,1389,1620,1801,1818
42987,605,1304,27761,15226,3.01461e+13,557.478,4678.53,42987,463,287,41659,40386,36513,34798,31305
79258,2999,4376,54694,24564,3.6788e+13,1223.11,13864.5,79258,1250,418,74882,74588,70350,69594,63488
1661,178,242,1061,600,2.37223e+13,79.6653,505.561,1661,82,54,1419,1417,1405,1401,1301
76200,2140,2733,47686,28514,3.03708e+13,659.579,9054.52,76200,546,432,73467,73379,68522,70266,62963
30415,2860,2961,22159,8256,6.23693e+13,1337.46,7544.52,30415,1006,275,27454,27454,27454,27454,27130
64308,3079,3670,43079,21229,4.25342e+13,918.273,10097.2,64308,1029,425,60638,60537,57968,47414,34234
84788,4064,4322,60446,24342,4.81013e+13,1421.51,15036.2,84788,1772,556,80466,80453,80127,79337,76270
85047,1380,2440,54728,30319,2.93443e+13,601.734,8553.24,85047,649,377,82607,82597,79467,78435,66914
58095,756,1545,37481,20614,2.9729e+13,597.102,5619.32,58095,520,320,56550,56189,50529,51562,45439
50654,3382,3724,35071,15583,5.08129e+13,1117.24,10163.3,50654,1306,455,46930,46798,46115,41987,36914
6667,1035,1311,4709,1958,6.6089e+13,149.855,2301.25,6667,213,145,5356,5347,5284,4919,3889
75399,3029,3927,52218,23181,4.86171e+13,1308.72,12372.7,75399,1422,471,71472,71213,65954,38346,47282
23648,11351,12306,19156,4492,3.07411e+13,922.434,15421.8,23648,2883,15,11342,11271,11342,11342,9438
68392,2279,2660,43670,24722,3.0286e+13,585.547,8540.02,68392,586,416,65732,65710,64299,64657,61666
55064,727,2064,35539,19525,2.952e+13,560.714,6681.35,55064,531,333,53000,52419,46625,46718,36236
70608,1681,4143,49238,21370,5.20805e+13,1409.64,13112.2,70608,1759,509,65513,61328,47309,31607,29980
92334,1997,4151,58731,33603,2.93886e+13,810.523,12772,92334,1191,435,88183,87817,80651,80716,58710
69898,3574,3882,43884,26014,2.96666e+13,653.116,10446.6,69898,1036,371,66016,66016,66016,66016,65607
37027,2674,2889,26223,10804,4.54574e+13,1067.99,8574.85,37027,958,318,34138,34034,33779,33719,33522
76554,1796,3800,51952,24602,4.39774e+13,1173.33,11660.2,76554,1333,467,72277,69749,55591,22319,30093
42102,643,2834,27917,14185,2.83452e+13,491.247,7572.4,42102,990,236,38868,37684,28657,21262,14375
14267,873,978,9257,5010,3.04021e+13,380.557,2633.18,14267,327,171,13289,13278,13208,13265,13227
85418,3569,4202,58882,26536,4.7748e+13,1341.25,14102.6,85418,1807,531,81216,81131,78999,53243,59976
37766,433,1753,24410,13356,2.99314e+13,497.861,5215.79,37766,448,278,35293,32796,30662,29351,18871
66432,1600,2255,42742,23690,2.96166e+13,572.599,7657.23,66432,642,350,64177,64177,62778,61091,53085
68559,1248,3515,45276,23283,3.7668e+13,830.305,9724.58,68559,913,355,65044,64243,51828,10223,11176
48498,542,557,32919,15579,3.36165e+13,301.31,3696.28,48498,298,243,47941,47941,47941,47917,47908
69572,665,3782,45741,23831,2.96336e+13,671.487,10845.5,69572,1223,317,65104,63652,42803,24482,7743
41859,719,3188,25811,16048,2.96481e+13,395.835,7076.22,41859,980,192,38671,38456,27222,17058,8698
47822,1398,2924,32590,15232,2.88494e+13,535.554,8172.28,47822,958,265,44898,44641,41678,37360,18897
15557,887,1723,10131,5426,2.40984e+13,299.676,3760.27,15557,586,150,13834,13823,12277,12750,7831
95325,3141,3961,64815,30510,4.37311e+13,1292.9,13152.6,95325,1386,482,91364,90998,85741,39699,57371
1562,98,326,1115,447,2.40625e+13,146.651,678.001,1562,196,51,887,391,559,615,665
44279,12972,18998,35426,8853,103701000,914.726,27632.7,44279,4446,11,25281,25281,23547,25281,17531
86781,1076,4443,59254,27527,3.66205e+13,1225.56,14356.9,86781,1281,419,80766,77772,61888,49851,27542
27464,1064,1074,17728,9736,2.95369e+13,537.041,3615.32,27464,405,242,26390,26390,26388,26390,26380
88501,2813,4341,63409,25092,4.8224e+13,1713.96,15561.7,88501,1818,564,84134,83458,69776,68741,66963
46627,219,3584,32453,14174,5.09366e+13,1042.28,9603.13,46627,1165,429,37741,33673,23001,7548,4573
37090,778,2467,26417,10673,2.78411e+13,606.197,6952.18,37090,833,254,34351,33578,21341,14352,5972
7208,184,1437,4797,2411,5.8131e+13,240.69,2686.24,7208,511,108,5487,5059,3850,4361,1336
43090,259,3403,26644,16446,3.15082e+13,435.686,7710.6,43090,937,224,38309,35968,24792,7323,3019
17068,1745,1882,12065,5003,3.6224e+13,459.747,4601.48,17068,606,142,15186,15076,15186,15169,14956
71900,831,4138,49786,22114,5.16395e+13,1321.79,13038.9,71900,1745,459,64153,61491,43132,22758,15483
78768,2214,3962,50679,28089,2.94178e+13,627.64,11665.1,78768,1248,351,74806,74757,74189,74653,54750
13812,663,842,8920,4892,2.95896e+13,402.99,2397.27,13812,321,177,12970,12867,12548,12307,12059
88917,2669,2889,57146,31771,2.94976e+13,672.273,9618.69,88917,732,428,86028,85980,85710,85809,84856
90138,482,4284,57953,32185,2.91674e+13,794.806,13150.9,90138,1247,410,83918,80052,60186,41023,16852
57693,616,2523,35837,21856,3.07268e+13,599.16,7405.34,57693,482,380,54817,53828,42146,28514,15620
42403,999,3722,30205,12198,5.90303e+13,1187.01,9686.79,42403,1240,466,37005,35155,23715,14705,14922
21886,202,953,14073,7813,2.86086e+13,472.969,3097.51,21886,412,213,19280,18214,16580,14721,8554
61661,1065,2081,39886,21775,2.97899e+13,565.998,7136.2,61661,544,353,59580,59532,56180,55066,43696
67604,1158,3208,44666,22938,3.70135e+13,798.658,9180.12,67604,842,357,64396,63687,51197,9889,11259
72566,171,4186,52041,20525,5.17259e+13,1410.53,13784.2,72566,1653,535,56239,49554,30625,24941,7317
66437,2331,3454,41454,24983,2.9462e+13,680.679,9484.08,66437,909,379,62983,62925,62238,62474,56474
18625,923,2827,13112,5513,5.56503e+13,373.141,5564.31,18625,664,314,15798,15589,9574,4874,3989
87656,701,2892,56340,31316,2.98043e+13,677.149,9652,87656,720,420,84546,83377,71406,68048,47983
29588,2171,2790,21592,7996,6.16258e+13,1263.29,7413.93,29588,966,274,26798,25100,21322,22115,22350
14166,1140,1426,10089,4077,3.02278e+13,464.328,3748.3,14166,498,154,12740,12665,12547,12666,11434
88849,618,2859,57085,31764,2.97038e+13,670.343,9576.44,88849,719,427,85619,83707,72486,68107,44399
26903,817,12771,21946,4957,2.70217e+13,1009.19,16652.1,26903,3270,15,13248,11760,11700,9808,2700
87286,442,2897,54575,32711,3.00571e+13,703.935,9829.46,87286,582,449,82785,78605,64825,48583,23291
8186,196,1119,5594,2592,4.87553e+13,246.871,2328.55,8186,244,152,6762,6341,4829,1407,1008
10679,651,812,6817,3862,2.83214e+13,372.496,2139.58,10679,310,159,9867,9806,9577,9508,9379
77518,839,2742,49038,28480,2.99381e+13,645.791,9101.9,77518,594,430,74693,74115,63314,53906,40394
65932,545,2183,42439,23493,2.92199e+13,575.945,7482.86,65932,560,367,63314,59997,54287,52521,32671
66082,1943,3750,42524,23558,2.92516e+13,544.5,10513.7,66082,1229,316,62332,62291,61447,62099,40618
16723,1514,1820,11800,4923,3.05856e+13,407.822,4317.18,16723,701,143,14903,14748,14892,14901,14542
88429,1682,4470,63019,25410,4.23233e+13,1675.04,15272,88429,1673,452,82683,78659,68520,66558,39979
3211,328,618,2244,967,1.45594e+13,380.861,1232.71,3211,400,60,2238,1606,1689,2126,2040
69945,1336,3898,49974,19971,3.7678e+13,1250.22,12738.5,69945,1313,401,65151,62362,53864,51925,32637
39294,1840,3031,26319,12975,4.1098e+13,615.091,7191.26,39294,801,323,36263,35968,30381,9804,11215
41148,3177,3487,29876,11272,6.20633e+13,1487.91,9325.29,41148,1175,436,37661,37653,36331,36859,36284
4263,368,1055,2872,1391,6.79402e+13,190.194,1794.06,4263,382,63,3208,2975,2680,2595,926
16687,2438,2553,12447,4240,6.26539e+13,977.328,5425.92,16687,722,218,14134,13654,14022,14038,13921
19462,791,898,12556,6906,2.8571e+13,457.161,2891.41,19462,337,215,18564,18538,18339,18313,18249
18123,1638,2760,13168,4955,7.03692e+13,712.784,5547.05,18123,665,402,15363,14783,9827,10603,11115
40291,1317,2934,28857,11434,4.899e+13,1310.52,9106.06,40291,1146,333,36377,34085,29019,26780,21773
4885,392,2000,3961,924,1.72144e+12,77.3355,2363.35,4885,440,60,2885,2712,580,2722,796
54123,756,3413,37763,16360,3.05234e+13,813.814,9903.16,54123,1003,282,49819,48389,32443,21242,8631
40476,1458,3357,27388,13088,4.54786e+13,694.882,8232.85,40476,944,410,37119,36261,28322,10302,12116
87248,3593,4495,57886,29362,3.07348e+13,881.937,13629.1,87248,1328,356,82753,82753,82753,82753,75917
21987,569,1337,14170,7817,2.92011e+13,486.536,3588.51,21987,421,216,20611,19780,18756,17482,16944
50667,457,576,34372,16295,3.36586e+13,303.003,3793.56,50667,300,247,50091,50091,46641,47529,46611
5699,444,684,3689,2010,3.05729e+13,270.207,1534.64,5699,225,137,5015,4743,4748,4545,3684
97007,1570,4065,61705,35302,2.96385e+13,881.917,12933.8,97007,1167,445,92942,92339,82407,60736,57357
30387,823,1823,18187,12200,3.14897e+13,323.146,4372.3,30387,392,236,28564,28491,21503,14969,9137
18143,2211,2452,12866,5277,5.92186e+13,693.789,5541.33,18143,810,218,15691,15491,15029,15102,15025
85880,2283,2901,53821,32059,3.01613e+13,738.941,9830.93,85880,629,451,82979,82839,77737,78868,71365
41584,1881,2739,28293,13291,2.83432e+13,520.625,7555.53,41584,942,257,38845,38844,37892,38526,30769
34631,2357,2545,21409,13222,2.92955e+13,325.751,5789.52,34631,889,163,32086,32086,32082,32086,32006
39523,1754,1826,25586,13937,3.02031e+13,522.609,5683.59,39523,491,319,37697,37697,37628,37563,37614
90518,327,4429,63079,27439,3.97288e+13,1345.84,15067,90518,1446,440,77670,72091,46192,23175,11398
94798,3890,4315,67360,27438,4.66835e+13,1663.93,16109,94798,1843,574,90483,90423,89833,80831,82865
9379,111,775,5999,3380,2.91711e+13,366.054,1997.96,9379,312,157,7612,6971,5992,5226,2598
47069,277,1990,30307,16762,2.94097e+13,553.048,6307.51,47069,502,323,42308,39023,36432,33123,17403
2912,200,438,1852,1060,2.74017e+13,107.15,871.632,2912,125,100,2474,2351,2175,2325,1414
11847,379,1007,7662,4185,3.05298e+13,354.055,2457.4,11847,289,204,10720,10020,8925,9183,2351
31302,2158,2345,22052,9250,2.71907e+13,590.039,6396.79,31302,829,253,28957,28957,28946,28952,27300
37659,559,2044,24075,13584,2.9484e+13,574.612,5855.63,37659,461,324,35270,34287,29828,27015,12897
60648,435,614,41092,19556,3.35171e+13,301.902,4161.55,60648,304,255,60034,60034,51770,54731,51361
6337,279,1476,4354,1983,5.07067e+13,298.282,2608.98,6337,399,142,4570,4160,3412,3028,905
89392,1941,4536,58982,30410,3.11551e+13,905.828,13909.1,89392,1353,357,84856,84435,81908,83245,43343
68610,1245,3260,42621,25989,3.07847e+13,716.07,9182.14,68610,634,399,65350,64881,55357,37825,36364
86728,1931,4100,57326,29402,2.90044e+13,917.893,12929.6,86728,1251,403,82628,82108,80310,80209,46962
74717,3101,3890,50021,24696,3.10709e+13,857.492,11803.4,74717,1238,285,70827,70810,70809,70827,66977
98927,31250,38905,80313,18614,1.70351e+12,105.632,40876.1,98927,2190,159,60022,60021,48806,54690,49515
68683,452,2274,44327,24356,2.95558e+13,583.538,7677.9,68683,610,357,65132,60547,55592,53494,28442
11431,20,675,6685,4746,3.23877e+13,250.696,1602.95,11431,197,110,8725,7725,5205,1323,468
10989,734,920,7111,3878,3.10829e+13,399.401,2295.52,10989,283,181,10069,10061,9828,9814,9418
99099,1028,25371,81542,17557,2.37247e+13,5215.35,42114.7,99099,8339,27,54320,48016,45573,24675,3099
94102,2232,4034,63037,31065,3.94509e+13,1320.64,12814.4,94102,1158,445,90068,87684,74804,22857,41417
45253,1412,1813,29087,16166,2.87178e+13,543.969,5534.53,45253,478,297,43440,43440,43306,43274,42238
1531,138,265,895,636,3.12377e+13,52.3233,432.19,1531,47,47,1266,1221,1157,1217,884
6090,235,481,3553,2537,3.14581e+13,176.349,1050,6090,112,91,5609,5373,4709,5134,3382
40917,1950,3257,29170,11747,5.84149e+13,1510.42,9235.03,40917,1368,298,37403,34446,28141,29565,29032
11783,646,788,8622,3161,3.12715e+13,197.327,2501.92,11783,284,129,10995,10995,10809,10939,9593
40833,117,1951,26330,14503,2.95517e+13,530.75,5964.65,40833,515,317,33597,30893,26669,22422,6428
39672,1112,2094,25289,14383,2.99665e+13,571.905,6034.77,39672,482,332,37578,37487,34304,29854,27183
63602,1077,2596,40336,23266,3.00659e+13,590.839,8205.53,63602,598,409,61006,60848,53112,44868,32850
97204,177,4587,69267,27937,4.54209e+13,1732.33,16235.4,97204,1708,625,76043,63032,40574,19678,5071
8410,862,5802,6034,2376,1.92281e+12,10.7803,6086.31,8410,1500,48,2608,2608,548,260,148
55774,7700,10456,38403,17371,2.60706e+13,259.867,14379.3,55774,1302,169,45318,45310,42505,44551,42203
16158,2667,2804,11820,4338,6.46618e+13,755.796,5407.18,16158,763,244,13354,13354,13354,13354,13018
32224,1301,1880,20091,12133,3.11458e+13,450.587,5043.25,32224,403,275,30344,30334,27582,28291,23325
4105,264,672,3023,1082,9.22507e+13,212.141,1196.39,4105,71,190,3397,2938,1528,2042,1718
25830,1647,2844,17716,8114,4.71065e+13,499.37,5973.07,25830,721,317,22986,22820,18346,7863,7442
53421,844,3482,35588,17833,4.12263e+13,778.655,9115.14,53421,966,414,49539,48671,37517,8770,8583
30973,321,3512,21686,9287,5.67506e+13,688.045,7879.81,30973,927,412,25670,23154,15319,6444,4478
94635,1755,4306,66721,27914,4.64334e+13,1399.36,15688.4,94635,1766,570,89261,84715,70191,51449,46784
14886,403,1367,9515,5371,2.86465e+13,345.974,3287.05,14886,351,214,13392,12507,11705,11444,6628
98674,3841,4131,66171,32503,4.04785e+13,1379.74,13343.4,98674,1412,475,94543,94543,94370,94330,91913
91120,1595,4370,64775,26345,4.67436e+13,1580.3,15709.3,91120,1756,568,85051,80638,66055,53405,41782
21101,263,2545,15295,5806,5.52522e+13,1149.51,5994.18,21101,860,209,15824,14139,8569,7153,3096
39641,2278,2712,26873,12768,2.80702e+13,515.793,7373.09,39641,935,250,36929,36929,36789,36880,32956
6099,291,675,3907,2192,2.94443e+13,281.176,1542.5,6099,222,143,5294,4998,4726,4615,2610
35441,122,2952,24050,11391,4.49272e+13,591.111,7225.47,35441,818,335,27695,24462,18017,4286,1502
72746,185,2685,46333,26413,3.02316e+13,628.83,8786.7,72746,591,408,63861,59151,50390,39462,14687
96027,2283,2963,60951,35076,2.97677e+13,728.647,10241.6,96027,694,447,93064,92858,89225,87412,83127
30073,229,2965,21878,8195,6.20397e+13,1335.39,7529.52,30073,959,277,22786,20290,10878,8971,4260
96479,3327,4389,67989,28490,4.65684e+13,1588.75,16044.3,96479,1838,566,92090,91623,86444,68919,73089
61261,775,4098,43248,18013,5.59328e+13,1472.98,12378.3,61261,1704,493,52953,50260,32408,22418,13587
67686,3951,4142,47374,20312,5.305e+13,1404.79,12917.1,67686,1717,496,63544,63531,63195,62215,59928
95492,477,2946,61123,34369,2.98562e+13,696.012,10075.2,95492,708,434,90811,85116,75782,69969,44030
27749,334,1131,17920,9829,2.96899e+13,547.832,3692.65,27749,413,244,25346,23452,22168,21539,9374
67783,1340,2649,42844,24939,3.03222e+13,624.554,8532.96,67783,600,414,65134,64966,58428,48784,42400
47979,1602,3398,34214,13765,4.22259e+13,1046.15,10157.8,47979,1058,341,44402,42980,38495,37070,30910
68479,1850,3912,47640,20839,4.97033e+13,1271.5,11962.8,68479,1396,470,64008,60571,48412,28223,30901
32539,961,1151,21033,11506,2.98955e+13,530.107,3954.62,32539,413,259,31388,31374,30925,30878,30535
98338,2072,3924,64563,33775,3.54563e+13,1220.01,12430.3,98338,1023,435,94414,93027,78789,16670,26056
81915,3515,3907,56378,25537,4.71331e+13,1301.4,12789.7,81915,1494,464,78008,77813,76247,69907,61466
2838,1065,1252,2283,555,1.63232e+12,65.698,1497.28,2838,410,48,1586,1586,1417,1578,1378
61071,3524,3677,41849,19222,3.07459e+13,799.751,10731.9,61071,1078,284,57394,57377,57394,57394,56825
52221,2308,3002,34571,17650,2.91775e+13,520.233,8431,52221,1071,261,49219,49182,48508,49017,42182
5872,17,795,4222,1650,2.65621e+13,202.893,1852.23,5872,322,98,1304,620,350,333,317
97443,233,802,66086,31357,3.3575e+13,304.317,5388.19,97443,314,276,94527,88748,63916,35725,47739
23227,585,987,14965,8262,2.97504e+13,497.331,3279.22,23227,382,220,22213,21281,20423,19466,17234
44007,1004,2804,27649,16358,2.94746e+13,408.585,7033.38,44007,1094,188,41203,40893,38577,35147,26338
51071,3875,3923,36544,14527,6.20082e+13,1516.58,11084.8,51071,1543,456,47148,47148,47144,47148,47051
12461,86,851,7993,4468,2.86869e+13,428.062,2319.54,12461,336,167,9866,7698,7464,6981,2327
83253,482,2471,53548,29705,2.93379e+13,597.784,8564.32,83253,641,379,79493,74175,67088,65452,34564
46618,1104,2930,30178,16440,2.87898e+13,462.367,7761.27,46618,1094,222,43688,43301,40242,36198,23941
59356,2147,3683,37651,21705,2.9926e+13,484.939,9677.79,59356,1200,257,55673,55670,55352,55621,40284
39546,2763,3623,27748,11798,5.36719e+13,947.503,8886.64,39546,1029,423,35923,35812,31750,20072,22561
72649,2418,4458,47746,24903,3.32125e+13,922.441,12334,72649,1147,285,68191,67827,66639,67470,43849
57457,1369,4119,41036,16421,5.70009e+13,1538.77,12139.6,57457,1652,513,51540,47702,34377,29704,22770
95227,2869,2921,60519,34708,2.96455e+13,721.535,10094.4,95227,658,449,92306,92306,92293,92306,92071
69855,2923,3650,47532,22323,4.40203e+13,1106.54,10947.8,69855,1177,433,66205,65970,61962,28413,38077
69510,589,3772,46543,22967,2.90392e+13,796.187,10875.8,69510,1112,283,64356,61324,44621,29062,20896
75804,716,4254,53262,22542,5.05207e+13,1378.53,13953.1,75804,1766,530,66697,63811,44525,28270,17659
19355,2205,2989,14268,5087,6.2139e+13,1078.68,6145.88,19355,779,310,16366,15350,14213,14876,13772
18236,46,889,11795,6441,2.95426e+13,447.025,2817.7,18236,338,202,12114,7556,8840,4504,2161
68048,1320,3692,44551,23497,2.95064e+13,645.217,10628.5,68048,1225,310,64356,63805,53501,50586,30174
34462,811,3070,23361,11101,4.49619e+13,559.308,7321.75,34462,860,344,31392,30857,22516,6789,6392
26246,291,1252,16993,9253,3.03225e+13,554.47,3853.48,26246,391,243,23681,21990,20558,19760,10668
8264,854,1120,5326,2938,3.03472e+13,251.571,2285.98,8264,306,165,7144,7104,6924,6792,5691
34010,214,1665,21903,12107,2.94217e+13,493.629,4952.3,34010,415,274,29766,27681,25168,22627,10366
27076,571,1522,15956,11120,3.18255e+13,308.278,3462.99,27076,395,178,25554,25404,18020,11065,7833
60781,783,3700,41409,19372,4.49788e+13,1011.89,10187.1,60781,1095,436,55708,54603,38712,9141,7520
56383,369,3872,39884,16499,5.54416e+13,1317,11263.7,56383,1478,459,46752,42779,26129,12724,9445
46440,438,3721,32371,14069,5.17963e+13,1101.81,9841.64,46440,1305,434,39508,36711,24086,9456,5122
24641,1629,2065,14801,9840,2.96764e+13,297.88,4194.48,24641,544,147,22576,22576,22482,22576,21130
93866,965,3050,60603,33263,3.09078e+13,825.409,10142,93866,767,430,90797,90307,77606,74596,48999
44193,1699,2832,31301,12892,3.31926e+13,803.927,8656.14,44193,922,231,41361,41069,40683,40826,35369
94752,1143,4619,62699,32053,3.08545e+13,1029.07,14642.4,94752,1362,409,89608,87460,68111,54271,23662
74945,2940,3905,48851,26094,2.95212e+13,667.612,11584.3,74945,1233,378,71040,70908,70990,70814,60419
86147,1580,3994,54684,31463,2.95487e+13,769.449,12016.6,86147,1088,427,82153,81690,72216,55337,49463
66732,1901,3764,45771,20961,3.14754e+13,966.754,11734.1,66732,1056,308,62968,62720,60167,60100,40663
34618,1617,2553,24587,10031,3.32574e+13,759.393,7319.25,34618,792,205,32065,31696,31454,31446,27414
32073,254,1140,20638,11435,2.92152e+13,513.614,3925.75,32073,462,257,28795,26684,25176,24387,12978
29102,1279,2408,20804,8298,3.06711e+13,691.336,6370.9,29102,676,191,26694,25973,25354,25969,18952
38533,1691,2014,24944,13589,3.04711e+13,596.961,5880.72,38533,494,320,36519,36497,36226,36265,35402
21046,141,1933,14819,6227,3.54653e+13,536.082,5153.28,21046,636,152,16673,14872,10354,9801,3421
82191,1978,2798,51223,30968,3.03103e+13,658.88,9365.77,82191,552,432,79393,79225,71981,71703,60058
45658,1143,1553,29449,16209,2.95017e+13,546.119,5087.94,45658,468,319,44105,44097,42550,41470,40579
81834,3452,4281,56906,24928,4.86274e+13,1369.07,14247,81834,1800,541,77553,77387,73608,53629,59208
95193,4110,4238,65295,29898,4.57034e+13,1386.94,14860.7,95193,1804,537,90955,90952,90726,89299,89223
16052,1279,2767,11555,4497,6.74989e+13,648.791,5327.89,16052,651,382,13285,12593,8726,8656,7759
65259,615,3693,44458,20801,4.45908e+13,1051.14,10805.3,65259,1269,423,59341,57213,41244,11523,9917
28740,116,462,19557,9183,3.38138e+13,298.067,2808.1,28740,284,204,21303,12483,13396,11696,13947
14702,65,1727,9043,5659,2.72846e+13,255.619,3280.74,14702,391,130,11036,9273,7292,3159,1501
78607,607,3756,56431,22176,4.30157e+13,1510.15,13610.6,78607,1480,411,69339,64900,43438,31184,26309
44659,1147,3253,27832,16827,2.92865e+13,409.303,7563.99,44659,1025,188,41406,41271,33926,32323,23642
83320,2828,3611,52502,30818,2.9698e+13,856.26,11074.2,83320,962,446,79709,79547,79670,79702,75415
66176,1549,3569,43709,22467,3.86754e+13,845.097,9810.05,66176,1020,431,62607,61638,49793,11752,14253
54078,1169,3685,37129,16949,4.74862e+13,1020.62,10213.2,54078,1261,432,49519,47687,34821,14652,14850
60300,3540,3627,40370,19930,4.25771e+13,837.607,9796.86,60300,1010,420,56673,56655,56565,56552,55505
69721,2353,4210,49398,20323,5.23852e+13,1405.47,13496,69721,1717,529,65511,62663,51597,45300,45796
17656,263,921,11363,6293,2.93813e+13,473.42,2819.4,17656,338,207,15740,14521,13773,13332,6637
34244,296,2985,23237,11007,4.46482e+13,606.965,7145.37,34244,799,338,29388,26396,20724,5017,3582
66761,83,2693,41510,25251,3.03937e+13,616.684,8411.09,66761,504,408,54930,46946,39734,24073,5292
27980,992,1747,18455,9525,3.75069e+13,478.8,4563.54,27980,405,240,26233,26214,23913,21024,10904
14913,26,386,10112,4801,3.36116e+13,281.468,1985.4,14913,243,155,4979,2439,2060,1102,1084
33881,1153,1793,24462,9419,2.95935e+13,642.297,5925.85,33881,698,228,32088,31359,30868,31649,24050
45237,2785,3200,32191,13046,3.7301e+13,893.875,9455.03,45237,909,308,42037,42032,40842,41012,40691
46823,952,3114,31305,15518,3.97529e+13,674.802,7917.02,46823,820,342,43709,43191,33146,7325,6655
68473,155,652,46432,22041,3.35136e+13,303.66,4444.55,68473,307,261,58182,36849,38312,23464,31641
82731,3322,4299,58687,24044,4.10577e+13,1350.01,14454.3,82731,1430,447,78432,78256,71369,72177,67881
94949,1723,6706,67506,27443,4.61812e+13,1621.65,18358.2,94949,2825,666,86875,82370,65841,40929,5507
56720,1994,2153,36661,20059,2.9765e+13,553.738,7010.12,56720,549,352,54567,54567,54356,54346,54252
30370,299,1338,17802,12568,3.17636e+13,319.707,3294,30370,421,173,28891,28061,19305,10655,7959
39746,2483,15257,32304,7442,2.36428e+13,3846.84,22222.1,39746,4088,16,21321,16584,16705,10874,8413
25849,2329,11626,20681,5168,118455000,650.885,16574.5,25849,2600,11,14223,12914,11261,13751,2790
36812,3072,3634,25895,10917,5.42442e+13,962.777,8695.11,36812,998,419,33178,33088,32084,21346,23058
12866,641,803,8292,4574,2.91846e+13,429.362,2328.49,12866,299,180,12063,12037,11688,11710,11500
22559,2860,3326,16109,6450,6.33817e+13,682.467,6790.63,22559,863,388,19233,19230,18910,16327,16369
18124,443,896,10572,7552,3.17661e+13,276.537,2243.43,18124,258,139,17228,17063,14581,14313,12936
18596,2335,2555,13914,4682,6.47734e+13,985.461,5674.86,18596,735,233,16041,15365,15343,15369,15486
39533,1694,3398,26705,12828,4.52568e+13,682.919,8164.01,39533,951,411,36135,35448,27373,11226,13100
36084,1075,1251,23225,12859,2.91466e+13,531.436,4253.67,36084,483,266,34833,34833,34403,34414,34051
73099,2594,3845,47705,25394,2.96234e+13,630.231,11220.4,73099,1248,336,69254,69116,68715,68973,50861
44053,2641,2652,31534,12519,3.19404e+13,843.063,8315.71,44053,924,233,41401,41401,41401,41401,41305
71952,821,2658,45276,26676,3.02228e+13,629.265,8707.5,71952,547,415,69169,68481,57698,46403,34362
65710,180,3693,41949,23761,2.96691e+13,582.853,10475.6,65710,1229,321,56359,46851,37353,13121,6625
91990,3294,4007,60306,31684,3.54048e+13,1238.49,12164.1,91990,1030,419,87983,87825,85965,83718,72311
49739,1515,3398,30924,18815,2.99701e+13,426.414,8199.2,49739,1010,256,46341,46259,43441,43762,33794
40883,619,1326,26363,14520,2.93225e+13,563.923,4604.28,40883,505,282,39514,38675,34730,34187,28528
69178,2116,3485,46064,23114,2.92707e+13,738.078,10243.7,69178,1169,279,65693,65388,64088,58033,50230
58980,3508,3516,42122,16858,4.129e+13,1090.21,11458.3,58980,1211,351,55464,55464,55464,55464,55426
21548,1168,1613,15723,5825,2.92147e+13,340.817,4438.5,21548,413,177,19935,19823,19669,19833,18665
8001,1211,1429,5637,2364,6.17018e+13,204.522,2598.39,8001,285,155,6572,6562,6427,6284,5907
21058,696,1334,15383,5675,2.98538e+13,360.995,4119.95,21058,392,179,19724,19515,18449,18181,11053
8374,1281,1694,5817,2557,4.10447e+13,338.728,3178.14,8374,532,141,6680,6679,6274,6362,6154
60300,3117,3997,43355,16945,5.60747e+13,1490.32,12229.5,60300,1523,523,56303,56260,52656,53018,53246
79886,3465,4410,52985,26901,2.9639e+13,891.547,12726.8,79886,1240,332,75476,75436,75476,75476,68805
13563,610,857,8804,4759,3.00712e+13,444.638,2437.89,13563,335,178,12706,12393,12069,11794,11576
7319,236,684,4729,2590,2.96125e+13,296.096,1663.07,7319,228,152,6360,5949,5506,5534,3224
36498,371,1230,23422,13076,2.88969e+13,559.924,4305.73,36498,444,275,33885,31366,29733,28580,16668
67227,771,3614,44402,22825,3.78197e+13,845.323,9848.95,67227,974,422,63034,62112,48447,8764,8160
80440,92,3751,54376,26064,4.2803e+13,1188.28,11755.8,80440,1332,459,60838,48662,38170,7783,3926
18310,581,1338,11754,6556,3.08567e+13,355.284,3417.07,18310,355,199,16972,16650,15772,14082,12745
76537,179,3594,50539,25998,3.6327e+13,998.87,10528.7,76537,902,355,64513,59260,48798,6689,3194
51070,1347,3099,36475,14595,4.20876e+13,1132.47,10212.4,51070,1114,345,47358,45056,41093,39095,31094
30236,2089,2410,19364,10872,2.80013e+13,349.203,5806.19,30236,892,177,27826,27826,27664,27826,26669
10823,63,1761,7517,3306,2.38303e+13,323.876,3479.73,10823,571,136,5538,2766,2434,862,369
68139,1948,3610,49042,19097,4.40941e+13,1254.46,12543.9,68139,1348,384,64203,62024,55167,52848,44434
97132,2428,4361,68403,28729,4.65104e+13,1560.66,16058.5,97132,1793,567,92477,90203,74933,62087,57916
5841,332,642,3790,2051,2.8431e+13,225.401,1429.2,5841,255,114,5199,4942,4669,4698,3822
10608,448,942,6839,3769,2.90671e+13,307.179,2300.66,10608,277,146,9635,9347,9154,8586,7784
19613,584,1629,13164,6449,4.39853e+13,403.886,3909.45,19613,356,209,17984,17692,14590,4306,3750
15307,1032,1893,10613,4694,2.3874e+13,363.94,4181.73,15307,650,163,13414,13285,12299,11994,7986
52292,1034,2979,36852,15440,3.27464e+13,915.916,9712,52292,974,259,48883,46457,43277,42944,27031
74525,2944,3908,51563,22962,4.83281e+13,1301.65,12331.7,74525,1404,473,70617,70351,64154,37078,46727
30230,495,2198,18210,12020,2.96016e+13,318.041,4670.17,30230,604,156,27881,26801,22039,19151,17029
42626,1255,1313,27507,15119,2.97015e+13,534.16,4630.93,42626,444,286,41313,41313,41256,41247,41181
69057,2208,2283,44483,24574,2.95975e+13,578.404,7602.87,69057,575,345,66774,66774,66745,66768,66661
4707,535,789,3316,1391,3.12792e+13,266.055,1655.38,4707,294,77,3918,3797,3244,3255,1795
54534,1445,2499,34148,20386,3.03693e+13,566.282,7426.38,54534,528,374,52035,51945,45970,36558,36912
29441,499,1080,18962,10479,2.91741e+13,499.333,3708.33,29441,375,254,28148,26261,24772,23853,20396
39653,1360,1681,25396,14257,2.85529e+13,529.368,5241.98,39653,484,277,37972,37971,37769,37643,35558
59316,356,3684,40638,18678,2.88959e+13,766.358,10283.7,59316,992,283,52711,49972,32941,16157,8138
47675,1002,1348,30816,16859,2.99538e+13,542.844,4934.31,47675,465,303,46327,46317,44739,44559,43163
16315,1505,2189,11063,5252,4.21958e+13,866.473,4958.32,16315,787,204,14126,13542,13684,13229,10847
70054,1731,3612,46399,23655,3.91663e+13,878.834,10096.6,70054,1009,412,66442,65381,53775,14233,17454
34490,50,1209,22342,12148,3.04811e+13,537.875,4136.17,34490,442,260,23484,15399,17702,10069,3217
21102,1440,1752,14265,6837,4.71832e+13,408.335,4173.77,21102,354,230,19350,19340,18855,18424,16616
98423,1574,4131,62892,35531,2.94584e+13,866.909,13315.4,98423,1197,447,94292,93658,82756,61861,58504
92398,32348,36342,75012,17386,1.70056e+12,102.425,38241.8,92398,1882,159,56056,56056,50295,55007,50616
71967,1583,3510,47789,24178,2.89516e+13,764.159,10572.7,71967,1182,285,68457,68086,65398,55148,36571
35263,1284,1582,22652,12611,2.94542e+13,532.294,4669.42,35263,450,271,33681,33681,33609,33621,33317
10677,254,737,6868,3809,2.92618e+13,363.358,2023.14,10677,304,152,9487,8979,8516,8333,5950
11717,133,1196,8327,3390,2.75596e+13,507.749,3174.07,11717,617,121,7907,4265,4598,2004,1509
67679,1315,2676,42560,25119,3.03161e+13,616.531,8500.57,67679,541,427,65003,64815,57417,44472,36878
34265,1257,3626,24523,9742,5.92582e+13,1052.34,8583.41,34265,1137,416,29939,28232,17907,13187,12050
44587,1531,1985,27796,16791,3.07683e+13,454.559,5849.86,44587,464,307,42602,42598,40390,41334,37325
83445,120,732,56570,26875,3.35344e+13,304.132,4952.24,83445,311,269,63172,36849,40368,16147,16523
56528,1955,2040,36473,20055,2.9505e+13,533.048,6641.53,56528,538,327,54488,54488,54391,54371,54236
26147,1345,1574,16896,9251,3.01099e+13,487.839,4475.39,26147,429,270,24573,24570,24236,24163,23910
90183,3968,4377,63714,26469,4.75331e+13,1424.43,15446.3,90183,1814,567,85806,85773,85030,80512,75299
47759,3369,3652,32986,14773,4.93337e+13,954.533,9464.43,47759,1079,430,44107,44004,43437,41655,37309
8327,209,854,6036,2291,2.97937e+13,185.321,2123.46,8327,247,119,7403,6815,5413,6069,3073
29949,500,1775,17789,12160,3.18642e+13,322.127,4103.83,29949,422,182,28174,27890,19182,5787,3831
12645,391,753,7387,5258,3.17366e+13,248.118,1789.53,12645,188,137,11892,11715,9999,10799,7693
98856,1983,3726,64834,34022,3.48178e+13,1194.94,12072.5,98856,938,381,95130,93989,81408,17581,26694
67095,1297,2624,44288,22807,3.64863e+13,857.409,7756,67095,659,344,64471,63936,54359,10691,14770
29339,1962,2382,20078,9261,2.70137e+13,531.987,6209.03,29339,876,221,26957,26957,26844,26928,24470
78062,2444,3633,51722,26340,3.78147e+13,884.706,10362.8,78062,994,434,74429,74019,64677,18836,25396
7728,1331,1351,5199,2529,3.64468e+13,351.825,2652.13,7728,395,100,6377,6377,6364,6377,6342
72356,1996,2449,46727,25629,3.0294e+13,628.883,7902.91,72356,605,356,69907,69840,69322,68816,63745
62190,3209,3489,41357,20833,3.98622e+13,811.114,9517.03,62190,966,414,58701,58699,57915,56636,51578
79072,3196,4125,54603,24469,4.83439e+13,1274.17,13014.1,79072,1561,477,74947,74735,69338,42755,51895
58088,3502,4067,41683,16405,5.65158e+13,1504.92,12151.6,58088,1567,521,54021,54007,52656,51709,51546
21907,1334,1456,13629,8278,3.11496e+13,293.428,3767.41,21907,311,219,20451,20451,20353,20363,19676
2503,250,346,1601,902,2.65369e+13,91.9652,715.553,2503,116,62,2157,2157,2138,2138,1937
29281,818,1639,18868,10413,2.96074e+13,508.784,4784.06,29281,434,280,27642,27274,25253,24134,14945
39085,823,2013,23768,15317,3.11111e+13,440.913,5461.09,39085,412,306,37072,36884,28888,16450,14840
40757,1579,1981,25196,15561,3.11003e+13,439.178,5589.54,40757,402,288,38776,38765,37078,37759,34733
32177,2283,2910,21880,10297,4.51325e+13,526.443,6803.91,32177,733,334,29267,29210,27782,13158,14582
1203,210,223,783,420,2.74898e+13,76.276,431.104,1203,72,47,980,980,980,980,974
10038,248,733,6467,3571,2.91897e+13,336.85,1960.76,10038,255,151,8910,8449,8131,7837,5401
81203,1623,3692,54739,26464,4.11838e+13,1145.25,11332.7,81203,1140,440,76988,75146,61063,18248,30845
55048,1566,2010,35447,19601,2.8974e+13,532.642,6418.48,55048,538,316,53038,53038,52594,52191,48916
9425,139,745,6070,3355,2.95959e+13,359.967,1947.42,9425,233,166,7875,7516,6375,5385,1284
82470,22668,22743,67541,14929,2.56742e+13,5421.22,36655.2,82470,7793,22,59727,59727,59727,59727,59580
47614,3196,3615,33905,13709,5.68404e+13,1557.09,10428.3,47614,1433,402,43999,43990,43202,43299,42822
21946,326,1953,15540,6406,3.56593e+13,573.143,5303.62,21946,661,155,19130,18017,15128,16041,7405
13290,4305,5464,7568,5722,7.62338e+12,157.469,7067.47,13290,432,179,7826,7826,5817,4449,4393
93482,27882,93482,46741,46741,5808080,0,93482,93482,46742,2,0,0,0,0,0
17773,2414,2618,13301,4472,7.04726e+13,801.195,5511.91,17773,701,257,15155,15068,15009,14944,14930
70353,2720,3686,50709,19644,4.45889e+13,1373.15,12868.3,70353,1350,398,66667,66374,58251,60666,56839
8957,695,1305,6339,2618,1.8332e+13,362.999,2791.44,8957,500,132,7652,7600,5081,6154,1987
99343,4584,4691,70092,29251,4.37411e+13,1702.16,16435.6,99343,1721,620,94652,94652,94652,94559,94435
75550,1910,2338,48819,26731,2.98776e+13,608.837,8186.07,75550,669,382,73212,73212,72102,71282,69545
2005,174,301,1173,832,3.29725e+13,78.0708,528.691,2005,62,49,1704,1618,1544,1618,1156
2905,126,386,1694,1211,3.17159e+13,93.7126,696.548,2905,68,73,2497,2328,2071,2096,1047
21811,1332,1858,15629,6182,2.84103e+13,484.104,4882.1,21811,587,155,19953,19536,19891,19946,18672
96259,1921,2945,61634,34625,2.95485e+13,700.808,10029.5,96259,723,432,93314,93210,90075,84761,78556
43013,2548,3714,30712,12301,5.91976e+13,1168.71,9668.51,43013,1259,457,39299,38118,33002,25647,28881
53418,1574,1938,34496,18922,2.9916e+13,532.476,6382.27,53418,525,314,51480,51478,50969,50522,46690
98075,4059,4502,67029,31046,3.76763e+13,1324.1,15407.8,98075,1457,433,93573,93536,92399,91649,90692
21345,1004,2654,14961,6384,5.71472e+13,844.385,6052.37,21345,814,228,18273,17374,12793,12872,8502
43254,1500,2839,30878,12376,2.74548e+13,703.541,7925.49,43254,827,263,40415,40255,38577,39778,27332
78455,4152,4233,52005,26450,2.91084e+13,863.622,12270.8,78455,1228,331,74222,74222,74222,74222,74124
61393,1255,4026,44237,17156,5.59431e+13,1498.39,12376.9,61393,1519,521,55123,51264,37831,35049,26586
41019,2505,2784,26925,14094,2.83788e+13,473.477,7391.27,41019,1007,229,38235,38235,38231,38235,37043
88088,14726,34660,71517,16571,1.70283e+12,105.072,36512.6,88088,1992,159,53428,53419,23953,28936,26005
68201,2715,3515,44929,23272,2.96494e+13,674.725,10151.4,68201,1199,278,64686,64485,64576,64385,56079
28367,273,1701,20572,7795,2.99174e+13,469.031,5314.17,28367,482,205,25974,25027,15714,6915,6666
21013,368,946,13457,7556,2.82368e+13,483.099,3041.08,21013,356,214,19409,18122,17155,16701,9935
25627,149,1524,16549,9078,3.00176e+13,532.503,4280.88,25627,418,265,21696,20217,17235,14193,2336
90812,1688,4178,58328,32484,2.94401e+13,758.443,13064.3,90812,1252,405,86634,86227,77170,61537,48795
43241,2333,3687,30613,12628,5.64806e+13,1125.14,9542.85,43241,1284,448,39554,38053,32454,23759,26341
43308,506,519,29377,13931,3.35453e+13,297.721,3464.07,43308,295,234,42789,42789,42788,42752,42710
94848,2605,4612,67276,27572,4.38339e+13,1724.99,16055,94848,1704,586,90043,88626,77238,74692,62252
88158,513,4353,63102,25056,4.78035e+13,1724.13,15599.4,88158,1832,570,76050,71723,43023,35910,12103
65344,2108,2594,41635,23709,2.95735e+13,570.841,8278.75,65344,569,406,62750,62746,61129,61644,57884
13012,506,809,7594,5418,3.17169e+13,252.162,1888.25,13012,198,134,12203,12118,11040,11552,9719
14499,2526,2555,10703,3796,6.57417e+13,668.645,4959.66,14499,659,245,11944,11944,11944,11944,11944
94167,1652,4307,66489,27678,4.63653e+13,1559.92,15765.9,94167,1768,564,88362,83837,69437,51844,41385
60989,174,2469,40024,20965,3.66502e+13,561.242,7174.04,60989,565,331,52168,48593,39977,5818,2835
68006,1347,2242,43863,24143,2.9645e+13,590.329,7649.15,68006,581,371,65764,65725,62668,61548,50163
76462,175,4170,54378,22084,5.05698e+13,1384.64,14158.9,76462,1720,535,59762,53015,33940,24755,7028
74216,2911,3855,51062,23154,4.84399e+13,1177.72,11898.6,74216,1390,470,70361,70071,63826,33013,44479
75269,314,4168,52981,22288,3.75134e+13,1267.98,13509.3,75269,1359,412,63608,58412,38358,16174,5669
30238,1836,2788,21863,8375,6.12507e+13,1281.29,7590.83,30238,1126,254,27236,25281,19706,20062,20989
41624,1763,3464,29992,11632,6.21075e+13,1470.46,9328.43,41624,1176,439,37635,34397,25328,27994,25678
4090,248,622,2614,1476,2.95234e+13,152.855,1226.94,4090,183,98,3450,3300,3138,2997,2121
99301,2324,3777,62972,36329,2.95361e+13,950.269,12379.2,99301,992,460,95524,95053,90075,92104,77868
62708,3827,4177,44899,17809,5.49064e+13,1447.3,12704.7,62708,1635,523,58531,58531,58399,56960,56356
29970,1133,2353,18682,11288,2.80362e+13,307.736,5368.95,29970,808,159,27617,27615,27270,27009,20256
38706,1389,2595,26803,11903,2.81551e+13,550.316,7220.56,38706,885,258,36111,35905,33812,30934,21641
62386,369,2221,40056,22330,2.9525e+13,587.507,7392.01,62386,600,351,57611,53078,49748,47278,23290
20633,527,1901,12584,8049,2.81615e+13,292.934,3966.31,20633,461,150,18592,17517,15701,16310,11843
39006,1089,2008,23875,15131,3.11208e+13,434.209,5455.46,39006,394,296,36998,36947,30743,26448,20442
78125,1549,3927,50597,27528,2.94358e+13,667.794,11746.1,78125,1234,376,74198,73923,65827,64631,41687
44743,1442,2644,29775,14968,3.94616e+13,735.487,6864.85,44743,654,318,42099,41731,35748,9745,11097
15763,371,919,10126,5637,2.88202e+13,435.144,2614.05,15763,362,197,14431,13561,12990,12516,8225
63383,2174,3642,45383,18000,3.76031e+13,1069.03,11773.8,63383,1101,385,59741,59110,55085,53971,48803
75719,755,3939,49387,26332,2.96935e+13,683.456,11729.4,75719,1247,382,71304,70159,50708,30404,15226
7583,1275,1483,5041,2542,5.45523e+13,186.586,2737.87,7583,488,116,6100,6100,6100,6085,5686
73107,1313,3537,45689,27418,2.98464e+13,803.426,10199.2,73107,901,410,69570,69020,59692,40027,40296
18002,1693,1810,15314,2688,4.2025e+13,17.0763,2322.32,18002,908,903,16192,16192,15509,15903,15859
51514,1231,3087,36862,14652,4.17003e+13,1174.35,10245.6,51514,1124,339,47551,45289,40643,38954,29614
68801,3078,3727,49521,19280,4.55924e+13,1515.06,12815.8,68801,1376,383,65074,64776,60601,60123,60039
80656,2161,3181,50312,30344,3.06452e+13,753.468,9759.42,80656,630,452,77475,77277,71163,72743,63848
53107,670,2509,33298,19809,3.07851e+13,550.399,7281.57,53107,488,367,50413,49580,40540,30143,18819
93348,3487,4417,65562,27786,4.13538e+13,1572.31,15491.8,93348,1662,457,88931,88721,82172,83629,77405
50090,1362,2953,33719,16371,2.89184e+13,519.375,8340.78,50090,994,263,47137,46873,42684,37783,19996
76959,733,2661,49868,27091,3.11813e+13,682.14,8544.85,76959,656,369,74238,73455,62073,58903,27248
51495,828,3731,35905,15590,5.24809e+13,1138.51,10284.2,51495,1309,450,45841,44131,30766,13458,13572
67585,2346,3658,48630,18955,4.5559e+13,1566.03,12652.1,67585,1361,379,63669,61861,54542,55516,48879
73800,2622,2735,46694,27106,3.00125e+13,639.485,8904.29,73800,580,429,71065,71021,71005,71020,70226
47645,1771,1936,30627,17018,2.92168e+13,537.175,5889.31,47645,506,299,45709,45709,45603,45639,45092
68276,2117,2148,43993,24283,2.95523e+13,562.77,7336.93,68276,564,346,66128,66128,66125,66124,66093
24482,620,2204,16277,8205,2.69029e+13,414.095,5383.36,24482,822,181,22118,21406,16535,13670,8758
38590,1259,2011,23501,15089,3.10948e+13,399.693,5381.82,38590,404,288,36579,36542,31188,30374,23870
91658,3473,4255,64396,27262,4.6874e+13,1342.95,15347.4,91658,1793,536,87403,87244,83852,66812,71467
7287,197,545,4257,3030,3.24678e+13,192.961,1203.83,7287,139,93,6688,6069,5393,4846,3348
73008,2209,2693,45818,27190,3.02539e+13,662.562,8862.33,73008,587,438,70315,70194,66569,67730,62490
2873,35,682,1964,909,1.81807e+13,349.991,1232.17,2873,439,63,1148,612,155,122,149
5560,105,467,3245,2315,3.18749e+13,171.164,996.546,5560,109,91,4845,4431,3789,2537,1914
6612,602,679,4304,2308,2.9585e+13,215.269,1516.07,6612,206,110,5933,5861,5905,5871,5505
65515,2786,3769,42521,22994,2.94133e+13,607.026,10464,65515,1215,306,61746,61643,61686,61541,51214
94041,615,4145,61933,32108,2.95141e+13,925.286,13297.6,94041,1255,409,88598,86295,60800,40551,23564
92842,3314,4271,61317,31525,2.90923e+13,954.972,13644.6,92842,1254,411,88571,88420,88543,88240,79609
90704,1015,4075,57718,32986,2.98579e+13,823.413,12577.3,90704,1160,438,86413,85754,69883,48882,33405
79256,1485,3802,56888,22368,4.30062e+13,1510.96,13722.8,79256,1481,405,74075,70389,61643,60546,42244
88284,413,3615,57927,30357,3.54689e+13,1127.48,11100,88284,910,379,81193,74810,64434,8604,5553
27807,2088,2114,16445,11362,3.1391e+13,294.134,4054.08,27807,511,160,25693,25693,25693,25693,25693
35540,204,1211,23001,12539,2.98422e+13,539.022,4183.5,35540,409,267,31088,28869,26224,23431,11800
82465,2949,4256,58423,24042,4.94263e+13,1343.68,14655.6,82465,1732,541,78209,78025,71797,61297,64484
19917,974,1318,12875,7042,3.0017e+13,511.891,3567.33,19917,389,233,18599,18576,17954,17737,16770
49207,272,3000,35478,13729,4.73485e+13,1241.93,10068,49207,1154,336,40449,37068,25628,24646,9091
42061,413,3366,30156,11905,5.4649e+13,1419.58,9707.7,42061,1228,341,33905,31622,19824,17523,8579
90705,3356,3978,62108,28597,4.61201e+13,1314.98,13294.2,90705,1540,483,86727,86464,83964,46646,58979
10314,1887,2016,7502,2812,5.78005e+13,251.132,3755.88,10314,535,157,8298,8298,8156,8189,7973
93641,1075,3844,59253,34388,2.91738e+13,933.282,12196,93641,1006,465,89512,88896,75596,55061,44945
60493,1364,2564,37837,22656,3.06319e+13,605.925,7959.95,60493,532,400,57929,57761,50609,38436,39567
28943,106,3488,20984,7959,6.21119e+13,1073.16,7841.72,28943,995,417,20341,15570,9145,5258,1747
90504,679,3877,61943,28561,4.52521e+13,1300.34,12994.9,90504,1378,488,82570,80642,55737,18520,13120
2922,269,349,1882,1040,2.70661e+13,95.0791,754.904,2922,114,66,2573,2568,2562,2556,2381
24938,1602,3157,18081,6857,6.22237e+13,1119.41,7009.51,24938,930,355,21625,20180,13920,15009,13263
55451,2628,3228,34661,20790,2.90435e+13,544.117,8593.67,55451,943,311,52223,52223,52223,52223,46877
85367,502,4354,58571,26796,3.70004e+13,1222.02,14288.4,85367,1313,412,76236,71868,49256,28244,16072
52831,1074,3475,33489,19342,2.90404e+13,459.653,8891.64,52831,1139,239,49356,48921,38742,32239,18992
64701,2222,3545,46522,18179,4.65693e+13,1573.23,12223.2,64701,1344,376,60796,58518,51713,51766,44839
26757,232,3081,19646,7111,6.44523e+13,1251.57,7240.13,26757,1024,272,20052,17790,9570,7351,3697
29107,173,1113,18838,10269,2.98811e+13,496.5,3734.47,29107,373,249,25140,23595,20586,17190,8980
23351,407,1001,14965,8386,2.81882e+13,486.061,3278.98,23351,419,226,21737,20138,19354,18629,13256
14971,958,2639,11031,3940,6.17889e+13,767.499,5128.62,14971,696,167,12316,11459,6958,7055,3905
17671,334,837,11387,6284,2.88139e+13,452.047,2637.48,17671,346,186,16154,15232,14527,14105,11148
97423,488,4316,63408,34015,2.96366e+13,853.469,13921.5,97423,1262,443,90703,86177,64369,45596,18806
1264,289,366,1084,180,3.98625e+13,5.11155,627.371,1264,183,5,898,898,898,898,748
99107,982,3299,63954,35153,3.15507e+13,887.167,10740.2,99107,784,437,95709,95157,81225,68578,29022
33183,592,1594,21375,11808,2.89716e+13,464.178,4882.98,33183,407,280,31588,30956,28252,28398,21646
40874,1381,3333,29196,11678,5.59186e+13,1472.43,9488.57,40874,1289,342,36398,33619,26043,25428,18550
34000,1921,1970,21612,12388,3.03177e+13,550.061,5391.52,34000,505,322,32030,32030,32010,32030,31870
21712,120,2150,15156,6556,3.69182e+13,600.242,5561.06,21712,606,191,16536,14723,10037,10622,2673
58739,518,2587,36876,21863,3.0816e+13,609.255,7841.25,58739,585,382,55498,53762,43780,33597,16971
28976,442,2807,20635,8341,5.56822e+13,1341.77,7470.32,28976,1116,240,23009,21180,14226,12901,5588
22767,595,2657,16258,6509,5.24163e+13,1099.61,6267.29,22767,876,225,18480,17639,11991,10457,5229
97396,3644,3897,66255,31141,4.41149e+13,1333.2,13437.2,97396,1467,481,93499,93488,92064,87835,81401
75844,22815,29867,61571,14273,1.70411e+12,101.384,31578.5,75844,1657,156,45977,45974,35648,41422,36278
86044,1576,2864,54684,31360,3.04045e+13,690.422,9603.58,86044,628,448,83180,82965,76626,65088,58943
92235,2675,4302,59850,32385,2.96766e+13,815.439,13456.7,92235,1250,438,87933,87726,87514,87612,65906
8778,654,1115,6314,2464,2.39599e+13,342.543,2602.9,8778,561,107,7663,7370,6401,5912,6283
57730,1920,2166,37180,20550,2.94442e+13,568.996,6991.31,57730,544,334,55564,55564,55334,55354,54886
4784,515,614,3052,1732,2.62407e+13,153.694,1260.58,4784,185,99,4170,4133,4138,4117,3751
71252,1702,2633,45681,25571,3.0252e+13,603.116,8629.16,71252,612,410,68619,68591,65356,60084,59838
13409,1159,1222,8476,4933,2.99183e+13,255.906,2873.73,13409,291,183,12187,12185,12170,12186,11949
52285,786,2979,36930,15355,3.26942e+13,917.773,9712.22,52285,973,258,48156,46065,36178,37877,24969
37781,360,1895,22757,15024,3.11108e+13,376.762,5037.53,37781,425,269,35653,34485,25663,11541,8580
38164,2157,2649,24580,13584,2.92829e+13,456.146,6853.4,38164,1020,196,35515,35514,35237,35512,32400
55259,1346,2010,35647,19612,2.93779e+13,556.184,6257.05,55259,521,313,53249,53249,52615,52666,50861
8072,186,562,4705,3367,3.11221e+13,197.872,1276.56,8072,127,105,7398,6704,5768,4960,2929
35273,6046,13967,29120,6153,2.82202e+13,1307.09,19157.2,35273,4858,16,21306,18719,17757,19142,16575
35690,1582,2406,25472,10218,2.79592e+13,607.355,6764.11,35690,816,249,33284,33270,32093,32912,24492
60484,2699,4036,42665,17819,5.6353e+13,1364,12108.5,60484,1727,465,56448,56158,49790,40222,43194
49664,2623,3395,35664,14000,5.16915e+13,1356.55,10545.2,49664,1285,355,46269,45985,43407,43344,42889
63267,1936,4037,44462,18805,5.38298e+13,1313.93,12055.5,63267,1528,456,58812,55046,42135,31103,30846
58784,7291,15234,43527,15257,2.27583e+13,199.634,19551,58784,1470,179,43550,43513,33812,34822,32294
39650,952,1228,25555,14095,2.93256e+13,557.94,4421.48,39650,477,278,38422,38421,37279,36939,36408
9808,3187,9808,4904,4904,5807550,0,9808,9808,4904,2,0,0,0,0,0
36431,2225,3372,26736,9695,6.54387e+13,1439.33,8698.14,36431,1045,430,33059,30487,26167,27165,26348
74638,582,4099,51815,22823,5.07674e+13,1391.94,13256.8,74638,1730,503,64870,61302,41587,20490,11182
30456,2222,2323,21283,9173,3.5392e+13,784.732,6874.19,30456,816,220,28133,28133,28121,28133,27950
52410,3669,3688,37736,14674,5.97937e+13,1598.74,11009.9,52410,1471,519,48722,48717,48711,48718,48673
73243,3549,3736,49252,23991,4.15149e+13,1102.38,10890.9,73243,1115,423,69507,69292,68529,67397,66234
85358,3567,4245,61390,23968,4.83115e+13,1734.24,15108.4,85358,1734,564,81113,80927,79062,78151,78375
88898,3704,4016,59428,29470,3.95788e+13,1274.75,12464.6,88898,1131,448,84882,84882,84621,84338,81060
98099,1366,4241,68686,29413,4.6274e+13,1347.48,15703.5,98099,1782,550,91708,87063,70727,45603,40151
35900,684,1700,23169,12731,2.91193e+13,504.036,5290.66,35900,432,304,34184,33646,30653,29824,18019
22653,1138,1921,13857,8796,2.81657e+13,304.606,4205.43,22653,654,135,20732,20732,20482,20725,16707
60632,99,2458,39930,20702,3.72233e+13,560.56,7135.97,60632,516,317,49269,42067,33917,5206,1620
83736,928,2922,52578,31158,3.03167e+13,706.266,9694.01,83736,617,447,80656,80096,67014,53359,42306
97577,2084,3543,63801,33776,3.3768e+13,955.328,10923.9,97577,777,394,94034,93362,86714,78651,43258
98057,722,2994,62003,36054,2.97479e+13,734.048,10376.6,98057,704,452,94730,93614,78286,68262,51718
68239,1952,2276,43909,24330,2.91251e+13,586.245,7681.84,68239,592,368,65963,65963,65361,64989,64620
12663,805,826,8134,4529,2.98187e+13,408.762,2325.18,12663,329,185,11837,11835,11820,11821,11824
40085,2542,3317,28659,11426,5.69345e+13,1493.43,9374.73,40085,1281,340,36768,36363,33880,34094,33289
56726,2825,3532,40646,16080,3.9854e+13,930.101,11087.5,56726,1024,363,53194,53186,49268,50569,49957
45152,1472,2059,29606,15546,3.5389e+13,530.095,5836.25,45152,470,291,43093,43089,41315,39100,35873
99139,2557,3028,62913,36226,2.97615e+13,751.661,10472.9,99139,699,451,96111,95941,92938,93514,87463
73306,3708,4198,51763,21543,5.14649e+13,1390.83,13753.9,73306,1723,536,69108,69089,68237,58082,59997
42496,583,1776,27418,15078,2.98121e+13,493.81,5589.98,42496,466,303,40708,38969,35762,35677,26991
9571,157,698,6155,3416,2.84676e+13,357.301,1897.79,9571,253,161,8149,7743,6737,6830,3027
18124,1386,1527,13054,5070,3.03004e+13,432.822,4305.37,18124,501,182,16597,16543,16460,16500,15234
5589,336,433,3258,2331,3.12075e+13,172.447,968.966,5589,92,98,5156,5141,4986,5021,4477
22209,1052,2175,14859,7350,2.69702e+13,428.215,5170.75,22209,806,184,20034,19769,18453,16782,8656
14030,82,960,9064,4966,2.96821e+13,378.381,2628.96,14030,286,194,11165,9149,8532,7173,2425
45067,12080,19314,36057,9010,135899000,922.34,28105.8,45067,4529,11,25753,25753,23412,25753,16198
49311,1731,2330,31420,17891,3.01302e+13,543.903,7021.98,49311,545,355,46981,46954,45007,44430,40918
65089,2256,3747,44322,20767,3.08584e+13,810.563,11081.7,65089,1108,282,61342,61218,59760,60647,44283
91670,9719,36067,74419,17251,1.70562e+12,101.92,37960.2,91670,1880,160,55603,55588,16675,21389,19135
53666,1327,1896,34581,19085,2.92716e+13,534.488,6313.29,53666,525,316,51770,51766,50871,50555,46425
68929,959,2657,42923,26006,3.08524e+13,627.513,8509.59,68929,540,416,66272,65896,53767,38088,29657
8277,200,570,4828,3449,3.19831e+13,196.613,1303.97,8277,148,105,7637,6963,5958,5261,3925
10245,473,756,6590,3655,2.91503e+13,369.689,2047.03,10245,280,166,9456,8898,8831,8551,7312
83043,2397,4372,57638,25405,3.67983e+13,1322.43,14300,83043,1426,421,78671,77407,72654,71030,51890
32423,707,3458,22362,10061,5.27023e+13,688.328,7888.53,32423,930,414,28384,27684,18984,8209,7849
25471,365,1157,16365,9106,2.98866e+13,526.687,3608.31,25471,422,252,23296,21472,19946,19146,7070
83914,1253,4252,59970,23944,4.25195e+13,1567.05,14624,83914,1550,437,77550,73553,57875,50274,28827
24963,234,1524,16040,8923,2.93952e+13,425.439,4328.98,24963,385,272,22081,20404,18308,17230,5362
96578,92,4555,67206,29372,4.09146e+13,1570.56,15872.2,96578,1667,452,68298,49477,36334,10889,3996
82277,3901,4462,54647,27630,3.09943e+13,917.917,13199.7,82277,1334,333,77815,77815,77815,77815,75552
26412,1699,1811,15496,10916,3.21535e+13,292.182,3630.49,26412,486,159,24601,24601,24601,24601,24581
38794,3001,3686,28395,10399,6.52181e+13,1372.93,9336.74,38794,1172,454,35108,35051,32642,31488,31957
78298,1160,2375,50470,27828,2.93125e+13,581.005,8203.56,78298,622,376,75923,75897,70984,69818,57494
17347,1102,1297,11170,6177,2.87368e+13,382.672,3353.02,17347,304,219,16050,16045,15994,15979,14929
74677,1919,3621,53911,20766,4.18759e+13,1242.53,12998.5,74677,1342,395,70713,68503,61302,59193,49799
92804,3051,4140,61266,31538,2.93194e+13,917.973,13374.6,92804,1251,408,88664,88509,88566,88308,77042
10052,773,838,5950,4102,3.16111e+13,199.2,1732.7,10052,175,111,9214,9214,9165,9151,8910
48833,3128,3161,34287,14546,2.74155e+13,745.623,8865.22,48833,877,280,45672,45672,45672,45672,45649
40391,903,2683,25896,14495,2.9176e+13,450.862,6996.02,40391,1039,196,37697,37280,34529,29559,20726
15955,216,1395,11487,4468,2.75781e+13,274.959,3753.86,15955,379,145,14059,12360,9633,10639,4080
91077,333,2964,57392,33685,3.00152e+13,724.867,10078.9,91077,655,453,84525,79012,67791,52102,24227
2084,909,937,1414,670,2.27012e+13,50.4271,1160.99,2084,268,86,1147,1147,1147,1147,1138
38028,1892,3291,27138,10890,5.95252e+13,1496.48,9058.32,38028,1276,316,34423,31864,25213,26609,25410
25528,452,1004,16437,9091,2.85572e+13,482.111,3362.49,25528,383,225,24164,22481,21722,20658,17391
77972,2960,4121,53918,24054,5.02045e+13,1309.65,13250.6,77972,1751,469,73851,73613,66513,42955,50845
57735,856,1990,37488,20247,3.22665e+13,606.902,6270.37,57735,589,328,55745,55541,47768,45456,23703
53905,2170,3420,37624,16281,3.05033e+13,816.753,9884.53,53905,994,281,50485,50411,49524,50027,38417
5505,616,1344,3743,1762,4.80426e+13,298.038,2311.45,5505,366,126,4161,4039,3546,3678,1242
41888,209,3505,30378,11510,6.1693e+13,1430.29,9338.83,41888,1175,431,31498,27591,15260,12341,3195
56603,1073,2117,36525,20078,2.96924e+13,566.789,6916.79,56603,567,338,54486,54442,51275,50843,43051
5454,351,467,3186,2268,3.21612e+13,166.287,997.182,5454,110,87,4987,4967,4763,4848,4175
98819,2687,4330,68670,30149,4.52043e+13,1347.09,15737.8,98819,1815,553,94489,93347,83942,58651,64129
43157,147,2652,30872,12285,3.19443e+13,841.557,8235.1,43157,924,234,33877,26218,19579,4541,5215
92659,3688,4279,59936,32723,2.95148e+13,827.213,13449.5,92659,1256,416,88380,88342,88380,88341,83860
95790,2483,2964,61051,34739,2.97215e+13,723.034,10178.5,95790,738,446,92826,92637,90072,88775,84885
25826,64,1030,16655,9171,2.99822e+13,525.675,3447.79,25826,415,226,19027,13135,14629,13372,2972
40284,2661,2919,28625,11659,4.59541e+13,1064.59,8959.86,40284,1017,318,37365,37213,36802,36845,36287
66868,3987,4131,47035,19833,5.31499e+13,1437.67,12934.8,66868,1714,522,62737,62726,62509,61750,59959
35970,1051,2727,25480,10490,3.45077e+13,776.17,7768.16,35970,789,226,33056,31650,29634,30868,16932
84695,381,3645,55687,29008,3.538e+13,1026.86,10840.8,84695,901,362,77470,71122,61721,7748,6346
84217,1099,3604,55312,28905,3.51831e+13,1039.49,10718.5,84217,844,355,80303,79641,63543,9692,13101
20679,526,1483,14811,5868,2.61886e+13,630.893,4516.86,20679,741,177,18508,16882,12722,9763,11315
73957,1227,3896,50929,23028,4.79019e+13,1267.93,12240.4,73957,1363,484,68203,65561,49572,21764,21894
39962,101,1303,25747,14215,2.94806e+13,549.632,4543.92,39962,431,278,32748,28903,24772,22328,7507
90755,2032,4093,57791,32964,2.95854e+13,817.759,12691.2,90755,1186,434,86662,86296,79675,79875,60344
80512,92,681,54520,25992,3.34235e+13,297.054,4798.04,80512,305,263,53302,21351,34743,11222,24047
53285,357,3563,33813,19472,2.98842e+13,477.389,9086.7,53285,1178,236,48096,45214,31220,13751,5359
20987,2534,3082,15465,5522,6.43476e+13,1070,6421.05,20987,782,356,17905,17155,15889,16040,15576
90887,3386,4225,62265,28622,4.70951e+13,1372.19,14276.8,90887,1831,521,86662,86445,81871,49927,59880
26737,198,1188,15652,11085,3.18966e+13,313.272,2962.91,26737,386,159,24911,22306,16492,9169,6281
78509,2968,3360,51354,27155,3.45109e+13,930.891,9838.8,78509,745,356,75149,75140,74631,74069,69551
26795,862,2851,18955,7840,5.10718e+13,1069.79,7322.87,26795,918,311,22933,21716,16625,15290,9652
98492,3268,4326,64867,33625,3.00206e+13,841.834,13854.9,98492,1266,428,94166,94142,94152,93817,79420
43597,3123,3279,30867,12730,5.57122e+13,1478.28,9630.12,43597,1363,326,40318,40316,40318,40318,39619
13020,592,782,8434,4586,2.94224e+13,368.23,2271.02,13020,288,173,12238,12029,11839,11561,11243
53304,2400,3166,33050,20254,2.96793e+13,551.948,8208.23,53304,944,312,50138,50134,50109,50137,45723
9626,671,824,6205,3421,2.88748e+13,345.187,1989.35,9626,348,141,8802,8614,8621,8450,8575
94655,3078,3199,59302,35353,3.0223e+13,756.348,10554.3,94655,649,461,91456,91456,91445,91456,91412
70789,415,3720,47829,22960,4.23318e+13,1077.58,10852.4,70789,1115,437,63252,58222,45115,9011,5817
98810,21885,38831,80206,18604,1.70524e+12,103.583,40801,98810,1980,160,59979,59975,34857,40165,36661
68149,1627,2734,42181,25968,3.06e+13,646.846,8480.8,68149,544,410,65415,65168,57202,44216,44000
13479,874,956,8682,4797,2.9632e+13,382.537,2560.04,13479,305,178,12523,12520,12464,12476,12454
59226,1723,3592,37795,21431,2.94456e+13,506.028,9729.89,59226,1215,269,55634,55597,54150,54452,35398
49514,1475,3377,35588,13926,4.094e+13,976.07,10239.9,49514,922,348,45944,44202,39668,38254,30200
27535,124,2117,16809,10726,2.84492e+13,324.454,4730.13,27535,751,152,22464,19738,14480,6853,4724
38784,123,1973,23413,15371,3.13507e+13,375.279,5173.54,38784,463,254,34216,30802,24235,9224,4638
78689,2074,2503,50708,27981,2.95944e+13,615.499,8329.82,78689,651,353,76186,76186,75366,75067,73739
30757,280,2457,19880,10877,2.8347e+13,391.945,6021.77,30757,909,183,26626,24510,17738,11603,7707
90439,1585,4505,59906,30533,3.0357e+13,999.489,13986.2,90439,1299,399,85934,85015,74033,73535,39779
13011,543,2339,9338,3673,6.31656e+13,296.399,4097.7,13011,518,288,10672,10332,4809,2051,919
61709,2308,3665,39170,22539,2.98594e+13,540.481,10022.7,61709,1187,303,58044,58031,57692,57998,43345
52118,865,3416,37278,14840,5.11159e+13,1334.72,10759,52118,1326,349,45855,43120,32870,30367,19663
8398,481,1081,5458,2940,2.97291e+13,254.229,2258.88,8398,295,167,7317,7095,6444,6476,2895
40684,1562,3381,29744,10940,6.4313e+13,1496.62,9138.86,40684,1175,455,36380,33391,22796,24901,22968
72863,2128,4160,50551,22312,5.05205e+13,1305.83,12878.9,72863,1612,468,68549,64706,52269,33599,36922
25358,1233,2890,18630,6728,6.6615e+13,1068.46,6759.58,25358,972,256,21890,20499,15890,15370,13583
78269,3996,4233,51902,26367,2.90335e+13,826.315,12232.7,78269,1238,332,74036,74036,74036,74036,73234
18742,2241,2863,13814,4928,6.71449e+13,887.066,5859.46,18742,809,253,15879,15335,14658,14602,14420
22300,799,1009,14352,7948,2.93022e+13,504.435,3251.08,22300,422,226,21291,21276,20742,20435,20224
90521,6829,9213,76859,13662,4.21314e+13,18.0928,10416.9,90521,4527,3093,81308,81308,67444,75462,74175
68900,2026,3488,42884,26016,2.97077e+13,758.293,9680.62,68900,720,411,65412,65150,60384,62074,53044
33205,2261,2601,23330,9875,3.72432e+13,814.91,7545.26,33205,818,262,30604,30602,30122,30292,29970
86180,925,2809,54916,31264,3.03033e+13,694.444,9606.33,86180,711,437,83306,82806,71409,63361,49558
5229,344,445,3055,2174,3.25218e+13,160.804,955.76,5229,105,83,4784,4755,4599,4682,4280
72564,496,2764,45594,26970,3.02356e+13,639.824,8913.36,72564,571,434,69002,66231,54637,42930,25278
41086,1525,2343,24774,16312,3.15917e+13,462.576,5720.32,41086,593,271,38743,38644,36199,37295,34573
54047,3162,4033,38491,15556,5.82944e+13,1397.29,11405.1,54047,1536,454,50014,49903,46397,40750,42680
10275,333,765,6624,3651,2.91199e+13,377.269,2055.05,10275,303,156,9221,8603,8187,7931,5883
85824,1353,3936,58737,27087,4.57369e+13,1267.77,12684.9,85824,1394,478,80236,77384,60567,21391,26330
55873,2541,3092,39664,16209,3.14742e+13,926.253,10079.8,55873,1005,281,52781,52771,52687,52722,49715
86727,1098,4233,59967,26760,4.7907e+13,1397.2,14302.2,86727,1770,536,79493,75653,56357,28892,23324
27640,1057,2406,19301,8339,3.65062e+13,787.41,6664.37,27640,812,233,24898,23697,23140,21247,17275
55991,2973,3441,37082,18909,3.93163e+13,753.358,9049.19,55991,957,370,52550,52550,50882,48337,39317
60674,1325,2174,39511,21163,3.25915e+13,582.243,6593.75,60674,573,328,58500,58485,54403,52351,45250
89548,1681,4579,59237,30311,3.09433e+13,901.482,13971.5,89548,1357,368,84969,84243,79576,77161,41521
12201,1088,1197,8756,3445,2.59825e+13,539.317,3226.76,12201,670,116,11004,10786,10938,10978,10505
92161,2475,4210,63486,28675,4.68984e+13,1372.31,14638.2,92161,1801,529,87951,86277,73868,44983,52824
3796,126,407,2213,1583,3.11258e+13,133.92,802.806,3796,79,78,3294,3015,2644,2503,1215
3451,241,480,2248,1203,3.08693e+13,118.226,957.83,3451,151,72,2971,2928,2834,2842,2390
4519,1276,1453,3283,1236,3.79357e+13,195.081,2262.39,4519,437,99,3066,3066,2925,2983,2908
61984,2082,3190,38737,23247,2.93648e+13,568.109,8861.12,61984,948,324,58794,58767,58716,58778,52016
57262,2249,4055,40664,16598,5.79834e+13,1526.92,12039.3,57262,1641,501,53151,49731,40363,37034,37503
90640,939,4599,60010,30630,3.17651e+13,1037.88,14402.8,90640,1346,371,85039,82781,60969,45919,16959
11513,417,808,7426,4087,3.02912e+13,434.451,2220.13,11513,343,159,10457,9802,9512,9081,7079
85616,238,747,58093,27523,3.35968e+13,305.229,5028.4,85616,312,272,83157,79431,56142,37099,41959
1258,61,355,881,377,2.66308e+13,128.048,637.33,1258,201,52,549,214,287,290,342
61991,2380,3740,42956,19035,3.17175e+13,932.049,11305.1,61991,1023,303,58251,58145,57615,57754,43914
30166,1713,2799,21418,8748,4.58897e+13,840.223,7622.91,30166,835,302,27367,26452,23682,23993,21397
95070,3797,4194,60804,34266,2.97867e+13,817.113,13291.1,95070,1250,436,90876,90876,90876,90876,87948
88734,3645,3860,59974,28760,4.3043e+13,1233.61,12358.7,88734,1371,470,84874,84785,83703,80083,79981
53833,2910,3635,36513,17320,4.60027e+13,834.173,9542.38,53833,1028,424,50198,50067,47198,21473,27801
80898,1072,4397,53695,27203,3.08508e+13,905.162,12852.3,80898,1330,293,75964,74139,55079,47280,21244
17073,730,1137,11004,6069,3.0929e+13,444.976,3091.69,17073,357,215,15936,15905,14732,14527,12633
82767,3580,4323,59325,23442,4.90091e+13,1700.87,15011.2,82767,1757,557,78444,78301,76232,73283,73932
6256,110,675,4014,2242,2.85482e+13,296.789,1556.78,6256,251,134,5056,4638,3964,3603,2114
7322,170,725,4726,2596,3.02154e+13,336.657,1716.53,7322,284,145,6111,5783,5078,4517,2624
14066,134,1376,8642,5424,3.07871e+13,217.673,2998.73,14066,258,179,12117,11120,8982,4032,2196
17952,822,2496,13170,4782,5.58101e+13,1148.49,5523.42,17952,753,205,14593,13851,8301,9391,6106
24977,328,1833,16685,8292,4.34471e+13,440.182,4576.57,24977,416,226,22309,20446,17084,4106,2778
8387,62,1935,5935,2452,5.01579e+13,284.084,3345.47,8387,506,190,4819,3274,2301,1870,524
77236,15426,21660,63391,13845,2.41776e+13,4994.83,35040.5,77236,7294,22,55576,55576,51313,52601,47994
56936,1483,3636,36515,20421,2.91177e+13,508.144,9618.36,56936,1216,255,53300,53216,49242,47947,29538
15909,743,918,10280,5629,2.99363e+13,420.265,2678.28,15909,331,195,14991,14984,14621,14676,14305
53780,2328,2484,34315,19465,3.01647e+13,569.222,7483.51,53780,574,375,51296,51296,51139,51210,50345
86866,3229,4194,59523,27343,4.80357e+13,1395.56,13955.1,86866,1774,497,82672,82393,76601,47812,58422
9672,243,598,5656,4016,3.25769e+13,222.947,1416.57,9672,171,113,9030,8732,7320,6764,4943
92774,2534,4545,60563,32211,3.21403e+13,960.046,14116.8,92774,1182,395,88229,87804,86874,87605,61681
90899,3644,4470,64475,26424,4.19082e+13,1651.28,15462.9,90899,1693,450,86429,86332,82150,82466,79507
15044,844,1274,8825,6219,3.22057e+13,245.81,2472.06,15044,321,145,13770,13767,13696,13762,13629
60246,187,3742,41584,18662,3.11308e+13,848.188,10871.7,60246,1036,286,49839,41065,30358,13115,4312
45099,96,3369,32221,12878,5.40576e+13,1421.23,10007.1,45099,1297,344,31225,22464,15096,12040,2605
57172,1102,3075,37247,19925,2.93833e+13,570.811,8706.81,57172,1165,260,54065,53424,48675,40903,28365
80387,2950,3962,57842,22545,4.78361e+13,1739.15,14204.1,80387,1627,534,76425,75916,66629,67970,67375
85113,1171,4015,58516,26597,4.71217e+13,1294.93,13148.1,85113,1544,475,78992,75872,56420,25013,23264
97661,4205,4682,64507,33154,3.12394e+13,979.885,14932.5,97661,1368,397,92979,92947,92979,92979,90753
52610,1518,1586,33929,18681,3.0001e+13,581.252,5452.56,52610,518,321,51024,51024,50947,50942,50843
33635,72,2329,20105,13530,3.02597e+13,372.406,4891.79,33635,659,175,27324,24138,17886,2777,625
5917,227,485,3463,2454,3.25921e+13,160.891,1045.55,5917,120,88,5432,5174,4616,5006,3391
39589,784,1286,25458,14131,2.85107e+13,532.577,4457.02,39589,417,285,38303,38230,35378,35046,32286
69839,407,2722,44157,25682,3.04187e+13,634.774,8755.63,69839,584,423,65507,61428,52179,40617,24117
84632,3440,4319,60104,24528,4.20334e+13,1561.07,14752.4,84632,1533,450,80313,79994,74568,74966,70711
39392,460,1791,25829,13563,3.46151e+13,512.391,5176.25,39392,458,279,36988,34499,30690,4390,4688
30376,150,1134,19541,10835,2.93693e+13,548,3866.93,30376,439,243,25740,24213,21023,18068,8236
7042,1434,1466,4688,2354,5.85212e+13,267.036,2659,7042,503,108,5576,5576,5576,5576,5552
14158,1477,1835,9976,4182,3.65297e+13,406.661,4161.15,14158,558,135,12323,12053,12086,12260,11751
64362,2055,2582,41291,23071,2.9912e+13,583.74,8186.79,64362,655,400,61780,61775,60507,60237,58059
8002,804,1365,5554,2448,5.75616e+13,214.018,2543.86,8002,279,140,6637,6624,5958,3382,3379
96952,738,2992,61304,35648,3.00953e+13,728.231,10350.2,96952,655,458,93609,92618,76711,65717,50382
13448,372,1342,9830,3618,2.81408e+13,217.678,3481.59,13448,384,162,12106,11866,7730,7003,4083
45864,1562,1797,29864,16000,3.23606e+13,552.007,5527.79,45864,521,307,44067,44067,43603,43548,42536
5702,573,884,3717,1985,3.12489e+13,233.144,1738.65,5702,224,107,4818,4630,4587,4559,4191
6940,426,537,4060,2880,3.25111e+13,195.424,1178.06,6940,132,100,6403,6375,6196,6270,5765
51634,1094,3090,31927,19707,2.98136e+13,545.393,7954.16,51634,900,305,48544,48293,40050,31004,21641
74390,1762,21586,60619,13771,2.35748e+13,5720.32,34901.9,74390,6443,21,40385,32100,33026,19871,9158
92003,1072,4473,63556,28447,3.82167e+13,1328.93,15069.5,92003,1437,432,85189,81648,63765,50507,26121
62898,4093,4116,44075,18823,5.27696e+13,1312.6,12074.5,62898,1520,466,58782,58782,58775,58762,58739
59376,1671,2488,38025,21351,2.97166e+13,590.292,7775.95,59376,550,390,56888,56857,54536,51733,51013
22172,1110,1333,14509,7663,3.40157e+13,461.289,3664.21,22172,414,240,20839,20839,20499,20379,19530
33864,2099,3406,28782,5082,4.22248e+13,16.9898,4105.54,33864,1705,1700,30458,30458,22642,27197,26559
83855,2992,4199,58866,24989,4.86233e+13,1346.27,14598.7,83855,1752,531,79656,79431,73130,57686,63049
63986,2511,3792,45855,18131,5.26457e+13,1429.93,12382.9,63986,1462,509,60194,58976,51470,52231,51569
58014,1582,2364,37394,20620,2.99544e+13,614.945,7526.36,58014,564,363,55650,55605,53989,52042,48838
48125,1206,1914,31130,16995,3.03783e+13,565.825,6355.02,48125,550,341,46211,46194,44203,41954,32138
44932,2047,3042,29995,14937,3.92833e+13,665.626,7431.54,44932,752,329,41890,41582,37614,11511,14629
28593,1057,1124,18477,10116,2.97735e+13,501.345,3723.54,28593,368,248,27469,27467,27398,27390,27332
40617,979,3219,29048,11569,5.83438e+13,1485.77,9181.14,40617,1382,275,35171,32524,23011,21743,14970
43709,1690,3012,31248,12461,3.95284e+13,916.564,9176.63,43709,845,324,40697,39635,36976,35113,31775
50616,1520,2130,32643,17973,2.94201e+13,586.676,6806.53,50616,508,352,48486,48471,47088,46101,42878
76315,1055,3658,48019,28296,2.96005e+13,729.083,10616.1,76315,967,411,72643,72141,59636,39076,31215
9889,673,778,6398,3491,3.12806e+13,354.73,2074.85,9889,255,158,9111,9065,9075,9083,8943
94438,8238,9601,80179,14259,4.21378e+13,18.054,10839.7,94438,4722,3164,84837,84837,77095,81546,80767
41585,610,1817,26853,14732,2.97955e+13,518.946,5459.77,41585,423,283,39759,38528,34723,34388,28803
21751,890,2883,15065,6686,5.14439e+13,445.078,5839.97,21751,699,322,18868,18573,11938,4305,3333
36776,1320,1973,21984,14792,3.13779e+13,364.618,4866.15,36776,453,235,34803,34737,30022,30619,25953
9669,114,792,6208,3461,2.94896e+13,354.768,2057.31,9669,303,157,7822,7075,6201,5474,2746
56989,1014,2116,36743,20246,2.93257e+13,576.716,6953.7,56989,556,339,54873,54807,51408,50540,43001
27014,21,1060,17510,9504,3.01696e+13,484.354,3556.76,27014,384,241,13409,5657,7935,2675,1491
67473,3544,3814,46033,21440,4.5979e+13,1165.09,11253.5,67473,1355,456,63659,63464,62705,59926,55246
86035,3070,4452,57014,29021,3.09949e+13,906.279,13536.6,86035,1352,354,81583,81515,81433,81182,68467
77820,1409,4005,52491,25329,3.14229e+13,1024.44,12704.9,77820,1216,323,73535,71816,64614,54490,29202
63731,3477,3776,43832,19899,4.83186e+13,1153.67,11160.2,63731,1341,464,59955,59778,58960,56151,49093
61464,2057,18821,50457,11007,2.64741e+13,4296.03,29198.2,61464,7115,21,36098,28996,30452,22112,7442
68254,951,3601,43147,25107,2.92326e+13,578.531,10079.7,68254,1074,336,64653,64122,51999,33765,27430
56496,1236,2031,36501,19995,2.98727e+13,573.08,6889.46,56496,525,348,54465,54448,51849,50363,40084
14637,258,813,8557,6080,3.2261e+13,246.519,1979.56,14637,228,142,13757,13255,10488,8542,7219
46066,2073,2301,28881,17185,3.02371e+13,515.131,6490.26,46066,470,348,43765,43765,43306,43511,42133
32277,8772,13538,26553,5724,2.39754e+13,1112.9,18568.9,32277,4069,16,18739,17652,15967,17257,14023
55660,2626,3925,39072,16588,5.49603e+13,1184.8,10987.3,55660,1370,468,51735,50722,44498,28771,34184
9021,38,944,5813,3208,3.02979e+13,322.811,2191.38,9021,288,150,5425,2896,3660,2152,941
17514,40,1364,11336,6178,3.01814e+13,386.75,3474.27,17514,364,235,10927,5942,7626,5532,1373
52216,98,3550,33261,18955,2.97898e+13,509.185,9057.19,52216,1190,242,39654,30684,25019,5599,2324
5276,49,454,3078,2198,3.2286e+13,168.637,975.235,5276,111,88,4288,3946,2946,1472,808
85854,2650,3436,56283,29571,3.43024e+13,924.275,10340,85854,714,366,82418,82396,81158,79646,71146
15367,1326,1436,11074,4293,2.88757e+13,332.289,3909.05,15367,442,165,13931,13915,13888,13878,12992
84689,2629,4159,59264,25425,4.88318e+13,1322.98,14434.6,84689,1749,543,80530,79645,70679,51757,55762
91003,2136,2951,57734,33269,2.99604e+13,731.967,10036.2,91003,670,449,88052,87824,83106,79417,76396
66962,559,4180,47610,19352,5.37556e+13,1459.54,13286.7,66962,1674,521,56772,53407,35014,26614,15522
97820,713,4181,66953,30867,4.57788e+13,1338.93,14581.8,97820,1794,520,88631,85803,61554,25055,17160
12471,403,777,8019,4452,2.88444e+13,395.049,2230.68,12471,316,169,11458,10722,10442,10074,8620
68548,595,2685,43664,24884,3.02207e+13,603.468,8594.88,68548,591,422,65489,64098,54196,47416,30489
26469,1447,1691,19168,7301,3.06369e+13,476.605,5135.05,26469,473,194,24778,24656,24350,24565,22270
3812,77,634,2471,1341,3.11604e+13,174.976,1253.32,3812,172,110,2903,2289,2223,1908,432
47213,2995,3045,28808,18405,3.06462e+13,506.319,7066.62,47213,680,298,44168,44168,44168,44168,44161
30784,459,1668,19834,10950,2.93597e+13,501.921,4943.43,30784,432,283,28709,27130,24885,23917,13531
43279,1847,3319,30671,12608,5.50001e+13,1472.06,9709.02,43279,1295,341,39546,36516,30324,31067,25544
30269,799,2593,21301,8968,3.78043e+13,791.778,7218.37,30269,817,262,26963,25712,23799,21918,16972
18009,865,1866,12777,5232,3.52311e+13,499.257,4666.17,18009,595,143,16093,15620,15186,15178,13023
68325,1917,2309,44136,24189,2.93296e+13,591.939,7668.06,68325,583,350,66016,66016,65354,65165,63481
6814,458,927,4954,1860,2.66777e+13,172.03,2035.81,6814,231,102,5887,5881,5560,5646,5206
48335,1719,2351,30440,17895,3.01983e+13,528.392,6895.93,48335,497,369,45984,45957,42912,43620,36853
71531,3622,3909,48711,22820,3.14463e+13,979.172,12231.3,71531,1112,307,67622,67528,67622,67622,65408
3207,599,1023,2734,473,3.97588e+13,4.90302,1657.13,3207,459,12,2184,2184,2184,2184,1340
3821,135,578,2422,1399,2.67028e+13,177.219,1137.22,3821,184,102,3154,3071,2677,2211,754
10119,266,606,5916,4203,3.23612e+13,215.664,1438.71,10119,172,113,9500,9277,7911,7868,5972
58388,2996,3686,40021,18367,4.63502e+13,1041.04,10374.6,58388,1220,431,54702,54545,52161,28012,32692
77894,2396,3902,51806,26088,3.10838e+13,878.963,11906.5,77894,1295,288,73992,73723,72354,73049,59312
12362,1645,1876,8535,3827,3.81804e+13,404.028,3982.68,12362,526,142,10486,10450,10436,10456,9865
18574,92,951,11933,6641,2.95656e+13,464.3,2918.68,18574,329,213,14917,12420,11000,10153,3549
57513,3369,5736,48936,8577,4.19729e+13,17.1139,6667.29,57513,2871,2866,51777,51777,37603,45868,43592
15328,1203,2555,11396,3932,6.70428e+13,695.675,5070.23,15328,674,254,12773,12025,8055,7997,8718
22975,2134,3003,17023,5952,6.91496e+13,1312.44,6736.44,22975,879,268,19972,18347,16605,17010,16543
16759,737,1224,9940,6819,3.18624e+13,269.049,2626.25,16759,268,135,15535,15522,12841,12992,9975
13194,1489,2167,9014,4180,4.88573e+13,487.413,4419.3,13194,784,168,11027,10974,10367,10627,9473
10661,1537,1674,7493,3168,2.71125e+13,334.102,3371.13,10661,441,127,8987,8932,8978,8987,8867
47988,1175,3280,34254,13734,3.90542e+13,920.577,9892.19,47988,936,328,44292,42618,37832,37098,22908
66651,3150,3455,44049,22602,3.77159e+13,791.115,9486.79,66651,923,356,63196,63193,62206,60639,56088
84856,1331,3928,55794,29062,2.98306e+13,731.734,12346.2,84856,1241,401,80928,80181,66089,57839,34908
59821,5843,25216,47861,11960,128063000,1011.6,36958.4,59821,6009,11,34605,29888,26243,34605,7020
19945,373,405,13474,6471,3.32147e+13,287.732,2303.78,19945,260,169,19540,19540,19421,19317,19172
83251,1546,3902,57201,26050,4.68395e+13,1272.15,12562.1,83251,1367,478,78105,75209,59781,24384,31241
20332,8244,9052,16802,3530,2.78933e+13,534.434,12237.3,20332,2075,12,11280,11161,11280,11280,9666
19897,889,1743,13348,6549,4.58825e+13,381.279,4102.95,19897,334,214,18154,18118,16251,5957,6216
8810,439,569,5160,3650,3.25396e+13,216.423,1340.31,8810,159,101,8241,8220,7951,8040,7599
79794,6316,7981,67851,11943,4.21252e+13,17.0433,9075.17,79794,3994,3988,71813,71813,61851,67659,66644
15130,683,811,8825,6305,3.18603e+13,261.184,2010.8,15130,228,131,14319,14306,13975,14112,13599
56329,1376,2101,36176,20153,2.85251e+13,555.706,6859.43,56329,550,340,54228,54217,52893,51629,45319
61272,706,4084,43040,18232,5.37726e+13,1320.28,11957,61272,1568,463,53289,51338,32839,18925,10151
31984,3521,13731,26067,5917,2.51271e+13,2441.38,18846.8,31984,3049,16,18068,14127,13710,15841,7101
75822,2921,29863,61559,14263,1.70448e+12,101.958,31573.4,75822,1656,157,45959,45918,6110,10638,8763
29421,674,1690,17920,11501,3.12878e+13,305.49,4366.69,29421,334,242,27731,27691,21832,13250,11391
21176,5745,7432,17281,3895,1.73515e+13,124.561,9159.12,21176,578,131,13744,13744,11743,12492,12057
15852,1115,1745,9811,6041,2.69747e+13,293.898,3575.63,15852,577,132,14107,14107,13908,14100,10705
63870,1771,3997,45490,18380,3.64528e+13,1070.87,12104,63870,1052,392,59873,58632,53204,52886,34551
11607,152,699,7457,4150,2.84932e+13,369.841,2057.27,11607,266,157,10089,9660,8343,8180,4002
72008,4019,4260,50936,21072,5.20192e+13,1407.22,13724.8,72008,1771,530,67748,67738,67447,66801,64238
55991,2225,3111,34561,21430,2.94412e+13,555.496,8077.19,55991,719,308,52880,52870,52829,52874,50198
77863,3529,3747,52372,25491,4.1535e+13,1115.28,11061.7,77863,1172,441,74116,73903,73398,71861,70045
26855,1320,1523,17362,9493,2.97452e+13,429.338,4431.06,26855,409,265,25332,25330,24971,24884,23828
74778,1638,2807,48468,26310,3.18571e+13,656.173,8332.23,74778,605,353,71971,71868,68448,65702,59425
1289,132,417,836,453,3.52701e+13,93.8867,662.578,1289,104,70,832,762,659,579,472
1204,85,215,758,446,2.40774e+13,80.3347,420.458,1204,74,48,958,780,848,803,634
60829,36,3459,43956,16873,4.48719e+13,1259.87,11653.2,60829,1211,369,32090,16811,13773,8630,1501
18455,1627,1819,11650,6805,2.60834e+13,307.675,3966.06,18455,627,141,16636,16636,16632,16636,16150
16982,1194,1972,11582,5400,2.43516e+13,334.118,4384.7,16982,671,174,15010,15004,14021,14065,11357
42917,1611,2892,30566,12351,4.51325e+13,1097.08,9223.47,42917,1080,322,39814,37960,34447,32933,29106
19148,7866,8513,15855,3293,1.96553e+13,371.966,11533.5,19148,2647,12,10635,10587,10635,10635,10635
9335,681,2028,6727,2608,7.30113e+13,206.68,3514.75,9335,414,142,7307,7222,6123,6262,4117
1595,85,177,1355,240,4.20845e+13,16.79,315.494,1595,91,86,1418,1418,889,1194,1161
26085,247,1012,16776,9309,2.94525e+13,521.978,3442.37,26085,431,224,23345,21838,20641,19908,11131
43465,586,1288,27981,15484,2.92836e+13,555.287,4655.98,43465,449,288,42117,40308,37043,35784,32258
87239,1559,2727,56495,30744,3.07139e+13,730.895,9190.75,87239,687,393,84512,84344,79891,78653,65892
25806,210,1060,16598,9208,2.8817e+13,518.827,3509.2,25806,368,237,22597,21009,19302,19168,8206
98409,2885,2971,62716,35693,2.94271e+13,706.561,10253.3,98409,710,438,95438,95438,95408,95435,94934
20572,1067,1488,13351,7221,2.99645e+13,457.751,3960.23,20572,407,227,19084,19076,18413,18255,16234
16881,2907,2923,12491,4390,6.26754e+13,931.316,5713.64,16881,728,249,13958,13958,13958,13958,13948
85270,1856,4495,56444,28826,3.09179e+13,912.837,13519,85270,1344,357,80775,80217,77657,78348,40852
70365,1813,2369,45499,24866,2.96832e+13,599.955,7874.42,70365,603,372,67996,67984,66885,66116,61399
70580,2703,3956,48947,21633,4.95376e+13,1265.52,11986.5,70580,1409,482,66624,66220,58461,31433,41746
55584,73,2159,35783,19801,2.92162e+13,546.412,6931.03,55584,564,345,42904,31889,32822,30036,6088
1893,326,470,1215,678,3.24168e+13,102.034,814.488,1893,114,77,1423,1367,1338,1362,1239
7371,473,968,5180,2191,3.24246e+13,364.125,2276.05,7371,413,101,6313,5918,5039,5641,3032
28630,1602,1723,20735,7895,3.0277e+13,475.356,5347.16,28630,500,200,26907,26907,26837,26827,25998
19322,286,1045,12454,6868,3.00522e+13,441.53,3085.79,19322,315,204,17464,16207,15285,14845,7920
29377,711,2280,20604,8773,3.61989e+13,685.371,6669.35,29377,698,205,26411,25263,24084,22989,15631
12405,770,1198,8830,3575,2.59183e+13,537.528,3252.9,12405,670,117,11207,10904,9924,10195,9310
55618,1304,3502,38812,16806,3.07037e+13,851.155,10234.1,55618,992,281,52116,50699,45163,40670,23092
87857,2479,4335,59168,28689,3.43222e+13,1109.26,13891.1,87857,1313,394,83522,82992,79478,78633,63109
41209,312,3369,27697,13512,4.38194e+13,702.973,8286.43,41209,958,412,35237,31855,25047,5406,4305
84801,1542,3953,55180,29621,2.95467e+13,685.937,12303.1,84801,1252,386,80848,80526,70910,68938,44991
68476,11570,19823,56467,12009,2.41004e+13,4085.82,31562.3,68476,7199,21,48653,43332,43340,42412,34774
32965,1402,1526,21257,11708,2.94188e+13,547.592,4612.52,32965,464,275,31439,31433,31207,31009,31258
51512,154,3123,34270,17242,3.87923e+13,692.662,8066.28,51512,833,330,42353,39218,30680,4059,1990
87574,893,4132,60110,27464,4.68678e+13,1299.96,13491.4,87574,1591,467,80187,77386,56227,21956,15744
19001,1874,2540,14034,4967,5.82095e+13,1169.12,5752.99,19001,747,231,16461,15163,14512,14808,13665
93388,3755,4035,58959,34429,3.09072e+13,966.083,12389,93388,956,458,89353,89353,89353,89353,88295
70137,271,3695,46398,23739,2.97727e+13,713.107,10635.2,70137,1212,289,63123,59565,38119,8714,2365
15250,745,1182,10057,5193,3.70797e+13,389.072,3014.31,15250,318,200,14068,14048,12980,12362,8649
16381,735,1856,11587,4794,3.62737e+13,456.807,4481.82,16381,602,141,14411,13891,13452,13240,11166
88271,3512,4187,56255,32016,2.96256e+13,788.126,12761.9,88271,1214,427,84084,84066,84084,84084,79844
49943,263,2916,35442,14501,3.04279e+13,910.259,9102.48,49943,928,252,42453,38787,24855,6863,3907
18816,1775,2550,13423,5393,5.84397e+13,778.622,5554.75,18816,745,207,16266,15598,13259,13947,13123
94852,591,3911,64510,30342,4.37934e+13,1294.7,13196.2,94852,1421,474,86384,82354,59596,17583,10645
95497,500,4536,63099,32398,3.02671e+13,997.64,14368.7,95497,1302,414,88205,84294,58629,39138,16799
12937,378,817,8348,4589,2.96331e+13,421.511,2349.48,12937,346,170,11774,10979,10644,10218,7609
92120,1988,4675,61164,30956,3.17515e+13,1042.69,14678.2,92120,1366,375,87445,86841,84618,85807,44089
97827,3923,4407,68949,28878,4.51387e+13,1546.64,16192.5,97827,1825,575,93420,93384,92178,76758,80563
71231,9549,20992,58053,13178,2.3966e+13,5604.25,33684.8,71231,6182,21,50239,39503,41904,44390,29612
5682,495,626,3618,2064,2.65515e+13,220.972,1402.59,5682,182,106,5056,4885,4897,4860,4707
65588,446,4096,46216,19372,5.43671e+13,1434.27,12737.2,65588,1693,507,54842,51015,32696,18982,8936
39359,68,2626,27030,12329,2.80764e+13,531.695,7278.33,39359,903,254,25834,17991,14029,4030,2084
17918,254,925,11526,6392,2.8795e+13,459.986,2832.28,17918,345,210,15938,14647,13878,12897,5191
15287,2623,2883,11255,4032,6.5068e+13,586.305,5380.38,15287,670,230,12404,12287,12180,12287,12199
55486,2155,3609,34688,20798,2.97176e+13,532.927,9117.24,55486,1058,310,51877,51849,51628,51861,43116
92111,3205,3264,59545,32566,3.15825e+13,860.599,10378.6,92111,741,429,88847,88847,88830,88847,88686
39164,2240,3927,33302,5862,4.2134e+13,17.0355,4687.84,39164,1967,1962,35237,35237,25142,31026,29552
30292,7037,13286,24820,5472,2.43359e+13,1477.5,17970.5,30292,2842,16,17006,15149,14876,15617,8920
91152,2503,4111,58298,32854,2.96852e+13,796.805,12809.8,91152,1194,431,87041,86856,85981,86356,70633
34607,658,2301,24320,10287,3.48045e+13,806.327,7297.16,34607,794,213,31069,29790,27141,25937,16525
93386,3608,4470,64223,29163,3.83919e+13,1334.74,15191.7,93386,1447,429,88916,88689,83900,84592,79960
16341,1623,2480,11750,4591,5.88589e+13,505.023,5182.35,16341,611,227,13861,13663,9861,10099,9659
53942,327,3385,35885,18057,3.99593e+13,722.797,8892.07,53942,903,368,47570,43034,35232,5566,2742
33865,1471,1644,21887,11978,2.95644e+13,612.018,4909.98,33865,473,298,32221,32220,31909,31877,31752
6297,414,828,4469,1828,3.12498e+13,334.048,1994.9,6297,391,96,5410,5119,3933,3888,2568
51498,600,3223,35595,15903,2.86368e+13,616.057,8813.1,51498,941,277,47559,45377,32116,18040,10287
42397,1774,2891,25937,16460,2.99284e+13,453.236,6801.3,42397,696,259,39506,39456,39173,39244,35611
49001,687,2077,30248,18753,3.09616e+13,497.609,6193.87,49001,411,313,46856,46280,37289,24373,24131
77700,998,2786,49630,28070,2.98404e+13,636.439,9126.78,77700,637,424,74914,74630,66077,60492,46902
27921,730,3549,20208,7713,6.30845e+13,971.662,7786.37,27921,948,413,23181,22381,11241,7848,4091
39745,544,2163,25449,14296,2.98947e+13,562.765,6168.32,39745,489,333,37244,36032,31147,28275,14300
1223,83,218,770,453,2.55444e+13,75.3148,428.774,1223,82,44,980,785,842,816,593
78391,2643,4309,53514,24877,3.8827e+13,1256.32,13698.2,78391,1407,405,74082,73567,69099,67364,52448
94735,1993,3965,60106,34629,2.92604e+13,879.943,12526.4,94735,1075,446,90770,90255,83231,82817,63034
93937,3730,4025,59811,34126,2.96245e+13,862.477,12608.9,93937,1088,447,89912,89912,89912,89912,89147
47065,2568,3565,33674,13391,5.6149e+13,1610.97,10362.8,47065,1434,388,43500,42606,39773,40049,39119
37260,618,1258,24166,13094,3.0863e+13,531.524,4371.34,37260,415,271,35999,35264,31912,31282,28040
99016,3954,4060,62954,36062,2.92534e+13,894.62,12912.2,99016,1103,451,94956,94956,94956,94956,94606
87310,3162,4024,57616,29694,2.97923e+13,751.091,12670.9,87310,1258,402,83286,83284,83264,82957,73075
66092,249,4042,46998,19094,3.74121e+13,1177.98,12504.2,66092,1137,401,54677,48985,31324,12058,2563
20577,103,2448,14413,6164,5.01365e+13,882.368,5926.22,20577,797,262,14224,10647,7345,7499,1655
79408,659,3674,52279,27129,3.63782e+13,1076.73,10638.7,79408,965,364,74914,73455,57627,9127,7975
98774,3758,4362,69482,29292,4.5679e+13,1543,16222.9,98774,1804,576,94412,94313,92862,76375,80298
37615,2808,2878,26574,11041,4.62246e+13,1069.28,8633.69,37615,990,312,34737,34721,34715,34720,34547
65561,3582,3622,41431,24130,2.94913e+13,565.836,9968.23,65561,1086,320,61939,61939,61939,61939,61819
88937,2520,4450,62484,26453,4.14649e+13,1568.88,15206.3,88937,1561,452,84375,83334,74698,73438,57660
60644,2048,3601,41754,18890,3.07034e+13,790.624,10631.4,60644,1052,286,57043,56952,55282,56219,39355
81210,38248,44433,71143,10067,8.63719e+11,17.7419,45037.3,81210,3064,51,36777,36777,31906,35155,31992
87876,1976,3818,59100,28776,4.15159e+13,1221.85,12131.1,87876,1380,461,83769,81213,67494,24032,36323
88646,3984,4286,56968,31678,2.95294e+13,806.727,13083.4,88646,1258,409,84360,84322,84360,84360,82218
51798,918,1997,33405,18393,3.01857e+13,564.792,6608.48,51798,516,346,49801,49627,45591,45019,32169
90580,1324,3602,56856,33724,2.95004e+13,944.931,11226.6,90580,741,452,86978,86237,75476,54891,48622
84113,1109,4152,57686,26427,4.73841e+13,1260.53,13368.3,84113,1597,470,77581,74439,55222,24808,19426
57144,100,2557,35602,21542,3.04763e+13,586.484,7634.34,57144,544,375,47946,43167,35015,21171,5155
26499,1352,1742,16506,9993,3.09193e+13,427.727,4520,26499,366,258,24757,24754,23267,23912,20990
31433,1730,2094,22604,8829,2.72907e+13,632.93,6069.17,31433,783,235,29339,29335,28828,29123,25795
32332,1416,2304,23243,9089,2.85089e+13,623.265,6514.21,32332,636,202,30028,29643,29095,29598,24338
31542,1048,1173,20339,11203,2.98901e+13,539.796,3956.15,31542,443,255,30369,30369,30156,30144,29941
48276,1349,1941,31118,17158,2.97063e+13,530.539,6366.57,48276,505,347,46335,46325,44778,43379,35192
64735,1531,3796,46618,18117,5.35409e+13,1427.4,12405.3,64735,1463,524,59724,55578,44203,41285,34744
75472,9519,21512,61774,13698,2.70571e+13,5241.24,34168.5,75472,7793,22,53960,43215,44960,48361,29331
58829,1196,3589,42241,16588,5.00891e+13,1440.98,11611.5,58829,1453,355,53051,49495,40127,36389,28651
1177,230,294,773,404,3.27626e+13,64.7579,502.964,1177,92,46,883,883,845,876,837
74403,2411,4005,49354,25049,2.88777e+13,844.134,11539.1,74403,1217,294,70398,70092,69121,69914,47853
42575,4211,15075,35313,7262,2.61088e+13,1711.25,21761.4,42575,5197,17,27500,23122,20980,24802,12592
46707,68,3243,33429,13278,3.85735e+13,899.613,9677.73,46707,883,325,31611,22596,15964,4785,2330
67576,691,3591,45022,22554,4.01943e+13,846.619,9952.92,67576,1014,419,63095,62091,48326,9325,9729
80010,785,3267,52395,27615,3.48042e+13,892.908,9616.75,80010,744,370,76354,75594,59901,8013,9127
54774,1665,2343,35949,18825,3.70268e+13,564.152,6732.46,54774,539,306,52431,52418,50186,50024,43104
85968,1886,4406,58596,27372,3.61462e+13,1130.95,14077.4,85968,1263,419,81562,80401,73426,64928,48293
12003,2142,3441,10289,1714,1.99047e+13,5.13538,5924.99,12003,1719,7,8562,8562,8562,8562,5968
97957,338,3030,61846,36111,2.99043e+13,723.051,10440.3,97957,675,465,91083,85066,73919,58988,27860
41386,91,1306,26702,14684,2.94081e+13,580.505,4556.6,41386,501,285,33564,28295,24857,23064,7293
55358,2260,3442,39696,15662,4.23231e+13,1260.03,11045,55358,1185,359,51916,50381,46479,46883,41021
32950,295,1135,21234,11716,2.93771e+13,554.308,3959.28,32950,479,244,30097,27892,26706,25607,15871
75329,287,690,51123,24206,3.36203e+13,303.911,4682.75,75329,309,265,74186,72207,51834,49894,44549
61187,2575,3097,40953,20234,2.95244e+13,639.944,9215.58,61187,1091,278,58090,57946,57889,57930,51003
13754,43,367,9316,4438,3.31272e+13,268.654,1882.84,13754,235,144,6036,2770,3285,3160,2909
41420,538,1326,26600,14820,2.8827e+13,562.467,4638.49,41420,466,284,39912,37777,34735,33282,25652
27434,2057,3236,19958,7476,6.46827e+13,1205.16,7374.69,27434,991,429,24198,22487,17817,19132,18801
46769,1134,3839,33622,13147,5.88818e+13,1380.11,10369.9,46769,1295,464,41019,38420,23911,18265,13595
89650,1633,4399,61556,28094,3.64271e+13,1291.4,14682,89650,1433,419,84650,82009,74906,65630,39234
63007,2134,2600,40287,22720,2.96188e+13,590.78,8160.65,63007,630,401,60407,60396,59224,59510,56267
3166,360,776,2223,943,3.49434e+13,168.569,1382.21,3166,314,72,2390,2280,1913,2120,1777
31479,871,1167,20350,11129,2.98203e+13,515.632,3924.99,31479,443,265,30312,30276,29119,28835,28386
40930,61,1315,26315,14615,2.89312e+13,562.197,4579.07,40930,493,294,29859,20694,23040,21977,5258
59516,3365,3654,37991,21525,2.98932e+13,526.402,9863.52,59516,1226,283,55862,55862,55862,55862,53367
74908,1096,4154,52942,21966,3.73674e+13,1297.29,13505.9,74908,1377,420,69107,65717,50134,44427,19183
64521,210,3721,44017,20504,4.4527e+13,1085.38,10695.9,64521,1227,427,53361,48527,36517,7494,3556
85195,921,2670,55120,30075,3.05803e+13,710.871,8977.29,85195,645,391,82525,82212,71013,68603,45256
40689,14955,15328,33175,7514,2.91111e+13,3543.7,21880.8,40689,4848,17,25361,25361,25361,25361,24617
17792,840,1795,11285,6507,2.56005e+13,298.909,3937.59,17792,619,142,15997,15968,14754,14943,10382
83559,2705,4484,55496,28063,3.15147e+13,995.857,13406.7,83559,1334,303,79075,78663,78646,78575,60080
77533,195,713,52621,24912,3.36254e+13,304.552,4768.43,77533,310,267,73461,60538,50721,29644,38698
3089,426,703,2170,919,3.04392e+13,129.048,1294.11,3089,223,61,2386,2382,1611,1502,1018
46499,3286,3656,31625,14874,4.7278e+13,749.608,9101.87,46499,1029,418,42843,42827,41853,40340,34141
51257,3361,3420,36731,14526,4.0034e+13,932.347,10433.6,51257,953,346,47837,47837,47837,47793,47658
71118,954,2779,44447,26671,3.03053e+13,633.63,8810.5,71118,598,428,68339,67922,56874,43027,34050
66223,923,3730,44806,21417,3.07833e+13,809.309,11032.4,66223,1150,282,61855,60390,49357,35451,19787
75637,290,3910,49435,26202,2.95136e+13,637.236,11490.6,75637,1240,349,68463,64686,44292,18355,9166
2880,81,614,2108,772,8.02353e+12,362.033,1146.31,2880,219,57,1519,561,585,1424,1327
5285,481,1446,4243,1042,8.61121e+13,170.921,2164.16,5285,296,124,3839,3765,876,908,11
26220,1378,1572,16890,9330,2.91455e+13,502.586,4416.95,26220,401,256,24648,24646,24401,24331,24208
65849,1064,2719,40970,24879,3.03876e+13,620.984,8404.05,65849,563,407,63130,62819,52515,37005,29579
39171,1750,2687,23545,15626,3.15659e+13,434.941,5907.63,39171,603,257,36484,36450,35889,36140,34554
87909,4017,4518,58184,29725,3.09326e+13,895.684,13777.7,87909,1353,368,83391,83391,83391,83391,81761
68584,3104,3878,47719,20865,5.00664e+13,1279.77,12004.8,68584,1434,470,64706,64499,60905,38868,45665
65642,843,2115,42454,23188,2.95483e+13,573.041,7365.28,65642,563,364,63527,63154,57507,57177,44207
32017,732,1387,20774,11243,3.14333e+13,498.41,4251.75,32017,433,265,30630,30559,27428,26095,20503
1062,877,1062,798,264,3.47927e+13,0,1062,1062,136,8,0,0,0,0,0
60224,637,2588,37294,22930,3.09466e+13,618.719,7679.46,60224,498,396,57230,56309,43325,28658,16134
15233,1796,1994,10189,5044,4.21353e+13,795.979,4543.22,15233,676,176,13239,12915,13162,13214,11991
76176,2032,3897,52628,23548,4.84866e+13,1235.17,12236.7,76176,1377,481,72025,68702,55902,27592,35684
61179,1157,3559,43709,17470,3.9514e+13,1107.28,11608.2,61179,1162,362,56728,54120,47933,47870,29352
17245,639,1892,10319,6926,3.02833e+13,247.024,3393.23,17245,413,138,15353,15282,14253,14670,12532
8862,169,940,5731,3131,3.0111e+13,322.864,2162.03,8862,276,150,7418,6774,6143,5714,2487
53803,192,2260,35237,18566,3.49853e+13,539.874,6510.6,53803,545,332,46631,43312,37030,4897,3281
16413,573,831,10596,5817,2.94452e+13,414.914,2586.34,16413,312,197,15582,15303,14790,14562,14004
4369,250,873,2985,1384,4.58117e+13,276.357,1669.75,4369,314,73,3295,2850,2632,2737,1416
38148,1142,2349,27399,10749,2.82401e+13,628.277,6866.94,38148,805,250,35799,35056,29098,26347,21009
33064,138,3379,24323,8741,6.49989e+13,1402.83,8359.41,33064,1045,403,23375,18724,9895,8644,2306
16900,1645,2737,12226,4674,6.9358e+13,646.387,5375.12,16900,666,399,14163,13695,9157,9842,10191
65592,2348,19532,53874,11718,2.27659e+13,4435.44,31155.6,65592,6249,21,39511,31134,30840,19651,16181
53584,1637,3893,37742,15842,5.58079e+13,1143.62,10731.8,53584,1338,459,49047,46690,35249,22022,25658
81828,716,2826,51869,29959,2.93614e+13,638.957,9385.9,81828,677,433,78801,77946,66793,59548,43006
20752,518,1547,13156,7596,3.02977e+13,457.56,3956.82,20752,368,236,19029,18538,15731,13491,9497
65717,460,2124,42309,23408,2.92577e+13,534.892,7143.58,65717,541,337,62494,57901,53351,52105,31177
52202,2990,5237,44372,7830,4.22184e+13,16.9938,6109.68,52202,2622,2618,46965,46965,33502,41351,40242
58697,2275,2502,36605,22092,3.03245e+13,577.888,7701.23,58697,491,396,56195,56161,55630,55821,54629
68457,1838,3897,46488,21969,3.13509e+13,884.272,11711.6,68457,1117,295,64560,64088,61995,55119,40543
99811,855,4342,70766,29045,4.55825e+13,1618.82,16465,99811,1894,577,90578,86516,61600,50091,22284
86229,65,4301,60771,25458,4.80344e+13,1332.75,14983.2,86229,1783,539,58279,41745,31005,14429,4233
11211,639,1005,8185,3026,2.99535e+13,197.488,2674.6,11211,307,144,10206,10198,9711,9981,6084
14809,590,812,8636,6173,3.2019e+13,253.656,1982.56,14809,231,137,13997,13978,13383,13646,12634
79861,3991,4185,57037,22824,4.19541e+13,1331.44,14117.4,79861,1396,453,75676,75674,75587,74615,74082
51767,403,3158,32225,19542,2.88237e+13,489.224,8161.36,51767,936,299,47581,44972,33017,17192,7047
3035,425,518,2007,1028,3.2831e+13,117.151,1001.47,3035,138,86,2517,2507,2466,2503,2445
99344,3700,4894,66764,32580,3.46032e+13,1272.79,15878.9,99344,1409,470,94450,94213,93157,92371,84832
65935,3290,3611,43694,22241,3.87102e+13,841.937,9841.88,65935,990,424,62324,62322,61209,59982,56792
81642,728,2499,52527,29115,2.91773e+13,616.596,8422.03,81642,630,363,79143,78111,68963,67661,51915
82848,3016,4219,55809,27039,3.2661e+13,1095.1,13347.5,82848,1272,366,78629,78371,77585,76441,70333
79927,753,2828,50006,29921,3.01079e+13,668.093,9344.17,79927,554,455,76854,75875,62278,48306,36537
63198,15565,19452,51560,11638,2.65649e+13,5183.78,30319.8,63198,6852,22,43746,43746,41727,42077,40252
89799,1081,4308,59275,30524,2.91518e+13,963.642,13406.7,89799,1248,405,85023,83588,63346,47839,20377
25353,2352,3388,17824,7529,5.93943e+13,671.064,7160.44,25353,912,397,21965,21688,17177,13199,14364
20918,701,1578,15063,5855,3.09506e+13,502.485,4637.02,20918,508,187,19204,18421,15369,14783,8403
83951,2295,2820,53321,30630,2.97585e+13,688.846,9538.13,83951,618,440,81131,81010,78013,78862,72566
1528,9,245,1002,526,2.94711e+13,76.413,497.314,1528,69,52,477,173,147,105,85
26284,2669,3126,19253,7031,6.36686e+13,1251,7217.34,26284,1017,304,23158,23132,22550,22568,21962
2276,271,508,1467,809,3.11662e+13,103.938,902.507,2276,128,95,1768,1682,1653,1644,1211
95213,1321,3611,62504,32709,3.45935e+13,1151.96,11511.6,95213,850,386,91341,90483,74028,12146,16687
55704,473,3438,35125,20579,2.95154e+13,458.456,8918.23,55704,1060,268,51736,49178,36218,19645,14255
65492,1963,2640,41254,24238,3.03981e+13,607.806,8322.45,65492,546,401,62852,62748,58675,59557,50411
98831,763,4216,63136,35695,2.96812e+13,866.335,13506.9,98831,1249,450,93937,92609,73376,52960,35984
73819,3502,3510,46043,27776,2.99111e+13,835.237,10081,73819,733,417,70309,70309,70309,70309,70309
75831,175,3987,50899,24932,3.20089e+13,946.295,12292.1,75831,1208,303,63574,52448,39367,11960,8444
38985,1691,2651,24367,14618,2.86773e+13,350.387,6448.49,38985,959,177,36334,36334,35904,35112,27699
77879,2671,4290,56007,21872,4.98893e+13,1681.1,14393.1,77879,1614,550,73584,72239,59812,61693,58615
13677,2291,2662,10085,3592,6.53291e+13,627.67,4881.3,13677,689,167,11015,10741,10970,11015,10281
96736,4050,4289,63136,33600,2.95724e+13,826.036,13749.9,96736,1250,435,92447,92430,92447,92447,90441
5406,451,630,3466,1940,3.05376e+13,270.198,1447.46,5406,180,142,4776,4527,4527,4411,3884
58847,733,2064,37852,20995,2.92367e+13,593.838,7084.77,58847,563,363,56732,55958,50709,48896,35601
24958,935,1110,16163,8795,2.98517e+13,463.517,3473.29,24958,363,222,23848,23767,23433,23156,23222
97924,1729,4151,66722,31202,4.53735e+13,1309.63,14114.8,97924,1687,479,92763,88880,69996,30368,35785
13921,88,1427,9911,4010,3.04359e+13,476.311,3723.58,13921,499,152,8434,4054,4066,1154,647
65127,2836,3636,41682,23445,2.91869e+13,510.898,10260.9,65127,1236,286,61491,61491,61489,61447,54354
25698,360,999,16615,9083,2.92992e+13,504.19,3388.92,25698,374,229,23746,22055,20948,20224,13892
11865,630,1572,7882,3983,2.27996e+13,312.725,3306.75,11865,545,145,10293,10092,7831,8376,4563
79496,1262,3688,53063,26433,4.10554e+13,1015.62,10893.2,79496,1037,434,75425,74047,60785,15446,24788
58816,2345,3559,39027,19789,3.92251e+13,780.723,9377.34,58816,992,406,55257,54907,47103,15214,19051
5036,392,526,4275,761,4.25303e+13,18.4382,788.016,5036,265,260,4510,4510,3730,4180,4126
37830,3528,3672,27285,10545,6.25947e+13,1187.58,9158.13,37830,1208,444,34158,34158,34046,33822,33065
53093,3135,3978,38070,15023,5.99361e+13,1551.88,11423.5,53093,1545,498,49115,49063,45694,44845,45057
65929,2229,3668,42003,23926,2.98204e+13,578.337,10401.8,65929,1207,319,62261,62240,61925,62206,47413
54307,246,2477,34465,19842,3.02418e+13,544.001,7489.92,54307,537,380,48828,45289,38729,28379,11223
29774,1138,2392,19554,10220,2.74232e+13,401.009,6001.92,29774,872,191,27382,27244,25279,23444,13705
19250,2162,2573,14442,4808,6.52777e+13,989.975,5757.93,19250,733,234,16677,15800,15049,14890,14908
49611,2223,2367,30938,18673,3.06733e+13,510.957,6759.6,49611,467,347,47244,47244,47071,47127,46328
95506,5511,39491,76411,19095,128376000,1114.17,58369,95506,9588,11,56015,47718,40370,56015,6636
69871,2647,3419,46189,23682,2.98337e+13,716.228,10097.7,69871,1195,289,66452,66200,66271,66078,57769
41624,2386,2908,29655,11969,4.52631e+13,1055.29,9072.45,41624,993,330,38716,38399,35745,36174,36169
68188,2046,3605,49043,19145,4.66523e+13,1681.05,12599.2,68188,1484,381,64046,60696,53887,50788,42705
72003,107,2737,46175,25828,3.01324e+13,616.499,8750.12,72003,649,407,59576,53634,45627,37011,8625
23915,907,994,15427,8488,2.9683e+13,479.528,3279.24,23915,375,216,22921,22917,22795,22858,22755
60329,1744,3724,42329,18000,3.14916e+13,1009.45,11217.9,60329,1047,333,56605,55753,53324,53137,33717
69928,1055,2661,44948,24980,2.99483e+13,586.236,8488.64,69928,677,402,67267,67136,60995,57859,43732
21807,601,2154,14405,7402,2.60523e+13,321.032,4910.7,21807,738,175,19628,18486,15167,13067,8752
76487,3596,3868,51761,24726,4.48436e+13,1177.54,11887.9,76487,1412,471,72619,72456,71663,68536,64006
13075,248,668,7639,5436,3.26183e+13,240.31,1677.75,13075,224,116,12344,11969,9578,8007,7278
8100,500,714,5193,2907,2.90339e+13,353.015,1822.68,8100,220,164,7386,7037,6958,6864,6410
56558,244,3440,40376,16182,5.02591e+13,1333.74,11251.6,56558,1345,355,45400,40221,27023,25313,8201
45584,2885,3787,32956,12628,6.13708e+13,1415.85,10115.9,45584,1323,451,41797,41727,38229,36867,37338
60286,582,2272,38849,21437,2.962e+13,558.304,7331.07,60286,590,346,57828,55578,49507,48345,30560
30914,1702,1805,18949,11965,3.11341e+13,371.719,4735.38,30914,339,266,29109,29109,29060,29073,28445
46056,1705,1857,29715,16341,2.93719e+13,528.651,6005.48,46056,493,317,44199,44199,44022,44065,43688
16528,2236,2472,11942,4586,5.92135e+13,850.304,5218.14,16528,742,181,14056,13419,14056,14056,13811
16340,326,1372,10503,5837,2.94395e+13,385.889,3403.24,16340,354,220,14549,13432,12485,12177,6444
22145,478,2597,15477,6668,4.59652e+13,872.915,6337.53,22145,806,279,17983,16668,12380,11486,5465
10658,389,685,6228,4430,3.23082e+13,238.571,1569.84,10658,192,108,9973,9854,8716,9271,7016
8966,672,734,5754,3212,2.85208e+13,335.59,1887.11,8966,264,161,8232,8232,8193,8189,7964
13152,750,1433,9503,3649,3.06259e+13,210.716,3460.94,13152,380,150,11719,11693,9007,9940,4730
76590,2421,3965,55272,21318,5.00932e+13,1677.9,13808.5,76590,1505,568,72363,69878,58134,60669,53159
81174,1912,3935,52563,28611,2.9457e+13,661.511,11945,81174,1243,380,77239,77022,75036,75063,50441
74229,2680,4276,52311,21918,5.08744e+13,1370.01,13914.8,74229,1754,535,69953,69524,60935,51289,53457
92421,3860,4300,64796,27625,4.66741e+13,1329.07,15364,92421,1819,549,88121,88081,86930,72042,73857
13393,584,1826,9426,3967,3.41188e+13,365.337,3995.92,13393,503,131,11464,11046,10285,10270,8189
21547,481,1953,15274,6273,3.54701e+13,558.141,5253.89,21547,663,156,19033,18474,16562,17159,9807
34034,2608,2967,22894,11140,4.24174e+13,580.484,6774.57,34034,727,320,31067,31065,30250,28664,23635
10506,193,866,6804,3702,3.05963e+13,341.42,2222.88,10506,244,175,9080,8287,7638,8036,2782
32497,2496,2510,21168,11329,2.84237e+13,407.808,6336.16,32497,929,191,29987,29987,29987,29987,29987
15798,776,881,10199,5599,2.94869e+13,441.706,2641.89,15798,352,198,14917,14912,14811,14656,14674
61345,1047,3716,42015,19330,3.06955e+13,792.326,10757.3,61345,1074,284,57307,55630,45723,36925,15184
62985,378,2668,39935,23050,3.06014e+13,568.724,8235.59,62985,548,398,58597,54857,47386,39029,20408
24254,442,1621,17661,6593,2.9859e+13,456.273,4903.11,24254,458,195,22325,21663,14296,12999,7664
68424,331,3698,43629,24795,2.95534e+13,573.482,10518.6,68424,1179,318,62179,58115,43630,24500,14065
87427,219,3616,54850,32577,2.95149e+13,920.159,11116.4,87427,751,452,77521,70944,58070,38349,13390
84058,3496,4251,60145,23913,4.25756e+13,1572.24,14661.6,84058,1550,437,79807,79760,74746,74711,72849
31425,1413,2290,22169,9256,3.64834e+13,702.951,6845.6,31425,728,207,29135,28122,28528,28062,24403
14488,680,1254,10459,4029,2.78241e+13,223.858,3414.84,14488,354,140,13234,13222,12741,12709,10300
66498,2732,3671,47803,18695,4.63522e+13,1567.37,12539.4,66498,1402,381,62827,62381,54538,56969,54017
64338,2445,3488,46294,18044,4.70203e+13,1420.35,12057.3,64338,1382,376,60850,59887,52818,54823,53159
19788,1335,1561,13088,6700,3.98485e+13,418.076,3816.49,19788,347,211,18227,18227,17840,17900,16962
89153,2640,3423,55703,33450,3.02453e+13,776.284,10529.5,89153,642,448,85730,85663,84231,84744,81767
7546,114,520,4407,3139,3.20619e+13,200.435,1213.19,7546,140,100,6628,5986,4660,2733,1655
3852,94,401,3276,576,4.21225e+13,16.9211,625.72,3852,204,199,3451,3451,1631,2689,2551
79703,1750,3802,52584,27119,2.97341e+13,709.686,11733.8,79703,1238,362,75901,75595,73465,72526,41885
65571,11880,26363,52994,12577,1.89423e+13,118.318,30500.1,65571,2107,169,39208,39207,27640,26614,26161
72171,2094,2780,45782,26389,2.99339e+13,634.927,8894.83,72171,618,429,69391,69319,66144,65091,60299
6232,464,623,4054,2178,3.19304e+13,249.139,1443.76,6232,201,123,5609,5443,5498,5465,4849
85532,1437,4371,60935,24597,4.83953e+13,1637.22,15276.6,85532,1736,554,78968,74256,59325,49903,35272
10808,2002,3264,9236,1572,6.25504e+12,35.29,5450.37,10808,1545,12,7544,7508,7509,7508,5514
26395,1176,1439,17017,9378,2.94586e+13,488.398,4147.84,26395,387,267,24956,24954,24365,24050,23752
22547,584,1758,16244,6303,2.85136e+13,448.419,4894.46,22547,528,158,20670,20427,18663,19509,11226
10553,649,761,6723,3830,2.69385e+13,343.255,2012.1,10553,333,147,9792,9637,9664,9524,9543
87725,1698,2665,56849,30876,3.06593e+13,715.805,9132.12,87725,656,392,85060,84870,81407,80177,68272
34700,1136,2574,24595,10105,3.44484e+13,756.244,7451.07,34700,785,226,32032,30737,30004,30586,20224
17485,956,1271,10242,7243,3.19587e+13,258.111,2615.28,17485,330,148,16214,16213,16176,16214,16118
38670,1678,3379,28451,10219,6.54057e+13,1498.94,8906.17,38670,1050,446,34633,31644,22502,24899,21698
55264,1310,5529,46999,8265,4.2092e+13,17.0564,6437.84,55264,2767,2762,49735,49735,24458,39199,34821
35146,1139,2311,24713,10433,3.52001e+13,812.939,7347.44,35146,775,214,32510,31290,31083,28663,24611
13659,307,1878,9117,4542,4.62476e+13,713.428,4094.99,13659,672,125,10668,9750,8531,7458,2476
42733,683,3564,29332,13401,5.046e+13,741.552,8806.83,42733,951,437,38395,37655,27115,9819,9420
23924,1131,1601,17307,6617,2.89923e+13,621.778,4937.68,23924,542,204,22323,21809,21624,21893,17962
32495,240,1117,21018,11477,2.97539e+13,547.241,3946.13,32495,423,258,29030,26931,24816,24146,12130
60666,1688,3523,43524,17142,4.361e+13,1264.69,11717.8,60666,1248,362,56673,54137,48759,46341,37362
16358,605,1460,11739,4619,2.94393e+13,449.549,4061.02,16358,504,170,14820,14047,11321,12187,6025
81685,2362,3962,56390,25295,4.78807e+13,1302.29,12824.4,81685,1501,486,77723,74844,65211,35511,45599
75549,3748,3759,48286,27263,2.96555e+13,599.66,11078.6,75549,1229,329,71790,71790,71790,71790,71760
44609,2117,2240,28520,16089,2.96638e+13,575.715,6620.76,44609,575,346,42369,42369,42299,42350,41702
40430,1912,2567,29020,11410,2.88115e+13,800.014,7591.06,40430,812,232,37863,37854,37745,37841,35638
9114,2002,4564,7292,1822,167819000,3.39247,6228.16,9114,923,11,4550,4550,4040,4550,1991
35083,951,3240,25204,9879,6.10716e+13,1405.2,8627.97,35083,1227,265,29996,27854,18562,18276,12942
1936,93,211,1645,291,4.21588e+13,16.8285,365.321,1936,108,104,1725,1725,1040,1436,1390
56903,2841,3756,39227,17676,4.84603e+13,1111.73,10537,56903,1271,452,53147,52941,47559,26958,33834
6583,370,923,4251,2332,2.94595e+13,184.784,1878.18,6583,230,136,5660,5461,5284,4627,3877
67438,2504,4035,48624,18814,5.36406e+13,1444.6,12960.3,67438,1525,531,63403,61993,52763,53522,52841
48028,2675,2903,31781,16247,2.8812e+13,488.292,8056.18,48028,1042,253,45125,45124,45114,45125,43253
40632,549,2658,27102,13530,3.98207e+13,641.37,6657.65,40632,692,329,37663,35784,27491,4731,3660
10296,1049,1917,7379,2917,6.40258e+13,302.086,3726.6,10296,479,150,8379,8212,7937,7444,5071
57307,1733,2584,35953,21354,3.05082e+13,577.684,7696.54,57307,507,372,54723,54637,49895,45894,41193
70580,3350,3795,45129,25451,2.96377e+13,590.166,10918.6,70580,1243,321,66785,66785,66785,66785,63350
11581,2013,2457,8573,3008,7.07843e+13,330.439,4234.61,11581,503,316,9124,9058,8199,8503,7851
88296,2697,3890,59740,28556,4.37234e+13,1214.2,12462.5,88296,1416,476,84406,83978,74435,31122,49739
73036,3010,3837,48270,24766,2.97374e+13,709.763,11156.2,73036,1235,326,69199,69106,69164,68888,59669
31732,824,1764,20447,11285,2.93202e+13,573.819,4930.45,31732,423,299,29968,29530,27099,25215,14219
82439,1222,3920,54205,28234,2.96024e+13,716.713,12160.3,82439,1240,391,78490,77607,61501,50517,27228
33406,414,1625,21891,11515,3.47475e+13,493.912,4720.53,33406,421,268,31007,28708,25966,4039,4278
79987,94,3746,57073,22914,4.35052e+13,1533.96,13749.5,79987,1546,401,55383,38502,28177,14320,4271
93606,509,4323,66286,27320,4.65861e+13,1563.13,15807.1,93606,1769,569,81856,77338,49063,34131,10281
68842,807,4103,48223,20619,5.3122e+13,1409.34,12977.2,68842,1710,506,60667,57795,39127,24157,15230
50251,361,1934,32423,17828,2.95974e+13,538.742,6447.49,50251,522,340,46604,42977,39815,38039,14390
33253,2735,3151,23960,9293,6.246e+13,1308.96,8316.33,33253,1185,276,30102,30100,30102,30101,29747
29993,23,1162,19344,10649,2.9355e+13,540.334,3848.44,29993,427,239,15453,7476,9617,3287,1802
32453,762,1878,19436,13017,3.15834e+13,335.575,4552.05,32453,410,229,30575,30469,22418,11029,8042
47799,2817,3683,33129,14670,4.89837e+13,1038.13,9658.95,47799,1140,416,44116,43972,39861,22754,26696
47392,2252,3480,31840,15552,4.35103e+13,755.632,8849.46,47392,993,410,43912,43381,35822,14651,18056
13810,302,785,8058,5752,3.17687e+13,243.128,1895.3,13810,208,134,13020,12665,10448,8988,7570
37683,572,3601,26664,11019,5.55306e+13,1055.1,8932.39,37683,1123,413,32169,30876,18341,9079,7617
61076,2531,3590,38475,22601,2.91017e+13,541.338,9633.15,61076,1128,316,57486,57485,57397,57464,47523
88275,2273,4175,56273,32002,2.9637e+13,796.982,12643.3,88275,1186,434,84100,83870,79963,81335,63844
83689,1632,4180,55590,28099,3.18777e+13,1024.56,13000.9,83689,1318,315,79509,78429,75198,75981,37889
96264,1872,4391,68029,28235,4.59945e+13,1607.3,16273.9,96264,1858,566,90702,86379,72645,59068,48856
98983,2732,4126,66003,32980,3.89828e+13,1423.47,13315.5,98983,1135,449,94857,94157,84576,25509,47390
82513,835,4276,58701,23812,4.15364e+13,1339.6,14422.8,82513,1429,454,74669,71652,45465,31728,13150
33707,954,1722,21811,11896,2.98483e+13,597.036,5010.21,33707,504,283,31985,31790,29819,27927,22102
21158,1519,2872,14720,6438,5.25866e+13,420.595,5866.16,21158,684,322,18286,18108,12478,7307,6386
17039,662,840,10971,6068,2.8892e+13,453.576,2660.42,17039,339,190,16199,16184,15702,15554,15422
62266,196,4185,43981,18285,5.47364e+13,1457.05,12621.5,62266,1749,512,47639,41877,26420,15330,5337
50459,2047,2423,31752,18707,2.98249e+13,551.481,7005.54,50459,519,363,48036,48033,46721,47273,44262
60113,2196,3607,37926,22187,2.95304e+13,556.778,9685.95,60113,1162,304,56506,56485,56179,56473,44646
18692,855,1380,13432,5260,2.58843e+13,633.485,4226.11,18692,740,159,17227,16839,15945,16132,13738
83753,3385,4201,60114,23639,4.8644e+13,1698.22,14851.4,83753,1664,574,79552,79217,76355,74656,74806
86740,2112,4269,60740,26000,4.73583e+13,1316.27,14903.4,86740,1776,541,82224,78121,64618,50707,49316
32068,1503,3546,22473,9595,5.71474e+13,667.638,7967.33,32068,965,416,28522,27655,20690,12184,12768
90422,705,2921,57593,32829,3.01624e+13,715.759,9902.08,90422,686,446,87197,86087,72651,63406,42150
29485,871,1647,18926,10559,2.86436e+13,508.196,4802.71,29485,420,276,27838,27663,25932,24702,16158
5152,1775,2579,4122,1030,332586,3.39383,3520.1,5152,523,8,2573,2573,2413,2413,1773
95654,3475,4674,62652,33002,3.28785e+13,1084.56,14970.8,95654,1192,425,90980,90660,90980,90966,78357
13205,228,954,8539,4666,3.02895e+13,388.278,2557.75,13205,279,174,11556,10628,10079,8732,6155
31065,1696,1725,20043,11022,2.94568e+13,510.732,5071.07,31065,481,303,29340,29340,29328,29308,29327
3467,392,575,2235,1232,2.92272e+13,120.934,1112.39,3467,153,91,2892,2871,2753,2768,2566
55213,1634,3907,39175,16038,5.63216e+13,1352.12,11236.2,55213,1451,469,50369,47117,34214,26936,25474
10169,943,1864,7005,3164,3.91448e+13,339.867,3632.8,10169,515,138,8305,8100,7696,7721,6571
45906,1046,1918,29637,16269,2.96825e+13,544.551,6159.24,45906,508,330,43988,43966,42210,40932,33308
58671,2987,3546,42000,16671,4.04735e+13,1071.15,11403.5,58671,1159,356,55125,55125,52821,52664,52554
87952,297,2764,57111,30841,3.15337e+13,740.899,9237.51,87952,670,395,80027,73792,67491,6927,7289
60271,848,4025,42474,17797,5.43272e+13,1329.94,11827.8,60271,1495,472,53031,50574,33162,20019,12546
19577,1286,1559,12081,7496,3.11978e+13,262.362,3659.94,19577,367,205,18018,18016,17316,17619,15312
20424,427,1487,13146,7278,2.99332e+13,404.649,3923.28,20424,365,245,18723,17529,16231,15682,8101
45959,1115,2170,28655,17304,3.04412e+13,525.832,6194.48,45959,473,345,43789,43761,38195,30040,28841
95137,531,2974,60411,34726,3.02115e+13,734.673,10189.1,95137,676,454,91116,87119,73952,62954,37644
53461,2013,2304,35192,18269,3.76807e+13,555.659,6660.99,53461,542,314,51157,51157,50645,50588,49256
59186,1868,2530,37711,21475,2.95807e+13,570.306,7850.88,59186,570,397,56656,56644,54583,54012,50845
59283,252,3674,40719,18564,2.98782e+13,772.081,10430.9,59283,1007,282,51421,46643,31259,12984,5601
17433,552,1012,11256,6177,2.93531e+13,394.276,2884.17,17433,301,194,16421,16015,15341,15064,14421
19150,24,1478,13880,5270,2.76769e+13,629.436,4365.97,19150,549,180,6124,2443,1868,1082,538
52951,3032,5313,45007,7944,4.22165e+13,16.9934,6192.03,52951,2659,2654,47638,47638,33979,41942,40817
59576,9206,18552,48838,10738,2.60491e+13,4393.9,28732.1,59576,6845,21,41024,33512,34229,36937,26716
21049,651,2542,15640,5409,6.19993e+13,1195.41,6019.68,21049,767,253,16929,16481,8354,8305,5020
82417,1468,4334,54782,27635,3.14528e+13,982.108,13018.5,82417,1319,304,78013,76552,69259,71450,34851
87611,2370,3287,57283,30328,3.47822e+13,743.12,10082.1,87611,687,381,84324,84172,82520,80794,70612
3201,628,802,2215,986,4.10281e+13,225.105,1405.5,3201,243,61,2399,2399,2290,2245,2222
3948,11,726,2645,1303,4.98065e+13,219.294,1401.3,3948,255,86,1415,914,461,729,143
79393,1608,4240,55171,24222,4.93316e+13,1388.51,13951,79393,1785,533,73916,69663,54318,35337,31394
26543,879,1030,17112,9431,2.93635e+13,508.963,3498.67,26543,399,236,25513,25508,25141,24900,24866
48291,1964,2264,31087,17204,3.01679e+13,588.604,6871.07,48291,548,358,46027,46026,45616,45730,44518
49978,1280,2364,31775,18203,3.01869e+13,554.706,7085.42,49978,530,364,47614,47545,43411,37389,34883
73124,2020,3740,52647,20477,4.37926e+13,1460.54,13152.7,73124,1378,407,68884,66496,59541,57632,49251
70316,2836,3901,48634,21682,4.8849e+13,1242.31,11928.3,70316,1379,454,66415,66162,59805,33364,43215
92436,4142,4501,64509,27927,4.10975e+13,1544.8,15482,92436,1566,460,87935,87925,87828,86688,85917
40317,200,1269,26017,14300,2.98247e+13,549.883,4491.75,40317,517,275,35444,33209,30011,27657,13374
23371,1945,2136,15700,7671,2.64667e+13,416.112,5270.68,23371,807,184,21235,21235,21185,21235,19975
89526,2491,4258,62489,27037,4.78978e+13,1321.63,14873.6,89526,1812,537,85268,83647,72159,51430,55458
98161,3357,4522,68216,29945,4.08206e+13,1527.27,15882.6,98161,1621,452,93639,93166,86290,86255,78334
49763,1389,2276,31920,17843,3.01238e+13,589.034,7030.85,49763,516,361,47487,47437,44896,41555,38267
72423,2620,3717,46319,26104,2.95503e+13,602.875,10967.6,72423,1241,328,68706,68705,68522,68648,54705
69811,1958,4258,49210,20601,5.24198e+13,1422.58,13441.8,69811,1733,530,65098,61043,47682,39976,36056
94095,3484,4230,60651,33444,2.9444e+13,835.421,13441.5,94095,1256,418,89865,89826,89865,89816,84030
63958,3921,3960,44851,19107,3.34051e+13,1051.4,11931.9,63958,1068,373,59998,59998,59998,59998,59974
92306,2457,2948,59108,33198,2.95299e+13,704.783,9954.93,92306,705,437,89358,89247,87559,86959,84723
66025,2270,4257,47120,18905,5.38664e+13,1451.89,13212.3,66025,1736,533,61701,58397,47139,46151,45546
52380,280,2384,33533,18847,2.97949e+13,590.376,7266.75,52380,552,369,47305,44071,39106,31330,12528
9383,1245,1479,6376,3007,2.07201e+13,337.379,2971.27,9383,520,131,7904,7904,7894,7904,7196
70332,2331,4001,45357,24975,2.9513e+13,632.657,11267.4,70332,1245,358,66331,66274,65764,66140,46133
4292,310,477,2763,1529,2.78046e+13,161.398,1065.12,4292,145,101,3815,3682,3665,3670,2987
98106,1264,4649,68970,29136,4.22212e+13,1684.63,16228.2,98106,1722,528,90679,86219,67187,57380,26596
80524,2189,4072,51491,29033,2.94593e+13,676.255,12022.8,80524,1233,382,76452,76382,74137,74629,55429
52633,13239,17560,42887,9746,2.42095e+13,4649.35,26898.4,52633,5853,21,35073,35073,32890,33322,30357
38551,1033,2088,24436,14115,2.98479e+13,541.448,5880.67,38551,479,338,36463,36358,32722,27523,24585
81863,2298,4264,54048,27815,2.96255e+13,789.557,12348.1,81863,1256,356,77599,77281,76240,76848,45224
82523,1407,8237,70194,12329,4.2047e+13,17.0793,9353.49,82523,4121,4116,74286,74286,33328,57217,53815
70902,3460,4142,49539,21363,5.28032e+13,1401.82,13034.9,70902,1748,497,66760,66631,64383,48543,51702
92409,840,4310,65274,27135,4.69152e+13,1578.65,15668.1,92409,1782,560,83268,79520,54072,41967,18256
50099,1959,1963,32230,17869,2.8884e+13,520.898,6136.96,50099,489,319,48136,48136,48136,48132,48133
32896,1464,1687,20887,12009,3.0474e+13,474.553,4864.54,32896,432,263,31209,31208,30810,31030,29585
51054,409,1475,32955,18099,2.95511e+13,547.617,5215.11,51054,481,305,48178,44368,41470,39992,23287
93690,2544,3977,61643,32047,3.59941e+13,1206.08,12276.6,93690,1034,438,89713,89067,80077,20953,31027
42384,996,1318,27232,15152,2.88553e+13,539.491,4658.55,42384,428,292,41066,41064,39696,39520,38542
79597,1957,4244,55918,23679,5.00954e+13,1369.86,14251.6,79597,1781,537,74787,70648,56812,43129,40526
56811,3312,3606,36358,20453,2.9444e+13,500.941,9517.85,56811,1208,245,53205,53205,53205,53205,50362
39269,931,3227,28073,11196,6.00706e+13,1417.24,9017.11,39269,1313,274,33904,31512,21524,21430,13823
41806,2847,3737,30209,11597,6.29803e+13,1392.2,9804.35,41806,1211,455,38069,37950,34234,32299,32911
81028,2579,3113,50508,30520,3.01264e+13,726.303,9705.82,81028,589,444,77915,77875,76165,76760,73959
26995,193,1037,17417,9578,2.9414e+13,501.035,3529.52,26995,397,236,23557,22020,19793,18300,9463
78794,3294,3914,54318,24476,4.7826e+13,1270.78,12421.6,78794,1380,474,74880,74644,72061,40060,49539
51718,460,2412,32804,18914,3.05554e+13,569.365,7203.87,51718,543,371,48465,46171,39183,32195,13205
82731,847,2721,53221,29510,2.96533e+13,626.801,9032.93,82731,668,413,80010,79393,70552,68161,51010
94520,1076,3658,59755,34765,2.9562e+13,926.041,11855.3,94520,968,451,90579,90009,76058,56389,46362
43742,7913,15994,35562,8180,2.27309e+13,4208.78,23800.8,43742,4632,16,27748,21849,23235,25085,17105
71735,873,2949,46721,25014,3.40971e+13,651.67,8435.28,71735,613,350,68786,68427,57919,9733,11844
24206,1443,2546,18002,6204,6.38956e+13,1250.46,6433.7,24206,819,272,21042,19661,13159,14449,12528
52758,51,1484,34026,18732,2.97382e+13,581.817,5360.87,52758,483,310,36198,24022,27189,20929,4513
45594,213,3570,30780,14814,4.59479e+13,762.792,8920.49,45594,1020,412,37737,34261,25909,5488,3989
48321,532,1383,30975,17346,2.82924e+13,548.597,4984.24,48321,497,302,46689,44122,40890,39501,32214
46822,2921,3103,31254,15568,3.9651e+13,663.846,7639.79,46822,781,325,43719,43719,43325,43153,41847
84350,1085,4318,59617,24733,4.12003e+13,1349.69,14605.6,84350,1414,448,77564,74047,54609,43861,17818
3156,241,737,2174,982,3.52766e+13,166.599,1328.04,3156,312,70,2419,2210,2019,1855,1797
41742,821,2003,27335,14407,3.53164e+13,528.661,5600.86,41742,462,290,39739,39577,34095,6492,7977
4551,21,580,2959,1592,2.91302e+13,159.517,1217.65,4551,194,108,2239,911,1340,442,364
43595,1036,2066,26891,16704,3.11282e+13,456.439,5857.17,43595,407,289,41529,41470,35064,26820,23118
62466,1242,3507,40771,21695,2.95746e+13,646.015,9746.73,62466,1193,271,58959,58294,48982,48018,26724
45511,1946,2944,32217,13294,3.42539e+13,822.27,9066.65,45511,941,238,42567,42559,42166,41571,35846
23063,50,1004,14834,8229,2.87355e+13,509.97,3248.34,23063,387,228,15864,10419,11916,8785,2017
31729,1181,1185,20410,11319,2.95854e+13,546.13,4016.68,31729,432,263,30544,30544,30544,30525,30541
69309,572,652,47006,22303,3.35318e+13,302.754,4467.81,69309,307,261,68657,68657,66756,67056,66537
2473,56,326,1626,847,3.00455e+13,108,684.882,2473,121,57,1771,1188,1463,1461,706
28038,2487,2664,19839,8199,4.41524e+13,834.013,7162.67,28038,822,278,25374,25368,25100,24919,24876
13383,243,822,8663,4720,3.04126e+13,403.575,2409.57,13383,289,176,11803,10861,10352,9975,6081
73015,3387,3551,47931,25084,3.52247e+13,1001.24,9913.5,73015,827,342,69464,69451,69430,69443,68507
84393,996,3622,53047,31346,2.95256e+13,888.916,11148,84393,951,438,80504,79968,66442,48379,37371
76979,7215,7865,65339,11640,4.21649e+13,17.9068,8972.95,76979,3855,2444,69114,69114,65641,67599,67179
59461,643,2175,38317,21144,2.9141e+13,561.726,7144.69,59461,573,340,57260,56006,49438,49023,35952
55608,87,3124,36968,18640,3.89493e+13,716.77,8464.37,55608,869,356,42800,34015,28496,4654,1928
64108,2475,3356,39937,24171,2.94018e+13,669.398,9135.45,64108,946,378,60752,60728,60718,60746,56089
56225,802,2491,35711,20514,3.02765e+13,552.192,7624.83,56225,576,376,53734,53004,46083,38942,26496
46083,2463,2940,32582,13501,3.42076e+13,808.838,9086.98,46083,927,240,43143,43143,43135,43120,40080
10725,138,738,6910,3815,2.86329e+13,348.648,2046.49,10725,257,167,9026,8573,7483,6616,3497
29301,3257,3498,21102,8199,6.06999e+13,1093.85,7990.14,29301,963,416,25803,25785,25598,25314,23698
49349,278,3392,31170,18179,2.96633e+13,465.069,8462.29,49349,1141,228,43912,40978,28138,9758,4346
6714,973,1514,4668,2046,1.98822e+13,224.78,2560.77,6714,389,121,5200,5134,5200,5184,4570
6916,107,715,4462,2454,2.95271e+13,309.069,1667.46,6916,243,146,5569,4899,4349,3947,2336
80739,436,3913,55322,25417,4.67628e+13,1225.33,12465.6,80739,1382,474,71340,66030,47350,12722,7740
39315,1071,2057,25079,14236,3.03532e+13,576.958,5904.58,39315,487,328,37258,37192,33873,29593,26326
4939,432,438,2881,2058,3.20683e+13,151.494,941.333,4939,105,79,4501,4501,4501,4501,4491
52495,2776,3074,33699,18796,2.90825e+13,508.351,8236.96,52495,1187,236,49421,49404,49408,49421,47726
33796,916,2162,24287,9509,2.7453e+13,635.396,6336.07,33796,791,244,31502,30774,22122,17557,15580
31405,1808,3299,23106,8299,6.82172e+13,1268.18,7946.92,31405,1031,437,27794,25766,19656,20914,21666
82735,1178,3938,55649,27086,4.11716e+13,1326.51,11943.9,82735,1208,437,77588,75475,58165,15137,17019
71814,1541,2177,46222,25592,2.90666e+13,565.386,7411,71814,589,347,69637,69632,68635,68283,63850
8838,557,1029,6425,2413,2.89795e+13,184.607,2357.69,8838,261,124,7809,7801,7634,7716,7221
44243,1209,1830,28466,15777,2.93668e+13,514.258,5834.41,44243,474,308,42413,42395,41260,41000,36137
16722,341,2490,12006,4716,5.95375e+13,524.121,5276.96,16722,650,230,13241,12338,7833,6873,3030
8321,506,904,5368,2953,2.8686e+13,292.81,2042.02,8321,258,141,7417,7100,7019,6807,6270
85860,668,4122,58917,26943,4.69152e+13,1300.86,13451.1,85860,1594,466,77234,75109,51967,20119,12337
54639,1686,2189,35650,18989,3.39143e+13,577.008,6435.06,54639,598,322,52450,52450,51091,49555,48153
44025,1823,2841,28704,15321,2.86198e+13,465.069,7566.84,44025,1057,222,41184,41183,40465,38775,32079
76167,3246,4218,53099,23068,5.03495e+13,1382.37,13788,76167,1802,523,71949,71803,66822,50314,55619
66261,3624,3679,44972,21289,4.38035e+13,1052,10450.4,66261,1060,429,62582,62567,62513,62454,62472
38368,1175,2665,24623,13745,2.93832e+13,413.751,6851.6,38368,1015,191,35703,35574,33746,31314,20607
88167,3336,4317,58991,29176,3.29147e+13,1114.67,13756.4,88167,1347,380,83850,83608,82596,81975,77591
15102,449,1431,10871,4231,2.74667e+13,249.747,3681.78,15102,368,141,13671,13563,12087,12698,7225
33544,80,3051,24216,9328,6.09869e+13,1317.52,7945.52,33544,1040,273,22003,15173,10666,8640,1401
99961,2975,4064,66479,33482,3.91785e+13,1321.39,13037.9,99961,1090,452,95897,95335,90106,29768,46072
40542,3320,3615,28384,12158,5.33084e+13,1062.32,9153.28,40542,1145,428,36927,36852,36422,35367,32357
42838,2329,2589,30784,12054,2.67413e+13,791.86,7696.37,42838,782,248,40249,40228,40245,40245,39601
21594,1032,1416,14008,7586,3.05403e+13,521.725,3827.04,21594,433,245,20178,20160,19425,18969,17641
16123,104,1014,10375,5748,2.88225e+13,394.408,2806.24,16123,314,185,13459,12074,10663,9284,3805
71428,1435,3773,47638,23790,2.91751e+13,822.824,10993.9,71428,1156,284,67655,66623,61494,53249,31906
57067,385,2473,36714,20353,2.98346e+13,580.291,7654.88,57067,562,384,52863,49108,44302,41127,18089
98136,3645,3671,64149,33987,3.39043e+13,1149.75,11650.8,98136,860,400,94465,94459,94451,94403,94424
22781,1018,1979,14417,8364,2.62809e+13,295.721,4534.62,22781,675,155,20802,20801,20469,20096,13975
13219,397,798,7714,5505,3.17634e+13,249.637,1878.51,13219,193,134,12421,12258,10606,11183,8781
48513,987,3733,34284,14229,5.63359e+13,1130.91,10167.5,48513,1304,447,43066,41191,29370,15250,16203
95560,2703,3032,60732,34828,3.02944e+13,745.461,10349.5,95560,676,448,92528,92424,90543,90998,86666
43001,2258,2922,30837,12164,3.91287e+13,915.84,8991.11,43001,837,318,40079,39901,37346,38408,36894
84819,895,4144,58403,26416,4.88083e+13,1334.97,13757.6,84819,1793,471,77182,74056,53734,24386,19739
20993,709,979,13508,7485,2.95847e+13,473.226,3115.91,20993,328,219,20014,19950,19104,18980,18259
83370,1686,4267,53475,29895,2.9266e+13,760.688,12537.5,83370,1246,387,79103,78774,69550,60229,39613
46416,2880,2912,30728,15688,2.88456e+13,497.125,7961.45,46416,1034,250,43504,43504,43504,43504,43371
23843,878,3474,17427,6416,6.87211e+13,789.307,7083.83,23843,831,404,19734,18988,11972,9489,7566
41002,1522,3044,27493,13509,4.08691e+13,630.31,7478.41,41002,797,332,37958,37614,29322,8761,8810
46162,1239,3599,33345,12817,6.37578e+13,1507.91,10182.9,46162,1431,454,40634,37791,25209,24313,19157
45764,2552,3333,32780,12984,4.15203e+13,928.089,9795.91,45764,887,336,42431,42382,38655,40048,38355
17731,104,386,12022,5709,3.34709e+13,276.532,2150.47,17731,252,161,12432,6335,8059,8291,6008
4123,75,474,2403,1720,3.09106e+13,126.288,908.723,4123,90,84,3463,3144,2298,1425,843
95959,1114,4015,64730,31229,4.35448e+13,1387.5,13116.4,95959,1405,477,89937,87524,69620,20497,29844
46207,476,2320,29003,17204,3.05408e+13,521.196,6584.82,46207,495,344,43266,41908,34205,26273,13247
60818,2097,2223,39191,21627,2.9347e+13,553.664,7278.98,60818,583,342,58595,58595,58445,58433,58480
11683,346,815,7547,4136,2.93325e+13,411.228,2209.95,11683,355,167,10556,9848,9593,9139,7367
44879,217,2939,31864,13015,2.7614e+13,683.499,8191.96,44879,848,276,38399,34239,22149,7291,2357
95038,3855,4563,65422,29616,4.27124e+13,1560.13,15587.6,95038,1705,442,90475,90410,86594,86915,82696
95105,32081,33694,77137,17968,2.36138e+13,2525.15,45008.3,95105,6068,162,61411,61411,61411,61411,59272
79684,348,3698,53861,25823,4.20131e+13,1131.76,11375.9,79684,1204,429,70538,64563,51250,9209,5883
96683,1878,4833,69058,27625,4.53445e+13,1756.47,16624.7,96683,1802,623,90778,86497,72649,68860,44124
81968,1959,2464,52783,29185,2.91658e+13,618.598,8618.67,81968,669,389,79504,79498,78347,77759,76330
78030,4200,4229,55610,22420,5.02268e+13,1384.84,14358.9,78030,1691,545,73801,73794,73793,73787,73515
71288,4240,4244,50406,20882,5.1917e+13,1408.38,13699.5,71288,1764,529,67044,67044,67044,67044,67039
10263,350,1652,6933,3330,3.89104e+13,443.98,3374.57,10263,489,123,8026,7364,6525,5449,2133
91187,3187,4384,64180,27007,4.12399e+13,1556.61,15304.6,91187,1653,449,86803,86407,78774,79295,71368
59099,39,2572,37202,21897,3.02409e+13,564.631,7826.76,59099,512,388,39999,26563,26827,12113,2659
71735,764,2660,45684,26051,3.01081e+13,609.332,8711.94,71735,603,421,68965,68154,58760,51607,37216
61483,142,2872,37917,23566,3.07801e+13,674.926,7970.59,61483,612,382,53649,48940,38713,20531,6419
46575,1278,2267,29668,16907,2.99637e+13,574.821,6743.11,46575,511,350,44308,44246,41048,36271,34839
72230,1514,2349,46601,25629,2.98034e+13,600.123,7902.65,72230,620,364,69881,69877,68126,66943,59245
57470,2495,3097,37595,19875,2.93738e+13,575.668,8799.32,57470,1148,260,54373,54273,54038,54205,48553
48440,1257,1452,31321,17119,3.00415e+13,611.608,5128.76,48440,513,298,46988,46988,46467,46444,46174
3262,569,937,2796,466,300735,5.13182,1611.98,3262,469,5,2325,2325,2325,2325,1595
74917,2199,3819,50039,24878,3.1027e+13,850.962,11656.3,74917,1247,286,71098,70812,69206,69566,54569
69333,372,3626,49773,19560,4.1332e+13,1250.08,12559.6,69333,1324,384,59279,55783,33787,19136,14715
50616,2066,2388,30986,19630,3.12889e+13,556.689,6583.04,50616,549,309,48228,48187,47926,47963,46841
35581,1826,2857,25335,10246,4.3947e+13,849.96,8261.66,35581,840,309,32724,31868,29058,29607,27407
30496,1411,1576,19656,10840,2.9203e+13,439.769,4712.6,30496,387,284,28920,28920,28689,28607,27805
86372,2297,4424,59695,26677,3.68522e+13,1319.66,14576.8,86372,1421,423,81948,80161,74822,73520,53293
66125,271,652,44895,21230,3.36262e+13,305.067,4376.04,66125,307,261,64786,61336,44334,39548,37619
86148,826,3060,55890,30258,3.28459e+13,735.473,9679.39,86148,703,393,83039,82440,69858,9929,13299
23507,1254,2868,16253,7254,5.02053e+13,453.881,6040.04,23507,663,316,20639,20407,13821,6026,4466
79297,873,3859,54727,24570,4.77166e+13,1288.71,12575.9,79297,1446,471,72370,69933,49140,20510,17656
11589,962,1172,8401,3188,2.98147e+13,205.739,2862.8,11589,297,134,10417,10417,10341,10416,10287
43416,2355,3619,30208,13208,5.10012e+13,930.382,9095.64,43416,1041,429,39797,38824,32038,16963,21312
76262,539,2749,47877,28385,3.04792e+13,656.651,9071.94,76262,566,432,72875,70288,57831,44374,29670
60125,1929,3618,40464,19661,4.41638e+13,880.263,9892.44,60125,989,410,56507,55434,45517,16049,20366
47472,12824,16554,38733,8739,2.27581e+13,4131.06,24995,47472,5162,17,30918,26967,29932,29932,26276
35843,1113,2576,25461,10382,3.26944e+13,748.292,7459.19,35843,796,212,33142,31894,30333,31322,19765
67336,2510,3867,46121,21215,3.16378e+13,940.258,11838.3,67336,1076,303,63469,63305,62935,62731,47996
33211,2714,3598,24276,8935,6.70417e+13,1269.98,8496.36,33211,1116,447,29613,29510,25334,25679,26163
38888,480,1975,25546,13342,3.67105e+13,501.956,5423.49,38888,433,275,36525,34026,29797,5300,4589
74574,2450,3480,46649,27925,2.99047e+13,787.308,10251.1,74574,889,415,71094,70946,70279,70523,65458
11532,279,773,8423,3109,3.14025e+13,198.008,2459.86,11532,281,124,10759,10626,8786,9733,4762
99628,2473,4591,71045,28583,4.44035e+13,1680.84,16719.1,99628,1915,598,94672,92912,78783,70185,64418
89292,2079,2924,56446,32846,3.03822e+13,717.575,9959.99,89292,660,453,86368,86166,80885,77915,72225
12297,1239,1277,7735,4562,3.00366e+13,232.35,2811.52,12297,285,168,11020,11020,11009,11020,10907
67360,1149,3909,46763,20597,4.99836e+13,1236.79,11881.2,67360,1356,465,61461,58992,43332,20344,18023
37882,368,2036,24201,13681,2.9737e+13,567.981,5747.89,37882,508,319,34697,32607,29010,25306,9896
14878,1772,2641,10863,4015,6.37356e+13,711.97,5069.03,14878,693,169,12237,11687,10340,10804,9477
77758,1482,4164,55597,22161,4.08557e+13,1328.18,13887.2,77758,1380,439,72588,69433,59856,58317,34749
28347,1824,2141,20252,8095,3.36023e+13,699.498,6218.62,28347,748,187,26206,26050,26118,26106,25372
3403,264,1091,2518,885,4.67725e+13,153.703,1671.6,3403,399,114,2220,2025,1405,1432,1223
68248,2929,3684,49149,19099,4.56938e+13,1550.29,12701.5,68248,1360,379,64564,64254,58469,58952,58102
34621,578,1977,21218,13403,3.10436e+13,422.165,5201.51,34621,362,277,32542,32068,24578,14546,10209
51623,2753,3896,36844,14779,5.80324e+13,1392.29,10941.3,51623,1428,466,47727,47552,42353,36847,38660
13925,1269,2426,10419,3506,6.6804e+13,518.661,4791.11,13925,621,222,11499,11125,9103,9008,7987
65300,1835,2242,42032,23268,2.92915e+13,554.177,7346.86,65300,665,346,63058,63058,62437,61944,59561
34141,1165,1262,22019,12122,2.93011e+13,510.509,4162.09,34141,391,279,32879,32879,32679,32591,32621
85290,3162,4213,59339,25951,4.88519e+13,1354.9,14394.2,85290,1804,534,81077,80849,75194,53268,60184
28466,1165,2142,17573,10893,2.81324e+13,317.414,4915.23,28466,762,148,26324,26323,26041,26088,20574
4035,487,515,2631,1404,3.11101e+13,171.714,1086.57,4035,142,90,3520,3498,3512,3510,3428
45994,525,2075,28217,17777,3.07734e+13,468.146,5962.95,45994,421,298,43665,42837,33629,20255,18675
51242,589,3800,35727,15515,5.23556e+13,1152.46,10392.6,51242,1364,456,44751,42815,28601,11751,11760
33719,1229,1707,21711,12008,2.92166e+13,505.707,5177.48,33719,465,299,32012,31987,30955,30327,27439
83873,223,2939,52538,31335,3.00791e+13,681.957,9712.55,83873,614,456,75574,69456,58446,39834,18440
63670,1743,3626,42442,21228,4.07899e+13,829.585,9816.2,63670,1022,421,60044,59021,47908,14057,16331
19837,84,1563,14302,5535,2.86115e+13,273.376,4352.84,19837,432,155,15434,13141,8635,4808,1342
75108,787,3989,50633,24475,3.18042e+13,961.583,12407.7,75108,1189,303,69861,67786,52166,35145,21897
93033,3428,4193,64011,29022,4.67141e+13,1373.54,14545.4,93033,1774,532,88840,88583,84395,53196,63817
36248,2563,2622,22863,13385,2.90114e+13,359.505,6334.95,36248,963,177,33626,33626,33626,33626,33626
37531,1116,2808,22702,14829,2.98263e+13,403.496,6050.11,37531,678,189,34723,34593,28914,27106,21865
80892,1189,4238,56153,24739,4.86891e+13,1410.39,14127.3,80892,1800,527,74001,70181,52935,30341,24967
39398,1742,1806,25423,13975,2.97382e+13,511.145,5341.06,39398,476,282,37592,37592,37578,37565,37510
95291,2766,3981,64659,30632,4.37511e+13,1283.66,13230.5,95291,1434,482,91310,90908,81662,35770,54571
67519,22825,25277,54376,13143,2.42241e+13,3392.14,34478.3,67519,4735,137,42242,42242,41631,41852,41787
70856,2232,3927,48110,22746,3.17335e+13,946.24,12092.2,70856,1119,304,66929,66654,64963,65821,46962
33242,49,2455,23145,10097,2.76597e+13,554.284,6670.57,33242,862,247,18496,10623,9155,2936,1226
19339,582,1541,13982,5357,2.9892e+13,293.471,4266.92,19339,391,172,17798,17604,12249,11536,5723
57954,2479,3660,39716,18238,4.68723e+13,1067.6,10406.8,57954,1247,439,54294,52991,45729,23381,30391
58272,1227,3660,39963,18309,4.55534e+13,1036.46,10146.7,58272,1118,431,53802,52170,38511,13125,14517
45807,52,3601,31458,14349,4.93683e+13,761.248,8972.14,45807,984,425,30009,20018,17386,4772,1844
52057,2962,2979,36887,15170,3.22807e+13,868.667,9629.29,52057,948,254,49078,49078,49078,49078,49058
24332,171,1496,15723,8609,2.96895e+13,412.764,4175.84,24332,361,250,20823,19386,16871,14045,6678
29300,288,2818,20651,8649,5.14033e+13,1195.43,7530.67,29300,1039,306,22801,20249,14079,11784,3032
76880,2048,3924,53039,23841,4.75415e+13,1270.98,12456.7,76880,1433,468,72748,69006,57397,30269,37685
39239,512,1898,25773,13466,3.62815e+13,543.098,5388.62,39239,472,276,36893,34412,30242,5121,4576
74064,592,2703,47293,26771,3.02352e+13,629.274,8871.14,74064,599,420,70970,68911,58761,51642,33000
97126,1699,3946,64005,33121,3.64233e+13,1172.54,12484.8,97126,1044,437,93180,91610,77473,16181,23821
90934,286,4075,57577,33357,2.91801e+13,834.37,12346.9,90934,1089,432,82135,76438,61104,40599,15093
4869,350,592,3152,1717,2.87884e+13,182.149,1279.56,4869,171,103,4277,4110,4018,3865,3548
99430,2114,4490,65661,33769,2.93035e+13,964.27,14319.9,99430,1277,411,94940,94425,92921,93967,57877
69319,1181,6935,58945,10374,4.21225e+13,17.0447,7953.79,69319,3470,3465,62384,62384,27900,48010,41668
83801,1020,2864,53380,30421,2.97032e+13,663.527,9546.62,83801,669,423,80937,80654,71158,64710,51178
71052,73,2285,45844,25208,2.93843e+13,559.517,7562.03,71052,565,342,54635,40312,41181,38682,7659
99515,2042,4283,68218,31297,4.52995e+13,1349.8,15160.1,99515,1839,533,94756,90425,73556,43743,45577
52809,2047,3412,36819,15990,2.85035e+13,787.008,9552.57,52809,909,281,49397,49306,48290,48923,36335
66234,3484,3643,47602,18632,4.59696e+13,1513.67,12488.9,66234,1309,381,62591,62591,62586,62546,62510
58301,3560,5833,49580,8721,4.21031e+13,17.0533,6766.68,58301,2919,2914,52468,52468,38862,46794,44458
35369,921,1170,22855,12514,2.94132e+13,512.55,4074.01,35369,432,281,34199,34197,33362,32742,32336
65304,907,2657,40376,24928,3.0735e+13,633.287,8193.32,65304,538,395,62598,62062,49790,32862,24042
57270,124,2437,36742,20528,3.00944e+13,596.457,7663.19,57270,576,395,48028,44429,37545,29310,7900
60501,2397,3666,39126,21375,2.93126e+13,583.531,9825.69,60501,1205,259,56835,56747,56256,56633,38295
57473,1609,4066,40812,16661,5.79317e+13,1422.37,11890.2,57473,1714,455,52370,48721,35691,28895,28261
80724,2346,3585,50825,29899,2.95111e+13,827.571,11018.9,80724,962,415,77139,76870,74369,75470,67496
10271,615,1660,7234,3037,2.64837e+13,338.961,3293.19,10271,437,127,8608,8311,7925,8289,5839
46891,2401,2793,32452,14439,2.8797e+13,554.176,7998.73,46891,916,273,44098,44098,43932,44057,39062
1930,64,301,1277,653,3.13531e+13,86.7653,600.187,1930,94,57,1443,992,1185,1143,583
43386,2304,2912,27116,16270,2.91761e+13,401.207,6962.08,43386,1005,187,40474,40473,40315,40454,38275
83706,1851,4154,56046,27660,3.18669e+13,1065.7,13192.2,83706,1307,344,79552,78440,75246,67255,46860
39341,1525,2456,26169,13172,4.14135e+13,533.306,6157.25,39341,530,287,36885,36855,33200,13839,12591
57612,1146,3380,37569,20043,2.94251e+13,606.213,9173.37,57612,1182,265,54232,53502,43729,43828,25229
81621,1931,4084,53826,27795,2.93393e+13,797.499,12265.1,81621,1243,367,77537,77154,75351,76350,43101
33830,1560,1787,24475,9355,2.93468e+13,632.095,5912.5,33830,745,223,32043,32043,31791,31862,29861
86538,292,4077,59375,27163,4.69184e+13,1279.63,13384.6,86538,1573,473,73100,66197,49364,15676,6766
63348,3321,3594,45340,18008,3.75772e+13,1089.94,11727.6,63348,1133,363,59754,59754,59539,59119,58977
23062,964,2007,13706,9356,3.07376e+13,287.202,3842.63,23062,501,146,21055,21044,20787,20924,19765
57094,1075,2351,36781,20313,2.967e+13,594.195,7466.28,57094,556,380,54743,54634,50151,47003,34686
75698,1098,3913,54474,21224,4.65624e+13,1662.79,13677,75698,1562,456,68650,64547,51669,50537,26234
16010,870,1904,11262,4748,3.66126e+13,433.071,4489.97,16010,590,143,14106,13685,13222,13165,11618
4297,480,589,2770,1527,2.87561e+13,148.884,1194.17,4297,154,99,3708,3659,3680,3651,3293
67714,1766,3688,42894,24820,2.98173e+13,579.236,10271.1,67714,1173,324,64026,63892,61050,61672,47183
50978,1197,2979,36237,14741,3.26298e+13,862.255,9501.27,50978,933,252,47956,46241,45018,45870,29424
3942,272,409,2300,1642,3.18643e+13,139.938,808.49,3942,83,76,3533,3496,3270,3415,2887
58754,2181,5893,49940,8814,4.22168e+13,16.9942,6819.86,58754,2949,2945,52861,52861,30614,43587,41744
19885,2144,2174,13836,6049,4.07756e+13,584.418,5361.42,19885,617,193,17711,17711,17711,17711,17660
42934,1179,3615,29795,13139,5.10625e+13,942.211,9139.57,42934,1045,427,38565,37391,27361,12288,12733
3455,262,484,2235,1220,3.06303e+13,161.764,994.16,3455,138,87,2971,2875,2810,2804,2366
11425,1513,2175,8494,2931,6.36095e+13,290.342,4075.23,11425,488,176,9250,9204,6358,7053,6125
39908,1465,3588,28006,11902,5.28995e+13,954.21,8854.54,39908,999,418,35777,34547,26509,13463,13696
90764,1177,4418,64236,26528,4.73282e+13,1582.08,15673.6,90764,1845,567,83161,78919,61117,48125,28941
4941,684,959,3179,1762,2.89397e+13,123.959,1738.77,4941,185,129,3982,3935,3912,3880,3154
50649,2012,2973,35871,14778,3.30777e+13,903.886,9584.45,50649,966,256,47676,47667,47398,45998,41137
23823,57,2461,16537,7286,3.80346e+13,796.416,6290.66,23823,810,236,14892,9107,7999,6023,1460
12293,62,2431,9077,3216,7.0486e+13,338.173,4312.45,12293,540,158,7517,4894,2969,1837,118
37838,1471,2583,26170,11668,2.8131e+13,556.627,7144.9,37838,888,257,35255,35186,34013,30629,22960
24816,750,1656,14746,10070,3.18406e+13,302.816,3690.74,24816,354,172,23160,23100,17022,11860,6960
53703,1403,3041,35631,18072,2.92297e+13,538.98,8590.58,53703,1068,261,50662,50424,46506,41547,24748
99026,2260,4649,70269,28757,4.49829e+13,1752.83,16434,99026,1751,627,93817,90160,77357,75347,55389
14924,791,807,8725,6199,3.25173e+13,246.82,1972.05,14924,236,132,14117,14117,14112,14116,14084
71182,524,4019,49479,21703,5.01199e+13,1254.65,12374.5,71182,1520,468,62087,58160,39292,17552,8225
28279,4790,28278,14140,14139,5807740,3.53619e-05,28278.4,28279,14139,2,1,1,1,1,1
70116,2396,3443,46321,23795,2.96651e+13,710.199,10149.3,70116,1195,289,66673,66436,65562,66251,52116
99753,18856,25405,82162,17591,2.52851e+13,5113.94,41822,99753,9017,26,74348,74348,70447,71737,64603
87264,3238,4122,59945,27319,4.67377e+13,1283,13493,87264,1560,474,83142,82875,77424,44808,56500
23632,168,1530,14950,8682,2.99392e+13,440.753,4096.63,23632,385,246,20558,18988,16349,10845,6365
77536,928,4014,51627,25909,3.10636e+13,932.711,12087.8,77536,1309,297,72682,71024,54245,48811,27144
84835,341,4247,60890,23945,4.84848e+13,1737.54,15038.5,84835,1740,572,70991,65705,37543,30388,9496
55117,2264,3641,37466,17651,4.64045e+13,878.946,9687.42,55117,995,423,51476,50669,42195,17075,25165
8297,438,754,5357,2940,2.97516e+13,325.546,1819.55,8297,269,142,7496,7090,6984,6712,5609
9803,552,1169,6341,3462,2.87849e+13,257.836,2522.51,9803,284,164,8634,8431,8228,8004,6877
49292,193,2965,32534,16758,2.91206e+13,482.467,8170.25,49292,1068,250,42535,35547,26000,9880,7308
84203,1423,4246,58413,25790,4.77357e+13,1382.9,14302.1,84203,1796,535,78089,73854,57824,33630,30085
3081,1034,1072,2297,784,4.82347e+13,131.694,1593.96,3081,391,104,2009,2009,2000,2006,1972
10424,448,650,6095,4329,3.2642e+13,234.711,1521.45,10424,187,105,9774,9721,9085,9374,8364
21548,2160,2592,14977,6571,4.57559e+13,864.538,6227.21,21548,805,271,18956,18778,17059,17606,17516
44481,452,2065,27459,17022,3.10934e+13,476.894,5941.33,44481,411,297,42014,40438,32495,20438,16317
53036,1173,3051,32575,20461,3.02562e+13,558.349,7582.66,53036,700,307,49985,49722,42126,35033,28955
92386,11087,35637,75207,17179,2.03494e+13,440.631,43902.1,92386,4159,170,56749,56623,41324,38270,25610
60184,1905,3353,40684,19500,2.91127e+13,686.624,9519.88,60184,1060,278,56831,56622,55063,49471,41129
61614,2667,3695,42789,18825,3.16971e+13,929.878,11256.6,61614,1028,301,57919,57828,57856,57284,50608
92579,2389,4709,62367,30212,3.50051e+13,1196.73,14736.3,92579,1381,419,87870,87192,82106,82168,58429
38591,846,1977,23880,14711,3.09395e+13,419.704,5482.78,38591,417,287,36614,36407,30178,21309,19236
9580,795,994,5754,3826,3.21289e+13,183.94,1955.28,9580,164,116,8586,8586,8002,8229,7026
8480,395,1007,5614,2866,4.00122e+13,282.655,2197.63,8480,271,156,7410,7044,6323,1815,2136
90702,304,2918,56821,33881,3.01754e+13,688.05,10012.6,90702,618,462,83872,78274,66196,45557,24072
18298,485,1042,11813,6485,3.00039e+13,502.134,3059.47,18298,322,200,17065,16518,15425,14780,13353
25412,1599,2589,18684,6728,6.17225e+13,1241.49,6645.34,25412,880,259,22374,20847,15289,16481,15125
64319,2097,3556,46256,18063,4.8305e+13,1411.77,12101.9,64319,1457,357,60566,57317,50481,52903,47937
96764,1994,4659,63956,32808,3.12105e+13,1083.42,14958.4,96764,1362,409,92105,91447,89154,89946,49860
59429,1080,3092,36747,22682,3.04182e+13,586.957,8088.63,59429,711,326,56337,56036,47500,33960,30628
27464,1646,2105,16938,10526,2.79653e+13,322.392,4825.35,27464,735,153,25359,25359,25263,25358,23386
40222,1194,3382,28971,11251,5.9882e+13,1519.99,9281.03,40222,1371,283,35080,32545,23201,22836,16827
74258,3082,3552,48914,25344,3.5702e+13,1007.17,9913.14,74258,859,346,70706,70605,70138,70176,67074
10348,524,854,6703,3645,3.14175e+13,397.433,2176.57,10348,292,168,9494,9106,8755,8312,7857
76405,2724,4212,53380,23025,4.95024e+13,1382.1,13904.5,76405,1784,531,72193,71830,64200,48571,52464
77385,2246,4068,53429,23956,4.82467e+13,1246.77,12770.2,77385,1544,476,73317,70096,59157,34541,41303
71539,1496,4143,49843,21696,3.55727e+13,1095.69,12845.3,71539,1113,403,67096,65373,58937,51155,32681
10235,307,1044,8697,1538,4.22379e+13,16.9649,1420.86,10235,524,519,9191,9191,4799,7356,7003
62529,3723,3773,42839,19690,4.70012e+13,1133.14,10907.2,62529,1342,453,58756,58756,58704,58658,58688
73986,2062,3754,47400,26586,2.96411e+13,605.269,11106.2,73986,1241,325,70232,70202,69677,70140,51239
1205,222,316,959,246,9.62298e+13,91.3369,531.515,1205,53,73,889,865,750,797,754
98091,837,4934,69877,28214,4.52873e+13,1732.47,16839.5,98091,1825,624,87796,83654,51804,34702,14213
12926,1448,2254,9058,3868,4.95325e+13,408.604,4426.01,12926,584,192,10672,10656,8881,9166,8205
48832,2328,2856,33737,15095,2.89379e+13,558.246,8217.63,48832,926,278,45976,45976,45749,45850,39595
1887,275,363,1209,678,3.14726e+13,88.6126,678.56,1887,101,69,1524,1513,1514,1517,1403
63226,394,2643,39787,23439,3.03192e+13,603.536,8209.31,63226,535,410,59187,55800,46596,36109,15457
98360,2777,4417,69449,28911,4.58355e+13,1557.68,16244,98360,1835,573,93943,93252,79467,65702,67415
59124,1838,2083,38166,20958,2.94735e+13,530.726,6776.25,59124,522,334,57041,57040,56701,56524,55521
75887,52,3824,49800,26087,2.97729e+13,678.986,11456.7,75887,1227,353,52340,37822,31148,8859,2579
57571,1358,3571,36591,20980,2.9566e+13,502.887,9519.28,57571,1217,263,54000,53856,47634,46523,31083
40646,2035,2928,27210,13436,3.98176e+13,653.882,6988.22,40646,703,325,37718,37461,34580,11001,13243
13506,1061,2236,9270,4236,5.04271e+13,480.256,4564.58,13506,785,177,11270,10975,9865,8999,6999
39544,1462,3971,33612,5932,4.22201e+13,16.9917,4728.34,39544,1989,1984,35573,35573,20547,29307,28068
77003,715,2748,49460,27543,2.94576e+13,610.875,8882.6,77003,632,411,74140,73128,63680,61457,43072
57933,1601,2175,37266,20667,2.88796e+13,544.619,7043.58,57933,598,349,55758,55749,54744,53713,47736
73655,1108,4243,50970,22685,3.51312e+13,1099.19,13065.9,73655,1121,393,68547,66168,51355,42604,18764
21331,2433,2849,14873,6458,5.3559e+13,448.039,6016.97,21331,732,335,18482,18480,17908,16432,13317
58455,1716,6007,49602,8853,4.21007e+13,18.6858,6957.66,58455,2984,2922,52448,52446,27142,41835,39597
13621,996,1638,8985,4636,2.32277e+13,304.874,3532.85,13621,559,148,11983,11979,11656,11799,6365
25051,2314,3176,17136,7915,5.02798e+13,485.114,6713.17,25051,847,337,21875,21872,19455,12271,12379
78172,1862,2617,50464,27708,3.00297e+13,620.328,8501.86,78172,643,369,75555,75507,73851,72434,64299
5192,402,537,4413,779,4.22012e+13,16.9337,800.557,5192,272,267,4655,4655,3875,4325,4273
96257,4370,4881,64804,31453,3.55244e+13,1309.22,15463.9,96257,1415,429,91376,91348,91271,90182,88937
66342,777,2564,42407,23935,2.94327e+13,570.935,8270.34,66342,582,402,63742,63027,55503,51392,36295
15332,298,860,9883,5449,2.91532e+13,428.128,2569.09,15332,337,189,13846,12841,12391,11858,7378
91350,445,4544,60483,30867,3.09955e+13,896.869,14127.8,91350,1364,371,83829,79703,55272,35451,12303
31816,261,1560,20494,11322,2.90442e+13,557.62,4639.2,31816,423,282,28512,26487,23794,20146,6968
60889,1340,2177,39215,21674,2.9188e+13,578.661,7201.03,60889,576,340,58712,58702,56921,56007,49594
81593,2117,4099,56315,25278,4.93098e+13,1299.88,13381.4,81593,1721,476,77327,73188,59279,34817,40068
81263,2533,2877,51116,30147,3.07526e+13,701.84,9536.84,81263,617,445,78386,78303,76427,77128,74446
62168,2064,3716,43169,18999,3.1623e+13,946.026,11330,62168,1034,305,58452,58275,56775,56459,38458
4621,212,626,2968,1653,2.92066e+13,172.74,1279.43,4621,181,104,3945,3776,3573,3514,2571
55636,1466,3040,37475,18161,2.93672e+13,590.964,8816.51,55636,1042,271,52596,52392,49707,43128,23138
14622,127,1447,10400,4222,3.07483e+13,460.04,3833.76,14622,499,158,10274,6074,6182,1608,1303
47322,374,1945,30290,17032,2.88121e+13,592.116,6330.97,47322,576,321,43661,40407,37570,35522,21539
25483,887,1567,16380,9103,3.00768e+13,422.718,4412.37,25483,424,272,23916,23841,22381,22409,17409
99752,4022,4213,68244,31508,4.51886e+13,1353.05,14768.1,99752,1782,532,95539,95516,94900,92048,89832
94238,1809,4227,65882,28356,4.64073e+13,1317.95,15363.4,94238,1756,549,89169,84630,70401,49891,47701
92632,2102,4270,64087,28545,4.62458e+13,1333.43,14982.8,92632,1814,537,88047,83739,68575,46125,48227
64651,113,4084,45604,19047,5.45804e+13,1434.43,12668.7,64651,1676,509,46978,38340,24705,14054,3591
39732,1494,1868,24961,14771,3.06159e+13,471.641,5511.83,39732,440,295,37864,37859,36424,37051,33856
14399,1960,2197,9830,4569,4.72617e+13,651.293,4602.96,14399,785,166,12202,12181,12014,12072,11969
31840,587,2359,22524,9316,2.743e+13,595.833,6445.26,31840,824,247,28804,26474,17297,9698,3848
49651,1846,3808,34763,14888,5.38118e+13,1149.08,10272.2,49651,1342,462,45543,43222,32990,21437,25333
70293,860,4044,50516,19777,5.26538e+13,1430.01,13263.1,70293,1538,532,62097,58795,43001,38627,25987
63108,1902,8294,41728,21380,2.83275e+13,418.593,13542.8,63108,1138,306,54814,54762,46870,46514,43289
47394,18559,18692,38476,8918,1.70036e+12,96.215,20020.6,47394,1251,146,28702,28702,28625,28702,28610
2001,38,262,1285,716,2.5599e+13,95.1554,562.657,2001,100,58,1290,758,978,549,535
62928,1172,2389,40990,21938,3.42978e+13,589.103,7061.37,62928,607,336,60539,60439,53208,44943,20734
10894,295,722,6357,4537,3.20855e+13,226.077,1659.08,10894,175,116,10167,9846,8243,8090,6053
63250,1562,3528,41980,21270,3.90097e+13,833.769,9629.73,63250,975,414,59722,58740,47287,11548,13126
35485,1522,2550,25294,10191,3.27267e+13,735.023,7355.84,35485,796,200,32935,32245,32063,32127,27198
43232,447,1337,27861,15371,2.93147e+13,564.75,4730.1,43232,480,285,41137,38107,35751,34129,22501
39618,2578,2612,27377,12241,2.8299e+13,557.052,7303.91,39618,890,258,37006,37006,37006,37006,36877
14980,235,2442,10896,4084,6.32551e+13,664.03,4938.11,14980,704,188,11318,10249,5642,4460,2742
25245,1545,1888,18323,6922,2.7201e+13,517.923,5310.44,25245,511,184,23357,23206,23325,23350,22426
71642,1881,2253,46127,25515,2.93388e+13,573.287,7831.65,71642,609,375,69389,69389,68464,67845,65962
94109,2090,4008,62658,31451,3.91876e+13,1330.23,12632.6,94109,1139,459,90101,87946,74571,19700,38881
74757,3672,4163,52527,22230,3.76082e+13,1228.4,13455.5,74757,1335,413,70594,70544,69484,68948,68196
7557,6,348,5136,2421,3.33885e+13,251.122,1394.21,7557,210,111,790,287,338,172,351
81635,2904,3797,55076,26559,4.22349e+13,1136.47,11789.2,81635,1345,451,77838,77539,71334,30220,46205
15712,142,6213,13156,2556,2.95746e+13,218.516,8935.06,15712,1833,12,9271,9135,0,6476,54
69496,456,2176,44809,24687,2.94041e+13,558.962,7396.95,69496,579,346,66047,61129,56256,54853,35977
28283,91,3477,20080,8203,6.12324e+13,666.165,7598.86,28283,871,408,20188,15590,9650,4709,1765
56675,4841,18137,46352,10323,2.53328e+13,4545.13,28002.8,56675,6431,21,35564,26697,26934,31709,18316
84612,2111,4264,58765,25847,4.81138e+13,1388.33,14454.5,84612,1789,544,80030,75781,61259,42677,43958
62034,689,3716,39514,22520,2.9744e+13,565.395,10177.5,62034,1215,308,58091,56769,41235,23290,13352
17545,651,872,11316,6229,2.92143e+13,424.05,2735.16,17545,320,208,16673,16637,16062,15953,15549
38314,1521,2128,27624,10690,2.81124e+13,635.773,6591.6,38314,784,251,36186,36158,35071,35793,28723
37581,1828,3775,31944,5637,4.22162e+13,16.9912,4512.87,37581,1891,1886,33806,33806,22152,28945,27987
5240,1480,1502,4492,748,3.99585e+13,5.13531,2586.68,5240,751,5,3738,3738,3738,3738,3698
25962,4998,11058,21419,4543,2.44862e+13,1046.22,15200.1,25962,3003,13,14904,13753,13787,10637,5763
96549,3837,4510,63736,32813,2.94387e+13,984.075,14176.5,96549,1277,412,92039,91935,92039,92039,88211
90367,3940,4032,60386,29981,3.96114e+13,1353.23,12740.9,90367,1183,442,86335,86334,86242,86177,85243
70216,1892,2737,43847,26369,3.03539e+13,646.749,8768.01,70216,554,428,67479,67299,61788,59132,50527
14970,24,1017,9681,5289,3.03468e+13,402.244,2746.23,14970,291,202,7683,3784,4789,1529,943
31342,2686,3274,23057,8285,6.38151e+13,1451.71,8077.82,31342,1043,316,28068,27695,27266,27141,26567
81387,3193,3959,52865,28522,2.95721e+13,667.248,12067.5,81387,1244,383,77428,77426,77422,77289,70340
93234,68,4525,62931,30303,3.62462e+13,1223.83,14762.2,93234,1365,423,65206,48868,35319,9152,4023
83098,2648,3949,55260,27838,3.99297e+13,1200.41,11746.8,83098,1041,424,79149,78561,69732,22178,35692
33735,2013,3654,24110,9625,5.91048e+13,1044.03,8540.97,33735,1207,414,30081,28249,22726,19674,20088
65722,1456,2827,42958,22764,3.52552e+13,571.331,7791.94,65722,654,334,62895,62864,57164,54123,39658
85982,618,2880,53895,32087,3.02003e+13,687.211,9690.65,85982,593,455,82626,81397,65444,49330,32427
60882,2699,3560,43474,17408,3.97459e+13,1111.04,11590.2,60882,1162,378,57322,57196,53045,54538,51764
98641,4111,4221,68022,30619,4.57042e+13,1363.77,15207.6,98641,1782,534,94420,94413,94095,92104,90894
94506,147,3004,59138,35368,3.01042e+13,715.345,10297.2,94506,632,473,82232,75805,62449,40400,14402
91310,1444,4665,60595,30715,3.16447e+13,1060.13,14520.5,91310,1366,324,86443,84577,71921,68139,33119
44396,2134,2226,27871,16525,3.03666e+13,519.004,6298.63,44396,476,339,42170,42170,42124,42166,41702
86010,2765,2865,54808,31202,2.91223e+13,675.121,9592.9,86010,655,431,83145,83130,83106,83135,82623
42094,715,1849,27158,14936,2.9482e+13,527.424,5889.23,42094,491,317,40245,39683,36495,35394,27113
88977,2302,3952,58255,30722,2.98832e+13,723.095,12630,88977,1255,393,85025,84842,83956,84507,57508
60292,1985,3531,43133,17159,4.21838e+13,1251.1,11679.3,60292,1261,360,56601,54677,50159,47745,41134
20397,1217,2129,13375,7022,2.63628e+13,327.985,4739.38,20397,721,165,18268,18262,17549,17476,12017
79813,1125,3696,53920,25893,4.22151e+13,1110.3,11470.7,79813,1230,444,75070,73026,55932,15759,18244
31155,439,2209,22171,8984,3.32269e+13,734.257,6586.8,31155,750,199,27826,26842,20364,22969,8584
1267,17,370,776,491,2.65503e+13,54.5675,603.294,1267,86,85,554,261,283,169,71
95082,4222,4378,66995,28087,4.64903e+13,1589.09,15957.6,95082,1798,567,90704,90685,90349,89008,86723
24414,163,1021,15675,8739,2.88576e+13,504.852,3396.72,24414,389,233,20841,19626,17155,16606,5734
34779,250,2612,21719,13060,2.90584e+13,335.12,5991.95,34779,921,164,30609,28386,19987,12435,10134
19639,447,2507,13907,5732,5.7811e+13,807.274,5799.87,19639,808,227,15798,14590,10130,9373,4770
28948,1231,2745,21098,7850,6.1107e+13,1259.08,7285.67,28948,962,268,25218,23901,16227,16579,13440
21201,865,1217,13691,7510,3.18096e+13,484.703,3414.49,21201,371,219,19984,19976,18968,18134,16473
51395,2748,3609,35355,16040,4.73305e+13,949.815,9651.66,51395,1070,426,47786,47606,43112,22050,27590
50467,3232,10123,35179,15288,2.61936e+13,225.254,13760.5,50467,1306,157,40344,40310,31389,32640,31186
84067,2897,4342,57908,26159,3.69569e+13,1230.8,14251.5,84067,1346,421,79725,79376,75025,73996,64643
98230,949,4327,68336,29894,4.57702e+13,1342.64,15577.6,98230,1853,542,90096,86138,66327,36852,28453
22731,297,1023,14705,8026,3.06161e+13,506.614,3266.59,22731,392,215,20540,19065,18083,17303,10357
94722,1964,4547,67735,26987,4.55195e+13,1762.95,16011.9,94722,1722,630,89304,85114,72424,69553,45862
11741,647,931,7598,4143,3.00868e+13,358.563,2393.8,11741,308,161,10810,10598,10556,10512,10276
5466,73,546,3502,1964,2.95053e+13,240.354,1299.87,5466,186,125,4284,3134,3304,3283,1497
12905,641,796,8349,4556,2.97725e+13,393.732,2310.11,12905,285,180,12109,12096,11782,11738,11520
48464,739,1881,31259,17205,2.96372e+13,547,6083.31,48464,507,317,46583,46286,41850,41447,34856
65962,58,3718,47453,18509,4.76482e+13,1494.61,12446.2,65962,1462,403,41874,26389,19754,9204,2914
18231,752,1512,13201,5030,2.99771e+13,390.473,4260.39,18231,448,180,16719,16495,13655,13957,8232
68264,3406,3907,46276,21988,3.14166e+13,883.682,11704.7,68264,1124,290,64357,64271,64357,64357,61962
13550,679,1881,9298,4252,2.4154e+13,360.91,3945.52,13550,643,159,11669,11460,7585,8185,3288
53280,2428,3620,36241,17039,4.68394e+13,839.03,9510.89,53280,999,431,49660,49247,40150,16961,25277
49983,2105,3450,35846,14137,5.29795e+13,1535.63,10588.1,49983,1445,349,46409,43166,36761,38677,36129
62763,1015,2616,39844,22919,3.04228e+13,561.896,8148.01,62763,572,396,60147,59951,52767,44466,34098
24746,1094,1671,14941,9805,3.17511e+13,288.071,3993.01,24746,321,227,23075,23068,19762,20898,14282
43679,718,2787,31278,12401,2.69374e+13,814.331,8013.7,43679,805,260,40359,38737,23364,14713,8978
91506,2203,4129,62723,28783,4.62382e+13,1273.16,13666.3,91506,1590,472,87303,83410,69581,35753,44244
70577,1599,3713,44835,25742,2.99536e+13,608.306,10579,70577,1173,334,66864,66677,60618,61496,44697
93177,1590,3908,63568,29609,4.504e+13,1292.99,13271.5,93177,1548,473,88107,84592,66464,29783,32658
54347,703,1984,35143,19204,2.99252e+13,541.791,6397.52,54347,498,316,52363,51961,45948,45266,38067
5329,84,474,3878,1451,3.07811e+13,163.436,1367.73,5329,200,95,4416,4036,2756,1371,1285
2686,192,614,1962,724,8.18278e+12,354.458,1115.17,2686,216,55,1636,1248,874,1534,1457
13073,1073,1384,8000,5073,3.15435e+13,209.453,2908.15,13073,252,181,11689,11689,10709,11172,8591
33802,11258,13332,27430,6372,1.69682e+12,93.8483,14438.4,33802,1056,132,20470,20470,17482,20234,17567
54972,1652,3404,39372,15600,5.03572e+13,1364.45,11092.1,54972,1361,361,50881,47508,40872,39600,33360
36542,1364,1936,22018,14524,3.18149e+13,375.174,4968.25,36542,465,252,34606,34535,30621,32152,27704
94271,1507,4305,66228,28043,4.68704e+13,1348.19,15570.9,94271,1824,541,88324,83715,67994,45260,41406
90535,1317,4412,65027,25508,4.50417e+13,1742.98,15481.3,90535,1654,593,83582,79029,62275,59963,35025
36484,3178,3278,26626,9858,6.18577e+13,1497.59,8564.04,36484,1152,348,33206,33205,33150,33183,32966
91963,2924,4540,60771,31192,3.07519e+13,980.242,14139.5,91963,1361,400,87423,87031,87190,86954,67865
37237,1408,1985,22707,14530,3.1148e+13,414.702,5296.51,37237,392,284,35252,35217,31740,33145,28119
92010,3648,4308,59946,32064,2.96885e+13,829.046,13570.5,92010,1244,436,87702,87664,87702,87623,81966
7903,256,552,4621,3282,3.25007e+13,193.221,1248.85,7903,145,101,7351,7167,6174,6664,4272
80221,760,3936,55310,24911,4.72017e+13,1267.15,12435,80221,1400,481,73060,71169,48940,14708,11073
45209,2031,3748,32684,12525,6.18613e+13,1407.45,10041.6,45209,1292,452,41346,37906,30217,30912,31855
69775,670,2645,44007,25768,3.04985e+13,636.236,8591.76,69775,579,419,66835,65898,54169,43613,30588
22403,1232,1524,14409,7994,2.91863e+13,435.116,3997.51,22403,396,236,20879,20871,20689,20667,19024
34280,1855,2309,24626,9654,2.89294e+13,624.517,6729.82,34280,650,211,31971,31963,31873,31965,30285
56671,9899,18137,46348,10323,2.53346e+13,4520.99,28002.2,56671,6431,21,38534,31899,32952,35008,26015
16707,1192,1328,10669,6038,2.84052e+13,397.016,3331.45,16707,399,204,15379,15379,15351,15342,15003
1333,91,260,836,497,2.8715e+13,74.6864,483.245,1333,81,49,1060,892,891,904,583
63609,58,2908,41625,21984,3.50039e+13,573.253,7886.57,63609,554,334,45299,31520,32816,4181,1549
32867,1021,1742,21234,11633,3.01791e+13,570.289,4958.24,32867,425,293,31125,30963,28982,27557,17945
4889,317,473,3568,1321,3.14773e+13,169.087,1308.68,4889,193,90,4416,4410,4219,4354,3044
19614,180,1404,12675,6939,2.97056e+13,414.127,3743.61,19614,378,231,16751,15721,13711,12479,6172
30196,2838,3031,25678,4518,4.21157e+13,17.0457,3697.76,30196,1518,1514,27165,27165,26026,26686,26604
91427,2019,4159,62719,28708,4.67803e+13,1363.77,14324.5,91427,1774,525,86852,82569,66749,37686,43852
82982,149,2445,53496,29486,2.96779e+13,615.733,8451.24,82982,663,362,70767,66568,57165,47338,8961
64821,1865,2673,40530,24291,3.02623e+13,629.168,8340.46,64821,559,392,62148,62017,56600,55072,46793
72002,168,2329,46443,25559,2.95303e+13,577.484,8008.89,72002,614,374,61977,57831,50407,41598,15234
95295,86,4568,67282,28013,4.25027e+13,1687.41,15918,95295,1702,520,65716,47405,34180,9890,3043
84366,13069,15337,58826,25540,2.54012e+13,362.864,21960.4,84366,1625,313,69029,69029,66977,68524,66618
71038,2508,2540,45889,25149,3.03687e+13,637.149,7870.79,71038,675,366,68498,68496,68491,68471,68458
26657,1367,1718,15812,10845,3.1794e+13,291.38,3828.78,26657,375,181,24939,24935,23507,24115,22115
6305,449,673,4099,2206,3.10716e+13,301.259,1581.51,6305,250,128,5615,5329,5269,5152,4433
44031,473,2826,29561,14470,2.85339e+13,501.7,7762.77,44031,976,256,39979,37634,26960,18029,10995
56901,15370,18146,46569,10332,2.54142e+13,4498.33,28021,56901,5376,18,38755,38755,38574,38574,33753
51092,704,2621,33906,17186,3.85545e+13,715.635,7228.16,51092,659,339,48273,47635,36240,6568,5397
93995,1318,4558,66928,27067,4.42783e+13,1723.9,15963.6,93995,1696,599,86843,82302,64604,55602,32140
34537,1329,1623,22640,11897,3.47057e+13,506.873,4777.68,34537,431,273,32914,32910,32125,32175,30757
85935,465,2928,53769,32166,3.03493e+13,682.121,9760.2,85935,590,456,81546,77840,64200,47876,24462
43833,1347,2051,28844,14989,3.63223e+13,514.993,5801.43,43833,468,291,41782,41771,39398,37192,29838
4250,783,1292,2745,1505,4.77545e+13,155.058,1985.68,4250,340,114,2958,2958,2635,2940,1515
9894,431,1109,6353,3541,2.87615e+13,275.257,2451.85,9894,278,183,8785,8422,7753,7774,3745
51786,271,1938,33359,18427,2.94375e+13,542.895,6314.2,51786,503,317,46599,42841,40362,37427,18485
25234,1822,2539,21450,3784,4.22106e+13,16.9879,3140.58,25234,1273,1268,22695,22695,18415,20908,20565
39490,661,2570,28074,11416,3.2854e+13,766.603,7814.58,39490,1034,215,36220,34413,26350,25788,12183
81447,3857,3897,55685,25762,4.65604e+13,1213.42,12298.5,81447,1404,470,77550,77550,77503,77398,77410
75667,3408,3745,54433,21234,4.34518e+13,1514.92,13353.4,75667,1408,405,71922,71720,71584,70278,69501
60702,1483,3580,43328,17374,3.56788e+13,987.406,11266.8,60702,1018,363,57042,55393,50854,50403,35609
58189,1910,3864,41106,17083,5.48481e+13,1318.15,11390.9,58189,1498,467,53930,50298,39834,29931,31650
63923,1763,3441,41973,21950,2.96451e+13,663.991,9732.48,63923,1194,277,60482,60305,58889,59901,33342
19695,777,894,12690,7005,2.91404e+13,451.286,2941.53,19695,333,214,18801,18798,18553,18410,18284
72367,3488,4205,50497,21870,3.61282e+13,1111.14,13036.4,72367,1105,407,68162,67964,65455,66529,63924
5687,763,1434,4205,1482,7.95581e+13,168.758,2413.29,5687,279,134,4253,4166,4032,4137,3219
83075,606,3570,54706,28369,3.58484e+13,1164.36,10966,83075,920,357,78482,76609,61411,8785,8764
2280,97,312,1466,814,2.53057e+13,89.861,640.876,2280,109,61,1937,1647,1680,1724,1106
20916,243,2104,13860,7056,2.60265e+13,329.955,4822.53,20916,710,176,17358,15596,11415,9564,4292
9613,3982,6681,7652,1961,1.99759e+13,2.19515,7532.1,9613,1279,11,2932,2932,2932,2932,2932
90790,3410,4235,63278,27512,4.69879e+13,1320.28,15004.1,90790,1822,543,86555,86370,82322,60786,67143
84252,2846,4216,57905,26347,4.82165e+13,1379.26,13895.4,84252,1784,504,80036,79761,71884,44837,53452
93431,3713,3985,63925,29506,4.52582e+13,1260.09,13453.9,93431,1523,474,89446,89444,88231,84566,76817
47887,2050,2375,31523,16364,3.93509e+13,541.39,6526.98,47887,487,289,45512,45512,44940,45039,42837
14526,966,998,9322,5204,2.86393e+13,392.322,2687.49,14526,282,177,13528,13528,13515,13486,13458
38088,623,2568,27279,10809,3.24296e+13,761.764,7681.45,38088,860,216,34735,33280,24208,23828,10945
79498,1253,2768,50209,29289,3.01745e+13,655.996,9247.25,79498,590,437,76730,76461,67369,55773,47379
54707,3301,3478,39160,15547,3.97014e+13,948.66,10847.6,54707,1016,348,51229,51229,51197,50942,50733
2193,264,484,1482,711,3.54245e+13,79.8855,833.84,2193,132,56,1709,1708,1625,1570,1522
22945,982,2592,16701,6244,5.73562e+13,1185.2,6312.84,22945,860,237,19376,18287,12487,13558,10377
61641,860,3726,42209,19432,3.08153e+13,798.344,10813.2,61641,1088,288,57219,55760,42294,29372,14140
50057,2052,2242,32899,17158,3.65518e+13,547.971,6358.32,50057,492,311,47815,47815,47493,47574,46843
33677,1505,1764,21158,12519,3.03885e+13,466.106,5029.25,33677,442,271,31913,31912,31298,31532,29378
39604,1303,2081,26088,13516,3.76138e+13,505.868,5657.62,39604,451,277,37523,37514,34994,32738,21870
87087,2654,3988,57469,29618,2.98297e+13,754.542,12657.7,87087,1254,405,83099,82845,82132,82646,57968
57672,1481,3462,40789,16883,3.1208e+13,967.943,10668.5,57672,992,286,54210,52764,50009,49386,31215
36320,915,2600,24576,11744,2.76911e+13,508.933,6973.28,36320,923,232,33612,33099,26989,22145,11964
51203,2203,2308,33015,18188,2.99398e+13,592.4,7069.96,51203,535,370,48895,48895,48858,48881,48618
19925,2880,3195,14079,5846,6.12369e+13,619.406,6324.61,19925,810,402,16730,16729,16524,16133,14911
13201,1564,1830,9273,3928,3.71193e+13,397.078,4022.62,13201,542,134,11371,11292,11303,11336,11026
6073,448,494,3542,2531,3.23793e+13,182.254,1073.76,6073,120,88,5579,5573,5538,5552,5411
4770,221,866,3547,1223,9.21051e+13,232.095,1550.56,4770,88,225,3719,3231,1271,2352,1450
23892,550,1607,14762,9130,3.04572e+13,298.81,4019.76,23892,371,221,22285,21998,18359,12322,11335
26904,1759,2706,19126,7778,5.48129e+13,1270.48,7064.4,26904,1116,243,24077,22384,19466,19526,19533
44324,2653,3750,32100,12224,6.18697e+13,1458.4,10088.3,44324,1310,456,40574,40290,35387,32795,34458
63286,70,2444,41453,21833,3.53268e+13,585.986,7187.82,63286,580,337,47744,34900,33876,4345,1888
85680,3240,4322,60689,24991,4.1833e+13,1564.47,14876.1,85680,1546,449,81358,81009,73867,74916,68056
83344,6171,19829,60681,22663,2.34939e+13,257.81,25850.4,83344,1910,187,63515,63447,45579,45153,43568
70061,3380,3886,50417,19644,4.8442e+13,1677.98,13081.8,70061,1493,477,66175,65940,64880,65053,64217
3933,96,411,3342,591,4.22924e+13,16.9102,638.17,3933,209,204,3522,3522,1660,2741,2599
86286,2420,3738,57502,28784,4.02857e+13,1050.63,11185.4,86286,1062,440,82548,81632,68862,19641,37050
28763,958,1096,18555,10208,2.94459e+13,501.202,3712.66,28763,416,248,27667,27666,27327,27297,27156
76217,458,4348,52956,23261,3.67772e+13,1201.44,13588.5,76217,1197,423,67129,63051,41673,21734,10595
97196,675,3028,62753,34443,3.02386e+13,783.074,10114.7,97196,761,427,93789,92221,78519,74033,36482
6038,568,837,3891,2147,2.99766e+13,256.812,1766.98,6038,254,130,5201,5075,5020,5020,4685
78300,1127,3630,51834,26466,3.80072e+13,876.397,10384.9,78300,1020,425,74468,73284,59138,11973,12545
32873,900,1531,21349,11524,3.05719e+13,643.729,4690.57,32873,481,287,31342,31061,29077,28072,23019
32125,269,1850,19189,12936,3.14543e+13,310.459,4452.26,32125,421,219,30016,28871,20638,6988,4182
37782,1834,2712,25040,12742,2.79023e+13,483.211,7119.85,37782,973,223,35070,35070,34424,32670,28687
22735,1208,1369,14666,8069,2.86427e+13,473.8,3654.68,22735,406,215,21366,21366,21350,21353,21249
97448,2634,6391,68475,28973,4.53483e+13,1634.57,18433.5,97448,1910,611,90873,89477,58639,36877,23185
50327,92,2893,35830,14497,3.11532e+13,836.411,9197.51,50327,926,241,35117,24385,18765,8846,5140
8995,583,936,5809,3186,3.11204e+13,354.788,2126.54,8995,317,150,8059,7886,7743,7621,7118
14305,1538,1555,9728,4577,5.04088e+13,310.279,3402.64,14305,297,203,12750,12750,12750,12730,12743
58305,296,611,39527,18778,3.35262e+13,301.527,4082.85,58305,303,252,57479,56010,40496,40691,37675
16886,849,2050,11239,5647,2.58046e+13,334.95,4385.06,16886,688,162,14836,14689,11789,12106,6499
46949,3269,3596,33689,13260,5.73307e+13,1571.37,10320,46949,1432,399,43353,43351,42711,42999,42684
13353,76,786,7792,5561,3.17598e+13,238.733,1872.74,13353,195,134,11419,10439,7708,3605,2855
78799,631,3980,49857,28942,2.95502e+13,739.615,11524.6,78799,1074,389,74302,72592,55746,38559,21326
32162,11866,13908,26068,6094,2.65198e+13,3131.38,19087.5,32162,3398,13,18254,16455,17654,17646,18254
92277,961,4420,62699,29578,3.63899e+13,1234.99,14770.4,92277,1398,417,85780,82547,65990,46874,29600
96365,1839,4391,67973,28392,4.64073e+13,1569.02,16000.8,96365,1826,572,90788,86252,71286,52508,44876
14542,2174,2264,9978,4564,4.91773e+13,618.819,4729.6,14542,788,176,12278,12247,12248,12252,12183
20688,1480,1953,14415,6273,3.53033e+13,587.468,5140.39,20688,621,156,18735,18179,18345,18396,16877
93863,2885,3024,59578,34285,3.03906e+13,717.747,10223.3,93863,691,450,90839,90839,90693,90724,89494
47092,127,1905,30235,16857,2.94699e+13,545.591,6238.98,47092,535,341,39524,36861,31785,26542,7251
1460,44,429,1073,387,9.19528e+13,94.7493,628.912,1460,53,96,947,773,189,272,147
26280,127,2957,18012,8268,4.87427e+13,516.938,6600.86,26280,810,339,20138,17717,12186,3961,1252
74477,2415,3894,53469,21008,4.62997e+13,1630.68,13480.2,74477,1554,404,70390,68154,60014,61337,53321
79680,955,2865,49916,29764,2.99913e+13,668.387,9384.34,79680,592,431,76762,76337,64084,50083,39026
47253,2905,2991,33736,13517,4.83079e+13,1260.71,9887.82,47253,1164,340,44262,44262,44251,44222,44078
78269,1283,4243,54918,23351,4.98934e+13,1369.4,14111.8,78269,1785,533,71800,67731,51760,35051,28771
83176,738,3853,56269,26907,4.36654e+13,1207.48,12080.4,83176,1378,473,76752,74886,55573,14331,15585
27392,978,1371,17847,9545,3.28715e+13,504.784,4048.53,27392,421,252,26021,26014,24790,24328,21548
2596,349,1018,1755,841,6.77625e+13,70.9969,1446.45,2596,275,90,1578,1558,1301,1193,747
14959,489,1513,12715,2244,4.22201e+13,16.9776,1972.25,14959,760,755,13446,13446,7326,10892,10393
29952,2201,2788,21310,8642,4.703e+13,847.939,7584.88,29952,834,295,27164,26931,23670,24771,24738
88368,486,3845,59543,28825,4.19011e+13,1214.15,12233.8,88368,1385,473,80304,74550,57950,12143,10258
8429,96,564,5439,2990,3.04032e+13,312.45,1633.42,8429,229,138,6997,6344,5375,5003,2301
59179,3096,3514,42444,16735,4.14743e+13,1245.57,11531.9,59179,1249,354,55665,55659,54573,53629,53552
32850,1614,3205,23714,9136,6.20181e+13,1331.71,8262.38,32850,1124,273,29069,26999,19708,20266,19360
38356,687,3724,28192,10164,6.62636e+13,1444.9,9355.95,38356,1198,452,31604,30232,14077,10991,5136
85894,239,4118,54865,31029,2.94428e+13,733.226,12595.5,85894,1247,409,76059,70197,53383,26956,11027
25875,101,1490,16681,9194,2.96754e+13,514.085,4169.74,25875,395,264,21171,19144,16654,14432,2942
49442,34,2272,31714,17728,2.97019e+13,591.607,6937.56,49442,577,359,29820,17185,19962,10772,2447
83757,1929,4284,59131,24626,4.05679e+13,1320.08,14457,83757,1421,443,79134,76641,67846,66372,43804
67879,426,3825,48673,19206,4.91945e+13,1507.19,12786.1,67879,1465,464,57078,53725,33425,32559,10685
98463,673,3379,63054,35409,3.15673e+13,900.236,10980.2,98463,729,461,94507,93103,76686,9948,15003
36938,1383,1739,23808,13130,2.92346e+13,515.091,5452.54,36938,443,302,35199,35193,34554,34386,33027
40262,11837,20247,32139,8123,2.39681e+13,198.066,23073.9,40262,2429,138,20015,20015,20013,19548,18648
98078,2874,33499,79802,18276,2.30259e+13,2585.59,45722.8,98078,6225,162,59635,52377,35648,22743,10527
78114,3528,3883,51334,26780,2.98647e+13,682.622,11676.3,78114,1240,359,74231,74231,74231,74231,70198
22990,764,2686,16206,6784,6.05442e+13,953.537,6468.17,22990,1001,234,19343,18579,13087,13106,7927
59774,2752,3857,42099,17675,5.37492e+13,1309.78,11445.3,59774,1412,459,55917,55700,49860,36272,40754
83947,3542,4313,59086,24861,3.97265e+13,1331.42,14466.6,83947,1423,434,79634,79446,75006,75902,72240
32189,2234,2807,22653,9536,4.90596e+13,1260.42,7913.32,32189,1109,308,29382,28248,25742,26758,26276
25712,1362,2223,17466,8246,2.75442e+13,511.769,5680.18,25712,863,193,23489,23476,22951,21851,16334
8783,606,698,5625,3158,2.7865e+13,305.762,1831.4,8783,256,147,8085,7998,8024,7968,7526
5282,25,656,3411,1871,3.06953e+13,281.605,1452.79,5282,240,130,2728,1449,1671,759,553
93695,829,4437,65844,27851,4.09228e+13,1591.43,15545.5,93695,1669,452,84639,80850,54588,36698,16480
27848,4817,12906,22756,5092,2.50795e+13,947.469,17009.2,27848,3797,16,14942,12894,12175,13732,10651
93614,1772,4582,66393,27221,4.29175e+13,1701.31,15855.4,93614,1698,525,87861,83658,72353,70466,44628
43625,2437,3701,30860,12765,5.63965e+13,1155.9,9673.03,43625,1267,447,39924,38544,33402,24282,27552
79451,609,2820,49864,29587,3.02405e+13,669.291,9323.91,79451,616,438,76111,74583,60785,47010,32512
17502,29,883,11262,6240,2.90604e+13,459.027,2734.53,17502,368,198,9904,6013,6543,2318,1350
79471,2718,4108,54911,24560,4.88113e+13,1273.33,13074.8,79471,1576,477,75363,75066,66820,40017,48729
56702,1443,2319,37082,19620,3.46214e+13,551.105,6686.82,56702,501,331,54383,54372,50683,47956,38348
59350,236,3580,37851,21499,3.001e+13,504.241,9724.95,59350,1213,277,52426,48587,34877,13193,7189
57668,694,3315,41101,16567,3.32887e+13,941.483,10609.1,57668,1008,321,52557,50101,37971,31767,26341
72650,1151,2263,46862,25788,2.93635e+13,582.24,7866.35,72650,655,374,70387,70299,65849,65026,51611
36676,968,1823,23528,13148,2.95392e+13,486.673,5456.4,36676,518,310,34853,34778,32461,32835,26124
39013,2406,2741,26174,12839,2.83219e+13,493.633,7308.54,39013,960,234,36272,36272,36245,36272,34016
96871,2058,4073,64654,32217,3.93199e+13,1414.68,13086.6,96871,1080,460,92780,90472,76878,19741,37527
2276,530,550,1449,827,2.52312e+13,85.6902,864.235,2276,175,63,1726,1726,1724,1726,1717
70987,3854,3901,49098,21889,4.99772e+13,1171.82,11838.1,70987,1378,468,67086,67086,67075,66999,67051
92675,1369,3253,60012,32663,3.16622e+13,843.088,10328.7,92675,745,429,89422,89049,79255,74273,52069
26138,769,1572,18852,7286,2.62462e+13,633.466,5093.61,26138,752,201,24324,23804,19999,20709,17978
71486,2882,3585,47516,23970,2.89183e+13,782.957,10626.6,71486,1174,282,67901,67664,67797,67897,63273
30793,144,1764,22226,8567,3.05814e+13,547.891,5646.89,30793,537,214,24968,18819,15264,3786,3782
53815,1364,1989,34737,19078,2.94156e+13,530.825,6327.49,53815,498,309,51826,51818,50985,50785,46847
9496,646,1241,6765,2731,2.45996e+13,227.486,2800.07,9496,298,112,8255,8238,7874,7947,6368
37825,673,2744,26957,10868,4.11331e+13,852.372,8283.2,37825,830,293,33594,32359,27321,26165,17170
79149,2087,2787,50133,29016,2.98905e+13,666.724,9270.85,79149,610,437,76362,76237,72454,71062,65897
41731,753,1813,26960,14771,2.97887e+13,533.565,5781.21,41731,492,331,39918,39400,35898,35114,21921
8708,521,1221,5465,3243,3.02325e+13,175.238,2401.04,8708,261,153,7487,7448,6513,5304,4173
41910,1661,2679,27057,14853,2.8851e+13,443.406,7174.83,41910,1052,200,39231,39230,38618,37489,27884
70652,2337,3701,47664,22988,4.20534e+13,1071.82,10720,70652,1064,442,66951,65549,56171,19706,33529
54124,2450,3469,38544,15580,4.1533e+13,1086.86,10926,54124,1092,352,50655,50353,46155,47124,43277
29644,227,1411,17392,12252,3.17589e+13,318.695,3392,29644,420,179,27785,25891,17923,6330,2133
21767,934,967,13989,7778,2.93344e+13,452.778,3116.57,21767,396,212,20800,20800,20762,20783,20759
33970,377,2502,22292,11678,2.84468e+13,460.771,6532.26,33970,962,196,30043,27743,20714,14918,9213
2260,106,320,1320,940,3.15547e+13,93.7257,568.122,2260,59,55,1904,1760,1584,1483,886
29535,9286,12658,23688,5847,1.98598e+13,108.865,14697.2,29535,1105,138,16877,16877,16877,16877,16877
72371,1628,3923,49836,22535,4.89709e+13,1190.34,11925.8,72371,1385,470,67651,65035,51678,23423,29009
49336,1487,2951,34876,14460,3.33358e+13,879.329,9465.58,49336,968,247,46385,45091,44147,42956,33241
59468,467,3649,40254,19214,4.51296e+13,881.812,9834.98,59468,1018,420,53837,50132,38915,9348,10292
74134,2127,4284,51630,22504,3.66624e+13,1164.11,13330,74134,1145,416,69850,68893,63398,62715,44506
36361,2238,2568,23814,12547,2.82597e+13,451.696,6781.13,36361,972,198,33793,33792,33617,33793,30776
51224,42641,51223,25612,25612,5807920,1.95221e-05,51223.4,51224,25612,2,1,1,1,1,1
74802,2013,3532,49454,25348,3.68384e+13,1008.82,10130.7,74802,864,343,71270,70403,61526,15938,21805
53713,961,3650,36906,16807,4.66848e+13,1044.71,9937.62,53713,1096,425,48997,47420,33661,10919,10081
31768,395,462,21481,10287,3.34539e+13,292.303,2936.36,31768,284,208,31306,31306,29965,30092,29711
27932,401,2640,19667,8265,4.15293e+13,801.512,7089.97,27932,814,272,23222,21998,17682,16419,9336
79553,999,4278,57285,22268,4.96852e+13,1665.75,14496.8,79553,1633,559,71427,67177,49108,45989,22580
98103,2811,4145,66844,31259,4.58029e+13,1323.69,14321.1,98103,1802,472,93958,93557,84228,43864,60094
48658,1149,3227,34640,14018,3.5408e+13,892.938,9783.53,48658,941,306,45041,43341,39862,39353,23545
56454,14917,56453,28227,28227,5807940,1.77135e-05,56453.4,56454,28227,2,1,1,1,1,1
75515,546,2725,47776,27739,2.99549e+13,657.476,8990.66,75515,637,429,72201,69625,58769,48323,29605
13457,759,1224,9597,3860,2.96231e+13,402.093,3481.96,13457,501,132,12233,12151,11745,11873,6997
72414,1027,3829,45865,26549,2.94698e+13,648.885,10706.2,72414,1073,378,68585,68045,55210,35010,30961
93514,513,785,63467,30047,3.36005e+13,304.966,5272.28,93514,314,276,92729,92729,78468,82008,75517
20722,905,2511,14334,6388,5.1736e+13,465.817,5085.23,20722,662,295,18211,18001,11601,4622,3091
62127,1417,3151,41090,21037,3.77415e+13,767.361,8784.44,62127,883,348,58976,58392,47006,10476,11651
55089,434,4082,39112,15977,5.64101e+13,1359.32,11443.9,55089,1506,461,45555,42572,25375,16366,6066
48985,326,2101,30142,18843,3.04227e+13,492.026,6186.18,48985,423,313,45764,43517,35400,21778,14266
35058,530,2811,23672,11386,4.23181e+13,586.582,6476.13,35058,697,329,31917,30162,22339,4020,2136
89181,1582,2895,57402,31779,2.98518e+13,653.412,9581.93,89181,735,418,86286,86177,81284,76930,65052
71705,1460,2639,45970,25735,2.96103e+13,600.858,8599.52,71705,613,405,69066,69003,65124,60216,50657
71112,1252,3639,51364,19748,4.35116e+13,1272.91,12787.5,71112,1341,396,65839,62822,53503,51965,32879
89207,683,4460,59241,29966,3.15405e+13,1076.3,13940.7,89207,1334,322,82481,79783,54019,39007,9400
13820,998,1308,8855,4965,2.9013e+13,348.654,3155.3,13820,333,213,12512,12496,12293,12180,10251
51565,4671,20294,41864,9701,1.71591e+12,96.3185,21686.6,51565,1110,150,31271,31261,8143,13305,9609
96997,2637,4057,64879,32118,3.90089e+13,1310.4,12871.2,96997,1177,445,92940,91709,81967,25184,45222
26595,297,2760,18833,7762,4.85567e+13,868.95,7149.38,26595,831,296,21244,19284,14218,12369,5831
6528,1082,1107,4634,1894,2.03416e+13,202.041,2238.57,6528,258,108,5421,5421,5421,5421,5418
14950,1375,1702,9857,5093,2.3827e+13,294.4,3726.01,14950,580,153,13248,13248,13215,13244,12012
28070,147,1640,20268,7802,2.76897e+13,624.721,5317.27,28070,747,207,21464,15077,12330,4380,5782
41248,2390,3722,30093,11155,6.32115e+13,1439.06,9642.26,41248,1191,457,37526,35513,30932,29878,31460
7841,288,867,5084,2757,2.93289e+13,255.957,1924.95,7841,211,152,6824,6507,5763,6168,2451
86698,1796,4309,61128,25570,4.83199e+13,1353.62,15049.2,86698,1791,545,81496,76992,63460,48794,45687
95596,900,3970,62982,32614,3.66838e+13,1231.88,12454.2,95596,1028,442,90502,89332,72354,12621,14976
6652,592,994,4718,1934,3.37071e+13,376.983,2212.65,6652,384,91,5658,5318,5185,5248,2538
27930,266,1558,17992,9938,2.9548e+13,502.113,4471.76,27930,413,279,25019,23029,20658,18800,5420
26683,2088,2377,17126,9557,2.72798e+13,322.72,5455.88,26683,796,171,24306,24306,24147,24306,23587
92035,1167,4391,65362,26673,4.67681e+13,1575.71,15801.2,92035,1770,581,84355,80071,62497,49850,30038
38542,512,1945,23325,15217,3.149e+13,390.57,5196.43,38542,429,264,36559,36021,27007,13135,11673
67711,447,3699,45818,21893,4.30445e+13,1064.99,10804.3,67711,1207,429,60495,56134,42500,9471,7162
72132,391,3777,46217,25915,2.94315e+13,587.943,11024.2,72132,1236,327,66107,62037,46330,27779,15479
52582,193,576,35670,16912,3.35708e+13,301.212,3857.61,52582,300,248,49598,40573,34178,24835,28437
86971,89,2863,55247,31724,3.00855e+13,682.76,9702.17,86971,663,454,71168,60715,52542,40378,9573
48523,150,2093,29626,18897,3.06824e+13,499.536,6110.97,48523,457,315,43143,39135,31412,14555,7496
42074,213,3475,30565,11509,6.24501e+13,1487.57,9351.95,42074,1175,443,31576,27587,14938,12106,3585
60696,1785,3672,41586,19110,3.06548e+13,777.538,10619.2,60696,1076,282,57024,56658,54461,47921,36752
81014,1260,4360,57943,23071,4.8921e+13,1437.78,14734.3,81014,1748,560,74090,69914,55246,46890,35418
65187,489,3682,43974,21213,4.3882e+13,947.113,10212.1,65187,1005,434,59540,55434,43709,9904,12607
65369,2801,4180,46785,18584,5.40239e+13,1431.41,12981.6,65369,1629,524,61189,61044,54973,52997,53750
79672,1336,3947,51556,28116,2.97734e+13,652.711,11825.4,79672,1244,368,75725,75321,63342,53961,34768
53066,1997,2327,34244,18822,2.98194e+13,618.425,7166.58,53066,545,368,50739,50733,50449,50415,49601
27745,1038,1551,17773,9972,3.03059e+13,505.812,4366.69,27745,411,267,26194,26192,25356,25273,23436
86544,1382,4361,59535,27009,3.65739e+13,1258.61,14447.8,86544,1399,419,81256,78452,67412,56870,27083
92417,3205,3969,63092,29325,4.47125e+13,1268.99,13025.5,92417,1426,479,88448,88153,83822,40507,54956
59731,801,1928,38448,21283,2.96807e+13,558.568,6207.09,59731,569,325,57803,57683,52369,52333,47094
82410,1152,4299,57569,24841,3.75815e+13,1315.28,14223.1,82410,1408,423,76419,73093,56933,46942,20286
60875,1974,3665,41520,19355,4.51848e+13,1068.04,10384.3,60875,1168,423,57137,55062,45657,19679,26746
21902,1019,1090,14202,7700,3.00534e+13,477.322,3273.34,21902,354,223,20812,20812,20808,20812,20802
63406,585,633,43019,20387,3.35758e+13,303.811,4270.35,63406,306,258,62773,62773,62338,62261,62050
42002,1794,2018,25982,16020,3.11301e+13,456.016,5746.38,42002,399,293,39984,39980,39455,39660,38568
70782,1589,2667,44887,25895,3.00895e+13,623.307,8698.69,70782,581,413,68115,67992,62904,54242,53552
72490,3329,4207,50581,21909,5.09246e+13,1397.34,13384.9,72490,1764,530,68283,68141,64218,48989,52828
36417,1142,2502,25796,10621,3.43279e+13,782.354,7647.81,36417,764,231,33827,32466,32208,32242,23558
24957,361,1578,14614,10343,3.22469e+13,302.758,3295.19,24957,464,152,23367,22893,17671,14193,13644
14589,285,1204,10459,4130,2.51842e+13,515.753,3524.26,14589,677,127,12225,10925,6933,4443,5464
7917,1755,1940,5864,2053,6.77605e+13,217.433,3040.95,7917,381,289,5977,5975,5674,5834,5312
41566,1098,2168,26472,15094,3.01038e+13,543.501,6226.03,41566,468,339,39398,39300,35399,30206,25677
32383,491,1917,21344,11039,3.86565e+13,510.085,5104.59,32383,446,251,30151,28095,24353,4948,4628
8057,279,1631,5881,2176,7.46372e+13,224.168,2997.28,8057,349,148,6320,5918,3801,3846,1812
6576,197,657,4235,2341,2.91278e+13,279.18,1572.86,6576,233,143,5559,5213,4934,4530,3099
98466,2135,3650,62081,36385,3.01978e+13,1014.87,11838.8,98466,907,466,94816,94256,87406,80697,71826
93834,3835,4124,63422,30412,4.27733e+13,1412.1,13282.3,93834,1377,470,89710,89706,89539,89389,87744
75665,2687,3917,47670,27995,2.94868e+13,738.889,11111.4,75665,1070,399,71748,71665,71703,71736,63928
56496,2121,3094,35000,21496,2.99949e+13,560.226,8125.3,56496,745,316,53402,53375,53344,53390,49917
99832,1847,3093,62699,37133,2.98524e+13,751.707,10702.5,99832,718,475,96739,96398,88567,71504,69990
71767,911,2801,46008,25759,3.04704e+13,614.872,8861.9,71767,659,419,68966,68475,59955,55461,40237
74720,9438,20733,61801,12919,2.40008e+13,4002.24,33398.6,74720,7691,22,53987,46223,45848,49197,34006
75612,2790,4025,48008,27604,2.96158e+13,666.871,11429.7,75612,1175,369,71587,71575,71541,71552,59525
95908,1347,4441,65168,30740,3.62986e+13,1278.28,15024.2,95908,1434,417,90328,87345,75278,62208,35724
36204,688,1138,23325,12879,2.9178e+13,514.507,4125.26,36204,444,266,35066,34849,32322,31171,29252
50509,2631,2929,35849,14660,3.18377e+13,852.993,9319.44,50509,926,250,47580,47580,47580,47576,46026
28777,1090,1103,18543,10234,2.9192e+13,486.512,3686.87,28777,452,247,27674,27674,27665,27660,27668
92209,1584,4470,63161,29048,3.65635e+13,1317.98,14903.7,92209,1440,417,86978,84245,76688,65065,35620
70152,1190,2343,45290,24862,2.95629e+13,558.378,7824.58,70152,610,367,67809,67752,63340,63068,52015
54664,2337,3515,34864,19800,2.96836e+13,498.201,9218.38,54664,1202,246,51149,51146,50847,51095,36139
66778,1585,4100,47002,19776,5.3584e+13,1438.36,12893.4,66778,1688,529,61509,57382,43620,31824,28946
47062,292,3855,33957,13105,6.03454e+13,1409.03,10401.4,47062,1307,459,37366,33908,17982,10122,5925
76128,1740,2450,49040,27088,2.94751e+13,594.692,8229.42,76128,639,374,73678,73677,72344,70641,62291
41497,1031,3269,29618,11879,5.77479e+13,1519.19,9361.61,41497,1346,319,36112,33222,23768,23047,14978
82360,8790,22564,67610,14750,2.50661e+13,5141.28,36551.1,82360,7796,23,59796,47631,49667,53291,34800
88182,2227,4223,56678,31504,2.95568e+13,732.778,12867.6,88182,1253,397,83959,83828,81214,81944,61336
34170,1088,2804,22452,11718,3.09912e+13,454.554,6872.08,34170,779,224,31366,30852,27596,24417,15198
29967,733,3015,21968,7999,6.06433e+13,1436.43,7658.78,29967,1032,268,24684,23413,13287,12115,7178
26366,1861,2300,17452,8914,2.70882e+13,405.352,5624.62,26366,846,183,24066,24066,23838,24057,21918
32990,9902,16974,26348,6642,2.78522e+13,345.926,19901.7,32990,2681,116,16016,15931,16014,15055,12867
86865,1871,4204,60032,26833,4.80301e+13,1386.53,14273.3,86865,1778,537,81897,77545,61435,37100,38379
60771,1923,2615,37712,23059,3.04694e+13,606.692,7797.36,60771,478,379,58156,58053,53005,54663,45952
89353,1851,4433,62936,26417,4.15175e+13,1556.65,15189.2,89353,1558,454,84168,80650,71121,70254,45326
2724,1163,1167,1808,916,2.2071e+13,67.5558,1461.78,2724,322,93,1557,1557,1557,1557,1557
56788,1417,3759,40916,15872,5.66995e+13,1504.31,11601.1,56788,1455,517,51445,47444,35694,33314,27086
55967,4988,18037,45744,10223,2.51506e+13,4494.7,27810.2,55967,6330,21,35103,26266,26764,31350,17569
55223,258,3834,39068,16155,5.54972e+13,1258.06,10879.3,55223,1345,460,44978,40703,25466,6608,2969
61405,54731,61405,30703,30702,5808050,0,61405,61405,30703,2,0,0,0,0,0
80839,5411,8071,68761,12078,4.20472e+13,17.0809,9175.98,80839,4037,4033,72768,72768,56834,66125,63969
56282,1432,3766,39347,16935,5.33655e+13,1155.31,10799.5,56282,1336,460,51531,49143,36799,19976,23825
69981,2370,3642,46223,23758,2.97062e+13,714.65,10494.1,69981,1205,288,66339,66100,65200,65888,44268
60132,3514,3856,42258,17874,5.29305e+13,1300.62,11385.8,60132,1410,470,56276,56249,55534,51839,46911
5778,372,686,3670,2108,2.70615e+13,273.138,1503.86,5778,225,139,5086,4825,4719,4487,3623
44738,1534,1918,28850,15888,2.91458e+13,534.084,6096.19,44738,497,320,42820,42818,42217,41998,40260
89490,1465,2898,57113,32377,3.02507e+13,702.214,9878.85,89490,691,445,86592,86381,79225,71668,60919
7432,342,677,4814,2618,2.93516e+13,298.472,1688.22,7432,232,139,6614,6256,6139,5802,4978
25221,285,443,17123,8098,3.3658e+13,296.22,2620.23,25221,278,193,24626,24001,18372,19913,19195
23356,688,2599,16350,7006,4.45831e+13,847.72,6508.46,23356,811,267,19803,18764,15404,14073,8514
81740,3336,3874,58725,23015,4.3643e+13,1622.21,14057.8,81740,1622,402,77866,77634,76474,75434,74142
40429,512,4045,34389,6040,4.20478e+13,17.077,4821.16,40429,2025,2020,36384,36384,15213,27560,25461
27947,746,1081,17954,9993,2.89159e+13,499.762,3659.09,27947,388,242,26866,26802,25479,25452,24475
29382,351,1681,18986,10396,2.94004e+13,508.545,4866.98,29382,457,272,26863,24937,23025,22061,10271
8351,1430,1746,5777,2574,6.1816e+13,325.947,3170.45,8351,429,148,6605,6483,6472,6605,4934
8198,239,740,5313,2885,2.98019e+13,280.445,1790.68,8198,242,147,7190,6759,6454,6225,4012
19615,1370,1466,12192,7423,3.08513e+13,273.535,3582.91,19615,319,214,18149,18149,18095,18119,17702
19227,1293,1494,13970,5257,2.93216e+13,229.564,4173.98,19227,392,155,17733,17733,17662,17731,17364
71208,1388,3701,51184,20024,4.5441e+13,1547.37,12999.5,71208,1426,394,65892,62159,53138,51952,33879
67358,1008,2644,43080,24278,2.99368e+13,585.125,8444.85,67358,608,406,64714,64546,57668,52537,39155
26924,2072,2324,18672,8252,2.65895e+13,554.667,5969.24,26924,847,216,24600,24600,24598,24600,23692
67015,1640,2255,43215,23800,2.96487e+13,565.642,7642.36,67015,572,366,64760,64759,63363,62005,53699
77488,3646,4259,55679,21809,5.00809e+13,1680.98,14331.8,77488,1627,549,73229,73156,71844,69855,70188
97692,3207,4240,64053,33639,2.96785e+13,858.3,13819.1,97692,1252,440,93452,93382,93445,93108,79134
99338,3274,4530,65669,33669,3.07589e+13,1001.49,14763.2,99338,1367,412,94808,94637,94739,94462,81930
97437,326,4478,66582,30855,3.76053e+13,1310.91,15309.7,97437,1443,427,84719,79085,52073,25860,16714
22369,935,1538,14123,8246,2.98494e+13,420.223,4032.08,22369,347,243,20831,20790,19228,18364,15542
51615,944,3397,36913,14702,4.15886e+13,1068.3,10521.9,51615,1034,353,46867,44639,35203,35616,17373
96823,3421,4408,69091,27732,4.54678e+13,1666.35,16279.6,96823,1894,587,92415,91940,88383,80916,82450
15241,249,1739,9299,5942,2.80908e+13,254.99,3300.16,15241,400,127,13104,12167,9785,9072,5322
39838,12694,15712,31939,7899,2.82855e+13,5550.19,22704.7,39838,4051,17,24126,19020,22515,22661,23129
15536,681,934,9155,6381,3.1879e+13,260.331,2130.83,15536,255,139,14602,14590,13524,13930,12400
27262,2564,2761,19581,7681,5.89034e+13,1241.54,7233.3,27262,1103,250,24501,24434,24107,24013,24079
74042,1135,2785,46299,27743,3.01862e+13,650.653,9044.02,74042,575,429,71257,70936,60020,45446,36566
49478,1646,2410,30829,18649,3.06591e+13,510.988,6804.22,49478,481,352,47068,47028,42118,41742,34108
38644,1855,1888,25025,13619,3.04823e+13,540.934,5728.89,38644,483,308,36756,36756,36742,36725,36743
68177,1247,4125,47519,20658,5.28451e+13,1330.97,12712.2,68177,1724,470,61989,58854,42714,25915,22509
92505,2137,2931,58841,33664,3.0072e+13,690.882,9994.69,92505,672,442,89574,89363,85079,83662,79057
87496,4305,23721,71589,15907,2.51768e+13,5676.95,38549.5,87496,7799,26,56755,41188,42479,49909,18074
24339,175,2257,15884,8455,2.67928e+13,335.311,5232.72,24339,759,174,19638,15072,12515,6503,3498
88780,177,4293,61543,27237,4.68174e+13,1315.8,14699.3,88780,1816,535,70445,63293,44272,19878,5776
83393,1404,4068,57391,26002,4.73294e+13,1277.57,13146.6,83393,1513,471,77738,74271,56901,26858,26348
5648,101,2445,4719,929,7.08756e+12,4.0818,3374.64,5648,790,11,3203,3203,2657,3202,834
28962,820,1736,17653,11309,3.15208e+13,303.975,4374.97,28962,342,223,27226,27192,21927,16887,10890
93532,1101,2969,59297,34235,3.00542e+13,710.475,10151.6,93532,681,449,90563,90233,78401,68049,56899
77711,256,2772,48812,28899,2.98932e+13,660.7,9120.5,77711,581,428,70906,66393,55450,39437,16667
15520,2018,2716,11311,4209,6.30039e+13,706.071,5241.15,15520,753,197,12804,12253,11652,11845,11180
16800,816,2655,12213,4587,6.00638e+13,862.684,5373.48,16800,775,171,13761,13006,7887,8850,6034
95393,1943,2976,61177,34216,2.97044e+13,706.16,10063.2,95393,755,436,92417,92284,89134,83276,79441
85704,6183,8554,72899,12805,4.20544e+13,17.0766,9691.9,85704,4280,4276,77150,77150,62945,71227,70057
50715,1945,2458,31814,18901,2.99791e+13,535.003,7079.16,50715,478,353,48257,48252,45753,46807,41460
90823,691,4404,64091,26732,4.16177e+13,1568.16,15326.8,90823,1661,455,80983,77281,49011,30478,12715
49572,2146,3374,35614,13958,5.24686e+13,1367.35,10497.1,49572,1302,353,46058,43647,37225,38650,37480
37261,52,1715,24111,13150,2.9725e+13,503.481,5367.09,37261,466,311,25862,16944,19716,15030,2692
51506,1282,2956,36951,14555,4.57688e+13,1244.96,10223.7,51506,1152,336,47447,44998,39578,36471,30437
10861,753,2206,7702,3159,6.46336e+13,308.039,4052.93,10861,499,147,8655,8463,7285,6881,4427
24228,1269,1684,14520,9708,3.18072e+13,305.506,3786.75,24228,353,171,22544,22514,20776,21502,18611
27989,1990,3310,19201,8788,5.17095e+13,632.976,7261.55,27989,915,402,24679,24168,17867,10550,11700
44909,2243,2308,28582,16327,3.02351e+13,576.536,6662.92,44909,525,355,42601,42601,42572,42601,42348
22848,652,2053,16000,6848,2.61473e+13,545.685,5331.54,22848,821,191,20534,19519,12691,9720,3975
74429,2281,3173,48999,25430,3.6253e+13,796.883,9116.95,74429,597,350,71256,70956,69227,68736,59045
46406,530,2774,32167,14239,2.88042e+13,560.037,7960.5,46406,905,273,42644,40156,28021,14949,8266
91082,691,4211,62533,28549,4.6091e+13,1380.88,14540,91082,1782,536,81637,78644,56759,24610,16479
96534,3556,4589,68312,28222,4.42054e+13,1729.76,16193.7,96534,1707,612,91945,91655,83223,84335,80777
93705,2462,4639,62028,31677,3.14891e+13,1014.4,14709,93705,1356,385,89066,88585,87284,88211,53414
20589,391,1427,13316,7273,3.00829e+13,415.254,3862.71,20589,353,248,18806,17468,16132,15771,8150
43410,774,2758,27577,15833,2.91878e+13,408.108,7133.67,43410,1071,190,40644,40244,33670,30009,21378
37956,1691,3398,27645,10311,6.23359e+13,1466.64,8891.88,37956,1176,403,34051,31023,23101,25723,23730
18502,721,1174,12083,6419,3.34912e+13,422.947,3209.45,18502,335,214,17328,17311,15917,15003,10838
6984,1760,1855,5192,1792,6.57503e+13,209.777,2839.5,6984,383,268,5129,5129,5037,5108,4905
38109,2131,2613,23875,14234,2.86465e+13,344.186,6343.13,38109,942,179,35496,35496,35284,34956,33844
69721,5941,7131,59182,10539,4.21078e+13,18.4194,8180.85,69721,3488,3139,62590,62590,55878,59726,59036
69552,1771,3624,49819,19733,3.9723e+13,1234.77,12523.1,69552,1319,387,65550,63098,58505,56339,46353
84042,3188,3963,53169,30873,2.92173e+13,804.747,11900.7,84042,1077,420,80079,79964,80079,80068,74945
82635,1365,3760,52183,30452,2.90588e+13,785.607,11351.8,82635,970,416,78875,78347,67995,46556,44436
4858,242,329,3241,1617,3.21713e+13,219.901,1109.44,4858,194,91,4507,4355,3911,4061,4305
92692,173,2922,58025,34667,3.0038e+13,721.594,10156.9,92692,659,466,81884,75370,62590,43594,13753
53824,587,2026,34681,19143,2.92015e+13,560.051,6683.74,53824,515,339,51654,49531,44676,42798,30397
8549,386,585,4988,3561,3.23805e+13,194.352,1329.74,8549,152,103,7964,7915,7415,7663,6540
27895,2491,2683,19767,8128,4.64419e+13,826.962,7131.8,27895,829,294,25212,25204,25076,24804,24791
19691,756,916,11512,8179,3.22099e+13,281.271,2345.84,19691,290,141,18775,18771,18260,18465,17755
83776,1271,4218,59190,24586,4.89422e+13,1361.92,14780.9,83776,1734,547,77111,72936,58066,42919,35472
47165,575,3623,32768,14397,5.06718e+13,1018.5,9696,47165,1220,428,41480,39652,26226,10090,9105
73292,3711,4168,50896,22396,3.56471e+13,1099.12,13038.1,73292,1118,405,69124,69062,68043,67777,66909
23973,1403,1606,14743,9230,3.11102e+13,295.514,4011.5,23973,324,213,22367,22367,21952,22115,21005
34011,2177,2458,23564,10447,2.75056e+13,549.309,6732.09,34011,865,250,31553,31553,31542,31543,29581
21373,933,1520,13624,7749,3.05306e+13,469.234,3952.33,21373,387,237,19853,19780,18640,18100,16222
26147,601,1425,16894,9253,2.97325e+13,543.953,4043.43,26147,431,261,24583,23971,21524,20668,7916
20641,798,2587,14536,6105,5.63004e+13,920.557,6080.97,20641,812,272,17312,16454,12150,10834,6512
59559,550,2176,38410,21149,2.90457e+13,557.938,7069.3,59559,585,345,57102,54333,49051,47636,33153
44227,114,4439,37594,6633,4.22138e+13,16.993,5240.91,44227,2223,2218,39788,39788,13865,28982,26835
30544,180,2470,19784,10760,2.82458e+13,400.614,6042.17,30544,902,187,25162,19653,15716,7768,4872
88822,3387,3895,59648,29174,4.08028e+13,1303.06,12190.8,88822,1269,435,84927,84645,83451,78106,68537
14941,964,2275,10294,4647,5.00021e+13,647.106,4821.18,14941,788,181,12576,11957,10568,9794,7139
17307,850,1372,12418,4889,2.71173e+13,640.142,4081.69,17307,694,157,15845,15462,14619,14773,12414
41235,1278,2706,28122,13113,2.82114e+13,524.219,7494.42,41235,927,257,38529,38243,34435,31049,16142
72621,679,4134,50678,21943,5.22878e+13,1396.03,13165.1,72621,1755,506,63597,60985,40831,22045,12864
14833,1434,1604,10000,4833,4.60153e+13,349.976,3505.01,14833,377,180,13229,13229,13094,13080,12463
38970,344,1926,25520,13450,3.4983e+13,505.152,5356.17,38970,429,274,35594,32905,29335,4200,4230
51145,3095,3443,36563,14582,4.14697e+13,1047.67,10555,51145,989,348,47702,47702,46965,46356,46332
34909,705,1836,22486,12423,3.02913e+13,624.691,5193.39,34909,486,320,32947,32245,28663,26492,15491
32375,3058,3170,23329,9046,6.10025e+13,1335.46,8147.31,32375,1076,277,29205,29203,29205,29205,28919
51134,1612,2458,32010,19124,3.0608e+13,522.313,7109,51134,489,362,48676,48629,43778,39920,35896
13401,807,824,8651,4750,2.94049e+13,416.576,2354.63,13401,333,170,12577,12577,12562,12547,12559
53800,2235,3464,34361,19439,2.91352e+13,482.874,8984.39,53800,1201,211,50336,50333,49958,50271,34103
95535,1925,4088,64577,30958,4.31268e+13,1377.29,13234.9,95535,1432,477,91065,87955,72725,26526,40452
70495,440,671,47856,22639,3.36628e+13,304.572,4524.91,70495,308,264,69824,69824,58086,61650,56385
69867,280,3485,46554,23313,2.89419e+13,732.238,10416.8,69867,1155,281,63016,59199,38803,16952,13370
68994,3780,4231,48466,20528,5.21979e+13,1450.08,13334.5,68994,1774,526,64763,64747,63945,53125,55277
35861,865,2557,25641,10220,3.32303e+13,758.185,7466.9,35861,855,204,32937,31982,25516,28537,13529
11679,465,704,6825,4854,3.24462e+13,234.883,1630.93,11679,203,114,10975,10923,10132,10527,9230
76203,2429,2737,48704,27499,3.0203e+13,618.96,8964.52,76203,612,419,73466,73418,72428,72831,70065
96120,2715,4395,68257,27863,4.5977e+13,1591.17,16193.7,96120,1895,569,91693,90930,76177,68434,66446
17441,1432,3044,12804,4637,6.9272e+13,512.16,5754.54,17441,685,334,14397,13965,11247,11627,9372
87060,175,747,59101,27959,3.36347e+13,304.213,5063.61,87060,312,271,78628,54543,53463,26506,40028
38981,1377,3426,28106,10875,5.87631e+13,1506.91,9101.37,38981,1262,295,34294,31546,23351,23315,20168
81541,3958,4375,55911,25630,3.59521e+13,1137.12,13811.9,81541,1213,408,77166,77124,76572,76054,75703
3252,241,455,2443,809,1.74946e+13,154.524,1061.6,3252,200,82,2797,2760,2449,2305,2289
65207,3464,3725,44047,21160,2.95989e+13,797.286,10766,65207,1051,282,61482,61482,61482,61482,61007
90064,657,2598,58062,32002,2.96787e+13,613.724,9041.83,90064,669,405,87370,85324,74028,73442,45384
55078,19722,23318,44066,11012,111342000,987.689,34112.1,55078,5530,11,31760,31760,30861,31760,27276
48756,575,1933,31366,17390,2.91251e+13,547.921,6361.74,48756,520,328,46662,45004,40573,40194,27798
46656,615,2041,29095,17561,3.0888e+13,491.356,6076.82,46656,474,318,44462,43726,36480,26674,24029
39801,1802,14613,33002,6799,2.71654e+13,1408.86,20659.7,39801,5166,16,24384,20967,21500,17293,5761
18349,2097,2168,12637,5712,3.90794e+13,568.796,5163.25,18349,590,190,16181,16181,16181,16181,16049
56149,1597,3087,36889,19260,2.92686e+13,552.82,8746.69,56149,1118,262,53062,52975,51555,44575,28412
31482,1581,1634,20324,11158,2.94553e+13,492.193,4968.96,31482,421,283,29848,29848,29840,29846,29789
95155,12074,25075,77895,17260,2.40432e+13,5750.79,41395.3,95155,7799,26,70080,58124,60957,63538,40229
81252,3763,4066,54028,27224,3.16405e+13,963.658,12648.8,81252,1313,312,77186,77181,77186,77186,75406
54600,253,3540,38284,16316,3.08256e+13,866.208,10236.2,54600,981,283,46299,41570,28270,11635,3329
84276,91,8414,71683,12593,4.2054e+13,17.0773,9542.32,84276,4210,4205,75862,75862,25959,55065,46973
29312,1305,3555,21258,8054,6.25783e+13,1127.44,7996.37,29312,1047,424,25122,23474,13816,12213,10196
8213,554,777,5314,2899,2.98503e+13,308.471,1825.14,8213,278,134,7436,7223,7174,6915,6151
78393,1941,4160,54450,23943,4.96769e+13,1372.09,13649.8,78393,1784,511,73752,69633,55069,36336,38685
26759,721,2370,17333,9426,2.8124e+13,355.551,5594.51,26759,843,178,24389,23931,20220,17925,12118
73913,2432,2591,47720,26193,2.94959e+13,610.113,8478.8,73913,600,394,71322,71321,71263,71303,70740
93607,2209,4545,65169,28438,4.05812e+13,1541.58,15554.3,93607,1515,450,88678,86015,76955,75852,53283
60738,1838,3743,43665,17073,5.13785e+13,1432.74,11983.3,60738,1460,433,56427,52551,44778,45205,38818
83318,543,4200,53137,30181,2.97297e+13,722.504,12416.3,83318,1215,396,77939,74053,56942,39828,17147
40838,869,3349,29349,11489,5.93166e+13,1532.79,9377.03,40838,1420,272,34727,32432,21994,20290,12816
65439,1738,3706,44494,20945,4.37043e+13,1077.1,10620.1,65439,1129,438,61371,59589,48732,17154,24406
78632,331,3567,51760,26872,3.59532e+13,1031.61,10241.9,78632,898,348,70833,64716,56732,7304,5545
96195,827,4764,63669,32526,3.1192e+13,1085.98,15040.4,96195,1374,406,90121,87906,64624,42431,17678
15930,491,1394,9795,6135,3.11152e+13,237.935,3207.96,15930,269,179,14536,14477,11589,7272,6238
83633,83,4260,59217,24416,4.8474e+13,1351.37,14785.3,83633,1766,549,59892,45882,31762,16257,3966
33353,844,1218,21528,11825,2.97062e+13,534.38,4084.65,33353,423,270,32135,32059,30500,30425,28679
57057,1326,2493,36300,20757,2.98728e+13,563.421,7715.4,57057,548,386,54564,54505,50165,44223,37990
56966,261,614,38672,18294,3.36642e+13,305.106,4048.3,56966,304,254,55613,52779,38016,33807,33840
75831,1396,4236,53310,22521,5.06678e+13,1386.41,13957.5,75831,1755,529,69702,65462,50754,34901,30191
48433,9790,16516,39732,8701,2.32659e+13,3591.04,24941.1,48433,5328,17,31917,27809,27693,29337,22613
60843,2358,3641,38448,22395,2.95371e+13,549.038,9803,60843,1160,305,57202,57189,56964,57171,45083
43554,662,2715,30000,13554,2.84204e+13,542.946,7685.16,43554,917,264,40335,39121,27424,17419,10055
56012,1896,2008,36397,19615,3.2038e+13,565.501,6199.12,56012,535,323,54004,54004,53903,53907,53652
87925,142,752,59625,28300,3.35056e+13,304.105,5092.64,87925,313,272,71710,44281,46332,20483,37098
54900,310,1485,35402,19498,2.93931e+13,567.037,5419.93,54900,553,317,50277,45978,44314,42127,25655
46322,505,2050,29868,16454,2.94255e+13,534.349,6313.14,46322,530,328,43967,41361,37479,36033,21970
75943,3089,3943,54792,21151,5.07051e+13,1682.18,13700.1,75943,1501,563,72000,71635,64668,64440,64730
68032,2995,20796,55050,12982,2.63438e+13,6393.14,32814.5,68032,6407,21,37966,27042,28458,17122,12540
72595,1141,2359,46813,25782,2.93706e+13,570.716,7984.88,72595,606,361,70236,70187,65485,64933,53220
8900,249,736,5715,3185,2.90482e+13,356.516,1878.17,8900,280,149,7806,7377,6804,6766,3625
38522,2888,3394,28086,10436,6.24575e+13,1470.89,8926.86,38522,1175,395,35128,35099,33717,33874,33400
29904,364,1079,19323,10581,3.02894e+13,496.96,3767.7,29904,399,240,27749,25619,24489,23269,17927
99768,1404,4298,65276,34492,2.99141e+13,849.905,13972.6,99768,1262,441,95470,94588,77033,54358,41452
48566,1118,3419,30287,18279,2.94081e+13,448.887,8204.96,48566,1039,257,45147,44960,36348,31844,21674
80112,634,4364,54940,25172,3.56115e+13,1135.14,13679.6,80112,1201,415,72879,70036,48177,30133,17586
66832,866,3955,47638,19194,3.77796e+13,1178.7,12491.7,66832,1199,393,60846,58220,38158,30371,16822
49997,66,3085,36038,13959,5.02137e+13,1291.73,10274.5,49997,1182,354,33103,23545,15741,10216,2410
38130,592,3620,28050,10080,6.7258e+13,1433.45,9147.48,38130,1125,460,31245,29814,14129,11406,5996
71950,3898,3903,49805,22145,4.8432e+13,1233.36,12102.3,71950,1384,471,68047,68047,68047,68035,68045
67643,96,652,45894,21749,3.35709e+13,303.484,4418.43,67643,307,260,45624,19255,29539,11702,22485
10953,783,1185,7832,3121,2.55374e+13,436.277,3015.97,10953,641,111,9768,9611,8728,8937,8541
27851,1682,3405,20361,7490,6.47646e+13,1132.09,7647.68,27851,950,411,24227,22627,15592,16430,15107
37696,2636,2759,22550,15146,3.1263e+13,420.057,5741.48,37696,609,240,34937,34937,34937,34937,34933
22041,1065,2546,16484,5557,6.63015e+13,1059.04,6109.04,22041,750,262,18529,17776,11025,11436,9120
54017,2040,3439,37857,16160,3.06164e+13,866.158,10036.1,54017,978,286,50578,50485,49353,49913,36166
26386,2167,3252,19172,7214,6.36785e+13,1184.96,7292.21,26386,987,411,23134,21646,18225,19220,18758
40656,763,4077,34569,6087,4.21384e+13,17.0336,4852.39,40656,2041,2036,36579,36579,16723,28303,25436
8683,1239,1446,6071,2612,6.13288e+13,220.716,2732.37,8683,277,168,7237,7235,7076,6904,6358
52562,309,2411,33478,19084,2.93515e+13,573.059,7342.86,52562,593,374,47851,44549,39793,31749,12682
11351,2016,2159,8261,3090,6.10877e+13,332.962,4144.96,11351,586,155,9192,9192,9188,9192,9192
26012,1189,1380,17023,8989,3.45018e+13,465.221,3978.92,26012,396,249,24632,24632,24276,24362,23496
7191,446,649,4608,2583,2.8574e+13,291.213,1629.12,7191,203,135,6529,6218,6158,5990,5774
96937,3007,3045,61443,35494,3.00988e+13,732.311,10390.1,96937,674,454,93892,93892,93884,93892,93781
77449,2877,4234,53912,23537,3.74484e+13,1214.55,13659.7,77449,1277,425,73215,72947,68685,67870,60642
21167,374,972,13618,7549,2.89425e+13,465.391,3080.63,21167,377,223,19561,18084,17204,16644,11343
27067,316,1068,17307,9760,2.79892e+13,470.581,3530.54,27067,403,239,24885,22984,22278,20996,13989
41770,505,2170,26496,15274,3.04178e+13,546.955,6217.01,41770,463,345,39101,38006,31435,26274,11557
48985,379,3216,34446,14539,2.73623e+13,774.214,8934.09,48985,864,280,43325,40844,26331,10603,4676
34892,288,485,23639,11253,3.34651e+13,294.064,3091.89,34892,288,218,34234,33390,25153,27054,25315
98711,470,3596,62308,36403,2.95513e+13,993.564,11854.1,98711,952,461,92964,87688,72418,54227,28468
97722,3212,3952,66654,31068,4.48088e+13,1309.68,13563.3,97722,1534,476,93770,93469,89477,46722,59298
12746,2014,5083,10372,2374,1.70283e+12,88.7678,5725.36,12746,552,92,7663,7663,3222,7046,3540
50188,2342,2966,35521,14667,3.2804e+13,847.255,9394.56,50188,925,252,47222,47222,47205,47200,43656
17287,463,1219,12660,4627,2.93215e+13,235.345,3675.38,17287,346,162,16068,16003,12358,13990,5951
74851,1036,3686,50716,24135,4.3282e+13,1140.7,11322.3,74851,1262,427,70000,68024,51431,15676,16701
10580,784,791,6864,3716,2.94773e+13,372.224,2111.51,10580,330,150,9789,9789,9789,9789,9784
28654,804,2963,20927,7727,6.28131e+13,1313.45,7378.66,28654,914,266,24007,22602,12550,12990,7568
82744,456,3937,54528,28216,3.67586e+13,1090.09,11372.7,82744,1000,417,76123,70382,58223,8114,6212
82569,1738,4025,54801,27768,3.93316e+13,1185.15,11686.2,82569,1092,447,78539,76929,63946,17054,23298
10676,627,1242,6708,3968,3.09717e+13,188.106,2614.5,10676,256,159,9434,9403,8272,6919,5491
45056,318,1943,29098,15958,2.94866e+13,541.079,6155.96,45056,493,317,41143,37840,35396,32381,16780
19644,96,918,12711,6933,2.99252e+13,462.54,2931.47,19644,385,204,15976,13443,11956,11183,4373
34277,233,1177,22151,12126,2.92418e+13,509.034,4047.19,34277,395,264,30542,28303,26365,25880,14570
16075,429,1590,10938,5137,4.92444e+13,335.082,3600.33,16075,350,207,14390,13645,11099,3724,3034
90478,1600,3615,59404,31074,3.49108e+13,1157.07,11416.2,90478,849,379,86863,85735,72480,13641,19993
8254,556,1639,6272,1982,7.04828e+13,225.619,2934.52,8254,420,173,6615,6351,3082,3129,2069
88305,2015,4249,62003,26302,4.78262e+13,1361.44,15049.4,88305,1779,547,83555,79323,65292,51115,48836
59196,2771,3725,41094,18102,3.13414e+13,858.828,10886.4,59196,1015,293,55471,55436,55448,55471,50240
87089,2203,4151,55866,31223,2.9396e+13,738.701,12768.5,87089,1243,392,82938,82762,79185,80028,59793
27833,1310,1553,17887,9946,2.89939e+13,448.411,4407.16,27833,371,263,26280,26278,26088,26058,24139
50665,1637,3387,36115,14550,4.30126e+13,1113.29,10473.4,50665,1067,347,47050,45266,41016,39638,31253
90747,4348,18884,64794,25953,2.46091e+13,305.159,25723.7,90747,1859,275,71863,71794,52305,51737,50402
64694,1638,3590,46419,18275,4.75532e+13,1603.02,12260.4,64694,1361,378,60058,56732,48959,47016,34878
16949,601,1065,12355,4594,3.16835e+13,204.075,3382.49,16949,348,151,15884,15884,15209,15699,10428
38478,2294,2503,27075,11403,3.37987e+13,844.723,7880.73,38478,794,235,35975,35975,35975,35968,34606
20702,58,1492,13205,7497,3.02628e+13,463.392,3880.76,20702,364,240,15210,11186,11641,6898,2277
1668,55,236,1103,565,2.90223e+13,89.8345,503.601,1668,80,50,1211,797,994,997,546
27286,1191,1577,17537,9749,2.90385e+13,443.911,4475.24,27286,383,268,25709,25694,25365,25105,22571
70444,3815,4235,49552,20892,5.23063e+13,1428.74,13420.2,70444,1747,526,66209,66197,65490,61678,57291
76287,879,3833,52206,24081,4.6878e+13,1205,11945.7,76287,1361,470,70202,68228,51235,16283,20169
53558,774,3118,38549,15009,4.30858e+13,1251.1,10571.7,53558,1153,355,47586,45532,36636,36476,20262
5576,365,478,3259,2317,3.2365e+13,172.99,1018,5576,119,84,5098,5071,4893,4986,4426
7812,156,1101,5010,2802,3.21215e+13,295.096,2221.75,7812,310,175,6256,5736,5001,4014,1070
75735,2103,3840,48537,27198,2.92282e+13,605.632,11355.7,75735,1248,335,71895,71870,71332,71768,52839
66915,1361,3703,42708,24207,2.94189e+13,584.565,10550.8,66915,1217,322,63212,62994,53991,49767,33027
7281,253,1587,5337,1944,7.35657e+13,192.54,2810.17,7281,327,142,5609,5240,3310,3389,1741
97095,1333,4475,66980,30115,3.93339e+13,1339.44,15433.2,97095,1457,444,90958,87692,71495,59832,32883
84414,2753,3974,60747,23667,4.5403e+13,1714.66,14512.7,84414,1633,520,80399,79812,69146,72042,66542
37887,2747,3793,32226,5661,4.20498e+13,17.0812,4544.07,37887,1899,1894,34094,34094,27851,31488,30756
41292,1967,2972,25406,15886,2.90568e+13,419.683,6908.89,41292,910,228,38320,38318,38268,38312,32345
84222,790,2946,52673,31549,3.02416e+13,702.469,9751.35,84222,617,459,80980,80050,66361,51502,38276
96074,3218,4592,68532,27542,4.5409e+13,1726.77,16153.5,96074,1695,623,91482,90972,78430,80509,73461
99843,1090,4314,69521,30322,4.5788e+13,1321.57,15748.5,99843,1835,540,92310,88146,69230,40453,32450
12067,527,1349,8663,3404,2.94681e+13,323.526,3393.61,12067,425,148,10655,10240,7241,7842,3300
70492,588,3856,50932,19560,5.17588e+13,1506.48,13037.2,70492,1468,547,60559,57749,38131,36089,16288
16027,2205,4591,13738,2289,1.92735e+13,5.13727,7908.23,16027,2294,7,11436,11436,11344,11017,5502
64950,2262,3043,42857,22093,3.58693e+13,796.649,8322.37,64950,738,341,61907,61527,57724,41126,22293
31305,28,1155,20049,11256,2.85745e+13,516.478,3914.28,31305,458,254,17428,10050,11088,5113,1402
37460,238,1238,24183,13277,2.94471e+13,542.425,4331.22,37460,470,271,33408,30854,28717,28263,12506
19493,1876,1877,13864,5629,3.38138e+13,509.122,4843.36,19493,587,149,17616,17616,17616,17616,17615
72887,2313,2718,46448,26439,2.95348e+13,609.224,8798.12,72887,636,418,70169,70160,68887,69221,66190
78254,1135,4058,50239,28015,2.92315e+13,681.543,11809.9,78254,1236,382,74196,73477,59791,38714,30440
28555,2147,2170,17794,10761,2.77598e+13,315.837,5086.88,28555,738,156,26385,26385,26385,26385,26385
53475,607,3019,34627,18848,2.92588e+13,514.932,8350.72,53475,1145,241,49892,47951,36924,26869,21481
59254,2016,3553,37283,21971,2.89846e+13,519.953,9409.33,59254,1076,302,55701,55671,55342,55640,43882
71223,1664,3795,48211,23012,4.37519e+13,1156.64,11351.6,71223,1323,444,66891,64701,50183,20122,23940
18325,425,1051,11819,6506,3.00899e+13,420.597,3020.64,18325,337,198,17104,16032,15387,14996,12317
55778,2533,3561,35697,20081,2.93587e+13,497.138,9356.58,55778,1213,246,52217,52215,52076,52155,40296
78944,2183,4013,51299,27645,2.94695e+13,683.979,11987.3,78944,1241,385,74931,74782,73822,74528,49105
16318,68,945,10530,5788,2.98153e+13,445.958,2736.85,16318,360,191,12188,8832,9248,8645,2911
14836,761,860,9534,5302,2.8724e+13,411.628,2547.27,14836,296,186,13976,13976,13808,13845,13691
18074,1037,1486,12997,5077,2.93553e+13,469.687,4266.66,18074,508,176,16588,16441,16025,16050,13045
88346,4742,23776,72384,15962,2.46858e+13,5513.54,38797.7,88346,7796,25,58424,42536,47142,51902,20481
22553,2844,2875,16490,6063,6.56279e+13,969.994,6380.16,22553,906,254,19678,19678,19678,19678,19642
37413,1524,2725,26586,10827,3.35984e+13,732.221,7855.93,37413,796,222,34688,33933,33824,33865,27581
65919,3124,3871,45038,20881,3.15573e+13,905.996,11578.5,65919,1087,299,62048,61930,62043,62048,57572
63636,213,637,43195,20441,3.36183e+13,302.799,4279.3,63636,306,258,61166,56784,41602,30875,33169
63829,1464,2283,41182,22647,2.95808e+13,561.721,7494.58,63829,600,359,61546,61539,59583,57924,48527
70448,117,669,47767,22681,3.35773e+13,303.783,4519.89,70448,308,261,52711,30822,33677,13521,8747
92189,2285,2912,58618,33571,3.02952e+13,706.685,9917.76,92189,648,452,89277,89086,85283,83684,78425
97204,187,3045,61161,36043,3.02351e+13,731.692,10503.1,97204,670,475,86048,78958,66606,44995,18129
70736,3130,3803,45343,25393,2.91271e+13,589.962,10982,70736,1236,340,66933,66933,66933,66918,62266
17135,1842,1852,12222,4913,3.06062e+13,413.625,4414.61,17135,521,144,15283,15283,15283,15283,15277
21048,1358,1670,15327,5721,2.8979e+13,301.729,4557.9,21048,423,165,19378,19373,19254,19375,18482
10874,360,1237,6599,4275,3.15544e+13,178.287,2442.71,10874,215,130,9637,9521,6981,2605,1953
63462,439,2204,40894,22568,2.90999e+13,575.309,7248.87,63462,559,336,59818,55571,51257,49603,31894
98077,2996,4401,70122,27955,4.52353e+13,1656.13,16429.4,98077,1882,581,93676,93026,81812,77294,77404
6012,219,523,4373,1639,3.18035e+13,178.181,1500.57,6012,207,107,5483,5032,4046,4661,2202
57994,1656,3450,41811,16183,4.32896e+13,1242.75,11333.2,57994,1193,356,54042,51514,46123,43799,35225
44089,1063,3784,31896,12193,6.08874e+13,1409.27,10118,44089,1225,458,38308,35845,21528,16785,12365
32967,460,1145,21152,11815,2.81329e+13,501.348,3978.45,32967,397,260,31377,29052,27653,26698,21261
22629,56,996,14585,8044,3.00017e+13,510.928,3243.48,22629,387,225,15914,10500,12218,9499,2642
48138,786,3325,29889,18249,2.94062e+13,434.961,8026.77,48138,1000,261,44813,44539,33408,17958,10870
59824,1442,3541,37514,22310,2.9821e+13,548.88,9297.12,59824,1010,319,56283,56085,50270,49697,38016
33006,996,1861,19858,13148,3.1562e+13,327.732,4676.95,33006,408,251,31145,31093,24762,21456,14817
63538,2885,4087,45685,17853,5.45245e+13,1467.27,12721.3,63538,1572,523,59451,59338,54096,53993,54692
14642,2565,2701,10421,4221,6.46089e+13,535.791,5058.93,14642,645,379,11941,11931,11737,11739,11331
38343,1322,1804,24756,13587,3.01785e+13,535.97,5645.62,38343,457,307,36539,36536,35648,35162,31693
82588,663,2874,51766,30822,3.04686e+13,677.54,9559.5,82588,593,443,79329,78102,63582,48798,35238
58882,2997,3115,36754,22128,2.96261e+13,562.801,8519.8,58882,942,312,55767,55767,55767,55767,55599
72993,3876,4183,50320,22673,3.3859e+13,1079.4,12862.1,72993,1123,382,68810,68789,68710,68399,67977
40565,2445,4058,34505,6060,4.20456e+13,17.0763,4835.49,40565,2032,2027,36507,36507,26856,32481,31690
78905,1370,3920,50918,27987,2.93563e+13,638.842,11737.8,78905,1228,358,74985,74633,64342,58877,38522
74821,1109,2756,47603,27218,2.95851e+13,628.307,8947.35,74821,656,427,72065,71840,64131,56782,44552
45064,1568,2882,27337,17727,3.09331e+13,519.77,6720.89,45064,622,308,42182,42067,38370,39707,34915
21797,1418,1470,14067,7730,2.99586e+13,430.508,3950.2,21797,387,238,20327,20325,20322,20288,20258
27124,297,2958,19945,7179,6.48254e+13,1347.3,7201.27,27124,982,263,20838,18843,9041,7700,2456
58869,3007,3423,42148,16721,4.9307e+13,1432.53,11457.9,58869,1446,357,55446,55444,55396,55410,54346
15269,2034,2507,11366,3903,6.01132e+13,933.198,5168.6,15269,721,198,12762,12090,12289,12409,10572
98392,4238,4875,65887,32505,3.40368e+13,1243.28,15615,98392,1387,449,93517,93394,93348,92894,89395
81898,2140,3919,53719,28179,3.58719e+13,1060.08,11134,81898,981,373,77979,77011,65236,15463,22486
4179,597,602,2705,1474,3.03763e+13,154.09,1210.57,4179,168,96,3577,3561,3577,3576,3575
29369,1387,1655,18973,10396,2.92938e+13,481.792,4856.88,29369,422,280,27714,27710,27429,27460,26864
19250,618,1438,11465,7785,3.21394e+13,253.724,3097.99,19250,300,155,17812,17774,12574,7311,3427
33568,1155,1186,21644,11924,2.978e+13,533.543,4104.92,33568,410,263,32382,32382,32335,32357,32342
74411,225,3992,51698,22713,4.98213e+13,1282.51,12559.7,74411,1485,471,60567,54480,38442,14174,4416
58408,547,2111,37663,20745,3.00495e+13,565.372,6356.45,58408,534,327,56026,52962,47240,44041,16912
40883,739,2864,24867,16016,2.96531e+13,441.695,6608.7,40883,867,231,38019,37734,27770,16800,7551
31208,1015,1751,22653,8555,2.96606e+13,630.234,5675.87,31208,552,214,29445,28609,27039,27557,20666
1766,332,385,1151,615,3.21149e+13,74.2911,701.707,1766,113,55,1381,1378,1376,1359,1268
84795,1871,4077,53924,30871,2.95885e+13,746.709,12277.9,84795,1182,412,80718,80385,73218,70837,51078
20596,326,3092,15292,5304,6.95518e+13,1015.05,6325.65,20596,738,395,15809,14078,5618,4920,1600
53272,1712,3915,37963,15309,5.78814e+13,1356.74,11050.9,53272,1454,456,48593,45264,33401,27878,27180
84660,190,2891,53148,31512,3.07235e+13,689.238,9706.95,84660,610,461,75326,69164,56931,40220,13068
70951,1634,3802,46885,24066,2.98197e+13,701.729,10893.1,70951,1219,284,67149,66873,63505,61917,32408
29521,969,1751,17761,11760,3.15853e+13,328.242,4350.52,29521,366,251,27770,27717,22353,19798,13690
67323,122,2570,43193,24130,2.9696e+13,595.971,8299.56,67323,594,402,56420,51967,44265,35706,9825
50376,1478,2429,31346,19030,3.06936e+13,540.751,6953.22,50376,465,357,47947,47853,41966,34790,33006
27279,64,1623,16729,10550,3.05945e+13,296.623,4227.07,27279,336,227,21969,18229,16094,8125,2214
7634,558,687,4895,2739,2.96814e+13,316.7,1721.31,7634,259,155,6947,6797,6781,6748,6654
63764,927,4212,45259,18505,5.42773e+13,1476.35,12966.9,63764,1696,511,55860,52424,36984,29333,20554
52711,211,1468,34025,18686,2.977e+13,548.932,5271.03,52711,484,304,46656,43444,39774,37241,17806
5532,43,1073,4305,1227,9.22399e+13,181.083,1905.63,5532,155,131,3158,2103,741,1295,390
66963,2569,6714,56918,10045,4.22196e+13,16.9954,7704.63,66963,3360,3355,60249,60249,35403,49893,47836
62754,1220,2727,40785,21969,3.3023e+13,595.361,7555.93,62754,588,333,60027,59962,53922,50304,32072
96166,1645,2947,61505,34661,2.95329e+13,686.064,10047.4,96166,711,444,93219,93055,87886,82000,71998
70831,8196,20323,58321,12510,2.64093e+13,4362.97,32111.4,70831,7793,22,50508,40500,41103,45041,29260
44969,2790,2832,30410,14559,2.85907e+13,518.389,7881.08,44969,969,260,42137,42137,42137,42137,41956
3319,125,575,2137,1182,2.91737e+13,128.505,1090.08,3319,145,88,2630,2481,2189,2119,1512
49776,539,2250,31902,17874,2.94602e+13,585.024,6928.6,49776,570,365,47118,45279,40264,37854,22036
42536,2017,3753,30934,11602,6.318e+13,1487.11,9831.49,42536,1257,455,38547,35068,27650,27945,28484
26338,937,1556,16962,9376,2.97309e+13,453.74,4457.02,26338,382,271,24782,24744,23830,23359,18753
63020,151,3819,40784,22236,2.94315e+13,581.93,10292.3,63020,1222,288,52369,42683,33688,7992,4124
12276,542,1068,7867,4409,2.90272e+13,333.697,2605.54,12276,291,200,11208,11094,9739,9805,4276
84032,1484,2480,54168,29864,2.94861e+13,610.701,8636.16,84032,665,380,81552,81528,78309,77114,64908
67451,2421,4141,47232,20219,5.34309e+13,1422.11,12885.6,67451,1735,501,63310,60955,51931,39587,42671
85845,3453,4390,58597,27248,3.65052e+13,1214.89,14269.4,85845,1275,414,81455,81193,78009,78324,73851
52930,769,3445,33442,19488,2.97333e+13,470.55,8937.38,52930,1148,253,49471,48896,35834,20428,10125
26311,2883,2894,18117,8194,4.80323e+13,465.88,6317.01,26311,710,323,23417,23417,23417,23417,23388
69668,1056,3824,43888,25780,2.99444e+13,671.309,10362.8,69668,1063,396,65844,65426,53642,34474,31292
77434,520,3984,49957,27477,2.94796e+13,637.727,11661.6,77434,1246,361,72165,68830,51217,33270,21687
10247,915,1041,8711,1536,4.21885e+13,16.9696,1418.19,10247,524,519,9206,9206,8475,8897,8847
1690,63,251,1095,595,2.78118e+13,96.9627,520.059,1690,93,53,1265,859,1061,776,592
36891,562,1249,23763,13128,2.90049e+13,522.288,4311.83,36891,406,273,35550,34119,31072,29869,22523
56856,1357,3594,38204,18652,4.34135e+13,793.738,9580.7,56856,975,420,53262,51980,41498,13032,14326
94063,1157,4012,61839,32224,2.96833e+13,751.928,13025.9,94063,1251,401,89921,88753,71630,57614,32202
41484,1771,2873,29350,12134,3.47661e+13,815.183,8601.61,41484,863,235,38611,38243,37903,37734,31252
2560,147,342,1658,902,2.74852e+13,97.1223,721.869,2560,121,65,2218,2169,2023,2062,1488
4209,355,640,2686,1523,3.02267e+13,187.887,1270.14,4209,188,106,3569,3449,3358,3247,2836
14756,284,1050,9505,5251,2.98907e+13,414.282,2783.77,14756,345,188,13153,12129,11498,11171,6571
13014,3951,6492,10412,2602,117700000,25.9904,8873.17,13014,1313,11,6522,6499,6010,6522,3962
82609,1575,4097,52743,29866,2.97687e+13,751.112,12306.6,82609,1232,396,78512,78112,68153,52315,41971
47756,533,1921,30829,16927,2.9676e+13,539.026,6300.55,47756,502,333,45539,43256,39196,38149,21785
14466,620,1132,10599,3867,2.93553e+13,204.627,3276.67,14466,315,156,13334,13321,12613,12551,7240
87339,844,2960,55051,32288,3.04555e+13,711.454,9919.34,87339,654,459,84147,83488,69667,57403,44798
73334,1501,3901,47232,26102,2.93585e+13,614.759,11338.8,73334,1248,352,69433,69221,61204,60774,38980
44716,15665,16401,36128,8588,2.95694e+13,5072.21,24021.7,44716,4758,17,28315,28315,28315,28315,26844
79888,1553,3695,53679,26209,4.0639e+13,1117.33,11207.6,79888,1127,430,75597,73931,60917,17201,28595
90462,479,3914,61804,28658,4.5141e+13,1318.53,13159.3,90462,1470,473,80664,74937,54646,15067,11874
41198,908,1276,26603,14595,2.97915e+13,600.693,4565.96,41198,495,273,39922,39853,38282,37957,36820
76228,892,3922,54958,21270,4.21156e+13,1310.63,13483.9,76228,1344,423,69213,66037,42618,32540,22534
46546,232,2056,28837,17709,3.10476e+13,484.755,6038.7,46546,418,305,42507,39610,31980,20688,11938
13166,989,1159,8443,4723,2.92648e+13,290.813,2747.59,13166,313,173,12007,12006,11930,11970,11639
14524,515,1623,9921,4603,5.32337e+13,327.926,3545.5,14524,293,216,12880,12419,9973,4144,3302
78281,1549,3688,52804,25477,4.18942e+13,1104.7,11341.4,78281,1212,429,74013,72007,56951,18666,25749
96299,2587,3054,61717,34582,3.02358e+13,803.995,10326.8,96299,736,451,93245,93086,91399,91666,88130
62706,1191,3588,45012,17694,3.77014e+13,1038.29,11623.8,62706,1062,368,58491,56244,50166,49625,33144
40298,604,1285,26070,14228,3.04536e+13,572.84,4536.25,40298,487,279,38962,37774,34693,32640,30699
2578,168,471,1683,895,3.17706e+13,93.3522,866.65,2578,148,60,2107,2072,1937,1919,1509
59208,652,3625,40617,18591,3.0915e+13,777.039,10512.7,59208,1188,285,54381,52255,36812,22145,11031
28318,829,1618,18257,10061,2.91282e+13,429.73,4587.66,28318,405,265,26700,26593,25611,25466,21282
11313,314,922,7347,3966,2.99066e+13,377.62,2357.8,11313,297,162,10049,9308,9184,8502,5545
71533,3194,3724,51408,20125,4.50672e+13,1533.61,13074.9,71533,1470,394,67809,67607,65269,64049,63644
66597,2830,2958,43542,23055,3.5931e+13,591.852,8095.65,66597,603,336,63639,63639,63637,63639,63309
14129,1026,1434,10238,3891,2.96342e+13,218.43,3632.77,14129,384,160,12695,12695,12175,12252,8384
65916,326,3779,47441,18475,4.96901e+13,1399.23,12520,65916,1467,446,54494,50224,33167,31275,11682
87164,3418,4372,61495,25669,4.14927e+13,1540.88,14954.8,87164,1494,456,82792,82391,75755,77129,72598
52250,2004,3387,36431,15819,2.92855e+13,810.895,9564.33,52250,1071,282,48863,48768,47648,48333,35253
77736,126,3947,50007,27729,2.9345e+13,632.323,11607.5,77736,1250,354,63154,52683,43369,18652,7869
30450,2193,13278,24986,5464,2.63561e+13,1136.07,17806.9,30450,4169,16,17172,14294,15196,14289,7422
66559,2812,3686,45315,21244,4.46777e+13,1055.18,10827.3,66559,1299,423,62873,62671,57872,27768,36545
92981,1201,4321,66588,26393,4.66895e+13,1686.59,15879.4,92981,1811,586,85517,80936,64597,59239,36436
93332,3565,4047,61249,32083,2.98509e+13,797.857,13067,93332,1246,424,89285,89267,89285,89285,83705
9920,2439,2846,8503,1417,3.19853e+13,5.13397,4898.73,9920,1422,7,7074,7074,7074,7074,6266
29490,1060,1723,18357,11133,3.05123e+13,420.264,4694.44,29490,369,260,27767,27753,24763,24070,17732
35238,684,1545,22791,12447,3.15792e+13,505.275,4654.85,35238,474,278,33693,33445,29319,27528,12195
35611,1205,2278,23765,11846,4.28662e+13,483.637,5744.64,35611,456,278,33333,33299,29634,9174,9660
12593,582,2327,9022,3571,6.56898e+13,324.357,4395.64,12593,528,154,10180,9890,7474,6502,3804
51168,557,1908,33111,18057,2.98424e+13,515.733,6269.75,51168,513,331,49182,47286,41740,41815,29728
20111,577,977,11738,8373,3.21178e+13,278.296,2395.4,20111,300,140,19134,19076,17332,18063,15984
82202,2249,2602,52998,29204,2.94596e+13,601.737,8788.16,82202,658,386,79600,79594,79029,79041,78464
42384,1575,2600,30021,12363,2.85813e+13,597.221,7485.49,42384,846,275,39784,39767,38232,39257,27646
70301,2381,3937,48911,21390,5.0327e+13,1295.68,12200,70301,1506,472,66364,63559,56253,34223,40687
54638,2253,3402,39040,15598,4.14388e+13,1113.87,10860.6,54638,1145,344,51236,50159,46552,47027,41183
9711,1115,1496,6574,3137,2.1411e+13,333.539,3019.34,9711,524,138,8215,8215,8148,8211,6826
4748,500,509,2769,1979,3.18184e+13,140.294,997.054,4748,99,78,4239,4239,4239,4237,4220
36696,2137,3388,27000,9696,6.48052e+13,1502.48,8775.96,36696,1050,438,33239,30273,25603,25735,26199
11652,584,639,6815,4837,3.25576e+13,236.209,1574.13,11652,204,110,11013,11011,10948,10952,10828
42993,175,2047,26554,16439,3.06384e+13,442.129,5809.56,42993,398,305,38314,34570,28536,15551,8222
44344,119,3611,30918,13426,5.14544e+13,1055.72,9384.38,44344,1081,426,33340,28224,19127,5602,2392
33416,181,3657,24057,9359,6.17077e+13,1215.99,8648.44,33416,1203,440,24835,21548,12048,6844,3769
20384,1150,1940,12196,8188,3.02981e+13,274.837,3673.66,20384,463,143,18444,18443,18210,18442,17246
43874,2278,3665,30247,13627,5.13123e+13,779.958,8973.14,43874,1022,418,40209,39603,32850,15795,21521
30882,1108,1631,19916,10966,2.9171e+13,448.929,4677.07,30882,391,272,29251,29243,28867,28735,26529
87968,202,4255,60926,27042,4.72078e+13,1375.2,14613.2,87968,1808,526,70390,63101,45031,20127,7378
23283,2770,8422,18786,4497,1.98879e+13,144.501,10309.1,23283,841,155,14861,14830,7284,7963,7344
71911,935,2607,46585,25326,3.17163e+13,650.316,8100.5,71911,630,347,69304,69077,59992,57034,33895
98359,1769,10001,83500,14859,4.2172e+13,17.7158,11263.1,98359,4921,2499,88358,88357,40135,63223,58949
66923,1790,3606,44215,22708,3.80147e+13,798.834,9792.42,66923,1026,413,63317,62472,51122,13098,17126
81055,1678,3950,52598,28457,3.08705e+13,700.955,11972.4,81055,1057,377,77105,76776,70665,70804,48760
93927,76,2978,59262,34665,3.02403e+13,719.812,10251.2,93927,651,466,74862,59958,54836,39754,8858
5637,279,507,3302,2335,3.26394e+13,170.137,1050.49,5637,119,87,5130,5032,4548,4812,3441
16820,303,1363,10035,6785,3.19071e+13,238.996,2893.78,16820,264,153,15434,14978,10386,2807,1368
34839,1253,1697,22443,12396,2.98445e+13,486.481,5222.1,34839,457,302,33142,33141,32476,31723,26424
39043,543,1766,25174,13869,2.95005e+13,499.141,5265.79,39043,439,287,37190,35477,32538,31445,23908
37557,3080,3567,26100,11457,5.42436e+13,711.34,8433.58,37557,947,419,33990,33937,32861,20672,22436
54544,1620,3497,34460,20084,2.95419e+13,476.897,9036.99,54544,1149,262,51047,50982,48990,49177,34420
27445,1617,1673,19824,7621,2.94282e+13,610.247,5296.12,27445,520,210,25772,25772,25761,25745,25483
54983,610,3450,37951,17032,2.77107e+13,716.273,9587.67,54983,937,281,50657,48736,33810,19016,10523
27158,1384,1509,17480,9678,2.91131e+13,494.106,4352.39,27158,384,274,25649,25647,25448,25333,25505
40611,1531,2733,27384,13227,2.81582e+13,512.51,7464.51,40611,954,249,37878,37865,36774,33996,23477
19128,350,405,13002,6126,3.37353e+13,285.327,2255.08,19128,262,167,18723,18723,18336,18235,18016
91766,3585,3998,60209,31557,2.98571e+13,739.944,12854.7,91766,1260,398,87768,87768,87768,87768,82426
10129,602,722,7417,2712,3.13461e+13,191.302,2241.69,10129,264,117,9407,9407,9281,9372,8540
59207,1957,3587,42092,17115,3.3737e+13,1013.86,11075.3,59207,1008,355,55620,55303,52966,51982,43145
20168,2007,2535,13966,6202,4.30046e+13,849.147,5959.33,20168,802,260,17633,17499,16377,16808,15920
90661,3944,4774,60490,30171,3.21135e+13,1209.58,14699.7,90661,1379,370,85887,85782,85778,85682,80603
15773,2310,2456,11852,3921,6.97013e+13,688.875,5006.44,15773,638,260,13317,13100,12658,12533,12667
45172,181,1889,29072,16100,2.93425e+13,517.435,6077.35,45172,489,332,39096,36179,31779,27983,10259
72780,1465,2358,46749,26031,2.87893e+13,581.659,7884.32,72780,645,349,70422,70420,68497,67546,60113
86461,472,747,58671,27790,3.3612e+13,304.802,5049.64,86461,312,272,85714,85714,71168,74775,68026
73387,922,3972,48741,24646,2.9335e+13,803.441,11308.8,73387,1222,291,68902,67826,48681,36964,14832
3650,562,794,2342,1308,2.81486e+13,90.7627,1338.92,3650,172,135,2856,2856,2806,2695,1843
41254,1530,2679,26555,14699,2.90776e+13,443.317,7112.4,41254,1052,198,38575,38567,37916,35043,23314
16292,6169,11255,12850,3442,2.31438e+13,523.644,12639.8,16292,2145,15,5037,4279,4940,4980,4948
50145,1658,3812,35808,14337,5.71295e+13,1365.7,10673.8,50145,1340,463,45535,42360,31301,25410,23726
58385,2053,2585,36417,21968,3.07678e+13,601.494,7703.24,58385,490,383,55800,55730,52534,53885,49608
91441,632,4370,65052,26389,4.73259e+13,1635.81,15786.9,91441,1852,569,80634,76811,49376,38138,13512
26310,978,1756,19048,7262,3.00525e+13,452.71,5108.76,26310,461,190,24554,24208,22427,22781,14508
85829,24715,28271,68394,17435,1.89951e+13,205.144,34182.9,85829,2201,195,57558,57539,53705,56437,53306
64853,169,2144,41806,23047,2.96366e+13,563.993,7032.28,64853,529,335,56049,52729,45510,39164,15332
26395,2058,2798,18552,7843,5.26821e+13,1158.45,7177.49,26395,970,311,23597,22635,19340,20365,20356
75667,933,4022,50684,24983,3.16913e+13,937.676,12293.5,75667,1218,301,70834,68786,57313,40845,25334
63389,1785,3775,40756,22633,2.91376e+13,545.07,10375.4,63389,1225,314,59614,59542,58221,58190,37111
1256,152,233,734,522,3.33714e+13,43.2524,378.671,1256,47,46,1023,997,976,991,773
39641,1995,2590,28196,11445,3.24914e+13,778.414,7860.55,39641,860,214,37051,37043,36894,36836,34269
38391,32760,38391,19196,19195,5808000,0,38391,38391,19196,2,0,0,0,0,0
41095,1318,3056,27537,13558,4.10159e+13,629.185,7313.13,41095,774,330,38039,37678,28580,7002,6274
69926,2601,3665,43869,26057,2.93164e+13,688.15,10160.8,69926,961,391,66261,66219,66178,66246,59197
5241,343,637,3414,1827,2.8732e+13,171.27,1325.44,5241,172,101,4604,4448,4334,4154,3611
52346,3005,3343,36450,15896,2.75749e+13,739.017,9294.83,52346,905,280,49003,49003,49002,49003,48140
7499,34,654,4816,2683,2.93504e+13,276.94,1612.83,7499,200,122,4485,2488,3040,1883,832
33945,105,1157,21874,12071,2.85948e+13,524.885,4007.16,33945,433,253,28190,24383,21448,19425,7466
12441,110,367,8470,3971,3.34318e+13,271.173,1796.84,12441,236,137,8961,5308,5825,6068,6570
72716,821,3447,48031,24685,3.69855e+13,841.306,9705.23,72716,969,369,68915,68129,54232,9190,9443
28323,1525,2103,20519,7804,2.76094e+13,444.827,5813.72,28323,521,191,26220,26177,25929,26107,23278
42871,1606,3535,29244,13627,4.80061e+13,719.004,8666.12,42871,1000,417,39336,38437,30087,12446,14481
62113,1929,2581,38518,23595,3.06559e+13,613.033,7898.83,62113,492,388,59532,59412,54072,55638,47304
61669,6617,19057,50427,11242,2.46658e+13,4841.35,29879.1,61669,5575,21,41414,31106,33825,37011,20886
71429,1515,2750,45666,25763,2.99683e+13,613.626,8779.7,71429,658,426,68679,68598,64256,57545,48673
7242,162,1078,4648,2594,2.91889e+13,199.977,2160.28,7242,250,164,5966,5600,5001,4243,2164
14001,26,1291,8888,5113,3.00805e+13,273.769,3007.42,14001,295,184,8316,5236,5133,2117,854
34092,1363,2047,22636,11456,4.18413e+13,480.033,5414.74,34092,466,273,32045,32033,30240,28181,18199
92656,7053,24596,75874,16782,2.42581e+13,5665.26,40437.4,92656,7799,26,66536,48671,54254,58987,27502
57352,596,3543,40956,16396,4.11637e+13,1092.32,11300.9,57352,1153,350,50893,48236,32582,25815,9884
45321,888,1854,29247,16074,2.98698e+13,519.442,5839.65,45321,446,305,43467,43394,40820,40714,35490
47038,2728,3122,29783,17255,2.91857e+13,447.049,7823.6,47038,1120,200,43916,43916,43907,43916,41581
88153,2561,4346,62163,25990,4.76888e+13,1345.78,15229.7,88153,1801,542,83807,82273,71538,58667,60744
45438,758,2560,30298,15140,3.9849e+13,699.735,6661.43,45438,653,292,42741,42314,31571,5684,5291
25169,38,424,17059,8110,3.3375e+13,286.659,2589.26,25169,274,183,10374,4900,5021,3451,2675
37124,1467,2502,26227,10897,3.41442e+13,788.507,7731.69,37124,780,231,34622,33617,33891,32968,27636
1610,76,568,1056,554,4.59805e+13,51.2944,848.278,1610,111,91,1022,844,764,230,198
34057,1673,3199,24918,9139,6.05302e+13,1533.31,8280.07,34057,1101,292,30346,27578,21901,23672,21572
1234,233,388,824,410,3.34283e+13,98.9854,598.042,1234,128,50,846,756,760,835,751
88086,1117,4035,55890,32196,2.93153e+13,815.953,12390.8,88086,1123,423,83951,83365,69695,47647,34292
74199,3052,3987,53346,20853,4.06442e+13,1302.72,13364.4,74199,1338,411,70212,70168,63392,65419,61170
85137,736,4361,58395,26742,3.69682e+13,1210.56,14281.3,85137,1310,424,77759,75292,53736,34812,20317
86062,803,2874,54384,31678,3.00317e+13,709.225,9753.76,86062,691,444,82904,82028,69589,59329,44379
41590,594,3532,29985,11605,6.09169e+13,1502.01,9587.17,41590,1380,337,33965,32243,19242,17659,8611
38875,1274,1735,25126,13749,2.93451e+13,476.832,5375.17,38875,425,292,37140,37129,36534,35894,31356
89238,3729,4261,63787,25451,4.76637e+13,1737.01,15378.3,89238,1728,584,84977,84812,84293,83017,83440
93472,1677,4527,66018,27454,4.16997e+13,1637.9,15689.3,93472,1706,453,87645,83591,73112,70785,43843
15327,623,2526,11606,3721,6.54586e+13,1009.54,5204.25,15327,643,221,11865,11388,5471,5181,2097
59219,2472,4075,42474,16745,5.65462e+13,1505.97,12250.4,59219,1580,517,55144,53702,44542,44066,43947
92329,3251,3967,61761,30568,3.90882e+13,1344.72,12561.2,92329,1152,434,88362,87998,84861,73752,57251
40646,1760,2719,25459,15187,2.95133e+13,370.197,6630.68,40646,1030,178,37927,37927,37504,37241,31473
55738,3405,3761,40019,15719,5.34586e+13,1474.69,11539.5,55738,1454,450,51977,51976,51106,51457,50980
56345,1767,3196,37510,18835,3.88099e+13,722.222,8688.46,56345,829,353,53149,52597,43327,12715,15526
74838,179,2313,48353,26485,2.95187e+13,589.649,8042,74838,635,375,65139,60802,53023,45051,14771
3133,692,923,2147,986,3.93549e+13,144.557,1493.52,3133,288,57,2210,2210,1985,1877,1744
93438,2972,3007,59100,34338,3.00812e+13,736.247,10253.7,93438,665,457,90431,90431,90431,90431,90306
69588,2650,3739,47112,22476,4.30562e+13,1084.46,10722.8,69588,1113,428,65849,65053,57712,21639,33796
18299,433,938,11769,6530,2.93332e+13,464.58,2885.07,18299,409,201,17075,15818,15343,14586,10840
29385,2031,2177,18052,11333,2.83676e+13,323.204,4977.96,29385,773,154,27208,27208,27208,27207,26893
86446,1428,2903,54164,32282,3.03377e+13,689.656,9787.96,86446,598,457,83543,83235,73663,55444,50376
24664,721,1503,15822,8842,2.98695e+13,505.158,4109.29,24664,411,244,23152,22661,21277,19183,19561
90926,2311,4419,65349,25577,4.54005e+13,1744.4,15538,90926,1652,591,86039,83053,71286,69185,56502
51529,1447,2473,32704,18825,3.07332e+13,548.055,7308.83,51529,522,362,49056,49003,44707,38483,38527
15434,130,2621,11244,4190,6.24161e+13,696.05,5108.72,15434,736,163,10912,8413,5278,3886,1745
32628,252,1422,21019,11609,2.97881e+13,536.66,4318.57,32628,454,252,29049,26990,25163,24248,14006
41904,144,3499,30209,11695,6.12429e+13,1513.48,9606.06,41904,1423,332,30125,25262,14818,11668,3308
41223,2716,3553,28227,12996,4.98604e+13,714.424,8665.24,41223,960,419,37670,37553,34193,18383,20463
62947,2370,2663,41408,21539,3.63733e+13,813.798,7608.09,62947,645,329,60284,59952,59425,58772,55583
53038,831,2979,37450,15588,3.23256e+13,917.95,9777.85,53038,1005,259,49082,46979,37762,39284,25539
70408,239,4151,49371,21037,3.71082e+13,1091.28,12884.5,70408,1251,418,59094,52834,34965,16254,5401
51395,5831,7698,38776,12619,2.532e+13,540.237,15405.4,51395,2814,246,43697,43697,33695,29220,25020
1565,210,422,976,589,3.03968e+13,63.6556,705.611,1565,108,89,1143,1137,1075,1063,400
66121,662,6617,56224,9897,4.21294e+13,17.9734,7611.59,66121,3311,3307,59504,59501,23805,44623,38550
86870,1609,2858,54848,32022,2.99757e+13,698.522,9739.77,86870,630,456,84012,83729,76823,63302,60564
82005,2225,2723,52469,29536,2.95254e+13,636.019,9164.04,82005,637,420,79282,79239,77599,77041,74286
42396,1371,2196,27007,15389,2.97342e+13,544.658,6416.15,42396,535,342,40200,40151,37571,33955,33601
47828,352,557,32429,15399,3.35281e+13,302.412,3674.68,47828,298,243,47271,47271,37999,41036,37149
4253,436,474,2744,1509,2.80596e+13,175.478,1060.61,4253,143,93,3779,3710,3777,3763,3628
22692,2371,3412,16597,6095,7.01169e+13,731.252,6864.19,22692,785,412,19280,18891,14540,14321,16117
79899,1702,3889,55178,24721,4.81019e+13,1272.02,12587,79899,1428,473,75149,71650,56351,29048,33211
31554,2257,2812,22502,9052,5.35865e+13,1374.37,7879.62,31554,1120,301,28742,27384,25869,25834,25801
66127,2895,4129,46578,19549,5.4724e+13,1434.67,12796.7,66127,1686,505,61998,61833,55476,44814,48693
93239,3302,3987,62077,31162,3.91126e+13,1321.18,12603.3,93239,1105,447,89252,88946,86562,80161,63335
50831,748,1484,32820,18011,2.9592e+13,576.97,5230.44,50831,516,301,49347,49109,44252,45362,40388
7311,201,580,4719,2592,2.9932e+13,286.096,1527.41,7311,203,130,6392,6027,5687,5534,3354
44077,3590,3598,30285,13792,5.03642e+13,770.307,8943.79,44077,958,414,40479,40479,40476,40451,40458
20705,72,1617,12660,8045,3.16304e+13,271.944,3759.28,20705,303,218,16783,14334,12057,5296,1444
41861,1197,2915,29741,12120,4.53088e+13,1158.9,9116.98,41861,1118,314,38049,36076,31455,28931,23593
2607,123,367,1699,908,3.07683e+13,102.015,746.964,2607,129,65,2238,1930,1956,1936,1296
78373,137,4276,53660,24713,3.4687e+13,1114.56,13392.5,78373,1191,395,61207,49369,36851,10044,5263
1339,63,392,839,500,3.34276e+13,65.5071,651.594,1339,100,84,860,620,622,540,157
29141,1095,2300,19465,9676,2.77355e+13,482.403,6000.05,29141,894,198,26841,26565,24296,21967,11549
91385,1265,3874,62069,29316,4.50173e+13,1240.82,12738.3,91385,1406,478,85955,83478,65543,22058,29550
85642,2567,4135,54831,30811,2.96677e+13,756.067,12591.1,85642,1242,410,81507,81416,81303,81432,64999
80232,390,2838,50592,29640,3.01614e+13,675.217,9420.49,80232,623,439,75117,70383,60124,48450,23515
21558,1227,1981,12982,8576,2.95095e+13,294,3938.38,21558,492,146,19577,19577,19335,19573,17676
78078,3021,3825,51565,26513,2.98754e+13,702.202,11611.4,78078,1236,347,74253,74249,74214,73949,65275
93250,2411,4678,61848,31402,3.16956e+13,1034.24,14745.3,93250,1364,377,88572,88064,86629,87683,50190
45614,1837,3793,32956,12658,6.10887e+13,1433.8,10228.6,45614,1318,460,41340,37958,28750,26651,25871
14838,26,897,9621,5217,3.02288e+13,420.936,2590.99,14838,284,188,7686,3627,4592,2373,869
65400,352,4131,45943,19457,5.46503e+13,1440.62,12700.7,65400,1715,495,53717,48650,31557,17026,6388
27224,2903,3329,19910,7314,6.60084e+13,1170.01,7458.49,27224,928,411,23895,23889,22911,22846,22569
29659,711,2986,25207,4452,4.2233e+13,16.9879,3639.56,29659,1495,1491,26673,26673,13058,20994,18667
11650,863,1196,8221,3429,2.67517e+13,550.159,3130.95,11650,670,117,10454,10189,9499,9765,8882
32241,433,2456,22315,9926,2.72821e+13,548.398,6572.45,32241,867,236,28426,26141,18447,10179,5741
97856,3794,4280,63771,34085,2.97257e+13,848.539,13860,97856,1259,445,93576,93538,93576,93574,88366
63915,830,2240,41243,22672,2.95587e+13,583.799,7416.17,63915,583,350,61675,61191,55164,54122,43610
78210,1512,4270,55094,23116,5.03038e+13,1341.87,14150.2,78210,1792,527,72485,68415,53459,37770,34065
26872,1030,1052,17310,9562,2.90092e+13,488.427,3501.45,26872,381,242,25820,25813,25799,25779,25795
12918,1826,1878,8964,3954,3.76704e+13,397.778,4065.92,12918,540,142,11040,11040,11040,11040,10923
30393,3239,3526,21862,8531,6.0014e+13,919.516,8004.08,30393,945,411,26867,26850,26597,26031,23462
54158,2374,3324,38494,15664,3.44711e+13,958.461,10357.5,54158,1007,318,50834,50802,49696,49898,46023
40488,746,3670,28399,12089,5.30703e+13,1041.76,9197.42,40488,1174,416,35315,34098,21450,11482,9078
92172,1041,3588,60693,31479,3.53028e+13,1173.03,11487.4,92172,883,373,87986,87267,70435,11143,13617
51359,2721,3001,36928,14431,4.52834e+13,1237.67,10264.4,51359,1153,326,48358,48231,47367,47222,46888
53058,3208,3487,33423,19635,2.98681e+13,452.299,8873.13,53058,1140,252,49571,49571,49571,49571,48143
26140,222,2123,18618,7522,2.61957e+13,608.182,5704.15,26140,799,213,21285,18989,11746,5438,1329
31866,1730,2205,19072,12794,3.02407e+13,330.279,4659.71,31866,624,163,29661,29661,29550,29661,28049
39285,1547,2038,24091,15194,3.1305e+13,432.045,5517.31,39285,388,287,37247,37218,34607,35782,31902
54423,2498,3658,37370,17053,4.66344e+13,1061.69,10098.8,54423,1157,419,50765,49475,42992,21674,28532
3678,157,396,2670,1008,3.34946e+13,166.034,1036.74,3678,175,86,3183,2951,2389,2548,1381
63050,1318,3722,42991,20059,3.08002e+13,797.679,10880.5,63050,1101,286,59328,58050,50943,44010,20322
77890,59,709,52861,25029,3.36339e+13,305.53,4777.72,77890,310,268,40670,17161,28959,5860,8062
26793,876,1136,17294,9499,2.9121e+13,497.782,3605.81,26793,394,222,25657,25653,25317,25317,25000
77254,1740,2726,48757,28497,3.02057e+13,655.214,9076.99,77254,565,442,74528,74350,68606,58356,59016
5203,422,532,3362,1841,3.0564e+13,233.485,1255.23,5203,168,124,4671,4536,4581,4556,4331
91753,3853,4277,65764,25989,4.63728e+13,1695.82,15565.9,91753,1741,595,87476,87421,87371,85505,86128
80834,3147,4108,51597,29237,2.94732e+13,706.291,12053.4,80834,1184,396,76726,76682,76726,76688,66122
61984,3264,4166,43775,18209,5.5235e+13,1454.09,12477.7,61984,1732,502,57818,57721,53979,46239,48579
44867,1501,2054,27650,17217,3.06311e+13,459.559,5919.16,44867,422,300,42813,42785,39478,40760,36000
84416,3318,4104,55787,28629,2.90683e+13,818.376,12674.9,84416,1244,384,80312,80249,80309,80289,72471
89637,990,4384,63561,26076,4.14983e+13,1613.82,15225,89637,1688,449,81576,77067,54652,42707,15778
58954,1377,3362,40039,18915,2.85134e+13,653.146,9609.85,58954,1010,281,55592,55161,49976,42618,22060
4354,174,913,3389,965,9.27615e+13,149.719,1597.5,4354,111,121,3412,3011,1276,1671,1087
54725,1207,2499,34611,20114,3.0473e+13,538.088,7565.7,54725,525,369,52226,52136,46293,37957,33943
48316,2533,3441,30300,18016,2.93041e+13,430.618,8285.28,48316,1102,232,44875,44874,44868,44853,37673
30026,2053,2406,19592,10434,2.78621e+13,395.523,5978.45,30026,892,185,27620,27620,27403,27607,25685
99940,1139,3818,65666,34274,3.48823e+13,1258.97,12401,99940,951,414,95552,94617,77297,12501,17215
15551,4456,6208,12610,2941,1.6767e+12,86.8826,6924.47,15551,582,96,9343,9343,6893,9148,6974
16066,1647,2535,12149,3917,6.82373e+13,878.29,5279.11,16066,644,225,13531,12739,11357,11104,10282
75425,2317,2772,47522,27903,3.07231e+13,683.91,9091.52,75425,606,423,72653,72551,69425,70608,65281
75823,2878,3922,48924,26899,2.95883e+13,636.779,11564.8,75823,1240,362,71901,71865,71790,71778,61321
12619,548,850,8140,4479,2.96659e+13,387.572,2312.63,12619,316,178,11769,11362,11187,10705,10151
91315,1208,4564,64814,26501,4.25943e+13,1674.67,15620.2,91315,1697,486,83942,79542,60693,52799,25967
79608,2605,4241,56177,23431,4.99919e+13,1366.05,14368.9,79608,1765,544,75367,74087,64894,53084,54522
9251,247,726,6008,3243,2.99084e+13,346.07,1885.4,9251,297,142,8132,7701,7340,7101,4858
7553,115,612,4883,2670,3.14513e+13,319.989,1600.68,7553,225,142,6270,5708,5046,4552,2238
56373,1054,2444,34806,21567,3.07365e+13,585.166,7185.67,56373,460,379,53929,53699,44370,28786,29763
9393,1791,1905,6655,2738,6.80827e+13,261.667,3456.76,9393,437,151,7488,7488,7488,7488,7270
37959,784,3352,25739,12220,4.66366e+13,688.164,8048.24,37959,942,418,34249,33462,23999,7852,7007
61059,240,3421,41338,19721,2.83023e+13,711.145,9931.12,61059,1033,281,53769,48789,32758,13772,8523
92904,702,3344,60760,32144,3.40518e+13,943.37,10554.7,92904,704,392,88946,87684,69638,8571,8815
24947,92,1665,18112,6835,3.07339e+13,469.373,4982.41,24947,463,193,18609,14153,10408,2407,1814
34103,1373,2378,24590,9513,2.81225e+13,659.028,6748.62,34103,688,211,31725,31176,30606,31199,24887
65657,679,3600,47058,18599,4.15345e+13,1222.34,12219.9,65657,1318,370,58467,55635,40271,37861,14032
28719,2429,2788,20144,8575,5.19575e+13,1194.32,7381.73,28719,1082,294,25931,25524,25280,25424,24716
30855,144,1754,19901,10954,2.97392e+13,514.414,5052.77,30855,432,291,25876,24136,20776,17923,4858
78250,4110,4119,49997,28253,3.04199e+13,723.958,11882.6,78250,1047,381,74131,74131,74131,74131,74098
11223,52,801,7204,4019,2.85661e+13,385.128,2170.39,11223,308,164,7793,5053,5931,4402,1630
5342,485,1492,3600,1742,6.10949e+13,161.445,2397.98,5342,372,132,3850,3754,3073,2940,1369
57582,3605,3617,36745,20837,2.9636e+13,499.225,9576.15,57582,1212,242,53965,53965,53965,53965,53921
49255,1009,2958,32777,16478,2.88525e+13,496.098,8240.07,49255,1038,259,46262,45571,39213,31524,19490
59457,1292,3311,36638,22819,3.00846e+13,658.995,8457.08,59457,691,373,56146,55790,47113,32086,31241
24367,825,2968,16727,7640,4.89074e+13,501.854,6330.25,24367,804,314,21399,21020,14297,5882,5156
98742,1596,2966,63071,35671,2.99503e+13,732.237,10326.1,98742,710,447,95776,95534,88277,80496,70683
40792,562,1866,26347,14445,3.03778e+13,571.04,5855.16,40792,486,297,38549,36713,33667,32093,22028
29847,1055,2841,20988,8859,5.12015e+13,1227.55,7645.93,29847,1053,303,26082,24322,19395,18717,12602
87655,4082,4293,61325,26330,4.81223e+13,1337.61,14940.1,87655,1820,543,83362,83350,82789,81266,77660
82285,608,3941,59084,23201,4.50555e+13,1683.37,14240.6,82285,1627,453,71823,67894,43570,30481,25407
59148,3317,3409,42251,16897,3.54272e+13,956.943,10933.8,59148,1010,338,55739,55739,55739,55616,55617
71187,4012,4110,49686,21501,5.26114e+13,1333.99,12941.7,71187,1770,464,67077,67072,66995,66536,66056
9760,56,1059,6986,2774,2.91767e+13,349.32,2763.64,9760,430,117,4418,1717,1612,1216,490
67730,1845,3866,48853,18877,5.02792e+13,1508.26,12795.8,67730,1466,480,63195,59252,50333,47893,42338
58516,1826,3146,42439,16077,4.70707e+13,1299.07,11122.9,58516,1174,375,54898,52184,45436,43206,39343
85319,2930,3824,57409,27910,4.13549e+13,1211.92,12028,85319,1310,448,81495,81165,74242,30319,46614
39998,26,1888,25851,14147,3.02031e+13,622.561,5779.47,39998,515,312,21180,10841,13424,4191,1759
36869,1439,2499,26422,10447,3.13641e+13,753.812,7380.6,36869,793,212,34370,33578,33196,33696,27928
94310,2164,4265,66233,28077,4.64081e+13,1409.67,15567,94310,1787,549,89759,85841,71814,57030,54620
99502,2400,4260,68801,30701,4.58507e+13,1352.97,15368.1,99502,1808,545,95242,92436,78851,49534,56017
79350,2923,3759,56960,22390,4.33684e+13,1590.87,13736.3,79350,1609,398,75591,75274,68693,69965,67605
80985,2972,3640,50939,30046,2.98608e+13,833.036,10957.9,80985,963,426,77345,77211,77319,77345,73366
95160,2719,3620,62021,33139,3.39912e+13,968.557,11069.9,95160,751,415,91540,91473,89747,87743,76911
24698,1363,1587,15927,8771,2.95912e+13,499.83,4334.99,24698,401,262,23111,23110,22789,22691,22456
86693,3507,3666,54722,31971,2.90249e+13,857.002,11511.9,86693,979,442,83027,82989,83027,83027,82506
18318,868,876,11727,6591,2.78735e+13,462.761,2794.3,18318,361,194,17442,17442,17442,17442,17438
48050,1521,4824,40842,7208,4.22173e+13,16.9932,5660.54,48050,2415,2410,43226,43226,23445,34978,31981
36945,372,2052,24583,12362,4.10825e+13,510.242,5559.63,36945,454,273,33714,30825,26317,5518,4323
85530,3202,4245,59038,26492,4.77499e+13,1385.24,14259,85530,1797,524,81285,81022,75614,49821,58123
13097,34,833,8450,4647,3.0012e+13,430.694,2310.79,13097,356,152,7976,5262,5645,2020,1450
78095,802,4091,56121,21974,4.21952e+13,1414.12,13908,78095,1369,428,70267,67074,41004,30594,15287
71529,1396,3771,48268,23261,4.23757e+13,1093.7,10853,71529,1164,442,67044,65506,52318,15447,23117
17590,11172,11439,13964,3626,2.38947e+13,592.489,13129.4,17590,2330,15,6151,6151,6058,4945,5752
44672,936,2659,31915,12757,3.13621e+13,837.051,8343.61,44672,925,235,41621,40128,35059,37057,24476
33038,216,2497,22647,10391,2.75729e+13,528.181,6654.16,33038,879,238,27723,24819,16868,9873,4008
48639,930,2295,29637,19002,3.12557e+13,537.612,6332.13,48639,543,305,46344,46036,36944,21852,20998
45739,2571,2728,31940,13799,2.86187e+13,573.419,7878.57,45739,890,276,43011,43011,43005,43011,41433
53956,372,3386,38248,15708,4.15528e+13,1142.39,10798.3,53956,1168,347,46185,43917,27440,22677,6736
6930,144,725,4456,2474,2.94877e+13,280.765,1685.43,6930,227,135,5742,5454,4759,4509,2319
56252,1378,3651,38427,17825,4.5493e+13,978.515,9904.88,56252,1074,438,51951,50549,40252,14132,18069
50837,2466,3405,36379,14458,5.21432e+13,1382.08,10629.9,50837,1341,350,47432,46733,42274,42619,41979
44967,2359,3434,32228,12739,5.60334e+13,1592.63,9981.78,44967,1425,332,41533,39321,36359,36786,35968
75016,1994,3852,51207,23809,4.62239e+13,1157.99,11815.9,75016,1356,470,70908,68232,55009,24263,32702
42359,2540,3623,29729,12630,5.37897e+13,1069.89,9398.19,42359,1187,420,38736,37545,32527,22903,25448
9773,1503,2180,7152,2621,6.63265e+13,256.544,3707.55,9773,448,293,7593,7587,4493,5610,4531
73692,3563,3828,47999,25693,2.95568e+13,632.039,11287,73692,1233,365,69864,69864,69864,69864,67654
54402,63,2432,34638,19764,2.98331e+13,576.366,7503.42,54402,523,390,40875,30329,31190,23879,2201
3541,269,594,2317,1224,3.16368e+13,133.938,1136.94,3541,166,96,2947,2811,2686,2649,1854
98298,3089,4053,64988,33310,3.73505e+13,1223.95,12819.8,98298,1083,439,94245,93921,89722,82321,57127
93316,1707,4122,59443,33873,2.99376e+13,851.35,12865.1,93316,1192,438,89194,88698,79269,62155,56896
53428,1531,2619,35349,18079,3.81596e+13,781.793,7138.78,53428,691,304,50809,50400,45234,11002,14272
57568,382,4119,40868,16700,5.80613e+13,1498.14,12071,57568,1682,476,46687,42538,25774,17943,6423
34605,1769,1808,21691,12914,3.08579e+13,470.426,5132.13,34605,413,270,32797,32797,32789,32797,32644
42994,1238,3352,28809,14185,4.23146e+13,654.2,8219.81,42994,904,349,39642,39115,30202,8943,9027
82383,41,2826,52962,29421,2.95974e+13,631.317,9227.6,82383,672,416,53244,31289,37640,20086,5069
65088,1117,2812,40144,24944,3.05505e+13,665.394,8229.32,65088,558,389,62276,61882,51458,33253,31991
36510,1222,1718,23507,13003,2.93112e+13,509.454,5087.48,36510,437,276,34792,34763,34457,34221,31714
15790,62,2435,11616,4174,5.83528e+13,841.915,5139.59,15790,728,181,9126,5773,3975,3594,882
4656,584,817,3099,1557,3.35835e+13,113.943,1510.25,4656,212,75,3839,3839,3817,3798,3517
26757,1018,1978,17962,8795,4.67734e+13,448.826,4945.74,26757,401,268,24779,24734,22224,8264,8619
89713,186,766,60883,28830,3.35865e+13,305.257,5156,89713,313,274,83450,61105,57479,26152,40846
96514,1739,4357,67540,28974,4.6019e+13,1384.34,15798.8,96514,1818,560,91094,86684,71507,50319,44978
23577,1080,1133,13810,9767,3.18047e+13,313.038,2787.99,23577,356,166,22444,22444,22416,22403,22247
45121,190,1821,29160,15961,2.95812e+13,545.132,6025.95,45121,481,333,39540,36711,32213,27497,10023
75248,3380,3534,46814,28434,3.05285e+13,748.716,9908.06,75248,642,429,71714,71697,71714,71714,71701
77967,3795,3972,55969,21998,4.20487e+13,1545.48,13777,77967,1410,419,73995,73995,73993,73905,73531
76769,675,3400,50693,26076,3.65654e+13,987.994,9731.43,76769,882,348,72720,71526,56451,8578,7142
28311,566,1033,18223,10088,2.90062e+13,497.403,3573.75,28311,380,240,27269,26128,24696,24333,22104
50325,689,2987,34181,16144,2.90919e+13,527.785,8426.41,50325,985,267,46884,45697,34039,22017,13636
25929,769,1055,16688,9241,2.893e+13,497.783,3509.48,25929,375,243,24874,24850,23895,23800,23000
50024,1014,2358,31955,18069,3.00359e+13,586.527,7125.83,50024,518,357,47666,47486,42814,37356,26940
71890,2805,4094,50016,21874,5.22554e+13,1343.35,12966.4,71890,1729,471,67796,67536,60373,41431,48340
8763,792,2125,6796,1967,6.83653e+13,189.161,3497.61,8763,430,163,6638,6612,3032,3122,1895
17607,1445,1779,14967,2640,4.21926e+13,18.1415,2283.91,17607,892,887,15828,15828,13851,14999,14845
18070,441,990,10557,7513,3.20544e+13,270.047,2335.97,18070,278,139,17080,16923,14345,13957,12015
94841,2705,4040,60173,34668,2.9305e+13,899.867,12671.4,94841,1091,461,90801,90548,90260,90398,80375
6991,23,694,4470,2521,2.85461e+13,312.785,1668.15,6991,269,140,3577,1811,2113,816,498
15278,984,1733,9441,5837,2.6947e+13,276.492,3440.59,15278,423,126,13545,13541,13268,13481,10517
94243,21993,24669,77388,16855,2.33224e+13,5345.68,40864.1,94243,7799,26,69574,69574,69513,69513,64391
75419,1976,4194,52630,22789,5.04101e+13,1394.25,13643.3,75419,1761,532,70787,66646,52596,39005,37133
15663,1210,1330,11379,4284,2.86044e+13,218.469,3604.9,15663,344,145,14333,14333,14303,14331,14148
58606,1024,2235,37722,20884,2.93885e+13,570.225,7139.99,58606,601,340,56371,56315,52307,52093,43962
64780,2232,3885,45270,19510,5.17765e+13,1258.35,11619.3,64780,1379,471,60865,57993,48649,28431,33852
16352,213,1325,9770,6582,3.23209e+13,238.24,2802.37,16352,260,158,14826,13561,10004,2362,1000
8836,253,669,5710,3126,3.03724e+13,306.587,1757.62,8836,243,138,7908,7444,7073,7178,4487
21548,502,1455,13962,7586,3.06249e+13,445.38,4002.8,21548,367,258,19991,19258,17077,17243,9825
68064,19406,23680,55089,12975,1.84011e+13,188.927,28399.9,68064,1846,193,44384,44363,39490,42193,39046
33125,765,1144,21358,11767,2.94602e+13,531.495,4015.56,33125,403,257,31981,31832,30313,30345,28617
55861,2827,3328,38157,17704,2.87496e+13,655.482,9293.2,55861,991,279,52533,52479,52450,52532,49865
65086,976,2162,41847,23239,2.9364e+13,580.06,6985.89,65086,543,335,62924,62819,58426,58717,52504
86346,2186,4064,57501,28845,3.15148e+13,1026.59,13188,86346,1327,319,82282,81787,79846,70846,60324
11230,518,946,7242,3988,2.96137e+13,367.007,2371.14,11230,327,164,10284,9786,9805,9347,8913
58656,885,2120,37850,20806,2.96679e+13,576.418,7116.59,58656,569,370,56536,56206,50756,50081,35415
46604,1187,2132,28495,18109,3.12573e+13,513.68,6070.25,46604,463,305,44472,44352,37058,31573,25363
74673,3394,3827,50817,23856,4.50586e+13,1147.57,11683.4,74673,1381,464,70846,70624,68726,58600,50556
52060,538,2404,32412,19648,3.07166e+13,546.325,6984.23,52060,484,362,49193,48168,38048,26625,13000
25837,743,1491,16669,9168,2.95231e+13,476.476,4125.03,25837,437,228,24346,24165,23403,22676,21854
73842,1802,3967,50208,23634,3.14241e+13,1016.37,12457.7,73842,1168,324,69875,68879,66090,58001,40536
7297,99,707,4727,2570,3.04537e+13,322.204,1686.37,7297,230,149,5927,5062,4431,2425,486
1327,186,369,1057,270,9.57604e+13,98.0249,599.315,1327,55,70,958,888,627,749,688
18866,660,917,12161,6705,2.93691e+13,443.264,2864.5,18866,339,203,17949,17870,17257,16778,15983
93382,1299,4482,63802,29580,3.64085e+13,1325.97,15002.5,93382,1442,421,87554,84439,71782,59107,31470
87052,2768,4276,61371,25681,4.81852e+13,1367.04,15112.3,87052,1751,538,82776,82388,73809,61908,64591
45241,2064,2806,32319,12922,3.20757e+13,866.278,8648.28,45241,924,233,42435,42432,42336,42302,39320
88664,1440,4406,58595,30069,2.92901e+13,948.24,13481.7,88664,1266,397,84179,82954,69805,67020,38120
61261,3557,4035,43994,17267,5.53053e+13,1478.78,12453.6,61261,1557,517,57226,57212,56283,55169,55009
63534,2735,3727,41420,22114,2.96019e+13,601.474,10180.2,63534,1220,273,59807,59688,59701,59590,48813
82311,1261,3936,59443,22868,4.92722e+13,1741.05,14355.2,82311,1632,565,75551,71202,56164,54453,31935
7264,414,948,5269,1995,2.59554e+13,183.893,2146.15,7264,237,103,6316,6302,5784,5947,4850
92843,1104,4194,60532,32311,2.95891e+13,793.201,13299.6,92843,1254,417,88510,87435,69775,45735,32430
85176,3750,3936,58485,26691,4.64718e+13,1303.29,12947.9,85176,1470,476,81240,81240,80344,77959,76774
24416,2565,3212,17669,6747,6.11277e+13,1129.67,7011.6,24416,958,358,21204,20522,18946,19713,19109
26228,480,1223,17011,9217,3.03437e+13,554.702,3795.67,26228,411,236,24669,23669,22297,20992,18268
2265,238,932,1848,417,1.68519e+13,89.6512,1197.98,2265,154,57,1333,1165,512,738,751
2566,118,320,1850,716,2.20005e+13,170.587,839.087,2566,195,59,1709,716,1190,1396,1359
16863,804,868,10884,5979,2.87429e+13,456.548,2678.51,16863,345,194,15995,15993,15893,15845,15799
15280,563,859,9776,5504,2.86999e+13,472.183,2602.54,15280,374,184,14371,13713,13428,13137,12630
41155,2552,3568,28156,12999,4.99323e+13,724.248,8658.65,41155,998,412,37587,37338,32414,16726,19129
6308,1062,1538,4687,1621,8.33915e+13,151.387,2522.64,6308,318,118,4770,4770,4603,4770,4115
39063,3587,3718,28531,10532,6.72295e+13,1378.74,9442.05,39063,1229,462,35345,35345,35287,35028,34718
86560,1874,4008,59339,27221,4.62984e+13,1302.48,13207.4,86560,1535,472,81854,77957,63059,32644,37709
23172,2236,3216,15972,7200,5.34035e+13,502.563,6672.88,23172,828,355,19956,19774,16795,11917,11781
64604,1073,2359,41612,22992,2.94676e+13,607.549,7824.41,64604,595,384,62245,62171,57587,55981,41266
39444,2180,2859,28099,11345,4.47779e+13,1063.5,8777.69,39444,960,310,36585,35797,32438,33652,33331
35184,2262,3577,25820,9364,6.84538e+13,1273.63,8746.17,35184,1132,453,31607,29744,24299,24445,26374
43453,824,3022,26882,16571,2.89787e+13,421.548,7210.8,43453,926,229,40431,40197,29841,19279,9294
59468,230,3652,40853,18615,3.06447e+13,780.721,10556.3,59468,1060,285,51140,45841,30733,13101,5237
33093,1956,3157,22484,10609,4.63581e+13,577.377,7333.44,33093,896,350,29936,29603,23198,10900,12147
21229,350,1443,13737,7492,2.95937e+13,472.443,3812.29,21229,397,235,19225,17960,16556,15716,6813
87834,78897,87832,43918,43916,5807950,2.27702e-05,87832.8,87834,43916,2,2,2,2,2,2
5716,562,592,4856,860,4.22715e+13,16.9377,869.294,5716,298,294,5124,5124,4974,5057,5055
66206,2505,4078,46437,19769,5.44502e+13,1354.39,12579.2,66206,1729,460,62128,60815,52661,39865,43950
19656,1325,2802,14651,5005,7.17544e+13,862.702,5946.46,19656,783,256,16746,15716,11572,11165,12402
42453,1345,3332,30329,12124,5.67192e+13,1630.5,9584.73,42453,1421,317,37702,34398,27042,25848,20069
18242,779,2709,13128,5114,6.08867e+13,759.475,5551.24,18242,793,201,15163,14463,9306,9039,7508
31060,1352,2210,19268,11792,2.80844e+13,336.872,5233.78,31060,783,168,28850,28850,28588,28451,22212
41726,242,2198,26659,15067,2.98446e+13,547.241,6359.14,41726,510,338,37129,34376,30138,24636,9522
51192,614,1430,32930,18262,2.87839e+13,553.555,5152.86,51192,523,303,49703,48522,43717,43067,35324
80040,3673,3740,57523,22517,4.31565e+13,1518.16,13732.5,80040,1522,393,76300,76300,76300,76300,75690
76152,2008,2750,47994,28158,3.03802e+13,656.802,9123.93,76152,593,438,73402,73247,68412,66671,59785
52137,2528,3471,34799,17338,4.12857e+13,757.115,8996.76,52137,981,415,48666,48526,43947,16889,19770
44974,1626,1968,29060,15914,2.97845e+13,562.465,6205.83,44974,539,328,43006,43006,42476,42207,41366
14007,56,1242,8994,5013,2.91977e+13,362.744,3005.72,14007,347,219,9803,6671,7664,1435,393
23879,398,2161,16099,7780,2.76256e+13,456.272,5428.68,23879,821,189,20570,18496,14096,9057,5162
6283,310,865,4028,2255,2.88077e+13,270.81,1807.93,6283,248,140,5354,4995,4907,4334,3234
89374,1218,4426,60895,28479,3.67721e+13,1227.86,14604.1,89374,1339,416,83675,81116,66658,55335,29261
89292,4050,4501,62619,26673,4.09149e+13,1522.82,15199.3,89292,1482,454,84791,84776,84153,82994,82209
38532,357,500,26172,12360,3.36034e+13,296.639,3259.3,38532,292,225,38032,38032,32493,34320,32527
97992,16785,27117,79579,18413,2.56811e+13,6077.78,43342.5,97992,7932,87,70875,70871,64611,63319,53050
20187,1667,2365,14006,6181,5.14687e+13,416.835,4863.98,20187,562,302,17822,17724,16487,7983,8111
1031,436,536,721,310,1.65245e+13,74.5771,662.895,1031,202,43,495,447,467,493,475
43287,853,2707,30679,12608,2.82942e+13,638.511,7686.71,43287,850,272,40358,39480,26815,18797,7674
18153,648,1844,12798,5355,2.49711e+13,487.155,4566.01,18153,733,166,16177,15395,9555,7820,3056
14776,1216,2374,10507,4269,6.07825e+13,337.426,4351,14776,551,290,12402,12330,8817,5815,4543
60728,1297,3748,41808,18920,3.10135e+13,839.938,10887.1,60728,1043,287,56980,55496,48813,44963,20668
21443,10643,11991,17265,4178,2.47772e+13,739.031,14586.8,21443,2881,15,9452,9452,8383,6070,8261
9615,531,997,6983,2632,3.14244e+13,201.618,2458.36,9615,306,139,8618,8601,7402,7845,3691
52759,380,3097,32616,20143,2.9351e+13,538.286,8041.54,52759,936,312,48335,45496,34398,18207,12866
8830,107,1200,5689,3141,2.87534e+13,256.116,2470.38,8830,278,163,7052,6369,5524,4816,2037
76339,3233,3737,54536,21803,4.4909e+13,1543.87,13503.6,76339,1544,398,72602,72400,70338,69389,68380
67954,944,2691,42040,25914,3.03314e+13,622.849,8405.52,67954,524,405,65263,64782,51929,35150,27470
19279,479,1349,12408,6871,2.9295e+13,429.439,3560.93,19279,344,213,17770,16512,16008,15143,12382
15413,1984,2473,11001,4412,5.65958e+13,478.643,5050.32,15413,617,218,12940,12828,10782,11350,10908
12996,233,1213,9412,3584,2.84832e+13,211.782,3148.84,12996,312,136,11658,10453,8403,9419,3820
20754,1044,1434,13357,7397,2.95858e+13,396.875,3873.68,20754,380,241,19320,19293,18803,18231,14150
99195,2085,4413,70044,29151,4.55305e+13,1580.09,16416.2,99195,1898,567,94075,89817,76031,58537,52993
52146,32,2491,32949,19197,3.03152e+13,539.057,7378.92,52146,496,372,32648,21141,20878,7532,1975
94362,1055,3613,59407,34955,2.96589e+13,976.305,11640.2,94362,931,452,90377,89832,75298,56592,45785
57964,512,3078,38008,19956,2.95022e+13,592.398,8813.65,57964,1154,262,53699,51189,37522,23434,20100
9358,123,586,5466,3892,3.20166e+13,215.943,1381.17,9358,161,107,8345,7513,5944,3722,2739
54510,2803,3907,38483,16027,5.56137e+13,1232.69,10917,54510,1394,473,50603,50403,44518,30356,34680
21626,791,1648,15529,6097,2.52617e+13,643.098,4752.49,21626,763,186,19799,19438,16541,14222,14361
64572,1132,3118,42836,21736,2.9876e+13,672.65,9403.08,64572,1169,272,61320,60487,54160,44905,29187
17481,1992,2504,12881,4600,5.5953e+13,1100.02,5477.42,17481,731,209,14977,13946,14596,14586,13396
71106,514,2676,44676,26430,3.02716e+13,624.729,8690.38,71106,541,417,67711,65503,53991,41984,26732
26501,587,1338,17221,9280,3.19748e+13,484.186,3891.82,26501,395,245,25163,24400,22062,18415,7766
1252,27,225,924,328,1.73193e+13,158.712,509.505,1252,148,49,292,88,85,141,168
37522,1209,1929,24176,13346,2.91729e+13,625.467,5608.13,37522,501,312,35593,35539,34094,32470,30080
77485,1013,4181,55400,22085,4.09288e+13,1341.98,13893.4,77485,1381,430,70745,67215,47653,40397,17506
16177,65,2006,10849,5328,2.54567e+13,333.809,4273.73,16177,680,161,9800,6371,5396,2103,1454
86338,1886,8807,73285,13053,4.21874e+13,17.0673,9960.63,86338,4324,4111,77531,77531,37152,60216,57001
68990,848,3862,47886,21104,5.00654e+13,1282.97,11972.8,68990,1345,463,62346,60076,40673,15789,12763
97241,19093,25046,80009,17232,2.56907e+13,5177,41064.2,97241,8931,26,72195,72195,68294,69584,63965
39084,674,1228,25225,13859,2.90481e+13,554.803,4378.22,39084,479,282,37856,37326,33708,33809,30627
96540,3348,4050,63401,33139,3.5793e+13,1231.58,12420.9,96540,1021,427,92490,92328,90477,86467,75115
32098,2617,3532,23199,8899,6.49821e+13,1227.14,8270.94,32098,1100,439,28566,27756,23768,24214,24596
77770,773,2768,49807,27963,2.95664e+13,604.692,9028.75,77770,666,418,74938,74131,64765,60431,43323
55254,1061,3039,36655,18599,2.93668e+13,565.962,8710.99,55254,1087,261,52150,51351,45318,36770,22626
16811,771,885,9814,6997,3.20629e+13,270.364,2159.73,16811,250,140,15926,15925,15692,15780,15428
57830,531,2402,35587,22243,3.09582e+13,597.944,7045.38,57830,559,345,55043,53810,42805,26704,23989
20634,829,951,13332,7302,2.96693e+13,488.115,3025.46,20634,396,215,19683,19678,19400,19293,19203
75479,2666,2743,47359,28120,3.04022e+13,650.126,9025.82,75479,561,431,72736,72736,72709,72736,72245
58219,410,3611,37737,20482,2.92509e+13,573.256,9596.95,58219,1199,257,52950,50194,32778,16033,3593
48901,3809,4036,35160,13741,6.00833e+13,1436.26,10783,48901,1423,466,44865,44865,44737,44612,43457
3335,219,351,2834,501,4.22382e+13,16.8996,558.859,3335,179,174,2984,2984,2217,2660,2607
21905,1312,3139,15104,6801,5.44747e+13,470.039,6439.54,21905,787,345,18766,18417,12472,7623,7334
22496,811,1500,14507,7989,2.94786e+13,492.565,4107.78,22496,437,248,20996,20755,19426,18251,12503
64496,893,2158,41555,22941,2.95278e+13,583.234,7423.26,64496,564,364,62338,62085,57004,55783,43467
91159,782,4491,63746,27413,4.06369e+13,1429.86,15292.6,91159,1455,461,82533,79352,54660,34529,18089
36382,1644,2547,24796,11586,2.79432e+13,528.363,6958.18,36382,905,249,33835,33831,32951,30665,25945
7281,87,699,4733,2548,2.9592e+13,250.536,1622.62,7281,211,111,5879,4729,4610,4389,1901
15717,704,2507,11363,4354,5.97532e+13,657.716,5110.57,15717,660,204,12841,12470,7396,7690,5403
21992,584,1588,15958,6034,3.01644e+13,430.898,4671.86,21992,453,184,20266,19714,14179,13729,7092
48316,2941,3258,34290,14026,2.89624e+13,854.024,9119.05,48316,853,276,45058,45058,45058,45058,44355
17867,73,935,11485,6382,2.90264e+13,471.863,2840.66,17867,341,205,13665,10113,10339,9320,3011
84383,1655,3772,56967,27416,4.3206e+13,1169.34,12023,84383,1366,475,80024,77525,61954,22967,32394
70644,552,3653,47859,22785,4.2654e+13,1116.79,10809.5,70644,1103,431,64601,61530,45321,10477,7851
69953,1514,3717,44570,25383,2.97765e+13,586.857,10649.2,69953,1187,323,66236,66041,59178,59226,40355
79839,2374,3703,53407,26432,4.14237e+13,1026.36,10914.8,79839,1031,428,76136,75254,63213,19151,36449
21052,2276,3272,15149,5903,6.73103e+13,705.5,6546.44,21052,799,412,17780,17429,12977,12509,14131
9604,39,708,6994,2610,3.17835e+13,194.933,2159.05,9604,250,129,6147,2780,3500,1169,1040
17644,561,980,11315,6329,2.93537e+13,439.241,2891.62,17644,369,222,16664,16072,15112,14476,13531
35207,426,1928,21119,14088,3.14183e+13,340.466,4789.55,35207,440,231,33252,32569,23706,9232,8037
11069,849,1216,7850,3219,3.21976e+13,433.796,3129.67,11069,493,118,9853,9853,9603,9822,6834
80007,7150,22193,65629,14378,2.46435e+13,5157.33,35965.2,80007,7507,22,57149,42865,46280,50611,29046
82411,3428,4076,54792,27619,3.19522e+13,982.334,12780.7,82411,1300,306,78335,78180,78335,78335,74248
68213,3213,3667,43443,24770,2.9391e+13,578.93,10441.9,68213,1169,317,64546,64546,64546,64546,62223
66111,1611,4184,47006,19105,5.35276e+13,1440.58,13114.8,66111,1734,515,60811,56651,43400,37489,31988
94180,2718,3279,61371,32809,3.34964e+13,817.442,10475.3,94180,731,401,90901,90883,89581,87893,78526
40868,284,2029,24934,15934,3.12619e+13,443.894,5598.44,40868,422,300,37929,36076,27494,14239,7456
77464,3272,4204,54205,23259,3.70111e+13,1246.68,13697.5,77464,1371,412,73260,73066,69588,70084,64909
59160,1647,2632,37609,21551,3.03638e+13,547.599,8021.02,59160,530,403,56528,56480,52494,47427,46388
48433,621,3015,34890,13543,4.86654e+13,1264.67,10027.7,48433,1161,341,41763,39965,29950,27889,17146
36981,2746,3326,26951,10030,6.18483e+13,1499.44,8702.29,36981,1174,356,33655,33600,32486,32549,32064
93403,21676,25395,76126,17277,2.36532e+13,5291.05,41262.4,93403,7834,74,68008,68004,67751,67583,62390
42867,2668,2980,30737,12130,4.76393e+13,1278.97,9400.39,42867,1145,327,39887,39721,38866,38713,38500
16942,436,2332,11896,5046,5.63097e+13,392.225,4665.92,16942,527,321,14465,13558,8115,3040,1858
35994,1468,2525,24898,11096,2.77813e+13,544.686,6933.12,35994,872,254,33469,33416,32355,29262,22517
93421,409,4106,62857,30564,4.15691e+13,1402.14,13054.7,93421,1362,471,83441,76730,61041,12358,11298
76093,656,3785,51312,24781,4.22369e+13,1103.8,11383.4,76093,1273,441,70106,68098,49634,12036,10718
65602,2196,2577,40588,25014,3.06978e+13,615.717,8022.41,65602,498,399,63025,62991,60224,61366,57837
35352,17919,35351,17676,17676,5807820,2.82869e-05,35351.4,35352,17676,2,1,1,1,1,1
28209,1505,2244,20036,8173,2.69042e+13,596.966,6011.97,28209,810,230,25965,25953,25155,25660,20150
39666,3101,3370,29059,10607,6.42428e+13,1506.67,9007.06,39666,1115,445,36296,36287,35023,35424,34984
16691,61,1518,12101,4590,3.09565e+13,299.299,3963.5,16691,386,160,11722,8606,6132,1102,771
76597,1478,3560,50454,26143,3.59971e+13,1007.78,10107.3,76597,864,357,73037,72163,58697,11953,14814
49207,701,1980,31735,17472,2.94044e+13,562.747,6406.74,49207,535,330,47227,46510,41897,41761,29844
39225,1607,1814,25317,13908,2.98981e+13,554.491,5701.81,39225,490,314,37411,37411,37110,37018,36759
28593,1315,1645,18186,10407,3.04097e+13,477.852,4580.23,28593,415,258,26948,26944,26204,26460,24297
90074,972,2875,57608,32466,2.94024e+13,677.943,9718.02,90074,710,443,87199,86913,76510,70688,54672
98354,1549,4304,68776,29578,4.58807e+13,1336.06,15791.2,98354,1805,554,92537,87950,71882,46484,43127
48723,2548,3611,33788,14935,4.98661e+13,1005.15,9753.42,48723,1182,419,45112,44138,38279,23298,28025
96426,369,4059,65660,30766,4.45751e+13,1289.9,13703.5,96426,1526,481,83996,77118,58340,17175,7342
60065,1610,2060,38804,21261,2.9759e+13,560.707,7095.28,60065,534,360,58005,58004,56902,56128,53532
5948,232,1763,4569,1379,5.64306e+13,141.743,2757.65,5948,422,132,4057,3696,1870,1309,680
43981,2840,2997,26927,17054,2.95515e+13,452.105,7170.8,43981,917,257,40984,40984,40984,40984,40618
68379,1590,2681,42742,25637,3.01036e+13,633.335,8538.31,68379,554,409,65698,65486,58284,45912,47592
13969,5642,8141,11266,2703,1.65522e+13,401.82,9777.7,13969,1881,11,5828,5509,5828,5828,5828
32926,1276,2836,23746,9180,5.97044e+13,1411.98,8009.81,32926,1139,290,28953,27221,20031,19473,15598
98648,4929,10993,84036,14612,3.65304e+13,45.603,13711.4,98648,4807,4360,87655,87655,57765,74698,69482
59870,521,614,40616,19254,3.36022e+13,302.788,4138.28,59870,304,255,59256,59256,56610,57198,56498
91559,3508,4336,64949,26610,4.6412e+13,1578.18,15737,91559,1778,562,87223,87080,83752,72878,75580
83713,1620,3249,54763,28950,3.47241e+13,733.352,9843.2,83713,714,371,80464,80262,72934,69432,51619
47311,237,2260,30398,16913,3.0311e+13,615.234,6817.68,47311,548,366,41937,38815,34495,29020,9157
88820,14671,30183,72287,16533,2.35293e+13,2856.35,41910.7,88820,6007,155,58637,58635,54728,54102,32083
31868,2018,2823,22614,9254,4.79475e+13,1086.02,7925.65,31868,953,299,29045,28053,24661,25729,24425
79315,250,4228,56745,22570,4.17516e+13,1414.29,14179.8,79315,1393,446,64994,58140,36277,15239,3798
19261,1004,1500,13977,5284,2.91382e+13,232.391,4202.01,19261,393,155,17761,17755,17556,17635,15886
3514,56,928,2461,1053,3.28013e+13,268.548,1528.98,3514,396,100,1728,947,938,524,329
41109,1339,2732,26830,14279,2.84455e+13,468.686,7280.19,41109,1042,212,38377,38359,36692,33304,21293
94587,1405,4558,65856,28731,4.08374e+13,1490.59,15579.2,94587,1483,463,88286,84754,70212,58900,28614
61286,270,614,41529,19757,3.34989e+13,302.388,4183.28,61286,304,255,60049,56953,41577,40159,37257
83529,3195,3951,57250,26279,4.58783e+13,1268.78,12835.8,83529,1504,476,79578,79337,75805,41747,51534
93161,585,4762,62435,30726,3.38e+13,1214.76,14963,93161,1378,403,85073,80743,53498,33013,5620
18686,165,2399,13045,5641,5.07514e+13,909.883,5595.75,18686,793,250,13562,12074,8038,6959,1403
53807,2799,3732,37161,16646,4.96113e+13,1098.79,10343,53807,1310,458,50075,49861,44310,26232,32410
26022,57,1719,15521,10501,3.12519e+13,313.397,3889.23,26022,359,179,21323,18971,14871,3735,1195
25476,2050,2765,17921,7555,5.52726e+13,1209.25,6988.25,25476,965,302,22711,21681,18396,19457,19689
91393,2584,3906,62380,29013,4.49457e+13,1295.74,12887.5,91393,1382,476,87487,86227,76847,33156,52578
38077,202,3687,27023,11054,5.77466e+13,1178.16,9144.86,38077,1258,453,29181,25680,15607,7013,4240
86662,2792,4281,55961,30701,2.94086e+13,778.605,12907.4,86662,1244,400,82381,82229,82145,82133,61915
78380,760,4176,56288,22092,4.20398e+13,1400.88,13998.6,78380,1386,436,70196,67238,40147,25711,9807
95912,3828,4440,66022,29890,3.85969e+13,1327.95,15285,95912,1441,432,91472,91384,88285,88611,85684
98941,1780,4530,67286,31655,3.68455e+13,1325.26,15373.4,98941,1452,439,93975,91005,83709,71686,45171
58429,16424,18389,47854,10575,2.48837e+13,4374.19,28577.2,58429,6164,20,40040,40040,39741,32957,36420
45216,3608,3743,31658,13558,5.37586e+13,1137.16,9805.65,45216,1295,449,41473,41473,41238,40613,39542
14165,540,2666,10095,4070,6.41619e+13,500.483,4959.03,14165,646,348,11090,10664,6229,5336,4261
47286,1828,2804,32449,14837,2.87278e+13,543.571,8032.57,47286,940,266,44482,44477,43189,44037,33826
75278,1284,2313,48490,26788,2.92994e+13,592.798,8027.1,75278,592,369,72965,72948,69955,68767,56496
55976,2934,3510,40063,15913,4.02621e+13,1034.99,11070.3,55976,1059,355,52466,52463,49844,49996,49872
2370,320,444,1576,794,3.05819e+13,97.592,811.244,2370,142,56,1926,1926,1869,1830,1800
32984,334,3135,23828,9156,5.99663e+13,1311.97,7973.48,32984,1017,266,25932,23832,13481,12696,3639
10125,305,1004,7343,2782,3.06628e+13,204.141,2494.38,10125,271,129,9121,9060,7444,8337,4279
36327,1336,2061,24043,12284,4.04759e+13,508.361,5545.32,36327,497,267,34266,34236,32196,30014,19943
9847,1117,1122,7034,2813,2.1617e+13,398.424,2769.47,9847,573,105,8725,8725,8724,8725,8716
38214,2176,2900,27162,11052,4.64025e+13,1067.21,8721.57,38214,990,322,35314,34398,30959,32198,31459
70458,1169,2288,45427,25031,2.97158e+13,572.027,7825.69,70458,553,366,68170,68125,64298,63300,50032
35836,2842,3202,25704,10132,6.11786e+13,1412.98,8671.24,35836,1241,271,32634,32630,32634,32634,32037
97760,1015,3297,61318,36442,3.04056e+13,829.72,10851.2,97760,648,464,94271,93725,78336,61835,51430
25355,875,1242,16440,8915,3.13387e+13,490.095,3716.44,25355,387,249,24113,24099,22900,21992,20752
58677,669,2604,36959,21718,3.04012e+13,573.374,7866.11,58677,584,385,55843,54975,45261,36484,23032
68347,1560,3855,43582,24765,3.0736e+13,636.744,10841.1,68347,1038,349,64492,64245,57982,57960,41539
42255,75,1977,26264,15991,3.06713e+13,431.502,5701.13,42255,406,301,34459,28250,25207,14825,4620
65216,620,2250,42101,23115,2.96897e+13,588.176,7399.98,65216,601,337,62849,60805,54012,52427,37271
19202,787,1467,12408,6794,3.03063e+13,411.594,3675.25,19202,362,220,17735,17616,17157,17076,15001
80892,617,2887,50687,30205,3.06949e+13,687.054,9498.35,80892,590,456,77492,76188,61130,46405,30362
61227,2127,2153,39493,21734,2.93485e+13,574.237,7194.9,61227,576,342,59074,59074,59063,59060,59054
24956,1689,3145,17136,7820,5.16445e+13,515.676,6727.39,24956,817,350,21811,21472,15233,8878,8220
11962,466,748,7690,4272,2.92956e+13,385.67,2183.5,11962,260,177,11178,10470,10445,10028,9647
56839,428,2071,37061,19778,3.30745e+13,557.488,6326.27,56839,534,319,53340,49412,45484,5536,5715
87454,798,4305,62367,25087,4.18345e+13,1620.17,14992.9,87454,1665,454,78356,74653,46843,30907,12013
60194,11241,18641,49367,10827,2.61932e+13,4276.85,28885.5,60194,6934,21,41553,36062,36142,35824,29467
65089,3216,3898,45442,19647,5.11933e+13,1238.18,11724,65089,1401,473,61191,60990,58469,37575,42744
95080,2934,4627,63062,32018,3.15549e+13,1038.73,14916.4,95080,1364,390,90453,89954,90242,89998,71686
92092,3035,4360,59474,32618,2.9513e+13,801.184,13458.4,92092,1263,412,87732,87649,87652,87565,68738
88356,237,4657,58674,29682,3.17694e+13,1059.41,14277.7,88356,1356,351,76994,70056,48388,9895,3827
11806,441,1217,7511,4295,2.98341e+13,255.81,2743.39,11806,295,174,10586,10276,9529,8008,6816
77816,2356,3943,56053,21763,4.82138e+13,1694.17,13932.8,77816,1565,526,73508,71092,60784,61357,53515
17673,501,1423,11035,6638,3.10176e+13,270.688,3416.66,17673,307,202,16250,16063,13684,9706,8749
65554,2159,2554,42421,23133,3.14365e+13,626.309,7666.55,65554,575,337,63000,62953,62730,62661,60077
8655,109,1079,6206,2449,2.07396e+13,363.35,2534.36,8655,519,95,5066,3041,2305,3193,3269
95052,2872,3401,61391,33661,3.19654e+13,919.032,10786.1,95052,769,447,91651,91623,90036,89654,87993
30622,1789,3162,20825,9797,4.69051e+13,539.611,7176.61,30622,856,340,27460,27117,20333,9539,9804
74097,1475,4178,50960,23137,3.39508e+13,1083.8,12942.2,74097,1135,382,69589,67884,61829,54702,29463
13125,329,773,7666,5459,3.20871e+13,257.128,1847.42,13125,206,134,12344,12007,10160,9893,7761
94950,1566,3621,59802,35148,2.94236e+13,922.268,11672.2,94950,964,458,91329,90666,81599,62140,60817
28665,2405,3137,19562,9103,4.8502e+13,554.221,7053.28,28665,868,340,25528,25526,23969,13689,14267
94600,723,4367,67629,26971,4.64319e+13,1667,16125.1,94600,1855,575,84211,80313,52626,45295,22746
46801,608,3811,33674,13127,5.93288e+13,1378.62,10383.7,46801,1282,458,39343,37666,20420,13384,7883
42072,2728,2752,28666,13406,2.84366e+13,533.788,7614.08,42072,932,262,39320,39320,39320,39320,39241
21146,1084,1557,15305,5841,3.0018e+13,492.251,4639.48,21146,509,190,19589,19346,18938,18989,14562
2300,149,290,1481,819,2.45962e+13,96.103,623.138,2300,104,62,2010,1968,1903,1935,1641
1084,337,368,702,382,5.10289e+13,37.2103,574.265,1084,113,44,716,716,716,716,703
37525,1847,1949,22615,14910,3.12102e+13,356.598,5062,37525,436,251,35576,35560,35495,35504,34916
17827,979,1345,11497,6330,2.97153e+13,502.637,3435.04,17827,419,230,16482,16444,15841,15694,14813
5005,377,1001,3381,1624,4.26054e+13,240.009,1890.25,5005,360,73,3944,3733,3321,3004,2506
56408,501,2479,35919,20489,3.00662e+13,558.172,7607.24,56408,547,387,53307,51170,44227,37515,19921
54229,1257,2557,34250,19979,3.05389e+13,534.143,7542.68,54229,516,377,51672,51603,45468,36701,31554
16993,633,2974,12629,4364,6.46307e+13,946.673,5774.33,16993,732,277,13168,12625,5686,5437,2439
17594,92,1504,12649,4945,3.06282e+13,493.856,4258.86,17594,502,171,11676,7092,6083,1479,1160
49761,984,1947,32009,17752,2.92098e+13,545.529,6405.64,49761,479,340,47814,47749,44995,43858,33469
4431,985,1324,2861,1570,2.50659e+13,140.925,1918.52,4431,265,97,3107,3104,3036,3074,2957
28684,573,2374,19854,8830,2.67884e+13,554.044,6186.85,28684,851,228,25719,23418,16683,10867,5933
16122,1947,2116,10832,5290,4.07295e+13,650.497,4808.18,16122,687,192,14006,14006,13964,13993,13073
40910,1410,2927,25158,15752,2.89976e+13,413.389,6757.3,40910,905,203,37983,37919,35388,35604,27039
6195,549,863,4010,2185,3.11251e+13,268.927,1814.5,6195,218,146,5332,5149,4935,4981,4065
20856,879,2047,14393,6463,2.72058e+13,487.974,5068.06,20856,790,186,18809,18521,14223,13110,4861
81669,1988,4049,52408,29261,2.94205e+13,680.364,12112.8,81669,1246,378,77620,77462,73351,73211,53146
47289,2168,16543,38587,8702,1.73455e+13,128.947,19888.8,47289,1173,162,30746,30734,9110,6767,9736
17459,127,1159,11348,6111,3.07689e+13,455.388,3078,17459,330,197,14333,13493,11306,9753,4716
27574,1439,1715,19975,7599,3.05014e+13,497.556,5280.7,27574,501,202,25859,25722,25339,25609,22765
92197,3571,4401,65228,26969,4.58861e+13,1544.26,15757.7,92197,1816,573,87796,87670,84737,72456,75519
24209,519,1098,15642,8567,2.98867e+13,535.865,3543.08,24209,376,233,22936,22348,21193,20473,18238
80283,23956,31571,65179,15104,1.71103e+12,100.114,33335.3,80283,1726,158,48712,48711,37531,43401,38217
97303,2006,2948,62348,34955,3.01144e+13,730.104,10171.2,97303,726,448,94355,94181,90194,82707,81226
6914,122,698,4510,2404,2.98398e+13,250.498,1590.07,6914,262,118,5852,5335,4698,4361,2465
45457,821,3850,32588,12869,6.03179e+13,1185.84,10088.2,45457,1328,452,39388,37797,25214,15357,13945
14398,72,842,9311,5087,2.99308e+13,438.956,2515.55,14398,305,196,10781,8063,7962,7424,2491
59871,1067,2094,38713,21158,2.98602e+13,563.585,7064.94,59871,550,364,57777,57700,54279,53111,40880
78968,1643,3838,53605,25363,4.45362e+13,1157.64,11914.1,78968,1394,469,74563,72041,57493,22731,30471
63417,643,2510,40650,22767,2.94808e+13,597.156,8033.67,63417,600,400,60680,59423,52151,48687,31173
85465,2991,4043,56746,28719,3.17342e+13,996.481,13060.6,85465,1302,309,81422,81034,81337,80359,72031
42859,5272,16164,34509,8350,2.65595e+13,5342.29,23770.1,42859,4456,20,24153,16634,19261,21366,11584
15582,682,834,9083,6499,3.15948e+13,245.087,2034.24,15582,220,130,14748,14740,14300,14485,13880
60583,328,2757,37397,23186,3.11724e+13,645.981,7716.05,60583,602,379,56160,53450,41745,25408,9386
65725,1411,2318,42771,22954,3.32558e+13,582.033,6980.44,65725,596,335,63407,63398,58954,55242,45545
25413,1271,2039,15910,9503,2.70402e+13,305.525,4734.51,25413,709,155,23374,23374,23139,22991,17322
47927,183,2194,29331,18596,3.13049e+13,506.016,6194.13,47927,465,317,43156,39152,31160,14338,7864
24851,3124,3548,17838,7013,6.65398e+13,688.399,7284.59,24851,901,398,21303,21299,21033,19615,18794
1250,135,222,794,456,2.61184e+13,77.08,434.12,1250,82,46,1028,975,1005,985,832
11276,302,935,7285,3991,3.04042e+13,381.966,2375.63,11276,257,163,10013,9293,8923,8362,5529
14567,765,1919,10026,4541,2.38686e+13,351.385,4097.14,14567,652,163,12648,12452,8818,8765,3904
67995,2350,2716,43308,24687,3.04747e+13,612.467,8599.14,67995,580,409,65279,65233,63874,64499,61364
89136,3768,4333,63902,25234,4.76186e+13,1695.11,15506.7,89136,1780,576,84803,84648,84501,81598,82506
52668,261,1404,33991,18677,2.93987e+13,567.386,5182.86,52668,505,304,47701,44237,41814,40270,22674
34929,101,2830,25021,9908,5.81182e+13,1405.54,8278.89,34929,1152,311,24082,17480,11423,10025,1910
42585,2260,2751,27135,15450,2.95291e+13,448.124,7179.35,42585,1081,194,39834,39832,39554,39828,36716
32745,1261,1635,21037,11708,2.88262e+13,519.435,4934.95,32745,400,295,31110,31104,30209,29760,28728
47828,1732,2859,32879,14949,2.87383e+13,555.862,8151.77,47828,931,274,44969,44961,43466,38934,31800
40208,190,2906,28624,11584,4.61809e+13,1068.2,8936.86,40208,1049,321,31759,28001,19545,19200,5948
32735,494,1649,21133,11602,3.01804e+13,523.671,4930.4,32735,469,289,30787,29594,26270,25848,13190
25663,129,1571,18510,7153,2.63423e+13,638.286,5052.47,25663,751,199,18187,11886,10467,4533,4875
34618,1116,1748,22301,12317,2.93442e+13,519.42,5328.71,34618,448,310,32870,32832,31410,29849,22961
78876,4166,4170,56548,22328,4.19771e+13,1492.15,14090.5,78876,1395,433,74706,74706,74706,74706,74704
74236,1785,3780,50282,23954,4.3504e+13,1157.18,11471.2,74236,1335,456,70054,67741,53231,21469,27635
30476,384,1087,19711,10765,2.93793e+13,511.531,3778.49,30476,415,256,28424,26367,24832,24023,14186
10085,1057,1962,7373,2712,5.69641e+13,253.688,3657.38,10085,488,160,8123,8123,5385,5628,4518
67580,48966,67580,33790,33790,5808060,0,67580,67580,33790,2,0,0,0,0,0
50585,1478,1997,32656,17929,2.9519e+13,548.968,6492.35,50585,536,327,48588,48582,47626,46989,41946
63851,1115,2173,41180,22671,2.96322e+13,569.618,7375.66,63851,557,350,61678,61635,58045,57079,46284
69821,2121,3979,48397,21424,5.06129e+13,1276.87,12304.4,69821,1542,481,65691,62017,51310,33266,37773
18075,1702,2629,13080,4995,5.98762e+13,872.113,5507.77,18075,846,169,15446,14600,12293,13358,12117
50428,2480,3601,36175,14253,5.33827e+13,1542.8,10788,50428,1445,360,46827,45674,41075,41465,41009
62382,1588,3408,42139,20243,2.86422e+13,681.445,9917.68,62382,1060,280,58974,58747,56733,49005,28771
89533,1568,3931,61339,28194,4.58704e+13,1301.66,13162.4,89533,1525,473,84412,80862,62911,28871,33118
49133,2496,3373,30824,18309,2.9155e+13,428.421,8357.47,49133,1056,253,45760,45759,45725,45740,39949
57538,2584,3764,39661,17877,4.90383e+13,1111.29,10627.3,57538,1319,458,53774,52713,45886,26143,34047
35941,313,2936,25828,10113,5.4521e+13,1415.74,8563.02,35941,1139,330,28208,25248,15988,13635,5174
82225,1042,3912,53377,28848,2.96131e+13,675.075,12039.8,82225,1246,384,78201,77205,60985,42651,26212
73391,373,4038,52582,20809,3.93945e+13,1304.89,13306.1,73391,1336,415,62245,57811,35356,14235,4069
65600,1115,19413,54001,11599,2.73289e+13,4141.47,30221.7,65600,7707,21,36400,31949,31108,21773,3999
88036,1528,3872,59740,28296,4.42042e+13,1217.7,12447.4,88036,1401,467,83317,80707,64610,22628,31572
37775,488,1280,24263,13512,2.86989e+13,548.374,4403.15,37775,453,272,36096,33614,31613,30077,21916
56188,514,17967,46035,10153,2.52908e+13,4322.89,27686.8,56188,5944,18,27944,25902,11383,12952,1027
56323,1261,3175,40758,15565,4.617e+13,1279.82,10946,56323,1173,371,51609,49065,41660,39722,31147
51915,1719,3292,36940,14975,3.5632e+13,914.496,10186.4,51915,1002,317,48623,47751,46240,44792,38249
88698,2733,4355,62894,25804,4.75278e+13,1592.44,15426.4,88698,1810,567,84343,83611,69875,61455,61392
42896,473,2482,25939,16957,3.1548e+13,462.879,6011.9,42896,585,278,40276,39489,29504,13571,12164
70113,757,3675,47287,22826,4.28321e+13,995.124,10471.7,70113,1017,442,65249,64233,49837,11824,15706
59919,1569,3550,42850,17069,4.94483e+13,1439.81,11707,59919,1453,364,55283,51646,43925,41348,35151
9121,591,1107,6509,2612,2.05905e+13,366.372,2619.03,9121,552,98,7995,6644,7087,6872,6897
65770,259,3996,46075,19695,3.41663e+13,1063.24,12153.2,65770,1080,380,55335,50849,33813,14840,4737
62238,1351,2183,40047,22191,2.93127e+13,570.081,7272.21,62238,573,355,60055,60036,58323,56919,48937
48390,304,3089,34652,13738,4.22109e+13,1098.22,9910.79,48390,1018,337,41129,38628,25406,22882,9122
39943,490,1792,25782,14161,2.96322e+13,594.402,5698.21,39943,478,319,37580,35843,32050,31577,14406
98434,523,4031,66935,31499,4.3841e+13,1410.82,13364.7,98434,1423,479,89372,83595,62490,13708,9941
67875,1886,3749,43173,24702,2.96452e+13,579.527,10525.1,67875,1205,321,64126,64017,62104,62638,45250
41149,2478,2575,29522,11627,2.99838e+13,826.216,7769.52,41149,812,230,38574,38574,38574,38574,38468
34802,2055,3497,29582,5220,4.22149e+13,16.9906,4206.43,34802,1752,1747,31305,31305,22680,27706,26998
31185,1526,3104,26556,4629,4.17683e+13,17.2097,3788.12,31185,1554,1550,28081,28081,18642,24145,22537
99514,3816,4338,69693,29821,4.55695e+13,1395.76,15928.9,99514,1807,559,95176,95125,93700,72403,77779
64403,1789,2121,41598,22805,2.94657e+13,552.347,7310.46,64403,576,371,62282,62280,61537,61051,60204
36087,2329,3025,24269,11818,4.22624e+13,611.682,7041.89,36087,755,332,33062,32933,30980,12337,14162
38128,481,519,25875,12253,3.36789e+13,302.936,3271.98,38128,294,233,37609,37609,37563,37460,37376
24694,790,1548,15967,8727,3.02228e+13,516.483,4238.47,24694,463,261,23146,22732,21015,19671,10737
79040,4155,4231,55336,23704,4.96453e+13,1372.12,14166.8,79040,1774,533,74809,74807,74756,74198,73972
35632,670,2494,25299,10333,3.45904e+13,758.09,7516.68,35632,760,230,32302,31018,28050,28603,14363
30772,2168,2835,21937,8835,5.58442e+13,1416.66,7772.19,30772,1120,292,27937,26328,23537,24077,24087
74453,1013,3680,53668,20785,4.27729e+13,1331.58,13109.7,74453,1354,402,68266,64545,52102,51475,31192
95339,3918,4322,67184,28155,4.58425e+13,1379.44,15696.7,95339,1782,559,91017,90985,89966,75998,77985
47469,2391,3446,31830,15639,4.36292e+13,770.853,8833.62,47469,1011,421,44023,43712,37825,16236,18657
77943,3262,3705,52545,25398,4.24298e+13,1135.75,11436.6,77943,1266,442,74238,73997,71649,61641,50049
84910,2298,2790,54568,30342,2.96792e+13,643.022,9339.8,84910,717,418,82120,82079,80883,80696,78454
25973,1449,2615,22076,3897,4.22233e+13,16.9864,3225.54,25973,1311,1306,23358,23358,16389,20449,19879
75078,2788,4150,52167,22911,5.13901e+13,1400.07,13305.5,75078,1759,504,70928,70651,63159,43704,49408
33573,546,1181,21591,11982,2.98173e+13,565.111,4107.1,33573,464,258,32182,29972,28107,26925,22167
26005,776,3422,19055,6950,6.4648e+13,1106.03,7426.68,26005,885,407,21410,20346,9981,8720,5626
94056,3430,3591,59114,34942,2.9679e+13,984.149,11490.8,94056,868,456,90465,90283,90465,90465,90028
59088,74,2093,38121,20967,2.96439e+13,531.322,7087.72,59088,527,359,45809,34246,34524,32220,6300
73389,633,3761,52660,20729,4.49651e+13,1524.88,13271.3,73389,1494,383,64584,61195,41040,39723,12491
11218,218,367,7635,3583,3.37129e+13,269.535,1711.95,11218,227,137,10635,9896,7459,7236,8428
93779,367,3902,61456,32323,3.54302e+13,1174.65,12075.9,93779,997,373,85267,78215,67853,7478,3884
22911,200,424,15533,7378,3.35548e+13,289.865,2479.63,22911,271,180,21725,19982,15058,13171,16360
86161,439,4343,59725,26436,3.72742e+13,1323.44,14518.8,86161,1423,425,75330,70784,47206,25577,13330
94858,1220,4316,66989,27869,4.61285e+13,1565.91,15885.6,94858,1786,575,87477,83157,65437,49158,31043
48084,518,2324,31726,16358,3.89968e+13,521.334,6451.9,48084,510,306,45459,42751,36512,7417,5921
70764,2917,9574,47296,23468,2.78436e+13,430.815,15334.3,70764,1230,313,61190,61165,53264,54661,52167
96625,4054,4204,63636,32989,2.92724e+13,915.281,13652.9,96625,1257,407,92421,92352,92421,92421,91982
16262,678,1344,11751,4511,2.82349e+13,221.021,3718.25,16262,351,148,14918,14901,14184,14377,11032
56600,325,3019,34937,21663,3.08496e+13,585.4,7670.06,56600,649,317,52196,49704,38772,22524,16028
99862,616,3473,64312,35550,3.24714e+13,920.94,11217.8,99862,755,453,95605,92721,77201,9917,11624
74457,1433,4030,53516,20941,4.05052e+13,1304.6,13408.1,74457,1342,415,69476,66326,57133,55009,33714
29175,245,1645,21011,8164,2.70368e+13,622.753,5408.98,29175,754,207,25056,22501,13968,5926,7874
9413,657,943,6086,3327,3.07105e+13,368.682,2244.36,9413,274,151,8470,8190,8075,7997,7895
72072,668,3771,48114,23958,2.95703e+13,834.053,11083.1,72072,1174,284,67090,65318,48367,31721,24762
26211,2757,2837,18335,7876,5.09421e+13,1173.79,7227.1,26211,932,302,23374,23366,23360,23361,23269
20410,1029,1214,13187,7223,2.99126e+13,519.192,3371.15,20410,381,259,19196,19195,18935,18684,18863
36451,1390,1635,23516,12935,2.92231e+13,502.655,5142.74,36451,433,277,34816,34809,34469,34156,32255
1690,248,269,985,705,3.15445e+13,63.1183,462.558,1690,48,44,1421,1421,1419,1419,1391
2657,168,331,1741,916,2.60581e+13,100.898,710.444,2657,115,62,2326,2289,2169,2191,1783
72731,2101,4115,52423,20308,5.16089e+13,1513.09,13638.8,72731,1567,547,68305,64359,53181,53791,48152
90733,134,4333,65127,25606,4.70505e+13,1688.98,15758.8,90733,1820,576,67869,53846,36753,14492,6817
49886,256,1403,32110,17776,2.84231e+13,574.403,5052.7,49886,501,300,45197,41762,39976,38429,19206
89677,734,2940,57530,32147,2.98999e+13,691.036,9807.71,89677,688,436,86540,85549,73870,68806,49649
21680,1359,2593,14990,6690,4.59253e+13,873.312,6259.66,21680,805,268,19011,18196,16440,15437,12519
45361,2107,2603,30258,15103,3.97986e+13,687.361,6736.15,45361,655,309,42758,42470,41088,38587,26486
95887,1214,3921,65397,30490,4.45494e+13,1307.34,13357.7,95887,1471,484,90048,86746,65910,24182,24967
5600,247,476,4085,1515,3.1227e+13,177.674,1404.23,5600,194,107,5124,4750,4255,4678,2769
30895,519,1576,19917,10978,2.92904e+13,465.173,4733.97,30895,422,280,29165,27815,25520,24587,15976
27235,907,1078,17620,9615,2.99612e+13,509.998,3603.45,27235,385,240,26157,26156,25777,25734,25358
15943,49,1896,11116,4827,2.56063e+13,501.388,4336.14,15943,733,166,7545,3794,3165,1139,544
96775,2990,4296,67170,29605,4.56829e+13,1323.91,15369.3,96775,1819,546,92479,92184,84723,58188,67139
79584,172,3551,49893,29691,2.94616e+13,792.783,10635.6,79584,938,412,69076,62693,49902,28586,11092
49417,1125,3365,35447,13970,5.22203e+13,1359.87,10478.6,49417,1301,342,44130,41250,32099,29932,22373
77669,892,2702,50113,27556,3.02875e+13,669.19,8673.02,77669,689,379,74967,74482,64433,62165,41282
22812,772,1974,14378,8434,2.65596e+13,306.647,4507.19,22812,670,153,20838,20794,19188,18730,13745
96764,726,4698,64203,32561,3.15773e+13,1041.37,15141,96764,1373,391,90187,87836,63050,42250,15776
90813,1541,4337,64291,26522,4.6669e+13,1411.44,15508.2,90813,1800,559,84863,80332,66322,49988,42161
82547,2937,4059,55286,27261,3.1602e+13,1031.14,12999.3,82547,1291,326,78488,78108,78315,77094,68474
71988,862,3237,47335,24653,3.57914e+13,872.892,9197.59,71988,695,345,68413,67877,53216,8510,9761
31533,2681,3257,23141,8392,6.25763e+13,1422.16,8077.42,31533,1040,316,28276,28234,27368,27276,26792
69923,815,2646,43728,26195,3.03157e+13,627.894,8473.78,69923,550,403,67130,66480,54276,39891,28495
93802,2768,4551,62006,31796,3.08306e+13,959.781,14317.3,93802,1362,396,89251,88876,88549,88737,64727
65497,3928,4165,45905,19592,5.35468e+13,1458.69,12864,65497,1748,505,61332,61315,60918,59908,57865
21240,2196,3069,15681,5559,7.43732e+13,697.823,6227.61,21240,681,404,18171,17642,13525,13882,15278
64307,2783,3759,41539,22768,2.9488e+13,576.241,10418.5,64307,1230,308,60548,60481,60487,60407,50810
31260,1090,1633,20064,11196,2.89664e+13,496.027,4814.3,31260,408,280,29627,29599,28341,27410,22268
94189,2004,4552,62335,31854,3.09279e+13,1020.78,14451.8,94189,1354,409,89637,89071,86823,87648,49454
19432,845,1506,14045,5387,2.82966e+13,645.217,4431.97,19432,542,184,17775,17338,15611,16092,13048
13384,1931,2153,9130,4254,4.80167e+13,520.401,4418.87,13384,784,164,11231,11221,11037,11124,11035
14692,94,738,8596,6096,3.28195e+13,265.204,1851.25,14692,244,121,12753,11494,8727,4597,3439
58124,615,3625,37460,20664,2.93464e+13,561.287,9529.4,58124,1208,248,53988,52575,35048,17467,4933
69609,2661,4177,49735,19874,5.29211e+13,1420.31,13465.6,69609,1652,529,65432,64591,56881,52994,53720
74765,315,3711,47617,27148,2.94168e+13,598.851,10930.8,74765,1181,336,67938,63352,48638,29146,16174
87284,1792,3880,59321,27963,4.4669e+13,1235.12,12467,87284,1395,472,82899,80056,65741,25660,36103
70268,2314,3653,50604,19664,4.16913e+13,1246.55,12666.5,70268,1325,385,66615,65136,59166,58364,52378
79467,3290,3776,52321,27146,3.61582e+13,1070.18,10822.9,79467,937,364,75691,75656,74928,74949,69623
78710,3837,4368,52188,26522,2.93718e+13,894.483,12493.1,78710,1232,332,74342,74342,74342,74342,72618
79916,2609,4420,53048,26868,2.96417e+13,890.174,12665,79916,1249,330,75496,75192,74386,74944,52220
68125,3536,3613,44922,23203,2.97715e+13,694.815,10292.9,68125,1200,282,64512,64512,64512,64512,63956
86912,3723,4396,62051,24861,4.223e+13,1651.09,15052.4,86912,1657,441,82516,82471,80356,79271,77404
56952,14319,18177,46589,10363,2.5529e+13,4420.05,28067.2,56952,6148,20,38775,38775,35235,36525,35544
58642,457,3670,39923,18719,4.52877e+13,1006.77,10165,58642,1087,436,52286,48428,35298,8340,5803
63018,728,3673,41170,21848,2.95052e+13,614.521,10105.1,63018,1208,268,58848,58087,39480,26649,7374
21655,897,1005,12650,9005,3.20232e+13,297.736,2526.22,21655,301,156,20650,20650,20360,20454,19880
73957,492,3962,48208,25749,2.96397e+13,674.177,11622.9,73957,1237,382,68387,65313,45396,27855,11625
13781,347,1220,9944,3837,2.75966e+13,217.367,3301.86,13781,318,138,12561,12239,10439,11086,5853
55476,3329,3833,38972,16504,5.54166e+13,1197.34,10910.9,55476,1326,467,51643,51500,50353,34815,38541
39325,306,1257,25396,13929,2.94462e+13,538.143,4401.64,39325,446,273,36004,33157,31838,30463,16489
50694,240,3412,31635,19059,2.94058e+13,444.378,8439.1,50694,1041,264,44952,41310,30150,10324,6050
92075,916,4248,60887,31188,2.93742e+13,949.203,13528.6,92075,1257,412,87190,85736,64246,42199,23121
86948,2344,4098,59775,27173,4.7113e+13,1276.7,13298.1,86948,1510,474,82850,79743,68319,37050,46794
86904,116,4418,59141,27763,3.61665e+13,1205.73,14247.9,86904,1299,428,66497,53295,39483,10949,5915
59421,2430,3350,40331,19090,2.86845e+13,668.552,9621.27,59421,1027,281,56071,55984,55499,55820,46766
66434,419,4093,46490,19944,5.42336e+13,1338.33,12600.9,66434,1734,464,55994,51798,34178,18073,8780
7567,1526,1645,5015,2552,4.92364e+13,367.007,2848.45,7567,446,115,5922,5922,5915,5912,5626
6437,618,689,4147,2290,2.84669e+13,269.009,1592.96,6437,205,128,5748,5739,5693,5727,5552
90566,3769,3988,61881,28685,4.56546e+13,1299.46,13258.3,90566,1543,471,86578,86578,85582,82820,81728
41248,1310,2756,27926,13322,2.81264e+13,514.345,7528.55,41248,941,257,38492,38262,34907,31361,15490
93213,396,4135,63757,29456,4.69886e+13,1290.8,14020.6,93213,1767,472,81215,74751,55830,19192,11129
46236,1193,1987,29757,16479,2.91513e+13,544.911,6289.94,46236,552,330,44249,44235,42568,41375,34217
98410,1915,4113,63014,35396,2.94393e+13,872.562,13258.7,98410,1204,449,94297,93806,86023,72242,62309
46663,2383,2902,31097,15566,2.87481e+13,493.513,7993.7,46663,1026,256,43761,43760,43538,43649,38875
99416,910,3662,62843,36573,2.94764e+13,990.98,12125.1,99416,979,465,95191,94547,78300,59753,45017
38549,326,1986,23869,14680,3.13451e+13,435.317,5494.72,38549,428,289,35743,33987,27334,16862,9665
53969,562,576,36572,17397,3.35298e+13,299.572,3901.28,53969,300,248,53393,53393,53392,53329,53248
59024,2157,2547,36670,22354,3.04037e+13,597.286,7723.5,59024,499,392,56477,56443,54115,54996,52382
21137,406,9741,16910,4227,72568100,508.498,13746.9,21137,2125,11,10961,10561,6524,5159,485
77507,289,4033,49073,28434,2.94561e+13,730.771,11446.2,77507,1077,407,69837,64966,50631,30119,10680
82018,1167,4110,55031,26987,3.17047e+13,1051.75,13064.7,82018,1270,340,77177,75059,63856,53124,30657
82870,842,4664,52325,30545,3.05282e+13,678.448,11588.8,82870,893,450,78044,77160,61574,44957,33762
12456,310,772,8124,4332,3.01789e+13,402.308,2248.8,12456,308,168,11245,10386,10053,9514,7556
74218,1972,2682,46198,28020,3.06614e+13,649.316,8772.76,74218,591,425,71536,71385,65067,66210,56865
13473,962,1932,9216,4257,3.74357e+13,528.134,4209.26,13473,522,166,11541,10892,10792,10687,8149
36631,1315,2617,23030,13601,2.84693e+13,337.022,6224.17,36631,922,173,34014,34009,32980,32179,23938
57444,3290,3521,41046,16398,4.10954e+13,1093.93,11278.2,57444,1175,346,53923,53923,53763,53403,53011
6922,391,646,4441,2481,2.8729e+13,308.151,1624.91,6922,223,140,6180,5852,5786,5543,4659
49032,1070,3783,34423,14609,5.43132e+13,1134.64,10181.4,49032,1346,459,43764,41825,29772,15279,15830
82184,2221,3831,55355,26829,4.17474e+13,1188.64,11871.2,82184,1378,451,78303,76039,64839,24788,41110
93821,3636,4005,61712,32109,3.59424e+13,1191.78,12326.3,93821,1033,434,89816,89813,89173,88213,81543
42732,861,1496,27542,15190,3.01782e+13,562.512,4932.74,42732,468,302,41236,41164,37323,37256,32966
29257,1090,1610,18492,10765,3.00457e+13,460.085,4572.62,29257,387,263,27647,27634,25983,26445,22296
45301,2011,2898,29598,15703,2.87085e+13,472.333,7740.42,45301,1070,232,42403,42402,41737,39760,35645
25714,1988,2960,18926,6788,6.45975e+13,1274.47,7007.12,25714,821,273,22682,20857,17943,18558,19070
84299,3828,4234,56642,27657,3.26628e+13,1094.97,13412.4,84299,1300,370,80065,80029,79839,79839,78238
92982,268,2968,58461,34521,3.02112e+13,716.634,10252.9,92982,639,464,85062,79223,67536,50153,18991
24168,476,2149,16937,7231,2.58141e+13,568.998,5562.1,24168,824,204,21024,18799,12830,7771,3556
69649,1994,3782,44595,25054,2.96663e+13,593.646,10848.7,69649,1238,333,65867,65803,64806,65230,46060
63542,1370,2573,40366,23176,3.0486e+13,570.932,8177.78,63542,568,399,60969,60874,55227,46871,43489
34478,1373,3341,25282,9196,6.23541e+13,1489.94,8489.87,34478,1045,386,30060,27466,18828,20637,15883
32105,604,1850,19084,13021,3.17098e+13,329.949,4395.78,32105,431,217,30255,30056,21286,7663,5714
7255,2711,2927,5911,1344,1.74952e+12,86.1203,3389.75,7255,480,78,4328,4328,4131,4304,4036
93928,2018,4208,64538,29390,4.61703e+13,1366.95,14700.8,93928,1780,536,89269,84945,68688,41046,42856
3287,370,565,2087,1200,2.80877e+13,105.963,1077.51,3287,154,88,2722,2701,2627,2644,2118
22125,591,2149,15472,6653,3.70116e+13,590.458,5564.11,22125,627,185,19400,18379,17363,17231,11841
34727,642,18999,30419,4308,8.68444e+11,14.9775,19387.9,34727,1468,50,15728,15728,2667,2702,1422
59235,830,2575,37430,21805,2.99705e+13,565.97,7957.64,59235,582,396,56658,55949,48068,40248,28551
79619,941,2777,50217,29402,2.99887e+13,647.276,9255.87,79619,583,441,76825,76358,65608,54277,42432
81999,1648,3762,58759,23240,4.23264e+13,1509.31,13891,81999,1576,399,77239,73650,65995,63407,47659
94263,2976,3994,62028,32235,2.98221e+13,759.551,13072,94263,1263,408,90269,90041,90203,89921,76566
69344,3395,3569,43914,25430,2.94452e+13,572.632,10139.1,69344,1102,329,65775,65775,65775,65775,64977
65351,352,3305,43263,22088,3.75701e+13,782.622,9233.05,65351,911,359,58911,53882,46102,6963,4104
55610,288,3136,36949,18661,3.84115e+13,758.141,8421.46,55610,838,342,48979,44550,37784,5621,3600
2197,185,633,1883,314,4.00072e+13,5.12107,1087.44,2197,316,5,1564,1564,1430,1564,674
13798,389,2721,9866,3932,6.35635e+13,482.787,4971.54,13798,641,343,10543,9543,5818,4841,3220
50516,1982,3750,35739,14777,5.66901e+13,1151.88,10386,50516,1322,460,46490,44061,35544,23872,28831
94929,2194,4630,66795,28134,4.19165e+13,1661.9,15902.4,94929,1702,475,89811,86357,77370,75306,51853
62188,1104,2124,40035,22153,2.88452e+13,547.122,7225.12,62188,552,366,60064,60035,56384,55604,43522
49049,1610,2251,32152,16897,3.64021e+13,560.23,6365.29,49049,549,299,46798,46791,44844,44090,39610
82261,4108,4124,56737,25524,4.87352e+13,1370.7,13697.1,82261,1743,513,78137,78137,78137,78119,78115
69092,1459,3217,45631,23461,3.65584e+13,821.564,9108.14,69092,820,348,65875,65268,52228,11036,13939
14305,254,819,9184,5121,2.89047e+13,432.24,2453.86,14305,295,192,12703,11854,11057,10942,5082
60733,2512,3614,38603,22130,2.92986e+13,524.896,9835.89,60733,1168,304,57119,57117,56922,57077,44105
9773,1128,1767,6807,2966,3.42955e+13,305.438,3421.13,9773,444,130,8006,7826,7763,7921,7098
77619,655,3934,56138,21481,5.0178e+13,1676.2,13844.9,77619,1505,559,67767,64797,39702,37045,13677
33177,2351,2483,21727,11450,2.8605e+13,460.631,6417.24,33177,954,194,30694,30694,30691,30694,29764
50644,1576,3323,36157,14487,4.29723e+13,1094.15,10385.9,50644,1081,351,47038,45200,41027,39542,30601
81467,3665,4095,52218,29249,2.95001e+13,678.513,12111.2,81467,1252,383,77372,77372,77372,77372,74088
84049,3013,4302,59806,24243,4.81993e+13,1496.89,15015,84049,1726,559,79747,79399,73208,65594,66813
85391,2705,2797,54615,30776,2.96036e+13,660.843,9486.4,85391,668,425,82594,82547,82547,82584,82025
74321,2381,2430,47971,26350,2.9446e+13,589.553,8089.31,74321,655,359,71891,71891,71889,71860,71846
23110,1970,2225,15994,7116,3.75039e+13,648.389,5880.46,23110,694,196,20885,20885,20834,20866,19259
79858,3446,3935,51549,28309,2.92952e+13,638.281,11788.4,79858,1245,364,75923,75923,75923,75923,72032
34775,2114,2889,24781,9994,4.64983e+13,970.854,8296.9,34775,888,312,31886,31263,27551,28842,28394
71406,3551,3833,48908,22498,4.68638e+13,1149.92,11605.7,71406,1364,463,67573,67411,66574,63605,57095
76429,1233,3950,49454,26975,2.94001e+13,651.565,11654.9,76429,1238,372,72479,71836,59446,47476,28926
69103,802,3931,48244,20859,5.11998e+13,1278.96,12160.7,69103,1495,473,61889,59652,40013,20206,16165
75520,1641,3756,54179,21341,4.44792e+13,1527.95,13436.1,75520,1498,396,70732,67399,59654,57985,42657
61575,2818,2975,40829,20746,3.7586e+13,808.034,8146.33,61575,739,340,58600,58600,58253,58281,56676
70037,2144,2655,44001,26036,3.04022e+13,643.219,8661.71,70037,538,439,67382,67280,63961,65032,59012
97300,2329,4537,67288,30012,3.996e+13,1447.21,15660.9,97300,1469,448,92622,90631,81087,80089,59977
58865,763,3760,40267,18598,4.64244e+13,1082.61,10648,58865,1311,426,53318,51845,36739,11959,11685
27111,912,1750,16293,10818,3.11501e+13,307.398,4191.01,27111,348,219,25361,25317,20241,17663,11137
80635,1724,4429,53648,26987,3.09117e+13,908.871,13019.5,80635,1333,333,76206,75541,72519,71036,35780
9230,34,637,5415,3815,3.21552e+13,210.359,1447.07,9230,170,107,7384,6783,4480,1118,952
11247,785,872,7275,3972,2.97062e+13,378.943,2220.73,11247,303,150,10375,10372,10283,10332,10198
89563,3169,3980,58991,30572,3.64097e+13,1114.28,11944.4,89563,1019,436,85583,85499,82853,79933,62636
85250,4189,4262,59449,25801,4.86112e+13,1358.48,14696.2,85250,1815,537,80988,80986,80930,80218,79666
35823,1083,1241,22996,12827,2.93629e+13,567.262,4279.94,35823,487,264,34582,34559,34258,34317,34103
42613,979,2200,26971,15642,3.00997e+13,541.359,6333.93,42613,496,344,40413,40246,35176,28699,21448
6764,1048,1080,4887,1877,2.81397e+13,170.983,2246.07,6764,351,107,5684,5684,5678,5674,5502
68150,3831,3972,48446,19704,3.83891e+13,1176.33,12664,68150,1218,396,64178,64176,64152,63988,63528
68599,3173,3678,46381,22218,4.29426e+13,1046.53,10577.8,68599,1113,430,64921,64714,62545,50675,40919
74891,1845,3084,46610,28281,3.08093e+13,721.684,9288.61,74891,618,432,71807,71542,64220,55263,50388
75970,400,4003,48389,27581,2.97782e+13,677.002,11452,75970,1181,384,69629,65218,49343,32900,12264
66168,947,2123,42703,23465,2.93539e+13,596.612,7480.85,66168,556,372,64045,63821,58591,58058,44345
10314,876,1808,7028,3286,3.78584e+13,466.473,3536,10314,545,152,8506,8160,7475,7115,5261
77079,2782,4003,48842,28237,2.9556e+13,738.694,11428.2,77079,1076,405,73076,72995,73029,73054,64338
33853,1516,2469,24342,9511,2.84922e+13,672.639,6831.64,33853,746,207,31384,31012,30831,31123,26613
19273,1267,3109,13485,5788,5.76572e+13,449.426,6121.59,19273,762,342,16164,15880,10239,7082,6844
57109,2406,2498,35871,21238,3.073e+13,588.174,7649.91,57109,512,388,54611,54577,54569,54576,54019
77576,2374,2694,49914,27662,2.98123e+13,656.126,8524.41,77576,644,362,74882,74856,74471,74568,73532
4595,427,1150,3074,1521,5.33899e+13,190.563,1904.29,4595,309,128,3445,3339,2802,2767,557
8945,28,1038,6543,2402,2.89137e+13,183.243,2509.78,8945,369,128,4053,1354,1660,753,88
23929,836,2708,16875,7054,5.99212e+13,1004.39,6600.78,23929,1001,241,20308,19323,13856,13900,8970
76205,459,3963,51317,24888,3.17084e+13,983.846,12543.1,76205,1185,308,68608,64855,46070,24871,16359
82755,567,4288,54766,27989,2.89699e+13,842.991,12723.1,82755,1245,351,77066,73928,50699,31299,11693
89916,2347,3022,58352,31564,3.19939e+13,776.074,9767.97,89916,684,404,86894,86709,85414,83093,72271
93093,1050,3626,58630,34463,2.95794e+13,922.975,11541.9,93093,933,454,89167,88605,74270,55349,43441
81488,1407,4278,57980,23508,4.1695e+13,1505.3,14452.9,81488,1420,454,75623,72154,60574,51977,32266
89764,2965,4467,61732,28032,3.67822e+13,1321.05,14821.7,89764,1426,421,85297,84876,80082,78603,70023
76767,1652,4100,53205,23562,5.04883e+13,1287.59,13089.7,76767,1721,469,71607,67950,52127,29161,32011
73984,2598,3848,49442,24542,3.10262e+13,846.359,11591.5,73984,1252,285,70136,69917,69728,69794,58046
94518,891,4550,65911,28607,4.12254e+13,1545.73,15668.8,94518,1580,450,86104,82279,58118,40285,19853
94306,1644,2960,59838,34468,2.97841e+13,721.927,10169.3,94306,674,446,91346,91080,85093,73201,66422
19523,1076,2205,13491,6032,3.91308e+13,571.331,5355.24,19523,625,191,17318,16524,16528,16410,12055
13560,1464,1878,9022,4538,4.59937e+13,667.119,4075.04,13560,672,125,11682,11488,11452,11070,9576
14639,1768,2776,10506,4133,6.24769e+13,308.592,4964.21,14639,627,319,11863,11774,8866,7588,6542
40457,592,2035,24583,15874,3.09425e+13,431.917,5508.77,40457,438,294,38353,37972,28881,14970,12442
62371,1506,3792,39588,22783,3.08689e+13,588.811,10236.2,62371,1040,323,58579,58401,52068,52900,37235
16601,785,1999,11126,5475,2.52816e+13,334.069,4325.42,16601,681,165,14602,14421,11124,11382,6088
61976,2615,3662,40155,21821,2.93623e+13,590.583,10072.5,61976,1216,298,58314,58227,57957,58128,46843
49806,1351,3057,30445,19361,3.08729e+13,557.876,7255.86,49806,635,319,46749,46548,40223,38220,32825
71630,2479,3623,47328,24302,3.82317e+13,846.683,10088.7,71630,1028,413,68007,67713,59477,18287,24424
21600,629,1884,15468,6132,2.99642e+13,508.913,4962.28,21600,584,159,19410,19046,17699,18327,11691
71347,673,3906,49518,21829,4.88199e+13,1303.91,12159.9,71347,1389,469,63598,61743,40379,16170,10425
51130,1284,3842,36415,14715,5.65846e+13,1313.19,10654.3,51130,1332,466,45669,43177,30897,18038,16003
75017,2557,4144,51904,23113,5.01993e+13,1314.32,13021.2,75017,1705,468,70873,69658,60838,38685,45908
16426,577,1455,11914,4512,2.86958e+13,285.82,3960.21,16426,388,170,14971,14744,10086,10174,5864
40825,3187,3753,29751,11074,6.42213e+13,1416.26,9728.56,40825,1202,460,37072,36987,35516,33598,33646
53848,223,3250,33474,20374,2.92071e+13,546.408,8437.86,53848,931,317,47458,43095,33239,14198,6512
1586,194,298,1006,580,2.86595e+13,73.3197,559.756,1586,83,56,1288,1288,1264,1271,1101
5919,210,1200,3966,1953,5.73541e+13,321.893,2159.4,5919,405,69,4440,4169,3140,3551,1057
45597,1420,3304,32596,13001,3.96881e+13,924.389,9664.9,45597,888,329,42155,40551,36793,35621,27071
18829,815,903,12104,6725,2.86047e+13,467.643,2882.37,18829,341,201,17926,17919,17793,17807,17713
73261,3181,3967,46157,27104,3.00316e+13,684.634,10976.9,73261,990,384,69294,69266,69294,69282,65077
73888,2751,3742,47132,26756,2.92671e+13,590.616,11015.7,73888,1238,328,70146,70145,70025,70091,59422
7135,488,583,5198,1937,3.19284e+13,186.586,1716.66,7135,219,118,6552,6552,6479,6525,6057
95963,4310,9600,81591,14372,4.215e+13,17.0321,10800,95963,4802,4797,86363,86363,54659,73147,68394
85804,184,4153,54931,30873,2.94509e+13,732.521,12593.3,85804,1244,397,74067,63535,50924,23996,8489
24965,276,1516,16149,8816,2.98385e+13,456.953,4257.52,24965,396,257,22217,20467,19029,18168,8791
86069,3598,4169,59296,26773,4.77369e+13,1397.17,14184.1,86069,1769,530,81900,81822,79713,53836,61947
64096,1944,2167,41344,22752,2.9394e+13,541.587,7149.37,64096,555,343,61929,61925,61512,61238,59438
52947,3317,3742,38053,14894,5.78562e+13,1551.32,11180.4,52947,1454,510,49205,49202,47129,47505,47426
51717,1863,1965,33402,18315,2.97542e+13,548.619,6532.27,51717,515,348,49752,49752,49577,49477,49608
63443,3142,3615,41405,22038,2.95292e+13,632.117,10016,63443,1206,270,59828,59826,59828,59792,55140
25160,842,1554,16024,9136,3.01405e+13,459.193,4221.18,25160,379,243,23606,23399,21822,19706,18636
4780,1272,1300,3451,1329,4.09834e+13,259.981,2087.79,4780,400,130,3480,3480,3478,3479,3462
14496,1112,2350,10419,4077,5.60791e+13,414.529,4713.68,14496,553,208,12146,11990,8343,8580,6966
92414,2537,24572,75656,16758,2.43625e+13,5695.23,40362.5,92414,7799,26,56069,42206,41764,25604,16181
92998,342,2954,58814,34184,3.01219e+13,710.998,10118.9,92998,666,450,86581,80855,70195,57006,30131
1419,426,621,1100,319,1.55818e+13,68.5497,848.226,1419,169,50,798,798,633,706,512
13334,658,2396,9952,3382,6.5269e+13,497.781,4599.39,13334,610,241,10661,10405,6533,5962,4708
1983,228,484,1267,716,3.13713e+13,98.5885,838.797,1983,140,91,1499,1410,1376,1373,880
11028,679,1326,8038,2990,3.00514e+13,201.689,3129.64,11028,377,146,9702,9676,7470,7107,3904
22514,417,952,14529,7985,2.90799e+13,468.604,3137.26,22514,347,222,21118,19537,18657,17989,13645
23638,124,424,16062,7576,3.35949e+13,287.432,2513.06,23638,273,180,18095,10628,11740,11451,12542
18999,2082,3054,13647,5352,6.69324e+13,657.878,6027.91,18999,748,405,15945,15490,10955,11337,11277
73053,3633,4186,51310,21743,3.77301e+13,1210.92,13311.4,73053,1277,420,68867,68787,67199,67154,66104
24615,738,1912,17508,7107,3.1921e+13,598.904,5399.35,24615,800,164,22364,21815,20950,21222,14523
74794,12430,21840,60768,14026,2.45965e+13,6107.32,35163.4,74794,6576,25,52954,42535,47352,48716,36533
74436,2359,4215,52399,22037,5.07233e+13,1381.69,13873.2,74436,1746,523,70221,67437,55883,45328,46662
84981,3083,3940,55718,29263,3.6253e+13,1133.95,11506.6,84981,1025,427,81041,80916,78229,73459,57064
95277,1261,4137,65077,30200,4.5442e+13,1273.92,13792,95277,1596,478,89164,85786,65687,26535,25849
50525,847,2953,34656,15869,2.89036e+13,549.399,8416.71,50525,943,277,47367,46553,35218,24634,13271
32485,909,2484,21025,11460,2.78833e+13,391.806,6227.11,32485,915,185,30001,29714,26684,23815,15866
93870,188,3028,60090,33780,2.92812e+13,724.187,10019.7,93870,745,442,82230,76385,66609,5726,5380
10642,918,1185,7754,2888,3.04673e+13,190.191,2863.77,10642,373,141,9457,9457,9160,9338,6719
26272,2003,2031,18450,7822,3.48361e+13,679.273,5886.35,26272,693,178,24241,24241,24241,24241,24192
80266,3792,3895,51835,28431,2.93814e+13,638.859,11794.3,80266,1238,364,76371,76371,76371,76371,75774
4556,445,453,2664,1892,3.26953e+13,157.607,916.199,4556,105,83,4103,4103,4101,4103,4097
94919,1316,4786,63206,31713,3.25128e+13,1225.17,15155.1,94919,1384,419,89399,87481,70743,66161,33336
46510,139,2964,33317,13193,4.45904e+13,1237.59,9719.5,46510,1150,321,35226,30091,20204,14536,5147
17682,425,1540,12836,4846,3.12998e+13,326.026,4090.55,17682,386,159,16142,15843,9261,6332,2494
88677,1313,4415,58585,30092,2.90126e+13,930.792,13394.3,88677,1240,394,84058,82914,67292,57754,32284
8550,1493,1928,6136,2414,7.07117e+13,197.924,3304.63,8550,406,144,6622,6617,6472,6622,5465
23007,1338,2862,15931,7076,5.18108e+13,454.846,6191.05,23007,721,336,20145,19892,13638,7874,6666
94298,1547,4304,61578,32720,2.95595e+13,801.931,13559.6,94298,1260,415,89994,89475,75283,56804,38422
73691,3383,4111,53056,20635,5.16796e+13,1506.46,13671.6,73691,1551,545,69580,69561,66764,66384,66977
1958,20,270,1281,677,2.92517e+13,91.8534,576.107,1958,93,56,987,381,651,199,235
29157,19,1342,17099,12058,3.18841e+13,322.321,3245.37,29157,416,178,22267,19540,13315,2436,501
47475,335,1348,30627,16848,2.91759e+13,550.988,4897.89,47475,494,292,44090,40601,39280,36970,22554
42884,139,1332,27647,15237,2.9103e+13,532.862,4672.62,42884,435,289,36264,34210,29288,26475,10059
5629,186,1033,3932,1697,5.57022e+13,190.577,1911.49,5629,260,114,4505,4210,2973,1309,882
68458,254,2329,44155,24303,2.95254e+13,574.887,7766.37,68458,616,361,61411,56630,52566,46617,19211
57140,211,3406,40720,16420,3.69501e+13,972.581,10830.7,57140,1014,346,47576,42614,26923,9398,8643
50855,2402,3349,36204,14651,3.72045e+13,919.261,10204.9,50855,1029,320,47506,47472,45389,45709,42391
44385,1197,1341,28615,15770,2.96058e+13,567.016,4778.19,44385,477,296,43044,43043,42635,42574,42448
14681,900,1681,9467,5214,2.49982e+13,302.891,3594.21,14681,589,140,13000,12989,11888,12341,8012
23473,461,1002,15139,8334,2.96968e+13,474.858,3286.53,23473,348,233,22251,20660,19584,18640,14403
96678,868,3086,62012,34666,3.07286e+13,871.964,10485.3,96678,753,456,93397,92741,78003,69855,45668
36015,1765,1785,22741,13274,3.01983e+13,479.013,5180.83,36015,436,277,34230,34230,34230,34230,34195
10736,734,778,6931,3805,2.98343e+13,364.172,2069.44,10736,293,152,9958,9958,9958,9954,9954
97974,3604,4925,69906,28068,4.49252e+13,1704.83,16830.1,97974,1895,626,93049,92828,85848,81866,81248
58958,468,3107,36540,22418,3.00552e+13,576.459,8351.22,58958,889,313,55033,52601,41624,24379,20186
89247,3229,4062,60077,29170,4.17377e+13,1371.65,12723.1,89247,1377,477,85185,84809,81502,36539,53585
71730,2624,2786,44886,26844,3.06471e+13,660.404,8925.9,71730,573,423,68944,68929,68739,68767,67549
24466,69,2044,17611,6855,2.79634e+13,589.584,5367.23,24466,634,175,18032,14686,9992,4673,1858
47035,1519,2921,30757,16278,2.89188e+13,475.502,7895.1,47035,1078,235,44114,44102,42874,38372,24218
73977,1880,3275,48594,25383,3.54169e+13,863.018,9308.43,73977,685,345,70702,70148,64921,17484,23464
80861,555,4133,55748,25113,4.90534e+13,1370.45,13648.7,80861,1765,505,70776,66378,46397,21128,11571
36764,649,2451,25992,10772,2.78843e+13,593.366,6918.84,36764,838,261,33788,32532,20368,11915,4886
10668,843,1232,6523,4145,3.19007e+13,166.92,2458.2,10668,220,135,9436,9426,8018,8514,5365
81851,1662,4260,54382,27469,3.14878e+13,987.004,12799.7,81851,1318,305,77591,76729,73954,74731,36931
65377,1119,2671,40972,24405,3.03907e+13,634.578,8407.61,65377,542,422,62706,62446,52600,39962,31670
16950,813,888,10980,5970,2.98075e+13,455.927,2699.39,16950,369,184,16062,16054,15991,16031,15938
60716,22985,25574,48577,12139,125990000,1015.69,37495.3,60716,6098,11,35142,35142,34495,35142,31916
46366,699,2201,29974,16392,2.99799e+13,565.239,6631.8,46366,496,355,44104,43385,38530,37592,23014
64880,895,2598,41182,23698,2.96111e+13,585.239,8318,64880,564,413,62282,61919,53890,48011,35695
37805,459,2571,26296,11509,2.80562e+13,559.405,7142.88,37805,867,262,33900,31601,21905,11090,5809
59502,282,2031,38265,21237,2.91584e+13,554.676,6671.63,59502,527,331,53958,49855,47030,45562,21970
7975,1241,1967,5734,2241,5.64184e+13,211.934,3274.08,7975,504,220,6008,6008,4425,4525,4190
57659,516,3482,38392,19267,4.00512e+13,775.113,9346.14,57659,964,411,52873,49502,39261,7542,6718
94564,3767,4377,67602,26962,4.61103e+13,1671.78,16072.9,94564,1842,581,90187,90028,89508,83634,85124
94393,64,4381,66719,27674,4.67149e+13,1569.8,15927.3,94393,1820,570,63219,44575,33112,12620,2760
49813,1085,3167,35329,14484,3.40618e+13,910.837,9762.3,49813,997,284,46204,44295,41173,40659,22060
46484,304,1971,29900,16584,2.8829e+13,549.038,6210.53,46484,555,310,42261,39146,36598,33263,18945
89029,44,2899,56315,32714,3.01468e+13,694.595,9859.48,89029,618,456,61260,41631,43276,27450,5057
16055,1189,2023,10800,5255,4.02327e+13,741.212,4700.36,16055,675,194,14032,13491,13121,12680,8123
26593,866,1082,17159,9434,2.97793e+13,477.148,3534.75,26593,360,235,25511,25502,24894,24955,24501
21802,2398,2870,15171,6631,5.30864e+13,439.353,6070.58,21802,740,334,18932,18930,18358,12700,12656
5492,438,505,3550,1942,3.03906e+13,234.92,1263.5,5492,177,123,4987,4940,4923,4925,4823
21246,843,1914,15121,6125,3.55155e+13,552.48,5161.49,21246,665,152,19133,18672,18126,17933,15297
92721,2889,3125,59752,32969,3.1397e+13,882.761,10311.1,92721,766,447,89596,89578,89136,89191,87634
14319,5585,7013,11456,2863,107016000,140.015,9655.44,14319,1443,11,7306,7153,6991,7306,5729
92330,2309,4166,63137,29193,4.56762e+13,1318.25,13736,92330,1569,475,88164,84977,72035,36529,47187
55401,641,3017,36982,18419,2.92365e+13,569.604,8736.45,55401,1057,266,51774,50448,36987,25495,17541
5637,402,706,3689,1948,3.1282e+13,182.882,1454.74,5637,194,101,4931,4801,4660,4586,3779
25681,687,1059,16611,9070,2.94943e+13,518.33,3475.13,25681,397,238,24622,24436,23073,22203,21764
73204,3697,3923,52376,20828,4.83136e+13,1689.26,13439.8,73204,1499,485,69281,69230,68969,68969,68594
82332,2941,4347,56120,26212,3.50046e+13,1119.94,13709.1,82332,1244,404,77985,77577,74608,73688,66912
26430,81,1431,17084,9346,3.00211e+13,523.14,4147.44,26430,426,265,20933,16225,16129,14545,2595
46589,6933,19923,37274,9315,131381000,934.035,29019.2,46589,4681,11,26666,26666,21447,26666,8476
74346,1819,4000,51515,22831,4.88614e+13,1267.52,12533.4,74346,1512,466,69644,65994,51945,30876,32399
39259,277,2692,24570,14689,2.89173e+13,339.696,6408.25,39259,979,174,35157,32738,23091,14339,12094
49041,2948,3651,35267,13774,6.16081e+13,1578.49,10545.5,49041,1436,480,45390,45348,41421,42373,42491
60500,3669,3865,42218,18282,5.26129e+13,1165.37,11198.3,60500,1351,464,56635,56633,56112,54513,51330
71231,592,4164,49768,21463,5.17061e+13,1399.27,13292.5,71231,1741,512,61479,58073,39422,21901,12366
35841,2137,3598,25048,10793,5.5796e+13,691.591,8302.54,35841,952,417,32243,31521,25323,14949,17670
18382,1875,2490,13141,5241,5.93748e+13,770.401,5442.92,18382,745,208,15892,15229,14092,14311,13500
23246,603,1066,14958,8288,2.93441e+13,454.625,3334.32,23246,363,219,22179,21708,20904,20288,19671
41619,65,2639,25191,16428,3.17046e+13,456.924,6116.48,41619,604,268,33463,28844,23223,8550,2805
13349,241,1091,9717,3632,3.0324e+13,203.661,3054.98,13349,312,151,12256,11238,7470,5969,2540
33551,2057,2180,24230,9321,2.98345e+13,560.123,6331.51,33551,592,218,31371,31371,31370,31370,31339
23896,760,1612,15142,8754,3.02684e+13,472.647,4243.8,23896,389,251,22284,21995,19803,16508,14368
46345,558,2265,29134,17211,3.05164e+13,522.894,6457.64,46345,515,341,43715,42807,34374,26101,11869
64742,974,4005,46608,18134,5.43e+13,1454.83,12661.9,64742,1519,531,57299,53561,38988,34838,24444
37738,161,1261,24403,13335,2.97525e+13,512.996,4374.36,37738,413,274,32176,30166,26407,22720,10608
12249,951,1324,8948,3301,2.76652e+13,245.343,3314.4,12249,380,152,10925,10902,10234,10276,7528
43731,1719,1912,28140,15591,2.93822e+13,553.181,6080.55,43731,529,334,41819,41819,41483,41341,41393
83906,827,4351,58212,25694,3.69008e+13,1316.71,14343.1,83906,1415,419,76488,73582,52420,34905,17627
11582,251,680,6750,4832,3.13821e+13,240.865,1646.75,11582,174,117,10835,10429,8242,6590,4751
33303,675,2525,21068,12235,2.81591e+13,328.49,5959.16,33303,885,174,30778,30520,25025,23033,17096
20203,1052,1490,14515,5688,2.72027e+13,643.445,4483.91,20203,740,183,18713,18189,18061,18243,15909
62062,2017,2054,39977,22085,2.91124e+13,588.788,6474.61,62062,601,338,60008,60008,60004,60002,59961
40816,942,4093,34705,6111,4.21387e+13,17.0337,4869.94,40816,2049,2044,36723,36723,17848,28854,26634
75327,2669,3950,54404,20923,5.05836e+13,1702.72,13697.2,75327,1501,560,71352,70582,57948,61026,57979
38472,1985,3337,26113,12359,4.7116e+13,693.503,8101.9,38472,939,403,35135,34423,27199,12144,15267
59011,395,2451,37699,21312,2.96856e+13,572.054,7788.14,59011,590,389,54966,51242,46218,40558,21725
57777,371,2101,37281,20496,2.95736e+13,558.949,6996.76,57777,523,370,53775,49642,45756,44499,20294
49886,764,2999,32948,16938,2.89633e+13,491.701,8268.36,49886,1070,256,46614,45999,36429,27231,18589
21073,354,1454,13553,7520,2.93515e+13,409.858,3888.36,21073,354,232,19137,17843,16737,16350,10034
43086,302,3509,30884,12202,5.85151e+13,1592.75,9763.9,43086,1422,310,33069,29824,17790,15550,4401
74386,3385,3444,48998,25388,3.6057e+13,992.909,9894.25,74386,876,357,70942,70941,70938,70940,70751
61426,282,2126,39591,21835,2.92396e+13,549.094,7184.57,61426,526,355,55851,51521,47973,45479,16925
69951,1303,2712,43683,26268,3.06053e+13,637.625,8604.91,69951,624,415,67239,67000,58277,42801,41645
33005,1507,2019,21907,11098,4.1258e+13,472.504,5324.95,33005,448,274,30986,30986,29667,28733,24645
17073,1087,1902,11879,5194,3.65765e+13,492.468,4624.7,17073,578,144,15171,14634,14472,14200,11824
84126,309,4245,58532,25594,4.79972e+13,1362.38,14374.1,84126,1779,528,70274,63294,45901,22102,9812
66553,1923,2109,42889,23664,2.95795e+13,571.582,7111.08,66553,547,341,64444,64442,64144,64049,62853
78242,1567,3684,52835,25407,4.24494e+13,1152.54,11443.5,78242,1254,438,73955,71880,56874,19210,25917
58417,1460,3443,42042,16375,4.79597e+13,1431.19,11461.3,58417,1264,361,53832,50474,43266,40742,32875
90890,1957,4278,63883,27007,4.70517e+13,1345.06,15326.8,90890,1750,546,85999,81845,67866,53170,49610
12189,2293,4923,9896,2293,1.69094e+12,85.6929,5543.78,12189,538,90,7266,7266,3603,6864,3912
40173,1575,1882,25918,14255,2.95814e+13,531.571,5789.14,40173,476,329,38291,38284,37815,37519,37160
7307,167,554,4260,3047,3.12236e+13,200.168,1236.72,7307,126,102,6600,5967,5074,4157,2534
91846,1183,3722,60482,31364,3.57484e+13,1171.85,11751.4,91846,983,379,87738,86829,70889,12159,15972
76359,11285,30006,61959,14400,1.70412e+12,101.586,31725.1,76359,1659,157,46353,46346,18710,23764,20450
42487,1460,3626,29758,12729,5.22692e+13,1009.05,9288.77,42487,1178,418,38351,36673,25688,15184,15154
88113,2293,2779,57174,30939,3.15352e+13,772.124,9332.81,88113,718,387,85334,85157,84263,82634,75030
35708,852,2854,25238,10470,4.73872e+13,1196.23,8376.67,35708,1113,303,31309,29458,23778,21915,14705
9837,312,802,6305,3532,2.93435e+13,388.418,2041.09,9837,286,161,8785,8259,7732,7484,4646
39930,1712,1751,25751,14179,2.97332e+13,494.326,5446.16,39930,433,297,38179,38179,38172,38107,38033
77420,779,2655,49940,27480,3.00941e+13,652.487,8507.51,77420,664,363,74765,74230,63656,61178,35409
74540,486,2722,47866,26674,2.97837e+13,615.474,8788.64,74540,674,407,70826,66479,58810,55603,30346
63832,1587,3562,45586,18246,3.87628e+13,1107.16,11830.6,63832,1185,369,60000,58156,53583,52610,40624
96520,2814,3974,65699,30821,4.41567e+13,1331.44,13526.8,96520,1453,476,92546,92161,84097,39752,56835
62773,2328,3707,40799,21974,2.95412e+13,603.001,10195,62773,1214,299,59066,58960,58420,58737,37517
1523,21,257,885,638,3.10302e+13,49.1589,427.877,1523,44,44,1174,1055,737,437,207
31579,1232,1681,20388,11191,3.00109e+13,474.178,4887.78,31579,425,277,29898,29888,29448,28988,25851
53145,1824,2086,34569,18576,3.27361e+13,559.349,6188.41,53145,564,308,51059,51059,50675,50806,49536
19576,662,2790,14102,5474,6.28047e+13,889.246,5847.67,19576,859,241,16017,15232,9402,8575,6116
4454,486,873,3089,1365,5.46928e+13,107.669,1560.36,4454,173,111,3581,3557,3218,1782,1741
95299,1885,4089,63473,31826,3.97379e+13,1296.83,12840.5,95299,1102,444,91131,89196,74814,19306,34051
88122,1640,3931,58028,30094,3.64636e+13,1088.57,11723.5,88122,1041,431,84191,82804,68755,13889,20663
26028,966,1550,16786,9242,2.94416e+13,522.61,4380.66,26028,405,259,24478,24383,23145,21782,16072
37367,1130,1249,24043,13324,2.95281e+13,540.895,4349.56,37367,468,274,36118,36118,35912,35927,35686
1412,214,273,943,469,2.85037e+13,81.7571,503.206,1412,80,48,1139,1137,1139,1139,1139
56130,2021,3718,38761,17369,4.95664e+13,1104.95,10455.1,56130,1270,460,52319,49988,40014,22157,28269
9358,1146,1147,6618,2740,3.31356e+13,400.061,2747.12,9358,483,111,8211,8211,8210,8211,8211
11883,695,781,7713,4170,3.07326e+13,359.5,2191.96,11883,244,165,11102,11087,11099,11094,11026
82023,1058,4379,56389,25634,3.66662e+13,1210.76,14036.3,82023,1270,419,76116,73111,57018,46014,21876
89346,2248,4226,61322,28024,4.77499e+13,1393.77,14185.3,89346,1813,520,85031,81272,68201,39240,45491
83600,3377,3983,60259,23341,4.68026e+13,1730.47,14506.6,83600,1633,546,79617,79246,77064,75287,75511
90581,2333,3961,61929,28652,4.53642e+13,1300.03,13141.7,90581,1436,474,86620,83368,72333,33827,46661
26834,1210,1528,17282,9552,2.92338e+13,449.968,4467.21,26834,393,269,25306,25289,24822,24438,21829
43887,2264,2966,31722,12165,5.34185e+13,1328.41,9529.72,43887,1166,339,40921,39100,33017,34451,34552
16550,517,1629,11124,5426,4.58162e+13,362.071,3684.09,16550,352,194,14907,14163,12054,3611,3272
31478,1497,1570,20264,11214,2.8784e+13,499.924,4538.46,31478,428,249,29908,29906,29895,29892,29806
74949,2624,3953,49681,25268,2.90427e+13,815.291,11412.2,74949,1219,292,70996,70693,70241,70560,54469
63883,16483,19396,52302,11581,2.39292e+13,4776.53,30662.9,63883,5861,21,44487,44487,44220,44220,39420
32261,470,3284,23623,8638,6.85358e+13,1271.84,8054.18,32261,1037,429,26112,24475,12816,10221,7851
46891,416,2870,28538,18353,3.12013e+13,555.81,6860.49,46891,618,311,43497,42070,31050,15298,9970
72835,39,3812,47562,25273,2.95514e+13,637.578,11264,72835,1226,346,46225,32297,25714,6387,2030
34455,615,2309,24223,10232,3.55263e+13,750.861,7268.79,34455,771,211,30928,29637,27349,26878,15441
77501,240,4219,54543,22958,5.00976e+13,1345.43,14060.9,77501,1753,527,62699,55947,38091,23068,8465
57498,509,599,39038,18460,3.36122e+13,300.224,4040.63,57498,303,250,56899,56899,54962,55147,54612
32644,894,2424,20257,12387,2.86437e+13,317.868,5559.99,32644,860,158,30220,30191,28864,27622,21567
40076,1525,1737,25812,14264,2.91648e+13,503.946,5424.26,40076,456,289,38339,38337,38066,37947,36522
51635,828,3199,36701,14934,3.3795e+13,899.443,9964.11,51635,1002,298,47487,45623,36614,38436,17699
47409,2543,2948,33499,13910,3.39633e+13,831.191,9272.54,47409,979,242,44461,44461,44449,44439,41814
37727,1174,3574,26705,11022,5.59399e+13,1111.54,9018.5,37727,1152,414,33265,31520,21106,14002,13436
42106,459,1564,27371,14735,3.20301e+13,563.63,5026.51,42106,469,295,39693,36541,33257,13826,6723
74030,581,3945,48086,25944,2.9473e+13,645.138,11500.1,74030,1242,371,69155,66289,47361,28500,10646
33933,120,1895,20239,13694,3.14035e+13,352.034,4614.27,33933,427,231,29813,26940,20597,5880,2893
21312,63,979,12449,8863,3.20768e+13,290.179,2474.22,21312,306,143,18000,16480,11825,3960,2522
50745,2805,2841,31069,19676,3.13362e+13,569.999,7100.79,50745,625,319,47904,47904,47904,47904,47904
67692,534,2293,43638,24054,2.96933e+13,607.945,7707.42,67692,592,363,64825,61457,55250,53127,28051
97661,2774,3653,61362,36299,2.99725e+13,1000.2,11351.9,97661,714,461,94008,93684,92639,93116,89170
71493,1487,2373,46149,25344,2.96579e+13,569.561,7925.09,71493,618,358,69120,69116,66965,65890,57305
83120,2536,2910,52076,31044,3.06711e+13,685.763,9662.13,83120,620,454,80210,80125,77638,78636,75322
63150,504,3093,41502,21648,2.95961e+13,634.682,9199.57,63150,1155,266,58776,56138,40672,24871,22224
66692,2008,2390,42835,23857,2.93555e+13,604.551,7283.16,66692,578,347,64302,64277,64066,63968,61860
99690,1743,4797,70963,28727,4.45038e+13,1710.65,16978.4,99690,1925,606,93463,88865,74195,66581,44123
82719,2495,4010,55307,27412,3.15022e+13,991.404,12925.5,82719,1251,310,78709,78359,77819,76453,60829
53232,2033,4003,38009,15223,6.06729e+13,1534.21,11392.6,53232,1565,492,49043,45217,33826,33866,34189
73492,2580,3697,52716,20776,4.54555e+13,1528.66,13207,73492,1491,386,69789,69020,60753,62725,55354
30852,243,3282,21253,9599,5.21519e+13,667.9,7502.8,30852,924,411,25176,22656,15740,5291,3562
62613,3718,4072,43871,18742,5.22434e+13,1284.01,11929.6,62613,1509,458,58541,58536,57831,55319,50160
66753,1103,2652,41612,25141,3.00374e+13,628.261,8375.09,66753,498,415,64101,63803,54016,38942,31173
1988,210,282,1301,687,2.6899e+13,87.3471,581.511,1988,90,56,1706,1704,1700,1692,1616
30495,478,2476,19287,11208,2.82051e+13,325.025,5734.23,30495,856,168,27639,25890,20513,18007,13054
1638,431,929,1107,531,2.6067e+13,66.9475,1135.46,1638,168,79,709,663,486,528,354
36344,1429,2946,25998,10346,5.10948e+13,1362.82,8655.88,36344,1145,319,32674,30404,25540,24129,19804
23223,2036,2516,16120,7103,3.95254e+13,809.058,6323,23223,810,246,20707,20636,20079,20302,19222
74206,878,3921,48160,26046,2.95604e+13,656.349,11530.2,74206,1242,376,70047,69109,52364,33064,19565
51974,1917,2100,33394,18580,2.84961e+13,253.62,6038.12,51974,513,262,49874,49874,49865,49874,49671
37224,2052,3605,26400,10824,5.56288e+13,1026.86,8842.07,37224,1098,415,33619,31790,25535,18582,20177
11290,747,810,7243,4047,3.00918e+13,395.548,2200.22,11290,295,161,10480,10473,10413,10435,10327
66893,1436,3846,45863,21030,4.69034e+13,1123.02,11243.9,66893,1394,465,62330,59974,46300,19394,23465
31632,2157,3570,22662,8970,5.86291e+13,1027.81,8299.59,31632,1013,416,28062,26566,21271,16912,17551
12325,5421,6172,9860,2465,124256000,3.39221,8422.5,12325,1244,11,6153,6153,6005,6153,5408
5251,852,1240,3534,1717,6.04123e+13,251.818,2078.93,5251,409,65,4011,3970,3646,3882,2786
75902,3856,3949,49718,26184,2.96316e+13,682.753,11748,75902,1232,377,71953,71953,71953,71953,71122
55691,3407,4071,39730,15961,5.79842e+13,1519.8,11885,55691,1623,501,51620,51558,49822,46796,47092
95314,4078,4111,64579,30735,4.35501e+13,1371.52,13259.3,95314,1412,473,91203,91203,91201,91201,91155
94796,1935,3359,61394,33402,3.2043e+13,858.967,10625.7,94796,752,429,91437,91085,86080,81433,69335
39977,744,1760,25841,14136,2.98529e+13,496.229,5546.67,39977,481,315,38217,38017,34400,34772,26565
63655,715,3873,44374,19281,3.18595e+13,1030.21,11684,63655,1078,350,57933,55388,37554,23697,8719
38649,568,3014,25904,12745,4.13359e+13,602.616,7140.93,38649,790,318,35370,33703,25493,3944,2778
37580,728,1881,23425,14155,3.04066e+13,426.952,5318.97,37580,419,277,35699,35240,29894,22121,21709
23992,959,1054,15480,8512,2.99166e+13,481.37,3360.7,23992,353,235,22938,22938,22792,22775,22671
3561,1240,1292,2333,1228,5.77799e+13,102.519,1882.01,3561,354,123,2269,2269,2269,2269,2216
74969,999,3614,49316,25653,3.68989e+13,845.794,10101.9,74969,978,379,71177,70292,56724,10014,8595
39913,2447,15743,31984,7929,2.79799e+13,5628.92,22792.4,39913,4035,20,18645,13608,14852,8275,6195
66441,2557,2629,41963,24478,3.0845e+13,609.15,8375.58,66441,563,399,63812,63795,63786,63812,63407
63247,3495,3936,44228,19019,5.21124e+13,1249.11,11598.3,63247,1395,465,59311,59183,58086,51235,45341
99504,1234,4853,66721,32783,3.39593e+13,1242.12,15814.3,99504,1398,476,93704,91379,70699,63227,29955
11492,3786,4095,9363,2129,1.72191e+13,121.64,5147.22,11492,363,107,7397,7397,7081,7324,7231
73368,2843,3758,52794,20574,4.41302e+13,1511.36,13201.8,73368,1387,398,69610,69274,61305,63684,61660
77827,2759,4341,53622,24205,3.57878e+13,1133.48,13542.5,77827,1172,411,73486,73121,69363,68474,58327
29037,277,1075,18674,10363,2.92989e+13,518.19,3714.35,29037,383,259,26230,24218,23108,22071,8224
6003,736,1708,4660,1343,5.68278e+13,147.457,2665.01,6003,379,133,4295,4291,2322,2359,1576
97418,1196,2963,61918,35500,2.97862e+13,726.324,10268.7,97418,703,452,94455,94165,83347,74276,62564
53319,98,2245,34708,18611,3.44608e+13,565.42,6512.89,53319,579,311,43208,36718,30249,3506,1683
83137,2280,4395,59275,23862,4.88025e+13,1642.11,15071.1,83137,1777,566,78331,75129,62418,57014,50632
42310,413,1294,27267,15043,2.93446e+13,570.126,4618.99,42310,467,277,39811,36852,34797,33280,19586
68466,1450,2722,42746,25720,3.03569e+13,628.401,8564.9,68466,569,430,65744,65507,57984,43544,45032
93052,2120,4814,62469,30583,3.42223e+13,1255.3,15075.9,93052,1387,406,88238,87157,82411,82675,43558
85899,729,4016,55977,29922,2.96117e+13,702.784,12455.5,85899,1256,392,81246,79879,59590,39088,26391
92182,329,3261,59944,32238,3.27949e+13,853.34,10357.4,92182,705,415,84098,77141,69179,8198,5633
63488,839,3128,42207,21281,2.96679e+13,658.861,9348.32,63488,1151,273,59955,59136,46794,34314,25311
92996,1886,3556,58293,34703,3.02819e+13,929.467,10972.3,92996,664,474,89440,88921,80740,65058,68650
70523,3083,3792,46062,24461,2.95504e+13,642.622,11044.4,70523,1227,344,66731,66728,66723,66563,60320
76779,3978,4254,53276,23503,3.67776e+13,1202.6,13537.1,76779,1241,418,72525,72510,72457,71679,71550
68086,1907,2771,42321,25765,3.04779e+13,642.034,8575.93,68086,512,412,65315,65156,58888,57430,46935
42911,2429,3527,30722,12189,5.8065e+13,1596.94,9771.69,42911,1424,329,39384,37480,34954,35193,34597
92614,236,4499,61339,31275,3.00788e+13,1007.71,14115.2,92614,1276,407,81657,74579,52529,18729,7529
43984,722,1274,28373,15611,2.89765e+13,542.914,4640.38,43984,436,284,42710,42546,39396,39624,37128
92287,3868,3920,62587,29700,4.44157e+13,1232.67,12772.3,92287,1446,477,88367,88367,88307,87859,88081
97883,1198,3039,61949,35934,2.99286e+13,731.352,10450.6,97883,672,451,94844,94450,82657,70503,60228
82765,2790,3863,55077,27688,3.94323e+13,1187.45,11237.7,82765,1065,428,78902,78463,71495,22916,37173
72678,2423,3741,49320,23358,4.38229e+13,1141.32,11387.6,72678,1302,463,68937,67351,59043,25481,38404
28558,349,2990,20853,7705,6.2694e+13,1319.21,7413.72,28558,992,263,22490,20487,10422,8793,3925
70877,1655,2894,46199,24678,3.36641e+13,613.255,8488.01,70877,593,348,67983,67867,63603,61420,50938
89870,1637,4471,61102,28768,3.64639e+13,1228.57,14565.8,89870,1309,423,85016,82803,75395,65047,37594
79133,1071,3987,52561,26572,3.10773e+13,917.979,12144.7,79133,1313,295,74612,72616,60289,50965,30998
54168,3167,3470,34544,19624,2.91788e+13,483.016,9042.97,54168,1201,211,50698,50698,50698,50698,47705
95668,3335,4894,64110,31558,3.44e+13,1283.37,15394.6,95668,1401,411,90774,90328,87866,88747,74067
15054,1246,1466,10858,4196,3.04601e+13,243.669,3739.02,15054,382,154,13588,13572,13320,13484,11312
85153,1353,3946,55699,29454,2.98071e+13,725.986,12389.6,85153,1256,390,81207,80526,66825,59489,35963
26316,1458,2579,19389,6927,6.24472e+13,1243.84,6718.31,26316,881,265,23107,21644,14849,16028,14131
61606,3185,3752,42757,18849,3.18037e+13,918.342,11236.2,61606,1025,302,57854,57755,57854,57854,54445
50778,773,3487,31937,18841,2.98984e+13,450.269,8687.57,50778,1115,252,47291,46837,34312,19585,10794
36702,246,1191,23660,13042,2.91425e+13,526.995,4216.54,36702,421,259,32993,30535,28582,28071,15770
54751,2631,3440,39220,15531,5.02059e+13,1331.59,11095.6,54751,1312,355,51311,50890,48252,48327,47378
87670,510,4417,59488,28182,3.61927e+13,1224.63,14345.3,87670,1315,411,78620,74197,51219,29533,20694
99812,2863,4264,68806,31006,4.53034e+13,1339.73,15331.3,99812,1807,541,95548,95195,86747,54626,64795
48078,2285,2314,30742,17336,2.95196e+13,575.706,6979.06,48078,530,359,45764,45764,45763,45764,45697
96673,456,4828,69010,27663,4.53637e+13,1746.78,16610,96673,1810,623,82574,77034,45019,21937,7750
39867,1107,2912,28302,11565,4.57704e+13,1182.52,8913.75,39867,1116,316,35862,33777,29135,26712,20799
72757,2766,3630,48400,24357,3.94076e+13,873.029,10222.7,72757,1003,421,69127,69098,64384,22468,28333
75872,247,2715,47478,28394,3.00126e+13,650.576,9011.55,75872,593,431,69184,64576,53609,35754,16552
48944,223,3022,32078,16866,2.90538e+13,482.659,8181.36,48944,1085,247,42829,38813,26564,11576,7801
28478,480,2742,20848,7630,6.20606e+13,1272.79,7141.97,28478,897,276,23078,21669,11841,11289,5362
93396,2870,4417,64683,28713,3.94323e+13,1334.25,15212.3,93396,1449,442,88979,88548,80618,79033,69472
54338,1775,2266,35462,18876,3.44363e+13,535.663,6548.02,54338,528,312,52072,52067,50787,50759,46737
85904,807,4268,61421,24483,4.20228e+13,1630.6,14821.9,85904,1646,435,76917,73194,46058,31151,10846
21581,892,1515,15471,6110,2.77426e+13,632.032,4641.12,21581,715,185,19954,19479,17756,18647,15133
87259,2717,3535,54741,32518,2.95313e+13,921.336,10962.1,87259,741,438,83724,83505,83603,83624,80656
8154,1166,7324,6242,1912,3.56858e+13,0.732892,7565.58,8154,1043,12,830,830,0,825,0
96118,2941,4186,61446,34672,2.96701e+13,883.723,13457.8,96118,1238,452,91932,91735,91876,91871,78665
53252,1338,2989,34840,18412,2.92189e+13,531.116,8408.29,53252,1115,253,50263,50036,46541,41617,26614
23523,183,1573,15163,8360,2.97894e+13,475.896,4339.13,23523,395,267,20143,18684,16065,13043,2282
46341,398,1924,29885,16456,2.91306e+13,532.534,6166.34,46341,526,316,43215,40146,37146,35645,21798
21634,409,1109,13954,7680,2.9274e+13,476.55,3243.75,21634,355,219,20038,18610,17532,17026,11784
10631,587,627,6216,4415,3.25226e+13,217.568,1490.43,10631,182,109,10004,10003,9988,9985,9851
28187,499,1602,18137,10050,2.96381e+13,438.294,4629.91,28187,398,278,26488,25186,22802,22747,14547
5226,472,1428,3502,1724,5.90856e+13,202.413,2255.17,5226,419,98,3798,3456,3108,3262,1024
12141,2484,2631,9029,3112,6.5978e+13,521.871,4616.54,12141,621,166,9510,9412,9510,9510,9234
34391,1189,2389,24418,9973,2.76393e+13,603.208,6673.56,34391,824,251,32002,31529,27298,25035,17437
16424,341,1119,9620,6804,3.16855e+13,261.473,2415.14,16424,293,144,15304,14981,12143,10626,8731
11124,1364,2170,7975,3149,6.08913e+13,294.796,3916.93,11124,514,306,8954,8953,5701,6469,5100
57349,1913,3751,41259,16090,5.57648e+13,1489.52,11676.3,57349,1459,509,53185,49391,39107,40049,34514
64402,1381,2280,41544,22858,2.96783e+13,598.185,7506.38,64402,609,350,62122,62120,59877,58765,50294
56981,1796,2629,37758,19223,3.73582e+13,733.44,7248.93,56981,661,316,54352,53987,50109,12721,17690
2324,249,482,1556,768,4.69408e+13,148.934,911.939,2324,158,55,1842,1658,1534,1697,1146
6072,260,1442,4444,1628,7.65544e+13,178.312,2496.09,6072,279,136,4617,4307,2653,2730,1447
13592,103,994,8813,4779,3.05245e+13,394.551,2622.72,13592,303,166,11099,9799,8724,7737,3470
65409,826,3709,44281,21128,3.00605e+13,799.843,10824.9,65409,1074,281,60942,59579,46812,31269,19646
9318,334,1583,6280,3038,5.37593e+13,375.658,3211.38,9318,612,118,7375,6746,6314,6341,2332
33716,927,3560,24745,8971,6.86169e+13,1295.36,8523.47,33716,1103,452,28362,26726,16782,14333,14737
19786,826,2566,14111,5675,6.06527e+13,744.867,5893.74,19786,808,226,16692,16150,11263,10517,8447
44296,679,2713,30622,13674,2.86598e+13,557.496,7739.7,44296,908,269,41112,39933,27607,17608,9911
86595,349,2935,54853,31742,3.03084e+13,691.468,9829.41,86595,661,445,80343,75062,65456,53360,28559
1776,136,453,1190,586,3.43939e+13,76.8542,771.362,1776,118,60,1323,1263,1097,1042,835
57274,1182,1805,37109,20165,3.10421e+13,608.452,5960.79,57274,583,330,55469,55418,52368,52320,47627
9881,881,1087,7087,2794,2.862e+13,351.638,2814.46,9881,428,116,8794,8794,8682,8781,7530
66428,1414,4168,46551,19877,5.36246e+13,1417.29,12900.9,66428,1753,508,60613,56715,42239,30470,26407
90709,2772,3978,60701,30008,3.97306e+13,1328.1,12679.8,90709,1234,437,86731,86183,79101,28502,46098
56862,320,2087,36729,20133,2.95992e+13,540.406,6513.91,56862,554,327,52099,47736,45423,43324,20293
66770,729,2195,43047,23723,2.94623e+13,556.256,7588.07,66770,585,374,64561,63925,56368,56379,38947
17911,258,1405,11505,6406,2.97328e+13,373.065,3595.57,17911,349,240,15862,14699,13163,12049,3389
51902,263,2200,34018,17884,3.55995e+13,534.988,6391.76,51902,499,303,46346,42658,37790,5502,4000
61506,593,3790,42745,18761,5.10249e+13,1110.63,11042.7,61506,1335,462,54899,53056,36804,13460,12471
44718,1827,2172,27328,17390,3.16033e+13,488.524,6011.95,44718,457,307,42546,42493,40894,41531,38991
1514,175,242,883,631,3.34434e+13,57.247,419.835,1514,53,46,1272,1225,1206,1242,1041
27399,664,1095,17705,9694,2.99563e+13,503.235,3623.25,27399,430,239,26304,26034,24444,23830,22947
32139,1815,2977,23307,8832,6.0815e+13,1381.93,7759.44,32139,1075,270,28873,26404,22432,23624,22415
60657,3073,3589,43588,17069,4.93388e+13,1423.88,11800.7,60657,1453,370,57068,57065,56718,56616,55845
66959,1690,3707,44886,22073,4.20713e+13,910.205,10222.2,66959,1056,428,63252,62042,50881,15220,18709
78655,803,4164,54596,24059,4.98602e+13,1386.69,13651.4,78655,1748,509,70269,67280,47373,24718,16514
94426,133,3666,61888,32538,3.44301e+13,1170.82,11433.1,94426,842,391,78142,71950,59236,6066,3548
74172,223,2757,46391,27781,3.06489e+13,650.151,8929.1,74172,587,423,67133,62265,51426,32551,14016
46121,2291,2980,33267,12854,5.05028e+13,1295,9762.85,46121,1166,344,43141,41525,36284,37546,37551
9983,128,792,6463,3520,2.9718e+13,385.563,2065.13,9983,293,158,8232,7739,6607,5766,3128
63999,1842,3839,44560,19439,5.1531e+13,1231.34,11596,63999,1352,468,59610,56549,45011,26000,29281
34086,1549,3613,24304,9782,5.85787e+13,1067.82,8602.49,34086,1145,410,30062,28408,19376,15980,15800
97847,2528,4874,65199,32648,3.23712e+13,1236.1,15534.8,97847,1404,441,92973,92234,90069,91020,53586
86691,2056,2915,55578,31113,2.95109e+13,673.005,9623.2,86691,684,424,83776,83694,80824,77150,76192
93997,4162,4296,65799,28198,4.66683e+13,1319.84,15404.5,93997,1816,547,89701,89686,89362,87998,87129
92635,1535,2925,59103,33532,3.01046e+13,719.65,10003.6,92635,696,442,89710,89488,82651,74081,65301
86734,1339,4395,60443,26291,3.85873e+13,1333.7,14693.1,86734,1420,438,80950,77820,64307,54530,23762
45733,3269,3787,32955,12778,5.9779e+13,1435.89,10293.5,45733,1329,449,41946,41874,41322,36136,36778
61237,3129,3678,41797,19440,4.52786e+13,1040.88,10543.3,61237,1208,440,57559,57415,55313,29456,35333
63540,3317,3665,43348,20192,4.4714e+13,1089.42,10617.8,63540,1167,427,59875,59686,58357,55364,46599
73994,3244,4137,52054,21940,3.75227e+13,1239.29,13377.4,73994,1341,413,69857,69712,66135,66872,61814
79352,643,4134,55051,24301,4.93605e+13,1405.29,13724.1,79352,1723,529,69861,67048,46221,22023,12517
40247,457,2894,28691,11556,4.43639e+13,1038.9,8900.19,40247,960,328,34428,32880,25425,24735,12665
96350,3160,4365,67763,28587,4.64713e+13,1409.67,15769.8,96350,1802,559,91985,91749,85509,67192,73187
70876,1953,3638,51092,19784,4.24494e+13,1261.89,12729.8,70876,1339,391,66948,64797,58311,56328,47665
76374,1267,2561,49299,27075,2.9913e+13,607.193,8221.99,76374,617,369,73813,73761,69218,68199,58868
81168,3495,3969,58451,22717,4.8371e+13,1748.51,14306.5,81168,1624,542,77199,76829,75250,74854,74647
68647,572,3588,49165,19482,3.83731e+13,1225.99,12337.7,68647,1320,375,60599,56613,38918,26508,24369
13518,307,844,8698,4820,2.97549e+13,428.698,2428.2,13518,345,189,12136,11189,10736,10340,5369
75387,1423,3753,54128,21259,4.47444e+13,1529.96,13450.7,75387,1519,400,70075,66116,57246,56355,36475
40991,1574,2626,28758,12233,2.84075e+13,584.236,7427.68,40991,864,265,38365,38350,36956,35907,26410
51554,872,2426,32560,18994,3.01097e+13,576.098,7322.34,51554,535,373,49097,48506,41224,34269,22631
27792,1025,1505,17992,9800,2.96894e+13,436.705,4480.43,27792,393,272,26287,26250,25634,25012,20598
87239,1852,4244,62671,24568,4.39452e+13,1728.83,15001.5,87239,1635,531,81969,77880,67816,65481,46938
82291,1725,2893,51260,31031,3.01298e+13,670.196,9548.44,82291,548,453,79398,79133,70583,55004,56687
90150,5497,9025,76641,13509,4.21752e+13,18.0114,10187.1,90150,4515,4510,81125,81125,59987,72311,70560
41328,734,1698,26678,14650,2.9773e+13,533.7,5145.8,41328,479,283,39630,39426,36077,35261,32829
95171,107,4059,60146,35025,2.96672e+13,877.044,12474.2,95171,1038,456,78066,68230,56080,33507,8630
96514,3054,4030,61020,35494,2.93259e+13,903.164,12467.2,96514,1051,462,92484,92256,92445,92476,86496
83942,1191,3893,57706,26236,4.68381e+13,1290.2,12858.7,83942,1447,474,78059,74898,55646,23070,23340
3740,40,599,2768,972,2.18747e+13,131.058,1292.4,3740,269,93,1835,730,883,445,419
4421,701,1072,2901,1520,4.01861e+13,112.343,1760.94,4421,270,99,3349,3343,3341,3331,2191
52521,1349,3404,37520,15001,4.1994e+13,1080.72,10655.8,52521,1074,347,48491,46421,41001,40359,27309
62003,1021,2150,39979,22024,2.92535e+13,555.631,7260.73,62003,540,368,59853,59796,55437,54962,42024
74798,967,4183,52255,22543,5.05878e+13,1403.67,13547.8,74798,1740,527,67181,63554,45662,27574,19893
82130,923,4454,54446,27684,2.89935e+13,863.808,12865.4,82130,1246,355,77150,75530,53891,39952,15179
92912,7448,30673,73935,18977,1.91139e+13,290.898,36988.5,92912,2391,196,62239,62024,29554,26359,27438
26779,755,1678,19324,7455,3.0528e+13,516.461,5236.81,26779,518,204,24985,24583,20387,20845,11833
15475,2864,8480,13558,1917,8.60887e+11,14.7418,8734.46,15475,880,47,6995,6995,3000,4422,2624
39484,3235,3449,28601,10883,5.9857e+13,1461.2,9052.18,39484,1172,363,36035,36035,35660,35819,35479
67748,752,4134,48745,19003,5.31229e+13,1429.49,13177.3,67748,1577,541,58826,55957,39061,34189,22144
52303,1217,1814,33868,18435,3.18264e+13,557.351,5821.49,52303,525,311,50489,50479,47877,47781,43199
47888,1947,1983,30784,17104,2.88627e+13,568.77,6324.16,47888,539,324,45905,45905,45883,45894,45887
1985,457,746,1311,674,1.57492e+13,119.425,1078.95,1985,204,86,1239,1239,1238,1238,900
53194,418,3482,33771,19423,2.97075e+13,478.102,9050.08,53194,1184,261,48588,45823,32104,16101,7272
80976,1771,3792,54755,26221,4.26499e+13,1171.18,11819.6,80976,1336,476,76698,74254,58867,22071,28628
46491,929,3619,31647,14844,4.74313e+13,736.914,9021.51,46491,1019,419,42435,41513,32007,10474,11273
22022,429,1010,14132,7890,2.85666e+13,475.854,3200.22,22022,368,218,20611,19152,18176,17419,12993
47898,1362,1426,30935,16963,2.98438e+13,562.556,5023.78,47898,464,295,46472,46472,46375,46386,46355
15237,620,889,9781,5456,2.92248e+13,414.369,2608.03,15237,288,199,14348,14257,13543,13521,12785
32815,991,2832,23558,9257,5.71578e+13,1398.81,8010.25,32815,1125,301,28271,26345,18885,17550,11873
46339,2013,2948,32816,13523,3.41826e+13,812.663,9121.82,46339,927,240,43391,43383,43252,43139,37542
75756,1985,4283,54376,21380,5.07779e+13,1478.44,14127.9,75756,1662,554,71000,66955,55018,52811,46783
55709,2622,4093,39622,16087,5.84124e+13,1527.07,11859.9,55709,1654,493,51616,50788,44429,41120,42709
3340,106,709,2505,835,1.60211e+13,186.412,1284.6,3340,225,75,1964,945,977,465,1046
98611,275,3062,62051,36560,3.03459e+13,739.676,10575.9,98611,672,471,90438,84366,71734,52687,23211
97840,2970,3002,61586,36254,3.02584e+13,714.031,10426.4,97840,649,468,94838,94838,94831,94838,94734
87017,1280,3597,54469,32548,3.01679e+13,902.5,10706.6,87017,660,458,83420,82713,71369,52463,45706
66482,914,2619,42246,24236,2.98751e+13,593.395,8389.93,66482,580,406,63863,63437,55424,48720,36253
13094,1453,2619,9715,3379,6.60453e+13,445.298,4743.92,13094,634,176,10475,10165,6258,7292,6241
55602,101,595,37720,17882,3.35834e+13,303.191,3980.83,55602,302,252,38499,18643,24791,12072,22724
31775,785,1217,20452,11323,2.9436e+13,543.976,3995.85,31775,442,255,30558,30463,29106,27486,27667
81664,2563,4203,54966,26698,3.21764e+13,1075.88,13194.8,81664,1263,360,77461,77021,76284,74744,59689
41256,820,2194,26252,15004,3.02449e+13,576.317,6243.77,41256,508,345,39062,38365,33363,27895,16298
7029,659,856,4555,2474,3.02549e+13,262.792,1883.89,7029,230,147,6173,6163,5959,5854,5238
18918,974,1383,12163,6755,2.96737e+13,486.191,3568.86,18918,364,221,17535,17503,17071,17111,15846
69279,2853,4201,48761,20518,5.19895e+13,1432.51,13362.7,69279,1748,532,65078,64848,58531,48098,51426
27505,272,1620,19819,7686,2.74959e+13,630.382,5257.42,27505,747,211,23907,22112,13364,5574,7830
71907,2321,3949,49968,21939,4.99549e+13,1268.76,12361.3,71907,1519,479,67958,64922,56637,35161,41400
94268,1357,3687,61846,32422,3.50478e+13,1178.93,11606.5,94268,935,373,90415,89415,73026,12624,18245
41994,2488,3584,30396,11598,6.11217e+13,1466.94,9490.71,41994,1194,426,38410,37311,32918,33586,34003
85720,487,4387,61079,24641,4.81381e+13,1628.75,15302.8,85720,1742,559,73743,69747,42219,32200,8861
29676,127,1831,17722,11954,3.18789e+13,311.239,4286.58,29676,397,226,26268,23701,18041,4793,1069
55379,1753,3564,35220,20159,2.96383e+13,500.159,9241.61,55379,1205,245,51815,51793,50702,50945,33312
5750,630,669,3718,2032,3.08891e+13,287.733,1507.45,5750,234,136,5081,5080,5031,5056,5027
78035,1045,3975,52291,25744,3.17975e+13,956.692,12534.8,78035,1212,305,73451,71144,60468,48124,27508
95365,1265,4338,67308,28057,4.65309e+13,1561.63,15895.9,95365,1811,571,88154,83826,65961,48582,31628
10357,360,1559,7402,2955,7.25573e+13,223.056,2949.96,10357,260,254,8769,8030,4753,3846,2510
52073,622,2476,32895,19178,3.02197e+13,559.537,7262.21,52073,504,368,49293,48274,40255,33088,18123
85061,1481,4469,56322,28739,2.96223e+13,875.049,13239.2,85061,1256,353,80592,79493,69214,66272,36317
9846,514,1552,5940,3906,3.0294e+13,177.909,2471.48,9846,285,111,8294,8237,8040,8104,7365
99845,2996,3948,65035,34810,3.44789e+13,1261.18,12501.7,99845,894,439,95897,95669,92632,90043,77158
57716,310,2382,35595,22121,3.09623e+13,594.16,7040.05,57716,472,389,53521,50631,39497,23862,5139
80682,2084,4074,53520,27162,2.92468e+13,788.293,12284.4,80682,1235,351,76608,76227,74870,75847,43064
59613,696,3124,36867,22746,2.99776e+13,597.056,8239.24,59613,725,323,56321,55521,44128,27618,27312
61554,478,3664,39841,21713,2.94698e+13,592.985,9989.24,61554,1212,299,56568,53928,36421,18918,5551
90217,2479,4168,61889,28328,4.74153e+13,1348.03,14065.7,90217,1779,484,86049,84366,73431,41826,51275
38723,517,1873,24390,14333,3.03098e+13,503.458,5442.26,38723,440,304,36511,35581,30365,24623,18971
72050,123,3878,46405,25645,2.93252e+13,624.166,11231.7,72050,1232,358,57909,47886,38745,13316,5408
40144,1399,2654,27395,12749,2.81582e+13,531.981,7378.21,40144,922,257,37490,37312,35115,32661,21557
23420,129,1229,15132,8288,2.94512e+13,483.948,3546.77,23420,418,212,19583,18321,15701,13429,6381
46981,543,1422,30248,16733,2.96744e+13,572.106,5009.28,46981,474,301,45305,42251,38764,37655,30134
20591,1587,1749,14829,5762,2.79948e+13,437.043,4654.69,20591,528,153,18842,18794,18842,18842,18625
53663,2676,3592,36255,17408,4.43262e+13,761.488,9360.9,53663,999,424,50071,49941,45845,19354,22397
26837,895,2809,18886,7951,5.18305e+13,1175.01,7284.44,26837,976,304,22909,21498,16423,15701,9823
68174,3642,3684,45659,22515,4.27024e+13,934.612,10383.1,68174,1013,416,64490,64490,64447,64372,64369
77412,213,690,52477,24935,3.35178e+13,302.747,4739.84,77412,309,266,74476,69198,51078,34854,40632
80584,2347,2850,50983,29601,3.08432e+13,682.306,9461.08,80584,616,447,77734,77598,74216,75355,69391
39858,1552,1765,25763,14095,2.98504e+13,522.486,5668.92,39858,479,315,38093,38085,37712,37469,37650
14302,30,773,8357,5945,3.224e+13,255.441,1876.84,14302,233,125,11375,10354,6675,1894,889
21008,1215,1584,15221,5787,3.07796e+13,438.135,4575.18,21008,449,177,19424,19248,18707,19187,14808
52411,1607,1970,33770,18641,2.92584e+13,515.033,6292.34,52411,468,317,50441,50439,50055,49674,46252
85459,3421,3974,61456,24003,4.45466e+13,1690.68,14554.1,85459,1632,521,81485,81114,79953,78683,78125
51111,1023,2044,32980,18131,2.9463e+13,548.849,6581.43,51111,527,327,49067,49013,46198,45581,37740
24945,104,1606,17916,7029,2.90358e+13,626.087,5030.46,24945,686,209,17235,11044,9646,2844,2694
31430,715,1635,20223,11207,2.9092e+13,464.031,4839.23,31430,429,281,29795,29557,27209,26946,22178
51701,2038,3768,37104,14597,5.68689e+13,1555.95,11093.9,51701,1456,472,47668,44049,34882,37533,34214
81622,1430,3790,55260,26362,4.32847e+13,1169.46,11884.2,81622,1380,473,77036,74513,59276,20275,25711
30810,766,1120,19829,10981,2.89511e+13,535.964,3863.54,30810,436,243,29690,29559,28238,28221,26869
38044,1099,1459,24614,13430,3.12958e+13,562.535,4676.81,38044,446,283,36585,36576,35219,35043,33577
34274,99,1114,22067,12207,2.94658e+13,545.299,4014.39,34274,442,264,28023,23409,20825,19248,6478
32466,654,1057,21001,11465,2.96761e+13,541.637,3836.91,32466,418,250,31409,30921,28793,28878,27385
35592,706,2561,22458,13134,2.83362e+13,342.494,6182.12,35592,909,174,33031,32712,27061,24747,18633
83062,491,3204,54170,28892,3.40153e+13,714.685,9701.53,83062,666,375,78746,73595,63878,8986,7290
80297,2973,4008,53381,26916,3.16559e+13,933.038,12479.5,80297,1284,303,76289,75990,76224,76287,68612
48676,553,1979,31345,17331,2.99102e+13,570.493,6455.31,48676,517,343,46385,44783,39513,38328,20853
39195,2021,2531,27576,11619,2.80577e+13,587.199,7203.75,39195,852,264,36664,36664,36275,36428,30933
19832,990,2073,13263,6569,2.71094e+13,374.072,4818.11,19832,758,175,17759,17621,15789,15019,7397
91747,545,4444,63850,27897,3.99159e+13,1329.4,15143.6,91747,1443,449,81491,76772,50574,29852,15950
89673,2660,4353,63515,26158,4.76088e+13,1542.66,15478.4,89673,1827,568,85305,84483,70317,60381,59745
75796,1229,2828,47459,28337,3.07594e+13,675.161,9163.45,75796,577,432,72968,72643,62274,46372,38453
26434,1357,14914,22796,3638,8.47238e+11,14.3628,15246.2,26434,990,49,11520,11520,2576,3165,1754
31033,1005,2420,21416,9617,2.72324e+13,548.357,6431.46,31033,866,234,28595,28019,23516,20216,9000
35738,1676,1782,23111,12627,3.02438e+13,535.572,5441.97,35738,483,296,33956,33956,33937,33954,33875
92297,3427,4527,61147,31150,3.07278e+13,1012.17,14206.2,92297,1339,404,87770,87625,87766,87609,76584
7043,893,1501,5337,1706,6.81956e+13,194.515,2583.47,7043,418,152,5542,5542,3155,3648,2898
41009,450,519,27835,13174,3.35583e+13,299.985,3379.2,41009,294,234,40490,40490,39248,39356,38961
35052,427,1867,21801,13251,3.08043e+13,424.843,5159.63,35052,416,273,32830,31701,25737,17294,13758
89749,633,3963,61084,28665,4.55414e+13,1212.52,12761.5,89749,1414,484,82357,78858,58010,15421,16281
11392,26,1153,8093,3299,3.04823e+13,416.732,3093.14,11392,494,120,3492,1676,1148,934,248
81636,1894,3992,51658,29978,2.94266e+13,755.441,11663.3,81636,1078,414,77644,77328,70494,68073,52213
2625,74,516,1757,868,5.13151e+13,183.218,998.376,2625,186,62,1743,1323,1268,1171,477
25383,839,1604,16067,9316,3.02521e+13,437.529,4296.37,25383,370,255,23779,23579,21602,18698,17408
53219,462,2384,32860,20359,3.06838e+13,570.853,6909.34,53219,443,366,50183,48711,37788,24353,9538
48812,384,3868,34971,13841,5.86866e+13,1409.53,10665,48812,1369,454,39672,36388,20098,11308,7708
17449,68,386,11823,5626,3.32938e+13,276.448,2133.98,17449,245,159,9815,4012,6890,6023,6640
5164,263,605,3285,1879,2.78535e+13,249.655,1384.31,5164,165,145,4460,4193,3948,3899,2256
99630,1665,3545,65250,34380,3.40626e+13,1027.04,11356.9,99630,761,399,96085,95271,83789,15732,24075
86548,1491,2851,55143,31405,2.95003e+13,650.873,9570.36,86548,669,429,83697,83536,77626,69873,59321
76964,1276,3724,51934,25030,4.15542e+13,1114.76,11308.9,76964,1191,428,72350,70283,54139,16136,17531
2422,323,356,1404,1018,3.06081e+13,80.3229,623.571,2422,59,75,2066,2064,2056,2062,1959
12796,206,781,8220,4576,2.87944e+13,406.324,2299.98,12796,272,186,11102,10280,9455,9507,4607
9767,743,2332,6813,2954,5.20474e+13,344.809,3948.47,9767,591,218,7435,7259,4991,4527,2489
67189,1158,2282,43345,23844,2.93688e+13,572.836,7648.48,67189,601,365,64907,64866,60664,60195,47239
77109,3940,4136,53379,23730,5.05949e+13,1328.94,13313.2,77109,1779,480,72973,72966,72434,70939,69099
63501,2132,2136,40900,22601,2.92391e+13,586.312,7322.45,63501,554,369,61365,61365,61365,61361,61363
31567,1381,1926,20803,10764,3.83452e+13,498.646,5046.19,31567,457,249,29641,29629,28404,27189,23931
26459,299,2312,17120,9339,2.7134e+13,327.87,5420.38,26459,779,174,22987,21145,15410,11576,6646
97692,2135,4140,65149,32543,3.90776e+13,1405.13,13318.2,97692,1352,456,93392,90642,77289,25280,44986
68678,319,2647,44052,24626,2.9448e+13,603.63,8467.49,68678,638,408,62751,57983,52688,45791,18892
93817,205,4022,62804,31013,3.98035e+13,1344.5,12884.4,93817,1288,443,78860,71964,57559,9650,5245
4281,898,1193,2747,1534,4.54092e+13,104.651,1871.27,4281,333,101,3088,3080,3088,3080,2612
35570,1234,2837,25404,10166,4.46607e+13,843.147,8260.7,35570,839,309,32443,31145,27308,25418,21844
75023,345,690,50930,24093,3.35942e+13,304.301,4674.75,75023,309,266,74333,74333,54849,55305,48545
4766,235,474,3477,1289,3.17874e+13,169.563,1283.38,4766,194,93,4292,3966,3749,4012,2363
87181,4226,4270,60707,26474,4.76538e+13,1328.23,14706.2,87181,1813,536,82911,82911,82893,82579,82460
47119,101,2903,30226,16893,2.89126e+13,462.65,7704.45,47119,1121,209,35428,26419,22006,6770,5031
28669,925,1109,18512,10157,2.97486e+13,515.622,3710.56,28669,381,248,27560,27551,27081,26918,26704
63329,3108,3497,45453,17876,4.78514e+13,1459.2,11950,63329,1403,370,59832,59745,59822,59754,58837
85295,3240,3958,54239,31056,2.94251e+13,754.888,12180.9,85295,1182,411,81337,81253,81337,81322,77161
86144,2480,3969,62227,23917,4.80261e+13,1722.56,14685.2,86144,1633,575,81905,80261,67237,68366,61602
4681,292,474,3424,1257,3.21538e+13,169.833,1274.51,4681,194,96,4207,4205,3984,4150,2854
87600,3260,4406,61324,26276,3.988e+13,1347.17,14845.7,87600,1440,450,83194,82912,75812,74984,69881
78007,1147,2672,50377,27630,3.02068e+13,643.621,8515.17,78007,719,368,75335,75225,68387,67972,54607
88609,380,4519,58750,29859,3.0903e+13,896.979,13927.3,88609,1359,369,80510,76393,52367,26100,11568
31560,1063,2182,22508,9052,3.2903e+13,723.64,6573.28,31560,752,193,29217,28167,27690,28025,21514
94323,35028,37135,76562,17761,1.70168e+12,103.159,39054.7,94323,1910,158,57188,57188,54157,56978,54466
65788,1012,3772,44695,21093,3.07422e+13,817.69,11176.6,65788,1105,288,61583,59691,49304,38360,18015
93715,267,785,63567,30148,3.35735e+13,305.616,5279.18,93715,314,275,91866,87115,62679,50149,49996
5113,1136,1438,4148,965,7.65414e+13,163.451,2137.03,5113,315,120,3675,3667,2846,3114,2962
90984,1785,4286,64176,26808,4.74549e+13,1406.91,15402.7,90984,1779,555,85705,81142,67033,49381,45974
18279,880,1950,12696,5583,2.52439e+13,463.119,4666.82,18279,744,173,16329,16042,12243,11725,4413
94488,2289,4246,61399,33089,2.95666e+13,821.149,13563.3,94488,1253,431,90242,89931,87789,88048,62934
61489,2393,3037,40569,20920,3.61898e+13,778.584,8159.72,61489,770,333,58452,58228,55607,51426,33689
94035,2340,4019,61593,32442,2.99057e+13,736.834,12997.8,94035,1266,395,90016,89797,88826,89419,60760
24957,25,2184,17665,7292,2.62012e+13,606.71,5664.06,24957,808,216,8773,4411,2870,1408,412
16571,1435,1437,11985,4586,2.83561e+13,433.95,4042.5,16571,507,168,15134,15134,15134,15134,15134
37801,29,2903,26910,10891,4.6537e+13,1056.1,8657.92,37801,990,315,19131,9712,7402,7278,1325
24155,553,1267,14196,9959,3.19474e+13,307.556,2984.35,24155,351,162,22888,22744,17589,13876,12983
39018,10634,13682,31836,7182,1.73021e+13,127.17,16536.9,39018,987,158,25336,25336,21739,22552,21877
40592,1327,3645,28346,12246,5.17827e+13,970.822,9055.31,40592,1083,425,36307,34920,25542,12737,13002
51824,3120,3590,34950,16874,4.46091e+13,774.878,9309.24,51824,981,421,48234,48230,46617,44246,34287
97458,4166,4216,64261,33197,2.93805e+13,911.329,13781.6,97458,1257,406,93242,93242,93242,93242,93110
9893,48,1188,7152,2741,2.83152e+13,452.194,2892.89,9893,430,116,4162,1660,1491,1392,863
57006,1246,3655,40543,16463,4.14322e+13,1123.98,11340,57006,1161,382,52640,50272,43790,43432,25665
46767,99,2880,31354,15413,2.86852e+13,504.11,8015.03,46767,989,259,34695,25715,20463,6330,3187
89515,5719,23942,73387,16128,2.43932e+13,5390.74,39296.2,89515,7808,26,61381,45118,49501,54843,26579
49868,1459,2313,31180,18688,3.05015e+13,520.394,6684.56,49868,472,349,47555,47519,42492,37657,33224
74404,1752,3860,53514,20890,4.64888e+13,1641.6,13433.7,74404,1558,417,69521,65660,57533,54494,42176
11471,2263,2533,8160,3311,5.76023e+13,470.592,4495.5,11471,633,227,8938,8912,8609,8771,8596
67988,1443,3774,44119,23869,2.95437e+13,593.14,10789.2,67988,1230,336,64214,63937,57097,55197,34482
46706,2337,2879,32681,14025,2.84668e+13,626.427,8123.53,46706,889,275,43827,43827,43612,43726,38539
22451,2744,2862,15580,6871,5.21409e+13,461.123,6106.11,22451,760,335,19589,19589,19467,19463,18765
10201,109,614,5964,4237,3.25419e+13,230.279,1468.34,10201,177,109,8958,8087,6279,3733,2811
55575,1001,3423,40049,15526,4.94772e+13,1286.64,11166.8,55575,1213,354,49775,46942,37611,34675,26514
71881,4061,4189,50662,21219,3.79814e+13,1218.78,13224.2,71881,1264,410,67692,67685,67666,67535,67039
21851,702,1486,14098,7753,2.89122e+13,393.5,4007.51,21851,363,254,20365,20246,19036,18638,14571
53620,1879,2415,33317,20303,3.07307e+13,552.781,7019.84,53620,468,375,51205,51154,47879,49161,43370
80742,2549,4229,56424,24318,4.92977e+13,1380.96,14249.2,80742,1751,527,76513,74968,64876,47803,50527
88754,325,4408,61871,26883,3.91693e+13,1328.86,14871.2,88754,1430,441,76132,70684,45597,22792,10329
64532,417,3800,44084,20448,4.60396e+13,1124.46,10993,64532,1360,451,56503,52362,37985,10070,6277
26845,1345,1570,17252,9593,2.94317e+13,448.18,4420.26,26845,413,258,25275,25275,25044,24989,23876
19333,301,1222,12564,6769,3.0435e+13,516.536,3400.2,19333,349,217,17254,16143,15176,13550,8768
96613,1870,4895,64997,31616,3.51456e+13,1268.87,15538.4,96613,1398,462,91607,90071,83159,83812,42304
45867,969,3067,33130,12737,5.21288e+13,1319.14,9816.15,45867,1181,348,40478,38131,28986,26865,19641
26255,1024,1272,17001,9254,3.09448e+13,510.039,3802.31,26255,406,238,24983,24983,24435,24152,23716
91512,2028,4320,59009,32503,2.93876e+13,795.821,13324.5,91512,1253,410,87192,86886,81350,80604,56644
3636,121,788,2772,864,9.2539e+13,136.949,1314.49,3636,76,134,2745,2212,755,960,713
85346,1643,2809,54064,31282,3.00628e+13,686.569,9571.73,85346,624,442,82537,82312,76126,64503,61245
27553,943,1708,16621,10932,3.17375e+13,309.892,4136.51,27553,353,204,25845,25796,20496,17691,12224
82352,2231,2769,52976,29376,2.93508e+13,620.453,9099.2,82352,697,406,79583,79576,78631,78520,77456
95755,278,4108,65409,30346,4.54388e+13,1325.37,13857.8,95755,1559,471,80946,73113,56123,15874,7362
25008,2649,9857,20279,4729,1.73252e+12,91.7793,10798.2,25008,733,118,15151,15146,4530,9941,5172
75525,2549,4284,53759,21766,5.07796e+13,1383.24,14159.5,75525,1778,527,71241,69940,60587,54456,55215
21699,74,1526,13191,8508,3.12311e+13,258.067,3650.52,21699,275,208,17960,15395,12763,5164,1823
30651,1622,2283,21423,9228,3.61685e+13,745.122,6836.12,30651,718,210,28368,27774,28003,26674,24276
35170,339,3012,23759,11411,4.32765e+13,584.668,7112.66,35170,780,332,30677,27753,21648,4468,2932
31494,201,2180,18940,12554,2.97716e+13,317.292,4701.7,31494,621,164,28007,24860,18817,10602,9800
74156,1489,21746,60224,13932,2.80902e+13,6137.45,34323.6,74156,7446,22,37554,30649,18845,18072,3717
60305,3135,3786,43159,17146,5.35714e+13,1447.22,11992.3,60305,1460,508,56519,56504,54139,54350,53980
1370,93,360,874,496,3.26667e+13,81.0285,606.501,1370,109,78,961,831,793,747,554
99143,2593,4373,69492,29651,4.54876e+13,1559.82,16239.9,99143,1783,561,94617,93074,78137,63763,61216
16405,1655,1723,10325,6080,2.6109e+13,306.904,3664.1,16405,603,137,14682,14682,14682,14682,14640
80620,350,2939,52483,28137,3.33487e+13,669.519,9023.64,80620,647,366,74272,68423,61922,7513,5842
68078,2039,2666,42768,25310,3.06916e+13,645.537,8472.61,68078,545,418,65412,65297,60777,61766,55026
70177,4055,7034,59651,10526,4.22151e+13,16.9955,8048.55,70177,3520,3516,63143,63143,45290,55700,54226
12990,563,816,8388,4602,2.82235e+13,382.562,2326.3,12990,291,166,12174,12065,11458,11147,10040
14630,992,2793,10683,3947,6.57296e+13,431.008,5155.29,14630,668,235,11837,11356,10047,9211,6709
65467,3490,19565,53716,11751,2.71814e+13,4557.37,30498.7,65467,7459,22,41577,31308,32067,27221,9410
22597,1362,1529,14416,8181,2.86119e+13,436.804,4079.58,22597,387,243,21068,21068,20948,20959,20493
86981,2352,2884,55466,31515,2.95833e+13,692.839,9699.31,86981,714,436,84097,84008,81966,81229,77994
67347,12318,21739,54859,12488,2.46767e+13,4150.97,32726.9,67347,5528,97,45608,39889,41444,40125,29271
15937,1434,1909,10976,4961,2.38125e+13,340.106,4233.84,15937,656,174,14028,14023,13799,13555,12526
96594,320,4324,69148,27446,4.50965e+13,1645.41,16156.6,96594,1856,585,80889,73632,44540,23414,17473
62370,3656,4164,44700,17670,5.50033e+13,1460.88,12701.4,62370,1611,520,58206,58199,57872,55239,55337
18513,1313,2014,12680,5833,2.60181e+13,460.497,4734.18,18513,761,181,16499,16491,16086,15509,12961
30725,801,2158,21952,8773,3.3064e+13,701.063,6474.11,30725,752,193,28144,27295,25554,26438,16960
81632,1074,2619,52642,28990,2.94756e+13,611.775,8781.32,81632,634,395,79013,78926,72314,71329,54532
90013,3418,4373,64229,25784,4.68403e+13,1627.79,15741.3,90013,1824,562,85640,85229,81964,74903,75949
39712,935,1845,25518,14194,2.8798e+13,512.396,5729.33,39712,477,323,37867,37767,35583,34299,25429
14369,256,832,9307,5062,2.9971e+13,440.902,2463.62,14369,307,189,12791,11861,10969,10848,5621
61434,3379,3789,42289,19145,3.1264e+13,856.355,11038.9,61434,1048,288,57645,57588,57645,57645,55874
36911,548,3299,26446,10465,5.85585e+13,1420.54,8987.23,36911,1190,321,29942,27800,17506,15375,7061
3327,531,582,2167,1160,3.1303e+13,121.941,1102.64,3327,142,89,2745,2736,2736,2733,2630
87211,564,3859,59206,28005,4.45078e+13,1200.37,12412.6,87211,1386,470,79763,75599,56940,14442,14100
29048,2778,2931,19734,9314,4.47126e+13,506.569,6328.55,29048,696,316,26117,26116,25823,25870,24154
61034,2103,2388,39189,21845,2.91891e+13,627.171,7742.92,61034,578,387,58646,58644,58333,58436,57147
18589,2076,2312,12752,5837,4.06624e+13,839.213,5432.43,18589,806,218,16277,16262,16184,16247,15926
56711,993,2496,36067,20644,3.00397e+13,537.432,7704.86,56711,555,394,54215,54087,47783,41162,30203
96610,3854,4650,68448,28162,4.38632e+13,1713.01,16202.5,96610,1712,613,91960,91844,88000,87263,85714
92108,254,4279,64926,27182,4.67293e+13,1501.8,15569.3,92108,1769,558,76423,69241,45107,21258,4709
40912,2095,2818,25516,15396,2.89764e+13,389.856,6675.38,40912,1008,183,38094,38093,37820,38042,35391
10690,769,1612,7603,3087,6.98237e+13,259.027,3100.72,10690,286,254,9078,9007,7666,5613,5080
21288,664,2530,15905,5383,6.37815e+13,1179.73,6034.72,21288,750,261,17268,16783,8368,8089,4251
46747,823,1814,30187,16560,2.93379e+13,507.219,5886.24,46747,507,302,44933,44786,41698,41639,34934
66707,2315,3453,44679,22028,2.87927e+13,751.804,10243,66707,1130,281,63254,63030,61864,62832,52541
87318,2536,3975,58531,28787,4.00613e+13,1318.26,12162.2,87318,1174,449,83343,81814,71985,23826,42353
64107,1010,2539,40790,23317,2.94656e+13,565.13,8139.16,64107,561,393,61568,61439,55599,49297,36518
92398,3668,4487,63532,28866,3.74819e+13,1325.68,15058.6,92398,1439,431,87911,87755,84189,85036,80476
72646,3020,3734,52139,20507,4.55238e+13,1532.42,13151.5,72646,1504,390,68912,68606,63539,63776,62553
53515,1419,2315,32759,20756,3.09008e+13,556.791,6621.33,53515,553,305,51200,51019,45222,45451,38283
57584,998,3332,40982,16602,3.32981e+13,942.146,10617.3,57584,1009,322,53591,51124,45396,45526,29433
24196,91,2015,15208,8988,2.67204e+13,304.986,4629.26,24196,683,154,18233,14273,10973,4641,2614
50426,1424,3370,35960,14466,5.25595e+13,1415.85,10548.8,50426,1369,335,45952,42571,35020,33274,26580
86475,1448,4356,60002,26473,3.74806e+13,1311.07,14563.1,86475,1424,420,81059,78030,68885,60476,31191
31608,2667,2852,21416,10192,4.38516e+13,578.919,6364.45,31608,731,337,28756,28756,28310,28167,26657
3816,276,726,3017,799,9.39638e+13,144.684,1324.2,3816,81,110,3090,2959,1668,1924,1734
99857,2003,4538,68363,31494,3.84976e+13,1335.67,15572.7,99857,1458,431,95086,92450,84069,73948,56130
25363,637,1044,16338,9025,2.93373e+13,465.351,3442.63,25363,329,252,24319,24159,22350,22415,20421
73181,2961,4175,51527,21654,3.76223e+13,1224.65,13334.2,73181,1304,409,69006,68841,64542,63913,57517
64842,2472,3857,44270,20572,3.16108e+13,887.398,11469.6,64842,1191,299,60985,60878,60431,60783,46610
9510,1094,2126,7121,2389,7.18736e+13,243.601,3477.01,9510,381,313,7384,7382,2863,3819,1973
51824,2377,3439,32843,18981,2.91078e+13,453.464,8786.36,51824,1135,236,48385,48382,48187,48348,36547
40142,1797,1865,25843,14299,2.95657e+13,530.593,5752.82,40142,484,324,38277,38277,38202,38181,38213
61176,2059,8474,40632,20544,2.8068e+13,375.77,13507.6,61176,1164,289,52702,52674,45080,44548,42943
81500,8601,23596,66211,15289,2.76751e+13,5685.9,37073.7,81500,7867,72,57904,43298,47639,49578,26960
4790,273,542,3108,1682,3.03202e+13,224.943,1225.58,4790,208,105,4226,4028,3793,3841,2375
90074,3820,4007,64820,25254,4.68106e+13,1710.73,15032.1,90074,1665,586,86067,85925,85918,85066,85731
89399,1345,4345,63960,25439,4.71589e+13,1683.29,15643.4,89399,1828,571,82481,77856,62864,57447,37121
36195,1351,2340,22130,14065,2.89378e+13,344.297,5506.71,36195,866,163,33855,33854,33570,33511,27728
98280,3123,4539,66709,31571,3.63816e+13,1321.18,15297.6,98280,1453,420,93741,93426,88711,87237,79652
98136,843,4229,63069,35067,2.93957e+13,837.753,13652.5,98136,1266,441,93397,92213,73547,52824,35835
92454,460,4249,61093,31361,2.92203e+13,934.376,13522.6,92454,1261,409,85696,81701,57450,37166,17390
38447,1456,2074,24529,13918,2.9992e+13,566.123,5876.42,38447,471,333,36373,36342,34643,34442,31829
44211,493,1821,28936,15275,3.42738e+13,570.29,5499.48,44211,490,298,41753,38715,34611,4990,6202
88394,2538,4229,62405,25989,4.78167e+13,1334.36,15089.1,88394,1752,547,84165,82681,71765,58662,60503
75152,2505,4189,53392,21760,3.83773e+13,1321.52,13624.3,75152,1370,422,70963,70541,65075,63524,53133
99687,777,4156,66640,33047,3.96381e+13,1371.24,13453,99687,1376,456,92971,91119,69171,15060,16283
40467,2564,2811,28474,11993,3.42903e+13,827.537,8403.44,40467,830,235,37656,37656,37656,37646,36038
39505,168,2868,23912,15593,3.06477e+13,428.677,6302.31,39505,680,254,34807,31031,23628,7806,3546
48379,2362,3509,34648,13731,5.35952e+13,1567.77,10485.7,48379,1442,343,44870,42575,38179,38655,37777
27083,2134,2994,18527,8556,4.74634e+13,510.738,6486.53,27083,782,322,24089,23894,21900,10939,11634
10780,1292,1991,7842,2938,5.7665e+13,258.323,3783.96,10780,538,160,8789,8789,6315,6549,5613
67521,2640,3868,46194,21327,3.18363e+13,942.449,11809.1,67521,1095,303,63653,63468,63360,63411,52355
31597,869,1766,22839,8758,3.03381e+13,537.095,5714.12,31597,543,215,29829,29288,24898,26896,14977
38244,1823,2656,25128,13116,2.8101e+13,464.804,7025.58,38244,995,210,35588,35587,35025,33553,29107
97608,4512,4661,68535,29073,4.19493e+13,1666.57,16151.4,97608,1718,510,92947,92944,92947,92808,92821
33263,724,1717,21023,12240,3.06032e+13,483.726,4971.25,33263,432,263,31529,31045,27534,22885,22893
57083,2112,3674,39047,18036,4.63098e+13,940.743,9867.11,57083,1041,426,53409,52038,42589,16419,24128
7247,178,573,4221,3026,3.12686e+13,181.548,1250.06,7247,110,96,6572,6064,5086,3875,2393
61518,39,2120,39568,21950,2.87934e+13,562.344,6700.51,61518,543,328,38571,22459,26968,19554,4348
98314,2649,4722,69150,29164,4.25213e+13,1714.26,16365.9,98314,1719,552,93410,91963,81188,78970,64371
52734,1648,2071,34391,18343,3.34903e+13,564.587,6188.51,52734,519,317,50663,50659,49435,49320,46296
7905,204,1412,5605,2300,6.6687e+13,162.52,2523.49,7905,227,179,6418,5991,3389,2063,1549
76458,765,2759,48030,28428,3.06036e+13,650.876,9080.24,76458,546,442,73470,72669,59749,46256,35063
50287,1870,2975,33532,16755,2.90275e+13,503.706,8321.85,50287,1030,259,47312,47306,46107,42582,34922
66266,2820,3656,42155,24111,2.9469e+13,576.287,10296.2,66266,1174,315,62610,62610,62591,62573,56334
51206,3329,3645,35192,16014,4.83682e+13,888.816,9540.04,51206,1011,432,47561,47423,46674,44280,38345
51778,2551,3390,36684,15094,3.11095e+13,902.088,9841.68,51778,943,266,48388,48386,48367,48376,44455
69791,27252,27492,56672,13119,1.69657e+12,100.341,29127.9,69791,1560,157,42299,42299,42011,42295,42066
14174,47,1268,9152,5022,2.93711e+13,363.839,3014.43,14174,310,192,9317,5968,6888,6149,1723
14854,7122,14854,7427,7427,5807760,0,14854,14854,7428,2,0,0,0,0,0
20225,2248,2851,14677,5548,6.51517e+13,950.805,6009.41,20225,857,246,17374,16674,16326,16289,15804
59824,1346,2267,38501,21323,2.91542e+13,609.465,7482.72,59824,549,376,57557,57515,55222,52151,41636
8037,466,710,5162,2875,2.88931e+13,318.582,1750.76,8037,293,138,7305,6951,6925,6602,6560
49578,3117,3461,33040,16538,4.08366e+13,733.991,8794.53,49578,962,401,46117,46115,45161,43149,38993
92447,3796,4577,65747,26700,4.32311e+13,1721.53,15804.4,92447,1693,541,87870,87715,84296,83695,81655
4534,291,993,3016,1518,4.72516e+13,149.229,1705.4,4534,295,95,3540,3322,3111,3447,1045
13600,1476,2382,9777,3823,6.57715e+13,389.98,4530.69,13600,512,334,11218,11108,6541,7558,6250
29792,1268,2183,18161,11631,2.8825e+13,335.086,4899.35,29792,782,156,27609,27609,27350,27563,22898
6020,862,1097,3792,2228,3.06182e+13,96.1771,1935.5,6020,208,121,4923,4922,4690,4788,4029
58841,491,2513,37024,21817,3.01819e+13,556.108,7727.69,58841,527,388,55673,53709,44456,34784,18233
47374,1175,3336,29867,17507,2.96524e+13,448.713,8091.84,47374,1126,196,44038,43801,35947,33806,23058
68846,2084,2266,44273,24573,2.9085e+13,583.093,7635.72,68846,608,349,66580,66580,66369,66344,66300
99037,2390,4273,68814,30223,4.5369e+13,1341.66,15611.9,99037,1785,549,94764,91921,78470,53844,58442
94195,291,4476,63685,30510,3.64789e+13,1215.09,14843.3,94195,1354,419,82152,76744,51029,25070,15198
91293,3818,4245,58578,32715,2.95054e+13,768.93,13160.1,91293,1255,415,87048,87048,87048,87048,83629
6033,404,1373,4004,2029,4.69157e+13,275.535,2410.13,6033,393,102,4580,4257,3192,3459,971
12096,1842,2538,9074,3022,6.57704e+13,434.05,4519.14,12096,593,168,9558,9400,8270,8349,8119
79734,307,2887,50057,29677,3.01816e+13,699.921,9510.08,79734,672,444,73387,68432,58267,42285,13155
89129,3717,4132,61193,27936,4.75441e+13,1370.41,14018.9,89129,1765,502,84997,84966,83140,72752,64335
55719,526,2045,36056,19663,3.01884e+13,553.778,6555.59,55719,529,320,53309,49961,45141,44026,29598
36856,1061,1274,23770,13086,2.94641e+13,530.753,4370.1,36856,412,284,35582,35582,34894,34899,34556
19724,224,1042,12717,7007,2.97963e+13,457.857,3091.89,19724,330,198,17521,16321,15214,14141,8118
99165,470,4315,68806,30359,4.57757e+13,1325.55,15649.2,99165,1829,549,87110,81435,60419,31891,17910
19647,906,1061,12651,6996,2.9906e+13,451.803,3124.13,19647,342,216,18586,18441,18280,18122,18423
58213,2754,3536,41687,16526,3.96509e+13,1056.03,11308.1,58213,1118,365,54677,54627,50463,51989,50447
87567,3501,4219,56260,31307,2.94785e+13,749.813,12945.3,87567,1239,404,83348,83346,83348,83343,78531
6638,446,661,4248,2390,2.91313e+13,288.249,1613.26,6638,220,136,5958,5632,5655,5490,4388
74049,3634,3899,49545,24504,3.10128e+13,858.675,11753.4,74049,1235,286,70150,70145,70150,70150,69092
49796,423,1398,32143,17653,2.96586e+13,547.056,5057.91,49796,512,309,47178,43535,40873,39415,27432
48179,713,2911,32871,15308,2.88959e+13,531.194,8204.64,48179,954,268,44866,43642,32744,21064,12268
11696,1079,1126,8380,3316,2.20751e+13,427.409,3030.99,11696,608,113,10570,10456,10538,10546,10444
16854,468,2582,12613,4241,7.0224e+13,781.089,5337.41,16854,684,254,13396,12657,7189,6546,5158
46461,358,557,31579,14882,3.37661e+13,302.697,3624.99,46461,298,243,45904,45904,36733,39723,36097
51181,51,3017,33483,17698,2.91392e+13,501.313,8308.4,51181,1107,253,33675,24496,18506,4643,2429
10121,626,727,7351,2770,3.22601e+13,200.275,2226.34,10121,252,129,9394,9394,9293,9361,8595
18837,488,1054,11008,7829,3.20772e+13,265.17,2441.29,18837,310,150,17783,17691,15410,15460,12885
7452,361,719,4787,2665,2.96127e+13,289.907,1727.91,7452,232,143,6645,6303,6139,5833,4350
53048,1916,3577,35820,17228,4.44312e+13,746.552,9270.84,53048,1001,418,49471,48603,39372,14240,18181
31808,554,1693,22971,8837,2.72777e+13,622.842,5655.91,31808,756,213,29304,27052,20230,13447,17105
15804,51,889,10218,5586,2.90305e+13,438.564,2633.11,15804,363,192,10915,7190,8244,3658,1725
73350,1467,3637,52970,20380,4.26294e+13,1253.13,12940.6,73350,1342,400,68722,65604,57322,55427,40172
3852,232,525,2778,1074,3.07765e+13,157.383,1172.02,3852,191,94,3327,3092,2395,2278,1513
26884,351,1652,16324,10560,3.14556e+13,278.035,4112.68,26884,332,217,25171,24386,18247,8635,6683
53418,177,1958,34400,19018,2.9202e+13,532.948,6345.58,53418,538,314,46409,43394,38089,33719,12974
65904,2969,4167,47018,18886,5.38091e+13,1437.97,13101.3,65904,1650,535,61737,61601,56259,52415,53981
34648,59,1883,21362,13286,3.12068e+13,405.62,5108.84,34648,365,280,27006,22185,19861,7770,2516
28248,1241,1659,17907,10341,3.11489e+13,481.379,4587.94,28248,409,257,26589,26588,25275,25675,22496
42729,1042,1327,27494,15235,2.94062e+13,554.541,4688.73,42729,492,292,41402,41402,40363,39995,39642
35780,408,1186,22968,12812,2.91619e+13,550.697,4181.86,35780,427,264,33537,30988,29548,28341,22363
38075,1030,1683,24456,13619,2.8949e+13,493.059,5290.37,38075,441,291,36392,36362,35339,35031,30479
59861,2067,3651,40992,18869,4.59149e+13,1072.21,10306.6,59861,1147,430,56210,54091,45213,20099,26885
58425,433,3055,39372,19053,2.94443e+13,617.255,9032.56,58425,1062,277,53744,51051,35266,19280,14424
35399,1301,1739,22782,12617,2.87328e+13,481.26,4960.29,35399,414,271,33660,33646,33508,33402,31901
31377,457,3124,26718,4659,4.17818e+13,17.2076,3810.24,31377,1565,1560,28253,28253,12283,21594,19622
15905,2633,4626,13621,2284,2.30734e+13,13.6595,7896.78,15905,2259,12,11279,11270,11279,11279,6355
55897,2883,4103,39721,16176,5.88451e+13,1437.93,11849.4,55897,1690,453,51794,51635,46252,41032,43317
22158,1759,3377,16175,5983,7.12478e+13,692.621,6716.03,22158,774,404,18781,18074,13037,12450,13141
74801,358,3825,49639,25162,2.96837e+13,846.948,11292.1,74801,1200,286,67782,64700,42813,21448,16815
43101,1783,3780,30705,12396,5.87012e+13,1162.11,9793.59,43101,1283,453,38921,36663,28150,21459,23960
24213,2287,2771,17046,7167,5.49935e+13,1134.05,6832.62,24213,948,284,21442,20911,19884,19968,19861
58632,738,2117,37771,20861,2.93897e+13,548.767,7004.48,58632,572,341,56515,55933,50429,49951,39052
4225,1246,1562,3209,1016,4.02406e+13,129.412,2291.61,4225,401,111,2663,2663,2240,2304,2104
93916,2242,3564,59173,34743,2.99226e+13,967.693,11397.6,93916,748,457,90352,89873,83725,84954,73039
6891,1263,1507,5095,1796,7.85447e+13,190.682,2676.01,6891,286,139,5384,5384,5384,5384,4700
46906,3730,3842,33629,13277,6.02007e+13,1236.55,10267.1,46906,1312,469,43064,43064,42949,42750,41876
87804,238,3493,54996,32808,2.99521e+13,906.555,10758.4,87804,718,451,79129,73456,60142,39643,18573
88214,958,9007,74884,13330,4.21103e+13,18.1407,10200.1,88214,4409,3873,79207,79203,32243,51908,47489
18339,1416,1507,13210,5129,3.00136e+13,485.386,4329.4,18339,505,175,16832,16771,16807,16763,16291
1119,223,292,891,228,9.57026e+13,87.3896,491.558,1119,46,70,827,819,763,786,760
37372,1252,2556,25019,12353,4.15243e+13,610.358,6391.12,37372,638,315,34816,34517,28460,8510,8755
28913,743,2359,20041,8872,2.6679e+13,550.736,6196.37,28913,848,232,26292,25810,17541,14183,6293
66204,2217,3465,41382,24822,2.96572e+13,678.775,9507.22,66204,924,372,62739,62675,61204,61756,54924
51332,2525,3453,32497,18835,2.92824e+13,451.575,8616,51332,1146,204,47879,47877,47797,47837,39393
6475,219,498,3785,2690,3.25644e+13,173.871,1094,6475,128,96,5972,5662,5061,5139,3470
96554,1997,3347,62539,34015,3.2337e+13,881.453,10742.5,96554,742,442,93207,92853,88128,83564,71357
7707,297,367,5214,2493,3.37985e+13,275.227,1442.86,7707,220,121,7325,7152,6690,6803,6720
48959,2795,2981,31932,17027,2.90647e+13,476.786,8087.94,48959,1083,240,45978,45977,45972,45978,44729
75397,2680,3883,48544,26853,2.94847e+13,633.613,11458.6,75397,1238,359,71514,71477,71201,71376,57202
1365,68,358,860,505,2.41286e+13,84.5487,581.788,1365,162,53,865,545,577,619,352
43705,210,1828,28031,15674,2.94771e+13,565.822,5575.93,43705,508,286,38212,35628,32237,31796,12860
12876,579,1244,8293,4583,2.94456e+13,306.578,2942.93,12876,302,205,11632,11489,10427,10458,6004
73126,2925,3712,52464,20662,4.46977e+13,1524.87,13183.7,73126,1472,390,69414,69105,63419,64043,62379
7520,31,549,4389,3131,3.20222e+13,192.68,1225.03,7520,137,102,6017,5487,3617,1344,486
13014,126,878,8432,4582,3.03447e+13,473.599,2461.46,13014,266,188,10864,10170,8739,7346,1445
93123,3261,4480,65246,27877,4.15201e+13,1548.95,15538.4,93123,1601,458,88643,88205,80390,80890,73454
76382,7164,10876,51611,24771,2.75535e+13,427.452,17049.9,76382,1328,320,65506,65499,61725,64307,60907
94688,1189,2935,60243,34445,2.98264e+13,713.233,10102.2,94688,687,440,91753,91478,81655,73377,61819
44266,1017,3255,27640,16626,2.91366e+13,402.527,7514.11,44266,1023,189,41011,40752,32114,27220,20181
53536,1923,3393,38225,15311,4.99492e+13,1335.72,10963,53536,1305,354,49783,47098,40870,41900,36570
82550,5523,22713,67651,14899,2.54865e+13,5347.15,36644.2,82550,7793,22,56360,40889,30684,50017,13803
24990,260,2634,17584,7406,4.41694e+13,833.257,6748.61,24990,815,273,19633,17629,13685,12171,5475
72379,915,4118,50300,22079,5.1743e+13,1338.8,13038.5,72379,1707,474,64969,61956,43552,23464,17971
81198,1611,2847,51063,30135,3.03285e+13,677.904,9423.92,81198,587,448,78351,78088,70643,56216,58168
50258,2034,2108,31008,19250,3.10606e+13,511.167,6296.43,50258,433,326,48150,48104,48127,48150,47539
46953,662,1417,30178,16775,2.93025e+13,569.638,5034.29,46953,456,303,45536,44821,39824,38695,34945
61073,2681,3621,38446,22627,2.97181e+13,549.771,9503.53,61073,1060,304,57452,57451,57450,57448,51038
74358,947,4234,52042,22316,5.09687e+13,1420.15,13731.6,74358,1776,518,66571,62999,45282,27629,19650
36643,1257,1317,23702,12941,3.01536e+13,557.052,4354.35,36643,446,283,35326,35326,35286,35300,35217
27208,969,3228,19647,7561,6.38234e+13,1201.67,7370.17,27208,959,401,22898,21543,12728,11249,10172
96592,2497,4384,68208,28384,4.64047e+13,1538.29,16074.7,96592,1814,563,92011,90319,74912,63037,58661
36950,198,3000,24938,12012,4.35113e+13,593.688,7357.14,36950,834,343,30567,27674,21389,4828,2117
2597,136,401,1671,926,2.95868e+13,99.5576,785.492,2597,106,85,2196,2126,1799,1836,690
10736,1085,1169,7797,2939,3.04499e+13,190.713,2859.6,10736,374,144,9567,9567,9551,9545,8997
95795,4013,4689,63471,32324,3.13456e+13,968.32,14829.3,95795,1360,384,91106,91071,91106,91106,87197
12243,144,1119,7845,4398,2.92665e+13,336.56,2700.76,12243,295,201,10255,9524,8204,7135,2085
30022,641,1765,18779,11243,3.04783e+13,430.632,4754.95,30022,375,263,28195,27726,23096,16752,15705
62427,946,3710,40084,22343,2.91019e+13,549.327,10216.3,62427,1226,310,58657,57946,44172,32943,17124
42225,1668,1888,27328,14897,3.02371e+13,527.938,5951.6,42225,494,331,40337,40337,40032,40013,39813
66749,187,3891,46598,20151,5.10906e+13,1311.63,11889.9,66749,1386,466,52859,47589,31758,9929,4938
92099,1538,4205,59841,32258,2.94505e+13,780.157,13198.2,92099,1251,423,87894,87423,73774,60970,38154
21194,272,2211,14664,6530,3.87624e+13,575.89,5569.44,21194,608,194,17636,15985,13627,13812,6137
47019,1955,3026,29171,17848,2.89685e+13,449.161,7550.93,47019,934,259,43993,43991,43930,43983,36864
1173,47,400,760,413,3.59987e+13,98.1355,627.007,1173,102,71,616,432,380,291,210
27831,1237,2992,20455,7376,6.41191e+13,1275.63,7292.2,27831,947,258,23964,22233,16377,16475,11576
98225,4458,4468,67776,30449,3.99144e+13,1388.47,15604.2,98225,1477,452,93757,93757,93757,93757,93749
92922,8896,24429,76307,16615,2.6582e+13,5308.24,39729.2,92922,8830,26,68493,53748,55101,59825,36645
29828,1030,3519,21715,8113,6.56861e+13,1286.63,7983.26,29828,1050,444,25044,23354,13693,13250,11972
54459,2021,2238,35454,19005,3.43415e+13,589.45,6503.16,54459,563,312,52221,52220,51842,51923,50853
44338,1605,1844,28529,15809,2.88722e+13,502.965,5775.01,44338,452,307,42494,42492,42141,41989,40382
36918,1189,2551,26447,10471,3.16541e+13,756.246,7413.94,36918,817,213,34367,33265,32219,33167,22056
38374,734,1236,24732,13642,2.89438e+13,569.647,4367.21,38374,448,276,37138,36898,34142,34375,31652
9708,188,947,7107,2601,2.61502e+13,187.888,2538.94,9708,311,139,8520,7166,4791,3860,1211
34010,501,1605,21806,12204,2.91654e+13,523.194,4701.46,34010,456,258,32083,29787,28164,26965,20460
76824,1868,3723,48459,28365,2.94541e+13,733.044,10914.2,76824,967,405,73101,72799,65877,62466,47386
57061,3826,3840,40210,16851,5.41022e+13,1334.06,11276.6,57061,1393,460,53221,53221,53219,53219,53177
34236,2215,3059,24770,9466,5.95941e+13,1391.26,8075.32,34236,1110,274,31177,28868,27439,27540,27976
42805,1934,2829,28409,14396,2.83634e+13,498.052,7658.82,42805,990,239,39976,39975,39199,36652,32323
43299,1619,3593,29589,13710,4.88349e+13,725.923,8832.4,43299,1009,418,39706,38781,30357,12817,14107
64175,1931,3124,42834,21341,2.97131e+13,678.406,9435.1,64175,1139,278,61051,60842,59421,54111,43034
74210,2066,2741,46256,27954,3.05151e+13,647.782,8898.79,74210,525,418,71469,71359,65517,67154,57900
24537,318,2218,17165,7372,3.74638e+13,609.942,5979.53,24537,637,201,21049,19595,16914,17264,7753
69246,1602,2225,44535,24711,2.92481e+13,593.108,7530.26,69246,620,346,67021,67017,66061,65018,59387
91868,1382,4034,61586,30282,4.02128e+13,1338.32,12683.5,91868,1275,441,86989,84490,66959,18827,22854
53850,354,2187,33343,20507,3.10144e+13,546.568,6597.57,53850,437,354,50382,47872,37657,24388,6282
21176,81,2328,14458,6718,3.00891e+13,499.409,5396.51,21176,649,204,13308,8211,7283,2794,1229
9064,100,608,5294,3770,3.22944e+13,210.361,1383.65,9064,165,103,7888,7104,5582,3085,1912
99595,2737,4103,66174,33421,3.88562e+13,1290.18,12863.1,99595,1102,443,95492,94965,86072,24965,42948
73821,556,2755,46065,27756,3.07163e+13,649.527,8935.75,73821,538,433,70437,68305,55488,40033,25192
25492,658,1518,16488,9004,2.99611e+13,424.028,4335.33,25492,358,271,23974,23790,21825,21829,16481
25376,2873,3002,18767,6609,6.52859e+13,1250.86,7000.51,25376,800,284,22374,22374,22374,22374,22121
92932,993,4294,64968,27964,4.69382e+13,1337.27,15397.3,92932,1777,540,84990,80884,62965,39392,31032
94814,1759,4127,64605,30209,4.47231e+13,1300.6,13741.2,94814,1535,475,89760,85968,68620,30977,34756
42345,15090,16696,34378,7967,1.69039e+12,95.4058,17946.4,42345,1179,140,25649,25649,23311,25496,23461
28734,1770,2165,17021,11713,3.13083e+13,294.79,4238.15,28734,586,161,26569,26569,26487,26569,26289
59198,209,3581,36648,22550,3.07555e+13,572.314,8929.13,59198,828,316,52434,47189,37674,17198,9777
22625,347,1609,16346,6279,3.05899e+13,452.059,4741.21,22625,452,184,20573,20029,11982,10427,5249
87921,1857,2912,55781,32140,3.01448e+13,695.944,9820.94,87921,644,441,85009,84816,79989,70422,69857
98760,750,3325,64284,34476,3.33365e+13,823.026,10698.9,98760,708,399,95191,93949,79033,10926,14166
76059,3200,3900,48962,27097,2.91802e+13,643.977,11547.8,76059,1234,361,72159,72157,72156,72128,67420
8187,19,1786,6244,1943,8.41735e+13,243.144,2836.76,8187,307,289,4279,3190,852,1235,201
87013,676,4239,56075,30938,2.95225e+13,780.987,12844.8,87013,1251,397,81985,80004,58993,40093,18404
27282,970,1337,16030,11252,3.19824e+13,306.195,3204.75,27282,389,179,25945,25942,24152,24883,22493
4262,188,565,2714,1548,2.78036e+13,167.463,1188.51,4262,154,103,3562,3429,3248,2944,2364
55430,2222,3647,37945,17485,4.62996e+13,957.142,9812.6,55430,1062,429,51783,50521,41571,17467,24627
20352,294,1374,13132,7220,2.94649e+13,380.301,3765.9,20352,335,246,18308,16966,15677,14347,6475
75550,1517,2365,48690,26860,2.97791e+13,584.388,8104.85,75550,628,371,73185,73167,70697,69600,60302
26660,307,1692,19291,7369,3.05125e+13,475.235,5154.26,26660,473,196,24382,23804,14358,9805,6308
47418,3144,3637,32411,15007,4.83857e+13,808.17,9159.41,47418,1010,429,43781,43709,42260,35775,27602
57160,1077,3337,39078,18082,2.81092e+13,661.408,9583.05,57160,988,281,53699,52671,43736,35718,16268
20177,916,1601,14525,5652,2.83807e+13,279.869,4440.73,20177,436,156,18576,18509,18207,18311,15049
56976,2952,3303,38794,18182,2.87747e+13,649.188,9320.16,56976,999,278,53673,53624,53671,53673,53121
64343,3084,3955,45152,19191,3.35114e+13,1055.18,11965.4,64343,1075,371,60388,60258,58972,59080,55240
29691,14444,16262,26016,3675,8.57983e+11,14.8179,16619.7,29691,1300,50,13429,13429,12146,13422,12030
68690,2249,3453,45862,22828,2.89075e+13,725.217,10313.6,68690,1149,281,65237,64970,63793,64372,53500
86861,3256,4396,59574,27287,3.67172e+13,1252.33,14487.3,86861,1393,411,82465,82184,78153,77410,71504
53907,2482,3043,35727,18180,2.92518e+13,537.893,8574.88,53907,1087,262,50864,50812,50601,50703,44791
80734,2989,3525,50584,30150,2.97129e+13,812.689,10627.8,80734,812,420,77209,77081,77199,77209,74593
44910,2298,2371,27204,17706,3.12532e+13,511.604,6117.56,44910,541,304,42539,42531,42532,42539,42538
60452,3666,3680,40714,19738,4.34896e+13,886.826,9903.43,60452,1035,417,56772,56772,56770,56764,56751
45040,84,2792,30771,14269,2.85787e+13,538.388,7858.14,45040,935,265,32020,23153,18189,5304,2287
98823,2132,4919,66685,32138,3.60462e+13,1354.56,15965.9,98823,1422,477,93904,92011,86242,86867,45622
19855,979,1023,11615,8240,3.20499e+13,282.851,2412.89,19855,318,133,18832,18832,18830,18828,18735
15428,441,1433,11065,4363,2.90966e+13,450.86,3916.18,15428,506,162,13642,12850,9202,9236,4306
89345,2348,2948,56977,32368,3.03608e+13,718.911,9924.63,89345,684,438,86397,86241,83053,81832,77981
3566,97,586,2294,1272,2.77844e+13,115.784,1123.65,3566,165,94,2852,2416,2158,1981,1028
78715,3510,4103,54420,24295,4.95625e+13,1268.65,13099,78715,1656,466,74612,74514,72524,47551,53897
75982,1928,3930,52513,23469,4.86295e+13,1293.91,12492.2,75982,1480,464,71619,67832,54877,30891,35881
71862,180,3709,45315,26547,2.99035e+13,728.075,10450.3,71862,982,401,62117,54715,43253,21361,5634
52438,1404,1555,33891,18547,3.03463e+13,610.412,5424.96,52438,507,317,50883,50882,50597,50641,50320
99712,1031,2997,63133,36579,2.95986e+13,754.794,10491.9,99712,697,455,96647,96270,82666,71739,59487
76544,1363,3619,50566,25978,3.77263e+13,884.681,10265.3,76544,979,416,72925,71728,57977,12009,12957
49198,1558,2137,30076,19122,3.12536e+13,496.961,6169.82,49198,479,314,47061,46958,42731,44395,39793
4073,552,588,2661,1412,2.97161e+13,177.082,1201.75,4073,162,105,3485,3467,3458,3463,3370
20674,570,978,13269,7405,2.89997e+13,479.126,3087.72,20674,342,221,19673,18997,18111,17146,15566
25215,1197,2936,17347,7868,4.90146e+13,503.631,6239.33,25215,768,320,22279,22046,14852,6043,4352
32901,753,2452,23598,9303,3.28061e+13,701.181,6972.6,32901,796,194,29970,29086,22183,24873,12249
65161,1589,2642,41511,23650,2.97274e+13,577.543,8326.96,65161,602,400,62519,62452,58458,52410,50208
95318,2774,3595,60060,35258,2.98412e+13,965.274,11509.1,95318,743,451,91723,91440,91139,91317,87634
62209,3384,3570,44548,17661,3.8455e+13,1099.99,11654.1,62209,1131,373,58639,58639,58594,58267,58023
72515,3070,4087,50508,22007,5.2331e+13,1339.25,12992.9,72515,1727,465,68428,68215,62501,44436,50123
78491,709,2410,50573,27918,2.91617e+13,581.954,8259.29,78491,639,380,76081,75074,65914,65527,45394
37751,2647,2661,23621,14130,2.8839e+13,339.906,6285.09,37751,949,173,35090,35090,35090,35090,35044
24757,1589,3512,17923,6834,6.79574e+13,661.596,7134.77,24757,822,415,21245,20459,14554,12550,12539
68675,2810,3490,42851,25824,2.97601e+13,706.506,9734.14,68675,900,388,65185,65140,65161,65185,61578
1982,37,538,1525,457,1.71221e+13,128.781,923.001,1982,160,61,675,247,140,76,30
12802,1496,2324,9157,3645,6.47022e+13,264.962,4105.94,12802,521,309,10478,10442,9234,7298,6801
52714,228,1419,34035,18679,2.93436e+13,589.089,5230.33,52714,526,312,46981,43753,40210,37710,18215
11380,988,2294,8425,2955,6.04993e+13,407.501,4217.1,11380,590,223,9086,8767,6299,6282,4938
69975,338,2686,44580,25395,2.98281e+13,561.957,8595.54,69975,583,411,64714,60299,53885,43300,22610
36226,86,500,24580,11646,3.36864e+13,298.535,3168.12,36226,291,224,22992,9185,15489,9632,7194
71884,1037,4235,51425,20459,5.29832e+13,1385.93,13686.6,71884,1721,542,64455,60597,45230,35802,27133
49779,2379,3083,35570,14209,4.26333e+13,1098.28,10071.8,49779,1037,340,46696,46226,42538,43935,42560
82868,1419,2439,53420,29448,2.95811e+13,606.252,8558.07,82868,628,392,80429,80411,76660,75570,62072
39605,48,3977,33665,5940,4.22156e+13,16.9918,4734.94,39605,1992,1988,35628,35628,12075,25810,23861
32877,1629,3322,24227,8650,6.50689e+13,1424.29,8254.49,32877,1047,373,28987,26660,20874,20582,19390
20767,205,960,13372,7395,2.93919e+13,459.434,3065.65,20767,333,226,18153,16764,15344,14202,5024
71578,3043,3719,51461,20117,4.59885e+13,1648.73,13054.1,71578,1547,386,67859,67558,63274,62915,62061
6853,1032,1449,4570,2283,5.9683e+13,257.83,2615.21,6853,503,105,5404,5389,5357,5395,4656
16658,1279,2247,11332,5326,4.21719e+13,863.492,5074.03,16658,788,212,14411,13800,13497,13012,8985
99284,1671,3830,62752,36532,2.9269e+13,922.196,12419.2,99284,992,468,95454,94832,85860,65703,64054
97459,1135,3907,63991,33468,3.53804e+13,1157.08,12336.5,97459,978,398,93118,92059,75121,11970,14472
81482,293,4071,51635,29847,2.95305e+13,729.535,11901.9,81482,1153,405,73475,68377,53099,32436,11267
57400,1582,3558,39602,17798,2.979e+13,775.111,10164.8,57400,972,283,53842,53460,51174,44844,30493
47043,1423,3015,33625,13418,2.98694e+13,898.147,8840.96,47043,891,260,44028,43012,41061,41369,27762
90315,12294,37415,72257,18058,118584000,1103.98,55255,90315,9065,11,52900,52900,41608,52900,16528
21992,959,1678,14664,7328,4.16396e+13,436.081,4110.16,21992,366,216,20314,20292,18567,7633,6821
8236,109,675,5329,2907,2.9784e+13,320.912,1739.44,8236,264,136,6813,6156,5352,4924,2492
2376,133,255,2019,357,4.22884e+13,16.8552,427.783,2376,131,126,2121,2121,1416,1822,1774
64638,1035,2304,41623,23015,2.92826e+13,561.048,7583.64,64638,584,364,62334,62266,57638,56193,44859
57227,609,2556,36267,20960,2.99527e+13,557.221,7769.87,57227,569,393,54397,52878,45180,38072,23912
5152,12,329,3485,1667,3.30959e+13,199.409,1124.71,5152,187,90,931,287,274,239,509
46651,180,2070,28845,17806,3.0923e+13,489.82,6038.69,46651,418,316,41821,37906,31134,17529,9000
7687,766,1595,5114,2573,5.02261e+13,429.488,2793.52,7687,435,111,6092,5659,5483,5720,2368
72318,845,2699,45225,27093,3.06678e+13,638.369,8684.39,72318,535,417,69493,68834,56504,41379,31673
55021,2373,2539,36187,18834,3.79167e+13,574.12,7013.34,55021,554,312,52482,52450,52234,52278,51541
68864,642,3479,42888,25976,3.00561e+13,746.578,9536.19,68864,718,407,64921,63778,50331,32859,21170
5571,610,1416,4142,1429,6.91129e+13,197.261,2216.68,5571,307,242,4155,4139,1660,1692,1198
53718,1252,2439,34030,19688,2.93354e+13,570.841,7476.58,53718,560,389,51279,51198,47013,40535,31624
19974,1898,7124,16305,3669,1.72991e+13,124.841,8737.82,19974,550,127,12850,12847,5562,5091,6064
8137,404,545,4753,3384,3.21537e+13,205.189,1265.77,8137,153,96,7592,7547,7240,7398,6754
32257,1319,2174,23317,8940,3.02064e+13,569.84,6261.72,32257,588,208,30083,29814,28813,29683,23057
10164,407,745,6597,3567,3.10708e+13,365.414,2005.26,10164,281,147,9260,8723,8522,8150,6997
22570,1295,1726,16373,6197,2.79296e+13,371.915,4835.42,22570,471,174,20844,20812,20708,20834,19269
57142,68,2529,35300,21842,3.02987e+13,593.641,7462.39,57142,477,373,45554,37113,33176,18603,3247
75010,3709,3822,49542,25468,3.7545e+13,1044.85,10672.8,75010,968,420,71188,71188,71171,71182,70662
70981,3361,3801,48927,22054,4.88811e+13,1172.72,11620.6,70981,1362,471,67180,66966,65295,55341,46955
17589,739,1062,11369,6220,3.01327e+13,453.108,2983.45,17589,340,198,16527,16221,15937,15440,15526
16106,861,885,10398,5708,2.97973e+13,436.594,2682.7,16106,330,201,15221,15221,15203,15196,15199
88657,36231,36751,70932,17725,120931000,1100.76,54259.6,88657,8899,11,51906,51906,51777,51906,51260
56839,1931,3596,36239,20600,2.97734e+13,506.284,9512.32,56839,1206,264,53243,53238,52711,53174,36166
2599,134,514,1717,882,3.2924e+13,105.458,943.373,2599,163,72,2075,1919,1698,1684,1329
8301,631,708,5394,2907,2.98051e+13,346.098,1798.91,8301,269,140,7593,7583,7522,7536,7410
95454,1214,4422,67488,27966,4.62857e+13,1603.49,16184.7,95454,1866,570,87895,83496,65547,52230,31434
96924,2580,4616,68584,28340,4.36294e+13,1709.93,16199.6,96924,1715,604,92106,90632,78784,76502,63312
24639,1078,1690,14792,9847,3.18021e+13,278.653,3821.24,24639,354,177,22949,22929,19086,19908,13308
95139,519,785,64549,30590,3.3586e+13,304.184,5311.98,95139,314,276,94354,94354,79833,83526,76701
6597,373,511,3852,2745,3.22599e+13,193.193,1128.82,6597,132,95,6086,6045,5750,5895,5254
66004,1612,3400,41334,24670,2.95466e+13,652.31,9533.89,66004,952,380,62604,62395,55499,52838,40495
37879,225,2542,26530,11349,2.79056e+13,565.82,7116.02,37879,860,261,32402,29109,19201,9121,3143
47374,3352,3860,33932,13442,5.89141e+13,1311.18,10460,47374,1314,463,43514,43447,42817,35511,37050
32224,1480,1782,20739,11485,3.01165e+13,601.021,4952.57,32224,445,301,30442,30430,30129,30251,29091
39781,828,2216,25347,14434,2.99021e+13,556.372,6159.83,39781,479,342,37565,37099,32280,27193,15329
57297,17510,18227,46884,10413,2.53753e+13,4514.6,28186.6,57297,5477,20,39070,39070,39070,39070,37639
3547,548,597,2592,955,2.23107e+13,124.188,1255.11,3547,268,92,2950,2950,2929,2930,2577
96236,3012,4252,65810,30426,4.58335e+13,1359.75,14847,96236,1824,533,91984,91674,83779,50590,63384
65830,50,2615,41272,24558,3.05171e+13,615.11,8335.62,65830,530,401,48077,36341,34681,18639,4676
40962,798,2911,29106,11856,4.60558e+13,1124.46,9020.68,40962,1092,325,36403,34469,28433,26505,18479
14660,200,1484,12460,2200,4.22365e+13,16.9784,1938.45,14660,745,740,13176,13176,5507,9975,9142
85807,4688,4792,57418,28389,3.78815e+13,1263.18,14544.1,85807,1243,407,81015,81013,81008,80940,80665
15371,1205,1902,10785,4586,3.72917e+13,444.584,4419.9,15371,579,140,13469,13052,12950,12869,11919
78735,524,3750,53192,25543,4.23087e+13,1121.75,11548.7,78735,1287,439,71993,67403,51368,12036,10458
36308,3616,12711,29620,6688,1.7325e+13,128.277,15403.5,36308,922,152,23597,23593,10899,9468,10835
65849,18359,19644,54018,11831,2.72384e+13,4597.44,30638.1,65849,7479,22,46205,46205,45608,40301,44240
43785,5404,15530,36069,7716,2.74842e+13,2641.83,22532.1,43785,5197,17,28255,22917,22397,25113,12138
83995,2588,3960,55529,28466,3.85667e+13,1209.46,11640.2,83995,1037,429,80035,79370,70169,21393,31593
57247,494,2194,37220,20027,3.27605e+13,585.476,6535.55,57247,577,330,54369,50331,45005,5964,6387
17968,1468,1500,11924,6044,4.0172e+13,413.245,3592.5,17968,390,200,16468,16468,16466,16458,16422
61123,418,2251,39724,21399,3.2999e+13,571.104,6764.84,61123,556,333,57101,52724,47362,5927,5655
53001,1615,2416,33518,19483,3.02377e+13,547.296,7345.72,53001,564,369,50585,50543,46806,42951,41386
37457,1533,2620,24102,13355,2.89936e+13,409.152,6729.26,37457,995,191,34837,34834,34295,32522,22461
39032,9429,16900,31228,7804,117591000,865.584,24484.9,39032,3922,11,22132,22132,19676,22132,12218
20134,2232,2552,15098,5036,6.62697e+13,1066.17,5884.13,20134,747,252,17582,16602,15968,16003,16037
57916,769,2096,37326,20590,2.95392e+13,567.288,6610,57916,512,323,55820,55484,49595,49925,41682
20564,148,2073,17484,3080,4.21475e+13,17.024,2619.2,20564,1039,1034,18491,18491,6978,13688,12373
7103,499,619,4627,2476,2.98769e+13,242.417,1482.19,7103,192,104,6484,6290,6386,6361,5961
84948,102,4368,60509,24439,4.85093e+13,1442.72,15118.3,84948,1765,564,62363,49148,32661,17467,5415
60956,407,2582,38267,22689,3.01943e+13,583.225,7999.16,60956,525,399,57106,54031,45301,34681,15952
2987,141,606,2198,789,9.13978e+13,187.072,1000.62,2987,60,162,2240,1973,681,1191,783
54368,1563,2544,34101,20267,3.05888e+13,580.981,7369.28,54368,525,375,51824,51741,46236,39256,38358
43942,692,3241,27316,16626,2.92997e+13,419.466,7455.75,43942,1015,200,40701,40284,28186,17538,7160
22998,1405,1510,14846,8152,2.89575e+13,409.341,4067.13,22998,386,248,21488,21484,21424,21399,21157
44420,916,3206,31737,12683,3.96054e+13,928.053,9422.03,44420,871,315,40279,38561,30288,30412,14004
5492,582,793,3989,1503,2.91932e+13,232.575,1806.67,5492,321,94,4699,4597,4562,4354,2888
21799,44,970,14032,7767,2.87684e+13,493.772,3130.28,21799,386,215,14382,8619,10446,7343,2107
73945,819,3750,46567,27378,2.92228e+13,681.623,10530.3,73945,968,396,70035,69015,53852,34987,19336
60194,909,3622,42053,18141,3.14614e+13,962.866,11101,60194,1029,304,55652,53367,38533,29280,10129
50258,561,2060,32252,18006,2.89409e+13,565.878,6582.33,50258,538,332,47939,45626,41613,39915,27360
33945,1284,1772,21307,12638,3.00741e+13,449.858,5037.53,33945,424,277,32173,32166,30158,30710,26461
51357,616,3676,35555,15802,4.90264e+13,1044.62,9963.4,51357,1200,424,45723,44016,29227,9891,8141
22186,1144,2133,14599,7587,2.65085e+13,350.765,5005.23,22186,785,176,20053,20046,18851,18082,10494
9521,337,735,6146,3375,2.87646e+13,334.533,1909.61,9521,284,145,8596,8172,8031,7555,6173
91508,2240,3992,60092,31416,2.98e+13,751.09,12860.8,91508,1259,402,87516,87257,86194,86846,56983
24451,1217,1502,15840,8611,3.06552e+13,428.965,4268.86,24451,383,263,22949,22942,22532,22117,19897
53806,1512,3158,38752,15054,4.32899e+13,1248.98,10632.6,53806,1152,355,50002,47247,43008,40598,33960
77034,403,3780,55361,21673,4.29823e+13,1519.16,13515.5,77034,1440,402,65645,61313,37048,21240,18553
62767,2782,4079,44415,18352,5.53397e+13,1444.82,12510,62767,1665,507,58688,58500,52220,44289,47144
83866,2788,3510,52478,31388,3.02694e+13,892.56,10407.6,83866,648,454,80356,80194,80291,80344,79512
24392,72,2689,17177,7215,5.88533e+13,1053.72,6660.68,24392,1001,234,15919,11046,7851,7280,1447
84664,945,2906,53259,31405,3.03538e+13,710.249,9719.65,84664,654,447,81661,81094,68181,55506,44503
9041,5182,7219,7057,1984,2.5048e+13,1.45006,7748.31,9041,1179,11,1822,1822,1822,1822,1822
89338,3652,4444,60568,28770,3.5937e+13,1209.65,14385.2,89338,1324,418,84894,84723,81603,82449,79722
42918,1669,1851,27669,15249,2.99618e+13,554.076,5627.75,42918,518,292,41067,41067,40919,40899,40112
65424,1563,3748,45127,20297,3.12899e+13,965.351,11642,65424,1087,306,61665,60524,57436,49275,33874
73282,1962,4121,50954,22328,5.02067e+13,1278.79,12703.4,73282,1528,486,68766,64920,50808,32127,34457
3002,19,384,2188,814,3.38614e+13,160.939,932.215,3002,171,81,1329,415,351,278,69
82324,1898,2805,52786,29538,2.99513e+13,655.337,9352.11,82324,668,422,79519,79448,76134,71438,69587
53206,3232,3631,36265,16941,4.74837e+13,865.937,9543.26,53206,1005,423,49575,49441,47980,42418,33272
71903,228,3899,51836,20067,4.98158e+13,1560.24,13231.5,71903,1468,539,58014,51310,30380,20065,4492
3712,368,577,2412,1300,3.01035e+13,129.313,1137.34,3712,148,95,3135,3097,2971,2860,2715
54267,3459,3549,34843,19424,2.90925e+13,523.899,9093.23,54267,1197,234,50718,50718,50718,50718,50578
63373,1105,3781,40623,22750,2.9147e+13,537.083,10281.2,63373,1220,297,59592,59001,46808,38513,21034
86819,426,2813,55726,31093,2.89299e+13,640.226,9377.15,86819,714,416,81624,75725,69225,65226,40707
79162,112,2820,49861,29301,3.08755e+13,678.84,9299.13,79162,578,445,67155,60615,49770,32864,8841
72689,44,3672,49207,23482,4.30397e+13,1085.07,11111.5,72689,1245,428,45196,28270,26737,6368,1775
78689,909,2721,50510,28179,2.9731e+13,640.169,8998.29,78689,663,414,75968,75500,67187,63931,48505
22236,557,1053,14404,7832,3.05441e+13,466.978,3268.79,22236,370,215,21130,20645,19746,19308,18506
4101,641,995,2762,1339,6.93544e+13,188.665,1724.78,4101,362,61,3106,2927,2852,2877,2577
90718,1838,2937,57530,33188,3.00946e+13,719.328,10001.2,90718,696,451,87781,87547,81837,70219,69704
67039,599,2236,43201,23838,2.96823e+13,597.259,7540.52,67039,629,339,64575,62177,55187,54870,38856
2720,859,927,1926,794,7.39343e+13,88.1364,1368.32,2720,226,82,1793,1793,1793,1793,1763
78072,17859,42717,68397,9675,8.62756e+11,17.8385,43309.2,78072,2966,51,35355,35349,17673,18070,16050
37773,987,1838,24329,13444,2.94082e+13,521.284,5609.97,37773,471,304,35935,35890,34182,33199,26213
9092,908,1395,5420,3672,3.12587e+13,176.826,2246.02,9092,275,109,7697,7697,7599,7697,7441
33030,1312,1869,19608,13422,3.15797e+13,327.212,4363.4,33030,447,192,31161,31122,27860,29116,25043
70536,385,3787,45225,25311,2.94909e+13,585.902,10942.9,70536,1229,331,64554,60569,44856,25575,13892
29907,2136,2186,21233,8674,3.39166e+13,767.494,6454.45,29907,745,194,27721,27721,27721,27721,27606
79525,3678,3909,54715,24810,4.72926e+13,1243.22,12393.3,79525,1390,467,75616,75616,74702,71971,68236
97141,1328,4176,64051,33090,2.94603e+13,910.676,13601.8,97141,1261,409,92751,91891,76031,65990,39611
89796,2262,4371,63410,26386,4.70516e+13,1405.81,15389.9,89796,1767,563,85233,81818,68399,58770,56105
87070,244,4367,62234,24836,4.82422e+13,1670.05,15428,87070,1781,570,71397,64000,39165,19701,7932
98687,928,4834,70460,28227,4.53522e+13,1744.86,16901.7,98687,1851,625,89135,84488,54884,40298,15400
95786,765,4105,65524,30262,4.66802e+13,1336.64,14192.1,95786,1757,482,87327,84693,61422,23754,20093
33557,645,3499,23361,10196,5.45655e+13,672.573,7991.28,33557,922,424,29368,28700,19688,8771,8149
10374,207,1210,6641,3733,3.09128e+13,213.203,2564.16,10374,263,152,8933,8445,7354,5505,3581
68318,1999,3644,49046,19272,4.05742e+13,1251.23,12466.9,68318,1319,381,64515,62548,57863,55732,47507
40919,417,1821,26424,14495,2.96061e+13,523.957,5744.73,40919,452,329,38333,35654,32197,31610,12836
67684,1182,16653,52267,15417,2.47131e+13,996.807,26649.4,67684,4118,243,49600,46684,33443,13553,4270
60925,1002,3494,43434,17491,4.04848e+13,1118.1,11607.1,60925,1260,349,56107,53251,44522,44640,21708
55972,308,3774,40264,15708,5.59322e+13,1499.28,11505.4,55972,1457,502,44554,39926,24768,21220,8602
37666,1967,2086,24199,13467,3.00958e+13,577.322,5934.33,37666,499,334,35580,35580,35514,35566,35111
54362,334,2478,34351,20011,3.02781e+13,542.371,7502.47,54362,516,383,50078,46797,40364,31768,15126
56173,2239,2505,35204,20969,3.03499e+13,536.894,7482.15,56173,515,374,53668,53634,52945,53256,51228
14267,434,941,10415,3852,3.19943e+13,203.795,2934.76,14267,322,133,13326,13311,12425,12984,7719
14517,888,4610,12361,2156,2.68414e+13,65.1593,7475.56,14517,1969,12,9907,9811,8344,6925,1816
79499,255,2883,49660,29839,3.02678e+13,665.298,9342.08,79499,561,446,72671,68129,56031,37742,11727
57142,3883,4085,40640,16502,5.76896e+13,1556.06,12054.6,57142,1577,518,53057,53057,53028,52935,52062
91224,1540,3145,59306,31918,3.29265e+13,748.933,10001.8,91224,727,392,88079,87831,80053,75588,52979
79420,2146,2891,50094,29326,3.03494e+13,677.302,9441.08,79420,593,436,76529,76358,71910,69951,63509
87688,764,2663,56491,31197,2.97687e+13,633.422,9012.81,87688,723,393,84978,84049,72654,71645,48802
18725,396,1858,11806,6919,2.648e+13,304.77,4032.99,18725,645,137,16253,14794,12290,12372,7431
14606,13,981,9435,5171,2.93496e+13,383.675,2673.04,14606,317,193,5419,2105,2141,1057,561
96616,2014,2907,61854,34762,2.99005e+13,707.258,10091.5,96616,720,439,93709,93594,90404,84488,84192
38538,947,1799,24953,13585,3.02411e+13,618.066,5586.71,38538,519,308,36739,36459,33223,31698,20831
80861,999,4381,53751,27110,3.11315e+13,919.053,12873.2,80861,1343,297,75780,73969,54300,45167,20047
63534,2620,3529,39842,23692,2.95015e+13,559.963,9531.09,63534,1063,319,60005,60004,59970,60003,54358
7706,890,1398,5079,2627,2.19579e+13,312.761,2610.52,7706,475,120,6308,6300,5815,6006,3019
5615,365,463,3276,2339,3.25913e+13,163.786,1004.68,5615,115,87,5152,5133,4987,5058,4651
91312,243,4681,60434,30878,3.12738e+13,976.835,14385.6,91312,1358,376,80368,73817,51245,15263,5946
65202,83,2194,42046,23156,2.95404e+13,579.107,7517.02,65202,572,376,51834,41266,39027,35731,7462
32784,1600,2387,23205,9579,2.75679e+13,589.34,6545.77,32784,826,246,30397,30387,29409,30113,23088
28184,1137,2400,18023,10161,2.75189e+13,326.699,5573.52,28184,812,171,25784,25777,24639,23591,16180
87021,2680,4231,60580,26441,4.73746e+13,1334.65,14753.1,87021,1804,526,82790,82256,73398,52963,58212
26195,908,1052,16964,9231,3.01082e+13,502.747,3483.93,26195,382,239,25143,25138,24787,24731,24483
29320,2585,3484,21337,7983,6.57347e+13,1264.61,7886.43,29320,1040,425,25836,24892,21095,22475,22693
62504,2003,3756,40357,22147,2.95822e+13,576.887,10326.2,62504,1224,310,58748,58691,57906,58514,37139
78469,698,3301,51528,26941,3.54968e+13,885.404,9777.7,78469,736,367,74650,73823,58297,8333,8594
15621,881,1173,10050,5571,2.8559e+13,342.643,2992.23,15621,356,206,14448,14417,13977,13417,10914
37466,585,2652,23380,14086,2.87994e+13,336.241,6239.71,37466,944,172,34755,33067,27569,23905,18852
55195,1699,3098,36709,18486,3.84681e+13,750.445,8101.35,55195,748,344,52097,51631,42490,10376,12194
83148,3403,3847,56351,26797,4.35464e+13,1166.3,12001.2,83148,1358,468,79301,79042,76847,63606,53513
35377,45,1683,22754,12623,2.94383e+13,491.822,5149.47,35377,417,290,23242,14037,16955,9542,2618
38592,971,2856,27483,11109,4.4049e+13,861.328,8586.89,38592,933,313,35005,33465,29306,27097,22417
58544,1107,3764,40216,18328,4.80324e+13,1140,10696.5,58544,1313,458,53524,51474,37756,15187,18229
56054,72,2203,36505,19549,3.33646e+13,546.946,6445.1,56054,587,326,42899,31546,31078,3523,1647
12344,751,1613,8485,3859,5.70481e+13,262.271,3275.91,12344,317,222,10731,10667,9439,4857,4609
9580,302,721,6183,3397,2.9793e+13,351.884,1950.69,9580,288,158,8576,7939,7656,7294,5836
11622,48,1216,8227,3395,3.16346e+13,423.221,3159.11,11622,490,123,4916,2047,1855,1370,603
30867,603,2653,21742,9125,3.97341e+13,802.323,7404.96,30867,817,275,26843,25430,22048,20480,13873
74982,592,3922,53783,21199,4.75359e+13,1706.31,13630.6,74982,1623,452,64640,60912,38402,36783,17733
3857,356,894,2455,1402,2.79518e+13,111.491,1497.8,3857,201,104,2963,2893,2756,2585,2199
44892,2473,3760,32576,12316,6.25363e+13,1475.77,10027.1,44892,1258,448,41132,39862,34349,34381,36262
97889,2882,4162,62804,35085,2.93e+13,832.66,13479.3,97889,1242,445,93727,93557,93633,93658,79422
2021,163,245,1341,680,3.0792e+13,170.232,664.473,2021,142,64,1636,1109,1274,1263,1480
83895,3154,4015,54335,29560,2.93336e+13,676.809,12199.4,83895,1259,378,79880,79878,79865,79751,72058
65710,317,2644,41043,24667,3.03281e+13,634.025,8266.28,65710,542,399,60722,57200,46790,33186,13611
57294,309,3641,38465,18829,4.32486e+13,799.443,9610.51,57294,1011,417,49966,45321,36717,7256,5121
81764,3693,3938,53915,27849,3.749e+13,1093.57,11282.3,81764,1008,430,77826,77826,77680,77679,76144
84714,135,2898,53352,31362,3.02447e+13,703.21,9703.53,84714,598,439,72790,67256,55319,37055,12136
54730,1569,2007,35366,19364,3.03276e+13,610.439,6863.54,54730,520,353,52723,52719,51481,50584,48443
67319,2415,3641,48325,18994,4.61905e+13,1566.72,12595.5,67319,1402,375,63526,62132,54495,55651,49054
20608,1191,2884,14951,5657,5.90108e+13,1138.22,6204.58,20608,899,234,17275,15951,11153,11450,10121
40577,1938,2999,27244,13333,4.09223e+13,617.498,7298.95,40577,781,332,37578,37282,32379,11053,12580
85253,3322,4471,56618,28635,3.1e+13,900.228,13525.8,85253,1352,355,80782,80718,80765,80749,70132
47050,1092,3358,33730,13320,5.38466e+13,1600.76,10175.8,47050,1434,345,41306,38124,28681,26698,18110
51582,2515,3391,36884,14698,5.17178e+13,1352.16,10678.9,51582,1342,346,48191,47591,43670,43840,43310
22465,548,1514,14500,7965,2.96696e+13,506.592,4067.21,22465,421,243,20819,20151,18482,17530,8190
56938,2889,3060,37861,19077,2.94032e+13,574.029,8837.99,56938,1100,265,53878,53796,53860,53878,51704
54518,2022,2332,35088,19430,2.94335e+13,616.711,7312.63,54518,565,374,52186,52183,51952,51969,51156
33130,2880,3329,28161,4969,4.2213e+13,16.9906,4020.77,33130,1668,1663,29801,29801,27132,28685,28476
92851,4321,4559,66184,26667,4.43285e+13,1738.47,15878.8,92851,1685,604,88292,88289,88238,87735,87691
35693,999,1677,23049,12644,2.98719e+13,509.283,4948.01,35693,426,265,34016,33995,33353,33357,31606
39701,735,3337,28870,10831,6.32329e+13,1466.56,9025.4,39701,1175,436,33209,31793,17105,15776,13813
47850,1874,2887,34118,13732,3.04111e+13,887.311,8832.16,47850,928,253,44963,44818,44124,44430,38507
18608,181,1260,13537,5071,3.13482e+13,232.817,3767.51,18608,387,155,16745,15520,11202,11714,4095
56820,3563,3743,39720,17100,5.30236e+13,1134.81,10781.5,56820,1330,469,53077,53070,52558,51186,48508
97964,1549,3002,62018,35946,3.01927e+13,724.701,10400,97964,690,456,94962,94640,85675,72646,65047
38128,1294,1762,24589,13539,2.94701e+13,515.818,5548.36,38128,476,307,36366,36365,35288,34457,31826
40102,1234,1308,25844,14258,2.93461e+13,574.06,4571.36,40102,485,286,38794,38794,38691,38716,38620
84385,1307,4254,59548,24837,4.86502e+13,1341.41,14769,84385,1736,540,77856,73524,58160,40980,34835
94460,3187,3708,59621,34839,2.91575e+13,928.006,11832.6,94460,969,460,90752,90541,90743,90752,86994
39454,108,1295,25439,14015,2.96426e+13,567.253,4507.48,39454,480,279,32463,28925,24846,21966,7334
91302,826,4071,57980,33322,2.92954e+13,832.639,12482,91302,1100,432,86758,85551,68166,49441,33512
90523,2493,2941,56765,33758,3.00504e+13,689.841,10017,90523,611,454,87582,87480,84051,85383,80111
12049,1132,6608,10554,1495,8.67773e+11,14.7595,6831.07,12049,782,42,5441,5441,1551,3104,1192
39194,192,1918,24296,14898,3.15761e+13,450.637,5458.87,39194,410,288,35198,32008,25827,15381,5974
29933,1558,1731,18794,11139,3.07337e+13,448.844,4759.73,29933,435,260,28202,28202,27932,28010,26770
59849,1702,2079,38553,21296,2.9507e+13,601.615,6464.89,59849,619,325,57770,57768,57640,57635,56768
9459,195,584,5509,3950,3.15246e+13,220.206,1381.6,9459,147,109,8742,7928,6889,6013,3871
21583,812,991,13880,7703,2.91089e+13,470.13,3169.91,21583,330,227,20592,20585,20160,20157,19722
84694,1399,3992,55717,28977,2.96704e+13,743.903,12443.6,84694,1249,396,80702,80029,66442,58961,33595
9440,334,717,6872,2568,3.07849e+13,188.001,2137.96,9440,259,131,8723,8716,7522,7985,4291
7816,42,834,5698,2118,2.8517e+13,175.534,2101.31,7816,303,131,4888,2309,2783,1151,386
32657,59,3589,22979,9678,5.80989e+13,709.746,8128.65,32657,973,418,21393,14760,10568,4674,1742
46720,1512,2827,29881,16839,2.93039e+13,442.879,7550.18,46720,1137,197,43893,43884,43122,39309,27779
77872,1878,4044,52589,25283,3.15897e+13,1030.92,12760.9,77872,1229,329,73828,73205,70283,61950,44695
34015,2873,2881,24158,9857,5.23372e+13,1406.42,8297.67,34015,1148,327,31134,31134,31134,31134,31126
89292,12380,23910,73196,16096,2.5335e+13,5398.11,39039.9,89292,8089,26,65382,54961,56662,59246,43147
71719,1239,3848,46550,25169,2.94571e+13,629.728,11160.1,71719,1238,359,67871,67208,55007,47832,27777
57807,2395,3513,41166,16641,4.08203e+13,1107.56,11316.5,57807,1172,349,54294,53829,49803,50320,45431
62932,22532,26460,50350,12582,121739000,1025.15,38824.6,62932,6319,11,36472,36472,35490,36472,31571
77737,2358,7777,66100,11637,4.2132e+13,17.0398,8856.33,77737,3891,3886,69960,69960,37477,56421,52308
96571,1922,4502,65265,31306,3.62954e+13,1238.91,15056.6,96571,1406,416,91963,89958,83422,74153,52341
56926,1562,2385,36650,20276,2.98221e+13,613.613,7474.65,56926,583,377,54541,54496,52795,50428,48570
80690,226,4007,51151,29539,2.92518e+13,740.75,11693.7,80690,1091,405,71440,65074,51090,26026,10697
16829,1289,2057,11041,5788,2.6217e+13,294.794,4302.66,16829,675,160,14772,14767,14457,14636,12162
54817,157,3243,38865,15952,3.28298e+13,946.179,10224.9,54817,1005,304,42501,33650,25319,9060,7377
41612,453,3301,27957,13655,4.236e+13,614.277,8028.24,41612,902,350,37326,34789,26438,5817,3454
66835,2288,3871,46626,20209,5.10422e+13,1275.25,11963.4,66835,1482,459,62964,60013,52021,34495,40455
80519,656,2487,52026,28493,2.98027e+13,570.395,8448.75,80519,643,386,77997,76823,66445,66402,42907
82840,671,2839,52557,30283,3.04574e+13,690.851,9528.86,82840,660,436,79665,78312,65376,55364,36947
93744,3873,4398,66711,27033,4.65479e+13,1663.48,16119.2,93744,1892,571,89346,89228,88707,80778,82636
35614,1794,1974,21873,13741,3.10475e+13,430.663,5262.38,35614,379,282,33640,33634,33377,33463,32601
75690,3251,3750,54481,21209,4.31876e+13,1503.43,13369.9,75690,1409,404,71940,71738,69689,68378,68370
44245,981,1327,28539,15706,2.99189e+13,556.855,4783.68,44245,488,289,42918,42898,41460,41250,39976
49966,3665,3781,35401,14565,5.72972e+13,1174.83,10395.3,49966,1337,462,46185,46184,45981,45268,44818
20329,1273,2568,14082,6247,4.33355e+13,853.748,6021.12,20329,806,260,17658,16940,15402,14561,10242
11835,589,832,8623,3212,3.2002e+13,198.594,2547.99,11835,287,124,11003,11003,10680,10920,8738
99173,3918,4539,65487,33686,2.9297e+13,970.217,14304.4,99173,1271,414,94634,94530,94634,94634,91781
29635,18,1579,19048,10587,2.89688e+13,482.173,4529.02,29635,428,263,13515,5268,7251,2089,1352
26394,5567,11845,21116,5278,116126000,664.642,16902.1,26394,2655,11,14549,13184,12773,14549,6674
49651,997,2990,35885,13766,5.01243e+13,1288.85,10157.9,49651,1168,349,44358,41932,33163,30754,23187
90936,305,4213,65498,25438,4.59647e+13,1698.01,15344.4,90936,1706,586,75242,68586,39891,21722,15780
45721,166,1341,29465,16256,2.88238e+13,553.198,4816.64,45721,451,292,39538,37228,32491,28411,13391
65389,2162,4061,45794,19595,5.26146e+13,1302.59,12207.7,65389,1515,461,61224,57685,46820,33124,35617
49247,837,3256,35085,14162,3.58103e+13,905.767,9888.3,49247,940,313,45022,43209,33665,35497,16348
89602,2457,3557,56334,33268,2.9838e+13,932.319,11096.1,89602,735,456,86045,85658,82834,84123,78010
71533,80,3937,48556,22977,3.18559e+13,955.387,12121,71533,1148,302,51124,38322,28657,7375,3897
9257,379,709,6005,3252,3.19864e+13,334.63,1915.19,9257,234,153,8471,7917,7910,7713,5982
42821,1236,2950,30609,12212,4.64879e+13,1266.87,9358.06,42821,1145,319,38746,36530,31669,29236,23522
4580,16,904,3570,1010,9.1564e+13,157.764,1598.05,4580,116,118,2183,1485,455,933,265
55243,239,3082,36215,19028,2.93812e+13,565.395,8659.34,55243,1138,258,49037,45159,30280,12854,9903
78013,2103,2747,49643,28370,3.00808e+13,666.312,9129.45,78013,638,426,75266,75178,72078,71088,66634
81567,2040,2781,52392,29175,2.94483e+13,620.278,9169.77,81567,690,418,78786,78764,76810,75563,73867
43316,2534,2950,26484,16832,2.92675e+13,430.315,6913.72,43316,878,232,40366,40366,40366,40366,38491
11377,544,1976,7563,3814,4.90167e+13,568.733,3864.61,11377,585,165,9007,8247,7871,7729,2463
56631,320,3513,40437,16194,4.08253e+13,1099.57,11194.4,56631,1122,357,48302,45297,27761,23268,7238
42900,736,2846,30452,12448,3.3881e+13,811.244,8562.46,42900,917,224,39329,37828,29984,31563,12616
96561,3376,4389,68924,27637,4.58388e+13,1658.15,16297.4,96561,1898,595,92172,91707,87491,79580,81170
50242,3210,3826,35819,14423,5.72487e+13,1307.64,10648.7,50242,1287,459,46416,46278,44741,34339,36242
80513,2580,4011,52553,27960,2.94027e+13,700.144,12114.5,80513,1240,387,76502,76331,75716,76180,51753
30207,1590,1709,19522,10685,2.97717e+13,497.429,5018.83,30207,463,286,28498,28498,28411,28432,28377
43306,1499,2940,30976,12330,3.91326e+13,915.579,9049.11,43306,838,319,40320,38809,36539,34733,30175
3127,171,546,2002,1125,2.79048e+13,114.161,1028.3,3127,150,86,2551,2435,2288,2211,1828
10313,594,1600,6402,3911,2.67007e+13,224.889,2802.29,10313,350,112,8713,8640,7935,8237,6682
39254,608,2250,28286,10968,2.76417e+13,645.106,7032.68,39254,760,231,36419,34759,24813,16880,20225
16313,744,1321,10343,5970,3.03457e+13,278.185,3241.95,16313,301,204,14992,14976,13838,13670,11224
30003,1679,2466,18937,11066,2.83817e+13,327.922,5661.42,30003,847,165,27537,27537,27181,27185,24307
50506,714,2359,33211,17295,3.80991e+13,540.768,6631.86,50506,522,299,48147,47667,39602,8507,7805
49207,236,1991,32012,17195,3.30508e+13,571.536,5954.3,49207,493,308,43530,40212,35103,4293,3398
76947,1934,4034,55256,21691,4.20163e+13,1313.16,13693.6,76947,1357,430,72569,70200,62030,60075,41232
66746,3521,3593,47675,19071,3.94045e+13,1242.82,12252.1,66746,1330,379,63153,63153,63125,63140,62930
64463,897,3911,44934,19529,5.16314e+13,1236.86,11649.2,64463,1376,469,58014,55954,37486,16519,11526
66454,842,4073,46399,20055,5.24893e+13,1306.65,12401.2,66454,1624,459,59013,56494,38379,20672,13831
67790,1753,3803,43319,24471,2.95291e+13,584.153,10744.8,67790,1233,322,63987,63884,60636,60638,40816
53192,3538,4043,38021,15171,6.0218e+13,1411.77,11408.4,53192,1596,460,49149,49127,48671,44080,44604
70579,4228,4253,50244,20335,5.19187e+13,1397.47,13681.2,70579,1746,533,66326,66326,66322,66295,66276
64849,2081,3628,41063,23786,2.98566e+13,560.838,10045.1,64849,1148,319,61221,61192,60859,61181,48899
90062,86,3072,58125,31937,3.13739e+13,855.65,10087.6,90062,778,434,71940,58540,52266,5402,2282
66307,2830,3889,46123,20184,5.05205e+13,1251.52,11761.2,66307,1351,475,62418,62148,56197,33566,41866
23987,529,1022,15534,8453,3.05562e+13,510.823,3355.22,23987,387,229,22823,21354,20382,19706,14976
77333,762,2452,49821,27512,2.95982e+13,606.33,8240.98,77333,617,354,74881,74112,65146,65469,51267
9762,64,591,6295,3467,2.92068e+13,311.002,1739.85,9762,213,155,7405,5335,5838,5718,1986
79768,1875,3605,52406,27362,3.52118e+13,1031.53,10526.4,79768,844,359,76163,75271,64894,13955,20922
27307,718,1418,17629,9678,2.99995e+13,540.258,4137.92,27307,429,259,25867,25364,24266,22978,22895
57660,82,2427,35515,22145,3.0953e+13,600.732,7164.14,57660,493,383,47532,40882,33959,17730,3310
75421,1298,3162,49339,26082,3.53135e+13,802.982,9149.51,75421,622,341,72259,71866,62053,11836,16446
89091,1264,4202,62303,26788,4.76721e+13,1326.94,14883,89091,1771,538,82489,78325,61479,38003,31424
97285,2434,4262,67506,29779,4.60641e+13,1330.68,15372.8,97285,1781,543,93023,90858,77353,51953,57257
60499,1603,3641,38949,21550,2.91989e+13,537.455,9855.33,60499,1208,279,56858,56785,54211,53864,32797
84121,1284,8415,71527,12594,4.21399e+13,17.0368,9538.07,84121,4211,4206,75706,75706,32953,57888,49439
41106,2797,2862,29110,11996,3.49352e+13,787.507,8494.89,41106,853,233,38244,38244,38244,38244,38061
42749,2314,2673,29454,13295,2.85107e+13,546.914,7570.77,42749,914,263,40076,40076,39964,40051,36142
84319,2665,4016,55512,28807,2.99175e+13,754.932,12459.1,84319,1264,399,80303,80066,79403,79893,54867
19167,1848,2372,13296,5871,5.2402e+13,437.077,4898.67,19167,567,309,16795,16698,15932,8476,9211
19908,80,1181,12849,7059,2.94866e+13,452.292,3254.82,19908,339,210,15558,12220,11563,10602,3831
59378,2173,4160,42040,17338,5.70878e+13,1502.21,12281.1,59378,1700,493,55086,51352,40973,35952,36224
63800,1829,3796,44172,19628,4.98653e+13,1124.07,11191.3,63800,1353,468,59591,57084,45623,23474,30067
28367,253,1238,16581,11786,3.1923e+13,322.719,3086.38,28367,408,161,26818,25718,18297,11362,8611
35743,1586,1754,23018,12725,2.97666e+13,538.096,5173.29,35743,463,290,33989,33989,33647,33537,33723
82474,1580,3669,51789,30685,2.93184e+13,836.54,11107.7,82474,965,420,78805,78305,69413,50806,51076
73562,3228,3707,49772,23790,4.23969e+13,1120.49,11160.1,73562,1220,433,69855,69634,67397,55999,46085
54406,286,2487,34405,20001,3.00856e+13,542.616,7517.66,54406,519,387,49562,46216,39755,28154,7523
39980,652,2125,25377,14603,2.98756e+13,547.113,5955.5,39980,498,329,37714,36923,31427,25684,13232
80939,1795,2518,52001,28938,2.877e+13,615.868,8401.24,80939,687,369,78421,78419,77253,75620,68585
87836,219,4347,61592,26244,4.03288e+13,1334.98,14821.8,87836,1435,444,72755,64878,41674,19039,6445
7028,118,546,5131,1897,3.05924e+13,180.795,1662.93,7028,220,115,6039,5471,3864,2783,1911
48948,1477,3395,35067,13881,5.21282e+13,1363.4,10472,48948,1295,348,44551,41478,34162,32487,27175
97748,996,4548,68007,29741,4.12981e+13,1546.97,15875.6,97748,1605,457,89896,85551,63585,47546,23558
60900,2306,3752,41941,18959,3.09467e+13,837.405,10901.7,60900,1042,286,57148,57088,56204,56780,43094
5320,307,645,3430,1890,3.01058e+13,279.319,1441.93,5320,215,136,4590,4252,4029,4010,2817
16364,1112,1838,9743,6621,3.11473e+13,239.493,3210.34,16364,370,139,14526,14526,14348,14526,14010
61922,1745,3599,44464,17458,4.72225e+13,1581.51,12042.9,61922,1256,381,57481,54583,47035,45053,36548
91508,1038,3685,60067,31441,3.493e+13,1195.88,11705.9,91508,909,382,87270,86409,70313,11794,14660
56075,1956,2213,34413,21662,3.10189e+13,545.362,6703.83,56075,507,326,53862,53798,53173,53349,52165
27442,629,1035,17746,9696,2.97451e+13,510.015,3552.13,27442,402,237,26407,25958,24360,24220,22844
99531,24694,33841,78617,20914,6.52964e+12,127.548,37318.8,99531,2013,238,65690,65689,48231,45062,39635
73255,2958,3700,49621,23634,4.28492e+13,1148.7,11060.1,73255,1174,426,69555,69304,65219,27929,39689
94878,184,4441,67707,27171,4.63596e+13,1648.75,16220.5,94878,1922,581,75821,64166,42420,16681,8196
36918,166,1235,23817,13101,2.96393e+13,546.949,4294.53,36918,441,279,31767,29946,25960,22454,5870
89656,494,2903,57370,32286,2.9591e+13,677.658,9757.08,89656,712,427,85486,80660,71472,64485,34944
50280,1812,3661,36075,14205,5.52045e+13,1569.08,10817.4,50280,1448,406,46018,42263,34529,34997,29102
91049,1965,3966,59716,31333,2.98619e+13,731.446,12773,91049,1252,398,87083,86782,84897,85038,55261
43591,1266,1796,28096,15495,2.91247e+13,533.059,5468.41,43591,466,284,41795,41795,41471,41369,39934
5441,235,785,3885,1556,2.73722e+13,197.692,1786.3,5441,319,95,4656,4385,3310,2284,2387
8136,371,701,5247,2889,2.94928e+13,312.296,1774.27,8136,263,141,7309,6918,6777,6370,5435
17299,347,386,11717,5582,3.32894e+13,277.372,2125.85,17299,250,159,16913,16913,16675,16543,16395
78746,72,4146,56518,22228,4.23897e+13,1538.84,14045.3,78746,1409,431,50914,34545,23817,6719,1293
73357,1596,2778,45828,27529,3.05521e+13,649.328,8922.07,73357,539,439,70579,70328,62532,48015,50225
80060,1351,4218,57665,22395,4.9926e+13,1720.58,14520.3,80060,1661,564,73397,68948,54587,51464,33306
11750,1254,1602,8338,3412,2.21213e+13,407.177,3493.99,11750,606,146,10148,10142,9836,9950,9417
89292,175,4003,59261,30031,3.88336e+13,1183.01,12078,89292,1019,443,74752,68770,54891,7355,6485
14854,168,2773,10936,3918,6.47858e+13,541.916,5202.96,14854,670,201,10703,9232,4725,3728,739
7324,249,558,4700,2624,2.80535e+13,282.181,1487.49,7324,196,132,6538,6153,5960,5848,4576
13022,163,966,8395,4627,2.93859e+13,382.384,2525.96,13022,267,181,11113,10325,9236,8287,2723
1101,127,547,764,337,1.24091e+13,45.4305,703.89,1101,138,50,554,502,415,427,352
6526,157,1729,4921,1605,5.25337e+13,183.242,2882.13,6526,439,134,4389,3789,2186,1649,801
62371,3012,3786,45016,17355,5.54813e+13,1456.93,12163.2,62371,1460,527,58585,58565,54199,54873,55295
26158,231,2471,17700,8458,3.04699e+13,481.186,5985.21,26158,682,221,21912,19838,13651,8779,4140
19222,942,988,12452,6770,2.96447e+13,404.178,2973.84,19222,316,202,18234,18232,18180,18123,17943
54862,775,2468,34847,20015,3.01949e+13,529.629,7520.1,54862,532,386,52394,51748,44886,37586,26010
77250,1083,3791,55469,21781,4.25379e+13,1506.44,13522.8,77250,1431,401,70956,66870,55522,55405,32981
6341,218,618,4104,2237,3.00519e+13,269.532,1528.05,6341,210,143,5451,5081,4813,4662,3205
30052,1112,1563,19383,10669,2.91571e+13,502.539,4458.54,30052,446,250,28489,28480,28312,28288,27275
42481,616,1825,27373,15108,2.90342e+13,514.12,5829.73,42481,464,323,40586,39618,35619,35163,20706
52969,428,2049,34196,18773,2.91788e+13,536.071,6729.79,52969,576,349,49925,46254,42419,41283,21268
48139,2265,3742,34052,14087,5.66537e+13,1158.69,10192.1,48139,1319,460,44397,42449,35446,25225,28609
30374,244,1056,19606,10768,2.96444e+13,550.532,3741.58,30374,428,237,27256,25364,23588,23189,13058
52204,1622,3421,37447,14757,5.13336e+13,1350.25,10802.6,52204,1303,352,48079,44930,37662,36581,31298
33743,118,3592,24567,9176,6.55843e+13,1262.26,8610.74,33743,1124,449,23808,18389,10303,6930,2284
7618,212,723,4903,2715,3.00019e+13,328.544,1750.07,7618,286,136,6500,6119,5685,5445,3582
20568,6457,7259,16787,3781,1.72937e+13,125.044,8942.22,20568,568,129,13309,13309,12404,13006,12749
69530,3056,3469,43276,26254,3.02963e+13,729.144,9481.02,69530,713,387,66061,66017,66061,66061,65055
47443,1650,3621,32256,15187,4.69484e+13,748.553,9117.53,47443,996,415,43822,42865,34025,13466,15595
90474,3528,4432,61061,29413,3.54618e+13,1140.06,14268.8,90474,1352,413,86042,85795,83038,83347,79869
30737,335,1841,19006,11731,3.0976e+13,393.428,4839.18,30737,426,271,28408,27118,21479,13487,8397
5053,276,686,3268,1785,2.96629e+13,272.438,1419.9,5053,285,110,4311,4066,3680,3779,2204
52432,160,1973,33837,18595,2.97778e+13,562.564,6571.3,52432,578,341,45085,42131,36207,30692,9908
73294,475,3156,48338,24956,3.56297e+13,838.943,8820.59,73294,768,340,68375,63364,53808,5665,2387
92539,493,770,62761,29778,3.35406e+13,303.667,5229.57,92539,313,274,91769,91769,76979,80560,73299
33193,1995,3611,23244,9949,5.7131e+13,698.487,8164.65,33193,949,408,29582,28834,22730,14385,16652
19728,652,925,12687,7041,3.00404e+13,495.865,2991.68,19728,398,202,18803,18549,17890,17702,17330
2843,313,475,1808,1035,2.89082e+13,128.277,921.707,2843,106,81,2368,2324,2293,2281,2145
28318,1711,2742,19868,8450,5.2698e+13,1200.53,7303.1,28318,1075,288,25576,23841,20832,21212,18500
80702,1090,3937,53436,27266,3.84856e+13,1132.58,11254.7,80702,1030,439,76235,74995,59957,13270,15015
69849,1542,4234,49773,20076,5.26968e+13,1414.01,13532.9,69849,1713,526,64280,60133,46570,38488,33724
75264,2551,3750,54002,21262,4.34843e+13,1529.21,13332.4,75264,1435,398,71499,70834,62395,64343,58450
33782,1000,3001,22847,10935,4.45171e+13,571.935,7114.67,33782,857,331,30781,30375,22298,6970,6964
59400,209,1974,38315,21085,2.96136e+13,534.993,6640.13,59400,566,325,52588,48911,44443,40895,18132
33805,2108,3236,24412,9393,6.30094e+13,1308.84,8468.03,33805,1205,267,30489,28269,23060,23846,24350
88309,785,4067,56114,32195,2.92733e+13,800.212,12527.8,88309,1180,430,83863,82624,65420,45634,29738
47644,2064,3159,30190,17454,2.92956e+13,440.886,7852.33,47644,1123,200,44485,44482,44146,44443,31515
24968,1850,1918,17866,7102,3.32451e+13,627.007,5524.85,24968,661,164,23050,22941,23050,23050,22953
13611,537,1200,9773,3838,2.4729e+13,520.852,3395.86,13611,672,119,12053,10716,8646,7635,8364
23979,283,1587,15222,8757,3.07209e+13,476.501,4230.07,23979,435,245,21476,20313,17717,13815,6852
66635,2015,3711,42650,23985,2.96017e+13,579.352,10561.7,66635,1219,325,62924,62892,62342,62823,44587
33101,1134,1887,20281,12820,3.10241e+13,386.427,4941.73,33101,350,267,31214,31200,26428,25197,18860
84182,2958,3971,60536,23646,4.57554e+13,1722.66,14480.4,84182,1631,525,80211,79713,71333,72330,71332
25967,755,1512,16748,9219,2.94833e+13,425.879,4376.59,25967,380,266,24455,24340,22900,22729,16887
86618,1591,2880,55683,30935,2.95818e+13,659.16,9506.69,86618,689,420,83738,83624,79086,75156,63776
64949,340,3778,41810,23139,2.92744e+13,558.078,10402.9,64949,1227,290,58912,55710,38320,16242,8102
26534,872,1060,17035,9499,2.92674e+13,513.44,3540.39,26534,420,228,25474,25453,25065,25078,24622
6059,168,632,3884,2175,2.71291e+13,192.88,1402.58,6059,178,109,5244,5077,4598,4447,3100
99680,2678,4686,65972,33708,3.13157e+13,1045.97,15389.9,99680,1373,396,94994,94485,94005,94323,64707
69766,1381,2700,43323,26443,3.075e+13,635.459,8496.62,69766,519,401,67066,66783,57190,39599,43113
80360,986,2410,51818,28542,2.9373e+13,585.917,8404.83,80360,607,383,77950,77834,70615,70692,54316
77054,3092,3714,51511,25543,4.09375e+13,1006.13,10761.1,77054,1040,433,73340,73140,69851,43374,38259
93347,34743,36619,75771,17576,1.70981e+12,105.346,38533.6,93347,1909,159,56728,56728,53922,56531,54217
86247,2147,4606,57219,29028,3.11101e+13,976.977,13815.1,86247,1335,333,81641,81175,79534,80427,42151
55512,3101,3609,35638,19874,2.92942e+13,519.724,9272.15,55512,1209,233,51903,51901,51903,51899,48340
60278,1773,3531,43458,16820,4.41708e+13,1254.92,11677.4,60278,1250,362,56347,53765,48337,45684,37139
48866,1121,1438,31457,17409,2.92181e+13,574.276,5093.24,48866,511,310,47428,47411,46245,45907,45059
78361,1137,3885,51532,26829,2.96991e+13,691.808,11716.4,78361,1241,361,74344,73330,56926,46859,23393
99614,3817,4297,68788,30826,4.54018e+13,1352.14,15297.8,99614,1810,553,95317,95280,93176,65357,71736
54154,555,3526,36007,18147,3.97797e+13,755.925,9082.67,54154,964,398,49749,48252,36783,7219,4658
96757,2578,2995,60877,35880,3.02803e+13,746.374,10492.5,96757,668,459,93762,93645,90126,91332,85215
66168,625,2624,42250,23918,2.98494e+13,587.291,8359.82,66168,625,412,63242,61867,53383,47774,30352
67910,3659,3881,43688,24222,2.94236e+13,601.951,10903.3,67910,1240,338,64029,64029,64029,64029,63276
24234,1457,2750,17045,7189,5.51143e+13,1197.11,6841.44,24234,967,302,21221,19924,16315,16301,13242
2491,293,497,1611,880,2.95496e+13,108.48,911.685,2491,123,83,1994,1907,1841,1854,1640
64246,1612,3806,46381,17865,5.44366e+13,1447.68,12386.3,64246,1476,528,59385,55227,43490,40956,35632
13936,778,1204,9982,3954,2.41828e+13,534.526,3443.22,13936,678,121,12732,12426,11382,11644,10780
9252,159,1151,5902,3350,2.98724e+13,228.672,2423.52,9252,271,170,7717,7203,6303,5213,2584
81873,3729,4097,56329,25544,4.74774e+13,1284.3,13180.8,81873,1547,468,77776,77774,76443,70513,62752
10173,573,1195,6362,3811,3.03039e+13,184.041,2519.74,10173,259,163,8978,8952,7811,6230,4862
67694,983,3783,46239,21455,4.62883e+13,1136.06,11205,67694,1341,469,62357,60292,45291,15449,17342
34695,513,2468,21443,13252,2.86206e+13,318.347,5709.55,34695,871,158,31959,30414,24995,21070,18253
22812,494,1608,16475,6337,3.05968e+13,520.084,4836.86,22812,512,194,20756,19939,13246,14134,6273
70293,2028,3880,50358,19935,4.83182e+13,1674.02,13093.8,70293,1492,457,65810,62255,53951,50554,42869
91893,2525,4652,61072,30821,3.17366e+13,1043.77,14656,91893,1366,375,87241,86735,85671,86450,54102
76227,2288,4157,52770,23457,5.02869e+13,1365.25,13328.1,76227,1793,492,72066,68883,57486,38378,43007
43277,3521,3581,30247,13030,5.20501e+13,1023.79,9340.66,43277,1115,421,39696,39645,39620,39590,38760
47163,2615,2962,31169,15994,2.88718e+13,488.061,8035.2,47163,1043,252,44201,44200,44134,44201,41553
51499,247,3092,36999,14500,4.43597e+13,1287.74,10362.8,51499,1154,340,42193,37698,24214,15562,6527
66425,22044,27858,53144,13281,115317000,1038.79,40920.9,66425,6668,11,38567,38567,36940,38567,31137
18066,710,2185,12379,5687,3.98626e+13,549.321,5133.24,18066,605,190,15581,14799,14317,14259,8835
1380,64,571,878,502,2.32578e+13,132.928,791.181,1380,342,47,614,311,215,288,187
60495,1219,3669,41299,19196,4.47918e+13,1082.76,10380.3,60495,1123,419,55978,54130,40064,13893,13479
77708,2025,4231,54247,23461,5.00684e+13,1399.58,13966.3,77708,1760,530,73053,68856,54906,41191,39914
7656,571,740,4898,2758,2.73532e+13,338.316,1748.96,7656,274,148,6916,6646,6658,6504,6201
94071,2838,4034,64184,29887,4.50164e+13,1325.13,13632.9,94071,1519,485,90037,89659,80547,41598,57840
53789,1756,3029,36806,16983,2.90381e+13,593.714,8765.56,53789,980,276,50760,50702,49025,43647,33894
90565,1892,4081,57744,32821,2.95124e+13,832.478,12742.5,90565,1190,430,86484,86028,78736,74036,53905
53914,1256,3211,33598,20316,2.92161e+13,536.269,8424.06,53914,940,306,50703,50482,42799,36723,26352
11173,42,751,7198,3975,2.87191e+13,354.929,2107.17,11173,267,167,7195,4166,5182,3432,1321
81922,2908,3836,55462,26460,4.3152e+13,1155.15,11914.2,81922,1382,464,78086,77762,71488,31022,46261
99354,646,2993,62492,36862,3.0528e+13,726.169,10505.1,99354,630,463,95889,94076,76840,60390,44523
58953,325,2257,37888,21065,2.92394e+13,592.991,7209.88,58953,585,336,53933,49417,46495,44438,16258
7636,120,697,4885,2751,2.8678e+13,290.251,1703.89,7636,222,132,6326,5826,5077,4694,2393
42595,2115,3818,30897,11698,6.25702e+13,1370.22,9918.39,42595,1273,449,38628,35748,28664,25980,26922
26080,1233,1394,16855,9225,2.98198e+13,524.752,4020.05,26080,433,263,24686,24684,24390,24278,24364
52312,952,3390,37348,14964,4.2646e+13,1146.56,10641.9,52312,1128,347,47472,44933,35846,35813,15567
24849,5473,11226,19881,4968,123249000,626.001,15974.6,24849,2500,11,13623,12413,12119,13623,6562
42226,2152,3401,30107,12119,5.877e+13,1552.19,9578.14,42226,1420,288,38775,35740,31177,32409,31902
59129,2787,3549,42365,16764,3.91297e+13,1097.97,11391.9,59129,1118,360,55580,55537,51469,52937,51392
34906,810,20391,26833,8073,2.19597e+13,297.187,21890.8,34906,20078,81,14515,12595,2161,912,9911
12016,1821,6016,9613,2403,127308000,3.39406,8210.26,12016,1214,11,6000,6000,5163,5708,1810
49180,102,1898,31760,17420,2.98842e+13,549.311,5920.04,49180,517,306,40435,35215,30141,27463,8463
7761,1408,1986,5718,2043,6.58228e+13,198.546,3126.82,7761,415,273,5775,5775,3182,4049,3090
50010,1904,2466,31411,18599,3.009e+13,526.515,7192.24,50010,527,375,47544,47528,44801,45526,40608
32408,948,1161,20914,11494,3.00684e+13,529.114,3986.43,32408,447,267,31247,31244,30674,30201,30228
37974,1727,3464,25883,12091,4.88602e+13,711.375,8313.74,37974,940,400,34510,33694,26454,12682,13921
61638,1643,3911,43270,18368,5.29544e+13,1239.57,11521.1,61638,1372,466,56778,54021,41900,23861,26269
98193,1321,4367,68950,29243,4.51579e+13,1376,15960.8,98193,1867,570,91403,86888,70915,48894,39132
93572,676,4031,61251,32321,2.97875e+13,747.695,12983.5,93572,1264,403,88671,86664,63827,42710,27208
61713,2500,2527,39240,22473,2.97552e+13,565.943,7996.19,61713,576,397,59186,59186,59186,59186,59134
80768,2079,4234,54466,26302,3.23386e+13,1087,13229.9,80768,1244,361,76534,75938,73049,64600,52249
22620,135,1014,14667,7953,3.02567e+13,478.588,3275.62,22620,354,225,18819,17779,15095,12968,5920
18735,445,1827,13133,5602,2.65019e+13,532.386,4631.93,18735,756,169,15995,13863,9219,5384,1932
63208,792,2264,40790,22418,2.97335e+13,556.441,7414.13,63208,587,350,60944,60404,54045,52579,41278
41324,1557,3545,29746,11578,6.07267e+13,1485.38,9351.54,41324,1172,391,36914,34047,24273,25353,22182
14504,1477,2450,10552,3952,6.11785e+13,555.824,4872.16,14504,689,165,12054,11752,11069,11010,7988
42149,175,3602,30425,11724,6.13143e+13,1480.03,9610.32,42149,1262,402,30953,26912,15658,11958,2756
54318,2390,3479,37724,16594,2.86568e+13,770.631,9699.89,54318,929,282,50839,50838,50384,50732,41723
91038,2092,2889,58451,32587,2.90824e+13,653.695,9654.31,91038,690,427,88149,88103,86061,83806,82165
46204,2069,2323,29398,16806,2.98877e+13,559.327,6854.52,46204,504,356,43881,43877,43405,43617,41797
40095,1635,2085,26446,13649,3.84623e+13,527.74,5751.02,40095,483,276,38010,38005,36934,36688,33834
4571,337,576,2951,1620,3.00481e+13,154.779,1197.19,4571,195,103,3995,3897,3838,3771,2553
47604,1194,1929,30703,16901,2.94809e+13,537.51,6282.02,47604,496,334,45675,45643,43491,41741,31165
40380,691,1264,26037,14343,2.96947e+13,536.257,4515.57,40380,460,277,39116,38873,35400,36123,33102
34988,1109,2416,23462,11526,4.25757e+13,597.339,5938.57,34988,612,278,32572,32297,25980,7094,7387
78223,2357,2406,50409,27814,2.96699e+13,599.517,8331.54,78223,622,380,75817,75817,75768,75709,75767
22237,253,2211,14394,7843,2.71792e+13,324.69,4900.31,22237,748,162,18654,16924,12572,10427,5163
49831,248,3676,34366,15465,4.81977e+13,1028.22,9767.15,49831,1136,433,41085,37127,26213,6805,3790
34882,3293,3301,25540,9342,6.18943e+13,1547.89,8484.59,34882,1105,335,31581,31581,31581,31581,31567
65747,237,3662,47167,18580,4.79642e+13,1551.68,12434.6,65747,1464,388,53486,48337,29355,14425,2586
92332,1468,4428,64882,27450,4.13258e+13,1564.81,15427.1,92332,1650,450,86288,82186,71038,60316,36251
86455,4179,4376,60694,25761,4.00112e+13,1333.85,14734,86455,1433,449,82079,82076,82026,81267,80702
23406,825,1630,16934,6472,3.06639e+13,445.617,4820.9,23406,453,185,21776,21467,17389,19263,11167
87936,3121,3729,59010,28926,4.0364e+13,1169.79,11811.4,87936,1209,438,84207,83942,80133,33269,47830
31359,1159,1852,18901,12458,3.13982e+13,326.28,4525.31,31359,389,221,29507,29461,24877,24678,19616
37129,2008,2585,23732,13397,2.85858e+13,393.567,6551.86,37129,987,184,34544,34543,34201,33533,31494
74423,4157,4213,51876,22547,5.07746e+13,1409.94,13657.6,74423,1780,524,70210,70208,70176,70032,69512
50565,20684,50565,25283,25282,5808030,0,50565,50565,25283,2,0,0,0,0,0
47436,2817,3751,34085,13351,5.92824e+13,1402.04,10386.3,47436,1295,447,43685,43559,39528,33759,35006
43545,409,2917,30977,12568,4.50017e+13,1170.22,9308.99,43545,1118,321,36723,34845,26064,24479,11342
92251,603,4222,60122,32129,2.9573e+13,780.815,13238.5,92251,1258,417,86818,83899,60472,40855,15103
95442,1419,4831,64219,31223,3.55252e+13,1248.84,15208,95442,1412,425,90003,87706,72019,69935,35920
58583,113,2473,37526,21057,3.00848e+13,579.64,7787.28,58583,589,397,48897,44812,37697,29174,7381
82195,1229,2974,53489,28706,3.24668e+13,717.699,9249.38,82195,689,379,79221,79005,69749,65872,41513
35601,272,3004,24130,11471,4.49305e+13,583.13,7241.54,35601,841,336,30458,27580,21796,5196,3261
32188,846,1751,20695,11493,2.88663e+13,513.039,5161.85,32188,457,289,30437,30249,28401,27732,21320
97755,1162,4445,69749,28006,4.50372e+13,1637.12,16360.2,97755,1899,581,89990,85236,68342,60987,37625
34164,11885,14952,27334,6830,134519000,806.174,21563.7,34164,3436,11,19212,19212,18445,19212,15388
95855,921,4001,62902,32953,3.55394e+13,1211.77,12381.9,95855,1074,434,91014,89876,72016,11382,10714
14151,2636,2671,10407,3744,6.3927e+13,635.411,5004.18,14151,690,172,11480,11420,11480,11480,11462
21953,1560,5381,15609,6344,2.58405e+13,167.338,7281.83,21953,727,133,16572,16547,11804,13252,11884
72231,1534,3679,51822,20409,4.56293e+13,1590.41,13070,72231,1515,393,67287,63504,55259,52635,37566
82322,2920,3050,53543,28779,3.25757e+13,710.835,9300.14,82322,725,361,79272,79272,79195,79234,79116
12703,595,1281,9078,3625,3.01289e+13,434.155,3433.27,12703,499,131,11415,10679,8763,9811,3777
17484,1421,2640,12674,4810,5.90101e+13,904.936,5465.54,17484,789,170,14844,13775,10051,11498,9097
73833,1634,3720,47070,26763,2.96527e+13,598.062,10776.1,73833,1180,334,70113,69951,64618,65061,48639
46686,937,1382,30116,16570,2.9283e+13,556.202,4923.8,46686,443,297,45304,45267,43122,43054,41109
52636,1046,1714,33982,18654,3.03499e+13,572.462,5653.07,52636,521,314,50922,50903,47147,46199,42372
21642,2463,2813,15638,6004,6.14135e+13,1044.06,6168.9,21642,944,256,18829,18200,18696,18829,17928
25532,435,1687,18485,7047,3.11602e+13,478.994,5044.25,25532,471,188,23517,22887,13976,8870,4742
68835,2427,2607,44679,24156,3.1915e+13,632.5,7649.75,68835,623,348,66228,66228,66184,66203,65222
70536,2234,3673,47548,22988,4.29106e+13,983.086,10539.7,70536,1020,434,66863,65709,55626,18343,30634
74986,2139,2778,48069,26917,3.03781e+13,637.505,9030.89,74986,641,429,72208,72177,69972,69416,65717
83838,2149,4240,59023,24815,4.83565e+13,1321.58,14721.2,83838,1778,537,79413,75586,62283,51625,50549
62084,2471,3282,38438,23646,2.98567e+13,666.151,8652.08,62084,725,380,58802,58779,58763,58796,56982
56409,426,3515,35546,20863,2.97054e+13,458.109,9170.51,56409,1138,272,51926,49116,36682,20342,12784
10133,454,1524,6363,3770,2.58297e+13,229.03,2763.16,10133,340,117,8472,7810,7467,7607,6044
75263,2528,3927,51902,23361,4.83196e+13,1262.3,12287,75263,1374,472,71336,69957,62328,32603,44078
15762,311,839,9218,6544,3.23858e+13,264.127,1991.97,15762,263,128,14904,14571,11316,9593,7918
53338,2669,3780,37189,16149,5.23744e+13,1128.38,10527.3,53338,1339,464,49558,49227,42868,27275,31961
83547,3167,4337,58406,25141,3.82152e+13,1314.71,14381,83547,1412,430,79210,78952,73593,72665,66936
58282,2952,3074,38574,19708,3.66842e+13,769.879,8066.5,58282,740,328,55208,55208,55108,54969,54458
67247,1074,2667,42670,24577,3.02401e+13,606.59,8481.45,67247,601,424,64580,64385,56478,48206,37347
77045,2398,2401,49636,27409,2.95008e+13,602.105,8132.43,77045,609,359,74644,74644,74644,74640,74643
93361,23832,24728,76448,16913,2.41844e+13,5684.05,40705.1,93361,7799,26,68633,68633,68358,68358,67946
46649,3529,3839,33638,13011,6.09554e+13,1419.6,10357.8,46649,1334,463,42810,42781,42569,41639,40028
66537,1592,3060,43887,22650,3.60204e+13,815.607,8368.31,66537,746,341,63477,62946,53030,11125,13898
97479,927,2997,61827,35652,3.01712e+13,738.188,10402.9,97479,686,458,94306,93890,79579,69561,55284
81599,3651,4160,52327,29272,2.94475e+13,704.747,12342.5,81599,1242,383,77439,77439,77439,77439,73774
8169,173,658,5945,2224,3.21613e+13,188.73,1931.42,8169,239,108,7246,6695,5044,5923,2234
38026,1201,1232,24653,13373,2.99525e+13,534.003,4319.25,38026,452,277,36794,36794,36735,36735,36727
76477,1779,3855,50490,25987,3.81257e+13,1055.98,10770.3,76477,1033,422,72622,71421,58652,14745,19093
38345,2284,2596,25633,12712,4.13479e+13,649.459,6417.29,38345,666,309,35749,35590,34977,34434,30676
39352,411,1722,25308,14044,2.88144e+13,485.149,5397.63,39352,450,297,36886,34287,31881,31010,19813
52333,1993,3866,37243,15090,5.714e+13,1376.97,10969.8,52333,1417,455,48180,44578,35876,29331,30903
66905,576,2676,41719,25186,3.05516e+13,624.304,8464.14,66905,519,418,63732,62151,50034,36146,22403
23578,337,2036,14694,8884,2.7235e+13,307.115,4557.26,23578,691,144,20691,19050,15132,12830,8830
97624,1695,4282,68160,29464,4.58775e+13,1320.18,15672.7,97624,1783,553,92246,87716,72206,47532,45569
3498,409,411,2279,1219,2.96092e+13,109.871,874.049,3498,147,68,3087,3087,3087,3087,3086
87796,1239,4135,60030,27766,4.61626e+13,1265.36,13500.5,87796,1591,472,81667,78431,59486,25660,24283
41507,49,2453,27581,13926,4.02324e+13,531.559,6249.57,41507,463,290,27874,18674,18188,2858,591
90629,2981,4136,61032,29597,4.20096e+13,1359.06,12970.6,90629,1384,467,86493,85953,80020,33300,50540
95848,4208,4829,68512,27336,4.54327e+13,1751.77,16544.4,95848,1794,621,91019,91019,90251,88761,88694
78414,2224,4171,54493,23921,4.98252e+13,1406.44,13773.6,78414,1750,537,74104,70270,56970,39761,43348
87425,1131,4367,61629,25796,4.14303e+13,1550.83,14986.1,87425,1540,450,80465,76439,56825,49130,20613
19200,1482,1589,12332,6868,2.99435e+13,478.841,3964.02,19200,443,227,17611,17611,17552,17609,17495
13506,832,1422,9629,3877,3.07768e+13,446.867,3640.15,13506,498,149,12084,12007,11310,11768,7097
40065,561,2746,28575,11490,4.08187e+13,866.857,8546.6,40065,835,298,35340,33825,28262,27451,15187
88528,1677,2847,56804,31724,2.9428e+13,654.9,9561.65,88528,695,422,85681,85541,81075,75551,66128
23064,2485,3056,16774,6290,6.1983e+13,1104.8,6678.77,23064,908,341,20008,19041,18275,18577,18059
55249,1871,3670,38099,17150,4.78222e+13,1042.17,10256.6,55249,1264,424,51384,49372,38922,20384,25119
47335,271,3387,33894,13441,4.23841e+13,999.457,10059.1,47335,915,348,40034,37167,22837,12223,4885
23203,1082,2198,16213,6990,3.95626e+13,585.481,5755.27,23203,607,201,20999,20026,20259,19658,15665
16913,403,1163,10943,5970,3.04718e+13,512.735,3156.8,16913,327,207,15416,14536,12871,12796,6368
7024,707,1512,5151,1873,7.54957e+13,194.671,2718.11,7024,306,142,5512,5416,5136,5148,3776
26772,498,1636,17221,9551,2.9144e+13,527.264,4645.77,26772,439,263,24847,23457,21760,20756,10609
1657,171,470,1056,601,3.43161e+13,94.0054,776.696,1657,134,85,1181,1085,1002,982,488
29803,715,1979,19979,9824,4.41557e+13,465.107,5079.3,29803,453,279,27824,27617,22884,6925,7242
48869,699,1813,31462,17407,2.9611e+13,578.894,5572.99,48869,503,304,47056,46622,41554,41464,35680
75331,1710,4187,53298,22033,3.75574e+13,1312.17,13574.5,75331,1380,419,70729,68137,61927,60909,38262
42797,2287,2852,28264,14533,2.86175e+13,488.294,7621.95,42797,1019,236,39945,39944,39649,39869,35409
43611,431,2795,31192,12419,2.69499e+13,752.179,7990.19,43611,813,259,39058,36466,22048,7478,2814
96816,4129,4133,65173,31643,4.16943e+13,1385.3,13437.8,96816,1412,482,92683,92683,92681,92667,92662
99360,2395,4900,70554,28806,4.49552e+13,1740.47,16890.2,99360,1812,638,94039,91218,77971,74676,58702
25692,1266,2095,18540,7152,2.82776e+13,428.796,5541.43,25692,512,184,23597,23528,22661,23244,16865
73225,3294,4063,50786,22439,4.95135e+13,1273.27,12602.6,73225,1513,474,69162,69006,65602,42991,49721
84756,311,4282,60135,24621,4.87002e+13,1339.72,14914.1,84756,1767,544,71218,65476,44751,32461,12440
70274,1482,4184,50029,20245,5.24783e+13,1418.12,13598.3,70274,1710,530,64517,60253,47056,38221,32307
24389,85,1756,16097,8292,3.91747e+13,465.31,4372.88,24389,422,223,19029,15144,12559,2216,970
32993,4230,14116,26691,6302,2.673e+13,3511.53,19506,32993,3156,13,18289,13497,3,15353,7866
41620,233,1232,26773,14847,2.91547e+13,556.976,4520.01,41620,459,281,37158,34572,31943,31619,15036
61154,2421,3474,38027,23127,3.0543e+13,572.493,8903.64,61154,828,328,57680,57679,57637,57679,54436
58051,548,2661,38293,19758,3.67837e+13,784.823,7471.81,58051,684,317,54705,51502,41932,5208,5057
43618,500,538,29587,14031,3.36234e+13,300.982,3498.65,43618,296,239,43080,43080,43020,42916,42826
77393,1859,2779,48599,28794,3.03415e+13,663.84,9178.34,77393,573,435,74614,74420,68441,59254,59137
27914,1356,1753,17462,10452,3.06128e+13,455.711,4656.91,27914,429,264,26161,26158,24678,25274,21990
80560,3136,4359,55034,25526,3.48456e+13,1111.57,13599.3,80560,1213,400,76201,75934,73198,72348,67402
75371,1569,2779,47855,27516,3.03117e+13,640.765,9067.32,75371,641,430,72592,72480,67145,58196,54991
51188,839,1938,33033,18155,2.9534e+13,530.29,6296.94,51188,489,318,49250,49085,44449,45285,36327
55568,1955,2054,35714,19854,2.91487e+13,547.44,6542.82,55568,553,326,53514,53514,53422,53389,53151
17083,1350,1483,10336,6747,3.19848e+13,218.611,3164.76,17083,255,154,15600,15600,15454,15498,14734
27578,1457,2077,19505,8073,3.48911e+13,649.663,6070.93,27578,917,174,25501,24900,24960,24817,23428
81522,609,2444,52422,29100,2.94687e+13,587.081,8454.58,81522,638,374,78885,76261,67646,65598,42956
25572,1270,3141,18586,6986,6.29318e+13,1103.94,7066.62,25572,929,393,21955,20422,12985,13123,11633
71660,2761,4159,49910,21750,5.23231e+13,1362.51,13091,71660,1770,464,67501,67274,59961,42655,48090
29020,1080,2491,19601,9419,4.46826e+13,552.333,5663.56,29020,662,298,26529,26283,20205,5839,4928
82943,635,4328,54967,27976,2.90231e+13,843.393,12788.2,82943,1239,349,77522,75544,51416,32097,11718
32620,1015,1171,21080,11540,2.99162e+13,520.668,3982.22,32620,394,258,31449,31434,31046,30958,30875
23362,1276,2902,17082,6280,6.51865e+13,1095.59,6551.45,23362,942,257,20006,18583,14128,14498,12513
1851,99,518,1209,642,2.9813e+13,80.0827,847.354,1851,157,58,1311,1182,1122,625,453
12878,790,841,8292,4586,2.91131e+13,421.614,2358.11,12878,342,179,12037,12033,11986,11985,11970
13824,2495,2645,10175,3649,6.46857e+13,640.254,4906.89,13824,689,165,11179,10925,11179,11179,10808
50587,1763,1776,32747,17840,3.13593e+13,569.11,5662.88,50587,500,313,48811,48811,48811,48811,48800
24497,713,1002,15810,8687,2.9288e+13,487.496,3328.43,24497,372,222,23495,23444,22621,21908,21775
96091,1554,4384,68487,27604,4.58126e+13,1671.2,16239.7,96091,1868,577,89819,85412,71173,63055,47163
2087,403,433,1347,740,3.06142e+13,91.4758,767.009,2087,129,93,1654,1653,1650,1648,1627
20277,1329,1495,13016,7261,2.9054e+13,509.305,3873.96,20277,429,239,18782,18782,18647,18651,18553
85648,630,4253,57336,28312,3.2526e+13,1091.39,13515.1,85648,1309,369,78708,75870,55120,35134,25760
94796,1989,3478,62057,32739,3.42229e+13,964.633,10908.2,94796,764,403,91318,90607,83060,66757,34913
82245,2792,2842,52105,30140,2.98895e+13,674.307,9462.95,82245,608,434,79403,79403,79398,79403,79195
65479,2869,3226,43216,22263,3.68972e+13,787.844,9133.8,65479,866,348,62253,62251,60961,59154,53608
79919,2239,3930,52193,27726,2.97866e+13,695.791,11986.3,79919,1246,389,75989,75814,74948,75511,49558
40703,806,1741,26363,14340,2.99013e+13,495.62,5541.99,40703,427,305,38962,38802,35896,35977,29421
17751,361,2975,12770,4981,6.75791e+13,715.025,5807.75,17751,711,399,13726,12225,6548,4916,4137
50895,741,1631,32757,18138,2.95271e+13,559.389,5407.08,50895,517,316,49264,49025,43059,42038,33713
9832,860,2251,6918,2914,5.16894e+13,449.879,3971.44,9832,623,191,7581,7213,6129,5968,3364
70190,2436,3639,46550,23640,2.97806e+13,738.69,10528.6,70190,1205,290,66551,66295,65501,66102,49212
85417,392,4254,57502,27915,3.34133e+13,1102.71,13596.4,85417,1301,379,76188,72162,49455,25275,18996
76810,951,2745,47777,29033,2.99749e+13,652.924,9000.68,76810,549,434,74038,73567,60381,43574,35312
81571,140,728,55407,26164,3.36593e+13,304.823,4896.76,81571,311,270,66071,40668,42499,19678,34386
58272,3623,3870,41434,16838,4.20236e+13,1172.67,11742.5,58272,1211,385,54402,54399,54325,53855,53287
81151,2693,3995,53283,27868,2.96995e+13,724.21,12205.4,81151,1246,389,77156,76956,76454,76779,54770
42865,1322,3027,26417,16448,2.93297e+13,427.348,7113.17,42865,913,224,39838,39717,35061,35781,25489
43621,2150,3602,31462,12159,6.24649e+13,1464.53,9843.33,43621,1384,427,39950,36757,29744,31289,30722
28527,605,1100,18346,10181,2.94429e+13,527.751,3715.91,28527,417,255,27402,26343,24631,23430,21560
95129,656,3652,60161,34968,2.9327e+13,964.333,11932.1,95129,968,476,90664,89346,71613,53144,35838
62391,9716,21909,50514,11877,2.73629e+13,3827.68,31296.8,62391,5505,111,40482,34068,36573,35897,20835
3121,357,481,2302,819,2.47634e+13,155.899,1077.11,3121,206,66,2640,2640,2250,2295,1606
29909,823,1614,19372,10537,3.01432e+13,518.12,4571.06,29909,456,244,28295,28142,27060,26716,24906
14305,394,1217,9470,4835,3.87816e+13,387.782,2998.04,14305,364,187,12856,12045,10879,2527,2830
99547,3200,4103,67766,31781,4.43073e+13,1416.32,13940.1,99547,1541,478,95444,95051,90082,46325,63036
93501,106,4425,63531,29970,3.6404e+13,1246.68,14869.3,93501,1401,421,70434,55311,41002,10988,6326
62862,2730,3636,39400,23462,2.96533e+13,563.077,9564.21,62862,1048,308,59226,59225,59226,59225,53576
48892,984,3050,34269,14623,2.75745e+13,651.916,8687.28,48892,886,281,45686,44721,34264,26991,11305
62121,2569,2592,39664,22457,2.98684e+13,572.753,8079.18,62121,621,403,59529,59529,59529,59529,59484
54476,1759,3731,38877,15599,5.33353e+13,1479.64,11360.9,54476,1455,434,50064,46362,38325,38817,31976
3446,41,1046,2485,961,7.70204e+13,103.139,1603.75,3446,228,94,1856,1318,652,664,208
76562,2337,4274,54274,22288,5.05198e+13,1357.75,14167.2,76562,1760,533,72288,69476,57271,51033,51479
41406,1306,1845,26770,14636,2.98899e+13,510.151,5744.23,41406,494,304,39561,39552,38928,38175,33050
56566,2030,2056,36443,20123,2.95053e+13,575.609,6444.75,56566,559,318,54510,54510,54510,54504,54488
62767,1430,3815,45160,17607,5.29596e+13,1419.24,12246.9,62767,1465,504,57485,53371,42839,39511,32384
98691,260,804,66976,31715,3.35956e+13,304.591,5421.49,98691,315,278,96591,91778,65934,49047,52115
82790,3481,3983,59737,23053,4.92319e+13,1758.65,14478.1,82790,1666,562,78807,78431,76222,75888,75849
23718,996,1027,15263,8455,3.00245e+13,520.898,3341.63,23718,400,226,22691,22691,22659,22666,22673
5236,396,469,3054,2182,3.21567e+13,164.899,983.509,5236,116,82,4767,4762,4708,4711,4567
48401,1991,3434,30707,17694,2.94572e+13,464.733,8523.9,48401,1134,230,44967,44962,44580,44921,31364
8602,84,1442,5844,2758,2.08827e+13,349.31,2817.6,8602,518,123,5006,2985,2620,1385,696
87638,810,3541,54852,32786,2.98803e+13,913.906,10785.4,87638,718,462,83611,82653,67788,50566,38314
69002,2159,3699,46567,22435,4.35911e+13,981.472,10471.7,69002,1041,429,65303,64080,53391,17815,28053
7178,1423,1585,4746,2432,4.29621e+13,333.843,2815.49,7178,460,123,5593,5576,5517,5478,5092
40007,348,2041,24055,15952,3.16426e+13,406.042,5225.93,40007,500,249,37677,36446,26639,10614,9016
55115,1992,3500,38537,16578,3.06445e+13,856.314,10209.9,55115,984,281,51615,51518,50138,50812,34959
8548,444,1115,6222,2326,2.71084e+13,209.131,2574.87,8548,347,134,7433,7259,5128,5111,3386
98483,3056,4171,67240,31243,4.55106e+13,1351.13,14536.8,98483,1816,517,94312,93993,86988,48861,62948
40107,9537,14001,32708,7399,1.72462e+13,129.844,16951,40107,1005,156,26106,26106,20656,20836,20365
67331,738,3641,44855,22476,4.04782e+13,847.064,10116.1,67331,1014,421,62842,61920,48104,10239,11445
82151,674,732,55736,26415,3.35553e+13,304.787,4916.98,82151,311,269,81419,81419,80992,80836,80594
21951,338,1000,14101,7850,2.87359e+13,468.946,3172.8,21951,348,230,20151,18621,17727,17152,9293
6226,506,528,4525,1701,3.15924e+13,187.254,1534.23,6226,211,105,5698,5698,5679,5689,5497
78683,644,3969,56415,22268,4.84355e+13,1702.11,14052.9,78683,1567,546,68714,65372,41845,38881,13863
46284,649,2052,30213,16071,3.43047e+13,536.801,5904.91,46284,495,293,44232,43595,36727,5963,6619
9795,271,738,6283,3512,2.84772e+13,345.34,1952.45,9795,269,149,8707,8238,8049,7758,5282
73781,1064,2391,47649,26132,2.95355e+13,577.949,7982.84,73781,603,368,71390,71341,65923,65222,52782
43051,2095,2760,26161,16890,3.13954e+13,444.401,6354.4,43051,624,270,40291,40291,40249,40285,39839
73755,2883,3680,49878,23877,4.22993e+13,1130.51,11038.9,73755,1187,438,70075,69834,64823,27186,39279
60912,1945,1996,39357,21555,2.9657e+13,564.362,6727.57,60912,562,331,58916,58916,58902,58866,58758
10701,134,768,6952,3749,3.02489e+13,387.403,2106.44,10701,305,155,8950,8501,7179,6264,3370
79420,30235,33056,63542,15878,135046000,1079.63,48717.3,79420,7975,11,46364,46364,45659,46364,42848
50954,118,3115,36357,14597,4.2048e+13,1128.09,10222.5,50954,1114,349,38438,31719,21589,13969,5135
36888,1373,2684,22059,14829,3.1353e+13,418.469,5661.74,36888,606,227,34204,34085,30637,32093,27516
3709,523,558,2373,1336,3.03939e+13,200.526,1143.95,3709,140,118,3151,3104,3142,3145,3086
97415,2714,3496,63455,33960,3.39034e+13,881.482,11008,97415,765,431,93919,93859,92089,90244,80348
51823,1147,2019,33202,18621,2.91287e+13,561.288,6223.33,51823,481,316,49804,49779,48054,48034,45009
50016,235,2239,32736,17280,3.65818e+13,521.485,6382.41,50016,497,303,44237,40563,34898,5221,3186
87065,3930,4304,57611,29454,2.90442e+13,970.273,13216.8,87065,1233,395,82761,82657,82761,82761,81702
42463,619,1495,27319,15144,2.88115e+13,546.025,4865.08,42463,488,279,40939,39685,36643,34960,33293
67918,1401,3665,42893,25025,2.94295e+13,640.627,10081.6,67918,1076,367,64253,63986,55338,48153,35665
48363,301,2964,34412,13951,3.33724e+13,855.45,9270.94,48363,932,251,42279,39798,25733,11150,10046
14174,1258,2443,10613,3561,6.72091e+13,531.13,4827.86,14174,624,225,11731,11337,9423,8991,8112
59815,1981,3087,40068,19747,2.95593e+13,635.176,9127.84,59815,1086,272,56728,56581,55275,50211,42141
93817,3187,4298,60637,33180,2.95689e+13,806.614,13510.2,93817,1253,424,89519,89424,89519,89353,75643
92741,2831,2998,58209,34532,3.00831e+13,725.397,10222.1,92741,616,465,89743,89743,89358,89412,88166
95399,732,4318,61901,33498,2.96896e+13,818.685,13600.4,95399,1256,436,90336,88780,66040,45906,24193
68133,1019,2647,43249,24884,2.9944e+13,598.482,8506.46,68133,622,413,65486,65287,57526,49712,36573
60242,773,3090,39705,20537,2.9649e+13,608.705,9017.94,60242,1146,266,56735,55976,43906,32716,24250
22793,342,1631,16463,6330,3.07415e+13,424.202,4742.37,22793,450,180,20776,20318,11888,5479,2983
5434,87,611,3528,1906,3.05084e+13,220.062,1371.63,5434,205,104,4293,3423,3380,3046,1645
85364,1994,4162,54612,30752,2.92269e+13,734.478,12584.2,85364,1244,404,81202,80945,75130,74765,53563
52978,502,1981,34101,18877,2.93117e+13,530.501,6480.12,52978,531,330,50597,47447,42794,42842,24761
18284,2918,2945,13452,4832,6.25535e+13,919.719,5925.74,18284,734,268,15339,15338,15336,15339,15285
5591,24,538,3633,1958,3.08593e+13,234.97,1300.18,5591,185,110,2727,1113,1695,761,461
84279,1504,2400,54259,30020,2.9333e+13,594.74,8519.95,84279,670,384,81879,81879,78657,77563,66056
25607,4850,12586,20835,4772,2.83893e+13,1040.57,16162.2,25607,2937,15,13021,11211,10423,11713,6952
63460,2653,3719,41242,22218,2.93389e+13,584.933,10292.4,63460,1216,296,59741,59654,59426,59546,47591
30635,348,1762,22164,8471,3.06795e+13,545.606,5630.76,30635,539,211,27999,27163,16417,14310,6208
23460,2232,2319,14888,8572,2.77818e+13,291.167,5018.79,23460,741,157,21141,21141,21141,21141,20999
82166,2919,3940,59050,23116,4.65746e+13,1703.02,14330.4,82166,1632,537,78226,77716,68740,70057,68639
69084,1411,3646,49388,19696,4.69373e+13,1562.82,12755.9,69084,1559,378,63957,60070,51442,49989,32168
7078,265,1764,5156,1922,7.64679e+13,153.838,2872.06,7078,345,132,5314,4894,2711,2997,2141
94704,2675,4410,64168,30536,3.63055e+13,1261.68,14928.2,94704,1426,413,90294,89657,85245,83103,67550
69360,1370,2663,43178,26182,3.02369e+13,632.129,8548.44,69360,523,431,66697,66447,58281,42462,43821
1051,232,306,838,213,9.61371e+13,82.1589,489.846,1051,44,66,745,731,660,687,652
52593,1300,2980,36087,16506,2.89659e+13,553.756,8593.96,52593,955,279,49613,49242,43562,38378,17083
33908,1680,2855,24025,9883,4.79106e+13,1089.05,8202.56,33908,986,305,30942,29381,26136,26556,22727
55964,512,3276,39680,16284,3.28386e+13,944.77,10382.6,55964,1037,308,49720,46300,32158,20310,20356
77930,485,3922,53819,24111,4.78996e+13,1295.24,12546.7,77930,1466,473,68614,63862,44375,14208,10827
21944,202,1539,14373,7571,3.70176e+13,449.88,3959.85,21944,419,222,18831,17506,14726,2370,1438
28960,292,1654,18298,10662,3.03585e+13,447.046,4589.07,28960,400,261,26330,24844,21752,16470,11602
61523,1030,4130,43325,18198,5.56649e+13,1469.46,12433.4,61523,1737,504,54430,50904,34877,24573,17351
85198,4089,4335,61174,24024,4.81841e+13,1676.57,15229.9,85198,1777,570,80863,80858,80715,80404,79339
88626,99,4011,59794,28832,4.23033e+13,1368.06,12589.8,88626,1369,469,67866,55654,43490,8648,3561
79506,359,4149,52919,26587,3.10857e+13,938.218,12430.2,79506,1317,297,71473,67895,43842,21596,2870
17453,531,1700,12502,4951,2.72843e+13,395.928,4231.11,17453,494,146,15619,15402,13977,14613,9147
67591,1647,2857,44190,23401,3.44553e+13,584.61,7895.82,67591,613,343,64734,64705,61373,57695,50359
44694,1046,3651,31128,13566,5.05162e+13,1043.79,9430.14,44694,1095,427,40101,38555,25974,10991,9096
93253,3270,4530,66795,26458,4.53162e+13,1748.33,15900.4,93253,1677,628,88723,88251,77002,79380,72737
88751,11928,24019,72547,16204,2.52545e+13,5818.5,39075.6,88751,7799,26,64732,53443,56488,59064,39004
15765,1185,1308,10041,5724,3.09458e+13,306.455,3220.38,15765,325,195,14457,14453,14382,14428,14000
1363,47,206,865,498,2.10622e+13,70.6654,427.694,1363,69,51,981,586,790,638,456
12282,1141,2006,8149,4133,4.22204e+13,524.579,4121.58,12282,673,178,10276,9934,9717,9838,5778
14357,144,769,8388,5969,3.23319e+13,259.243,1869.27,14357,236,125,13013,11579,8918,5584,4790
15264,123,1237,9840,5424,2.95411e+13,479.07,3123.34,15264,321,212,12492,11612,10123,7648,2848
68861,2660,3929,47876,20985,4.98119e+13,1315.62,12079.3,68861,1421,469,64932,63915,57290,34461,43532
98043,2514,3023,62207,35836,3.01859e+13,749.621,10420.9,98043,708,456,95020,94815,91703,92170,84747
44171,2751,2954,31674,12497,4.69758e+13,1266.11,9519.12,44171,1146,327,41217,41172,40831,40710,40294
98446,3599,4182,67142,31304,4.60462e+13,1319.63,14347.2,98446,1809,481,94264,94068,91248,52146,65016
37788,756,1884,23507,14281,3.09607e+13,438.124,5376.82,37788,381,280,35904,35434,29865,20848,20480
26759,1480,1681,19355,7404,3.07719e+13,536.079,5237.82,26759,515,197,25078,25008,24775,24895,23043
88494,2865,3969,59391,29103,4.03798e+13,1346.26,12275.3,88494,1227,442,84525,84014,77790,28935,45119
58088,1854,2492,36850,21238,3.02936e+13,540.16,7744.32,58088,526,384,55596,55590,52648,53360,46352
23428,786,1083,15100,8328,2.95548e+13,468.594,3386.66,23428,339,227,22345,22062,21543,21181,21612
22339,641,1039,14491,7848,3.07244e+13,445.366,3239.19,22339,332,215,21300,20920,19963,19507,19472
33257,383,1172,21413,11844,2.93262e+13,534.882,4066.64,33257,450,260,30950,28596,27114,26087,17052
62278,887,3200,41241,21037,3.75531e+13,788.376,8924.27,62278,894,347,58904,58308,45864,9262,9563
75936,80,3622,47729,28207,2.94518e+13,783.589,10711.1,75936,959,413,59804,48595,41554,23358,5136
90718,3119,4436,61478,29240,3.60853e+13,1224.24,14498.7,90718,1343,420,86282,85984,81831,81165,75351
17423,225,405,11823,5600,3.37235e+13,285.994,2157.6,17423,257,163,16648,15586,11967,11691,13332
97659,4370,4386,69416,28243,4.62657e+13,1639.15,16357.7,97659,1918,582,93273,93273,93271,93253,93220
73088,1344,3057,47981,25107,3.49927e+13,853.456,8682.36,73088,707,345,70031,69470,58928,11458,15947
48345,804,3548,32625,15720,4.4617e+13,741.457,9003.91,48345,988,412,44275,43371,33121,9221,10588
2362,179,325,1377,985,3.17994e+13,98.1537,585.333,2362,60,55,2037,1913,1775,1926,1224
61167,2064,3569,43666,17501,3.99727e+13,1102.17,11669.5,61167,1187,363,57598,56417,52877,51645,44433
27685,1260,2069,20115,7570,2.79557e+13,401.426,5708.2,27685,507,190,25616,25542,24633,25198,19075
66389,113,3744,47810,18579,4.82023e+13,1510.34,12523.7,66389,1462,404,48577,39126,25182,16421,4201
10939,3029,3137,9377,1562,1.37033e+13,5.13466,5400.67,10939,1567,7,7802,7802,7802,7802,7590
13555,154,840,8721,4834,2.89677e+13,418.033,2408.05,13555,334,182,11459,10812,9498,7961,4105
43788,137,3021,26878,16910,2.91546e+13,421.512,7126.66,43788,921,228,37044,32660,24644,6777,3436
40723,901,2823,28824,11899,3.4372e+13,793.695,8393.92,40723,854,233,37527,36034,30365,32723,15476
58840,2842,3602,39578,19262,4.30787e+13,831.356,9676.27,58840,963,432,55238,55184,51796,21600,26140
85433,1537,4327,61221,24212,4.82886e+13,1684.38,15277.6,85433,1746,568,79232,74757,61056,54860,40491
64265,1560,3425,40163,24102,2.97857e+13,694.002,9264.6,64265,947,376,60840,60575,53713,48995,37464
42153,3056,3619,30834,11319,6.51832e+13,1496.42,9529.61,42153,1208,459,38534,38490,36453,36799,36587
62296,830,3126,38759,23537,2.9683e+13,597.752,8683.98,62296,902,324,59132,58493,48042,30178,29141
70824,358,3637,44921,25903,2.95235e+13,603.092,10461.2,70824,1168,343,64726,60490,46128,29566,13653
74744,1431,3929,47223,27521,2.93664e+13,679.1,11061.3,74744,1071,382,70815,70435,59721,41654,39085
44451,780,2813,29817,14634,2.85206e+13,497.699,7780.55,44451,983,254,41384,40805,32281,23967,15217
57771,3195,3392,41183,16588,4.90309e+13,1404.89,11320.6,57771,1413,348,54379,54379,54379,54379,53639
16207,146,915,10529,5678,3.00805e+13,459.394,2699.12,16207,342,194,13723,13003,10942,9594,2878
29139,45,1449,18756,10383,2.91915e+13,534.13,4243.28,29139,446,243,19117,11856,14059,2228,901
24454,700,1215,15864,8590,3.04502e+13,558.555,3677.87,24454,386,218,23211,22752,21724,20846,21000
50112,2798,2966,35458,14654,3.27835e+13,847.918,9382.9,50112,925,251,47146,47146,47146,47146,46209
59738,2634,3450,42817,16921,4.93844e+13,1313.57,11538.7,59738,1338,354,56288,55880,52714,52935,51959
97682,2839,3664,61429,36253,2.98265e+13,998.204,11599.7,97682,749,460,94018,93708,93251,93515,90063
47032,463,3613,34013,13019,6.38411e+13,1526.29,10263,47032,1431,443,38155,35512,19343,18011,8445
77716,17484,21927,63603,14113,2.41579e+13,5342.14,35516.1,77716,7098,22,55789,55789,54832,47129,48785
14334,273,1275,10147,4187,2.97254e+13,647.406,3606.23,14334,632,135,11959,10968,6661,2946,4253
18264,1060,1261,13344,4920,3.05741e+13,294.119,3755.32,18264,363,169,17003,16911,16726,16902,15023
46498,1025,2990,33450,13048,4.77668e+13,1256.9,9812.43,46498,1153,328,41593,39207,32356,30074,22759
80330,1557,4320,57849,22481,4.95199e+13,1653.35,14657.5,80330,1674,557,74300,69935,56510,51747,38784
4179,363,420,3043,1136,3.12995e+13,168.269,1151.88,4179,175,86,3759,3759,3692,3738,3321
58387,2330,3450,41969,16418,4.24151e+13,1249.78,11361.1,58387,1190,356,54937,53737,48804,49571,44223
82731,2281,4257,53154,29577,2.94818e+13,759.894,12576.3,82731,1237,399,78474,78305,75936,76608,56373
6877,100,595,4984,1893,3.23071e+13,186.89,1691.39,6877,223,105,5698,5112,3453,1859,1434
98781,2714,4593,67082,31699,4.22652e+13,1483.23,15652.9,98781,1636,435,94188,93266,84587,82561,67383
92659,810,4379,66574,26085,4.61705e+13,1771.36,15655.5,92659,1686,607,82792,78860,46899,34917,16989
43153,2102,2111,27526,15627,2.95132e+13,602.012,6369.87,43153,549,342,41042,41042,41042,41042,40995
78876,2362,3876,54008,24868,4.70288e+13,1200.04,12131.2,78876,1406,468,75000,72770,63383,29403,41181
90888,2093,3479,59486,31402,3.42698e+13,945.746,10693.3,90888,748,389,87409,86751,80804,73501,41725
63027,306,3121,41392,21635,2.96287e+13,663.392,9254.23,63027,1182,269,57205,54108,35763,17214,12304
64054,2950,3736,43821,20233,4.68315e+13,1133.62,10981.7,64054,1337,462,60318,60089,55689,29787,37995
49436,1498,1951,31831,17605,2.97321e+13,556.184,6424.1,49436,533,338,47485,47481,46347,45321,42100
31667,975,1699,22848,8819,2.75503e+13,636.65,5663.07,31667,758,215,29916,29166,26742,27781,21810
12358,1299,2357,9167,3191,6.30904e+13,455.771,4429.06,12358,602,240,10001,9734,6930,7034,6851
30637,766,1104,19766,10871,2.99047e+13,519.68,3836.82,30637,402,252,29533,29483,28109,27940,26983
71128,1145,4171,49796,21332,5.19729e+13,1414.62,13247.6,71128,1744,529,64381,60824,43726,28105,22004
71895,1955,3548,45116,26779,2.92497e+13,754.519,10310.2,71895,952,403,68347,68080,62501,64074,51790
13075,119,1808,9224,3851,6.59991e+13,302.3,3576.4,13075,286,275,10160,8842,4707,2541,279
21519,1505,1563,15529,5990,2.98061e+13,455.126,4633.84,21519,459,192,19956,19956,19938,19915,19667
95268,11790,52130,83468,11800,8.60486e+11,17.2975,52785.1,95268,3470,51,43138,43132,14444,11961,11603
30100,1800,2130,21748,8352,2.8953e+13,494.643,6088.31,30100,565,196,27970,27970,27879,27965,26596
56693,1040,2417,34913,21780,3.06969e+13,574.776,7076.66,56693,457,375,54276,54063,44340,28143,28770
37930,148,2911,26898,11032,4.61006e+13,1077.84,8699,37930,999,316,28983,25055,16676,15418,4222
71320,2156,2704,44624,26696,3.03257e+13,654.162,8741.94,71320,549,418,68616,68525,64620,66051,60247
27179,234,1588,17558,9621,2.95927e+13,442.59,4525.58,27179,405,269,24006,22114,20145,17734,7140
76095,1013,4249,53429,22666,5.06104e+13,1385.31,14008.6,76095,1757,532,68533,64684,47443,31056,22899
34019,1579,3380,23000,11019,4.53817e+13,589.912,7699.25,34019,933,354,30639,30180,22616,8554,9644
34548,515,2863,24365,10183,4.82813e+13,1174.78,8251.74,34548,1096,300,28869,26964,19982,18358,10339
64635,380,3739,41599,23036,2.9201e+13,559.907,10404.8,64635,1230,322,58939,55570,39185,20009,9535
50295,2761,3082,35120,15175,2.75802e+13,658.198,8831.52,50295,898,281,47213,47213,47209,47213,46045
57240,2547,3502,38239,19001,4.15736e+13,801.158,9370.28,57240,973,415,53738,53558,48471,18385,22293
72681,2428,3952,47345,25336,2.95732e+13,671.38,11553.7,72681,1235,385,68729,68613,68005,68376,45637
82859,3530,4215,57511,25348,4.85946e+13,1377.68,14140.3,82859,1775,527,78644,78537,75973,53942,59435
99179,1966,4371,69672,29507,4.56185e+13,1549.51,16141.7,99179,1807,572,93877,89646,74730,53111,47739
61160,2592,3781,42119,19041,3.09554e+13,834.962,10955.8,61160,1048,284,57379,57345,57133,57306,48458
11123,1647,2085,8033,3090,7.30546e+13,247.207,3808.18,11123,436,153,9038,9035,8834,9038,7265
3910,843,1102,2568,1342,4.23757e+13,86.4494,1689.15,3910,265,101,2808,2800,2806,2796,2303
78899,1723,4199,56133,22766,5.02067e+13,1375.16,14364.3,78899,1706,540,73771,69368,56277,46403,42454
73803,1554,3814,49275,24528,3.09745e+13,840.356,11544.5,73803,1237,287,69989,69239,66013,55899,33490
88921,3301,4248,62277,26644,4.74139e+13,1336.28,15045.3,88921,1778,552,84673,84483,79706,61550,67045
74817,897,3685,50520,24297,4.20733e+13,1134.69,11196.2,74817,1192,438,69620,67944,51026,13483,14156
70662,1822,3619,50708,19954,3.97205e+13,1229.68,12602.4,70662,1323,387,66700,64262,59595,57346,47873
14834,330,965,9574,5260,2.91831e+13,374.126,2644.57,14834,314,177,13537,12584,12341,11669,9033
84079,3896,3970,57626,26453,4.6862e+13,1264.96,12617.6,84079,1381,480,80109,80109,79952,79868,79545
31827,2740,2867,22465,9362,4.88666e+13,1126.19,7947.64,31827,1007,302,28960,28878,28901,28845,28625
98417,781,4325,68751,29666,4.58327e+13,1335.85,15801.3,98417,1846,546,89160,85791,64819,39773,26370
80461,2385,2796,51292,29169,2.92209e+13,636.057,9225.78,80461,656,427,77665,77597,76048,76434,72979
36017,2559,3663,25771,10246,6.01739e+13,1188.43,8876.24,36017,1211,442,32354,31349,26635,23843,25170
17373,523,1331,11209,6164,2.91793e+13,427.353,3322.51,17373,430,197,15943,15041,14841,13852,11687
24295,210,1561,14944,9351,3.12307e+13,287.106,3953.25,24295,320,218,22101,20417,16650,9243,5509
48499,2651,3024,32316,16183,3.88606e+13,695.609,7616.97,48499,741,331,45475,45475,44268,42017,37024
40541,3219,3489,27656,12885,4.87586e+13,697.805,8456.84,40541,983,413,37052,37051,36466,35295,33001
12752,1619,2313,9371,3381,6.74754e+13,417.523,4437.75,12752,511,159,10439,10355,10212,10244,7490
23695,2102,2218,16375,7320,3.63518e+13,763.423,6018.37,23695,723,197,21477,21477,21477,21477,20991
38179,2293,3402,27629,10550,5.84678e+13,1491.39,8865.96,38179,1164,302,34777,32241,29915,30117,30608
1106,61,510,704,402,2.64764e+13,44.0325,631.204,1106,181,62,592,349,434,411,26
87038,1754,4413,62327,24711,4.29823e+13,1697,15103.5,87038,1648,485,81510,77429,67281,65245,39833
47238,197,3793,34004,13234,6.05268e+13,1414.41,10420.6,47238,1345,451,35763,31256,17729,11979,3258
41230,88,1302,26521,14709,2.86798e+13,526.813,4527.81,41230,455,292,33392,27640,24766,22950,7879
29290,551,1639,18793,10497,2.93245e+13,501.894,4573.18,29290,420,246,27499,26246,24516,23149,16248
8446,635,723,5442,3004,2.98267e+13,352.513,1818.2,8446,287,148,7723,7716,7612,7607,7620
81870,3796,3922,54337,27533,3.90297e+13,1159.02,11317.1,81870,1058,423,77948,77948,77934,77942,77461
85503,1393,4114,54614,30889,2.95181e+13,744.881,12496.6,85503,1244,401,81389,80924,68635,46886,41999
33835,1408,1616,21840,11995,2.97357e+13,495.377,5012.43,33835,455,290,32219,32219,31885,31752,30144
16250,1519,2788,11691,4559,6.77159e+13,657.403,5352.43,16250,669,396,13462,12927,8173,7904,8845
49444,2374,3647,35413,14031,5.47262e+13,1553.94,10731.2,49444,1447,410,45797,43542,38217,39057,38198
7537,1203,1480,5598,1939,6.2774e+13,231.892,2665.66,7537,416,156,6057,6057,5562,5655,5377
42827,2470,2738,30689,12138,2.71144e+13,713.545,7835.68,42827,812,259,40089,40089,40086,40086,39136
60397,1907,2196,39004,21393,2.98497e+13,571.159,7193.71,60397,599,335,58201,58201,57842,57840,57528
41746,229,2875,29605,12141,3.46828e+13,812.308,8616.97,41746,861,234,35540,31617,21746,10418,4858
71427,2386,3848,49489,21938,4.90153e+13,1223.58,11982.2,71427,1364,470,67579,65162,57532,31997,40723
64600,1291,3894,45138,19462,5.11389e+13,1265.06,11727.7,64600,1472,468,59095,56016,40075,22893,20174
86184,3608,4242,60083,26101,4.8228e+13,1374.74,14634.6,86184,1784,533,81942,81886,79785,59101,64546
17636,538,2844,12458,5178,5.71037e+13,379.193,5515.04,17636,679,322,14727,14085,8170,4021,3125
48973,1736,2112,30367,18606,3.09054e+13,491.087,6209.94,48973,440,307,46861,46824,45243,45919,43292
26689,1231,2083,15960,10729,3.0303e+13,297.547,4220.04,26689,554,159,24606,24606,24362,24598,22882
21300,245,407,14446,6854,3.33427e+13,287.864,2378.26,21300,268,178,20585,19715,14873,15930,16677
25418,692,1945,18160,7258,2.61166e+13,630.416,5432.96,25418,777,212,23142,22152,13868,11147,8665
79208,3395,3953,56988,22220,4.59313e+13,1692.76,14073.9,79208,1623,470,75255,74940,73811,72535,72014
84703,2454,3608,55516,29187,3.43019e+13,1158.65,10749.6,84703,833,364,81095,80571,75498,60320,34841
15950,96,2069,10998,4952,3.7765e+13,551.208,4693.12,15950,550,174,11354,8935,6255,5489,1553
62997,2314,3924,44239,18758,5.23371e+13,1276.95,11631.2,62997,1403,461,59073,56452,48212,30740,35175
54021,1566,2181,35196,18825,3.30623e+13,559.071,6335.9,54021,545,329,51840,51835,49872,47910,44054
67133,3500,3816,48292,18841,4.97977e+13,1481.92,12678.1,67133,1465,477,63317,63317,62551,62907,62309
9481,632,1006,6129,3352,3.0326e+13,298.184,2282.35,9481,270,186,8475,8431,7809,7527,3583
8006,738,1819,5830,2176,5.26132e+13,238.119,3203.91,8006,469,155,6187,6178,3767,4332,2405
43992,3372,3377,31252,12740,5.42914e+13,1454.69,9895.42,43992,1295,342,40615,40615,40615,40615,40606
29592,833,1105,19066,10526,2.92915e+13,514.512,3778.75,29592,400,244,28487,28446,27591,27503,26817
57223,2488,3514,40712,16511,4.07819e+13,1090.18,11238.1,57223,1173,355,53709,53466,49235,50050,45755
7085,306,499,4137,2948,3.24991e+13,189.69,1154.94,7085,137,90,6586,6512,5922,6200,5096
95328,673,25279,77862,17466,2.66731e+13,6029.51,41137.4,95328,8497,27,47046,42352,27535,22922,1680
71099,2660,3710,51036,20063,4.5289e+13,1543,12998.6,71099,1446,382,67389,66922,58729,61151,55493
51247,1008,3101,36575,14672,4.22882e+13,1133.26,10239.8,51247,1114,346,46855,44275,38501,37659,25176
25290,1172,2233,17435,7855,3.67203e+13,723.465,6179.41,25290,696,202,22954,22022,21845,20191,16269
90666,1699,4088,57878,32788,2.94733e+13,823.491,12761.7,90666,1184,432,86578,86066,76934,59444,53700
63443,1316,3086,41793,21650,2.9657e+13,634.11,9211.41,63443,1171,266,60357,59856,54968,48149,31483
65510,2424,4005,45810,19700,3.34341e+13,1052.09,12095.4,65510,1084,378,61505,61320,59535,58659,47587
76877,1438,2969,49920,26957,3.29679e+13,675.998,8845.67,76877,635,354,73908,73764,67229,64142,47435
49114,669,2340,31300,17814,3.0128e+13,565.078,7006.73,49114,542,363,46575,45824,39315,34559,21384
54445,1243,2037,35061,19384,2.95406e+13,515.817,6433.75,54445,516,323,52408,52393,50906,50908,46652
49383,1216,2984,30390,18993,2.94196e+13,495.551,7574.42,49383,882,283,46399,46221,39500,36074,28096
90434,460,4541,64280,26154,4.23557e+13,1685.15,15551.4,90434,1691,492,77256,71985,44495,22086,7832
53502,2513,3815,37651,15851,5.5336e+13,1159.62,10690.4,53502,1363,460,49687,48355,42621,28170,33121
27967,228,2072,20029,7938,2.65745e+13,625.084,5804.82,27967,791,229,23141,20653,12563,4133,1607
43864,3414,5025,31926,11938,2.73396e+13,723.456,11137.2,43864,1422,249,38839,38839,34808,35406,24722
70831,2604,2615,45465,25366,2.96298e+13,582.072,8458.94,70831,612,404,68216,68216,68216,68216,68187
97503,1959,4591,69716,27787,4.48343e+13,1687.56,16494.7,97503,1855,588,91971,87823,75049,67662,54316
27405,864,2760,23292,4113,4.22353e+13,16.9876,3387.58,27405,1383,1378,24645,24645,13305,19914,18504
37163,1054,2644,23576,13587,2.90284e+13,397.748,6516.76,37163,997,185,34519,34249,32826,30519,21437
40887,2254,2571,29248,11639,2.91159e+13,807.128,7647.76,40887,812,234,38316,38316,38310,38316,37502
92875,3578,4026,63414,29461,4.46832e+13,1412.17,13181.9,92875,1420,477,88849,88661,86870,81736,71780
84712,2415,2904,53139,31573,3.00025e+13,681.299,9680.15,84712,599,453,81808,81672,78055,79483,74004
1820,247,281,1351,469,2.27425e+13,167.715,658.845,1820,162,52,1539,1538,1539,1539,1539
34029,100,481,23103,10926,3.354e+13,296.814,3056.72,34029,289,214,23410,11116,15120,11963,13821
61793,268,3543,44226,17567,4.04673e+13,1108.36,11710.4,61793,1203,375,52347,48578,30116,13985,9397
79541,1054,2865,49686,29855,3.05896e+13,678.721,9360.38,79541,577,454,76676,76283,63468,47075,36149
34472,2126,3390,25272,9200,6.32831e+13,1447.66,8527.94,34472,1043,398,31001,28367,24541,24603,23837
40335,2635,3559,27691,12644,5.01869e+13,711.356,8579.1,40335,930,415,36776,36582,32476,17523,19914
95787,1376,3237,61624,34163,3.12894e+13,900.176,10603,95787,782,446,92550,92047,81558,77519,60117
47213,1699,2842,28743,18470,3.1102e+13,542.733,6847.74,47213,620,308,44371,44273,41668,42777,39148
57557,3843,31504,50424,7133,8.62196e+11,14.9341,32008,57557,2140,50,26053,26053,6381,5296,4486
46910,148,538,31800,15110,3.35389e+13,296.992,3613.41,46910,296,240,38980,24336,26068,19506,23608
79451,1857,4237,55972,23479,4.94672e+13,1365.22,14329.1,79451,1766,527,74461,70104,57006,44544,40360
12879,817,851,8265,4614,2.89912e+13,424.146,2370.62,12879,335,176,12028,12028,12019,12028,11998
54907,945,3127,39701,15206,4.47542e+13,1251.37,10727.8,54907,1159,363,49511,46964,38724,37833,24330
52148,1974,3035,33738,18410,2.92504e+13,504.39,8251.29,52148,1149,235,49113,49078,48227,46114,38328
52534,1924,2083,33912,18622,2.94123e+13,556.492,6694.06,52534,545,333,50451,50451,50313,50375,50251
48746,2159,3055,30053,18693,2.98878e+13,545.161,7581.95,48746,704,314,45691,45671,45635,45685,42662
66145,873,2621,41583,24562,3.0304e+13,616.942,8345.18,66145,567,404,63479,62895,53018,42056,30407
91777,1303,20475,71041,20736,2.82792e+13,2408.98,34579.9,91777,5733,249,65204,60126,31928,15337,2888
10207,247,809,6577,3630,3.03348e+13,385.061,2136.3,10207,328,169,8900,8225,7660,7122,2731
14637,799,1653,9044,5593,2.70506e+13,273.958,3344.56,14637,551,128,12984,12956,12189,12536,9494
92826,869,4667,62223,30603,3.42645e+13,1194.22,14715.1,92826,1370,411,86236,83871,59886,49561,24116
3041,8,362,1776,1265,3.25168e+13,117.204,693.142,3041,76,67,1983,1541,1280,319,112
83940,2695,4231,58191,25749,4.82171e+13,1373.57,14264.9,83940,1791,530,79709,79188,70072,47338,53386
97500,3270,4771,64496,33004,3.16838e+13,1016.39,15181.8,97500,1373,390,92729,92481,92691,92303,77286
43863,3486,3812,31556,12307,6.15667e+13,1278.49,10035,43863,1297,454,40051,39987,39594,37650,35202
10433,239,367,7100,3333,3.41174e+13,267.167,1648.51,10433,228,129,9927,9483,7382,7754,8488
21413,189,424,14498,6915,3.34496e+13,293.342,2407.15,21413,269,179,19893,15828,13945,13754,14018
2908,438,710,1868,1040,3.00115e+13,169.067,1233.89,2908,213,92,2198,2075,2045,2093,1797
25638,273,1609,15910,9728,3.03428e+13,321.848,4194.59,25638,347,229,23474,22345,18397,12262,8451
33291,3188,14604,26635,6656,138052000,793.427,21040.6,33291,3348,11,18687,16630,14577,18687,3826
63748,622,3690,43375,20373,4.41486e+13,1090.47,10584.2,63748,1148,428,57953,56348,39593,9949,8241
28160,1344,1743,20393,7767,3.07965e+13,492.877,5351.68,28160,512,204,26417,26220,25552,26099,21307
34283,1474,2784,24386,9897,4.36935e+13,848.711,8032.72,34283,838,305,31451,30086,27635,25612,23405
14569,2264,2451,10931,3638,6.80625e+13,566.216,4903.85,14569,625,225,12118,11987,11556,11602,11421
98049,272,3349,61582,36467,3.05528e+13,829.964,10922.4,98049,657,485,89603,83769,69721,50168,18156
67764,2135,2317,43725,24039,2.94479e+13,568.024,7704.03,67764,606,361,65447,65447,65145,65047,65137
28888,2228,2390,18970,9918,2.73531e+13,401.123,5913.48,28888,876,189,26498,26498,26470,26498,25553
5766,96,792,4143,1623,3.05392e+13,330.089,1880.23,5766,381,93,3412,1492,1836,874,823
23714,1350,2512,16470,7244,3.86126e+13,795.776,6360.13,23714,810,246,21185,20262,19868,18383,15276
30062,405,1763,17778,12284,3.17256e+13,316.445,4029.45,30062,417,194,28296,27817,18970,4890,3003
89473,242,4242,61592,27881,4.70488e+13,1404.44,14546.7,89473,1789,534,72888,65186,47629,18162,7661
20242,66,977,11816,8426,3.20975e+13,273.529,2429.54,20242,305,142,17127,15598,11443,3786,2494
42235,413,2650,29492,12743,2.84166e+13,574.78,7545.56,42235,879,267,38001,35543,24078,11301,6023
80633,1821,3874,53199,27434,2.98032e+13,712.533,11836.8,80633,1239,350,76759,76461,74337,74011,42468
78005,1088,4241,56062,21943,5.04166e+13,1701.65,14424.5,78005,1657,558,70248,66048,49086,45822,24408
74739,348,3588,47168,27571,2.95738e+13,781.244,10709.6,74739,957,399,68138,63201,50346,34357,14749
97489,2541,3118,62350,35139,3.0737e+13,874.963,10558.5,97489,723,455,94371,94124,91681,91019,88063
36700,1115,1445,23637,13063,3.00761e+13,542.287,4533.93,36700,502,288,35255,35249,34402,33846,33196
97132,3177,3918,65991,31141,4.36115e+13,1254.88,13205.7,97132,1424,468,93214,92876,88611,41420,57380
23598,352,976,15162,8436,2.9199e+13,482.572,3237.35,23598,382,228,21789,20306,19508,18501,12018
11308,291,780,7309,3999,2.96705e+13,375.803,2170.42,11308,295,168,10074,9347,9012,8704,5708
31884,1739,2608,22434,9450,3.79249e+13,803.658,7417.97,31884,821,267,29276,28611,28252,27848,25094
82259,2024,2846,51379,30880,3.05966e+13,684.11,9496.37,82259,596,446,79413,79227,72357,73650,59731
63714,400,3740,43459,20255,4.54072e+13,1074.18,10823.4,63714,1267,441,55937,51617,38151,9708,6250
39585,2515,2663,25579,14006,2.90774e+13,451.403,7013.77,39585,1043,198,36922,36922,36903,36922,35722
90236,4006,4524,64198,26038,4.34159e+13,1741.66,15592.4,90236,1672,544,85712,85708,84655,83964,82754
50774,270,572,34427,16347,3.35157e+13,300.347,3789.91,50774,299,244,49694,47179,34633,33768,33672
46738,1025,3053,33338,13400,4.38468e+13,1115.91,9750.67,46738,1038,332,42432,40214,34676,34066,23016
27358,678,1696,19886,7472,3.01098e+13,469.772,5215.41,27358,476,201,25618,24910,19620,18902,9862
39105,1274,2593,27004,12101,2.80731e+13,546.063,7239.2,39105,886,260,36512,36200,32188,30176,18582
96495,3749,4323,67019,29476,4.56292e+13,1342.59,15546.3,96495,1816,551,92172,92128,90411,65988,73050
42852,2864,2983,30689,12163,4.70781e+13,1274.44,9395.3,42852,1148,327,39869,39851,39817,39817,39427
85640,2158,2633,55080,30560,2.92104e+13,622.784,9005.85,85640,677,390,83007,83003,81907,81699,80207
70407,2476,3939,50313,20094,3.76525e+13,1272.45,12848.4,70407,1327,396,66468,66161,61581,59985,52301
72756,559,2306,46929,25827,2.97851e+13,575.568,7839.11,72756,604,353,70124,65984,59749,58863,39015
26943,1020,1072,17311,9632,2.90219e+13,497.632,3584.82,26943,404,245,25871,25871,25808,25836,25759
14345,167,1984,9497,4848,4.55767e+13,807.873,4366.17,14345,671,165,10380,9354,7216,6110,1155
64755,1447,2664,41198,23557,2.97009e+13,587.153,8344.44,64755,602,407,62091,62025,57780,51352,45342
62628,1240,3651,39594,23034,2.99086e+13,566.84,9913.16,62628,1159,317,58977,58730,49282,42669,27888
64362,1505,3834,44804,19558,5.11791e+13,1218.1,11518,64362,1366,466,59350,56736,44222,22893,24832
53237,41,3632,36172,17065,4.67399e+13,861.546,9552.9,53237,981,418,32272,20182,17897,4978,2136
81531,1501,3703,54860,26671,4.06092e+13,1177.32,11417.8,81531,1159,439,77161,75197,59726,17218,25261
30073,250,1098,19431,10642,2.98616e+13,524.176,3779.58,30073,382,239,26917,25009,23453,22932,12897
77382,1539,3830,53177,24205,4.7733e+13,1130.49,11990.5,77382,1376,477,72681,70162,55869,22920,31221
23763,604,2008,15025,8738,2.65683e+13,305.378,4611.49,23763,681,157,21741,20780,18288,16970,12696
31121,355,1675,20072,11049,2.9539e+13,522.417,4946.23,31121,437,279,28490,26451,24303,23152,11463
48801,554,3200,34662,14139,3.04859e+13,885.61,9273.21,48801,944,263,43959,40742,25443,12320,4301
59795,643,2539,38034,21761,2.99569e+13,558.665,7899.29,59795,545,394,57103,55872,48745,42023,27060
36863,1250,2669,24688,12175,2.77783e+13,498.738,7056.04,36863,953,231,34194,33949,31561,27917,15298
21538,362,405,14578,6960,3.33075e+13,282.055,2382.46,21538,260,174,21133,21133,20731,20616,20370
84345,1052,4082,53832,30513,2.95732e+13,756.637,12496.7,84345,1243,397,80227,79307,64355,41633,27514
10299,691,723,6633,3666,2.95434e+13,389.547,2001.13,10299,275,162,9576,9570,9548,9545,9542
88670,128,4258,61912,26758,4.77204e+13,1330.09,14844,88670,1797,544,67923,57633,39926,20374,4745
50316,465,1430,32442,17874,2.95116e+13,556.418,5123.95,50316,497,313,48107,44517,41615,39978,26079
5629,444,669,3631,1998,3.00031e+13,278.092,1503.93,5629,236,137,4960,4711,4686,4468,3764
62444,2024,3588,41305,21139,3.82421e+13,789.867,9532.05,62444,959,389,58856,58181,47558,13569,17656
30057,157,3011,21893,8164,6.17687e+13,1306.5,7595.31,30057,949,276,21816,18646,10619,8349,1951
74143,26383,30946,59319,14824,1.24e+08,1064.49,45552.1,74143,7445,11,43197,43197,42056,43197,37504
16117,662,1303,10359,5758,2.96365e+13,371.973,3292.83,16117,347,220,14814,14706,13151,13247,7351
58423,178,2211,38182,20241,3.43938e+13,567.913,6651.2,58423,507,327,50284,47207,39519,5020,3094
84345,783,4003,55020,29325,2.97185e+13,706.137,12353.5,84345,1246,387,79867,78515,58748,37975,25954
3974,308,449,2549,1425,2.7834e+13,149.126,984.216,3974,137,103,3525,3427,3397,3386,2638
38114,3196,3726,27393,10721,6.11129e+13,1195.72,9215.06,38114,1232,452,34388,34310,33740,28572,29434
36973,1236,1723,23876,13097,2.99566e+13,488.157,5242.92,36973,412,284,35250,35228,34709,34318,31092
47481,3225,3639,32493,14988,4.89795e+13,804.827,9200.63,47481,1004,419,43842,43764,42500,40391,30997
77579,16673,21733,63661,13918,2.42349e+13,5027.68,35167.3,77579,7311,22,55846,55846,53045,52510,49249
30166,745,1133,19477,10689,2.93826e+13,513.87,3796.3,30166,444,250,29033,28886,27439,27105,26370
29948,293,2684,21210,8738,4.30009e+13,820.551,7381.33,29948,820,287,24572,22648,17356,16175,7414
49037,29,1535,31699,17338,3.00172e+13,567.651,5211.89,49037,496,318,27508,16127,18077,2195,715
24965,2032,2855,17239,7726,5.08475e+13,479.976,6290.64,24965,765,327,22110,21876,19715,11437,11442
53422,1406,2163,32992,20430,3.06044e+13,573.092,6586.21,53422,460,360,51259,51165,45575,44019,37000
1169,20,238,683,486,3.2487e+13,40.4072,374.476,1169,44,33,883,785,532,289,166
97473,4026,4115,66614,30859,4.60572e+13,1368.11,14261.5,97473,1746,471,93358,93346,93191,93081,91535
49157,61,1463,31636,17521,2.96722e+13,576.144,5133.19,49157,518,311,35586,24546,27280,24224,5435
53197,1563,3496,35297,17900,3.98654e+13,758.744,9063.07,53197,1005,418,49701,48871,39204,10534,12544
17467,220,405,11877,5590,3.37676e+13,286.21,2159.13,17467,256,163,16659,15534,11721,11364,13139
17914,1363,2461,12963,4951,6.02497e+13,775.339,5366.09,17914,762,196,15453,14719,10689,11556,9859
32339,107,1771,20201,12138,3.03047e+13,433.461,4920.32,32339,376,269,27336,25067,20488,12610,5069
74288,723,3897,47714,26574,2.93466e+13,607.464,11309.1,74288,1243,347,70035,68492,51909,32484,23687
75504,2863,4283,53910,21594,5.1368e+13,1412.75,14204.8,75504,1714,545,71221,71025,64435,59424,60729
55058,2012,3537,38063,16995,2.77191e+13,733.368,9698.06,55058,949,281,51521,51426,50047,51095,37359
99816,3693,4372,64239,35577,2.93072e+13,890.541,13946.1,99816,1259,437,95444,95403,95444,95428,90659
5283,89,482,3860,1423,3.0996e+13,175.421,1366.15,5283,191,111,4351,3939,2499,2326,1105
84207,609,2802,53633,30574,2.97518e+13,659.986,9430.92,84207,646,433,81027,78307,67886,60199,42979
95250,3974,4505,65614,29636,3.86496e+13,1325.75,15310.3,95250,1447,445,90745,90701,88888,88262,87168
47025,92,3084,28791,18234,3.03466e+13,512.057,7247.96,47025,704,298,38849,34035,26437,10202,1664
83484,3936,4349,57541,25943,3.70717e+13,1228.23,14220,83484,1333,417,79135,79101,78471,77955,77176
33788,2501,3613,24375,9413,6.27067e+13,1222.41,8633.21,33788,1200,448,30175,28992,24599,23016,24466
76639,667,3893,51004,25635,3.11112e+13,875.421,11795.2,76639,1305,288,71320,69166,51122,33003,25289
62649,1327,3614,40774,21875,2.94608e+13,627.242,9947.65,62649,1207,270,59035,58581,50047,48475,28170
65106,1980,2634,41068,24038,3.03537e+13,590.069,8307.97,65106,546,420,62472,62400,58512,59383,51492
99439,1547,4366,71017,28422,4.4828e+13,1635.45,16462.2,99439,1851,587,93162,88731,73987,65465,49291
58035,2322,3057,35989,22046,3.00678e+13,559.675,8264.55,58035,896,318,54978,54968,54948,54978,51401
41136,327,1737,26552,14584,2.92584e+13,533.088,5250.12,41136,498,291,37501,34620,32525,31284,20891
40345,948,1299,26022,14323,2.971e+13,545.034,4555.6,40345,457,278,39046,39037,37689,36942,36233
5170,391,792,3717,1453,2.79354e+13,193.322,1751.59,5170,319,92,4378,4252,3481,3417,2846
50521,641,1939,32549,17972,2.94058e+13,541.967,6112.08,50521,526,313,48555,47813,42580,41605,34149
78424,2151,3664,49174,29250,2.95097e+13,810.97,10835.2,78424,958,412,74760,74517,69483,71307,59690
90638,33283,49587,79404,11234,8.6313e+11,17.4517,50226.1,90638,3344,51,41051,41051,29444,30884,28392
65436,3527,4176,46643,18793,5.38778e+13,1433.62,13034,65436,1661,522,61260,61241,59684,55151,55494
54196,2010,3314,38647,15549,3.48468e+13,959.623,10382,54196,1004,321,50882,50696,49170,47758,42791
80322,518,709,54481,25841,3.35691e+13,302.799,4839.92,80322,310,268,79613,79613,70231,73598,69514
29885,1119,1611,18969,10916,3.05404e+13,471.797,4624.58,29885,432,264,28274,28268,26827,27222,23317
87937,3272,4254,60867,27070,4.742e+13,1339.51,14691.9,87937,1802,532,83683,83492,78241,55717,62913
25297,1232,1292,14863,10434,3.20451e+13,298.156,3060.28,25297,374,169,24005,24005,23970,23953,23797
10613,9,760,6899,3714,2.99959e+13,384.213,2079.83,10613,279,164,3420,1312,1149,574,202
61589,162,2533,39302,22287,2.96382e+13,599.387,8020.16,61589,617,411,53042,49361,42066,34095,8991
4253,533,549,2747,1506,3.33871e+13,237.477,1175.23,4253,177,123,3704,3704,3701,3700,3700
3958,289,388,2306,1652,3.16655e+13,143.952,797.612,3958,84,80,3570,3545,3424,3492,3128
38568,926,2928,27539,11029,4.81681e+13,1305.57,8869.37,38568,1141,318,33759,31711,25628,23440,16602
81952,1520,4478,54332,27620,3.09867e+13,923.661,13162.7,81952,1336,332,77474,76362,67660,66705,33407
38791,1846,2547,23755,15036,2.88581e+13,387.723,5956,38791,888,175,36244,36244,36191,36241,30650
25962,1626,1641,16698,9264,2.99337e+13,445.115,4502.54,25962,433,265,24321,24321,24321,24304,24307
97178,698,3296,63056,34122,3.22974e+13,853.355,10600.6,97178,730,433,93549,92401,77895,9678,14191
7973,330,723,5171,2802,3.06076e+13,304.187,1764.2,7973,251,140,7109,6752,6563,6225,4796
74669,1770,3915,48664,26005,2.95172e+13,673.773,11596.7,74669,1237,382,70754,70533,67104,66810,41412
15066,498,896,9727,5339,2.8912e+13,403.272,2580.02,15066,309,187,14154,13311,12844,12226,9858
77637,2314,4277,55704,21933,4.96785e+13,1688.5,14391.7,77637,1634,554,72968,69938,58363,57452,50352
92762,1806,4501,64611,28151,4.04365e+13,1439.09,15403.9,92762,1458,452,87508,84256,74390,64627,46503
91311,1694,4421,63704,27607,4.03717e+13,1338.59,15119.9,91311,1446,451,86127,83095,72749,63104,41180
94072,992,3950,64163,29909,4.48778e+13,1276.12,13436.2,94072,1525,471,87353,84444,62927,23400,20930
62035,3520,3722,40058,21977,2.91818e+13,560.148,10071.3,62035,1216,285,58313,58313,58313,58313,57397
96067,1660,4211,62941,33126,2.99472e+13,808.262,13502.2,96067,1263,423,91856,91398,79514,72597,44950
63033,781,3557,39777,23256,2.92764e+13,553.866,9668.94,63033,1068,315,59430,58566,45672,27635,23442
47406,2390,2833,31583,15823,3.87559e+13,684.837,7214.74,47406,707,333,44573,44467,43056,40630,31767
2186,8,533,1720,466,9.41167e+13,116.982,905.447,2186,72,87,870,447,141,424,30
30754,778,1755,22282,8472,3.00571e+13,582.449,5643.3,30754,529,217,28750,28263,22829,23243,13726
77706,2290,2383,50113,27593,2.94707e+13,585.118,8204.4,77706,642,375,75323,75323,75216,75140,75256
49785,2795,3781,35038,14747,5.49644e+13,1121.12,10252.1,49785,1346,450,46004,45828,41111,28147,32379
36986,408,1937,22797,14189,3.09994e+13,411.545,5326.4,36986,383,280,34684,33457,26417,16033,13057
51647,2457,3395,37025,14622,5.18129e+13,1464.03,10687.3,51647,1408,338,48252,47226,42706,43015,42310
1853,148,407,1208,645,3.32652e+13,88.3006,718.967,1853,103,71,1444,1331,1316,1252,993
39740,1589,2038,25048,14692,3.04907e+13,537.926,5790.84,39740,472,330,37702,37695,35930,36536,32539
5799,43,492,3385,2414,3.18956e+13,179.824,1044.4,5799,112,90,4699,4351,3175,1557,621
80141,281,709,54307,25834,3.35219e+13,303.379,4836.4,80141,310,268,78817,76816,54409,49130,44849
2471,403,453,1619,852,2.8989e+13,80.0789,835.222,2471,110,63,2018,2018,2007,2010,1982
39064,440,2058,23904,15160,3.15752e+13,444.619,5578.15,39064,405,288,36678,35508,26554,15107,8918
33167,706,1116,21429,11738,2.93928e+13,515.981,3935.81,33167,406,254,32051,31873,29970,29696,28329
51397,852,3139,37147,14250,5.02263e+13,1293.19,10461.5,51397,1182,361,45494,43183,33129,30651,22074
91054,1891,4427,63979,27075,4.1617e+13,1553.74,15362.7,91054,1599,454,85918,82723,73235,72177,46096
34764,105,3308,25458,9306,6.23188e+13,1527.99,8460.18,34764,1105,356,23654,17085,10144,6882,2880
30347,1025,1724,18978,11369,3.07501e+13,430.224,4756.2,30347,391,268,28623,28611,25581,24411,18942
44441,2148,2776,28778,15663,2.85377e+13,458.257,7471.85,44441,1076,208,41665,41663,41294,41570,37582
18245,1028,2533,13649,4596,6.41761e+13,995.184,5628.14,18245,732,229,15020,14338,9288,9714,7039
34174,778,1478,22174,12000,3.19859e+13,540.529,4546.12,34174,440,278,32696,32586,28794,27502,20508
22013,801,957,14166,7847,2.90253e+13,492.93,3137.81,22013,389,214,21056,21020,20690,20598,20466
72999,670,4155,50100,22899,3.31524e+13,1086.1,12803.6,72999,1140,376,66504,63948,45520,27253,14932
37445,1522,2862,26539,10906,4.73248e+13,1071.89,8589.23,37445,1045,319,34301,32593,29008,27839,23295
72501,150,3024,47363,25138,3.55614e+13,623.506,8693.71,72501,594,354,61202,57326,46388,6086,3016
64672,2695,5492,41328,23344,2.95158e+13,501.732,10774.5,64672,977,345,59180,59174,56456,58339,55354
90853,1007,4174,61977,28876,4.55125e+13,1295.9,13728.5,90853,1658,473,83886,80685,60330,23781,19469
87900,1069,4426,61830,26070,4.08603e+13,1551.65,15055.8,87900,1513,448,80585,76496,56265,45142,19374
89294,965,3648,56325,32969,2.94651e+13,867.673,11464.2,89294,977,453,85360,84777,70105,49788,37891
90672,2581,4239,63409,27263,4.72262e+13,1321.18,15069.3,90672,1783,547,86433,85120,74719,55180,59208
97530,1340,3012,61279,36251,3.00041e+13,734.577,10457.7,97530,660,468,94518,94079,81556,66099,59323
56544,227,3295,40162,16382,3.27557e+13,941.638,10452,56544,1008,312,46956,41737,27754,11474,10160
45784,327,4564,38965,6819,4.19186e+13,17.1425,5394.31,45784,2285,2280,41220,41220,15830,30636,26332
94035,245,4261,61061,32974,2.95084e+13,830.506,13559,94035,1252,438,83933,77496,56954,25924,8432
87601,3088,3860,59444,28157,4.43708e+13,1254.41,12454,87601,1388,478,83741,83405,78581,35950,50855
49059,652,3796,35123,13936,5.86004e+13,1316.83,10519,49059,1290,466,42044,40559,22731,12001,6544
64875,85,3704,46406,18469,3.80805e+13,1114.58,12019.5,64875,1165,389,43965,30391,21954,6578,2216
76539,2313,2437,49237,27302,2.91091e+13,616.388,8429.68,76539,619,394,74102,74101,74034,74082,73589
24085,239,1231,15624,8461,3.03788e+13,544.084,3681.78,24085,372,224,21397,19877,18218,17430,8129
60974,633,2562,38535,22439,2.96416e+13,553.025,7930.31,60974,534,387,58180,57274,47912,39856,25815
99755,712,4154,67837,31918,4.4851e+13,1308.76,14177.2,99755,1689,480,91175,88804,64274,21744,14673
66850,1714,3732,42628,24222,2.99318e+13,605.933,10545.8,66850,1225,322,63118,62996,59765,60084,41358
98715,3886,4319,69236,29479,4.51017e+13,1390.75,15926.9,98715,1766,566,94396,94350,92984,73725,79021
12298,140,1036,7990,4308,3.21337e+13,383.406,2516.81,12298,338,185,10312,9660,8325,981,959
86444,2196,3978,59352,27092,4.62302e+13,1285.1,13132.9,86444,1499,479,82376,78619,66981,34697,43644
90659,2434,4618,60185,30474,3.15956e+13,1051.86,14442.8,90659,1360,354,86041,85535,84138,85143,49301
64168,3629,3696,43195,20973,4.35765e+13,911.567,10167.4,64168,1012,436,60472,60389,60363,60301,60331
27822,1327,1656,17359,10463,3.08048e+13,426.274,4533.19,27822,376,266,26166,26165,25059,25515,22743
25711,76,1100,15014,10697,3.21142e+13,297.804,2800.26,25711,365,159,22064,20039,14832,4475,3168
73916,2559,3773,53180,20736,4.517e+13,1620.37,13292.6,73916,1556,388,70101,68759,60661,62770,55522
25760,225,1004,16566,9194,2.85789e+13,474.411,3399.58,25760,389,235,22906,21263,19705,18994,9727
43611,646,2106,26688,16923,3.14702e+13,494.148,5878.14,43611,456,301,41354,40991,31227,17286,11618
61546,3224,3625,41843,19703,4.45732e+13,999.972,10251.3,61546,1050,437,57921,57747,55973,47029,39420
16902,577,942,10956,5946,3.04755e+13,459.805,2787.37,16902,319,199,15957,15339,14733,14013,13134
6191,363,546,4027,2164,3.07328e+13,272.258,1383.47,6191,208,130,5620,5343,5351,5259,4374
94654,3634,4136,64700,29954,4.66749e+13,1311.18,14142.5,94654,1798,467,90518,90507,88230,58359,65198
66392,3142,3727,42401,23991,2.96208e+13,577.955,10519,66392,1229,314,62665,62665,62665,62665,58539
80005,2451,3629,50423,29582,2.90781e+13,773.162,10967.4,80005,964,416,76376,76189,75060,75470,66561
41944,102,2937,29652,12292,3.39385e+13,870.525,8679.95,41944,870,259,31038,24751,18152,5166,2834
38062,1606,1955,23462,14600,3.12652e+13,429.586,5431.26,38062,383,287,36107,36103,34764,35265,33102
29493,841,2410,21059,8434,3.06987e+13,679.677,6398.17,29493,863,191,26872,26105,19744,22973,11825
41070,1579,1902,26569,14501,3.01242e+13,567.677,5932.5,41070,496,320,39168,39164,38625,38647,38266
13095,256,1928,8945,4150,3.79356e+13,540.157,4152.08,13095,518,166,10092,8900,7763,7768,3808
58519,642,2669,38733,19786,3.72424e+13,793.714,7488.96,58519,644,320,55470,54582,42297,6195,5275
21801,640,1543,13370,8431,3.10219e+13,272.723,3757.83,21801,297,217,20258,20198,16305,10862,8670
34267,1401,2464,23967,10300,2.75809e+13,573.443,6757.6,34267,853,252,31803,31629,30323,27301,20647
17860,258,386,12083,5777,3.32371e+13,276.278,2157.22,17860,250,161,17297,16580,13257,14322,14960
44241,1873,1888,28523,15718,2.98833e+13,534.332,5995.17,44241,530,317,42353,42353,42353,42351,42319
87548,3547,3957,57520,30028,3.58137e+13,1112.14,11604.1,87548,1040,430,83591,83569,83232,82957,79374
71360,707,2318,45909,25451,2.92121e+13,595.43,7862.93,71360,644,368,69027,68050,60345,59008,43861
80870,468,3999,54010,26860,3.17386e+13,998.237,12814.8,80870,1273,307,73279,69416,49405,26226,19783
79653,2985,4239,56677,22976,4.97493e+13,1385.2,14497.2,79653,1700,537,75414,75237,69376,62496,65205
91725,3566,4460,62956,28769,3.68533e+13,1318.77,14940.4,91725,1436,427,87265,87017,83275,83815,79123
33025,302,1785,20650,12375,3.11964e+13,452.364,5017.01,33025,425,277,30266,28599,23900,16600,9612
27241,323,2988,19982,7259,6.33793e+13,1351.09,7266.47,27241,906,272,20976,19203,9254,8012,4508
16273,735,2469,11868,4405,5.69755e+13,842.229,5224.58,16273,729,193,13255,12781,8046,8066,4998
85057,648,4267,58960,26097,4.81284e+13,1390.24,14463.3,85057,1794,537,75246,72158,50673,25690,15410
76695,462,4240,55001,21694,5.08535e+13,1667.38,14330,76695,1670,554,64948,61317,35628,30450,8266
94555,2628,4190,64828,29727,4.72701e+13,1392.06,14325.3,94555,1785,497,90365,89107,79038,44113,55728
33751,776,1676,21207,12544,3.02641e+13,434.722,4901.37,33751,413,273,32075,31713,28168,22465,22189
88816,800,4109,56486,32330,2.93612e+13,806.15,12359.2,88816,1084,432,84300,83157,65969,47266,31224
14404,71,776,8420,5984,3.2383e+13,261.706,1867,14404,241,124,12135,11032,8365,3612,2307
49989,1947,5196,42375,7614,4.21284e+13,17.7278,6097.74,49989,2503,1435,44793,44793,26626,35010,33487
25245,1278,2697,21357,3888,4.21255e+13,17.6801,3327.19,25245,1270,691,22548,22548,15183,18255,17729
45256,606,2280,28912,16344,3.03517e+13,575.859,6648.4,45256,533,349,42652,41829,35460,31187,16186
39068,154,1800,25094,13974,2.93951e+13,496.572,5426.63,39068,520,290,33231,31136,26952,25579,8789
53888,2817,2830,35729,18159,3.74734e+13,762.842,7558.8,53888,688,338,51058,51058,51053,51036,50960
42738,928,1905,27626,15112,2.96437e+13,543.749,5967.39,42738,478,320,40833,40696,38009,37389,29414
37016,501,2362,26612,10404,2.85634e+13,651.115,7028.07,37016,691,222,33957,32780,21464,21773,8736
89941,3257,4573,59457,30484,3.09693e+13,900.975,13990.3,89941,1352,376,85368,85300,85314,85095,72509
22844,1504,1649,16568,6276,3.11115e+13,396.612,4647.89,22844,429,178,21195,21167,21060,21097,19966
61942,2568,2581,38289,23653,3.10829e+13,607.62,7723.4,61942,485,385,59361,59361,59361,59361,59327
86311,1489,3259,56334,29977,3.43963e+13,706.108,9949.1,86311,693,389,83052,82841,74022,70071,41622
65702,10074,25845,53326,12376,1.71166e+12,100.672,27431.6,65702,1517,153,39857,39849,16576,21831,18018
3161,268,1179,2576,585,6.07693e+13,102.877,1662.79,3161,298,106,1982,1857,741,791,410
33954,2468,2492,24186,9768,3.31614e+13,722.066,7144.05,33954,793,194,31462,31462,31462,31462,31340
79969,2661,2822,50977,28992,2.99069e+13,662.919,9310.15,79969,661,438,77147,77080,76934,77003,75930
68602,443,3759,46349,22253,3.0898e+13,818.423,11291.8,68602,1149,287,62161,58725,41126,23203,14594
83191,3142,3813,56289,26902,4.30705e+13,1185.56,11966.9,83191,1372,474,79378,79098,75807,35140,49181
28688,334,1079,18502,10186,2.91942e+13,506.597,3684.47,28688,408,236,26407,24264,23353,22198,14659
27214,531,1628,17165,10049,3.00313e+13,445.232,4455.09,27214,414,253,25420,24893,21329,17250,16257
2063,558,579,1345,718,3.65794e+13,39.2453,883.268,2063,152,53,1484,1484,1484,1484,1472
69331,1265,3087,45513,23818,3.6079e+13,614.936,8459.58,69331,676,343,66244,66110,57598,43424,19599
74927,2995,4183,53946,20981,5.09267e+13,1488.53,13912.9,74927,1582,563,70744,70578,65455,64234,64871
20546,7423,8959,17008,3538,2.72554e+13,547.632,12232.2,20546,2134,12,11587,11345,11587,11587,7698
32159,1594,2453,22195,9964,2.7474e+13,548.298,6560.6,32159,870,236,29706,29698,28906,28492,22513
87673,2793,4258,61079,26594,4.77128e+13,1341.57,14913.7,87673,1773,554,83415,83108,74935,56019,61166
43926,3281,3683,30288,13638,5.07294e+13,786.2,9019.45,43926,1049,414,40243,40149,39389,37701,29990
42122,1117,1251,27148,14974,2.93885e+13,559.205,4538.76,42122,482,277,40871,40869,40572,40525,40399
91591,1684,3584,57564,34027,2.97756e+13,937.462,11434.2,91591,918,446,88007,87415,78612,60626,61306
70936,1870,3631,45202,25734,2.92331e+13,576.215,10547.5,70936,1172,330,67305,67209,65717,66177,50099
32581,188,2960,22174,10407,4.61063e+13,553.745,6990.39,32581,797,344,26584,24072,18004,4476,2177
52818,335,3018,35603,17215,2.90475e+13,526.981,8596.07,52818,1016,266,47658,45104,30538,15570,9866
55555,1225,1567,35673,19882,2.9039e+13,599.811,5554.46,55555,538,317,53988,53984,52879,52291,51927
81549,3528,3634,51277,30272,2.91918e+13,788.641,11000.9,81549,962,422,77915,77915,77915,77915,77731
10679,449,1972,7756,2923,6.67238e+13,292.404,3805.59,10679,465,151,8568,8203,6089,5516,3040
16232,691,2465,12230,4002,7.05391e+13,688.074,5133.1,16232,653,237,13200,12863,8880,8230,7760
15351,257,1369,9214,6137,3.18265e+13,220.442,2857.76,15351,246,144,13912,13442,9596,2874,1650
12121,1101,2106,8305,3816,4.60303e+13,436.691,4164.37,12121,676,167,10015,9868,8980,8723,6687
3075,252,450,1962,1113,3.00222e+13,143.312,917.762,3075,119,86,2625,2519,2491,2480,2108
88781,2625,2971,56391,32390,2.99874e+13,701.06,9923.76,88781,660,446,85810,85710,84030,84748,80400
54733,744,2112,35259,19474,2.98117e+13,587.038,6874.39,54733,534,332,52621,51901,47168,46731,35693
27204,69,1090,17572,9632,3.00367e+13,508.643,3624.26,27204,398,251,20350,14613,15324,14484,3692
27251,1054,2254,18985,8266,3.64859e+13,686.432,6416,27251,698,205,24872,23650,23749,22289,17769
43170,1126,1805,27800,15370,2.90632e+13,527.374,5881.22,43170,499,322,41365,41336,39287,37753,28554
65678,624,2632,41486,24192,2.98777e+13,590.189,8360.37,65678,558,421,62780,61750,51607,42585,28153
48302,1475,2410,30299,18003,2.98573e+13,529.173,6844.99,48302,495,354,45892,45857,41348,35053,34941
16704,1692,2611,12003,4701,5.84141e+13,524.009,5331.73,16704,595,236,14093,13904,10020,10459,9603
72279,2990,3902,49042,23237,3.16889e+13,967.185,12231.8,72279,1141,308,68377,68217,68357,67541,61949
10861,164,703,6337,4524,3.12252e+13,228.08,1620.41,10861,162,118,9894,8947,7310,4634,3455
98710,2489,4108,67290,31420,4.45175e+13,1297.79,13854.8,98710,1542,481,94602,93031,80866,39001,53192
34920,1174,1820,22482,12438,2.95821e+13,534.01,5439.48,34920,466,297,33100,33078,31939,30322,24199
88177,1885,4318,62551,25626,4.76203e+13,1571.96,15359.1,88177,1784,566,82856,78731,65337,51743,44753
28003,2219,2269,19650,8353,3.72159e+13,656.986,6439.29,28003,678,204,25734,25734,25734,25734,25668
66082,8481,18235,52513,13569,2.48231e+13,1709.83,28960.8,66082,5617,192,47847,45135,36376,30889,22731
51128,936,1959,33013,18115,2.98772e+13,522.147,6141.62,51128,506,322,49169,49118,45648,46277,41380
63241,2495,3855,44043,19198,3.17409e+13,1019.93,11614.3,63241,1069,340,59386,59256,58884,57743,48747
39978,1838,15677,32116,7862,2.66705e+13,5326.64,22768,39978,4057,16,18085,14167,14706,8141,5884
45762,1123,1780,29516,16246,2.96527e+13,531.686,5630.86,45762,467,289,43982,43968,43341,43181,40546
24452,1535,2240,17034,7418,3.80255e+13,613.177,5988.57,24452,629,200,22212,21652,21891,21865,18398
37190,540,1759,23998,13192,2.95283e+13,519.573,5428.33,37190,464,300,35220,34172,30682,29601,14953
1347,159,257,786,561,3.15394e+13,59.1886,416.875,1347,45,47,1090,1043,993,1055,668
1372,101,287,1021,351,2.98642e+13,63.5321,546.225,1372,128,55,1085,1012,866,762,719
69751,2699,3759,44599,25152,2.96513e+13,603.847,10864.6,69751,1225,331,65992,65991,65857,65938,53251
93328,1618,4499,65263,28065,4.13853e+13,1585.65,15615.4,93328,1624,455,87543,83952,73091,62826,39326
62466,1089,2574,38832,23634,3.08387e+13,596.376,7842,62466,523,385,59892,59623,50052,34051,31698
64407,200,3399,43346,21061,2.90128e+13,707.084,9950.52,64407,1102,281,56290,48932,33893,11016,8509
85077,1409,3973,56634,28443,3.97485e+13,1174.64,11756.8,85077,1018,428,80737,79238,65360,15620,22570
75664,2702,3707,50522,25142,4.09214e+13,996.127,10699.9,75664,1023,427,71957,71583,64231,21579,33252
37954,1745,2358,27423,10531,2.80914e+13,718.981,7095.55,37954,674,229,35596,35586,35424,35545,33187
51768,799,3329,36089,15679,2.76003e+13,736.026,9237.91,51768,900,281,48091,46881,32459,21189,9449
65608,2353,4078,46037,19571,5.45839e+13,1336.87,12540.5,65608,1741,468,61530,58881,49877,37301,40556
50767,810,2242,33222,17545,3.51567e+13,540.395,6365.08,50767,527,320,48525,48364,40927,7616,8884
97809,2195,4661,64763,33046,3.142e+13,1128.07,15206.3,97809,1360,425,93148,92453,90885,91775,52432
36837,953,1281,23658,13179,2.93456e+13,543.359,4361.15,36837,429,269,35556,35527,34457,34177,33329
8146,293,1447,5807,2339,7.19697e+13,190.567,2604.81,8146,231,209,6669,6178,3590,2799,1834
58736,5466,23176,47700,11036,1.70866e+12,99.3557,24667.8,58736,1418,149,35560,35545,9430,14655,11142
16134,584,1507,11688,4446,3.12833e+13,270.795,3869.54,16134,384,156,14627,14500,9554,8940,3178
81240,2409,3249,53065,28175,3.46638e+13,710.239,9655.13,81240,716,369,77991,77896,76738,75496,68375
43533,2220,3815,31245,12288,6.15743e+13,1205.09,9946.61,43533,1283,453,39665,37484,30282,24893,28329
1454,90,448,985,469,5.4499e+13,84.1953,722.393,1454,150,52,951,696,714,695,394
86345,668,4535,57184,29161,3.08594e+13,919.399,13627.3,86345,1347,332,80225,77606,53245,33525,8905
19124,611,8937,15300,3824,159887000,429.954,12540.1,19124,1928,11,10154,9549,6627,5948,726
37608,1014,2053,24064,13544,3.02979e+13,576.635,5711.21,37608,502,328,35555,35452,32350,28154,23816
62412,8630,24587,50641,11771,1.7065e+12,98.8894,26127.7,62412,1462,155,37825,37819,14396,19629,15846
10782,342,753,6932,3850,2.80906e+13,387.52,2087.59,10782,279,168,9747,9036,8791,8268,6251
8787,612,1153,6334,2453,2.74931e+13,199.239,2660.96,8787,360,135,7634,7588,6179,5817,3511
60627,816,2192,38987,21640,2.917e+13,561.559,7288.88,60627,562,361,58435,57891,52153,51420,36817
40476,630,2729,27473,13003,2.8239e+13,515.996,7448.74,40476,940,255,37223,36082,26714,17633,10938
6479,693,1489,4393,2086,4.34708e+13,307.136,2624.29,6479,436,129,4990,4905,4395,4001,1797
12785,440,1022,9345,3440,2.82043e+13,199.139,2973.05,12785,314,154,11763,11741,8997,10335,4880
96598,393,4106,64385,32213,3.87375e+13,1378.09,13028.1,96598,1091,441,87409,80198,65294,8745,5157
46215,1968,2317,29138,17077,3.02865e+13,535.903,6693.64,46215,501,360,43898,43898,42739,43261,40594
41187,1069,2064,25289,15898,3.12391e+13,440.116,5705.58,41187,412,303,39123,39051,32655,23591,19847
6580,588,1092,4654,1926,2.54585e+13,272.628,2225.25,6580,533,88,5479,5108,4645,4409,4234
60634,325,3636,38497,22137,2.92771e+13,533.586,9838.64,60634,1168,299,54867,51523,36636,19133,6500
4402,289,1280,3580,822,7.23769e+13,134.002,1913.61,4402,304,121,3122,2962,949,1011,362
4792,1241,1566,3580,1212,4.10011e+13,169.79,2439.69,4792,432,106,3226,3226,2862,2871,2672
4482,38,425,2611,1871,3.12571e+13,150.529,875.816,4482,88,84,3628,3330,2313,1266,628
17607,989,1978,12202,5405,2.57272e+13,471.809,4607.66,17607,751,178,15629,15350,13670,12957,6656
19568,648,1366,12650,6918,2.94951e+13,496.78,3605.43,19568,409,228,18182,17676,16375,15240,7568
77485,1336,2787,49579,27906,3.01612e+13,631.909,9093.66,77485,650,422,74698,74568,67942,61627,50184
37706,621,2688,25352,12354,2.7852e+13,504.035,7154.94,37706,940,237,34575,33442,25093,17391,11321
27048,535,1907,17963,9085,4.14996e+13,436.998,4741.13,27048,401,232,25113,24160,20183,4976,4596
81210,3302,3699,54581,26629,4.09236e+13,1134.11,11150.8,81210,1102,424,77511,77248,75209,70585,57874
69257,334,3507,45645,23612,3.60061e+13,970.271,9354.92,69257,787,345,62199,56606,48740,5020,2666
44045,614,1662,28534,15511,3.12403e+13,536.135,5230.62,44045,501,302,42375,41536,35936,34025,16044
31983,2732,3315,23577,8406,6.4459e+13,1454.34,8181.83,31983,1043,355,28668,28618,27605,27620,27079
2160,215,476,1418,742,3.40126e+13,112.067,856.595,2160,121,84,1684,1562,1487,1378,1135
44504,264,2959,27485,17019,2.91415e+13,440.461,7234.63,44504,923,248,39732,37073,26791,11252,6327
13209,1834,2441,9846,3363,6.48746e+13,485.339,4709.73,13209,617,223,10768,10534,9377,9336,9814
49283,2963,2986,32071,17212,2.90668e+13,476.821,8061.92,49283,1108,234,46297,46297,46297,46297,46213
71208,572,3668,48056,23152,4.24859e+13,1079.92,10698.2,71208,1100,430,65474,62590,45940,8709,7458
58202,2511,3537,38538,19664,3.92616e+13,769.078,9315.62,58202,960,391,54665,54610,49356,17152,21152
72440,579,3648,52208,20232,4.10748e+13,1235.78,12806.3,72440,1328,381,64012,59888,40062,27849,25120
51497,29,576,34959,16538,3.36438e+13,302.986,3822.97,51497,300,248,18586,9305,7839,1591,2610
70796,1633,2702,45218,25578,2.9785e+13,627.132,8705.47,70796,612,415,68094,68009,64171,58363,53153
45207,326,1849,29054,16153,2.91017e+13,548.076,5658.77,45207,516,292,41310,38040,36113,34487,21131
78484,2475,3895,51808,26676,3.75686e+13,1068.02,11049.4,78484,1022,411,74589,74064,65847,19628,27495
86547,1323,3426,56635,29912,3.4283e+13,1081.65,10552.4,86547,803,373,82976,82184,69026,11636,15278
13954,405,2373,9962,3992,6.26488e+13,337.96,4291.27,13954,551,301,11468,10391,5314,2213,1097
57791,1765,3792,41086,16705,4.21276e+13,1176.26,11585.1,57791,1202,381,53892,52075,46756,46076,29723
41468,1379,2729,26644,14824,2.93206e+13,452.873,7149.91,41468,1065,199,38739,38724,37536,34557,23076
1864,334,418,1216,648,3.20119e+13,81.5606,722.094,1864,104,59,1446,1435,1411,1442,1402
23249,1157,1441,14909,8340,2.84994e+13,436.193,4078.99,23249,366,263,21808,21793,21464,21282,18970
30242,825,2821,21243,8999,5.06259e+13,1244.47,7641.74,30242,1087,301,26030,24396,18515,17825,9199
69160,3896,3944,48150,21010,5.09909e+13,1285.51,12201.6,69160,1508,472,65216,65216,65182,65125,65129
28333,2002,2988,19328,9005,4.71429e+13,486,6758.98,28333,786,341,25345,25111,21811,11817,11728
11669,17,1295,8429,3240,2.80238e+13,334.004,3250.33,11669,432,149,2882,1296,735,778,232
19997,106,1474,12908,7089,2.9672e+13,469.425,3887.08,19997,385,232,16239,14844,12657,10877,2991
13323,44,885,8558,4765,2.96412e+13,404.22,2446.19,13323,302,187,8594,5373,6292,3827,1406
17349,623,1085,12642,4707,3.17727e+13,205.193,3438.59,17349,360,150,16264,16264,15609,16086,11002
89078,359,770,60438,28640,3.35983e+13,305.755,5144.29,89078,313,274,88308,88302,64724,63122,55311
11569,467,808,7498,4071,3.07287e+13,396.22,2212,11569,308,172,10693,10043,9853,9523,7669
28691,1276,2157,20593,8098,3.11152e+13,691.486,6148.66,28691,672,191,26534,25810,25923,26011,22825
1686,156,440,1096,590,3.22235e+13,88.013,750.039,1686,114,85,1239,1141,1039,1008,577
10194,630,750,6540,3654,2.86886e+13,388.113,2040.17,10194,276,168,9444,9402,9265,9149,8958
64795,2289,3639,43982,20813,4.38868e+13,1007.52,10314.9,64795,1055,425,61156,59861,50716,18945,29766
57053,967,2552,35769,21284,2.99904e+13,541.803,7604.58,57053,515,384,54501,54286,45737,34343,24859
8252,454,1686,5795,2457,4.36629e+13,302.768,3154.09,8252,529,132,6389,5940,4618,3576,2869
78106,1288,2757,48873,29233,3.02997e+13,665.552,9104.16,78106,557,436,75349,75006,65358,47655,42254
41538,2271,3574,28389,13149,4.91636e+13,715.652,8681.71,41538,1027,416,37964,37562,29913,14361,18442
93248,366,766,63242,30006,3.35242e+13,303.163,5242.68,93248,313,274,92482,92482,68936,67678,59986
6123,741,1879,4505,1618,5.8518e+13,151.826,2833.73,6123,425,207,4244,4239,2366,2603,1780
31097,1135,1711,20080,11017,2.98334e+13,534.347,4960.83,31097,465,281,29386,29352,28167,26810,21665
23917,6198,10719,19672,4245,2.64861e+13,928.103,14393.2,23917,2316,12,13198,12146,5485,12226,4377
94080,1435,4386,60655,33425,2.93379e+13,805.004,13554.8,94080,1251,412,89694,89083,74599,52065,45412
21773,1804,2409,14942,6831,4.9814e+13,470.736,5092.72,21773,591,304,19364,19267,18260,8766,9379
84539,3075,4487,56094,28445,3.20734e+13,1048.11,13552.1,84539,1329,314,80052,79828,79974,79777,65245
30884,4226,13339,25359,5525,2.35386e+13,1133.09,18156.3,30884,3584,15,17545,14876,13134,16237,9498
12236,1027,1161,7292,4944,3.19951e+13,207.858,2353.75,12236,199,141,11075,11075,10825,10896,10221
35746,9914,14170,29389,6357,2.81953e+13,1910.3,19573.9,35746,4743,17,21576,20416,19363,20170,19225
96840,332,4155,66087,30753,4.58988e+13,1315.08,14098.8,96840,1712,470,83364,75898,57749,17274,9360
76942,1426,3680,51806,25136,4.17119e+13,1070.79,10887.2,76942,1104,436,72648,71170,58288,15718,26731
3696,886,920,2549,1147,1.52022e+13,187.418,1547.5,3696,252,98,2776,2776,2776,2776,2763
38558,1148,1752,24879,13679,2.87544e+13,539.317,5527.13,38558,507,304,36806,36780,35729,34171,28136
97437,60,4690,64527,32910,3.16277e+13,1023.59,15087.9,97437,1366,394,68436,49925,40943,12578,3440
55003,4791,21604,44622,10381,1.71383e+12,97.3126,23047.8,55003,1364,152,33399,33383,8496,13621,10032
50315,206,3041,32180,18135,2.9103e+13,491.649,8030.81,50315,1177,216,43891,38960,26619,9317,5698
83911,3001,4227,56195,27716,3.21464e+13,1081.62,13365.1,83911,1290,358,79684,79308,79015,77851,70631
56797,784,4021,40776,16021,5.7624e+13,1537.8,11935.9,56797,1551,512,48508,45757,29231,25015,15241
78517,1709,4249,54722,23795,4.95037e+13,1386.66,13907.9,78517,1783,527,73226,68968,54380,36070,32448
98899,1348,4249,68597,30302,4.59017e+13,1336.11,15547.7,98899,1757,545,92462,88073,70601,41165,36492
94183,418,3982,63949,30234,4.37696e+13,1277.78,13249.7,94183,1434,482,83337,76869,57886,14354,7017
4243,426,467,3093,1150,3.33151e+13,176.241,1188.6,4243,189,92,3776,3776,3760,3774,3749
4019,548,1086,2842,1177,1.48318e+13,343.12,1789.54,4019,252,96,2889,2060,1566,1849,626
23273,1119,1464,15014,8259,3.01506e+13,435.795,4111.33,23273,377,239,21809,21774,21346,20865,17703
30717,669,2646,21679,9038,3.99877e+13,810.515,7391.77,30717,820,271,26906,25661,22619,20793,14736
98145,33,3046,61972,36173,2.99071e+13,727.897,10490.8,98145,723,450,62399,41262,40128,14563,4951
74207,1098,3958,48140,26067,2.95295e+13,660.439,11580.6,74207,1241,379,70231,69371,54509,41017,22106
92075,2857,3965,62520,29555,4.38303e+13,1321.61,13000.9,92075,1422,468,88110,87722,79371,34578,53128
91635,2447,2980,58053,33582,2.99532e+13,710.299,10067,91635,695,451,88655,88485,85273,85862,78621
33849,280,1821,20656,13193,3.17838e+13,356.29,4828.75,33849,379,254,31463,30030,22513,11435,6129
57332,1181,2100,36814,20518,2.89171e+13,573.357,6987.6,57332,584,343,55232,55189,52212,51876,43509
27241,7879,10719,22095,5146,1.70726e+12,92.8774,11705.3,27241,762,122,16522,16522,12368,15964,12553
53745,2136,2393,35328,18417,3.76727e+13,550.337,6813.11,53745,517,303,51352,51352,50918,51063,49584
39240,2140,3362,28306,10934,5.90172e+13,1522.41,9084.4,39240,1291,277,35802,32867,28500,29665,28829
79791,2815,3962,52755,27036,3.79638e+13,1076.09,11301.9,79791,1034,423,75829,75597,71024,51855,31387
7263,232,612,4239,3024,3.14524e+13,185.048,1302.67,7263,123,114,6634,6259,5401,5270,3459
69237,960,3891,49823,19414,4.95183e+13,1473.74,12971.5,69237,1470,516,61908,58106,44598,42406,26409
36065,2956,14113,29766,6299,2.04637e+13,1475.72,20155.2,36065,3666,16,21952,18173,16111,12245,9567
36112,1435,1705,23295,12817,2.92873e+13,542.981,5281.67,36112,456,302,34407,34405,33868,33545,33345
11556,1500,1857,7869,3687,3.88331e+13,475.772,3822.67,11556,508,143,9699,9573,9488,9655,8249
54424,2425,2472,33896,20528,3.05668e+13,583.823,7267.1,54424,481,372,51952,51952,51946,51952,51761
9277,611,1045,5576,3701,3.16022e+13,172.279,2053.06,9277,173,131,8232,8229,6582,6697,3303
47891,2998,3487,31991,15900,4.1708e+13,708.4,8736.7,47891,940,397,44404,44401,42864,40705,31080
47052,642,3664,33809,13243,6.04439e+13,1574.96,10360.1,47052,1433,455,38768,36529,21690,19678,10213
45244,2391,2998,27618,17626,3.09816e+13,526.656,6930.23,45244,621,307,42246,42245,42235,42246,41734
87974,2871,2947,55800,32174,3.02303e+13,723.255,9931.06,87974,663,442,85027,85027,85006,85027,84447
15759,358,837,10129,5630,2.87206e+13,444.506,2567.4,15759,325,179,14511,13585,13144,12443,10197
48038,152,557,32603,15435,3.36922e+13,300.377,3677.29,48038,298,243,40384,25205,26735,20918,24949
49647,1512,2077,30346,19301,3.10872e+13,514.511,6149.42,49647,467,312,47570,47431,43053,44583,39355
15144,549,829,9767,5377,2.95249e+13,433.611,2540.92,15144,301,199,14315,13761,13346,12937,12481
65390,343,2311,42612,22778,3.32475e+13,591.942,6968.5,65390,578,343,60113,55512,50560,6023,5096
52757,380,3782,36842,15915,5.27751e+13,1124.95,10462.8,52757,1353,455,44804,41146,27940,10600,7186
15340,594,2337,10763,4577,5.64065e+13,540.671,4975.13,15340,774,202,12553,11941,9121,7864,4643
50920,1821,1933,33165,17755,3.30609e+13,560.809,5916.29,50920,550,315,48987,48983,48863,48877,48635
56762,2436,3431,40648,16114,4.09245e+13,1219.12,11134.9,56762,1213,348,53331,52653,48578,49785,44727
92799,1485,4077,63268,29531,4.49447e+13,1321.9,13569.7,92799,1532,478,87246,83743,65003,28238,29748
10503,907,1568,7334,3169,6.20634e+13,249.637,3047.5,10503,315,207,8935,8907,8200,5075,5130
54137,3660,4004,38544,15593,5.74359e+13,1371.57,11311.8,54137,1462,460,50133,50133,49660,47672,44918
35552,1704,3253,25911,9641,6.10687e+13,1514.5,8496.31,35552,1171,314,31826,28889,22707,24777,22894
94016,3044,4156,61694,32322,2.98731e+13,800.743,13240.2,94016,1251,430,89860,89827,89758,89490,73619
2148,428,533,1582,566,9.19163e+13,140.608,825.966,2148,58,128,1615,1576,1488,1548,1408
60946,1465,3874,42995,17951,3.29139e+13,1049.9,11550.8,60946,1045,365,56907,55299,51429,50757,30703
47077,6525,16767,38124,8953,2.49172e+13,4989.54,25163.1,47077,5058,20,29021,20789,23724,26111,15846
27009,526,1060,17371,9638,2.94196e+13,534.394,3566.73,27009,399,240,25741,24286,22976,21723,18320
51423,478,2049,33114,18309,2.90487e+13,555.621,6596.82,51423,534,333,48655,45537,41789,40446,25920
6826,572,1407,4537,2289,5.9734e+13,205.664,2598.51,6826,504,108,5419,5110,5023,5237,3099
42200,1448,2651,29415,12785,2.83831e+13,562.656,7533.04,42200,884,265,39549,39376,37964,33698,24381
80957,2210,3514,50754,30203,2.97772e+13,870.839,10731.5,80957,904,429,77443,77116,72481,74416,64792
88409,2090,4402,63086,25323,4.7607e+13,1594.84,15522.4,88409,1765,572,83368,79286,66409,55674,49430
11962,749,1329,8663,3299,2.90117e+13,206.684,3275.57,11962,379,153,10633,10598,8673,9342,5592
11953,596,782,7722,4231,2.93527e+13,387.397,2177.33,11953,319,168,11171,10986,10827,10671,10281
51267,610,2104,33115,18152,3.00018e+13,601.105,6778.47,51267,609,349,48896,47693,41739,41165,23951
79709,4064,4186,55213,24496,4.90797e+13,1397.56,13953.4,79709,1728,531,75523,75514,75258,73906,72348
83690,20961,22896,68608,15082,2.5223e+13,5348.51,37181.2,83690,7796,23,60794,60794,59870,59870,60794
79219,8937,18681,57627,21592,2.35145e+13,238.048,24046.8,79219,1831,187,60538,60494,48511,49374,46646
66437,2468,3802,42781,23656,2.91885e+13,585.86,10682.8,66437,1222,336,62635,62597,62194,62494,44075
84057,2792,3353,54907,29150,3.45652e+13,792.522,9955.06,84057,677,371,80704,80696,79946,78913,72958
20147,1372,1488,13011,7136,2.89616e+13,406.348,3794.91,20147,388,227,18659,18659,18609,18624,18348
57851,389,614,39272,18579,3.36603e+13,304.256,4075.05,57851,304,254,57237,57237,46651,49936,45223
84018,4203,4276,58522,25496,4.84541e+13,1376.53,14415.5,84018,1815,533,79742,79740,79706,78861,79514
64275,194,3739,41815,22460,2.94598e+13,624.841,10294.3,64275,1221,304,56008,47746,34252,7172,3095
18585,388,1031,12018,6567,3.05776e+13,433.338,3009.57,18585,304,204,17235,15962,15361,14806,11286
13597,158,1245,8808,4789,3.0451e+13,313.221,3000.91,13597,302,212,11471,10753,9092,7960,2667
69974,800,2724,43924,26050,3.07508e+13,645.873,8733.37,69974,561,437,67075,66355,54757,42360,31088
96503,3213,4603,63748,32755,3.02693e+13,999.685,14535.9,96503,1311,410,91900,91745,91859,91552,78179
12179,832,838,7849,4330,3.02524e+13,434.338,2279.81,12179,372,168,11341,11341,11341,11337,11337
68334,3520,3710,45716,22618,4.16223e+13,923.835,10296.7,68334,1040,430,64624,64568,63907,63098,60985
78347,2673,3814,51628,26719,2.96937e+13,709.334,11592.8,78347,1230,345,74533,74279,73762,74114,56816
7242,673,733,4689,2553,3.00439e+13,276.721,1704.62,7242,234,138,6509,6507,6468,6487,6388
68994,1898,3729,44294,24700,2.94649e+13,594.254,10822.4,68994,1230,328,65265,65184,63693,64379,44381
14262,1085,1235,10365,3897,3.06042e+13,212.36,3237.58,14262,328,143,13027,13027,12996,13027,12984
70839,726,4144,49938,20901,3.76621e+13,1206.04,13066.9,70839,1224,411,63879,61526,38273,24796,9222
28214,971,1533,16595,11619,3.16042e+13,320.218,3548.18,28214,396,174,26681,26668,23165,22834,20165
57140,2341,3933,40430,16710,5.54756e+13,1358.76,11407.6,57140,1489,470,53207,50355,43437,32787,36735
13732,775,825,8858,4874,2.99266e+13,423.295,2424,13732,307,179,12907,12897,12858,12883,12807
50885,416,1961,32760,18125,2.93445e+13,564.038,6499.04,50885,493,333,47573,44210,41265,39658,23207
20507,1368,1558,14711,5796,2.48412e+13,638.52,4566.85,20507,761,174,18949,18947,18904,18899,18149
20883,314,1477,12915,7968,3.07228e+13,290.726,3695.43,20883,305,216,19155,18291,15145,9728,6397
31898,590,1858,19266,12632,3.14547e+13,334.117,4632.28,31898,380,245,30040,29851,22407,11233,9410
87161,1507,3554,54786,32375,2.96954e+13,918.808,10976.5,87161,738,439,83607,82921,73804,54828,52918
7846,1330,1495,4978,2868,2.56126e+13,203.843,2504.98,7846,325,110,6351,6351,6347,6351,6162
74901,2704,4272,52273,22628,3.75693e+13,1226.98,13503.6,74901,1273,416,70629,70270,65976,65018,56307
92946,4196,4482,64795,28151,4.05852e+13,1441.99,15416,92946,1456,455,88464,88459,88360,87149,86432
4379,392,1315,3229,1150,6.07067e+13,149.004,1952.18,4379,302,195,3064,2734,1471,1569,1255
50577,1099,3813,36224,14353,5.82275e+13,1389.91,10738.1,50577,1324,473,44715,41999,26589,18749,15683
67885,1359,3586,45338,22547,4.13588e+13,912.667,10127.1,67885,978,442,64236,62797,50957,13891,17705
45373,189,1878,29256,16117,2.97486e+13,557.578,6084.77,45373,490,328,39651,37022,32407,27740,10138
89591,1332,4270,62597,26994,4.7202e+13,1325.83,15032.5,89591,1790,550,83165,78811,62539,39568,33386
91222,3667,3954,57764,33458,2.95756e+13,867.544,12179.6,91222,1043,446,87268,87268,87268,87268,87060
71363,304,3704,44877,26486,2.96311e+13,607.597,10172.6,71363,1078,349,64649,60258,46455,29292,9539
55155,1562,3473,39350,15805,4.1308e+13,1095.71,11003.9,55155,1104,343,51395,49508,44865,43684,33687
82405,1342,4004,52110,30295,2.94218e+13,759.732,11769.7,82405,1078,420,78401,77863,66942,45390,44270
8228,40,745,5265,2963,2.87871e+13,357.277,1848.59,8228,291,160,5152,3055,3662,810,313
82532,535,2809,53075,29457,2.95784e+13,644.784,9178.99,82532,656,412,78930,75161,66397,62956,35389
74575,1529,4236,53650,20925,5.12084e+13,1499.45,13952.2,74575,1612,548,68829,64389,52088,46785,38113
87350,600,2887,54610,32740,3.02296e+13,689.528,9788.12,87350,595,459,83843,82281,66823,49784,35363
9614,390,1119,6915,2699,2.25505e+13,371.547,2742.35,9614,568,105,8075,7122,5087,4365,3836
42468,1663,2015,26294,16174,3.1269e+13,471.843,5790.29,42468,408,287,40453,40448,39079,39620,37615
10629,171,3964,8942,1687,3.92668e+13,172.579,5879.35,10629,1495,12,6635,6470,0,6465,66
84402,536,3943,55012,29390,2.9615e+13,697.358,12243.9,84402,1244,389,79021,75736,55305,36040,20903
24124,389,1451,15588,8536,2.92508e+13,467.634,4020.12,24124,390,253,22234,20849,19234,18621,7686
10303,996,1169,6665,3638,2.93e+13,276.139,2574.3,10303,283,158,9134,9111,9095,9070,8426
78757,3838,4121,54368,24389,4.87661e+13,1303.3,13123.6,78757,1640,461,74636,74636,73931,71327,66168
12370,2015,2376,9191,3179,6.30292e+13,423.835,4463.49,12370,604,225,9994,9934,8906,9162,8764
93758,417,4546,62050,31708,3.04907e+13,1004.19,14280.5,93758,1291,403,85646,81167,55617,35575,12752
40570,1210,2740,25372,15198,2.95821e+13,358.025,6668.99,40570,1023,178,37830,37823,36409,34774,26190
46898,973,1437,30258,16640,2.9991e+13,561.687,5021.28,46898,513,298,45461,45435,43058,42244,40846
89534,1189,4071,56888,32646,2.96382e+13,781.745,12487.4,89534,1156,420,85463,84823,72176,49708,37819
53831,2835,3906,37971,15860,5.59596e+13,1170.69,10780.4,53831,1373,457,49925,49739,44678,30227,34141
87190,2631,4521,57641,29549,2.97933e+13,879.895,13535.7,87190,1264,370,82669,82366,81501,82103,56147
92032,10246,24302,75544,16488,2.64528e+13,5353.23,39524.3,92032,8703,26,67730,55685,55801,59731,40281
63632,3236,3766,41171,22461,2.95421e+13,587.504,10272.2,63632,1220,294,59866,59864,59866,59826,55168
34382,558,3715,24910,9472,6.39479e+13,1220.34,8739.2,34382,1192,445,28112,26721,14751,10561,9421
29721,223,1397,19130,10591,2.92167e+13,497.213,4076.69,29721,467,241,26226,24398,22468,20912,10709
79852,3942,3955,52519,27333,2.96308e+13,720.467,12054.4,79852,1235,392,75897,75897,75897,75897,75865
15237,1731,2820,10919,4318,6.12264e+13,329.74,5173.27,15237,634,312,12417,12311,8962,7674,6763
2522,317,738,1764,758,4.09059e+13,155.041,1224,2522,311,68,1784,1674,1393,1580,1263
51975,11143,39475,22144,29831,6.1257e+12,118.271,41763.6,51975,23733,176,12500,12500,11537,12143,10750
65114,1914,3774,44434,20680,4.5572e+13,1121.16,11019.9,65114,1338,456,61103,58820,46279,21529,27590
40658,1325,1773,26152,14506,2.93668e+13,515.36,5564.91,40658,490,303,38885,38871,38303,37708,33359
36713,1258,2872,26069,10644,4.66853e+13,1056.16,8519.86,36713,988,315,33285,31632,27347,26013,21088
80316,2381,4245,57036,23280,4.01986e+13,1322.39,14150.3,80316,1406,436,76071,74728,67534,66122,51046
13594,333,778,7937,5657,3.21494e+13,240.349,1853.81,13594,217,125,12816,12599,10688,10470,8689
32382,1178,2861,23058,9324,4.76127e+13,942.961,7989.01,32382,865,305,29040,27804,23187,21690,17710
41707,1019,1978,25835,15872,3.08175e+13,454.307,5691.03,41707,437,291,39729,39699,34018,26468,23136
72035,103,4297,50711,21324,5.13352e+13,1408.09,13751.1,72035,1787,524,52138,40647,27500,14290,4234
48148,3061,3660,34508,13640,5.62746e+13,1563.88,10563.3,48148,1444,429,44488,44469,43418,43373,42820
22631,767,1597,13931,8700,3.06501e+13,304.283,3981.31,22631,373,222,21034,21009,17653,13449,11416
57765,2018,3670,40228,17537,3.1363e+13,843.128,10722.3,57765,1001,291,54095,53995,52653,53294,36563
50232,3066,3403,35878,14354,4.13215e+13,1053.65,10373.8,50232,1066,352,46829,46829,46178,45659,45446
16045,878,2984,11766,4279,6.75108e+13,507.134,5549.62,16045,675,271,12942,12453,9907,9115,6424
63546,1251,4200,44958,18588,5.43871e+13,1495.34,12819.1,63546,1730,525,57094,53357,38186,28796,22682
39597,1103,1904,24775,14822,3.03826e+13,438.222,5470.32,39597,428,291,37693,37682,34101,31048,26749
62380,3142,3726,43229,19151,3.16417e+13,938.528,11358.4,62380,1042,305,58654,58565,58654,58645,54824
53463,1901,2069,34444,19019,2.9525e+13,579.12,6684.21,53463,564,322,51394,51394,51294,51378,51146
61782,663,3182,38730,23052,3.00032e+13,590.198,8853.16,61782,947,331,58399,57439,45198,28707,26018
93400,2592,4358,65948,27452,4.6294e+13,1421.26,15669.4,93400,1755,567,89042,87499,76051,61795,63711
74525,1295,4188,52363,22162,5.06436e+13,1382.65,13775.8,74525,1747,528,68197,64170,48995,33487,27646
43156,188,3310,30835,12321,5.52123e+13,1466.39,9654.71,43156,1329,344,31977,27630,17377,13231,3193
36592,462,500,24802,11790,3.36495e+13,299.009,3184.93,36592,291,224,36092,36092,36016,35900,35828
42210,1222,2584,29914,12296,2.83524e+13,597.919,7469.49,42210,847,274,39626,39122,33544,30747,19498
67887,2707,3840,46767,21120,3.13338e+13,984.691,11895.7,67887,1093,320,64047,63898,63855,62702,54602
52022,1748,2479,32612,19410,3.06511e+13,551.293,7261.08,52022,477,378,49543,49489,45236,44853,37011
56772,1212,3168,35290,21482,2.92943e+13,560.521,8447.22,56772,950,314,53604,53361,45642,38009,28778
80663,167,4322,55835,24828,3.70869e+13,1234.99,14036.1,80663,1377,417,64088,52631,38162,11786,4724
43597,1972,2077,26698,16899,3.1032e+13,467.444,5830.97,43597,419,298,41520,41488,41460,41478,40832
81679,2224,3625,53934,27745,3.64712e+13,1036.09,10853.3,81679,865,374,78054,77282,69842,18885,26590
74083,2665,2811,46374,27709,3.05321e+13,667.139,9079.39,74083,572,439,71272,71272,71104,71072,70062
11512,1362,2436,8564,2948,6.46079e+13,376.016,4292.45,11512,534,191,9076,8934,5325,5953,4805
84676,2669,3907,57977,26699,4.56057e+13,1231.63,12544.3,84676,1420,475,80769,80343,71428,33361,48837
3429,80,477,2217,1212,2.97135e+13,143.189,972.76,3429,133,86,2737,2103,2187,2127,1211
25024,50,1587,17983,7041,2.76897e+13,628.498,5021.16,25024,745,201,12879,5987,5586,1966,1411
78057,298,2798,48958,29099,3.04059e+13,683.639,9252.91,78057,600,431,71789,66957,56099,41147,13478
26832,2343,2640,18859,7973,4.25545e+13,809.574,6963.21,26832,815,269,24192,24190,23413,23340,23283
89830,3911,4585,59678,30152,3.1574e+13,1085.91,14387.7,89830,1350,354,85245,85207,85245,85245,80428
28216,1799,12959,23071,5145,2.52732e+13,1003.22,17148.6,28216,3850,16,15257,12698,13624,12693,6093
32257,145,1666,20816,11441,2.90093e+13,443.6,4904.72,32257,429,283,27389,25664,22180,18623,7206
63086,884,3587,39546,23540,2.96953e+13,548.052,9509.21,63086,1060,324,59499,59037,47493,29460,24974
96130,3456,4859,64721,31409,3.56752e+13,1308.11,15404.8,96130,1417,433,91271,90897,88004,88451,76457
64749,754,3810,41613,23136,2.9397e+13,550.206,10479.3,64749,1237,305,60687,59900,44599,26764,15881
60137,2147,3080,39674,20463,2.94015e+13,599.885,9017.2,60137,1127,267,57057,56939,55937,51927,46711
39328,1829,2626,25515,13813,2.86634e+13,446.399,6990.62,39328,1019,197,36702,36701,36179,34954,30021
55079,1637,3568,38750,16329,3.19279e+13,907.644,10458.5,55079,959,288,51511,50868,48897,50208,30619
60424,2145,4099,42540,17884,5.43852e+13,1345.56,11938.1,60424,1525,464,56198,52604,41929,32562,33272
64272,2268,3871,44861,19411,5.10649e+13,1279.6,11723.8,64272,1378,471,60401,57503,49246,30862,36273
35859,146,3587,25382,10477,5.507e+13,1059.34,8717.21,35859,1054,422,26894,23452,14657,5411,2426
54474,177,1962,35128,19346,2.97237e+13,539.341,6218.99,54474,496,319,47122,44138,38790,34857,15084
76576,609,3661,47964,28612,2.9327e+13,819.656,10717.8,76576,960,407,72252,70526,55408,37532,20826
74185,668,2768,46465,27720,3.05206e+13,649.157,8978.09,74185,543,441,71094,70154,56760,42428,30722
67704,3694,3743,45610,22094,3.02279e+13,815.128,11006.4,67704,1124,283,63961,63961,63961,63961,63869
11980,1587,2359,8852,3128,6.24381e+13,449.575,4466.66,11980,611,213,9621,9399,8554,8565,8175
70431,254,2689,44180,26251,3.06289e+13,636.909,8684.12,70431,543,412,64085,59989,49872,34183,15705
49888,356,557,33858,16030,3.35858e+13,299.306,3741.63,49888,298,244,49331,49331,39200,42382,38070
83114,2822,3745,55772,27342,4.17628e+13,1182.42,11878.7,83114,1305,447,79369,79049,71787,29490,45512
12210,630,1512,8340,3870,5.12891e+13,292.637,3102.46,12210,320,173,10698,10498,8830,3582,3308
76997,4051,4095,53304,23693,5.05388e+13,1339.28,13253.9,76997,1746,466,72902,72896,72869,72812,72719
25544,1240,1608,16388,9156,2.91347e+13,524.134,4524.6,25544,459,251,23936,23928,23216,22952,21542
8021,191,620,5855,2166,3.23335e+13,193.054,1865.19,8021,230,123,7246,6695,5123,5519,2455
57119,1171,2034,36966,20153,3.01088e+13,550.13,6912.84,57119,554,345,55085,55050,52194,51128,41059
35551,1269,1917,21315,14236,3.16092e+13,363.281,4839.15,35551,435,254,33634,33577,29302,30232,25506
6530,369,1022,4224,2306,3.03458e+13,210.971,2008.92,6530,252,161,5508,5238,4821,4911,2173
4843,370,791,3472,1371,2.88621e+13,190.69,1699.19,4843,318,89,4052,3930,3189,3238,2721
8409,434,622,4903,3506,3.13985e+13,195.7,1376.38,8409,137,105,7787,7768,7120,7387,5875
2395,827,975,1579,816,5.95834e+13,90.6973,1380.21,2395,290,90,1420,1420,1372,1420,1084
54943,457,1829,35712,19231,3.19491e+13,613.629,5933.45,54943,577,325,51916,47967,43526,5897,6653
80413,412,4164,55489,24924,4.9435e+13,1350.13,13572.1,80413,1792,465,68805,63318,44992,19131,9383
83022,1186,4315,59237,23785,4.82192e+13,1416.15,14872.7,83022,1705,563,75869,71749,56372,46279,34180
47582,2531,3026,29389,18193,2.96547e+13,460.585,7538.63,47582,921,263,44556,44556,44556,44556,41602
53818,633,1549,34595,19223,2.93539e+13,582.668,5457.29,53818,502,308,52241,50887,45435,44143,37994
8222,758,999,5848,2374,3.06787e+13,357.405,2441.75,8222,417,107,7223,7192,7085,7197,6369
92902,601,2979,59448,33454,2.96932e+13,694.142,9957.78,92902,728,439,89493,86884,74665,68015,46824
63255,3287,3746,43147,20108,4.48398e+13,1089.99,10702.1,63255,1204,441,59509,59345,57588,52014,41669
75938,1614,3822,50040,25898,2.98181e+13,696.733,11472.3,75938,1229,339,72116,71814,67008,65729,37666
99964,658,804,67775,32189,3.35058e+13,304.532,5454.09,99964,315,278,99160,99160,92933,95057,92732
89602,3181,4126,57406,32196,2.95015e+13,760.473,12887.6,89602,1244,406,85476,85395,85476,85423,75212
67755,1928,3425,45187,22568,2.93414e+13,736.426,10054.5,67755,1154,279,64330,64028,62461,56730,44754
42889,1585,2874,30253,12636,3.42804e+13,843.444,8752.33,42889,890,239,40015,39207,38759,37419,30379
87543,17015,36306,70040,17503,122538000,1098.37,53591.7,87543,8787,11,51237,51237,42860,51237,23609
7695,239,785,4938,2757,2.97017e+13,346.399,1801.46,7695,314,147,6636,6248,5608,5806,2730
30275,543,1160,19486,10789,2.96583e+13,533.225,3895.87,30275,431,252,28988,27278,25447,24666,20149
45374,581,3818,32885,12489,6.25328e+13,1467.16,10080.4,45374,1260,453,37293,35517,19079,17067,7791
35719,1662,2520,25562,10157,3.31063e+13,756.105,7402.04,35719,855,200,33199,32954,32624,32721,29713
75068,866,3825,49998,25070,3.10985e+13,861.46,11568.7,75068,1291,283,70342,68947,54687,39306,28585
55032,680,2472,34879,20153,3.03749e+13,555.506,7530.81,55032,537,367,52398,51517,44004,36628,23490
55549,10484,17976,45387,10162,2.5035e+13,4592.4,27694.9,55549,6270,21,37573,31629,32869,34462,26280
72698,142,2734,46031,26667,3.03414e+13,613.796,8865.26,72698,611,414,62636,57890,48052,35172,9336
91218,4002,4240,62976,28242,4.70807e+13,1360.1,14621.9,91218,1751,543,86978,86951,86214,84061,79940
37402,1252,2727,26578,10824,3.37623e+13,777.378,7833.83,37402,851,217,34675,33514,32348,33193,22535
67758,2468,4186,48026,19732,5.23224e+13,1420.28,13340.5,67758,1685,524,63572,62009,52594,46432,46524
53455,553,2136,32900,20555,3.10003e+13,533.038,6487.48,53455,470,327,51040,50219,39429,24672,23763
44459,521,3370,31810,12649,5.44114e+13,1421.26,9920.35,44459,1296,339,36706,34271,22437,19952,10319
96061,1058,4837,68705,27356,4.56119e+13,1748.55,16573,96061,1814,618,87303,82332,56950,47604,23043
46105,390,1343,29674,16431,2.89805e+13,569.002,4864.63,46105,432,296,43091,39888,37514,36466,19582
24499,1421,1913,17523,6976,3.39041e+13,609.84,5498.79,24499,674,162,22586,21944,22210,22080,21204
10849,754,800,7011,3838,2.92915e+13,390.357,2141.64,10849,284,167,10049,10049,9999,10017,9976
88531,512,23802,72543,15988,2.46343e+13,5435.97,38960.9,88531,7796,25,43939,40878,36254,25126,3434
88924,21473,29608,72467,16457,2.29412e+13,2936.28,41748.2,88924,5940,148,59316,59316,55407,56705,45872
4802,76,586,3110,1692,2.79592e+13,176.607,1260.34,4802,160,105,3806,2986,2959,2820,1410
35850,631,1878,22084,13766,3.0428e+13,411.185,5202.73,35850,387,286,33919,33390,26875,17350,16690
80119,1123,2859,49964,30155,3.06271e+13,678.594,9374.69,80119,597,452,77260,76847,64098,47129,38691
66375,3461,3627,43498,22877,2.95551e+13,660.43,10236.4,66375,1212,277,62748,62748,62748,62748,61049
95253,1269,3948,64895,30358,4.46346e+13,1327.68,13481,95253,1544,475,89453,86024,65561,25116,27213
49975,817,2381,31721,18254,2.96819e+13,571.942,7107.22,49975,548,372,47578,46895,40354,34723,21781
94535,31233,37190,76756,17779,1.70116e+12,102.883,39113.1,94535,1912,158,57345,57344,48669,54234,49187
78041,1809,3704,52447,25594,4.12979e+13,1129.78,11029.4,78041,1080,434,74008,72384,59728,17530,32659
53066,2856,2988,35248,17818,3.794e+13,749.171,7694.45,53066,729,335,50078,50078,49827,49884,48769
28997,1196,1617,18397,10600,2.97336e+13,459.225,4545.91,28997,421,253,27380,27378,26155,26564,23703
88867,1567,3903,60839,28028,4.55282e+13,1292.36,12973.8,88867,1457,467,83730,80270,62466,27867,31210
4985,492,614,3190,1795,2.77515e+13,180.713,1321.86,4985,171,106,4371,4285,4268,4213,4128
22098,1698,1945,15596,6502,3.52424e+13,553.211,5296.04,22098,652,154,20153,19995,20152,20152,19172
35308,22,1964,21539,13769,3.1403e+13,405.115,5189.44,35308,374,275,23231,17644,13686,3483,835
91988,22456,24607,75196,16792,2.48131e+13,5873.91,40290.7,91988,7799,26,67381,67381,67018,67018,64177
81484,2236,4116,52425,29059,2.95514e+13,715.964,12189.4,81484,1251,376,77368,77259,76124,76497,55670
64484,259,2670,41035,23449,2.99365e+13,600.721,8322.77,64484,572,410,58243,54265,47368,36612,15701
36504,1570,1772,23481,13023,2.91543e+13,497.957,5416.09,36504,483,317,34732,34731,34376,34246,34023
59900,3437,3784,41377,18523,4.96536e+13,1123.4,10892.2,59900,1349,463,56116,55971,54988,50572,43614
22165,2580,2607,15479,6686,4.56826e+13,870.297,6346.69,22165,807,276,19558,19558,19558,19557,19533
48210,993,2074,31094,17116,2.94728e+13,540.79,6450.38,48210,524,328,46136,46073,42960,42540,34814
14917,108,807,8710,6207,3.20422e+13,251.265,1981.93,14917,229,128,13159,11853,9030,4769,2977
94384,2486,4477,65154,29230,3.93668e+13,1337.69,15314.7,94384,1465,453,89907,89215,80570,78831,59877
47771,2744,2953,33886,13885,3.36767e+13,802.97,9253.35,47771,934,249,44818,44818,44818,44811,43511
70216,2383,3958,45151,25065,2.9285e+13,601.247,11148.7,70216,1237,343,66258,66240,65840,66136,47614
81796,426,4245,57600,24196,4.89956e+13,1368.23,14587.6,81796,1768,528,69749,65176,45385,29809,14306
25017,153,1634,18058,6959,3.02471e+13,514.349,5049.08,25017,515,198,20323,14923,12110,2599,3698
39954,2539,2987,24450,15504,2.93603e+13,444.796,6786.44,39954,910,231,36967,36967,36967,36967,35291
16784,972,977,10866,5918,3.05048e+13,425.996,2827.22,16784,298,199,15807,15807,15807,15805,15805
85248,877,2842,53948,31300,3.01087e+13,675.143,9597.62,85248,643,443,82329,81779,69799,59053,46181
60772,1665,2578,37712,23060,3.06358e+13,599.797,7838.3,60772,514,392,58194,58015,51373,42586,40176
28561,799,1627,18446,10115,3.00088e+13,503.401,4723.31,28561,447,274,26934,26549,24696,23561,14852
4174,71,864,2935,1239,1.4731e+13,404.19,1626.33,4174,257,93,2024,832,734,479,94
91572,3602,3950,62460,29112,4.47011e+13,1287.46,12927.2,91572,1396,476,87622,87485,85953,80846,69523
47885,2811,4774,40751,7134,4.19337e+13,17.1335,5623.16,47885,2391,2385,43111,43111,31365,38212,36897
54708,1936,2444,33888,20820,3.07032e+13,584.164,7059.76,54708,469,377,52264,52186,49299,50442,46234
75198,1708,2388,48624,26574,2.95217e+13,571.13,8153.13,75198,644,372,72810,72808,70994,69218,60814
38482,865,2501,23121,15361,3.18755e+13,449.863,5676.46,38482,583,249,35981,35756,27290,19487,12294
8586,779,971,6036,2550,3.07713e+13,391.683,2472.52,8586,410,105,7615,7586,7476,7589,5338
24919,849,1088,16150,8769,3.03732e+13,533.224,3537.78,24919,369,214,23831,23555,23196,22885,23136
6346,316,525,4623,1723,3.12394e+13,178.499,1556.74,6346,206,117,5821,5811,5490,5647,3942
95193,1307,4284,62567,32626,2.97746e+13,827.477,13631.8,95193,1255,428,90900,89943,73097,50691,33492
92446,2388,2927,57998,34448,2.98515e+13,708.669,10067.8,92446,628,458,89519,89383,84772,86641,78712
24519,52,1847,17740,6779,2.72887e+13,467.914,5192.84,24519,495,182,16479,8935,8787,3108,1305
41777,914,2632,29308,12469,2.82875e+13,578.339,7495.44,41777,871,266,39010,38217,27717,21178,9377
92525,1042,3563,58133,34392,2.98704e+13,918.257,11250.8,92525,746,458,88693,88141,74628,55480,45860
40498,2594,15617,32793,7705,1.94411e+13,1228.35,22401.9,40498,4038,103,24862,21137,17119,12620,9571
19631,937,2106,13679,5952,3.70666e+13,576.091,5211.23,19631,597,181,17503,16611,16569,16353,13136
32716,621,1674,20850,11866,3.03629e+13,482.521,4831.74,32716,447,273,30925,30343,27646,23980,22336
82692,2700,4365,59100,23592,4.914e+13,1639.31,14983.3,82692,1738,571,78327,77582,63946,61915,59957
7174,870,877,4600,2574,3.01912e+13,228.623,1833.03,7174,271,153,6297,6297,6297,6297,6294
97568,1311,4185,62530,35038,2.9558e+13,846.534,13516.6,97568,1258,442,93383,92705,79772,53902,42171
85104,4005,4046,53850,31254,2.93651e+13,809.143,12014.7,85104,1089,421,81058,81058,81058,81058,80993
43624,852,2825,27221,16403,2.96169e+13,396.079,6935.87,43624,1074,180,40799,40588,34958,33459,24584
29492,2167,2981,21524,7968,6.30182e+13,1324.58,7481.87,29492,1016,277,26511,24577,23393,23253,24119
11258,66,774,8212,3046,3.13165e+13,192.603,2433.15,11258,271,133,9026,7960,5320,2331,1618
3974,99,516,2513,1461,2.71982e+13,192.622,1120.14,3974,142,111,3200,3008,2516,2199,1132
53721,2138,2483,34034,19687,2.99849e+13,555.382,7435.75,53721,555,369,51238,51238,50081,50593,47981
10446,523,742,6670,3776,2.86031e+13,374.683,2058.36,10446,273,169,9704,9398,9241,8977,8751
87044,2795,4532,57700,29344,3.10478e+13,907.983,13744.2,87044,1358,356,82512,82193,82099,82012,61824
71300,2076,4169,49053,22247,3.27131e+13,1072.73,12647.4,71300,1119,369,67131,66653,63557,63345,43759
59427,1363,3693,41171,18256,3.13566e+13,848,10831.1,59427,1023,290,55734,54377,49911,45037,25812
53227,745,3483,33490,19737,2.9678e+13,451.337,8871.72,53227,1118,267,49744,49293,36471,20719,12176
23323,1084,1531,15043,8280,2.96398e+13,521.941,4070.93,23323,472,240,21792,21764,20932,20454,19101
17617,312,883,11342,6275,2.89665e+13,440.509,2724.19,17617,372,195,16073,15032,14559,13864,8383
26204,1438,1527,16785,9419,2.9378e+13,434.719,4359.19,26204,363,261,24677,24677,24602,24567,24411
82962,2026,4368,57088,25874,3.71216e+13,1217.07,14155,82962,1310,413,78594,76960,70992,70128,48731
64568,1672,3691,46440,18128,4.90165e+13,1415.45,12286.4,64568,1461,395,59971,56142,48771,45694,39795
96307,1225,4166,65962,30345,4.57705e+13,1378.09,14593.5,96307,1767,531,89707,85778,66397,30264,27619
55452,2117,3034,37751,17701,2.92885e+13,588.763,8840.75,55452,995,278,52418,52360,51055,52027,41313
71967,954,4218,51338,20629,5.15142e+13,1397.01,13765.9,71967,1663,532,64075,60350,44601,35248,25661
23379,1571,2122,16112,7267,2.69603e+13,536.676,5418.29,23379,835,193,21257,21252,20849,21132,17605
13325,106,1190,8599,4726,3.07424e+13,302.941,2850.92,13325,284,185,11003,10186,8700,6792,2989
7403,205,947,4470,2933,3.06708e+13,150.655,1775.47,7403,159,104,6428,5937,4644,1416,740
99194,3384,4935,66795,32399,3.54443e+13,1314.08,15861.9,99194,1426,461,94259,93774,90192,91204,76521
32431,1768,2259,19709,12722,2.90729e+13,343.784,5112.63,32431,815,159,30172,30172,30068,30171,28116
76938,2711,2786,49135,27803,2.95456e+13,642.842,9063.47,76938,625,424,74152,74120,74117,74152,73693
48573,885,2401,30407,18166,3.07556e+13,515.753,6731.39,48573,489,343,46172,45764,38082,28111,20535
10861,289,1152,7750,3111,3.13373e+13,425.189,3019.55,10861,493,118,9167,8692,5306,3801,1323
48791,888,3351,30830,17961,2.92011e+13,442.413,8295.23,48791,1136,198,45440,45014,32949,24773,13206
64046,1850,2184,41302,22744,2.93838e+13,552.72,7376.8,64046,553,369,61862,61862,61133,60895,59985
88966,3396,4381,60128,28838,3.53704e+13,1124.8,14119.2,88966,1321,409,84585,84320,81267,80899,77251
77264,3545,4161,55631,21633,4.99805e+13,1686.83,14103.3,77264,1569,552,73103,73030,71200,70741,70859
9021,941,1040,5761,3260,2.84873e+13,261.423,2288.76,9021,270,181,7981,7977,7961,7907,7590
86458,1534,4472,57348,29110,3.08951e+13,898.806,13589.2,86458,1341,356,81986,80923,72270,71110,38067
14840,589,2107,10088,4752,4.55353e+13,736.776,4554.97,14840,784,156,12131,10966,10063,8843,4420
90233,413,3175,58612,31621,3.28155e+13,715.22,10014.2,90233,676,400,84648,78495,70548,8769,6136
46352,3399,3831,33528,12824,6.34176e+13,1510.92,10333,46352,1379,448,42521,42521,41543,41457,41119
17271,1142,1777,11236,6035,2.52263e+13,295.544,3980.11,17271,603,156,15494,15494,15356,15407,10241
81112,2047,4218,56613,24499,4.89447e+13,1357.38,14307.9,81112,1758,534,76573,72375,58917,44885,43558
74720,2875,3736,53467,21253,4.49402e+13,1567.92,13337.1,74720,1575,385,70984,70653,63280,65208,62761
13085,1449,1718,9215,3870,6.46259e+13,302.132,3474.19,13085,316,262,11367,11366,11148,10983,9531
5185,903,1083,3632,1553,6.19093e+13,125.229,1889.98,5185,210,110,4102,4099,4069,4082,3303
14263,115,856,9207,5056,2.92762e+13,403.141,2466.24,14263,310,185,11844,10910,9414,8397,3941
98040,2301,4206,67081,30959,4.53591e+13,1376.84,14780.5,98040,1827,536,93798,90368,75784,42109,50335
41737,2979,3476,30058,11679,6.08507e+13,1510.31,9604.42,41737,1425,322,38261,38245,37637,37542,37008
13735,1420,1743,9742,3993,2.84866e+13,368.998,3835.22,13735,482,132,11992,11779,11983,11979,11615
74262,655,2528,47996,26266,3.07406e+13,632.256,8062.64,74262,599,373,71652,70215,59916,56597,22831
32359,552,1179,20898,11461,2.99139e+13,525.917,3988.42,32359,445,248,31090,29463,27464,25922,19990
90020,2949,4207,58633,31387,2.96102e+13,768.986,13039.9,90020,1257,422,85813,85649,85686,85530,65208
47667,1834,1975,30734,16933,2.96784e+13,527.98,6341.71,47667,502,339,45692,45692,45473,45441,45516
34133,1317,1866,21270,12863,3.10941e+13,427.84,5112.84,34133,386,278,32267,32258,29475,30425,24116
64116,544,2733,42338,21778,3.61995e+13,800.321,7889.1,64116,640,328,60687,57057,46378,6210,6337
66050,2322,6623,56141,9909,4.22216e+13,16.9947,7606.74,66050,3315,3310,59427,59427,33649,48681,46546
96554,969,4128,66172,30382,4.68687e+13,1335.83,14279.1,96554,1739,477,89131,85590,63784,25899,24802
4697,365,807,3029,1668,2.84367e+13,151.506,1478.51,4697,217,119,3890,3826,3499,3572,1180
18631,802,1831,12762,5869,5.38414e+13,371.615,4152.89,18631,335,271,16800,16713,14177,6584,6450
47699,944,1369,30759,16940,2.89561e+13,568.611,4933.26,47699,480,295,46330,46279,44195,44105,42315
10710,761,1578,6828,3882,2.43997e+13,260.609,2940.58,10710,339,120,9132,9095,8311,8689,6195
19222,79,3086,13713,5509,6.43402e+13,647.104,6106.31,19222,772,389,12698,9396,5621,3509,1383
59230,988,2063,38226,21004,2.98102e+13,566.151,7048.41,59230,531,354,57167,57070,53189,52302,39179
35930,869,2632,22687,13243,2.91236e+13,352.125,6319.02,35930,969,178,33298,33140,30006,27298,20606
17727,878,1413,11422,6305,2.90254e+13,397.167,3531.82,17727,406,223,16314,16276,15960,15884,14212
89439,652,3968,58659,30780,2.99791e+13,734.537,12671.8,89439,1242,394,84541,82506,60037,39630,24414
20708,1768,3103,15270,5438,6.51868e+13,993.638,6391.77,20708,772,368,17605,16578,13819,13144,12420
65586,4714,19410,53990,11596,2.31948e+13,4145.75,30880.6,65586,6738,21,43075,33345,33585,38913,21057
82757,3534,4102,56989,25768,4.78426e+13,1305.79,13258.9,82757,1557,477,78655,78482,76325,47805,56066
43440,52,1357,27928,15512,2.93719e+13,571.477,4789.22,43440,466,293,29898,19815,22642,17125,4564
98018,2275,4820,65509,32509,3.33053e+13,1245.46,15524.6,98018,1396,455,93198,92324,88613,89512,50719
25827,1073,1532,16640,9187,2.88102e+13,445.803,4196.78,25827,423,242,24295,24280,24118,24033,22607
88800,2302,2940,56242,32558,3.02975e+13,719.212,9938.16,88800,682,442,85860,85668,81726,80935,73662
56177,158,4130,40132,16045,5.74854e+13,1531.27,11967.9,56177,1608,516,41226,35812,20613,15808,3752
9978,411,617,5837,4141,3.26076e+13,225.79,1458.14,9978,182,111,9361,9299,8626,8943,7691
73050,18541,30507,58445,14605,125802000,1061.29,44895,73050,7335,11,42543,42543,37836,42543,25889
32827,279,2491,23402,9425,3.31374e+13,716.888,7046.85,32827,792,194,28858,27353,17406,8651,5065
6076,298,481,3552,2524,3.25494e+13,177.712,1062.76,6076,116,93,5595,5499,5048,5301,4155
24038,2627,2997,17766,6272,6.58517e+13,1109.14,6805.68,24038,803,268,21041,21041,21041,21041,20695
31415,463,1113,20129,11286,2.88594e+13,535.116,3872.33,31415,397,257,29742,27652,26136,25051,18050
70192,2139,3918,47475,22717,3.14654e+13,888.349,11769.7,70192,1162,290,66274,66005,64225,65203,47933
21302,1471,2652,15140,6162,5.6437e+13,855.441,6050.81,21302,812,231,18650,17832,13899,14239,13062
34111,1610,1944,22613,11498,3.96686e+13,475.924,5217.58,34111,438,266,32167,32163,31521,31453,29396
29174,1115,1122,18792,10382,2.94941e+13,546.017,3764.93,29174,472,248,28052,28052,28052,28045,28047
73266,1602,4180,52043,21223,5.15704e+13,1398.79,13828.8,73266,1723,528,67863,63604,50145,40257,35719
45069,1704,2835,30854,14215,2.861e+13,537.296,7914.78,45069,945,263,42234,42227,40879,36905,29439
56112,1920,2652,37130,18982,3.75858e+13,777.097,7370.2,56112,663,317,53460,53073,49939,37294,19141
63786,1365,2621,39860,23926,3.04749e+13,627.689,8125.97,63786,523,398,61165,60975,53502,39694,41697
84554,415,3957,55779,28775,2.98694e+13,743.86,12389.1,84554,1249,402,78151,74247,51124,31584,11681
79909,817,2432,51590,28319,2.97114e+13,577.541,8393.49,79909,655,379,77477,76879,68139,68309,50137
91016,2863,4575,64477,26539,4.21714e+13,1667.19,15603.7,91016,1693,478,86441,85852,76199,74647,65270
55931,573,3665,35872,20059,2.92583e+13,507.251,9492.53,55931,1212,258,51752,49126,34398,17272,6411
53455,1260,2012,34452,19003,2.93951e+13,554.557,6677.6,53455,575,338,51443,51420,49643,48081,39569
62701,1543,2057,40458,22243,2.92936e+13,529.782,6869,62701,539,334,60644,60643,59897,59476,54522
59768,3539,4092,37451,22317,3.0941e+13,548.253,9013.33,59768,883,338,55676,55676,55363,55668,55358
62955,774,3668,39776,23179,2.97196e+13,561.67,9906.76,62955,1137,315,59254,58379,44403,26533,20438
63126,3433,3649,45389,17737,4.9262e+13,1428.01,12109,63126,1454,383,59477,59477,59303,59386,59223
32991,489,2788,23439,9552,4.37833e+13,843.661,7867.37,32991,835,301,28192,26778,21228,20188,11855
34397,2489,2533,22829,11568,2.74936e+13,488.912,6685.67,34397,941,210,31864,31864,31864,31864,31838
71462,1744,3848,47934,23528,3.09576e+13,847.228,11465.1,71462,1224,287,67614,67065,64518,58154,37126
95719,1141,4320,61528,34191,2.96526e+13,824.382,13550.7,95719,1258,430,91303,90440,75467,51384,36829
15734,468,870,10176,5558,3.07249e+13,484.261,2604.98,15734,373,190,14638,13689,13393,12519,9805
58985,2218,2406,36321,22664,3.03153e+13,598.526,7226.19,58985,496,382,56579,56579,56008,56149,54883
99734,11833,29350,81228,18506,2.52481e+13,4751.19,44523.4,99734,8216,123,70384,59957,61823,62049,31596
48606,684,2118,31308,17298,2.92958e+13,588.571,6652.46,48606,533,351,46390,45619,40830,39468,23856
25370,907,3484,18533,6837,6.56944e+13,988.949,7406.97,25370,876,405,20888,20029,10436,9104,6095
67425,263,2676,42265,25160,3.015e+13,609.34,8460.37,67425,534,406,61572,57753,48096,32480,16134
4130,334,563,2636,1494,3.12811e+13,227.676,1166.15,4130,199,119,3567,3410,3399,3307,2699
53867,1510,3289,36998,16869,2.86597e+13,634.665,9081.93,53867,965,279,50578,50431,48450,43119,25637
17341,247,11404,13750,3591,3.36649e+13,580.928,13035.6,17341,2294,15,5183,4937,4638,4931,812
25650,3067,8985,20933,4717,1.7284e+13,127.394,11015.6,25650,684,139,16665,16664,8585,7933,8794
51033,1492,2970,33687,17346,2.90759e+13,498.062,8309.39,51033,1085,254,48063,48029,46047,40575,24789
91713,1067,4613,60998,30715,3.14628e+13,1139.11,14571.7,91713,1380,373,86006,83430,62113,53532,22348
79812,546,2806,49918,29894,3.01513e+13,677.394,9281.16,79812,619,431,76229,73747,60688,45645,26699
91890,2066,3657,60327,31563,3.48673e+13,1126.46,11329.6,91890,836,391,88233,87220,77659,16053,25097
2493,130,565,1682,811,5.17718e+13,177.59,1007.7,2493,205,64,1752,1495,1242,1363,630
48773,16051,16460,40128,8645,2.34825e+13,3281.32,24844.3,48773,5394,17,32313,32313,32313,32313,32313
26199,8918,11766,20961,5238,116920000,659.804,16784.6,26199,2635,11,14433,14433,13722,14433,10877
10030,554,1757,6999,3031,3.32912e+13,309.141,3426.63,10030,427,129,8250,7868,7117,7482,5182
3648,401,579,2375,1273,3.22913e+13,190.65,1151.57,3648,186,108,3069,3003,2937,2832,2322
55922,3604,3791,40278,15644,5.73257e+13,1533.65,11559.1,55922,1459,514,52131,52131,51466,51428,51158
8770,1202,1667,5854,2916,5.29945e+13,336.141,3094.9,8770,547,112,7103,7103,7063,7091,5703
96923,4716,25090,79647,17276,2.65476e+13,5313.56,40927.2,96923,9094,27,65635,48494,49745,57705,18479
86695,2360,3962,59400,27295,4.58459e+13,1292.55,13026.8,86695,1473,470,82733,79880,69936,35124,46840
55857,250,1704,36034,19823,3.01517e+13,585.946,5734.39,55857,556,324,50157,46355,42013,4027,4784
63633,2397,3791,45790,17843,5.10298e+13,1421.01,12286.3,63633,1462,452,59842,57481,50176,51606,50788
50408,1887,2353,32196,18212,3.0053e+13,553.36,7162.72,50408,524,376,48055,48051,46679,47091,43641
15601,2683,2705,11127,4474,6.28294e+13,406.041,5204.63,15601,630,337,12896,12896,12894,12894,12872
32605,243,2036,21815,10790,4.38356e+13,514.426,5268.42,32605,445,282,28570,26210,20757,4437,2614
30181,1185,1693,19136,11045,3.05527e+13,437.495,4734.91,30181,402,258,28488,28482,26840,27296,23264
95436,3192,4517,66498,28938,4.11478e+13,1564.9,15770.8,95436,1645,458,90919,90439,82143,81136,73229
28418,2319,2826,19382,9036,4.5055e+13,505.028,6165.03,28418,648,326,25592,25568,24358,20004,13256
45016,1840,2194,29608,15408,3.81718e+13,528.629,6135.05,45016,511,289,42822,42820,42167,41624,39816
72649,1416,3932,49036,23613,3.18947e+13,939.18,12090.1,72649,1159,302,68717,67101,61570,53140,26982
4956,887,1421,4248,708,301058,5.13398,2446.76,4956,710,5,3535,3535,3535,3535,2472
10271,674,1247,6362,3909,3.07944e+13,185.113,2559.15,10271,256,169,9024,9012,7651,6523,4379
8911,689,721,5737,3174,2.96593e+13,336.707,1847.52,8911,229,157,8190,8190,8165,8168,8149
20914,781,1013,13472,7442,3.01002e+13,501.074,3171.8,20914,376,217,19901,19833,19241,19128,18776
41171,68,2841,25948,15223,3.08123e+13,414.736,6989.6,41171,914,196,29896,23634,17965,5262,3429
10827,88,732,6995,3832,2.87003e+13,359.207,2019.82,10827,276,149,8855,7143,6744,6352,2467
31439,870,2192,18669,12770,3.09639e+13,308.519,4444.19,31439,619,153,29247,29223,27536,28179,24993
91976,1441,4526,62018,29958,3.53814e+13,1173.93,14492.9,91976,1371,422,87014,84798,73120,67708,38295
7400,651,1592,5038,2362,4.99269e+13,326.727,2911.02,7400,457,144,5808,5662,5134,4294,1874
46767,1151,1463,30167,16600,2.9347e+13,559.941,5031.38,46767,474,301,45304,45302,44350,44382,43257
45949,869,1791,29669,16280,2.96518e+13,553.746,5495.26,45949,521,304,44158,44035,41468,41462,38985
87521,2695,4318,61912,25609,4.81603e+13,1339.59,15157.1,87521,1790,543,83203,82727,73316,61362,63576
31018,197,1108,19970,11048,2.89657e+13,556.985,3855.81,31018,418,249,27134,25419,22784,21885,9671
40780,870,1832,26217,14563,2.9324e+13,498.344,5651.25,40780,466,306,38948,38817,35949,36287,30442
44016,1347,3194,27536,16480,2.92161e+13,413.83,7429.07,44016,1025,190,40822,40745,37705,37037,26169
34423,1393,1624,22401,12022,3.30671e+13,504.278,4746.61,34423,501,269,32799,32799,32458,32061,31893
83258,2465,2801,53982,29276,3.12512e+13,729.613,9087.47,83258,728,389,80457,80369,79844,79341,76806
50470,1414,2988,36539,13931,5.0903e+13,1284.1,10211.9,50470,1169,353,46432,43672,36163,33669,28770
70298,1632,2707,44052,26246,3.05591e+13,647.942,8726.29,70298,568,425,67591,67407,60454,48730,50071
57561,239,595,39002,18559,3.34409e+13,302.101,4043.96,57561,303,252,55870,53390,38428,34527,35111
97998,3041,4226,63420,34578,2.93934e+13,836.831,13712.1,97998,1257,433,93772,93634,93698,93572,75549
43775,293,3704,31117,12658,5.80516e+13,1167.78,9791.65,43775,1269,450,35492,31888,19795,8934,6046
78723,1410,4253,56404,22319,5.01299e+13,1470.89,14400,78723,1720,543,72519,67999,54500,45752,35932
82257,4494,11113,55485,26772,2.73883e+13,449.409,17615.7,82257,1351,334,71144,71118,63419,65078,62098
19352,821,953,12483,6869,2.98896e+13,497.699,2989.86,19352,389,199,18399,18347,18120,18160,18019
45798,2923,3783,32199,13599,5.51555e+13,1147.64,9960.19,45798,1362,458,42015,41894,38176,27520,30383
36512,551,3659,26525,9987,6.5151e+13,1238.36,9017.5,36512,1205,454,30195,28719,15986,11629,9952
84930,3956,4103,58517,26413,4.85457e+13,1314.06,13693.7,84930,1768,467,80827,80818,80322,78637,77356
81396,1116,3675,54931,26465,4.20995e+13,1123.85,11502,81396,1255,429,76688,74634,58076,16221,18360
52775,350,3027,34986,17789,2.91675e+13,524.327,8500.46,52775,1066,262,47785,45132,30972,17498,12393
35741,468,2489,25669,10072,3.03144e+13,719.981,7182.59,35741,748,210,32265,31215,20333,20202,8677
96006,2049,4318,62052,33954,3.09208e+13,853.63,13601.2,96006,1071,427,91688,91231,84585,84707,60664
8551,398,1620,5644,2907,5.81356e+13,254.921,3068.11,8551,614,119,6908,6381,6084,6273,2912
16032,1274,1335,10314,5718,2.91972e+13,353.966,3393.13,16032,305,223,14697,14697,14670,14624,14584
48562,1781,1974,31376,17186,2.91894e+13,536.883,6323.56,48562,521,320,46588,46588,46441,46510,46202
7900,1573,1730,5386,2514,4.1352e+13,270.942,3113.49,7900,500,134,6170,6163,6110,6152,5994
57368,2876,3112,35656,21712,3.00985e+13,568.825,8167.87,57368,725,304,54256,54256,54256,54256,53847
31600,175,1796,19796,11804,3.08714e+13,425.478,4926.74,31600,392,264,27839,25272,21311,13968,6030
83539,2133,3955,54052,29487,2.97181e+13,682.326,12169.2,83539,1252,381,79584,79468,78521,79257,55333
33533,770,1151,21626,11907,2.88834e+13,518.621,4017.64,33533,432,264,32382,32315,30652,30508,29431
6165,256,645,3970,2195,2.85344e+13,223.049,1453.15,6165,228,105,5388,5212,5027,4850,3815
50223,1631,2962,34534,15689,2.88448e+13,550.893,8429.04,50223,946,276,47261,47247,45530,40516,28208
6619,609,666,4231,2388,2.87895e+13,270.706,1578.45,6619,221,148,5953,5946,5937,5940,5878
9261,71,678,6777,2484,3.17144e+13,191.235,2082.17,9261,242,126,7458,6619,4261,1920,976
31798,508,3035,21498,10300,4.48561e+13,547.998,7055.28,31798,846,343,28396,26521,19797,5779,4175
65820,309,3356,41345,24475,2.93857e+13,573.538,9423.84,65820,967,331,59841,55825,43572,27269,16326
18388,2054,2561,13488,4900,5.66832e+13,1162.41,5666.01,18388,783,216,15827,14623,15098,15183,14475
14822,795,2688,10643,4179,6.31117e+13,346.739,4998.33,14822,586,320,12134,11890,6492,5128,4048
62195,2075,3562,44720,17475,4.73638e+13,1603.92,12013.6,62195,1338,379,58115,55442,48957,46662,40556
98023,2687,4316,64357,33666,2.97418e+13,809.572,13814.1,98023,1259,430,93707,93448,92822,93164,64444
64440,288,3820,46385,18055,5.15634e+13,1403.26,12405.3,64440,1465,493,52498,48088,30710,28513,10304
51938,26,581,35274,16664,3.37079e+13,300.22,3837.39,51938,300,248,17392,8514,7296,1737,2311
37468,562,1678,24052,13416,2.88326e+13,511.096,5001.58,37468,454,276,35709,34374,31464,30904,26701
14044,103,900,9109,4935,3.0284e+13,443.325,2527.23,14044,305,189,11335,9865,8528,7666,1604
57052,3240,3788,39043,18009,4.8415e+13,1121.89,10663.8,57052,1357,457,53264,53108,51590,31158,36972
18710,357,894,12074,6636,2.89295e+13,433.675,2824.27,18710,363,199,17271,16087,15366,14699,11483
91151,1238,4503,60271,30880,2.91811e+13,979.847,13729.4,91151,1255,401,86333,84822,67620,54411,26617
78302,3993,4244,56376,21926,4.96378e+13,1672.05,14362.3,78302,1614,550,74058,74058,74005,73478,73169
74226,3207,3695,49369,24857,4.02069e+13,1003.44,10619.8,74226,1037,431,70531,70385,68003,63818,48274
67299,465,3607,48457,18842,4.18114e+13,1231.13,12380.6,67299,1322,375,58417,55377,34809,31940,14022
96898,1122,4184,66305,30593,4.55957e+13,1338.42,14551.8,96898,1798,523,89969,86231,65973,28826,26850
28060,640,1600,17915,10145,2.96649e+13,506.241,4452.38,28060,425,259,26384,25808,23947,21548,20268
89610,3880,23963,73461,16149,2.60823e+13,5474.42,38979.7,89610,8346,27,57777,42675,42798,50578,16010
4177,718,1763,3398,779,1.69604e+12,73.988,2085.79,4177,426,54,2414,2411,1084,2342,1228
42417,1662,3337,30232,12185,5.47045e+13,1472.64,9659.24,42417,1296,338,38489,35394,28806,29719,23529
70009,272,3658,44620,25389,2.95577e+13,578.305,10583.6,70009,1166,329,62808,58360,43755,23390,12052
99407,58438,99406,49704,49703,5808030,1.00597e-05,99406.4,99407,49704,2,1,1,1,1,1
56879,736,2070,36622,20257,2.90683e+13,574.696,6406.25,56879,549,330,54809,54446,48441,49712,41122
17402,657,1030,11269,6133,3.02463e+13,413.616,2892.21,17402,340,196,16372,16083,15400,14913,14994
72992,906,3884,47121,25871,2.94923e+13,639.321,11336.2,72992,1238,363,68936,68087,52254,33109,20188
81403,3637,4007,53845,27558,3.89027e+13,1206.1,11620.9,81403,1045,424,77396,77295,77070,76948,73551
27960,888,3290,19040,8920,4.97852e+13,612.888,7232.6,27960,847,396,24499,23822,16497,6944,5246
71121,508,671,48241,22880,3.35467e+13,304.205,4542.14,71121,308,264,70450,70450,63393,65917,63209
55989,3120,3459,35130,20859,2.9033e+13,458.149,8939.2,55989,1066,283,52530,52530,52530,52530,51719
63646,199,3644,42824,20822,4.35956e+13,938.878,10119.2,63646,1041,422,53354,48661,37503,7014,7254
25879,307,2251,18060,7819,3.76371e+13,626.411,6174.58,25879,647,202,22264,20748,17633,18057,7274
1987,374,445,1563,424,9.34857e+13,109.21,767.825,1987,59,84,1542,1540,1475,1509,1448
54020,1169,3382,38756,15264,5.01921e+13,1318.04,10945.2,54020,1304,349,48796,45834,36944,34368,27043
5613,129,1028,3616,1997,2.98139e+13,198.473,1936.19,5613,214,146,4309,4050,3445,2781,1434
34373,1255,2294,20810,13563,2.93985e+13,338.027,5197.32,34373,849,161,32079,32077,31792,32029,27321
9009,121,1967,6874,2135,7.1949e+13,322.247,3376.52,9009,415,158,6254,4241,2257,2362,670
79985,1971,4322,57352,22633,4.90051e+13,1664.63,14741.2,79985,1712,562,74883,70827,59201,53262,45134
71540,2787,3949,48460,23080,3.20456e+13,957.818,12130.4,71540,1218,302,67591,67344,67389,67506,57532
86929,617,2874,54585,32344,3.01989e+13,695.718,9824.69,86929,604,457,83549,82041,67078,54142,37763
40199,791,1567,26034,14165,3.14072e+13,531.206,4907.74,40199,446,299,38632,38526,34165,32445,24740
57355,1746,2098,36876,20479,2.95974e+13,536.562,6693.85,57355,503,319,55257,55253,54888,54545,51137
20189,652,1177,13089,7100,3.04002e+13,527.499,3374.05,20189,383,209,18961,18514,17582,17030,16798
50547,1439,1887,32527,18020,2.9101e+13,523.877,6173.5,50547,463,317,48660,48651,48058,47543,43620
98325,2717,2953,61763,36562,3.04553e+13,709.158,10427.9,98325,633,476,95372,95372,94390,94714,92609
28725,11079,13049,23491,5234,2.55026e+13,1389,17359.5,28725,2686,13,15676,15539,15589,15587,11267
54027,3296,3460,36069,17958,4.17691e+13,788.284,9151.33,54027,998,417,50567,50566,50170,50211,48146
78079,1004,2450,50395,27684,2.92957e+13,608.162,8425.53,78079,659,381,75629,75527,69051,68070,52371
30859,424,1627,19843,11016,2.8955e+13,483.311,4719.23,30859,448,263,28622,26704,24880,24164,16050
57373,1110,3051,37994,19379,2.94838e+13,582.697,8821.53,57373,1104,262,54286,53596,47688,40642,25477
71902,3098,3147,47229,24673,3.62705e+13,670.41,8585.36,71902,570,336,68755,68755,68748,68747,68683
39060,1744,1873,25198,13862,2.96245e+13,551.579,5738.85,39060,516,311,37187,37187,37093,37113,37059
18388,122,852,11865,6523,2.87775e+13,453.497,2748.26,18388,358,201,15566,14531,12574,11004,4811
40875,1305,11338,30620,10255,2.25121e+13,178.529,14513.6,40875,1134,166,29537,29477,14856,15017,14943
69429,73,2613,44340,25089,2.95626e+13,600.355,8495.01,69429,607,403,54220,40837,41128,34387,5864
78351,1945,3796,52971,25380,4.27066e+13,1177.29,11679.9,78351,1350,446,74263,71846,57901,22647,33680
86959,661,3990,56739,30220,2.96442e+13,701.775,12486.7,86959,1246,390,82124,80148,58394,38386,24961
46104,2820,3631,32061,14043,5.09834e+13,1048.13,9665.51,46104,1189,422,42473,42344,38824,25509,28216
83766,3159,4288,60078,23688,4.87422e+13,1699.68,15047.1,83766,1725,562,79478,79046,71877,69302,69990
67973,768,4209,47927,20046,5.29364e+13,1450.16,13234.7,67973,1738,523,59257,56396,37804,25051,15841
51873,1873,2597,34342,17531,3.78846e+13,737.683,7237.42,51873,619,324,49276,48921,45969,14781,18435
70456,1022,3705,47729,22727,4.27079e+13,1132.85,10890.9,70456,1136,425,65638,63824,47519,12595,12087
77734,4103,4281,55479,22255,4.96454e+13,1463.43,14356,77734,1676,560,73453,73448,73343,73114,72310
30254,1072,1751,18961,11293,3.05707e+13,445.198,4805.17,30254,392,264,28503,28484,25897,25502,19735
1675,65,278,1223,452,2.82462e+13,75.1582,589.334,1675,132,65,1352,1231,939,683,712
23064,115,1858,16665,6399,2.81492e+13,534.896,5045,23064,524,166,18467,16178,11111,4221,2915
54933,2902,3145,39721,15212,4.75505e+13,1310.62,10824.5,54933,1173,350,51788,51770,50659,50415,50143
75556,1449,2746,48040,27516,3.06302e+13,657.373,9074.97,75556,618,431,72810,72659,66531,56291,48026
61121,2914,3602,38369,22752,2.9301e+13,559.447,9510.11,61121,1063,316,57519,57517,57519,57516,55288
61018,1703,3255,39846,21172,2.95266e+13,632.253,9243.41,61018,1189,273,57763,57621,56269,55939,33299
99097,2217,4281,64016,35081,2.96905e+13,865.097,13846.3,99097,1266,427,94816,94448,89687,90626,67167
4832,467,727,3493,1339,1.78919e+13,291.742,1624.35,4832,443,83,3975,3576,2894,3032,2537
66868,646,2177,43173,23695,2.9714e+13,563.737,7387.53,66868,569,339,64691,63734,56016,55324,39601
46236,589,4626,39324,6912,4.20657e+13,17.0666,5456.61,46236,2315,2310,41610,41610,17418,31526,27870
77323,109,714,52492,24831,3.36475e+13,304.581,4765.45,77323,311,268,55848,33051,35257,13765,13403
26921,1596,2926,18489,8432,4.86899e+13,479.756,6459.54,26921,748,333,23995,23726,17487,8397,8015
61090,283,3771,43819,17271,5.50827e+13,1461.03,12034.3,61090,1460,524,48780,44022,27080,23819,8686
87295,471,4347,62557,24738,4.75973e+13,1648.67,15457.6,87295,1754,564,75080,70962,42631,36270,12629
88340,3758,4499,58587,29753,3.10005e+13,896.606,13841.4,88340,1354,352,83841,83841,83841,83841,79955
61577,350,6163,52361,9216,4.21257e+13,18.045,7122.52,61577,3084,3079,55414,55411,20568,40889,35042
36587,1089,1669,23679,12908,3.03724e+13,555.269,5201.26,36587,445,307,34918,34891,32981,31596,25405
80914,5730,7430,52478,28436,2.93989e+13,577.473,14204.9,80914,1093,401,73484,73484,72028,73204,71817
33759,1077,2957,22860,10899,4.39221e+13,554.803,6977.84,33759,786,327,30802,30452,22518,6439,6364
41391,2057,2876,25134,16257,3.04853e+13,432.587,6469.72,41391,684,261,38515,38515,38473,38509,37006
77363,2376,3711,52153,25210,4.19603e+13,1155.07,11359.7,77363,1202,431,73652,71823,62131,23869,38768
73309,3265,3842,50074,23235,4.60485e+13,1144.84,11626.4,73309,1385,460,69467,69259,66941,34923,45187
44057,131,2008,27181,16876,3.07188e+13,458.77,5846.15,44057,417,292,38382,35015,28443,15130,6799
82106,439,4216,58119,23987,4.8914e+13,1354.08,14594.1,82106,1764,534,70298,66190,46031,32521,15689
16829,151,877,10881,5948,2.92692e+13,447.355,2669.62,16829,356,188,14408,13677,11800,10497,5611
55573,1143,2361,35539,20034,2.95191e+13,551.771,7445.76,55573,540,387,53212,53118,48467,43664,34335
25165,1022,1546,16202,8963,2.99257e+13,456.839,4212.64,25165,367,234,23619,23586,23370,23195,21420
31370,1255,1593,20273,11097,2.94928e+13,449.496,4772.71,31370,389,275,29777,29768,29402,29024,26004
97250,1996,4756,69568,27682,4.51414e+13,1719.74,16661.8,97250,1864,607,91627,87408,74092,68015,50402
68620,1196,3625,49058,19562,4.59875e+13,1664.84,12681.2,68620,1483,377,62440,58660,48321,46715,26733
82971,464,3969,59838,23133,4.85649e+13,1736.37,14491.7,82971,1627,566,70975,66884,38668,36474,10301
71026,1024,3666,47254,23772,4.03499e+13,897.25,10316.2,71026,1042,429,67001,65790,52696,12361,14267
45267,1227,1336,29180,16087,2.94424e+13,568.919,4827.94,45267,492,296,43931,43931,43686,43709,43517
67250,2540,3197,44453,22797,3.67647e+13,824.523,8960.27,67250,808,335,64053,63943,60724,55959,36959
76033,1483,2815,47591,28442,2.99441e+13,663.729,9185.53,76033,559,432,73218,72939,65071,50769,49587
88208,1098,2934,56022,32186,2.95492e+13,704.133,9854.84,88208,676,434,85274,84977,75290,66731,54063
76683,3371,3948,55406,21277,4.96893e+13,1668.07,13797.4,76683,1507,551,72735,72477,69803,69656,69648
26809,652,1458,15795,11014,3.18856e+13,302.974,3365.16,26809,387,174,25351,25279,18861,13701,11932
75850,2428,4165,53159,22691,3.74538e+13,1226.44,13546.9,75850,1354,413,71685,71234,66616,65483,51246
95679,1499,4839,64432,31247,3.55685e+13,1314.78,15349.7,95679,1410,425,90206,87702,75200,74546,36904
14024,812,834,9057,4967,2.98449e+13,453.122,2461.74,14024,293,189,13190,13173,13176,13190,13158
30049,1641,2413,21529,8520,3.10628e+13,696.052,6513.87,30049,678,190,27636,27500,27365,27459,24994
34931,1626,1884,21009,13922,3.12161e+13,348.354,4831.82,34931,423,243,33047,33043,32322,32618,31086
60743,1120,3101,39838,20905,2.95357e+13,605.622,9009.56,60743,1167,263,57574,56873,51711,43427,29497
91923,1437,2890,58347,33576,2.97158e+13,681.213,9936.47,91923,647,450,89033,88792,80458,70597,61652
69719,3147,3652,50128,19591,4.06168e+13,1246.61,12609.8,69719,1323,379,66067,66067,63803,62982,62799
5601,49,497,3274,2327,3.2522e+13,169.998,1030.89,5601,112,96,4592,4246,3102,1597,791
41010,1786,3629,28738,12272,5.21029e+13,1044.5,9137.41,41010,1110,424,37197,35510,27429,16111,17045
75900,1940,2411,49015,26885,2.9245e+13,573.628,8100.81,75900,603,368,73489,73488,72527,72168,69114
81067,1765,3684,54663,26404,4.15604e+13,1123.08,11508.7,81067,1269,438,76998,74818,61512,21818,32429
19888,1589,2156,16795,3093,4.2052e+13,17.0757,2710.73,19888,999,978,17732,17732,15432,16653,16473
96359,2980,4524,67011,29348,4.09138e+13,1540.04,15763.1,96359,1600,452,91835,91232,82657,81394,71385
85856,1016,3919,58905,26951,4.63152e+13,1326.25,12938.6,85856,1433,473,79390,76441,55246,20702,19372
11201,248,779,8215,2986,3.14758e+13,192.995,2431.05,11201,272,134,10422,9591,8146,9079,4003
29713,288,1082,19127,10586,2.88028e+13,502.087,3721.45,29713,373,241,27052,24896,23926,22747,13143
8362,382,736,4898,3464,3.24437e+13,193.155,1455.09,8362,181,102,7626,7580,7081,7279,6249
96754,1833,4466,65315,31439,3.62338e+13,1240.95,15021.7,96754,1404,413,92096,89681,83067,74401,49806
71482,1369,2651,46045,25437,3.0075e+13,600.407,8536.28,71482,641,399,68831,68767,64198,60848,47916
17996,135,858,11576,6420,2.85676e+13,452.192,2743.94,17996,360,200,15325,14476,12556,10884,5164
88318,1480,2984,55130,33188,3.01702e+13,721.938,9987.07,88318,623,457,85334,84927,75278,56177,56550
82184,1409,4245,58436,23748,4.92088e+13,1366.06,14736.3,82184,1732,546,76024,71435,57815,44537,37741
77972,1286,3908,51294,26678,3.64328e+13,1058.69,10883.2,77972,987,405,73943,72870,59398,11045,12231
37288,700,3581,25769,11519,5.31328e+13,707.858,8452.54,37288,945,409,33019,32255,22771,9494,8916
30900,1444,1814,18538,12362,3.0981e+13,326.032,4423.83,30900,381,231,29086,29057,27460,28105,25729
55526,3103,3754,38267,17259,4.91246e+13,1092.01,10469.6,55526,1363,448,51772,51609,49738,29977,34588
57067,912,2488,36280,20787,2.97321e+13,564.969,7733.87,57067,586,395,54579,54291,47404,42145,29651
35518,74,1696,22954,12564,3.00586e+13,499.182,5295.17,35518,450,305,27544,20562,20808,18725,3140
65073,3123,3754,41812,23261,2.92787e+13,575.805,10550,65073,1226,333,61319,61319,61319,61293,57198
77881,3858,4243,54308,23573,3.72339e+13,1237.44,13741.6,77881,1358,411,73638,73596,73096,72534,71712
5796,240,1365,4450,1346,7.05818e+13,169.319,2264.31,5796,406,147,4319,3992,1693,1763,972
42791,1794,2744,26612,16179,2.88944e+13,378.018,6707.33,42791,1004,178,40047,40047,39620,38815,31647
41118,3120,3353,29490,11628,5.53543e+13,1408.62,9570.86,41118,1219,342,37765,37765,37765,37765,37394
74527,16756,23220,60117,14410,2.63627e+13,6014.69,35827.3,74527,6714,87,51307,51304,47880,46716,42189
33441,5306,14227,27027,6414,2.68448e+13,3697.93,19729.8,33441,3407,13,19214,13898,621,16574,6419
97892,3686,3941,66557,31335,4.36095e+13,1314.37,13409.8,97892,1480,470,93951,93946,92688,88753,84620
74120,756,2705,47113,27007,3.07317e+13,640.826,8934.92,74120,586,425,71233,70438,59918,51854,37542
99335,4129,4180,63329,36006,2.95589e+13,872.009,13376,99335,1199,453,95155,95155,95155,95155,94767
90225,1732,2861,57855,32370,2.93754e+13,680.872,9702.49,90225,747,422,87364,87253,83567,77809,67264
7853,3422,6435,6105,1748,2.6057e+13,1.29912,6847.17,7853,1021,11,1418,1418,1418,1418,1418
61063,459,2064,39332,21731,2.94803e+13,548.478,6729.78,61063,553,323,58107,53784,49663,48140,34675
51497,2966,3134,36928,14569,4.27659e+13,1260.63,10356.4,51497,1152,339,48363,48358,48307,48170,47839
94885,2767,3420,61828,33057,3.39578e+13,843.582,10759.2,94885,765,424,91465,91446,90039,88396,78717
3324,306,1670,2660,664,459514000,3.37786,2275.18,3324,344,11,1654,1654,1308,1389,294
13505,324,1339,8542,4963,3.05288e+13,278.348,3026.38,13505,306,185,11998,11458,10295,7717,5063
22523,831,987,14536,7987,2.9993e+13,492.66,3222.86,22523,364,225,21536,21534,21130,20960,20996
78552,437,709,53285,25267,3.35727e+13,304.473,4795.17,78552,310,268,77843,77843,63091,66394,59699
72690,17452,21539,58965,13725,2.57724e+13,6245.23,34352.3,72690,6696,25,51151,51151,49448,49640,46897
46921,906,3226,29327,17594,2.98035e+13,445.766,7744.13,46921,1114,199,43695,43370,33334,27504,19172
48405,994,3114,32255,16150,3.96864e+13,667.346,8151.99,48405,860,351,45291,44743,34805,8467,8229
4285,181,609,2776,1509,2.9395e+13,143.284,1225.47,4285,158,97,3607,3458,3247,3107,2209
27932,457,1089,18001,9931,2.93496e+13,495.743,3646.38,27932,390,244,26467,24598,23266,22346,16982
50533,2048,3208,32089,18444,2.95871e+13,487.486,8259.17,50533,1181,210,47325,47322,46890,47269,32148
54894,3921,4023,39388,15506,5.80498e+13,1561.13,11730.3,54894,1552,508,50871,50871,50862,50865,50476
18826,8840,9925,15314,3512,1.86533e+13,491.901,12418,18826,2557,12,8901,8901,8901,8901,8901
32233,350,1619,20760,11473,2.96203e+13,488.186,4848.64,32233,414,281,29499,27333,25584,24714,10899
58860,3080,3781,40232,18628,4.74733e+13,1120.1,10764.6,58860,1331,451,55079,54872,52172,29605,35843
93791,1592,4455,64993,28798,3.94897e+13,1350.17,15258,93791,1454,440,88344,85346,75199,65730,37274
32782,2362,2853,23182,9600,4.93493e+13,1119.15,8049.53,32782,1042,304,29929,29445,27594,27625,27553
43132,654,3260,26709,16423,2.94619e+13,422.589,7380.82,43132,1020,190,39872,39291,27053,15958,6237
83440,1300,3850,56637,26803,4.41497e+13,1209.61,12095.9,83440,1333,464,78411,75900,59252,20463,25483
91280,3847,4022,61248,30032,4.08066e+13,1346.98,12683.3,91280,1345,456,87258,87258,87227,87243,86690
94046,1450,4028,64226,29820,4.44684e+13,1446.07,13501.6,94046,1449,472,88476,84767,66452,27102,30500
90255,4079,27244,73249,17006,2.65793e+13,5090.54,41220.9,90255,7934,116,55533,42101,39813,48234,8332
45602,1902,2656,32469,13133,3.1794e+13,841.247,8436.89,45602,924,236,42946,42936,42547,42759,39292
51272,1676,2488,32290,18982,3.07238e+13,536.812,7143.67,51272,530,361,48784,48752,44669,41936,36564
23656,1433,2013,14946,8710,2.66226e+13,300.142,4620.55,23656,684,154,21643,21643,21512,21562,16518
80250,2662,2875,50362,29888,3.07375e+13,672.756,9466.41,80250,575,452,77375,77360,76766,76924,75565
37991,1332,1617,24464,13527,2.90727e+13,523.629,4941.5,37991,472,268,36374,36368,36302,36284,35587
64354,2545,2656,39965,24389,3.04067e+13,607.23,8209.04,64354,498,399,61698,61698,61637,61610,60942
89019,2000,2965,56216,32803,3.00677e+13,712.985,9933.32,89019,637,461,86054,85842,79581,69882,72028
29442,789,3319,21523,7919,6.62461e+13,1238.61,7688.91,29442,1047,429,24489,23170,12903,11159,9171
58202,1809,2174,37426,20776,2.88816e+13,546.945,7052.46,58202,546,347,56028,56026,55386,55301,54500
98343,942,4349,63862,34481,2.95409e+13,866.532,13953.9,98343,1261,434,93536,92300,71552,49033,30512
36786,1520,1921,24118,12668,3.63407e+13,501.479,5268.07,36786,448,277,34865,34859,33748,33762,30658
34501,1118,1349,22317,12184,3.01246e+13,531.219,4283.36,34501,409,278,33152,33150,32514,32410,31623
7033,10,955,4608,2425,3.6319e+13,254.881,1967.09,7033,240,156,2392,954,754,435,125
76651,154,2797,48738,27913,3.05031e+13,656.633,9170.75,76651,614,425,66105,61281,51282,37147,11211
13451,236,894,9822,3629,3.16225e+13,200.751,2804.21,13451,310,131,12557,11430,9323,10816,4672
32061,286,1888,19421,12640,3.17296e+13,346.29,4687.22,32061,379,236,29761,28501,20930,9393,5548
98168,1006,4401,69931,28237,4.51989e+13,1636.57,16414.4,98168,1885,583,89747,84721,65344,56758,33708
61481,5055,25880,49189,12292,124608000,1018.9,37954.4,61481,6175,11,35601,30718,26592,35601,6076
39835,989,1335,25601,14234,2.9133e+13,559.419,4555.81,39835,459,283,38500,38496,37226,36938,35443
61994,2446,3681,44340,17654,4.96958e+13,1425.55,12034.2,61994,1461,395,58313,57127,51102,51632,50795
31429,12491,13724,25519,5910,2.63189e+13,2790.07,18718.4,31429,3630,13,17705,16272,17588,17502,17705
23663,637,2384,20114,3549,4.22179e+13,16.987,2965.98,23663,1195,1190,21279,21279,10826,16919,15990
53621,2295,3839,37686,15935,5.47983e+13,1147.15,10638,53621,1389,458,49782,47853,39571,25783,30776
32270,2263,2461,21465,10805,2.76622e+13,472.542,6441.7,32270,927,195,29809,29809,29776,29809,28011
87275,1543,3938,59755,27520,4.59264e+13,1289.12,12909.1,87275,1412,477,82069,79139,63396,25692,31847
54580,1396,1945,35208,19372,2.98129e+13,570.685,6096.66,54580,527,313,52635,52630,52261,52303,51190
85863,3798,4190,59320,26543,4.79153e+13,1372.76,14163.7,85863,1770,534,81673,81648,80236,71930,64926
89726,1429,4038,58907,30819,2.99288e+13,736.984,12785,89726,1255,397,85688,85064,72047,65621,38974
36577,7321,15917,29264,7313,125514000,837.11,23011.2,36577,3677,11,20660,20660,17642,20660,9056
26830,1446,1527,17233,9597,2.91127e+13,446.198,4328.55,26830,365,256,25303,25297,25283,25253,25102
80030,2386,3007,52023,28007,3.23481e+13,714.887,9164.02,80030,731,369,77023,76929,76190,75209,68743
28666,10,460,19405,9261,3.3464e+13,292.837,2796.92,28666,281,194,4498,1525,1275,413,214
85986,829,3952,58869,27117,4.58439e+13,1247.21,12773.3,85986,1397,475,79085,76939,54940,16824,13788
10829,420,1293,7804,3025,2.89756e+13,331.305,3160.4,10829,425,139,9370,8897,5955,5735,2451
77375,2633,3896,52667,24708,4.60551e+13,1184.85,12058.3,77375,1400,462,73479,72384,64534,30235,43990
81301,4072,4336,55442,25859,3.48671e+13,1119.44,13623.9,81301,1234,396,76965,76953,76942,76423,76344
99083,1077,3580,62428,36655,2.9571e+13,947.649,11655.8,99083,815,451,95239,94648,80987,62306,51254
43654,3647,3737,31687,11967,6.1965e+13,1474.25,10022.7,43654,1230,457,39917,39917,39840,39726,39464
75766,2959,3960,51029,24737,3.17473e+13,962.826,12457.3,75766,1187,305,71806,71526,71766,71192,64226
97525,4020,4181,62433,35092,2.98176e+13,836.493,13437.5,97525,1258,434,93344,93344,93344,93344,91991
43797,1680,1998,28138,15659,2.9084e+13,610.031,6225.23,43797,523,320,41799,41798,41276,41278,40914
31397,463,2134,22815,8582,2.87615e+13,493.91,6141,31397,539,208,28897,28125,17972,17095,8442
98422,3789,4116,62487,35935,2.93239e+13,928.161,12881.5,98422,1088,460,94306,94306,94306,94306,93655
4812,376,1486,3404,1408,7.10373e+13,124.673,2265.79,4812,325,122,3326,3210,2424,2558,1420
90610,1772,2875,58200,32410,2.94588e+13,687.577,9656.24,90610,701,433,87735,87631,84341,79216,69660
32995,501,3399,24266,8729,6.49685e+13,1411.31,8367.07,32995,1048,395,26379,24807,11975,10303,5241
22567,377,2658,15787,6780,5.9484e+13,900.805,6325.22,22567,951,231,18197,16842,11312,10893,4206
21985,189,1556,15942,6043,2.86421e+13,611.507,4723.09,21985,512,199,18569,13609,10103,2562,3596
55304,17365,25608,44353,10951,2.17967e+13,161.121,29238.2,55304,2664,162,29696,29696,29694,29352,28960
82878,1954,3533,51875,31003,2.98951e+13,885.472,10613.9,82878,728,453,79345,78904,72123,69651,57290
41356,425,1796,27063,14293,3.43496e+13,536.718,5312.29,41356,455,279,38579,35742,31983,4522,4458
92368,4025,4420,63034,29334,3.65432e+13,1303.83,14873.1,92368,1442,420,87948,87913,87273,86719,85987
91509,3345,4402,65368,26141,4.73771e+13,1691.78,15940,91509,1878,570,87107,86635,81771,74810,76565
62780,3261,3926,44263,18517,3.41087e+13,1060.01,11840.5,62780,1049,381,58854,58772,57270,57785,55474
61504,1227,4030,44202,17302,5.50209e+13,1485.34,12437.5,61504,1533,529,55104,51329,38189,34939,26814
73086,3750,3817,48737,24349,3.00187e+13,841.708,11265.3,73086,1176,283,69269,69269,69269,69269,69193
7442,617,922,4828,2614,3.07883e+13,267.16,1969.86,7442,229,150,6520,6385,6152,6108,5364
94681,4409,4538,65917,28764,4.06682e+13,1542.82,15651.5,94681,1580,451,90143,90143,90143,90143,89517
49740,298,2020,32032,17708,2.93809e+13,552.597,6492.83,49740,488,324,45089,41563,38819,35794,17900
23814,1848,3334,16830,6984,6.11408e+13,673.44,6955.56,23814,877,402,20480,19838,14548,11464,13012
5114,245,862,3780,1334,9.19909e+13,246.805,1536.67,5114,91,224,4102,3509,1487,2232,1699
20741,2289,3085,15273,5468,6.35029e+13,1080.75,6415.73,20741,782,353,17656,16635,14706,15510,14793
83974,1678,3671,55243,28731,3.59604e+13,1047.05,11132,83974,922,377,80303,79239,65911,13964,19594
11205,1532,1571,7695,3510,2.1233e+13,320.09,3320.03,11205,530,144,9634,9634,9634,9634,9628
65591,1939,3565,46800,18791,3.91737e+13,1176.89,12035.6,65591,1289,368,62026,60350,56614,54653,45987
25527,247,2757,17946,7581,5.70364e+13,1163.4,6915.53,25527,1003,287,19467,17520,11785,9286,2382
73003,2146,4140,50803,22200,5.22416e+13,1366.86,13125.7,73003,1767,465,68737,64851,52544,36744,39545
95436,1930,2959,60530,34906,2.95819e+13,706.879,10146.3,95436,674,456,92477,92253,87277,76748,75508
57040,994,3551,40658,16382,4.221e+13,1114.8,11256.2,57040,1200,365,52152,49139,40762,41604,23892
75718,1904,2667,49048,26670,3.15958e+13,704.013,8612.05,75718,689,372,73051,72926,71474,70276,63497
19212,1137,1425,12342,6870,2.99754e+13,405.429,3752.64,19212,354,247,17787,17760,17310,16878,14086
9097,346,2080,6821,2276,8.06272e+13,285.175,3311.05,9097,367,290,6881,6051,1864,1657,592
63558,2408,4056,45726,17832,5.47952e+13,1462.39,12682.5,63558,1547,530,59502,57090,47952,48333,47556
75275,2445,3901,53913,21362,4.74146e+13,1716.27,13675.8,75275,1560,488,71108,69676,59712,61515,53763
15825,695,1275,11389,4436,2.79396e+13,599.734,3821.55,15825,544,143,14356,13512,11895,10950,10510
64117,1892,2304,41253,22864,2.92944e+13,576.929,7490.36,64117,642,340,61813,61813,61115,60844,59749
50986,762,2137,31497,19489,3.12408e+13,522.528,6381.95,50986,441,328,48799,48235,39614,25694,26684
7441,531,739,4710,2731,2.67062e+13,314.567,1733.58,7441,292,146,6702,6443,6393,6189,5754
69084,379,2688,44290,24794,2.9829e+13,634.281,8564.84,69084,676,407,64095,59557,53539,48349,19222
98604,1155,4270,68986,29618,4.59398e+13,1332.61,15694.2,98604,1775,550,91389,87230,69095,43089,35515
2268,38,317,1329,939,3.23755e+13,93.3267,569.444,2268,69,55,1813,1705,1128,670,322
68645,2297,2956,44879,23766,3.55663e+13,569.579,8188.41,68645,587,339,65689,65681,65073,65312,62994
34234,1311,2539,21684,12550,2.84046e+13,345.806,6128.88,34234,942,175,31695,31690,30487,29641,21212
27901,219,2254,19386,8515,3.62413e+13,728.131,6494.96,27901,699,207,22993,20376,16537,16160,6357
56040,3438,3446,40141,15899,3.75396e+13,973.874,10819,56040,1018,348,52594,52594,52594,52594,52593
34207,1707,3671,24414,9793,5.99681e+13,1181.52,8752.56,34207,1190,429,30227,28260,19513,17692,17242
42683,1050,2691,29591,13092,2.85491e+13,561.749,7610.18,42683,904,263,39992,39141,32155,26817,12034
11610,238,789,7505,4105,3.02078e+13,397.481,2189.68,11610,288,167,10213,9540,8884,8409,5147
16075,45,1802,9857,6218,2.79115e+13,263.542,3463.74,16075,412,121,11747,9993,6674,2481,1481
94674,2049,4318,61374,33300,2.9376e+13,821.094,13641.3,94674,1252,435,90356,90035,83889,83005,56101
83632,3833,4191,60206,23426,4.88676e+13,1751.48,14863.9,83632,1710,574,79441,79361,79356,78292,78587
21619,144,424,14622,6997,3.33848e+13,293.007,2417.91,21619,271,179,17629,11028,11596,10713,9483
87359,2133,2919,55505,31854,3.01758e+13,692.335,9797.34,87359,648,454,84440,84261,79985,78247,72721
87422,3964,3965,57887,29535,3.82429e+13,1168.12,11878.6,87422,1052,442,83457,83457,83457,83453,83457
98339,3561,4109,62507,35832,2.90925e+13,856.967,13103.9,98339,1201,454,94230,94230,94230,94230,91587
13838,763,857,8956,4882,3.05109e+13,439.363,2477.17,13838,316,183,12981,12981,12882,12921,12809
18084,1787,2747,13015,5069,6.07029e+13,760.178,5587.27,18084,801,195,15337,14644,11981,13065,11779
69041,1326,2660,43548,25493,3.03051e+13,621.237,8574.81,69041,557,406,66381,66232,59065,47334,41044
60330,3463,3693,39100,21230,2.92258e+13,583.741,9909.11,60330,1198,264,56637,56637,56637,56637,55192
8671,305,760,5604,3067,3.09362e+13,384.467,1931.09,8671,286,156,7637,7013,6573,6474,3563
21563,1352,1487,15521,6042,2.61275e+13,628.185,4600.89,21563,742,183,20076,20026,19997,20020,19449
80835,1408,3996,53950,26885,3.18999e+13,967.608,12655,80835,1285,302,76710,75067,68343,59617,34985
41194,713,1333,26591,14603,2.94669e+13,541.272,4608.79,41194,448,288,39861,39684,36154,35504,33393
31126,1952,3023,22583,8543,6.14018e+13,1320.32,7694.72,31126,1017,273,27926,25692,21867,22811,22607
18273,715,890,11773,6500,2.88205e+13,445.098,2808.19,18273,358,195,17383,17363,16993,16883,16825
86427,919,4034,54612,31815,2.93146e+13,839.8,11969.2,86427,1033,442,82076,81399,66222,47865,34852
59266,644,2433,37871,21395,2.95321e+13,584.493,7747.44,59266,594,389,56620,55605,48661,44960,29421
44994,3346,3370,32254,12740,5.32331e+13,1412.55,10017.3,44994,1268,339,41624,41624,41624,41624,41596
31051,1514,1788,22473,8578,3.09894e+13,542.408,5685.65,31051,557,213,29263,29243,28798,29035,26528
59211,2634,3659,41360,17851,3.17672e+13,931.271,11025.7,59211,1012,299,55552,55491,55486,54984,48431
26148,673,1077,16845,9303,2.94519e+13,519.932,3539.69,26148,413,237,25071,24740,23464,22277,21070
20062,1040,1053,12946,7116,2.99959e+13,465.203,3149.01,20062,349,217,19009,19009,19009,18999,18997
73652,1978,6793,52424,21228,1.72056e+13,270.752,11764.4,73652,1694,1983,66859,66705,62460,45710,43836
93211,4229,4519,65101,28110,4.09671e+13,1568.12,15555.3,93211,1574,456,88692,88687,88624,87819,86754
79071,3582,4019,52757,26314,3.19353e+13,960.503,12512.3,79071,1249,303,75052,74933,75052,75052,72420
48808,583,2222,32093,16715,3.7164e+13,554.6,6325.59,48808,500,303,46413,44406,38105,7155,6497
74815,572,3802,49075,25740,2.96539e+13,668.207,11327.5,74815,1231,338,70050,67204,47105,28509,13273
14956,104,391,10133,4823,3.34023e+13,278.89,1990.93,14956,247,149,10469,5358,6766,7043,7204
62999,1220,3738,43532,19467,3.15987e+13,931.446,11402.8,62999,1030,302,59129,57358,48311,44446,19867
8412,867,1000,6023,2389,3.02036e+13,352.736,2523.8,8412,421,106,7412,7412,7354,7402,6488
74493,2391,2775,46264,28229,3.04347e+13,642.88,8930.89,74493,514,422,71718,71667,68870,69914,66774
30451,336,1814,18275,12176,3.13546e+13,319.208,4412.56,30451,390,217,28504,27671,20039,7424,5836
98204,3435,4071,62634,35570,2.93062e+13,847.584,13159,98204,1195,446,94133,94031,94133,94126,90232
88070,2170,4010,57787,30283,2.98173e+13,732.447,12670.1,88070,1253,394,84060,83829,82559,83457,53559
31578,151,2159,18936,12642,2.98299e+13,314.59,4642.14,31578,615,158,27490,24156,18348,9040,8276
90275,3161,4084,60729,29546,4.16724e+13,1377.53,12908.6,90275,1388,468,86191,85800,82120,36290,51995
94608,360,4052,63192,31416,3.93216e+13,1310.98,12802.2,94608,1132,458,84656,77648,63648,9787,7581
69370,723,3244,45926,23444,2.96779e+13,730.39,9870.64,69370,1194,284,65474,64093,48701,32644,26406
98025,1730,3727,64389,33636,3.49549e+13,1191.78,11910.1,98025,896,398,94298,93125,79281,14521,22351
9816,368,1121,7090,2726,2.25169e+13,366.484,2760.41,9816,572,109,8262,7311,4963,4237,4203
70644,1382,2339,45466,25178,2.93767e+13,591.285,7895.28,70644,610,372,68305,68286,65431,64230,53206
78170,3236,3481,48665,29505,3.04243e+13,723.52,9924.33,78170,648,436,74689,74689,74689,74689,74513
37306,1037,2260,26999,10307,2.80775e+13,663.39,6905.76,37306,649,229,35046,34048,31932,32844,21863
63308,1473,2211,40814,22494,2.99177e+13,573.822,7458.63,63308,569,375,61097,61087,58874,57191,47365
91252,3640,4316,58554,32698,2.91472e+13,755.158,13187.5,91252,1253,402,86936,86926,86936,86924,82351
82645,1661,2635,53225,29420,2.93445e+13,656.81,8901.17,82645,665,407,80010,79940,76421,74982,62847
34971,1211,1847,21700,13271,3.08995e+13,421.229,5147.4,34971,375,281,33124,33117,29506,29856,23411
64733,699,4178,46210,18523,5.43738e+13,1459.47,13038.5,64733,1659,523,55602,52939,35217,27920,16291
16504,41,1652,14053,2451,4.17978e+13,17.1875,2144.56,16504,829,824,14852,14852,5209,10830,9435
39539,312,1925,23891,15648,3.14495e+13,393.391,5194.63,39539,455,264,37179,35728,26712,11921,7631
49817,19737,21214,39857,9960,123019000,956.89,30955.7,49817,5004,11,28603,28603,28236,28603,26761
4835,511,1973,3916,919,1.73624e+12,79.2771,2335.72,4835,440,60,2862,2858,856,2698,888
10414,1505,2120,7661,2753,7.44056e+13,216.288,3725.83,10414,416,147,8294,8290,7999,8278,6570
87650,2070,4121,60238,27412,4.78082e+13,1307.62,13604.2,87650,1638,474,83225,79076,63802,34494,40827
60148,286,3639,41485,18663,3.07182e+13,810.098,10687.6,60148,1039,285,52206,48707,33136,16830,6689
42918,535,2743,27272,15646,2.97064e+13,403.078,7133.28,42918,1086,196,39692,37379,29794,23219,18409
16291,167,405,11077,5214,3.38888e+13,289.553,2095.26,16291,256,164,14202,9518,9546,8284,8519
4792,79,436,2808,1984,3.20839e+13,158.764,921.514,4792,103,86,4032,3686,2887,1497,740
68047,3195,4223,48088,19959,5.29452e+13,1443.68,13267.6,68047,1755,527,63824,63678,59117,50188,52722
6129,181,1120,4091,2038,5.66533e+13,341.653,2138.43,6129,419,67,4666,4409,3203,3741,976
77800,728,3737,55599,22201,4.4093e+13,1548.97,13605.4,77800,1574,408,69297,66212,45274,43614,19604
41411,189,1714,26950,14461,3.23606e+13,505.234,5188.86,41411,528,300,35951,33482,29312,3654,2343
85511,2981,4388,59455,26056,3.84317e+13,1329.9,14587.8,85511,1417,428,81123,80816,74930,73486,66294
32550,1257,3653,23350,9200,6.04829e+13,1153.1,8567.42,32550,1157,416,28163,26370,16728,13799,12782
77446,2541,3845,50773,26673,2.97405e+13,683.05,11619.4,77446,1236,353,73601,73397,72825,73233,50668
47058,3133,3371,33758,13300,4.09112e+13,928.596,9951.86,47058,890,340,43687,43687,43503,43183,43090
99140,902,3614,62652,36488,2.96067e+13,1005.64,11976.4,99140,971,466,94937,94301,78194,59498,45912
75512,1169,2769,47053,28459,3.03023e+13,662.857,9018.97,75512,559,437,72743,72405,61045,44141,37153
7458,830,1040,4829,2629,2.96267e+13,228.812,2128.18,7458,249,163,6418,6378,6234,6159,5264
19499,1069,8593,16148,3351,2.808e+13,417.132,11686.4,19499,2036,12,10906,10147,0,6476,697
39356,479,3635,27175,12181,5.23147e+13,695.987,8616.18,39356,959,420,34423,32368,22793,8224,6542
71667,3534,3920,49689,21978,4.89042e+13,1284.56,12182.8,71667,1417,470,67747,67626,66347,61240,53419
89774,3341,4189,61479,28295,4.64518e+13,1363.39,14208.6,89774,1766,522,85585,85331,80552,49725,59928
19137,1947,2187,12987,6150,3.8631e+13,787.95,5354.62,19137,694,196,16950,16950,16896,16928,15349
16962,6916,11350,13425,3537,2.17758e+13,555.735,12892.5,16962,2240,15,5612,5005,5569,5582,5577
63991,1778,3507,46029,17962,4.72838e+13,1514.8,12026.6,63991,1448,373,59760,56002,49637,46644,40429
92901,187,3630,61167,31734,3.54833e+13,1143.49,11620,92901,912,380,79243,72962,60807,7647,4234
32853,44,1845,21601,11252,3.66471e+13,492.778,4973.15,32853,428,257,21536,13700,14494,2208,991
8605,58,1313,6037,2568,1.86392e+13,365.247,2750.17,8605,495,128,4227,2100,1819,696,356
42823,1240,2392,25922,16901,3.14407e+13,460.818,5961.03,42823,585,283,40431,40251,34428,32995,27272
18199,543,1814,13026,5173,2.82308e+13,435.983,4443.94,18199,542,148,16112,15830,14497,15164,9572
12640,94,1297,8146,4494,2.95835e+13,309.323,2961.95,12640,306,209,10202,8917,7762,6671,852
71603,2515,3672,48505,23098,4.3097e+13,1094.69,11087.2,71603,1245,426,67931,66687,57690,24981,38299
20077,528,1085,12993,7084,3.02398e+13,438.493,3133.49,20077,316,203,18941,18435,17602,17207,15993
52647,5221,5282,44749,7898,4.22197e+13,16.9936,6158.46,52647,2644,2639,47365,47365,47027,47219,47204
6176,97,502,3605,2571,3.20907e+13,170.883,1097.9,6176,115,100,5357,4877,3935,2626,1857
87892,2118,4176,60540,27352,4.7925e+13,1359.97,14070.5,87892,1789,507,83533,79398,64171,38684,43817
93618,3167,3231,60967,32651,3.34253e+13,765.468,10332.1,93618,738,404,90387,90387,90345,90272,90255
86603,2419,2688,55985,30618,2.95908e+13,605.419,9069.23,86603,687,395,83915,83912,83659,83647,83215
64238,134,2216,41349,22889,2.89851e+13,565.733,7350.39,64238,613,345,54119,50706,43620,36292,12488
27225,165,443,18413,8812,3.33268e+13,294.038,2714.77,27225,278,193,23743,15626,16004,13758,16834
94810,1115,3321,61677,33133,3.30704e+13,828.981,10551.8,94810,718,414,91489,91084,77949,25760,19472
25173,1899,2199,16802,8371,2.69414e+13,406.864,5454.04,25173,834,186,22974,22974,22810,22967,21102
89077,3802,4536,59596,29481,3.27477e+13,1165.03,14126.9,89077,1359,381,84541,84491,84415,84134,80413
79707,2106,22500,65020,14687,2.71928e+13,5791.68,35895.7,79707,7793,22,45083,34862,24021,21039,5263
61053,1190,3744,39317,21736,2.92798e+13,546.085,10042.7,61053,1221,283,57309,56855,45896,39640,23535
11525,1683,2424,8546,2979,7.19097e+13,334.785,4203.51,11525,532,156,9101,9101,8688,9074,6794
89041,2293,4267,62115,26926,4.75091e+13,1347.87,14934.5,89041,1799,536,84701,81285,67345,49351,52222
87781,3333,4314,59111,28670,3.42542e+13,1109.63,13841.7,87781,1320,392,83467,83219,81052,80650,76348
62806,1925,3514,41177,21629,2.95807e+13,653.736,9781.6,62806,1188,272,59292,59132,57833,58823,33752
4631,223,408,2708,1923,3.24994e+13,148.895,872.382,4631,99,80,4223,3998,3660,3932,2866
40785,1355,3626,28557,12228,5.24143e+13,1020.77,9078.06,40785,1078,406,36524,34894,24183,13252,13175
54833,8655,21667,44533,10300,1.70259e+12,95.8373,23101.2,54833,1148,152,33166,33161,14014,19445,15378
68503,1782,2658,43824,24679,3.0067e+13,573.085,8472.08,68503,595,418,65845,65824,62799,58922,58051
17093,344,847,11046,6047,2.99371e+13,446.425,2677.5,17093,336,207,15686,14547,13932,13256,8924
31614,616,1707,20325,11289,2.93993e+13,509.478,5095.23,31614,422,292,29872,29256,26342,26020,18375
60995,1944,3752,42104,18891,3.13646e+13,864.143,11024,60995,1045,288,57243,57081,55180,56281,37723
9192,599,680,6667,2525,3.22428e+13,194.807,2071.79,9192,253,111,8512,8512,8425,8490,7969
62789,2018,3854,44100,18689,5.3217e+13,1298.31,11717.4,62789,1484,461,58689,54893,44934,31310,34612
91055,2682,4036,61062,29993,4.01499e+13,1358.9,12654,91055,1213,442,87019,85894,77493,27336,46725
90793,12432,24125,74482,16311,2.62681e+13,5376.43,39238.6,90793,8525,26,66668,56248,57627,53827,44578
49988,789,1999,32222,17766,2.95699e+13,555.881,6511.94,49988,496,355,47989,47352,42791,42455,27874
5079,997,1084,3676,1403,2.69117e+13,182.846,1903.92,5079,346,82,3995,3995,3969,3994,3882
20071,678,1422,12895,7176,2.99692e+13,432.186,3743.57,20071,350,232,18649,18546,17647,17220,15506
12937,431,771,8349,4588,2.91325e+13,383.544,2256.66,12937,278,177,12017,11300,11053,10544,9188
25066,995,1026,16072,8994,2.89209e+13,523.797,3416.61,25066,389,236,24040,24035,24005,24012,24021
50686,305,3773,35759,14927,5.68553e+13,1138.56,10418.7,50686,1312,457,41978,38012,24689,10041,6369
46693,67,3449,31275,15418,4.22689e+13,737.26,8667.96,46693,948,405,32815,23593,21179,4058,1440
29921,294,1651,17516,12405,3.21811e+13,320.575,3585.45,29921,516,164,28103,27194,19864,14019,12934
22373,1354,1459,14360,8013,2.98589e+13,494.221,3919.47,22373,377,237,20914,20912,20869,20902,20532
92624,4158,4330,60026,32598,2.9965e+13,821.313,13518.3,92624,1259,420,88294,88285,88294,88294,87453
82535,2315,3728,55372,27163,4.04252e+13,1116.93,11222.8,82535,1093,438,78807,77351,65527,19622,35069
29750,348,1992,21603,8147,2.96059e+13,494.87,5717.88,29750,522,206,27184,26532,16377,14212,7494
39474,1267,1691,25827,13647,3.34241e+13,552.788,5063.03,39474,510,285,37783,37779,36430,35186,33730
47431,99,3822,33917,13514,5.81579e+13,1305.86,10410,47431,1308,458,33793,25419,16666,10197,2069
85533,3839,3967,56820,28713,3.89723e+13,1192.28,11703.6,85533,1056,435,81566,81566,81527,81493,80506
28982,1952,2300,19420,9562,2.76064e+13,487.571,6014.72,28982,890,194,26682,26682,26475,26675,23716
89629,1227,3185,58362,31267,3.35846e+13,730.296,10007.7,89629,673,394,86444,86180,74487,59228,25420
45702,1854,3344,28429,17273,2.93694e+13,429.652,7817.53,45702,1032,233,42358,42355,42008,42334,33106
95182,3140,4183,60778,34404,2.94012e+13,827.658,13165,95182,1195,440,90999,90868,90991,90960,79137
49221,385,3622,34084,15137,4.88838e+13,1065.78,9732.25,49221,1121,418,42219,38480,26392,7234,4879
73322,1013,4199,52099,21223,5.13699e+13,1391.57,13867.3,73322,1694,536,65772,61893,45790,34964,25755
58628,26,2081,37742,20886,2.92694e+13,581.085,6506.1,58628,582,323,31324,16457,19559,6416,2815
50629,1854,3885,36216,14413,6.19715e+13,1543.11,10993.4,50629,1519,456,46232,42272,31187,30565,31888
25430,2041,11998,20782,4648,2.7321e+13,1101.1,15702.2,25430,2487,12,13410,11375,0,6476,1530
39916,192,2409,24022,15894,3.15304e+13,446.271,5670.58,39916,591,260,36127,32533,25088,9567,6350
94421,1703,4101,63550,30871,4.19232e+13,1385.21,13289.7,94421,1381,479,89727,86782,70816,24312,34763
63634,893,2260,41030,22604,2.97048e+13,564.446,6996.93,63634,577,349,61374,61233,54344,55427,45332
20155,626,950,12951,7204,3.02208e+13,503.863,3028.71,20155,439,205,19202,18651,18113,17311,16619
26952,2256,3114,18487,8465,5.00336e+13,532.786,6865.65,26952,835,348,23838,23775,21415,12872,13285
12080,784,944,7769,4311,2.93825e+13,347.015,2428.14,12080,315,166,11136,11109,11037,11093,11006
23290,176,424,15792,7498,3.35165e+13,288.495,2497.5,23290,267,186,20976,14669,14353,12084,14655
78640,2974,3925,56676,21964,4.88986e+13,1709.55,13992.4,78640,1564,546,74715,74270,65686,66237,65591
92601,279,4616,61370,31231,3.18723e+13,1029.72,14652,92601,1349,387,82205,76627,53132,21200,8673
15330,509,2792,10900,4430,5.95418e+13,351.166,5110.81,15330,663,309,12490,11887,6332,2722,1805
47104,2408,2871,33391,13713,3.24355e+13,855.739,8904.6,47104,924,237,44233,44233,44216,44230,42455
57939,351,3061,37890,20049,2.94979e+13,577.412,8776.77,57939,1149,260,52834,50150,34527,19093,16868
16410,536,1290,10470,5940,2.98076e+13,314.752,3201.57,16410,327,195,15120,15020,14219,13117,11530
59866,7446,34766,46079,13787,2.1903e+13,299.601,36820.5,59866,34456,104,25100,25100,7733,5896,18638
30672,1882,3607,21998,8674,6.03857e+13,932.002,8105.96,30672,969,422,27024,25786,19537,15009,15551
52288,2071,3882,36916,15372,5.60931e+13,1158.96,10672.7,52288,1360,459,48196,45643,37490,24659,29142
86871,1443,4273,60363,26508,4.80988e+13,1370.84,14572,86871,1801,543,80805,76504,59951,35068,32153
48558,1363,2928,33336,15222,2.88884e+13,538.322,8244.84,48558,940,265,45630,45352,41504,37143,17947
86046,341,3879,56461,29585,3.55851e+13,1085.06,11459.3,86046,958,373,77492,70748,60396,6726,4532
23086,2310,2757,16273,6813,5.60745e+13,1076.68,6661.09,23086,899,282,20329,20091,18969,19041,19110
66381,227,3615,47822,18559,4.30953e+13,1245.3,12349.3,66381,1320,373,54789,48951,30772,15612,6841
87593,2320,2877,55425,32168,2.97801e+13,683.631,9733.53,87593,623,434,84716,84546,81285,81982,75397
42061,415,3605,29390,12671,5.22636e+13,1054.88,9299.62,42061,1135,424,35749,32894,21243,8192,5747
66144,1948,3813,45369,20775,3.1636e+13,938.793,11709.4,66144,1063,303,62331,62090,59994,60438,40684
8477,1916,1920,6681,1796,7.22476e+13,195.009,3146.8,8477,396,165,6557,6557,6557,6557,6557
61272,3658,4074,43516,17756,5.56615e+13,1509.59,12506.7,61272,1638,520,57198,57184,56655,50941,51541
16973,585,2965,12577,4396,6.38695e+13,928.819,5772.25,16973,732,275,13114,12572,5789,5152,2523
1542,287,429,1175,367,1.66214e+13,107.246,742.938,1542,189,58,1113,1103,954,1028,855
90126,3153,4262,63811,26315,4.70325e+13,1543.96,15390.9,90126,1756,563,85864,85468,79707,66588,69288
99435,362,4623,65730,33705,3.08844e+13,1007.08,14908.8,99435,1370,412,90196,85318,60214,32671,14172
25247,245,1553,16141,9106,2.92428e+13,432.804,4371.18,25247,414,263,22382,20686,19071,17498,8078
75619,3315,3994,48399,27220,2.96173e+13,659.706,11631.7,75619,1235,378,71625,71625,71625,71619,66766
93526,2269,4230,64771,28755,4.64614e+13,1351.43,15009.1,93526,1792,539,89218,85696,71224,47186,51377
78975,866,4066,52223,26752,2.94707e+13,792.42,12014.3,78975,1239,346,74359,73260,52339,38227,13523
12664,1087,1617,8549,4115,2.26299e+13,306.793,3493.71,12664,543,155,11047,11047,10934,11040,8474
44505,1783,3663,30850,13655,5.13217e+13,860.615,9121.04,44505,995,426,40842,39692,31111,14944,18041
9456,121,1238,5934,3522,3.07569e+13,183.021,2497.95,9456,259,160,7847,7284,6090,3373,1832
32661,10959,14351,26131,6530,140656000,784.003,20661.9,32661,3285,11,18310,18310,17462,18310,14080
77523,3139,3831,55721,21802,4.46134e+13,1617.32,13721.9,77523,1619,397,73692,73457,69894,68958,68057
41036,419,2732,26767,14269,2.82869e+13,465.615,7274.84,41036,1026,214,37023,34557,25601,17314,12850
54228,523,2999,36537,17691,2.91827e+13,565.01,8683.43,54228,1030,268,50156,47636,34283,21755,13951
97148,2465,4290,66747,30401,4.56702e+13,1358.62,15065.6,97148,1848,552,92858,91018,78051,46592,53895
68288,203,2298,44095,24193,2.98832e+13,602.267,7697.46,68288,648,352,59952,55948,50261,44004,17869
83777,137,728,56822,26955,3.35679e+13,303.473,4955.29,83777,311,270,67229,41228,43159,18376,34825
77638,3592,4232,55848,21790,5.01782e+13,1696.06,14346.8,77638,1605,568,73406,73333,71593,70117,70364
87173,2308,3973,57540,29633,3.73254e+13,1104.61,11718.6,87173,1065,428,83200,82285,70234,18123,26958
75794,2655,3560,47531,28263,2.93715e+13,768.649,10454.4,75794,959,409,72234,72151,72186,72227,67456
49077,377,2114,29967,19110,3.09006e+13,495.803,6157.56,49077,485,307,46279,44453,34720,18681,14171
35287,701,3545,29995,5292,4.2209e+13,16.991,4259.48,35287,1776,1771,31742,31742,14700,24638,23229
34531,1357,1423,22335,12196,3.06323e+13,524.077,4425.71,34531,437,272,33108,33108,33043,33042,32981
62534,509,2634,38949,23585,3.05582e+13,609.924,8081.58,62534,500,405,59277,57419,45749,32823,16603
98584,1640,4171,66577,32007,4.26338e+13,1374.3,13702.8,98584,1377,484,93692,90707,74336,23806,35939
44552,12,538,30226,14326,3.37022e+13,299.291,3530.47,44552,296,239,8000,2440,2333,879,938
63201,3605,3666,42361,20840,4.2471e+13,894.309,9996.17,63201,1027,420,59535,59479,59441,59426,58834
20698,788,2482,14909,5789,5.50839e+13,1095.9,5846.27,20698,846,212,17285,16543,10726,10590,8676
26665,1074,1587,17142,9523,2.91237e+13,522.102,4516.67,26665,453,267,25078,25051,24029,23092,19839
26649,377,1501,17230,9419,3.02596e+13,538.147,4165.55,26649,386,246,24384,22650,21537,19860,13007
7994,390,683,5144,2850,2.85908e+13,272.591,1694.58,7994,229,156,7242,6909,6691,6606,4982
92867,661,4521,64998,27869,4.10978e+13,1557.72,15527,92867,1582,450,82894,79243,52387,31237,15717
53600,722,3761,36996,16604,4.96532e+13,1115.78,10377.6,53600,1342,457,47812,46196,31751,11882,11629
90359,1746,3609,56828,33531,2.95276e+13,930.535,11486.3,90359,962,444,86750,86150,77712,60729,61169
82122,1998,2826,51581,30541,3.04519e+13,687.002,9533.72,82122,623,445,79296,79087,73511,67867,63757
51743,1399,1983,33408,18335,2.981e+13,524.459,6400.43,51743,548,327,49760,49753,48956,48122,42229
80846,469,4275,53755,27091,3.14895e+13,988.494,12796.5,80846,1313,302,73572,69861,46213,32802,7908
98821,2533,4612,65301,33520,3.07462e+13,1016.44,14874,98821,1364,414,94209,93779,92520,93518,58301
27061,1410,3454,19703,7358,6.36751e+13,1108.07,7613.12,27061,906,415,23115,21570,13339,13096,11180
77377,735,3889,51050,26327,3.71367e+13,1073.57,10959.3,77377,994,424,72513,71519,55889,9477,7777
93776,2746,2850,59529,34247,3.01878e+13,707.72,10015.6,93776,647,450,90926,90926,90878,90875,89972
86246,3824,3995,57691,28555,4.02051e+13,1295.36,12036,86246,1134,429,82251,82251,82213,82240,81372
66304,1161,4087,46403,19901,5.27226e+13,1303.35,12296.5,66304,1535,465,60070,57111,40160,24198,20547
30432,484,3253,22357,8075,6.76653e+13,1215.24,7653.06,30432,1005,431,24707,23269,11752,9866,8849
3007,435,1096,1907,1100,5.16696e+13,115.069,1591.79,3007,332,98,1911,1818,1332,1666,690
57600,1981,3064,38181,19419,2.95096e+13,593.897,8872.22,57600,1105,265,54536,54424,53254,48973,41130
56902,1820,2521,35562,21340,3.05789e+13,585.392,7596.93,56902,499,375,54381,54300,49764,50781,42562
52443,3134,3500,33210,19233,2.9921e+13,474.874,8903.68,52443,1169,239,48943,48943,48943,48943,46286
72573,2652,3730,51905,20668,4.61316e+13,1572.36,13130,72573,1570,395,68843,68386,59954,62354,55442
40929,2588,3571,29598,11331,6.03432e+13,1475.01,9412.21,40929,1207,391,37358,36603,33805,34116,34000
82400,1300,4158,56794,25606,4.9172e+13,1334.96,13650.5,82400,1794,470,76194,72670,55169,27407,25505
99511,853,4094,63524,35987,2.96381e+13,886.94,13270.7,99511,1189,443,94959,93923,75912,56067,41054
52512,228,2992,34686,17826,2.90291e+13,505.409,8422.58,52512,1070,258,46395,42397,28845,11889,9366
78202,3694,4333,54019,24183,3.65181e+13,1193.19,13683.7,78202,1196,410,73869,73763,71800,72124,70384
87899,269,4355,62652,25247,4.74013e+13,1586.22,15437.9,87899,1757,564,73038,66740,41924,20031,8611
23053,1348,12629,20196,2857,8.58969e+11,14.7946,12942.6,23053,1117,50,10424,10424,2387,3287,1626
97751,1233,4568,67395,30356,4.01185e+13,1516.73,15796.1,97751,1511,456,90808,87277,68437,57120,29809
73064,957,3821,47875,25189,2.96266e+13,662.203,11260.8,73064,1222,347,68983,68017,50441,38584,17921
95389,3048,4199,64944,30445,4.43761e+13,1431.14,13722,95389,1440,479,91190,90658,84701,40099,57697
28353,653,3152,20912,7441,6.59364e+13,1259.15,7487.23,28353,1037,286,23222,22226,13654,11885,9486
48383,1956,2115,29759,18624,3.09611e+13,502.778,6187.76,48383,435,320,46268,46220,45886,45978,45152
1333,216,411,1039,294,9.26902e+13,75.3181,650.086,1333,55,78,922,895,714,758,633
99218,3462,4306,68860,30358,4.56987e+13,1339.99,15579.3,99218,1839,544,94912,94686,90541,63373,72639
38724,1064,1719,24897,13827,2.87075e+13,490.88,5389.68,38724,450,299,37005,36957,35887,35604,30800
31923,12179,13848,25889,6034,2.64509e+13,3030.3,18967.2,31923,3845,13,18075,16395,17790,17655,18075
5062,85,1642,3823,1239,4.75428e+13,141.612,2546.87,5062,434,117,2932,2096,1388,954,346
97434,485,3605,61349,36085,2.97176e+13,1020.37,11665.4,97434,748,467,91861,86894,71273,54496,30056
72427,1740,3850,45446,26981,2.92386e+13,664.231,10574,72427,1021,397,68577,68351,61264,59152,43894
94564,2611,4253,65260,29304,4.64019e+13,1373.11,14956.1,94564,1802,533,90311,88982,78119,48995,56799
34949,327,3030,25428,9521,5.88933e+13,1529.64,8195.5,34949,1161,287,27116,24388,13027,10913,5456
50227,540,1713,32601,17626,3.19231e+13,574.965,5611.27,50227,513,315,48190,45364,40479,29598,9373
35982,1499,2594,22704,13278,2.90148e+13,355.411,6289.64,35982,982,178,33388,33388,32886,31427,23307
64021,2086,2609,39674,24347,3.05333e+13,611.875,8024.48,64021,499,395,61412,61364,57186,58771,53614
97179,4144,4384,63004,34175,2.95082e+13,821.26,13820.5,97179,1263,431,92795,92783,92795,92795,90971
53262,2889,3410,37025,16237,2.76793e+13,742.44,9431.29,53262,917,280,49852,49852,49847,49852,48103
35424,1768,1777,22904,12520,3.01498e+13,573.746,5293.56,35424,510,297,33647,33647,33647,33647,33617
62481,3396,3629,39583,22898,2.93621e+13,562.239,9956.28,62481,1163,314,58852,58852,58852,58852,57266
61233,393,3664,41162,20071,4.3183e+13,825.765,9878.73,61233,1010,426,54573,50137,40341,8204,7258
8896,435,687,5716,3180,2.83811e+13,326.682,1817.63,8896,275,147,8153,7713,7718,7365,6195
53698,106,576,36417,17281,3.35522e+13,299.98,3892.52,53698,300,248,38201,20222,24483,12542,10727
92593,3975,4490,62585,30008,3.60365e+13,1248.3,14649.5,92593,1389,417,88103,88043,86663,86594,85558
59146,627,2505,37175,21971,3.07731e+13,576.705,7761.55,59146,512,393,56339,55480,45043,34456,21546
34239,1748,3394,25293,8946,6.74577e+13,1427.86,8444.62,34239,1046,440,30398,27892,21130,21173,20431
48496,3253,3362,34681,13815,3.96781e+13,928.524,10046.9,48496,903,331,45134,45134,45123,45057,44911
58266,3331,3598,40780,17486,3.17417e+13,924.73,10870.5,58266,1005,303,54668,54632,54668,54668,52706
53090,2814,3414,38005,15085,5.03952e+13,1342.5,10906.6,53090,1272,355,49676,49644,48914,48556,47697
83973,2622,4383,60149,23824,4.80539e+13,1660.95,15084.1,83973,1773,562,79459,77990,65246,65741,60706
79075,678,4029,52793,26282,3.20297e+13,952.896,12479.8,79075,1257,302,73296,70923,53160,36620,25207
50256,690,3539,33899,16357,4.46707e+13,770.585,9116.3,50256,993,413,45906,45025,33787,9020,9933
93001,1224,3716,60989,32012,3.48626e+13,1174.4,11858.1,93001,896,380,88903,87989,72252,12226,17051
46545,870,4656,39588,6957,4.20767e+13,17.0622,5489.12,46545,2333,2327,41889,41889,19197,32430,30387
67700,2867,3570,42614,25086,2.91332e+13,693.833,10085.2,67700,952,376,64130,64086,64121,64129,58121
93612,2237,2906,60112,33500,2.98578e+13,670.723,9837.44,93612,707,437,90706,90614,88551,87700,85730
60440,2775,3761,42006,18434,5.10752e+13,1146.28,11038.8,60440,1326,461,56679,56418,50681,29694,36539
7816,94,606,5717,2099,3.11108e+13,188.409,1833.08,7816,232,106,6538,5900,3840,2973,1535
46403,325,2947,32827,13576,3.41475e+13,831.514,9161.39,46403,932,240,40527,38083,25190,21782,6855
99610,2948,4434,70927,28683,4.47652e+13,1644.45,16516.7,99610,1914,591,95176,94522,82572,77456,77897
28430,396,1803,17581,10849,3.14509e+13,386.302,4677.28,28430,334,272,26334,25384,19496,12649,6784
55638,3244,3319,39554,16084,3.43966e+13,954.789,10490.5,55638,1004,328,52319,52319,52319,52258,52206
73302,471,3614,48381,24921,3.76881e+13,868.9,10139.1,73302,1007,425,67404,62375,51388,7766,6083
70694,271,2536,45625,25069,3.00303e+13,634.798,8334.15,70694,608,397,63631,58858,53898,48357,17027
80963,2383,3956,58232,22731,4.81111e+13,1745.4,14272.9,80963,1626,543,76594,74036,63425,63620,56330
81733,2421,4323,58569,23164,4.90555e+13,1653.4,14863,81733,1705,561,77131,74611,61829,60290,53215
86144,3570,3993,56167,29977,2.95196e+13,706.403,12455.7,86144,1249,392,82151,82151,82151,82151,77784
85423,3511,4327,57545,27878,3.36596e+13,1105.94,13674.4,85423,1319,383,81096,80887,79682,79592,76105
91402,2212,4257,64208,27194,4.7016e+13,1333.74,15296.6,91402,1739,547,86993,83119,69837,55724,55956
1082,129,175,629,453,3.2105e+13,28.2181,300.012,1082,32,32,907,905,885,889,652
94705,1023,9456,80548,14157,4.20695e+13,17.069,10652.4,94705,4730,4725,85249,85249,34677,64174,55737
13231,405,1886,9107,4124,3.91828e+13,413.906,4137.75,13231,721,142,11054,10396,9110,9088,6446
24313,140,1691,14617,9696,3.19625e+13,293.439,3865.81,24313,343,208,21530,19302,14799,4607,2242
51903,1824,3108,32369,19534,2.91086e+13,456.878,8067.21,51903,938,279,48795,48743,48159,48392,40044
17273,566,840,10133,7140,3.1914e+13,272.046,2103.39,17273,283,131,16433,16399,14960,15592,14023
40654,1249,2547,28968,11686,2.81917e+13,610.287,7297.45,40654,841,270,38107,37628,32837,29856,20022
76309,2204,3940,52553,23756,4.71188e+13,1263.09,12230.5,76309,1412,457,72293,69109,58426,27954,37631
4811,983,1025,3019,1792,2.96066e+13,212.286,1813.68,4811,225,137,3786,3786,3785,3786,3719
69070,723,2643,43860,25210,2.97132e+13,592.26,8525,69070,585,412,66299,65503,56458,49042,35967
4372,315,404,3187,1185,2.97259e+13,150.604,1151.8,4372,187,88,3968,3967,3861,3928,3177
75311,508,2776,47528,27783,3.01927e+13,664.266,9063.3,75311,611,435,71645,68464,57628,46735,26532
4385,188,487,2816,1569,2.83702e+13,179.986,1082.56,4385,149,95,3800,3640,3446,3405,2557
96625,451,4271,67283,29342,4.66544e+13,1322.34,15439,96625,1843,552,84243,78889,58476,32811,16644
91891,3860,3907,62259,29632,4.39747e+13,1211.77,12691,91891,1440,476,87984,87984,87929,87828,87704
37225,490,3717,26751,10474,6.15744e+13,1184.17,9078.4,37225,1232,454,30682,28943,16452,10543,9205
36126,1640,2897,25535,10591,4.76806e+13,1156.49,8485.38,36126,1097,313,33066,31178,27947,28438,23525
86628,1290,2856,55431,31197,2.98048e+13,655.608,9579.53,86628,713,424,83772,83581,76770,70874,58542
14904,406,1431,10687,4217,2.98081e+13,455.939,3862,14904,501,159,13046,12278,8040,7409,3154
9511,661,676,6949,2562,3.13396e+13,196.713,2108.84,9511,252,124,8835,8835,8833,8832,8796
45115,2274,2298,28298,16817,3.0369e+13,510.218,6431.26,45115,487,350,42817,42817,42817,42817,42763
18158,782,881,11776,6382,3.05065e+13,455.101,2792.1,18158,337,207,17277,17277,17062,17041,17045
92046,2536,2959,58158,33888,2.95183e+13,708.183,10074.3,92046,662,446,89087,88946,86301,86826,81849
16574,864,1214,10636,5938,2.93179e+13,322.15,3067.13,16574,356,188,15360,15354,15030,15038,13925
94545,1911,4868,62776,31769,3.5726e+13,1199.83,15365.4,94545,1226,488,89607,88473,82506,83986,49900
62777,2927,3091,41915,20862,2.95318e+13,646.152,9284.79,62777,1112,277,59686,59527,59675,59686,57693
16212,2697,2961,11521,4691,6.49235e+13,572.981,5573.5,16212,681,379,13251,13246,13216,12914,12930
11120,63,1764,7499,3621,4.35806e+13,426.795,3619.49,11120,582,123,7050,4432,4409,3183,838
20157,2288,2423,14569,5588,5.53122e+13,1046.08,5690.27,20157,831,190,17734,16949,17734,17734,17548
48095,318,557,32644,15451,3.36084e+13,302.186,3683.25,48095,298,244,47538,46519,35448,38298,34364
82214,1719,3921,53376,28838,3.08105e+13,705.218,12004.8,82214,1057,380,78293,77930,73364,73289,50676
18676,629,994,12097,6579,2.99311e+13,427.04,2956.41,18676,339,199,17682,17339,17031,16843,16276
62993,2306,3936,44327,18666,3.33899e+13,1052.4,11830.9,62993,1057,374,59057,58880,56879,56092,44636
79329,809,4122,52752,26577,3.11122e+13,929.919,12324.1,79329,1313,298,74129,72429,52038,43380,21773
70266,1210,3567,46652,23614,3.92103e+13,864.56,10028.7,70266,1021,417,66605,65339,52570,11852,12827
39178,1656,2695,23992,15186,2.91191e+13,400.417,6150.51,39178,890,178,36483,36479,36363,36473,30567
85285,2997,4348,60777,24508,4.84034e+13,1641.92,15238.3,85285,1765,559,80937,80378,70849,63471,64494
32765,751,2255,19984,12781,2.88498e+13,332.578,5167.56,32765,813,156,30510,30426,27212,27510,20961
63394,2122,2327,41294,22100,3.35884e+13,589.071,6965.76,63394,576,331,61067,61067,60756,60857,60037
64203,2236,2613,40102,24101,3.02732e+13,628.569,8230.04,64203,538,404,61590,61522,59158,60064,57518
12200,3928,5248,10139,2061,3.82717e+13,286.1,7230.94,12200,1673,12,6952,6802,6952,6952,4310
92754,518,4252,59748,33006,2.96146e+13,856.431,13415.6,92754,1254,428,86687,82546,63080,44379,22193
33296,266,1707,21467,11829,3.06526e+13,522.688,5068.69,33296,428,297,29747,27567,24728,20455,4526
25457,1459,3321,17448,8009,5.11258e+13,548.591,7052.11,25457,882,378,22136,21661,15292,8012,8042
28336,63,1041,18249,10087,2.90053e+13,490.81,3591.12,28336,415,243,21019,14812,16285,14733,3998
87189,3591,4334,61092,26097,4.01439e+13,1328.16,14767.3,87189,1446,447,82855,82662,77573,78812,75424
4257,84,679,2754,1503,3.01855e+13,192.46,1374.36,4257,196,111,3247,2721,2523,2074,1019
88972,1949,3974,64155,24817,4.62184e+13,1690.5,14867.1,88972,1637,564,84169,80279,69044,66333,55114
29810,1784,3290,21863,7947,6.7104e+13,1198.54,7747.71,29810,1024,423,26282,24448,18230,19797,19799
27569,341,1603,17732,9837,2.96389e+13,513.1,4614.98,27569,450,276,25120,23265,21005,20245,7716
36375,469,500,24688,11687,3.36994e+13,298.352,3173.97,36375,291,224,35875,35875,35821,35767,35666
12616,415,812,8122,4494,2.98628e+13,416.476,2315.15,12616,333,187,11619,10815,10448,10172,8356
74436,3521,4034,53444,20992,4.03445e+13,1300.53,13414,74436,1338,422,70402,70389,68455,67001,66718
80366,2478,3077,52434,27932,3.35017e+13,692.186,9392.47,80366,658,368,77289,77254,76358,75233,67650
70688,6225,21249,57254,13434,2.56925e+13,6368.1,33796.4,70688,6493,21,46285,31422,38183,40835,21027
93879,1847,4527,67314,26565,4.56975e+13,1747.18,15930.4,93879,1675,623,88258,83721,70464,68060,43187
47627,2868,2970,34135,13492,4.46943e+13,1236.18,9839.37,47627,1149,327,44657,44648,44611,44632,44351
36589,327,1999,22485,14104,3.10662e+13,427.838,5353.32,36589,380,283,33912,32327,25131,14687,8087
90826,4010,4171,59018,31808,2.95671e+13,784.49,13027.5,90826,1261,418,86655,86633,86655,86655,85492
90135,4034,4451,62117,28018,3.77615e+13,1323.74,14920,90135,1432,438,85684,85656,84932,84127,83402
67652,9386,20680,54787,12865,2.61959e+13,6281.89,32628.5,67652,6335,21,46972,34825,39028,40395,26219
72803,1776,2337,47024,25779,2.96829e+13,583.548,7905.9,72803,609,356,70466,70465,69378,68228,61946
48679,1949,3047,34084,14595,2.77932e+13,651.876,8649.64,48679,890,278,45632,45551,44363,45226,34142
56769,1237,3583,35970,20799,2.96685e+13,499.469,9410.48,56769,1208,262,53186,52908,44821,40680,25725
2759,990,2759,2069,690,3.50031e+13,0,2759,2759,349,8,0,0,0,0,0
97406,1971,4522,66846,30560,3.85941e+13,1330.47,15470.3,97406,1464,437,92618,90035,81568,71382,53872
65735,3722,3791,42329,23406,2.94016e+13,585.384,10625.3,65735,1224,338,61944,61944,61944,61944,61790
81037,1058,4012,54127,26910,3.1727e+13,976.387,12781.8,81037,1259,306,76393,73976,63630,49308,30337
85788,3981,4209,57015,28773,3.16279e+13,1050.23,13367.3,85788,1322,319,81579,81579,81579,81579,79836
29846,31,2274,20838,9008,3.60402e+13,726.441,6738.19,29846,706,209,15921,7239,7156,5288,1850
36253,1240,3349,24547,11706,4.6246e+13,664.073,7905.53,36253,923,411,32904,32050,24015,8863,8482
31293,26,1877,20679,10614,3.90407e+13,480.979,4977.94,31293,415,259,16849,9175,9255,2216,617
90692,2379,2918,57746,32946,3.01551e+13,706.652,9941.2,90692,656,447,87774,87600,84526,83350,78669
91376,2477,4393,65372,26004,4.73367e+13,1686.38,15895.1,91376,1863,571,86605,84823,70770,66916,61420
82983,2113,3548,54483,28500,3.54299e+13,1083.9,10683.2,82983,880,356,79435,78470,70282,17765,24742
99945,1658,4286,64660,35285,2.9432e+13,887.317,14029.3,99945,1260,430,95659,95013,83513,64506,55184
77138,437,3801,55425,21713,4.28787e+13,1510.64,13522.2,77138,1459,416,66134,61659,37565,23442,19183
39186,357,3334,28208,10978,5.88866e+13,1509.35,9090.78,39186,1340,275,30698,28073,16530,14420,5575
14824,461,1329,8857,5967,3.19139e+13,228.552,2734.42,14824,231,155,13495,13416,9415,3103,1815
42225,2425,2505,28186,14039,4.01615e+13,685.681,6432.07,42225,642,284,39720,39689,39639,39669,39200
72084,1822,3710,48754,23330,4.24051e+13,1102.33,10994.6,72084,1200,436,68065,66009,54239,18938,29822
58866,1406,1912,38019,20847,2.95072e+13,561.753,6054.28,58866,549,318,56954,56954,56461,56493,55962
35145,1312,3244,23750,11395,4.46966e+13,577.106,7526.06,35145,911,339,31901,31522,23759,7953,8624
51280,1174,3616,35468,15812,4.90564e+13,1050.52,9960.94,51280,1231,424,46807,44951,32560,14828,15350
93464,1409,4366,67192,26272,4.61774e+13,1683.75,15885.2,93464,1822,585,86757,82024,67592,63137,42747
14868,1323,2668,10896,3972,6.33907e+13,694.86,5082.3,14868,665,168,12200,11406,7178,8500,5944
13254,547,824,8535,4719,2.93276e+13,368.555,2333.23,13254,321,179,12430,11988,11832,11542,10481
3384,8,364,1976,1408,3.21725e+13,134.302,731.957,3384,80,70,2206,1696,1443,301,182
76165,1006,2738,48501,27664,3.07567e+13,642.089,9007.63,76165,600,425,73427,73189,65016,56268,43437
28873,964,1888,19170,9703,4.13475e+13,478.904,4873.91,28873,422,240,26985,26935,23803,7115,8108
92950,946,4493,65242,27708,4.13159e+13,1579.58,15560.2,92950,1639,448,84712,80529,56859,42816,17893
29368,1896,13034,23496,5872,104370000,726.987,18686.1,29368,2953,11,16334,14672,12489,14687,2270
17443,1307,1520,12712,4731,3.068e+13,265.859,4009.71,17443,385,159,15923,15923,15646,15817,13834
59476,1977,4028,42756,16720,5.60918e+13,1508.13,12240.5,59476,1533,522,55088,51112,39948,42249,36494
82121,1874,4239,55403,26718,3.28288e+13,1084.31,13335.4,82121,1261,371,77882,76885,73003,64714,46599
88127,3831,4316,62891,25236,4.77928e+13,1588.07,15401.5,88127,1751,569,83811,83771,83163,74912,76354
41286,3177,3633,28825,12461,5.19688e+13,935.296,8982.46,41286,1064,420,37653,37586,36521,30450,25378
91661,959,3969,61572,30089,4.0752e+13,1338.79,12594.4,91661,1288,443,85898,83993,64678,16451,18171
1332,342,349,847,485,3.30704e+13,79.0405,588.96,1332,113,83,983,983,983,983,980
41929,731,1830,27067,14862,2.97452e+13,558.026,5804.99,41929,472,314,40073,39424,36237,35511,22900
94987,1079,3962,64430,30557,4.43548e+13,1248.19,12955.9,94987,1418,478,89042,86706,68287,20534,29761
3233,559,923,2218,1015,3.91828e+13,159.618,1514.07,3233,283,57,2310,2254,2003,1618,1563
99747,4042,4349,69655,30092,4.52556e+13,1389.5,15987.1,99747,1835,567,95398,95360,94727,92370,84532
35391,550,2889,25161,10230,4.59915e+13,1042.84,8368.93,35391,946,313,30173,28514,22104,21096,13126
20012,1132,1471,14399,5613,2.63651e+13,632.522,4434.82,20012,741,174,18541,18185,18228,18348,16587
44137,2305,4432,37516,6621,4.22202e+13,16.9926,5233.05,44137,2219,2214,39705,39705,26973,34396,32491
51224,1310,1981,33037,18187,2.97056e+13,547.593,6462.32,51224,502,322,49243,49242,48030,46982,40422
39427,906,2032,25976,13451,3.79362e+13,505.578,5594.67,39427,445,283,37395,37295,32228,7728,8946
1111,179,295,886,225,9.52518e+13,96.405,504.699,1111,48,65,816,768,606,675,591
86673,3653,4371,58752,27921,3.50725e+13,1141.12,13970.5,86673,1287,408,82302,82112,79981,80383,77899
58056,521,2557,37810,20246,3.34749e+13,561.324,7020.07,58056,588,331,55209,52056,45508,6582,5951
3963,288,892,2563,1400,2.94058e+13,106.948,1553.18,3963,189,127,3071,2980,2814,2795,1681
3957,153,580,2559,1398,2.85597e+13,150.337,1172.48,3957,175,104,3263,3131,2845,2409,1688
93840,3566,4503,67378,26462,4.56515e+13,1719.31,15993.6,93840,1750,618,89337,89134,85153,82022,82519
17991,357,903,10497,7494,3.19148e+13,280.079,2248.21,17991,261,152,17085,16693,13515,11203,10002
19930,702,916,12806,7124,2.94112e+13,471.321,2967.38,19930,346,222,19014,18975,18397,18063,17825
65890,3614,3896,46095,19795,5.20945e+13,1293.17,11946.8,65890,1512,464,61994,61994,61374,59602,54410
73739,3744,4270,51689,22050,5.09787e+13,1414.62,13764.9,73739,1779,521,69469,69451,68262,54430,57481
50568,3570,3716,34767,15801,4.88225e+13,898.644,9600.84,50568,1055,431,46852,46740,46414,46002,45205
88573,1906,3823,55974,32599,2.92207e+13,871.966,11865.6,88573,972,438,84750,84269,76537,64318,57887
59403,2939,3611,37448,21955,2.92909e+13,526.259,9493.96,59403,1065,314,55792,55792,55792,55783,53235
51382,1172,2408,32972,18410,3.03136e+13,561.338,7251.75,51382,533,368,48974,48899,44697,39498,29976
62988,2606,3677,42904,20084,4.44579e+13,1119.51,10547,62988,1140,445,59311,58317,50948,22665,32809
26672,8939,12738,21748,4924,2.72557e+13,1020.8,16564.7,26672,3194,15,13934,13003,11336,12626,9593
27073,716,1133,15797,11276,3.20778e+13,301.837,2903.98,27073,402,154,25940,25913,23595,24561,22177
85164,2766,2887,53444,31720,3.04479e+13,697.404,9703.5,85164,640,450,82277,82277,82224,82227,81493
70622,1518,2670,45073,25549,3.00113e+13,595.893,8661.98,70622,602,421,67952,67871,63469,56834,50839
24705,2284,2337,15609,9096,2.80331e+13,302.552,5131.64,24705,780,162,22368,22368,22368,22368,22321
78054,1276,2420,50332,27722,2.95449e+13,580.83,8220.91,78054,622,370,75634,75616,71860,71164,60917
25191,1965,2246,17602,7589,2.63414e+13,579.677,5743.12,25191,829,212,22945,22945,22942,22940,21769
98379,513,4025,65822,32557,3.91464e+13,1311.08,13151.2,98379,1247,444,90797,85201,66876,11917,11208
44938,1733,2067,27706,17232,3.10618e+13,486.951,5967.43,44938,412,296,42871,42833,41549,42101,39845
62864,660,3653,42526,20338,4.4402e+13,930.276,10136.4,62864,1019,428,57998,57010,42937,11041,14965
44154,1340,3330,31489,12665,5.48537e+13,1511.42,9778.34,44154,1382,334,39577,36400,28518,27430,19592
55334,88,1763,35617,19717,2.89644e+13,561.428,5707.88,55334,481,321,44670,37304,32885,28769,3754
71899,965,4154,50812,21087,3.77609e+13,1199.48,13234.4,71899,1275,422,66009,62999,44982,36828,12799
88488,3783,8851,75239,13249,4.21419e+13,17.0352,10003.1,88488,4428,4423,79637,79637,49261,66976,64017
49516,14814,23718,39624,9892,2.19509e+13,141.406,26860.3,49516,2433,154,25798,25798,25796,25577,25383
76199,2354,3729,51560,24639,4.27729e+13,1108.08,11357.8,76199,1270,427,72470,70735,61178,24759,37848
42405,1298,1646,27526,14879,3.11308e+13,530.355,5113.96,42405,469,291,40759,40756,39932,39995,38278
