"data_size","cache_size","unique_size","reads","writes","data","ins","avg_step","avg_reuse_dist","sum_sqrt_count","sum_count","lis","lds","belady","lru","pivot","ld","mru"
5067,625,659,1605,3462,0,5067,3.62329e+13,212.45,1506.13,5067,123,178,4408,4408,4408,4408,4358
22572,714,825,22572,0,22572,0,4.26155e+18,340.748,2950.86,22572,186,188,21747,21746,21566,21577,21447
34797,1556,1791,0,34797,10957,23840,9.02938e+15,467.163,5519.46,34797,361,403,33006,33005,32921,32928,31732
38793,157,312,0,38793,38218,575,2.65659e+16,136.175,2235.46,38793,100,106,38475,38331,35611,34339,28050
22316,966,2162,13376,8940,13376,8940,1.85846e+18,687.187,5386.01,22316,432,280,19941,19035,17926,17270,11734
3344,1011,1019,2996,348,1985,1359,2.07717e+18,153.064,1548.55,3344,156,149,2325,2325,2325,2325,2320
800,1,14,797,3,800,0,1.02739e+14,7.6125,76.0807,800,10,8,312,312,312,312,312
21833,199,1654,6669,15164,0,21833,3.33611e+13,403.165,4541.14,21833,377,290,18721,17169,10827,9061,2589
43944,13050,43944,43944,0,43944,0,68717900000,0,43944,43944,43944,1,0,0,0,0,0
19188,401,1314,5714,13474,0,19188,3.38949e+13,506.567,3700.76,19188,321,245,17404,16686,14743,14796,7035
34820,103,3008,20720,14100,20720,14100,1.86315e+18,987.509,7603.45,34820,437,523,23436,18145,13638,9801,2335
32037,21,228,0,32037,31291,746,2.62617e+16,147.257,1834.13,32037,97,94,29801,28311,24799,19532,12789
8977,100,1505,5374,3603,5374,3603,1.8641e+18,603.593,3064.91,8977,242,334,5913,4792,3642,3058,372
32533,1178,1923,9203,23330,0,32533,3.7107e+13,667.177,5864.12,32533,395,412,30610,30314,29843,29858,21901
33841,416,3309,0,33841,0,33841,2.40447e+18,869.923,7886.4,33841,424,463,27949,24098,18107,14676,8387
36720,5282,5309,36720,0,32989,3731,1.13022e+18,824.677,10836.7,36720,593,480,31411,31411,31410,31410,31410
45782,1623,1969,0,45782,13086,32696,9.46615e+15,862.984,6837.46,45782,450,352,43813,43759,43463,43419,41222
4904,89,1202,4904,0,4336,568,2.58219e+18,386.99,2119.7,4904,211,141,2616,1804,1276,1080,582
39511,147,2023,0,39511,13040,26471,8.9655e+15,379.464,5969.11,39511,386,300,31816,26718,19151,16750,8540
16052,1108,2622,9663,6389,9663,6389,1.8762e+18,531.102,5126.83,16052,382,293,13430,12777,10846,11062,7635
17395,286,2626,15812,1583,10545,6850,2.01541e+18,673.179,5319.58,17395,279,366,12945,10256,8550,7267,2142
595,6,12,573,22,595,0,1.08806e+14,6.70756,64.3354,595,9,9,576,564,552,543,514
11812,427,1008,3774,8038,0,11812,3.53207e+13,461.807,2743.8,11812,221,270,10547,9970,8554,8604,5912
45131,3587,3944,39684,5447,26348,18783,1.97262e+18,1190.45,10172.3,45131,468,571,41187,41170,41072,41066,39790
34031,843,2906,0,34031,0,34031,2.34691e+18,738.435,7423.76,34031,391,370,30646,29015,19700,17426,13309
44528,37312,44528,44528,0,44528,0,1.75918e+13,0,44528,44528,44528,1,0,0,0,0,0
29887,2396,2891,27101,2786,18291,11596,1.98375e+18,951.915,6980.24,29887,391,426,26996,26939,26793,26827,24028
3281,20,21,3178,103,3281,0,9.90012e+13,13.011,178.583,3281,15,17,3260,3260,3260,3260,3260
31135,721,3099,18995,12140,0,31135,4.71984e+18,881.858,7474.32,31135,454,450,27042,23804,20310,19387,11106
21654,2078,2850,21654,0,19465,2189,2.78168e+18,830.948,6313.01,21654,416,337,18804,18786,18450,18160,16087
18113,4129,18113,18113,0,18113,0,1.75912e+13,0,18113,18113,18113,1,0,0,0,0,0
19393,1400,2064,0,19393,5952,13441,9.13845e+15,320.185,4842.71,19393,435,284,17329,17316,17026,17031,13845
16116,444,2420,16116,0,14204,1912,2.62143e+18,532.2,4927.86,16116,302,357,13025,10431,5300,3272,2309
43565,56,95,42699,866,43565,0,1.058e+14,20.5726,897.134,43565,31,33,43470,43466,42319,42322,35451
7536,479,1158,4575,2961,4575,2961,1.89636e+18,502.6,2358.25,7536,232,199,5974,5398,5352,5270,2734
46227,102,2896,0,46227,14375,31852,9.1036e+15,716.018,8249.64,46227,494,463,36208,31141,21832,18450,4688
44273,2249,3914,0,44273,0,44273,2.30171e+18,1018.35,9987.26,44273,536,472,40359,40026,36491,32000,26693
27979,5,281,0,27979,27591,388,2.64393e+16,122.425,1835.27,27979,92,101,21808,18750,17266,13919,9636
28038,391,736,28026,12,28038,0,4.01405e+18,327.013,3079.23,28038,203,185,27302,27142,23344,22977,21955
9608,519,1041,0,9608,2719,6889,8.49057e+15,221.828,2422.83,9608,191,176,8567,8458,8183,8235,4299
12844,539,1993,11524,1320,7594,5250,2.00003e+18,445.326,4065.44,12844,277,280,10595,10003,5599,5541,2889
29891,2156,2733,17845,12046,17845,12046,1.87996e+18,799.636,6805.84,29891,398,434,27158,27150,26724,26900,22564
18472,2290,2504,0,18472,0,18472,2.16728e+18,489.249,5355.29,18472,263,426,15968,15968,15922,15968,14847
43684,301,3961,26437,17247,0,43684,4.8824e+18,1044.61,9679.33,43684,572,592,34677,29478,20282,17342,6117
20062,725,1473,6455,13607,0,20062,3.41134e+13,696.584,4203.69,20062,350,393,18334,17165,15370,15323,12840
44913,578,3434,26629,18284,0,44913,4.79441e+18,1134.38,8986.8,44913,490,452,39343,36295,26248,23248,10583
48859,354,1251,48835,24,48859,0,4.26051e+18,368.529,4617.5,48859,249,241,47496,46885,33646,32763,27652
4998,874,1082,3001,1997,0,4998,4.83192e+18,339.435,1998.21,4998,185,198,3916,3753,3829,3834,3561
30160,3020,3868,30139,21,27187,2973,1.83988e+18,824.422,8474.63,30160,420,431,26292,26237,26123,26155,23022
6503,169,486,6503,0,6503,0,4.16589e+18,224.437,1424.87,6503,118,114,5785,5072,4008,3761,3104
19003,992,1863,0,19003,0,19003,2.28249e+18,792.463,4692.35,19003,320,337,17042,15745,15417,14803,12061
5673,837,1443,3442,2231,3442,2231,1.89025e+18,250.387,2347.93,5673,185,226,4230,4098,4000,4084,2699
25719,1848,2450,0,25719,0,25719,2.36078e+18,626.364,6288.7,25719,280,509,23269,23261,23023,23051,19881
16296,164,244,0,16296,16000,296,2.54873e+16,104.382,1370.26,16296,77,89,16052,16033,15606,15518,13663
48429,474,2321,13895,34534,0,48429,3.7498e+13,739.033,7326.72,48429,489,357,44162,40716,30270,28465,13740
10868,1121,1786,0,10868,0,10868,2.37654e+18,350.996,3525.02,10868,265,279,9082,8975,8626,8593,6342
23718,601,3239,23718,0,21150,2568,1.64957e+18,684.577,7031.05,23718,345,478,19113,16448,9323,7293,4982
14946,5,46,14690,256,14946,0,1.04993e+14,19.0854,457.14,14946,22,24,13945,13138,11889,11929,6907
34630,11,215,0,34630,34179,451,2.51942e+16,151.165,1745.22,34630,95,102,31333,29703,25504,21989,12478
26085,261,306,0,26085,25579,506,2.52651e+16,109.028,1925.83,26085,101,100,25779,25779,25621,25529,24835
25086,321,891,25086,0,25086,0,4.02209e+18,327.934,3152.96,25086,201,192,24100,23380,17262,16649,14773
36782,196,230,0,36782,35747,1035,2.49211e+16,164.566,1919.97,36782,110,116,36545,36413,35773,35555,34764
16555,983,2480,14882,1673,9972,6583,1.98284e+18,799.003,5096.28,16555,354,288,13905,13197,11255,10518,5670
40947,938,3104,0,40947,0,40947,2.42006e+18,952.347,8132.46,40947,475,424,37211,33230,24512,18143,11622
840,360,392,562,278,562,278,2.3248e+18,24.9036,501.403,840,96,73,448,448,446,446,423
37875,1891,3571,0,37875,0,37875,2.2431e+18,739.253,8495.75,37875,438,573,34304,34087,32957,32767,20721
32110,13,274,0,32110,31671,439,2.58676e+16,137.956,1910.16,32110,98,111,29123,27682,23859,18963,11801
17472,79,2051,0,17472,0,17472,2.42349e+18,579.951,4639.69,17472,316,239,11767,9600,7006,5467,918
12160,690,2401,12160,0,10538,1622,2.27775e+18,695.827,4461.85,12160,368,327,9390,8332,6479,5849,3285
18135,1499,1746,5777,12358,0,18135,3.37557e+13,331.559,4361.39,18135,414,269,16389,16388,16284,16287,15823
2303,91,576,1388,915,0,2303,4.50744e+18,183.427,961.495,2303,114,92,1498,1221,1069,1071,398
30240,245,289,0,30240,29713,527,2.58398e+16,141.847,2015.07,30240,99,104,29951,29945,29732,29673,29153
20311,1706,1741,0,20311,6334,13977,8.95262e+15,400.799,4548.84,20311,296,292,18570,18570,18570,18570,18531
3197,248,593,3197,0,2782,415,2.70267e+18,323.169,1189.59,3197,150,123,2228,1705,1565,1277,1113
47175,1998,2639,0,47175,0,47175,2.32692e+18,821.242,7225.06,47175,404,409,44536,44474,43425,42829,40080
16719,7,36,16582,137,16713,6,9.84213e+13,15.1274,477.536,16719,20,20,16405,16199,14437,14196,9462
41152,247,3206,41152,0,37122,4030,1.93306e+18,1254.75,8363.69,41152,515,481,31630,27404,12470,9390,2320
11670,412,599,11670,0,11670,0,4.4537e+18,295.496,1970.17,11670,144,148,11071,10890,9955,9868,10068
10116,168,215,0,10116,9954,162,2.63841e+16,76.8077,994.957,10116,61,68,9901,9886,9696,9692,9099
23949,211,235,0,23949,23312,637,2.57192e+16,108.252,1567.85,23949,90,84,23714,23713,23622,23573,23368
29387,1263,2713,17372,12015,0,29387,4.4225e+18,728.683,6679.36,29387,404,433,26674,25795,23257,23216,17074
20623,292,2522,20623,0,18550,2073,2.68877e+18,744.458,5636.83,20623,314,300,15652,12563,7114,3720,3187
15676,134,551,15676,0,15676,0,4.20924e+18,262.296,2163.76,15676,155,156,13868,11781,8889,8464,6165
8355,849,2123,8355,0,7493,862,1.80898e+18,317.317,3604.35,8355,247,304,6232,6000,4843,4471,2987
10468,1664,1855,0,10468,0,10468,2.20405e+18,321.442,3544.09,10468,251,350,8613,8613,8600,8608,8097
37429,24,64,36801,628,37429,0,1.01117e+14,19.2238,715.38,37429,28,26,37363,37345,35060,35057,28303
37350,12,70,36731,619,37350,0,9.91684e+13,18.74,736.165,37350,27,27,37137,37025,33141,33095,21316
28814,517,911,28814,0,28789,25,4.13731e+18,348.837,3364.99,28814,214,204,27903,27751,24582,24366,22895
18712,247,1014,5526,13186,0,18712,3.55206e+13,384.29,3205.49,18712,253,251,16317,14104,11722,11210,5623
21251,2095,2410,21251,0,17948,3303,1.27243e+18,1067.49,5849.98,21251,324,427,18841,18795,18645,18605,17968
13863,1907,1973,12566,1297,8417,5446,1.98857e+18,575.654,4176.02,13863,266,255,11890,11890,11890,11890,11845
35693,664,1282,35693,0,35693,0,4.20184e+18,389.369,4073.76,35693,225,220,34411,34264,29464,29268,26201
32747,1626,1978,0,32747,10189,22558,9.07819e+15,551.85,5802.43,32747,417,377,30769,30767,30419,30401,28192
30104,374,1675,0,30104,9286,20818,8.26128e+15,593.501,5329.5,30104,354,332,27568,26369,23151,23376,9800
25357,1581,3440,15247,10110,0,25357,4.86725e+18,857.125,7275.2,25357,423,502,21917,20930,20066,19780,11514
17746,43,2423,0,17746,0,17746,2.21863e+18,456.711,5154.37,17746,328,310,9887,5978,4748,2859,606
25659,728,1625,7518,18141,0,25659,3.59585e+13,588.093,4838.19,25659,380,314,23916,23314,21266,21419,15028
18758,273,603,18758,0,18758,0,3.97991e+18,309.135,2427.65,18758,166,177,18011,17506,14288,14205,12566
48569,325,866,48569,0,48569,0,3.99712e+18,362.832,4135.96,48569,230,230,47511,46753,35438,35003,29206
45486,64,299,0,45486,44841,645,2.6047e+16,118.334,2257.97,45486,99,115,44575,43435,37843,34270,25290
8883,1184,1255,0,8883,0,8883,2.50075e+18,307.28,2681.17,8883,232,160,7628,7628,7601,7621,7514
10737,869,1843,6430,4307,0,10737,5.06995e+18,379.823,3643.74,10737,295,326,8894,8753,8244,8240,5330
41511,29,349,0,41511,40703,808,2.62013e+16,151.169,2510.81,41511,110,128,39155,37618,31260,25507,16842
33941,2923,3147,0,33941,0,33941,2.35199e+18,879.955,7726.57,33941,443,388,30794,30794,30692,30711,30182
20239,46,261,0,20239,19867,372,2.64284e+16,115.632,1533.17,20239,87,89,19446,18889,15971,14775,9437
27088,2301,2620,16448,10640,0,27088,5.06625e+18,702.639,6251.75,27088,366,416,24468,24453,24338,24302,22446
32809,2273,2629,0,32809,0,32809,2.4125e+18,1126.67,7187.23,32809,555,386,30180,30155,29385,28799,28234
600,251,337,429,171,429,171,1.59716e+18,31.2033,415.437,600,93,40,263,263,262,262,251
30859,1242,2246,18835,12024,18835,12024,1.81266e+18,970.948,6332.05,30859,448,371,28464,27524,27096,27003,22788
48975,40,62,47995,980,48975,0,9.76932e+13,20.1074,800.663,48975,27,29,48913,48909,47637,47637,41754
19606,592,606,19606,0,19606,0,4.47738e+18,279.63,2496.74,19606,174,176,19000,19000,18990,18998,18926
44992,682,4605,27073,17919,0,44992,4.75118e+18,959.363,10527.9,44992,608,721,39058,35457,26614,24242,12974
28683,2567,4096,28683,0,28683,0,9.00312e+15,3511.08,10839,28683,4096,8,15413,0,7768,15408,15413
39660,57,2299,11453,28207,0,39660,3.59367e+13,799.965,7117.07,39660,479,450,28580,23976,17897,4129,4254
33369,1660,1791,10586,22783,0,33369,3.25583e+13,455.787,5271.12,33369,300,382,31578,31578,31556,31565,31236
26028,711,1475,0,26028,8083,17945,8.48955e+15,514.484,4404.11,26028,333,345,24528,23968,22895,22995,15703
27075,1631,3140,15466,11609,15466,11609,1.81167e+18,830.24,7008.82,27075,421,577,23935,23389,23027,23165,17677
14328,320,1916,0,14328,4175,10153,9.55906e+15,279.94,4169.05,14328,365,242,12312,11554,8838,8581,3692
3690,572,688,0,3690,0,3690,2.26285e+18,314.738,1365.41,3690,172,129,3002,2846,2894,2867,2792
12350,487,1039,0,12350,3861,8489,8.91687e+15,263.313,2607.7,12350,256,186,11311,11270,10619,10655,8947
16035,2330,2967,14290,1745,9383,6652,1.8811e+18,397.651,5624.33,16035,368,385,13068,13058,12888,12969,11170
48377,3217,5679,48377,0,42733,5644,2.28788e+18,1101.85,12459.1,48377,590,599,42698,42525,38894,38319,29388
14064,1210,1637,0,14064,0,14064,2.35275e+18,465.737,3807.76,14064,240,250,12427,12310,12184,12134,10306
16235,614,2112,0,16235,0,16235,2.3818e+18,351.735,4532.04,16235,224,359,14123,13602,13045,11888,5021
45350,14,72,44605,745,45350,0,1.01704e+14,19.865,780.42,45350,29,29,45185,45060,41378,40619,25681
31856,1975,2724,18887,12969,18887,12969,1.82598e+18,1130.42,7205.97,31856,415,444,29132,28467,27834,27826,24374
1702,425,577,1702,0,1581,121,2.64137e+18,56.2914,821.594,1702,114,87,1125,1122,1046,1005,941
5512,253,591,0,5512,0,5512,2.35128e+18,308.024,1472.73,5512,143,160,4500,3656,3601,2847,3066
7875,78,1388,7875,0,7000,875,1.83082e+18,329.026,2744.44,7875,193,256,4476,3187,1689,893,732
47742,1418,2150,0,47742,14085,33657,9.27524e+15,605.578,6870.11,47742,471,346,45592,45449,43939,44180,34376
3398,47,61,0,3398,3379,19,2.54047e+16,30.8537,305.026,3398,32,36,3337,3314,3249,3286,3270
25044,1274,1623,7224,17820,0,25044,3.71462e+13,578.072,4686.85,25044,344,302,23421,23406,22914,22946,20717
28828,452,3412,28828,0,25479,3349,1.33721e+18,914.868,7779.87,28828,393,398,23234,19839,14004,11805,5828
20406,187,216,0,20406,20009,397,2.54035e+16,114.643,1295.33,20406,81,87,20190,20186,19942,19942,19543
5109,494,1453,5109,0,4622,487,2.02535e+18,182.369,2310.26,5109,233,192,3656,3314,2664,2710,1728
20619,356,2378,12405,8214,0,20619,4.93491e+18,620.8,5304.06,20619,391,358,17178,14262,10182,9046,3732
30129,1043,3055,0,30129,0,30129,2.27788e+18,671.728,7223.68,30129,436,389,26993,26261,21102,19762,10398
9279,346,1253,0,9279,2496,6783,9.9798e+15,280.115,2701.32,9279,216,241,7966,7523,7354,7320,2747
26527,734,2812,14981,11546,14981,11546,1.68239e+18,838.544,6433.56,26527,345,442,23332,22176,18461,18562,7694
4176,539,919,2608,1568,2608,1568,1.70995e+18,294.008,1691.24,4176,197,144,3257,2943,2832,2761,2272
12517,1314,1606,6911,5606,6911,5606,1.52047e+18,231.424,3325.68,12517,254,237,10911,10904,10771,10736,10444
47859,979,4228,43111,4748,29063,18796,1.96803e+18,1460.87,10531.5,47859,592,496,41648,37728,24082,21625,15099
27725,3987,4234,24942,2783,16299,11426,1.96621e+18,836.87,8475.19,27725,386,532,23491,23491,23482,23491,23100
11044,170,185,0,11044,10847,197,2.61441e+16,90.8988,977.018,11044,68,67,10859,10857,10832,10733,10688
33285,1222,3114,30123,3162,19868,13417,1.95e+18,1102.54,7938.88,33285,473,487,29373,27455,22293,21682,12241
25118,13,48,24568,550,25118,0,1.0248e+14,18.9608,592.193,25118,24,26,24985,24868,22135,21994,15653
6752,1750,2100,6752,0,5911,841,2.27896e+18,249.6,3241.85,6752,293,215,4652,4642,4623,4631,4206
49575,666,2714,14639,34936,0,49575,3.53936e+13,929.857,8388.05,49575,499,498,45704,43554,34309,34377,14732
40066,573,845,40066,0,40066,0,4.25755e+18,378.851,3799.07,40066,229,233,39221,39126,36673,36611,36628
24983,725,3598,22277,2706,14881,10102,1.91042e+18,1022.04,7619.89,24983,392,428,20205,18321,11812,11654,6693
41264,2549,3112,24297,16967,24297,16967,1.84634e+18,1356.34,8582.78,41264,508,472,38152,37970,37401,37576,34704
25163,1588,2120,7946,17217,0,25163,3.44479e+13,424.964,5574.29,25163,460,298,23043,23038,22793,22769,21328
30866,2264,4284,27861,3005,18574,12292,1.98966e+18,573.386,8793.15,30866,356,558,26582,26491,25200,25433,17879
19671,1662,1804,12198,7473,12198,7473,1.82783e+18,786.632,4746.35,19671,302,361,17867,17867,17828,17841,17746
10371,474,1773,6143,4228,6143,4228,1.91328e+18,374.526,3468.79,10371,196,348,8517,7607,7446,7235,3089
17507,38,202,0,17507,17189,318,2.54859e+16,123.297,1199.13,17507,83,80,16728,16227,14153,13034,8285
44861,35,54,43946,915,44861,0,9.81127e+13,16.246,708.529,44861,24,25,44807,44807,44344,44345,42872
33632,3602,3660,0,33632,0,33632,2.36919e+18,702.433,8234.42,33632,577,337,29972,29972,29956,29969,29932
1926,327,554,0,1926,0,1926,2.02108e+18,99.4133,866.645,1926,111,67,1372,1295,1306,1297,995
10599,1498,1971,9506,1093,5839,4760,1.86155e+18,264.135,3503.71,10599,350,236,8628,8584,8422,8433,8088
24522,1704,3411,21624,2898,14783,9739,1.95063e+18,1044.92,7285.1,24522,392,446,21111,20096,18472,18489,14046
41734,275,3135,22928,18806,0,41734,3.97805e+18,1098.25,7985.85,41734,419,492,36231,33857,16351,12454,4413
39454,174,4538,39454,0,34615,4839,2.91161e+18,1031.16,10055.2,39454,405,424,27820,22941,10307,4508,1815
4629,224,665,0,4629,1549,3080,8.17406e+15,183.991,1459.35,4629,170,164,3931,3699,3299,3321,1612
45830,983,1096,45830,0,45820,10,4.19501e+18,373.471,4345.16,45830,235,243,44734,44732,44378,44396,44037
48948,2165,2358,0,48948,14143,34805,9.2396e+15,993.932,7759.31,48948,641,433,46590,46585,46275,46291,45802
31630,1207,3803,27738,3892,18671,12959,1.93402e+18,853.552,8603.85,31630,402,488,27779,26348,23285,23361,14017
5038,1034,1292,3082,1956,0,5038,4.64114e+18,169.223,2113.45,5038,207,138,3746,3746,3715,3719,3388
36695,276,4846,32478,4217,21598,15097,1.96654e+18,939.167,10461.7,36695,520,545,27578,22405,13352,11027,2001
7370,6,434,7370,0,7370,0,3.89852e+18,225.487,1407.96,7370,115,116,2126,582,712,696,167
26730,2388,2857,15842,10888,0,26730,4.63925e+18,833.011,6818.33,26730,365,515,23873,23868,23693,23677,22120
39676,8,76,38856,820,39676,0,1.01151e+14,19.4246,782.518,39676,28,32,39031,38681,34216,32924,17900
30613,2810,3994,18438,12175,18438,12175,1.87222e+18,906.006,8623.96,30613,532,415,26619,26340,25793,26017,20907
19417,1035,2011,0,19417,0,19417,2.36285e+18,602.506,4716.4,19417,398,293,17406,16741,13324,10218,9559
45049,6,35,43996,1053,45049,0,9.64599e+13,17.9081,670.325,45049,23,25,43875,43165,37057,37394,23516
40019,18,78,39497,522,40019,0,9.92716e+13,18.9156,752.113,40019,29,31,39912,39847,35677,35140,25947
38257,840,2431,22758,15499,22758,15499,1.92135e+18,1169.07,7141.24,38257,525,419,34172,31784,30667,28984,19528
38491,3183,4357,34532,3959,21997,16494,1.94426e+18,1216.78,9780.39,38491,551,585,34134,33727,31844,31468,26526
12519,333,565,12513,6,12519,0,4.13395e+18,284.534,2012.62,12519,144,152,11947,11717,10093,9891,9417
7224,102,1174,4260,2964,4260,2964,1.73454e+18,160.991,2275.98,7224,169,163,5348,4004,4109,2989,476
14494,426,1582,8606,5888,0,14494,4.82017e+18,432.673,3696.64,14494,246,319,12615,11452,8975,8347,5554
5204,881,1121,4557,647,3040,2164,1.90029e+18,280.321,2094.66,5204,160,205,4083,4050,3976,3992,3602
9807,7,31,9630,177,9807,0,1.01087e+14,15.5786,325.094,9807,20,21,9571,9471,8343,8186,5779
10500,763,1443,10500,0,9389,1111,3.04193e+18,697.363,3255.04,10500,239,241,8852,7435,7948,7640,6426
8933,1648,2179,8933,0,7996,937,2.85287e+18,320.14,3625.68,8933,272,235,6754,6723,6664,6472,5930
7036,416,1449,0,7036,0,7036,2.53322e+18,197.491,2544.47,7036,216,152,5584,5125,3843,2488,1468
15184,1074,1466,0,15184,4577,10607,9.22708e+15,333.509,3686.56,15184,297,372,13718,13703,13502,13501,11883
22374,11,48,22039,335,22368,6,1.00204e+14,22.0841,597.322,22374,23,26,22170,22014,19565,19449,13776
25499,1385,2371,15589,9910,15589,9910,1.83543e+18,916.771,5938.52,25499,423,436,23128,22303,21871,22108,17379
1576,356,424,507,1069,0,1576,3.47465e+13,70.9423,715.665,1576,73,85,1152,1152,1150,1150,1085
38001,538,2296,0,38001,11145,26856,9.26161e+15,753.719,6952.87,38001,466,492,35073,33716,28155,28068,13726
18613,2462,2978,18613,0,16533,2080,2.7294e+18,832.956,6093.01,18613,302,404,15635,15608,14833,14716,13804
36730,563,694,36724,6,36730,0,4.14903e+18,346.484,3428.22,36730,220,213,36036,36008,34712,34699,35042
7430,1060,1402,4384,3046,0,7430,5.08485e+18,344.228,2625.9,7430,230,294,6028,5881,5931,5934,5479
44737,669,873,44737,0,44737,0,3.9685e+18,377.334,3987.65,44737,226,222,43864,43830,41759,41627,40657
43624,39,97,42859,765,43624,0,9.96495e+13,22.0899,881.84,43624,31,33,43527,43519,40322,40252,29285
30800,72,229,0,30800,29802,998,2.55711e+16,140.42,1693.88,30800,84,85,30304,30001,26439,23701,16931
5397,313,1150,4786,611,3065,2332,1.92864e+18,215.55,2109.36,5397,157,211,4167,3781,2239,2242,1598
35927,44,68,35347,580,35927,0,1.02814e+14,20.1519,731.34,35927,26,29,35859,35859,34619,34620,29151
26790,59,275,0,26790,26061,729,2.45787e+16,122.434,1904.49,26790,96,100,25965,25289,20727,19551,12995
15905,156,195,0,15905,15560,345,2.50945e+16,121.143,1275.64,15905,78,85,15692,15597,15174,14968,14301
39754,159,2469,24058,15696,24058,15696,1.80847e+18,939.993,7309.59,39754,396,435,29149,23346,18252,14598,3659
7346,68,169,0,7346,7204,142,2.75342e+16,67.4446,783.087,7346,60,56,7138,7010,6408,6347,5108
48087,294,942,47969,118,48087,0,4.25021e+18,379.528,4231.34,48087,237,228,46723,45388,29100,28197,24626
3338,435,724,2944,394,2120,1218,1.8595e+18,352.605,1368.92,3338,140,143,2455,2019,2118,2108,1861
44397,601,2751,0,44397,13057,31340,9.328e+15,707.284,8091.46,44397,374,495,41088,39897,32231,32425,14053
31084,4,195,0,31084,30739,345,2.47812e+16,121.092,1544.09,31084,82,94,22707,19382,17552,15327,11450
11484,1185,1195,3388,8096,0,11484,3.54462e+13,354.278,2832.69,11484,290,194,10289,10289,10289,10289,10277
28406,395,1657,8978,19428,0,28406,3.48873e+13,700.191,5127.23,28406,406,334,25847,24712,18428,18649,9043
39952,2321,3279,0,39952,0,39952,2.09394e+18,847.383,8329.17,39952,440,471,36673,36504,35582,35565,32346
23568,8,56,23116,452,23568,0,1.0289e+14,19.0192,608.735,23568,25,26,23143,22956,20106,19911,11868
43255,15839,43255,43255,0,43255,0,1.75918e+13,0,43255,43255,43255,1,0,0,0,0,0
45207,516,875,45207,0,45207,0,4.04746e+18,399.55,3994.24,45207,217,221,44332,44150,38830,39129,35122
45072,609,3029,27179,17893,27179,17893,1.79754e+18,1358.49,8853.7,45072,527,555,38537,34537,26681,25094,16297
45115,3356,45115,0,45115,0,45115,1048550,0,45115,45115,45115,1,0,0,0,0,0
10273,813,1537,5780,4493,5780,4493,1.71558e+18,389.271,3196.5,10273,201,305,8736,8368,8329,8287,5132
42722,1209,2539,23769,18953,0,42722,4.10401e+18,1049.47,7212.64,42722,469,414,39882,38267,36922,35735,29655
9746,243,1341,0,9746,2840,6906,9.49562e+15,231.825,2909.37,9746,306,178,8194,7578,6004,5713,2859
7632,788,991,4016,3616,4016,3616,1.58578e+18,222.375,2167.9,7632,177,225,6641,6603,6536,6400,6367
38645,119,320,0,38645,37608,1037,2.62518e+16,161.562,2296.04,38645,98,121,38172,37811,34001,30990,24514
24646,877,2307,14615,10031,0,24646,4.77239e+18,704.721,5793.21,24646,303,429,22286,20893,20329,19961,12187
19544,673,1786,19544,0,17372,2172,2.03931e+18,843.483,4706.1,19544,281,373,17089,16415,9118,7311,6778
8663,850,1016,0,8663,2673,5990,8.98321e+15,292.665,2330.96,8663,205,217,7647,7569,7506,7524,6985
28184,1029,3542,24948,3236,16891,11293,1.98038e+18,647.336,7490.4,28184,384,459,24545,23468,20315,19957,15459
11410,2010,2207,11410,0,10220,1190,2.37303e+18,479.056,4128.94,11410,223,359,9203,9203,9180,9132,9058
38981,595,1944,11756,27225,0,38981,3.55185e+13,712.623,6366.72,38981,490,378,36494,35506,27223,26987,17814
6804,553,923,0,6804,1821,4983,1.01901e+16,320.572,1962.45,6804,206,167,5881,5623,5535,5567,4357
24880,1975,2203,22112,2768,15032,9848,2.02306e+18,1146.03,5791.76,24880,372,344,22677,22668,22603,22610,21967
45231,3357,3654,0,45231,0,45231,2.39914e+18,991.563,9743.05,45231,615,464,41577,41575,41103,41008,40121
22134,2089,2126,19913,2221,11897,10237,1.87962e+18,433.668,5104.14,22134,301,302,20008,20008,20008,20008,19984
28646,476,3045,17276,11370,0,28646,4.92495e+18,675.912,7033.76,28646,364,355,24716,22319,14038,12061,5386
32441,146,2814,0,32441,0,32441,2.27514e+18,1049.34,7267.29,32441,426,366,24732,20342,10951,10400,2512
34323,24,54,33663,660,34323,0,1.00189e+14,20.9296,642.954,34323,25,27,34265,34256,32320,31962,23465
13136,965,2130,11820,1316,7936,5200,2.0165e+18,438.146,4213.3,13136,229,351,11006,10861,10206,10192,4459
9753,381,1252,6115,3638,6115,3638,1.74163e+18,377.561,2764.62,9753,238,222,8266,6556,6119,5856,3893
48433,37,66,47613,820,48433,0,1.01413e+14,21.7504,804.95,48433,29,28,48367,48360,46109,46110,39279
49371,87,284,0,49371,48076,1295,2.57181e+16,171.076,2350.41,49371,109,125,48630,47848,42565,38257,29441
41058,62,2074,12757,28301,0,41058,3.11981e+13,637.051,6598.08,41058,472,398,31114,24365,17765,8771,3890
25055,1298,1474,0,25055,6931,18124,9.45355e+15,492.409,4462.18,25055,342,249,23581,23573,23411,23388,22609
37192,2783,4249,37192,0,33043,4149,2.72376e+18,1054.54,9646.98,37192,414,520,32943,32639,30815,29985,21946
45428,1765,2675,0,45428,13721,31707,9.37184e+15,860.922,7873.03,45428,493,494,42753,42290,41270,41351,34880
28518,645,2173,8514,20004,0,28518,3.56264e+13,559.016,5849.02,28518,409,344,26075,25341,20101,20267,10756
33069,864,1681,0,33069,9163,23906,9.3599e+15,750.76,5380.53,33069,436,353,31216,30868,29126,29214,18446
47323,773,3690,0,47323,0,47323,2.35677e+18,1335.16,9662.85,47323,410,507,42030,39885,29969,27669,15064
25095,714,3266,25095,0,22565,2530,1.85973e+18,1002.66,6914.42,25095,365,369,20924,19267,16892,16954,4622
43045,66,101,42335,710,43045,0,1.02389e+14,18.0776,934.762,43045,31,30,42944,42944,41942,41940,37983
12772,555,2226,12772,0,11557,1215,1.39924e+18,413.722,4228.76,12772,255,287,10521,9652,5646,4937,3530
8112,186,1214,0,8112,0,8112,2.39838e+18,513.944,2577.96,8112,201,194,6010,5039,4091,3487,1831
23702,975,2491,14316,9386,0,23702,4.91182e+18,754.788,5887.54,23702,348,404,20812,19159,18215,17994,9875
9033,177,1524,8003,1030,5267,3766,1.93574e+18,362.638,3036.98,9033,302,166,6164,4654,3050,2738,1863
3094,197,1008,2693,401,1826,1268,1.96052e+18,179.279,1536.31,3094,171,128,2008,1643,1092,970,750
30961,690,3219,27809,3152,18437,12524,1.96581e+18,1056.94,7840.75,30961,456,371,26299,24095,14323,13773,9383
31318,58,72,30692,626,31318,0,1.02999e+14,18.4206,693.166,31318,26,27,31246,31246,30929,30930,29995
47698,2054,3528,0,47698,0,47698,2.43831e+18,1143.55,9289.57,47698,547,519,44170,43170,41476,40519,33995
49008,2450,2724,29165,19843,29165,19843,1.9078e+18,1177.19,8468.7,49008,507,467,46284,46272,46076,46183,44866
35677,1279,2302,11537,24140,0,35677,3.41741e+13,674.836,6633.06,35677,371,548,33375,32828,32259,32299,23481
32671,171,297,0,32671,31844,827,2.66211e+16,137.126,1984.79,32671,101,105,32374,32277,29967,29244,25242
4501,263,683,2695,1806,2695,1806,1.6538e+18,276.82,1430.12,4501,168,126,3585,2936,3107,2495,1814
35352,3213,4123,31309,4043,20874,14478,1.93477e+18,890.983,9336.49,35352,536,462,31229,31216,30592,30548,27115
17810,607,1908,0,17810,0,17810,2.13954e+18,524.362,4436.01,17810,337,326,15619,14396,13953,12748,5112
15204,967,2411,13680,1524,8884,6320,1.92519e+18,549.962,4939.67,15204,356,368,12793,12184,11084,11009,7810
14009,289,1452,0,14009,0,14009,2.44907e+18,606.873,3542.4,14009,282,257,11067,9492,6687,5825,2413
1437,111,262,1437,0,1437,0,3.93253e+18,106.77,545.694,1437,66,63,1126,993,882,868,624
36387,747,2571,0,36387,0,36387,2.40206e+18,1219.26,7400.76,36387,440,446,32253,30007,27765,22461,14033
22585,45,46,22255,330,22573,12,1.00152e+14,18.1274,577.542,22585,25,25,22539,22539,22513,22513,22473
36012,391,3314,32590,3422,20874,15138,1.93802e+18,793.512,8224.23,36012,419,404,30330,24927,12825,11712,4789
3318,102,148,0,3318,3218,100,2.75157e+16,53.9623,543.072,3318,55,46,3170,3153,3105,3107,2658
18476,27,48,18164,312,18345,131,1.0192e+14,17.218,529.61,18476,24,24,18428,18425,17784,17806,16054
30192,474,1519,18416,11776,0,30192,4.85134e+18,459.343,4432.84,30192,289,275,28595,27543,18360,16301,15559
22850,1430,1475,0,22850,6919,15931,9.15752e+15,416.576,4156.92,22850,296,266,21375,21375,21373,21372,21311
45490,85,97,44712,778,45482,8,1.04484e+14,21.9242,939.334,45490,33,33,45393,45393,44898,44922,43215
757,51,155,0,757,246,511,7.9e+15,59.5984,299.508,757,54,48,540,404,415,415,279
18657,2263,2454,11218,7439,0,18657,4.89498e+18,541.521,5223.32,18657,379,425,16203,16203,16176,16165,15507
49515,3566,3825,0,49515,0,49515,2.22448e+18,858.353,9585.83,49515,496,581,45690,45684,45509,45355,44451
38998,798,1365,0,38998,12377,26621,8.83976e+15,501.947,5038.64,38998,320,358,37633,37540,34748,35038,30028
25434,1422,1896,0,25434,8042,17392,9.24314e+15,660.096,5261.89,25434,440,339,23538,23294,22630,22644,20696
11510,775,2088,10376,1134,6964,4546,1.92286e+18,402.107,4038.22,11510,276,369,9383,9220,6506,6513,3607
26037,221,266,0,26037,25596,441,2.62748e+16,118.964,1857.77,26037,89,100,25771,25761,25673,25580,24217
46662,424,3656,28159,18503,0,46662,4.93385e+18,1073.07,9333.75,46662,536,450,40220,34815,26361,22302,6301
3276,247,943,3276,0,2919,357,2.49823e+18,230.413,1513.3,3276,173,133,2187,1699,1476,1316,1170
49798,3593,3821,29967,19831,0,49798,4.65465e+18,917.209,10232.9,49798,578,512,45977,45977,45885,45711,44854
39861,45,74,39144,717,39795,66,1.01106e+14,21.5118,865.336,39861,27,31,39787,39785,38660,38713,34831
8534,1591,1697,7821,713,5328,3206,1.95364e+18,395.496,3162.87,8534,277,189,6837,6837,6836,6836,6732
33367,3081,3367,18883,14484,0,33367,4.27241e+18,724.773,7826.54,33367,406,545,30000,29999,29929,29945,29407
37769,82,99,37177,592,37769,0,1.05141e+14,16.5724,797.792,37769,29,30,37670,37670,37111,37112,35191
35409,40,80,34625,784,35397,12,1.03364e+14,17.267,760.931,35409,28,30,35329,35328,33370,33339,24674
39763,3311,3515,22315,17448,0,39763,4.43002e+18,867.035,8532.39,39763,386,548,36248,36229,36218,36229,35516
24509,10484,24509,0,24509,0,24509,1048530,0,24509,24509,24509,1,0,0,0,0,0
22125,25,1725,6755,15370,0,22125,3.42854e+13,312.542,4576.94,22125,223,361,13547,9668,7771,3341,2336
37942,1542,2364,0,37942,11764,26178,8.96875e+15,568.574,6719.9,37942,470,306,35578,35503,34216,34405,27374
16233,14,675,16233,0,16233,0,4.47799e+18,307.483,2397.45,16233,171,162,7315,3458,2697,2364,687
44886,1535,3020,26532,18354,0,44886,4.74568e+18,1066.27,8738.17,44886,524,460,41795,40621,37492,36558,25960
41421,1785,2371,0,41421,0,41421,2.34093e+18,1013.08,7134.91,41421,429,395,39050,39026,37557,37433,36493
41709,261,335,0,41709,40773,936,2.61494e+16,168.345,2593.38,41709,108,126,41374,41293,40314,39966,37912
48770,1563,3865,29506,19264,29506,19264,1.88576e+18,919.628,10157.3,48770,667,461,44905,44185,36163,35742,25935
6677,9,27,6571,106,6677,0,1.03957e+14,15.7966,263.48,6677,18,19,6583,6529,5728,5580,4439
39569,154,1105,39559,10,39569,0,4.22173e+18,352.948,4027.26,39569,217,212,35980,31835,18995,17242,9829
44442,2225,3004,0,44442,0,44442,2.32351e+18,1165.9,8662.01,44442,538,434,41438,40822,40213,39659,33232
12571,525,1888,11225,1346,6932,5639,1.91462e+18,357.806,3871.96,12571,237,296,10683,10212,9130,8990,4335
8147,91,416,8147,0,8147,0,4.10282e+18,229.189,1464.43,8147,125,119,6618,5231,3988,3787,2516
27806,25,66,27429,377,27756,50,9.66529e+13,16.5405,698.097,27806,26,27,27740,27736,25796,25674,19744
14260,1026,1356,4381,9879,0,14260,3.37261e+13,230.09,3349.67,14260,237,209,12904,12888,12834,12860,9567
40654,1718,4016,36403,4251,24039,16615,1.98233e+18,1325.93,9630.42,40654,515,543,36468,33827,29710,29740,23068
6566,502,1088,0,6566,1778,4788,9.92691e+15,185.597,2124,6566,253,195,5478,5371,5184,5171,3104
22919,761,1891,12709,10210,0,22919,4.18037e+18,891.339,4758.99,22919,345,340,20355,19436,18913,18191,11906
36610,524,541,36592,18,36610,0,4.06758e+18,347.897,3181.43,36610,209,203,36069,36069,36034,36038,36033
4890,28,207,0,4890,4778,112,2.67749e+16,55.4415,739.525,4890,59,53,4533,4360,3709,3281,2025
30723,548,2242,0,30723,0,30723,2.2506e+18,1013.58,6310.89,30723,402,385,26757,25087,21631,19501,11064
22206,211,823,22206,0,22206,0,4.3104e+18,271.869,2854.81,22206,187,180,20926,19309,13585,13851,10792
44342,626,4553,44338,4,39613,4729,2.81029e+18,1268.1,10727.3,44342,451,465,37383,34286,20201,16675,6488
34830,2103,2822,20769,14061,20769,14061,1.86579e+18,1105.48,7531.28,34830,365,512,32008,31532,31534,31559,28173
27471,135,264,0,27471,27044,427,2.48455e+16,144.527,1777.9,27471,99,98,27135,26963,24779,24896,21007
30809,1596,2974,18854,11955,18854,11955,1.83519e+18,708.825,7102.79,30809,415,378,27835,27676,27050,27287,22952
14690,291,1392,0,14690,4326,10364,9.00246e+15,371.374,3465.48,14690,372,269,12718,11707,9076,8686,5320
20892,1387,3116,18796,2096,12339,8553,1.92223e+18,767.105,6447.66,20892,328,491,17776,17003,15253,15245,8601
9158,30,35,8976,182,9139,19,9.55259e+13,15.4209,338.689,9158,19,20,9123,9121,9000,9000,8809
1715,87,336,0,1715,487,1228,9.43382e+15,130.71,614.709,1715,101,67,1255,1083,986,1010,688
22743,255,2233,12985,9758,0,22743,4.60628e+18,486.629,5375.39,22743,272,385,19046,17303,10110,9625,3858
7267,418,1281,0,7267,0,7267,2.22782e+18,453.429,2547.19,7267,227,220,5616,4833,3968,3637,1996
33959,1800,2982,19761,14198,0,33959,4.81696e+18,603.528,7509.05,33959,474,396,30977,30884,28879,28376,25033
29510,1311,1899,0,29510,9360,20150,8.64166e+15,547.863,5704.19,29510,376,468,27611,27435,26592,26498,22184
25429,333,805,25423,6,25429,0,4.03317e+18,334.295,3078,25429,188,188,24532,24009,18318,17795,15719
16171,698,1475,4566,11605,0,16171,3.70208e+13,415.622,3690.93,16171,309,281,14696,14387,13685,13727,8977
28879,474,679,28828,51,28879,0,3.89771e+18,337.644,3098.09,28879,201,193,28200,28092,26238,26053,24892
30841,176,1556,8852,21989,0,30841,3.67989e+13,686.688,5256.51,30841,430,368,25928,22852,18323,17582,6470
7779,306,1505,4548,3231,0,7779,4.28623e+18,264.36,2768.22,7779,198,216,6253,5614,4069,3840,2546
46922,122,2155,15665,31257,0,46922,3.29557e+13,821.956,7191.21,46922,465,556,39382,35364,18679,7145,5834
10273,747,989,0,10273,3202,7071,7.03565e+15,133.401,2245.83,10273,218,132,9284,9284,9263,9263,8541
27935,1665,2047,8798,19137,0,27935,3.48084e+13,527.246,5811.55,27935,413,417,25888,25871,25712,25665,23943
39242,2567,2971,23331,15911,23331,15911,1.90469e+18,1087.63,8175.91,39242,501,396,36271,36256,35907,36109,34823
23947,1414,2254,21531,2416,14082,9865,1.89906e+18,487.307,5512.26,23947,364,272,21693,21588,16874,15923,14881
25679,1564,2615,14694,10985,0,25679,4.66193e+18,695.672,6282.47,25679,328,385,23064,22638,22409,22360,15490
47141,274,366,0,47141,46351,790,2.6924e+16,152.134,2726.99,47141,114,131,46775,46754,45297,45326,41623
16890,951,2217,10134,6756,0,16890,4.7494e+18,451.753,4727.1,16890,355,226,14673,14404,13006,12690,8556
14572,909,1434,0,14572,4543,10029,9.07042e+15,399.161,3590.42,14572,245,332,13138,12992,12760,12775,10860
21793,671,2018,12855,8938,0,21793,4.50755e+18,640.075,4978.17,21793,324,280,19465,17854,14919,14725,9938
22147,198,1833,0,22147,6738,15409,9.28789e+15,383.171,5013.59,22147,256,414,18908,16811,11620,11087,3598
5745,153,822,5745,0,5187,558,1.39992e+18,209.178,1750.42,5745,185,117,4480,3358,1926,1173,865
13051,1250,1869,11920,1131,7638,5413,1.98673e+18,497.054,3995,13051,250,272,11182,11131,10834,10971,8662
13975,198,1640,8100,5875,8100,5875,1.56529e+18,305.703,3695.97,13975,290,303,11377,10014,6172,6101,2822
48304,492,2760,0,48304,13674,34630,9.30112e+15,798.225,8341.06,48304,539,472,44188,41784,29069,25289,12762
15885,975,1270,4936,10949,0,15885,3.51382e+13,285.789,3263.4,15885,362,192,14615,14612,14398,14403,13603
14778,1463,1914,0,14778,0,14778,2.37759e+18,396.154,4144.3,14778,252,269,12864,12840,12744,12670,10299
6005,1126,1323,0,6005,0,6005,2.33337e+18,200.171,2362.49,6005,235,257,4682,4682,4680,4680,4114
35451,71,81,34910,541,35451,0,1.02321e+14,18.464,717.328,35451,28,29,35370,35370,34948,34949,33339
46368,536,844,46368,0,46368,0,4.06372e+18,341.028,4051.13,46368,220,229,45524,45425,42812,42646,39808
2410,87,95,0,2410,2338,72,2.69394e+16,45.5909,333.015,2410,38,38,2315,2314,2314,2315,2275
22972,507,529,22972,0,22972,0,4.14117e+18,303.662,2554.92,22972,178,175,22443,22443,22410,22419,22319
32210,266,582,32210,0,32210,0,4.12447e+18,340.545,3068.04,32210,199,202,31324,30617,24330,24068,20369
17668,335,2037,10561,7107,10561,7107,1.86913e+18,806.076,4705.33,17668,382,356,14283,12430,8599,7829,3187
29355,3689,4014,26290,3065,16912,12443,1.91682e+18,661.219,8254.35,29355,501,484,25341,25303,25311,25320,22915
36504,780,2428,0,36504,11012,25492,8.85347e+15,603.556,7086.14,36504,510,355,33828,33080,24096,25116,12097
27627,2806,2858,24796,2831,16640,10987,1.96769e+18,881.703,6850.81,27627,424,336,24769,24769,24765,24765,24715
4899,903,1164,0,4899,0,4899,2.48178e+18,204.267,1934.84,4899,186,142,3735,3617,3700,3681,3020
42871,18,68,42072,799,42871,0,9.93448e+13,22.4613,826.418,42871,29,27,42775,42733,38512,38086,27563
8011,2024,2099,8011,0,7313,698,2.7689e+18,279.396,3389.13,8011,252,177,5912,5912,5912,5907,5868
39712,64,1392,10994,28718,0,39712,3.70032e+13,803.16,5379.3,39712,391,342,29354,24705,20419,11522,4941
11652,1568,1673,6898,4754,6898,4754,1.84734e+18,306.351,3479,11652,259,230,9979,9979,9976,9969,9839
20314,1527,1945,5526,14788,0,20314,3.77707e+13,347.23,4900.56,20314,245,351,18369,18364,18228,18217,16970
28952,186,2993,17037,11915,0,28952,4.96698e+18,872.153,7138.59,28952,489,490,22049,18579,13927,11750,2226
21436,3,259,0,21436,21030,406,2.63443e+16,113.439,1593.11,21436,94,86,14534,12275,11226,10133,7269
5927,230,447,5927,0,5927,0,4.30026e+18,210.109,1308.26,5927,118,105,5449,5141,4428,4374,3783
41664,1496,2514,11924,29740,0,41664,3.69307e+13,731.266,7534.09,41664,585,517,39150,38753,37408,37469,32503
12211,491,1234,3879,8332,0,12211,3.57427e+13,374.63,3156.98,12211,285,379,10932,10565,9999,9790,6291
3942,842,980,3942,0,3530,412,2.9733e+18,372.124,1717.4,3942,143,167,2962,2805,2962,2962,2867
3773,41,379,3773,0,3773,0,4.25428e+18,189.146,983.36,3773,96,90,2412,1550,1034,904,622
35227,1709,2083,0,35227,10686,24541,9.11411e+15,646.035,6268.53,35227,419,401,33144,33130,32924,32886,30880
20995,911,1944,0,20995,0,20995,2.37681e+18,1083.85,5068.81,20995,385,378,18219,16663,16388,13627,11641
12571,89,467,12571,0,12571,0,3.87636e+18,235.181,1802.29,12571,153,140,10624,7671,5578,5013,2893
1347,641,651,1221,126,884,463,1.68034e+18,79.7008,865.568,1347,141,98,696,696,696,696,696
28628,228,739,28592,36,28628,0,4.1663e+18,348.343,3121.05,28628,190,191,27143,25341,17864,17211,14101
47609,119,2013,14401,33208,0,47609,3.58207e+13,656.716,6866.3,47609,432,425,38791,33943,25892,19053,6736
4786,525,635,2449,2337,0,4786,3.63559e+18,120.13,1310.04,4786,178,116,4151,4149,4144,4147,4003
31939,237,3544,28338,3601,19766,12173,1.9483e+18,731.397,7889.9,31939,406,473,22760,17823,10401,9181,1722
12810,1043,1178,4025,8785,0,12810,3.62284e+13,350.029,2987.28,12810,283,212,11632,11632,11606,11603,11266
23156,471,819,23156,0,23156,0,4.0822e+18,334.206,2963.4,23156,188,185,22337,22174,19254,19162,18666
33784,487,2947,0,33784,0,33784,2.30997e+18,916.896,7365.05,33784,480,405,29315,26281,21252,16148,8076
8513,1655,1880,5096,3417,0,8513,5.23678e+18,269.648,3169.62,8513,184,275,6633,6629,6598,6616,6302
12673,345,504,12673,0,12673,0,4.09106e+18,288.193,1900.87,12673,147,140,12165,11951,11098,11072,10730
16292,18,36,15988,304,16292,0,9.97052e+13,18.3272,433.243,16292,22,21,16244,16225,15001,14788,11884
5227,20,26,5161,66,5227,0,1.05547e+14,16.9198,232.265,5227,18,20,5199,5193,5041,5042,4856
18839,6,50,18549,290,18839,0,1.03467e+14,16.0948,522.076,18839,22,23,18262,17627,15800,15659,8461
44812,42,72,43983,829,44812,0,1.02422e+14,19.2588,803.609,44812,28,29,44740,44738,43520,43532,36719
8542,453,516,8542,0,8542,0,3.9728e+18,256.521,1630.22,8542,124,131,8026,8025,7962,7961,7907
48209,335,343,0,48209,47232,977,2.48553e+16,148.048,2731.54,48209,116,134,47866,47866,47860,47811,47680
44818,699,2888,26379,18439,0,44818,4.76994e+18,1232.23,8199.84,44818,462,423,39995,37914,25302,23145,10817
17985,909,1221,5168,12817,0,17985,3.62824e+13,419.34,3352.24,17985,309,277,16764,16662,16111,16116,14406
33638,370,3168,29829,3809,19951,13687,1.91692e+18,895.683,7778.64,33638,515,360,27325,21593,14353,12139,7180
7540,713,1367,0,7540,0,7540,2.15683e+18,229.964,2630.18,7540,254,172,6173,6063,5635,5153,4453
27172,2281,2932,27172,0,24654,2518,2.45825e+18,780.407,6800.35,27172,357,363,24240,24229,23855,23610,22023
27041,181,301,0,27041,26599,442,2.67329e+16,130.035,1900.81,27041,96,98,26740,26655,25399,25351,22662
4906,3,25,4819,87,4896,10,9.15685e+13,14.7318,228.56,4906,17,18,4124,3726,3650,3545,2301
1639,161,365,0,1639,543,1096,9.89478e+15,69.2935,658.245,1639,74,100,1274,1212,1206,1200,702
34916,212,839,34916,0,34891,25,4.20564e+18,328.282,3485.19,34916,211,212,33337,30927,20554,19413,16418
47881,504,3751,42405,5476,28858,19023,1.95731e+18,1457.67,10282.1,47881,513,496,38614,32796,22659,19837,11090
31270,1411,2221,0,31270,9410,21860,8.69799e+15,450.334,6214.54,31270,459,312,29049,28980,28054,28059,23456
49007,139,140,47955,1052,49007,0,1.06406e+14,17.5192,1033.71,49007,30,35,48867,48867,48787,48787,48807
24119,1900,3637,24119,0,21345,2774,1.4253e+18,438.175,7362.05,24119,241,633,20482,20398,19272,19409,14174
46956,1133,4042,28324,18632,28324,18632,1.84418e+18,1009.19,10058.5,46956,563,462,42379,40698,31127,26197,15726
43500,10,346,0,43500,42550,950,2.49469e+16,153.574,2608.02,43500,111,129,38059,34675,31195,26075,15832
24626,637,1516,6908,17718,0,24626,3.63992e+13,495.161,4516.16,24626,400,273,23036,22589,20492,20643,13591
29608,2196,3694,25959,3649,17361,12247,1.9738e+18,998.236,8079.03,29608,433,558,25914,25315,24436,24759,18424
40230,590,3995,36192,4038,23546,16684,1.94692e+18,1495.37,9694.16,40230,563,540,33423,29819,17201,17293,7351
27135,1238,2427,0,27135,0,27135,2.37135e+18,778.025,6051.83,27135,481,356,24708,23987,20965,17128,18982
18957,648,2093,11560,7397,11560,7397,1.85677e+18,550.294,4773.04,18957,339,352,16710,16124,12995,12572,6245
43725,1483,2613,0,43725,0,43725,2.3088e+18,1102.21,7925.87,43725,447,424,41006,39886,37366,32063,29896
34241,1030,3134,30325,3916,20026,14215,1.93315e+18,975.493,7654.14,34241,407,464,30740,29595,27590,26566,17574
3585,97,380,3585,0,3585,0,4.31972e+18,174.042,954.587,3585,91,80,2882,2312,1694,1548,999
31076,30,68,30610,466,31076,0,1.01047e+14,15.8611,675.151,31076,25,27,31008,31008,29312,29194,21297
5183,116,1154,0,5183,0,5183,2.24972e+18,231.333,2065.04,5183,228,138,3485,2794,1424,1425,447
24343,4,7,22822,1521,24247,96,0.000246477,0.999712,407.805,24343,7,1,24336,24336,24336,24336,24336
7443,119,152,0,7443,7197,246,2.53069e+16,60.0603,698.519,7443,45,55,7291,7281,7205,7191,6881
35249,1070,1125,35249,0,35249,0,4.3369e+18,354.916,3899.09,35249,218,220,34124,34124,34111,34114,34090
30358,154,262,0,30358,29836,522,2.62307e+16,109.091,1859.61,30358,94,96,30096,30056,28757,28516,24779
5231,18,33,5125,106,5231,0,1.04713e+14,16.5062,262.523,5231,20,21,5191,5178,4922,4923,4496
24455,1742,2594,24455,0,22016,2439,2.30959e+18,1081.07,6275.3,24455,380,412,21861,21044,20614,20550,19167
3572,61,125,0,3572,3533,39,2.73142e+16,42.2889,471.358,3572,38,49,3444,3410,3206,3270,2351
31172,520,624,31172,0,31172,0,4.16437e+18,323.563,3088.29,31172,194,192,30548,30548,30213,30208,29912
41216,1557,2009,0,41216,12170,29046,8.92425e+15,705.234,6538.21,41216,458,388,39207,39137,39019,38992,36037
15190,5,40,14860,330,15190,0,1.01342e+14,17.7539,438.216,15190,22,23,14281,13408,12249,12346,7253
23856,1433,1912,6792,17064,0,23856,3.69675e+13,537.94,5159.36,23856,311,369,21944,21920,21663,21636,18334
7444,100,441,7444,0,7444,0,4.51208e+18,212.692,1438.73,7444,115,121,6292,4962,3118,3057,2327
19478,752,2211,11694,7784,11694,7784,1.77997e+18,591.813,5108.46,19478,301,295,17022,16263,15345,14454,8369
37329,1701,3948,37329,0,33602,3727,2.26599e+18,1002.51,9262.66,37329,524,395,33381,31703,30346,29141,22065
29195,281,2517,0,29195,0,29195,2.38609e+18,642.843,6439.79,29195,435,297,23375,19076,12406,11162,6638
23061,920,1737,7377,15684,0,23061,3.4293e+13,417.539,4780.31,23061,266,326,21324,21061,19506,19612,15205
46253,196,316,0,46253,45352,901,2.57677e+16,156.533,2479.46,46253,123,121,45922,45830,42963,42698,37655
25444,650,884,25426,18,25444,0,4.15437e+18,335.658,3181.5,25444,196,203,24560,24553,23544,23540,23549
26201,2021,3250,15824,10377,15824,10377,1.92313e+18,599.658,7004.68,26201,434,528,22951,22912,22052,22401,13598
30441,91,775,30441,0,30416,25,4.08077e+18,357.598,3285.97,30441,197,198,25141,19826,14026,12364,6135
10373,23,33,10171,202,10373,0,1.02491e+14,14.8482,338.362,10373,19,19,10340,10338,9811,9813,8372
10470,13,29,10318,152,10470,0,9.70782e+13,14.3272,371.277,10470,18,19,10416,10374,9690,9659,8464
35669,1500,2349,22400,13269,22400,13269,1.80746e+18,704.292,6536.78,35669,379,442,33320,32940,32427,32478,25868
21406,2130,2154,0,21406,0,21406,2.24535e+18,422.692,4922.05,21406,262,356,19252,19252,19252,19252,19151
47980,2090,4696,43020,4960,28834,19146,1.98401e+18,1491.78,11260.3,47980,545,610,43284,41341,38890,38492,25028
42093,1598,2782,25776,16317,25776,16317,1.86313e+18,735.821,7986.55,42093,469,405,39311,39138,36249,35522,25508
16223,57,235,0,16223,15924,299,2.59307e+16,102.198,1306.56,16223,82,88,15602,15040,13187,12351,7967
5003,1208,1296,4390,613,2961,2042,1.98308e+18,354.294,2218.34,5003,177,193,3707,3707,3702,3705,3627
28508,791,4150,28508,0,25696,2812,2.20586e+18,737.376,8509.09,28508,428,558,23878,21915,11636,9697,8024
35685,883,3349,21743,13942,0,35685,4.75155e+18,598.675,8179.29,35685,412,448,32292,31681,24794,23685,17216
31361,184,279,0,31361,30921,440,2.54354e+16,142.514,1909.45,31361,108,100,31082,30942,29443,29316,26792
1296,251,258,1296,0,1187,109,1.66254e+18,133.165,528.011,1296,92,61,1038,1037,1033,1037,1038
15385,192,676,15360,25,15385,0,4.15761e+18,258.72,2320.6,15385,155,164,14138,12672,8755,8074,6537
20230,90,701,20224,6,20230,0,4.29616e+18,288.687,2636.1,20230,176,168,16369,12613,8824,8300,3931
562,22,45,0,562,538,24,2.17968e+16,21.0249,122.163,562,20,25,508,487,475,451,424
37732,465,998,37732,0,37732,0,4.38207e+18,378.172,3898.97,37732,218,217,36734,36408,26836,26152,26436
3151,538,794,1812,1339,1812,1339,1.76803e+18,128.901,1372.45,3151,145,104,2357,2338,2266,2155,1740
40271,1076,3717,40271,0,35690,4581,2.30034e+18,988.747,9218.53,40271,365,492,36097,34721,16931,12044,12647
30277,1899,2992,18168,12109,18168,12109,1.83021e+18,857.425,7063.77,30277,448,438,27285,26977,26284,26037,22971
20447,782,2295,12591,7856,12591,7856,1.84263e+18,516.866,5210.9,20447,363,306,18009,16939,14475,15033,10854
33600,1,54,32965,635,33600,0,1.00602e+14,18.8398,639.646,33600,25,24,13761,13761,13761,13761,13761
20093,2991,3233,20093,0,17981,2112,1.20564e+18,749.025,6501.56,20093,342,354,16860,16794,16791,16801,16024
43744,988,2618,13328,30416,0,43744,3.62589e+13,752.85,7800.4,43744,535,527,40915,40268,33779,33773,22199
4175,422,1271,4175,0,3788,387,2.72668e+18,150.178,1945.52,4175,194,141,2904,2687,2422,2290,1666
27169,536,1252,0,27169,8193,18976,8.2981e+15,574.447,3988.83,27169,293,231,25664,24483,23415,23640,16190
26725,1767,2379,16237,10488,0,26725,4.82732e+18,927.144,6140.62,26725,401,410,24346,23720,23442,23047,20297
47797,72,3943,0,47797,0,47797,2.29149e+18,1220.2,10283.1,47797,527,536,29954,21591,16235,10236,1575
47305,1893,3448,47305,0,42041,5264,2.34378e+18,1192.57,9358.19,47305,564,381,43857,42750,42386,40495,32969
39056,161,3609,23457,15599,23457,15599,1.83475e+18,728.834,8786.7,39056,589,376,28512,23223,15742,12523,2453
27174,1836,2134,7959,19215,0,27174,3.535e+13,498.367,5767.98,27174,273,408,25040,25035,24970,24955,23920
513,201,233,446,67,338,175,1.92992e+18,21.2827,314.848,513,58,59,280,280,275,276,249
45459,268,323,0,45459,44789,670,2.57137e+16,154.733,2479.42,45459,125,112,45136,45133,44791,44747,44027
31039,650,1629,9398,21641,0,31039,3.59875e+13,575.29,5129.36,31039,363,374,29244,28153,25976,26168,18105
38400,2259,3512,38400,0,34779,3621,2.25326e+18,1244.68,8726.42,38400,474,448,34888,34724,33205,32661,28968
27587,1150,1880,0,27587,8384,19203,8.33053e+15,518.056,5309.61,27587,305,387,25707,25496,25019,24942,20169
34244,278,352,0,34244,33671,573,2.62883e+16,134.709,2331.04,34244,107,115,33892,33883,33060,32762,30860
30650,116,2736,30650,0,27244,3406,2.45598e+18,1333.82,7028.48,30650,414,370,19871,15181,6898,3386,2193
19179,78,2098,11342,7837,0,19179,4.74421e+18,810.918,4970.08,19179,336,355,12889,9493,6445,6233,1326
47972,2701,3611,28643,19329,0,47972,4.74745e+18,1176.73,9898.33,47972,583,499,44361,44325,43323,43138,36981
13619,1160,1248,3843,9776,0,13619,3.65288e+13,400.588,3153.23,13619,266,270,12371,12308,12284,12286,12146
45946,254,2950,27505,18441,0,45946,4.82799e+18,788.594,8150.21,45946,489,495,38424,31437,24496,22004,9942
20444,99,544,20444,0,20444,0,4.15744e+18,254.908,2453.28,20444,155,170,17952,14374,9096,9332,3695
34270,3433,3573,34270,0,30648,3622,2.14892e+18,730.4,8130.79,34270,502,367,30697,30697,30695,30684,30057
43368,387,987,43368,0,43368,0,4.13644e+18,404.928,4158.37,43368,237,236,42195,41489,30019,28783,23891
26754,1360,1533,7576,19178,0,26754,3.80209e+13,722.762,4744.79,26754,345,308,25221,25221,25174,25180,24700
15573,225,2022,15573,0,13676,1897,2.81384e+18,734.121,4381.89,15573,368,332,11388,8832,5178,2622,1930
28202,356,3210,25253,2949,16415,11787,1.93867e+18,800.62,7608.23,28202,329,495,21985,18304,11282,9676,3936
40692,2439,3428,36592,4100,24576,16116,1.9089e+18,944.016,8644.97,40692,440,470,37264,37085,36230,36340,31483
39625,361,5082,39625,0,35880,3745,2.32247e+18,1134.87,10852.5,39625,577,643,30730,25359,12473,8114,4598
25739,244,2798,15059,10680,15059,10680,1.79849e+18,803.238,6424.43,25739,400,350,20579,17557,13336,11456,4268
20321,1269,2614,11910,8411,0,20321,4.42207e+18,522.914,5642.79,20321,340,331,17707,17406,15414,15202,11667
39506,3030,3774,23377,16129,0,39506,4.79317e+18,997.806,9383.89,39506,571,565,35732,35555,34972,34794,31978
6591,770,1309,3742,2849,0,6591,4.45322e+18,185.607,2303.46,6591,190,172,5282,5192,5162,5174,4085
22444,755,2322,22444,0,20133,2311,3.12758e+18,740.076,5392.49,22444,351,324,19907,18055,11947,10375,11325
4273,55,621,2503,1770,2503,1770,1.72649e+18,245.949,1347.1,4273,133,120,2674,2043,1665,1272,473
28104,2327,3142,0,28104,0,28104,2.4808e+18,756.282,7046.94,28104,434,331,24962,24745,24599,24514,20987
17537,259,1219,0,17537,5094,12443,9.05792e+15,523.799,3414.22,17537,275,247,15419,13517,10614,10890,6399
6567,129,943,1915,4652,0,6567,3.59292e+13,279.564,2058.1,6567,222,261,5168,4536,4033,4102,1415
16687,9,32,16455,232,16687,0,1.02186e+14,15.497,423.592,16687,21,20,16519,16408,14509,14122,10805
32470,1795,1967,10633,21837,0,32470,3.19191e+13,452.913,5670.79,32470,356,294,30503,30503,30379,30386,29831
48601,64,82,47664,937,48589,12,1.00738e+14,21.9697,902.441,48601,28,32,48519,48517,47612,47614,44332
30052,1315,2742,18254,11798,18254,11798,1.82514e+18,777.86,6858.83,30052,431,431,27310,26532,24923,24608,15098
25020,1,45,24432,588,25020,0,9.6109e+13,17.7853,546.516,25020,23,24,10395,10395,10395,10395,10395
32889,2454,3345,29379,3510,19879,13010,1.99869e+18,998.84,7932.2,32889,453,402,29544,29079,29110,29220,26327
1116,41,532,670,446,670,446,1.75374e+18,42.7823,691.714,1116,130,64,547,328,299,290,123
45384,418,5203,45384,0,40814,4570,2.58761e+18,1026.99,11520.3,45384,619,461,37411,32367,19371,16330,6058
23398,332,655,23398,0,23398,0,4.15048e+18,324.246,2781.3,23398,186,188,22640,22308,18725,18325,14300
7121,1262,2057,6398,723,4273,2848,2.05441e+18,269.092,3206.75,7121,246,253,5064,4965,4739,4779,3302
44361,3976,4452,39266,5095,26493,17868,1.98102e+18,1164.25,10550.9,44361,534,565,39909,39892,39848,39841,39169
13219,932,2674,13219,0,11730,1489,1.87246e+18,507.173,4876.56,13219,294,377,10545,9987,6810,6445,5674
43286,1574,2467,25349,17937,0,43286,4.69216e+18,1397.56,8029.29,43286,488,554,40444,39006,37554,36959,31865
33360,3050,4077,19228,14132,19228,14132,1.77757e+18,469.708,8828.86,33360,301,732,29283,29278,28755,28920,24497
11155,41,1033,0,11155,3509,7646,9.3874e+15,428.122,2781.86,11155,234,270,7583,6060,4789,4816,1352
44079,2423,3724,25683,18396,25683,18396,1.83853e+18,843.58,9352.84,44079,604,455,40355,40290,38770,38472,33767
17305,1326,2160,10356,6949,0,17305,4.90318e+18,591.567,4792.57,17305,352,406,15145,14956,14015,13814,10639
23461,183,2370,0,23461,0,23461,2.43228e+18,1018.39,5891.88,23461,388,387,17558,14758,10184,8406,1572
25340,33,43,24762,578,25340,0,9.49176e+13,17.9013,582.659,25340,21,25,25297,25297,24217,24219,19997
30470,1750,2027,0,30470,8489,21981,9.58268e+15,561.628,5958.59,30470,336,424,28443,28422,28333,28319,27617
10396,400,1477,6298,4098,0,10396,4.79058e+18,461.34,3148.64,10396,228,268,8482,7182,6372,6321,3413
7426,120,1276,0,7426,0,7426,2.40734e+18,301.712,2471.87,7426,224,223,5245,4362,3514,3037,687
48672,2660,3635,29018,19654,0,48672,4.95924e+18,1247.67,9731.04,48672,621,476,45037,44388,43252,42951,38808
2993,79,782,1794,1199,1794,1199,2.09764e+18,133.078,1238.51,2993,132,103,2031,1688,1246,1129,179
22774,291,1940,14317,8457,14317,8457,1.83551e+18,456.767,4785.48,22774,275,299,18474,14180,10878,9525,4819
31131,7,595,31071,60,31131,0,4.15697e+18,326.885,3067.01,31131,199,202,10263,3889,3406,3371,830
1536,30,503,934,602,0,1536,5.24895e+18,75.4408,755.635,1536,104,95,880,669,576,556,91
17038,1438,2398,15147,1891,10059,6979,2.00111e+18,514.278,4921.41,17038,368,276,14640,14492,13565,13776,8444
5256,119,1203,0,5256,0,5256,2.52893e+18,205.679,2053.44,5256,201,140,3637,3167,2175,1624,920
24157,877,1759,0,24157,7605,16552,8.94986e+15,533.997,4912.89,24157,329,362,22398,21877,20916,21050,16113
15367,341,1257,0,15367,4472,10895,9.54575e+15,377.571,3314.57,15367,257,221,13930,12528,11006,11139,6627
37070,659,3069,0,37070,0,37070,2.39499e+18,1062.62,7920,37070,499,483,32853,31001,22851,22390,8329
24061,1838,2636,24061,0,21444,2617,2.24667e+18,1006.55,6125.55,24061,346,342,21425,20726,21037,21012,19148
2894,41,128,0,2894,2847,47,2.99784e+16,41.3721,450.528,2894,46,45,2749,2652,2378,2344,1752
34181,257,3936,20236,13945,0,34181,4.80731e+18,787.08,8670.33,34181,539,458,27154,23213,15399,12991,4925
8364,707,1427,7577,787,4978,3386,1.88271e+18,474.105,2920.66,8364,206,200,6835,6204,5676,5605,4611
4479,809,971,2633,1846,2633,1846,1.90716e+18,214.833,1759.23,4479,134,223,3508,3508,3433,3441,3053
38570,143,285,0,38570,37647,923,2.60357e+16,154.446,2208.22,38570,101,112,38211,38060,35022,34185,27585
2504,15,18,2468,36,2504,0,9.74598e+13,12.0459,143.267,2504,14,14,2486,2485,2440,2440,2432
37149,198,287,0,37149,36389,760,2.51035e+16,141.217,2113.58,37149,97,119,36862,36829,35429,35142,31824
46453,876,3688,41455,4998,27982,18471,1.95892e+18,1660.14,10136.3,46453,535,501,39961,36499,25310,25038,13859
35741,245,265,0,35741,35193,548,2.6028e+16,135.836,2189.2,35741,94,110,35476,35476,35464,35418,34926
22744,27,2421,22744,0,20466,2278,1.97734e+18,757.667,5878,22744,344,346,9810,5226,3494,1591,322
24901,2026,2460,0,24901,0,24901,2.08277e+18,508.897,5370.97,24901,263,326,22441,22431,22344,22435,21522
15543,10914,15543,15543,0,0,15543,268418000,0,15543,15543,15543,1,0,0,0,0,0
38019,661,4299,33829,4190,22845,15174,1.95673e+18,1244.03,9566.84,38019,479,494,31951,29486,16125,15192,7889
36853,3486,4223,33399,3454,22290,14563,1.93559e+18,1019.56,9364.2,36853,488,462,32630,32559,32279,32329,29083
31058,360,759,31058,0,31058,0,4.86545e+18,331.968,3229.96,31058,193,198,30274,29826,23808,23141,23288
42570,2000,2340,12643,29927,0,42570,3.60608e+13,626.819,6962.05,42570,518,359,40230,40200,40061,40053,39315
14435,56,1629,0,14435,0,14435,2.31716e+18,683.792,3805.1,14435,248,306,8627,6152,5106,2398,178
7667,112,173,0,7667,7537,130,2.45581e+16,92.0146,812.916,7667,57,68,7480,7414,6996,7035,6326
4009,18,841,2512,1497,0,4009,4.55069e+18,223.954,1541.88,4009,163,129,1821,936,973,896,91
26860,696,2420,0,26860,0,26860,2.36721e+18,524.469,5918.92,26860,420,375,24224,23599,14041,12965,11725
21913,615,2591,19955,1958,13610,8303,1.9754e+18,549.431,5516.79,21913,358,278,19261,17610,14810,14099,11386
16511,73,468,16511,0,16511,0,4.22283e+18,244.883,2097.55,16511,149,146,12842,8402,6518,5948,2867
40571,2363,2875,0,40571,12487,28084,8.66358e+15,676.378,8000.88,40571,352,704,37696,37693,37530,37484,35639
6247,21,30,6165,82,6247,0,9.88567e+13,13.263,260.379,6247,17,19,6217,6215,5986,6005,5650
22583,458,1813,0,22583,6791,15792,9.2617e+15,435.624,4982.42,22583,307,332,20445,19391,17241,17009,8607
10930,19,36,10827,103,10930,0,1.02186e+14,16.1707,365.128,10930,19,20,10893,10884,10186,10118,8134
26681,732,3454,26681,0,23822,2859,2.89693e+18,699.98,7348.08,26681,346,404,22902,21344,12806,10956,8419
1794,104,449,1794,0,1576,218,2.10998e+18,221.036,806.742,1794,89,97,1039,739,505,407,387
47416,297,347,0,47416,46336,1080,2.55461e+16,164.04,2663.1,47416,115,130,47069,47054,46380,46235,45060
530,221,231,530,0,454,76,3.1763e+18,28.4792,309.046,530,36,35,299,299,299,299,299
41954,1309,2005,13595,28359,0,41954,3.52422e+13,368.178,5651.13,41954,391,309,39949,39925,38363,38418,34704
4570,93,105,0,4570,4549,21,2.578e+16,30.5687,434.345,4570,36,42,4465,4464,4456,4456,4404
42134,902,1852,0,42134,13272,28862,8.23787e+15,668.462,6268.58,42134,366,427,40094,39518,37339,37472,22691
27656,934,2704,0,27656,0,27656,2.14557e+18,897.434,6166.1,27656,366,340,24439,23467,17923,16749,7058
34825,190,226,0,34825,34330,495,2.50159e+16,137.788,1750.33,34825,99,95,34599,34547,34332,34046,33602
49095,306,4341,44261,4834,29511,19584,1.99032e+18,1501.66,10798.4,49095,487,547,38135,30816,17308,14976,8035
16976,7,46,16593,383,16976,0,1.00795e+14,16.3805,468.058,16976,23,23,16571,16383,14298,14100,8450
23930,511,1786,0,23930,7296,16634,9.14215e+15,638.758,4966.64,23930,383,412,21710,20729,18279,18390,10807
8846,492,510,8846,0,8846,0,4.07685e+18,237.68,1655.9,8846,125,138,8336,8334,8328,8328,8311
36988,674,1694,10744,26244,0,36988,3.47689e+13,676.845,5764.04,36988,435,361,34970,33259,32370,32540,17666
48331,17,299,0,48331,47607,724,2.70245e+16,144.707,2415.27,48331,112,117,44545,42578,36510,30199,17776
43808,399,1069,43783,25,43808,0,4.04955e+18,385.052,4232.02,43808,235,238,42665,42042,32795,32125,30384
11406,943,1046,3570,7836,0,11406,3.49243e+13,341.426,2713.31,11406,224,229,10360,10350,10335,10338,10116
5233,179,1228,3056,2177,0,5233,4.79974e+18,205.911,2176.05,5233,148,243,3849,3353,3032,3020,850
22346,17,683,22346,0,22346,0,4.16311e+18,331.137,2770.1,22346,179,182,10610,5035,4317,3845,865
16702,1182,1835,10103,6599,10103,6599,1.83817e+18,918.974,4415.01,16702,335,322,14684,13581,13739,13481,11650
29510,2155,3109,0,29510,0,29510,2.33319e+18,863.646,7208.41,29510,492,577,26401,26284,25833,25735,20329
47972,907,2181,0,47972,13527,34445,9.75153e+15,826.102,7117.6,47972,471,351,45619,43607,38875,39170,25350
46557,577,1342,0,46557,14843,31714,7.34017e+15,774.207,5342.43,46557,366,325,44283,42850,39374,39771,22654
40153,161,893,40153,0,40153,0,4.1183e+18,376.618,3853.06,40153,221,221,36671,32363,21495,20315,11906
37621,371,654,37609,12,37621,0,3.86334e+18,328.614,3381.02,37621,193,207,36928,36660,30468,30258,26448
14916,2802,2975,13333,1583,8817,6099,1.99519e+18,497.157,5377.74,14916,261,383,11941,11940,11933,11934,11431
17853,385,1970,0,17853,0,17853,1.98477e+18,321.597,4374.67,17853,300,281,15739,14597,12034,9895,6142
43003,1744,3827,0,43003,0,43003,2.32886e+18,1130.92,9679.49,43003,425,572,39113,37992,35865,35165,22690
16301,2217,2837,9755,6546,9755,6546,1.93445e+18,525.075,5469.72,16301,368,470,13464,13425,13196,13290,11606
16618,1,45,16256,362,16618,0,1.05287e+14,16.9962,461.956,16618,23,23,6537,6537,6537,6537,6537
38679,77,285,0,38679,37763,916,2.56456e+16,145.562,2110.23,38679,103,108,37869,37007,33001,30627,23012
31855,706,2921,28828,3027,19091,12764,1.94267e+18,799.537,7113.85,31855,347,347,28413,26692,16220,14924,10790
6336,58,772,0,6336,2108,4228,8.54731e+15,161.408,1723.39,6336,155,138,4796,3994,2744,2649,1294
33703,2795,4662,33703,0,29915,3788,1.83444e+18,1066.75,9755.21,33703,550,502,29041,28760,28077,27790,23542
22027,2047,2662,0,22027,0,22027,2.41275e+18,530.434,5741.69,22027,435,330,19365,19332,19196,19311,17454
11181,490,2081,0,11181,0,11181,2.29045e+18,310.972,3900.67,11181,318,193,8978,8187,5409,4187,1961
12083,14,25,11818,265,12083,0,9.27381e+13,15.9676,341.785,12083,18,20,12039,12014,11203,11197,9861
11613,1386,1597,6966,4647,0,11613,4.97176e+18,423.212,3441.98,11613,304,238,10016,9908,9862,9851,9589
24080,245,2412,21295,2785,14298,9782,1.96623e+18,917.376,5898.73,24080,326,289,18137,14012,9762,7967,4307
17866,40,217,0,17866,17565,301,2.5486e+16,99.7194,1388.12,17866,80,74,17239,16852,14751,13372,8129
47449,325,1070,47449,0,47449,0,4.07399e+18,373.712,4398.68,47449,237,230,46107,45050,31855,30862,27137
29944,1886,2038,0,29944,8848,21096,9.1514e+15,650.522,5948.4,29944,382,386,27906,27901,27866,27848,26969
1574,48,96,0,1574,1531,43,2.82463e+16,29.8933,275.496,1574,36,28,1478,1456,1354,1403,1153
40613,248,2268,11737,28876,0,40613,3.75489e+13,745.995,7061.47,40613,538,385,34978,31679,22102,16067,6642
36132,599,2855,20853,15279,0,36132,4.5749e+18,964.395,7533.31,36132,446,341,31884,29985,18129,15752,9118
29796,3102,3704,26893,2903,17790,12006,1.94537e+18,1048.54,8230.94,29796,445,457,26092,26043,25813,25827,23443
41858,375,1817,0,41858,13043,28815,9.22885e+15,646.412,6223.29,41858,399,447,38292,34895,26431,26988,16259
5367,249,1264,3074,2293,3074,2293,1.57323e+18,165.313,2165.34,5367,287,163,4061,3746,1781,2000,973
46256,661,2574,13753,32503,0,46256,3.55988e+13,896.298,7959.77,46256,541,505,42976,41605,35608,35744,16948
16781,101,2159,0,16781,0,16781,2.22107e+18,537.255,4718.28,16781,245,379,11880,9009,5896,5026,666
16784,541,1544,0,16784,4806,11978,9.45894e+15,423.322,3956.74,16784,250,259,15037,14446,13885,13989,7737
32175,14,62,31675,500,32134,41,1.03168e+14,18.0721,730.873,32175,26,26,32026,31916,29216,29109,19418
15634,117,234,0,15634,15367,267,2.72302e+16,103.336,1299.04,15634,84,78,15377,15269,14080,13853,11332
26650,1438,1612,0,26650,7951,18699,9.55763e+15,666.327,4777.65,26650,317,325,25038,25038,25005,25001,24550
47406,166,333,0,47406,46622,784,2.57034e+16,157.614,2551.9,47406,113,123,47007,46817,42743,43406,36467
38169,588,2758,0,38169,11908,26261,8.6071e+15,640.832,7636.79,38169,468,437,35050,33800,27961,27702,11628
20360,1255,3197,20360,0,18342,2018,2.62838e+18,411.007,6136.97,20360,323,310,17163,16784,15902,15136,6985
3395,1009,1030,0,3395,0,3395,2.32592e+18,190.257,1644.32,3395,198,137,2365,2365,2365,2365,2359
42471,3439,4003,38289,4182,23853,18618,1.89851e+18,1081.74,9572.06,42471,499,512,38468,38452,37976,37829,32241
16375,4,50,16006,369,16375,0,1.03463e+14,18.7586,447.855,16375,24,23,14667,13616,12725,12834,7870
20534,859,1655,0,20534,5809,14725,9.39797e+15,415.197,4461.19,20534,310,331,18879,18664,18366,18340,12493
4328,60,652,2747,1581,2747,1581,1.76341e+18,319.393,1406.97,4328,155,153,2397,1803,1317,1060,70
24935,243,1899,0,24935,6874,18061,9.58137e+15,490.767,5247.23,24935,326,418,21758,19520,17215,17712,4298
40822,3146,3933,40797,25,36151,4671,2.76421e+18,1268.42,9675.51,40822,451,468,36889,36815,36889,36889,34381
7060,281,452,7060,0,7060,0,3.86674e+18,234.263,1412.82,7060,109,117,6600,6402,5703,5710,5144
10351,499,1856,9280,1071,6262,4089,1.89239e+18,430.317,3545.76,10351,284,237,8350,7159,6363,6169,3175
15708,16,213,0,15708,15455,253,2.64276e+16,104.344,1250.9,15708,72,80,14427,13784,11790,9334,5905
23102,1096,2238,0,23102,0,23102,2.35451e+18,888.487,5436.23,23102,400,403,20689,19488,18868,15537,12803
46103,115,1134,46093,10,46103,0,4.18978e+18,403.88,4415.7,46103,240,233,39681,32556,21003,19479,8622
47943,84,87,46903,1040,47937,6,9.85397e+13,30.6777,905.716,47943,33,31,47856,47856,47277,47277,47253
31964,900,3456,18738,13226,18738,13226,1.80144e+18,652.57,8009.97,31964,352,651,28241,27239,25142,24281,9573
14917,52,195,0,14917,14647,270,2.55683e+16,66.8547,1070.37,14917,63,70,14622,14430,13121,12217,10308
27085,2385,2831,0,27085,0,27085,2.39163e+18,964.703,6798.7,27085,397,432,24254,24248,24088,24175,22202
22443,1558,1839,6841,15602,0,22443,3.61058e+13,440.064,4889.97,22443,413,277,20604,20600,20449,20455,19107
16484,616,1782,0,16484,4769,11715,9.67484e+15,358.501,4252.53,16484,232,392,14702,14257,13260,13361,7499
4922,312,1479,4922,0,4445,477,2.74107e+18,302.322,2371.01,4922,199,183,3122,2670,1410,1298,1045
25275,1410,1428,0,25275,7905,17370,8.89066e+15,402.82,4336.33,25275,278,345,23847,23847,23843,23846,23837
35312,252,876,35312,0,35312,0,4.00142e+18,338.296,3609.21,35312,217,212,33818,32290,25053,24599,20296
48035,1938,2327,13714,34321,0,48035,3.7278e+13,935.254,7487.49,48035,514,483,45708,45702,45486,45551,42235
40138,3658,3661,23429,16709,0,40138,4.59374e+18,1071.82,9009.79,40138,489,513,36477,36477,36477,36477,36477
28570,1579,1694,8034,20536,0,28570,3.63017e+13,564.537,5105.72,28570,364,287,26876,26872,26862,26860,26564
3153,47,120,0,3153,3075,78,2.41335e+16,47.8332,418.632,3153,43,45,2999,2923,2690,2778,1923
43784,38,1017,43784,0,43784,0,3.92719e+18,361.806,4120.69,43784,221,220,28239,17959,13861,12790,3443
13071,923,1921,7780,5291,7780,5291,1.92205e+18,547.292,4022.09,13071,320,285,11150,10356,9909,9984,7384
14649,845,1408,0,14649,4008,10641,9.32226e+15,331.14,3479.37,14649,362,180,13241,13222,12539,12607,10538
26679,2252,2683,0,26679,0,26679,2.31731e+18,721.116,6338.95,26679,337,432,23996,23969,23796,23834,22331
38561,177,1764,0,38561,11495,27066,9.19705e+15,745.592,5864.42,38561,380,370,32524,29534,20607,15369,3437
27847,2792,3010,24790,3057,16358,11489,1.92266e+18,1142.97,7095.65,27847,465,428,24837,24713,24783,24779,24311
11519,1883,1948,0,11519,0,11519,2.48248e+18,450.691,3715.38,11519,264,261,9571,9568,9561,9562,9529
7403,652,1125,4447,2956,0,7403,4.56683e+18,299.042,2271.49,7403,246,149,6278,6257,6094,6055,5526
5767,210,1054,3398,2369,0,5767,4.7463e+18,277.758,2052.45,5767,206,172,4241,3484,2307,1900,943
22901,868,2667,13946,8955,13946,8955,1.87336e+18,759.87,6122.82,22901,421,391,19941,18310,16130,16248,9659
24660,682,2470,0,24660,0,24660,2.40355e+18,679.739,5773.65,24660,425,385,21880,20650,16480,14326,8117
22518,182,241,0,22518,21983,535,2.66177e+16,98.791,1452.69,22518,81,84,22277,22256,21622,21731,20664
48856,1522,3420,0,48856,0,48856,2.17636e+18,1171.67,9426.39,48856,492,535,45187,43399,38867,29759,25023
41432,4327,4809,41432,0,37009,4423,2.58339e+18,934.563,10447.8,41432,507,529,36623,36603,36549,36530,36016
24147,619,1647,0,24147,7063,17084,9.37314e+15,529.863,4687.29,24147,402,296,22348,21591,19897,19981,13936
38269,2283,3338,38269,0,34574,3695,1.28025e+18,1008.41,8732.16,38269,455,530,34931,34886,33853,33637,24172
31514,1545,2974,18702,12812,0,31514,4.76745e+18,812.636,7265.48,31514,380,455,28540,27956,27683,27618,20936
12367,1258,1850,11116,1251,6830,5537,1.90452e+18,396.894,3639.16,12367,255,179,10517,10388,10278,10368,9284
14407,267,592,14407,0,14407,0,4.40436e+18,293.413,2173.44,14407,161,148,13673,13056,10322,10099,8578
12015,908,1794,7272,4743,7272,4743,1.78758e+18,326.756,3696.26,12015,334,172,10221,10128,9834,9491,7798
22471,29,34,21956,515,22471,0,9.83054e+13,18.3804,486.025,22471,20,22,22437,22437,21725,21726,21506
11189,284,1920,11189,0,10047,1142,2.36817e+18,567.029,3874.51,11189,269,300,8186,6659,5944,5648,2577
46798,15,115,45940,858,46798,0,1.04042e+14,21.3374,1035.86,46798,32,34,46572,46443,41542,41159,24888
10738,1492,1994,0,10738,0,10738,2.14084e+18,390.835,3726.86,10738,260,407,8744,8599,8506,8449,6547
42967,482,2537,13585,29382,0,42967,3.54544e+13,858.589,7708.99,42967,458,444,39328,37648,25229,24632,10993
45818,2354,4024,45818,0,40824,4994,1.63533e+18,1320.09,10356,45818,477,538,41794,40903,38149,36159,28496
28663,1731,3014,17378,11285,17378,11285,1.83937e+18,687.099,6951.21,28663,418,346,25649,25508,24953,25124,18931
28308,914,954,28279,29,28308,0,4.057e+18,324.879,3356.77,28308,203,206,27354,27353,27322,27324,27268
4883,607,1055,4883,0,4566,317,1.85846e+18,132.627,1859.44,4883,159,149,3828,3817,2946,2786,1971
16933,1043,2825,16933,0,15054,1879,2.94866e+18,784.667,5560.49,16933,383,301,13807,12702,11680,11138,6477
35711,1162,2387,0,35711,10699,25012,8.9034e+15,563.542,6788.34,35711,428,355,33324,33037,31472,31448,21842
21206,924,2188,12819,8387,0,21206,4.82625e+18,693.119,5301.36,21206,359,352,19013,18107,16390,16089,10056
39671,13212,39671,39671,0,39671,0,1.75917e+13,0,39671,39671,39671,1,0,0,0,0,0
29845,129,1482,18239,11606,18239,11606,1.84038e+18,409.671,4744.99,29845,366,260,21158,16426,13307,9807,6216
47658,756,934,47658,0,47658,0,4.34174e+18,365.947,4202.74,47658,224,232,46724,46721,45832,45881,45337
1227,201,324,382,845,0,1227,3.36112e+13,71.3619,564.422,1227,59,79,903,858,877,879,675
35899,88,357,0,35899,35387,512,2.62306e+16,132.554,2364.84,35899,107,108,35289,34711,30132,27697,20695
48086,850,1040,48056,30,48086,0,4.01124e+18,372.94,4373.92,48086,236,233,47046,47036,46311,46329,45673
24680,1667,3024,0,24680,0,24680,2.10424e+18,798.026,6420.34,24680,373,405,21656,21121,20648,20162,15037
30096,2,68,29583,513,30096,0,1.00933e+14,17.5535,666.439,30096,24,27,21666,18985,18032,18605,12720
10867,1375,2315,10867,0,9820,1047,2.59216e+18,424.117,4057.57,10867,342,241,8552,8396,8198,8201,5733
45503,44,85,44762,741,45478,25,1.00854e+14,20.155,861.234,45503,32,30,45418,45418,43591,43587,33259
23711,52,250,0,23711,23369,342,2.59744e+16,143.639,1636.63,23711,97,89,22916,22249,19214,17550,10923
43183,52,2862,43183,0,39109,4074,1.77085e+18,1545.49,8019.66,43183,420,474,23558,13143,7522,2693,1945
1985,35,39,0,1985,1985,0,2.54834e+16,25.0232,201.011,1985,25,29,1946,1946,1937,1938,1934
12667,10,46,12417,250,12667,0,1.03017e+14,16.6106,395.294,12667,23,23,12507,12401,10861,10739,7852
5676,449,614,0,5676,1778,3898,9.56702e+15,270.282,1512.84,5676,165,165,5062,4891,4759,4757,4502
22098,1369,1613,6373,15725,0,22098,3.63467e+13,420.88,4463.28,22098,305,292,20485,20455,20413,20388,18581
5277,12,18,5177,100,5277,0,1.0316e+14,13.5323,209.879,5277,15,15,5250,5243,4886,4885,4689
20420,209,755,20420,0,20420,0,4.00563e+18,334.175,2733.97,20420,178,185,18981,17342,11615,11259,9323
37016,19,56,36380,636,37016,0,1.00527e+14,20.099,679.416,37016,28,28,36937,36901,33158,32940,24986
38112,4582,4778,38112,0,33865,4247,2.40718e+18,1161.29,10344.2,38112,482,515,33334,33334,33324,33322,33217
33553,2376,2744,20392,13161,20392,13161,1.84513e+18,841.461,6921.21,33553,453,441,30809,30583,30533,30670,27827
32867,5,231,0,32867,32170,697,2.53223e+16,142.596,1907.48,32867,103,111,25230,21058,19862,17494,10828
34562,1233,2840,19970,14592,0,34562,4.42473e+18,1092.87,7358.92,34562,421,431,31397,30380,28859,28378,19523
5885,131,156,0,5885,5695,190,2.466e+16,77.9183,660.352,5885,51,56,5729,5698,5665,5614,5388
35020,1622,2672,0,35020,0,35020,2.4166e+18,1009,7055.53,35020,492,377,32255,31749,29044,24225,24580
31000,1092,3877,27602,3398,17940,13060,1.88005e+18,664.598,8524.03,31000,375,673,27123,26098,24151,24105,14016
36465,178,314,0,36465,35870,595,2.50883e+16,142.074,2328.7,36465,101,108,36142,36036,33807,33653,28370
20657,1695,2927,20657,0,18259,2398,2.82765e+18,841.851,6312.69,20657,403,398,17730,17247,16600,16136,13105
4557,333,711,3981,576,2681,1876,1.98311e+18,394.314,1557.29,4557,149,165,3430,2726,2562,2505,2232
38529,1004,3919,38529,0,34863,3666,2.42528e+18,957.746,9431.91,38529,398,518,33775,30940,18106,11668,9654
38171,247,271,0,38171,37139,1032,2.60492e+16,152.991,2098.9,38171,112,109,37900,37900,37740,37743,37381
39825,2613,4218,39825,0,36153,3672,2.65925e+18,1730.02,9987.28,39825,464,494,35517,33915,33144,32161,25822
10427,459,505,10408,19,10427,0,4.14068e+18,250.758,1788.77,10427,136,137,9922,9921,9850,9858,9841
46618,1741,4536,27527,19091,0,46618,4.91108e+18,1113.63,10744.4,46618,525,587,42082,40845,38003,37708,27052
3930,160,655,0,3930,1308,2622,8.61891e+15,166.762,1352.01,3930,164,160,3191,2896,2583,2666,1334
5562,19,32,5432,130,5562,0,1.03845e+14,14.0541,243.715,5562,18,18,5530,5525,5312,5312,4893
49634,278,360,0,49634,48887,747,2.6286e+16,166.682,2645.57,49634,119,129,49274,49257,47600,47699,45022
39724,517,717,39724,0,39691,33,3.99354e+18,365.464,3648.71,39724,221,213,39007,38938,36297,36270,35517
8285,824,1324,0,8285,0,8285,2.43158e+18,558.94,2682.43,8285,262,203,6891,6219,6475,6190,5545
16010,19,33,15786,224,16010,0,1.01532e+14,16.4254,409.79,16010,22,21,15975,15963,15317,15316,13874
5339,345,374,5339,0,5339,0,4.04397e+18,173.195,1168.17,5339,105,102,4965,4962,4935,4935,4839
31056,1379,3491,27690,3366,18461,12595,1.94839e+18,1153.4,8026.77,31056,443,421,27224,25729,23640,23911,14158
45391,24,279,0,45391,44597,794,2.56665e+16,156.544,2272.43,45391,109,103,42731,41503,34814,30486,18279
45180,52,2405,12999,32181,0,45180,3.53411e+13,585.405,7613.7,45180,349,454,32645,26426,21132,8108,3676
41741,781,3735,0,41741,0,41741,2.23281e+18,1129.55,9500.89,41741,596,681,36497,33800,23970,21585,11583
46047,366,3009,46047,0,41346,4701,2.36646e+18,1304.98,8703.01,46047,487,497,38397,33486,19208,11717,11182
41442,878,4010,41442,0,37099,4343,2.26319e+18,1348.78,10242.1,41442,445,562,35385,33035,24651,20557,11483
19688,1028,1455,0,19688,5566,14122,9.50067e+15,576.098,3980.54,19688,327,281,18233,17960,17970,17901,15629
33678,57,82,33117,561,33678,0,1.03412e+14,20.9916,732.554,33678,29,28,33596,33596,32569,32572,29382
25115,1564,1681,6959,18156,0,25115,3.70571e+13,389.472,4870.54,25115,286,372,23434,23434,23429,23434,22974
33825,334,1818,10415,23410,0,33825,3.37107e+13,731.847,5832.8,33825,474,422,30557,28673,20571,19994,7566
28123,240,686,28117,6,28123,0,3.95749e+18,329.446,3045.21,28123,195,190,27059,26002,18998,18514,14598
14062,5,26,13902,160,14062,0,9.17969e+13,15.1883,367.973,14062,19,21,13274,12645,11330,11344,7006
49347,1604,2397,14426,34921,0,49347,3.60547e+13,869.739,8019.01,49347,607,386,46950,46538,44907,44972,36464
15842,1425,1465,8238,7604,0,15842,3.91057e+18,250.994,3498.39,15842,291,236,14377,14377,14374,14375,14301
2394,285,545,0,2394,758,1636,1.00849e+16,92.3709,971.797,2394,85,133,1849,1794,1783,1772,1150
33161,2109,2427,20284,12877,0,33161,4.77989e+18,1070.73,6617.7,33161,398,489,30734,30324,30281,30203,29770
31907,492,3499,0,31907,0,31907,2.31823e+18,788.516,8086.77,31907,393,475,27143,24683,16042,12609,6335
33191,2142,2751,20159,13032,20159,13032,1.85528e+18,767.514,7138.65,33191,465,422,30440,30288,30029,30228,28065
47680,473,744,47674,6,47680,0,3.97855e+18,357.787,4018.32,47680,229,219,46936,46824,42721,42375,41973
3033,182,634,0,3033,0,3033,2.37873e+18,284.809,1186.7,3033,120,148,2099,1772,1330,1042,959
48292,3344,5001,48267,25,42581,5711,1.82896e+18,1193.55,12006.9,48292,620,549,43291,43259,42433,42035,30738
40881,3351,4118,40881,0,36875,4006,1.85659e+18,1417.47,9671.83,40881,555,539,36763,36658,36127,35975,32636
30654,1661,3030,19193,11461,0,30654,4.91819e+18,641.957,7495.67,30654,505,329,27624,27541,24208,23706,19633
25113,213,1546,7363,17750,0,25113,3.66995e+13,567.37,4619.5,25113,367,270,21578,18933,15766,15379,6112
18588,1052,1980,11109,7479,0,18588,4.74968e+18,676.056,4754.85,18588,299,306,16506,15529,15230,15045,11504
3421,290,892,0,3421,0,3421,2.50542e+18,166.505,1459.86,3421,179,122,2529,2256,2296,2250,1331
43174,198,293,0,43174,42380,794,2.55642e+16,149.302,2287.42,43174,101,119,42881,42808,41637,41111,39147
6365,574,1011,3779,2586,3779,2586,1.91235e+18,371.909,2119.8,6365,162,216,5317,4893,5035,4975,3370
26276,2751,2807,15894,10382,0,26276,4.9132e+18,555.954,6403.85,26276,350,335,23469,23469,23464,23466,23349
38721,259,1008,38721,0,38721,0,4.15223e+18,362.895,3970.92,38721,222,228,36977,35025,24709,23960,20833
39220,759,1670,0,39220,11607,27613,8.44186e+15,834.932,5869.27,39220,445,346,36978,35616,34896,35081,19306
24687,2448,3148,21969,2718,14994,9693,1.94787e+18,707.789,7002.55,24687,406,372,21539,21490,20996,21066,19765
25636,2837,3748,25636,0,22872,2764,2.23707e+18,1069.19,7715.46,25636,417,427,21888,21491,21198,20778,17916
16241,308,1020,0,16241,5032,11209,9.35597e+15,458.446,3258.07,16241,248,319,14626,13884,12623,12835,7102
14506,766,1366,0,14506,4367,10139,9.11899e+15,369.202,3454.13,14506,266,267,13140,12882,11892,12001,10054
17845,2535,3068,15919,1926,10687,7158,2.00023e+18,626.12,5945.98,17845,370,371,14777,14750,14664,14706,13582
5136,572,803,1460,3676,0,5136,3.75278e+13,218.462,1668.99,5136,171,140,4333,4296,4280,4277,3663
40607,38,72,39781,826,40607,0,1.05494e+14,19.1537,760.627,40607,27,29,40535,40535,38572,38568,30928
29890,30,44,29150,740,29884,6,1.01553e+14,16.4588,619.475,29890,23,23,29846,29846,29087,29111,24649
4797,286,876,0,4797,1379,3418,9.36727e+15,202.068,1669.19,4797,173,173,3886,3613,3180,3195,2027
22493,2354,2771,0,22493,0,22493,2.41142e+18,580.424,6080.97,22493,434,365,19722,19702,19622,19700,18495
22100,670,3895,22100,0,19938,2162,2.54555e+18,623.743,7345.1,22100,366,417,17871,16669,8732,6364,4762
2270,66,650,1407,863,1407,863,1.76894e+18,155.13,1076.72,2270,93,139,1332,930,796,637,208
18051,1032,2736,10743,7308,0,18051,4.95532e+18,516.248,5504.32,18051,323,435,15315,14693,14048,14135,6564
35156,1021,3180,35156,0,31147,4009,2.59399e+18,1092,8020.32,35156,392,426,31543,29225,19960,17400,16932
19202,15,52,18943,259,19202,0,1.08313e+14,17.5946,511.303,19202,25,28,19116,19061,17002,16852,12062
22892,51,2517,12805,10087,0,22892,4.35544e+18,812.543,5715,22892,331,472,13959,8182,5925,5879,571
22987,1057,1844,0,22987,6750,16237,8.63633e+15,421.66,4852.24,22987,319,404,21143,20891,20552,20349,15567
11644,411,1618,11644,0,10360,1284,1.27713e+18,528.113,3449.45,11644,265,264,9214,7292,6065,5647,4526
11752,2465,2821,11752,0,10565,1187,1.71734e+18,345.448,4656.92,11752,369,295,8931,8930,8842,8859,8044
19424,101,228,0,19424,19145,279,2.55266e+16,126.63,1356.87,19424,83,89,19115,18937,17011,16200,12928
7179,675,1644,7179,0,6332,847,1.21072e+18,296.755,2884.47,7179,227,306,5535,5347,3980,3753,3589
555,32,36,0,555,538,17,1.80469e+16,23.5045,114.96,555,20,24,517,499,508,511,488
36537,2117,2479,20786,15751,20786,15751,1.75316e+18,949.915,7045.77,36537,447,425,34058,33883,33878,33934,32459
41946,2660,3236,0,41946,0,41946,2.41241e+18,848.431,8717.03,41946,672,418,38710,38693,37385,35687,34165
22160,971,1079,7221,14939,0,22160,3.56525e+13,370.774,3410.52,22160,291,241,21081,21080,21051,21055,20802
44944,305,335,0,44944,44165,779,2.60982e+16,165.073,2618.85,44944,125,117,44609,44607,44526,44486,44219
23572,133,232,0,23572,23229,343,2.72219e+16,127.01,1474.54,23572,83,90,23289,23119,21830,21804,18886
47652,165,332,0,47652,46669,983,2.54861e+16,160.967,2654.42,47652,119,129,47273,47140,42818,41328,34302
44021,1153,4767,39329,4692,26019,18002,1.96094e+18,967.847,10780.9,44021,578,453,38989,37331,19309,17444,10540
39610,4058,4417,39610,0,35310,4300,2.74043e+18,794.05,10002.3,39610,439,492,35193,35193,35193,35193,33705
16780,548,802,16780,0,16780,0,3.94905e+18,272.396,2465.02,16780,173,163,15978,15945,15152,15119,14809
4656,5,121,0,4656,4544,112,2.53502e+16,43.5273,505.972,4656,39,47,3600,3128,2877,2785,1827
10305,132,188,0,10305,10077,228,2.64247e+16,83.8705,898.365,10305,60,71,10117,10100,9793,9827,9269
15590,166,229,0,15590,15271,319,2.60684e+16,80.4269,1291.97,15590,76,82,15361,15351,14971,14971,14056
7403,15,16,7371,32,7403,0,2.16225e+18,15.9654,344.163,7403,16,16,6895,0,6464,6464,6895
7428,148,177,0,7428,7300,128,2.48632e+16,84.1323,800.191,7428,62,64,7251,7224,7159,7149,6882
31523,916,1259,0,31523,8626,22897,9.60115e+15,637.713,4532.83,31523,353,320,30264,30178,29648,29645,23143
42136,1389,1808,0,42136,13075,29061,8.43819e+15,658.96,6100.25,42136,417,349,40328,40305,40128,40121,38440
11259,245,1336,0,11259,0,11259,2.22457e+18,522.96,3118.88,11259,251,255,8535,6869,4856,3657,3001
34611,1249,2187,21388,13223,0,34611,4.90852e+18,846.804,6511.49,34611,399,405,32424,31525,29200,28316,24502
36612,1198,4931,36612,0,32744,3868,2.76644e+18,1058.91,10190.4,36612,521,543,31253,29941,17437,13474,8355
21607,186,2416,0,21607,0,21607,2.13493e+18,732.444,5566.21,21607,369,365,16226,13457,8390,7351,2591
3780,947,1028,3358,422,2165,1615,1.96787e+18,246.917,1715.27,3780,137,171,2752,2702,2736,2717,2671
47407,2524,4963,47407,0,42438,4969,1.91539e+18,1286.83,11673.9,47407,517,510,42444,41869,38107,36691,27125
17104,857,1124,5634,11470,0,17104,3.40864e+13,352.999,3343.79,17104,225,198,15980,15923,15750,15753,14893
46902,93,5355,46902,0,41630,5272,2.38509e+18,1056.28,11986.7,46902,539,672,29126,20372,9933,2750,1353
18779,953,2415,18754,25,16738,2041,3.20265e+18,695.415,5317.63,18779,349,301,16088,14900,13231,12655,8000
13853,373,467,13853,0,13853,0,4.10833e+18,252.714,1944.77,13853,145,148,13386,13348,12647,12627,12188
21349,953,1330,0,21349,6556,14793,8.48345e+15,407.975,3856.02,21349,254,326,20019,19850,19378,19407,16977
30283,351,2603,18380,11903,18380,11903,1.82286e+18,552.889,6304.93,30283,344,329,26388,21491,18548,16022,5608
23169,20,50,22645,524,23169,0,9.83203e+13,16.268,539.075,23169,23,25,23119,23111,21730,21710,17856
31103,2342,3499,18734,12369,0,31103,4.80901e+18,971.796,7910.11,31103,459,573,27604,26970,25757,25199,23228
18830,1262,2168,11012,7818,0,18830,4.86029e+18,574.072,4915.5,18830,306,372,16662,16222,15994,15782,13707
4896,14,157,0,4896,4820,76,2.29743e+16,58.03,576.783,4896,50,51,4428,4204,3690,3438,1996
15762,344,1235,4882,10880,0,15762,3.26496e+13,331.688,3228.17,15762,244,225,14431,13777,11396,11418,5185
27327,1385,2859,15494,11833,15494,11833,1.64736e+18,552.496,6435.25,27327,301,470,24468,24187,23661,23574,16413
24046,1653,2850,14173,9873,0,24046,4.57991e+18,901.638,6560.31,24046,431,459,21196,20274,19839,19636,16704
5417,559,610,0,5417,1719,3698,8.8446e+15,259.98,1515.28,5417,188,155,4807,4807,4756,4769,4675
44489,2193,3765,44489,0,39646,4843,2.11734e+18,1704.48,9836.45,44489,534,488,40427,38397,37052,35511,30471
49250,444,1953,13417,35833,0,49250,3.67277e+13,812.817,6802.31,49250,589,415,45747,43765,34448,34710,22002
45151,3410,4425,45151,0,40606,4545,2.45049e+18,1483.51,10564.9,45151,536,464,40726,40096,40454,40427,35780
1302,244,337,405,897,0,1302,3.72063e+13,61.6075,574.232,1302,71,94,965,950,946,944,761
4078,210,582,0,4078,1329,2749,6.58205e+15,102.889,1242.98,4078,150,124,3496,3409,2321,2049,1368
37668,213,3504,37668,0,33844,3824,1.15424e+18,1632.81,8495.71,37668,453,554,29643,26064,12868,12078,3241
23281,127,1725,0,23281,0,23281,2.38853e+18,894.346,4780.11,23281,353,363,16794,13405,10578,8586,2860
34503,1655,2231,0,34503,10335,24168,8.90276e+15,565.332,6506.98,34503,457,477,32272,32148,31832,31759,27091
46716,130,297,0,46716,46050,666,2.59566e+16,138.523,2375.82,46716,109,108,46354,46168,42708,40134,32751
36865,212,327,0,36865,36184,681,2.55452e+16,133.369,2325.44,36865,99,107,36538,36506,34912,34715,30755
21942,1272,2355,21942,0,20204,1738,3.0491e+18,661.348,5341.15,21942,309,307,19587,19282,16099,15464,15277
30349,1187,1988,0,30349,0,30349,2.29129e+18,767.702,5860.65,30349,336,364,28361,28328,24339,20553,18471
44825,244,2499,27194,17631,0,44825,4.91724e+18,959.888,7854.6,44825,520,384,35443,28735,22324,20217,7953
17589,1346,2209,10413,7176,0,17589,4.6488e+18,405.929,4839.69,17589,262,389,15380,15274,14910,14733,12691
29232,147,2722,17692,11540,17692,11540,1.8124e+18,625.71,6779.43,29232,411,404,21367,17472,13544,9661,2845
29317,328,832,29317,0,29317,0,4.03997e+18,348.564,3300.42,29317,209,198,28336,27602,21097,20381,18300
22564,417,739,22560,4,22564,0,4.29285e+18,336.782,2866.87,22564,185,187,21825,21576,18608,18366,18106
25235,78,319,0,25235,24780,455,2.64416e+16,117.191,1970.6,25235,88,87,24695,24211,21120,19567,12032
20072,403,556,20072,0,20072,0,4.14595e+18,294.828,2452.09,20072,167,161,19516,19441,18084,17978,16724
35888,185,3422,21235,14653,0,35888,4.84214e+18,1346.91,8565.35,35888,567,583,27647,23679,15686,13291,3457
44930,120,327,0,44930,44165,765,2.58898e+16,151.219,2436.65,44930,109,108,44450,44145,39339,36104,25341
20499,420,567,20499,0,20499,0,4.43792e+18,301.881,2482.38,20499,162,158,19932,19849,18807,18689,18240
36097,165,310,0,36097,35240,857,2.5935e+16,161.201,2183.82,36097,109,111,35747,35573,33116,32783,27107
10686,8,44,10481,205,10680,6,1.02412e+14,16.3325,420.132,10686,23,23,10460,10355,8992,8838,5481
14186,141,226,0,14186,13961,225,2.5235e+16,100.939,1224.9,14186,71,72,13960,13882,13334,13392,11570
5291,174,956,3169,2122,0,5291,5.00755e+18,261.617,1843.54,5291,180,168,3968,3336,2996,2904,496
45307,663,3582,26307,19000,0,45307,4.85145e+18,815.247,9368.75,45307,414,593,40704,38458,27364,23740,9442
27412,812,1729,0,27412,8848,18564,8.3412e+15,479.427,5046.55,27412,395,352,25683,25275,24458,24523,18546
26028,1375,2938,26028,0,23623,2405,1.69054e+18,960.116,6675.73,26028,366,376,23039,21798,16737,14549,11823
4234,431,736,0,4234,0,4234,2.3686e+18,322.021,1490.67,4234,182,154,3417,3044,3150,3073,2503
11635,908,2179,6780,4855,0,11635,4.96085e+18,398.9,4093.32,11635,250,356,9456,9144,8760,8755,4764
15465,116,2115,0,15465,0,15465,2.33785e+18,460.434,4397.05,15465,281,332,11794,9186,7911,5175,2523
6822,357,911,6175,647,4292,2530,1.90464e+18,401.68,2063.43,6822,191,172,5320,3739,3097,2779,1794
4286,836,1255,4286,0,3794,492,2.25436e+18,214.799,1986.3,4286,196,188,3031,2985,2653,2550,2264
17993,1762,2323,10330,7663,0,17993,4.57537e+18,559.134,5050.09,17993,303,295,15670,15605,15544,15577,14117
9217,902,982,2616,6601,0,9217,3.60484e+13,423.3,2412.09,9217,271,222,8235,8220,8199,8216,8139
1046,47,258,1046,0,1046,0,3.62437e+18,83.4589,466.81,1046,63,49,639,363,397,355,249
44564,93,2809,13302,31262,0,44564,3.54531e+13,921.259,8469.95,44564,508,440,35190,30222,22143,9094,5193
46843,137,349,0,46843,46040,803,2.60354e+16,173.297,2720.31,46843,118,132,46325,46047,40859,38322,30835
43610,41,76,42749,861,43610,0,1.01482e+14,20.2641,815.277,43610,29,29,43534,43534,42015,41972,31922
3179,52,641,0,3179,900,2279,9.76108e+15,125.133,1164.5,3179,144,133,2272,1978,1456,1282,374
48952,1764,4116,43351,5601,28962,19990,1.93669e+18,1165.52,10501.6,48952,614,452,44836,43207,29247,27253,20361
45617,24,347,0,45617,44794,823,2.59327e+16,132.914,2688.93,45617,107,122,42876,41388,35693,31276,17390
21244,1294,1639,0,21244,6903,14341,8.38051e+15,307.385,4355.66,21244,358,369,19605,19581,18944,19024,17041
7427,151,540,7427,0,7427,0,4.17532e+18,232.502,1547.89,7427,117,110,6489,5634,3904,3663,2283
35492,378,4219,20596,14896,0,35492,4.87274e+18,684.84,9216.2,35492,478,468,29808,26462,15953,13817,3800
46893,80,86,45757,1136,46889,4,1.01556e+14,17.9009,869.191,46893,30,29,46807,46807,46779,46779,46268
24676,1123,3231,22070,2606,14998,9678,2.01486e+18,1107.37,7094.31,24676,404,334,20788,19001,13556,13070,8200
40307,25,54,39475,832,40307,0,9.99868e+13,18.3881,714.462,40307,25,26,40253,40250,37797,37701,27878
40300,284,329,0,40300,39389,911,2.50647e+16,151.951,2397.45,40300,116,116,39971,39965,39712,39413,38603
19228,270,762,0,19228,6304,12924,8.67219e+15,309.014,2746.26,19228,220,226,17775,15101,13454,13605,10855
27056,848,1579,0,27056,7684,19372,9.61214e+15,624.191,4901.13,27056,404,325,25473,24872,23563,23675,16804
16557,783,1408,5196,11361,0,16557,3.31972e+13,332.586,3703.75,16557,195,305,15149,15047,14937,14946,10510
42765,325,341,0,42765,42049,716,2.57211e+16,162.033,2521.7,42765,115,122,42424,42424,42390,42364,42234
6362,29,148,0,6362,6277,85,2.45101e+16,53.4428,630.969,6362,47,46,6116,5937,5290,4655,3120
9625,493,937,3105,6520,0,9625,3.57413e+13,366.433,2400.44,9625,204,188,8688,8367,7774,7803,6239
15741,218,1409,4502,11239,0,15741,3.66914e+13,472.208,3690.27,15741,340,230,13427,12024,10251,10139,3570
18011,813,1229,5709,12302,0,18011,3.26594e+13,271.859,3553.78,18011,209,271,16782,16743,16662,16662,12781
12905,1042,1754,12905,0,11646,1259,2.63208e+18,358.094,3542.58,12905,219,244,11151,11052,9989,10208,6234
42317,2674,3311,23932,18385,23932,18385,1.61027e+18,704.438,8550.8,42317,474,506,39006,38980,38791,38731,36408
4191,454,1216,4191,0,3756,435,2.4657e+18,194.367,1919.79,4191,213,115,2975,2762,2641,2430,1180
20154,807,3039,17961,2193,12125,8029,1.90544e+18,500.266,6246.18,20154,283,382,17057,16005,13802,13407,6144
29866,1,78,29328,538,29866,0,1.09222e+14,21.7271,693.537,29866,29,27,11621,11621,11621,11621,11621
2171,31,685,0,2171,0,2171,2.20941e+18,75.3865,1038.06,2171,137,95,1170,791,451,523,118
5805,83,776,1628,4177,0,5805,3.14225e+13,132.713,1651.52,5805,162,149,4499,3683,2869,2492,570
48665,87,94,47752,913,48665,0,1.03839e+14,22.8522,984.552,48665,31,34,48571,48571,48438,48438,47458
9445,1057,1358,5787,3658,5787,3658,1.84685e+18,330.225,2911.67,9445,189,290,8087,8081,7984,8010,7295
5233,103,1258,3194,2039,3194,2039,1.89905e+18,222.439,2145.12,5233,169,197,3496,2851,2217,1718,344
24872,126,238,0,24872,24431,441,2.54949e+16,105.404,1626.6,24872,84,86,24624,24540,23129,22868,18421
19635,1466,1908,0,19635,0,19635,2.35842e+18,834.349,4734.77,19635,339,325,17727,17067,16812,15436,16239
44426,947,4287,39998,4428,26251,18175,1.92774e+18,951.849,10353.9,44426,477,532,39474,37169,19501,18820,11623
2540,237,694,1581,959,0,2540,4.53989e+18,242.795,1155.06,2540,130,114,1723,1431,1349,1347,1040
29955,3,9,28082,1873,29827,128,0.000267067,0.9997,498.329,29955,9,1,29946,29946,29946,29946,29946
38674,2650,4700,38639,35,34275,4399,2.0472e+18,1005.26,10668.1,38674,552,528,33974,33301,32743,33132,21923
14434,286,1985,0,14434,0,14434,2.37224e+18,559.891,4256.61,14434,301,336,11438,10326,6662,7179,1610
6018,1012,1156,3615,2403,3615,2403,1.84499e+18,291.627,2169.71,6018,216,198,4862,4855,4810,4804,4737
9127,221,446,9127,0,9127,0,4.31967e+18,235.899,1600,9127,126,128,8567,8041,7085,6945,6059
41740,250,3945,37129,4611,25065,16675,1.9746e+18,1355.81,9453.49,41740,600,472,31035,24410,14303,12760,5638
37851,48,84,37059,792,37851,0,1.01827e+14,20.3473,779.311,37851,30,32,37767,37762,36611,36611,29194
34021,1316,2293,20112,13909,20112,13909,1.88932e+18,711.875,6597.51,34021,384,380,31728,31509,30472,30582,22457
14754,369,1443,4094,10660,0,14754,3.67048e+13,318.563,3528.34,14754,260,238,13223,12524,11769,11788,6862
41247,897,2082,0,41247,12446,28801,9.19584e+15,834.056,6479.76,41247,436,425,38953,37974,34359,34527,24520
10789,835,2251,10789,0,9650,1139,1.88898e+18,452.199,4050.69,10789,372,240,8538,7777,6030,5898,4789
24159,1512,2871,24159,0,21123,3036,2.51815e+18,556.226,6516.93,24159,385,338,21288,21169,20721,20104,11076
30430,190,820,30418,12,30430,0,4.21569e+18,374.632,3359.1,30430,200,202,28178,25196,16589,15243,11810
30426,325,2686,18221,12205,18221,12205,1.90029e+18,770.152,6863.55,30426,398,424,24787,21018,17035,15808,5314
10955,9,30,10681,274,10955,0,9.90753e+13,14.8762,342.897,10955,19,20,10824,10746,9433,9352,7015
27337,2007,2539,15909,11428,0,27337,4.59094e+18,723.919,6111.87,27337,335,338,24798,24555,24554,24570,23204
28336,3013,3476,28336,0,25708,2628,1.47451e+18,719.346,7505.8,28336,507,402,24860,24847,24572,24535,21716
24285,708,2003,13797,10488,13797,10488,1.82731e+18,1003.02,5492.95,24285,400,432,21238,19876,19412,18999,8349
6412,740,918,0,6412,1673,4739,9.82816e+15,192.374,1899.84,6412,187,159,5494,5494,5479,5472,4976
10680,1230,1301,5681,4999,0,10680,3.61083e+18,190.969,2739.26,10680,217,181,9379,9379,9377,9375,9242
19860,19,52,19511,349,19860,0,1.05518e+14,18.715,498.917,19860,26,24,19798,19776,18277,18165,13673
12725,1372,1699,6999,5726,0,12725,4.40313e+18,272.118,3450.1,12725,244,209,11026,10950,10979,10980,10419
4138,66,715,0,4138,1213,2925,8.61329e+15,169.771,1455.46,4138,191,153,2863,2469,2202,2089,600
26958,52,229,0,26958,26477,481,2.53557e+16,134.36,1619.76,26958,99,107,26043,25155,22084,20294,13646
48159,107,2364,0,48159,15187,32972,8.78337e+15,733.996,7481.98,48159,379,470,38664,33831,23124,20401,5713
4601,221,690,4601,0,4172,429,2.85435e+18,403,1549.7,4601,168,159,3071,2163,1911,1645,1888
20632,1292,2889,12641,7991,12641,7991,1.83792e+18,676.069,6045.53,20632,379,534,17743,17333,15613,16191,10797
39746,3672,4928,39746,0,35370,4376,2.97146e+18,1207.95,10579.7,39746,587,457,34818,34351,34188,33822,31191
8301,1862,2001,8301,0,7494,807,1.45383e+18,315.177,3348.82,8301,256,259,6300,6300,6265,6272,6070
19841,620,1482,5764,14077,0,19841,3.68837e+13,429.561,4039.2,19841,362,322,18284,17996,15999,15893,12106
2028,308,447,678,1350,0,2028,3.52042e+13,117.444,819.18,2028,100,116,1581,1511,1506,1509,1316
47483,1082,4269,27498,19985,0,47483,4.77275e+18,1081.73,10411,47483,481,627,42357,40383,36666,36156,18194
45145,244,280,0,45145,44140,1005,2.66125e+16,99.1671,1924.46,45145,91,95,44865,44863,44406,44374,43929
5790,15,30,5636,154,5790,0,9.85408e+13,14.5017,247.342,5790,16,19,5757,5743,5444,5407,4435
29394,434,1811,9134,20260,0,29394,3.26237e+13,612.638,5152.96,29394,317,280,27013,25887,19515,17885,7341
42068,53,311,0,42068,41262,806,2.53165e+16,135.958,2353.46,42068,105,107,40956,39965,33461,29631,20775
29278,770,3764,26352,2926,16682,12596,1.90075e+18,632.044,8035.92,29278,521,429,25075,23425,10283,10862,5069
47592,656,2306,14525,33067,0,47592,3.55695e+13,685.081,7751.74,47592,439,475,44829,43981,37444,37096,18644
16776,541,1055,4764,12012,0,16776,3.7771e+13,544.718,3158.97,16776,298,237,15366,13961,13628,13742,10807
45370,2455,3192,40412,4958,25709,19661,1.88326e+18,1813.91,9051.9,45370,408,597,42035,39629,40939,41031,36122
12343,316,950,3662,8681,0,12343,3.47761e+13,348.881,2619.79,12343,214,174,11107,9954,9004,9095,5428
10344,1506,1912,9018,1326,6171,4173,1.92766e+18,677.01,3754.81,10344,286,358,8432,8083,8026,8007,7684
2342,342,773,1417,925,1417,925,1.98875e+18,72.1097,1139.92,2342,119,128,1569,1525,1507,1515,854
7135,1531,1568,4047,3088,0,7135,4.29164e+18,220.679,2749.33,7135,304,194,5567,5567,5567,5567,5540
12702,940,1323,0,12702,3910,8792,9.23467e+15,481.731,3292.23,12702,305,264,11379,11172,10622,10625,9067
10663,490,983,3301,7362,0,10663,3.64615e+13,351.339,2552.67,10663,222,249,9653,9331,9040,9046,7787
37592,163,271,0,37592,37044,548,2.55917e+16,142.076,2035.13,37592,95,104,37304,37220,35047,34946,29536
41586,10,64,40851,735,41556,30,9.97545e+13,21.2125,818.42,41586,27,30,41177,40891,36100,34845,22963
12158,27,38,11949,209,12158,0,1.00014e+14,16.2734,378.891,12158,22,21,12120,12120,11558,11557,10449
44037,146,321,0,44037,42974,1063,2.74015e+16,147.474,2483.13,44037,129,129,43617,43437,40048,38332,32551
35528,1699,3264,35528,0,32158,3370,2.56077e+18,1080.24,8027.56,35528,506,375,32264,30623,29208,29426,16436
41501,1482,3415,23982,17519,0,41501,4.64497e+18,1266.67,8794.26,41501,447,486,37788,36432,32565,32006,19214
27672,375,2891,0,27672,0,27672,2.40809e+18,806.639,6838.78,27672,472,461,22993,19822,15779,14206,3274
43360,3375,3443,26410,16950,0,43360,4.92921e+18,1177.97,8784.92,43360,634,458,39917,39838,39905,39902,39775
31460,4153,4310,28205,3255,18495,12965,1.95475e+18,794.127,9058.35,31460,532,570,27150,27150,27150,27150,27060
3363,8,88,0,3363,3292,71,2.37836e+16,52.5569,349.493,3363,37,48,2931,2663,2428,2483,1572
4801,245,862,2872,1929,0,4801,4.87015e+18,251.639,1648.97,4801,165,151,3759,3293,3203,3178,1198
21855,2511,3014,21855,0,19488,2367,2.05444e+18,821.915,6478.68,21855,434,409,18841,18785,18769,18754,17900
26442,2535,3745,26417,25,23554,2888,2.8032e+18,968.854,7780.81,26442,475,386,22697,22602,22502,22438,19801
18743,61,250,0,18743,18403,340,2.62388e+16,113.502,1477.35,18743,87,91,18210,17795,15392,14493,9390
34600,92,826,34600,0,34600,0,5.03832e+18,340.359,3439.67,34600,201,208,28508,22382,12700,10229,6808
17201,398,1474,0,17201,5343,11858,9.2182e+15,491.144,3868.3,17201,280,304,15450,14514,11601,11566,5940
3197,592,965,2669,528,1848,1349,1.96668e+18,226.972,1546.11,3197,159,149,2232,2107,2015,2012,1599
8847,411,630,0,8847,2874,5973,8.32572e+15,304.866,1822.35,8847,195,171,8217,8152,7656,7718,7031
26313,1426,2293,15558,10755,0,26313,4.93968e+18,904.84,5833.11,26313,451,395,24020,23281,22221,21713,18699
15142,2217,2438,0,15142,0,15142,2.26239e+18,380.307,4888.37,15142,432,265,12704,12703,12499,12298,11820
38107,22,67,37327,780,38107,0,1.03772e+14,18.4943,738.57,38107,27,31,38036,38014,34806,34574,25108
26043,339,644,26043,0,26043,0,4.39689e+18,353.411,2930.5,26043,196,187,25285,24927,18858,18726,16183
14565,241,1648,8465,6100,0,14565,4.46666e+18,376.584,3791.21,14565,366,244,11926,10305,8329,7876,4320
3360,82,934,2984,376,2085,1275,2.03732e+18,273.387,1549.13,3360,155,167,1867,1385,881,890,356
43414,2333,2731,26603,16811,26603,16811,1.84275e+18,1373.23,8519.2,43414,444,587,40683,40677,40124,40373,37888
8645,68,1032,0,8645,2597,6048,9.44034e+15,243.246,2355.15,8645,239,215,6413,5572,4060,4170,1198
23622,782,1500,7045,16577,0,23622,3.43744e+13,353.39,4209.09,23622,368,265,22122,21997,20580,20681,15138
7809,71,847,2428,5381,0,7809,3.5223e+13,280.208,2030.88,7809,192,160,5511,4620,3916,3277,1229
37661,201,963,37661,0,37661,0,4.07026e+18,359.438,3812.94,37661,218,216,35119,31762,22231,21449,15650
9154,1736,1787,9154,0,8378,776,1.63036e+18,393.072,3250.61,9154,237,229,7367,7367,7367,7367,7318
21885,107,1469,6701,15184,0,21885,3.56892e+13,535.336,4248.98,21885,311,298,17320,14988,10451,6454,3344
43529,42,2108,0,43529,12534,30995,9.49096e+15,877.367,6960.11,43529,480,401,30399,24462,19026,17789,4058
34786,44,71,33996,790,34786,0,1.03185e+14,20.3935,709.711,34786,25,28,34715,34708,33265,33266,28752
26039,226,739,26033,6,26039,0,4.21622e+18,315.478,2986.94,26039,190,192,24716,23090,16303,15641,13003
7430,298,1076,4445,2985,0,7430,4.97655e+18,280.488,2225.52,7430,210,150,6146,5064,5074,4898,3590
10236,622,1337,9314,922,5380,4856,1.85002e+18,231.261,2755.48,10236,245,155,8899,8872,7602,8019,6575
28834,45,76,28315,519,28834,0,1.05692e+14,18.7231,675.26,28834,28,27,28758,28756,27638,27656,22442
6637,339,386,6637,0,6637,0,3.49594e+18,138.634,1196.43,6637,112,117,6251,6247,6152,6137,5640
2401,166,733,0,2401,0,2401,2.35944e+18,166.329,1146.48,2401,110,130,1569,1328,957,719,518
36207,83,342,0,36207,35699,508,2.71498e+16,135.168,2299.34,36207,99,114,35595,35073,29800,26510,19048
14198,203,609,14198,0,14173,25,4.10621e+18,266.28,2187.92,14198,156,160,13249,12340,8769,8723,6799
4233,479,1120,3653,580,2490,1743,1.9762e+18,186.895,1896.96,4233,126,187,3113,2938,2762,2819,1712
43759,1037,2372,0,43759,12809,30950,9.66405e+15,852.04,7551.78,43759,527,498,41280,40213,36266,36405,28826
43582,259,2721,26345,17237,0,43582,4.74248e+18,700.905,7407.74,43582,440,432,36167,29478,19399,17984,7380
14996,1169,1951,8897,6099,0,14996,4.83649e+18,406.548,4204.9,14996,286,259,13045,12988,12107,11696,9655
4030,127,329,0,4030,1246,2784,6.37434e+15,124.557,940.148,4030,102,90,3645,3471,2682,2498,1257
11522,1342,1622,10504,1018,6336,5186,1.86014e+18,216.661,3221.87,11522,248,170,9900,9895,9851,9855,8994
36287,718,1827,10516,25771,0,36287,3.54965e+13,660.25,5833.53,36287,510,327,34250,32046,26570,26625,17609
12901,1791,1892,7719,5182,0,12901,4.97904e+18,577.154,3958.59,12901,343,268,11009,11009,11005,11009,10927
21489,2068,2424,0,21489,0,21489,2.44288e+18,626.803,5485.11,21489,375,328,19065,18953,18837,18611,17570
44924,3550,4515,26239,18685,26239,18685,1.76095e+18,754.739,10753.2,44924,407,746,40409,40397,39964,40089,36271
49273,907,1302,49263,10,49273,0,4.30581e+18,423.767,4753.02,49273,247,250,47971,47937,45397,45225,43756
21337,244,1520,6554,14783,0,21337,3.64695e+13,398.235,4046.23,21337,343,300,18361,16040,11889,11308,8046
43377,67,2454,38858,4519,26500,16877,1.98144e+18,1229.33,7833.33,43377,494,420,24986,17808,10479,9146,1160
38719,1969,2407,0,38719,11363,27356,9.43266e+15,798.998,7391.74,38719,479,573,36312,36031,35871,35775,33532
36704,1204,3413,21802,14902,21802,14902,1.88587e+18,755.407,8386.91,36704,381,555,33201,32341,30286,28985,18226
43698,250,705,43698,0,43698,0,4.14898e+18,343.785,3674.26,43698,227,219,42474,41010,29452,28109,24680
6214,200,736,0,6214,1977,4237,7.61413e+15,136.098,1679.4,6214,114,144,5478,5318,4463,4510,1981
3989,500,942,3547,442,2198,1791,1.93439e+18,196.526,1666.3,3989,116,144,3047,2850,2838,2891,1582
9047,437,686,0,9047,2938,6109,8.94205e+15,262.846,1843.65,9047,178,175,8361,8312,7817,7852,7194
24331,423,1751,7591,16740,0,24331,3.40797e+13,417.7,4669.65,24331,278,339,22224,21289,19603,19446,11830
24434,2754,3280,24434,0,21411,3023,2.91681e+18,1101.67,7119.84,24434,391,379,21154,20777,20945,20874,19940
6000,66,1146,0,6000,0,6000,2.53211e+18,280.626,2136.79,6000,194,162,3841,2906,2361,2215,381
26722,801,1685,0,26722,7683,19039,9.53752e+15,605.399,4867.8,26722,384,306,24879,24403,22519,22699,16907
31343,1968,2804,0,31343,0,31343,2.39862e+18,749.254,6667.09,31343,370,434,28539,28512,28068,27763,19641
39267,1,58,38657,610,39267,0,9.98752e+13,19.0339,757.171,39267,25,29,15956,15956,15956,15956,15956
5006,815,870,4529,477,2883,2123,1.86771e+18,206.776,1714.31,5006,152,153,4136,4135,4127,4128,4108
41372,493,931,41357,15,41372,0,4.23474e+18,381.589,3936.06,41372,235,225,40441,40173,34508,34293,33358
47985,42,79,47111,874,47985,0,1.01081e+14,19.5266,848.708,47985,32,32,47906,47906,45952,45929,36983
25058,904,2878,25058,0,22646,2412,1.97881e+18,1061.88,6384.6,25058,375,322,21411,19936,12693,10648,8064
34031,103,232,0,34031,33337,694,2.65566e+16,119.101,1641.89,34031,89,92,33747,33650,30971,29617,23897
11696,538,1250,0,11696,3478,8218,9.68613e+15,299.45,3016.52,11696,263,283,10446,10195,9358,9302,6284
17985,1782,1855,10756,7229,0,17985,4.69979e+18,650.404,4365.23,17985,318,327,16130,16130,16124,16117,16016
34178,854,2025,0,34178,10139,24039,9.38654e+15,754.524,6078.93,34178,463,499,31908,30715,28038,27931,21346
34377,517,1460,10654,23723,0,34377,3.50609e+13,530.981,5119.69,34377,346,317,32625,31525,28265,28485,17514
38087,846,3268,23106,14981,0,38087,4.83661e+18,762.31,8038.48,38087,437,465,34577,33652,26507,25144,15931
808,10,18,798,10,808,0,1.17746e+14,7.875,92.3683,808,11,10,789,785,667,671,579
7231,91,195,0,7231,7097,134,2.64175e+16,86.2233,855.971,7231,61,64,7004,6897,6246,6177,4730
39424,1650,1763,0,39424,10988,28436,9.52931e+15,759.47,5934.12,39424,540,333,37661,37659,37641,37648,37484
18774,47,573,18774,0,18774,0,4.09735e+18,294.776,2398.77,18774,176,175,13158,9186,6802,6358,2580
40840,3578,4176,23694,17146,0,40840,4.68602e+18,858.099,9737.11,40840,505,511,36664,36656,36314,36328,33494
24329,1450,1951,14536,9793,14536,9793,1.87e+18,865.284,5295.15,24329,398,371,22378,21758,21327,20972,19573
15963,19,30,15674,289,15942,21,9.68757e+13,14.5753,399.283,15963,18,19,15932,15927,15303,15307,13629
43831,71,393,0,43831,42992,839,2.66343e+16,136.06,2785.7,43831,112,132,42919,41570,35658,32442,22562
10916,283,955,3131,7785,0,10916,3.66194e+13,464.013,2559.52,10916,231,215,9298,8529,7865,7986,4002
19721,541,1559,0,19721,5980,13741,9.18541e+15,352.194,4155.28,19721,373,281,18162,17798,14157,14615,10460
7482,162,188,0,7482,7287,195,2.67833e+16,80.8956,877.591,7482,66,63,7294,7290,7258,7246,7016
33510,183,299,0,33510,32860,650,2.44149e+16,126.634,2143.65,33510,101,118,33211,33154,31406,30571,26823
21090,163,238,0,21090,20840,250,2.70669e+16,123.816,1544.16,21090,86,92,20852,20766,20212,20088,18734
38587,395,2675,23390,15197,23390,15197,1.92154e+18,1074.44,7357.11,38587,532,361,31989,27706,22685,21145,10318
17022,1022,2806,17022,0,15153,1869,2.43377e+18,725.627,5609.77,17022,417,302,13955,12802,12335,11741,5671
13512,963,1204,0,13512,4124,9388,9.44216e+15,384.455,3168.73,13512,285,235,12308,12307,11908,11931,10983
15601,2025,2512,13804,1797,9341,6260,1.9329e+18,640.21,5167.48,15601,261,443,13089,13080,12811,12863,12060
46481,182,951,46481,0,46481,0,4.16468e+18,356.532,4157.26,46481,227,234,43506,39864,24951,23177,14779
11499,396,1556,6972,4527,6972,4527,1.82644e+18,372.201,3309.28,11499,331,212,9725,8575,7414,6890,3889
14275,10,222,0,14275,13999,276,2.50221e+16,103.584,1151.88,14275,74,76,12673,11545,10285,9288,4895
28775,568,1799,0,28775,26977,1798,0.0624848,0.93748,7194.77,28775,1799,1,26976,26976,26976,26976,26976
4392,587,1136,2714,1678,0,4392,5.10805e+18,229.168,1845.79,4392,155,181,3256,3089,3091,3078,1859
17393,26,1271,5496,11897,0,17393,3.56381e+13,404.609,3744.18,17393,253,302,10636,7953,6583,2142,1496
48013,1743,2449,27290,20723,0,48013,4.25749e+18,1407.17,7740.71,48013,423,469,45138,43005,44091,44042,38623
1027,180,239,1027,0,1027,0,4.49844e+18,85.8841,433.631,1027,49,49,788,770,773,769,739
30901,104,294,0,30901,30508,393,2.66115e+16,118.457,1914.99,30901,95,100,30530,30297,27145,26022,19731
10782,1105,1729,9649,1133,6552,4230,2.04464e+18,633.249,3519.26,10782,261,240,9053,8477,7963,8031,7287
1603,204,244,0,1603,473,1130,9.30662e+15,60.6488,524.902,1603,70,67,1359,1354,1352,1345,1161
9283,137,179,0,9283,9045,238,2.47308e+16,88.7585,899.938,9283,64,65,9104,9081,8843,8799,8338
36199,155,940,36181,18,36199,0,4.21591e+18,367.845,3747.92,36199,215,218,32533,27878,18318,16938,11443
26811,1969,3425,26811,0,23797,3014,2.68272e+18,788.794,7352.39,26811,350,498,23386,23206,20703,20336,18281
40111,1608,2436,40086,25,35835,4276,1.83589e+18,1312.06,7514.83,40111,427,467,37612,35431,34987,34762,32515
2029,379,431,533,1496,0,2029,3.85676e+13,96.6535,761.66,2029,119,77,1598,1586,1595,1596,1567
13351,1567,2385,12072,1279,7595,5756,1.94836e+18,347.805,4418.23,13351,201,329,10966,10928,10618,10733,7307
9035,1150,1292,0,9035,0,9035,2.49934e+18,272.576,2685.16,9035,261,165,7743,7742,7712,7736,7331
21798,10244,21798,21798,0,0,21798,268423000,0,21798,21798,21798,1,0,0,0,0,0
40388,467,2655,0,40388,0,40388,2.30285e+18,766.348,7487.76,40388,484,435,35531,32300,24629,23208,5746
30947,2381,3170,18909,12038,0,30947,4.89398e+18,636.132,7326.81,30947,489,341,27777,27753,26523,26227,23799
30566,373,2037,8972,21594,0,30566,3.47092e+13,593.955,5851.32,30566,432,288,27750,26332,21836,22034,10758
40022,109,4151,24313,15709,24313,15709,1.77776e+18,722.12,9461.46,40022,601,410,27420,21438,16027,11190,1567
44465,350,1851,12930,31535,0,44465,3.66916e+13,941.481,6446.79,44465,451,366,39994,37138,26934,27391,12699
46645,1577,3736,28148,18497,0,46645,4.76086e+18,1116.38,9543.54,46645,559,449,42909,41437,33077,31706,22650
40716,3536,5222,36821,3895,24863,15853,1.91816e+18,771.219,11242.1,40716,652,502,35494,35445,33594,33214,28174
34987,9,16,34859,128,34987,0,2.16184e+18,15.9927,748.192,34987,16,16,18654,0,4374,17488,18654
14836,579,1997,0,14836,0,14836,2.31078e+18,511.788,4306.17,14836,311,278,12707,11816,8849,7800,4421
6450,22,425,6450,0,6450,0,4.05786e+18,216.646,1347.36,6450,112,113,3584,2239,1486,1353,417
39018,22,48,37897,1121,39018,0,9.66964e+13,18.6536,679.134,39018,24,23,38967,38960,36417,36265,26956
12354,61,203,0,12354,12152,202,2.52441e+16,85.0207,1035.4,12354,68,77,12019,11698,10524,10024,6968
15197,10,46,14927,270,15197,0,1.04889e+14,16.8529,451.724,15197,23,23,15019,14925,13145,13052,8316
39083,504,878,39083,0,39083,0,3.9424e+18,391.227,3790.47,39083,216,214,38205,37947,33694,33257,33582
25572,316,701,25572,0,25572,0,4.24639e+18,327.299,2962.56,25572,190,198,24767,24246,18729,18248,18084
41577,2677,3934,41577,0,37454,4123,2.75875e+18,1102.1,9650.48,41577,418,563,37643,37527,35819,35205,30677
33341,80,86,32701,640,33341,0,1.06568e+14,22.1291,752.295,33341,29,29,33255,33255,33127,33127,32967
6856,10,1072,0,6856,0,6856,2.35731e+18,374.049,2273.83,6856,178,200,2341,1044,958,932,88
1762,34,193,568,1194,0,1762,2.20434e+13,102.066,506.488,1762,84,66,1026,620,572,561,271
46339,637,3161,28007,18332,0,46339,4.90498e+18,1080.17,8674.31,46339,470,492,41556,38979,29693,27221,12312
17189,97,1798,9482,7707,9482,7707,1.58673e+18,626.847,4114.9,17189,281,301,12884,9060,5543,5282,1398
31332,1754,2945,31332,0,27829,3503,2.60075e+18,1058.45,7291.25,31332,366,399,28387,27690,25572,25085,23047
21880,158,284,0,21880,21514,366,2.77758e+16,111.889,1689.6,21880,93,87,21596,21526,20603,20225,18032
12246,20,1176,3639,8607,0,12246,3.32148e+13,249.269,2883.77,12246,184,210,7093,4977,3599,999,585
43895,998,2997,0,43895,0,43895,2.31555e+18,1324.28,8708.03,43895,510,465,39862,37254,26190,24511,15096
49382,2595,4016,49382,0,44132,5250,2.02565e+18,1271.5,10314.6,49382,541,537,45366,44125,44102,43451,36880
33312,27,50,32367,945,33282,30,1.00898e+14,18.7792,643.487,33312,24,25,33262,33257,32321,32302,27332
8873,466,720,5551,3322,0,8873,4.8545e+18,352.198,1999.45,8873,174,175,8153,8114,7584,7491,6907
41060,3016,3758,36862,4198,24333,16727,1.96173e+18,1134.25,9234.83,41060,438,525,37302,37229,36986,37047,32931
5246,24,25,5181,65,5246,0,9.07848e+13,12.9253,232.689,5246,16,18,5221,5221,5181,5181,5162
31199,3442,4374,31199,0,28127,3072,2.05425e+18,915.813,8892.18,31199,563,340,26825,26665,26739,26750,25105
19428,194,195,0,19428,19196,232,2.51431e+16,117.917,1285.85,19428,86,87,19233,19233,19233,19231,19232
16425,600,707,16425,0,16425,0,4.52698e+18,254.129,2326.84,16425,164,162,15718,15717,15500,15525,15433
35115,453,2197,10736,24379,0,35115,3.42436e+13,637.07,6495.51,35115,388,484,32123,30528,24815,24741,11991
3578,348,721,3200,378,2179,1399,1.76539e+18,277.917,1367.3,3578,162,121,2743,2166,2241,2033,2027
549,231,297,334,215,334,215,1.9296e+18,20.9454,377.537,549,61,57,252,250,249,249,204
26972,26,47,26194,778,26972,0,1.04932e+14,17.8316,577.361,26972,25,25,26925,26924,25678,25679,23982
24621,800,2787,14320,10301,14320,10301,1.7491e+18,883.535,6413.14,24621,449,385,21031,19432,16876,16865,8378
22838,2183,2872,20241,2597,13529,9309,1.96959e+18,878.942,6115.61,22838,376,384,19966,19816,19632,19689,18403
8025,1237,1317,4630,3395,4630,3395,1.6659e+18,214.098,2652.4,8025,268,199,6708,6707,6707,6707,6640
29300,1527,2660,17863,11437,0,29300,4.7176e+18,752.089,6579.39,29300,357,389,26640,25973,25494,25078,20849
42718,1366,3481,42718,0,38178,4540,2.31311e+18,1460.76,9241.3,42718,515,461,38301,35989,31911,28431,23451
3555,50,612,1095,2460,0,3555,3.64283e+13,124.491,1250.15,3555,103,135,2580,2104,1584,1644,528
32764,1642,2231,0,32764,10012,22752,8.83366e+15,578.418,6368.59,32764,348,420,30533,30436,30329,30278,27117
13936,2061,2090,7785,6151,0,13936,4.36564e+18,305.442,4081.9,13936,282,281,11846,11845,11846,11846,11797
35165,3230,4220,35165,0,31440,3725,2.0273e+18,801.286,9286.54,35165,411,569,30945,30927,29891,29478,26723
30292,199,839,30286,6,30292,0,4.03311e+18,347.911,3367.35,30292,203,202,28226,25522,16429,15732,11997
30035,695,988,30035,0,30035,0,4.00684e+18,386.771,3506.77,30035,211,211,29047,29035,27390,27463,27140
842,96,222,231,611,0,842,4.98194e+13,29.0285,333.695,842,77,30,620,592,584,584,365
30364,926,2374,18500,11864,0,30364,4.70491e+18,848.453,6444.77,30364,532,347,27463,25397,22705,22320,17228
18520,2765,2940,16236,2284,11057,7463,1.9354e+18,849.729,5961.31,18520,424,345,15580,15576,15573,15577,15513
10167,13,34,9995,172,10167,0,1.04706e+14,15.6551,342.072,10167,19,21,10102,10055,9133,8970,7021
16957,340,855,5470,11487,0,16957,3.48183e+13,388.368,2891.81,16957,253,242,15503,13702,12166,12121,9806
16692,215,251,0,16692,16430,262,2.65058e+16,101.374,1338.52,16692,82,81,16441,16431,16303,16232,15541
4444,1017,1179,0,4444,0,4444,2.45984e+18,175.025,1966.61,4444,189,222,3265,3264,3244,3255,2994
19651,473,1886,11048,8603,11048,8603,1.77454e+18,369.729,4423.69,19651,239,324,17691,17104,15771,14646,8255
13080,457,1978,8002,5078,0,13080,4.81352e+18,360.962,4046.82,13080,267,414,11049,10006,8912,8686,5756
4826,88,636,0,4826,1459,3367,9.30352e+15,187.906,1459.17,4826,142,191,3637,3062,2618,2686,1147
35592,487,657,35592,0,35592,0,4.21e+18,329.565,3349.78,35592,204,206,34935,34901,33204,33000,32388
40690,1024,1848,0,40690,11654,29036,9.56652e+15,945.23,6345.16,40690,466,475,38475,37232,34924,35219,28593
43087,839,3491,24830,18257,24830,18257,1.75165e+18,1168.48,9022.74,43087,533,513,38538,36567,29089,27930,15662
10810,4,27,10635,175,10810,0,1.00066e+14,15.3414,334.729,10810,17,22,9753,9012,8321,8417,5486
39285,452,1201,39285,0,39285,0,4.05903e+18,388.373,4220.63,39285,227,234,38080,37495,28921,28549,26180
34036,1005,2033,10256,23780,0,34036,3.56482e+13,853.781,6171.53,34036,431,417,31669,30942,29169,29295,20793
23255,1487,2178,13836,9419,0,23255,4.78183e+18,883.926,5643.29,23255,403,429,21077,20181,19852,19687,18013
43946,3909,4690,39270,4676,26520,17426,1.9358e+18,1260.12,10980.9,43946,514,614,39256,39241,39009,39031,37713
35657,8250,35657,35657,0,35657,0,1.75917e+13,0,35657,35657,35657,1,0,0,0,0,0
28627,609,3429,25720,2907,17320,11307,1.95815e+18,778.368,7697.92,28627,396,428,23960,21350,14582,13783,8398
2707,198,552,0,2707,867,1840,9.32133e+15,165.993,1033.07,2707,124,132,2057,1855,1686,1692,1033
25415,827,2586,25415,0,22591,2824,1.34158e+18,1207.41,6408.13,25415,402,403,21675,19434,12688,10755,9731
23046,1177,1517,6979,16067,0,23046,3.6176e+13,499.759,4300.2,23046,311,299,21529,21516,20938,20943,19737
11514,76,1584,6998,4516,0,11514,4.86407e+18,306.545,3305.53,11514,223,239,7133,5324,3755,2925,938
25953,1694,1868,7517,18436,0,25953,3.56426e+13,535.864,5376.33,25953,353,353,24085,24084,24017,24022,23474
19848,1622,1698,12051,7797,12051,7797,1.78481e+18,641.543,4512.97,19848,342,274,18150,18150,18110,18127,17966
3832,589,905,0,3832,0,3832,2.54706e+18,157.269,1573.29,3832,121,165,2927,2901,2861,2907,2279
41081,533,2837,22754,18327,0,41081,4.09405e+18,906.404,7580.13,41081,424,373,36873,34818,25657,24275,10881
40039,61,62,39401,638,40039,0,1.01612e+14,19.9791,763.149,40039,27,29,39977,39977,39955,39955,39960
49171,472,782,49171,0,49171,0,3.91627e+18,364.199,4011.54,49171,215,217,48389,48244,44984,44754,42388
25747,783,2144,0,25747,7717,18030,9.4347e+15,606.067,5681.17,25747,322,372,23591,22918,21216,20907,12938
21780,28,269,0,21780,21469,311,2.58951e+16,116.214,1620.37,21780,88,95,20531,19777,17073,13714,9068
6959,57,374,6959,0,6959,0,4.64182e+18,207.789,1302.04,6959,114,115,5248,3914,2759,2358,1403
7984,724,1381,4809,3175,4809,3175,1.85776e+18,326.248,2780.92,7984,157,299,6603,6529,6316,6387,4854
23823,795,2231,13521,10302,0,23823,4.4827e+18,863.445,5622.45,23823,348,380,21053,20239,15749,14926,11890
5189,146,1149,3329,1860,3329,1860,1.76661e+18,290.301,2043.21,5189,240,185,3376,2793,2171,1579,559
36468,43,247,0,36468,35787,681,2.5351e+16,150.398,2016.16,36468,99,102,35157,34213,29497,26422,17337
1148,121,389,0,1148,0,1148,2.50715e+18,70.2274,588.525,1148,55,80,759,664,578,578,251
9648,429,1478,5911,3737,5911,3737,1.81623e+18,430.842,3002.64,9648,273,277,7948,6746,5706,5838,4510
2593,571,943,2378,215,1548,1045,2.07514e+18,91.86,1312.09,2593,149,99,1650,1626,1546,1556,1025
21230,822,2480,13088,8142,13088,8142,1.82473e+18,478.124,5699.93,21230,304,445,18750,18198,15388,16341,9017
15379,58,604,15379,0,15379,0,4.06299e+18,269.252,2251.49,15379,155,164,10842,6746,5645,5437,2142
32870,1416,2601,0,32870,0,32870,2.06523e+18,923.765,6765.58,32870,349,508,30269,28990,28753,26190,23922
17155,16,44,16754,401,17155,0,1.02155e+14,16.9872,473.187,17155,23,26,17084,17033,15373,15127,9722
20512,1702,1988,0,20512,0,20512,2.40105e+18,748.686,4921.02,20512,371,364,18524,18327,18219,17964,17465
46864,232,313,0,46864,45692,1172,2.57962e+16,155.353,2569.82,46864,100,112,46551,46501,44544,43827,40856
21087,1569,3018,21062,25,18749,2338,2.40304e+18,957.106,6448.82,21087,346,511,18069,17073,16034,16043,12354
41996,30,2533,0,41996,12106,29890,9.3062e+15,771.378,7622.77,41996,562,377,27183,20935,16318,16678,3225
43078,571,2326,12342,30736,0,43078,3.67395e+13,781.367,7183.7,43078,591,381,39730,38267,29738,29226,15682
8290,228,1148,0,8290,2410,5880,8.93261e+15,248.548,2478,8290,251,180,6982,6267,4974,4842,2573
6530,253,390,6530,0,6530,0,3.99226e+18,187.628,1308.72,6530,113,99,6129,5957,5566,5528,5055
4721,335,989,2835,1886,0,4721,4.90337e+18,263.689,1859.01,4721,174,186,3674,3334,2815,2902,1535
34092,68,72,33315,777,34092,0,1.02139e+14,16.4034,698.865,34092,29,28,34020,34020,33960,33960,33753
49440,4139,4819,49440,0,43777,5663,2.14811e+18,1126.69,11479.6,49440,502,656,44621,44617,44452,44164,42740
23541,445,2241,0,23541,0,23541,2.40621e+18,736.973,5509.88,23541,402,315,20146,18332,14072,13573,7391
14429,996,1589,8012,6417,0,14429,4.23313e+18,293.795,3508.22,14429,200,289,12840,12829,12664,12677,10451
12269,492,551,12269,0,12269,0,4.07956e+18,249.245,1957.76,12269,144,136,11718,11717,11634,11633,11524
8571,645,1311,5003,3568,0,8571,4.29598e+18,330.068,2733.77,8571,254,221,7260,6975,6075,6022,4828
9537,586,1976,0,9537,0,9537,2.47928e+18,292.439,3447.44,9537,288,259,7561,7260,5396,5089,2792
45588,243,987,45588,0,45588,0,4.02236e+18,365.935,4175.66,45588,217,218,43706,41608,28287,27810,21926
26456,3051,3148,26431,25,23626,2830,2.28508e+18,836.921,7352.45,26456,350,497,23308,23307,23261,23269,22970
47047,2261,3627,28764,18283,0,47047,4.79746e+18,931.582,9080.09,47047,523,409,43420,43256,39813,38838,30024
20125,130,225,0,20125,19715,410,2.57546e+16,111.724,1372.43,20125,87,92,19879,19825,18249,18192,14983
38623,76,101,37774,849,38623,0,1.05563e+14,19.8848,846.785,38623,29,31,38522,38522,38086,38086,36036
41426,1,12,38837,2589,41250,176,0.000265534,0.99971,670.469,41426,12,1,41414,41414,41414,41414,41414
12289,6,227,0,12289,12052,237,2.59523e+16,89.4548,1121.58,12289,69,71,10034,8759,8126,6852,4401
32018,512,2633,28431,3587,19293,12725,2.03394e+18,885.506,6879.1,32018,564,329,26110,22664,17455,16274,11513
42955,255,359,0,42955,41956,999,2.64159e+16,143.672,2573.21,42955,113,121,42596,42570,41552,41263,38306
28363,2351,2708,0,28363,0,28363,2.34001e+18,813.487,6609.58,28363,377,347,25655,25655,25286,25030,24534
44625,766,3532,40041,4584,27131,17494,1.96255e+18,1382.63,9592.94,44625,568,423,38592,35496,22845,21658,11116
21807,39,56,21370,437,21807,0,1.05145e+14,18.0489,570.216,21807,26,27,21751,21751,21123,21125,20011
41457,1325,1999,12346,29111,0,41457,3.35952e+13,676.68,6451.1,41457,344,430,39458,39303,39067,39031,34452
32120,1271,1916,9956,22164,0,32120,3.59562e+13,668.005,5996.08,32120,391,383,30204,30160,28361,28427,24055
11314,702,1177,3522,7792,0,11314,3.49959e+13,335.599,2818.35,11314,235,265,10137,9948,9532,9517,7400
36040,1231,3139,32327,3713,21471,14569,1.98288e+18,1219.99,8245.57,36040,466,453,32300,29224,21083,20876,16136
3656,9,391,3656,0,3656,0,4.0955e+18,184.098,989.338,3656,93,87,1565,664,753,674,111
9102,846,1703,0,9102,0,9102,2.31179e+18,269.253,3190.45,9102,273,274,7399,7324,7052,7080,4599
24080,2457,2572,14014,10066,0,24080,4.40202e+18,663.615,5919.69,24080,338,412,21508,21496,21493,21507,21218
41791,334,4009,25302,16489,0,41791,4.64143e+18,1024.02,9611.11,41791,505,688,33733,29037,21066,17360,7305
9291,381,1598,8249,1042,5223,4068,1.89006e+18,438.133,3228.31,9291,207,323,7286,6446,5510,5335,2004
24258,831,863,24258,0,24258,0,4.21396e+18,304.379,2990.6,24258,186,194,23395,23395,23375,23379,23331
46371,744,2397,0,46371,13669,32702,9.33129e+15,612.502,7667.85,46371,416,478,43791,42588,38872,39483,17592
33354,963,2536,20253,13101,0,33354,4.8337e+18,1046.68,6902.9,33354,519,381,30130,28697,26073,25194,16310
31527,870,3319,18879,12648,18879,12648,1.78597e+18,828.382,7839.6,31527,506,560,27806,26593,22209,22056,11763
30469,39,76,29743,726,30469,0,1.02395e+14,18.6827,711.058,30469,30,28,30393,30390,29137,29144,23498
5557,728,827,3185,2372,3185,2372,1.87528e+18,255.958,1700.48,5557,221,143,4730,4729,4712,4712,4525
8637,51,162,0,8637,8362,275,2.57462e+16,82.852,782.183,8637,57,61,8340,8195,7362,6957,4436
6283,10,24,6152,131,6283,0,9.14359e+13,14.2846,244.156,6283,17,18,6219,6169,5675,5597,4755
1568,121,521,1568,0,1446,122,3.17109e+18,45.5108,735.094,1568,99,83,1047,936,481,368,79
40303,1991,2437,0,40303,12496,27807,8.96757e+15,725.628,7110.95,40303,410,374,37866,37780,37376,37315,35260
14296,127,1513,7495,6801,7495,6801,1.45134e+18,223.578,3388.54,14296,273,255,12108,10211,4187,4791,1908
44619,3097,3318,26806,17813,26806,17813,1.88446e+18,1025.85,8638.02,44619,611,413,41301,41215,41194,41205,40714
37528,3136,3634,21560,15968,0,37528,4.61789e+18,1179.39,8694.72,37528,449,534,33894,33249,33609,33609,32061
13475,584,1747,7671,5804,7671,5804,1.70789e+18,369.656,3714.7,13475,224,295,11708,11143,9645,9175,3364
10636,1142,1344,6422,4214,6422,4214,1.94646e+18,643.437,3003.12,10636,265,243,9292,8666,9102,9162,8826
15489,312,1624,0,15489,4975,10514,8.69415e+15,384.539,3875.81,15489,350,206,13635,12926,9198,8793,5043
30906,1063,3349,27670,3236,18651,12255,1.92235e+18,996.1,8011.41,30906,359,463,26409,24212,20142,19255,11037
18833,715,2559,0,18833,0,18833,2.36427e+18,783.514,5500.98,18833,358,377,15778,14781,12726,12180,6588
3735,21,27,3645,90,3735,0,9.95528e+13,15.8059,213.772,3735,17,17,3708,3705,3572,3566,3454
1326,568,622,1326,0,1200,126,2.96462e+18,74.6946,822.528,1326,132,77,704,704,704,704,689
11092,263,671,3494,7598,0,11092,3.49787e+13,272.413,1985.45,11092,175,177,10225,8595,8105,8048,6462
19640,764,1194,0,19640,6132,13508,8.35899e+15,471.572,3561.12,19640,273,258,18446,18111,17630,17698,14219
20138,358,855,20138,0,20138,0,4.32645e+18,344.006,2839.54,20138,183,187,19220,18658,13668,13523,12344
42661,925,4286,38251,4410,24705,17956,1.94239e+18,1160.09,10255.3,42661,550,603,37281,35623,20031,19723,10640
20874,1,30,20740,134,20874,0,1.00365e+14,21.6927,461.02,20874,20,22,8936,8936,8936,8936,8936
19266,705,1513,0,19266,6059,13207,8.83565e+15,337.465,3944.93,19266,255,299,17753,17565,15814,16001,9973
36080,2109,2611,21495,14585,0,36080,4.92522e+18,1245.46,7260.92,36080,470,372,33469,32984,32381,32283,31156
6091,1156,1459,3671,2420,0,6091,4.94658e+18,212.641,2514.75,6091,141,246,4632,4626,4556,4565,4075
32963,2252,2419,32963,0,29048,3915,1.30307e+18,1193.52,6880.99,32963,389,408,30544,30544,30516,30514,30099
28988,2820,3236,28988,0,25911,3077,2.62855e+18,985.178,7454.65,28988,381,369,25752,25745,25748,25748,25008
42812,897,1770,12483,30329,0,42812,3.71649e+13,693.122,6385.36,42812,481,320,41031,40373,37306,37547,29163
10224,59,903,6410,3814,0,10224,4.72507e+18,401.09,2333.6,10224,185,183,5768,4218,3144,2622,1277
16441,1235,2081,10058,6383,10058,6383,1.89022e+18,538.437,4431.52,16441,378,270,14360,14210,13735,13640,11631
45102,2725,2847,26751,18351,26751,18351,1.84149e+18,959.312,8281.11,45102,473,417,42255,42255,42249,42244,41908
30211,1198,2508,17556,12655,0,30211,4.35675e+18,662.422,6493.8,30211,366,352,27703,27540,24531,23879,13453
12086,1232,1649,6732,5354,6732,5354,1.52867e+18,282.732,3421.6,12086,211,364,10437,10333,10186,9668,9252
40527,3746,3838,36336,4191,24300,16227,2.00744e+18,1188.63,9491.78,40527,621,448,36689,36689,36688,36687,36425
23282,255,667,23257,25,23282,0,4.42032e+18,312.484,2791.71,23282,188,175,22312,21373,14288,13995,12823
36633,418,2040,11840,24793,0,36633,2.97036e+13,490.108,6085.49,36633,402,380,34118,33078,26165,24495,12305
26321,1829,3639,15146,11175,15146,11175,1.70312e+18,537.105,7624.7,26321,375,631,22682,22579,21721,21875,14205
18423,308,597,18423,0,18423,0,4.17038e+18,297.884,2431.2,18423,169,162,17771,17424,14250,14105,12619
24158,1437,2185,14197,9961,14197,9961,1.79134e+18,729.105,5606.83,24158,363,379,21973,21712,20912,20925,15253
39161,606,2560,0,39161,0,39161,2.37514e+18,885.636,7342.51,39161,490,469,35250,32809,24096,17959,14558
6837,61,500,6837,0,6837,0,4.22947e+18,220.639,1436.66,6837,117,122,4950,3448,2557,2454,1096
5109,811,1256,0,5109,0,5109,2.55688e+18,162.471,2015.86,5109,163,173,3853,3852,3741,3757,2665
23700,696,2032,0,23700,7530,16170,8.26278e+15,400.444,5239.69,23700,406,411,21644,21092,19013,18840,11553
6000,8,40,5871,129,6000,0,1.04568e+14,12.8273,287.02,6000,18,20,5877,5819,5163,5088,3466
31600,1291,1446,9103,22497,0,31600,3.64102e+13,624.735,4777.48,31600,347,335,30154,30153,30111,30130,29165
47696,208,332,0,47696,46657,1039,2.62149e+16,169.315,2616.18,47696,122,121,47361,47237,44869,44625,38806
33968,3051,3368,30698,3270,19886,14082,1.95831e+18,959.539,8166.38,33968,539,440,30600,30591,30589,30583,29947
27747,596,1735,7738,20009,0,27747,3.71532e+13,482.724,5173.09,27747,436,266,25850,24873,23112,23182,14188
18796,1512,3012,18796,0,16870,1926,1.71813e+18,591.462,5874.3,18796,392,393,15784,15536,14927,14849,10560
6014,162,590,1902,4112,0,6014,3.68906e+13,233.358,1468.5,6014,157,174,4948,4177,3346,3428,2014
19620,1972,2153,10898,8722,10898,8722,1.52712e+18,424.236,4660.3,19620,251,382,17467,17366,17404,17425,16802
8111,227,885,0,8111,2459,5652,9.61951e+15,291.153,2148.12,8111,215,191,6835,6060,5394,5420,3385
32238,88,293,0,32238,31593,645,2.60622e+16,129.414,2007.54,32238,97,102,31747,31357,28175,26492,19751
30203,2894,4025,30203,0,26819,3384,1.3408e+18,823.598,8633.87,30203,437,424,26178,26027,25754,25652,21359
47199,309,1201,47199,0,47199,0,3.99902e+18,365.359,4412.01,47199,239,231,45710,44100,30296,29073,25411
38551,1138,2322,0,38551,11923,26628,8.43291e+15,749.892,6941.03,38551,471,507,36228,35315,32991,33127,21652
26964,238,2071,8878,18086,0,26964,3.32641e+13,504.932,5698.41,26964,421,405,23603,21709,13871,11853,6864
17269,2011,2178,15355,1914,10353,6916,2.01106e+18,1056.44,4967.63,17269,365,325,15091,15082,15087,15087,14887
41630,88,94,40637,993,41620,10,9.9196e+13,19.9185,823.376,41630,30,33,41536,41536,41391,41391,41158
32053,79,1884,9888,22165,0,32053,3.31549e+13,492.635,5724.66,32053,376,349,25007,21011,16088,7105,2930
22629,113,247,0,22629,22306,323,2.60572e+16,127.23,1615.88,22629,82,94,22303,22104,20247,20199,15882
28951,40,70,28343,608,28936,15,1.02047e+14,18.6605,683.977,28951,29,28,28881,28877,27624,27648,20391
14405,449,1422,0,14405,4392,10013,9.47554e+15,298.454,3421.52,14405,315,221,12981,12471,10320,10470,7804
16298,796,1404,5229,11069,0,16298,3.50987e+13,363.191,3663.34,16298,321,329,14894,14791,14442,14448,10956
41549,2769,3037,0,41549,0,41549,2.42536e+18,1138.21,8341.84,41549,488,457,38512,38512,38361,38180,37125
30855,663,862,30855,0,30855,0,4.28937e+18,341.96,3389.68,30855,199,207,29993,29971,28903,28935,28059
6897,1257,1279,0,6897,0,6897,1.89384e+18,207.883,2415.16,6897,252,194,5618,5618,5618,5618,5615
27088,1985,3146,24127,2961,16132,10956,1.97587e+18,1143.86,7121.96,27088,446,544,23942,22962,21907,22125,18715
47921,146,1710,13259,34662,0,47921,3.71758e+13,839.834,6387.88,47921,505,368,39368,34169,27230,20590,9547
3497,578,634,942,2555,0,3497,3.55084e+13,101.112,1231.09,3497,125,129,2863,2863,2862,2862,2758
31154,1295,1916,0,31154,9207,21947,9.39124e+15,641.705,5720.44,31154,456,417,29238,29016,27614,27708,23638
35339,493,4564,31686,3653,21232,14107,1.98318e+18,1101.3,9880.7,35339,467,535,28116,24283,17282,15309,3455
5506,386,763,0,5506,1671,3835,9.67912e+15,176.222,1597.14,5506,194,122,4743,4642,4611,4620,3945
38080,3226,3947,38080,0,34023,4057,2.49841e+18,747.668,8974.84,38080,351,576,34133,34123,33511,33162,31215
44136,962,3836,44136,0,39506,4630,2.32013e+18,814.107,9074.2,44136,505,492,39863,38810,31637,29819,20929
15308,1371,1400,0,15308,5014,10294,7.5934e+15,236.869,3505.64,15308,249,388,13908,13904,13908,13908,13739
16574,139,2035,16574,0,14885,1689,2.31548e+18,783.328,4656.77,16574,317,329,11530,9265,4919,5005,1168
4916,385,908,0,4916,1326,3590,9.60203e+15,203.357,1726.1,4916,170,160,4008,3814,3616,3681,1836
25953,1243,1494,7508,18445,0,25953,3.60133e+13,494.15,4392.38,25953,374,252,24459,24458,24141,24190,22578
48655,986,1051,48655,0,48655,0,4.16203e+18,381.176,4399.78,48655,233,235,47604,47601,47484,47467,47368
22792,156,242,0,22792,22392,400,2.41478e+16,109.971,1468.06,22792,81,98,22550,22502,21322,21484,19414
17225,103,211,0,17225,16941,284,2.5581e+16,119.093,1248.21,17225,77,89,16954,16800,15203,15311,12241
16020,333,529,16020,0,16020,0,4.20085e+18,253.619,2199.96,16020,154,166,15491,15324,13604,13635,12136
26935,2201,2502,23591,3344,16366,10569,1.88585e+18,1184.03,6361.52,26935,466,403,24433,24433,24431,24424,24233
30917,381,3594,18281,12636,0,30917,4.6091e+18,937.233,8104.38,30917,454,578,25466,22767,14717,11973,3408
6067,865,1098,1885,4182,0,6067,3.39426e+13,181.254,2146.89,6067,215,150,4969,4964,4914,4907,4211
8769,936,1377,5343,3426,5343,3426,1.86295e+18,367.295,2773.01,8769,208,236,7392,7255,7199,7267,5546
21186,1926,3049,12861,8325,0,21186,4.8528e+18,631.752,6320.28,21186,354,352,18137,18030,16985,16605,11173
24355,1489,2031,21634,2721,14983,9372,1.94756e+18,827.741,5405.52,24355,349,397,22324,21966,21517,21498,20482
16327,280,710,16321,6,16327,0,3.9687e+18,295.051,2428.02,16327,167,163,15516,14842,11594,11335,9762
19627,47,623,19617,10,19627,0,4.35783e+18,304.781,2539.72,19627,170,164,13815,9978,6684,6234,2801
48034,1607,3458,29449,18585,29449,18585,1.84131e+18,790.405,9148.24,48034,526,384,44576,44046,40189,38664,28688
17346,871,3135,15301,2045,10308,7038,1.9669e+18,535.146,5909.55,17346,479,373,14211,13311,7374,6782,6299
43405,1333,1898,0,43405,12057,31348,9.66977e+15,833.569,6486.74,43405,518,420,41507,41004,39651,39629,34704
22038,240,933,22031,7,22013,25,4.2227e+18,347.033,3035.55,22038,186,194,20508,18935,12051,11977,8153
5766,1035,1246,0,5766,0,5766,2.52284e+18,234.536,2212.76,5766,255,188,4520,4518,4416,4418,4065
7544,1328,1447,6671,873,4477,3067,1.92299e+18,334.046,2731.68,7544,206,196,6097,6097,6090,6092,5791
20744,1012,1821,12356,8388,0,20744,4.92722e+18,572.681,4689.96,20744,351,269,18923,18390,17201,16721,13896
22216,961,1469,0,22216,7050,15166,9.10067e+15,346.305,4111.09,22216,358,356,20747,20728,19743,19787,18354
30140,39,1464,0,30140,9209,20931,8.5352e+15,385.985,4775.38,30140,265,295,20339,15558,12893,12034,3414
10869,107,1833,6417,4452,0,10869,5.20556e+18,308.983,3533.6,10869,236,244,7766,6312,4668,4101,1235
16065,1113,2221,14090,1975,9726,6339,1.94463e+18,537.087,4857.62,16065,272,308,13844,13752,12427,12489,7551
8788,24,1493,5281,3507,0,8788,4.88533e+18,377.872,3019.88,8788,209,285,4149,2457,1908,1977,219
43434,2233,2418,0,43434,12976,30458,9.20798e+15,711.07,7342.99,43434,430,450,41016,41016,40985,40970,40482
40462,786,929,40456,6,40462,0,4.18585e+18,367.479,3942.16,40462,221,220,39533,39529,38869,38911,38576
17910,154,234,0,17910,17612,298,2.47113e+16,102.595,1418.18,17910,83,83,17676,17643,17067,17133,15228
6819,1322,1577,6047,772,4139,2680,1.87526e+18,456.314,2825.43,6819,224,275,5242,5001,5031,5061,4946
22258,1205,1898,6826,15432,0,22258,3.36807e+13,498.319,4890.14,22258,327,344,20360,20174,19705,19725,13967
15347,183,234,0,15347,15116,231,2.48284e+16,93.1174,1337.97,15347,80,70,15113,15106,15030,14991,13870
7676,791,965,4739,2937,0,7676,5.20916e+18,305.35,2134.95,7676,192,164,6711,6703,6686,6689,6461
21244,286,1599,6132,15112,0,21244,3.55819e+13,411.562,4432.93,21244,306,303,18988,17522,14432,14131,6290
31361,134,2460,18736,12625,0,31361,4.81447e+18,838.844,6527.44,31361,370,443,23062,18561,13304,12477,2826
22087,33,65,21675,412,22087,0,1.04169e+14,17.2931,603.445,22087,28,29,22022,22022,21189,21211,17387
26163,4,40,25662,501,26163,0,1.01668e+14,19.6592,542.52,26163,23,24,23799,22379,20559,20139,11859
21217,151,2397,12867,8350,12867,8350,1.74624e+18,475.404,5390.3,21217,449,270,15481,12556,8684,7235,1855
34609,1455,3350,0,34609,0,34609,2.39171e+18,906.863,7907.97,34609,412,393,31259,30434,28234,22235,20150
31366,2164,2257,9797,21569,0,31366,3.45539e+13,611.859,6205.97,31366,527,471,29109,29109,29088,29087,28889
49575,2215,2855,28441,21134,28441,21134,1.59847e+18,859.592,8043.4,49575,449,501,46720,46637,46043,46004,40277
2118,237,476,702,1416,0,2118,3.23659e+13,95.1657,852.218,2118,101,100,1642,1595,1572,1565,994
29694,60,69,28995,699,29694,0,1.03418e+14,18.3321,673.925,29694,26,27,29625,29625,29587,29587,29241
15274,1005,1092,0,15274,5198,10076,8.54641e+15,387.637,3230.66,15274,243,257,14182,14182,14139,14128,13962
36648,34,102,35977,671,36648,0,1.0656e+14,17.6732,833.234,36648,29,30,36546,36540,33576,33429,21652
4937,303,1017,0,4937,0,4937,2.58579e+18,210.392,1807.28,4937,174,160,3868,3423,3466,3280,1040
6267,696,1658,6267,0,5688,579,2.03551e+18,270.893,2670.47,6267,215,223,4609,4409,2804,2532,1870
10728,2116,2426,10728,0,9646,1082,2.7988e+18,393.801,4170.4,10728,269,306,8302,8279,8288,8286,7764
5835,632,1046,0,5835,0,5835,2.45665e+18,223.991,2006.28,5835,162,175,4789,4705,4641,4631,3091
6351,574,734,2005,4346,0,6351,3.17897e+13,118.492,1656.65,6351,122,160,5617,5615,5606,5617,4323
47224,1128,2803,0,47224,0,47224,2.38413e+18,1271.53,8402.38,47224,528,487,43388,40227,35930,27480,27283
6403,161,346,6403,0,6403,0,4.23935e+18,174.462,1184.28,6403,101,107,5978,5732,3891,4171,3034
45079,71,311,0,45079,44458,621,2.53231e+16,148.874,2494.31,45079,105,114,44292,43497,37700,35090,24933
40060,529,2914,23927,16133,0,40060,4.75248e+18,1081.34,8092.82,40060,453,454,34598,31170,22410,19632,10622
48232,2463,3555,28721,19511,28721,19511,1.83626e+18,1000.7,9739.18,48232,424,594,44677,44636,43930,44188,37090
13930,1950,2821,13930,0,12681,1249,2.43796e+18,578.119,5059.74,13930,315,364,11109,11096,11041,11086,9911
26662,43,1874,15276,11386,0,26662,4.50694e+18,994.081,5359.5,26662,415,332,15757,10336,6216,6769,1083
18247,1776,2328,16174,2073,11027,7220,1.98852e+18,684.455,5078.68,18247,281,299,15919,15860,15729,15772,14370
42841,6,66,42092,749,42799,42,9.96837e+13,20.5961,862.578,42841,27,28,41318,39377,34631,35090,19236
11485,384,453,11485,0,11485,0,4.31947e+18,246.426,1793.61,11485,135,125,11032,11012,10626,10612,9935
40361,4717,5707,40361,0,36134,4227,1.59908e+18,1053.46,11934.5,40361,567,603,34654,34634,34430,34525,30577
21982,2348,2431,0,21982,0,21982,2.33249e+18,637.169,5545.38,21982,350,385,19551,19549,19539,19543,19390
23777,98,259,0,23777,23357,420,2.59629e+16,100.419,1655.35,23777,86,85,23445,23230,21578,20542,15916
23463,482,1756,0,23463,7168,16295,8.8885e+15,376.918,4887.42,23463,240,359,21578,20935,19379,19604,9531
22443,829,2683,0,22443,0,22443,2.17101e+18,570.478,5946.42,22443,313,392,19760,18884,11348,9479,8187
40117,1751,3114,23797,16320,0,40117,4.75706e+18,1319.08,8646.39,40117,502,543,36721,35014,32843,32588,28348
28479,1076,1922,0,28479,8605,19874,9.26789e+15,660.541,5483.22,28479,372,382,26557,26008,24599,24728,16778
37995,800,833,37995,0,37995,0,4.54615e+18,347.96,3639.84,37995,216,216,37162,37161,37125,37139,37037
46457,1068,2332,13950,32507,0,46457,3.58201e+13,730.193,7484.04,46457,512,480,44057,43208,40636,40780,29664
22887,19785,22887,0,22887,22887,0,4095.82,0,22887,22887,22887,1,0,0,0,0,0
3717,23,123,0,3717,3626,91,2.5764e+16,40.5004,445.119,3717,39,47,3509,3425,3156,2923,1901
11300,152,222,0,11300,11013,287,2.61895e+16,90.4444,1100.91,11300,71,68,11078,11047,10705,10808,9453
9882,1462,2147,9882,0,9022,860,2.14271e+18,339.582,3737.87,9882,240,291,7735,7698,7488,7557,6001
19080,25,41,18684,396,19080,0,9.94311e+13,16.3083,470.562,19080,22,23,19039,19038,18065,18087,14607
11136,180,541,11136,0,11136,0,4.10177e+18,288.695,1881.4,11136,151,138,10110,8991,6614,6254,5361
6483,260,441,6483,0,6483,0,4.95349e+18,223.813,1354.91,6483,115,110,6034,5787,4766,4731,4328
40706,2095,3115,0,40706,0,40706,2.2222e+18,826.234,8377.25,40706,465,384,37591,37576,34315,30599,28996
42375,1921,3722,25135,17240,25135,17240,1.93713e+18,1025,9315.61,42375,467,522,38653,37821,36816,37073,21362
7054,523,601,7054,0,7054,0,4.06834e+18,236.299,1599.92,7054,124,122,6453,6453,6424,6423,6411
45222,99,110,44367,855,44930,292,1.04083e+14,22.3424,1017.09,45222,35,32,45112,45112,44790,44805,43785
4889,61,653,1510,3379,0,4889,3.344e+13,318.02,1516.7,4889,175,179,3363,2792,2363,2099,831
29566,281,1916,17467,12099,0,29566,4.86537e+18,994.411,5705.88,29566,440,370,24330,21358,16064,13675,6547
43380,654,1154,43127,253,43380,0,4.09881e+18,373.494,4321.61,43380,232,237,42226,42141,38336,38222,37392
41132,991,2366,12342,28790,0,41132,3.4339e+13,704.564,7285.93,41132,447,385,38764,37301,35504,35515,23318
1724,281,391,581,1143,0,1724,2.76785e+13,59.9229,683.485,1724,125,63,1333,1325,1328,1327,1165
40766,699,2118,0,40766,12651,28115,9.27207e+15,623.301,6736.23,40766,433,355,38247,37141,32272,32330,20798
35996,68,82,35374,622,35996,0,1.05026e+14,19.8645,766.766,35996,28,31,35914,35914,34991,34992,33191
38714,1668,2716,0,38714,0,38714,2.46715e+18,1269.77,7718.21,38714,588,471,35697,34583,34490,31962,27774
39110,1638,3910,23416,15694,0,39110,4.72119e+18,527.807,9208.26,39110,589,434,35200,35122,23625,23055,16943
37361,549,3291,0,37361,0,37361,2.36033e+18,837.879,8019.78,37361,455,386,32802,29704,16327,14831,11014
725,230,237,238,487,0,725,3.65257e+13,33.829,369.704,725,50,67,488,488,486,486,484
49138,269,3481,29818,19320,0,49138,4.9645e+18,1142.57,9672.37,49138,612,425,39306,32406,25368,21667,4484
15445,361,1124,4939,10506,0,15445,3.63738e+13,324.676,2953.97,15445,258,213,14253,13822,11885,11922,9972
1375,528,614,1375,0,1236,139,2.60705e+18,81.616,833.078,1375,123,108,761,761,751,737,723
21695,740,2295,13167,8528,0,21695,4.90704e+18,652.335,5305.89,21695,393,351,19106,18010,13158,13100,10671
45118,39,76,44302,816,45106,12,1.0149e+14,21.842,887.247,45118,28,31,45042,45034,43072,43023,36375
23720,571,1537,0,23720,7832,15888,8.82213e+15,550.442,4578.66,23720,325,387,21874,20732,17968,17906,12143
21017,21,231,0,21017,20653,364,2.62387e+16,119.026,1516.11,21017,89,85,19329,18247,15318,13173,8601
47223,34,56,46466,757,47223,0,1.01586e+14,21.6487,750.462,47223,26,28,47167,47165,46048,46050,42091
31569,35,84,30947,622,31563,6,1.00093e+14,21.1526,803.26,31569,28,31,31485,31475,29372,29397,23559
35576,427,833,35576,0,35576,0,3.98401e+18,332.967,3516.7,35576,213,205,34743,34570,28680,28251,23895
2136,52,499,1286,850,0,2136,4.88619e+18,181.081,900.389,2136,104,106,1234,961,794,783,221
5877,1331,1443,0,5877,0,5877,2.45196e+18,206.714,2416.5,5877,213,175,4434,4434,4432,4434,3963
1450,8,534,876,574,0,1450,5.03745e+18,71.1503,780.986,1450,86,91,449,188,154,193,43
6436,799,1129,0,6436,0,6436,2.38501e+18,367.812,2205.86,6436,180,179,5307,5046,5189,5205,4419
42866,975,2886,42866,0,38959,3907,2.27921e+18,1480.12,8368.3,42866,472,387,37147,34184,24097,20783,17093
22602,1021,1660,0,22602,7293,15309,8.78135e+15,472.159,4625.63,22602,341,283,20942,20863,20121,20239,16862
19313,1212,2503,19313,0,17473,1840,2.41565e+18,581.468,5364.47,19313,335,317,16810,16459,14808,14158,9607
48600,700,2733,13761,34839,0,48600,3.5976e+13,767.678,8535.03,48600,448,536,45368,44055,40599,40891,17127
2618,216,753,1628,990,1628,990,1.77008e+18,205.158,1229.95,2618,135,174,1780,1463,1383,1392,503
37019,2909,2968,0,37019,0,37019,2.27338e+18,701.403,7609.86,37019,345,413,34051,34051,34051,34051,33955
36409,1975,2785,22331,14078,0,36409,4.91141e+18,1062.69,7492.15,36409,367,458,33624,32541,32901,32825,29265
38403,936,2959,0,38403,0,38403,2.39824e+18,918.896,8015.43,38403,440,420,34615,32379,26753,18838,16625
48129,3843,4171,0,48129,0,48129,2.26686e+18,1370.36,10585.2,48129,563,612,43958,43871,43767,43720,42784
30974,648,3097,18527,12447,0,30974,4.65931e+18,986.362,7558.9,30974,425,578,26374,23882,18656,18896,7101
16536,1269,2242,9683,6853,0,16536,5.13299e+18,513.069,4745.91,16536,266,372,14294,13969,13788,13791,9406
17538,51,71,17107,431,17538,0,1.0583e+14,14.9276,545.559,17538,25,24,17467,17467,17145,17145,15883
44969,698,3218,27184,17785,0,44969,4.88994e+18,1136.17,9142.66,44969,502,467,39612,36477,29215,26652,14564
6969,363,1080,2063,4906,0,6969,3.49234e+13,170.301,2187.41,6969,213,167,5889,5688,4956,5013,2877
10452,519,946,0,10452,3027,7425,9.25321e+15,283.942,2351.65,10452,269,194,9506,9428,8672,8750,7655
33607,139,3073,30383,3224,19929,13678,1.97187e+18,1519.99,7954.56,33607,437,495,23323,18278,10635,8327,1862
16607,118,1417,5287,11320,0,16607,3.48695e+13,450.969,3751.18,16607,289,338,13345,11687,8033,5454,3020
9996,1879,2035,8986,1010,5964,4032,1.9802e+18,356.893,3644.53,9996,295,174,7961,7958,7951,7953,7833
21064,1141,2305,18572,2492,12842,8222,1.95631e+18,1190.3,5669.77,21064,376,368,18068,15846,15208,15005,10844
4012,94,644,0,4012,1291,2721,9.09889e+15,208.936,1370.26,4012,155,153,2957,2553,1915,1930,752
35285,1269,3576,0,35285,0,35285,2.22939e+18,752.103,8447.65,35285,481,436,31709,30840,27741,27247,18008
36660,2367,2805,22129,14531,22129,14531,1.81336e+18,650.116,7492.05,36660,323,547,33855,33849,33694,33723,32439
37230,950,3710,21645,15585,0,37230,4.81785e+18,761.451,8897.16,37230,564,467,33187,31756,22184,20955,13125
43356,343,1677,43356,0,39174,4182,1.36015e+18,1118.58,6060.4,43356,413,340,37927,35593,13102,8472,7193
2251,469,742,2251,0,2045,206,2.44242e+18,65.4522,1068.89,2251,134,100,1509,1501,1381,1451,589
18354,1327,1357,5754,12600,0,18354,3.49039e+13,391.051,3720.85,18354,252,303,16997,16997,16992,16993,16922
26840,1,51,26478,362,26840,0,9.93345e+13,18.7819,587.3,26840,27,25,11140,11140,11140,11140,11140
2572,226,319,2572,0,2572,0,4.05019e+18,120.994,769.884,2572,79,82,2253,2219,2162,2153,1994
20010,297,667,20010,0,20010,0,4.47999e+18,303.527,2633.19,20010,171,178,19225,18633,13844,13542,13213
30660,1135,2966,0,30660,0,30660,2.2952e+18,653.818,7009.07,30660,515,350,27694,27135,23120,20821,19644
5342,626,859,3244,2098,0,5342,4.68214e+18,364.598,1807.37,5342,187,185,4483,3917,4188,4227,3744
9580,1463,1618,5497,4083,5497,4083,1.8386e+18,399.85,3179.12,9580,193,265,7962,7960,7946,7957,7663
18760,30,1863,5507,13253,0,18760,3.70914e+13,389.843,4503.89,18760,379,244,12166,9599,6719,2248,1272
18871,1948,2022,18871,0,16791,2080,2.30422e+18,861.547,4893.49,18871,280,390,16849,16848,16826,16814,16592
27542,1122,3669,27542,0,24826,2716,2.68664e+18,1138.34,7675.83,27542,468,400,23185,22080,19525,18623,9978
25851,210,3127,25839,12,23330,2521,2.27703e+18,1285.89,6888.54,25851,345,427,17852,13681,6657,3117,2321
37953,887,1134,37953,0,37953,0,4.12722e+18,432.684,4105.32,37953,224,230,36819,36814,36225,36259,35690
40562,243,2533,24383,16179,24383,16179,1.88456e+18,1097.18,7651.64,40562,435,493,31871,26038,19955,15937,5337
16371,649,1854,10068,6303,0,16371,4.89659e+18,468.4,4156,16371,316,262,14517,13936,12424,12128,9634
3613,485,801,2120,1493,2120,1493,1.83298e+18,292.243,1474.57,3613,142,169,2812,2540,2491,2366,2071
23759,1506,2971,23759,0,21234,2525,2.91726e+18,779.801,6515.89,23759,328,324,20788,20603,17978,16995,13300
19902,1109,2042,17546,2356,12095,7807,1.94913e+18,1063.73,5286.99,19902,364,408,17389,15480,14029,13894,12817
15901,2062,2342,0,15901,0,15901,2.3394e+18,533.968,4785.95,15901,312,450,13559,13553,13467,13541,12062
49605,230,981,49595,10,49605,0,4.07896e+18,356.798,4253.62,49605,235,235,47701,44673,28679,26410,17979
25425,1176,2097,15600,9825,0,25425,5.02416e+18,673.653,5613.94,25425,342,358,23283,22495,21345,21157,15945
40020,36,53,39514,506,40020,0,9.7152e+13,18.4267,692.243,40020,26,25,39967,39967,39482,39484,37601
36252,1217,2833,0,36252,0,36252,2.21143e+18,871.458,7621.63,36252,396,415,33419,32696,25365,25108,18851
5619,3645,5619,5619,0,0,5619,15.9972,0,5619,5619,5619,1,0,0,0,0,0
30570,904,2243,18559,12011,0,30570,5.10554e+18,870.475,6175.69,30570,422,311,27727,24913,19074,18479,9505
40086,406,827,40086,0,40086,0,4.48447e+18,351.297,3724.66,40086,222,229,39250,38973,31500,30762,29049
8034,819,895,0,8034,0,8034,2.32512e+18,302.552,2153.62,8034,200,159,7139,7104,7114,7077,6694
24633,657,1882,0,24633,7531,17102,9.27911e+15,334.751,4894.52,24633,428,243,22751,22479,18805,18300,10754
47160,331,828,47160,0,47160,0,4.47983e+18,369.676,3998.02,47160,236,228,46124,45359,35118,33827,32402
48365,331,1005,48365,0,48365,0,4.21932e+18,377.571,4346.88,48365,236,227,47133,46173,34131,33423,29505
43793,437,2262,26375,17418,0,43793,4.92432e+18,1109.45,7311.76,43793,443,384,37500,32350,24735,20744,9853
48296,58,3771,0,48296,0,48296,2.1843e+18,879.473,9769.09,48296,479,563,30258,20306,13164,10464,1164
19078,365,543,19042,36,19078,0,3.92893e+18,296.93,2400.45,19078,173,169,18535,18444,17324,17226,16911
16407,1032,1049,4752,11655,0,16407,3.5244e+13,346.973,3221.78,16407,367,180,15358,15358,15353,15354,15319
16484,575,2420,0,16484,0,16484,2.52333e+18,366.735,4864.17,16484,251,405,14064,13357,12714,12717,3736
22772,17,50,22334,438,22772,0,1.06981e+14,18.4521,539.549,22772,24,26,22707,22652,20814,20628,15163
49320,3777,5421,44079,5241,29338,19982,1.98881e+18,960.089,12390.2,49320,431,809,43899,43890,42949,43111,39879
19898,831,1968,17732,2166,11969,7929,2.01338e+18,930.34,4965.7,19898,360,300,17117,15124,12494,12602,9049
13985,590,1567,4242,9743,0,13985,3.67064e+13,287.082,3658.93,13985,287,246,12418,12175,10685,10606,7319
20030,478,1252,0,20030,18779,1251,0.0624563,0.937494,5007.74,20030,1252,1,18778,18778,18778,18778,18778
9686,354,964,0,9686,2943,6743,9.37892e+15,306.274,2368.08,9686,239,227,8525,7929,7069,7114,5154
45032,2338,3157,0,45032,0,45032,2.26788e+18,1037.52,9091.68,45032,423,533,41875,41807,40588,40069,31871
9264,75,212,0,9264,9096,168,2.63372e+16,78.4403,1028.91,9264,68,73,9010,8856,7958,7747,5715
31844,1692,3099,19195,12649,19195,12649,1.89109e+18,801.371,7267.74,31844,392,492,28745,28482,27382,26862,21356
20001,1476,2121,12002,7999,12002,7999,1.88714e+18,792.092,5119.24,20001,392,350,17880,17360,17097,17150,14434
35760,55,80,34913,847,35760,0,1.02956e+14,17.6364,772.347,35760,28,28,35680,35680,35072,35075,32339
39784,129,1098,39759,25,39784,0,4.22807e+18,315.618,3961.87,39784,220,222,34527,28359,19088,15067,8812
41224,168,333,0,41224,40245,979,2.6104e+16,154.249,2446.53,41224,106,108,40867,40747,37671,37429,30677
3854,620,857,0,3854,0,3854,2.62312e+18,150.978,1488.14,3854,145,144,2997,2996,2972,2990,2046
7417,6,30,7266,151,7417,0,9.82527e+13,13.0928,281.676,7417,18,19,7161,6879,6274,6214,4677
14593,507,1894,13091,1502,7806,6787,1.91112e+18,363.712,3878.83,14593,193,256,12679,12280,7112,6647,2464
31568,51,62,30575,993,31568,0,9.01636e+13,17.5797,658.794,31568,26,27,31506,31506,31177,31177,30383
5819,587,670,3693,2126,0,5819,4.54103e+18,383.995,1642.5,5819,179,154,5149,5104,5065,5077,5052
47024,542,2156,14951,32073,0,47024,3.32913e+13,613.576,6983.65,47024,486,359,44375,43604,29249,28529,17039
15336,752,1411,4681,10655,0,15336,3.21027e+13,290.718,3458.05,15336,203,279,13925,13797,13620,13624,9159
39328,439,983,39257,71,39328,0,4.15207e+18,392.381,3935.13,39328,214,225,38320,37898,30954,30493,28386
40838,2355,2777,0,40838,0,40838,2.30633e+18,1246.13,7946.61,40838,472,489,38061,37862,37389,36548,35886
42539,22,960,42479,60,42539,0,4.09474e+18,345.438,4028.87,42539,223,227,23955,14942,9847,9608,2185
38581,196,337,0,38581,37807,774,2.66372e+16,140.567,2471.38,38581,105,123,38244,38194,36000,34411,30977
26389,541,672,26389,0,26389,0,4.42104e+18,326.008,2954.83,26389,199,182,25717,25709,25107,25095,25123
26023,712,2198,16242,9781,16242,9781,1.81538e+18,851.513,5749.78,26023,367,341,23042,21711,17899,18182,11719
20626,81,242,0,20626,20389,237,2.62819e+16,110.777,1466.94,20626,75,87,20275,20050,18098,16475,12607
11343,1459,1949,6534,4809,6534,4809,1.76875e+18,304.087,3716.9,11343,323,266,9394,9337,9241,9252,8006
39280,853,2195,12311,26969,0,39280,3.45446e+13,707.149,6608.59,39280,358,392,37014,36137,31713,31523,21199
7335,99,945,4319,3016,4319,3016,1.81544e+18,340.795,2098.77,7335,213,178,4999,3994,3390,2763,806
36652,2887,3446,21189,15463,0,36652,4.4841e+18,740.788,8245.69,36652,532,440,33206,33205,33033,33072,31544
46367,9,67,45603,764,46361,6,1.00189e+14,23.7878,855.245,46367,27,31,45838,45515,40874,38854,21557
8210,368,814,0,8210,2761,5449,7.58368e+15,146.637,1981.59,8210,154,181,7396,7331,6929,6952,4935
16599,119,722,16599,0,16599,0,4.01645e+18,314.487,2458,16599,167,168,13940,11337,7399,7055,4318
46694,1770,2116,0,46694,13833,32861,9.22755e+15,749.356,7180.71,46694,505,371,44578,44556,44446,44454,40958
8576,125,201,0,8576,8441,135,2.56773e+16,78.7002,906.778,8576,59,63,8375,8345,8035,7977,7249
22669,874,2525,13620,9049,13620,9049,1.93072e+18,654.529,5791.18,22669,411,299,19943,18129,16865,16703,9617
26838,21,279,0,26838,26280,558,2.69915e+16,130.751,1806.66,26838,85,97,24973,23922,20406,15687,10501
47436,1888,2415,13884,33552,0,47436,3.72388e+13,757.899,7746.45,47436,455,414,45021,44936,44607,44631,40309
17394,883,1845,10718,6676,0,17394,4.72263e+18,515.41,4280.69,17394,306,239,15549,15355,14738,14485,12404
25415,2286,2712,15374,10041,0,25415,4.76684e+18,1010.46,6280.19,25415,421,425,22703,22113,22124,21956,21144
24288,266,680,24288,0,24288,0,4.76249e+18,329.625,2822.25,24288,184,179,23241,22249,15594,14518,13753
3706,26,105,0,3706,3632,74,2.67738e+16,57.3786,425.625,3706,38,49,3467,3381,2994,2809,1940
15145,1376,1742,9027,6118,0,15145,4.72761e+18,567.228,3940.51,15145,318,320,13403,13305,13248,13172,11549
42887,759,784,42887,0,42887,0,4.37938e+18,342.309,3820.04,42887,217,224,42103,42103,42075,42076,41898
22153,411,784,22129,24,22153,0,4.24151e+18,317.846,2886.69,22153,171,187,21369,21105,17899,17774,17390
2874,694,698,1713,1161,1713,1161,1.74434e+18,219.921,1239.04,2874,118,139,2176,2176,2172,2174,2171
972,104,343,0,972,0,972,2.60973e+18,48.7819,505.801,972,65,86,629,582,518,485,147
42931,35,74,42226,705,42931,0,1.00642e+14,18.5815,794.512,42931,29,28,42857,42855,40409,40407,30676
19904,18,1645,5865,14039,0,19904,3.60868e+13,450.176,4213,19904,332,257,11555,8388,7209,4214,1528
36513,2080,2944,21542,14971,0,36513,5.02854e+18,1086.92,7799.95,36513,468,474,33569,32914,32530,32393,27743
45633,59,75,44797,836,45598,35,1.02226e+14,19.8563,809.665,45633,27,31,45558,45558,45085,45086,43568
14520,482,1979,0,14520,0,14520,2.43599e+18,530.963,4225.05,14520,347,287,12116,11056,8463,8715,4691
22860,187,2764,22860,0,20409,2451,2.81257e+18,1283.37,6337.03,22860,346,435,15336,11994,6091,3525,3406
49262,589,2696,0,49262,15364,33898,8.85695e+15,653.042,7998.03,49262,445,409,46021,43924,31750,29428,15977
4773,288,612,4773,0,4321,452,2.47891e+18,133.096,1293.47,4773,104,121,4161,4128,4074,4092,3821
15724,1133,2098,13593,2131,9049,6675,2.01507e+18,800.229,4743.15,15724,286,343,13626,12952,11014,10831,9221
46509,485,1142,46509,0,46509,0,4.31156e+18,394.135,4395.4,46509,233,243,45367,45027,34755,34033,31065
49655,3358,3449,49655,0,44316,5339,2.26206e+18,1910.42,10299.9,49655,524,590,46206,46206,46206,46206,45976
23868,422,2367,21244,2624,14446,9422,2.00685e+18,502.295,5353.32,23868,366,285,20668,14861,12737,11946,11574
3492,228,737,3492,0,3282,210,2.24059e+18,162.599,1331.12,3492,126,102,2737,2306,2396,2375,1881
30531,486,1396,0,30531,9415,21116,8.60313e+15,744.796,5038.99,30531,324,336,28144,26699,24711,24797,14541
28437,27,79,27964,473,28427,10,1.05426e+14,17.2625,701.734,28437,26,29,28358,28344,25626,25582,15881
31976,3165,3368,28871,3105,18347,13629,1.90381e+18,826.838,7969.72,31976,362,539,28608,28608,28602,28607,28231
11672,38,1182,0,11672,0,11672,2.29821e+18,354.745,2934.71,11672,249,183,6861,4567,3813,3449,326
42746,753,1011,42721,25,42746,0,4.33272e+18,367.607,4050.47,42746,214,224,41735,41711,39971,39836,39268
7788,599,982,0,7788,2515,5273,9.01939e+15,286.711,2225.74,7788,220,218,6806,6696,6570,6576,5752
35222,211,2514,21619,13603,0,35222,4.81647e+18,646.04,6731.78,35222,412,334,26523,20723,14848,11224,6618
30016,545,669,30016,0,30016,0,4.09719e+18,332.618,3137.02,30016,204,191,29347,29339,28575,28445,28206
23558,122,1332,7541,16017,0,23558,3.61128e+13,382.707,3763.12,23558,285,258,18237,15799,11436,5481,3141
40381,1973,2878,24675,15706,24675,15706,1.87222e+18,1075.78,7649.97,40381,430,432,37503,36865,36831,37013,31279
15402,1155,1387,4147,11255,0,15402,3.77181e+13,446.309,3492,15402,331,207,14015,14015,13961,13946,13360
4677,129,864,1313,3364,0,4677,3.93942e+13,144.961,1638.34,4677,172,136,3675,3394,2241,2205,903
13069,944,1624,0,13069,0,13069,1.91502e+18,237.059,3550.56,13069,209,297,11445,11428,11192,11170,8777
17969,1174,1716,0,17969,5203,12766,9.32245e+15,335.125,4280.34,17969,246,317,16253,16246,16103,16075,12498
12989,294,2166,12989,0,11757,1232,2.28333e+18,621.517,4305.18,12989,259,272,9708,8278,3614,2816,2088
31102,704,2060,9915,21187,0,31102,3.24266e+13,458.267,5891.66,31102,365,469,28995,28312,26877,26802,16608
29209,168,759,29209,0,29209,0,4.04121e+18,332.257,3144.19,29209,196,197,26595,23128,16242,15255,10508
41567,697,896,41567,0,41567,0,4.20207e+18,341.973,3835.44,41567,216,233,40671,40606,38780,38732,38238
39704,24,64,38929,775,39704,0,1.03235e+14,19.2963,735.056,39704,26,28,39638,39617,37174,37054,28495
22397,345,2904,0,22397,0,22397,2.46453e+18,477.541,6163.34,22397,295,388,18956,16155,13278,9591,2339
14445,192,198,0,14445,14182,263,2.46279e+16,92.9064,1069.17,14445,74,83,14247,14247,14243,14220,14205
46620,11,311,0,46620,45891,729,2.49466e+16,163.594,2422.09,46620,115,114,41242,37578,34499,27467,16635
27689,206,1934,8534,19155,0,27689,3.6663e+13,774.45,5602.12,27689,445,356,23421,20716,14217,10198,6425
38181,255,1626,0,38181,10771,27410,9.68545e+15,689.462,5535.22,38181,476,325,34115,30263,23837,23448,9840
35302,1709,1835,10579,24723,0,35302,3.55642e+13,739.936,5893.22,35302,397,343,33467,33467,33430,33435,33050
12111,1200,1298,3948,8163,0,12111,3.50298e+13,299.883,3205.46,12111,187,311,10813,10813,10813,10813,10604
3351,758,1111,3351,0,3043,308,2.88761e+18,107.329,1642.24,3351,156,158,2240,2237,2143,2171,1256
29651,675,2543,0,29651,0,29651,2.45748e+18,649.289,6529.34,29651,479,364,26598,23842,18528,16385,13175
27365,1729,1841,0,27365,8703,18662,8.62407e+15,536.486,5286.98,27365,356,395,25524,25518,25489,25506,25238
22840,74,1739,6696,16144,0,22840,3.69959e+13,441.767,4716.63,22840,461,278,17147,14646,10990,5148,3206
41038,251,310,0,41038,39964,1074,2.58799e+16,142.988,2262.36,41038,104,106,40728,40722,40109,39964,38346
30926,174,702,30926,0,30926,0,4.17653e+18,319.235,3159.93,30926,189,189,28984,26627,17714,17616,12354
35534,2110,2387,0,35534,0,35534,2.30568e+18,559.835,6859.26,35534,382,306,33147,33147,32152,31013,30927
23804,988,1531,7411,16393,0,23804,3.43871e+13,319.163,4198.31,23804,269,253,22273,22193,22027,22024,19977
29897,1955,3778,26572,3325,17807,12090,1.96634e+18,1172.38,8316.51,29897,425,452,26119,24901,20578,20495,16858
42460,400,3412,25185,17275,0,42460,4.86747e+18,1140.89,9092.16,42460,484,545,35201,31501,22643,19736,9034
16831,467,671,16831,0,16831,0,4.34907e+18,279.314,2397.47,16831,160,166,16160,16095,14713,14632,14056
25867,2069,3222,22766,3101,15336,10531,1.9049e+18,1240.6,7168.98,25867,412,432,22645,21518,20907,21094,17136
43824,51,52,43355,469,43812,12,9.72165e+13,21.6418,809.091,43824,26,26,43772,43772,43771,43771,43686
1231,401,551,1231,0,1056,175,2.97809e+18,53.5142,740.628,1231,103,60,680,672,671,654,531
48026,105,2554,0,48026,13654,34372,9.27333e+15,1009.68,8156.42,48026,547,468,38446,33580,25001,21360,5471
41322,862,2412,0,41322,11886,29436,9.39547e+15,677.031,7270.84,41322,530,398,38835,37856,34787,35108,21085
2833,48,702,1548,1285,0,2833,4.15062e+18,105.845,1221.12,2833,139,114,1644,899,602,535,348
38418,923,3048,23166,15252,0,38418,5.06236e+18,1118.5,7947.03,38418,498,431,34331,32654,29108,28507,16425
8850,99,195,0,8850,8603,247,2.65433e+16,92.6279,896.327,8850,63,60,8621,8482,7789,7890,5933
24093,1117,2842,21845,2248,13684,10409,1.90924e+18,874.256,6100.67,24093,390,381,21136,19723,10114,9099,10841
4486,547,886,2625,1861,0,4486,5.14088e+18,192.929,1639.92,4486,174,152,3600,3559,3534,3525,2922
38945,3041,3805,38945,0,35281,3664,2.50195e+18,1121.23,9425.57,38945,486,550,35140,35131,34092,33601,30503
35551,1369,1786,10200,25351,0,35551,3.62123e+13,685.67,5904.69,35551,511,346,33765,33735,33061,33055,31013
15109,3,48,14874,235,15109,0,1.03581e+14,17.5478,498.875,15109,23,23,12565,11347,10914,10698,6349
10362,640,953,3288,7074,0,10362,3.64048e+13,267.774,2511.09,10362,151,257,9409,9343,9306,9287,7893
13072,847,1017,3593,9479,0,13072,3.51848e+13,445.035,2696.18,13072,237,243,12055,11927,12003,12001,10875
49278,131,322,0,49278,48557,721,2.49229e+16,158.902,2584.92,49278,111,107,48830,48530,43928,41375,35118
15185,1177,2162,9063,6122,9063,6122,1.92873e+18,825.922,4549.2,15185,360,335,12961,12060,12001,12031,9442
24300,2828,3165,24300,0,21602,2698,2.6066e+18,954.136,6999.69,24300,441,437,21135,20887,21116,21042,20106
14484,1030,1240,0,14484,4487,9997,9.31988e+15,345.903,3279.55,14484,232,266,13244,13236,13177,13151,12473
9213,1109,1330,0,9213,0,9213,2.23282e+18,410.377,2830.13,9213,226,232,7883,7883,7750,7722,7463
15486,474,547,15474,12,15486,0,4.14568e+18,301.859,2204.18,15486,155,172,14939,14879,14623,14631,14747
8231,266,1048,2445,5786,0,8231,3.69023e+13,170.44,2344.99,8231,161,217,7151,6706,6380,6450,2629
37149,2414,4277,21895,15254,21895,15254,1.77052e+18,647.618,9622.35,37149,369,705,32872,32835,31824,32170,22953
10882,69,549,10882,0,10882,0,4.61671e+18,258.458,1844.98,10882,142,146,8117,5753,3749,3431,1965
18606,2685,3627,18606,0,16573,2033,2.36552e+18,765.112,6689.37,18606,373,385,14979,14954,14704,14753,12360
11353,395,2303,11353,0,10129,1224,2.04566e+18,500.563,4285.06,11353,298,247,8319,6730,5647,5027,2139
27381,2150,2882,16658,10723,0,27381,4.64491e+18,801.075,6943.92,27381,411,422,24499,24349,23785,23536,20253
3371,69,123,0,3371,3297,74,2.68266e+16,54.6138,470.203,3371,42,39,3237,3192,2997,3056,2633
8347,26,33,8180,167,8347,0,9.72537e+13,16.6358,301.645,8347,18,20,8314,8314,7973,7973,7684
10092,853,2377,10092,0,9111,981,2.15701e+18,310.535,4072.83,10092,234,342,7715,7409,6905,7115,3222
29622,81,811,29622,0,29622,0,4.15313e+18,297.225,3292.37,29622,197,201,23434,16518,12383,11023,4845
8365,346,1682,5009,3356,5009,3356,1.88602e+18,256.024,3092.39,8365,237,231,6617,5926,4259,3376,1610
10406,156,189,0,10406,10253,153,2.49495e+16,84.898,928.699,10406,64,68,10217,10212,10067,9968,9667
22460,1518,2625,0,22460,0,22460,2.31007e+18,720.655,5994.37,22460,428,449,19835,19576,18182,17844,15762
34989,1574,2840,0,34989,0,34989,2.21353e+18,909.989,7374.43,34989,449,410,32149,31188,30219,28498,24224
37538,1513,3186,0,37538,0,37538,2.28888e+18,1009.56,8362.42,37538,387,513,34231,33062,29628,28101,20527
3250,93,702,0,3250,0,3250,2.25082e+18,149.186,1285.1,3250,115,134,2130,1572,1239,1085,618
7857,430,896,4177,3680,4177,3680,1.40293e+18,166.187,1966.66,7857,198,144,6961,6917,6751,6656,5939
28661,1728,3072,17100,11561,17100,11561,1.8523e+18,919.131,7150.81,28661,422,441,25589,25101,24655,24326,20911
32596,229,902,32578,18,32596,0,4.19272e+18,389.737,3568.45,32596,209,208,30807,28747,18785,18113,13726
43457,4349,5203,43457,0,39313,4144,2.41938e+18,834.783,11181.3,43457,549,391,38254,38248,38027,37362,33005
44728,84,992,44703,25,44728,0,4.29924e+18,350.493,4170.76,44728,227,229,35902,26477,17865,16249,6604
33674,1178,4228,33674,0,29906,3768,2.60487e+18,867.371,9208.06,33674,407,489,29270,27146,23947,22378,11389
47143,1982,3076,28227,18916,0,47143,4.84277e+18,987.919,8997.67,47143,588,391,44067,43899,41880,41313,37039
12156,667,1207,3537,8619,0,12156,3.71631e+13,366.065,2845.7,12156,298,208,10949,10771,10357,10388,8333
14585,1234,2173,14585,0,12948,1637,2.5085e+18,555.643,4491.57,14585,251,301,12412,12107,9390,9428,8131
21799,2584,2615,19463,2336,12983,8816,1.89961e+18,710.843,6057.32,21799,309,395,19184,19184,19184,19184,19172
8380,544,1624,7425,955,5163,3217,1.85892e+18,587.351,3142.87,8380,258,253,6305,5407,4778,4766,3631
1662,235,505,994,668,994,668,1.85776e+18,160.237,798.698,1662,95,98,1154,946,967,940,710
10051,202,451,10051,0,10051,0,3.77498e+18,233.488,1621.24,10051,141,134,9523,9200,7658,7721,5231
27040,166,1844,0,27040,8521,18519,8.43887e+15,532.651,5454.25,27040,453,340,22797,20156,14409,13117,5550
31269,1937,2203,0,31269,0,31269,2.1735e+18,756.769,6172.98,31269,374,326,29066,29049,29006,29013,26041
46522,878,4137,28362,18160,0,46522,4.88679e+18,705.997,9744.9,46522,375,590,42204,40330,31832,30536,18587
21012,1115,1569,12579,8433,0,21012,4.8611e+18,581.087,4540.54,21012,423,262,19443,19219,18026,17758,15214
48129,830,3910,27547,20582,27547,20582,1.75983e+18,736.404,10053.2,48129,558,473,43834,42018,35982,32413,15972
7190,1119,1444,7190,0,6504,686,1.37209e+18,381.78,2673.86,7190,192,199,5746,5693,5522,5464,5273
24310,43,322,0,24310,23759,551,2.66682e+16,116.423,1988.26,24310,101,105,23354,22589,18716,15829,10909
42214,3096,3320,25388,16826,0,42214,4.7832e+18,1421.08,9111.31,42214,486,527,38894,38723,38766,38756,38298
42065,1524,3897,0,42065,0,42065,2.39942e+18,1112.97,9602.14,42065,559,500,37973,36517,31704,29052,21799
18577,902,2185,10812,7765,10812,7765,1.74417e+18,840.469,4844.13,18577,330,348,16174,15538,14823,14826,7207
32264,7,79,31821,443,32264,0,1.02404e+14,18.289,735.426,32264,27,30,31434,31029,27190,26437,14682
42052,1621,2987,26412,15640,26412,15640,1.84115e+18,675.76,7833.4,42052,443,391,39065,38874,36813,36767,28705
24054,1655,2155,14628,9426,0,24054,4.84319e+18,556.391,5423.73,24054,421,268,21899,21897,21125,20878,19656
46218,1129,1199,46206,12,46218,0,4.2172e+18,392.136,4506.94,46218,239,234,45019,45019,44939,44942,44863
14442,206,1940,8585,5857,8585,5857,1.9326e+18,524.161,4250.29,14442,292,372,11138,9149,7809,6987,1710
8515,123,158,0,8515,8393,122,2.36102e+16,69.1764,732.206,8515,56,63,8357,8355,8082,8115,7519
813,147,253,0,813,243,570,7.89017e+15,49.6851,406.071,813,63,53,560,543,546,529,417
12279,248,1328,0,12279,3764,8515,9.66926e+15,358.067,3257.92,12279,222,414,10478,9522,7740,7732,3604
23434,1076,2157,0,23434,0,23434,2.13844e+18,537.271,5553.12,23434,261,432,21277,21015,20300,19493,12942
34708,1250,2807,0,34708,0,34708,2.29883e+18,1188.99,7378.53,34708,405,449,31592,29563,26131,25334,20426
47864,1023,4056,29229,18635,29229,18635,1.89953e+18,879.997,10379.2,47864,436,583,43070,40733,38703,38058,18098
24188,2097,3145,14324,9864,14324,9864,1.96777e+18,474.538,6795.48,24188,321,511,21043,21025,20468,20645,15552
36866,2511,2598,0,36866,0,36866,2.37845e+18,893.967,7264.04,36866,446,387,34268,34268,34246,34240,34037
27928,308,1410,8399,19529,0,27928,3.32761e+13,700.996,4545.86,27928,340,276,25391,24148,19186,19295,7091
20802,646,2322,0,20802,0,20802,2.38488e+18,410.483,5161.37,20802,324,346,18480,17791,15287,13443,9624
14650,31,38,14388,262,14650,0,9.67969e+13,17.0692,445.967,14650,22,24,14612,14612,14200,14201,13415
3877,354,667,3877,0,3299,578,7.46747e+17,298.125,1387.01,3877,143,123,3024,2439,2772,2761,1876
25046,30,36,24742,304,25046,0,9.39751e+13,17.5091,521.651,25046,21,23,25010,25010,24476,24476,23458
40755,2577,3326,0,40755,0,40755,2.35783e+18,1018.59,8594.59,40755,603,466,37429,37209,36203,34645,34542
26484,50,2215,16055,10429,0,26484,4.80942e+18,839.647,5741.4,26484,443,349,16167,11771,9476,8571,1051
26743,698,2260,16496,10247,0,26743,4.93203e+18,562.373,5815.77,26743,282,385,24268,23552,19296,19307,12606
34777,1544,4774,31007,3770,19897,14880,1.97217e+18,1013.41,10129.3,34777,489,726,29953,28063,22455,22295,11840
16085,36,54,15731,354,16085,0,1.06396e+14,15.5974,470.934,16085,23,23,16031,16031,15596,15597,14277
47604,382,993,47604,0,47604,0,4.43914e+18,380.657,4274.72,47604,223,239,46546,45929,34173,33009,31640
37270,2851,3349,22286,14984,0,37270,4.92439e+18,918.382,8392.21,37270,514,404,33921,33912,33273,33286,31763
5835,57,147,0,5835,5735,100,2.88602e+16,62.871,651.967,5835,57,56,5635,5496,5021,5006,3942
13418,319,2458,13418,0,12075,1343,2.08621e+18,423.069,4619.53,13418,320,333,10436,8858,4354,2608,1920
11810,626,1434,0,11810,3869,7941,8.42725e+15,317.943,3303.1,11810,309,348,10376,10161,9754,9617,6594
44436,825,1016,44394,42,44436,0,3.9293e+18,369.008,4162.88,44436,224,230,43420,43387,41671,41732,40357
10361,1004,2441,9167,1194,6103,4258,2.01283e+18,356.28,4150.56,10361,219,321,7920,7752,7070,7250,4296
10090,23,41,9870,220,10090,0,1.0185e+14,16.2576,365.15,10090,23,22,10049,10049,9693,9694,7422
39007,503,952,39007,0,39007,0,4.1137e+18,347.959,3822.39,39007,214,214,38055,37968,32908,32426,29262
46992,1371,3528,0,46992,0,46992,2.41942e+18,1128.14,9435.91,46992,603,559,43319,40625,39252,36912,23246
8165,697,813,2592,5573,0,8165,3.55831e+13,302.322,2018.74,8165,184,182,7352,7352,7300,7301,7093
32128,1905,4513,29255,2873,19299,12829,1.97591e+18,718.903,9491.88,32128,373,509,27615,27110,25535,25866,14798
14257,1603,1781,8829,5428,0,14257,4.95195e+18,542.161,3945.26,14257,369,270,12476,12474,12310,12280,12130
39096,256,304,0,39096,38395,701,2.54642e+16,139.572,2151.81,39096,92,103,38792,38789,37803,37884,35497
5591,343,856,1771,3820,0,5591,3.61626e+13,195.931,1830.08,5591,127,235,4735,4412,4458,4440,2542
14681,387,508,14681,0,14681,0,4.25981e+18,261.233,2036.45,14681,156,158,14173,14123,13684,13646,13614
30510,270,2755,18399,12111,0,30510,4.61467e+18,1054.99,6874.68,30510,430,451,24555,20779,14230,11159,3445
583,149,237,323,260,323,260,1.31296e+18,49.4134,346.54,583,51,46,346,336,246,221,191
16544,59,579,16544,0,16544,0,3.89871e+18,268.381,2214.12,16544,152,158,12034,8294,6273,6291,2860
34967,2025,2470,20723,14244,0,34967,5.00174e+18,995.598,6819.75,34967,526,349,32497,32486,32352,32316,31338
6156,1053,1122,5398,758,3614,2542,1.94555e+18,301.952,2251.72,6156,146,211,5034,5034,5032,5032,4995
29149,2062,3402,17397,11752,17397,11752,1.872e+18,751.688,7465.77,29149,476,546,25747,25411,24636,24490,20421
11601,834,1317,6910,4691,0,11601,5.23797e+18,570.378,3048.9,11601,245,222,10204,9613,9706,9653,7130
43673,1559,2079,0,43673,12553,31120,9.45625e+15,737.575,6859.91,43673,480,392,41594,41375,40450,40554,38090
32722,1358,3226,32712,10,29334,3388,2.08765e+18,1068.04,7812.88,32722,407,459,29354,28114,18630,16064,13708
17742,30,45,17286,456,17742,0,1.00949e+14,18.1438,475.071,17742,25,22,17697,17692,17044,17045,14966
30470,2980,3067,0,30470,0,30470,2.42098e+18,822.048,7236.43,30470,431,494,27403,27403,27401,27400,26986
17679,230,1172,5051,12628,0,17679,3.76472e+13,559.932,3526.4,17679,342,291,14836,13381,10240,9864,5113
45423,2791,3930,26682,18741,26682,18741,1.75773e+18,1356.65,9873.03,45423,471,705,41493,41444,40413,40886,31061
13828,132,187,0,13828,13558,270,2.65188e+16,104.428,1122.34,13828,73,83,13627,13558,13072,13029,12264
14734,590,1898,0,14734,0,14734,2.22375e+18,295.621,3969.82,14734,229,350,12836,12391,11403,10623,4738
23645,1090,2895,14347,9298,14347,9298,1.8412e+18,721.156,6430.58,23645,373,448,20710,19984,16315,15787,10033
27761,19,1712,0,27761,7739,20022,9.71423e+15,798.309,5183.27,27761,404,345,16486,12473,9613,9879,2162
35873,91,95,35085,788,35873,0,1.04774e+14,18.1317,804.689,35873,30,30,35778,35778,35692,35692,35680
32260,1038,2157,0,32260,9763,22497,9.2513e+15,598.337,6113.24,32260,393,350,30103,29698,28867,28938,22809
1759,97,312,1759,0,1759,0,4.28757e+18,128.055,644.397,1759,74,65,1347,1092,847,846,533
47390,3444,4427,42127,5263,28206,19184,1.97899e+18,1663.74,10992.6,47390,551,508,42963,42112,42003,42113,38902
40199,4829,5504,40199,0,36414,3785,2.36863e+18,1084.28,11553.3,40199,406,684,34695,34684,34391,34084,32502
8512,25,26,8379,133,8512,0,9.96011e+13,13.8512,290.964,8512,17,18,8486,8486,8388,8388,8448
36703,498,3585,21452,15251,21452,15251,1.72748e+18,866.784,8743.39,36703,466,563,31099,28519,19197,18113,7226
18646,2014,2238,11091,7555,11091,7555,1.83824e+18,712.896,5047.65,18646,305,315,16408,16386,16385,16401,15661
45758,3121,3882,40906,4852,25906,19852,1.9345e+18,1643.1,9700.86,45758,492,462,41876,41717,41389,41409,38600
42858,1155,3167,0,42858,0,42858,2.17444e+18,1101.54,8557.24,42858,511,493,39314,37908,32078,31128,21477
7607,657,823,2054,5553,0,7607,3.62482e+13,218.532,1883.91,7607,246,138,6784,6784,6715,6717,6453
10231,17,32,9974,257,10231,0,9.75852e+13,16.2459,336.131,10231,21,18,10194,10181,9617,9609,7912
15201,220,1495,0,15201,4650,10551,9.42025e+15,334.622,3604.29,15201,350,236,12810,11189,8725,8593,5615
43834,3343,3544,0,43834,0,43834,2.33601e+18,1027.81,9131.76,43834,498,568,40290,40270,40262,40261,40180
20272,702,1722,5762,14510,0,20272,3.70836e+13,372.404,4506.78,20272,270,284,18550,18266,17006,17070,11061
29275,278,287,0,29275,28939,336,2.62312e+16,126.015,1867.32,29275,90,99,28988,28988,28981,28971,28929
7644,264,341,7644,0,7644,0,4.25909e+18,219.8,1308.96,7644,123,121,7303,7262,6885,6879,6768
20013,1848,1993,0,20013,0,20013,2.10634e+18,593.83,4636.63,20013,269,328,18020,18018,18005,18020,17679
24926,93,306,0,24926,24529,397,2.64341e+16,121.129,1732.38,24926,98,102,24478,23990,21306,20377,15189
40861,229,832,40861,0,40836,25,4.23748e+18,368.182,3811.01,40861,215,227,39118,37037,23564,22678,19541
49605,1274,3212,27817,21788,0,49605,4.27541e+18,1615.55,9109.72,49605,491,497,44892,42996,34873,34299,19582
6895,296,435,6895,0,6895,0,4.1394e+18,213.121,1381.87,6895,118,122,6460,6399,5657,5640,5151
13980,16,1562,8464,5516,8464,5516,1.928e+18,670.677,3761.78,13980,284,264,6416,3192,2985,2480,266
5440,113,852,3186,2254,3186,2254,1.84076e+18,257.649,1685.4,5440,210,138,3755,2928,2455,2265,1200
48361,1890,5909,48361,0,43487,4874,2.54509e+18,936.475,12788.1,48361,535,568,42452,41717,37894,36485,17683
35729,58,68,34906,823,35723,6,1.02399e+14,25.2989,748.078,35729,28,32,35661,35661,35337,35336,34689
10623,1595,1729,6233,4390,6233,4390,1.93782e+18,303.134,3352.25,10623,217,275,8894,8894,8861,8873,8488
42111,1045,3172,0,42111,0,42111,2.30708e+18,851.891,8498.87,42111,487,408,38711,37022,30526,27829,20163
36755,201,850,36755,0,36755,0,4.19831e+18,375.466,3659.09,36755,212,214,34367,31256,20788,20278,14411
9738,528,1261,0,9738,0,9738,2.43467e+18,399.183,2763.1,9738,241,218,8465,7884,7489,6009,5882
39958,172,2439,0,39958,12456,27502,8.78353e+15,724.844,7228.41,39958,454,387,33990,30608,19575,16721,5035
15877,149,1254,4824,11053,0,15877,3.09558e+13,329.51,3286.37,15877,227,225,13875,12901,8171,8018,3021
31631,899,1902,9090,22541,0,31631,3.71757e+13,555.354,5653.86,31631,351,355,29729,29087,27556,27622,16511
12064,461,1227,0,12064,3638,8426,9.3399e+15,387.809,3028.25,12064,266,251,10674,10158,9517,9421,6118
37268,1650,3322,34031,3237,21887,15381,1.98869e+18,1101.16,8558.96,37268,487,396,33946,32597,25101,24713,16026
1204,8,75,0,1204,1177,27,2.59743e+16,18.1752,210.412,1204,22,35,1037,919,862,832,544
29958,1975,1987,27008,2950,16830,13128,1.86985e+18,1035.69,5668.11,29958,351,379,27971,27971,27971,27971,27966
25073,2130,2680,0,25073,0,25073,2.24689e+18,652.848,6431.67,25073,359,458,22393,22383,22029,22033,19459
44577,327,4185,0,44577,0,44577,2.1403e+18,1092.69,10102.3,44577,454,613,37344,34078,19055,17607,5143
4569,836,866,4078,491,2579,1990,2.02071e+18,285.226,1642.66,4569,188,132,3703,3703,3699,3699,3692
18546,1224,2332,10793,7753,10793,7753,1.93359e+18,565.652,5274.96,18546,348,436,16214,15762,15422,15464,10068
31582,2949,4785,28078,3504,18445,13137,1.97528e+18,773.022,9620.02,31582,401,663,26797,26700,24427,23367,18808
38064,3137,4277,38064,0,34487,3577,1.98319e+18,1520.82,9869.86,38064,660,569,33787,33158,33272,33220,30038
37334,15,76,36598,736,37299,35,9.63761e+13,17.2241,804.673,37334,29,28,37218,37144,33965,33992,23778
47895,1443,3035,27650,20245,0,47895,4.55545e+18,964.518,8711.51,47895,528,459,44812,43737,39767,39211,28004
21327,1955,2120,0,21327,0,21327,2.21412e+18,712.526,5271.89,21327,319,395,19207,19207,19138,19163,18809
28444,753,2027,0,28444,8640,19804,9.23895e+15,619.848,5669.73,28444,473,445,26314,25530,22925,23132,13815
37150,2680,3168,0,37150,0,37150,2.23585e+18,1125.59,8206.92,37150,412,425,33982,33564,33361,32909,31040
25377,1451,2928,15326,10051,0,25377,4.9992e+18,792.649,6639.4,25377,381,415,22449,21806,20822,20362,13740
6792,929,1352,4009,2783,0,6792,4.8836e+18,293.936,2547.17,6792,259,274,5440,5320,5170,5194,4501
41116,38,54,40255,861,41116,0,9.94092e+13,20.0527,716.348,41116,27,26,41062,41060,39401,39401,35634
48378,3420,4406,48378,0,43157,5221,2.72179e+18,1233.83,10985.7,48378,592,464,43972,43933,43083,41756,36397
12394,178,210,0,12394,12198,196,2.56452e+16,86.8263,1169.27,12394,61,69,12184,12184,12176,12128,11921
46582,2355,5193,46582,0,41071,5511,1.51498e+18,1135.08,11720,46582,522,544,41389,40376,35795,36349,21914
13272,227,2907,13272,0,11909,1363,1.6321e+18,510.756,5060.9,13272,272,395,9204,7499,3532,2823,705
667,116,301,388,279,388,279,1.86329e+18,37.0105,415.123,667,56,50,366,335,299,265,221
35905,893,2192,21678,14227,21678,14227,1.89607e+18,920.098,6406.19,35905,440,364,33224,29357,27650,26269,17803
38966,2979,3447,23159,15807,0,38966,4.81738e+18,1037.76,8659.17,38966,485,554,35519,35513,35365,35373,33676
34478,1632,3152,20665,13813,20665,13813,1.87301e+18,678.452,7679.08,34478,497,401,31326,31164,26866,24876,18807
20591,582,852,6565,14026,0,20591,2.64669e+13,323.238,2862.61,20591,212,196,19692,19473,19366,19382,16440
24442,1139,2677,21825,2617,14823,9619,1.94674e+18,1024.17,6353.2,24442,371,405,21318,20206,16601,16460,13381
45998,1939,4378,26706,19292,26706,19292,1.81548e+18,1071.26,10567.4,45998,597,689,41620,40865,37005,36976,26185
39749,43,94,38900,849,39749,0,1.03387e+14,20.9606,823.55,39749,30,29,39655,39649,37878,37801,28836
28279,175,267,0,28279,27902,377,2.61486e+16,136.465,1781.5,28279,96,97,28007,27922,26404,26298,23136
41688,60,89,41048,640,41688,0,9.96319e+13,19.8541,828.403,41688,29,31,41599,41598,40353,40353,33415
22845,130,2854,20513,2332,13612,9233,1.90771e+18,501.448,6345.8,22845,266,408,15377,11287,6157,5408,1550
34377,1230,4340,31194,3183,20332,14045,1.99168e+18,836.679,9369.04,34377,382,571,29523,27520,26163,26387,11164
41005,2415,2962,36069,4936,24260,16745,1.97152e+18,1382.53,8291.39,41005,481,465,38043,37246,37599,37607,35905
46107,7,33,45449,658,46107,0,9.47288e+13,20.3203,760.113,46107,24,23,45194,44733,38999,38559,25451
21839,1120,2661,19645,2194,13360,8479,2.01575e+18,697.922,5837.11,21839,398,336,19178,18103,14605,14169,13403
35562,1185,2423,31703,3859,21180,14382,1.94982e+18,1262.75,7037.87,35562,450,365,32405,30609,28687,28875,22163
31467,1418,2245,0,31467,9395,22072,9.46236e+15,465.277,6351.21,31467,375,404,29222,29136,28495,28385,21529
45718,33,86,44977,741,45718,0,9.89826e+13,19.4968,834.74,45718,29,30,45632,45627,43521,43344,33613
9344,450,499,9344,0,9344,0,4.02704e+18,242.083,1665.24,9344,144,131,8845,8839,8804,8802,8714
6277,124,154,0,6277,6144,133,2.74134e+16,62.7137,681.467,6277,54,58,6123,6122,5943,6026,5463
6508,3534,4096,6508,0,6508,0,1.01691e+16,1518.06,5095.08,6508,4096,3,2412,0,1964,1850,2412
25631,1591,3261,25631,0,23002,2629,3.07154e+18,810.636,6906.98,25631,441,428,22370,21683,20849,20717,17428
25707,91,1742,7704,18003,0,25707,3.6561e+13,507.197,5103.42,25707,469,277,19654,16688,12165,6626,2538
24809,334,1739,7123,17686,0,24809,3.681e+13,441.282,4941.97,24809,305,381,22448,20558,17963,18170,7091
23805,10,42,23515,290,23805,0,1.00778e+14,16.0691,524.583,23805,21,24,23603,23434,21233,21030,14612
29122,320,4355,29122,0,26112,3010,2.78313e+18,682.442,8705.68,29122,524,345,22587,18239,11729,9894,2772
36491,3151,3916,36491,0,32827,3664,2.77272e+18,1248.12,9327.9,36491,480,523,32575,32327,32103,32022,29611
23549,928,1579,0,23549,7406,16143,8.28528e+15,445.591,4373.56,23549,291,357,21970,21750,21322,21341,16387
43573,453,1756,0,43573,13671,29902,9.12624e+15,572.224,6147.27,43573,431,387,40481,37474,28236,27740,21980
26484,1101,2702,0,26484,0,26484,2.44722e+18,792.838,6427.85,26484,483,357,23618,22131,19921,16230,14607
16110,844,1354,0,16110,4979,11131,9.12855e+15,447.205,3674.34,16110,237,323,14756,14517,14470,14403,11679
33288,93,335,0,33288,32645,643,2.62532e+16,145.534,2349.96,33288,110,112,32684,32205,27899,26553,20263
47322,76,2515,42586,4736,25856,21466,1.91947e+18,1413.92,7660.06,47322,445,362,29945,17820,9701,6945,540
45153,1018,2649,0,45153,13993,31160,8.63007e+15,704.875,8011.67,45153,429,490,42391,41664,39279,39599,23082
46810,2655,4330,0,46810,0,46810,2.38102e+18,793.076,10502.9,46810,373,593,42480,42445,41664,42244,36280
26947,1983,2443,0,26947,0,26947,2.25898e+18,860.444,6209.53,26947,337,405,24504,24475,24184,24305,20435
32874,21,88,32155,719,32874,0,1.0386e+14,18.0479,737.734,32874,28,31,32783,32758,30146,29655,17832
29908,2303,3013,17446,12462,17446,12462,1.66908e+18,610.654,7082.42,29908,363,399,26895,26754,26519,26678,23899
40452,3190,4285,40452,0,36387,4065,2.52846e+18,708.438,10051.8,40452,518,475,36167,36164,36156,36155,27666
8003,1054,1491,0,8003,0,8003,2.19904e+18,195.707,2717.49,8003,200,191,6512,6511,6427,6416,4061
15605,831,1835,9576,6029,0,15605,4.88594e+18,460.105,4090.54,15605,318,373,13770,13367,10881,11045,8179
45837,2593,3027,0,45837,0,45837,2.47766e+18,1240.45,8772.33,45837,517,445,42810,42751,42630,42618,40056
18744,807,1523,5402,13342,0,18744,3.75825e+13,388.105,3963.85,18744,319,315,17221,16986,16006,16051,11662
34705,138,3327,0,34705,0,34705,2.33719e+18,736.844,8243.82,34705,350,421,26122,22190,14703,12864,2930
5925,246,402,5925,0,5925,0,3.992e+18,210.522,1236.48,5925,105,100,5493,5284,4948,4887,4115
47306,1935,4853,47306,0,41919,5387,2.08629e+18,1179.75,11271.2,47306,576,474,42453,41368,38215,35936,22016
38272,738,1924,11590,26682,0,38272,3.57416e+13,657.253,6277.89,38272,469,336,36069,35558,31502,31516,18743
11278,786,970,0,11278,3112,8166,9.55937e+15,283.678,2463.92,11278,253,173,10308,10308,10287,10286,9977
44077,111,3840,39704,4373,25475,18602,1.97136e+18,1283.58,9765.34,44077,656,490,30192,21165,11443,9484,1455
19363,201,1403,6120,13243,0,19363,3.50183e+13,384.523,4012.76,19363,254,330,16578,14797,10045,9501,4282
26228,1265,2468,23144,3084,16179,10049,1.91615e+18,865.455,6379.67,26228,401,375,23760,22327,20825,20412,18798
46156,1484,2797,27326,18830,27326,18830,1.81845e+18,1077.86,8551.25,46156,513,488,43132,41541,40222,39241,28233
26750,42,44,26277,473,26750,0,1.02889e+14,18.3378,554.329,26750,24,24,26706,26706,26625,26625,26685
11560,1162,1187,3595,7965,0,11560,3.64319e+13,254.762,2901.76,11560,251,197,10373,10373,10373,10373,10361
13978,389,1587,8669,5309,8669,5309,1.84257e+18,479.458,3608.39,13978,280,254,11322,9214,6619,6502,2641
13191,1432,1600,7701,5490,7701,5490,1.86854e+18,342.167,3500.14,13191,261,270,11591,11591,11529,11552,10559
31086,1383,1754,0,31086,9934,21152,8.86156e+15,651.837,5481.91,31086,381,351,29332,29240,28625,28671,26562
17070,309,607,17070,0,17070,0,4.19823e+18,299.001,2339.21,17070,162,162,16409,15962,14119,13950,12910
45000,1225,1728,0,45000,14007,30993,9.25392e+15,821.479,6324.31,45000,452,385,43272,42803,41133,41159,36334
39121,1132,2190,0,39121,11965,27156,9.3177e+15,417.01,6073.83,39121,310,323,36931,36759,35818,35858,28992
16980,2,47,16672,308,16980,0,9.55161e+13,16.9531,465.021,16980,23,24,12126,10506,10085,10296,7088
39973,1861,2697,35580,4393,23922,16051,1.99624e+18,1213.02,7753.76,39973,505,470,37276,36344,35525,35575,34505
49778,59,82,48933,845,49778,0,1.03027e+14,20.4074,875.544,49778,28,33,49696,49694,48560,48560,43410
26026,106,600,26026,0,26026,0,4.01586e+18,317.181,2810.19,26026,180,188,22106,18044,13053,12072,6224
8878,1287,1740,8024,854,5119,3759,1.91059e+18,288.558,3311.97,8878,175,316,7138,7123,6956,7017,5281
28576,1846,1877,8588,19988,0,28576,3.55779e+13,551.309,5323.27,28576,412,307,26699,26699,26699,26699,26536
18960,1686,2690,0,18960,0,18960,2.41962e+18,478.82,5567.85,18960,382,374,16270,16127,15787,15710,12931
40917,1506,4700,36258,4659,23933,16984,1.97263e+18,1054.64,10462.9,40917,539,564,36192,34664,22939,21518,17526
17493,19,36,17242,251,17493,0,1.00809e+14,18.9934,446.19,17493,22,23,17451,17441,16680,16637,14703
6097,996,1234,6097,0,5454,643,2.93834e+18,437.754,2337.51,6097,174,188,4863,4845,4678,4700,4456
17461,1958,2973,17461,0,15379,2082,2.50291e+18,586.994,5733.87,17461,345,332,14488,14418,13556,13274,9647
18269,155,281,0,18269,17994,275,2.6679e+16,107.502,1565.07,18269,87,91,17988,17901,17088,16977,14377
19687,24,1452,11658,8029,11658,8029,1.87784e+18,705.271,4050.41,19687,360,269,10512,6984,5856,4332,552
40640,2779,3311,23956,16684,23956,16684,1.8106e+18,1034.09,9071.75,40640,494,469,37329,37274,36840,37063,33994
20312,318,1313,0,20312,6043,14269,9.49164e+15,634.701,4001.65,20312,337,286,17888,16371,12958,13089,7671
35227,1706,2777,21874,13353,0,35227,4.83892e+18,737.828,7228.95,35227,432,412,32450,32245,27872,27126,21860
46253,1444,2323,0,46253,13394,32859,9.45274e+15,725.916,7376.52,46253,440,411,43930,43690,42196,42158,33666
7386,724,922,0,7386,0,7386,1.79596e+18,221.108,2045.81,7386,174,150,6464,6417,6396,6409,5475
15340,20,50,14982,358,15340,0,1.00333e+14,16.708,446.24,15340,24,25,15287,15278,14211,14059,10963
8515,927,1929,8515,0,7644,871,2.3541e+18,301.493,3404.84,8515,177,357,6586,6554,4247,3856,3259
43286,4127,5203,43286,0,38393,4893,2.2857e+18,1187.2,11299.1,43286,421,569,38083,38018,37800,37775,34871
38274,535,829,38274,0,38274,0,4.186e+18,343.904,3663.6,38274,216,209,37445,37396,34749,34656,34996
20446,351,1784,11999,8447,0,20446,4.37822e+18,476.041,4550.36,20446,276,269,17587,15640,12212,11115,4942
23411,1825,2681,20992,2419,14311,9100,1.96677e+18,604.304,5874.62,23411,389,315,20730,20692,20444,20490,18787
13709,203,1150,4012,9697,0,13709,3.68902e+13,595.42,3161.35,13709,296,295,11328,10121,8114,7660,3629
23527,150,3297,23527,0,21105,2422,2.50272e+18,828.512,6960.45,23527,513,317,15791,12929,8061,6686,1618
49484,89,4428,44347,5137,29444,20040,1.90731e+18,1022.69,11139.6,49484,536,431,29861,19954,11804,11310,590
26509,3304,3487,15273,11236,15273,11236,1.69826e+18,469.982,7339.15,26509,527,372,23022,23022,22997,22997,22712
8927,23,36,8785,142,8927,0,1.10358e+14,15.3293,318.812,8927,21,19,8891,8887,8710,8710,8115
27536,1911,2694,0,27536,0,27536,2.42566e+18,702.699,6386.86,27536,451,359,24842,24770,24442,23590,23090
22110,1842,2663,0,22110,0,22110,2.39718e+18,552.963,6029.28,22110,436,412,19447,19390,18726,16925,16433
30969,525,2947,0,30969,0,30969,2.3039e+18,647.3,7005.81,30969,343,533,27332,25163,15049,12026,5025
47847,2157,5287,47847,0,42743,5104,1.5488e+18,1603.62,11914.6,47847,585,600,42459,40519,37393,35374,23424
33436,15,67,32679,757,33436,0,9.93028e+13,18.0849,739.641,33436,27,27,33315,33242,29740,29705,20767
21129,848,859,21129,0,21129,0,4.20664e+18,327.995,2917.14,21129,188,187,20270,20270,20270,20270,20269
888,273,290,0,888,279,609,8.4838e+15,54.3604,443.683,888,76,68,598,598,596,592,590
6652,1186,1214,5985,667,3571,3081,1.90032e+18,153.476,2229.09,6652,174,179,5438,5438,5438,5436,5434
46746,1675,3329,28258,18488,0,46746,4.68158e+18,885.157,9178.59,46746,564,601,43417,42898,35469,35824,26919
36091,546,2418,36091,0,32245,3846,2.57326e+18,1372.11,7222.88,36091,395,398,30545,26314,14978,11890,8879
47417,670,2061,0,47417,13960,33457,9.4694e+15,764.251,6952.43,47417,460,319,44622,41980,31504,30916,17007
26056,63,1854,8461,17595,0,26056,3.562e+13,473.239,5352.26,26056,354,342,18960,15888,11400,4770,2686
5720,841,913,5720,0,5077,643,2.75518e+18,513.373,1994.22,5720,199,197,4807,4806,4731,4730,4745
42376,29,2303,0,42376,12159,30217,9.41549e+15,686.494,7079.04,42376,371,466,27669,21660,17151,17160,3450
44741,61,70,43900,841,44741,0,9.97788e+13,20.0662,799.165,44741,30,30,44671,44671,44448,44448,43538
9379,822,1506,0,9379,0,9379,2.04097e+18,224.077,2906.56,9379,246,206,7873,7790,7280,7112,4679
22815,2710,2730,22815,0,20304,2511,2.48949e+18,775.267,5986.73,22815,364,303,20085,20085,20085,20085,20059
28213,1181,2169,8389,19824,0,28213,3.60195e+13,542.567,5949.36,28213,374,418,26044,25799,24956,24918,18508
39872,60,111,39232,640,39872,0,1.03358e+14,19.3064,882.86,39872,30,33,39761,39759,38385,38387,30077
34936,1560,3860,31253,3683,20922,14014,1.97354e+18,1010.31,8621.29,34936,519,450,31076,29648,26866,26452,17268
43091,391,5277,43091,0,38729,4362,2.59042e+18,1051.48,11591.6,43091,552,455,34414,28630,20904,17992,3507
33100,1337,1805,10026,23074,0,33100,3.28451e+13,650.14,5655.99,33100,387,403,31295,30949,30402,30426,27137
7684,67,429,7672,12,7684,0,3.65275e+18,239.124,1430.66,7684,114,108,6022,4486,3676,3515,1665
25912,1062,1618,8088,17824,0,25912,3.18865e+13,635.192,4621.6,25912,316,345,24294,23678,23731,23793,19344
30169,209,1915,26767,3402,17974,12195,1.93722e+18,1143.6,5787.75,30169,385,390,21658,16255,9504,8441,5783
39780,37,296,0,39780,39071,709,2.60335e+16,161.243,2241.92,39780,103,120,38005,36891,30838,26522,17655
17472,12,36,17122,350,17472,0,9.7885e+13,15.4188,436.173,17472,21,23,17370,17315,15880,15818,12744
24196,1447,1670,7286,16910,0,24196,3.60778e+13,418.17,4532.5,24196,319,376,22526,22526,22480,22469,21554
42641,138,287,0,42641,41680,961,2.59716e+16,138.695,2358.63,42641,100,119,42287,42136,38434,36533,31120
24373,2336,3819,21960,2413,14680,9693,1.99327e+18,775.417,7627.96,24373,443,376,20554,20332,19661,19792,16710
20232,1,6,18967,1265,20152,80,0.000247133,0.999703,338.934,20232,6,1,20226,20226,20226,20226,20226
38740,891,1017,0,38740,12405,26335,7.73696e+15,529.284,4254.38,38740,330,281,37723,37720,37262,37344,36633
49093,270,307,0,49093,48040,1053,2.53266e+16,136.783,2527.86,49093,116,113,48786,48779,48320,47830,46807
6468,399,1331,3843,2625,0,6468,4.85287e+18,219.306,2421.83,6468,205,160,5137,4494,3782,3540,2839
31983,135,1069,31983,0,31983,0,4.18647e+18,344.314,3654.11,31983,213,222,27644,22708,14751,12807,8068
17944,174,259,0,17944,17706,238,2.72224e+16,94.4297,1505.13,17944,79,85,17685,17669,17035,17116,15646
40030,21532,40030,0,40030,0,40030,1048550,0,40030,40030,40030,1,0,0,0,0,0
38542,1383,38542,38542,0,0,38542,268428000,0,38542,38542,38542,1,0,0,0,0,0
20605,2129,2403,18259,2346,12543,8062,1.91603e+18,886.933,5616.9,20605,384,280,18202,17920,18122,18135,17325
17502,14858,17502,17502,0,17502,0,68715600000,0,17502,17502,17502,1,0,0,0,0,0
9728,1574,2083,8624,1104,5732,3996,1.94761e+18,375.437,3795.3,9728,274,274,7645,7636,7313,7294,6560
25866,21689,25866,0,25866,25866,0,4095.84,0,25866,25866,25866,1,0,0,0,0,0
37286,17342,37286,37286,0,0,37286,15.9996,0,37286,37286,37286,1,0,0,0,0,0
44543,1466,4382,0,44543,0,44543,2.32505e+18,968.962,10257.8,44543,527,609,40131,38594,27349,24362,20719
3789,255,723,0,3789,1107,2682,8.19769e+15,139.949,1385.31,3789,162,141,3066,2888,2592,2546,1500
43197,1076,4284,38378,4819,25730,17467,1.97446e+18,1634.31,10337.1,43197,564,484,37356,33874,25832,26142,12897
21123,226,1756,12564,8559,0,21123,4.77356e+18,884.794,4756.23,21123,425,289,16590,13651,11996,10936,2538
21015,25,30,20675,340,21015,0,9.84997e+13,17.1312,461.679,21015,21,24,20985,20985,20383,20383,19634
34067,218,4582,34067,0,30040,4027,2.34808e+18,1158.69,9843.97,34067,408,602,24568,19387,13231,11190,2775
10244,256,825,0,10244,3053,7191,7.65321e+15,167.63,2086.09,10244,183,150,9419,9190,8256,8290,2132
48915,178,827,48915,0,48915,0,4.11215e+18,441.978,4227.91,48915,241,225,44999,39936,26417,24449,17041
36393,1416,3726,32277,4116,21900,14493,1.99297e+18,1706.26,9004.02,36393,594,446,31562,29724,23998,23226,15900
25186,203,272,0,25186,24562,624,2.5795e+16,139.765,1728.58,25186,93,102,24914,24883,23786,23706,22259
39057,983,2239,10983,28074,0,39057,3.73503e+13,700.615,6919.44,39057,499,336,36818,35953,33197,33404,24576
30261,1602,3884,27127,3134,18311,11950,1.95553e+18,1033.15,8319.7,30261,403,432,26344,25089,21794,21241,16585
47742,2071,2487,13598,34144,0,47742,3.70497e+13,778.318,7908.8,47742,445,461,45255,45227,44988,44983,41714
11430,107,1065,3519,7911,0,11430,3.49491e+13,356.624,2729.16,11430,220,230,8934,7874,5738,4358,2183
36924,988,1809,0,36924,11183,25741,8.783e+15,719.405,5923.26,36924,422,413,35093,34408,32781,33005,24489
44191,266,322,0,44191,43430,761,2.57683e+16,151.522,2489.02,44191,100,114,43869,43859,43800,43498,42538
26707,719,2721,23873,2834,15457,11250,1.93996e+18,601.627,6519.93,26707,341,331,23834,22976,15556,14224,5321
6979,91,826,2354,4625,0,6979,3.27363e+13,276.933,1993.83,6979,219,225,5281,4390,2758,2245,1025
9523,1085,1229,0,9523,3020,6503,9.03954e+15,276.323,2681.76,9523,253,258,8294,8294,8291,8282,7838
6094,771,1403,0,6094,0,6094,2.63834e+18,176.203,2298.11,6094,287,158,4691,4624,4561,3658,3100
38029,759,3345,22531,15498,0,38029,4.40482e+18,744.123,8439.34,38029,428,428,34041,32079,23257,19434,13581
33858,64,74,33132,726,33834,24,1.00443e+14,19.5324,780.938,33858,29,26,33784,33784,33338,33343,32457
27777,50,278,0,27777,27215,562,2.55265e+16,125.934,1968.97,27777,97,116,26821,25982,22040,20056,13382
47090,477,4591,47090,0,41999,5091,2.72414e+18,1504.72,11312.2,47090,491,536,36668,30303,17936,11910,7581
1009,181,310,272,737,0,1009,3.68252e+13,29.7423,474.923,1009,62,61,699,698,697,697,540
45315,1807,5403,40013,5302,26270,19045,1.93659e+18,1198.31,12058.1,45315,569,648,39661,38467,29226,28337,21130
1116,147,472,1116,0,992,124,2.2695e+18,89.397,646.803,1116,81,76,644,526,376,295,324
2238,603,816,2238,0,1964,274,2.78504e+18,145.899,1201.52,2238,107,138,1422,1368,1381,1332,1185
1660,2,16,1628,32,1660,0,1.05469e+14,8.54096,114.101,1660,14,12,1142,965,897,955,775
48232,641,2818,15137,33095,0,48232,3.45327e+13,848.133,8436.34,48232,560,648,44527,43045,33098,33145,14269
30471,2973,3006,0,30471,0,30471,2.3163e+18,959.33,7330.25,30471,430,492,27465,27465,27452,27443,27416
26951,1836,2386,26951,0,24559,2392,2.07215e+18,658.896,5542.59,26951,334,379,24565,24548,24360,24225,23064
35048,1125,1750,10820,24228,0,35048,3.56673e+13,700.159,5686.87,35048,419,306,33298,32862,30341,30494,26614
35810,813,2193,0,35810,9971,25839,9.62443e+15,567.578,6588.02,35810,427,290,33617,32853,30684,30947,21500
31384,27,2188,18020,13364,0,31384,4.52189e+18,846.534,6130.24,31384,327,430,15390,7634,7566,6348,380
23361,133,293,0,23361,22915,446,2.71778e+16,127.115,1719.57,23361,97,101,23041,22886,20926,19894,15508
12437,217,626,12437,0,12437,0,3.92447e+18,283.586,2055.47,12437,143,146,11506,10536,8104,7960,6503
26679,2148,2956,24388,2291,15745,10934,1.88838e+18,685.056,6900.37,26679,345,378,23723,23682,23279,23397,20052
8654,624,1239,2782,5872,0,8654,3.52981e+13,313.258,2672.32,8654,248,355,7415,7171,6785,6811,4874
17753,2420,2456,10622,7131,0,17753,4.86831e+18,486.834,5161.67,17753,319,411,15297,15297,15297,15297,15170
48804,1303,2083,15361,33443,0,48804,3.37709e+13,1023.36,7324.22,48804,521,475,46497,45694,44119,44131,35219
40951,906,3900,36317,4634,24704,16247,1.93224e+18,1298.53,9639.26,40951,454,516,35152,31740,24009,22983,14572
9054,2201,2290,7757,1297,5236,3818,2.03256e+18,351.233,3793.16,9054,270,260,6764,6764,6763,6763,6658
30927,3447,3576,18240,12687,18240,12687,1.70954e+18,747.789,7949.46,30927,580,428,27351,27351,27332,27335,27230
28380,1251,1774,0,28380,26607,1773,0.0624736,0.937491,7095.46,28380,1774,1,26606,26606,26606,26606,26606
28829,450,597,28829,0,28829,0,3.75791e+18,315.09,2916.02,28829,187,186,28232,28168,27199,26999,26327
37425,80,88,36626,799,37413,12,1.00857e+14,19.0924,823.553,37425,29,30,37337,37337,37185,37185,36770
46384,1432,1988,14053,32331,0,46384,3.555e+13,483.826,6877.01,46384,338,401,44396,44387,44159,44159,40422
19818,380,2685,11795,8023,11795,8023,1.84687e+18,539.395,5672.78,19818,335,496,16574,14833,13341,11973,2615
13857,213,540,13857,0,13857,0,4.42443e+18,257.584,1978.02,13857,143,152,12994,11803,9240,8894,8167
41376,221,244,0,41376,40600,776,2.56267e+16,154.867,1968.56,41376,105,108,41132,41130,41041,40914,40592
30374,1772,1830,9485,20889,0,30374,3.54279e+13,497.478,5173.27,30374,323,307,28544,28544,28544,28544,28518
14463,209,1308,0,14463,0,14463,2.39391e+18,474.228,3266.07,14463,278,225,11424,9140,7968,7623,3669
14195,649,959,0,14195,4542,9653,7.30048e+15,338.026,2649.33,14195,215,226,13236,13026,13027,13047,9328
36988,108,2935,22266,14722,0,36988,5.0621e+18,1129.43,7810.46,36988,549,464,26089,21562,16336,14278,1783
2669,254,586,1725,944,1725,944,1.61538e+18,219.345,1094.8,2669,137,111,2012,1620,1617,1382,1129
29737,847,2316,0,29737,9185,20552,8.80781e+15,470.442,6170.1,29737,312,500,27421,26833,26041,25937,16966
35720,1899,2933,21177,14543,21177,14543,1.72098e+18,569.105,7127.8,35720,446,416,32787,32726,32421,32538,27851
19473,803,2572,19473,0,17515,1958,1.55658e+18,735.967,5468.38,19473,301,330,16554,16001,12181,11786,6788
7649,734,1264,7649,0,6759,890,2.77224e+18,347.664,2572.77,7649,187,233,6385,6215,6024,5878,4845
43717,2666,3806,43717,0,39326,4391,2.39317e+18,1326.59,9581.96,43717,453,428,39911,39559,38104,37992,31901
21686,404,1751,6442,15244,0,21686,3.72075e+13,456.256,4632.93,21686,325,310,19457,18682,15679,15789,9231
33840,316,326,0,33840,33020,820,2.64765e+16,135.961,2170.45,33840,102,118,33514,33513,33504,33456,33298
27381,1910,3245,24393,2988,16083,11298,1.96476e+18,820.833,7244.44,27381,382,409,24136,24064,22939,23210,14386
43642,12,66,42595,1047,43642,0,9.7867e+13,21.7378,754.351,43642,28,30,43407,43262,38188,37945,24600
19932,1542,1906,12063,7869,12063,7869,1.93078e+18,798.626,4700.83,19932,333,341,18026,17548,17775,17883,16612
46745,107,417,0,46745,45902,843,2.57124e+16,141.796,2967.96,46745,122,136,46132,45788,39147,36461,26195
9052,1102,1536,0,9052,0,9052,2.42162e+18,324.169,2990.96,9052,215,262,7516,7504,7315,7384,5916
24082,26,34,23637,445,24082,0,9.48733e+13,18.6125,514.963,24082,20,22,24048,24048,23786,23787,22992
1744,215,574,0,1744,0,1744,2.35903e+18,121.507,871.828,1744,127,99,1167,1005,919,886,727
29482,2193,2660,17669,11813,0,29482,4.58855e+18,971.181,6679.77,29482,445,434,26822,26815,26773,26776,26071
28187,20,191,0,28187,27559,628,2.37747e+16,135.726,1402.83,28187,89,92,26289,25187,21802,20482,12236
5009,339,697,0,5009,0,5009,2.2423e+18,385.611,1596,5009,158,178,3958,3300,3317,3009,2361
5148,492,719,1625,3523,0,5148,3.59018e+13,248.898,1574.39,5148,189,169,4429,4372,4376,4363,4089
31958,46,54,31522,436,31950,8,1.04292e+14,17.9243,645.656,31958,24,25,31904,31903,31626,31626,31253
29159,141,2214,25934,3225,17827,11332,1.93242e+18,825.806,6026.99,29159,362,383,18398,13661,7695,6912,2515
20102,1914,2274,17962,2140,12206,7896,1.93309e+18,790.576,5386.39,20102,330,302,17828,17798,17753,17743,16907
2685,151,243,0,2685,925,1760,6.15901e+15,80.5128,632.32,2685,71,71,2442,2442,2000,1976,1527
25054,1225,2938,25054,0,22360,2694,2.89544e+18,641.567,6355.46,25054,315,336,22116,21836,20866,20107,10627
5173,126,842,0,5173,0,5173,2.00588e+18,203.287,1657.69,5173,132,126,4014,2892,1891,1876,514
18310,20,32,17956,354,18310,0,1.00323e+14,17.5412,445.003,18310,22,21,18276,18265,17475,17476,15008
44836,16,103,44067,769,44836,0,1.04188e+14,19.8848,876.555,44836,31,36,44675,44586,40265,39712,25617
18402,18282,18402,18402,0,0,18402,15.9991,0,18402,18402,18402,1,0,0,0,0,0
29518,3576,3596,29518,0,26067,3451,1.92528e+18,950.417,8149.97,29518,538,376,25922,25922,25922,25922,25905
37489,1994,3986,0,37489,0,37489,2.3178e+18,830.048,9287.27,37489,547,529,33503,32933,25303,22117,17578
42354,1728,3854,0,42354,0,42354,2.36511e+18,982.943,9233.77,42354,412,568,38500,37749,35859,32572,25483
3223,585,609,860,2363,0,3223,4.02691e+13,118.392,1120.6,3223,158,99,2614,2614,2614,2614,2607
38408,882,1505,12479,25929,0,38408,3.51118e+13,752.824,5643.08,38408,371,411,36768,35737,34427,34633,29795
28133,1948,2569,0,28133,0,28133,2.42348e+18,678.15,6410.05,28133,449,300,25564,25558,24877,24551,19560
35285,2228,3391,35285,0,32057,3228,2.48796e+18,1298.47,8195.04,35285,526,413,31894,30756,31031,30723,28808
7282,9,26,7195,87,7282,0,9.43535e+13,14.7573,268.882,7282,18,20,7193,7131,6453,6363,5074
744,200,235,0,744,226,518,1.04135e+16,41.5242,348.097,744,64,49,509,509,507,504,488
49450,496,1084,49450,0,49450,0,4.17732e+18,361.952,4397.38,49450,239,235,48366,48185,39413,38768,34777
37605,250,305,0,37605,37048,557,2.67766e+16,142.594,2206.58,37605,103,111,37300,37291,36835,36690,35260
1757,104,118,0,1757,1717,40,2.67397e+16,35.9067,343.756,1757,38,32,1639,1639,1634,1635,1599
42474,7,116,41492,982,42474,0,1.00419e+14,18.5694,924.931,42474,33,34,41418,40816,36257,35375,18031
32458,1348,1722,0,32458,10545,21913,8.19162e+15,481.172,5419.32,32458,272,385,30736,30726,30637,30616,28646
11444,1417,1944,0,11444,0,11444,2.17391e+18,364.792,3750.02,11444,254,249,9500,9479,9272,9233,8057
10717,328,475,10717,0,10717,0,4.07239e+18,249.504,1737.93,10717,139,146,10242,10150,9085,8955,8286
29535,1166,1988,0,29535,9101,20434,9.21987e+15,615.653,5712.33,29535,376,428,27547,27281,26128,26108,19207
24277,1849,2191,21505,2772,14437,9840,1.9422e+18,1075.6,5641.21,24277,370,365,22086,21220,21820,21815,20542
29132,835,1668,0,29132,9048,20084,8.03262e+15,603.186,5015.18,29132,300,369,27325,26638,25026,24932,14221
46257,824,1926,14250,32007,0,46257,3.54606e+13,805.801,6844.55,46257,444,352,43919,41844,38669,38863,28101
13373,1095,1826,0,13373,0,13373,2.37763e+18,703.247,3945.31,13373,279,300,11543,10861,10649,10619,8260
32799,72,2412,0,32799,9705,23094,8.94584e+15,603.517,6716.78,32799,359,459,25181,21395,15964,13652,3356
11924,54,554,11924,0,11924,0,4.173e+18,268.776,1946.88,11924,148,145,8241,5506,4113,3759,1836
29582,708,4271,29582,0,26329,3253,1.3879e+18,591.308,8636.34,29582,353,580,24843,22663,15856,13395,6629
30719,1467,3116,18073,12646,18073,12646,1.76183e+18,878.796,7386.09,30719,495,411,27603,27106,25732,25444,18590
42044,2757,3425,25488,16556,25488,16556,1.88228e+18,742.199,8992.17,42044,561,405,38619,38530,38281,38380,34051
3275,120,326,3275,0,3275,0,3.6391e+18,155.126,847.123,3275,96,71,2820,2524,1905,1777,1273
43053,243,1098,43053,0,43053,0,4.01721e+18,386.254,4201.27,43053,226,224,40946,38455,24825,23267,16082
19628,693,2289,11718,7910,0,19628,4.80564e+18,816.691,5249.15,19628,371,407,16678,15245,13978,13865,9018
4898,735,1130,2961,1937,2961,1937,1.71079e+18,212.251,2004.44,4898,181,231,3768,3708,3584,3619,3071
19843,1107,2239,11982,7861,0,19843,4.96242e+18,687.344,5064.11,19843,381,399,17604,17058,15877,15681,9168
44051,2251,2619,12943,31108,0,44051,3.46645e+13,725.546,7786.65,44051,604,350,41432,41421,41232,41238,39961
33846,998,3626,30471,3375,19383,14463,1.93082e+18,930.889,8311.62,33846,421,429,29736,28489,25962,25772,10539
35642,2711,3565,31839,3803,21293,14349,1.93727e+18,1073.13,8483.91,35642,442,442,32077,31719,31429,31543,27422
26684,2094,2139,15657,11027,0,26684,4.87192e+18,837.709,5596.31,26684,385,305,24545,24545,24543,24543,24512
748,10,80,0,748,742,6,2.54322e+16,13.6016,184.143,748,24,22,649,610,520,515,318
36098,1821,2394,21479,14619,21479,14619,1.86814e+18,1001.4,6930.76,36098,474,354,33704,33665,33071,33060,30115
24719,886,2944,24707,12,22058,2661,1.279e+18,1001.27,6717.17,24719,412,438,21144,19114,14526,13293,9728
17427,445,1046,0,17427,5352,12075,9.00171e+15,631.09,3343.11,17427,283,280,15748,14955,14444,14526,8518
29460,422,590,29460,0,29460,0,4.84521e+18,325.722,2942.15,29460,192,192,28870,28783,26515,26417,26554
7527,136,741,0,7527,2492,5035,8.15679e+15,146.081,1773.04,7527,151,192,6662,6319,4641,4393,2719
36648,180,2973,11715,24933,0,36648,3.59964e+13,457.185,7813.29,36648,345,646,31077,27492,17596,11235,4330
36230,384,944,36230,0,36230,0,4.35293e+18,361.474,3749.61,36230,218,219,35239,34872,26906,25993,24198
13204,2,37,12991,213,13204,0,1.03475e+14,16.4004,396.448,13204,20,21,9375,8189,7675,7857,5605
29833,2782,3258,29808,25,26965,2868,2.35462e+18,988.361,7329.52,29833,372,439,26575,26575,26332,26063,25385
17587,54,212,0,17587,17325,262,2.55748e+16,96.9665,1313.39,17587,70,79,17121,16744,14551,13300,9224
26121,353,1350,7981,18140,0,26121,3.16031e+13,606.134,4317,26121,384,277,24037,22727,20283,20340,10505
46583,3026,3569,26181,20402,26181,20402,1.62848e+18,672.57,9169.1,46583,425,494,43014,42996,42748,42826,41154
18869,770,1771,5754,13115,0,18869,3.61135e+13,386.51,4560.35,18869,287,396,17098,16834,15945,16091,8540
30698,1816,3173,0,30698,0,30698,2.08702e+18,460.132,7528.99,30698,439,298,27525,27497,24865,24400,18896
9687,1959,1972,9687,0,8728,959,2.30658e+18,464.138,3570,9687,266,218,7715,7715,7715,7715,7715
16120,390,674,16120,0,16120,0,4.06755e+18,258.453,2311.74,16120,160,166,15446,15386,13411,13281,12918
46147,2463,3457,27158,18989,0,46147,4.5672e+18,1189.98,9366.19,46147,432,525,42690,42363,40900,40485,34269
29498,435,564,29498,0,29498,0,4.18258e+18,325.867,2979.67,29498,192,189,28934,28881,27657,27545,27154
48915,1905,3208,0,48915,0,48915,2.39589e+18,1092.15,9180.05,48915,626,413,45707,45328,43864,41042,38161
31119,246,2068,0,31119,0,31119,2.36226e+18,864.282,6025.02,31119,381,337,25012,20230,15463,14540,5070
34390,1022,3363,19864,14526,0,34390,4.57339e+18,867.074,7920.41,34390,473,382,30844,29345,18426,17740,10158
19642,413,2774,11523,8119,0,19642,4.97771e+18,414.337,5651.87,19642,327,370,16618,15169,11533,11124,3363
4075,333,353,4075,0,4075,0,4.00379e+18,184.047,1008.65,4075,89,90,3722,3718,3711,3713,3683
19732,19,50,19283,449,19732,0,1.02451e+14,19.2316,507.573,19732,26,23,19667,19651,18331,18094,13543
1268,153,246,1268,0,1268,0,4.08648e+18,108.546,499.18,1268,60,57,1022,922,835,822,783
11915,8,26,11776,139,11894,21,9.89831e+13,16.6883,384.269,11915,19,21,11740,11645,10047,9756,7909
34583,62,70,34068,515,34583,0,1.03986e+14,17.7693,699.992,34583,29,32,34513,34513,34361,34362,34204
39314,578,2103,0,39314,12090,27224,8.84635e+15,725.846,6619.12,39314,444,350,36504,34786,27206,27549,18232
37540,2810,3104,37540,0,34079,3461,1.71489e+18,776.203,7832.36,37540,384,501,34436,34432,34401,34298,32531
4901,22,26,4808,93,4901,0,9.87836e+13,14.0802,240.446,4901,16,16,4875,4873,4721,4721,4497
11389,1393,1432,7086,4303,7086,4303,1.87711e+18,481.431,3191.01,11389,229,268,9957,9957,9947,9949,9920
4513,22,27,4420,93,4513,0,1.02037e+14,13.0075,218.182,4513,15,16,4486,4486,4370,4371,4198
41175,218,3208,24149,17026,24149,17026,1.71518e+18,548.781,8016.98,41175,434,366,33548,28533,16575,13854,4068
20156,1436,1522,5920,14236,0,20156,3.61671e+13,461.263,4300.03,20156,379,272,18634,18634,18616,18609,18317
2483,20,31,2438,45,2483,0,1.03385e+14,11.6017,183.166,2483,15,17,2452,2449,2336,2336,2209
33006,88,889,33006,0,33006,0,4.12102e+18,339.794,3455.96,33006,193,210,26830,19614,14047,11792,4765
49029,1094,2135,0,49029,14037,34992,9.53195e+15,933.718,7055.49,49029,490,435,46661,45421,42087,42501,32552
30905,1126,1750,0,30905,9625,21280,9.07468e+15,593.911,5366.4,30905,357,342,29155,28997,28020,28050,22464
7645,885,1079,4616,3029,0,7645,5.14235e+18,485.301,2332.9,7645,202,205,6566,6127,6249,6235,5948
22775,1518,2685,0,22775,0,22775,2.26088e+18,629.743,6058.06,22775,392,414,20090,19993,19282,17632,15656
44640,2463,4180,27215,17425,0,44640,4.97308e+18,752.044,9808.07,44640,506,463,40460,40316,39207,38961,31445
36281,1119,2056,0,36281,11313,24968,8.62111e+15,586.392,6028.68,36281,367,347,34225,33804,33222,33229,27928
45720,1395,4748,40861,4859,27895,17825,1.96934e+18,1261.01,11193.2,45720,489,506,40311,38144,24479,23471,16697
27518,45,47,27062,456,27518,0,1.01817e+14,19.8413,645.508,27518,24,27,27471,27471,27306,27306,26923
48192,9,60,47313,879,48192,0,9.76801e+13,19.7916,760.558,48192,28,27,47650,47254,42257,40980,24640
6022,913,1194,3647,2375,0,6022,5.08111e+18,277.597,2188.98,6022,186,178,4828,4800,4743,4743,3820
27008,1670,2110,16016,10992,16016,10992,1.87149e+18,672.871,5788.92,27008,306,391,24898,24873,24722,24795,21498
40224,380,3106,23599,16625,23599,16625,1.83352e+18,1210.98,8497.89,40224,487,508,33540,29636,22904,18119,7903
26254,388,2132,26254,0,23314,2940,2.30703e+18,1107.93,5866.24,26254,361,345,21466,17310,8669,5253,5516
19350,1107,1545,5880,13470,0,19350,3.25225e+13,579.831,3996.73,19350,311,317,17805,17482,17402,17422,15790
46493,180,2684,0,46493,14280,32213,9.16076e+15,713.083,8343.45,46493,428,474,38808,33850,25227,20785,7546
41031,2411,3455,24554,16477,24554,16477,1.81834e+18,924.839,8846.02,41031,436,619,37576,37328,36820,37056,31523
19041,585,1461,0,19041,5605,13436,9.67004e+15,348.927,3961.18,19041,243,295,17580,17350,16226,16391,11135
36109,1700,1921,0,36109,10949,25160,9.0722e+15,861.508,6167.04,36109,451,366,34188,34142,33897,33899,33077
16709,264,601,16709,0,16709,0,4.06441e+18,310.756,2332.89,16709,164,167,15914,15251,12196,12053,10621
41765,221,301,0,41765,41276,489,2.52396e+16,147.905,2319.32,41765,98,112,41464,41432,40586,40251,37316
23486,2209,2469,0,23486,0,23486,2.42839e+18,896.729,5962.04,23486,411,375,21017,21013,20463,20025,20216
14163,46,48,13926,237,14163,0,1.01795e+14,15.9468,424.771,14163,26,20,14115,14115,13928,13927,14058
20878,2506,2623,12634,8244,0,20878,4.87314e+18,651.43,5792.54,20878,331,378,18255,18255,18250,18247,18019
24320,437,1864,0,24320,7557,16763,9.25006e+15,489.319,5032.31,24320,438,416,22013,20883,15468,15207,10003
45756,2075,3319,41138,4618,27866,17890,1.98665e+18,1631.81,9181.37,45756,505,452,42351,41042,40492,40548,34939
16172,43,1253,4620,11552,0,16172,3.68159e+13,362.784,3323.42,16172,321,224,11381,8820,6733,1571,1351
39655,13,291,0,39655,38991,664,2.74984e+16,133.611,2018.01,39655,104,105,35843,33893,28324,20926,15180
49708,962,1906,0,49708,14353,35355,9.5412e+15,778.757,6771.34,49708,466,378,47701,46603,44050,44400,33598
45536,1198,4827,40369,5167,26982,18554,1.95077e+18,1244.01,11497.5,45536,576,612,39517,37455,26067,25879,15189
45014,920,2410,0,45014,13922,31092,8.89217e+15,671.592,7298.32,45014,431,481,42604,41752,37873,37869,26001
6512,266,1094,2163,4349,0,6512,3.19488e+13,186.723,2179.29,6512,234,196,5393,5106,3576,3514,1818
46025,2232,3076,46025,0,41587,4438,2.24125e+18,1279.43,8561.47,46025,451,508,42949,42847,42425,42280,40768
978,34,85,0,978,961,17,2.91768e+16,13.047,224.998,978,21,30,893,892,811,794,580
25839,1009,2544,23227,2612,14456,11383,1.99005e+18,947.509,6139.84,25839,431,359,22922,21331,14453,14058,9350
35982,1938,2398,0,35982,0,35982,2.3239e+18,1105.2,7177.99,35982,456,407,33584,33443,32519,31639,30361
32148,1,48,31668,480,32148,0,9.53837e+13,18.1972,617.723,32148,24,25,13583,13583,13583,13583,13583
12711,2236,2529,7548,5163,7548,5163,1.90717e+18,447.668,4541.64,12711,244,317,10182,10182,10109,10122,9667
21996,253,1622,13382,8614,13382,8614,1.94382e+18,917.858,4623.47,21996,357,309,17015,14245,10945,9320,3939
21470,218,233,0,21470,20978,492,2.77961e+16,126.586,1526.01,21470,91,102,21237,21237,21200,21113,20871
49425,825,2566,0,49425,15241,34184,8.77414e+15,680.117,7630.05,49425,490,435,46557,45401,37132,37069,21578
41154,241,2693,12963,28191,0,41154,3.53236e+13,729.644,7845.37,41154,543,436,35545,31678,20332,12191,5919
23446,668,1800,0,23446,7017,16429,9.32367e+15,414.351,4687.49,23446,359,305,21646,21179,17278,17382,11602
9200,387,1308,2523,6677,0,9200,3.6965e+13,215.973,2768.55,9200,292,182,7892,7551,6485,6470,3696
3103,233,544,974,2129,0,3103,3.26221e+13,91.9894,1077.66,3103,126,130,2559,2485,2312,2190,1519
46258,292,806,46258,0,46258,0,4.10414e+18,383.28,3953.29,46258,229,231,44972,43769,32029,30845,26529
24228,310,1495,6822,17406,0,24228,3.71628e+13,577.43,4438.19,24228,412,337,21523,19933,15899,15799,7473
1180,385,412,752,428,0,1180,3.12566e+18,91.6831,646.012,1180,112,76,768,768,754,747,754
3867,1095,1162,0,3867,0,3867,2.25709e+18,156.119,1816.72,3867,185,130,2705,2705,2705,2705,2657
2914,379,656,0,2914,954,1960,8.54474e+15,125.834,1185.28,2914,146,110,2258,2194,2056,2075,1502
44307,303,3817,39898,4409,25567,18740,1.91667e+18,1560.89,9776.34,44307,455,442,34979,30421,12964,11421,4477
42032,19,66,41134,898,42032,0,1.02466e+14,18.6018,769.736,42032,29,28,41953,41914,38498,38273,27072
1262,283,356,399,863,0,1262,3.72549e+13,59.0016,572.881,1262,77,75,906,905,902,900,785
41880,617,3736,37313,4567,25867,16013,1.91822e+18,1210.42,9202.56,41880,457,439,35179,29268,18523,16776,8727
20994,842,3093,18751,2243,12450,8544,1.9404e+18,526.664,6395.02,20994,371,326,17831,16974,12365,12001,8646
42645,763,3522,38099,4546,25417,17228,1.95664e+18,1074.35,9363.85,42645,459,518,37434,34209,26586,25693,14868
18937,43,2171,0,18937,0,18937,2.14183e+18,570.863,4856.19,18937,325,314,10706,6598,4882,4581,677
24099,2151,2848,24099,0,21414,2685,2.28541e+18,559.867,6129.11,24099,372,275,21251,21248,21207,21183,19922
24007,1885,3747,24007,0,21389,2618,2.66093e+18,647.346,7475.4,24007,503,362,20260,19754,18999,19217,10776
43723,251,259,0,43723,42899,824,2.5614e+16,134.275,2094.57,43723,87,92,43464,43459,43461,43455,43352
590,16,184,590,0,567,23,1.98657e+18,14.1712,265.411,590,51,41,370,71,41,134,2
3018,211,648,1789,1229,0,3018,5.12509e+18,180.81,1170.12,3018,107,133,2270,1943,1952,1963,834
45549,1446,2414,0,45549,13394,32155,9.35013e+15,772.337,7705.42,45549,504,497,43135,42680,41712,41701,34889
32405,181,3822,32405,0,28854,3551,1.72142e+18,774.305,8360,32405,484,349,23456,19040,11552,9012,3168
31473,1808,2043,9105,22368,0,31473,3.59833e+13,618.299,6033.1,31473,525,292,29430,29429,29004,29012,28399
38173,1626,2958,22535,15638,22535,15638,1.83558e+18,1041.72,7918.7,38173,486,521,35215,34207,33557,33142,29851
22234,840,2233,0,22234,0,22234,2.43548e+18,633.834,5246.11,22234,381,293,19903,19188,17393,14139,12425
41854,250,2125,0,41854,12987,28867,8.19001e+15,683.527,6580.64,41854,351,429,37795,34777,23821,23133,8983
21132,1188,2126,12741,8391,0,21132,4.69212e+18,844.972,5272.84,21132,335,407,18913,18242,16938,16789,13535
46976,405,2648,0,46976,13526,33450,9.51831e+15,805.587,8060,46976,482,543,42367,39931,31935,32393,14512
32425,2374,4025,32425,0,28607,3818,3.03421e+18,1144.88,8857.02,32425,501,574,28400,27718,26849,26601,19665
932,157,217,0,932,0,932,2.33581e+18,67.6717,385.012,932,69,55,715,712,708,702,571
36562,984,3310,21867,14695,21867,14695,1.88239e+18,1022.68,8181.66,36562,448,494,32623,31333,30024,27913,11808
1676,69,560,1069,607,0,1676,6.06313e+18,48.457,806.416,1676,130,86,1095,979,829,766,357
48447,92,101,47257,1190,48447,0,1.00327e+14,17.5618,942.33,48447,33,33,48346,48346,47971,47971,46877
42635,224,2775,12197,30438,0,42635,3.71654e+13,684.967,8133.87,42635,466,423,36759,32256,24626,22438,8099
8050,1277,1408,4876,3174,0,8050,4.8044e+18,597.413,2820.46,8050,270,288,6642,6299,6504,6497,6293
31886,1943,3181,28709,3177,19251,12635,1.92711e+18,1029.11,7744.25,31886,407,421,28705,28131,27060,27345,21702
6108,537,1519,5445,663,3646,2462,2.02381e+18,297.333,2570.15,6108,186,242,4589,4200,3847,3903,2115
28242,2936,3534,28242,0,25378,2864,1.53831e+18,1186.65,7798.47,28242,463,525,24708,24379,24211,24019,23259
11605,1039,1182,3402,8203,0,11605,3.60347e+13,348.87,2936.85,11605,254,272,10423,10423,10386,10389,9944
3310,141,604,891,2419,0,3310,3.74206e+13,114.935,1159.73,3310,116,127,2659,2396,2317,2355,953
16211,89,2118,0,16211,0,16211,2.47953e+18,675.074,4552.43,16211,408,286,10936,8372,6398,5255,1275
9311,21,528,9311,0,9311,0,4.17491e+18,260.561,1731.14,9311,135,128,4847,2760,2094,1872,585
21615,753,1772,6747,14868,0,21615,3.32811e+13,392.852,4573.99,21615,266,341,19843,19509,18718,18826,11875
49280,2951,4874,43943,5337,29882,19398,2.00313e+18,823.771,11293,49280,690,444,44406,44309,38358,38237,33535
11093,921,1671,6958,4135,0,11093,4.8893e+18,420.017,3457.29,11093,293,341,9422,9144,8539,8484,6691
3139,87,583,0,3139,840,2299,1.05036e+16,112.656,1062.54,3139,146,112,2380,2136,1750,1788,891
31621,1360,2176,0,31621,8753,22868,9.6293e+15,652.047,6256.26,31621,525,289,29445,29025,28514,28504,23982
16556,500,2871,16556,0,14503,2053,1.07191e+18,902.36,5713.92,16556,324,475,12560,10689,6602,5412,3611
18424,545,2288,10930,7494,10930,7494,1.88284e+18,519.528,5132.72,18424,341,336,15727,14693,12930,12682,5705
48016,21,38,46934,1082,48016,0,9.72233e+13,18.6189,708.255,48016,23,25,47975,47962,45748,45749,39511
6920,74,894,1967,4953,0,6920,3.79139e+13,320.546,1986.42,6920,202,164,5227,4523,3265,3117,1090
3160,216,861,0,3160,0,3160,2.4783e+18,146.785,1385.41,3160,167,92,2252,1932,1358,1442,616
48948,2174,3798,29003,19945,0,48948,4.66247e+18,750.698,9796.9,48948,599,542,45150,44929,39714,38664,26643
21053,1337,2719,18916,2137,12203,8850,1.97296e+18,823.362,5813.45,21053,339,396,18334,17422,16871,16999,8801
43835,1340,2005,0,43835,13356,30479,8.4514e+15,855.748,6396.23,43835,421,425,41830,41132,40613,40680,36990
36252,121,2323,10862,25390,0,36252,3.68435e+13,670.473,6808.21,36252,405,426,28722,25075,17773,6962,4954
42236,134,238,0,42236,40856,1380,2.58197e+16,155.772,1948.93,42236,89,91,41890,41644,39076,38331,34041
22215,1430,1841,0,22215,0,22215,2.06875e+18,783.968,4660.57,22215,333,376,20374,19913,19788,19566,19161
25701,2021,2331,15473,10228,15473,10228,1.83469e+18,659.194,5924.37,25701,482,320,23370,23369,23188,23134,22477
17283,2012,2443,0,17283,0,17283,2.10282e+18,361.097,4962.31,17283,271,319,14840,14828,14701,14837,11884
13345,1233,2965,13345,0,12020,1325,2.59768e+18,525.355,5116.98,13345,315,346,10380,9817,7386,6865,5171
25256,145,250,0,25256,24819,437,2.56779e+16,136.932,1691.34,25256,91,96,24969,24817,22861,22999,19970
5285,96,387,5285,0,5285,0,4.70939e+18,169.93,1146.44,5285,109,105,4541,3829,2067,1940,1563
48784,1760,3643,27694,21090,27694,21090,1.69634e+18,885.114,9621.52,48784,507,422,45141,44448,42941,42714,29899
10275,366,1727,0,10275,0,10275,2.34871e+18,379.165,3383.69,10275,268,308,8271,7166,5464,4863,1869
17915,1300,1508,0,17915,5369,12546,8.55406e+15,237.836,3829.84,17915,222,308,16407,16405,16370,16394,13635
16978,1493,2086,15408,1570,9579,7399,1.92963e+18,636.621,4487.92,16978,252,260,14892,14873,14708,14772,13385
8504,1058,2386,7439,1065,5088,3416,1.90162e+18,300.056,3834,8504,324,259,6118,5924,4727,4808,3697
37092,1938,1997,10531,26561,0,37092,3.80158e+13,791.225,6397.82,37092,453,370,35095,35095,35095,35095,35047
12225,7,29,12066,159,12225,0,9.85913e+13,14.8652,344.656,12225,17,20,11960,11789,10331,10241,7687
44110,913,3526,0,44110,0,44110,2.41395e+18,1146.93,9275.3,44110,626,414,39524,37951,29609,27591,15771
14761,1111,1884,8563,6198,0,14761,4.71961e+18,508.606,4190.67,14761,334,274,12877,12806,11875,11769,9090
43973,780,3507,39364,4609,26461,17512,1.96958e+18,1231.28,9363.5,43973,533,458,37599,33420,22595,21976,17177
5070,381,495,0,5070,1502,3568,9.5114e+15,236.083,1242.25,5070,129,137,4575,4574,4409,4441,4284
40254,1691,3716,35510,4744,23786,16468,1.91611e+18,1528.19,9411.95,40254,541,581,36063,34269,29466,28625,22535
41310,2539,3034,41310,0,37334,3976,1.84307e+18,1013.94,7910.41,41310,417,416,38276,37974,38010,37507,32500
45110,35,56,44310,800,45110,0,9.9518e+13,18.3697,747.436,45110,25,27,45054,45054,43436,43437,38360
27259,1490,1863,16641,10618,16641,10618,1.90428e+18,938.245,5478.24,27259,397,343,25396,25393,25245,25298,24478
31964,1300,2863,0,31964,0,31964,2.26778e+18,645.477,6992.63,31964,358,444,29101,28589,27115,24399,19916
23620,939,2205,13523,10097,0,23620,4.21675e+18,614.279,5447.31,23620,348,314,21415,20424,18431,18394,13202
12599,13,196,0,12599,12341,258,2.4942e+16,96.5637,1030.16,12599,67,69,11311,10694,9402,7234,4880
43865,1773,2550,14197,29668,0,43865,3.44176e+13,687.445,7532.02,43865,500,441,41315,41021,40029,40009,35131
45901,2350,2694,13256,32645,0,45901,3.69009e+13,722.438,8156.53,45901,447,458,43207,43118,43021,42997,39626
29136,2478,3169,29136,0,26139,2997,2.19728e+18,1134.87,7352.66,29136,454,437,25967,25951,25785,25648,24880
10829,277,572,10829,0,10829,0,4.16123e+18,282.983,1914.81,10829,150,145,10162,9724,7669,7636,7325
43166,772,1028,43154,12,43166,0,4.02331e+18,384.77,4148.36,43166,239,219,42138,42117,40319,40265,38905
13504,110,537,13504,0,13504,0,4.3418e+18,267.03,2012.09,13504,149,146,11345,9130,6240,5954,3452
9089,220,1679,9089,0,8194,895,2.43393e+18,431.91,3311.28,9089,222,279,6351,4773,2807,1734,1713
11512,16,197,0,11512,11366,146,2.69403e+16,86.9104,999.572,11512,65,67,10573,10161,8562,7502,4494
21725,398,1523,6719,15006,0,21725,3.51519e+13,454.66,4272.94,21725,351,284,19772,18766,14461,14476,10815
10438,46,1487,0,10438,0,10438,2.24749e+18,318.124,3146.32,10438,195,265,6139,3890,3044,2712,452
47409,911,3383,0,47409,0,47409,2.30028e+18,1171.77,9127,47409,421,551,42786,40572,27503,27463,16611
40960,326,3218,36928,4032,24144,16816,1.96878e+18,1697.8,8847.51,40960,516,428,31916,24597,15990,13287,3706
38841,1507,3728,0,38841,0,38841,2.41564e+18,1324.95,9174.93,38841,614,584,34608,33187,30276,29957,15488
6553,163,298,6553,0,6553,0,4.63324e+18,165.599,1104.76,6553,107,107,6235,6095,4622,4515,4780
33594,36,45,33031,563,33594,0,9.85676e+13,20.6544,620.845,33594,23,26,33549,33549,32806,32806,31199
20235,1546,2486,20235,0,17819,2416,2.65431e+18,837.485,5712.54,20235,303,352,17749,17685,17296,17122,15163
15682,242,1885,15682,0,14067,1615,2.21571e+18,735.647,4375.82,15682,358,274,11450,9829,5576,5278,2402
36481,3578,5180,0,36481,0,36481,2.34076e+18,591.456,10555.2,36481,353,882,31301,31273,30630,30928,24108
48241,2006,2760,0,48241,14937,33304,8.77045e+15,718.437,8332.78,48241,412,515,45481,45430,44988,44913,37406
48685,1560,2760,15161,33524,0,48685,3.44672e+13,650.113,7831.16,48685,448,400,45925,45662,43684,43782,33440
12267,214,1273,0,12267,3471,8796,9.51836e+15,281.824,2995.8,12267,266,190,10456,9212,8094,8202,3968
40297,1503,1731,0,40297,0,40297,1.97428e+18,1109.53,6196.12,40297,391,406,38528,37215,38131,38166,36379
13301,1589,2396,11855,1446,7930,5371,1.98758e+18,509.368,4621.59,13301,247,432,10905,10889,10420,10486,8710
1101,229,388,0,1101,0,1101,2.10272e+18,30.4777,573.263,1101,72,61,713,712,699,703,499
29250,176,3661,29250,0,25707,3543,2.16047e+18,894.829,7991.63,29250,375,459,20238,15731,7937,2181,714
13504,667,1890,8024,5480,0,13504,4.8227e+18,310.892,3988.75,13504,343,194,11614,11458,8970,8861,6118
8190,357,1750,0,8190,0,8190,2.39471e+18,223.48,3060.72,8190,249,192,6440,5928,3741,3402,1973
36677,525,2485,10697,25980,0,36677,3.63037e+13,657.62,7045.24,36677,351,461,33500,32001,27919,28061,12061
25644,2243,2386,14532,11112,0,25644,4.06543e+18,742.345,5795.54,25644,360,393,23258,23093,23212,23222,22755
39510,2062,2444,12216,27294,0,39510,3.5207e+13,623.491,7168.55,39510,522,450,37066,37066,36904,36909,35363
7021,66,165,0,7021,6896,125,2.57195e+16,80.9457,742.889,7021,63,59,6793,6625,6089,6010,4683
42412,2521,4179,38069,4343,24560,17852,1.96029e+18,1703.44,10109.2,42412,472,551,38233,36520,34291,33836,28178
18626,1596,2880,16636,1990,10799,7827,1.94575e+18,598.567,5916.42,18626,347,332,15746,15503,13628,13548,10732
23781,2432,3062,23781,0,21709,2072,2.10712e+18,1042.37,6490.95,23781,366,392,20719,20703,20697,20716,19444
47677,578,4034,42630,5047,28098,19579,1.91691e+18,1577.76,10576,47677,503,647,38983,34004,19715,18587,11301
7701,129,166,0,7701,7566,135,2.65176e+16,74.3401,801.99,7701,51,60,7535,7528,7400,7419,6808
8947,698,1370,0,8947,0,8947,2.36566e+18,522.463,2853.02,8947,248,246,7529,6899,6749,6180,4763
24209,253,596,24149,60,24209,0,3.98801e+18,337.702,2738,24209,178,181,23275,22413,17811,17146,14278
49487,273,1046,49487,0,49487,0,4.25458e+18,386.067,4458.04,49487,234,239,47722,45786,30956,28678,23823
10766,175,576,10766,0,10766,0,4.09157e+18,257.419,1887.77,10766,140,126,9726,8601,6127,5763,4742
16561,1959,2282,16561,0,14854,1707,3.28275e+18,647.125,4722.44,16561,349,318,14279,14074,14096,14098,13471
20354,668,1375,12012,8342,0,20354,4.9014e+18,749.009,3989.11,20354,311,281,18524,17699,16580,16051,8820
16257,450,1236,0,16257,5014,11243,9.16252e+15,398.088,3440.77,16257,314,226,14838,14307,12585,12568,8598
28155,614,2751,0,28155,0,28155,2.38419e+18,1027.21,6715.41,28155,449,416,23952,21938,17555,13557,9267
34152,2111,3178,30638,3514,20338,13814,1.93021e+18,1173.85,7978.92,34152,403,430,30974,30546,27305,27198,24067
32125,103,3323,0,32125,0,32125,2.39392e+18,871.56,7909.92,32125,413,468,22801,18659,13797,11079,1605
40678,1584,1589,24056,16622,0,40678,4.90188e+18,1031,5861.1,40678,379,393,39089,39089,39089,39089,39089
27949,1288,1760,8616,19333,0,27949,3.32801e+13,679.443,5343.36,27949,403,433,26189,25900,24862,24838,21615
7768,100,690,2458,5310,0,7768,3.61537e+13,356.243,1850.43,7768,178,200,5885,5114,3620,3463,1892
915,194,443,915,0,814,101,2.69014e+18,38.4874,573.029,915,69,60,472,446,434,452,339
4656,43,1131,4081,575,2751,1905,1.96075e+18,360.774,1988.75,4656,190,197,2373,1595,1007,1036,163
12974,1490,1603,11619,1355,7911,5063,1.96392e+18,680.62,3744.43,12974,286,248,11371,11371,11371,11371,11282
35401,1273,2135,0,35401,11391,24010,8.35972e+15,559.308,6309.07,35401,357,480,33266,33140,32118,32082,24296
11034,1258,2028,0,11034,0,11034,2.38177e+18,339.189,3835.17,11034,266,285,9006,8933,8706,8818,6880
46789,472,4724,46789,0,41736,5053,2.32656e+18,1794.98,11501.9,46789,636,564,36679,31609,17056,9421,5879
31948,562,2223,9494,22454,0,31948,3.46968e+13,711.74,6246.87,31948,334,381,29187,28122,22442,22127,9235
48873,2760,2932,0,48873,15691,33182,8.57594e+15,605.132,8595.82,48873,509,352,45941,45939,45896,45892,45390
12545,532,1003,3615,8930,0,12545,3.56013e+13,387.612,2692.24,12545,248,211,11527,11260,10440,10479,7904
49322,100,108,48210,1112,49322,0,1.0132e+14,18.0175,957.842,49322,30,33,49214,49214,49162,49163,48928
40326,565,936,40326,0,40326,0,4.23374e+18,397.996,3963.31,40326,227,219,39390,39239,35431,35274,34773
8695,1102,1672,5204,3491,0,8695,4.92692e+18,350.491,3142.57,8695,180,318,7023,7002,6818,6842,5424
4110,381,419,4110,0,4110,0,4.18495e+18,204.455,1079.96,4110,102,90,3691,3687,3680,3678,3679
6562,384,1083,3774,2788,0,6562,4.71828e+18,225,2158,6562,152,190,5438,4989,4929,4864,1802
6177,684,702,1872,4305,0,6177,3.62403e+13,242.219,1706.73,6177,216,155,5475,5475,5474,5474,5465
40355,290,3315,24373,15982,24373,15982,1.81325e+18,1062.16,8916.7,40355,537,466,31985,27374,19587,14655,5513
23626,493,1903,7051,16575,0,23626,3.62835e+13,496.755,5149.7,23626,391,335,21309,20367,16979,17259,8160
8565,1339,1390,5019,3546,5019,3546,1.89964e+18,334.406,2753.9,8565,233,272,7175,7172,7170,7174,7120
41524,32,60,40810,714,41524,0,9.98288e+13,18.5916,778.731,41524,27,29,41464,41464,40000,39921,32338
7894,571,881,2342,5552,0,7894,3.71656e+13,319.566,2122.35,7894,207,184,7013,6792,6731,6743,5583
19238,1542,2282,11488,7750,11488,7750,1.87441e+18,588.932,5228.96,19238,353,405,16956,16622,15810,15721,12644
22065,2433,2703,0,22065,0,22065,2.38758e+18,615.868,5884.29,22065,423,420,19362,19362,19265,19354,18843
11339,248,585,11339,0,11339,0,4.15881e+18,265.421,1921.93,11339,153,143,10641,10126,8262,8110,7503
18390,34,42,17994,396,18390,0,1.01861e+14,16.9982,471.899,18390,23,24,18348,18348,18001,18001,16846
20605,1197,1352,6490,14115,0,20605,3.07421e+13,499.501,3819.79,20605,295,332,19253,19129,19078,19081,18417
35102,365,2272,10005,25097,0,35102,3.65494e+13,682.268,6588.91,35102,519,446,31324,29076,22783,21884,7333
26058,354,843,26058,0,26058,0,4.1565e+18,334.823,3162.57,26058,190,198,25161,24530,18109,17618,18224
21017,1299,1506,0,21017,6519,14498,9.17633e+15,451.964,4116.6,21017,288,375,19511,19511,19327,19341,18806
16001,2337,3373,14192,1809,9506,6495,2.00155e+18,444.941,5952.68,16001,325,477,12628,12559,12197,12322,10158
30188,24,903,30188,0,30188,0,4.46037e+18,329.147,3311.77,30188,201,199,16622,9389,7034,6073,1642
6793,18,776,0,6793,0,6793,2.2522e+18,462.836,1960.53,6793,186,192,2966,1694,1438,866,235
12684,229,612,12684,0,12684,0,4.33569e+18,251.564,2024.82,12684,143,150,11866,10946,8214,8005,6964
28035,36,703,28010,25,28035,0,4.14862e+18,337.218,3063.98,28035,188,191,18222,12135,8793,8352,2466
3105,225,706,2631,474,1810,1295,2.07172e+18,320.036,1281.88,3105,140,141,2122,1744,1348,1311,1017
41169,173,3994,23515,17654,23515,17654,1.66825e+18,646.942,9666.11,41169,415,562,32874,29085,21368,15087,4289
29205,305,3921,29205,0,26183,3022,2.66769e+18,845.537,8261.31,29205,521,559,22523,18572,8855,5656,3044
18220,46,52,17997,223,18220,0,1.00803e+14,16.9746,509.052,18220,24,24,18168,18168,18019,18019,17776
47658,2109,4386,47658,0,42705,4953,2.34215e+18,888.218,10829.3,47658,608,475,43272,42915,41936,40814,31043
40597,1744,1806,0,40597,11991,28606,9.30772e+15,682.904,6260.33,40597,523,339,38791,38791,38748,38756,38583
2736,609,624,0,2736,0,2736,2.41502e+18,227.743,1122.03,2736,130,151,2112,2112,2112,2112,2102
31405,1384,1616,9498,21907,0,31405,3.57533e+13,576.999,5012.06,31405,318,358,29789,29788,29712,29706,28983
36991,2648,2884,21978,15013,21978,15013,1.88287e+18,1112.71,7664.38,36991,481,460,34107,33922,33917,34017,33455
31792,49,84,31341,451,31792,0,1.02455e+14,16.8829,730.934,31792,27,27,31708,31708,30794,30795,25923
17136,332,2299,10164,6972,0,17136,4.57731e+18,504.925,4937.79,17136,410,262,13629,11876,8247,6746,3035
15148,51,219,0,15148,14807,341,2.63343e+16,96.1934,1204.45,15148,75,72,14710,14439,12795,11435,8200
21046,2,266,0,21046,20607,439,2.65826e+16,98.7536,1521.42,21046,88,88,11657,9137,8436,8818,6492
26895,3377,3822,26895,0,24036,2859,2.48464e+18,888.141,7996.8,26895,491,454,23073,23072,23016,23032,22020
14745,1260,1410,4719,10026,0,14745,3.47593e+13,408.41,3531.6,14745,287,317,13335,13335,13308,13308,12861
7055,286,765,4486,2569,4486,2569,1.86143e+18,385.62,1893.06,7055,184,181,5663,4570,4855,4579,2747
14979,485,1100,0,14979,4862,10117,8.92251e+15,315.273,2999.07,14979,247,242,13879,13680,9971,10129,7578
1898,422,766,1898,0,1699,199,3.11435e+18,121.32,1088.87,1898,112,112,1132,1022,1100,1101,756
23470,1971,2103,0,23470,0,23470,2.09107e+18,793.795,5168.74,23470,297,299,21367,21367,21294,21291,20789
13567,1952,3042,12350,1217,8188,5379,2.07678e+18,359.78,5168.01,13567,220,401,10525,10522,9945,9998,7850
47609,2576,4927,41803,5806,27931,19678,1.97231e+18,1508.16,11432.8,47609,500,641,42682,41462,40564,40878,31013
24353,1317,1609,7398,16955,0,24353,3.54621e+13,456.505,4746.67,24353,427,251,22744,22725,22283,22304,21376
24900,1084,2537,14915,9985,0,24900,4.95686e+18,841.402,6063.7,24900,379,317,22200,21477,20865,20678,14961
10089,63,979,5511,4578,5511,4578,1.46863e+18,432.256,2308.16,10089,212,159,6708,4419,2956,3084,557
28891,174,242,0,28891,28513,378,2.5263e+16,137.305,1692.58,28891,90,100,28638,28550,27865,27635,26049
45632,1885,4489,45607,25,41320,4312,2.75471e+18,1063.66,10624.8,45632,484,538,41143,40124,37228,36626,22738
47712,77,106,46741,971,47687,25,1.03087e+14,19.8886,895.959,47712,31,33,47606,47606,46761,46762,43597
32018,1,38,31660,358,32018,0,1.01837e+14,18.4682,577.86,32018,25,22,13792,13792,13792,13792,13792
508,19,186,250,258,250,258,1.3983e+18,69.1004,286.385,508,50,41,161,22,36,34,72
11942,19,31,11737,205,11942,0,9.1264e+13,15.7237,359.538,11942,22,18,11909,11904,11463,11463,10106
48089,2125,4170,48089,0,43063,5026,2.46611e+18,1407.06,10187.4,48089,441,500,43742,42005,41745,40414,30462
15854,308,2978,9508,6346,9508,6346,1.90534e+18,412.904,5482.27,15854,416,304,12231,10696,8106,6783,3205
14385,30,46,14155,230,14385,0,9.87171e+13,16.2494,427.414,14385,20,23,14339,14339,13847,13848,12219
8225,727,1322,4982,3243,4982,3243,1.82312e+18,437.482,2715.92,8225,213,234,6903,6663,6258,6063,4502
34800,31,63,34018,782,34796,4,1.0375e+14,20.4856,692.825,34800,27,29,34737,34729,32752,32638,26081
5812,771,958,3130,2682,3130,2682,1.61272e+18,164.795,1933.3,5812,131,204,4854,4834,4819,4833,3922
28384,445,1958,0,28384,8297,20087,9.41901e+15,518.185,5678.89,28384,356,411,25815,24217,20805,20976,7515
40278,177,3727,36061,4217,24392,15886,1.98008e+18,1268.55,9417.59,40278,536,411,27767,22432,12019,10722,805
13746,38,53,13477,269,13746,0,1.08364e+14,16.4612,433.716,13746,23,24,13693,13693,13340,13340,12753
41225,3950,4904,36944,4281,23882,17343,1.99176e+18,1002.53,10951.1,41225,518,666,36321,36302,35744,35923,31982
40115,109,3941,23481,16634,0,40115,4.77652e+18,765.367,9617.64,40115,556,440,28306,23875,15135,10887,3258
34890,589,1731,10098,24792,0,34890,3.66981e+13,761.381,5901.31,34890,470,328,32386,30994,26550,26539,15401
29946,1469,2758,0,29946,0,29946,2.34381e+18,895.704,6676.78,29946,371,389,27188,26462,25984,25593,21200
37208,1022,2013,0,37208,11129,26079,9.69023e+15,636.555,6262.74,37208,479,362,35195,34565,32922,33031,26197
46285,1074,1183,46285,0,46285,0,4.09547e+18,362.078,4432.5,46285,239,235,45102,45101,44933,44921,44553
47148,150,297,0,47148,46419,729,2.54024e+16,158.608,2326.83,47148,101,111,46791,46603,43471,41912,33671
33508,900,3244,19799,13709,19799,13709,1.76475e+18,891.273,7838.09,33508,430,539,29780,27846,22391,22365,13200
10184,635,2054,0,10184,0,10184,2.47452e+18,310.982,3642.4,10184,235,318,8130,7610,7237,7252,3014
34768,56,64,34163,605,34768,0,1.04096e+14,19.1351,692.435,34768,29,29,34704,34704,34056,34057,32550
44643,73,83,43851,792,44643,0,1.03264e+14,17.9913,828.99,44643,27,32,44560,44560,44230,44231,43651
41049,1507,4536,36607,4442,25048,16001,1.97415e+18,712.731,10145.2,41049,382,720,36513,35694,32817,33106,17683
14515,273,1595,14515,0,12843,1672,2.36825e+18,623.416,3869.11,14515,268,232,10397,7638,5244,3641,3199
43405,1042,3623,0,43405,0,43405,2.40845e+18,1081.69,9441.58,43405,559,429,38891,36478,28288,24247,12977
22704,2532,3349,20406,2298,13881,8823,1.94674e+18,768.385,6875.66,22704,434,421,19355,19330,19146,19242,18144
49858,2776,4226,49858,0,44520,5338,1.69871e+18,1078.24,10840,49858,586,416,45632,45355,44211,43686,36790
17584,24,38,17305,279,17584,0,9.95986e+13,14.7455,446.135,17584,20,22,17546,17543,16957,16956,14926
19477,925,2983,19477,0,17409,2068,2.8742e+18,606.396,5900.95,19477,394,374,16354,15541,13668,13195,7702
39775,550,2568,23662,16113,0,39775,4.85855e+18,1102.4,7638.08,39775,511,387,35046,32638,23672,22433,12778
20729,1108,2483,12344,8385,0,20729,4.61817e+18,471.297,5597.86,20729,403,321,18246,18067,14029,14054,10323
19025,533,2907,19025,0,17146,1879,1.22965e+18,444.34,5587.19,19025,343,304,15914,14885,12121,10875,7363
49041,329,3107,28472,20569,0,49041,4.7096e+18,1180.64,8881.67,49041,570,491,41617,36438,23795,22874,8716
19122,163,1804,0,19122,5668,13454,9.49418e+15,516.891,4648.88,19122,388,362,15476,13695,10549,9077,3080
48552,896,4843,28529,20023,28529,20023,1.76781e+18,867.443,11489.8,48552,618,510,43025,40321,30618,28052,14114
45114,66,2183,13297,31817,0,45114,3.59177e+13,920.917,7165.7,45114,400,461,33147,27735,21293,9390,4149
1640,1313,1640,1640,0,1640,0,68677600000,0,1640,1640,1640,1,0,0,0,0,0
19284,1139,1710,19284,0,16888,2396,1.52183e+18,1004.13,4699.38,19284,320,340,17341,15678,15665,15599,14099
40905,1444,2567,12701,28204,0,40905,3.55396e+13,615.066,7579.79,40905,485,404,38338,38076,35768,35923,26792
19705,1173,2332,11246,8459,0,19705,4.77048e+18,455.297,5387.7,19705,270,544,17373,17324,16821,16737,8732
44724,1181,2104,13556,31168,0,44724,3.27476e+13,952.186,6949.67,44724,439,421,42389,41149,39726,39925,30443
22098,1555,2673,0,22098,0,22098,2.47076e+18,764.595,6008.17,22098,326,455,19425,18720,18312,18539,12217
3723,184,689,0,3723,1038,2685,9.95901e+15,171.367,1314.68,3723,196,116,2983,2733,2136,2129,1183
14581,175,255,0,14581,14370,211,2.59944e+16,85.6467,1299.1,14581,70,81,14326,14319,13939,13950,12999
33764,3797,3907,20274,13490,0,33764,4.89136e+18,672.909,8629.8,33764,579,350,29857,29857,29850,29857,29725
22181,2301,2329,13479,8702,0,22181,4.68794e+18,616.898,5459.37,22181,424,288,19852,19852,19852,19852,19838
24143,603,897,24143,0,24143,0,4.13067e+18,322.591,3062.93,24143,188,199,23246,23232,21308,21268,21401
13281,1300,1836,13281,0,11604,1677,3.15452e+18,735.682,4032.12,13281,284,287,11445,10967,11045,11052,10378
42979,3007,3277,24639,18340,24639,18340,1.74662e+18,1209.15,8660.18,42979,501,430,39702,39409,39515,39604,38783
31845,907,2641,18840,13005,0,31845,4.79191e+18,935.907,7033.02,31845,396,406,28651,27163,23677,22886,14404
44961,2684,3655,26443,18518,26443,18518,1.7423e+18,720.704,9191.72,44961,514,405,41306,41288,40696,40692,34991
7718,17,38,7563,155,7718,0,9.54421e+13,15.4271,306.316,7718,18,21,7678,7645,7158,7154,5062
24416,227,331,0,24416,23912,504,2.68534e+16,111.005,1906.01,24416,95,94,24085,24068,23259,23267,20754
46504,1222,2419,0,46504,14277,32227,8.98781e+15,576.901,7791.49,46504,476,390,44085,43863,42590,42771,31684
22717,2095,2269,13402,9315,0,22717,4.52279e+18,525.068,5464.5,22717,360,361,20448,20446,20387,20384,20046
49726,1212,4556,29153,20573,29153,20573,1.80351e+18,1252.36,11189.4,49726,583,696,44649,42387,33516,34360,17371
23004,95,249,0,23004,22532,472,2.60741e+16,117.633,1589.34,23004,85,86,22657,22393,20316,19088,14319
12256,218,1176,7525,4731,7525,4731,1.86087e+18,415.787,2846.33,12256,207,222,9453,7212,5654,5188,2522
10198,356,1516,10198,0,9174,1024,2.4375e+18,539.521,3085.58,10198,261,235,7974,6266,3834,2894,3120
13222,575,1370,0,13222,4019,9203,9.41072e+15,374.866,3398.16,13222,310,346,11852,11360,10844,10555,7116
35126,872,2988,21544,13582,0,35126,4.82523e+18,1116.84,7859.84,35126,553,379,31005,27377,20828,20362,12429
4384,14,29,4347,37,4360,24,1.00417e+14,15.6029,223.424,4384,17,19,4335,4313,4110,4110,3178
26209,1210,2868,22908,3301,15655,10554,1.94915e+18,1131.43,6825.55,26209,475,476,22810,21143,16420,15336,12579
27011,710,1550,0,27011,8670,18341,9.19793e+15,649.024,4926.4,27011,379,405,25268,24425,21940,21844,16541
6353,17,28,6263,90,6353,0,1.08771e+14,14.8092,260.47,6353,18,18,6322,6312,5935,5950,4721
25192,194,1914,7970,17222,0,25192,3.30894e+13,490.412,5178.67,25192,438,362,22030,20462,14192,13955,5111
11396,1071,1208,3330,8066,0,11396,3.5769e+13,301.904,2900.26,11396,187,252,10188,10188,10172,10169,9907
17949,2237,2406,16229,1720,9913,8036,1.9115e+18,315.199,4753.06,17949,243,338,15543,15543,15517,15530,14182
2732,338,459,866,1866,0,2732,3.45383e+13,204.499,946.049,2732,129,134,2273,2086,2142,2135,2112
34977,195,345,0,34977,34208,769,2.48557e+16,145.564,2347.34,34977,108,118,34632,34547,32565,32365,28428
40782,14,48,40055,727,40782,0,9.95331e+13,20.0271,678.98,40782,23,26,40678,40607,36940,36632,25483
39881,390,4482,39881,0,35728,4153,2.67989e+18,1073.22,10386.2,39881,419,652,30140,24248,19810,18344,6133
38241,2039,4204,34178,4063,22477,15764,1.95943e+18,1142.47,9481.09,38241,579,421,34037,32740,29997,29819,24531
43953,2943,5789,39612,4341,26667,17286,1.97438e+18,1286.89,12292.2,43953,578,730,38164,37014,33407,33465,18597
25961,604,738,25961,0,25953,8,4.17116e+18,325.723,2987.94,25961,187,188,25223,25219,24980,24971,24290
11467,517,2354,10148,1319,7006,4461,1.99228e+18,532.075,4265.45,11467,280,323,8501,7285,5634,5534,2269
20743,32,36,20367,376,20743,0,1.0047e+14,18.5586,489.128,20743,22,25,20707,20707,20557,20558,20097
20856,2367,2434,0,20856,0,20856,2.36382e+18,751.291,5683.94,20856,340,474,18422,18422,18413,18408,18325
33352,441,2136,20006,13346,20006,13346,1.88355e+18,676.19,6106.88,33352,395,353,28681,24279,24251,22205,11940
49157,150,4749,44150,5007,29482,19675,1.9615e+18,791.525,11183.6,49157,433,679,33834,26081,15386,11986,5127
6314,98,189,0,6314,6178,136,2.72071e+16,62.6603,756.805,6314,54,64,6125,6083,5611,5585,4385
48860,605,2394,14558,34302,0,48860,3.48499e+13,760.731,7703.78,48860,438,444,45254,42830,39239,38910,21211
26605,197,815,26605,0,26605,0,4.40353e+18,328.155,3132.18,26605,189,189,24800,22774,14982,13501,9980
47694,210,1290,47694,0,47694,0,4.12206e+18,413.08,4702.06,47694,245,249,44193,39910,25245,23864,16969
19066,1421,1771,11505,7561,11505,7561,1.82381e+18,760.934,4633.1,19066,343,307,17295,17290,17189,17195,16221
21746,130,2462,13320,8426,0,21746,4.97016e+18,745.225,5640.06,21746,420,329,14947,12349,7538,6035,1957
36007,830,939,35987,20,36007,0,3.99108e+18,331.142,3724.5,36007,198,208,35068,35066,34602,34578,34001
43350,2060,2684,13473,29877,0,43350,3.60037e+13,745.565,7821.38,43350,431,510,40666,40597,40391,40353,37473
21373,2876,3287,19007,2366,12885,8488,1.96958e+18,884.662,6697.34,21373,388,419,18086,18053,18013,18044,17401
6775,409,875,3970,2805,3970,2805,1.82202e+18,307.083,1895.53,6775,169,158,5900,5393,4771,4019,2349
21599,1124,1808,6891,14708,0,21599,3.29146e+13,343.1,4705.33,21599,282,428,19791,19740,19341,19308,15138
5385,304,573,0,5385,1698,3687,8.88253e+15,251.046,1428.61,5385,151,129,4740,4585,4272,4270,3458
49002,3213,5064,49002,0,43662,5340,1.74484e+18,1492.72,11777.8,49002,548,696,43938,43312,42056,41267,34857
15491,1807,1933,8658,6833,0,15491,4.11672e+18,556.889,4226,15491,225,294,13558,13423,13546,13554,13286
38845,1126,2043,11758,27087,0,38845,3.58587e+13,689.659,6437.32,38845,431,381,36802,36119,34092,34215,27759
3028,79,126,0,3028,2976,52,2.62007e+16,50.6235,425.871,3028,46,42,2902,2854,2722,2767,2341
34411,37,1049,34411,0,34411,0,4.02068e+18,389.662,3836.08,34411,223,218,21235,12966,10438,9546,2359
29243,15,51,28642,601,29243,0,9.4637e+13,20.0437,603.383,29243,25,29,29149,29096,25995,25934,16755
20434,239,2492,12214,8220,0,20434,4.64604e+18,595.261,5483.93,20434,364,301,16312,14090,8514,6648,1902
18738,545,1188,5035,13703,0,18738,3.69644e+13,661.666,3602.93,18738,306,274,17099,16419,15831,15934,9381
6725,580,954,0,6725,1936,4789,9.93434e+15,234.921,2035.04,6725,206,181,5771,5736,5626,5631,4276
10190,589,1303,0,10190,0,10190,2.19076e+18,509.741,2962.54,10190,226,275,8718,7922,6605,6052,5177
34628,2398,4012,34628,0,30891,3737,1.5594e+18,1422.8,9182.23,34628,522,448,30616,28745,27159,27639,21696
32016,3115,3802,27666,4350,18745,13271,2.00371e+18,1132.24,8720.24,32016,512,496,28214,28186,27714,27725,24702
21203,2094,3157,18710,2493,12678,8525,1.97165e+18,889.144,6515.07,21203,305,417,18046,17586,17397,17637,15040
18668,1682,1746,0,18668,5473,13195,9.29275e+15,439.51,4476.68,18668,360,278,16922,16922,16920,16920,16818
34309,508,855,34051,258,34309,0,4.1862e+18,377.199,3596.73,34309,218,219,33454,33299,29526,29410,28757
40922,129,305,0,40922,39921,1001,2.5587e+16,148.957,2238.53,40922,110,113,40462,40081,36024,34623,27704
35958,873,2292,0,35958,10207,25751,9.55914e+15,682.074,6811.81,35958,501,351,33614,32817,29918,29907,19883
48965,817,4063,29097,19868,0,48965,4.60078e+18,894.903,10179.8,48965,393,531,44022,41248,28045,24047,14438
2101,124,481,653,1448,0,2101,3.47037e+13,125.459,863.428,2101,134,91,1539,1374,1225,1218,697
8711,600,960,2312,6399,0,8711,3.94575e+13,333.366,2268.4,8711,215,177,7741,7307,7562,7565,6509
32609,1232,1805,0,32609,10216,22393,8.03122e+15,695.935,5497.95,32609,429,312,30804,30284,30407,30425,28253
736,479,736,736,0,0,736,15.9783,0,736,736,736,1,0,0,0,0,0
32746,2124,2499,19774,12972,0,32746,4.94361e+18,1158.22,6868.43,32746,468,380,30247,29930,29857,29719,29207
29751,2506,2763,17096,12655,17096,12655,1.63168e+18,704.586,6629.96,29751,410,400,26988,26734,26852,26893,25739
1764,238,426,539,1225,0,1764,3.18514e+13,113.552,736.709,1764,118,82,1338,1244,1277,1258,1085
46923,1298,3199,27490,19433,27490,19433,1.7461e+18,1177.78,9012.35,46923,534,484,43217,41326,39717,38871,24897
18602,501,726,18602,0,18602,0,4.08029e+18,303.552,2575.29,18602,172,176,17876,17829,16579,16531,15981
46581,790,3061,28366,18215,0,46581,4.99355e+18,1018.87,8466.54,46581,467,436,42266,39680,29417,27887,20250
32710,713,2905,19599,13111,19599,13111,1.83682e+18,914.627,7212.2,32710,545,452,28823,26684,18845,19046,13449
40721,701,3556,0,40721,0,40721,2.27549e+18,825.462,9101.96,40721,392,579,36087,33509,29890,22756,11438
23976,124,1400,7236,16740,0,23976,3.50851e+13,518.212,4185.01,23976,348,321,19541,16686,13205,7991,4429
12668,856,1009,4173,8495,0,12668,3.34587e+13,353.834,2842.46,12668,248,263,11659,11653,11598,11619,11344
49708,14,355,0,49708,49023,685,2.54075e+16,161.938,2741.06,49708,107,116,45186,43102,36993,30250,18701
48036,55,62,47171,865,48036,0,1.00007e+14,21.0699,809.491,48036,26,30,47974,47974,47584,47584,46916
33364,961,2034,10534,22830,0,33364,3.59496e+13,650.745,6126.85,33364,384,346,31330,30809,26500,26750,20106
41985,2676,2914,41985,0,37942,4043,2.26635e+18,1490.83,8118.2,41985,424,534,39071,37903,38894,38776,38311
49335,2603,5420,43999,5336,29570,19765,1.96342e+18,941.739,12257.6,49335,522,566,43915,43507,40162,39751,27577
28662,806,1242,0,28662,9010,19652,7.70938e+15,565.014,4059.65,28662,288,264,27247,26490,26732,26732,21021
40722,995,1837,0,40722,11424,29298,9.42492e+15,811.919,6215.61,40722,461,316,38800,37697,35714,35889,29141
9124,2111,2172,0,9124,0,9124,2.26795e+18,259.879,3683.69,9124,407,197,6952,6952,6950,6950,6901
25651,2688,3422,15313,10338,15313,10338,1.86151e+18,808.475,7213.14,25651,466,422,22229,22097,21796,21961,19698
48942,1040,4614,29039,19903,29039,19903,1.87294e+18,1575.54,11451.2,48942,550,671,42286,38267,32626,34148,12145
47616,352,729,47616,0,47616,0,4.06852e+18,358.176,3925.14,47616,228,222,46806,46383,37921,37356,31508
18851,474,668,18841,10,18851,0,4.26035e+18,300.274,2499.62,18851,171,171,18183,18132,16797,16686,16103
35060,2464,3468,19634,15426,0,35060,4.45969e+18,670.66,8241.06,35060,392,659,31592,31557,31059,31026,23324
49721,731,2950,30356,19365,30356,19365,1.85715e+18,1154.78,8418.26,49721,483,488,45270,43273,33195,32509,17440
43169,1166,3180,25836,17333,0,43169,5.02145e+18,1267.87,8846.61,43169,526,488,39066,36333,31941,31267,20422
11458,112,1183,3511,7947,0,11458,3.57023e+13,325.208,2919.8,11458,227,239,8963,7741,5791,5624,1768
18809,1163,2410,10931,7878,10931,7878,1.70975e+18,534.541,5280.56,18809,350,407,16399,15959,14351,14005,11337
12897,26,34,12550,347,12897,0,9.73172e+13,14.9159,381.193,12897,22,20,12863,12862,12440,12456,11093
5957,195,1277,0,5957,0,5957,2.44349e+18,232.229,2267.56,5957,257,141,4468,3943,3237,3153,1409
44558,212,362,0,44558,43474,1084,2.61609e+16,155.664,2555.73,44558,114,125,44196,44083,41623,40487,35986
15453,983,2468,0,15453,0,15453,2.27021e+18,541.418,4944.92,15453,333,419,12985,12439,11456,11266,8160
27211,14,56,26768,443,27211,0,9.80319e+13,22.4608,659.986,27211,27,29,27078,27005,24417,24474,15299
31911,91,794,31911,0,31911,0,4.11339e+18,344.501,3371.91,31911,204,201,26334,20467,14410,13362,6259
27397,92,256,0,27397,26968,429,2.51441e+16,133.858,1780.72,27397,86,98,26987,26681,23629,22962,16580
39042,775,2231,0,39042,11568,27474,9.31866e+15,765.131,6903.88,39042,478,363,36373,35208,32980,33124,20333
21803,626,2049,13133,8670,13133,8670,1.87357e+18,766.379,5068.09,21803,361,343,18798,17218,16549,16134,9596
8915,513,1531,5313,3602,5313,3602,1.93564e+18,358.17,3005.33,8915,226,260,7384,6941,4693,5179,3436
36503,448,1838,0,36503,11075,25428,8.86516e+15,639.946,5928.64,36503,354,351,33956,31973,26368,26113,13006
531,10,144,0,531,0,531,1.82368e+18,72.1168,259.495,531,47,41,101,16,26,14,67
42926,129,339,0,42926,42231,695,2.63179e+16,129.219,2361.94,42926,108,123,42520,42227,37792,36067,28295
47879,2199,3565,28305,19574,0,47879,4.87506e+18,1274.32,9709.98,47879,490,618,44314,43267,41694,40713,34933
18465,1828,1973,16379,2086,10982,7483,2.0237e+18,682.51,4791.42,18465,343,259,16492,16489,16492,16492,16275
13590,1594,2662,8254,5336,0,13590,4.84256e+18,387.139,4855.82,13590,346,269,10928,10832,10197,9973,7312
15788,280,542,15788,0,15778,10,4.0151e+18,283.255,2196.6,15788,155,154,15159,14833,12119,11671,10564
33707,2096,3682,19806,13901,0,33707,4.51528e+18,774.192,8462.74,33707,447,454,30025,29778,28915,28631,20648
1293,441,464,749,544,749,544,1.73535e+18,86.9954,696.55,1293,116,63,829,827,827,828,822
21702,1949,2332,12952,8750,0,21702,4.69375e+18,980.931,5627.58,21702,423,481,19370,18940,18370,17991,18233
15949,551,602,15949,0,15949,0,3.918e+18,286.465,2261.79,15949,161,154,15347,15346,15306,15300,15208
3456,254,582,1918,1538,0,3456,3.63226e+18,120.53,1157.83,3456,107,125,2874,2805,2787,2774,2287
19231,484,499,19231,0,19231,0,4.32429e+18,310.035,2329.63,19231,162,167,18732,18732,18717,18718,18720
15770,50,65,15367,403,15770,0,1.09324e+14,15.0872,508.312,15770,24,24,15705,15705,15467,15466,14518
30820,2923,4100,18760,12060,0,30820,5.00395e+18,576.873,8607.85,30820,293,659,26720,26710,26239,26278,22714
27282,1416,2984,16509,10773,0,27282,4.67148e+18,679.611,7066.93,27282,334,421,24298,24106,21933,21399,14363
21245,172,280,0,21245,20895,350,2.61436e+16,106.4,1673.1,21245,79,89,20965,20915,19938,19770,17267
3313,16,23,3240,73,3313,0,9.97442e+13,14.0036,184.234,3313,15,15,3288,3283,3162,3165,2834
25092,233,1640,8209,16883,0,25092,3.43606e+13,477.648,4883.59,25092,280,497,21984,19879,13044,13164,5347
14697,6,33,14369,328,14697,0,1.00356e+14,16.0408,397.188,14697,21,24,14215,13875,12322,12271,7769
22827,32,64,22550,277,22827,0,1.0295e+14,18.4405,583.205,22827,27,25,22763,22760,22043,22012,18356
27632,1697,1782,0,27632,8841,18791,9.23521e+15,474.539,5242.36,27632,309,333,25850,25850,25825,25813,25586
6332,472,480,6332,0,6311,21,4.24571e+18,238.354,1383.37,6332,114,120,5852,5852,5849,5849,5848
3630,694,883,2118,1512,2118,1512,1.86623e+18,155.437,1516.56,3630,117,160,2747,2747,2698,2705,2420
3746,516,1083,0,3746,0,3746,2.01202e+18,185.204,1729.86,3746,229,143,2663,2615,2437,2390,2082
14392,1773,2153,8762,5630,0,14392,4.50295e+18,572.971,4398.76,14392,335,338,12239,12227,12091,12041,11742
49762,58,90,48939,823,49762,0,1.00306e+14,20.893,898.056,49762,31,31,49672,49672,48550,48553,43398
7533,402,445,2309,5224,0,7533,2.69771e+13,131.193,1386.16,7533,128,107,7088,7088,7077,7088,6681
3480,509,570,2191,1289,0,3480,4.61744e+18,311.902,1208,3480,154,142,2910,2904,2855,2859,2846
11427,1127,1329,3303,8124,0,11427,3.70569e+13,283.437,3034.85,11427,241,213,10098,10084,10064,10064,9578
2514,249,345,2514,0,2514,0,3.99693e+18,138.911,789.734,2514,77,71,2169,2119,2049,2048,1926
38487,304,4126,34209,4278,23108,15379,1.96544e+18,1323.22,9822.3,38487,494,514,28905,24084,12709,11313,3740
10885,31,36,10747,138,10879,6,1.0279e+14,17.4169,379.843,10885,22,22,10849,10847,10692,10692,10491
26518,206,610,26518,0,26514,4,4.13751e+18,318.636,2867.19,26518,187,190,25043,23108,17643,17322,13090
2126,282,316,2126,0,2126,0,4.40324e+18,157.219,718.878,2126,77,74,1810,1806,1766,1768,1770
19511,2239,3059,17253,2258,11585,7926,1.9665e+18,737.018,6143.25,19511,384,415,16452,16281,15940,16102,13561
16358,1120,1392,4644,11714,0,16358,3.68226e+13,429.519,3660.68,16358,370,239,14966,14959,14806,14807,14214
42319,106,110,41686,633,42205,114,9.88913e+13,25.1676,995.843,42319,33,36,42209,42209,42124,42124,41918
28340,2068,2073,9159,19181,0,28340,3.43625e+13,643.241,5904.2,28340,444,492,26267,26267,26267,26267,26266
3438,22,24,3389,49,3438,0,1.04059e+14,12.6213,186.305,3438,16,16,3414,3413,3299,3298,3347
13829,1728,1995,0,13829,0,13829,2.40558e+18,442.911,4209.56,13829,251,389,11834,11834,11727,11719,11376
23811,1505,1540,0,23811,6627,17184,9.20241e+15,498.005,4563.95,23811,333,263,22271,22271,22270,22270,22247
6885,662,939,4015,2870,0,6885,4.75127e+18,281.488,2023.88,6885,204,141,5946,5941,5531,5473,4835
9757,3,24,9548,209,9757,0,1.00999e+14,12.8109,307.947,9757,16,18,8231,7446,6937,6859,5440
34275,1501,3279,20641,13634,20641,13634,1.90371e+18,1020.12,8043.62,34275,531,518,30878,29618,29170,28839,15312
23781,1338,2383,0,23781,0,23781,2.2153e+18,639.801,5869.7,23781,291,381,21398,21302,20850,20790,14208
1636,6,457,463,1173,0,1636,3.49315e+13,61.6974,738.637,1636,78,99,576,264,283,271,110
43202,34,320,0,43202,42522,680,2.65784e+16,144.702,2438.11,43202,103,127,41389,40382,33817,27864,17790
18187,1260,2478,16365,1822,11042,7145,1.96247e+18,736.625,5426.97,18187,350,314,15659,14829,12605,12122,9650
2202,255,520,0,2202,720,1482,8.95284e+15,113.846,933.361,2202,105,136,1682,1580,1571,1594,899
32049,1126,2365,10513,21536,0,32049,3.30006e+13,567.628,6372.57,32049,375,398,29684,29333,28093,28182,17528
11656,528,1027,0,11656,3619,8037,9.09558e+15,333.913,2655.8,11656,233,244,10629,10438,10019,10014,8459
23265,136,237,0,23265,22837,428,2.60046e+16,134.912,1562.2,23265,82,99,22989,22877,21032,21107,17666
12655,513,686,12655,0,12655,0,4.21726e+18,300.671,2157.23,12655,152,158,11969,11912,11407,11354,11292
33461,746,3527,33461,0,29146,4315,2.88956e+18,1742.55,8677.76,33461,473,523,27446,24824,19090,16500,9809
34806,2345,2969,34806,0,30252,4554,2.27918e+18,1126.22,7852.08,34806,397,411,31837,31516,31677,31445,28457
40260,522,3425,0,40260,0,40260,2.42003e+18,1199.87,8851.48,40260,602,451,34140,30676,21393,20615,10181
31714,176,4079,31714,0,28454,3260,2.45337e+18,1087.3,8780.92,31714,450,539,23235,19445,11239,7558,3264
23117,67,1725,0,23117,0,23117,2.28085e+18,927.919,5043.38,23117,360,373,14593,10404,7981,5122,1411
41272,2373,2741,24867,16405,0,41272,4.74891e+18,1299.89,8130.41,41272,557,471,38531,38271,37536,37310,36787
37271,3827,3852,37271,0,33180,4091,1.62729e+18,965.456,9084.23,37271,525,421,33419,33419,33419,33419,33393
30268,2400,2914,17841,12427,0,30268,4.91403e+18,855.711,7202.84,30268,388,560,27354,27336,27174,27126,24381
37121,706,1777,0,37121,10189,26932,9.49863e+15,924.561,6089.54,37121,458,372,34708,33653,31608,31830,19781
6325,13,27,6189,136,6325,0,9.85721e+13,14.6713,261.389,6325,18,18,6281,6250,5661,5551,4712
29248,1513,2168,0,29248,8594,20654,9.37983e+15,572.476,6028.74,29248,382,388,27080,26902,26588,26517,20491
36301,1892,2970,21172,15129,21172,15129,1.85446e+18,1224.43,7694.15,36301,503,559,33331,32311,30895,30781,25189
47294,1404,3614,0,47294,0,47294,2.43117e+18,1270.42,9670.4,47294,569,612,43410,42012,34677,29548,24857
13401,413,1828,8028,5373,0,13401,4.85692e+18,336.971,4046.95,13401,195,374,11363,10234,9586,9579,4666
26439,61,1954,8336,18103,0,26439,3.42371e+13,483.17,5591.67,26439,308,372,19040,15779,11629,5503,2400
43161,866,3479,25097,18064,25097,18064,1.80704e+18,1084.69,9258.5,43161,528,588,38641,37057,32443,32607,10442
32583,1637,2850,18214,14369,18214,14369,1.59358e+18,798.732,6976.11,32583,384,440,29733,28983,29034,28781,21383
40707,1352,2164,0,40707,11884,28823,8.84883e+15,618.836,6774.57,40707,432,431,38543,38309,37064,37163,27166
26485,683,2613,0,26485,0,26485,2.22901e+18,735.824,6308.93,26485,410,386,23054,21632,19962,17513,9706
32228,34,38,31227,1001,32228,0,9.89025e+13,18.5586,598.482,32228,23,24,32190,32190,31955,31955,31278
1169,92,157,1169,0,1169,0,3.31083e+18,92.1779,386.818,1169,54,54,954,665,746,768,623
49024,1197,4455,0,49024,0,49024,2.42348e+18,807.396,10570.6,49024,410,657,44569,43470,38027,31765,24720
42016,6,88,41308,708,42016,0,1.06592e+14,20.8774,864.379,42016,33,30,40596,39776,34090,34137,19808
21263,1794,2060,0,21263,0,21263,2.04151e+18,696.259,5125.08,21263,315,435,19203,18951,19003,18926,18399
5659,242,745,0,5659,1798,3861,8.93353e+15,190.391,1701.95,5659,130,178,4895,4625,4283,4372,2007
27384,241,3414,24325,3059,16431,10953,1.99749e+18,810.998,7577.02,27384,452,369,19903,16050,8676,7499,3723
23882,199,268,0,23882,23558,324,2.60026e+16,118.073,1692.18,23882,95,98,23614,23587,23018,22857,20819
11601,71,223,0,11601,11437,164,2.65721e+16,91.4069,1085.09,11601,64,71,11289,10994,9900,9449,6379
14643,739,1215,4616,10027,0,14643,3.01138e+13,316.703,3111.49,14643,270,205,13428,13344,12524,12642,9591
15071,1379,2456,15071,0,13518,1553,1.31825e+18,397.474,4784.33,15071,283,288,12615,12512,11862,11560,7165
45689,269,281,0,45689,44837,852,2.58382e+16,153.697,2297.59,45689,111,116,45408,45408,45405,45404,45286
6282,1307,1403,6282,0,5529,753,2.01279e+18,280.299,2477.05,6282,162,209,4879,4879,4872,4875,4836
18205,225,2930,10544,7661,0,18205,4.63703e+18,396.159,5766.36,18205,368,308,14161,12258,8681,7427,1972
18973,1586,2252,11116,7857,0,18973,4.96625e+18,479.202,4970.93,18973,411,260,16721,16625,16443,16435,14992
43013,1152,1889,12386,30627,0,43013,3.66092e+13,639.726,6344.6,43013,436,330,41124,40991,38599,38738,28749
29368,68,1845,8544,20824,0,29368,3.66971e+13,459.896,5410.19,29368,453,258,21998,18698,14703,8731,4307
511,20,155,0,511,177,334,9.59961e+15,27.1879,246.072,511,35,53,310,232,204,211,85
26398,46,63,25888,510,26373,25,1.03653e+14,18.2623,625.284,26398,27,27,26335,26335,25844,25844,24661
45339,629,2434,14488,30851,0,45339,3.49794e+13,950.746,7626.95,45339,562,528,41981,40345,30385,29552,16058
11668,413,2090,6927,4741,6927,4741,1.82205e+18,328.29,3961.24,11668,272,248,9535,8760,6523,5927,2661
7967,69,1092,7056,911,4929,3038,1.92287e+18,496.461,2507.88,7967,220,212,4130,2653,1676,1590,664
40853,435,2216,0,40853,11933,28920,9.359e+15,755.089,6980.67,40853,443,437,37473,35780,29702,30179,13577
8632,56,1354,7738,894,5402,3230,1.91613e+18,471.263,2827.29,8632,209,202,4483,2996,1896,1643,582
49093,836,1931,14377,34716,0,49093,3.72639e+13,1090.71,7346.55,49093,589,424,46226,44476,40743,41102,28786
31613,1472,2303,9522,22091,0,31613,3.67323e+13,595.199,6315,31613,396,449,29310,28940,28560,28539,22804
2806,4,24,2754,52,2806,0,1.14657e+14,11.5994,165.836,2806,16,16,2551,2402,2177,2208,1348
41278,2086,3287,24080,17198,24080,17198,1.74686e+18,1277.76,8674.68,41278,472,420,37991,37266,36345,36216,28685
19373,1261,1494,5494,13879,0,19373,3.66915e+13,426.466,4039.57,19373,367,225,17879,17823,17491,17514,16996
30831,2023,2147,0,30831,9469,21362,8.89997e+15,472.158,6099.43,30831,327,356,28684,28684,28684,28684,28013
13423,897,1744,12152,1271,7477,5946,1.8513e+18,295.614,3615.51,13423,227,271,11679,11478,6908,6467,7412
6977,329,836,0,6977,2310,4667,7.66898e+15,125.048,1875.06,6977,140,180,6141,6001,5807,5852,4002
31902,1186,1975,0,31902,9033,22869,9.44466e+15,593.189,5924.65,31902,369,387,29927,29567,29421,29367,22530
5745,225,1221,0,5745,0,5745,2.20767e+18,172.582,2163.76,5745,217,155,4500,4083,2906,2547,817
34554,2190,3700,30907,3647,20976,13578,1.98536e+18,1281.13,8518.83,34554,447,388,30854,29990,27398,26897,24444
7513,310,1448,4530,2983,0,7513,4.95796e+18,272.072,2636.37,7513,242,159,5858,4866,3298,3184,2067
37752,2211,3975,37748,4,33393,4359,2.44053e+18,1180.63,9363.48,37752,460,539,33777,33043,30301,29705,27188
12633,585,1039,3886,8747,0,12633,3.20102e+13,254.717,2674.08,12633,198,263,11594,11479,11220,11212,7298
33594,46,948,33594,0,33594,0,4.49554e+18,345.687,3548.14,33594,211,213,22956,15667,10430,9866,3257
32866,1415,3372,20000,12866,0,32866,4.86207e+18,812.83,7712.96,32866,410,409,29494,28726,22388,21601,13942
10968,454,1090,3190,7778,0,10968,3.7883e+13,423.319,2740.67,10968,226,229,9603,9031,8902,8958,5999
26057,273,284,0,26057,25664,393,2.71036e+16,126.997,1858.21,26057,97,113,25773,25773,25766,25749,25700
44575,2677,4783,40020,4555,26736,17839,2.00842e+18,1029.11,10947.8,44575,532,673,39792,39382,37850,38115,23859
36805,1410,3253,21937,14868,21937,14868,1.89709e+18,1077.98,8230.46,36805,465,509,33325,32357,31154,31458,15192
29354,1,50,28557,797,29336,18,1.03753e+14,18.1895,644.598,29354,26,23,12267,12267,12267,12267,12267
39656,2238,3435,0,39656,0,39656,2.37324e+18,1001.95,8623.16,39656,509,424,36221,35693,35082,34441,28904
46178,412,928,46178,0,46178,0,4.10441e+18,367.314,4138.11,46178,235,222,45250,44896,34277,34187,30555
43934,749,2950,0,43934,0,43934,2.20197e+18,1159.77,8504.89,43934,467,565,39133,36101,24795,17615,13614
37293,1312,2194,10855,26438,0,37293,3.63264e+13,672.274,6657.22,37293,463,400,35099,34651,34223,34213,27253
44144,2667,3284,0,44144,0,44144,2.26922e+18,1481.01,8698.03,44144,457,580,40860,39887,40063,39510,32448
39581,3051,5432,35330,4251,23834,15747,2.00791e+18,948.272,11303.5,39581,507,657,34149,34082,32239,32580,20909
6744,415,748,2162,4582,0,6744,3.62121e+13,346.734,1875.76,6744,208,204,5884,5495,5165,5192,4327
36193,1982,2225,21646,14547,0,36193,4.85321e+18,872.905,6621.03,36193,401,386,33968,33964,33580,33470,32794
49881,2907,3153,30148,19733,0,49881,4.91723e+18,1254.99,9229.73,49881,545,443,46728,46728,46631,46592,46006
37496,49,333,0,37496,36909,587,2.58571e+16,132.051,2265.74,37496,102,102,36212,35192,29532,25903,18121
4289,51,547,0,4289,1381,2908,9.08193e+15,254.819,1271.84,4289,142,148,2933,2388,1681,1813,557
39611,30,44,38860,751,39611,0,9.9356e+13,19.3818,664.79,39611,23,26,39567,39567,38685,38686,35202
31257,56,749,31257,0,31257,0,4.39122e+18,366.801,3290.35,31257,199,193,22842,15830,10857,10039,3485
44681,2318,3239,26380,18301,0,44681,4.67134e+18,1274.29,8703.67,44681,428,532,41442,41085,40809,40706,36318
1479,400,580,1479,0,1284,195,3.01355e+18,70.9148,837.377,1479,83,109,899,897,781,735,646
6961,398,1404,0,6961,0,6961,2.40653e+18,285.978,2602.87,6961,248,277,5520,4987,4367,4163,1729
15169,177,636,15169,0,15169,0,4.17151e+18,257.44,2157.42,15169,152,155,13782,12145,8907,8183,6117
23055,1463,3139,20772,2283,14206,8849,1.95237e+18,617.991,6674.04,23055,394,414,19916,19754,17550,17346,12121
44941,1606,2522,13743,31198,0,44941,3.63716e+13,724.064,7708.05,44941,477,437,42419,42258,40241,40289,35812
29060,1022,2967,17093,11967,17093,11967,1.8072e+18,589.727,7072.9,29060,414,358,26093,25626,21759,20428,13066
21966,259,791,21966,0,21966,0,4.44196e+18,312.048,2850.28,21966,172,179,20874,19744,14025,13535,11179
48254,3111,3394,28285,19969,28285,19969,1.77258e+18,1245.74,9239.39,48254,465,480,44860,44789,44687,44778,43228
4576,702,829,0,4576,1212,3364,1.05432e+16,140.633,1540.2,4576,150,132,3747,3747,3747,3743,3443
33757,891,1066,33757,0,33757,0,4.2585e+18,391.102,3824.53,33757,220,232,32691,32680,31993,32004,31783
3210,196,827,0,3210,0,3210,2.40535e+18,237.236,1403.66,3210,129,161,2211,1808,1493,1182,872
26454,1050,1802,8106,18348,0,26454,3.56441e+13,532.808,5253.68,26454,371,331,24652,24531,23276,23368,18702
49605,43251,49605,49605,0,0,49605,15.9997,0,49605,49605,49605,1,0,0,0,0,0
24206,1376,2653,21346,2860,14830,9376,1.98236e+18,751.352,6326.42,24206,315,443,21553,21007,19571,19665,15954
44707,904,2876,27102,17605,0,44707,4.73809e+18,1073.92,8419.21,44707,451,399,40894,37194,27848,26217,15312
7902,1138,1955,6977,925,4726,3176,2.035e+18,294.548,3326.45,7902,273,249,5947,5816,5329,5082,4070
29721,3284,3794,29721,0,26656,3065,2.28667e+18,861.141,8257.06,29721,434,537,25927,25927,25750,25557,24878
40168,398,3679,23693,16475,0,40168,4.89563e+18,1021.52,8969.46,40168,510,476,33980,30039,22724,20629,7516
13187,615,1071,3776,9411,0,13187,3.77264e+13,414.906,2852.33,13187,258,236,12116,11842,11659,11653,9373
23383,1025,2595,13796,9587,13796,9587,1.76181e+18,612.185,5820.34,23383,302,366,20788,20220,19638,19744,10218
24721,132,284,0,24721,24323,398,2.63997e+16,117.482,1914.92,24721,86,97,24407,24296,22059,22321,16841
4802,188,563,1519,3283,0,4802,3.32025e+13,269.621,1368.34,4802,190,166,3883,3334,3101,3067,2085
5431,71,430,5431,0,5431,0,5.00688e+18,213.008,1228.7,5431,110,97,4189,3106,2025,1642,1087
19585,8,42,19163,422,19585,0,1.01639e+14,17.4112,486.322,19585,23,22,19291,19154,16929,16516,9547
47561,742,3776,26599,20962,26599,20962,1.57585e+18,1019,9474.42,47561,534,473,42503,40329,32790,31567,15738
43540,1894,3449,38328,5212,26411,17129,1.96701e+18,1481.58,9091.86,43540,519,574,39954,38528,33606,33065,31249
5468,796,866,0,5468,1590,3878,9.89754e+15,249.462,1712.51,5468,175,151,4602,4600,4590,4587,4513
33074,1504,3714,29697,3377,19650,13424,1.96452e+18,932.138,8589.36,33074,441,478,29360,28584,23741,22810,12813
44186,1314,3012,27003,17183,0,44186,4.97608e+18,948.717,8414.47,44186,496,559,41105,40264,36559,35707,16315
7340,885,915,0,7340,2204,5136,9.30291e+15,271.508,2079.4,7340,208,223,6425,6425,6424,6425,6404
13219,176,1766,13219,0,11892,1327,1.59186e+18,284.757,3536.57,13219,241,198,10931,9245,3631,3193,2364
15389,2141,2594,9315,6074,0,15389,4.6057e+18,710.783,5144.4,15389,387,466,12795,12793,12620,12561,12056
46054,1463,1727,13220,32834,0,46054,3.72657e+13,906.345,6460.2,46054,435,360,44327,44013,44071,44055,41478
15010,1576,1634,0,15010,0,15010,2.07857e+18,351.816,3843.13,15010,244,279,13376,13376,13376,13376,13315
44657,271,3624,0,44657,0,44657,2.34777e+18,1000.86,9185.21,44657,480,677,35650,29283,20479,16130,2994
4363,401,877,3822,541,2765,1598,1.95829e+18,437.19,1715.58,4363,167,175,3157,2544,2518,2537,2045
33945,45,74,33374,571,33945,0,1.04928e+14,19.2194,701.591,33945,28,29,33871,33871,32787,32788,28821
21477,130,1503,6821,14656,0,21477,3.39085e+13,389.313,4174.96,21477,320,284,18219,16358,11982,9193,5195
31340,760,847,31340,0,31340,0,4.32714e+18,336.953,3405.92,31340,196,204,30493,30488,30132,30170,30094
21881,332,3082,19326,2555,13247,8634,1.9433e+18,812.219,6583.19,21881,309,409,16279,13044,7465,6655,3363
2050,468,561,1214,836,0,2050,3.05971e+18,105.36,946.926,2050,149,69,1489,1488,1369,1344,1278
35699,1503,2203,10912,24787,0,35699,3.65066e+13,535.027,6230.94,35699,372,348,33496,33428,33074,33114,29513
16699,1185,1413,4568,12131,0,16699,3.61941e+13,361.141,3684.09,16699,264,253,15286,15193,15240,15237,13668
14791,3,38,14447,344,14791,0,9.73966e+13,16.514,409.669,14791,22,22,12404,11135,10700,10472,7235
9495,256,1781,8522,973,5860,3635,1.9852e+18,388.524,3375.69,9495,272,194,6792,5320,3725,3460,2539
35670,2206,2998,22046,13624,0,35670,4.93252e+18,695.334,7470.71,35670,412,415,32672,32663,31605,31488,28874
31960,2035,2351,0,31960,0,31960,2.00314e+18,810.035,6106.8,31960,408,308,29609,29407,29332,29251,27818
9997,13,33,9873,124,9997,0,1.03586e+14,16.1094,372.173,9997,22,22,9929,9890,9009,8980,7414
10007,713,1478,6038,3969,0,10007,4.75127e+18,356.157,3062.89,10007,202,239,8529,8238,8002,7971,5695
6018,641,893,1726,4292,0,6018,3.78716e+13,249.923,1870.28,6018,185,191,5125,5045,5066,5058,4368
44719,2606,4758,44719,0,40075,4644,2.89723e+18,1275.97,11167.6,44719,528,565,39961,39269,38561,38195,26399
15200,241,1442,4845,10355,0,15200,3.57448e+13,328.468,3599.51,15200,239,290,13253,11715,7279,7123,3259
42869,263,322,0,42869,41876,993,2.58671e+16,159.458,2316.02,42869,108,123,42547,42528,41406,41241,39436
9984,715,1501,8991,993,5283,4701,1.86601e+18,217.511,2961.5,9984,230,260,8483,8336,4819,5009,5567
36418,1332,2259,0,36418,11199,25219,8.69915e+15,486.569,6706.49,36418,373,404,34159,34049,33208,33126,22991
14052,97,183,0,14052,13857,195,2.5332e+16,112.378,1032.97,14052,69,69,13778,13571,12628,12793,10750
22993,831,1802,12777,10216,0,22993,4.29711e+18,521.092,4680.96,22993,250,371,21191,20226,20146,19931,14885
26984,49,70,26561,423,26984,0,1.00703e+14,20.0195,648.308,26984,26,29,26914,26909,26202,26202,23062
25335,587,1824,0,25335,7317,18018,9.47373e+15,502.14,4987.24,25335,362,330,23393,22767,20873,20951,12684
49897,3158,3584,0,49897,0,49897,2.27136e+18,1127.72,9856.57,49897,455,522,46313,46242,46113,46263,43959
9123,177,1110,2408,6715,0,9123,3.92066e+13,316.136,2485.22,9123,228,238,7479,6753,6242,6415,1864
2579,242,468,0,2579,823,1756,8.80304e+15,89.6879,931.378,2579,99,110,2111,2069,2031,2045,1306
15280,3,222,0,15280,15001,279,2.57908e+16,94.6937,1234.8,15280,71,76,10293,8644,7810,7123,5211
25737,55,1978,7666,18071,0,25737,3.65235e+13,502.818,5251.82,25737,395,308,18608,15506,11785,4515,2558
12949,1362,2287,0,12949,0,12949,2.43859e+18,373.819,4362.18,12949,290,374,10662,10546,10218,10388,6579
49118,192,4698,49089,29,43865,5253,9.99859e+17,1137.19,11191.4,49118,510,489,35110,26290,23169,21487,2454
27175,655,844,27052,123,27175,0,4.18722e+18,341.597,3232.43,27175,198,200,26331,26285,25695,25584,25691
44227,187,1686,0,44227,13548,30679,8.19727e+15,1006.58,6129.83,44227,435,359,39155,36509,21780,18788,7083
24670,29,36,24306,364,24670,0,1.01203e+14,16.7048,510.747,24670,21,23,24634,24634,24181,24180,23309
37698,1273,3315,22139,15559,22139,15559,1.8169e+18,1223.84,8548.32,37698,514,491,33568,32385,28914,28382,14450
10587,492,930,0,10587,2947,7640,9.35336e+15,273.404,2341.53,10587,195,209,9657,9541,9048,9109,6407
11970,190,209,0,11970,11833,137,2.69509e+16,96.0202,1085.83,11970,72,71,11761,11760,11703,11627,11263
8244,800,1561,0,8244,0,8244,2.50112e+18,393.959,2868.88,8244,205,225,6683,6254,6393,6360,4455
27551,604,2041,0,27551,8450,19101,9.18531e+15,502.882,5645.84,27551,393,349,25430,24872,19571,19472,12479
11593,11,40,11315,278,11593,0,1.03359e+14,16.9279,390.302,11593,22,21,11492,11421,10252,10069,6738
8367,29,185,0,8367,8235,132,2.81961e+16,74.2154,858.905,8367,53,65,7908,7698,6470,5632,3453
3292,325,722,1929,1363,0,3292,4.69812e+18,284.867,1343.06,3292,125,151,2479,2233,2051,2069,1449
1546,10,80,0,1546,1526,20,2.12538e+16,25.718,244.568,1546,32,30,1344,1100,1136,1112,782
11126,119,199,0,11126,10890,236,2.55758e+16,86.7435,1029.43,11126,71,71,10925,10875,10095,9958,8993
46568,1287,2113,0,46568,14478,32090,9.14918e+15,789.351,7051.05,46568,428,398,44455,44182,42270,42265,36847
48061,85,94,47138,923,48030,31,1.02796e+14,22.6378,925.098,48061,30,35,47967,47967,47643,47643,47202
32207,870,1592,9621,22586,0,32207,3.58868e+13,679.834,5215,32207,358,356,30509,30089,28308,28365,21546
49594,299,853,49594,0,49594,0,4.25883e+18,363.754,4128.28,49594,241,231,48381,47112,34532,33829,29244
49849,1403,1632,0,49849,15051,34798,8.38419e+15,837.839,6343.99,49849,386,341,48217,48212,48158,48142,47629
37518,1714,1898,0,37518,11582,25936,9.09274e+15,742.736,6014.59,37518,387,340,35620,35615,35483,35488,34923
16111,25,58,15813,298,16111,0,1.01367e+14,16.4168,508.302,16111,26,23,16053,16045,15146,15078,11868
38781,1983,4252,38781,0,34403,4378,2.64915e+18,1096.88,9641.97,38781,418,483,34529,33906,31396,29235,23996
25112,1661,1773,7308,17804,0,25112,3.62888e+13,625.585,4872.28,25112,282,294,23339,23339,23322,23321,23088
43677,338,2804,0,43677,0,43677,2.39898e+18,1235.87,8191.73,43677,483,461,36189,30929,23727,17642,7637
1073,149,514,1073,0,957,116,1.67717e+18,61.1128,695.809,1073,107,62,559,498,283,268,142
2711,116,117,0,2711,2648,63,2.74835e+16,44.2984,402.605,2711,38,41,2594,2594,2594,2594,2592
14234,840,2745,8519,5715,8519,5715,1.89322e+18,378.897,5016.18,14234,376,371,11489,11080,9459,9710,4373
2622,649,809,2622,0,2333,289,2.52579e+18,269.141,1291.79,2622,145,112,1813,1647,1791,1789,1698
5421,973,1589,4703,718,3175,2246,2.0402e+18,301.53,2551.74,5421,172,279,3832,3681,3455,3487,2968
7771,142,398,7771,0,7771,0,4.26509e+18,216.966,1410.23,7771,119,120,6900,5981,4897,4855,3625
27047,1530,2831,0,27047,0,27047,2.36985e+18,572.214,6786.94,27047,341,407,24216,23771,22615,21352,14932
35555,311,3089,21302,14253,0,35555,4.62587e+18,673.795,7385.64,35555,351,418,30064,25104,16740,13883,6068
8781,940,1384,0,8781,0,8781,2.24924e+18,295.445,2824.74,8781,268,194,7397,7391,6852,6385,6423
39712,434,632,39712,0,39712,0,4.1122e+18,337.767,3473.59,39712,216,210,39080,38997,35475,35498,34889
25041,1112,3295,25041,0,22242,2799,1.78431e+18,641.933,7157.95,25041,371,388,21746,20668,15422,13939,9725
18110,1300,2095,16169,1941,10244,7866,1.90988e+18,393.838,4642.42,18110,266,219,16015,15979,14751,14544,12120
4882,593,785,1340,3542,0,4882,3.829e+13,248.424,1601.47,4882,186,152,4097,3940,3873,3882,3523
19520,515,1899,11204,8316,11204,8316,1.92237e+18,830.194,4824.31,19520,336,402,16466,14704,12623,12945,5535
19608,337,1987,11865,7743,11865,7743,1.94172e+18,847.478,4850.09,19608,378,340,15721,13590,11226,10787,4868
22414,715,818,22414,0,22414,0,4.11907e+18,286.257,2871.87,22414,178,176,21596,21592,21390,21372,21174
35382,823,1735,10243,25139,0,35382,3.65798e+13,720.007,5688.46,35382,435,317,33481,32707,29641,29930,19977
46949,1102,2295,0,46949,15199,31750,8.98513e+15,588.909,6759.42,46949,401,396,44654,44242,42472,42622,35024
43812,9,76,42546,1266,43812,0,1.04419e+14,18.8813,806.021,43812,30,30,43331,43065,38195,37581,22011
42684,1449,4068,38075,4609,25377,17307,1.9675e+18,1082.74,10132.3,42684,549,416,38317,36633,27979,26841,20891
30207,931,1001,30207,0,30207,0,4.01408e+18,347.377,3530.3,30207,208,209,29206,29203,29123,29144,28993
42671,1247,2291,12069,30602,0,42671,3.75421e+13,783.91,7436.11,42671,399,511,40380,39570,38788,38777,29607
2795,193,222,1341,1454,0,2795,3.12899e+18,110.892,665.181,2795,83,78,2573,2573,2527,2528,2494
21761,206,2642,12458,9303,12458,9303,1.71419e+18,455.914,5723.23,21761,229,386,17890,16326,12403,8967,2205
16936,436,2791,0,16936,0,16936,2.43257e+18,427.719,5521.87,16936,281,410,13924,12654,9312,7744,3728
48149,1,79,47263,886,48149,0,1.02333e+14,20.366,852.554,48149,28,31,19579,19579,19579,19579,19579
42807,479,2486,12991,29816,0,42807,3.5868e+13,700.699,7103.31,42807,440,441,39485,37443,27730,27690,10828
3786,16,21,3699,87,3786,0,1.02524e+14,12.2277,188.752,3786,14,15,3764,3757,3535,3536,3394
38155,3147,3576,0,38155,0,38155,2.16115e+18,972.249,8683.6,38155,518,638,34579,34547,34336,34253,33375
29900,2501,2952,29900,0,26811,3089,1.35527e+18,737.405,7076.87,29900,418,412,26948,26941,26858,26819,25913
14093,1124,2260,12594,1499,8616,5477,1.93828e+18,607.905,4525.74,14093,351,269,11833,11255,10797,10812,8493
43829,848,957,43829,0,43829,0,4.37119e+18,384.311,4147.87,43829,227,233,42872,42862,42227,42259,42127
10557,222,493,10557,0,10557,0,3.81913e+18,249.155,1715.25,10557,130,130,9905,9163,7135,6897,6335
26492,131,265,0,26492,26072,420,2.68353e+16,137.527,1800.25,26492,95,105,26164,25995,23798,23057,18575
32666,2492,2746,32666,0,29088,3578,2.37102e+18,1227.65,7253.41,32666,452,354,29920,29359,29805,29834,28308
43457,3419,5210,37327,6130,25506,17951,1.99329e+18,1044.09,11571.8,43457,517,589,38247,38044,35000,34970,26530
43914,2911,3570,25994,17920,0,43914,5.00673e+18,1222.81,9451.06,43914,529,574,40344,39998,39793,39754,36413
17959,2860,3571,17959,0,16024,1935,2.66332e+18,638.653,6436.94,17959,367,366,14388,14295,14285,14256,13080
29405,116,267,0,29405,28781,624,2.63995e+16,127.925,1806.26,29405,95,98,29054,28784,26563,26273,21464
14717,54,1763,0,14717,0,14717,2.37178e+18,409.013,3989.57,14717,286,255,9183,6939,5332,4832,702
35732,2140,2839,0,35732,0,35732,2.36377e+18,820.229,7497.03,35732,540,372,32893,32867,31355,30170,27544
21377,735,1589,12777,8600,0,21377,5.12694e+18,720.904,4504.1,21377,314,319,19394,18241,17935,17835,13443
37346,43,50,36584,762,37346,0,9.96312e+13,19.4717,669.115,37346,27,24,37296,37296,37075,37076,36318
8572,16,34,8448,124,8572,0,1.03567e+14,13.5035,313.294,8572,17,20,8537,8524,7811,7782,5785
695,189,223,211,484,0,695,3.96915e+13,29.4403,333.365,695,40,52,472,472,472,472,419
39844,636,1010,39844,0,39844,0,4.11219e+18,325.702,3881.55,39844,226,209,38834,38804,36930,36973,35249
2033,577,702,1239,794,1239,794,1.81736e+18,107.584,1062.03,2033,105,132,1331,1331,1310,1311,1220
1494,241,426,874,620,0,1494,4.74831e+18,151.568,691.144,1494,83,97,1068,880,840,851,861
37602,315,322,0,37602,36905,697,2.62786e+16,138.991,2334.03,37602,103,112,37280,37279,37279,37280,37133
18269,25,29,18042,227,18269,0,1.00856e+14,18.4981,437.519,18269,19,22,18240,18240,18037,18037,17868
43728,2922,4806,43728,0,39080,4648,2.71186e+18,1212.72,10757.4,43728,573,494,38922,38417,37732,37082,32144
44768,1912,2724,27482,17286,27482,17286,1.87119e+18,1104.11,7702.67,44768,474,379,42044,41042,41332,41520,37169
18449,75,2147,11182,7267,0,18449,4.90417e+18,721.138,4951.42,18449,372,364,11721,8643,6223,5172,690
27450,1549,2532,0,27450,0,27450,2.2916e+18,853.409,6432.06,27450,448,417,24918,24641,24216,23739,21052
2845,248,317,0,2845,839,2006,6.78746e+15,97.2696,763.156,2845,86,80,2528,2527,2517,2518,2429
39056,2902,4637,39056,0,34824,4232,2.65818e+18,1184.23,10232.8,39056,480,472,34419,34114,31449,30240,24966
35897,18,724,35897,0,35897,0,4.14885e+18,337.846,3417.02,35897,204,199,18542,8796,7020,6799,1902
19496,451,2032,19496,0,17561,1935,2.40792e+18,1077.59,4989.89,19496,357,290,15633,13635,12093,10622,6076
20160,1148,1463,5658,14502,0,20160,3.78689e+13,710.916,4138.93,20160,370,355,18697,18124,18166,18169,17399
42125,696,2271,12840,29285,0,42125,3.44444e+13,679.01,7147.73,42125,409,420,39512,38444,34423,34439,19001
44870,513,2971,27203,17667,27203,17667,1.87465e+18,1174.8,8352.28,44870,445,456,39359,34599,29578,28491,10366
47508,76,141,46572,936,47107,401,9.76112e+13,18.9124,1077.42,47508,35,33,47367,47367,46014,46020,35808
18445,885,3180,16561,1884,10925,7520,1.98116e+18,525.869,6152.83,18445,353,509,15245,14742,12740,12712,5297
7553,102,160,0,7553,7356,197,2.4032e+16,73.3667,711.067,7553,58,61,7393,7346,6953,7070,6318
19889,515,2076,19889,0,18070,1819,2.09203e+18,958.723,4819.38,19889,318,273,16890,15867,8015,6925,6991
29641,187,288,0,29641,29225,416,2.65394e+16,114.059,1977.56,29641,87,97,29353,29305,28067,27829,25111
46022,85,866,46022,0,46001,21,4.19401e+18,361.228,4015.35,46022,217,226,37873,28636,20343,18288,7992
15939,39,218,0,15939,15718,221,2.50139e+16,102.836,1290.12,15939,74,85,15315,14922,12672,11632,7162
17585,426,668,17585,0,17585,0,4.2348e+18,274.966,2359.08,17585,165,172,16917,16908,14827,14695,14842
23236,982,1541,7059,16177,0,23236,3.49828e+13,432.536,4522.93,23236,300,301,21695,21654,21277,21304,17203
15015,472,987,9291,5724,0,15015,4.86058e+18,563.533,3088.84,15015,263,239,13184,11176,11649,11480,8433
614,18,57,0,614,605,9,2.86353e+16,14.0814,133.773,614,22,21,555,540,468,468,313
14689,1291,1483,4606,10083,0,14689,3.46594e+13,282.467,3487.77,14689,257,238,13206,13151,13170,13163,12756
20066,849,1457,0,20066,5853,14213,9.27009e+15,449.567,3976.93,20066,361,295,18609,18511,17301,17394,15025
11397,1372,1938,6748,4649,0,11397,5.02614e+18,419.524,3795.37,11397,265,303,9459,9312,9138,9155,7112
26296,1782,2707,23118,3178,16008,10288,1.91446e+18,935.118,6517.83,26296,360,461,23589,23332,21817,21862,21469
9177,67,1223,5386,3791,0,9177,4.63507e+18,402.47,2717.75,9177,209,210,5730,4078,2920,2356,563
47326,2650,3303,27946,19380,0,47326,4.66373e+18,1139.55,9219.03,47326,469,530,44023,44015,43824,43845,42048
2238,42,719,0,2238,0,2238,2.22228e+18,123.601,1100.3,2238,144,117,1219,807,636,472,180
15516,894,1358,4601,10915,0,15516,3.51819e+13,361.401,3507.03,15516,371,210,14158,14084,13349,13393,11877
11372,661,1037,0,11372,3426,7946,8.12351e+15,221.112,2550.04,11372,216,211,10335,10187,9572,9617,8010
4838,952,974,0,4838,0,4838,2.40071e+18,296.012,1823.36,4838,147,212,3864,3844,3857,3864,3854
32381,308,4922,32381,0,29094,3287,2.00406e+18,802.317,9961.48,32381,574,508,24774,21038,12911,12106,1740
47988,1819,2355,0,47988,14727,33261,8.83439e+15,941.053,7927.21,47988,466,498,45633,45253,44180,44305,41766
22312,450,919,22282,30,22312,0,4.07804e+18,327.82,3055.47,22312,190,200,21393,21199,18589,18358,16838
41554,432,3514,23736,17818,23736,17818,1.73674e+18,1160.16,8844.43,41554,476,504,35971,33397,23615,22108,6931
3294,481,1038,3294,0,2918,376,2.00231e+18,138.284,1624.51,3294,109,164,2256,2156,2039,2095,1627
47325,1834,2381,14584,32741,0,47325,3.57907e+13,791.624,7519.17,47325,463,496,44944,44942,43313,43338,39900
20372,530,1416,0,20372,6479,13893,8.6141e+15,477.755,3981.65,20372,294,335,18775,17926,16265,16471,7737
32898,73,1536,0,32898,9641,23257,9.29054e+15,723.349,5184.78,32898,372,343,24645,20891,16433,14786,3403
31982,396,2880,18773,13209,18773,13209,1.73824e+18,885.444,7248.06,31982,421,487,26727,24017,18481,14378,3391
17741,1480,1979,10352,7389,0,17741,4.79092e+18,773.836,4656.03,17741,365,341,15762,15191,15359,15324,14199
13107,12,44,12906,201,13107,0,9.72828e+13,13.9766,404.535,13107,20,23,13025,12965,11482,11372,7537
1169,19,91,0,1169,1153,16,2.49028e+16,20.3952,229.547,1169,37,27,1054,1012,953,949,681
15077,5,28,14833,244,15071,6,1.02307e+14,16.1252,419.123,15077,19,18,14358,13739,12377,12719,9405
41799,53,61,40977,822,41749,50,9.91653e+13,18.6757,767.146,41799,27,27,41738,41738,41254,41255,40080
19619,111,2466,19619,0,17490,2129,1.29727e+18,741.261,5431.39,19619,364,358,12222,8911,5883,5337,1181
39067,188,808,39031,36,39067,0,3.9703e+18,364.434,3686.42,39067,223,215,36693,33847,22205,20288,13963
41706,2778,4850,41706,0,37143,4563,2.51681e+18,1121.64,10717.8,41706,525,659,36856,36481,33180,31820,24935
47119,474,2855,0,47119,0,47119,2.40521e+18,1077.3,8549.14,47119,531,406,41645,38737,30440,27100,10529
35106,920,3262,35106,0,30557,4549,1.83977e+18,874.711,8095.29,35106,362,635,31449,27846,23739,22766,20417
28266,1593,1768,0,28266,26499,1767,0.0625133,0.937451,7068.45,28266,1768,1,26498,26498,26498,26498,26498
23750,3,56,23351,399,23750,0,1.06344e+14,20.5135,571.097,23750,24,27,19739,17744,17046,16593,9395
37109,73,76,36444,665,37109,0,1.0698e+14,18.5238,779.945,37109,28,29,37033,37033,36825,36825,36960
27915,1901,2939,15838,12077,0,27915,4.42249e+18,655.187,6819.9,27915,469,437,24976,24836,24360,24095,21414
21098,1519,2774,21098,0,18958,2140,2.37608e+18,910.622,6021.24,21098,466,344,18324,18073,17305,17237,10259
11034,105,173,0,11034,10814,220,2.77743e+16,74.3695,990.109,11034,57,64,10861,10801,10198,10296,8900
15659,187,197,0,15659,15399,260,2.69889e+16,92.3895,1183.96,15659,73,80,15462,15462,15451,15442,15372
35378,2764,3137,20865,14513,20865,14513,1.80412e+18,899.364,7807.59,35378,440,462,32241,32053,32060,32123,31240
24538,10055,24538,24538,0,24538,0,68716700000,0,24538,24538,24538,1,0,0,0,0,0
49326,2033,4062,43691,5635,29263,20063,1.96925e+18,1745.57,10731.1,49326,627,472,44651,42194,35249,34497,29149
46917,224,277,0,46917,45902,1015,2.51681e+16,155.892,2189.28,46917,107,126,46640,46606,45229,44874,43652
6507,763,1538,6507,0,5853,654,2.18193e+18,394.164,2688.03,6507,229,216,4964,4291,4333,4062,3019
37181,2651,3198,22163,15018,0,37181,4.70747e+18,1062.33,8244.22,37181,465,525,33983,33966,33466,33340,32673
6473,3771,4096,6473,0,6473,0,7.35131e+15,1504.12,5080.59,6473,4008,2,2377,0,2377,2140,2377
24269,480,1232,7910,16359,0,24269,3.63498e+13,573.186,4137.19,24269,312,323,22226,20340,15324,15439,14238
34402,2564,3214,0,34402,0,34402,2.36584e+18,961.605,7912.68,34402,440,466,31188,31060,29983,29020,28045
14311,137,492,14311,0,14311,0,4.17609e+18,225.681,2010.25,14311,143,145,13047,11784,9182,8683,6928
4837,1135,1346,4382,455,2837,2000,2.0724e+18,222.427,2147.69,4837,180,167,3491,3489,3454,3461,3314
16990,1037,1396,0,16990,4915,12075,9.52875e+15,485.76,3718.25,16990,295,301,15594,15360,15412,15383,13520
17498,37,40,17091,407,17498,0,9.99755e+13,16.1586,456.573,17498,22,25,17458,17458,17399,17399,17225
2055,99,722,1332,723,0,2055,4.66948e+18,82.5251,1065.41,2055,161,89,1296,1068,762,705,267
37556,252,300,0,37556,36980,576,2.57889e+16,142.374,2166.68,37556,95,107,37256,37251,37087,36792,35694
37107,937,2744,0,37107,0,37107,2.39463e+18,967.845,7452.11,37107,535,377,33666,32009,29442,27617,19056
22032,805,1636,7277,14755,0,22032,3.2704e+13,396.616,4553.46,22032,239,337,20396,20222,19217,19215,12833
36030,213,800,36012,18,36020,10,4.04609e+18,346.54,3547.68,36030,218,207,34010,31392,22858,22245,16433
937,76,270,463,474,463,474,2.2893e+18,52.6638,421.88,937,60,55,661,596,522,419,228
10735,305,508,10735,0,10735,0,4.11411e+18,262.112,1784.66,10735,132,140,10205,9965,8824,8764,8060
1282,459,559,851,431,0,1282,4.32463e+18,66.8744,774.809,1282,129,82,723,717,718,719,644
25921,2214,3814,22833,3088,15273,10648,1.98272e+18,759.887,7772.8,25921,483,583,22107,21823,20631,20775,15793
21141,45,58,20805,336,21141,0,1.06487e+14,17.7778,565.334,21141,24,27,21083,21083,20531,20531,19032
3958,302,841,2443,1515,2443,1515,1.87447e+18,196.355,1497.27,3958,174,115,3117,2800,2762,2468,1245
36015,610,3410,21271,14744,21271,14744,1.80437e+18,811.011,8336.06,36015,486,603,31247,29125,24010,23250,10115
5178,124,935,3216,1962,3216,1962,1.77392e+18,301.557,1839.54,5178,169,198,3412,2738,2268,1899,701
38629,88,315,0,38629,37692,937,2.64865e+16,147.69,2214.52,38629,97,112,37931,37341,32247,29582,20691
28728,234,3271,0,28728,0,28728,2.25341e+18,663.021,7135.63,28728,297,516,23559,21326,12721,10654,3215
15881,1596,2218,15881,0,14196,1685,3.21848e+18,591.976,4664.63,15881,380,285,13663,13447,13491,13468,10954
48744,1799,2241,0,48744,14199,34545,9.418e+15,765.131,7336.46,48744,458,389,46503,46412,45959,45887,40966
43656,2338,3722,39019,4637,25518,18138,1.93725e+18,1290.14,9576.66,43656,468,546,39934,38980,36648,36429,30762
2047,101,477,587,1460,0,2047,4.25619e+13,61.3591,810.222,2047,126,89,1570,1462,1173,1167,611
4360,360,410,4360,0,4360,0,4.07013e+18,192.545,1102.44,4360,102,93,3950,3942,3900,3895,3790
26374,78,833,26374,0,26374,0,3.99326e+18,330.336,3150.39,26374,197,193,20431,14916,11045,10040,3433
23654,628,664,23654,0,23654,0,3.99057e+18,307.718,2794.25,23654,180,180,22990,22990,22938,22967,22960
42678,45,58,41664,1014,42678,0,1.01041e+14,18.4287,740.56,42678,25,27,42620,42620,41125,41126,37109
23511,1948,2817,23511,0,21271,2240,1.76837e+18,936.58,6141.48,23511,352,324,20694,19920,20280,19958,15490
32344,28447,32344,32344,0,32344,0,68717400000,0,32344,32344,32344,1,0,0,0,0,0
22250,106,2765,13503,8747,0,22250,5.00646e+18,597.111,6101.95,22250,471,420,15604,12920,9558,7265,2054
18245,507,605,18245,0,18245,0,4.1998e+18,265.219,2418.99,18245,168,159,17640,17626,17056,17079,16699
19570,1676,1749,11573,7997,11573,7997,1.8335e+18,714.322,4547.63,19570,324,379,17821,17821,17791,17799,17615
25098,128,706,25098,0,25098,0,3.99399e+18,347.009,2956.45,25098,203,194,21904,18877,12340,11449,7332
28435,10,48,27968,467,28435,0,1.00147e+14,18.0669,587.057,28435,25,23,28190,28015,24779,24621,14387
20317,1295,1514,0,20317,6167,14150,9.22138e+15,584.774,4237.73,20317,338,298,18803,18802,18576,18610,18078
41132,920,2679,12582,28550,0,41132,3.49909e+13,966.978,7903.64,41132,507,535,37848,36930,33690,33657,17443
1280,66,95,0,1280,1257,23,2.5558e+16,32.232,260.877,1280,31,32,1185,1178,1119,1140,1030
18775,151,256,0,18775,18463,312,2.62977e+16,98.7399,1497.13,18775,77,89,18519,18482,17220,17448,14932
49223,832,2876,29206,20017,0,49223,4.74651e+18,1504.52,8909.77,49223,497,527,43599,40626,28927,26419,19004
30542,840,2598,18382,12160,18382,12160,1.75274e+18,829.812,6795.1,30542,363,492,27532,26403,24148,22806,13684
7888,628,1189,0,7888,2319,5569,9.18349e+15,224.298,2502.59,7888,304,172,6699,6622,6206,6171,4251
795,3,236,0,795,252,543,5.62811e+15,79.4503,396.751,795,89,52,111,57,44,40,18
23001,1889,3187,13900,9101,0,23001,4.98056e+18,449.119,6638.49,23001,282,410,19814,19754,19154,19231,13665
26930,73,921,26930,0,26930,0,3.99484e+18,350.153,3293.53,26930,203,194,20840,15036,10774,9680,3174
41399,33,82,40956,443,41399,0,1.02252e+14,19.6175,813.919,41399,28,30,41317,41311,38925,38756,29959
4999,459,817,0,4999,1492,3507,9.21426e+15,185.652,1670.04,4999,133,167,4182,4118,4033,4036,2946
49081,290,358,0,49081,48228,853,2.73514e+16,145.836,2685.61,49081,116,129,48723,48723,47262,47214,45340
26734,2733,3585,26734,0,24075,2659,2.45755e+18,605.969,7397.43,26734,365,427,23149,23088,22785,22881,19282
5717,436,686,3132,2585,0,5717,3.54821e+18,148.901,1509.66,5717,134,118,5031,5019,4960,4813,2104
6101,647,877,1759,4342,0,6101,3.63447e+13,238.676,1887.26,6101,194,168,5224,5195,5185,5187,4344
19391,1808,2256,0,19391,0,19391,2.35058e+18,550.544,5208.6,19391,339,376,17135,16947,16939,17030,15256
42604,78,79,41640,964,42604,0,1.00661e+14,19.0691,791.813,42604,27,28,42525,42525,42525,42525,42525
47312,685,3496,0,47312,0,47312,2.3561e+18,1040.11,9501.9,47312,531,617,41732,39541,32435,29273,12410
5230,176,180,0,5230,5140,90,2.55578e+16,63.2333,676.933,5230,52,56,5050,5050,5049,5049,5046
27642,1822,2503,0,27642,0,27642,2.364e+18,887.236,6196.89,27642,406,328,25139,24995,23925,22506,18315
5167,670,1123,0,5167,0,5167,2.36723e+18,169.991,2027.24,5167,194,158,4044,3995,3936,3920,3306
899,127,280,296,603,0,899,3.85198e+13,52.1635,429.36,899,63,75,619,579,573,571,450
18928,11,16,18864,64,18928,0,2.16081e+18,15.9865,550.316,18928,16,16,12610,0,7096,11820,12610
40487,51,79,39628,859,40487,0,1.02789e+14,21.7989,839.389,40487,28,31,40408,40404,39181,39209,35237
23736,254,260,0,23736,23257,479,2.66938e+16,119.331,1705.43,23736,88,109,23476,23476,23470,23440,23399
12351,389,465,12351,0,12351,0,4.26889e+18,273.22,1870.81,12351,144,141,11886,11860,11589,11585,11481
49143,22,82,48225,918,49129,14,1.04748e+14,23.1145,926.629,49143,32,29,49046,49020,44087,43579,30495
48403,3188,3244,28754,19649,28754,19649,1.91683e+18,1175.66,9326.14,48403,531,554,45159,45159,45142,45148,45115
36924,285,2412,0,36924,11238,25686,8.79721e+15,689.303,7021.06,36924,398,454,32923,30480,23114,21775,6579
6593,6,31,6477,116,6593,0,1.01652e+14,16.0895,277.19,6593,19,21,6375,6257,5479,5451,3641
34305,320,3082,30852,3453,20753,13552,1.96792e+18,1067.95,7792.29,34305,463,487,26528,21095,15634,14133,3281
31714,574,1990,0,31714,10216,21498,8.84193e+15,491.592,5859.84,31714,397,361,29598,28319,21396,21291,11972
42994,519,2501,12089,30905,0,42994,3.67546e+13,581.572,7799.36,42994,431,441,39919,38228,34579,34778,14843
3227,405,779,1952,1275,0,3227,5.03046e+18,223.27,1369.15,3227,117,147,2448,2133,2277,2296,1776
34248,512,1028,34248,0,34248,0,4.2571e+18,336.697,3704.4,34248,219,210,33220,33104,27683,27424,26357
15636,1044,1636,0,15636,0,15636,2.39819e+18,539.107,3946.62,15636,312,235,14000,13236,13236,12749,11354
38465,4841,4965,34433,4032,22582,15883,1.97582e+18,1375.6,10633,38465,537,646,33500,33500,33500,33500,33297
3916,552,1016,3916,0,3491,425,2.87879e+18,124.283,1661.93,3916,130,164,2900,2880,2459,2503,2039
35092,667,2607,0,35092,10853,24239,9.00007e+15,650.224,7228.97,35092,391,435,32143,30907,24856,25382,10410
21261,519,1864,0,21261,0,21261,2.02309e+18,649.062,4490.05,21261,302,284,18936,18124,16233,13214,7631
49718,2132,3374,28066,21652,0,49718,4.39205e+18,983.181,9160.38,49718,488,433,46344,46272,43596,42540,31474
32557,2599,2796,18686,13871,18686,13871,1.77174e+18,1141.31,7095.17,32557,415,403,29761,29761,29697,29694,29569
18132,1764,2166,16629,1503,10136,7996,1.91625e+18,618.958,4913.58,18132,347,327,15966,15944,15828,15861,15483
24873,162,692,24873,0,24873,0,4.43259e+18,302.334,2905.63,24873,181,187,22786,20388,13362,12834,8093
5053,774,892,5053,0,4642,411,1.92393e+18,143.073,1670.56,5053,151,116,4161,4158,3970,4049,3731
1610,3,16,1567,43,1610,0,1.02975e+14,8.98944,111.752,1610,11,12,1319,1155,1143,1135,864
34570,161,328,0,34570,34015,555,2.52525e+16,132.811,2289.35,34570,102,107,34235,34114,31808,31446,26183
49075,272,389,0,49075,48141,934,2.60186e+16,156.668,2813.4,49075,114,127,48686,48638,47339,46498,42726
21381,75,260,0,21381,20927,454,2.66177e+16,83.4667,1542.76,21381,80,90,21031,20415,18172,16783,11970
9495,1077,1540,5692,3803,5692,3803,1.9316e+18,454.121,3059.38,9495,221,227,7955,7670,7776,7794,6704
23679,11,52,23344,335,23679,0,9.95667e+13,17.7878,555.498,23679,25,26,23461,23284,21002,20541,14865
15475,198,219,0,15475,15190,285,2.62202e+16,88.4127,1282.11,15475,75,78,15256,15256,15199,15095,14875
30151,83,290,0,30151,29453,698,2.47808e+16,120.769,1878.77,30151,98,99,29615,28936,25557,23949,17401
29118,1648,2635,17091,12027,0,29118,4.43146e+18,967.11,6616.76,29118,421,396,26483,25614,23950,23857,20672
44161,313,325,0,44161,43475,686,2.64989e+16,149.244,2332.47,44161,100,120,43836,43836,43822,43789,43646
33908,191,1646,0,33908,10611,23297,8.20697e+15,663.257,5391.67,33908,347,338,29950,27945,19603,17462,7783
12405,299,1575,7304,5101,7304,5101,1.804e+18,579.477,3568.76,12405,221,282,9781,8582,7153,6667,2649
21894,64,235,0,21894,21496,398,2.70241e+16,89.3539,1401.12,21894,78,84,21389,20782,18949,17636,11556
47294,4065,5645,47294,0,42938,4356,2.12776e+18,1025.04,12234.3,47294,468,745,41649,41434,40648,40311,34141
26124,757,870,26124,0,26124,0,4.03157e+18,330.051,3184.68,26124,197,196,25254,25247,24882,24856,24801
38155,911,2144,0,38155,12127,26028,8.29451e+15,593.142,6653.53,38155,443,350,36011,35451,31329,31363,22316
23322,1178,2311,13902,9420,0,23322,4.81945e+18,771.926,5571.71,23322,342,320,21011,20526,18285,17914,14785
23402,1611,2405,13284,10118,13284,10118,1.67791e+18,562.147,5496.25,23402,378,326,20997,20871,20703,20711,18823
37559,763,3869,37559,0,33248,4311,2.78432e+18,1265.94,9352.46,37559,573,375,31982,29404,22658,18977,9108
5505,507,1238,5034,471,3179,2326,1.91986e+18,147.508,2177.65,5505,185,175,4267,4204,3610,3786,1995
46966,20,87,46292,674,46918,48,1.03071e+14,21.3887,947.023,46966,32,33,46856,46821,42782,42294,30141
40582,2235,3207,40582,0,36654,3928,2.49986e+18,1038.22,8508.18,40582,529,410,37375,37245,36686,36391,27175
31300,1180,1980,8899,22401,0,31300,3.75009e+13,659.207,5710.62,31300,367,391,29320,28807,28525,28577,20510
49725,1855,4147,30059,19666,30059,19666,1.83398e+18,1177.95,10544.8,49725,534,608,45479,44425,42734,42119,23865
27840,1636,2102,0,27840,7937,19903,9.63465e+15,572.145,5764.15,27840,376,342,25738,25678,25481,25423,23389
10272,597,1745,6128,4144,6128,4144,1.89378e+18,483.951,3437.03,10272,307,282,8384,7766,6274,6548,4914
44823,2212,3668,39571,5252,26542,18281,1.95609e+18,1315.7,9754.95,44823,475,585,41155,40101,34389,34137,27987
1874,582,709,1707,167,1152,722,1.97785e+18,162.29,1036.33,1874,97,110,1165,1163,1143,1152,1054
20742,959,1913,12265,8477,0,20742,5.0126e+18,831.913,4816.02,20742,356,350,18556,17779,16917,16389,10694
48912,53,265,0,48912,47571,1341,2.60052e+16,154.635,2334.3,48912,111,123,47574,46606,38188,34964,23917
10507,910,1180,0,10507,3177,7330,8.87481e+15,270.658,2725.06,10507,187,233,9327,9272,9284,9271,7764
22009,1162,1449,0,22009,6364,15645,9.0469e+15,541.56,4283.82,22009,328,326,20560,20553,20163,20136,18259
39772,2529,3595,22688,17084,0,39772,4.71571e+18,1112.03,8756.31,39772,436,531,36177,35750,35096,34998,29244
10200,12,28,9934,266,10200,0,9.65572e+13,14.9706,311.793,10200,18,20,10139,10107,9151,9138,6962
44801,914,5789,39801,5000,26860,17941,1.97551e+18,1228.87,12295.4,44801,625,759,37527,35114,17186,16034,5582
17532,1171,1205,5687,11845,0,17532,3.5232e+13,591.647,3579.14,17532,290,323,16327,16327,16311,16315,16221
49642,2778,3230,15737,33905,0,49642,3.40697e+13,641.812,9331.1,49642,514,443,46412,46383,46258,46235,43353
38942,3080,4126,38942,0,35138,3804,2.38155e+18,1469.62,9658.03,38942,513,500,34816,33618,33628,33037,29778
24292,437,771,24292,0,24292,0,4.13342e+18,350.229,2965.02,24292,193,193,23521,23324,19925,19648,20198
26850,1387,2296,15996,10854,15996,10854,1.82809e+18,921.072,6059.08,26850,401,394,24554,23357,22537,21910,17024
11323,15,25,11150,173,11323,0,9.64271e+13,14.6513,350.385,11323,18,18,11292,11283,10493,10489,8563
20853,1976,2669,18346,2507,12167,8686,1.96277e+18,502.675,5920.45,20853,291,331,18184,18103,17965,18021,15667
11950,379,1625,6795,5155,0,11950,4.51596e+18,276.973,3463.38,11950,212,284,10194,9036,8299,8029,3363
16256,488,503,16256,0,16256,0,4.16475e+18,291.26,2103.97,16256,166,148,15753,15753,15682,15717,15741
34038,2431,2940,0,34038,0,34038,2.32584e+18,1003.1,7573.82,34038,408,463,31098,31051,30897,30884,29148
41846,16,311,0,41846,41046,800,2.64254e+16,141.953,2407.96,41846,110,119,38235,36661,30825,25300,14759
16614,301,2121,10190,6424,10190,6424,1.78857e+18,648.19,4756.95,16614,296,326,12783,10745,8819,7342,3414
30146,3405,3450,18188,11958,18188,11958,1.82608e+18,712.819,7742,30146,422,567,26696,26696,26669,26664,26584
16589,29,54,16261,328,16589,0,1.01602e+14,18.8013,487.158,16589,23,24,16535,16529,15572,15561,12308
11391,1954,2438,11391,0,10058,1333,2.76312e+18,329.324,4437.79,11391,259,302,8953,8947,8921,8857,7235
47966,979,2881,0,47966,15594,32372,8.46676e+15,416.154,7883.66,47966,523,411,45085,44706,33035,31903,21624
34547,1132,1940,9976,24571,0,34547,3.71589e+13,669.684,6063.3,34547,378,410,32607,31921,31902,31920,24227
48234,3134,3382,29100,19134,29100,19134,1.82227e+18,848.846,9572.41,48234,472,533,44852,44850,44684,44759,44227
27458,760,2759,24620,2838,16944,10514,1.91364e+18,822.045,6548.3,27458,366,387,23841,22025,13591,13387,5698
48591,1213,3192,28187,20404,28187,20404,1.946e+18,632.046,8350.58,48591,505,373,45399,44907,43352,41999,32874
47383,2615,3469,47383,0,42410,4973,2.49282e+18,1663.52,9596.76,47383,577,456,43914,42977,42748,42386,37592
48641,936,3033,29220,19421,0,48641,4.79165e+18,1137.31,9049,48641,542,472,44531,42249,34713,33577,21101
5409,945,1008,0,5409,0,5409,2.31784e+18,225.877,1924.08,5409,184,137,4401,4401,4374,4369,4341
41489,270,290,0,41489,40758,731,2.52807e+16,156.332,2216.38,41489,108,115,41199,41195,41134,41025,40801
22381,249,275,0,22381,21859,522,2.60465e+16,108.357,1665.47,22381,89,84,22106,22106,22088,22013,21755
45872,1262,2224,0,45872,14367,31505,9.08391e+15,755.33,6886.37,45872,385,343,43648,42846,40611,40887,33136
4020,25,26,3973,47,4020,0,1.06569e+14,14.3418,203.778,4020,16,18,3994,3994,3974,3974,3930
17230,1004,2174,0,17230,0,17230,2.3928e+18,413.35,4512.3,17230,372,213,15056,14940,13444,12636,10681
11066,22,171,0,11066,10908,158,2.60726e+16,64.4519,882.609,11066,55,60,10458,9907,8683,8008,5681
40168,51,328,0,40168,39474,694,2.60727e+16,151.517,2440.66,40168,118,117,38805,37772,31670,27413,18579
35666,218,284,0,35666,34795,871,2.59251e+16,155.237,2105.07,35666,99,109,35382,35337,34092,33862,32151
28474,1096,2174,16675,11799,16675,11799,1.87342e+18,566.025,5475.23,28474,323,388,26300,25868,24971,23602,18401
17944,205,690,17944,0,17944,0,4.36483e+18,295.878,2521.14,17944,173,164,16736,15354,10411,10025,8567
4243,415,440,4243,0,4243,0,4.20468e+18,208.045,1114.63,4243,101,103,3803,3797,3770,3787,3777
39451,223,3964,23319,16132,0,39451,4.92475e+18,802.191,9382.94,39451,469,634,31409,26066,21518,18920,3773
21011,50,595,21011,0,21011,0,4.81814e+18,285.19,2558.86,21011,174,167,14948,10412,6307,5722,2910
7243,218,1310,6419,824,4257,2986,1.97005e+18,417.049,2505.69,7243,194,188,5187,4059,2925,2732,1959
33540,159,3406,19449,14091,19449,14091,1.87611e+18,852.878,7987.37,33540,442,531,24764,20352,15247,11904,2302
28531,81,754,28531,0,28531,0,4.08821e+18,334.233,3175.46,28531,192,196,22988,17067,12732,11505,4766
2176,323,470,1335,841,1335,841,1.80292e+18,229.738,874.495,2176,102,104,1668,1372,1493,1436,1423
10211,1139,1327,6246,3965,0,10211,5.10056e+18,728.493,3017.47,10211,247,274,8817,7997,8646,8610,8176
34044,926,3993,34044,0,29769,4275,2.24402e+18,982.674,9116.86,34044,448,495,29459,27205,16020,12405,8037
16367,56,226,0,16367,16160,207,2.62397e+16,111.939,1320.83,16367,78,88,15839,15469,13433,12692,8751
36713,699,2820,21087,15626,21087,15626,1.92533e+18,817.995,7212.64,36713,503,425,33181,31498,23119,23136,11915
12333,155,1538,0,12333,0,12333,2.10101e+18,406.551,3500.13,12333,220,339,9545,7907,3403,2825,1487
21394,571,1539,6715,14679,0,21394,3.62004e+13,355.695,4088.27,21394,325,237,19855,19791,16035,16163,11730
48964,4593,4670,48964,0,44108,4856,1.21246e+18,1313.85,11439.5,48964,622,534,44294,44294,44284,44286,44165
49783,1855,2670,15067,34716,0,49783,3.53557e+13,716.564,8701.45,49783,413,580,47113,47013,46706,46668,37448
32707,629,2080,0,32707,10171,22536,8.73058e+15,568.814,6094.41,32707,381,443,30377,29532,24820,24615,13964
12573,260,496,12573,0,12573,0,3.95343e+18,265.279,1915.64,12573,146,145,11998,11629,9981,9862,8078
18280,200,2710,11013,7267,0,18280,4.91734e+18,450.336,5462.86,18280,458,261,13718,11337,7510,5835,3114
26323,867,2274,15515,10808,15515,10808,1.82548e+18,582.799,5717.6,26323,394,331,23964,23127,22664,21266,15279
32848,306,319,0,32848,32200,648,2.40909e+16,126.039,2258.48,32848,99,112,32529,32529,32522,32444,32305
32785,100,2737,0,32785,0,32785,2.29824e+18,747.297,7270.54,32785,389,477,21876,16925,12439,9043,1468
5344,157,620,2774,2570,2774,2570,1.30759e+18,131.408,1407.64,5344,121,119,4697,4210,1347,1817,874
28582,43,2571,28582,0,25971,2611,1.25745e+18,935.638,6476.94,28582,356,370,14095,7337,5308,5787,429
29753,38,62,29085,668,29753,0,9.82748e+13,17.9233,632.241,29753,28,27,29691,29689,28670,28670,26166
34617,688,3466,30347,4270,20763,13854,2.00021e+18,967.493,8163.68,34617,455,442,29850,25978,19514,17287,11583
47710,1555,2316,14234,33476,0,47710,3.55436e+13,785.352,7537.53,47710,549,493,45394,45162,41681,41888,37554
49694,1497,2707,14806,34888,0,49694,3.60911e+13,620.028,8300.72,49694,412,528,46987,46834,45531,45498,32057
41136,4113,4132,36475,4661,24803,16333,1.94287e+18,929.959,9646.23,41136,543,476,37004,37004,37004,37004,36994
5315,29,406,5315,0,5315,0,4.31925e+18,214.647,1183.11,5315,103,100,3117,1838,1227,1151,642
39033,2242,4117,39033,0,35016,4017,1.46243e+18,1372.51,9805.84,39033,440,432,34916,34145,31533,30998,21924
15061,544,1472,0,15061,4612,10449,8.16309e+15,267.519,3460.31,15061,257,219,13589,13241,11853,11872,6700
32894,1220,3126,0,32894,0,32894,2.42195e+18,735.777,7775.88,32894,440,403,29768,29434,22960,22990,13602
48185,307,395,0,48185,47116,1069,2.62868e+16,131.384,2798.17,48185,113,116,47790,47784,47003,46776,44130
40949,2458,2721,24578,16371,0,40949,4.97146e+18,1391.78,7903.65,40949,522,446,38228,37991,37829,37714,37122
16927,448,540,16927,0,16927,0,4.22859e+18,276.246,2264.51,16927,165,160,16387,16367,16135,16137,15851
45265,59,2370,0,45265,14496,30769,8.84577e+15,617.158,7249.85,45265,473,372,32918,27348,19891,18580,4570
9712,19,26,9529,183,9712,0,9.75253e+13,12.6537,282.776,9712,16,18,9686,9680,9557,9554,9295
22415,188,254,0,22415,22112,303,2.4779e+16,131.196,1600.17,22415,100,94,22161,22106,21380,21206,19991
33366,3289,3417,19442,13924,19442,13924,1.82645e+18,821.303,8003.94,33366,488,381,29949,29949,29880,29902,29520
1969,550,628,1175,794,0,1969,4.97085e+18,106.137,978.275,1969,107,126,1341,1341,1336,1335,1297
45037,1977,3132,26346,18691,26346,18691,1.73546e+18,1156.84,8676.74,45037,471,455,41905,40598,40782,40465,32243
35025,4,53,34010,1015,35025,0,1.0072e+14,18.6237,667.14,35025,27,25,31339,28999,26903,27238,15709
43481,311,705,43481,0,43464,17,4.18218e+18,347.5,3743.78,43481,221,219,42598,41892,32462,32383,26440
33480,33,60,32648,832,33480,0,9.96347e+13,19.1856,738.337,33480,25,25,33420,33417,32387,32387,27522
13017,114,1630,13017,0,11770,1247,1.62899e+18,299.042,3421.46,13017,204,246,9807,5792,3816,3326,1120
1756,363,431,1125,631,0,1756,5.04955e+18,194.638,754.421,1756,102,99,1325,1112,1277,1291,1254
15926,2400,2550,9447,6479,9447,6479,1.9132e+18,527.907,5057.1,15926,315,427,13376,13376,13306,13329,13101
12663,152,541,12657,6,12663,0,4.25567e+18,254.927,1938.52,12663,146,141,11359,9879,7367,7001,5341
43395,271,1180,43376,19,43395,0,4.32181e+18,409.495,4406.18,43395,231,239,41406,39274,24322,23283,17207
30628,488,3732,27788,2840,17747,12881,1.95831e+18,791.651,8012.98,30628,449,382,25673,23063,9835,9482,4367
42664,3446,3602,0,42664,0,42664,2.31138e+18,1155.56,9038.48,42664,475,434,39062,39052,39001,38974,38683
23089,289,1578,7483,15606,0,23089,3.23782e+13,271.055,4289.88,23089,336,257,21154,19226,14682,13026,5749
42980,67,317,0,42980,42209,771,2.58053e+16,152.957,2384.88,42980,117,112,42027,40953,35836,32649,21910
34202,994,4323,30397,3805,19210,14992,1.97002e+18,750.674,9400.27,34202,344,645,29655,27566,21994,21676,12128
33565,12,62,33001,564,33565,0,1.03315e+14,20.3729,686.621,33565,27,28,33338,33192,29591,28694,18653
12462,850,2474,11207,1255,7107,5355,1.99963e+18,348.977,4359.51,12462,244,305,9988,9463,9050,9051,5373
15875,431,2290,0,15875,0,15875,2.40405e+18,484.196,4659.3,15875,373,296,13222,11930,8687,6804,3157
3337,114,659,0,3337,854,2483,8.68254e+15,151.918,1244.26,3337,173,100,2563,2249,1860,1917,805
35820,1067,1741,9999,25821,0,35820,3.70237e+13,701.549,5690.89,35820,440,324,34079,33403,32351,32442,28302
17898,176,217,0,17898,17608,290,2.65637e+16,111.918,1334.99,17898,75,83,17681,17670,17353,17294,16058
28180,39,64,27482,698,28180,0,9.7208e+13,16.0372,610.639,28180,25,25,28116,28115,27426,27428,24029
6270,110,1490,3792,2478,3792,2478,1.82363e+18,235.901,2582.86,6270,186,218,4174,3329,2686,2364,582
12027,20,1167,3561,8466,0,12027,3.74138e+13,450.605,2955.52,12027,293,245,7218,5396,4284,2523,911
7909,1239,1448,6981,928,4600,3309,1.9877e+18,494.926,2822.93,7909,224,189,6461,6298,6381,6393,5958
27096,616,2227,16187,10909,0,27096,4.76403e+18,717.5,5862.97,27096,408,387,24007,22262,18618,18273,9220
31128,50,88,30614,514,31128,0,1.03211e+14,20.9241,724.435,31128,27,28,31040,31032,29869,29871,24663
15931,306,620,15931,0,15931,0,4.19378e+18,287.549,2270.04,15931,159,152,15265,14910,11861,11796,10991
2915,378,826,0,2915,0,2915,2.45909e+18,94.8895,1268.77,2915,134,122,2089,2047,2033,2022,1421
30543,81,368,0,30543,30066,477,2.69565e+16,127.141,2325.03,30543,107,110,29864,29229,24587,23186,14947
32965,73,680,32965,0,32965,0,4.18817e+18,347.471,3284.13,32965,200,197,26274,19717,14526,13147,5502
39393,396,3838,39393,0,35207,4186,1.61756e+18,1842.06,9463.68,39393,469,605,31339,27295,14644,11254,4154
15008,8491,15008,15008,0,15008,0,1.7591e+13,0,15008,15008,15008,1,0,0,0,0,0
19483,1876,1954,10696,8787,0,19483,3.90206e+18,375.09,4511.49,19483,210,287,17529,17529,17527,17529,17484
10824,164,215,0,10824,10655,169,2.60231e+16,79.8472,1046.01,10824,66,73,10609,10594,10306,10127,9651
29182,145,2024,8700,20482,0,29182,3.41348e+13,582.425,5781.76,29182,367,336,24626,22457,15507,13981,3203
24844,2189,2570,14343,10501,0,24844,4.43055e+18,598.516,5977.42,24844,349,349,22274,22270,22017,21944,21162
6657,587,1435,5964,693,3980,2677,1.99794e+18,471.718,2605.99,6657,186,211,5156,4508,3833,3775,3114
12852,155,596,12852,0,12852,0,4.03363e+18,272.478,2035.79,12852,142,153,11562,10058,7642,7321,5039
19780,1059,1563,5711,14069,0,19780,3.69113e+13,453.376,4144.18,19780,275,340,18217,18078,18082,18078,16250
7107,994,1117,2015,5092,0,7107,3.66189e+13,270.858,2272.21,7107,189,196,5990,5990,5975,5967,5613
13627,509,1128,4079,9548,0,13627,3.62776e+13,468.894,3054.47,13627,263,234,12268,11468,11155,11260,6699
31995,162,2589,19784,12211,19784,12211,1.78948e+18,661.684,6763.79,31995,424,400,23857,19639,14220,11751,3853
9766,1795,2393,9766,0,8749,1017,2.93481e+18,408.127,3986.89,9766,304,254,7373,7343,7304,7320,6165
48719,519,1075,48713,6,48719,0,4.1313e+18,368.743,4408.07,48719,236,239,47644,47443,40644,40222,38283
2425,520,554,0,2425,612,1813,8.41043e+15,93.9159,972.878,2425,149,92,1871,1870,1871,1869,1811
13294,258,2798,13294,0,12049,1245,2.77142e+18,480.319,4918.42,13294,305,298,9578,7770,4782,3440,1293
20976,285,2333,12138,8838,0,20976,4.51859e+18,771.078,5283.65,20976,344,387,17374,15800,8795,7561,3379
1362,127,231,1362,0,1362,0,4.07162e+18,65.6226,456.704,1362,53,50,1131,1094,882,875,726
37443,3120,4122,37443,0,33648,3795,1.56301e+18,930.735,9433.08,37443,506,507,33321,33255,32965,32715,27346
9822,313,830,3138,6684,0,9822,3.60299e+13,306.875,2207.4,9822,196,185,8741,7756,6838,6779,4413
5486,206,883,4793,693,3415,2071,1.92597e+18,461.607,1893.97,5486,179,177,3699,2869,2227,2224,1917
30379,279,1970,18469,11910,0,30379,4.84865e+18,646.838,5690.45,30379,383,356,24826,20039,13217,12281,6462
23658,1601,2049,6656,17002,0,23658,3.75577e+13,470.966,5355.98,23658,336,422,21609,21609,21450,21446,19797
9000,894,1186,0,9000,2675,6325,9.35362e+15,247.203,2584.42,9000,203,241,7814,7788,7737,7727,7053
15801,1142,1958,0,15801,0,15801,2.33407e+18,751.483,4364.59,15801,352,374,13843,13397,12592,11866,10733
29229,1386,1860,9106,20123,0,29229,3.21164e+13,523.729,5438.34,29229,327,353,27369,27171,27011,27022,23250
20390,1383,1415,5364,15026,0,20390,3.66819e+13,645.526,4006.59,20390,329,269,18975,18975,18973,18975,18895
16798,612,1060,5353,11445,0,16798,3.47327e+13,457.47,3193.35,16798,239,253,15738,15019,14135,14230,10671
3745,19,25,3614,131,3745,0,1.07555e+14,13.9105,203.377,3745,19,17,3720,3720,3561,3561,3531
9717,1304,1324,5733,3984,5733,3984,1.82314e+18,360.846,2899.76,9717,257,217,8393,8393,8388,8389,8375
6502,6,24,6434,68,6502,0,1.01257e+14,14.6261,251.174,6502,16,18,6290,6049,5186,5232,3993
44679,28,64,43766,913,44584,95,9.8966e+13,18.6236,824.563,44679,28,29,44615,44610,41139,41180,31030
24985,193,1686,0,24985,7469,17516,8.90325e+15,488.698,4856.38,24985,365,250,21332,19314,12732,11551,4055
34284,389,1986,0,34284,9968,24316,9.37369e+15,471.757,5856.38,34284,320,381,31878,30676,25885,26491,13993
39290,2118,2517,23448,15842,23448,15842,1.84305e+18,796.527,6982.32,39290,330,411,36773,36747,36612,36708,34337
36889,989,3048,0,36889,0,36889,2.44691e+18,1082.17,8004.99,36889,499,420,33183,31880,22643,17401,12551
10333,57,1028,2916,7417,0,10333,3.72697e+13,233.46,2505.18,10333,276,199,7498,6276,5122,5030,1649
9284,876,1069,2849,6435,0,9284,3.707e+13,303.658,2539.01,9284,185,242,8215,8206,8169,8171,7310
43390,345,3721,26331,17059,26331,17059,1.80101e+18,790.154,9353.46,43390,583,499,36115,30741,21785,17928,6269
42049,1997,2805,24913,17136,0,42049,4.84209e+18,1117.48,8215.87,42049,582,390,39244,38936,38317,38106,33437
3927,399,464,1129,2798,0,3927,3.75986e+13,211.655,1047.72,3927,127,113,3463,3440,3443,3452,3290
4335,301,952,2571,1764,2571,1764,1.93898e+18,223.837,1707.15,4335,128,195,3280,2970,2690,2699,1222
40031,220,272,0,40031,39294,737,2.52745e+16,151.042,2215.34,40031,100,118,39759,39732,39222,39105,38097
24579,351,675,24579,0,24579,0,3.8878e+18,343.798,2877.56,24579,192,187,23830,23400,19147,18861,16070
21721,219,2663,0,21721,0,21721,2.25402e+18,826.203,5975.71,21721,378,394,16411,13500,9422,6753,2616
13532,242,1282,0,13532,0,13532,2.31026e+18,512.812,3231.45,13532,252,243,10344,8149,5361,4461,3041
1800,630,703,1616,184,1100,700,2.16343e+18,53.965,959.558,1800,140,73,1097,1097,1088,1093,1001
10330,165,1291,6098,4232,6098,4232,1.96622e+18,376.094,2908.48,10330,272,220,7976,6851,5465,4459,2106
695,11,17,680,15,695,0,1.1421e+14,9.69928,79.7085,695,12,11,676,673,647,648,642
3517,306,413,3517,0,3517,0,4.21298e+18,203.596,1021.91,3517,89,96,3104,2991,2939,2953,2787
46598,1319,2261,0,46598,14215,32383,9.22584e+15,694.331,7483.05,46598,487,432,44337,44011,41249,41485,34659
15612,15596,15612,15612,0,15612,0,1.75911e+13,0,15612,15612,15612,1,0,0,0,0,0
18179,163,240,0,18179,17859,320,2.71123e+16,113.296,1507.55,18179,80,84,17939,17868,17236,17245,15389
37095,1025,2011,10722,26373,0,37095,3.69433e+13,805.894,6428.64,37095,506,432,34990,34351,32364,32315,24309
4899,440,463,4899,0,4899,0,4.24924e+18,205.561,1203.2,4899,106,103,4436,4436,4423,4418,4423
22782,1722,1842,0,22782,6540,16242,9.5475e+15,526.512,5031.52,22782,335,383,20940,20940,20906,20893,20566
7326,295,497,7326,0,7326,0,4.01646e+18,227.303,1490.49,7326,112,115,6829,6671,5913,5863,4832
47295,1339,4696,41668,5627,27590,19705,1.95682e+18,1165.7,11222.3,47295,585,658,42129,40457,25951,25092,18320
23891,562,643,23891,0,23891,0,4.01382e+18,320.531,2739.01,23891,176,188,23248,23247,22953,22923,22841
10195,987,1257,3116,7079,0,10195,3.57468e+13,241.012,2855.6,10195,276,205,8938,8937,8876,8878,7737
7066,814,985,4342,2724,0,7066,5.00855e+18,279.395,2057.9,7066,193,163,6081,6081,6081,6081,5604
28404,2313,3944,28404,0,24223,4181,3.04861e+18,981.289,8322.02,28404,399,434,24460,24182,23188,23030,18532
41820,10,54,41329,491,41820,0,9.79982e+13,19.1856,703.44,41820,25,29,41428,41123,36363,35459,21778
16676,382,457,16676,0,16676,0,3.9812e+18,260.084,2133.26,16676,160,151,16219,16201,15759,15751,15233
28065,329,2461,25070,2995,16944,11121,1.9392e+18,1027.73,6483.23,28065,373,370,21600,17236,10631,9268,5543
891,5,8,853,38,891,0,9.57206e+13,7.34905,71.9383,891,8,8,862,831,758,763,791
44692,1668,2147,0,44692,13472,31220,8.50824e+15,767.355,7081.82,44692,480,422,42545,42359,41690,41743,37009
8044,1079,1214,4308,3736,4308,3736,1.48435e+18,184.143,2385.51,8044,205,163,6830,6830,6817,6828,6528
44412,333,658,44412,0,44412,0,4.02423e+18,304.861,3619.82,44412,219,213,43733,43514,34896,34561,31650
23310,235,1000,7523,15787,0,23310,3.50006e+13,371.143,3533.79,23310,260,243,20410,17544,12914,12447,6393
44479,303,2145,12857,31622,0,44479,3.6475e+13,711.511,6806.77,44479,539,365,39703,35683,25420,24896,10307
15485,1032,1722,9355,6130,9355,6130,1.82806e+18,338.98,3946.65,15485,196,351,13763,13736,13481,13554,11809
35472,1019,2683,20533,14939,0,35472,4.61103e+18,1004.4,7381.44,35472,376,475,32295,30909,25304,24021,18716
28454,358,688,28454,0,28454,0,4.3624e+18,341.806,3079.96,28454,190,199,27712,27419,23176,22758,21074
8006,1454,1805,7068,938,4574,3432,1.9383e+18,282.106,3236.9,8006,184,299,6201,6197,6051,6132,5462
34875,1161,2262,11124,23751,0,34875,3.5663e+13,648.013,6730.04,34875,426,430,32613,32232,29574,29714,22939
29437,295,1997,0,29437,8263,21174,9.68516e+15,533.731,5825.95,29437,349,398,26158,23504,21216,21171,8916
6196,346,1385,3715,2481,0,6196,4.79352e+18,263.941,2478.97,6196,157,283,4749,4274,3455,3387,1866
49638,2931,3177,28271,21367,28271,21367,1.75327e+18,1163.52,9106.76,49638,550,517,46461,46460,46298,46391,45457
4223,140,148,0,4223,4143,80,2.5936e+16,39.9181,543.849,4223,45,39,4075,4075,4074,4063,3882
3825,18,126,0,3825,3734,91,2.61104e+16,51.5932,478.478,3825,46,45,3504,3336,2909,2755,1819
33611,85,2778,19904,13707,0,33611,4.40194e+18,856.892,7266.56,33611,466,461,21757,15296,10289,8044,1370
37684,242,277,0,37684,36925,759,2.69385e+16,140.4,2137.97,37684,102,115,37407,37406,37175,37124,36611
16924,9,224,0,16924,16650,274,2.62361e+16,116.373,1319.07,16924,86,87,14570,13305,11508,9267,6154
39090,3859,4997,39090,0,34835,4255,2.75417e+18,992.066,10578.6,39090,368,607,34093,34088,33019,32533,27900
13858,2230,13858,13858,0,0,13858,15.9988,0,13858,13858,13858,1,0,0,0,0,0
15044,754,1282,4415,10629,0,15044,3.56569e+13,358.037,3344.81,15044,278,255,13762,13615,12962,12964,10386
15942,157,1633,5199,10743,0,15942,3.44201e+13,353.3,3996.92,15942,302,306,12992,11077,7188,4573,3273
26888,75,246,0,26888,26205,683,2.547e+16,118.218,1640.7,26888,87,91,26398,25939,23412,21860,16192
16515,1432,1533,0,16515,4725,11790,9.5541e+15,399.647,3832.38,16515,317,313,14982,14909,14961,14961,14800
36499,3150,3642,22017,14482,0,36499,4.90199e+18,768.951,8523,36499,425,353,32857,32856,32701,32743,31719
6371,92,182,0,6371,6243,128,2.7122e+16,68.9515,776.607,6371,53,56,6177,6102,5633,5638,4391
44351,3051,4183,44351,0,39151,5200,1.29445e+18,1368.34,10275.5,44351,613,428,40168,39962,39501,39423,36265
44078,63,90,43371,707,44078,0,9.81123e+13,17.9253,854.304,44078,28,29,43988,43986,42549,42580,34083
7046,261,1518,7046,0,6274,772,2.5555e+18,354.479,2755.11,7046,241,218,4954,3991,2529,2001,1824
11783,485,2527,11783,0,10435,1348,2.74057e+18,387.442,4575.23,11783,276,252,8953,7756,5471,5298,2523
22194,343,3365,22194,0,20024,2170,1.91403e+18,633.785,6850.95,22194,466,422,16787,13218,8904,8554,2145
46615,3957,4472,46615,0,41381,5234,2.76731e+18,1308.04,10796.3,46615,413,566,42143,42142,41943,41826,39302
16747,29,2067,9255,7492,9255,7492,1.64066e+18,378.361,4480.49,16747,255,384,8431,4267,3534,3439,348
5201,483,1226,0,5201,0,5201,2.05727e+18,173.185,2078.98,5201,209,179,3975,3863,2884,2405,2026
33273,3071,3499,33273,0,30046,3227,1.30663e+18,1154.3,8229.43,33273,404,448,29774,29566,29407,29347,27943
28969,188,256,0,28969,28245,724,2.60258e+16,138.512,1743.5,28969,102,97,28713,28671,27417,27764,25805
36954,758,967,36948,6,36954,0,4.03478e+18,374.516,3838.68,36954,215,212,35987,35948,35336,35310,35011
30928,1135,2179,0,30928,9618,21310,9.24618e+15,588.734,6180.74,30928,393,513,28749,28333,27272,27299,17436
11722,139,525,11722,0,11722,0,4.62886e+18,274.296,1888.29,11722,142,133,10375,8994,5929,5450,4115
25477,1806,2792,0,25477,0,25477,2.33223e+18,873.304,6471.93,25477,460,397,22685,22248,20834,17845,18960
8107,516,1577,5002,3105,5002,3105,1.94257e+18,271.011,2873.74,8107,244,200,6530,6221,4979,4758,2310
28255,316,1795,0,28255,8556,19699,7.78298e+15,416.89,5085.44,28255,464,285,25838,24469,16698,16479,6638
3182,364,584,947,2235,0,3182,3.41094e+13,162.56,1157.74,3182,159,107,2598,2526,2368,2385,1840
42828,2787,3408,38567,4261,24363,18465,1.91024e+18,1514.59,8847.84,42828,465,495,39420,38373,38869,38871,37257
16525,586,1725,9369,7156,0,16525,4.70059e+18,480.507,4147.87,16525,331,274,14543,13369,11868,11250,9550
825,177,275,227,598,0,825,3.82173e+13,35.5891,406.98,825,88,46,550,545,542,535,476
41073,662,2126,0,41073,12558,28515,9.13946e+15,819.938,6779.3,41073,386,396,38192,37087,31046,30933,17828
31153,41,84,30741,412,31081,72,1.01303e+14,19.3031,778.633,31153,27,31,31069,31067,29663,29668,23606
1666,33,520,0,1666,0,1666,2.57466e+18,107.639,810.026,1666,78,99,913,640,519,464,83
18438,452,1916,10164,8274,0,18438,4.07225e+18,467.46,4197.37,18438,245,261,16254,15397,14696,14114,7433
2656,60,504,2656,0,2478,178,2.07782e+18,157.363,1001.11,2656,100,101,1342,567,535,295,191
15595,1023,2335,9372,6223,9372,6223,1.82548e+18,666.561,4851.33,15595,302,354,13260,12582,11557,11561,8007
25762,937,1212,7165,18597,0,25762,3.80538e+13,593.872,4139.15,25762,344,285,24550,24426,24070,24083,22983
9180,160,1355,5499,3681,0,9180,4.92801e+18,323.593,2792.27,9180,270,165,6680,5435,4563,4363,1484
5483,664,1084,5483,0,4913,570,2.44781e+18,383.049,2068.19,5483,204,169,4399,4052,4112,4063,3754
35835,1208,2575,22063,13772,0,35835,4.6815e+18,708.908,6988.69,35835,452,468,33247,32855,27307,26682,23586
5416,822,990,3282,2134,0,5416,4.82949e+18,219.344,1835.92,5416,256,127,4426,4425,4424,4425,3915
18826,959,1113,5613,13213,0,18826,3.68002e+13,289.446,3267.17,18826,262,188,17713,17713,17696,17696,17349
3428,98,188,0,3428,1192,2236,7.28295e+15,88.5298,639.314,3428,78,77,3236,3222,2705,2692,2259
16889,998,2264,14786,2103,9967,6922,1.96748e+18,571.897,4789.73,16889,419,314,14625,14219,11843,11435,10795
5099,1065,1159,0,5099,0,5099,2.18428e+18,250.026,2081.61,5099,261,152,3940,3940,3908,3905,3792
40276,2165,2851,24051,16225,0,40276,4.66354e+18,793.535,7958.48,40276,385,404,37425,37369,37082,36972,33738
41659,60,75,40934,725,41659,0,1.03221e+14,20.0972,787.832,41659,30,29,41584,41584,40979,40980,38454
777,39,353,461,316,461,316,2.06662e+18,27.7606,458.9,777,89,56,407,309,250,252,161
26948,2081,2141,8294,18654,0,26948,3.5282e+13,498.582,5716.25,26948,356,360,24807,24807,24802,24801,24666
42990,177,2522,0,42990,12888,30102,9.17864e+15,902.768,7924.5,42990,514,459,35997,31911,23729,19666,6141
11561,1046,1534,0,11561,0,11561,1.98145e+18,247.273,3226.19,11561,271,272,10027,10018,9661,9094,8839
18807,35,227,0,18807,18603,204,2.59503e+16,102.864,1387.28,18807,73,85,18056,17633,14939,13388,8367
48773,155,3631,29086,19687,29086,19687,1.81659e+18,870.101,9603.34,48773,550,437,35698,28596,21071,15873,3546
3454,19,583,0,3454,985,2469,9.14935e+15,193.09,1178.62,3454,154,144,1987,1491,1086,1135,278
5790,1070,1108,3487,2303,0,5790,5.38039e+18,384.548,2056.22,5790,211,197,4682,4682,4660,4650,4625
15095,939,1018,0,15095,4906,10189,9.26203e+15,409.085,3003.95,15095,231,249,14077,14067,14006,14015,13968
15765,1863,2570,0,15765,0,15765,2.32397e+18,323.616,4942.28,15765,275,414,13195,13193,12977,13049,9641
1197,37,92,0,1197,1174,23,2.73302e+16,20.914,242.521,1197,30,23,1105,1086,979,1008,621
27132,2133,2298,16158,10974,0,27132,4.97226e+18,735.867,5734.35,27132,324,362,24834,24834,24780,24774,24419
27121,940,2639,15743,11378,0,27121,4.65682e+18,798.07,6302.01,27121,357,360,24373,22854,21412,20868,14695
43917,934,2067,0,43917,12922,30995,9.35113e+15,823.487,6689.83,43917,409,436,41643,40829,37704,38104,24678
3669,486,697,891,2778,0,3669,3.68654e+13,84.8419,1301.22,3669,160,119,2972,2971,2946,2946,2312
18770,1266,1944,11219,7551,0,18770,4.86526e+18,537.947,4744.75,18770,336,371,16826,16795,16448,16341,13775
9755,348,965,2810,6945,0,9755,3.49351e+13,266.401,2382.51,9755,239,156,8779,8428,7546,7464,5378
36837,61,68,36256,581,36837,0,9.97929e+13,19.6828,709.138,36837,26,31,36769,36769,36306,36307,36279
33269,34,264,0,33269,32554,715,2.5495e+16,139.406,2052.73,33269,100,101,31709,30801,25881,21879,14387
21630,1572,2208,12580,9050,0,21630,4.60328e+18,669.801,5275.77,21630,363,379,19422,19367,19153,19063,16644
48151,215,1041,48151,0,48151,0,4.201e+18,387.45,4367.72,48151,237,235,45373,41669,27147,26136,17775
49618,3696,4980,44153,5465,29361,20257,1.99116e+18,1335.97,11708.8,49618,686,630,44638,44551,43997,44159,41633
27504,304,3105,24748,2756,16078,11426,1.87584e+18,473.1,6906.05,27504,275,487,22168,17775,8734,7509,2860
40007,702,1212,39982,25,40007,0,4.16468e+18,390.756,4199.63,40007,223,230,38795,38714,34814,34574,33323
13210,726,2261,0,13210,0,13210,2.28557e+18,320.971,4306.78,13210,218,346,10949,10600,10203,10041,4206
37409,43,250,0,37409,36927,482,2.53721e+16,120.784,1913.7,37409,90,95,36371,35632,30596,26965,17868
46388,2099,2994,0,46388,13560,32828,9.27667e+15,838.391,8870.74,46388,577,634,43394,43090,41903,41839,36104
21741,44,1627,6870,14871,0,21741,3.47637e+13,321.587,4196.04,21741,253,308,14625,11626,9399,3195,1703
23138,29,39,22948,190,23114,24,9.98023e+13,18.5962,571.067,23138,23,22,23099,23099,22542,22600,21314
10251,1870,2055,9239,1012,6345,3906,1.94893e+18,466.133,3843.66,10251,319,228,8196,8196,8186,8190,8002
26877,582,1628,7974,18903,0,26877,3.68347e+13,726.046,4876.97,26877,381,328,24491,22832,18777,18740,9535
25793,2374,2589,15506,10287,0,25793,4.68697e+18,521.916,6155.8,25793,417,332,23204,23204,23155,23115,21915
9300,319,691,0,9300,0,9300,1.71663e+18,211.405,1818.88,9300,148,141,8609,8499,7420,6732,3801
28728,1989,3079,28703,25,25520,3208,2.68918e+18,1060.15,7388.87,28728,384,397,25649,25074,25166,24943,20345
43918,3823,4369,43918,0,39510,4408,2.69466e+18,1086.99,10414.4,43918,476,500,39549,39534,39549,39549,36227
22762,1807,3003,13466,9296,0,22762,4.8944e+18,668.044,6327.84,22762,408,345,19759,19586,18777,18528,15324
8150,862,1271,0,8150,0,8150,2.44381e+18,326.521,2630.41,8150,204,255,6879,6859,6695,6734,5529
24658,2924,2989,14941,9717,14941,9717,1.85948e+18,1021.24,6641.2,24658,428,398,21669,21669,21660,21656,21630
45106,3263,4033,40096,5010,27089,18017,1.96127e+18,1420.01,10205.8,45106,477,640,41073,40756,40409,40599,37677
2971,228,801,2971,0,2639,332,1.89427e+18,312.48,1355.94,2971,160,123,1914,1431,1258,1158,1142
10861,53,155,0,10861,10621,240,2.74272e+16,80.9604,836.971,10861,64,68,10514,10164,9096,9075,6613
25390,317,3287,0,25390,0,25390,2.34629e+18,537.087,7015.39,25390,334,488,20436,17456,13824,11597,4049
18067,34,240,0,18067,17736,331,2.58366e+16,113.482,1395.09,18067,85,90,17158,16623,14200,12718,8711
37179,1144,1368,0,37179,11986,25193,8.93554e+15,680.734,5221.94,37179,393,371,35811,35809,35510,35491,34369
19720,1757,2283,19720,0,17466,2254,1.91001e+18,1023.02,5474,19720,294,357,17437,16981,16880,16753,16269
38082,3019,3914,33898,4184,23143,14939,1.94416e+18,784.658,9188.49,38082,372,561,34168,34126,33528,33712,29531
21632,1005,2692,19021,2611,12729,8903,1.94628e+18,1163.13,6091.9,21632,407,347,18338,16677,13634,13164,9594
30082,2948,3572,30082,0,26683,3399,2.62485e+18,1224.88,8197.97,30082,434,500,26510,26428,25665,25473,24356
19843,367,2202,11667,8176,11667,8176,1.75199e+18,569.669,5137.34,19843,309,337,16677,14441,10266,8807,4963
22546,2419,2971,13118,9428,13118,9428,1.77922e+18,562.654,6394.01,22546,334,607,19575,19573,19307,19357,17496
4399,593,671,1268,3131,0,4399,3.97709e+13,197.766,1369.81,4399,174,148,3728,3684,3715,3713,3477
18098,1266,2591,16178,1920,10831,7267,1.94338e+18,519.506,5431.92,18098,301,476,15507,15259,14280,14436,9988
42849,2845,4014,0,42849,0,42849,2.47307e+18,1111.77,9693.55,42849,567,472,38835,38377,37997,37762,29774
4118,75,226,4118,0,4118,0,3.54993e+18,122.455,795.848,4118,96,90,3167,2005,1944,2106,1562
32025,1359,2224,19232,12793,0,32025,4.92651e+18,1033.44,6365.6,32025,397,424,29553,27559,28170,28032,18292
36288,695,1045,11755,24533,0,36288,3.45095e+13,429.143,4362.47,36288,299,310,35243,35220,33390,33500,29420
31371,1490,1545,9661,21710,0,31371,3.54667e+13,612.905,5198.44,31371,429,435,29826,29826,29818,29818,29671
34575,47,78,33983,592,34521,54,1.02219e+14,17.4772,781.036,34575,29,28,34497,34497,33229,33234,23901
45047,30,68,44308,739,45047,0,1.00963e+14,19.4222,802.577,45047,28,29,44979,44970,42299,42119,31205
22588,831,1551,0,22588,6704,15884,9.29563e+15,500.61,4539.14,22588,298,339,21018,20556,20385,20416,14980
14799,661,1254,4435,10364,0,14799,3.25445e+13,382.521,3159.63,14799,258,240,13545,13303,13007,13070,9015
10792,171,2228,9643,1149,6336,4456,1.99435e+18,355.146,4056.92,10792,331,325,7503,6056,3284,3200,784
25401,1957,2852,15925,9476,15925,9476,1.86769e+18,605.978,6604.53,25401,458,347,22549,22413,22039,22159,18087
43902,1330,2795,13933,29969,0,43902,3.47464e+13,577.393,7987.26,43902,642,360,41107,41005,35665,35788,29282
39480,272,3702,39480,0,35257,4223,2.30056e+18,1369.32,9372.44,39480,457,548,29269,23925,19320,16840,5883
49987,8,84,49050,937,49945,42,9.52086e+13,20.721,947.585,49987,31,32,49061,48505,42878,42256,25189
25961,1092,1622,16556,9405,0,25961,5.07035e+18,491.147,4645.42,25961,342,284,24339,24312,24126,23977,23197
5822,88,527,5822,0,5822,0,4.00124e+18,188.374,1368.44,5822,115,110,4622,3089,2208,2076,1812
37509,50,301,0,37509,36931,578,2.5364e+16,153.334,2209.61,37509,103,115,36284,35328,30379,27534,17736
16185,1092,2109,14563,1622,9020,7165,1.92181e+18,436.051,4512.98,16185,253,243,14076,13763,13285,13354,10512
44337,391,3649,26108,18229,0,44337,4.68254e+18,1358.91,9394.97,44337,454,504,36716,31495,19852,15619,5771
33619,88,935,33594,25,33619,0,4.06071e+18,349.141,3543.21,33619,210,210,27054,20579,14303,13796,6197
23824,82,1454,0,23824,6607,17217,9.28961e+15,659.353,4520.86,23824,346,332,17989,15675,12404,11215,3592
27004,892,2974,16243,10761,16243,10761,1.86428e+18,617.502,6745.33,27004,343,484,23987,22936,22240,22034,13329
21043,1234,1469,0,21043,6173,14870,9.1674e+15,373.289,4065.06,21043,343,272,19574,19569,19132,19169,18292
27329,3073,3263,0,27329,0,27329,2.25149e+18,562.396,7255.41,27329,375,466,24066,24065,24055,24012,23498
24267,100,264,0,24267,23672,595,2.65224e+16,137.561,1705.23,24267,87,105,23806,23391,21055,19785,15258
25579,1699,2042,0,25579,0,25579,2.38434e+18,865.735,5407.45,25579,371,341,23537,23425,22757,22108,21045
40126,871,922,40126,0,40126,0,4.15489e+18,346.952,3805.79,40126,217,217,39204,39204,39185,39186,39169
22288,1978,2138,0,22288,0,22288,2.33458e+18,432.428,5337.04,22288,317,341,20150,20129,20099,20126,19622
4691,10,30,4576,115,4691,0,1.07286e+14,11.961,226.004,4691,17,19,4642,4612,4237,4224,3112
1489,54,82,0,1489,1447,42,3.11653e+16,21.4124,266.126,1489,34,26,1407,1397,1310,1371,1121
49922,145,274,0,49922,49166,756,2.51254e+16,154.413,2354.37,49922,120,117,49537,49232,45401,44500,40011
48201,1735,2484,0,48201,15447,32754,8.47144e+15,587.275,7636.65,48201,501,439,45717,45630,44923,45003,37763
17799,443,1958,9959,7840,0,17799,4.21957e+18,490.506,4355.26,17799,260,314,15594,14683,13252,12714,3918
1210,147,307,0,1210,354,856,8.21817e+15,52.7116,522.798,1210,83,62,903,897,647,623,508
36679,50,66,35822,857,36648,31,1.00292e+14,18.7429,746.321,36679,27,26,36613,36613,36070,36072,33200
23942,1950,3443,14380,9562,14380,9562,1.95802e+18,590.155,7090.79,23942,420,496,20499,20332,19210,19490,13960
42947,52,378,0,42947,42294,653,2.62882e+16,152.103,2799.22,42947,127,125,41592,40390,33641,29831,18857
32988,46,80,32372,616,32988,0,1.02332e+14,19.0542,702.382,32988,28,30,32908,32905,31878,31880,27678
47581,950,3607,0,47581,0,47581,2.4391e+18,988.82,9239.4,47581,545,549,42854,40301,32456,29116,21508
14339,512,1562,14339,0,12909,1430,2.88036e+18,467.679,3616.81,14339,260,238,12682,9377,8546,8187,8477
5802,822,1157,5802,0,5096,706,2.17257e+18,436.899,2212.64,5802,165,188,4645,4288,4391,4430,3950
4208,315,1124,3763,445,2426,1782,1.89084e+18,169.669,1874.4,4208,144,196,3084,2791,2341,2304,1115
34876,3117,3958,20453,14423,0,34876,5.00724e+18,1024.98,8972.29,34876,446,582,30918,30536,30510,30462,25716
17064,130,1202,0,17064,5293,11771,9.44775e+15,545.07,3493.02,17064,257,336,13471,11713,8229,7992,3792
17434,582,1746,15589,1845,10452,6982,1.91051e+18,911.967,4526.9,17434,283,330,14142,11754,10271,10352,7679
30739,1111,3403,18605,12134,18605,12134,1.83388e+18,658.469,7495.06,30739,444,381,27336,26700,22636,22746,16727
15799,1857,2709,0,15799,0,15799,2.35334e+18,509.53,5200.24,15799,365,333,13090,12944,12508,11729,10569
15502,848,2266,14022,1480,9368,6134,1.97203e+18,663.461,4719.67,15502,366,272,13048,11749,10278,10136,6589
30029,56,60,29426,603,30029,0,1.00896e+14,17.6077,636.152,30029,25,27,29969,29969,29929,29930,29629
37708,1938,2845,23091,14617,0,37708,4.85313e+18,794.298,7495.59,37708,472,371,34863,34690,33931,33671,30209
49999,3458,4566,29882,20117,0,49999,4.88037e+18,1163.77,11450,49999,688,501,45433,45351,44493,44379,37569
13157,1405,2384,11794,1363,8031,5126,1.94243e+18,403.419,4484.67,13157,289,245,10773,10710,9935,9920,7704
30383,389,947,30377,6,30383,0,4.05518e+18,342.364,3515.02,30383,204,201,29402,28998,20932,20480,17239
11270,1057,1184,6859,4411,6859,4411,1.86461e+18,398.43,2779.06,11270,219,258,10086,10085,10028,10032,9715
2698,359,851,1648,1050,0,2698,5.49985e+18,84.4855,1302.07,2698,164,129,1847,1813,1619,1601,672
31174,1494,1560,9351,21823,0,31174,3.4146e+13,485.559,4871.52,31174,367,307,29614,29613,29592,29598,29458
6629,820,1306,6629,0,5785,844,3.20976e+18,324.51,2444.92,6629,185,189,5323,5219,4991,4930,3564
25752,3108,4120,25752,0,23160,2592,1.84091e+18,618.456,7980.56,25752,339,494,21632,21610,21476,21377,19267
44706,683,1132,44706,0,44706,0,4.30579e+18,378.428,4354.94,44706,232,240,43574,43528,39030,38679,36767
46878,3085,4086,27609,19269,0,46878,4.72356e+18,1171.2,10331,46878,573,619,42792,42751,42164,42094,37300
23662,1681,1994,14555,9107,0,23662,5.04843e+18,516.914,4841.6,23662,335,352,21668,21666,21210,21071,20914
48439,473,2689,0,48439,14674,33765,9.06509e+15,756.34,8582.71,48439,461,675,44321,41775,34138,34119,12162
39126,13,16,38966,160,39126,0,2.16154e+18,15.9935,791.212,39126,16,16,31289,0,24448,29333,31289
2356,42,665,2121,235,1392,964,1.9252e+18,197.772,1095.12,2356,94,137,1176,755,367,410,28
16480,1046,1337,0,16480,5082,11398,9.40147e+15,533.842,3835.91,16480,305,379,15143,14948,14832,14847,13669
22915,1864,1916,0,22915,6476,16439,9.1566e+15,417.323,4955.55,22915,501,276,20999,20999,20999,20999,20929
24354,1385,1661,7112,17242,0,24354,3.49693e+13,458.762,4654.92,24354,318,279,22693,22690,22640,22638,20970
5971,22,26,5898,73,5965,6,9.64966e+13,15.4539,276.019,5971,18,18,5945,5945,5899,5899,5799
47846,160,4398,28422,19424,0,47846,4.82163e+18,1035.13,10882,47846,603,528,36097,29694,21391,16088,3000
19915,747,2609,12171,7744,12171,7744,1.9023e+18,556.065,5435.91,19915,323,386,17306,16086,14352,14073,8604
37148,29352,37148,37148,0,37148,0,1.75917e+13,0,37148,37148,37148,1,0,0,0,0,0
14514,286,1810,14514,0,13128,1386,2.27068e+18,354.216,3832.8,14514,239,316,12351,11563,7264,6202,5914
16983,1495,2078,16983,0,14746,2237,2.85621e+18,863.147,4907.95,16983,347,317,14905,14639,14755,14698,13681
35483,2494,2644,11067,24416,0,35483,3.35201e+13,675.489,7271.12,35483,429,493,32839,32839,32797,32799,32291
2965,448,601,0,2965,936,2029,9.50387e+15,149.157,1145.07,2965,101,162,2364,2348,2337,2328,2074
24848,113,272,0,24848,24326,522,2.56703e+16,130.406,1776.14,24848,92,98,24486,24227,21908,20915,17016
34295,522,2506,0,34295,0,34295,2.0349e+18,952.193,6937.92,34295,423,486,30326,28371,16734,20613,7915
45550,869,2606,14374,31176,0,45550,3.57209e+13,611.889,8271.55,45550,453,767,42757,42143,38831,38864,19027
20008,15,35,19456,552,20008,0,1.01952e+14,20.9165,475.145,20008,22,24,19942,19906,18434,18352,14299
20451,1605,2895,12185,8266,0,20451,5.0317e+18,561.224,5895.86,20451,430,294,17556,17362,16648,16424,13328
43149,2062,3340,26210,16939,26210,16939,1.81045e+18,1279.83,8974.03,43149,532,563,39809,38959,38027,37945,28194
49126,2430,3706,0,49126,0,49126,2.41381e+18,961.858,9939.51,49126,406,600,45420,45329,44837,44895,38570
16466,1797,2165,0,16466,0,16466,2.31565e+18,592.981,4735.74,16466,341,309,14301,14293,13837,13741,12909
36381,77,84,35765,616,36381,0,1.00734e+14,18.4686,738.594,36381,29,28,36297,36297,36170,36173,35811
21259,951,2140,12525,8734,0,21259,4.69959e+18,634.249,5043.87,21259,297,327,19119,18237,17551,17158,10544
41993,2667,5591,41993,0,37327,4666,1.99116e+18,957.456,11808.4,41993,664,453,36402,36173,35003,34543,21362
28065,165,259,0,28065,27508,557,2.53056e+16,137.571,1802.23,28065,91,103,27796,27739,26220,25970,22943
45305,1518,4012,40792,4513,26355,18950,1.97363e+18,1252.33,10112.6,45305,388,559,40642,39136,36852,37257,19057
38510,2286,3712,23195,15315,23195,15315,1.82551e+18,779.424,8820.17,38510,448,576,34798,34608,33491,33641,23177
26979,31,274,0,26979,26550,429,2.47671e+16,117.977,1855.91,26979,89,106,25582,24725,20891,18718,11692
26884,46,247,0,26884,26253,631,2.64682e+16,115.61,1704.74,26884,89,93,25979,25158,21090,19120,12776
45170,3319,4024,45170,0,40376,4794,2.40862e+18,1320.2,10054.9,45170,490,499,41146,41137,41073,41078,39858
1816,429,435,1592,224,1021,795,2.03198e+18,223.455,784.042,1816,92,97,1381,1381,1379,1379,1377
5759,21,24,5618,141,5759,0,1.00586e+14,13.7597,235.841,5759,15,17,5735,5735,5705,5706,5662
46170,96,98,45524,646,46150,20,1.03476e+14,21.4035,948.801,46170,34,33,46072,46072,46067,46067,46061
23005,3704,23005,23005,0,23005,0,68716500000,0,23005,23005,23005,1,0,0,0,0,0
38259,2368,2711,38259,0,34943,3316,2.6079e+18,1471.97,7782.44,38259,432,449,35548,35548,35383,35321,34929
31305,247,278,0,31305,30729,576,2.69333e+16,123.748,2067.96,31305,100,111,31027,31024,30988,30855,30506
43912,227,302,0,43912,43204,708,2.60732e+16,147.581,2316.66,43912,104,112,43610,43571,42451,42056,39554
13891,1158,1965,12425,1466,8346,5545,1.9893e+18,776.767,4279.74,13891,313,336,11834,10667,10384,10404,9316
5440,1030,1252,3268,2172,0,5440,5.0589e+18,238.559,2144.78,5440,155,196,4188,4135,4153,4163,3702
48684,82,323,0,48684,47997,687,2.59937e+16,174.409,2548.77,48684,119,128,47836,47082,40658,36519,27340
1866,173,608,1146,720,1146,720,1.88572e+18,144.615,942.138,1866,96,109,1202,1016,828,708,447
40892,512,3013,23974,16918,0,40892,4.77573e+18,1009.77,8203.07,40892,400,506,35860,33279,23651,21207,10554
11090,951,1195,3646,7444,0,11090,3.46204e+13,351.49,2931.39,11090,249,233,9895,9889,9837,9831,9004
26968,2277,2577,0,26968,0,26968,2.3027e+18,793.418,6384.74,26968,417,502,24391,24275,24234,23877,23667
13639,442,1239,0,13639,4198,9441,8.2342e+15,300.272,3108.3,13639,187,247,12400,12028,11254,11420,6108
3454,556,1161,3100,354,2159,1295,1.89641e+18,174.629,1757.31,3454,163,160,2293,2127,1833,1827,1501
24915,1208,2671,14586,10329,14586,10329,1.83701e+18,808.478,6344.54,24915,416,416,22203,21476,20095,19439,12728
36217,2754,3570,21768,14449,0,36217,4.90342e+18,681.922,8619.64,36217,361,569,32647,32628,32335,32369,29220
3087,39,134,0,3087,2984,103,2.50697e+16,36.2815,450.901,3087,39,38,2940,2893,2598,2519,1725
46124,2244,3008,0,46124,14503,31621,9.0061e+15,583.476,8950.84,46124,389,633,43116,43091,42749,42647,35229
35008,31,58,34053,955,35008,0,1.01983e+14,19.7836,696.264,35008,28,26,34950,34949,33572,33571,28092
4010,33,126,0,4010,3986,24,2.82481e+16,35.8738,468.692,4010,46,35,3854,3785,3245,2945,2071
8618,5195,8618,8618,0,0,8618,268404000,0,8618,8618,8618,1,0,0,0,0,0
24400,1323,2648,14084,10316,14084,10316,1.71193e+18,818.319,6026.92,24400,332,410,21752,21044,20509,20516,11549
10815,1758,2274,10815,0,9685,1130,2.21987e+18,526.185,4101.12,10815,317,297,8541,8539,8487,8464,7960
30880,1417,1541,9314,21566,0,30880,3.67306e+13,550.138,5128.57,30880,411,305,29339,29337,29309,29311,28912
37583,253,326,0,37583,37113,470,2.578e+16,144.036,2204.12,37583,98,115,37257,37243,36701,36453,35033
41779,189,297,0,41779,40978,801,2.6385e+16,161.692,2323.03,41779,101,114,41460,41363,40011,39453,36122
7510,366,422,7510,0,7510,0,3.81598e+18,211.178,1403.69,7510,116,117,7088,7081,7040,7028,6671
24406,551,1573,6619,17787,0,24406,3.57218e+13,531.762,4611.24,24406,419,279,22546,21944,19931,20037,13381
10349,1081,1659,6090,4259,0,10349,5.01183e+18,303.543,3253.73,10349,235,206,8690,8640,8476,8443,5684
31721,37,56,31268,453,31721,0,1.02178e+14,17.3962,640.313,31721,25,27,31665,31665,30641,30644,26987
11185,1258,1433,0,11185,0,11185,2.24901e+18,435.94,3179.87,11185,281,225,9752,9752,9687,9667,9523
31820,1496,2870,18598,13222,18598,13222,1.82113e+18,779.256,7331.73,31820,464,395,28950,28827,25547,24491,15738
36327,191,744,36327,0,36327,0,4.10481e+18,343.748,3505.75,36327,197,213,34357,32078,21643,20049,14489
34829,2315,3846,34829,0,31315,3514,2.23904e+18,1064.79,8664.13,34829,406,568,30983,30333,28960,28493,25451
17163,1223,1722,9390,7773,0,17163,4.54285e+18,434.16,3876.63,17163,266,306,15441,15322,15192,15155,10470
13424,87,233,0,13424,13099,325,2.58461e+16,99.5576,1219.37,13424,74,76,13124,12899,11772,11361,9133
47611,157,2619,13295,34316,0,47611,3.65312e+13,697.328,8237.07,47611,450,473,39668,33974,27368,21715,7096
5265,766,1083,3235,2030,3235,2030,1.80789e+18,250.451,1980.27,5265,184,158,4182,4179,3938,3741,3183
37580,2707,3040,21274,16306,0,37580,4.40496e+18,913.461,7692.79,37580,483,328,34540,34356,34169,34199,33274
49151,1184,2873,15372,33779,0,49151,3.57342e+13,707.828,8741.42,49151,523,438,46278,45610,38261,38002,25387
3718,66,959,2239,1479,0,3718,5.07811e+18,154.457,1592.4,3718,160,146,2376,1747,1426,1323,334
45730,544,2749,0,45730,14089,31641,9.02225e+15,643.149,8218.95,45730,466,395,42341,40519,28334,25956,14563
42268,42,2113,23639,18629,0,42268,4.14944e+18,1127.4,6715.22,42268,389,453,24018,13383,9125,10164,1510
9625,1061,1109,0,9625,2880,6745,9.1732e+15,346.146,2647.96,9625,226,186,8516,8512,8515,8514,8412
7770,188,448,7770,0,7770,0,4.2327e+18,239.692,1477.45,7770,118,120,7106,6482,4911,4848,4216
16029,293,689,16005,24,16019,10,4.17588e+18,299.224,2366.73,16029,165,168,15207,14755,11511,11577,10427
14737,892,907,0,14737,4857,9880,8.46039e+15,344.963,2817.39,14737,232,217,13830,13830,13828,13830,13810
16086,630,1702,9506,6580,9506,6580,1.79241e+18,499.941,4007.13,16086,345,244,14330,13777,12180,10934,7293
37176,562,685,37176,0,37176,0,4.28305e+18,341.377,3455.85,37176,212,207,36491,36467,35644,35512,35547
47117,318,4183,47117,0,42223,4894,2.93671e+18,1413.14,10497.7,47117,528,455,35637,27420,16725,10950,6391
22793,2530,3145,20655,2138,13619,9174,2.0332e+18,862.819,6832.43,22793,477,368,19648,19615,19109,19103,16970
4421,790,902,2685,1736,0,4421,4.84665e+18,240.381,1634.78,4421,232,115,3519,3486,3477,3477,3271
14902,152,676,14902,0,14902,0,4.59673e+18,305.339,2293.63,14902,161,164,13104,11121,6850,6372,4169
13362,364,2116,13362,0,11819,1543,2.11184e+18,580.162,4230.96,13362,290,366,10426,8452,4199,3021,2745
40684,99,326,0,40684,39898,786,2.64434e+16,147.8,2319.42,40684,109,112,40024,39321,34384,31942,24598
2968,46,614,0,2968,844,2124,9.36046e+15,112.36,1137.24,2968,107,150,2065,1722,1510,1548,403
11799,319,2433,11799,0,10459,1340,2.98604e+18,335.797,4351.55,11799,272,299,9073,7709,3914,2631,2389
39038,219,925,39038,0,39038,0,4.07361e+18,371.357,3845.88,39038,219,222,36958,34378,23685,22934,16573
19100,24,63,18691,409,19094,6,1.03011e+14,19.4098,574.724,19100,25,27,19034,19016,17598,17621,11634
38853,61,86,38093,760,38841,12,1.03562e+14,20.2377,795.453,38853,29,32,38767,38767,37741,37743,33520
12334,1846,2748,12334,0,10844,1490,1.76387e+18,522.88,4826.03,12334,352,299,9586,9387,9145,9212,7931
3301,557,923,0,3301,0,3301,2.59134e+18,143.752,1481.29,3301,150,151,2378,2303,2235,1923,1720
29606,1117,2929,0,29606,0,29606,2.33695e+18,500.542,6952.97,29606,277,474,26677,26408,25847,25906,17440
33346,67,190,0,33346,32902,444,2.47035e+16,140.545,1617.92,33346,98,98,32699,31943,28764,26783,20465
22097,403,2891,22097,0,19659,2438,2.47268e+18,682.335,6265.71,22097,366,311,17127,13167,10935,9844,3132
11378,1351,1581,7065,4313,7065,4313,1.89121e+18,547.358,3380.42,11378,320,239,9797,9794,9747,9752,9324
1443,72,299,378,1065,0,1443,4.48664e+13,47.034,521.172,1443,121,56,1131,1029,844,864,519
36157,429,2220,20575,15582,20575,15582,1.65301e+18,1076.49,6600.58,36157,455,344,31253,28963,24986,21268,8468
27040,2676,3543,27040,0,24267,2773,2.34149e+18,689.682,7288.73,27040,403,357,23497,23354,23175,23148,21019
17662,2673,2805,10402,7260,0,17662,4.41464e+18,336.771,5467.89,17662,403,302,14857,14853,14856,14855,14403
34959,5,283,0,34959,34299,660,2.51632e+16,149.9,1985.59,34959,109,110,27052,23225,21585,19261,11898
32046,2209,3519,18876,13170,0,32046,4.73202e+18,910.275,8108.35,32046,486,559,28527,27897,27128,26956,21639
7094,860,1676,7094,0,6287,807,2.72107e+18,350.033,2908.74,7094,317,195,5418,5171,5037,5066,3716
15458,519,1784,4344,11114,0,15458,3.59487e+13,365.874,4059.96,15458,286,245,13601,13040,11412,11542,5725
2001,17,19,1951,50,2001,0,1.11127e+14,10.7266,131.09,2001,15,12,1982,1982,1978,1977,1967
6377,1,26,6275,102,6377,0,1.09024e+14,15.1543,255.241,6377,17,18,2473,2473,2473,2473,2473
31978,892,1865,0,31978,9908,22070,9.2359e+15,582.128,5809.06,31978,322,377,30113,29512,27209,27243,21061
2320,240,813,2100,220,1438,882,2.01785e+18,171.439,1230.03,2320,107,130,1473,1199,1064,1024,659
44009,1081,3730,44009,0,39732,4277,2.03156e+18,1028.59,9366.28,44009,506,482,39684,37619,29098,29105,21494
40243,741,4202,36376,3867,23352,16891,1.92307e+18,1021.92,9990.92,40243,462,496,34496,31330,17586,16023,9126
4557,11,24,4451,106,4557,0,1.0797e+14,13.4501,214.085,4557,17,17,4506,4467,4023,4025,3323
41107,1872,2723,12895,28212,0,41107,3.37109e+13,626.49,7679.77,41107,466,381,38384,38265,36687,36791,28977
44036,2908,3583,25843,18193,25843,18193,1.70542e+18,920.218,9259.47,44036,592,415,40453,40447,40176,40248,38702
9173,518,1038,2739,6434,0,9173,3.60977e+13,388.423,2490.17,9173,230,258,8080,7761,7587,7572,4655
21400,35,40,21017,383,21400,0,9.79509e+13,20.4511,503.22,21400,21,22,21360,21360,20863,20863,20133
23600,1169,1771,7197,16403,0,23600,3.53575e+13,509.926,4922.6,23600,367,348,21829,21641,20779,20851,17439
7470,419,506,7460,10,7470,0,4.45922e+18,245.949,1538.19,7470,121,121,6964,6944,6843,6850,6727
6867,166,1444,4144,2723,4144,2723,1.83996e+18,238.569,2535.01,6867,222,177,4978,4139,3486,2938,1228
18087,1245,1995,0,18087,0,18087,2.42059e+18,904.1,4652.53,18087,353,315,15945,15095,15017,13276,11881
20784,2224,3434,20784,0,18854,1930,2.0017e+18,607.167,6611.63,20784,350,414,17350,17172,16692,16687,14404
8554,753,1049,4545,4009,4545,4009,1.46001e+18,144.613,2276.08,8554,154,194,7505,7503,7424,7451,7023
42515,2562,3118,25559,16956,0,42515,4.86388e+18,1123.34,8385.3,42515,573,457,39397,39002,38746,38717,36817
17775,615,1483,5390,12385,0,17775,3.61403e+13,501.54,3978.29,17775,296,287,16095,15327,14105,14203,9244
17675,389,1963,9813,7862,0,17675,4.33589e+18,541.878,4271.47,17675,325,243,15377,14644,11507,10767,3820
36364,1576,3638,21736,14628,0,36364,4.6763e+18,844.1,8616.04,36364,607,411,32726,31686,27048,26212,17541
24963,1001,1753,0,24963,7924,17039,9.09718e+15,623.418,5019.44,24963,382,335,23210,22659,21634,21722,16150
13357,21,34,13133,224,13357,0,1.0151e+14,17.4255,381.506,13357,22,22,13322,13314,12596,12596,10309
38439,4630,4729,0,38439,0,38439,2.21447e+18,838.738,9949.24,38439,433,674,33710,33710,33688,33710,33495
14340,1081,1357,4337,10003,0,14340,3.60428e+13,295.364,3397.79,14340,318,277,12983,12980,12847,12871,12216
41742,559,3753,0,41742,0,41742,2.27929e+18,1228.75,9410.89,41742,567,533,35107,31733,20016,14849,11246
33367,70,265,0,33367,32747,620,2.63314e+16,141.005,1934.1,33367,98,110,32616,31901,27923,25941,18392
41740,306,2660,12993,28747,0,41740,3.59651e+13,554.831,7611.53,41740,446,402,37470,33177,21418,16415,7225
47875,1015,2758,28778,19097,0,47875,4.91938e+18,1163.28,8795.75,47875,500,465,43860,40455,38613,37497,21644
17949,85,235,0,17949,17600,349,2.48663e+16,78.8988,1330.62,17949,70,66,17659,17437,15830,14925,10980
12958,998,2004,0,12958,0,12958,2.21713e+18,456.409,4112.72,12958,264,356,10954,10738,9812,9975,8142
28681,232,3520,17535,11146,0,28681,4.90527e+18,631.882,7641.33,28681,548,428,22137,18317,12639,10880,4793
29018,307,1780,0,29018,9177,19841,9.10842e+15,439.347,4991.58,29018,321,367,26612,23633,14322,13642,7061
11926,1447,2176,11926,0,10743,1183,2.48642e+18,458.215,4064.49,11926,282,254,9750,9702,9279,9147,7965
47898,296,3318,0,47898,0,47898,2.46656e+18,1333.48,9235.2,47898,474,573,38431,32054,23930,17468,6905
27778,658,1631,8254,19524,0,27778,3.65713e+13,554.501,4779.35,27778,415,365,25989,25402,22980,22882,17550
35402,70,281,0,35402,34803,599,2.61144e+16,134.831,2054.44,35402,95,105,34678,33867,29562,27112,19135
28796,1162,1884,16168,12628,16168,12628,1.58178e+18,1024.01,5417.83,28796,348,311,26503,25009,25063,24843,17413
43574,569,4572,38860,4714,26278,17296,1.95886e+18,1380.37,10733.3,43574,502,582,36060,31089,17505,14664,8745
21759,1309,1661,0,21759,6281,15478,9.42782e+15,546.816,4619.31,21759,374,280,20098,19957,19883,19838,18575
40221,1714,2448,0,40221,0,40221,2.46365e+18,1079.32,7357.26,40221,416,504,37773,36380,36904,36346,30281
10980,730,2231,10980,0,9721,1259,2.20918e+18,741.135,4147.31,10980,278,335,8379,7227,5887,5508,4099
28247,128,1888,0,28247,9123,19124,8.7436e+15,528.01,5522.45,28247,356,507,23321,20730,12444,12560,2746
45557,3216,4210,41071,4486,26085,19472,1.9019e+18,1477.57,10165.7,45557,486,571,41347,40524,40596,40768,37157
14154,1325,2186,8145,6009,8145,6009,1.82787e+18,338.019,4532.93,14154,230,452,11968,11916,11540,11662,8179
28972,1699,3055,28972,0,26053,2919,2.27213e+18,1232.88,7104.97,28972,310,428,25748,24386,24513,23577,19199
27866,71,98,27366,500,27866,0,1.06566e+14,17.6594,740.54,27866,29,30,27768,27768,27147,27147,23682
10081,501,1518,10081,0,9112,969,1.44175e+18,828.694,3240.34,10081,261,260,7645,6519,4689,4196,3459
21912,627,1576,6780,15132,0,21912,3.58025e+13,496.163,4569.74,21912,310,323,20181,19504,17352,17479,9384
6236,760,876,0,6236,1807,4429,9.89803e+15,232.698,1894.32,6236,197,201,5360,5280,5341,5340,4979
48056,22,109,47245,811,48050,6,1.01529e+14,20.9424,949.746,48056,33,33,47938,47904,43291,42629,26879
48190,2446,5608,42935,5255,28291,19899,1.98026e+18,1266.57,12743.3,48190,601,509,42582,41610,33686,32605,24244
41543,2298,2300,0,41543,12149,29394,9.41586e+15,800.315,7045.38,41543,511,495,39243,39243,39243,39243,39241
35733,564,2635,0,35733,0,35733,2.42252e+18,947.352,7400.68,35733,376,457,30569,27950,22064,19391,7994
23388,1918,2730,20634,2754,13701,9687,2.00909e+18,754.387,6309.8,23388,363,470,20658,20634,20006,20123,16960
6062,6,26,5920,142,6062,0,1.02709e+14,12.97,243.183,6062,17,18,5895,5789,5139,5108,3493
34231,3246,3596,34231,0,31137,3094,2.37432e+18,974.562,8288.1,34231,448,397,30635,30589,30579,30585,29614
3812,34,141,0,3812,3674,138,2.37231e+16,45.0268,512.591,3812,43,43,3628,3543,3162,3013,1915
38128,2460,4985,38128,0,34458,3670,2.21466e+18,909.248,10497.2,38128,414,661,33143,32829,32093,31373,18727
19371,11,34,19002,369,19371,0,9.99717e+13,18.7639,460.727,19371,22,25,19225,19116,17056,16862,12693
34192,2387,3053,20371,13821,0,34192,4.86976e+18,946.705,7829.83,34192,551,377,31139,31103,30513,30398,27215
42584,100,3346,25734,16850,0,42584,4.53463e+18,954.733,8355.1,42584,525,454,29612,22725,16046,13823,934
9277,642,1754,0,9277,0,9277,2.49871e+18,295.572,3193.81,9277,263,261,7523,7075,6605,6480,3083
10121,817,1051,2829,7292,0,10121,3.64664e+13,264.969,2559.14,10121,246,226,9070,9069,8905,8919,8030
46107,1792,2690,46107,0,41573,4534,2.96139e+18,1216.23,8287.59,46107,486,413,43412,42119,41312,40885,36770
19456,64,202,0,19456,18781,675,2.57513e+16,116.8,1279.49,19456,67,76,19099,18892,16814,15069,11370
31809,1460,1473,10368,21441,0,31809,3.41035e+13,607.847,4966.31,31809,324,359,30336,30336,30336,30336,30330
45222,241,4012,40702,4520,26127,19095,1.96148e+18,1581.67,10024.3,45222,476,604,35098,31090,13698,10962,3804
10421,1207,1211,3020,7401,0,10421,3.91702e+13,299.377,2801.84,10421,263,294,9210,9210,9210,9210,9209
33716,20274,33716,0,33716,33716,0,4095.88,0,33716,33716,33716,1,0,0,0,0,0
27358,2839,2892,27358,0,24764,2594,1.7253e+18,928.879,6448.34,27358,378,343,24466,24427,24466,24466,24403
37008,2118,2199,11480,25528,0,37008,3.57211e+13,653.121,6634.05,37008,371,423,34809,34808,34793,34783,34633
5616,293,1187,5011,605,3354,2262,1.88964e+18,264.713,2096.82,5616,186,141,4221,3612,3093,2426,1113
2069,359,741,2069,0,1788,281,2.76272e+18,127.594,1099.02,2069,140,92,1328,1224,1276,1223,871
45966,14,84,45169,797,45966,0,1.005e+14,23.6201,909.3,45966,29,32,45739,45596,41656,41378,26197
4913,442,867,4527,386,2766,2147,1.83079e+18,147.394,1606.87,4913,141,121,4046,3993,3363,3621,1607
25446,1376,2955,25446,0,22859,2587,2.60212e+18,921.062,6856.12,25446,378,354,22381,21185,20893,19785,15672
25848,1889,3328,25828,20,23077,2771,1.60276e+18,904.777,7260.74,25848,499,310,22520,21924,20600,20433,16464
9737,571,655,0,9737,3080,6657,7.08204e+15,150.295,1775.77,9737,148,160,9082,9067,9079,9070,8197
34443,537,2621,0,34443,0,34443,2.39506e+18,1117.48,6976.52,34443,404,444,29938,27904,23557,19132,6258
12550,944,1077,0,12550,3854,8696,8.6282e+15,297.106,2735.17,12550,215,180,11473,11456,11284,11328,10979
48654,334,1014,48654,0,48654,0,3.78868e+18,371.514,4305.3,48654,227,236,47473,46460,33122,32477,29218
22491,1851,2282,13530,8961,13530,8961,1.85264e+18,730.695,5462.39,22491,306,362,20209,20180,19886,20011,18831
27196,2061,3281,16260,10936,0,27196,4.99962e+18,873.757,7252.1,27196,451,471,23915,23454,22669,22526,18103
16267,861,1492,14567,1700,9666,6601,2.05651e+18,882.683,3976.81,16267,304,273,14003,11609,12253,12342,10307
41771,714,2283,12493,29278,0,41771,3.41549e+13,785.312,7146.93,41771,426,432,38953,37978,34508,34889,19145
6361,1130,1342,0,6361,0,6361,2.39286e+18,263.554,2415.98,6361,299,135,5019,5015,4979,4661,4729
23016,455,1532,0,23016,7130,15886,8.21643e+15,456.788,4282.68,23016,320,341,21306,20664,16851,16881,9140
19087,236,1845,0,19087,0,19087,2.42078e+18,720.876,4598.47,19087,361,327,15475,13217,10279,7410,3797
39337,987,1686,11175,28162,0,39337,3.73733e+13,845.888,5724.52,39337,399,327,37485,36521,34840,35014,28057
23536,1730,2564,14139,9397,0,23536,4.79221e+18,538.422,5949.11,23536,307,439,20972,20965,20562,20625,16244
20038,882,1070,0,20038,5855,14183,9.3708e+15,372.931,3196.51,20038,222,223,18968,18965,18815,18840,18044
4683,145,537,0,4683,1277,3406,9.41774e+15,201.606,1260.74,4683,168,112,3819,3261,3326,3357,1805
15557,636,1719,4819,10738,0,15557,3.60654e+13,285.771,4010.35,15557,373,209,13838,13567,10423,10302,6552
16827,327,2292,15188,1639,10174,6653,1.9319e+18,683.398,4969.18,16827,312,341,12842,10640,7064,6602,4854
44625,66,78,43785,840,44625,0,9.83225e+13,21.4277,773.626,44625,29,31,44547,44547,43985,43986,43651
40325,176,330,0,40325,39654,671,2.65394e+16,150.359,2367.53,40325,107,112,39979,39787,36599,35111,25649
37457,853,924,37410,47,37457,0,4.22593e+18,342.739,3746.37,37457,223,209,36533,36530,36382,36384,36001
10878,712,922,3373,7505,0,10878,3.80289e+13,396.208,2538.08,10878,255,286,9956,9890,9812,9830,9316
29130,383,1886,9393,19737,0,29130,3.38877e+13,441.738,5207.57,29130,353,416,26731,25189,19504,19277,12440
34282,1555,2323,21170,13112,21170,13112,1.88193e+18,952.598,6119.39,34282,387,396,31959,31356,31048,31211,26292
21057,293,2355,21057,0,18939,2118,1.26102e+18,507.29,5487.8,21057,283,369,16906,14584,10364,9849,5352
23781,1354,3101,14579,9202,14579,9202,1.73653e+18,682.027,6722.05,23781,337,459,20680,19915,19131,19118,13193
15322,142,1348,4833,10489,0,15322,3.45045e+13,402.233,3553.8,15322,302,271,12736,11211,7544,7145,3018
30544,3048,3170,0,30544,0,30544,2.38055e+18,774.436,7528.53,30544,387,384,27374,27364,27370,27374,27279
36215,757,1867,11215,25000,0,36215,3.52854e+13,665.044,5870.43,36215,422,356,34092,33379,30536,30672,20298
22774,2034,2121,0,22774,0,22774,2.30914e+18,754.618,5403.51,22774,324,375,20653,20653,20623,20595,20404
5906,113,158,0,5906,5775,131,2.48286e+16,65.7765,642.085,5906,58,54,5748,5736,5481,5350,4861
40488,1692,3101,24524,15964,0,40488,4.91276e+18,929.601,8176.15,40488,453,490,37387,36334,34421,33450,24831
4374,678,741,1370,3004,0,4374,3.05067e+13,110.937,1406.95,4374,177,104,3633,3633,3617,3611,3581
45504,729,974,45504,0,45504,0,4.11875e+18,372.1,4173.24,45504,222,224,44530,44515,42288,42154,38433
41674,557,4996,24662,17012,24662,17012,1.83398e+18,885.404,11003.6,41674,657,512,34960,31702,22410,19813,9075
5697,118,166,0,5697,5614,83,2.65363e+16,68.4134,671.373,5697,54,59,5531,5518,5293,5319,4808
7757,201,209,0,7757,7584,173,2.6837e+16,71.6309,899.559,7757,65,59,7548,7548,7547,7548,7509
7430,176,200,0,7430,7252,178,2.57197e+16,71.0701,853.345,7430,54,57,7230,7229,7223,7206,7092
16233,1243,2338,9806,6427,0,16233,4.97184e+18,579.832,4875.67,16233,307,310,13895,13498,12888,12596,9400
7738,137,1131,7738,0,6918,820,1.77727e+18,193.445,2277,7738,204,189,6313,5006,2057,1826,1065
29914,616,2128,9092,20822,0,29914,3.62333e+13,590.424,5644.05,29914,320,319,27610,26911,20180,20053,11083
32691,2215,2514,20062,12629,0,32691,4.83275e+18,852.558,6573.99,32691,405,382,30177,30151,30098,30086,29263
41070,3021,3993,0,41070,0,41070,2.42194e+18,1056.39,9493.74,41070,504,602,37077,36921,36508,36573,32493
31955,800,5110,31955,0,28450,3505,1.31068e+18,1144.75,10141.9,31955,497,580,25448,23366,14382,11281,5757
23979,45,2641,21573,2406,13316,10663,1.94365e+18,837.159,6123.3,23979,321,366,12489,6793,4265,4009,524
18291,2732,3636,16236,2055,10847,7444,2.03855e+18,546.214,6552.75,18291,302,461,14655,14621,14192,14291,12949
33799,511,881,33799,0,33799,0,4.07341e+18,345.87,3574.25,33799,212,209,32918,32818,27848,27598,27850
33627,464,2287,0,33627,10596,23031,8.99911e+15,453.404,6225.02,33627,364,315,31146,29809,18699,17136,8744
14097,140,195,0,14097,13840,257,2.59821e+16,95.1466,1081.28,14097,71,74,13902,13848,13288,13182,12153
33740,677,2162,10739,23001,0,33740,3.45149e+13,547.502,6420.8,33740,467,318,31510,30609,24452,24535,17131
24408,1088,2647,14331,10077,14331,10077,1.87447e+18,732.633,6031.57,24408,449,326,21721,20909,19966,18894,12511
12651,120,229,0,12651,12394,257,2.6178e+16,88.8727,1196.34,12651,71,79,12422,12340,11146,11353,8985
12026,199,298,12026,0,12026,0,4.36403e+18,205.862,1523.33,12026,136,132,11585,10853,10515,10499,9150
4023,161,397,4023,0,4023,0,4.34599e+18,199.297,1051.02,4023,96,96,3475,3018,2500,2437,2197
8015,152,724,0,8015,2615,5400,9.08188e+15,383.96,1983.27,8015,224,213,6390,5476,4224,4310,2041
43475,1477,2457,0,43475,13105,30370,9.17798e+15,771.509,7752.59,43475,430,575,41018,40533,39744,39667,32334
20195,307,624,20195,0,20195,0,4.11527e+18,284.247,2500.94,20195,178,175,19544,18862,15954,15854,16011
13726,1373,1960,8119,5607,0,13726,4.5244e+18,430.387,4084.24,13726,306,340,11766,11752,11617,11478,10553
16669,1075,1605,9848,6821,0,16669,4.63926e+18,645.65,4061.04,16669,258,338,15038,14264,14402,14320,11878
24186,116,2385,7531,16655,0,24186,3.54592e+13,506.237,5849.76,24186,305,445,19668,17461,11077,5787,2356
46400,81,3373,0,46400,0,46400,2.30815e+18,991.731,9209.43,46400,384,588,32056,23257,16042,11627,2172
20141,12771,20141,20141,0,0,20141,15.9992,0,20141,20141,20141,1,0,0,0,0,0
37339,2278,4276,37339,0,33208,4131,2.45809e+18,1158.24,9788.05,37339,433,570,33063,32305,30341,28827,20633
11797,75,191,0,11797,11583,214,2.63017e+16,96.999,1023.24,11797,66,72,11521,11307,10383,9864,7952
19454,527,661,19444,10,19454,0,4.10519e+18,305.418,2571.23,19454,170,173,18793,18790,18184,18121,17718
6144,454,462,6144,0,6144,0,4.39671e+18,246.897,1359.67,6144,115,117,5682,5682,5677,5677,5673
46852,3141,4219,0,46852,0,46852,2.19492e+18,1423.42,10358,46852,596,602,42633,41869,41122,38827,34902
4315,25,910,2487,1828,0,4315,5.2348e+18,248.551,1662.46,4315,148,205,2444,1705,1409,1240,172
44461,739,2879,25364,19097,25364,19097,1.77136e+18,1625.28,8241.64,44461,457,486,39070,36638,29894,26919,12588
22571,39,55,22123,448,22571,0,1.0009e+14,16.8807,541.249,22571,24,24,22516,22516,21877,21878,19916
16988,1146,1368,4897,12091,0,16988,3.58704e+13,424.272,3639.76,16988,303,298,15620,15589,15568,15586,14712
20143,22,38,19708,435,20143,0,9.85856e+13,20.6805,516.479,20143,24,24,20101,20090,19067,18990,15569
24598,1498,1820,0,24598,7530,17068,8.98949e+15,522.902,5098.13,24598,485,451,22778,22661,22163,22184,20809
16554,377,2407,0,16554,0,16554,2.42575e+18,646.051,4988.76,16554,358,306,13396,11634,8094,6748,3667
4498,325,450,4045,453,2230,2268,1.8492e+18,136.584,1093.15,4498,113,106,4048,4045,4040,4038,3788
5678,476,660,1673,4005,0,5678,3.76551e+13,250.951,1576.73,5678,179,156,5018,4876,4850,4845,4216
47672,3451,4412,47625,47,43310,4362,2.14861e+18,1348.58,10663.7,47672,471,595,43260,43001,42708,42568,38826
4768,921,1113,4308,460,2738,2030,1.91812e+18,265.214,1983.27,4768,155,214,3655,3581,3574,3593,3503
41909,33,90,41056,853,41909,0,1.01847e+14,21.4877,844.072,41909,30,30,41819,41804,38730,38508,26320
13865,224,570,13865,0,13865,0,4.8814e+18,299.975,2095.16,13865,156,147,12921,11927,8471,8185,7718
32625,165,282,0,32625,32025,600,2.589e+16,112.259,2097.81,32625,88,91,32343,32255,30903,30775,27193
9748,234,499,9748,0,9748,0,4.2683e+18,266.712,1714.92,9748,141,128,9129,8628,6704,6684,5756
39986,350,1906,0,39986,11519,28467,9.48959e+15,888.606,6511.78,39986,491,404,35658,32748,26199,26304,10178
22001,195,659,22001,0,22001,0,4.03067e+18,293.385,2668.23,22001,186,181,20424,18466,13392,12981,10803
10778,752,1141,6700,4078,0,10778,4.70613e+18,330.012,2680.78,10778,192,178,9637,9636,8514,8382,7499
19130,92,2018,11597,7533,11597,7533,1.87014e+18,468.536,4765.03,19130,260,360,12902,10113,7895,6030,2069
3622,558,798,2273,1349,0,3622,4.29783e+18,311.09,1476.94,3622,164,137,2824,2511,2660,2578,2331
48364,25,100,47205,1159,48364,0,1.05719e+14,18.8713,896.865,48364,33,33,48264,48250,43914,43425,29629
44207,155,245,0,44207,43056,1151,2.51869e+16,138.203,2001.56,44207,101,106,43953,43771,41842,41703,38609
45503,526,1600,0,45503,14741,30762,8.98316e+15,485.555,5631.3,45503,374,383,43759,42928,34013,34402,25689
33225,8,9,31148,2077,33097,128,0.000240783,0.999729,543.03,33225,9,1,33216,33216,33216,33216,33216
6795,10,23,6581,214,6795,0,9.91275e+13,8.74584,227.746,6795,14,16,6763,6753,6105,6121,6108
19798,596,2002,0,19798,0,19798,2.00965e+18,578.776,4702.64,19798,286,260,17466,16578,13900,10211,4349
35785,5780,35785,0,35785,0,35785,1048550,0,35785,35785,35785,1,0,0,0,0,0
25318,1109,1359,0,25318,6898,18420,9.45853e+15,657.707,4341.28,25318,303,302,23959,23447,23808,23767,22547
6649,319,971,5890,759,3904,2745,2.01662e+18,323.136,2016.39,6649,219,147,5322,4027,3859,3842,3521
1959,10,22,1923,36,1959,0,1.06757e+14,11.0602,144.104,1959,15,13,1928,1918,1790,1746,1412
45677,309,1093,45677,0,45677,0,4.06487e+18,394.751,4339.52,45677,232,227,44255,42800,29563,28300,22036
45650,1635,2407,14399,31251,0,45650,3.5223e+13,515.474,7387.43,45650,453,410,43243,43231,39470,39796,28451
29883,1075,2768,18010,11873,0,29883,5.04751e+18,927.674,6936.38,29883,357,459,26832,26042,24490,23946,12732
48663,2542,4043,48663,0,43542,5121,1.82748e+18,1093.94,10320.3,48663,421,607,44620,44006,41456,40431,31783
49434,225,2161,14879,34555,0,49434,3.69027e+13,699.703,7335.42,49434,446,407,43738,38783,30276,25571,13182
27440,38,807,27440,0,27440,0,4.14663e+18,323.96,3165.26,27440,203,195,17820,11853,7818,7559,2810
23942,1663,3025,0,23942,0,23942,2.36648e+18,720.397,6798.5,23942,351,519,20917,20079,19657,19654,11658
37840,2219,2352,0,37840,11911,25929,9.19926e+15,554.213,7083.74,37840,360,610,35488,35488,35439,35430,34923
42296,53,330,0,42296,41579,717,2.5456e+16,155.003,2343.9,42296,117,117,40898,39529,33168,30457,20364
24685,10,54,24385,300,24675,10,1.01347e+14,23.6147,566.954,24685,27,26,24381,24164,21679,21251,14178
997,7,16,981,16,997,0,2.1717e+18,15.7432,126.3,997,16,16,396,0,215,369,396
23515,187,2781,20789,2726,13984,9531,1.98468e+18,601.172,6282.1,23515,438,275,16743,13268,7862,6280,2393
38459,1429,1749,23233,15226,23233,15226,1.83206e+18,1093.34,6208.64,38459,448,381,36710,36011,36326,36470,33646
29474,385,3321,17599,11875,17599,11875,1.82965e+18,584.388,7489.01,29474,475,454,25032,21516,15474,12061,3809
14283,16,237,0,14283,14012,271,2.59111e+16,97.7624,1303.02,14283,78,78,13049,12488,10752,9062,5646
9094,491,1681,9094,0,8138,956,2.04953e+18,216.964,2976.57,9094,224,266,7413,7155,3040,3369,2473
2033,280,599,1159,874,1159,874,2.15231e+18,68.9331,891.145,2033,128,74,1434,1377,1400,1398,983
35797,3465,3880,21380,14417,0,35797,4.86058e+18,964.551,8989.21,35797,558,458,31917,31882,31763,31782,29591
12894,966,1265,0,12894,3864,9030,9.17188e+15,339.53,3148.75,12894,267,257,11629,11627,11317,11327,9906
41710,15474,41710,0,41710,41710,0,4095.9,0,41710,41710,41710,1,0,0,0,0,0
9876,170,1151,5485,4391,0,9876,4.28107e+18,354.481,2670.71,9876,198,240,8136,7244,5584,5327,2415
41787,1785,2682,0,41787,0,41787,2.26467e+18,749.619,7595.98,41787,398,486,39105,39076,37709,37675,27837
16735,20,576,16735,0,16735,0,3.96574e+18,277.146,2276.7,16735,168,153,8592,4369,3458,3016,985
657,7,8,647,10,657,0,1.03251e+14,6.91476,62.1428,657,8,8,646,639,627,626,646
45532,243,3440,45532,0,41334,4198,2.64628e+18,1448.16,9182.91,45532,407,517,36760,33247,14391,12633,3805
29730,1725,2179,8628,21102,0,29730,3.79181e+13,516.1,5867.43,29730,400,383,27551,27547,27342,27301,24833
42558,94,2064,24947,17611,0,42558,4.40476e+18,773.85,6772.76,42558,354,388,30027,21456,12927,14099,3924
18889,1061,4207,18889,0,16826,2063,2.18982e+18,561.049,7281.75,18889,420,468,14682,13803,10394,9865,5655
25924,822,945,25924,0,25924,0,4.23156e+18,366.733,3296.28,25924,201,200,24979,24961,24834,24841,24607
44983,1922,2983,40158,4825,25265,19718,1.91051e+18,1340.29,8368.72,44983,435,471,41860,40457,39116,38880,34542
17155,978,1351,5516,11639,0,17155,3.36664e+13,352.393,3648.71,17155,289,227,15804,15706,15697,15701,14066
27610,344,717,27610,0,27610,0,4.23092e+18,339.18,3093.68,27610,191,198,26811,26309,21880,21211,19516
15926,451,1125,0,15926,4853,11073,9.4897e+15,463.588,3208.54,15926,303,217,14635,13687,12427,12490,9492
43877,1509,2788,25811,18066,25811,18066,1.77599e+18,1062.9,8262.3,43877,407,502,41075,39846,39341,39020,28835
48591,3084,3519,44219,4372,29053,19538,1.99434e+18,1233.07,9374.93,48591,461,535,45072,45054,44921,44912,41994
1930,464,830,1930,0,1704,226,1.22707e+18,112.839,1147.97,1930,131,111,1100,1063,1017,1018,683
18505,196,247,0,18505,18204,301,2.54743e+16,109.019,1440.07,18505,77,77,18258,18237,17892,17921,17204
35548,2216,2476,20871,14677,20871,14677,1.75725e+18,812.263,6530.24,35548,404,307,33072,33021,32972,32992,32657
7488,459,882,4469,3019,0,7488,4.7272e+18,480.486,2165.91,7488,200,191,6268,5487,5266,5148,4248
23156,315,1987,13556,9600,13556,9600,1.65395e+18,568.299,5123.91,23156,340,295,18895,16535,13252,12595,6286
10092,52,149,0,10092,9818,274,2.61042e+16,82.8181,752.842,10092,56,66,9694,9343,8557,7967,6080
37246,1008,1589,0,37246,11155,26091,8.75978e+15,776.443,5426.28,37246,416,341,35494,34809,33531,33644,28020
29399,90,3531,17184,12215,0,29399,4.73933e+18,930.94,7999.44,29399,470,611,20132,15150,10910,8907,1073
47047,387,1011,47018,29,47047,0,4.6204e+18,380.608,4269.28,47047,231,242,45969,45332,32241,30857,32800
32245,2543,3444,18306,13939,18306,13939,1.67974e+18,718.653,7646.75,32245,468,461,28801,28765,28289,28379,25664
39223,123,670,39223,0,39223,0,4.21577e+18,363.141,3476.96,39223,219,218,33856,27784,19397,17738,10854
41787,985,2457,0,41787,11716,30071,9.58503e+15,610.667,7590.15,41787,407,515,39175,38600,37533,37454,19132
11322,321,1402,3213,8109,0,11322,3.81139e+13,254.42,3088.09,11322,222,248,9822,9318,8772,8755,3457
49910,145,3830,0,49910,0,49910,2.27054e+18,845.611,9622.32,49910,434,426,37122,29776,19689,13712,3256
7123,224,1401,0,7123,0,7123,2.493e+18,292.234,2569.29,7123,206,264,5390,4702,4544,4176,1229
15907,1432,1777,9385,6522,0,15907,4.82526e+18,477.086,3944.71,15907,244,317,14130,14130,14067,14078,13569
30640,844,4096,30640,0,30640,0,8.71573e+15,3548.44,11196.5,30640,4096,8,5901,0,3374,5058,5901
29314,379,3041,17747,11567,0,29314,5.06553e+18,640.31,6882.79,29314,383,525,24540,20385,15974,13738,2585
27658,300,2797,16687,10971,0,27658,4.83442e+18,919.803,6781.67,27658,365,419,21771,18525,13080,10583,4766
30870,178,316,0,30870,30181,689,2.4946e+16,127.931,2129.4,30870,105,110,30554,30440,28707,28574,24501
28703,56,293,0,28703,28165,538,2.57197e+16,141.276,1935.01,28703,96,109,27778,27107,23307,21277,13101
35283,2322,3477,35283,0,31618,3665,2.09838e+18,1019.87,8199.37,35283,386,498,31806,31715,30621,30223,27602
4741,639,684,0,4741,1283,3458,8.55829e+15,207.068,1421.59,4741,191,114,4057,4054,4046,4046,3963
27412,2483,2785,16258,11154,0,27412,4.94267e+18,753.177,6719.15,27412,387,434,24627,24627,24547,24558,23282
37364,793,1779,0,37364,11719,25645,8.70763e+15,602.655,5938.5,37364,317,348,35462,34727,33958,34088,20927
32865,1344,2716,19037,13828,19037,13828,1.80975e+18,931.449,7129.48,32865,380,363,29962,29294,28311,27599,18864
5268,15,180,0,5268,5160,108,2.66182e+16,64.5213,685.671,5268,52,56,4840,4666,3863,3065,1846
43458,1709,2423,12667,30791,0,43458,3.50997e+13,639.268,7356.66,43458,408,474,41035,40944,40656,40670,33951
36284,1383,3126,21131,15153,0,36284,4.4738e+18,859.716,7908.71,36284,508,380,32986,31719,29104,29395,21475
42298,1630,2128,0,42298,13152,29146,8.52428e+15,834.859,6747.64,42298,450,416,40170,39867,39710,39728,35537
32080,2891,3878,28390,3690,19119,12961,1.93442e+18,1081.93,8698.69,32080,498,622,28202,27807,26214,25854,24473
28896,2320,2433,17558,11338,0,28896,4.78303e+18,942.705,6527.44,28896,434,361,26463,26463,26428,26445,26356
25830,1813,1848,14835,10995,14835,10995,1.76926e+18,765.989,5104.14,25830,350,371,23982,23982,23972,23974,23953
8466,1060,1574,8466,0,7561,905,2.06184e+18,397.892,2955.05,8466,239,223,6892,6837,6700,6665,6248
14571,1010,1404,0,14571,4656,9915,9.00273e+15,433.281,3616.85,14571,350,284,13167,13006,12302,12286,10235
25521,2214,3090,22958,2563,14650,10871,1.91389e+18,625.22,6749.35,25521,399,379,22431,22422,21333,21527,17591
47961,97,102,47039,922,47961,0,1.02212e+14,20.1919,904.144,47961,32,30,47859,47859,47220,47220,46589
6681,11,32,6522,159,6681,0,1.06127e+14,13.6753,286.248,6681,20,18,6616,6573,5829,5786,4243
10231,967,1076,2847,7384,0,10231,3.54684e+13,265.866,2586.92,10231,234,166,9155,9152,9134,9133,8905
1508,190,380,0,1508,447,1061,9.34678e+15,49.3714,650.051,1508,78,82,1128,1094,1089,1080,666
38242,2047,2547,22658,15584,22658,15584,1.88994e+18,961.511,7122.54,38242,505,412,35695,35679,35517,35575,34335
32519,523,2071,0,32519,9068,23451,9.37668e+15,623.411,6198.77,32519,500,307,29972,29128,23539,23944,11088
9772,354,656,0,9772,3106,6666,8.92033e+15,414.298,2069.17,9772,218,233,8705,7566,7847,7872,5834
36919,2448,3971,33429,3490,21991,14928,1.98925e+18,966.477,9122.47,36919,604,417,32948,32865,31603,31711,27368
49022,36,42,48188,834,49022,0,9.87823e+13,20.203,728.292,49022,24,24,48980,48980,48609,48704,47702
49926,218,3496,0,49926,0,49926,2.31888e+18,1009.17,9668.27,49926,514,512,39888,33281,24535,17842,4400
17487,1153,1638,0,17487,5519,11968,8.76256e+15,342.195,4230.95,17487,372,231,15849,15828,15405,15400,13226
23893,31,48,23495,398,23893,0,9.87221e+13,20.9258,602.158,23893,26,26,23845,23841,23016,23038,20856
41095,354,2157,0,41095,12305,28790,9.25374e+15,838.639,6820.04,41095,450,434,36911,33706,25546,23492,11748
3494,648,973,0,3494,0,3494,2.34458e+18,179.215,1586.15,3494,144,169,2521,2485,2424,2459,2095
20917,18,233,0,20917,20647,270,2.65777e+16,101.614,1459.08,20917,76,75,19466,18582,15808,12761,8376
5855,332,444,5855,0,5855,0,4.10518e+18,224.557,1280,5855,108,112,5411,5341,5133,5112,5056
35715,81,341,0,35715,35102,613,2.67591e+16,142.093,2298.47,35715,100,122,35028,34450,29269,27090,18460
19634,261,523,19634,0,19634,0,4.13301e+18,297.253,2377.77,19634,170,168,18952,18425,13967,13771,11628
32484,811,2193,0,32484,0,32484,2.38976e+18,979.7,6364.77,32484,424,351,29295,27045,22125,15235,14047
22344,12142,22344,22344,0,0,22344,15.9993,0,22344,22344,22344,1,0,0,0,0,0
22993,1865,4521,22993,0,20396,2597,2.21937e+18,657.375,8207.81,22993,396,538,18472,17964,13669,13104,10154
47474,1605,2094,14347,33127,0,47474,3.6127e+13,838.289,7212.93,47474,448,423,45380,45136,44919,44888,39178
5525,48,127,0,5525,5482,43,2.568e+16,55.8002,527.126,5525,48,55,5334,5191,4753,4677,3306
14573,36,54,14341,232,14549,24,1.02098e+14,19.2658,499.102,14573,23,24,14519,14519,14026,14031,12727
1673,2,88,0,1673,1609,64,2.23969e+16,22.5146,263.938,1673,28,39,887,682,610,692,530
47915,1242,2601,15058,32857,0,47915,3.26158e+13,720.274,7971.18,47915,451,481,45314,44641,42794,42830,27204
7162,49,150,0,7162,7029,133,2.68632e+16,57.9397,724.215,7162,52,59,6941,6799,6282,6136,4887
35531,2103,2153,0,35531,0,35531,2.36191e+18,882.233,6666.13,35531,397,438,33378,33378,33356,33351,33319
45171,1507,1983,0,45171,13290,31881,8.99152e+15,776.493,6834.42,45171,494,427,43188,42954,42090,42058,37414
32936,1490,2641,19245,13691,0,32936,4.57604e+18,914.337,7060.91,32936,367,509,30295,29508,29447,29439,24508
22023,655,776,22023,0,22023,0,4.2829e+18,314.438,2846.36,22023,188,180,21247,21245,20788,20805,20699
30458,948,3696,30458,0,27464,2994,2.45916e+18,816.406,8040.07,30458,480,405,26607,25112,22022,20424,11535
39431,812,2693,0,39431,0,39431,2.25935e+18,975.371,7829.25,39431,451,413,35164,32123,25915,22446,9794
40708,2063,3053,0,40708,0,40708,2.40605e+18,1245.84,8463.77,40708,497,501,37655,36792,36052,34378,30303
41699,2185,2766,25158,16541,25158,16541,1.83946e+18,1041.95,7958.55,41699,472,479,38933,38367,37786,37949,34406
11523,205,1438,6891,4632,6891,4632,1.87888e+18,356.672,3153.91,11523,299,175,8933,7211,6745,5752,2692
48928,3286,6259,43787,5141,28565,20363,1.95535e+18,1272.13,13403.5,48928,634,576,42669,41822,33311,30966,26957
43251,65,74,42475,776,43231,20,9.63439e+13,20.7114,879.234,43251,27,29,43177,43177,42695,42710,41543
21563,1523,2299,12954,8609,12954,8609,1.98295e+18,808.752,5309.23,21563,408,314,19264,18785,18864,18992,16538
28349,1894,2805,25752,2597,16330,12019,1.94337e+18,1247.41,6727.04,28349,368,415,25474,24213,24040,24218,18906
42691,441,702,42691,0,42691,0,4.15099e+18,354.088,3672.44,42691,225,213,41989,41811,38296,38076,36510
13030,457,1265,4051,8979,0,13030,3.5464e+13,349.355,3086.15,13030,283,214,11735,11216,9488,9608,6788
8688,406,1465,0,8688,0,8688,2.24241e+18,292.039,2910.61,8688,293,227,7205,6576,5281,4496,2435
13042,903,923,0,13042,0,13042,2.3142e+18,527.267,2811.78,13042,228,232,12119,12119,12116,12116,12112
46928,1195,4807,41951,4977,26953,19975,1.94608e+18,1119.19,11103.1,46928,671,472,41567,39629,23929,22320,9979
39997,119,277,0,39997,39389,608,2.5496e+16,137.432,2027.99,39997,102,105,39577,39187,35417,33213,24716
13175,878,1848,7868,5307,7868,5307,1.85883e+18,456.349,3961.62,13175,276,290,11327,11133,9918,9702,6754
21973,158,293,0,21973,21602,371,2.73926e+16,114.203,1722.29,21973,95,83,21680,21573,20668,20469,17619
11943,1003,1915,7145,4798,7145,4798,1.86645e+18,393.758,3872.59,11943,309,285,10028,9914,8173,8061,5845
29582,14,76,29201,381,29582,0,1.01992e+14,16.8426,672.099,29582,25,27,29455,29373,26050,25742,14523
25999,2380,2570,23502,2497,14529,11470,1.91814e+18,976.187,6145.48,25999,374,369,23429,23428,23428,23428,23254
1863,683,754,1207,656,0,1863,4.22934e+18,91.2877,1060.63,1863,186,98,1109,1109,1109,1109,1106
10340,288,2300,9312,1028,6218,4122,1.97522e+18,406.606,4026.79,10340,278,273,7558,6336,3649,3539,1530
14717,1031,2576,8696,6021,8696,6021,1.92628e+18,473.935,4867.63,14717,402,307,12141,11464,9124,9035,5101
37033,600,1795,0,37033,0,37033,2.04114e+18,1192.6,5994.29,37033,408,431,33362,31450,22893,25559,15733
24584,180,246,0,24584,24088,496,2.57554e+16,114.442,1682.77,24584,95,95,24338,24310,23389,23268,22093
4004,22,148,0,4004,3933,71,2.82544e+16,55.2358,561.819,4004,49,51,3689,3525,3054,2875,1649
29183,709,2227,0,29183,9020,20163,9.12527e+15,797.041,6338.67,29183,430,519,26374,25672,23155,23088,13198
41317,439,932,41268,49,41317,0,4.20403e+18,354.921,3965.29,41317,226,224,40385,40081,33388,33100,31754
24798,2435,2895,14412,10386,0,24798,4.53892e+18,675.648,6478.61,24798,393,370,21903,21832,21771,21763,20068
14512,10,26,14242,270,14500,12,9.88617e+13,18.8085,406.042,14512,19,20,14390,14304,12951,12899,10141
2591,363,548,2591,0,2345,246,2.11394e+18,117.67,975.976,2591,126,80,2043,2039,2040,2040,1973
17520,34,246,0,17520,17220,300,2.61991e+16,122.509,1417.86,17520,81,83,16600,16033,13797,12273,7188
23780,217,251,0,23780,23366,414,2.67444e+16,103.918,1669.06,23780,84,83,23529,23528,23371,23314,22799
35288,207,2764,35288,0,31248,4040,2.72494e+18,1287.28,7421.88,35288,449,399,25491,19744,9840,5278,4133
5914,551,979,3643,2271,0,5914,4.76722e+18,349.762,2015.49,5914,200,162,4923,4522,4195,4111,3268
37148,412,2492,10611,26537,0,37148,3.67442e+13,534.134,7091.58,37148,436,471,34133,32607,26962,27235,11308
25410,997,1758,0,25410,7945,17465,8.96014e+15,414.786,4914.95,25410,315,319,23652,23587,22908,22902,18762
12221,1843,1930,7273,4948,0,12221,4.854e+18,437.764,3863.92,12221,290,258,10291,10239,10276,10282,10187
7337,115,189,0,7337,7194,143,2.7126e+16,84.4931,859.366,7337,62,63,7136,7061,6668,6714,5914
43271,856,1083,43271,0,43271,0,4.36129e+18,395.337,4217.26,43271,234,235,42188,42179,40323,40208,39802
34302,10,55,33906,396,34302,0,1.00144e+14,19.5707,715.446,34302,26,27,33986,33743,30398,28578,20506
31270,2175,2572,18116,13154,18116,13154,1.78831e+18,898.442,6892.46,31270,411,440,28698,28693,28332,28511,26301
28361,1441,2808,28361,0,25497,2864,2.4576e+18,829.657,6848.77,28361,439,340,25553,24179,22584,21877,15989
43713,4491,5008,39228,4485,26061,17652,1.91984e+18,1001.81,10917.4,43713,502,528,38705,38705,38639,38672,36836
35693,197,2129,35693,0,31561,4132,2.68469e+18,1187.81,6323.24,35693,397,347,25659,19157,10131,3752,6321
30561,730,1983,0,30561,9165,21396,9.15317e+15,654.06,5879.14,30561,334,388,28330,27124,25903,26047,17425
8156,827,1021,2356,5800,0,8156,3.58958e+13,306.753,2301.22,8156,239,210,7135,7126,6928,6936,6542
9028,295,1661,9028,0,8061,967,1.59451e+18,218.654,3132.39,9028,206,259,7284,6662,5167,4177,1638
34539,145,274,0,34539,33888,651,2.51041e+16,151.606,2009.48,34539,105,105,34199,34026,30985,31045,25238
46895,954,3879,27162,19733,0,46895,4.60281e+18,924.786,10076.4,46895,454,760,42124,39931,32373,29964,9038
14741,466,2108,0,14741,0,14741,2.06379e+18,312.197,4145.89,14741,374,251,12631,11979,4823,5764,2756
2613,78,716,1545,1068,1545,1068,1.91068e+18,101.905,1128.54,2613,122,111,1795,1531,1388,1228,297
27636,2040,2823,0,27636,0,27636,2.30405e+18,838.54,6839.46,27636,356,389,24813,24560,24107,24182,21884
17946,405,1789,5679,12267,0,17946,3.46353e+13,371.319,4437.45,17946,422,218,16008,15226,9861,9426,5584
23487,124,640,23487,0,23487,0,4.267e+18,317.369,2725.43,23487,183,182,21145,18393,11166,10422,5980
12366,1880,2011,10803,1563,7316,5050,1.97348e+18,709.479,4142.93,12366,280,309,10355,10327,10338,10350,10211
3551,564,678,0,3551,1043,2508,8.93989e+15,154.53,1300.17,3551,191,104,2873,2838,2775,2782,2564
45076,141,3320,45076,0,39927,5149,1.69763e+18,1455.98,9214.32,45076,518,489,29822,23567,11835,8176,3120
30813,60,280,0,30813,30290,523,2.63414e+16,141.268,1999.42,30813,97,108,29959,29173,24891,23185,16153
11991,8,40,11843,148,11991,0,1.04764e+14,15.1916,376.974,11991,22,22,11760,11668,10264,9847,7938
23515,58,687,23515,0,23515,0,4.43521e+18,295.24,2803.51,23515,187,175,17354,11950,8308,7643,3278
48254,1622,2930,42959,5295,28964,19290,1.94545e+18,1118.68,8794.04,48254,576,463,45324,44744,39013,38114,35685
30038,833,2269,17694,12344,0,30038,4.91983e+18,944.169,6288.19,30038,496,391,27021,25454,23771,23495,15306
48106,810,1106,48010,96,48106,0,4.12523e+18,373.336,4387.11,48106,231,229,47000,46980,45327,45224,43734
14427,306,1516,4013,10414,0,14427,3.77003e+13,316.342,3671.79,14427,228,282,12760,11730,10761,10834,4833
39984,151,242,0,39984,39471,513,2.55367e+16,146.198,1982.41,39984,93,93,39706,39583,37739,37257,33055
14782,593,996,4789,9993,0,14782,3.05782e+13,384.806,2831.82,14782,187,253,13786,13398,13119,13073,10587
4074,19,612,0,4074,1344,2730,8.1405e+15,149.456,1295.14,4074,109,170,2280,1471,1299,1273,384
4332,498,1228,4332,0,3948,384,2.79029e+18,132.477,1870.46,4332,175,158,3104,2995,2322,2238,1865
16373,2030,2823,9734,6639,9734,6639,1.91484e+18,384.549,5392.76,16373,248,388,13550,13549,13208,13306,11387
36010,3401,5044,35985,25,32044,3966,2.72004e+18,1121.95,10399.4,36010,445,554,30966,30639,30248,30117,23949
11784,361,2221,10500,1284,6995,4789,1.94882e+18,394.753,4107.06,11784,299,314,9135,7571,5604,5065,1783
27539,1996,2709,0,27539,0,27539,2.43645e+18,852.946,6567.24,27539,402,442,24830,24719,23903,23857,22627
29654,3813,3844,29629,25,26765,2889,2.69633e+18,1145.59,8353.22,29654,453,479,25810,25810,25810,25810,25768
26537,121,4203,23424,3113,15853,10684,2.01584e+18,1038.28,8294.53,26537,405,557,17479,14238,8303,6310,1304
12924,674,1649,0,12924,0,12924,2.27982e+18,453.902,3566.65,12924,331,224,11246,10689,9842,9387,8089
27196,615,1930,8508,18688,0,27196,3.18037e+13,584.332,5204.16,27196,306,406,25040,24289,22795,22875,13107
25797,1212,2416,0,25797,0,25797,2.37148e+18,1153.2,6144.73,25797,406,375,22846,21066,19825,15828,15172
43257,82,291,0,43257,42608,649,2.47356e+16,155.91,2256.83,43257,97,110,42627,42115,36799,33516,24673
30133,3102,3182,27336,2797,16530,13603,1.89114e+18,708.788,7350,30133,403,510,26951,26951,26951,26951,26881
24417,1226,2682,14764,9653,14764,9653,1.85708e+18,635.986,6312.05,24417,334,415,21735,21542,20005,20111,13106
29081,1859,2961,17754,11327,17754,11327,1.8509e+18,784.671,6866.22,29081,429,381,26120,25802,25336,24955,22416
28273,17,43,27866,407,28273,0,1.01338e+14,19.1519,571.017,28273,21,26,28211,28174,25790,25577,19498
35994,226,248,0,35994,35349,645,2.55167e+16,153.515,1914.22,35994,102,123,35746,35736,35710,35367,35262
11431,143,2252,0,11431,0,11431,2.50324e+18,284.44,4069.75,11431,223,408,8292,7115,5732,5044,482
32097,71,291,0,32097,31277,820,2.62934e+16,122.773,1823.2,32097,94,91,31536,30658,27354,24923,18254
9974,331,548,9917,57,9974,0,4.05667e+18,260.595,1782.76,9974,146,131,9426,9274,8083,7911,6800
44184,273,929,44184,0,44184,0,4.33954e+18,329.667,3928.54,44184,213,218,43023,42041,27437,26851,23594
5232,992,1337,5232,0,4620,612,2.79728e+18,238.453,2303.39,5232,239,171,3895,3882,3869,3882,3506
10206,526,587,10206,0,10206,0,4.39621e+18,238.879,1802.34,10206,136,137,9619,9618,9529,9533,9509
22986,1237,2601,20635,2351,13677,9309,1.91655e+18,676.919,6166.16,22986,388,337,20385,19980,15813,15541,12316
46024,66,306,0,46024,45220,804,2.56595e+16,160.221,2305.86,46024,112,117,44848,43610,37441,34971,23514
20213,420,1242,0,20213,6136,14077,8.4084e+15,549.768,3666.19,20213,351,271,18557,17911,16163,16225,8990
16863,45,53,16586,277,16863,0,1.06511e+14,16.8505,509.955,16863,25,23,16810,16810,16573,16574,15773
33928,806,4060,30631,3297,19645,14283,1.98518e+18,1197.97,8860.62,33928,423,567,28297,25961,16971,16994,6179
7100,1810,1908,7100,0,6375,725,2.8915e+18,286.322,3076.02,7100,231,238,5192,5192,5192,5189,5162
2825,590,595,1776,1049,1776,1049,1.70367e+18,212.32,1108.37,2825,119,114,2230,2230,2230,2230,2228
29366,306,309,0,29366,28785,581,2.66751e+16,127.763,2105.08,29366,106,113,29057,29057,29054,29042,29056
8987,1808,1863,8103,884,5493,3494,2.00467e+18,455.625,3343.63,8987,245,267,7124,7124,7124,7124,7112
30065,7,70,29327,738,30065,0,1.00204e+14,18.7549,686.51,30065,28,30,29310,28942,25172,24297,13216
26145,2484,2540,16002,10143,0,26145,4.96882e+18,966.161,6318.81,26145,464,369,23605,23605,23571,23579,23549
44107,3995,4296,39845,4262,26493,17614,1.98558e+18,857.298,10381.6,44107,497,461,39811,39811,39790,39775,38296
42298,1215,2165,12814,29484,0,42298,3.63907e+13,758.342,6810.61,42298,462,456,40133,39655,37145,37267,28972
12687,1131,1375,3484,9203,0,12687,3.5026e+13,297.801,3263.45,12687,320,175,11312,11311,11136,11143,10463
31187,297,3140,0,31187,0,31187,2.31046e+18,662.363,7529.95,31187,462,401,25386,22221,11997,11121,2817
10301,299,1874,0,10301,0,10301,2.40091e+18,323.715,3601.05,10301,192,419,8092,6823,5431,5230,1601
45094,106,316,0,45094,44376,718,2.58532e+16,145.048,2435.5,45094,114,115,44523,43962,39640,37103,29475
24283,1011,3335,21712,2571,14773,9510,1.98548e+18,1210.63,7136.45,24283,485,600,19987,18354,13140,13063,10603
14016,1957,2014,8163,5853,8163,5853,1.67752e+18,360.615,4245.83,14016,244,417,12002,12002,11996,11991,11972
21109,768,4096,21109,0,21109,0,8.87066e+15,3301.21,9293.18,21109,4096,6,3701,0,2302,3301,3701
34759,189,2857,20561,14198,0,34759,4.96036e+18,1127.22,7370.74,34759,496,465,26960,22813,15510,11395,3122
17278,1055,1399,0,17278,5371,11907,8.91362e+15,446.687,3761.93,17278,327,285,15879,15837,15371,15414,14506
16601,865,1333,4891,11710,0,16601,3.58381e+13,351.825,3664.26,16601,260,326,15268,15227,14950,14944,12233
10841,529,542,10841,0,10841,0,4.14004e+18,283.744,1826.38,10841,140,132,10299,10299,10291,10290,10257
15918,152,2095,0,15918,0,15918,2.30886e+18,528.904,4473.54,15918,357,299,11549,9241,6713,4993,1144
28189,1618,3774,28189,0,25450,2739,2.27511e+18,653.29,7886.69,28189,291,429,24415,24280,23325,22940,16893
17378,687,1743,9691,7687,0,17378,4.08909e+18,336.658,3997,17378,211,287,15635,15307,14934,14697,10305
34485,2512,2704,0,34485,10435,24050,9.23584e+15,699.245,7249.29,34485,514,443,31781,31742,31740,31739,31022
35354,1718,2137,9967,25387,0,35354,3.64598e+13,745.35,6473.16,35354,380,381,33217,33079,33073,33084,28800
3089,459,661,1935,1154,1935,1154,1.91471e+18,205.965,1224.79,3089,116,135,2428,2427,2371,2389,2037
30126,11,37,29722,404,30126,0,9.96928e+13,19.9463,560.046,30126,22,23,29962,29831,27350,27129,19670
35611,2046,3043,20758,14853,20758,14853,1.80115e+18,1003.97,7906.65,35611,380,454,32568,32291,31746,32080,26349
41532,1442,2120,0,41532,12694,28838,9.07785e+15,592.956,6424.54,41532,374,386,39412,39377,38224,38284,34491
22249,744,1561,6481,15768,0,22249,3.5917e+13,396.402,4251.83,22249,354,261,20688,20571,19397,19410,14327
8026,165,709,0,8026,2475,5551,7.60983e+15,169.463,1788.35,8026,150,169,7195,6879,5414,5480,3287
22248,55,284,0,22248,21985,263,2.6484e+16,122.824,1679.82,22248,100,91,21519,20952,18354,16859,11811
8921,1,40,8769,152,8921,0,1.04437e+14,18.0568,380.887,8921,21,24,3534,3534,3534,3534,3534
2394,128,2394,2394,0,0,2394,268323000,0,2394,2394,2394,1,0,0,0,0,0
47949,30,74,47163,786,47949,0,1.01509e+14,20.289,825.805,47949,30,29,47875,47869,45538,45450,40313
17015,332,2269,10443,6572,0,17015,4.9463e+18,944.024,5018.32,17015,387,399,13388,11814,9069,7952,2773
22992,311,1482,0,22992,0,22992,2.40302e+18,832.478,4489.46,22992,312,291,18817,16049,12162,9069,5055
9459,527,1189,8493,966,5007,4452,1.82722e+18,206.565,2465.37,9459,191,142,8270,8226,7788,7797,7197
31683,54,58,31246,437,31683,0,9.99375e+13,19.4832,652.699,31683,25,26,31625,31625,31387,31387,31286
24922,3035,3145,24922,0,22048,2874,1.51312e+18,995.779,6940.05,24922,426,490,21777,21774,21754,21758,21639
29652,1294,3583,29652,0,26878,2774,2.6262e+18,956.977,7709.93,29652,325,478,25970,24836,19348,17116,11214
16755,669,1594,0,16755,0,16755,2.36682e+18,525.199,3942.42,16755,306,265,14865,14199,10884,8253,7018
42673,132,283,0,42673,42072,601,2.57343e+16,148.336,2139.19,42673,111,109,42280,42017,37873,37062,30241
16954,962,1566,5302,11652,0,16954,3.6106e+13,435.62,3921.8,16954,332,269,15388,15252,14495,14579,12878
20074,1293,2167,11967,8107,0,20074,4.66145e+18,721.63,5046.34,20074,268,381,17907,17210,16962,16849,14985
17353,1368,1888,10743,6610,0,17353,4.89245e+18,452.16,4391.65,17353,255,318,15465,15459,15283,15272,13141
31501,689,923,31501,0,31501,0,4.11648e+18,367.217,3509.22,31501,205,208,30578,30553,28924,28949,28748
46780,745,2825,0,46780,0,46780,2.13888e+18,1160.95,8259.99,46780,445,409,42489,40382,30562,24937,16776
14928,225,544,14928,0,14928,0,4.12346e+18,285.993,2119.46,14928,152,165,14127,13100,10112,9759,8523
42793,18,52,42115,678,42769,24,9.88878e+13,22.8077,783.778,42793,26,26,42712,42664,40050,39540,29885
1561,88,112,0,1561,1527,34,2.6035e+16,31.9955,312.518,1561,34,37,1449,1446,1390,1410,1291
42386,93,97,41591,795,42386,0,1.01896e+14,20.8911,955.981,42386,31,31,42289,42289,42179,42179,42000
9709,613,1805,5622,4087,0,9709,4.68213e+18,226.583,3331.03,9709,188,283,7904,7714,7281,7220,3912
21422,1288,1791,19171,2251,13290,8132,1.90263e+18,626.787,4669.76,21422,342,285,19631,19613,19550,19543,18459
23592,738,2360,14664,8928,14664,8928,1.79164e+18,557.016,5760.08,23592,362,366,21110,19787,15693,15569,9105
25943,135,286,0,25943,25459,484,2.69199e+16,128.561,1878.36,25943,94,100,25609,25414,23374,22403,18453
38572,2627,4632,35189,3383,22506,16066,1.9523e+18,1160.22,10096.1,38572,452,582,33940,33263,32571,32759,25668
42832,2052,3987,24843,17989,0,42832,4.39122e+18,913.398,9654,42832,577,551,38845,38223,30077,30036,25499
41167,857,2845,0,41167,0,41167,2.2692e+18,1021.72,7764.49,41167,436,442,37605,35485,29868,24342,18365
47350,323,378,0,47350,46628,722,2.58038e+16,121.405,2857.82,47350,112,120,46972,46971,46885,46705,45371
11647,70,548,11647,0,11647,0,3.95758e+18,269.225,1890.17,11647,138,141,8971,6648,4635,4534,2228
5316,322,479,5316,0,5316,0,3.80021e+18,174.752,1266.5,5316,104,101,4837,4795,4520,4527,3819
2020,48,98,0,2020,1984,36,2.73249e+16,26.9856,295.503,2020,33,36,1922,1893,1800,1795,1550
36951,1018,2050,11672,25279,0,36951,3.51142e+13,654.191,6523.26,36951,417,383,34901,34415,28805,28889,20444
40934,163,278,0,40934,40045,889,2.59985e+16,139.467,2222.21,40934,95,105,40645,40550,38356,37656,31360
7146,163,419,7146,0,7146,0,4.30549e+18,220.226,1357.93,7146,122,113,6369,5536,4295,4233,3850
27950,429,1312,0,27950,8385,19565,8.87889e+15,558.549,4524.04,27950,375,279,25375,23811,21255,21298,12002
38217,2133,2145,0,38217,12174,26043,8.49582e+15,548.547,6658.44,38217,415,410,36072,36072,36072,36072,36068
24501,669,2994,14531,9970,14531,9970,1.82072e+18,573.649,6619.49,24501,353,477,21325,20076,18472,18155,4663
5062,119,439,2541,2521,2541,2521,1.18793e+18,148.305,1145.65,5062,119,112,4400,3016,2338,2241,1837
19078,2477,2564,0,19078,0,19078,2.49489e+18,498.903,5448.97,19078,300,462,16514,16514,16500,16506,16404
26322,902,3479,26322,0,23563,2759,1.48953e+18,946.444,7337.29,26322,381,504,22149,20120,13554,11697,10570
29943,1926,1935,0,29943,0,29943,2.37211e+18,747.064,5508.54,29943,356,411,28008,28008,28004,28000,28006
28393,591,1770,8582,19811,0,28393,3.58273e+13,449.379,5182.84,28393,384,365,26623,26109,20229,20235,13427
40608,1,72,39669,939,40608,0,1.01644e+14,19.54,720.762,40608,27,28,16940,16940,16940,16940,16940
23681,241,285,0,23681,23297,384,2.72214e+16,119.487,1808.11,23681,96,109,23396,23392,23283,23173,22238
13606,1172,1231,4266,9340,0,13606,3.4052e+13,302.923,3186.4,13606,214,239,12375,12375,12375,12375,12303
49980,7,59,49065,915,49980,0,9.90797e+13,19.9838,880.566,49980,27,28,48949,48419,42245,41794,23974
45367,1400,3231,27214,18153,0,45367,4.81408e+18,921.799,8641.55,45367,457,439,42136,41260,37180,36568,22674
24808,185,529,24808,0,24808,0,4.23889e+18,294.793,2698.02,24808,182,187,23249,21233,15402,14778,10876
48757,264,648,48757,0,48757,0,4.23936e+18,363.748,3887.78,48757,232,226,47615,46506,34320,33108,27459
14855,1157,2960,14855,0,13543,1312,2.27836e+18,571.46,5277.24,14855,367,374,11895,11083,7773,6779,5490
37382,276,302,0,37382,36723,659,2.66395e+16,148.486,2197.15,37382,110,116,37080,37080,36907,36674,36544
23351,767,2839,23351,0,21146,2205,1.97318e+18,1013.04,6390.46,23351,360,362,19113,17351,9678,8227,5430
13626,2,34,13272,354,13626,0,1.01262e+14,15.2795,378.64,13626,20,21,10011,8874,8409,8661,6234
45951,70,75,44931,1020,45951,0,1.02664e+14,19.762,827.05,45951,27,31,45876,45876,45718,45718,45324
33816,2178,3578,20320,13496,0,33816,4.87781e+18,800.955,8449.93,33816,475,432,30238,29999,29328,29295,21610
43693,121,342,0,43693,42910,783,2.59103e+16,145.892,2471.24,43693,111,126,43250,43015,38012,35323,27782
2952,338,369,2952,0,2952,0,4.15117e+18,151.895,876.693,2952,86,91,2583,2583,2572,2570,2543
46860,30,91,46059,801,46835,25,1.03616e+14,19.1464,885.54,46860,30,32,46769,46759,42729,42603,31266
23987,2477,3249,21297,2690,14145,9842,1.96403e+18,897.572,7091.37,23987,348,552,20738,20709,20194,20366,18386
34518,3752,3763,0,34518,0,34518,2.36214e+18,732.008,8315.12,34518,446,547,30755,30755,30755,30755,30751
4082,596,648,2357,1725,0,4082,3.75723e+18,150.564,1302.38,4082,139,92,3434,3434,3409,3398,3217
26088,1246,1851,15515,10573,15515,10573,1.90937e+18,943.21,5240.33,26088,405,272,24187,23444,23094,23126,19718
34171,221,259,0,34171,33308,863,2.61948e+16,134.498,1951.21,34171,106,107,33912,33909,33425,33402,32793
12541,1348,2231,0,12541,0,12541,2.29286e+18,421.709,4387.67,12541,401,383,10310,10225,8981,8944,7398
17350,1081,1732,9435,7915,9435,7915,1.52676e+18,362.065,3826.15,17350,238,268,15618,15310,15304,15428,11829
47120,2824,3316,47120,0,41774,5346,2.27997e+18,1671.8,9413.41,47120,567,440,43804,43782,43332,43188,41472
8759,1908,1950,8124,635,5125,3634,1.94015e+18,231.29,3371.88,8759,246,226,6809,6809,6809,6809,6740
6677,1407,1595,6677,0,5938,739,2.36459e+18,325.91,2799.31,6677,204,191,5082,5081,5067,5067,4852
28752,3292,3412,16769,11983,16769,11983,1.76666e+18,674.656,7576.19,28752,331,572,25340,25340,25312,25323,25178
20857,982,2566,12361,8496,12361,8496,1.88479e+18,627.609,5758.31,20857,363,446,18291,17432,15735,15435,9745
15178,1,31,14884,294,15178,0,9.26323e+13,15.5916,437.325,15178,20,21,6237,6237,6237,6237,6237
35883,1768,2473,21285,14598,21285,14598,1.75869e+18,616.656,6768.41,35883,374,340,33410,33339,32879,33054,28253
27519,1711,2685,0,27519,0,27519,2.37191e+18,755.797,6572.8,27519,500,327,24834,24261,23916,23722,19857
48284,3297,4308,48284,0,43400,4884,2.6832e+18,1247.71,10803.9,48284,449,555,43976,43873,43678,43568,40478
26165,127,3073,23358,2807,15678,10487,1.9783e+18,943.877,6877.05,26165,391,377,17281,13508,7662,5996,1337
34165,1282,4840,34165,0,30919,3246,1.91778e+18,718.444,10028.7,34165,387,643,29325,28068,17685,15385,10919
4855,692,918,0,4855,0,4855,2.23636e+18,235.561,1789.84,4855,159,163,3937,3912,3889,3887,3555
23546,1109,1599,7042,16504,0,23546,3.68602e+13,589.351,4733.19,23546,403,281,21947,21837,21264,21306,17345
33488,185,1402,10046,23442,0,33488,3.26368e+13,740.424,4961.05,33488,384,324,29363,27080,18844,17164,7427
42885,1010,3627,42885,0,38009,4876,2.27056e+18,1330.75,9446.64,42885,470,534,37666,35495,19177,14088,16060
42103,767,1602,0,42103,11656,30447,9.47825e+15,836.929,5948,42103,435,327,39829,38733,37120,37368,27773
18384,689,2847,18384,0,16220,2164,2.53896e+18,792.221,5796.24,18384,351,304,14815,12983,11707,11372,5357
6644,113,1078,6644,0,5910,734,2.74594e+18,340.658,2174.3,6644,209,148,4316,3437,1541,562,287
30858,2104,2350,18275,12583,0,30858,4.83252e+18,744.542,6456.13,30858,394,363,28508,28508,28385,28221,27500
34626,2352,3299,20198,14428,0,34626,4.64958e+18,725.267,8034.75,34626,416,530,31327,31223,30651,30463,25885
37105,464,3499,21605,15500,21605,15500,1.73065e+18,867.743,8463.26,37105,521,449,31940,28990,18195,15024,7070
47739,234,352,0,47739,46865,874,2.68343e+16,143.686,2651.11,47739,119,123,47387,47358,45500,44546,39722
23006,212,2185,14207,8799,14207,8799,1.8862e+18,452.698,5130.88,23006,367,262,17696,13637,10576,10657,5845
15179,1062,1806,9065,6114,0,15179,4.30606e+18,505.645,4190.37,15179,303,288,13373,13106,12426,12311,10894
39518,563,3145,0,39518,0,39518,2.32985e+18,1017.42,8024.32,39518,399,426,34499,31645,20751,16692,12917
30269,28,80,29638,631,30259,10,1.03007e+14,21.0321,753.443,30269,32,30,30189,30170,28035,27910,18966
37326,1342,2035,0,37326,10869,26457,9.35943e+15,695.765,6527.05,37326,461,373,35291,35104,34082,34044,29825
4765,74,143,0,4765,4643,122,2.61616e+16,59.3079,563.635,4765,45,54,4611,4553,4286,4300,3570
6728,1228,1418,4007,2721,4007,2721,1.85898e+18,334.988,2575.12,6728,205,203,5310,5303,5253,5275,5025
9181,1320,2098,9181,0,8387,794,2.87704e+18,271.562,3623.35,9181,280,268,7083,7032,6847,6788,4834
38229,125,1939,0,38229,11563,26666,9.21296e+15,767.14,6389.69,38229,471,395,30193,26722,19810,16165,5317
49256,963,4538,43721,5535,29027,20229,1.95896e+18,1164.66,11167.5,49256,670,505,43323,40197,29103,27777,16617
37251,1568,2745,34154,3097,22483,14768,1.92163e+18,738.062,7389.33,37251,323,474,34506,34385,33538,33754,22088
40794,3460,4007,36271,4523,24638,16156,1.929e+18,1050.07,9674.86,40794,582,433,36787,36786,36582,36565,34044
30539,610,1243,9722,20817,0,30539,3.56398e+13,422.435,4169.72,30539,283,279,29296,29194,25755,25904,21581
33368,1858,2459,0,33368,10472,22896,8.92475e+15,541.967,6885.92,33368,503,348,30909,30898,29997,30052,26300
18328,11450,18328,0,18328,0,18328,1048520,0,18328,18328,18328,1,0,0,0,0,0
44495,1835,2929,25439,19056,0,44495,4.6618e+18,1359.06,8398.92,44495,440,516,41206,39443,38738,38191,27520
36834,636,2722,21756,15078,21756,15078,1.83218e+18,740.149,7143.88,36834,404,418,33537,31835,26112,24844,11742
32854,196,319,0,32854,32214,640,2.54244e+16,132.041,2128.19,32854,110,117,32535,32485,30739,30512,27563
738,56,185,738,0,738,0,3.92372e+18,63.1165,323.03,738,34,44,522,411,330,353,225
4219,508,600,1355,2864,0,4219,3.57352e+13,245.956,1333.14,4219,154,149,3619,3552,3581,3581,3457
6369,10,20,6187,182,6369,0,9.59465e+13,12.2807,245.332,6369,15,16,6318,6289,5626,5720,4807
34146,18,73,33587,559,34146,0,1.07971e+14,19.987,732.263,34146,29,29,34035,33964,30433,30097,22096
34234,76,88,33560,674,34234,0,1.05416e+14,18.3879,753.955,34234,30,30,34146,34146,33687,33688,32597
801,115,268,801,0,748,53,2.10506e+18,17.2385,374.896,801,63,48,533,530,359,364,225
19834,2352,2564,17691,2143,12025,7809,1.946e+18,672.08,5530.68,19834,352,389,17270,17257,17256,17248,16852
637,9,65,0,637,627,10,2.96376e+16,15.8257,155.586,637,23,21,541,493,415,406,221
2404,310,489,0,2404,757,1647,8.57398e+15,86.0699,921.684,2404,105,113,1915,1900,1892,1888,1190
31931,63,310,0,31931,31398,533,2.54914e+16,137.843,2056.53,31931,99,107,31027,30272,25808,23671,15348
42271,1199,3418,25011,17260,25011,17260,1.83086e+18,1156.93,8946.27,42271,521,490,38253,36724,33282,33015,17234
14517,954,1365,4786,9731,0,14517,3.39755e+13,428.569,3481.5,14517,245,262,13152,12991,12793,12797,11414
16957,90,1359,0,16957,4818,12139,9.74762e+15,508.929,3618.08,16957,328,240,13014,11571,8157,7431,2927
49143,1459,2806,0,49143,15061,34082,8.84288e+15,659.703,8287.26,49143,482,395,46337,46130,44459,44515,32881
41969,191,917,41969,0,41969,0,4.35747e+18,335.528,3923.11,41969,227,224,39191,35448,23155,21826,16810
28162,760,3007,16624,11538,16624,11538,1.77071e+18,674.12,7111.72,28162,417,412,24873,23055,19586,19428,9525
49229,99,304,0,49229,48323,906,2.59006e+16,134.772,2534.45,49229,109,112,48602,47941,42782,40770,29409
18658,2306,2382,18658,0,16576,2082,2.16989e+18,918.025,5429.73,18658,283,360,16276,16276,16273,16271,16242
4498,8,27,4420,78,4498,0,9.89984e+13,14.8997,218.997,4498,19,17,4396,4350,3829,3785,2634
38529,3217,4675,34254,4275,23000,15529,1.994e+18,1088.54,10403.6,38529,489,581,33854,33683,32649,32834,25771
22251,570,1473,6871,15380,0,22251,3.62672e+13,377.647,4177.87,22251,253,297,20778,20512,18404,18513,13779
20702,12,240,0,20702,20389,313,2.5625e+16,128.046,1558.16,20702,85,93,18500,17372,15203,12816,7988
10810,99,1762,6280,4530,6280,4530,1.98405e+18,548.529,3506.1,10810,242,298,7430,6191,4432,3805,969
31305,165,647,31305,0,31305,0,3.98015e+18,347.124,3174.27,31305,203,207,28735,25537,18351,17441,12829
13728,6,46,13451,277,13728,0,1.03298e+14,16.2374,429.216,13728,22,24,13292,12853,11539,11294,7036
30888,616,2158,9327,21561,0,30888,3.64437e+13,749.002,6128.31,30888,444,354,28172,26821,22760,22877,13282
29355,997,1878,0,29355,9261,20094,9.15272e+15,477.09,5376.83,29355,410,324,27477,27368,25790,25830,20282
49729,1607,4013,44669,5060,29608,20121,1.96965e+18,1251.81,10819.9,49729,425,558,45413,44184,40542,40819,23826
35472,134,2860,31903,3569,19828,15644,1.95213e+18,1330.54,7779.85,35472,440,495,26546,19732,8961,7565,1586
6776,1061,1236,6776,0,6029,747,1.10551e+18,555.489,2388.64,6776,218,180,5540,4920,5378,5352,5195
34514,1612,1829,11297,23217,0,34514,3.45643e+13,577.635,5771.61,34514,334,381,32685,32566,32601,32593,31869
33079,816,3535,0,33079,0,33079,2.17093e+18,678.703,7904.47,33079,480,352,29285,27543,17534,18075,7051
41937,2045,4110,24940,16997,24940,16997,1.84128e+18,1028.39,9865.42,41937,427,542,37827,36903,35557,35843,22962
49562,910,3539,44238,5324,29748,19814,1.97633e+18,1182.23,9522.57,49562,590,444,44047,38519,29125,28113,21177
2853,477,491,2603,250,1567,1286,1.72673e+18,137.404,1006.33,2853,114,83,2362,2361,2362,2362,2358
12993,475,2335,0,12993,0,12993,2.2782e+18,291.525,4365.62,12993,352,309,10658,10129,7071,6906,2933
5888,244,764,1615,4273,0,5888,3.74927e+13,269.836,1679.68,5888,181,141,4919,4489,4134,4151,2125
47744,3964,4194,0,47744,0,47744,2.33688e+18,1106.18,10512.9,47744,655,645,43550,43549,43531,43543,42919
18660,2083,3008,16727,1933,11085,7575,1.98803e+18,435.281,5855.67,18660,324,442,15652,15585,15092,15289,10982
2288,326,737,1950,338,1376,912,1.97311e+18,129.062,1136.47,2288,96,115,1551,1456,1369,1390,1014
26881,209,2558,0,26881,0,26881,2.38036e+18,896.04,6221.04,26881,430,339,20245,16722,11784,9320,2352
28222,328,1194,0,28222,8554,19668,9.28324e+15,395.226,3672.7,28222,310,218,26830,24892,22115,22544,14532
4082,696,738,0,4082,1130,2952,9.81535e+15,163.649,1397.04,4082,199,132,3344,3344,3340,3340,3265
39777,662,982,39777,0,39777,0,4.23714e+18,374.926,3959.84,39777,215,220,38795,38745,36524,36570,35422
39691,2829,3642,0,39691,0,39691,2.42258e+18,750.085,8998.86,39691,479,553,36049,36046,35643,35419,29080
6347,225,1494,6347,0,5711,636,1.67556e+18,372.836,2543.71,6347,223,184,4387,3646,1969,2049,1457
6434,486,1292,3732,2702,3732,2702,1.95933e+18,191.776,2368.57,6434,155,223,5142,4986,4804,4917,2221
16789,1126,1369,0,16789,4803,11986,9.61733e+15,429.307,3619.94,16789,315,268,15420,15339,15215,15201,14423
23797,1173,2061,23797,0,21694,2103,1.15555e+18,1098.42,5214.53,23797,356,345,21214,19507,19280,19610,14846
1625,381,714,1625,0,1452,173,2.56483e+18,62.1969,969.863,1625,135,94,911,891,892,889,484
37034,191,4057,22603,14431,0,37034,4.95894e+18,710.747,9160.1,37034,495,470,27743,22756,15429,12051,2320
49266,3016,3455,0,49266,0,49266,2.36591e+18,1310.42,9596.84,49266,499,514,45811,45433,45215,44929,43096
4755,20,31,4688,67,4755,0,1.02645e+14,11.7012,238.748,4755,18,16,4724,4724,4600,4600,4043
43639,2006,3170,25391,18248,0,43639,4.56687e+18,1102.96,8526.04,43639,483,514,40469,39372,38342,37956,29791
25345,1598,2752,14515,10830,14515,10830,1.84525e+18,547.168,6264.86,25345,450,347,22593,22514,21999,21765,16763
27360,663,1294,0,27360,0,27360,2.42074e+18,893.694,4498.53,27360,345,322,25306,24061,23043,18053,14723
3141,422,834,1929,1212,0,3141,4.82615e+18,139.325,1391.85,3141,111,160,2307,2246,2211,2221,1494
45522,2205,3583,45522,0,40811,4711,1.89528e+18,914.249,9011,45522,483,468,41939,41612,40961,40457,34388
34390,3492,3715,0,34390,0,34390,2.41765e+18,942.714,8544.2,34390,522,493,30675,30670,30572,30446,30029
5865,1187,1225,3499,2366,3499,2366,1.97682e+18,288.055,2164,5865,193,179,4640,4543,4635,4635,4580
23870,179,722,23864,6,23870,0,4.07719e+18,328.343,2902.53,23870,191,193,22045,19926,13557,12969,9924
6418,473,706,0,6418,2122,4296,7.69696e+15,93.9475,1532.61,6418,145,111,5712,5709,5679,5679,5220
23785,1806,1842,7170,16615,0,23785,3.60287e+13,551.464,5027.03,23785,351,382,21943,21943,21940,21939,21867
44734,3873,4149,26857,17877,0,44734,4.66008e+18,848.991,10169.9,44734,469,485,40585,40576,40494,40516,39462
2308,185,649,0,2308,0,2308,2.69375e+18,117.068,1041.67,2308,112,131,1658,1517,1436,1430,435
15029,2325,2529,0,15029,0,15029,2.29986e+18,364.75,4794.96,15029,300,283,12500,12500,12495,12493,11925
12424,556,1296,0,12424,0,12424,2.37771e+18,486.024,3136.02,12424,253,233,11005,9212,9198,8587,5322
12390,314,1968,7170,5220,7170,5220,1.70469e+18,227.673,3795.78,12390,228,248,10387,9538,6013,4452,1703
35634,31,52,34787,847,35628,6,9.91729e+13,17.5794,649.521,35634,24,25,35582,35580,34427,34430,29479
21223,925,2682,12762,8461,0,21223,4.79109e+18,800.346,5970.25,21223,369,459,18110,17452,14346,14424,8082
7843,1050,2228,7139,704,4763,3080,1.94096e+18,234.026,3522.14,7843,307,277,5615,5563,4331,4195,3371
17466,14,630,17466,0,17466,0,4.08593e+18,318.046,2385.22,17466,171,164,8143,3767,3065,3373,730
19415,2260,2395,11124,8291,0,19415,4.31363e+18,583.724,5235.67,19415,419,372,17020,17020,17020,17020,16741
49360,486,648,49360,0,49360,0,4.41913e+18,362.743,3834.17,49360,229,229,48712,48695,44714,44598,45210
17823,1292,1903,10837,6986,0,17823,4.70254e+18,524.004,4493.3,17823,278,348,15920,15899,15449,15263,14422
21975,239,453,21969,6,21975,0,4.13604e+18,272.855,2447.28,21975,169,166,21264,20557,16559,16202,12733
31882,1899,2336,0,31882,0,31882,2.14512e+18,801.629,6208.65,31882,353,355,29546,29512,29291,28817,27201
35222,1327,3099,0,35222,0,35222,2.02496e+18,820.291,7706.86,35222,353,418,32123,31126,29100,26649,15411
5958,106,161,0,5958,5817,141,2.62688e+16,48.9067,660.481,5958,53,47,5797,5772,5688,5666,5072
26739,2206,3339,0,26739,0,26739,2.29771e+18,729.038,7431.69,26739,389,494,23400,23301,22381,21909,17727
37161,1067,3429,21938,15223,21938,15223,1.90576e+18,733.265,8386.78,37161,446,541,33732,32594,30676,30037,14117
37141,19,62,36705,436,37087,54,1.01432e+14,20.1831,785.865,37141,26,27,37051,36976,34093,34033,22960
4386,76,673,0,4386,1236,3150,9.64468e+15,116.728,1358.86,4386,131,129,3514,3100,2692,2745,708
40483,1971,2731,0,40483,12823,27660,9.18571e+15,461.75,7817.17,40483,358,655,37752,37743,37447,37391,29157
44783,2271,3445,26979,17804,0,44783,4.98522e+18,1290.75,9245.1,44783,659,474,41338,40298,39598,39100,34017
49700,1341,4585,29392,20308,29392,20308,1.83404e+18,1147.41,11169.7,49700,640,525,44970,42430,34532,32407,20398
22446,868,1372,22446,0,20031,2415,2.87229e+18,707.973,4420.32,22446,291,289,21074,20942,18403,17943,17537
6981,9,25,6881,100,6981,0,1.02575e+14,13.2739,254.992,6981,16,18,6907,6853,6034,5989,5106
47718,672,2822,0,47718,0,47718,2.36327e+18,725.649,8125.36,47718,453,372,44262,42186,26557,21947,15851
37240,1220,2469,22776,14464,22776,14464,1.84563e+18,1103.96,7166.57,37240,468,365,34300,32734,31320,30305,22678
27705,763,1757,8571,19134,0,27705,3.22071e+13,499.314,5045.14,27705,358,323,25948,25342,24328,24405,15325
16709,2719,2949,14919,1790,10066,6643,1.96317e+18,437.097,5638.24,16709,260,371,13760,13760,13753,13755,13098
3100,433,761,3100,0,2737,363,2.92874e+18,293.229,1351.25,3100,116,126,2246,1895,1939,1930,1697
26907,174,268,0,26907,26392,515,2.5452e+16,126.584,1760.82,26907,83,94,26639,26587,25836,25647,23892
1798,160,553,0,1798,0,1798,2.23182e+18,97.2492,884.821,1798,86,83,1226,1037,847,869,603
16717,733,1586,5140,11577,0,16717,3.41587e+13,350.709,3993.29,16717,262,287,15131,14841,14176,14286,8833
47806,1392,3928,42579,5227,28569,19237,1.93561e+18,1535.34,10685,47806,532,752,42496,40851,35908,35603,19988
28901,709,3211,0,28901,0,28901,2.51037e+18,611.567,7084.87,28901,406,474,25406,24232,21807,14812,5139
34680,464,3570,34680,0,31267,3413,2.51694e+18,888.768,8237.69,34680,441,451,28505,23720,21388,20240,6112
10571,1120,1651,10571,0,9298,1273,2.61997e+18,413.742,3296.42,10571,261,222,8920,8895,8846,8844,8204
26602,73,80,26071,531,26602,0,1.02826e+14,18.7563,713.921,26602,29,29,26522,26522,26232,26257,26277
8161,665,1166,4936,3225,4936,3225,1.8658e+18,469.44,2488.33,8161,248,220,6982,6647,6371,6278,4740
4772,17,25,4713,59,4772,0,9.27242e+13,13.356,239.308,4772,18,15,4747,4740,4498,4514,3928
25012,1520,3061,22505,2507,15010,10002,1.9631e+18,1130.56,6908.74,25012,408,368,21651,20135,17403,17190,15449
2256,238,276,2256,0,2256,0,4.31624e+18,140.171,671.16,2256,76,63,1980,1928,1837,1834,1821
22701,22,32,22491,210,22701,0,1.00818e+14,17.2658,482.022,22701,20,21,22669,22665,22136,22137,21032
47314,1560,2784,0,47314,0,47314,2.46598e+18,1295.26,8080.47,47314,492,428,44365,42824,40310,33630,34705
8181,588,1105,4684,3497,0,8181,4.1001e+18,334.239,2416.86,8181,189,228,7076,6770,6547,6425,5066
38965,601,2189,22857,16108,22857,16108,1.78142e+18,883.173,6663.9,38965,408,480,35059,32235,29612,27586,17161
30343,2853,2919,18289,12054,0,30343,4.73e+18,934.752,7211.02,30343,448,452,27424,27424,27417,27418,27332
38042,66,69,37211,831,38042,0,9.92734e+13,16.8436,723.313,38042,25,28,37973,37973,37632,37632,37760
25427,60,250,0,25427,24900,527,2.57432e+16,128.729,1646,25427,88,98,24719,24127,21373,19516,13216
45367,117,323,0,45367,44774,593,2.62297e+16,157.282,2400.18,45367,113,135,44879,44487,39116,36882,28050
9171,641,1203,5456,3715,0,9171,5.32938e+18,541.013,2649.65,9171,237,221,7715,7056,7092,7078,5205
18517,1116,3070,18517,0,16851,1666,1.95704e+18,476.559,5839.17,18517,307,335,15447,14995,12949,13166,5933
7045,257,416,7039,6,7045,0,3.72883e+18,209.886,1380.08,7045,112,119,6629,6501,5928,5929,4825
2027,11,100,0,2027,1993,34,2.68039e+16,41.7321,316.087,2027,36,39,1809,1687,1505,1276,798
40313,816,3055,0,40313,0,40313,2.34088e+18,988.113,7888.38,40313,515,438,36270,34321,22519,21339,17960
13150,596,1484,7752,5398,0,13150,4.68787e+18,547.895,3502.51,13150,237,332,11486,10805,9830,9727,5026
23330,1697,2040,0,23330,7055,16275,9.21091e+15,405.707,5354.16,23330,281,473,21290,21290,21210,21175,19946
46472,483,2316,0,46472,13355,33117,9.53905e+15,735.786,7605.03,46472,467,498,42917,41293,34236,34530,12199
44874,2105,3629,44874,0,40037,4837,2.57931e+18,1803.11,9652.47,44874,561,525,40885,38813,35677,34484,30565
17743,308,1377,5534,12209,0,17743,3.60486e+13,344.078,3576.45,17743,281,240,15834,14199,10852,10244,7195
7070,113,166,0,7070,6964,106,2.40736e+16,71.5281,728.704,7070,56,57,6904,6891,6597,6616,6061
41869,1740,2217,0,41869,12356,29513,9.25635e+15,807.325,6767.64,41869,530,342,39652,39558,39172,39186,37808
10865,74,1553,6537,4328,0,10865,4.6368e+18,409.977,3297.56,10865,288,281,6964,5156,4022,3587,838
37043,418,1092,37043,0,37043,0,4.01437e+18,376.343,4000.32,37043,226,219,35907,35388,25992,25852,23509
13259,2187,2701,13259,0,12029,1230,1.98973e+18,461.61,4839.37,13259,258,402,10558,10548,10535,10540,9849
2589,227,837,1628,961,0,2589,4.96703e+18,126.279,1292.01,2589,145,162,1752,1505,1283,1267,536
34013,934,4223,20357,13656,20357,13656,1.85744e+18,634.671,9141.19,34013,676,525,29727,27779,20385,19490,10521
33874,928,2800,19594,14280,0,33874,4.5882e+18,985.46,7323.17,33874,487,476,30431,28238,22525,21548,15986
20151,1147,2552,0,20151,0,20151,2.31455e+18,481.176,5618.29,20151,331,316,17599,17448,15091,13428,10404
48583,1943,2665,14539,34044,0,48583,3.63106e+13,693.73,8162.84,48583,491,411,45918,45873,45376,45404,40329
27455,1898,3293,24448,3007,16064,11391,1.92674e+18,829.049,7379.04,27455,357,511,24162,23948,22724,22934,14157
6017,871,1229,3743,2274,0,6017,4.77385e+18,477.682,2321.97,6017,223,274,4788,4387,4246,4148,4023
46083,1374,1893,14186,31897,0,46083,3.54842e+13,493.804,6263.16,46083,338,317,44190,44174,43880,43890,39621
22909,1751,1916,0,22909,0,22909,2.09515e+18,686.29,4940.2,22909,278,393,20993,20976,20935,20961,20584
12588,681,1238,3542,9046,0,12588,3.69103e+13,397.406,3024.75,12588,323,216,11350,11115,10804,10829,8942
18520,528,782,18520,0,18520,0,4.27503e+18,332.873,2664.52,18520,176,179,17738,17633,16576,16576,16313
41888,2445,3462,25327,16561,0,41888,4.90082e+18,920.348,8659.17,41888,560,385,38426,38300,37883,37713,35308
23308,115,2168,21360,1948,12990,10318,1.89591e+18,881.761,5131,23308,355,295,17372,10922,5169,4604,1035
6153,288,423,6147,6,6153,0,4.08109e+18,221.057,1297.51,6153,111,111,5730,5645,5145,5157,4376
38426,29,78,37787,639,38384,42,1.01702e+14,18.3782,826.171,38426,28,31,38348,38344,35270,35080,24098
24015,746,1916,7390,16625,0,24015,3.64822e+13,503.253,5345.53,24015,307,395,22089,21442,19812,19924,10473
24602,1656,3287,24602,0,22221,2381,2.69005e+18,806.216,6848.33,24602,495,414,21315,20519,19610,19168,11719
21190,722,1608,0,21190,0,21190,2.44657e+18,831.615,4518.57,21190,342,312,18952,17424,15857,14884,11119
31926,137,3400,18841,13085,0,31926,5.08664e+18,825.056,7685.74,31926,406,390,23783,19680,16312,12527,2138
9057,1730,1861,5432,3625,0,9057,4.74377e+18,292.168,3294.7,9057,222,295,7196,7186,7186,7192,7048
24148,1431,3876,21261,2887,13823,10325,1.95584e+18,739.244,7744.48,24148,454,425,20272,19091,14496,14687,11560
31936,35,235,0,31936,31269,667,2.44946e+16,141.928,1861.45,31936,97,98,30576,29782,25475,23026,14225
33797,209,3886,29982,3815,20442,13355,1.95417e+18,1040.88,8710.74,33797,489,424,23961,18366,10361,9113,3869
4821,453,1259,2928,1893,2928,1893,1.87114e+18,189.728,2051.63,4821,227,153,3562,3382,3230,3230,1635
35338,49,50,34524,814,35338,0,1.01891e+14,21.4984,644.947,35338,26,27,35288,35288,35222,35222,35281
12246,161,2204,12246,0,10952,1294,2.33853e+18,401.89,4156.37,12246,329,277,8409,6906,3483,2193,1698
12779,1325,1917,0,12779,0,12779,2.38652e+18,382.41,3875.02,12779,282,355,10862,10859,10614,10716,8164
29819,57,2458,8732,21087,0,29819,3.70681e+13,507.124,6610.62,29819,358,622,21619,18240,13855,8204,2943
36244,3044,3768,21658,14586,0,36244,5.01559e+18,586.514,8650.48,36244,334,621,32476,32465,32163,32138,28411
6864,15,32,6745,119,6864,0,1.02519e+14,13.8578,281.351,6864,20,19,6828,6818,6291,6290,4972
34267,42,48,33497,770,34267,0,1.03137e+14,19.4165,641.413,34267,25,26,34219,34219,33877,33877,33542
11045,200,406,11045,0,11045,0,3.84769e+18,213.152,1613.5,11045,137,126,10569,10308,8392,8515,5661
34218,2374,3754,34218,0,30480,3738,2.39824e+18,975.845,8701.08,34218,342,443,30464,30252,29707,29494,26193
15811,479,2071,15811,0,14370,1441,1.75422e+18,571.717,4217.97,15811,274,266,13494,12679,4514,3434,2854
28155,182,215,0,28155,27660,495,2.55139e+16,133.831,1584.6,28155,90,98,27940,27939,27366,27378,26413
7191,737,1274,7191,0,6669,522,2.5381e+18,320.718,2493.32,7191,223,157,5917,5807,5853,5806,3926
41352,1184,2988,0,41352,0,41352,2.27976e+18,908.282,8056.11,41352,597,428,38133,36918,31039,32213,21382
15215,160,544,15215,0,15215,0,4.35555e+18,277.828,2140.73,15215,149,155,14097,13145,7671,7342,6192
37986,865,893,37986,0,37986,0,4.1847e+18,371.176,3780.34,37986,221,216,37093,37093,37049,37071,37046
30395,232,631,30395,0,30395,0,4.00377e+18,342.449,3073.88,30395,193,185,29216,27866,20589,20370,16151
17460,1671,1887,10580,6880,0,17460,4.76374e+18,655.167,4503.07,17460,304,322,15573,15570,15528,15510,14794
21049,1066,2405,0,21049,0,21049,2.43235e+18,495.08,5561.51,21049,291,326,18644,18379,17367,17118,11687
30522,123,310,0,30522,30093,429,2.53838e+16,137.474,1892.37,30522,104,108,30148,29857,26826,25763,22128
3844,344,980,0,3844,0,3844,2.46005e+18,181.866,1594.46,3844,156,126,2864,2561,2514,2448,1437
3118,473,520,0,3118,991,2127,9.02758e+15,198.654,1052.94,3118,174,142,2598,2542,2558,2575,2541
45666,366,3569,27018,18648,27018,18648,1.7276e+18,831.857,9398.31,45666,484,528,39313,33724,22579,19364,6181
18408,2186,2301,16581,1827,10784,7624,1.89883e+18,483.71,5117.08,18408,374,258,16107,16107,16094,16088,16007
5141,138,756,3180,1961,0,5141,4.8627e+18,322.506,1632.95,5141,176,172,3513,2826,2284,2189,1520
10683,21,40,10405,278,10683,0,1.07711e+14,18.1185,367.195,10683,22,24,10639,10628,10033,9992,7615
41973,866,3177,25159,16814,25159,16814,1.88075e+18,1040.04,8461.43,41973,504,433,37580,34093,26350,27714,13412
28334,734,1994,0,28334,8832,19502,9.07365e+15,444.364,5632.45,28334,347,467,26284,25746,24352,24414,14135
16818,84,204,0,16818,16559,259,2.58616e+16,90.7484,1188.47,16818,75,79,16577,16428,14758,14275,11086
49962,3750,3794,0,49962,0,49962,2.23303e+18,1199.93,10419.8,49962,474,648,46168,46166,46168,46168,46029
25548,174,230,0,25548,25098,450,2.67382e+16,112.318,1698.18,25548,92,95,25318,25304,24963,24753,23614
13638,201,1516,4085,9553,0,13638,3.76116e+13,314.864,3515.5,13638,239,315,11508,10182,8509,7892,4006
38940,728,2110,23761,15179,0,38940,5.02083e+18,1059.6,6887.31,38940,434,399,35472,32455,27384,26880,19551
38115,2096,3695,33922,4193,23141,14974,1.93442e+18,883.04,8961.73,38115,572,405,34420,34224,31209,29767,25352
41879,26418,41879,0,41879,41879,0,4095.9,0,41879,41879,41879,1,0,0,0,0,0
19403,1175,2262,11788,7615,11788,7615,1.91296e+18,412.869,4800.97,19403,339,260,17141,16931,16732,16748,13897
35694,320,902,35684,10,35694,0,4.16645e+18,379.16,3713.88,35694,216,215,34495,33414,24095,23206,22015
8306,1512,1723,4877,3429,4877,3429,1.83414e+18,243.348,3093.33,8306,261,197,6583,6583,6542,6544,6196
32430,4207,4281,32430,0,29038,3392,2.34403e+18,611.703,8822.72,32430,362,625,28149,28149,28147,28140,28122
40549,616,730,40525,24,40524,25,4.04193e+18,374.41,3660.38,40549,214,215,39819,39815,39560,39569,39536
10354,363,630,10354,0,10354,0,4.32376e+18,271.218,1904.7,10354,139,138,9724,9540,7940,7882,7813
31527,3131,3206,18699,12828,0,31527,4.80836e+18,942.829,7580.27,31527,494,490,28321,28321,28303,28310,28229
47455,58,86,46534,921,47455,0,1.03165e+14,20.4547,878.008,47455,30,30,47369,47369,46156,46156,41028
11549,2215,2527,11549,0,10498,1051,1.49463e+18,387.841,4307.46,11549,295,263,9022,8994,8930,8908,7878
46520,2013,2729,0,46520,13358,33162,9.23586e+15,803.613,8292.57,46520,502,469,43791,43734,43494,43449,38777
2979,222,260,2979,0,2979,0,3.75382e+18,168.01,776.618,2979,86,81,2705,2549,2592,2568,2484
30139,1932,2531,0,30139,0,30139,2.26528e+18,918.245,6723.55,30139,367,443,27608,27428,26988,26943,25250
40020,2100,2381,0,40020,11916,28104,9.37287e+15,558.845,7329.28,40020,415,470,37639,37637,37539,37505,36274
27508,2364,2464,15060,12448,15060,12448,1.59484e+18,911.351,5893.97,27508,382,442,25044,24973,24989,25019,24725
45908,2054,3429,0,45908,0,45908,2.34739e+18,1358.2,9176.86,45908,517,521,42408,41046,39470,35125,32178
26701,1602,3648,23133,3568,15762,10939,1.98736e+18,979.971,7684.11,26701,448,457,22968,22204,17024,16463,9783
18062,1191,2442,10946,7116,0,18062,5.05775e+18,870.808,5152.97,18062,364,360,15483,14594,13138,13389,9292
34269,800,2486,20191,14078,20191,14078,1.76643e+18,912.872,6649.43,34269,382,462,31335,30420,27972,27905,14689
27009,543,1632,0,27009,8238,18771,8.82133e+15,567.928,4994.84,27009,311,281,24884,23797,22130,22125,13073
2704,499,766,2704,0,2482,222,1.21537e+18,137.823,1254.55,2704,121,116,1938,1932,1716,1709,1184
22454,1665,2511,13295,9159,0,22454,4.74223e+18,684.356,5816.42,22454,354,374,19943,19624,19579,19474,17141
35807,75,84,34994,813,35807,0,1.06075e+14,21.7661,824.356,35807,30,30,35723,35723,35425,35425,34877
12652,791,1243,3860,8792,0,12652,3.65582e+13,300.024,3130.62,12652,237,297,11409,11397,11044,11062,9459
36123,1625,2379,20239,15884,20239,15884,1.52282e+18,944.595,6559.45,36123,408,391,33744,32755,33069,32863,30415
3802,280,787,1181,2621,0,3802,2.94806e+13,112.478,1469.1,3802,271,127,3015,2942,2340,2303,1572
44667,1644,4283,25862,18805,0,44667,4.82225e+18,1203.31,10620.7,44667,554,711,40145,38629,35332,35139,19014
4008,839,970,2426,1582,0,4008,5.38087e+18,201.456,1584.77,4008,151,133,3038,3007,3024,3024,2890
3713,248,601,1302,2411,0,3713,3.06288e+13,119.676,1197.6,3713,134,119,3112,2986,2677,2679,1941
9446,578,692,0,9446,3080,6366,9.44508e+15,232.799,1909.83,9446,160,165,8754,8753,8744,8746,8342
16136,45,245,0,16136,15859,277,2.5682e+16,95.593,1406.08,16136,75,74,15586,15268,13197,11887,8108
13576,155,185,0,13576,13322,254,2.41873e+16,98.0577,995.385,13576,72,73,13391,13368,13266,13173,12782
27818,2117,2591,16893,10925,0,27818,4.69742e+18,712.953,6339.69,27818,393,444,25227,25210,24588,24479,23749
30775,803,3085,18180,12595,0,30775,5.05475e+18,787.9,7374.86,30775,389,438,27181,26292,25028,24353,10250
14491,35,42,14173,318,14491,0,1.01083e+14,16.8647,416.259,14491,19,25,14449,14449,14145,14144,13682
38281,3740,4295,33930,4351,22697,15584,1.94854e+18,1460.42,9809.73,38281,488,512,33986,33864,33860,33805,32236
49618,61,146,48363,1255,49618,0,1.03507e+14,17.7302,1069.2,49618,32,35,49472,49470,46761,46714,33433
39351,214,294,0,39351,38694,657,2.74728e+16,162.037,2306.26,39351,108,117,39057,38998,37628,37308,34694
1597,210,329,1597,0,1597,0,4.22861e+18,118.687,633.871,1597,78,59,1268,1193,1127,1099,1044
8996,687,1835,8996,0,8043,953,2.66857e+18,507.337,3358.76,8996,257,269,7120,6084,5587,5260,4322
31207,55,3706,31207,0,27769,3438,2.49786e+18,1026.14,8360.82,31207,492,414,17476,12167,6209,3238,816
25592,2037,2076,25592,0,22769,2823,2.38608e+18,630.855,5456.66,25592,374,338,23516,23516,23516,23516,23516
7740,222,417,7740,0,7740,0,4.52041e+18,244.284,1440.96,7740,120,113,7220,6816,5728,5591,4854
24678,16,25,24073,605,24678,0,9.45096e+13,16.7356,474.447,24678,21,20,24645,24621,23278,23277,22217
21679,1,50,21423,256,21649,30,1.03779e+14,17.3428,571.047,21679,22,22,8928,8928,8928,8928,8928
8567,102,1616,7594,973,5104,3463,1.92262e+18,399.224,3009.2,8567,254,249,5336,4017,2655,2108,850
42055,2209,3191,0,42055,0,42055,2.27827e+18,1063.9,8856.55,42055,429,533,38864,38784,38286,38285,35940
9764,138,169,0,9764,9634,130,2.68113e+16,85.3631,866.898,9764,75,66,9595,9589,9495,9476,9257
5535,988,1379,5535,0,4995,540,2.79216e+18,429.007,2307.36,5535,187,165,4156,3856,3856,3848,3571
2746,397,580,728,2018,0,2746,3.91664e+13,95.902,1027.91,2746,142,116,2166,2158,2157,2160,1706
23634,848,3167,23634,0,21069,2565,2.65327e+18,1201.27,6836.08,23634,409,459,19587,17623,14246,13067,10074
42292,49,68,41582,710,42256,36,1.00811e+14,22.2192,836.16,42292,29,29,42224,42224,41644,41642,39161
12727,739,1054,3843,8884,0,12727,3.55415e+13,327.665,2728.5,12727,291,218,11673,11673,11475,11496,10801
7515,21,151,0,7515,7390,125,2.69917e+16,71.2579,747.795,7515,53,59,7107,6926,5881,5511,2966
20675,1088,1915,0,20675,0,20675,1.90485e+18,436.671,4697.72,20675,413,281,18760,18665,17320,16142,12688
14501,111,186,0,14501,14208,293,2.48806e+16,122.872,1024.75,14501,75,75,14260,14155,12979,13289,11448
29406,1813,3040,29406,0,26093,3313,3.09086e+18,990.885,7440.74,29406,450,352,26366,26150,24376,24006,18205
41740,3,331,0,41740,41036,704,2.60592e+16,155.958,2322.27,41740,114,111,28069,22968,20978,20083,13848
12674,263,664,12674,0,12674,0,4.06142e+18,279.204,2141.57,12674,158,157,11876,11339,8488,8297,7493
7472,603,1688,6694,778,4483,2989,1.96601e+18,343.435,2986.85,7472,315,212,5716,5111,3777,3623,2645
16886,1444,1841,5027,11859,0,16886,3.66532e+13,310.963,4366.27,16886,208,387,15045,15043,14947,14927,13479
28717,633,865,28717,0,28717,0,4.03017e+18,314.7,3239.05,28717,200,193,27852,27835,25966,25932,25896
19964,768,1914,0,19964,5988,13976,9.65438e+15,358.893,4828.86,19964,268,401,18050,17765,17298,17182,10783
35024,925,2369,21479,13545,21479,13545,1.8254e+18,624.447,6524.35,35024,417,416,32637,32059,28869,27732,20444
48334,162,1116,48334,0,48334,0,4.22823e+18,389.811,4419.16,48334,235,235,43900,38052,25041,23931,12246
1084,100,396,638,446,638,446,2.02214e+18,61.4197,581.643,1084,53,84,677,562,518,492,222
31976,20,52,31352,624,31976,0,9.50782e+13,18.7168,622.85,31976,27,25,31919,31904,29100,29076,21348
39410,613,2667,12534,26876,0,39410,3.4647e+13,686.791,7388.37,39410,529,522,36238,35542,26721,26774,11069
6365,1085,1275,0,6365,0,6365,2.50608e+18,313.414,2324.88,6365,240,172,5090,5046,5049,5048,4762
23827,41,47,23479,348,23827,0,9.86411e+13,17.0411,543.917,23827,24,25,23780,23780,23469,23469,22824
37229,1350,2132,22318,14911,22318,14911,1.85976e+18,1151.51,6688.3,37229,479,403,34797,32932,32415,32144,28027
48813,1257,2567,0,48813,15455,33358,8.68101e+15,788.358,8113.44,48813,436,474,46246,45506,43176,43362,32804
3132,50,357,3132,0,3132,0,4.42183e+18,167.229,882.219,3132,85,83,2154,1445,1037,990,582
6580,751,1225,3931,2649,3931,2649,1.75665e+18,342.423,2357.47,6580,228,199,5355,5089,5017,4945,4176
14000,23,52,13791,209,14000,0,9.83154e+13,14.9354,474.165,14000,23,24,13948,13948,13613,13602,12145
24007,1131,2641,13900,10107,0,24007,4.46094e+18,514.075,6209.6,24007,283,522,21366,21168,20593,20454,12494
5720,722,929,3104,2616,0,5720,4.19137e+18,207.993,1889.81,5720,151,193,4791,4730,4712,4685,4486
21060,590,783,21060,0,21060,0,4.24686e+18,298.776,2741.56,21060,186,183,20277,20225,19426,19421,19349
29314,642,1644,0,29314,8584,20730,9.66269e+15,663.94,5117.9,29314,363,317,27272,25868,24080,24055,18740
24691,17,39,24096,595,24691,0,9.7173e+13,17.317,519.443,24691,22,23,24640,24603,22370,22310,17111
37226,287,1028,37174,52,37226,0,4.35373e+18,366.861,3847.13,37226,224,226,35929,35065,22554,21381,17630
41199,2318,4703,41199,0,36778,4421,2.42114e+18,969.149,10588.8,41199,542,512,36496,35913,33032,30971,23833
26050,1253,1958,7882,18168,0,26050,3.61383e+13,558.054,5480.26,26050,426,330,24092,23949,22810,22925,18819
43349,13,64,42410,939,43349,0,1.02334e+14,21.4265,752.968,43349,26,28,43175,43041,38478,38226,23548
6994,1109,1751,6994,0,6334,660,2.68711e+18,256.644,2877.47,6994,230,247,5243,5220,4827,4878,3830
7623,809,841,0,7623,2109,5514,9.27402e+15,220.861,1939.96,7623,243,135,6782,6781,6765,6772,6749
6984,707,995,2158,4826,0,6984,3.68412e+13,233.587,2155.38,6984,179,185,5989,5959,5879,5864,4912
8996,1041,1302,0,8996,2770,6226,9.42483e+15,188.099,2776.04,8996,165,274,7694,7692,7646,7625,6951
28752,1624,1858,0,28752,8864,19888,9.06757e+15,493.463,5395.78,28752,416,291,26894,26894,26622,26647,25637
21018,2434,2513,18674,2344,12506,8512,2.0261e+18,1112.21,5800.66,21018,408,434,18505,18505,18489,18497,18450
2139,371,388,671,1468,0,2139,3.46931e+13,149.492,789.892,2139,116,94,1751,1751,1751,1751,1730
28643,1,74,28150,493,28643,0,1.04776e+14,16.5888,649.146,28643,27,27,11587,11587,11587,11587,11587
6646,4,22,6512,134,6646,0,1.00291e+14,13.5159,245.043,6646,16,18,6096,5784,5288,5123,3422
47142,85,3000,28796,18346,28796,18346,1.81178e+18,1042.96,8864.99,47142,608,365,31787,25104,20398,14445,2394
7201,23,926,3937,3264,0,7201,3.74757e+18,172.598,1931.45,7201,154,147,3201,1286,1038,960,150
9596,401,483,9596,0,9596,0,4.06642e+18,243.132,1689.88,9596,140,127,9113,9101,8778,8789,8674
44759,3102,3118,0,44759,0,44759,2.36113e+18,1043.59,8584.86,44759,553,575,41641,41641,41639,41639,41615
10778,60,208,0,10778,10553,225,2.66757e+16,84.8014,1066.07,10778,58,72,10464,10270,8990,8516,5442
16679,451,1303,5379,11300,0,16679,3.48695e+13,309.585,3476.09,16679,241,239,15376,14945,12562,12655,7464
24673,8,265,0,24673,24287,386,2.61152e+16,102.249,1743.79,24673,85,91,20841,18032,16726,14370,9161
12819,1488,2171,7766,5053,0,12819,5.12473e+18,413.043,4146.95,12819,223,315,10648,10590,10343,10369,7743
14931,409,1079,0,14931,4512,10419,9.36163e+15,484.096,3036.51,14931,300,244,13516,12651,11258,11231,7086
7733,108,117,0,7733,7607,126,2.02858e+16,71.1744,608.038,7733,59,62,7616,7612,7493,7538,7323
31265,2761,2935,18245,13020,0,31265,4.5758e+18,1190.11,7186.55,31265,421,406,28330,27915,28175,28164,27951
21748,2459,2528,19666,2082,12315,9433,1.87602e+18,782.988,5678.47,21748,282,357,19220,19188,19215,19218,19054
38490,10,16,38346,144,38490,0,2.16144e+18,15.9933,784.755,38490,16,16,23085,0,9625,21642,23085
6797,532,965,0,6797,2124,4673,8.92738e+15,202.472,2074.28,6797,219,170,5832,5779,5081,5098,3585
8174,13,24,8067,107,8174,0,9.99318e+13,11.6702,278.462,8174,17,17,8138,8123,7606,7562,6115
48805,3605,3908,0,48805,0,48805,2.35643e+18,832.096,9750.52,48805,429,577,44897,44890,44818,44846,44246
780,3,9,769,11,780,0,1.23416e+14,7.95641,70.8047,780,9,9,662,610,491,486,456
49348,1027,2265,0,49348,14919,34429,9.03722e+15,663.795,7346.12,49348,492,318,47008,46670,38010,39188,24045
6195,12,24,6121,74,6195,0,1.12227e+14,14.7629,244.577,6195,18,17,6159,6142,5718,5698,5006
49962,2555,2761,0,49962,0,49962,2.4059e+18,1167.2,8462.56,49962,566,451,47201,47176,47131,47019,46188
26479,2508,2690,15936,10543,15936,10543,1.79017e+18,804.713,6347.06,26479,387,430,23789,23788,23736,23753,23492
5258,833,1191,5258,0,4702,556,2.21259e+18,347.569,2127.79,5258,187,174,4067,4037,4004,4000,3474
1301,177,245,666,635,0,1301,3.5436e+18,88.0008,495.222,1301,58,65,1056,1055,1054,1054,991
1632,116,438,1003,629,1003,629,1.91187e+18,149.884,710.944,1632,104,84,1058,908,831,683,714
43892,631,2381,12608,31284,0,43892,3.77872e+13,702.672,7436.79,43892,446,419,40800,38913,33808,34177,17981
40419,1256,3027,40419,0,36376,4043,1.08293e+18,715.464,7800.66,40419,454,383,37392,36741,30761,30681,22104
45657,541,2265,0,45657,13421,32236,9.12961e+15,784.388,7068.69,45657,441,452,42535,40945,33228,31354,15654
47522,2249,3259,47522,0,41845,5677,2.43574e+18,1617.86,9366.11,47522,521,495,44217,42693,42607,42165,36451
34908,1449,1954,10358,24550,0,34908,3.66707e+13,645.427,5732.39,34908,413,315,32954,32776,32432,32467,30468
9453,863,2264,9453,0,8600,853,1.7475e+18,314.813,3820.55,9453,241,307,7189,6932,4532,3902,2761
42614,1951,3534,37741,4873,25433,17181,2.00526e+18,1242.42,9292.41,42614,498,472,39080,38159,35230,34987,31688
14315,774,1296,8646,5669,8646,5669,1.91848e+18,683.372,3381.12,14315,260,256,12847,11932,11383,10939,9401
21762,143,1510,0,21762,6588,15174,8.4919e+15,521.266,4154.16,21762,334,265,18820,17308,11129,11106,3402
46075,1675,3847,27409,18666,0,46075,4.94221e+18,1036.67,10026,46075,559,534,42228,41097,39215,38570,24426
18186,598,2562,0,18186,0,18186,2.32015e+18,482.541,5390.86,18186,402,276,15473,14456,10747,9678,5386
30184,1380,2113,9021,21163,0,30184,3.38219e+13,583.707,5964.12,30184,382,336,28071,27771,27577,27565,24074
9539,456,1143,2787,6752,0,9539,3.51196e+13,246.375,2523.42,9539,211,193,8396,8070,7914,7929,5354
1078,409,454,687,391,687,391,1.74585e+18,63.0891,624.434,1078,70,94,624,624,619,617,607
44678,1649,1988,13016,31662,0,44678,3.64484e+13,850.348,6894.91,44678,451,424,42690,42688,42073,42120,38659
16821,856,1294,5122,11699,0,16821,3.49903e+13,579.475,3694.54,16821,320,314,15506,14906,14549,14551,12730
42829,2582,4107,25612,17217,0,42829,4.77448e+18,1036.4,9842.19,42829,578,502,38722,38576,37097,36662,31867
24633,40,58,24018,615,24613,20,1.0115e+14,18.4755,641.845,24633,25,29,24575,24575,24139,24158,22284
6130,14,32,5984,146,6130,0,1.09284e+14,13.4706,267.298,6130,19,18,6091,6073,5526,5479,4207
7555,737,1701,4551,3004,0,7555,4.90394e+18,360.383,2931.91,7555,264,270,5854,5548,5146,5201,3369
42490,2626,2840,0,42490,13317,29173,8.75288e+15,660.533,7960.58,42490,467,538,39650,39650,39591,39597,39069
48354,1643,4390,28902,19452,0,48354,4.62971e+18,1035.71,10761.5,48354,572,584,43964,42181,33639,33492,25764
20311,570,1647,0,20311,6470,13841,8.85416e+15,359.167,4400.26,20311,267,403,18664,18074,16956,17149,7790
10026,32,599,10026,0,10026,0,4.31861e+18,260.714,1827.61,10026,141,141,5843,3178,2488,2201,827
6157,523,1193,6157,0,5442,715,2.59181e+18,366.366,2232.62,6157,196,141,4944,4510,3629,3297,2461
36460,670,873,36460,0,36460,0,4.14185e+18,328.509,3651.48,36460,209,214,35587,35552,33129,32976,31724
44183,338,2300,12852,31331,0,44183,3.6269e+13,690.853,7300.41,44183,395,479,40338,37325,28180,28302,12023
24563,161,795,24563,0,24563,0,4.20659e+18,333.531,3013.15,24563,189,195,22241,19535,13123,12064,8544
26705,2525,3451,26705,0,23442,3263,1.03401e+18,874.521,7477.42,26705,487,362,23254,23081,22523,22539,19750
19043,34,246,0,19043,18784,259,2.46714e+16,118.342,1436.53,19043,82,85,18063,17423,14872,13665,8469
8086,564,914,2372,5714,0,8086,3.64506e+13,278.973,2208.6,8086,180,207,7172,7129,6989,6987,5531
43343,19390,43343,0,43343,0,43343,1048550,0,43343,43343,43343,1,0,0,0,0,0
24087,102,3033,0,24087,0,24087,2.38336e+18,545.884,6510.66,24087,415,286,16096,12560,7717,6119,1144
46147,434,1021,46135,12,46147,0,4.34704e+18,364.168,4277.27,46147,235,230,45126,44890,34352,33612,29329
40572,460,4341,36556,4016,24630,15942,2.00169e+18,1294.96,9706.97,40572,543,529,33295,26766,18895,17439,4154
35376,1702,3089,0,35376,0,35376,2.28611e+18,769.453,7918.36,35376,563,472,32287,32109,28751,26952,22753
1479,290,386,471,1008,0,1479,3.31375e+13,104.211,639.616,1479,118,98,1093,1050,1059,1058,1028
25763,25,46,25419,344,25763,0,1.014e+14,19.8041,554.147,25763,25,24,25717,25703,25002,24962,22238
26434,883,2007,0,26434,8007,18427,9.15549e+15,460.244,5461.96,26434,405,293,24427,24169,22182,22439,16218
3778,625,958,2252,1526,0,3778,4.92015e+18,185.013,1603.91,3778,201,128,2820,2751,2695,2598,2121
38438,3371,3708,23408,15030,23408,15030,1.83359e+18,934.318,8533.49,38438,504,517,34730,34716,34614,34647,33983
46827,81,102,46133,694,46827,0,1.02691e+14,20.5256,897.745,46827,32,31,46725,46725,45987,46002,44168
8339,995,1894,4987,3352,0,8339,4.79752e+18,221.578,3257.53,8339,266,192,6445,6373,5905,5828,3591
9005,1408,1565,9005,0,8257,748,1.8311e+18,198.045,2870.07,9005,173,214,7440,7440,7440,7440,6373
32824,1403,1879,0,32824,10327,22497,8.48308e+15,540.747,5637.22,32824,398,418,30945,30824,30229,30319,28016
1778,2,8,1705,73,1778,0,9.98938e+13,7.67942,102.433,1778,8,8,1390,1273,1248,1254,1026
35905,7699,35905,0,35905,35905,0,4095.89,0,35905,35905,35905,1,0,0,0,0,0
39426,28,72,38632,794,39401,25,1.01129e+14,18.6375,730.888,39426,26,28,39354,39351,36390,36360,27388
25933,39,60,25262,671,25933,0,9.60576e+13,18.2554,596.489,25933,26,27,25873,25873,25179,25179,22989
32736,92,687,32736,0,32736,0,3.92838e+18,333.11,3257.85,32736,202,201,27705,21498,14900,13888,7476
6457,765,1160,3873,2584,0,6457,5.02825e+18,307.437,2220.46,6457,164,188,5297,5216,5199,5204,4323
21660,75,231,0,21660,21157,503,2.66541e+16,132.862,1567.5,21660,91,92,21163,20761,18009,17007,12637
30374,40,48,29563,811,30374,0,1.01789e+14,18.5061,598.766,30374,25,24,30326,30326,29492,29492,27361
3628,65,539,1144,2484,0,3628,3.59648e+13,190.681,1124.56,3628,124,132,2531,2156,1570,1076,345
18409,187,2090,10595,7814,0,18409,4.28498e+18,379.778,4757.45,18409,236,355,15068,13449,7757,7055,2219
12625,818,973,0,12625,3643,8982,9.16487e+15,448.265,2613.99,12625,250,227,11652,11465,11489,11498,11095
46977,747,1853,0,46977,14662,32315,7.65671e+15,803.997,6375.12,46977,415,397,44721,43623,42035,42308,29157
4718,135,820,1363,3355,0,4718,3.88119e+13,168.893,1583.69,4718,160,151,3668,3247,2252,2313,870
3529,458,460,3529,0,3529,0,3.8321e+18,159.234,1042.91,3529,95,83,3069,3069,3069,3069,3067
34381,19,84,33658,723,34381,0,9.91113e+13,17.9664,752.494,34381,31,29,34284,34242,30866,30734,19286
48214,3764,4132,43117,5097,29261,18953,1.98375e+18,1017.78,10332,48214,482,493,44082,44081,44073,44074,43118
41096,1935,2935,0,41096,12093,29003,9.28238e+15,620.087,8170.59,41096,420,592,38161,38131,37687,37526,27737
34345,3557,3610,20078,14267,0,34345,4.70189e+18,788.207,8503.74,34345,454,466,30735,30735,30728,30729,30655
35599,307,1054,35599,0,35599,0,4.05295e+18,361.325,3865.62,35599,215,230,34216,32966,22393,21898,17286
31056,77,363,0,31056,30407,649,2.4662e+16,138.912,2369.83,31056,109,118,30371,29810,25744,23291,15391
14904,147,213,0,14904,14561,343,2.64898e+16,102.891,1203.61,14904,68,70,14691,14667,13789,13893,12293
33132,58,327,0,33132,32484,648,2.60549e+16,131.666,2208.98,33132,102,102,32275,31676,26475,23406,15813
12995,251,642,12995,0,12995,0,4.14791e+18,297.085,2124.93,12995,153,152,12169,11527,8379,8167,7305
22225,145,271,0,22225,21800,425,2.6385e+16,128.505,1650.19,22225,82,108,21937,21855,20231,19568,16509
45993,2359,4804,45993,0,41131,4862,2.68762e+18,961.916,11127.4,45993,618,476,41189,40572,39890,38761,26447
17800,1729,2174,10264,7536,10264,7536,1.83535e+18,544.62,4940.9,17800,333,358,15626,15621,15545,15557,14604
11279,1563,1926,6633,4646,6633,4646,1.76646e+18,290.62,3691.95,11279,223,283,9353,9340,9286,9320,7702
6999,2,28,6834,165,6999,0,9.55948e+13,13.2669,270.3,6999,16,18,5194,4587,4359,4497,3275
38240,32,264,0,38240,37098,1142,2.55801e+16,147.019,1989.24,38240,94,99,37007,36220,29231,25337,16454
40166,49,96,39677,489,40166,0,1.04683e+14,18.7606,790.915,40166,30,31,40070,40070,38309,38310,32623
19631,91,2739,17701,1930,11677,7954,2.00335e+18,892.988,5850.27,19631,339,347,12181,8554,5090,3951,793
29359,927,2140,0,29359,8260,21099,9.76575e+15,640.751,6062.22,29359,323,489,27184,26310,25670,25587,15965
15612,57,565,15612,0,15612,0,4.09179e+18,287.374,2178.51,15612,156,157,11433,8211,5923,5288,2663
33804,2383,4020,30322,3482,19816,13988,1.92921e+18,1083.98,8844.49,33804,459,477,29784,28987,26752,26870,20398
46131,950,4454,46131,0,41535,4596,1.68619e+18,1361.64,10662.9,46131,492,578,40154,37636,24520,20841,13596
31228,1368,3917,18723,12505,18723,12505,1.8805e+18,709.063,8546.72,31228,510,418,27311,26450,20912,20868,13476
25962,1132,1445,0,25962,8070,17892,9.02048e+15,486.588,4532.19,25962,324,322,24517,24499,24433,24420,23155
36574,2533,3053,0,36574,0,36574,2.31155e+18,938.97,7963.67,36574,450,450,33521,33483,33050,32631,30721
31389,64,1880,9710,21679,0,31389,3.60282e+13,600.473,5575.43,31389,320,341,22646,18948,13894,6679,3380
14386,1338,1340,0,14386,0,14386,2.08706e+18,441.432,3443.38,14386,223,284,13046,13046,13045,13044,13046
29580,973,3208,17302,12278,0,29580,4.62655e+18,782.035,7268.25,29580,417,545,26083,24875,21366,21658,13448
1722,539,653,1065,657,1065,657,1.75108e+18,101.48,957.55,1722,138,80,1069,1053,1039,1052,977
46195,985,1000,46195,0,46195,0,4.38853e+18,361.234,4217.47,46195,234,233,45195,45194,45172,45169,45043
4374,251,467,4374,0,4374,0,4.28929e+18,198.976,1166.08,4374,99,103,3905,3680,2795,2680,2662
35294,6,58,34466,828,35294,0,1.04323e+14,20.3074,688.863,35294,28,26,34106,32953,29309,29083,17447
19816,641,1667,12197,7619,0,19816,4.913e+18,457.965,4377.47,19816,346,258,18149,17658,12278,11854,9615
23208,1291,2370,13052,10156,13052,10156,1.73768e+18,634.959,5370.39,23208,252,447,20838,20397,20080,20125,12651
49274,391,3650,44302,4972,31170,18104,1.89716e+18,767.823,9415.15,49274,432,441,39465,30052,18819,17101,6619
19485,15,31,18871,614,19485,0,9.64688e+13,15.3825,425.185,19485,20,18,19446,19434,18539,18457,15877
43990,394,4153,43990,0,39408,4582,1.78061e+18,730.132,10118.8,43990,400,580,35131,26415,17544,13612,8093
41956,661,989,41656,300,41956,0,4.11958e+18,359.67,4057.12,41956,223,223,40967,40924,38387,38453,37281
40686,1569,4620,36290,4396,24557,16129,1.93305e+18,984.099,10433,40686,533,440,36066,35260,25352,24383,14449
40113,2116,2359,0,40113,11556,28557,9.68078e+15,690.307,7138.51,40113,375,422,37754,37754,37698,37675,36450
1177,6,14,1141,36,1177,0,7.70053e+13,12.3297,99.6183,1177,12,14,1094,946,930,932,805
37844,48,68,36789,1055,37844,0,1.01332e+14,21.1754,746.384,37844,27,28,37776,37774,36844,36844,32451
38515,687,796,38509,6,38515,0,4.09875e+18,353.84,3653.86,38515,212,220,37719,37714,37375,37390,37063
12274,1605,2892,12274,0,10955,1319,1.95398e+18,369.448,4832.83,12274,368,333,9382,9274,8172,7860,5393
11327,1142,1555,6809,4518,0,11327,4.95695e+18,530.708,3403.89,11327,300,232,9772,9615,9325,9292,7804
32371,2184,3265,0,32371,0,32371,2.29651e+18,802.903,7704.86,32371,486,373,29106,29055,27170,26459,24694
39841,3349,4104,23855,15986,0,39841,4.88493e+18,842.958,9588.99,39841,387,634,35737,35729,35377,35399,31708
12835,170,2607,0,12835,0,12835,2.31575e+18,336.226,4611.18,12835,412,275,9488,8033,5021,3680,809
23557,1327,3922,23557,0,21284,2273,2.42346e+18,657.798,7601.32,23557,342,481,19635,18703,11526,9621,7862
32605,1804,1989,0,32605,8795,23810,9.36496e+15,767.675,6034.34,32605,556,450,30616,30612,30562,30569,30179
29628,5,271,0,29628,29022,606,2.57315e+16,149.002,1788.89,29628,94,108,23116,19582,18296,15217,9778
36875,2749,4025,36850,25,33090,3785,2.68628e+18,1356.01,9284.62,36875,560,587,32850,31783,31352,30720,28864
41614,46,994,41614,0,41614,0,4.43044e+18,365.143,4047.05,41614,230,230,28173,18209,13699,12351,4046
13233,1001,1157,4135,9098,0,13233,3.26368e+13,271.099,2979.69,13233,269,226,12076,12076,11783,11776,11507
16721,1024,1501,0,16721,5019,11702,9.02108e+15,529.611,3961.6,16721,319,310,15220,14924,14669,14623,10999
39704,186,2719,11972,27732,0,39704,3.54823e+13,620.381,7746.78,39704,596,342,34029,30530,20405,7306,5772
26998,1041,2532,0,26998,0,26998,2.32748e+18,745.699,6315.94,26998,356,416,24466,23536,21832,17644,12833
16290,741,1148,5200,11090,0,16290,3.19126e+13,313.063,3150.54,16290,226,239,15142,14971,14580,14594,12355
1116,134,313,1080,36,590,526,2.1176e+18,16.9391,446.066,1116,86,62,803,802,774,595,334
23693,232,260,0,23693,23266,427,2.70981e+16,118.291,1628.47,23693,82,89,23433,23422,23415,23310,23094
15337,830,1217,0,15337,4811,10526,9.15585e+15,461.199,3379,15337,234,309,14120,13867,13887,13850,12197
11909,716,1371,6992,4917,6992,4917,1.91051e+18,595.98,3206.37,11909,264,247,10292,9166,9501,9245,7523
12808,1727,2084,12808,0,11691,1117,1.90709e+18,330.465,4028.32,12808,280,265,10724,10719,10658,10500,8715
22190,1785,1996,13250,8940,0,22190,4.7964e+18,547.615,5063.05,22190,354,290,20194,20194,20174,20172,19634
19570,1612,2122,19570,0,17219,2351,1.54811e+18,1115.56,5220.66,19570,322,377,17448,16306,16695,16713,15886
33773,66,73,33222,551,33072,701,9.64867e+13,18.397,765.606,33773,26,28,33700,33700,33310,33389,32309
42092,851,2845,24323,17769,24323,17769,1.76326e+18,1199.39,8284.39,42092,522,530,37660,35108,32005,31842,13645
28582,11,60,28229,353,28582,0,9.61067e+13,16.413,622.908,28582,26,24,28353,28193,25367,24804,15000
27327,1114,2512,16771,10556,16771,10556,1.86807e+18,496.245,6065.13,27327,317,380,24815,24664,22485,22163,12019
7284,62,403,7284,0,7284,0,4.09682e+18,203.223,1366.16,7284,112,108,5661,4058,3279,3285,1419
7929,924,1762,4749,3180,4749,3180,1.97701e+18,251.337,2930.69,7929,208,221,6167,6090,5873,5986,3871
27035,1372,3130,27035,0,24025,3010,1.17821e+18,1036.35,7397.3,27035,356,644,23510,22456,19416,18331,15262
21736,2122,2160,13281,8455,0,21736,4.6919e+18,565.033,5195.77,21736,285,381,19576,19576,19572,19572,19558
9586,129,179,0,9586,9446,140,2.72039e+16,86.4201,898.848,9586,55,59,9407,9376,9060,9124,8225
4118,13,23,4084,34,4118,0,1.0123e+14,13.7387,201.659,4118,17,18,4083,4062,3898,3898,3050
29024,113,2968,0,29024,0,29024,2.29291e+18,733.076,7301.57,29024,450,398,20117,16209,10347,8408,2347
30568,173,280,0,30568,29945,623,2.57393e+16,145.105,1962.52,30568,99,103,30260,30173,28526,28528,24556
11006,636,949,0,11006,3543,7463,7.38871e+15,201.069,2417.59,11006,195,221,10057,10008,9938,9971,7051
47507,2212,2278,14671,32836,0,47507,3.40374e+13,930.14,7567.77,47507,494,493,45229,45132,45210,45198,45054
22268,16,1130,0,22268,7030,15238,9.16917e+15,365.825,3361.82,22268,248,233,12002,8208,7265,7186,1467
44562,2118,2557,27019,17543,27019,17543,1.82423e+18,842.792,7645.57,44562,407,409,42005,42004,41745,41868,40806
17752,3829,17752,0,17752,17752,0,4095.77,0,17752,17752,17752,1,0,0,0,0,0
39976,32,236,0,39976,39370,606,2.48713e+16,147.05,2027.95,39976,103,111,38262,37325,31915,28437,17999
20946,1310,1470,0,20946,6614,14332,9.05784e+15,496.634,4300.25,20946,302,360,19476,19476,19405,19395,19096
22613,1157,2739,12985,9628,0,22613,4.42554e+18,493.104,5975.16,22613,423,413,19874,19006,15741,15951,11706
19789,168,565,19783,6,19789,0,4.19902e+18,311.322,2465.57,19789,173,173,18163,16013,11489,10812,7869
38899,493,3517,0,38899,0,38899,2.39202e+18,980.121,8663.9,38899,595,398,32871,29319,18760,15263,8505
32344,943,2421,19286,13058,0,32344,4.99212e+18,1047.83,6610.63,32344,407,387,29199,27785,26547,25555,16882
42470,36,57,41673,797,42470,0,9.65845e+13,20.5395,732.033,42470,25,27,42413,42413,41273,41274,36837
35746,3880,4020,32163,3583,21126,14620,1.91832e+18,666.764,8747.72,35746,451,422,31726,31726,31723,31721,31443
24107,844,1641,6918,17189,0,24107,3.70238e+13,565.726,4829.19,24107,393,324,22426,22055,21196,21228,16650
19368,1838,2172,11067,8301,0,19368,4.37245e+18,708.493,4857.33,19368,307,393,17196,16977,16920,16842,14907
6485,356,1080,6485,0,5809,676,1.7446e+18,391.479,2198.48,6485,199,178,4905,3610,2660,2379,2225
10474,3,53,10240,234,10474,0,9.81699e+13,16.2656,397.752,10474,23,22,8691,7866,7551,7243,4547
34347,312,333,0,34347,33667,680,2.61948e+16,143.895,2295.12,34347,108,124,34014,34010,33987,33843,33459
36192,2031,4708,21121,15071,0,36192,4.59958e+18,934.899,10106.2,36192,633,838,31484,30834,28054,27744,18519
23286,201,278,0,23286,22815,471,2.64113e+16,107.419,1818.68,23286,84,96,23008,23002,22667,22664,21102
9368,883,1646,5531,3837,0,9368,4.83404e+18,492.225,3272.94,9368,254,279,7722,7256,6790,6575,5338
1975,334,425,569,1406,0,1975,4.14705e+13,50.1195,739.598,1975,141,54,1550,1548,1547,1550,1310
25370,196,264,0,25370,24890,480,2.4665e+16,118.07,1731.87,25370,98,90,25106,25083,24171,23768,22119
18799,2341,2725,18799,0,16984,1815,2.56826e+18,400.55,5293.52,18799,327,366,16074,16005,16008,15900,15100
27783,222,3161,0,27783,0,27783,2.38904e+18,947.001,7291.06,27783,460,552,21230,17473,11836,8269,3008
32346,663,1920,9725,22621,0,32346,3.55679e+13,484.876,5681.15,32346,431,333,30290,29854,27743,27890,18741
40394,2643,2735,0,40394,12140,28254,9.14226e+15,657.842,7797.15,40394,611,665,37659,37655,37640,37637,37372
42911,80,82,41934,977,42911,0,9.64841e+13,22.6737,806.003,42911,32,31,42829,42829,42793,42794,42765
48360,8,70,47466,894,48360,0,1.01578e+14,21.2049,811.853,48360,30,30,47584,47175,41926,40936,22382
29407,434,911,29407,0,29407,0,4.31614e+18,353.988,3401.17,29407,206,203,28496,28086,22008,21817,20283
6211,12,32,6034,177,6211,0,1.06771e+14,12.1048,274.058,6211,17,20,6164,6135,5702,5661,4349
6016,10,32,5917,99,6016,0,1.04009e+14,12.6471,270.909,6016,18,16,5956,5930,5530,5431,4260
46049,2786,3407,27448,18601,27448,18601,1.84229e+18,967.694,9255.74,46049,462,576,42642,42639,42295,42379,38637
23182,552,2052,13288,9894,13288,9894,1.67658e+18,809.664,5182.16,23182,331,338,20422,18985,18240,17415,7394
48409,409,4043,43321,5088,28444,19965,1.90587e+18,1409.63,10612,48409,543,553,38573,32257,17691,16324,8127
35021,1755,2656,10590,24431,0,35021,3.57823e+13,618.58,7186.17,35021,525,284,32365,32258,30579,30685,24909
14877,986,2091,0,14877,0,14877,2.46221e+18,429.319,4234.43,14877,301,202,12786,12608,11951,10434,8594
49529,752,1153,49529,0,49529,0,4.29585e+18,442.657,4596.75,49529,244,246,48376,48198,44639,44343,44531
31767,2440,3920,28425,3342,19097,12670,1.95873e+18,866.895,8478.06,31767,398,469,27847,27689,26638,26836,19204
45300,2061,2674,0,45300,14090,31210,8.96081e+15,528.108,7935.96,45300,581,342,42626,42558,42201,42139,37067
20123,1174,1929,6510,13613,0,20123,3.36043e+13,356.078,4764.88,20123,434,297,18194,18151,17399,17499,13010
32449,36,58,31868,581,32423,26,1.02618e+14,19.0363,644.706,32449,26,27,32391,32391,31262,31266,28536
9734,273,1428,5374,4360,5374,4360,1.49359e+18,228.794,2831.62,9734,239,178,8283,7914,2855,4224,1349
841,3,14,827,14,841,0,1.10448e+14,9.11296,81.7477,841,12,11,675,581,579,565,376
18384,394,1671,0,18384,5398,12986,8.92178e+15,273.751,4207.61,18384,228,336,16653,15993,14882,15133,7041
35051,99,905,35051,0,35051,0,4.01548e+18,366.39,3662.87,35051,223,207,29306,23394,16395,15664,5722
5269,517,1592,5269,0,4769,500,2.77017e+18,169.037,2437.89,5269,190,172,3677,3451,2602,2685,1555
27726,994,1654,0,27726,8740,18986,7.98871e+15,628.918,4808.67,27726,344,418,26072,25438,24263,24275,17512
45103,82,3181,26764,18339,26764,18339,1.79807e+18,1482.57,8999.91,45103,515,564,29263,20682,15117,11491,2649
7181,29,39,7007,174,7181,0,1.0301e+14,13.8052,300.711,7181,20,22,7142,7142,6968,6970,6634
6449,846,858,0,6449,1851,4598,1.01133e+16,322.381,1889.53,6449,184,175,5591,5591,5584,5582,5573
6637,275,1427,6637,0,5951,686,2.48991e+18,424.824,2584.5,6637,219,215,4771,4117,2237,1590,1456
41256,2898,3629,24942,16314,0,41256,4.82892e+18,1144.18,9201.34,41256,545,451,37627,37577,36459,36171,34361
16542,149,231,0,16542,16171,371,2.48121e+16,98.3452,1369.5,16542,67,79,16311,16289,15718,15745,13917
45001,190,317,0,45001,44240,761,2.5716e+16,144.188,2434.67,45001,108,115,44677,44614,42167,41331,34580
7437,228,521,7437,0,7437,0,4.24713e+18,269.588,1545.03,7437,124,121,6755,6280,5079,4882,4489
22160,49,55,21692,468,22160,0,9.76528e+13,18.3903,550.556,22160,24,25,22105,22105,22017,22016,21775
31877,2596,3340,0,31877,0,31877,2.41045e+18,487.213,7337.71,31877,292,523,28537,28531,28225,28250,25215
19277,1331,2859,19277,0,17232,2045,1.82687e+18,530.396,5742.66,19277,308,401,16418,16163,13296,12349,7703
31246,1853,2136,9237,22009,0,31246,3.69253e+13,574.535,5988.83,31246,413,295,29110,29107,28793,28794,27649
1283,58,96,0,1283,1258,25,2.3701e+16,21.6251,263.399,1283,32,28,1187,1184,1130,1167,965
31794,655,3367,18814,12980,18814,12980,1.86932e+18,1381.09,8175.72,31794,472,699,26574,24707,21163,19748,8056
46038,884,977,46038,0,46038,0,4.07078e+18,389.593,4230.15,46038,225,234,45061,45058,44853,44865,44636
19925,1359,1632,6008,13917,0,19925,3.78504e+13,471.528,4411.09,19925,315,323,18293,18265,18149,18165,16738
36304,3290,3293,21748,14556,21748,14556,1.8036e+18,1013.42,8110.08,36304,444,660,33011,33011,33011,33011,33011
34862,124,3128,34862,0,31600,3262,2.3776e+18,1484.15,7851.64,34862,417,459,25176,17347,9324,5570,3276
20110,50,60,19827,283,20080,30,1.02345e+14,20.5272,594.236,20110,25,27,20050,20050,19878,19881,19600
32159,6298,32159,32159,0,32159,0,68717300000,0,32159,32159,32159,1,0,0,0,0,0
23966,523,1684,7375,16591,0,23966,3.64993e+13,427.687,4441.28,23966,378,318,22211,21597,18160,17772,12711
6981,224,1333,0,6981,0,6981,2.2733e+18,281.547,2520.13,6981,187,253,5423,4665,2742,2960,1394
41891,553,4343,37500,4391,25332,16559,1.95259e+18,1118.35,10018.5,41891,419,448,34993,30208,14890,13839,9508
46297,3507,3737,0,46297,0,46297,2.37303e+18,1103.47,9652.34,46297,607,684,42560,42542,42530,42551,42109
4727,332,858,2924,1803,0,4727,4.54083e+18,350.892,1705.06,4727,182,147,3599,3090,2792,2764,2290
11630,130,201,0,11630,11440,190,2.50065e+16,95.469,1061.83,11630,72,78,11429,11382,10722,10499,9648
8482,485,712,0,8482,2596,5886,8.29723e+15,356.253,2019.68,8482,233,195,7770,7025,7297,7311,6860
40969,1359,3896,40969,0,36530,4439,2.45151e+18,1335.34,9444.78,40969,431,563,36449,33645,28584,25871,22656
42100,14,69,41422,678,42100,0,9.89578e+13,19.9006,759.097,42100,30,28,41940,41827,37153,36933,24764
35726,401,1368,0,35726,10765,24961,9.09894e+15,429.148,4537.68,35726,285,290,34060,33406,28460,29045,17118
20290,1635,2918,18197,2093,12156,8134,1.96189e+18,752.247,6182.76,20290,352,375,17372,16998,15643,15787,12350
39480,19,41,38674,806,39480,0,1.00327e+14,18.3749,660.554,39480,24,24,39434,39408,35686,35403,23028
47777,3760,4422,47777,0,42778,4999,2.93112e+18,1570.57,11236.4,47777,493,623,43355,42591,42499,42198,39045
21284,3137,3197,21284,0,18964,2320,2.5124e+18,791.326,6527.49,21284,377,394,18087,18087,18087,18087,18058
24411,1820,2350,21593,2818,14719,9692,2.00886e+18,933.083,5885.36,24411,366,388,22061,22048,21440,21446,21115
31372,284,633,31272,100,31362,10,3.95602e+18,309.985,3092.55,31372,197,197,30588,29986,23946,23260,20989
41533,309,1190,41533,0,41508,25,3.95116e+18,400.768,4282.34,41533,230,222,40000,38792,25857,24911,21264
16703,110,584,16703,0,16703,0,4.89489e+18,298.179,2301.61,16703,160,161,14383,12116,7456,6591,4443
4362,246,766,0,4362,1269,3093,9.12e+15,97.0108,1465.21,4362,175,125,3596,3471,3077,3088,1820
4730,358,1233,4268,462,2791,1939,2.08566e+18,232.612,1965.38,4730,184,148,3485,3157,2557,2372,1886
42620,1192,3425,0,42620,0,42620,2.32249e+18,1121.61,9149.57,42620,560,462,38784,36587,29965,28569,21404
32601,271,284,0,32601,32066,535,2.64174e+16,145.595,1994.03,32601,103,124,32317,32317,32301,32289,32241
27732,1746,2610,0,27732,0,27732,2.31199e+18,693.939,6510.95,27732,337,494,25122,25114,24662,24544,18600
6994,25,28,6898,96,6994,0,1.03873e+14,14.6762,276.404,6994,18,19,6966,6966,6848,6848,6829
1256,5,19,1236,20,1256,0,9.54687e+13,10.1377,106.491,1256,12,13,1175,1108,1023,1024,709
5339,29,31,5248,91,5339,0,1.01066e+14,12.8781,248.472,5339,21,17,5308,5308,5267,5267,5259
45631,3666,3954,40758,4873,27133,18498,1.9452e+18,1131.47,10068.8,45631,640,485,41677,41677,41673,41677,40947
36007,615,1966,9953,26054,0,36007,3.72845e+13,612.859,6186.73,36007,396,385,33696,33013,30365,30447,16267
48573,38867,48573,48573,0,48573,0,68718100000,0,48573,48573,48573,1,0,0,0,0,0
6874,63,463,3416,3458,0,6874,3.43565e+18,143.657,1293.76,6874,118,126,4521,2407,830,1907,996
39304,2597,3271,35931,3373,22774,16530,1.91229e+18,1074.56,8204.77,39304,407,453,36033,35251,35691,35714,33070
39415,374,2314,11009,28406,0,39415,3.72508e+13,711.882,7025.51,39415,454,430,35830,33842,26647,26935,10843
30322,496,2128,0,30322,9720,20602,8.97234e+15,739.526,6030.41,30322,411,417,27498,26232,18150,18365,12569
17830,170,2756,0,17830,0,17830,2.47581e+18,796.003,5433.28,17830,311,385,13092,11115,8017,6046,1179
37053,4474,4609,33063,3990,22043,15010,1.97593e+18,1121.97,10137.2,37053,539,563,32444,32444,32439,32443,32266
27980,1311,3186,25327,2653,15371,12609,1.88756e+18,606.293,6945.94,27980,406,418,24794,24148,21931,22780,8962
19086,259,284,0,19086,18614,472,2.59258e+16,117.074,1567.44,19086,83,94,18802,18802,18736,18694,18464
4991,14,28,4904,87,4985,6,9.96529e+13,15.8223,263.07,4991,18,19,4954,4945,4615,4573,3611
15013,774,1341,8433,6580,0,15013,4.10292e+18,606.378,3334.14,15013,255,259,13592,12917,13032,12932,10826
6681,8,26,6457,224,6681,0,9.68587e+13,13.1076,265.652,6681,17,16,6563,6506,5742,5699,4317
25247,66,2363,15529,9718,0,25247,4.92332e+18,615.618,5770.42,25247,358,458,15771,11682,8423,6889,1356
12723,104,1394,0,12723,3506,9217,9.77981e+15,353.351,3317.33,12723,309,299,9995,8703,7282,7247,1530
26131,1,63,25547,584,26119,12,1.02417e+14,18.0792,664.395,26131,26,27,10424,10424,10424,10424,10424
2241,56,95,0,2241,2224,17,2.63344e+16,41.1615,314.351,2241,32,40,2137,2090,1994,2039,1652
17256,111,255,0,17256,17060,196,2.58023e+16,100.132,1404.64,17256,84,91,16981,16830,15151,15338,11759
34721,1743,2045,0,34721,10210,24511,9.40425e+15,775.566,6358.74,34721,419,422,32676,32673,32419,32376,30711
49847,2818,3565,29980,19867,29980,19867,1.88896e+18,1294.16,9472.54,49847,516,440,46282,46005,45738,45903,41119
14970,37,50,14777,193,14970,0,1.00143e+14,14.7489,483.453,14970,23,24,14920,14920,14770,14769,13934
43945,106,2060,0,43945,12593,31352,9.42093e+15,873.162,7017.53,43945,500,400,34670,29816,23630,19621,5225
19922,381,1177,5997,13925,0,19922,3.3115e+13,546.526,3518.92,19922,250,213,18231,17358,15920,15982,8063
23277,1338,3228,23231,46,21080,2197,2.27097e+18,675.831,6787.28,23277,547,311,20049,19271,17482,17754,8649
14597,255,1886,13288,1309,8605,5992,1.89755e+18,499.489,4220.73,14597,235,321,11294,9656,3397,3016,1197
40399,3218,3573,23404,16995,23404,16995,1.7066e+18,1261.31,8590.06,40399,438,504,36826,36826,36618,36715,33615
49130,1282,4259,0,49130,0,49130,2.24112e+18,1014.74,10554.7,49130,613,545,44443,42870,34849,32219,24641
27629,12,69,27089,540,27629,0,9.77509e+13,17.0118,647.578,27629,29,25,27462,27364,24297,24241,15272
15673,43,1322,0,15673,4425,11248,9.36815e+15,364.148,3521.29,15673,313,270,10918,8986,6946,6667,1554
5555,348,844,1439,4116,0,5555,3.76511e+13,189.248,1731.77,5555,177,149,4711,4537,4381,4392,2261
4663,72,133,0,4663,4617,46,2.73056e+16,45.7392,517.539,4663,44,44,4530,4457,4213,4338,3623
13790,25,277,0,13790,13497,293,2.6085e+16,92.2992,1333.98,13790,85,76,12943,12321,10553,8986,5991
19895,2275,3647,19895,0,18043,1852,2.47286e+18,617.529,6672.03,19895,343,479,16248,16224,13118,13051,10296
15843,464,761,15843,0,15843,0,4.28211e+18,301.719,2451.89,15843,161,167,15082,14991,13240,13279,12440
30911,229,230,0,30911,30357,554,2.54024e+16,125.147,1669.59,30911,78,93,30681,30681,30681,30681,30681
12290,30,46,12180,110,12290,0,1.03429e+14,17.4838,407.621,12290,23,24,12244,12241,11893,11895,10479
27085,303,754,27073,12,27085,0,3.98234e+18,349.875,3121.2,27085,197,190,26144,25312,19000,18460,15633
38408,1198,3565,23287,15121,0,38408,4.92025e+18,836.333,8368.2,38408,555,441,34843,33819,28686,26969,20519
15480,888,2010,9320,6160,0,15480,4.9037e+18,404.231,4319.12,15480,237,307,13470,13269,12758,12591,8669
20792,1651,1851,0,20792,6774,14018,9.13474e+15,485.304,4837.45,20792,319,527,18941,18941,18836,18828,18566
25778,122,240,0,25778,25127,651,2.57309e+16,130.217,1668.7,25778,81,90,25492,25359,23331,22864,18398
30905,238,298,0,30905,30455,450,2.62607e+16,125.734,2064.68,30905,97,109,30607,30601,29802,29615,28682
32401,914,1933,18199,14202,0,32401,3.95208e+18,877.752,5566.62,32401,351,337,29911,28712,26747,25979,17610
39036,1112,2087,12192,26844,0,39036,3.44535e+13,723.489,6571.76,39036,443,401,36921,36013,35222,35276,28557
45180,1901,2688,0,45180,12953,32227,9.25504e+15,794.233,8122.74,45180,546,565,42492,42370,41665,41572,34820
38194,1892,2262,0,38194,11995,26199,8.85976e+15,699.401,7199.04,38194,415,552,35932,35831,35819,35755,33742
28129,51,55,27445,684,28129,0,9.95757e+13,17.4598,605.275,28129,26,24,28074,28074,27900,27900,27794
23946,13,56,23516,430,23946,0,9.90443e+13,16.1697,571.011,23946,22,24,23830,23727,21197,20783,12892
12043,1081,2155,6833,5210,6833,5210,1.70927e+18,278.619,3927.71,12043,305,240,9888,9758,9309,8579,5847
15866,375,548,15866,0,15866,0,4.11612e+18,297.741,2215.43,15866,154,156,15318,15151,14401,14330,13904
16433,1822,2576,16433,0,14735,1698,2.05479e+18,566.798,5125.87,16433,348,296,13857,13836,13634,13721,12086
11005,695,1230,0,11005,3174,7831,9.60473e+15,300.566,2874.42,11005,279,217,9775,9536,9416,9379,7602
28507,239,270,0,28507,28035,472,2.72286e+16,148.81,1808.51,28507,107,115,28237,28230,28100,27890,27438
23556,3318,3518,23556,0,21061,2495,2.70639e+18,820.022,7291.32,23556,436,434,20038,20038,20038,20038,19795
29351,1988,2875,16966,12385,0,29351,4.94983e+18,950.091,6925.45,29351,435,418,26476,26149,25100,24985,22056
45710,40378,45710,0,45710,0,45710,1048550,0,45710,45710,45710,1,0,0,0,0,0
27053,320,3275,27053,0,23912,3141,2.85066e+18,827.01,7346.77,27053,373,446,20596,16880,11553,9100,2314
32710,57,78,31881,829,32710,0,1.0383e+14,17.7907,694.981,32710,29,27,32632,32632,31929,31929,30114
13885,1362,1596,4307,9578,0,13885,3.64774e+13,338.35,3741.48,13885,264,315,12289,12289,12237,12209,11374
44396,2199,2281,0,44396,13873,30523,8.48457e+15,700.961,7032.61,44396,427,462,42115,42115,42103,42099,41838
14583,1027,1955,0,14583,0,14583,2.48403e+18,431.008,4030.35,14583,277,297,12628,12446,12219,12085,9959
27884,970,3378,24746,3138,16689,11195,1.95161e+18,1192.2,7564.73,27884,461,408,23647,22038,17102,16008,11024
3255,76,187,3255,0,3255,0,4.94973e+18,114.473,667.809,3255,85,83,2540,1596,1377,1405,1610
15619,167,212,0,15619,15330,289,2.55033e+16,96.174,1250.4,15619,70,76,15407,15391,15347,15314,14796
30950,2711,3263,0,30950,0,30950,2.36757e+18,855.837,7728.42,30950,377,509,27687,27680,27458,27646,25865
11866,436,599,11866,0,11866,0,3.8782e+18,252.916,1975.3,11866,147,135,11267,11219,10524,10485,9836
40385,1021,3754,40385,0,35879,4506,1.4043e+18,1033.25,9075.68,40385,483,451,35953,33788,27688,24895,15777
7562,1252,1503,4460,3102,4460,3102,1.89546e+18,256.624,2715.11,7562,220,178,6059,6040,5965,6003,5619
39919,337,357,0,39919,39233,686,2.59501e+16,134.25,2550.86,39919,106,114,39562,39562,39556,39508,38826
44653,1208,3459,26736,17917,0,44653,4.9292e+18,952.488,8995.45,44653,503,428,41081,39358,35263,34519,24434
10089,418,1529,6015,4074,6015,4074,1.81749e+18,409.427,3138.1,10089,280,182,8358,7448,5418,4240,2803
43560,3660,4368,25892,17668,25892,17668,1.83501e+18,843.612,10494.9,43560,499,659,39192,39192,38714,38913,33772
48643,59,86,47927,716,48643,0,1.01166e+14,22.8989,858.953,48643,32,29,48557,48552,47463,47465,43671
2106,151,641,1855,251,1264,842,1.97157e+18,213.145,1038.8,2106,108,102,1279,995,703,641,545
32855,2753,4558,32855,0,29458,3397,2.71723e+18,607.904,9467.63,32855,355,591,28297,28217,27631,27541,19707
29483,36,39,29105,378,29483,0,1.03805e+14,15.4796,540.005,29483,23,22,29444,29444,28925,28927,28396
13175,125,186,0,13175,12893,282,2.59353e+16,86.4667,978.05,13175,65,69,12989,12942,12518,12419,11074
39696,118,369,0,39696,38804,892,2.5417e+16,135.343,2442.68,39696,107,107,39216,38917,34370,32246,24755
33607,3175,3376,30023,3584,19821,13786,1.95671e+18,709.89,7926.83,33607,459,433,30231,30231,30190,30183,29216
17128,777,1394,0,17128,4883,12245,9.65783e+15,401.686,3797.34,17128,307,320,15734,15623,15164,15132,10195
45074,740,4646,45074,0,40472,4602,1.64717e+18,1068.83,10711.7,45074,511,579,38959,36265,32711,31692,5882
5874,202,961,1725,4149,0,5874,3.81721e+13,180.38,1927.81,5874,171,194,4843,4408,4109,4028,1405
26649,145,278,0,26649,26074,575,2.64717e+16,130.45,1740.45,26649,77,90,26355,26274,24216,23279,19075
5346,286,1350,4807,539,3331,2015,1.97771e+18,393.442,2251.05,5346,181,185,3742,3110,2126,2060,1542
48645,1479,3312,27181,21464,27181,21464,1.63042e+18,1098.88,9159.17,48645,438,514,45211,44266,43135,42603,30873
19870,761,2903,19870,0,17878,1992,2.11007e+18,863.183,6007.58,19870,447,353,16204,14153,10109,9732,6249
17731,594,2480,17731,0,16009,1722,2.60275e+18,534.146,5345.38,17731,275,371,14868,11430,9158,7983,7121
28542,2662,3062,16512,12030,0,28542,4.10597e+18,686.075,7009.64,28542,513,494,25480,25476,25023,24753,22295
5357,678,966,0,5357,0,5357,2.49517e+18,245.765,1798.4,5357,225,144,4391,4380,4318,3915,3913
12666,15,35,12320,346,12666,0,1.0107e+14,15.7491,385.146,12666,19,20,12616,12590,11542,11323,9090
35934,56,70,35074,860,35934,0,9.87131e+13,18.7465,713.651,35934,28,29,35864,35864,35348,35348,34627
3270,82,106,0,3270,3209,61,2.6311e+16,56.0526,390.884,3270,40,46,3164,3096,3035,3063,2924
1227,69,80,0,1227,1208,19,2.29035e+16,23.119,210.923,1227,23,30,1147,1143,1124,1138,1071
2262,18,21,2208,54,2262,0,1.07762e+14,11.4779,144.024,2262,14,17,2241,2239,2197,2196,2224
30259,1718,2636,0,30259,0,30259,2.36427e+18,1164.83,6830,30259,479,428,27382,26341,26000,23929,22657
22653,1379,1901,20168,2485,13685,8968,1.95324e+18,718.014,5101.35,22653,305,313,20752,20718,20490,20561,19099
19069,320,663,19069,0,19069,0,4.30339e+18,307.819,2514.44,19069,180,179,18343,18058,14656,14366,13959
6659,323,446,6659,0,6659,0,4.71193e+18,209.264,1365.29,6659,108,99,6213,6157,5847,5836,5710
16419,745,2351,9350,7069,0,16419,4.28027e+18,362.488,4676.9,16419,291,273,14068,13696,11583,10955,4905
32738,110,608,32738,0,32738,0,3.96267e+18,314.085,3068.15,32738,188,192,29269,21718,15562,15670,8716
30467,22,36,30061,406,30467,0,9.63967e+13,18.1218,564.56,30467,25,23,30426,30412,29379,29380,26466
19477,2241,2840,0,19477,0,19477,2.3354e+18,458.283,5808.32,19477,327,503,16637,16621,16430,16550,15067
17363,35,712,17363,0,17363,0,4.19538e+18,307.093,2480.72,17363,162,169,10766,6601,4719,4428,1552
2778,66,652,1753,1025,0,2778,4.82538e+18,261.096,1166.98,2778,189,121,1592,1178,975,835,562
24262,698,1412,0,24262,7437,16825,8.6267e+15,572.685,4264.83,24262,325,260,22749,22032,21250,21353,13843
21521,2162,2919,21521,0,19509,2012,1.42668e+18,546.393,6020.84,21521,349,341,18602,18581,18222,18291,15816
24206,58,257,0,24206,23811,395,2.55504e+16,126.148,1646.99,24206,93,85,23505,22922,20173,18870,12922
18587,598,2553,16213,2374,10983,7604,1.96525e+18,685.442,5511.81,18587,343,430,15325,13849,10435,9701,4566
39811,435,1170,39771,40,39811,0,4.04031e+18,413.941,4192.07,39811,232,245,38582,37912,26268,24936,22668
31331,267,3555,0,31331,0,31331,2.18403e+18,481.977,7828.76,31331,537,408,26182,22932,12502,13091,2392
34483,317,740,34483,0,34483,0,4.52789e+18,335.527,3409.21,34483,208,201,33628,32972,25084,24164,22458
27995,180,287,0,27995,27561,434,2.57035e+16,121.815,1823.45,27995,90,102,27708,27648,26291,26298,22806
35445,1860,3545,21318,14127,21318,14127,1.82917e+18,878.467,8378.33,35445,404,547,31900,31639,30128,29852,18665
42223,1843,2334,12810,29413,0,42223,3.56828e+13,563.313,6977.44,42223,337,438,39889,39871,39731,39730,35777
48654,2088,3959,48654,0,43423,5231,1.99392e+18,1316.8,10549.4,48654,557,528,44695,43737,40456,38729,31427
10324,832,1208,0,10324,0,10324,2.3105e+18,314.661,2743.42,10324,221,160,9116,9088,8507,8355,5818
1635,1443,1635,1635,0,1635,0,68677400000,0,1635,1635,1635,1,0,0,0,0,0
15415,370,1687,15415,0,13866,1549,1.39114e+18,606.864,4171.08,15415,270,278,12271,10375,7133,6913,3635
22582,249,1626,7181,15401,0,22582,3.09147e+13,515.423,4418.75,22582,332,325,20075,19093,12274,11901,5088
17069,834,1561,9758,7311,9758,7311,1.58953e+18,712.426,3880.26,17069,286,333,15326,14534,14507,14039,8716
45393,868,1362,0,45393,14289,31104,7.68347e+15,564.944,5324.81,45393,376,320,44031,43949,42801,42877,29435
24350,2219,2837,14690,9660,0,24350,5.06637e+18,657.672,6227.44,24350,489,353,21513,21429,21213,21220,19525
12269,801,1303,0,12269,3923,8346,8.42398e+15,266.42,3085.8,12269,271,315,10966,10857,10548,10553,9265
31787,2836,3238,29263,2524,19263,12524,1.86891e+18,746.9,7733.94,31787,493,361,28549,28543,28476,28480,27296
26289,884,2060,15788,10501,0,26289,4.92799e+18,994.722,5595.14,26289,390,374,23567,21540,20201,19625,14084
33005,3539,3813,29283,3722,19381,13624,1.94905e+18,983.623,8473.21,33005,521,464,29192,29192,29184,29177,28649
25689,240,1321,0,25689,7291,18398,9.76264e+15,630.049,4364.87,25689,368,298,21927,19758,16634,16412,8557
1520,63,313,797,723,0,1520,3.70599e+18,150.064,615.154,1520,85,84,852,457,239,223,436
24003,756,1774,0,24003,0,24003,2.04133e+18,637.98,4671.47,24003,315,280,22176,21494,20182,16840,10904
22115,237,3190,19679,2436,13102,9013,1.94821e+18,1123.76,6758.19,22115,352,466,15948,13037,6666,6006,2033
23276,1033,1614,7608,15668,0,23276,3.5415e+13,447.837,4503.76,23276,318,335,21662,21608,20915,20919,18444
18154,551,2178,10321,7833,10321,7833,1.64144e+18,503.349,4728.77,18154,288,310,15712,14623,13378,12829,7456
35012,25,284,0,35012,34305,707,2.61995e+16,138.22,2086.01,35012,101,115,32851,31369,26212,22237,14472
1248,116,551,1248,0,1124,124,2.91132e+18,58.4575,748.993,1248,87,63,697,551,263,175,144
29447,163,203,0,29447,29116,331,2.48937e+16,147.548,1566.19,29447,92,95,29223,29111,28239,28177,26679
45976,2592,3550,27248,18728,0,45976,4.76634e+18,1078.53,9194.91,45976,493,433,42426,42105,40864,40467,38314
13389,1096,1588,7968,5421,0,13389,4.89476e+18,463.996,3482.84,13389,334,276,11801,11598,11465,11389,10322
49745,369,2541,0,49745,15198,34547,9.03993e+15,945.265,8235.37,49745,492,427,45091,42268,27698,24443,12497
23295,2040,3037,20525,2770,14163,9132,1.94786e+18,784.293,6706.21,23295,428,436,20258,20239,17706,17559,16611
43448,461,1940,25785,17663,0,43448,5.04108e+18,1122.23,6964.48,43448,458,415,37934,34177,30624,29992,13039
5493,454,786,0,5493,1546,3947,8.50182e+15,148.479,1678.58,5493,154,170,4707,4647,4482,4500,3076
5127,628,1135,0,5127,0,5127,2.17758e+18,229.21,2031.66,5127,189,159,3992,3882,3671,3314,3019
12603,12098,12603,12603,0,0,12603,268414000,0,12603,12603,12603,1,0,0,0,0,0
16372,6821,16372,16372,0,0,16372,15.999,0,16372,16372,16372,1,0,0,0,0,0
37754,1653,2115,20545,17209,0,37754,3.84962e+18,952.659,6043.37,37754,353,368,35639,34276,35186,35089,32066
5333,513,584,2856,2477,0,5333,3.23362e+18,164.875,1373.59,5333,135,103,4749,4748,4723,4713,4552
42483,625,931,42483,0,42483,0,4.10073e+18,403.85,4014.56,42483,232,227,41552,41461,38823,38758,36899
10193,1069,1319,2870,7323,0,10193,3.84571e+13,335.537,2895.92,10193,211,225,8874,8817,8808,8792,8116
39872,1340,2476,0,39872,0,39872,2.14801e+18,951.888,7301.84,39872,316,474,37183,36235,35757,34085,26343
4031,743,780,0,4031,1298,2733,8.35827e+15,183.232,1534.53,4031,201,139,3251,3251,3248,3251,3239
22457,492,1897,20030,2427,13904,8553,1.94013e+18,697.916,4900.55,22457,311,310,19454,14725,11415,10527,8626
46418,1792,3380,28312,18106,28312,18106,1.85385e+18,1288.92,9060.32,46418,518,474,43038,41876,40291,39892,31014
1302,213,271,1302,0,1302,0,4.19672e+18,117.963,523.816,1302,59,57,1031,993,979,969,922
21336,2486,2488,21336,0,19319,2017,2.08217e+18,568.788,5433.37,21336,383,313,18848,18848,18848,18848,18848
40745,154,306,0,40745,39978,767,2.61014e+16,157.262,2221.06,40745,111,130,40365,40158,36235,35292,27770
44719,260,1002,44719,0,44719,0,4.43805e+18,358.888,4105.74,44719,226,221,43153,41613,26601,25000,21955
46610,3656,4072,46610,0,41800,4810,2.01169e+18,1441.99,10266.9,46610,528,511,42538,42500,42368,42368,41638
39362,26,112,38557,805,39041,321,1.05684e+14,21.2406,934.291,39362,34,35,39250,39192,36308,36257,21693
46189,59,88,45644,545,46176,13,1.0202e+14,20.309,844.452,46189,29,32,46101,46099,44616,44617,37640
36691,318,2754,0,36691,0,36691,2.34462e+18,623.779,7041.62,36691,387,313,30060,24897,16165,13388,7527
36740,2650,3138,0,36740,0,36740,2.40715e+18,956.729,8037.96,36740,424,546,33602,33274,33402,33506,31580
518,119,246,338,180,338,180,1.67583e+18,47.3282,332.678,518,64,49,272,232,211,214,173
42749,643,1122,42749,0,42749,0,4.27134e+18,427.715,4305.25,42749,239,230,41627,41448,37775,37740,36378
11169,934,2561,10024,1145,6855,4314,1.95535e+18,383.996,4363.08,11169,223,317,8608,8322,7501,7472,3604
39254,990,3218,0,39254,0,39254,2.41078e+18,995.151,8031.64,39254,452,407,35602,33987,28635,26284,20900
6609,325,514,6609,0,6609,0,4.65425e+18,250.603,1460.29,6609,114,105,6095,5980,5174,5055,5132
39639,792,2209,12481,27158,0,39639,3.32871e+13,676.837,6833.37,39639,393,476,37262,36175,33674,33928,21327
40863,1529,2765,23387,17476,23387,17476,1.7151e+18,1157.97,7928.7,40863,463,500,37945,36594,36346,36376,30214
37481,2930,3545,0,37481,0,37481,2.26186e+18,975.31,8778.09,37481,367,640,33936,33918,33724,33877,31254
25766,1061,2477,23155,2611,14659,11107,1.93403e+18,886.478,6096.67,25766,409,345,22748,21840,20467,20736,12893
13082,222,1778,7876,5206,0,13082,5.13395e+18,484.492,3681,13082,277,259,10031,8442,6723,5905,2474
4689,522,1053,2897,1792,0,4689,4.8912e+18,262.876,1895.12,4689,189,180,3636,3383,2867,2948,2615
40686,2348,3978,40686,0,36788,3898,1.4444e+18,1267.6,9425.52,40686,447,540,36708,35073,34247,33688,28852
35663,2921,3645,21363,14300,21363,14300,1.84245e+18,839.569,8431.01,35663,451,551,32018,31935,31462,31691,29111
49475,2375,2665,0,49475,15069,34406,9.18215e+15,853.642,8265.92,49475,535,461,46810,46804,46675,46647,45492
17661,848,2146,10689,6972,0,17661,4.85013e+18,672.234,4813.33,17661,402,344,15433,14416,11493,10853,9325
1504,228,263,1504,0,1504,0,3.95474e+18,79.5465,533.892,1504,71,51,1241,1238,1235,1235,1191
6713,440,451,6713,0,6713,0,4.76542e+18,234.808,1385.54,6713,110,112,6262,6262,6255,6258,6242
13099,35,44,12832,267,13099,0,1.07119e+14,18.8394,408.802,13099,23,25,13055,13054,12822,12822,12245
27799,1070,1604,0,27799,8743,19056,8.90341e+15,518.803,5210.24,27799,340,403,26195,25994,25633,25542,19702
30449,1276,2455,18810,11639,18810,11639,1.79479e+18,639.927,6379.62,30449,339,437,27994,27636,26828,26928,21015
31540,80,913,31540,0,31540,0,4.08719e+18,319.034,3471.39,31540,211,191,24863,17779,13106,12089,5010
35715,22,56,34986,729,35705,10,9.62369e+13,19.2116,730.559,35715,26,25,35654,35636,32609,32634,25180
33681,249,2319,10056,23625,0,33681,3.54982e+13,608.758,6769.55,33681,509,353,29277,26445,19369,16454,7107
34142,1147,3508,0,34142,0,34142,2.36518e+18,684.843,8026.19,34142,440,426,30634,29797,23783,22792,16414
44870,2017,2793,26255,18615,26255,18615,1.74901e+18,897.301,8225.42,44870,487,441,42077,42063,40700,40974,33858
44111,2003,2412,0,44111,12886,31225,9.39761e+15,713.518,7577.06,44111,548,470,41699,41690,41559,41456,38512
30671,2829,4236,27221,3450,18279,12392,1.9308e+18,914.611,8934.56,30671,508,396,26435,26327,24670,24667,21678
36091,757,3230,21636,14455,0,36091,4.86364e+18,900.602,7880.93,36091,478,433,32143,30584,23934,21669,10659
33235,141,253,0,33235,32431,804,2.53433e+16,141.027,2014.64,33235,97,105,32955,32795,30856,30315,25848
727,37,306,469,258,0,727,4.48441e+18,40.9711,429.51,727,87,53,379,239,186,168,72
39230,1,73,38583,647,39230,0,1.02897e+14,20.1581,754.133,39230,31,26,16181,16181,16181,16181,16181
11816,1335,1565,0,11816,0,11816,2.17621e+18,450.917,3436.06,11816,279,267,10251,10237,10204,10228,9861
2966,236,604,0,2966,797,2169,1.00345e+16,113.036,1080.22,2966,148,90,2362,2278,2203,2207,759
27782,995,4044,27782,0,24785,2997,1.53684e+18,987.519,8346.61,27782,444,414,23165,21061,17125,14826,9077
35559,273,299,0,35559,34916,643,2.47326e+16,147.737,2098.38,35559,111,118,35260,35254,34953,34687,34154
4862,35,1066,4862,0,4454,408,2.66532e+18,265.872,1977.87,4862,191,143,2106,864,633,207,246
35528,7,38,34708,820,35528,0,9.29564e+13,19.0755,630.472,35528,24,23,34781,34368,30416,29743,19996
7789,124,955,0,7789,2335,5454,9.66421e+15,266.229,2188.78,7789,225,237,6163,5427,4064,4373,1899
22093,2642,3171,19604,2489,13197,8896,1.90691e+18,728.118,6634.99,22093,427,435,18922,18812,18651,18691,17336
49075,4,56,47940,1135,49075,0,9.95589e+13,19.4747,773.21,49075,27,25,44560,41686,38556,38276,23629
6507,22,31,6443,64,6507,0,1.04596e+14,16.5351,264.017,6507,20,21,6476,6472,6246,6246,5877
31051,1078,1296,0,31051,9093,21958,8.19319e+15,664.267,4667.92,31051,349,285,29730,29241,29490,29487,26205
47819,2299,4845,42686,5133,28143,19676,1.97041e+18,1364.77,11582.6,47819,465,649,42974,41056,40726,41046,27783
39696,253,305,0,39696,39168,528,2.58835e+16,149.254,2348.3,39696,100,120,39391,39362,38525,38468,37420
5656,591,1253,0,5656,0,5656,2.36978e+18,235.85,2244.2,5656,153,231,4403,4242,4133,4129,2710
11735,71,2286,11735,0,10608,1127,1.64162e+18,344.791,4185.22,11735,315,279,6977,5223,2779,2192,579
12165,63,229,0,12165,11886,279,2.68802e+16,99.6391,1183.72,12165,75,75,11794,11594,10258,9637,6776
17775,186,237,0,17775,17510,265,2.50044e+16,101.779,1354.97,17775,83,84,17538,17534,17324,17201,16361
31209,761,893,31209,0,31209,0,4.24648e+18,364.076,3443.81,31209,208,205,30316,30314,30101,30084,29930
2090,13,25,2054,36,2090,0,1.06126e+14,10.7713,140.409,2090,15,15,2064,2060,1876,1888,1459
1965,3,20,1934,31,1965,0,1.03709e+14,9.36489,135.278,1965,12,12,1606,1425,1416,1401,946
25290,2542,3195,14971,10319,14971,10319,1.88756e+18,553.858,6923.43,25290,436,476,22095,22094,21847,21927,20719
1571,227,264,1571,0,1571,0,4.52844e+18,96.4959,553.29,1571,65,62,1307,1304,1304,1304,1294
42005,2873,3329,25220,16785,25220,16785,1.83376e+18,746.149,8264.98,42005,439,502,38676,38675,38342,38512,37049
1869,49,89,0,1869,1820,49,2.79518e+16,37.3103,285.864,1869,32,41,1773,1731,1634,1658,1460
12653,1696,2017,7545,5108,7545,5108,1.85143e+18,390.002,3991.41,12653,370,219,10636,10636,10548,10586,9976
27282,698,2260,24303,2979,16171,11111,1.95742e+18,1212.21,6047.74,27282,429,339,23462,21681,19062,18205,10507
29918,2304,3457,29918,0,26807,3111,2.45239e+18,1064.74,7855.56,29918,445,411,26461,25097,24584,23980,21261
5117,160,370,5111,6,5117,0,3.98526e+18,190.326,1133.41,5117,102,106,4590,4126,3359,3401,2718
24656,1047,2668,0,24656,0,24656,2.40303e+18,852.013,6298.6,24656,419,385,21683,20526,18339,17488,11296
42803,3130,3864,0,42803,0,42803,2.38358e+18,875.314,9753.08,42803,555,382,38939,38855,38649,38415,33391
38438,1137,4822,38413,25,34238,4200,2.07724e+18,886.759,10373.1,38438,420,548,33503,31067,19207,14266,8599
19722,1166,2480,17623,2099,11906,7816,1.95794e+18,563.008,5505.58,19722,326,369,17242,16999,16111,16320,9323
28562,39,68,28086,476,28537,25,9.94852e+13,19.2162,647.21,28562,27,27,28494,28494,27695,27696,23760
39325,2117,2583,0,39325,12028,27297,8.92663e+15,742.076,7581.66,39325,532,511,36742,36694,36213,36232,33248
10613,12,20,10503,110,10613,0,9.33037e+13,14.4385,306.09,10613,15,17,10562,10539,9754,9746,8351
3207,208,229,0,3207,1081,2126,6.74012e+15,98.908,693.199,3207,82,79,2978,2974,2968,2976,2921
20407,1844,3227,18287,2120,12313,8094,1.92527e+18,792.569,6437.29,20407,354,331,17180,16697,15862,15637,13350
19040,749,2254,11387,7653,0,19040,5.1045e+18,606.369,5159.33,19040,402,265,16659,15797,14458,14484,6282
41217,206,325,0,41217,40475,742,2.68951e+16,146.392,2462.53,41217,105,120,40892,40828,38770,38561,32955
23796,759,2296,13692,10104,0,23796,4.373e+18,645.942,5484.45,23796,379,342,21430,20377,17597,17292,8285
24755,419,2275,0,24755,0,24755,2.32946e+18,933.123,5619.97,24755,426,336,21217,18995,12809,10561,4281
39015,2070,2915,0,39015,0,39015,2.28033e+18,850.205,8051.87,39015,532,397,36100,36046,34181,33049,28391
3325,860,931,1957,1368,1957,1368,1.97095e+18,143.517,1467.1,3325,205,127,2394,2390,2386,2385,2327
37316,1424,3306,22623,14693,22623,14693,1.8543e+18,1056.66,8427.3,37316,513,510,33761,32523,30884,29915,19047
12406,40,188,0,12406,12255,151,2.68924e+16,99.2915,1030.91,12406,72,73,11873,11513,9965,9216,5987
25938,99,1706,7830,18108,0,25938,3.69291e+13,593.931,5059.15,25938,424,356,20048,17531,12851,6652,3923
11142,779,1266,6297,4845,6297,4845,1.53908e+18,334.507,2877.89,11142,195,247,9876,9797,9508,9379,8428
22265,590,3756,19989,2276,13255,9010,1.96937e+18,764.158,7231.99,22265,441,514,17726,15752,11503,10941,2982
48701,70,84,47583,1118,48701,0,1.04254e+14,22.8357,898.805,48701,34,30,48617,48617,47804,47805,45934
44115,169,355,0,44115,43363,752,2.6863e+16,144.676,2472.3,44115,105,120,43734,43615,40184,37886,31868
32293,683,1914,0,32293,9924,22369,8.06598e+15,592.494,5538.79,32293,312,377,30236,29392,28430,28597,16841
18181,326,1174,5199,12982,0,18181,3.83289e+13,554.19,3530.03,18181,329,249,15943,14612,12238,11746,6010
49807,2642,4102,29162,20645,29162,20645,1.85711e+18,1294.43,10761.8,49807,675,708,45705,45126,44109,44290,32660
19210,1221,1422,5487,13723,0,19210,3.67606e+13,516.27,4001.86,19210,356,315,17788,17778,17601,17600,17201
48245,2592,3076,0,48245,0,48245,2.2191e+18,1331.54,8998.41,48245,466,533,45169,45120,44692,43776,41385
42039,1499,2146,12578,29461,0,42039,3.58541e+13,862.71,7085.52,42039,512,452,39893,39599,37561,37652,34457
21105,1404,2896,18727,2378,12816,8289,1.96908e+18,861.035,6176.05,21105,392,413,18209,17498,13793,13235,12919
44395,3196,3871,40336,4059,24511,19884,1.90719e+18,1227.97,9424.51,44395,472,659,40524,40022,39842,39941,37639
40980,243,4077,24389,16591,0,40980,4.77798e+18,1329.06,9893.47,40980,493,548,32056,27755,18598,12939,2088
10516,15,27,10278,238,10516,0,9.40572e+13,16.4329,328.139,10516,20,19,10479,10468,9844,9778,8303
6881,959,1480,6881,0,6071,810,2.1542e+18,422.811,2731.1,6881,197,224,5401,5303,5032,5018,4747
38178,622,3197,38178,0,34030,4148,3.15167e+18,1102.71,8048.05,38178,483,358,33457,30759,12869,7859,7714
13708,323,561,13708,0,13708,0,4.85863e+18,279.425,2065.47,13708,157,151,13109,12868,10538,10355,10005
37110,901,2464,21847,15263,21847,15263,1.8376e+18,1123.25,7085.66,37110,478,424,33829,32515,28133,24840,15159
6899,167,168,0,6899,6814,85,2.68637e+16,71.256,781.115,6899,57,53,6731,6731,6731,6731,6728
3718,828,941,2295,1423,2295,1423,1.88103e+18,201.637,1601.39,3718,168,125,2777,2777,2763,2766,2647
11524,782,859,3592,7932,0,11524,2.70893e+13,220.32,2167.47,11524,192,139,10665,10655,10663,10663,10524
12766,1185,1751,12766,0,11373,1393,2.09186e+18,601.697,3823.91,12766,263,265,11015,10952,10639,10572,9652
43903,222,320,0,43903,43096,807,2.6026e+16,159.077,2514.26,43903,116,127,43583,43495,41948,41562,38567
15469,1606,2682,13742,1727,9123,6346,1.93672e+18,409.194,5097.57,15469,412,299,12787,12727,11660,11585,8175
13747,1549,1809,8236,5511,8236,5511,1.80826e+18,565.809,3993.88,13747,307,293,11938,11926,11746,11841,11346
6540,72,1290,3913,2627,3913,2627,1.78929e+18,222.624,2375.25,6540,236,143,4293,3421,2809,2000,620
39607,859,3714,39607,0,35408,4199,1.75096e+18,1202.44,9080.57,39607,526,474,33202,28797,22173,18501,12536
35286,673,3567,35286,0,31465,3821,2.13961e+18,1554.49,8706.36,35286,504,459,28499,25521,15131,12000,7577
45525,395,3779,0,45525,0,45525,2.33767e+18,834.241,9542.74,45525,497,595,39238,32570,23302,17705,6964
23030,1234,3202,13971,9059,0,23030,4.77509e+18,656.991,6533.22,23030,415,399,19828,19179,16326,16225,12290
46963,3502,3707,0,46963,0,46963,2.49039e+18,1276.68,9600.48,46963,568,523,43256,43253,43152,43228,42800
35414,744,1041,35414,0,35414,0,4.26349e+18,367.427,3850.04,35414,215,214,34373,34333,32702,32872,31510
18890,848,2186,10958,7932,10958,7932,1.73394e+18,583.015,5070.43,18890,292,393,16505,15923,15440,15155,6920
36531,712,2806,22044,14487,0,36531,4.93073e+18,1130.69,7497.02,36531,525,389,32534,30076,20315,19622,9210
517,156,185,454,63,266,251,2.25605e+18,61.9536,285.319,517,55,50,332,332,321,326,312
39704,85,3192,39704,0,35840,3864,1.58354e+18,1098.57,8542.79,39704,514,411,24752,16650,9457,7045,2429
22995,2132,2818,14015,8980,0,22995,5.01515e+18,692.29,6074.87,22995,389,447,20177,20152,19738,19774,18104
16823,1582,1685,0,16823,5026,11797,9.58935e+15,397.675,4227.76,16823,301,294,15138,15138,15129,15128,14942
20180,559,2039,12197,7983,12197,7983,1.93002e+18,776.665,5129.63,20180,355,374,16958,15476,13225,13569,6825
35201,88,241,0,35201,34612,589,2.52277e+16,153.603,1838.95,35201,102,108,34690,34252,30318,29198,22568
40961,1966,2035,12288,28673,0,40961,3.54151e+13,606.097,6615.32,40961,372,374,38926,38926,38908,38915,38700
31785,2393,3052,28478,3307,19292,12493,1.99693e+18,959.878,7419.69,31785,385,378,28733,28560,28389,28461,23899
7251,115,740,0,7251,2412,4839,8.57253e+15,295.783,1883.09,7251,189,182,5768,5001,3183,3211,2015
11148,1387,1563,0,11148,0,11148,2.24919e+18,527.504,3363.18,11148,194,303,9585,9465,9564,9556,9282
21076,1870,2385,21076,0,19251,1825,2.31594e+18,1158.24,5717.76,21076,339,338,18691,17679,17842,17796,16898
15569,163,211,0,15569,15333,236,2.67052e+16,105.11,1226.01,15569,81,84,15358,15342,14732,14780,13693
3055,36,121,0,3055,2998,57,2.76438e+16,51.9476,441.467,3055,40,42,2878,2801,2414,2277,1659
37623,75,4069,37623,0,33856,3767,1.24325e+18,969.309,8972.67,37623,505,456,22894,14427,8952,8333,1074
32806,200,272,0,32806,31826,980,2.51036e+16,142.858,1949.09,32806,87,104,32527,32440,31389,30725,28904
41812,12,51,41162,650,41800,12,1.00164e+14,19.8538,745.94,41812,27,27,41617,41499,38288,37731,24266
26980,1909,2661,16006,10974,16006,10974,1.80737e+18,1056.58,6659.87,26980,376,449,24319,23981,23302,23368,19310
25961,594,2901,25961,0,23372,2589,1.65865e+18,635.334,6425.06,25961,421,324,22501,19510,15393,13773,7512
8026,594,927,4696,3330,4696,3330,1.86762e+18,315.555,2117.38,8026,184,151,7099,6999,6712,6232,4698
36852,1735,3346,32792,4060,21807,15045,1.9754e+18,1126.22,8697.33,36852,441,447,33506,32800,27503,27515,21559
10085,1483,1504,5904,4181,5904,4181,1.76396e+18,319.16,3096.58,10085,278,202,8581,8581,8581,8581,8553
22089,1590,2259,13437,8652,13437,8652,1.8943e+18,519.763,5033.61,22089,362,330,19830,19751,19599,19655,18000
29762,268,292,0,29762,29149,613,2.66664e+16,134.134,1977.3,29762,89,92,29470,29469,29452,29369,28745
22618,1110,2723,22618,0,20359,2259,2.40985e+18,662.512,5922.46,22618,332,380,19895,19380,14464,14234,12316
46090,99,941,46090,0,46059,31,4.0185e+18,349.311,4089.25,46090,227,225,38725,31823,21552,20319,9867
30276,289,2040,9617,20659,0,30276,3.24494e+13,522.401,5636.24,30276,407,303,27280,25502,16654,15584,5654
38727,38,308,0,38727,38079,648,2.59823e+16,140.476,2149.57,38727,98,108,37055,36025,30843,26952,17094
22724,615,2714,20158,2566,12658,10066,1.94393e+18,585.209,6141.67,22724,269,421,19525,18325,12396,11235,4794
24009,806,2337,14728,9281,14728,9281,1.81594e+18,597.928,5629.48,24009,413,289,21528,20487,18881,18696,13128
47481,3563,4483,0,47481,0,47481,2.37631e+18,936.459,10629.5,47481,587,487,42998,42857,41797,39157,37030
40553,1998,2068,0,40553,12642,27911,8.84406e+15,584.644,6381.2,40553,391,464,38485,38484,38468,38458,38345
39937,2965,3248,22384,17553,0,39937,4.11075e+18,952.536,8056.36,39937,391,496,36689,36689,36549,36588,35233
47655,1110,1120,47655,0,47630,25,4.03122e+18,364.419,4409.51,47655,224,235,46535,46535,46534,46534,46533
8601,738,959,0,8601,2360,6241,9.15798e+15,305.961,2233.1,8601,214,216,7642,7595,7412,7426,6949
47242,387,4281,28354,18888,28354,18888,1.86738e+18,1154.7,10578.3,47242,589,534,39063,33673,24172,18061,7846
48882,1459,2214,0,48882,14220,34662,9.30509e+15,724.213,7173.5,48882,536,396,46668,46646,45282,45373,43424
34768,868,3161,30834,3934,20385,14383,1.95748e+18,907.742,7793.45,34768,394,482,30803,29226,25885,25182,17159
4221,99,150,0,4221,4165,56,2.33535e+16,57.5373,537.909,4221,48,52,4071,4035,3929,3921,3550
6678,624,1641,3994,2684,0,6678,5.0557e+18,208.115,2683.61,6678,196,258,5037,4834,4697,4686,2302
49676,2144,3189,29849,19827,29849,19827,1.92247e+18,1167.79,9321.43,49676,477,502,46487,46343,45793,46043,40837
32691,1237,3567,32691,0,29254,3437,1.70408e+18,1166.08,8452.96,32691,431,453,28341,27203,20075,17283,13404
14040,1522,2311,8238,5802,0,14040,5.05585e+18,348.6,4494.54,14040,233,416,11729,11728,11513,11503,8948
9579,1029,1222,5694,3885,0,9579,4.72841e+18,609.113,2816.27,9579,233,292,8357,7973,8082,8071,7840
32827,54,3576,0,32827,0,32827,2.37227e+18,745.959,7908.53,32827,502,427,20316,14873,10663,8026,1230
16982,22,62,16703,279,16962,20,1.0187e+14,16.8841,549.261,16982,24,26,16919,16900,15458,15554,10599
10896,463,1037,0,10896,3595,7301,8.09835e+15,220.19,2431.15,10896,213,248,9859,9674,8834,8730,6693
45305,41,51,44738,567,45305,0,9.87728e+13,19.062,751.953,45305,24,28,45254,45254,44399,44399,42581
4462,736,1173,2667,1795,2667,1795,1.99459e+18,143.598,1924.38,4462,210,180,3289,3270,3081,2906,2144
2613,205,836,0,2613,0,2613,2.58053e+18,130.426,1264.1,2613,132,113,1777,1567,1041,833,582
4829,43,611,2991,1838,2991,1838,1.83603e+18,308.442,1423.57,4829,139,149,2654,1888,1340,1290,634
42271,2902,3726,25288,16983,0,42271,4.80475e+18,1186.86,9421.63,42271,597,430,38545,38538,36603,36089,33206
35859,782,1604,0,35859,10293,25566,9.46439e+15,734.125,5576.87,35859,399,312,33895,33193,30281,30748,19716
41060,1652,3336,24921,16139,0,41060,5.02122e+18,947.537,8413.22,41060,467,481,37724,37045,34603,33718,24716
4317,10,22,4260,57,4317,0,9.74765e+13,12.706,211.094,4317,15,17,4264,4238,3874,3745,3106
12483,5,202,0,12483,12229,254,2.50756e+16,93.8908,1019.52,12483,71,77,9801,8351,7696,7097,4299
33103,1730,1843,0,33103,10238,22865,9.08859e+15,634.356,5702.95,33103,387,428,31260,31260,31221,31227,31080
38048,1854,2379,0,38048,0,38048,2.39514e+18,939.414,6933.66,38048,480,422,35669,35317,34293,32062,31948
38109,546,4170,22022,16087,22022,16087,1.78186e+18,721.896,9299.7,38109,360,666,32672,30439,27162,26761,10790
7323,637,848,2470,4853,0,7323,3.16571e+13,212.23,1927.62,7323,159,190,6475,6380,6413,6405,5491
35518,962,3944,0,35518,0,35518,2.16853e+18,655.079,8749.84,35518,349,582,31229,30074,26550,22908,12827
6813,8,26,6731,82,6813,0,1.07418e+14,10.1899,257.409,6813,17,15,6746,6719,6315,6244,5293
40537,3140,3641,23845,16692,0,40537,4.67415e+18,1152.92,9270.57,40537,543,525,36896,36791,36170,36036,35073
47325,980,2665,0,47325,0,47325,2.25662e+18,953.23,8214.67,47325,431,375,44146,40777,36575,32366,22433
2811,625,863,1713,1098,1713,1098,1.80708e+18,149.718,1362.94,2811,145,134,1948,1928,1884,1884,1536
16041,1198,1485,9837,6204,9837,6204,1.86962e+18,571.471,3639.17,16041,243,234,14556,14322,14443,14482,13600
5514,111,158,0,5514,5359,155,2.56136e+16,71.704,682.473,5514,56,58,5356,5323,5095,5100,4656
15127,133,589,15127,0,15127,0,4.20649e+18,280.3,2174.2,15127,157,163,13027,10966,7036,6792,5755
49828,2273,2336,15192,34636,0,49828,3.62247e+13,496.682,7540.11,49828,356,415,47492,47492,47488,47487,47372
32689,1034,2925,0,32689,0,32689,2.43032e+18,1048.53,7553.78,32689,469,444,29268,27634,25977,24028,15001
23705,45,631,23705,0,23705,0,3.69725e+18,308.881,2679.66,23705,179,173,16673,11682,9068,8961,2732
18658,1024,2029,11153,7505,0,18658,5.11e+18,577.711,4638.61,18658,339,264,16629,16192,15942,15803,13153
22510,3030,3168,22510,0,20062,2448,1.98699e+18,598.822,6493.36,22510,434,355,19342,19342,19322,19302,19166
11149,533,1083,3433,7716,0,11149,3.73198e+13,353.988,2657.58,11149,231,237,10066,9752,8967,9030,7060
43057,60,2383,0,43057,12886,30171,9.19046e+15,864.665,7362.27,43057,470,482,31310,25810,18924,17356,4195
24838,2158,2635,14852,9986,0,24838,4.95253e+18,992.251,6302.11,24838,392,388,22203,21779,21772,21641,20013
32552,3,296,0,32552,31955,597,2.59126e+16,161.593,2152.14,32552,100,119,21592,17433,15994,15434,10112
13825,202,1161,8556,5269,8556,5269,1.74018e+18,428.974,3084.71,13825,234,223,10485,8102,7115,6010,2863
18571,1082,2275,10920,7651,0,18571,4.64294e+18,693.929,5175.72,18571,354,450,16111,15562,13230,13227,11067
6421,1006,1082,0,6421,0,6421,2.31025e+18,261.261,2096.82,6421,202,126,5339,5339,5337,5337,5310
29155,395,1968,8377,20778,0,29155,3.58052e+13,553.96,5863.13,29155,399,383,26346,24848,21246,21184,8406
41400,1490,1677,0,41400,11440,29960,9.46096e+15,944.518,6176.27,41400,513,399,39723,39536,39473,39480,38008
11328,456,1377,11328,0,9841,1487,3.06383e+18,463.826,3046.99,11328,226,191,9605,7171,5773,4892,3779
11634,2109,2263,11634,0,10240,1394,2.23345e+18,474.23,4274.62,11634,290,245,9371,9371,9355,9360,9165
48194,136,320,0,48194,47412,782,2.6729e+16,149.713,2352.93,48194,115,114,47743,47338,43382,39619,31550
30004,3137,3565,18173,11831,18173,11831,1.93566e+18,790.481,7899.79,30004,392,575,26439,26434,26100,26230,24277
47878,499,584,47878,0,47878,0,3.96956e+18,329.241,3475.05,47878,198,195,47294,47294,46646,46699,46356
48916,3341,3769,30011,18905,30011,18905,1.82524e+18,1091.64,9889.94,48916,453,584,45147,45018,44902,44958,42450
13643,104,1653,0,13643,0,13643,2.33465e+18,592.931,3719.23,13643,269,240,9486,7681,6234,3959,522
32777,212,325,0,32777,32333,444,2.65614e+16,136.356,2159.67,32777,100,103,32452,32397,30857,30511,26068
47462,136,374,0,47462,46914,548,2.62151e+16,170.345,2698.56,47462,111,123,46955,46717,41483,39056,29104
34204,675,4516,34204,0,30350,3854,2.86741e+18,847.021,9721.83,34204,568,401,28438,25689,20190,18065,10149
23857,1350,2696,13614,10243,0,23857,4.60416e+18,711.718,5995.82,23857,344,341,21161,20613,20032,19866,15023
25821,1399,2697,0,25821,0,25821,2.32078e+18,981.849,6529.18,25821,382,440,23045,22288,19500,20000,15224
34960,885,2403,0,34960,10737,24223,9.35166e+15,757.937,6900.59,34960,479,523,32347,31475,29416,29247,19326
26203,885,2726,16088,10115,0,26203,5.03576e+18,565.574,6316.91,26203,307,409,23477,22753,21730,21428,14709
20064,1461,1542,11968,8096,11968,8096,1.98829e+18,813.054,4290.73,20064,326,283,18522,18522,18522,18522,18397
1083,72,316,1083,0,986,97,1.22989e+18,119.078,537.957,1083,96,52,511,228,229,179,85
4123,57,465,3732,391,2152,1971,1.75972e+18,173.644,1117.52,4123,110,113,2134,808,505,360,595
45117,69,306,0,45117,44662,455,2.56915e+16,143.58,2233.42,45117,109,121,44221,42945,36856,34165,24071
32513,2118,2208,0,32513,0,32513,2.41527e+18,1017.39,6316.72,32513,534,357,30305,30305,30305,30281,30283
14078,852,1135,0,14078,4442,9636,8.17989e+15,252.392,2973.38,14078,222,186,12943,12939,12567,12618,11505
24983,367,2345,14222,10761,0,24983,4.46387e+18,643.411,5769.3,24983,354,358,21229,19042,12789,11838,6931
14949,850,2184,14949,0,13401,1548,1.94709e+18,530.789,4447.1,14949,354,269,12765,11989,11116,10607,7769
24870,959,2592,0,24870,0,24870,2.35601e+18,586.957,6078.04,24870,417,287,22278,21656,17972,16169,11476
22831,1,41,22469,362,22831,0,9.97266e+13,18.4896,516.433,22831,25,23,9434,9434,9434,9434,9434
41813,136,256,0,41813,41055,758,2.60603e+16,131.405,2183.85,41813,98,102,41536,41370,38853,38434,30887
40634,2659,3009,23558,17076,23558,17076,1.76749e+18,987.74,8248.5,40634,397,508,37625,37624,37466,37512,36684
33876,3521,3643,33876,0,29804,4072,2.76821e+18,1252.18,8799.84,33876,428,454,30233,30233,30233,30233,30056
21284,1476,2565,12307,8977,0,21284,4.55039e+18,477.936,5691.9,21284,405,427,18719,18642,16324,16327,12614
45958,77,80,45241,717,45958,0,9.8435e+13,18.5753,820.271,45958,29,30,45878,45878,45715,45714,45316
29555,1818,2156,17926,11629,17926,11629,1.8291e+18,977.573,6049.3,29555,414,422,27399,27319,27103,27232,26248
24969,17,51,24411,558,24969,0,9.99239e+13,19.2203,576.758,24969,23,27,24897,24859,22590,22292,17096
3880,536,723,0,3880,0,3880,1.91841e+18,110.451,1356.01,3880,140,102,3157,3155,3114,3108,2994
48750,296,302,0,48750,47574,1176,2.56806e+16,155.93,2470.45,48750,101,109,48448,48448,48442,48389,48396
44998,2685,2910,27516,17482,0,44998,4.98352e+18,885.079,8650.88,44998,431,408,42088,42056,41996,42004,40832
8364,195,1977,8364,0,7490,874,2.92498e+18,303.098,3401.67,8364,249,267,5822,4787,3116,2486,673
38115,1181,2369,0,38115,11761,26354,9.05617e+15,649.281,7030.02,38115,524,449,35746,35401,32621,32938,24381
2317,138,447,794,1523,0,2317,3.10441e+13,110.814,883.209,2317,112,114,1836,1655,1521,1524,859
33681,60,75,33178,503,33669,12,1.00235e+14,19.9616,804.522,33681,29,31,33606,33606,33218,33241,31640
46836,80,84,45666,1170,46836,0,1.01175e+14,18.9904,850.274,46836,31,30,46752,46752,46598,46599,46471
25310,39,46,24982,328,25209,101,9.90558e+13,20.6324,609.038,25310,26,28,25264,25264,25065,25092,24693
1259,411,528,1259,0,1073,186,3.49274e+18,72.1954,725.822,1259,104,67,731,720,725,698,656
5822,11,16,5790,32,5822,0,2.1591e+18,15.956,305.208,5822,16,16,3871,0,2182,3630,3871
4029,1104,1185,3486,543,2414,1615,2.03082e+18,211.187,1915.04,4029,221,165,2844,2844,2838,2838,2816
29521,593,2592,17621,11900,17621,11900,1.78566e+18,930.613,6741.36,29521,440,470,25812,24034,18958,18845,9488
32091,624,677,32091,0,32091,0,4.24501e+18,335.023,3214.21,32091,193,201,31414,31404,31244,31282,31287
12129,700,1043,0,12129,3424,8705,9.91847e+15,497.275,2797.26,12129,256,241,11008,10504,10677,10645,8985
47999,510,4245,42650,5349,28899,19100,1.98403e+18,1482.88,10916.5,47999,607,449,39104,32954,19461,16704,8078
17769,166,2166,0,17769,0,17769,2.03279e+18,574.931,4683.84,17769,309,289,14319,13048,6103,6151,1212
36065,3186,4019,31943,4122,21427,14638,1.94086e+18,1232.75,9027.33,36065,583,501,32046,31834,31123,31121,29424
43253,856,879,43253,0,43253,0,4.35887e+18,350.759,3914.99,43253,222,221,42374,42374,42366,42365,42361
18991,869,2258,11637,7354,11637,7354,1.84675e+18,706.777,5182.84,18991,366,376,16567,15868,14507,14539,7502
25618,1175,1572,0,25618,7704,17914,8.57124e+15,677.94,4703.75,25618,323,288,24046,24004,23650,23609,19931
37611,1133,2525,23676,13935,23676,13935,1.84318e+18,673.221,6723.89,37611,378,431,35086,34808,32491,32023,21056
24446,45,73,24039,407,24446,0,1.02891e+14,18.814,683.185,24446,29,31,24373,24373,23456,23513,20077
47882,3745,3954,0,47882,0,47882,2.30512e+18,927.628,9767.68,47882,654,477,43928,43918,43883,43858,43293
21227,438,1470,6397,14830,0,21227,3.7458e+13,313.334,3890.93,21227,300,214,19754,19370,17544,17566,13300
8695,185,191,0,8695,8518,177,2.59723e+16,79.95,892.363,8695,62,71,8504,8504,8503,8498,8481
42093,17,301,0,42093,41365,728,2.55771e+16,150.447,2467.69,42093,105,122,39156,37731,31830,27660,15607
41374,2403,2815,36619,4755,24207,17167,1.94956e+18,1406.08,7863.85,41374,395,473,38559,37559,38033,37984,34280
47999,1120,2925,0,47999,0,47999,2.08316e+18,1305.48,8541.5,47999,492,528,44135,41651,38608,27226,23538
32697,1622,2268,9803,22894,0,32697,3.64234e+13,519.915,6389.21,32697,385,391,30429,30295,30130,30116,25384
2256,137,293,2256,0,2256,0,4.90228e+18,115.864,697.954,2256,73,77,1937,1759,1542,1539,1336
30883,23,2260,18314,12569,0,30883,4.85985e+18,955.696,6176.82,30883,402,370,16334,10500,8651,7534,851
37844,1167,1416,0,37844,11313,26531,9.48706e+15,866.971,5736.17,37844,432,391,36359,35950,35766,35757,33718
21789,2011,2405,13110,8679,13110,8679,1.90736e+18,1072.26,5602.94,21789,436,401,19384,18737,18672,18685,16828
10797,1381,1473,6468,4329,6468,4329,1.86424e+18,414.55,3195.8,10797,333,249,9324,9317,9283,9287,9125
31734,45,60,31367,367,31734,0,1.00318e+14,18.7599,649.878,31734,27,27,31674,31674,31254,31254,29917
18309,11,71,17886,423,18309,0,1.05863e+14,17.1212,561.461,18309,27,28,18152,18066,16162,16068,9022
21163,4,36,20834,329,21163,0,9.97793e+13,17.4909,479.392,21163,20,22,19345,18253,16592,16120,10583
43697,3200,4108,26350,17347,0,43697,4.75307e+18,647.534,9770.13,43697,606,376,39589,39567,38934,38783,36659
17668,1245,1579,0,17668,4910,12758,9.17418e+15,401.065,4143.78,17668,357,250,16089,16087,15990,15930,14259
2157,18,22,2142,15,2157,0,9.27813e+13,13.4502,168.762,2157,15,15,2135,2132,2106,2106,2030
31170,67,1068,31170,0,31170,0,4.21977e+18,369.401,3702.97,31170,221,219,22688,14926,12092,10354,4532
20370,74,244,0,20370,20039,331,2.71145e+16,115.475,1525.32,20370,82,99,19910,19466,16779,15995,11534
11348,248,1959,6626,4722,6626,4722,1.80286e+18,401.941,3796.28,11348,343,349,8873,7941,5879,5265,2394
27234,587,1948,7863,19371,0,27234,3.37956e+13,690.811,5253.03,27234,458,336,24893,24128,21679,21803,10045
23214,2183,2846,0,23214,0,23214,2.44262e+18,719.347,6216.93,23214,316,386,20368,20259,20194,20167,17593
14881,197,1595,4211,10670,0,14881,3.5511e+13,308.985,3771.31,14881,314,222,12836,11985,8646,7949,2622
2668,130,853,2391,277,1514,1154,2.20123e+18,83.6919,1290.41,2668,123,142,1804,1506,1009,834,310
15301,10,30,14939,362,15301,0,9.95402e+13,15.8541,402.426,15301,20,21,15163,15073,13410,13238,9344
17851,480,729,17851,0,17851,0,4.17869e+18,355.606,2609.33,17851,173,179,17122,16958,15174,15176,15112
39344,171,1018,38811,533,39344,0,4.11188e+18,373.596,4033.2,39344,234,225,36039,32164,20233,18938,13406
25288,1133,3221,25288,0,22656,2632,2.66238e+18,645.988,6675.62,25288,392,326,22067,21097,15446,14273,12371
47989,203,642,47989,0,47989,0,3.91428e+18,351.921,3698.76,47989,202,214,46277,44245,32262,31993,23374
28110,454,788,28110,0,28110,0,4.20587e+18,307.433,3178.24,28110,192,201,27322,27235,23109,22957,19787
20551,631,1652,0,20551,5922,14629,9.29269e+15,573.265,4481.78,20551,411,268,18719,17867,16535,16576,10626
17042,1475,2387,9854,7188,9854,7188,1.71704e+18,441.116,4906.25,17042,326,288,14655,14439,14247,14244,11582
1931,378,728,1931,0,1748,183,2.1503e+18,73.2097,1040.33,1931,102,114,1203,1174,939,941,755
15049,1790,1966,8594,6455,0,15049,4.47539e+18,388.902,4315.02,15049,314,284,13083,13080,13059,13062,12907
10416,117,431,10416,0,10416,0,4.04259e+18,261.5,1680.69,10416,127,132,9013,7640,5561,5219,3287
32215,422,724,32215,0,32215,0,4.27612e+18,336.345,3297,32215,208,210,31491,31323,27889,27735,24555
18906,60,1770,0,18906,5977,12929,8.96757e+15,342.752,4441.13,18906,363,265,13719,11527,7976,7855,1826
44533,48,2222,0,44533,12716,31817,9.49749e+15,962.672,7250.14,44533,520,390,31502,25900,20567,19317,4137
18326,105,1209,0,18326,6206,12120,8.32498e+15,466.111,3492.11,18326,279,280,15398,13919,8196,8189,1811
12029,102,1133,3846,8183,0,12029,3.25059e+13,264.21,2723.08,12029,249,253,10222,9400,6532,6623,3104
3649,212,319,1915,1734,1915,1734,1.32282e+18,131.087,882.665,3649,90,94,3330,3321,3195,3154,2638
2331,126,429,0,2331,591,1740,1.0078e+16,94.266,790.831,2331,137,74,1884,1766,1740,1729,847
42523,1477,2112,13461,29062,0,42523,3.49455e+13,595.262,6512.55,42523,407,437,40411,40348,37558,37756,35533
23011,759,2664,13722,9289,13722,9289,1.87527e+18,941.368,6019.84,23011,356,393,19516,18201,14624,12863,8285
22766,344,1560,6804,15962,0,22766,3.27941e+13,582.401,4385.45,22766,300,274,20682,19661,17270,17370,6996
36395,1029,1070,36395,0,36395,0,4.08785e+18,386.783,3949.99,36395,226,226,35325,35321,35301,35308,35302
48199,944,2298,15255,32944,0,48199,3.57859e+13,829.006,7594.51,48199,467,411,45666,44163,40841,40822,30068
49964,7861,49964,49964,0,0,49964,15.9997,0,49964,49964,49964,1,0,0,0,0,0
45710,1774,3782,45710,0,41251,4459,1.77309e+18,1282.84,9897.75,45710,469,534,41928,40710,34021,31619,23040
6089,507,936,1667,4422,0,6089,4.07062e+13,176.921,1885.49,6089,203,143,5153,5062,5057,5062,3514
2026,191,426,0,2026,588,1438,7.71875e+15,112.898,799.135,2026,113,105,1600,1471,1364,1347,949
18313,2219,2690,18313,0,16488,1825,2.34351e+18,448.021,5229.33,18313,246,344,15623,15614,15581,15595,14860
44680,570,3895,44655,25,40241,4439,1.63651e+18,1446.23,9826.89,44680,438,481,38219,35374,15634,12473,7270
16570,29,35,16197,373,16570,0,9.61128e+13,16.4428,426.62,16570,19,22,16535,16535,16368,16368,16054
18039,179,266,0,18039,17656,383,2.68714e+16,117,1492.14,18039,92,84,17773,17720,16892,16657,14672
20890,2270,2524,20890,0,18726,2164,2.85311e+18,695.014,5666.02,20890,314,341,18366,18332,18291,18218,17947
42952,910,1286,13592,29360,0,42952,3.07484e+13,779.07,5237.24,42952,358,352,41472,40199,40207,40358,33772
33136,266,336,0,33136,32427,709,2.74609e+16,142.544,2286.87,33136,102,121,32800,32787,32209,32067,30537
40676,493,965,40676,0,40676,0,4.20625e+18,344.469,3888.11,40676,206,225,39711,39607,33124,32961,31253
13278,1403,2056,7897,5381,0,13278,4.61247e+18,339.484,4097.04,13278,244,261,11222,11125,11016,11016,8356
40016,1273,2114,0,40016,11830,28186,9.1345e+15,742.501,6635.21,40016,408,367,37902,37532,35447,35641,31485
5934,400,1736,5431,503,3562,2372,2.06737e+18,182.985,2612.06,5934,207,160,4198,3831,2336,2252,773
22771,1533,2435,13519,9252,13519,9252,1.83941e+18,801.431,5807.22,22771,431,433,20336,19765,19152,19121,16600
25495,1590,1678,0,25495,7691,17804,9.20237e+15,484.933,4956.42,25495,325,397,23817,23817,23800,23800,23551
12922,21,32,12692,230,12922,0,1.02792e+14,16.2447,369.563,12922,20,22,12890,12888,12259,12257,10917
45220,1213,3383,26413,18807,0,45220,4.49684e+18,1393.21,8989.88,45220,468,459,40980,38959,33709,32034,21881
13378,131,166,0,13378,13082,296,2.50193e+16,103.443,1024.57,13378,74,68,13188,13112,12747,12684,11973
40146,716,4527,36280,3866,23791,16355,1.91907e+18,760.558,10277,40146,399,615,34916,32600,24170,22482,7973
34589,704,1686,10534,24055,0,34589,3.22566e+13,750.33,5444.78,34589,362,272,32455,31558,28366,28539,13250
40044,120,277,0,40044,39350,694,2.41326e+16,144.306,2277.64,40044,102,107,39668,39476,35725,35605,26276
11855,2411,2469,10779,1076,7221,4634,1.98845e+18,487.102,4390.47,11855,286,268,9386,9369,9386,9386,9363
4855,1,22,4807,48,4855,0,1.04416e+14,13.1308,217.645,4855,14,17,1873,1873,1873,1873,1873
40922,616,1754,12557,28365,0,40922,3.57362e+13,814.495,6133.16,40922,417,432,38024,36320,30107,30313,20500
31734,1777,1999,0,31734,9565,22169,9.26462e+15,570.896,5771.28,31734,487,310,29735,29726,29430,29450,28773
15639,221,250,0,15639,15334,305,2.48486e+16,101.876,1358.54,15639,79,76,15389,15388,15286,15266,14716
7687,695,848,2472,5215,0,7687,3.45543e+13,260.987,1994.68,7687,175,154,6839,6830,6668,6675,6383
982,115,389,596,386,596,386,1.88326e+18,44.058,541.844,982,44,75,593,547,405,329,173
10415,129,1543,0,10415,0,10415,2.08207e+18,191.685,2984.54,10415,189,205,8416,6975,3704,3658,617
2267,201,497,0,2267,708,1559,8.06233e+15,75.1548,899.58,2267,129,99,1770,1746,1488,1355,785
1830,252,572,1152,678,0,1830,5.66743e+18,80.0672,859.289,1830,119,114,1258,1178,1149,1157,758
14864,267,605,14864,0,14864,0,4.38204e+18,286.951,2202.55,14864,152,145,14152,13665,9883,9733,8577
32068,1788,1843,0,32068,9812,22256,9.05906e+15,526.945,5769.36,32068,361,374,30225,30224,30213,30204,30114
12115,382,2169,0,12115,0,12115,2.31123e+18,314.688,4052.16,12115,252,350,9882,9028,8009,6985,2063
48868,1381,2109,0,48868,14784,34084,9.48404e+15,584.976,6533.8,48868,391,374,46759,46609,45191,45334,37479
25835,126,2316,25835,0,23357,2478,2.55696e+18,1212.18,6069.18,25835,375,343,17420,13756,6080,2845,1848
45913,800,4001,27640,18273,27640,18273,1.88451e+18,1068.22,9904.55,45913,521,523,39819,36099,31144,31187,20363
16061,351,1978,0,16061,0,16061,1.99459e+18,366.148,4078.82,16061,323,318,13839,13187,7448,8756,2189
40077,454,3294,0,40077,0,40077,2.31716e+18,1279.17,8542.83,40077,567,554,33972,30985,19005,12985,8996
23207,808,1645,0,23207,7367,15840,8.16104e+15,551.927,4580.65,23207,321,333,21562,20981,19321,19354,15242
39936,301,3489,23704,16232,0,39936,4.86039e+18,752.773,8472.24,39936,566,492,33094,28441,18297,15707,7521
21249,814,1578,0,21249,0,21249,2.39482e+18,613.48,4523.26,21249,279,264,19636,19293,16973,15094,11087
40016,2245,2776,22144,17872,0,40016,4.22102e+18,915.653,7549.89,40016,355,504,37240,37211,36939,36938,32014
1063,202,482,944,119,677,386,1.98137e+18,48.461,643.515,1063,69,90,581,541,513,508,414
27401,617,2258,27401,0,24646,2755,2.24832e+18,839.094,5831.5,27401,383,349,24191,22990,20735,19101,10089
10377,153,849,0,10377,3336,7041,9.12293e+15,342.933,2290.17,10377,206,253,8623,7358,5742,5920,2282
7703,1168,1195,4651,3052,4651,3052,1.88358e+18,511.15,2552.4,7703,203,267,6508,6508,6494,6504,6479
38026,3694,4251,34217,3809,22181,15845,1.9124e+18,1391.13,9582.52,38026,493,548,33775,33148,33578,33583,32402
10558,1017,1296,10558,0,9547,1011,1.64355e+18,247.419,2746.5,10558,239,172,9262,9241,9234,9232,8906
35264,1779,2899,0,35264,0,35264,2.27099e+18,964.559,7603.51,35264,405,513,32365,31676,30350,28116,22715
12622,26,46,12475,147,12622,0,1.05927e+14,16.0813,399.276,12622,22,24,12576,12575,11905,11929,8904
1771,45,708,1106,665,0,1771,4.2276e+18,72.0452,1011.77,1771,178,95,882,472,391,365,155
18412,174,185,0,18412,18162,250,2.50668e+16,130.579,1198.04,18412,85,78,18227,18170,18206,18091,18030
4883,761,1117,4228,655,2905,1978,1.94932e+18,353.49,2040.55,4883,211,188,3766,3719,3473,3591,2832
36166,1117,3667,36166,0,32069,4097,1.71215e+18,978.35,8432.87,36166,395,492,32327,30729,23670,21252,17646
32183,1839,2519,18044,14139,0,32183,4.32898e+18,992.468,6575.8,32183,376,397,29664,28550,28948,28849,25918
17473,1610,1793,0,17473,0,17473,2.30342e+18,672.522,4414.09,17473,257,263,15680,15609,15633,15671,15284
43884,191,284,0,43884,43189,695,2.53197e+16,153.44,2380.58,43884,106,109,43595,43498,41752,41371,38121
37412,1153,2429,0,37412,11473,25939,8.89478e+15,722.036,6910.27,37412,422,385,34983,34301,31818,31975,23696
16643,104,2184,9210,7433,9210,7433,1.60952e+18,378.743,4492.46,16643,347,307,12699,9308,5307,5094,1073
34582,2620,3519,20442,14140,20442,14140,1.89063e+18,1218.44,8476.91,34582,585,531,31063,30447,29770,29687,25729
26832,1551,1727,0,26832,8072,18760,8.81133e+15,444.444,5168.26,26832,357,306,25105,25072,25054,25005,23521
23258,37,245,0,23258,22783,475,2.62169e+16,119.792,1660.91,23258,82,84,22375,21791,18533,16717,10424
14684,1159,1169,4644,10040,0,14684,3.61701e+13,371.923,3190.66,14684,226,252,13515,13515,13509,13509,13512
43585,764,1868,0,43585,13697,29888,9.24449e+15,745.294,5791.57,43585,368,364,41427,40832,33303,33558,26134
42700,290,411,0,42700,41896,804,2.54059e+16,155.456,2911.18,42700,121,134,42289,42259,41478,40881,37304
40036,106,108,38807,1229,40036,0,1.06042e+14,19.4795,888.983,40036,30,31,39928,39928,39927,39927,39867
33212,1416,2294,19663,13549,19663,13549,1.74216e+18,781.518,6674.58,33212,377,355,30918,30820,29929,29690,23998
19394,2373,2400,17347,2047,11862,7532,1.99636e+18,976.386,5520.16,19394,360,396,16994,16994,16994,16994,16989
24065,90,227,0,24065,23409,656,2.60145e+16,131.65,1592.9,24065,81,89,23704,23430,21169,19859,15400
16406,2195,2320,16406,0,14695,1711,2.5705e+18,469.048,4832.1,16406,299,278,14086,14081,14078,14074,13794
43030,1198,4901,37972,5058,26018,17012,1.94192e+18,1060.84,11284,43030,592,526,37450,35014,24253,23482,15664
46631,981,3370,27836,18795,27836,18795,1.82509e+18,1298.32,9136.67,46631,629,410,42040,39230,29527,26751,14986
48719,304,348,0,48719,47816,903,2.62087e+16,148.107,2572.95,48719,117,123,48371,48359,48049,47822,46484
17002,985,1385,5425,11577,0,17002,3.38173e+13,422.972,3805.58,17002,223,373,15617,15438,15493,15458,13365
34617,565,2042,10700,23917,0,34617,3.38482e+13,718.636,6168.73,34617,380,354,32025,30770,24944,25140,11618
34664,287,291,0,34664,33910,754,2.66787e+16,156.809,2315.96,34664,108,121,34373,34373,34371,34354,34301
44770,20,59,43953,817,44770,0,9.8878e+13,18.7396,757.618,44770,26,25,44704,44685,40261,39832,27336
34807,192,298,0,34807,34184,623,2.67305e+16,138.875,2213.3,34807,102,110,34509,34475,33313,33191,30301
17552,338,1722,0,17552,0,17552,2.36515e+18,539.134,4185.07,17552,307,257,14589,11976,9946,8206,4782
8378,15,20,8271,107,8378,0,9.13167e+13,14.2071,271.521,8378,18,17,8354,8347,8020,8020,7688
32859,3618,3697,0,32859,0,32859,2.13326e+18,584.639,8199.99,32859,305,509,29162,29162,29162,29162,28941
7065,641,814,0,7065,0,7065,2.36606e+18,330.793,1903.13,7065,175,152,6251,6176,6051,5982,5262
22832,2405,2862,0,22832,0,22832,2.24983e+18,453.646,6126.19,22832,313,484,19970,19966,19773,19916,18813
37368,11,76,36765,603,37368,0,1.03474e+14,21.7132,750.744,37368,30,29,37013,36780,32594,32496,19428
46896,612,844,46896,0,46896,0,4.32227e+18,362.011,4047.1,46896,232,229,46052,46044,43443,43246,42389
13346,845,948,0,13346,4304,9042,8.93128e+15,384.765,2774,13346,260,252,12398,12396,12340,12342,12129
20983,1942,2512,0,20983,0,20983,2.14744e+18,588.23,5486.77,20983,288,432,18471,18462,18328,18379,16780
8324,204,210,0,8324,8164,160,2.33123e+16,71.1313,941.071,8324,66,62,8114,8114,8112,8112,8056
14797,21,32,14563,234,14797,0,9.77946e+13,15.4915,393.239,14797,19,22,14765,14765,13702,13699,11767
12096,193,218,0,12096,11817,279,2.50677e+16,92.6229,1097.57,12096,81,73,11878,11877,11839,11823,11546
32492,1333,3493,29117,3375,19433,13059,1.97245e+18,1148.83,8213.51,32492,470,500,28625,26504,24052,24252,12656
41875,439,2509,11986,29889,0,41875,3.60556e+13,761.864,7702.43,41875,475,545,37692,35453,30290,30690,8859
43022,943,2023,12632,30390,0,43022,3.70426e+13,672.558,6627.74,43022,437,359,40984,40229,34648,34468,22895
10201,329,570,10201,0,10201,0,4.1344e+18,248.432,1816.97,10201,141,139,9631,9469,8450,8386,6871
22541,2114,4096,22541,0,22541,0,9.41119e+15,3351.7,9598.8,22541,4096,7,10517,0,1207,9834,10517
4572,338,869,4131,441,2751,1821,1.93637e+18,307.422,1678.72,4572,180,149,3442,2733,2680,2614,1767
29415,14,42,28766,649,29415,0,1.00868e+14,20.0822,580.764,29415,23,25,29311,29252,26734,26606,20840
45755,368,2286,0,45755,14383,31372,8.8042e+15,621.978,7524.31,45755,353,425,41978,38798,27793,25333,14085
24971,2023,2143,14570,10401,0,24971,4.51367e+18,804.564,5764.46,24971,363,485,22828,22828,22767,22757,22584
24450,867,1715,7311,17139,0,24450,3.46558e+13,693.903,4933.35,24450,358,385,22537,22103,21479,21543,14423
30281,6,9,28388,1893,30153,128,0.000264192,0.999703,504.064,30281,9,1,30272,30272,30272,30272,30272
33970,457,2430,20286,13684,20286,13684,1.86832e+18,1021.34,6833.28,33970,475,328,28893,26112,22794,21969,9484
46861,2854,4155,46861,0,42717,4144,2.44821e+18,738.84,10541.1,46861,442,555,42706,42615,42538,42525,31214
32253,180,241,0,32253,31773,480,2.41891e+16,134.373,1777.12,32253,96,99,32012,31982,31298,31253,29853
36253,1671,2959,21180,15073,0,36253,4.93906e+18,780.052,7696.63,36253,428,360,33294,32922,31609,30978,26398
35566,410,2110,0,35566,11275,24291,8.27181e+15,617.615,6360,35566,436,380,32570,31027,20998,20466,8760
24000,737,809,24000,0,23975,25,4.12426e+18,325.901,2966.22,24000,192,183,23191,23190,23003,23008,22826
28120,1773,3025,28120,0,25521,2599,2.13245e+18,1028.55,7025.93,28120,384,332,25095,23553,22740,22455,15957
26093,2406,4639,26093,0,23419,2674,2.24469e+18,496.628,8733.76,26093,472,496,21454,21374,21164,21269,12631
18065,128,222,0,18065,17906,159,2.53489e+16,100.893,1289.66,18065,71,82,17834,17741,16394,16778,14455
45521,2551,3703,27192,18329,0,45521,4.7112e+18,1275.65,9845.06,45521,663,492,41818,40843,39735,39178,34937
13917,1521,2230,13917,0,12405,1512,1.6514e+18,546.85,4620.73,13917,331,235,11687,11658,11487,11525,9903
21011,735,3265,12539,8472,0,21011,4.99054e+18,527.525,6497.26,21011,507,323,17614,16529,10435,8911,4837
31295,136,2695,18821,12474,0,31295,4.83193e+18,1064.53,7013.01,31295,472,396,22412,18466,13339,10013,1627
40135,1924,2863,35365,4770,23830,16305,1.95073e+18,1202.55,7785.9,40135,417,439,37272,36476,35373,35580,28050
47551,1245,2922,28554,18997,0,47551,4.96535e+18,1193.8,8937.36,47551,613,458,43943,40660,39785,38820,21826
2286,487,847,2286,0,2028,258,1.6434e+18,111.24,1229.68,2286,104,132,1439,1386,1296,1277,979
23982,122,755,23982,0,23982,0,4.23657e+18,324.389,2924.35,23982,184,184,20858,17396,11734,10975,6057
27771,255,2863,16662,11109,16662,11109,1.88421e+18,841.361,6819.73,27771,463,456,21911,18162,14059,11690,3235
32779,164,2223,0,32779,9633,23146,9.33806e+15,598.074,6216.78,32779,425,322,27304,23700,17156,16192,6955
41797,432,3708,0,41797,0,41797,2.27328e+18,799.203,9141.72,41797,498,465,35669,31023,19802,15633,7154
9727,3,32,9547,180,9727,0,1.02699e+14,12.4526,318.616,9727,17,18,8253,7547,6936,6860,5106
2971,293,947,2971,0,2723,248,2.51067e+18,127.277,1376.93,2971,182,109,2024,1863,1385,1218,587
6677,153,491,6677,0,6677,0,4.28255e+18,233.55,1429.55,6677,118,118,5825,5002,3682,3465,3028
41055,1555,3476,0,41055,0,41055,2.26033e+18,977.165,8726.73,41055,537,440,37579,36360,34431,33762,20659
3508,848,1034,3238,270,2184,1324,1.83383e+18,260.528,1673.83,3508,188,146,2474,2468,2459,2450,2388
26166,294,2196,26166,0,24038,2128,1.79057e+18,795.161,5663.19,26166,365,323,19688,15087,9775,5556,2148
5620,1255,1294,0,5620,0,5620,2.34709e+18,220.686,2222.48,5620,194,154,4326,4326,4326,4326,4307
42668,258,329,0,42668,42001,667,2.70495e+16,133.862,2257.59,42668,109,112,42339,42324,41425,41339,39804
38717,406,3002,23110,15607,23110,15607,1.86082e+18,781.664,7904.8,38717,434,395,33845,29669,25787,24382,8524
14653,114,215,0,14653,14263,390,2.54142e+16,106.758,1186.24,14653,73,75,14415,14313,13310,13561,11481
37278,2282,2525,22483,14795,22483,14795,1.91479e+18,1160.13,7211.88,37278,483,431,34753,34745,34548,34659,33954
511,154,206,0,511,167,344,7.3329e+15,22.6947,303.239,511,72,48,305,305,263,260,234
38790,384,3176,38790,0,34472,4318,2.18107e+18,1240.01,8488.5,38790,594,409,31301,24463,15847,11824,5284
40708,852,975,40708,0,40708,0,4.39673e+18,384.24,3975.03,40708,215,215,39733,39733,39379,39356,39375
25339,9,32,25056,283,25339,0,1.00153e+14,18.0219,484.022,25339,20,23,25150,25033,22767,21851,14590
5577,42,646,1951,3626,0,5577,3.05376e+13,117.299,1430.73,5577,157,126,3917,2881,1817,947,1176
15875,985,1647,9548,6327,9548,6327,1.86095e+18,613.087,3970.05,15875,317,298,14228,13773,13448,13179,11503
12582,175,206,0,12582,12325,257,2.66136e+16,84.8625,1116.09,12582,71,72,12376,12371,12257,12219,11973
10719,1103,1654,6306,4413,6306,4413,1.89214e+18,471.074,3452.33,10719,289,304,9065,8953,8598,8409,7477
24939,2080,2328,24939,0,22173,2766,2.76337e+18,637.751,5611.15,24939,305,342,22611,22602,22456,22447,22167
39149,534,935,39139,10,39149,0,4.18678e+18,356.828,3901.58,39149,217,222,38214,38138,34937,34795,34653
867,195,434,740,127,538,329,1.88994e+18,36.6367,567.679,867,62,65,433,414,346,377,215
20481,2305,2539,12012,8469,12012,8469,1.74873e+18,557.395,5684.76,20481,319,527,17942,17936,17840,17890,17309
43758,1522,2735,0,43758,41023,2735,0.06248,0.937497,10939.7,43758,2735,1,41023,41023,41023,41023,41023
49574,2473,2577,15843,33731,0,49574,3.57437e+13,523.267,7807.31,49574,371,542,46997,46997,46972,46971,46759
16412,34,227,0,16412,16128,284,2.67736e+16,108.926,1358.45,16412,76,84,15657,15198,12839,11395,6724
33892,905,3192,20054,13838,0,33892,4.84414e+18,890.781,7877.22,33892,438,460,30099,28304,22287,21653,10550
18514,149,247,0,18514,18070,444,2.55242e+16,109.929,1416.95,18514,84,72,18267,18188,17218,17249,15261
15267,1583,1945,9564,5703,9564,5703,1.79569e+18,388.953,4127.96,15267,266,293,13322,13321,13101,13193,11590
31172,23,60,30570,602,31172,0,1.07707e+14,21.3334,645.534,31172,27,30,31102,31083,28642,28523,23199
17881,230,1925,0,17881,0,17881,2.34128e+18,463.357,4259.62,17881,326,285,13847,10898,7594,4653,2052
45761,2467,2782,0,45761,13238,32523,9.50734e+15,696.414,8382.88,45761,543,564,42979,42979,42841,42777,41108
15391,1610,1860,13925,1466,8431,6960,1.88475e+18,470.292,3968,15391,291,257,13531,13531,13483,13453,13178
2039,340,588,1251,788,0,2039,4.98874e+18,155.007,955.216,2039,107,101,1451,1319,1238,1153,1032
46756,1512,4569,46756,0,41098,5658,1.70546e+18,1038.49,10761,46756,505,662,42187,40402,33485,30351,25161
27170,131,312,0,27170,26658,512,2.63779e+16,135.681,1901.99,27170,96,103,26814,26662,24172,23296,17781
47636,1294,2687,28296,19340,0,47636,4.57088e+18,713.305,8349.67,47636,578,397,44949,44813,34649,33433,25359
949,17,69,0,949,929,20,2.56644e+16,20.8841,182.722,949,22,31,861,829,754,699,491
42186,1433,4271,42186,0,38036,4150,2.68479e+18,1090.76,9874.56,42186,418,459,37471,35657,21658,17441,11276
21989,1200,3321,21989,0,19672,2317,2.40717e+18,715.348,6541.63,21989,407,408,18668,17663,14289,12948,9881
40781,1027,2470,0,40781,11991,28790,9.2555e+15,756.687,7311.73,40781,553,389,38112,37093,33351,33077,24318
4499,124,973,2787,1712,0,4499,5.25427e+18,262.472,1769.38,4499,177,162,3102,2694,2202,1824,847
32712,699,1970,9900,22812,0,32712,3.59183e+13,645.496,5760.77,32712,422,342,30474,29165,25104,25365,18106
2855,406,499,0,2855,866,1989,9.2808e+15,131.345,1010.52,2855,103,126,2356,2354,2339,2334,1928
10104,830,1722,6130,3974,6130,3974,1.83589e+18,259.138,3438.5,10104,195,313,8382,8344,7952,8074,5399
33279,27,80,32817,462,33279,0,1.04778e+14,18.0204,732.792,33279,32,28,33199,33195,30381,30260,22059
31135,1776,1864,9669,21466,0,31135,3.3671e+13,758.548,5706.41,31135,355,427,29271,29220,29201,29195,28863
14874,150,158,0,14874,14563,311,2.66837e+16,74.7374,900.918,14874,63,71,14716,14716,14698,14688,14675
24162,1882,2316,13855,10307,0,24162,4.58449e+18,589.479,5666.66,24162,402,338,21846,21840,21322,21254,19246
20515,1822,2581,12422,8093,12422,8093,1.84511e+18,684.071,5705.22,20515,320,454,17934,17908,17586,17667,15864
8808,1017,1063,0,8808,2613,6195,9.622e+15,271.229,2444.7,8808,194,221,7745,7745,7741,7739,7648
17226,488,1468,15698,1528,10212,7014,1.8638e+18,409.409,3836.43,17226,256,218,15672,13932,9739,8975,6972
6343,126,1005,1695,4648,0,6343,3.94301e+13,191.389,1984.1,6343,207,154,5084,4674,2912,2289,696
36309,20,947,36284,25,36293,16,4.06668e+18,355.969,3644.03,36309,211,214,19585,11487,8414,8046,1549
26074,925,1900,7924,18150,0,26074,3.49944e+13,470.947,5357.57,26074,427,355,24174,23910,20879,20958,13261
47487,1866,3829,0,47487,0,47487,2.32431e+18,1128.26,9982.4,47487,578,463,43658,42365,36549,29453,27186
9609,1146,1220,5420,4189,5420,4189,1.45999e+18,260.389,2661.75,9609,197,243,8389,8377,8381,8387,7984
14756,2281,2327,8978,5778,0,14756,5.26382e+18,446.083,4572.87,14756,476,269,12429,12429,12422,12416,12358
10920,94,198,0,10920,10637,283,2.5372e+16,81.3988,970.768,10920,63,64,10709,10598,9986,9860,7636
35967,2895,5107,32241,3726,21539,14428,1.97299e+18,977.936,10619,35967,483,678,30860,30711,28649,28738,19520
42931,486,2218,0,42931,13272,29659,9.26819e+15,822.339,7307.06,42931,414,547,39577,37536,29635,29980,15738
8645,327,413,8639,6,8645,0,4.24014e+18,240.401,1529.52,8645,127,119,8232,8187,7653,7651,7157
30693,556,1686,10114,20579,0,30693,3.29751e+13,711.185,5417.84,30693,370,391,28055,26690,23341,23474,12565
23104,145,258,0,23104,22606,498,2.68283e+16,123.915,1691.46,23104,95,97,22838,22711,21559,21290,18469
36656,77,2471,0,36656,10937,25719,8.41867e+15,659.542,6835.42,36656,492,389,29060,24339,16755,14205,2053
22855,1095,1522,6852,16003,0,22855,3.58881e+13,437.736,4263.1,22855,299,315,21333,21280,21140,21151,18605
10527,424,1044,6465,4062,0,10527,4.98568e+18,421.653,2671.78,10527,234,201,9079,7817,7399,7148,6022
33519,648,1185,33519,0,33519,0,4.39343e+18,368.103,3927.5,33519,217,224,32334,32241,27978,27580,27228
10492,29,36,10306,186,10492,0,9.99598e+13,16.0965,361.008,10492,17,24,10456,10456,10151,10152,9440
21881,714,2168,0,21881,6929,14952,9.03268e+15,387.565,5394.8,21881,333,409,19713,19284,16165,15972,8468
26371,16,53,25917,454,26371,0,1.03823e+14,19.2899,588.661,26371,24,27,26285,26231,23505,23273,15613
15777,1958,2019,0,15777,0,15777,2.42198e+18,414.942,4379.38,15777,381,238,13758,13756,13751,13754,13678
23908,852,1538,7251,16657,0,23908,3.26279e+13,522.227,4368.89,23908,279,330,22370,21868,21262,21346,16967
5807,705,789,0,5807,1718,4089,8.25881e+15,126.89,1693.83,5807,167,144,5018,5015,5018,5018,4634
29242,1910,2821,26308,2934,16687,12555,1.88095e+18,945.924,6557.48,29242,370,426,26421,25652,24408,24551,19311
2303,4,19,2266,37,2303,0,9.56993e+13,12.1198,138.632,2303,15,15,2080,1941,1833,1844,1196
18206,7,234,0,18206,17802,404,2.56948e+16,115.812,1346.12,18206,79,93,15049,12967,12084,10278,6149
735,156,419,0,735,0,735,1.61881e+18,20.8735,510.385,735,115,54,316,301,281,287,163
46071,2947,2993,0,46071,0,46071,2.12435e+18,989.097,8242.49,46071,440,399,43078,43078,43054,43053,42827
41804,1102,4288,41804,0,37541,4263,1.80685e+18,1045.29,9919.31,41804,413,615,36914,35267,25195,22593,17552
46094,743,992,46094,0,46084,10,4.30736e+18,415.72,4237.11,46094,242,236,45102,45057,42965,42982,41540
13634,1367,1426,3890,9744,0,13634,3.84207e+13,341.583,3461.47,13634,323,329,12208,12208,12208,12208,12118
12322,1126,2049,12322,0,10908,1414,2.70056e+18,523.408,4031.13,12322,281,261,10273,10181,8670,8487,5378
49217,5,104,48483,734,49217,0,1.01228e+14,19.9111,861.961,49217,32,32,46178,44035,39457,40049,22835
5511,388,753,0,5511,0,5511,2.46553e+18,378.278,1688.1,5511,170,166,4534,3614,4025,3689,3248
32207,61,80,31524,683,32207,0,9.87748e+13,16.342,712.927,32207,26,29,32127,32127,31674,31675,28983
1059,14,33,0,1059,1013,46,2.62647e+16,25.4674,149.019,1059,24,25,952,886,850,763,677
25816,26,58,25354,462,25816,0,1.02631e+14,19.9921,604.39,25816,24,26,25758,25744,23688,23571,17538
24215,60,74,23625,590,24215,0,1.035e+14,17.0775,608.346,24215,28,23,24141,24139,23848,23849,22517
20397,35,40,20175,222,20385,12,9.77306e+13,19.3891,520.959,20397,24,23,20357,20357,20152,20152,20147
37821,61,2112,11737,26084,0,37821,3.17379e+13,617.309,6226.39,37821,431,335,28154,21887,16807,6251,4724
9733,1144,1435,5426,4307,0,9733,3.84983e+18,230.358,2932.65,9733,316,201,8298,8291,8235,8205,7887
18419,130,251,0,18419,18075,344,2.64187e+16,122.8,1549.05,18419,81,84,18142,18009,16630,16792,12717
25273,1333,2394,15233,10040,15233,10040,1.84243e+18,655.126,5867.5,25273,451,348,22879,22404,20122,19425,15171
15651,971,1810,13905,1746,9267,6384,2.05516e+18,835.426,4289.88,15651,320,297,13380,11426,11921,11842,10475
27760,886,2664,27760,0,24834,2926,2.3282e+18,808.43,6360.62,27760,471,345,24903,23458,20655,18652,12433
34473,1917,3532,34473,0,31171,3302,1.65387e+18,987.074,8429.56,34473,477,538,30941,30484,26389,25177,20297
20634,792,1887,18559,2075,11959,8675,2.01988e+18,1100.13,5082.44,20634,394,314,17499,15981,13882,13554,10225
22578,621,2354,13141,9437,13141,9437,1.87266e+18,670.999,5464.46,22578,391,366,19871,18989,17166,15454,8733
32301,1490,2311,32301,0,28056,4245,2.93794e+18,855.589,6470.87,32301,350,392,29990,29684,28417,27228,22769
14799,847,1729,0,14799,0,14799,2.01829e+18,430.765,3755.56,14799,287,235,13070,12752,12383,11669,6366
47535,1777,3231,0,47535,0,47535,2.38902e+18,890.65,8456.64,47535,436,584,44304,43879,40175,33946,31449
10714,7,26,10610,104,10714,0,9.68903e+13,15.6033,322.531,10714,18,19,10485,10368,9039,8946,6399
26328,1898,3548,23410,2918,15871,10457,1.97419e+18,961.316,7580.49,26328,471,409,22780,21997,20146,19622,15486
41283,1333,1777,11570,29713,0,41283,3.65331e+13,833.336,6238.3,41283,600,342,39506,39301,38486,38533,36289
4995,1062,1354,4995,0,4501,494,2.11959e+18,235.437,2213.71,4995,228,171,3641,3638,3618,3623,3284
19314,352,675,19303,11,19314,0,4.02766e+18,308.552,2548.29,19314,173,174,18603,18289,15675,15515,14331
20430,1412,1900,12019,8411,0,20430,4.92866e+18,650.393,4527.22,20430,333,272,18530,18064,18293,18227,15951
31692,2969,3501,0,31692,0,31692,2.26449e+18,490.769,7914.04,31692,570,308,28191,28182,27991,28029,26506
24812,328,1771,0,24812,7240,17572,9.26993e+15,466.193,4847.98,24812,360,306,22476,20829,14083,13802,6048
38985,77,302,0,38985,38267,718,2.63925e+16,138.963,2321.94,38985,114,125,38154,37444,31371,29022,19605
49092,525,3038,0,49092,0,49092,2.44464e+18,980.751,8976.82,49092,554,436,43005,39678,26030,25288,12451
27312,1787,2295,24307,3005,16970,10342,1.92984e+18,846.987,6223.74,27312,360,366,25017,25011,24233,24228,21344
37805,787,867,37487,318,37805,0,4.08112e+18,333.405,3687.82,37805,204,221,36938,36936,36571,36694,36119
26349,212,292,0,26349,25942,407,2.61223e+16,114.587,1904.35,26349,91,104,26057,26043,25530,25425,24228
22346,212,219,0,22346,22054,292,2.51264e+16,99.1078,1420.29,22346,73,72,22127,22127,22123,22113,22032
10546,124,401,10546,0,10546,0,3.81613e+18,237.909,1613.1,10546,135,131,9160,7705,6174,5767,4401
31997,747,2409,18465,13532,0,31997,4.68761e+18,851.822,6583.02,31997,389,375,28996,26965,23762,23746,14104
33764,721,2686,0,33764,0,33764,2.30461e+18,740.751,7085.1,33764,362,442,30420,27522,24570,21504,12070
38351,15,345,0,38351,37562,789,2.53502e+16,140.113,2534.67,38351,106,117,35032,33451,28954,23369,14244
21805,1520,3320,21805,0,19562,2243,1.1427e+18,768.413,6610.91,21805,396,323,18485,17957,17322,16804,12555
37306,3185,4654,37306,0,33682,3624,2.00076e+18,1009.67,9842.1,37306,407,524,32652,32614,31757,31075,25272
12873,918,1203,0,12873,3760,9113,9.11964e+15,349.624,3055.43,12873,230,197,11670,11654,11403,11386,9924
42364,515,3459,0,42364,0,42364,2.30692e+18,1037.82,9023.9,42364,498,438,36848,33912,21896,19828,7409
40049,145,324,0,40049,39353,696,2.49267e+16,153.853,2371.75,40049,105,116,39653,39390,35564,33840,26975
1849,437,663,1849,0,1676,173,1.81793e+18,167.426,984.364,1849,99,105,1186,1029,1127,1137,960
21452,71,726,21452,0,21452,0,4.10629e+18,316.068,2742.86,21452,175,188,16569,11598,9144,7981,3890
27736,2499,2733,0,27736,0,27736,2.39498e+18,695.201,6570.34,27736,422,355,25003,24991,24689,24353,24004
26333,6,8,24688,1645,26221,112,0.000265826,0.999696,436.585,26333,8,1,26325,26325,26325,26325,26325
9257,529,656,0,9257,2870,6387,9.33432e+15,295.143,1850.85,9257,174,173,8601,8600,8443,8472,8139
16610,487,1138,5210,11400,0,16610,3.53152e+13,445.272,3428.24,16610,270,277,15309,14378,12415,12396,9655
44759,1412,3632,26731,18028,26731,18028,1.82158e+18,1246.81,9501.84,44759,535,609,40766,39637,37972,37790,21650
6759,18,32,6569,190,6759,0,1.02029e+14,14.769,277.628,6759,18,18,6726,6716,6279,6222,4171
34320,270,2711,20930,13390,0,34320,4.80804e+18,664.9,7150.82,34320,403,436,27435,22605,17206,14461,4936
48566,457,1163,48566,0,48566,0,3.9983e+18,381.423,4484.87,48566,231,229,47402,46995,36861,35591,33141
10707,172,463,10707,0,10707,0,4.32097e+18,237.251,1700.1,10707,144,131,9747,8636,6797,6625,4498
37435,75,92,36834,601,37435,0,1.05199e+14,18.8158,799.781,37435,29,30,37343,37343,37084,37086,36024
42148,313,766,42148,0,42148,0,4.05609e+18,342.133,3744.42,42148,211,223,41188,40385,30777,30230,27931
37088,814,3142,0,37088,0,37088,2.21065e+18,898.657,7943.03,37088,394,476,33235,31542,27604,23379,13736
17966,1074,4096,17966,0,17966,0,8.60838e+15,3162.17,8565.46,17966,4096,5,4292,0,2147,4080,4292
26523,41,64,26002,521,26523,0,1.03981e+14,17.6224,701.127,26523,27,29,26459,26459,25789,25831,23554
33241,707,2415,0,33241,0,33241,2.4201e+18,1166.81,6750.48,33241,475,387,28804,26380,20980,18526,7479
20389,1773,2394,11765,8624,11765,8624,1.77001e+18,810.848,5397.39,20389,372,410,17995,17711,17628,17500,16462
12119,1305,2161,0,12119,0,12119,2.37052e+18,410.075,4097.44,12119,263,243,9958,9893,9574,9726,7032
26487,2309,2616,0,26487,0,26487,2.341e+18,615.665,6409.15,26487,364,418,23871,23857,23740,23787,22219
19811,1818,2694,17751,2060,12155,7656,1.99258e+18,779.887,5566.62,19811,387,316,17117,16758,16687,16778,14834
39855,680,977,39855,0,39855,0,4.3152e+18,356.726,3956.19,39855,231,231,38878,38859,37473,37390,37135
21082,482,689,21082,0,21082,0,4.31438e+18,287.703,2674.83,21082,183,174,20393,20379,19047,19126,18056
42118,4282,5130,42118,0,37624,4494,2.29024e+18,1288.24,10882.5,42118,594,570,36988,36952,36528,36450,34997
28215,691,2864,25400,2815,17317,10898,1.97697e+18,689.759,6909.9,28215,308,422,24728,23529,16602,15407,8521
21615,150,2431,21615,0,19015,2600,1.68769e+18,1032.67,5778.13,21615,366,367,13620,10509,6632,5615,2007
47326,3044,3249,28696,18630,28696,18630,1.91879e+18,1125.85,9000.22,47326,686,452,44077,44042,44020,44039,43583
17392,1162,1174,0,17392,4994,12398,9.379e+15,569.461,3474.68,17392,377,284,16218,16218,16218,16218,16214
37796,3660,4396,0,37796,0,37796,2.42353e+18,1032.79,9825.81,37796,483,623,33400,33390,33040,33060,30099
3145,60,129,0,3145,3075,70,2.6509e+16,35.648,457.067,3145,43,40,3016,2996,2875,2829,2086
15871,1438,1877,0,15871,0,15871,2.367e+18,644.384,4430.51,15871,271,307,13994,13982,13830,13934,12633
46229,2178,2197,0,46229,14123,32106,8.47082e+15,702.985,7194.48,46229,411,494,44032,44032,44032,44032,44009
46119,65,68,44909,1210,46098,21,1.0035e+14,18.7207,777.352,46119,27,30,46051,46051,45900,45900,45905
13353,467,1144,4106,9247,0,13353,3.51894e+13,313.596,3000.54,13353,224,226,12209,11739,11066,11113,8562
34690,2795,3395,20830,13860,0,34690,4.65093e+18,818.818,8071.58,34690,432,491,31295,31251,30802,30778,28257
40758,493,3440,24093,16665,0,40758,4.47324e+18,740.295,8250.33,40758,472,394,36426,34327,18005,17155,10883
32118,3871,4713,32118,0,28428,3690,1.3897e+18,1137.91,9646.18,32118,555,709,27405,27213,26751,26627,24074
22186,16,48,21910,276,22186,0,9.94667e+13,17.7342,511.172,22186,23,26,22117,22083,20040,19896,16134
39970,673,985,39970,0,39970,0,4.19566e+18,396.151,3981.78,39970,230,236,38985,38953,36765,36845,35936
5708,472,817,3388,2320,3388,2320,1.76605e+18,280.782,1719.22,5708,198,137,4891,4785,4767,4728,4343
47215,812,2353,0,47215,13238,33977,9.67144e+15,764.283,7630.99,47215,411,456,44523,43307,40663,41235,18876
15822,466,1601,0,15822,4784,11038,9.31983e+15,457.168,3946.71,15822,343,282,14042,13160,10875,10956,7173
29313,1444,2015,0,29313,8752,20561,9.31919e+15,608.784,5708.76,29313,458,382,27298,27248,26662,26709,25276
35450,64,70,34769,681,35450,0,1.05389e+14,23.155,789.373,35450,30,29,35380,35380,35314,35315,35022
26795,1302,3509,0,26795,0,26795,2.43976e+18,696.108,7293.41,26795,482,466,23286,22634,19913,18665,11471
49828,1184,2233,15364,34464,0,49828,3.52869e+13,950.448,7462.87,49828,572,457,47313,46459,42233,42231,35962
845,5,13,827,18,845,0,8.361e+13,9.06272,78.9757,845,11,11,788,758,724,717,625
23558,634,655,23558,0,23558,0,4.32054e+18,325.434,2783.41,23558,180,193,22903,22903,22896,22892,22875
39648,106,990,39648,0,39648,0,3.9521e+18,371.658,3936,39648,227,220,33391,27330,19144,17420,7730
39031,1735,2030,12336,26695,0,39031,3.25181e+13,503.232,6229.58,39031,417,410,37001,36981,36733,36731,35431
34975,141,949,34975,0,34975,0,4.08476e+18,367.775,3718.97,34975,208,216,31216,26980,17062,15705,9247
15616,133,2405,9465,6151,0,15616,4.9382e+18,512.508,4850.48,15616,296,323,10895,9242,7138,6193,1083
42251,269,362,0,42251,41589,662,2.57969e+16,135.603,2569.95,42251,119,115,41889,41875,40934,40713,38538
26849,1597,1679,0,26849,25171,1678,0.0624977,0.937465,6713.83,26849,1679,1,25170,25170,25170,25170,25170
22617,2022,2602,22617,0,20484,2133,2.6094e+18,890.449,5857.52,22617,384,292,20015,19943,19910,19760,18420
3802,106,861,2209,1593,0,3802,4.41158e+18,203.394,1558.35,3802,220,131,2498,2021,1442,1098,617
39292,2244,2787,23782,15510,0,39292,4.8461e+18,1120.52,7775.79,39292,423,427,36505,36104,35661,35460,33058
46371,1061,2285,0,46371,14075,32296,9.44053e+15,776.344,7092.48,46371,434,432,44061,43273,39676,39976,32276
36585,358,3470,33095,3490,21697,14888,1.8695e+18,815.747,8512.09,36585,467,462,29021,24050,12061,11718,5271
44472,120,3856,39766,4706,27568,16904,1.93564e+18,1308.01,9602.85,44472,525,546,28077,22387,13079,11491,2848
48213,665,3589,29026,19187,0,48213,4.91452e+18,1009.61,9614.44,48213,470,557,43164,40575,34573,33118,15665
608,60,183,0,608,173,435,1.11417e+16,31.4309,269.835,608,46,41,425,391,362,372,261
48373,733,1181,48373,0,48373,0,4.07359e+18,375.481,4521.3,48373,242,232,47192,47157,41700,41445,37636
49012,2181,2332,0,49012,14725,34287,9.36354e+15,646.976,6928.21,49012,377,368,46680,46674,46622,46638,46156
39294,26906,39294,39294,0,39294,0,1.75917e+13,0,39294,39294,39294,1,0,0,0,0,0
44421,563,4035,44421,0,39747,4674,2.14903e+18,1241.06,10268.7,44421,539,487,37323,33323,16225,11290,5218
17698,1818,2483,10530,7168,0,17698,4.78122e+18,380.126,5126.64,17698,328,313,15215,15202,14980,15016,13024
4898,132,586,3019,1879,3019,1879,1.8673e+18,299.835,1396.23,4898,135,149,3429,2705,2136,1999,1372
14778,13,41,14540,238,14767,11,1.04796e+14,15.4792,418.447,14778,21,21,14714,14673,13311,12942,9282
2632,67,548,0,2632,718,1914,9.96637e+15,102.458,982.173,2632,129,112,1939,1694,1342,1287,424
10740,462,1400,6372,4368,0,10740,4.88215e+18,511.049,3095.76,10740,256,212,9044,8333,6994,7236,4219
25341,608,2019,0,25341,8084,17257,8.57872e+15,385.056,5418.93,25341,428,284,23322,22818,18691,18637,10630
42810,275,2880,24840,17970,24840,17970,1.69218e+18,1194.6,8232.38,42810,453,519,34833,30413,18967,15408,5900
49689,3098,3177,0,49689,15837,33852,8.57224e+15,743.439,9309.51,49689,539,431,46512,46512,46495,46491,46239
23547,413,2078,0,23547,7066,16481,9.12608e+15,554.253,5367.12,23547,430,337,20950,19743,13619,11476,4890
11284,430,1287,0,11284,0,11284,2.02307e+18,223.107,2907.29,11284,183,251,9997,9781,9367,9200,3635
6967,425,1659,4172,2795,4172,2795,1.91643e+18,237.194,2801.34,6967,185,313,5308,4827,4692,4753,1748
15496,339,1008,0,15496,4871,10625,8.82769e+15,330.817,2995.81,15496,229,230,14154,12994,10129,10221,4685
48595,356,2856,0,48595,14837,33758,9.04741e+15,611.777,8652.17,48595,579,421,44368,41439,25920,22987,10269
18090,693,709,18090,0,18090,0,4.05587e+18,322.637,2559.7,18090,187,170,17381,17381,17375,17375,17353
18761,1008,2355,18761,0,16934,1827,2.50688e+18,499.919,4825.57,18761,328,349,16406,15778,14215,14006,10262
4024,667,948,2429,1595,0,4024,4.87138e+18,172.65,1645.58,4024,217,152,3076,3071,2949,2836,2487
43260,613,3539,39145,4115,24503,18757,1.90443e+18,1672.66,8996.44,43260,486,494,36875,34339,21114,20030,11348
20957,909,1944,18513,2444,12438,8519,1.9544e+18,913.822,4996.35,20957,293,306,18587,17758,15385,15367,9009
17612,240,1482,5337,12275,0,17612,3.69797e+13,561.783,3977.27,17612,316,331,15039,13441,10220,10037,4288
15545,969,2093,0,15545,0,15545,2.40695e+18,515.893,4441.65,15545,329,320,13452,13177,12289,11271,10077
7452,264,1313,4148,3304,0,7452,4.33326e+18,175.542,2524.77,7452,179,243,6107,5689,5293,5119,2309
16021,2240,3165,16021,0,14430,1591,1.61742e+18,355.259,5809.49,16021,238,514,12856,12844,12523,12657,10195
18309,1859,2236,11080,7229,11080,7229,1.88669e+18,412.445,4823.42,18309,261,370,16073,16052,15922,15945,14709
40781,1275,2800,0,40781,0,40781,2.28512e+18,701.451,7425.46,40781,385,469,37981,37476,32201,24479,18528
2521,120,878,2213,308,1546,975,2.00525e+18,109.892,1289.35,2521,173,129,1569,1287,824,802,308
13558,1046,2022,11989,1569,7952,5606,1.96067e+18,623.643,4100.72,13558,261,251,11536,10995,10919,10951,7276
31671,62,70,31110,561,31671,0,1.05086e+14,24.2644,649.356,31671,28,30,31601,31601,31234,31234,30993
6502,376,1580,3824,2678,0,6502,4.77284e+18,274.757,2676.78,6502,188,341,4905,4355,3926,3962,1189
41780,28833,41780,41780,0,0,41780,268429000,0,41780,41780,41780,1,0,0,0,0,0
3084,514,765,3084,0,2879,205,2.87721e+18,177.203,1319.21,3084,125,96,2319,2301,2230,2199,2118
24832,459,1332,7923,16909,0,24832,3.51854e+13,518.412,4264.95,24832,322,327,23010,21671,19117,19149,11486
23658,37,711,23608,50,23658,0,4.2488e+18,286.868,2835.72,23658,177,185,15027,9160,6521,5997,2772
25934,2654,3105,14934,11000,0,25934,4.48328e+18,892.608,6935.22,25934,415,457,22829,22583,22662,22667,21127
35423,12,303,0,35423,34582,841,2.47665e+16,144.755,2121.04,35423,98,106,31856,29867,26250,21583,12862
46132,1261,4302,41340,4792,27423,18709,1.97523e+18,1171.34,10639.4,46132,531,614,41012,39230,33124,32336,13412
46510,283,302,0,46510,45658,852,2.54224e+16,147.611,2619.95,46510,115,118,46208,46208,46196,46119,45975
32954,1659,2294,10233,22721,0,32954,3.49008e+13,870.183,6443.72,32954,465,522,30660,30216,29783,29813,27272
10511,617,1644,6405,4106,0,10511,4.6854e+18,362.574,3356.84,10511,322,176,8867,8416,7423,7108,5160
31582,29,64,31012,570,31582,0,1.01585e+14,18.8195,721.947,31582,28,28,31518,31511,29553,29491,22733
22082,2059,2345,13604,8478,13604,8478,1.81848e+18,475.074,5339.65,22082,382,297,19737,19737,19554,19625,18703
27025,1773,2748,27025,0,23706,3319,1.42013e+18,1073.85,6632.2,27025,427,365,24277,23420,23504,23201,19067
38673,1754,3132,34005,4668,23344,15329,1.95099e+18,1039.2,8462.31,38673,469,462,35541,35319,30078,29911,21434
21461,1660,1990,0,21461,5736,15725,9.85814e+15,491.234,5020.17,21461,367,365,19471,19469,19379,19361,18484
772,68,185,772,0,772,0,4.67628e+18,66.1723,332.999,772,45,47,566,473,367,347,284
38983,1602,2158,12252,26731,0,38983,3.51952e+13,657.423,6660.61,38983,409,439,36825,36802,36493,36561,33786
16523,703,1638,9878,6645,0,16523,4.72646e+18,719.733,3992.13,16523,319,263,14486,13577,12737,12403,7677
41694,2799,2980,11935,29759,0,41694,3.71405e+13,675.859,8545.14,41694,471,699,38714,38714,38652,38648,37771
37301,775,3919,22454,14847,0,37301,4.61293e+18,1227.64,9306.98,37301,574,750,32163,29522,21551,19848,8976
16926,604,1339,0,16926,5159,11767,8.65759e+15,236.843,3573.72,16926,229,254,15587,15450,14768,14822,8573
8324,6,26,8193,131,8324,0,1.02053e+14,11.8706,286.594,8324,17,17,8072,7769,7112,7043,5335
13730,32,548,13730,0,13730,0,3.90581e+18,289.896,2032.87,13730,153,150,8623,5621,4383,4218,1338
40591,612,2786,36391,4200,24250,16341,1.97305e+18,1337.3,8067.75,40591,476,414,34580,30589,20633,18382,11413
2423,304,591,0,2423,762,1661,8.83715e+15,108.468,1038.86,2423,118,107,1832,1745,1697,1703,1078
8406,294,1339,0,8406,0,8406,2.35348e+18,362.086,2678.46,8406,235,176,6530,5269,4089,3922,2361
39325,1979,2103,0,39325,12457,26868,8.02637e+15,678.888,6414.66,39325,403,368,37222,37194,37199,37196,36728
35949,91,283,0,35949,35467,482,2.6625e+16,143.031,2065.21,35949,93,116,35439,34987,31063,28260,21211
49323,2769,2842,49323,0,44656,4667,1.89315e+18,1387.87,8398.69,49323,448,434,46481,46474,46479,46481,46189
40540,1986,3351,0,40540,0,40540,2.32399e+18,1018.27,8598.2,40540,507,498,37189,36527,34485,31802,26586
14521,270,1041,4313,10208,0,14521,3.6572e+13,415.857,2998.23,14521,291,212,12670,11620,9444,9481,5449
29160,8,79,28578,582,29160,0,1.00466e+14,18.095,680.78,29160,28,30,28629,28372,25214,24526,13955
27319,5,254,0,27319,26852,467,2.55561e+16,107.994,1697.54,27319,85,105,21567,18775,17447,15081,9402
36560,318,1846,0,36560,11979,24581,8.62043e+15,734.362,5953.46,36560,463,422,32659,29811,17601,17411,8994
13263,1176,1886,7936,5327,7936,5327,1.94533e+18,379.387,3909.02,13263,306,225,11377,11289,11126,11196,9261
21581,1734,2326,21581,0,19154,2427,2.4355e+18,972.232,5541.45,21581,377,342,19255,18394,18151,18092,16891
24567,4213,4633,22056,2511,14912,9655,1.96979e+18,694.893,8494.23,24567,307,623,19934,19913,19872,19864,19266
42158,380,3330,25128,17030,0,42158,4.68854e+18,883.002,9031.26,42158,484,488,34885,30123,18900,14761,6759
37763,62,70,37193,570,37763,0,9.7659e+13,19.9415,741.882,37763,27,29,37693,37693,37098,37098,35779
2765,527,692,0,2765,0,2765,2.1753e+18,137.121,1215.68,2765,98,148,2073,2031,2043,2069,1708
10694,1830,1935,0,10694,0,10694,2.31878e+18,459.999,3725.39,10694,297,356,8759,8759,8757,8758,8639
32627,209,316,0,32627,32067,560,2.63102e+16,142.624,2101.17,32627,103,103,32311,32254,31029,30578,27800
40750,3684,3846,0,40750,0,40750,2.4367e+18,986.974,9249.92,40750,465,411,36904,36904,36869,36858,36702
25877,642,2239,15630,10247,0,25877,4.76107e+18,753.602,5866.74,25877,315,400,22670,20502,14916,13521,11237
1108,263,424,0,1108,0,1108,2.61475e+18,42.9179,599.995,1108,76,74,684,669,653,670,497
1958,18,120,0,1958,1923,35,2.74173e+16,34.0557,338.652,1958,40,34,1776,1694,1470,1377,839
14619,1407,1825,0,14619,0,14619,1.98263e+18,333.318,3842.29,14619,266,252,12794,12763,12531,12427,11463
1049,341,371,368,681,0,1049,3.10033e+13,30.5596,551.804,1049,103,65,678,678,678,678,651
13074,1443,1790,0,13074,0,13074,2.24514e+18,574.859,3872.76,13074,314,292,11284,11277,11200,10923,10815
889,305,328,555,334,555,334,1.67223e+18,50.982,480.114,889,76,60,561,561,561,561,536
5511,1347,1368,4721,790,3241,2270,2.03514e+18,281.007,2311.09,5511,216,170,4143,4143,4143,4143,4122
24088,957,1795,6553,17535,0,24088,3.78059e+13,564.387,4947.57,24088,410,310,22293,21768,21372,21406,17193
24015,1408,1773,14381,9634,14381,9634,1.86071e+18,912.501,5108.25,24015,409,360,22242,20992,21474,21257,19552
2183,225,550,0,2183,0,2183,2.24821e+18,112.271,963.443,2183,132,95,1633,1534,1105,1032,936
9790,618,1434,3101,6689,0,9790,3.51689e+13,251.42,3070.72,9790,270,271,8356,8215,7409,7478,4350
28005,694,2195,17084,10921,0,28005,4.67202e+18,923.067,5920.57,28005,415,439,24481,21316,15438,13514,13513
3585,875,1242,3585,0,3175,410,2.07913e+18,184.608,1873.12,3585,159,203,2343,2340,2198,2211,1902
2106,114,732,0,2106,0,2106,2.21258e+18,117.208,1088.65,2106,120,103,1305,1047,793,573,417
22476,3025,3076,22476,0,20197,2279,2.06691e+18,761.898,6397.79,22476,395,452,19400,19400,19395,19395,19358
9456,17,30,9343,113,9426,30,1.06e+14,16.8944,352.712,9456,19,21,9413,9394,8893,8918,7477
18588,1875,2516,11257,7331,0,18588,4.89761e+18,832.344,5383.01,18588,331,359,16072,15474,15726,15758,13601
11247,641,1274,0,11247,3266,7981,9.36712e+15,334.703,2991.63,11247,207,265,9973,9824,9470,9461,6443
38429,2203,3609,22829,15600,0,38429,4.99955e+18,1022.96,8835.26,38429,417,578,34820,34307,33742,33591,24912
20029,1534,2131,11946,8083,0,20029,4.59637e+18,409.239,5067.34,20029,226,381,17898,17898,17729,17743,15613
29206,191,771,29200,6,29206,0,4.19412e+18,315.836,3199.26,29206,187,201,27550,25881,15827,14351,9781
34388,878,4444,34388,0,30570,3818,1.47303e+18,936.755,9605.26,34388,496,680,29073,27004,21289,20323,11274
47236,1390,4048,27920,19316,0,47236,4.96384e+18,950.992,10396.8,47236,460,665,42884,41347,40062,39503,15723
39016,3706,4177,0,39016,0,39016,2.43422e+18,961.394,9453.62,39016,471,563,34839,34836,34712,34797,33713
15763,918,1707,9375,6388,0,15763,4.85356e+18,810.751,4078.38,15763,322,288,13666,12944,12866,12669,9521
34641,123,4096,34641,0,30860,3781,1.9801e+18,1054.45,8951.56,34641,416,464,22421,17241,7819,2956,1267
28141,2446,2449,15660,12481,15660,12481,1.6156e+18,1018.2,6083.46,28141,377,373,25692,25692,25692,25692,25692
35642,209,2692,19815,15827,19815,15827,1.78765e+18,1209.1,7598.92,35642,437,510,28647,25460,19212,14755,4085
25839,692,2272,0,25839,0,25839,2.4395e+18,828.81,5811.03,25839,391,333,22297,20132,15556,11953,6628
45929,177,2365,14335,31594,0,45929,3.49485e+13,623.904,7606.83,45929,535,398,38320,33890,24256,10775,6691
17209,233,559,17209,0,17209,0,4.36207e+18,305.543,2310.06,17209,158,164,16385,15504,10953,10690,9170
5237,135,863,1363,3874,0,5237,3.79239e+13,162.607,1675.92,5237,168,143,4237,3833,3429,3420,1188
24967,32,37,24586,381,24967,0,1.00338e+14,19.2464,533.959,24967,24,23,24930,24930,24409,24409,23638
43923,1974,2892,13440,30483,0,43923,3.63148e+13,615.531,8244.17,43923,590,423,41031,40928,40313,40301,34848
39504,188,325,0,39504,38666,838,2.60549e+16,153.639,2339.13,39504,103,116,39179,39062,36639,36348,30440
8185,6,20,8122,63,8185,0,9.65993e+13,10.7459,261.892,8185,15,16,7960,7730,6972,6924,4966
21077,1726,2477,0,21077,0,21077,2.41191e+18,668.347,5548.4,21077,354,356,18600,18591,18192,18195,14768
36043,2031,2605,0,36043,0,36043,2.41686e+18,925.18,7237.97,36043,394,420,33438,33076,32879,32939,29488
12359,123,1159,4073,8286,0,12359,3.28813e+13,324.044,3025.38,12359,254,220,9929,8604,5890,3209,2860
23628,795,2790,21086,2542,14459,9169,1.92157e+18,1273.77,6544.97,23628,409,550,19319,16614,12594,12432,9183
46495,420,2217,14597,31898,0,46495,3.38467e+13,543.45,7122.16,46495,368,378,43631,41695,26683,26004,15107
42723,102,1161,42723,0,42723,0,4.03505e+18,409.05,4299.6,42723,240,228,35472,27936,20178,18512,6165
37935,718,2201,21789,16146,0,37935,4.46038e+18,1156.67,6745.81,37935,397,418,34023,31589,27910,27159,15327
9183,876,985,2710,6473,0,9183,3.59014e+13,235.325,2365.37,9183,211,185,8198,8198,8151,8152,7847
10213,452,464,10213,0,10213,0,4.2206e+18,244.06,1726.04,10213,135,140,9749,9749,9742,9741,9721
39211,1004,3410,22985,16226,0,39211,4.57958e+18,1060.3,8728.84,39211,453,602,35048,34023,29629,29038,11113
26639,59,247,0,26639,26212,427,2.56783e+16,121.182,1605.35,26639,82,91,26031,25495,22691,20863,14679
20406,1211,1343,6536,13870,0,20406,3.22666e+13,411.86,3793.63,20406,293,251,19063,19059,18905,18908,18665
28803,384,826,28749,54,28778,25,4.07417e+18,331.694,3244.75,28803,198,198,27977,27693,22606,22419,22116
6762,460,1084,2085,4677,0,6762,3.56602e+13,198.867,2234.71,6762,166,185,5678,5490,4961,5001,2664
45779,1970,3672,27010,18769,0,45779,4.77453e+18,874.066,9413.9,45779,461,703,42107,41583,39711,38890,28968
15979,1788,2593,15979,0,14372,1607,2.3383e+18,522.939,4946.87,15979,309,361,13386,13210,13100,12927,10292
3490,141,295,3490,0,3490,0,4.07346e+18,182.471,853.61,3490,95,86,3042,2709,2418,2352,2028
31095,206,802,31095,0,31095,0,4.06126e+18,359.242,3281.22,31095,205,205,29083,26461,19863,18410,14392
34971,1558,4058,34971,0,31037,3934,1.92088e+18,1043.01,9021.18,34971,506,425,30913,29586,25849,23646,18601
30780,1063,2306,18703,12077,18703,12077,1.86487e+18,623.26,5758.47,30780,369,458,28474,27899,26456,26286,20426
47696,538,2098,14466,33230,0,47696,3.39266e+13,1021,7290.83,47696,460,405,43723,41659,32809,33365,20005
29745,1414,2117,18586,11159,0,29745,4.81474e+18,545.914,5575.37,29745,331,372,27628,27622,25601,24993,23794
8871,60,851,0,8871,2826,6045,8.19693e+15,253.902,2184.43,8871,226,196,6288,5103,3928,3746,1223
33408,2088,2618,29836,3572,19862,13546,1.97623e+18,1448.18,7232,33408,495,390,30790,29433,29709,29639,27477
11223,133,469,11223,0,11223,0,4.22043e+18,264.77,1794.09,11223,136,139,9973,8664,6575,6208,4000
46686,1415,2497,12870,33816,0,46686,3.7388e+13,950.268,8170.42,46686,653,394,44099,43271,41077,41227,29586
12514,642,999,4061,8453,0,12514,3.08548e+13,212.421,2587.12,12514,246,158,11515,11480,11123,11153,10306
36380,377,1855,11627,24753,0,36380,3.49933e+13,433.085,5619.19,36380,364,324,33894,30514,21397,17656,14997
47225,1908,2357,0,47225,14421,32804,9.46657e+15,843.228,7949,47225,498,566,44868,44866,44595,44564,41763
44538,718,1994,12394,32144,0,44538,3.69409e+13,767.984,6943.77,44538,492,347,42129,41234,37518,37518,21136
16745,630,1551,9950,6795,0,16745,4.98732e+18,566.959,3847.15,16745,302,321,15032,14367,13010,12605,10253
1398,144,268,1398,0,1398,0,4.6355e+18,98.8269,525.193,1398,63,60,1123,1001,902,900,773
43984,4,50,43446,538,43978,6,1.01074e+14,20.9839,790.893,43984,24,25,40144,37861,34921,34785,22862
38783,239,3905,38758,25,34638,4145,1.61793e+18,795.424,9021.61,38783,443,389,29089,23546,13444,10344,5208
7469,16,22,7360,109,7469,0,9.68527e+13,14.2484,260.595,7469,18,17,7444,7440,7130,7128,6947
19653,202,265,0,19653,19394,259,2.64795e+16,90.5489,1436.26,19653,77,85,19388,19386,19039,19016,18006
43690,243,778,43679,11,43690,0,4.43354e+18,372.86,3884.83,43690,227,219,42058,40093,25929,24603,19445
28156,2152,2322,0,28156,0,28156,2.11194e+18,720.797,5962.65,28156,332,516,25834,25833,25785,25801,25243
12735,115,214,0,12735,12524,211,2.72841e+16,108.521,1191.54,12735,76,79,12489,12345,11351,11566,9022
31477,850,1665,0,31477,9105,22372,9.43361e+15,669.753,5331.12,31477,392,354,29713,28954,27641,27658,21422
25358,1753,3577,15271,10087,0,25358,4.94559e+18,752.537,7308.31,25358,356,490,21781,21201,20732,20718,14413
31581,1149,2023,9647,21934,0,31581,3.3463e+13,509.363,5932.88,31581,390,398,29558,29512,27948,28012,18705
2981,392,556,1829,1152,0,2981,4.45659e+18,255.777,1100.78,2981,151,113,2425,2092,2245,2136,2069
10107,221,1389,0,10107,3123,6984,9.49067e+15,288.979,3036.35,10107,192,343,8457,7805,6006,5482,2377
39630,9,36,39122,508,39630,0,1.00232e+14,20.1398,632.241,39630,23,22,39332,39181,35274,33528,23438
38291,1590,4511,33861,4430,22461,15830,1.98233e+18,981.826,10103.5,38291,435,643,33780,32396,28420,28236,14413
23520,1242,1438,0,23520,7446,16074,8.05744e+15,509.851,4406.12,23520,333,289,22082,21926,22019,21993,20779
10871,926,1048,3262,7609,0,10871,3.71103e+13,377.043,2625.14,10871,227,227,9823,9780,9697,9708,9465
25188,1103,1448,7788,17400,0,25188,3.59829e+13,531.009,4466.83,25188,326,285,23740,23738,23477,23487,21935
22015,103,1675,12826,9189,0,22015,4.62394e+18,933.881,4751.46,22015,331,331,15730,12772,8540,6725,1839
21706,1193,3213,12847,8859,0,21706,4.72193e+18,638.414,6490.6,21706,420,505,18493,17751,14906,15801,9172
31290,2529,2646,0,31290,0,31290,2.30775e+18,1011.97,6924.05,31290,386,431,28644,28643,28625,28626,28461
42986,290,1060,42961,25,42986,0,4.32672e+18,372.841,4119.61,42986,215,220,41589,40302,25617,24887,22772
36748,389,1857,0,36748,11289,25459,9.20768e+15,512.735,5896.01,36748,596,312,34007,31327,23288,23540,13868
46277,2777,3091,27876,18401,27876,18401,1.88834e+18,1517.11,8991.26,46277,567,525,43186,42532,42899,43051,42312
10101,87,176,0,10101,9890,211,2.53889e+16,109.696,927.313,10101,63,69,9838,9683,8979,9046,7256
38499,198,267,0,38499,37741,758,2.59658e+16,121.401,2037.07,38499,86,95,38232,38199,37344,37015,33601
1303,78,393,433,870,0,1303,3.20841e+13,49.1097,612.315,1303,99,63,906,773,640,654,395
9209,61,2195,9209,0,7904,1305,2.37522e+18,373.503,3788.62,9209,219,279,5045,3503,2291,1624,440
39901,74,266,0,39901,39257,644,2.51925e+16,142.627,2120.03,39901,108,115,39221,38369,33792,31254,21337
8910,100,190,0,8910,8755,155,2.67366e+16,90.6272,910.707,8910,64,67,8699,8581,7920,7984,6389
26380,46,691,26380,0,26380,0,3.9187e+18,320.282,2947.76,26380,193,188,18727,13189,9786,9114,2755
29011,12,62,28469,542,29011,0,1.01264e+14,17.8604,629.345,29011,26,26,28841,28745,25742,25727,14783
978,53,408,0,978,0,978,2.21673e+18,46.7577,574.211,978,89,66,516,376,285,266,135
29886,836,1015,29886,0,29886,0,4.06613e+18,321.002,3550.86,29886,212,214,28871,28869,28445,28422,28095
16961,224,1516,16961,0,15078,1883,1.86027e+18,839.086,4120.23,16961,295,307,11657,8616,5199,4234,3329
7124,13,24,7004,120,7124,0,9.68808e+13,14.6099,261.713,7124,18,18,7086,7069,6511,6505,5833
39692,544,594,39692,0,39642,50,3.88618e+18,393.187,3376.88,39692,207,200,39098,39054,38796,38817,38707
38307,2499,2792,38307,0,34638,3669,1.12151e+18,1255.05,7813.29,38307,438,453,35515,35498,35411,35421,34816
34208,1101,1927,9557,24651,0,34208,3.78483e+13,650.71,5995.64,34208,523,275,32281,31914,30494,30590,26162
6278,910,934,1729,4549,0,6278,3.964e+13,206.614,1943.33,6278,189,199,5344,5344,5343,5343,5308
7332,1102,1353,4267,3065,4267,3065,1.59971e+18,273.924,2621.83,7332,259,187,5979,5942,5919,5932,5019
973,13,249,973,0,973,0,6.18081e+18,60.5868,416.807,973,63,48,510,300,92,108,48
25183,3004,3226,15093,10090,15093,10090,1.80277e+18,737.38,7077.33,25183,420,389,21957,21957,21869,21901,21312
3146,283,901,3146,0,2798,348,3.11004e+18,96.8856,1371.17,3146,135,109,2245,2133,1200,788,533
27548,2664,4547,27548,0,24042,3506,2.36399e+18,678.683,8782.52,27548,548,469,23001,22941,22581,22652,18412
34526,1306,3557,19485,15041,0,34526,4.64141e+18,861.964,8541.77,34526,443,471,30969,29989,21533,19889,13848
20881,919,2116,0,20881,0,20881,2.29906e+18,696.722,5147.13,20881,311,365,18765,17964,15323,11690,10990
37752,1560,2344,0,37752,0,37752,2.2056e+18,647.704,6785.86,37752,422,336,35408,35296,34403,33083,28431
16956,1079,2049,10101,6855,0,16956,4.77229e+18,497.949,4486.08,16956,333,296,14907,14699,13832,13498,8698
16423,214,2089,0,16423,0,16423,2.31656e+18,776.956,4673.46,16423,342,302,12969,11397,8729,7644,2069
24230,2553,2657,14700,9530,14700,9530,1.82668e+18,721.736,6177.34,24230,443,395,21573,21573,21568,21568,21377
7498,567,1316,4360,3138,4360,3138,1.9171e+18,384.6,2563.19,7498,215,228,6150,5765,5510,5211,3631
23086,699,1932,7055,16031,0,23086,3.73935e+13,519.992,5191.34,23086,344,398,20944,20328,17508,16995,11282
9352,12,34,9260,92,9352,0,1.03477e+14,13.8014,331.273,9352,17,21,9278,9227,8514,8481,6711
19869,1378,2338,0,19869,0,19869,2.37066e+18,535.432,5175.17,19869,434,256,17531,17376,16428,15581,13796
21421,91,264,0,21421,21063,358,2.70826e+16,118.234,1591.63,21421,83,95,21028,20741,18811,17359,13295
47916,1540,3583,27575,20341,27575,20341,1.69978e+18,773.519,9384.6,47916,411,601,44333,44117,42528,43083,16042
41469,3291,3508,24703,16766,24703,16766,1.74549e+18,690.234,8324.84,41469,414,375,37961,37961,37910,37927,37509
27121,98,270,0,27121,26563,558,2.5222e+16,134.541,1908.79,27121,94,103,26695,26308,23481,22493,17541
47159,766,1245,47159,0,47159,0,4.3629e+18,454.288,4619.81,47159,246,248,45914,45803,41130,40828,40960
3812,388,1128,3407,405,2243,1569,2.0683e+18,147.2,1738.63,3812,132,187,2684,2443,2336,2340,1460
28430,877,1702,8403,20027,0,28430,3.60347e+13,594.038,5263.61,28430,350,347,26636,25925,24814,24930,17949
24577,1110,1379,0,24577,7597,16980,9.27121e+15,622.355,4360.88,24577,301,338,23198,23034,22978,22940,21778
19915,2317,2579,12018,7897,0,19915,5.02405e+18,700.92,5593.35,19915,412,315,17336,17331,17220,17244,16681
12483,753,804,3850,8633,0,12483,3.42159e+13,321.42,2346.5,12483,194,207,11679,11678,11669,11668,11627
41593,300,4584,41593,0,37185,4408,2.63346e+18,1161.33,10315,41593,465,508,31062,24927,13289,7260,3537
32642,717,745,32622,20,32642,0,4.42717e+18,355.704,3377.41,32642,213,217,31897,31895,31813,31822,31781
33784,3857,4002,33784,0,30494,3290,2.40768e+18,1444.85,8974.29,33784,634,469,29782,29782,29716,29735,29608
32785,501,2079,10031,22754,0,32785,3.66652e+13,539.944,6185.27,32785,344,399,30289,28579,21688,22187,15180
33669,2047,3823,20378,13291,0,33669,4.81852e+18,998.999,8652.8,33669,523,516,29846,28916,27338,26788,18296
35968,1817,3712,21414,14554,21414,14554,1.85336e+18,885.417,8751.15,35968,393,566,32256,31759,30683,31006,20244
39301,6,11,36845,2456,39141,160,0.000254446,0.99972,645.333,39301,11,1,39290,39290,39290,39290,39290
20557,43,65,20183,374,20557,0,1.02447e+14,16.5647,561.839,20557,26,27,20492,20492,19585,19618,16398
6850,1331,1638,3988,2862,0,6850,4.86242e+18,179.98,2811.77,6850,148,347,5212,5210,5151,5174,4483
10092,22,33,9893,199,10092,0,9.76742e+13,14.7511,326.044,10092,19,21,10059,10059,9691,9692,8728
8663,43,176,0,8663,8513,150,2.55775e+16,88.3161,802.032,8663,66,64,8276,8038,7189,6694,4423
32833,197,931,32785,48,32833,0,4.13325e+18,352.253,3579.82,32833,208,214,30531,27648,18462,17740,12568
11850,1298,1964,0,11850,0,11850,2.31593e+18,387.576,3867.6,11850,346,202,9886,9847,9578,9487,8139
13654,88,1292,4452,9202,0,13654,3.42156e+13,236.834,3255.87,13654,184,369,10787,9360,6361,6122,1211
1655,270,366,0,1655,0,1655,1.77779e+18,121.037,705.017,1655,120,73,1289,1289,1144,1152,1061
2473,222,250,0,2473,761,1712,5.34634e+15,117.97,662.202,2473,102,73,2223,2223,2187,2182,2120
37166,59,330,0,37166,36383,783,2.52724e+16,163.853,2332.03,37166,103,125,36043,34946,29574,27314,18000
10096,414,1414,6077,4019,6077,4019,1.92553e+18,378.464,2929.09,10096,284,241,8534,7202,7406,6983,3342
45023,2840,3656,0,45023,0,45023,2.24666e+18,778.661,9240.08,45023,509,391,41367,41248,40992,41122,35404
14659,232,1045,0,14659,4639,10020,9.21548e+15,430.6,3021.06,14659,237,255,12730,11428,10359,10190,4922
10252,257,1828,6152,4100,0,10252,4.92226e+18,275.491,3419.99,10252,268,244,8082,6741,5619,5357,2950
25921,126,251,0,25921,25564,357,2.63785e+16,111.613,1589.99,25921,92,91,25666,25584,23651,23099,19485
44407,20,56,43807,600,44407,0,1.00624e+14,18.2242,761.456,44407,25,30,44342,44313,40763,40356,29327
39051,2470,2608,0,39051,12347,26704,8.73477e+15,747.326,7483.11,39051,399,439,36443,36442,36434,36437,36012
14463,345,1146,3846,10617,0,14463,3.60291e+13,458.105,3117.98,14463,294,248,12913,11952,11178,11259,6574
43972,1632,4302,25967,18005,25967,18005,1.86042e+18,835.649,10378.3,43972,411,669,39670,38900,37228,37561,19817
42921,396,954,42903,18,42921,0,3.9461e+18,360.192,4024.37,42921,237,229,41929,41385,34487,34034,31790
18168,132,240,0,18168,17771,397,2.60817e+16,105.116,1388.63,18168,73,85,17918,17838,16521,16729,14151
14607,3,36,14177,430,14607,0,9.97411e+13,17.624,417.213,14607,23,23,12075,10765,10647,10427,6460
37148,423,642,37148,0,37148,0,4.18765e+18,338.447,3319.54,37148,213,212,36506,36383,32595,32676,31359
7179,294,1773,7179,0,6456,723,2.63342e+18,315.38,2984.09,7179,243,219,5081,4096,2237,1944,1047
7257,582,1413,4049,3208,0,7257,4.43712e+18,178.522,2513.67,7257,239,135,5844,5761,5522,5288,3863
27745,777,2777,0,27745,0,27745,2.31489e+18,580.078,6620.32,27745,343,344,24917,24345,16764,15655,8050
29043,128,1958,0,29043,8775,20268,8.81132e+15,631.786,5488.89,29043,409,314,24794,22558,14952,13370,4898
46559,57,821,46559,0,46559,0,3.96688e+18,376.262,4009.98,46559,229,222,34224,23919,18236,16263,4806
18784,293,1278,0,18784,5119,13665,9.20186e+15,595.512,3679.67,18784,315,240,16629,15161,14160,14378,6555
13353,143,198,0,13353,13000,353,2.65394e+16,104.441,1074,13353,68,69,13155,13122,12756,12692,12078
9533,420,760,3050,6483,0,9533,2.72557e+13,169.808,1946.46,9533,200,156,8773,8667,8378,8392,7420
24792,24,273,0,24792,24331,461,2.67862e+16,127.975,1845.78,24792,93,96,23248,22359,18852,15790,9240
11396,1287,1596,11396,0,10220,1176,3.10818e+18,477.024,3461.24,11396,293,199,9800,9796,9756,9735,9345
4182,233,298,1392,2790,0,4182,2.3859e+13,101.962,848.148,4182,94,92,3884,3878,3855,3874,3593
957,9,18,937,20,957,0,1.33532e+14,7.82759,96.9671,957,11,9,937,931,814,814,569
12086,88,1062,0,12086,3598,8488,9.19005e+15,264.879,2659.34,12086,242,173,9084,7729,6456,5748,1838
28847,55,64,28376,471,28847,0,1.02171e+14,18.959,673.014,28847,27,27,28783,28783,28294,28294,26167
41830,221,310,0,41830,40938,892,2.60273e+16,133.754,2345.03,41830,113,103,41520,41491,40282,40191,37734
970,268,411,0,970,0,970,1.4557e+18,65.3526,588.429,970,109,46,559,550,429,388,358
33893,1161,2813,20002,13891,0,33893,4.88003e+18,562.714,7174.7,33893,366,450,31080,30749,29673,28948,20726
48485,1994,2170,0,48485,15211,33274,8.82297e+15,809.13,7103.62,48485,440,410,46315,46315,46134,46120,45916
27063,746,1698,17161,9902,17161,9902,1.85633e+18,506.808,5017.17,27063,305,267,25365,25254,20694,19806,11542
25655,235,1761,0,25655,7533,18122,9.60867e+15,588.79,5019.84,25655,383,314,22421,19859,16315,15428,7023
10557,1558,1729,6327,4230,0,10557,4.86415e+18,390.975,3354.46,10557,289,250,8828,8827,8799,8807,8613
21292,1242,1273,0,21292,6380,14912,9.48604e+15,538.182,3889.14,21292,327,294,20019,20019,20013,20012,19996
14783,462,1839,8720,6063,8720,6063,1.70997e+18,407.746,3908.16,14783,233,282,12874,12085,11085,10071,6021
12051,780,1604,7231,4820,0,12051,4.77362e+18,332.249,3381.55,12051,218,239,10447,10405,9226,8910,4782
1704,405,589,0,1704,0,1704,2.3281e+18,91.2482,896.722,1704,90,129,1115,1103,1104,1104,940
19324,713,2324,11677,7647,11677,7647,1.83438e+18,583.059,5257.17,19324,355,343,16777,15967,15062,14086,7504
3940,227,452,3940,0,3940,0,3.92312e+18,175.318,1084.46,3940,91,91,3487,3260,2776,2751,2472
34548,2025,2690,0,34548,0,34548,2.21505e+18,774.569,7198.06,34548,417,375,31858,31729,31639,31747,29699
20909,14,42,20526,383,20666,243,9.82991e+13,17.8229,550.954,20909,22,25,20821,20765,18827,18566,11660
5343,303,1041,3259,2084,3259,2084,1.93319e+18,383.136,1937.89,5343,204,187,4038,3650,3367,3128,1552
9882,766,1392,9882,0,8875,1007,2.53241e+18,463.551,3084.45,9882,233,217,8485,7735,7791,7702,5106
11974,984,1963,7299,4675,0,11974,4.70182e+18,436.884,3882.33,11974,345,229,10011,9759,7777,7819,5261
7141,25,551,7141,0,7141,0,4.41419e+18,225.218,1542.91,7141,117,116,3899,2198,1563,1411,607
37127,1014,1683,11818,25309,0,37127,3.53151e+13,483.801,5158.85,37127,351,311,35444,35277,33262,33343,26662
4958,869,936,2913,2045,0,4958,5.01986e+18,208.724,1813.84,4958,124,216,4022,4022,4010,4012,3974
39420,223,742,39420,0,39420,0,4.16114e+18,344.322,3619.84,39420,218,217,37650,35194,25338,24407,19294
36514,6,317,0,36514,36011,503,2.57138e+16,148.772,2239.11,36514,108,116,29563,25218,23587,20138,12539
14790,26,2546,13232,1558,8940,5850,1.99912e+18,515.278,4841.5,14790,292,374,6953,4388,2813,2459,251
45008,666,3163,0,45008,0,45008,2.35659e+18,880.968,8466.07,45008,516,449,40776,38188,27078,20874,16259
13946,2146,2620,12378,1568,8428,5518,1.96857e+18,634.959,4821.3,13946,297,370,11326,11326,11252,11281,10645
45725,35,59,45157,568,45725,0,1.01214e+14,16.5114,740.142,45725,24,26,45666,45662,43419,43418,31046
24556,1203,1535,0,24556,23021,1535,0.0624695,0.93749,6139.46,24556,1535,1,23021,23021,23021,23021,23021
46272,132,244,0,46272,44860,1412,2.60702e+16,135.268,2077.86,46272,104,102,45916,45635,43027,41479,36309
42108,2791,3491,38117,3991,24212,17896,1.88233e+18,748.181,8590.8,42108,370,481,38617,38515,38327,38404,34229
31848,594,2693,18918,12930,0,31848,4.80253e+18,1000.54,6985.9,31848,565,471,27322,25266,19349,18521,9403
3304,156,629,0,3304,914,2390,1.0274e+16,149.978,1154.74,3304,141,135,2615,2358,2354,2351,1023
48811,871,1820,0,48811,15725,33086,8.62794e+15,454.643,6033.14,48811,398,299,46991,46766,44554,44751,37348
18058,21,477,18052,6,18058,0,4.00151e+18,292.99,2261.74,18058,156,168,10899,7584,5089,4594,861
13315,18,23,13161,154,13315,0,9.66721e+13,14.6916,343.531,13315,18,18,13292,13287,12760,12758,11968
46085,9,363,0,46085,45445,640,2.56756e+16,144.905,2579.81,46085,111,116,40078,36162,32965,26395,16191
42097,2253,4117,37395,4702,25542,16555,1.95787e+18,1363.48,10104.7,42097,448,536,37980,36985,35305,35673,26794
33816,1590,3357,20996,12820,20996,12820,1.83842e+18,743.105,8092.55,33816,486,399,30459,30302,23370,24305,13904
522,48,196,446,76,320,202,2.09865e+18,29.8218,273.858,522,40,40,326,275,174,166,165
30946,244,4357,27452,3494,18515,12431,1.93438e+18,765.45,9124.62,30946,391,527,22786,17613,11724,9501,1667
22869,280,1551,7067,15802,0,22869,3.55103e+13,511,4527.29,22869,397,324,20156,18295,15642,15697,6678
35034,1,10,32844,2190,34890,144,0.000256893,0.999715,577.44,35034,10,1,35024,35024,35024,35024,35024
39342,33,348,0,39342,38711,631,2.62043e+16,142.069,2379.92,39342,100,116,37511,36412,30266,25535,16341
16467,188,211,0,16467,16228,239,2.39668e+16,98.5158,1226.75,16467,75,77,16256,16255,16212,16185,15758
20976,35,59,20573,403,20976,0,9.83206e+13,17.575,553.582,20976,24,26,20917,20915,20130,20129,17041
4889,360,695,1362,3527,0,4889,3.77144e+13,182.577,1509.99,4889,198,129,4194,4097,3702,3734,2590
12242,1237,2307,7159,5083,0,12242,4.67634e+18,344.296,4251.75,12242,356,357,9935,9835,8661,8730,6423
22480,206,582,22480,0,22480,0,4.17686e+18,284.362,2658.67,22480,177,165,21341,20151,14249,13997,10779
11428,207,481,11428,0,11404,24,4.20489e+18,250.793,1812.94,11428,138,147,10659,9797,7970,7573,7188
24158,51,252,0,24158,23812,346,2.56936e+16,112.088,1635.07,24158,89,94,23312,22538,19387,18037,12467
17493,1685,2514,9988,7505,0,17493,4.3425e+18,353.698,5092.95,17493,358,374,14979,14891,14511,14332,11759
24520,442,664,24520,0,24520,0,4.11739e+18,327.629,2857.02,24520,185,181,23856,23691,22139,22046,21399
8057,65,1920,4886,3171,0,8057,5.16475e+18,250.678,3146.89,8057,224,232,5256,4373,2828,2624,493
7525,398,1592,0,7525,0,7525,2.20269e+18,215.856,2791.01,7525,368,164,5933,5564,4315,2914,2302
5971,906,1033,3562,2409,0,5971,4.40733e+18,365.583,2088.9,5971,190,208,4938,4794,4853,4821,4639
20843,147,225,0,20843,20394,449,2.66755e+16,110.102,1451.74,20843,84,91,20614,20546,19427,19325,17633
38422,619,946,38412,10,38422,0,4.47686e+18,361.502,3855.45,38422,219,233,37476,37442,34440,34272,32661
39769,96,2177,0,39769,12375,27394,8.99285e+15,629.534,6763.38,39769,376,422,31160,27014,18824,17126,5329
31178,1792,2151,9442,21736,0,31178,3.20298e+13,699.204,5869.44,31178,460,360,29027,29000,28704,28721,26344
10521,607,1169,0,10521,3193,7328,8.9772e+15,342.31,2750.82,10521,240,319,9352,9095,8570,8627,5539
38998,17,76,38331,667,38998,0,1.05746e+14,19.0381,770.129,38998,31,30,38874,38796,34883,34744,23473
35687,1273,2164,0,35687,10585,25102,9.09281e+15,558.672,6552.56,35687,362,373,33523,33362,32475,32515,21798
7276,15,170,0,7276,7172,104,2.52935e+16,74.3484,753.753,7276,54,58,6650,6350,5481,5010,2955
1549,199,539,1292,257,897,652,2.06044e+18,88.5507,806.325,1549,68,92,1010,866,794,774,616
31124,55,292,0,31124,30526,598,2.61847e+16,121.288,2022,31124,92,93,30323,29664,24917,22688,14455
41915,1358,2699,24910,17005,0,41915,4.77682e+18,1215.44,8091.6,41915,525,437,38578,37041,36503,35956,24345
9175,41,1280,0,9175,0,9175,2.26044e+18,328.753,2799.52,9175,202,297,5076,3167,2571,2282,99
23925,42,44,23493,432,23919,6,9.69782e+13,19.3012,600.706,23925,22,23,23881,23881,23876,23876,23858
49339,2553,4553,29625,19714,29625,19714,1.86044e+18,1482.83,11072.5,49339,637,712,44786,43369,41412,40598,33008
17401,1273,1460,4959,12442,0,17401,3.61851e+13,335.668,3861.14,17401,397,237,15941,15938,15657,15682,14823
22858,43,57,22491,367,22858,0,1.0004e+14,20.2335,624.503,22858,24,26,22801,22799,22269,22303,20338
35993,756,3097,35993,0,31305,4688,2.92946e+18,1082.14,8112.41,35993,548,509,31176,27757,20943,18497,13651
44598,1896,2355,0,44598,13221,31377,9.16411e+15,693.03,7501.58,44598,595,450,42243,42192,41114,41220,38188
47336,199,351,0,47336,46505,831,2.63564e+16,147.623,2566.01,47336,112,116,46985,46916,44027,42442,37475
19183,2439,2621,11643,7540,0,19183,5.11056e+18,617.81,5588.79,19183,297,401,16562,16556,16491,16497,16154
17044,357,524,17038,6,17044,0,4.27098e+18,305.359,2216.99,17044,162,159,16515,16350,15190,15209,14736
8079,15,29,7978,101,8079,0,9.95391e+13,14.6679,294.438,8079,19,20,8043,8027,7544,7530,6455
17324,539,2252,15609,1715,10009,7315,1.95575e+18,555.531,4833.95,17324,344,261,14687,13819,5326,5608,3569
26836,581,980,26836,0,26836,0,3.96371e+18,353.193,3335.31,26836,195,200,25856,25784,23236,23057,21213
37749,60,84,37225,524,37749,0,1.02937e+14,18.3651,776.651,37749,27,32,37665,37665,36870,36871,32989
40712,860,3020,0,40712,0,40712,2.37194e+18,1163.06,8331.14,40712,567,619,35626,31842,24793,23615,16947
25233,2178,2800,14380,10853,0,25233,4.36537e+18,677.329,6393.69,25233,446,453,22433,22260,22058,22028,20335
19538,701,3212,19538,0,17517,2021,1.65593e+18,660.324,6268.42,19538,401,447,16157,14650,10542,9085,6781
33947,1032,1794,10313,23634,0,33947,3.57502e+13,627.519,5820.94,33947,359,427,32153,32078,30425,30476,22367
49106,1767,3803,0,49106,0,49106,2.34712e+18,905.287,10037.2,49106,436,560,45303,44334,42066,40369,28633
33249,2117,2615,19958,13291,19958,13291,1.86921e+18,1219.82,7158.25,33249,473,417,30634,30129,29952,30046,27801
26563,324,748,26509,54,26563,0,4.34754e+18,353.592,3063.7,26563,191,187,25685,25176,17726,17265,16273
6454,280,329,6454,0,6454,0,3.96547e+18,166.9,1160.75,6454,112,106,6125,6106,5959,5933,5382
36775,3636,3935,36775,0,32937,3838,2.44349e+18,1157.37,9216.81,36775,426,525,32840,32807,32748,32761,32263
3511,177,507,904,2607,0,3511,3.64055e+13,141.136,1057.12,3511,136,103,2892,2624,2661,2656,1517
9337,819,997,0,9337,2833,6504,7.91574e+15,180.502,2256.9,9337,189,169,8340,8340,8331,8331,6899
27208,198,3366,27208,0,24835,2373,1.95683e+18,968.885,7513.47,27208,381,388,19351,14511,7021,4281,2323
2819,18,20,2741,78,2819,0,9.99493e+13,14.1277,160.793,2819,14,16,2799,2798,2761,2760,2693
15512,837,2438,15512,0,13846,1666,1.64551e+18,683.6,5089.82,15512,299,397,12683,11258,9742,9091,6931
11569,782,1221,3329,8240,0,11569,3.67809e+13,249.528,2928.77,11569,229,256,10348,10327,10228,10236,7304
42423,1204,2142,11876,30547,0,42423,3.6606e+13,817.274,7059.56,42423,504,415,40281,39771,37938,38101,27690
42322,2472,3434,24611,17711,24611,17711,1.79108e+18,878.828,9131.5,42322,443,745,38888,38866,38177,38462,29917
45741,1387,2782,0,45741,14455,31286,8.81343e+15,618.868,8315.31,45741,433,587,42959,42631,41018,40956,24511
33634,330,612,33634,0,33634,0,4.13871e+18,297.553,3201.02,33634,202,205,32956,32619,26655,26390,22345
46129,52,2314,0,46129,13993,32136,8.90881e+15,594.361,7667.38,46129,379,458,33327,26726,20691,18860,4418
19892,129,228,0,19892,19511,381,2.3238e+16,112.473,1409.4,19892,82,83,19652,19597,18197,18474,16002
24492,1145,4085,24492,0,22144,2348,2.15136e+18,613.307,7933.46,24492,495,369,20407,19527,14828,12324,7086
16605,566,2134,10090,6515,0,16605,4.60379e+18,499.2,4757.46,16605,301,324,14172,13130,10370,9724,5444
47582,47,61,46598,984,47576,6,9.82225e+13,19.3949,852.251,47582,28,27,47521,47521,46449,46453,43071
26814,1699,2275,0,26814,8372,18442,8.85919e+15,544.048,5917.44,26814,417,478,24539,24449,23826,23925,20679
41592,1418,2682,41592,0,37588,4004,2.53877e+18,1309.91,7851.67,41592,411,425,38373,36865,36160,34831,27558
17894,753,1297,5532,12362,0,17894,3.49489e+13,496.906,3705.39,17894,359,255,16572,16013,15239,15319,12522
19353,1454,2202,11845,7508,0,19353,5.09212e+18,500.541,5027.78,19353,418,315,17151,17027,15445,15211,13543
20283,1466,2556,11908,8375,0,20283,4.91355e+18,470.875,5604.02,20283,271,456,17727,17678,17168,17041,12481
2800,585,723,836,1964,0,2800,3.70993e+13,86.3864,1186.78,2800,128,108,2077,2075,2060,2058,1679
38871,1228,3550,0,38871,0,38871,2.31535e+18,1044.29,8876.77,38871,443,459,34981,33299,28539,28267,13204
42201,1000,4845,37773,4428,24461,17740,1.93031e+18,1203.11,10871.1,42201,428,609,36576,34828,19829,18618,10778
7960,909,1724,4734,3226,0,7960,4.66817e+18,230.476,3025.66,7960,297,289,6236,6172,5948,5766,4118
47895,42,108,46909,986,47382,513,9.62407e+13,19.8973,1006.01,47895,33,33,47787,47783,44812,44710,33443
9048,395,1019,2596,6452,0,9048,3.71637e+13,408.623,2422.6,9048,260,195,7760,7120,6771,6763,3666
14758,1174,1752,8798,5960,0,14758,4.84205e+18,462.414,3944.26,14758,257,291,13006,12933,12474,12410,10922
12788,216,230,0,12788,12522,266,2.50467e+16,98.3856,1239.67,12788,73,78,12558,12558,12550,12541,12392
16378,934,2227,9848,6530,9848,6530,1.88012e+18,431.476,4705.1,16378,291,278,14151,13714,13196,13244,8306
47658,3485,3806,47622,36,43359,4299,1.35131e+18,1628.7,10129.4,47658,490,547,43852,43715,43623,43584,43036
48208,3685,4259,43721,4487,29576,18632,1.98634e+18,1280.85,10707.2,48208,489,542,43949,43932,43810,43798,40136
47927,2077,3153,28762,19165,0,47927,4.76069e+18,878.58,8632.66,47927,415,520,44774,44073,43519,43407,36756
27586,907,1276,7679,19907,0,27586,3.67123e+13,718.708,4338.74,27586,324,303,26172,25309,25694,25735,21667
4387,112,136,0,4387,4329,58,2.5722e+16,53.1238,514.799,4387,47,47,4251,4235,4217,4209,3914
18964,2175,2607,18964,0,16910,2054,2.29201e+18,448.538,5484.91,18964,373,357,16357,16355,16229,16197,13967
19836,74,301,0,19836,19520,316,2.53307e+16,113.129,1693.7,19836,89,103,19320,18845,16436,15538,11201
15037,6,34,14755,282,15037,0,9.94721e+13,16.1016,414.866,15037,22,21,14592,14171,12396,12506,8551
2537,218,569,1471,1066,1471,1066,1.83755e+18,193.79,1008.26,2537,136,107,1850,1551,1513,1369,1181
41884,1612,2322,37453,4431,24987,16897,1.97021e+18,1414.54,7540.14,41884,514,390,39101,35456,37088,37023,32307
36692,2359,3271,22004,14688,22004,14688,1.83241e+18,884.363,8037.51,36692,511,430,33421,33044,32770,32805,29794
6108,21,23,5960,148,6108,0,1.05807e+14,14.6143,245.331,6108,16,18,6085,6085,5968,5967,5910
45451,3196,3807,40701,4750,26833,18618,1.95996e+18,1096.54,9582.46,45451,613,573,41644,41640,41564,41533,39716
35299,1250,2214,0,35299,10350,24949,9.14634e+15,652.857,6633.35,35299,448,405,33085,32767,31847,31765,23866
15055,373,545,15055,0,15055,0,4.02814e+18,271.18,2141.25,15055,158,151,14510,14426,13446,13404,12814
24151,167,256,0,24151,23735,416,2.65394e+16,118.528,1669.68,24151,96,100,23891,23828,22887,22530,20613
31297,53,862,31297,0,31297,0,4.27875e+18,333.037,3415.16,31297,204,201,21615,13616,10166,8728,3561
34784,1,71,34268,516,34784,0,1.0786e+14,20.5135,722.519,34784,27,30,13283,13283,13283,13283,13283
33015,2699,2824,18636,14379,18636,14379,1.65783e+18,1064.87,6932.84,33015,409,514,30191,29470,30095,30125,29613
43754,3306,3942,25569,18185,25569,18185,1.77691e+18,803.497,9741.53,43754,497,508,39812,39754,39490,39589,36233
9164,335,1225,2638,6526,0,9164,3.3807e+13,208.012,2601.63,9164,202,207,7919,7585,6014,6003,2503
35027,40,100,34203,824,35027,0,1.02579e+14,19.7257,809.196,35027,29,31,34927,34920,32605,32490,24463
17661,2927,3348,17661,0,15623,2038,1.83087e+18,517.694,6218.47,17661,302,417,14313,14299,14292,14292,13712
36750,1447,1990,11343,25407,0,36750,3.21556e+13,673.831,6065.92,36750,341,344,34760,34354,34356,34373,29875
47311,565,2194,0,47311,14384,32927,9.12062e+15,757.423,7105.1,47311,445,446,44398,42980,37392,36045,21128
38966,5754,38966,38966,0,38966,0,1.75917e+13,0,38966,38966,38966,1,0,0,0,0,0
20803,15,63,20392,411,20803,0,1.09665e+14,16.6673,545.881,20803,24,27,20717,20660,18249,18001,11222
17825,428,1471,0,17825,5900,11925,8.49281e+15,546.066,3935.46,17825,341,362,15920,15203,11912,12027,6639
8066,844,1528,7228,838,4901,3165,1.99085e+18,346.57,2954.68,8066,188,250,6538,6401,6007,6117,4071
31423,431,2641,18185,13238,18185,13238,1.69483e+18,802.363,6839.3,31423,400,383,27280,25016,18152,16853,6647
27551,1487,2701,24603,2948,16675,10876,1.9489e+18,794.488,6533.25,27551,408,338,24850,24578,21017,21013,15981
35016,3147,3869,35016,0,31320,3696,2.8709e+18,1281.29,9038.48,35016,543,482,31147,31089,30917,30851,29010
13780,1638,1730,13780,0,12389,1391,1.95701e+18,687.865,3931.16,13780,305,312,12050,12050,12048,12045,11998
34096,3086,3792,34096,0,30547,3549,2.30761e+18,953.104,8648.66,34096,466,422,30304,30279,30037,30023,28289
33525,867,2563,0,33525,0,33525,2.34643e+18,673.467,6932.27,33525,350,432,30530,29068,27018,20953,10753
42291,581,911,42291,0,42291,0,4.38684e+18,341.7,3932.42,42291,213,221,41380,41324,38409,38413,36996
16560,10171,16560,0,16560,0,16560,1048510,0,16560,16560,16560,1,0,0,0,0,0
7848,867,868,0,7848,2285,5563,8.92242e+15,287.488,2015,7848,257,176,6980,6980,6980,6980,6980
3997,73,825,0,3997,0,3997,2.2899e+18,186.63,1536.86,3997,124,194,2604,1929,1401,1281,138
41454,722,2254,0,41454,12567,28887,9.18281e+15,706.693,6992.73,41454,412,425,38715,37411,28506,28791,15952
4844,808,1096,0,4844,0,4844,2.50021e+18,220.158,1869.69,4844,199,130,3748,3603,3657,3660,3110
10358,595,1951,10358,0,9124,1234,2.18299e+18,444.591,3838.19,10358,272,327,8076,7046,6851,6868,3143
1515,59,265,1515,0,1515,0,4.07556e+18,110.008,541.398,1515,55,57,1082,813,647,633,471
7127,1090,1581,4384,2743,4384,2743,1.85968e+18,320.716,2812.08,7127,244,271,5546,5435,5273,5316,4335
26387,125,893,26387,0,26387,0,4.27421e+18,344.152,3232.27,26387,203,197,22461,18288,12947,11357,7011
17870,1461,3942,17870,0,16088,1782,2.50339e+18,360.917,6728.41,17870,309,373,13928,13732,11408,11211,6559
44059,23,76,43257,802,44059,0,1.02294e+14,17.6871,755.919,44059,26,30,43982,43968,41392,41207,34139
8226,513,672,0,8226,2942,5284,8.4347e+15,380.959,1907.87,8226,242,186,7529,7096,7249,7252,6713
29554,183,253,0,29554,29020,534,2.71417e+16,145.855,1834.49,29554,94,104,29299,29245,28267,28155,25724
19869,2168,2254,19869,0,17795,2074,2.69432e+18,726.805,5414.99,19869,347,349,17615,17613,17615,17615,17476
10401,371,795,3264,7137,0,10401,2.65901e+13,195.453,1986.01,10401,179,133,9606,9510,8739,8783,5087
44927,422,752,44927,0,44927,0,4.09147e+18,373.395,3806.91,44927,214,212,44141,43819,38563,38789,35509
17276,449,1220,0,17276,5575,11701,8.95207e+15,475.643,3600.89,17276,278,329,15752,15126,12904,13001,7635
37816,209,310,0,37816,37198,618,2.48132e+16,135.903,2256.75,37816,111,108,37506,37467,36789,36529,34214
28781,364,3028,17139,11642,17139,11642,1.8441e+18,729.531,7074.98,28781,380,457,23971,20523,18550,16495,5701
7619,676,917,0,7619,2312,5307,9.88413e+15,351.406,2088.84,7619,225,214,6702,6447,6388,6383,5910
47767,683,2937,28946,18821,28946,18821,1.91454e+18,1686.46,9106.97,47767,561,512,40408,36813,28214,29731,15003
3735,651,759,1139,2596,0,3735,3.42552e+13,129.801,1412.15,3735,169,98,2976,2976,2959,2959,2774
31176,1983,3077,0,31176,0,31176,2.42084e+18,743.984,7231.08,31176,440,367,28099,28044,27587,27248,23312
40867,1679,3371,0,40867,0,40867,2.37491e+18,652.35,8236.8,40867,417,316,37496,37283,30349,25929,24086
44092,1296,4515,39609,4483,25727,18365,1.97409e+18,1250.31,10601.6,44092,492,572,38958,37102,33387,33528,15038
9110,188,934,2940,6170,0,9110,3.57061e+13,263.202,2334.01,9110,164,240,7810,7147,6016,6007,2473
3155,47,806,1853,1302,1853,1302,1.76095e+18,163.839,1373.13,3155,150,132,1756,1115,899,727,127
31357,158,266,0,31357,30750,607,2.46183e+16,139.141,1933.96,31357,95,99,31073,30976,28962,29002,24923
20739,2015,2354,0,20739,0,20739,2.25362e+18,626.087,5521.11,20739,337,434,18385,18385,18300,18310,17533
33167,3548,3949,29489,3678,20023,13144,1.91865e+18,1291.99,8945.55,33167,545,467,29218,29214,29163,29193,28387
28904,763,2600,16866,12038,0,28904,4.97206e+18,681.191,6377.31,28904,415,286,25980,25333,22823,22264,13880
36713,1458,3403,36713,0,32912,3801,2.16569e+18,892.1,8435.89,36713,431,405,33310,32703,29897,27974,14106
26740,1741,3513,15815,10925,15815,10925,1.84871e+18,720.412,7323.99,26740,437,578,23227,22584,22068,22223,15560
46214,993,4110,27909,18305,27909,18305,1.90406e+18,837.729,9933.57,46214,567,563,41881,40149,34967,34133,20101
44252,4159,4310,25650,18602,0,44252,4.63427e+18,901.019,10383.9,44252,414,614,39942,39942,39910,39911,39623
17646,133,691,17596,50,17646,0,4.4458e+18,280.614,2423.22,17646,161,171,15347,13004,8940,8027,6062
13710,1893,2076,0,13710,0,13710,2.35305e+18,610.774,4240.44,13710,304,352,11634,11632,11612,11632,11377
42394,162,299,0,42394,41734,660,2.50062e+16,142.761,2307.12,42394,104,114,42056,41888,38950,38344,33574
32490,90,335,0,32490,31949,541,2.64722e+16,129.332,2210.81,32490,100,126,31962,31581,26301,24784,16953
26775,1718,2851,15576,11199,0,26775,4.8233e+18,583.978,6397.66,26775,347,401,23924,23576,23174,22948,17753
33998,643,742,33998,0,33998,0,4.09416e+18,331.495,3335.08,33998,191,206,33256,33252,32962,32991,32951
13844,20,42,13592,252,13844,0,9.75121e+13,17.5037,460.059,13844,22,23,13799,13791,13013,13005,11184
26985,1192,1774,0,26985,7674,19311,9.37561e+15,621.287,5248.69,26985,343,376,25211,24887,24599,24510,20809
11764,1105,1524,7001,4763,7001,4763,1.82261e+18,388.785,3188.56,11764,286,175,10240,10087,10102,10156,9053
4812,75,826,0,4812,0,4812,2.35808e+18,360.709,1684,4812,160,181,2973,2235,1690,1177,453
33017,507,2958,19328,13689,19328,13689,1.87208e+18,941.395,7457.81,33017,455,396,28455,26623,21557,20054,6167
27492,855,2416,0,27492,0,27492,2.28268e+18,786.596,6193.59,27492,346,476,24822,23470,22173,21646,10902
38179,1994,3584,22755,15424,22755,15424,1.78457e+18,747.902,8934.6,38179,523,427,34595,34480,32439,31291,21799
42117,980,4274,37860,4257,25508,16609,1.95583e+18,898.456,10150,42117,556,448,37507,35176,24013,24067,15208
29453,50,69,28872,581,29453,0,1.02869e+14,18.8457,677.147,29453,28,27,29384,29384,28533,28534,25572
31959,254,601,31959,0,31959,0,4.05039e+18,310.526,2992.44,31959,195,186,31078,30232,21899,22422,16560
18125,284,697,18125,0,18125,0,4.1828e+18,258.358,2469.85,18125,162,159,17404,16932,12063,11771,11854
19538,671,3521,17224,2314,10929,8609,1.98264e+18,562.627,6535.86,19538,343,404,15763,14428,8929,7848,3754
3078,237,242,0,3078,0,3078,1.58804e+18,110.108,716.008,3078,85,82,2836,2836,2836,2836,2836
49800,1066,3741,44307,5493,28700,21100,1.96082e+18,1305.52,9945.09,49800,513,532,44603,41380,28572,27624,18708
29116,1033,2096,8928,20188,0,29116,3.60312e+13,423.392,5637.53,29116,435,259,27020,26925,23175,23265,17484
35185,2258,2545,20823,14362,0,35185,4.95306e+18,1274.26,6935.79,35185,470,459,32640,32619,32420,32386,31758
46083,485,1514,0,46083,15027,31056,7.61467e+15,604.757,5747.47,46083,417,339,43800,42706,36056,36016,23676
26767,2063,2071,16064,10703,16064,10703,1.90731e+18,912.81,5622.06,26767,480,347,24696,24696,24685,24691,24689
48314,99,309,0,48314,47587,727,2.60839e+16,145.856,2414.93,48314,110,115,47688,47188,41541,39016,29009
40927,987,2295,11666,29261,0,40927,3.73705e+13,879.339,7125.06,40927,436,391,38305,37363,34731,34887,23978
18893,1709,2304,10547,8346,0,18893,4.25633e+18,529.621,4878.62,18893,295,286,16589,16394,16363,16359,15105
15327,1116,1560,9175,6152,0,15327,4.84829e+18,593.906,3755.14,15327,304,225,13767,13550,13467,13409,11623
10482,399,482,10482,0,10482,0,4.00631e+18,265.581,1739.23,10482,138,135,10000,9964,9662,9694,9144
44980,1029,3384,27024,17956,27024,17956,1.86291e+18,1016.12,9108.64,44980,522,529,41021,38812,35957,33041,12687
25558,13880,25558,0,25558,25558,0,4095.84,0,25558,25558,25558,1,0,0,0,0,0
45997,109,2029,13879,32118,0,45997,3.67465e+13,436.074,6000.48,45997,318,369,36244,30538,23059,14716,3684
47528,264,5156,47528,0,42758,4770,2.44598e+18,1024.69,11831.5,47528,583,702,36730,30160,17163,10412,2655
27080,134,268,0,27080,26737,343,2.5795e+16,124.69,1773.52,27080,90,98,26790,26624,24187,23763,18110
1021,3,241,0,1021,320,701,9.03541e+15,62.764,422.413,1021,57,56,269,148,140,136,92
40705,2405,3292,24374,16331,24374,16331,1.8378e+18,1201.12,8608.7,40705,441,432,37413,36924,36696,36756,33475
8415,668,890,2744,5671,0,8415,3.103e+13,193.477,2109.42,8415,199,225,7525,7512,7407,7410,6856
29455,1956,2977,26489,2966,17854,11601,1.94956e+18,964.609,7057.58,29455,380,415,26478,26117,25431,25681,20152
26931,2100,2905,16073,10858,0,26931,4.93712e+18,915.539,6646.21,26931,331,402,24026,23457,23722,23686,20955
47099,1580,2352,13546,33553,0,47099,3.69682e+13,884.618,7619.62,47099,426,456,44747,44456,43847,43940,37422
24743,633,1786,7751,16992,0,24743,3.28261e+13,554.132,4897.4,24743,313,414,22842,22192,20795,20996,12441
27622,1113,3136,16648,10974,0,27622,4.74959e+18,664.967,7245.86,27622,482,449,24486,23935,19950,19840,13034
47694,1087,1140,47694,0,47694,0,3.96457e+18,384.785,4426.93,47694,227,233,46554,46551,46506,46496,46359
27439,1662,3674,27439,0,24411,3028,2.03002e+18,970.805,7746.6,27439,373,411,23765,23056,18291,17633,12470
37413,925,2613,34060,3353,22996,14417,1.95517e+18,886.241,6892.49,37413,374,378,34464,32976,23487,22307,19378
37010,1115,2021,0,37010,11335,25675,8.78498e+15,436.282,6102.9,37010,510,247,34989,34896,32236,32390,26008
39501,162,287,0,39501,38360,1141,2.53382e+16,163.571,2222.12,39501,112,115,39147,38981,35918,35637,31054
1908,67,105,0,1908,1865,43,3.0364e+16,28.3202,313.271,1908,33,38,1803,1795,1653,1741,1196
8146,155,1170,4780,3366,4780,3366,1.82261e+18,290.144,2480.25,8146,176,280,6031,4908,3859,3374,897
20459,1333,1681,5845,14614,0,20459,3.70622e+13,428.425,4410.56,20459,359,284,18778,18774,18553,18531,17364
45348,3999,4461,26063,19285,0,45348,4.6532e+18,1124.26,10766.1,45348,500,692,40887,40741,40707,40672,39364
15972,881,1579,4555,11417,0,15972,3.72026e+13,376.787,3967.09,15972,251,317,14393,14346,13950,13976,9374
43994,252,306,0,43994,42792,1202,2.59394e+16,142.645,2283.75,43994,105,113,43688,43681,43065,43070,42060
6268,1201,1260,0,6268,0,6268,2.5977e+18,212.872,2281.26,6268,173,208,5008,5008,5000,5008,4913
40213,15,90,39511,702,40213,0,1.02866e+14,20.7497,874.956,40213,30,34,40043,39935,35301,35019,19373
20916,940,1424,0,20916,6290,14626,9.12589e+15,469.905,4032.79,20916,334,295,19492,19306,18558,18656,16165
48140,23,2264,28410,19730,0,48140,4.83395e+18,1353.24,7822.6,48140,495,447,24279,15106,12327,11360,911
49117,2826,5628,43805,5312,29690,19427,1.93957e+18,1506.97,12937.3,49117,665,534,43489,42084,35677,35068,29326
15372,28,38,15070,302,15372,0,9.81466e+13,16.8011,411.498,15372,21,23,15334,15334,14950,14951,14199
27639,7,58,27027,612,27639,0,1.00649e+14,19.4487,605.18,27639,27,26,27007,26710,23432,22973,14197
46783,903,922,46783,0,46783,0,4.39127e+18,351.951,4172.38,46783,221,222,45861,45861,45855,45854,45847
20276,39,720,20276,0,20276,0,4.2312e+18,265.324,2637.4,20276,169,178,12982,7873,6068,5504,2289
8263,365,536,8263,0,8263,0,4.13137e+18,245.028,1631.66,8263,137,129,7727,7658,7033,6948,6341
15178,345,1288,4378,10800,0,15178,3.69492e+13,406.899,3348.15,15178,256,282,13593,12781,11236,11162,6029
21226,34,2895,21226,0,18947,2279,2.77462e+18,949.22,6250.38,21226,345,315,10476,6819,3641,1878,332
16208,384,1054,5067,11141,0,16208,3.19025e+13,227.026,2849.61,16208,182,187,15154,14921,14015,14071,8934
4182,371,1090,4182,0,3739,443,1.74124e+18,237.696,1858.41,4182,204,147,3032,2510,1805,1450,1057
23645,2588,2684,20998,2647,14192,9453,1.96162e+18,986.137,6338.16,23645,332,405,20961,20937,20952,20958,20814
37131,800,959,37106,25,37131,0,4.1047e+18,357.819,3829.91,37131,213,224,36172,36162,35189,35295,34964
40579,100,351,0,40579,39821,758,2.63893e+16,162.154,2429.43,40579,112,127,39851,39280,34264,31697,23519
9413,403,1417,8443,970,5445,3968,1.85806e+18,553.98,3034.19,9413,203,238,7643,7142,4070,3707,2772
21224,381,2314,0,21224,0,21224,2.21218e+18,782.475,5401.05,21224,366,335,17793,15979,9995,8954,5535
28044,550,2091,8337,19707,0,28044,3.60258e+13,579.78,5671.34,28044,400,315,25668,24666,19709,19750,12580
9653,1066,1278,5277,4376,0,9653,3.88998e+18,183.287,2605.47,9653,164,214,8375,8375,8317,8346,6063
35619,627,3582,21366,14253,0,35619,4.55296e+18,571.729,8158.04,35619,545,320,31819,30124,15751,12827,7510
34948,857,1959,10403,24545,0,34948,3.59835e+13,684.527,5848.03,34948,416,327,32989,32241,28948,29107,22236
42880,1034,1135,42553,327,42870,10,4.19647e+18,382.714,4212.06,42880,233,233,41745,41744,41563,41602,41437
690,68,375,438,252,438,252,1.86461e+18,25.7493,475.323,690,76,71,315,255,228,234,66
30278,18,53,29679,599,30278,0,1.00457e+14,17.9281,608.523,30278,24,25,30217,30191,27801,27830,20647
48041,50,62,47095,946,48041,0,1.03618e+14,21.62,814.994,48041,28,28,47979,47975,47259,47260,46178
44686,1626,3209,26604,18082,26604,18082,1.74571e+18,900.483,8525.86,44686,556,405,41477,40866,38830,37110,29683
48482,43,4132,27894,20588,27894,20588,1.77657e+18,1142.36,10218.4,48482,457,513,28752,19176,13929,12696,1229
45385,1185,4451,45385,0,40646,4739,2.27554e+18,1187.95,10578.1,45385,554,576,40100,37817,29814,26274,12804
11162,582,835,0,11162,3294,7868,9.16606e+15,276.587,2288.38,11162,222,163,10327,10298,9920,9918,8958
32157,2022,2143,0,32157,0,32157,2.4367e+18,1205.22,6267.97,32157,426,396,30014,30003,29889,29784,29657
48956,2609,3053,0,48956,0,48956,2.20144e+18,724.098,8254.02,48956,431,503,45903,45902,45747,45746,44367
48880,528,905,48880,0,48880,0,3.97793e+18,368.4,4147.25,48880,241,235,47975,47929,44025,43746,43767
29093,40,271,0,29093,28588,505,2.6804e+16,127.407,1820.67,29093,87,98,27880,27047,23274,20911,13666
40596,270,1014,40596,0,40596,0,4.37922e+18,350.58,3954.87,40596,214,219,39250,38086,24728,23909,18616
3869,535,592,1222,2647,0,3869,3.50354e+13,187.225,1255.28,3869,137,144,3277,3222,3263,3264,3132
17569,1812,1935,17569,0,15708,1861,2.73957e+18,932.452,4640.89,17569,357,283,15634,15634,15628,15629,15499
44763,847,1566,14293,30470,0,44763,3.06425e+13,715.274,5780.14,44763,331,378,42955,41858,40936,41037,29899
43277,974,2242,13399,29878,0,43277,3.38488e+13,812.542,7119.28,43277,509,415,40917,40160,34645,34758,27643
35374,7588,35374,35374,0,35374,0,1.75917e+13,0,35374,35374,35374,1,0,0,0,0,0
41963,2420,2544,37403,4560,24881,17082,1.91709e+18,1322.75,7679.04,41963,451,470,39419,39412,39404,39414,39195
8441,219,1017,2539,5902,0,8441,3.65026e+13,246.829,2394.01,8441,285,240,7217,6498,5204,5224,2653
19063,200,602,19063,0,19063,0,4.52915e+18,289.154,2422.35,19063,161,160,18102,17216,9227,8970,8001
39153,27,90,38400,753,39153,0,1.05393e+14,19.9555,770.083,39153,30,34,39062,39041,36115,35923,23853
33565,1208,3332,33565,0,30065,3500,1.93242e+18,1095.25,8047.51,33565,425,469,29919,27817,20154,17368,17981
10035,1213,1545,6010,4025,0,10035,4.97769e+18,374.21,3182.67,10035,223,252,8490,8479,8228,8176,7736
25145,19,56,24824,321,25079,66,9.69185e+13,20.6844,657.267,25145,25,28,25072,25032,22687,22547,16214
4792,555,643,1552,3240,0,4792,3.57774e+13,173.304,1450.57,4792,137,184,4149,4149,4136,4130,3889
28444,2849,3458,25566,2878,17045,11399,1.98079e+18,1003.02,7672.8,28444,452,508,24986,24974,24673,24754,22721
30058,1927,2373,8769,21289,0,30058,3.61754e+13,514.64,6339.04,30058,480,310,27685,27684,27443,27408,26084
9567,627,2178,0,9567,0,9567,2.42215e+18,228.188,3748.72,9567,279,224,7389,7061,5360,4911,3248
38028,1267,2054,0,38028,0,38028,2.42803e+18,1014.47,6561.58,38028,406,381,35974,35726,32141,31639,28964
2556,288,918,2556,0,2288,268,1.6232e+18,258.577,1383.52,2556,152,130,1544,1248,998,883,813
12363,3,4,11590,773,12315,48,0.00024266,0.999676,218.837,12363,4,1,12359,12359,12359,12359,12359
34334,17,319,0,34334,33726,608,2.6104e+16,149.958,2145.1,34334,115,102,31656,30371,25746,20595,12584
14673,8,237,0,14673,14458,215,2.55908e+16,101.863,1303.12,14673,72,83,12363,10932,9874,8196,5190
34404,2698,2838,20028,14376,20028,14376,1.71369e+18,981.182,7420.14,34404,380,455,31566,31555,31477,31537,31407
40281,1062,2433,0,40281,11304,28977,9.67159e+15,799.701,7293.44,40281,508,489,37790,36749,35116,35196,22347
45377,3918,3999,45377,0,40166,5211,1.35186e+18,1533.86,10034.9,45377,504,538,41378,41378,41378,41378,41327
16214,212,231,0,16214,15973,241,2.68072e+16,98.6411,1382.87,16214,72,79,15983,15982,15942,15910,15528
3883,347,580,1354,2529,0,3883,3.15365e+13,181.748,1239.46,3883,122,125,3303,3205,3041,3046,2099
27409,155,1589,8533,18876,0,27409,3.47533e+13,374.152,4565.75,27409,279,283,22644,18996,14581,7302,8206
3762,342,622,0,3762,1027,2735,9.80911e+15,184.912,1230.63,3762,148,115,3140,2948,2984,3000,2058
25508,329,2945,22774,2734,15114,10394,1.99557e+18,707.647,6526.21,25508,416,393,20485,15707,11822,10278,4635
25350,1727,2070,15339,10011,15339,10011,1.89685e+18,972.926,5561.96,25350,400,366,23280,23245,22989,22977,21001
16328,70,238,0,16328,15829,499,2.65274e+16,95.3496,1290.13,16328,84,84,15888,15446,13866,13128,10012
18779,1281,1611,11640,7139,11640,7139,1.84768e+18,625.419,4326.45,18779,312,302,17168,17164,17097,17109,16479
37127,1272,4541,37127,0,33286,3841,1.73397e+18,922.63,10147.7,37127,491,460,32309,30492,22634,19161,10718
810,257,270,263,547,0,810,4.51947e+13,31.5864,384.2,810,75,49,540,540,540,540,529
12701,1201,1813,11213,1488,7616,5085,2.03943e+18,458.806,3813.53,12701,246,229,10888,10814,8920,8724,7434
954,189,477,929,25,864,90,2.31278e+18,66.9277,630.211,954,81,58,477,414,369,381,286
3066,250,605,0,3066,840,2226,1.02495e+16,102.357,1097.6,3066,135,111,2461,2377,2344,2356,1592
19419,1026,2253,0,19419,0,19419,2.4618e+18,932.216,5347.7,19419,324,439,16637,15538,15070,13030,9676
15247,1808,2600,13955,1292,9205,6042,2.01096e+18,525.181,5148.22,15247,388,261,12647,12636,11501,11598,9432
2902,151,655,1639,1263,1639,1263,1.60411e+18,124.426,1154.12,2902,117,108,2181,1854,1638,1452,1053
12653,215,1607,7358,5295,7358,5295,1.88623e+18,346.055,3534.05,12653,245,218,9972,7965,7727,6905,2148
29831,2257,3076,16371,13460,0,29831,4.27961e+18,545.899,6927.69,29831,441,451,26755,26741,26507,26529,24541
38309,152,299,0,38309,37705,604,2.69279e+16,119.827,2075.15,38309,100,108,38010,37947,34721,33620,26146
9791,20,838,0,9791,3183,6608,8.47901e+15,286.761,2196.3,9791,173,226,5387,3322,2944,2892,952
10668,304,591,10668,0,10668,0,4.30592e+18,277.377,1865.63,10668,142,138,10028,9808,7891,7804,6740
38930,22,76,38264,666,38825,105,1.03234e+14,18.8819,768.842,38930,29,30,38851,38831,35838,35550,23910
11145,621,1648,6153,4992,6153,4992,1.59945e+18,338.488,3322.42,11145,300,243,9497,9025,8371,8459,6368
23116,172,252,0,23116,22844,272,2.61909e+16,119.338,1594.59,23116,87,95,22864,22792,21774,21645,19985
23672,837,1661,6945,16727,0,23672,3.58255e+13,495.167,4697.61,23672,334,308,22011,21477,20732,20748,15216
35922,65,338,0,35922,35027,895,2.58407e+16,123.349,2236.54,35922,102,115,35101,34290,29271,26446,17497
35576,393,2589,19922,15654,19922,15654,1.59454e+18,987.808,6912.23,35576,502,430,31259,29112,21408,17742,5334
1480,127,500,1319,161,827,653,1.92003e+18,71.3027,764.728,1480,74,89,980,906,447,482,132
4000,275,471,1064,2936,0,4000,3.46252e+13,202.899,1112.87,4000,151,113,3508,3107,3127,3127,2235
7576,671,755,3940,3636,0,7576,3.38972e+18,155.277,1757.82,7576,152,160,6821,6821,6821,6821,6070
7733,784,848,2313,5420,0,7733,3.64765e+13,314.532,2043.04,7733,223,166,6885,6879,6839,6827,6696
29416,19,41,28872,544,29322,94,9.85395e+13,19.4157,649.29,29416,24,24,29363,29340,27254,27120,20641
3616,455,470,1180,2436,0,3616,3.34773e+13,240.37,1095.95,3616,169,129,3146,3146,3146,3144,3141
42913,2986,4163,38571,4342,24889,18024,1.94347e+18,1017.24,10074.6,42913,414,571,38750,38647,37984,38151,28133
46454,53,72,45573,881,46430,24,9.97653e+13,18.1787,839.943,46454,27,29,46382,46382,45537,45534,42949
38585,278,3930,22874,15711,22874,15711,1.7963e+18,814.132,9384.14,38585,562,496,31491,27134,19921,16922,5084
35503,963,2012,10236,25267,0,35503,3.67482e+13,882.085,6288.65,35503,464,461,33130,32031,30265,30479,19639
15908,931,1433,0,15908,0,15908,2.37139e+18,657.823,3796.54,15908,304,279,14366,13568,13546,13326,11124
42454,54,68,41582,872,42454,0,1.02018e+14,19.8246,774.203,42454,31,31,42386,42386,41714,41715,40822
18635,660,2505,11065,7570,11065,7570,1.87581e+18,463.005,5330.95,18635,441,395,16130,15284,10351,10035,5970
5120,425,976,0,5120,0,5120,2.29598e+18,244.979,1887.73,5120,231,134,4144,4008,2640,2024,1793
28979,255,849,28979,0,28954,25,4.16886e+18,325.903,3249.38,28979,195,203,27634,25949,17387,16496,15952
43139,3398,3694,43139,0,38791,4348,1.76607e+18,1246.05,9318.42,43139,520,405,39445,39265,39360,39343,38038
10861,515,1332,6558,4303,6558,4303,1.80286e+18,502.356,3126.28,10861,237,279,9171,8569,8061,8181,5511
16533,761,2686,0,16533,0,16533,2.21844e+18,522.006,5309.66,16533,339,267,13840,12632,8874,8172,5756
49515,2779,5093,49515,0,44165,5350,2.49876e+18,1401.12,11627.4,49515,550,517,44422,43840,42268,40916,26835
47517,4263,4449,47517,0,42743,4774,1.41e+18,1219.91,10701.2,47517,562,502,43068,43067,43040,43019,42524
29723,930,3180,29723,0,27005,2718,2.53888e+18,1255.56,7606.1,29723,462,377,24998,22744,15676,13422,10210
8666,724,1251,0,8666,0,8666,2.40832e+18,472.98,2659.35,8666,251,234,7354,6795,6990,6686,5566
30899,347,1622,8864,22035,0,30899,3.65939e+13,598.41,5134.17,30899,446,292,28119,25937,21154,21253,12005
27514,230,1681,8500,19014,0,27514,3.50362e+13,542.48,5016.82,27514,422,374,23917,21192,13934,12612,6952
23063,102,692,23063,0,23063,0,4.32134e+18,320.976,2767.2,23063,179,181,19419,15842,10563,9847,5011
3552,408,416,3552,0,3552,0,4.23553e+18,170.869,989.372,3552,101,94,3136,3136,3133,3135,3117
32330,690,1864,9439,22891,0,32330,3.65512e+13,627.499,5704.6,32330,343,342,30176,28950,23476,23569,14968
14630,176,2029,8728,5902,8728,5902,1.92323e+18,456.578,4312.43,14630,267,358,11037,9330,6716,5615,1528
989,135,366,587,402,0,989,5.32656e+18,70.2861,522.205,989,65,71,623,542,530,545,313
17263,489,591,17263,0,17263,0,4.23853e+18,289.331,2312.23,17263,163,165,16672,16671,16301,16296,16306
2425,11,308,0,2425,0,2425,1.7611e+18,137.713,717.997,2425,85,77,546,73,126,49,6
26535,757,1163,0,26535,8293,18242,7.54494e+15,657.961,3954.92,26535,296,305,25163,24566,23995,24090,19369
44528,184,292,0,44528,43916,612,2.52044e+16,144.369,2239,44528,101,108,44232,44166,41781,41213,36392
20127,880,2373,0,20127,0,20127,2.0825e+18,511.946,5203.18,20127,317,346,17754,17203,15369,15659,8743
37827,345,2394,11628,26199,0,37827,3.59148e+13,553.537,6918.83,37827,360,458,34115,31144,23045,22177,7310
28765,3074,3295,25593,3172,17184,11581,2.02757e+18,1238.57,7657.23,28765,528,435,25470,25450,25450,25456,24937
34347,671,813,34347,0,34347,0,4.22246e+18,376.882,3517.44,34347,207,210,33534,33530,32790,32818,32452
28069,6,44,27657,412,28069,0,9.83044e+13,19.0386,635.524,28069,24,25,27262,26630,22750,22518,14802
41642,2875,3478,0,41642,0,41642,2.2738e+18,859.152,8526.97,41642,455,484,38164,38156,37881,37883,35862
47451,725,2455,42856,4595,25966,21485,1.91362e+18,1488.96,7616.87,47451,457,371,42348,40221,31815,27442,11643
25720,80,275,0,25720,25193,527,2.56349e+16,128.655,1772.55,25720,98,103,25212,24762,21530,20465,15093
39097,1037,1777,11787,27310,0,39097,3.6289e+13,735.789,5772.27,39097,427,381,37320,36763,33309,33438,26885
42303,187,3123,25490,16813,25490,16813,1.85923e+18,1239.89,8431.56,42303,616,432,32176,26488,20933,15026,3466
15495,458,1166,0,15495,4954,10541,8.68516e+15,311.06,3303.14,15495,275,266,14308,13571,11983,11702,7356
33901,741,2314,9692,24209,0,33901,3.72885e+13,616.253,6481.99,33901,440,383,31432,30718,27915,28088,14978
46055,3535,4143,26446,19609,26446,19609,1.67158e+18,1069.2,10307.2,46055,490,561,41912,41638,41577,41716,39267
39465,4088,4114,22825,16640,22825,16640,1.736e+18,747.952,9642.42,39465,435,601,35351,35351,35349,35349,35296
34799,787,2485,9995,24804,0,34799,3.60759e+13,606.515,6764.54,34799,499,327,32314,31278,26392,26654,17152
14870,153,1619,0,14870,4236,10634,9.25428e+15,357.233,3745.98,14870,374,271,12125,10608,7976,7489,3013
27913,5,8,26169,1744,27801,112,0.000250779,0.999713,462.503,27913,8,1,27905,27905,27905,27905,27905
9321,727,972,2695,6626,0,9321,3.72381e+13,373.735,2404.33,9321,229,220,8349,8033,7968,7974,7420
38591,2494,2724,0,38591,0,38591,2.35558e+18,903.986,7639.37,38591,379,484,35867,35867,35796,35794,34601
27132,1054,1964,0,27132,8163,18969,9.06129e+15,571.315,5536.84,27132,407,369,25168,24856,22952,23080,14449
45580,716,2390,13975,31605,0,45580,3.37268e+13,729.643,7257.86,45580,452,436,42825,41631,34731,34542,20631
23372,7186,23372,0,23372,23372,0,4095.82,0,23372,23372,23372,1,0,0,0,0,0
1771,584,661,1094,677,0,1771,4.69199e+18,100.039,949.207,1771,114,96,1110,1110,1110,1110,1074
46146,448,2308,13966,32180,0,46146,3.48296e+13,759.203,7494.03,46146,498,435,42290,40102,27243,25114,11764
21939,325,579,21939,0,21939,0,4.32067e+18,315.878,2626.91,21939,173,175,21316,20944,16539,16300,15559
9762,843,1189,0,9762,0,9762,2.42318e+18,406.178,2659.07,9762,222,239,8573,8375,7794,6872,7082
30685,260,656,30673,12,30685,0,3.71174e+18,336.849,3096.26,30685,189,194,29702,28726,22570,22223,15813
9310,18,37,9140,170,9310,0,1.07118e+14,16.684,339.166,9310,23,20,9269,9257,8767,8768,7522
22625,1667,2263,13573,9052,13573,9052,1.84004e+18,721.277,5525.77,22625,325,386,20362,20323,19916,20093,16758
32220,4,73,31444,776,32214,6,1.00351e+14,18.0639,749.889,32220,29,29,28780,26759,24654,24933,13681
16914,1391,1703,10197,6717,10197,6717,1.91855e+18,775.574,4228.68,16914,310,333,15211,15146,14967,14942,14432
47708,3694,4017,0,47708,0,47708,2.21353e+18,938.811,10165.7,47708,472,559,43691,43674,43620,43690,42536
42001,1394,3379,37972,4029,25024,16977,1.91625e+18,1269.65,9083.84,42001,419,547,38250,34432,31306,31023,20353
13681,841,1873,0,13681,0,13681,2.4342e+18,639.654,3997.73,13681,319,312,11664,10654,10226,9484,7662
41478,104,2828,0,41478,0,41478,2.37725e+18,913.165,8016.18,41478,488,419,28797,23204,17539,11488,1785
6095,112,348,6095,0,6095,0,3.71576e+18,161.042,1129.89,6095,106,112,5506,4455,3315,3046,3098
11646,975,1284,0,11646,3178,8468,9.87016e+15,306.606,3013.44,11646,230,226,10362,10300,10269,10230,8982
33536,153,315,0,33536,32939,597,2.58055e+16,123.388,2184.32,33536,97,109,33214,33080,30660,30279,25405
13735,2024,2209,12251,1484,7818,5917,1.95258e+18,462.517,4451.15,13735,249,359,11526,11526,11519,11520,11334
39150,2381,4001,34961,4189,23495,15655,1.93151e+18,1287.62,9706.18,39150,633,485,35149,34475,31432,31241,26468
44870,2170,2804,0,44870,0,44870,2.15238e+18,1488.56,8405.77,44870,491,525,42066,40574,40490,39865,38475
24341,1069,1958,0,24341,7539,16802,9.21096e+15,449.394,5236.34,24341,341,403,22383,22169,21289,21307,16731
7802,623,789,2474,5328,0,7802,3.5144e+13,217.046,1924.84,7802,199,146,7013,7012,6534,6535,6243
7948,1169,1644,4819,3129,4819,3129,1.81264e+18,288.411,2999.34,7948,231,221,6304,6269,6155,6198,5441
44228,271,2914,13729,30499,0,44228,3.49645e+13,559.268,8025.91,44228,544,351,39817,35449,24167,13461,6937
18450,730,810,18402,48,18425,25,4.20838e+18,297.698,2649.2,18450,172,179,17640,17638,17531,17500,17451
28438,1859,2787,28438,0,25648,2790,1.89775e+18,1249.39,6875.78,28438,458,382,25651,24957,24607,24611,22876
19096,1512,1640,5544,13552,0,19096,3.75987e+13,541.165,4248.4,19096,316,308,17456,17435,17433,17427,17048
48403,2738,3178,28812,19591,0,48403,4.8595e+18,920.578,8995.82,48403,564,373,45225,45224,45044,45068,43494
38923,2383,4477,34910,4013,23545,15378,1.94468e+18,1399.72,10010.7,38923,480,578,34446,33042,30493,30658,26169
48188,1634,2348,13792,34396,0,48188,3.62496e+13,953.865,7793.56,48188,500,401,45840,45441,44700,44737,40533
15918,15,174,0,15918,15591,327,2.47254e+16,111.498,1064.96,15918,71,73,14742,14180,12156,11297,6430
47490,94,368,0,47490,46770,720,2.67049e+16,171.116,2726.51,47490,118,139,46690,45936,38339,36013,26376
34729,409,1220,10855,23874,0,34729,3.07681e+13,746.402,4610.71,34729,331,343,32470,31381,27570,27271,15114
17783,4,5,16672,1111,17719,64,0.000224934,0.999719,294.586,17783,5,1,17778,17778,17778,17778,17778
16871,1109,1788,14938,1933,10697,6174,1.89247e+18,743.597,4285.9,16871,270,253,15083,14775,13159,13167,10588
2772,47,324,2772,0,2772,0,4.05935e+18,167.66,805.523,2772,80,74,1844,1267,950,908,434
3435,1013,1183,3066,369,1979,1456,1.94709e+18,187.309,1780.61,3435,143,141,2252,2252,2230,2241,2059
46437,1784,2752,41317,5120,28764,17673,1.97111e+18,1282.39,8148.97,46437,462,429,43685,42657,42596,42709,36143
2617,567,871,2401,216,1579,1038,2.13895e+18,77.2793,1251.96,2617,123,115,1746,1740,1709,1713,1350
25583,558,4191,25583,0,23058,2525,1.58474e+18,621.683,8078.88,25583,462,407,20848,19139,12014,7958,3314
6557,686,1067,1940,4617,0,6557,3.62575e+13,181.038,2134.9,6557,185,188,5490,5464,5435,5424,4295
39434,45,71,38368,1066,39424,10,9.68041e+13,19.1777,765.395,39434,29,28,39363,39363,38320,38321,33836
33370,928,3379,19584,13786,19584,13786,1.75751e+18,679.178,8020.73,33370,460,379,29558,28498,22669,21155,12028
48795,1804,4690,29432,19363,29432,19363,1.81492e+18,907.902,11024.7,48795,693,403,44105,43217,33676,33315,17960
40845,2001,4072,40845,0,36444,4401,2.73484e+18,1352.21,9723.69,40845,500,648,36773,34623,29665,28163,27467
12843,6,42,12548,295,12843,0,9.65868e+13,15.5278,401.104,12843,20,21,12387,11995,10495,10482,6204
40072,3037,3241,0,40072,0,40072,2.39611e+18,822.612,8387.23,40072,458,443,36831,36824,36761,36804,36321
48240,1277,3762,43335,4905,29375,18865,1.95899e+18,1355.02,9815.55,48240,563,493,43309,41444,32288,30755,22949
43784,129,338,0,43784,42808,976,2.70019e+16,140.504,2410.91,43784,118,115,43352,43071,39297,37144,30381
9685,59,1220,5655,4030,0,9685,5.09144e+18,437.6,2741.03,9685,234,195,6304,4639,3920,3148,984
6449,166,437,6449,0,6449,0,4.30497e+18,228.052,1360.3,6449,115,118,5765,5106,4023,3808,2947
2449,276,658,1390,1059,0,2449,4.32523e+18,103.891,1090.43,2449,118,99,1791,1705,1624,1571,1169
18328,542,1497,0,18328,5522,12806,9.13249e+15,357.524,3870.7,18328,301,249,16831,16453,15080,15209,10119
16238,521,2636,16238,0,14507,1731,1.95265e+18,463.878,5124.33,16238,374,284,13512,12107,9773,8713,6060
20060,143,2968,18108,1952,12033,8027,1.96879e+18,562.274,6150.66,20060,263,444,13756,11141,8108,6746,1190
28744,1450,1951,0,28744,8361,20383,9.23307e+15,477.724,5397.01,28744,432,357,26793,26783,25673,25794,22608
24472,7,42,24090,382,24472,0,1.00228e+14,20.653,560.425,24472,25,24,23829,23527,20317,20251,13280
21956,671,2253,13508,8448,13508,8448,1.83642e+18,760.232,5331.04,21956,341,374,19340,18276,16036,14676,6375
10891,5,41,10580,311,10891,0,1.04723e+14,16.865,375.476,10891,23,19,10294,9828,8881,8987,4848
8852,384,397,8852,0,8852,0,4.11095e+18,209.992,1474.79,8852,120,128,8455,8455,8447,8449,8429
41697,617,3922,0,41697,0,41697,2.39542e+18,1176.99,9737.76,41697,503,639,35502,33066,20504,15400,7443
43021,312,357,0,43021,42263,758,2.5898e+16,161.586,2600.22,43021,120,123,42664,42660,42199,41905,41330
32628,1359,1761,10509,22119,0,32628,3.53354e+13,552.86,5436.9,32628,366,397,30867,30805,30551,30602,28366
8866,17,34,8688,178,8866,0,9.62275e+13,16.3577,334.582,8866,19,21,8829,8816,8332,8294,6193
48657,457,4437,0,48657,0,48657,2.35765e+18,1124.45,11145.7,48657,592,457,40549,36340,24216,19350,5390
31958,1662,2511,19313,12645,19313,12645,1.87299e+18,826.115,6812.24,31958,478,392,29447,29206,26824,25703,23042
3055,104,467,0,3055,917,2138,6.687e+15,109.443,980.488,3055,95,99,2423,1865,1902,1905,1086
21120,2970,3110,21120,0,18631,2489,2.98966e+18,757.5,6378.81,21120,403,343,18010,18009,17994,17991,17689
853,3,8,840,13,853,0,1.03945e+14,7.69871,70.7371,853,8,8,746,700,592,600,638
2265,11,16,2238,27,2265,0,1.05258e+14,10.5828,136.043,2265,13,14,2245,2240,2169,2171,1732
48411,3352,4861,42905,5506,27409,21002,1.92361e+18,1139.47,11737.8,48411,640,501,43550,43364,41887,42224,36357
28606,218,254,0,28606,28150,456,2.53963e+16,139.129,1760.26,28606,88,99,28352,28337,27922,27701,27152
1887,26,509,0,1887,0,1887,2.34638e+18,185.449,833.649,1887,113,119,958,608,494,244,70
36493,292,298,0,36493,35859,634,2.5075e+16,158.08,2236.15,36493,117,119,36195,36194,36190,36186,36135
7931,461,1242,0,7931,0,7931,2.30761e+18,247.901,2514.76,7931,237,160,6689,6490,6083,5714,3076
23604,14,56,23308,296,23604,0,1.04486e+14,17.7498,599.309,23604,23,26,23501,23448,20846,20620,12377
14255,239,1293,0,14255,4525,9730,8.23854e+15,265.378,3261.5,14255,186,301,12704,12037,10708,10815,5836
18097,1525,1671,0,18097,0,18097,2.31836e+18,744.793,4310.79,18097,335,270,16426,16425,16256,16252,15895
23378,96,1631,0,23378,0,23378,2.11148e+18,590.634,4621.88,23378,284,312,16252,11895,7870,7090,1577
3524,672,843,3078,446,2074,1450,2.02978e+18,258.07,1518.19,3524,107,158,2681,2668,2626,2617,2510
30102,2382,2611,17698,12404,17698,12404,1.90976e+18,1209.28,6697.11,30102,543,344,27491,27024,27304,27356,26603
44125,4120,4665,44125,0,39077,5048,1.93929e+18,1282.65,10964.4,44125,458,581,39460,39451,39309,39193,37435
27017,387,701,27017,0,27017,0,3.97134e+18,323.245,3011.37,27017,185,192,26298,25943,22741,22363,20562
20254,86,253,0,20254,19854,400,2.61207e+16,123.685,1566.47,20254,83,89,19828,19486,17464,16581,12679
8447,293,917,0,8447,0,8447,1.89235e+18,151.064,2076.96,8447,139,168,7530,7416,7150,7069,4726
23495,1867,2368,14181,9314,14181,9314,1.7917e+18,864.872,5847.8,23495,440,453,21127,20932,20501,20428,19662
44648,79,2696,0,44648,13547,31101,8.96411e+15,784.479,8142.95,44648,535,509,34485,29534,19793,17116,4291
23215,1729,2476,13968,9247,13968,9247,1.9249e+18,647.603,5846.44,23215,314,478,20739,20733,20379,20469,18071
33120,2136,3493,19350,13770,19350,13770,1.80733e+18,923.304,8161.43,33120,440,429,29627,29351,27637,27717,20807
17078,150,192,0,17078,16718,360,2.37717e+16,115.462,1176.18,17078,65,68,16886,16819,16423,16495,15482
11249,1151,1250,0,11249,3459,7790,9.44038e+15,256.757,2974.35,11249,181,287,9999,9999,9994,9994,9849
12432,1062,1089,3797,8635,0,12432,3.62967e+13,322.57,2859.69,12432,274,233,11343,11343,11343,11343,11315
33804,805,2153,19800,14004,19800,14004,1.87797e+18,890.68,6193.2,33804,394,414,31092,30060,28303,26667,18426
14981,720,1163,0,14981,4499,10482,9.30287e+15,355.718,3177.25,14981,299,201,13818,13704,13114,13184,11776
43294,170,322,0,43294,42464,830,2.59277e+16,144.801,2388.33,43294,111,112,42962,42821,40066,38925,32129
16038,367,1655,0,16038,5033,11005,8.28287e+15,348.314,4041.84,16038,355,275,14271,13259,10973,10614,6230
39938,1744,1949,12123,27815,0,39938,3.21229e+13,680.711,6330.8,39938,332,364,37989,37983,37941,37935,36849
43258,2069,2882,25915,17343,25915,17343,1.7166e+18,1021.59,7922.79,43258,407,405,40376,39979,39832,39975,36930
1483,160,441,0,1483,0,1483,2.24553e+18,148.475,708.086,1483,104,81,989,815,777,788,431
28013,14,40,27632,381,28013,0,1.01033e+14,17.9171,567.853,28013,22,23,27931,27877,25416,25155,17105
35701,283,3090,21422,14279,0,35701,4.8853e+18,1098.34,7952.94,35701,491,497,28334,24193,18092,15544,5070
26334,1355,3116,15419,10915,15419,10915,1.78308e+18,1062.67,6915.99,26334,420,543,23055,21977,20297,19847,12928
29953,4144,4212,29953,0,27043,2910,2.26494e+18,716.358,8743.45,29953,322,488,25741,25741,25741,25741,25658
29546,1756,3199,29546,0,26551,2995,1.65784e+18,762.975,7224.95,29546,309,417,26347,26066,25383,25663,21735
45955,4567,5330,27258,18697,0,45955,4.95564e+18,757.468,11808.4,45955,374,781,40625,40623,40309,40350,37398
14942,1500,2275,14942,0,13524,1418,2.02334e+18,526.694,4805.61,14942,331,296,12667,12619,12293,12283,9672
33342,1765,3103,19419,13923,19419,13923,1.78749e+18,892.704,7652.08,33342,478,434,30239,29848,28763,28250,20685
37388,3748,4633,33210,4178,22630,14758,1.92762e+18,803.247,10239.3,37388,422,606,32755,32751,32324,32459,30280
22064,78,263,0,22064,21692,372,2.63489e+16,118.834,1688.65,22064,82,91,21598,21210,18927,17710,13351
21218,347,1502,6583,14635,0,21218,3.60944e+13,375.854,4058.27,21218,327,246,19345,17472,15127,15372,10067
38340,230,1896,0,38340,10906,27434,9.50088e+15,743.341,6135.18,38340,397,407,33395,29464,21191,21195,9790
28809,1244,2148,0,28809,9097,19712,8.69773e+15,501.736,5876.37,28809,349,372,26661,26493,25605,25571,20023
37197,58,92,36472,725,37197,0,1.02815e+14,19.7333,806.42,37197,30,32,37105,37105,36123,36138,30875
32661,355,1636,0,32661,9807,22854,8.09577e+15,583.727,5132.78,32661,309,320,29963,28680,25878,26055,7551
31568,1444,2798,18844,12724,18844,12724,1.80712e+18,844.117,7060.52,31568,441,386,28770,28024,27270,27086,19721
26378,338,924,26372,6,26378,0,4.25544e+18,274.904,3135.47,26378,188,198,25454,25209,18062,17518,14762
18400,87,242,0,18400,17950,450,2.66222e+16,91.8173,1444.06,18400,80,76,18113,17895,16221,15645,12365
40911,170,2625,0,40911,0,40911,2.40692e+18,1333.41,7731.14,40911,504,434,30852,25493,19853,14473,3603
33593,196,1452,9536,24057,0,33593,3.75919e+13,736.239,4957.36,33593,385,303,28758,24858,21713,21207,9135
6866,222,1973,6060,806,4112,2754,1.94842e+18,248.148,3108.71,6866,305,194,4678,3922,2378,2160,985
45577,1110,2269,0,45577,14337,31240,9.20343e+15,618.961,6566.86,45577,470,399,43308,42984,39125,39440,32818
38061,41,43,37395,666,38061,0,9.6495e+13,18.5113,662.097,38061,23,24,38018,38018,37625,37625,37656
25059,230,698,25059,0,25059,0,4.04951e+18,295.52,2888.4,25059,187,188,23938,22427,16208,15598,13029
13272,1557,2046,12175,1097,7920,5352,1.9611e+18,905.008,4239.85,13272,269,312,11226,10336,10757,10717,8858
31601,1536,4463,28569,3032,18147,13454,1.97127e+18,707.567,9079.79,31601,457,512,27138,26286,20142,20514,12698
4840,327,612,0,4840,1586,3254,8.47999e+15,216.918,1374.61,4840,152,127,4228,3912,3845,3851,3401
14385,1726,2217,0,14385,0,14385,2.51064e+18,351.058,4496.13,14385,253,312,12168,12145,12004,12094,10932
17791,1021,1620,10435,7356,0,17791,4.87677e+18,719.874,4123.92,17791,327,293,16117,15429,15199,14859,12520
25318,2735,2759,15588,9730,0,25318,4.59815e+18,669.022,6178.21,25318,435,421,22559,22559,22559,22558,22536
7449,1054,1327,6611,838,4520,2929,1.9197e+18,405.305,2666.9,7449,193,234,6122,6040,6020,6060,5790
12148,163,1043,3503,8645,0,12148,3.65588e+13,332.021,2711.08,12148,254,182,10048,8839,6455,6389,2260
13810,437,1467,0,13810,4303,9507,8.43539e+15,310.596,3521.89,13810,199,294,12343,11882,10913,10879,5294
26029,28,537,26029,0,26029,0,4.43045e+18,291.466,2774.77,26029,179,184,15968,10090,6442,6197,2158
17013,845,1038,5534,11479,0,17013,3.3724e+13,442.639,3338,17013,275,284,15975,15966,15483,15508,14603
48491,1331,3630,0,48491,0,48491,2.36343e+18,1074.56,9877.21,48491,459,540,44649,43332,36292,33992,20532
5017,889,1144,4559,458,2985,2032,1.85217e+18,285.297,2086.18,5017,196,184,3873,3868,3578,3544,3354
11809,148,2210,7176,4633,0,11809,5.09025e+18,472.659,4053.53,11809,245,299,8592,7289,5488,4702,1049
12565,1330,1389,3816,8749,0,12565,3.67997e+13,399.798,3382.07,12565,286,258,11176,11176,11173,11168,10986
1621,293,611,974,647,974,647,1.82488e+18,101.463,876.413,1621,80,124,1010,933,937,929,702
48779,361,3182,29903,18876,0,48779,4.89403e+18,831.2,8691.72,48779,420,516,42736,33774,24111,19452,10840
46848,1152,5853,41943,4905,28338,18510,1.98259e+18,1173.9,12695.9,46848,455,741,39808,36617,29003,27932,14533
662,146,185,662,0,662,0,3.46573e+18,51.2704,313.21,662,62,36,477,470,397,399,399
6061,766,1605,5548,513,3694,2367,1.9815e+18,310.813,2614.52,6061,213,207,4456,4271,3651,3780,2035
25482,563,1519,7542,17940,0,25482,3.54318e+13,581.076,4673.59,25482,334,289,23569,22653,22150,22195,13350
8171,795,958,8171,0,7308,863,2.93316e+18,537.961,2376.98,8171,205,214,7213,7207,6777,6775,6790
29635,268,279,0,29635,29165,470,2.61874e+16,142.626,1893.79,29635,102,102,29356,29356,29330,29304,29246
46215,837,4096,46215,0,46215,0,8.89201e+15,3732.97,13755.8,46215,4096,12,9196,0,5020,8360,9196
33344,1909,4173,33344,0,29671,3673,2.27684e+18,1067.23,8908.13,33344,499,471,29171,28325,26732,25753,16905
18086,1049,1734,18086,0,16225,1861,1.73913e+18,771.136,4497.48,18086,307,305,16352,15823,15528,15250,13520
44178,178,1208,43954,224,44153,25,4.07343e+18,400.983,4394.93,44178,238,235,40560,36064,22999,22424,14340
43982,959,1026,43957,25,43982,0,4.19188e+18,373.208,4114.31,43982,235,235,42956,42954,42865,42893,42842
42620,758,913,42608,12,42574,46,4.19902e+18,376.425,4008.06,42620,221,241,41707,41698,40732,40797,40694
36662,47,317,0,36662,35939,723,2.65043e+16,138.434,2183.23,36662,104,107,35264,34162,29085,25468,15280
25551,1707,3376,0,25551,0,25551,2.40556e+18,606.328,7197.08,25551,401,383,22175,21960,20293,20761,15374
33147,702,723,33147,0,33147,0,4.18405e+18,324.991,3341.23,33147,187,202,32424,32424,32308,32336,32312
44061,460,1229,44049,12,44061,0,4.14246e+18,370.144,4432.2,44061,238,243,42832,42481,31925,31611,27482
31496,1958,1959,0,31496,9575,21921,8.64332e+15,526.337,5836.49,31496,339,410,29537,29537,29537,29537,29537
11102,30,44,10923,179,11092,10,1.022e+14,18.0903,422.396,11102,22,23,11058,11053,10504,10523,8456
1502,244,462,863,639,0,1502,4.85042e+18,73.7383,700.729,1502,102,78,1040,984,1000,1010,741
2950,315,421,2950,0,2950,0,4.0556e+18,147.386,916.631,2950,88,99,2529,2496,2378,2387,2165
47228,134,404,0,47228,46278,950,2.63374e+16,161.956,2979.53,47228,121,133,46698,46354,40347,37830,29151
6408,17,30,6255,153,6408,0,1.08233e+14,13.7093,267.621,6408,18,18,6376,6369,5999,6001,4634
16751,742,2281,9920,6831,9920,6831,1.8185e+18,696.226,4937.73,16751,337,367,14086,13009,9568,9126,4424
33621,816,1785,0,33621,9506,24115,9.61555e+15,831.926,5730.22,33621,420,410,31417,30574,28469,28641,16457
32922,26,45,32409,513,32922,0,1.01563e+14,20.3304,604.632,32922,24,27,32877,32873,32123,32125,30414
8394,422,462,8394,0,8394,0,4.26663e+18,219.742,1517,8394,127,129,7932,7928,7844,7846,7877
21189,1703,2114,12770,8419,0,21189,5.09429e+18,686.371,5195.23,21189,365,302,19075,19057,18954,18919,17915
34598,29606,34598,34598,0,0,34598,268428000,0,34598,34598,34598,1,0,0,0,0,0
24444,3048,3098,24444,0,21781,2663,2.84737e+18,1084.37,6921.83,24444,425,385,21346,21346,21346,21346,21308
39216,1702,2412,23737,15479,23737,15479,1.92528e+18,1025.89,7117.18,39216,472,442,36804,36634,35868,35504,33446
9229,796,1796,8281,948,5483,3746,1.97845e+18,365.939,3348.18,9229,251,302,7433,7282,6679,6722,3139
2109,229,573,1258,851,0,2109,4.19507e+18,112.286,963.923,2109,102,108,1536,1493,1378,1388,477
2549,1,2,2390,159,2533,16,0.000392311,0.999215,65.066,2549,2,1,2547,2547,2547,2547,2547
18916,931,1497,0,18916,5691,13225,9.18394e+15,544.389,4001.96,18916,293,334,17419,17075,16852,16835,13249
47984,1715,3526,0,47984,0,47984,2.37196e+18,1048.44,9695.84,47984,438,581,44458,43652,41129,37654,28448
2510,411,972,2510,0,2224,286,2.03363e+18,167.301,1394.99,2510,149,129,1538,1375,1089,1134,980
28511,30,244,0,28511,28148,363,2.4753e+16,141.64,1617.58,28511,98,98,27036,26126,22336,20687,13285
32471,2762,3572,32446,25,28963,3508,2.35685e+18,1020.01,8233.07,32471,380,584,28899,28868,27914,27655,25171
2144,69,136,0,2144,2111,33,2.40977e+16,41.9263,368.257,2144,40,38,2008,1965,1890,1916,1669
23399,77,2011,6902,16497,0,23399,3.66152e+13,514.615,5144.04,23399,292,367,18137,15718,11642,3670,2643
38661,739,3610,21549,17112,21549,17112,1.62784e+18,941.369,8482.06,38661,545,500,34302,32421,26209,26241,10980
24587,1439,3096,14043,10544,14043,10544,1.78721e+18,687.179,6686.18,24587,351,437,21491,21003,20306,19705,10850
8769,876,1726,0,8769,0,8769,2.47506e+18,273.86,3116.87,8769,220,182,7043,6941,6778,6747,4681
20994,1189,1441,6448,14546,0,20994,3.60475e+13,499.892,4238.6,20994,295,318,19553,19553,19485,19462,18756
39390,1894,2662,23553,15837,23553,15837,1.84102e+18,923.904,7292.83,39390,405,416,36728,36232,36135,36395,32492
16701,1110,1864,0,16701,5397,11304,8.64174e+15,373.106,4416.58,16701,359,300,14837,14798,13581,13471,10281
44288,825,1923,12746,31542,0,44288,3.6562e+13,736.299,6518.81,44288,442,344,42117,40771,38019,38192,25657
5971,177,1094,3507,2464,0,5971,4.82736e+18,224.3,2059.65,5971,254,131,4484,3787,2619,2643,1066
41965,2907,3401,25456,16509,25456,16509,1.87239e+18,862.93,8671.65,41965,488,544,38564,38559,38464,38481,37390
8233,121,183,0,8233,8076,157,2.68959e+16,79.7485,837.362,8233,66,66,8050,8017,7650,7710,6430
46112,886,1018,46112,0,46112,0,4.23937e+18,378.855,4254.68,46112,237,238,45094,45087,44884,44879,44839
47969,507,3327,28455,19514,0,47969,4.72871e+18,951.458,8940.86,47969,512,504,42815,40021,28466,25400,13778
33408,1,82,32935,473,33408,0,1.02672e+14,19.5433,753.991,33408,30,28,13615,13615,13615,13615,13615
16085,2350,2469,9472,6613,0,16085,4.71528e+18,506.29,4846.79,16085,307,318,13616,13541,13599,13595,12883
28920,1955,2187,17524,11396,17524,11396,1.81118e+18,828.498,5913.76,28920,418,433,26733,26731,26559,26653,26032
39224,2212,2241,12526,26698,0,39224,3.4709e+13,711.766,6840.77,39224,435,515,36983,36983,36980,36981,36914
47858,3493,3928,41912,5946,27942,19916,1.92811e+18,1203.17,10566.6,47858,619,466,43930,43928,43878,43892,42738
45271,102,3681,27203,18068,0,45271,4.83591e+18,921.757,9446.2,45271,487,486,30836,24377,17865,14237,2882
30467,487,841,30467,0,30467,0,4.46833e+18,345.951,3360.1,30467,197,200,29626,29513,25290,25052,24437
6536,225,1457,0,6536,0,6536,2.37935e+18,182.189,2483.16,6536,192,178,5029,4490,3632,2640,775
7839,691,1702,4714,3125,0,7839,5.06416e+18,243.309,2902.73,7839,195,214,6137,5981,5776,5730,2726
14144,372,538,14144,0,14144,0,4.27947e+18,286.436,2096.07,14144,151,158,13606,13524,12500,12326,11786
42261,423,940,42253,8,42261,0,4.10881e+18,334.936,3980.54,42261,229,212,41321,41033,33782,33536,28373
42071,274,306,0,42071,41501,570,2.52085e+16,156.909,2269.15,42071,104,109,41765,41760,41660,41509,40934
13227,1652,1984,7865,5362,0,13227,5.11691e+18,407.585,3935.69,13227,269,244,11243,11135,11128,11130,10521
1929,60,440,637,1292,0,1929,3.9851e+13,105.117,793.142,1929,79,123,1354,1126,890,966,345
16785,121,1607,0,16785,0,16785,2.48456e+18,882.343,4021.16,16785,281,309,11936,9544,7385,5146,1986
7436,1073,1884,6750,686,4398,3038,1.97165e+18,275.246,3124.03,7436,259,205,5552,5493,5048,5064,4055
48947,1701,2710,13614,35333,0,48947,3.69893e+13,937.295,8552.97,48947,663,512,46237,45770,44442,44514,34716
22019,171,3133,19729,2290,13189,8830,1.96492e+18,808.137,6620.16,22019,371,413,14887,11743,6149,5392,1007
32432,235,3749,18768,13664,18768,13664,1.67795e+18,728.189,8348.02,32432,511,427,25924,23105,12996,10028,2600
18327,223,1663,11084,7243,0,18327,4.70643e+18,852.942,4360.97,18327,298,311,14133,12004,7714,6250,1944
11091,279,1551,11091,0,9924,1167,3.07479e+18,704.925,3415.93,11091,280,229,8219,6443,3847,2559,2766
29518,908,1637,0,29518,9027,20491,8.63615e+15,619.591,5023.64,29518,373,342,27881,27259,26691,26700,21948
28642,2619,2699,16356,12286,0,28642,4.44979e+18,718.723,6446.86,28642,505,283,25943,25943,25931,25926,25733
8120,155,189,0,8120,7969,151,2.55131e+16,74.8789,883.188,8120,62,57,7931,7925,7913,7920,7541
38834,4,53,38096,738,38834,0,1.00822e+14,18.8525,681.667,38834,25,25,35027,32516,30467,30839,17624
8861,94,161,0,8861,8784,77,2.50385e+16,53.7835,786.971,8861,48,54,8700,8647,8095,8120,6500
44073,469,769,44057,16,44073,0,4.07414e+18,353.952,3799.54,44073,219,224,43304,43195,38573,37977,36566
41921,1970,2339,12686,29235,0,41921,3.56317e+13,783.201,7337.5,41921,520,543,39582,39567,38977,39031,37668
15978,282,478,15978,0,15978,0,4.19014e+18,295.955,2119.36,15978,153,150,15367,14833,13042,13176,11578
46092,341,3495,27523,18569,0,46092,4.67797e+18,1128.93,8997.98,46092,560,514,37722,32591,18943,13844,5991
30407,766,2134,0,30407,9281,21126,9.24094e+15,789.37,6013.91,30407,469,349,27908,27075,22474,22245,14237
35066,802,2217,35066,0,31698,3368,1.41872e+18,1112.47,6252.76,35066,409,347,31559,29977,17976,15433,20963
32811,330,866,32811,0,32811,0,4.14458e+18,326.593,3524.98,32811,212,208,31859,31258,23386,22832,20610
11109,868,2482,11109,0,9701,1408,1.2554e+18,427.933,4391.58,11109,333,274,8627,8025,6784,6618,4740
766,298,356,470,296,0,766,4.3863e+18,39.3655,476.236,766,100,47,410,409,410,410,396
42563,1720,1904,13231,29332,0,42563,3.34058e+13,494.048,6158.32,42563,371,311,40659,40659,40456,40476,39653
47719,183,318,0,47719,46603,1116,2.66946e+16,125.071,2341.37,47719,99,107,47401,47341,44311,44030,38049
915,353,477,915,0,833,82,1.43222e+18,51.0732,606.382,915,102,71,438,421,412,434,285
16726,143,994,5174,11552,0,16726,2.91008e+13,500.148,2903.59,16726,236,241,14687,13643,8220,7367,1836
27744,692,1677,0,27744,8868,18876,8.52668e+15,491.629,4980.26,27744,393,255,26052,25420,22421,22795,15052
9855,530,1603,5648,4207,0,9855,4.35967e+18,354.573,3204.31,9855,189,286,8207,7927,6011,6055,2755
36955,147,1797,0,36955,11269,25686,8.75867e+15,810.98,5922.6,36955,380,392,31693,28846,18893,17098,4997
27840,1135,2929,16665,11175,0,27840,4.88151e+18,699.852,6854.68,27840,439,396,24814,24013,21245,21008,11606
20099,1295,2277,0,20099,0,20099,2.39836e+18,599.064,5099.3,20099,337,308,17822,17721,16900,16208,13741
41234,447,3178,37384,3850,23466,17768,1.93307e+18,1108.38,8218.5,41234,491,368,34977,31484,17622,15748,8452
25001,1,53,24598,403,24956,45,1.0126e+14,19.5692,632.012,25001,24,26,10174,10174,10174,10174,10174
20803,1737,2928,18851,1952,12051,8752,1.9273e+18,464.599,5889.03,20803,342,270,17875,17828,16959,16892,15128
26983,2055,3198,26983,0,23719,3264,2.32511e+18,693.349,7048.5,26983,343,561,23785,23490,22400,22450,18587
4612,878,1047,2780,1832,2780,1832,1.94957e+18,247.905,1787.9,4612,151,176,3565,3522,3522,3549,3254
34523,55,4295,31035,3488,20553,13970,1.95066e+18,1083.47,9423.34,34523,446,453,19013,12699,8053,6564,673
10895,706,1026,0,10895,3126,7769,9.40469e+15,419.699,2610.76,10895,229,238,9869,9519,9653,9626,8273
41150,696,1870,11811,29339,0,41150,3.75688e+13,850.198,6213.11,41150,492,372,38700,37119,34299,34419,19042
45189,2291,2541,13015,32174,0,45189,3.72433e+13,809.489,8007.4,45189,464,509,42648,42577,42500,42476,40819
46319,647,1187,46247,72,46319,0,4.12834e+18,388.983,4418.87,46319,229,236,45132,45041,39527,39274,36628
17033,30,2744,15400,1633,10071,6962,1.91893e+18,475.647,5451.29,17033,298,374,8084,4839,2964,2517,199
35118,756,898,35118,0,35118,0,4.03509e+18,331.599,3618.33,35118,208,218,34220,34216,33861,33840,33388
2715,577,848,2715,0,2371,344,2.60477e+18,120.857,1326.39,2715,104,119,1867,1858,1726,1687,1352
37293,509,922,37264,29,37293,0,4.21484e+18,353.298,3771.72,37293,216,218,36371,36240,30634,30553,26375
23075,127,2419,0,23075,0,23075,2.34389e+18,653.741,5702.72,23075,375,378,16454,13585,9851,7191,1913
39223,505,1824,23641,15582,23641,15582,1.88596e+18,728.266,6113.42,39223,414,383,34470,29019,28279,27211,17438
21658,3094,3193,12912,8746,12912,8746,1.78896e+18,615.639,6549.5,21658,394,452,18465,18465,18450,18451,18368
36052,1579,2856,0,36052,0,36052,2.24128e+18,804.739,7479.84,36052,489,337,33196,32878,28594,22215,23043
45528,157,271,0,45528,44190,1338,2.48961e+16,155.039,2313.77,45528,110,110,45202,44965,42048,41663,36409
11844,948,1397,3496,8348,0,11844,3.74255e+13,314.569,3274.01,11844,240,251,10447,10401,10275,10272,8142
43578,777,2900,0,43578,0,43578,2.33231e+18,952.594,8130.4,43578,445,406,39772,37979,25319,24565,12221
24917,31,54,24447,470,24917,0,9.82346e+13,17.9454,574.526,24917,24,25,24863,24860,23843,23843,18966
18201,484,1994,11090,7111,0,18201,4.89182e+18,426.073,4600.85,18201,295,326,15788,14238,12954,12819,4742
36813,924,3056,0,36813,0,36813,2.36464e+18,911.122,7881.83,36813,387,445,33219,31674,28925,18442,17037
2830,42,367,2824,6,2830,0,3.896e+18,143.875,854.009,2830,92,82,1768,1039,927,913,465
4464,1,20,4328,136,4464,0,9.19967e+13,13.8976,201.823,4464,16,17,1886,1886,1886,1886,1886
41715,2196,2254,0,41715,12832,28883,9.12812e+15,774.587,6974.09,41715,523,447,39461,39460,39449,39448,39351
39827,195,273,0,39827,39162,665,2.4512e+16,124.49,2047.8,39827,106,101,39554,39522,38933,38789,37373
28726,1870,3389,25651,3075,17473,11253,1.95194e+18,1010.98,7773.41,28726,394,396,25337,24583,23368,23578,16288
10996,476,1121,3528,7468,0,10996,3.54121e+13,302.245,2827.43,10996,233,229,9875,9482,8761,8746,6234
15240,14,45,15039,201,15240,0,1.03429e+14,17.9934,491.353,15240,22,26,15144,15084,13445,13378,10335
23281,93,280,0,23281,22800,481,2.62034e+16,119.284,1708.86,23281,89,105,22842,22437,19996,18818,15028
19978,38,42,19682,296,19978,0,9.99494e+13,17.3572,487.98,19978,22,25,19936,19936,19873,19873,19708
43984,676,4565,39338,4646,26539,17445,1.97652e+18,1480.46,10800.3,43984,521,488,36919,33002,21382,19981,11660
39459,182,328,0,39459,38817,642,2.56427e+16,141.601,2405.11,39459,105,103,39131,39041,36823,36788,31735
7663,452,873,2494,5169,0,7663,3.46318e+13,231.685,2089.14,7663,208,196,6790,6675,5828,5909,4493
22798,661,2006,0,22798,0,22798,2.4579e+18,636.623,5230.85,22798,321,334,20092,18438,17392,13924,10148
8500,605,783,2632,5868,0,8500,2.87609e+13,142.14,1903.78,8500,153,162,7717,7716,7684,7711,5801
31020,499,2753,9435,21585,0,31020,3.5196e+13,462.633,7042.1,31020,342,628,27981,26793,22483,22710,5481
12157,392,1924,12157,0,10857,1300,1.55526e+18,712.211,3957.11,12157,309,268,9203,7723,4942,4595,2394
35223,1840,4415,35223,0,31685,3538,2.2833e+18,853.805,9169.35,35223,516,442,30808,30057,28568,27539,20067
26817,224,289,0,26817,26422,395,2.57631e+16,124.123,1847.05,26817,92,95,26528,26510,25903,25811,24144
46412,1524,3923,46412,0,40815,5597,2.77519e+18,1598.84,10095.9,46412,482,478,41809,39586,36867,34185,24907
35552,2026,2689,31807,3745,21552,14000,2.02026e+18,1074.48,7411.51,35552,444,408,32863,32854,32565,32600,31027
10189,747,1456,5915,4274,5915,4274,1.68188e+18,298.005,3078.7,10189,268,214,8733,8678,8296,7964,6756
5312,49,683,0,5312,1618,3694,9.38178e+15,212.67,1539.35,5312,138,151,3660,2981,2296,2385,904
23232,501,865,23232,0,23232,0,4.00549e+18,355.05,3013.74,23232,183,192,22367,22220,19568,19357,17988
48490,3172,4938,27895,20595,0,48490,4.67357e+18,809.896,11572,48490,611,746,43552,43506,41087,40489,33869
19856,1536,2517,17519,2337,11749,8107,1.90963e+18,1076.65,5616.2,19856,396,383,17339,16313,15259,15302,12169
39467,1360,2043,0,39467,11606,27861,9.48814e+15,555.811,6162.84,39467,312,398,37424,37213,37078,37002,31521
36570,1885,3164,36570,0,32737,3833,1.75206e+18,1007.67,8160.24,36570,382,469,33406,32703,31167,30561,26729
36000,137,738,36000,0,36000,0,4.06038e+18,352.562,3487.82,36000,204,204,32240,27967,18687,18000,10497
48337,1369,2753,14772,33565,0,48337,3.50281e+13,786.138,8296.2,48337,483,423,45584,44885,43188,43377,31194
1238,290,1238,1238,0,0,1238,15.9871,0,1238,1238,1238,1,0,0,0,0,0
41070,207,3044,24918,16152,0,41070,4.9294e+18,827.463,8324.47,41070,430,535,31693,26257,19179,16216,3467
27374,15,82,26696,678,27374,0,1.02877e+14,18.8817,714.91,27374,30,29,27249,27201,23911,23647,14043
1812,307,386,0,1812,620,1192,7.53615e+15,69.8013,709.727,1812,116,66,1426,1426,1421,1419,1309
29396,389,964,29396,0,29396,0,4.26432e+18,331.249,3408.48,29396,204,205,28432,28052,22122,21698,18828
35897,4001,4403,32008,3889,21682,14215,1.96166e+18,1021.82,9688.19,35897,507,437,31494,31481,31458,31450,30540
44710,2472,4161,0,44710,0,44710,2.28232e+18,1056.85,10256.2,44710,521,571,40549,40197,38241,35970,28801
44101,918,2395,13151,30950,0,44101,3.58065e+13,688.199,7255.21,44101,470,366,41706,40813,33363,33672,22249
44837,23,72,44157,680,44837,0,1.04443e+14,19.1621,823.972,44837,28,29,44762,44752,41474,40897,29257
46458,852,1008,46458,0,46458,0,4.38208e+18,365.541,4257.42,46458,231,230,45450,45448,44988,45030,43943
27725,2336,2540,16289,11436,0,27725,4.7165e+18,1094.22,6571.57,27725,424,409,25185,25164,24913,24878,24408
17956,1752,1778,10653,7303,10653,7303,1.85819e+18,521.325,4343.83,17956,362,229,16178,16174,16178,16178,16176
5362,53,175,0,5362,5232,130,2.62053e+16,66.9562,708.512,5362,55,60,5125,4944,4381,4242,3029
36936,1879,2395,22249,14687,0,36936,4.86084e+18,973.289,6805.27,36936,376,356,34541,34250,34094,34031,31722
43011,1400,3636,25954,17057,0,43011,4.99665e+18,902.545,9291.73,43011,624,388,39280,38053,29323,27532,20612
40268,380,4587,40268,0,36089,4179,2.27464e+18,1204.49,10300.3,40268,440,487,32511,28220,13050,7781,3544
44554,3198,3446,27012,17542,27012,17542,1.89226e+18,952.033,9110.92,44554,401,542,41108,41108,41029,41053,40765
15063,30,1646,0,15063,0,15063,2.26107e+18,633.147,3898.64,15063,281,303,7880,4723,3571,3486,355
9065,672,1190,0,9065,0,9065,1.99746e+18,244.073,2577.54,9065,182,276,7875,7753,7592,7611,5739
39429,3223,3316,23638,15791,0,39429,4.86246e+18,1052.26,8498.5,39429,550,528,36113,36113,36096,36098,36000
42874,2283,2365,26444,16430,26444,16430,1.87306e+18,893.552,7238.08,42874,450,449,40509,40509,40487,40489,40300
29922,142,825,29922,0,29872,50,4.19597e+18,360.346,3290.81,29922,203,199,26527,22840,14736,14124,9339
1674,271,385,0,1674,492,1182,8.58883e+15,163.059,693.786,1674,129,88,1289,1130,1178,1195,994
26261,2014,2254,0,26261,0,26261,2.32298e+18,838.294,5820.42,26261,398,419,24007,23999,23958,23908,23573
48614,681,959,48614,0,48614,0,4.38024e+18,352.71,4215.05,48614,236,237,47655,47619,44666,44612,41354
41354,120,311,0,41354,40312,1042,2.5825e+16,151.524,2291.58,41354,113,123,40843,40410,36744,34969,26490
30587,44,1898,9163,21424,0,30587,3.31913e+13,608.437,5609.72,30587,382,335,21504,16742,12466,4934,2414
36849,119,226,0,36849,36058,791,2.53881e+16,160.477,1848.36,36849,99,114,36403,36093,33295,32789,26327
7314,635,1241,4433,2881,0,7314,4.98935e+18,332.119,2456.38,7314,220,208,6073,5752,5736,5697,4431
1758,233,427,0,1758,573,1185,8.97789e+15,95.5222,745.153,1758,83,88,1331,1261,1202,1226,863
40060,303,2206,12596,27464,0,40060,3.48906e+13,467.321,6431.39,40060,414,378,36966,33067,21930,19752,12121
44698,1771,2049,12927,31771,0,44698,3.69791e+13,751.797,6860.15,44698,455,355,42649,42615,42559,42533,41539
31581,1886,3104,19509,12072,0,31581,4.85571e+18,619.524,7446.44,31581,346,517,28477,28417,27892,27800,20204
12719,784,2207,12719,0,11193,1526,1.83401e+18,504.185,4425.75,12719,308,332,10350,9532,6920,6202,4577
34699,904,960,34699,0,34699,0,4.03646e+18,322.162,3633.62,34699,221,203,33739,33739,33641,33650,33570
23075,328,698,23023,52,23054,21,4.18361e+18,307.462,2805.94,23075,184,194,22334,21979,16891,16461,13686
1309,185,236,1309,0,1309,0,3.6827e+18,98.3201,492.169,1309,69,54,1073,1044,1054,1049,923
10280,751,997,3180,7100,0,10280,3.48737e+13,269.76,2543.51,10280,213,211,9283,9262,9170,9167,8136
41038,2476,2889,0,41038,0,41038,2.47839e+18,1021.18,7965.51,41038,499,394,38149,38141,37971,37947,36707
35938,962,3994,32271,3667,21689,14249,1.93451e+18,894.623,9097.01,35938,586,417,31434,29473,20662,19109,13166
5428,453,820,5428,0,5038,390,1.24764e+18,449.982,1856.26,5428,175,182,4251,3076,3686,3805,2664
47908,33,294,0,47908,47069,839,2.57109e+16,168.785,2432.78,47908,117,123,45680,44421,37849,33482,19970
37473,227,307,0,37473,36706,767,2.57787e+16,137.587,2263.98,37473,100,119,37166,37131,36017,35725,33330
16874,1351,2032,0,16874,0,16874,2.34312e+18,570.36,4529.69,16874,313,295,14842,14666,14589,14755,12972
6464,564,1246,0,6464,0,6464,2.40517e+18,445.269,2308.97,6464,189,190,5145,4608,4631,3935,3336
41164,2249,5561,41164,0,37024,4140,2.55456e+18,802.168,11613.5,41164,539,612,35603,35207,27985,25952,19334
689,5,49,0,689,685,4,2.29037e+16,9.88099,130.024,689,21,19,578,525,501,503,367
8341,802,1715,7499,842,4981,3360,1.93888e+18,289.627,3077.49,8341,285,161,6626,6568,6087,6009,4975
21012,384,725,21012,0,21012,0,5.057e+18,321.073,2665.72,21012,180,170,20287,19985,17396,17285,16927
4067,18,129,0,4067,3990,77,2.69486e+16,58.2373,509.39,4067,46,43,3763,3643,3192,2855,1923
22400,1526,2549,22400,0,20203,2197,1.73382e+18,482.215,5630.4,22400,302,315,19851,19724,19226,18754,13047
45001,142,893,45001,0,44976,25,4.00585e+18,328.352,4006.94,45001,215,208,41224,36564,23271,22164,14141
25997,728,3137,0,25997,0,25997,2.36114e+18,911.932,6932.67,25997,479,459,22285,21105,15565,14858,9303
33162,2253,2288,19616,13546,0,33162,4.52391e+18,952.69,6399.93,33162,355,395,30874,30874,30865,30864,30814
9108,310,957,2568,6540,0,9108,3.82198e+13,479.15,2359.15,9108,280,197,7701,7078,6603,6729,3882
35661,792,1947,0,35661,11120,24541,8.35696e+15,628.004,6248.56,35661,336,409,33674,32811,30438,30573,17999
32057,167,3497,32057,0,28764,3293,1.58755e+18,986.904,8194.96,32057,522,397,23592,19122,9626,8444,1980
45697,990,2621,0,45697,13063,32634,9.50639e+15,941.392,8222.57,45697,492,522,42697,41144,38828,38768,22020
48540,2092,3631,29442,19098,29442,19098,1.90239e+18,952.663,9361.24,48540,489,504,44909,44198,43603,43977,34047
26213,512,813,26092,121,26213,0,4.15711e+18,376.327,3144.73,26213,201,192,25400,25239,23030,22952,21801
16931,903,2248,9879,7052,9879,7052,1.74069e+18,495.2,4927.79,16931,367,294,14683,14308,11324,11814,8810
42080,1377,4360,42080,0,37946,4134,2.69327e+18,1099.04,10151,42080,481,507,37402,35674,32501,30767,14834
3112,783,923,0,3112,0,3112,2.44533e+18,122.146,1425.37,3112,144,144,2189,2171,2168,2189,2051
15671,915,2081,15671,0,13694,1977,1.12363e+18,836.683,4735.11,15671,328,405,13374,12307,10492,9921,7401
37806,499,889,37806,0,37806,0,4.19049e+18,332.847,3670.3,37806,216,209,36917,36839,32953,32916,29083
27466,1134,1772,0,27466,8786,18680,9.01295e+15,567.259,5111.81,27466,312,403,25694,25396,24355,24293,20644
36106,1237,1851,10013,26093,0,36106,3.69898e+13,681.904,5816.95,36106,392,393,34255,34122,33647,33654,27787
2985,131,337,2985,0,2985,0,4.18595e+18,147.612,825.259,2985,85,67,2556,2276,1786,1712,1233
13077,1049,1427,3851,9226,0,13077,3.72975e+13,337.119,3288.62,13077,259,204,11650,11585,11554,11554,10379
28901,283,284,0,28901,28408,493,2.56158e+16,119.025,1882.98,28901,93,103,28617,28617,28616,28612,28609
38778,289,711,38778,0,38778,0,4.24848e+18,369.811,3602.18,38778,220,214,37686,36725,27429,26561,23201
9209,492,1917,9209,0,8360,849,1.41604e+18,516.264,3388.98,9209,273,214,7089,6015,4150,3750,2532
47704,130,3287,27735,19969,0,47704,4.61054e+18,873.975,9011.8,47704,541,425,35201,29322,16494,12615,1746
47935,166,359,0,47935,47042,893,2.60316e+16,166.724,2687.84,47935,112,124,47525,47306,43066,40102,33763
2867,552,620,2867,0,2608,259,1.90264e+18,328.579,1185.99,2867,135,121,2247,2246,2242,2234,2192
3586,42,404,1007,2579,0,3586,3.44633e+13,209.21,981.758,3586,121,108,2393,1944,1608,1554,405
43894,26,89,43159,735,43894,0,1.04866e+14,18.7118,910.168,43894,31,32,43805,43791,40046,39730,27182
1864,150,438,0,1864,564,1300,9.47258e+15,96.8487,767.821,1864,93,90,1418,1311,1110,1131,636
24470,224,1848,0,24470,7714,16756,9.09665e+15,473.842,5191.77,24470,306,326,21244,19176,14247,13109,5219
37137,1096,3576,21436,15701,21436,15701,1.69017e+18,912.476,8619.5,37137,482,482,33288,32219,27164,27554,15467
48943,1024,1139,48943,0,48943,0,4.50674e+18,374.814,4460.98,48943,237,243,47804,47799,47322,47369,46812
39457,1416,3268,35083,4374,23045,16412,1.9311e+18,1229.27,8571.47,39457,436,468,35813,34120,28372,27310,16266
26402,143,2398,23800,2602,15313,11089,1.92623e+18,891.885,6130.98,26402,295,367,18416,14282,7089,6158,2835
12953,826,1921,7154,5799,7154,5799,1.71928e+18,292.825,3849.65,12953,310,224,11032,10777,10313,9962,6996
30243,1387,2831,0,30243,0,30243,2.38469e+18,781.059,6944.39,30243,554,457,27412,26893,24298,19627,20452
28565,13,258,0,28565,28158,407,2.57884e+16,140.542,1832.88,28565,98,97,25911,24478,21151,17035,10802
33933,253,2014,0,33933,10782,23151,8.21704e+15,474.438,5808.22,33933,391,371,30384,27490,19391,18085,9656
17238,178,191,0,17238,16929,309,2.62347e+16,87.7255,1099.85,17238,69,73,17047,17047,17023,16983,16874
21565,893,1632,6885,14680,0,21565,3.4015e+13,536.437,4624.37,21565,390,344,19933,19652,17408,17485,12432
39763,943,3433,0,39763,0,39763,2.37024e+18,754.866,8588.52,39763,347,529,36023,35008,32253,30796,18131
38327,4198,4295,34052,4275,22809,15518,1.94858e+18,721.4,9444.41,38327,504,413,34032,34032,34030,34030,33963
45343,614,4079,26899,18444,0,45343,4.55728e+18,1056.46,10002.3,45343,586,664,39231,36418,18565,16770,10173
658,12,61,0,658,636,22,2.70491e+16,11.8328,144.28,658,21,19,586,557,506,505,371
44090,706,2635,14171,29919,0,44090,3.42439e+13,551.413,7532.21,44090,460,377,41400,40501,30923,31226,20006
46292,146,4142,26911,19381,0,46292,4.49546e+18,1121.36,10088.1,46292,437,623,35671,29212,18593,14887,2627
27521,1372,2539,0,27521,0,27521,1.96774e+18,603.307,5973.27,27521,411,293,24982,24403,23374,22087,17341
36383,3666,3924,36383,0,32457,3926,2.83018e+18,1085.76,8901.59,36383,422,512,32459,32335,32424,32428,31636
2941,130,625,0,2941,0,2941,2.18929e+18,252.115,1161.32,2941,134,130,1886,1540,1003,838,212
2449,340,591,2449,0,2176,273,2.35866e+18,223.326,1059.15,2449,126,104,1765,1465,1615,1630,1291
23403,622,745,23336,67,23403,0,3.9931e+18,321.598,2899.05,23403,184,171,22658,22650,22188,22186,20982
49262,1154,3577,29153,20109,0,49262,4.70004e+18,1028.83,9621.68,49262,452,529,44935,42095,40604,40079,22748
16154,2519,2743,16154,0,14510,1644,2.45249e+18,399.437,5187.4,16154,288,389,13411,13409,13372,13320,12930
36350,541,1067,36350,0,36350,0,4.28288e+18,343.014,3812.78,36350,228,221,35283,35173,30130,29367,27277
41338,2205,3837,23816,17522,23816,17522,1.78846e+18,753.553,9426.04,41338,388,529,37501,37283,36395,36779,24886
16533,351,2294,9876,6657,0,16533,4.94196e+18,409.849,4751.34,16533,414,314,13582,11412,9829,9179,3370
33092,31062,33092,33092,0,33092,0,1.75917e+13,0,33092,33092,33092,1,0,0,0,0,0
40814,2171,2633,24792,16022,0,40814,4.91754e+18,957.683,7638.61,40814,452,459,38181,38179,37611,37628,34552
20995,2593,2603,20995,0,18595,2400,2.53689e+18,823.902,5924.91,20995,337,360,18392,18392,18392,18392,18392
20098,29,233,0,20098,19495,603,2.52873e+16,124.393,1413.58,20098,74,84,19173,18501,15837,14268,8985
37274,678,2573,11313,25961,0,37274,3.55069e+13,659.19,7239.55,37274,438,558,34231,32927,29005,28979,15942
2198,268,836,1347,851,0,2198,4.54612e+18,90.2625,1203.24,2198,171,116,1362,1288,875,879,734
32864,105,791,32864,0,32864,0,3.83189e+18,356.238,3374.63,32864,217,210,27810,22864,15506,14383,8187
29168,1565,2524,16889,12279,0,29168,4.518e+18,742.364,6470.79,29168,388,468,26644,26449,25377,25169,19117
49232,209,2039,0,49232,14612,34620,9.07046e+15,555.462,6983.03,49232,475,373,42963,37165,26740,24986,9728
45609,153,341,0,45609,44719,890,2.52105e+16,154.928,2579.2,45609,115,126,45199,45048,41073,39286,32449
19142,1412,2722,19142,0,16931,2211,2.99263e+18,817.827,5788.64,19142,325,375,16374,15462,15277,15062,10789
13269,1833,2068,11949,1320,8290,4979,1.90683e+18,626.986,4211.34,13269,317,331,11201,11199,11201,11201,10984
11019,43,711,3594,7425,0,11019,3.6334e+13,374.834,2220.76,11019,217,217,7545,5939,4593,2182,1596
6676,21,503,6670,6,6676,0,3.85593e+18,234.718,1432.2,6676,108,112,3801,2488,1780,1595,197
45509,326,1187,45509,0,45484,25,4.04598e+18,395.491,4473.65,45509,239,247,43948,42510,30330,29005,19426
41011,1779,4088,36558,4453,23799,17212,1.98065e+18,1124.69,9702.63,41011,439,552,36923,35594,33584,33844,21138
31707,673,2716,0,31707,0,31707,2.43333e+18,893.684,6786.75,31707,363,463,28292,27168,23405,21173,7592
11773,1160,1551,6772,5001,6772,5001,1.81392e+18,429.47,3335.28,11773,231,301,10222,10147,9973,10047,8206
44811,305,2727,0,44811,13394,31417,8.64327e+15,891.706,8112.44,44811,644,515,40222,36902,25867,25402,8878
46275,1407,2990,27438,18837,27438,18837,1.84919e+18,993.246,8706.46,46275,512,530,43247,42907,39903,39450,25443
13116,91,195,0,13116,12709,407,2.57443e+16,86.2667,1055.2,13116,57,68,12891,12783,11714,11774,9521
35461,88,3531,21552,13909,0,35461,4.97111e+18,834.181,8483.61,35461,403,540,23625,18522,13764,11523,930
24752,26,51,24262,490,24752,0,1.01641e+14,16.3796,565.097,24752,25,24,24701,24699,23343,23288,19569
38321,56,3464,22841,15480,0,38321,5.01033e+18,836.968,8751.29,38321,422,493,23856,17329,12726,11132,735
10046,676,1560,8972,1074,5870,4176,1.85494e+18,497.339,3219.41,10046,202,263,8350,7742,5470,5475,4173
48330,3022,4124,0,48330,0,48330,2.34256e+18,1117.43,10603.7,48330,544,516,44206,44123,43129,42108,38029
14905,129,2282,8538,6367,0,14905,4.58412e+18,402.059,4476.51,14905,312,326,11355,9170,5903,5470,1926
32986,801,3105,19991,12995,0,32986,4.88453e+18,952.504,7770.02,32986,460,432,29277,27285,24255,23093,12673
18092,1224,2548,10529,7563,10529,7563,1.75179e+18,326.316,5278.21,18092,236,501,15544,15497,14770,15012,6592
35755,287,2734,21358,14397,0,35755,5.04179e+18,1010.32,7196.79,35755,513,397,28945,24260,17123,13179,6318
39692,587,2395,11645,28047,0,39692,3.63294e+13,712.294,7276.73,39692,436,402,36638,34971,30109,30311,16500
40439,667,3144,0,40439,0,40439,2.30987e+18,932.095,8251.2,40439,381,484,36090,34190,21948,21764,12862
26988,1157,2527,16212,10776,0,26988,4.99463e+18,1133.19,6355.02,26988,498,450,24019,23035,21253,20747,13849
31704,2085,2946,28270,3434,18569,13135,1.91564e+18,1314.58,7706.84,31704,387,612,28586,27078,26591,26562,24663
41793,1975,3631,0,41793,0,41793,2.37362e+18,1040.37,9372.58,41793,595,582,38162,37557,35442,34274,28142
35973,3222,4048,35973,0,32008,3965,2.30087e+18,1080.42,9185.18,35973,518,528,31925,31714,31703,31605,29742
32543,283,1579,0,32543,10809,21734,8.73308e+15,501.182,4948.61,32543,325,333,29179,25806,14864,14470,10274
47766,276,368,0,47766,47025,741,2.62157e+16,162.834,2548.04,47766,117,123,47398,47384,45998,46009,44064
12669,199,214,0,12669,12488,181,2.52421e+16,94.2523,1136.89,12669,66,73,12455,12453,12450,12429,12309
22927,1326,1385,7164,15763,0,22927,3.24051e+13,541.707,4280.29,22927,278,240,21542,21542,21540,21542,21244
27878,1382,1517,7912,19966,0,27878,3.69277e+13,723.376,4769.8,27878,378,303,26361,25860,26308,26320,25302
17907,36,56,17582,325,17907,0,1.04058e+14,17.8776,506.156,17907,24,27,17851,17850,17437,17438,15149
3712,448,826,2224,1488,0,3712,5.05667e+18,191.783,1452.34,3712,196,135,2886,2849,2733,2706,2212
8179,146,164,0,8179,8014,165,2.53907e+16,76.5432,727.982,8179,57,63,8015,8009,7913,7906,7747
20467,1249,1601,6498,13969,0,20467,3.53291e+13,539.168,4477.57,20467,273,372,18866,18800,18775,18783,17301
48585,1223,2275,14285,34300,0,48585,3.64051e+13,981.257,7532.62,48585,486,422,46128,45214,41910,42187,35521
18736,142,241,0,18736,18365,371,2.54256e+16,90.2526,1431.91,18736,71,77,18495,18462,17466,16323,14061
41832,4,63,41105,727,41832,0,1.00675e+14,18.3486,750.066,41832,28,28,37792,35361,32560,32515,18761
16046,1041,1383,10024,6022,0,16046,5.00573e+18,505.157,3602.56,16046,244,255,14663,14663,13815,13600,12766
3365,319,491,0,3365,1005,2360,7.93469e+15,113.835,1028.82,3365,135,123,2874,2838,2616,2635,1898
4992,1123,1199,4447,545,3048,1944,1.86164e+18,374.684,2124.99,4992,174,210,3793,3793,3772,3768,3733
33836,1733,1967,9881,23955,0,33836,3.46553e+13,836.207,6093.94,33836,445,406,31869,31377,31535,31544,30250
37229,48,324,0,37229,36404,825,2.6178e+16,157.095,2396.37,37229,112,116,35876,34844,28599,24245,16378
20546,958,1860,0,20546,6205,14341,9.22397e+15,440.178,4852.58,20546,255,331,18686,18565,18222,18157,13936
5760,873,968,0,5760,0,5760,2.3033e+18,266.893,1914.15,5760,203,139,4792,4791,4783,4783,4674
23360,2702,2732,20680,2680,14186,9174,1.97877e+18,679.369,5955.99,23360,366,389,20628,20628,20627,20627,20615
39496,46,2365,0,39496,12003,27493,8.62115e+15,622.932,6896,39496,435,344,27984,21798,16575,14711,2932
9242,429,990,8557,685,5949,3293,1.87064e+18,504.635,2535.42,9242,212,223,7447,5219,5289,5024,4122
39370,183,319,0,39370,38502,868,2.57226e+16,144.454,2302.24,39370,109,107,39051,38931,37232,37023,33259
1026,74,85,0,1026,1017,9,2.64071e+16,14.9825,209.179,1026,19,30,941,941,932,935,916
41097,218,3353,0,41097,0,41097,2.40267e+18,1364.55,8787.31,41097,529,461,32004,26548,19902,14867,3452
26013,10,34,25424,589,26013,0,9.8002e+13,18.0753,521.847,26013,22,23,25779,25598,23241,23002,17348
11469,212,1899,10169,1300,6863,4606,1.92667e+18,731.776,3900.91,11469,262,330,8111,6553,3367,3109,1431
17142,843,1437,0,17142,0,17142,2.39195e+18,693.424,3856.24,17142,311,268,15624,14950,14811,14461,12831
12749,965,1383,4148,8601,0,12749,3.42023e+13,299.038,3235.8,12749,296,230,11366,11353,11081,11082,9602
26098,46,256,0,26098,25652,446,2.57385e+16,117.299,1681.49,26098,92,108,24963,24120,20330,18525,12978
31433,1091,3547,28044,3389,18681,12752,1.95629e+18,973.435,8306.88,31433,456,454,27236,25983,20862,20966,13315
30534,35,102,30012,522,30338,196,1.02454e+14,19.5895,821.717,30534,31,32,30432,30423,28104,27946,17791
6594,85,1202,0,6594,0,6594,2.26772e+18,283.426,2337.44,6594,151,225,4311,3224,2209,1833,177
29629,3301,3588,26699,2930,17175,12454,1.94062e+18,1234.33,7737.14,29629,451,353,26041,26037,26002,26000,25676
22213,182,233,0,22213,21804,409,2.56596e+16,95.9132,1515.59,22213,82,89,21980,21977,21515,21391,20430
41932,534,3721,41932,0,37218,4714,2.57681e+18,1353.57,9728.35,41932,518,472,34463,29973,15415,10794,8058
15335,174,1729,9324,6011,9324,6011,1.86418e+18,681.764,4133.09,15335,271,277,11268,9475,6974,5766,1527
27301,317,1770,8883,18418,0,27301,3.39165e+13,634.467,5094.02,27301,371,394,24359,22671,15635,15096,7720
41412,1420,2505,24729,16683,0,41412,4.93307e+18,1013.27,7486.87,41412,451,383,38496,38235,36270,35574,28364
39876,3266,4247,23531,16345,0,39876,4.67026e+18,1092.62,9957.73,39876,551,748,35629,35506,33539,33095,31203
13133,274,465,13133,0,13133,0,4.06815e+18,268.166,1940.72,13133,145,150,12606,12230,10810,10718,9216
16434,12221,16434,0,16434,0,16434,1048510,0,16434,16434,16434,1,0,0,0,0,0
13506,1156,1267,4288,9218,0,13506,3.61954e+13,308.042,3078.52,13506,292,265,12239,12239,12228,12220,12096
14740,26,206,0,14740,14568,172,2.5054e+16,97.9682,1228.19,14740,71,75,13934,13509,11739,10473,6790
10479,71,1371,6446,4033,0,10479,4.87879e+18,453.069,3045.85,10479,202,237,6373,4804,3843,3385,701
27608,24,68,27225,383,27608,0,1.01771e+14,19.518,661.994,27608,27,26,27538,27524,25580,25335,18359
46453,4115,4700,41786,4667,27771,18682,1.9472e+18,1209.14,11033.4,46453,441,531,41753,41730,41713,41715,40287
47964,84,3775,28136,19828,0,47964,4.75857e+18,1020.53,10155.7,47964,519,562,32012,24553,18478,16329,1892
30370,1771,2847,17925,12445,0,30370,4.5582e+18,689.161,7096.93,30370,457,323,27523,27450,26172,25931,21697
36606,927,2370,21062,15544,0,36606,4.61662e+18,1336.69,7157.1,36606,418,466,32897,30957,27556,27003,15124
21819,1104,2833,21819,0,19491,2328,2.5644e+18,963.873,6284.15,21819,411,392,18482,17433,14324,13216,9512
4410,229,576,0,4410,0,4410,1.72333e+18,153.055,1265.88,4410,126,95,3834,3722,3253,2494,1290
27362,785,3215,16022,11340,16022,11340,1.7646e+18,1012.79,7422.98,27362,484,552,23206,21946,17418,15025,10370
15371,453,1336,9449,5922,9449,5922,1.83436e+18,437.464,3379.47,15371,266,236,13760,11983,11924,11329,8815
16262,422,772,16256,6,16262,0,4.36633e+18,297.843,2516.29,16262,165,167,15490,15300,13354,13262,12292
28003,887,1830,8113,19890,0,28003,3.63168e+13,614.829,5230.23,28003,412,290,26173,25505,25007,25082,20661
4589,13,27,4488,101,4589,0,1.00961e+14,13.1085,225.119,4589,19,17,4553,4536,4220,4129,3516
2192,87,906,1836,356,1260,932,1.9832e+18,103.209,1252.11,2192,136,117,1193,938,430,393,131
24157,56,62,23666,491,24157,0,9.95774e+13,18.6332,597.576,24157,26,26,24095,24095,23936,23936,23256
7670,682,1324,4462,3208,0,7670,4.4279e+18,184.355,2485.67,7670,203,178,6346,6295,6178,6125,2828
38259,17,266,0,38259,37358,901,2.55486e+16,143.472,2100.62,38259,94,105,35207,33501,29027,22309,14844
47758,73,77,46820,938,47758,0,1.00837e+14,21.6571,839.652,47758,31,27,47681,47681,47508,47508,46776
10057,1091,1498,0,10057,0,10057,2.33289e+18,466.084,3124.44,10057,270,222,8559,8404,8400,8402,7616
14225,100,224,0,14225,13875,350,2.72224e+16,98.4106,1178.42,14225,74,79,13964,13820,12874,12413,10250
44260,35,71,43462,798,44248,12,9.81159e+13,22.3748,838.876,44260,28,29,44189,44177,42504,42398,35548
39949,2435,4350,36129,3820,24081,15868,1.96963e+18,1056.03,9928.77,39949,426,515,35599,35046,33921,34172,25531
25531,852,2878,15360,10171,0,25531,4.89754e+18,948.51,6611.82,25531,427,447,22144,20822,16765,16606,9026
30696,1593,2248,0,30696,0,30696,2.37266e+18,920.16,5768.73,30696,386,390,28448,27853,27753,27428,25720
2866,238,476,0,2866,0,2866,2.33036e+18,256.073,1010.9,2866,110,138,2149,1711,1749,1410,1197
15428,88,2087,15428,0,13979,1449,3.00164e+18,755.087,4468.53,15428,355,292,9712,7400,3717,1966,773
6939,1564,1682,3968,2971,3968,2971,1.91523e+18,232.307,2869.23,6939,274,206,5257,5256,5239,5244,5147
34952,869,1013,34952,0,34952,0,4.00398e+18,363.34,3735.37,34952,221,218,33939,33923,33405,33430,33151
24589,55,66,24266,323,24251,338,1.0235e+14,19.9334,670.204,24589,27,28,24523,24523,24205,24246,23343
41807,64,942,41753,54,41807,0,4.21354e+18,361.511,3969.66,41807,218,225,31506,22493,16542,15295,5135
18248,2132,2316,16353,1895,11209,7039,1.97477e+18,894.543,5189.07,18248,398,323,15932,15916,15896,15888,15515
11470,932,1755,7019,4451,7019,4451,1.8384e+18,441.413,3511.26,11470,319,279,9715,9480,9098,8972,8305
41865,1012,3299,37595,4270,25602,16263,1.95515e+18,1103.09,8850.9,41865,465,446,37337,34038,25293,24367,12303
45758,32,58,44942,816,45758,0,1.01424e+14,23.0708,771.953,45758,27,30,45700,45693,43551,43529,36770
7633,180,462,7633,0,7633,0,3.99601e+18,221.883,1481.56,7633,125,122,6902,6203,4395,4199,3904
48956,297,324,0,48956,48250,706,2.64484e+16,157.248,2493.13,48956,118,127,48632,48628,48522,48427,48154
42063,1535,2372,13383,28680,0,42063,3.45267e+13,522.08,7084.4,42063,390,432,39691,39658,39235,39232,30527
17503,1284,1517,0,17503,5444,12059,9.11208e+15,475.808,3973,17503,268,286,15986,15985,15948,15935,15276
34542,1228,2187,0,34542,10352,24190,9.26787e+15,550.841,6458.29,34542,522,407,32355,32269,29714,29862,22609
17682,738,1416,5032,12650,0,17682,3.61641e+13,480.195,3809.94,17682,357,239,16241,15815,14644,14757,9784
10730,289,1279,3036,7694,0,10730,3.72709e+13,289.356,2917.84,10730,218,241,9292,8377,6861,7064,3304
26382,2124,2594,26382,0,23737,2645,1.56984e+18,662.862,6225.82,26382,394,345,23788,23780,23486,23439,22208
12201,455,1497,0,12201,0,12201,1.97306e+18,359.511,3133.96,12201,242,205,10652,10306,9304,7820,3142
30453,2192,3346,30453,0,27261,3192,2.68615e+18,827.326,7708.93,30453,334,491,27107,27057,26078,25792,22020
26227,1149,1475,7785,18442,0,26227,3.63629e+13,797.827,4888.55,26227,355,352,24752,24238,24190,24210,22730
31953,107,328,0,31953,31388,565,2.63623e+16,115.777,2138.75,31953,93,100,31570,31343,27847,26890,18642
35959,267,323,0,35959,35263,696,2.61106e+16,123.604,2317.96,35959,95,101,35636,35629,35240,35285,33994
34270,51,93,33646,624,34270,0,1.00755e+14,18.5651,801.705,34270,30,31,34177,34175,32382,32385,23303
27626,268,1821,0,27626,8870,18756,8.92979e+15,652.384,5295.28,27626,340,438,24025,21820,14909,12127,6613
15832,58,1916,14126,1706,9753,6079,1.96425e+18,454.396,4409.09,15832,323,235,8211,5718,3228,3283,960
46813,1819,3334,27927,18886,0,46813,4.69709e+18,708.437,8776.09,46813,506,372,43479,43372,38632,37699,28752
39727,1535,2449,12639,27088,0,39727,3.24529e+13,564.939,7272.56,39727,400,425,37278,37100,36070,36102,27243
40243,2185,3460,40243,0,36354,3889,1.08009e+18,1488.78,8969.92,40243,489,472,36783,35345,35201,34808,26467
17111,2021,2745,10362,6749,10362,6749,1.83999e+18,782.924,5491.34,17111,357,422,14366,13973,13825,14002,12563
5743,141,148,0,5743,5645,98,2.6123e+16,50.1275,630.438,5743,45,48,5595,5595,5594,5594,5576
22322,1502,2414,0,22322,0,22322,2.44899e+18,840.667,5730.28,22322,406,330,19908,19385,17976,17359,13868
36511,2516,4438,32436,4075,21294,15217,1.94787e+18,915.572,9720.97,36511,386,581,32073,31468,30818,31128,24363
26355,541,1534,8100,18255,0,26355,3.56465e+13,396.524,4463.07,26355,309,262,24821,24382,20607,20477,12783
33623,3234,3393,20010,13613,20010,13613,1.88518e+18,1021.25,8217.58,33623,510,573,30230,30153,30159,30173,29837
9828,812,2468,9828,0,9033,795,2.34851e+18,323.659,4045.45,9828,199,293,7360,7004,3792,3548,2876
5193,861,1036,5193,0,4691,502,1.71741e+18,147.387,1861.48,5193,154,168,4157,4156,4140,4138,3929
16552,74,1310,0,16552,4700,11852,9.70059e+15,380.834,3456.93,16552,259,352,12334,10762,8221,7109,2576
7365,27,36,7193,172,7365,0,1.0552e+14,13.9428,299.406,7365,17,22,7329,7329,6947,6984,5876
11658,1269,1395,10399,1259,5990,5668,1.90852e+18,225.304,2950.96,11658,208,229,10263,10263,10255,10253,10165
32588,154,285,0,32588,32039,549,2.55214e+16,134.786,1991.93,32588,101,105,32266,32171,29265,29575,24481
40282,1064,1835,0,40282,12309,27973,9.1784e+15,754.262,6250.71,40282,425,368,38447,38133,35591,35684,28283
48046,2841,3939,28123,19923,0,48046,4.5745e+18,1077.14,10318.1,48046,549,563,44107,44078,43091,42880,38535
3097,163,372,3097,0,3097,0,4.31945e+18,165.986,898.416,3097,91,83,2653,2314,2002,1921,1794
7632,626,1070,0,7632,2063,5569,1.01551e+16,193.433,2201.03,7632,230,133,6562,6498,6390,6384,5223
37923,81,3313,23053,14870,0,37923,4.85813e+18,1249.6,8458.28,37923,510,444,24429,18236,13665,11623,1813
10305,423,1878,9112,1193,6055,4250,1.9382e+18,417.142,3563.74,10305,264,239,8197,6877,6067,5480,2507
44910,3571,4186,40592,4318,26030,18880,1.94911e+18,1182.85,10478.3,44910,559,533,40724,40705,40468,40490,37114
40822,532,2602,24785,16037,24785,16037,1.82308e+18,1150.2,7601.26,40822,490,454,35336,31920,24827,24904,13434
40854,804,844,40781,73,40854,0,4.07433e+18,359.958,3748.35,40854,224,225,40010,40010,39967,39963,39935
13665,140,2254,12013,1652,8004,5661,1.94279e+18,414.883,4569.99,13665,231,366,9202,7093,4154,3562,401
27465,70,919,27465,0,27465,0,4.00939e+18,359.48,3327.61,27465,202,209,20691,13919,10943,10478,3850
15917,737,1190,4394,11523,0,15917,3.66093e+13,478.249,3299.17,15917,263,248,14603,14467,14193,14211,11021
43086,3494,3958,43086,0,39003,4083,2.89334e+18,1225,9897.72,43086,475,538,39128,39112,38488,38362,35756
6797,157,835,6119,678,4118,2679,1.90567e+18,365.811,1977.9,6797,191,169,4509,3476,2699,2514,1237
6375,275,1051,3778,2597,3778,2597,1.86366e+18,248.573,2087.44,6375,233,141,5137,4425,3993,3732,2436
16121,108,217,0,16121,15798,323,2.54332e+16,108.579,1265.41,16121,79,82,15875,15745,14312,14375,11871
24459,913,1870,7391,17068,0,24459,3.56154e+13,526.404,5131.08,24459,387,421,22589,22107,20792,20945,14883
39771,590,3324,24051,15720,24051,15720,1.83412e+18,938.476,8722.66,39771,472,608,35162,32400,26467,25919,9805
27876,59,707,27876,0,27876,0,4.4918e+18,333.625,3044.98,27876,197,202,20657,14973,10414,9023,4533
17857,318,759,17857,0,17857,0,4.16015e+18,306.739,2565.55,17857,169,173,17019,16516,12600,12170,12209
47497,1042,5294,47497,0,42791,4706,2.47371e+18,1079.81,11964.1,47497,510,622,41185,37880,18919,14224,9515
2716,184,501,905,1811,0,2716,3.32735e+13,185.408,995.712,2716,119,147,2121,1866,1676,1653,1015
18096,1768,2466,0,18096,0,18096,2.1415e+18,438.361,5088.87,18096,232,469,15630,15541,15375,15427,12382
3865,903,916,0,3865,0,3865,2.32215e+18,229.898,1580.32,3865,180,149,2949,2949,2946,2945,2928
7401,244,539,7401,0,7401,0,4.29921e+18,235.505,1540.7,7401,127,120,6803,6348,4923,4828,4358
14251,943,1459,8459,5792,8459,5792,1.76423e+18,501.227,3661.95,14251,281,309,12792,12625,12408,12243,11333
36889,2245,2775,21940,14949,21940,14949,1.89491e+18,945.059,7732.6,36889,642,352,34114,34061,33525,33458,31594
42628,4617,5593,37389,5239,25536,17092,1.95066e+18,1187.15,11954.8,42628,530,660,37035,36970,36580,36679,35310
15012,772,975,0,15012,4360,10652,9.41649e+15,436.408,2790.97,15012,276,232,14037,13846,13776,13758,12975
41546,760,1815,12644,28902,0,41546,3.55546e+13,788.867,6557.46,41546,391,410,39000,37806,34060,34118,22417
11623,421,1940,11623,0,10059,1564,1.37215e+18,765.121,3979.34,11623,240,375,8871,7542,6357,6011,3008
19196,39,2100,11530,7666,0,19196,4.77311e+18,576.838,4937.33,19196,257,348,10990,7253,5289,4850,486
19966,2564,2660,12171,7795,12171,7795,1.89095e+18,702.009,5834.7,19966,361,419,17306,17306,17281,17292,17030
47833,89,296,0,47833,46914,919,2.49618e+16,148.864,2526.67,47833,108,112,47241,46720,41051,38606,29003
40110,850,2537,35623,4487,24189,15921,1.93085e+18,1049.44,7309.41,40110,440,422,36728,35136,23002,21514,18342
32337,3,64,31609,728,32313,24,1.03592e+14,20.9571,741.916,32337,29,28,26945,24253,23055,22583,13574
4699,18,25,4583,116,4699,0,1.00454e+14,13.2175,218.264,4699,17,16,4674,4671,4533,4534,4008
21472,344,1478,0,21472,6503,14969,9.27322e+15,455.713,4306.31,21472,343,346,19446,17872,17138,17205,8570
45592,115,339,0,45592,44709,883,2.70944e+16,121.946,2470.57,45592,109,120,45136,44861,39950,37371,30451
34899,914,3705,0,34899,0,34899,2.22774e+18,1000.06,8625.41,34899,633,545,30270,28618,19412,19195,12496
36748,1694,2545,0,36748,10974,25774,9.41713e+15,689.165,7174.67,36748,468,529,34203,34177,33336,33281,25753
836,125,224,836,0,836,0,3.72407e+18,65.445,391.69,836,55,42,612,573,467,442,407
36622,616,3124,33287,3335,22567,14055,1.97974e+18,794.589,7637.62,36622,432,398,32902,30800,16555,16507,14503
14149,839,2190,14149,0,12638,1511,2.56624e+18,405.622,4284.79,14149,301,255,11959,11709,10649,10461,7726
2696,156,511,0,2696,681,2015,8.70038e+15,122.199,952.822,2696,134,104,2124,1895,1857,1881,992
22186,133,309,0,22186,21659,527,2.74707e+16,129.759,1729.53,22186,87,102,21849,21702,19741,18715,15300
567,204,319,486,81,324,243,1.96898e+18,32.0547,398.368,567,61,59,248,241,219,221,227
1458,102,103,0,1458,1437,21,2.59962e+16,37.4143,289.929,1458,38,30,1355,1355,1354,1355,1355
17874,155,230,0,17874,17524,350,2.7704e+16,115.573,1362.38,17874,89,83,17641,17528,16664,16560,14735
23826,51,52,23275,551,23820,6,9.89997e+13,16.719,592.487,23826,23,27,23774,23774,23773,23773,23681
19810,637,1548,0,19810,0,19810,1.91945e+18,634.533,3998.68,19810,275,292,17953,17301,15102,11918,11646
13134,591,1454,0,13134,0,13134,2.35145e+18,691.906,3508.42,13134,258,335,11182,10439,9252,8181,5308
38382,187,325,0,38382,37775,607,2.66964e+16,143.466,2194.83,38382,111,114,38057,37994,35979,36028,31430
14753,1496,1538,0,14753,3963,10790,9.44014e+15,317.339,3705.26,14753,248,309,13215,13215,13211,13209,13131
2296,611,713,0,2296,0,2296,2.45134e+18,115.632,1112.99,2296,110,121,1583,1579,1569,1567,1398
6048,15,28,5944,104,6048,0,1.02761e+14,12.8823,241.789,6048,17,17,6016,6003,5691,5681,5352
40629,1247,3310,23909,16720,0,40629,4.88966e+18,864.275,8621.86,40629,572,378,37222,36419,31010,30631,18863
41514,3628,4413,0,41514,0,41514,2.365e+18,992.55,10182.5,41514,578,783,37101,37022,36751,36763,33332
35138,1662,3216,20649,14489,20649,14489,1.7676e+18,863.88,8134.92,35138,432,451,31922,31058,29094,27837,19462
9252,27,28,9174,78,9252,0,1.02648e+14,12.0164,304.448,9252,16,18,9224,9224,9206,9206,9202
43062,2833,3607,26153,16909,26153,16909,1.85595e+18,845.168,9076.62,43062,465,439,39455,39407,38868,39114,35302
11735,16,201,0,11735,11515,220,2.41625e+16,85.991,1022.08,11735,71,66,10718,10251,8921,7703,4755
25269,491,1513,0,25269,8146,17123,8.97955e+15,663.747,4732.84,25269,328,394,22962,21527,14319,14611,8228
19750,2431,3028,19750,0,17821,1929,2.14494e+18,632.215,6059.43,19750,345,333,16722,16720,16304,16080,15118
3498,92,143,0,3498,3431,67,2.77066e+16,49.311,514.988,3498,41,51,3355,3340,3161,3227,2794
48027,294,3913,28865,19162,28865,19162,1.92038e+18,1157.38,10284.9,48027,691,486,38864,33273,25826,20706,3954
38019,1093,1941,34176,3843,21945,16074,1.93887e+18,909.64,6193.35,38019,345,372,35826,33995,33886,33959,27003
46682,5193,5392,41707,4975,27888,18794,1.91662e+18,882.889,11972.9,46682,554,472,41290,41290,41281,41275,40619
30195,4,74,29589,606,30195,0,1.06158e+14,17.8459,681.717,30195,27,29,27159,25312,23173,23680,13481
37114,403,757,37114,0,37114,0,4.05201e+18,349.347,3526.66,37114,204,208,36357,36046,29853,29610,28117
49310,343,1084,49310,0,49285,25,4.439e+18,364.89,4409.52,49310,236,236,48077,46848,31253,29029,28715
6270,127,188,0,6270,6144,126,2.64212e+16,68.0785,790.018,6270,52,55,6082,6063,5806,5828,5103
11040,1184,1629,6749,4291,6749,4291,1.77786e+18,392.695,3407.04,11040,285,271,9411,9351,9120,9042,7619
13455,1142,1753,8072,5383,8072,5383,1.81725e+18,623.115,3742.04,13455,315,287,11702,11187,11148,11191,9083
16348,1186,1580,0,16348,5111,11237,7.71425e+15,256.31,3757.32,16348,361,302,14768,14758,14230,14236,10442
3114,91,97,0,3114,3051,63,2.69349e+16,51.57,381.861,3114,45,42,3017,3017,3017,3014,2992
45554,729,1000,45554,0,45554,0,4.15628e+18,382.878,4196.02,45554,233,225,44554,44519,42386,42345,41872
48667,55,107,47657,1010,48642,25,1.04471e+14,22.5382,989.253,48667,31,33,48560,48555,46646,46672,37533
18493,2837,2976,16640,1853,11242,7251,1.97667e+18,761.964,5913.08,18493,349,350,15517,15517,15498,15492,15365
47309,694,3488,0,47309,0,47309,2.35835e+18,1340.78,9496.27,47309,544,488,41648,38836,25013,20629,12444
43708,1295,2559,13650,30058,0,43708,3.57982e+13,707.889,7912.74,43708,417,504,41149,40474,38470,38666,28188
44663,3174,3594,26757,17906,26757,17906,1.89333e+18,1049.2,9327.48,44663,550,458,41069,41060,40904,40960,40082
38851,1499,5016,38851,0,34232,4619,3.00159e+18,848.437,10579.1,38851,465,565,33835,32502,25939,23248,15554
11394,425,544,11394,0,11394,0,4.29977e+18,262.836,1864.22,11394,145,136,10850,10842,10323,10289,9858
36588,2552,2937,33082,3506,21576,15012,1.9492e+18,1221.12,7850.52,36588,495,392,33651,33448,33457,33445,31962
21391,32,55,20815,576,21391,0,1.03098e+14,16.8133,534.068,21391,23,26,21336,21335,20640,20641,17580
42483,146,349,0,42483,41607,876,2.42058e+16,144.817,2413.96,42483,102,116,42104,41960,38161,35181,27563
4741,6,25,4692,49,4741,0,9.98612e+13,14.0304,215.697,4741,17,18,4607,4521,4021,4044,2870
33765,1153,1967,10712,23053,0,33765,3.49602e+13,537.395,6113.11,33765,379,352,31798,31629,30187,30248,22467
46681,342,343,0,46681,45513,1168,2.56751e+16,157.909,2597.72,46681,119,122,46338,46338,46337,46325,46332
44302,12,16,44126,176,44302,0,2.16175e+18,15.9942,841.922,44302,16,16,32478,0,22147,30447,32478
40869,592,2056,12441,28428,0,40869,3.58534e+13,771.633,6549.62,40869,428,437,38042,36544,28138,28345,14695
33861,432,2202,20986,12875,20986,12875,1.83488e+18,587.282,6129,33861,331,409,30957,26587,23406,22723,12167
11112,755,2069,6708,4404,0,11112,5.14918e+18,295.63,3830.19,11112,224,325,9043,8826,8441,8484,4285
7067,137,161,0,7067,6987,80,2.67757e+16,56.0814,736.202,7067,46,55,6906,6901,6883,6867,6591
16218,2,48,15842,376,16218,0,1.05245e+14,16.957,440.064,16218,23,23,11549,10040,9614,9916,6884
39230,2111,4517,23053,16177,0,39230,4.8316e+18,763.755,9896.91,39230,443,560,34713,34293,32968,32654,19654
32043,27,781,32030,13,32043,0,4.07037e+18,363.038,3348.14,32043,197,204,17969,9390,8633,7457,1967
24854,42,52,24371,483,24854,0,1.02946e+14,19.0479,598.932,24854,26,27,24802,24802,24484,24484,24170
6769,26,168,0,6769,6640,129,2.52506e+16,80.1365,735.108,6769,53,55,6394,6173,5200,4974,2787
24066,507,1021,0,24066,7683,16383,7.65237e+15,478.415,3463.52,24066,269,220,22855,22318,20869,21098,15765
46510,199,343,0,46510,45771,739,2.62451e+16,143.593,2600.19,46510,111,115,46164,46086,43128,43113,35180
48689,2466,3888,43520,5169,28758,19931,1.95056e+18,1323.78,10299.8,48689,442,578,44801,44206,43589,43802,38186
15792,128,2495,15792,0,14268,1524,2.92202e+18,502.178,5026.72,15792,288,282,9779,7711,3953,2018,688
43777,890,1845,0,43777,13704,30073,8.15778e+15,883.17,6461.85,43777,399,413,41461,40099,37875,38241,24600
35769,137,278,0,35769,35198,571,2.66583e+16,123.561,2067.96,35769,100,99,35458,35276,33212,31987,28268
32527,1243,1880,0,32527,9986,22541,8.025e+15,526.044,5582.2,32527,338,354,30647,30579,30431,30325,27072
49097,543,1928,0,49097,15553,33544,8.3334e+15,718.991,6749.45,49097,349,391,46238,44237,38556,39022,18484
22952,325,1607,0,22952,0,22952,2.29612e+18,594.96,4554.87,22952,302,367,18150,14313,10443,8321,6945
33642,2720,4090,30511,3131,19868,13774,1.95536e+18,991.732,9063.98,33642,542,389,29552,29517,26818,26819,20851
45458,206,2092,12864,32594,0,45458,3.6747e+13,871.39,7114.61,45458,573,334,38852,34635,24750,23524,9212
44981,117,321,0,44981,44067,914,2.58012e+16,175.75,2374.97,44981,110,119,44474,44187,39245,36752,27331
7656,578,1242,0,7656,0,7656,2.11709e+18,388.639,2472.89,7656,201,194,6414,5990,5346,4544,4250
36919,421,731,36919,0,36919,0,3.98878e+18,330.33,3467.77,36919,220,205,36188,36126,32701,32451,32409
18527,32,41,18236,291,18527,0,1.03979e+14,19.6394,474.597,18527,24,23,18486,18486,18159,18160,17453
34599,36,1007,34599,0,34599,0,4.36372e+18,352.991,3739.12,34599,215,214,21428,12929,9568,8406,2372
15292,379,2270,9176,6116,0,15292,4.91548e+18,440.485,4520.67,15292,354,313,12612,10911,7961,7549,4706
13880,1614,2097,13880,0,12264,1616,2.27581e+18,694.475,4363.96,13880,351,269,11783,11739,11681,11672,10628
22243,2274,2423,22243,0,20131,2112,2.7844e+18,798.108,5655.5,22243,388,362,19820,19815,19652,19636,19584
9257,344,2312,8498,759,5455,3802,1.90253e+18,242.373,3790.07,9257,346,170,6908,6276,3960,3961,2580
31476,486,842,31476,0,31476,0,3.80669e+18,348.853,3343.03,31476,204,196,30634,30467,27252,27021,26299
48522,905,3945,43120,5402,28870,19652,1.95871e+18,1342.76,10402.3,48522,504,517,42899,39631,26561,24004,13585
11954,611,1325,0,11954,3353,8601,9.58379e+15,407.348,3112.02,11954,256,240,10605,10203,9793,9904,6870
35921,1499,3021,21392,14529,0,35921,4.93666e+18,907.972,7725.2,35921,430,434,32900,31872,30183,29400,15071
36471,2198,2274,10499,25972,0,36471,3.47877e+13,829.156,6581.93,36471,427,357,34197,34193,34167,34161,34122
18057,982,1980,18057,0,16146,1911,2.50662e+18,884.753,4629.43,18057,348,280,15766,14785,12718,12389,10561
29574,907,3501,26595,2979,16643,12931,1.91394e+18,989.983,7635.91,29574,405,454,25642,24282,18873,17539,12338
14540,16,27,14368,172,14534,6,9.8381e+13,18.5311,428.4,14540,20,21,14496,14464,13739,13799,12023
31457,548,1638,0,31457,9930,21527,8.83001e+15,618.749,5347.19,31457,345,310,29332,28556,26221,26246,15101
39177,244,2388,0,39177,12129,27048,9.18303e+15,654.698,6955.66,39177,457,438,33719,29535,19780,18205,7296
22667,153,752,22667,0,22667,0,4.03769e+18,323.938,2848.08,22667,180,185,20260,17470,12069,11841,7792
27934,919,3417,16606,11328,0,27934,4.87366e+18,674.541,7475.45,27934,396,498,24284,22870,16777,15627,7924
1194,1,16,1158,36,1194,0,9.87758e+13,8.30821,101.29,1194,12,11,517,517,517,517,517
32189,1431,2600,0,32189,0,32189,2.41723e+18,747.331,6948.07,32189,332,435,29589,28966,28504,28281,19762
30396,976,2666,17774,12622,17774,12622,1.73924e+18,716.761,6777.94,30396,327,460,27615,26215,25985,25683,12438
17396,1645,2477,17396,0,15667,1729,1.54987e+18,449.608,5218.15,17396,237,402,14919,14807,13854,13670,10621
26124,241,281,0,26124,25573,551,2.66617e+16,128.948,1843.17,26124,103,93,25843,25835,25560,25616,24636
29450,1903,3351,0,29450,0,29450,2.40283e+18,892.793,7641.14,29450,436,550,26099,25448,24460,23517,17779
45380,53,1094,45362,18,45380,0,4.09713e+18,384.897,4346.21,45380,233,229,31850,20771,16224,14985,4066
23614,1215,3173,21252,2362,14465,9149,1.97085e+18,738.831,6894.46,23614,506,422,20415,18771,11981,11561,10030
36848,2648,3503,32726,4122,22395,14453,1.93314e+18,1033.01,8766.82,36848,496,568,33345,33326,32538,32704,29434
6584,399,422,6584,0,6584,0,3.77026e+18,234.61,1313.74,6584,113,105,6162,6162,6111,6120,6116
31020,2922,3700,31020,0,27652,3368,1.91767e+18,1236.7,8521.68,31020,425,596,27320,27257,26876,26628,25359
37660,2903,3209,34289,3371,21303,16357,1.91625e+18,1406.42,7916.71,37660,431,430,34451,34451,34439,34444,34023
21430,1073,2661,12685,8745,0,21430,4.78267e+18,845.199,5902.95,21430,369,375,18568,17759,14541,14414,8859
43626,1554,2656,0,43626,0,43626,2.41637e+18,1170.95,8041.33,43626,581,455,40816,39550,37564,35543,29354
42264,220,317,0,42264,41200,1064,2.6667e+16,150.779,2334.07,42264,115,117,41947,41919,40247,40024,36685
34417,41,284,0,34417,33681,736,2.59385e+16,153.077,2082.12,34417,100,107,33022,32094,27073,24171,15286
12943,1936,2779,12943,0,11686,1257,2.00441e+18,345.806,4788.63,12943,220,389,10164,10161,8975,9071,8083
48162,2030,3225,0,48162,0,48162,2.43749e+18,1219.42,9133.53,48162,527,442,44937,43938,43428,40869,36295
37177,3547,3913,21727,15450,0,37177,4.71731e+18,878.589,9239.59,37177,540,428,33264,33116,33080,33154,32134
2290,12,19,2224,66,2290,0,9.84551e+13,11.5581,145.618,2290,14,13,2269,2266,2156,2158,2002
8813,1575,1635,5280,3533,0,8813,4.94151e+18,357.835,3070.59,8813,280,229,7178,7178,7170,7172,7046
15038,896,1180,4726,10312,0,15038,3.56039e+13,359.858,3277.29,15038,289,213,13858,13818,13178,13236,11575
42254,1873,3055,0,42254,0,42254,2.14444e+18,1155.63,8045.63,42254,532,488,39199,38283,37471,37192,31339
17501,2442,2648,17501,0,15370,2131,2.76685e+18,676.511,5382.82,17501,326,326,14853,14845,14845,14823,14294
11601,12,227,0,11601,11340,261,2.69386e+16,96.9884,1143.14,11601,71,74,10415,9798,8363,6670,4001
12728,156,228,0,12728,12529,199,2.65631e+16,100.24,1166.14,12728,77,76,12500,12466,11968,11956,10972
38933,2748,3433,0,38933,0,38933,2.34337e+18,1057.3,8495.92,38933,427,524,35500,35437,35216,35315,33400
46017,919,2079,0,46017,13362,32655,9.35625e+15,765.079,7224.05,46017,415,414,43794,43053,40764,40940,27875
26006,31,50,25604,402,26006,0,1.02866e+14,19.3738,580.168,26006,26,24,25956,25954,25145,25148,22570
43749,1727,3891,26326,17423,0,43749,4.77963e+18,757.368,9578.37,43749,551,467,39858,39543,35458,34998,28049
28667,1920,28667,0,28667,28667,0,4095.86,0,28667,28667,28667,1,0,0,0,0,0
18480,934,1499,5582,12898,0,18480,3.68617e+13,417.513,4024.09,18480,312,376,16981,16941,16474,16512,13273
3405,15,16,3389,16,3405,0,2.15754e+18,15.9248,233.409,3405,16,16,3164,0,2967,2966,3164
4010,4,27,3918,92,4010,0,1.04518e+14,14.1257,207.793,4010,16,18,3617,3380,3110,3163,1859
13214,67,555,13214,0,13214,0,4.0341e+18,282.275,2045.75,13214,154,141,10169,7260,5398,5070,2295
877,109,275,0,877,274,603,1.01087e+16,36.6203,418.016,877,65,55,602,576,560,561,330
42980,261,286,0,42980,42207,773,2.54767e+16,148.789,2215.63,42980,114,115,42694,42693,42673,42582,42357
24107,1734,2657,14344,9763,14344,9763,1.88865e+18,607.708,6034.73,24107,362,480,21450,21319,20976,21158,17409
44544,894,1998,14437,30107,0,44544,3.39376e+13,768.289,6795.45,44544,383,388,42402,41559,37083,37264,28298
40469,2402,4419,36004,4465,23761,16708,1.93159e+18,1240.36,10098.9,40469,565,541,36050,34765,31225,30543,28250
37841,50,72,36835,1006,37829,12,9.86998e+13,21.988,757.271,37841,29,31,37769,37769,36894,36906,35122
20895,1037,2807,12328,8567,0,20895,4.75091e+18,361.26,5886.08,20895,461,266,18088,17975,16563,16083,9593
11916,1006,2872,11916,0,10295,1621,2.23094e+18,309.576,4924.89,11916,288,416,9044,8913,8060,8540,4214
22844,201,897,22844,0,22844,0,4.21817e+18,339.261,3030.35,22844,188,198,20904,18660,11804,10792,7972
35125,26,286,0,35125,34563,562,2.56618e+16,155.153,2130.8,35125,97,107,33060,31751,26701,22770,14240
13526,171,212,0,13526,13270,256,2.56086e+16,94.6004,1154.6,13526,70,74,13314,13308,13147,13139,12707
14190,1039,2271,8298,5892,8298,5892,1.90606e+18,491.254,4585.55,14190,273,322,11919,11468,10910,10843,7539
21739,1878,2789,21739,0,19628,2111,1.63922e+18,799.527,6000.02,21739,371,413,18950,18545,18146,18122,16129
10155,848,1021,0,10155,0,10155,2.27562e+18,543.119,2600.43,10155,210,243,9134,8541,8884,8812,8215
5842,67,154,0,5842,5733,109,2.63217e+16,62.2246,708.934,5842,53,53,5665,5568,5066,5114,4127
16910,897,2318,0,16910,0,16910,2.31563e+18,556.043,4914.89,16910,282,349,14522,14023,13468,13522,7525
47361,3,78,46533,828,47361,0,1.01219e+14,21.8899,846.109,47361,29,31,39325,35097,34145,33458,20449
19839,976,2562,19839,0,17884,1955,1.77528e+18,877.629,5482.75,19839,397,338,17102,15908,13745,12892,10950
37096,129,2203,0,37096,11107,25989,9.30907e+15,625.082,6428.6,37096,506,353,29670,25732,18838,17417,6379
29726,2899,3286,29726,0,26452,3274,2.20936e+18,992.551,7471.92,29726,447,499,26440,26102,26212,26142,25577
9027,494,1104,0,9027,2617,6410,9.88747e+15,227.105,2530.02,9027,206,212,7923,7785,7450,7432,4922
19040,1862,2121,0,19040,0,19040,2.39401e+18,754.726,4977.46,19040,326,356,16919,16896,16886,16906,16592
47343,190,2941,28064,19279,28064,19279,1.78073e+18,1067.69,8581.44,47343,538,401,37027,30284,24645,18196,4011
49639,1232,3039,0,49639,0,49639,2.38021e+18,697.485,8656.47,49639,476,343,46600,46109,39270,26249,26627
11479,18,42,11357,122,11479,0,1.03429e+14,17.1262,371.38,11479,22,21,11433,11418,10632,10474,8174
2332,61,124,0,2332,2301,31,2.57393e+16,38.2762,395.849,2332,40,39,2208,2174,2016,2077,1711
44530,1404,4691,39340,5190,26610,17920,1.95487e+18,1465.52,11146.4,44530,525,696,39042,37586,30386,30047,13761
33950,151,1796,0,33950,10285,23665,8.45812e+15,501.347,5595.97,33950,427,307,28824,25523,16906,15741,4998
40808,2859,5022,40758,50,36829,3979,1.70981e+18,832.849,10716.6,40808,592,381,35786,35750,35096,35095,26508
32831,908,3152,19852,12979,19852,12979,1.89608e+18,787.379,7514.49,32831,501,374,29443,27934,22572,21683,11231
8652,256,1162,7892,760,4599,4053,1.83204e+18,188.858,2341.51,8652,244,140,7465,7210,2672,2328,1889
23568,1623,1702,13744,9824,13744,9824,1.80753e+18,882.155,4881.25,23568,342,371,21866,21861,21811,21843,21671
17404,22,63,17101,303,17393,11,1.04332e+14,18.1204,499.099,17404,24,26,17337,17326,16104,16117,12227
16459,88,1788,10053,6406,10053,6406,1.84606e+18,695.962,4245.17,16459,332,311,10889,8643,7214,5138,1149
46364,1048,2233,0,46364,15021,31343,9.06184e+15,561.041,6959.28,46364,386,362,44131,43878,39654,39535,30305
8869,405,1694,5172,3697,0,8869,5.18417e+18,292.847,3105.26,8869,246,279,7175,6478,6534,6455,2194
31188,1427,1704,0,31188,9167,22021,9.25444e+15,644.715,5444.15,31188,424,331,29484,29479,28997,28982,28118
16897,354,1687,0,16897,0,16897,2.30113e+18,561.178,4179.45,16897,315,333,14338,12147,9412,6213,2928
35303,2672,3241,21522,13781,0,35303,4.97017e+18,1022.28,7855.36,35303,502,382,32062,31876,31855,31830,30563
35028,766,962,35028,0,35028,0,4.32771e+18,355.37,3701.5,35028,210,217,34066,34060,33273,33262,32833
34021,262,2165,20558,13463,0,34021,4.91302e+18,1064.1,6410.56,34021,419,361,27228,22417,17393,15140,5244
4172,147,799,2640,1532,2640,1532,1.76242e+18,289.151,1567.32,4172,156,160,2803,2219,1971,1660,1084
24100,141,283,0,24100,23757,343,2.44548e+16,107.371,1764.7,24100,85,107,23806,23749,21489,21195,16559
42255,4197,4654,37543,4712,25171,17084,1.94339e+18,1048.09,10702.5,42255,457,545,37601,37586,37507,37508,36069
7577,61,148,0,7577,7518,59,2.51446e+16,64.4594,616.133,7577,51,60,7393,7183,6516,6288,4817
9373,1401,1455,0,9373,0,9373,2.30942e+18,390.844,2941.35,9373,215,201,7918,7918,7915,7911,7872
13978,311,634,13978,0,13978,0,4.23447e+18,293.758,2195.63,13978,158,171,13277,12813,10332,10161,9714
1913,280,640,0,1913,0,1913,2.34358e+18,88.679,964.572,1913,80,129,1273,1201,1206,1208,690
35121,502,3610,20968,14153,20968,14153,1.8317e+18,736.592,8574.28,35121,609,396,30172,27253,18729,15024,7486
46979,374,3429,28168,18811,28168,18811,1.7936e+18,913.027,9214.16,46979,507,410,39365,33604,21997,19067,6572
21481,417,1258,0,21481,6460,15021,9.31196e+15,302.957,3598.64,21481,297,206,20223,19989,18212,18360,13158
8844,159,167,0,8844,8680,164,2.70665e+16,79.4281,830.998,8844,58,64,8677,8677,8674,8658,8630
5698,1214,1228,3345,2353,0,5698,5.37745e+18,213.188,2160.04,5698,190,185,4470,4470,4470,4470,4460
528,112,233,528,0,459,69,2.46359e+18,30.5379,309.396,528,35,47,295,274,209,209,196
28067,1648,2024,25490,2577,15239,12828,1.88448e+18,1029.63,5351.96,28067,401,383,26043,25389,25470,25441,22763
16683,284,1247,10299,6384,0,16683,5.0873e+18,483.117,3461.49,16683,260,295,13757,10772,7693,6945,6047
37561,124,945,37561,0,37561,0,4.16912e+18,341.802,3728.61,37561,209,219,33208,28173,18116,16425,9190
44656,223,2228,0,44656,13526,31130,8.54064e+15,802.757,7073.24,44656,465,447,39559,36832,25645,23816,6823
14461,226,1200,0,14461,4173,10288,9.78498e+15,333.648,3074.8,14461,292,280,12637,11113,8961,9032,2896
2339,398,775,2065,274,1335,1004,1.96504e+18,121.64,1197.15,2339,102,108,1564,1532,1350,1397,966
22104,326,701,22104,0,22104,0,4.17772e+18,310.476,2763.63,22104,181,184,21374,20859,16459,16074,14776
24743,586,2562,14539,10204,14539,10204,1.82968e+18,672.658,6137.71,24743,328,450,21620,20295,16520,16756,8707
4172,84,139,0,4172,4096,76,2.47332e+16,44.0046,509.655,4172,44,44,4033,4010,3831,3893,3470
47378,1714,2785,14281,33097,0,47378,3.61906e+13,521.333,8004.91,47378,415,482,44593,44501,43801,43930,34119
19853,10,40,19611,242,19853,0,1.01571e+14,16.9458,485.957,19853,22,24,19691,19602,17336,17150,11455
16904,1405,2363,16904,0,15117,1787,2.40334e+18,842.144,5013.69,16904,350,310,14503,14188,13044,13002,9802
33206,1093,3165,19765,13441,19765,13441,1.84517e+18,1037.88,7653.31,33206,450,513,29407,27505,25778,24233,14097
38363,582,1005,38360,3,38363,0,4.11877e+18,358.927,3898.86,38363,222,211,37358,37298,33050,33047,32138
29014,758,1897,17382,11632,0,29014,4.68314e+18,974.962,5727.45,29014,336,397,26142,24108,17271,16497,15754
9462,543,1152,5680,3782,5680,3782,1.90417e+18,620.565,2697.83,9462,231,247,7853,7066,7175,7073,4344
49893,3102,3265,28988,20905,28988,20905,1.74231e+18,1245.37,9184.56,49893,459,439,46628,46628,46620,46619,46411
45419,4824,5543,45419,0,40839,4580,1.26115e+18,1070.06,11829.5,45419,513,702,39876,39853,39797,39598,37594
10639,843,1732,10639,0,9841,798,2.08828e+18,435.936,3555.69,10639,214,239,8907,8361,6038,5585,3827
49386,204,370,0,49386,48643,743,2.55352e+16,167.497,2789.57,49386,112,131,48994,48889,46156,44294,39038
48758,49,60,47782,976,48758,0,9.93114e+13,19.796,794.001,48758,26,26,48698,48698,48198,48199,46656
19335,1604,1694,6077,13258,0,19335,3.42066e+13,345.688,4406.67,19335,314,342,17641,17641,17639,17641,17152
23242,113,247,0,23242,22782,460,2.76921e+16,117.666,1623.04,23242,94,103,22917,22633,20384,19097,15235
26451,128,280,0,26451,25987,464,2.55448e+16,112.682,1826.03,26451,85,95,26146,26043,23820,23749,20016
4064,98,139,0,4064,3986,78,2.63124e+16,50.6558,530.75,4064,44,47,3925,3919,3832,3842,3653
36690,1105,3606,0,36690,0,36690,2.28898e+18,892.137,8750.75,36690,471,403,32985,31433,22284,21121,12031
46384,1796,4058,46384,0,41596,4788,2.27626e+18,1066.27,10014.5,46384,654,409,42326,41179,39878,38519,28645
37128,14,39,36289,839,37128,0,9.59404e+13,18.2837,670.398,37128,22,26,37013,36943,33483,33430,25602
33921,4457,4768,30163,3758,20214,13707,1.97855e+18,1052.22,9943.03,33921,540,619,29153,29153,29144,29143,28549
16085,803,1261,0,16085,4406,11679,9.21078e+15,541.794,3440.36,16085,361,223,14746,14220,14178,14226,12410
29096,2551,3172,17575,11521,17575,11521,1.84353e+18,1111.78,7467.08,29096,459,485,25924,25498,25483,25621,23625
601,30,246,343,258,0,601,5.03582e+18,32.797,339.888,601,35,55,327,208,194,162,54
6892,399,947,4078,2814,0,6892,4.57959e+18,310.241,2032.63,6892,181,184,5905,5567,4140,3945,3972
34448,441,2642,10943,23505,0,34448,3.54311e+13,521.85,7133.58,34448,451,337,31214,29410,18939,18032,9124
43236,367,840,43141,95,43236,0,3.77887e+18,364.833,3897.82,43236,222,217,42320,41660,34813,34125,29942
47931,40,106,47086,845,47931,0,1.04684e+14,20.1402,921.072,47931,33,33,47825,47825,44784,44580,30539
48560,1666,3894,29224,19336,0,48560,4.93046e+18,1408.54,10142.9,48560,506,521,44398,42426,34348,33349,27364
22282,282,2763,13348,8934,13348,8934,1.83471e+18,850.531,6278.23,22282,381,549,17576,15237,11392,8583,1925
3255,16,22,3220,35,3255,0,9.32199e+13,11.7939,186.022,3255,16,15,3233,3230,3094,3094,2850
34398,1658,1803,10633,23765,0,34398,3.60469e+13,606.721,5791.28,34398,346,375,32595,32595,32554,32545,32231
35328,1484,3078,20674,14654,20674,14654,1.80218e+18,1063.59,8009.65,35328,456,534,32250,30794,28801,27122,20618
23633,1508,2037,20843,2790,14292,9341,1.95422e+18,819.835,5452.66,23633,330,323,21596,21457,20682,20622,19609
22263,401,611,22263,0,22263,0,4.01544e+18,329.29,2694.95,22263,182,172,21650,21440,19803,19726,18459
27181,1368,2883,24068,3113,16130,11051,1.95306e+18,814.235,6734.59,27181,351,434,24298,23265,21297,21003,16174
48674,2887,3069,28168,20506,0,48674,4.47251e+18,1396.14,9057.74,48674,443,556,45605,45597,45550,45558,45052
33234,43,45,32677,557,33234,0,1.01092e+14,20.7596,628.404,33234,24,25,33189,33189,32876,32876,32804
13958,1719,1963,0,13958,0,13958,2.32961e+18,399.795,4171.3,13958,303,273,11995,11995,11940,11983,11397
36806,238,372,0,36806,36128,678,2.64769e+16,156.86,2597.49,36806,116,128,36434,36355,34673,34189,29759
34606,769,892,34606,0,34606,0,4.29744e+18,281.686,3509.35,34606,209,193,33714,33709,33132,33131,33137
40921,1314,1998,0,40921,12170,28751,8.75747e+15,639.205,6536.97,40921,394,403,38923,38718,37168,37337,30703
18905,574,2408,16764,2141,11429,7476,1.95044e+18,648.63,5474.68,18905,333,302,15652,13536,7703,7669,3373
4059,907,1008,0,4059,0,4059,2.62967e+18,160.024,1643.9,4059,191,108,3051,3051,3036,3044,2970
34777,3350,3432,34777,0,31202,3575,1.14907e+18,1269.3,8206.36,34777,438,392,31345,31345,31333,31341,31317
18547,849,2383,0,18547,0,18547,2.38149e+18,438.067,5020.96,18547,350,252,16164,15997,11430,10664,9410
38973,3792,4494,34886,4087,22801,16172,1.90664e+18,1214.6,9999.42,38973,406,576,34479,34424,34158,34176,32708
43730,1917,3447,39191,4539,26281,17449,1.9823e+18,1063.25,8856.6,43730,515,385,40283,39598,37339,37304,27745
19175,1447,3252,17268,1907,11502,7673,1.93855e+18,576.614,6363.72,19175,501,283,15923,15686,12117,11495,8078
18968,1251,1551,5793,13175,0,18968,3.70149e+13,688.743,4254.84,18968,375,403,17417,16974,16848,16864,16104
34094,3138,4043,30310,3784,20661,13433,1.98489e+18,874.576,8866.01,34094,423,635,30051,30024,29484,29651,26983
30350,35,46,29869,481,30350,0,9.87901e+13,19.1388,603.938,30350,24,24,30304,30303,29736,29736,28873
10458,1152,1516,6191,4267,0,10458,4.66281e+18,489.09,3249.67,10458,200,343,8942,8743,8797,8780,7544
49702,3244,4080,49702,0,44687,5015,2.53713e+18,1413.43,10617.2,49702,588,501,45622,45511,45207,44788,40295
19039,647,1186,0,19039,5712,13327,9.39695e+15,363.627,3464.63,19039,309,228,17853,17754,16240,16411,13584
23744,119,740,23744,0,23744,0,4.07204e+18,297.438,2766.81,23744,174,184,20469,17031,11704,10723,7609
27517,159,1664,8851,18666,0,27517,3.48137e+13,565.771,4962.47,27517,347,394,22374,19242,13409,7888,5415
34035,1151,3997,34035,0,30735,3300,2.18141e+18,963.319,8925.67,34035,551,436,29518,27184,21239,20101,11386
41739,63,73,40791,948,41739,0,1.0094e+14,19.3157,770.865,41739,28,29,41666,41666,40505,40508,37217
28955,318,652,28955,0,28955,0,4.00412e+18,338.629,3042.7,28955,198,199,28181,27711,23588,23241,19665
32882,2495,3814,32882,0,29380,3502,2.57291e+18,1049.48,8614.38,32882,380,453,29068,28902,28135,27707,24764
37526,1258,2229,0,37526,11503,26023,9.41985e+15,529.337,6743.85,37526,427,502,35297,35257,34583,34535,26396
10081,103,167,0,10081,9937,144,2.56252e+16,91.9607,908.76,10081,67,66,9899,9814,9269,9245,7800
30353,72,316,0,30353,29830,523,2.65009e+16,136.22,2138.35,30353,104,113,29605,28972,24690,22563,16243
49251,37,316,0,49251,48515,736,2.52351e+16,162.703,2579.48,49251,112,121,47258,46025,38039,32091,20018
14473,233,1339,0,14473,4351,10122,9.31756e+15,398.407,3416.75,14473,309,290,12457,11101,9232,9436,3511
31354,1931,3126,31329,25,27607,3747,2.10122e+18,1189.17,7775.65,31354,361,577,28228,27326,25489,25761,22105
46140,2,87,45340,800,46140,0,1.02482e+14,17.477,844.095,46140,29,31,33055,28763,27757,28675,19061
45726,720,2795,0,45726,14306,31420,8.83808e+15,621.888,8345.16,45726,442,601,42628,41486,36151,35863,17665
15973,115,1571,9713,6260,9713,6260,1.92601e+18,611.002,3816.95,15973,333,254,11098,9225,6871,5645,1476
45443,200,320,0,45443,44755,688,2.55072e+16,162.792,2543.87,45443,110,111,45123,45036,43105,42556,38480
25763,106,2663,23062,2701,14950,10813,1.90594e+18,682.469,6229.13,25763,380,312,17161,11492,6213,5591,1803
19385,3,6,18174,1211,19305,80,0.000257931,0.99969,333.074,19385,6,1,19379,19379,19379,19379,19379
29095,643,2956,17156,11939,0,29095,4.85616e+18,648.494,6992.46,29095,519,375,25794,24772,17980,17874,7375
42724,1392,1894,0,42724,13251,29473,8.57633e+15,616.909,6553.38,42724,429,330,40830,40706,39421,39569,33570
23821,1207,2611,23821,0,21317,2504,1.64655e+18,1086.41,6082.45,23821,336,412,20866,20174,17832,17670,13289
43958,1529,2667,0,43958,13081,30877,9.34045e+15,679.398,7950.9,43958,490,466,41291,41064,39397,39388,30983
5698,639,996,3328,2370,0,5698,4.54889e+18,283.145,1950.63,5698,202,175,4702,4678,4603,4527,4240
43214,419,938,43214,0,43214,0,4.08071e+18,355.056,4022.87,43214,224,224,42276,41974,34125,33703,29880
35414,212,222,0,35414,34687,727,2.48603e+16,126.472,1853.06,35414,101,99,35192,35192,35172,35059,34938
27932,577,1677,0,27932,8875,19057,8.82782e+15,567.542,5004.36,27932,368,394,26020,25123,20479,20871,15113
14228,14,564,14228,0,14199,29,4.00679e+18,278.503,2121.68,14228,145,149,7039,3377,2879,2379,339
21656,716,1556,0,21656,6782,14874,9.03354e+15,548.323,4405.63,21656,308,295,20033,18661,17559,17549,9585
35622,53,331,0,35622,34819,803,2.60381e+16,145.846,2240.22,35622,111,117,34384,33185,27400,24863,17100
25083,2644,2892,25083,0,22686,2397,1.4989e+18,776.243,6577.15,25083,333,371,22191,22129,22151,22137,21514
47490,26,365,0,47490,46498,992,2.67004e+16,143.413,2713.92,47490,112,121,44595,42979,36328,28422,18520
7769,1749,1837,7769,0,6932,837,1.56794e+18,290.312,3161.18,7769,220,241,5932,5932,5926,5928,5859
2701,505,531,0,2701,0,2701,2.28146e+18,285.372,1042.68,2701,139,120,2170,2170,2170,2168,2137
23385,11,16,23289,96,23385,0,2.16198e+18,15.9891,611.686,23385,16,16,15580,0,8764,14605,15580
15554,34,35,15354,200,15554,0,1.00237e+14,17.6583,415.553,15554,20,23,15519,15519,15461,15461,15486
47931,282,1028,47931,0,47931,0,4.17988e+18,373.323,4312.48,47931,233,222,46324,44735,28643,26361,23326
48405,39,291,0,48405,47199,1206,2.5304e+16,144.304,2449.72,48405,112,110,46392,45108,38312,34432,21210
12839,798,962,4072,8767,0,12839,3.36808e+13,374.208,2761.31,12839,259,219,11877,11875,11672,11682,11556
44576,238,1150,44576,0,44576,0,4.25894e+18,400.128,4353.52,44576,236,236,42175,39580,25054,24035,18166
43771,2129,3898,25563,18208,25563,18208,1.89151e+18,1172.95,9842.93,43771,484,632,39873,38989,37891,38115,27344
22287,1883,3465,22287,0,19976,2311,1.76748e+18,708.179,6920.83,22287,323,512,18822,18685,14903,14228,11510
16802,887,931,4783,12019,0,16802,3.83079e+13,509.75,2993.91,16802,300,211,15871,15871,15868,15863,15844
20635,214,1366,6279,14356,0,20635,3.56537e+13,596.884,4058,20635,305,284,17824,16216,11610,10543,4558
9696,612,1856,8794,902,5834,3862,2.04554e+18,339.35,3408.35,9696,255,182,7840,7426,6471,6271,4655
21556,1782,1849,12455,9101,0,21556,4.74496e+18,728.794,4993.72,21556,329,458,19707,19700,19674,19669,19630
7165,1147,1316,4326,2839,0,7165,5.19702e+18,220.354,2449.08,7165,253,240,5849,5849,5847,5848,5403
46662,1083,4053,42140,4522,27604,19058,1.96156e+18,977.028,9939.07,46662,465,500,42039,40438,30035,29193,19396
24888,21,55,24460,428,24888,0,1.01414e+14,18.3928,575.715,24888,25,26,24829,24810,22953,22747,17836
30250,543,918,30250,0,30250,0,4.44868e+18,383.02,3442.48,30250,200,206,29332,29114,26277,26041,26584
35826,4311,4601,35826,0,31840,3986,2.61296e+18,1214.94,9866.6,35826,429,508,31225,31225,31225,31225,30945
1509,410,416,899,610,899,610,1.91637e+18,116.816,664.571,1509,102,71,1093,1093,1093,1093,1091
22538,638,1240,6422,16116,0,22538,3.65571e+13,539.313,3947.98,22538,306,294,21184,20385,19855,19896,13047
32533,334,2165,18632,13901,0,32533,4.36212e+18,1365.56,6221.12,32533,374,434,27391,25014,13849,12072,5048
27486,443,3038,27486,0,24521,2965,1.17699e+18,1030.24,7164.04,27486,480,367,21684,18349,14994,13934,6024
14313,24,38,14145,168,14313,0,1.0061e+14,16.2807,399.028,14313,19,23,14275,14274,13811,13812,12034
44628,52,1010,44628,0,44628,0,4.48341e+18,387.287,4215.53,44628,238,233,31132,20828,14026,12311,4599
46394,156,2379,0,46394,13582,32812,9.3047e+15,701.987,7531.95,46394,448,472,38679,33809,26930,23479,6905
28179,527,1690,0,28179,8143,20036,9.38306e+15,730.027,4969,28179,377,298,25879,24971,21786,21997,13581
2294,278,709,1424,870,1424,870,1.86514e+18,136.814,1121.04,2294,102,161,1585,1407,1398,1408,739
33321,3301,3392,19616,13705,0,33321,4.88006e+18,1162.8,8129.77,33321,469,491,29929,29929,29918,29910,29654
25267,96,97,24757,510,25267,0,1.03747e+14,17.4156,719.386,25267,29,24,25170,25170,25170,25170,25161
47161,536,1146,47161,0,47161,0,4.22677e+18,421.762,4457.53,47161,237,235,46015,45770,38649,38346,34660
42142,258,1265,42142,0,42142,0,4.16201e+18,394.379,4382.47,42142,223,230,40153,38430,23080,21529,18525
36446,1953,2791,20458,15988,0,36446,4.17831e+18,974.699,7193.36,36446,350,438,33655,33512,32804,32591,27787
4345,403,706,2703,1642,2703,1642,1.85336e+18,292.644,1458.07,4345,141,148,3619,2906,3362,3359,2697
49714,2070,4092,49714,0,44191,5523,2.8007e+18,1446.45,10533.4,49714,562,500,45622,44249,39876,38302,32762
38025,37,49,37206,819,38025,0,9.73858e+13,17.202,693.058,38025,24,26,37976,37976,37065,37065,33797
23566,2038,3702,23566,0,20772,2794,2.15385e+18,814.428,7420.02,23566,440,374,19864,19558,19248,18895,16043
20402,921,2693,20402,0,18191,2211,2.68016e+18,645.037,5939.28,20402,347,366,17709,16393,15412,14565,8157
42915,71,3255,38690,4225,25185,17730,1.98171e+18,1314.33,8740.92,42915,478,484,26297,18629,10693,9125,1513
41087,982,1155,41075,12,41087,0,4.1701e+18,383.601,4223.12,41087,231,230,39932,39930,39464,39427,39333
17226,18,37,16921,305,17208,18,1.01178e+14,18.3941,483.864,17226,21,23,17174,17139,15970,15946,13741
48999,2239,4873,28500,20499,28500,20499,1.78549e+18,818.71,11331,48999,714,682,44126,43664,33285,30190,19824
33188,3350,3499,33188,0,29498,3690,2.64892e+18,1254.01,8313.04,33188,505,468,29689,29685,29688,29683,29493
41413,2500,3420,24874,16539,0,41413,4.83026e+18,1018.3,9005.77,41413,669,452,37993,37990,37072,36776,34223
41963,1090,2710,0,41963,12955,29008,9.16941e+15,517.522,7896.69,41963,601,300,39253,39037,32216,31932,22927
31965,1533,3568,28507,3458,19061,12904,1.94482e+18,1211.68,8193.89,31965,578,507,27970,26665,24176,23877,16936
17675,26,52,17410,265,17675,0,1.03752e+14,17.7709,479.482,17675,23,25,17623,17617,16547,16546,13685
49666,1590,3369,29573,20093,0,49666,4.76951e+18,1195.64,9531.26,49666,490,496,46122,45330,40843,40174,25414
5311,173,175,0,5311,5250,61,2.58464e+16,52.6665,692.573,5311,46,48,5136,5136,5136,5136,5136
34927,2909,3328,31022,3905,21109,13818,1.98637e+18,1105.03,8226.71,34927,419,419,31599,31593,31562,31560,30649
12673,17,193,0,12673,12336,337,2.6667e+16,92.4864,1038.93,12673,66,70,11667,11139,9542,8809,5126
22687,212,229,0,22687,22452,235,2.47455e+16,129.824,1449.06,22687,89,85,22458,22456,22441,22415,22357
22244,1784,1829,0,22244,6126,16118,9.31456e+15,536.964,4852.68,22244,438,278,20415,20414,20412,20405,20333
48963,3053,4667,48959,4,42829,6134,1.0946e+18,1440.79,11541.1,48963,491,756,44296,43304,42966,42772,37018
34945,627,811,34945,0,34945,0,4.10859e+18,346.974,3541.06,34945,217,215,34134,34092,33203,33088,32552
21818,29,48,21322,496,21818,0,1.01622e+14,17.6428,521.291,21818,24,24,21770,21767,21153,21155,18185
38459,2135,3300,23101,15358,0,38459,4.87741e+18,638.766,8381.61,38459,470,399,35159,35083,33110,32512,23621
48025,3551,3720,43035,4990,28848,19177,1.97978e+18,1580.38,10214.7,48025,518,554,44305,44303,44294,44294,44010
21219,526,912,21219,0,21219,0,4.29812e+18,303.613,2900.88,21219,182,182,20307,20230,18304,18202,17164
4983,472,665,0,4983,1589,3394,8.88732e+15,162.204,1505.99,4983,130,181,4318,4301,4280,4269,3877
32349,258,606,32349,0,32349,0,4.55452e+18,304.313,3024.16,32349,187,185,31475,30645,19793,19548,17774
20148,187,1555,5576,14572,0,20148,3.70829e+13,461.243,4169.77,20148,252,294,17013,14745,11798,10635,4896
1602,14,86,0,1602,1591,11,2.63582e+16,36.5144,249.463,1602,33,37,1454,1402,1278,1219,801
12411,325,437,12399,12,12411,0,4.12505e+18,246.338,1836.55,12411,136,148,11972,11849,11061,11082,10566
34892,2625,3004,31372,3520,20982,13910,1.99263e+18,1139.71,7863,34892,439,422,31888,31887,31832,31840,31261
6401,1188,1326,5737,664,3848,2553,2.04551e+18,345.246,2433.94,6401,180,219,5075,5065,5024,5027,4853
19136,241,1418,6137,12999,0,19136,3.45146e+13,492.496,3945.09,19136,293,285,16327,14659,9463,9512,5017
37585,2091,2258,11389,26196,0,37585,3.44778e+13,667.696,6667.07,37585,436,418,35327,35325,35296,35296,34909
47695,533,2311,13646,34049,0,47695,3.72209e+13,1066.92,7517.33,47695,512,534,43776,41063,32488,32094,13377
36144,1711,3402,36144,0,32691,3453,2.05555e+18,1156.71,7958.36,36144,439,435,32742,31688,30857,30525,24408
46824,226,300,0,46824,45875,949,2.57505e+16,149.937,2469.24,46824,114,120,46524,46514,45292,44870,41044
45249,2585,4327,0,45249,0,45249,2.33553e+18,900.674,10325.5,45249,489,614,40922,40769,39719,39371,31995
31496,609,988,31496,0,31496,0,4.05262e+18,371.934,3592.52,31496,215,208,30508,30373,27055,27041,25653
9971,134,148,0,9971,9840,131,2.46142e+16,51.4007,761.463,9971,50,52,9823,9822,9812,9806,9354
15904,835,2064,14360,1544,9221,6683,1.94852e+18,626.04,4628.38,15904,274,343,13527,11965,10649,10675,5567
33118,2706,3143,0,33118,0,33118,2.42556e+18,1136.64,7712.35,33118,443,532,29975,29884,29779,29738,27795
43350,1511,3238,26115,17235,0,43350,4.95473e+18,949.595,8777.69,43350,469,427,40112,39614,37955,37418,28302
12770,2278,2423,12770,0,11408,1362,1.87744e+18,485.65,4601.33,12770,288,379,10347,10347,10337,10326,10213
34237,2416,3180,30779,3458,20778,13459,1.95121e+18,982.921,7812.3,34237,442,420,31057,31025,29053,28903,26748
15849,8,54,15511,338,15824,25,1.06275e+14,16.7592,476.351,15849,25,22,15561,15412,13675,13203,8033
8395,352,1055,0,8395,2347,6048,9.64457e+15,259.284,2358.78,8395,215,174,7313,6958,6634,6705,4164
16123,180,233,0,16123,15917,206,2.5077e+16,98.7734,1310.39,16123,78,76,15890,15869,15480,15477,14957
17513,457,664,17513,0,17513,0,4.19479e+18,292.877,2455.4,17513,170,164,16849,16808,16018,16037,15641
38277,1919,3507,34149,4128,23424,14853,1.93268e+18,874.724,8610.1,38277,452,486,34770,34627,33465,33484,27990
37337,3908,4495,33198,4139,21948,15389,1.97036e+18,1075.34,9669.94,37337,604,457,32842,32680,32643,32640,31327
28272,1109,3223,28272,0,25481,2791,1.7516e+18,1006.36,7322.1,28272,408,410,24816,22965,18021,15753,10400
37373,345,870,37361,12,37373,0,4.30153e+18,352.955,3697.95,37373,211,212,36416,35880,26257,25660,22322
4176,58,75,0,4176,4099,77,2.51236e+16,35.2921,365.8,4176,36,40,4101,4098,4025,4030,3817
13816,1248,2199,12358,1458,8339,5477,1.93284e+18,462.868,4469.3,13816,342,250,11617,11440,10038,9815,7608
1520,119,387,487,1033,0,1520,3.04674e+13,71.6296,686.157,1520,100,83,1119,1028,845,817,493
40484,2077,3390,24523,15961,0,40484,4.88145e+18,807.33,8454.21,40484,643,374,37094,36937,35037,34437,29972
29205,2525,2602,26374,2831,16011,13194,1.86862e+18,734.715,6245.66,29205,411,381,26603,26603,26603,26603,26569
26207,30,261,0,26207,25519,688,2.56974e+16,135.039,1788.48,26207,93,90,24937,24005,20379,16863,10717
47421,3205,3989,47421,0,42435,4986,1.21255e+18,1289.65,10184.3,47421,528,490,43432,43356,42910,42955,40559
43745,406,3322,38125,5620,25066,18679,1.96169e+18,1321.11,9309.95,43745,464,556,35313,30187,15237,13801,6220
47100,239,3524,47100,0,41779,5321,2.07985e+18,1251.58,9521.56,47100,460,512,34652,26533,14368,4384,5564
39238,373,3179,0,39238,0,39238,2.08849e+18,983.661,8294.6,39238,372,629,33576,30811,18650,20379,6100
33435,181,936,33423,12,33435,0,4.06836e+18,346.906,3610.09,33435,210,207,30841,27788,18237,17391,12404
49054,1981,3173,0,49054,0,49054,2.30477e+18,1386.89,9067.73,49054,572,511,45881,45042,43944,41605,33298
38033,199,1369,11949,26084,0,38033,2.87811e+13,553.301,4836.79,38033,309,339,35017,33597,24735,25411,11081
30581,1436,3529,26836,3745,18027,12554,1.96388e+18,1039.08,8181.86,30581,427,446,26782,24755,20253,19782,15393
30677,1493,2702,18823,11854,0,30677,4.83654e+18,861.365,6833.72,30677,469,368,27975,27635,25381,24531,19045
6877,2,28,6701,176,6877,0,1.07155e+14,15.9346,273.963,6877,19,20,4873,4198,4025,4200,2988
31672,1426,2742,19289,12383,0,31672,4.85204e+18,585.264,6960.65,31672,488,352,28930,28896,22240,22165,17292
9103,6,40,8944,159,9103,0,1.02658e+14,15.4276,344.145,9103,21,20,8789,8559,7434,7478,4681
25196,13,223,0,25196,24525,671,2.62423e+16,127.415,1486.7,25196,86,94,22981,21969,18631,15105,8698
18395,132,226,0,18395,17928,467,2.63552e+16,112.184,1408.66,18395,82,85,18153,18062,16945,16888,14575
30165,2,8,28280,1885,30053,112,0.000232057,0.999735,489.51,30165,8,1,30157,30157,30157,30157,30157
18350,1529,2395,0,18350,0,18350,2.50347e+18,603.453,4988.3,18350,438,307,15955,15797,15049,12721,13090
25099,1686,3587,22760,2339,14867,10232,1.98827e+18,734.435,7397.02,25099,378,370,21512,21260,20225,20379,15159
17210,694,1270,4681,12529,0,17210,3.68188e+13,608.995,3599.23,17210,383,268,15778,15106,14521,14572,11361
42071,1690,1942,0,42071,0,42071,2.29813e+18,1088.04,6830.79,42071,425,390,40129,39652,39537,39010,37999
10915,128,1148,6462,4453,6462,4453,1.87856e+18,483.651,2830.88,10915,246,201,7665,6295,5052,4215,1904
13347,2068,2410,13347,0,11912,1435,2.46293e+18,403.55,4437.14,13347,237,387,10937,10937,10863,10896,10084
29554,381,1409,0,29554,8283,21271,9.69023e+15,703.478,4833.19,29554,369,288,27102,25869,23264,23668,11329
5060,40,1087,3015,2045,0,5060,4.91498e+18,130.811,1893.38,5060,205,139,3209,2433,2013,1902,225
33182,218,277,0,33182,32465,717,2.63414e+16,137.92,1937.9,33182,101,97,32905,32862,31924,31702,30322
7309,607,1259,4308,3001,4308,3001,1.84179e+18,289.549,2440.06,7309,200,200,6050,5740,5563,5578,3538
10375,38,139,0,10375,10114,261,2.61144e+16,77.8589,784.01,10375,58,64,9898,9623,8536,7956,5211
23350,1581,2878,0,23350,0,23350,2.51403e+18,704.059,6194.13,23350,418,463,20472,19930,19435,19626,11493
18781,766,2252,0,18781,0,18781,2.1567e+18,530.568,4902.11,18781,331,321,16529,15887,12403,10240,6998
7313,6,20,7241,72,7313,0,9.00276e+13,13.5434,250.194,7313,16,17,7141,7028,6204,6317,4304
39950,1380,1942,12703,27247,0,39950,3.46464e+13,620.396,6095.25,39950,423,357,38008,37835,36624,36708,32862
42234,161,301,0,42234,41267,967,2.63175e+16,135.306,2200.52,42234,101,118,41926,41827,38574,36551,31717
13800,1437,1804,0,13800,0,13800,2.38913e+18,464.73,3800.28,13800,296,248,11996,11995,11884,11540,11503
22658,648,2173,13838,8820,0,22658,4.88394e+18,576.776,5296.58,22658,313,337,20336,18466,15104,14748,8052
42477,61,90,41594,883,42477,0,9.92855e+13,20.1076,918.825,42477,31,30,42387,42386,41121,41136,33125
8101,487,1480,7237,864,5128,2973,1.87886e+18,442.333,2918.05,8101,220,249,6289,4921,4866,4688,3168
47538,1867,3513,0,47538,0,47538,2.3272e+18,1047.86,9386.33,47538,548,393,44025,43257,39501,32399,29489
1933,375,625,1722,211,1118,815,2.06514e+18,105.171,918.418,1933,123,74,1308,1230,1254,1263,1043
44353,266,3865,26028,18325,0,44353,4.66133e+18,867.083,9725.44,44353,425,662,36126,31136,23136,19563,6961
21878,541,632,21878,0,21878,0,4.37337e+18,279.207,2624.54,21878,175,173,21246,21236,20980,20927,20639
23181,156,251,0,23181,22876,305,2.6161e+16,109.023,1606.57,23181,83,95,22930,22890,21750,21483,18398
6246,876,1807,5650,596,3774,2472,2.00599e+18,221.479,2789.61,6246,196,257,4439,4344,4053,4132,2642
33225,1261,2539,29703,3522,18723,14502,1.95589e+18,956.811,6825.56,33225,390,393,30686,29351,26228,25156,22249
42823,720,3399,24446,18377,0,42823,4.57e+18,1233.56,9213.99,42823,400,660,37556,35017,24956,20506,13882
3221,278,675,0,3221,0,3221,2.66642e+18,145.539,1222.86,3221,149,122,2546,2309,2327,2099,1611
38100,1028,4222,38100,0,33882,4218,2.90954e+18,1142.25,9496.45,38100,482,631,32941,30017,21468,19327,8470
32116,168,4059,32116,0,28893,3223,2.96507e+18,803.135,8404.02,32116,456,518,21263,16212,9689,6514,1373
25477,471,3371,22916,2561,14799,10678,1.91239e+18,518.028,7097.37,25477,378,469,21661,19691,15171,13231,8540
44723,1251,2437,0,44723,14089,30634,9.05279e+15,676.901,7362.83,44723,370,382,42286,41896,38132,38645,23843
1996,1660,1996,1996,0,0,1996,15.992,0,1996,1996,1996,1,0,0,0,0,0
21268,829,1750,0,21268,6220,15048,9.38029e+15,521.114,4542.59,21268,316,320,19518,19052,18257,18286,12714
24696,727,3342,14076,10620,0,24696,4.39818e+18,439.305,6805.55,24696,400,342,21354,20433,11377,11260,5475
32555,146,264,0,32555,32072,483,2.52905e+16,134.555,1844.84,32555,98,110,32255,32120,29442,29892,25363
30863,1619,1896,9068,21795,0,30863,3.72624e+13,605.54,5612.02,30863,312,338,28967,28945,28895,28911,27750
49821,73,1123,49821,0,49821,0,4.06986e+18,349.493,4431.42,49821,237,239,38672,28399,21017,19327,7268
25947,14,16,25851,96,25947,0,2.16188e+18,15.9901,644.323,25947,16,16,22475,0,19449,21069,22475
41251,119,919,41251,0,41251,0,4.23419e+18,354.823,3909.99,41251,219,217,36376,31010,18361,16796,11054
31501,588,1830,0,31501,9278,22223,9.37094e+15,696.097,5644.25,31501,405,354,29112,27586,23615,23584,14234
42467,2629,3079,24736,17731,24736,17731,1.84494e+18,935.715,8247.71,42467,561,477,39388,39332,38896,38778,35384
3690,381,967,0,3690,0,3690,2.58974e+18,136.752,1513.4,3690,158,148,2723,2570,2609,2553,1231
30205,423,2113,9205,21000,0,30205,3.35796e+13,527.604,5821.6,30205,328,387,27543,26529,22572,22536,12630
41179,2662,4569,41179,0,36785,4394,2.54629e+18,811.577,10213.6,41179,477,374,36610,36569,36271,35961,26529
39089,479,725,39089,0,39089,0,4.12759e+18,353.386,3594.97,39089,209,201,38364,38245,36070,36038,33979
32106,15,88,31542,564,32106,0,1.04354e+14,20.4911,813.869,32106,33,30,31920,31816,28294,28285,16083
37390,686,1984,11682,25708,0,37390,3.43546e+13,653.75,6469.04,37390,368,478,35001,34089,31117,31283,14425
41850,513,3086,24388,17462,24388,17462,1.71819e+18,896.785,8506.85,41850,412,487,36261,32874,28190,25690,10197
47879,2457,2828,0,47879,0,47879,2.42237e+18,1272.04,8662.76,47879,567,474,45051,45033,44302,43930,43235
40479,558,902,40479,0,40479,0,4.35929e+18,358.39,3786.63,40479,219,214,39577,39479,35513,34991,34078
46342,17,75,45495,847,46342,0,1.01045e+14,18.524,817.628,46342,28,31,46232,46162,41475,40985,27131
10682,551,1616,6173,4509,6173,4509,1.69047e+18,287.185,3232.15,10682,196,256,9066,8702,8499,8193,5336
4366,259,360,4366,0,4366,0,3.98598e+18,178.533,1033.43,4366,91,93,4006,3911,3699,3681,3512
31249,235,311,0,31249,30811,438,2.59393e+16,143.153,2059.35,31249,103,109,30938,30888,30081,29824,28988
18688,1919,2685,16420,2268,10845,7843,1.96172e+18,884.829,5634.09,18688,363,388,16003,15323,15424,15534,13814
44851,263,2702,44851,0,39880,4971,2.37241e+18,1492.29,8138.2,44851,491,425,34125,26582,12456,6409,6571
19665,610,1742,0,19665,5702,13963,9.34916e+15,424.363,4338.01,19665,351,236,17923,17546,14045,14441,9786
41377,2189,2213,13081,28296,0,41377,3.58554e+13,699.676,6963.33,41377,501,451,39164,39164,39155,39155,39139
43984,317,1173,43984,0,43938,46,4.546e+18,384.468,4363.66,43984,230,238,42479,40990,26916,26319,23159
25522,566,2230,0,25522,0,25522,2.41111e+18,906.261,5834.82,25522,378,369,22244,21373,18297,15944,9297
6268,915,919,0,6268,1827,4441,9.64173e+15,195.351,1919.22,6268,190,190,5349,5349,5349,5349,5346
46015,5080,5416,41133,4882,27816,18199,1.9553e+18,1211.85,11902.6,46015,551,658,40599,40599,40595,40592,40168
18123,734,2014,16119,2004,10974,7149,1.97261e+18,860.304,4860.76,18123,287,341,15487,13768,9853,9621,9215
31932,1436,2056,0,31932,9875,22057,8.43442e+15,577.872,5879.11,31932,314,374,29876,29685,29691,29585,25617
45424,61,80,44340,1084,45424,0,9.94807e+13,20.5057,827.981,45424,29,33,45344,45344,44615,44622,42398
3383,767,774,0,3383,0,3383,2.35865e+18,196.362,1403.8,3383,129,170,2609,2609,2609,2609,2609
9606,347,1262,8732,874,5141,4465,1.84967e+18,197.935,2572.17,9606,157,192,8344,8080,4144,3122,1389
39727,2809,2954,24039,15688,0,39727,4.83491e+18,1083.62,8211.29,39727,526,347,36773,36773,36745,36744,36532
9900,188,190,0,9900,9702,198,2.74693e+16,94.2906,981.39,9900,73,82,9710,9710,9709,9706,9708
2308,13,24,2271,37,2302,6,1.0598e+14,10.812,163.636,2308,14,15,2279,2270,2187,2194,1744
17356,1069,2360,15639,1717,9857,7499,1.95859e+18,588.269,5046.39,17356,299,419,14996,14436,13349,13475,9059
20859,594,3547,20859,0,18134,2725,2.83715e+18,679.098,6974.67,20859,392,394,16763,15191,12349,10815,4184
26482,412,672,26482,0,26482,0,4.04243e+18,296.338,2901.43,26482,194,182,25810,25731,23576,23406,23441
17057,2103,2185,10320,6737,10320,6737,1.92046e+18,656.902,4780.53,17057,301,314,14872,14872,14866,14864,14731
2947,47,117,0,2947,2877,70,2.64073e+16,47.3865,411.993,2947,40,47,2797,2731,2525,2474,1689
5849,734,1355,0,5849,0,5849,2.28702e+18,228.195,2370.46,5849,142,284,4494,4473,4235,4285,2871
5023,13,26,4891,132,5023,0,1.04678e+14,12.9005,229.559,5023,16,18,4990,4973,4619,4616,3601
47107,383,2417,15008,32099,0,47107,3.50647e+13,695.817,7432.08,47107,389,436,42980,40643,27462,22426,12490
37670,929,1111,37281,389,37670,0,4.12002e+18,364.241,3985.71,37670,217,221,36559,36546,36199,36247,35263
37742,2284,3346,22429,15313,0,37742,4.8615e+18,1249.05,8416.55,37742,484,538,34396,33442,32823,32533,27717
31160,3749,3782,0,31160,0,31160,2.35134e+18,718.738,8201.63,31160,387,497,27378,27378,27376,27376,27349
41356,2336,3231,37268,4088,24427,16929,1.92309e+18,957.511,8494.78,41356,399,459,38125,38109,37571,37723,36129
9951,5,204,0,9951,9768,183,2.44393e+16,92.4742,1009.94,9951,72,62,7706,6617,6160,5758,3531
4764,741,1312,4764,0,4280,484,3.12842e+18,223.118,2090.6,4764,219,165,3452,3317,3360,3323,2406
35864,2702,3289,21167,14697,21167,14697,1.76697e+18,863.136,8288.18,35864,525,530,32575,32569,32139,32280,28629
17025,754,1811,10236,6789,0,17025,4.84722e+18,750.726,4285.57,17025,319,281,14854,14129,13182,12764,8445
740,54,237,0,740,237,503,9.78769e+15,47.6581,363.006,740,53,46,485,403,329,333,225
36293,326,3408,32193,4100,22226,14067,1.94086e+18,776.719,8572.78,36293,384,556,27515,21351,14258,13289,6596
38986,1030,1888,12340,26646,0,38986,3.52089e+13,464.202,5886.62,38986,376,401,37098,37020,34719,34863,26919
21660,2071,2891,13287,8373,0,21660,4.79763e+18,896.977,6205.11,21660,338,458,18769,18137,17864,17711,15215
39470,682,2865,0,39470,0,39470,2.43154e+18,1266.31,8088.25,39470,485,472,34137,31363,23394,20905,11023
509,33,159,151,358,0,509,3.45691e+13,32.8861,260.516,509,46,38,307,233,224,223,136
4938,309,959,3159,1779,0,4938,4.7373e+18,282.452,1841.25,4938,157,202,3774,3085,2978,3072,2188
45813,8,76,44864,949,45813,0,9.91828e+13,19.0818,833.63,45813,26,30,45131,44712,39647,38839,20112
23063,1219,1405,0,23063,6916,16147,9.28456e+15,559.181,4270.9,23063,367,314,21658,21651,21455,21487,20764
43309,1331,4967,43309,0,38960,4349,2.57706e+18,980.805,10982.8,43309,591,497,38222,36560,30646,29663,14966
5962,370,695,5962,0,5342,620,1.3446e+18,201.981,1636.01,5962,179,122,5267,5149,3332,3317,3438
18055,688,2594,10733,7322,10733,7322,1.90646e+18,651.122,5254.62,18055,329,396,15140,13758,13429,13178,8245
36211,418,762,36161,50,36211,0,4.15195e+18,358.37,3531.47,36211,211,209,35449,35155,29943,29763,29368
6868,611,995,3877,2991,0,6868,4.50337e+18,269.907,2101.6,6868,214,177,5873,5769,5671,5589,4930
31875,1158,3461,19140,12735,0,31875,4.88641e+18,969.369,8164.09,31875,548,419,28014,26789,22054,22251,13807
1804,202,438,0,1804,0,1804,2.45433e+18,169.557,755.515,1804,99,94,1306,1097,1143,1091,708
47516,2329,4092,27379,20137,27379,20137,1.78975e+18,1099.36,10191.5,47516,427,589,43424,43062,42211,42586,32681
1910,99,276,1910,0,1910,0,4.21858e+18,132.344,628.998,1910,73,73,1520,1266,1077,1026,832
3630,818,956,3630,0,3182,448,2.27454e+18,261.707,1623.19,3630,182,127,2674,2667,2662,2657,2523
25119,209,2024,7991,17128,0,25119,3.5189e+13,477.133,5405.97,25119,394,330,21544,19452,13273,11292,5704
37742,77,82,37193,549,37742,0,1.01964e+14,21.2333,775.78,37742,30,29,37660,37658,37398,37399,37050
46586,651,4854,46586,0,42110,4476,2.73073e+18,1143.58,10897.5,46586,535,533,40163,36863,24141,20266,11569
28903,510,3047,25763,3140,16738,12165,1.97701e+18,1273.61,7377.61,28903,400,487,23747,21647,13653,12916,6478
16014,1657,2612,16014,0,14387,1627,2.14707e+18,477.347,5088.73,16014,335,290,13402,13328,13102,13382,9249
40749,1775,4086,35856,4893,24502,16247,1.96553e+18,939.048,9721.15,40749,454,446,36663,36154,28305,27153,22020
20279,2077,2139,11648,8631,11648,8631,1.66717e+18,575.51,5018.09,20279,327,311,18140,18140,18129,18128,18058
22816,651,797,22816,0,22816,0,4.28522e+18,322.15,2911.77,22816,187,184,22019,22018,21388,21394,21218
37196,616,1056,37196,0,37196,0,4.05848e+18,350.811,3931.53,37196,222,220,36140,36066,31987,31602,29204
12125,371,1259,3545,8580,0,12125,3.66531e+13,340.933,3075.99,12125,232,283,10620,9959,9563,9598,4643
27636,469,744,27614,22,27636,0,4.19228e+18,320.984,3107.53,27636,191,193,26892,26823,23877,23785,20389
46870,4243,4313,46870,0,41727,5143,2.81179e+18,1501.33,10900.2,46870,479,511,42557,42557,42557,42544,42486
12048,478,999,0,12048,3477,8571,9.37643e+15,329.963,2628.38,12048,251,282,11049,10661,10021,10029,6750
36248,522,2527,21861,14387,0,36248,4.98814e+18,1110.71,7228.19,36248,542,473,30895,27991,19454,17193,9133
18024,436,1957,0,18024,0,18024,2.4001e+18,350.373,4353.98,18024,306,271,15995,15292,12280,8967,8728
28313,16,59,27783,530,28295,18,9.85906e+13,18.1794,684.387,28313,26,24,28225,28167,25193,25411,13922
10996,866,1039,0,10996,3595,7401,8.70396e+15,331.73,2702.9,10996,235,223,9957,9878,9864,9847,8708
8861,1247,2077,7927,934,5253,3608,2.00149e+18,413.236,3550.87,8861,262,269,6784,6523,6349,6445,4589
40267,220,278,0,40267,39429,838,2.49564e+16,145.347,2263.65,40267,105,113,39989,39977,38769,38594,37238
40195,943,2662,12527,27668,0,40195,3.48505e+13,442.83,7747.37,40195,295,596,37533,37134,35495,35622,18886
15175,18,48,14894,281,15175,0,1.03613e+14,16.7492,442.254,15175,23,22,15120,15093,13850,13702,10779
28371,568,1516,8312,20059,0,28371,3.33347e+13,517.503,4694.75,28371,353,256,26527,25590,23888,24003,16205
7386,811,839,0,7386,2292,5094,7.45444e+15,185.793,1979.37,7386,256,136,6547,6547,6532,6540,6456
3411,777,893,2040,1371,2040,1371,1.83603e+18,166.038,1515.22,3411,145,190,2518,2513,2478,2489,2369
47141,1882,2280,14212,32929,0,47141,3.47328e+13,790.891,7513.53,47141,517,505,44861,44806,43430,43543,41905
2968,75,118,0,2968,2941,27,2.22874e+16,46.2867,372.369,2968,38,42,2850,2802,2678,2736,2426
46836,5,289,0,46836,45647,1189,2.4567e+16,137.536,2412.38,46836,109,115,36017,30524,27881,24874,16382
30559,1620,3690,27651,2908,18212,12347,1.93592e+18,994.988,8375.71,30559,387,458,26825,25501,22661,22365,16341
7640,433,460,7640,0,7640,0,4.32576e+18,229.117,1445.67,7640,120,119,7180,7178,7169,7165,7142
32752,682,1982,0,32752,10214,22538,8.83705e+15,495.665,6062.34,32752,320,444,30614,30090,27447,27584,16757
8904,48,490,8904,0,8904,0,3.84927e+18,221.183,1618.56,8904,119,116,6297,4341,3115,2726,1612
35260,3615,3746,31525,3735,20806,14454,1.95273e+18,840.264,8744.12,35260,504,433,31514,31513,31514,31514,31283
33615,1975,4421,29812,3803,19975,13640,1.9794e+18,927.188,9503.01,33615,471,463,29194,28037,20882,19949,17302
13062,115,2284,13037,25,11585,1477,2.16365e+18,610.02,4427.16,13062,323,322,8234,6546,3127,1593,941
40172,2223,5182,35648,4524,23450,16722,1.95951e+18,821.369,11253.7,40172,365,921,34990,34840,32633,32952,19152
29400,3348,3997,29379,21,26117,3283,1.95559e+18,785.079,8407.31,29400,396,407,25403,25363,25318,25315,24088
2361,38,506,1443,918,1443,918,1.0807e+18,121.592,933.19,2361,123,76,1036,336,307,317,46
22503,607,2952,13450,9053,13450,9053,1.84264e+18,841.321,6247.54,22503,363,438,18790,17213,14241,13738,6338
20687,2067,2984,20687,0,18124,2563,2.92179e+18,847.958,6309.09,20687,333,358,17703,17423,17076,16884,15028
25433,456,1729,8166,17267,0,25433,3.15259e+13,598.535,4915.68,25433,304,330,23211,22476,15273,15743,7797
36937,1539,3138,36937,0,33802,3135,2.64247e+18,1233.06,8084.84,36937,457,422,33665,30515,29877,28019,17553
22798,1804,3001,13595,9203,0,22798,4.95895e+18,669.449,6433.26,22798,397,442,19797,19375,19240,19118,14975
34065,1977,2587,0,34065,0,34065,2.40751e+18,894.73,6988.37,34065,405,435,31478,31461,30888,30787,25757
15070,1633,2636,0,15070,0,15070,2.37082e+18,343.466,4875.41,15070,405,350,12434,12400,12015,11178,9851
48204,1394,3754,28683,19521,0,48204,4.86205e+18,1236,9988.1,48204,540,571,43890,41622,34954,33477,25869
20505,1977,2703,20505,0,18247,2258,2.4373e+18,690.551,5866.13,20505,415,334,17802,17684,17280,17198,14996
1429,106,600,1334,95,926,503,1.89931e+18,163.7,857.495,1429,108,104,673,483,296,269,147
46813,61,2857,28051,18762,28051,18762,1.85474e+18,980.348,8463.36,46813,506,463,29077,20808,16497,13139,1777
11570,440,1320,6881,4689,6881,4689,1.80457e+18,366.291,3056.03,11570,315,171,10192,9669,8314,7612,5886
21177,1020,2008,12815,8362,12815,8362,1.85035e+18,590.639,5231.35,21177,376,329,19169,18808,17437,17282,12947
36123,19,60,35689,434,35996,127,1.01282e+14,20.755,760.607,36123,28,27,36030,35972,32873,32496,23715
47908,1537,3965,47908,0,42555,5353,2.63054e+18,1249.08,10454.2,47908,496,513,43343,41200,35762,32823,25181
3320,182,746,0,3320,0,3320,2.37314e+18,264.623,1344.74,3320,140,161,2340,1952,1570,1494,1078
22881,1395,1801,0,22881,6955,15926,9.45837e+15,558.151,5027.21,22881,345,329,21080,21063,20879,20827,19635
4996,205,1236,4996,0,4498,498,2.49256e+18,159.65,2105.66,4996,169,180,3740,3172,1433,884,740
22549,2915,3144,20139,2410,13511,9038,1.95465e+18,931.446,6645.31,22549,436,375,19405,19404,19363,19363,18871
952,149,212,952,0,952,0,3.88748e+18,67.5788,402.746,952,56,52,740,721,682,684,536
8606,158,164,0,8606,8405,201,2.59981e+16,87.3564,827.579,8606,63,70,8442,8439,8428,8415,8402
5076,462,824,0,5076,0,5076,2.37882e+18,214.408,1741.79,5076,151,175,4252,4243,4108,4129,2851
16816,489,564,16816,0,16816,0,3.96681e+18,270.052,2205.12,16816,160,164,16252,16245,15856,15883,15997
17387,160,197,0,17387,17025,362,2.67684e+16,108.71,1241.84,17387,84,93,17190,17168,16872,16895,16474
41360,1935,4332,37183,4177,23683,17677,1.98004e+18,1452.55,9957.85,41360,546,477,36924,34468,24520,23818,21352
1244,196,349,0,1244,0,1244,2.72134e+18,98.9035,557.836,1244,68,57,895,799,789,756,624
10121,98,2236,10121,0,8966,1155,2.1863e+18,314.268,3940.3,10121,231,387,6428,4631,2274,976,725
47364,670,3451,42561,4803,27928,19436,1.90906e+18,1189.96,9541.09,47364,486,460,41483,37219,22359,19841,13586
33403,257,305,0,33403,32759,644,2.6316e+16,144.392,2017.46,33403,101,104,33098,33089,32604,32564,31253
6646,1193,1298,3945,2701,0,6646,4.41165e+18,305.117,2417.97,6646,206,180,5348,5348,5342,5345,5255
37910,92,289,0,37910,37209,701,2.48372e+16,156.358,2232.33,37910,103,107,37354,36855,32541,30410,24391
37309,2985,3102,33097,4212,22203,15106,1.96091e+18,1419.2,8218.67,37309,424,424,34207,33767,34200,34203,33914
43936,151,214,0,43936,43430,506,2.538e+16,153.927,1820.01,43936,104,109,43667,43508,40842,40827,37760
45198,863,3624,26694,18504,26694,18504,1.88488e+18,1234.08,9486.9,45198,441,513,40064,37181,36324,34179,16392
46233,1145,2715,27473,18760,27473,18760,1.90963e+18,1183.9,8394.39,46233,595,400,42900,41453,37331,35382,25252
44018,203,2546,14165,29853,0,44018,3.46453e+13,986.911,7821.56,44018,466,496,37808,34093,20381,10188,7871
15604,607,2069,13980,1624,9438,6166,2.05645e+18,886.571,4569,15604,314,332,12335,10819,8538,8344,6487
27682,279,3599,24626,3056,16478,11204,1.93236e+18,827.904,7768.42,27682,410,430,20893,16443,10135,8176,3775
19016,3226,3726,19016,0,17054,1962,1.45673e+18,514.372,6723.09,19016,428,374,15290,15274,15176,15202,14159
27280,137,259,0,27280,26729,551,2.65277e+16,139.253,1827.97,27280,95,102,26956,26766,24413,23959,19319
38073,1774,2320,11402,26671,0,38073,3.70029e+13,661.254,6935.34,38073,414,502,35753,35727,35099,35135,30984
16448,197,611,16448,0,16448,0,4.16225e+18,286.975,2315.59,16448,164,170,15303,14010,10374,9990,8249
41021,241,3133,0,41021,0,41021,2.2017e+18,1007.48,8361.69,41021,432,480,32320,27884,13956,13722,1996
30060,2121,3094,30060,0,27511,2549,2.00902e+18,843.466,7453.99,30060,384,405,26966,26585,25637,25222,22316
49336,1737,2765,27609,21727,27609,21727,1.6122e+18,1343.89,8326.81,49336,424,502,46050,44764,44277,43869,35143
14377,365,568,14367,10,14377,0,4.33464e+18,282.772,2130.02,14377,148,151,13809,13670,11888,11730,11322
5408,22,30,5285,123,5408,0,1.04564e+14,14.0703,234.942,5408,19,18,5378,5378,5188,5188,4978
37835,53,1755,0,37835,11992,25843,8.5827e+15,732.048,5740.77,37835,388,362,26941,21388,16937,15627,3349
43499,983,2462,0,43499,0,43499,2.45237e+18,1221.93,7645.34,43499,517,407,39948,37844,36933,32544,21882
23637,3085,3185,13696,9941,13696,9941,1.70281e+18,429.034,6567.71,23637,505,311,20452,20451,20451,20451,19563
20356,865,2042,20356,0,17949,2407,2.82589e+18,776.849,5018.24,20356,302,337,18116,16701,15004,14629,11085
1177,147,185,1062,115,568,609,1.86668e+18,108.125,428.086,1177,61,58,992,985,965,961,937
35312,112,781,35312,0,35312,0,4.15414e+18,360.46,3463.99,35312,201,205,31118,25974,16145,14550,8524
2510,177,476,1508,1002,0,2510,4.71809e+18,248.229,938.456,2510,115,116,1780,1398,1224,1193,986
3643,228,1080,2125,1518,2125,1518,1.68687e+18,120.9,1695.35,3643,211,120,2563,2380,1876,1815,1352
7122,559,1241,4120,3002,0,7122,5.02757e+18,276.852,2416.09,7122,210,176,5881,5621,5359,5334,2945
14728,1598,3075,12973,1755,8796,5932,1.91011e+18,510.094,5608,14728,317,380,11653,11510,10585,10661,7910
2138,27,105,0,2138,2117,21,2.96927e+16,36.5561,340.965,2138,40,36,1999,1928,1689,1622,1153
15720,81,544,15720,0,15720,0,4.45528e+18,264.24,2182.27,15720,161,154,12745,9907,6841,6051,3512
22165,2467,2850,12950,9215,12950,9215,1.84145e+18,537.433,6150.89,22165,391,319,19315,19282,19216,19239,18262
32569,223,1909,19151,13418,19151,13418,1.76648e+18,1055.18,5949.63,32569,378,422,25609,21446,17571,12847,5177
4845,637,650,0,4845,0,4845,2.10354e+18,164.905,1475.07,4845,157,123,4195,4195,4195,4195,4185
27910,24,2460,17025,10885,17025,10885,1.86329e+18,647.782,6027.4,27910,352,457,13430,8101,6361,6009,342
41901,110,313,0,41901,40981,920,2.59505e+16,157.888,2369.85,41901,117,127,41314,40820,36422,33755,25831
38214,2,70,37536,678,38214,0,1.00373e+14,18.6041,764.304,38214,28,27,27531,24052,22951,23598,16038
34325,193,3679,0,34325,0,34325,2.30624e+18,674.328,8515.29,34325,356,489,26113,21280,13885,9744,2935
25159,941,1660,25159,0,22337,2822,1.76381e+18,969.506,4862.45,25159,360,277,22981,21777,21585,21596,17428
6926,155,353,6926,0,6926,0,4.18925e+18,211.043,1286.99,6926,117,102,6253,5575,4530,4352,3479
26120,1979,2840,23030,3090,15683,10437,1.96958e+18,789.319,6701.21,26120,422,336,23280,23109,22161,22261,18383
22715,918,1524,13737,8978,0,22715,5.0345e+18,895.238,4537.13,22715,380,287,20707,17633,18872,18594,16827
23989,1730,3360,14113,9876,0,23989,5.02908e+18,428.212,6824.34,23989,381,458,20629,20487,19963,20029,15300
25281,133,269,0,25281,24924,357,2.67014e+16,129.762,1778.97,25281,93,104,24958,24842,22948,22447,18278
11270,26,45,11076,194,11270,0,1.00877e+14,17.8836,404.654,11270,23,25,11225,11218,10787,10810,10015
46156,77,275,0,46156,45255,901,2.66181e+16,146.504,2415.21,46156,106,122,45365,44601,38981,36102,25631
24888,127,263,0,24888,24568,320,2.63992e+16,132.731,1738.81,24888,83,93,24583,24455,22970,22432,18399
8376,87,190,0,8376,8231,145,2.64453e+16,72.4649,862.212,8376,57,59,8176,8079,7614,7563,5694
17573,2660,2780,17573,0,15344,2229,2.38067e+18,748.528,5731.95,17573,278,420,14793,14792,14756,14750,14686
10308,53,1934,10308,0,9201,1107,2.57482e+18,708.711,3705.36,10308,248,271,5885,4365,1685,717,386
27353,3237,4398,24824,2529,16194,11159,1.95963e+18,937.229,8698.82,27353,435,532,22955,22522,22332,22550,19428
31955,2015,2855,18904,13051,0,31955,5.00199e+18,716.817,7183.4,31955,482,414,29100,29034,27743,27514,22147
14227,159,197,0,14227,14120,107,2.63069e+16,69.2562,1104.72,14227,61,70,14030,14024,13813,13908,13347
46457,84,1939,0,46457,13171,33286,9.65491e+15,763.361,6653.24,46457,499,388,35453,30883,22374,19451,6194
40178,1980,4351,36055,4123,24088,16090,1.96632e+18,1104.69,10090.7,40178,497,608,35827,35184,32258,32205,16464
35288,1757,1818,0,35288,10519,24769,9.39618e+15,776.476,5888.75,35288,439,386,33470,33470,33449,33448,33335
43273,670,2370,0,43273,0,43273,2.32295e+18,943.843,6860.8,43273,387,439,39994,38374,28019,22021,18956
16481,1154,2506,9823,6658,0,16481,4.5105e+18,559.464,5214.35,16481,323,528,13975,13618,12795,12836,8261
49748,324,344,0,49748,48815,933,2.56739e+16,160.656,2766.16,49748,118,128,49404,49404,49393,49354,48882
20571,165,2656,12420,8151,12420,8151,1.88395e+18,907.515,5795.34,20571,367,395,14851,12256,9211,7114,2515
28002,1888,2798,17324,10678,17324,10678,1.8364e+18,502.11,6698.66,28002,309,444,25204,25167,24635,24853,17966
43360,930,2644,26135,17225,26135,17225,1.79954e+18,1128.36,8066.47,43360,426,458,39377,36449,33819,33216,17259
26579,1687,2272,0,26579,7939,18640,9.03465e+15,430.641,5882.91,26579,373,369,24307,24289,24064,23955,20150
14893,1678,2235,0,14893,0,14893,2.28578e+18,594.707,4675.23,14893,307,368,12658,12369,12341,12341,11018
4843,249,1155,4384,459,2910,1933,1.98513e+18,326.958,2008.51,4843,181,171,3292,2588,1844,1860,1024
31995,129,3176,31995,0,28614,3381,2.42684e+18,977.219,7607.77,31995,411,431,21081,16102,7850,3896,2088
32396,136,326,0,32396,31768,628,2.62198e+16,148.763,2159.32,32396,98,111,31988,31798,28409,27188,21236
16963,1461,2810,15196,1767,10103,6860,1.92977e+18,541.545,5678.67,16963,312,394,14153,13949,13188,13290,8996
8273,305,1174,8273,0,7483,790,2.47182e+18,197.306,2427.8,8273,177,199,7099,6782,6380,6209,4160
35062,580,3554,35037,25,31454,3608,1.5719e+18,970.338,8243.68,35062,476,461,29619,26672,19760,18308,7664
3317,350,598,1058,2259,0,3317,3.54354e+13,146.003,1187.53,3317,134,151,2719,2634,2528,2535,2016
49101,811,1080,49091,10,49091,10,4.34088e+18,367.798,4360.02,49101,238,243,48021,47994,46327,46305,44554
28180,1253,3621,25357,2823,17353,10827,1.91313e+18,955.555,8105.36,28180,433,467,24292,22245,19159,18729,12103
9210,564,759,0,9210,2980,6230,7.22556e+15,135.416,1946.71,9210,135,161,8451,8451,8406,8398,7815
14062,91,189,0,14062,13741,321,2.62876e+16,87.7644,1101.92,14062,69,80,13825,13637,12514,12415,10268
47492,269,312,0,47492,46905,587,2.60059e+16,153.368,2522.68,47492,106,115,47180,47178,46602,46234,44656
23661,1572,1581,6522,17139,0,23661,3.76014e+13,666.754,4763.45,23661,369,314,22080,22080,22076,22077,22073
7498,1217,1283,4424,3074,0,7498,5.17243e+18,254.961,2440,7498,198,200,6215,6215,6207,6201,6004
39419,2210,2539,11558,27861,0,39419,3.70079e+13,618.02,7458.43,39419,527,359,36880,36867,36746,36732,35852
34538,1057,2340,0,34538,0,34538,2.46993e+18,1096.1,6689.75,34538,416,424,31534,29834,29549,25866,15470
29819,31,32,29377,442,29819,0,9.76419e+13,18.6009,538.161,29819,21,23,29787,29787,29439,29439,29782
22788,1665,1767,0,22788,6807,15981,9.38679e+15,638.145,4811.44,22788,389,349,21021,21000,21003,20996,20581
27744,31,83,27270,474,27723,21,1.08374e+14,16.8948,686.102,27744,28,26,27661,27657,25856,25802,18145
17322,159,1618,17322,0,15778,1544,1.95072e+18,382.313,3608.66,17322,277,241,14830,12198,3791,2197,1033
42538,235,3506,0,42538,0,42538,2.35475e+18,899.843,8841.91,42538,389,461,32967,26623,18795,14657,5772
20199,1888,1897,0,20199,5877,14322,9.5444e+15,439.259,4669.14,20199,322,258,18302,18302,18302,18302,18300
39365,19,294,0,39365,38867,498,2.58174e+16,158.227,2194.23,39365,109,123,36672,35386,29916,24863,14553
703,11,15,693,10,703,0,1.24922e+14,6.74822,74.51,703,9,9,688,685,615,615,618
11765,55,187,0,11765,11477,288,2.57485e+16,95.3185,1044.23,11765,64,70,11386,11156,10094,9236,6860
42252,1585,3051,26103,16149,0,42252,4.84733e+18,820.729,8293.65,42252,386,464,39201,38481,35352,34565,24467
17782,1875,2425,10352,7430,0,17782,4.5054e+18,573.64,5104.02,17782,326,263,15357,15128,15065,15035,13925
16198,74,195,0,16198,15897,301,2.5944e+16,126.626,1234.34,16198,87,92,15751,15313,13810,12983,10754
8576,299,1408,5111,3465,5111,3465,1.92836e+18,353.008,2827.61,8576,237,285,6713,5771,5539,5336,1196
36346,640,881,36346,0,36346,0,4.13114e+18,355.205,3709.4,36346,214,212,35465,35434,34119,34054,32854
47163,1729,3226,47163,0,42109,5054,2.53572e+18,1040.69,8916.1,47163,527,436,43937,43438,42614,42546,36903
1866,408,695,1866,0,1605,261,1.9591e+18,100.311,1003.2,1866,79,131,1171,1143,1018,1016,850
22976,561,2159,0,22976,0,22976,2.40501e+18,642.298,5255.86,22976,413,276,19951,18145,13273,11611,6837
49362,215,393,0,49362,48046,1316,2.57622e+16,153.589,2932.74,49362,119,126,48949,48877,46091,45436,38308
40117,7,36,39317,800,40117,0,9.78713e+13,19.484,648.346,40117,23,24,39331,38959,34241,33635,23648
46235,227,1729,12823,33412,0,46235,3.67783e+13,876.604,6540.28,46235,526,359,40178,35587,28636,28428,11265
41441,1423,1722,12864,28577,0,41441,3.20458e+13,686.738,6082.49,41441,397,375,39719,39671,39046,39097,37653
48647,709,2746,14175,34472,0,48647,3.68616e+13,963.628,8449.98,48647,498,445,45029,43687,34461,35030,18704
1678,247,642,1085,593,1085,593,1.73881e+18,129.563,925.158,1678,134,104,1036,872,765,759,454
29115,2138,3386,26011,3104,17478,11637,1.97042e+18,1101.9,7636.22,29115,436,466,25729,24820,24206,24497,19835
47199,2242,3926,28827,18372,0,47199,4.98988e+18,984.997,9625.64,47199,555,618,43273,42695,40964,40592,34390
12946,896,1552,7633,5313,0,12946,4.52477e+18,494.3,3565.31,12946,223,263,11394,10938,10539,10526,9108
21822,39,686,21703,119,21822,0,4.12406e+18,309.503,2698.67,21822,176,176,14906,10807,7144,6566,2305
19776,2413,2619,11589,8187,0,19776,4.47686e+18,718.98,5697.41,19776,408,353,17157,17110,17059,17076,16614
22145,512,679,22145,0,22145,0,4.40752e+18,319.26,2753.96,22145,182,177,21466,21423,19959,19955,19485
7857,10,482,7857,0,7857,0,4.80021e+18,247.029,1536.72,7857,120,115,3155,1338,1015,964,126
45081,2336,5433,45081,0,39814,5267,2.87496e+18,1176.08,11860.4,45081,536,683,39648,38618,37732,37005,26588
44937,29074,44937,44937,0,0,44937,15.9996,0,44937,44937,44937,1,0,0,0,0,0
43473,54,75,42351,1122,43473,0,9.80014e+13,18.0616,788.851,43473,28,29,43398,43398,42591,42593,39882
29963,1425,1971,17830,12133,17830,12133,1.89045e+18,1013.76,5906.96,29963,426,391,27992,27261,26597,26563,23087
747,353,448,0,747,0,747,1.54393e+18,33.0977,550.628,747,104,51,299,298,296,299,272
9098,821,1049,2858,6240,0,9098,3.54134e+13,258.85,2471.92,9098,281,215,8049,8043,7928,7929,7344
7860,27,919,0,7860,2253,5607,1.01084e+16,290.506,2141.11,7860,223,189,5157,4143,3440,3392,881
23260,333,1249,0,23260,6654,16606,9.39285e+15,494.419,3906.14,23260,307,250,21444,19613,14643,15195,9230
12165,25,36,11927,238,12165,0,9.94709e+13,14.9527,359.203,12165,23,19,12129,12127,11720,11719,10788
44605,383,2711,0,44605,0,44605,2.39019e+18,1475.94,8201.61,44605,522,516,38097,32601,24983,20829,7958
3576,108,725,2139,1437,2139,1437,1.82774e+18,282.17,1364.84,3576,166,142,2310,1815,1560,1344,686
14315,195,1152,0,14315,4316,9999,9.16051e+15,372.424,3090.91,14315,267,230,12091,10477,8711,8933,4853
10535,893,2143,6088,4447,0,10535,4.99601e+18,302.694,3874.2,10535,351,232,8392,8161,6840,7127,4945
17016,601,2930,9992,7024,0,17016,4.86757e+18,382.925,5557.35,17016,417,294,14046,13111,7053,6839,3094
31312,1019,3460,0,31312,0,31312,2.40516e+18,798.665,7814.92,31312,531,452,27589,26077,21704,18855,12513
31117,190,276,0,31117,30641,476,2.60355e+16,128.55,1937.26,31117,91,104,30841,30775,29615,29423,27472
45723,397,1995,13711,32012,0,45723,3.66117e+13,807.129,6624.61,45723,596,446,42065,39876,28176,28117,14910
15061,767,2873,15061,0,13274,1787,2.73153e+18,453.888,5312.87,15061,254,378,12188,11371,10810,10524,4586
28861,9,42,28004,857,28855,6,9.88544e+13,19.5137,566.285,28861,22,24,28553,28369,24891,25186,16177
12073,414,1747,0,12073,0,12073,2.34663e+18,323.444,3650.65,12073,191,344,10251,9734,9150,9172,3229
22877,3,50,22560,317,22841,36,1.02417e+14,19.764,605.351,22877,23,26,18925,16887,16561,16320,10512
22346,32,954,22346,0,22346,0,4.22323e+18,352.377,3105.12,22346,195,196,12447,6136,4942,4549,1600
28583,2026,2872,16623,11960,0,28583,4.68881e+18,618.389,6903.26,28583,449,419,25711,25654,23758,22997,20688
19606,378,2000,12019,7587,12019,7587,1.8155e+18,606.45,4854.54,19606,318,310,16415,13593,10948,9927,5183
5169,10,24,5034,135,5169,0,1.03246e+14,13.9719,228.089,5169,17,18,5117,5091,4532,4478,3595
13219,5,31,12940,279,13219,0,1.07275e+14,17.4243,383.322,13219,21,23,12374,11693,10447,10593,6765
25834,2459,3177,0,25834,0,25834,2.291e+18,593.266,6858.97,25834,378,398,22657,22596,22031,21873,20485
17986,1398,1550,0,17986,5528,12458,8.62088e+15,492.06,3939.22,17986,288,322,16436,16370,16359,16363,16098
28209,32,44,27649,560,28209,0,9.63497e+13,20.3795,625.549,28209,24,22,28165,28165,27081,27084,25786
45779,2789,3470,0,45779,0,45779,2.27456e+18,1283.51,9427.14,45779,510,660,42309,41675,41346,40017,38875
6046,358,408,6046,0,6046,0,4.39339e+18,230.905,1286.98,6046,115,110,5638,5636,5572,5568,5501
22900,1575,1858,13950,8950,0,22900,4.977e+18,841.677,4840.51,22900,342,332,21042,20753,20620,20558,19537
35271,239,279,0,35271,34606,665,2.54779e+16,140.058,2008.11,35271,97,105,34992,34989,34688,34342,33384
11186,957,1139,9913,1273,6838,4348,1.98411e+18,431.509,2830,11186,220,235,10047,10047,9793,9736,9284
8761,13,16,8729,32,8761,0,2.1624e+18,15.9708,374.401,8761,16,16,6996,0,5466,6558,6996
36646,1729,2388,0,36646,11305,25341,9.14022e+15,473.091,6922.06,36646,344,470,34258,34244,34040,33946,30091
21613,32,38,21253,360,21601,12,1.00984e+14,19.6214,550.754,21613,24,25,21575,21575,21422,21453,20927
22234,210,253,0,22234,21677,557,2.63484e+16,98.6769,1456.05,22234,83,82,21981,21981,21724,21733,20968
18318,928,2817,11127,7191,0,18318,4.98858e+18,671.232,5593.95,18318,329,338,15485,14697,10692,10146,6218
32265,995,2952,19088,13177,19088,13177,1.6842e+18,532.791,7194.33,32265,447,313,29313,28929,23544,22573,14076
3507,243,333,3507,0,3507,0,4.44283e+18,175.242,912.591,3507,88,79,3174,3094,2862,2849,2667
6418,316,469,6418,0,6418,0,4.26934e+18,219.155,1368.85,6418,121,124,5949,5847,5216,5215,4921
40447,2136,3687,0,40447,0,40447,2.27137e+18,1259.05,9164.75,40447,504,521,36760,35990,33009,32575,24110
7859,874,1132,4704,3155,0,7859,4.86543e+18,375.031,2337.36,7859,220,169,6727,6556,6669,6619,5907
42923,121,2190,0,42923,13173,29750,8.75679e+15,589.156,6647.56,42923,389,333,36107,31794,21431,18541,6444
49601,1988,2184,27132,22469,0,49601,4.11973e+18,1084.08,7028.99,49601,398,396,47417,47417,47395,47407,46814
22545,705,2216,0,22545,0,22545,2.13327e+18,725.897,5348.53,22545,343,360,19544,18272,14509,12288,8787
49891,70,321,0,49891,49313,578,2.56826e+16,142.899,2549.69,49891,129,122,48762,47587,41001,37253,26703
11468,350,599,11468,0,11468,0,4.10288e+18,246.115,1952.25,11468,146,148,10869,10727,9451,9359,8947
41860,2927,2983,24883,16977,0,41860,4.69386e+18,1067.35,8287.93,41860,404,586,38877,38877,38866,38868,38814
1501,348,379,484,1017,0,1501,4.05218e+13,68.1679,641.342,1501,67,92,1122,1106,1115,1114,1072
15547,130,446,15547,0,15547,0,4.57912e+18,304.656,2053.35,15547,149,160,13742,11803,8570,7895,4952
30174,1019,2553,17902,12272,17902,12272,1.87709e+18,817.653,6498.23,30174,480,350,27260,26557,25291,24099,16688
24920,1428,1536,7260,17660,0,24920,3.60986e+13,547.367,4497.13,24920,336,320,23384,23384,23336,23329,23216
41283,2130,4649,37158,4125,23858,17425,1.97471e+18,1406.99,10571.3,41283,479,575,36368,34669,32528,32959,19046
1258,183,272,628,630,0,1258,3.74464e+18,84.9499,523.648,1258,79,56,986,967,860,863,697
10927,218,2012,10927,0,9744,1183,1.87041e+18,599.763,3919.62,10927,244,365,7739,6183,3957,3595,867
14858,33,1489,4082,10776,0,14858,3.57364e+13,396.959,3661.06,14858,316,257,9978,7652,6674,5574,1402
44941,2621,3356,40425,4516,26805,18136,1.97993e+18,1261.18,9135.42,44941,490,445,41585,41574,41178,41116,38782
24615,645,779,24609,6,24615,0,4.09942e+18,305.353,2981.68,24615,196,188,23836,23822,23323,23329,23334
2554,26,27,2511,43,2554,0,1.08336e+14,12.3692,174.312,2554,16,15,2527,2527,2527,2527,2522
23791,275,547,23791,0,23791,0,4.06997e+18,312.47,2656.79,23791,183,181,23053,22356,18408,18171,16592
5143,243,539,1502,3641,0,5143,3.05148e+13,197.37,1345.71,5143,142,135,4491,4207,3954,3975,2908
26724,158,297,0,26724,26151,573,2.78427e+16,130.688,1948.62,26724,103,103,26418,26287,24542,23794,20508
49095,757,4518,49074,21,44074,5021,1.94093e+18,1997.07,11625.1,49095,537,618,40403,35177,24322,24455,11663
5498,24,1017,0,5498,0,5498,2.34231e+18,294.799,2033.63,5498,142,207,2565,1471,1284,1149,172
43572,802,1090,43572,0,43572,0,4.24521e+18,387.486,4221.15,43572,230,240,42482,42439,40397,40234,39532
6898,989,1282,0,6898,0,6898,2.25184e+18,200.743,2325.54,6898,186,182,5616,5577,5525,5602,5296
20976,657,685,20976,0,20976,0,4.16024e+18,311.074,2647.35,20976,182,171,20291,20291,20246,20266,20258
31832,1066,1856,0,31832,9582,22250,8.50608e+15,635.971,5667.42,31832,389,382,29976,29311,28925,28937,21393
6892,26,909,0,6892,2049,4843,8.60052e+15,159.096,1996.46,6892,164,194,4279,3202,2485,2394,498
24139,1372,2023,0,24139,0,24139,2.33695e+18,751.227,5262.05,24139,326,409,22116,21928,21036,20227,16208
24169,1715,2878,14917,9252,0,24169,4.73182e+18,501.323,6341.72,24169,389,333,21291,21241,20374,20101,14665
18645,1522,2951,16572,2073,10429,8216,1.9172e+18,463.781,5749.35,18645,285,523,15694,15474,13515,13691,11129
35847,88,289,0,35847,35412,435,2.49299e+16,125.035,2044.08,35847,100,122,35347,34988,30958,29602,23145
8401,187,815,0,8401,2794,5607,8.56252e+15,175.924,2036.26,8401,175,162,7300,6587,5479,5327,3333
16344,1275,2947,14632,1712,9771,6573,2.04546e+18,593.227,5554.02,16344,297,310,13397,12936,11240,10958,7147
24056,71,262,0,24056,23502,554,2.73362e+16,121.1,1750.28,24056,99,101,23513,23036,19372,18117,13299
49035,1178,3546,28885,20150,0,49035,4.75737e+18,1614.28,10074.4,49035,591,682,43652,41293,35015,34261,20245
47424,299,992,47184,240,47424,0,3.99871e+18,349.886,4226.6,47424,225,228,46072,44870,33461,32533,28126
42883,143,329,0,42883,42189,694,2.56285e+16,137.137,2452.81,42883,98,125,42511,42387,38533,35989,28544
22100,2231,2529,13311,8789,0,22100,4.89919e+18,1000.57,5883.87,22100,430,361,19571,19358,19054,18972,18846
32335,652,2634,0,32335,0,32335,2.37496e+18,1013.94,6886.82,32335,447,417,27853,25391,20344,20458,11144
13389,535,1337,4507,8882,0,13389,3.41472e+13,354.35,3361.45,13389,260,371,12052,11752,11230,11162,5081
19393,37,53,19170,223,19393,0,1.03472e+14,17.9056,518.813,19393,24,25,19340,19338,18853,18853,17394
9666,685,1331,5804,3862,0,9666,4.81445e+18,634.786,2960.12,9666,231,272,8020,7187,6603,6671,5905
38824,795,842,38824,0,38824,0,4.29017e+18,340.156,3732.02,38824,220,228,37982,37982,37852,37858,37728
28790,118,782,28790,0,28790,0,4.13523e+18,334.752,3166.76,28790,202,192,24916,20686,14809,13037,7217
10853,67,2258,10828,25,9809,1044,1.92931e+18,422.049,3991.47,10853,252,248,6335,4066,2392,1185,412
21783,724,1644,13079,8704,0,21783,4.70102e+18,609.511,4511.71,21783,298,349,20023,19479,16484,16164,14178
3435,377,699,1969,1466,1969,1466,2.03468e+18,179.672,1261.66,3435,154,105,2736,2463,2513,2416,1534
1064,197,364,339,725,0,1064,3.53169e+13,33.1024,541.956,1064,70,69,700,698,639,633,410
20023,40,58,19665,358,20023,0,1.05685e+14,16.4867,535.973,20023,24,25,19965,19965,19340,19343,16915
38016,3796,4258,34402,3614,22376,15640,1.92234e+18,1235.63,9840.9,38016,498,520,33758,33589,33699,33725,32098
2071,283,353,588,1483,0,2071,3.64955e+13,149.597,697.09,2071,99,91,1718,1716,1678,1673,1599
45168,192,2456,0,45168,14148,31020,8.87423e+15,689.86,7834.9,45168,397,467,38725,35110,22379,20538,7490
30448,2963,3262,26960,3488,18200,12248,1.96638e+18,996.639,7811.84,30448,369,412,27186,27186,27165,27165,26415
36722,263,309,0,36722,36033,689,2.64943e+16,150.94,2256.36,36722,109,116,36413,36407,36002,35773,34424
8941,105,200,0,8941,8764,177,2.56445e+16,73.0708,898.695,8941,64,61,8741,8689,8206,8273,6936
12739,459,1066,4117,8622,0,12739,3.45079e+13,444.096,2980.19,12739,230,296,11408,10769,10251,10302,5771
37291,30,53,36705,586,37291,0,9.417e+13,18.9675,746.409,37291,25,26,37238,37233,35738,35720,30611
3039,635,657,0,3039,843,2196,9.61554e+15,108.057,1156.62,3039,173,86,2382,2382,2382,2382,2362
6850,24,29,6692,158,6850,0,1.07413e+14,14.7766,280.369,6850,18,21,6821,6821,6588,6588,6550
46792,3107,3545,0,46792,0,46792,2.44528e+18,1218.75,9243.64,46792,539,418,43247,43137,43110,43139,42219
37405,255,2946,0,37405,0,37405,2.40179e+18,884.974,7716.02,37405,521,439,28907,24047,17876,15339,4635
657,60,261,657,0,541,116,2.57908e+18,40.6332,369.355,657,59,41,371,256,145,174,132
631,4,13,624,7,631,0,1.10181e+14,7.29635,67.3288,631,9,8,560,515,484,496,425
40790,1007,3074,24572,16218,24572,16218,1.8791e+18,1073.67,8412.81,40790,477,495,37100,35866,33794,32547,19254
34261,84,294,0,34261,33631,630,2.66686e+16,137.756,2082.61,34261,95,109,33677,33103,28908,26078,17299
45621,811,921,45585,36,45621,0,4.15805e+18,339.483,4038.41,45621,226,226,44700,44693,44498,44495,44109
10130,1345,1557,5752,4378,5752,4378,1.57912e+18,208.184,2997.59,10130,198,197,8573,8571,8518,8572,6564
15253,15093,15253,0,15253,0,15253,1048510,0,15253,15253,15253,1,0,0,0,0,0
7543,7,218,0,7543,7422,121,2.61368e+16,73.7392,933.575,7543,62,68,6206,5405,4981,4441,2517
49503,2828,3436,29668,19835,29668,19835,1.89545e+18,1073.58,9371.22,49503,575,557,46067,46064,45611,45810,38965
37774,2107,2151,11516,26258,0,37774,3.57612e+13,776.569,6239.32,37774,380,353,35623,35623,35614,35621,35542
43651,1812,1998,0,43651,12338,31313,9.69017e+15,870.356,6840.63,43651,538,409,41653,41650,41373,41366,40697
42472,25,72,41623,849,42472,0,1.00623e+14,22.9093,801.141,42472,27,31,42394,42383,40219,39911,31519
20457,710,2021,11972,8485,0,20457,4.64354e+18,957.428,4990.45,20457,355,379,17756,16610,14111,14195,8388
48704,204,342,0,48704,47674,1030,2.498e+16,150.998,2734.17,48704,109,135,48362,48314,45468,44967,40325
37309,133,361,0,37309,36574,735,2.61103e+16,132.987,2480.94,37309,112,122,36901,36686,33405,31564,26586
22603,159,639,22603,0,22603,0,4.10479e+18,315.788,2683.14,22603,182,169,20518,18097,13449,12729,7868
4249,213,490,1314,2935,0,4249,3.46842e+13,240.622,1170.05,4249,156,138,3509,3004,2938,2917,2038
19480,13,44,19225,255,19480,0,1.05221e+14,17.089,482.178,19480,22,24,19390,19339,17388,17295,11620
5277,1,22,5200,77,5277,0,1.0268e+14,15.5056,225.422,5277,17,18,2130,2130,2130,2130,2130
25150,504,763,25108,42,25150,0,4.20729e+18,328.568,2967.6,25150,189,190,24387,24300,22843,22858,22653
38273,612,1120,38242,31,38273,0,4.43354e+18,349.336,3935.72,38273,222,223,37153,37055,33138,32946,29723
9810,1131,1154,5848,3962,0,9810,4.8321e+18,542.604,2678.7,9810,248,223,8656,8472,8649,8651,8615
48933,588,3059,0,48933,45875,3058,0.0624936,0.937486,12234.3,48933,3059,1,45874,45874,45874,45874,45874
3194,488,950,2835,359,2033,1161,1.88899e+18,216.043,1526.43,3194,116,133,2244,1954,1705,1699,1273
20280,1722,3062,18071,2209,11981,8299,1.99682e+18,520.397,6279.67,20280,317,368,17218,17017,16433,16554,12476
48212,1691,3964,29068,19144,29068,19144,1.80066e+18,882.554,9672.62,48212,538,416,44248,43353,39959,38405,27144
37246,842,2374,33581,3665,22246,15000,2.02645e+18,1056.93,7122.58,37246,427,360,33155,28752,22765,21277,13916
4993,87,1483,4993,0,4480,513,2.35623e+18,214.25,2390.71,4993,222,220,2739,1937,1364,1102,555
37937,1601,3771,22467,15470,22467,15470,1.80374e+18,831.836,9203.17,37937,417,559,34166,33552,32024,31633,16389
5265,715,1303,3181,2084,3181,2084,2.0584e+18,191.996,2151.49,5265,178,172,3962,3867,3753,3850,2524
28933,1118,1459,0,28933,8649,20284,9.57195e+15,785.43,4909.57,28933,360,331,27474,26986,26477,26488,25008
49170,120,309,0,49170,48044,1126,2.58115e+16,153.576,2583.84,49170,108,123,48654,48261,43957,40537,33338
5213,705,1230,5213,0,4692,521,2.09867e+18,264.716,2128.16,5213,153,174,3983,3865,3119,3087,2790
30536,557,823,30526,10,30536,0,4.34778e+18,344.75,3347.5,30536,199,200,29713,29656,27439,27433,26526
5240,5,21,5134,106,5240,0,9.71199e+13,13.4599,221.424,5240,15,17,4889,4634,4092,4108,3264
42858,238,2272,0,42858,13605,29253,8.39573e+15,576.93,6742.05,42858,380,451,38197,34944,21917,18943,6156
14470,811,2368,14445,25,13200,1270,2.21346e+18,449.461,4512.4,14470,238,394,12102,11466,11387,11097,7739
28094,2254,2611,16343,11751,16343,11751,1.73418e+18,767.562,6392.7,28094,461,304,25483,25477,25212,25223,21419
10805,110,188,0,10805,10615,190,2.54286e+16,84.877,926.327,10805,68,74,10606,10566,9734,9746,8647
37958,2737,3697,33885,4073,22674,15284,1.96666e+18,987.748,9050.07,37958,450,564,34261,34244,33812,33978,28869
33833,2579,3372,19923,13910,0,33833,5.04842e+18,1017.92,8197.03,33833,539,478,30461,30394,29434,29249,27546
1751,553,587,0,1751,0,1751,2.61308e+18,82.5363,878.38,1751,90,104,1164,1151,1160,1162,1134
11211,123,612,11211,0,11211,0,4.20826e+18,277.69,1983.53,11211,140,153,9462,7774,4811,4738,3253
3882,4,20,3850,32,3882,0,9.83932e+13,13.145,189.348,3882,14,16,3438,3162,2937,2969,1792
30126,238,719,30126,0,30126,0,4.25241e+18,348.827,3173.43,30126,200,199,28857,27281,19634,18777,15092
20169,100,1427,5939,14230,0,20169,3.67011e+13,553.856,3955.96,20169,328,285,15799,13523,10355,9013,2490
8018,225,1276,0,8018,0,8018,2.29917e+18,433.445,2612.84,8018,224,234,6058,4927,3773,2736,1836
36185,1135,2883,0,36185,0,36185,2.3047e+18,777.542,7595.48,36185,360,409,33302,32749,26088,19763,14476
38742,310,3609,23086,15656,23086,15656,1.83331e+18,837.978,8871.04,38742,508,505,30832,26657,20282,16129,5930
2936,1,18,2911,25,2936,0,9.67333e+13,11.7047,162.561,2936,16,14,1193,1193,1193,1193,1193
36236,1761,4074,36236,0,32620,3616,2.73081e+18,1660.29,9665.89,36236,433,625,31264,29792,26962,25499,14576
18168,864,2716,0,18168,0,18168,2.17481e+18,543.284,5631.19,18168,401,318,15350,14793,10591,10727,7810
42088,967,4289,25027,17061,25027,17061,1.81251e+18,681.319,10193.6,42088,394,638,37577,36287,34680,34853,16037
6647,555,819,2182,4465,0,6647,3.22933e+13,230.551,1897.37,6647,213,173,5828,5801,5216,5227,4233
25657,3044,3126,14763,10894,14763,10894,1.78315e+18,399.66,6716.68,25657,510,394,22531,22531,22521,22524,22482
14672,1278,2034,14672,0,13037,1635,2.24016e+18,554.316,4341.13,14672,265,264,12638,12618,12443,12418,11344
4593,759,1021,1424,3169,0,4593,3.15061e+13,122.37,1836.78,4593,256,140,3572,3566,3479,3470,3045
29652,158,3182,26445,3207,17839,11813,1.97361e+18,1166.45,7632.64,29652,469,395,20353,16460,9752,7587,2909
23404,1332,2470,14633,8771,14633,8771,1.80555e+18,497.358,5885.61,23404,421,291,20934,20910,18106,18474,11413
32737,26,1793,9757,22980,0,32737,3.6451e+13,686.087,5555.49,32737,427,361,20486,15434,12283,5369,2769
18833,991,2615,0,18833,0,18833,2.182e+18,417.598,5394.06,18833,282,391,16218,15816,14635,12381,7335
47252,26,74,46261,991,47216,36,1.01565e+14,23.7257,878.858,47252,31,27,47172,47156,44202,44011,32109
19388,133,251,0,19388,18925,463,2.59643e+16,88.1134,1448.07,19388,79,84,19137,19088,17703,17005,13641
8352,1116,1253,4835,3517,0,8352,5.08932e+18,275.269,2558.71,8352,211,193,7099,7099,7082,7079,6771
20758,337,1723,6005,14753,0,20758,3.67921e+13,441.129,4426.19,20758,359,356,18578,17391,11912,11877,5105
42109,24,54,41554,555,42091,18,9.78604e+13,19.6667,786.594,42109,25,26,42055,42038,39290,39359,33084
41729,862,2961,23754,17975,23754,17975,1.69383e+18,1121.66,8070.81,41729,505,402,37677,35884,31949,31026,11420
23947,4,34,23531,416,23937,10,9.68539e+13,20.0231,545.851,23947,23,23,21540,19889,18564,18832,10743
15064,361,1710,8842,6222,8842,6222,1.8655e+18,623.485,3993.58,15064,297,312,12398,10734,9854,9525,2923
13285,541,1752,8071,5214,8071,5214,1.83915e+18,475.467,3752.09,13285,252,291,11456,10644,7158,7572,3206
23879,1147,2000,6998,16881,0,23879,3.61239e+13,490.812,5186.81,23879,349,450,21879,21743,20788,20824,16078
42119,636,3117,0,42119,0,42119,2.39925e+18,834.947,8279.16,42119,548,449,37804,34797,25002,20586,12652
33441,1286,2140,9741,23700,0,33441,3.76507e+13,839.714,6388.7,33441,434,420,31301,30531,30017,30064,24526
21590,93,2741,0,21590,0,21590,2.10871e+18,501.405,5657.71,21590,367,474,15520,11101,7127,6349,405
19170,670,1837,11621,7549,11621,7549,1.8002e+18,759.719,4721.85,19170,368,355,16524,15335,12152,12137,9236
19971,2030,2210,17801,2170,11872,8099,1.99107e+18,829.953,5175.33,19971,336,340,17761,17757,17713,17694,17412
13609,1474,2088,8475,5134,8475,5134,1.80369e+18,404.669,4193.11,13609,263,324,11521,11506,11113,11264,8284
41108,2091,3924,41108,0,36979,4129,2.73457e+18,1532.83,9608.61,41108,441,425,37066,35190,34922,32932,23090
47586,3046,4118,27994,19592,27994,19592,1.84458e+18,892.099,10515.4,47586,489,665,43468,43415,42690,42943,38012
21777,2161,2977,19442,2335,12341,9436,1.95349e+18,623.866,6431.53,21777,308,447,18800,18759,18169,18296,13814
36215,88,5046,36215,0,31632,4583,1.98482e+18,794.045,10545.1,36215,460,696,22188,15547,9690,7386,641
28045,1789,3713,24981,3064,16837,11208,1.95367e+18,900.438,7956.81,28045,401,524,24332,23649,21937,22216,15362
49740,2747,4265,44136,5604,29277,20463,2.00775e+18,1479.89,10674.3,49740,471,621,45475,44311,44501,44701,39668
3981,113,814,0,3981,0,3981,2.29662e+18,246.334,1500.43,3981,192,132,2605,2121,1554,1405,808
41973,598,3470,24307,17666,24307,17666,1.65833e+18,914.831,8892.93,41973,475,449,36517,33329,28178,24114,9506
25342,635,891,25306,36,25321,21,4.09539e+18,308.72,3128.38,25342,200,185,24451,24420,23623,23601,22178
45254,2071,4587,45229,25,40884,4370,2.88867e+18,1170.29,11111.3,45254,612,472,40667,39632,34062,32250,20319
25787,233,2212,15611,10176,0,25787,4.59246e+18,738.002,5801.68,25787,378,325,19446,15757,8538,5969,2808
47710,110,118,46759,951,47710,0,1.05446e+14,18.9431,896.359,47710,29,33,47592,47592,47395,47395,47130
40122,2628,3464,0,40122,0,40122,2.33824e+18,1181.14,9074.63,40122,482,460,36658,36385,36164,36194,31373
11234,155,1027,0,11234,3723,7511,8.54827e+15,396.587,2716.38,11234,237,205,9474,8760,5713,5739,2276
21986,601,2456,13048,8938,13048,8938,1.88578e+18,631.925,5601.24,21986,410,334,19157,17973,16260,16188,6909
34083,2337,2724,0,34083,0,34083,2.27435e+18,963.393,7054.24,34083,447,382,31359,31359,31223,31188,29576
32115,1523,2521,0,32115,10370,21745,8.89174e+15,455.325,6846.31,32115,297,513,29594,29551,29136,29038,18723
33023,666,866,33023,0,33023,0,4.03017e+18,354.809,3540.61,33023,210,199,32157,32122,31213,31215,30316
39026,51,65,38255,771,39026,0,1.03175e+14,18.5595,741.629,39026,27,27,38961,38961,38384,38402,34428
18628,208,269,0,18628,18183,445,2.7569e+16,111.939,1566.48,18628,87,99,18359,18347,17923,17914,16966
37720,1859,3608,0,37720,0,37720,2.26749e+18,962.02,8765.22,37720,374,641,34112,33537,32721,32430,23539
33932,517,1424,0,33932,10765,23167,8.84538e+15,429.518,4748.28,33932,308,328,32448,31954,27543,27582,17254
23930,481,1699,0,23930,7325,16605,9.11309e+15,415.871,4738.83,23930,388,361,22095,21126,17852,17637,10886
37719,96,280,0,37719,37010,709,2.68333e+16,135.427,2043.04,37719,98,104,37247,36810,32841,30656,22968
23509,2149,2961,21226,2283,13924,9585,1.99701e+18,992.413,6458.91,23509,364,358,20548,19869,20044,20147,17326
13050,996,1222,0,13050,4159,8891,8.80114e+15,310.975,3203.19,13050,257,351,11828,11798,11592,11608,10528
10462,1021,1155,0,10462,3104,7358,8.18621e+15,169.986,2644.7,10462,211,156,9307,9307,9304,9303,8099
3148,25,96,0,3148,3106,42,2.6644e+16,47.6417,378.752,3148,42,38,2947,2859,2541,2441,1601
28678,644,709,28678,0,28678,0,4.18952e+18,319.665,3079.72,28678,183,192,27969,27968,27885,27887,27464
45191,72,285,0,45191,44168,1023,2.59667e+16,164.326,2391.32,45191,110,126,44323,43131,37558,34356,24712
17025,126,2607,10055,6970,10055,6970,1.74577e+18,398.196,5174.53,17025,441,248,12528,10165,6953,5140,913
34493,630,2468,20582,13911,0,34493,4.89765e+18,1272.8,7037.03,34493,463,429,29343,26916,20564,18017,9223
10142,108,1507,6065,4077,0,10142,4.66674e+18,305.135,3041.91,10142,233,213,6977,5535,4442,4008,1684
21858,54,2539,0,21858,0,21858,2.4447e+18,619.096,5699.9,21858,345,474,13865,10385,8075,7342,311
33765,1092,2745,30202,3563,20287,13478,2.01172e+18,1010.36,7353.42,33765,508,399,30551,27769,25134,25024,18577
6369,637,1405,6369,0,5741,628,2.60011e+18,283.222,2453.94,6369,190,205,4964,4785,4623,4580,3321
29743,2362,2789,0,29743,0,29743,2.30987e+18,705.871,6900.52,29743,316,437,26954,26954,26853,26924,26171
34211,1224,1979,9779,24432,0,34211,3.70914e+13,687.276,5904.77,34211,388,328,32232,31535,30785,30823,24744
27381,486,3547,27381,0,24524,2857,2.75715e+18,930.916,7745.09,27381,388,408,22027,18968,8539,5231,4492
18143,1042,1429,0,18143,0,18143,2.42529e+18,462.512,3735.74,18143,266,276,16714,16543,16642,16561,14450
38457,1773,2207,11401,27056,0,38457,3.59258e+13,581.447,6607.16,38457,445,327,36250,36199,36031,35998,32219
20817,71,251,0,20817,20474,343,2.63938e+16,115.316,1576.69,20817,86,96,20310,19893,17428,16357,11990
44803,969,2816,13073,31730,0,44803,3.59737e+13,626.079,8129.4,44803,479,398,41882,41278,32782,33000,18279
32098,793,1961,0,32098,9938,22160,8.8751e+15,509.286,5698.57,32098,378,357,30026,29285,27466,27167,15832
42257,2400,3615,24315,17942,24315,17942,1.76374e+18,863.16,8817.24,42257,431,567,38642,38274,37759,38090,29656
23310,101,206,0,23310,22989,321,2.53145e+16,117.534,1387.89,23310,86,90,23021,22820,20357,19948,16577
8206,910,1498,0,8206,0,8206,2.44674e+18,318.524,2894.12,8206,168,298,6708,6683,6540,6633,5462
20169,456,515,20169,0,20169,0,4.67935e+18,292.685,2419.74,20169,166,163,19654,19653,19564,19564,19327
4753,653,882,0,4753,0,4753,2.53281e+18,239.977,1655.36,4753,182,130,3871,3820,3772,3801,3053
24844,1258,1878,7808,17036,0,24844,3.38342e+13,423.334,5246.79,24844,233,447,22966,22957,22747,22780,18419
12302,348,517,12302,0,12302,0,4.39131e+18,246.064,1857.4,12302,144,144,11785,11770,11011,10947,10928
10148,1444,1751,6046,4102,6046,4102,1.70284e+18,435.676,3444.88,10148,266,295,8397,8329,8298,8299,7893
15639,37,1394,0,15639,4314,11325,9.65461e+15,385.78,3530.83,15639,290,320,10829,8864,6959,6937,1056
28730,190,1797,8641,20089,0,28730,3.44332e+13,705.675,5343.72,28730,338,306,24800,23007,15827,13477,4746
4307,11,641,2731,1576,0,4307,4.7091e+18,336.571,1435.03,4307,148,167,1419,695,640,601,106
28760,1870,3069,16555,12205,16555,12205,1.71052e+18,738.194,6976.7,28760,417,515,25691,25436,24950,25105,19923
25191,1356,1484,0,25191,7984,17207,8.52511e+15,427.776,4320.87,25191,317,273,23707,23707,23663,23665,23284
8477,455,967,2588,5889,0,8477,3.56801e+13,177.004,2172.38,8477,162,164,7510,7430,7249,7275,3834
12893,154,220,0,12893,12679,214,2.66647e+16,93.2504,1172.44,12893,68,82,12673,12634,12098,12197,11355
8397,13,35,8272,125,8367,30,1.07401e+14,14.8553,322.189,8397,19,19,8338,8303,7445,7414,5188
6547,364,1296,3971,2576,0,6547,4.9911e+18,341.078,2390.29,6547,209,196,5092,4577,4058,4013,2037
2753,17,21,2700,53,2753,0,1.01016e+14,13.543,164.317,2753,14,17,2732,2732,2671,2671,2465
31191,198,242,0,31191,30381,810,2.65882e+16,90.8265,1674.13,31191,83,89,30949,30948,30773,30762,30372
5894,108,381,5894,0,5894,0,4.37889e+18,209.652,1225.48,5894,109,100,5050,4302,3130,3039,1928
18242,905,3407,18242,0,16418,1824,2.05683e+18,546.175,6362.63,18242,349,479,14835,14104,8275,6973,5249
4101,7,22,4040,61,4101,0,1.00071e+14,12.6133,198.601,4101,15,16,4016,3972,3404,3399,3179
43154,632,830,43154,0,43154,0,4.2971e+18,360.274,3901.42,43154,224,224,42324,42308,40966,41041,39241
47495,211,4286,42518,4977,26866,20629,1.90369e+18,989.761,10448.5,47495,530,468,37171,32790,11249,10398,3211
41198,999,2531,13309,27889,0,41198,3.46863e+13,595.921,7487.29,41198,579,470,38667,38371,33171,33413,26855
3152,7,25,3100,52,3152,0,1.18145e+14,10.4686,183.775,3152,14,15,3095,3063,2648,2612,1762
12310,86,551,12310,0,12310,0,4.43867e+18,243.797,1880.48,12310,143,144,9592,7023,5138,4560,2539
8946,524,1431,4904,4042,4904,4042,1.67902e+18,267.866,2861.91,8946,240,239,7515,7204,5314,5360,4079
42504,390,737,42504,0,42479,25,4.13729e+18,340.71,3757.66,42504,222,226,41764,41441,34794,34447,30554
48504,967,2569,0,48504,14708,33796,8.82907e+15,974.874,8078.31,48504,444,482,45475,44634,39654,39990,20658
25321,1856,2776,25321,0,22611,2710,2.05071e+18,1170.6,6411.85,25321,357,392,22545,21269,21855,21324,18169
49729,2026,3054,0,49729,0,49729,2.24722e+18,1425.39,8993.46,49729,538,466,46626,44791,44019,42598,36741
17177,419,488,17177,0,17177,0,4.75277e+18,218.773,2121.34,17177,159,152,16689,16664,15585,15600,15633
31203,2000,3033,18509,12694,0,31203,4.87957e+18,1099.58,7487.24,31203,484,481,28170,27561,26733,26225,24640
20792,12,34,20437,355,20792,0,9.64561e+13,18.7407,475.861,20792,23,21,20685,20616,18565,18465,13736
38779,8754,38779,38779,0,38779,0,1.75917e+13,0,38779,38779,38779,1,0,0,0,0,0
33466,203,2131,10092,23374,0,33466,3.51407e+13,546.315,5932.48,33466,399,411,28982,25786,19376,17271,7867
16104,1459,1725,9513,6591,9513,6591,1.846e+18,630.748,4105.42,16104,321,295,14379,14377,14236,14314,13268
13172,29,35,12854,318,13172,0,1.04303e+14,16.5963,383.728,13172,22,21,13137,13137,12868,12867,12588
9272,893,1037,2853,6419,0,9272,3.48768e+13,250.587,2433.74,9272,200,217,8235,8224,8219,8208,7760
22664,1130,3057,13384,9280,0,22664,4.72815e+18,670.129,6503.76,22664,415,522,19607,19153,17693,17504,8254
36041,47,300,0,36041,35414,627,2.63012e+16,154.297,2173.76,36041,110,120,34634,33330,28011,25302,16556
22161,1200,1724,6351,15810,0,22161,3.74603e+13,608.85,4745.66,22161,361,351,20437,20298,20181,20176,18233
7629,145,1004,0,7629,2473,5156,9.01703e+15,355.159,2294.94,7629,227,309,6016,5335,3760,3939,1583
44818,1302,3793,0,44818,0,44818,2.28569e+18,902.291,9570.32,44818,625,600,41025,39692,31552,27405,19773
21217,1084,2799,12678,8539,12678,8539,1.79e+18,475.155,6087.73,21217,321,401,18418,18186,16880,16766,10079
22721,2633,2929,20218,2503,13884,8837,1.97612e+18,1037.07,6427.82,22721,419,363,19792,19782,19719,19696,19173
31715,667,760,31705,10,31715,0,4.31181e+18,327.511,3314.97,31715,206,199,30955,30952,30269,30365,30212
33888,371,2124,0,33888,10017,23871,9.01709e+15,663.07,6099.25,33888,430,406,30913,29238,19376,19071,8438
5481,750,965,1651,3830,0,5481,3.76731e+13,160.784,1886.28,5481,192,162,4516,4513,4484,4483,4121
18933,275,1560,0,18933,5383,13550,9.11206e+15,403.409,4159.45,18933,285,339,16554,14665,13895,14127,5799
17254,2506,2869,15254,2000,10224,7030,2.07877e+18,550.021,5561.47,17254,322,328,14385,14378,14283,14300,13427
27793,1053,2318,16259,11534,0,27793,4.92647e+18,622.166,5863.46,27793,438,354,25475,24954,23916,22936,15005
47878,674,4356,27846,20032,0,47878,4.56085e+18,750.873,10778.9,47878,545,696,42599,40004,28578,27708,8236
41158,258,296,0,41158,40083,1075,2.63174e+16,107.684,2023.09,41158,94,96,40862,40852,40717,40697,40065
5837,27,33,5707,130,5837,0,1.05752e+14,13.8787,293.387,5837,19,21,5804,5804,5650,5650,5330
8742,11,174,0,8742,8589,153,2.40852e+16,76.4985,860.574,8742,56,61,7703,6809,6270,5973,3528
4918,1171,1381,4326,592,2712,2206,1.98922e+18,139.406,2181.49,4918,177,186,3537,3533,3491,3515,3130
40801,3574,3923,36956,3845,24581,16220,1.97236e+18,1014.52,9514.89,40801,414,542,36878,36813,36798,36782,34901
29986,3264,3583,26677,3309,17096,12890,1.94597e+18,796.095,7735.24,29986,332,463,26403,26171,26368,26363,25094
33639,1768,3137,0,33639,0,33639,2.27726e+18,785.989,7901.59,33639,353,543,30502,30301,29141,28731,21995
28197,71,2735,17350,10847,17350,10847,1.81878e+18,867.798,6596.21,28197,435,422,17265,12656,9332,7380,1199
12685,965,1028,3866,8819,0,12685,3.7118e+13,523.271,2825.56,12685,283,254,11657,11468,11607,11616,11524
23500,1483,1499,0,23500,7018,16482,9.16168e+15,379.789,4351.98,23500,286,337,22001,21989,21998,21995,21961
40414,739,1134,40404,10,40414,0,4.21849e+18,327.619,4108.58,40414,228,225,39280,39245,36679,36477,36000
9324,131,535,9324,0,9324,0,3.96906e+18,210.838,1716.99,9324,140,124,8287,7138,4989,5040,3505
41668,3675,4147,37286,4382,25444,16224,1.98576e+18,1136.15,9603.19,41668,523,462,37521,37516,37389,37394,36043
3129,396,684,0,3129,773,2356,9.95039e+15,76.465,1165.67,3129,128,116,2445,2440,2421,2414,1833
45247,1562,4293,40295,4952,27131,18116,2.00389e+18,1363.54,10510.1,45247,579,589,40512,38642,28027,27208,18782
49842,37,62,49196,646,49842,0,1.00681e+14,23.2404,826.431,49842,28,33,49780,49776,48488,48489,44549
27363,88,686,27077,286,27363,0,4.41328e+18,307.275,2981.78,27363,193,190,22675,16534,10973,10143,5082
42948,1510,3089,25994,16954,25994,16954,1.87156e+18,1095.25,8627.61,42948,620,406,39711,38353,35554,33300,24249
17643,1961,2254,10325,7318,10325,7318,1.84133e+18,357.831,4817.1,17643,283,363,15389,15389,15320,15335,14924
9343,913,1252,0,9343,2875,6468,8.73359e+15,220.858,2833.65,9343,155,328,8091,8080,8003,7956,6421
25851,2903,2927,15393,10458,15393,10458,1.83532e+18,586.891,6676.41,25851,477,373,22924,22924,22922,22922,22909
28320,130,1854,0,28320,8807,19513,8.76449e+15,641.414,5314.24,28320,405,375,22711,19697,13774,10984,4187
35492,1673,2052,0,35492,10381,25111,9.44753e+15,621.562,6330.02,35492,424,319,33440,33419,33172,33147,31837
44276,227,716,44276,0,44276,0,4.05316e+18,371.88,3788.7,44276,219,219,42497,40038,28648,28307,22431
45237,2441,2549,0,45237,0,45237,2.386e+18,717.169,7652.4,45237,399,366,42688,42688,42688,42688,42461
48976,2628,4752,48976,0,43754,5222,1.43346e+18,1291.71,11263.5,48976,444,686,44224,43518,39986,39016,33731
12370,1403,1823,7308,5062,0,12370,4.60786e+18,466.246,3749.72,12370,284,296,10547,10490,10285,10251,8540
19160,1,58,18832,328,19140,20,1.01881e+14,17.4728,525.552,19160,24,27,7823,7823,7823,7823,7823
21509,843,1411,0,21509,5986,15523,9.6298e+15,412.071,3978.94,21509,254,264,20098,19811,19873,19797,15118
26415,290,616,26415,0,26415,0,4.09731e+18,318.208,2842.04,26415,181,186,25677,25168,20895,20545,16572
45729,3181,4304,0,45729,0,45729,2.34407e+18,1009.4,10589.7,45729,468,612,41425,41395,40507,39906,35778
1980,116,195,0,1980,586,1394,4.91262e+15,117.143,551.125,1980,97,66,1704,1147,1409,1383,1228
13303,715,1107,3944,9359,0,13303,3.68842e+13,396.842,2949.46,13303,285,228,12196,11806,11250,11262,10006
15284,835,1744,9168,6116,9168,6116,1.7907e+18,579.5,4071.38,15284,284,303,13500,12450,12785,12532,9513
4756,342,1179,2798,1958,0,4756,4.97961e+18,171.615,1935.19,4756,224,160,3577,3334,2856,2780,1347
28216,379,3291,25104,3112,17215,11001,1.93377e+18,991.355,7470.32,28216,389,405,21694,17322,9637,8776,5833
19528,164,235,0,19528,19200,328,2.51287e+16,120.927,1436.47,19528,77,86,19293,19231,18366,18570,16499
2910,90,370,2910,0,2910,0,3.80469e+18,168.827,870.721,2910,83,79,2256,1771,1493,1477,808
29652,1141,1389,0,29652,8810,20842,9.71711e+15,652.637,4729.97,29652,348,337,28263,28063,27951,27950,26855
40946,1047,4551,0,40946,0,40946,2.4409e+18,1092.55,10340.1,40946,572,618,35595,33043,24357,24898,12777
41277,64,66,40590,687,41277,0,1.00392e+14,22.0007,781.352,41277,28,29,41211,41211,41150,41150,41078
5963,711,1216,3668,2295,0,5963,4.99136e+18,260.608,2223.03,5963,180,187,4747,4696,4427,4419,2825
33920,2451,2674,0,33920,0,33920,2.43722e+18,769.208,7004.07,33920,427,379,31246,31239,31192,31155,30402
26086,1012,3068,0,26086,0,26086,2.37701e+18,698.79,6906.67,26086,384,408,22828,21538,18660,18351,8898
44812,628,3960,39844,4968,26697,18115,1.97488e+18,1436.23,10113.5,44812,498,485,37309,31996,19982,18547,10053
49958,21,102,48979,979,49958,0,1.00842e+14,19.0515,956.986,49958,33,31,49848,49804,44895,44475,29078
20102,361,690,20102,0,20102,0,4.26924e+18,288.577,2547.33,20102,178,172,19412,19257,16745,16575,14516
18725,353,781,18725,0,18725,0,4.3435e+18,287.067,2604.6,18725,165,173,17944,17738,13848,13443,11564
4330,31,930,3952,378,2499,1831,1.96107e+18,195.535,1704.72,4330,139,151,1842,763,639,646,234
1362,18,76,0,1362,1335,27,2.11623e+16,22.6116,219.772,1362,26,33,1265,1232,1116,1042,779
26219,196,249,0,26219,25741,478,2.52624e+16,153.968,1697.14,26219,102,103,25970,25900,25176,24960,23780
46163,1452,5560,46163,0,41203,4960,1.87446e+18,1226.78,12408,46163,540,574,39601,36990,31747,29091,16683
46430,325,1002,46418,12,46430,0,4.26182e+18,386.192,4270.22,46430,234,231,45184,44208,32105,31626,24777
1019,207,240,500,519,500,519,1.41025e+18,112.996,450.152,1019,71,53,779,744,770,764,749
27935,18,70,27621,314,27935,0,1.01265e+14,17.9757,641.821,27935,25,28,27856,27832,25050,25062,16988
33640,98,2133,11024,22616,0,33640,3.43404e+13,609.195,6454.5,33640,412,456,26896,23813,15504,7921,4271
8157,1175,1305,4812,3345,0,8157,4.64509e+18,353.045,2717.74,8157,170,230,6852,6843,6841,6851,6518
32994,2665,3516,32994,0,29807,3187,2.37493e+18,1141,8036.98,32994,553,477,29478,28978,28964,28813,26816
13412,711,1340,4159,9253,0,13412,3.59258e+13,457.273,3375.68,13412,329,283,12072,11548,11279,11277,9258
42627,2498,3218,42627,0,38558,4069,1.36141e+18,1433.99,8767.77,42627,426,409,39409,38330,38976,38888,36510
47068,266,311,0,47068,46148,920,2.58237e+16,159.937,2497.4,47068,105,110,46757,46755,46686,46347,45294
48763,2061,2422,15290,33473,0,48763,3.42172e+13,916.739,7744.62,48763,471,378,46341,46306,45909,45950,44092
20056,967,2548,20056,0,17672,2384,2.52959e+18,1224.47,5839.41,20056,323,399,16596,15081,10337,9000,8405
42601,1095,3135,0,42601,0,42601,2.18448e+18,1183.66,8414.71,42601,470,436,38664,36631,30014,28615,19639
27865,118,1028,27865,0,27865,0,4.17381e+18,329.937,3331.12,27865,192,192,23730,19368,12728,11018,6255
4667,615,1380,4203,464,2823,1844,2.01598e+18,176.361,2181.87,4667,199,189,3287,3125,2821,2701,1529
42454,319,2993,42454,0,38537,3917,2.48154e+18,1352.71,7969.09,42454,421,423,35961,33321,17414,11239,10508
47018,579,3077,0,47018,0,47018,2.31184e+18,1068.03,8873.44,47018,472,418,41121,37339,25059,17843,11578
20512,403,1365,0,20512,5521,14991,9.74055e+15,648.781,4026.5,20512,330,237,18445,17487,16199,16361,8581
19633,1825,2493,11582,8051,0,19633,4.7221e+18,631.792,5483.85,19633,333,374,17140,17131,16732,16764,13338
4863,239,928,1492,3371,0,4863,3.20426e+13,180.299,1801.94,4863,282,140,3895,3590,2774,2535,1820
16886,74,205,0,16886,16685,201,2.49083e+16,91.941,1218.93,16886,70,70,16553,16313,14909,13854,10750
12654,170,1266,0,12654,3867,8787,9.50256e+15,387.619,3173.3,12654,295,301,10264,8934,6594,6409,2902
30566,1529,1696,0,30566,9713,20853,8.97295e+15,593.498,5289.26,30566,341,354,28870,28867,28797,28801,28425
5966,78,179,0,5966,5863,103,2.45547e+16,66.7472,711.874,5966,53,57,5773,5646,5360,5401,4337
37098,229,708,37098,0,37098,0,4.2484e+18,342.417,3505.13,37098,210,203,35629,33659,22724,22129,18950
37992,720,3309,0,37992,0,37992,2.33688e+18,839.354,8540.94,37992,484,403,33611,32095,24742,20097,11996
4931,33,1345,4931,0,4546,385,1.79109e+18,217.987,2150.96,4931,241,170,2645,1792,702,449,215
31433,310,605,31433,0,31433,0,4.85517e+18,308.041,3010.59,31433,191,187,30719,30284,21148,20863,21205
45443,169,314,0,45443,44605,838,2.58528e+16,151.065,2478.83,45443,111,123,45089,44894,41825,41506,34719
9698,17,45,9525,173,9698,0,1.06141e+14,13.6736,361.588,9698,19,22,9652,9640,8984,9011,6069
37939,301,307,0,37939,37092,847,2.64383e+16,158.071,2156.38,37939,103,110,37632,37628,37626,37556,37428
993,62,77,0,993,975,18,2.80104e+16,14.9758,204.017,993,21,28,916,916,893,898,824
7314,690,853,2132,5182,0,7314,3.57613e+13,321.978,2014.61,7314,224,173,6461,6321,6340,6344,6009
1936,44,566,1092,844,0,1936,5.68695e+18,71.1111,838.175,1936,139,59,1284,1096,880,901,302
3405,356,962,2082,1323,0,3405,4.9315e+18,174.689,1554.29,3405,164,186,2443,2270,2096,2130,1163
23738,1757,1780,6962,16776,0,23738,3.67209e+13,673.015,5021.71,23738,418,436,21958,21958,21957,21958,21909
13712,4,44,13387,325,13712,0,1.05759e+14,18.7336,413.733,13712,25,23,12353,11617,10594,10657,6633
27944,725,2719,25036,2908,15681,12263,1.90198e+18,637.424,6533.04,27944,337,363,24876,23268,18070,17089,12705
2262,9,21,2217,45,2262,0,1.00172e+14,11.7905,149.102,2262,14,16,2223,2208,2049,2024,1730
46822,1039,1182,46822,0,46822,0,4.32866e+18,388.386,4473.77,46822,231,233,45640,45635,45435,45418,45254
33676,259,741,33676,0,33676,0,4.33973e+18,339.934,3350.06,33676,202,198,32575,31550,20685,19998,17889
22630,1912,2533,0,22630,0,22630,2.31294e+18,641.082,5936.22,22630,492,404,20097,20040,19427,19093,17348
31339,2159,2655,0,31339,0,31339,2.24932e+18,849.278,6861.99,31339,312,468,28684,28682,28523,28644,26835
25379,1992,2319,15378,10001,0,25379,4.71957e+18,627.566,5766.04,25379,398,317,23060,23056,22502,22325,21931
39363,133,5043,35140,4223,23668,15695,1.96398e+18,1070.82,10935.6,39363,589,604,26108,20250,11940,9456,2236
24313,264,2925,14753,9560,0,24313,4.95229e+18,579.567,6605.73,24313,328,436,19100,15760,11453,9019,2927
49583,452,760,49583,0,49583,0,4.20202e+18,373.028,4101.55,49583,233,230,48823,48656,42633,41889,37583
16021,1133,1346,4645,11376,0,16021,3.66097e+13,503.728,3537.87,16021,304,310,14675,14663,14591,14611,13444
30248,1041,3407,27249,2999,18192,12056,1.98571e+18,869.056,7789.79,30248,489,431,26421,25031,18272,18233,13158
3030,59,92,0,3030,2972,58,2.37101e+16,49.2581,333.348,3030,42,48,2927,2853,2751,2821,2584
28450,60,77,27979,471,28450,0,1.05744e+14,21.0379,695.211,28450,28,24,28373,28373,27941,27941,26953
32906,1000,3869,19371,13535,0,32906,4.71314e+18,692.827,8704.97,32906,518,375,28936,27801,19590,18343,13566
25960,1666,2831,15638,10322,0,25960,4.81746e+18,737.881,6563.01,25960,434,539,23129,22967,22328,22284,15703
37341,2032,2249,11900,25441,0,37341,3.52085e+13,655.659,6556.1,37341,426,411,35092,35065,34977,34976,34179
30762,322,3703,27276,3486,18300,12462,1.96602e+18,734.688,7930.39,30762,453,507,23361,18580,11049,9506,3671
46818,29,107,45919,899,46653,165,1.02296e+14,19.713,1021.31,46818,34,33,46711,46698,42981,42740,27897
23025,1226,1733,0,23025,7144,15881,8.23971e+15,374.278,4762.17,23025,246,415,21292,21229,21162,21110,18606
24212,1508,2106,14732,9480,14732,9480,1.81165e+18,590.305,5196.74,24212,303,386,22106,21918,21817,21843,20392
20240,1913,2782,0,20240,0,20240,2.39935e+18,467.74,5968.46,20240,300,420,17458,17445,17050,17131,12440
28366,2008,3492,28366,0,25334,3032,2.46561e+18,1180.46,7716,28366,403,497,24874,23783,22132,22120,18947
23587,792,2241,14381,9206,0,23587,4.70032e+18,738.987,5552.59,23587,341,344,20987,19674,14991,14409,9843
41758,45,95,40819,939,41733,25,9.55082e+13,19.5365,869.62,41758,29,34,41663,41661,39345,39358,28419
10688,778,1287,3077,7611,0,10688,3.47054e+13,271.295,2904.85,10688,222,258,9401,9320,9172,9180,6556
39973,208,260,0,39973,39225,748,2.51742e+16,138.848,2027.51,39973,103,108,39713,39703,38949,38707,37977
39696,2016,3218,23719,15977,0,39696,4.97055e+18,867.714,8378.28,39696,460,372,36478,36107,35571,35515,30307
49116,64,102,48245,871,49116,0,1.04301e+14,21.1681,934.154,49116,31,34,49014,49011,47543,47546,40951
48751,2166,3810,48751,0,43865,4886,2.84411e+18,1228.5,10037.8,48751,406,506,44941,44566,43498,43205,31856
651,25,334,396,255,396,255,1.57802e+18,49.2826,436.387,651,62,47,223,66,65,63,24
19548,1218,2594,0,19548,0,19548,2.39777e+18,429.122,5342.46,19548,455,297,16954,16840,15054,14706,9885
39338,34972,39338,39338,0,0,39338,15.9996,0,39338,39338,39338,1,0,0,0,0,0
3324,480,679,1832,1492,0,3324,4.24656e+18,112.477,1205.39,3324,132,101,2645,2633,2622,2619,2423
2272,355,565,0,2272,0,2272,2.48885e+18,193.919,933.486,2272,135,89,1707,1484,1525,1487,1407
15058,274,1763,13568,1490,9191,5867,1.90942e+18,462.215,4138.1,15058,250,265,11354,8394,6896,5858,2613
9259,119,1602,5337,3922,5337,3922,1.5625e+18,207.195,3116.13,9259,245,275,6998,5413,3919,3489,797
45072,1970,4214,0,45072,0,45072,2.19394e+18,726.123,10095.4,45072,349,738,40858,40769,39769,40556,29963
32228,1478,1985,9531,22697,0,32228,3.60671e+13,657.524,5934.91,32228,408,332,30243,30117,29199,29281,25827
14021,183,1130,0,14021,4439,9582,9.02553e+15,391.169,3076.38,14021,224,303,12118,11074,8973,9174,3005
11342,310,586,11342,0,11342,0,4.40963e+18,276.075,1930.82,11342,137,138,10725,10394,8613,8522,7537
37316,17,59,36568,748,37295,21,9.89947e+13,19.6787,691.942,37316,31,25,37230,37184,34008,33755,26672
17013,1374,2211,10443,6570,10443,6570,1.85244e+18,507.169,4650.68,17013,315,425,14802,14527,14256,14090,12419
4523,675,878,2774,1749,0,4523,4.90766e+18,366.43,1695.54,4523,172,201,3645,3338,3440,3465,3173
46224,498,2358,27296,18928,27296,18928,1.86611e+18,1463.7,7707.07,46224,506,452,40019,37174,28288,26615,14190
48380,2386,3440,28721,19659,28721,19659,1.82488e+18,1181.95,9251.22,48380,491,570,44940,44630,43969,44069,39598
33583,1535,2573,0,33583,0,33583,2.35231e+18,651.859,6881.46,33583,330,452,31010,30944,30584,30800,21843
3268,465,875,0,3268,0,3268,2.36899e+18,184.078,1411.86,3268,158,144,2393,2158,2246,2185,1544
17021,402,588,17021,0,17021,0,3.91335e+18,284.31,2300.79,17021,164,169,16433,16338,15227,15153,14107
39317,233,309,0,39317,38737,580,2.6177e+16,146.241,2134.07,39317,100,105,39008,38985,37903,37868,35252
9619,833,1042,0,9619,3097,6522,8.96518e+15,345.248,2577.69,9619,227,275,8577,8523,8345,8350,7470
12536,950,1635,7610,4926,0,12536,4.8113e+18,573.741,3647.12,12536,365,328,10901,10535,9948,9727,8019
43532,508,2341,14315,29217,0,43532,3.42141e+13,760,7347.17,43532,365,514,39987,37671,24638,21316,17581
45780,2414,3203,26521,19259,26521,19259,1.73566e+18,991.359,8862.62,45780,436,535,42577,42361,41799,42053,34223
31402,734,1607,9375,22027,0,31402,3.21445e+13,638.998,5024.25,31402,308,298,29507,28830,27525,27737,13625
31926,1256,1789,0,31926,9393,22533,9.53644e+15,651.107,5648.7,31926,366,399,30137,30035,29540,29520,26203
12282,1110,1815,7252,5030,0,12282,4.75906e+18,433.498,3831.32,12282,214,350,10467,10435,10186,10160,7932
19207,675,2121,10910,8297,0,19207,4.33633e+18,392.483,4831.8,19207,366,249,17020,16534,12932,12704,8566
29932,1647,1862,0,29932,8897,21035,8.75672e+15,702.534,5486.78,29932,400,392,28070,28052,27844,27818,26797
5154,85,1400,3170,1984,3170,1984,1.84847e+18,193.356,2302.87,5154,242,174,3288,2568,1976,1621,429
40363,193,306,0,40363,39597,766,2.55468e+16,145.387,2389.23,40363,96,116,40057,39955,38074,37817,33730
4437,239,693,1423,3014,0,4437,3.32788e+13,220.826,1457.38,4437,148,148,3586,3235,2896,2914,1383
28762,2160,3057,17069,11693,0,28762,4.77386e+18,681.145,7060.77,28762,482,365,25705,25542,25144,24950,21837
24501,2562,3451,24501,0,21826,2675,2.89052e+18,945.709,7300.1,24501,375,406,21050,20806,20597,20594,17824
16914,550,627,16914,0,16914,0,4.3678e+18,294.276,2369.72,16914,165,166,16287,16284,16099,16118,16021
41186,1634,3240,24611,16575,24611,16575,1.73477e+18,759.646,8272.44,41186,365,486,37946,37688,36523,36746,19484
35749,1164,1937,10675,25074,0,35749,3.69597e+13,749.97,6129.03,35749,354,427,33812,33331,31704,31752,27925
29876,123,285,0,29876,29432,444,2.68878e+16,115.436,1955.36,29876,90,106,29555,29361,26767,26688,20380
2484,1,22,2435,49,2484,0,1.00398e+14,11.0946,159.429,2484,15,15,1027,1027,1027,1027,1027
36992,48,62,36142,850,36967,25,9.939e+13,18.9825,704.513,36992,27,25,36930,36925,35986,35986,34110
13054,2199,2501,7601,5453,7601,5453,1.88101e+18,323.481,4605.75,13054,443,317,10553,10553,10502,10518,10149
31367,892,1699,19011,12356,0,31367,4.96345e+18,909.818,5448.65,31367,399,337,29208,25543,25203,24719,21819
34009,72,76,33537,472,33997,12,1.03167e+14,19.9121,796.921,34009,30,28,33933,33933,33723,33724,33497
30294,59,105,29683,611,30294,0,9.9335e+13,15.9487,757.375,30294,29,30,30189,30189,29292,29299,23072
3233,723,1089,3233,0,2831,402,2.95367e+18,177.255,1639.19,3233,139,141,2144,2086,2115,2108,1625
48780,1845,4745,43364,5416,29079,19701,1.95453e+18,1622.98,11540.3,48780,606,618,43558,41708,32084,31045,18519
43683,109,276,0,43683,42758,925,2.57496e+16,152.678,2251.09,43683,104,120,43177,42704,38848,35283,29732
21861,710,713,21861,0,21861,0,4.63922e+18,331.249,2773.53,21861,178,190,21148,21148,21148,21148,21148
1184,421,437,0,1184,0,1184,2.30629e+18,70.3961,641.97,1184,80,86,747,747,746,746,729
19662,1210,1452,5877,13785,0,19662,3.34384e+13,414.228,3866,19662,338,251,18210,18198,18100,18101,15648
8511,1042,1071,4942,3569,4942,3569,1.87097e+18,282.918,2309.72,8511,264,159,7440,7440,7439,7439,7374
38328,516,790,38328,0,38328,0,4.16081e+18,358.908,3639.69,38328,215,220,37538,37464,34713,34393,33177
40367,2664,3349,35821,4546,23962,16405,1.94626e+18,1127.93,8947.58,40367,562,389,37018,36915,36295,36229,32088
38758,1620,3828,0,38758,0,38758,2.44152e+18,987.824,9136.29,38758,439,619,34930,33746,32590,32646,15989
30147,57,2390,16901,13246,16901,13246,1.61397e+18,884.294,6228.85,30147,385,391,18772,11584,7811,8302,1415
21584,1637,2070,12976,8608,12976,8608,1.87546e+18,831.438,5118.87,21584,339,332,19514,19268,18962,19005,16583
8758,346,506,8758,0,8758,0,4.03965e+18,247.606,1636.06,8758,140,125,8252,8162,7568,7557,7087
39125,742,895,39125,0,39125,0,4.46475e+18,366.973,3802.55,39125,219,213,38230,38212,36040,36028,36081
8306,966,1308,0,8306,2744,5562,7.94782e+15,167.896,2656.5,8306,301,173,6998,6972,6838,6816,6217
1211,169,242,1211,0,1211,0,4.04713e+18,118.273,478.882,1211,53,50,969,879,841,846,738
9258,1356,2106,8372,886,5509,3749,2.12281e+18,314.868,3548.41,9258,203,308,7152,7046,6783,6834,5419
39722,3191,3736,39722,0,35111,4611,2.09047e+18,872.994,9283.4,39722,404,476,35986,35982,35767,35766,34841
29596,640,773,29586,10,29596,0,4.30453e+18,329.458,3222.68,29596,197,189,28823,28811,28081,28113,27862
1807,302,454,0,1807,590,1217,9.95082e+15,75.8489,776.556,1807,87,103,1353,1339,1315,1302,1036
4195,8,22,4093,102,4195,0,1.01519e+14,14.0389,197.188,4195,17,16,4113,4072,3641,3625,2802
29992,634,1938,0,29992,9377,20615,8.32466e+15,541.285,5611.15,29992,319,391,27904,27030,24639,24658,12902
1745,179,448,516,1229,0,1745,3.03396e+13,60.3777,763.165,1745,133,84,1297,1267,884,855,466
41992,921,1800,0,41992,13118,28874,8.45566e+15,798.39,6120.42,41992,433,342,39968,38604,36547,36822,27380
38708,936,3560,0,38708,0,38708,2.08544e+18,881.315,8564.23,38708,389,461,34854,33870,25728,23655,11105
40510,286,322,0,40510,39628,882,2.515e+16,145.112,2492.51,40510,112,118,40188,40186,40030,39789,38842
11115,1,34,10956,159,11074,41,1.0198e+14,18.285,393.756,11115,22,22,4437,4437,4437,4437,4437
33187,2295,3222,0,33187,0,33187,2.35949e+18,949.947,7881.67,33187,559,389,29965,29852,28712,28141,24971
24178,764,3488,24178,0,21913,2265,2.35721e+18,585.313,7007.62,24178,426,436,20595,18962,13358,12082,8776
7105,277,661,0,7105,2229,4876,9.21394e+15,280.868,1706.53,7105,161,185,6274,5461,5405,5463,4342
47343,3170,4095,41820,5523,28344,18999,1.97214e+18,1100.42,10604.7,47343,511,585,43248,43169,41664,41796,38911
8549,284,1513,5044,3505,0,8549,5.0792e+18,428.337,2908.14,8549,226,304,6555,5627,4801,4684,2084
15876,2520,2901,15876,0,14237,1639,2.20804e+18,528.19,5538.84,15876,367,290,12975,12975,12934,12875,11698
17848,9,43,17549,299,17808,40,9.87089e+13,17.7566,505.008,17848,22,23,17625,17470,15499,15121,10201
40956,1335,3587,0,40956,0,40956,2.3296e+18,954.286,9067.13,40956,549,478,37344,36256,28263,24492,18840
27124,1449,1501,7681,19443,0,27124,3.72302e+13,721.18,4803.61,27124,369,318,25623,25619,25585,25581,25356
28605,277,1434,0,28605,8565,20040,9.48428e+15,651.3,4582.38,28605,335,288,25564,22709,16042,16562,11194
30232,2220,3130,0,30232,0,30232,2.25226e+18,700.074,7541.54,30232,499,348,27102,27093,26185,24366,23259
36119,1384,2174,0,36119,10546,25573,9.34586e+15,635.067,6536.57,36119,393,391,33945,33522,32647,32712,26313
40007,2760,4444,40007,0,35951,4056,2.84758e+18,1053.52,9876.21,40007,508,432,35563,34602,35023,34818,26625
27243,1209,2892,16513,10730,16513,10730,1.79069e+18,525.835,6684.45,27243,358,434,24351,24109,22811,23165,11311
31894,1647,2075,19121,12773,0,31894,4.94372e+18,947.401,5996.74,31894,376,366,29819,29434,29212,29057,26957
23416,972,2885,13819,9597,13819,9597,1.81991e+18,815.004,6463.36,23416,432,378,20234,19146,16309,16628,8878
2416,456,678,1447,969,0,2416,5.29106e+18,111.042,1080.71,2416,101,123,1738,1725,1716,1718,1451
6857,1301,1443,4081,2776,4081,2776,1.88182e+18,253.161,2618.27,6857,236,218,5414,5414,5395,5398,5181
46512,1476,2544,0,46512,0,46512,2.46798e+18,1094.98,7889.53,46512,478,418,43968,43037,40280,39067,33941
3589,332,1083,3589,0,3165,424,2.03572e+18,221.025,1728.75,3589,140,197,2472,2003,1286,1150,1203
30357,783,863,30357,0,30357,0,4.52288e+18,305.082,3216.76,30357,194,200,29494,29491,29316,29335,29243
48286,63,68,47447,839,48286,0,9.82652e+13,20.5795,808.115,48286,30,28,48218,48218,47792,47792,47429
6414,424,741,0,6414,0,6414,2.24174e+18,438.449,1870.73,6414,198,191,5332,4440,4865,4853,4102
31505,1504,3743,28145,3360,19111,12394,1.91691e+18,1359.05,8518.85,31505,476,453,27359,25203,20325,20211,13082
31459,1794,2807,31434,25,28214,3245,2.02252e+18,1118.84,7330.08,31459,471,367,28652,27632,25949,25782,22533
42624,720,2378,0,42624,12532,30092,9.04893e+15,761.802,7375.42,42624,425,412,39818,38317,34954,34995,20019
32273,34,84,31717,556,32273,0,1.08411e+14,18.1912,720.9,32273,30,31,32189,32186,30125,30003,23373
35064,343,2105,0,35064,10763,24301,8.73392e+15,675.931,6207.57,35064,438,332,31533,29802,21258,19596,9371
13657,4,32,13437,220,13657,0,1.0569e+14,18.1917,396.488,13657,22,22,12267,11427,10477,10659,7037
48469,488,1224,48469,0,48469,0,4.36899e+18,379.695,4538.55,48469,228,232,47245,46962,36685,36249,34576
9527,478,939,3036,6491,0,9527,3.38328e+13,292.604,2366.81,9527,202,211,8588,8346,8235,8266,6574
40300,58,70,39496,804,40300,0,9.44725e+13,18.6481,764.487,40300,28,26,40230,40230,39758,39759,38289
2784,203,313,2784,0,2784,0,3.71578e+18,128.12,753.771,2784,81,73,2471,2373,2239,2209,1848
12102,909,2185,11035,1067,6841,5261,1.79786e+18,296.162,4038.19,12102,301,290,9917,9622,5731,5087,4434
36738,1206,2306,11360,25378,0,36738,3.37842e+13,625.097,6785.79,36738,383,511,34432,34131,32896,32929,17161
49462,2241,3243,29216,20246,0,49462,4.80493e+18,1538.91,9651.53,49462,457,649,46097,44665,44668,44376,38939
11444,939,1879,0,11444,0,11444,2.39556e+18,425.9,3695.51,11444,328,299,9565,9247,8119,7980,6422
26725,1403,1813,7771,18954,0,26725,3.71354e+13,705.684,5368.13,26725,408,340,24912,24713,24340,24353,22179
19868,19552,19868,0,19868,0,19868,1048520,0,19868,19868,19868,1,0,0,0,0,0
33096,1196,2266,0,33096,10498,22598,8.78436e+15,437.739,6258.09,33096,346,407,30830,30673,29212,29371,23230
33719,1623,3588,30429,3290,19207,14512,1.94269e+18,1432.5,8158.08,33719,437,454,29601,28249,25513,25398,16793
40814,4,16,40654,160,40814,0,2.16175e+18,15.9937,808.099,40814,16,16,8160,0,5102,7650,8160
6288,235,409,6288,0,6288,0,5.07598e+18,215.447,1284.19,6288,117,119,5834,5530,4430,4412,4317
28057,1708,1925,28057,0,24935,3122,2.26885e+18,1001.68,5404.45,28057,385,346,26132,25708,25971,25960,25699
43637,2484,3145,25887,17750,25887,17750,1.7113e+18,859.924,8272.8,43637,444,541,40492,40425,40051,40226,36871
31931,2,73,31341,590,31921,10,1.03304e+14,22.0377,771.909,31931,30,29,22983,20053,19371,19932,13197
43090,696,3499,38868,4222,26064,17026,1.98552e+18,1265.17,9020.66,43090,477,481,35986,30649,21579,21367,10158
23244,3049,3214,14204,9040,0,23244,4.60103e+18,646.799,6878.05,23244,553,511,20030,20030,19878,19849,19718
42714,1552,1992,25270,17444,25270,17444,1.83504e+18,1141.97,6912.03,42714,458,401,40722,40609,40174,40268,36236
21933,1520,1582,0,21933,6734,15199,9.45172e+15,612.135,4579.05,21933,352,333,20351,20350,20322,20309,20281
22512,130,2813,0,22512,0,22512,2.28854e+18,553.931,6161.51,22512,359,469,16405,13782,9171,6908,2602
12427,1830,2073,7358,5069,0,12427,4.44764e+18,273.372,3981.36,12427,247,250,10354,10340,10309,10340,8867
20795,9,32,20378,417,20795,0,9.82424e+13,15.9915,467.992,20795,21,23,20635,20540,18598,17966,12770
42584,1367,2539,0,42584,12827,29757,8.9783e+15,655.978,7723.22,42584,398,431,40045,39689,38169,38152,28594
49063,196,327,0,49063,48193,870,2.5602e+16,166.565,2637.77,49063,121,126,48716,48547,45027,44961,38161
30958,1487,1912,9982,20976,0,30958,3.28522e+13,369.282,5444.48,30958,362,307,29046,29039,28499,28512,26711
14505,926,1145,4576,9929,0,14505,3.46346e+13,368.251,3162.16,14505,231,255,13360,13339,13293,13305,12477
4471,455,1325,0,4471,0,4471,2.39322e+18,156.884,2025.78,4471,207,144,3146,2973,2212,1655,1098
32250,2814,3267,32250,0,29329,2921,2.25687e+18,923.551,7904.52,32250,453,346,28983,28982,28557,28483,27789
16016,1818,1982,8826,7190,8826,7190,1.73563e+18,388.368,4419.67,16016,259,353,14034,14034,14026,14030,13759
9555,1669,1928,5777,3778,0,9555,5.02694e+18,349.961,3431.04,9555,249,231,7627,7587,7588,7597,6830
45224,1983,2201,13481,31743,0,45224,3.6578e+13,1065.61,7096.81,45224,531,449,43023,42873,42823,42811,41824
20611,707,1818,0,20611,0,20611,2.24071e+18,433.028,4583.28,20611,282,334,18793,18557,17010,15807,6972
13511,74,1382,0,13511,4266,9245,9.28672e+15,420.013,3511.95,13511,296,356,9878,8351,5957,6104,2080
27894,669,1854,0,27894,8016,19878,9.35161e+15,487.136,5411.14,27894,352,402,26028,25429,23830,24109,12343
21509,56,62,21094,415,21509,0,9.70096e+13,16.7124,564.721,21509,26,26,21447,21447,21323,21323,21090
37430,40,58,36560,870,37430,0,1.03499e+14,18.4644,713.047,37430,26,27,37372,37371,36595,36595,32554
47637,4237,4238,47612,25,42431,5206,2.69312e+18,1637.35,10905,47637,543,495,43399,43399,43399,43399,43399
29125,1919,2964,0,29125,0,29125,2.3728e+18,933.709,7151.6,29125,432,446,26161,25473,24555,23154,20473
32092,497,4181,28674,3418,19177,12915,1.93134e+18,712.964,9192.1,32092,507,415,26385,23010,13543,13294,6254
47431,249,3678,26911,20520,0,47431,4.41326e+18,1235.47,9550.12,47431,528,478,39192,34767,19413,16765,6388
42370,125,311,0,42370,41750,620,2.56565e+16,151.564,2379.08,42370,108,127,41907,41587,37444,34766,29033
4322,337,835,0,4322,1205,3117,8.45372e+15,149.117,1595.46,4322,197,124,3487,3349,3139,3092,1805
26034,1851,1974,15666,10368,0,26034,5.11762e+18,1010.01,5461.41,26034,429,371,24060,24059,24041,24044,23921
8166,267,1260,4762,3404,0,8166,4.83003e+18,414.431,2663.81,8166,215,246,6370,5683,4463,4286,1984
47265,2816,4788,42448,4817,27808,19457,1.93683e+18,1342.55,11329.3,47265,530,551,42477,41590,39245,39438,30020
5658,422,699,1893,3765,0,5658,3.09441e+13,115.196,1523.03,5658,132,143,4959,4935,4876,4871,4135
38326,4,84,37519,807,38326,0,1.01894e+14,17.8018,785.029,38326,29,31,34653,32378,30128,30512,16377
40179,2810,3895,40179,0,36066,4113,2.16378e+18,598.794,8932.93,40179,459,387,36284,36276,36010,35765,25925
30816,582,1877,30816,0,27766,3050,1.16642e+18,502.032,5379.88,30816,346,274,28893,28528,26866,26131,9033
17872,231,1346,4983,12889,0,17872,3.77577e+13,371.68,3524.67,17872,381,216,15785,13904,12934,12874,5737
21574,660,2277,0,21574,0,21574,2.40947e+18,969.131,5392.46,21574,395,358,18381,17243,16760,15528,6572
24649,2136,2187,7248,17401,0,24649,3.75724e+13,472.987,5763.29,24649,306,480,22462,22462,22455,22455,22385
8635,258,936,4604,4031,0,8635,3.55757e+18,200.625,2076.99,8635,178,143,7662,7455,6124,5849,2345
33486,766,1638,9359,24127,0,33486,3.72929e+13,750.554,5341.89,33486,493,289,31488,30511,29086,29285,23079
38568,449,1039,38568,0,38568,0,4.06053e+18,382.53,3990.88,38568,230,224,37529,37084,29343,28840,25135
30231,568,3159,18218,12013,0,30231,4.97238e+18,689.405,7103.87,30231,509,411,26482,24345,17720,16762,10242
34132,176,2153,0,34132,10331,23801,8.92111e+15,588.82,6423.1,34132,382,357,29019,25568,17787,17101,5753
27379,1529,1784,16325,11054,16325,11054,1.92771e+18,948.851,5364.13,27379,381,349,25595,25592,25366,25456,24369
44379,2577,3806,26813,17566,26813,17566,1.87411e+18,919.85,9121.57,44379,459,598,40573,40473,39238,39351,33795
40298,26096,40298,40298,0,0,40298,268429000,0,40298,40298,40298,1,0,0,0,0,0
22514,447,1451,0,22514,6726,15788,9.24574e+15,553.914,4292.5,22514,307,263,20172,18933,16413,16596,10797
10911,308,805,0,10911,3772,7139,8.2034e+15,335.54,2254.13,10911,169,196,9891,9506,8493,8493,5184
11343,781,1064,11333,10,10179,1164,9.83246e+17,564.855,2864.44,11343,222,240,10279,9861,9776,9807,8497
43171,179,1050,43171,0,43171,0,3.95408e+18,379.968,4205.79,43171,232,226,39698,35569,23044,21534,15133
24691,1156,1874,7397,17294,0,24691,3.63547e+13,562.497,5197.82,24691,351,375,22817,22664,21637,21657,16552
42961,2140,2306,0,42961,13633,29328,9.04282e+15,849.405,7032.23,42961,496,405,40655,40655,40604,40623,40108
14814,1280,1915,0,14814,0,14814,2.34684e+18,599.819,4283.46,14814,263,353,12899,12875,12248,12139,10135
17881,625,2168,0,17881,0,17881,2.20289e+18,517.683,4872.46,17881,374,342,15418,14316,12219,11709,4644
26329,1863,2895,0,26329,0,26329,2.36909e+18,994.03,6677.75,26329,460,426,23434,22896,22530,22701,14430
27993,647,3765,27993,0,25077,2916,2.38551e+18,920.528,8015.23,27993,378,421,23076,21083,10352,6461,5124
27786,1331,2907,16361,11425,0,27786,4.87883e+18,885.219,6856.96,27786,479,371,24879,23975,20908,20424,15469
45026,81,82,44014,1012,45026,0,1.03098e+14,20.6405,828.694,45026,32,29,44944,44944,44824,44824,44849
48507,28,60,47651,856,48507,0,1.00098e+14,19.8161,765.23,48507,28,26,48447,48436,46442,46503,35610
33967,637,3569,30406,3561,19449,14518,1.95369e+18,1057.13,8203.13,33967,454,323,29195,27416,13549,11705,8356
43698,334,2398,0,43698,12375,31323,9.48995e+15,847.164,7559.96,43698,520,374,39524,36627,28018,27834,11678
20392,1269,1516,0,20392,0,20392,2.39617e+18,702.51,4101.5,20392,274,303,18876,18802,18783,18849,18317
11643,679,2327,10376,1267,6778,4865,1.9204e+18,453.829,4306.88,11643,249,345,9259,8551,7228,7110,4295
12008,792,990,3389,8619,0,12008,3.6502e+13,359.624,2569.12,12008,233,191,11018,10995,10973,10975,10428
28909,244,2493,0,28909,8919,19990,9.10581e+15,482.74,6490.02,28909,588,292,25067,22653,15417,14353,4414
20927,1394,1774,12452,8475,12452,8475,1.83605e+18,950.792,4709.2,20927,349,338,19054,17960,18658,18685,16443
4062,5,22,3945,117,4062,0,1.01933e+14,13.8488,198.273,4062,17,17,3792,3561,3233,3285,2083
21187,852,2039,21187,0,18540,2647,2.56293e+18,1124.42,5381.35,21187,356,407,17988,16790,14321,13962,10569
14043,651,1456,8241,5802,0,14043,4.37674e+18,667.904,3619.33,14043,278,255,12294,11393,9986,9935,7194
22168,1924,2625,0,22168,0,22168,2.35774e+18,552.76,5780.01,22168,425,417,19543,19491,19332,18656,17519
7654,1365,1600,7654,0,6847,807,2.79309e+18,275.098,2928.98,7654,256,154,6054,6041,6054,6054,5782
16944,51,211,0,16944,16700,244,2.52695e+16,103.846,1197.74,16944,69,74,16533,16267,14331,12839,9286
2839,4,12,2794,45,2839,0,9.47836e+13,8.98767,136.743,2839,11,12,2669,2583,2289,2111,2190
30774,1758,2905,0,30774,0,30774,2.39624e+18,885.981,7044.14,30774,363,462,27869,27669,26513,26339,19147
34695,2435,2843,20822,13873,20822,13873,1.70434e+18,652.395,6964,34695,337,487,31852,31815,31644,31737,30313
44142,54,76,43292,850,44142,0,1.0918e+14,18.4775,840.129,44142,27,30,44066,44066,42790,42791,41627
29297,602,3119,0,29297,0,29297,2.28411e+18,597.073,7299.51,29297,490,313,25528,22937,16321,12462,7946
37806,58,84,37047,759,37806,0,9.90146e+13,20.2691,824.064,37806,27,32,37722,37722,36910,36921,33070
21690,1549,2302,12973,8717,0,21690,4.95068e+18,893.335,5446.92,21690,368,356,19388,18806,18693,18445,15977
5032,55,141,0,5032,4995,37,2.74226e+16,61.4767,547.645,5032,53,51,4849,4719,4367,4298,3391
6097,5,34,6026,71,6097,0,9.81495e+13,12.9911,269.795,6097,21,19,5772,5523,4893,4951,3099
43239,195,403,0,43239,42505,734,2.69773e+16,133.385,2650.67,43239,117,126,42836,42738,40055,38534,33946
31732,28,64,31309,423,31722,10,1.0169e+14,19.5523,660.788,31732,28,29,31668,31656,29816,29794,25056
43052,2244,2334,12885,30167,0,43052,3.56119e+13,671.155,7203.68,43052,466,474,40718,40718,40703,40709,40565
32330,934,3376,32330,0,28542,3788,2.30193e+18,910.59,8173.77,32330,488,368,28273,26657,20795,19356,11249
29808,12,292,0,29808,29215,593,2.50394e+16,140.042,1931.27,29808,101,102,26764,25152,21896,18735,10886
27874,2275,3540,27874,0,24523,3351,2.9299e+18,1058.8,7836.85,27874,451,415,24334,23673,23335,23128,18648
13668,271,606,13668,0,13668,0,4.13823e+18,283.422,2137.35,13668,153,157,12915,12175,9874,9678,9211
36633,411,3615,0,36633,0,36633,2.36881e+18,885.698,8380.88,36633,381,599,31492,26889,20135,13632,6203
8078,124,1890,7113,965,4742,3336,2.00182e+18,384.731,3180.3,8078,223,225,5401,4568,2837,2417,740
33894,650,2842,0,33894,0,33894,2.35813e+18,687.314,7397.78,33894,349,511,30415,28471,23272,23699,10462
35439,2094,3477,20628,14811,20628,14811,1.7892e+18,879.377,8250.97,35439,423,507,31962,31430,30926,30923,24151
41104,1471,3336,36794,4310,24576,16528,1.94833e+18,1007.02,8513.3,41104,422,488,37768,36824,33344,33152,19386
45941,574,2340,0,45941,13784,32157,9.1258e+15,952.182,7626.59,45941,553,589,42675,40864,33674,33991,16433
45569,1211,2178,0,45569,13591,31978,9.04563e+15,861.894,7312.78,45569,461,405,43380,42791,39912,39979,32022
20010,627,664,19985,25,20010,0,4.27366e+18,251.645,2566.14,20010,179,156,19346,19346,19260,19250,18956
19134,624,1812,0,19134,5708,13426,8.99052e+15,350.539,4532.11,19134,441,280,17322,17048,11813,11638,7259
5672,1186,1371,5672,0,5144,528,1.92718e+18,285.138,2331.59,5672,277,139,4301,4294,4219,4247,3846
46985,109,364,0,46985,45758,1227,2.62343e+16,166.702,2916.38,46985,121,128,46308,45779,39548,37501,24548
41174,3385,3573,24182,16992,24182,16992,1.82858e+18,933.863,9051.54,41174,483,519,37601,37601,37493,37545,36635
7689,159,192,0,7689,7492,197,2.8124e+16,75.6353,868.788,7689,59,60,7497,7497,7478,7448,7117
3361,573,829,1973,1388,1973,1388,2.00665e+18,135.675,1370.54,3361,173,121,2532,2518,2498,2519,2103
45009,2848,2950,0,45009,0,45009,2.35492e+18,1149.9,8585.3,45009,487,495,42059,42059,42008,41975,41819
49245,466,3718,29467,19778,29467,19778,1.85819e+18,1074.77,9780.04,49245,565,541,42534,39018,30665,25639,9956
23688,2041,2396,0,23688,0,23688,2.4123e+18,583.524,5644.08,23688,336,407,21292,21276,21224,21266,20375
8817,122,1236,2413,6404,0,8817,3.76951e+13,253.669,2605.83,8817,259,157,7083,6336,4359,3982,1480
38525,1339,2083,11425,27100,0,38525,3.59358e+13,753.478,6700.37,38525,424,396,36442,36212,35189,35201,31090
23083,25,56,22636,447,23083,0,1.03918e+14,17.6154,555.376,23083,25,27,23027,23015,21713,21620,17588
4192,199,367,4192,0,4192,0,4.80269e+18,174.988,1017.97,4192,89,90,3793,3579,3105,3039,2731
30484,3428,3542,0,30484,0,30484,2.26716e+18,582.712,7768.09,30484,327,550,26942,26942,26926,26919,26612
41976,968,2825,24551,17425,24551,17425,1.89157e+18,1068.28,8002.51,41976,428,477,38363,36500,35031,31830,16320
29440,633,1145,29403,37,29440,0,4.15943e+18,367.623,3702.15,29440,212,204,28295,28190,23840,23824,21609
3294,519,918,2954,340,1837,1457,1.97402e+18,175.65,1484.95,3294,148,149,2376,2302,2187,2235,1905
8956,1341,1706,5496,3460,0,8956,4.4447e+18,320.12,3233.67,8956,241,247,7250,7239,7164,7106,6633
15297,56,217,0,15297,14891,406,2.65724e+16,115.42,1280.5,15297,77,75,14862,14605,12658,11697,7789
13382,136,205,0,13382,13170,212,2.36172e+16,109.809,1115.55,13382,73,75,13177,13119,12528,12547,11427
46797,3483,3842,0,46797,0,46797,2.317e+18,1069.68,10204.1,46797,472,522,42955,42945,42766,42801,41489
32727,29,48,31986,741,32727,0,1.02744e+14,20.5562,632.832,32727,26,26,32679,32675,31708,31710,28686
26967,1369,1636,0,26967,8513,18454,8.69171e+15,509.388,5059.93,26967,332,452,25331,25328,25240,25219,23415
12912,106,207,0,12912,12710,202,2.52191e+16,96.6133,1192.48,12912,80,86,12670,12598,11677,11193,9043
12335,1372,1698,0,12335,0,12335,2.43813e+18,451.47,3625.07,12335,237,261,10637,10635,10576,10607,9957
25576,195,2187,0,25576,0,25576,2.34409e+18,924.66,5851.46,25576,345,417,19224,15862,12887,10102,2481
18267,2449,2829,11317,6950,0,18267,4.80741e+18,684.526,5665.5,18267,417,304,15438,15405,14966,14988,14614
3891,346,861,3456,435,2303,1588,1.99913e+18,269.607,1600.18,3891,178,125,2935,2267,1894,1862,1634
17996,1570,1726,10756,7240,10756,7240,1.86925e+18,868.161,4430.13,17996,361,303,16270,16257,16124,16170,15735
42469,683,3395,42469,0,37671,4798,1.91256e+18,1336.97,8925.16,42469,447,543,36521,32824,23128,18672,12458
11188,1244,2008,0,11188,0,11188,2.3788e+18,293.181,3815.1,11188,284,297,9180,9170,8717,8487,6597
2282,796,801,2282,0,1986,296,1.95039e+18,201.773,1196.42,2282,159,141,1481,1433,1481,1481,1477
13258,165,186,0,13258,12724,534,2.50338e+16,98.8571,1038.34,13258,68,71,13072,13048,12954,12981,12723
36140,244,273,0,36140,35467,673,2.63627e+16,130.842,2096.1,36140,105,102,35867,35862,35843,35770,35286
6785,611,963,2028,4757,0,6785,3.81515e+13,241.629,2082.18,6785,238,184,5822,5764,5593,5594,4483
11149,974,1082,0,11149,3297,7852,8.20525e+15,257.218,2581.08,11149,190,195,10067,10064,10049,10046,9881
4890,655,828,0,4890,1481,3409,8.85802e+15,112.732,1627.08,4890,182,126,4062,4061,4054,4051,3578
40675,2262,2762,0,40675,0,40675,2.25358e+18,835.72,7191.04,40675,440,382,37913,37796,37639,37318,35557
33202,2284,3162,20058,13144,0,33202,4.78741e+18,956.904,7573.13,33202,497,394,30040,29790,29211,29076,26855
20723,425,1909,12523,8200,12523,8200,1.84949e+18,609.972,4799.98,20723,371,252,17958,15849,13672,11765,5487
6720,392,829,0,6720,0,6720,2.27871e+18,388.252,1948.15,6720,213,182,5650,4265,4517,4075,4329
9467,1202,1348,0,9467,0,9467,2.45071e+18,331.498,2869.5,9467,249,213,8119,8112,8092,8114,7652
18378,399,727,18378,0,18378,0,4.10089e+18,293.081,2591.88,18378,169,180,17651,17450,15028,14939,14522
35895,28,59,35288,607,35887,8,9.98554e+13,19.1932,692.337,35895,29,27,35836,35835,34114,34112,29460
3218,144,609,0,3218,952,2266,9.15931e+15,112.669,1194.54,3218,117,128,2555,2315,2240,2227,1064
29322,12,42,28767,555,29322,0,1.0091e+14,19.0724,584.821,29322,22,26,29159,29032,26094,25668,19656
7494,18,32,7296,198,7494,0,9.99851e+13,14.6511,300.479,7494,20,19,7462,7455,7004,6969,6314
39662,4,76,38773,889,39662,0,1.00797e+14,21.6626,775.671,39662,28,31,35654,33224,31161,31210,17919
10680,197,1761,6453,4227,6453,4227,1.80998e+18,511.604,3572.24,10680,297,278,7863,6654,5067,3911,1805
44365,701,2431,26293,18072,0,44365,4.90591e+18,1375.2,7868.54,44365,481,458,39154,36680,28130,26859,16796
42444,1484,2569,13304,29140,0,42444,3.4229e+13,823.893,7813.04,42444,522,579,39875,39487,37549,37552,27103
21253,19,55,20937,316,21253,0,1.0186e+14,16.8125,538.259,21253,25,25,21194,21176,19340,19173,13035
42295,3972,4531,42295,0,37729,4566,2.35771e+18,1345.71,10818.9,42295,602,516,37764,37727,37757,37757,36241
12296,655,1423,0,12296,0,12296,1.97617e+18,224.074,3180.66,12296,189,270,10873,10788,10399,10345,7330
24087,21,32,23910,177,23897,190,9.89669e+13,18.0136,559.569,24087,20,23,24051,24034,22982,23000,18166
42125,75,2919,0,42125,0,42125,2.45166e+18,932.183,8262.41,42125,464,462,27552,20332,15197,12075,1701
17721,40,58,17297,424,17721,0,1.03355e+14,15.382,504.793,17721,25,26,17663,17663,17230,17231,15321
21658,708,2609,0,21658,0,21658,2.29748e+18,847.215,5940.6,21658,298,452,18224,16482,12778,13309,6132
44534,235,3597,26650,17884,0,44534,4.88738e+18,1085.33,9432.35,44534,586,411,35561,29101,21538,17199,5030
6126,869,1017,3471,2655,0,6126,4.55197e+18,294.188,2068.77,6126,150,236,5109,5071,5059,5061,4863
18442,1024,2073,11123,7319,11123,7319,1.89165e+18,779.565,4919.22,18442,346,328,16364,14810,14950,14726,11306
7191,1270,1538,4270,2921,0,7191,5.33895e+18,237.33,2650.13,7191,200,170,5653,5642,5579,5623,5195
38260,1427,2342,12170,26090,0,38260,3.26466e+13,553.244,6942.26,38260,470,304,35918,35724,34391,34445,27108
32964,15,73,32343,621,32964,0,1.02458e+14,20.8343,699.553,32964,25,28,32840,32728,29026,28932,19202
18322,889,1672,10857,7465,0,18322,4.87592e+18,895.295,4315.84,18322,293,336,16218,15455,15156,15021,8652
3213,465,926,0,3213,0,3213,2.22905e+18,149.55,1496.66,3213,141,196,2287,2217,2129,2172,1485
47771,198,346,0,47771,46884,887,2.63412e+16,156.23,2709.11,47771,114,144,47403,47274,44542,41730,37631
45803,2381,2392,0,45803,13594,32209,9.05716e+15,633.983,7785.09,45803,384,425,43411,43411,43411,43411,43372
14672,1436,1447,0,14672,0,14672,1.9973e+18,288.211,3402.26,14672,246,218,13225,13225,13225,13225,13213
19569,274,1902,5880,13689,0,19569,3.62299e+13,483.336,4802.24,19569,350,394,16840,15371,11456,10145,4259
31054,2226,2488,19151,11903,0,31054,4.87612e+18,669.115,6515.8,31054,383,393,28566,28542,28477,28514,27835
44892,307,719,44892,0,44892,0,4.01282e+18,356.895,3791.43,44892,216,220,43934,43076,32078,31473,25842
2202,60,482,648,1554,0,2202,3.15782e+13,103.483,895.847,2202,137,107,1566,1338,1099,1012,451
24900,41,288,0,24900,24325,575,2.61405e+16,116.875,1718.63,24900,92,94,23821,23078,19425,17629,10736
38150,667,3868,34442,3708,23424,14726,1.98389e+18,855.51,8996.24,38150,417,486,33319,27338,20250,19087,13005
38512,27,411,0,38512,37804,708,2.67148e+16,137.207,2721.68,38512,111,135,36386,35267,29112,22375,14183
22721,981,1690,14052,8669,0,22721,5.05702e+18,868.407,4814.05,22721,356,319,20813,18351,18630,18202,15568
23822,1708,3488,14215,9607,0,23822,4.99979e+18,445.91,7102.57,23822,309,654,20334,20265,19399,19378,10860
5717,252,1053,0,5717,0,5717,2.27841e+18,347.903,2083.66,5717,194,173,4261,3587,2357,1945,1308
39420,3,291,0,39420,38341,1079,2.58801e+16,141.633,2120.44,39420,100,109,25997,20974,19206,17975,12871
47829,2305,3886,28593,19236,28593,19236,1.8626e+18,965.486,9900.6,47829,586,392,43943,43795,42272,41885,31904
7419,97,1279,7419,0,6657,762,2.71587e+18,609.418,2545.15,7419,225,212,4779,3609,1581,1028,489
41597,2779,3620,25260,16337,0,41597,4.76963e+18,751.422,9123.63,41597,417,559,37977,37921,37237,37174,32132
34407,593,823,34395,12,34407,0,4.08946e+18,363.414,3483.23,34407,215,209,33584,33551,31460,31435,29424
40801,2228,4397,36218,4583,24711,16090,1.92659e+18,1366.12,10361.5,40801,532,493,36404,35666,30782,30722,25758
27071,956,2937,27071,0,24195,2876,1.86525e+18,784.197,6755.71,27071,349,350,23942,22664,21898,21920,13793
22087,2457,2514,0,22087,0,22087,2.25745e+18,815.172,5709.33,22087,364,390,19573,19573,19573,19573,19543
31816,164,340,0,31816,31213,603,2.5203e+16,132.867,2219.66,31816,100,118,31455,31349,28711,26936,21467
31741,1042,3451,28999,2742,18513,13228,1.94893e+18,859.662,8196.94,31741,459,368,27765,26408,16251,15394,9739
28400,537,2887,16706,11694,16706,11694,1.79625e+18,709.899,6878.51,28400,506,370,24639,23380,15239,13357,9466
48664,273,4649,43373,5291,28937,19727,1.98899e+18,1626.32,11510.2,48664,557,558,36328,29923,15360,12942,3859
45712,66,2937,26186,19526,0,45712,4.68202e+18,728.331,8423.56,45712,583,350,29593,20654,14366,12194,1588
12423,1000,2186,11001,1422,7384,5039,2.01535e+18,442.141,4220.79,12423,237,365,10237,10018,9375,9525,5128
20118,320,2002,12200,7918,0,20118,4.92663e+18,853.623,4944.95,20118,326,384,15925,13842,10114,9091,4987
20074,236,1463,6128,13946,0,20074,3.57075e+13,452.749,4216.03,20074,260,335,17198,15246,12507,12879,3926
47324,369,2064,0,47324,14583,32741,8.85672e+15,756.915,7144.01,47324,489,407,43182,40492,30266,29567,12010
9946,531,971,3017,6929,0,9946,3.21352e+13,150.29,2266.06,9946,164,169,8975,8934,8784,8883,3963
29301,2393,3769,26436,2865,17220,12081,1.97e+18,665.349,8206.74,29301,342,562,25532,25473,24602,24771,16374
18603,1285,2112,0,18603,0,18603,1.97832e+18,403.317,4496.4,18603,279,312,16491,16233,16133,15193,13496
49625,948,3515,49625,0,44530,5095,2.56318e+18,964.545,9641.42,49625,469,506,45481,44002,29164,24030,13206
740,169,377,740,0,618,122,2.53008e+18,36.7176,486.645,740,62,66,363,336,304,308,226
25365,935,2204,15088,10277,15088,10277,1.74382e+18,900.268,5878.45,25365,337,415,22578,21094,20055,19928,10313
2858,585,789,2471,387,1706,1152,2.06753e+18,109.88,1252.14,2858,159,116,2069,2067,2013,2033,1677
3388,29,129,0,3388,3320,68,2.65219e+16,43.6219,428.416,3388,45,48,3192,3102,2722,2530,1635
46987,3278,4015,27859,19128,27859,19128,1.84816e+18,957.197,9765.74,46987,616,482,42972,42950,42763,42828,41219
4338,195,812,0,4338,1257,3081,9.7514e+15,181.073,1520.15,4338,162,150,3446,3113,2633,2761,896
26398,848,2937,23581,2817,15684,10714,1.90474e+18,915.624,6634.01,26398,439,438,23068,21729,17197,15711,12142
13122,1052,2036,8011,5111,0,13122,4.92068e+18,317.222,3999.4,13122,326,293,11086,11050,8994,8609,6205
35495,3163,3313,35495,0,32082,3413,2.54502e+18,953.171,8136.56,35495,441,469,32182,32182,32172,32157,31961
14837,1386,1411,0,14837,4168,10669,9.33539e+15,445.707,3521.62,14837,325,246,13426,13426,13423,13423,13397
16607,309,769,16568,39,16607,0,3.71637e+18,302.507,2511.07,16607,171,163,15770,15336,12509,12307,9447
37906,1242,2368,0,37906,11725,26181,8.94264e+15,611.545,6954.57,37906,354,441,35538,35219,33937,33994,23433
8141,153,168,0,8141,8083,58,2.48719e+16,69.5461,772.754,8141,57,60,7973,7971,7965,7949,7841
16179,790,2310,0,16179,0,16179,2.34917e+18,585.948,4765.97,16179,319,311,13498,12675,10231,9240,5249
5691,54,150,0,5691,5625,66,2.545e+16,58.2601,650.929,5691,46,51,5506,5414,4956,4862,3222
34625,963,2643,0,34625,0,34625,2.40461e+18,1167.62,7160.96,34625,423,434,31098,29946,26443,24021,14909
19961,319,1613,5759,14202,0,19961,3.55536e+13,636.601,4398.4,19961,352,315,17495,15831,12470,12010,6155
5660,154,166,0,5660,5536,124,2.60987e+16,69.7094,644.25,5660,52,52,5494,5493,5491,5486,5396
46706,195,865,46706,0,46706,0,4.0462e+18,380.571,4049.07,46706,223,224,44070,40774,26884,26070,18444
47409,1529,2398,14009,33400,0,47409,3.54762e+13,830.087,7544.58,47409,460,404,45011,44773,43609,43727,35487
27769,1721,1859,0,27769,7937,19832,8.99285e+15,555.726,5333.93,27769,410,326,25910,25910,25636,25644,24905
16949,57,568,16676,273,16949,0,3.95689e+18,265.984,2306.08,16949,163,163,12223,7985,6346,6297,2208
15367,1583,1727,8636,6731,8636,6731,1.65528e+18,358.078,3878.77,15367,217,327,13640,13626,13637,13636,12253
42803,177,286,0,42803,42173,630,2.57016e+16,155.604,2324.92,42803,99,114,42493,42402,39920,39583,34099
42888,1301,2286,12919,29969,0,42888,3.66155e+13,603.51,7222.46,42888,401,636,40602,40493,39520,39522,28834
31813,1815,3050,0,31813,0,31813,2.39423e+18,941.019,7482.46,31813,511,363,28763,28522,25000,20597,17138
13918,177,264,0,13918,13620,298,2.58141e+16,103.956,1378.95,13918,82,78,13654,13614,13241,13229,12342
42039,148,309,0,42039,41194,845,2.55465e+16,142.349,2414.82,42039,105,101,41677,41481,38190,36928,31095
7308,4171,7308,7308,0,7308,0,1.75898e+13,0,7308,7308,7308,1,0,0,0,0,0
30208,2601,2640,0,30208,0,30208,2.3756e+18,902.724,6673.96,30208,389,400,27568,27568,27562,27563,27533
10979,596,889,0,10979,3558,7421,7.11835e+15,155.851,2200.62,10979,242,125,10090,10081,9988,9992,9190
30690,227,2709,0,30690,0,30690,2.35647e+18,1131.2,7056.8,30690,405,519,23972,19933,15792,10128,4642
38112,234,318,0,38112,37362,750,2.61444e+16,131.007,2218.67,38112,115,118,37794,37790,36536,36391,33898
20934,92,629,20904,30,20934,0,4.23269e+18,292.931,2564.73,20934,179,163,17325,12693,9058,8943,4493
1840,342,605,1151,689,0,1840,5.82011e+18,72.7005,886.857,1840,135,109,1235,1194,1201,1206,758
46259,124,3575,0,46259,0,46259,2.23535e+18,1097.07,9199.52,46259,510,551,35813,29913,17762,14365,1769
13377,433,435,13377,0,13377,0,4.09866e+18,291.443,1874.69,13377,148,146,12942,12942,12936,12936,12942
21254,1614,1682,6439,14815,0,21254,3.38013e+13,374.357,4453.41,21254,286,372,19572,19568,19569,19570,19474
26961,200,874,26961,0,26961,0,4.14432e+18,332.308,3186.7,26961,201,204,25041,22480,14967,13951,12029
48610,2987,4545,0,48610,0,48610,2.23849e+18,986.989,11055,48610,432,713,44065,43818,43303,43644,34236
14061,161,1477,0,14061,4290,9771,8.39996e+15,356.244,3458.27,14061,252,269,11887,10951,7311,7828,1656
2708,14,24,2647,61,2699,9,1.00408e+14,13.4819,162.653,2708,16,16,2679,2672,2533,2540,2374
10008,23,537,10008,0,10008,0,4.58873e+18,260.041,1772.45,10008,143,136,5626,3516,2068,1911,685
38633,1917,3463,22585,16048,22585,16048,1.77573e+18,859.004,8515.23,38633,407,519,35170,34899,34007,34420,24047
29152,1263,1951,9124,20028,0,29152,3.51748e+13,459.582,5446.26,29152,348,295,27201,27161,25469,25605,21661
42212,1778,4427,37287,4925,25558,16654,1.9796e+18,1253.13,10283,42212,536,606,37737,35814,31616,31654,16792
42719,1373,4668,38254,4465,25261,17458,1.97188e+18,1743.46,10916.9,42719,529,665,36837,34486,19521,18896,17767
23723,6,57,23284,439,23717,6,1.01197e+14,19.1089,629.576,23723,24,28,22778,21672,19089,19002,11796
10547,582,1951,10547,0,9523,1024,2.99713e+18,318.928,3629.94,10547,217,275,8596,8177,3684,2795,2708
11127,77,1186,3492,7635,0,11127,3.65345e+13,260.864,2848.73,11127,209,230,8150,6872,4951,3361,2141
6733,1082,1283,4127,2606,0,6733,4.92085e+18,281.259,2380.83,6733,216,196,5450,5450,5393,5406,5205
20386,1037,1503,12619,7767,12619,7767,1.80574e+18,412.633,3838.87,20386,294,289,18883,18863,18613,18656,17345
15967,1342,2022,0,15967,0,15967,2.37389e+18,494.695,4381.32,15967,274,291,13945,13884,13706,13844,11947
17533,226,711,17533,0,17533,0,4.16796e+18,289.993,2504.43,17533,171,179,16497,15538,11104,10781,9214
29730,542,862,29684,46,29730,0,4.23962e+18,340.17,3352.96,29730,203,210,28868,28805,25132,24763,23976
20257,2021,2996,18143,2114,11959,8298,1.92153e+18,844.612,6209.22,20257,414,421,17261,16680,16334,16391,15123
14992,1216,1506,14992,0,13250,1742,2.42958e+18,730.439,3894.09,14992,280,265,13486,13377,13107,12948,12355
16080,2576,2726,14578,1502,9104,6976,1.88528e+18,397.337,5336.67,16080,391,239,13354,13354,13353,13353,13202
1706,47,106,0,1706,1670,36,2.73701e+16,30.721,308.313,1706,36,37,1600,1564,1475,1469,1059
4782,174,183,0,4782,4701,81,2.60234e+16,54.2949,642.364,4782,47,51,4599,4599,4595,4591,4555
38684,276,1638,0,38684,11669,27015,9.02094e+15,699.538,5645.58,38684,396,296,34425,31722,24958,23626,11259
41516,54,62,40965,551,41516,0,1.02499e+14,19.8829,758.829,41516,27,28,41454,41454,41276,41276,40789
20186,2075,2922,11962,8224,0,20186,4.85299e+18,579.506,6015.68,20186,375,305,17264,17073,16679,16654,14454
39590,102,295,0,39590,38965,625,2.61002e+16,141.711,2259.36,39590,110,100,39092,38711,34573,33100,25394
34196,1029,1827,19195,15001,0,34196,4.09381e+18,969.588,5649.64,34196,363,387,31842,30722,29237,28339,23530
27545,233,236,0,27545,27141,404,2.48782e+16,124.412,1637.97,27545,81,88,27309,27309,27306,27296,27244
15973,1223,1230,4868,11105,0,15973,3.49362e+13,433.033,3359.06,15973,281,280,14743,14743,14742,14743,14740
21155,1085,1802,6056,15099,0,21155,3.80043e+13,445.045,4585.45,21155,336,287,19353,19204,19069,19063,15754
13288,67,172,0,13288,13002,286,2.77158e+16,85.1407,1052.84,13288,68,77,12962,12620,11535,11087,8591
47231,1201,3839,47210,21,41940,5291,1.40529e+18,1350.99,9995.22,47231,482,470,42296,39343,33308,30426,22968
25768,241,1081,25743,25,25768,0,4.06307e+18,364.33,3465.51,25768,197,205,23894,21918,13916,12981,11578
3651,192,641,1174,2477,0,3651,3.53544e+13,143.382,1296.23,3651,106,171,2974,2704,2581,2603,976
38896,3017,3431,0,38896,0,38896,2.46019e+18,840.614,8571.06,38896,406,505,35465,35455,35266,35395,33844
45487,1321,3223,27247,18240,27247,18240,1.87496e+18,1141.85,8940.05,45487,478,494,41887,39980,37750,36205,26786
25010,360,3001,15006,10004,15006,10004,1.87852e+18,880.781,6595.52,25010,379,433,20037,17521,13862,11126,4172
18690,566,2668,16446,2244,11224,7466,1.99225e+18,760.059,5660.2,18690,314,407,14953,12918,9143,8902,4744
37710,3673,4934,33266,4444,22321,15389,1.99252e+18,1099.58,10558.6,37710,547,499,32776,32653,31945,32152,27658
40798,1124,2582,24476,16322,0,40798,4.83194e+18,923.143,7587.07,40798,432,466,38066,36655,30050,29437,22661
29918,772,958,29918,0,29918,0,4.5214e+18,350.194,3449.91,29918,196,216,28960,28953,28220,28198,28311
7548,1119,1127,0,7548,0,7548,2.56754e+18,524.379,2322.3,7548,230,193,6421,6421,6420,6421,6417
25333,1621,1901,7396,17937,0,25333,3.39362e+13,389.977,5082.77,25333,405,216,23432,23408,23369,23369,21258
30940,2572,2928,0,30940,0,30940,2.19606e+18,709.037,7296.39,30940,370,545,28012,28011,27902,27974,26654
29479,956,2576,17682,11797,0,29479,5.02627e+18,911.205,6471.11,29479,393,413,26343,24939,23593,23127,14189
43335,3192,4366,25377,17958,0,43335,4.88466e+18,791.329,10230,43335,411,650,38969,38956,38488,38484,32510
19295,368,797,19285,10,19295,0,4.09336e+18,321.699,2715.91,19295,186,175,18477,18118,14775,14625,14215
48439,1102,2171,0,48439,14127,34312,9.47159e+15,658.842,7260.4,48439,473,370,46268,45705,41744,42090,30131
23846,2066,3319,21502,2344,13959,9887,1.93524e+18,589.58,7006.45,23846,384,344,20527,20379,19608,19837,16189
32747,807,3327,29620,3127,19207,13540,1.97251e+18,1076.08,7872.67,32747,553,371,28165,25219,14243,13755,11392
47626,362,4077,28783,18843,28783,18843,1.90928e+18,1296.04,10318.1,47626,612,536,39493,33523,24682,22277,5403
23217,445,1220,6702,16515,0,23217,3.69169e+13,640.303,4072.17,23217,344,334,20907,19179,17884,17495,12717
35201,2644,3519,35201,0,31034,4167,2.87637e+18,1247.41,8577.61,35201,443,475,31682,31304,31268,31250,29326
38182,928,1689,12032,26150,0,38182,3.43945e+13,695.042,6047.56,38182,418,467,36453,35651,34135,34234,28171
14818,684,1910,8024,6794,8024,6794,1.61425e+18,354.465,3930.78,14818,307,259,12908,12434,10718,9582,7636
46658,1952,4657,0,46658,0,46658,2.4228e+18,1158.81,11125.8,46658,671,441,41935,40719,33790,26409,21003
18754,2051,2393,0,18754,0,18754,2.31978e+18,552.968,5076.9,18754,387,316,16361,16355,16225,16188,15013
9702,5109,9702,9702,0,9702,0,1.75904e+13,0,9702,9702,9702,1,0,0,0,0,0
25957,1952,2291,15215,10742,0,25957,4.58843e+18,893.529,5862.85,25957,408,453,23666,23640,22977,22785,22642
35375,2850,4338,35375,0,31562,3813,1.91704e+18,1472.27,9402.73,35375,476,464,31037,30051,29514,29328,26217
48350,2404,4137,48350,0,43453,4897,1.69144e+18,1974.03,10794.5,48350,563,465,43531,41663,41366,41645,31672
2282,214,742,2068,214,1410,872,1.89447e+18,233.002,1170.8,2282,115,150,1430,1100,905,836,610
25611,1510,1762,7347,18264,0,25611,3.52481e+13,557.919,5214.68,25611,382,439,23849,23847,23779,23785,21771
31764,582,3175,31764,0,28437,3327,1.90724e+18,1011.98,7737.24,31764,437,401,26920,23064,17946,14643,9116
43320,816,869,43320,0,43320,0,4.07639e+18,377.483,3901.4,43320,234,222,42451,42451,42345,42343,42211
18549,235,265,0,18549,18270,279,2.62996e+16,95.6304,1445.75,18549,85,86,18284,18284,18217,18225,18032
24938,1493,3664,22318,2620,14958,9980,1.98523e+18,632.902,7337.63,24938,444,376,21274,20891,16801,16090,13262
41370,250,1045,41370,0,41370,0,4.10486e+18,367.423,4060.38,41370,222,220,39441,37071,23668,22319,18096
17282,2061,2150,17282,0,15447,1835,2.35626e+18,844.497,4935.82,17282,348,304,15132,15132,15121,15119,15063
10490,289,787,3428,7062,0,10490,3.12092e+13,237.316,2210.9,10490,176,217,9534,9151,8708,8682,5152
24700,578,1494,0,24700,7619,17081,8.13194e+15,380.667,4309.27,24700,306,258,23206,22860,20802,21082,10126
2037,323,431,631,1406,0,2037,3.9319e+13,119.403,793.235,2037,90,102,1606,1537,1582,1582,1388
16680,1374,1929,0,16680,0,16680,2.44107e+18,579.147,4313.69,16680,302,271,14751,14482,14184,13944,13074
9088,74,1140,4723,4365,0,9088,4.33068e+18,242.388,2472.53,9088,221,194,6720,4545,2091,2338,669
42432,50,56,41723,709,42403,29,9.98153e+13,19.8066,747.628,42432,26,26,42376,42376,42265,42265,41894
10605,10,24,10424,181,10605,0,9.88681e+13,11.2742,306.768,10605,16,18,10546,10511,10097,10066,8984
14806,1129,2422,13245,1561,8639,6167,1.94658e+18,538.317,4748.1,14806,319,345,12384,12150,11074,11088,7238
31524,1637,2845,28311,3213,19673,11851,1.93425e+18,703.557,7145.85,31524,339,471,28679,28671,27589,27846,15916
5692,227,727,1684,4008,0,5692,3.71416e+13,210.535,1622.17,5692,189,146,4756,4243,4089,4099,2313
29739,107,1879,9198,20541,0,29739,3.54409e+13,566.169,5656.14,29739,393,456,23089,20055,15520,9293,4285
35738,95,1086,35738,0,35738,0,4.5005e+18,381.091,3922.38,35738,223,222,29245,21928,13733,12612,6328
2681,966,1170,2681,0,2471,210,2.33769e+18,84.7035,1579.48,2681,204,137,1511,1510,1501,1501,1395
17549,997,2150,0,17549,0,17549,2.53482e+18,730.213,4854.91,17549,324,388,15028,14126,13663,12611,8266
12780,8,35,12596,184,12780,0,1.03582e+14,16.6592,394.72,12780,21,22,12569,12470,10916,10919,7930
12621,520,1185,11533,1088,6657,5964,1.83831e+18,256.506,2677.11,12621,205,196,11436,11162,10424,10693,7245
33711,1765,2018,0,33711,10224,23487,9.28948e+15,629.762,5682.09,33711,423,304,31693,31675,31621,31607,30342
21285,1094,2845,12363,8922,12363,8922,1.78931e+18,384.435,5843.68,21285,301,445,18440,18120,17423,17519,8977
24830,517,2464,14500,10330,14500,10330,1.82568e+18,732.447,6075.62,24830,344,548,21223,20170,17619,16854,3772
29106,786,3374,29106,0,25787,3319,2.59297e+18,774.078,7445.06,29106,497,378,25276,23480,17000,14982,9413
19358,28,36,19045,313,19333,25,9.80905e+13,18.2849,475.129,19358,21,23,19322,19322,18858,18858,18050
2031,61,94,0,2031,1975,56,2.63254e+16,33.9015,321.621,2031,34,33,1937,1919,1800,1866,1338
9595,598,1511,5441,4154,0,9595,4.35241e+18,259.392,3061.76,9595,269,244,8084,7741,6250,6191,5024
46183,2271,4319,41470,4713,28234,17949,1.94591e+18,1061.48,10776.9,46183,455,591,41864,41471,39988,40306,26248
11778,4,16,11746,32,11778,0,2.16146e+18,15.9783,434.106,11778,16,16,2354,0,1471,2205,2354
29002,912,4482,29002,0,25884,3118,1.89936e+18,607.877,8994.24,29002,385,699,24407,23316,14068,10703,5842
8358,310,438,8358,0,8358,0,3.89102e+18,229.448,1460.62,8358,124,118,7920,7892,7480,7471,7332
35386,895,3532,0,35386,0,35386,2.12922e+18,740.943,8421.7,35386,456,440,31385,30494,23775,23245,13833
37057,1332,1872,0,37057,11426,25631,9.26275e+15,755.441,6045.3,37057,451,387,35185,35034,33808,33877,31153
20965,244,2196,20965,0,18612,2353,1.74513e+18,957.877,5456.74,20965,330,396,14678,11490,6646,5736,3287
8480,3,35,8365,115,8480,0,9.83837e+13,14.9882,343.967,8480,20,20,7092,6383,6243,6117,3946
2805,1,2,2630,175,2789,16,0.000356506,0.999287,73.7777,2805,2,1,2803,2803,2803,2803,2803
31554,754,2097,0,31554,9545,22009,9.20412e+15,609.696,6139.72,31554,403,396,29270,28388,25572,25340,16080
3726,483,684,0,3726,1161,2565,9.38346e+15,159.958,1357.93,3726,108,189,3042,3041,2994,2978,2514
26381,1316,2745,23664,2717,14887,11494,1.91616e+18,675.706,6631.82,26381,300,486,23636,23330,22299,22419,11331
15225,41,42,14985,240,15204,21,9.8022e+13,17.7925,427.961,15225,21,23,15183,15183,15181,15181,15176
27540,2846,3565,24886,2654,15592,11948,1.90873e+18,856.347,7314.18,27540,510,411,23975,23972,22879,22985,19488
36956,2554,5285,36956,0,32861,4095,1.85902e+18,933.724,10814.9,36956,494,523,31671,31106,29589,28747,18612
19284,28,48,18913,371,19284,0,1.02627e+14,18.0453,503.25,19284,24,25,19236,19232,18577,18579,16708
37744,17,314,0,37744,36865,879,2.71706e+16,160.357,2339.65,37744,122,130,34526,32794,27157,20693,13570
1303,59,364,0,1303,0,1303,1.67749e+18,87.6861,612.004,1303,88,61,763,410,325,278,355
32245,745,2024,0,32245,10084,22161,9.34325e+15,661.159,6040.81,32245,421,490,30048,28567,25751,25069,14663
21829,1947,2162,12980,8849,12980,8849,1.91665e+18,901.618,5334.89,21829,385,357,19667,19544,19417,19541,18904
44052,1928,3708,0,44052,0,44052,2.32598e+18,870.753,9262.91,44052,463,483,40344,39614,38586,35850,29756
39806,357,2233,0,39806,11424,28382,9.62215e+15,622.075,6845.95,39806,437,342,36355,34278,24540,22574,10841
43755,1165,2407,0,43755,13698,30057,9.08338e+15,757.255,7406.11,43755,403,463,41348,40527,38599,38679,25144
8413,1205,1346,0,8413,0,8413,2.30175e+18,323.707,2707.75,8413,213,185,7067,7067,7050,7058,6876
33957,53,76,33204,753,33947,10,1.03747e+14,18.1583,743.002,33957,29,28,33881,33881,33215,33216,30174
29314,1260,3392,16638,12676,0,29314,4.46805e+18,716.329,7566.97,29314,430,482,25922,25439,23074,22654,13133
31815,142,2861,18629,13186,0,31815,4.5282e+18,721.323,6968.11,31815,383,438,24219,19831,11404,8661,3837
3037,299,487,0,3037,831,2206,1.00132e+16,144.021,976.464,3037,138,90,2550,2374,2402,2421,1855
10634,19,33,10483,151,10634,0,9.89426e+13,13.8846,312.726,10634,20,20,10601,10598,10325,10326,10232
45306,527,905,45306,0,45306,0,4.26789e+18,369.435,4049.49,45306,219,236,44401,44235,38841,38130,38178
23060,1398,2872,13666,9394,0,23060,4.90514e+18,728.724,6435.35,23060,347,441,20188,19639,19188,19106,15326
44952,2114,3819,44952,0,39982,4970,1.97926e+18,1130.42,9514.08,44952,456,517,41133,40887,38771,38738,34255
10340,9,35,10139,201,10340,0,1.02083e+14,15.405,348.77,10340,18,23,10207,10126,8856,8765,6024
14369,390,1113,0,14369,4464,9905,8.94767e+15,296.353,3070.01,14369,213,228,13246,12847,11573,11821,8062
5039,25,150,0,5039,4984,55,2.66552e+16,47.6704,614.215,5039,44,49,4753,4530,4076,3859,2680
38793,902,2363,23081,15712,0,38793,5.03118e+18,1255.58,7089.82,38793,469,416,34859,32963,32300,31292,14874
18928,30,56,18591,337,18928,0,1.08498e+14,16.339,511.142,18928,25,25,18872,18872,17755,17739,15052
48140,2207,3191,28821,19319,28821,19319,1.82123e+18,1237.31,8905.35,48140,474,545,44949,44236,43651,43736,37026
24926,52,68,24593,333,24926,0,1.05178e+14,17.6797,620.339,24926,26,27,24858,24858,24373,24374,22963
38423,1630,2507,34269,4154,23443,14980,2.00918e+18,1106.88,7211.74,38423,438,382,35916,35565,31801,31665,28900
6994,870,1032,6209,785,4125,2869,1.88781e+18,360.718,2165.95,6994,197,157,5962,5960,5955,5954,5809
23781,34,70,23421,360,23781,0,1.02217e+14,19.0607,638.87,23781,28,27,23711,23705,22745,22720,18209
38136,299,762,38130,6,38136,0,3.9795e+18,352.26,3578.22,38136,210,222,37044,35834,27064,26637,23211
49188,2083,2614,15012,34176,0,49188,3.53425e+13,723.292,7996.26,49188,455,360,46574,46572,45872,45904,41381
26191,704,3531,23290,2901,15775,10416,1.91157e+18,764.226,7610.95,26191,431,360,22010,20130,8902,8828,3890
11813,718,1140,3701,8112,0,11813,3.00949e+13,172.381,2660.05,11813,225,152,10673,10637,10451,10459,8980
22272,1377,1607,13711,8561,0,22272,5.08124e+18,876.204,4602.19,22272,359,326,20665,20629,20277,20227,19927
11430,1826,2302,10287,1143,6975,4455,2.03307e+18,373.343,4150.61,11430,317,210,9128,9123,9014,9063,8435
7315,27,429,7315,0,7315,0,4.26626e+18,245.243,1433.91,7315,117,120,4066,2145,1733,1539,715
1427,438,525,1427,0,1304,123,1.60366e+18,62.9783,754.698,1427,119,78,902,902,885,875,860
21451,139,729,21451,0,21451,0,4.46179e+18,316.236,2770.43,21451,183,182,18931,16168,10397,9586,7031
9137,356,1444,9137,0,8114,1023,1.68141e+18,466.985,3010.19,9137,222,262,7191,6299,4409,4235,2793
12855,1680,2138,7803,5052,7803,5052,1.8903e+18,520.101,4177.88,12855,362,237,10717,10712,10421,10442,9154
9470,997,1804,8438,1032,5578,3892,1.96718e+18,501.85,3435.2,9470,253,364,7666,7307,6435,6500,5414
8779,287,805,0,8779,0,8779,2.21131e+18,409.385,2174.21,8779,205,194,7036,5566,4998,4134,4153
35766,2318,3439,35766,0,32102,3664,2.8631e+18,1006.17,8491.41,35766,445,476,32327,32198,31021,30807,27150
40439,174,728,40439,0,40439,0,4.03645e+18,341.87,3604.19,40439,214,216,37520,33572,23085,21386,15723
16263,527,533,16190,73,16263,0,4.07292e+18,293.481,2237.86,16263,156,152,15730,15730,15728,15728,15717
48013,1881,4079,42947,5066,28204,19809,1.94341e+18,1545.59,10292.9,48013,535,532,43621,41639,33332,33088,29405
48660,2515,3006,0,48660,15718,32942,8.81098e+15,754.856,8594.91,48660,605,467,45654,45652,45222,45270,43652
29460,1413,1451,9474,19986,0,29460,3.35386e+13,411.148,4611.11,29460,275,345,28009,28009,28003,28003,27984
26111,1047,1550,0,26111,8209,17902,9.19259e+15,490.598,4812.13,26111,328,312,24561,24508,23292,23265,20176
49674,986,5949,49674,0,44345,5329,2.23552e+18,1045.77,12893.1,49674,490,733,42578,39329,23336,18606,15918
4364,6,24,4268,96,4364,0,1.00426e+14,13.7351,204.956,4364,15,16,4232,4151,3598,3550,2690
29806,96,4267,26756,3050,17677,12129,1.94025e+18,887.356,8901.44,29806,478,560,18779,13269,7687,6331,1116
15087,1200,2140,8561,6526,8561,6526,1.80768e+18,367.743,4567.24,15087,244,444,12947,12928,12527,12648,9599
21368,261,295,0,21368,20872,496,2.74601e+16,128.902,1771.81,21368,99,98,21073,21069,20988,20916,20694
16058,1508,1547,0,16058,4903,11155,9.37029e+15,336.301,3842.87,16058,239,268,14511,14511,14508,14508,14450
29105,1258,2227,0,29105,8575,20530,9.43778e+15,510.119,6087.58,29105,297,434,26878,26672,26399,26283,20814
46677,2716,3477,27119,19558,27119,19558,1.72614e+18,1072.22,9452.44,46677,571,563,43200,43131,42451,42520,39791
25095,2902,2916,22136,2959,14751,10344,1.93546e+18,1118.92,6772.7,25095,403,463,22179,22179,22179,22179,22166
674,196,341,571,103,388,286,2.08339e+18,30.4585,438.245,674,48,62,333,327,314,295,204
29703,234,254,0,29703,29130,573,2.58023e+16,144.591,1829.5,29703,92,101,29449,29446,29382,29215,28955
3053,67,121,0,3053,3024,29,2.55377e+16,38.0861,409.839,3053,37,40,2932,2913,2716,2818,2337
25463,730,2181,14773,10690,0,25463,4.32335e+18,998.927,5585.09,25463,354,374,22401,20938,19209,18735,9108
40496,212,306,0,40496,39954,542,2.74914e+16,137.405,2239,40496,112,109,40190,40158,39522,39309,37453
33912,913,1768,20077,13835,0,33912,4.75002e+18,930.943,5611.99,33912,413,394,31592,30138,27965,26710,19959
5895,219,400,5340,555,3103,2792,1.74503e+18,159.6,1220.98,5895,113,113,5495,5454,5302,5197,3913
18296,38,54,18059,237,18296,0,1.01415e+14,18.774,510.098,18296,23,27,18242,18241,17683,17683,16108
14061,144,613,14061,0,14061,0,4.15955e+18,274.924,2144.18,14061,155,152,12404,10636,7363,6775,4528
32197,1,41,31554,643,32197,0,9.91726e+13,19.9581,608.072,32197,24,25,13040,13040,13040,13040,13040
6662,517,1195,3928,2734,3928,2734,1.84438e+18,254.778,2287.4,6662,264,169,5467,5339,5118,4940,3709
9976,18,44,9792,184,9976,0,1.06569e+14,15.7597,365.284,9976,20,21,9929,9923,9188,9156,6689
14764,402,1427,4472,10292,0,14764,3.69558e+13,315.07,3511.98,14764,274,215,13301,12802,10690,10855,7525
17621,1826,2321,0,17621,0,17621,2.26568e+18,460.223,5077.29,17621,253,368,15300,15293,15145,15218,13621
39626,2274,3920,35069,4557,23554,16072,1.95809e+18,1451.74,9602.87,39626,622,512,35706,34241,30912,30005,26004
10795,138,2186,6477,4318,0,10795,5.02097e+18,312.193,3916.52,10795,257,319,7763,6480,4694,3845,1236
1553,45,539,1553,0,1448,105,2.09329e+18,27.7663,734.054,1553,106,66,1009,898,291,218,44
29598,1548,2494,0,29598,0,29598,2.52356e+18,986.004,6395.54,29598,499,382,27104,26271,25430,21567,22432
40866,400,2364,0,40866,12795,28071,8.95543e+15,705.583,6982.59,40866,521,526,37313,35455,24847,23972,10235
26394,1902,3837,26394,0,23713,2681,2.84197e+18,900.002,8018.13,26394,348,444,22557,21924,19961,19077,13688
28019,760,911,28019,0,28019,0,4.19767e+18,374.85,3345.41,28019,207,207,27108,27097,26614,26613,26520
9913,1202,1824,5940,3973,0,9913,4.97359e+18,277.733,3454.14,9913,286,252,8089,8078,7960,7938,6451
3277,220,345,3277,0,3277,0,3.94054e+18,169.435,887.801,3277,83,75,2932,2776,2416,2374,2155
43316,2528,3004,26236,17080,26236,17080,1.87985e+18,1081.28,8483.43,43316,531,428,40312,40169,39839,40071,37700
42188,1898,3577,0,42188,0,42188,2.31878e+18,858.331,8916.68,42188,574,428,38611,38204,32445,26195,26813
42851,196,4486,42851,0,37913,4938,2.02847e+18,1029.93,10597.7,42851,483,453,30703,24758,12217,6864,1952
46285,1738,3342,0,46285,0,46285,2.35042e+18,1150.2,9104.11,46285,614,480,42943,42064,37689,32783,28236
26788,2910,3948,26788,0,24202,2586,2.01758e+18,995.665,8061.59,26788,360,426,22840,22486,22550,22250,20099
49378,457,2729,0,49378,16158,33220,8.23141e+15,699.694,8270.05,49378,475,382,45565,43741,28096,25955,14212
34583,1579,3456,20910,13673,0,34583,4.73821e+18,1039.27,8350.36,34583,464,509,31057,30043,28138,27705,15825
15141,2213,2622,13843,1298,8897,6244,1.93696e+18,566.775,4948.51,15141,282,332,12519,12366,12433,12452,10843
10062,1249,1474,0,10062,0,10062,2.3214e+18,477.744,3161.14,10062,258,307,8588,8402,8106,7449,7727
3039,651,682,2689,350,1864,1175,1.92607e+18,336.912,1264.5,3039,154,134,2357,2352,2352,2353,2341
24007,1722,4165,24007,0,21739,2268,2.45477e+18,811.657,7920.15,24007,313,488,19842,19017,15238,14308,9636
34164,1130,1918,9716,24448,0,34164,3.69621e+13,667.221,5820.09,34164,455,346,32246,31707,30700,30764,22208
42442,894,3647,24924,17518,24924,17518,1.8262e+18,907.098,9013.14,42442,568,491,38398,36131,32465,30924,14902
47065,220,334,0,47065,46304,761,2.60734e+16,145.602,2535,47065,109,125,46731,46701,44779,44362,39491
41833,1886,2548,0,41833,13303,28530,8.87343e+15,537.198,7351.52,41833,530,412,39285,39216,38738,38772,36132
46160,38,82,45393,767,46081,79,1.00346e+14,19.9639,919.205,46160,30,31,46078,46076,43150,43046,34951
4478,538,932,2752,1726,0,4478,4.74033e+18,229.997,1705.06,4478,164,133,3546,3466,3402,3318,2366
44619,1412,3149,25529,19090,25529,19090,1.71995e+18,1455.64,8566.32,44619,506,488,40632,38409,35917,34905,17138
9917,1253,1709,9031,886,5665,4252,1.87725e+18,319.827,3373.4,9917,223,247,8208,8194,7996,8045,6243
48092,165,376,0,48092,47395,697,2.59586e+16,174.538,2801.61,48092,115,129,47629,47413,42773,40059,31859
47009,2488,4275,41869,5140,28182,18827,1.99765e+18,1286.05,10484.4,47009,548,434,42734,41939,40336,40377,34691
9086,350,1180,5427,3659,0,9086,4.91668e+18,422.164,2699.31,9086,214,202,7362,6359,4596,4581,3830
1290,56,251,1290,0,1290,0,4.06349e+18,79.6496,492.771,1290,56,52,904,594,571,490,270
3328,328,652,0,3328,848,2480,9.8847e+15,103.559,1182.01,3328,151,123,2676,2644,2614,2627,1533
14946,548,677,14946,0,14946,0,4.27246e+18,280.11,2300.3,14946,160,163,14269,14260,14011,14022,13777
10411,176,1686,0,10411,0,10411,2.40495e+18,389.861,3308.62,10411,223,286,7747,6612,5192,4670,1516
18718,29,2376,0,18718,0,18718,2.25633e+18,582.993,5175.78,18718,372,404,9335,5468,4791,4521,315
35169,3632,3640,35169,0,31277,3892,2.76021e+18,1027.45,8691.62,35169,428,468,31529,31529,31524,31526,31519
34567,1714,2154,0,34567,10445,24122,8.56243e+15,651.377,6381.7,34567,351,475,32413,32390,32103,32126,27109
34844,226,1861,20457,14387,20457,14387,1.8882e+18,1053.12,5877.34,34844,399,343,28102,22858,20910,17509,6644
5077,349,1029,0,5077,0,5077,2.0858e+18,153.515,1850.96,5077,154,174,4048,3887,3488,3564,1250
48240,90,2659,13675,34565,0,48240,3.71883e+13,735.795,8229.4,48240,523,416,37282,32350,24945,12852,6525
7047,20,22,6982,65,7047,0,9.6741e+13,15.1863,252.079,7047,17,18,7025,7025,7022,7022,7003
11434,911,920,3521,7913,0,11434,3.70117e+13,451.977,2634.63,11434,287,290,10514,10514,10513,10513,10505
8477,329,2399,7630,847,5110,3367,1.98175e+18,235.429,3750.99,8477,310,215,6012,5325,2661,2227,878
44644,128,324,0,44644,43885,759,2.66028e+16,166.321,2593.85,44644,116,130,44144,43810,39630,36891,30157
48546,145,315,0,48546,47433,1113,2.60587e+16,150.419,2613.56,48546,117,116,48146,47834,44112,41637,34602
17225,2,204,0,17225,16973,252,2.50958e+16,113.764,1223.63,17225,74,80,10034,8176,7481,8023,5795
32021,1686,3258,28652,3369,18939,13082,1.96213e+18,914.074,7745.72,32021,448,363,28763,28023,24989,24961,18081
37648,3231,3389,0,37648,0,37648,2.35665e+18,655.67,8233.02,37648,390,523,34259,34259,34242,34256,33961
23466,601,3018,21139,2327,13254,10212,1.95928e+18,880.307,6334.58,23466,377,355,19840,18814,14958,14530,4887
45303,65,1616,0,45303,13303,32000,8.46748e+15,842.583,5966.99,45303,397,338,34896,27690,20011,17850,3773
6299,526,1242,3691,2608,0,6299,4.35711e+18,264.263,2298.55,6299,205,199,5057,4855,4572,4579,2639
11162,1124,2036,10146,1016,6339,4823,1.91555e+18,270.296,3752.74,11162,219,272,9126,9080,8309,8507,4844
19410,75,2171,10894,8516,0,19410,4.50775e+18,457.099,4748.48,19410,236,355,13244,8880,6278,6159,1087
49176,1831,2349,0,49176,14809,34367,9.22389e+15,922.26,7664.08,49176,476,479,46827,46426,45450,45502,43352
8508,429,2016,7483,1025,5116,3392,1.9694e+18,333.563,3486.85,8508,242,252,6389,5471,3736,3670,1607
32415,1302,1846,9642,22773,0,32415,3.66456e+13,770.344,5703.72,32415,478,391,30569,30196,29327,29356,26056
3319,108,123,0,3319,3272,47,2.47719e+16,61.8057,452.127,3319,41,49,3196,3184,3158,3163,2939
21128,387,622,21128,0,21128,0,4.44014e+18,316.433,2583.56,21128,175,183,20506,20317,18538,18406,18840
34589,2234,3486,31367,3222,20762,13827,1.92384e+18,1163.07,8303.21,34589,475,461,31103,30310,30221,30494,25752
41437,1209,3734,41387,50,36890,4547,2.64569e+18,945.423,9088.96,41437,486,485,37664,36497,24843,22834,18769
27849,74,205,0,27849,27191,658,2.40607e+16,119.245,1564.96,27849,89,90,27404,26854,24075,22774,18395
13978,1197,1632,12592,1386,8682,5296,1.96075e+18,434.052,3578.01,13978,253,214,12346,12340,12256,12289,11944
8261,416,889,2451,5810,0,8261,3.46825e+13,320.66,2192.37,8261,244,222,7327,6806,6624,6616,4629
42508,1207,3421,25247,17261,25247,17261,1.84642e+18,1044.34,9125.74,42508,508,654,38857,37238,35668,35842,21301
14774,162,2687,14774,0,13280,1494,1.9793e+18,584.841,5133.14,14774,414,256,9647,7633,3838,2849,968
41691,2642,2905,23786,17905,0,41691,4.36249e+18,1242.07,7959.17,41691,422,465,38786,38202,38518,38480,37519
34949,2938,3880,34949,0,31597,3352,2.83957e+18,919.656,8978.6,34949,643,452,31069,30964,29817,28809,26769
48133,304,3066,0,48133,0,48133,2.38089e+18,1032.79,8774.04,48133,456,416,39174,32090,22872,15146,8620
2480,41,827,2480,0,2221,259,1.93557e+18,221.069,1278.03,2480,125,100,1064,548,299,167,130
11687,367,564,11681,6,11687,0,4.06177e+18,272.35,1921.75,11687,145,145,11123,10991,10103,10045,9303
42674,860,3243,25352,17322,25352,17322,1.7894e+18,1169.47,8750.69,42674,476,449,37983,35315,27410,26949,12002
9947,509,1368,6128,3819,6128,3819,1.55612e+18,402.613,2864.55,9947,242,218,8579,8085,6713,5982,4586
32993,45,251,0,32993,32297,696,2.75712e+16,134.217,1910.52,32993,104,109,31957,31039,25334,22853,16251
46899,2589,3267,46874,25,42813,4086,1.47765e+18,1192.12,8683.06,46899,428,499,43632,43392,43258,43191,40492
24130,3134,3148,13809,10321,13809,10321,1.72713e+18,428.338,6499.48,24130,270,457,20982,20982,20981,20981,20979
3112,160,878,0,3112,0,3112,2.48392e+18,97.7651,1374.54,3112,144,145,2219,1938,1718,1663,735
26445,2226,2760,15956,10489,15956,10489,1.91143e+18,739.597,6408.51,26445,429,381,23685,23681,23554,23590,22695
32125,540,2885,19435,12690,0,32125,4.89116e+18,879.406,7329.67,32125,479,372,28142,26453,21676,20159,7297
34997,274,794,34961,36,34997,0,4.0525e+18,346.173,3492.89,34997,207,206,33907,32892,24515,23886,17630
39854,709,2272,12438,27416,0,39854,3.52862e+13,557.351,6841.14,39854,547,385,37576,36754,29311,28883,24179
35459,2055,3558,20248,15211,20248,15211,1.73768e+18,664.888,8278.13,35459,451,536,31901,31698,30864,30223,25379
6847,439,979,0,6847,2198,4649,8.69412e+15,201.685,2089.41,6847,192,203,5868,5740,5341,5451,3404
19011,14,30,18727,284,19011,0,9.7201e+13,17.2077,430.392,19011,19,22,18953,18919,17255,17315,13105
33923,59,2921,19543,14380,19543,14380,1.79037e+18,775.652,7495.99,33923,360,480,21599,14559,10204,9532,1564
14287,36,39,14122,165,14287,0,1.0365e+14,16.8621,418.493,14287,20,23,14248,14248,14061,14061,14153
23009,2805,2934,20536,2473,13714,9295,1.97062e+18,836.431,6447.77,23009,472,325,20075,19987,20067,20067,19927
15134,385,474,15134,0,15134,0,4.48013e+18,259.988,1988.66,15134,140,148,14660,14643,14195,14212,14161
16571,1170,1247,5146,11425,0,16571,3.51351e+13,457.944,3553.8,16571,305,269,15324,15321,15307,15308,15020
8745,188,195,0,8745,8633,112,2.63264e+16,82.3952,921.851,8745,56,64,8550,8550,8548,8547,8495
3042,423,569,0,3042,944,2098,9.23962e+15,199.061,1114.34,3042,143,138,2473,2389,2373,2354,2206
44467,3457,4774,44467,0,39285,5182,2.73141e+18,957.287,11060.1,44467,508,465,39693,39627,38737,38404,35125
16384,452,1394,10454,5930,0,16384,4.96175e+18,517.836,3669.98,16384,250,248,14156,11581,11212,10893,8517
34671,6,56,34079,592,34671,0,9.85502e+13,21.429,723.216,34671,25,28,33712,32816,28374,28614,16486
37542,2021,4026,37542,0,33701,3841,1.93175e+18,811.621,8989.14,37542,493,482,33516,33003,30905,30545,23926
9097,13,31,8971,126,9097,0,1.02726e+14,15.2866,310.132,9097,21,18,9047,9025,8263,8141,5978
42918,1115,3315,0,42918,0,42918,2.32741e+18,1110.9,9020.98,42918,527,483,38926,36578,25371,24678,14362
48961,3067,3873,28522,20439,28522,20439,1.71433e+18,1187.19,9875.19,48961,557,435,45088,44799,44446,44666,39718
34951,949,2941,20838,14113,0,34951,4.85806e+18,908.435,7697.4,34951,463,406,31382,28755,19199,18087,13714
6691,20,689,1948,4743,0,6691,3.46253e+13,290.855,1737.44,6691,193,174,4034,3047,2416,1519,578
46498,2464,3075,0,46498,0,46498,2.22347e+18,1365.35,8514.5,46498,377,468,43423,43010,43235,43117,40828
44415,657,2373,0,44415,12829,31586,9.61583e+15,690.201,7525.22,44415,459,450,41547,40180,34027,34256,17827
17106,459,1699,0,17106,0,17106,2.33938e+18,816.748,4234.31,17106,330,380,14455,13196,10614,10316,4690
8150,289,475,8150,0,8150,0,3.95334e+18,213.9,1564.88,8150,132,126,7675,7511,6872,6849,6114
35308,454,1314,0,35308,10206,25102,9.49853e+15,694.306,5011.5,35308,417,299,32275,29830,27720,27878,18417
40823,912,3810,24410,16413,24410,16413,1.83535e+18,816.02,9478.02,40823,393,633,36484,35083,30425,31105,14726
30731,311,1607,18074,12657,0,30731,4.86606e+18,821.171,5047.45,30731,336,312,26327,21335,19692,19067,7240
39231,637,2572,22530,16701,0,39231,4.53572e+18,1030,7463.05,39231,449,536,34788,32349,23657,24688,7390
47711,183,299,0,47711,46979,732,2.61629e+16,154.683,2470.3,47711,110,122,47403,47262,44572,44269,40824
31884,493,606,31884,0,31884,0,4.09639e+18,318.294,3102.13,31884,200,185,31278,31256,30010,30133,29156
11048,1029,1319,3354,7694,0,11048,3.57575e+13,367.181,3095.45,11048,338,289,9729,9638,9432,9445,8656
23831,1604,2915,14419,9412,0,23831,4.78737e+18,739.99,6503.65,23831,366,404,20916,20723,18977,18519,10626
49657,3605,3686,28156,21501,28156,21501,1.6128e+18,984.198,9967.42,49657,541,585,45971,45971,45960,45959,45885
9793,682,1679,9793,0,8772,1021,2.66628e+18,544.208,3337.81,9793,276,205,8046,7153,6924,6636,4878
1714,70,98,0,1714,1685,29,2.43416e+16,42.4872,292.137,1714,37,39,1616,1582,1563,1572,1453
9272,773,1323,0,9272,2568,6704,9.03328e+15,242.731,2818.68,9272,257,238,7949,7926,7638,7641,5089
36211,13,16,36067,144,36211,0,2.16161e+18,15.9929,761.168,36211,16,16,28956,0,22626,27148,28956
15334,215,637,15334,0,15334,0,4.23979e+18,282.741,2245.27,15334,161,153,14213,13033,9863,9562,8184
44403,899,2675,13456,30947,0,44403,3.52428e+13,713.399,8066.34,44403,532,475,41515,40364,36363,35727,21844
27353,28,58,26697,656,27353,0,9.61235e+13,18.7258,660.967,27353,26,27,27295,27293,26129,26245,22243
23980,2858,3040,21481,2499,14445,9535,2.02195e+18,861.227,6704.13,23980,467,328,20940,20940,20937,20937,20672
8971,1608,1895,5436,3535,5436,3535,1.89641e+18,261.155,3303.14,8971,223,313,7076,7075,6996,7023,6569
24021,102,276,0,24021,23694,327,2.63021e+16,131.765,1669.16,24021,92,97,23591,23247,20983,19791,15152
33748,1386,4637,30320,3428,20046,13702,1.96624e+18,848.681,9574.1,33748,478,437,29071,27713,18774,18034,9161
39316,270,312,0,39316,38618,698,2.62968e+16,135.737,2246.44,39316,106,123,39004,39001,38752,38485,37732
3587,66,600,0,3587,1152,2435,8.81023e+15,127.33,1217.34,3587,111,132,2713,2313,1549,1478,609
13071,566,1712,13071,0,11983,1088,1.47403e+18,518.809,3663.04,13071,254,266,11315,9752,8925,8857,7150
4577,142,147,0,4577,4512,65,2.7551e+16,65.7463,557.693,4577,51,44,4430,4430,4429,4430,4415
27128,899,2784,27128,0,24102,3026,2.68611e+18,1107.19,6750.28,27128,368,362,23593,22506,15198,13748,11370
6071,286,603,1770,4301,0,6071,3.58911e+13,204.421,1460.42,6071,172,128,5468,5280,4949,4944,4265
11174,227,395,11174,0,11174,0,4.30864e+18,224.279,1598.31,11174,140,134,10751,9824,9198,9184,8786
4076,95,1067,3717,359,2490,1586,2.00529e+18,215.909,1754.17,4076,164,158,2472,1943,1152,998,324
13698,37,48,13454,244,13698,0,1.04264e+14,15.7276,427.885,13698,23,23,13650,13650,13405,13407,12315
3502,4,24,3457,45,3502,0,1.00309e+14,11.0979,194.059,3502,16,17,3104,2856,2726,2727,1866
15200,1136,2356,13755,1445,8956,6244,1.9495e+18,357.841,4693.12,15200,327,221,12844,12800,10340,10102,7678
32479,1619,1910,10234,22245,0,32479,3.55301e+13,658.858,5750.68,32479,376,393,30569,30511,30153,30168,29029
31950,2005,2645,10197,21753,0,31950,3.42669e+13,512.764,6929.73,31950,538,378,29305,29305,28555,28534,26750
30488,1841,2110,9148,21340,0,30488,3.72433e+13,640.689,5941.04,30488,508,451,28378,28373,28268,28283,27593
9837,17,30,9635,202,9837,0,1.02009e+14,16.4175,325.294,9837,20,19,9800,9790,9264,9266,7861
3980,498,805,3980,0,3498,482,2.18002e+18,291.48,1557.51,3980,118,146,3175,3134,2485,2473,2128
46226,269,330,0,46226,45466,760,2.58046e+16,152.315,2529.25,46226,106,115,45896,45886,45628,45301,43556
15475,1430,2486,9386,6089,0,15475,4.58319e+18,519.397,5055.16,15475,321,330,12989,12773,11372,11335,9047
3682,17,24,3625,57,3682,0,1.00756e+14,11.8504,186.62,3682,16,15,3658,3655,3471,3480,3327
46790,2708,4171,46790,0,41925,4865,2.24919e+18,1368.87,10545.7,46790,550,448,42619,42101,41471,41002,35449
2688,492,518,880,1808,0,2688,3.5766e+13,176.099,1011.48,2688,139,127,2170,2155,2165,2165,2153
18287,18,249,0,18287,17836,451,2.61326e+16,135.625,1503.25,18287,82,88,16767,16009,13220,10819,6567
2749,443,570,878,1871,0,2749,3.73795e+13,112.772,1061.86,2749,105,135,2179,2170,2164,2162,1944
3348,224,309,1155,2193,0,3348,2.43371e+13,87.4421,817.122,3348,105,83,3039,3021,2725,2716,2237
22859,61,281,0,22859,22470,389,2.57667e+16,125.085,1732.62,22859,84,89,22254,21799,18364,16818,11820
45384,1362,2041,26954,18430,0,45384,4.91654e+18,1301.36,6965.52,45384,464,384,42972,40382,41089,40646,32616
18971,1544,2428,0,18971,0,18971,2.29662e+18,532.271,5400.63,18971,381,344,16543,16430,14994,14159,12595
4780,77,345,4780,0,4780,0,3.85418e+18,172.078,1044.1,4780,99,91,3645,2504,1832,1704,1314
26632,594,1549,0,26632,7548,19084,9.43374e+15,575.757,4808.05,26632,340,297,24785,23904,21752,22130,13986
11990,144,191,0,11990,11786,204,2.5674e+16,97.0569,1010.98,11990,69,74,11795,11743,11401,11321,10693
33869,810,2932,18925,14944,0,33869,4.2451e+18,1009.51,7297.29,33869,434,430,30404,29113,24953,25052,10549
29168,54,2398,25766,3402,17442,11726,2.01644e+18,1159.99,6514.57,29168,438,373,16459,11626,7027,6326,1106
39210,903,3591,0,39210,0,39210,2.31138e+18,798.067,8738.73,39210,487,544,35426,33909,21751,21037,10430
29559,60,2881,16757,12802,16757,12802,1.72777e+18,950.28,6903.03,29559,374,394,19078,13383,8841,8675,751
7869,238,465,7869,0,7869,0,4.02382e+18,225.814,1516.61,7869,119,123,7340,7001,5985,5931,5211
39888,428,804,39888,0,39888,0,4.11431e+18,346.952,3705.4,39888,228,197,39084,38839,32720,32433,31059
38933,18,324,0,38933,38057,876,2.62723e+16,146.993,2360.84,38933,103,111,36167,34788,29935,24166,14256
20501,795,2402,11775,8726,0,20501,4.82707e+18,657.787,5468.38,20501,381,395,17810,16620,14463,14074,9309
24090,1557,1877,7151,16939,0,24090,3.6087e+13,478.776,5126.96,24090,399,383,22213,22202,21973,21989,20461
17102,537,1454,10342,6760,0,17102,4.63837e+18,552.815,3945.06,17102,306,314,15165,14434,10520,10114,7519
15648,441,2902,15648,0,13903,1745,2.95608e+18,549.067,5414.96,15648,407,290,12186,10698,7457,5954,2523
41367,1361,3741,0,41367,0,41367,2.34964e+18,1311.04,9378.48,41367,511,577,36812,34600,31570,26318,17427
37378,678,743,37378,0,37378,0,4.33555e+18,350.091,3532.08,37378,208,199,36635,36629,36504,36506,36461
36256,824,3087,0,36256,0,36256,2.34247e+18,1140.81,7971.42,36256,421,519,31563,28916,22664,20821,12865
45760,2440,2728,0,45760,13974,31786,9.03856e+15,770.553,8212.22,45760,605,548,43032,43032,43009,42991,42301
1290,51,370,406,884,0,1290,3.37254e+13,60.2016,606.369,1290,89,74,865,733,495,528,249
37838,1272,3216,21803,16035,21803,16035,1.77995e+18,1026.19,8158.94,37838,475,456,34314,33299,31926,31480,19084
49879,41,80,49141,738,49879,0,9.6329e+13,22.5631,948.699,49879,28,31,49799,49792,47344,47273,38226
47586,2228,3704,0,47586,0,47586,2.08091e+18,1052.27,9415.11,47586,478,615,43882,43513,42018,40656,26441
20594,347,713,20406,188,20594,0,4.20253e+18,332.782,2717.73,20594,184,190,19812,19377,15756,15460,14736
8320,201,403,8320,0,8320,0,4.86261e+18,236.606,1469.88,8320,118,117,7722,7161,5424,5426,4929
6733,190,528,6708,25,6733,0,3.97848e+18,220.125,1474.74,6733,131,121,6069,5602,4182,4116,3264
45973,605,2062,0,45973,14566,31407,8.55165e+15,582.581,7078.37,45973,400,524,43439,41949,37599,37462,20393
26818,395,2414,16573,10245,16573,10245,1.85276e+18,683.132,5839.19,26818,338,372,22404,18397,13665,13476,6431
35911,1558,1906,11228,24683,0,35911,3.5715e+13,765.971,6047.25,35911,435,319,34005,34004,33252,33305,32554
45792,1611,3093,41113,4679,27147,18645,1.98812e+18,1450.99,8872.86,45792,492,486,42194,40119,34633,34387,30050
29293,711,1699,0,29293,9359,19934,8.12098e+15,427.948,5118.05,29293,309,274,27582,27253,23775,23667,15650
27113,65,303,0,27113,26544,569,2.64705e+16,128.533,1925.3,27113,103,107,26306,25595,21971,20438,14611
46536,1702,1745,14252,32284,0,46536,3.60255e+13,709.595,6293.69,46536,362,415,44791,44791,44769,44767,44260
35901,314,643,35901,0,35901,0,4.13282e+18,347.146,3355.08,35901,216,204,35091,34421,27597,27173,22775
24724,213,2947,24724,0,22282,2442,2.36059e+18,951.012,6718.99,24724,422,355,17501,13701,6880,4763,1966
622,58,324,380,242,380,242,1.8901e+18,27.127,406.448,622,87,51,298,226,201,170,151
35134,2653,2819,21204,13930,21204,13930,1.86917e+18,1051.05,7430.3,35134,463,505,32315,32313,32212,32255,31978
6553,386,458,6553,0,6543,10,4.2211e+18,198.12,1376.79,6553,125,104,6095,6087,5881,5905,5744
37521,2222,2400,20659,16862,20659,16862,1.5484e+18,1101.38,6656.59,37521,346,422,35121,34268,35021,35057,33936
12755,132,1681,0,12755,0,12755,2.19453e+18,499.087,3723.04,12755,292,337,9355,8020,4524,4659,1902
1935,1694,1935,1935,0,1935,0,1.75831e+13,0,1935,1935,1935,1,0,0,0,0,0
39297,2718,3555,23732,15565,0,39297,4.94525e+18,941.994,8767.57,39297,542,461,35742,35662,35370,35362,32162
30534,1756,2634,18227,12307,0,30534,4.87335e+18,882.786,6877.48,30534,469,370,27900,27606,26615,26476,22964
28017,1346,2922,28017,0,24762,3255,1.37727e+18,1058.93,7054.11,28017,423,466,24870,23882,21991,22380,16553
37017,59,76,36173,844,37017,0,1.03254e+14,17.3823,781.212,37017,27,30,36941,36941,36406,36402,35683
14833,695,703,14833,0,14833,0,4.54574e+18,314.162,2341.65,14833,154,161,14130,14130,14125,14125,14124
47764,2669,3487,28664,19100,0,47764,4.84116e+18,1163.01,9494.36,47764,514,638,44277,43948,42814,42480,40577
22273,148,245,0,22273,21785,488,2.65837e+16,126.75,1467.82,22273,82,90,22016,21915,20526,20188,17809
31220,233,258,0,31220,30633,587,2.52895e+16,138.097,1850.26,31220,99,106,30962,30960,30904,30723,30516
42287,1,84,41446,841,42287,0,1.06202e+14,20.9811,828.378,42287,29,32,16631,16631,16631,16631,16631
2547,25,845,1536,1011,0,2547,4.83575e+18,119.663,1270.18,2547,126,163,1209,715,599,528,192
49112,1189,3933,29038,20074,0,49112,4.68315e+18,1350.31,10472.8,49112,612,714,44406,43029,38905,38707,13727
28503,531,1750,8280,20223,0,28503,3.61584e+13,706.202,5277.11,28503,432,362,25570,23574,17938,16193,9848
15726,403,2165,9386,6340,0,15726,5.02143e+18,509.835,4516.3,15726,284,327,13106,12052,11225,10853,2872
21589,94,2237,0,21589,0,21589,2.22568e+18,543.529,5344.25,21589,387,336,14638,10906,8440,5525,1338
20633,684,2572,12399,8234,12399,8234,1.88558e+18,529.258,5580.03,20633,331,415,17929,17170,15106,14276,7009
11346,116,185,0,11346,11112,234,2.62294e+16,76.6858,973.731,11346,59,75,11161,11141,10582,10523,9092
40024,1381,4747,35757,4267,23880,16144,1.95902e+18,913.749,10725.6,40024,465,470,35277,34151,21992,21556,13633
21290,1465,1866,0,21290,0,21290,2.43724e+18,881.666,4819.63,21290,337,317,19424,19209,18498,17411,17994
49687,87,112,48903,784,49651,36,1.00259e+14,23.596,1049.95,49687,32,34,49575,49575,48534,48546,45228
1022,64,86,0,1022,1009,13,2.24211e+16,14.8679,197.013,1022,23,30,936,936,902,912,804
2142,195,286,2142,0,2142,0,4.55544e+18,133.239,685.583,2142,75,68,1856,1776,1698,1698,1572
23620,2043,2753,20918,2702,13925,9695,1.96055e+18,700.761,6355.18,23620,364,357,20867,20838,20391,20532,16401
8874,569,1104,5485,3389,5485,3389,1.80484e+18,478.196,2528.29,8874,249,197,7686,6836,6912,6448,4562
13476,440,1141,3928,9548,0,13476,3.64447e+13,299.436,3028.62,13476,278,275,12335,11981,10045,10006,6165
21260,860,3295,21260,0,19263,1997,2.54316e+18,937.614,6534.8,21260,413,438,17313,15676,13728,13731,7933
24344,1442,3499,24344,0,21762,2582,2.1972e+18,735.062,7249.6,24344,401,473,20845,20016,15170,14573,11496
17664,826,3036,16064,1600,10584,7080,2.00649e+18,543.741,5826.83,17664,357,327,14628,13824,11141,10844,8406
26465,295,2262,7837,18628,0,26465,3.60437e+13,527.23,5997.47,26465,349,461,22933,20789,15454,15173,4102
22787,1422,2864,0,22787,0,22787,2.29531e+18,706.259,6129.91,22787,350,396,19923,18982,18566,17922,13872
47339,1377,3390,42097,5242,27804,19535,1.95511e+18,1350.23,9534.46,47339,522,432,43446,41468,31133,27982,22422
18563,155,1896,11209,7354,0,18563,4.63327e+18,535.348,4705.72,18563,287,290,13855,11403,7154,6197,2400
45023,1994,2565,45023,0,39959,5064,2.7085e+18,1184.3,7902.95,45023,469,375,42458,42304,42221,42097,39190
13462,332,438,13378,84,13462,0,3.89304e+18,269.243,1903.55,13462,143,146,13024,12943,12442,12470,11470
6387,42,988,1735,4652,0,6387,4.04607e+13,196.513,1987.31,6387,196,164,4549,3821,2575,2538,685
13680,820,1540,3901,9779,0,13680,3.29638e+13,284.471,3455.67,13680,258,204,12140,11931,11290,11339,8020
44961,1430,1937,13296,31665,0,44961,3.67777e+13,830.471,6481.58,44961,567,356,43024,42869,42136,42183,39563
1819,264,518,998,821,998,821,2.11314e+18,101.023,816.738,1819,103,101,1301,1227,1219,1178,721
42957,69,73,42099,858,42957,0,1.00699e+14,20.0467,808.745,42957,29,29,42884,42884,42692,42692,42450
4563,410,582,2710,1853,0,4563,4.592e+18,291.468,1336.09,4563,164,122,3981,3865,3812,3728,3535
33475,748,2751,33475,0,29514,3961,2.25169e+18,907.816,7246.98,33475,435,471,30199,28718,22592,21241,12738
12242,379,766,0,12242,11477,765,0.0624898,0.937429,3061.61,12242,766,1,11476,11476,11476,11476,11476
41489,1526,4072,24370,17119,24370,17119,1.76179e+18,1060.04,9965.57,41489,541,487,37417,36226,31235,30513,21426
19444,223,1730,11345,8099,11345,8099,1.80748e+18,531.664,4607.59,19444,246,348,15532,13069,10247,9057,4098
28775,13,34,28221,554,28775,0,9.72326e+13,20.6679,537.026,28775,22,21,28667,28594,25820,25683,18849
41063,85,309,0,41063,40436,627,2.64081e+16,145.349,2285.15,41063,118,118,40351,39650,34948,32148,24433
3600,727,991,3600,0,3151,449,2.58577e+18,159.364,1577.39,3600,204,80,2609,2590,2601,2558,2218
10943,26,211,0,10943,10772,171,2.54569e+16,74.8298,1083.57,10943,65,68,10314,9961,8358,7620,4652
20095,1661,1714,18155,1940,12160,7935,1.97753e+18,966.201,4671.97,20095,323,298,18381,18381,18362,18372,18281
48233,215,4383,48233,0,43206,5027,2.86646e+18,1261.52,10751,48233,473,451,34499,28303,17071,11472,2408
1536,247,454,839,697,0,1536,3.798e+18,97.5326,741.031,1536,116,71,1082,1075,912,951,615
17845,92,693,17832,13,17845,0,4.19251e+18,285.345,2438.05,17845,174,161,14414,11188,7924,6811,4153
38727,185,308,0,38727,38046,681,2.58669e+16,132.304,2304.81,38727,99,111,38419,38342,36162,36428,31431
48524,1448,2731,0,48524,15442,33082,8.70648e+15,836.19,8382.48,48524,449,422,45793,45265,43329,43331,32119
40122,197,391,0,40122,39284,838,2.63073e+16,142.991,2782.54,40122,109,123,39731,39653,36715,34591,28722
34857,8,46,34398,459,34839,18,9.9817e+13,20.9551,720.341,34857,26,26,34302,34044,29550,28882,19533
1527,19,268,1527,0,1365,162,1.13263e+18,111.684,556.255,1527,65,67,485,35,128,133,147
34733,1600,3653,31103,3630,20909,13824,1.89019e+18,1099.16,8788.18,34733,534,483,30892,29648,25113,24578,18872
46180,1208,3599,27749,18431,27749,18431,1.86603e+18,934.614,9368.5,46180,426,492,42217,40887,39527,38834,20268
46983,2483,2701,0,46983,13834,33149,9.43804e+15,814.241,8105.6,46983,441,508,44282,44264,44231,44196,43524
16953,280,676,16953,0,16953,0,4.03396e+18,283.475,2391.37,16953,170,159,16192,15624,12510,12303,11109
7100,695,1398,7100,0,6400,700,2.69658e+18,461.278,2605.44,7100,228,240,5583,5030,4088,4069,4315
41629,55,64,40603,1026,41629,0,9.99624e+13,17.5072,754.612,41629,26,28,41565,41565,41319,41319,40713
36289,220,340,0,36289,35649,640,2.63776e+16,155.715,2427.9,36289,110,113,35949,35878,34022,33423,29388
32574,3022,3722,0,32574,0,32574,2.39544e+18,872.285,8309.21,32574,401,472,28852,28809,28611,28766,26603
27956,132,258,0,27956,27418,538,2.626e+16,141.303,1853.33,27956,99,116,27618,27435,25176,23832,20333
36128,7,53,35467,661,36111,17,9.63755e+13,18.4489,720.432,36128,26,25,35343,34982,30633,30241,19595
42509,144,2212,0,42509,12837,29672,9.16681e+15,634.858,6928.58,42509,430,367,34563,29830,21785,19331,6199
21978,456,1598,6432,15546,0,21978,3.49658e+13,440.052,4346.23,21978,349,296,20079,19363,17751,17792,8928
28053,298,881,28053,0,28053,0,4.1418e+18,340.428,3265.29,28053,205,195,27003,26184,18764,18342,14003
36833,1461,3491,36833,0,32298,4535,1.7188e+18,912.055,8406.44,36833,424,466,33319,32073,27438,25771,20680
25743,332,741,25735,8,25743,0,4.59013e+18,345.089,2976.99,25743,192,190,24913,24398,18059,17295,19099
29916,803,867,29916,0,29916,0,3.9529e+18,358.395,3349.25,29916,202,201,29049,29033,29007,29007,28768
5332,261,393,5326,6,5332,0,3.81686e+18,181.285,1171.67,5332,107,96,4939,4819,4588,4560,3930
42757,1701,2755,12876,29881,0,42757,3.62831e+13,795.177,7751.65,42757,547,428,40002,39730,37584,37744,33184
33358,240,289,0,33358,32691,667,2.71291e+16,136.553,2016.08,33358,98,109,33069,33066,32676,32534,31709
16138,1029,2182,16138,0,14494,1644,2.64349e+18,516.328,4548.57,16138,308,262,13956,13833,13071,12855,10519
31430,1630,3427,28588,2842,18911,12519,1.91159e+18,1415.19,8318.27,31430,443,535,27595,25061,21323,21348,16979
2990,213,226,0,2990,983,2007,5.54245e+15,100.911,675.63,2990,87,74,2764,2764,2759,2763,2744
32440,274,287,0,32440,31884,556,2.61887e+16,126.165,1929.08,32440,97,95,32153,32153,32117,32106,31892
27873,57,62,27281,592,27861,12,9.82282e+13,17.1863,654.55,27873,27,25,27811,27811,27793,27793,27693
9639,32,38,9465,174,9639,0,1.05506e+14,17.2912,332.823,9639,21,21,9601,9599,9333,9333,9278
48067,246,350,0,48067,46994,1073,2.68191e+16,153.772,2763.54,48067,115,131,47717,47702,45776,45489,41039
43152,14,66,42449,703,43152,0,9.98002e+13,21.5149,749.798,43152,29,27,42982,42883,38305,37975,26839
38952,2845,4326,38952,0,34348,4604,1.20271e+18,1064.02,10228.8,38952,503,542,34626,34519,33722,33834,29236
37301,973,3781,33528,3773,22275,15026,1.96207e+18,867.747,8864.21,37301,416,536,32843,30614,21103,20455,7775
44974,4359,4515,44974,0,40541,4433,1.92842e+18,1147.24,10915.3,44974,458,565,40459,40451,40441,40437,40219
31661,14630,31661,0,31661,0,31661,1048540,0,31661,31661,31661,1,0,0,0,0,0
47736,28,84,47000,736,47736,0,1.01166e+14,18.8308,867.023,47736,28,29,47652,47645,43853,43413,28553
44212,56,93,43451,761,44193,19,1.01017e+14,17.6852,848.394,44212,28,30,44119,44117,42463,42485,34148
38089,1606,2455,12363,25726,0,38089,3.44994e+13,764.781,7198.59,38089,482,568,35634,35351,34535,34579,29654
39063,873,2943,23416,15647,0,39063,4.90651e+18,812.534,7973.7,39063,450,397,35810,34600,31018,30005,19202
21936,160,211,0,21936,21532,404,2.67556e+16,116.589,1399.82,21936,91,96,21725,21691,21062,21041,20285
25334,1564,2779,15385,9949,0,25334,4.90451e+18,709.869,6451.17,25334,353,462,22555,22457,21163,20876,16548
22009,688,2254,0,22009,0,22009,2.51127e+18,648.57,5293.51,22009,340,366,19539,17970,14881,11524,11159
11892,734,1851,10444,1448,7097,4795,1.93027e+18,626.77,3870.44,11892,218,315,9870,8915,7739,7519,4551
29809,1365,2305,16635,13174,0,29809,4.0465e+18,917.253,5973.75,29809,344,389,27454,27077,26027,25457,14145
24835,1035,2016,0,24835,7439,17396,9.3234e+15,441.103,5479.11,24835,364,429,22819,22633,21635,21631,16618
34302,26,38,34018,284,34302,0,1.01736e+14,22.1499,602.527,34302,24,24,34260,34253,33300,33302,29826
9541,856,1521,5636,3905,0,9541,4.81331e+18,386.102,3119.45,9541,201,257,8020,8001,7622,7589,6264
19774,72,241,0,19774,19228,546,2.60441e+16,135.548,1450.86,19774,88,87,19287,18982,16636,15562,11204
36375,58,273,0,36375,35788,587,2.47542e+16,140.678,1963.15,36375,98,113,35345,34469,29414,27108,18369
33899,2545,3146,0,33899,0,33899,2.41286e+18,831.208,7579.51,33899,524,396,30753,30728,30488,29833,29162
46421,720,3065,27543,18878,27543,18878,1.81963e+18,909.201,8535.22,46421,549,429,41274,37399,29730,29522,18674
15512,576,688,15482,30,15512,0,4.11966e+18,319.171,2366.49,15512,164,167,14824,14805,14395,14358,14231
22244,474,636,22244,0,22244,0,4.45719e+18,321.76,2692.4,22244,172,182,21608,21585,19824,19956,19631
8339,777,866,2571,5768,0,8339,3.1565e+13,217.296,2073.25,8339,147,207,7473,7473,7473,7473,7238
33099,49,2063,9688,23411,0,33099,3.69064e+13,575.892,5957.58,33099,375,462,23283,19124,14521,4676,3064
8247,20,972,0,8247,2723,5524,8.53803e+15,179.222,2231.2,8247,151,201,4728,3167,2636,2660,538
7546,422,1505,4603,2943,0,7546,4.71861e+18,373.028,2795.37,7546,254,232,5752,5132,3689,3509,2298
5912,1479,5912,5912,0,5912,0,1.75892e+13,0,5912,5912,5912,1,0,0,0,0,0
28063,239,311,0,28063,27669,394,2.65014e+16,117.192,1955.47,28063,104,105,27752,27749,27420,27378,25942
25673,685,2468,15287,10386,15287,10386,1.86839e+18,929.67,6071.24,25673,434,424,22482,21033,18804,18263,9010
10657,851,1498,6449,4208,6449,4208,1.89049e+18,581.172,3164.73,10657,307,212,9035,8310,8116,7947,6754
18281,1297,2576,16224,2057,10993,7288,1.956e+18,818.768,5495.11,18281,323,416,15705,14744,13826,13857,8626
6232,772,1036,3488,2744,0,6232,4.423e+18,189.618,1983.65,6232,163,165,5196,5124,5139,5154,4659
10912,155,180,0,10912,10708,204,2.62425e+16,109.361,1038.32,10912,78,78,10732,10712,10590,10497,10134
43175,27,263,0,43175,42455,720,2.54985e+16,146.583,2274.05,43175,110,107,40905,39689,33508,28788,17592
34397,1785,2427,0,34397,0,34397,2.46635e+18,1126.91,6850.88,34397,503,349,31970,31631,30075,29806,27189
34835,497,1845,0,34835,9668,25167,9.553e+15,760.721,5826.14,34835,431,318,31918,30423,24831,25126,13404
10841,305,513,10841,0,10841,0,4.92964e+18,282.652,1807.73,10841,130,144,10291,10051,7856,7747,7368
8516,348,1255,4705,3811,4705,3811,1.63681e+18,219.526,2581.85,8516,171,195,7261,6891,6330,5767,3255
46240,104,3510,41741,4499,28276,17964,1.93835e+18,1248.31,9480.39,46240,481,498,28931,22368,14249,11168,2715
26318,1258,2354,0,26318,0,26318,2.0489e+18,625.968,5620.59,26318,310,321,23964,23411,22879,21466,16944
43269,442,2952,24220,19049,24220,19049,1.62e+18,763.614,8052.32,43269,366,491,38651,36034,33321,28854,14357
11904,763,1208,11904,0,10771,1133,2.05562e+18,304.588,2720.36,11904,216,214,10696,10429,9548,9627,7946
49631,1624,3943,0,49631,0,49631,2.19555e+18,1158.89,10450.5,49631,489,500,45437,43298,39045,37947,25550
18546,795,2185,0,18546,0,18546,2.2396e+18,350.334,4734.72,18546,234,314,16361,16054,14826,14776,6403
15911,284,1818,8670,7241,0,15911,4.09682e+18,379.523,4039.82,15911,297,369,13734,12775,6560,7047,3218
41435,1131,3758,24705,16730,0,41435,4.77851e+18,805.498,9239.28,41435,508,404,37552,36194,25714,24771,14221
34438,1501,2295,20138,14300,20138,14300,1.78591e+18,944.336,6504.31,34438,410,377,32143,31537,31175,31201,24996
44137,75,80,43426,711,44137,0,1.02197e+14,20.8573,878.107,44137,34,30,44057,44057,43937,43948,43729
22688,423,2702,13294,9394,0,22688,4.786e+18,817.162,6234.62,22688,316,514,18460,16394,12163,10131,5170
5846,599,919,1575,4271,0,5846,3.97752e+13,170.194,1827.5,5846,218,162,4927,4920,4885,4885,3860
10374,925,1209,3254,7120,0,10374,3.374e+13,339.622,2846.41,10374,230,225,9165,9102,9015,9000,7917
41120,1253,2286,13143,27977,0,41120,3.39344e+13,752.837,7060.76,41120,467,483,38834,38383,34369,34416,27758
3494,156,910,2026,1468,2026,1468,1.88916e+18,137.276,1521.35,3494,115,157,2509,2202,2018,1817,678
8678,91,1966,7512,1166,5138,3540,1.95444e+18,443.924,3532.62,8678,257,227,4988,3407,2008,1832,596
44683,94,1077,44683,0,44683,0,4.16288e+18,397.864,4301.63,44683,228,240,36616,28226,19416,17622,7716
7305,374,431,7305,0,7305,0,4.08534e+18,205.503,1407.05,7305,117,120,6874,6864,6758,6757,6448
20267,623,2479,12392,7875,0,20267,4.63727e+18,648.48,5683.2,20267,432,464,17314,16451,13344,12983,7322
43199,257,950,43174,25,43199,0,4.36553e+18,350.897,4054.2,43199,227,222,41623,39832,24906,24347,18849
13889,6,28,13762,127,13889,0,9.94051e+13,13.2693,359.84,13889,19,18,13499,13163,11906,11766,8992
42893,772,2686,25180,17713,25180,17713,1.75683e+18,839.993,7666.66,42893,379,489,39853,38744,36409,33608,12050
1122,215,272,342,780,0,1122,3.36379e+13,59.2335,475.2,1122,73,62,850,850,850,850,777
12355,139,209,0,12355,12149,206,2.5767e+16,84.3951,1101.78,12355,64,69,12146,12109,11267,11380,9900
32129,2216,3548,18103,14026,0,32129,4.58459e+18,984.417,7924.4,32129,401,459,28581,27785,27508,27186,23924
14702,25,41,14430,272,14702,0,9.77182e+13,17.8885,428.22,14702,21,21,14661,14656,14175,14176,12881
26818,1064,3187,23774,3044,15941,10877,1.94633e+18,867.401,7287.91,26818,463,345,23498,22288,18431,17170,9792
15822,1664,2779,15822,0,14354,1468,1.75189e+18,331.432,5063.42,15822,305,367,13043,13005,11889,11022,7145
4169,20,320,4169,0,4169,0,4.44037e+18,186.6,955.567,4169,99,91,2200,1152,868,798,392
35922,706,1832,0,35922,11230,24692,9.24479e+15,726.764,5983.5,35922,380,478,33359,31321,28840,28869,16327
19612,111,264,0,19612,19243,369,2.51203e+16,115.685,1587.04,19612,91,90,19304,19140,17622,17212,13461
43483,445,1144,43483,0,43458,25,4.24587e+18,370.941,4239.77,43483,225,234,42339,41961,31356,30446,29216
20873,2123,2580,0,20873,0,20873,2.30398e+18,480.2,5677.69,20873,295,360,18293,18248,18127,18229,16239
19522,1686,2748,11105,8417,11105,8417,1.69999e+18,498.213,5552.59,19522,309,443,16774,16543,16235,16411,13993
12556,1842,2498,11297,1259,7464,5092,1.99773e+18,467.531,4475.96,12556,275,237,10058,9925,9846,9889,8636
38499,1038,2875,0,38499,0,38499,2.39235e+18,1057.44,7596.1,38499,405,384,34991,33908,27109,26088,18478
47017,1014,4319,47017,0,42444,4573,1.65447e+18,1170.44,10549.5,47017,585,589,41480,37481,27185,24893,16878
16941,1590,1845,9990,6951,9990,6951,1.90284e+18,857.533,4433.93,16941,371,365,15096,14754,14901,14927,14488
19161,12,260,0,19161,18745,416,2.52904e+16,109.441,1620.06,19161,86,84,17099,15870,13758,10395,6917
3044,225,588,806,2238,0,3044,4.05959e+13,132.093,1058.88,3044,141,92,2456,2264,2270,2271,1466
30873,785,1783,9161,21712,0,30873,3.52074e+13,447.519,5330.88,30873,328,310,29090,28631,27719,27801,17671
5503,19,251,5503,0,5503,0,3.38426e+18,129.196,932.995,5503,101,101,2382,633,1029,855,480
29910,459,698,29904,6,29910,0,4.18933e+18,330.395,3169.47,29910,204,197,29212,29083,27245,27193,25853
35847,67,832,35823,24,35847,0,4.11296e+18,355.861,3595.95,35847,216,212,27130,19400,14413,12352,4983
44580,1715,3633,26764,17816,26764,17816,1.91098e+18,976.462,9152.03,44580,454,593,40947,40354,37934,37336,24247
33685,2117,2921,0,33685,0,33685,2.41369e+18,996.322,7235.87,33685,395,473,30764,30246,29935,29803,26830
1077,178,311,550,527,0,1077,4.11131e+18,67.0121,513.293,1077,70,58,766,764,762,761,674
40576,1986,3120,24594,15982,0,40576,4.89034e+18,994.755,8249.62,40576,546,369,37456,37275,35802,35171,31905
40005,1773,1827,12390,27615,0,40005,3.24589e+13,867.663,6004.91,40005,310,484,38178,38178,38169,38170,37946
17818,279,535,17818,0,17818,0,4.46972e+18,282.659,2306.13,17818,155,158,17194,16794,13427,13055,11624
15075,57,246,0,15075,14710,365,2.60794e+16,103.636,1292.31,15075,80,89,14546,14078,12399,11432,7449
19884,539,671,19884,0,19884,0,4.32441e+18,306.821,2618.88,19884,171,162,19213,19196,18239,18206,17452
17421,1593,3471,15520,1901,10334,7087,1.91321e+18,372.846,6348.06,17421,262,534,13950,13876,12710,12827,7459
47355,524,1872,14784,32571,0,47355,3.19181e+13,980.656,6750.56,47355,380,480,44295,42687,37817,38113,13236
1679,429,433,0,1679,0,1679,2.22017e+18,166.135,747.681,1679,97,86,1246,1246,1246,1245,1246
26639,41,56,26146,493,26639,0,1.01109e+14,17.6807,627.533,26639,26,27,26583,26583,25748,25750,23530
8756,904,1024,0,8756,2480,6276,9.02452e+15,285.461,2304.14,8756,224,181,7732,7732,7684,7689,7377
699,201,251,205,494,0,699,3.00021e+13,28.8941,372.674,699,63,54,448,448,445,445,409
7533,7,150,0,7533,7332,201,2.59898e+16,79.4606,704.429,7533,59,65,6318,5567,5114,4168,2532
46929,154,352,0,46929,45928,1001,2.6777e+16,141.669,2636.49,46929,109,134,46557,46417,42220,39325,31558
2744,19,20,2702,42,2744,0,8.88331e+13,10.4122,155.755,2744,15,15,2724,2724,2714,2714,2719
27450,1172,2427,16327,11123,16327,11123,1.85032e+18,1047.91,6340.19,27450,364,389,24467,23574,23079,22466,13940
40837,40,66,40132,705,40837,0,1.02563e+14,20.8313,762.683,40837,28,29,40771,40769,39375,39378,34688
1432,448,493,896,536,0,1432,4.15049e+18,79.2116,722.141,1432,103,57,939,933,939,939,919
35582,87,278,0,35582,35019,563,2.59397e+16,119.847,2010.09,35582,94,105,35124,34670,30992,28618,21557
47707,1267,5020,47707,0,42492,5215,2.74716e+18,1244.93,11502.9,47707,485,609,41917,38833,35964,34168,16866
47035,2401,3765,0,47035,0,47035,2.34091e+18,677.023,9440.02,47035,444,406,43270,43153,42632,42596,36703
24050,40,1838,0,24050,7439,16611,8.87093e+15,548.549,4920.92,24050,288,336,16580,12504,9769,9396,1566
29131,1073,2750,0,29131,0,29131,2.38027e+18,976.958,6930.79,29131,423,404,25788,24265,21461,15765,14732
30258,2895,3150,26769,3489,18094,12164,1.96905e+18,971.087,7457.48,30258,400,411,27108,27101,27092,27082,26421
4440,615,756,1390,3050,0,4440,3.68478e+13,151.915,1558.49,4440,136,181,3684,3684,3673,3673,3365
21301,104,270,0,21301,20845,456,2.69375e+16,115.885,1594.42,21301,89,93,20964,20730,19056,17733,13757
10765,149,194,0,10765,10481,284,2.69623e+16,93.2941,981.787,10765,67,66,10571,10541,10232,10171,9597
31685,24,42,30942,743,31685,0,9.68219e+13,18.6931,599.762,31685,22,25,31643,31638,30216,30167,27749
42180,1011,2340,12869,29311,0,42180,3.36852e+13,609.801,7032.58,42180,463,380,39840,39177,36384,36626,25632
30607,64,299,0,30607,29927,680,2.67777e+16,139.27,2032.94,30607,101,102,29804,29166,24739,23045,15775
13582,469,1477,7539,6043,7539,6043,1.47975e+18,302.826,3475.73,13582,185,285,12105,11732,11262,10938,6305
24611,168,256,0,24611,24162,449,2.6263e+16,120.725,1739.1,24611,94,102,24355,24331,23353,23341,20544
36419,360,2189,0,36419,10882,25537,9.15108e+15,569.084,6567.45,36419,374,420,33381,31818,25061,24987,10663
32012,365,3297,17864,14148,17864,14148,1.61188e+18,747.583,7406.64,32012,419,399,27324,25477,12064,13156,3223
15807,613,2350,15807,0,13971,1836,2.08445e+18,477.007,4557.71,15807,282,366,13329,12473,8907,8006,8303
39797,1596,3997,0,39797,0,39797,2.18952e+18,697.813,9463.44,39797,503,481,35800,35434,31391,28945,21421
33170,912,1695,0,33170,9885,23285,9.15996e+15,726.245,5506.86,33170,450,383,31420,30792,28604,28947,21215
48376,318,987,48376,0,48376,0,4.0906e+18,390.174,4297.69,48376,228,237,47023,45888,32068,30458,25757
3251,37,84,0,3251,3221,30,2.48467e+16,26.6709,344.798,3251,36,34,3167,3148,3093,3085,2919
17394,119,1979,17394,0,15142,2252,1.96254e+18,888.586,4792.67,17394,289,347,10785,8179,5917,3960,1335
34883,151,768,34858,25,34883,0,4.31459e+18,326.964,3439.96,34883,211,211,31556,27202,17837,16928,12123
33621,176,2051,10610,23011,0,33621,3.5059e+13,625.329,5874.05,33621,346,328,28272,24700,16296,10517,6316
14249,280,654,14249,0,14249,0,4.22943e+18,284.928,2197.67,14249,165,160,13541,13204,10337,10051,9038
23926,165,242,0,23926,23507,419,2.59608e+16,113.828,1472.47,23926,81,89,23684,23623,22817,22969,20301
49246,598,3418,49246,0,43973,5273,1.35366e+18,1872.4,9949.9,49246,572,495,40880,36589,21582,16840,10181
27831,1437,3972,16660,11171,16660,11171,1.88938e+18,749.057,8162.29,27831,439,693,23859,22914,21295,21168,8710
43996,2855,3176,26406,17590,26406,17590,1.91828e+18,1012.14,8438.91,43996,557,464,40820,40794,40744,40755,40287
30730,2996,4233,30705,25,27918,2812,2.31958e+18,794.721,8735.71,30730,546,388,26497,26474,26271,26312,23919
46415,83,2890,13973,32442,0,46415,3.64161e+13,731.057,8689.28,46415,510,581,35246,30326,21663,8294,4226
15732,510,637,15732,0,15732,0,4.31957e+18,281.525,2299.8,15732,167,158,15095,15085,14744,14748,14657
30696,785,2506,30696,0,27950,2746,1.486e+18,721.433,6368.82,30696,472,338,27586,25647,23004,22024,15409
34180,2212,3058,20714,13466,20714,13466,1.80778e+18,1189.42,7807.55,34180,506,459,31122,30672,30378,30630,27365
32714,1086,3096,19613,13101,0,32714,4.66883e+18,1153.62,7670.72,32714,522,514,28893,27083,19425,18567,13481
10844,976,1685,9787,1057,6484,4360,1.99961e+18,809.865,3545.88,10844,248,300,8904,8147,7695,7785,6486
9995,270,957,0,9995,3223,6772,9.02385e+15,353.528,2470.29,9995,201,233,8714,7939,7348,7444,3866
36761,797,955,36749,12,36761,0,4.11794e+18,369.416,3759.25,36761,217,217,35806,35795,35132,35097,34830
29591,1019,2663,17915,11676,17915,11676,1.83216e+18,596.67,6685.17,29591,386,439,26928,26606,25335,24331,11746
17749,17,48,17382,367,17749,0,9.66428e+13,15.0398,475.693,17749,23,21,17700,17691,16102,16010,11488
34710,983,1828,10879,23831,0,34710,3.53403e+13,559.438,5821.48,34710,372,371,32882,32727,31442,31471,19783
1540,310,679,1540,0,1364,176,2.76037e+18,85.8565,931.072,1540,92,88,861,791,593,579,542
29064,678,3704,25671,3393,17362,11702,2.00049e+18,818.435,8167.33,29064,369,560,23704,20315,17345,16968,8375
32791,75,286,0,32791,32123,668,2.59369e+16,142.654,2076.58,32791,102,105,32018,31325,27291,25069,16788
10909,462,575,10909,0,10909,0,4.49963e+18,250.419,1869.04,10909,131,133,10334,10327,9890,9912,9526
9727,9,178,0,9727,9538,189,2.50613e+16,79.5296,849.791,9727,60,68,8574,7907,6867,5840,3549
20581,321,1580,0,20581,6087,14494,9.0585e+15,359.643,4294.51,20581,273,298,18528,16696,13837,14238,5469
10372,118,1098,2910,7462,0,10372,3.46171e+13,232.848,2628.17,10372,214,220,8705,7491,5994,5813,1660
9696,809,1164,0,9696,0,9696,2.36667e+18,427.253,2730.47,9696,194,216,8532,8485,8402,8420,7551
44406,2190,3140,26529,17877,0,44406,4.84978e+18,871.01,8533.47,44406,454,490,41266,41126,40405,40355,35447
46015,3123,4096,46015,0,46015,0,8.91109e+15,3731.4,13726.3,46015,4096,12,32189,0,22536,32180,32189
39680,2176,3780,23431,16249,23431,16249,1.8163e+18,1231.46,9283.04,39680,483,498,35900,34975,33575,33349,23747
33672,2525,3562,30131,3541,19050,14622,1.8667e+18,715.595,8282.09,33672,388,557,30110,30061,29432,29601,20398
46112,181,2680,0,46112,14909,31203,8.92323e+15,575.931,8107.37,46112,568,442,39444,34760,21502,20435,7488
25004,49,51,24490,514,25004,0,1.02598e+14,15.6324,548.604,25004,23,23,24953,24953,24866,24865,24759
10635,422,1673,9497,1138,6264,4371,1.94893e+18,369.079,3336.37,10635,240,232,8820,7030,6609,5824,1979
9201,83,962,0,9201,2751,6450,9.11874e+15,229.227,2331.91,9201,182,196,7062,6002,4355,4357,1874
31528,33,58,31155,373,31528,0,1.00429e+14,18.753,650.637,31528,25,26,31470,31468,30328,30333,25814
42190,229,3637,25140,17050,25140,17050,1.79354e+18,1109.04,9309.49,42190,501,592,32303,27177,17695,14215,4547
34461,50,287,0,34461,33924,537,2.52843e+16,134.467,2003.71,34461,101,119,33284,32366,27449,25095,16578
31292,588,640,31292,0,31292,0,4.14498e+18,316.012,3168.54,31292,199,189,30652,30652,30491,30515,30343
21119,2872,3209,19015,2104,12974,8145,1.88434e+18,591,6496.19,21119,339,490,17910,17893,17798,17852,17494
49713,1399,2132,15532,34181,0,49713,3.41839e+13,860.863,7246.56,49713,508,462,47581,47130,45271,45345,40807
3310,402,1011,3310,0,2952,358,2.19091e+18,288.492,1610.93,3310,165,157,2241,1806,1625,1558,1133
4490,331,674,0,4490,1398,3092,8.73932e+15,200.68,1431.44,4490,190,131,3816,3411,2942,2926,1753
35361,2474,3181,21688,13673,0,35361,4.89134e+18,867.099,8215.97,35361,487,526,32180,32174,31576,31490,27706
17398,17,52,17065,333,17373,25,1.05323e+14,18.8055,495.67,17398,25,25,17328,17285,15637,15591,10923
9667,173,186,0,9667,9533,134,2.49709e+16,74.6613,934.554,9667,60,64,9481,9481,9474,9467,9214
6942,21,166,0,6942,6785,157,2.68945e+16,82.3663,754.597,6942,61,69,6370,6071,5146,4388,2739
28914,137,3523,28914,0,25898,3016,2.34595e+18,800.822,7865.3,28914,398,500,18888,14771,6785,4468,1923
43939,56,265,0,43939,43121,818,2.62113e+16,152.613,2187.77,43939,101,118,43006,42416,36395,32117,22618
33004,2976,3275,19948,13056,0,33004,4.9331e+18,849.119,7809.27,33004,423,449,29729,29729,29622,29598,28452
40804,386,2036,12594,28210,0,40804,3.53304e+13,622.164,6577.95,40804,480,329,37294,35324,22913,17881,14169
6345,711,839,1993,4352,0,6345,3.18543e+13,167.555,1877.02,6345,126,185,5506,5502,5496,5496,5173
6325,939,1185,0,6325,0,6325,2.48393e+18,236.525,2210.25,6325,205,169,5140,5138,4886,4420,4311
45862,3137,3894,27866,17996,0,45862,4.75491e+18,977.804,9509.84,45862,529,435,41968,41962,41626,41584,37703
40136,2217,3514,24367,15769,0,40136,4.93222e+18,808.465,8325.98,40136,421,529,36622,36557,35777,35744,29045
9231,35,36,9011,220,9231,0,1.00046e+14,16.0523,330.022,9231,18,21,9195,9194,8959,8959,9178
9719,289,498,9713,6,9719,0,4.07789e+18,242.938,1692.91,9719,128,127,9192,8987,8045,8012,6998
26826,1990,2137,0,26826,0,26826,2.43523e+18,1043.97,5821.63,26826,398,366,24689,24655,24559,24385,23947
31231,3786,3891,27951,3280,19108,12123,1.95732e+18,1041.86,8498.02,31231,532,513,27340,27340,27339,27340,27156
13577,1816,1831,0,13577,0,13577,2.01087e+18,328.31,3650.55,13577,258,272,11746,11746,11746,11746,11746
6381,1130,1242,3863,2518,0,6381,5.08066e+18,223.077,2291.45,6381,159,202,5139,5138,5123,5131,4638
40969,3685,4407,37005,3964,24532,16437,1.96319e+18,1202.15,10006.1,40969,513,488,36562,36534,36473,36482,35100
21239,225,3241,18774,2465,12950,8289,1.92199e+18,611.25,6485.39,21239,383,342,14699,11332,5837,6317,2852
1747,3,16,1731,16,1747,0,2.15934e+18,15.8535,167.188,1747,16,16,232,0,163,216,232
42024,1595,3640,25315,16709,0,42024,4.89028e+18,789.658,9194.61,42024,717,459,38384,38166,27862,26414,17276
44729,2492,2543,12293,32436,0,44729,3.7569e+13,860.616,8169.85,44729,494,476,42186,42186,42182,42179,42067
11238,478,555,11238,0,11238,0,4.00715e+18,294.842,1896.96,11238,149,142,10683,10672,10563,10556,10549
1634,102,506,1506,128,933,701,2.08235e+18,61.6371,750.655,1634,126,72,1104,916,631,505,233
20483,1734,3012,18138,2345,12210,8273,1.95388e+18,734.978,6013.84,20483,404,348,17471,16969,16647,16734,13683
1795,76,106,0,1795,1768,27,2.64546e+16,35.005,310.567,1795,39,35,1689,1682,1635,1659,1548
27004,304,3096,0,27004,0,27004,2.40173e+18,779.433,7016.71,27004,347,409,21903,18866,14072,10498,1834
28452,1098,1621,9531,18921,0,28452,3.36865e+13,619.206,5060.04,28452,296,403,26831,26718,26020,26037,22296
39394,3391,3449,23652,15742,23652,15742,1.83346e+18,1286.43,8866.4,39394,450,580,35945,35945,35926,35924,35892
9250,184,1224,0,9250,2631,6619,9.90208e+15,259.185,2674.37,9250,263,276,7691,6871,5447,5421,2249
48491,27,88,47225,1266,48491,0,1.0438e+14,22.3846,887.816,48491,31,32,48398,48391,43657,43881,30410
21792,1601,3101,21792,0,19713,2079,2.3277e+18,640.95,6150.3,21792,359,469,18691,18265,15783,15935,13995
29484,181,1913,9048,20436,0,29484,3.37036e+13,752.483,5411.14,29484,345,393,25244,22890,15281,12022,5572
22299,1783,3578,0,22299,0,22299,2.40585e+18,560.999,6987.95,22299,331,508,18721,18576,17265,17378,10459
39266,427,3768,39266,0,34753,4513,1.96982e+18,1040.08,9226.89,39266,475,499,32595,25762,15986,11415,8297
7540,191,483,7540,0,7540,0,4.63114e+18,250.497,1494.47,7540,123,117,6859,6270,4545,4326,4023
22603,1640,2953,20356,2247,13706,8897,1.94016e+18,695.738,6514.99,22603,415,364,19650,19520,17504,17613,13366
33666,1064,3196,0,33666,0,33666,2.36945e+18,695.929,7751.29,33666,383,407,30274,29350,17979,17502,10354
915,23,324,915,0,845,70,1.85371e+18,65.9738,494.75,915,76,50,356,165,116,30,13
35278,60,297,0,35278,34729,549,2.48152e+16,127.508,2130.53,35278,105,97,34395,33504,29233,27243,19113
42948,662,2065,0,42948,13088,29860,9.28511e+15,788.947,7203.09,42948,470,460,40001,38456,30254,30235,16643
28387,2407,2593,17382,11005,0,28387,4.87477e+18,666.137,6125.13,28387,366,288,25794,25787,25769,25771,25509
21316,507,1950,13248,8068,0,21316,5.05331e+18,417.345,4597.38,21316,330,264,19279,18389,9287,8361,6251
43343,2621,4206,39040,4303,25774,17569,1.93413e+18,1290.03,9884.77,43343,469,610,39137,38338,34778,34676,30308
12976,213,1073,4054,8922,0,12976,3.6037e+13,399.061,3041.6,12976,268,325,10976,9646,7666,7692,4287
35307,804,4514,31500,3807,21034,14273,1.97521e+18,952.441,9846.01,35307,605,491,29455,27982,16075,16262,8995
24329,359,3293,24329,0,21653,2676,1.68797e+18,855.465,7044.4,24329,437,356,18488,15287,8218,7217,3678
8268,191,1140,5301,2967,5301,2967,1.81692e+18,431.254,2515.56,8268,211,244,5934,4723,4014,3864,2328
43128,2174,4191,38792,4336,24420,18708,1.89431e+18,1275.93,10193.4,43128,621,706,38937,38323,35406,35671,23954
26545,3973,3977,26545,0,24124,2421,1.16679e+18,858.231,8106.29,26545,337,461,22568,22568,22568,22568,22566
19652,814,1336,0,19652,6156,13496,9.02081e+15,329.654,3852.51,19652,342,208,18316,18266,17381,17499,14655
19954,147,1832,0,19954,5705,14249,8.62589e+15,304.214,4465.56,19954,393,211,16878,15170,11422,10468,3514
12233,539,1602,12233,0,10920,1313,2.04474e+18,536.798,3645.57,12233,258,228,9949,8019,7583,7364,6328
46098,2983,3385,0,46098,0,46098,2.28322e+18,1044.49,9142.07,46098,434,513,42713,42672,42602,42706,41966
5435,957,1133,3242,2193,0,5435,4.45494e+18,277.443,2113.39,5435,223,196,4302,4286,4214,4143,4070
29865,1239,3538,26108,3757,16992,12873,1.97353e+18,1098.97,8095.58,29865,426,421,25641,24756,17410,16741,11200
35380,2356,2358,0,35380,9977,25403,9.31286e+15,643.177,6908.24,35380,450,492,33022,33022,33022,33022,33022
47101,3758,4515,27673,19428,0,47101,4.545e+18,1071.48,10962.1,47101,638,540,42586,42583,41433,41104,38520
13100,665,2039,13100,0,11704,1396,2.07279e+18,502.155,4035.46,13100,235,210,11014,10605,5564,5115,3246
9291,18,36,9112,179,9291,0,1.02944e+14,18.2881,316.237,9291,23,21,9246,9236,8670,8673,7746
13144,468,1205,0,13144,4107,9037,9.22333e+15,383.799,3093.99,13144,276,287,11878,11400,10188,10117,6992
40600,233,2239,0,40600,13132,27468,8.8481e+15,628.015,6812.26,40600,417,526,35287,31269,19806,19929,8773
26224,173,1495,7999,18225,0,26224,3.5063e+13,619.165,4597.82,26224,322,348,22645,20240,15238,15404,6243
22849,1053,1397,7011,15838,0,22849,3.40895e+13,514.064,4191.68,22849,274,314,21452,21323,21197,21201,18721
33753,3270,4046,30196,3557,19743,14010,1.95663e+18,801.054,9183.9,33753,389,617,29707,29683,29360,29448,26576
839,29,49,0,839,827,12,1.88089e+16,21.5304,151.868,839,21,23,790,770,767,775,677
25650,1308,2453,15738,9912,15738,9912,1.84367e+18,633.873,5848.51,25650,441,406,23197,23031,21288,20289,15287
38928,2519,4053,23238,15690,0,38928,4.87901e+18,1172.78,9531.37,38928,571,542,34875,33934,31875,31235,26709
41425,323,4113,41425,0,37155,4270,2.01768e+18,1268.73,9771.1,41425,590,542,30889,25530,13482,10005,5540
29490,57,60,28838,652,29432,58,1.02062e+14,18.7771,642.996,29490,27,28,29430,29430,29246,29246,29182
47562,1007,3263,27915,19647,0,47562,4.70706e+18,1143.07,9065.97,47562,592,427,43463,40884,33779,32963,22505
28652,2541,2805,25289,3363,17271,11381,1.96826e+18,1557.81,7151.41,28652,488,416,25847,24777,25680,25682,25009
14856,1347,1561,8608,6248,8608,6248,1.75236e+18,540.289,3752.58,14856,282,295,13295,13265,13210,13231,12639
47219,1852,2318,14839,32380,0,47219,3.25693e+13,725.782,7531.14,47219,438,443,44901,44856,44689,44661,40568
16840,921,2302,16815,25,14818,2022,2.03924e+18,774.354,5064.59,16840,306,358,14135,13120,8445,7048,5793
6421,23,32,6370,51,6421,0,9.95532e+13,15.1811,270.937,6421,19,21,6389,6388,6248,6247,5671
31396,653,931,31396,0,31396,0,4.75364e+18,357.443,3490.73,31396,209,206,30465,30441,28303,28171,28693
46746,1818,2829,46746,0,42132,4614,9.57863e+17,1336.92,8402.85,46746,427,435,43647,41491,41273,40688,33036
21179,1673,2765,0,21179,0,21179,2.04482e+18,352.505,5592.05,21179,371,331,18414,18394,17910,15510,15277
12957,506,602,12957,0,12957,0,4.27154e+18,248.431,2017.16,12957,150,150,12355,12348,12166,12174,12069
22368,1463,1520,6814,15554,0,22368,3.17937e+13,382.65,4314.01,22368,266,293,20848,20848,20844,20843,20754
30725,3176,3202,18291,12434,18291,12434,1.7933e+18,559.853,7676.59,30725,326,473,27523,27523,27522,27522,27511
40793,2106,3355,0,40793,0,40793,2.27066e+18,983.614,8457.96,40793,504,415,37438,36965,35922,34200,28139
2445,543,549,1352,1093,1352,1093,1.92844e+18,80.4855,988.3,2445,100,118,1896,1896,1896,1896,1896
29625,2752,3337,26332,3293,17658,11967,1.99544e+18,925.083,7756.89,29625,411,394,26288,26265,26020,25978,23534
12556,140,2309,7549,5007,7549,5007,1.84198e+18,557.705,4398.11,12556,287,359,8562,7028,4957,3883,708
5432,257,386,5432,0,5432,0,4.08561e+18,210.509,1188.11,5432,102,95,5041,4933,4286,4135,3899
11753,19,52,11533,220,11753,0,9.96769e+13,15.625,444.909,11753,22,21,11699,11690,10727,10655,7606
38706,1356,1761,11480,27226,0,38706,3.38426e+13,651.368,5795.12,38706,406,308,36945,36841,36545,36578,33466
49978,863,4047,49978,0,44775,5203,2.93573e+18,1609.24,10574.9,49978,583,499,43804,41670,36855,36095,15030
47294,1201,2424,0,47294,14395,32899,8.77219e+15,590.813,7791.47,47294,525,366,44870,44676,40036,40131,28319
27568,350,2818,24636,2932,16535,11033,1.97101e+18,940.257,6920.77,27568,465,313,21456,17277,12582,11077,3187
39649,14068,39649,0,39649,39649,0,4095.9,0,39649,39649,39649,1,0,0,0,0,0
35795,4143,4873,35795,0,32103,3692,2.1538e+18,1049.18,10171.1,35795,498,497,30922,30913,30792,30820,29338
22437,28,67,22037,400,22387,50,1.04112e+14,18.4603,582.567,22437,27,26,22370,22357,20878,20751,15108
33461,1808,2084,19311,14150,19311,14150,1.80804e+18,1035.76,6208.02,33461,392,363,31377,31375,31299,31334,30796
6725,13,157,0,6725,6629,96,2.6573e+16,55.5619,721.872,6725,48,54,6189,5937,5058,4637,2559
43389,1811,3761,43389,0,38659,4730,2.7143e+18,1355.8,9924.76,43389,485,511,39471,37826,37296,35813,25394
8640,4,22,8459,181,8640,0,1.00927e+14,11.4031,270.92,8640,15,15,8004,7699,6949,6857,5388
9018,324,507,9018,0,9018,0,4.67893e+18,244.51,1656.19,9018,138,111,8511,8370,7124,6944,6136
2039,183,490,0,2039,652,1387,8.95995e+15,114.773,852.08,2039,142,91,1549,1387,1346,1359,874
1917,144,740,1692,225,1187,730,1.87926e+18,148.061,1077.74,1917,107,104,1062,878,607,651,288
38562,19,69,37902,660,38562,0,9.75552e+13,19.3269,741.019,38562,27,28,38487,38462,35118,35058,27453
10110,1003,1902,6060,4050,6060,4050,1.92857e+18,359.66,3557.32,10110,294,323,8208,8138,7772,7725,5740
21005,876,2208,12662,8343,0,21005,4.71774e+18,533.814,5327.35,21005,397,337,18797,18144,14667,14409,11447
39866,1905,4064,39866,0,35575,4291,2.7084e+18,1395.81,9791.55,39866,565,469,35662,33690,32586,31055,17651
32651,1571,3505,19332,13319,19332,13319,1.76469e+18,694.15,8315.39,32651,325,634,29146,28803,27744,28237,16594
35166,54,251,0,35166,34599,567,2.59208e+16,152.106,1879.21,35166,93,103,34381,33872,28736,25402,18407
39828,64,1075,39828,0,39828,0,4.14664e+18,391.93,4123.02,39828,224,223,28943,19372,14557,13659,5161
2659,230,426,0,2659,751,1908,9.02531e+15,168.131,892.058,2659,102,98,2187,2022,2048,2055,1662
27905,977,2756,0,27905,0,27905,2.37353e+18,864.93,6557.44,27905,466,440,24620,23917,18536,15089,10158
4603,18,31,4518,85,4603,0,1.08236e+14,15.37,248.808,4603,18,20,4571,4561,4249,4247,3466
38079,5,75,37426,653,38079,0,1.05593e+14,21.9383,837.429,38079,30,29,35673,33768,30010,30424,18424
19364,950,1698,6067,13297,0,19364,3.61426e+13,348.944,4409.77,19364,303,405,17666,17621,17281,17270,13613
42005,1897,3418,24705,17300,0,42005,4.65235e+18,910.317,8970.11,42005,497,462,38587,38101,36339,35992,27053
11686,327,543,11676,10,11686,0,4.32334e+18,263.101,1901.94,11686,143,136,11143,11025,9861,9774,9103
33111,1935,2501,19535,13576,19535,13576,1.79574e+18,1057.03,6849.09,33111,428,397,30610,29843,30112,30319,27500
42301,424,828,42301,0,42301,0,4.11611e+18,367.458,3777.97,42301,228,218,41473,41140,33272,32985,33796
13804,446,503,13804,0,13804,0,4.28997e+18,275.292,2030.09,13804,149,166,13301,13294,13116,13116,13049
3651,126,646,3651,0,3264,387,3.17825e+18,300.373,1308.33,3651,165,130,2350,1827,1101,789,968
1459,143,264,0,1459,0,1459,1.27703e+18,122.743,553.059,1459,85,65,1176,651,872,874,777
3549,582,827,0,3549,0,3549,2.23092e+18,182.082,1458.45,3549,138,139,2722,2718,2636,2424,2413
7280,1448,1569,6684,596,4128,3152,1.93064e+18,205.134,2744.44,7280,221,196,5711,5711,5711,5711,5625
45738,2542,4372,27605,18133,0,45738,4.88702e+18,784.901,10360.9,45738,485,544,41366,41064,39876,39802,24767
37689,1494,1950,11936,25753,0,37689,3.5604e+13,438.239,5780.57,37689,269,387,35739,35730,35605,35605,31410
46940,13448,46940,46940,0,46940,0,1.75918e+13,0,46940,46940,46940,1,0,0,0,0,0
16414,34,48,16144,270,16414,0,1.04263e+14,18.5311,473.623,16414,21,25,16366,16366,15732,15734,14380
26867,182,706,26867,0,26867,0,4.15621e+18,315.287,2992.61,26867,198,188,25183,23249,16438,15256,10914
49658,3541,4143,29849,19809,29849,19809,1.88146e+18,1065.55,10468.2,49658,562,559,45515,45386,45085,45236,41518
49485,1411,3114,29629,19856,29629,19856,1.86873e+18,1191.64,9115.07,49485,541,471,46180,44356,42166,40850,32047
36408,1605,2296,0,36408,11381,25027,8.63826e+15,647.636,6647.85,36408,422,384,34112,33875,33270,33264,28306
9584,683,926,0,9584,2820,6764,9.08031e+15,338.041,2375.31,9584,182,196,8658,8650,8631,8625,7510
4932,6,28,4848,84,4932,0,1.03984e+14,13.4475,226.394,4932,19,17,4760,4636,4160,4072,2849
20064,1228,1711,6655,13409,0,20064,3.36915e+13,483.253,4546.11,20064,334,461,18353,18219,17968,17975,16457
10835,1115,1828,10835,0,9748,1087,2.82036e+18,524.537,3655.91,10835,287,222,9007,8458,8405,7887,6845
15694,66,2129,0,15694,0,15694,2.39408e+18,491.757,4506.95,15694,340,311,9723,7322,5811,3820,703
36671,299,3462,36671,0,32817,3854,2.99104e+18,1305.5,8323.1,36671,474,477,28396,22462,11181,6796,7201
43000,1817,3030,0,43000,0,43000,2.0071e+18,856.136,8086.36,43000,508,350,39970,39600,37059,29276,29943
915,297,402,0,915,0,915,2.38999e+18,29.6623,529.887,915,98,50,513,511,507,499,489
1827,248,320,473,1354,0,1827,4.19083e+13,75.2923,624.16,1827,120,66,1507,1482,1482,1478,1349
29218,446,809,29218,0,29218,0,4.26021e+18,336.047,3260.44,29218,198,186,28409,28223,25136,24815,23339
49023,1059,4168,44711,4312,29389,19634,1.97744e+18,1152.39,10401.6,49023,561,472,43820,38994,31236,30587,20587
42636,1602,4320,38471,4165,24399,18237,1.89079e+18,1084.83,10281.3,42636,474,464,38316,36560,22003,20879,16009
40158,28,952,40158,0,40129,29,4.33041e+18,354.456,3916.98,40158,227,219,24770,15787,9922,9564,2217
31235,2399,2595,31235,0,27513,3722,1.4312e+18,957.701,6909.8,31235,388,415,28640,28634,28617,28629,28215
13063,486,806,4173,8890,0,13063,3.40812e+13,372.778,2537.34,13063,260,231,12242,11957,11061,11057,9909
1191,118,274,1191,0,1191,0,4.04273e+18,89.55,499.083,1191,55,57,913,783,715,691,615
19817,39,48,19500,317,19817,0,1.05733e+14,17.3245,508.659,19817,22,24,19769,19769,19525,19525,18476
37716,322,2807,0,37716,11375,26341,9.31914e+15,583.9,7791.72,37716,434,629,33773,31406,21469,22151,6590
22245,168,263,0,22245,21900,345,2.50364e+16,128.174,1647.44,22245,82,101,21977,21885,20678,20536,17765
16166,2063,2346,9717,6449,0,16166,5.13877e+18,666.014,4833.57,16166,326,335,13820,13785,13725,13779,13029
18301,1557,2397,10635,7666,10635,7666,1.69327e+18,392.798,5045.08,18301,382,283,15904,15820,14855,13753,11638
31238,2997,3023,18134,13104,0,31238,4.45252e+18,831.418,7275.65,31238,411,466,28215,28215,28202,28203,28189
34499,640,2316,19910,14589,0,34499,4.68072e+18,964.861,6650.64,34499,433,488,30850,28964,17809,15454,13818
22040,176,750,22034,6,22040,0,3.84133e+18,310.785,2800.78,22040,182,178,20379,18557,12905,12600,8128
18237,2186,2511,10967,7270,10967,7270,1.90323e+18,537.661,5191.89,18237,349,298,15726,15677,15613,15656,14926
20479,275,1307,0,20479,5669,14810,9.57341e+15,468.683,3885.67,20479,362,220,18019,16438,14008,14303,6494
45344,81,106,44676,668,45334,10,1.02723e+14,19.2941,875.42,45344,34,31,45238,45238,44401,44402,42275
9806,107,170,0,9806,9535,271,2.62777e+16,74.2852,902.645,9806,66,65,9636,9613,9234,9121,7940
33231,960,1542,9274,23957,0,33231,3.76878e+13,719.979,5162.39,33231,360,311,31571,30656,30789,30822,26448
43669,1774,3691,25955,17714,0,43669,4.57428e+18,738.92,9214.67,43669,478,605,39978,39581,36110,35800,20517
3660,6,25,3620,40,3660,0,1.00362e+14,13.3,195.106,3660,15,16,3531,3446,3101,3039,2084
11505,9,30,11296,209,11505,0,9.3972e+13,16.3957,348.409,11505,19,22,11365,11270,9997,9980,7664
5570,166,433,5570,0,5570,0,3.99111e+18,195.726,1249.67,5570,102,101,4966,4433,3683,3611,3051
17981,1172,2295,10173,7808,10173,7808,1.73505e+18,432.286,5070.1,17981,248,453,15686,15562,15016,15221,9534
720,61,69,0,720,702,18,2.47198e+16,14.3708,171.51,720,24,26,651,651,645,645,634
19862,1685,1719,11943,7919,0,19862,4.87827e+18,884.368,4497.17,19862,329,335,18143,18143,18130,18125,18105
22454,2493,2799,22454,0,20193,2261,2.09727e+18,927.443,6348.63,22454,362,416,19655,19591,19650,19648,19484
11257,87,1533,0,11257,0,11257,2.33949e+18,346.854,3201.57,11257,250,222,7571,5703,4391,3996,720
29110,99,1019,29110,0,29110,0,4.45741e+18,350.306,3521.71,29110,204,212,23361,17661,11336,9973,5899
873,11,57,0,873,860,13,2.91368e+16,10.3746,155.273,873,20,16,808,788,625,605,399
16696,1818,2201,16675,21,14932,1764,2.90207e+18,1054.43,5002.3,16696,338,368,14495,13593,14223,14157,13372
5198,1242,1342,3176,2022,0,5198,5.20125e+18,178.751,2203.28,5198,138,223,3856,3856,3849,3849,3797
8372,272,1103,4568,3804,0,8372,4.11577e+18,264.358,2337.06,8372,168,192,7126,6731,4710,4070,3677
41107,178,858,41107,0,41107,0,4.24882e+18,359.302,3868.93,41107,220,214,37978,33901,22341,20947,13828
33757,1550,2252,20375,13382,0,33757,4.82166e+18,954.199,6435.91,33757,396,454,31505,30912,29189,28740,27589
37163,643,1841,11468,25695,0,37163,3.14703e+13,850.435,5879.3,37163,339,418,34686,33732,30127,30029,14608
21794,169,201,0,21794,21489,305,2.50618e+16,116.463,1331.98,21794,85,85,21593,21577,21507,21469,21045
39736,2510,4184,23785,15951,0,39736,4.72252e+18,756.401,9867.19,39736,381,633,35552,35509,34869,34901,26240
8611,18,36,8411,200,8611,0,1.07674e+14,16.2635,314.285,8611,19,21,8571,8557,7874,7867,7063
45355,344,820,45355,0,45330,25,4.22682e+18,377.127,3941.85,45355,219,230,44351,43823,32963,32136,28090
46683,221,939,46683,0,46683,0,3.94799e+18,363.234,4193.26,46683,233,212,44492,41849,30496,30107,22945
16092,533,2361,14467,1625,9892,6200,1.92422e+18,809.223,5026.15,16092,338,354,13041,11498,8470,8217,4086
43645,105,330,0,43645,42497,1148,2.6378e+16,144.454,2531.74,43645,106,128,43137,42800,38001,34933,27120
41627,3242,3320,41627,0,36630,4997,1.93913e+18,1201.63,8725.79,41627,460,548,38307,38307,38307,38307,38227
18319,133,1387,0,18319,5647,12672,8.9912e+15,400.358,3745.61,18319,305,326,14795,12698,9672,8715,3914
42374,2501,3695,0,42374,0,42374,2.31225e+18,999.512,9502.78,42374,516,434,38679,38667,34731,33872,26340
41624,2345,3382,0,41624,0,41624,2.42552e+18,1151.63,8863.08,41624,450,508,38242,37858,37657,37650,30295
41926,1725,3053,0,41926,0,41926,2.21351e+18,743.325,8027.25,41926,383,560,38873,38642,36828,34473,23704
26948,123,3112,24411,2537,16461,10487,1.96152e+18,669.135,7095.32,26948,418,323,16922,12891,7541,6549,1028
22076,23,48,21558,518,22076,0,9.98731e+13,19.1293,546.081,22076,25,25,22027,22014,21270,21269,18170
32770,2212,2841,28839,3931,19726,13044,2.00095e+18,1022.2,7731.78,32770,408,440,29929,29893,29199,29300,25954
13660,77,503,13660,0,13660,0,3.81463e+18,258.621,1992.36,13660,140,157,10933,7795,6016,6123,2877
48264,1225,5211,43391,4873,28017,20247,1.90209e+18,1122.69,11878.4,48264,577,627,42503,39772,29949,28386,19441
30251,986,2386,17352,12899,17352,12899,1.73548e+18,1006.62,6610,30251,404,417,27281,25668,22938,22766,17149
15428,898,2665,0,15428,0,15428,2.43473e+18,452.072,5148.85,15428,302,490,12763,12270,11166,10194,6290
44975,88,97,44089,886,44975,0,1.02714e+14,20.9438,922.416,44975,32,32,44878,44878,44731,44738,44446
17788,1941,2483,17788,0,15705,2083,2.74007e+18,576.51,5134.34,17788,302,301,15305,15260,15298,15267,14683
49338,3197,4399,28985,20353,28985,20353,1.76722e+18,910.892,10836.1,49338,438,620,44939,44896,43911,44337,31669
16854,231,1484,5067,11787,0,16854,3.61466e+13,424.207,3975.6,16854,325,278,14385,13022,9954,9601,3318
48175,253,364,0,48175,47035,1140,2.60979e+16,146.88,2756.84,48175,107,117,47811,47776,46152,45978,41069
39072,1825,4756,35049,4023,23783,15289,1.96945e+18,1065.04,10131.8,39072,522,552,34316,33281,26330,25587,15232
7592,63,160,0,7592,7419,173,2.41173e+16,57.6345,774.302,7592,52,49,7407,7347,6702,6492,4537
9603,1075,1871,5726,3877,0,9603,5.03992e+18,258.338,3447.35,9603,183,336,7732,7698,7458,7451,5610
17106,187,839,17106,0,17106,0,3.94349e+18,328.321,2651.62,17106,185,176,15359,13424,9375,8771,6331
26940,838,3957,23580,3360,16052,10888,1.99327e+18,771.467,8188.36,26940,307,577,22323,20266,16583,16023,8402
26862,1583,3250,24275,2587,16380,10482,1.97617e+18,674.018,7077.79,26862,454,364,23612,23328,19491,18990,16370
43487,775,4208,24983,18504,24983,18504,1.7572e+18,895.246,10050.4,43487,647,733,38334,37052,25549,25976,9972
9566,176,1979,8663,903,5796,3770,1.95497e+18,473.934,3594.05,9566,268,255,6473,5333,2927,2578,1273
25892,1181,2708,0,25892,0,25892,2.30501e+18,630.705,6281.82,25892,365,385,23184,22843,20019,18648,13318
41794,1173,2217,12437,29357,0,41794,3.6278e+13,651.303,6920.38,41794,424,398,39577,39455,37971,38030,24197
16484,1150,1546,0,16484,4812,11672,9.02366e+15,423.805,3854.33,16484,246,320,14938,14886,14793,14757,12175
47358,954,2708,14683,32675,0,47358,3.55848e+13,735.217,8251.53,47358,488,482,44456,43787,38673,38742,19231
10784,1265,1821,0,10784,0,10784,2.28336e+18,344.285,3622.37,10784,255,370,8963,8912,8655,8712,7143
27333,1102,2395,16253,11080,16253,11080,1.74909e+18,785.652,6150.25,27333,380,382,24763,24040,22582,21260,13880
26351,1657,1668,7768,18583,0,26351,3.68693e+13,450.819,5003.37,26351,329,372,24683,24683,24683,24683,24664
17036,1437,1844,9805,7231,9805,7231,1.69828e+18,375.614,4330.79,17036,290,304,15192,15180,15030,15087,14189
29861,1097,2954,0,29861,0,29861,2.22289e+18,781.642,7176,29861,412,400,26822,25725,23041,20024,14302
38261,177,240,0,38261,37387,874,2.54587e+16,144.701,1915.09,38261,100,97,38021,38012,36824,36579,34865
44063,45,77,43417,646,44051,12,9.81201e+13,19.3086,894.323,44063,28,27,43986,43986,42589,42598,33969
28678,36,2395,17063,11615,17063,11615,1.76664e+18,669.113,6417.08,28678,320,486,15122,8185,7039,6152,1133
47748,3631,4443,28946,18802,28946,18802,1.80861e+18,1409.19,10845.7,47748,578,690,43305,43193,42596,42865,40193
4763,383,450,0,4763,1479,3284,9.39597e+15,230.834,1169.27,4763,142,134,4313,4312,4272,4290,4208
22768,1148,2410,13764,9004,13764,9004,1.74294e+18,547.737,5790.23,22768,320,371,20358,20111,19467,19670,14588
15114,333,1624,0,15114,0,15114,2.52911e+18,804.954,3892.42,15114,308,276,11854,10493,8192,6604,3071
46018,2387,3983,0,46018,0,46018,2.27382e+18,1066.61,10093.4,46018,480,602,42035,41542,40378,39724,29944
12062,993,1115,0,12062,3662,8400,9.19934e+15,250.819,2877.58,12062,176,310,10947,10947,10923,10906,10084
37726,3210,3723,37726,0,33750,3976,2.36435e+18,798.561,8851.16,37726,439,373,34003,33977,33949,33974,32502
27666,108,587,27666,0,27666,0,3.96731e+18,313.79,2865.95,27666,186,188,23786,20053,14134,13082,7822
49697,255,309,0,49697,48574,1123,2.58786e+16,157.048,2577.69,49697,120,116,49388,49384,48239,47844,46545
5372,324,744,1717,3655,0,5372,3.53206e+13,246.397,1683.68,5372,190,163,4576,4226,3391,3349,2782
6039,881,1093,6039,0,5365,674,1.24528e+18,391.151,2157.5,6039,150,214,4946,4946,4920,4905,4813
36481,1870,3398,36481,0,32848,3633,1.80016e+18,1308.75,8415.98,36481,462,469,32692,31604,28009,26756,22142
27322,510,2020,8053,19269,0,27322,3.67721e+13,608.118,5630.89,27322,428,385,24948,23903,19336,19006,9831
21319,182,591,21319,0,21315,4,4.34946e+18,291.729,2578.78,21319,162,164,19847,17995,13392,12487,9739
6607,373,856,0,6607,0,6607,2.29695e+18,331.687,1914.08,6607,170,167,5616,4383,4746,4483,4029
27598,2619,3312,27598,0,24828,2770,2.79704e+18,777.561,7375.31,27598,429,378,24286,24244,24086,23895,22258
33696,394,955,33696,0,33696,0,4.0641e+18,335.923,3661.3,33696,213,213,32741,32309,27160,26498,24294
5925,288,1387,5925,0,5400,525,1.98498e+18,178.866,2353.38,5925,225,131,4538,4309,3214,2830,926
19476,693,1723,0,19476,6235,13241,8.91612e+15,420.759,4541.81,19476,312,470,17753,17268,16421,16461,7801
10534,33,195,0,10534,10388,146,2.44958e+16,80.2347,925.149,10534,63,63,10040,9767,8739,7922,5220
48179,165,330,0,48179,47177,1002,2.52342e+16,150.946,2610.76,48179,112,117,47830,47699,44094,42502,36376
29828,377,755,29828,0,29828,0,4.10129e+18,346.595,3219.53,29828,190,202,29038,28665,24479,24143,21353
25479,1115,1967,7279,18200,0,25479,3.52826e+13,626.81,5415.17,25479,437,338,23512,23072,22475,22534,17963
34419,71,3116,0,34419,0,34419,2.34673e+18,1173.98,7790.62,34419,615,457,22869,17092,14083,10824,1409
44917,976,2682,0,44917,14213,30704,9.16788e+15,722.843,7880.89,44917,442,489,42167,41519,34295,34200,19543
48399,224,320,0,48399,47385,1014,2.60128e+16,119.639,2426.64,48399,97,103,48079,48061,46793,46728,43115
23292,50,54,22939,353,23292,0,1.03904e+14,18.4874,559.719,23292,26,25,23238,23238,23196,23196,23121
19863,846,2569,11802,8061,11802,8061,1.89794e+18,717.224,5545.35,19863,396,409,17098,15934,14460,13686,7771
6400,992,1188,3705,2695,3705,2695,1.67977e+18,271.078,2283.83,6400,230,201,5212,5212,5184,5191,5017
8601,120,903,2765,5836,0,8601,3.33562e+13,347.984,2296.89,8601,200,238,6733,5825,3894,3633,1887
10538,338,1621,0,10538,0,10538,2.33718e+18,604.593,3345.84,10538,325,262,8351,7460,6092,5715,2807
14315,179,226,0,14315,13982,333,2.74992e+16,87.6076,1234.25,14315,75,76,14089,14077,13886,13929,13187
17668,31,40,17239,429,17668,0,1.03251e+14,18.5802,460.738,17668,22,26,17628,17628,17106,17105,16299
48237,26,45,47153,1084,48237,0,8.82409e+13,18.6607,743.5,48237,23,25,48192,48189,45870,45872,36047
9601,81,206,0,9601,9482,119,2.68462e+16,80.0404,1006.28,9601,58,63,9368,9208,8473,8122,6321
28046,2053,2140,0,28046,9039,19007,8.73167e+15,437.273,6011.98,28046,311,475,25906,25905,25891,25895,25743
36823,67,75,36288,535,36823,0,9.60854e+13,22.5533,801.533,36823,29,29,36748,36748,36433,36434,35723
24353,1704,3038,0,24353,0,24353,2.41507e+18,621.897,6422.84,24353,351,392,21315,20954,20045,19422,15754
39659,2043,2500,11563,28096,0,39659,3.56381e+13,612.82,7299.13,39659,446,398,37159,37143,37022,37021,33945
41154,25,69,40337,817,41141,13,9.93379e+13,18.3124,740.505,41154,26,31,41085,41072,38621,38414,29716
28611,724,4116,28611,0,25791,2820,2.26572e+18,1016.64,8504.71,28611,506,512,23335,21439,15940,15514,6671
33712,1,74,33214,498,33712,0,1.02255e+14,18.3592,726.348,33712,29,29,13728,13728,13728,13728,13728
30214,3046,3491,30214,0,27023,3191,2.38887e+18,1114.52,8017.46,30214,457,363,26723,26526,26699,26400,25283
31522,3484,4085,19131,12391,19131,12391,1.84279e+18,752.342,9038.79,31522,483,525,27437,27413,27077,27207,24223
35126,2222,2942,35126,0,31598,3528,1.69614e+18,1152.96,7459.49,35126,523,388,32184,31988,31728,31244,25954
8699,1770,2012,7633,1066,5021,3678,2.08624e+18,319.454,3383.07,8699,223,234,6687,6687,6668,6671,6431
7177,51,157,0,7177,6992,185,2.66665e+16,67.4021,734.652,7177,53,56,6942,6811,6118,5896,4504
23675,868,2684,13810,9865,13810,9865,1.77198e+18,531.375,6189.61,23675,391,445,20991,20406,15569,15768,8516
44068,513,710,44068,0,44068,0,3.91481e+18,345.757,3755.91,44068,228,213,43358,43307,41579,41520,40603
40755,1680,4077,0,40755,0,40755,2.23751e+18,877.289,9591.62,40755,481,439,36678,36007,28684,21418,14667
35333,716,2689,0,35333,10997,24336,9.18783e+15,594.918,7493.23,35333,370,476,32505,31638,25733,26109,14871
26949,134,199,0,26949,26565,384,2.45808e+16,140.152,1443.99,26949,96,91,26674,26495,24589,24967,22177
6482,520,1479,5957,525,3856,2626,2.01656e+18,199.672,2538.1,6482,170,202,5003,4867,4220,4347,1547
18719,569,1555,0,18719,5839,12880,8.51902e+15,444.263,3977.58,18719,302,328,17042,16410,15391,15410,8723
21899,1336,1486,13245,8654,13245,8654,1.68745e+18,464.191,4233.44,21899,284,306,20413,20403,20258,20310,19733
12887,2289,12887,0,12887,12887,0,4095.68,0,12887,12887,12887,1,0,0,0,0,0
35429,1922,2183,11406,24023,0,35429,3.47577e+13,629.234,6662.6,35429,364,461,33246,33244,33186,33201,31185
9610,4,198,0,9610,9424,186,2.68286e+16,73.568,1004.08,9610,62,63,6887,5503,5228,4800,2943
14659,29,481,14659,0,14659,0,4.25085e+18,237.607,1994.9,14659,155,142,8197,3863,3917,3134,853
27812,7,736,27812,0,27812,0,4.33006e+18,313.252,3102.53,27812,202,182,7953,2621,2080,2190,670
34855,1626,1918,0,34855,10532,24323,8.77043e+15,695.14,6000.19,34855,468,413,32937,32875,32332,32325,30425
44084,1533,2740,24878,19206,24878,19206,1.6719e+18,1329.36,7865.65,44084,419,487,40830,38508,39322,39076,30660
44498,2016,3792,26906,17592,26906,17592,1.86126e+18,1262.17,9437.19,44498,525,483,40706,39751,37905,37131,27117
40315,1659,2895,23973,16342,0,40315,5.01525e+18,1222.45,8252.4,40315,445,509,37143,35780,34548,33820,29025
26721,608,685,26721,0,26721,0,4.13357e+18,328.723,2948.96,26721,191,188,26036,26026,25921,25922,25566
6507,401,890,0,6507,0,6507,2.37301e+18,315.944,1896.39,6507,193,134,5548,4784,4831,4665,2567
32312,131,3854,32312,0,28326,3986,1.59231e+18,1103.65,8707.09,32312,498,446,19967,15353,8693,6407,1638
31821,189,1928,9819,22002,0,31821,3.06791e+13,511.453,5616.65,31821,358,441,28697,27308,19819,20065,2788
30355,67,217,0,30355,29778,577,2.50748e+16,136.14,1609.18,30355,83,91,29834,29390,26180,23983,17291
27923,841,2077,24861,3062,16687,11236,1.97257e+18,1054.25,5880.82,27923,329,350,25087,23887,19936,19205,14373
4287,16,25,4159,128,4287,0,9.81587e+13,13.6641,216.078,4287,15,18,4261,4253,4089,4091,3709
41723,1496,2301,0,41723,13000,28723,8.66873e+15,731.809,6842.56,41723,438,481,39422,38961,37940,38132,31503
47271,606,1179,47253,18,47271,0,4.25361e+18,404.303,4505.24,47271,241,241,46092,45925,39099,38731,34496
49902,1503,3864,29414,20488,0,49902,4.83768e+18,1189.92,10365.4,49902,565,533,45761,44304,40851,39991,24068
22055,640,2580,12969,9086,0,22055,4.71171e+18,515.524,5697.38,22055,317,341,19388,18616,15517,15192,7355
30159,190,2785,30159,0,27049,3110,1.44599e+18,1300.85,7011.37,30159,413,328,20959,16490,10014,8658,4410
36805,361,5392,36805,0,32649,4156,1.46204e+18,847.422,10642.2,36805,509,631,28557,23074,15267,13216,4155
43603,912,3363,0,43603,0,43603,2.31196e+18,993.434,8958.69,43603,451,616,39569,37256,31869,29362,13817
35836,2571,3273,21545,14291,0,35836,4.87453e+18,940.775,8238.08,35836,427,481,32563,32525,32028,31960,29747
3858,29,124,0,3858,3803,55,2.70824e+16,36.8888,482.754,3858,40,45,3687,3603,3249,3124,2339
42114,2985,3239,42114,0,37364,4750,1.99517e+18,1316.98,9079.61,42114,500,444,38875,38874,38860,38852,38561
48208,695,2749,0,48208,15052,33156,8.77651e+15,719.118,8434.75,48208,453,596,44759,42725,34563,34839,18366
18165,1034,1641,11003,7162,11003,7162,1.89217e+18,708.041,4255.27,18165,338,275,16486,15340,15332,15077,11191
37206,1325,1616,0,37206,11124,26082,9.42254e+15,513.336,5107.3,37206,310,338,35590,35569,35471,35451,32718
22545,172,275,0,22545,21954,591,2.64515e+16,113.651,1563.96,22545,80,94,22270,22221,21078,20756,18731
29721,151,302,0,29721,29211,510,2.69286e+16,137.044,2018.95,29721,104,122,29397,29230,26886,25492,22609
41603,3987,4070,24979,16624,0,41603,4.8071e+18,1057.77,9928.97,41603,646,570,37533,37533,37520,37524,37365
629,11,14,616,13,629,0,1.49911e+14,6.03816,71.0223,629,9,9,615,615,534,533,486
25329,40,53,24843,486,25329,0,1.05071e+14,17.729,565.987,25329,27,26,25276,25276,24670,24670,23557
40084,475,3457,24057,16027,0,40084,4.93529e+18,1018.66,8790.04,40084,499,561,34410,31607,21715,19131,5270
32854,15586,32854,32854,0,32854,0,1.75917e+13,0,32854,32854,32854,1,0,0,0,0,0
29483,2824,3900,26359,3124,17419,12064,1.97705e+18,639.259,8173.96,29483,355,504,25583,25495,25026,25172,21606
609,107,276,518,91,356,253,2.11365e+18,29.8194,359.4,609,44,60,333,313,229,221,54
31663,778,2277,0,31663,9674,21989,9.04198e+15,646.573,6518.67,31663,353,433,29121,28429,25415,25534,12487
47965,1417,3945,27923,20042,0,47965,4.74671e+18,1301.59,10246.8,47965,524,600,43647,41901,37333,37490,22666
7631,28,38,7462,169,7631,0,1.08887e+14,13.861,305.111,7631,18,19,7593,7590,7308,7309,6420
8284,442,914,0,8284,0,8284,2.23108e+18,359.14,2200.35,8284,171,197,7363,7045,6442,6390,5796
12885,1558,1605,0,12885,0,12885,2.43203e+18,318.886,3407.85,12885,313,206,11280,11280,11280,11280,11277
41367,1293,4118,0,41367,0,41367,2.29956e+18,854.928,9686.33,41367,657,407,37249,36071,25340,24753,14983
21404,48,2703,21404,0,18881,2523,2.14808e+18,693.972,5953.02,21404,316,400,10774,7202,3285,851,1139
38281,2764,3564,21918,16363,0,38281,4.34825e+18,1034.75,8597.02,38281,462,397,34717,34540,34125,33970,30051
19645,1689,1794,5867,13778,0,19645,3.66011e+13,376.283,4574.01,19645,257,401,17851,17849,17841,17836,17444
28360,1510,3823,25143,3217,16615,11745,1.94672e+18,763.216,8175.41,28360,482,439,24537,23902,21360,21139,11736
32765,480,1932,0,32765,9707,23058,9.40141e+15,572.501,5558.68,32765,505,309,30190,28493,21006,20001,14958
23488,263,600,23488,0,23488,0,4.18705e+18,311.365,2714.49,23488,183,177,22655,21971,15795,15684,14111
13913,887,1337,0,13913,3976,9937,9.54807e+15,380.699,3281.65,13913,235,264,12576,12351,12380,12341,10039
36544,63,96,35675,869,36544,0,1.02395e+14,19.2867,788.33,36544,31,30,36448,36446,35811,35812,31703
18372,15055,18372,18372,0,18372,0,1.75912e+13,0,18372,18372,18372,1,0,0,0,0,0
35413,357,792,35413,0,35413,0,4.02771e+18,365.104,3539,35413,219,213,34535,33915,26804,26440,25695
45693,24,1776,13849,31844,0,45693,3.17684e+13,905.904,6077.03,45693,407,403,27428,19445,14428,2617,2015
45015,439,4098,25712,19303,0,45015,4.44425e+18,1010.68,10067,45015,556,463,38567,35265,19342,17817,6416
38141,2745,3297,23198,14943,0,38141,5.01798e+18,1003.39,8421.04,38141,458,465,34844,34815,34656,34677,33176
16195,690,2665,14611,1584,9507,6688,1.94741e+18,477.941,5107.69,16195,244,398,13512,12471,10126,10040,3399
13279,1221,1367,8285,4994,8285,4994,1.73557e+18,462.339,3393.48,13279,249,242,11912,11909,11792,11820,11165
36870,44,233,0,36870,36179,691,2.62081e+16,144.324,1872.33,36870,88,94,35954,35312,29330,26265,18585
2240,8,18,2176,64,2240,0,8.49453e+13,11.2362,141.997,2240,14,16,2187,2169,1959,1948,1554
14311,288,1949,8612,5699,8612,5699,1.82584e+18,379.696,4067.1,14311,343,182,11556,9460,7902,6392,2128
37177,4925,5115,37177,0,32748,4429,1.92609e+18,1128.7,10765.3,37177,613,605,32062,32061,32059,32057,31598
35774,1593,2371,35749,25,31456,4318,1.42989e+18,1210.18,7049.17,35774,391,415,33403,32899,32122,32101,29149
26965,1201,2169,16357,10608,0,26965,4.98167e+18,832,5586.09,26965,402,309,24796,24294,22494,21944,19175
28216,1612,1709,0,28216,8672,19544,9.14948e+15,665.842,5060.55,28216,387,393,26507,26484,26490,26490,26173
45458,1445,1625,13162,32296,0,45458,3.71881e+13,688.485,6150.76,45458,423,342,43833,43833,43653,43656,42749
5547,632,1033,3372,2175,3372,2175,1.71016e+18,446.513,2039.53,5547,201,253,4503,4099,4021,3956,3131
35346,2054,3540,31070,4276,20449,14897,1.9701e+18,1112.66,8732.35,35346,410,549,31806,31553,30260,30511,22068
18498,1128,1947,11126,7372,11126,7372,1.87958e+18,639.88,4562.22,18498,323,318,16551,16112,15296,15018,9905
17537,217,227,0,17537,17209,328,2.63915e+16,87.8688,1323.92,17537,66,81,17310,17310,17305,17294,17204
11018,874,944,0,11018,0,11018,2.36946e+18,361.039,2457.65,11018,190,192,10074,10071,10061,10061,9978
11776,1221,1264,7007,4769,0,11776,4.88261e+18,508.089,2986.2,11776,216,224,10512,10512,10504,10505,10464
21060,680,2906,18788,2272,11978,9082,1.94053e+18,602.552,6219.45,21060,378,320,17794,16147,11290,11521,7888
9436,232,236,0,9436,9205,231,2.66055e+16,80.404,1048.56,9436,64,70,9200,9200,9199,9195,9172
3259,442,465,1041,2218,0,3259,3.33552e+13,168.301,1027.12,3259,136,111,2794,2794,2792,2793,2774
24896,510,3005,14655,10241,14655,10241,1.83141e+18,610.122,6561.88,24896,410,333,21448,19808,15797,14831,8140
23232,662,1583,7399,15833,0,23232,3.47233e+13,616.006,4620.65,23232,333,352,21551,20941,19243,19154,12453
3241,142,366,3241,0,3241,0,4.15066e+18,168.746,912.065,3241,85,83,2758,2402,1905,1835,1590
38733,2251,3740,23255,15478,23255,15478,1.77335e+18,1030.39,9126.35,38733,668,532,34993,34626,33809,33992,30383
28869,20,38,28212,657,28869,0,9.80178e+13,16.9618,566.854,28869,22,23,28828,28816,27479,27413,21201
29356,130,959,8005,21351,0,29356,3.61677e+13,618.634,3873.93,29356,330,279,23676,20174,17047,17194,6544
7078,526,561,0,7078,0,7078,1.77479e+18,156.294,1423.6,7078,156,123,6517,6517,6517,6517,6508
33428,486,1788,0,33428,10283,23145,8.51843e+15,787.965,5795.67,33428,376,335,30702,29281,25020,24983,11716
36305,400,2276,21244,15061,0,36305,4.78606e+18,1106.21,6737.85,36305,435,337,31115,28003,20358,19405,7465
27599,1152,1846,0,27599,8244,19355,9.22302e+15,507.376,5275.52,27599,357,346,25753,25453,25211,25117,20946
13998,214,225,0,13998,13761,237,2.50385e+16,103.066,1228.05,13998,75,88,13773,13773,13759,13738,13658
26928,1,43,26521,407,26928,0,1.00097e+14,16.2419,559.405,26928,25,24,11439,11439,11439,11439,11439
11775,245,1696,11775,0,10376,1399,1.74751e+18,525.167,3608.49,11775,273,223,8352,6614,4936,3826,1212
19633,1250,1305,5979,13654,0,19633,3.57698e+13,384.798,3712.12,19633,285,273,18328,18328,18322,18322,18225
46458,1095,2940,0,46458,0,46458,2.40004e+18,812.965,8569.45,46458,423,511,43454,41817,38520,37501,19850
34290,129,286,0,34290,33672,618,2.47527e+16,124.586,2002.63,34290,109,106,33981,33806,31015,30443,25535
45494,3071,4808,40321,5173,27954,17540,1.92802e+18,1075.74,11022.2,45494,456,597,40686,40534,39406,39682,34556
26058,1221,4096,26058,0,23343,2715,2.00769e+18,964.387,7995.87,26058,451,505,21716,19838,14562,13102,10923
6522,824,1004,0,6522,0,6522,2.5376e+18,432.651,2079,6522,206,199,5518,5047,5280,4995,5103
8999,538,1249,0,8999,2493,6506,9.41876e+15,262.946,2634.82,8999,207,191,7750,7599,7119,7180,4692
926,2,16,919,7,926,0,1.17332e+14,7.4622,88.3104,926,10,11,652,580,529,574,347
17881,269,2178,0,17881,0,17881,2.40688e+18,494.183,4857.44,17881,299,377,14448,12219,8982,6552,2176
16365,2410,2487,0,16365,0,16365,2.18874e+18,546.089,4985.8,16365,293,295,13878,13876,13856,13876,13807
10348,724,843,2916,7432,0,10348,3.83902e+13,484.769,2364.58,10348,252,205,9494,8956,9306,9284,8907
41801,2166,3424,37759,4042,24206,17595,1.88273e+18,686.984,8653.57,41801,444,460,38377,38247,35201,34793,28024
660,28,244,397,263,397,263,2.06647e+18,38.85,347.067,660,39,63,382,265,201,191,35
34275,2663,3385,20908,13367,20908,13367,1.82517e+18,845.975,7829.01,34275,475,447,30890,30681,30513,30662,26886
48308,284,2067,13948,34360,0,48308,3.68063e+13,808.193,7259.02,48308,436,401,42198,38663,28520,22733,13166
29844,2089,3354,18012,11832,18012,11832,1.88988e+18,730.835,7530.32,29844,402,449,26490,26240,25745,26019,17695
22093,662,2683,22093,0,20116,1977,1.51172e+18,821.39,5894.97,22093,363,340,18659,17234,13575,12455,6248
7428,1,44,7327,101,7428,0,1.03109e+14,14.2076,328.358,7428,21,19,2995,2995,2995,2995,2995
23113,437,584,23113,0,23113,0,4.015e+18,320.999,2676.82,23113,178,182,22529,22469,21771,21762,21429
4730,17,21,4667,63,4730,0,8.70016e+13,13.0383,207.344,4730,16,16,4709,4705,4692,4692,4638
7283,1095,1105,0,7283,0,7283,2.47999e+18,296.572,2248.81,7283,230,156,6178,6178,6177,6178,6172
1444,271,582,868,576,0,1444,4.55278e+18,64.3082,813.212,1444,132,63,862,829,635,648,404
38595,362,3104,34508,4087,23557,15038,1.94266e+18,946.458,8197.63,38595,443,483,30057,23874,13440,13447,9369
43164,674,2535,0,43164,12951,30213,9.16275e+15,719.744,7762.09,43164,468,419,40137,39026,34165,34220,19439
16649,348,1409,4822,11827,0,16649,3.59076e+13,374.457,3549.41,16649,319,279,14954,14098,11232,11343,4934
39182,667,3235,23210,15972,0,39182,4.57084e+18,730.162,8170.08,39182,413,553,35164,33278,25748,23715,13002
22142,1481,1867,0,22142,6555,15587,9.4635e+15,368.585,4911.51,22142,265,394,20275,20247,20164,20098,17038
1743,29,83,0,1743,1729,14,2.69131e+16,37.4194,257.244,1743,33,35,1631,1600,1493,1455,1204
19999,1810,2437,17738,2261,11727,8272,1.92111e+18,801.826,5471.59,19999,412,289,17562,17260,16950,16827,15236
1649,207,487,945,704,945,704,1.67521e+18,80.5258,795.686,1649,84,89,1162,1128,1088,1072,571
34733,1916,3522,34733,0,30783,3950,2.74845e+18,1538.77,8665.85,34733,515,488,30592,28095,26908,25683,19870
9984,510,765,0,9984,3106,6878,7.19936e+15,168.893,2010.7,9984,149,145,9219,9214,9180,9167,8183
23728,1485,2262,0,23728,0,23728,2.35362e+18,639.446,5681.01,23728,368,412,21466,21421,19585,17858,17415
9749,162,528,9749,0,9749,0,4.6096e+18,241.584,1723.8,9749,131,132,8721,7721,5284,5100,4411
41120,2199,2652,0,41120,0,41120,2.22586e+18,772.504,7722.01,41120,420,387,38468,38431,37363,36525,35891
26207,182,234,0,26207,25725,482,2.4966e+16,136.338,1632.13,26207,98,106,25967,25901,24848,24656,23247
26160,1,42,25599,561,26160,0,9.83228e+13,17.9097,554.148,26160,25,24,10980,10980,10980,10980,10980
32205,22,62,31550,655,32205,0,1.01211e+14,18.6677,656.883,32205,25,28,32140,32122,29753,29511,22081
16880,219,2402,16880,0,15387,1493,1.74375e+18,885.663,5070.33,16880,371,267,11825,9712,5173,4484,2546
30093,2362,2422,18411,11682,0,30093,4.93914e+18,930.528,6408.83,30093,404,401,27671,27671,27636,27631,27627
37931,13,74,37310,621,37931,0,1.04974e+14,19.7987,743.312,37931,27,31,37725,37574,33481,33116,21661
19097,859,1774,0,19097,5778,13319,9.3135e+15,359.625,4544.89,19097,259,355,17323,17179,16541,16527,10900
1501,1,1,1407,94,1501,0,0,0.999334,38.7427,1501,1,1,1500,1500,1500,1500,1500
3342,71,943,2044,1298,2044,1298,1.76057e+18,243.516,1539.28,3342,169,155,1955,1417,1015,871,275
5902,1055,1199,3565,2337,3565,2337,1.89693e+18,388.763,2212,5902,207,228,4703,4527,4636,4656,4433
44173,33,48,43338,835,44173,0,9.66332e+13,19.0262,711.23,44173,26,26,44125,44125,42800,42800,39942
8859,106,1009,2900,5959,0,8859,3.62295e+13,308.931,2417.48,8859,175,256,6835,5854,4367,3689,1961
26836,1093,2549,15682,11154,0,26836,4.79464e+18,756.153,6231.28,26836,374,418,24287,23664,22143,21901,15678
38562,1181,2398,34124,4438,22871,15691,1.92117e+18,1046.71,6947.54,38562,472,393,35918,33867,33024,32999,28739
26425,80,679,26425,0,26425,0,4.17847e+18,291.392,2941.06,26425,186,183,21112,15289,11130,11247,5278
12803,961,1248,7875,4928,7875,4928,1.82212e+18,500.849,3207.12,12803,272,207,11555,11513,11263,11391,10418
44847,328,4214,44847,0,39994,4853,2.29139e+18,1256.02,10179.4,44847,500,657,36689,32717,16418,10731,8300
22155,1105,2673,13356,8799,13356,8799,1.83829e+18,718.22,5952.59,22155,509,272,19482,18655,17002,15488,10091
7256,502,545,7256,0,7256,0,3.94416e+18,239.317,1543.82,7256,126,117,6711,6711,6688,6691,6569
26956,645,666,26950,6,26956,0,3.99518e+18,334.377,2937.69,26956,188,187,26290,26290,26285,26284,26270
18346,1653,2729,18346,0,16451,1895,1.81774e+18,451.095,5323.17,18346,293,295,15617,15526,15305,14851,10438
12143,72,509,12143,0,12143,0,3.97007e+18,257.511,1911.88,12143,145,145,9352,6531,5227,4797,2454
22670,1492,2624,0,22670,0,22670,2.47485e+18,749.065,5865.71,22670,393,339,20046,19412,18845,16602,12258
21178,7,34,20660,518,21178,0,9.79011e+13,17.2609,471.388,21178,21,20,20798,20554,18162,18131,12358
23935,1158,1698,7692,16243,0,23935,3.41696e+13,582.985,4777.28,23935,382,348,22237,22198,21799,21845,20558
24344,1575,2601,0,24344,0,24344,2.07472e+18,614.811,5842.17,24344,276,360,21743,21365,21215,21128,16016
7858,1601,1715,7858,0,7216,642,1.35362e+18,201.753,2954.25,7858,197,200,6143,6141,6141,6104,5747
9347,1291,1680,5606,3741,5606,3741,1.87592e+18,353.635,3207.15,9347,278,200,7667,7661,7582,7625,6457
16429,1325,1782,9381,7048,9381,7048,1.70479e+18,685.322,4296.73,16429,262,355,14647,14020,14348,14462,13043
17458,366,2135,0,17458,0,17458,2.09485e+18,327.536,4483.61,17458,287,220,15148,13899,7566,8447,3270
23851,19,66,23359,492,23826,25,1.05457e+14,15.8806,597.536,23851,27,27,23782,23766,21663,21626,14636
37659,1319,2922,21746,15913,0,37659,4.36967e+18,902.195,7742.37,37659,433,417,34647,33774,30766,30287,20757
35607,1159,2175,10508,25099,0,35607,3.62861e+13,668.168,6477.4,35607,421,385,33432,33076,31294,31425,21195
10801,405,1582,6372,4429,0,10801,4.88315e+18,565.029,3327.35,10801,250,279,8640,7880,6111,5577,2868
42209,68,1006,42098,111,42209,0,4.02162e+18,360.037,4087.23,42209,225,224,32044,22468,16920,15860,5041
26890,358,2728,15984,10906,15984,10906,1.78991e+18,893.628,6434.17,26890,432,373,22184,19526,14778,12034,5008
38881,60,2405,11460,27421,0,38881,3.57458e+13,666.857,7259.58,38881,451,496,28268,23589,17931,7234,3219
47340,1336,3386,28163,19177,0,47340,4.81822e+18,1310.44,9154.25,47340,542,553,43499,40993,31246,30166,25753
44807,129,262,0,44807,43726,1081,2.59126e+16,149.072,2204.33,44807,105,113,44442,44170,40697,40276,31234
48788,322,2598,48763,25,42839,5949,2.99795e+18,1545.85,8583.5,48788,506,477,37905,30326,14360,7514,7867
15634,853,2564,13969,1665,9316,6318,1.92371e+18,473.572,4954.49,15634,326,247,13070,12636,8835,7649,3730
19088,627,1288,5986,13102,0,19088,3.4571e+13,520.209,3928.63,19088,267,414,17685,17347,15713,15813,11717
1267,53,250,0,1267,462,805,7.2806e+15,75.8003,479.916,1267,83,69,895,739,392,393,345
34108,1273,2338,0,34108,10500,23608,9.15235e+15,605.255,6666.83,34108,394,621,31770,31519,29939,29848,18982
19809,320,1572,0,19809,0,19809,2.43358e+18,680.747,4220.86,19809,344,276,16022,13732,9626,9357,4244
25593,1126,2393,0,25593,0,25593,2.40049e+18,895.689,6215.09,25593,375,483,23054,21665,21070,19596,14596
3574,557,679,0,3574,1039,2535,9.6281e+15,158.256,1285.21,3574,140,120,2895,2858,2891,2885,2582
27766,103,2293,16590,11176,16590,11176,1.9303e+18,923.521,6100.94,27766,395,448,18800,15687,11465,8595,1755
37296,44,48,36598,698,37296,0,9.68743e+13,19.6526,650.737,37296,25,27,37248,37248,37170,37171,37102
24901,16,40,24585,316,24901,0,1.00219e+14,17.4838,522.105,24901,23,23,24839,24800,23311,23279,19683
38926,1067,2206,11777,27149,0,38926,3.6677e+13,693.836,6747.93,38926,446,450,36720,36372,32370,32349,20378
42650,253,281,0,42650,41987,663,2.60185e+16,137.725,2251.36,42650,104,107,42369,42369,42210,42023,41186
23158,1373,2632,13766,9392,0,23158,4.95893e+18,742.366,5944.83,23158,398,477,20526,19988,19467,19183,11409
42741,644,1736,12600,30141,0,42741,3.63183e+13,839.836,6391.13,42741,470,375,40265,39172,35631,35911,23976
33900,108,2030,20417,13483,20417,13483,1.8471e+18,1075.69,6156.18,33900,429,366,23847,19237,15708,12217,2396
13653,430,1240,4244,9409,0,13653,3.04008e+13,266.243,3038.11,13653,215,315,12413,12012,11056,11075,4135
27399,6,55,27009,390,27399,0,9.66504e+13,17.9874,604.047,27399,23,26,26377,25280,22478,22259,13407
18394,823,1851,10736,7658,10736,7658,1.79706e+18,422.504,4453.01,18394,342,283,16543,16329,14918,14439,12192
39993,1327,3888,23663,16330,23663,16330,1.77982e+18,964.95,9544.05,39993,473,723,35785,35257,31545,31073,15800
22228,842,2343,20171,2057,13035,9193,1.90463e+18,621.737,5443.95,22228,313,339,19885,19206,17197,17603,11331
33088,924,3143,0,33088,0,33088,2.34389e+18,643.626,7485.44,33088,378,480,29726,28405,26910,20822,15955
33520,1515,3084,19475,14045,19475,14045,1.74803e+18,782.243,7740.73,33520,500,427,30436,30053,27705,26101,19478
30700,689,1755,0,30700,9690,21010,9.09882e+15,589.32,5280.29,30700,351,345,28852,28034,23544,23710,18955
37946,2946,3829,22693,15253,22693,15253,1.8228e+18,966.888,9071.79,37946,491,575,34117,34070,33579,33616,30744
44553,2438,3848,44553,0,39739,4814,1.74455e+18,1330.08,9858.23,44553,511,481,40705,39985,39690,39317,33985
15970,604,1734,4525,11445,0,15970,3.69041e+13,322.737,4092.14,15970,271,331,14236,13994,12886,12948,7152
33137,1063,3061,33137,0,30202,2935,2.18941e+18,863.292,7115.96,33137,445,309,29893,28574,27396,26310,15176
45403,214,2647,0,45403,14137,31266,8.93565e+15,746.969,7842.03,45403,431,371,39818,36064,23958,22121,8607
15263,133,1261,0,15263,4602,10661,8.9515e+15,424.267,3406.04,15263,295,300,12421,10890,9162,9062,2143
48016,213,349,0,48016,47285,731,2.62158e+16,158.448,2636.84,48016,109,124,47667,47592,45121,43846,40497
19793,337,596,19793,0,19793,0,4.98242e+18,311.317,2477.46,19793,167,165,19152,18799,15152,14946,13921
18694,490,961,0,18694,5869,12825,9.45102e+15,385.753,3037.3,18694,246,222,17733,17622,15431,15571,14076
32119,1525,2993,19417,12702,0,32119,4.85871e+18,686.492,7341.43,32119,508,390,29126,28676,26706,26154,18535
5864,8,30,5706,158,5864,0,1.04353e+14,13.9253,262.516,5864,17,18,5750,5709,4916,4837,3205
7988,14,28,7867,121,7988,0,9.48941e+13,15.8683,290.742,7988,20,19,7945,7925,7440,7420,6692
49560,2489,4372,28718,20842,0,49560,4.57236e+18,948.111,10870,49560,598,558,45188,44736,42855,42392,34919
8138,1664,1729,7020,1118,4715,3423,2.08731e+18,292.562,3057.47,8138,214,224,6409,6409,6407,6409,6315
47202,44768,47202,47202,0,47202,0,6.8718e+10,0,47202,47202,47202,1,0,0,0,0,0
34121,1602,1710,0,34121,0,34121,2.37489e+18,897.977,5609.18,34121,467,326,32411,32411,32287,32272,31929
26565,2085,2948,0,26565,0,26565,2.32653e+18,816.374,6668.51,26565,402,394,23617,23491,22730,21844,18233
20816,1372,1966,0,20816,6083,14733,9.48624e+15,407.637,4845.94,20816,458,337,18850,18773,17972,18105,14949
7174,668,1248,4310,2864,0,7174,4.69759e+18,320.588,2406.65,7174,265,192,5926,5770,5498,5253,4864
5806,1039,1680,5251,555,3548,2258,1.96499e+18,242.145,2632.64,5806,233,189,4126,4018,3865,3899,2829
38095,2630,3364,38095,0,33836,4259,2.72948e+18,931.535,8432.55,38095,512,433,34731,34709,33409,33216,31399
24235,814,3193,24235,0,21531,2704,1.92829e+18,717.541,7105.65,24235,414,376,20502,18408,14438,12577,5511
32216,1597,2180,0,32216,9840,22376,9.3636e+15,473.805,6041.69,32216,307,331,30036,29985,29827,29789,27629
24912,413,841,0,24912,7942,16970,6.89297e+15,435.968,3056.33,24912,233,197,23752,23203,22283,22382,14367
40731,3174,3674,0,40731,0,40731,2.37893e+18,848.907,9053.06,40731,528,469,37057,37018,36887,37019,33626
48317,1912,4417,48317,0,42911,5406,2.33128e+18,1635.73,10983.1,48317,535,517,43459,41796,35977,32266,24435
12482,136,1256,3337,9145,0,12482,3.78093e+13,343.254,3044.41,12482,231,245,10127,8769,6984,6741,2538
23992,495,2372,14451,9541,0,23992,4.91615e+18,671.556,5893.12,23992,386,362,20384,18448,14595,12852,7618
31332,15,91,30690,642,31332,0,1.02279e+14,21.1871,745.825,31332,31,29,31185,31112,27475,27350,14682
38158,2046,3312,38158,0,34015,4143,2.05239e+18,1163.45,8653.04,38158,409,426,34846,34692,33603,33392,30069
31261,116,1952,0,31261,8964,22297,9.71921e+15,568.806,5862.54,31261,389,418,24963,21732,16422,14650,5271
20296,1970,2036,0,20296,0,20296,2.28554e+18,600.296,4925.13,20296,273,344,18260,18260,18260,18260,18199
6626,87,887,2265,4361,0,6626,2.91689e+13,189.253,1849.75,6626,261,143,5256,4566,2643,2122,663
20747,211,274,0,20747,20372,375,2.7695e+16,120.053,1627.87,20747,86,91,20473,20462,20139,20045,18109
28645,884,2420,17006,11639,0,28645,4.87328e+18,986.565,6362,28645,416,443,25313,23960,19887,19620,13437
19716,170,563,19716,0,19716,0,4.08558e+18,295.934,2384.83,19716,164,166,18500,17193,12341,12213,7834
4554,128,600,1396,3158,0,4554,3.76472e+13,198.191,1388.41,4554,139,192,3627,3125,2773,2804,1483
1759,115,386,0,1759,535,1224,9.34502e+15,129.093,686.303,1759,87,86,1277,1120,1065,1075,717
6944,595,674,6351,593,3566,3378,1.79833e+18,179.768,1611.12,6944,147,132,6270,6268,6262,6268,5959
4878,554,788,0,4878,1551,3327,9.29297e+15,242.941,1652.81,4878,187,218,4090,3988,3906,3895,3603
17647,1488,1891,17647,0,15437,2210,9.78896e+17,552.657,4491.57,17647,261,334,15756,15718,15505,15527,14648
25421,5,73,25022,399,25421,0,1.07559e+14,17.7101,630.928,25421,28,27,24037,23007,20724,20857,11128
24604,490,1358,7003,17601,0,24604,3.69845e+13,594.535,4280.12,24604,319,279,22787,21708,20041,20094,12543
19184,108,252,0,19184,18732,452,2.54028e+16,117.267,1443.3,19184,82,85,18870,18643,17200,16696,13031
24238,3516,3969,24238,0,21813,2425,2.57966e+18,585.002,7736.2,24238,424,371,20269,20195,20269,20260,18222
33736,1038,4426,33736,0,30135,3601,2.7684e+18,777.895,9301.27,33736,447,426,29022,27207,22918,20077,10571
35299,2458,3196,21208,14091,21208,14091,1.79704e+18,885.771,7880.64,35299,435,431,32103,32029,31673,31863,28075
4531,67,1060,0,4531,0,4531,2.17851e+18,285.661,1869.04,4531,174,156,2687,1873,1340,648,302
16487,818,1371,5048,11439,0,16487,3.40066e+13,431.439,3473.11,16487,241,227,15116,14841,14826,14824,12600
13278,247,1972,8142,5136,8142,5136,1.81327e+18,469.155,4082.64,13278,300,338,10304,8669,7402,6062,2244
1450,410,433,501,949,0,1450,4.04044e+13,53.8138,665.499,1450,120,104,1017,1017,1017,1017,999
41042,1548,3219,0,41042,0,41042,2.31443e+18,1028.98,8377.35,41042,476,421,37823,37158,34309,32262,23411
36959,3528,3859,0,36959,0,36959,2.32589e+18,1286.31,9133.6,36959,521,698,33100,33044,33004,32993,32490
35789,782,874,35738,51,35789,0,4.364e+18,360.577,3682.21,35789,209,212,34915,34911,34666,34693,34626
34245,2572,2643,20558,13687,20558,13687,1.88735e+18,916.188,7023.72,34245,399,474,31602,31602,31573,31589,31542
39327,139,3075,23617,15710,0,39327,4.81598e+18,1172.37,8272.75,39327,475,559,28512,23533,16196,12064,4065
26426,1776,1964,16383,10043,0,26426,4.8878e+18,547.69,5136.54,26426,369,304,24462,24455,24435,24435,24323
48829,462,2708,0,48829,14938,33891,9.16764e+15,496.689,8060.49,48829,345,463,45637,44157,35820,36591,18670
16748,195,225,0,16748,16412,336,2.68216e+16,105.161,1328.92,16748,74,80,16523,16515,16481,16386,15861
20903,1920,2089,12445,8458,12445,8458,1.85065e+18,601.691,4932.49,20903,376,276,18814,18813,18754,18754,18530
5233,30,147,0,5233,5106,127,2.54743e+16,58.3174,551.174,5233,48,56,4956,4826,4218,3990,2446
1336,8,12,1310,26,1336,0,9.60725e+13,7.58383,92.8148,1336,9,10,1322,1321,1304,1307,1277
22884,336,799,22884,0,22884,0,4.56265e+18,331.041,2917.6,22884,184,193,22007,21491,16107,15455,15728
30850,222,980,30844,6,30850,0,3.93437e+18,337.13,3521.5,30850,215,200,29134,27344,17853,16837,12279
9862,803,2086,0,9862,0,9862,2.42549e+18,266.206,3634.05,9862,271,226,7776,7626,7185,6949,4171
37250,10,278,0,37250,36502,748,2.61555e+16,150.008,2071.06,37250,103,121,33019,30555,26774,22470,13185
26102,206,250,0,26102,25362,740,2.5994e+16,126.605,1630.64,26102,85,85,25852,25848,25292,25285,23901
15960,1168,2056,8937,7023,0,15960,4.1501e+18,347.054,4254.14,15960,227,356,13904,13754,13537,13512,9200
29517,108,252,0,29517,28860,657,2.71562e+16,113.838,1854.14,29517,81,99,29213,29018,26016,25126,19309
12454,155,233,0,12454,12251,203,2.73269e+16,98.9359,1157.18,12454,76,74,12221,12190,11819,11722,10931
17756,1225,2182,17756,0,16051,1705,1.76236e+18,816.845,5010.23,17756,322,286,15348,14496,13815,13557,10993
41032,1651,4065,37104,3928,24185,16847,1.9767e+18,1285.01,9862.43,41032,457,566,36464,35387,31894,31934,18463
8417,22,40,8243,174,8417,0,1.05942e+14,16.8698,326.633,8417,21,19,8376,8369,7803,7805,6422
30330,8,294,0,30330,29694,636,2.60007e+16,144.327,2029.63,30330,91,98,26038,22588,20678,18354,10182
47526,65,108,46550,976,47526,0,1.049e+14,19.098,933.319,47526,33,34,47418,47418,46018,46029,37340
13365,58,538,13365,0,13365,0,4.10749e+18,274.554,2011.64,13365,153,146,9711,6957,5166,4648,2095
2400,570,2400,2400,0,0,2400,15.9933,0,2400,2400,2400,1,0,0,0,0,0
16956,197,1345,0,16956,0,16956,2.47012e+18,787.181,3748.62,16956,298,266,12939,10896,7978,8103,3753
18067,234,2413,10909,7158,0,18067,4.78109e+18,506.952,5212.28,18067,380,284,13705,11082,6561,5027,3047
28258,1380,2710,16532,11726,16532,11726,1.8032e+18,772.344,6746.08,28258,336,416,25447,24087,24252,24437,14723
42449,1994,3673,23733,18716,0,42449,4.56986e+18,903.103,8999.89,42449,379,574,38776,38048,37959,37918,28834
15997,143,218,0,15997,15635,362,2.49952e+16,105.178,1273.39,15997,81,82,15779,15706,15098,14865,13792
10757,120,2019,10757,0,9626,1131,2.78505e+18,564.187,3826.22,10757,255,226,6710,5241,3355,2961,935
30076,1695,3268,18072,12004,18072,12004,1.87826e+18,942.11,7615.45,30076,550,350,26808,25771,25067,24406,20162
32720,22,290,0,32720,32147,573,2.58721e+16,112.725,1843.19,32720,87,104,30589,29547,25857,20783,12275
34476,11,315,0,34476,34093,383,2.59024e+16,145.752,2014.35,34476,105,108,30819,28276,25312,21137,12331
38132,72,293,0,38132,37208,924,2.57679e+16,146.839,2256.8,38132,109,116,37322,36746,31911,29123,21043
40317,1577,3293,23902,16415,23902,16415,1.83265e+18,1033.92,8518.65,40317,499,394,37024,35998,33770,32076,23071
30251,369,704,30239,12,30251,0,4.05102e+18,338.291,3171.51,30251,194,190,29512,29204,25657,25483,23172
19375,17,31,19092,283,19357,18,1.00997e+14,19.4366,494.251,19375,20,24,19324,19286,17600,17568,15165
36710,581,1733,11558,25152,0,36710,3.49349e+13,450.307,5642.21,36710,340,320,34946,34474,30544,30603,21967
7668,389,757,0,7668,0,7668,1.66948e+18,144.667,1732.89,7668,158,136,6911,6872,6808,6742,6347
32227,756,1358,0,32227,9545,22682,9.34062e+15,670.214,4656.57,32227,349,321,30811,30253,28515,28740,20928
28268,1492,1678,8681,19587,0,28268,3.2968e+13,483.715,5006.67,28268,327,300,26590,26522,26557,26549,25050
26261,936,2292,15596,10665,0,26261,4.83073e+18,843.041,6017.24,26261,309,426,23583,22153,20743,20156,12917
13173,1548,2045,8103,5070,8103,5070,1.85112e+18,687.977,4163.05,13173,290,338,11128,10670,10832,10955,9425
34964,411,2089,10711,24253,0,34964,3.61886e+13,660.4,5997.59,34964,377,404,32149,30208,20509,20362,10882
25057,3439,3701,25032,25,21844,3213,1.15791e+18,680.418,7724.83,25057,339,553,21356,21356,21331,21322,20569
34691,1946,2793,19439,15252,19439,15252,1.58046e+18,590.343,6928.88,34691,289,461,31898,31869,31448,31617,27765
43562,1887,4090,25970,17592,25970,17592,1.88967e+18,938.995,9877.8,43562,434,605,39472,38757,37756,38011,24306
38193,1240,3519,22940,15253,0,38193,4.95302e+18,813.581,8523.86,38193,497,511,34597,33673,31513,30413,12545
40196,31,55,39200,996,40196,0,1.03435e+14,20.967,719.711,40196,27,26,40141,40135,38980,38983,33888
35044,1185,1963,0,35044,9839,25205,9.45136e+15,899.673,6146.45,35044,454,393,32949,32138,30741,30833,25998
22115,2287,2407,0,22115,0,22115,2.44503e+18,921.037,5753.97,22115,359,368,19708,19575,19644,19611,19479
20274,1090,1985,6282,13992,0,20274,3.32301e+13,335.767,4990.68,20274,414,434,18289,18185,16925,16574,12575
27060,1627,1678,0,27060,8510,18550,8.9432e+15,524.943,4799.45,27060,351,316,25382,25382,25372,25371,25282
9179,138,1432,5809,3370,5809,3370,1.74949e+18,442.706,2982.45,9179,266,202,6100,4958,3981,3163,1588
49857,106,264,0,49857,49051,806,2.48084e+16,180.32,2486.79,49857,128,119,49207,48650,42613,40964,31577
47471,875,2229,14953,32518,0,47471,3.49302e+13,596.874,7385.29,47471,488,416,45242,44876,40661,40849,34067
29233,2163,2860,17807,11426,17807,11426,1.87224e+18,831.407,7034.56,29233,489,346,26373,26288,25893,25721,23189
5691,115,146,0,5691,5605,86,2.57286e+16,59.7826,630.154,5691,46,51,5545,5520,5455,5504,5049
44176,2282,4830,44176,0,39533,4643,1.9735e+18,1135.45,11009.6,44176,491,490,39346,37961,36642,34562,25692
47530,4008,4096,43434,4096,47530,0,9.15852e+15,3743.02,13949.8,47530,4096,13,42554,0,41586,42456,42554
2533,761,994,2533,0,2223,310,2.88511e+18,100.861,1415.27,2533,148,135,1539,1538,1432,1405,1376
33366,141,263,0,33366,32465,901,2.67188e+16,150.412,1990.38,33366,108,115,32997,32661,30004,29437,23999
42804,990,2993,0,42804,0,42804,2.3635e+18,1329.59,8475.76,42804,566,591,38446,37146,27803,26602,15582
42811,202,293,0,42811,42084,727,2.61361e+16,161.597,2253.4,42811,112,113,42509,42429,40852,40793,38007
32098,1635,3340,32098,0,28874,3224,2.6086e+18,1080.58,7892.64,32098,427,443,28707,26836,21903,20853,19621
33085,146,3401,19604,13481,0,33085,4.8769e+18,792.514,7942.08,33085,549,450,23965,19713,14780,10743,1509
606,37,46,0,606,593,13,3.00835e+16,15.2723,128.367,606,19,20,560,560,558,559,536
22912,470,2265,20506,2406,13160,9752,1.90858e+18,416.03,5375.29,22912,329,325,20473,16910,8113,8577,6164
38800,1615,2409,23588,15212,0,38800,4.80966e+18,1063.23,7000.06,38800,443,401,36391,35704,34153,33694,30812
10619,955,1077,3395,7224,0,10619,3.5266e+13,362.153,2704.73,10619,250,268,9542,9503,9367,9364,9215
23826,2403,2426,23826,0,21094,2732,1.75347e+18,995.804,6083.18,23826,414,369,21400,21400,21400,21400,21382
39339,1731,2633,13028,26311,0,39339,3.37121e+13,498.407,7331.14,39339,529,419,36706,36686,35271,35419,30018
4307,5,19,4227,80,4307,0,9.18865e+13,12.8291,194.423,4307,14,14,4118,4004,3535,3493,2734
9029,597,955,2843,6186,0,9029,3.15523e+13,280.503,2349.23,9029,190,198,8074,7900,7703,7710,5720
16236,301,1572,4793,11443,0,16236,3.72205e+13,386.446,3822.54,16236,309,237,14167,12713,10413,10451,6234
46259,987,2676,0,46259,14059,32200,9.21429e+15,807.942,8101.7,46259,473,466,43500,42311,36608,36544,26769
34560,67,95,33932,628,34560,0,1.02377e+14,16.9316,782.204,34560,30,32,34465,34465,33646,33646,30185
40469,1018,2133,12434,28035,0,40469,3.58777e+13,834.572,7033.03,40469,468,418,38111,36823,35320,35403,26032
21285,713,1649,7104,14181,0,21285,3.36599e+13,470.798,4347.09,21285,346,312,19636,19060,17497,17490,14991
8949,788,1283,5427,3522,0,8949,4.56609e+18,490.169,2793.12,8949,208,197,7666,7175,6973,6778,5944
30266,2041,2270,17963,12303,17963,12303,1.84982e+18,881.513,6373.85,30266,442,444,27996,27979,27772,27909,27388
47584,1390,2346,0,47584,14072,33512,9.19401e+15,839.302,7629.38,47584,548,404,45238,44870,41148,41372,34586
10217,250,494,10217,0,10217,0,4.23734e+18,278.431,1747.14,10217,135,133,9591,9121,7134,7129,6559
20333,18,40,20013,320,20333,0,1.02274e+14,20.1218,496.866,20333,25,24,20274,20250,18861,18819,15126
13746,118,1804,13746,0,12113,1633,2.97286e+18,694.786,3966.75,13746,277,302,8772,6669,3977,2724,668
17507,1696,1877,10337,7170,10337,7170,1.79735e+18,769.906,4542.41,17507,334,352,15630,15625,15462,15542,15205
19974,840,1611,5804,14170,0,19974,3.66684e+13,563.931,4304.43,19974,362,363,18355,18022,17292,17340,12632
45667,2257,4659,40784,4883,26386,19281,1.92712e+18,1312.62,10871,45667,505,545,41008,39952,37836,38001,25353
24351,1299,2019,0,24351,7391,16960,9.06426e+15,380.363,5230,24351,297,343,22332,22269,22048,22029,16918
44861,282,334,0,44861,44198,663,2.59633e+16,133.661,2564.61,44861,110,120,44527,44523,44055,43661,41865
2289,428,573,2051,238,1380,909,1.96722e+18,259.14,1010.47,2289,109,113,1716,1360,1539,1511,1433
15712,1328,1490,4640,11072,0,15712,3.66183e+13,522.989,3789.92,15712,321,274,14222,14121,14183,14200,13731
9154,272,1955,8158,996,5334,3820,1.89599e+18,365.345,3523.27,9154,253,232,6922,6043,2891,2746,1127
42747,359,2079,12913,29834,0,42747,3.61866e+13,875.159,7001.07,42747,498,477,38348,35951,27378,27460,13672
42530,340,620,42505,25,42530,0,4.14238e+18,348.756,3489.73,42530,217,219,41803,41357,35150,34833,34500
32497,715,2762,19881,12616,0,32497,4.75172e+18,1002.06,7063.61,32497,412,452,28190,25666,17459,16069,14171
7343,446,1577,6624,719,4356,2987,2.02546e+18,437.272,2837.15,7343,249,214,5530,5055,3572,3250,2050
34485,2772,3391,20336,14149,0,34485,4.57814e+18,684.83,8158.69,34485,474,433,31094,31083,30539,30500,27529
13879,387,1174,4136,9743,0,13879,3.75663e+13,389.864,3103.34,13879,224,270,12555,11852,10641,10627,7627
14413,336,2042,12614,1799,8405,6008,1.95024e+18,678.954,4508.06,14413,248,332,10910,9057,5203,5244,3085
19016,1033,1906,0,19016,0,19016,2.4584e+18,699.232,4557.2,19016,386,259,17110,16389,16143,15304,11230
41147,2085,3891,36752,4395,24060,17087,1.94215e+18,1272.97,9439.36,41147,500,501,37256,36095,31626,31175,23427
1885,416,639,1162,723,1162,723,2.11192e+18,73.6928,942.819,1885,128,118,1246,1233,1219,1225,846
9444,70,1710,9444,0,8459,985,1.46421e+18,351.815,3326.59,9444,223,269,5420,3662,2276,1703,901
18339,2173,2207,10738,7601,10738,7601,1.74874e+18,437.741,4899.71,18339,273,250,16132,16132,16132,16132,16052
34104,112,259,0,34104,33397,707,2.46573e+16,145.602,1941.81,34104,103,104,33671,33355,30290,30456,25292
29573,2302,4300,29573,0,26689,2884,2.01562e+18,784.137,8451.92,29573,511,472,25273,24891,24830,24889,12390
11313,38,1433,0,11313,3213,8100,9.256e+15,324.267,3300.59,11313,261,397,7676,5879,4803,4685,776
24038,712,2608,24007,31,21578,2460,1.4459e+18,717.792,5860.82,24038,355,355,20574,19540,13257,11420,10764
20833,1054,1291,6431,14402,0,20833,3.64653e+13,389.933,3773.4,20833,262,229,19542,19503,19485,19480,18753
47362,173,338,0,47362,46726,636,2.56634e+16,178.212,2475.99,47362,116,120,46971,46799,43379,41359,35729
1254,141,337,1254,0,1164,90,2.02737e+18,55.2209,539.28,1254,88,58,917,917,782,759,527
37039,130,834,37039,0,37039,0,4.27065e+18,356.037,3631.2,37039,211,208,33059,27998,17145,16859,9793
7813,747,860,0,7813,2421,5392,8.29695e+15,297.007,2105.32,7813,198,215,6953,6887,6884,6877,6521
25082,461,2082,7310,17772,0,25082,3.64951e+13,553.809,5733.18,25082,370,382,22571,21377,18405,18270,8027
42322,286,3819,42322,0,37334,4988,9.79678e+17,1240.5,9681.58,42322,431,579,32522,25919,22354,20938,5311
39816,174,839,39816,0,39816,0,4.21737e+18,360.263,3795.85,39816,219,225,36972,33691,21394,20460,14808
32314,248,329,0,32314,31550,764,2.59898e+16,130.842,2200.35,32314,99,98,31985,31976,31305,31181,29467
34984,1408,2084,21571,13413,21571,13413,1.84711e+18,669.97,6110.87,34984,414,373,32900,32586,32257,32190,29627
43361,38,244,0,43361,42745,616,2.53742e+16,142.525,2055.9,43361,115,104,41675,40616,34822,31127,20257
5573,593,1222,5002,571,3254,2319,1.90239e+18,306.622,2214.89,5573,213,150,4351,4212,3508,3469,3381
22224,42,46,21800,424,22224,0,1.01285e+14,17.8216,514.794,22224,25,24,22178,22178,22041,22041,22031
8958,1463,1654,5301,3657,5301,3657,1.78193e+18,289.431,3123.62,8958,217,296,7304,7304,7263,7278,6940
22765,428,1934,6659,16106,0,22765,3.48152e+13,390.473,5084.13,22765,296,367,20693,19884,17774,17760,6837
27888,650,2905,27888,0,24893,2995,2.98641e+18,1063.03,6879.59,27888,412,349,23750,20543,14176,12316,7046
49674,1053,1129,49664,10,49674,0,4.37403e+18,363.491,4517.17,49674,232,239,48545,48545,48386,48410,48325
38851,1351,3453,0,38851,0,38851,2.29834e+18,827.756,8857.27,38851,605,353,35299,33755,25056,23932,17867
18467,298,1645,5630,12837,0,18467,3.43373e+13,446.057,4203.25,18467,305,347,16368,15189,11659,11662,3661
830,163,285,0,830,273,557,7.90219e+15,46.7807,441.378,830,96,62,545,533,467,477,395
20053,1135,1330,6128,13925,0,20053,3.55348e+13,356.718,3604.6,20053,286,220,18723,18698,18694,18688,18209
6738,20,147,0,6738,6657,81,2.54095e+16,50.0064,647.763,6738,49,50,6334,6059,5483,4831,3147
7849,67,202,0,7849,7696,153,2.6853e+16,88.1065,909.814,7849,62,59,7578,7442,6597,6279,4252
2087,36,621,0,2087,0,2087,2.39576e+18,154.333,1000.41,2087,88,130,1078,710,598,244,166
7656,49,1171,2242,5414,0,7656,3.55398e+13,196.893,2381.91,7656,218,151,5305,4358,3545,3031,605
49147,12,63,48277,870,49147,0,9.80042e+13,20.6615,809.474,49147,27,28,48878,48674,43727,42914,27115
19795,642,2692,0,19795,0,19795,2.05333e+18,403.743,5486.43,19795,365,452,17103,16467,15416,14759,5227
38943,55,102,38503,440,38943,0,1.04768e+14,21.9813,844.309,38943,30,30,38841,38833,37462,37465,30391
47968,829,873,47968,0,47945,23,4.24491e+18,355.541,4146.47,47968,229,230,47095,47092,47019,47057,46965
46604,71,78,45392,1212,46604,0,9.79645e+13,17.8541,843.705,46604,29,29,46526,46526,46505,46505,46375
15429,29,2417,13899,1530,8791,6638,1.91765e+18,430.145,4889.78,15429,236,338,6873,3379,2372,2026,324
30829,433,3811,0,30829,0,30829,2.39495e+18,757.572,8454.14,30829,449,502,25256,22618,15394,11755,5161
46013,399,3879,0,46013,0,46013,2.34721e+18,903.936,10079.9,46013,389,632,38983,34398,23322,18093,6678
17311,1211,1647,5290,12021,0,17311,3.45861e+13,386.1,4088.41,17311,315,241,15664,15634,15133,15164,13643
31930,2915,3225,19026,12904,19026,12904,1.81671e+18,771.112,7680.66,31930,362,462,28705,28702,28505,28600,27883
28389,301,303,0,28389,27722,667,2.56513e+16,123.309,1897,28389,101,115,28086,28086,28086,28086,28081
33742,135,210,0,33742,33126,616,2.51141e+16,110.003,1639.53,33742,78,81,33505,33413,31770,31321,26712
42490,511,846,42490,0,42490,0,4.04854e+18,347.625,3877.56,42490,224,228,41644,41553,36143,36120,34543
32985,57,61,32407,578,32985,0,1.02094e+14,17.28,661.12,32985,26,27,32924,32924,32670,32670,32575
5583,532,1125,3265,2318,0,5583,5.15618e+18,252.738,2021.12,5583,211,144,4458,4258,4095,4005,2854
16184,18,270,0,16184,15934,250,2.60911e+16,99.9642,1434.63,16184,80,90,14928,14283,12294,10519,6249
40610,12,98,40082,528,40589,21,1.00121e+14,17.9144,840.267,40610,32,28,40378,40226,35817,35695,20210
1607,304,426,0,1607,0,1607,2.51984e+18,134.182,700.874,1607,89,73,1181,1073,1138,1134,932
17811,1497,1539,5670,12141,0,17811,3.57682e+13,407.716,4076.86,17811,289,432,16272,16272,16266,16266,16227
4184,592,932,0,4184,0,4184,2.47198e+18,185.727,1665.18,4184,126,205,3252,3207,3154,3222,2702
14370,530,1624,0,14370,4182,10188,9.27121e+15,337.578,3831.73,14370,366,346,12746,12373,10497,10283,5416
15589,236,691,15589,0,15589,0,4.41838e+18,291.021,2330.6,15589,160,164,14559,13489,9762,9509,8412
26566,748,1798,16324,10242,0,26566,4.81781e+18,491.671,5054.69,26566,307,290,24767,23898,20991,20822,15952
8024,34,1313,4742,3282,4742,3282,1.61394e+18,248.234,2747.42,8024,242,193,3981,1933,1615,1660,224
18060,2007,2529,18060,0,16349,1711,1.61147e+18,555.488,4982.54,18060,315,292,15531,15332,15356,15368,14343
9465,298,1860,9465,0,8404,1061,2.2855e+18,410.47,3574.91,9465,296,229,6944,5854,4166,3343,1608
30648,949,4075,30648,0,27236,3412,2.63547e+18,760.582,8795.3,30648,351,564,26125,24786,20154,19314,8892
36587,1609,2897,21268,15319,0,36587,4.57752e+18,1105.57,7594.56,36587,414,362,33658,32349,29544,28908,21143
1283,70,415,0,1283,414,869,8.54171e+15,38.304,633.924,1283,89,70,868,771,525,561,198
26502,2887,3054,23543,2959,16351,10151,1.95143e+18,961.282,7077.57,26502,424,441,23448,23448,23447,23443,23284
1166,324,451,741,425,741,425,1.78614e+18,67.3911,634.836,1166,101,64,715,677,699,686,591
28571,469,635,28571,0,28571,0,3.9703e+18,333.967,2982.59,28571,186,181,27936,27858,27280,27212,27016
35761,348,3735,20855,14906,20855,14906,1.77639e+18,868.777,8672.44,35761,374,551,30068,27042,21984,17379,3215
36743,1809,2063,11434,25309,0,36743,3.60458e+13,609.942,6623.94,36743,390,525,34680,34664,34552,34561,33746
46624,794,2565,14681,31943,0,46624,3.43129e+13,801.009,7794.26,46624,475,488,43599,42386,33989,34481,21215
2664,396,511,887,1777,0,2664,3.56109e+13,93.1674,954.782,2664,101,107,2153,2152,2148,2146,1997
45550,459,744,45550,0,45550,0,4.17179e+18,346.514,3863.85,45550,221,216,44806,44682,41388,40988,38488
20817,115,202,0,20817,20191,626,2.56288e+16,110.116,1301.28,20817,70,80,20579,20470,19258,19242,16694
19827,88,2070,19827,0,18003,1824,1.61853e+18,908.248,4917.87,19827,265,317,13050,8035,3695,2657,810
6835,234,881,1785,5050,0,6835,3.63668e+13,200.881,1936.97,6835,197,159,5873,5363,5133,5199,1897
25709,1477,1760,16213,9496,0,25709,4.89745e+18,586.347,4957.54,25709,346,357,23949,23940,23530,23379,22712
26695,57,749,26695,0,26695,0,4.46348e+18,293.439,2965.19,26695,187,183,19763,14283,9869,9404,3884
22987,191,2302,0,22987,0,22987,2.44422e+18,763.693,5640.71,22987,333,331,17352,14712,9470,6665,1699
21637,897,1402,21637,0,19721,1916,2.38023e+18,842.442,4013.17,21637,277,264,20000,18772,18737,19018,16049
39651,1734,2271,0,39651,12036,27615,9.18807e+15,526.501,6912.58,39651,355,458,37380,37363,37157,37134,31359
16577,287,2215,9326,7251,9326,7251,1.68767e+18,323.984,4613.27,16577,324,327,13898,12444,9980,9423,5311
38404,72,78,37618,786,38384,20,1.04011e+14,24.0191,772.318,38404,30,30,38326,38326,38159,38159,37817
24272,1047,2178,0,24272,0,24272,2.36133e+18,841.242,5631.17,24272,402,379,21922,20503,18401,14754,15053
11218,374,1677,0,11218,0,11218,2.22299e+18,487.755,3576.98,11218,264,227,9041,7917,5380,5483,2733
18119,374,500,18074,45,18119,0,4.02811e+18,295.248,2241.36,18119,165,161,17619,17556,16098,15955,14520
45456,788,1018,45456,0,45456,0,4.20039e+18,337.341,4185.55,45456,231,230,44438,44415,42308,42443,38935
21419,4090,21419,21419,0,0,21419,268423000,0,21419,21419,21419,1,0,0,0,0,0
2264,103,112,0,2264,2214,50,2.63533e+16,36.5905,361.023,2264,35,40,2152,2152,2152,2151,2145
43945,3126,3599,0,43945,0,43945,2.33134e+18,1080.64,9573.94,43945,388,680,40346,40312,40198,40236,38746
11591,187,190,0,11591,11280,311,2.45871e+16,89.3876,1012.37,11591,71,68,11401,11401,11400,11401,11389
14323,1367,1848,12692,1631,8445,5878,1.91026e+18,638.814,3941.7,14323,250,240,12475,12270,12276,12354,11290
27393,1246,3612,27393,0,24442,2951,2.77208e+18,741.812,7668.14,27393,360,508,23722,22607,16494,15763,13832
25221,31,44,24773,448,25221,0,9.73742e+13,19.7571,527.32,25221,24,26,25177,25177,24370,24370,23748
16813,2844,3053,16813,0,15004,1809,2.28923e+18,582.761,5733.7,16813,420,326,13760,13750,13721,13724,13191
20200,26,40,19765,435,20200,0,1.0154e+14,17.4204,491.908,20200,23,23,20160,20160,19568,19569,17632
48008,1261,2063,14219,33789,0,48008,3.63364e+13,817.277,6932.32,48008,427,398,45945,45708,44007,44093,36912
13237,174,1270,7852,5385,0,13237,4.83937e+18,370.272,3169.81,13237,224,237,10157,8157,7340,6879,1224
6360,375,1060,3812,2548,3812,2548,1.90245e+18,261.731,2071.23,6360,218,141,5286,4476,4746,4363,3615
41787,308,309,0,41787,41153,634,2.62851e+16,159.718,2378.74,41787,115,113,41478,41478,41477,41473,41474
5925,207,1032,0,5925,1897,4028,9.00107e+15,211.256,2061.76,5925,205,217,4745,4272,3482,3432,1494
44902,2081,3798,26494,18408,0,44902,4.71982e+18,896.278,9470.51,44902,557,481,41104,40583,37824,37097,28754
33668,884,2473,0,33668,10235,23433,9.22733e+15,548.851,6695.45,33668,516,441,31195,30535,27042,27216,19456
7746,934,1439,4688,3058,0,7746,4.96932e+18,362.776,2723.28,7746,240,262,6307,6088,5817,5795,5110
12737,37,1012,4393,8344,0,12737,3.23899e+13,447.402,2816.54,12737,200,230,8685,6314,4536,1812,927
14616,2097,2344,13271,1345,8625,5991,1.9995e+18,386.908,4619.49,14616,300,226,12272,12269,12272,12271,11672
11655,362,547,11655,0,11655,0,4.2392e+18,270.7,1921.19,11655,146,142,11108,11058,9754,9672,9419
17407,1860,2359,10245,7162,10245,7162,1.79118e+18,700.6,5031.84,17407,320,364,15048,14675,14565,14535,13369
31016,1540,1965,9254,21762,0,31016,3.6551e+13,644.08,5913.91,31016,426,319,29051,28974,28542,28548,25949
36438,1747,2215,11358,25080,0,36438,3.50009e+13,630.548,6620.71,36438,391,349,34223,34093,33895,33944,30624
43867,2956,4096,39087,4780,26113,17754,1.94721e+18,976.609,9879.77,43867,481,507,39771,39594,39132,39279,36174
35933,183,346,0,35933,35337,596,2.60594e+16,146.664,2473.21,35933,111,127,35578,35461,33805,33377,29139
12874,1439,1754,7601,5273,0,12874,4.92729e+18,343.874,3706.81,12874,316,294,11120,11116,11064,11011,9808
26648,85,757,26648,0,26648,0,4.22203e+18,334.906,3065.98,26648,190,194,21586,16488,12290,11132,5338
37506,97,2945,22737,14769,22737,14769,1.77869e+18,628.301,7597.77,37506,466,354,25179,19084,14690,11086,2287
37054,23,50,36631,423,37054,0,9.84109e+13,21.1079,675.126,37054,24,26,37000,36987,34867,34605,26660
25496,1690,2227,0,25496,0,25496,2.4186e+18,688.281,5583.75,25496,384,344,23269,23122,22777,22519,19709
6079,64,168,0,6079,5951,128,2.5663e+16,65.6442,725.655,6079,53,57,5880,5753,5122,5038,3913
10361,1031,1366,5481,4880,5481,4880,1.51251e+18,188.035,2759.27,10361,250,249,8995,8980,8951,8890,8439
32381,1573,1581,9965,22416,0,32381,3.29056e+13,710.031,5141.77,32381,366,317,30800,30800,30800,30800,30788
27723,260,321,0,27723,27273,450,2.52643e+16,119.031,2056.33,27723,93,105,27402,27396,27185,26941,25184
37790,55,68,37275,515,37765,25,1.0325e+14,20.2656,807.311,37790,28,30,37722,37722,37152,37163,35744
995,66,441,995,0,895,100,2.83639e+18,36.205,593.741,995,73,77,554,438,258,184,157
28722,80,279,0,28722,28211,511,2.43856e+16,129.488,1844.27,28722,96,99,28128,27433,24402,22677,17315
38681,27,82,38116,565,37825,856,9.90306e+13,20.8057,871.281,38681,31,28,38599,38586,35405,35320,23442
10467,903,2460,9473,994,6147,4320,1.9539e+18,290.417,4113.83,10467,352,210,8007,7801,6055,5929,4760
40466,63,303,0,40466,39643,823,2.54017e+16,146.599,2206.74,40466,106,106,39484,38711,33259,30238,20285
9904,1398,1881,5872,4032,0,9904,5.23505e+18,262.965,3401.66,9904,203,323,8023,8021,7847,7893,6589
33927,260,269,0,33927,33102,825,2.5094e+16,152.323,1919.59,33927,98,106,33658,33655,33638,33630,33565
16842,383,2206,0,16842,0,16842,2.50087e+18,390.927,4620.22,16842,348,245,14421,12697,11144,9616,4178
46042,1722,4351,40952,5090,27696,18346,1.97746e+18,1485.42,10698,46042,505,603,41409,38866,31918,31663,24064
23640,1671,2564,14229,9411,14229,9411,1.83805e+18,848.057,5957.49,23640,448,369,21076,20619,20350,20313,18176
21350,14,57,21011,339,21350,0,1.00857e+14,19.998,563.204,21350,25,26,21250,21193,18972,18766,13292
24152,1129,1586,6932,17220,0,24152,3.39355e+13,622.845,4483.64,24152,371,231,22566,22244,21543,21538,18025
19014,1173,1207,0,19014,6033,12981,9.42268e+15,515.985,3739.88,19014,296,299,17807,17807,17807,17807,17738
38968,799,3659,22921,16047,22921,16047,1.81621e+18,933.676,8945.14,38968,530,479,34506,32684,22779,22994,9580
20227,281,1518,0,20227,6408,13819,9.0762e+15,511.683,4141.19,20227,317,284,17889,16495,12428,12313,6270
12723,82,1357,0,12723,4012,8711,8.88287e+15,299.058,3222.25,12723,223,278,9668,8382,5856,4896,1539
11297,2028,2151,0,11297,0,11297,2.41615e+18,415.739,4044.73,11297,258,292,9146,9130,9124,9135,8828
43627,216,5087,25824,17803,25824,17803,1.82515e+18,603.186,11115.6,43627,369,897,34230,28493,21352,13582,1626
13599,301,1264,4134,9465,0,13599,3.74589e+13,348.82,3376.59,13599,249,397,11941,11025,10120,10194,3274
31006,24,2243,10034,20972,0,31006,3.43665e+13,518.424,6276.85,31006,368,396,18670,13113,10494,4384,1903
48372,265,2940,0,48372,0,48372,2.43405e+18,1078.48,8868.09,48372,708,405,39413,32682,22752,21881,7791
19733,9,42,19468,265,19733,0,1.05427e+14,17.9727,484.895,19733,23,24,19460,19286,16769,16422,9335
40887,266,732,40887,0,40885,2,4.46979e+18,346.949,3666.61,40887,217,208,39755,38724,26196,25501,19906
36202,62,281,0,36202,35333,869,2.50934e+16,145.729,2112.64,36202,101,107,35304,34619,29636,27113,17321
28291,677,2580,25071,3220,16796,11495,1.97099e+18,1222.21,6669.93,28291,484,401,23965,22453,18870,17663,7220
36223,1128,3787,32262,3961,21856,14367,1.94449e+18,1009.62,9162.59,36223,437,583,31659,28802,24994,24381,12951
29609,1658,2101,8716,20893,0,29609,3.83428e+13,495.047,5726.38,29609,433,319,27508,27492,27386,27374,26041
906,137,258,900,6,906,0,4.59037e+18,74.5475,431.887,906,55,47,648,581,490,500,462
17899,435,2449,15858,2041,10763,7136,1.91223e+18,556.703,5275.82,17899,397,322,14395,11613,8383,8722,2278
14539,6,36,14261,278,14539,0,9.23862e+13,16.0952,398.774,14539,22,21,14022,13491,12084,12079,7270
23567,254,2280,14191,9376,0,23567,4.87218e+18,762.221,5717.51,23567,366,456,18188,14783,10096,7995,4166
34886,2750,3345,21103,13783,21103,13783,1.82654e+18,860.415,8030.57,34886,480,417,31541,31525,31304,31377,29996
10924,1179,2057,6472,4452,0,10924,4.89502e+18,304.476,3789.71,10924,333,303,8867,8787,8333,8434,6614
26625,1146,2641,16172,10453,16172,10453,1.83468e+18,666.649,6161.97,26625,364,404,23954,23340,21380,21564,16256
19519,2187,2875,11593,7926,0,19519,4.79833e+18,425.244,5917.62,19519,332,377,16644,16595,16422,16353,13163
26388,2907,3831,23104,3284,15349,11039,2.00458e+18,808.226,7908.4,26388,518,467,22557,22324,22064,22199,19520
31749,23,60,31146,603,31749,0,9.78414e+13,18.0064,664.459,31749,27,27,31689,31674,28916,28683,20043
10948,1149,1703,6744,4204,6744,4204,1.79895e+18,311.68,3440.03,10948,355,184,9245,9200,8441,7883,5087
44496,207,334,0,44496,43760,736,2.6484e+16,178.348,2601.5,44496,122,120,44134,44078,41866,41437,35124
11308,313,1167,0,11308,3139,8169,9.31396e+15,368.687,2818.94,11308,264,247,9952,9210,8615,8825,4140
20303,881,1526,5958,14345,0,20303,3.71032e+13,558.252,4241.13,20303,287,269,18777,18358,17924,17977,15369
26931,1099,1375,0,26931,8612,18319,8.89139e+15,366.574,4408.08,26931,287,250,25556,25555,24946,24987,23373
17601,1511,1680,0,17601,0,17601,2.22283e+18,775.928,4247.13,17601,301,317,15921,15598,15824,15767,15461
20631,38,54,20265,366,20631,0,1.00879e+14,17.867,511.191,20631,22,26,20577,20577,20210,20211,19523
42577,335,989,42577,0,42577,0,4.32561e+18,331.864,4015.76,42577,231,222,41505,40946,28570,27670,22795
29873,75,285,0,29873,29340,533,2.72282e+16,122.548,2018.56,29873,98,110,29218,28501,24810,23049,16578
10299,476,1337,0,10299,3295,7004,8.92186e+15,268.143,2968.47,10299,276,313,8962,8683,8137,8020,5516
40500,2166,3277,24054,16446,0,40500,4.74741e+18,1171.1,8567.54,40500,470,448,37223,36699,36363,36247,31452
15559,35,38,15360,199,15541,18,1.0433e+14,19.5853,474.527,15559,23,23,15521,15521,15392,15392,15172
6404,1125,1573,3866,2538,0,6404,5.22251e+18,210.945,2579.77,6404,203,207,4831,4812,4714,4735,3881
23258,21,46,22650,608,23258,0,1.02495e+14,18.3539,524.724,23258,24,25,23211,23198,21513,21515,16717
27431,1320,2987,27431,0,24912,2519,2.15358e+18,1238.76,6900.16,27431,384,438,23761,22429,18949,17194,12563
47436,368,668,47436,0,47436,0,4.03318e+18,357.342,3840.46,47436,223,226,46721,46348,37925,37368,32956
37215,43,46,36474,741,37215,0,9.92634e+13,17.0716,647.613,37215,22,25,37169,37169,36873,36873,36748
30082,2006,2565,18121,11961,0,30082,4.83402e+18,1210.92,6666.79,30082,434,416,27517,26715,26723,26612,24292
11260,1149,1506,6809,4451,0,11260,4.9501e+18,443.989,3229.76,11260,236,243,9754,9661,9613,9607,8853
2280,587,658,2066,214,1439,841,1.92925e+18,247.842,1089.02,2280,127,125,1622,1593,1611,1609,1563
40530,3128,3976,0,40530,0,40530,2.39724e+18,629.435,9405.38,40530,385,606,36554,36551,36182,36293,31946
26458,1753,1950,0,26458,7691,18767,9.20162e+15,475.169,5221.24,26458,452,308,24508,24508,24449,24441,24014
11878,928,1928,10601,1277,7066,4812,1.95351e+18,466.634,3886.42,11878,317,223,9950,9516,8113,7962,6554
26962,1485,2954,16258,10704,16258,10704,1.86091e+18,929.226,6950.16,26962,418,461,24008,22782,21779,21840,15794
10791,325,2026,0,10791,0,10791,2.3296e+18,326.462,3789.01,10791,221,335,8504,7492,5821,4593,1758
19950,2550,2742,18044,1906,11505,8445,1.93743e+18,879.271,5656.2,19950,282,373,17208,16829,17169,17161,16583
10274,331,1351,2928,7346,0,10274,3.80981e+13,303.756,2955.18,10274,295,214,8789,8160,6737,6634,3141
4413,43,132,0,4413,4328,85,2.64849e+16,63.5901,514.575,4413,49,51,4183,4067,3777,3684,2832
28717,73,276,0,28717,28189,528,2.55942e+16,123.491,1811.66,28717,96,97,28132,27307,24509,22639,15795
17681,453,2082,10362,7319,10362,7319,1.85507e+18,688.595,4649.26,17681,330,338,14946,13488,10892,10443,6031
17351,819,2335,10210,7141,0,17351,4.78404e+18,373.187,4810.78,17351,347,230,15016,14717,13541,13128,6682
10566,13,1292,0,10566,3315,7251,9.02072e+15,259.156,2971.46,10566,200,293,5027,2799,2667,2521,609
28601,351,1765,0,28601,8731,19870,8.55009e+15,513.536,5201.25,28601,316,299,25862,24048,17456,16602,9629
36605,669,2755,20610,15995,0,36605,4.3137e+18,1155.4,7100.47,36605,481,429,32543,30990,24897,23881,16027
26726,796,1538,8338,18388,0,26726,3.4795e+13,450.61,4800.43,26726,299,313,25188,25075,22850,22930,17175
33976,61,69,33424,552,33976,0,1.03631e+14,18.5567,710.382,33976,26,29,33907,33907,33580,33581,31928
18134,597,611,18134,0,18134,0,4.75485e+18,309.3,2416.68,18134,159,161,17523,17523,17430,17422,17510
32438,74,792,32426,12,32438,0,4.34362e+18,333.607,3375.04,32438,208,203,24886,17136,12663,12138,5986
7015,398,1016,0,7015,2104,4911,9.60254e+15,207.323,2170.69,7015,231,172,5999,5639,5043,5048,3561
43855,1562,2057,0,43855,13054,30801,9.55425e+15,538.258,6274.14,43855,392,410,41798,41739,39261,39384,36822
3789,553,1058,2325,1464,0,3789,4.54939e+18,248.728,1753.79,3789,228,219,2731,2560,2456,2460,1686
19715,1418,2450,0,19715,0,19715,2.34576e+18,565.059,5342.17,19715,343,427,17265,17026,16597,16510,10068
22709,16,258,0,22709,22334,375,2.68856e+16,103.146,1710.25,22709,92,93,20798,19892,16782,14478,8835
16054,242,1332,4993,11061,0,16054,3.53248e+13,438.325,3517.39,16054,245,254,14007,13116,9679,9854,4187
37471,233,2595,33329,4142,22305,15166,1.93611e+18,1083.73,7373.13,37471,397,394,27963,22225,14902,11060,4808
33863,346,2326,20338,13525,20338,13525,1.92991e+18,957.107,6725.24,33863,453,471,28945,24416,21792,19689,7942
3214,303,928,3214,0,2941,273,2.49101e+18,137.161,1421.34,3214,192,100,2286,2110,1630,1592,953
729,188,259,219,510,0,729,4.65474e+13,23.31,359.325,729,69,47,470,466,469,469,368
34314,1723,3062,20652,13662,0,34314,4.80424e+18,857.003,7831.72,34314,420,489,31252,31069,29921,29811,21795
3541,161,726,3541,0,3183,358,2.50201e+18,337.115,1376.29,3541,136,120,2242,1667,1055,855,872
33043,704,2255,0,33043,10337,22706,8.98842e+15,511.016,6341.22,33043,423,423,30645,30143,24935,25266,11466
18858,2068,2575,11156,7702,0,18858,4.90283e+18,622.683,5419.28,18858,450,338,16283,16283,16122,16150,14860
20859,472,644,20859,0,20859,0,4.3676e+18,318.207,2612.99,20859,174,175,20215,20160,18926,18967,18750
13194,2507,2661,0,13194,0,13194,2.33534e+18,299.398,4752.22,13194,376,286,10533,10533,10527,10533,9998
1419,281,363,427,992,0,1419,3.95804e+13,69.3129,608.688,1419,88,80,1056,1054,1041,1040,903
42609,2428,2507,13047,29562,0,42609,3.60567e+13,465.878,7206.83,42609,457,359,40102,40102,40092,40084,39897
25800,43,61,25254,546,25800,0,1.04626e+14,18.7168,604.004,25800,27,26,25739,25738,25102,25102,22790
47729,873,3350,28437,19292,28437,19292,1.80077e+18,1431.43,9167.08,47729,575,557,42980,41084,36522,33819,16175
12394,726,1609,6995,5399,6995,5399,1.63295e+18,403.433,3517.26,12394,220,267,10785,10311,9748,8476,6490
34918,116,337,0,34918,34167,751,2.64516e+16,130.915,2382.44,34918,98,114,34489,34133,30169,28312,21694
3040,86,118,0,3040,2999,41,2.49832e+16,37.6553,421.132,3040,38,36,2922,2920,2840,2849,2655
21000,347,1659,6091,14909,0,21000,3.65725e+13,550.854,4526.55,21000,354,378,18567,17300,14804,14891,6701
3966,554,695,0,3966,1123,2843,9.26104e+15,148.878,1357.32,3966,153,124,3271,3268,3269,3261,2848
5946,1179,1365,5318,628,3335,2611,2.00601e+18,275.801,2439.13,5946,194,204,4581,4580,4537,4537,4373
4617,208,642,2788,1829,0,4617,4.4574e+18,371.071,1472.29,4617,174,153,3220,2493,2128,1914,1561
27555,1745,2928,27530,25,24913,2642,2.21579e+18,651.259,6451.81,27555,374,424,24627,24332,22175,21973,18202
14514,33,40,14232,282,14514,0,1.01602e+14,16.4771,416.544,14514,21,21,14474,14474,14108,14111,13330
15704,39,716,15704,0,15704,0,4.53522e+18,278.375,2397.53,15704,166,157,10158,6704,4493,3936,1779
47623,736,2185,13613,34010,0,47623,3.6508e+13,702.002,7435.85,47623,543,371,45193,43503,37541,37866,21787
30078,386,2032,8895,21183,0,30078,3.58271e+13,578.933,5887.8,30078,412,299,27083,25244,18423,17002,8788
45279,2906,4689,40669,4610,27282,17997,2.02495e+18,1098.94,11020.5,45279,606,439,40590,40374,38358,38124,32664
41809,65,112,40893,916,41809,0,1.03383e+14,17.5815,897.944,41809,30,31,41697,41697,40163,40164,33390
32629,2152,3013,19146,13483,0,32629,4.47664e+18,806.877,7544.47,32629,331,415,29616,29490,29133,29056,23232
38113,62,88,37619,494,38113,0,1.053e+14,18.3123,788.799,38113,27,28,38025,38025,36994,36995,33209
8055,20,31,7861,194,8055,0,1.03714e+14,15.2945,289.471,8055,20,20,8024,8018,7703,7704,6987
4569,128,155,0,4569,4443,126,2.57068e+16,69.8418,610.147,4569,57,55,4414,4409,4358,4369,4218
28852,1001,2629,17144,11708,0,28852,4.79626e+18,881.702,6720.64,28852,410,425,25898,24604,22343,22267,13061
45568,1621,3593,26445,19123,26445,19123,1.7537e+18,1314.72,9525.61,45568,512,525,41568,40337,38591,37244,21930
9341,543,1701,8401,940,5680,3661,2.02791e+18,655.637,3294.08,9341,242,275,7105,6525,4638,4542,3059
25055,366,794,25055,0,25055,0,4.36152e+18,285.574,2909.27,25055,188,182,24261,24086,19517,19095,19663
35342,1211,2812,0,35342,0,35342,2.39896e+18,906.468,7247.49,35342,373,437,32420,31632,30302,29709,22000
26813,1976,2810,16048,10765,0,26813,4.93316e+18,768.489,6691.18,26813,381,375,24003,23689,23482,23426,20104
20909,1267,1489,0,20909,5836,15073,9.57105e+15,515.939,4281.77,20909,327,315,19420,19420,19254,19237,17358
2820,204,718,1668,1152,0,2820,5.09593e+18,217.048,1221.33,2820,124,147,1944,1665,1386,1433,881
6932,401,1207,1877,5055,0,6932,3.79923e+13,187.848,2301.2,6932,252,137,5725,5528,4249,4210,2410
5700,338,1415,0,5700,0,5700,2.34543e+18,247.601,2424.39,5700,238,273,4249,3707,3279,3219,1486
48886,777,2072,15615,33271,0,48886,3.50421e+13,829.934,7122.44,48886,454,450,46229,44414,33698,33942,31976
27965,417,2696,25054,2911,17172,10793,1.96752e+18,811.394,6256.03,27965,339,360,23096,17077,9946,10220,7252
46231,2682,3176,26188,20043,26188,20043,1.7007e+18,783.799,8753.84,46231,426,473,43055,43046,42784,42876,40799
48617,963,3332,28837,19780,28837,19780,1.8545e+18,1013.89,9277.4,48617,540,526,44590,41842,35623,34669,21059
49807,996,3277,30546,19261,30546,19261,1.83987e+18,924.935,9645.78,49807,478,490,45381,42369,38933,30867,19459
23319,24,58,22756,563,23319,0,9.92691e+13,15.5143,563.467,23319,24,27,23259,23256,22000,21994,19272
31194,1302,1668,8772,22422,0,31194,3.71904e+13,757.067,5418.8,31194,402,324,29526,29133,29094,29117,27086
32847,2511,2958,18406,14441,0,32847,4.10563e+18,685.62,7214.81,32847,306,482,29889,29828,29764,29791,27046
8122,1043,1494,8122,0,7182,940,2.1023e+18,699.616,3012.85,8122,251,254,6544,5788,6085,5966,5358
49333,65,367,0,49333,48299,1034,2.64551e+16,158.938,2766.48,49333,109,129,48108,46814,38887,35794,24538
38866,2081,2449,12563,26303,0,38866,3.47281e+13,548.121,7192.53,38866,448,473,36417,36414,35929,35969,34185
43568,540,1213,43568,0,43568,0,4.06964e+18,392.957,4372.51,43568,235,227,42355,41982,35634,35280,32183
25216,126,603,25216,0,25216,0,4.08116e+18,274.78,2778.5,25216,186,178,22657,19416,13433,12630,7528
3083,855,934,3083,0,2797,286,2.19062e+18,228.185,1499.49,3083,144,127,2149,2132,2140,2141,2101
38894,3223,5411,38894,0,35084,3810,1.90578e+18,658.928,10883.7,38894,624,395,33483,33327,32604,32128,17567
28584,650,2068,0,28584,9040,19544,8.5222e+15,613.069,5830.1,28584,406,324,26222,25087,21360,21680,10534
6953,1102,1255,3773,3180,0,6953,4.70231e+18,162.661,2266.28,6953,168,184,5698,5698,5690,5695,5481
17947,1247,1391,0,17947,5776,12171,8.90632e+15,344.883,3913.91,17947,256,348,16556,16556,16501,16498,15830
6521,160,1594,5848,673,3885,2636,1.98785e+18,285.545,2738.21,6521,219,291,4294,3505,2196,2039,430
44721,140,2087,13621,31100,0,44721,3.24167e+13,643.01,6947.37,44721,521,493,37870,33953,23059,19368,6441
41390,729,821,41390,0,41390,0,4.24055e+18,358.679,3802.52,41390,229,227,40569,40569,40401,40405,40206
8762,373,936,0,8762,2709,6053,9.5452e+15,311.172,2287.36,8762,213,195,7747,7127,6919,6947,5144
12255,518,1759,12255,0,11021,1234,2.70688e+18,412.525,3751.48,12255,297,226,10482,9058,7697,7401,4398
33459,11,240,0,33459,33042,417,2.56409e+16,141.475,1757.38,33459,90,95,29881,26978,24448,17952,12623
26178,847,1581,8013,18165,0,26178,3.56408e+13,357.445,4382.01,26178,270,230,24597,24522,24115,24131,21308
26924,651,800,26924,0,26924,0,4.40672e+18,302.84,3088.96,26924,188,197,26124,26114,25710,25701,25610
22592,288,2861,0,22592,0,22592,2.34479e+18,514.934,6268.11,22592,397,359,17866,14685,10962,8619,4455
49195,59,98,48305,890,49153,42,1.04757e+14,20.4687,942.965,49195,30,33,49097,49095,47540,47544,38510
47494,394,1110,47457,37,47494,0,3.97737e+18,386.918,4434.14,47494,245,234,46304,45738,32232,30757,27717
31337,50,284,0,31337,30607,730,2.58941e+16,127.255,1837.81,31337,98,105,30214,29263,25367,23059,15407
11955,593,1373,3458,8497,0,11955,3.76637e+13,238.458,3206.85,11955,274,254,10582,10510,9885,9904,6932
46048,314,2791,14069,31979,0,46048,3.58045e+13,674.506,8017.92,46048,471,535,40747,36516,27449,22916,9879
43567,1310,4215,39380,4187,24985,18582,1.96223e+18,1387.79,9988.8,43567,552,488,38418,36833,28572,28430,19936
16967,911,1377,0,16967,0,16967,2.15946e+18,357.526,3562.26,16967,311,261,15590,15548,14946,13685,14519
36632,1077,4173,36607,25,33436,3196,1.6757e+18,1025.2,9375.82,36632,480,533,31755,29788,25723,25491,9292
10339,1500,2417,10339,0,9383,956,2.30235e+18,383.414,4034.02,10339,237,345,7922,7860,6357,6467,5635
39072,1659,2271,21948,17124,0,39072,4.16663e+18,1144.35,6819.7,39072,464,441,36699,35548,35439,34800,32328
49265,2501,3987,28379,20886,0,49265,4.54396e+18,1114.3,10034.3,49265,469,604,45278,44918,44395,44279,31063
22584,633,2281,13760,8824,13760,8824,1.86793e+18,613.351,5506.6,22584,365,317,19719,17892,16463,16226,11520
31357,1173,2601,31357,0,28584,2773,2.4991e+18,627.035,6603.99,31357,349,311,28756,28603,24521,23766,19939
31490,1495,1651,0,31490,9825,21665,8.27992e+15,661.365,5192.47,31490,343,355,29839,29831,29705,29715,29290
709,22,213,655,54,425,284,1.4154e+18,111.852,369.741,709,81,45,211,41,44,36,96
7845,5,22,7683,162,7845,0,9.41123e+13,15.955,274.879,7845,18,17,7409,7088,6314,6359,4374
5398,695,896,3313,2085,0,5398,4.86682e+18,265.975,1805.64,5398,167,150,4502,4502,4187,4125,3956
15106,234,1704,0,15106,0,15106,2.30966e+18,479.158,3922.67,15106,289,276,11806,9346,7534,6471,3694
1718,219,467,0,1718,0,1718,2.34623e+18,77.9889,721.469,1718,141,72,1251,1213,1240,1235,781
23361,206,275,0,23361,22851,510,2.60982e+16,130.259,1706.54,23361,92,101,23086,23071,22394,22335,21206
4126,560,983,2473,1653,0,4126,4.8489e+18,189.675,1705.55,4126,145,148,3143,3097,2955,2951,2414
8872,10,180,0,8872,8654,218,2.65831e+16,74.6001,838.678,8872,50,66,7787,7112,6419,4886,3221
6468,523,1476,6468,0,5831,637,1.56782e+18,346.728,2554.53,6468,241,149,4992,4121,3962,3778,2613
38802,17212,38802,0,38802,38802,0,4095.89,0,38802,38802,38802,1,0,0,0,0,0
49737,3429,3897,0,49737,0,49737,2.37638e+18,1237.68,10297.7,49737,575,590,45840,45794,45426,45434,42982
24617,2500,2744,14653,9964,0,24617,4.57365e+18,635.196,6110.94,24617,299,340,21873,21790,21853,21847,21240
17921,1403,2917,10722,7199,10722,7199,1.88397e+18,384.646,5650.38,17921,299,447,15004,14928,14339,14480,9244
44953,1583,3072,0,44953,0,44953,2.0871e+18,1098.68,8440.63,44953,383,546,41391,40814,39126,34622,30487
13869,111,1188,0,13869,4271,9598,9.2141e+15,426.217,3185.32,13869,277,282,10919,9577,7032,6210,2563
46771,625,3942,27600,19171,0,46771,5.00556e+18,870.834,9988.91,46771,616,393,41463,38494,28685,24618,14127
43097,534,2201,13127,29970,0,43097,3.32496e+13,846.081,7127.05,43097,403,449,39633,37860,33853,34342,14201
22020,10,49,21555,465,22020,0,9.60878e+13,17.5343,534.319,22020,24,25,21813,21677,19518,19316,13440
47779,1335,4244,42648,5131,27856,19923,1.97051e+18,1596.22,10778.2,47779,539,560,42462,40479,25890,24013,18806
31190,1976,2543,31190,0,27644,3546,3.02445e+18,1079.9,6932.05,31190,388,402,28647,28575,28213,28169,25667
14666,199,642,14666,0,14666,0,4.06167e+18,246.787,2208.69,14666,168,151,13714,12717,8365,8051,6591
31715,584,2522,31715,0,28684,3031,1.14173e+18,658.41,6234.43,31715,360,367,28741,26562,17056,15116,11439
6973,37,189,0,6973,6877,96,2.47805e+16,79.0691,802.43,6973,62,59,6606,6418,5656,5260,3506
27609,1358,1827,0,27609,8783,18826,8.46118e+15,572.532,5186.41,27609,361,401,25782,25744,25528,25563,23101
21621,1177,1713,0,21621,6970,14651,8.63405e+15,369.367,4697.92,21621,365,388,19908,19873,18317,18557,13813
24139,36,63,23691,448,24085,54,1.04106e+14,18.0483,656.135,24139,25,26,24076,24075,23221,23221,18857
37357,1097,1948,10914,26443,0,37357,3.61921e+13,800.872,6123.41,37357,432,338,35409,34786,33953,33946,24481
45405,217,4948,40704,4701,27624,17781,1.90876e+18,1287.64,11479.6,45405,514,666,31941,24551,14907,12900,1915
19272,1047,2582,17286,1986,11316,7956,1.94751e+18,1167.83,5815.21,19272,337,378,15993,14382,12043,11801,7792
26075,563,668,26075,0,26075,0,4.09261e+18,282.721,2858.97,26075,190,182,25407,25395,24683,24688,24918
19563,40,50,19197,366,19563,0,1.06084e+14,18.2852,508.003,19563,24,25,19513,19513,19184,19184,18982
38646,1811,3256,0,38646,0,38646,2.45102e+18,913.261,8143.31,38646,491,451,35390,34935,33404,28311,28126
40983,578,684,40251,732,40983,0,4.11576e+18,341.311,3643.09,40983,214,219,40299,40296,39530,39453,37954
38285,48,67,37623,662,38285,0,9.30043e+13,17.1992,716.16,38285,28,26,38218,38218,37705,37710,35251
23714,1931,2507,23689,25,21214,2500,2.28758e+18,920.242,6058.19,23714,358,343,21207,21025,20869,20840,19424
32035,612,3326,0,32035,0,32035,2.44087e+18,802.536,7746.78,32035,515,370,27235,24428,18965,15769,9371
39644,177,311,0,39644,38802,842,2.48269e+16,161.798,2374.02,39644,108,112,39300,39133,36740,36637,31491
6984,250,1085,4208,2776,0,6984,5.04052e+18,305.199,2306.49,6984,188,245,5486,4644,4054,3998,2116
36702,3674,3997,32729,3973,22081,14621,1.99453e+18,1215.96,9167.72,36702,521,441,32705,32699,32667,32674,32049
11015,74,2127,11015,0,9900,1115,1.63396e+18,389.946,4005.81,11015,382,191,6172,4024,2404,1906,372
42565,925,2279,25698,16867,25698,16867,1.86023e+18,1086.73,7226.17,42565,525,365,39550,36994,34659,32046,18981
31484,1905,4172,31484,0,28343,3141,2.28226e+18,925.374,8950.29,31484,330,508,27312,26914,26608,25949,19030
39336,1057,2248,0,39336,12290,27046,9.16725e+15,492.457,6645.5,39336,365,414,37088,36954,32865,32061,21215
25330,573,1865,0,25330,7986,17344,8.95692e+15,648.828,5285.33,25330,320,430,23007,21992,20352,20439,9593
13494,574,622,13494,0,13494,0,4.21581e+18,253.215,2073.05,13494,156,162,12872,12872,12789,12789,12780
10579,570,955,0,10579,2839,7740,9.265e+15,409.06,2499.05,10579,278,208,9610,9239,9047,9023,7585
38199,298,375,0,38199,37442,757,2.56302e+16,146.706,2410.93,38199,113,123,37824,37820,37060,37186,35624
16759,1393,1445,10276,6483,0,16759,4.87454e+18,390.546,3709.57,16759,281,222,15314,15314,15265,15264,15206
29412,758,2832,0,29412,0,29412,2.16903e+18,1035.22,6843.29,29412,399,425,25734,24486,15008,14719,9019
12879,58,1891,0,12879,0,12879,2.50424e+18,493.546,3911.82,12879,238,278,8163,6303,4573,4049,604
21391,1038,1928,0,21391,6320,15071,9.56301e+15,474.396,4933.94,21391,315,372,19463,19106,18773,18734,14158
44742,2035,3049,25033,19709,0,44742,4.6123e+18,1173.11,8673.75,44742,489,590,41693,41318,40121,39846,33284
40742,1852,4238,40742,0,37004,3738,2.44882e+18,1222.09,9972.88,40742,571,386,36398,35054,33949,33085,22779
6731,16,37,6630,101,6731,0,1.04963e+14,14.4779,291.188,6731,20,20,6690,6678,6204,6187,4458
30588,1173,3654,27077,3511,18424,12164,1.96388e+18,1040.04,8139.76,30588,459,528,26498,24778,19118,17703,11058
17507,1487,2094,0,17507,0,17507,2.31356e+18,640.462,4752.41,17507,307,318,15413,15124,15132,15202,13710
49013,101,343,0,49013,48198,815,2.5831e+16,154.657,2493.32,49013,108,116,48446,47969,42705,38925,29419
37702,1687,2689,0,37702,11980,25722,8.93173e+15,694.529,7482.86,37702,392,473,35013,34765,34442,34415,29454
21554,212,773,21554,0,21554,0,4.08843e+18,316.384,2816.82,21554,188,178,20057,18313,12713,11922,9175
36251,3840,4035,36251,0,32561,3690,1.97824e+18,617.937,9159.45,36251,550,339,32216,32216,32216,32215,31715
44566,224,238,0,44566,44141,425,2.49678e+16,155.727,2023.07,44566,101,111,44328,44328,44318,44175,43967
2598,350,774,0,2598,0,2598,2.51065e+18,119.97,1178.54,2598,163,109,1824,1718,1760,1683,1117
35937,2534,3541,21338,14599,21338,14599,1.8436e+18,735.893,8346.17,35937,532,432,32396,32311,31880,31914,27684
36608,503,1057,0,36608,10111,26497,9.29511e+15,656.59,4457.95,36608,364,291,34663,33177,30576,31005,20539
24680,1612,2444,24680,0,22169,2511,2.86108e+18,889.769,5958.45,24680,477,277,22236,22176,21622,21142,19410
11541,1430,1578,6988,4553,0,11541,4.87861e+18,397.798,3420.26,11541,311,208,9963,9963,9840,9835,9552
22330,483,804,22330,0,22330,0,4.29241e+18,293.074,2829.85,22330,181,180,21526,21499,19329,19167,18859
10046,400,1278,6116,3930,6116,3930,1.86434e+18,438.785,2789.01,10046,268,215,8516,6975,7011,6547,5250
47005,2653,5077,47005,0,42360,4645,2.71135e+18,1273.12,11359.2,47005,554,455,41928,41086,40487,39612,31986
1458,234,422,461,997,0,1458,3.16653e+13,62.0501,703.817,1458,127,69,1036,1010,757,747,690
24989,1660,2771,14584,10405,0,24989,4.40319e+18,483.041,6267.38,24989,362,359,22218,22172,21820,21449,15453
37160,1263,2235,0,37160,10105,27055,9.7136e+15,815.321,6875.81,37160,460,455,34919,34270,33432,33290,21097
589,60,162,532,57,286,303,1.87662e+18,88.382,292.291,589,49,48,301,143,110,117,197
20620,162,235,0,20620,20226,394,2.52028e+16,120.783,1399.09,20620,91,81,20385,20315,19355,19162,17770
5095,228,1222,4490,605,3083,2012,1.88096e+18,365.765,2152.52,5095,163,188,3388,2538,1481,1497,930
18550,197,245,0,18550,18204,346,2.69819e+16,112.742,1536.59,18550,81,89,18305,18300,18168,18153,17366
11663,357,2599,10425,1238,7000,4663,1.90084e+18,493.684,4596.27,11663,370,289,8487,7216,4316,4028,1799
38502,2031,4101,22962,15540,22962,15540,1.87021e+18,886.299,9381.17,38502,492,490,34401,33821,31144,29839,24268
37468,2939,3063,22518,14950,0,37468,5.02399e+18,1009.78,7804.81,37468,581,396,34405,34300,34371,34366,34111
11278,8,215,0,11278,11067,211,2.518e+16,89.6083,1115.04,11278,67,75,9486,8371,7661,6608,3884
2878,310,320,2878,0,2878,0,4.87798e+18,140.563,806.279,2878,82,75,2558,2558,2548,2551,2545
10756,1396,2116,9779,977,6226,4530,1.89365e+18,302.413,3912.52,10756,194,355,8640,8576,8253,8312,5793
35482,9873,35482,35482,0,0,35482,15.9995,0,35482,35482,35482,1,0,0,0,0,0
38815,31258,38815,0,38815,38815,0,4095.89,0,38815,38815,38815,1,0,0,0,0,0
39778,1691,3743,24149,15629,24149,15629,1.84356e+18,802.985,9179.51,39778,505,547,36035,35354,34201,34243,24136
11057,232,433,11057,0,11057,0,3.65804e+18,225.464,1642.89,11057,146,132,10595,10381,9607,9626,8116
20315,1642,2519,18232,2083,11592,8723,1.94443e+18,1043.72,5563.47,20315,361,307,17796,16714,16212,16233,11923
35947,1125,2850,21599,14348,21599,14348,1.9308e+18,987.063,7374.5,35947,541,397,32659,29994,29897,29668,22767
34136,202,961,34058,78,34136,0,4.27914e+18,345.643,3625.7,34136,213,207,31928,29123,18649,17951,12654
35517,2655,3907,35496,21,31823,3694,1.36273e+18,754.841,8463.57,35517,384,485,31610,31508,31152,31270,28711
22406,131,260,0,22406,22036,370,2.77605e+16,110.006,1538.03,22406,87,100,22142,21975,20344,20001,17583
31014,11,47,30468,546,31014,0,9.97245e+13,17.3293,629.21,31014,26,25,30815,30642,27153,27037,20008
15063,38,49,14803,260,15063,0,1.04178e+14,18.2088,447.049,15063,23,25,15014,15012,14753,14753,13815
16407,140,198,0,16407,16038,369,2.51787e+16,108.935,1120.04,16407,73,75,16206,16129,15712,15738,14914
18859,1126,1395,0,18859,5250,13609,9.75197e+15,512.553,3886.67,18859,304,311,17464,17251,17291,17256,15817
32268,1654,3117,19640,12628,19640,12628,1.88195e+18,733.347,7477.93,32268,488,462,29151,28887,27224,26262,19489
13203,665,1269,0,13203,3869,9334,9.56009e+15,353.777,3184.68,13203,296,193,11908,11452,10932,10969,7804
22043,1029,1302,6311,15732,0,22043,3.68084e+13,613.656,4048.72,22043,331,283,20741,20677,20361,20369,19385
5828,1025,1079,5249,579,3287,2541,1.90543e+18,462.032,2188.8,5828,182,210,4749,4749,4729,4741,4711
10237,1272,1313,10216,21,9217,1020,1.11843e+18,343.869,2851.8,10237,225,173,8924,8924,8922,8922,8869
22881,35,52,22441,440,22863,18,1.01563e+14,16.9908,595.059,22881,24,24,22829,22829,22282,22283,19469
15132,462,1584,4900,10232,0,15132,3.44468e+13,317.075,3926.09,15132,288,295,13465,12932,10876,10986,6246
42216,552,2989,25268,16948,0,42216,4.63735e+18,993.041,7923.33,42216,467,466,37882,36027,19800,16732,8341
27924,1417,2054,24942,2982,16528,11396,1.98221e+18,1172.79,5955.05,27924,393,372,25482,24093,24723,24784,19724
4606,845,982,2827,1779,0,4606,4.49651e+18,243.375,1798.37,4606,195,131,3624,3623,3466,3376,3307
32500,1283,2055,9951,22549,0,32500,3.4736e+13,535.966,5952.36,32500,373,329,30445,30310,28996,29054,24541
7911,983,1082,4578,3333,4578,3333,1.87156e+18,337.045,2316.69,7911,224,195,6829,6827,6792,6799,6333
21883,242,271,0,21883,21438,445,2.6794e+16,107.7,1598.69,21883,91,98,21612,21612,21569,21550,21352
3949,682,1086,2416,1533,2416,1533,1.83653e+18,210.2,1776.01,3949,215,169,2863,2792,2751,2661,2538
2228,542,584,2228,0,1993,235,2.62872e+18,255.28,1026.13,2228,96,110,1644,1644,1642,1641,1622
31382,813,1002,31357,25,31382,0,4.30088e+18,352.117,3588.42,31382,201,216,30380,30364,29186,29088,29155
2920,291,333,0,2920,1004,1916,7.21223e+15,111.131,797.596,2920,113,84,2587,2587,2587,2587,2561
33352,1411,4339,33352,0,30320,3032,2.36401e+18,820.89,8975.5,33352,409,530,29013,27896,18568,17280,14741
33039,19,265,0,33039,32592,447,2.53671e+16,131.067,1874.86,33039,92,93,30694,29249,25521,21786,13581
39153,438,857,39035,118,39153,0,4.31493e+18,349.314,3759.68,39153,205,214,38296,38003,33087,32872,31168
4461,355,1152,2694,1767,0,4461,4.85879e+18,264.621,1942.96,4461,189,173,3279,2863,2262,2240,1654
36964,9,634,36964,0,36964,0,4.09104e+18,357.894,3424.93,36964,205,206,12320,4667,4156,3929,896
11062,24,40,10917,145,11062,0,1.04885e+14,15.11,372.39,11062,20,21,11022,11021,10542,10575,8607
32716,2523,3046,32716,0,29096,3620,2.23383e+18,1201.7,7483.05,32716,424,385,29670,29260,29252,29018,25733
27337,252,276,0,27337,26844,493,2.65093e+16,122.613,1701.49,27337,87,102,27061,27059,26927,26904,26621
36340,138,2212,10671,25669,0,36340,3.66561e+13,843.034,6761.76,36340,454,499,29683,25737,19225,14706,3842
2056,82,103,0,2056,2017,39,2.77927e+16,29.1206,324.85,2056,35,31,1953,1951,1933,1948,1857
5571,890,1246,3397,2174,3397,2174,1.82005e+18,238.475,2199.44,5571,210,225,4325,4316,3947,3790,3267
22131,1276,2651,13261,8870,13261,8870,1.8757e+18,738.503,6011.34,22131,396,314,19480,18633,17869,17651,11209
13613,11,198,0,13613,13296,317,2.53391e+16,95.7231,1141.44,13613,72,69,12162,10608,9834,8937,5126
29867,951,3649,0,29867,0,29867,2.43643e+18,603.14,7695.33,29867,358,452,26218,25170,20992,18115,12991
27737,1771,2953,0,27737,0,27737,2.2915e+18,673.815,6986.15,27737,352,423,24784,24743,23540,22788,18366
28938,2247,4096,28938,0,28938,0,8.96347e+15,3516.24,10885.6,28938,4096,8,13748,0,3261,13476,13748
48953,145,3266,28945,20008,28945,20008,1.80783e+18,826.094,9192.32,48953,482,411,36924,30825,22489,16447,5272
26500,1264,3651,26500,0,23294,3206,2.6739e+18,864.186,7568.54,26500,461,365,22849,21637,16330,13990,11891
45956,989,2564,27801,18155,0,45956,5.09478e+18,1079.76,7852.58,45956,524,475,42500,39020,36645,35407,26095
23377,99,854,23377,0,23352,25,4.22447e+18,320.461,3002.54,23377,185,193,19277,14879,10227,9780,4867
3207,113,996,0,3207,0,3207,2.25823e+18,143.738,1548.59,3207,211,130,2064,1702,1094,878,479
27259,26477,27259,0,27259,0,27259,1048540,0,27259,27259,27259,1,0,0,0,0,0
41166,1337,4582,41166,0,37281,3885,2.07024e+18,1365.43,10529.8,41166,470,618,35748,32921,26437,20753,16458
19632,399,2453,19632,0,17331,2301,2.73069e+18,1293.44,5675.53,19632,374,397,14677,12606,6614,4920,4042
37722,502,3030,21730,15992,21730,15992,1.72892e+18,1255.74,7947.73,37722,471,551,32274,29578,23663,20936,10627
4464,5,17,4420,44,4464,0,9.77346e+13,9.8022,179.291,4464,13,14,4291,4131,3672,3794,2788
41064,2246,2981,0,41064,12196,28868,9.28039e+15,581.411,8328.02,41064,411,462,38083,37991,37823,37707,30884
45403,816,888,45391,12,45403,0,4.11569e+18,400.348,4104.82,45403,238,227,44515,44509,44245,44265,44260
39249,153,292,0,39249,38627,622,2.64555e+16,148.334,2167.32,39249,97,113,38922,38772,35918,34781,30698
42747,1447,1919,0,42747,13945,28802,8.75674e+15,896.656,6757.74,42747,421,480,40828,40359,39845,39845,37952
43971,38,65,43351,620,43947,24,9.73076e+13,19.9365,815.296,43971,29,29,43906,43906,42126,42126,33503
20364,2264,2647,20364,0,18234,2130,2.37441e+18,1063.72,5926.22,20364,406,341,17717,17590,17585,17516,16561
40309,1601,3641,0,40309,0,40309,2.27147e+18,888.109,9265.16,40309,515,471,36668,35911,32546,30671,24125
28524,743,2446,25445,3079,17544,10980,1.93808e+18,590.048,6342.29,28524,419,297,26050,25446,18621,18410,13888
45080,1741,3670,26082,18998,0,45080,4.48049e+18,1340.71,9542.45,45080,515,603,41284,39996,33399,34434,26447
21846,757,820,21846,0,21846,0,4.32109e+18,328.717,2859.15,21846,186,194,21026,21025,21014,21017,20974
24030,3577,3672,14151,9879,14151,9879,1.70318e+18,626.119,7419.2,24030,467,495,20358,20358,20343,20351,20278
49092,40,1140,49092,0,49067,25,4.33692e+18,381.774,4511.93,49092,235,230,32328,21039,14933,13917,3566
36798,734,1660,12113,24685,0,36798,3.31069e+13,533.385,5893.98,36798,375,396,35085,34757,31496,31298,21664
39214,642,2478,12139,27075,0,39214,3.42402e+13,576.592,7358.9,39214,419,425,36513,35500,26931,27236,15479
24485,1773,1981,0,24485,0,24485,2.37404e+18,717.335,5316.83,24485,368,284,22504,22502,22457,22469,21928
14324,82,1641,7766,6558,7766,6558,1.56034e+18,267.537,3447.41,14324,211,261,10160,6520,4789,4701,2166
21903,1456,2756,21903,0,19607,2296,2.0124e+18,518.148,6031,21903,312,383,19147,18961,18622,18244,13641
47107,2746,3313,27245,19862,27245,19862,1.74339e+18,893.445,9140.29,47107,473,587,43794,43777,43220,43462,40345
33435,862,2925,19568,13867,19568,13867,1.75708e+18,835.138,7265.71,33435,375,416,30070,28824,25053,23512,13991
47517,1953,2645,42030,5487,27589,19928,1.94384e+18,1107.93,8261.12,47517,437,466,44872,44859,44427,44543,41677
42557,137,279,0,42557,41669,888,2.59806e+16,148.221,2177.42,42557,116,124,42193,41978,37823,37180,32445
3742,204,547,0,3742,0,3742,2.32222e+18,287.371,1213.74,3742,139,140,2723,2062,1911,1740,1821
46175,2100,2633,13610,32565,0,46175,3.65703e+13,970.655,7977.29,46175,436,456,43542,43140,43123,43134,40882
34229,1074,3569,30577,3652,20560,13669,1.9856e+18,1041.32,8548.58,34229,445,500,30033,27607,23099,22454,13056
23970,1700,3190,0,23970,0,23970,2.33528e+18,892.856,6930.58,23970,447,480,20780,19984,18744,18462,14514
22061,148,244,0,22061,21628,433,2.60977e+16,106.422,1564.93,22061,84,85,21817,21780,20794,20771,18283
44773,37,58,44089,684,44773,0,9.59355e+13,19.276,748.364,44773,27,26,44715,44712,43491,43492,38384
47768,5288,5383,42572,5196,28753,19015,2.01426e+18,1144.39,12053.8,47768,427,693,42385,42385,42382,42382,42308
17715,540,1252,0,17715,5272,12443,9.37645e+15,473.339,3723.79,17715,285,307,16194,15323,14816,14861,10180
15113,1079,1084,0,15113,4940,10173,9.056e+15,327.659,3073.36,15113,279,214,14029,14029,14029,14029,14029
45992,891,2469,12968,33024,0,45992,3.74517e+13,813.496,7926.93,45992,490,494,43195,41963,38899,38958,22921
43665,3162,3434,0,43665,0,43665,2.42254e+18,1259.07,8982.95,43665,514,541,40231,40227,40140,39969,39297
48720,971,3273,29026,19694,29026,19694,1.8691e+18,1218.34,9584.4,48720,539,490,44320,41271,38026,36558,16701
13926,1483,2170,0,13926,0,13926,2.53826e+18,412.896,4310.58,13926,312,405,11756,11729,11551,11564,9745
9400,374,483,9400,0,9400,0,4.20182e+18,260.866,1653.66,9400,132,132,8917,8894,8383,8339,7946
19725,2449,2856,19725,0,17477,2248,1.6661e+18,445.518,5727.55,19725,365,276,16869,16858,16822,16825,16219
7793,77,150,0,7793,7629,164,2.3671e+16,53.4304,717.557,7793,49,54,7643,7597,7028,7083,5708
36927,3744,3896,32994,3933,21228,15699,1.91346e+18,934.233,9191.45,36927,520,491,33031,33031,33022,33023,32524
25839,2251,2809,23112,2727,15285,10554,1.95602e+18,1000.7,6359.52,25839,410,369,23030,22649,22770,22761,21739
49885,1600,3134,0,49885,15644,34241,8.74725e+15,629.569,8977.96,49885,576,493,46751,46428,42227,42460,31222
48490,2964,4580,28580,19910,0,48490,4.61996e+18,1205.22,11393.2,48490,502,534,43910,43532,39219,39345,34685
19691,1194,1316,0,19691,5533,14158,9.38215e+15,433.034,3748.58,19691,309,277,18375,18277,18269,18275,18059
48152,48103,48152,48152,0,48152,0,6.8718e+10,0,48152,48152,48152,1,0,0,0,0,0
31468,34,48,30996,472,31468,0,9.96722e+13,17.9565,617.643,31468,27,25,31420,31420,30936,30937,29531
24326,3124,3588,24326,0,21602,2724,1.93573e+18,934.988,7495.93,24326,383,428,20738,20736,20645,20582,19782
1163,49,282,1163,0,1163,0,3.9066e+18,99.7481,516.258,1163,56,55,674,315,266,264,235
24284,517,676,24284,0,24284,0,3.95997e+18,335.258,2875.83,24284,188,190,23608,23567,22080,22161,20885
13042,9,177,0,13042,12788,254,2.4918e+16,50.5543,919.544,13042,60,54,11256,9972,9315,6778,5150
39208,2106,3572,0,39208,0,39208,2.34915e+18,683.935,8690.44,39208,337,618,35636,35605,35020,35215,27831
40161,812,3162,24104,16057,24104,16057,1.79456e+18,1053.85,8357.58,40161,508,446,36074,34147,26129,26939,13780
31459,20,72,30842,617,31459,0,1.00318e+14,18.2186,701.74,31459,28,29,31379,31354,28153,27882,18048
22299,1815,2467,13444,8855,0,22299,4.70107e+18,607.598,5664.45,22299,412,250,19832,19676,19582,19584,17301
41495,1198,3323,41495,0,37415,4080,2.87191e+18,1257.15,8906.53,41495,502,410,37141,34801,32407,29768,19589
15548,198,684,15548,0,15548,0,4.04014e+18,306.116,2365.28,15548,169,158,14426,13469,8914,8710,7344
2826,221,800,1655,1171,0,2826,5.08158e+18,100.994,1211.18,2826,157,82,2026,1878,1325,1275,501
33639,2267,2853,19490,14149,0,33639,4.48804e+18,898.549,7356.54,33639,393,386,30786,30737,30551,30547,27513
49794,2411,3695,30025,19769,30025,19769,1.91698e+18,864.538,9723.86,49794,532,392,46099,45779,45240,45438,37971
24741,107,714,24741,0,24741,0,4.17585e+18,318.699,2913.77,24741,194,183,21017,17307,11721,10762,4773
35241,340,2201,20410,14831,20410,14831,1.63432e+18,1049.8,6471.79,35241,385,417,29869,26971,16663,16442,9309
7547,186,193,0,7547,7399,148,2.64381e+16,82.9009,843.205,7547,61,64,7354,7354,7329,7338,7252
33208,2666,3216,19853,13355,0,33208,4.80418e+18,929.469,7861.57,33208,457,487,29992,29991,29771,29754,27392
1793,203,221,1793,0,1793,0,4.79728e+18,89.2716,553.073,1793,65,58,1572,1572,1564,1561,1519
19051,1202,2421,11479,7572,11479,7572,1.85013e+18,658.775,5330.29,19051,309,310,16630,15939,15408,15180,10524
22456,2570,3105,22456,0,19878,2578,1.48817e+18,850.443,6712.55,22456,353,455,19351,19348,19250,19262,18079
26565,463,705,26555,10,26565,0,4.12993e+18,293.56,2956.15,26565,182,186,25860,25837,24122,24197,23449
48084,189,1379,48054,30,48084,0,4.02131e+18,426.204,4826.48,48084,246,246,43888,38703,23253,21776,13302
28887,31,55,28554,333,28869,18,9.97983e+13,21.5624,678.511,28887,25,27,28832,28824,27586,27595,20961
24913,1573,2559,14644,10269,0,24913,4.93273e+18,577.528,5982.95,24913,406,268,22354,22043,21428,21290,16339
31325,766,3076,19383,11942,0,31325,4.5465e+18,773.544,7095.25,31325,456,371,27910,26112,17836,16669,13734
22757,1186,2269,13427,9330,0,22757,4.85364e+18,727.24,5723.85,22757,427,457,20488,20050,18725,18523,10263
49944,2382,2643,0,49944,15211,34733,9.31504e+15,793.825,8514.66,49944,390,508,47301,47301,47234,47251,46159
9209,14,189,0,9209,9047,162,2.77543e+16,74.5848,935.395,9209,64,68,8359,7966,6778,6142,3353
38688,32,63,38162,526,38676,12,1.00541e+14,19.7966,804.616,38688,27,31,38625,38622,36496,36436,26802
48476,2856,5216,48476,0,43004,5472,2.5137e+18,1194.11,12069.9,48476,607,555,43260,42869,40355,38795,24708
36278,461,2545,21413,14865,21413,14865,1.87383e+18,865.453,7014.78,36278,470,472,32055,29877,24791,23449,12460
1752,537,560,1752,0,1563,189,2.71064e+18,71.3099,829.634,1752,101,70,1192,1191,1192,1192,1192
25954,26,243,0,25954,25301,653,2.49318e+16,112.203,1663.99,25954,84,111,24216,23324,19990,16080,11371
45102,322,4660,45102,0,40248,4854,2.24742e+18,1310.65,10824.5,45102,488,626,34165,27012,16307,15733,6246
39185,2688,2862,0,39185,0,39185,2.25817e+18,1045.4,7355.19,39185,357,423,36323,36323,36281,36301,35879
17248,1714,2186,0,17248,0,17248,2.11514e+18,415.81,4497.94,17248,308,316,15062,14965,14912,15004,13895
48043,3202,3985,29116,18927,29116,18927,1.82912e+18,1176.46,10152.5,48043,652,525,44058,44010,43626,43770,40218
27459,24,59,26997,462,27459,0,9.96784e+13,18.9495,631.133,27459,24,28,27398,27390,25149,24990,17515
2574,3,23,2545,29,2574,0,1.03339e+14,11.6593,175.221,2574,14,15,2090,1837,1841,1811,1184
22655,2337,2536,20139,2516,13871,8784,1.9371e+18,760.566,5733.57,22655,350,327,20119,20117,20115,20114,19830
3921,196,659,0,3921,1076,2845,1.01364e+16,146.109,1294.89,3921,151,116,3217,2947,2902,2924,1638
9625,163,1115,0,9625,2945,6680,8.91907e+15,235.053,2615.11,9625,179,219,8004,7155,6172,6343,2384
33726,390,2930,19370,14356,19370,14356,1.75585e+18,667.304,7309.4,33726,373,490,28691,25976,21809,19763,6492
27800,154,258,0,27800,27197,603,2.79963e+16,121.321,1726.42,27800,98,95,27542,27467,25918,25599,22958
40376,1450,3790,36068,4308,24416,15960,1.98008e+18,1237.67,9186.34,40376,503,476,36082,34519,29843,29862,21983
48443,301,1221,48443,0,48443,0,4.1638e+18,404.178,4582.73,48443,236,239,46768,45395,28745,26998,19564
15070,855,1515,15070,0,13340,1730,2.67215e+18,695.981,3779.4,15070,294,275,13232,12882,11180,10803,10209
15831,1835,2134,0,15831,0,15831,2.47225e+18,442.444,4573.15,15831,284,272,13697,13615,13556,13679,12649
16291,6059,16291,16291,0,16291,0,68715300000,0,16291,16291,16291,1,0,0,0,0,0
35469,516,700,35469,0,35459,10,4.25073e+18,306.799,3398.52,35469,210,194,34769,34758,33121,33065,32967
25881,66,1513,7174,18707,0,25881,3.85039e+13,534.59,4527.19,25881,351,240,19696,16727,12953,9179,3394
6509,100,711,0,6509,0,6509,1.9073e+18,119.867,1656.5,6509,123,161,5452,4106,2609,2957,2022
34315,65,2480,0,34315,0,34315,2.21955e+18,716.316,7008.17,34315,407,451,20445,14419,9887,7138,1127
8642,15,1124,2619,6023,0,8642,3.63207e+13,209.624,2444.72,8642,239,163,4706,2801,2440,1322,625
49449,131,767,49449,0,49449,0,4.27555e+18,382.162,4034.49,49449,221,222,45331,39047,22076,21759,11944
44166,2534,4459,44141,25,39833,4333,1.79337e+18,1158.82,10267.6,44166,595,452,39707,39207,38176,38208,31408
16230,669,1408,4936,11294,0,16230,3.62476e+13,348.438,3573.84,16230,289,219,14822,14634,13771,13856,10114
22171,657,801,22171,0,22171,0,4.15959e+18,326.815,2855.08,22171,179,193,21370,21319,20800,20741,20544
43063,86,4208,43063,0,38547,4516,2.84687e+18,924.772,9682.64,43063,406,593,25477,16949,10184,6200,2370
24282,28,43,23906,376,24282,0,9.98067e+13,17.5346,541.722,24282,23,24,24239,24238,23516,23516,21777
39094,1847,2878,24028,15066,24028,15066,1.81235e+18,743.619,7634.05,39094,480,361,36216,35997,35371,34762,30732
34503,2784,3472,20482,14021,20482,14021,1.89637e+18,673.831,8259.64,34503,439,688,31031,31021,30661,30773,27778
13886,429,1590,7827,6059,7827,6059,1.56764e+18,462.389,3571.09,13886,266,265,12112,11454,10867,9474,3943
11739,883,2643,11739,0,10528,1211,2.57306e+18,470.066,4624.92,11739,261,344,9096,8465,6314,5839,4292
12149,33,39,11908,241,12149,0,9.83741e+13,15.2926,388.32,12149,22,18,12110,12110,12060,12060,11730
45187,951,2596,40149,5038,26623,18564,1.9723e+18,1373.86,8129.77,45187,413,448,41355,39308,34309,33785,21665
9453,41,454,9453,0,9453,0,4.7596e+18,209.697,1597.84,9453,128,122,6411,4212,2447,2268,1369
26065,2043,2614,15441,10624,0,26065,4.65003e+18,931.389,6451.92,26065,477,443,23451,23441,23242,23188,22248
22443,22,66,22009,434,22426,17,9.86915e+13,17.548,591.525,22443,26,25,22377,22367,20588,20349,14604
683,225,318,427,256,427,256,1.95581e+18,21.4758,415.326,683,72,47,365,365,336,327,328
46949,1788,3732,26858,20091,26858,20091,1.7492e+18,1261.23,9880.74,46949,583,667,42982,41949,41090,40922,30698
47447,487,2060,0,47447,14265,33182,8.77476e+15,951.679,7172.46,47447,437,389,43937,41989,34611,34337,16876
6004,406,816,0,6004,1948,4056,8.49695e+15,238.559,1841.34,6004,202,165,5186,4898,4407,4385,3134
5211,282,352,5211,0,5211,0,3.93638e+18,208.273,1125.14,5211,110,98,4859,4785,4537,4522,4209
16482,168,685,16482,0,16482,0,4.07449e+18,293.893,2403.65,16482,168,159,14918,13204,8823,8185,5309
30860,2239,2346,18774,12086,18774,12086,1.87016e+18,892.436,6418.74,30860,371,341,28514,28390,28465,28485,28364
806,57,282,478,328,478,328,1.94883e+18,58.5372,432.826,806,55,68,445,288,286,265,51
41631,414,2531,13427,28204,0,41631,3.2061e+13,637.039,7546.2,41631,465,478,38390,36704,27438,27535,11673
46067,107,970,46067,0,46067,0,4.39806e+18,367.856,4166.5,46067,226,227,39335,32602,20714,18282,9756
7966,18,34,7833,133,7966,0,1.01446e+14,15.1415,311.451,7966,21,22,7928,7919,7363,7332,5571
21051,127,302,0,21051,20772,279,2.69528e+16,120.9,1689.33,21051,87,89,20718,20565,18517,17506,13478
46537,157,291,0,46537,45629,908,2.62422e+16,131.279,2269.85,46537,105,113,46246,46156,42579,40734,35204
24835,852,2119,14731,10104,14731,10104,1.74934e+18,860.37,5659.44,24835,393,377,22484,21809,20194,19501,9939
35048,1339,2558,20274,14774,20274,14774,1.72487e+18,918.624,7144.22,35048,448,402,32424,31510,30941,30396,24388
29852,3770,4224,29852,0,26721,3131,2.32357e+18,980.74,8818.79,29852,467,455,25628,25561,25420,25385,23507
3209,563,675,0,3209,0,3209,2.16499e+18,170.017,1246.78,3209,122,131,2534,2532,2531,2534,2236
2088,86,96,0,2088,2047,41,2.56412e+16,41.2605,296.366,2088,34,40,1992,1992,1992,1992,1981
36014,13,56,35524,490,36014,0,9.86736e+13,18.3153,675.293,36014,25,22,35894,35789,32633,32410,21031
15389,21,34,15143,246,15389,0,9.90259e+13,17.3753,408.322,15389,20,20,15355,15346,14546,14545,13314
27343,1120,2436,15751,11592,0,27343,4.39703e+18,781.352,6067.51,27343,386,282,24863,23986,23144,22424,14965
44539,1233,2662,0,44539,13645,30894,8.73408e+15,655.717,7876.51,44539,352,580,41877,41278,40578,40536,28393
1339,8,9,1335,4,1339,0,1.14776e+14,7.46079,89.7188,1339,9,8,1330,1330,1330,1330,1327
47142,2602,5320,47142,0,41795,5347,2.85229e+18,1115.04,11948.8,47142,527,630,41822,41253,40373,40177,27555
21533,1116,1616,0,21533,0,21533,2.31099e+18,517.397,4280.45,21533,322,379,19917,19655,18578,17181,17583
49938,33,92,49135,803,49938,0,1.01401e+14,21.2439,891.689,49938,29,34,49846,49835,46324,46064,34964
18909,151,229,0,18909,18662,247,2.6039e+16,114.59,1401.48,18909,85,90,18678,18579,17738,17854,15979
27219,1022,3133,24239,2980,16100,11119,1.95993e+18,838.193,7090.94,27219,320,480,23884,23014,20821,20992,12497
6595,19,24,6478,117,6595,0,9.89753e+13,16.0484,255.121,6595,17,20,6568,6565,6300,6300,6254
33934,1615,2085,19710,14224,19710,14224,1.64886e+18,822.475,6142.26,33934,352,349,31849,30928,31389,31392,25717
24427,398,1783,7593,16834,0,24427,3.50469e+13,470.751,4882.51,24427,365,297,22233,21179,13865,13812,9332
24343,1412,2662,14190,10153,14190,10153,1.821e+18,599.616,6181.48,24343,394,327,21681,21367,20406,19569,13996
18914,5,48,18661,253,18914,0,1.00512e+14,19.3184,495.835,18914,24,25,17802,16876,14975,15049,8563
15616,1430,1701,8821,6795,0,15616,4.27124e+18,740.552,3838.15,15616,270,238,13915,13319,13810,13806,13105
34367,2432,3430,30473,3894,20486,13881,1.94011e+18,1017.18,8238.07,34367,387,445,30937,30888,30096,30267,27042
25368,274,301,0,25368,24695,673,2.60133e+16,119.462,1900.71,25368,102,97,25067,25067,25034,24890,24639
24929,965,2035,14753,10176,14753,10176,1.80547e+18,861.541,5614.14,24929,342,411,22500,21223,20884,20445,14330
12964,161,12964,12964,0,12964,0,68714200000,0,12964,12964,12964,1,0,0,0,0,0
27649,1151,2549,16592,11057,0,27649,5.07197e+18,809.147,6259.8,27649,544,306,25067,23820,21790,21443,18146
11331,1345,2093,6689,4642,0,11331,4.6654e+18,340.336,3902.24,11331,236,278,9238,9108,8832,8864,6549
31231,281,922,31231,0,31231,0,3.88044e+18,330.184,3438.11,31231,210,206,30057,29246,21801,21247,15829
10137,13,35,10013,124,10119,18,1.01295e+14,19.6915,363.372,10137,20,23,10055,9982,8994,8833,6141
42236,51,329,0,42236,41425,811,2.63077e+16,132.783,2406.11,42236,115,109,40782,39364,33774,31189,20017
42671,85,98,41907,764,42671,0,1.03834e+14,19.217,857.899,42671,28,29,42573,42573,42103,42103,41039
20041,368,2563,20041,0,18218,1823,2.10647e+18,979.221,5308.82,20041,319,260,16484,14970,5650,3662,2374
25966,35,58,25518,448,25966,0,1.04575e+14,20.7337,608.696,25966,26,26,25908,25905,25347,25347,23425
24184,1938,2419,14024,10160,14024,10160,1.76144e+18,618.134,5909.07,24184,326,445,21765,21756,21561,21601,19528
42512,1584,4367,0,42512,0,42512,2.33096e+18,736.808,9928.05,42512,550,360,38145,37565,26558,22051,13137
15203,748,1725,4497,10706,0,15203,3.57017e+13,396.276,3965.89,15203,414,295,13478,13270,11688,11818,8243
40920,28,64,40219,701,40920,0,1.01323e+14,22.8558,743.156,40920,29,32,40855,40841,38344,38200,29403
12528,113,1345,3968,8560,0,12528,3.38967e+13,245.48,3152.03,12528,322,186,10139,8863,6305,5421,2609
28732,76,952,28732,0,28682,50,4.30669e+18,344.713,3398.47,28732,205,193,22299,16361,10786,9788,4935
4187,3507,4187,0,4187,4187,0,4095.02,0,4187,4187,4187,1,0,0,0,0,0
29573,957,1491,0,29573,8464,21109,9.51049e+15,603.421,4823.75,29573,427,269,28082,27652,26429,26502,23442
16964,1891,2034,0,16964,0,16964,2.24305e+18,479.938,4621.31,16964,314,298,14930,14930,14707,14603,14589
11690,21,36,11409,281,11690,0,1.00575e+14,15.5973,358.269,11690,21,20,11654,11651,11039,10996,9436
13159,192,574,13159,0,13130,29,4.56086e+18,271.631,2032.48,13159,144,138,12118,10953,7543,7130,5552
41826,538,1038,41826,0,41826,0,4.11648e+18,381.004,4126.47,41826,233,232,40788,40618,35194,35070,34901
21681,1151,1391,6574,15107,0,21681,3.62312e+13,439.769,4172.83,21681,324,288,20290,20287,20242,20237,19559
38211,2638,3623,33607,4604,23090,15121,1.93672e+18,1163.99,8841.14,38211,481,506,34588,34514,33420,33441,31604
33930,900,1946,9642,24288,0,33930,3.72483e+13,730.88,5990.36,33930,458,425,31795,31050,28960,29145,18101
23765,829,1800,7114,16651,0,23765,3.61917e+13,495.355,4971.21,23765,325,319,21965,21548,20141,20202,13097
29784,981,2391,0,29784,0,29784,2.22689e+18,539.872,6204.19,29784,267,424,27393,26905,25801,22117,17465
31732,339,2010,0,31732,0,31732,2.03582e+18,980.755,5744.22,31732,370,305,27862,26415,19761,18083,5515
49039,3962,3990,0,49039,0,49039,2.28466e+18,1151.98,10275.9,49039,594,546,45049,45049,45046,45046,45029
4165,19,30,4102,63,4165,0,1.0421e+14,13.1592,210.282,4165,18,15,4135,4134,3920,3918,3892
31692,33,60,31140,552,31692,0,1.01987e+14,19.3002,652.51,31692,26,27,31632,31631,30071,30071,24515
13361,511,2290,12140,1221,7499,5862,1.91967e+18,322.323,4161.96,13361,260,266,11050,10379,3884,3485,2181
6318,355,402,6318,0,6318,0,4.35021e+18,237.465,1292.04,6318,116,111,5916,5916,5770,5785,5801
7163,74,763,0,7163,2038,5125,9.08693e+15,309.557,1870.67,7163,221,173,5277,4456,3840,3630,1425
34767,1672,2353,20449,14318,0,34767,4.88032e+18,1060.56,6736.84,34767,456,374,32414,31476,31137,30984,27282
13878,1012,1956,12569,1309,8550,5328,2.00077e+18,478.404,4079.02,13878,336,218,11922,11445,10758,10797,8699
43094,2933,3995,43094,0,38333,4761,3.00346e+18,1237.51,9901.17,43094,510,514,39099,38842,38744,38712,34522
15297,1489,1907,0,15297,4819,10478,9.29532e+15,278.03,4352.98,15297,182,512,13390,13387,13278,13251,11445
6443,1152,1196,0,6443,0,6443,2.30529e+18,344.29,2358.17,6443,237,191,5247,5247,5235,5239,5195
8592,677,905,2485,6107,0,8592,3.46167e+13,342.306,2247.25,8592,238,193,7687,7536,7394,7401,6910
35177,3027,3685,0,35177,0,35177,2.33601e+18,865.822,8653.5,35177,570,469,31492,31444,31203,30787,28509
22434,1903,2460,13013,9421,13013,9421,1.7608e+18,769.025,5780.8,22434,358,466,19974,19893,19569,19745,17018
14545,314,1845,14545,0,13239,1306,2.28227e+18,757.175,4199.81,14545,248,302,11274,9805,4522,3347,2737
47198,3137,4808,47198,0,41389,5809,2.47017e+18,1360.31,11275.8,47198,668,499,42390,41780,41878,41448,34765
500,12,173,500,0,500,0,4.04906e+18,44.926,272.075,500,36,39,180,67,53,48,35
27553,593,1463,8791,18762,0,27553,3.44027e+13,550.426,4614.73,27553,308,280,25900,24903,20916,20805,14605
12760,511,1230,7975,4785,0,12760,4.88446e+18,688.985,3265.36,12760,230,286,10678,9287,8222,8063,6019
2684,4,77,0,2684,2662,22,2.75989e+16,40.5462,309.428,2684,35,40,1929,1673,1405,1165,1015
24089,369,1858,14710,9379,14710,9379,1.84397e+18,668.033,5076.76,24089,319,342,19770,16412,12607,13205,4970
44697,2461,2469,0,44697,13893,30804,9.01956e+15,661.056,7620.52,44697,439,528,42228,42228,42226,42228,42225
11777,712,1481,0,11777,0,11777,2.23718e+18,447.517,3280.54,11777,239,261,10296,9886,9064,7699,6031
13858,1556,2039,0,13858,0,13858,2.1974e+18,357.736,4307.07,13858,228,440,11819,11797,11718,11779,9835
48671,11,60,47577,1094,48671,0,1.00952e+14,19.8379,799.981,48671,27,29,48357,48103,43105,42421,26136
21490,11,227,0,21490,21044,446,2.64625e+16,94.5329,1356.49,21490,78,89,19292,17868,16088,12874,7783
43991,1011,2697,26085,17906,0,43991,4.99563e+18,1285.18,8061.16,43991,515,457,40031,37446,35284,34848,19836
12773,367,1818,7526,5247,7526,5247,1.87278e+18,459.405,3775.02,12773,277,262,10464,9245,8041,7781,2440
15358,18,215,0,15358,15187,171,2.46699e+16,108.592,1262.26,15358,68,78,14142,13454,11391,9243,6086
28407,11,249,0,28407,27800,607,2.50085e+16,118.306,1762.99,28407,87,85,25543,23014,20825,17642,10549
9349,1488,1780,5638,3711,0,9349,4.7632e+18,294.536,3337.54,9349,260,247,7569,7548,7454,7480,6117
35817,1913,2695,20486,15331,0,35817,4.39148e+18,967.613,7328.39,35817,472,490,33122,32781,31855,31505,29833
11646,5,29,11417,229,11646,0,9.94809e+13,16.0801,349.505,11646,20,20,11016,10600,9240,9387,6086
28074,969,2530,16234,11840,0,28074,4.47532e+18,630.998,5950.55,28074,402,327,25544,24751,21119,21716,14340
20192,1158,2843,17865,2327,11974,8218,1.95347e+18,714.968,6114.4,20192,264,468,17347,16691,14780,14534,11484
29093,136,944,29093,0,29093,0,3.94479e+18,351.249,3427.7,29093,207,203,25378,21427,14239,13332,7368
2811,294,699,1719,1092,0,2811,4.82646e+18,201.589,1215.67,2811,135,118,2080,1816,1576,1632,1342
6972,245,443,6972,0,6972,0,4.22467e+18,234.933,1415.61,6972,117,122,6477,6157,5113,5089,4627
11204,1195,1487,0,11204,0,11204,2.45041e+18,413.258,3245.23,11204,243,240,9717,9713,9654,9706,9000
18613,222,1744,5821,12792,0,18613,3.55961e+13,376.894,4452.41,18613,380,325,15760,14081,8562,8345,3583
45104,159,372,0,45104,44080,1024,2.55455e+16,141.285,2730.91,45104,113,114,44711,44517,40250,39459,30692
46412,1662,3289,41221,5191,27553,18859,1.97462e+18,1381.9,9374.65,46412,555,504,42865,41208,33213,32653,31942
40983,3045,3272,22891,18092,22891,18092,1.64648e+18,1052.7,8262.26,40983,416,496,37711,37707,37621,37645,37441
20686,1489,2775,0,20686,0,20686,2.47777e+18,616.028,6003.98,20686,450,345,17911,17723,14923,14195,10044
41675,1014,2619,24487,17188,0,41675,4.53799e+18,1442.78,7790.99,41675,473,427,37066,34786,31433,30740,18102
48643,39,57,47829,814,48627,16,1.00356e+14,23.6246,875.358,48643,30,31,48586,48582,46869,46920,42682
9528,467,950,2722,6806,0,9528,3.59069e+13,323.426,2379.64,9528,257,197,8550,8222,7656,7695,5409
2602,730,837,2602,0,2346,256,3.23478e+18,145.557,1293.08,2602,130,140,1765,1765,1740,1713,1651
33514,661,2081,10353,23161,0,33514,3.23093e+13,571.309,6038,33514,412,346,31198,30450,24272,23557,15125
21682,390,775,21682,0,21682,0,4.10055e+18,325.327,2824.75,21682,187,179,20907,20652,17927,17743,17124
41716,330,3414,41716,0,36817,4899,2.20689e+18,1483.78,9225.23,41716,445,479,30230,24343,12614,8569,3232
30773,76,253,0,30773,30335,438,2.4753e+16,136.492,1861.97,30773,80,90,30303,30008,26375,23207,16709
42760,617,915,42760,0,42760,0,4.33488e+18,353.831,3919.53,42760,222,221,41845,41776,39823,39652,38666
14324,16,42,14032,292,14318,6,9.96287e+13,17.7362,467.809,14324,22,24,14267,14233,13060,13035,9303
13916,1135,2535,8291,5625,0,13916,4.97172e+18,356.334,4742.36,13916,354,316,11381,11129,10580,10248,6980
14780,550,1784,4286,10494,0,14780,3.63701e+13,280.655,3958.58,14780,293,241,12996,12653,11218,10940,6518
40044,163,2913,0,40044,0,40044,2.42076e+18,1145.86,8042.85,40044,525,374,29416,24709,18696,14772,3819
22894,1447,1577,0,22894,6798,16096,9.36995e+15,422.945,4402.29,22894,389,229,21317,21310,21253,21254,20887
35229,556,1035,35204,25,35229,0,4.17302e+18,390.97,3829.08,35229,221,228,34194,33980,29603,29093,27958
22641,11,62,22052,589,22641,0,1.00514e+14,15.5164,572.838,22641,25,26,22450,22304,19837,19511,10543
4031,619,1040,0,4031,0,4031,2.40725e+18,257.215,1719.2,4031,184,138,2991,2775,2775,2738,2076
36431,223,307,0,36431,35637,794,2.53807e+16,152.289,2207.23,36431,106,120,36124,36055,35057,34770,32673
21603,850,1484,0,21603,6138,15465,9.84735e+15,657.799,4282.97,21603,425,319,19988,19334,18598,18735,15742
698,37,69,0,698,693,5,2.46731e+16,12.8968,169.979,698,22,21,629,624,603,615,503
47821,1571,3790,28977,18844,28977,18844,1.87717e+18,1140.49,9964.05,47821,554,519,43806,41968,39419,38644,25407
38182,1321,1987,0,38182,11953,26229,8.8493e+15,682.177,6417.74,38182,382,434,36195,35984,35251,35219,31020
3321,245,784,0,3321,0,3321,2.60534e+18,143.218,1329.16,3321,135,132,2484,2176,2173,2181,1459
12418,1496,2465,12418,0,11352,1066,1.5444e+18,488.9,4506.55,12418,306,310,9953,9914,9507,9477,8314
19796,1038,1416,6507,13289,0,19796,3.40302e+13,431.257,4020.39,19796,285,399,18380,18373,18157,18164,14981
8583,637,1350,0,8583,0,8583,2.39246e+18,364.32,2694.72,8583,212,200,7233,6816,6099,5315,3911
21513,1217,1301,6725,14788,0,21513,3.54679e+13,476.367,4042.67,21513,359,273,20212,20212,20135,20139,19770
35780,326,894,35780,0,35780,0,4.00209e+18,354.981,3636.68,35780,216,203,34717,33976,27103,26426,22145
35015,1377,3285,0,35015,0,35015,2.2155e+18,703.341,7941.14,35015,534,352,31730,31320,25354,25193,14997
42313,1213,4595,24496,17817,24496,17817,1.73578e+18,869.905,10328.8,42313,609,534,37585,36473,29309,28170,13014
44070,2008,2655,26503,17567,26503,17567,1.88359e+18,1265.67,8056.29,44070,480,461,41415,41075,40749,40986,37348
45482,2236,4125,0,45482,0,45482,2.40819e+18,1040.46,10060.3,45482,431,599,41357,40624,39802,39351,30003
42639,818,4705,38802,3837,25851,16788,1.92357e+18,1332.97,10902.6,42639,548,625,35832,32662,22805,21459,8742
4390,245,812,0,4390,0,4390,2.03536e+18,213.789,1614.86,4390,156,158,3447,3176,2681,2566,1997
36954,82,2048,11336,25618,0,36954,3.42718e+13,756.649,6287.69,36954,438,427,29242,24706,17480,4680,4044
35336,470,3280,35336,0,31368,3968,1.87504e+18,889.974,7920.39,35336,421,395,30325,26863,16583,14487,8851
16760,1407,1493,0,16760,4728,12032,9.3933e+15,408.145,3918.79,16760,371,265,15267,15267,15232,15235,15018
23307,28,54,22705,602,23307,0,1.05516e+14,17.2401,554.918,23307,25,27,23253,23253,21782,21768,16715
41070,1606,1966,13056,28014,0,41070,3.4932e+13,699.231,6506.89,41070,499,447,39104,38980,38419,38444,37339
43295,1903,3008,0,43295,0,43295,2.24405e+18,1152.3,8379.79,43295,467,366,40287,40059,37961,35948,28240
10884,12,42,10722,162,10874,10,1.01816e+14,17.0019,368.32,10884,21,22,10794,10738,9508,9480,5737
18150,45,255,0,18150,17816,334,2.48927e+16,104.959,1422.72,18150,84,88,17460,16893,14175,13214,8044
4549,1076,1137,2720,1829,2720,1829,1.84288e+18,227.329,1926.13,4549,180,142,3412,3412,3394,3402,3370
40730,2089,3437,40730,0,36981,3749,2.09229e+18,1233.59,8666.04,40730,527,522,37293,36572,35011,34842,29629
35018,1066,4050,35018,0,31099,3919,1.93897e+18,783.177,9036.76,35018,397,482,30875,28984,19778,16300,12692
17316,1589,2038,17316,0,15273,2043,2.92181e+18,626.314,4808.64,17316,342,292,15278,15256,15066,14921,13234
15004,143,722,4721,10283,0,15004,3.6295e+13,270.044,2262.53,15004,192,190,12352,9977,7690,7719,6307
41128,37,85,40414,714,41128,0,1.03172e+14,19.1249,815.471,41128,27,31,41043,41040,38327,38186,27995
18164,127,1641,0,18164,5304,12860,9.02027e+15,362.783,4096.9,18164,279,315,15277,13899,10881,10650,4488
25836,120,3089,25836,0,23241,2595,2.54286e+18,675.657,6904.92,25836,310,338,18544,13184,6352,3180,1331
24890,21,37,24577,313,24890,0,1.0049e+14,18.3709,521.028,24890,23,25,24850,24844,23482,23479,21143
20875,1543,2445,18141,2734,12460,8415,1.96327e+18,1331.42,5897.1,20875,375,451,18006,16857,16461,16565,13648
17707,1543,2613,17707,0,16050,1657,2.04837e+18,443.188,5408.22,17707,370,247,15094,15074,14307,13353,9832
38820,185,310,0,38820,38041,779,2.59794e+16,155.731,2211.39,38820,106,129,38503,38408,35958,35917,31329
26340,2275,2498,15256,11084,15256,11084,1.73951e+18,1076.85,6072.98,26340,381,394,23842,23836,23797,23819,23386
7228,2,3,6776,452,7196,32,0.000276702,0.999585,137.638,7228,3,1,7225,7225,7225,7225,7225
24711,22,598,24711,0,24711,0,4.56284e+18,291.554,2720.2,24711,183,186,13829,8239,5050,4638,1501
16918,13,39,16704,214,16918,0,9.88276e+13,16.137,489.036,16918,23,23,16825,16756,15293,15253,12374
48439,350,3107,0,48439,0,48439,2.22791e+18,1556.86,8904.36,48439,477,594,40903,36805,23101,23634,5536
20794,1402,3759,18972,1822,12446,8348,1.995e+18,495.539,6974.92,20794,390,575,17035,16583,14925,15083,6746
9041,1264,1474,5431,3610,5431,3610,1.91987e+18,315.699,2993.2,9041,208,279,7567,7565,7474,7513,6941
38688,200,316,0,38688,37926,762,2.5554e+16,150.075,2330.9,38688,99,115,38372,38269,36793,36893,33095
10361,639,1526,6275,4086,0,10361,5.05345e+18,581.943,3186.5,10361,293,244,8540,7764,7452,7312,5359
41817,1423,3052,41817,0,37322,4495,2.40827e+18,1156.54,8382.78,41817,531,385,38679,37154,34475,34085,25339
22728,2163,3036,22728,0,20089,2639,2.25748e+18,783.784,6431.74,22728,345,348,19692,19594,19430,19244,17637
48093,1183,5138,42795,5298,28843,19250,1.93195e+18,1133.12,11518,48093,553,549,42461,40802,26734,25780,10629
25113,29,35,24651,462,25113,0,9.97993e+13,18.3265,510.472,25113,21,22,25078,25078,24126,24125,21936
27198,806,1226,8329,18869,0,27198,3.37947e+13,474.096,4154.38,27198,305,261,25972,25885,23960,24108,18731
15002,3,48,14602,400,15002,0,9.90474e+13,12.7817,485.228,15002,20,22,12734,11639,10894,10693,6729
10103,14,38,9938,165,10103,0,9.96017e+13,18.581,336.383,10103,21,21,10040,10011,9181,9131,7071
38981,68,901,38981,0,38981,0,4.32301e+18,343.024,3788.17,38981,215,222,29672,21664,15221,13652,5834
46097,2204,3659,28748,17349,0,46097,4.79665e+18,857.926,9377.07,46097,412,480,42438,42310,41101,40830,28686
20921,1684,2085,0,20921,0,20921,2.3867e+18,798.722,5153.91,20921,371,299,18836,18578,18585,18466,17408
44030,63,3726,26487,17543,0,44030,4.74542e+18,730.322,9438.21,44030,360,593,26693,19126,14353,12819,1114
44037,2293,2339,0,44037,13501,30536,8.80411e+15,757.445,6935.06,44037,448,409,41698,41698,41681,41677,41570
6645,1504,1615,6620,25,6046,599,2.21616e+18,205.767,2716.14,6645,226,227,5030,5030,5021,4998,4966
33031,1651,3115,29596,3435,20027,13004,1.93722e+18,1057.44,7768.04,33031,435,367,29916,28951,23106,22753,19784
21607,2071,2109,12826,8781,12826,8781,1.87332e+18,858.221,5208.27,21607,334,388,19498,19498,19479,19481,19473
13340,1124,2225,7949,5391,0,13340,4.53408e+18,326.134,4313.54,13340,317,246,11115,11043,9539,9495,6388
31944,2464,4096,31944,0,31944,0,9.12097e+15,3570.79,11434.7,31944,4096,9,17241,0,7112,16418,17241
4691,377,1034,0,4691,0,4691,2.4112e+18,273.903,1824.81,4691,224,175,3650,3268,3265,3082,1933
5502,592,1317,3309,2193,0,5502,4.49206e+18,319.529,2278.48,5502,244,249,4185,3819,3063,2982,2939
4745,132,672,2658,2087,2658,2087,1.40179e+18,133.819,1434.15,4745,113,143,3902,2940,3006,2560,1543
25661,18,37,25227,434,25661,0,9.62421e+13,16.8378,514.334,25661,20,23,25621,25610,23424,23360,19613
11403,9,43,11149,254,11403,0,1.06365e+14,15.3122,391.591,11403,20,23,11235,11151,9877,9776,6796
1409,2,18,1386,23,1409,0,1.05279e+14,8.57559,110.132,1409,14,13,982,850,792,837,587
6313,412,1386,3661,2652,0,6313,5.2265e+18,232.237,2381.67,6313,223,170,4927,4581,3901,3818,2308
43809,1088,4070,39333,4476,24982,18827,1.91427e+18,1200.69,10116.9,43809,494,508,38794,36629,24994,24521,15019
24554,95,1739,13334,11220,13334,11220,1.46657e+18,675.894,4623.59,24554,345,348,18427,12475,7373,8015,2829
47221,169,336,0,47221,46272,949,2.59918e+16,176.814,2575.43,47221,117,131,46815,46613,42969,41166,35316
30872,27068,30872,0,30872,30872,0,4095.87,0,30872,30872,30872,1,0,0,0,0,0
17558,17,36,17032,526,17558,0,1.00836e+14,17.4692,422.11,17558,21,20,17513,17497,16723,16721,13975
25562,545,631,25562,0,25562,0,4.27301e+18,325.024,2820.17,25562,178,177,24931,24928,24669,24692,24531
22115,307,733,22103,12,22115,0,4.20679e+18,313.317,2806.33,22115,177,181,21283,20741,16063,15867,12898
41692,2116,4329,41667,25,36154,5538,1.44019e+18,1041.07,10278.3,41692,520,601,37363,36968,35833,36037,28848
24099,2387,3140,24099,0,21645,2454,2.75066e+18,960.073,6561.65,24099,321,414,20959,20320,20599,20469,15802
13928,378,596,13928,0,13928,0,3.97367e+18,295.224,2158.56,13928,157,158,13332,13119,11874,11829,11974
13925,189,225,0,13925,13613,312,2.57131e+16,96.8453,1202.09,13925,75,70,13700,13689,13632,13581,13084
21450,663,2535,21450,0,18746,2704,1.93231e+18,1038.59,5964.21,21450,367,390,17653,15937,11741,10056,7914
40026,2281,3665,35783,4243,23738,16288,1.95083e+18,1181.88,9277.33,40026,491,390,36361,35973,33996,34213,28247
29705,133,2647,18121,11584,0,29705,4.60735e+18,834.218,6746.07,29705,387,362,20324,16312,10787,8030,2669
44108,359,840,44108,0,44108,0,4.08268e+18,349.045,3862.53,44108,232,228,43209,42720,33562,32976,31218
46288,79,96,45145,1143,46288,0,1.05414e+14,21.9319,885.984,46288,31,30,46192,46192,45401,45400,43215
36924,41,2341,0,36924,11437,25487,8.79735e+15,530.873,6853.5,36924,354,420,25251,19828,14908,14557,3206
11102,584,1226,6856,4246,6856,4246,1.84724e+18,529.432,2973.84,11102,263,283,9731,8382,7665,7475,6331
31611,2095,2419,28723,2888,17759,13852,1.93932e+18,985.28,6287.5,31611,356,342,29192,29104,29116,29119,28563
4200,373,1034,2552,1648,0,4200,5.11956e+18,218.607,1714.2,4200,171,174,3166,2775,2799,2809,1370
20065,149,262,0,20065,19635,430,2.55012e+16,111.341,1568.09,20065,91,92,19803,19699,18397,18471,15297
40709,2797,3599,0,40709,0,40709,2.36745e+18,843.906,8959.75,40709,465,516,37110,37033,36723,36812,31047
1262,160,354,399,863,0,1262,3.69217e+13,58.5103,587.514,1262,75,79,908,848,858,860,554
37016,648,3959,22078,14938,22078,14938,1.87586e+18,819.265,9290.27,37016,454,537,31953,29394,23282,23054,7361
22193,164,1929,13128,9065,13128,9065,1.88482e+18,703.165,4912.93,22193,394,363,16754,13585,11355,9318,1940
44463,912,1145,44463,0,44438,25,4.13647e+18,394.26,4372.02,44463,232,234,43318,43288,42303,42307,41177
19732,997,1161,6073,13659,0,19732,3.04088e+13,352.958,3317.21,19732,231,214,18571,18381,18541,18535,17064
3211,420,1069,2815,396,1835,1376,1.99486e+18,150.633,1632.69,3211,105,167,2142,2028,1833,1868,1075
24251,1690,1705,0,24251,7698,16553,8.7653e+15,404.857,4633.86,24251,349,296,22546,22546,22546,22546,22538
15916,64,239,0,15916,15719,197,2.67206e+16,108.298,1234.25,15916,81,75,15438,15086,13590,12552,8972
26398,1532,3242,26386,12,23758,2640,1.05769e+18,565.121,6917.17,26398,418,333,23156,22783,21770,21589,16003
6378,2,178,0,6378,6252,126,2.67308e+16,72.9868,742.748,6378,52,55,3658,2955,2739,2717,2097
37953,193,4327,33941,4012,23266,14687,1.93112e+18,1268.03,9834.42,37953,547,598,26325,19620,12111,10605,2946
28932,2236,2521,0,28932,0,28932,2.18195e+18,666.335,6420.61,28932,394,354,26411,26393,26098,26056,25467
33307,1360,2260,9904,23403,0,33307,3.70676e+13,716.72,6436.14,33307,448,408,31047,30616,29840,29905,24738
26812,895,2663,23956,2856,16456,10356,1.94218e+18,982.052,6646.41,26812,428,416,23401,21417,16972,16473,11241
31181,167,2251,0,31181,9741,21440,9.13091e+15,550.118,6220.6,31181,491,384,25998,23026,15271,13211,5219
28163,2120,2606,0,28163,0,28163,2.3702e+18,958.592,6494.37,28163,441,357,25557,25458,24890,24554,22901
12505,250,1532,11287,1218,7516,4989,1.84218e+18,671.593,3436.4,12505,312,234,9292,7256,5847,4919,2476
36731,922,1665,0,36731,11695,25036,8.99482e+15,392.988,5459.01,36731,383,325,35066,35039,34184,34286,30640
12760,1566,2291,12760,0,11454,1306,2.7495e+18,363.421,4279.02,12760,231,291,10469,10396,8604,8627,7057
41927,4044,4154,37378,4549,25622,16305,1.96081e+18,1007.41,10208.6,41927,513,463,37773,37773,37773,37773,37647
38050,414,999,38050,0,38025,25,4.23354e+18,353.429,3862.45,38050,228,225,37051,36659,30482,29847,26970
28643,2608,2647,25815,2828,17514,11129,1.9625e+18,869.937,6695.45,28643,384,325,25996,25996,25994,25994,25926
2389,102,946,2133,256,1462,927,1.96201e+18,147.31,1340.55,2389,181,125,1272,939,569,554,181
41797,1520,3736,0,41797,0,41797,2.43616e+18,849.339,9196.81,41797,538,435,38061,37389,35557,34333,22364
42844,775,880,42814,30,42844,0,4.15419e+18,345.115,3958.97,42844,227,230,41964,41955,40444,40605,39350
15759,7,50,15517,242,15759,0,1.04542e+14,16.8132,454.292,15759,24,24,15372,15182,13325,13083,7779
29329,14,649,29329,0,29329,0,4.58429e+18,336.69,3058.4,29329,199,196,14177,6436,5005,4642,1367
30689,2168,2800,27192,3497,18380,12309,1.99239e+18,1133.18,7201.67,30689,431,437,27889,27864,27054,27087,25017
42926,2126,3575,24419,18507,24419,18507,1.6724e+18,1025.41,8925.77,42926,467,470,39351,38671,35916,33855,27754
48438,1804,2735,30250,18188,30250,18188,1.88554e+18,1046.59,8119.24,48438,449,501,45703,45452,44572,44656,38805
38754,406,1961,0,38754,0,38754,2.43819e+18,484.05,5558.2,38754,313,317,35283,26943,13841,12094,5805
41175,4265,4534,36983,4192,23924,17251,1.95399e+18,937.946,10289.8,41175,372,592,36641,36641,36629,36627,36351
8826,77,1094,0,8826,2919,5907,8.66356e+15,241.866,2542.76,8826,216,200,6650,5517,3565,3498,881
45678,1371,2234,15019,30659,0,45678,3.336e+13,717.903,7117.57,45678,447,532,43444,43272,41215,41248,36364
9514,815,2005,9514,0,8631,883,3.19838e+18,381.524,3503.18,9514,286,244,7509,7063,6426,6008,4291
14172,5,34,13987,185,14172,0,1.01889e+14,17.9548,405.274,14172,22,22,13226,12432,11055,11271,7336
15597,1767,1984,9319,6278,9319,6278,1.79646e+18,572.02,4367.03,15597,289,320,13613,13610,13517,13568,12838
17966,847,3139,16194,1772,10770,7196,1.97004e+18,507.253,6080.7,17966,269,424,14774,13794,11659,11374,6307
11037,290,1309,3439,7598,0,11037,3.4371e+13,277.761,2962.84,11037,315,197,9397,8678,5395,5498,2547
14314,469,2500,14314,0,12854,1460,1.98238e+18,437.545,4706.95,14314,232,325,11579,10523,4912,2735,2316
31729,2810,3193,31729,0,28063,3666,1.33798e+18,1054.29,7838.7,31729,516,428,28536,28533,28364,28291,26746
19925,1464,2788,11526,8399,11526,8399,1.64028e+18,430.846,5679.13,19925,331,533,17137,16793,16269,15466,11528
23204,34,54,22628,576,23204,0,1.00501e+14,19.8648,547.589,23204,24,26,23150,23144,22193,22194,18798
23638,1589,3287,21161,2477,13925,9713,1.9044e+18,806.878,7067.61,23638,328,564,20351,19602,18537,18682,9694
8327,222,797,0,8327,2689,5638,9.45967e+15,314.758,2066.65,8327,203,232,7095,6188,5526,5604,3953
49376,114,330,0,49376,48563,813,2.74142e+16,148.993,2515.64,49376,118,133,48762,48290,42087,39032,30717
32709,224,292,0,32709,32223,486,2.55327e+16,146.373,1916.18,32709,99,99,32417,32399,31609,31503,30644
15830,1294,2762,13970,1860,9457,6373,1.96835e+18,823.335,5366.03,15830,325,394,13068,12219,10683,10577,8176
18249,977,1471,0,18249,5621,12628,8.71056e+15,373.36,3978.41,18249,368,290,16778,16758,15898,15984,14097
47217,767,947,47207,10,47217,0,4.20864e+18,353.014,4148.58,47217,229,228,46270,46245,44466,44617,42101
1201,469,659,1201,0,1108,93,2.38932e+18,46.1099,830.949,1201,100,112,542,532,533,542,475
4965,162,510,1672,3293,0,4965,2.92546e+13,107.864,1194.69,4965,104,116,4455,4355,4127,4134,2767
49950,641,3649,0,49950,0,49950,2.3425e+18,810.977,10042.9,49950,700,432,44117,40523,29531,28421,14365
21612,934,1608,0,21612,6801,14811,8.69314e+15,503.274,4401.4,21612,333,345,20004,19597,18817,18855,16026
39204,88,2321,12386,26818,0,39204,3.50537e+13,741.721,7020.87,39204,410,482,30603,26673,17248,6922,4521
15376,1530,2181,13879,1497,9412,5964,2.0462e+18,869.404,4698.77,15376,341,340,13195,12219,11632,11593,10626
8590,899,964,0,8590,2479,6111,9.70053e+15,270.523,2279.73,8590,213,219,7626,7626,7626,7626,7495
18176,1133,2266,10965,7211,10965,7211,1.8614e+18,444.431,4890.38,18176,442,277,15910,15760,14095,13100,9370
13588,70,227,0,13588,13382,206,2.58895e+16,98.7685,1259.56,13588,73,78,13242,13010,11553,11017,7752
44260,4618,4994,44260,0,39157,5103,2.85065e+18,1353.46,11449.5,44260,509,637,39266,39266,39266,39261,38633
41864,399,2209,13632,28232,0,41864,3.4236e+13,700.134,6757.83,41864,470,392,38226,36029,23357,20678,12254
36693,18000,36693,36693,0,0,36693,268428000,0,36693,36693,36693,1,0,0,0,0,0
41415,506,3959,36385,5030,24700,16715,1.97439e+18,1256.52,9890.2,41415,473,456,33641,28781,18827,16155,9426
25667,1196,2097,7537,18130,0,25667,3.63805e+13,731.787,5672.96,25667,433,371,23570,23015,22296,22295,17108
39361,91,95,38602,759,39361,0,1.0229e+14,20.052,835.17,39361,28,33,39266,39266,39199,39199,39113
37314,4,44,36910,404,37314,0,1.03028e+14,20.1394,651.844,37314,27,26,34036,32111,29476,29547,18597
5054,1141,1271,4591,463,3050,2004,1.95638e+18,327.015,2123.49,5054,192,168,3783,3595,3742,3736,3584
16138,821,1352,4678,11460,0,16138,3.66687e+13,386.896,3506.96,16138,257,235,14786,14572,14312,14306,12058
5648,153,155,0,5648,5507,141,2.65496e+16,68.0708,649.526,5648,46,52,5493,5493,5491,5489,5492
19493,2016,2271,11502,7991,0,19493,4.91416e+18,491.035,5105.52,19493,332,319,17222,17219,17173,17153,16115
44787,7,50,44033,754,44744,43,9.96763e+13,18.3473,721.876,44787,25,26,44070,43602,38160,37838,25065
32628,1868,2862,18993,13635,18993,13635,1.74234e+18,892.107,7155.77,32628,468,506,29766,29529,28829,28717,24360
9414,1191,2319,9389,25,8491,923,2.40043e+18,378.459,3822.16,9414,247,325,7095,6882,5794,5693,4639
29274,53,55,28846,428,29274,0,9.96328e+13,18.2967,665.427,29274,26,26,29219,29219,29172,29172,28994
29902,24,50,29235,667,29902,0,1.06634e+14,17.9571,595.3,29902,28,25,29850,29834,28389,28373,24046
37250,39,44,36530,720,37250,0,9.50972e+13,18.3532,643.302,37250,25,25,37206,37206,37030,37030,36959
16869,201,211,0,16869,16468,401,2.47796e+16,109.41,1278.95,16869,80,79,16658,16658,16651,16610,16398
34425,485,3062,20394,14031,0,34425,4.66535e+18,612.665,7624.8,34425,380,497,30791,28309,20399,18442,7418
11845,223,1421,0,11845,0,11845,2.34453e+18,481.854,3222.78,11845,258,296,9135,7285,5232,4215,1931
6550,1027,1417,0,6550,0,6550,2.29832e+18,408.445,2510.53,6550,276,203,5133,4798,4981,4721,4543
35236,120,272,0,35236,34582,654,2.68898e+16,106.499,1997.03,35236,87,97,34948,34865,32407,31983,25453
4920,287,400,4920,0,4920,0,4.1586e+18,200.832,1153.77,4920,102,103,4520,4437,4075,4114,3932
1946,392,589,1946,0,1763,183,3.16653e+18,63.6074,871.663,1946,108,79,1357,1356,1215,1184,770
48605,913,3875,29638,18967,29638,18967,1.85875e+18,866.548,10090,48605,430,593,44208,41515,39120,36376,11750
22473,25,30,22179,294,22473,0,9.98122e+13,17.2498,498.008,22473,21,22,22443,22443,21983,21982,21004
42262,3042,3432,25127,17135,25127,17135,1.82348e+18,703.008,8976.74,42262,500,401,38830,38823,38525,38676,37363
12771,970,1558,7624,5147,0,12771,4.72335e+18,460.231,3570.29,12771,277,322,11213,10936,10081,9842,8792
36084,206,1794,0,36084,10656,25428,9.32444e+15,812.283,5945.03,36084,464,328,31068,28387,20169,17016,6511
16279,18,29,15865,414,16279,0,9.76753e+13,16.1565,413.869,16279,21,22,16245,16236,15516,15530,13426
13524,1561,2294,0,13524,0,13524,2.43102e+18,419.457,4401.85,13524,306,245,11230,11200,11007,11109,9366
6174,530,769,1731,4443,0,6174,3.70766e+13,344.577,1771.48,6174,184,167,5405,5089,5146,5145,4210
9137,4,190,0,9137,8895,242,2.57017e+16,76.3277,891.097,9137,58,54,6478,5193,4847,4606,2849
32685,715,734,32685,0,32685,0,4.29127e+18,324.551,3336.84,32685,203,206,31951,31951,31924,31924,31912
33540,26,74,33085,455,33540,0,1.02981e+14,17.6773,708.011,33540,28,30,33466,33464,30568,30240,21538
11046,138,1659,0,11046,0,11046,2.09671e+18,223.507,3278.42,11046,207,192,8906,7245,3674,3510,1166
35825,415,3227,0,35825,0,35825,2.39467e+18,764.675,8174.05,35825,499,409,30835,27747,18715,16853,5830
36683,382,3749,32477,4206,21320,15363,1.96238e+18,853.968,8850.9,36683,443,564,30009,25880,15237,14512,3189
33181,108,319,0,33181,32440,741,2.55604e+16,144.112,2266.58,33181,112,119,32680,32351,28447,26731,20957
25260,1233,2211,0,25260,0,25260,2.40067e+18,723.702,5639.09,25260,421,365,23049,22376,21548,19752,15288
12104,1015,2070,10920,1184,7289,4815,2.00363e+18,636.487,4092.1,12104,321,235,10011,9405,8473,8466,6676
42296,733,4095,25114,17182,0,42296,4.81824e+18,1052.7,9781.17,42296,448,621,36852,35202,23696,21818,9710
47684,2140,4211,0,47684,0,47684,2.27367e+18,1265.4,10695.5,47684,544,569,43473,42621,40266,36170,27334
49040,603,3518,29290,19750,29290,19750,1.84106e+18,1187.71,9288.74,49040,544,451,43897,41518,32405,32209,15019
41633,3330,3465,41633,0,37506,4127,2.58533e+18,1261.69,8699.75,41633,447,454,38168,38165,38168,38168,37701
24269,539,2882,21631,2638,14862,9407,1.92243e+18,871.407,6674.74,24269,345,403,19868,17005,10662,10181,6963
14365,501,541,14365,0,14365,0,4.36136e+18,260.444,2104.96,14365,145,153,13824,13811,13633,13691,13568
36815,206,241,0,36815,35932,883,2.46893e+16,130.759,2029.72,36815,98,109,36574,36574,36343,35796,34039
38945,2197,2314,22982,15963,22982,15963,1.89785e+18,978.498,7021.21,38945,435,392,36631,36628,36528,36574,35940
17681,224,1314,0,17681,5623,12058,8.54532e+15,341.176,3668.04,17681,224,306,15692,14755,13204,13127,5309
7466,303,662,0,7466,2484,4982,8.68527e+15,343.282,1829.53,7466,202,223,6515,5859,5263,5321,4567
37070,117,297,0,37070,36535,535,2.59132e+16,132.925,2268.21,37070,97,110,36677,36335,32133,29808,22980
24193,1819,2332,0,24193,0,24193,2.23287e+18,567.798,5554.94,24193,327,344,21861,21825,21602,21658,19240
25522,1156,2521,15108,10414,15108,10414,1.78691e+18,728.692,6256.75,25522,356,466,23001,22380,21768,21744,14680
32011,44,1870,8679,23332,0,32011,3.68408e+13,667.242,5836.92,32011,421,309,22791,18678,15228,5971,2985
32444,1973,3205,19588,12856,0,32444,4.87514e+18,785.294,7878.78,32444,487,482,29239,29083,28173,27921,20235
4835,134,417,4835,0,4835,0,4.25538e+18,190.865,1170.39,4835,100,103,4161,3541,2450,2452,1728
9580,1374,9580,0,9580,9580,0,4095.57,0,9580,9580,9580,1,0,0,0,0,0
36487,8,72,35715,772,36451,36,1.04746e+14,21.5428,798.011,36487,30,32,35820,35452,30492,29420,18839
13725,1042,1744,7602,6123,0,13725,4.37693e+18,430.72,3820.43,13725,280,257,11981,11875,11563,11334,9829
1094,124,348,0,1094,0,1094,2.58856e+18,75.8282,535.225,1094,76,75,746,648,589,530,370
7243,862,1314,4272,2971,0,7243,4.88069e+18,392.333,2524.9,7243,170,239,5929,5552,5789,5765,4911
17717,203,2012,0,17717,0,17717,2.24568e+18,637.445,4743.06,17717,267,370,13555,11421,7500,7201,1928
6953,507,1196,4070,2883,4070,2883,1.98388e+18,213.868,2328.87,6953,168,212,5757,5625,5432,5477,2881
24033,1647,2245,7169,16864,0,24033,3.70731e+13,440.767,5674.59,24033,313,374,21788,21784,21556,21542,18086
31853,530,1668,20039,11814,20039,11814,1.82193e+18,685.459,5369.54,31853,344,350,29195,25077,17317,17560,13614
29822,2618,3244,26581,3241,17571,12251,1.92753e+18,1132.32,7737.16,29822,385,449,26578,26353,25789,25843,24347
22962,585,719,22962,0,22962,0,4.29821e+18,304.061,2823.03,22962,189,185,22243,22221,21727,21697,21280
33768,1573,2248,10698,23070,0,33768,3.38678e+13,439.993,6394.1,33768,307,444,31520,31487,31262,31230,25124
37749,3159,3998,0,37749,0,37749,2.30603e+18,1109.92,9396.05,37749,451,691,33751,33738,33274,32933,29163
6386,1152,1726,5759,627,3786,2600,1.96681e+18,308.939,2872.94,6386,213,316,4660,4575,4274,4354,3727
43487,89,331,0,43487,42737,750,2.60115e+16,165.318,2447.32,43487,112,120,42784,42148,36903,34458,25367
40553,285,873,40535,18,40553,0,4.08077e+18,378.045,3850.03,40553,216,224,39230,37818,28409,28029,22498
26306,856,1746,15841,10465,0,26306,4.57768e+18,584.556,5282.75,26306,323,331,24560,24374,22216,21681,16833
41706,1739,3192,0,41706,0,41706,2.40561e+18,953.573,8337.7,41706,523,374,38514,37994,33675,31780,28403
9506,741,826,0,9506,2877,6629,9.03764e+15,255.143,2185.85,9506,187,181,8680,8680,8677,8676,8480
5848,488,891,0,5848,1740,4108,9.51342e+15,273.03,1874,5848,200,197,4957,4720,4586,4550,3420
29368,674,4082,29368,0,26452,2916,1.72073e+18,587.788,8164.24,29368,399,417,25093,23657,14603,10010,4042
42442,1032,4447,42442,0,37815,4627,2.57455e+18,1375.28,10512.2,42442,541,518,36645,34193,26091,20354,10360
9448,1052,1344,0,9448,0,9448,2.52024e+18,634.221,2864.54,9448,258,249,8085,7318,7712,7392,6798
8713,722,1112,5286,3427,0,8713,4.87792e+18,333.819,2532.22,8713,216,183,7601,7597,6616,6346,5327
18555,13,38,18210,345,18555,0,9.3264e+13,17.1805,459.976,18555,23,21,18476,18424,16451,16388,11498
34452,1907,2651,19390,15062,0,34452,4.27117e+18,917.625,6928.28,34452,409,318,31801,31755,30489,30272,20618
41684,2976,3994,41684,0,37592,4092,2.1012e+18,703.337,9501.06,41684,415,676,37690,37637,36108,35755,30662
20315,260,3298,20280,35,18090,2225,2.5556e+18,809.538,6476.35,20315,370,355,14703,12416,9316,7583,1598
26964,227,3707,23662,3302,15897,11067,1.98952e+18,889.662,7832.65,26964,478,530,19521,15597,9001,8132,3142
38399,49,100,37533,866,38399,0,1.02705e+14,16.7657,909.721,38399,27,32,38299,38298,36790,36681,27612
19171,48,239,0,19171,18852,319,2.5435e+16,87.3425,1413.98,19171,80,83,18526,17928,15997,14883,10127
19267,936,1172,0,19267,6166,13101,8.67528e+15,338.452,3541.37,19267,289,244,18095,18092,17700,17708,16553
42958,649,3317,0,42958,0,42958,2.42673e+18,1159.05,8953.8,42958,544,485,38051,35091,24274,24108,10503
3774,109,799,0,3774,0,3774,2.19734e+18,210.654,1471.99,3774,171,143,2554,2064,1477,1207,824
26384,3102,3274,0,26384,0,26384,2.35366e+18,652.248,7246.97,26384,329,573,23110,23108,23081,23102,22299
18406,709,1585,5722,12684,0,18406,3.5221e+13,453.859,4157.19,18406,280,311,16821,16450,15539,15621,11289
16939,310,1323,0,16939,5374,11565,8.62785e+15,393.058,3639.88,16939,310,287,15132,14155,12283,12364,6517
9078,246,1283,0,9078,0,9078,2.44493e+18,322.778,2673.84,9078,218,210,7313,6082,6192,5520,1388
16189,257,260,0,16189,15957,232,2.61098e+16,104.768,1394.66,16189,77,79,15929,15929,15929,15929,15922
29084,1322,1788,17536,11548,0,29084,4.83967e+18,475.46,4812.33,29084,323,328,27296,27286,25737,25275,24845
42815,1,76,42088,727,42815,0,1.0238e+14,18.3313,802.759,42815,29,29,17501,17501,17501,17501,17501
20110,1036,2627,20076,34,18007,2103,1.73018e+18,462.939,5667.52,20110,380,380,17483,17275,15997,15917,10860
22339,19136,22339,22339,0,22339,0,68716400000,0,22339,22339,22339,1,0,0,0,0,0
10165,1336,1575,9123,1042,6203,3962,2.01058e+18,415.754,3162.67,10165,250,214,8590,8577,8585,8580,8260
11470,361,1333,0,11470,3674,7796,9.04169e+15,276.381,3150.91,11470,238,222,10118,9460,7119,6980,4445
33661,374,1728,10483,23178,0,33661,3.54899e+13,652.965,5638.22,33661,423,374,30278,28129,19904,19418,14380
6775,63,1683,6775,0,6158,617,2.37319e+18,279.449,2838.66,6775,230,285,3842,2686,1220,978,593
36329,847,942,36304,25,36329,0,4.16035e+18,375.992,3804.67,36329,225,231,35387,35367,34864,34798,34700
42878,764,4618,25855,17023,0,42878,4.75692e+18,720.359,10156.9,42878,450,738,37806,36129,24859,22826,8709
11707,678,1122,0,11707,3503,8204,9.33084e+15,361.868,2853.47,11707,255,294,10585,10372,10006,10027,7832
11552,39,40,11263,289,11552,0,1.05334e+14,15.9365,398.97,11552,21,21,11512,11512,11512,11512,11436
7758,408,1317,7097,661,4493,3265,1.89255e+18,348.942,2665.11,7758,194,181,6292,5501,3145,2935,2145
31070,1216,3618,31070,0,27625,3445,2.54926e+18,1117.26,8060.54,31070,501,414,26849,25024,20242,18721,12169
24773,46,63,24322,451,24773,0,1.05725e+14,18.8269,608.468,24773,26,24,24710,24708,24285,24285,22809
37459,3903,4192,22230,15229,0,37459,4.84199e+18,697.903,9312.12,37459,378,559,33267,33266,33226,33245,32934
9861,475,1710,8642,1219,5659,4202,1.95291e+18,397.31,3427.66,9861,171,302,8019,7207,5449,4974,3451
5317,162,382,5317,0,5317,0,4.53712e+18,196.387,1169.04,5317,105,110,4757,4326,3203,3079,2812
9689,742,1088,3022,6667,0,9689,3.62811e+13,373.746,2623.87,9689,261,240,8601,8485,8361,8371,7620
49601,2805,3930,30060,19541,0,49601,4.88452e+18,1392.85,10304.2,49601,565,495,45671,45222,43314,42684,37200
10347,358,465,10347,0,10347,0,3.60509e+18,197.243,1679.81,10347,128,132,9882,9860,9243,9233,8538
49111,774,2744,0,49111,13756,35355,9.33004e+15,886.267,8476.4,49111,598,551,45784,44791,39449,39875,18541
10866,692,1579,6386,4480,6386,4480,1.82415e+18,335.651,3266.79,10866,304,229,9287,9117,8646,8300,5454
14004,745,1067,4414,9590,0,14004,3.64758e+13,467.542,2993.14,14004,261,295,12937,12640,12566,12600,11673
49518,38,87,48673,845,49463,55,9.98733e+13,22.6686,954.034,49518,30,33,49431,49422,46046,45973,31704
37085,932,1628,11445,25640,0,37085,3.66054e+13,451.808,4945.01,37085,384,305,35457,35352,33434,33514,29014
45685,2920,3491,41144,4541,26951,18734,1.95773e+18,1233.24,9535.83,45685,472,520,42194,42154,42018,42056,39099
48803,13,382,0,48803,47609,1194,2.61769e+16,164.543,2827.6,48803,127,128,43436,40534,34371,25165,17897
9637,138,193,0,9637,9489,148,2.59235e+16,94.0417,935.957,9637,67,66,9442,9374,9090,9103,8373
5796,229,903,0,5796,0,5796,2.06269e+18,127.709,1751.01,5796,167,124,4893,4699,4085,3992,3022
41844,6,11,39229,2615,41684,160,0.000238983,0.999737,670.329,41844,11,1,41833,41833,41833,41833,41833
25065,1791,2069,15292,9773,0,25065,5.03433e+18,504.077,5139.47,25065,317,278,22996,22948,22912,22929,22551
6317,139,1199,3868,2449,0,6317,5.05206e+18,473.462,2279.74,6317,196,194,4367,3689,2686,2553,710
36174,614,2218,11838,24336,0,36174,3.39542e+13,585.512,6509.13,36174,451,411,33674,32708,25442,25449,18748
27214,375,3185,27214,0,24563,2651,2.0287e+18,1364.92,7299.99,27214,416,504,20372,17527,10567,9626,3899
41176,1353,2370,0,41176,13329,27847,8.81666e+15,705.939,6882.47,41176,442,446,38806,38529,37754,37866,30809
38190,547,3281,38190,0,34246,3944,1.94394e+18,726.033,8288.85,38190,430,437,33959,31344,19127,16180,10358
32255,1030,3770,32255,0,29034,3221,2.71762e+18,874.009,8345.53,32255,429,465,28220,26614,22288,21156,14913
41986,204,2680,25208,16778,0,41986,4.913e+18,1158.13,7927.97,41986,488,441,32496,26901,21066,16488,4131
17119,14,600,17119,0,17119,0,4.05194e+18,326.897,2351.16,17119,164,158,8211,4002,3272,3080,717
35298,1508,3448,31769,3529,21557,13741,1.96361e+18,1119.1,8212.53,35298,434,439,31719,30272,24664,23838,17350
2638,358,887,0,2638,0,2638,2.19248e+18,160.104,1346.65,2638,165,108,1751,1547,901,834,570
15952,2182,2569,14208,1744,9409,6543,1.92526e+18,434.213,5126.94,15952,336,261,13383,13383,13337,13342,12562
32486,322,765,32486,0,32473,13,4.27483e+18,350.436,3380.05,32486,200,214,31513,30805,23112,22503,19336
27543,1256,2307,16734,10809,16734,10809,1.81727e+18,750.51,5885.16,27543,344,392,25236,24769,23769,23337,20270
31309,166,2855,0,31309,0,31309,2.31636e+18,1178.53,7371.17,31309,468,464,22812,18672,12370,9070,2903
3740,890,937,0,3740,0,3740,2.63165e+18,113.036,1557.13,3740,175,136,2803,2803,2803,2803,2756
5265,118,1489,5265,0,4748,517,2.26642e+18,339.194,2326.26,5265,212,202,3242,2689,993,909,353
4214,455,636,1227,2987,0,4214,3.92197e+13,194.556,1323.44,4214,146,162,3578,3491,3503,3527,3028
49190,1400,2972,15157,34033,0,49190,3.38876e+13,777.273,8629.21,49190,506,576,46218,45476,43100,43076,26712
34932,2918,4199,34932,0,30975,3957,2.82617e+18,937.416,9329.57,34932,471,529,30733,30450,30363,30075,25918
21639,2503,3133,19574,2065,12302,9337,1.91898e+18,489.572,6223.63,21639,359,366,18506,18501,18410,18412,17005
23473,795,835,23473,0,23473,0,4.197e+18,325.764,3010.38,23473,192,192,22638,22638,22594,22581,22442
43875,3,99,42904,971,43875,0,1.02518e+14,20.6042,890.069,43875,31,33,36289,32638,31549,30788,17763
34526,2297,2874,30948,3578,20610,13916,1.97288e+18,1364.55,7681.63,34526,493,391,31652,30769,31187,31199,29790
36827,127,319,0,36827,36220,607,2.49748e+16,142.895,2252.65,36827,101,121,36432,36193,32384,31036,25048
10709,3,26,10522,187,10709,0,9.754e+13,16.677,323.583,10709,18,20,8950,7970,7858,7716,4693
4973,1071,1123,4392,581,3064,1909,1.86638e+18,408.211,2059.01,4973,176,201,3850,3832,3834,3836,3798
40154,122,356,0,40154,39470,684,2.43788e+16,172.497,2561.48,40154,112,133,39615,39269,34075,32371,23817
29774,656,2115,0,29774,9262,20512,9.02689e+15,565.754,5854.09,29774,403,387,27466,26835,22604,22196,14747
5963,335,1222,3621,2342,0,5963,4.93021e+18,307.963,2243.85,5963,221,220,4572,3822,2658,2468,2212
49437,1435,3007,28813,20624,0,49437,4.81861e+18,1302.19,8966.39,49437,543,578,46077,43615,37458,36905,31193
8426,1420,1460,4878,3548,4878,3548,1.89421e+18,273.647,2860.15,8426,241,208,6966,6966,6965,6965,6959
36250,173,908,36250,0,36240,10,3.90007e+18,325.974,3662.23,36250,215,217,33465,30131,19835,19546,12551
25043,100,1930,0,25043,7702,17341,8.89781e+15,544.289,5282.5,25043,349,401,20616,18215,11822,10818,2929
32557,27,39,32095,462,32557,0,9.91048e+13,17.6488,589.82,32557,21,22,32518,32518,31767,31776,26555
43594,70,99,42927,667,43594,0,1.10959e+14,19.93,846.823,43594,31,31,43495,43495,42359,42359,37587
3619,89,279,3619,0,3619,0,4.88371e+18,172.935,844.863,3619,94,91,2907,2233,1697,1608,1396
20506,1512,2200,12520,7986,0,20506,4.80338e+18,668.803,5265.91,20506,387,337,18306,18285,17556,17461,14928
39012,2869,4235,39012,0,34945,4067,1.43756e+18,1109.25,10004,39012,623,457,34777,34519,33467,33196,25219
24738,650,1785,0,24738,6980,17758,9.44742e+15,452.737,4982.64,24738,320,372,22826,22107,20384,20544,13356
38976,135,3160,23319,15657,0,38976,4.64964e+18,1065.72,8216.96,38976,430,543,27918,22977,14677,10710,1353
7383,230,419,7383,0,7383,0,4.49016e+18,213.438,1390.84,7383,117,119,6931,6638,5775,5768,5385
3806,639,680,1098,2708,0,3806,3.41063e+13,158.632,1326.74,3806,186,126,3126,3126,3104,3116,3074
6500,1,19,6428,72,6500,0,9.50955e+13,12.8246,234.786,6500,16,15,2915,2915,2915,2915,2915
833,71,176,0,833,297,536,6.79277e+15,80.503,341.001,833,63,61,597,500,368,355,428
31472,2260,2679,19023,12449,19023,12449,1.85667e+18,860.72,6945.85,31472,558,352,28793,28791,28668,28690,27700
14639,2033,2394,8384,6255,8384,6255,1.76596e+18,466.084,4723.6,14639,329,357,12245,12235,11997,11907,11595
35518,1536,2138,10225,25293,0,35518,3.3964e+13,568.178,6254.27,35518,372,377,33380,33281,32908,32933,28928
905,211,404,798,107,504,401,1.94992e+18,58.0597,546.943,905,59,56,501,459,375,363,337
17318,630,2250,17318,0,15592,1726,2.86746e+18,814.821,4916.69,17318,270,353,14398,13645,7917,7581,5277
34606,4502,34606,34606,0,0,34606,15.9995,0,34606,34606,34606,1,0,0,0,0,0
22261,124,260,0,22261,21887,374,2.59992e+16,121.69,1567.93,22261,82,89,21966,21854,19422,19489,14730
49416,3225,3866,29685,19731,29685,19731,1.82054e+18,1354.06,10345.9,49416,574,635,45550,45475,45104,45243,43182
1031,6,276,0,1031,297,734,1.01005e+16,61.4239,448.314,1031,78,72,389,215,197,214,83
1867,162,635,0,1867,0,1867,2.50104e+18,78.8436,951.305,1867,87,110,1232,1113,1044,932,594
27230,2116,2855,0,27230,0,27230,2.30606e+18,626.315,6695.9,27230,349,624,24375,24343,24034,23756,18092
29886,115,2139,16430,13456,0,29886,4.07639e+18,703.862,5593.88,29886,363,387,23837,16674,9947,7848,4356
12492,1426,1527,11192,1300,7680,4812,1.8852e+18,637.089,3583.04,12492,242,277,10965,10965,10960,10963,10890
47247,3558,3739,47247,0,42596,4651,2.64243e+18,996.11,9624.29,47247,490,496,43508,43505,43508,43508,43104
21303,44,796,21303,0,21303,0,4.01898e+18,311.693,2813.53,21303,182,180,14265,9440,7133,6767,2086
17834,438,1527,0,17834,5148,12686,9.19952e+15,410.98,4014.61,17834,293,298,16054,15185,14617,14755,8800
41265,63,259,0,41265,40780,485,2.61723e+16,138.43,2094.89,41265,98,101,40389,39744,34659,31215,21581
32507,1747,2540,19383,13124,19383,13124,1.81396e+18,868.401,6698.61,32507,501,376,29967,29789,29494,29350,26644
21311,1650,2770,12695,8616,0,21311,4.4736e+18,681.256,5975.35,21311,459,312,18541,17912,16981,16609,13842
31511,11,62,31025,486,31511,0,1.0009e+14,18.8095,673.486,31511,25,27,31260,31089,27439,27081,18020
26727,2173,3966,26727,0,24205,2522,2.48176e+18,566.878,7914.34,26727,463,404,22761,22497,22285,21439,12969
36219,194,643,36207,12,36219,0,4.08789e+18,333.825,3377.78,36219,200,195,34147,31395,22860,21915,15009
35924,251,305,0,35924,35180,744,2.57349e+16,153.809,2235.41,35924,104,126,35619,35604,35206,35174,34106
40645,10,50,39828,817,40645,0,1.01018e+14,17.2606,698.73,40645,25,26,40360,40181,36872,36189,23834
20155,2920,2963,18115,2040,11453,8702,1.9446e+18,493.405,6036.16,20155,295,347,17192,17192,17192,17192,17177
42304,360,2396,25579,16725,25579,16725,1.90327e+18,1066,7560.87,42304,466,474,34855,30065,23055,22976,10576
6593,9,599,2047,4546,0,6593,3.57617e+13,267.981,1534.67,6593,166,157,2818,1714,1569,1237,465
41007,74,82,40077,930,41007,0,1.02549e+14,18.2687,813.343,41007,29,30,40925,40925,40536,40536,38961
42191,3444,3551,25326,16865,25326,16865,1.82575e+18,1121.59,9007.91,42191,553,477,38640,38640,38618,38620,38508
47567,2018,3216,28781,18786,28781,18786,1.90668e+18,1101.84,8864.78,47567,586,374,44351,44107,42145,41609,35734
30909,31,284,0,30909,30378,531,2.49868e+16,123.964,2015.01,30909,92,111,29390,28333,23687,21412,13444
39427,307,339,0,39427,38827,600,2.5786e+16,161.247,2382.7,39427,105,116,39088,39048,38923,38706,38349
38232,1493,3686,38207,25,33933,4299,1.97677e+18,911.095,9021.75,38232,428,407,34546,33716,21831,18998,17309
41735,2774,4619,41710,25,36879,4856,2.76136e+18,957.629,10414.9,41735,543,422,37116,36882,36786,36429,30306
18008,319,1863,5169,12839,0,18008,3.68858e+13,395.715,4513.6,18008,308,397,15805,14520,11350,10751,3813
31318,422,2070,18982,12336,18982,12336,1.90549e+18,1027.38,6128.37,31318,415,381,26147,22203,18277,18667,9261
45386,214,3465,0,45386,0,45386,2.28552e+18,1019.86,9015.91,45386,435,571,35475,29892,20312,17414,4626
14459,152,223,0,14459,14284,175,2.66722e+16,81.3687,1089.55,14459,73,68,14236,14227,13773,13796,12867
26727,2161,4203,23782,2945,15626,11101,1.95413e+18,805.824,8270.9,26727,317,560,22524,22392,19380,20089,11944
18304,651,679,18304,0,18304,0,4.10126e+18,303.991,2527.27,18304,169,177,17625,17625,17623,17622,17619
14984,1711,1787,14984,0,13421,1563,3.094e+18,562.744,4091.16,14984,326,252,13197,13197,13197,13197,13038
35097,2840,3284,35072,25,31701,3396,2.38298e+18,648.525,7801.15,35097,409,384,31813,31811,31762,31759,30769
16411,338,1026,0,16411,15386,1025,0.0624581,0.937481,4103.32,16411,1026,1,15385,15385,15385,15385,15385
35489,1456,3565,0,35489,0,35489,2.18293e+18,740.543,8450.88,35489,511,576,31924,31172,25339,25201,20307
5888,793,1065,5265,623,3362,2526,1.94949e+18,244.762,2106.22,5888,160,168,4823,4814,4746,4798,4487
49623,3193,3634,28788,20835,28788,20835,1.6862e+18,1349.71,9693.06,49623,536,564,45989,45578,45583,45781,43694
6200,462,1503,5449,751,3711,2489,1.92161e+18,445.562,2618.82,6200,265,258,4469,3799,2930,2895,2130
35286,3340,3425,21368,13918,21368,13918,1.80376e+18,1021.8,8325.45,35286,524,515,31861,31861,31812,31832,31781
31737,2007,3296,18057,13680,18057,13680,1.71922e+18,917.44,7934.69,31737,465,489,28441,28065,27318,26767,21110
8605,355,1637,7702,903,5305,3300,2.02423e+18,479.394,3085.22,8605,244,223,6337,5129,3704,3502,2346
19563,1953,4096,19563,0,19563,0,8.27329e+15,3238.4,8942.46,19563,4096,5,7808,0,3905,7353,7808
16612,1367,1735,10358,6254,0,16612,4.85174e+18,473.298,3974.67,16612,264,288,14877,14876,14599,14582,13147
7595,52,1479,4397,3198,0,7595,4.57275e+18,273.359,2788.24,7595,244,227,4425,2677,2133,1839,549
1441,9,19,1408,33,1441,0,1.02745e+14,10.4497,114.736,1441,15,13,1412,1401,1297,1297,1110
10122,649,1548,5928,4194,0,10122,4.87807e+18,367.302,3232.87,10122,275,289,8574,8245,7862,7648,5290
20694,633,1913,12393,8301,12393,8301,1.93113e+18,762.333,4837.77,20694,364,328,17899,16308,16134,14967,7590
28046,2295,3108,28046,0,24905,3141,1.69836e+18,819.404,7147.39,28046,375,410,24938,24817,23961,24048,19487
8061,1263,1806,8061,0,7238,823,2.2227e+18,276.339,3195.16,8061,228,299,6255,6240,5569,5563,4605
12784,1158,1612,7667,5117,7667,5117,1.80157e+18,520.287,3624.64,12784,261,309,11172,10730,10866,10834,9768
49715,107,356,0,49715,48770,945,2.69113e+16,159.073,2719.99,49715,114,140,49068,48579,42266,39267,29800
47781,25,82,47089,692,47781,0,9.95041e+13,19.5249,870.042,47781,29,31,47699,47681,43806,43566,34086
28033,8872,28033,28033,0,0,28033,15.9994,0,28033,28033,28033,1,0,0,0,0,0
2905,35,117,0,2905,2880,25,2.28948e+16,42.8582,380.368,2905,33,45,2747,2677,2484,2414,1742
4681,244,603,4681,0,4114,567,8.07044e+17,336.374,1411.03,4681,135,135,3555,2611,3011,3040,1891
26997,750,2376,15923,11074,15923,11074,1.75009e+18,1121.43,6122.92,26997,436,473,23544,21829,19941,19285,8653
14396,211,621,14396,0,14371,25,4.52576e+18,260.779,2186.92,14396,165,158,13447,12517,9139,8622,8004
32688,1538,2537,19056,13632,0,32688,4.65789e+18,742.542,6778.04,32688,424,331,30151,30016,27622,27014,22210
10760,530,1960,0,10760,0,10760,2.32188e+18,370.539,3725.79,10760,326,279,8662,8038,6619,6255,3572
4808,168,445,4796,12,4808,0,4.27061e+18,215.033,1187.97,4808,102,108,4158,3555,2826,2796,2378
41772,3653,3954,25038,16734,25038,16734,1.83314e+18,862.195,9560.08,41772,649,431,37818,37818,37702,37742,37099
7760,1157,1294,6987,773,4858,2902,1.9246e+18,435.786,2627.74,7760,222,216,6466,6466,6428,6441,6317
40259,2099,2357,12432,27827,0,40259,3.56768e+13,774.355,7132.33,40259,452,413,37902,37868,37867,37867,36584
7261,584,1425,7261,0,6602,659,2.87514e+18,340.755,2721.31,7261,182,212,5836,5601,4107,4058,3420
49673,25,99,48727,946,49673,0,1.05931e+14,20.9547,935.911,49673,31,31,49573,49552,44419,44179,27142
15716,1040,1428,0,15716,4784,10932,8.48978e+15,282.403,3581.52,15716,232,255,14288,14262,14050,14115,11399
18777,1219,1371,0,18777,6142,12635,8.77981e+15,449.537,3859.25,18777,259,302,17406,17397,17375,17373,16982
25263,512,736,25244,19,25263,0,3.95521e+18,318.945,2952.88,25263,183,184,24527,24457,22930,22766,22334
32645,1552,2699,29190,3455,19784,12861,1.91679e+18,983.974,6824.76,32645,408,414,29946,28907,25856,25634,23844
11713,62,155,0,11713,11442,271,2.49769e+16,64.9535,828.036,11713,58,54,11517,11435,10575,10032,7829
46941,3062,3778,28142,18799,0,46941,4.69512e+18,1161.32,9918.32,46941,528,577,43163,43028,42343,42221,40114
28696,53,273,0,28696,28242,454,2.71196e+16,136.167,1902.95,28696,97,114,27682,26766,22416,20529,13845
37396,7,51,36553,843,37396,0,9.89786e+13,20.3747,678.539,37396,25,26,36694,36218,32116,31897,19867
10976,251,1424,0,10976,0,10976,2.37211e+18,355.793,3102.23,10976,249,262,8803,7056,6927,5300,3798
17792,827,1877,15881,1911,10803,6989,1.9894e+18,1054.96,4701.1,17792,335,312,14766,12662,12644,12301,8325
17181,63,591,17181,0,17181,0,4.72258e+18,303.338,2340.08,17181,166,167,12847,8852,6046,5333,2692
16742,60,2256,16742,0,14768,1974,2.35736e+18,593.431,4834.31,16742,333,334,9326,6489,3165,1321,625
8626,491,1594,5187,3439,5187,3439,1.86042e+18,439.94,3029.7,8626,241,275,6789,6250,5532,5882,3207
5998,139,835,1929,4069,0,5998,3.52544e+13,209.872,1879.99,5998,151,238,4772,4138,3673,3629,1749
35862,554,3245,0,35862,0,35862,2.24955e+18,807.473,8190.29,35862,400,547,31589,29953,25165,16309,9984
46370,13,101,45345,1025,46363,7,1.04681e+14,24.8804,898.02,46370,32,33,46045,45751,40394,39883,26259
20822,1720,3296,12228,8594,12228,8594,1.85888e+18,468.831,6509.6,20822,298,490,17526,17433,16608,16940,11661
28749,1527,2016,8708,20041,0,28749,3.57753e+13,468.864,5627.69,28749,352,322,26733,26670,26484,26478,21788
20871,474,1698,0,20871,6197,14674,9.23805e+15,421.772,4465.84,20871,354,326,18959,17882,16729,16829,8565
40858,1834,4226,36538,4320,24309,16549,1.96095e+18,1547.01,10054.8,40858,524,702,36034,34347,31982,32091,15146
3281,20,23,3211,70,3281,0,1.04406e+14,14.0158,178.314,3281,15,16,3258,3258,3189,3188,3125
15714,168,2115,9392,6322,0,15714,5.01592e+18,384.915,4427.95,15714,357,322,11919,9860,8584,7982,2447
13031,1959,2249,11518,1513,7688,5343,1.94273e+18,630.06,4441.7,13031,362,323,10782,10781,10712,10623,9969
43554,2502,4273,25957,17597,0,43554,4.86865e+18,793.407,10166.8,43554,453,658,39281,39222,38209,37985,23504
31306,258,283,0,31306,30808,498,2.49737e+16,131.593,1848.95,31306,98,102,31023,31020,30964,30923,30848
24814,1702,2567,14847,9967,14847,9967,1.78736e+18,782.864,6119.68,24814,382,409,22247,21840,21410,21646,16782
48253,357,4790,42910,5343,28359,19894,1.95146e+18,981.333,11341.5,48253,581,651,39432,31823,16999,14577,7600
29190,1720,2635,17619,11571,0,29190,5.01629e+18,1000.09,6772.02,29190,427,495,26555,25803,24477,24223,22303
38494,1050,1786,11462,27032,0,38494,3.49437e+13,581.493,6059.22,38494,373,388,36708,36256,35855,35895,27677
16076,17,30,15755,321,16072,4,9.85585e+13,19.2538,425.508,16076,19,19,16040,16024,15033,15018,11533
33621,34,287,0,33621,32900,721,2.48616e+16,131.615,2038.01,33621,98,108,32102,31238,26323,22084,13687
37835,525,4482,37835,0,34295,3540,2.58716e+18,1090.7,9829.54,37835,488,556,31885,29890,16730,12157,4913
11593,417,1842,6934,4659,0,11593,4.58505e+18,408.642,3803.5,11593,281,379,9600,8382,8341,8229,3955
20434,40,46,20136,298,20434,0,1.01714e+14,16.205,501.188,20434,21,26,20388,20388,19741,19739,19871
11938,350,1627,7306,4632,7306,4632,1.81171e+18,769.222,3630.58,11938,277,353,9220,7914,6585,6447,2846
42229,3,278,0,42229,41329,900,2.54776e+16,148.365,2160.42,42229,105,105,27892,22209,20269,20325,13625
33324,119,748,33255,69,33324,0,4.07733e+18,328.692,3381.43,33324,205,207,29668,25496,16284,14151,9811
48500,1416,2829,0,48500,15007,33493,9.09913e+15,813.066,8280.08,48500,559,487,45671,44944,40988,41258,29868
23498,726,1725,14320,9178,14320,9178,1.89349e+18,845.187,4874.93,23498,363,360,21153,19466,18513,17094,12581
