"data_size","cache_size","unique_size","reads","writes","avg_step","avg_reuse_dist","sum_sqrt_count","sum_count","lis","lds","belady","lru","pivot","ld","mru"
15592,568,987,11158,4434,3.67174e+13,518.466,3009.11,15592,248,227,14393,13603,13198,12328,9712
45429,511,2421,31744,13685,3.64911e+13,596.965,7125.18,45429,569,357,42500,41246,26870,19643,15255
7230,567,833,4912,2318,3.37016e+13,237.579,1989.48,7230,228,173,6397,6326,5842,4770,4964
26905,430,1333,19181,7724,3.66313e+13,631.766,4306.68,26905,331,282,24956,24212,22162,18164,13748
31086,95,2136,22134,8952,3.75951e+13,469.919,5867.41,31086,501,276,24338,20795,15401,5586,4307
72308,759,2964,50194,22114,3.59628e+13,1032.67,10140.3,72308,526,620,68259,65995,54925,37677,27054
78894,1513,3357,54447,24447,3.32063e+13,830.492,11247.3,78894,739,489,75537,75181,58395,44406,37614
56972,831,2567,39700,17272,3.5975e+13,779.577,8254.04,56972,490,426,54092,52681,40247,28726,24718
91466,2420,3021,63116,28350,3.51005e+13,1024.21,11318.7,91466,626,520,88445,88383,87708,86666,80805
80015,651,2780,58075,21940,3.71628e+13,1160.9,10518.5,80015,695,467,74651,71763,62329,41878,31764
71871,76,2268,49895,21976,3.36079e+13,981.626,8712.89,71871,478,428,57113,46558,32277,8075,6068
22370,393,1629,15623,6747,3.25011e+13,548.212,4488.04,22370,305,376,20280,19287,17768,13835,5997
31269,972,1807,21955,9314,3.70965e+13,585.59,5498.64,31269,380,348,29462,29262,27054,25074,20978
21002,1269,1823,14789,6213,3.77655e+13,403.315,4835.78,21002,310,350,19179,19170,18962,18715,15500
39751,270,2424,27464,12287,3.53392e+13,538.073,6797.07,39751,463,266,35614,31162,20348,9335,6601
67136,2036,3162,44828,22308,3.34723e+13,775.542,9896.73,67136,723,475,63974,63906,61349,56630,57052
41817,1604,2383,29389,12428,3.65094e+13,645.242,6981.28,41817,434,376,39434,39394,38532,36575,31367
49143,1325,2668,34866,14277,3.51111e+13,742.689,8312.22,49143,459,498,46475,45748,42763,34825,31091
27875,364,1832,19597,8278,3.44783e+13,583.742,5074.73,27875,346,279,25238,23549,17962,12392,10840
73500,1401,2775,52461,21039,3.60649e+13,1291.51,10110.1,73500,656,556,70438,69377,61059,43504,46970
26703,331,2091,18578,8125,3.38432e+13,487.138,5624.17,26703,254,457,23974,22572,17752,12901,4753
75095,3052,3407,52068,23027,3.57965e+13,978.574,11322.8,75095,777,605,71688,71686,70586,69642,68564
67795,1638,3522,46553,21242,3.50386e+13,695.891,11162.3,67795,545,688,64273,64018,59603,49518,35804
8877,6802,8877,0,8877,15.9982,0,8877,8877,8877,1,0,0,0,0,0
77973,2038,2473,55153,22820,3.55855e+13,957.663,9160.64,77973,589,400,75500,75318,75184,74828,68948
18464,262,1383,12691,5773,3.55763e+13,371.088,3992.98,18464,231,356,16185,14120,11747,8287,7321
42550,895,2401,29697,12853,3.70103e+13,777.031,7270.76,42550,511,461,39891,39188,33940,25768,22279
67929,754,2753,47327,20602,3.499e+13,938.74,9197.12,67929,590,500,64531,62705,50665,37643,30675
74706,1145,2650,52643,22063,3.7076e+13,1026.6,9699.47,74706,618,527,71768,70316,65112,50726,46128
31168,437,1648,22327,8841,3.70636e+13,778.796,5358.41,31168,451,302,28076,25828,22257,16145,12315
65972,184,2572,46871,19101,3.64169e+13,767.578,9208.69,65972,651,487,56289,48765,38607,19375,10030
94265,1307,3490,65605,28660,3.58888e+13,1205.03,12317.2,94265,634,593,90337,88985,76970,52597,45279
74995,1923,2514,52842,22153,3.68661e+13,1072.64,9110.26,74995,578,473,72481,72103,70527,67596,66083
75296,1737,3331,51151,24145,3.56086e+13,761.98,10286.4,75296,657,479,71965,71723,64893,55587,55948
83911,208,3183,60803,23108,3.62726e+13,964.764,11567.9,83911,897,462,71572,63238,43467,13978,14083
44298,2763,2963,31090,13208,3.71786e+13,584.855,8701.03,44298,633,483,41335,41335,41291,41315,40619
43824,1898,2854,30126,13698,3.57285e+13,577.527,7991.49,43824,453,385,40970,40831,39811,38088,34027
60807,2348,2569,41928,18879,3.62356e+13,724.273,8499.52,60807,578,446,58238,58234,58064,57618,57426
30911,526,2238,21386,9525,3.39684e+13,552.652,6161.22,30911,396,446,28275,27138,23764,17324,11002
33224,803,1874,23191,10033,3.6173e+13,734.672,5854.25,33224,447,378,31199,29421,23402,17028,18192
62044,1762,2184,44790,17254,3.66286e+13,981.881,8128.89,62044,586,355,59860,59840,58513,56149,55411
60669,1881,2588,42986,17683,3.59843e+13,912.441,8848.22,60669,588,657,58081,57820,55853,51766,50130
96811,2377,3157,67080,29731,3.59612e+13,982.514,11675.1,96811,620,624,93654,93596,92134,89926,82588
28581,1686,1769,19767,8814,3.50846e+13,557.003,5259.02,28581,352,333,26812,26812,26796,26795,26587
22598,1064,1462,16187,6411,3.62876e+13,487.959,4307.28,22598,345,280,21136,21047,20349,18392,18728
77615,2859,3097,54294,23321,3.41352e+13,943.272,10650.4,77615,485,650,74518,74518,74478,74487,73750
9212,553,934,6620,2592,3.52855e+13,241.03,2355.71,9212,199,196,8278,8252,8025,8004,5797
65909,1154,2678,46321,19588,3.70551e+13,796.819,9291.05,65909,508,457,63231,62595,58594,48253,43450
47881,433,2350,33008,14873,3.58536e+13,710.128,7202.45,47881,500,387,44394,42014,29443,22130,18218
59800,363,2221,42905,16895,3.70647e+13,1030.22,8186.44,59800,545,420,54523,51172,39451,26486,16997
93237,2234,3519,63481,29756,3.52336e+13,1159.56,11943.5,93237,530,492,89718,89200,85784,74454,76766
62818,1907,2498,42218,20600,3.42463e+13,896.141,8751.5,62818,568,630,60320,60101,58974,55901,56685
53833,680,2720,37723,16110,3.65605e+13,947.637,9089.7,53833,531,548,50016,47475,40034,29171,24166
46227,1406,1696,32927,13300,3.63139e+13,722.564,6311.98,46227,485,362,44531,44521,44315,43873,43408
10045,585,1520,7061,2984,3.62954e+13,247.179,3146.55,10045,313,215,8525,8278,6815,5076,4105
8860,68,1097,6102,2758,3.38599e+13,303.923,2475.17,8860,228,216,6843,5774,4209,1878,1057
13224,334,1103,8856,4368,3.26971e+13,252.742,2889.63,13224,207,289,12032,11610,10775,10484,6171
57199,1255,1918,39250,17949,3.31816e+13,853.649,7538.54,57199,408,451,55281,54960,53720,52356,44897
3890,84,782,2860,1030,4.11382e+13,116.235,1375.85,3890,153,119,2944,2652,2128,1809,506
13689,716,1031,9368,4321,3.57725e+13,574.946,3124.8,13689,249,326,12498,11964,11802,10338,10164
8732,878,901,6041,2691,3.69531e+13,285.617,2208.19,8732,230,235,7831,7831,7831,7831,7790
5764,540,867,3970,1794,3.64888e+13,243.624,1872.65,5764,145,211,4897,4757,4743,4692,3669
17217,9712,17217,0,17217,15.9991,0,17217,17217,17217,1,0,0,0,0,0
51741,1377,2860,35834,15907,3.40441e+13,839.252,8601.24,51741,590,545,48881,48186,46266,40631,32283
84430,2231,3216,59057,25373,3.59567e+13,822.67,11241.3,84430,720,481,81214,81145,75436,60885,62229
6568,761,892,4686,1882,3.72499e+13,260.734,1919.06,6568,216,141,5676,5654,5670,5659,5314
8259,54,1104,5733,2526,3.8294e+13,308.176,2410.16,8259,210,220,5890,4961,3410,1319,1092
60325,1344,2474,41864,18461,3.28218e+13,862.693,8518.91,60325,548,382,57851,57360,54655,47516,42571
60732,994,1950,41377,19355,3.19307e+13,735.991,7746.2,60732,462,428,58738,57704,52480,37544,33532
92940,948,3098,64542,28398,3.47729e+13,1156.48,11201.7,92940,672,516,88840,86791,64229,47606,44034
42147,943,2095,29328,12819,3.58924e+13,609.039,6283.32,42147,407,356,40052,39648,36273,33340,23121
45845,214,2393,31648,14197,3.65642e+13,623.795,7557.82,45845,556,365,39829,35186,23963,12352,7964
72961,133,3083,49948,23013,3.40853e+13,903.678,10837.5,72961,578,527,60489,53423,34462,11458,8969
72786,815,2412,51590,21196,3.58883e+13,1132.44,9016.52,72786,600,484,69347,67347,53970,38665,30905
35891,769,2135,24683,11208,3.35272e+13,576.363,6466.69,35891,510,388,33610,32696,28112,22485,17825
71137,804,2929,50701,20436,3.54546e+13,788.933,10266.3,71137,599,582,67680,65544,59552,49211,27152
18658,1167,1308,12906,5752,3.17814e+13,419.4,3556.63,18658,298,213,17350,17290,17173,17034,16987
65463,486,2539,45502,19961,3.4481e+13,920.507,8867.03,65463,476,501,60529,57581,41149,27282,20296
55757,322,2548,38584,17173,3.43359e+13,808.805,8505.02,55757,489,440,50296,46123,31990,15851,12478
58633,1919,2496,41839,16794,3.66408e+13,977.494,8730.82,58633,631,513,56137,56058,55036,53225,51238
90490,3160,4078,62311,28179,3.51015e+13,1130.45,13227.3,90490,693,666,86412,86295,85201,83563,78124
82161,1604,3505,56765,25396,3.59869e+13,1134.57,12088.1,82161,603,609,78601,77432,69488,52223,50584
64366,1546,2904,43877,20489,3.46426e+13,785.854,9420.32,64366,594,493,61462,61227,56801,47269,47806
32472,144,1872,22093,10379,3.30166e+13,523.374,5374.3,32472,341,364,27274,23863,15693,4989,5756
82276,1781,3194,56337,25939,3.46263e+13,750.961,10310.6,82276,502,390,79082,78864,74714,62337,63933
24076,1414,1526,16550,7526,3.60178e+13,444.235,4236.11,24076,325,250,22550,22539,22533,22545,22379
92089,471,3337,63512,28577,3.54291e+13,957.957,11472.4,92089,627,543,86563,83942,55953,33164,28355
8744,768,957,6302,2442,3.81708e+13,246.713,2240.94,8744,198,183,7787,7787,7761,7768,7128
5832,556,724,4024,1808,3.12035e+13,137.666,1530.8,5832,166,122,5108,5050,5096,5082,4538
50016,452,2741,35106,14910,3.64396e+13,850.648,8273.61,50016,478,477,46044,43536,33934,23730,13355
73996,2783,3057,51955,22041,3.50403e+13,1082.61,10477.5,73996,527,498,70939,70939,70847,70859,69252
6511,46,863,4852,1659,3.69443e+13,226.661,1888.86,6511,204,179,4627,3718,3110,1541,853
43693,1326,2182,30948,12745,3.67927e+13,751.892,7323.87,43693,531,401,41511,41109,38707,32008,32501
82636,941,2919,58586,24050,3.62461e+13,1020.12,10413.4,82636,547,500,78780,76636,68069,49212,44094
27450,1257,1786,18790,8660,3.6023e+13,572.869,5302.69,27450,307,396,25664,25501,25460,25333,21981
56553,409,2846,40090,16463,3.57634e+13,813.488,9091.34,56553,580,381,51622,49113,33546,20229,16620
92880,1621,4023,63368,29512,3.52105e+13,833.931,13617.8,92880,632,708,88857,88260,76208,63213,52774
68573,2869,2930,49599,18974,3.64867e+13,1112.05,10459,68573,683,598,65643,65643,65614,65609,65530
37390,80,2073,25789,11601,3.33233e+13,573.424,6223.2,37390,432,321,29633,24686,17494,5240,5649
42192,187,2310,28714,13478,3.57642e+13,580.852,6902.37,42192,442,411,35453,31439,20503,9546,9763
58830,2351,2546,40323,18507,3.5387e+13,824.234,8689.98,58830,487,602,56284,56282,56192,56190,55055
30980,1502,1878,22075,8905,3.56059e+13,824.47,5706.36,30980,463,363,29102,28842,28598,27479,26695
32487,1864,2128,22266,10221,3.42524e+13,440.943,6103.44,32487,422,312,30359,30344,30248,30231,28532
36636,938,2494,25045,11591,3.24337e+13,752.733,6888.16,36636,458,436,33980,33190,30959,21599,19497
78732,396,2860,55388,23344,3.67663e+13,998.459,9851.53,78732,665,437,72231,66470,45309,24297,20786
42020,1726,2533,29766,12254,3.72585e+13,581.541,7631.99,42020,358,475,39487,39447,39154,38415,32335
93809,1928,4089,65057,28752,3.58278e+13,941.802,13214.5,93809,674,647,89720,88903,81670,68643,53315
26138,468,2075,18737,7401,3.72217e+13,637.463,5515.75,26138,400,439,23538,22206,20122,18626,6513
97001,56,3318,67684,29317,3.35594e+13,1187.71,12367.6,97001,722,557,71322,57162,42541,12843,7178
82972,116,3078,57809,25163,3.65769e+13,1163.74,10988.6,82972,567,508,65834,57234,41168,13178,8151
18993,751,1736,13562,5431,3.79461e+13,491.581,4384.13,18993,287,299,17257,16545,15761,12769,9579
3500,278,515,2364,1136,3.60325e+13,219.334,1127.36,3500,138,135,2935,2644,2588,2390,1971
59220,1579,3037,41838,17382,3.74886e+13,931.249,9886.12,59220,539,553,56183,55610,53667,48060,42196
89703,206,2664,62406,27297,3.26832e+13,1057.86,10780.8,89703,519,520,78855,72593,48776,13439,10716
20279,1247,1779,14573,5706,3.69454e+13,463.183,4535.11,20279,370,260,18500,18401,18092,17644,15863
86221,1285,2725,60188,26033,3.47598e+13,1019.64,10392.4,86221,607,484,83396,82418,74292,56885,58274
82677,1146,3269,56947,25730,3.44853e+13,922.639,11448.1,82677,506,605,79350,77898,67650,48557,33377
24762,1128,1248,16695,8067,3.49033e+13,630.729,4194.28,24762,314,353,23514,23500,23370,23206,23185
37919,1442,2204,26550,11369,3.47239e+13,667.413,6767.45,37919,455,366,35715,35423,34639,33707,29158
82995,1652,2061,56685,26310,3.43349e+13,642.929,8106.27,82995,424,416,80934,80870,79977,79610,74360
20057,1110,1485,13523,6534,3.07307e+13,283.166,4188.91,20057,243,291,18572,18560,18438,18337,16193
18145,664,1362,12251,5894,3.49404e+13,425.445,3721.8,18145,300,276,16783,16505,15526,13181,11935
23105,1756,1871,16040,7065,3.35488e+13,529.302,4893.19,23105,380,373,21234,21215,21105,20963,20845
34567,1964,2157,23812,10755,3.35827e+13,590.751,6501.75,34567,426,462,32410,32407,32353,32295,31309
91391,1325,2941,63306,28085,3.41019e+13,1093.17,11293.6,91391,660,450,88335,86956,77692,54429,57361
48335,1174,1954,35081,13254,3.68282e+13,839.104,6577.87,48335,453,354,46354,44935,44827,40473,36239
15918,536,1362,11195,4723,3.55108e+13,466.984,3607.77,15918,291,257,14249,13347,12811,10976,7128
1389,116,453,1114,275,2.98913e+13,44.1094,680.73,1389,126,58,936,889,788,428,301
89904,518,3539,61722,28182,3.54639e+13,1233.72,12487.2,89904,568,647,83643,79888,54697,33069,21281
46438,411,2325,32295,14143,3.63943e+13,614.093,7125.91,46438,567,387,43030,40451,29993,23057,16930
30195,258,1498,20624,9571,3.52096e+13,405.777,4662.82,30195,309,261,27278,23263,16820,11683,8214
8530,1053,1219,5756,2774,3.15702e+13,180.255,2632.11,8530,320,182,7311,7308,7192,7072,6839
88034,520,3048,62688,25346,3.65382e+13,964.634,11619.5,88034,686,617,81788,78027,58470,38830,26127
77781,1424,3477,54124,23657,3.45135e+13,903.034,11393.6,77781,564,632,74270,73325,67985,55551,39210
34721,1538,2100,24297,10424,3.11449e+13,549.68,5969.04,34721,401,303,32621,32463,32225,30595,28777
90239,1927,3433,63077,27162,3.58335e+13,1054.14,12191.2,90239,848,519,86806,86522,82663,70976,68954
93339,2955,3865,64891,28448,3.56897e+13,999.5,13171.6,93339,628,774,89474,89462,88373,86312,78618
17722,533,1707,12487,5235,3.70161e+13,421.424,4367.44,17722,326,321,15950,15180,14127,11994,7365
77271,666,3142,53430,23841,3.5058e+13,954.724,10718,77271,650,469,72504,69522,48388,34425,31707
32299,1825,1911,22169,10130,3.49475e+13,643.813,5852.7,32299,460,386,30388,30387,30366,30373,30212
72074,2518,3029,50829,21245,3.65436e+13,1187.29,10158.7,72074,642,533,69045,68762,68451,67494,66008
8950,486,1305,6135,2815,3.59387e+13,231.748,2827.74,8950,247,259,7645,7416,6782,5726,3938
83778,764,3740,57314,26464,3.41794e+13,1030.14,11944.8,83778,610,698,78980,77035,56383,40398,31354
40426,839,1917,28349,12077,3.50289e+13,783.819,6630.2,40426,396,438,38190,37245,35069,30838,21630
65256,50,2714,45881,19375,3.41803e+13,932.564,9571.78,65256,439,522,47040,36963,28065,7303,4397
9482,151,1167,6589,2893,3.47999e+13,227.128,2617.62,9482,236,176,8028,7379,5198,2897,1877
87849,509,2589,62834,25015,3.62893e+13,1129.02,10563.3,87849,663,530,81130,76618,58647,40639,26032
65458,369,2258,46774,18684,3.70749e+13,1139.92,8812.08,65458,578,473,59391,55774,38043,27602,17503
36623,1841,2215,25149,11474,3.36821e+13,689.101,6579.92,36623,407,383,34408,34250,33879,32945,31548
46373,2108,2422,32649,13724,3.72726e+13,871.241,7733.59,46373,438,472,43951,43948,43811,43835,42555
24126,723,1832,16732,7394,3.59669e+13,649.852,4992.44,24126,363,376,22060,21257,19757,14489,14110
69559,2436,3162,47813,21746,3.57548e+13,686.065,10644.8,69559,502,588,66397,66387,65997,65957,60501
99028,1729,4076,68415,30613,3.54359e+13,1168.42,14133.8,99028,867,829,94952,93899,85683,74578,61490
49254,1546,2522,33586,15668,3.47739e+13,709.17,7867.86,49254,375,478,46732,46470,45785,44586,36700
57714,2182,2302,40167,17547,3.43656e+13,865.221,8249.27,57714,523,436,55412,55411,55392,55402,54861
50223,1600,2027,34698,15525,3.15456e+13,739.038,6977.66,50223,364,419,48196,48194,48099,48115,46800
7054,556,570,4756,2298,3.46512e+13,265.718,1588.66,7054,166,162,6484,6484,6484,6484,6474
9724,544,863,6962,2762,3.62747e+13,288.007,2174.49,9724,216,195,8861,8732,8199,7535,7504
95150,737,3949,64041,31109,3.41248e+13,1102.63,13388.9,95150,726,754,90104,88473,57477,35777,23295
85335,1112,2969,60022,25313,3.71448e+13,797.577,10269.1,85335,593,425,82366,81466,67953,49971,47932
3164,59,586,2550,614,3.1272e+13,98.0708,1114.85,3164,200,72,2423,2174,1795,1119,586
9924,850,1247,6883,3041,3.70884e+13,269.698,2794.04,9924,300,193,8677,8610,8326,7789,7439
21676,1529,1971,15411,6265,3.7792e+13,460.369,5155.77,21676,329,373,19705,19648,19506,19479,17323
35620,596,1973,25364,10256,3.42226e+13,690.208,6101.91,35620,376,339,33101,31550,29491,22787,11845
42365,1231,2016,29594,12771,3.62525e+13,755.681,6853.36,42365,493,348,40349,39927,37393,32741,27058
62030,2520,2666,42189,19841,3.30464e+13,875.733,8940.2,62030,399,496,59364,59350,59327,59346,58659
1153,273,276,895,258,3.4058e+13,59.2428,475.482,1153,109,52,877,877,877,877,877
52326,612,2752,37082,15244,3.58046e+13,859.99,8664.55,52326,591,447,48272,46147,35370,26157,18037
9171,519,1129,6488,2683,3.49011e+13,248.99,2540.62,9171,253,307,8042,7864,7021,5089,4729
1546,37,356,1088,458,3.44275e+13,140.369,625.92,1546,89,77,968,772,684,349,267
68510,1917,3431,47603,20907,3.57697e+13,1083.57,11132.2,68510,697,660,65079,64271,57972,46143,46785
57796,1421,2206,40093,17703,3.62579e+13,920.51,7300.2,57796,483,425,55590,54734,51758,44774,48795
80955,460,2549,58215,22740,3.71521e+13,1132.6,10106.1,80955,705,535,74508,70815,55770,34079,27087
88183,1696,3242,60869,27314,3.52639e+13,1063.41,10787.6,88183,578,489,84941,83943,75925,60779,59740
33913,1765,2261,22986,10927,3.43243e+13,622.242,6631.19,33913,345,574,31652,31581,31373,31201,27764
68427,2456,3142,47146,21281,3.55133e+13,1260.89,10097.6,68427,569,599,65285,64936,64497,63646,61363
38610,318,2002,26362,12248,3.51293e+13,653.686,6201.8,38610,395,368,34371,30955,21145,14598,10594
38255,1545,1918,27087,11168,3.64993e+13,756.274,6045.96,38255,393,329,36337,35961,35820,34711,34198
11288,493,1340,7989,3299,3.65897e+13,402.268,3060.28,11288,234,234,9877,9469,8372,6370,4783
92190,660,2835,65412,26778,3.57147e+13,1260.02,10875.5,92190,666,518,86982,82641,64025,42429,33548
57578,1048,2524,40308,17270,3.65818e+13,689.415,8369.44,57578,540,371,55054,54581,47206,34370,29092
18779,13836,18779,0,18779,15.9991,0,18779,18779,18779,1,0,0,0,0,0
85558,2537,3223,59578,25980,3.3873e+13,1164.99,11696.8,85558,662,523,82335,82287,80286,76952,71831
62534,962,2797,42822,19712,3.39781e+13,942.786,9298.05,62534,538,505,59421,58399,48822,35767,31339
33544,806,2000,23340,10204,3.67337e+13,557.681,6187.17,33544,342,503,31544,30869,29203,26446,18523
66814,308,2764,46832,19982,3.54701e+13,1066.65,9599.12,66814,566,468,59429,53712,35503,11497,13615
94437,2807,3606,64437,30000,3.44421e+13,970.728,12363.8,94437,641,660,90831,90752,89185,86425,80890
96647,2056,3454,68984,27663,3.62713e+13,1329.96,13100.5,96647,745,667,93193,92405,89641,81300,66441
52451,396,3257,37087,15364,3.62066e+13,885.784,9765.54,52451,511,809,47345,44637,35745,24983,11123
8127,860,999,5583,2544,3.73934e+13,246.982,2259.67,8127,209,195,7128,7127,7089,7082,6879
18646,864,1317,12446,6200,3.35024e+13,429.591,3862.76,18646,244,315,17329,17265,17096,16872,14311
43168,2301,2417,30134,13034,3.68723e+13,620.842,7442.12,43168,570,374,40751,40750,40704,40435,40383
28485,437,2011,19885,8600,3.64672e+13,516.284,5510.79,28485,406,384,25970,24680,18149,13378,11526
8404,198,829,5798,2606,3.56419e+13,292.826,2039.19,8404,203,207,7012,6017,4574,3490,2183
45688,48,2514,32776,12912,3.75649e+13,811.703,7631.64,45688,513,349,32836,27037,20429,5802,4496
39388,1472,1982,26262,13126,3.34802e+13,662.872,6388.13,39388,371,483,37406,37354,36731,35824,33617
37292,1708,2138,26664,10628,3.68455e+13,604.158,6572.82,37292,422,335,35154,35072,34712,34173,31320
88165,507,2971,61549,26616,3.58513e+13,1053.48,10703,88165,580,500,82597,79583,52498,37098,29167
17728,498,1134,12248,5480,3.60893e+13,409.249,3340.12,17728,275,266,16594,16044,14045,9967,10671
60366,545,2545,42209,18157,3.61285e+13,912.849,8840.95,60366,535,453,56442,53805,40878,28145,20738
75278,394,2709,52303,22975,3.41918e+13,1103.97,9910.32,75278,707,508,68496,64030,43712,25553,18786
14502,628,1291,9925,4577,3.49799e+13,535.247,3364.69,14502,287,302,13090,12470,12052,11489,8433
46971,2614,2936,32196,14775,3.48186e+13,567.733,8351.17,46971,568,401,44035,44028,43947,43931,42527
60973,433,3654,42048,18925,3.49361e+13,882.382,10737.1,60973,648,727,55598,52238,36372,19771,14026
39118,2279,2375,27000,12118,3.66313e+13,636.791,7187.2,39118,391,500,36743,36743,36734,36743,36451
48250,140,2314,33240,15010,3.25693e+13,858.371,7376.8,48250,431,463,41468,37885,23615,5547,6242
10372,832,992,7562,2810,3.86383e+13,394.566,2526.51,10372,316,209,9380,9360,9351,9369,9053
99479,1110,4314,67525,31954,3.46461e+13,1341.18,14179.1,99479,667,692,93882,91326,55954,42893,38837
5933,95,676,4036,1897,3.67725e+13,277.389,1629.63,5933,168,167,4351,3809,3284,1726,1050
31694,403,1435,22317,9377,3.42153e+13,869.02,4896.21,31694,398,333,28875,27254,23954,15569,12287
56318,362,2522,39590,16728,3.53788e+13,820.908,8232.32,56318,561,454,50857,47378,34851,22673,15351
27620,1825,2016,19205,8415,3.5348e+13,433.589,5210.86,27620,447,328,25604,25604,25581,25321,25278
5869,10,976,4167,1702,3.89783e+13,219.001,1952.32,5869,202,156,2848,1757,1614,943,429
40494,2263,2569,27379,13115,3.47608e+13,623.246,7373.25,40494,561,406,37925,37922,37656,37362,36780
65143,1046,2618,45206,19937,3.62131e+13,860.224,9055.82,65143,545,454,62420,61288,50192,37576,37453
62265,414,2403,43383,18882,3.44088e+13,976.079,8576.94,62265,516,556,57324,54330,35004,19166,16759
25924,1145,1853,18341,7583,3.57256e+13,517.559,5087.54,25924,405,289,24071,23967,23375,21391,19823
2792,524,551,1880,912,3.64508e+13,113.679,1065.54,2792,95,140,2241,2241,2241,2241,2222
13423,683,942,9424,3999,3.55804e+13,324.938,2732.64,13423,242,190,12481,12420,11928,11047,10622
22026,1412,1786,15633,6393,3.59673e+13,579.326,4808.41,22026,385,343,20240,20120,19973,19732,18080
84484,71,4319,59649,24835,3.64325e+13,807.89,13568.9,84484,848,618,62699,53530,39704,12465,6612
71307,2924,3568,49506,21801,3.57214e+13,864.187,10819.8,71307,647,627,67739,67662,67333,66196,64333
14225,850,1392,10243,3982,3.83018e+13,296.25,3440.43,14225,275,292,12833,12753,12539,12508,8754
73643,1255,3295,51985,21658,3.69504e+13,1031.19,10886.2,73643,437,635,70151,68573,64963,60451,38970
73142,957,3311,51519,21623,3.69125e+13,977.371,10722.7,73142,659,542,69353,66969,55179,40773,33796
94697,718,2976,66717,27980,3.68022e+13,911.316,11768.5,94697,757,492,90169,86620,63434,45017,37709
50296,1351,2580,35388,14908,3.58822e+13,695.994,8306.8,50296,473,510,47716,47482,45660,42338,34749
47720,2315,2535,32822,14898,3.36505e+13,928.532,7898.4,47720,433,518,45185,45173,45121,45128,44171
89690,2507,3174,62593,27097,3.44757e+13,894.958,11282,89690,538,517,86516,86471,86216,86400,81062
5492,635,760,3737,1755,3.47795e+13,249.235,1704.94,5492,163,161,4732,4688,4713,4692,4455
56576,1886,1999,38432,18144,3.55063e+13,898.315,7642.17,56576,459,535,54577,54577,54445,54284,53808
40524,1766,2204,28787,11737,3.72371e+13,631.252,6882.91,40524,412,494,38320,38194,37981,37758,35989
63818,2772,2944,43550,20268,3.29842e+13,787.105,9603.57,63818,577,464,60874,60867,60721,60362,59915
42419,454,2260,29531,12888,3.29773e+13,708.96,7084.97,42419,352,512,39314,37689,32996,27957,10225
84718,2004,3005,59855,24863,3.45993e+13,1262.3,11320.2,84718,611,508,81713,80780,79672,75332,67860
87390,957,3141,62711,24679,3.68929e+13,1205.84,11869.8,87390,719,572,82925,80532,70234,45273,34110
89334,1732,3937,60765,28569,3.4609e+13,1130.87,13269,89334,772,734,85378,84536,78762,66893,47483
34030,446,1181,24822,9208,3.58654e+13,649.903,4585.74,34030,372,281,31618,29792,27725,24870,20144
16580,1021,1067,11199,5381,3.38484e+13,420.582,3214.38,16580,264,267,15513,15513,15497,15498,15461
22909,337,1731,16370,6539,3.68032e+13,483.319,4782.62,22909,387,300,20670,19432,17044,15237,7260
42269,196,1874,30324,11945,3.6418e+13,805.023,6323.88,42269,460,399,36167,31185,25070,14613,9167
46006,287,2316,32657,13349,3.63268e+13,1015.67,7626.93,46006,520,390,41240,38054,25887,16345,9479
7466,928,1078,5387,2079,3.93491e+13,261.464,2241.72,7466,196,163,6388,6377,6345,6350,6079
83484,703,3396,59299,24185,3.66395e+13,1190.75,12093,83484,859,656,78208,75343,62659,46787,28161
37946,2046,2273,26915,11031,3.70413e+13,561.862,6737.56,37946,409,422,35673,35669,35616,35630,34621
99097,3641,3783,70121,28976,3.62506e+13,983.755,13225.3,99097,627,653,95314,95314,95283,95296,94921
79906,1547,2841,56663,23243,3.55456e+13,1048.47,10498.6,79906,616,516,77065,76317,72112,63500,54435
68793,1799,2517,48122,20671,3.60599e+13,968.444,9345.98,68793,565,483,66276,66060,65486,62202,60652
42557,1888,2008,29851,12706,3.5452e+13,817.245,6830.3,42557,479,376,40549,40548,40413,40349,40025
93027,903,2869,65334,27693,3.43254e+13,1279.26,11249.3,93027,700,632,88580,85822,72139,51840,42564
77185,668,3909,53678,23507,3.43374e+13,899.926,11745.9,77185,789,649,72272,70709,45153,31495,20190
35929,115,2089,25503,10426,3.71117e+13,827.209,6474.19,35929,469,432,28817,25426,18468,5829,3876
33937,337,1766,23400,10537,3.1053e+13,471.814,5532.4,33937,373,328,31347,30128,24274,18327,14744
44174,156,2693,30549,13625,3.60201e+13,689.65,8049.14,44174,412,556,36326,31610,21729,9642,6188
21751,185,1566,15129,6622,3.12828e+13,535.893,4222.25,21751,297,257,19004,17673,11131,3456,2959
40406,1900,2116,28131,12275,3.41278e+13,764.242,6757.13,40406,431,466,38290,38228,38147,38047,36594
73867,2055,2835,52769,21098,3.69167e+13,1018.17,10400.5,73867,614,527,71032,70580,70016,67628,63265
41671,1641,1994,29001,12670,3.2794e+13,596.475,6328.46,41671,491,346,39677,39665,39437,39330,35769
84800,2188,3658,58306,26494,3.43288e+13,739.007,11841.3,84800,800,582,81142,81056,78669,69614,65968
79197,252,3431,55040,24157,3.54831e+13,933.779,11528.6,79197,592,617,69893,62027,44361,16045,13425
18644,134,1562,12717,5927,3.50281e+13,396.752,4227,18644,349,338,15517,13936,9462,4276,2962
50477,1722,2277,34593,15884,3.41037e+13,624.47,7524.93,50477,620,315,48200,48185,47477,44295,44458
76799,3220,3496,53487,23312,3.70803e+13,716.292,11464.3,76799,466,587,73303,73303,73169,73219,71617
86204,859,3441,60591,25613,3.56466e+13,1064.39,12165.6,86204,635,659,81762,79271,63139,44706,28861
92428,544,3593,65824,26604,3.67999e+13,1075.98,13059.5,92428,578,599,85828,82155,59810,37991,26932
48543,135,2420,34088,14455,3.5258e+13,1047.83,8002.17,48543,457,480,40611,36270,25370,6121,5797
50739,218,2648,34915,15824,3.32825e+13,779.051,8491.72,50739,443,495,44590,41064,27436,9740,8208
90816,448,2997,64393,26423,3.52835e+13,1284.69,11451.3,90816,723,527,83565,79479,54874,35119,16678
63427,2658,2992,44643,18784,3.58958e+13,855.836,9756.46,63427,733,439,60435,60428,59519,58030,56540
31351,447,2402,21744,9607,3.60306e+13,710.78,6581.08,31351,419,405,27901,26183,19320,13789,9570
5620,456,629,3790,1830,3.41622e+13,334.253,1547.07,5620,190,157,4987,4513,4667,4575,4333
86044,822,2020,58393,27651,3.52919e+13,769.873,8127.82,86044,495,419,83867,82443,67084,53760,51037
24166,1140,1610,17158,7008,3.6409e+13,613.805,4586.41,24166,372,337,22556,22224,21939,20490,19090
35192,1220,1697,24972,10220,3.61034e+13,602.517,5398.98,35192,372,284,33495,33313,33016,32937,30443
83812,322,2953,58006,25806,3.45961e+13,1182.3,11137.5,83812,578,558,75458,69221,48947,22523,17885
30515,1245,1482,21377,9138,3.30328e+13,558.848,4809.73,30515,312,260,29033,28775,28896,28801,27294
63788,1917,2474,44931,18857,3.58044e+13,976.641,8957.32,63788,510,464,61314,61218,60404,59574,55906
24392,1718,1720,17317,7075,3.60937e+13,660.084,4788.86,24392,355,376,22672,22672,22672,22672,22672
65406,1639,3384,45023,20383,3.51657e+13,824.915,10332.8,65406,681,527,62022,61626,52355,41391,40225
16553,117,1402,11422,5131,3.3215e+13,374.361,3675.7,16553,208,323,13918,12171,9051,4655,2229
86428,103,3831,59784,26644,3.41713e+13,788.613,12990.6,86428,858,438,69853,61054,41284,13479,8066
18684,712,1171,12982,5702,2.78707e+13,339.934,3138.55,18684,218,203,17513,17188,17186,16920,14401
67428,174,2109,46037,21391,3.46325e+13,996.819,8225.06,67428,427,506,58312,51142,35135,12025,12051
83870,326,3225,57875,25995,3.5853e+13,860.809,11311.4,83870,508,486,76246,69806,46320,18838,16981
64134,1362,2450,43822,20312,3.40191e+13,629.627,8364.64,64134,458,428,61684,61477,56702,49434,46308
97783,3220,3808,66934,30849,3.45628e+13,1016.29,12677.1,97783,609,717,93975,93942,93216,91938,90962
21323,1476,1796,15426,5897,3.78773e+13,362.413,4774.6,21323,256,332,19527,19527,19443,19397,17365
90738,1630,2837,63025,27713,3.34583e+13,1206.31,10828,90738,637,550,87901,87005,84541,77880,68612
85027,2097,2447,58412,26615,3.30422e+13,815.506,9960.24,85027,557,464,82580,82545,82168,81819,77013
57733,1635,2856,40222,17511,3.62228e+13,905.402,9166.22,57733,455,490,54877,54424,51845,49441,40670
13922,391,1256,9641,4281,3.1755e+13,240.341,3030.07,13922,208,217,12653,12221,12001,11491,8760
7810,396,978,5361,2449,3.46421e+13,267.941,2234.31,7810,210,197,6830,6438,6136,5340,3607
47643,1391,2342,32902,14741,3.44286e+13,852.87,7732.2,47643,468,451,45301,44658,42947,39836,34579
13425,32,1195,8941,4484,3.26398e+13,343.117,3100.5,13425,255,218,8818,6379,4557,2908,1142
24413,1148,1633,16873,7540,3.52144e+13,483.918,4799.34,24413,339,325,22780,22729,22402,22218,20490
50128,1711,2298,34730,15398,3.4618e+13,882.517,7560.14,50128,411,443,47830,47413,47239,46509,42991
65032,2076,3331,44969,20063,3.48297e+13,974.397,10686.6,65032,641,682,61701,61333,57995,49727,43062
72656,1972,3629,49688,22968,3.50387e+13,1143.3,11944.3,72656,682,801,69027,68152,65724,58919,49007
94286,719,2778,67245,27041,3.66162e+13,1162.51,11350.3,94286,741,598,89209,86430,63754,45495,39351
76366,991,2698,52730,23636,3.61851e+13,942.941,9698.76,76366,504,549,73404,71743,62053,51431,45208
95673,1666,3460,66120,29553,3.54502e+13,1146.24,12379.9,95673,575,567,92183,91026,82780,61576,53672
64857,2970,3321,44892,19965,3.44255e+13,1174.32,10507.1,64857,622,567,61536,61531,61162,60801,59775
96064,2393,2810,66217,29847,3.42388e+13,864.329,10685.1,96064,572,462,93254,93184,92867,92559,87586
29705,1486,1980,20314,9391,3.52042e+13,556.383,5795.65,29705,383,348,27725,27646,27324,26699,24557
42635,2195,2387,29317,13318,3.43805e+13,548.889,6702.05,42635,477,339,40248,40245,40163,40174,39659
55261,1194,2234,39154,16107,3.51614e+13,756.772,7829.89,55261,502,428,53027,52563,49676,44659,35539
17571,894,1535,12238,5333,3.7149e+13,305.358,3918.67,17571,349,242,16036,15999,15103,13013,12745
23184,183,1412,15654,7530,3.30262e+13,522.391,4239.6,23184,287,389,20144,18595,13284,8294,3489
60599,1064,2999,41993,18606,3.5001e+13,754.425,10143.9,60599,425,588,57600,56508,52915,46510,29170
26208,510,1797,18352,7856,3.68396e+13,568.444,4934.08,26208,375,293,24154,23303,18216,11945,10451
32539,1713,1993,22237,10302,3.5375e+13,891.526,6166.43,32539,457,493,30546,30276,29890,28823,29387
3890,239,743,2698,1192,3.72699e+13,177.656,1420.22,3890,157,175,3126,2831,2772,2339,1548
11190,468,1245,7923,3267,3.29801e+13,201.429,2876.68,11190,231,170,9945,9776,8770,6256,4078
30396,73,1580,21395,9001,3.38412e+13,725.051,5009.35,30396,372,309,23426,18826,14179,3273,2748
49021,223,2749,33372,15649,3.31184e+13,724.036,8184.85,49021,489,588,43724,41006,27427,10417,8790
91881,729,3378,63014,28867,3.42025e+13,1081.45,12281.2,91881,571,708,86488,83518,59502,42239,33467
56062,1593,2389,39214,16848,3.61527e+13,796.504,8000.35,56062,479,412,53673,53516,51937,49242,44871
93795,2267,2864,65728,28067,3.47467e+13,1199.74,11075.7,93795,600,476,90931,90579,89469,87961,81853
2491,332,539,1863,628,4.02321e+13,99.3424,942.374,2491,136,88,1952,1921,1906,1928,1397
13759,642,1313,9692,4067,3.43759e+13,388.275,3334.37,13759,332,273,12446,12253,11280,9627,8729
98987,188,2502,67728,31259,3.35605e+13,1036.94,10551.6,98987,583,465,85206,74907,52770,19567,15471
27226,1676,1813,19042,8184,3.62884e+13,493.331,5162.56,27226,342,336,25413,25412,25376,25353,25113
70582,2651,2656,48568,22014,3.33961e+13,927.705,9748.34,70582,530,473,67926,67926,67926,67926,67911
76130,1303,3212,51817,24313,3.5655e+13,932.244,10959.5,76130,589,629,72861,71811,54871,42594,31405
66682,1424,2665,47544,19138,3.70329e+13,1087.22,9279.21,66682,630,458,63908,62971,58773,47085,47605
66440,1528,2819,45918,20522,3.52439e+13,866.069,9500.87,66440,503,511,63621,63158,58078,45751,44643
83873,125,3585,57837,26036,3.33641e+13,900.878,12449.6,83873,483,756,69658,61619,41867,12038,7640
50897,1714,2923,34980,15917,3.32101e+13,825.91,8491.41,50897,454,489,47974,47630,45341,40755,37113
5864,345,874,3989,1875,3.62459e+13,166.016,1889.94,5864,127,243,4990,4806,4719,4660,2506
65981,1470,3026,45452,20529,3.56135e+13,890.04,9323.8,65981,598,426,62955,62292,55575,46515,47455
30382,473,1898,20720,9662,3.46361e+13,502.481,5500.59,30382,319,311,28218,27213,21068,15759,11710
40982,1020,2525,28643,12339,3.58766e+13,539.829,7309.34,40982,451,354,38457,37729,35553,29177,24026
22766,1184,1902,15532,7234,3.39194e+13,593.063,5198.06,22766,346,409,20864,20574,20062,19065,16705
72202,1144,2274,50318,21884,3.49333e+13,834.202,8514.34,72202,507,440,69928,69281,63265,52473,53938
7415,270,682,5251,2164,3.59149e+13,222.194,1757.37,7415,204,138,6711,6196,5457,4020,3344
27531,36,1609,18831,8700,3.5475e+13,508.123,4529.95,27531,303,262,17926,14183,11580,5488,2713
86425,1207,2779,62042,24383,3.68191e+13,1054.64,10849.7,86425,595,572,83346,81813,75541,62917,48907
42654,594,2374,30270,12384,3.57904e+13,730.928,7491.27,42654,380,540,39353,37857,34209,27802,17206
20412,578,1438,13826,6586,3.23726e+13,474.13,4127.43,20412,313,379,18827,18222,16977,13960,11276
13105,453,1161,9350,3755,3.68183e+13,354.691,2913.43,13105,281,231,11882,11502,10377,7999,7437
78570,1724,3137,55727,22843,3.67943e+13,995.797,10985.5,78570,670,502,75433,74885,71099,61452,60313
44026,1415,2086,31409,12617,3.64562e+13,703.066,7002.26,44026,609,395,41940,41880,40649,37386,35804
12968,3106,12968,0,12968,15.9988,0,12968,12968,12968,1,0,0,0,0,0
41997,952,2278,28927,13070,3.67899e+13,647.594,7064.61,41997,467,384,39719,39140,34955,27259,23085
9341,623,1049,6531,2810,3.57864e+13,214.277,2491.63,9341,232,188,8292,8186,8146,8068,6038
31743,866,2045,22775,8968,3.66429e+13,717.943,6002.86,31743,438,458,29508,28634,26861,22402,14372
65659,982,3277,45504,20155,3.53993e+13,1164.81,10834.5,65659,513,726,61453,59765,51534,38708,29786
95009,808,2654,65704,29305,3.2716e+13,943.749,10107.3,95009,652,503,91491,90053,58527,44908,40033
23398,78,1356,16798,6600,3.68106e+13,611.084,4155.61,23398,329,277,17507,14873,12427,4288,3171
38653,844,2216,26777,11876,3.43282e+13,543.059,6730.21,38653,375,422,36377,35929,32696,25317,22359
52739,255,2629,36108,16631,3.27055e+13,578.73,8274.71,52739,552,351,47289,42298,25775,10549,8935
47435,2129,2417,31970,15465,3.37649e+13,730.673,7716.63,47435,328,552,45018,45018,44979,45008,43377
73442,1761,2821,51534,21908,3.59622e+13,839.355,9527.48,73442,557,445,70621,70408,65481,57460,57209
12480,483,1219,8806,3674,3.60024e+13,359.436,3104.39,12480,228,206,11231,10846,9676,7423,6112
72311,1923,3399,50111,22200,3.61046e+13,835.139,11152.2,72311,843,485,68912,68852,62474,52276,52299
60878,1309,2778,42892,17986,3.68765e+13,726.802,9167.09,60878,514,529,58100,57765,54047,43008,39864
10869,975,1094,7316,3553,3.35649e+13,230.583,2644.05,10869,215,240,9775,9769,9736,9764,9439
80604,1623,2883,57023,23581,3.65276e+13,1046.02,10557,80604,675,470,77721,76866,70543,52842,57674
33450,69,1618,23437,10013,3.40357e+13,649.084,5347.39,33450,400,326,25919,20698,16094,5048,4240
52318,1906,2771,35996,16322,3.45195e+13,801.477,8514.04,52318,570,454,49547,48985,47066,43470,40998
6367,375,977,4482,1885,3.72341e+13,199.259,2029.41,6367,142,224,5390,5173,5114,5073,2710
78927,1425,3342,55348,23579,3.67271e+13,1233.6,11555.4,78927,712,582,75162,73859,59033,41046,35045
54399,1790,2294,38894,15505,3.70181e+13,796.837,7821.93,54399,500,428,52105,51958,51752,50764,47323
81232,1358,3471,57135,24097,3.59165e+13,923.994,11774.5,81232,695,579,77659,76594,64118,47972,41334
96333,671,3290,69029,27304,3.71124e+13,1067.53,12764.8,96333,806,511,90726,86995,62234,44434,32156
58271,438,2430,41116,17155,3.70993e+13,848.644,8293.34,58271,561,432,53256,49981,36130,23256,14851
6029,673,746,4381,1648,3.58366e+13,232.611,1645.11,6029,215,134,5283,5283,5280,5269,5260
77485,2604,3252,55877,21608,3.68224e+13,1039.14,11699,77485,608,595,74233,74217,73889,73729,67975
26812,1548,1919,19081,7731,3.74616e+13,555.038,5248.38,26812,457,303,24893,24800,24729,23960,24005
62840,357,3366,43951,18889,3.53729e+13,796.971,10726.4,62840,460,710,56863,52810,38177,20849,11643
92041,1670,2838,63297,28744,3.54143e+13,816.929,10934.5,92041,684,505,89203,89128,84454,74928,72512
12334,1059,1089,8793,3541,3.59857e+13,315.778,2709.42,12334,248,167,11245,11245,11242,11244,11217
44187,1497,2318,31160,13027,3.51678e+13,839.016,7419.45,44187,440,456,41869,41320,40728,39552,35241
20652,949,2025,14820,5832,3.68371e+13,507.137,4970.14,20652,466,381,18627,18098,16880,13703,13271
32547,1815,2249,22228,10319,3.36357e+13,579.381,6286.64,32547,384,438,30298,30152,30143,30097,27825
77619,3181,3337,54336,23283,3.71337e+13,889.613,11324.3,77619,668,566,74282,74280,74138,74110,73800
4445,468,738,2964,1481,3.30295e+13,251.791,1515.39,4445,151,184,3707,3519,3527,3521,2847
75948,1487,3012,52456,23492,3.61684e+13,797.508,9988.74,75948,528,452,72936,72374,62599,51025,51618
11520,1231,1588,8388,3132,3.75979e+13,280.919,3346.67,11520,346,171,9932,9930,9834,9878,8758
41953,1034,1854,30256,11697,3.71877e+13,770.369,6393.82,41953,468,390,40004,38830,37988,36868,28601
8357,377,935,5860,2497,3.42091e+13,164.352,2100.19,8357,190,129,7422,7298,6922,6719,4964
14686,41,1436,10097,4589,3.58026e+13,304.832,3660.39,14686,258,324,10181,8164,6459,3153,1627
44786,287,1756,31014,13772,3.61698e+13,727.72,6097.28,44786,403,364,40412,35685,25960,16192,16049
80403,41,2439,55276,25127,3.62971e+13,598.829,8493.45,80403,477,389,55486,44633,34603,15000,8757
62708,637,2254,44536,18172,3.65361e+13,955.615,8314.86,62708,444,422,59193,56699,41159,26758,24321
6559,512,764,4567,1992,3.45705e+13,197.1,1785.81,6559,150,154,5795,5783,5697,5606,4622
33449,1778,2631,23399,10050,3.60385e+13,454.603,7178.98,33449,296,504,30818,30803,30469,30210,24236
96790,1009,3815,66940,29850,3.51345e+13,1206.28,13192,96790,717,688,91780,89508,71727,51680,43070
74727,1361,3156,51370,23357,3.52278e+13,840.781,10742.2,74727,537,531,71571,70908,62436,47657,33366
42904,1324,2373,29333,13571,3.59994e+13,664.039,7525.55,42904,386,611,40531,40349,39377,38332,27103
36684,1064,1590,26187,10497,3.72447e+13,691.373,5497.12,36684,412,342,35094,35061,33308,31404,30996
59184,1635,2666,40659,18525,3.45141e+13,862.329,8829.07,59184,436,393,56518,56184,53145,44692,41183
77939,1780,3146,55100,22839,3.57111e+13,1094.42,10572.6,77939,647,454,74793,74052,69355,58748,51907
3608,249,438,2471,1137,3.70609e+13,198.943,1006.33,3608,121,125,3131,2740,2772,2611,2373
83351,1659,2899,58362,24989,3.58857e+13,946.096,10294.2,83351,621,517,80452,80279,75743,67362,61129
35798,859,1984,24902,10896,3.48502e+13,945.785,6235.44,35798,409,397,33316,32447,30107,24404,18080
69132,2175,2457,47719,21413,3.59605e+13,763.644,9286.64,69132,672,529,66675,66672,66526,66259,63385
15931,626,1186,10988,4943,3.19352e+13,287.388,3199.26,15931,296,268,14745,14514,13667,11935,11381
85926,287,2562,60809,25117,3.70612e+13,897.765,9889.04,85926,536,460,78585,71155,50764,31714,24261
85367,1387,2828,58214,27153,3.46352e+13,1331.01,11248.5,85367,678,670,82041,80814,76139,62146,53588
30896,1438,2078,21468,9428,3.45766e+13,380.809,5790.57,30896,434,269,28818,28769,28165,27223,23283
82341,2346,3179,57979,24362,3.61435e+13,845.044,11557.2,82341,444,605,79162,79134,78722,78850,71291
93669,3216,3836,66409,27260,3.60906e+13,1163.94,13241.5,93669,659,617,89833,89681,89514,89454,85856
60081,1978,2645,42084,17997,3.62594e+13,867.834,8806.06,60081,554,444,57436,57168,55441,50183,52125
75371,1801,2638,52858,22513,3.55669e+13,1047.37,10046.4,75371,582,484,72733,72290,70738,69460,59526
38147,1726,2103,26407,11740,3.65126e+13,853.935,6814.57,38147,499,461,36044,35764,35115,33746,33782
55221,1941,2047,38177,17044,3.394e+13,865.795,7207.61,55221,412,420,53174,53166,53132,53119,52667
44103,207,1962,30561,13542,3.6109e+13,741.64,6677.57,44103,447,398,37921,33935,24156,8012,8610
69936,1830,3132,49107,20829,3.66888e+13,1094.05,10604.5,69936,624,651,66804,66196,63136,56861,51166
28515,45,1855,19476,9039,3.366e+13,458.068,5591.15,28515,444,305,19996,15555,12286,4389,2882
47810,47,2300,33490,14320,3.63265e+13,927.348,7556.9,47810,590,473,33569,27431,19721,8809,4030
95329,1364,3468,66157,29172,3.24547e+13,995.169,12234.7,95329,757,509,91805,90604,78696,54210,47366
50896,1790,2563,34566,16330,3.4455e+13,736.754,8131.23,50896,515,402,48333,48251,47243,44740,43461
96278,166,3480,65895,30383,3.34788e+13,1151.17,11966,96278,570,557,82408,73096,46510,13964,9236
32235,209,1600,22177,10058,3.35367e+13,526.44,5272.16,32235,280,342,28256,25176,16748,8842,6161
76655,735,3131,53810,22845,3.50307e+13,1005.26,10557.1,76655,514,533,72069,69214,55520,39549,30324
67900,693,2684,46953,20947,3.46998e+13,944.501,9474.82,67900,548,543,63873,61461,47626,31677,22583
56944,245,2333,39036,17908,3.53514e+13,742.455,7859.28,56944,442,481,51322,44850,32339,13277,12721
7523,721,1067,5124,2399,3.39785e+13,217.974,2283.28,7523,193,200,6456,6365,6215,5202,5172
15272,386,1467,10411,4861,3.37048e+13,425.685,3682.18,15272,322,310,13552,13031,10808,10049,5438
1565,124,375,1096,469,3.62522e+13,79.5246,642.939,1565,83,87,1190,1073,955,1007,518
99314,807,4156,68775,30539,3.5914e+13,1175.5,13902.2,99314,905,609,93263,89728,59440,43769,31137
66712,781,2661,46311,20401,3.51008e+13,806.352,9696.61,66712,440,540,63495,61432,55867,42713,25345
48759,1369,2308,33869,14890,3.34962e+13,746.772,7420.34,48759,526,347,46451,46281,43045,30048,29904
79722,1722,3694,54654,25068,3.54077e+13,843.196,12233.6,79722,755,603,76028,75703,59624,48380,44144
76357,861,2974,54011,22346,3.60875e+13,1015.73,10475.2,76357,688,484,72258,70223,54656,36088,26937
37479,1701,1716,27081,10398,3.69096e+13,725.06,5804.28,37479,425,328,35763,35763,35761,35759,35750
76532,2606,2830,55151,21381,3.65786e+13,939.438,10983.9,76532,597,546,73702,73699,73593,73473,72329
23742,733,1579,16551,7191,3.68215e+13,390.032,4353.86,23742,283,301,22163,22059,19011,12939,15554
38451,1472,1820,26361,12090,3.20808e+13,701.878,5850.59,38451,314,376,36631,36230,36503,36248,33565
7584,286,861,5221,2363,2.86554e+13,151.884,2030.43,7584,205,179,6723,6576,5747,5095,2133
89088,503,3324,61956,27132,3.64647e+13,1200.83,11794.2,89088,684,610,81506,76876,53285,30343,28159
83711,1377,3068,57469,26242,3.51324e+13,1150.07,11485.5,83711,625,583,80437,78256,73480,59329,54339
30345,901,2006,20923,9422,3.57581e+13,567.211,5857,30345,343,438,28339,27908,26593,24447,18096
66208,2756,2823,46010,20198,3.50855e+13,1133.18,10035.5,66208,609,611,63385,63378,63366,63376,63073
28634,424,1722,19192,9442,3.49066e+13,568.871,5289.98,28634,320,445,26131,24677,18514,15253,11231
29111,1220,1723,20480,8631,3.75686e+13,610.222,5265.96,29111,362,332,27388,27338,26818,25981,24565
18462,640,1884,13017,5445,3.67942e+13,406.92,4623.18,18462,438,315,16578,15919,11627,10202,8117
2443,436,485,1763,680,4.11966e+13,89.3573,903.971,2443,166,84,1958,1958,1958,1958,1808
97581,1963,4047,66970,30611,3.49997e+13,1406.92,14326.4,97581,582,806,93534,92008,87870,76895,62504
9789,26,1204,6806,2983,3.56768e+13,231.378,2776.39,9789,192,299,6121,4621,3634,1768,881
74154,1256,2594,52928,21226,3.68076e+13,765.877,9509.2,74154,710,358,71560,70926,65019,46348,44922
57796,77,1941,40826,16970,3.69862e+13,918.977,7682.83,57796,521,432,44377,38049,28735,9796,6414
87935,91,2906,61606,26329,3.53774e+13,1096.34,10887.2,87935,659,565,68270,58492,43318,14097,9300
10075,544,1162,6863,3212,3.35456e+13,226.079,2714.15,10075,182,232,8913,8740,8441,8446,5930
32423,126,1569,21860,10563,3.44299e+13,387.733,4958.04,32423,380,292,25701,21490,15060,6400,7148
53063,711,2383,36347,16716,3.07718e+13,759.006,7683.2,53063,415,407,50034,48942,37865,28773,17234
83716,1797,3298,59441,24275,3.62648e+13,963.516,11263.2,83716,495,634,80418,80182,78704,77051,62177
88724,2385,3555,63265,25459,3.63934e+13,1108.61,12836,88724,675,712,85169,84761,83945,81578,68361
98330,2711,2981,68387,29943,3.41756e+13,1352.63,11949.1,98330,680,602,95349,95117,95064,94745,92244
3183,385,402,2156,1027,3.38747e+13,212.753,948.23,3183,118,126,2781,2781,2781,2780,2762
5804,362,849,4067,1737,3.68864e+13,163.618,1809.22,5804,210,178,4955,4803,4572,3708,2802
25422,89,1635,17044,8378,3.43286e+13,673.404,4948.91,25422,307,427,19821,17071,10620,5200,2563
60087,2171,2559,42275,17812,3.62571e+13,984.924,8723.08,60087,530,485,57528,57515,56421,53517,55616
17175,16,1399,11513,5662,3.28968e+13,423.409,3752.84,17175,280,305,8961,5681,4762,2834,1179
78630,1880,3465,54440,24190,3.47496e+13,927.256,11257.7,78630,645,576,75165,74658,68961,56420,53754
76402,2513,3128,52552,23850,3.44701e+13,986.098,10752.4,76402,551,533,73274,73195,72304,69600,68411
10818,335,939,7376,3442,3.64247e+13,339.897,2493.03,10818,236,245,9675,8721,8283,7075,5779
11017,1039,1162,7415,3602,3.39202e+13,314.928,2840.13,11017,224,233,9855,9849,9789,9708,9658
78815,657,3463,53304,25511,3.36657e+13,956.493,11303.7,78815,531,588,74047,71608,49239,36348,25415
77609,3038,3138,54125,23484,3.55897e+13,914.328,10259.9,77609,511,481,74471,74470,74452,74446,74133
43155,337,2676,30144,13011,3.63727e+13,698.686,7966.51,43155,561,412,38191,35216,24782,14385,10135
15731,164,1396,11079,4652,3.53619e+13,409.151,3624.64,15731,389,266,12986,11335,8991,6089,3801
34778,2358,2480,24526,10252,3.68237e+13,718.522,7000.43,34778,522,358,32298,32267,32269,32248,31815
79552,1192,3273,55285,24267,3.58531e+13,1073.25,11331.6,79552,570,495,76055,74370,62914,43613,39449
77760,2066,2895,56126,21634,3.75684e+13,979.039,10883.3,77760,631,534,74865,74809,73883,71785,59621
63853,2370,3248,44652,19201,3.62418e+13,768.134,10516,63853,500,722,60605,60392,60144,60099,51617
66512,32,2754,46039,20473,3.48401e+13,976.006,9648.86,66512,527,477,43413,33666,25972,9716,5214
29101,1325,1565,20908,8193,3.63924e+13,736.109,4970.57,29101,415,296,27536,27518,26924,26309,26274
70056,1125,2745,48739,21317,3.59046e+13,897.399,9432.41,70056,546,443,67311,66017,61104,48786,47411
91863,196,3823,64759,27104,3.66542e+13,805.016,13685.9,91863,510,858,77494,68279,51897,16345,13455
11360,542,1392,7658,3702,3.39993e+13,294.212,3114.22,11360,283,227,9968,9625,8742,7736,6483
58516,1983,2786,41823,16693,3.66846e+13,967.597,9239.46,58516,702,605,55730,55255,51814,44154,48385
80287,251,3696,55717,24570,3.49841e+13,1227.73,12272.4,80287,694,737,70459,64408,42633,14815,10260
34394,695,2197,24075,10319,3.49933e+13,803.535,6295.69,34394,463,367,31739,30592,25039,18939,17085
34197,1177,1925,23401,10796,3.09744e+13,694.074,6004.83,34197,425,416,32272,31880,30697,25325,22407
72817,2973,3325,49691,23126,3.58216e+13,965.992,10783.5,72817,577,653,69492,69428,69322,69147,67046
41099,557,2027,28377,12722,3.56225e+13,554.151,6219.93,41099,393,416,38793,38065,30200,25943,20287
57985,1748,2001,40414,17571,3.29591e+13,948.536,7557.48,57985,458,493,55984,55708,55586,55148,54379
40605,122,2051,27913,12692,3.52242e+13,570.442,5985.23,40605,441,364,32069,27306,20285,7650,6683
99696,1937,4641,69202,30494,3.60732e+13,1041.32,15314.3,99696,690,757,95055,94348,84775,70873,48102
43561,1579,2233,30752,12809,3.74166e+13,815.533,6945.55,43561,526,388,41328,41211,40688,39414,38852
95596,872,3519,66943,28653,3.65998e+13,1049.8,12794.1,95596,523,689,91306,89372,78274,56513,38451
6839,469,779,4661,2178,3.4865e+13,230.79,1838.35,6839,155,171,6060,6049,5976,5960,5210
14851,467,1117,10279,4572,3.13256e+13,402.854,3017.99,14851,235,218,13545,12977,12325,9296,8385
32744,513,2411,22274,10470,3.36658e+13,468.188,6639.36,32744,355,468,30120,28923,22337,16267,12201
32798,793,1944,22694,10104,3.46533e+13,619.659,5961.93,32798,330,372,30545,29302,27876,22575,19284
53740,794,2576,37028,16712,3.39104e+13,766.126,8350.62,53740,501,451,50763,48957,42950,32525,26789
74139,299,3207,52577,21562,3.5563e+13,1159.51,10649.1,74139,625,554,66356,60553,43553,17891,12890
3976,578,777,2891,1085,4.10979e+13,162.156,1400.68,3976,161,123,3199,3157,3177,3166,2803
42530,1419,1974,30052,12478,3.56686e+13,822.902,6655.83,42530,468,364,40556,40305,39670,37858,35657
97002,1553,2962,68916,28086,3.62844e+13,1313.43,12099.9,97002,804,619,93613,92444,87031,77515,53315
62177,475,2994,44800,17377,3.70495e+13,807.511,10073,62177,441,536,57524,55058,48549,36451,21868
77144,2909,3382,54153,22991,3.63441e+13,1188.69,11075.3,77144,612,687,73762,73677,73515,73555,71236
20486,1228,1581,14642,5844,3.82332e+13,575.821,4406.64,20486,340,355,18905,18896,18671,18620,15712
96504,3604,3780,66084,30420,3.43209e+13,1020.46,12830.1,96504,694,515,92724,92702,92667,92667,91771
16410,1308,1495,11470,4940,3.58381e+13,373.557,3795.55,16410,314,262,14915,14911,14881,14893,14184
67840,3283,3675,46913,20927,3.51726e+13,968.395,11376.3,67840,610,698,64165,64160,64000,63689,62294
64765,2198,3002,44704,20061,3.45437e+13,1130.28,10006.4,64765,467,623,61763,61381,61138,59788,53772
59338,1660,1999,41729,17609,3.35031e+13,716.712,7433.69,59338,390,383,57339,57305,57180,57148,55622
70893,965,2724,48140,22753,3.47975e+13,824.754,9295.4,70893,528,541,68057,65945,45900,36544,33541
9091,791,871,6411,2680,3.57505e+13,264.121,2135.48,9091,243,188,8220,8220,8181,8158,8001
16897,1014,1466,11882,5015,3.41553e+13,490.271,3766.56,16897,314,309,15431,15264,15102,14700,12213
22409,790,1527,15754,6655,3.66311e+13,524.194,4435.53,22409,331,263,20863,20195,18046,14705,13616
61115,1808,2066,43796,17319,3.67962e+13,973.455,8165.67,61115,615,404,59049,59047,58988,58986,57997
88815,2524,2683,62289,26526,3.48557e+13,1083.74,10399.8,88815,618,501,86132,86131,86129,86132,85353
36866,972,1745,25372,11494,3.6745e+13,356.595,5402.33,36866,355,274,35121,35060,33875,32712,27723
90959,2806,3785,63363,27596,3.50451e+13,962.896,12874.2,90959,587,659,87174,87116,86452,85813,78285
49761,2164,2860,34524,15237,3.54231e+13,955.766,8617.62,49761,569,399,46901,46715,45439,42921,38078
21910,563,1544,14913,6997,3.45057e+13,503.846,4375.43,21910,319,332,20210,19610,15659,12435,12217
24160,910,1468,17113,7047,3.5044e+13,551.763,4248.16,24160,319,301,22692,22310,21135,19638,18076
89150,858,3189,61754,27396,3.55451e+13,921.687,11158.5,89150,671,647,85182,83873,58406,47325,38809
62567,607,2732,42063,20504,3.48372e+13,678.03,8963.9,62567,438,624,59401,57614,36401,29413,24497
26804,1947,2108,18176,8628,3.48527e+13,506.187,5706.4,26804,363,361,24696,24685,24650,24647,23948
77983,1360,3578,54380,23603,3.58083e+13,1096.5,12061.3,77983,593,626,74202,72600,67828,51929,44749
25863,596,1782,18447,7416,3.62245e+13,505.743,5103.43,25863,418,350,23960,23196,21303,17600,12605
89207,999,3545,62345,26862,3.54137e+13,946.427,12399.5,89207,581,631,85274,83553,72890,50731,39147
51963,90,2999,35632,16331,3.33121e+13,836.257,9060,51963,438,577,42131,35676,25208,8812,6298
22677,1078,1655,15706,6971,3.55796e+13,517.041,4608.88,22677,444,273,21022,20923,19745,18584,16863
37424,213,1921,26340,11084,3.66635e+13,727.107,6210.29,37424,404,400,31370,27661,20685,8243,8262
86797,2881,3745,59137,27660,3.43776e+13,973.612,12456.9,86797,615,676,83052,83031,82380,81173,75300
31918,169,1758,22367,9551,3.53828e+13,509.717,5267.5,31918,374,333,26680,23095,17287,7413,6835
82531,2013,2961,58356,24175,3.66001e+13,1025.1,10664.1,82531,693,482,79570,79229,75017,64705,64428
79720,1521,3356,55328,24392,3.5283e+13,935.158,11278.1,79720,523,577,76364,75775,70354,57036,52542
84724,2850,3392,58504,26220,3.3657e+13,991.438,11408.8,84724,610,667,81332,81317,80561,79006,77157
78817,1331,2980,54399,24418,3.37938e+13,803.575,10370.5,78817,502,596,75837,75367,68640,55856,44653
28076,1953,2029,19421,8655,3.36581e+13,580.87,5648.12,28076,379,404,26047,26042,26029,26038,25593
93432,700,3142,65947,27485,3.66143e+13,1132.54,11736.2,93432,555,518,88414,85716,62668,41859,33378
29096,146,1542,20528,8568,3.60879e+13,552.736,4986.23,29096,385,275,24469,21773,18325,8908,4986
29341,1034,1444,21068,8273,3.67368e+13,623.739,4784.69,29341,326,318,27863,27191,27254,26484,22645
65415,1881,2299,45299,20116,3.40843e+13,865.357,7993.06,65415,574,468,63116,62871,62364,60804,59123
48700,1024,2482,35031,13669,3.61242e+13,865.88,8231.75,48700,613,541,45912,44692,42085,35919,22224
30615,113,1684,22320,8295,3.68852e+13,715.529,5453.73,30615,379,368,24619,21058,16776,6835,4001
99700,2062,3725,68542,31158,3.44601e+13,1052.51,12576.4,99700,693,622,95975,95359,90373,79730,77737
17150,1083,1242,12120,5030,3.87245e+13,590.49,3547.42,17150,312,290,15908,15905,15792,15739,14960
85573,2124,2857,60572,25001,3.67413e+13,892.255,10181.5,85573,656,407,82716,82673,81800,80243,77783
81043,811,2918,55877,25166,3.5398e+13,967.758,10229.4,81043,551,480,77148,74538,54793,38833,39118
75719,1464,3537,53785,21934,3.7083e+13,880.937,11823.3,75719,498,694,72182,71609,69039,65705,41321
5066,366,536,3523,1543,3.40723e+13,266.685,1364.73,5066,193,166,4516,4323,4098,4038,3793
74692,522,3155,52063,22629,3.5839e+13,1037.09,10391.6,74692,611,531,69181,65441,43975,25981,24543
69140,2082,2428,47571,21569,3.4561e+13,930.236,9331.68,69140,522,534,66712,66643,66331,65699,63308
11236,386,1396,8068,3168,3.81846e+13,277.305,3179.18,11236,205,289,9827,9306,8887,8837,3795
55204,1699,2290,38136,17068,3.57115e+13,745.063,7299.99,55204,410,362,52914,52699,52201,51472,47423
91954,1753,3003,64751,27203,3.62889e+13,1224.5,11527.2,91954,575,550,88951,88153,84040,72270,67065
97196,1990,3048,69805,27391,3.68542e+13,1153.4,11699.3,97196,758,559,94148,93952,87316,70973,77848
57030,496,2781,38906,18124,3.45692e+13,989.838,9390.44,57030,448,720,52010,49468,36132,27584,12941
70456,219,1867,48050,22406,3.54012e+13,838.955,7369.25,70456,446,407,62195,53210,37117,13750,12956
73758,1531,2480,51828,21930,3.47751e+13,1101.68,9481.11,73758,643,446,71278,70271,67012,58313,50355
76867,159,3235,53348,23519,3.55117e+13,1031.15,10826.3,76867,621,585,64378,56902,38798,12773,11277
49431,1618,2608,34064,15367,3.5363e+13,683.682,8196.99,49431,522,398,46823,46658,43413,36005,35536
36628,2092,2141,24735,11893,3.14573e+13,439.164,6398.08,36628,339,368,34487,34487,34475,34479,34411
98549,2814,3284,67521,31028,3.53147e+13,891.931,12343.2,98549,543,612,95265,95264,94959,95053,91551
75249,1575,2981,52109,23140,3.6595e+13,912.302,10161.2,75249,457,565,72268,71381,68800,63339,55890
61841,2060,2814,42939,18902,3.58811e+13,1137.67,9461.31,61841,640,522,59027,58482,56680,51792,51091
55236,288,2654,38013,17223,3.68114e+13,814.52,8589.11,55236,481,536,48297,43005,28040,13891,12117
37793,1654,1885,25920,11873,3.43967e+13,524.769,5914.28,37793,397,349,35908,35897,35787,35753,33972
29351,397,1807,20468,8883,3.36393e+13,407.769,5244.6,29351,303,304,27092,25649,19841,15104,12076
57151,1605,3256,38952,18199,3.49515e+13,909.041,9798.04,57151,702,591,53895,53261,48695,42310,39953
67619,1117,2719,47389,20230,3.55851e+13,1123.28,9523.72,67619,596,530,64497,62649,58414,45993,37479
20307,1299,1629,14054,6253,3.20298e+13,327.236,4226.76,20307,274,285,18678,18586,18605,18590,16530
5835,596,962,4190,1645,3.29295e+13,245.155,1935.35,5835,234,189,4873,4855,4572,4182,4095
13797,447,1127,9693,4104,3.74001e+13,473.363,3046.24,13797,272,269,12331,11477,10870,9212,6803
63074,1873,2826,42986,20088,3.51916e+13,929.582,9350.96,63074,435,582,60248,59346,58473,57075,47541
87329,113,2434,61882,25447,3.64407e+13,1279.55,10024.2,87329,655,534,70678,61518,44718,13291,11169
85162,801,2670,59647,25515,3.55243e+13,1125.57,10710,85162,536,524,80868,78464,67083,45536,37065
30324,1443,1972,21079,9245,3.59774e+13,416.358,5736.11,30324,347,401,28352,28341,28108,27780,24291
43047,254,1832,30184,12863,3.74932e+13,734.979,6346.81,43047,464,432,38153,33143,25758,18280,9842
32957,1455,2506,23519,9438,3.58202e+13,638.705,7065.3,32957,421,419,30451,30348,29768,29734,22980
43977,1152,2766,30572,13405,3.48871e+13,822.803,8066.62,43977,537,517,41139,40135,35427,26964,26250
32537,147,2254,22427,10110,3.50506e+13,627.173,6437.04,32537,407,367,26899,23740,17692,6274,4330
84424,2304,3035,58153,26271,3.27011e+13,1049,11108.6,84424,622,653,81389,80879,79294,70221,74156
50147,1597,2112,34383,15764,3.43288e+13,802.492,6876.54,50147,430,424,48035,47931,46720,45187,44533
81654,2757,3600,56284,25370,3.3393e+13,1050.31,12016.1,81654,637,592,78054,78018,76601,72481,67517
21590,889,1321,15566,6024,3.63558e+13,494.984,4066.72,21590,347,283,20269,19969,19030,17755,16306
95568,902,3592,67430,28138,3.72236e+13,1220.95,13085.7,95568,598,614,90716,88527,72918,50141,37346
50592,2006,2654,34906,15686,3.5471e+13,823.246,8253.07,50592,470,456,47938,47802,47542,46950,44141
13607,1268,1494,9401,4206,3.57491e+13,352.679,3467.81,13607,282,251,12113,12075,12062,12034,11427
28334,1805,1944,20332,8002,3.81974e+13,532.318,5530.18,28334,392,376,26390,26387,26376,26220,25697
26983,257,1687,18506,8477,3.60598e+13,453.948,4878.06,26983,313,346,23935,21039,16571,10480,9763
54925,73,2509,38972,15953,3.69971e+13,817.621,8690.89,54925,598,414,41170,34868,26579,9449,5405
33823,631,1869,23848,9975,3.42643e+13,702.461,5847.21,33823,375,395,31488,30019,27495,23182,13355
38649,326,2200,27328,11321,3.78567e+13,689.208,6672.89,38649,546,395,34360,31187,23677,15716,11921
94448,2494,2631,67488,26960,3.7024e+13,1155.96,10397.5,94448,610,590,91817,91815,91743,91651,91151
51834,994,1899,36617,15217,3.70845e+13,861.076,6909.44,51834,479,400,49830,48591,43561,31604,35840
94243,1488,3373,65159,29084,3.53013e+13,1156.25,12315.7,94243,561,561,90837,88705,82909,62198,54070
77931,244,2826,54973,22958,3.63827e+13,1005.02,9776.53,77931,643,513,67591,59376,42584,16901,16263
73310,2047,3294,50761,22549,3.54535e+13,1138.95,11027.5,73310,625,608,70016,69222,66593,62477,57259
98336,492,3560,69447,28889,3.65347e+13,1406.27,13022.3,98336,733,655,90443,85249,56895,30707,27482
69544,1206,3431,46918,22626,3.39862e+13,732.301,10997.8,69544,464,730,66113,65300,60366,53417,32255
69688,211,2684,49179,20509,3.72992e+13,1160.05,9791.45,69688,617,541,59481,52311,38201,13200,13263
94729,134,3380,67317,27412,3.65089e+13,1065.3,12196.9,94729,701,556,76838,65833,49977,14237,11465
62299,209,3366,42341,19958,3.46082e+13,745.359,10686.2,62299,448,625,54378,49826,33029,10543,6966
77056,1884,2766,52709,24347,3.47335e+13,792.579,9567.78,77056,471,479,74290,74232,72171,69530,65203
35071,125,1649,24731,10340,3.68431e+13,536.768,5189.04,35071,386,287,27809,24239,17276,5872,5960
83844,2130,3170,59652,24192,3.64543e+13,1029.26,11181,83844,802,524,80674,80426,76718,67293,71314
29943,696,1702,20812,9131,3.75034e+13,615.876,5308.12,29943,390,426,28104,27264,24075,17301,17250
93272,1453,4868,63747,29525,3.44742e+13,882.321,15026.1,93272,884,690,88404,87151,59064,52445,43001
67657,628,3301,47715,19942,3.65886e+13,1075.21,10592,67657,598,518,62878,60108,44409,30005,23892
77098,1443,3616,52862,24236,3.53281e+13,964.11,11883.9,77098,591,549,73482,72595,59629,46495,42829
29864,1429,2070,21062,8802,3.60602e+13,643.669,5963.26,29864,476,457,27794,27606,27049,25031,24720
95241,257,3251,66883,28358,3.54688e+13,1267.31,12166.1,95241,652,603,83235,74839,52237,17599,16667
32825,23328,32825,0,32825,15.9995,0,32825,32825,32825,1,0,0,0,0,0
76093,878,2933,53469,22624,3.69691e+13,1012.89,10233.2,76093,507,537,72551,71052,59679,42240,34211
84172,1248,2962,58971,25201,3.42192e+13,1106.44,10249,84172,631,446,80882,79907,67075,42805,45424
20368,543,1845,14795,5573,3.76907e+13,459.029,4670.48,20368,415,339,18370,17513,16585,14413,7054
59450,738,1942,42486,16964,3.68572e+13,840.376,7426.6,59450,488,385,57080,54546,49278,34709,31423
12383,248,1380,8973,3410,3.8024e+13,375.05,3297.17,12383,250,277,10449,9559,8768,7416,3672
87479,1810,2802,59777,27702,3.28625e+13,1001.44,10945.5,87479,477,480,84677,84236,83095,80671,73029
48857,424,1962,33601,15256,3.47047e+13,548.077,6757.36,48857,459,331,45984,42722,28112,20021,16467
11701,532,1312,8181,3520,3.60271e+13,334.861,3046.09,11701,271,210,10358,9881,9276,8100,6420
27360,263,1871,18869,8491,3.60109e+13,493.098,5497.4,27360,370,331,24103,21587,16429,10220,7677
74722,2435,2678,52614,22108,3.40385e+13,1016.21,9662.54,74722,648,488,72044,72044,71963,71964,70697
15079,1628,1759,10567,4512,3.68261e+13,296.616,4052.98,15079,346,288,13320,13319,13295,13305,12974
60102,302,2358,41240,18862,3.37661e+13,1043.52,8603.26,60102,580,437,53449,49894,36340,15264,14508
6333,918,1044,4595,1738,3.78073e+13,198.024,2066.22,6333,179,174,5289,5279,5289,5289,5023
62267,2127,2426,43605,18662,3.38325e+13,1072.72,8709.06,62267,460,466,59841,59508,59721,59638,57271
46487,1548,2736,32598,13889,3.37531e+13,789.421,8051.19,46487,550,460,43751,43022,42127,37661,34619
12392,142,1073,8694,3698,3.583e+13,332.88,2814.4,12392,245,270,9965,8452,6369,2738,1842
67306,370,2731,46802,20504,3.46753e+13,860.501,9563.57,67306,476,495,60912,56641,41535,25370,18415
73191,1194,2992,50888,22303,3.3933e+13,900.279,10341.9,73191,489,499,69990,68726,64383,48333,40460
68098,1867,2764,46637,21461,3.33348e+13,1000.96,9869.18,68098,484,604,65334,64912,64050,63102,49014
70434,3166,3279,50291,20143,3.61702e+13,1153.99,11136,70434,631,677,67155,67124,67047,67011,66801
42039,800,2049,28921,13118,3.54427e+13,721.655,6645.05,42039,388,386,39690,38770,35782,27698,25408
1653,300,351,1170,483,3.61152e+13,137.684,646.35,1653,87,82,1302,1223,1267,1284,1237
23706,1220,2078,16432,7274,3.56553e+13,488.636,5380.12,23706,431,401,21628,21496,20782,19035,16750
67930,1608,2562,47459,20471,3.46178e+13,865.173,9359.86,67930,593,464,65368,65167,61431,49458,50318
33077,971,1219,23722,9355,3.80635e+13,655.8,4549.39,33077,382,297,31858,31816,31212,31074,29847
24307,1333,1933,16956,7351,3.71198e+13,454.844,5311.26,24307,335,451,22374,22347,21908,21583,17851
4567,537,672,3255,1312,3.72664e+13,193.104,1406.59,4567,131,132,3895,3878,3865,3882,3598
44394,944,2014,30930,13464,3.42005e+13,1033.15,6805.71,44394,418,385,41856,40954,37636,31942,23427
89695,1337,3213,61518,28177,3.43988e+13,1179.89,11968.1,89695,773,638,86131,84508,75002,52193,48862
15071,102,1563,10449,4622,3.69009e+13,267.004,3800.65,15071,226,295,12120,10581,7559,3295,2252
24341,1336,1705,17513,6828,3.72889e+13,627.193,5021.16,24341,446,350,22636,22420,21908,21395,20034
46243,1186,2378,32187,14056,3.32704e+13,677.52,7691.19,46243,369,543,43865,43564,43055,42500,29493
52078,219,2499,35517,16561,3.51924e+13,1035.37,8216.07,52078,530,470,44587,39425,24516,9242,10056
15863,1213,1266,10903,4960,3.56022e+13,378.814,3437.41,15863,265,331,14597,14597,14589,14582,14512
13661,833,1229,9749,3912,3.72055e+13,509.322,3236.59,13661,365,281,12432,11977,11811,11443,10606
57528,1999,2244,39461,18067,3.6281e+13,548.268,7008.85,57528,390,331,55284,55279,55165,55101,54060
14437,770,1089,10179,4258,3.79051e+13,522.637,3064.6,14437,281,231,13348,13084,12681,11929,11574
56876,2039,2094,40636,16240,3.64006e+13,906.869,7730.05,56876,481,449,54782,54782,54765,54761,54568
5075,488,503,3414,1661,2.91478e+13,206.33,1251.82,5075,105,117,4572,4572,4572,4572,4563
7067,352,836,4825,2242,3.53732e+13,233.824,1966.08,7067,230,216,6230,5982,5620,4987,3499
63443,2611,3222,44101,19342,3.59853e+13,703.464,10091.1,63443,626,472,60221,60215,58975,56639,55235
95809,498,3633,68358,27451,3.48069e+13,1130.82,13182.6,95809,794,537,88861,84944,59301,35941,24595
10395,571,907,6924,3471,3.38491e+13,300.329,2351.35,10395,198,169,9488,9315,8820,7949,6689
83534,1526,2981,58036,25498,3.57958e+13,1074.75,11209.5,83534,652,531,80553,79771,74138,61003,51439
63331,274,3205,44895,18436,3.74001e+13,750.603,10227.6,63331,498,631,55847,50398,35664,14380,11223
5270,11,622,3594,1676,3.40934e+13,293.539,1534.22,5270,193,175,2489,1619,1383,1070,522
41706,173,2083,29413,12293,3.39613e+13,825.572,6726.89,41706,407,363,36190,33334,23094,8552,7005
32005,133,2024,22342,9663,3.46142e+13,589.983,6002.57,32005,360,401,26667,23694,17539,7312,4161
66567,411,1682,46422,20145,3.10118e+13,894.956,7004.27,66567,491,342,61943,59396,48620,35074,22163
1577,143,231,1005,572,2.72247e+13,93.5866,512.803,1577,81,75,1346,1207,1203,1065,1187
38506,990,2066,27410,11096,3.63882e+13,625.795,6441.51,38506,425,347,36353,35712,33577,28459,22965
35045,1979,2120,25378,9667,3.69718e+13,752.534,6365.36,35045,501,381,32925,32925,32893,32768,31880
53875,1802,2013,37344,16531,3.15981e+13,637.648,6902.22,53875,410,398,51862,51862,51801,51809,51241
16882,548,1287,11602,5280,3.44774e+13,450.469,3513.01,16882,317,269,15538,15003,11521,8725,9549
8578,768,919,6052,2526,3.49175e+13,238.716,2143.42,8578,234,161,7659,7659,7602,7323,7410
58574,276,3037,40303,18271,3.41419e+13,692.265,9674.27,58574,476,654,52583,47808,30529,11126,9809
29576,765,1487,20958,8618,3.42505e+13,647.112,4802.46,29576,339,290,27914,27101,26541,24466,18356
19419,308,2118,13604,5815,3.44449e+13,385.65,4882.51,19419,458,251,16875,15698,9780,4558,2713
13661,133,1207,9727,3934,3.71224e+13,304.48,3116.8,13661,247,302,11295,9830,8121,6062,2444
38227,448,2006,26924,11303,3.68837e+13,635.023,6493.23,38227,458,359,34917,33043,25862,17723,15174
87578,545,3579,60804,26774,3.50214e+13,1268.23,12224.3,87578,703,621,81303,77864,52792,34996,27835
3339,172,599,2375,964,3.58746e+13,165.855,1162.11,3339,143,110,2681,2435,2255,2092,912
8422,129,690,5671,2751,3.49355e+13,315.111,1917.46,8422,190,196,6598,5793,4515,2692,2746
82897,2151,3275,57659,25238,3.44286e+13,829.848,11098.7,82897,727,437,79622,79554,76044,64913,61218
68086,2074,2513,47506,20580,3.48802e+13,1006.56,9233.42,68086,652,487,65573,65554,65247,64411,63131
22562,1477,1746,15638,6924,3.66694e+13,416.528,4591.14,22562,321,389,20816,20799,20505,19987,19348
61204,1922,3313,42433,18771,3.58252e+13,705.479,9988.35,61204,629,521,57891,57601,52968,41404,40300
69583,1070,2550,49195,20388,3.66066e+13,772.134,9015.86,69583,544,390,67033,65803,63918,57457,50999
17111,350,1602,11706,5405,3.432e+13,418.322,4130.91,17111,333,295,15134,14199,11070,9347,5835
55611,2528,3222,39272,16339,3.69686e+13,967.63,9561.3,55611,478,560,52389,52076,52122,51237,47785
45574,2234,2676,31453,14121,3.49347e+13,973.544,8118.13,45574,425,456,42898,42334,42513,42071,40189
10400,318,1434,7431,2969,3.86263e+13,221.782,3052.88,10400,199,288,8966,8415,8096,8131,3010
15754,886,1404,10678,5076,3.48298e+13,447.35,3769.41,15754,319,402,14350,14114,13533,12375,11988
1048,198,336,845,203,2.95462e+13,35.6498,508.949,1048,67,58,712,707,703,701,563
21262,1595,1608,14807,6455,3.2582e+13,466.489,4267.17,21262,324,325,19654,19654,19653,19654,19634
1053,285,300,749,304,3.58236e+13,91.5793,475.457,1053,96,68,753,731,752,747,752
2972,223,439,2019,953,3.31052e+13,208.126,974.441,2972,126,127,2437,2160,2085,2014,1570
60329,1504,3440,41535,18794,3.56315e+13,763.363,9933.75,60329,568,457,56889,56388,47660,37756,35567
9931,1279,1300,7152,2779,3.43915e+13,268.622,2902.94,9931,270,228,8631,8631,8631,8631,8610
24137,194,1740,16750,7387,3.28207e+13,398.977,4629.86,24137,325,245,21086,19112,13270,8905,2580
53852,2375,2504,38168,15684,3.65199e+13,861.985,8189.51,53852,508,461,51348,51348,51323,51319,50769
90225,296,2306,65243,24982,3.68695e+13,1214.22,10128.8,90225,602,561,81747,73425,56579,29219,19991
35227,713,1768,24142,11085,3.48551e+13,493.391,5526.88,35227,368,417,33459,32897,31115,28346,18219
87310,1914,3247,59459,27851,3.48282e+13,833.715,11337.2,87310,527,615,84063,83805,80317,73389,62168
19663,648,1551,14220,5443,3.68224e+13,571.923,4133.83,19663,369,243,17976,17245,16290,14185,9197
33046,1165,1807,21867,11179,3.32418e+13,821.893,5857.54,33046,405,479,31239,30602,29201,23765,26727
70358,739,2832,49411,20947,3.66738e+13,932.509,9812.47,70358,623,510,66529,63068,48883,35526,30223
31744,958,2339,21843,9901,3.50377e+13,616.061,6471.43,31744,419,507,29403,28588,26764,22443,13724
48913,627,2740,34348,14565,3.63264e+13,869.685,8457.47,48913,487,464,45316,43746,34731,25228,17706
36668,1690,2096,25462,11206,3.63438e+13,690.616,6429.16,36668,499,511,34572,34507,33816,32043,32718
62278,2323,3517,42728,19550,3.52709e+13,831.671,10373.8,62278,611,477,58761,58668,56619,51921,48874
25779,249,1858,18017,7762,3.42509e+13,682.777,5257.32,25779,402,384,22127,20439,14428,5946,4295
66534,3014,3213,45883,20651,3.35465e+13,845.396,10084.9,66534,540,485,63321,63275,63265,63280,62366
82408,2126,3554,56737,25671,3.41223e+13,818.059,11921,82408,640,524,78854,78635,74052,59875,57150
83391,169,2872,59701,23690,3.74e+13,1235.33,11057,83391,592,569,70113,61901,47507,14603,13539
69040,586,2551,47720,21320,3.47925e+13,976.366,9168.57,69040,524,385,65065,62411,41416,30141,20376
17571,1423,1607,12760,4811,3.80249e+13,437.119,4140.36,17571,316,248,15964,15960,15921,15923,15398
50850,2008,2111,35084,15766,3.24857e+13,754.982,7127.6,50850,446,401,48739,48739,48712,48708,48308
38959,832,2169,27152,11807,3.4589e+13,719.673,6715.38,38959,366,496,36482,34854,32802,27976,20931
76348,3201,3309,52472,23876,3.47968e+13,753.383,10620.5,76348,609,428,73039,73039,72978,72966,72608
99538,123,3366,70478,29060,3.62953e+13,1216.59,12486.7,99538,699,673,79408,68997,51213,15974,10342
3500,205,564,2522,978,3.79665e+13,153.092,1139.21,3500,134,126,2875,2638,2633,2692,1354
71074,886,2331,50871,20203,3.68386e+13,908.597,8866.18,71074,512,507,67953,65352,60659,54745,31743
92873,895,3455,65120,27753,3.52644e+13,972.848,11693.3,92873,610,515,88706,86173,62745,46433,35733
72423,1880,2828,50189,22234,3.55116e+13,1079.86,9790.32,72423,604,499,69595,69503,65850,60997,59876
92728,3270,3295,64684,28044,3.62802e+13,1543.96,12300.8,92728,681,594,89433,89433,89426,89433,89421
98777,823,3337,68875,29902,3.60918e+13,1319.99,11883.1,98777,639,540,93825,91307,64370,46641,41777
11376,105,1270,8218,3158,3.74537e+13,256.91,2948.95,11376,267,280,8960,7634,6301,3471,1806
77439,834,2481,53653,23786,3.48134e+13,986.873,9568.77,77439,548,523,74066,72200,60808,40689,32357
32596,1446,2266,22533,10063,3.54384e+13,668.596,6438.61,32596,382,407,30330,30195,29535,28889,25551
81329,1575,2360,56293,25036,3.23361e+13,1032.34,9427.87,81329,538,476,78969,78377,75978,69904,66870
90842,9389,90842,0,90842,15.9998,0,90842,90842,90842,1,0,0,0,0,0
26313,1436,1515,18352,7961,3.65321e+13,608.448,4684.08,26313,372,317,24798,24798,24790,24783,24650
64626,926,2677,45140,19486,3.5957e+13,853.584,9184.78,64626,480,496,61657,60353,54374,44448,31082
66655,1515,2145,48310,18345,3.53352e+13,998.552,8667.67,66655,671,461,64510,64303,63300,61987,55441
5356,687,852,3843,1513,3.70287e+13,192.403,1708.69,5356,179,133,4504,4493,4489,4479,4168
89221,1494,3297,62393,26828,3.64609e+13,1065.45,11100.5,89221,599,519,85924,84563,74980,58227,59084
35441,917,1031,24257,11184,3.57543e+13,494.046,4430.17,35441,304,330,34410,34410,34279,34242,33491
37320,636,2388,25791,11529,3.41642e+13,652.92,7004.56,37320,414,369,34519,33240,25502,18358,13265
59024,1064,2588,41419,17605,3.62873e+13,856.628,8571.12,59024,467,523,56364,54942,50744,43534,33593
82214,663,3233,56648,25566,3.39932e+13,889.826,11029.1,82214,563,719,78008,76070,53406,40884,30985
86421,2569,3382,58948,27473,3.33093e+13,1298.53,11858,86421,657,580,83039,82987,81841,79124,76184
81227,465,2882,56258,24969,3.36144e+13,1054.24,10679.8,81227,635,461,75623,72106,47393,31202,17103
52347,1934,2012,35933,16414,3.57447e+13,676.787,6788.27,52347,395,366,50335,50335,50333,50335,50237
23817,1684,1704,16470,7347,3.26158e+13,500.876,4766.02,23817,382,299,22113,22113,22113,22113,22081
72308,1421,2952,50475,21833,3.54917e+13,936.016,9992.26,72308,616,527,69356,68525,64163,52868,51385
67676,1111,3671,46393,21283,3.52574e+13,896.801,11291.6,67676,540,572,63905,62858,46602,36500,28710
38704,478,2806,26335,12369,3.47088e+13,668.901,7751.5,38704,571,490,35026,33598,24042,16874,11197
29107,1505,2360,20062,9045,3.37146e+13,418.393,6244.69,29107,301,570,26747,26717,26370,26412,20865
80143,2642,3314,55124,25019,3.43075e+13,905.924,11052.2,80143,495,513,76829,76742,76434,75797,67724
32127,1342,1706,22413,9714,3.58262e+13,587.759,5421.73,32127,454,340,30421,30377,29787,29099,28406
48864,1382,2090,34540,14324,3.60736e+13,858.853,6909.61,48864,530,428,46774,46385,44024,40583,40659
98626,2291,2454,70502,28124,3.67868e+13,1038.42,10845.5,98626,751,465,96172,96171,95831,95310,94197
50859,1265,2729,35368,15491,3.56184e+13,759.503,8673.36,50859,446,515,48130,47333,45519,42438,28617
59702,731,2740,42039,17663,3.71969e+13,1108.13,9068.48,59702,597,525,55425,53649,38311,28489,24782
23076,1110,1387,16569,6507,3.84993e+13,643.906,4118.13,23076,326,300,21689,21300,21423,21109,19586
27517,1509,1746,19727,7790,3.77558e+13,628.008,5031.5,27517,414,266,25771,25771,25701,25737,25163
94463,255,3067,66707,27756,3.62025e+13,895.517,11818.9,94463,543,635,84478,74886,55078,19389,17246
37045,1145,1697,25995,11050,3.59869e+13,503.027,5547.84,37045,480,350,35348,35289,33098,31404,29350
42153,755,2687,28722,13431,3.43974e+13,649.895,7745.88,42153,388,481,39216,38098,29666,21334,15977
79591,2763,2776,56416,23175,3.58121e+13,995.03,10575.1,79591,710,449,76815,76815,76815,76815,76802
27786,948,2027,19298,8488,3.74103e+13,695.879,5712.48,27786,385,402,25664,24998,23369,19598,18498
1471,165,329,1108,363,4.3819e+13,79.7675,561.427,1471,121,55,1142,1103,1062,1067,753
48256,1831,2638,33534,14722,3.54555e+13,828.415,8210.07,48256,452,509,45618,45557,44589,42816,39144
80456,2215,3435,56829,23627,3.6121e+13,1219.01,11748.3,80456,611,578,77021,76428,71843,58080,61508
27764,833,2026,19313,8451,3.45635e+13,556.553,5706.2,27764,373,336,25716,25102,23837,19983,15443
79134,2106,3143,54155,24979,3.47636e+13,1199.34,11109.6,79134,565,725,75991,75506,73675,69076,61507
26486,537,1507,18869,7617,3.72845e+13,603.214,4695.65,26486,381,290,24492,23448,21793,15199,12946
80537,1404,3037,55786,24751,3.43364e+13,863.825,10115.3,80537,637,487,77500,76909,68934,57309,55170
62997,2225,2271,42965,20032,3.50175e+13,643.89,8328.79,62997,447,489,60726,60726,60703,60722,60685
77459,123,3057,53841,23618,3.58519e+13,1151.59,10599.5,77459,695,512,61681,52913,39917,13106,9066
76143,1980,2930,53226,22917,3.49619e+13,1202.83,10384,76143,598,561,73213,72343,70283,65136,60347
38942,76,2689,27158,11784,3.47808e+13,612.867,7466.2,38942,446,561,29211,24764,17814,5861,3210
41583,1505,1826,29289,12294,3.65488e+13,673.565,5988.45,41583,465,361,39757,39643,39570,39153,38625
34736,305,2198,24181,10555,3.5086e+13,593.621,6615.52,34736,440,337,30839,28390,20599,14999,7247
9303,366,825,6125,3178,3.25443e+13,200.558,2162.52,9303,185,203,8478,8422,7717,6735,4140
7954,373,1004,5716,2238,3.70373e+13,219.17,2172.36,7954,257,134,6950,6726,6539,5259,4863
70593,340,2688,49047,21546,3.5642e+13,1080.86,9187.54,70593,565,466,63943,58190,38055,15597,17958
83017,2548,3272,57588,25429,3.52706e+13,859.072,11744.7,83017,495,611,79745,79708,79439,79517,74703
70453,1619,3193,49322,21131,3.6064e+13,775.319,10726,70453,517,659,67260,67040,65376,62314,47347
5688,293,459,3963,1725,3.74721e+13,240.425,1246.64,5688,140,139,5220,4451,4662,4783,4212
54913,1062,2131,38599,16314,3.71948e+13,727.076,7482.5,54913,545,397,52782,52122,47270,37587,35842
62300,1148,2657,43672,18628,3.47769e+13,857.943,9002.89,62300,648,408,59521,58525,53441,40920,37556
95099,829,2874,65506,29593,3.41915e+13,1114.36,10891.5,95099,566,554,91136,89302,70889,50251,42902
73148,850,3099,49419,23729,3.47174e+13,793.926,10453.2,73148,493,597,69445,67314,52442,40534,30109
33646,1892,2513,23788,9858,3.47624e+13,625.598,6784.45,33646,391,410,31133,31078,30819,30601,26397
81441,1718,2735,56511,24930,3.43944e+13,998.941,9988.16,81441,620,494,78706,78083,74935,64972,66698
9571,44,1165,6740,2831,3.30875e+13,281.075,2647.49,9571,211,226,6599,5079,4057,2089,865
72413,681,2416,49410,23003,3.41117e+13,1009.15,9288.05,72413,555,541,68223,65577,46298,32894,33414
70880,2016,3526,49377,21503,3.56286e+13,800.174,11106.1,70880,518,728,67354,67269,65198,64196,52432
52557,1251,2609,37177,15380,3.64968e+13,818.721,8283.96,52557,560,386,49948,48997,45000,33545,33686
83431,2667,3149,59460,23971,3.7329e+13,1260.84,11389.4,83431,806,664,80282,79981,79554,78813,76465
88696,1296,3666,62329,26367,3.52028e+13,855.102,12621.2,88696,501,789,85030,83993,79943,76992,37956
24212,1786,1982,17193,7019,3.60227e+13,518.908,5271.94,24212,357,337,22230,22229,22187,22125,21696
17112,40,1724,12235,4877,3.7635e+13,536.843,4231.63,17112,349,346,11788,9735,6846,2210,1470
41432,620,2338,28864,12568,3.5588e+13,580.179,7062.73,41432,493,388,38512,37013,26865,21182,14903
4837,327,616,3258,1579,3.04656e+13,109.082,1362.18,4837,123,123,4221,4187,3748,2709,2308
83130,1995,4289,57346,25784,3.49355e+13,1065.24,13768.4,83130,694,734,78841,78002,73845,65863,43565
60774,2050,2098,41806,18968,3.13897e+13,1019.39,7812.74,60774,451,430,58676,58676,58676,58676,58433
14276,1244,1348,9906,4370,3.3518e+13,402.785,3425.18,14276,281,364,12928,12924,12919,12891,12242
9346,603,1195,6639,2707,3.85685e+13,263.803,2653.7,9346,227,210,8151,7995,7893,7924,5943
62603,1939,2791,43680,18923,3.39005e+13,965.044,9255.09,62603,561,476,59812,59426,57669,55131,44099
66407,2353,2881,46649,19758,3.69008e+13,878.663,9802.99,66407,538,456,63526,63523,63021,62212,57006
53273,1905,2517,37225,16048,3.66503e+13,886.286,8475.1,53273,719,523,50756,50476,48026,43231,44803
88025,2349,3144,62992,25033,3.67949e+13,1121.66,11726.5,88025,801,501,84881,84715,83471,80503,77363
4524,632,773,3282,1242,3.84262e+13,166.913,1509.79,4524,183,116,3751,3703,3742,3734,3471
48713,415,2516,35236,13477,3.73266e+13,787.335,8141.04,48713,603,512,44775,42439,32733,23421,14263
18055,41,1636,12349,5706,3.55572e+13,386.698,4176.1,18055,339,294,12190,9764,7269,3740,1811
68703,1511,3095,47272,21431,3.54075e+13,1072.22,10530.8,68703,547,593,65608,64138,61406,53426,49369
7233,395,741,4939,2294,3.45488e+13,356.915,1928.6,7233,222,204,6356,6143,5816,5183,4247
78674,1382,3058,55863,22811,3.64964e+13,1160.42,10683,78674,637,514,75504,73389,67650,47585,52918
55696,872,3464,37291,18405,3.37189e+13,637.745,9786.39,55696,598,365,52010,51169,36997,25517,19210
79484,1017,1883,55393,24091,3.1896e+13,947.896,8089.97,79484,533,461,77378,74197,71537,54550,54865
69382,1811,3672,48934,20448,3.56153e+13,708.349,11490.6,69382,518,712,65710,65356,64476,62809,45632
38787,801,1268,26383,12404,3.48198e+13,483.517,4713.86,38787,321,318,37519,37379,34663,32214,29922
34197,709,1647,23765,10432,3.21221e+13,867.682,5423.29,34197,387,342,31922,31077,29567,25937,18004
9005,567,778,6198,2807,3.62785e+13,358.749,2058.54,9005,209,195,8227,8206,7921,7756,7383
20184,132,1311,14090,6094,3.59998e+13,400.008,3768.92,20184,256,257,16120,14109,11219,5894,4165
18345,413,1409,12469,5876,3.14941e+13,394.853,3762.26,18345,234,294,16759,16036,14891,13384,6740
84816,2843,3790,58544,26272,3.5059e+13,1081.3,12371.8,84816,602,654,81026,80973,79803,78246,74519
6307,240,662,4142,2165,3.2189e+13,264.536,1657.87,6307,170,155,5508,5165,4847,4291,2457
8826,68,1115,6345,2481,3.90866e+13,230.881,2460.09,8826,206,233,6691,5785,4686,4082,782
23196,740,1666,15930,7266,3.39274e+13,563.877,4708.06,23196,369,334,21443,20986,18648,14305,12753
18519,850,1229,12864,5655,3.5962e+13,376.079,3424.93,18519,233,280,17290,17284,17143,16844,14911
18337,742,1721,12560,5777,3.29146e+13,314.868,4210.49,18337,336,243,16616,16468,13933,10780,8826
91287,2305,2977,63003,28284,3.50802e+13,979.915,11130.4,91287,588,422,88310,88290,87051,85368,82286
78620,1321,2303,56223,22397,3.59505e+13,1181.37,9843.09,78620,676,524,75951,74249,71508,60559,52212
42342,75,2457,28809,13533,3.49252e+13,767.41,7542.25,42342,522,493,31390,26624,18259,7665,3606
29894,64,1710,20537,9357,3.28864e+13,705.061,5281.26,29894,329,449,23451,18700,13936,4088,3524
83124,2007,3157,57478,25646,3.46471e+13,893.785,10637,83124,571,547,79967,79772,76765,70366,64468
24526,20,1749,16912,7614,3.43765e+13,547.542,4940.73,24526,313,310,14139,9823,8039,4267,1598
33664,2210,2441,23523,10141,3.46023e+13,605.492,6746.27,33664,451,562,31223,31221,31148,30999,29967
70155,796,3000,48892,21263,3.49823e+13,795.53,10033.2,70155,525,492,66582,64257,53903,37699,31550
68981,468,2151,49469,19512,3.6875e+13,1029.75,8437.87,68981,625,477,63679,60494,47607,32123,24412
72979,1290,2797,50527,22452,3.59881e+13,799.418,10032.7,72979,572,488,70182,69477,61482,46027,42644
36427,821,2192,25978,10449,3.6331e+13,616.571,6717.26,36427,391,364,34164,33397,31679,27478,18579
32285,713,1921,22198,10087,3.33467e+13,670.724,5814.51,32285,444,366,30097,29096,26009,20428,18178
47743,2316,2880,33040,14703,3.4012e+13,759.464,8620.67,47743,436,466,44863,44840,44511,44421,41689
10023,17,941,6762,3261,3.55311e+13,383.78,2518.57,10023,239,291,5441,3754,3056,1481,872
85297,1705,3100,59977,25320,3.48385e+13,1273.61,11200,85297,660,539,82197,80950,75718,61726,62460
34421,1395,1914,24761,9660,3.72382e+13,673.14,6069.01,34421,388,360,32507,32479,32295,32114,29204
94264,1359,2725,67713,26551,3.73769e+13,1069.48,10982,94264,649,489,91539,90837,85995,71198,67516
37449,1271,2214,26121,11328,3.42041e+13,732.696,6663.74,37449,469,414,35235,34567,33102,28426,25298
18078,145,1136,12371,5707,3.26183e+13,388.593,3367.87,18078,230,265,15689,14495,10540,7032,3802
76827,1806,3300,53995,22832,3.6076e+13,1081.64,11328.7,76827,736,581,73527,72855,69322,60613,55560
75496,1101,2553,52813,22683,3.64243e+13,1009.95,9387.25,75496,514,457,72581,70955,63603,47107,44150
28293,1239,2349,19744,8549,3.63126e+13,616.116,6181.85,28293,386,370,25944,25567,24091,20316,17269
45145,780,2748,31446,13699,3.57475e+13,671.206,8339.32,45145,440,546,42142,40805,36394,27634,18651
12891,846,1010,8866,4025,3.34349e+13,500.645,2824.04,12891,236,250,11881,11411,11762,11672,10625
71022,646,3823,49977,21045,3.53982e+13,833.037,11905.2,71022,569,661,65886,62877,47373,32998,18740
39827,1491,2051,28630,11197,3.74084e+13,645.477,6657.55,39827,524,319,37776,37667,37175,36453,34041
33278,5490,33278,0,33278,15.9995,0,33278,33278,33278,1,0,0,0,0,0
87371,2252,3884,59745,27626,3.46897e+13,1040.4,12786.1,87371,824,628,83487,83254,78012,64618,66178
12802,1337,1371,9350,3452,3.72178e+13,306.014,3261.2,12802,320,210,11431,11431,11431,11431,11371
40309,160,2126,28147,12162,3.56814e+13,779.833,6844.94,40309,460,350,33339,28639,20998,8562,7059
13203,918,1294,9545,3658,3.61746e+13,372.468,3174.42,13203,324,241,11909,11775,11607,11180,10108
42257,1517,2425,29458,12799,3.65267e+13,741.182,7329.88,42257,457,481,39832,39561,38411,36132,32628
19108,1156,1172,12741,6367,3.29488e+13,482.6,3545.64,19108,255,325,17936,17936,17930,17928,17909
65842,1119,2932,45563,20279,3.43522e+13,979.415,9991.43,65842,518,506,62675,61216,56782,45850,34307
1490,50,438,1000,490,3.35339e+13,65.9262,700.004,1490,108,98,985,817,656,557,290
87232,436,2250,61016,26216,3.44225e+13,1098.46,9297.77,87232,563,442,81334,77445,57494,37731,24238
75619,2767,3883,52404,23215,3.51561e+13,1180.66,11979.4,75619,593,696,71736,71561,70113,67554,58052
39561,1534,2175,27821,11740,3.51744e+13,578.525,6727.08,39561,344,484,37386,37327,37059,36954,32167
67625,813,3670,46268,21357,3.44096e+13,872.333,11384.5,67625,726,673,63217,60974,39865,33656,23556
67610,1235,3365,48161,19449,3.62139e+13,1069.16,11064.2,67610,546,562,63826,62287,59094,46965,36967
55021,3290,3397,38202,16819,3.58337e+13,791.927,9898.89,55021,475,470,51624,51624,51618,51620,51387
39960,1176,2179,27944,12016,3.4824e+13,716.064,6537.67,39960,387,373,37781,37246,35585,28758,27158
99963,3067,3093,69829,30134,3.52213e+13,1245.27,12090.3,99963,626,531,96870,96870,96870,96870,96807
98963,1452,3285,69340,29623,3.50272e+13,1169.09,12388.7,98963,523,631,95473,94040,86264,68182,61145
79607,144,2519,54671,24936,3.54314e+13,981.927,9347.28,79607,620,558,64461,55564,39539,15042,14293
76237,2577,3892,52704,23533,3.3264e+13,939.03,12304.6,76237,515,832,72345,72296,71475,71189,58216
3700,416,656,2485,1215,3.27163e+13,160.474,1296.12,3700,146,128,3044,2976,2885,2658,2521
86059,503,3933,60128,25931,3.6478e+13,954.106,12603.9,86059,539,573,79300,74610,51292,27242,22776
14128,165,1102,9996,4132,3.68778e+13,410.896,3048.25,14128,250,235,11677,10347,8335,6666,3681
33259,2035,2365,23029,10230,3.47373e+13,607.149,6718.24,33259,427,410,30894,30887,30754,30490,29717
47509,1718,2202,32450,15059,3.28006e+13,550.342,7000.34,47509,360,381,45307,45299,45163,45161,40688
28459,1298,1732,19142,9317,3.46661e+13,481.192,5148.01,28459,306,400,26727,26718,26485,26367,24246
28444,702,1905,20248,8196,3.34715e+13,608.103,5326.08,28444,382,261,26346,25672,24336,15779,12532
88682,1287,3199,62404,26278,3.67322e+13,1099.63,11289.7,88682,654,528,85374,83569,68665,47769,42623
83910,1077,2821,58704,25206,3.49685e+13,1086.24,10311.8,83910,605,514,80545,78989,70253,52684,45703
94388,1750,3775,64189,30199,3.48336e+13,963.536,12265.2,94388,574,661,90613,89952,81307,68528,59730
20637,282,1641,14209,6428,3.58758e+13,469.925,4368.19,20637,280,375,18296,16259,12722,8677,7717
78464,1091,2480,54403,24061,3.58819e+13,863.338,9575.06,78464,577,486,75940,74715,67073,51006,47709
82192,1098,3341,56604,25588,3.59457e+13,964.671,11077.6,82192,550,533,78691,77505,58342,46785,41636
14134,199,1302,9966,4168,3.64221e+13,460.279,3253.26,14134,265,248,12096,11138,8508,5967,3765
90472,1457,3672,62642,27830,3.50383e+13,1155.52,12332.9,90472,633,549,86513,85521,76662,56202,46799
87296,2305,3238,60988,26308,3.60196e+13,948.59,11639.9,87296,743,423,84058,84033,80834,73825,74746
19528,1018,1304,13911,5617,3.66769e+13,523.14,3897.28,19528,298,268,18224,18209,18138,18115,17252
34864,806,1870,24050,10814,3.56648e+13,586.191,5799.74,34864,440,321,32863,32145,28119,22507,21637
43612,107,2257,29727,13885,3.43174e+13,499.435,6923.68,43612,519,340,34773,29918,18928,7758,5699
79178,2420,3220,54439,24739,3.54789e+13,888.357,10984.4,79178,574,564,75958,75952,74877,73769,66569
13535,478,1094,9151,4384,3.48593e+13,358.48,2973.19,13535,233,218,12425,11994,10836,8388,8537
93087,3551,3693,65560,27527,3.63221e+13,1264.6,13056.8,93087,663,673,89394,89394,89322,89382,89014
58130,2399,2636,40210,17920,3.53577e+13,942.769,8767.22,58130,533,438,55494,55484,55168,54945,54029
58517,1006,2973,40990,17527,3.64586e+13,765.179,8985.28,58517,487,444,55372,54476,45881,35455,31368
69363,370,3098,48351,21012,3.53154e+13,895.941,9773.45,69363,493,435,63493,59329,38500,22007,15350
3046,579,729,2032,1014,3.77499e+13,83.1507,1224.32,3046,227,107,2317,2308,2244,1943,1981
24910,1108,1755,17165,7745,3.25999e+13,715.256,4851.38,24910,346,343,23155,22780,22661,21989,19069
95714,2529,3072,67115,28599,3.3761e+13,922.794,11493.9,95714,741,429,92642,92622,92074,91332,87411
9371,174,811,6323,3048,3.48176e+13,257.607,2155.48,9371,168,194,8010,6981,4991,3931,2875
12343,713,1152,8786,3557,3.68597e+13,350.024,2956.29,12343,260,225,11191,10972,10487,9333,8225
98437,3591,3951,67795,30642,3.51922e+13,1002.81,12952.1,98437,742,625,94486,94200,93849,92357,92074
26841,1597,1782,18702,8139,3.46469e+13,535.838,4901.47,26841,340,294,25059,24987,25020,25026,24566
67526,1782,3086,46827,20699,3.44516e+13,948.705,10156.8,67526,652,449,64440,63949,62159,56885,51118
42054,1431,2321,29142,12912,3.4246e+13,632.653,7052.99,42054,483,331,39733,39662,37510,33129,30444
95362,1841,3752,65021,30341,3.53513e+13,925.123,12127.1,95362,641,490,91610,91093,79625,64481,63840
88910,375,2579,63245,25665,3.45496e+13,943.961,10906.2,88910,594,583,82052,77054,59903,38506,22392
62959,410,2053,42895,20064,3.53137e+13,769.74,7792.29,62959,419,401,58497,55071,37086,26520,16874
23150,1414,1963,16567,6583,3.72667e+13,500.653,5258.29,23150,359,379,21187,21113,20789,20733,17389
55807,1569,1857,38536,17271,3.46949e+13,819.568,7207.38,55807,425,425,53950,53943,53867,53775,52444
38806,219,2167,27651,11155,3.67604e+13,910.198,6990.95,38806,578,427,33594,30369,21749,12888,7357
60058,1212,2488,40916,19142,3.229e+13,972.533,8227.1,60058,419,374,57440,56408,52273,41725,34762
6198,71,762,4356,1842,3.74928e+13,228.856,1727.68,6198,202,154,4574,3931,3215,1765,1168
80986,1310,3697,55851,25135,3.47476e+13,1164.22,11928.4,80986,613,603,76879,75245,65783,50994,31765
21247,1163,1514,14507,6740,3.51259e+13,641.22,4411.85,21247,321,416,19733,19314,18902,16980,17956
89494,47,2758,62618,26876,3.54916e+13,962.44,10263.4,89494,599,535,62148,50555,38330,14362,8066
58741,2243,2347,41521,17220,3.60919e+13,921.055,8650.41,58741,638,414,56394,56394,56212,56184,56047
64014,3195,3377,44726,19288,3.60763e+13,870.548,10562.6,64014,643,642,60637,60608,60443,60239,59640
46696,1919,2135,32893,13803,3.40473e+13,865.948,7039.79,46696,471,339,44561,44524,44247,43801,43121
89148,111,3028,62082,27066,3.46103e+13,1050.62,11442.3,89148,697,493,72166,62826,43257,14169,9354
95956,621,3160,65890,30066,3.35267e+13,1164.35,11811.8,95956,718,546,90306,86610,54642,29057,21971
56950,2329,2399,39714,17236,3.61787e+13,775.948,7706.55,56950,486,452,54551,54551,54529,54543,54401
20505,1100,1320,13861,6644,3.27274e+13,314.498,3921.27,20505,306,230,19185,19183,18562,17668,17629
39500,1988,2070,26858,12642,3.50786e+13,537.179,6686.74,39500,451,399,37430,37430,37352,37335,37021
49638,100,2285,35011,14627,3.44501e+13,891.675,7560.15,49638,454,458,40168,34628,24733,5972,4674
57336,1021,2702,39856,17480,3.62772e+13,683.323,9029.11,57336,574,426,54634,54125,42318,33873,29032
7161,440,860,5255,1906,3.66405e+13,251.993,1946.74,7161,192,182,6301,6061,5947,5901,4370
63129,1931,2008,44318,18811,3.61884e+13,651.915,7356.94,63129,476,367,61121,61121,61110,61113,60955
84903,2593,3088,60205,24698,3.70372e+13,1250.52,11196.4,84903,775,596,81815,81578,80515,78060,78007
58936,822,3202,40401,18535,3.43166e+13,834.365,10183.8,58936,466,603,55199,53606,46173,33427,21735
8067,644,717,5572,2495,2.87714e+13,178.232,1781.03,8067,141,155,7350,7347,7349,7323,6660
61736,1593,3272,42612,19124,3.55556e+13,885.358,10150.9,61736,699,514,58464,57650,50805,39570,37455
11885,1077,1262,8265,3620,3.64414e+13,376.056,3066.27,11885,303,227,10623,10616,10541,10508,9929
1217,120,362,832,385,3.64321e+13,62.8439,564.988,1217,69,80,855,782,777,711,388
7875,347,898,5454,2421,3.19928e+13,266.464,2130.97,7875,167,201,6939,6652,6191,6153,3606
80644,2008,3540,55074,25570,3.43746e+13,685.766,11313.2,80644,594,493,77104,76915,65445,54425,56425
35856,392,2297,24687,11169,3.61255e+13,529.32,6624.66,35856,568,397,32729,30894,21746,17257,13102
56409,953,2622,38775,17634,3.48775e+13,917.498,8977.77,56409,508,557,53424,51868,47740,35963,30880
52697,689,2558,37480,15217,3.68914e+13,755.381,8422.31,52697,412,460,49446,47037,43739,33449,19702
82790,3074,3346,57580,25210,3.58453e+13,859.002,11175,82790,590,471,79444,79444,79379,79442,77431
37912,222,2020,26197,11715,3.31126e+13,659.442,6262.85,37912,378,432,33465,30314,20225,12259,8503
24409,1063,1781,17007,7402,3.73128e+13,504.064,4984.8,24409,321,312,22628,22493,22052,21791,18016
1228,195,348,881,347,4.5731e+13,43.9137,538.08,1228,90,54,880,845,864,865,577
58908,1898,2133,40709,18199,3.42619e+13,982.272,7927.42,58908,480,397,56775,56649,56420,56063,53671
63523,3162,3225,45597,17926,3.66946e+13,786.663,10627.8,63523,517,643,60298,60298,60279,60293,59971
79757,2237,2932,56949,22808,3.64646e+13,1259.7,10806.6,79757,651,506,76825,76268,74914,71653,66425
10546,571,1062,7396,3150,3.45707e+13,251.016,2665.39,10546,200,220,9484,9387,9067,8975,5624
77732,474,2774,55185,22547,3.75654e+13,845.574,9830.38,77732,667,427,71709,66782,45245,26649,22130
21033,1085,1370,14896,6137,3.60505e+13,376.082,4031.85,21033,259,345,19663,19663,19583,19334,17945
76290,564,2559,54532,21758,3.6089e+13,966.059,9715.23,76290,677,508,71301,68651,58948,42684,27331
29739,2131,2197,20610,9129,3.54502e+13,439.479,5971.9,29739,301,455,27542,27542,27542,27542,27323
84611,1059,3144,59031,25580,3.51095e+13,1036.25,11450.3,84611,536,629,80897,79104,73033,60611,47365
67256,902,2603,47776,19480,3.67256e+13,1111.58,9557.97,67256,579,429,63715,61396,54975,37880,33095
70478,2304,2527,49021,21457,3.58801e+13,1218.7,9352.94,70478,545,480,67951,67911,67604,67139,66986
53217,631,2348,37724,15493,3.5946e+13,838.214,7970.34,53217,480,433,49771,48200,36080,26697,22900
55777,3225,3423,38298,17479,3.57816e+13,661.521,9791.61,55777,453,547,52354,52354,52336,52323,51248
26977,1875,2162,19060,7917,3.60648e+13,515.678,5816.67,26977,419,381,24815,24795,24676,24588,23574
10715,599,855,7612,3103,3.90594e+13,452.803,2344.47,10715,269,215,9823,9119,9250,8929,8490
78555,2477,2948,54528,24027,3.59476e+13,1053.48,10373.6,78555,705,475,75607,75510,75003,74312,72023
30062,1100,1710,21561,8501,3.65021e+13,665.945,5329.98,30062,444,345,28352,27741,27139,26842,22578
55537,841,2311,38697,16840,3.59214e+13,816.586,7682.66,55537,499,443,52896,51699,47775,39563,31449
41541,1661,2463,28568,12973,3.51887e+13,832.982,7497.69,41541,410,468,39078,38698,37797,35568,31668
2146,103,177,1413,733,2.45914e+13,77.2074,501.531,2146,66,67,1969,1969,1763,1852,1568
80919,1088,3188,55663,25256,3.52063e+13,1238,11094.5,80919,585,486,77044,75371,63750,45389,41379
41366,1494,1982,28015,13351,3.37201e+13,608.639,6405.93,41366,373,422,39384,39382,38889,38193,35881
32283,701,2334,21978,10305,3.49663e+13,649.375,6382.18,32283,447,387,29651,28519,25337,18008,15642
11206,784,1282,8124,3082,3.72557e+13,272.506,2929.35,11206,266,192,9924,9896,9769,9265,7503
60681,2423,2946,41930,18751,3.53948e+13,786.613,9230.73,60681,519,446,57735,57725,57385,57137,53660
3840,104,764,2780,1060,4.03964e+13,121.096,1368.67,3840,130,117,2964,2633,2287,1774,574
73798,836,2531,51154,22644,3.54781e+13,798.175,8734.81,73798,509,471,71018,67517,49808,36617,42441
52657,610,2496,36575,16082,3.50718e+13,882.116,8111.47,52657,549,454,48550,46161,35544,24878,19808
4547,274,850,3270,1277,3.82011e+13,192.9,1596.87,4547,169,160,3673,3447,3281,3247,1243
92727,1796,3345,64617,28110,3.4861e+13,999.491,11810.4,92727,532,558,89382,88843,85803,77660,64077
34983,721,2175,23890,11093,3.55973e+13,559.031,6138.19,34983,448,337,32740,31985,25289,18887,20267
91488,1603,3962,62649,28839,3.51879e+13,768.727,13035.1,91488,726,651,87526,86985,69785,57600,52828
95018,253,3428,65853,29165,3.57325e+13,1054.53,11948.8,95018,529,512,84122,74648,51203,20842,19421
52231,960,1976,36427,15804,3.38494e+13,698.046,7144.84,52231,367,437,50255,49765,47542,47100,37445
92385,1947,3355,63367,29018,3.31965e+13,1598.34,12278.2,92385,588,693,88679,85683,82490,65089,67639
49677,661,2262,35481,14196,3.60577e+13,774.568,7892.97,49677,547,362,46728,45365,38595,26514,21592
4253,290,779,2976,1277,3.54749e+13,119.781,1435.75,4253,218,110,3474,3368,2703,2230,1781
93117,2000,3211,65263,27854,3.38695e+13,1161.95,11662.3,93117,625,535,89906,89502,87315,81854,77545
76313,1414,2493,54217,22096,3.69328e+13,1021.61,9571.25,76313,587,510,73820,73277,69599,64406,55867
31325,96,1671,22866,8459,3.66616e+13,648.134,5507.08,31325,397,378,24366,21001,16493,5939,4158
52427,757,2280,36859,15568,3.66153e+13,982.171,7429.15,52427,525,408,49409,48044,37380,25587,26185
6717,224,894,4863,1854,3.91856e+13,206.07,1909.14,6717,207,131,5660,5072,4829,3861,3227
28520,450,1507,19358,9162,3.52981e+13,348.181,4447.12,28520,331,241,27013,26788,19686,15619,16613
48006,1758,2631,33641,14365,3.41311e+13,835.286,8201.78,48006,424,472,45375,45242,44647,43582,36057
13288,1271,1399,9389,3899,3.59315e+13,334.345,3397.97,13288,245,366,11889,11888,11859,11849,11044
20022,1514,1903,14330,5692,3.81224e+13,343.293,4790.6,20022,252,393,18119,18117,17964,18060,16624
43246,1507,2165,29754,13492,3.47486e+13,709.544,7052.55,43246,388,477,41081,40729,40111,38309,36279
2688,186,399,1856,832,3.28853e+13,208.338,875.174,2688,129,115,2134,1796,1891,1826,1298
48064,762,2301,32728,15336,3.50487e+13,814.562,7851.95,48064,401,414,45123,43623,36024,24876,21583
75885,905,2800,53896,21989,3.66115e+13,909.626,10399.1,75885,557,531,72554,70455,61351,46411,39158
56084,1147,2997,39263,16821,3.46167e+13,731.408,9037.31,56084,611,544,53087,52294,49295,39405,32293
15070,135,1471,10862,4208,3.84051e+13,396.203,3668.18,15070,339,277,12374,10969,8839,6276,2994
80263,1618,3060,56806,23457,3.59573e+13,916.114,10806.3,80263,583,446,77203,76957,68595,53558,52923
3399,372,491,2331,1068,3.76836e+13,214.61,1078.14,3399,139,142,2908,2756,2702,2586,2658
11889,43,1006,7997,3892,3.39213e+13,469.523,2749.25,11889,249,263,7993,6271,4355,2225,1544
25587,299,1910,18033,7554,3.72356e+13,673.171,5368.55,25587,417,339,21897,19850,14814,9413,5898
70441,2069,3254,48369,22072,3.55913e+13,896.909,10878.9,70441,551,867,67187,66997,66044,64697,53635
84071,2752,3775,57915,26156,3.51923e+13,1133.01,12391.3,84071,789,547,80296,80097,78100,72806,73285
63206,335,2736,44513,18693,3.55305e+13,950.562,9249.77,63206,573,492,57505,53642,35447,18263,15184
7414,606,613,5049,2365,3.59057e+13,305.633,1710.76,7414,183,180,6801,6801,6800,6800,6800
75128,300,2378,53576,21552,3.68521e+13,836.311,9009.46,75128,575,448,67113,59963,46314,26452,23397
2873,261,514,1911,962,3.2827e+13,203.264,1028.65,2873,127,125,2309,2077,2095,1824,1817
92160,269,2705,64189,27971,3.21202e+13,1372.07,11098.4,92160,594,565,83478,78097,53851,22179,17479
30831,343,1981,21610,9221,3.66081e+13,683.88,5954.87,30831,405,345,27650,25093,19899,12318,8276
87085,2547,2970,61070,26015,3.48943e+13,954.453,10705.3,87085,549,554,84115,84103,83934,83789,81278
49891,1797,2045,34169,15722,3.54232e+13,587.334,7139.12,49891,423,466,47846,47825,47786,47801,46568
82092,2427,2879,57960,24132,3.66096e+13,922.615,10611.9,82092,665,541,79213,79191,78708,78070,76052
75008,2730,2979,53693,21315,3.58067e+13,1244.17,10783.4,75008,644,470,72029,71994,71822,71299,70766
68938,2754,3120,47360,21578,3.46704e+13,1153.3,10382.8,68938,669,532,65818,65621,65398,64493,64336
7449,736,877,5206,2243,3.48632e+13,241.031,2066.41,7449,185,237,6572,6572,6522,6557,6213
52509,140,2689,35469,17040,3.33794e+13,594.872,8174.92,52509,481,354,44340,39275,24560,7526,6273
52410,1027,2307,36532,15878,3.56506e+13,796.094,7776.89,52410,451,425,50037,49115,46181,40159,32334
20479,1383,1388,14192,6287,3.5835e+13,529.985,4087.11,20479,365,343,19091,19091,19091,19091,19090
81763,1598,3251,55711,26052,3.47504e+13,827.114,11058.4,81763,545,721,78512,78016,73400,66230,52499
46813,667,2504,32594,14219,3.28859e+13,840.108,7608.19,46813,670,325,43364,41686,25409,21329,11636
20780,147,1260,14023,6757,3.40316e+13,488.287,3911.27,20780,265,288,17119,15329,10455,4557,4039
16898,247,987,11947,4951,3.53826e+13,472.73,3122.99,16898,282,240,14751,12816,12207,10369,6197
5735,321,848,3910,1825,3.47289e+13,192.526,1824.39,5735,168,207,4887,4637,4579,4473,2671
74633,852,2899,52051,22582,3.45147e+13,872.845,10213.9,74633,565,468,71056,68128,49890,35469,25710
89622,743,3538,63580,26042,3.65619e+13,1226.27,12473.7,89622,810,535,83687,81075,58770,43678,36299
14728,629,1297,10300,4428,3.67912e+13,364.056,3337.66,14728,295,268,13431,13233,11986,9245,9654
53967,1503,2030,37514,16453,3.6013e+13,789.854,7564.63,53967,472,451,51937,51816,50578,48137,45858
53222,1272,2697,36856,16366,3.42261e+13,831.672,8888.89,53222,543,494,50477,49752,45717,34174,33155
56594,368,3100,39161,17433,3.5508e+13,837.419,9592.02,56594,514,575,51103,47231,33196,17599,10117
40969,1961,2106,28773,12196,3.58123e+13,674.715,6785.52,40969,500,388,38863,38863,38824,38825,38302
53303,2039,2675,36796,16507,3.45633e+13,701.759,8484.41,53303,489,492,50628,50613,50124,49784,45490
52105,251,2508,36893,15212,3.62055e+13,986.965,8273.2,52105,590,484,44872,40372,27542,8868,9182
42040,793,1404,29118,12922,3.17598e+13,736.713,5429.62,42040,360,346,40406,39435,37988,36381,30457
20888,1052,1552,14471,6417,3.59072e+13,496.498,4479.62,20888,348,411,19336,19233,18845,18414,15994
46929,39430,46929,0,46929,15.9997,0,46929,46929,46929,1,0,0,0,0,0
32551,857,2220,22394,10157,3.53399e+13,772.627,6528.03,32551,602,476,30018,29107,26177,21400,16969
80661,2194,2669,55759,24902,3.28369e+13,896.997,9714.83,80661,471,513,77992,77962,77567,77205,73280
26781,1487,1677,18952,7829,3.31836e+13,511.645,4807.11,26781,392,207,25104,25068,25022,25057,24457
98164,3128,3636,67092,31072,3.51131e+13,1071.93,12600.4,98164,521,661,94528,94511,94361,94476,90769
82981,1654,3343,56610,26371,3.33565e+13,854.528,11610.4,82981,574,509,79638,79390,72767,58937,54539
11710,978,1130,8138,3572,3.17585e+13,259.385,2810.41,11710,172,252,10580,10579,10567,10572,10053
22231,1836,1932,15834,6397,3.71033e+13,360.711,5092.23,22231,372,257,20299,20293,20296,20295,20058
37808,1967,2143,26003,11805,3.44676e+13,492.035,6362.07,37808,441,357,35665,35665,35644,35639,35006
84427,1974,3309,57622,26805,3.44836e+13,778.181,11422.7,84427,582,513,81118,80857,77213,67765,64523
90822,2632,2753,65061,25761,3.63492e+13,1090.88,10758,90822,631,437,88069,88069,88020,88024,87619
27461,1145,2003,19320,8141,3.57932e+13,517.543,5778.53,27461,364,429,25458,25331,24669,24552,16553
96918,2543,2637,66622,30296,3.42418e+13,940.481,10964.7,96918,490,501,94281,94281,94266,94278,94169
27732,890,2100,19132,8600,3.61805e+13,633.805,5822.79,27732,380,545,25430,24739,23448,20430,10598
55386,1953,3669,38388,16998,3.55826e+13,863.179,10526.5,55386,577,655,51717,51265,49346,44363,37205
49133,420,2783,35533,13600,3.74932e+13,781.287,8950.33,49133,469,565,44723,42482,36168,26544,12608
29072,715,1234,21034,8038,3.83199e+13,602.89,4378.17,29072,355,286,27838,27029,26093,24396,23318
41750,401,1837,30255,11495,3.65532e+13,717.585,6084,41750,420,354,37868,34873,26061,18565,14315
37511,719,2155,25453,12058,3.51311e+13,589.197,6675.91,37511,426,453,35140,34460,30101,25189,19721
27712,201,1904,19453,8259,3.30821e+13,557.83,5324.24,27712,409,404,24638,23130,16977,9199,3306
40571,734,2195,28028,12543,3.55118e+13,671.161,6649.77,40571,383,382,38259,37080,33851,24794,22902
50108,1693,2275,35478,14630,3.65131e+13,996.123,8010.82,50108,483,449,47833,47366,46389,43254,39321
43956,795,2006,31276,12680,3.77045e+13,705.519,6627.63,43956,456,321,41817,39401,31587,20760,17178
59692,1678,3419,41089,18603,3.57341e+13,769.82,10357.9,59692,600,625,56273,55836,51458,45316,33333
63245,1493,3016,44332,18913,3.53955e+13,866.277,10118.2,63245,602,568,60229,59616,57124,50550,38039
95481,912,4056,66194,29287,3.61508e+13,1112.79,13743,95481,635,740,90374,88280,69052,54545,30063
95142,884,2614,66641,28501,3.53104e+13,1095.72,10560.5,95142,611,514,91446,89252,71294,48997,42499
22342,876,1638,15817,6525,3.67564e+13,608.771,4699.85,22342,383,335,20666,19891,19420,18748,12541
44796,352,2457,31566,13230,3.66473e+13,674.215,7509.74,44796,539,358,40445,37405,27660,18097,14169
73425,1288,2185,51330,22095,3.7095e+13,760.293,8102.72,73425,487,397,71240,71132,66168,56704,59167
57497,2740,2843,39374,18123,3.50398e+13,820.624,8995.64,57497,582,410,54654,54654,54609,54644,54369
90180,987,3573,61306,28874,3.47529e+13,852.513,12664.6,90180,630,708,86344,85234,70479,48434,31401
75865,392,3341,53740,22125,3.68148e+13,1163.01,11078.2,75865,599,554,68880,64953,42471,22314,14821
56026,649,2301,39844,16182,3.64249e+13,846.171,7961.66,56026,456,475,52795,50722,44960,33739,22312
75551,237,3141,51842,23709,3.42242e+13,840.634,10729.1,75551,507,656,66626,59120,38818,15017,12563
80177,836,2431,55805,24372,3.2671e+13,1064.36,9892.76,80177,547,514,76810,74963,67808,49147,32068
66737,706,2185,45808,20929,3.29317e+13,777.786,8142.33,66737,452,430,64231,62983,54791,47487,22837
56149,106,2471,38649,17500,3.65267e+13,915.201,8477.14,56149,463,623,44960,39750,25759,11575,6093
69043,1405,2832,48618,20425,3.6012e+13,1136.06,9790.64,69043,560,493,66017,64877,59501,45059,43683
9157,549,993,6409,2748,3.67286e+13,297.28,2423,9157,297,230,8164,7945,7549,6409,6457
5690,631,724,4051,1639,3.82497e+13,269.998,1617.3,5690,192,165,4966,4894,4884,4826,4801
39169,1854,2261,27149,12020,3.49898e+13,747.322,6699.86,39169,475,444,36908,36708,36588,36068,35258
54637,2247,2642,37294,17343,3.4442e+13,923.84,8584.17,54637,579,531,51995,51991,51869,51392,50852
67818,1704,2694,47891,19927,3.4608e+13,849.64,9553.16,67818,421,530,65124,65066,64681,64754,58229
30701,965,1994,20935,9766,3.51144e+13,741.949,5845.11,30701,437,466,28634,27923,24938,21016,20337
48497,1035,2492,33517,14980,3.52568e+13,736.512,7913.47,48497,513,419,45892,45066,37375,27973,24981
85249,706,3422,59628,25621,3.48806e+13,1063.03,12106.6,85249,536,543,80177,77451,66160,42596,31812
12391,691,1201,8408,3983,3.39594e+13,262.056,3015.66,12391,183,249,11190,11133,10875,10534,7350
60690,1284,3093,41433,19257,3.39098e+13,775.064,9695.63,60690,491,536,57597,56945,48172,35642,32097
68711,1019,2698,48009,20702,3.62878e+13,1078.02,9708.57,68711,617,518,65487,64345,57031,42771,29743
42036,2366,2514,29038,12998,3.52759e+13,575.898,7263.92,42036,486,324,39522,39518,39500,39478,39069
23494,386,1735,16418,7076,3.46711e+13,528.511,4761.08,23494,351,305,21184,19771,15043,11517,9045
46227,589,2412,32575,13652,3.64449e+13,933.181,7712.71,46227,531,427,42791,40742,33440,24100,20373
81338,854,3658,54941,26397,3.33915e+13,902.416,12299.4,81338,758,561,76957,74797,49086,41075,30917
78968,1615,3598,55325,23643,3.47601e+13,800.559,11840.1,78968,881,458,75370,74938,65139,46991,48181
56191,2370,2567,39010,17181,3.70003e+13,900.918,8472.96,56191,548,451,53624,53616,53530,53511,52707
1185,11,336,882,303,3.3732e+13,37.4523,542.209,1185,99,54,589,269,284,191,100
15177,44,1491,10960,4217,3.8959e+13,541.208,3707.95,15177,366,320,10880,9093,6355,2283,1368
62892,1547,3171,42889,20003,3.27856e+13,876.897,10436.6,62892,572,766,59721,58934,56116,46399,39556
96820,1154,3541,68409,28411,3.7012e+13,1421.44,12506.8,96820,738,607,92506,90206,72380,52939,48802
10200,272,821,7297,2903,3.60022e+13,360.6,2211.84,10200,211,189,8977,7944,7377,5394,4138
65016,2510,3015,44325,20691,3.52154e+13,878.84,9856.93,65016,521,514,62001,61994,61229,60401,59088
44600,1292,1771,32027,12573,3.82159e+13,751.825,6447.97,44600,453,476,42829,42716,42268,41190,39079
79461,2006,2575,53155,26306,3.38161e+13,988.025,9738.36,79461,552,561,76886,76859,75294,71404,72926
10830,25,876,7353,3477,2.75232e+13,175.777,2207.78,10830,190,178,6350,4137,3254,776,379
56833,1562,2431,38540,18293,3.41904e+13,759.788,8049.85,56833,527,381,54402,54203,51786,47720,43490
17307,1025,1322,12024,5283,3.59179e+13,423.115,3618.25,17307,272,271,15985,15935,15768,15658,14131
10363,128,1024,6925,3438,3.35137e+13,304.447,2613.73,10363,184,273,8187,7101,5133,2586,2330
15158,1232,1299,11286,3872,3.48123e+13,512.033,3411.97,15158,351,219,13859,13859,13857,13836,13836
52934,1426,2284,37689,15245,3.69241e+13,758.828,7615.84,52934,521,366,50650,50483,49309,46974,43708
16337,397,926,11680,4657,3.57059e+13,467.295,2851.51,16337,272,214,15134,14647,13343,12550,10321
96804,3024,3101,65986,30818,3.41815e+13,984.943,11289.9,96804,552,552,93703,93703,93674,93685,93589
94760,167,3865,65587,29173,3.48066e+13,1118.04,13055.7,94760,623,581,80186,71753,48554,17311,10932
39036,1334,2363,27325,11711,3.64213e+13,652.448,7278.66,39036,538,403,36673,36543,34698,30016,27933
82503,2348,2649,57339,25164,3.59816e+13,930.557,10170.8,82503,565,492,79854,79853,79698,79510,77922
43419,1065,1863,30613,12806,3.53378e+13,804.267,6408.51,43419,474,325,41556,40912,37850,33483,30688
84651,357,2891,60900,23751,3.64585e+13,1013.58,10901.9,84651,670,555,77449,72536,54936,36770,22207
1314,57,300,932,382,3.77075e+13,80.5441,518.849,1314,73,75,952,798,655,564,363
88661,1775,2683,63107,25554,3.73165e+13,1216.51,10333.5,88661,696,572,85978,85620,83632,76418,77944
59742,2965,3391,41314,18428,3.50931e+13,790.72,10326.6,59742,505,635,56351,56347,56126,56054,53148
65570,1605,2710,46057,19513,3.65282e+13,913.205,9251.77,65570,552,549,62860,62388,58337,50614,47782
49164,1355,2562,34872,14292,3.57089e+13,832.434,8253.66,49164,432,462,46602,45884,44535,40067,32527
11642,697,1251,8026,3616,3.58233e+13,387.469,2947.8,11642,248,250,10391,10075,9853,9037,7158
1237,288,318,962,275,3.40194e+13,44.1568,511.933,1237,96,56,919,917,919,919,902
88108,1247,2975,61148,26960,3.67253e+13,1120.45,10053.4,88108,515,502,84781,83754,70435,51838,54580
62973,710,2352,45739,17234,3.76647e+13,1091.59,8963.5,62973,610,538,58812,56448,53100,41795,27010
25134,1733,2306,16836,8298,3.3336e+13,560.259,5735.82,25134,471,492,22828,22822,22394,21220,20871
9792,876,1032,7038,2754,3.93848e+13,407.98,2536.46,9792,205,237,8760,8711,8721,8745,8347
8887,113,808,6112,2775,3.38934e+13,393.65,2153.82,8887,167,218,7270,6328,4897,3271,1870
31004,1009,1880,21796,9208,3.31042e+13,727.818,5473.56,31004,357,351,29049,28307,26874,22550,19174
46483,1122,2910,32295,14188,3.61484e+13,744.51,8778.61,46483,388,547,43573,42776,39188,30644,24580
2048,170,364,1418,630,3.47856e+13,173.356,721.555,2048,96,106,1565,1348,1388,1492,928
72770,2150,3117,50826,21944,3.44806e+13,992.441,10394.9,72770,605,505,69653,69356,67134,57392,57551
5847,443,828,4265,1582,3.21374e+13,129.236,1737.69,5847,156,160,5019,4992,4756,4865,2329
80700,845,3000,54741,25959,3.36805e+13,1285.21,10947.2,80700,651,583,75935,73345,54278,42621,35942
89368,2534,3601,65424,23944,3.71682e+13,1090.4,13336.6,89368,574,955,85767,85744,85161,82211,61205
75243,56,2799,52595,22648,3.59436e+13,942.05,9505.3,75243,580,444,53818,44360,33966,13432,8193
17048,530,1617,11759,5289,3.53486e+13,443.686,4064.96,17048,357,406,15302,14835,12488,9951,7897
19740,572,1462,13587,6153,3.29229e+13,481.695,4006.09,19740,282,290,18185,17712,15751,14223,8924
38719,1359,2276,26549,12170,3.46144e+13,659.002,6742.16,38719,405,448,36443,36129,34827,32555,25176
16587,92,1299,12036,4551,3.61771e+13,497.869,3557.77,16587,371,232,12679,11141,8922,2685,2100
6193,302,756,4111,2082,2.86579e+13,151.344,1625.88,6193,179,134,5437,5337,4325,2954,1953
46277,1399,2119,32411,13866,3.61105e+13,645.422,7103.81,46277,410,397,44158,44096,41079,37137,33421
2073,72,497,1499,574,4.25063e+13,62.973,828.383,2073,133,89,1550,1403,1061,786,524
44918,283,2146,31770,13148,3.63225e+13,749.089,7175.86,44918,480,373,40036,36003,28667,20661,8866
96407,1855,2642,67083,29324,3.33256e+13,1127.94,10786.7,96407,632,472,93765,93518,89573,78275,80213
71999,2850,3275,50100,21899,3.61968e+13,899.624,10805.8,71999,562,693,68724,68721,68528,68229,65459
77163,1110,2595,54495,22668,3.63445e+13,905.634,9312.72,77163,584,444,74517,73573,64350,47955,52157
6303,152,714,4272,2031,3.65816e+13,323.47,1746.62,6303,186,198,5146,4622,3902,3586,2084
82171,568,2666,55706,26465,3.49453e+13,1193.17,10327.3,82171,573,643,76758,74030,43293,33279,31940
72697,1493,3513,51397,21300,3.61489e+13,932.41,11740.1,72697,666,710,69184,68405,63835,54155,32668
41195,1892,2612,28683,12512,3.52117e+13,591.193,7918.47,41195,348,461,38583,38541,38193,38286,33891
31633,1781,2182,22204,9429,3.44576e+13,547.95,6336.47,31633,358,543,29451,29441,29303,29221,26735
45762,1210,1700,32933,12829,3.73489e+13,844.674,6202.03,45762,452,381,44062,43101,43037,41588,37751
65886,662,2929,46240,19646,3.42531e+13,774.087,9761.68,65886,679,357,61997,60017,48043,34872,27611
67755,2172,2436,47763,19992,3.6057e+13,943.022,8909.64,67755,654,457,65319,65319,65219,64269,64606
58322,1348,1965,42096,16226,3.72178e+13,908.028,7520.57,58322,525,423,56286,55649,54974,51388,48569
4361,267,434,2983,1378,3.65181e+13,244.406,1115.88,4361,136,144,3828,3343,3415,3066,3196
64505,1774,3085,44785,19720,3.59873e+13,776.264,9619.31,64505,488,512,61420,61091,58472,51611,47248
44707,1961,2421,30890,13817,3.36375e+13,614.456,7236.41,44707,387,418,42286,42254,42114,42202,38976
79021,2522,3267,54190,24831,3.55775e+13,976.663,10901.8,79021,672,453,75754,75650,74713,71254,71426
11064,573,1025,7858,3206,3.58824e+13,299.44,2563.3,11064,229,169,10039,9845,9810,9479,8354
72252,534,2881,52091,20161,3.7333e+13,1269.28,10424.9,72252,673,605,66320,62930,54874,41926,20351
99803,2676,2974,69500,30303,3.60769e+13,1056.44,11335.5,99803,670,565,96829,96807,96455,96215,93047
41856,1024,2304,28887,12969,3.40432e+13,730.128,7119.3,41856,426,392,39552,39103,35389,28140,19671
84317,1178,2839,60592,23725,3.77496e+13,893.837,10806.6,84317,559,471,81278,79912,73571,59958,48549
29139,849,1366,20618,8521,3.61327e+13,625.722,4647.66,29139,364,322,27773,27015,25347,23260,21297
50712,1022,1976,34820,15892,3.33268e+13,990.557,7267.7,50712,407,480,48350,47242,42744,29477,24260
76661,1158,2998,53496,23165,3.54485e+13,875.361,10495.5,76661,502,616,73615,72198,66905,58251,37351
49509,174,2502,33797,15712,3.30896e+13,809.384,7795.49,49509,460,371,43211,39816,22872,7342,6756
11428,966,1231,8391,3037,3.79603e+13,355.137,2978.88,11428,291,215,10197,10156,10074,10123,9452
77321,920,3525,52340,24981,3.38555e+13,1109.93,11637.6,77321,659,750,73065,71412,57310,49468,28313
98802,299,2954,69811,28991,3.68811e+13,951.12,11568.8,98802,714,489,88999,79991,54080,23611,15714
12919,451,1267,9137,3782,3.71051e+13,311.02,3140.73,12919,247,201,11650,11295,10189,6975,6393
13252,1105,1188,9555,3697,3.92241e+13,463.502,3037.66,13252,298,223,12064,12038,12042,12030,11782
26302,1210,1481,18544,7758,3.40168e+13,390.911,4572.48,26302,315,251,24821,24738,24769,24795,22810
29416,591,1556,20060,9356,3.41533e+13,413.21,5190.53,29416,369,406,27860,27437,24994,22781,14045
83940,1158,1889,58597,25343,3.31564e+13,977.616,8523.91,83940,547,412,82051,81266,77972,73380,66104
68241,2628,2722,46542,21699,3.26443e+13,918.769,9374.2,68241,521,537,65519,65519,65497,65516,65323
17347,418,1071,12396,4951,3.64571e+13,577.26,3291.76,17347,297,251,15792,15209,13227,9966,8787
81414,1074,2182,56908,24506,3.6182e+13,1097.15,8961.9,81414,539,487,78832,77531,71654,62553,52677
62801,956,2446,43052,19749,3.35873e+13,808.794,8369.31,62801,454,428,60321,58313,52583,39687,39626
25571,683,1522,17761,7810,3.41929e+13,606.642,4641.24,25571,393,401,23882,23237,21453,19309,15336
22344,1319,1380,15152,7192,3.44738e+13,594.547,4240.84,22344,338,357,20964,20955,20929,20928,20837
72362,481,3239,50392,21970,3.53227e+13,912.716,10673,72362,548,550,67161,64169,49161,31682,19708
47184,154,2156,33644,13540,3.67141e+13,867.17,7188.44,47184,493,416,39010,33536,26454,8504,7816
77290,1954,2598,55361,21929,3.66406e+13,997.536,9598.51,77290,590,425,74692,74578,72543,66969,67448
75797,256,2548,52933,22864,3.47541e+13,1118.08,9809.02,75797,650,533,67448,61853,42118,19769,13201
5985,168,867,4316,1669,3.89739e+13,288.07,1830.08,5985,193,159,4796,4349,3566,2347,1795
44266,470,2926,31331,12935,3.59425e+13,599.73,8503.59,44266,398,499,40521,38661,30973,19300,11802
19427,893,1343,13451,5976,3.60157e+13,451.209,3753.47,19427,278,244,18084,17857,17160,15754,15966
54696,1523,2150,38963,15733,3.64746e+13,897.146,7745.48,54696,478,422,52546,52209,50880,49569,46457
95737,3508,3515,65869,29868,3.30054e+13,1251.91,12061.5,95737,821,523,92222,92222,92222,92222,92219
57418,1621,2439,40586,16832,3.68599e+13,783.637,8040.09,57418,528,392,54979,54815,52354,46336,46937
31029,145,1886,22131,8898,3.68556e+13,805.519,5644.59,31029,436,402,25068,21599,17169,7168,4388
57041,2463,2785,39911,17130,3.58915e+13,912.226,8888.13,57041,504,555,54256,54184,54062,53970,52624
74576,1795,3150,51289,23287,3.49864e+13,1111.67,10892,74576,584,559,71426,70771,67447,58509,50338
54273,2225,2472,38082,16191,3.45336e+13,1107.4,8267.79,54273,495,483,51801,51783,51504,50925,50564
11915,509,1041,8500,3415,3.47698e+13,492.349,2770.38,11915,288,255,10702,10308,9617,8945,6713
8762,308,911,5964,2798,3.58093e+13,246.067,2207.92,8762,234,185,7804,7203,6480,5539,5337
23144,673,1710,16147,6997,3.59436e+13,525.342,4687.69,23144,350,327,21387,20499,17762,13259,12863
67546,1303,2604,48451,19095,3.74907e+13,969.421,9509.86,67546,707,476,64942,64023,56921,43819,46061
82183,2241,3662,56069,26114,3.49831e+13,1081.4,12074.6,82183,649,590,78521,77889,74335,65495,63210
26424,1520,1977,17805,8619,3.35291e+13,393.938,5141.15,26424,375,284,24447,24446,24009,23368,22954
99997,2001,3922,68874,31123,3.53023e+13,1492.76,13824.8,99997,705,694,95905,94645,87494,71131,66033
1522,255,397,1048,474,3.44045e+13,83.8049,680.276,1522,106,92,1125,1096,1018,901,884
47814,1174,2293,33601,14213,3.64578e+13,888.38,7766.27,47814,479,510,45256,43932,41166,32583,31220
35629,641,2411,25280,10349,3.74439e+13,683.795,6889.06,35629,461,411,32893,31389,25645,18461,16642
89155,262,3082,61693,27462,3.44282e+13,1145.47,11630,89155,696,677,79542,73007,47012,17807,16716
19569,68,1398,13685,5884,3.67063e+13,359.334,3723.74,19569,345,252,14071,11916,8739,2978,3304
96286,926,3313,67670,28616,3.69193e+13,1006.4,12771.8,96286,531,679,92210,90665,76945,52007,37751
50003,1296,2797,35647,14356,3.66743e+13,742.106,8747.1,50003,429,464,47206,46771,44818,41700,31882
53855,1609,2725,37879,15976,3.47777e+13,715.735,8602.63,53855,379,526,51130,50547,50611,49412,37807
37200,1563,2454,26112,11088,3.46237e+13,688.369,7067.7,37200,411,392,34746,34533,33398,31713,26907
27080,300,1426,19437,7643,3.69659e+13,680.883,4469.95,27080,365,308,24553,22788,20133,18604,8367
29279,36,1838,19792,9487,3.45315e+13,568.548,5384.72,29279,345,422,19634,14921,11284,3858,2049
29836,141,2288,20646,9190,3.62238e+13,544.19,6271.62,29836,404,346,24298,21198,15189,5277,4651
22278,319,1634,15210,7068,3.52938e+13,558.355,4516.74,22278,383,346,19641,17937,12270,8803,8015
84077,1901,3431,58215,25862,3.46915e+13,1144.46,12020.6,84077,606,753,80646,79914,75824,61555,60496
89303,1818,3880,60847,28456,3.47304e+13,1028.28,12327.4,89303,717,614,85423,84567,73562,60323,63077
58270,1764,2125,41606,16664,3.71297e+13,850.104,7646.65,58270,474,450,56145,56130,55867,54906,52280
82975,1428,2137,58843,24132,3.72942e+13,1143.1,9138.48,82975,604,478,80720,79716,76912,68371,69362
29743,1132,1952,21110,8633,3.65538e+13,730.702,5723.75,29743,446,347,27791,27083,26459,24494,21993
80067,220,3271,57316,22751,3.69763e+13,1127.21,11732.9,80067,900,560,68433,60991,44676,17957,12240
35076,1013,1938,23983,11093,3.40203e+13,493.168,5746.83,35076,388,328,33138,32806,31187,25517,25700
65069,1188,3181,45194,19875,3.44044e+13,837.596,10117.5,65069,493,516,61888,60604,54874,38189,31352
53306,771,2736,37601,15705,3.66481e+13,803.605,8483.23,53306,475,474,50117,48590,43362,35396,26346
63856,2995,3331,43379,20477,3.34694e+13,696.156,9954.62,63856,500,444,60525,60524,60274,60211,58780
47914,1743,2216,33176,14738,3.42964e+13,760.442,7268.12,47914,466,403,45698,45455,45055,44286,40899
93609,1499,2962,64591,29018,3.45686e+13,1030.64,10666.6,93609,546,593,90647,89533,82289,64326,63588
92910,642,2990,63658,29252,3.34988e+13,876.959,11359.2,92910,706,425,88439,85064,55724,40969,35759
75191,2553,2707,53475,21716,3.65983e+13,1058.12,9993.43,75191,632,609,72484,72484,72327,72258,71625
42827,2113,2316,30314,12513,3.61531e+13,788.384,7238.66,42827,470,430,40511,40446,40374,40417,39798
8189,15,990,5705,2484,3.64397e+13,331.968,2292.54,8189,213,256,4379,2735,2361,1836,586
8961,597,1018,6483,2478,3.68527e+13,243.355,2384.75,8961,214,166,7943,7912,7532,7028,6142
81392,1034,2927,56959,24433,3.57478e+13,869.243,10267.4,81392,544,462,78271,77554,61964,42755,36688
85690,288,2648,60643,25047,3.71143e+13,995.675,10077.7,85690,654,477,75638,68438,48166,22663,18292
99170,1219,2709,68322,30848,3.27079e+13,1423.65,11324.1,99170,565,616,95203,92900,84909,58656,57775
95029,1929,3973,66704,28325,3.63907e+13,1093.39,13742.3,95029,693,717,91056,90439,86153,76075,61348
73691,988,2722,51109,22582,3.44101e+13,1129.51,9678.75,73691,571,506,70060,68233,57671,43261,35885
8503,405,892,6094,2409,3.79607e+13,255.795,2086.04,8503,184,175,7611,7468,6959,7037,4747
18853,1756,1768,13248,5605,3.6151e+13,403.027,4462.4,18853,344,375,17085,17085,17085,17085,17062
78810,1273,3165,53830,24980,3.46249e+13,860.491,10638.4,78810,650,561,75494,74435,61796,54125,45407
78838,413,2813,55205,23633,3.6619e+13,1033.37,10147.6,78838,480,569,72630,69071,45020,21047,22477
88688,2123,3285,61133,27555,3.56808e+13,1333.63,11664.3,88688,652,515,85403,84353,81777,74064,76065
52489,1687,2412,37339,15150,3.5319e+13,962.89,8108.31,52489,552,433,50077,49514,48632,45987,43930
69068,1696,2985,47486,21582,3.52655e+13,857.609,9715.98,69068,451,457,66083,65670,63058,58126,51324
60012,945,2449,41084,18928,3.57295e+13,938.538,8142.94,60012,473,497,57293,56497,45915,35196,34819
48086,53,2489,33427,14659,3.50755e+13,776.141,7912.02,48086,510,496,34877,28019,21642,7234,4354
97337,2077,3208,68913,28424,3.63914e+13,1016.03,12114.1,97337,637,597,94129,93662,89510,83585,73908
4390,137,539,2998,1392,3.71279e+13,218.137,1244.13,4390,135,139,3450,2983,2542,1932,1719
96111,309,3788,66548,29563,3.56563e+13,1351.54,13308.1,96111,777,676,85878,77987,52412,23971,17325
75171,2277,2801,54537,20634,3.7711e+13,1136.74,10843,75171,812,576,72370,72139,71661,70381,66901
31754,1995,2085,22297,9457,3.53971e+13,547.444,5921.66,31754,336,443,29669,29669,29668,29653,29461
67123,1004,2352,46984,20139,3.50848e+13,814.401,9045.32,67123,542,506,64570,63516,59441,51888,43453
41080,201,2089,29384,11696,3.77083e+13,749.366,6602.23,41080,431,375,34762,30686,23993,10255,7155
39815,1513,2009,28482,11333,3.63869e+13,808.936,6679.19,39815,498,369,37806,37605,37018,35333,33439
40299,317,2111,28241,12058,3.66159e+13,655.94,6485.74,40299,476,409,36022,32266,25912,18636,8903
28271,748,1358,19318,8953,3.54726e+13,443.013,4338.41,28271,317,264,26913,26846,24419,21137,21497
3240,316,521,2461,779,3.20187e+13,166.512,1059.41,3240,135,106,2719,2523,2495,2315,2030
19043,1261,1291,13698,5345,3.81529e+13,528.246,3757.6,19043,264,294,17752,17752,17748,17743,17690
58449,201,1835,40674,17775,3.31384e+13,1032.11,7307.96,58449,504,463,50817,47067,32734,15804,11684
44871,2124,2147,31344,13527,3.66362e+13,761.231,6887.76,44871,387,410,42724,42724,42716,42718,42656
92630,50,3579,64523,28107,3.45904e+13,968.725,12693.3,92630,879,527,67107,54022,40661,13106,6500
26096,971,1964,18489,7607,3.73974e+13,508.581,5401.72,26096,324,459,24132,24009,23184,22626,13665
15849,873,876,10810,5039,3.54025e+13,342.372,2707.12,15849,217,207,14973,14973,14973,14973,14967
41990,1515,1753,28923,13067,3.17169e+13,538.085,5990.48,41990,372,304,40237,40232,40080,40053,37413
33379,749,2501,23553,9826,3.57039e+13,666.11,6960.53,33379,490,417,30659,29934,27124,19908,14943
66483,439,2584,47158,19325,3.66244e+13,813.372,9227.16,66483,509,483,61615,58599,43125,31741,23161
40006,523,2100,27547,12459,3.51965e+13,618.324,6682.89,40006,471,374,37164,35868,29090,23186,15282
18064,954,1212,12698,5366,3.61549e+13,562.571,3564.7,18064,334,265,16852,16822,16390,16167,15657
17656,286,1572,12412,5244,3.48668e+13,456.564,4109.38,17656,338,247,15335,14122,10970,6922,4006
4691,590,713,3347,1344,3.84055e+13,201.285,1469.18,4691,143,146,3978,3976,3958,3965,3782
14385,79,1133,10058,4327,3.61843e+13,441.76,3200.18,14385,257,277,10774,9199,7031,3171,2158
40878,813,2262,28551,12327,3.56646e+13,1007.66,7029.11,40878,473,433,37987,36524,32769,22385,19188
96075,705,4328,65280,30795,3.28367e+13,1157.33,13525.2,96075,655,512,90094,87357,49338,29098,21960
4513,101,770,3087,1426,3.38434e+13,192.689,1544.65,4513,176,158,3381,2938,2054,969,867
26460,1434,1652,18621,7839,3.60472e+13,457.997,4686.67,26460,337,296,24808,24796,24760,24770,23927
9583,762,995,6666,2917,3.66024e+13,256.515,2409.43,9583,238,157,8588,8576,8549,8531,7827
35648,521,2027,25525,10123,3.70888e+13,733.481,6413.75,35648,388,408,32681,31409,28610,22596,13335
81209,264,3118,57573,23636,3.70243e+13,1064.95,10965.4,81209,567,559,70816,63731,45550,13601,12954
23795,673,1907,16788,7007,3.56516e+13,421.597,5033.77,23795,438,340,21881,21356,19416,14466,13345
35713,133,2177,24657,11056,3.53083e+13,553.513,6562.87,35713,535,438,28844,25038,17455,6105,5690
91386,3336,3630,63992,27394,3.68376e+13,1575.52,12882.9,91386,746,768,87756,87550,87194,86141,86298
52907,867,2543,36508,16399,3.57567e+13,683.885,8088.14,52907,466,494,50269,49511,39057,33306,26614
96879,370,2853,67855,29024,3.32589e+13,1270.87,11200.6,96879,616,553,88865,84155,54727,25897,18779
44034,860,1428,31260,12774,3.65508e+13,787.892,5738.04,44034,427,343,42397,41576,40192,38723,32471
63524,215,2371,46134,17390,3.69806e+13,1066.91,8848.01,63524,576,448,55167,49215,38969,18907,11008
52680,646,2032,36213,16467,3.48337e+13,644.252,6542.85,52680,394,346,50354,49535,38070,29582,27412
74024,2526,2638,52520,21504,3.6563e+13,917.64,10086.8,74024,495,549,71386,71385,71342,71219,70407
36458,527,1485,25701,10757,3.69807e+13,670.955,5304.64,36458,418,299,33764,31612,27500,18864,17764
19109,563,1376,13044,6065,3.31981e+13,285.373,3710.85,19109,291,207,17733,17587,12901,9119,6996
56886,2510,2624,39357,17529,3.36264e+13,853.86,8385.4,56886,403,475,54262,54249,54222,54210,53581
92672,283,3416,66133,26539,3.68274e+13,1233.54,12293.9,92672,694,598,82896,73050,51584,20120,18444
6571,4320,6571,0,6571,15.9976,0,6571,6571,6571,1,0,0,0,0,0
37901,1807,2262,26520,11381,3.58074e+13,674.317,7044.65,37901,440,435,35639,35604,35340,35113,32446
28726,1290,1757,19486,9240,3.45078e+13,385.009,5071.85,28726,359,280,26969,26964,25540,23023,23422
93416,3639,3809,64402,29014,3.48344e+13,996.092,12895.2,93416,663,588,89607,89607,89542,89543,89008
75484,771,2898,53029,22455,3.60263e+13,993.733,10330.4,75484,545,560,71282,69499,58605,39318,32955
4710,173,866,3409,1301,4.06732e+13,166.775,1619.06,4710,164,163,3746,3377,3115,3025,1331
63879,603,2575,44678,19201,3.60497e+13,939.384,8776.56,63879,501,446,59868,56840,41660,28574,21727
94563,496,3929,65388,29175,3.52696e+13,1062.22,13603.2,94563,586,637,86847,82142,56095,26766,23466
95520,3226,3811,65596,29924,3.56849e+13,964.945,13232.7,95520,644,471,91709,91691,91303,91189,87529
10795,388,1342,7772,3023,3.68489e+13,330.602,3063.63,10795,254,350,9328,8681,8382,8019,3518
77998,308,2303,53868,24130,3.65665e+13,861.974,9044.55,77998,548,569,70732,64283,37060,15770,17351
7771,693,850,5597,2174,3.76055e+13,268.293,2029.34,7771,192,210,6921,6908,6882,6832,5922
57399,1219,3130,39648,17751,3.43772e+13,654.35,9780.53,57399,380,644,54269,53821,52294,50323,31069
65615,1942,3167,45805,19810,3.64961e+13,880.461,10445.8,65615,482,574,62448,62234,61109,59368,48766
61645,905,2535,43255,18390,3.55507e+13,1064.95,8893.88,61645,559,474,58338,56325,49841,35122,29992
33510,1688,2170,23121,10389,3.5679e+13,538.874,6248.4,33510,385,404,31340,31333,30777,29860,28687
18198,1057,1512,12812,5386,3.68584e+13,530.528,4090.37,18198,270,278,16686,16396,16462,16317,14693
61914,1477,3055,43649,18265,3.53814e+13,781.761,9567.06,61914,451,601,58859,58442,55972,51374,32797
56792,1283,2811,39568,17224,3.45972e+13,898.683,9046.02,56792,507,443,53981,53082,49773,43055,32046
4173,146,424,2774,1399,2.77224e+13,95.1045,998.1,4173,107,91,3749,3699,1759,1516,729
98007,2497,3426,67704,30303,3.42234e+13,1037.48,12968.1,98007,901,469,94581,94518,91189,84731,78743
78507,3205,3668,54304,24203,3.57039e+13,1076.7,11942.3,78507,618,774,74839,74837,73718,70820,72004
40292,889,1902,28189,12103,3.28213e+13,713.86,6287.96,40292,380,424,38269,36978,36032,34600,26671
44310,581,2317,30270,14040,3.41415e+13,810.306,7503.33,44310,483,403,40850,38574,28615,22024,18236
11529,454,1077,7794,3735,3.34797e+13,324.462,2800.74,11529,305,222,10452,9882,8701,7197,6968
32731,1901,2678,22467,10264,3.55722e+13,629.709,7078.5,32731,479,538,30053,29964,29641,29604,25749
80981,2177,2906,57073,23908,3.63074e+13,990.674,10230.2,80981,589,520,78075,77899,77219,76892,70009
13809,668,1340,9344,4465,3.33622e+13,402.272,3283.18,13809,276,227,12469,12182,11423,10321,9165
45880,1232,2354,31339,14541,3.48175e+13,615.75,7531.03,45880,404,497,43526,43335,41189,39081,27538
21316,253,1569,15024,6292,3.76214e+13,509.828,4286.81,21316,379,297,18288,16418,11653,8396,5072
47269,1623,2266,32839,14430,3.66336e+13,960.889,7604.69,47269,480,664,45003,44151,43348,39120,37599
99052,1333,3780,68022,31030,3.6023e+13,1028.38,12441.1,99052,718,571,95161,93906,77337,57871,59382
25215,817,1423,17302,7913,3.35296e+13,561.508,4560.65,25215,347,316,23740,23468,22293,20228,16840
70193,1982,3721,47888,22305,3.49968e+13,850.022,11677.5,70193,523,672,66472,66336,63789,57522,50192
67543,2153,2760,46339,21204,3.52662e+13,711.153,9445.67,67543,437,438,64783,64699,64375,64290,59857
43414,2459,2823,30126,13288,3.57279e+13,627.424,8296.11,43414,360,469,40591,40582,40458,40439,37440
61179,40600,61179,0,61179,15.9997,0,61179,61179,61179,1,0,0,0,0,0
36353,2382,2468,25315,11038,3.58611e+13,698.289,7168.85,36353,557,360,33885,33885,33855,33884,33550
87962,468,2699,61007,26955,3.56979e+13,1086.71,10418.7,87962,592,547,81417,77720,51752,37771,24985
44082,862,2161,30867,13215,3.5353e+13,678.227,7007.08,44082,439,412,41902,41100,37944,28225,26907
65012,1400,2882,45163,19849,3.5326e+13,948.12,9626.13,65012,614,459,62130,61327,56647,46492,43251
98347,959,4104,68886,29461,3.65184e+13,1133.96,14289.9,98347,614,613,93289,90954,68442,48901,38653
12099,1285,1345,8075,4024,3.30851e+13,237.212,3188.43,12099,330,185,10754,10753,10747,10748,10560
73868,760,2247,50744,23124,3.57435e+13,775.36,8003.63,73868,496,424,71343,70211,59054,44022,46852
53350,1392,2286,37336,16014,3.22825e+13,833.536,7770.78,53350,428,421,51064,50585,49218,45881,35762
86877,1379,3268,60942,25935,3.59909e+13,1095.65,11587.9,86877,730,531,83243,82016,71536,52697,53082
99913,1920,3305,70384,29529,3.55322e+13,1252.85,12319,99913,709,527,96608,95727,89998,75211,70417
33149,1543,1833,22972,10177,3.37034e+13,737.161,5796.14,33149,370,320,31316,31051,31233,30931,28522
50616,1347,2659,35489,15127,3.63593e+13,742.396,8481.58,50616,486,451,47957,47713,43380,37051,25735
35449,1978,2297,24904,10545,3.48464e+13,631.433,6723.18,35449,343,418,33152,33089,33008,33089,31781
32800,1699,2120,23230,9570,3.56248e+13,682.575,6128.67,32800,359,401,30680,30641,30443,30553,28528
60501,33193,60501,0,60501,15.9997,0,60501,60501,60501,1,0,0,0,0,0
61006,2687,2744,42051,18955,3.60919e+13,943.75,9283.39,61006,593,623,58262,58262,58240,58259,58202
79440,1963,3357,55186,24254,3.68124e+13,899.935,10615.5,79440,572,531,76083,75569,71190,57827,58761
64067,2335,2822,44431,19636,3.48221e+13,838.712,9409.75,64067,457,482,61245,61151,60688,60473,54675
57123,38,2454,40139,16984,3.67404e+13,994.689,8498.23,57123,594,374,38775,31030,24514,8975,4516
62779,2136,3238,43638,19141,3.42511e+13,840.45,10111.7,62779,509,480,59541,59264,58805,58042,47877
90915,1580,3844,63574,27341,3.6506e+13,1136.17,13005,90915,625,719,86934,85796,79313,62984,49003
38998,2320,2524,26984,12014,3.53374e+13,637.652,6976.23,38998,374,380,36474,36474,36433,36455,35841
23078,1876,1945,16322,6756,3.44737e+13,388.526,5126.34,23078,377,295,21133,21130,21133,21133,20531
34228,701,1875,24005,10223,3.41826e+13,568.806,5821.42,34228,393,329,32045,31206,28852,20235,16705
33326,809,2150,23305,10021,3.55353e+13,481.251,6248.35,33326,418,395,31176,30913,26683,21312,14370
22862,128,1606,15746,7116,3.31294e+13,432.308,4510.59,22862,276,273,19669,18130,12701,6108,4536
22685,831,1534,15841,6844,3.73582e+13,613.991,4542.08,22685,422,300,21038,20308,19409,16904,14577
90837,2866,3063,64061,26776,3.60883e+13,1089.9,11720.6,90837,684,580,87774,87773,87666,87598,86569
84954,2720,3597,58511,26443,3.51643e+13,993.472,12243.9,84954,678,524,81357,81326,79522,73749,69571
61439,1998,2278,43905,17534,3.63446e+13,939.396,8439.66,61439,590,470,59161,59118,58817,58326,56180
34067,1874,1942,23961,10106,3.50066e+13,542.922,6085.73,34067,310,435,32125,32125,32120,32125,31963
31024,401,1523,22213,8811,3.71663e+13,615.275,5051.4,31024,446,283,28598,27458,23323,15914,13418
59916,1021,3147,40564,19352,3.42536e+13,824.296,9700.92,59916,497,435,56562,55512,39207,29646,26702
36501,279,1661,25750,10751,3.59995e+13,791.641,5688.89,36501,452,375,31327,28296,20663,7284,7999
31160,883,1805,21643,9517,3.68621e+13,451.45,5458.97,31160,374,337,29355,29240,27643,24151,21096
93314,982,2974,63548,29766,3.58632e+13,1320.01,10816.4,93314,561,592,89017,86766,66066,48880,49696
71393,881,3190,49212,22181,3.6327e+13,1240.9,10725.9,71393,621,722,67123,65293,51212,42547,24412
71555,1663,3725,50395,21160,3.60699e+13,906.206,12167.9,71555,518,662,67830,67241,66155,64990,48058
39226,2469,2580,27727,11499,3.53871e+13,802.781,7368.91,39226,447,458,36646,36643,36631,36640,36418
41735,756,1551,30548,11187,3.63156e+13,919.8,6094.65,41735,539,350,39150,37452,35511,29328,24166
61296,1112,2802,42326,18970,3.51117e+13,1004.95,9206.9,61296,551,548,58090,56449,49548,37415,35828
23205,753,1649,16106,7099,3.34757e+13,457.549,4529.46,23205,298,339,21510,20844,19814,17164,12283
39274,1043,1875,26805,12469,3.57293e+13,564.073,5880.98,39274,377,318,37399,37116,35770,33519,31040
81361,104,2736,57361,24000,3.65651e+13,1073.62,10424.1,81361,577,532,64425,55941,40465,11447,8924
70597,1339,3131,48754,21843,3.5948e+13,747.215,9957.11,70597,642,437,67466,67046,57906,48387,43088
61527,1421,2487,43582,17945,3.62415e+13,956.175,8707.61,61527,598,477,59040,58176,53670,43676,43780
4179,396,773,3044,1135,4.2233e+13,146.769,1430.66,4179,152,121,3406,3311,3321,3317,2511
58782,658,2366,41002,17780,3.52842e+13,1014.57,8321.35,58782,522,455,55164,53730,45957,32175,27051
77528,1680,2423,54171,23357,3.35354e+13,1048.81,9317.52,77528,552,520,75105,74437,72462,68059,64036
27117,704,2168,18744,8373,3.55176e+13,474.557,5877.3,27117,286,409,24894,24428,23112,22218,9452
12976,282,1102,8777,4199,3.35832e+13,386.251,2837.76,12976,256,228,11521,10936,8577,6574,5852
6417,213,887,4350,2067,3.50084e+13,163.384,1957.38,6417,139,232,5484,5067,4740,4809,1558
16180,758,1350,11406,4774,3.81952e+13,301.233,3416.82,16180,253,237,14830,14792,14592,14553,11885
47870,1776,2133,34083,13787,3.69678e+13,726.91,7313.6,47870,578,369,45737,45729,45116,43048,43351
86320,1297,3254,59358,26962,3.57534e+13,1023.21,11625.5,86320,643,599,82934,81577,66777,49632,44825
67675,2169,2712,46911,20764,3.44367e+13,824.788,9333,67675,590,428,64963,64908,63727,61451,59297
56311,1634,2584,39966,16345,3.71134e+13,1123.24,8746.89,56311,551,527,53727,52693,51149,46720,42014
16009,1132,1173,10863,5146,3.48271e+13,542.649,3409.81,16009,275,295,14836,14836,14814,14806,14793
30368,450,1748,20788,9580,3.60461e+13,475.211,5303.93,30368,324,308,28320,26297,18566,14735,13195
97553,3288,4166,67749,29804,3.57141e+13,1173.65,14156.7,97553,615,731,93387,93275,92889,93079,84614
95495,3038,3796,65503,29992,3.46954e+13,1019.21,12832.7,95495,701,542,91699,91566,90311,87555,85374
46564,681,2146,32251,14313,3.30948e+13,648.106,7090.29,46564,432,404,43833,42398,34645,25570,19641
81267,2369,2638,56921,24346,3.61281e+13,889.888,9710.97,81267,515,595,78629,78629,77979,76777,76682
66084,1493,2515,45005,21079,3.30707e+13,605.537,8231.91,66084,416,467,63569,63464,59413,52386,51402
95133,3451,3735,66583,28550,3.65747e+13,1106.66,12809,95133,792,609,91398,91390,91250,91182,90046
6944,143,856,5039,1905,3.63831e+13,216.106,1876.72,6944,208,133,5589,4805,4588,3948,2161
20966,326,1399,15021,5945,3.63335e+13,472.793,4072.36,20966,387,249,19035,17694,15760,11888,9054
41330,677,2129,27993,13337,3.29062e+13,615.23,6873.16,41330,424,415,38973,38117,32812,24276,17590
8143,190,1026,5591,2552,3.34646e+13,206.463,2255.63,8143,194,210,6981,6559,5580,4846,3055
93525,2679,3341,64703,28822,3.56359e+13,1197.47,12147.8,93525,697,726,90184,89859,87636,80535,78569
35665,2178,2236,24306,11359,3.31001e+13,496.49,6587.23,35665,363,529,33429,33429,33426,33427,33334
67686,2358,3467,46607,21079,3.49208e+13,980.434,10708.5,67686,504,591,64219,63921,62926,61120,52668
39613,520,1671,27343,12270,3.22897e+13,802.454,5641.81,39613,366,398,36914,35566,30857,20877,17608
17514,871,1270,12327,5187,3.82548e+13,649.002,3687.1,17514,327,290,16203,15639,15490,14846,13592
38741,1868,2049,26830,11911,3.23127e+13,640.935,6369.9,38741,480,352,36692,36598,36661,36643,34868
89633,3200,3386,61993,27640,3.60874e+13,1050.26,11681.8,89633,702,571,86247,86246,86120,85893,85584
9278,783,858,6413,2865,3.22507e+13,258.216,2142.35,9278,151,183,8420,8420,8418,8420,8223
34508,213,1709,24026,10482,3.33104e+13,842.345,5543.38,34508,397,401,30497,28549,19926,10400,8325
1624,179,434,1099,525,3.97012e+13,82.4464,707.107,1624,103,101,1190,1104,1102,1117,696
53690,2210,2726,37308,16382,3.63418e+13,1023.09,8883.7,53690,524,516,50964,50901,49856,47475,47429
92772,1902,3261,64148,28624,3.49553e+13,884.837,11549.9,92772,619,481,89511,89386,81063,63054,70517
36807,421,2397,25652,11155,3.64731e+13,630.174,6665.59,36807,496,432,33589,31604,23436,18451,12891
86157,59,3364,59465,26692,3.56517e+13,987.073,11748.4,86157,541,612,63012,52686,38249,13789,7495
60807,2129,2549,42487,18320,3.57748e+13,872.188,8885.12,60807,535,515,58258,58212,58131,57762,55287
89522,2504,3178,61675,27847,3.42872e+13,942.496,11248.9,89522,642,610,86344,86165,84129,77362,76306
64503,2338,3344,44151,20352,3.45841e+13,958.828,10374.1,64503,451,556,61159,60955,60084,58838,52454
71166,2362,2678,50850,20316,3.73639e+13,1114.15,10070,71166,586,530,68488,68414,68314,68326,66640
33409,380,1565,24130,9279,3.65993e+13,633.349,5137.73,33409,436,354,30532,28644,24840,18562,15931
81789,2665,3602,56584,25205,3.50337e+13,824.251,12123.3,81789,414,756,78187,78183,77766,77999,69876
13505,1238,1297,9864,3641,3.77275e+13,382.359,3289.92,13505,247,209,12208,12207,12198,12208,12102
35617,1009,2139,23923,11694,3.09686e+13,372.943,6387.47,35617,443,322,33478,33404,28914,22751,20019
71400,2194,3320,50440,20960,3.64737e+13,1028.02,11011.8,71400,777,622,68080,67590,65535,60249,57924
51871,596,1954,35820,16051,3.26317e+13,680.161,6929.97,51871,434,375,49299,47739,41308,34237,21499
71358,640,3057,50564,20794,3.69076e+13,1268.4,10165.2,71358,638,638,66641,64955,42656,28341,20621
79995,2526,3018,55207,24788,3.54779e+13,1056.77,10863.8,79995,618,587,76977,76977,76779,76725,73991
32927,1623,1908,23223,9704,3.6926e+13,887.621,6049.5,32927,506,463,31019,30991,30413,30042,29240
73904,405,2820,51093,22811,3.51827e+13,1135.12,9935.08,73904,581,561,67340,63443,42152,22281,16442
57711,845,2704,40007,17704,3.59737e+13,890.264,8971.86,57711,538,443,54562,53600,44509,30945,26663
90154,2223,3207,64275,25879,3.68178e+13,1197.6,11660.1,90154,679,544,86947,86607,84760,81762,74196
50991,1293,2647,35119,15872,3.37813e+13,573.173,8154.02,50991,557,439,48344,48018,41866,34314,30461
29160,1148,1660,19891,9269,3.59899e+13,564.289,5124.21,29160,350,372,27500,27310,26993,26802,24225
36726,647,2121,25313,11413,3.39091e+13,525.48,6351.81,36726,421,308,34520,33810,29174,22481,17112
46246,920,2459,32834,13412,3.49358e+13,798.619,7589.51,46246,535,415,43605,42649,39306,32812,18460
93902,3237,3724,64619,29283,3.43401e+13,961.305,12342.3,93902,671,476,90178,90177,89972,89792,87300
97330,592,3686,67524,29806,3.50323e+13,1041.71,12779.2,97330,591,560,91699,88619,61813,42857,29735
28089,80,1936,19978,8111,3.78635e+13,489.868,5393.05,28089,372,329,21202,18610,13481,4408,2637
45463,754,1929,32544,12919,3.66083e+13,879.529,6596.51,45463,490,429,43041,41496,38051,33062,24205
7959,813,1032,5375,2584,3.54445e+13,225.316,2332.86,7959,205,183,6927,6926,6887,6892,6455
18678,582,1693,13356,5322,3.49116e+13,382.276,4320.57,18678,391,330,16954,16364,14245,11143,7749
77041,2619,3107,52387,24654,3.3816e+13,1195.63,10804.9,77041,546,502,73934,73639,73448,73017,71787
55678,2526,2596,39531,16147,3.66972e+13,969.261,8597.57,55678,537,462,53082,53082,53058,53066,53013
82875,1969,3540,57019,25856,3.44083e+13,1213.89,11832.3,82875,532,634,79335,78251,74734,65192,64751
97175,1940,2600,66506,30669,3.2498e+13,1294.3,11115,97175,568,593,94575,93845,93233,90867,83144
10020,160,1155,6778,3242,3.41905e+13,303.174,2682.11,10020,282,217,8342,7617,6149,4661,2323
35949,1478,1831,25230,10719,3.36566e+13,803.909,5793.53,35949,410,326,34118,33999,33869,33822,31645
68389,904,2225,48669,19720,3.62532e+13,940.018,8725.94,68389,475,478,65653,64289,57831,41479,31944
54224,2435,2577,38140,16084,3.57925e+13,896.604,8466.16,54224,440,478,51647,51640,51587,51579,50930
89093,1055,3093,62272,26821,3.55519e+13,976.214,10865.9,89093,598,478,85859,83850,73782,54788,53715
34144,1003,1916,23412,10732,3.54125e+13,444.98,5296.83,34144,445,268,32228,32082,30122,27067,25585
46649,858,2150,32237,14412,3.52644e+13,621.298,7155.4,46649,403,419,44474,43293,38952,32722,25471
18588,588,1132,12655,5933,3.54112e+13,469.452,3399.64,18588,290,299,17421,16668,14874,11865,13357
21264,5008,21264,0,21264,15.9992,0,21264,21264,21264,1,0,0,0,0,0
9837,563,1188,6873,2964,3.72739e+13,219.957,2751.21,9837,184,246,8649,8594,8436,8350,5768
52808,1579,1927,37505,15303,3.41041e+13,973.742,7005.68,52808,504,361,50881,50832,49808,48499,46178
43707,2373,2834,30104,13603,3.44734e+13,640.427,7925.85,43707,463,556,40873,40857,39693,38806,36240
49684,2462,2553,34803,14881,3.63043e+13,907.601,8507.98,49684,499,508,47131,47131,47086,47118,46954
74528,3207,3810,50868,23660,3.52529e+13,838.19,12166.8,74528,620,557,70718,70685,70432,70448,66777
11307,1162,1220,8174,3133,3.70838e+13,409.992,2906.74,11307,281,253,10087,10077,10080,10087,9968
7469,195,360,4988,2481,2.62847e+13,119.039,1210.71,7469,114,107,7109,7076,6583,6646,4991
28150,508,1885,19214,8936,3.37402e+13,572.706,5407.18,28150,330,363,25948,25243,22644,18533,10339
15792,69,1088,11013,4779,3.56434e+13,309.598,2937.95,15792,269,265,11494,9775,7592,2901,2409
38847,510,2622,28028,10819,3.81789e+13,679.286,7653.91,38847,483,503,35323,33410,30525,23014,14591
96699,235,3946,65898,30801,3.41743e+13,981.612,13509.4,96699,689,691,85387,76545,50568,21554,14695
4112,90,519,2975,1137,3.93622e+13,195.553,1152.06,4112,157,111,3136,2674,2510,2522,935
3357,590,657,2478,879,3.979e+13,115.448,1192.5,3357,185,120,2700,2696,2699,2700,2596
11002,204,973,7942,3060,3.86989e+13,468.438,2563.63,11002,270,228,9136,8282,6944,5114,3959
76322,2499,3128,53944,22378,3.66066e+13,848.198,10944.2,76322,472,542,73194,73163,72913,72925,67293
6215,74,626,4314,1901,2.79681e+13,134.729,1474.54,6215,139,115,4925,3719,2717,810,586
43430,1906,2756,29679,13751,3.51862e+13,945.159,8233.25,43430,600,679,40674,40332,39448,37455,35417
16637,120,1443,11534,5103,3.33499e+13,475.267,3805.6,16637,229,328,13771,12522,9348,4812,3045
73821,1062,2802,52975,20846,3.73078e+13,1140.09,10152.8,73821,588,490,70381,68431,63384,47030,42431
3798,539,544,2616,1182,3.4726e+13,249.714,1206.99,3798,166,147,3254,3253,3253,3252,3254
83042,441,2538,57428,25614,3.35811e+13,1213.22,9927.62,83042,674,504,76461,73177,46836,31938,22799
68009,1825,3085,47326,20683,3.52564e+13,1010.71,10341.3,68009,563,566,64924,64304,60631,51210,52514
37609,404,1938,26360,11249,3.59059e+13,797.567,6225.82,37609,425,452,34195,32598,27501,19766,13263
71581,1847,2539,50743,20838,3.53215e+13,1042.81,9302.73,71581,701,484,69042,68590,67127,64360,57993
10717,352,1397,7528,3189,3.63034e+13,233.171,3035.87,10717,283,298,9315,8818,8043,7422,3389
17142,14,1339,11887,5255,3.33565e+13,325.777,3743.2,17142,269,226,8883,5350,5037,2760,1161
5948,298,454,4267,1681,3.63717e+13,235.383,1289.19,5948,141,123,5494,5071,5063,5162,4553
90005,2765,2984,63536,26469,3.57786e+13,1185.79,10975.5,90005,613,518,87021,87020,86934,86942,86250
95538,477,3310,67434,28104,3.7038e+13,981.33,11953,95538,689,471,88795,83683,61012,38122,28591
10055,52,979,7126,2929,3.74449e+13,484.06,2499.59,10055,257,230,7059,5909,4364,1900,828
3011,164,362,1960,1051,3.01493e+13,92.4683,828.757,3011,107,86,2649,2567,2387,2365,1517
60187,129,2779,41506,18681,3.527e+13,740.801,8709.84,60187,582,533,48837,41352,28455,8943,6794
30987,1831,1881,22605,8382,3.79085e+13,698.245,5528.7,30987,467,376,29106,29106,29090,29097,29040
55034,51,2676,38199,16835,3.44314e+13,1025.49,8661.63,55034,491,614,39971,31692,23369,8271,5047
5533,400,945,3744,1789,3.64854e+13,189.992,1886.6,5533,223,142,4588,4364,3613,2954,2501
67055,961,2695,48478,18577,3.6692e+13,893.547,9877.39,67055,463,553,63982,62589,59664,53644,38710
42763,2939,3125,29594,13169,3.55335e+13,776.716,8612.16,42763,468,594,39638,39638,39584,39512,38566
85861,978,2724,61966,23895,3.64762e+13,1251.76,10934.7,85861,640,592,81915,79706,71127,51172,41673
83230,2122,2776,58130,25100,3.33509e+13,966.862,10548.1,83230,595,638,80454,80393,78476,74158,69213
29798,982,2469,21333,8465,3.73717e+13,465.049,6604.94,29798,355,569,27329,27094,26264,25665,12902
72209,437,3563,50529,21680,3.53925e+13,914.485,11476,72209,597,690,66052,62296,43708,26302,16434
80130,2749,2840,56044,24086,3.58438e+13,906.073,9930.98,80130,543,533,77290,77290,77261,77281,77083
28486,1027,1341,20567,7919,3.70005e+13,792.401,4450.44,28486,336,318,26997,26243,26559,25779,23222
54614,887,2415,37460,17154,3.49431e+13,777.121,7715.39,54614,545,415,51990,50845,41346,30451,34381
18735,1131,1205,12677,6058,3.47502e+13,512.029,3662.41,18735,306,315,17530,17509,17501,17496,17319
35923,816,1611,24468,11455,3.14952e+13,612.935,5407.16,35923,315,367,34178,33545,32327,31079,18091
46540,1587,2297,32980,13560,3.6921e+13,765.591,7572.42,46540,405,495,44243,44120,43905,43375,38325
65426,1504,3502,45602,19824,3.5161e+13,999.009,11257,65426,451,617,61818,60811,58324,47930,37084
94392,1035,2871,66909,27483,3.71555e+13,1262.98,11168.3,94392,581,607,90564,88743,79496,60226,47757
88762,2285,2757,62488,26274,3.59179e+13,990.685,10808.3,88762,552,554,86005,85951,85792,85709,82023
75225,1441,2948,51949,23276,3.26188e+13,1050.78,10575.7,75225,535,584,72200,71265,67651,56600,41076
36907,1341,1661,24969,11938,3.58038e+13,685.264,5586.47,36907,388,417,35246,35187,34530,33570,33679
7618,727,990,5201,2417,3.37789e+13,258.029,2182.08,7618,250,195,6628,6625,5955,4943,5215
14960,1588,1773,10540,4420,3.67986e+13,320.657,3977.23,14960,464,226,13187,13187,13107,13095,12674
8570,69,600,5860,2710,2.84107e+13,183.097,1639.31,8570,187,125,6909,4993,3921,1616,2179
93612,1692,3277,64940,28672,3.41937e+13,1027.72,11691,93612,603,482,90335,89732,85189,73110,66577
23380,720,1690,16240,7140,3.47369e+13,577.728,4602,23380,334,275,21597,20966,19992,17563,11377
35306,698,1468,23990,11316,2.99074e+13,773.589,5205.95,35306,269,378,33405,32524,30704,26138,19048
20502,400,1093,14131,6371,3.7486e+13,292.054,3058.74,20502,256,203,19409,19198,17321,17311,14068
57218,2279,2411,40428,16790,3.70756e+13,890.944,8154.4,57218,556,535,54807,54807,54783,54729,54371
36456,2135,2328,25617,10839,3.67307e+13,651.483,6830.45,36456,602,550,34128,34125,33960,33435,33377
22933,863,1694,16165,6768,3.78624e+13,500.307,4572.26,22933,377,286,21239,20789,20150,18556,16470
45450,1415,2302,31856,13594,3.62157e+13,746.826,7431.62,45450,492,459,43148,43008,41596,40403,31146
36587,2161,2258,25179,11408,3.60162e+13,561.523,6622.27,36587,433,381,34329,34328,34319,34326,34102
27125,881,1989,18988,8137,3.65985e+13,643.063,5477.34,27125,441,385,25094,24580,22826,18492,17849
13996,855,1170,9869,4127,3.59082e+13,309.379,3069.36,13996,265,240,12826,12798,12296,11234,11194
7738,478,1107,5595,2143,3.99665e+13,242.189,2323.19,7738,207,210,6631,6392,6348,6321,3715
31341,92,1742,21695,9646,3.46907e+13,596.295,5463.42,31341,407,379,25599,21923,15628,4836,3933
81154,488,2812,56895,24259,3.53872e+13,907.623,10179.1,81154,568,456,75388,70850,50430,32439,25186
53726,2933,3024,37028,16698,3.41057e+13,845.252,9198.89,53726,522,486,50702,50702,50690,50701,50551
6251,287,937,4325,1926,3.8349e+13,170.139,2019.56,6251,140,273,5314,4904,4808,4888,2481
83914,1537,2885,58387,25527,3.61233e+13,1041.01,10357.7,83914,586,447,81029,79940,73135,57350,57874
83158,1192,2515,58848,24310,3.64914e+13,1027.08,9962.42,83158,593,484,80260,78651,72639,56343,53997
52474,364,2771,36703,15771,3.67031e+13,597.33,8028.58,52474,624,346,48720,45213,29178,20838,14458
25783,914,1869,18102,7681,3.37434e+13,471.833,4904.26,25783,328,278,23914,23561,22928,20083,17000
25439,1171,1811,17632,7807,3.38269e+13,415.425,4878.94,25439,331,277,23628,23438,22993,22333,18195
23921,552,1780,16429,7492,3.54758e+13,411.413,4610.78,23921,352,300,22110,21380,19234,15820,13248
89040,716,2971,63258,25782,3.68211e+13,1140.67,11564.1,89040,710,556,84106,80448,62270,42029,34543
44176,1648,2450,31499,12677,3.70955e+13,709.398,7500.73,44176,534,461,41726,41664,40611,40193,33850
5516,377,906,3821,1695,3.62095e+13,242.612,1860.08,5516,223,210,4610,4312,4059,3636,2826
81570,1046,3436,56969,24601,3.60947e+13,1080.07,11476,81570,658,501,77619,75506,55810,42967,37145
9363,74,1062,6567,2796,3.31952e+13,216.204,2461.55,9363,150,228,7219,5782,4883,2932,932
82098,2323,2994,58349,23749,3.71441e+13,1026.24,11356.2,82098,744,666,79104,79081,77019,74357,66568
79440,2554,2603,54486,24954,3.34958e+13,1001.85,9994.96,79440,510,487,76837,76837,76833,76826,76734
64558,644,2304,46117,18441,3.59668e+13,1101.14,8761.32,64558,614,461,60729,58920,51624,35494,23642
21801,1250,1462,15185,6616,3.28053e+13,512.092,4124.76,21801,281,310,20339,20298,20123,20128,18089
39137,1097,2191,27671,11466,3.49017e+13,783.623,6739.74,39137,501,433,36864,36259,34141,27461,22415
36138,2497,2504,25262,10876,3.45429e+13,489.281,7230.74,36138,554,367,33634,33634,33634,33633,33627
27441,1100,1841,18650,8791,3.37623e+13,511.912,5261.74,27441,340,361,25600,25447,23895,21106,18603
4676,304,689,3306,1370,3.58872e+13,114.801,1438.25,4676,141,145,3987,3941,3855,3870,2223
84139,1128,3542,58216,25923,3.51979e+13,922.934,11925.5,84139,550,606,80529,79224,69278,49872,40407
17232,164,1358,11737,5495,3.58178e+13,317.75,3617.33,17232,267,251,14530,12872,9016,4470,4314
25520,1070,1340,17442,8078,3.102e+13,633.349,4270.08,25520,285,380,24180,23650,23774,23384,22493
42688,893,2119,29861,12827,3.57532e+13,748.359,6856.4,42688,417,416,40335,39331,35630,25326,23400
47182,1505,3009,33597,13585,3.71077e+13,682.949,8567.42,47182,409,510,44173,43862,42501,41232,24851
33535,1579,2132,23966,9569,3.62305e+13,493.997,6352.2,33535,375,447,31403,31393,31175,30894,25681
53281,88,2526,35475,17806,3.36541e+13,607.582,7840.26,53281,516,361,42178,36686,22269,8712,6392
53526,2420,2436,37134,16392,3.52998e+13,762.571,7877.67,53526,414,441,51090,51090,51090,51090,51080
94533,1008,2859,66432,28101,3.45124e+13,990.311,10993.5,94533,632,509,91176,89354,72334,48043,53999
95103,550,3743,66083,29020,3.64636e+13,1030.84,13073.2,95103,755,676,88965,85603,62034,44387,29199
10073,611,917,6824,3249,2.81712e+13,167.579,2265.47,10073,211,237,9156,9131,8586,6797,5922
12528,492,977,8621,3907,3.68851e+13,374.49,2645.09,12528,216,237,11551,11229,9799,7651,8636
14823,688,1175,10497,4326,3.59702e+13,363.363,3166.92,14823,277,192,13648,13545,12280,10370,9665
96545,2177,2890,67081,29464,3.2831e+13,1033.01,11355.6,96545,592,527,93655,93605,93356,92643,82809
2886,20,627,2064,822,3.94556e+13,130.486,1116.09,2886,131,111,1758,1391,1005,333,215
15220,1257,1450,10328,4892,3.4042e+13,453.225,3669.41,15220,259,271,13770,13762,13725,13663,12884
5595,269,488,3873,1722,3.73829e+13,245.387,1282.68,5595,147,142,5031,4302,4421,3815,4042
72043,669,2553,50184,21859,3.54774e+13,920.285,9085.24,72043,580,449,68591,66543,50812,35139,34615
11961,1409,1509,8701,3260,3.93142e+13,313.787,3395.36,11961,214,255,10452,10452,10440,10449,10309
47592,286,3035,33265,14327,3.70773e+13,761.315,8563.1,47592,537,525,41926,37273,25436,13598,9165
92064,2894,3328,64155,27909,3.56348e+13,1014.7,11844.1,92064,641,531,88736,88733,88308,87972,84449
26852,467,1619,19197,7655,3.70663e+13,681.377,4846.48,26852,402,310,24669,23486,20366,14965,12496
79701,894,3240,56132,23569,3.65367e+13,1058.42,11579.3,79701,717,497,75565,73537,54935,39484,33549
50668,2813,2891,35332,15336,3.53472e+13,779.169,8851.06,50668,508,581,47777,47777,47760,47767,47400
37561,314,2534,26968,10593,3.77945e+13,728.967,7324.61,37561,401,469,32952,30074,21755,13358,8891
79142,1773,3660,55464,23678,3.66212e+13,898.177,11592.8,79142,551,638,75482,75226,68552,56469,40196
47688,70,2675,33392,14296,3.68441e+13,911.829,8316.27,47688,554,516,35392,30042,21463,8717,4947
17910,956,1436,12573,5337,3.62279e+13,456.762,3907.42,17910,321,331,16474,16231,16051,15988,13428
85794,469,2466,59594,26200,3.305e+13,1226.46,9596.39,85794,641,541,79588,75327,48574,30354,27040
75392,443,3574,52189,23203,3.56149e+13,1076.86,11909.9,75392,808,523,67826,63308,40029,18665,14610
33759,537,1422,23125,10634,3.12337e+13,805.312,5042.68,33759,332,378,31568,30444,27679,23673,12894
19409,421,1776,13556,5853,3.57521e+13,404.049,4592.22,19409,310,388,17371,16616,15015,12965,6889
96059,31631,96059,0,96059,15.9998,0,96059,96059,96059,1,0,0,0,0,0
61372,2202,3189,42155,19217,3.45035e+13,696.513,9857.63,61372,433,459,58183,58102,56980,55476,45659
77162,529,2043,53461,23701,3.09242e+13,1028.58,8195.92,77162,508,522,72062,68647,52232,39342,32293
87714,313,2462,61469,26245,3.43796e+13,1115.43,9852.3,87714,646,463,79449,72481,50670,22164,19509
29676,382,1636,21005,8671,3.65019e+13,660.629,5173.33,29676,388,332,26992,25308,20747,17203,10253
90998,2971,4127,62668,28330,3.51771e+13,1126.93,13324.9,90998,581,725,86871,86720,86178,86067,77571
39921,638,2083,27494,12427,3.55801e+13,694.366,6653.89,39921,404,428,37437,36440,28978,18550,18468
96073,827,3730,66760,29313,3.60385e+13,1223.76,12946.2,96073,718,673,90382,87336,61157,47045,27764
50058,301,1810,35759,14299,3.71275e+13,777.625,6671.61,50058,474,370,45191,40317,30469,18897,13643
92803,2413,3244,64687,28116,3.60543e+13,1202.02,12113.2,92803,608,597,89559,89301,87481,84696,80176
92182,435,3679,63199,28983,3.55331e+13,1014.78,12796.6,92182,684,738,84480,79526,49347,24709,18555
43581,1573,1912,31187,12394,3.80278e+13,815.1,6587.42,43581,493,465,41669,41652,41134,40640,38429
43501,1761,2739,30747,12754,3.65817e+13,759.642,8018.77,43501,454,381,40762,40616,39376,37327,31391
13879,1334,1366,9691,4188,3.57432e+13,428.832,3378.38,13879,276,227,12513,12462,12511,12507,12416
53386,774,2297,36543,16843,3.42703e+13,783.803,7800.58,53386,452,513,50571,49101,44016,35204,22969
34519,733,2171,23855,10664,3.64107e+13,708.864,6355.29,34519,433,382,32013,30908,26702,19739,18227
51447,689,2534,34914,16533,3.20655e+13,896.418,8211.39,51447,537,507,48102,46542,37465,31687,21195
87251,2179,3324,61885,25366,3.68186e+13,1034.24,12020.9,87251,669,688,83927,83666,81725,80859,65893
88988,543,3390,60862,28126,3.44759e+13,887.223,11383,88988,692,641,84024,81674,52939,34266,29269
73121,1157,2484,52508,20613,3.63102e+13,857.053,9894.78,73121,612,555,70625,69792,65991,60318,46420
55755,724,2462,38019,17736,3.5089e+13,723.741,8705.35,55755,392,610,52587,50627,47413,37950,25055
49831,521,2451,35569,14262,3.59623e+13,885.721,8057.32,49831,533,380,45618,43102,32271,23523,13800
39529,1759,2296,27760,11769,3.57607e+13,732.939,6830.44,39529,485,406,37233,37138,36668,35084,34598
26755,588,1539,18387,8368,3.50297e+13,505.185,4622.57,26755,333,323,24970,24235,22763,19390,14375
59295,1283,2442,40500,18795,3.13413e+13,752.441,8430.81,59295,422,455,56853,56126,55138,53221,43474
8750,599,1188,6103,2647,3.76763e+13,209.525,2632.64,8750,169,281,7562,7536,7346,7328,4874
37230,1413,2116,26509,10721,3.66812e+13,586.229,6310.37,37230,394,350,35114,34996,34478,33544,30103
46999,103,2255,33352,13647,3.50434e+13,673.354,7509.61,46999,469,447,37365,32406,24525,7645,6547
47322,523,2570,33804,13518,3.70153e+13,731.462,7943.62,47322,526,452,43655,41518,32161,21913,14523
62866,1587,2684,42822,20044,3.53164e+13,992.877,9290.94,62866,526,599,60182,59720,56707,51532,43790
9822,283,1128,6752,3070,3.39767e+13,253.347,2665.94,9822,247,234,8555,7787,6039,4891,3193
47859,1057,2041,33745,14114,3.64993e+13,747.951,7025.39,47859,466,362,45818,45530,43892,39516,37762
8800,878,1139,6049,2751,3.56993e+13,215.48,2503.89,8800,244,250,7661,7659,7619,7619,6837
78990,3104,3634,54812,24178,3.52297e+13,877.012,12298.1,78990,784,590,75356,75344,74066,70045,69124
82762,3392,3400,57448,25314,3.5702e+13,1117.67,11806.1,82762,621,532,79362,79362,79357,79356,79356
66108,241,2845,46190,19918,3.58868e+13,965.007,9282.84,66108,537,474,58170,51167,34341,11981,11412
32938,1910,2275,23248,9690,3.68084e+13,602.075,6662.67,32938,429,405,30663,30627,30536,30435,27643
71998,242,1834,51158,20840,3.43895e+13,952.568,7884.37,71998,500,450,64073,59316,41118,18890,17128
60332,116,2668,40408,19924,3.31479e+13,662.032,8903.9,60332,388,620,50738,45495,24953,11407,7623
64217,27,2652,44744,19473,3.55238e+13,976.292,9205.43,64217,577,534,40434,30587,22986,10071,4563
88950,2063,3944,61442,27508,3.53933e+13,1033.44,12944.9,88950,684,640,85006,84269,78229,67647,53773
90043,1540,2806,63305,26738,3.60947e+13,1134.11,10981.4,90043,714,534,87237,86249,80366,62964,61004
14117,228,1002,9941,4176,3.69361e+13,294.497,2723.81,14117,220,194,12368,10602,9589,6472,7045
99908,3267,3735,69629,30279,3.5125e+13,1250.03,12865.5,99908,601,751,96173,96155,95947,95940,93092
31786,420,1832,21540,10246,3.24267e+13,673.024,5413.36,31786,344,337,29092,27204,20615,14241,11532
30095,543,2193,21493,8602,3.60364e+13,681.53,6219.22,30095,411,424,27297,26370,21497,14056,11668
84378,2047,3004,59199,25179,3.41393e+13,1104.31,10893.7,84378,612,526,81374,81157,79137,75609,64708
87590,1346,3286,61968,25622,3.62493e+13,939.588,11939.4,87590,600,602,84256,83383,77149,61743,49055
3003,286,603,2080,923,3.53902e+13,163.227,1156.45,3003,126,161,2400,2245,2168,2082,1374
9048,84,1076,6658,2390,3.8551e+13,334.51,2430.1,9048,225,189,6989,6205,4772,2761,1741
47373,957,2490,32589,14784,3.50339e+13,770.055,7945.72,47373,455,508,44597,43713,40024,33339,22825
95867,453,3114,68175,27692,3.74337e+13,1122.36,11954,95867,667,612,87804,82762,59087,33576,27310
24303,470,1782,16828,7475,3.34499e+13,432.899,4977.94,24303,344,296,22213,21201,18774,14902,11067
79522,213,3042,55406,24116,3.54121e+13,979.427,10401.8,79522,637,475,68127,59776,41251,17194,13109
10399,416,687,7121,3278,3.77248e+13,246.293,1951.93,10399,187,179,9712,9712,9330,9223,8842
44329,806,1894,29906,14423,3.48345e+13,790.524,6544.59,44329,450,503,42109,40985,30927,25330,27809
93363,2289,3357,64154,29209,3.56392e+13,1050.28,11655.2,93363,571,573,90006,89793,86396,78761,77450
65149,594,3273,44492,20657,3.26897e+13,815.404,10269.5,65149,596,716,60802,58524,45119,37846,25125
34674,662,2227,24439,10235,3.70009e+13,732.224,6264.38,34674,467,385,31930,30575,24249,18267,16781
92769,1421,3177,66080,26689,3.6642e+13,1101,11861.1,92769,675,517,89592,88088,81462,62556,63755
48889,1847,2052,33784,15105,3.13726e+13,834.27,6976.54,48889,390,374,46837,46603,46765,46742,45278
40661,130,1624,29152,11509,3.74655e+13,669.372,5902.61,40661,487,384,32895,28799,21949,9321,6117
52052,1658,2421,37060,14992,3.70829e+13,873.544,8174.02,52052,528,445,49631,49131,48885,48484,44943
38086,985,2570,26346,11740,3.40048e+13,554.904,7444.05,38086,334,583,35516,35037,33713,31909,18317
84272,227,3408,59466,24806,3.62573e+13,1249.48,11418.5,84272,636,548,72385,63918,43601,15092,12636
85636,1587,3413,60162,25474,3.70238e+13,1121.51,11221.8,85636,755,617,82015,80943,72685,57372,57336
91083,3434,4473,64354,26729,3.55191e+13,1070.9,14572,91083,783,578,86610,86564,85396,84626,73034
99537,1892,3629,69455,30082,3.53561e+13,1124.57,13150.4,99537,753,493,95908,94781,87328,66299,67015
20473,625,1231,14376,6097,3.16256e+13,673.242,3609.76,20473,281,226,18952,18412,18106,16570,10097
9594,1141,1180,6943,2651,3.88033e+13,330.025,2630.43,9594,204,188,8414,8414,8414,8414,8386
6847,390,1036,5009,1838,3.9124e+13,222.686,2113.88,6847,227,194,5811,5571,5325,4390,2789
28724,49,1755,20070,8654,3.67865e+13,485.235,5245.02,28724,286,397,20074,16421,12631,4294,3347
47007,1089,2761,33897,13110,3.70367e+13,648.964,8543.68,47007,386,500,44246,43337,42653,40110,24952
9946,335,1088,6722,3224,3.21666e+13,225.845,2610.51,9946,202,283,8834,8462,8191,7997,4720
28492,1077,2113,20197,8295,3.58595e+13,578.079,5928.82,28492,386,404,26379,25818,25182,22532,17555
10084,653,1163,7277,2807,3.21427e+13,193.051,2582.1,10084,217,148,8921,8877,8370,8230,5103
50560,2100,3062,34482,16078,3.2367e+13,607.085,9038.57,50560,592,392,47498,47456,45206,39023,38803
66188,957,2477,46255,19933,3.59e+13,1000.38,8758.89,66188,527,419,62979,61549,54252,41042,37589
51882,395,2101,36158,15724,3.31455e+13,900.56,7492.19,51882,475,446,47443,44696,35393,25388,13397
85815,809,2069,61402,24413,3.72852e+13,1149.94,9564.79,85815,570,526,82066,79593,71959,51620,39152
34753,515,2176,23981,10772,3.54206e+13,699.488,6378.43,34753,370,369,31946,30381,23683,17644,12556
89815,2297,2994,63526,26289,3.6473e+13,1203.47,11967.5,89815,599,618,86821,86662,86258,85895,78251
19123,82,1452,13122,6001,3.04058e+13,415.376,3756.54,19123,303,248,15819,12824,9497,3209,3043
59892,2418,2997,41816,18076,3.52014e+13,976.123,9577.03,59892,560,540,56895,56856,56428,56140,51379
77068,3177,3440,53604,23464,3.60206e+13,910.756,11735.7,77068,500,769,73628,73628,73553,73596,71312
22096,370,1590,15355,6741,3.43649e+13,482.697,4405.61,22096,249,348,20109,19049,17006,15331,6095
43865,270,1979,30533,13332,3.3261e+13,782.273,6892.57,43865,436,525,39141,35128,27059,15512,8636
45278,1046,2266,31253,14025,3.2999e+13,804.901,7390.31,45278,460,410,42867,41601,40088,35538,28565
70738,2106,2952,48332,22406,3.38289e+13,979.526,10122.1,70738,566,569,67786,67438,64683,59308,54152
75019,2392,3306,51377,23642,3.45668e+13,866.774,10611.2,75019,537,459,71713,71523,69541,62518,62725
62588,676,2236,43917,18671,3.56178e+13,1076.23,8549.54,62588,527,399,58473,55433,46171,33726,26757
2326,217,467,1543,783,3.63202e+13,151.955,877.47,2326,101,107,1841,1660,1661,1694,1255
4693,410,536,3207,1486,3.08655e+13,177.178,1275.79,4693,170,126,4157,4156,3938,3999,3674
84373,337,3164,59413,24960,3.6455e+13,1228.19,11384.7,84373,591,540,76465,70966,49825,29090,18565
39960,1677,2448,27589,12371,3.60631e+13,622.613,7112.54,39960,415,499,37512,37380,36742,35363,31302
97357,3366,3581,66754,30603,3.2605e+13,1080.93,13149.9,97357,505,672,93776,93775,93736,93758,92144
38038,2032,2463,27243,10795,3.66862e+13,672.745,7247.84,38038,412,442,35575,35528,35446,35339,32796
72665,1618,2269,49979,22686,3.1898e+13,1083.17,9050.74,72665,470,483,70396,69890,68206,61007,53164
32187,961,2136,22494,9693,3.29773e+13,746.99,6213.13,32187,418,345,29892,29124,26805,20737,16133
30150,766,2420,20394,9756,3.27736e+13,492.961,6402.1,30150,437,357,27730,26815,19982,15425,14158
51357,2291,2603,36247,15110,3.49295e+13,830.371,8356.89,51357,499,423,48754,48693,48668,48190,46203
83127,1153,2897,58246,24881,3.41989e+13,987.31,10645.9,83127,681,460,80077,78845,67440,43146,43250
47624,765,2126,33491,14133,3.65225e+13,643.041,6876.99,47624,411,362,45433,44038,38643,28715,24036
54534,69,1565,38044,16490,2.99394e+13,832.002,6187.21,54534,447,293,43550,33171,25879,4776,5192
37238,1209,1973,25879,11359,3.60164e+13,821.22,6362.1,37238,463,344,35183,34310,33182,29300,27256
40641,1745,2354,27982,12659,3.58635e+13,570.759,7106.69,40641,387,510,38287,38281,37972,37403,32375
59947,1961,2634,42373,17574,3.49095e+13,869.517,8927.61,59947,567,460,57313,57221,56563,53097,52086
8626,898,905,6063,2563,3.69485e+13,255.389,2215.22,8626,197,167,7721,7721,7720,7721,7720
28370,612,1384,19805,8565,3.67494e+13,637.677,4595.8,28370,361,301,26650,24926,21938,15179,15634
84652,1370,2327,57822,26830,3.4345e+13,904.2,9427.48,84652,556,502,82325,81935,78123,67640,63636
33938,1560,1922,24071,9867,3.68625e+13,738.574,5953.57,33938,421,384,32016,32003,31807,31511,29746
64607,472,2645,44958,19649,3.54e+13,910.518,8873.69,64607,572,467,59576,56134,39709,26142,19993
32477,549,2020,22248,10229,3.3884e+13,593.718,6076.41,32477,380,380,30064,28976,26551,21552,13965
98413,488,3260,70163,28250,3.69183e+13,1032.86,11751.3,98413,688,579,90297,83727,62176,39806,31756
92825,2415,4042,62487,30338,3.34307e+13,1031.03,13060.5,92825,797,668,88783,88662,82798,73674,74073
99164,2392,3342,70463,28701,3.70742e+13,1114.93,12092.5,99164,793,532,95822,95671,92384,85592,88629
97462,373,2600,69392,28070,3.81653e+13,1010.96,10163.6,97462,572,486,87617,80181,58930,29835,28969
13080,1131,1185,9219,3861,3.5323e+13,347.255,2998.57,13080,285,297,11895,11895,11893,11893,11795
7785,628,1010,5612,2173,3.73965e+13,229.965,2226.64,7785,236,185,6775,6698,6305,5077,4772
36837,38,1690,26293,10544,3.55177e+13,704.056,5733.64,36837,473,295,24985,19448,16215,4689,3511
77443,2761,2838,54718,22725,3.57568e+13,1009.36,10199.9,77443,565,583,74605,74604,74592,74576,74031
12155,623,1051,8486,3669,3.48029e+13,334.175,2743.78,12155,242,246,11104,10958,10618,10540,8085
75424,49,3172,52701,22723,3.49888e+13,1199.2,10431.3,75424,550,571,53577,43296,33075,12921,5987
48044,1901,2150,33212,14832,3.5464e+13,803.167,7269.01,48044,520,469,45894,45894,45611,45091,45082
55793,3476,3590,38062,17731,3.4213e+13,740.09,10315.4,55793,748,556,52203,52203,52129,52112,51674
99026,2289,3428,69806,29220,3.67264e+13,1102.13,13049.5,99026,658,606,95598,95384,93437,90867,78365
91136,1778,3611,61646,29490,3.26777e+13,814.885,11912.4,91136,575,404,87525,87118,71915,53880,47890
36022,825,1660,24506,11516,2.97395e+13,544.754,5466.46,36022,323,400,34330,33500,32399,28990,22919
57854,3048,3526,41093,16761,3.62616e+13,851.761,10673.9,57854,461,555,54328,54328,54186,54126,52391
84450,113,2319,58182,26268,3.2271e+13,1073.31,9595.41,84450,502,500,72460,64042,40671,12481,12240
66196,758,3051,46382,19814,3.66628e+13,1092.81,10212,66196,532,532,61938,59670,44277,32202,26597
11952,463,1187,8293,3659,3.44398e+13,367.601,2963.32,11952,289,223,10694,10289,8747,7101,6589
22243,804,1715,15197,7046,3.52667e+13,513.459,4684.32,22243,343,298,20528,20148,18966,16899,13668
18099,1155,1461,12534,5565,3.65906e+13,460.812,3925.65,18099,354,291,16638,16476,15868,14310,14938
21949,1527,1585,15440,6509,3.14106e+13,591.52,4271.1,21949,348,262,20364,20364,20330,20364,20237
26746,809,1871,18880,7866,3.60981e+13,637.112,5418.05,26746,418,385,24762,24112,22752,20619,11879
38847,1213,2206,26687,12160,3.58515e+13,794.181,6900.88,38847,414,520,36641,36129,34212,31053,26766
77379,909,2735,54516,22863,3.60982e+13,1271.35,10478,77379,656,587,73265,71483,57247,37462,32777
36871,1229,2272,25812,11059,3.64088e+13,626.45,6677.26,36871,523,316,34599,34274,31663,25709,24159
37748,1842,2160,25784,11964,3.50015e+13,683.101,6696.84,37748,499,565,35588,35586,34778,33147,33643
51225,2052,2453,35475,15750,3.22962e+13,848.193,7933.99,51225,508,546,48772,48502,48523,48078,46976
66153,2430,2630,45821,20332,3.2739e+13,1060.74,9149.33,66153,440,502,63523,63515,63505,63521,62700
96003,2450,3357,68405,27598,3.69506e+13,1066.14,12606.7,96003,722,544,92646,92601,89525,83272,71264
12403,542,1551,8578,3825,3.51676e+13,260.784,3418.1,12403,317,284,10852,10469,9440,8069,6437
93836,2784,3302,64857,28979,3.55997e+13,1179.57,11525.5,93836,621,590,90534,90372,89629,88222,86371
62864,871,2416,43717,19147,3.23075e+13,971.308,8592.98,62864,495,444,59823,57992,53660,42850,33307
20577,484,2003,13915,6662,3.33212e+13,345.584,4943.88,20577,400,270,18539,17883,13042,11393,8198
5001,164,843,3541,1460,3.60795e+13,164.304,1661.14,5001,179,146,4065,3732,2788,1939,1413
50423,765,2641,34699,15724,3.52972e+13,674.239,8241.21,50423,455,393,47476,46183,36532,27561,22117
15881,171,1549,11213,4668,3.60107e+13,369.955,3959.09,15881,343,379,13205,11598,9117,6144,2428
34317,759,1609,25091,9226,3.75131e+13,865.458,5559.73,34317,435,328,32216,31328,30406,25226,21004
95462,2025,2300,68090,27372,3.66148e+13,1112.07,10193.1,95462,591,466,93162,93154,93023,93101,90879
34095,109,1633,23134,10961,3.56667e+13,895.691,5831.4,34095,408,458,27429,24267,16385,7690,4814
90737,3185,3657,64065,26672,3.65212e+13,1051.54,12758.1,90737,682,560,87080,87046,86883,86714,84414
63326,696,2946,43823,19503,3.538e+13,969.018,9617.88,63326,588,548,59205,56376,41075,31928,22213
64824,1032,2445,45454,19370,3.57307e+13,1022.31,8863.19,64824,548,430,61852,60220,52878,35691,36863
66840,2053,2290,47857,18983,3.77761e+13,921.301,8277.38,66840,520,405,64550,64547,64176,63801,63227
42638,552,1990,28956,13682,3.15304e+13,621.78,6543.19,42638,487,446,40044,38148,31926,23058,18710
97768,212,3531,68052,29716,3.69066e+13,1101.68,12712.5,97768,747,689,84996,77106,53004,14179,14116
68461,1047,2462,48419,20042,3.66067e+13,878.582,8523.51,68461,555,446,65799,64540,58347,44366,43381
6620,596,899,4547,2073,3.29568e+13,227.366,1945.35,6620,183,170,5721,5607,5566,5217,4777
39565,1853,1930,27179,12386,3.30345e+13,744.173,6384.66,39565,330,490,37635,37635,37605,37608,37371
11193,1295,1443,7748,3445,3.39932e+13,269.678,3249.15,11193,292,235,9750,9750,9688,9465,9418
37126,1995,2358,25896,11230,3.40984e+13,647.048,6932.44,37126,352,458,34768,34768,34650,34649,32809
77517,849,2890,54133,23384,3.57177e+13,1084.61,10205.3,77517,586,559,73627,71283,60308,41588,34759
68103,575,3200,46483,21620,3.41219e+13,1086.84,10632,68103,589,626,63088,60818,42694,34234,19971
24460,16729,24460,0,24460,15.9993,0,24460,24460,24460,1,0,0,0,0,0
79325,437,3349,54853,24472,3.43193e+13,883.729,11364.1,79325,591,522,73286,69708,42181,16357,12020
52641,1681,2364,36977,15664,3.57263e+13,649.235,8167.84,52641,575,353,50277,50143,48304,42890,40840
26749,1075,1555,18334,8415,3.61719e+13,473.502,4648.51,26749,282,270,25194,25117,24764,24625,23069
85077,1954,2952,58859,26218,3.65265e+13,1157.58,10393.5,85077,658,576,82125,81459,76263,64632,68902
23767,1439,1762,16954,6813,3.74734e+13,587.136,4856.6,23767,412,271,22005,21866,21802,21644,20223
93856,2347,3414,64625,29231,3.37585e+13,1147.02,11875,93856,674,503,90442,90220,87265,79804,80070
6446,51,759,4611,1835,3.67308e+13,265.413,1760.69,6446,207,173,4480,3663,2903,1579,931
58072,343,2774,39929,18143,3.44289e+13,637.276,9054.32,58072,404,632,52422,48215,34310,17197,16718
8454,1076,1090,5936,2518,3.74342e+13,272.168,2470.79,8454,233,290,7364,7364,7363,7363,7343
68459,41,2404,48580,19879,3.70184e+13,823.015,8792.89,68459,557,447,47433,38622,29833,12112,6150
14569,1099,1446,9970,4599,3.48503e+13,383.116,3577.19,14569,248,237,13123,13029,13033,12966,11870
67203,1253,2476,47489,19714,3.71022e+13,814.107,8840.96,67203,585,524,64727,64144,58234,43456,50654
39071,1101,2270,26581,12490,3.48053e+13,712.06,7103.65,39071,521,429,36801,36110,33308,27004,26755
95048,2603,3415,67189,27859,3.64703e+13,1387.64,12070.7,95048,709,590,91633,91086,89871,87011,85013
81308,3053,3313,55759,25549,3.51727e+13,970.961,11297.5,81308,584,660,77995,77949,77498,76188,75647
71067,720,3164,49960,21107,3.4875e+13,704.432,10630.5,71067,575,634,67385,65485,58221,43665,28418
38466,68,1153,26072,12394,3.58307e+13,558.113,4917.66,38466,363,352,28045,23879,17439,7372,5090
81127,2640,3889,56095,25032,3.51582e+13,1002.44,12583.1,81127,772,687,77238,77171,73180,65224,63603
21498,563,1803,15158,6340,3.63384e+13,545.058,4660.37,21498,370,359,19481,18997,16202,13628,8532
88538,3550,3930,60892,27646,3.48302e+13,1256.78,13215.1,88538,624,642,84608,84542,84501,84536,81961
6925,524,777,4841,2084,3.58867e+13,278.102,1853.62,6925,196,160,6148,6022,5655,5046,4815
9263,199,767,6287,2976,3.15454e+13,279.16,2132.33,9263,171,230,8089,7507,6827,6165,3519
27523,618,1747,19720,7803,3.71719e+13,488.723,5117.28,27523,347,378,25685,24841,23993,22681,15678
49485,83,2935,34459,15026,3.58412e+13,964.953,8815.96,49485,548,475,37707,32741,23174,8129,3933
38789,1240,2150,27096,11693,3.41604e+13,713.616,6586.29,38789,360,427,36639,36093,34789,31832,24682
17388,1296,1327,11800,5588,3.54237e+13,531.424,3818.05,17388,328,347,16061,16042,16056,16055,16021
3329,302,610,2407,922,3.4756e+13,146.974,1152.7,3329,138,107,2719,2629,2485,2297,1908
21848,851,1347,14945,6903,3.51337e+13,395.65,4119.43,21848,304,268,20501,20462,18618,15250,14724
99532,1316,3948,69228,30304,3.52223e+13,1175.09,13660,99532,670,749,95331,93594,84181,60294,47923
52922,697,2548,37524,15398,3.51978e+13,905.536,8531.06,52922,511,559,49336,47490,42762,31621,17783
48780,2643,2904,34028,14752,3.65619e+13,741.628,8445.72,48780,393,480,45876,45826,45778,45799,44671
45913,94,2767,31576,14337,3.31709e+13,735.228,8119.2,45913,484,546,37614,33475,23296,9478,7048
91115,2135,3207,62755,28360,3.21987e+13,1110.23,11974.8,91115,634,658,87908,87675,86549,84895,67244
47229,1261,2800,32566,14663,3.52448e+13,696.84,8318.68,47229,496,466,44429,43946,39957,30735,30153
54170,267,2316,39035,15135,3.73623e+13,851.757,7913.39,54170,514,422,48317,42765,34808,20168,11734
58531,2258,2732,40679,17852,3.46788e+13,906.03,9157.02,58531,488,480,55799,55749,55351,54824,52157
81795,138,3477,56114,25681,3.48821e+13,1065.58,11340.3,81795,558,569,66852,58428,40458,13591,9605
39215,343,2331,26871,12344,3.45855e+13,436.936,6424.7,39215,509,344,36479,35361,20313,13842,9610
48241,1896,2215,33752,14489,3.72544e+13,570.419,6735.76,48241,417,372,46026,46025,45729,45323,41768
82563,3102,3812,57215,25348,3.51725e+13,973.511,12494.2,82563,509,646,78751,78695,78424,78241,74423
80985,861,3679,57505,23480,3.63869e+13,896.582,12534.6,80985,723,770,76465,73771,60755,48952,26117
29109,674,1428,20745,8364,3.6748e+13,617.153,4671.15,29109,415,309,27506,26679,24743,20880,19379
78158,640,2571,54426,23732,3.30215e+13,1053.8,9583.48,78158,566,460,73717,71301,49420,35164,28303
91495,2987,3356,62573,28922,3.4774e+13,933.437,11380.1,91495,673,470,88139,88134,88004,88047,86876
70292,784,2502,48699,21593,3.36787e+13,1019.1,9189.61,70292,480,476,66948,64924,58607,42845,33238
77393,761,2937,53797,23596,3.57245e+13,749.701,10766.5,77393,429,677,73929,72535,67573,59593,39577
76511,2078,2841,53761,22750,3.64145e+13,1121.23,10248.8,76511,573,423,73670,73425,71766,67058,64999
74953,1446,3319,52191,22762,3.50309e+13,934.949,10900.8,74953,550,588,71634,70766,63660,49635,33764
69070,1154,3097,47874,21196,3.4995e+13,1233.04,10553.4,69070,599,600,65318,63573,55538,42305,34590
59716,1873,2471,42549,17167,3.68706e+13,964.672,8753.68,59716,600,472,57245,56808,55595,51222,50796
19915,651,1195,13641,6274,3.53802e+13,389.177,3538.57,19915,240,237,18720,18667,16752,13648,14616
59058,1663,2611,40929,18129,3.61059e+13,829.469,8500.38,59058,491,496,56447,56041,53806,49199,44441
31900,667,1523,21599,10301,3.44517e+13,739.497,5248.53,31900,365,443,29815,28741,26110,20974,19435
86417,1199,2561,59528,26889,3.09283e+13,1037.78,10126.6,86417,600,444,83559,81769,75365,53209,41657
20147,1179,1233,14499,5648,3.61831e+13,368.852,3576.35,20147,304,214,18914,18912,18908,18872,18479
38628,1088,1955,27029,11599,3.27668e+13,985.037,6266.73,38628,451,403,36163,35147,34203,30033,26972
38703,559,1979,26655,12048,3.50843e+13,481.558,5871.19,38703,406,358,36662,36222,25882,20041,16873
61292,1401,2558,42932,18360,3.66894e+13,838.795,8523.75,61292,596,428,58734,58259,54990,48717,47460
25829,1939,1948,17930,7899,3.45435e+13,425.617,5327.93,25829,336,332,23881,23881,23881,23881,23858
50544,953,2528,35633,14911,3.6899e+13,808.642,7849.27,50544,458,463,47909,46930,42289,31953,28904
80149,1089,3081,56505,23644,3.64472e+13,974.273,10474.8,80149,695,551,76504,75456,53629,36876,32610
94879,181,4034,66272,28607,3.59342e+13,1098.78,13513.8,94879,620,713,80220,70699,49537,16570,11396
51106,954,2323,36726,14380,3.69172e+13,789.518,7871.9,51106,448,453,48449,47288,44872,38198,25520
61854,890,2285,42303,19551,3.18834e+13,944.47,8549.98,61854,499,480,59029,57817,52154,40592,31476
6390,182,816,4492,1898,3.73811e+13,248.444,1834.82,6390,168,175,5245,4636,4431,4139,1953
49646,894,2494,35252,14394,3.74268e+13,860.785,7993.81,49646,505,385,46836,45558,41067,34272,28817
12089,663,1228,8683,3406,3.76539e+13,301.749,3034.24,12089,233,218,10861,10795,10614,10643,8175
43024,960,2331,29995,13029,3.50656e+13,785.412,7027.3,43024,441,458,40564,39546,31878,23642,22264
81435,358,2970,56750,24685,3.61343e+13,901.817,10875.7,81435,603,739,72941,66980,47576,26941,13214
38834,1721,2014,26526,12308,3.5659e+13,667.952,6459.22,38834,407,402,36820,36809,36627,36556,34676
39495,1827,2720,27751,11744,3.65188e+13,459.147,7494.75,39495,335,536,36775,36762,36435,36287,32093
58083,896,2505,41607,16476,3.76791e+13,1002.32,8601.11,58083,595,496,55002,53222,47858,34547,31273
3016,185,538,2052,964,3.71498e+13,189.8,1063.8,3016,120,159,2361,2122,2016,1801,1447
89122,2043,3617,61863,27259,3.55127e+13,999.752,12173.5,89122,731,452,85505,85044,79295,65100,63369
75159,1344,2630,54042,21117,3.70782e+13,1121.65,9993.53,75159,717,511,72153,70593,67191,58248,50592
28770,1537,2048,19669,9101,3.43926e+13,486.828,5697.82,28770,478,360,26722,26716,26386,25057,24769
51849,95,2103,35785,16064,3.35111e+13,956.924,7078.87,51849,417,389,41638,36280,25285,7721,4840
59964,433,2208,42725,17239,3.72904e+13,1114.57,7941.52,59964,527,454,54848,51508,37781,27395,15567
32237,942,2003,22892,9345,3.67803e+13,683.985,5692.6,32237,418,317,30234,29806,27329,24957,17980
30271,382,1929,21173,9098,3.61927e+13,716.581,5797.06,30271,398,351,27090,25469,18019,12020,8863
94504,753,2688,67263,27241,3.65945e+13,1146.97,10937.3,94504,658,575,90099,85629,63614,45492,32831
86346,905,2685,60648,25698,3.53998e+13,1077.29,10692.7,86346,586,539,82558,81460,69867,46932,36273
46177,1043,2375,31639,14538,3.35911e+13,738.034,7626.6,46177,422,455,43685,42954,39835,33742,27148
7361,295,785,5168,2193,3.30613e+13,309.264,1960.64,7361,180,174,6376,5687,5510,4523,3423
22451,1172,1474,15391,7060,3.41554e+13,352.363,4191.65,22451,340,258,20977,20971,20187,19182,19279
10737,313,1225,7772,2965,3.8817e+13,290.046,2828.23,10737,230,252,9386,8601,8314,8216,3421
72133,322,2327,51636,20497,3.72759e+13,1054.27,9070.48,72133,525,544,65437,60718,42213,19924,17890
85061,1968,2926,60802,24259,3.6411e+13,1122.15,11179,85061,640,509,82135,81791,80144,78873,66449
45201,134,2404,31327,13874,3.52548e+13,816.719,7549.12,45201,455,472,36687,32179,23779,9616,6619
79808,822,3493,55301,24507,3.56869e+13,720.466,11363.2,79808,712,574,76080,74563,46725,35777,34763
10803,41,1230,7677,3126,3.70111e+13,283.624,2882.85,10803,249,249,7430,6207,4598,1389,1043
52261,322,1694,37735,14526,3.80375e+13,803.599,6447.41,52261,446,371,48130,43842,38314,33576,15913
28338,317,1558,19665,8673,3.25794e+13,497.695,4815.87,28338,336,301,26016,24651,16900,12806,9414
45070,2254,2873,31589,13481,3.54439e+13,753.455,8510.48,45070,478,497,42197,42066,41790,41858,36921
84675,1771,2533,59877,24798,3.69343e+13,1123.59,10102.5,84675,624,534,82142,81927,79790,75339,73861
26143,1341,1733,18220,7923,3.44996e+13,801.532,5112.96,26143,405,352,24410,23888,23781,23334,22056
40331,2016,2176,27631,12700,3.44804e+13,570.5,6810.39,40331,347,391,38155,38155,38120,38138,37806
9490,141,1100,6831,2659,3.40899e+13,292.933,2557.44,9490,227,195,7498,6560,5287,2672,1256
51855,313,2257,35550,16305,3.56706e+13,872.661,7444.12,51855,523,452,46041,41727,26952,12064,14062
28145,54,2149,19703,8442,3.63726e+13,498.512,5662,28145,387,282,20060,16502,12660,5052,2598
49348,1906,2266,35102,14246,3.74435e+13,791.288,7622.37,49348,538,473,47082,47078,46661,46407,43834
43277,861,2025,30831,12446,3.57568e+13,764.294,6771.99,43277,542,332,41063,40297,35572,25327,24863
98300,1989,3418,68812,29488,3.52301e+13,1152.59,12205.6,98300,747,527,94882,94337,89899,80895,78542
69535,1346,2820,50040,19495,3.75836e+13,826.021,9779.32,69535,662,446,66715,66222,63564,56465,50784
56535,1198,2810,39361,17174,3.51683e+13,630.751,8527.11,56535,524,332,53725,53179,48499,38629,37153
23367,258,1687,16357,7010,3.34267e+13,433.749,4585.41,23367,257,355,20860,19791,15753,12010,6754
5287,277,561,3668,1619,3.81303e+13,269.268,1398.75,5287,154,134,4619,4171,4020,3567,3022
34060,946,2003,24298,9762,3.60127e+13,782.964,5999.39,34060,469,441,31874,31153,29214,23395,23340
33186,658,1387,22841,10345,3.50121e+13,428.08,4588.41,33186,330,322,31799,31664,28862,24296,24276
78927,2752,3281,54698,24229,3.57969e+13,1070.93,11221.9,78927,583,518,75646,75570,75069,73921,71974
26991,1863,1958,19024,7967,3.68325e+13,476.31,5371.62,26991,309,351,25033,25033,25017,25028,24784
41744,1646,2449,28955,12789,3.57534e+13,630.734,7390.93,41744,540,348,39295,39215,37389,32842,30490
35740,1059,2083,24820,10920,3.56166e+13,711.982,6423.82,35740,547,431,33657,33197,28643,22690,24579
80164,2704,3627,55341,24823,3.59244e+13,1185.04,11878.4,80164,672,729,76537,76495,75100,72830,70495
33415,998,2078,23529,9886,3.69937e+13,695.079,6154.69,33415,440,371,31337,30472,29594,25100,22611
27059,1046,1931,18846,8213,3.54492e+13,593.488,5532.55,27059,361,392,25128,24568,23311,20035,18792
54496,1502,2582,38138,16358,3.57372e+13,756.079,8603.38,54496,503,483,51914,51547,48663,41193,38688
25014,1025,1791,17103,7911,3.50105e+13,409.312,5019.1,25014,387,295,23223,23159,21239,17386,15482
94310,2073,3603,65603,28707,3.61744e+13,1090.53,12435.8,94310,645,524,90707,90094,85357,71632,69948
50906,540,2294,35806,15100,3.67037e+13,1023.07,7521.65,50906,522,409,46950,44315,30787,21818,18138
46329,394,2078,33591,12738,3.72902e+13,914.976,7251.51,46329,542,438,42423,40101,35106,24362,13517
2322,464,509,1736,586,3.65506e+13,66.4543,891.533,2322,112,95,1813,1813,1806,1810,1703
66279,841,2779,46419,19860,3.47258e+13,1037.12,9535.6,66279,615,596,62838,61306,56018,41798,29270
77665,346,2783,53796,23869,3.73002e+13,980.897,9703.16,77665,598,538,69485,62798,42515,20098,21599
11984,189,1329,8579,3405,3.79153e+13,341.033,3016.27,11984,220,231,9868,8601,7357,4804,3867
45658,370,1624,31516,14142,3.07013e+13,765.154,5873.12,45658,375,361,42403,40410,30027,22378,16843
51528,1176,1997,35598,15930,3.46682e+13,787.768,6948.14,51528,470,354,49531,49347,45651,37138,34863
30080,1354,1921,21478,8602,3.64192e+13,551.954,5630.2,30080,423,277,28159,28068,27062,26028,24517
24552,1524,1625,17897,6655,3.68536e+13,623.312,4840.21,24552,335,350,22927,22927,22902,22773,22382
59924,1250,2384,42997,16927,3.68987e+13,1043.1,8332.56,59924,564,435,57439,56060,53008,46027,43059
36587,934,1671,25595,10992,3.35021e+13,822.729,5503.51,36587,372,353,34662,33385,32554,29902,24082
40083,170,1906,27936,12147,3.36279e+13,921.498,6247.33,40083,389,430,34695,31668,21850,9396,6275
98243,451,2879,69119,29124,3.57177e+13,1081.83,11556.7,98243,608,580,90896,85790,58166,37473,24199
92514,31972,92514,0,92514,15.9998,0,92514,92514,92514,1,0,0,0,0,0
92046,1146,3592,63238,28808,3.49592e+13,1062.55,12008.3,92046,653,616,88050,86689,66312,53830,45573
47778,1541,1935,34003,13775,3.70193e+13,835.624,7029.21,47778,438,408,45843,45657,45197,44532,39988
58355,381,1857,40301,18054,3.00539e+13,839.317,6875.09,58355,470,374,54382,52570,44016,35713,24231
78044,2020,2088,54931,23113,3.57645e+13,1034.24,8448.23,78044,539,460,75956,75956,75940,75954,75858
6003,70,744,4024,1979,3.37204e+13,149.057,1693.86,6003,125,192,4709,3815,3346,3187,1552
93084,2955,3296,64745,28339,3.55021e+13,1118.13,12466.1,93084,692,622,89788,89776,89626,89321,86299
20723,86,1725,14512,6211,3.66103e+13,409.627,4563.91,20723,316,283,15870,13926,9932,3884,3028
75127,3408,3800,51208,23919,3.4337e+13,690.584,11930.9,75127,647,391,71327,71326,70905,70487,67342
98635,1800,3740,68406,30229,3.54704e+13,995.476,13069.4,98635,583,640,94895,94354,91387,83046,70364
27653,1614,2006,19527,8126,3.69178e+13,440.676,5620.53,27653,280,483,25647,25646,25476,25406,22525
9125,533,771,6438,2687,3.59259e+13,224.903,1926.16,9125,226,139,8354,8352,8250,7902,7918
44700,290,2967,30395,14305,3.56837e+13,576.011,8540.83,44700,377,688,39853,36284,25142,13485,8953
34537,224,2157,23475,11062,3.46421e+13,757.406,6501.21,34537,396,500,29771,27217,19317,6715,7140
1249,55,359,889,360,3.67415e+13,47.2066,584.557,1249,78,79,856,743,651,592,235
53250,1537,2723,37447,15803,3.64915e+13,675.891,8543.74,53250,682,416,50527,50421,46986,39386,39123
94400,2450,2956,64568,29832,3.47642e+13,842.306,10763,94400,475,490,91444,91348,91192,91254,84201
71016,980,2343,48023,22993,3.56299e+13,755.77,8532.64,71016,594,440,68673,68012,60486,50847,57791
21283,1241,1474,14474,6809,3.2288e+13,477.093,4167.82,21283,290,328,19809,19760,19639,19452,18565
94896,436,2732,67416,27480,3.58549e+13,1145.39,11062.8,94896,640,535,86815,81624,56438,30235,27327
88251,938,3754,60935,27316,3.54426e+13,1190.17,12513.2,88251,684,613,83204,80479,61105,44222,36083
44560,275,2057,30995,13565,3.65818e+13,625.445,6795.09,44560,429,415,38952,34352,24816,12321,8639
98878,2007,3271,70756,28122,3.72702e+13,1049.65,12592,98878,701,698,95607,95521,93625,91642,69265
96671,4015,4298,66450,30221,3.39625e+13,889.799,14097.9,96671,748,700,92373,92373,91663,90345,89379
80373,1814,2671,56630,23743,3.62652e+13,760.36,9986.55,80373,675,411,77702,77631,73761,56367,50120
91807,2682,4030,63748,28059,3.54115e+13,1263.32,13611.5,91807,719,837,87777,87380,85513,81850,73906
64937,3408,3540,44576,20361,3.60141e+13,977.058,10738.2,64937,578,756,61397,61397,61395,61314,61275
37904,2373,2587,26280,11624,3.64912e+13,535.393,7204.15,37904,409,460,35317,35317,35263,35305,33500
4030,382,677,2822,1208,3.59748e+13,151.275,1394.02,4030,173,135,3353,3244,3201,2969,2408
66081,842,2727,45702,20379,3.49654e+13,751.634,9234.23,66081,517,598,63021,61788,56092,46813,31853
96917,1939,3793,65710,31207,3.42837e+13,1141.03,13459.5,96917,622,619,93124,92284,88801,79948,66373
7860,180,870,5139,2721,3.02446e+13,145.44,2010.03,7860,172,163,6962,6636,4640,3984,2669
78120,2860,2910,55371,22749,3.74426e+13,957.917,10407.7,78120,683,523,75210,75209,75204,75196,75028
69375,1702,3070,48466,20909,3.54145e+13,829.77,10110.4,69375,487,608,66305,65884,63861,63618,45843
14557,1373,1653,10183,4374,3.4037e+13,292.302,3862.99,14557,294,248,12904,12903,12838,12818,11192
84234,1614,2355,59136,25098,3.63165e+13,1453.2,10130.2,84234,669,517,81534,80389,77231,68257,66696
81451,146,2696,57234,24217,3.70945e+13,1116.12,10272.2,81451,629,510,66846,58428,42572,15318,13610
49970,1069,1791,35559,14411,3.7266e+13,791.253,6615.81,49970,436,330,48144,47647,45362,40084,37638
21247,346,1567,14412,6835,3.09324e+13,407.677,4345.33,21247,342,278,19294,18255,15318,10982,8037
32849,1602,1780,22754,10095,3.49045e+13,545.558,5534.27,32849,299,358,31069,31062,31012,30883,30169
93718,1269,3534,64505,29213,3.46546e+13,971.018,12239.6,93718,606,554,90115,88821,78046,60585,57552
39476,768,2154,27388,12088,3.57502e+13,596.14,6790.85,39476,391,462,37165,36552,33041,23730,18238
56848,2087,2580,38729,18119,3.37372e+13,959.083,8570.94,56848,482,418,54268,54006,53501,52443,50743
63332,1487,2556,44619,18713,3.55948e+13,1009.46,9168.37,63332,727,475,60776,59876,56002,46156,47318
59173,1920,2366,41242,17931,3.31546e+13,869.683,8683.43,59173,438,447,56807,56648,56601,56482,51995
67197,1023,3081,46830,20367,3.55981e+13,962.686,10339,67197,513,532,63664,62090,58330,48372,34056
37609,1565,1903,26376,11233,3.65916e+13,494.66,5553.37,37609,372,303,35706,35694,35403,35406,34000
5818,890,907,3982,1836,3.7116e+13,226.483,1857.38,5818,218,158,4911,4911,4911,4911,4901
29435,1717,2161,20686,8749,3.60694e+13,610.832,6004.29,29435,447,302,27274,27269,26651,26112,24343
15567,20,1009,10698,4869,3.49747e+13,344.794,2816.24,15567,224,229,8975,6310,5336,2278,1076
88647,1376,3419,61654,26993,3.46632e+13,1049.52,12092.4,88647,621,549,85032,82666,76664,58828,51869
74814,2054,3114,52014,22800,3.52297e+13,1290.66,10923.8,74814,626,519,71700,70687,67642,59426,60369
95947,2563,3326,66166,29781,3.40069e+13,1238.41,12060.6,95947,604,605,92621,92574,90176,84243,83458
84155,2202,3186,58799,25356,3.60699e+13,1030.33,11386.1,84155,526,586,80969,80821,80336,79785,72459
46720,1123,2126,32268,14452,3.50685e+13,622.138,7104.24,46720,429,356,44594,44300,41441,35434,31473
28845,282,1512,20632,8213,3.74126e+13,613.507,4772.85,28845,378,266,26021,23395,20555,16193,10194
58487,1329,2196,41329,17158,3.68086e+13,907.944,8040.32,58487,527,419,56276,55772,53280,47235,34373
49605,1275,2312,35523,14082,3.74773e+13,859.37,8000.97,49605,497,357,47293,46597,44985,37946,36622
1901,140,184,1292,609,2.13943e+13,96.8932,512.164,1901,83,65,1717,1710,1666,1633,1493
20337,395,1424,14602,5735,3.59177e+13,554.605,4109.96,20337,352,293,18422,17103,15445,11455,6973
22422,343,1421,15734,6688,3.61493e+13,550.926,4315.5,22422,293,363,20054,18456,15993,10294,8421
38762,277,1918,26517,12245,3.42033e+13,558.255,6000.15,38762,373,354,34829,31066,22623,14840,11195
83240,970,2391,58898,24342,3.69465e+13,1189.36,10250.6,83240,554,574,79749,77753,71046,55525,41718
95963,346,3505,67784,28179,3.71587e+13,1153.98,11665.8,95963,616,461,85412,77773,53862,20641,19316
46812,442,1862,33110,13702,3.72868e+13,742.597,6623,46812,468,384,42463,39032,31626,20172,18240
50384,2119,2950,35125,15259,3.55524e+13,817.243,8779.18,50384,489,591,47434,47408,46944,46237,40087
23637,413,1979,16825,6812,3.75201e+13,633.762,5290.47,23637,371,481,21027,20120,17611,15703,5701
71966,691,2182,49515,22451,3.13615e+13,1179.2,8616.09,71966,426,515,68186,66000,55843,36962,32111
50112,1422,2093,34323,15789,3.47993e+13,707.468,6595.09,50112,410,373,48019,47732,44996,40937,40485
27182,1197,1575,19022,8160,3.43456e+13,534.913,4675.35,27182,295,292,25607,25403,25420,25111,23362
23776,308,1398,16712,7064,3.4569e+13,402.112,4230.55,23776,293,254,21753,20487,15206,11510,7951
76928,387,3101,54409,22519,3.66293e+13,1168.85,10851.8,76928,756,504,70020,65758,44378,23416,17188
29089,1074,1851,20267,8822,3.53112e+13,544.715,5396.21,29089,428,277,27238,27141,25552,21396,17137
90141,1842,2814,62775,27366,3.23532e+13,1069.05,11219.4,90141,485,651,87327,86886,86138,83741,69198
19290,1028,1278,13330,5960,3.61501e+13,453.282,3835.89,19290,348,238,18012,18002,17603,17352,16310
20344,985,1582,14273,6071,3.71966e+13,571.277,4453.34,20344,362,376,18762,18715,17949,17226,14735
39627,1056,2046,27770,11857,3.67919e+13,771.863,6568.66,39627,449,429,37458,37044,34084,31778,24153
81903,1764,3473,56715,25188,3.52028e+13,1038.01,12092.9,81903,615,684,78430,77642,71780,58908,50878
59066,1195,2182,41289,17777,3.43288e+13,795.025,8069.42,59066,397,422,56866,56467,55038,52995,39772
11885,125,1292,8215,3670,3.32305e+13,322.013,3089.17,11885,279,209,9864,8817,6146,3476,1998
51857,1366,2430,36091,15766,3.47656e+13,806.795,7931.78,51857,496,415,49427,48752,46732,38477,35451
76678,835,2911,53378,23300,3.5874e+13,932.408,10388.6,76678,543,516,72834,70632,58234,38180,40444
88134,1523,3343,61349,26785,3.59122e+13,915.053,11994.8,88134,716,454,84791,83963,75840,56967,52973
7123,264,532,4907,2216,3.63232e+13,260.069,1484.98,7123,155,156,6450,5451,5481,4955,4654
42111,919,2235,29066,13045,3.33536e+13,640.701,7264.57,42111,331,528,39746,38718,36822,34612,19283
6132,237,986,4505,1627,4.06274e+13,183.835,1936.85,6132,187,158,5104,4724,4610,4604,1838
9125,624,1054,6642,2483,3.62474e+13,245.149,2468.93,9125,194,210,8071,8057,7782,7501,5157
37223,1012,2285,25801,11422,3.42944e+13,785.222,6888.1,37223,467,424,34837,33875,31438,24023,22080
63415,965,3021,43919,19496,3.55269e+13,875.346,9595.98,63415,553,426,60153,58879,45243,34542,28618
56378,1041,1822,40531,15847,3.74291e+13,889.501,7068.02,56378,431,415,54476,52633,53190,49656,44486
63192,1616,2584,43779,19413,3.58362e+13,762.392,8611.75,63192,633,515,60608,60182,57723,51377,51178
41713,492,2006,30863,10850,3.57805e+13,962.044,6927.18,41713,544,379,37802,35608,31263,23014,15211
53488,1534,3052,36869,16619,3.55123e+13,897.722,9390.19,53488,599,537,50436,49535,47323,39319,37426
92674,1149,3428,65256,27418,3.54355e+13,1220.51,12622.1,92674,640,642,88502,86928,80512,64885,43328
63599,2200,3183,45017,18582,3.58558e+13,883.847,10509.9,63599,509,565,60416,60158,59792,59529,50289
59867,582,2344,41152,18715,3.2652e+13,891.636,8089.24,59867,451,484,56327,54327,40642,27886,19972
29696,1508,2224,20652,9044,3.60447e+13,570.652,6438.94,29696,347,460,27472,27274,27140,27117,22156
71279,189,3085,49356,21923,3.59069e+13,908.394,9856.43,71279,649,527,59769,53051,36934,12453,12073
60693,282,2285,41486,19207,3.36849e+13,752.037,8432.98,60693,457,365,55048,50871,34333,19779,11844
12793,351,1201,9053,3740,3.53781e+13,297.923,3003.14,12793,233,209,11415,10524,10050,9329,5465
93528,337,3143,64323,29205,3.57942e+13,1018.26,10846.8,93528,615,603,86145,79195,48384,21270,20998
23429,1143,1273,16348,7081,3.65206e+13,533.134,3859.92,23429,320,237,22156,22043,22097,22040,21688
93692,2212,2978,66227,27465,3.60587e+13,1139.94,11236,93692,656,571,90714,90624,89172,85240,83226
90113,1303,2805,62367,27746,3.42895e+13,1156.31,10990,90113,574,569,86930,84904,79767,61586,57368
92823,1739,3609,63662,29161,3.45277e+13,1241.37,12086.2,92823,654,741,89170,87956,77694,59574,62525
11603,882,890,8480,3123,3.75558e+13,490.994,2498.81,11603,248,180,10713,10713,10713,10708,10684
78151,3721,3771,53446,24705,3.46543e+13,767.698,11550.2,78151,523,620,74380,74380,74374,74378,74301
75522,1330,2372,52444,23078,3.29286e+13,1040.15,9073.08,75522,582,435,72938,71858,68538,61112,54377
25511,113,1768,17201,8310,3.35428e+13,615.545,5064.57,25511,365,360,20355,17690,12930,4108,4033
51764,1416,2414,36516,15248,3.65258e+13,851.196,8064.83,51764,550,367,49350,49056,44030,33793,36044
87476,628,3575,61636,25840,3.67998e+13,1158.78,11782.2,87476,684,509,81814,78787,55545,40332,30108
79839,805,3763,54662,25177,3.47228e+13,1076.23,12442.5,79839,578,782,74922,72460,58603,42232,22700
26208,1645,2028,17958,8250,3.53766e+13,490.249,5594.45,26208,359,377,24180,24166,23825,23045,21610
80234,2203,2914,56576,23658,3.62744e+13,1041.98,10200,80234,651,466,77320,77219,75522,72104,68596
35042,1379,1569,24497,10545,3.07528e+13,727.109,5202.29,35042,318,337,33473,33444,33451,33461,32666
68411,2139,3694,46101,22310,3.45681e+13,678.484,11383,68411,552,692,64717,64639,63210,61791,37454
21208,1340,1539,14308,6900,3.48873e+13,471.864,4408.07,21208,401,429,19669,19660,19598,19312,19331
52144,2932,3033,34986,17158,3.39661e+13,703.354,8937.57,52144,505,547,49111,49109,49104,49111,48855
11233,661,1304,7838,3395,3.53535e+13,358.105,3074.71,11233,276,237,9929,9573,9172,8279,6665
16533,1177,1291,11521,5012,3.66235e+13,282.289,3244.67,16533,304,204,15242,15242,15232,15193,15140
82672,1843,2878,57612,25060,3.37247e+13,819.406,10574.6,82672,668,456,79794,79649,75412,60750,60796
28941,574,1880,20790,8151,3.73035e+13,746.163,5597.75,28941,420,405,26544,25740,22487,16423,12073
20512,645,1722,14492,6020,3.45173e+13,457.233,4475.13,20512,276,268,18681,18105,17064,13098,12090
17880,1536,1756,12368,5512,3.52909e+13,436.273,4384.4,17880,348,272,16124,16115,15999,15682,15323
42350,1686,2627,30130,12220,3.69612e+13,627.802,8006.57,42350,346,566,39723,39718,39254,39319,32317
93614,2101,3157,64719,28895,3.2214e+13,1403.43,11532.8,93614,612,603,90457,89732,88699,85316,79098
31896,881,2099,22641,9255,3.66852e+13,569.911,5984.55,31896,364,426,29797,29046,27506,23632,14651
83040,2803,3158,57774,25266,3.44176e+13,1232.31,11330.8,83040,711,593,79882,79847,79613,79229,77672
44430,1104,1788,30664,13766,3.51375e+13,507.58,6084.49,44430,303,369,42642,42411,40616,41080,32938
55077,867,2154,39667,15410,3.69584e+13,920.969,7672.12,55077,610,429,52176,50180,45511,30545,31326
90634,2704,3165,63712,26922,3.59306e+13,1135.22,11708.3,90634,633,534,87469,87455,86878,86124,82742
88116,1043,2732,63068,25048,3.6624e+13,1173.27,10919.2,88116,735,534,84240,80840,71666,51620,47278
85000,1640,3869,58916,26084,3.50195e+13,1170.38,12362.9,85000,791,496,81131,79841,70906,53348,54551
13882,159,1081,9368,4514,3.01418e+13,228.3,2902.26,13882,244,265,12508,12042,8980,7302,3674
52227,753,2810,35286,16941,3.26875e+13,644.373,8577.73,52227,490,454,49265,48113,34822,28643,22054
19640,853,1560,13409,6231,3.45652e+13,393.876,4097.23,19640,356,286,18080,17954,17088,15341,14054
11937,584,996,8136,3801,3.40653e+13,366.275,2594.5,11937,215,231,10941,10497,10277,9598,8116
84421,3050,3317,57571,26850,3.54815e+13,831.786,11635.8,84421,507,593,81104,81097,80993,81028,79728
82381,2919,3603,58226,24155,3.60383e+13,1377.2,12583.4,82381,783,685,78778,78388,77630,75682,73509
11851,6926,11851,0,11851,15.9986,0,11851,11851,11851,1,0,0,0,0,0
36481,2106,2564,25731,10750,3.63107e+13,713.869,7370.69,36481,440,529,33917,33798,33591,33574,31117
96943,1752,3796,67518,29425,3.58714e+13,1112.77,12884.1,96943,556,560,93147,92387,88031,75492,67438
46242,665,2349,32478,13764,3.57087e+13,891.914,7508.82,46242,435,439,42816,40730,34349,26107,19246
29799,716,1919,20085,9714,3.38531e+13,682.4,5722.04,29799,464,457,27614,26793,24345,21353,14947
64639,728,2049,45918,18721,3.60708e+13,1055.35,7918.54,64639,519,411,61234,59100,49647,31451,35511
69434,951,3147,46699,22735,3.3989e+13,961.298,10142.6,69434,603,615,65883,64657,45994,38416,31189
57995,197,2565,40202,17793,3.60741e+13,941.752,8625.86,57995,532,505,49115,43635,28111,10272,11003
11783,802,831,8169,3614,3.60163e+13,330.378,2323.19,11783,203,201,10952,10952,10945,10940,10889
45166,2420,2944,32024,13142,3.74851e+13,806.296,8644.98,45166,409,566,42222,42197,42021,41493,38695
18051,1183,1309,12632,5419,3.76633e+13,393.011,3549.91,18051,275,250,16742,16742,16730,16721,16443
54928,1724,3237,38181,16747,3.56943e+13,878.318,9673.43,54928,579,486,51691,51057,48226,41103,36392
17851,453,1471,12604,5247,3.22561e+13,327.953,3746.3,17851,321,305,16265,15823,14581,11113,5654
62768,473,2668,43502,19266,3.30158e+13,1201.47,8896.17,62768,512,519,57765,55484,37658,23384,13665
70233,2464,2692,48658,21575,3.51899e+13,765.535,8738.31,70233,485,390,67541,67539,67406,67456,66588
78379,43,3070,54998,23381,3.58719e+13,1029.34,10528,78379,693,525,54669,44270,34164,13829,7117
30041,2071,2322,20617,9424,3.28164e+13,448.902,6101.55,30041,346,446,27719,27719,27680,27694,26863
85221,1630,2881,58470,26751,3.51917e+13,1176.99,11196.4,85221,617,540,82340,81634,76765,63624,60474
44261,2276,2400,30251,14010,3.52388e+13,753.513,7277,44261,394,429,41861,41861,41833,41837,41577
46589,434,2253,32422,14167,3.46624e+13,750.393,7270.78,46589,402,420,43154,41101,31069,21775,15674
91291,4063,4287,63391,27900,3.56565e+13,1343.66,13793,91291,771,655,87004,86990,86851,86662,86289
35386,503,2393,24929,10457,3.71509e+13,633.82,6927.34,35386,379,453,32259,30736,24241,17126,10730
97696,1816,2818,69332,28364,3.50578e+13,1238.2,11330.1,97696,582,508,94878,94194,90749,80394,80180
8307,52,808,5693,2614,3.46039e+13,441.609,2137.66,8307,240,232,5757,4706,3407,1631,999
69999,2108,2693,50166,19833,3.67522e+13,1120.12,10167.6,69999,651,594,67306,67214,66446,64681,60962
2489,335,527,1698,791,3.53443e+13,123.178,975.766,2489,121,102,1962,1915,1797,1679,1586
92792,236,3327,63749,29043,3.50428e+13,901.538,10972.2,92792,583,471,83505,72056,47763,18297,11406
96963,1303,3957,67158,29805,3.5549e+13,1033.42,13256.4,96963,619,731,92855,91223,76672,57140,51592
41152,23,2366,29465,11687,3.73738e+13,766.125,7273.52,41152,486,435,25395,19159,15539,7228,2824
42417,2309,2419,29086,13331,3.46845e+13,971.002,7506.86,42417,466,557,39998,39959,39986,39997,39785
90257,2328,3073,61910,28347,3.54143e+13,1224.16,11698.2,90257,630,619,87184,87169,85156,81275,79551
19862,502,1308,13842,6020,3.64054e+13,401.491,3726.86,19862,320,255,18499,18043,15652,12768,11851
90161,291,2967,64139,26022,3.72341e+13,1254.39,11274.2,90161,745,562,80002,72332,52689,24910,14560
77273,2304,3312,54468,22805,3.67428e+13,1115.02,11562.4,77273,602,724,73961,73568,72307,69352,65725
85814,2806,3132,58638,27176,3.45009e+13,946.2,10854.2,85814,587,582,82682,82680,82502,82633,81586
43780,91,1756,29655,14125,3.47685e+13,751.946,6506.54,43780,489,533,33931,29185,19652,7239,4265
84638,556,2929,59604,25034,3.49494e+13,1078.51,10613.7,84638,569,461,79396,76090,55444,35512,25303
52716,1496,2463,36669,16047,3.48895e+13,1045.62,8246.93,52716,529,509,50226,49435,47915,43100,35507
97672,2545,3147,70663,27009,3.70683e+13,1136.99,12058.6,97672,722,562,94525,94449,93995,92576,85925
92042,2953,3769,64768,27274,3.65273e+13,1063.84,13030.1,92042,679,590,88273,88210,87756,87836,80496
11850,428,1150,8150,3700,3.4026e+13,292.511,2865.01,11850,226,250,10676,10146,8644,7781,4592
1607,390,399,1096,511,3.74012e+13,88.6839,687.675,1607,90,89,1208,1208,1208,1208,1205
24262,451,1742,16172,8090,3.19628e+13,342.328,4806.46,24262,404,249,22447,21624,13042,9574,8785
60175,2525,2640,42517,17658,3.62414e+13,1042.08,9206.7,60175,573,555,57535,57535,57525,57478,57361
18688,743,1442,13275,5413,3.70123e+13,402.819,3786.85,18688,326,337,17246,17030,15511,12639,12219
41782,1290,2332,29196,12586,3.6564e+13,785.314,7154.7,41782,393,413,39450,38898,36794,31239,28977
87530,99,2925,61800,25730,3.61487e+13,936.691,11134.4,87530,644,401,68761,59703,44130,15157,8038
86083,739,3092,60429,25654,3.50406e+13,1232.58,11614.3,86083,630,624,80958,78154,67802,49492,34880
53275,284,2313,36081,17194,3.47633e+13,852.326,7977.19,53275,453,409,46459,41473,27165,14661,13339
10552,825,1181,7274,3278,3.42565e+13,384.326,2899.43,10552,254,224,9371,9266,9118,8143,8260
34570,1253,2071,24502,10068,3.64075e+13,744.609,6036.51,34570,420,373,32499,31831,29943,24979,24904
75294,664,3115,52167,23127,3.52968e+13,985.593,10344.4,75294,613,563,71354,69438,47199,33575,26815
51333,2219,2476,36177,15156,3.59317e+13,698.941,8033.11,51333,540,395,48857,48854,48475,47970,46900
33009,638,1949,23866,9143,3.76516e+13,636.886,5966.41,33009,373,380,30500,29222,27585,23767,14916
66329,413,2840,47231,19098,3.57439e+13,820.83,9914.96,66329,539,611,60565,56441,44991,32548,15431
38860,393,2175,27077,11783,3.639e+13,733.639,6856.19,38860,378,536,35021,32976,25830,18894,9600
80227,2699,2908,55516,24711,3.61819e+13,896.316,10107.9,80227,563,484,77319,77318,77258,77259,75030
74148,606,2756,50680,23468,3.4842e+13,792.283,9602.28,74148,442,533,70668,68911,47383,33984,31201
51705,602,2628,36040,15665,3.66073e+13,1174.66,8499.95,51705,515,588,47183,45084,33232,24575,15646
55977,1899,2863,38117,17860,3.3571e+13,719.442,9054.76,55977,412,454,53114,52970,52500,51760,43016
72370,224,3334,50366,22004,3.56587e+13,1032.85,11110.5,72370,658,613,63116,55703,36983,12772,11961
66360,839,2374,45734,20626,3.49997e+13,963.561,8030.16,66360,522,399,63454,62241,51035,34633,37055
52187,1119,2118,37633,14554,3.68152e+13,699.043,7526.85,52187,515,381,50069,49727,46359,42706,31315
34450,192,2311,23794,10656,3.41508e+13,575.188,6681.9,34450,379,553,30059,27329,18465,7374,4807
92602,2247,3515,64740,27862,3.59472e+13,1151.98,12389.8,92602,682,624,89087,88623,84172,72358,73843
72442,2042,2808,51143,21299,3.59603e+13,1046.51,10074.6,72442,744,478,69634,69368,67832,63513,63181
81708,2040,2963,56875,24833,3.45813e+13,984.135,10830.9,81708,535,578,78745,78644,77283,75217,69205
40269,932,2684,28098,12171,3.54462e+13,729.826,7686.51,40269,483,514,37499,36048,31595,23896,15478
33651,927,1985,23520,10131,3.48664e+13,678.842,6009.75,33651,417,392,31508,30979,28748,21694,20300
52720,62,2383,36226,16494,3.46721e+13,861.636,8079.02,52720,520,497,38754,32398,23055,8835,5535
47063,833,1943,33492,13571,3.67966e+13,718.705,7163.28,47063,496,421,44773,43565,39554,27487,23083
86610,201,3515,60373,26237,3.49647e+13,848.172,11762.9,86610,698,597,75407,66261,45078,16533,13909
20265,582,1541,14024,6241,3.53678e+13,522.736,4180.76,20265,405,313,18579,17949,15779,11942,12742
27114,1116,1852,18661,8453,3.51985e+13,530.954,5250.63,27114,376,363,25262,25076,24345,22602,21001
48640,1228,2479,33827,14813,3.62179e+13,683.962,7858.08,48640,434,427,46161,45857,42850,37252,31607
63102,2823,2926,43573,19529,3.52367e+13,716.131,9000.21,63102,477,399,60176,60176,60141,60134,59928
2808,386,567,2013,795,3.82016e+13,132.467,1022.2,2808,136,91,2241,2200,2188,2207,1873
6389,527,858,4550,1839,3.59167e+13,224.071,1908.78,6389,185,157,5531,5514,5038,4592,3636
16285,586,1754,11428,4857,3.72624e+13,362.805,4186.59,16285,300,252,14531,14132,11959,8805,7386
94692,74,3378,64485,30207,3.47244e+13,813.852,11263.8,94692,577,473,72022,60824,42798,16087,8421
29898,462,1337,20518,9380,3.59298e+13,525.996,4159.25,29898,321,289,28284,27633,22517,17415,16489
66333,1824,1940,47992,18341,3.72456e+13,1074.08,7919.66,66333,529,451,64393,64372,64245,64112,63391
42171,958,2001,28531,13640,3.45054e+13,804.395,6690.53,42171,430,480,40018,38196,36517,30968,27226
43529,658,2350,29853,13676,3.2367e+13,794.584,7310.14,43529,435,523,40699,39643,34275,27900,18956
21989,438,1778,15192,6797,3.53683e+13,411.109,4719.18,21989,397,364,19996,18627,16439,14126,9018
69840,1808,3096,49067,20773,3.58473e+13,1062.24,10240.1,69840,588,542,66744,66068,62440,54111,51412
77752,1720,3176,54253,23499,3.50186e+13,892.821,10739.7,77752,596,491,74576,74056,68815,53927,49982
45797,1602,2109,30862,14935,3.44169e+13,605.502,6691.62,45797,481,341,43688,43679,43133,41378,41039
59788,1321,2609,41238,18550,3.33407e+13,780.573,8929.59,59788,521,473,57179,56301,53455,44696,40252
20497,1395,1586,14277,6220,3.24103e+13,313.833,4091.03,20497,226,286,18911,18905,18908,18884,16961
3948,300,735,2693,1255,3.51536e+13,153.586,1453.61,3948,148,183,3213,3037,2812,2669,1492
41614,251,2481,28896,12718,3.54007e+13,563.773,7319.27,41614,373,458,36344,31829,22404,11048,9115
67081,1539,2805,47615,19466,3.59443e+13,803.671,9724.53,67081,442,591,64276,63922,63223,61978,48596
3150,28,614,2195,955,3.60144e+13,100.238,1157.78,3150,149,117,1987,1494,1273,683,315
92299,1840,3049,63927,28372,3.51192e+13,1078.44,11272,92299,677,595,89250,88821,85143,77411,73238
73257,407,2913,51939,21318,3.62782e+13,896.079,10546.2,73257,629,484,66973,62755,45593,30306,22280
72210,1993,2832,51309,20901,3.65553e+13,1019,9948.67,72210,591,426,69378,69026,68495,66409,62344
97306,2291,3260,65536,31770,3.43144e+13,1202.13,12020.5,97306,633,604,94046,93911,91300,85754,82704
7114,523,992,5151,1963,3.61674e+13,190.055,2057.83,7114,240,136,6122,6095,5924,4964,4686
32719,1038,1208,23395,9324,3.80292e+13,647.05,4620.18,32719,391,307,31511,31508,31126,30885,30407
86510,1687,2986,60779,25731,3.61486e+13,957.691,11029.3,86510,619,597,83524,82743,80132,72377,66288
84025,2099,3286,58305,25720,3.49663e+13,912.551,11746.8,84025,596,571,80739,80626,79109,77170,65341
60279,1097,2826,41508,18771,3.67915e+13,683.536,8914.09,60279,507,514,57453,56896,52576,47058,29194
91210,1028,2803,65325,25885,3.79638e+13,1128.57,11689.5,91210,652,516,87660,84526,73433,51038,46810
30367,1569,2063,20848,9519,3.60442e+13,401.024,5573.29,30367,460,305,28304,28298,27997,26531,26714
64822,1938,3491,45329,19493,3.51908e+13,782.02,10453.3,64822,540,529,61331,60923,58963,52190,44819
91228,1409,3628,63356,27872,3.47187e+13,1068.59,12249,91228,696,736,87434,86044,79883,68557,54030
25953,53,1867,18387,7566,3.772e+13,617.079,5286.19,25953,465,332,18676,15661,11672,4237,2791
68624,1519,3388,47888,20736,3.59347e+13,856.025,10633.8,68624,706,493,65236,64549,58653,44735,38879
29624,1356,2008,20700,8924,3.23573e+13,672.145,5814,29624,364,383,27616,27257,26213,24368,20862
19740,1238,2101,13733,6007,3.60716e+13,354.083,4944.01,19740,263,423,17639,17543,17291,17329,12793
6618,565,922,4692,1926,3.53748e+13,195.634,1923.99,6618,204,177,5696,5580,5530,5216,4533
76977,2839,3057,52770,24207,3.5237e+13,1031.64,10548,76977,590,522,73920,73816,73811,73533,71514
83567,2232,2877,58330,25237,3.67455e+13,900.749,10186.9,83567,586,504,80690,80605,78657,74572,73528
2546,273,450,1725,821,3.41661e+13,169.93,902.672,2546,118,102,2096,1896,1935,1703,1640
98726,2835,3531,67204,31522,3.48753e+13,1051.7,12395.5,98726,588,547,95195,95113,94669,94096,88877
26124,1118,1897,17857,8267,3.49694e+13,508.811,5304.15,26124,338,409,24227,23918,23736,23580,20472
27559,321,2045,19502,8057,3.70821e+13,655.263,5644.59,27559,384,445,24599,22743,18946,15879,7100
74040,1439,3557,52477,21563,3.72422e+13,865.664,11640.4,74040,604,738,70483,69817,65963,62387,36531
61198,512,2644,42752,18446,3.67503e+13,701.968,8578.19,61198,455,411,57991,56905,37316,27406,16409
37843,1808,1962,26442,11401,3.62053e+13,618.96,6138.8,37843,380,380,35881,35880,35830,35724,35135
95894,223,3859,66121,29773,3.43198e+13,982.027,13454.1,95894,612,591,83388,75344,49304,17368,11454
77232,1048,4101,52630,24602,3.43057e+13,922.839,12628.6,77232,583,595,72915,71153,50546,37058,30706
39637,1262,2324,28873,10764,3.73428e+13,726.676,7227.37,39637,406,427,37313,36602,36325,35129,25245
75343,2179,2932,53343,22000,3.69928e+13,838.393,10161,75343,613,428,72411,72291,72044,71603,64487
26027,1069,1362,18087,7940,3.65787e+13,398.558,4065.72,26027,282,272,24665,24640,24388,24399,21809
38208,965,1760,26476,11732,3.22038e+13,515.329,5755.71,38208,366,370,36448,36376,35393,34721,29340
56535,1947,2702,40911,15624,3.80145e+13,910.547,8863.71,56535,563,549,53833,53788,52785,51856,44595
13746,332,1169,9332,4414,3.06043e+13,244.443,2965,13746,251,224,12571,12240,10614,7579,5495
49935,210,2146,35116,14819,3.58098e+13,782.579,7445.99,49935,620,395,43413,39137,29506,14313,11141
93881,3582,3730,64331,29550,3.57844e+13,770.576,12282,93881,576,549,90151,90151,90104,90102,89613
20013,1098,1591,14218,5795,3.79605e+13,487.257,4352.85,20013,443,289,18422,18320,17198,14240,13951
29846,1177,1604,21000,8846,3.63628e+13,587.356,5175.49,29846,318,371,28242,28194,28103,27991,25652
86323,1601,2885,60297,26026,3.61295e+13,1310.59,10571.5,86323,637,600,83318,81704,77222,64575,64354
72689,1812,3442,49689,23000,3.38819e+13,1165.35,10943.8,72689,580,711,69247,68570,65842,62015,49718
37239,487,2336,26061,11178,3.48419e+13,721.792,6680.99,37239,422,441,33808,31957,22754,15744,9110
39033,248,2685,27447,11586,3.70553e+13,543.926,7681.75,39033,469,431,33945,30123,20604,10210,8373
19887,1231,1520,13753,6134,3.44734e+13,448.101,4262.77,19887,313,260,18367,18352,17817,17367,15999
87398,3034,3513,59873,27525,3.479e+13,1020.9,11778.1,87398,549,616,83885,83879,83671,83709,79077
2428,234,527,1633,795,3.50131e+13,89.8793,930.034,2428,94,111,1901,1824,1790,1780,971
78291,1812,2998,55307,22984,3.63307e+13,1096.44,10699.6,78291,618,550,75293,74705,72322,65463,57663
2843,54,528,1968,875,3.37704e+13,173.394,1036.22,2843,183,95,1886,1516,1303,664,453
30124,505,1774,20986,9138,3.52125e+13,640.641,5486.17,30124,428,301,27654,26241,21850,16307,12795
87897,1100,2471,62080,25817,3.61043e+13,1018.67,9275.62,87897,601,452,85112,83444,74727,61546,62791
59819,1945,3269,40452,19367,3.4466e+13,829.853,10145,59819,485,598,56550,56186,55752,55595,46701
81490,151,3043,58281,23209,3.63653e+13,783.991,10729.7,81490,611,364,66873,57517,43999,13936,9741
10248,436,982,7143,3105,3.63422e+13,268.442,2430.12,10248,183,254,9266,9094,8522,8598,4759
96973,1417,3277,66199,30774,3.36901e+13,1095.51,12506.1,96973,603,698,93696,92577,89459,80654,63569
98163,804,2719,69230,28933,3.66646e+13,1016.91,10713,98163,599,509,94415,92112,67278,48293,39061
85975,1455,2399,60207,25768,3.53621e+13,743.026,9284.08,85975,462,438,83576,83501,80934,79017,69001
19863,563,1456,14414,5449,3.73313e+13,606.112,4180.43,19863,398,297,17961,17030,16113,12104,10085
99635,2507,3162,71150,28485,3.73832e+13,1102.85,12528.9,99635,640,526,96473,96397,95849,95581,85714
31566,2047,2091,21661,9905,3.35848e+13,521.619,5962.21,31566,349,419,29475,29475,29475,29475,29053
11743,563,976,8342,3401,3.66456e+13,277.242,2498.84,11743,200,235,10767,10683,10249,10041,7083
76749,2077,2555,54654,22095,3.69024e+13,1047.88,9624.87,76749,544,466,74194,74082,73807,73092,71448
25675,569,1792,17877,7798,3.66951e+13,432.515,5078.41,25675,307,300,23805,23382,20744,15215,11859
11706,397,1288,8316,3390,3.74458e+13,277.181,3027.04,11706,238,276,10399,9944,9226,7810,5498
44454,622,2148,31877,12577,3.70876e+13,911.108,7291.47,44454,514,426,41331,39612,35257,25578,19330
92027,1607,2351,64189,27838,3.30177e+13,1019.83,10225.1,92027,494,466,89676,89431,87211,83069,67079
25322,403,1783,17571,7751,3.22727e+13,560.359,4932.91,25322,337,279,23019,22003,17415,11548,9181
33360,1248,2313,23149,10211,3.63549e+13,586.501,6664.38,33360,373,580,31047,30728,30088,29751,19382
82345,657,2486,58618,23727,3.57928e+13,974.234,9236.35,82345,542,488,78434,75731,61306,51040,39099
66410,447,3074,45407,21003,3.54252e+13,830.472,9852.63,66410,561,473,60988,57989,36343,22576,19769
14401,853,1385,10241,4160,3.77869e+13,357.473,3460.22,14401,272,282,13016,12979,12705,12560,10720
37939,663,1912,26574,11365,3.66955e+13,628.386,6290.4,37939,448,333,35728,34279,31816,26221,22255
30173,612,1946,20659,9514,3.39323e+13,584.053,5606.84,30173,363,309,27994,27156,21547,15390,12705
82952,1732,3719,57160,25792,3.55367e+13,1003.07,12911.6,82952,581,807,79233,78419,75970,68623,49972
9605,660,947,6843,2762,3.82322e+13,467.422,2383.23,9605,267,197,8585,8101,8210,7721,7476
63510,524,3096,44353,19157,3.53592e+13,993.672,10040.4,63510,594,674,58395,55633,41837,30402,19403
48300,1396,2286,32996,15304,3.3091e+13,1015.33,7776.41,48300,484,533,45933,45136,44145,41090,35693
68888,2727,2847,48085,20803,3.54602e+13,1017.92,9839.87,68888,497,531,66041,66041,66030,66040,65696
34434,738,1976,24443,9991,3.71104e+13,714.617,6245.89,34434,428,389,32153,31093,29392,26197,18046
64096,1698,3484,44035,20061,3.39809e+13,1328.25,10932.4,64096,608,743,60314,59343,55134,46661,38814
10173,7361,10173,0,10173,15.9984,0,10173,10173,10173,1,0,0,0,0,0
36326,374,1982,25639,10687,3.60833e+13,718.715,6128.35,36326,437,321,32788,30371,24434,15979,10145
21059,664,1486,14965,6094,3.58727e+13,460.525,4217.57,21059,383,235,19573,19124,17650,13250,12126
89028,2403,2894,61473,27555,3.39132e+13,1290.33,11034.7,89028,574,548,86134,85859,85181,82542,82766
78017,659,3016,55299,22718,3.63766e+13,1223.71,10686.5,78017,632,470,73132,70571,51167,36321,28082
12096,236,1413,8733,3363,3.81353e+13,298.981,3258.48,12096,208,275,10254,9179,8814,8785,3415
75850,1466,2952,52464,23386,3.36991e+13,1053.59,10278.8,75850,573,614,72781,71803,68387,57652,47556
81806,2490,3024,57443,24363,3.64761e+13,1172.81,11142.1,81806,728,585,78782,78332,77390,75005,72051
91833,2142,2589,63756,28077,3.57897e+13,1166.67,9934.37,91833,555,511,89244,89197,88835,88253,85820
32689,1994,2309,22633,10056,3.46491e+13,516.451,6309.51,32689,471,364,30380,30357,30175,30094,27279
81806,1860,3967,57220,24586,3.50776e+13,937.652,13146.4,81806,573,709,77839,77382,73945,69324,47196
17153,1810,1845,12153,5000,3.68757e+13,363.122,4346.82,17153,326,365,15308,15308,15308,15308,15274
41117,1031,2550,29150,11967,3.55557e+13,722.392,7418.58,41117,541,375,38567,37530,33656,26073,24135
6825,342,821,4792,2033,3.72255e+13,204.264,1919.87,6825,153,223,6004,5859,5738,5719,4308
68677,1847,2969,47293,21384,3.4255e+13,766.524,9903.34,68677,535,621,65708,65596,63456,59068,54098
75965,2802,3197,51581,24384,3.52219e+13,974.379,11006.1,75965,605,518,72768,72750,72604,72595,70224
45604,1429,2793,30673,14931,3.3405e+13,682.471,8389.69,45604,480,686,42811,42648,40644,37440,27524
62405,974,2412,42892,19513,3.23222e+13,837.183,8737.83,62405,423,469,59857,58542,53997,42252,30981
95110,2616,3774,65769,29341,3.37811e+13,1077.58,13254.4,95110,569,655,91336,91122,89921,86228,77437
45274,635,1959,31632,13642,3.52701e+13,844.664,6672.32,45274,439,448,42327,40576,33890,24522,18896
50659,1035,2665,34857,15802,3.65914e+13,596.324,7725.28,50659,568,370,47994,47274,41949,35293,34101
4078,399,583,2818,1260,3.66922e+13,205.439,1262.25,4078,132,138,3495,3448,3356,3248,3058
6799,278,1054,5018,1781,3.80277e+13,208.661,2107.75,6799,251,154,5690,5300,4958,4740,2094
12261,377,895,8313,3948,3.59894e+13,418.64,2631.69,12261,208,251,11050,10091,9751,8243,7189
22676,1044,1662,15928,6748,3.48229e+13,504.12,4614.31,22676,349,294,21014,20708,19447,15416,16645
54925,1870,2011,38780,16145,3.67563e+13,917.334,7673.75,54925,492,383,52914,52914,52887,52894,52414
24826,180,1540,17281,7545,3.47822e+13,584.701,4619.72,24826,372,298,21036,18784,14290,6398,4888
44416,228,2305,31272,13144,3.50262e+13,737.53,7430.79,44416,372,426,38535,35168,25111,11479,8670
44790,2505,2511,30719,14071,3.26544e+13,723.105,7482.68,44790,464,398,42279,42279,42279,42279,42279
45591,643,1953,31461,14130,3.54787e+13,676.03,6780.46,45591,458,439,43021,41750,33956,23893,22563
52135,1790,2729,36726,15409,3.49994e+13,753.313,8542.57,52135,634,351,49406,49223,48188,43875,42826
51764,1148,1593,36861,14903,3.67575e+13,837.075,6537.35,51764,492,370,50171,50011,48496,46891,45854
42625,2342,2467,29365,13260,3.53852e+13,729.702,7449.2,42625,445,397,40158,40158,40096,40084,39800
47704,1923,2060,32965,14739,3.37919e+13,632.17,6903.93,47704,420,431,45644,45644,45625,45590,44356
63745,1341,2762,45361,18384,3.68129e+13,1041.34,9711.66,63745,645,537,60668,60049,56021,49387,39956
53904,2554,3013,37672,16232,3.59797e+13,648.698,9069.16,53904,495,392,50891,50881,50469,49622,45746
84135,1945,3199,60510,23625,3.70257e+13,1117.6,11768.2,84135,912,564,80936,80566,76907,65821,66425
44346,497,2142,31204,13142,3.60253e+13,767.641,7124.84,44346,449,377,40965,38787,28982,19826,15106
19863,154,787,13548,6315,3.52166e+13,403.481,2975.25,19863,245,236,16113,13728,11031,7557,6552
52456,705,1760,36427,16029,3.19022e+13,938.579,6682.16,52456,366,410,49854,48069,45041,32151,25033
85152,329,3429,58458,26694,3.48372e+13,1171.54,11821.6,85152,605,604,76596,69686,43440,18145,15439
98311,1571,3565,69249,29062,3.60408e+13,1140.79,13329.7,98311,884,636,94370,93499,82720,63165,59888
81722,3601,3647,55815,25907,3.45544e+13,792.8,12241.9,81722,615,559,78075,78075,78069,78073,77976
96823,1772,2900,67203,29620,3.52856e+13,910.628,11077.2,96823,552,527,93923,93718,89361,84365,58870
78021,1976,2764,55943,22078,3.68421e+13,1028.37,10707.8,78021,562,518,75257,75082,73692,72029,66863
70379,2094,2952,48575,21804,3.45331e+13,1129.49,10008.1,70379,520,581,67427,66821,63349,55148,57573
60178,3096,3514,41442,18736,3.54831e+13,822.608,10722.6,60178,515,610,56664,56664,56521,56585,53810
67599,2205,3392,48055,19544,3.566e+13,817.208,10889.2,67599,632,764,64207,64076,62906,62680,51160
25577,490,1934,18127,7450,3.48447e+13,474.398,5265.36,25577,443,345,23208,22405,15854,12489,10446
1336,287,396,937,399,3.58257e+13,62.0494,625.591,1336,70,85,940,937,932,923,825
4768,365,564,3244,1524,3.36535e+13,267.208,1343.04,4768,180,151,4196,3962,3777,3562,3491
36272,25,1720,26291,9981,3.62999e+13,710.338,5675.99,36272,432,320,22564,17200,13999,5497,2984
6057,513,607,4199,1858,3.26173e+13,306.915,1578.05,6057,184,175,5450,5446,5297,5277,5019
19452,15,1433,13621,5831,3.68691e+13,423.935,3905.61,19452,266,282,10203,6626,5980,4718,1397
13314,305,1250,9576,3738,3.67812e+13,438.049,3182.24,13314,348,281,11438,10503,8972,6995,4801
82141,1738,3611,56878,25263,3.39851e+13,1006.19,11707.6,82141,649,779,78530,77426,71819,58727,58994
37736,2105,2237,25775,11961,3.5451e+13,622.885,6726.61,37736,582,387,35499,35498,35485,35491,34985
67440,1600,2339,47560,19880,3.57058e+13,921.054,8526.02,67440,647,379,65101,64753,62754,58665,56338
80654,2495,3517,56017,24637,3.5344e+13,906.069,11705,80654,581,571,77137,77105,75755,74225,65833
5965,626,736,4206,1759,3.80891e+13,237.345,1672.33,5965,197,147,5229,5205,5190,5143,4862
2836,7,494,1895,941,3.04298e+13,86.8653,964.223,2836,119,92,974,471,424,341,145
45310,141,2058,32100,13210,3.5029e+13,636.916,6864.7,45310,520,326,38053,33762,23740,10081,7991
88709,1284,2708,61193,27516,3.54418e+13,919.558,11068.4,88709,571,527,85963,84547,78227,61608,43475
88740,447,2350,62342,26398,3.53036e+13,1018.27,9779.99,88740,645,470,82658,78320,57044,42077,30726
51537,70,1505,35674,15863,3.37828e+13,844.491,6254.85,51537,395,355,39874,34083,24635,7310,5239
59405,1568,2359,41281,18124,3.62546e+13,938.203,8380.36,59405,528,499,57046,56824,55258,53890,50009
76535,1900,3051,51534,25001,3.41008e+13,835.941,10202.1,76535,538,572,73484,73466,71239,67777,52671
28640,1015,1976,19859,8781,3.31772e+13,615.829,5587.92,28640,377,325,26664,26165,24409,19612,16740
99719,2446,3344,70231,29488,3.61588e+13,1032.16,12680.9,99719,850,635,96375,96361,91313,83698,80606
9384,455,1201,6599,2785,3.5984e+13,342.895,2727.83,9384,253,248,8116,7775,7471,6292,4649
58599,1886,2116,41678,16921,3.78317e+13,687.301,7702.95,58599,518,365,56483,56480,55998,55373,55163
36273,976,1909,25249,11024,3.43598e+13,604.093,5995.32,36273,378,419,34364,33909,31546,26402,20845
81408,596,3077,56970,24438,3.37509e+13,1134.78,11059.2,81408,574,506,76269,73059,55955,39127,26374
98887,1435,4303,68667,30220,3.55177e+13,1188.57,14141.5,98887,645,754,94322,92529,75937,57725,47265
58107,1388,2981,39612,18495,3.49124e+13,948.283,9676.64,58107,626,650,55031,54147,47801,40540,33216
28502,23839,28502,0,28502,15.9994,0,28502,28502,28502,1,0,0,0,0,0
67623,1318,2980,47908,19715,3.62085e+13,926.15,10221.6,67623,730,441,64574,63364,59277,48370,42186
49151,2415,2629,33739,15412,3.23447e+13,670.954,8110.82,49151,437,453,46522,46488,46473,46491,45277
66274,916,2900,46174,20100,3.47547e+13,651.448,9475.88,66274,521,427,63374,62706,46643,35009,25404
12051,180,1127,8306,3745,3.31534e+13,301.476,2841.11,12051,303,193,10299,9423,7741,5198,3171
6827,263,750,4731,2096,3.43485e+13,243.465,1794.48,6827,199,148,5840,5020,3975,2979,2204
79996,2097,3053,55296,24700,3.49095e+13,1073.03,11137.6,79996,548,584,76943,76602,74769,72381,63103
53382,407,2477,38210,15172,3.7561e+13,722.065,8170.92,53382,465,461,48471,44919,35272,23130,21055
63001,2573,3125,43550,19451,3.48191e+13,780.925,9832.59,63001,472,513,59876,59861,59661,59542,55234
1160,320,324,786,374,3.78644e+13,71.3966,528.081,1160,71,77,836,836,836,836,836
22087,147,1015,15206,6881,3.58777e+13,327.303,3111.99,22087,222,217,18154,14978,10716,4499,4610
7732,511,1025,5341,2391,3.67071e+13,219.013,2249.11,7732,267,151,6707,6660,6167,5245,4623
87448,412,2649,59977,27471,3.51495e+13,636.957,10393.8,87448,581,443,81534,73914,51688,29338,30508
95971,3012,3843,66661,29310,3.52365e+13,1324.61,13384.4,95971,712,701,92128,91677,90695,86316,86669
70036,2019,2896,50387,19649,3.6572e+13,964.066,10314.6,70036,656,545,67140,66911,65230,58450,56399
32545,1541,1994,23474,9071,3.65538e+13,677.145,6156.96,32545,419,411,30551,30479,30170,29828,27497
9832,927,1059,6432,3400,2.98764e+13,275.05,2565.62,9832,235,258,8773,8734,8663,8306,8334
3108,479,545,2133,975,3.54646e+13,144.741,1078.47,3108,100,122,2563,2563,2558,2559,2448
6702,680,1106,4557,2145,3.37708e+13,157.144,2237.49,6702,185,221,5596,5557,5414,5370,3850
46287,810,1987,32630,13657,3.33537e+13,935.398,6864.31,46287,475,442,43572,42197,40283,31138,22370
30735,2308,2342,21005,9730,3.42225e+13,539.036,6275.39,30735,370,317,28393,28393,28388,28380,28250
3417,96,640,2496,921,4.00419e+13,111.825,1185.72,3417,171,120,2656,2387,1761,1139,730
69219,1913,2211,47701,21518,3.35179e+13,1050.16,8410.67,69219,466,408,67008,66978,66584,66127,63965
6524,573,822,4605,1919,3.62237e+13,238.217,1896.48,6524,191,169,5702,5692,5544,5052,4987
1231,64,379,860,371,3.45339e+13,67.9943,601.79,1231,100,75,790,688,610,538,199
41141,629,2022,28374,12767,3.3762e+13,514.539,6524.06,41141,454,370,39053,38339,31851,22711,17264
52410,842,2520,36220,16190,3.51256e+13,929.651,8251.78,52410,565,455,49182,47693,36433,27627,25285
81082,376,3436,57037,24045,3.62695e+13,937.022,11530.6,81082,601,578,74115,69111,48807,17536,17655
32286,1399,2241,23173,9113,3.73167e+13,740.78,6382.97,32286,439,328,30045,29634,29048,27199,23810
39285,578,1809,27328,11957,3.43534e+13,589.176,6192.67,39285,463,325,37031,35264,25460,19935,16868
94111,789,2737,67882,26229,3.66675e+13,1239.7,10753.2,94111,626,430,89249,85650,70337,50263,46779
58600,1062,1309,40536,18064,3.18664e+13,857.997,6309.53,58600,450,378,57291,56937,55997,54821,50840
88882,157,2878,61786,27096,3.39726e+13,1100.54,10940.9,88882,617,545,75270,67135,46061,13484,12995
51332,327,2153,36707,14625,3.76806e+13,680.011,7194.46,51332,482,354,45751,42187,32150,21176,16643
51103,2370,2473,35694,15409,3.52699e+13,955.405,7961.98,51103,461,386,48630,48624,48594,48588,47988
54056,2079,2582,38967,15089,3.72447e+13,870.852,8831.93,54056,693,375,51474,51461,49870,46678,44614
73145,433,3139,51261,21884,3.57372e+13,985.71,10796.7,73145,694,516,67594,64616,46108,27038,17985
76341,2200,2997,52471,23870,3.49264e+13,1140.79,10531.2,76341,585,532,73344,73198,71447,68033,65266
28567,862,2226,20101,8466,3.72963e+13,650.551,6216.51,28567,433,404,26220,25167,24198,21465,14159
43163,276,2141,29409,13754,3.47372e+13,692.632,7177.66,43163,363,537,38748,35160,24280,12753,7637
6139,881,904,4466,1673,3.97572e+13,186.969,1860.24,6139,204,158,5235,5235,5234,5233,5193
37335,1266,1895,26650,10685,3.67016e+13,723.642,5989.06,37335,436,371,35440,34870,33916,31268,30616
49405,1341,2651,33578,15827,3.35662e+13,747.77,7899.85,49405,453,518,46754,46063,40830,33156,32837
75898,2840,3008,52834,23064,3.5335e+13,881.272,10551.5,75898,646,530,72890,72864,72813,72859,72352
18101,1322,1418,12462,5639,3.59269e+13,418.588,3980.32,18101,299,283,16683,16682,16657,16661,16426
79324,2434,3362,54054,25270,3.42374e+13,1140.31,11492.8,79324,638,602,75962,75953,73525,68984,65365
81458,1736,3142,57047,24411,3.51626e+13,812.977,11116.9,81458,800,394,78316,78056,73367,59882,58929
33618,457,1763,23616,10002,3.675e+13,809.596,5891.18,33618,464,386,30214,28370,24718,18173,12129
7476,717,1107,5442,2034,3.85211e+13,232.78,2276.86,7476,198,208,6369,6349,6167,6130,4606
97418,2809,3901,66291,31127,3.39791e+13,1207.25,13908.5,97418,633,821,93517,93417,91700,87541,78841
62803,767,3015,44053,18750,3.59917e+13,828.541,9692.7,62803,711,438,59115,57404,40387,28227,20730
60729,2520,2681,42126,18603,3.46677e+13,876.808,8797.58,60729,603,569,58048,58028,57970,57968,57561
70747,1756,2894,48712,22035,3.60009e+13,966.133,9760.54,70747,542,547,67853,67250,63447,55488,55901
49271,1519,2250,34253,15018,3.53304e+13,636.883,7180.2,49271,387,474,47021,46919,44753,41675,38875
51175,1951,2527,35093,16082,3.3399e+13,667.54,8281.61,51175,463,517,48648,48534,48390,48437,44930
90679,2874,3536,63143,27536,3.54467e+13,1513.71,12517.5,90679,592,611,87143,86810,86237,85739,80534
10178,844,997,6949,3229,3.7246e+13,245.413,2426.82,10178,242,176,9181,9181,9107,9103,8934
13717,1386,1409,9753,3964,3.75474e+13,434.762,3469.38,13717,272,307,12308,12308,12306,12308,12296
93555,2625,3555,66854,26701,3.58429e+13,1000.47,12918.7,93555,583,592,90000,89945,89617,88974,77446
70542,355,3353,50199,20343,3.75816e+13,923.546,11209.1,70542,577,583,63171,57948,42887,24815,10518
92732,1991,2315,64186,28546,3.22404e+13,1093.05,9836.07,92732,580,462,90417,90409,89758,88141,86431
16303,502,1214,11362,4941,3.36962e+13,277.394,3215.11,16303,261,287,15089,14732,13241,11668,8018
36733,1208,1727,26299,10434,3.65449e+13,851.694,5864.24,36733,488,379,34928,33804,33772,32469,29028
45011,1744,1919,31226,13785,3.43327e+13,689.543,6504.03,45011,406,422,43092,43085,43052,42915,41509
76185,3025,3666,51044,25141,3.24546e+13,742.305,11336.9,76185,606,458,72519,72506,70812,66562,66230
2432,218,466,1680,752,3.71605e+13,140.381,883.253,2432,121,105,1954,1794,1748,1599,1196
41248,1955,2508,28381,12867,3.3534e+13,762.699,7377.72,41248,441,459,38740,38430,38429,38051,34391
77469,74777,77469,0,77469,15.9998,0,77469,77469,77469,1,0,0,0,0,0
83074,2424,2921,57921,25153,3.55438e+13,1098.46,10777.8,83074,692,565,80153,80134,79054,76304,75133
35802,1237,2154,24796,11006,3.59314e+13,760.534,6599.68,35802,425,414,33648,33170,30971,26829,24187
1791,101,381,1234,557,3.05022e+13,165.402,712.687,1791,124,86,1244,1055,962,798,614
69147,1841,2811,49136,20011,3.73582e+13,977.841,9966.61,69147,485,595,66336,66135,65526,64254,54094
13695,1260,1335,9187,4508,3.17533e+13,211.835,3233.86,13695,178,311,12360,12360,12354,12360,12219
62194,601,2626,42770,19424,3.4703e+13,670.831,8982.63,62194,475,406,59166,57248,40143,29837,20335
10236,663,909,7310,2926,3.61388e+13,289.198,2346.65,10236,279,164,9327,9313,9006,8182,8212
60228,824,3003,41634,18594,3.46408e+13,619.063,9171.2,60228,397,483,57037,56030,43867,34200,28639
46776,933,2793,32723,14053,3.57578e+13,714.24,8384.68,46776,482,444,43800,42618,37107,27998,22671
36669,692,1677,25349,11320,3.57958e+13,647.399,5616.33,36669,378,341,34602,32268,30405,22900,24501
29140,1638,1695,20097,9043,3.41884e+13,605.997,5060.04,29140,297,340,27445,27445,27439,27444,27371
93026,1823,3261,66842,26184,3.68738e+13,1310.84,12273.9,93026,654,666,89765,88607,83751,66402,61394
37095,167,2059,26189,10906,3.56244e+13,692.857,6471.91,37095,504,351,30586,26417,20609,7437,5378
93098,404,3794,65585,27513,3.65356e+13,938.62,12611.9,93098,589,595,85161,77708,53335,24229,23046
60936,1208,2791,43496,17440,3.75142e+13,802.095,9371.23,60936,554,586,58064,56566,53713,51279,31053
27659,1061,1802,19649,8010,3.76829e+13,610.098,5344.16,27659,402,409,25857,25556,24771,24400,17639
29911,841,1616,20716,9195,3.44315e+13,386.391,4937.46,29911,319,275,28295,28221,27516,27198,21686
60659,1150,2246,41897,18762,3.30937e+13,991.121,8072.35,60659,488,450,58147,57067,53054,40061,40632
47272,178,2145,33587,13685,3.68944e+13,1012.63,7391.04,47272,470,433,39748,34147,27216,9468,6691
57397,2013,2275,40534,16863,3.66422e+13,798.989,7673.19,57397,467,379,55122,55121,55052,54922,54195
3205,612,647,2428,777,3.96999e+13,66.9164,1139.85,3205,119,120,2558,2558,2558,2558,2484
16501,1220,1222,11191,5310,3.17064e+13,337.604,3346.72,16501,251,210,15279,15279,15279,15279,15279
20447,841,1317,14041,6406,3.61334e+13,408.346,4007.05,20447,283,283,19130,18984,17895,14444,14463
28134,1613,2345,19690,8444,3.64172e+13,531.746,6247.81,28134,348,515,25789,25707,25467,25447,19580
2200,253,397,1583,617,3.98568e+13,126.376,762.083,2200,84,110,1803,1659,1642,1606,1450
94547,1766,2899,65093,29454,3.32758e+13,1035.2,10585.7,94547,633,510,91648,91060,86373,73547,80605
25272,749,1858,17457,7815,3.51348e+13,377.28,5036.44,25272,374,288,23414,23245,21256,16949,14706
9181,167,1077,6199,2982,3.37737e+13,198.972,2469.49,9181,221,206,7814,7253,5819,5280,3122
50597,838,2387,35307,15290,3.60539e+13,797.491,7994.9,50597,548,398,47845,46392,40734,27980,23713
43690,1364,2484,31525,12165,3.72451e+13,810.888,8046.27,43690,458,501,41206,40543,39657,37622,28305
34441,820,1999,23827,10614,3.52468e+13,724.82,6050.68,34441,479,416,32286,31632,26909,20776,20724
38404,941,2101,26700,11704,3.34998e+13,606.309,6319.08,38404,329,400,36303,35533,33492,32388,20524
69220,2048,2267,50257,18963,3.66403e+13,876.396,8543.42,69220,606,491,66953,66953,66461,65831,65235
85120,637,3648,60024,25096,3.61152e+13,1020.35,12218.7,85120,709,655,79407,75338,55062,41079,21012
16258,963,1390,11553,4705,3.72029e+13,493.058,3743.5,16258,407,272,14868,14809,14006,12976,11862
32464,140,2127,22728,9736,3.6165e+13,540.215,6302.47,32464,447,398,26749,23079,16881,9379,4946
65146,2036,2760,44438,20708,3.44375e+13,694.829,9306.56,65146,457,483,62386,62349,61466,60707,54164
8759,1119,1140,6139,2620,3.73151e+13,328.111,2536.65,8759,233,281,7619,7619,7619,7619,7599
60260,151,2825,42363,17897,3.60418e+13,1097.58,9385.38,60260,537,490,49276,43225,32124,9439,7748
53833,1174,2429,36837,16996,3.61055e+13,1095.5,8253.96,53833,540,573,51023,49326,43338,34444,33194
14826,90,1542,10618,4208,3.62585e+13,407.984,3712.35,14826,367,287,11457,9947,7193,1922,1735
98007,392,2984,70042,27965,3.79562e+13,1150.86,11277.5,98007,731,557,88509,81628,57542,29262,23133
11033,781,1049,7542,3491,3.4459e+13,426.496,2836.18,11033,279,224,9984,9797,9792,9728,8823
58829,1198,2051,41830,16999,3.61893e+13,933.474,7610.54,58829,500,420,56756,55894,52676,46646,42272
9235,480,902,6601,2634,3.69447e+13,270.805,2188.66,9235,216,213,8333,8208,7688,7611,5481
86463,1460,3062,60898,25565,3.49913e+13,1368.51,11442.3,86463,586,575,82874,80703,78550,69231,61834
94949,336,2940,64896,30053,3.51386e+13,1116.47,10813.7,94949,508,525,86952,79555,50667,23878,23445
29160,1418,1783,19858,9302,3.42858e+13,362.392,4915.81,29160,358,264,27377,27353,27270,27196,26168
19304,132,2117,13358,5946,3.36505e+13,332.117,4880.64,19304,433,287,16068,14865,9542,4366,2795
64308,539,2440,45468,18840,3.66308e+13,914.801,8516.06,64308,492,423,59886,56144,41193,25435,20360
44369,1481,1980,31436,12933,3.49036e+13,889.028,6757.15,44369,445,343,42389,42114,40987,38308,35506
53025,913,2320,37745,15280,3.70949e+13,856.58,7979.21,53025,563,439,50372,48934,37607,26695,25613
8318,378,873,5739,2579,3.40797e+13,242.794,2097.34,8318,225,173,7445,7225,6762,6098,4662
42119,2061,2456,29379,12740,3.64536e+13,654.61,7113.16,42119,540,320,39663,39662,39474,39470,38152
83584,2400,3056,57495,26089,3.53149e+13,851.334,10614.3,83584,570,477,80528,80493,78929,76006,73623
69229,1897,2159,50708,18521,3.71359e+13,1022.45,9306.27,69229,563,480,67070,67039,66865,66337,63426
35110,1318,2236,24735,10375,3.49399e+13,640.221,6472.66,35110,436,350,32874,32635,31691,27747,25642
48161,272,2301,32785,15376,3.29166e+13,756.293,7557.37,48161,537,469,43198,40578,28271,15798,11216
51236,2536,2587,35916,15320,3.72439e+13,645.463,7994.81,51236,534,435,48649,48649,48644,48646,48565
31627,427,2288,21711,9916,3.34857e+13,483.901,6287.22,31627,455,499,29081,27823,23212,21211,11039
92325,2908,3080,65011,27314,3.57657e+13,1098.47,12040.3,92325,685,524,89245,89245,89037,88863,88401
9333,247,1134,6359,2974,3.50185e+13,241.842,2565.9,9333,233,234,7980,7404,5870,4336,3512
92165,2363,4270,63311,28854,3.58156e+13,1245.62,13871.9,92165,699,607,87895,86857,81728,66118,66107
33347,560,2016,24004,9343,3.63106e+13,634.459,6120.11,33347,437,326,30891,29925,26244,17669,12962
1460,161,386,1021,439,4.90718e+13,51.887,599.742,1460,109,60,1074,1016,1012,1014,655
45326,1602,1660,31892,13434,3.64541e+13,771.868,6026.38,45326,437,354,43666,43666,43660,43661,43583
27266,1763,2029,19433,7833,3.79053e+13,580.967,5680.05,27266,374,474,25237,25237,25162,25175,23945
98333,3408,3491,70720,27613,3.672e+13,1104.05,12845.1,98333,754,593,94842,94842,94822,94754,94516
18825,976,1674,13449,5376,3.60313e+13,414.437,4344.76,18825,347,272,17151,16993,16207,14941,12622
69387,2490,2992,49185,20202,3.69256e+13,978.502,9823.34,69387,522,500,66395,66368,66155,65895,62077
90170,139,2847,64035,26135,3.71032e+13,1075.01,10687.3,90170,673,500,73879,64610,46059,15122,14269
38906,95,2210,26659,12247,3.58432e+13,497.061,6662.95,38906,371,446,29521,25584,18460,6703,4513
89964,1890,3326,61819,28145,3.46121e+13,1257.52,11870,89964,633,617,86638,85531,78778,63697,65540
46011,468,2494,31645,14366,3.47861e+13,756.001,7457.08,46011,499,374,42155,39625,28056,20083,15459
65264,2850,3021,45256,20008,3.51329e+13,892.485,9764.8,65264,612,449,62243,62239,62225,62242,61086
52078,339,2830,36015,16063,3.56598e+13,843.195,9032.11,52078,449,553,46656,43194,29675,15794,12312
93551,3813,3869,64476,29075,3.54101e+13,1271.04,13497.1,93551,756,704,89682,89678,89670,89673,89560
70867,1956,2591,50053,20814,3.61816e+13,1074.78,9331.04,70867,524,514,68276,68095,67209,65831,62279
57879,2232,2525,39776,18103,3.39167e+13,774.344,8444.69,57879,450,495,55354,55238,55187,55143,53654
45071,507,2297,30357,14714,3.48683e+13,809.815,7416.94,45071,438,459,41236,39719,27574,23042,16156
37426,938,2395,25695,11731,3.38925e+13,738.474,6892.89,37426,386,473,34981,34097,33233,29909,16081
71991,881,2917,50902,21089,3.71526e+13,1184.07,10388.2,71991,658,529,67909,65318,55001,36634,33402
15808,152,1371,11450,4358,3.60553e+13,523.331,3589.59,15808,312,283,12808,11387,8612,4863,3555
72086,773,2399,50452,21634,3.36597e+13,1219.36,9406.65,72086,463,473,68261,66432,61529,44375,34305
32310,75,1871,22628,9682,3.39015e+13,573.904,5598.5,32310,348,332,25341,21131,15411,3431,2797
36580,2150,2532,24537,12043,3.1737e+13,580.235,7123.05,36580,472,490,34048,34046,33907,33170,32521
47746,421,2335,33787,13959,3.61776e+13,710.887,7583.67,47746,442,441,43986,41321,34069,28039,11666
4414,307,346,3082,1332,2.33381e+13,101.79,967.35,4414,104,84,4068,4068,4053,4012,3785
62869,1823,2546,43499,19370,3.55086e+13,855.217,8628.16,62869,443,471,60323,60226,58878,56842,53680
9930,947,1154,6942,2988,3.62783e+13,388.992,2761.66,9930,233,246,8776,8770,8715,8758,8034
63001,1992,3173,44034,18967,3.7017e+13,950.924,10204.8,63001,639,524,59828,59567,56186,49295,46501
15326,1019,1359,10437,4889,3.07725e+13,280.995,3621.54,15326,330,333,13967,13959,13624,11615,10661
66549,608,2241,47571,18978,3.68425e+13,804.761,8302.71,66549,495,416,62933,59024,49053,31651,29346
88247,1826,2707,61444,26803,3.54842e+13,1060.31,10091.8,88247,625,445,85540,85152,82060,73908,73031
74042,1404,2781,52910,21132,3.62603e+13,1091.2,10243.3,74042,645,501,71115,69538,64707,49499,47541
24602,751,1659,16639,7963,3.41395e+13,537.745,4814.96,24602,385,329,22935,22147,18132,13041,10731
73589,1543,2875,50559,23030,3.44535e+13,859.269,10014.7,73589,502,455,70714,70200,64688,52226,46677
3275,424,729,2372,903,3.85965e+13,98.8464,1269.46,3275,138,136,2546,2530,2497,2494,1630
37361,1460,1864,25893,11468,3.09114e+13,766.63,6063.43,37361,386,469,35497,35045,35033,33627,33142
21472,454,1274,14795,6677,3.48581e+13,352.703,3723.52,21472,218,290,20198,19998,18073,17162,13600
62437,1979,2662,42872,19565,3.46349e+13,938.679,9371.25,62437,542,545,59775,59704,58731,57131,52713
64940,461,2822,45015,19925,3.42809e+13,645.281,9051.57,64940,361,526,61229,59319,42414,28958,23950
57478,2912,3036,40126,17352,3.52901e+13,904.738,9769.15,57478,556,530,54442,54433,54408,54365,53822
72266,1140,2533,50203,22063,3.62074e+13,850.346,8198.35,72266,574,483,69733,68548,59211,46361,50906
72710,876,3426,49919,22791,3.57436e+13,938.896,11190,72710,646,538,68673,66519,50761,40574,32772
9899,667,814,6739,3160,3.37708e+13,336.096,2185.22,9899,197,179,9085,9072,9024,8933,8691
65445,273,2334,46688,18757,3.64407e+13,884.244,8829.56,65445,478,466,58018,51705,39144,19200,15522
99557,1456,3569,69571,29986,3.46528e+13,1033.7,12766,99557,662,594,95988,94776,83567,59873,53205
19861,564,1507,13783,6078,3.40617e+13,365.866,4176.21,19861,279,287,18354,17995,16786,13890,10581
63100,1818,3226,43971,19129,3.56984e+13,1037.68,10066.1,63100,570,603,59874,59302,57377,55010,42815
20596,591,1629,14198,6398,3.60015e+13,452.289,4417.68,20596,350,360,18799,18179,14842,11660,9605
30997,1509,1680,22120,8877,3.58094e+13,688.827,5130.96,30997,345,383,29317,29282,29255,29274,28654
51172,462,2738,36062,15110,3.65573e+13,983.035,8670.49,51172,563,403,46408,43630,31281,21927,13982
29508,25,2011,20461,9047,3.56463e+13,623.551,5827.74,29508,353,379,18385,13551,10645,4519,1768
81469,1508,2963,57365,24104,3.63823e+13,1017.18,10549,81469,627,608,78506,77641,70091,55550,54787
26131,951,1762,17844,8287,3.28749e+13,467.042,5018.79,26131,277,339,24369,24102,23270,22058,17343
35477,1174,2103,24602,10875,3.60858e+13,740.975,6518.09,35477,449,349,33374,32821,31487,28328,25392
52643,1648,2559,35896,16747,3.31832e+13,607.786,8318.38,52643,406,520,50084,50073,49275,48122,38774
4290,215,578,3021,1269,3.00542e+13,125.799,1228.65,4290,127,132,3712,3602,3088,1969,1769
93606,2450,3310,65854,27752,3.66501e+13,1078.75,12308.1,93606,598,489,90296,90086,89611,89397,80832
32010,1502,2151,21908,10102,3.5035e+13,732.333,6300.75,32010,367,462,29859,29595,29326,28827,23867
57568,1328,2151,42429,15139,3.67268e+13,955.046,7954.93,57568,533,392,55417,55113,54343,53117,48110
50441,1343,2311,34324,16117,3.31114e+13,800.997,7569.83,50441,496,483,48130,47760,45743,39804,39754
49113,1201,2550,33986,15127,3.3184e+13,812.245,7767.07,49113,448,510,46493,45571,42934,36828,27470
77442,1658,3243,54591,22851,3.68331e+13,1101.28,11261.2,77442,674,484,74171,72946,65236,49140,47696
66861,2665,2868,46351,20510,3.52144e+13,855.863,9862.19,66861,457,525,63993,63980,63948,63949,63428
59438,1324,2674,40764,18674,3.28693e+13,874.391,9101.78,59438,580,495,56764,55878,51858,38590,38079
17798,475,1546,12876,4922,3.75195e+13,419.071,4071.68,17798,306,386,16129,15487,14528,13717,6165
59332,1773,2392,41036,18296,3.56348e+13,779.125,8290.96,59332,480,534,56940,56937,56725,56839,54003
39204,553,2195,27885,11319,3.66388e+13,817.226,6642.48,39204,407,332,36386,35210,29812,18436,15348
65384,2405,2768,45719,19665,3.62891e+13,925.017,9533.92,65384,558,549,62616,62613,62466,62344,61429
19033,860,1440,12680,6353,3.31539e+13,489.763,3900.16,19033,280,284,17593,17375,16200,14292,13674
39938,1760,2441,28037,11901,3.55946e+13,582.399,7031.89,39938,499,378,37497,37471,36793,34405,30718
2426,255,273,1684,742,2.68579e+13,96.4328,659.381,2426,77,73,2153,2152,2153,2153,2143
92339,1904,3101,65251,27088,3.46992e+13,1018.46,11557.3,92339,594,639,89238,88895,87087,85093,69959
53570,274,2847,37064,16506,3.49837e+13,622.736,8633.41,53570,486,379,47472,42663,30216,15066,8799
14176,503,1332,9598,4578,3.41745e+13,277.437,3363.15,14176,262,264,12844,12622,11592,9500,6553
69585,46,3066,47428,22157,3.50711e+13,938.912,10148.1,69585,602,585,48825,38959,28733,12563,5781
32895,348,2028,22783,10112,3.33736e+13,579.742,6068.66,32895,345,424,29911,28355,23533,19908,9112
98651,2212,3172,68302,30349,3.60971e+13,1012.07,11470.7,98651,616,512,95479,95405,93426,89702,88340
90072,3513,3645,64179,25893,3.66434e+13,1180.98,12972.6,90072,683,584,86427,86427,86366,86411,85924
51985,119,2283,36464,15521,3.71119e+13,801.104,7395.62,51985,531,419,41129,35764,26404,10114,8639
61267,32532,61267,0,61267,15.9997,0,61267,61267,61267,1,0,0,0,0,0
33262,639,1808,23686,9576,3.70098e+13,688.83,5889.04,33262,388,462,30890,29485,27156,21290,15317
7991,6888,7991,0,7991,15.998,0,7991,7991,7991,1,0,0,0,0,0
19418,216,1267,13809,5609,3.78295e+13,486.745,3734.34,19418,285,249,16387,14551,11201,6510,6088
36012,1333,2310,24975,11037,3.6036e+13,797.388,6743.59,36012,435,480,33702,33007,32238,29577,23686
50752,2464,2641,35104,15648,3.45094e+13,887.627,7801.17,50752,485,474,48111,48048,48055,48051,47125
71012,1772,2860,47754,23258,3.35051e+13,888.983,9805.13,71012,433,634,68152,68105,66777,63953,56523
12538,595,848,8596,3942,3.47901e+13,362.73,2497.6,12538,223,194,11690,11588,11249,10825,10568
41386,1536,2510,28434,12952,3.58052e+13,556.117,6952.41,41386,515,435,38876,38731,37665,34672,34224
18066,1605,1763,13281,4785,3.72198e+13,536.62,4393.67,18066,345,290,16303,16301,16261,16299,15766
53959,2234,2385,37418,16541,3.6402e+13,592.882,7614.34,53959,391,385,51574,51543,51539,51555,51117
24902,249,1891,17471,7431,3.66683e+13,661.3,5190.22,24902,425,426,21598,19458,15688,11458,5660
48289,672,2638,33619,14670,3.52481e+13,743.799,8233.33,48289,474,490,45133,43253,34389,25014,17766
15435,423,1694,10879,4556,3.76807e+13,342.877,4078.49,15435,271,474,13563,12851,12057,11248,4527
59524,987,1955,41977,17547,3.53053e+13,1064,7843.17,59524,492,464,56964,54967,52164,46379,36137
85038,2520,2762,59519,25519,3.42363e+13,1118.27,10242.5,85038,552,534,82276,82275,82150,82004,81302
42263,72,1726,30587,11676,3.70071e+13,893.554,6192.59,42263,448,428,31181,26571,21574,5325,4262
95058,1644,3852,65973,29085,3.49564e+13,1065.97,13394.2,95058,740,570,91206,89888,78523,56672,52530
59923,693,1708,42501,17422,3.6336e+13,841.278,6895.64,59923,493,348,57057,54743,50958,40695,36134
84327,1677,2383,60470,23857,3.73899e+13,1066.47,9940.47,84327,750,441,81944,81718,77661,67945,70594
53188,341,2344,37287,15901,3.66719e+13,882.369,7979.51,53188,578,480,47607,44079,30590,15180,11761
16864,412,1495,11580,5284,3.14936e+13,285.238,3812.07,16864,233,327,15337,14635,13305,9511,5142
46019,1880,2279,31366,14653,3.56204e+13,852.25,7122.96,46019,377,458,43740,43475,43382,43123,41110
23335,1573,1966,16229,7106,3.65763e+13,546.213,5187.91,23335,372,447,21369,21298,21116,21189,19443
2179,384,480,1513,666,3.35352e+13,149.937,865.343,2179,139,97,1699,1661,1629,1626,1493
52931,79,2292,36474,16457,3.60057e+13,516.489,7371.56,52931,353,381,39426,33885,25907,8424,7435
94241,1400,3267,65856,28385,3.54229e+13,1128.01,11704,94241,619,551,90791,89341,75934,58838,53073
76884,1274,3345,52339,24545,3.55441e+13,680.451,10842.1,76884,629,447,73539,73191,56163,44922,40344
39372,563,1776,27916,11456,3.63106e+13,641.874,5878.32,39372,483,348,37010,35635,29973,21379,20132
92718,249,3359,64187,28531,3.52746e+13,1184.61,12271.1,92718,685,519,81097,73307,46547,18960,15119
41369,202,1821,28417,12952,3.55469e+13,695.994,6166.91,41369,391,416,36303,32338,21617,11585,9772
93225,2048,3361,65320,27905,3.54862e+13,1027.02,12030.4,93225,671,560,89864,89097,84704,74028,73864
6197,477,930,4305,1892,3.60478e+13,189.241,1951.75,6197,173,150,5267,5218,4881,4940,2908
21936,538,1174,15595,6341,3.54799e+13,662.59,3805.72,21936,340,304,20254,19474,17861,16673,12630
81327,990,2731,56460,24867,3.5494e+13,912.048,10422.4,81327,641,479,78229,76714,64596,50194,43669
20866,905,1551,14894,5972,3.63675e+13,475.447,4352.41,20866,369,323,19315,18958,17902,15699,13551
29589,385,2001,20670,8919,3.63255e+13,417.082,5722.3,29589,307,490,27244,25596,20785,16179,9430
8773,33,817,6103,2670,3.43082e+13,214.138,2085.72,8773,202,148,5767,4468,3480,1554,669
94465,622,3683,64647,29818,3.43435e+13,973.496,12254.9,94465,718,522,89127,85624,53486,26759,26930
71532,473,2335,50063,21469,3.39478e+13,891.695,8452.02,71532,512,529,67496,64796,48773,40595,18872
93537,1085,3483,65749,27788,3.56966e+13,1029.8,12562.5,93537,719,571,89511,87411,71773,49582,34504
96607,2217,3964,66910,29697,3.4384e+13,1080.18,13328.7,96607,565,589,92643,92293,89417,82164,75007
27766,59,1679,19520,8246,3.60429e+13,711.904,5212.46,27766,424,298,20374,17048,11831,4640,2758
20935,1626,1838,14510,6425,3.56425e+13,563.418,4876.94,20935,394,355,19097,19087,18909,18827,18352
70645,1535,2286,50150,20495,3.636e+13,852.329,8565.84,70645,427,440,68359,68198,67926,67589,62752
11070,711,919,7878,3192,3.80289e+13,488.698,2508.45,11070,248,228,10132,9572,9749,9245,9079
5212,356,610,3442,1770,3.21361e+13,170.855,1414.31,5212,127,135,4602,4510,4213,3294,2804
4092,599,631,2723,1369,3.35399e+13,164.263,1363.25,4092,116,161,3461,3459,3460,3461,3434
88648,2094,3741,62090,26558,3.61894e+13,1022.44,12814.3,88648,826,554,84907,84551,76519,56653,54070
36692,1424,2272,25132,11560,3.47552e+13,805.334,6723.32,36692,442,381,34420,33827,32715,28646,25459
42081,1137,2409,28300,13781,3.38573e+13,770.712,7475,42081,465,470,39586,38761,33877,29328,26771
55596,48,2689,39002,16594,3.49401e+13,799.248,8668.56,55596,473,466,39373,31787,24686,9927,4577
21333,312,1204,14528,6805,3.5685e+13,369.716,3534.78,21333,298,227,19843,17340,13816,10704,10885
34623,1937,2031,23889,10734,3.30145e+13,830.398,6178.53,34623,431,404,32592,32459,32525,32527,32339
67435,844,2591,46492,20943,3.50123e+13,760.201,8727.32,67435,532,385,64566,63726,49647,40127,37937
86519,1967,2140,62317,24202,3.66721e+13,1019.3,9730.09,86519,709,462,84379,84378,84071,83768,83268
34318,1686,1969,23914,10404,3.507e+13,511.498,5834.79,34318,412,387,32349,32349,32280,32281,31347
42816,127,1773,29678,13138,3.31426e+13,903.039,6370.9,42816,356,423,36190,32448,21743,7654,5301
68461,159,3031,48102,20359,3.68416e+13,961.292,9829.03,68461,607,479,56427,49577,36194,14501,10476
70860,2573,2772,49426,21434,3.63088e+13,888.052,9830.75,70860,592,482,68088,68086,68004,67877,66105
80288,1432,2182,57306,22982,3.74287e+13,1034.12,9278.14,80288,599,430,78106,77676,74041,67753,66714
80071,2059,3030,56203,23868,3.60721e+13,907.19,10894.9,80071,688,444,77041,76848,74103,66431,64786
80050,2600,3387,56191,23859,3.66724e+13,1073.36,11392.1,80050,672,584,76663,76441,75699,74846,70952
16471,43,1281,11496,4975,3.56477e+13,409.302,3526.93,16471,309,269,11482,9171,7494,2117,1621
47968,680,2428,33632,14336,3.35085e+13,819.887,7748.35,47968,420,415,44880,43144,39929,26233,20862
89296,1980,2464,61324,27972,3.24344e+13,1218.24,10315.4,89296,550,495,86832,86786,86300,86329,81840
26175,865,1754,18152,8023,3.32125e+13,599.838,5092.5,26175,321,390,24421,23959,23025,21308,14477
38078,138,1714,27157,10921,3.78059e+13,655.026,5837.2,38078,408,381,30814,26694,20802,6496,6433
69082,1811,1901,48614,20468,3.75981e+13,783.297,7645.72,69082,521,426,67181,67181,67135,67110,66998
89437,1025,3342,62418,27019,3.60493e+13,771.608,11833.5,89437,619,496,86008,85185,71966,53576,45553
49368,359,2150,34791,14577,3.65544e+13,718.65,6970.08,49368,363,491,46173,44396,30851,20727,9404
95426,63,3317,67835,27591,3.55844e+13,1176.96,12712.2,95426,698,638,71706,59146,44709,12472,7463
87601,1777,2619,62570,25031,3.69866e+13,1012.97,10468.2,87601,582,497,84982,84458,82451,81193,70263
81901,2781,3018,55899,26002,3.57088e+13,650.604,10791.4,81901,575,456,78883,78883,78211,78066,76141
35899,264,1285,25674,10225,3.6904e+13,668.633,4893.12,35899,395,349,32123,28364,25526,22300,12843
74477,248,2620,52468,22009,3.52706e+13,1151.01,9815.13,74477,593,450,65774,59651,41998,18299,13047
21180,131,1988,14593,6587,3.41178e+13,469.897,5035.92,21180,393,367,17039,14871,10109,4312,2577
51455,1062,2362,36316,15139,3.61143e+13,639.475,7730.2,51455,448,430,49093,48354,45869,40649,32457
62276,438,2837,43464,18812,3.44665e+13,858.549,8984.52,62276,474,431,58050,55730,42000,26973,21632
46957,774,2139,32535,14422,3.49623e+13,859.65,7231.94,46957,511,415,44117,42661,36297,27528,25336
63107,391,2748,44114,18993,3.60054e+13,858.167,9213.79,63107,533,523,57811,54856,37204,23635,15759
15067,1095,1128,10637,4430,3.62294e+13,369.294,3060.88,15067,265,253,13939,13939,13934,13935,13895
86533,74434,86533,0,86533,15.9998,0,86533,86533,86533,1,0,0,0,0,0
97064,1740,4433,66247,30817,3.43517e+13,1046.72,14361.9,97064,690,720,92628,91351,81204,63462,54748
22027,1048,1975,15446,6581,3.57406e+13,429.164,4960.56,22027,377,284,20052,19894,19027,16856,15408
54883,58,2753,37973,16910,3.41694e+13,905.078,8641.58,54883,460,606,40577,32580,24008,7750,5389
10962,791,1262,7579,3383,3.66117e+13,308.656,2929.63,10962,206,229,9700,9550,9552,9435,7665
10441,254,1090,6899,3542,3.09664e+13,246.066,2582.89,10441,257,173,9184,8665,6020,4567,3584
94477,1076,3894,63968,30509,3.40432e+13,1075.71,12946.6,94477,706,691,90115,88530,66643,48407,39240
17136,840,1326,11888,5248,2.93865e+13,268.079,3475.76,17136,289,186,15810,15673,15424,15315,13454
10399,407,919,7509,2890,3.8578e+13,426.986,2438.9,10399,237,197,9159,8554,8364,6979,5786
4207,622,677,3050,1157,3.88098e+13,200.43,1344.4,4207,166,126,3530,3530,3528,3529,3464
66884,550,2119,46936,19948,3.63755e+13,938.853,8729.5,66884,558,551,62181,59621,49778,35611,19317
25952,1676,1856,18355,7597,3.75557e+13,590.814,5168.45,25952,418,427,24096,24075,24019,23956,22993
86770,1064,3389,61403,25367,3.66052e+13,1231.43,11365.7,86770,693,514,82575,80403,66361,48158,39561
79853,1996,3930,54097,25756,3.48923e+13,1006.59,12225.3,79853,578,610,75923,75367,71947,61972,58519
63690,264,1572,43959,19731,3.04867e+13,725.039,6402.97,63690,419,419,58838,56094,37527,25224,18183
77184,286,2942,54273,22911,3.6838e+13,979.873,10216,77184,686,444,67950,62295,43440,21006,18532
32257,1744,1945,22089,10168,3.58409e+13,588.553,5812.46,32257,368,360,30312,30308,30064,29643,29615
6581,234,1078,4497,2084,3.51434e+13,188.03,2214.34,6581,228,157,5434,4919,3696,3197,1910
57792,74,2522,39598,18194,3.53731e+13,936.293,8531.26,57792,509,438,44024,37791,24612,9537,5103
25247,1336,1869,17847,7400,3.69799e+13,413.655,4958.93,25247,356,346,23378,23338,22951,22980,20279
39478,1110,1708,26956,12522,3.44022e+13,671.871,6062.5,39478,414,422,37770,37444,36436,34910,32479
93657,1373,2709,65640,28017,3.5647e+13,1715.42,11508.8,93657,690,655,89928,88455,79301,52410,51429
80570,372,1569,55005,25565,3.07982e+13,999.18,7692.16,80570,463,453,74962,71721,55325,33388,21638
59329,270,2378,41983,17346,3.60081e+13,861.999,8083.74,59329,500,385,52011,46664,33376,18281,15603
75251,1697,2843,53802,21449,3.63079e+13,1091.76,10499.5,75251,592,540,72408,71889,68942,61269,56065
17333,805,1136,11692,5641,3.37431e+13,331.313,3034.9,17333,241,211,16197,16163,15750,15080,14898
16110,89,1461,11276,4834,3.7272e+13,454.949,3687.68,16110,272,258,12371,10842,8020,2388,2731
18660,894,1371,13433,5227,3.58773e+13,345.152,3908.14,18660,433,195,17289,17248,16401,14850,14220
40484,455,2264,27715,12769,3.3207e+13,609.441,6879.96,40484,422,531,37652,35828,26843,20383,13190
74394,59,2639,51315,23079,3.45173e+13,855.281,9686.94,74394,482,571,53984,44391,34159,13189,6936
7432,212,809,5388,2044,3.82369e+13,260.756,1944.77,7432,191,188,6303,5592,5353,5347,2299
91823,1498,3422,63397,28426,3.48888e+13,1014.02,11791.2,91823,632,516,88344,86835,74356,56328,53016
40171,678,2243,27904,12267,3.58648e+13,820.464,6952.34,40171,464,436,37217,36204,29456,23260,16582
12188,170,1006,8530,3658,3.6082e+13,318.196,2690.54,12188,222,231,10021,8528,6841,4893,3570
60832,1777,3161,41303,19529,3.42215e+13,769.144,9602.86,60832,649,439,57671,57535,55184,48841,47529
51509,527,2787,35740,15769,3.52342e+13,735.322,8985.76,51509,394,537,47366,44603,34556,22927,18526
57296,1573,2092,38862,18434,3.45798e+13,962.917,7601.39,57296,471,430,55204,55007,53770,51295,52102
14299,1276,1455,10045,4254,3.43556e+13,284.39,3571.31,14299,207,276,12844,12844,12818,12837,12335
33204,389,1414,24037,9167,3.74636e+13,828.384,5056.39,33204,375,337,30212,28604,25828,21184,12979
47003,384,2271,32769,14234,3.4372e+13,669.132,7619.04,47003,541,387,43057,39347,27636,21325,16083
24546,418,1773,16876,7670,3.38598e+13,491.909,4818.49,24546,286,324,22426,21187,18329,14920,9631
77315,567,2563,54146,23169,3.47715e+13,995.524,9764.49,77315,623,419,72794,70120,48516,36102,26046
23083,49,1559,15814,7269,3.16877e+13,367.167,4339.48,23083,326,335,16365,12624,10544,2265,1954
53171,968,2098,36331,16840,3.20719e+13,861.823,7374.8,53171,432,382,50923,50269,45946,30991,32387
57502,955,1662,41216,16286,3.7529e+13,825.188,6946.74,57502,457,360,55568,53611,53417,50765,43839
10433,583,760,7530,2903,3.75059e+13,278.333,2038.49,10433,213,159,9673,9649,9524,9438,8882
28578,208,1454,19793,8785,3.12449e+13,605.454,4456.95,28578,382,304,25616,24251,18144,13187,10461
1959,169,374,1495,464,4.18873e+13,81.075,663.056,1959,113,63,1585,1520,1498,1511,866
17554,30,1697,12304,5250,3.54846e+13,390.533,4254.8,17554,333,280,11269,8540,6921,2657,1339
96659,1341,3361,68187,28472,3.61745e+13,1101.47,12013.2,96659,621,576,93211,91877,81541,61173,54356
48120,1344,2504,33799,14321,3.54899e+13,834.552,7858.56,48120,541,467,45616,44646,43076,35729,30709
73442,112,2963,52176,21266,3.60775e+13,1102.93,10514.9,73442,587,455,59463,51096,37236,11200,8439
17757,1257,1449,12485,5272,3.72343e+13,435.16,3767.8,17757,289,287,16308,16271,16271,16209,15692
42076,1155,2398,28976,13100,3.36608e+13,873.194,7447.4,42076,475,509,39547,38480,37163,33069,24638
48841,1334,1685,33782,15059,3.5073e+13,665.789,6209.57,48841,403,363,47156,47123,46041,44344,40958
94939,860,2699,66446,28493,3.41851e+13,1092.3,10813.6,94939,592,553,90796,87754,73831,49102,42034
65635,195,2823,45924,19711,3.38331e+13,783.853,9797.68,65635,427,478,55823,49135,37618,10048,9838
78015,645,2656,54811,23204,3.66133e+13,1026.98,9997.15,78015,628,427,73854,70898,53152,37004,28184
14537,701,1175,9800,4737,3.32054e+13,383.98,3203.13,14537,283,286,13362,13065,12765,11509,10841
41116,1422,1567,29080,12036,3.71801e+13,678.845,5771.15,41116,436,332,39549,39541,39499,39510,38888
44935,1008,2438,31525,13410,3.73449e+13,690.555,7859.37,44935,423,426,42463,41754,37550,29222,24702
20388,1050,1391,14714,5674,3.68174e+13,508.682,3871.42,20388,321,269,18997,18798,18796,18207,17520
99511,2039,3396,70789,28722,3.6969e+13,1317.43,13094.9,99511,818,587,96115,95280,92454,83395,77266
29255,527,2436,20831,8424,3.685e+13,428.992,6496.58,29255,385,626,26701,25899,22982,21695,8124
17236,1142,1368,11974,5262,3.46018e+13,505.271,3677.22,17236,288,336,15868,15605,15599,15180,14883
98444,274,3389,67361,31083,3.41484e+13,1354.83,12644.4,98444,612,708,86578,77877,49647,19397,17247
18413,91,1288,12847,5566,3.17203e+13,559.575,3471.64,18413,288,255,15466,13308,9123,3051,3222
22271,692,1492,15710,6561,3.78063e+13,556.926,4181.75,22271,383,252,20746,20156,18800,15637,15542
49483,2249,2551,33374,16109,3.45035e+13,495.98,7791.07,49483,349,485,46932,46928,46886,46894,45033
53248,2253,2631,37338,15910,3.64866e+13,895.422,8177.81,53248,529,502,50617,50393,50274,49823,48286
12734,29,893,8986,3748,3.77859e+13,490.672,2644.35,12734,255,226,8260,6559,4928,1710,1164
54502,930,2646,38093,16409,3.61919e+13,779.958,8775.15,54502,521,569,51523,50533,47717,43324,28346
17653,311,1366,11899,5754,3.46068e+13,477.599,3811.28,17653,260,329,15645,14437,11623,8286,6807
6329,638,810,4233,2096,3.35607e+13,293.307,1858.75,6329,186,183,5519,5469,5339,5246,5116
90776,3171,3226,63755,27021,3.63575e+13,1261.65,11247.2,90776,707,577,87550,87550,87535,87549,87476
43453,1752,2416,29932,13521,3.57321e+13,708.406,7401.51,43453,472,503,41037,40983,40418,39578,36555
81039,538,3190,57752,23287,3.59885e+13,879.731,11295.9,81039,510,547,75615,71961,57259,36225,21326
44340,478,2196,30748,13592,3.59163e+13,749.94,7283.67,44340,403,512,41028,38820,30786,24482,10762
62788,686,2157,45595,17193,3.67625e+13,1019.9,8405.1,62788,561,417,58827,55683,53152,43359,30239
23868,961,1613,16676,7192,3.29973e+13,504.157,4549,23868,313,305,22255,21953,21446,20777,15053
99995,433,3481,69179,30816,3.61175e+13,1047,12581,99995,686,584,92201,85321,55631,26968,26449
2199,281,490,1496,703,3.68063e+13,116.064,889.637,2199,90,118,1709,1636,1647,1665,1251
56121,234,2304,38860,17261,3.20283e+13,656.792,7758.75,56121,421,426,50868,47610,36690,25436,15507
72828,563,2477,50122,22706,3.26139e+13,1114.37,9492.99,72828,483,475,68113,65870,51971,34264,19538
88285,280,3231,60846,27439,3.45151e+13,1052.07,11586.4,88285,646,505,78295,71694,46687,18038,15624
29096,178,1901,19830,9266,3.48858e+13,563.115,5583.64,29096,353,304,24370,21265,14351,7514,6599
9530,301,1282,6762,2768,3.77056e+13,321.739,2790.88,9530,273,283,8031,7430,6041,4394,3228
66463,602,2310,46087,20376,3.20898e+13,855.325,8118.51,66463,527,450,62714,59932,42889,33651,29301
89671,1144,3475,62445,27226,3.58741e+13,1005.7,12158,89671,746,526,85854,84094,67550,50159,45634
69071,3512,3635,48266,20805,3.62392e+13,815.514,11634.1,69071,525,693,65436,65436,65436,65428,64999
36426,691,2350,25774,10652,3.55597e+13,618.19,6780.64,36426,445,357,33892,33033,27501,18330,13656
70729,2032,3287,49441,21288,3.49151e+13,954.728,10606,70729,614,562,67442,66976,64273,54570,54334
82506,2283,2877,58405,24101,3.63868e+13,1058.41,10404.9,82506,582,501,79629,79504,78455,76488,74645
28480,1127,1738,20191,8289,3.72785e+13,562.236,5400.27,28480,403,352,26742,26693,25288,22552,20135
70825,2851,3370,48919,21906,3.60932e+13,874.907,10717.6,70825,688,577,67455,67447,66847,66118,63661
93405,2904,3643,63854,29551,3.36791e+13,868.935,12163.5,93405,530,613,89762,89753,89296,88808,80597
32110,1022,2443,22681,9429,3.59627e+13,599.017,6645.34,32110,494,375,29667,29055,27235,21037,20904
17283,1287,1503,11806,5477,3.56382e+13,389.326,3992.87,17283,268,359,15780,15780,15701,15656,14810
85367,1976,2621,59996,25371,3.52852e+13,1022.15,10464.9,85367,554,528,82746,82609,82393,81583,76261
75786,2340,2519,52049,23737,3.45573e+13,741.717,9516.32,75786,509,446,73267,73263,73241,73204,71952
83153,991,2845,57651,25502,3.27725e+13,1043.65,10472.5,83153,580,474,79660,78091,65484,49074,38330
35983,717,2113,25059,10924,3.63266e+13,525.056,6354.3,35983,408,409,33818,33051,30850,26419,20154
78222,487,2981,54605,23617,3.65924e+13,1183.16,10847.7,78222,596,510,72568,68899,48013,33502,22056
67580,343,2953,46500,21080,3.60851e+13,1132.65,9592.66,67580,617,585,61343,56749,35566,17125,17340
24270,146,1435,16503,7767,3.60681e+13,586.631,4540.94,24270,285,377,19824,17149,11537,5148,5404
73365,450,3095,50754,22611,3.37566e+13,1003.94,10219.3,73365,543,486,68385,66115,45227,25846,19559
72148,1593,3073,50763,21385,3.59714e+13,1116.76,10987.4,72148,570,574,69050,67986,65406,58152,45921
76041,354,2767,53272,22769,3.5694e+13,1030.69,10540.9,76041,529,571,69122,64480,47171,26608,17854
50603,34,2765,35091,15512,3.54634e+13,990.805,8751.25,50603,638,557,33783,26255,20025,7638,3818
79563,489,3577,54700,24863,3.53774e+13,980.177,11899.6,79563,669,716,73511,70247,51106,34820,20135
71706,241,2501,50119,21587,3.64479e+13,987.405,8946.44,71706,530,438,63601,56654,37859,12783,12164
79332,1105,2697,56276,23056,3.68259e+13,1035.52,10034.5,79332,668,523,76208,74246,66959,51467,47248
29219,991,2128,20429,8790,3.6326e+13,578.497,5957.27,29219,392,429,27091,26287,25636,23468,18557
94775,2334,3288,66365,28410,3.57304e+13,1119.43,11989.2,94775,606,594,91487,91259,89333,84993,79694
84270,296,2984,59787,24483,3.68586e+13,1054.41,11497.3,84270,739,501,75768,67762,46559,20888,16949
32374,1415,2048,22340,10034,3.50513e+13,580.107,5958.4,32374,405,298,30326,30275,29050,26171,25435
47873,2205,2708,33427,14446,3.58312e+13,847.742,8361.12,47873,455,554,45165,45042,44921,44896,41877
47707,1410,2741,33136,14571,3.42609e+13,647.849,8273.32,47707,409,549,44966,44818,43877,42874,33184
96782,122,3982,66818,29964,3.40193e+13,1321.91,13326.8,96782,723,700,80255,70657,48241,19221,10163
37066,1729,1876,25536,11530,3.41939e+13,740.384,6031.73,37066,438,387,35190,35188,35061,35074,34814
97145,2810,3585,68236,28909,3.55224e+13,1119.16,13022.2,97145,613,710,93560,93516,92780,91236,88708
24775,132,2143,17617,7158,3.62462e+13,600.967,5603.4,24775,459,426,20546,18571,13502,6832,3442
25240,1163,1818,17762,7478,3.68176e+13,699.19,5069.89,25240,373,376,23422,22922,21340,18128,18940
17207,859,1480,11986,5221,3.14356e+13,300.894,3712.16,17207,277,278,15727,15585,15168,13037,12617
12547,136,1139,8549,3998,3.44485e+13,366.424,3023.49,12547,254,291,10378,9158,6846,3724,2536
86293,3714,4106,60239,26054,3.71054e+13,874.916,12927.7,86293,550,584,82187,82186,82063,82071,80423
39332,804,1639,27235,12097,3.21668e+13,748.382,5541.25,39332,391,313,37306,36052,34111,23855,21952
45017,2149,2720,31559,13458,3.57223e+13,651.872,8037.79,45017,515,472,42297,42227,41656,40471,38454
74177,1041,2910,50458,23719,3.29743e+13,989.353,10284.1,74177,514,520,70869,69862,55996,39914,34125
32698,844,1926,23689,9009,3.64386e+13,543.546,5848.48,32698,557,278,30761,30047,27966,19529,19100
10329,676,876,7039,3290,3.1998e+13,211.408,2233.3,10329,169,190,9453,9449,9402,9406,8834
16012,1346,1416,11390,4622,3.74344e+13,540.653,3701.83,16012,278,311,14596,14586,14596,14596,14417
66769,881,2907,46816,19953,3.72457e+13,1015.96,9859.65,66769,554,458,63203,61583,47686,35385,32517
79037,1024,3034,54998,24039,3.59136e+13,849.91,10684.1,79037,589,533,75937,74477,63566,46651,39202
25377,461,1749,17790,7587,3.54769e+13,384.589,4898.11,25377,354,252,23519,22972,20302,16384,11945
86960,2732,3055,60793,26167,3.61435e+13,1028.29,10824.3,86960,547,501,83905,83854,83781,83459,80979
18751,1396,1791,13083,5668,3.64744e+13,371.546,4457.6,18751,344,309,16960,16872,16829,16840,14652
68927,2332,2475,47377,21550,3.46138e+13,624.941,8834.11,68927,457,440,66452,66445,66417,66403,65607
31188,2018,2170,21137,10051,3.52446e+13,517.465,6037.77,31188,375,472,29018,29015,28801,28388,28599
86134,1454,2751,60029,26105,3.54321e+13,1046.13,10064.9,86134,592,448,83383,82437,75200,55580,64169
92448,2444,3720,64496,27952,3.57116e+13,1008.18,12430,92448,730,495,88728,88555,83621,72330,71982
20569,200,1597,14684,5885,3.65271e+13,511.288,4274.07,20569,321,332,17415,15164,12986,9308,6364
38781,1048,1378,27015,11766,3.24844e+13,796.782,5130.4,38781,387,320,37366,36588,36298,35397,30072
75141,2079,2551,53668,21473,3.58636e+13,755.805,9494.22,75141,666,383,72590,72580,70781,68663,67881
43813,2081,3021,30897,12916,3.6186e+13,716.219,8745.11,43813,494,464,40792,40555,40165,39809,32286
79295,86,2847,54521,24774,3.14414e+13,789.956,10357.6,79295,525,567,65327,53542,38751,9624,8943
20107,163,1532,13811,6296,3.49881e+13,553.695,4202.3,20107,324,268,16701,14871,9331,3603,4236
43968,1843,2219,31190,12778,3.55697e+13,874.059,7079.35,43968,565,417,41749,41484,41116,40309,37730
50510,1426,2247,36690,13820,3.69733e+13,867.57,7646.46,50510,507,391,48263,47972,46481,43269,38662
46675,649,2586,32168,14507,3.60815e+13,904.997,8070.59,46675,521,571,43114,41715,28752,21056,18148
49449,581,2406,34368,15081,3.65529e+13,870.873,7771.85,49449,458,469,46213,44931,33010,24159,20962
2033,296,351,1459,574,3.53094e+13,151.271,698.464,2033,124,83,1682,1551,1633,1644,1615
38075,1571,2332,27102,10973,3.58807e+13,911.312,7057.66,38075,525,404,35743,35195,34216,31751,29126
38064,740,2098,26649,11415,3.57216e+13,666.203,6293.41,38064,479,372,35667,34339,30586,20377,21407
46951,560,2657,32648,14303,3.47042e+13,607.745,8266.95,46951,594,343,43517,41674,26571,19931,11515
1672,478,509,1128,544,3.18297e+13,62.4426,796.66,1672,123,77,1163,1163,1163,1163,1144
91457,22315,91457,0,91457,15.9998,0,91457,91457,91457,1,0,0,0,0,0
93829,2329,3426,66344,27485,3.66968e+13,1117.18,12125.7,93829,623,570,90403,90227,88639,86605,78510
94975,2484,3219,66179,28796,3.62677e+13,1003.35,12067.1,94975,767,596,91756,91560,89945,84177,83898
32076,100,2119,22837,9239,3.71065e+13,668.412,6295.53,32076,343,420,25087,21958,16457,4240,4028
21637,182,1113,14842,6795,3.55105e+13,393.388,3676.53,21637,248,236,18151,15679,11671,7633,4901
65723,1388,2876,45480,20243,3.60907e+13,976.724,9591.4,65723,538,625,62847,62195,57728,48234,42066
62129,2128,2766,44096,18033,3.69059e+13,1012.43,9407.84,62129,582,517,59363,59078,57934,55295,52606
32571,1400,2210,22440,10131,3.58937e+13,524.981,6166.6,32571,459,345,30361,30272,29093,25535,25780
3232,331,581,2212,1020,3.45451e+13,195.271,1186.06,3232,141,172,2651,2477,2500,2377,1872
80751,2345,3003,55952,24799,3.42069e+13,989.661,10527.1,80751,549,425,77748,77648,76797,76037,67687
72382,2630,3279,49367,23015,3.48691e+13,1305.36,11122.4,72382,582,659,69103,69009,68015,65970,63500
51690,2016,2574,35674,16016,3.40827e+13,622.239,7884.26,51690,493,493,49116,49043,48740,48610,45057
66203,31,2736,46392,19811,3.58116e+13,1166.56,9408.18,66203,542,473,42681,33136,26668,10792,5310
67366,2711,3173,45603,21763,3.29781e+13,867.41,10053.8,67366,554,441,64193,64094,63468,62739,60063
78196,100,3047,54719,23477,3.6519e+13,989.001,10648.8,78196,607,417,61466,53782,39236,12430,8185
3395,360,423,2323,1072,2.49589e+13,107.396,953.735,3395,117,75,2972,2968,2920,2931,2616
26060,1131,1717,18216,7844,3.54373e+13,458.971,4896.45,26060,372,231,24343,24290,23805,22288,22194
9696,133,1103,6854,2842,3.7236e+13,293.592,2580.97,9696,221,240,7675,6686,5467,4060,2176
6777,437,801,4677,2100,3.58713e+13,267.064,1915.4,6777,199,233,5976,5882,5696,5549,3650
60203,464,1925,41583,18620,3.32583e+13,1046.5,7285.08,60203,421,506,55869,53565,40429,30150,22816
71888,1257,2734,50069,21819,3.56128e+13,889.201,9294.9,71888,615,473,69154,68161,59886,43051,42477
26214,734,1815,18198,8016,3.5838e+13,350.787,4989.45,26214,326,402,24399,24257,23135,20852,17341
42251,163,2223,29551,12700,3.57507e+13,641.987,6984.69,42251,402,406,34954,30282,22882,9181,7146
83346,1067,3223,58488,24858,3.66585e+13,971.081,11093.9,83346,642,637,79796,78476,62628,44626,41172
77231,869,3058,54265,22966,3.58664e+13,1174.68,10797.9,77231,668,455,73128,71335,57275,40647,33392
30509,1742,1853,21752,8757,3.78716e+13,685.296,5623.8,30509,452,332,28656,28616,28610,28610,28328
87191,419,3045,60408,26783,3.39799e+13,1206.95,11286.9,87191,577,606,80124,76056,53862,32811,22224
1464,246,437,1013,451,3.17264e+13,81.2725,687.901,1464,91,74,1027,984,956,979,624
81234,2345,2391,57036,24198,3.67937e+13,966.466,9512.38,81234,521,522,78843,78843,78838,78839,78803
8387,76,968,6055,2332,3.44871e+13,253.088,2236.17,8387,283,149,6105,5145,4341,2358,1168
17654,1434,1515,12559,5095,3.75012e+13,326.605,3765.59,17654,256,264,16139,16139,16138,16139,15978
99718,2059,3513,68326,31392,3.34919e+13,1188.02,12792.9,99718,701,672,96205,95475,90026,76030,69408
18952,324,1905,12989,5963,3.50554e+13,345.527,4631.17,18952,353,281,16661,15150,11056,6485,5528
10562,770,1078,7306,3256,3.64792e+13,279.674,2730.41,10562,189,228,9484,9475,9425,9434,8410
96748,431,4447,66804,29944,3.5597e+13,1113.96,14978.8,96748,803,532,88319,83002,54986,27536,15381
57560,469,3116,40221,17339,3.62446e+13,855.271,9730.15,57560,567,656,52307,49133,38030,26318,14617
88101,2517,3159,59761,28340,3.37742e+13,938.078,10932.9,88101,544,556,84942,84799,84431,84174,79753
23092,164,1682,16657,6435,3.69956e+13,605.941,4784.59,23092,348,311,19360,17082,13591,7793,3964
11595,80,1117,7652,3943,3.25346e+13,308.201,2784.88,11595,286,239,8842,7412,4708,2591,1351
23173,29,1511,16846,6327,3.76421e+13,634.693,4449.84,23173,449,265,15419,12477,9493,3701,1998
7271,493,1020,5281,1990,3.89284e+13,187.98,2149.94,7271,191,190,6251,6131,6063,5934,4220
97782,823,3430,69611,28171,3.67391e+13,1356.74,13279.5,97782,770,558,91701,87514,60836,45252,35818
66835,149,2020,46056,20779,3.08837e+13,845.918,7702.02,66835,499,476,58181,53426,34230,9539,10431
11104,688,1171,7597,3507,3.55817e+13,282.722,2849.89,11104,205,223,9933,9886,9634,9484,7861
30366,405,2196,21096,9270,3.58721e+13,480.493,6225.95,30366,327,551,27562,26161,23367,21156,8232
67197,706,2534,46043,21154,3.19201e+13,905.827,8966.15,67197,454,490,63757,62114,49217,31669,24343
85217,531,3628,57286,27931,3.41041e+13,1139.76,11937,85217,567,693,78601,75049,41820,22052,28593
23907,46,1730,16554,7353,3.71858e+13,686.809,5030,23907,369,505,17015,13640,10219,4609,2031
20023,1267,1539,13860,6163,3.55701e+13,393.523,4165.88,20023,317,259,18484,18464,18393,18245,16150
17003,1121,1697,12258,4745,3.85119e+13,426.177,4192.75,17003,271,404,15306,15231,15001,15023,12088
5360,277,601,3637,1723,3.44023e+13,302.711,1488.75,5360,146,153,4572,4275,4173,3644,2700
60381,838,2894,40992,19389,3.41617e+13,983.996,9838.4,60381,600,577,56831,55123,40804,33215,23398
19593,1420,1598,13119,6474,3.43982e+13,567.558,4363.03,19593,335,354,17995,17977,17945,17919,17501
5945,777,830,4123,1822,3.54697e+13,222.943,1852.05,5945,183,198,5115,5115,5110,5100,5085
50825,979,2346,34262,16563,3.49012e+13,810.989,7899.79,50825,512,490,48362,47473,38675,30576,31849
65925,1391,2316,46030,19895,3.49038e+13,923.874,8798.54,65925,518,440,63609,62918,60887,55304,50741
15621,568,1353,11350,4271,3.65601e+13,437.149,3597.16,15621,242,271,14224,13887,13120,12594,7365
63340,2109,2309,44268,19072,3.51348e+13,851.665,8477.45,63340,508,397,61031,61025,60980,60899,59702
66808,267,3061,45956,20852,3.58117e+13,1146.16,10015.2,66808,526,511,59587,52680,35564,16362,11669
99514,1368,3314,69623,29891,3.64671e+13,1052.97,12494.8,99514,655,573,96042,94968,84347,63910,50739
25597,500,1846,17469,8128,3.25405e+13,458.407,5206.42,25597,320,343,23519,22532,18510,14446,9732
10718,982,1141,7315,3403,3.48998e+13,293.688,2780.14,10718,243,207,9577,9574,9543,9565,9259
52471,1459,2227,37160,15311,3.48978e+13,815.86,7753.27,52471,526,436,50244,49647,48586,44407,40427
11455,330,904,7982,3473,3.48025e+13,375.214,2574.45,11455,267,226,10212,9097,8546,7823,5484
41593,1336,2081,28965,12628,3.62615e+13,742.137,6902.72,41593,384,456,39512,39107,37451,34248,32825
90895,459,2916,63236,27659,3.4191e+13,1242.56,10998.1,90895,592,572,84987,81686,58410,40993,24277
60856,1207,2641,42557,18299,3.5176e+13,779.959,9114.7,60856,470,573,58194,57435,55774,51930,39814
25064,185,2081,17644,7420,3.5457e+13,445.472,5487.55,25064,433,268,20843,17964,13143,5824,4877
63549,1424,2790,44342,19207,3.60562e+13,922.462,9541.93,63549,553,470,60759,60174,55335,42732,37038
99331,1758,3540,69597,29734,3.61299e+13,1060.64,13127.7,99331,611,554,95791,95348,88304,69492,64284
66034,396,2208,46324,19710,3.53779e+13,962.682,8443.68,66034,492,469,60556,57261,41007,26591,19148
86680,753,2801,60941,25739,3.54672e+13,1122.76,10562.8,86680,592,507,82123,79692,59299,42667,36200
92675,1224,3357,66341,26334,3.67352e+13,1007.44,12196.1,92675,662,574,89222,86702,83358,70926,61076
15393,834,1490,10764,4629,3.60738e+13,345.467,3690.58,15393,299,271,13903,13821,13148,11774,10865
1417,98,446,982,435,3.05928e+13,50.8567,699.072,1417,144,68,971,907,596,480,357
30373,812,1966,21005,9368,3.3315e+13,476.195,5727.93,30373,325,323,28407,28008,25316,21133,14526
5466,441,672,3775,1691,3.68072e+13,257.349,1611.78,5466,160,152,4794,4661,4471,3937,3678
33343,247,1367,24118,9225,3.55871e+13,610.634,4937.45,33343,430,277,29515,25441,21252,14197,10854
94908,847,4175,66168,28740,3.56106e+13,1220.48,14120.9,94908,712,708,89348,85685,64965,42964,29562
42920,897,2398,30872,12048,3.51327e+13,663.02,7393.5,42920,537,516,40279,39364,37630,29896,19791
11652,1047,1352,7938,3714,3.59984e+13,315.9,3218.93,11652,312,304,10300,10288,10086,9227,9401
25311,438,1930,17362,7949,3.39386e+13,367.83,4950.41,25311,363,260,23354,22715,16878,13738,8367
13852,706,1449,9586,4266,3.54526e+13,341.032,3469.78,13852,313,265,12403,12281,11601,9501,8841
49979,1955,2234,33294,16685,3.32305e+13,696.207,7726.1,49979,403,462,47745,47707,47640,47659,45426
73055,2465,2677,51344,21711,3.64767e+13,1033.54,9479.51,73055,591,482,70378,70378,70330,70350,69575
90243,312,3090,61789,28454,3.51037e+13,995.553,11341.7,90243,521,585,81609,74863,44208,18398,18654
18269,1319,1547,12904,5365,3.66243e+13,502.811,4159.38,18269,325,342,16722,16711,16642,16654,15979
59381,713,2315,41349,18032,3.34035e+13,944.566,8040.26,59381,460,430,55817,53981,47939,35084,24903
96971,695,3433,68449,28522,3.69154e+13,1118.58,12754.2,96971,840,708,90927,86093,63408,47458,26795
62194,901,1952,44407,17787,3.64933e+13,913.052,7736.9,62194,553,373,59714,57881,51085,30722,29089
43784,1481,2195,30858,12926,3.67381e+13,809.172,7283.28,43784,464,422,41589,41510,39856,37276,34720
56849,2769,2987,38263,18586,3.29704e+13,713.368,9092.07,56849,609,485,53862,53862,53775,53717,53058
54297,42,2602,39119,15178,3.74484e+13,754.552,8813.74,54297,465,500,38056,30606,23803,7247,4243
6479,39,539,4515,1964,3.68881e+13,256.32,1460.36,6479,149,158,4226,3386,2946,1159,860
20383,924,1472,14654,5729,3.73175e+13,663.82,4136.49,20383,362,294,18887,18212,17756,17127,15863
16412,1230,1414,11331,5081,3.6246e+13,486.344,3882.88,16412,278,338,14998,14998,14944,14991,14370
15927,1113,1514,10907,5020,3.5405e+13,393.492,3858.41,15927,311,375,14413,14390,13882,12708,12819
77667,1759,2517,55433,22234,3.6707e+13,1136.64,9782.38,77667,658,520,75150,74128,72245,66175,65969
77854,2625,2905,56261,21593,3.68622e+13,990.805,10722.2,77854,647,603,74949,74880,74816,74846,73551
28673,1284,1984,20254,8419,3.58173e+13,571.051,5688.31,28673,415,338,26689,26382,25504,22291,21501
21665,509,1432,15370,6295,3.58119e+13,462.513,4142.01,21665,330,292,19998,19275,17173,12584,10526
30095,895,1950,21563,8532,3.77531e+13,606.803,5563.44,30095,465,298,28145,27712,25931,21847,21182
5125,589,720,3481,1644,3.58749e+13,203.021,1629.31,5125,145,158,4405,4399,4371,4388,4114
98018,1685,2406,66039,31979,3.41227e+13,880.41,10159.7,98018,634,533,95612,95525,90899,75368,73162
43063,856,2218,30664,12399,3.61209e+13,782.893,7203.89,43063,418,390,40533,39177,36131,28809,17056
9322,131,743,6329,2993,2.77643e+13,128.551,1887.74,9322,127,142,8533,8184,6523,5649,2919
83559,519,3020,59120,24439,3.58305e+13,970.679,11084.5,83559,574,507,77935,73974,53461,33099,17831
73615,112,2965,50795,22820,3.35526e+13,957.243,10129.7,73615,601,560,59773,52015,36304,10822,6648
66845,606,1842,47761,19084,3.6769e+13,1017.68,7813.68,66845,544,445,62710,60535,50286,37037,32008
66740,1297,2621,46181,20559,3.41308e+13,992.008,9085.73,66740,571,436,64056,62721,57135,44493,44174
73284,1992,3067,52083,21201,3.56163e+13,1068.75,10756.8,73284,661,580,70217,69919,68912,66821,49977
2015,19,515,1385,630,3.49258e+13,99.8392,857.305,2015,144,88,1139,796,696,324,243
29662,1582,2044,20601,9061,3.54372e+13,556.738,5933.56,29662,330,364,27618,27577,27406,27453,24482
49860,1554,3145,34342,15518,3.5542e+13,612.82,9238.16,49860,683,441,46715,46602,41368,37190,35310
26811,563,1750,19393,7418,3.67116e+13,544.167,5018.85,26811,413,296,24687,23627,20463,13990,12381
4486,443,682,3130,1356,3.43332e+13,192.414,1444.35,4486,148,144,3804,3775,3444,3292,2831
55574,2913,3069,38682,16892,3.61322e+13,938.456,9358.86,55574,497,582,52505,52502,52449,52479,51951
22969,279,1631,16395,6574,3.64006e+13,666.121,4587.49,22969,389,280,19991,18206,13785,9432,6826
70816,616,2443,50220,20596,3.56908e+13,909.788,9070.17,70816,646,442,67092,64717,52690,37703,30494
93466,2475,3557,63198,30268,3.4954e+13,596.786,11551.4,93466,558,466,89909,89855,83678,69106,69169
3300,198,682,2273,1027,3.84794e+13,136.154,1243.16,3300,163,134,2608,2314,2156,1735,1296
23231,1440,1797,16245,6986,3.67958e+13,697.802,4993.61,23231,414,451,21434,21344,21075,21033,19847
52502,1615,2253,36536,15966,3.46962e+13,678.985,7728.58,52502,454,391,50249,50050,48982,46068,44174
85252,1806,3581,59595,25657,3.5333e+13,1086.4,12544.3,85252,534,640,81671,80991,77385,71866,57429
42588,859,2203,29463,13125,3.40758e+13,716.795,6848.58,42588,439,454,40220,39324,32139,22219,23174
98582,3171,3681,68182,30400,3.61819e+13,1037.65,12169.6,98582,684,487,94901,94848,94600,94543,91137
27571,361,1431,19007,8564,3.56703e+13,432.376,4322.08,27571,314,317,25562,23977,16508,13233,12708
4696,641,778,3360,1336,3.8908e+13,175.785,1550.98,4696,168,149,3918,3913,3898,3900,3483
2639,171,525,1803,836,3.31237e+13,115.721,987.699,2639,113,109,2108,1945,1827,1824,786
43652,1181,2544,30636,13016,3.60864e+13,771.199,7527.01,43652,474,543,41029,40440,38226,33710,25071
2431,349,427,1690,741,3.49754e+13,93.0897,817.893,2431,90,82,2004,2004,2002,2004,1940
29426,1466,1888,20512,8914,3.62364e+13,696.105,5454.78,29426,389,331,27538,27280,27090,27035,25553
60279,1038,3100,41507,18772,3.51247e+13,842.682,9899.4,60279,575,478,56876,55769,46502,31339,25735
65675,1802,2906,45265,20410,3.33957e+13,829.801,9767.74,65675,660,494,62769,62592,59198,50604,51663
45510,2008,2256,32322,13188,3.75339e+13,750.447,7169.16,45510,536,368,43254,43202,43125,43197,42000
68950,1054,2151,47721,21229,3.53845e+13,833.95,7876.86,68950,491,393,66799,66448,60387,45967,55286
54790,230,2545,38431,16359,3.62571e+13,920.922,8582.87,54790,559,447,47449,42175,29400,12441,10558
39195,1623,2005,26918,12277,3.15964e+13,601.553,6198.55,39195,465,326,37190,37177,36892,36297,35824
49115,1912,2232,35679,13436,3.7603e+13,831.419,7637.73,49115,448,411,46883,46874,46798,46599,44864
13169,627,1273,9290,3879,3.68678e+13,445.76,3241.66,13169,289,270,11794,11248,10817,9677,8161
71847,2425,3616,49712,22135,3.57612e+13,828.927,11073.2,71847,674,530,68231,68142,65476,57837,59637
45470,281,1467,31887,13583,3.13994e+13,898.489,5656.64,45470,375,337,41285,39543,31936,22159,10034
59870,1280,2317,41110,18760,3.57341e+13,795.584,8043.89,59870,437,475,57553,57145,53126,44730,41365
93428,2465,2548,65623,27805,3.54897e+13,1213.09,10466.5,93428,603,538,90880,90880,90836,90755,90018
5616,47,747,3848,1768,3.51881e+13,317.589,1701.46,5616,191,175,3799,3065,2360,758,650
75197,1172,2569,53530,21667,3.72379e+13,1012.44,9798.54,75197,704,438,72420,70609,65917,52207,51630
33799,624,2360,23201,10598,3.42256e+13,635.17,6657.26,33799,416,356,31011,29794,24672,17871,13901
85847,2430,2768,59945,25902,3.53562e+13,1348.68,10707.6,85847,718,516,83079,82713,82715,82183,79453
36510,425,1979,24596,11914,3.46828e+13,722.944,6188.65,36510,459,490,33127,31330,22513,16242,15258
3257,189,502,2198,1059,3.46619e+13,237.022,1088.01,3257,140,151,2561,2219,2115,1873,1210
39697,989,2209,26819,12878,3.51214e+13,662.784,6899.51,39697,375,445,37415,36805,32897,24382,20035
22612,1477,1750,16190,6422,3.70411e+13,457.349,4910.48,22612,369,406,20862,20806,20733,20521,19073
2041,460,479,1485,556,3.64122e+13,79.0461,820.968,2041,101,86,1562,1562,1562,1562,1545
78771,2732,3399,54562,24209,3.64464e+13,782.21,10927.4,78771,749,529,75372,75337,73550,68389,67805
38808,372,1800,26824,11984,3.56617e+13,754.679,6237.65,38808,404,362,35203,32869,24301,17974,13221
98896,2666,2707,70042,28854,3.7063e+13,1290.3,10876.1,98896,663,574,96189,96189,96177,96189,96147
95454,1882,2464,67856,27598,3.67666e+13,1114.01,10329.7,95454,620,468,92990,92696,91603,89886,85704
27054,132,1462,19008,8046,3.46156e+13,575.728,4628.2,27054,294,287,22165,19502,15352,6108,3647
18171,471,1647,12631,5540,3.63441e+13,412.615,4205.38,18171,298,274,16275,15634,13033,9446,8081
38563,609,1597,27640,10923,3.75621e+13,898.638,5816.74,38563,475,334,35534,33656,31476,22513,21041
94112,639,3185,66560,27552,3.62659e+13,1050.67,11984.6,94112,772,464,88800,85339,65439,46130,35281
12570,43,1145,8786,3784,3.49499e+13,429.26,2993.31,12570,244,276,8684,6771,5286,1929,1229
47949,119,1837,33879,14070,3.61637e+13,717.84,6583.65,47949,441,348,38971,33554,25130,8133,7987
75206,406,3548,52687,22519,3.68174e+13,902.731,10920.3,75206,632,630,67866,63079,43846,22495,21239
68127,998,3000,45817,22310,3.43016e+13,933.559,10211.2,68127,582,693,64822,63049,53734,44824,40211
65686,1161,2880,46062,19624,3.66148e+13,886.473,9394.73,65686,630,492,62697,61924,55410,41962,38949
53181,1464,2691,37460,15721,3.66056e+13,809.489,8537.94,53181,521,418,50490,49941,48472,43750,37596
20518,962,1335,14107,6411,3.64622e+13,540.274,4086.67,20518,264,382,19183,19098,18836,18485,16870
84826,915,2707,57899,26927,3.56951e+13,845.211,10020,84826,656,523,81876,80216,71614,52525,51935
63791,685,2777,43404,20387,3.39585e+13,812.758,8961.18,63791,507,450,60308,58452,41791,30757,23489
49809,45,2383,34716,15093,3.54171e+13,750.941,7645.77,49809,453,345,34682,27312,21399,8019,3793
99356,882,3881,70580,28776,3.71018e+13,1295.69,13649,99356,862,732,93833,90982,70857,57373,29854
42127,2024,2237,29903,12224,3.61498e+13,984.487,7238.34,42127,477,421,39890,39762,39649,39567,38903
61529,881,2181,43209,18320,3.7203e+13,943.614,8423.49,61529,563,498,58547,56656,51145,37195,34951
8624,61,800,6239,2385,3.64148e+13,269.628,1992.25,8624,210,172,6281,5232,4336,2438,1341
45405,648,2169,31419,13986,3.57175e+13,785.978,7089.15,45405,423,421,42374,40384,33110,23251,22086
67649,106,2399,46309,21340,3.33419e+13,1033.63,9173.94,67649,579,601,54274,46973,31905,9403,7933
37333,59,1962,26611,10722,3.62353e+13,592.347,6246.39,37333,397,365,27137,23020,17672,6223,3764
86760,1251,2838,61465,25295,3.55874e+13,1021.22,11012.8,86760,681,447,83778,82240,70966,48110,45891
94549,1483,2964,66185,28364,3.47615e+13,994.639,11357.1,94549,586,422,91585,90885,84988,70643,66558
18030,94,1645,12283,5747,3.36065e+13,373.17,4180.24,18030,327,261,14374,12553,8754,3728,1474
35276,680,2118,24229,11047,3.46314e+13,556.642,6491.76,35276,358,488,32904,31828,29251,24623,12188
50688,587,2856,35023,15665,3.48215e+13,758.061,8558.77,50688,497,441,46979,45018,34503,25043,20060
94661,204,2930,67009,27652,3.49136e+13,1030.01,11603,94661,714,572,82671,74442,50621,19379,12749
12371,880,1161,8560,3811,3.4126e+13,426.796,3020.48,12371,301,280,11210,11078,10819,10379,9996
6207,98,640,4253,1954,3.56947e+13,254.859,1581.62,6207,186,169,4699,3994,2911,1842,1589
57818,1105,2199,39402,18416,3.50304e+13,565.87,7887.97,57818,429,363,55619,55447,50746,41744,38859
41600,1156,1989,28471,13129,3.2937e+13,764.378,6419.37,41600,445,419,39611,39033,37899,34258,32834
58867,1346,1877,42329,16538,3.84098e+13,884.344,7566.7,58867,547,414,56990,56947,53964,51630,50545
60317,1486,2547,43016,17301,3.64431e+13,987.344,8930.41,60317,557,444,57770,57099,53546,46907,43597
58888,1363,2035,42072,16816,3.73435e+13,742.234,7402.8,58888,504,397,56853,56585,54562,52735,49098
88412,3379,3966,60863,27549,3.42647e+13,1094.49,13348.6,88412,676,582,84446,84442,83292,80725,78220
9869,885,1006,7007,2862,3.62685e+13,309.014,2473.93,9869,215,210,8863,8859,8855,8860,8665
79602,828,2878,55123,24479,3.57959e+13,985.932,10464.3,79602,499,484,75797,73635,55411,40471,33660
99203,1122,3223,69979,29224,3.6181e+13,1209.57,12164.5,99203,783,480,95261,93463,76270,57623,54854
32041,127,1689,21846,10195,3.3984e+13,455.655,5302.77,32041,397,310,26949,23814,14647,6278,4756
73714,1523,3439,51026,22688,3.61134e+13,1062.95,11530,73714,573,582,70275,68880,63590,49986,42467
38279,2001,38279,0,38279,15.9996,0,38279,38279,38279,1,0,0,0,0,0
6417,705,811,4283,2134,3.50959e+13,341.934,1884.84,6417,186,233,5606,5427,5525,5385,5467
65845,2322,2832,45605,20240,3.40747e+13,929.057,9288.23,65845,594,372,63013,63012,62693,62159,60187
38103,409,1881,26328,11775,3.67058e+13,443.065,5444.44,38103,398,406,35926,34847,23449,18660,15247
40700,995,1705,28554,12146,3.27018e+13,956.585,5976.76,40700,407,487,38659,37349,36464,32477,26266
90723,2143,2945,64147,26576,3.66683e+13,1027.58,10667.9,90723,661,497,87778,87512,86258,82463,80852
66544,1992,3164,45770,20774,3.5654e+13,919.309,10493.7,66544,704,635,63380,63234,59999,50858,50353
17078,81,1313,12485,4593,3.61764e+13,535.218,3619.26,17078,306,249,13240,11569,9241,4255,2423
4864,440,757,3487,1377,3.83117e+13,296.993,1551.23,4864,199,163,4107,3817,3762,3463,3187
34040,721,1973,23958,10082,3.67667e+13,618.073,5828.94,34040,389,404,31758,30756,26379,20982,16200
77679,1007,2942,55425,22254,3.70036e+13,1183.49,10679.5,77679,818,603,73950,71839,63939,53360,40864
48735,534,2234,33427,15308,3.4764e+13,649.563,7129.07,48735,430,397,45885,44673,31312,26256,21177
94994,717,3124,67193,27801,3.48582e+13,1216.33,12203.5,94994,754,596,89920,87496,68803,50528,33458
71037,2490,2839,49225,21812,3.51054e+13,1036.68,9757.94,71037,638,454,68198,68185,67801,67012,65717
58958,1226,2620,41355,17603,3.4579e+13,727.994,8912.46,58958,640,362,56338,55809,52747,43220,38386
56223,124,2210,39955,16268,3.68165e+13,843.68,7752.95,56223,477,425,45077,38473,30185,10501,9145
42625,515,2571,29721,12904,3.49052e+13,575.382,7407.63,42625,455,371,39433,37999,26300,19634,14333
64016,90,2374,46029,17987,3.68687e+13,1036.85,8787.77,64016,512,492,49115,42166,32774,10147,7076
96881,1456,3900,66377,30504,3.485e+13,821.522,13266.9,96881,705,502,92981,92205,66527,55417,40023
62034,2279,2887,43084,18950,3.32333e+13,882.04,9416.96,62034,569,649,59147,59093,58783,58914,54821
55430,2667,3002,38001,17429,3.35755e+13,701.919,9168.07,55430,579,424,52428,52428,52310,52339,50777
19963,1218,1578,14483,5480,3.6903e+13,472.026,4285.46,19963,339,227,18385,18296,18146,17845,17090
50865,454,2490,34782,16083,3.50773e+13,782.867,7873.33,50865,418,547,47008,44680,30469,19625,14080
54031,1933,2337,37101,16930,3.26862e+13,646.55,7620.94,54031,412,398,51694,51691,51588,51617,50052
19655,1333,1690,13562,6093,3.13207e+13,325.468,4141.46,19655,281,298,17965,17964,17883,17678,15848
92048,715,2951,65191,26857,3.7347e+13,927.311,11681.1,92048,571,532,87418,82512,72289,49924,33685
51334,432,1959,35495,15839,3.31622e+13,598.653,6475.02,51334,368,400,48543,47049,35774,25208,21315
44985,928,1975,31157,13828,3.36834e+13,830.857,6718,44985,415,408,42571,41488,38935,27961,27581
86368,88,3227,60384,25984,3.38363e+13,1117.05,11442.3,86368,536,752,68872,57474,42107,9758,6315
41666,435,2532,28962,12704,3.50415e+13,789.096,7535.78,41666,429,485,37828,35806,24510,17803,12419
73014,2164,2504,51136,21878,3.64022e+13,1065.98,9065.88,73014,569,499,70510,70474,69891,68908,68461
69957,847,2695,49165,20792,3.65204e+13,934.266,9711.98,69957,629,529,66456,63507,47250,35555,30748
99930,3455,3515,68822,31108,3.50279e+13,955.768,12504.7,99930,740,481,96415,96415,96395,96407,96039
36169,800,2245,25572,10597,3.64178e+13,716.749,6802.48,36169,432,444,33770,31912,29536,21859,17598
51997,1483,2320,36692,15305,3.43054e+13,830.199,8061.02,51997,474,471,49677,49347,48185,46437,36727
87638,2728,2838,61216,26422,3.66407e+13,1119.12,10660.1,87638,636,614,84800,84794,84745,84754,84469
97585,673,4167,67741,29844,3.44821e+13,1071.65,13914.5,97585,789,629,91160,88089,60298,38738,29079
93004,2868,3306,64229,28775,3.39591e+13,1099.45,11810.3,93004,659,482,89698,89693,89364,89086,86800
1809,175,394,1313,496,4.03009e+13,90.7446,684.078,1809,110,78,1415,1311,1349,1341,895
3648,119,687,2403,1245,3.20655e+13,152.595,1350.23,3648,153,156,2798,2341,1529,1077,959
25207,768,1716,18098,7109,3.68866e+13,553.003,4980.89,25207,347,301,23368,22459,21085,17515,14045
43682,1032,2229,30040,13642,3.50826e+13,467.228,6837.04,43682,312,424,41453,41323,39889,39188,28765
52165,428,2304,35987,16178,3.32738e+13,795.917,7733.48,52165,502,377,47970,45944,32018,24323,17468
52688,1127,2012,36620,16068,3.2675e+13,726.59,7127.46,52688,401,415,50676,49998,48850,45138,42348
50847,2674,2786,35765,15082,3.58207e+13,849.177,8627.77,50847,487,474,48061,48056,48036,48033,47218
31717,1982,2151,22412,9305,3.60079e+13,839.49,6404.11,31717,431,485,29566,29563,29547,29565,29137
57578,2471,2688,39599,17979,3.40848e+13,740.537,8956.4,57578,522,562,54890,54890,54806,54705,53756
92654,2289,2853,64847,27807,3.71185e+13,1244.76,11056.2,92654,628,580,89801,89406,88295,85385,82035
69375,2582,2810,47570,21805,3.50502e+13,867.915,9530.89,69375,479,504,66565,66564,66537,66549,65592
42732,249,1963,29835,12897,3.6407e+13,852.465,6399.82,42732,459,390,37387,32704,22525,11147,10049
92329,2081,2962,64517,27812,3.44116e+13,996.787,11230.1,92329,634,492,89367,89200,87624,84955,75521
92283,3160,3473,64655,27628,3.60908e+13,1166.33,12479.8,92283,627,551,88810,88754,88661,88652,87223
13850,879,971,9471,4379,3.51765e+13,453.179,2895.93,13850,298,245,12879,12876,12763,12781,12602
96798,2466,3128,66724,30074,3.57495e+13,1127.84,11619,96798,668,547,93670,93273,92636,90633,88093
43367,2058,2343,30196,13171,3.5876e+13,793.498,7453.82,43367,426,415,41024,41023,40857,40952,38210
98035,2857,3662,68364,29671,3.51912e+13,1127.38,12797,98035,743,725,94373,94323,93154,91894,85430
84024,72,3129,56509,27515,3.50697e+13,934.475,10639.3,84024,529,510,62156,54066,36382,15338,8459
55556,541,2158,37956,17600,3.27788e+13,590.186,7479.6,55556,331,405,53181,52131,35369,23267,18805
94309,498,2983,64894,29415,3.34217e+13,763.483,11166.1,94309,507,586,89460,83896,62543,46415,22558
81509,2720,3438,56248,25261,3.56158e+13,879.61,12086.2,81509,501,718,78071,78041,77719,77531,70683
87648,580,3984,59899,27749,3.51425e+13,950.762,13058.8,87648,745,612,82202,79530,49084,27878,24188
46900,401,2303,32510,14390,3.3994e+13,918.915,7510.46,46900,472,385,42926,41097,29533,20723,14606
27527,126,2072,19037,8490,3.61959e+13,401.407,5534.36,27527,415,345,21905,18748,13755,5877,3444
43679,482,2576,30082,13597,3.50258e+13,627.221,7528.39,43679,439,366,40363,38488,25135,18717,14969
70321,1575,1901,50472,19849,3.70525e+13,874.182,7936.14,70321,493,430,68420,68373,68315,68278,66504
46801,2119,46801,0,46801,15.9997,0,46801,46801,46801,1,0,0,0,0,0
90372,1464,4496,61832,28540,3.53928e+13,936.812,13910.7,90372,670,756,85876,84685,64867,55663,47630
40639,1171,2031,28836,11803,3.50456e+13,755.864,6704.6,40639,419,382,38582,37854,36481,33146,26601
86744,1883,3694,59263,27481,3.5209e+13,786.959,12677.8,86744,542,818,83050,82983,80835,78572,58710
78263,732,3146,53624,24639,3.30278e+13,1069.63,10863.3,78263,502,468,74154,71514,45147,31037,20983
47291,1950,2320,33527,13764,3.48402e+13,880.886,7514.19,47291,482,407,44971,44941,44565,44061,41534
92596,1796,3014,64076,28520,3.25653e+13,1115.22,11301,92596,557,627,89582,89426,87785,84654,75351
27032,21829,27032,0,27032,15.9994,0,27032,27032,27032,1,0,0,0,0,0
45131,254,2204,32411,12720,3.71831e+13,848.299,7125.03,45131,504,386,39623,35169,25399,12958,7627
59680,714,2490,40529,19151,3.41276e+13,733.334,8410.1,59680,493,534,56915,54644,42085,32689,29454
50506,1386,2110,34510,15996,3.60758e+13,637.492,6944.77,50506,461,389,48396,48364,46562,43357,42523
49845,1965,2096,35367,14478,3.61252e+13,697.247,7276.86,49845,516,354,47749,47746,47736,47724,47392
52993,1179,2726,37327,15666,3.63444e+13,876.166,8517.43,52993,578,465,50217,48829,44653,32207,32256
56484,2153,2616,39827,16657,3.58681e+13,918.156,8559.35,56484,578,481,53868,53764,52847,51470,50771
42884,513,2178,29551,13333,3.19276e+13,801.939,6799.47,42884,434,400,39619,37939,21765,17513,10160
88123,644,2286,63080,25043,3.70177e+13,983.597,9974.15,88123,492,473,83955,81060,68065,43228,29576
96845,1189,3028,66960,29885,3.63414e+13,1034.81,11815.4,96845,736,487,93374,91683,74519,55110,48923
64781,564,2341,46289,18492,3.70859e+13,868.98,8764.67,64781,476,460,60977,58892,51191,31058,26533
14756,432,1366,9868,4888,3.29756e+13,285.415,3414.24,14756,264,247,13350,13004,10875,7790,7123
55625,1596,3168,38570,17055,3.61604e+13,708.669,9628.43,55625,484,650,52457,52141,50540,47855,29750
51340,1510,3048,35182,16158,3.52986e+13,647.271,8950.1,51340,487,553,48292,47962,44049,36336,34129
38889,2259,2482,26901,11988,3.56473e+13,630.421,7316.26,38889,505,421,36407,36400,36364,36372,35394
3862,421,628,2663,1199,3.4958e+13,151.401,1290.05,3862,123,141,3234,3217,3115,3066,2011
64127,337,2112,45951,18176,3.72738e+13,888.245,8058.3,64127,478,389,57822,53454,40073,27716,21025
54933,2635,2674,39503,15430,3.68875e+13,945.445,8647.04,54933,592,433,52259,52259,52259,52259,52223
90540,212,2955,63710,26830,3.64988e+13,1312.32,11619.8,90540,715,581,78197,69645,49270,17374,14503
15398,1009,1309,11042,4356,3.5842e+13,324.016,3398.71,15398,276,235,14089,14016,13758,13577,12334
51633,1565,2298,36006,15627,3.6228e+13,837.305,7720.52,51633,489,441,49335,49250,47078,42394,42568
57702,1248,2603,40148,17554,3.62081e+13,601.801,8362.98,57702,388,367,55099,54866,48300,36751,35152
31900,182,2116,22013,9887,3.59306e+13,556.618,6135.43,31900,376,407,26992,23854,15522,5479,5705
17739,571,1473,12754,4985,3.85139e+13,540.438,3943.18,17739,351,394,15916,14986,14129,10894,7672
60740,2427,3724,42006,18734,3.56787e+13,897.139,11000.9,60740,657,535,57016,56789,55944,52497,46987
29601,69,2159,20072,9529,3.5145e+13,471.28,5934.42,29601,411,348,22045,18645,13209,5321,3547
5129,472,927,3639,1490,3.78781e+13,200.192,1759.72,5129,194,174,4202,4054,3991,3726,2497
92058,774,2791,65374,26684,3.63998e+13,1024.3,11170.2,92058,628,716,87780,84776,72329,54578,34823
69640,2528,2677,48841,20799,3.65287e+13,875.593,9391.37,69640,553,547,66963,66963,66887,66894,65540
68183,612,2692,47042,21141,3.48089e+13,1141.82,9565.18,68183,611,566,63799,61506,46052,32060,27022
86136,341,3205,58918,27218,3.37265e+13,1085.44,11468.4,86136,558,556,78755,74420,44159,21579,16979
71739,2951,3041,50476,21263,3.58477e+13,1203.21,10313.8,71739,561,564,68698,68686,68688,68679,68494
79363,1571,2930,54094,25269,3.39009e+13,1081.18,10557,79363,694,571,76375,75662,71465,60614,58715
70390,2147,3190,48168,22222,3.53538e+13,822.97,10027.4,70390,666,546,67200,67072,65470,57514,57855
37573,1924,2405,27195,10378,3.81832e+13,622.262,7116.89,37573,427,387,35168,35104,34902,35073,31254
38676,1778,2426,27051,11625,3.68357e+13,700.384,6950.28,38676,398,479,36250,36166,35856,35232,31479
87631,496,2968,61647,25984,3.60387e+13,1035.69,10881.2,87631,619,536,81988,76762,51888,32116,19859
84939,274,3188,58662,26277,3.43529e+13,1104.51,11461.4,84939,725,665,76604,68685,44495,18560,15531
89400,2512,2955,63396,26004,3.68918e+13,1238.22,11594.9,89400,614,497,86445,86293,86155,85872,81103
55986,159,2290,37837,18149,3.52286e+13,889.02,8113.61,55986,449,532,46604,41085,24138,10162,6543
35669,1196,2664,25663,10006,3.69548e+13,573.744,7317.49,35669,463,578,33005,32768,30957,29768,17319
11674,428,880,8343,3331,3.94424e+13,536.359,2557.75,11674,273,207,10327,9529,9427,8031,6745
76737,797,2270,55559,21178,3.68254e+13,1067.02,9657,76737,713,399,72879,69943,63417,43064,34459
67089,294,2583,45761,21328,3.46894e+13,918.355,9184.91,67089,526,520,59045,54183,35445,18376,12618
86748,1207,2648,59961,26787,3.44638e+13,923.137,10079.4,86748,556,503,83934,83215,73893,52662,54354
32873,488,2102,23496,9377,3.7319e+13,604.588,6220.91,32873,389,417,29954,28202,24463,18660,9183
16800,1198,1371,11321,5479,3.40404e+13,364.138,3755.08,16800,286,226,15429,15429,15339,15247,14606
9291,788,1170,6499,2792,3.48649e+13,209.139,2563.44,9291,263,187,8121,8064,7977,7968,6760
34856,1029,1756,24933,9923,3.58951e+13,595.631,5498.89,34856,430,287,33100,32613,31205,28215,25450
67012,1509,2755,46108,20904,3.39694e+13,1167.47,9578.74,67012,524,591,64058,62686,58744,45990,42485
45502,1415,2405,31572,13930,3.47376e+13,750.409,7704.9,45502,421,476,43097,42946,42229,41608,29420
42171,459,1968,29277,12894,3.12938e+13,718.093,6475.01,42171,461,366,39373,37679,32686,25223,14474
52620,1705,2730,37189,15431,3.45353e+13,650.342,8646.27,52620,412,507,49890,49842,49335,49248,41003
4755,442,845,3237,1518,3.24717e+13,108.816,1667.09,4755,163,130,3910,3880,3664,2941,2703
70899,1554,2689,49562,21337,3.48165e+13,1138.19,9810.05,70899,641,567,67909,66501,64907,56697,55019
84186,2344,2999,59094,25092,3.71711e+13,1158.15,11240.8,84186,558,505,81187,81054,79589,77297,72143
41177,2083,2849,28894,12283,3.59256e+13,703.657,8001.03,41177,450,537,38328,38124,37963,37612,33586
49940,986,2639,35083,14857,3.61637e+13,952.101,8226.43,49940,450,540,46915,45760,41158,31717,22865
63200,3238,3521,44532,18668,3.68238e+13,904.383,10655.2,63200,563,643,59679,59678,59626,59645,58483
1632,121,407,1145,487,3.81251e+13,82.6446,680.83,1632,105,102,1209,1102,935,841,693
33701,113,1798,24676,9025,3.62931e+13,882.339,5828.53,33701,430,347,26595,23418,19438,5289,3840
10732,1062,1178,7673,3059,3.87288e+13,265.548,2724.66,10732,233,232,9554,9553,9545,9544,9323
89453,1708,2763,60064,29389,3.36839e+13,900.614,10687.8,89453,583,535,86690,86467,85326,81501,78549
75182,2984,3201,52827,22355,3.54578e+13,850.685,10733.8,75182,774,435,71981,71980,71877,71108,71170
19865,525,976,13995,5870,3.51299e+13,424.446,3276.56,19865,265,234,18883,18379,17110,16037,13556
29933,1851,1876,21430,8503,3.62087e+13,531.111,5497.72,29933,430,314,28057,28057,28056,28049,27985
41345,1345,2024,28643,12702,3.43639e+13,690.552,6526.62,41345,384,402,39321,39124,38056,36184,33197
22900,421,1427,15930,6970,3.7739e+13,694,4385.38,22900,388,355,20472,18938,16057,12692,9662
63767,342,2794,44610,19157,3.48564e+13,938.177,9371.42,63767,675,400,57446,52429,34747,21184,13155
8297,764,966,5747,2550,3.36423e+13,313.581,2294,8297,187,200,7331,7265,7151,7105,6733
48245,3076,3204,33219,15026,3.43851e+13,790.474,9041.9,48245,588,473,45041,45041,45021,45039,44663
47921,1226,2623,32834,15087,3.54119e+13,551.284,7655.1,47921,566,464,45298,44924,36565,29264,30048
50692,618,1812,35731,14961,3.58036e+13,833.806,6636.48,50692,442,377,47705,46084,39387,27752,21645
58058,2783,3074,40516,17542,3.43463e+13,976.275,9701.31,58058,563,683,54984,54948,54532,54176,52325
95945,3234,3424,66039,29906,3.57453e+13,1155.88,12461.7,95945,640,748,92521,92489,92411,92434,91881
20009,728,1667,13855,6154,3.59804e+13,420.038,4438.37,20009,405,248,18342,17904,15110,11412,10309
6830,823,942,4793,2037,3.43565e+13,251.612,2052.97,6830,239,191,5888,5885,5851,5837,5577
11402,78,1095,7943,3459,3.4436e+13,341.448,2777.17,11402,219,200,8623,7402,5830,2581,1582
89581,1088,4221,61736,27845,3.52995e+13,955.16,13136.7,89581,554,604,85074,83757,61497,44430,31092
79789,1954,2469,55613,24176,3.31915e+13,1059.81,9508.81,79789,548,488,77320,76923,76155,74663,68132
33912,49,2036,23065,10847,3.42729e+13,474.501,5920.24,33912,391,387,23739,18912,14488,6034,3526
31656,1008,1806,22288,9368,3.64155e+13,669.21,5644.64,31656,359,394,29850,28877,28478,26657,21921
94607,2030,3508,64989,29618,3.44327e+13,1003.45,12772.1,94607,631,610,91099,90627,85956,74987,69315
69101,574,3288,48451,20650,3.35994e+13,826.195,10652.1,69101,659,483,64438,62053,36373,26176,13121
66972,826,2855,47606,19366,3.75795e+13,929.791,9755.54,66972,580,570,63491,61267,55005,43310,24730
95487,234,3397,67012,28475,3.53817e+13,1070.61,12183.8,95487,728,498,83680,74785,50573,16132,16785
8812,217,1129,6036,2776,3.40144e+13,223.289,2564.22,8812,259,234,7455,6801,5529,4826,2538
35135,726,2612,24398,10737,3.61426e+13,583.342,6920.33,35135,502,375,32418,31355,25728,19882,17673
37073,638,2151,26399,10674,3.61707e+13,867.478,6430.89,37073,438,428,34145,32817,27852,17834,16831
85712,448,2429,60729,24983,3.4924e+13,864.301,9590.12,85712,549,553,79189,73819,60344,43237,26331
97974,933,3488,69789,28185,3.67241e+13,1172.92,12898.5,97974,652,602,93159,90400,81217,51344,40101
76260,1148,1429,52233,24027,2.96006e+13,880.864,7112.25,76260,434,432,74828,74151,73780,72507,67191
4792,151,616,3173,1619,3.22245e+13,150.678,1327.03,4792,168,132,4051,3734,2748,2189,1383
76066,2289,3168,51969,24097,3.42576e+13,815.989,10677.8,76066,473,508,72898,72854,72384,72114,64560
66303,1496,3183,46476,19827,3.51916e+13,1105.55,10697.2,66303,678,601,63066,61986,56950,46467,38314
29416,1475,2356,21310,8106,3.73712e+13,619.276,6318.7,29416,462,451,27060,26700,25965,24007,21373
60439,706,2259,42591,17848,3.54123e+13,805.301,8029.87,60439,496,437,57394,55941,45155,28656,26247
20650,355,1614,14379,6271,3.59834e+13,409.9,4478.14,20650,259,400,18572,17022,15240,12415,5888
85797,955,2961,59526,26271,3.67525e+13,835.479,10300.9,85797,690,611,82430,81231,59296,48213,49008
19709,912,1725,13353,6356,3.04808e+13,277.634,4269.19,19709,369,259,17984,17906,17202,15217,13297
47482,1146,1857,32200,15282,3.48891e+13,576.112,6371.19,47482,471,434,45625,45615,42484,36172,38507
24057,68,1807,16935,7122,3.69663e+13,408.996,4634.46,24057,363,253,17784,15055,11293,4188,2296
80379,904,2989,55929,24450,3.65753e+13,985.538,10634.3,80379,618,481,76691,73667,59147,42135,43823
36928,1107,2377,26126,10802,3.58072e+13,867.944,7085.8,36928,421,459,34375,33540,31320,24807,22004
3422,138,368,2317,1105,3.67732e+13,206.959,923.612,3422,122,124,2739,2297,2097,1623,1598
75498,2168,3241,52083,23415,3.52597e+13,860.1,10150.6,75498,588,482,72257,72051,69748,63798,60323
91165,1722,2961,61848,29317,3.38589e+13,1016.87,10491.5,91165,574,487,88204,87627,82642,71313,67910
50633,1320,1944,36188,14445,3.76779e+13,732.531,6804.02,50633,464,329,48689,48619,46382,43447,43297
54843,1374,2851,37951,16892,3.50147e+13,805.325,9155.89,54843,488,543,51992,51384,48764,43914,36163
18007,397,1386,12696,5311,3.59327e+13,449.257,3755.1,18007,359,261,16025,14617,12078,8987,7155
16695,110,1154,11303,5392,3.57986e+13,468.638,3327.29,16695,237,257,12939,11258,8081,3547,3383
89883,2541,3219,61990,27893,3.54881e+13,1162.65,11328.9,89883,638,531,86664,86483,85275,81277,82469
89953,823,3937,62896,27057,3.49035e+13,1086.95,13043.3,89953,697,609,84568,82200,54169,37402,21058
42213,2398,2423,29643,12570,3.66894e+13,735.193,7276.61,42213,521,357,39790,39786,39790,39790,39640
47550,928,2499,33385,14165,3.49392e+13,858.823,7898.29,47550,549,444,44584,43437,39147,27846,23249
16405,152,1098,11415,4990,3.65071e+13,563.694,3227.78,16405,325,251,13650,12289,9235,5294,3541
97506,1900,4022,69306,28200,3.66067e+13,1307.84,13790.2,97506,741,814,93484,91950,86632,75178,49456
25632,1886,2108,18218,7414,3.75269e+13,647.356,5622.7,25632,438,487,23524,23523,23454,23426,22700
32436,569,1893,22971,9465,3.61526e+13,472.495,5702.52,32436,341,310,30474,29769,26513,18049,12883
85974,2675,3230,60226,25748,3.60371e+13,1192.92,11931.9,85974,580,654,82744,82639,82332,82392,77088
61733,995,2417,42828,18905,3.4434e+13,1117.56,8526.84,61733,513,478,58517,57156,51162,39106,34664
47339,1060,2386,32507,14832,3.38931e+13,751.152,7453.37,47339,400,497,44871,43973,40846,35921,30135
37216,113,1801,25639,11577,3.59534e+13,723.46,6208.17,37216,408,348,29687,26089,17863,6141,4985
48065,1199,2606,33903,14162,3.50578e+13,794.746,8181.34,48065,400,503,45392,44480,43129,40106,29340
79717,591,2590,55633,24084,3.54754e+13,922.113,9496.93,79717,556,488,74758,70087,52667,36646,25174
6391,451,712,4247,2144,2.99722e+13,106.436,1549.11,6391,151,117,5679,5669,5597,5601,5171
59997,491,2676,41700,18297,3.59961e+13,688.898,8532.7,59997,563,451,56310,54456,34391,25817,17777
63843,1452,2352,44391,19452,3.53568e+13,897.176,8424.9,63843,460,467,61491,60726,59311,55224,50903
38306,1394,2226,26900,11406,3.63099e+13,690.092,6757.9,38306,372,416,36080,36012,35162,33995,28992
2870,202,454,2132,738,3.42318e+13,164.07,925.312,2870,99,98,2374,2142,2102,2145,1504
11618,44,832,7816,3802,2.70644e+13,167.976,2200.75,11618,167,150,8170,5848,5067,3658,1938
3946,154,263,2613,1333,2.46442e+13,95.9093,769.823,3946,91,90,3683,3667,3294,3471,2782
20349,600,1544,13732,6617,3.516e+13,556.784,4322.11,20349,307,400,18563,17667,15168,12334,10533
20823,636,1518,14180,6643,3.41868e+13,625.998,4409.42,20823,315,364,18969,18204,16312,13437,8089
81460,2691,2750,56236,25224,3.42411e+13,1108.82,10173.4,81460,596,590,78710,78704,78690,78677,78449
92193,1586,3148,64181,28012,3.66038e+13,1183.28,11655.2,92193,721,546,88962,87837,78385,65613,66966
50691,1804,2599,35209,15482,3.59932e+13,837.474,8080.48,50691,454,414,48092,47758,46580,43351,41502
70844,403,2493,49495,21349,3.23729e+13,1000.01,9150.03,70844,471,499,65229,61807,49130,28642,16022
28429,1968,2169,19794,8635,3.65765e+13,368.443,5760.04,28429,298,397,26260,26260,26223,26247,25798
93355,565,2815,65111,28244,3.36645e+13,1045.46,11135.2,93355,594,618,88480,85189,69431,54290,31853
34435,541,2074,23846,10589,3.61595e+13,653.378,6217.07,34435,374,364,31571,29996,23712,17566,13783
11464,805,1441,8078,3386,3.78113e+13,236.467,3257.1,11464,179,354,10023,10016,9808,9868,7534
97566,887,4207,67556,30010,3.58646e+13,1041.46,13901.8,97566,778,512,92279,89868,60315,46255,36053
62179,1666,2897,42505,19674,3.53366e+13,652.666,9253.74,62179,561,503,59282,59218,55942,49022,48519
49781,965,1908,35064,14717,3.40143e+13,867.348,6771.4,49781,493,400,47539,46225,44217,37201,26057
12698,378,1527,8828,3870,3.61514e+13,245.943,3564.47,12698,166,447,11171,10575,9943,10137,3283
56254,2007,2438,39192,17062,3.59168e+13,877.545,8509.81,56254,452,542,53816,53761,53365,52888,50670
40208,1026,2263,28093,12115,3.61969e+13,601.692,6974.62,40208,613,346,37945,37567,33448,25355,22575
81247,971,2971,55974,25273,3.47594e+13,755.586,10898,81247,487,587,77859,76726,72080,57382,45938
85548,3259,4040,60613,24935,3.6063e+13,960.472,13361.6,85548,744,634,81508,81314,79183,71990,71170
47819,1437,1843,32537,15282,3.50206e+13,447.261,5913.44,47819,407,336,45976,45971,45912,45867,44652
4184,446,455,2923,1261,3.70725e+13,184.947,1076.31,4184,152,110,3729,3729,3728,3728,3728
95523,652,2276,65603,29920,3.187e+13,1047.56,9887.3,95523,502,501,90806,87544,72855,49742,40399
31914,401,1911,21548,10366,3.42282e+13,497.272,5816.77,31914,350,402,29446,27715,20135,13294,8945
22936,54,1731,15735,7201,3.10499e+13,445.987,4422.3,22936,285,289,16897,12707,9674,2251,1321
8855,357,836,6078,2777,3.57663e+13,372.433,2256.68,8855,206,251,7777,7345,6940,5742,4547
39624,666,2333,27301,12323,3.56753e+13,715.602,6715.63,39624,431,527,36892,36100,28966,24693,15266
89244,834,2942,62731,26513,3.60353e+13,1067.21,10694.2,89244,604,556,85343,83457,64675,40838,31602
46264,2942,3203,31924,14340,3.54212e+13,667.61,9155.98,46264,612,633,43061,43061,42974,43019,41720
24204,97,1744,16831,7373,3.58922e+13,676.641,4860.9,24204,385,397,18746,15746,11771,4035,3135
78432,1042,3164,55624,22808,3.57293e+13,1036.86,10641.1,78432,720,462,74771,72533,56180,45778,31664
46110,2134,2275,32231,13879,3.58422e+13,1019.61,7303.54,46110,464,462,43835,43835,43784,43815,43531
92891,2348,3394,63533,29358,3.30798e+13,889.96,12359.1,92891,458,715,89497,89447,88937,88910,74558
21513,490,1447,14826,6687,3.60142e+13,585.18,4342.14,21513,324,316,19398,18092,16315,12758,8605
89962,246,3086,62786,27176,3.61866e+13,1073.61,11910.4,89962,558,674,79713,72208,49759,16290,14587
24199,892,1541,17281,6918,3.88307e+13,595.688,4509.39,24199,370,277,22658,22265,21598,19610,19026
38330,2015,2321,27100,11230,3.68655e+13,642.924,6985.12,38330,475,331,36009,36001,35915,35663,34533
52296,462,2342,36089,16207,3.44721e+13,779.914,7673.89,52296,473,382,48651,46677,27188,17894,10649
1793,226,344,1402,391,3.55596e+13,71.749,636.971,1793,134,73,1449,1430,1432,1412,1255
60652,354,2953,41618,19034,3.52185e+13,809.5,9373.08,60652,527,434,55170,52095,30809,13883,10613
58253,323,2752,41306,16947,3.68436e+13,827.929,9571.8,58253,449,568,52497,47641,37405,21657,11261
77375,894,3512,54119,23256,3.622e+13,1147.72,11548.9,77375,624,597,72807,70693,57331,40116,24534
90068,2431,3763,61578,28490,3.44109e+13,799.741,11619.5,90068,537,462,86305,86106,82862,71185,70599
86049,942,3097,59942,26107,3.39547e+13,1096.35,10983.5,86049,592,449,82371,80856,59199,44641,36009
85130,3418,3420,57573,27557,3.37337e+13,1127.95,11634.8,85130,612,591,81710,81710,81710,81710,81710
25904,1042,1813,18161,7743,3.62699e+13,551.391,5095.03,25904,375,361,24091,23563,22848,20219,17887
42078,418,1862,28528,13550,3.48919e+13,790.579,6512.29,42078,435,377,38388,36186,24908,19185,13993
85125,2449,3072,59583,25542,3.44172e+13,1065.42,11154.7,85125,746,504,82053,81981,80549,77590,74059
88785,938,2014,62741,26044,3.59548e+13,1141.18,9657.05,88785,622,461,85719,84095,78115,63517,55024
57186,505,2638,39405,17781,3.50145e+13,757.761,8202.91,57186,475,471,53719,52303,37394,26494,23161
6424,396,751,4348,2076,3.14628e+13,250.013,1767.83,6424,162,226,5673,5413,5261,4416,4074
27630,1618,1649,19179,8451,3.53025e+13,499.291,4966.88,27630,317,334,25981,25981,25980,25981,25931
56510,605,2107,39467,17043,3.50244e+13,800.207,7635.93,56510,467,473,52725,49678,43853,34119,25067
11249,988,1155,7914,3335,3.59157e+13,430.622,2845.18,11249,311,256,10094,9905,10002,9975,9650
15665,669,1544,10447,5218,3.37309e+13,468.389,3844.3,15665,262,294,14121,13556,11309,9023,7831
9446,721,1287,6603,2843,3.47322e+13,198.684,2765.07,9446,241,218,8159,8130,7755,7077,5702
78059,485,2749,53994,24065,3.59968e+13,1050.39,9795.66,78059,567,518,72409,67270,44536,24339,22764
8589,587,824,5953,2636,3.6715e+13,261.519,2048.97,8589,251,192,7765,7752,7550,7214,7064
1262,215,360,881,381,2.94526e+13,55.8249,595.184,1262,116,66,902,890,797,672,638
91405,1989,2753,62920,28485,3.54121e+13,976.503,10083.7,91405,511,558,88652,88492,85069,78646,78203
29745,281,2063,21027,8718,3.68613e+13,606.371,5845.31,29745,450,361,26204,23366,16131,9616,5082
84999,3878,3956,58400,26599,3.42319e+13,1013.13,12852.6,84999,610,705,81043,81043,80984,80971,80852
71599,2283,2846,50126,21473,3.60447e+13,1232.96,10334.7,71599,686,501,68753,68687,68011,66653,66299
68986,822,2302,47163,21823,3.35034e+13,867.744,8732.84,68986,478,482,66290,64932,53040,39860,37232
1274,39,347,888,386,3.62447e+13,86.6845,553.509,1274,97,66,824,671,566,332,277
15347,168,1794,10719,4628,3.75019e+13,344.571,4152.63,15347,245,338,12622,11126,7826,4172,2924
30552,315,2388,21759,8793,3.68212e+13,668.599,6473.62,30552,401,438,27011,24979,18515,12959,8137
16303,1189,1351,11890,4413,3.69077e+13,475.917,3609.33,16303,342,241,14952,14930,14829,14561,14441
49705,856,2255,35391,14314,3.66524e+13,831.285,7464.98,49705,577,356,47153,46085,40142,30389,31735
40386,1328,1812,28250,12136,3.29233e+13,852.014,6063.65,40386,463,366,38574,38197,37593,36382,30308
22192,1013,1425,15311,6881,3.62475e+13,583.395,4322,22192,333,307,20767,20715,19679,17383,17854
19110,1301,1411,13290,5820,3.50376e+13,482.604,3903.69,19110,281,277,17699,17699,17669,17673,17485
89447,319,3595,62130,27317,3.57724e+13,1157.74,12933.6,89447,673,561,79425,73699,49676,18828,14429
79839,388,3608,54490,25349,3.43122e+13,879.161,11548.5,79839,492,625,73203,69715,41684,20806,21872
29856,1753,2144,21871,7985,3.75207e+13,741.502,6109.29,29856,492,370,27712,27466,27460,27134,26001
80205,2832,2961,55029,25176,3.33478e+13,1079.56,10781.7,80205,638,613,77244,77244,77110,77000,76930
49748,2368,2557,34253,15495,3.59694e+13,725.965,7518.09,49748,428,443,47191,47181,46997,46742,46673
45225,591,2067,31476,13749,3.62095e+13,701.803,6565.73,45225,443,357,42766,41686,32199,24098,21809
43344,165,2410,29792,13552,3.36191e+13,781.506,7469.41,43344,462,442,36688,33696,22505,7587,5541
14907,1306,1583,10489,4418,3.48968e+13,389.919,3885.05,14907,239,328,13324,13295,13262,13296,11929
53245,2550,2909,35994,17251,3.25077e+13,671.146,8991.98,53245,440,493,50336,50323,50192,50253,46184
20127,248,1506,14116,6011,3.59264e+13,507.889,4129.93,20127,424,251,17253,15408,11460,7595,6154
92425,835,2212,64400,28025,3.13785e+13,1102.12,9627.02,92425,569,476,88331,85258,80987,56250,41230
12734,421,1009,8995,3739,3.56809e+13,300.839,2764.1,12734,265,160,11700,11471,10225,8240,6598
17273,253,1130,12189,5084,3.58734e+13,470.532,3384.7,17273,368,257,14843,12933,10695,7219,5331
63265,2730,2895,44156,19109,3.46518e+13,997.895,9620.41,63265,469,551,60370,60369,60347,60363,59742
49500,1210,1832,34565,14935,3.20212e+13,773.039,6619.54,49500,398,341,47668,47213,46304,44577,36013
63759,2203,2372,45193,18566,3.70421e+13,1060.57,8831.98,63759,613,464,61387,61387,61320,61333,60964
88153,2482,2898,63136,25017,3.71005e+13,1170.4,10705.4,88153,723,491,85255,85246,84879,84603,83711
14725,1065,1683,10798,3927,3.83031e+13,464.346,3846.5,14725,312,255,13042,12810,12723,12474,9470
94645,2477,3427,65064,29581,3.45931e+13,1413.46,12972.7,94645,649,627,91218,90685,86620,75049,71836
56400,1532,2963,38781,17619,3.45001e+13,754.348,9491.02,56400,474,430,53437,53134,50850,44052,39579
22228,216,1677,15954,6274,3.39656e+13,438.213,4692.75,22228,368,367,19579,17836,14867,13256,4891
98078,1533,3191,68674,29404,3.47358e+13,886.933,12067.3,98078,782,456,94887,94399,80611,54358,48931
96026,1319,2865,68162,27864,3.69608e+13,1084.84,11053.1,96026,659,490,93135,91488,87196,70415,69516
83861,2620,2704,58890,24971,3.48192e+13,905.038,10014.1,83861,473,588,81157,81157,81120,81129,81001
93983,235,2439,68119,25864,3.70412e+13,1060.1,10052.6,93983,544,471,81982,71832,55268,23218,18730
57963,1743,2468,40757,17206,3.57038e+13,889.65,8349.29,57963,505,452,55495,55048,54654,52456,47780
3160,156,443,2313,847,3.44317e+13,189.158,957.26,3160,116,109,2564,2188,2226,1949,1472
58064,1914,2797,40500,17564,3.43609e+13,862.922,8753.05,58064,510,436,55267,54893,53396,46707,44753
62846,1499,3687,43638,19208,3.57373e+13,914.578,11082.4,62846,476,658,59159,57867,53754,45329,29541
42691,377,2377,29258,13433,3.61498e+13,766.728,7341.61,42691,443,453,38195,35488,23018,13027,12781
17406,1019,1551,12631,4775,3.66436e+13,484.374,3962.54,17406,347,283,15855,15737,15507,15399,13237
57719,1899,3496,39934,17785,3.43614e+13,812.536,10391.9,57719,659,852,54223,53751,51345,44511,33379
28628,857,1843,19809,8819,3.38118e+13,386.312,5364.13,28628,273,375,26785,26576,25450,23141,17667
25519,496,1579,17293,8226,3.46842e+13,456.744,4718.84,25519,295,279,23708,22743,17454,13770,10779
82982,619,2007,57436,25546,3.31742e+13,1092.25,8723.85,82982,517,459,78315,75153,62214,44693,35079
30924,1156,1864,21503,9421,3.67173e+13,651.259,5581.87,30924,474,338,29060,28891,27189,24732,25096
54352,367,2486,37528,16824,3.27681e+13,1133,8289.7,54352,497,494,49220,46878,30317,14686,10615
44453,204,2253,31362,13091,3.66962e+13,780.404,7251.38,44453,373,442,38621,34281,24057,10962,7958
65275,2983,3324,44096,21179,3.44283e+13,846.437,10484.3,65275,594,722,61951,61950,61775,61452,60981
15004,157,1329,10518,4486,3.62586e+13,482.261,3555.3,15004,350,346,12296,10674,8076,5639,2878
5629,395,688,3812,1817,3.57083e+13,252.58,1638.95,5629,174,166,4941,4749,4359,3509,3561
41325,315,2440,28538,12787,3.26662e+13,725.583,7351.24,41325,355,446,37346,35194,23761,15264,8499
95141,1953,3161,66655,28486,3.47728e+13,1021.52,11577,95141,673,518,91980,91641,82684,65535,66028
22891,354,1455,15942,6949,3.5487e+13,524.442,4361.27,22891,336,316,20505,19362,16142,13324,8781
45134,1942,2227,31747,13387,3.5205e+13,827.32,7472.62,45134,411,422,42907,42894,42764,42477,40626
72941,1589,2437,52187,20754,3.69701e+13,1087.84,9239.48,72941,628,475,70504,69828,67400,62001,56073
58251,1050,2076,41300,16951,3.72935e+13,771.878,7946.78,58251,646,384,56175,55940,53067,46874,44281
32914,391,2097,22546,10368,3.25803e+13,670.856,6019.45,32914,358,380,30173,29065,22497,16129,8245
64814,231,2075,45226,19588,3.6363e+13,831.532,7525.71,64814,438,446,58133,51005,34977,15616,13495
76106,1084,2857,53730,22376,3.53932e+13,1131.52,10454.6,76106,657,641,72615,71003,63319,53439,41296
32304,709,2191,22142,10162,3.48569e+13,500.227,6294.33,32304,384,573,30043,29218,27337,25167,15435
78948,2592,3254,54222,24726,3.47594e+13,790.162,11196.1,78948,679,481,75694,75687,74873,71789,69253
39564,2479,2707,27279,12285,3.52674e+13,659.133,7563.12,39564,532,478,36857,36857,36553,35865,36146
85020,1876,2992,59494,25526,3.66757e+13,943.168,11084.1,85020,510,607,82028,81809,80657,78344,71244
48184,646,2154,34652,13532,3.65926e+13,791.153,7142.03,48184,513,352,45142,43621,39927,30241,22668
86452,2774,2819,60730,25722,3.63554e+13,1209.71,10425.1,86452,620,459,83633,83633,83618,83633,83584
99768,1060,3493,69979,29789,3.53376e+13,1155.03,12593.9,99768,758,690,95554,94031,80447,63788,46208
94985,3218,3315,66656,28329,3.70494e+13,1211.06,12616.7,94985,623,547,91670,91577,91642,91302,90822
92521,116,3120,65394,27127,3.59213e+13,1301.24,11887.8,92521,727,549,76021,66612,47672,13615,7561
76759,3266,3868,53645,23114,3.48374e+13,979.851,12695.6,76759,700,728,72891,72781,72556,72613,66195
25932,148,1774,18107,7825,3.63637e+13,487.629,5034.72,25932,339,334,21545,18987,14528,5420,4738
97456,1337,2691,69715,27741,3.64468e+13,1193.82,10984.3,97456,688,483,94478,92620,86201,68735,68977
32143,168,1744,22506,9637,3.33059e+13,668.751,5374.43,32143,386,296,28199,26324,17076,9214,6369
40315,916,2768,27645,12670,3.41687e+13,600.119,7619.26,40315,458,346,37547,36821,28273,19702,17336
7676,598,1002,5522,2154,3.63796e+13,212.703,2193,7676,227,214,6674,6627,6347,6315,4993
57837,1121,2799,41686,16151,3.71634e+13,1134.31,9338.61,57837,636,508,54559,52742,50025,39505,32472
6052,755,926,4462,1590,3.57727e+13,180.86,1922.31,6052,195,135,5126,5126,5102,5095,4522
59836,1998,3053,40742,19094,3.61005e+13,648.81,8708.08,59836,450,370,56783,56518,55296,51442,50094
45152,686,2077,31470,13682,3.32011e+13,650.787,6644.82,45152,463,361,42727,41869,29765,20789,18558
54650,726,2211,38907,15743,3.71216e+13,893.189,7863.39,54650,489,390,51176,49142,39927,27827,22237
71754,65,2520,51211,20543,3.73151e+13,1018.05,9319.66,71754,560,511,53474,45459,34868,9623,6080
50529,1568,1733,35708,14821,3.68824e+13,711.41,6525.94,50529,541,370,48796,48795,48757,48713,48480
60327,1620,2453,41660,18667,3.56964e+13,896.587,9025.92,60327,487,556,57874,57688,55964,53157,49338
78682,1073,2930,55664,23018,3.65111e+13,1026.41,10047.6,78682,542,548,75402,73595,67124,51363,47963
99513,2993,3610,69461,30052,3.58702e+13,995.494,12553.7,99513,663,592,95903,95897,95626,95620,92045
96675,2440,3874,68331,28344,3.62782e+13,1054.78,13296.3,96675,575,731,92801,92637,90825,88462,75629
62065,4069,4214,42643,19422,3.4242e+13,686.445,12070.3,62065,715,533,57851,57851,57725,57359,57361
88672,1533,2871,62175,26497,3.55246e+13,1115.03,11080.4,88672,732,586,85601,84880,78162,60935,63896
12115,396,1282,8533,3582,3.58186e+13,279.818,2974.57,12115,210,239,10770,10343,9867,9841,5788
9084,658,881,6563,2521,3.68005e+13,214.587,2076.76,9084,259,152,8203,8194,8134,8058,7824
11285,781,1108,7775,3510,3.52529e+13,426.28,2810.39,11285,299,223,10177,10064,9566,9166,8164
21210,566,1878,14500,6710,3.19782e+13,344.872,4549.85,21210,331,298,19332,18777,15819,12527,8859
8038,640,1178,5847,2191,3.69879e+13,305.971,2482.34,8038,312,164,6860,6609,6325,4804,4969
19902,268,1903,13619,6283,3.39842e+13,524.166,4730.36,19902,348,324,17199,16066,10307,5923,3949
21474,77,1003,14622,6852,3.5407e+13,472.596,3532.83,21474,294,298,15960,13710,10427,4089,3640
46707,851,2141,32060,14647,3.57057e+13,1043.09,7316.35,46707,485,449,43757,42388,37223,27755,24970
73658,2317,3142,52043,21615,3.51716e+13,855.958,10539.9,73658,544,575,70516,70299,70045,69510,61369
70857,203,3013,48160,22697,3.3424e+13,1078.11,10219.4,70857,513,519,60860,55355,33761,12349,10780
58785,2161,2495,41284,17501,3.64259e+13,897.282,8301.59,58785,547,401,56290,56272,56080,55840,53859
52059,1440,2350,36725,15334,3.65141e+13,836.653,7819.15,52059,440,453,49709,49222,48077,47205,39469
96018,1736,3590,65365,30653,3.4351e+13,1123.12,12543.9,96018,574,602,92428,91763,87523,77472,68321
23780,38,1887,16947,6833,3.69919e+13,481.587,4834.38,23780,336,362,15996,12876,9586,3190,2069
83694,1462,3412,58376,25318,3.58395e+13,906.452,11925,83694,653,512,80282,79625,72335,57233,53613
84972,2541,3906,58206,26766,3.51052e+13,1240.33,12764.1,84972,633,731,81066,80369,79026,75814,68150
90507,1915,3533,62200,28307,3.48242e+13,1203.31,12076.4,90507,628,630,86974,85885,80496,64892,63768
28829,1693,2341,19944,8885,3.54377e+13,563.242,6251.56,28829,423,345,26488,26429,26189,26369,23008
97091,762,3091,68877,28214,3.63258e+13,1052.99,11708,97091,832,472,92519,88033,67579,47837,38829
73767,2783,3252,50316,23451,3.4156e+13,1026.32,10778.5,73767,513,595,70515,70504,70326,70117,67142
84146,2905,3455,58085,26061,3.40904e+13,1101.1,11786.1,84146,579,622,80691,80659,80228,80321,77822
58742,1653,2882,41727,17015,3.57963e+13,896.836,9547.41,58742,514,550,55860,55458,53203,50063,39757
58890,1291,3049,40010,18880,3.45483e+13,1025.57,9663.9,58890,501,731,55616,54217,47625,38682,25690
62072,1916,3061,42721,19351,3.52723e+13,591.304,9828.08,62072,401,634,59011,58876,58406,57974,47930
18386,631,1683,13035,5351,3.5791e+13,462.005,4236.06,18386,341,263,16610,15960,14880,12120,9674
31583,1770,1851,21783,9800,3.63045e+13,568.792,5672.39,31583,389,346,29732,29732,29726,29693,29389
61755,2495,2953,43177,18578,3.65411e+13,1039.86,9453.82,61755,581,556,58802,58602,58405,58185,55741
9212,933,1027,6147,3065,3.30338e+13,338.791,2502.92,9212,221,295,8185,8184,8174,8119,7712
92263,212,3665,63248,29015,3.44609e+13,846.362,12987,92263,614,654,78470,69297,47604,17160,12724
52795,717,2324,36083,16712,3.59861e+13,898.308,7992.99,52795,466,464,49418,47559,32072,24617,23016
31909,121,2243,22894,9015,3.69072e+13,655.938,6360.42,31909,508,363,25839,22600,16880,5642,4300
58217,1879,2584,40085,18132,3.3878e+13,1049.71,8818.87,58217,468,467,55633,54941,54342,52175,48286
72400,1189,2911,50133,22267,3.27024e+13,1004.8,10019.3,72400,462,495,69279,67321,63812,53634,42985
84336,815,3914,58566,25770,3.46713e+13,1094.84,13022.1,84336,613,734,78891,76568,61153,48551,24643
24186,2022,2134,16776,7410,3.57451e+13,461.67,5516.18,24186,277,409,22052,22051,22029,22043,21731
37630,728,1785,27293,10337,3.69186e+13,693.262,6241.39,37630,409,384,35495,34370,32368,27522,16568
20156,297,1476,14724,5432,3.69981e+13,609.74,4232.3,20156,434,265,17689,16164,14960,11625,6935
18355,609,1216,12609,5746,3.13823e+13,404.872,3471.18,18355,242,270,17139,16796,16274,15634,8716
67988,2615,2732,47070,20918,3.44568e+13,975.729,9704.54,67988,500,513,65256,65256,65248,65255,64907
70517,87,2482,49029,21488,3.39915e+13,943.893,8804,70517,408,480,56046,46737,35308,8613,6191
95475,327,3041,66410,29065,3.54624e+13,1208.52,11899.9,95475,616,580,85401,78105,52202,19463,22514
10963,80,950,7597,3366,3.76051e+13,310.222,2408.03,10963,198,199,8177,6974,5095,2084,2051
96092,1735,3727,67143,28949,3.54809e+13,1307.14,13594.2,96092,591,756,92207,90302,86368,73417,58399
49958,1404,2544,35064,14894,3.6009e+13,666.298,8075.23,49958,635,346,47414,47308,44866,39632,37936
33342,1750,1794,22340,11002,3.45484e+13,544.911,5644.59,33342,289,419,31548,31548,31548,31548,31440
69166,2209,3025,47671,21495,3.36275e+13,938.476,10016.5,69166,559,570,66141,66099,65824,65623,61434
92769,917,3187,65824,26945,3.71534e+13,1389.35,12335.3,92769,786,586,88037,85182,68505,43834,34598
5108,30,738,3473,1635,3.49738e+13,279.574,1636.81,5108,186,236,3220,2458,1943,842,391
19356,281,1495,13235,6121,3.53495e+13,293.386,3836.84,19356,248,247,17652,15005,10884,7925,6838
45911,1352,2578,32165,13746,3.63613e+13,643.139,7717.27,45911,469,329,43333,43090,40737,36437,31654
60533,1401,2401,42563,17970,3.64956e+13,918.212,8563.67,60533,558,402,58132,57548,55112,48833,45502
19915,357,1036,13661,6254,3.51905e+13,327.472,3385.77,19915,287,218,18764,17666,15149,12238,10087
34090,989,2327,24078,10012,3.72222e+13,696.607,6703.08,34090,524,548,31564,31118,28754,25088,18866
34237,260,1988,22985,11252,3.35777e+13,618.84,6232.58,34237,406,395,30164,27689,17566,10183,9036
31109,1501,1661,21342,9767,3.47352e+13,613.984,5203.25,31109,297,329,29448,29437,29400,29329,28578
24687,1091,1627,17086,7601,3.33542e+13,447.509,4576.07,24687,313,288,23060,23003,22794,22357,18237
53833,515,2738,37564,16269,3.42418e+13,786.461,8695.92,53833,548,524,49821,47414,36726,27394,18983
43951,699,2215,31874,12077,3.81305e+13,914.986,7204.09,43951,400,360,41108,39840,36491,28164,15820
88123,758,4367,60882,27241,3.52997e+13,883.883,13630.2,88123,793,585,82639,80922,52069,35323,25345
25281,185,1860,18072,7209,3.67843e+13,479.615,5179.12,25281,365,361,21269,18310,14186,7637,5627
48439,2035,2588,32907,15532,3.52209e+13,558.406,7692.04,48439,439,388,45851,45810,45524,45370,41896
47254,1503,1999,31730,15524,3.47117e+13,916.742,7058.85,47254,404,484,45255,45131,43889,41570,41460
39836,906,2153,27156,12680,3.40423e+13,802.486,6734.47,39836,435,390,37512,36848,30445,24598,23019
51937,627,2694,36530,15407,3.66364e+13,778.327,8514.33,51937,537,460,48141,45415,35796,25062,13667
12763,1059,1107,9051,3712,3.56681e+13,308.184,2877.51,12763,236,210,11656,11654,11647,11651,11588
24598,1046,1635,17582,7016,3.77096e+13,542.275,4808.78,24598,418,326,22963,22661,21895,19883,18607
32817,999,1612,22527,10290,3.44671e+13,527.576,5110.63,32817,327,324,31205,30965,29655,27176,26380
6785,311,774,4616,2169,3.56253e+13,271.76,1873.31,6785,151,189,5855,5258,5277,4939,3748
36422,1871,1925,26267,10155,3.69943e+13,885.431,6270.18,36422,505,332,34497,34497,34446,34448,34430
79312,173,2842,55389,23923,3.55248e+13,903.033,9812.98,79312,633,459,67414,58250,40736,14049,14924
27644,1634,1987,19974,7670,3.67618e+13,473.976,5484.05,27644,437,313,25657,25578,25534,25097,23678
86141,713,3405,59374,26767,3.48756e+13,1023.07,11630.8,86141,627,592,81211,78390,54563,41085,32203
43599,376,2032,30864,12735,3.61132e+13,765.35,6689.12,43599,471,355,39580,37381,26619,19433,13543
64018,766,2349,45772,18246,3.59479e+13,920.677,8638.55,64018,579,443,60702,58819,52428,38605,34089
3642,444,644,2573,1069,3.77582e+13,146.288,1242.12,3642,170,127,2998,2932,2976,2962,2492
82700,2340,2626,58961,23739,3.77213e+13,1035.66,10591.9,82700,634,549,80074,80042,79938,79836,78182
78632,2400,2444,53927,24705,3.1918e+13,854.233,8981.28,78632,574,377,76188,76188,76184,76183,76102
71384,1806,3283,49450,21934,3.49431e+13,942.05,11047.3,71384,541,599,68101,67595,64307,56554,45893
63753,239,1911,44245,19508,3.06155e+13,875.451,7181.08,63753,433,371,58087,55461,34998,13886,16199
45742,1417,2218,32432,13310,3.61869e+13,715.022,7083.13,45742,422,471,43524,43224,42377,41746,33188
38661,450,2640,26479,12182,3.53637e+13,665.652,7642.09,38661,509,578,34929,33345,22158,17619,11951
43515,220,2518,30563,12952,3.40132e+13,563.254,7405.39,43515,390,561,38448,34924,25067,15061,7075
99203,864,3567,68974,30229,3.62829e+13,1125.95,12424.3,99203,759,605,94218,90382,63854,48407,42802
84839,543,2472,59656,25183,3.61923e+13,1056.88,9914.78,84839,557,467,80050,76423,56628,37772,31608
43823,1440,2333,30166,13657,3.60439e+13,582.512,6913.49,43823,396,457,41490,41459,39305,36511,32095
60108,1937,2687,41541,18567,3.59724e+13,1015.25,8750.02,60108,522,505,57421,56922,55660,52918,49645
5228,113,756,3854,1374,3.81781e+13,237.167,1581.52,5228,185,128,4131,3757,3221,2353,1220
64470,2097,3044,44802,19668,3.44177e+13,925.279,10047.7,64470,649,453,61426,61173,59642,56258,53277
76293,2619,2829,54031,22262,3.66681e+13,944.337,10258.4,76293,688,499,73464,73445,73264,73094,71761
56105,152,3032,38560,17545,3.44224e+13,846.246,9465.07,56105,614,499,46379,41058,28602,9684,7872
31296,678,1985,21373,9923,3.40283e+13,535.039,5840.66,31296,445,387,29226,28438,24646,21594,17240
35381,398,2081,24627,10754,3.64094e+13,563.245,5959.11,35381,353,381,32621,31326,22795,17344,8949
44965,1030,2894,30643,14322,3.43888e+13,557.943,8033.17,44965,575,387,42071,41573,28644,22488,15692
45939,1601,2559,32758,13181,3.63836e+13,832.747,7748.34,45939,481,402,43380,42868,41546,37466,34801
38259,1439,2430,27008,11251,3.49992e+13,569.224,7078.31,38259,505,344,35829,35732,32557,26298,23819
41962,29457,41962,0,41962,15.9996,0,41962,41962,41962,1,0,0,0,0,0
40842,1998,3155,28387,12455,3.64732e+13,641.879,8437.81,40842,610,730,37687,37483,36512,34559,30190
84051,1645,3297,58223,25828,3.35212e+13,1062.36,11222.5,84051,582,491,80754,79833,75608,61927,54734
92003,1979,2140,64052,27951,3.21401e+13,963.279,8718.76,92003,594,459,89863,89850,89675,89493,88292
17944,473,1129,12114,5830,3.294e+13,419.151,3310.91,17944,237,250,16600,16139,15241,11606,8269
56290,139,2555,39984,16306,3.64184e+13,963.364,8756.35,56290,603,455,46196,40121,29060,8341,7251
42128,2097,2181,28876,13252,3.54072e+13,593.269,6808.87,42128,337,461,39947,39947,39947,39947,39610
55357,1805,2579,38438,16919,3.26605e+13,846.198,8710.64,55357,437,635,52778,52137,52123,51703,45535
80837,436,2947,57135,23702,3.58669e+13,917.697,10475.5,80837,593,599,74653,71282,46273,20332,19261
6693,257,894,4855,1838,3.58127e+13,207.036,1883.08,6693,215,132,5704,5209,4777,4280,2603
93435,1139,3273,66206,27229,3.73613e+13,1028.91,11844.7,93435,604,552,89844,87958,76069,50486,51791
76374,212,2315,55205,21169,3.71881e+13,951.828,9463.8,76374,528,435,66932,58909,45363,25572,15584
64487,33,2355,46253,18234,3.63989e+13,857.7,8780.1,64487,518,571,42813,33446,27900,9553,5264
70020,1657,2348,47935,22085,3.55756e+13,874.989,8636.37,70020,558,461,67672,67637,66563,63528,63836
34569,131,1764,23525,11044,3.21642e+13,547.304,5860.21,34569,362,311,28876,25760,18074,7883,5372
82868,1890,3502,56986,25882,3.45823e+13,901.983,11986.3,82868,674,594,79366,78882,70495,59152,55915
37746,957,1950,27070,10676,3.65172e+13,871.798,6311.55,37746,447,403,35366,33961,32576,27999,24598
73921,1255,3591,51909,22012,3.64025e+13,1194.62,11849.3,73921,685,711,69780,68336,61842,46108,34203
74441,2931,2989,52586,21855,3.59263e+13,958.614,10524.6,74441,672,467,71452,71451,71438,71416,71178
99300,109,3698,68106,31194,3.38984e+13,1167.55,12759.9,99300,644,605,81354,71425,46978,15734,10593
84375,1950,3528,58960,25415,3.51238e+13,1313.96,12523.6,84375,695,647,80847,79942,76551,66651,57556
41790,1280,2021,29053,12737,3.596e+13,471.727,6353.88,41790,406,534,39769,39686,38410,35949,34646
93799,1617,3195,65408,28391,3.64441e+13,1251.33,11659.7,93799,636,568,90534,89257,81877,64506,59819
91165,2280,3972,62338,28827,3.45831e+13,1253.14,13277.3,91165,648,576,87193,86601,81235,67560,65161
75507,559,2633,52758,22749,3.55871e+13,1117.9,9768.88,75507,590,492,71074,68130,49782,31055,23710
92081,1292,3074,63327,28754,3.15537e+13,1336.47,11500.6,92081,567,587,88266,86723,83100,65685,58827
40156,909,1518,27651,12505,3.5995e+13,530.437,5166.74,40156,335,303,38638,38406,36433,32588,32075
43462,153,1924,31661,11801,3.72427e+13,874.526,6654.24,43462,531,375,36430,31484,25106,9745,6795
51563,1884,2373,35360,16203,3.59006e+13,700.888,7718.01,51563,455,370,49190,48971,48767,48137,44693
75374,2341,3057,52075,23299,3.38186e+13,967.578,10595.7,75374,499,705,72317,72279,71948,70877,65196
32220,1626,1869,22012,10208,3.49949e+13,487.212,5717.5,32220,399,384,30351,30351,30290,30345,29668
3845,264,714,2760,1085,3.89852e+13,171.804,1349.91,3845,204,145,3131,2929,2454,1914,1603
21009,221,1569,14770,6239,3.57829e+13,324.464,4214.85,21009,319,301,18149,15628,11798,5427,3186
5808,420,976,4115,1693,3.5019e+13,178.218,1939.75,5808,207,201,4832,4718,4427,4150,2800
62858,2205,2939,42854,20004,3.51527e+13,803.355,9840.12,62858,559,578,59919,59819,58882,58251,53745
96142,2236,2404,66784,29358,3.43452e+13,1151.86,9524.94,96142,561,437,93738,93713,93511,93370,92346
40491,2346,2571,27602,12889,3.55482e+13,602.501,7540.24,40491,406,618,37920,37920,37827,37892,37175
62184,813,2510,42965,19219,3.4884e+13,879.017,8634.34,62184,548,483,59030,58036,46474,34233,30658
86611,3229,3236,62200,24411,3.71262e+13,1050.87,11936,86611,817,515,83375,83375,83375,83375,83372
77048,728,2958,53399,23649,3.27635e+13,1138.1,10557.9,77048,554,549,72362,70067,60596,40211,30870
79307,2432,3088,55447,23860,3.66355e+13,988.952,10698.6,79307,664,532,76219,75982,75033,73768,71500
7380,606,941,5200,2180,3.68502e+13,279.602,2060.78,7380,203,147,6439,6274,6283,6283,5125
68272,1384,3007,48571,19701,3.6619e+13,777.701,10322.4,68272,562,614,65265,64835,60891,52433,34444
25237,1152,1644,17708,7529,3.61096e+13,474.466,4720.49,25237,387,350,23593,23488,23189,22306,19197
74781,722,3100,51615,23166,3.54337e+13,794.498,10531.8,74781,475,533,71045,68067,50090,34953,31404
36117,1976,2339,25330,10787,3.58594e+13,632.635,6759.96,36117,455,369,33778,33772,33662,33639,31990
8887,657,1006,5998,2889,3.37829e+13,207.896,2281.92,8887,210,206,7881,7788,7622,6940,6893
41977,1508,1653,30644,11333,3.64974e+13,867.63,6165.29,41977,471,344,40324,40097,40069,39852,38308
27396,1400,2118,18583,8813,3.43157e+13,559.094,5828.83,27396,368,390,25278,25230,24350,23492,19242
72241,10764,72241,0,72241,15.9998,0,72241,72241,72241,1,0,0,0,0,0
19215,200,1308,13518,5697,3.53006e+13,441.8,3757.95,19215,256,257,16276,14206,11226,6789,3977
69219,1567,2697,47625,21594,3.27182e+13,949.103,8982,69219,581,377,66522,65803,62137,54239,56169
64501,1938,2313,44873,19628,3.59109e+13,974.341,8566.79,64501,671,480,62188,62140,61101,59810,59536
21360,1707,1853,15068,6292,3.66731e+13,460.658,4830.37,21360,403,315,19507,19504,19473,19505,18972
34739,977,2232,24721,10018,3.70629e+13,703.874,6637.62,34739,510,542,32454,31818,28772,22720,18984
21545,351,1310,14709,6836,3.55713e+13,598.887,4139.48,21545,304,360,19164,17266,15184,11155,10151
83966,2532,3917,57652,26314,3.524e+13,808.696,12825.1,83966,758,565,80049,79983,74106,56858,53873
47006,744,2445,32653,14353,3.56776e+13,656.491,7840.65,47006,417,575,44378,41683,38528,33325,24809
25163,1277,1944,17540,7623,3.64033e+13,491.28,5342.68,25163,475,365,23219,23201,21375,16838,15501
25618,1472,1671,17794,7824,3.3902e+13,532.68,4995.61,25618,364,365,23947,23934,23554,23062,22243
60037,427,2483,42314,17723,3.63388e+13,857.717,8744.94,60037,572,477,54304,49832,35149,23292,16644
68432,427,2681,48120,20312,3.40298e+13,893.667,9704.27,68432,495,546,63135,60064,48612,33717,18342
66778,119,3231,47581,19197,3.74464e+13,995.925,10737.7,66778,495,609,53262,46448,36136,11036,7534
6876,197,356,4561,2315,2.48266e+13,118.329,1113.53,6876,114,108,6520,6492,5995,6075,4091
26590,245,1947,18259,8331,3.23634e+13,511.649,5144.6,26590,341,359,23748,22522,15288,8507,7220
48539,1173,2559,34046,14493,3.74427e+13,788.665,8008.69,48539,464,348,45980,45609,40786,30621,29354
27406,613,1934,18743,8663,3.43042e+13,663.979,5562.02,27406,392,389,25098,24042,19814,15434,13757
71708,3584,3728,50008,21700,3.59058e+13,1032.16,11463.8,71708,617,585,67980,67980,67949,67976,67072
37710,436,1921,26864,10846,3.68992e+13,852.744,6113.15,37710,412,425,34663,33031,27544,20095,14864
3930,412,462,2741,1189,3.32441e+13,245.775,1103.87,3930,157,139,3468,3468,3453,3451,3414
39912,662,2491,28256,11656,3.67683e+13,622.155,7410.79,39912,387,425,37150,36166,33015,25696,16399
96847,3352,3695,67862,28985,3.56734e+13,1259.94,13465.6,96847,680,768,93152,93147,92934,92821,88824
82165,834,4311,56320,25845,3.57624e+13,1300.38,13695.2,82165,667,836,75939,73170,56347,43629,24153
58885,2413,3230,41931,16954,3.63773e+13,918.718,10046,58885,499,565,55655,55599,55264,55049,50524
15493,602,1072,11042,4451,3.7768e+13,505.034,3120.43,15493,328,239,14280,13585,12913,10960,11178
67901,244,2286,47650,20251,3.64595e+13,950.357,8703.54,67901,508,455,59175,54401,36841,17125,15613
74253,2090,3321,51819,22434,3.52252e+13,774.048,11129.1,74253,523,604,70932,70891,70020,68965,53528
8546,526,1026,5850,2696,3.74045e+13,274.698,2426.82,8546,195,328,7520,7317,7057,6665,4708
62454,2538,2592,44535,17919,3.63994e+13,936.306,9116.38,62454,546,540,59862,59862,59854,59857,59801
94813,2746,3137,67561,27252,3.61818e+13,1122.89,11817.4,94813,668,545,91676,91671,91489,91467,89337
70597,974,2848,49121,21476,3.59827e+13,1056.3,10172.3,70597,548,548,67038,65575,56984,42592,32097
13678,899,1336,9445,4233,3.54917e+13,295.721,3368.34,13678,216,309,12342,12341,12141,11862,9150
61165,1134,2067,42071,19094,3.59628e+13,763.551,7835.01,61165,530,410,59098,58738,54583,45113,45611
34280,824,1353,23624,10656,3.62309e+13,874.1,5450.67,34280,399,435,32246,30460,29957,24794,25489
96549,417,3580,67319,29230,3.6154e+13,1134.71,12553,96549,643,556,87788,81939,53722,24601,26723
15378,365,1132,10503,4875,3.43054e+13,416.657,3190.14,15378,238,240,13799,12537,11000,8831,7806
60881,293,2071,43514,17367,3.66364e+13,987.228,7939.44,60881,538,422,53356,47745,35235,22208,14648
72519,2688,2877,51077,21442,3.50757e+13,970.243,10013.9,72519,677,470,69642,69642,69382,69389,68167
53418,920,1539,36311,17107,2.92538e+13,645.01,6077.93,53418,412,413,51786,51364,49013,37649,41587
40556,1775,1979,27470,13086,3.51053e+13,692.639,6317.79,40556,373,414,38577,38575,38429,38264,37951
1360,255,339,923,437,3.79842e+13,66.8419,572.166,1360,78,78,1021,1016,1009,1017,937
36143,1511,1838,25368,10775,3.68781e+13,664.038,5696.36,36143,427,315,34305,34255,34005,33878,32430
65942,776,3234,45908,20034,3.61426e+13,862.084,10348.7,65942,512,581,61927,59613,45715,33058,26488
52574,2387,2977,37332,15242,3.72506e+13,753.939,9150.1,52574,475,595,49597,49554,49302,49273,44928
10794,414,1367,7769,3025,3.97347e+13,290.777,3039.07,10794,219,258,9423,8956,8678,8533,3355
57875,231,2435,40411,17464,3.61371e+13,855.754,8326.91,57875,546,458,50412,45433,30675,11117,9312
39813,2122,2126,27957,11856,3.68373e+13,562.891,6844.87,39813,384,407,37687,37687,37686,37685,37669
23067,1354,1752,16015,7052,3.39201e+13,543.056,4843.34,23067,277,320,21315,21077,21160,20958,17168
89889,759,3362,61786,28103,3.358e+13,1017.54,12051.6,89889,569,699,85445,83670,64216,53322,30332
8518,212,697,5875,2643,2.78398e+13,148.327,1726.71,8518,149,129,7798,7605,6273,4475,2395
52803,1477,2877,37196,15607,3.67672e+13,765.727,8905.42,52803,572,376,49926,49543,45608,35477,36051
86020,904,3295,61526,24494,3.70078e+13,922.912,12039.5,86020,738,456,82032,80191,60786,42112,36286
49896,61,1916,33779,16117,3.47708e+13,461.579,6531.15,49896,409,337,36133,30493,22125,9252,4251
48116,1660,2487,33707,14409,3.49337e+13,626.126,7863.51,48116,362,423,45629,45593,45234,44913,37073
68174,1460,2897,46941,21233,3.55262e+13,1009.8,9773.21,68174,629,615,65266,64371,60905,53381,43437
28480,1878,1881,19649,8831,3.44992e+13,548.585,5387.15,28480,342,410,26599,26599,26599,26599,26593
35008,1122,2384,24007,11001,3.41437e+13,464.91,6454.4,35008,429,354,32624,32352,29884,22640,21455
71139,3199,3494,50651,20488,3.67267e+13,992.803,11619.5,71139,641,661,67645,67639,67492,67579,66115
4575,240,573,3060,1515,3.13192e+13,117.015,1308.74,4575,121,153,4002,3897,3756,3824,2383
16790,510,1376,11849,4941,3.56183e+13,472.093,3734.04,16790,302,290,15084,14661,13719,10908,6924
10114,442,1058,6936,3178,3.33863e+13,251.321,2622.65,10114,168,250,9056,8808,8540,8387,5020
43770,2089,2285,30392,13378,3.58241e+13,718.977,7464.81,43770,395,500,41485,41482,41428,41426,40737
19442,1245,1533,13392,6050,3.32611e+13,385.334,4099.08,19442,236,301,17909,17905,17845,17863,17233
98843,438,3042,68455,30388,3.46653e+13,1261.03,11865.2,98843,560,514,92321,88356,61683,36793,28166
25004,967,1674,17242,7762,3.59265e+13,563.375,4751.96,25004,347,329,23330,23063,22154,20428,19572
36595,28,1502,25913,10682,3.6062e+13,751.404,5227.41,36595,388,340,23413,17832,15176,5953,2865
59439,1462,2317,41591,17848,3.61803e+13,777.433,8391.95,59439,504,400,57122,56909,54807,50822,46280
32167,1411,2382,22977,9190,3.69226e+13,623.31,6618.2,32167,438,512,29785,29490,28367,27749,21061
84016,1618,3308,58974,25042,3.51744e+13,995.221,11736.2,84016,749,573,80708,79945,74840,62261,53463
66973,2395,2529,46721,20252,3.43985e+13,835.999,8890.67,66973,579,458,64444,64443,64420,64438,64159
97634,174,3513,69332,28302,3.51382e+13,1173.62,13003.2,97634,663,628,84230,75523,53180,11478,11721
86872,3209,3213,59394,27478,3.41273e+13,977.125,11572.1,86872,504,573,83659,83659,83657,83659,83659
46136,55,2267,31639,14497,3.54117e+13,711.287,7382.1,46136,545,542,32913,26932,20018,8456,4664
50434,1046,1694,34934,15500,3.57179e+13,775.192,6131.88,50434,468,352,48740,48021,45041,39571,41304
54555,1889,2410,38655,15900,3.54279e+13,883.404,8110.8,54555,472,431,52145,52122,51330,50218,46378
96604,3928,3993,67063,29541,3.46309e+13,1205.41,13798.3,96604,713,766,92611,92611,92576,92592,92561
55238,2184,2605,38802,16436,3.6447e+13,810.183,8286.26,55238,569,454,52633,52588,52456,52460,50523
34929,76,2101,23809,11120,3.41729e+13,559.77,6375.68,34929,291,404,27126,22962,15501,4928,3587
8351,779,939,5683,2668,3.5886e+13,260.645,2302.24,8351,183,283,7412,7412,7388,7410,6990
37940,1315,1489,27037,10903,3.71107e+13,800.782,5587.74,37940,427,425,36451,36449,36367,36114,35167
92400,2606,3001,63782,28618,3.40947e+13,1116.46,11635.4,92400,479,568,89399,89386,89248,89329,87518
52814,1934,2239,36358,16456,3.55715e+13,805.518,7702.09,52814,433,425,50575,50533,50490,50335,48941
45878,747,2488,32979,12899,3.71131e+13,677.354,7992.35,45878,490,580,43222,42118,39545,37093,20221
14383,770,1280,10074,4309,3.61721e+13,400.498,3254.79,14383,293,234,13103,12972,12798,12462,11073
31850,474,1715,22054,9796,3.54464e+13,605.475,5484.17,31850,386,368,29364,27983,23440,16653,13574
24459,397,1428,17424,7035,3.73241e+13,590.465,4408.06,24459,405,342,22045,20699,17842,13220,7910
8375,225,1060,5724,2651,3.40045e+13,252.357,2405.85,8375,291,169,6994,6215,4768,3443,2212
70491,1883,2949,48741,21750,3.25611e+13,922.544,9767.57,70491,490,571,67542,67160,65975,64367,57127
43716,243,2086,31064,12652,3.68014e+13,685.445,6653.09,43716,478,433,38589,33752,25819,12444,10459
81237,3348,4093,56840,24397,3.58212e+13,1128.55,12946.8,81237,806,824,77144,77008,76438,74844,72322
27820,886,2129,19351,8469,3.33174e+13,511.599,6000.79,27820,412,386,25691,25081,24232,21721,16568
44496,562,1898,31437,13059,3.66979e+13,680.032,6403.95,44496,511,375,41564,38223,31240,22200,21421
70847,1260,2497,49285,21562,3.42787e+13,913.856,8951.88,70847,541,427,68341,67521,61349,46183,47333
38790,150,2412,26941,11849,3.59716e+13,664.416,7208.85,38790,485,523,31751,28126,19991,6378,4314
23176,1260,1495,16435,6741,3.65098e+13,545.258,4483.25,23176,335,293,21681,21662,21418,20777,20231
62952,2197,2744,44883,18069,3.63944e+13,767.923,9413.56,62952,620,467,60208,60170,58622,56136,55055
71450,2361,2780,50595,20855,3.66417e+13,953.372,9361.51,71450,522,447,68670,68606,68512,68311,66766
16966,444,1057,12080,4886,3.6504e+13,435.159,3158.63,16966,256,247,15681,15059,14059,12305,10745
54410,1635,2597,36790,17620,3.52604e+13,813.067,8394.72,54410,508,637,51813,51451,48690,42612,43785
67890,994,3074,46914,20976,3.5066e+13,1000.68,10293.5,67890,640,518,64288,62517,54357,36748,32426
34928,1197,2154,24796,10132,3.70171e+13,704.234,6370.98,34928,599,349,32774,32028,30932,26852,24880
71150,940,2607,50347,20803,3.67046e+13,939.72,9409.67,71150,543,405,67955,66430,60360,45571,36931
53961,258,2487,37237,16724,3.62883e+13,632.437,7675.18,53961,496,421,47508,41061,29480,15110,10402
18757,1559,1720,12877,5880,3.54127e+13,399.474,4405.45,18757,295,373,17037,17026,17003,17024,16286
98435,1924,4566,67894,30541,3.48989e+13,1035.16,14980.7,98435,752,735,93869,93136,77388,55535,49437
30754,1023,1597,20930,9824,3.23996e+13,483.045,5252.88,30754,339,288,29157,29116,27982,24817,23060
40110,1051,1852,27459,12651,3.52479e+13,658.552,6222.11,40110,369,467,38258,37907,36411,34201,25847
57673,661,2610,39243,18430,3.51377e+13,859.483,8814.52,57673,471,575,53874,51697,36543,29500,25334
68597,1309,3440,48006,20591,3.67542e+13,1115.67,10987.5,68597,576,624,64818,63586,59037,49565,43172
10103,477,1299,7179,2924,3.71041e+13,314.616,2896.95,10103,250,292,8804,8398,8219,7799,4619
86256,2868,3330,60297,25959,3.53402e+13,1112.55,11960.9,86256,786,513,82926,82918,82393,82171,78134
28233,756,1858,20169,8064,3.4313e+13,515.964,5330.28,28233,342,311,26311,25566,24608,23282,17179
15473,1168,1329,10296,5177,3.30227e+13,359.093,3342.34,15473,274,246,14144,14143,13998,13800,13688
22259,612,1725,15408,6851,3.05357e+13,330.315,4564.01,22259,256,329,20534,20118,19505,18132,12093
32740,1792,1854,22259,10481,3.56561e+13,474.189,5440.6,32740,351,320,30886,30886,30863,30882,30853
29289,1266,1817,19879,9410,3.41228e+13,609.145,5307.49,29289,397,387,27472,27271,26752,25688,23903
16460,559,1414,11506,4954,3.57358e+13,326.554,3725.47,16460,249,320,15046,14742,13916,12870,10106
25114,895,1273,17168,7946,3.62171e+13,441.159,4031.86,25114,323,338,23841,23758,22531,20355,20444
46072,2155,2727,32057,14015,3.56299e+13,823.345,8011.43,46072,468,500,43345,43283,42877,42493,39401
14278,460,1233,10009,4269,3.58002e+13,335.98,3183.12,14278,250,262,13026,12565,11317,8710,7191
24457,256,2011,16870,7587,3.53533e+13,349.904,5245.83,24457,410,240,21551,19449,14181,8229,7312
71968,71,3524,50064,21904,3.56791e+13,975.021,11355,71968,487,641,54630,47212,33118,12433,5739
44616,1008,1696,30263,14353,3.54134e+13,438.896,5821.2,44616,426,339,42920,42886,40573,36840,35870
68432,1628,2546,47033,21399,3.39151e+13,812.717,9040.97,68432,501,497,65886,65778,64399,62605,57280
70513,1708,3192,48662,21851,3.46006e+13,762.122,9957.51,70513,511,443,67321,66914,60963,46444,45113
45229,674,2788,31527,13702,3.4942e+13,683.856,8438.85,45229,366,501,41741,40272,35885,26740,14631
28500,131,1654,19473,9027,3.49336e+13,630.949,5275.92,28500,370,435,23275,20509,14651,5249,3780
81123,1439,2865,57338,23785,3.45537e+13,1259.95,10475.1,81123,667,604,78001,76766,73533,64337,52310
8655,406,1283,6185,2470,3.84636e+13,234.778,2678.11,8655,239,264,7372,7099,6755,5633,3033
90683,1067,4056,61794,28889,3.44349e+13,1011.37,13596.3,90683,600,632,86261,84518,64592,48273,36014
75436,519,2647,52410,23026,3.45045e+13,1000.36,9929.01,75436,628,464,70659,67879,49125,34741,26459
16909,913,1166,12075,4834,3.68608e+13,452.578,3260.63,16909,289,263,15743,15558,15520,15501,14424
82921,584,2221,57465,25456,3.25157e+13,1128.14,8961.37,82921,604,504,78308,74484,58245,44167,35066
36967,894,1970,25257,11710,3.57813e+13,459.316,5822.26,36967,399,325,34997,34816,29783,23215,23349
94143,1717,2974,65373,28770,3.4687e+13,1117.11,11617.7,94143,730,509,91169,90250,86878,75776,70762
45938,2534,2539,32169,13769,3.61134e+13,700.871,7938.98,45938,469,468,43399,43399,43399,43399,43395
54102,2304,2787,38188,15914,3.64619e+13,974.175,9081.75,54102,665,459,51315,51174,50506,49736,48365
17415,761,1364,12190,5225,3.6946e+13,503.292,3825.37,17415,294,268,15976,15244,14824,14156,10639
93397,387,3424,65591,27806,3.59988e+13,1147.5,12295,93397,675,667,84660,77510,54630,27524,20503
3559,335,728,2653,906,3.85178e+13,97.7002,1293.66,3559,166,123,2831,2783,2727,2747,1505
20162,735,1238,14434,5728,3.77512e+13,623.99,3833.53,20162,396,271,18772,17561,16835,14068,14295
62314,528,2694,43533,18781,3.61281e+13,1055.97,9160.25,62314,617,465,57557,54850,40742,29686,18977
74519,1477,3238,50605,23914,3.53109e+13,843.969,10635.3,74519,584,630,71281,70757,66319,59513,54412
66673,764,3187,45393,21280,3.46276e+13,893.668,10181.9,66673,571,672,62816,61297,43556,38342,26489
46276,1827,2006,31725,14551,3.26379e+13,770.401,6771.83,46276,443,361,44270,44267,44208,44173,43065
68737,985,3229,47989,20748,3.69658e+13,947.75,10424.6,68737,517,625,65133,63771,51684,34657,31356
71861,404,2052,50597,21264,3.25773e+13,1124.13,8211.64,71861,533,419,66952,64472,51368,37355,19824
98974,2746,3695,67791,31183,3.35773e+13,977.528,12398.3,98974,647,651,95279,95133,93105,89419,87203
86492,3866,4465,60805,25687,3.70791e+13,1025.27,14264.6,86492,749,1097,82027,82023,81763,81747,78765
70758,1349,2297,48858,21900,3.3445e+13,985.862,8713.78,70758,427,496,68461,67308,65875,61861,47972
71569,719,3048,49431,22138,3.36413e+13,1111.32,10778.9,71569,640,579,67052,64562,50651,39539,25070
22612,572,1564,16309,6303,3.61074e+13,528.545,4492.22,22612,318,271,20768,19920,18014,12931,10403
53411,2442,2674,36812,16599,3.4537e+13,921.71,8412.05,53411,455,476,50737,50715,50667,50699,49791
67745,1356,2923,47020,20725,3.4918e+13,1081.97,9901.85,67745,489,599,64591,63568,59865,50823,36697
15286,89,1326,10712,4574,3.40526e+13,261.85,3375.76,15286,250,274,12297,10422,7269,1713,1608
16505,278,1998,11360,5145,3.55702e+13,393.744,4504.81,16505,345,411,14126,13176,10375,5682,4014
6440,609,656,4371,2069,3.6247e+13,277.275,1713.76,6440,160,219,5784,5784,5769,5775,5674
49107,731,2972,34484,14623,3.57614e+13,824.246,9178.55,49107,434,604,45425,43397,35628,26325,19119
34680,619,1761,24564,10116,3.71287e+13,596.983,5594.54,34680,330,402,32709,31655,28324,20609,17790
6363,180,538,4629,1734,3.68979e+13,271.629,1457.44,6363,168,142,5386,4863,4642,4408,2916
73493,1774,2780,51171,22322,3.56782e+13,772.52,10276.8,73493,477,579,70713,70628,69687,68720,55579
4234,231,613,2867,1367,3.41082e+13,232.459,1334.45,4234,156,148,3535,3319,3071,2687,1963
27102,468,1472,19327,7775,3.75187e+13,719.841,4806.81,27102,342,320,24479,22952,21266,14713,12038
88683,2005,3081,60746,27937,3.4926e+13,1019.79,10936.3,88683,583,492,85602,85448,83628,77885,77246
80116,2247,3222,56405,23711,3.50209e+13,1079.29,11322,80116,624,534,76894,76601,75621,73620,64553
60767,1056,2620,42972,17795,3.64032e+13,856.971,9081.44,60767,482,524,57967,56840,52817,43444,27916
77068,2006,2617,53663,23405,3.40938e+13,837.95,9809.22,77068,612,431,74451,74418,72964,69981,62974
60371,1027,2700,41689,18682,3.47172e+13,1112.3,9271,60371,554,556,56867,55419,47061,36676,31904
2101,23,521,1559,542,3.14191e+13,64.6811,874.865,2101,153,76,1280,1014,715,538,200
32590,531,1909,22973,9617,3.67664e+13,725.16,5809.19,32590,446,408,30099,29215,24024,18767,12156
91788,1744,2905,64896,26892,3.6835e+13,1031.96,11143.5,91788,735,493,88883,88252,83358,74318,63396
90336,1770,3066,61584,28752,3.52855e+13,1132.06,10665.6,90336,569,527,87270,86473,80207,67518,68363
86850,196,3055,60279,26571,3.5237e+13,1109.44,11457.9,86850,619,634,74499,65715,45791,13259,13511
54541,967,2996,37204,17337,3.49425e+13,815.62,9151.83,54541,591,539,51356,50598,44319,36352,27572
1261,135,305,900,361,3.71719e+13,83.8549,519.467,1261,76,75,956,857,821,798,575
77477,1530,2826,52694,24783,3.42259e+13,1091.25,10055.2,77477,546,557,74651,73792,68525,56166,53853
1485,283,372,1093,392,3.66813e+13,63.437,622.046,1485,89,72,1113,1108,1113,1104,956
71537,1088,2749,49195,22342,3.36647e+13,739.793,9725.02,71537,392,500,68724,67651,64543,60146,43487
63629,2519,2690,44035,19594,3.50611e+13,836.949,9124.39,63629,585,455,60939,60939,60850,60823,60189
75124,2610,2918,52941,22183,3.55591e+13,1242.42,10868.1,75124,643,596,72206,71900,71740,71258,67287
4876,468,728,3669,1207,3.18099e+13,213.95,1507.1,4876,202,119,4148,4123,4102,3818,3737
38356,920,2312,26619,11737,3.39947e+13,722.923,6819,38356,341,459,35792,34762,33440,31247,20817
63468,789,2708,45303,18165,3.70011e+13,1002.52,9385.12,63468,547,470,59780,57861,52427,38323,27300
80156,2509,2553,54976,25180,3.27796e+13,1071.42,9900.15,80156,535,546,77603,77603,77594,77596,77452
64097,1097,1715,43979,20118,3.04912e+13,843.649,6960.89,64097,444,370,62373,61489,58497,52207,45127
70998,1818,2769,50807,20191,3.65791e+13,1047.49,9850.47,70998,667,525,68229,67890,65771,60741,58158
78693,503,3565,54108,24585,3.4125e+13,1030.5,11743.6,78693,538,604,72745,68576,44215,30277,16337
50887,2441,3252,35861,15026,3.7094e+13,664.244,9467.33,50887,679,385,47635,47598,46578,41322,41330
15374,99,1264,10768,4606,3.64113e+13,380.587,3325.1,15374,250,274,11846,10004,7865,3928,1338
12322,357,1448,8787,3535,3.73638e+13,270.638,3361.67,12322,267,273,10845,10162,9051,7350,4471
21798,645,1604,14914,6884,3.54625e+13,489.915,4545.28,21798,357,284,20079,19737,17429,14157,12031
29237,960,1712,20418,8819,3.21418e+13,577.325,5192.3,29237,377,285,27525,26936,25884,23747,17262
96521,466,3308,67096,29425,3.50618e+13,1138.43,12081.3,96521,639,543,90003,85402,57398,31686,26511
99992,1190,2904,70122,29870,3.70802e+13,967.702,11242.4,99992,683,565,96992,95582,79030,59950,64174
24776,1560,1884,17139,7637,3.24018e+13,441.731,5010.26,24776,370,340,22892,22880,22631,22516,21928
43264,1404,1713,29958,13306,3.5311e+13,426.65,5753.36,43264,362,298,41551,41546,41450,41440,38800
93573,2652,3302,65148,28425,3.60821e+13,1077.81,11885.3,93573,665,518,90271,90199,89650,87231,82743
22467,87,1676,15397,7070,3.59544e+13,413.225,4630.11,22467,361,287,16814,14530,9831,3969,2962
68709,3224,3645,46846,21863,3.40994e+13,639.603,10996.9,68709,688,443,65064,65064,64897,64901,62551
96517,614,3289,65691,30826,3.40225e+13,785.638,11001.2,96517,582,540,92308,90676,62049,42397,38848
15401,66,1632,10725,4676,3.3724e+13,381.671,3843.3,15401,309,277,11402,9250,6844,2008,1573
31959,276,2120,22135,9824,3.29477e+13,477.542,6109.57,31959,433,429,28684,26974,18241,11538,5335
47040,2478,2580,32339,14701,3.38561e+13,678.525,7710.88,47040,389,481,44460,44460,44437,44458,44175
39638,1196,2026,27161,12477,3.58916e+13,559.261,6465.08,39638,393,393,37612,37556,35113,30788,26634
15549,699,1476,10660,4889,3.22327e+13,240.158,3620.06,15549,253,197,14073,13932,12935,8844,7477
61890,41,2310,42609,19281,3.37528e+13,554.574,8133.24,61890,422,440,42431,32892,26303,9027,5750
99313,2685,3900,68007,31306,3.40559e+13,995.131,13525.6,99313,533,752,95413,95389,94783,93927,82161
20106,1604,1665,13699,6407,3.35302e+13,640.877,4542.02,20106,362,443,18441,18440,18406,18361,18239
96488,896,3716,66810,29678,3.48939e+13,1078.8,13182.5,96488,656,617,91670,89289,70044,50362,38569
39779,753,2378,28304,11475,3.76445e+13,793.672,7124,39779,525,379,36999,35171,31393,23449,20831
84288,672,2784,60573,23715,3.74004e+13,878.921,10410.6,84288,596,498,79864,75398,56271,37101,33594
6014,521,664,4072,1942,3.56463e+13,307.251,1646.95,6014,157,201,5350,5151,5227,5221,4728
68055,2933,3269,47453,20602,3.52366e+13,833.128,10521.3,68055,617,533,64786,64777,64654,64569,62597
45366,277,2264,32081,13285,3.56258e+13,639.103,7466.8,45366,505,395,40278,35624,25633,8965,8220
44977,1461,2258,32096,12881,3.37873e+13,771.871,7266.06,44977,539,370,42719,42409,40252,35518,35426
75201,2193,4012,51050,24151,3.49395e+13,1022.75,12267.3,75201,599,877,71189,70846,67066,60386,44994
33477,670,1429,23890,9587,3.62571e+13,642.676,4892.24,33477,394,331,31754,30676,29012,26378,23224
14527,548,1302,10059,4468,3.51716e+13,330.771,3337.95,14527,289,298,13225,12860,12205,10353,7393
32204,1458,2009,22154,10050,3.31993e+13,450.292,5485.58,32204,387,303,30195,30180,28880,26304,27034
88269,2093,2391,62224,26045,3.65522e+13,1019.07,9374.62,88269,504,457,85878,85716,85682,85573,84027
84128,2112,2385,57762,26366,3.46404e+13,700.146,9332.12,84128,565,421,81743,81735,81059,80965,77561
51178,1158,2116,36469,14709,3.65087e+13,770.574,7369.6,51178,434,430,49062,48611,45946,41441,35617
18027,252,1273,12567,5460,3.71181e+13,482.519,3626.21,18027,310,263,15725,14084,11532,8693,6210
26732,909,1675,18567,8165,3.54923e+13,601.984,5045.25,26732,423,395,25057,24641,23011,20533,18740
43284,380,2260,30402,12882,3.49559e+13,939.326,7305.73,43284,400,437,38991,36517,30481,20185,14099
61570,2085,2464,42741,18829,3.59577e+13,1096.69,8452.07,61570,491,453,59106,59096,58669,58112,55945
72743,2117,2733,50445,22298,3.41596e+13,981.89,9836.01,72743,520,591,70010,69995,69624,69126,64190
81250,1551,2864,55982,25268,3.55039e+13,937.019,9646.16,81250,478,465,78386,77829,72076,60270,58125
87218,411,4244,59064,28154,3.3862e+13,871.733,13287.2,87218,845,602,79592,74743,41407,17911,18925
19971,1352,1624,13821,6150,3.59743e+13,561.121,4351.69,19971,350,319,18347,18310,18160,17884,17345
71351,251,3276,49654,21697,3.46717e+13,942.186,10858.8,71351,694,652,62622,55813,38355,16217,11015
71776,219,2216,50191,21585,3.3175e+13,806.321,8951.45,71776,586,362,63633,57949,38536,17034,13996
50505,1665,2331,35638,14867,3.59188e+13,954.446,7701.03,50505,511,479,48174,47814,46671,44141,41518
97304,423,2416,69021,28283,3.65421e+13,1266.96,10770.9,97304,675,546,88839,84513,60220,36601,28880
56757,724,2566,39518,17239,3.59489e+13,972.583,8883.81,56757,603,424,52936,50609,38002,27049,22956
84159,1926,2456,61601,22558,3.64324e+13,1062.4,10248.6,84159,736,520,81703,81673,80041,76636,73868
27599,53,2354,19410,8189,3.61576e+13,459.236,6210.64,27599,335,421,20180,16492,11962,4825,2392
77019,1227,2900,52566,24453,3.60359e+13,692.225,9506.54,77019,510,547,74119,73957,64956,50223,42783
87618,555,2948,60692,26926,3.27434e+13,1026.39,10912.3,87618,666,632,83018,80394,58283,46544,29130
41170,580,1880,28761,12409,3.59817e+13,711.905,6301.53,41170,441,356,38507,36928,31294,20081,17343
86217,644,2934,60277,25940,3.46695e+13,1273.11,10722.8,86217,660,514,80765,77800,53951,36238,28681
64410,942,2571,46320,18090,3.72e+13,1287.42,9337.05,64410,605,462,60673,59041,53175,36387,32580
81805,493,2468,56021,25784,3.51903e+13,815.655,9049,81805,499,453,78134,75940,53305,32587,31755
52553,2096,2409,37447,15106,3.67582e+13,1009.67,8229.14,52553,541,456,50144,50143,49680,49097,48534
73975,314,2783,52058,21917,3.50337e+13,975.725,10161.2,73975,621,434,66376,60680,42039,16461,16800
36403,600,2201,25119,11284,3.60529e+13,763.776,6736.01,36403,472,369,33180,31673,20080,16565,11889
58270,2239,2794,39521,18749,3.31068e+13,787.989,8883.62,58270,509,415,55476,55469,54729,53146,52490
1534,147,313,1161,373,4.05525e+13,71.6121,561.375,1534,114,60,1221,1149,1152,1138,761
96879,1183,2401,69640,27239,3.68362e+13,1090.7,10492.5,96879,583,509,94255,92934,85347,69804,60769
67179,1433,2828,47312,19867,3.61068e+13,992.694,9518.24,67179,574,401,64351,63433,59449,51157,46632
28575,1042,1862,20828,7747,3.69572e+13,643.383,5530.84,28575,423,312,26713,26128,25282,23796,17698
98598,2148,2975,68789,29809,3.72056e+13,919.303,10787.5,98598,596,476,95623,95609,92626,87488,87674
56712,2070,2202,40459,16253,3.61692e+13,848.449,7855.9,56712,560,410,54510,54507,54406,54394,53765
79321,1868,3407,55666,23655,3.64781e+13,1227.85,11331.6,79321,665,720,75914,75155,72258,65856,54262
69868,688,2056,49573,20295,3.58979e+13,839.877,8430.38,69868,622,392,66751,64503,59893,45339,36797
40213,945,2095,27690,12523,3.57273e+13,502.069,6436.89,40213,406,465,38118,37915,34076,27772,22678
2215,243,474,1613,602,4.13055e+13,105.84,809.25,2215,145,78,1741,1671,1661,1668,1285
58165,1682,3094,39947,18218,3.50751e+13,729.509,9710.65,58165,567,443,55071,54903,50544,41487,39102
96768,973,4688,66979,29789,3.63998e+13,836.561,14487.9,96768,823,641,91675,90152,64417,46831,36713
63230,722,2324,44329,18901,3.65788e+13,968.76,8705.05,63230,610,443,59668,57152,48515,32224,29365
74046,422,2928,52237,21809,3.65705e+13,1135.09,10410.7,74046,655,583,67709,63929,46601,31643,13683
43583,729,2053,31052,12531,3.67078e+13,793.206,6871.5,43583,488,400,41088,39663,35744,25925,21997
60036,198,2848,42238,17798,3.68835e+13,930.63,9260.02,60036,606,515,50672,44727,31900,11134,8459
68477,1557,2279,47956,20521,3.39373e+13,1009.46,8817.6,68477,577,460,66198,65728,63504,57041,56590
92085,2675,3574,64026,28059,3.60361e+13,1013.36,11789.3,92085,726,534,88511,88481,85812,81490,71651
37070,1193,1931,26188,10882,3.70144e+13,594.296,5957.79,37070,443,298,35139,34964,34331,32767,30647
40293,222,2013,27498,12795,3.32228e+13,397.251,6211.6,40293,396,327,35727,31220,22916,12039,9301
66585,2286,2873,46991,19594,3.63813e+13,846.425,9781.14,66585,503,520,63712,63647,63534,63029,59628
78488,557,2879,55682,22806,3.67775e+13,850.368,10783.4,78488,685,422,73727,69309,53592,40908,28920
18260,1530,1638,13200,5060,3.71712e+13,370.09,4167.89,18260,435,231,16622,16622,16586,16574,16353
74451,417,2734,51711,22740,3.56749e+13,1027.38,9998.08,74451,549,479,68680,65713,40982,27526,16916
59113,2646,2862,41222,17891,3.53829e+13,968.422,9359.03,59113,486,546,56251,56249,56212,56133,54936
64667,818,2952,45378,19289,3.56018e+13,1048.64,10001.2,64667,625,531,60673,57969,47901,33909,28248
90682,2698,3295,64099,26583,3.65388e+13,1203.66,11750.7,90682,661,510,87387,87160,86653,85184,82505
87715,1132,2601,61553,26162,3.32294e+13,1029.58,10173.2,87715,617,484,84920,82935,74472,44996,39323
6915,277,1114,5010,1905,3.86766e+13,205.593,2240.71,6915,186,244,5759,5357,5207,5274,1844
14260,106,994,9505,4755,3.37682e+13,441.407,2908.73,14260,252,257,11166,9369,6048,3018,2671
84885,2209,3130,59397,25488,3.54827e+13,1339.32,11454.4,84885,727,622,81755,81086,77848,67945,70328
35127,1722,2555,24787,10340,3.67848e+13,540.726,7141.29,35127,547,365,32572,32504,31015,26363,25523
20645,840,1954,14163,6482,3.60752e+13,345.642,5034.54,20645,271,534,18691,18645,18085,17356,8554
34480,1101,1962,24106,10374,3.6623e+13,692.485,6019.62,34480,440,431,32518,31806,30260,27112,24439
51883,1592,1801,35693,16190,3.47814e+13,604.802,6723.7,51883,380,417,50082,50081,50037,50034,49038
51354,1242,2750,35997,15357,3.52251e+13,805.259,8749.27,51354,524,441,48604,47585,43897,36316,30328
63188,2540,2703,42898,20290,3.48702e+13,999.004,9495.25,63188,478,548,60485,60485,60375,60384,59708
37851,1023,1714,26287,11564,3.65577e+13,851.717,6064.93,37851,444,368,35863,34919,33949,29521,28385
61703,635,2771,43640,18063,3.61718e+13,1035.01,9170.06,61703,571,548,57557,55435,43047,31743,23058
78167,1621,2819,55462,22705,3.70216e+13,1059.38,10291.3,78167,782,412,75348,75001,69758,58163,57410
69540,2179,2496,48192,21348,3.40672e+13,967.368,9273.99,69540,564,452,67044,67044,66802,66739,64677
16976,698,1156,11895,5081,3.53178e+13,499.98,3393.17,16976,318,264,15820,15344,15223,14883,13078
82088,529,3467,58013,24075,3.65626e+13,1243.51,11790.1,82088,637,544,75969,72748,50989,30912,22664
71951,2069,3135,49906,22045,3.45626e+13,919.969,10331.6,71951,568,521,68816,68480,66669,60781,58347
56845,1197,2279,39458,17387,3.56086e+13,556.207,7254.12,56845,492,315,54566,54357,48514,33310,30037
22839,639,1051,15586,7253,3.62075e+13,345.851,3215.42,22839,247,233,21788,21711,19911,17218,18579
99969,2881,4060,68830,31139,3.59374e+13,916.396,13958.4,99969,576,769,95909,95885,95130,94258,82482
91545,1169,3281,62974,28571,3.28713e+13,873.9,11682.3,91545,649,540,88088,86822,70272,54396,53606
16909,1024,1401,12105,4804,3.81328e+13,390.673,3548.66,16909,344,225,15508,15476,15254,15208,13915
21953,340,1665,15101,6852,3.47975e+13,468.012,4730.78,21953,357,421,19602,18085,16037,14102,5683
60940,1621,2603,42883,18057,3.70357e+13,1100.69,8804.86,60940,567,521,58337,57533,55964,52082,46040
53555,1226,2808,37602,15953,3.80767e+13,736.492,8905.28,53555,621,556,50747,50229,45518,37002,35594
28463,984,2084,19881,8582,3.38842e+13,589.911,5613.46,28463,408,335,26379,25868,23114,15042,11355
28525,878,1845,20436,8089,3.68224e+13,562.364,5525.89,28525,362,373,26680,25849,25344,24137,17492
34858,60,2174,24126,10732,3.4604e+13,691.466,6433.83,34858,387,401,26455,22313,15602,4866,3028
91896,171,3096,64269,27627,3.69215e+13,1197.65,11465.7,91896,644,619,76556,67100,48294,12799,10524
72598,868,2966,50355,22243,3.5478e+13,793.641,9719.7,72598,525,475,69269,68321,56503,41521,37405
56853,1265,2537,39393,17460,3.33661e+13,867.966,8686.34,56853,498,568,54144,53278,51182,43968,35391
11425,545,1185,7838,3587,3.56094e+13,326.714,2979.56,11425,220,246,10240,9950,9087,7654,5441
58079,993,2386,41049,17030,3.61532e+13,1262.07,8625.17,58079,553,610,54652,52823,43765,30578,31323
61973,2060,2063,44757,17216,3.70206e+13,912.659,8126.94,61973,504,467,59910,59910,59910,59910,59901
10888,781,1196,7594,3294,3.59739e+13,299.907,2802.89,10888,273,175,9692,9642,9484,9444,8027
32788,869,1596,22781,10007,3.58841e+13,526.336,4869.15,32788,335,299,31192,30944,30032,27054,25885
62776,544,2789,43890,18886,3.48221e+13,1035.03,9674.96,62776,512,661,58462,55997,47120,36091,17859
55312,1641,1891,39254,16058,3.53944e+13,749.749,6958.92,55312,417,362,53421,53412,52796,51719,51049
36657,783,2206,25642,11015,3.5508e+13,511.436,6625.11,36657,405,335,34445,33957,30537,23711,19545
78107,187,2381,55809,22298,3.47148e+13,1019.68,9774.98,78107,526,481,68701,62515,43864,13288,10597
26675,1091,1396,18844,7831,3.61044e+13,565.233,4621.33,26675,353,315,25279,25269,24747,23853,22455
73963,1560,3326,51111,22852,3.54681e+13,885.622,11065.6,73963,621,529,70637,70112,58067,46067,45656
60487,200,2745,42931,17556,3.72228e+13,921.373,9322.48,60487,659,464,51809,45261,32451,13716,9879
85991,1932,3344,59680,26311,3.42528e+13,1008.71,12069.8,85991,457,702,82647,81950,81536,80296,61455
53397,1145,2255,37884,15513,3.66979e+13,1158.6,7682.04,53397,559,495,50634,49040,45490,38994,33457
22077,31,1549,15279,6798,3.65197e+13,493.381,4388.14,22077,390,306,14395,11293,8957,4342,2247
76695,662,2762,54571,22124,3.67066e+13,896.763,9938.98,76695,609,435,72555,69571,48525,31850,25443
79472,587,2154,55839,23633,3.36686e+13,919.949,8967.32,79472,531,486,75712,72841,62792,45621,30507
40668,1573,2509,27745,12923,3.56225e+13,509.901,7060.62,40668,419,325,38159,38108,36331,33421,30642
64971,472,2694,44557,20414,3.1585e+13,953.234,9219.16,64971,493,493,60513,58363,48643,38328,19021
54864,1532,2908,38357,16507,3.57204e+13,833.121,8800.38,54864,630,446,51956,51362,47924,39300,39716
66329,1407,2785,45444,20885,3.47939e+13,1003.25,9899.14,66329,629,504,63513,62957,58399,49185,43605
20896,884,1526,14329,6567,3.48224e+13,648.657,4345.81,20896,340,317,19314,18582,18114,16378,13373
93197,2333,3590,65485,27712,3.68669e+13,1004.84,12417.3,93197,646,605,89607,89545,86662,82969,75279
95125,1853,3499,67797,27328,3.70872e+13,1111.52,12578.7,95125,627,605,91626,90518,88600,83927,63874
34357,189,1874,23478,10879,3.49232e+13,579.488,5728.52,34357,356,333,29419,25726,18283,7253,7390
49187,474,2374,34831,14356,3.64135e+13,728.224,7571.36,49187,580,373,45736,43273,30676,21682,14195
28832,789,1953,20816,8016,3.72479e+13,645.019,5573.67,28832,405,322,26627,25995,24720,21666,15293
48452,30,2732,33515,14937,3.45545e+13,719.906,8455,48452,491,501,31231,23328,18817,7729,3516
88925,827,3099,63127,25798,3.53556e+13,1034.84,11644.2,88925,664,627,84524,82242,72523,58352,42111
94347,340,3010,66657,27690,3.65201e+13,1068.03,11185.1,94347,641,581,83725,77344,51520,22590,21566
4706,170,682,3149,1557,3.3288e+13,189.716,1455.39,4706,134,149,3928,3658,2956,2776,1636
23567,531,1918,16644,6923,3.71484e+13,463.7,5248.54,23567,376,330,21501,20648,16975,11933,8992
32893,1781,2102,22730,10163,3.4034e+13,553.964,6166.29,32893,378,381,30791,30781,30549,30407,28331
95427,2619,3919,66687,28740,3.59668e+13,1247.55,13756.7,95427,582,636,91508,91074,89325,84654,75195
40160,37,2290,27937,12223,3.35271e+13,645.288,7074.91,40160,367,374,26940,20508,15750,5929,2808
1018,186,304,723,295,3.95505e+13,48.2809,474.879,1018,73,72,714,698,674,610,537
57686,247,2700,40280,17406,3.57474e+13,853.694,8739.62,57686,576,477,50567,44719,31314,12444,11591
7183,946,979,4975,2208,3.72128e+13,233.732,2145.49,7183,212,211,6204,6204,6204,6204,6146
24314,441,1444,16642,7672,3.502e+13,459.064,4294.29,24314,343,340,22570,21571,17205,12733,10604
50431,699,2915,34923,15508,3.48382e+13,631.827,9093.18,50431,554,417,47243,45580,34119,25341,14766
47017,864,3161,32432,14585,3.5921e+13,711.407,9214.76,47017,452,737,43678,42088,37890,30525,18452
36394,1900,2027,25835,10559,3.42143e+13,766.565,6278.73,36394,355,405,34367,34367,34361,34339,33906
58851,217,2396,41498,17353,3.6679e+13,773.801,8250.99,58851,615,444,50577,44495,31610,14904,11754
41481,824,1813,28229,13252,3.48356e+13,711.052,6332.97,41481,419,509,39491,38665,32737,24709,25404
30389,342,1999,21451,8938,3.66299e+13,702.759,5625.71,30389,417,289,27360,25598,17323,12463,9872
82871,1492,3536,55913,26958,3.38345e+13,867.64,11461.3,82871,665,506,79335,78594,68112,56069,57655
27835,479,1695,18953,8882,3.559e+13,384.271,4704.15,27835,382,271,26119,25720,17525,14814,12323
50288,1543,2390,34775,15513,3.56965e+13,711.558,7749.39,50288,540,384,47898,47727,45669,41074,40073
54034,741,2200,37053,16981,3.27698e+13,908.054,7234.81,54034,451,435,50975,49792,42000,30274,29438
68208,903,2877,47453,20755,3.38676e+13,986.214,9706.79,68208,533,473,64459,62654,46166,29967,20686
82579,592,3135,57631,24948,3.60992e+13,1183.96,10550.2,82579,549,490,77586,74564,49801,36367,25198
24124,442,1801,16669,7455,3.22772e+13,340.421,4890.31,24124,451,323,22167,21810,16345,13793,7784
97139,1898,4625,66411,30728,3.53122e+13,1142.69,14509.2,97139,601,650,92514,91432,83532,67067,60679
2301,199,464,1582,719,3.70707e+13,133.081,882.548,2301,82,134,1837,1679,1660,1694,1016
21064,725,1343,15528,5536,3.67123e+13,615.38,3960.69,21064,310,253,19397,18919,18567,17401,13477
61660,154,2796,43608,18052,3.57793e+13,780.688,9481.41,61660,574,403,51517,45361,32906,9699,7966
47023,2110,2239,33135,13888,3.58376e+13,760.179,7055.32,47023,460,355,44784,44784,44728,44594,44564
54210,523,1626,37504,16706,3.14076e+13,885.002,6611.88,54210,412,407,50956,48692,44243,32297,23230
87953,1060,2862,61820,26133,3.4611e+13,1182.88,10476.4,87953,607,499,84531,82982,72876,57319,47912
31908,406,2211,21782,10126,3.54953e+13,538.307,6324.7,31908,424,405,28936,26881,17837,12822,9345
75171,1107,3586,51382,23789,3.54762e+13,920.332,11746.1,75171,554,586,71447,70407,60000,43023,32789
97633,2858,3232,68849,28784,3.59341e+13,1270.28,12153,97633,605,534,94401,94387,94259,93745,91328
3129,125,680,2133,996,3.51355e+13,135.85,1236.64,3129,155,115,2319,2074,1680,1004,724
97361,3438,3453,68044,29317,3.46729e+13,1030.27,12562.6,97361,795,543,93908,93908,93908,93908,93840
79820,2008,3666,55513,24307,3.56436e+13,936.404,12226.4,79820,536,708,76154,75662,71444,61661,58484
69833,1740,2721,49562,20271,3.47063e+13,1148.37,9568.85,69833,530,454,67112,66727,64603,62023,52089
28534,1562,2022,19905,8629,3.57154e+13,754.53,5775.1,28534,391,350,26512,26153,26011,24805,23849
25518,23,1784,18028,7490,3.59082e+13,722.913,5047.01,25518,357,385,15577,11517,9354,4464,2063
27520,1728,1948,19050,8470,3.46089e+13,488.522,5471.85,27520,401,335,25572,25566,25493,25543,24393
31170,291,1660,21832,9338,3.63229e+13,782.483,5408.42,31170,471,342,27520,24798,19335,12832,8606
48736,1315,2509,34929,13807,3.64071e+13,875.765,8373,48736,544,519,46195,45746,44524,43476,26846
65380,1040,3472,44185,21195,3.371e+13,749.823,10620.6,65380,582,657,61840,60596,49858,42707,33780
10633,97,1180,7487,3146,3.3531e+13,324.223,2791.18,10633,234,274,8191,6994,5329,1368,1134
7791,305,1181,5302,2489,3.27913e+13,206.899,2522.35,7791,251,175,6608,6164,4465,3221,2000
19072,1438,1706,13297,5775,3.68948e+13,419.909,4229.53,19072,313,310,17366,17358,17328,17334,16616
20340,1008,1829,14707,5633,3.82603e+13,450.468,4688.85,20340,313,296,18511,18371,17865,17454,13493
65509,1763,3270,44563,20946,3.27181e+13,652.406,10016.8,65509,512,429,62239,62129,53598,44055,38914
6660,845,891,4582,2078,3.49146e+13,246.374,1945.83,6660,239,218,5769,5769,5769,5768,5759
49037,137,2493,34106,14931,3.54381e+13,667.707,7496.15,49037,465,404,39711,34175,24630,10567,8221
23484,1123,1526,16979,6505,3.74236e+13,493.791,4526.08,23484,322,354,21958,21786,21638,21175,16808
73480,888,2474,50705,22775,3.37162e+13,976.739,9142.85,73480,527,454,70545,69525,62227,51932,40475
36604,2162,2863,26034,10570,3.73707e+13,501.728,7792.79,36604,434,634,33741,33724,33507,33189,26909
64698,36559,64698,0,64698,15.9998,0,64698,64698,64698,1,0,0,0,0,0
11184,471,839,7901,3283,3.3695e+13,303.249,2351.84,11184,256,162,10345,10167,8658,5774,6445
42112,1306,2469,29486,12626,3.58561e+13,669.287,7704.5,42112,416,472,39643,39323,37500,35112,24825
48349,1505,2771,33219,15130,3.44255e+13,729.823,8458.89,48349,505,525,45578,44846,42958,36134,33088
84127,1154,3278,58477,25650,3.47328e+13,1056.5,11506.7,84127,526,551,80505,78967,71325,50297,43207
44088,2110,2240,30194,13894,3.30016e+13,543.663,7210.22,44088,488,316,41848,41848,41816,41788,40560
3003,278,604,2178,825,3.95108e+13,133.467,1087.13,3003,141,102,2399,2285,2259,2273,1210
41864,1066,2126,29140,12724,3.47367e+13,633.018,6574.44,41864,393,368,39738,39260,35654,28958,23254
6601,30,557,4486,2115,3.23925e+13,193.551,1518.09,6601,151,141,4198,3089,2611,999,871
58260,511,2610,40776,17484,3.51221e+13,884.222,8337.7,58260,496,414,54254,52139,38138,28174,19519
91975,110,4022,61976,29999,3.40959e+13,1219.84,13108.1,91975,614,824,75475,65700,38671,15535,7644
35288,1197,1770,24171,11117,3.35158e+13,501.197,5574.07,35288,339,424,33518,33474,32501,32141,28261
26755,751,1713,19141,7614,3.50277e+13,471.326,4825.9,26755,312,256,25042,24665,23008,20789,12890
66077,790,2251,45526,20551,3.35612e+13,1040.66,8558.83,66077,457,461,62784,61331,54333,36790,29369
43924,896,2058,30513,13411,3.4304e+13,795.248,6449.89,43924,438,364,41703,40490,35295,24546,27097
85909,1229,2507,59800,26109,3.49231e+13,1003.9,9630.61,85909,521,484,83364,81858,74042,55190,59851
53917,840,2469,38178,15739,3.69422e+13,803.733,8250.34,53917,584,428,51207,48866,41119,32206,29761
23004,311,1500,16228,6776,3.62455e+13,535.278,4397.79,23004,344,332,20279,18540,16179,12771,7301
86199,577,2252,62072,24127,3.74964e+13,1186.49,10063.2,86199,580,510,80725,77255,67025,44021,27512
18392,413,1609,13222,5170,3.78278e+13,372.266,4152.55,18392,301,341,16704,15976,14261,13096,6214
6841,835,1121,4989,1852,3.69568e+13,264.045,2235.18,6841,217,200,5720,5666,5649,5629,4770
97553,1521,3022,67962,29591,3.65883e+13,1241.13,11582.8,97553,695,572,94330,93428,85644,68695,66614
86427,1679,3789,60533,25894,3.53043e+13,968.995,12813,86427,454,709,82638,82173,79304,75944,52028
57920,2385,2499,39701,18219,3.49908e+13,836.903,8814.39,57920,509,484,55421,55421,55391,55387,54763
77146,1299,2118,55173,21973,3.76424e+13,781.561,8243.93,77146,503,387,75028,74858,67526,52166,62073
2768,284,578,1896,872,3.54434e+13,145.368,1080.37,2768,133,149,2190,2068,2027,1941,1476
6877,647,760,4914,1963,3.87644e+13,279.671,1838.42,6877,179,179,6117,6076,6098,6106,5958
18470,947,1173,12490,5980,3.40796e+13,500.298,3551.5,18470,282,310,17297,17119,17116,16896,16142
11009,30,1219,7445,3564,3.57233e+13,277.875,2979.56,11009,212,335,6986,5221,4171,1473,1132
42549,791,2472,29873,12676,3.44163e+13,601.356,7600.46,42549,519,333,39808,38890,29016,23025,17815
16081,1346,1499,11011,5070,3.26118e+13,357.005,3654.61,16081,271,278,14582,14582,14561,14578,14220
81781,1146,2964,57512,24269,3.61535e+13,1069.7,10828.5,81781,589,512,78519,77184,67675,55205,40876
67112,625,2859,46975,20137,3.55404e+13,913.619,9400.2,67112,524,444,63228,61301,43029,32156,19970
71794,1999,2834,49343,22451,3.30988e+13,834.786,9561.13,71794,497,414,68960,68896,66236,63258,54004
73896,609,2451,50560,23336,3.58349e+13,498.512,8703.67,73896,480,352,71445,71068,45675,31215,28198
75543,2381,3170,53306,22237,3.64675e+13,984.235,10904.4,75543,753,539,72373,72240,70993,68399,62579
25934,549,1586,17775,8159,3.32608e+13,415.422,4723.08,25934,279,281,24292,23783,21834,15549,11603
26700,158,1910,19615,7085,3.64415e+13,610.443,5516.64,26700,454,376,21864,19002,15812,6998,4421
95221,1202,3641,67199,28022,3.60806e+13,1270.47,13246.6,95221,770,596,90785,88320,76984,60122,48581
74574,3079,3285,53139,21435,3.59926e+13,895.133,11292.3,74574,839,451,71289,71289,71204,71213,70461
78411,1455,3798,54556,23855,3.54308e+13,991.687,12294.4,78411,738,586,74526,73445,59594,41711,32355
32819,271,1446,22473,10346,3.4602e+13,693.788,4918.54,32819,370,296,28944,27241,19061,10879,10415
75220,310,2904,51565,23655,3.27193e+13,876.318,10434.9,75220,618,494,68965,63553,39925,17679,13611
39614,647,2300,28092,11522,3.74645e+13,693.305,7101.05,39614,484,528,36822,35593,32557,26621,12016
82872,1126,2569,57102,25770,3.42083e+13,903.295,10086.1,82872,607,497,79930,78452,69858,54340,49810
16292,1121,1516,11893,4399,3.69173e+13,438.779,3873.93,16292,331,259,14776,14594,14600,14552,12002
8926,236,873,6437,2489,3.60033e+13,364.053,2156.72,8926,236,204,7706,6773,6551,6186,3049
49483,1850,2387,35069,14414,3.7029e+13,990.084,7807.52,49483,566,395,47096,46794,46367,44737,44581
51771,561,2083,36781,14990,3.6434e+13,861.783,7705.48,51771,423,410,48322,45735,38753,29705,21603
51334,2070,2383,36262,15072,3.61597e+13,758.2,7843.35,51334,535,356,48951,48929,48853,48804,46806
62898,580,2989,43410,19488,3.27954e+13,674.495,9667.59,62898,547,456,58997,56569,38435,30819,17971
4875,753,823,3330,1545,3.50528e+13,244.45,1690.64,4875,173,211,4052,4016,4030,3958,3922
16287,367,1591,11351,4936,3.32622e+13,278.379,3971.99,16287,218,330,14631,14185,12532,11748,3794
31232,892,2365,21680,9552,3.52375e+13,521.383,6415.59,31232,433,276,28867,28303,21945,16795,14722
60694,2431,2635,41852,18842,3.31366e+13,1027.19,9289.68,60694,523,531,58059,58007,57788,57387,56804
67897,700,2206,47993,19904,3.61806e+13,1043.37,8587.61,67897,575,547,64284,61788,51321,38668,30709
85094,2049,3124,59243,25851,3.34432e+13,814.044,10909.4,85094,646,567,81970,81881,81128,80475,70792
9992,557,661,6972,3020,3.61564e+13,312.463,1957.23,9992,184,179,9331,9327,9285,9296,9048
94899,3144,3800,65718,29181,3.35339e+13,949.56,13054.1,94899,762,520,91099,91080,89865,87296,83099
77925,2706,2986,54768,23157,3.66093e+13,848.581,10600.6,77925,686,452,74939,74939,74812,74855,73141
8292,342,702,5981,2311,3.51032e+13,266.566,1775.48,8292,202,140,7590,7375,6927,7005,6004
63293,2075,2408,43885,19408,3.60425e+13,681.76,8455.98,63293,558,427,60885,60884,60548,60493,57354
77072,932,2946,53109,23963,3.46837e+13,906.265,10012.2,77072,517,509,73839,71743,57128,41314,40565
92539,1659,3226,63566,28973,3.39082e+13,1008.28,11612.2,92539,577,505,89313,88631,79663,61721,57794
45299,107,2321,31501,13798,3.55985e+13,827.739,7561.81,45299,479,413,36421,31663,22560,8912,6486
57367,185,2426,39646,17721,3.37812e+13,818.106,8177.09,57367,489,380,49856,44958,28433,9147,9187
39562,361,1284,27137,12425,3.62979e+13,330.006,4383.03,39562,363,243,38261,37735,30704,23688,22812
79486,2005,2474,55620,23866,3.41183e+13,1012.6,9295.74,79486,607,432,77012,76990,75894,74391,70006
59491,2985,3105,41896,17595,3.56042e+13,1033.1,9906.41,59491,554,659,56386,56386,56336,56385,56033
53953,10093,53953,0,53953,15.9997,0,53953,53953,53953,1,0,0,0,0,0
28304,1274,1928,19550,8754,3.59696e+13,651.537,5692.53,28304,462,457,26376,25958,24830,22577,22882
67140,941,2396,46522,20618,3.29973e+13,1006.21,8841.84,67140,479,471,64087,62487,55066,40042,38097
64774,722,2297,44979,19795,3.62574e+13,776.36,7984.95,64774,487,395,61924,58471,44431,31684,36949
99715,1016,2727,72063,27652,3.69308e+13,1377.22,11674.5,99715,624,553,95508,92398,87164,69938,46589
76927,1307,1774,52839,24088,3.11597e+13,1064.4,8412.07,76927,494,530,74965,74061,72823,67449,61814
54298,107,2083,37653,16645,3.51302e+13,876.28,7637.26,54298,467,427,44293,39017,28322,9532,7465
99297,1662,3578,69534,29763,3.5894e+13,1185.39,12642.5,99297,663,577,95719,94796,86583,73027,56857
83161,683,3253,57325,25836,3.51866e+13,820.447,10480.9,83161,524,421,79310,77678,54927,39438,32980
46635,1726,2306,33104,13531,3.69867e+13,830.039,7367.57,46635,492,412,44329,44042,43809,41001,41496
13725,66,1259,9294,4431,3.39476e+13,423.002,3261.04,13725,283,248,9869,8218,5672,2188,2136
10007,205,962,6904,3103,3.47745e+13,347.782,2427.75,10007,226,206,8139,6913,5219,3060,2074
83200,67,3727,57905,25295,3.48405e+13,1139.34,12425.4,83200,593,720,62712,52105,37950,13402,7076
86949,1950,3650,60659,26290,3.50254e+13,1142.79,12855.5,86949,684,632,83299,82510,77216,64378,54684
5601,613,857,4034,1567,3.7319e+13,129.008,1707.76,5601,183,112,4744,4743,4708,4700,4062
11824,1044,1182,8392,3432,3.78365e+13,321.039,2812.7,11824,300,209,10642,10630,10625,10605,10180
3125,114,412,2288,837,3.39167e+13,194.439,930.181,3125,116,100,2416,2039,2008,1662,1059
34239,279,1986,24173,10066,3.58136e+13,791.035,6136.16,34239,398,367,30191,27757,20667,12356,7615
81757,673,3623,56924,24833,3.63686e+13,889.226,12290,81757,853,484,76741,74065,50933,36611,29796
6339,901,960,4544,1795,3.7486e+13,215.179,1995.02,6339,235,191,5379,5379,5379,5379,5302
19981,41,1145,14124,5857,3.69683e+13,565.937,3597.16,19981,340,249,13717,11116,7880,3142,2101
79555,1752,3531,55458,24097,3.56391e+13,953.564,11419,79555,574,659,76024,75327,71209,62079,54013
75023,1120,1829,51487,23536,2.9899e+13,891.362,7607.07,75023,456,469,73137,72359,69598,67230,50829
29772,455,1965,20883,8889,3.68924e+13,528.961,5709.33,29772,433,401,27176,25801,22392,18745,13072
17394,943,1641,12410,4984,3.83811e+13,433.107,4136.65,17394,294,293,15753,15532,15265,15103,11670
50199,1251,2923,35663,14536,3.68564e+13,708.539,8844.09,50199,469,552,47276,46751,44427,39666,32896
64672,1838,2514,45889,18783,3.74778e+13,1090.59,9052.53,64672,610,497,62158,61703,60632,58557,54983
77119,837,2901,53717,23402,3.57687e+13,1104.25,10151.6,77119,650,529,73209,70681,55535,42092,37514
19816,380,1261,13691,6125,3.68526e+13,455.332,3715.97,19816,347,293,18035,16366,13853,10801,10236
33570,1584,1889,23521,10049,3.63095e+13,524.519,5789.74,33570,479,285,31681,31678,31285,30826,30383
56308,1484,2792,40093,16215,3.69643e+13,921.725,9362.29,56308,513,551,53516,52697,51494,48129,35807
12967,494,603,8706,4261,3.40183e+13,362.513,2260.4,12967,211,216,12364,12360,12104,12086,11591
86264,2386,2481,61781,24483,3.69264e+13,1246.41,10682.6,86264,774,580,83783,83782,83748,83743,83092
96882,422,3651,68840,28042,3.74419e+13,1322.28,12553.5,96882,642,621,87526,80893,56159,24120,25694
85503,904,3679,59421,26082,3.58973e+13,1172.36,12051.1,85503,559,565,80836,79012,60133,43915,34178
95942,2087,3656,66302,29640,3.56573e+13,1306.81,12865.4,95942,725,575,92286,91570,84154,65344,67524
66331,2172,3116,45485,20846,3.34978e+13,901.251,10152.4,66331,524,512,63215,63131,61322,57266,52895
77017,1869,2376,53039,23978,3.53156e+13,1098.6,8886.85,77017,566,491,74641,74183,73331,71196,69006
28487,658,1721,19834,8653,3.55946e+13,616.135,5137.14,28487,423,295,26449,25379,24180,19500,17526
5300,634,917,3728,1572,3.82149e+13,168.48,1803.5,5300,218,166,4383,4371,4317,4316,3365
39923,337,1911,28515,11408,3.81611e+13,564.477,6158.29,39923,499,302,35903,33328,25906,17780,13033
6979,340,705,4817,2162,3.49621e+13,312.506,1803.51,6979,222,207,6163,5573,5178,4158,4384
94309,522,3075,68151,26158,3.7243e+13,1320.37,12014.4,94309,845,538,87035,82430,65192,42086,29086
77483,695,3003,53872,23611,3.62609e+13,950.656,10333.7,77483,573,484,73387,70618,47449,34418,25588
96087,3332,3602,67429,28658,3.56806e+13,1107.71,12633.2,96087,667,582,92485,92483,92446,92473,91210
91562,1614,2698,65230,26332,3.63187e+13,1069.74,10444.3,91562,700,528,88864,88534,82219,66979,73445
82760,2245,3012,56809,25951,3.58429e+13,680.684,9770.34,82760,662,449,79748,79693,79244,77722,75556
85240,1776,3165,60090,25150,3.50733e+13,1003.23,10972.8,85240,609,552,82075,81412,77203,77123,58390
33609,1286,2579,23776,9833,3.60412e+13,525.676,6988.63,33609,570,357,31030,30764,28341,22871,19348
99112,2280,3536,68850,30262,3.46875e+13,1207.4,12506.1,99112,838,612,95576,94896,90138,79486,81140
97293,2461,3069,66607,30686,3.45569e+13,796.495,11051.2,97293,631,544,94224,94132,91771,89395,80239
64404,424,2221,46006,18398,3.70096e+13,919.183,8518.27,64404,581,441,58944,55150,43528,29930,22976
43847,1925,2255,30474,13373,3.59594e+13,513.14,6817.1,43847,416,293,41592,41507,41538,41530,38833
4336,192,756,3055,1281,3.48033e+13,171.814,1529.22,4336,173,192,3496,3175,2952,2596,1143
23964,636,1985,16876,7088,3.63511e+13,393.199,5186.46,23964,284,354,21979,21483,19543,15604,12204
73618,3487,3651,51351,22267,3.54499e+13,955.173,11650.3,73618,782,515,69967,69963,69912,69936,69036
41212,1417,2321,29255,11957,3.64015e+13,737.013,7232.12,41212,402,401,38891,38486,36673,33668,28477
53553,2214,2374,37977,15576,3.60248e+13,879.746,8003.25,53553,447,420,51179,51179,51160,51126,50351
35264,1101,2799,25560,9704,3.62993e+13,546.783,7502.7,35264,651,368,32465,32018,29346,20094,16870
44007,262,1953,30239,13768,3.07871e+13,636.503,6588.53,44007,435,342,40038,37827,24224,10126,8799
38686,648,1851,27630,11056,3.68895e+13,659.07,5919.49,38686,438,300,36369,35268,33242,26662,21894
19493,188,1061,13983,5510,3.76887e+13,627.413,3535.06,19493,342,244,16281,14450,12540,9291,5500
57785,1838,2211,40192,17593,3.37711e+13,1020.7,7857.82,57785,467,421,55574,55570,54842,54024,52779
19156,1351,1375,13985,5171,3.61227e+13,460.016,3973.65,19156,404,230,17781,17781,17774,17765,17732
41922,2142,2163,29687,12235,3.65107e+13,780.035,6724.54,41922,431,480,39759,39759,39759,39758,39742
24666,877,1480,17768,6898,3.62292e+13,584.432,4520.09,24666,392,251,23186,22747,21255,18317,17921
20654,144,1158,14220,6434,2.97596e+13,530.319,3435.34,20654,250,310,18438,17238,11350,6646,3187
28251,1437,1600,19760,8491,3.19024e+13,631.861,4902.06,28251,351,298,26651,26565,26636,26560,25314
33380,364,1353,22674,10706,3.26939e+13,388.621,4779.28,33380,297,264,31418,29064,23543,17721,12980
90491,732,3162,64042,26449,3.71749e+13,1079.22,11996.1,90491,663,598,85654,82599,61428,45333,28392
79671,821,2709,54914,24757,3.41529e+13,1223.64,9996.47,79671,550,476,75402,73037,58594,40929,37225
81563,2557,3181,56063,25500,3.56487e+13,904.074,11261.9,81563,584,621,78382,78350,77625,76070,71160
83615,2943,3098,58106,25509,3.6089e+13,955.071,10959.7,83615,502,510,80517,80517,80475,80489,80015
23261,1535,1755,16283,6978,3.65913e+13,410.132,5048.86,23261,248,455,21506,21500,21458,21493,20529
36165,237,2360,25022,11143,3.44909e+13,591.726,6752.23,36165,414,411,31948,29457,21481,9942,6520
92984,2298,3191,65189,27795,3.5805e+13,930.042,11973.8,92984,662,557,89793,89698,83963,71418,68099
85592,1744,3135,59205,26387,3.47484e+13,931.081,10715.3,85592,552,477,82457,82068,77042,61537,56819
70176,437,3211,49704,20472,3.69731e+13,983.394,10638.3,70176,620,507,63897,59406,40872,24323,17400
51930,1965,2269,36072,15858,3.27912e+13,945.856,7714.03,51930,513,417,49661,49485,49172,48524,45675
78078,965,2228,54362,23716,3.13283e+13,1160.19,9157.51,78078,554,472,74892,72956,69256,49796,45789
41742,781,1937,28462,13280,3.44198e+13,483.745,6487.08,41742,372,356,39805,39565,29596,21245,15079
5938,591,715,4225,1713,3.76665e+13,224.106,1627.66,5938,169,164,5223,5222,5203,5176,4618
83504,1153,2369,57691,25813,3.32833e+13,1034.47,9606.24,83504,621,489,80848,79391,73709,53762,54081
41725,1417,1549,29063,12662,3.56671e+13,853.203,5855.3,41725,399,438,40176,40174,40049,39705,38867
4397,476,722,2955,1442,3.68128e+13,192.261,1475.39,4397,146,171,3675,3659,3359,3026,2994
63753,748,2681,44098,19655,3.47589e+13,944.131,9263.89,63753,511,590,60147,57919,47893,36054,25208
76879,2542,2920,53890,22989,3.59594e+13,1126.24,10487.2,76879,582,495,73959,73958,73801,73857,71752
66314,435,3485,46355,19959,3.55596e+13,1185.89,10999.3,66314,628,731,60667,57583,39503,22188,13664
13661,807,1055,9803,3858,3.48581e+13,400.394,2908.2,13661,324,221,12606,12447,11953,12110,11245
63887,3787,4159,43247,20640,3.38888e+13,738.094,11839.2,63887,760,533,59728,59728,59163,58319,57512
64921,1016,3251,45221,19700,3.56708e+13,775.679,10346.7,64921,674,506,61591,60279,46459,37648,34497
35099,404,1777,25410,9689,3.70878e+13,637.778,5864.02,35099,466,307,31987,30023,26549,18493,9382
15541,654,1477,10772,4769,3.64e+13,397.155,3766.25,15541,243,318,14024,13464,12940,12426,8434
94093,2956,2966,66823,27270,3.56559e+13,1297.41,11407.5,94093,685,532,91127,91119,91122,91127,91112
56564,852,2050,39472,17092,3.60184e+13,889.623,7769.77,56564,476,443,53934,51932,48652,39025,30979
36913,1827,2714,25150,11763,3.47193e+13,467.553,7549.14,36913,320,587,34199,34150,33764,33526,23849
30703,54,1984,22007,8696,3.64675e+13,634.407,5848.8,30703,419,335,22499,18440,13978,3079,2500
55870,2743,2823,38538,17332,3.53552e+13,777.032,8946.53,55870,612,470,53047,53047,53022,53033,52693
6042,188,563,4347,1695,3.39421e+13,232.082,1420.01,6042,164,133,5107,4352,4488,4648,2679
24660,1310,2262,17154,7506,3.51386e+13,509.086,5859.04,24660,530,447,22398,22315,20996,18065,16254
52853,2807,2951,36372,16481,3.54021e+13,588.38,8850.93,52853,537,417,49902,49902,49855,49887,49540
79802,1679,2711,56367,23435,3.57751e+13,855.831,9879.12,79802,687,414,77091,76989,74630,69124,67833
7773,191,951,5200,2573,3.40804e+13,295.279,2224.39,7773,227,241,6476,5880,4312,3871,2595
87798,1621,3226,62162,25636,3.68471e+13,1158.45,11252.9,87798,659,539,84572,83623,78706,66786,67835
64330,87,2710,45633,18697,3.72123e+13,872.9,9385.57,64330,611,412,49469,42143,33389,12705,6924
86297,1778,3283,61972,24325,3.58418e+13,1143.21,11749.9,86297,722,659,83014,81886,78427,68852,60580
37612,2078,2178,25914,11698,3.5065e+13,739.161,6579.61,37612,460,468,35434,35434,35409,35389,35174
65935,1693,2850,45705,20230,3.56174e+13,1089.43,9976.76,65935,594,623,63085,62182,60110,52748,49699
51450,956,1911,36158,15292,3.30738e+13,879.788,7044.94,51450,489,450,49230,47603,46699,42241,33161
5265,326,483,3757,1508,3.30464e+13,237.581,1269.5,5265,143,129,4782,4638,4512,4576,4312
8556,756,804,5990,2566,3.57722e+13,275.815,2044.79,8556,205,199,7752,7751,7751,7751,7568
1503,186,378,1052,451,3.54972e+13,84.688,640.051,1503,79,87,1125,1062,1028,1026,753
58031,2086,2669,40515,17516,3.57817e+13,802.418,8876.81,58031,640,373,55362,55322,54117,51026,50995
38178,18890,38178,0,38178,15.9996,0,38178,38178,38178,1,0,0,0,0,0
13483,206,1535,9259,4224,3.52443e+13,425.593,3660.77,13483,286,402,11311,10235,8363,6781,2902
13802,327,1293,9944,3858,3.87317e+13,286.847,3256.68,13802,208,237,12402,11311,10394,7691,3822
53320,1270,3142,37467,15853,3.62012e+13,959.476,9534.7,53320,574,551,49989,48728,42582,32220,22643
54978,2446,2703,39065,15913,3.60775e+13,769.812,9042.38,54978,518,657,52275,52079,52139,52195,51436
9037,932,1072,6135,2902,3.52023e+13,280.074,2539.52,9037,256,207,7965,7925,7895,7862,7442
95354,230,3289,64781,30573,3.4228e+13,1025.43,12203.8,95354,628,647,84823,75948,50347,17226,16791
52664,1489,2771,37147,15517,3.70032e+13,717.225,8707.16,52664,669,458,49893,49704,46192,38020,36172
31723,157,1897,22909,8814,3.58566e+13,662.827,5734.13,31723,473,314,26132,22547,17892,6881,5362
7201,781,889,5095,2106,3.40305e+13,292.195,2038.46,7201,197,223,6312,6310,6308,6304,6195
51257,1726,2315,36355,14902,3.64105e+13,857.34,8023.69,51257,482,470,48942,48619,48179,46086,45824
75216,1520,2910,51997,23219,3.44104e+13,1143.33,10137.4,75216,545,555,72087,70920,66450,54051,50030
95385,2561,2999,66834,28551,3.5122e+13,1432.52,11916.3,95385,581,543,92386,92299,92139,91924,88491
21094,439,1800,14629,6465,3.36107e+13,333.562,4551.14,21094,233,362,19183,18559,17523,15522,10112
7780,672,686,5301,2479,3.41568e+13,279.236,1862.1,7780,171,203,7094,7094,7094,7094,7078
90043,1196,2939,64455,25588,3.68648e+13,1173.98,11864,90043,761,626,86596,84661,76727,58795,40294
41538,1439,1862,28891,12647,3.5116e+13,836.549,6422.87,41538,395,393,39676,39455,38645,37813,36455
27724,1671,2138,18855,8869,3.40402e+13,580.705,5789.87,27724,365,359,25586,25519,25090,24741,23028
64190,1566,3655,43195,20995,3.39828e+13,734.999,10899.5,64190,582,529,60535,60021,51283,45586,41078
46254,1457,2324,32694,13560,3.66206e+13,856.935,7753.61,46254,416,439,43930,43409,42817,42025,37084
73797,1407,2793,51983,21814,3.64234e+13,1067.73,9717.92,73797,580,535,70942,70466,66092,60394,43175
51390,1075,2815,35906,15484,3.55023e+13,1009.54,8832.72,51390,543,484,48176,46889,40755,31209,26148
79007,2620,2743,55170,23837,3.38679e+13,972.33,10324.3,79007,486,588,76264,76253,76233,76202,74699
18050,783,1595,12422,5628,3.63315e+13,544.436,4174.81,18050,313,325,16455,15981,14409,11197,9931
25426,579,1594,18047,7379,3.75091e+13,807.024,4784.57,25426,408,357,22984,21054,19742,15050,13211
63013,1973,2677,42731,20282,3.45668e+13,1008.88,8688,63013,493,493,60336,59988,58241,54004,55252
14249,1272,1559,9892,4357,3.48007e+13,368.279,3733.64,14249,366,239,12690,12685,12337,11753,10978
91611,703,3488,63208,28403,3.33792e+13,966.275,11699.3,91611,661,417,86847,84539,52787,38595,26734
12315,288,1074,8622,3693,3.65651e+13,508.2,2845.33,12315,260,263,10703,10089,8661,7304,4138
77686,1721,3516,54575,23111,3.63279e+13,990.145,11814,77686,685,639,74170,73465,68851,59871,42304
93819,2559,2652,67495,26324,3.67051e+13,1314.91,11009.6,93819,634,543,91167,91167,91130,91118,90872
76670,1492,3446,54276,22394,3.61671e+13,925.87,11570.7,76670,543,632,73224,72571,68216,62688,40980
60029,1082,3078,42103,17926,3.6355e+13,861.825,9959.19,60029,592,463,56778,55675,42975,31181,25626
53304,1696,2538,37544,15760,3.61424e+13,734.406,8284,53304,411,539,50766,50662,50306,49487,42884
6766,517,829,4756,2010,3.90697e+13,190.705,1856.84,6766,182,142,5937,5924,5660,5649,4690
47661,736,2156,33151,14510,3.2716e+13,625.947,7294.37,47661,492,364,45182,44132,39754,29309,23677
7573,443,827,5236,2337,3.51851e+13,251.954,1979,7573,167,157,6746,6704,5665,4820,3826
58105,1377,2269,39813,18292,3.55429e+13,646.17,7652.56,58105,454,486,55836,55646,53783,48322,48529
94163,2462,3306,65872,28291,3.44056e+13,1119.8,12440.6,94163,578,607,90857,90793,90496,90366,83123
9606,157,981,6629,2977,3.32141e+13,142.02,2256.6,9606,211,144,8540,8197,6345,5445,4073
90304,2085,3586,61750,28554,3.36494e+13,980.143,12146.1,90304,559,894,86718,86001,83134,74298,68381
19461,860,1689,13515,5946,3.63425e+13,413.481,4324.22,19461,298,265,17772,17508,16786,16228,12019
21140,1003,1579,14697,6443,3.64529e+13,521.587,4410.99,21140,331,295,19561,19281,18064,15122,14348
84827,183,2276,60078,24749,3.58534e+13,930.556,9591.45,84827,544,555,72811,66928,47896,15267,16433
41974,1415,2446,29588,12386,3.61261e+13,661.644,7034.47,41974,474,367,39528,39255,35750,25631,26874
25079,1136,1797,17383,7696,3.56078e+13,353.774,4922.34,25079,314,293,23282,23241,22166,20929,16779
8137,533,849,5629,2508,3.69908e+13,267.672,2044.4,8137,180,196,7288,7263,6756,6295,6138
72378,2608,2906,51723,20655,3.55084e+13,738.519,10254.5,72378,661,460,69472,69468,69392,69154,66322
82873,50938,82873,0,82873,15.9998,0,82873,82873,82873,1,0,0,0,0,0
79992,286,3181,56669,23323,3.55505e+13,946.487,11021.1,79992,726,460,71750,65609,45792,16954,15454
73916,1356,2626,50944,22972,3.31887e+13,794.649,9666.32,73916,595,469,71290,70488,65110,51346,47522
94466,3869,4329,67529,26937,3.47467e+13,1125.24,13546,94466,1326,586,90137,90101,89809,89216,85907
18511,1185,1443,13176,5335,3.64449e+13,403.996,3791.07,18511,320,264,17068,17059,16863,16879,16148
92803,169,2998,65045,27758,3.54554e+13,869.204,10583.5,92803,703,505,79160,71379,48083,16901,14987
31988,1741,1918,23129,8859,3.83897e+13,751.064,5956.45,31988,379,408,30070,30069,29979,30037,29046
84881,2015,3559,60125,24756,3.52278e+13,979.436,12088.6,84881,515,644,81322,80902,80053,77458,62068
39100,142,2268,27574,11526,3.36764e+13,826.031,6802.3,39100,442,386,33178,29823,19951,4818,4600
34892,1315,1981,23697,11195,3.57244e+13,582.965,5723.68,34892,340,456,32911,32613,31043,27340,27914
6582,184,851,4670,1912,3.81063e+13,231.883,1882.37,6582,186,157,5420,4793,3651,2609,1968
99051,411,2472,70686,28365,3.6466e+13,1245.98,11028.3,99051,699,532,91115,85678,60219,36953,25834
81888,719,3389,56114,25774,3.47502e+13,1264.03,11684.9,81888,600,597,76802,74342,52817,40250,25066
76989,1247,2700,55481,21508,3.68957e+13,1035.86,10580.3,76989,629,559,73978,72935,69524,63260,45593
40890,893,1697,29575,11315,3.73781e+13,873.939,6225.12,40890,456,372,38797,37093,36403,33156,25633
29678,56,1929,21154,8524,3.73388e+13,642.133,5639.56,29678,529,347,21621,18152,13519,4497,2748
34458,2201,2242,23516,10942,3.30412e+13,551.474,6420.31,34458,355,378,32216,32216,32213,32216,32179
95445,510,3248,66192,29253,3.50265e+13,1004.19,12161.6,95445,498,668,89159,85087,62149,36373,26839
6545,332,1003,4518,2027,3.5639e+13,193.327,2146.12,6545,148,202,5542,5277,4712,3685,2213
26707,807,1765,18437,8270,3.65448e+13,479.719,5102.64,26707,393,307,24942,24615,23382,21164,15305
59570,1155,2495,41549,18021,3.20616e+13,833.897,8122.41,59570,482,546,57015,56257,52919,40558,40229
1815,351,400,1354,461,3.8772e+13,71.7906,693.241,1815,101,59,1415,1409,1413,1412,1343
4932,254,845,3641,1291,3.76123e+13,128.401,1622.91,4932,157,144,4087,3915,3825,3740,1855
44123,2388,2405,30745,13378,3.55059e+13,802.694,7419.76,44123,518,364,41718,41718,41718,41718,41708
53807,1326,1790,38956,14851,3.77572e+13,1001.75,7143.81,53807,517,360,52017,51710,50091,47642,46660
65858,454,2562,46025,19833,3.38464e+13,917.541,8789.23,65858,567,466,61687,59612,45995,32329,17768
68357,2495,2774,46995,21362,3.34787e+13,1116.43,9816.87,68357,524,554,65583,65578,65446,65399,64199
64568,1844,2480,43988,20580,3.35414e+13,569.111,8079.3,64568,457,423,62088,61983,60541,58184,53415
37206,1714,2293,24735,12471,3.21194e+13,644.435,6666.09,37206,426,447,34913,34898,34245,33615,33029
16743,562,1251,11689,5054,3.62815e+13,455.818,3498.8,16743,308,219,15321,14543,13673,10120,8736
20549,1542,1562,14532,6017,3.66003e+13,418.635,4073.2,20549,320,374,18987,18986,18984,18984,18982
51863,929,2395,36927,14936,3.75694e+13,883.498,8059.82,51863,580,379,49171,47372,42028,29818,28180
25612,105,1227,18207,7405,3.48876e+13,684.748,4245.47,25612,375,316,19809,17188,12604,4878,3130
37465,283,2197,25707,11758,3.37785e+13,572.699,6534.72,37465,402,371,33618,30937,18428,6780,4990
84728,246,2167,58162,26566,3.24583e+13,1052.89,9555.85,84728,485,526,76746,71894,48076,17368,12509
62654,2059,2440,42003,20651,3.43548e+13,812.284,8255.24,62654,510,477,60214,60213,59567,57498,58910
94984,2220,3387,66938,28046,3.60355e+13,1237.73,12670.3,94984,818,666,91597,91060,87707,78854,76411
92698,1147,3022,65425,27273,3.6937e+13,1183.98,11380.8,92698,606,562,88937,86714,77011,52030,51568
78659,2377,3074,55927,22732,3.64751e+13,909.664,11023.2,78659,479,591,75585,75554,75347,74674,70758
13999,639,1282,10018,3981,3.78749e+13,533.649,3281.68,13999,284,249,12567,11970,11808,10258,8965
2376,328,478,1814,562,3.72006e+13,95.5673,844.985,2376,133,85,1898,1876,1889,1883,1610
17332,204,1525,12378,4954,3.78291e+13,444.719,3896.34,17332,356,245,14885,13266,10911,7138,4889
47685,1845,2338,32569,15116,3.56134e+13,504.7,7059.74,47685,396,449,45347,45336,44760,44326,42053
38965,428,2112,27174,11791,3.42497e+13,770.54,6656.76,38965,450,367,35601,33791,27556,20966,12856
75456,2317,2670,53058,22398,3.63521e+13,1135.15,9310.66,75456,614,455,72786,72769,72246,71718,71126
38395,495,2351,27309,11086,3.67875e+13,617.644,6944.02,38395,398,377,35200,33237,27335,22249,12771
45190,874,2492,31112,14078,3.45483e+13,721.884,7429.29,45190,458,368,42540,41455,35281,24943,24340
77490,608,2069,53626,23864,3.02417e+13,963.095,8225.82,77490,548,532,73443,71057,59954,44358,23977
13822,628,1375,9513,4309,3.64163e+13,387.803,3382.77,13822,288,305,12447,12173,11654,10064,7173
87285,1945,3351,60386,26899,3.608e+13,1515.38,11753.6,87285,652,661,83905,81795,75334,58590,63572
85179,3120,3806,59260,25919,3.55905e+13,1064.27,12499.1,85179,725,679,81373,81321,80891,80459,74893
67120,2409,3168,47544,19576,3.70354e+13,945.423,10373.4,67120,610,541,63952,63886,62463,59383,56504
95335,1859,2868,67318,28017,3.68969e+13,1181.32,11549,95335,715,625,92467,91730,89163,82878,77273
73466,1345,3241,49210,24256,3.3628e+13,832.99,10602.7,73466,756,529,70225,69854,63862,55546,54436
6432,364,836,4330,2102,3.41395e+13,258.462,1930.44,6432,201,172,5596,5162,4922,4050,3578
5634,181,703,3750,1884,3.31536e+13,239.996,1641.41,5634,169,202,4747,4350,3297,3194,2079
8354,237,1034,5978,2376,3.61268e+13,208.726,2335.31,8354,253,168,7127,6406,5655,4598,2183
46286,1147,2058,32474,13812,3.59234e+13,781.376,6846.61,46286,387,387,44228,43638,41143,38472,33412
40982,1761,2198,28417,12565,3.65301e+13,785.774,6917.07,40982,437,469,38784,38721,38241,37549,36484
43333,1557,2028,29708,13625,3.31845e+13,684.842,6815.07,43333,370,459,41305,41197,40883,40641,37224
23436,819,990,16155,7281,3.59703e+13,444.808,3477.25,23436,269,251,22446,22416,21900,20569,21421
64101,2243,2553,45149,18952,3.31508e+13,1071.14,9071.42,64101,536,445,61548,61509,61134,60738,57228
81195,244,2686,55851,25344,3.5064e+13,923.327,9910.59,81195,529,456,71637,61850,42278,18625,16772
65299,1327,2865,44806,20493,3.4521e+13,768.187,9398.17,65299,473,590,62434,61929,59219,55070,47404
61322,50,2767,42849,18473,3.68739e+13,707.231,9064.56,61322,502,513,43772,35998,25651,11246,5951
2004,319,386,1381,623,3.63127e+13,162.001,723.28,2004,112,105,1618,1475,1587,1592,1562
31368,2156,2242,21579,9789,3.27244e+13,486.46,6101.54,31368,542,232,29126,29126,29089,28977,28989
36908,744,2422,25866,11042,3.55748e+13,806.827,7144.87,36908,489,537,33883,32376,29865,23146,15356
85400,816,2006,59358,26042,3.18856e+13,1043.23,8609.02,85400,525,418,82031,78648,74164,61738,40890
27722,372,2313,19893,7829,3.68579e+13,555.363,6149.63,27722,473,332,24633,22735,15789,10688,7096
64637,1580,3030,45411,19226,3.41562e+13,690.898,10056.8,64637,487,644,61607,61494,60672,58966,40970
13555,894,1346,9454,4101,3.49008e+13,231.423,3240.45,13555,194,286,12209,12173,12050,12017,9862
43374,592,1923,30213,13161,3.55473e+13,670.444,6078.43,43374,445,309,41124,40073,33877,24752,22107
38414,429,1957,26637,11777,3.44203e+13,572.97,6149.84,38414,432,359,35467,34071,25801,19286,13700
89590,344,1602,61421,28169,2.83556e+13,880.941,7355.8,89590,414,400,84516,81412,56468,38356,27159
43175,1466,2547,30305,12870,3.53486e+13,714.483,7495.95,43175,442,562,40628,40373,38511,34485,31062
17684,1361,1825,12104,5580,3.5539e+13,376.494,4470.36,17684,366,385,15859,15837,15370,13109,12981
64482,1388,2948,44616,19866,3.50756e+13,927.659,9629.96,64482,614,436,61534,60624,55165,43604,41791
44821,1000,2134,30947,13874,3.45473e+13,527.158,6932.02,44821,429,390,42687,42444,39494,33736,29285
17420,145,1481,11974,5446,3.52229e+13,460.844,4008.67,17420,309,295,14009,12100,8910,5143,2779
98356,3050,4203,68211,30145,3.56151e+13,1333.86,14451,98356,661,746,94153,93805,92630,90115,82726
63738,680,2451,43215,20523,3.44312e+13,879.286,8969.31,63738,505,495,59959,57762,44879,33608,26338
95291,1613,2827,67564,27727,3.58012e+13,1307.7,11401.8,95291,706,598,92420,90860,86765,75309,66342
96309,2887,3240,67493,28816,3.53111e+13,1086.65,11948.8,96309,544,493,93069,93036,92861,92865,89761
93889,2457,3965,65026,28863,3.64935e+13,1230.17,13249,93889,707,578,89924,89434,87057,80303,74104
30841,115,1574,21848,8993,3.69663e+13,632.787,5077.79,30841,388,306,24440,21482,16489,6526,4696
87179,457,3724,60951,26228,3.60942e+13,956.603,12964.4,87179,569,666,80177,75159,54665,31566,23050
51877,1378,2097,36281,15596,3.58067e+13,908.891,7397.74,51877,488,395,49780,48970,46297,39721,39459
92455,292,3569,64315,28140,3.47812e+13,987.357,12399.1,92455,559,636,83183,76108,50555,20013,16519
66107,1000,3274,46470,19637,3.62819e+13,1014.54,10699.2,66107,639,711,62180,60645,55509,41929,28027
37902,804,2431,26414,11488,3.52144e+13,752.438,7198.37,37902,441,583,35040,34167,31525,27823,15463
32709,1581,1955,22848,9861,3.59964e+13,672.45,5780.18,32709,358,408,30754,30727,30533,30100,29459
96377,262,3546,68642,27735,3.67711e+13,1232.9,12852.2,96377,854,554,85460,75978,53110,20040,16678
41439,157,2231,28359,13080,3.55134e+13,459.474,6169.44,41439,349,368,34205,28944,20263,7798,5910
7812,561,767,5317,2495,3.43516e+13,320.584,2002.82,7812,202,223,7045,6884,6867,6844,6222
90279,1050,2882,63916,26363,3.61868e+13,1050.19,11097.9,90279,747,481,87048,85783,72292,49676,49933
68645,2072,3383,46466,22179,3.45505e+13,796.304,10786,68645,478,644,65262,65187,63561,60814,44443
66666,3003,3223,46176,20490,3.51867e+13,933.426,10407.4,66666,699,496,63443,63442,63252,63261,62550
33435,984,1711,24085,9350,3.68474e+13,663.547,5457.26,33435,426,333,31724,31196,29947,26822,26355
64133,47,2496,44993,19140,3.65551e+13,1053.63,9333.5,64133,493,483,46534,37352,29227,9701,5324
5876,208,965,4322,1554,3.90967e+13,181.771,1894.9,5876,183,172,4813,4485,4314,4183,1510
17682,314,1535,12219,5463,3.59255e+13,450.931,4071.93,17682,274,342,15563,14117,11559,9340,5185
77642,1597,2938,54849,22793,3.56794e+13,885.653,10494.2,77642,626,547,74704,74026,69586,57510,56476
99110,2069,3450,70198,28912,3.42371e+13,1132.47,12895.7,99110,563,674,95660,95262,94391,91232,75269
56402,2073,2988,38890,17512,3.61282e+13,749.664,9197.62,56402,412,553,53414,53277,52908,52240,45719
11259,160,958,7738,3521,3.2516e+13,365.87,2562.67,11259,194,265,9597,8921,6257,4381,2778
45091,1964,2041,31972,13119,3.72767e+13,649.208,6872.75,45091,560,346,43050,43050,43050,43050,42716
28679,795,1200,19630,9049,3.63035e+13,456.006,4160.32,28679,304,306,27479,27425,25766,23500,23680
73732,1405,3229,50524,23208,3.44025e+13,1137.14,10698.9,73732,516,665,70321,69068,57415,41996,44554
35621,4359,35621,0,35621,15.9996,0,35621,35621,35621,1,0,0,0,0,0
11544,355,1254,8085,3459,3.65106e+13,310.331,2988.34,11544,207,277,10203,9698,9011,7968,4368
53990,507,1675,37591,16399,3.35724e+13,989.849,6754.83,53990,422,440,50379,48490,43761,27825,24355
61965,610,2687,42507,19458,3.57102e+13,742.762,8982.06,61965,491,519,58381,56343,41584,31732,23469
79536,1879,2583,55314,24222,3.55453e+13,815.788,9464.39,79536,546,478,76953,76861,76316,75221,70393
7972,774,988,5641,2331,3.66534e+13,238.866,2216.7,7972,209,171,6984,6980,6909,6799,6460
5039,269,588,3372,1667,2.63681e+13,134.259,1393.71,5039,169,120,4451,4378,3799,3118,2102
54579,731,2005,39078,15501,3.75245e+13,794.119,7193.21,54579,503,384,52068,49399,45155,33163,26171
66752,1575,2910,46037,20715,3.32134e+13,886.03,9623.09,66752,523,464,63842,63339,58718,42204,46597
9915,249,996,6947,2968,3.67306e+13,272.123,2435.31,9915,189,189,8711,7601,6688,4923,2845
45048,286,2081,31443,13605,3.35758e+13,957.125,6870.92,45048,405,448,40452,37681,27400,14715,9412
31620,1296,1989,22550,9070,3.74457e+13,690.963,6036.41,31620,466,371,29631,29390,28544,25800,23990
34394,994,2328,23699,10695,3.50312e+13,572.872,6602.09,34394,386,352,32066,31686,29736,25677,22948
93978,1400,3265,66518,27460,3.59545e+13,1177.09,12025.3,93978,653,696,90585,89623,84263,73085,58132
39994,1241,2324,28645,11349,3.6799e+13,627.007,6982.88,39994,513,365,37670,37415,35937,32629,28839
43899,412,2170,30211,13688,3.50166e+13,565.054,6903.21,43899,487,534,40866,38445,27299,20998,14374
58230,1115,2367,40981,17249,3.63233e+13,877.958,8148.89,58230,596,459,55725,55149,47414,35446,36940
31928,665,2063,22371,9557,3.48451e+13,674.063,5948,31928,394,389,29471,28634,25455,19475,15443
26842,551,1920,19204,7638,3.76252e+13,451.063,5370.95,26842,318,449,24768,23778,21844,19181,9685
88795,1634,2564,62341,26454,3.46121e+13,1221.31,10113.9,88795,576,474,86231,85314,83043,77178,70322
71263,2383,3209,49355,21908,3.48496e+13,1184.59,10434.8,71263,576,594,68054,67554,65875,59766,60243
75391,529,3183,52098,23293,3.55584e+13,841.03,10654,75391,563,482,70926,67853,46476,34468,23073
74780,1520,2429,53813,20967,3.7183e+13,946.824,9417.52,74780,626,413,72351,72085,70146,64586,58638
7012,691,761,5077,1935,3.6552e+13,382.084,1868.32,7012,231,172,6251,5961,6174,6100,5979
56013,1146,2848,38048,17965,3.47069e+13,682.171,8458.88,56013,502,435,53165,52457,40251,32211,29980
49883,2363,2479,34609,15274,3.57927e+13,1188.85,8607.28,49883,522,682,47404,47381,47294,47269,46827
31070,1117,1975,21429,9641,3.58442e+13,646.477,5841.29,31070,376,421,29095,28526,27433,25735,21093
21679,1760,1822,15360,6319,3.63602e+13,373.465,4662.46,21679,292,313,19857,19857,19855,19830,19738
5337,83,721,3787,1550,3.94258e+13,323.247,1578.26,5337,175,168,3958,3503,2695,1860,979
5818,347,843,4109,1709,3.5715e+13,260.273,1798.81,5818,217,140,4970,4629,4267,3320,2892
84568,1678,3377,58973,25595,3.61026e+13,1011.33,11897.2,84568,710,562,81191,80565,75539,61442,64245
31728,697,1728,23047,8681,3.64348e+13,626.974,5345.5,31728,468,328,29750,29274,27141,24294,18272
41767,2216,2460,28486,13281,3.57692e+13,551.112,6998.84,41767,496,447,39307,39296,39163,38843,38255
15949,652,1115,10931,5018,3.50298e+13,355.464,3074,15949,294,214,14834,14759,14198,13368,13037
49307,1020,1868,35398,13909,3.59813e+13,764.087,6873.62,49307,410,367,47253,46033,44987,43147,35775
4179,314,739,2789,1390,3.4086e+13,139.679,1488.15,4179,166,145,3440,3312,2671,2321,2024
26121,1663,1824,18847,7274,3.78588e+13,565.518,5172.75,26121,365,290,24297,24289,24235,24297,23688
42622,143,2801,29434,13188,3.58089e+13,749.82,7957.66,42622,523,488,34478,29837,19854,5893,5468
75570,2462,2881,52170,23400,3.583e+13,870.613,9631.62,75570,493,407,72689,72689,72284,71979,70061
5010,486,785,3591,1419,3.73714e+13,234.985,1617.38,5010,186,152,4225,4103,3973,3855,3054
78199,118,3384,53518,24681,3.56227e+13,1050.36,10907.3,78199,627,562,62183,54253,37773,13110,8280
47272,1432,2437,33463,13809,3.71646e+13,670.024,7730,47272,445,478,44835,44550,43769,43426,35804
33080,2203,2237,22901,10179,3.5823e+13,563.301,6334.44,33080,434,318,30843,30843,30836,30843,30774
94491,1675,3217,65058,29433,3.48324e+13,1002.81,11319.9,94491,742,507,91274,90732,86298,76400,67326
69988,116,2647,49179,20809,3.57275e+13,1145.55,9794.37,69988,586,607,56950,49425,34720,10792,7984
77029,644,2898,53324,23705,3.47752e+13,869.414,9982.32,77029,489,576,72850,70686,58649,44272,31198
98596,3499,4054,67239,31357,3.48213e+13,1165.57,13478.8,98596,677,683,94542,94491,93460,91573,91517
99285,95,3226,68874,30411,3.61924e+13,1100.41,11859.6,99285,692,561,76524,66149,48644,19829,11322
88084,4012,4013,61522,26562,3.55044e+13,881.561,13315,88084,631,794,84071,84071,84071,84071,84070
78796,207,2794,55074,23722,3.47098e+13,1207.75,10188.2,78796,569,493,68914,63795,42028,13433,13814
87237,1574,3163,61599,25638,3.60494e+13,1144.19,11558.4,87237,639,559,84074,82561,77310,62982,57004
76469,1421,2374,51184,25285,3.45232e+13,1052.83,9264.58,76469,498,570,74095,73059,68828,56284,59931
63304,2302,2758,44606,18698,3.64046e+13,915.758,9219.25,63304,724,593,60546,60518,59031,55634,57192
66701,1587,1963,48121,18580,3.73183e+13,978.275,7675.68,66701,523,396,64738,64511,63574,62320,60854
10564,578,1163,7284,3280,3.60925e+13,250.428,2729.47,10564,251,234,9401,9307,9013,8439,5303
8965,279,840,6152,2813,3.48862e+13,315.653,2203.12,8965,187,202,7758,6753,5451,3929,3447
69479,1748,2645,47855,21624,3.33424e+13,816.537,8951.08,69479,535,456,66834,66663,65027,62251,59027
58684,1264,2787,41365,17319,3.60715e+13,823.603,9059.8,58684,507,419,55897,55034,50820,37366,36324
4440,440,599,3156,1284,3.98477e+13,193.07,1295.83,4440,147,127,3841,3764,3774,3756,3319
35691,502,2409,25245,10446,3.70948e+13,721.74,6674.45,35691,443,495,32736,31410,23598,18312,8557
43435,2012,2812,30055,13380,3.53266e+13,614.015,8006.58,43435,374,521,40623,40610,40201,40356,36037
96946,1217,2993,68071,28875,3.36834e+13,1157.23,11980,96946,696,452,93225,90986,82697,54012,48246
50550,1334,2578,34977,15573,3.55353e+13,669.874,7912.04,50550,520,385,47972,47782,42597,30301,27276
33859,1683,2166,23791,10068,3.68274e+13,621.744,6436.8,33859,352,420,31693,31678,31451,31544,28641
84214,305,3065,60280,23934,3.65516e+13,1019.15,11263.4,84214,622,542,74134,66759,48468,22254,19089
57202,1582,2652,40277,16925,3.68713e+13,1016.03,8596.47,57202,513,504,54550,54004,50924,45484,39886
91357,3422,3714,62842,28515,3.3593e+13,1233.27,12756.2,91357,678,703,87643,87643,87513,87344,86154
47335,1878,2443,33076,14259,3.59008e+13,730.282,7776.72,47335,579,378,44892,44782,43122,39533,40040
12086,1021,1178,8518,3568,3.70802e+13,371.752,2967.92,12086,307,205,10908,10908,10640,10149,10372
83360,3015,3265,59555,23805,3.74037e+13,932.137,11562.7,83360,582,598,80095,80093,80035,79736,77796
82908,2268,3390,58514,24394,3.53109e+13,1156.66,11325.6,82908,542,525,79518,79022,78866,77697,70246
72026,2248,2702,49751,22275,3.58933e+13,998.237,9116.23,72026,560,467,69324,68902,67802,62635,66180
40972,1415,2040,28938,12034,3.63779e+13,762.772,6695.48,40972,374,381,38932,38778,38617,38343,34608
88556,2354,2545,60292,28264,3.52522e+13,725.527,9088.48,88556,436,446,86011,85939,85920,85992,85046
60765,1781,2584,43741,17024,3.67078e+13,778.215,8740.39,60765,577,400,58181,58101,56327,53581,46549
31618,1828,1924,21161,10457,3.27252e+13,544.016,5754.66,31618,461,330,29694,29694,29668,29590,29534
69514,1980,2463,48380,21134,3.25654e+13,1033.05,8941.9,69514,536,566,67051,67045,66666,65871,58953
22858,630,1078,15470,7388,3.54035e+13,326.783,3290.41,22858,256,230,21780,21753,20415,18014,18580
80153,823,2865,55943,24210,3.38132e+13,850.134,10259.6,80153,492,642,76633,74836,70435,58559,47192
75381,357,3281,52602,22779,3.54356e+13,1095.24,11469.1,75381,618,590,68148,63735,42772,17764,16243
46910,176,2080,32433,14477,3.65477e+13,754.592,7091.98,46910,462,410,39229,34260,23764,10180,10579
69053,586,2659,48034,21019,3.56895e+13,1004.6,9474.95,69053,550,507,64660,61606,45055,34847,22226
4669,415,791,3357,1312,3.7742e+13,202.497,1552.2,4669,153,136,3878,3714,3709,3697,2586
71225,1742,2947,49556,21669,3.51514e+13,818.11,9917.76,71225,475,483,68278,68011,66850,63562,56788
31581,1347,1858,21750,9831,3.3874e+13,545.125,5443.42,31581,383,327,29723,29639,29260,27847,26165
14865,1711,1731,10328,4537,3.70986e+13,363.17,4023.44,14865,417,321,13134,13134,13134,13134,13097
71350,2073,2790,49442,21908,3.58398e+13,800.622,9329.06,71350,529,452,68560,68545,67923,67769,64001
15272,937,1094,10679,4593,3.52625e+13,569.861,3205.07,15272,323,238,14178,14173,13881,13844,13469
74319,1635,2421,51628,22691,3.27711e+13,954.096,8979.96,74319,464,409,71898,71340,70971,69573,58563
87719,2729,3123,61050,26669,3.43743e+13,1283.3,11898.8,87719,696,700,84596,84449,83478,81768,80745
72755,2135,2999,50273,22482,3.47354e+13,786.934,10126.5,72755,597,449,69756,69700,67426,62858,58415
5990,174,338,4113,1877,2.62429e+13,119.226,1080.6,5990,102,94,5652,5594,5103,5016,2837
23541,1074,1562,16714,6827,3.62575e+13,638.444,4506.71,23541,395,254,21979,21582,20505,18687,18677
56606,381,2696,39169,17437,3.47398e+13,793.205,8529.73,56606,554,438,51095,47962,31278,15440,15903
62087,1260,2294,44817,17270,3.7118e+13,1157.84,8516.76,62087,601,473,59517,58232,56105,50686,43189
39243,564,1815,28163,11080,3.41913e+13,619.432,5929.76,39243,403,310,36666,35070,31218,22189,20153
87100,1820,3410,61935,25165,3.63798e+13,979.436,11964.4,87100,522,639,83690,83419,80051,75341,63826
95940,3001,3134,66416,29524,3.43103e+13,1084.31,11427.7,95940,553,513,92806,92806,92781,92753,92162
62543,1716,2826,43193,19350,3.27237e+13,822.939,9183.01,62543,467,498,59717,59526,57446,54854,45243
15397,534,1194,10936,4461,3.65293e+13,489.743,3283.2,15397,346,274,14048,13622,12529,11893,8724
91750,98,3569,64355,27395,3.62319e+13,973.162,12410.1,91750,755,447,72264,62671,44718,14045,7237
76457,3069,3115,54632,21825,3.58968e+13,1133.19,10939.5,76457,648,515,73342,73338,73318,73321,73234
61767,2325,3193,42835,18932,3.47106e+13,903.113,10195.9,61767,637,583,58574,58543,57468,55059,50426
49933,337,2294,34200,15733,3.49608e+13,648.768,7588.97,49933,432,464,45717,42244,28780,17892,14235
23895,1050,1604,16485,7410,3.31389e+13,587.307,4509.06,23895,299,352,22291,21888,21825,21486,18759
27210,677,1755,18809,8401,3.12106e+13,503.779,4756.26,27210,326,278,25335,24745,23937,21072,17051
79498,2416,2694,55676,23822,3.72577e+13,956.182,10011.9,79498,604,471,76804,76802,76395,75488,75063
92097,223,2685,63010,29087,3.09072e+13,1001.61,10432.5,92097,664,462,82955,77711,46332,11840,9605
93422,394,2714,64354,29068,3.47215e+13,1143.49,10762.9,93422,620,518,86009,80871,51995,28395,23352
5847,451,999,3984,1863,3.27155e+13,194.872,1999.96,5847,179,227,4848,4727,4322,4112,2431
13987,479,1209,9839,4148,3.69893e+13,345.622,3119.44,13987,286,336,12776,12351,11644,10399,7467
35821,173,2445,25165,10656,3.55036e+13,629.53,7070.56,35821,495,394,30526,27654,18457,7719,5941
60144,282,3182,41116,19028,3.37274e+13,957.992,9929.69,60144,640,599,53464,49483,31484,12217,10019
43162,157,2349,29003,14159,3.43658e+13,720.49,7410.6,43162,450,552,36143,31728,19283,8007,5529
33477,847,1621,24093,9384,3.57418e+13,760.754,5395.8,33477,440,454,31603,30308,28498,22344,22382
18598,77,1436,12871,5727,3.56342e+13,324.03,3960.69,18598,254,274,13823,11568,9052,2704,2565
92012,751,3047,65328,26684,3.64974e+13,1053.59,11379.5,92012,696,562,87456,84293,64852,44966,31846
74711,548,2830,53212,21499,3.71601e+13,940.707,10252,74711,630,461,70257,68010,51302,36204,22859
14962,962,1354,10512,4450,3.56854e+13,382.852,3440.25,14962,337,296,13608,13524,13304,12718,12348
40167,1805,2334,27838,12329,3.45575e+13,825.033,7139.15,40167,446,400,37833,37630,37224,36427,34938
9099,167,902,6156,2943,3.50067e+13,321.538,2336.07,9099,200,213,7409,6626,5506,4568,1862
79729,2012,3279,55672,24057,3.51897e+13,966.943,11130,79729,671,556,76450,76080,71916,62249,57423
11945,699,1005,8143,3802,3.4632e+13,419.009,2660.29,11945,224,229,10940,10531,10463,10019,9171
18239,549,1494,12832,5407,3.5577e+13,380.927,3891.64,18239,267,293,16742,15938,14453,11089,9453
12535,741,1257,8657,3878,3.13836e+13,184.377,3125.22,12535,158,307,11278,11257,11112,11046,8135
13233,547,1079,9034,4199,3.29418e+13,237.27,2834.89,13233,261,195,12154,12088,11147,9348,9475
42139,358,2283,29063,13076,3.53003e+13,717.461,7257.28,42139,554,456,38175,35446,25471,16551,11555
75811,2373,3708,53507,22304,3.57478e+13,857.881,12043.7,75811,544,537,72103,71962,71202,71168,56556
44716,2081,2177,30986,13730,3.26552e+13,739.768,6988.98,44716,447,399,42539,42539,42520,42539,42421
41235,979,1854,29080,12155,3.6515e+13,727.148,6223.68,41235,496,350,39317,38385,35183,26394,27431
69136,50,2422,48899,20237,3.4403e+13,915.153,9057.56,69136,446,488,49889,40058,31151,7795,5009
35480,1004,2240,24612,10868,3.29676e+13,691.127,6435.75,35480,370,341,33213,32397,30136,24094,18315
56251,626,2791,39068,17183,3.56099e+13,835.608,8886.84,56251,513,469,52454,50571,36227,24689,16628
99383,1933,2541,70518,28865,3.72203e+13,995.737,10150.1,99383,543,468,96842,96602,94303,92555,86021
39872,474,1784,27495,12377,3.16992e+13,908.882,5863.19,39872,350,333,36969,35697,26100,18163,13239
94667,713,3657,65103,29564,3.50827e+13,1025.31,12602.1,94667,545,633,89511,86992,59986,45413,35847
73227,1505,3251,49963,23264,3.44544e+13,926.172,10421.6,73227,659,589,69976,68989,61203,47694,49247
11997,628,996,8151,3846,3.27576e+13,381.998,2700.56,11997,258,236,11001,10783,10357,9385,9633
58577,367,2052,41829,16748,3.68826e+13,1052.25,7671.95,58577,535,427,53269,49568,36006,21996,20474
72945,2026,2463,50896,22049,3.47242e+13,896.164,9019.99,72945,561,405,70482,70442,69467,68409,65673
56504,284,2754,40558,15946,3.69208e+13,1101.05,8837.36,56504,590,497,49763,44505,31609,13045,12515
43779,945,2534,31191,12588,3.71064e+13,763.158,7605.28,43779,454,493,41105,39642,37223,30775,17372
87001,1722,3301,60828,26173,3.53954e+13,1234.92,11838,87001,661,583,83614,82583,77399,65719,58268
58759,1230,2525,40156,18603,3.53183e+13,794.454,8617.21,58759,527,513,56234,55972,47861,40141,37541
87941,2814,3328,61071,26870,3.59722e+13,1057.94,11549,87941,495,528,84613,84526,84367,84233,80592
61821,1182,2533,43387,18434,3.61463e+13,853.995,8451.39,61821,606,397,59131,58087,53276,42235,42897
87111,3663,4009,59621,27490,3.57991e+13,1177.41,13066.9,87111,691,632,83102,83102,82996,82894,80683
42660,353,2043,29089,13571,3.43152e+13,873.204,6740.72,42660,467,451,38885,36898,23503,16528,9424
85807,2866,3030,61597,24210,3.68713e+13,998.057,10969.7,85807,673,525,82777,82742,82703,82716,81853
95897,780,3356,67225,28672,3.47042e+13,1276.5,12267.5,95897,659,566,90327,87236,63943,43898,36799
42002,982,1359,28502,13500,3.48871e+13,634.154,5385.83,42002,366,343,40643,40626,38810,35711,37102
67270,72,2829,47059,20211,3.47244e+13,779.76,9478.34,67270,633,440,50321,41272,32420,9573,6239
29223,2037,2088,19957,9266,3.19021e+13,527.221,5759.04,29223,339,407,27135,27135,27132,27133,27059
52749,599,2664,36620,16129,3.51551e+13,761.213,8115.13,52749,491,500,49411,47850,37685,29426,21854
95516,3131,3543,66775,28741,3.59615e+13,1189.19,12394.2,95516,726,617,91973,91956,91569,90303,89207
29978,1472,1921,20704,9274,3.51213e+13,588.163,5642.82,29978,373,382,28057,27810,27916,27701,25607
26018,350,1965,17947,8071,3.55446e+13,559.803,5422.81,26018,424,302,23192,21702,14354,10169,7309
45379,1453,2225,31732,13647,3.62685e+13,854.442,7257.11,45379,479,443,43154,42855,39934,32967,31927
84172,2659,2678,58428,25744,3.48329e+13,1084.92,9856.59,84172,637,592,81494,81494,81492,81494,81448
94260,3273,3537,66042,28218,3.46737e+13,1164.1,12634.2,94260,615,609,90723,90721,90649,90676,89816
19288,669,1772,13223,6065,3.58676e+13,408.14,4486.81,19288,331,505,17516,17065,16596,15401,10618
18038,288,1642,12503,5535,3.53249e+13,372.586,4158.6,18038,340,338,15918,14355,10482,7803,6067
74647,278,2383,52798,21849,3.68554e+13,1155.65,9307.91,74647,753,475,65276,58330,42182,16876,14213
73826,641,3001,50461,23365,3.48084e+13,1056.91,10058.2,73826,548,480,69378,66353,42093,32488,31644
73000,3458,3692,51521,21479,3.6686e+13,925.448,11868,73000,535,625,69308,69306,69227,69161,68260
54981,1059,2510,38446,16535,3.48443e+13,960.153,8377.41,54981,572,418,52054,50596,46746,31293,27780
25479,140,1985,17846,7633,3.63092e+13,555.793,5545.57,25479,372,427,20930,18345,13003,6269,3907
88331,999,3564,59438,28893,3.39313e+13,1083.63,11911.5,88331,606,671,83946,81541,54970,43674,39528
22395,1796,1857,15852,6543,3.71085e+13,521.517,4832.58,22395,333,282,20538,20538,20532,20538,20422
93197,211,3226,66526,26671,3.73927e+13,1147.12,12071.6,93197,683,514,80008,70914,51016,21329,15061
86546,442,3972,61294,25252,3.69291e+13,1079.85,13117.1,86546,593,610,79260,74987,51492,24664,19589
51371,1023,2307,35909,15462,3.64121e+13,826.647,7473.08,51371,391,381,49002,48273,41253,28778,32233
47939,719,2194,32950,14989,3.57714e+13,582.64,7144.13,47939,458,363,45597,44704,34034,24922,27759
68240,390,2585,47525,20715,3.37958e+13,920.32,9059.99,68240,523,440,62835,59690,39649,24843,14523
83490,660,2523,56352,27138,3.51636e+13,941.546,10001.1,83490,555,636,79267,77207,58375,50934,42601
6124,372,575,4204,1920,3.6636e+13,237.417,1466.02,6124,147,147,5549,5463,4823,3707,4123
70218,2296,2818,47788,22430,3.30945e+13,846.575,10027.4,70218,467,490,67400,67290,67044,66971,62947
91918,2124,2734,65222,26696,3.60399e+13,1207.62,11174.1,91918,824,505,89184,88742,86790,84734,79087
82835,418,3516,55996,26839,3.35781e+13,1082.98,11955.3,82835,678,561,75842,71781,45897,24469,17961
20976,472,1358,14564,6412,3.49407e+13,461.122,4137.06,20976,270,289,19327,17958,16065,11457,10039
28944,517,1810,20060,8884,3.6761e+13,534.396,5309.5,28944,302,361,26712,25273,21234,15591,11911
97576,2808,3584,66980,30596,3.41432e+13,1168.98,13196.1,97576,678,528,93992,93932,92647,89496,87037
35696,315,1836,25779,9917,3.72702e+13,757.062,5969.38,35696,398,357,32148,29431,24717,17831,10195
98169,2747,4520,67250,30919,3.50953e+13,911.517,14866.7,98169,876,597,93649,93468,85233,68770,66304
53763,1211,2767,36882,16881,3.52239e+13,649.762,8589.27,53763,438,382,50996,50546,45302,34261,30393
16309,39,1600,11342,4967,3.66479e+13,372.575,4020.3,16309,296,290,11096,8899,6532,2537,1340
4611,491,616,3067,1544,3.34562e+13,141.087,1358.1,4611,123,172,3995,3994,3986,3986,3538
89752,1010,2494,64260,25492,3.62645e+13,1078.26,10530.5,89752,684,508,86426,84318,76426,53251,46276
21021,348,1407,14802,6219,3.60763e+13,453.505,4148.08,21021,267,255,19272,18147,16170,13623,8511
56886,241,1792,38848,18038,2.97636e+13,843.624,6992.53,56886,365,406,52055,49511,36019,23407,16488
84087,1716,3163,58780,25307,3.63715e+13,1068.26,11299.6,84087,610,499,80924,80163,75859,63766,61499
50442,1095,2824,34501,15941,3.44811e+13,595.348,8458.12,50442,510,491,47618,47023,41529,33822,29819
92149,2840,3729,62733,29416,3.52759e+13,1199.62,12634.4,92149,663,751,88420,88327,86902,82815,83250
14316,1165,1412,9851,4465,3.62103e+13,418.671,3630.8,14316,272,368,12904,12897,12714,12721,11414
63483,572,2694,45082,18401,3.67516e+13,978.52,9173.38,63483,574,532,58303,54422,44867,31988,22661
7627,807,1040,5365,2262,3.66012e+13,229.579,2308.25,7627,219,242,6587,6580,6500,6458,5711
67666,2216,2715,47017,20649,3.57392e+13,982.377,9516.71,67666,570,436,64951,64909,64380,64037,62036
89028,948,3327,63735,25293,3.65502e+13,1073.3,12443.1,89028,710,657,84604,81477,74360,60027,24926
30933,635,1591,22337,8596,3.59948e+13,696.839,5225.59,30933,359,359,28845,27997,26498,20868,18261
50056,1069,2616,34101,15955,3.45804e+13,780.265,8385.05,50056,585,452,47362,46864,39308,33260,30813
37009,1203,2004,25538,11471,3.63128e+13,646.687,6233.76,37009,469,340,35005,34743,32110,25663,26335
94998,1586,2684,67907,27091,3.58992e+13,1102.41,11076.7,94998,712,489,92274,91297,88097,79904,70520
96737,2721,4163,66407,30330,3.43087e+13,961.615,13395.4,96737,613,691,92574,92425,89848,85464,74294
6563,92,540,4590,1973,2.84347e+13,147.167,1415.03,6563,137,102,5576,4520,3300,1293,1294
12115,269,1138,8685,3430,3.63646e+13,292.612,2746.47,12115,288,221,10696,9465,8913,8865,4998
31037,1046,1401,21568,9469,3.13689e+13,708.607,4702.54,31037,334,308,29636,29197,28779,27779,26234
82861,2647,2761,59246,23615,3.65937e+13,962.766,10640.5,82861,565,443,80100,80100,80045,80072,79223
29278,222,995,21323,7955,3.62872e+13,633.885,3949.87,29278,336,280,25683,22433,19100,14040,9888
1043,213,282,713,330,3.37397e+13,51.7651,480.767,1043,71,56,761,754,750,749,673
32257,814,2331,22627,9630,3.70952e+13,605.583,6362.44,32257,449,425,29895,28865,25018,19388,17339
40273,2447,2581,28067,12206,3.51395e+13,628.387,7340.4,40273,508,324,37692,37672,37666,37654,37250
38073,1985,2078,26402,11671,3.61154e+13,709.951,6373.49,38073,458,435,35995,35994,35980,35980,35848
81448,2299,3224,58623,22825,3.74013e+13,930.659,11735.6,81448,546,722,78224,78216,77772,77520,69387
43692,1386,2814,29773,13919,3.44499e+13,655.171,8146.95,43692,485,392,40878,40588,36059,26234,22543
89826,788,3823,61393,28433,3.40708e+13,1019.88,12663.6,89826,653,644,84603,82783,56806,42108,32696
53043,1499,2875,37222,15821,3.62616e+13,606.192,8881.44,53043,363,519,50168,49963,49144,48718,36620
13816,456,909,9497,4319,3.51065e+13,304.06,2548.29,13816,206,237,12907,12770,11558,11853,7432
99313,2600,3343,68806,30507,3.45307e+13,1089.08,11814.1,99313,570,655,95970,95923,94715,92733,88257
48411,2240,2583,32286,16125,3.32967e+13,840.565,7865.16,48411,497,454,45828,45826,45504,45093,44147
94889,2613,3356,66811,28078,3.68356e+13,1047.42,12021.6,94889,653,533,91533,91462,87869,73011,82105
92816,561,3853,61796,31020,3.32384e+13,829.712,12521.8,92816,479,760,87087,83621,44458,23290,23568
72634,674,3100,51173,21461,3.65509e+13,1047.04,10449.4,72634,790,601,68221,66339,47946,38110,28264
2901,243,494,1963,938,3.59566e+13,206.479,1008.4,2901,146,155,2328,2112,2068,1753,1669
30146,1414,1941,20900,9246,3.57907e+13,426.622,5422.27,30146,366,375,28205,28184,26959,25138,23339
14434,831,1039,10048,4386,3.59224e+13,393.169,2987.43,14434,263,285,13395,13386,13192,13172,12583
52249,1579,2242,35937,16312,3.56878e+13,830.552,7458.92,52249,452,395,50007,49835,48027,43583,44387
7307,538,1072,5029,2278,3.20145e+13,195.225,2245.56,7307,170,185,6235,6182,5746,5559,3690
87520,2777,3670,61041,26479,3.54637e+13,1145.16,12619.9,87520,649,639,83850,83800,82963,82526,76691
29535,164,2128,21202,8333,3.596e+13,761.482,6048.5,29535,507,457,24444,21201,16470,7101,5536
87979,504,2656,60936,27043,3.40311e+13,1037.15,10268,87979,578,505,82304,78671,59923,42067,30621
68377,403,2696,46658,21719,3.24966e+13,948.853,9407.12,68377,517,518,62884,59368,40189,28973,20315
18127,157,1114,12752,5375,3.66266e+13,498.931,3227.75,18127,289,219,15040,12810,9629,6777,4739
93367,1389,3496,65080,28287,3.53685e+13,1232.02,12581.3,93367,690,664,89576,87355,75472,54804,47530
94812,2557,3117,65809,29003,3.47576e+13,1082.24,11245.2,94812,552,523,91695,91580,91389,91274,87227
54767,274,2398,38382,16385,3.60479e+13,819.197,8035.82,54767,468,477,49164,44118,32029,18979,10719
56391,2646,2720,38665,17726,3.47745e+13,761.961,8843.43,56391,476,589,53671,53671,53664,53664,53168
93059,1637,3302,64196,28863,3.4626e+13,987.815,11749.2,93059,620,615,89757,88973,82125,69112,64795
59024,2103,2394,40548,18476,3.44965e+13,886.099,8132.33,59024,495,477,56630,56620,56325,56118,54960
7012,496,638,4735,2277,3.48483e+13,256.891,1668.24,7012,171,174,6374,6374,6140,5875,5922
46030,1040,2559,32553,13477,3.57005e+13,739.706,8166.52,46030,558,367,43471,42664,36516,27558,26070
53292,2238,2409,36872,16420,3.57683e+13,602.688,7868.07,53292,479,383,50883,50882,50837,50830,49303
87553,1477,3874,60346,27207,3.56903e+13,855.902,12733.7,87553,714,606,83679,82950,61605,51234,44288
80645,1089,2929,56423,24222,3.6255e+13,1074.42,10500.4,80645,625,528,77284,76032,66353,51226,47313
66425,822,2677,46625,19800,3.38401e+13,1139.36,9563.56,66425,529,632,62225,60677,56162,42091,28163
9323,490,994,6432,2891,3.56188e+13,271.611,2426.54,9323,215,247,8329,8290,7755,7575,4649
61083,2371,3095,42231,18852,3.59409e+13,950.163,10163.5,61083,522,590,57988,57767,57246,56358,51600
94983,2719,3971,64729,30254,3.46998e+13,1201.06,13309.8,94983,698,731,91012,90730,87651,80867,76348
53009,840,2616,38258,14751,3.66859e+13,844.12,8476.93,53009,502,432,49702,47844,42567,28791,23366
29765,1092,1855,20660,9105,3.36532e+13,466.971,5453.33,29765,304,424,27910,27732,27033,25959,20407
21933,534,1904,15264,6669,3.39985e+13,553.362,4944.21,21933,340,512,19764,18956,16689,14896,8394
6286,403,917,4552,1734,3.68146e+13,163.674,1927.04,6286,158,165,5369,5261,5113,5101,2832
26921,366,1718,18739,8182,3.56213e+13,545.444,4996.1,26921,356,270,24583,23060,17243,13555,8925
37599,1143,2303,26225,11374,3.81014e+13,749.926,6832.71,37599,431,430,35296,34564,32122,27205,25502
92062,127,3130,65147,26915,3.50782e+13,866.583,11508.2,92062,746,392,76972,69019,47419,13438,8663
87069,296,3383,61843,25226,3.66055e+13,1198.88,12117.9,87069,678,610,78170,70476,52260,26739,15597
5732,491,872,4078,1654,3.67689e+13,214.46,1807.21,5732,227,173,4860,4785,4714,4659,3596
24059,1908,1967,16861,7198,3.48177e+13,491.684,5276.64,24059,393,394,22092,22088,22056,22048,21929
77286,2946,3045,54273,23013,3.5825e+13,1215.4,10890.8,77286,811,660,74241,74233,74151,74074,74052
86726,1983,2971,61493,25233,3.64879e+13,963.591,10324.1,86726,635,468,83755,83579,81560,78883,74387
25572,848,1633,17862,7710,3.61642e+13,487.658,4953.16,25572,268,335,23939,23489,23225,22918,17454
30020,1888,2008,20812,9208,3.66948e+13,616.583,5780.74,30020,383,460,28012,28010,27996,27996,27750
23008,568,1460,16204,6804,3.34821e+13,517.452,4263.15,23008,297,303,21351,20339,19934,18680,13326
71170,64,2549,49405,21765,3.61329e+13,776.323,9015.21,71170,559,464,52979,45850,32790,12864,8574
90547,249,3282,63164,27383,3.60178e+13,1274.97,11676,90547,777,593,79356,70005,47844,13825,10423
63115,1242,2477,44595,18520,3.64782e+13,923.319,8986.61,63115,429,475,60535,59655,54486,46828,39105
18724,1260,1705,13185,5539,3.61807e+13,490.773,4371.13,18724,319,312,17019,16881,16858,16724,14571
68999,1736,1943,47075,21924,3.55896e+13,878.041,7248.31,68999,441,404,67056,66977,66805,66490,64398
4694,103,491,3165,1529,3.65858e+13,250.957,1246.63,4694,151,148,3518,3070,2429,1739,1649
76808,350,2806,52223,24585,3.51792e+13,952.293,10144.6,76808,598,555,70104,66138,39262,19790,22316
59658,608,2709,41719,17939,3.55178e+13,899.694,8759.85,59658,459,456,55868,54086,39662,28765,18202
68618,1483,2627,47381,21237,3.50089e+13,1020.95,9072.68,68618,453,519,65991,64884,62550,56827,45354
37235,1648,1655,25678,11557,3.19698e+13,760.596,5361.01,37235,362,284,35580,35580,35579,35580,35578
47731,542,1711,34134,13597,3.72986e+13,819.633,6291.64,47731,452,345,43935,39994,31871,23111,20314
56611,1130,2371,39290,17321,3.42019e+13,931.498,8317.86,56611,516,493,54058,52960,50113,42408,31273
10912,1173,1352,7949,2963,3.66099e+13,333.327,3050.81,10912,277,213,9560,9558,9457,9458,9174
26979,670,1642,18509,8470,3.16733e+13,526.259,4763.67,26979,388,291,25226,24555,23358,16783,15695
45683,1790,2268,33077,12606,3.74148e+13,986.667,7500.36,45683,531,366,43415,42943,42908,42433,39288
8285,786,1081,5650,2635,3.38611e+13,213.319,2407.52,8285,310,168,7204,7168,6992,6518,6372
13105,681,1086,8964,4141,3.16718e+13,254.604,2782.67,13105,200,252,12019,11908,11309,10600,8745
87844,2182,3222,60566,27278,3.39786e+13,1002.87,11706.8,87844,761,602,84622,84557,80209,68360,71234
23526,394,1704,15970,7556,3.35282e+13,295.013,4621.98,23526,327,366,21803,21313,16573,14489,8970
13743,233,1287,9820,3923,3.8586e+13,356.536,3190.84,13743,245,231,11811,10514,9173,6947,4479
53818,456,2666,38274,15544,3.7003e+13,925.498,8736.88,53818,568,616,48889,45768,33151,22904,11590
68781,890,2696,49083,19698,3.62193e+13,925.039,9911.17,68781,550,572,65367,64123,58168,47786,29862
94189,2434,3091,65829,28360,3.58998e+13,1233.23,11526.5,94189,617,590,91098,91045,90092,89118,82844
48528,829,2505,32944,15584,3.43669e+13,580.918,7768.75,48528,441,362,46023,45318,32146,24743,22565
11885,408,858,7967,3918,3.46928e+13,453.952,2562.99,11885,236,254,10668,9751,8878,6943,7168
66899,2593,2729,47105,19794,3.69208e+13,819.442,9369.17,66899,534,503,64170,64170,64127,63978,63423
64188,1387,2508,44886,19302,3.39209e+13,1171.88,8834.76,64188,503,498,61504,59603,57361,48254,44524
76395,2689,3061,53999,22396,3.64942e+13,901.913,10762.6,76395,495,690,73334,73332,73202,72975,70249
59537,1666,2235,41907,17630,3.61003e+13,669.357,7564.82,59537,383,374,57302,57202,57133,56956,54489
17591,1189,1405,12005,5586,3.58406e+13,491.136,3860.2,17591,260,345,16186,16181,15961,15734,15521
41708,2097,2232,28539,13169,3.58716e+13,772.207,7048.87,41708,437,461,39476,39444,39417,39406,38884
84598,806,1213,58148,26450,2.78779e+13,726.819,6325.54,84598,427,325,83364,82801,79885,76737,64243
92051,243,3664,63745,28306,3.58102e+13,1020.99,12199.6,92051,565,530,79619,70428,45132,18202,12856
48957,1381,1775,33658,15299,3.08839e+13,712.099,6308.11,48957,464,359,47182,46807,46451,45545,41263
60848,1751,2268,42701,18147,3.49213e+13,785.986,8038.67,60848,511,436,58580,58516,58358,58244,55482
32312,1609,2004,22286,10026,3.54248e+13,539.697,5891.01,32312,461,359,30308,30289,29554,29104,26688
81264,769,3279,57688,23576,3.68099e+13,1185.39,11442.4,81264,723,545,76456,73743,53395,38835,29580
93445,2383,3713,63809,29636,3.37301e+13,994.351,12695.4,93445,689,672,89732,89631,84631,70985,65176
64378,385,2091,44735,19643,3.32907e+13,1267.71,8212.18,64378,457,523,59129,56437,43331,30177,14266
19923,148,1793,14075,5848,3.72828e+13,566.875,4625.87,19923,389,373,16319,14398,11087,6051,3463
29540,556,2051,20933,8607,3.76746e+13,560.454,5820.34,29540,392,363,27022,25083,21540,15771,9217
83650,1761,3559,56374,27276,3.41851e+13,807.861,11268.4,83650,576,507,80091,79822,75985,67752,65699
77893,1080,3254,54606,23287,3.63875e+13,998.591,11526.5,77893,592,623,74199,72386,62167,46894,38450
62486,2519,3033,43472,19014,3.38067e+13,543.36,9628.03,62486,500,470,59453,59428,59228,59283,55903
23830,183,1908,16954,6876,3.62209e+13,525.244,5078.98,23830,316,388,20316,18271,15228,8057,4495
48668,256,2477,35071,13597,3.63664e+13,807.778,8183.91,48668,620,465,42884,38220,29007,14956,9786
77957,1480,3016,53338,24619,3.53422e+13,1017.39,10446.7,77957,536,538,74941,74232,65596,50092,44759
55619,1047,2364,39378,16241,3.65683e+13,851.309,8085.49,55619,558,441,52992,52069,47788,39331,30915
19275,518,1125,13149,6126,3.58407e+13,431.876,3476.44,19275,307,264,18144,17408,16302,14336,13880
6767,889,929,4458,2309,3.19503e+13,206.89,1978.68,6767,234,169,5838,5838,5838,5838,5809
3357,286,617,2318,1039,3.46325e+13,185.844,1194.92,3357,148,123,2720,2505,2449,2283,1933
60034,3021,3261,41603,18431,3.48286e+13,980.443,10031.4,60034,740,653,56773,56756,56319,55684,55377
81707,285,2783,56834,24873,3.61356e+13,883.968,9826.86,81707,556,427,73555,64334,43471,18430,19133
98639,1741,2715,70859,27780,3.67138e+13,1055.31,11263.4,98639,621,523,95924,95389,93432,88014,73781
14889,344,1750,10360,4529,3.66918e+13,323.472,4023.72,14889,393,269,12974,11890,9405,7501,5609
5088,24,925,3500,1588,3.45556e+13,104.389,1742.21,5088,203,118,3137,2241,1757,1173,590
89192,721,3122,62626,26566,3.47029e+13,1078.37,11505.8,89192,774,469,84391,81830,60692,45261,29521
69233,2090,2676,48858,20375,3.62007e+13,1026.81,9714.65,69233,622,387,66557,66441,64253,61420,61248
82833,973,2539,60003,22830,3.7252e+13,928.709,9997.61,82833,593,545,79822,76722,71247,55212,39442
26498,538,1909,17975,8523,3.25739e+13,510.602,5350.4,26498,349,322,24409,23576,17767,13694,10329
82829,947,3340,56805,26024,3.45039e+13,1114.14,11504.2,82829,633,651,78590,76059,61195,45260,36596
12454,1121,1226,8604,3850,3.65581e+13,399.452,3193.17,12454,287,238,11228,11147,11188,11211,10885
23415,836,1553,15971,7444,3.2552e+13,369.643,4365.84,23415,340,354,21862,21633,20907,19573,16518
76823,2482,2583,52442,24381,3.47681e+13,980.171,9432.85,76823,581,433,74240,74240,74171,74106,74054
94112,140,3533,64443,29669,3.52647e+13,1075.75,12272.3,94112,599,459,77687,67935,46282,16599,11732
68667,2010,3121,47936,20731,3.44614e+13,1098.11,10280.6,68667,542,597,65546,64641,63133,57274,51548
84481,2532,2962,60462,24019,3.68422e+13,1132.18,11037.2,84481,739,482,81519,81479,81068,80799,78288
72526,1586,4458,49500,23026,3.55283e+13,988.975,13019.2,72526,746,893,68017,66916,58042,48266,25937
58072,1716,3323,40838,17234,3.51621e+13,992.52,10076.5,58072,698,594,54749,53925,50379,41897,36619
42497,737,1852,29591,12906,3.66099e+13,725.986,6321.71,42497,414,389,40296,38755,35712,27124,24015
11761,61,1096,7884,3877,3.08364e+13,221.372,2799.63,11761,208,271,8945,6996,5628,3615,1945
5134,41,563,3468,1666,3.5127e+13,295.83,1401.92,5134,163,169,3448,2749,2151,891,731
18762,76,1043,12734,6028,3.57269e+13,545.223,3424.51,18762,263,288,14344,12272,8525,3574,2800
58092,1571,2875,40240,17852,3.56429e+13,718.707,9052.82,58092,584,397,55217,54906,51409,40477,39544
60642,130,2576,42391,18251,3.38592e+13,912.988,8522.68,60642,511,405,51199,46108,30875,9509,7230
9008,276,963,6232,2776,3.57993e+13,334.986,2323.01,9008,244,195,7621,6774,5990,4777,3571
21059,592,1617,14284,6775,3.40763e+13,462.098,4436.61,21059,269,379,19385,18707,17743,15560,9761
97443,2951,3485,67719,29724,3.56157e+13,1001.29,12376.8,97443,647,558,93958,93945,93297,92442,88914
84581,2146,3240,58452,26129,3.40791e+13,1059.81,11429.2,84581,561,511,81341,80951,80038,76972,71874
64982,2612,3270,45447,19535,3.66337e+13,889.875,10339.6,64982,587,558,61712,61641,61363,60507,58608
17047,936,1991,11708,5339,3.51091e+13,357.494,4682.44,17047,295,564,15056,14919,14299,14178,7969
47367,365,2510,33307,14060,3.47542e+13,878.694,7916.91,47367,549,448,42867,39871,31157,22682,10161
14894,1121,1223,10653,4241,3.68252e+13,398.213,3296.74,14894,317,239,13671,13657,13572,13258,13334
70628,1502,3347,48678,21950,3.5022e+13,793.997,10836.8,70628,655,503,67281,66855,62593,55026,48808
47678,680,3387,32833,14845,3.38995e+13,632.641,9430.67,47678,667,491,43912,42215,31019,26007,14824
65927,1472,2337,45683,20244,3.2238e+13,959.911,8498.55,65927,552,436,63590,63190,59375,51169,45541
86526,1943,3438,61318,25208,3.65129e+13,887.76,12654.2,86526,538,665,83088,83015,81347,79058,55001
9399,944,1320,6632,2767,3.72666e+13,309.887,2805.17,9399,294,215,8079,8060,7871,7167,7153
68732,1719,3124,48597,20135,3.65117e+13,939.776,10047.6,68732,725,462,65608,64689,59261,45097,47561
8446,976,982,6017,2429,3.608e+13,272.447,2290.06,8446,198,183,7464,7464,7464,7464,7453
32061,1546,2093,22378,9683,3.41954e+13,807.46,6161.54,32061,405,430,29968,29773,29435,28060,27510
49388,1287,2336,34796,14592,3.65971e+13,811.947,8034.96,49388,550,449,47052,46504,43408,36966,32179
82719,1882,2987,56517,26202,3.35078e+13,1002.28,10786.8,82719,543,621,79732,79438,77057,72618,60793
63773,1412,2617,43387,20386,3.53373e+13,790.997,9373.37,63773,527,424,61156,61033,55379,43545,36088
46647,274,2307,31771,14876,3.51422e+13,994.113,7539.97,46647,468,516,40887,37102,20620,8617,10419
80557,216,3537,56493,24064,3.48693e+13,1100.91,11858.4,80557,698,734,70345,64002,44260,16599,12443
24549,243,1496,17199,7350,3.56146e+13,451.012,4448.48,24549,327,355,21704,19413,14788,11011,6143
76023,2639,3271,53468,22555,3.64772e+13,1009.07,11384.5,76023,649,655,72752,72672,72276,72093,66049
37716,1220,2499,25867,11849,3.34873e+13,752.331,7133.94,37716,457,408,35217,34241,33267,29653,25972
88261,2581,3287,60351,27910,3.47431e+13,1173.2,11237.5,88261,629,584,84974,84566,83493,80232,80131
14496,891,1250,10224,4272,3.78275e+13,362.852,3206.45,14496,234,213,13246,13104,13121,13085,12076
49903,716,2344,34603,15300,3.5233e+13,852.481,7830.17,49903,499,495,46386,44209,35739,27047,21615
15671,1041,1775,10715,4956,3.63243e+13,288.323,4279.5,15671,295,407,13896,13838,13590,13705,10316
41182,1549,2245,28497,12685,3.45609e+13,883.577,7021.48,41182,415,434,38937,38393,37404,34093,30996
58943,126,2426,42521,16422,3.74415e+13,909.035,8514.42,58943,556,519,47419,41633,31780,10167,7971
48488,2186,2447,32631,15857,3.37573e+13,922.469,7682.84,48488,496,495,46041,45913,45751,45334,45140
60882,1034,2610,43230,17652,3.67858e+13,862.548,9153.68,60882,596,408,58014,56093,50506,34729,29952
85423,1128,3386,59568,25855,3.47581e+13,873.587,11327.9,85423,612,571,81972,80407,69530,50449,45077
72759,2142,2727,51616,21143,3.62618e+13,930.66,9786.33,72759,472,555,70032,69975,69740,69732,66427
92661,1734,2841,63727,28934,3.18198e+13,995.164,11128.8,92661,648,472,89820,89494,84413,65900,64477
7228,356,1021,4955,2273,3.48581e+13,263.921,2253.62,7228,221,215,6087,5684,4524,3230,2541
43581,366,2115,30359,13222,3.62687e+13,892.048,6912.72,43581,448,426,39926,37690,27172,19811,12425
44771,1254,1998,30859,13912,3.53721e+13,851.039,6737.46,44771,448,389,42773,42440,40249,35596,35796
27656,1427,1871,19344,8312,3.40559e+13,393.173,5220.94,27656,395,247,25785,25729,25454,25379,23421
72425,1111,3121,49478,22947,3.53835e+13,1013.9,10249.6,72425,533,579,69041,67535,49554,37939,38655
3467,554,573,2547,920,4.03533e+13,168.827,1127.47,3467,136,111,2894,2878,2894,2894,2876
38308,1302,1824,27035,11273,3.64989e+13,816.323,6116.37,38308,414,363,36484,36071,35446,33678,32693
65709,1195,3279,44960,20749,3.56335e+13,749.79,10255.5,65709,429,611,62430,61540,55326,38558,31278
74257,1824,3090,51332,22925,3.32061e+13,1036.08,10807.6,74257,662,664,71167,70483,66303,52999,47679
41428,852,2050,28059,13369,3.4571e+13,686.834,6597.08,41428,418,408,39368,38592,29601,24199,25931
97161,3615,3910,68655,28506,3.65119e+13,1124.32,13655.9,97161,740,851,93251,93248,93079,93223,92000
57986,1809,2816,39139,18847,3.46012e+13,566.104,8866.53,57986,461,544,55170,55069,53955,52596,48108
10236,878,886,6902,3334,2.75836e+13,138.649,2106.99,10236,190,140,9350,9350,9350,9350,9340
6176,667,6176,0,6176,15.9974,0,6176,6176,6176,1,0,0,0,0,0
22344,629,1576,16010,6334,3.66885e+13,621.603,4451.58,22344,342,314,20430,19900,18135,14907,12526
58424,180,2812,40325,18099,3.46181e+13,762.15,8866.58,58424,519,370,48946,43110,29683,12519,10517
94545,3196,3223,66037,28508,3.57525e+13,1324.48,11762.4,94545,663,545,91322,91322,91316,91322,91303
81668,734,2805,58027,23641,3.6653e+13,1076.22,10632.2,81668,556,649,76998,74250,63793,49491,24158
36188,1373,1606,25108,11080,3.29652e+13,725.328,5557.45,36188,422,333,34582,34185,34018,33305,32533
57942,99,2558,40271,17671,3.58248e+13,1020.63,8501.52,57942,480,495,46132,40025,27769,8622,7403
29894,1352,2272,21055,8839,3.64021e+13,478.076,6053.33,29894,371,421,27622,27523,26310,25356,19777
57757,2001,2769,41474,16283,3.69613e+13,1156.71,9110.23,57757,696,474,54988,54376,53610,50679,49942
4143,155,502,2847,1296,3.54467e+13,228.298,1165.54,4143,179,149,3341,2881,2754,2727,1581
45428,1322,2607,31445,13983,3.49887e+13,759.304,8034.33,45428,409,464,42821,42052,40231,37056,31013
57168,961,2469,38576,18592,3.45837e+13,761.445,8161.9,57168,425,531,54635,53122,47533,38187,29604
67969,1336,2633,47546,20423,3.63632e+13,879.935,8987.86,67969,531,528,65336,64685,57189,41342,43006
50769,2525,2552,35091,15678,3.58144e+13,742.555,7943.67,50769,412,473,48217,48216,48216,48217,48183
23348,1663,1843,16288,7060,3.59214e+13,469.531,5052.61,23348,448,291,21505,21505,21347,21222,20884
28684,277,1637,20438,8246,3.71964e+13,538.402,4924.27,28684,358,292,25621,22897,16510,11070,6069
77337,993,2988,55415,21922,3.65886e+13,1341.98,10838.1,77337,671,570,72784,69920,60297,43605,41505
92834,2155,2751,65946,26888,3.54829e+13,1019.65,10986,92834,762,440,90083,89973,88522,86071,81333
40253,1255,2555,28214,12039,3.52897e+13,589.779,7531.12,40253,374,529,37698,37301,36233,34846,25275
18367,949,1389,13155,5212,3.70675e+13,491.359,3870.33,18367,316,251,16978,16948,15869,13477,13482
35598,1490,2009,25054,10544,3.59541e+13,547.067,6220.09,35598,407,382,33589,33561,32601,32077,28673
50887,1091,2333,35755,15132,3.54214e+13,1001.99,7864.44,50887,486,432,48251,47023,44700,36521,30426
88462,455,3649,62479,25983,3.66859e+13,1186.51,12333.7,88462,702,577,81002,76839,52632,33417,21233
46825,1600,2323,32408,14417,3.36669e+13,599.056,7271.77,46825,377,537,44502,44424,43597,41910,35840
30304,698,1602,21396,8908,3.68154e+13,609.279,4942.26,30304,397,319,28501,27111,23368,16914,17312
75772,389,2934,52236,23536,3.49981e+13,866.471,9547.88,75772,552,474,70817,68253,39947,18117,21164
81227,1494,3015,58305,22922,3.67475e+13,1084.31,11330,81227,847,453,78092,77117,67908,47335,40862
95080,2289,3195,67635,27445,3.64942e+13,924.157,11772,95080,768,479,91885,91845,88807,81051,78746
93157,700,2839,65293,27864,3.5761e+13,1106.39,10669.9,93157,604,485,87752,84389,58832,40787,46686
29626,747,2492,20498,9128,3.38797e+13,381.687,6596.72,29626,279,540,27134,26719,25565,25110,10766
10905,600,748,7416,3489,3.26867e+13,316.128,2189.72,10905,212,202,10157,10147,9987,10007,9364
1367,139,319,1010,357,3.15089e+13,117.613,569.454,1367,107,71,1024,884,884,840,602
93972,3614,3640,65361,28611,3.62896e+13,1070.57,12398.7,93972,712,565,90332,90332,90320,90324,90302
70204,958,2874,49728,20476,3.67334e+13,1100.81,9915.3,70204,650,677,66393,64590,57257,45526,37342
56505,681,2023,39392,17113,3.54517e+13,697.914,6769.89,56505,417,357,54152,53200,45541,31741,31095
6396,500,1006,4629,1767,3.86437e+13,228.989,2066.8,6396,207,219,5390,5157,5172,5107,3476
99435,370,4172,68225,31210,3.47386e+13,1017.62,14194.1,99435,749,544,89599,83453,54144,22180,18824
31792,613,2057,22216,9576,3.63124e+13,609.441,6082.11,31792,409,380,29161,27555,23869,17979,14108
79747,2893,3605,57023,22724,3.68175e+13,908.1,12361.6,79747,878,435,76142,76141,75161,74090,66862
61170,542,2809,43039,18131,3.70777e+13,894.977,9599.11,61170,503,508,56800,54203,39016,25656,22176
95400,505,2962,67756,27644,3.64796e+13,1199,11687.4,95400,685,525,88706,83911,61929,43066,27635
38781,1111,1940,27228,11553,3.66356e+13,751.313,6496.12,38781,493,438,36841,36374,33365,26826,29284
95031,1044,3227,66265,28766,3.563e+13,1084.66,11747,95031,767,518,91144,88994,71908,52142,53591
94694,3656,3769,65860,28834,3.57376e+13,1174.6,13115.8,94694,600,644,90925,90925,90870,90852,90637
31419,144,2217,21645,9774,3.30222e+13,484.934,6101.7,31419,349,433,26791,24138,15862,4822,3582
38131,978,1707,26239,11892,3.5689e+13,501.224,5485.72,38131,331,367,36424,36041,33915,31865,25873
58137,499,2280,40273,17864,3.15732e+13,975.295,8082.18,58137,379,478,54165,51901,40466,28391,16632
4449,510,556,2953,1496,3.39795e+13,249.775,1322.83,4449,146,163,3893,3893,3881,3858,3809
92530,1361,2993,64968,27562,3.64529e+13,1187,11108.8,92530,668,536,89248,87805,80031,55477,63206
59315,451,2547,40983,18332,3.56939e+13,778.406,8350.01,59315,585,449,54591,50311,34428,22656,19826
71992,658,2618,50848,21144,3.5683e+13,915.15,9891.29,71992,617,479,67899,64986,56193,41109,29368
29277,811,1598,20315,8962,3.17539e+13,678.074,4828.59,29277,341,357,27455,26690,26653,24757,20938
21602,778,1919,15230,6372,3.73117e+13,524.8,5035.41,21602,341,324,19542,18910,18093,15729,11800
36835,2412,2594,25474,11361,3.50455e+13,518.691,7370.47,36835,487,328,34241,34239,34199,34226,33521
59252,2146,2848,41041,18211,3.50193e+13,856.591,9475.97,59252,523,638,56404,56192,55319,54222,48992
59401,1081,1942,41423,17978,3.25113e+13,753.717,7397.53,59401,482,371,57459,56468,54611,49544,36647
39357,367,2006,28671,10686,3.67223e+13,963.483,6646.85,39357,501,410,35263,32907,25320,17290,13555
3473,208,553,2367,1106,3.5422e+13,213.788,1154.2,3473,144,153,2778,2490,2344,1956,1797
75438,3379,3597,51465,23973,3.41038e+13,1071.05,11368.4,75438,606,620,71841,71841,71746,71803,71043
68564,2241,2583,48671,19893,3.52013e+13,1149.65,9208.38,68564,647,491,65981,65925,65382,64424,62366
12907,792,1205,9079,3828,3.56812e+13,337.683,3050.45,12907,279,205,11702,11588,11311,10776,9895
89051,1440,3608,61790,27261,3.45674e+13,907.046,12288.6,89051,701,481,85443,84592,68959,53279,51665
90088,2687,3541,64563,25525,3.70843e+13,1316.37,12557.4,90088,697,609,86547,86097,84671,80815,74669
9218,388,808,6267,2951,3.42647e+13,339.282,2130.2,9218,191,186,8363,7889,7236,6321,5922
25590,211,1828,17888,7702,3.59566e+13,489.701,5296,25590,283,362,21844,19396,13553,6125,4439
96537,1654,3812,67460,29077,3.43404e+13,1197.24,13515.5,96537,696,667,92725,91538,80321,58875,52436
21629,1383,1483,15239,6390,3.63451e+13,561.517,4310.71,21629,322,263,20146,20146,20146,20146,19894
96650,2415,3461,67008,29642,3.39604e+13,863.436,12528.1,96650,790,403,93189,93133,89900,81413,76088
4849,295,538,3329,1520,3.40887e+13,259.842,1311.45,4849,159,148,4219,3644,3718,3706,3050
34659,64,2263,24316,10343,3.66057e+13,640.531,6632.66,34659,360,366,25329,21474,15319,5500,3423
76677,2826,3185,52843,23834,3.47384e+13,1003.02,10681.7,76677,550,579,73492,73489,73276,73068,71885
67587,1627,3013,47718,19869,3.58405e+13,817.319,9797.3,67587,469,566,64574,64213,62530,60822,47477
35579,2027,2132,24702,10877,3.42983e+13,677.834,6361.89,35579,406,488,33447,33445,33421,33381,33023
22824,304,1711,15719,7105,3.54991e+13,523.499,4834.8,22824,409,340,20070,18033,12676,8974,6041
71918,1384,1845,51771,20147,3.73542e+13,982.956,7922.83,71918,588,430,70073,69774,67682,65003,64870
11528,659,1313,7891,3637,3.50692e+13,369.754,3131.3,11528,221,283,10215,9840,9381,8713,6854
32646,1132,1436,23901,8745,3.71699e+13,788.808,5044.39,32646,447,308,31210,30652,30379,30281,29225
43189,1638,1946,31179,12010,3.73769e+13,852.67,6492.47,43189,426,367,41243,40942,41060,40901,38711
93391,1516,3466,66477,26914,3.76068e+13,1093.25,12365.6,93391,693,725,89925,88747,80699,64194,41067
73835,580,2673,50960,22875,3.16124e+13,932.589,9871.32,73835,582,510,69564,67399,54783,41088,31837
74380,1701,2931,51910,22470,3.5494e+13,891.627,10437.4,74380,539,612,71449,71305,68785,64591,58723
55994,2802,3301,38880,17114,3.54491e+13,794.244,9655.95,55994,564,496,52693,52643,52482,52600,50617
44716,1117,2529,31278,13438,3.63662e+13,805.319,7879.48,44716,484,502,42106,41171,36973,26069,22048
17204,427,1190,11801,5403,3.63265e+13,399.29,3490.49,17204,278,264,15773,15107,14172,11250,9782
75194,1826,3145,52270,22924,3.56164e+13,1126.72,10824.7,75194,686,605,72049,71162,67551,58604,57791
12373,374,1267,8553,3820,3.59967e+13,316.989,3175.75,12373,241,256,10985,10319,9806,8771,4053
23233,919,1241,16062,7171,3.48571e+13,638.146,4028.9,23233,290,243,21992,21611,20855,19409,18896
44178,79,2391,30343,13835,3.4324e+13,579.774,7180.35,44178,430,356,33697,28319,20791,6454,3951
10358,574,752,7151,3207,3.51063e+13,349.358,2248.97,10358,248,247,9606,9589,9109,8898,8852
62412,382,2415,43284,19128,3.26646e+13,977.98,8420.6,62412,511,527,56970,53938,40436,28157,19177
65334,2353,2774,45504,19830,3.52487e+13,912.718,9277.03,65334,537,478,62560,62387,62142,61753,60228
36141,533,2279,25317,10824,3.37296e+13,615.916,6483.67,36141,513,288,33356,32184,20599,15698,10630
97029,1427,3217,67994,29035,3.48075e+13,1192.91,12448.4,97029,772,604,93495,91969,82262,58587,54934
58415,2849,2877,41181,17234,3.65152e+13,917.452,9204.85,58415,625,416,55538,55538,55538,55538,55528
26251,846,1771,17839,8412,3.60862e+13,406.356,4889.33,26251,312,274,24480,24281,22624,18611,17101
11331,595,1271,7879,3452,3.59002e+13,285.567,3066.82,11331,349,301,10060,9875,9360,8562,6693
37120,622,1940,25372,11748,3.30572e+13,582.416,6012.13,37120,389,380,34901,33816,28161,20771,19729
49150,1111,1711,34088,15062,3.51653e+13,741.12,6429.15,49150,431,368,47420,47004,43677,38025,37538
88282,2064,3631,61189,27093,3.57715e+13,1173.25,12494.4,88282,704,592,84651,84175,80078,71854,60299
75069,349,3147,53398,21671,3.66424e+13,1011.94,11036.9,75069,561,608,67271,61140,45701,25222,11090
66148,1217,2453,46857,19291,3.64324e+13,1114.29,9061.2,66148,504,462,63368,61615,58508,48325,41997
78724,2585,2768,55234,23490,3.54458e+13,1060.49,10179,78724,709,481,75956,75952,75754,75502,74219
46872,1591,2127,33860,13012,3.65843e+13,899.238,7275.92,46872,526,384,44745,44352,43600,41326,40235
87940,660,3038,59853,28087,3.48746e+13,977.232,11002.5,87940,662,547,82615,78335,53572,38162,32481
5769,138,1071,4210,1559,3.46247e+13,161.633,1996.14,5769,229,144,4558,4058,3087,1876,1220
86856,2270,3603,60912,25944,3.55457e+13,1233.27,12037.3,86856,688,516,83253,82543,80084,71601,67867
29951,912,2468,20722,9229,3.51196e+13,593.602,6559.78,29951,370,517,27483,26561,25025,19746,16479
16729,1761,1870,11612,5117,3.36649e+13,320.05,4358.16,16729,392,262,14859,14859,14858,14840,14604
79263,978,2595,57129,22134,3.72579e+13,1258.19,10025.6,79263,646,503,75533,73465,65651,45137,40806
55966,473,2515,40152,15814,3.49495e+13,812.929,8352.97,55966,544,510,51844,48917,36659,24760,17636
24960,442,1793,17770,7190,3.67559e+13,544.446,4944.2,24960,436,248,22740,21773,17921,14325,9778
71708,59489,71708,0,71708,15.9998,0,71708,71708,71708,1,0,0,0,0,0
83335,1697,3072,59263,24072,3.69562e+13,1296.83,11067.4,83335,686,537,80183,78931,74769,62628,61530
83727,3651,3725,57801,25926,3.55537e+13,967.314,12407.5,83727,583,589,80002,80002,79987,79991,79808
23133,1588,1885,15926,7207,3.60159e+13,455.486,5091.9,23133,398,372,21248,21171,21092,21060,19660
20419,322,1268,14383,6036,3.6895e+13,558.254,3812.06,20419,331,246,18128,16912,12855,9403,7285
96375,1493,4172,66817,29558,3.52977e+13,1137.48,13640.1,96375,628,873,92080,90568,83396,69075,50742
26545,1580,1814,18206,8339,3.3884e+13,605.499,5160.21,26545,306,383,24731,24488,24640,24596,23175
97727,273,2901,68406,29321,3.49549e+13,1154.84,10860.2,97727,624,518,87816,79124,53508,21337,19495
65697,3165,3506,45768,19929,3.66049e+13,808,10748,65697,476,720,62191,62164,62065,62059,60514
5264,278,734,3774,1490,3.885e+13,226.477,1569.83,5264,160,160,4464,4047,4078,4069,2362
53113,1770,2817,37134,15979,3.66515e+13,732.897,9039.16,53113,433,585,50296,50194,49222,48904,38254
18180,517,1842,12964,5216,3.42841e+13,445.381,4579.68,18180,363,281,16145,15328,11730,8557,6459
16189,1163,1376,11411,4778,3.59091e+13,444.766,3623.94,16189,358,242,14813,14812,14758,14690,14073
82804,2542,3168,57623,25181,3.46971e+13,880.684,10665.6,82804,550,611,79636,79602,78821,78375,73717
20443,1732,1752,14292,6151,3.57955e+13,471.06,4449.76,20443,312,277,18691,18687,18689,18687,18657
61797,1682,2892,43141,18656,3.48803e+13,811.462,9126.17,61797,574,421,58905,58491,57101,54233,50348
69195,882,2808,47403,21792,3.53807e+13,854.589,9321.47,69195,514,482,66134,64763,49276,38010,35136
96038,2977,3960,67765,28273,3.60848e+13,1176.51,13891.6,96038,787,747,92078,91873,91161,90413,83956
12747,1219,1228,8892,3855,3.67491e+13,362.458,3065.54,12747,259,291,11519,11519,11517,11516,11511
50206,1000,2128,35732,14474,3.77512e+13,838.173,7399.6,50206,546,482,47914,46687,39870,30298,33763
71979,1961,3342,49488,22491,3.58339e+13,957.767,10780.4,71979,488,565,68637,68317,66932,62635,54883
25148,384,1890,18215,6933,3.72674e+13,560.703,5228.83,25148,462,319,22634,21509,18573,13420,8931
80799,1586,2851,56203,24596,3.64201e+13,1115.45,10335.5,80799,620,547,77945,76503,71730,60451,54360
73257,1119,1922,52457,20800,3.76715e+13,920.871,7988.49,73257,542,396,71235,69419,66049,59110,54824
21729,1355,1478,15042,6687,3.43367e+13,554.08,4175.7,21729,352,274,20251,20250,20211,20191,20018
92196,262,2950,64862,27334,3.62361e+13,1124.71,10751.4,92196,692,411,82610,73480,51576,20643,16304
39356,997,1919,27380,11976,3.51272e+13,849.824,6459.57,39356,379,425,37230,36343,34461,28854,21453
68554,1511,3393,47882,20672,3.63666e+13,1007.3,10951.8,68554,648,684,64999,64115,55292,45316,38890
68487,1565,2108,48331,20156,3.61791e+13,1055.03,8166.36,68487,513,449,66379,65941,64959,63339,60636
71695,2196,2714,50957,20738,3.5749e+13,1004,9889.4,71695,613,544,68981,68914,68027,66102,64577
99523,1996,3516,69763,29760,3.6001e+13,1322.24,12708.5,99523,715,651,96007,94983,92738,87061,75854
13162,180,936,9026,4136,3.63656e+13,279.33,2541.92,13162,250,202,11243,9688,8296,6043,5636
1720,71,488,1139,581,3.04431e+13,95.2233,805.67,1720,141,75,1144,917,805,426,342
12323,343,1186,8542,3781,3.56553e+13,399.64,3043.95,12323,273,248,10759,9723,9086,7591,5310
81608,1994,2790,56496,25112,3.46962e+13,934.448,9853.98,81608,528,531,78818,78613,75023,64255,69663
64391,1765,2829,44798,19593,3.34427e+13,970.755,9592.33,64391,598,487,61562,60972,57837,48034,44819
99109,963,3354,67828,31281,3.35813e+13,1020.34,12538.8,99109,654,525,95317,93775,71776,58066,44616
32979,146,1832,23110,9869,3.64438e+13,596.105,5840.9,32979,365,365,26987,23542,17547,7393,5620
80430,2830,3057,55730,24700,3.36761e+13,853.363,11175.2,80430,422,660,77373,77364,77324,77238,74632
18572,99,1186,13134,5438,3.58384e+13,391.321,3301.17,18572,272,194,14154,11957,9513,3152,2568
69552,2273,3011,49972,19580,3.70688e+13,925.535,10465.8,69552,539,515,66541,66369,66102,65908,57126
57674,142,2583,39361,18313,3.47338e+13,654.19,8953.16,57674,380,574,47989,42578,28484,9907,8871
10726,530,1183,7485,3241,3.28307e+13,238.467,2709,10726,204,168,9543,9350,8770,8644,4733
87825,1991,3262,60290,27535,3.47504e+13,1203.77,11707.1,87825,556,532,84563,83657,78664,66956,65966
93808,858,3406,63368,30440,3.45279e+13,906.149,11921.7,93808,623,533,89783,87714,53705,39783,42644
34456,788,2027,23785,10671,3.53561e+13,438.422,6065.21,34456,391,329,32429,32055,26834,21521,16970
23552,1218,1744,16176,7376,3.55331e+13,581.971,4943.89,23552,406,344,21808,21633,21133,19914,18261
41618,198,2930,29250,12368,3.43356e+13,466.125,8142.78,41618,329,663,36313,33185,24520,16805,6289
12798,210,912,9033,3765,3.6522e+13,337.039,2583.56,12798,284,225,11073,9663,9185,7131,6457
23814,97,1778,16271,7543,3.58179e+13,288.887,4557.55,23814,311,302,18643,15861,11250,4480,2482
29699,726,1778,21116,8583,3.61354e+13,671.348,5487.7,29699,357,343,27521,26542,25299,21704,15421
59001,1390,2482,41348,17653,3.30448e+13,785.397,8726.6,59001,452,450,56519,56201,54505,51978,39959
20401,1246,1311,13782,6619,3.51545e+13,483.41,3969.4,20401,366,367,19090,19090,19052,19046,18962
70267,2489,2769,48660,21607,3.46685e+13,1045.97,9835.79,70267,618,424,67498,67474,66905,65834,65716
17697,621,1514,12462,5235,3.56347e+13,454.564,3905.56,17697,332,268,16128,15711,14270,13746,9296
69288,1912,2509,48107,21181,3.43951e+13,993.38,9220.62,69288,540,494,66779,66504,65555,63519,58779
20613,364,2050,14380,6233,3.69486e+13,499.635,5172.22,20613,390,508,18137,17192,14511,12086,5237
26944,1778,2024,18389,8555,3.33538e+13,562.893,5442.57,26944,306,379,24920,24914,24821,24833,24058
14220,909,1455,10427,3793,3.72877e+13,334.349,3479.4,14220,271,205,12765,12615,12428,12422,9779
96287,3656,3683,67783,28504,3.64916e+13,1094.35,13207.4,96287,797,554,92604,92604,92598,92574,92508
64166,2565,2772,44917,19249,3.42642e+13,1015.31,9408.84,64166,522,564,61394,61392,61248,61087,60654
37732,2337,2424,25807,11925,3.35769e+13,586.215,6909.96,37732,386,416,35308,35308,35308,35307,34306
76161,61,2384,52799,23362,3.28341e+13,929.872,8875.18,76161,504,456,57164,44459,34290,9279,6012
49056,922,1789,34331,14725,3.23475e+13,941.242,6584.05,49056,456,512,46797,45090,42891,36293,28842
38001,1269,2607,26468,11533,3.56507e+13,508.523,7228.73,38001,519,331,35394,35250,30140,22244,23204
76111,378,2336,52051,24060,3.40771e+13,1017.03,9284.56,76111,577,600,71190,68463,47833,34741,22963
36687,1705,1810,26447,10240,3.6182e+13,938.872,6124.36,36687,482,325,34877,34875,34802,34778,34650
43427,1908,1978,30095,13332,3.53751e+13,895.808,6636.69,43427,445,389,41449,41449,41437,41441,41339
47910,1623,1971,32866,15044,3.26635e+13,777.851,6808.58,47910,429,406,45939,45804,45355,45016,42421
56673,436,2491,39733,16940,3.64892e+13,834.377,8352.29,56673,590,440,51446,47854,33460,22326,19390
68028,355,1770,46958,21070,3.1926e+13,970.824,7187.63,68028,443,401,62934,60383,48798,30428,20199
61070,2388,2571,42284,18786,3.57393e+13,891.099,8247.3,61070,508,412,58499,58401,58424,58422,57844
58169,1310,2454,41047,17122,3.66226e+13,838.821,8010.03,58169,469,426,55715,54930,51816,45615,44621
18289,572,1497,12964,5325,3.56082e+13,468.502,3898.47,18289,334,270,16636,16193,14770,12705,10549
71193,1180,3515,49237,21956,3.48593e+13,1171.51,11267.2,71193,481,602,67110,65620,57648,38343,32772
35232,1827,1980,24292,10940,3.17761e+13,595.519,5982.9,35232,305,434,33252,33252,33241,33251,32898
32077,1134,1262,22140,9937,3.67319e+13,720.558,4988.25,32077,363,412,30815,30811,30621,30413,29757
60385,1425,2857,42965,17420,3.73719e+13,1135.6,9667.94,60385,650,537,57415,56283,52839,43898,37926
17149,31,1351,11932,5217,3.56734e+13,427.233,3775.39,17149,242,326,10990,8462,6742,2300,1428
47585,277,1674,33136,14449,3.56496e+13,658.902,6035.44,47585,408,331,42564,37585,26787,17100,14250
45654,2808,3337,32855,12799,3.73073e+13,768.617,9300.13,45654,396,639,42317,42253,42087,42098,39498
21400,228,1499,14720,6680,3.13422e+13,484.032,4106.9,21400,248,323,19081,18008,13046,7177,4262
40754,1927,2181,28847,11907,3.62754e+13,791.033,6902.79,40754,440,386,38573,38405,38473,38493,37403
85220,602,3352,59608,25612,3.62933e+13,1041.53,11595.4,85220,710,563,79625,76017,54111,35521,27110
20766,483,1403,14578,6188,3.62949e+13,442.161,4078.43,20766,288,274,19232,18103,16504,12844,7661
6469,267,882,4542,1927,3.68205e+13,242.214,1941.04,6469,181,196,5452,4971,4859,4685,2280
39939,663,3067,28552,11387,3.76685e+13,554.692,8422.38,39939,385,635,36644,35421,32327,27065,10466
90904,2304,3045,62271,28633,3.46324e+13,1004.91,11323,90904,526,571,87859,87770,86410,83706,80921
18753,985,1306,13190,5563,3.2403e+13,661.164,3695.68,18753,357,266,17447,16927,16965,16668,14047
88212,788,3676,60474,27738,3.51449e+13,963.379,12158.2,88212,580,661,83683,81513,55543,38773,29406
83367,577,2997,57803,25564,3.59619e+13,1080.7,10834.7,83367,572,537,78277,74957,51890,34048,25817
15630,167,1335,10913,4717,3.41917e+13,327.389,3470.52,15630,222,303,13497,12324,9221,6932,2746
23196,1512,1658,16254,6942,3.76945e+13,527.343,4677.06,23196,428,267,21538,21538,21491,21524,21039
80908,2675,3233,55422,25486,3.48942e+13,1087.11,11379.3,80908,745,662,77675,77665,76453,74030,73033
71900,2250,2642,50482,21418,3.56251e+13,860.103,9825.06,71900,528,462,69258,69230,69130,69064,66621
95954,1728,2979,67659,28295,3.62637e+13,1128.15,11734.2,95954,565,526,92975,92452,89369,83959,77579
33621,392,2273,23195,10426,3.54226e+13,560.783,6507.88,33621,478,383,30466,28788,20117,13277,10758
75544,1793,3867,51984,23560,3.50834e+13,880.611,12114.2,75544,719,549,71677,71092,66745,56763,48169
86993,1992,2873,63223,23770,3.6965e+13,1381.54,11587.7,86993,802,568,84120,83610,79534,68708,68463
50983,235,2456,35441,15542,3.49375e+13,801.162,7916.81,50983,489,519,45285,42022,29037,14035,10895
37731,2556,2968,26344,11387,3.7136e+13,585.773,7985.21,37731,366,546,34763,34759,34649,34733,32829
30858,215,2198,21194,9664,3.38648e+13,554.678,6228.94,30858,501,356,26294,23976,15912,7322,5288
42660,1036,2600,29092,13568,3.45211e+13,560.243,7155.5,42660,416,417,40060,39658,29189,22126,23431
30494,48,1963,21197,9297,3.59959e+13,562.293,5673.43,30494,400,354,21726,17459,12642,5035,2150
66526,488,2776,47071,19455,3.51995e+13,879.819,9940,66526,473,509,61859,59255,47736,33433,18422
43089,1136,1820,30521,12568,3.70883e+13,932.281,6318.2,43089,486,390,41094,40726,38597,36089,30768
54520,2197,3003,37798,16722,3.4145e+13,785.226,9263.13,54520,626,505,51517,51493,50218,44256,42070
32932,1638,2235,22905,10027,3.56688e+13,594.679,6122.44,32932,360,373,30697,30532,30322,29951,26421
91924,396,2614,66020,25904,3.73141e+13,1155.48,10544.7,91924,626,529,84129,79281,58743,38474,26675
99915,1572,3950,69611,30304,3.58979e+13,1162.24,13484.9,99915,760,803,95965,94751,72529,58714,52235
43338,1207,2138,30778,12560,3.61441e+13,699.561,7086.21,43338,421,389,41200,40678,39410,36523,31363
47970,1243,2653,33478,14492,3.51863e+13,773.445,8148.8,47970,454,453,45317,44680,41223,36080,28182
15981,861,1152,11277,4704,3.64779e+13,545.084,3359.03,15981,297,248,14829,14504,14357,14350,13265
44617,1288,2392,31492,13125,3.73441e+13,840.998,7754.62,44617,484,529,42225,41375,39108,33251,30641
44242,1504,2287,31095,13147,3.60304e+13,886.599,7361.11,44242,508,393,41955,41538,39491,35137,33342
86371,434,2365,60097,26274,3.27661e+13,1295.12,9682.02,86371,585,469,79727,75840,52595,34807,20913
5847,459,720,4062,1785,3.58033e+13,256.327,1685.46,5847,215,160,5127,4938,4877,4263,4303
48252,907,2687,33578,14674,3.6919e+13,623.727,8060.06,48252,495,373,45560,44782,35277,28599,25589
58213,1726,2337,40844,17369,3.49428e+13,844.909,7918.34,58213,565,369,55876,55699,55217,53223,50655
4355,166,466,3012,1343,3.54965e+13,229.352,1148.81,4355,126,137,3527,2961,3037,2916,1740
60517,2458,2958,42139,18378,3.50667e+13,828.298,9869.88,60517,448,522,57559,57552,57359,57166,53263
59833,1842,2683,41117,18716,3.26351e+13,838.136,9076.85,59833,586,401,57150,56821,54909,50654,45910
88782,2317,3451,63294,25488,3.64659e+13,1111.34,12616.9,88782,651,565,85331,85062,84167,83727,69022
85248,756,2572,61975,23273,3.70701e+13,1202.43,10720.2,85248,797,490,80397,76909,66913,45684,39378
10526,666,957,7607,2919,3.58793e+13,259.517,2288.18,10526,254,162,9569,9548,9522,9296,8741
93291,2625,3705,64322,28969,3.51038e+13,1150.34,12277.9,93291,675,637,89586,89101,87076,81943,79502
1232,137,315,890,342,3.39336e+13,124.728,529.836,1232,108,69,893,757,775,838,488
39463,1026,2129,27686,11777,3.48328e+13,613.827,6692.58,39463,414,414,37334,36766,34773,31515,19787
2151,192,491,1440,711,3.65266e+13,102.353,886.234,2151,93,118,1660,1534,1520,1548,954
34787,574,2231,23945,10842,3.64131e+13,582.982,6502.81,34787,399,347,32224,30970,18736,14782,11340
86382,885,3003,59794,26588,3.47128e+13,1066.79,10901.4,86382,566,556,82459,80480,63074,44951,39557
60952,1494,2324,41987,18965,3.49998e+13,550.563,8342.15,60952,373,458,58628,58493,58043,57882,49240
79013,1155,2235,55611,23402,3.66325e+13,1171.22,9251.8,79013,570,457,76414,74775,68753,61896,49880
76865,1487,3053,56095,20770,3.69322e+13,1023.38,11078.9,76865,714,434,73812,73084,67943,55085,54986
94028,3036,3454,65453,28575,3.61266e+13,1097.22,12399.5,94028,724,532,90574,90541,89689,89092,86798
50650,1145,2441,36326,14324,3.69e+13,839.596,7955.65,50650,477,518,48159,46841,45354,43033,25809
7836,209,598,5258,2578,2.4788e+13,131.893,1531.27,7836,151,118,7238,7117,6833,6461,5105
31794,190,1840,21767,10027,3.53991e+13,626.247,5543.57,31794,401,386,26537,23279,16020,7799,7459
93018,2532,3299,66148,26870,3.63191e+13,948.495,12492.9,93018,803,618,89719,89680,87324,79327,79635
9535,549,803,6547,2988,2.91285e+13,389.576,2168.88,9535,178,203,8724,8312,8236,8060,6792
87973,2115,2334,60434,27539,3.44746e+13,666.326,9266.06,87973,496,422,85639,85624,85576,85489,82425
32540,707,2326,22697,9843,3.58138e+13,508.454,6553.74,32540,456,323,30214,29508,25842,18898,15396
11250,350,1015,7876,3374,3.01513e+13,185.948,2384,11250,179,162,10235,10034,9213,9201,3090
5299,84,706,3630,1669,3.56216e+13,211.246,1576.05,5299,123,150,3930,3371,2383,956,757
69144,2671,2973,50024,19120,3.71739e+13,999.314,10027.3,69144,701,594,66171,66166,65961,65662,63846
72752,342,2630,50328,22424,3.46517e+13,793.475,9747.99,72752,649,506,66651,62477,41994,26357,19430
55444,2435,3112,38364,17080,3.50007e+13,862.071,9598.17,55444,574,559,52332,52096,51579,48015,48234
73104,1613,3488,50521,22583,3.56467e+13,1079.34,11232,73104,519,680,69616,68308,65183,56215,43367
48995,1125,2369,34840,14155,3.555e+13,935.988,7708.1,48995,456,397,46416,45429,41973,34553,29849
15605,713,1243,11338,4267,3.74857e+13,593.291,3334.12,15605,304,262,14238,13882,13420,12914,10086
56774,1103,2465,40047,16727,3.58391e+13,697.208,8329.26,56774,538,416,54309,53639,49000,35636,35196
8445,232,766,5663,2782,2.72355e+13,168.454,1923.49,8445,171,229,7587,7372,6308,4672,3475
98045,589,3018,69511,28534,3.62322e+13,1120.72,11539.6,98045,557,574,92357,88320,62272,42506,38998
70007,914,3160,49180,20827,3.63932e+13,953.024,10324.5,70007,568,534,66352,64492,47139,32779,21161
10088,76,1370,7087,3001,3.67513e+13,252.286,3028.13,10088,251,351,7559,6510,4785,3089,1140
8515,183,891,6067,2448,3.91461e+13,357.624,2177.42,8515,224,216,7064,6351,5283,4018,2681
74871,1842,2295,52463,22408,3.42507e+13,1106.99,9270.35,74871,623,440,72576,72552,71146,69743,63416
55433,2499,2512,38745,16688,3.62612e+13,717.931,8434.4,55433,421,455,52921,52921,52920,52919,52914
75589,1148,3358,52467,23122,3.50996e+13,1054.94,11211.3,75589,573,589,71905,70390,63417,52710,33509
42380,1392,2137,29218,13162,3.55238e+13,825.447,6950.55,42380,427,417,40243,39435,38864,37117,34612
74798,2011,2743,52457,22341,3.55841e+13,1101.55,10342.9,74798,650,486,72055,71607,70051,65690,64369
31265,1354,1729,21914,9351,3.59462e+13,503.187,5296.21,31265,346,448,29536,29512,29439,29072,25445
18725,574,1584,12963,5762,3.35619e+13,407.099,4080.97,18725,325,276,17079,16355,15214,12206,9706
51222,2503,2506,35966,15256,3.5705e+13,695.738,7853.07,51222,411,383,48716,48716,48716,48716,48716
11577,1021,1064,8392,3185,3.73853e+13,257.238,2604.75,11577,205,213,10513,10513,10511,10501,10397
41543,981,2390,28868,12675,3.62533e+13,634.526,7258.69,41543,377,396,39153,38476,35806,29678,24617
72755,2057,2659,50475,22280,3.49426e+13,882.926,10120.9,72755,482,553,70096,70096,69731,69453,62761
72809,2325,2347,51474,21335,3.66307e+13,1042.26,8997.93,72809,587,465,70462,70462,70461,70459,70410
35016,612,2140,24971,10045,3.62271e+13,633.515,6344.27,35016,395,392,32440,31481,28049,18099,15828
26902,133,2253,18501,8401,3.60292e+13,513.478,6003.59,26902,418,457,21843,19205,12963,4804,4276
99971,1356,3043,70306,29665,3.6754e+13,1299.35,11679.4,99971,723,569,96573,94798,84155,62411,63515
77982,2559,2718,53132,24850,3.38774e+13,582.113,9112.14,77982,512,392,75264,75264,75238,75230,73106
21225,144,1237,14777,6448,3.05427e+13,524.284,3538.3,21225,271,214,18961,17987,10992,5988,2365
64834,620,2946,45811,19023,3.71556e+13,1194.02,9808.37,64834,604,540,60275,57840,42628,32646,21126
48359,1657,2378,33934,14425,3.68347e+13,793.938,7574.05,48359,526,431,45981,45846,44878,41630,39918
31568,1042,1704,21537,10031,3.35918e+13,456.567,4914.45,31568,370,298,29864,29710,28393,27478,22904
27669,800,1694,19583,8086,3.6734e+13,709.934,5124.55,27669,392,269,25767,25074,23339,20090,16551
24502,1167,2155,16588,7914,3.42671e+13,505.323,5479.14,24502,424,308,22347,22112,21144,17941,17289
38048,1753,2203,26474,11574,3.39641e+13,562.048,6565.26,38048,398,347,35845,35804,35706,35613,31680
47525,692,2085,33716,13809,3.47119e+13,709.367,7286.77,47525,401,488,44889,43810,40489,37798,22374
36436,301,2149,24708,11728,3.44409e+13,587.958,6341.37,36436,335,345,32627,28909,20848,11457,11005
94260,1079,3870,66036,28224,3.5083e+13,1023.2,13458,94260,516,702,89772,87574,78545,56277,33097
13413,217,1457,8974,4439,3.10187e+13,188.991,3282.37,13413,221,237,11765,11230,9673,8445,5431
70425,2730,3228,49177,21248,3.5192e+13,849.908,10740.8,70425,511,661,67197,67186,66989,66999,64023
99507,1694,4144,67620,31887,3.50388e+13,1036.76,13702.3,99507,687,636,95363,94266,79708,62723,60743
84914,1929,3006,58506,26408,3.48246e+13,808.625,10240.4,84914,603,476,81908,81639,79206,72782,70904
19646,322,1604,13946,5700,3.54033e+13,432.003,4331.26,19646,303,315,17361,16094,14335,10722,6645
30721,268,1738,21055,9666,3.27059e+13,454.477,5339.05,30721,362,325,27422,24889,19628,13908,8541
16944,1316,1388,11361,5583,3.3976e+13,451.57,3848.96,16944,292,371,15556,15556,15533,15531,15388
37324,1958,2223,25742,11582,3.44255e+13,438.867,6577.13,37324,421,340,35101,35089,35060,34997,33014
15622,570,1127,10872,4750,3.52835e+13,529.516,3235.91,15622,253,248,14344,13754,13065,11808,9445
38668,1771,2255,27033,11635,3.60845e+13,698.901,6674.23,38668,463,352,36413,36402,35950,35475,34121
29622,1028,1921,20648,8974,3.56784e+13,547.71,5725.14,29622,450,384,27701,27626,25956,22373,20045
44833,767,2294,31312,13521,3.41476e+13,607.292,7314.14,44833,466,447,42263,41701,39173,31158,22546
57269,1642,2473,40481,16788,3.65206e+13,1116.38,8329.88,57269,535,461,54796,54316,51902,44391,46625
28796,813,1762,20213,8583,3.62275e+13,414.985,5111.72,28796,309,304,27034,26796,24622,19937,17766
47913,2078,2612,32684,15229,3.44782e+13,899.226,8238.02,47913,520,501,45301,45214,44754,42543,42754
77533,493,3307,53478,24055,3.60263e+13,875.468,10797.6,77533,671,531,72641,70249,45119,30885,21360
41209,1000,1890,28946,12263,3.46221e+13,1000.41,6667.43,41209,469,367,38685,37271,36298,30911,27885
31485,229,1764,21922,9563,3.66771e+13,706.444,5431.52,31485,328,336,27128,24296,18080,11357,6592
87048,506,2459,60134,26914,3.19602e+13,1069.55,9731.48,87048,506,555,82355,79518,66585,45750,22856
67131,459,2652,47450,19681,3.72207e+13,1203.62,9322.82,67131,569,556,61192,57501,40858,29781,20320
54211,683,2677,37710,16501,3.61037e+13,839.697,8665.78,54211,533,542,50552,48419,39276,27479,24781
76768,1457,2290,53540,23228,3.50112e+13,769.348,8836.04,76768,486,439,74478,74438,65565,52061,48162
8722,473,1015,5927,2795,3.2868e+13,374.555,2462.88,8722,292,227,7648,7197,6578,5885,5026
69105,1044,2656,49996,19109,3.74106e+13,1074.44,9876.73,69105,723,586,65600,63346,59841,50898,25563
82782,2289,3231,58619,24163,3.71617e+13,1222.42,11827.7,82782,642,531,79551,78989,77072,72635,63879
60898,2090,2909,43422,17476,3.73082e+13,677.871,9444.41,60898,537,687,57989,57962,57620,55827,39862
4144,509,717,2845,1299,3.54378e+13,181.858,1425.78,4144,187,134,3427,3416,3301,3322,2840
32951,485,1928,22785,10166,3.33531e+13,518.985,5794.35,32951,326,359,30595,29686,24831,18516,12795
35583,419,1866,24670,10913,3.62042e+13,647.233,6005.07,35583,330,426,32685,31157,25717,20187,10980
61658,498,1709,44592,17066,3.73707e+13,924.798,7209.77,61658,516,373,57175,53538,47758,31841,24599
39685,276,1901,28254,11431,3.76557e+13,756.16,6049.23,39685,464,341,34497,31187,22574,13920,11842
94797,1925,3280,66594,28203,3.63179e+13,1287.44,11911.9,94797,590,683,91517,90741,87038,79288,68345
91006,393,2555,64352,26654,3.36248e+13,1063.24,10212.4,91006,608,491,84039,79118,54366,30177,24261
45233,1900,2300,31466,13767,3.51745e+13,879.172,7500.39,45233,462,379,42933,42904,42407,41728,40068
93053,3255,3628,63627,29426,3.5883e+13,907.649,12187.8,93053,658,511,89425,89406,88925,88462,87247
19040,522,996,13693,5347,3.6219e+13,576.771,3259.51,19040,285,244,17748,17279,16149,15877,12591
58076,2124,2616,39146,18930,3.40538e+13,961.706,8696.41,58076,496,463,55460,55458,54635,53290,52410
70817,1268,2800,47821,22996,3.46737e+13,978.23,9741.36,70817,483,575,67945,66890,62698,51475,43797
54644,1289,2242,37734,16910,3.39958e+13,656.783,7719.5,54644,376,449,52402,52194,49944,47871,38458
98424,1102,3323,70462,27962,3.65541e+13,1021.5,12946.9,98424,684,601,94698,91589,84345,64148,46680
27958,953,1318,20034,7924,3.67738e+13,598.775,4335.32,27958,294,296,26640,26397,26363,25408,21432
51304,1833,2375,36248,15056,3.62924e+13,958.136,7803.82,51304,624,414,48929,48768,48283,46185,45013
29993,994,1951,20625,9368,3.56271e+13,503.88,5405.16,29993,365,323,28042,27832,25989,21368,22838
61047,1835,2511,41957,19090,3.31459e+13,808.665,8216.5,61047,384,424,58536,58388,57263,56057,52904
75485,965,3056,53527,21958,3.48398e+13,1072.4,10880.9,75485,578,551,71502,68890,63222,46520,31252
64617,1181,2401,46255,18362,3.71575e+13,770.467,8580.88,64617,612,397,62216,61823,58267,51622,47530
31250,306,1876,22660,8590,3.60953e+13,759.573,5766.2,31250,374,323,27760,25587,22192,17734,7868
22138,1500,1783,14955,7183,3.46023e+13,536.856,4747.26,22138,354,324,20355,20355,20234,19764,19777
8633,926,1102,6241,2392,3.55427e+13,247.18,2401.35,8633,268,177,7531,7527,7474,7142,7178
14206,521,1300,10054,4152,3.64569e+13,330.985,3338.07,14206,262,291,12906,12493,11268,11377,6626
93664,1471,3318,65865,27799,3.61749e+13,1151.69,12021.9,93664,615,578,90338,89068,81624,66004,63060
88643,212,2883,63400,25243,3.68716e+13,982.658,10917.6,88643,643,449,75890,67206,49988,18219,14822
66520,598,2816,45779,20741,3.5765e+13,768.799,9107.28,66520,611,517,62832,61170,42548,34259,28605
97199,2505,2943,69776,27423,3.72975e+13,1178.48,11360.9,97199,666,533,94256,94245,93562,92512,90187
12411,205,986,8701,3710,3.68487e+13,370.291,2675.17,12411,260,253,10308,9034,7912,6480,3473
88820,1874,3645,62541,26279,3.50844e+13,1146.91,13138.8,88820,648,730,85175,84395,81368,72469,58127
22722,1091,1902,15468,7254,3.5352e+13,402.997,5020.45,22722,345,306,20820,20710,20147,19010,15134
11769,63,1059,7885,3884,3.43593e+13,254.178,2685.34,11769,252,187,8823,7431,4949,1586,1882
66564,1445,2930,47118,19446,3.67114e+13,872.919,9964.33,66564,691,410,63634,62953,58534,44851,44427
86301,812,3124,60476,25825,3.61081e+13,981.268,11088.6,86301,582,629,82281,80628,62853,48230,30821
61490,1071,2915,44563,16927,3.79155e+13,746.285,10097.3,61490,519,615,58575,57544,55232,49497,29843
7164,729,1029,4972,2192,3.7016e+13,271.49,2178.18,7164,212,243,6135,6100,6060,5983,5278
56507,2573,3507,39932,16575,3.56585e+13,712.728,10378.5,56507,851,520,53000,52995,51581,47549,46443
56795,689,2301,40824,15971,3.70503e+13,1089.46,8506.67,56795,586,514,52997,51262,43500,29423,19978
42302,88,2101,28681,13621,3.46711e+13,483.654,6418.45,42302,400,352,31422,27111,19862,7462,5458
53499,2221,2343,37481,16018,3.60898e+13,821.473,7923.94,53499,495,359,51156,51156,51096,51100,50528
36990,517,1644,25470,11520,3.10857e+13,729.751,5335.54,36990,332,355,34616,33559,29909,22501,16233
70710,936,3072,49876,20834,3.67584e+13,1027.63,10230.8,70710,588,464,67125,64876,50564,34435,28660
10927,463,1376,7643,3284,3.70105e+13,273.27,3061.31,10927,243,186,9551,9312,6777,4892,3779
10978,249,979,7753,3225,3.58542e+13,391.734,2550.92,10978,255,212,9377,8375,7441,5812,3369
86076,1371,3305,59700,26376,3.56925e+13,941.628,10890.9,86076,529,524,82771,81384,71368,57374,51515
4626,823,984,3470,1156,3.54151e+13,116.377,1756.56,4626,205,133,3642,3637,3635,3637,3282
24891,766,1684,17632,7259,3.60667e+13,530.885,4788.47,24891,332,332,23147,22680,21128,18029,17266
39638,69,2298,28020,11618,3.65282e+13,660.347,7046.69,39638,500,351,29307,24745,18970,5412,3665
5889,376,843,4107,1782,3.4708e+13,165.565,1745.69,5889,232,128,5046,4910,4603,3524,3089
3756,600,641,2505,1251,3.5674e+13,133.02,1291.12,3756,147,136,3115,3115,3107,3113,3023
68518,2855,3450,47253,21265,3.43013e+13,914.963,11022.1,68518,582,570,65068,65050,63703,61040,56922
78876,405,2915,54696,24180,3.55818e+13,1059.14,10689.2,78876,648,500,72333,68803,45472,27230,20366
15371,715,1529,10744,4627,3.64545e+13,404.013,3883.58,15371,359,272,13842,13487,12857,10776,9655
3720,176,655,2591,1129,3.54548e+13,193.248,1284.83,3720,122,143,2925,2745,2234,1832,1439
4117,415,427,2832,1285,3.61053e+13,223.255,1071.35,4117,132,130,3690,3690,3687,3688,3685
16777,419,1757,11594,5183,3.64614e+13,342.625,4170.86,16777,335,338,14920,14216,12207,10306,7692
99776,2145,3695,71160,28616,3.76424e+13,1288.43,13464.4,99776,661,626,96081,95482,91004,82614,77225
84429,448,3341,57937,26492,3.54031e+13,1121.89,11608,84429,588,575,77703,73711,49684,25249,22803
76436,844,2001,51899,24537,3.48962e+13,742.08,8765.69,76436,488,525,74237,72793,64494,48974,37872
93084,1874,3005,65739,27345,3.68313e+13,1086.95,11520.7,93084,651,571,90079,89710,85896,79971,73644
46332,2254,2835,32623,13709,3.65351e+13,686.459,7940.19,46332,555,490,43497,43455,43142,42036,40880
17397,1183,1875,12283,5114,3.77948e+13,393.553,4384.21,17397,364,239,15522,15471,15017,14464,12133
39975,201,1794,27144,12831,3.45816e+13,419.909,5670.8,39975,363,292,34271,28982,21620,10237,12719
3174,19,545,2165,1009,3.49999e+13,148.758,1106.04,3174,111,123,1690,1101,998,356,242
3179,13,518,2236,943,3.91923e+13,168.863,1060.69,3179,154,122,1787,1270,1096,774,319
21314,124,2077,15204,6110,3.60445e+13,391.596,5284.38,21314,278,429,17061,14827,11993,4925,2603
93065,1552,2758,64472,28593,3.39459e+13,1187.69,11046,93065,606,462,90058,89120,84894,70317,66625
88911,1777,3197,62824,26087,3.65082e+13,1077.17,11215.6,88911,621,484,85714,85049,79156,63469,59919
75393,2740,2875,53289,22104,3.55215e+13,949.978,10237.9,75393,690,546,72518,72518,72412,72137,72022
42878,324,2297,30300,12578,3.61782e+13,744.685,7314.87,42878,443,443,38359,35355,27738,21496,12325
64821,1567,2633,44371,20450,3.37228e+13,871.593,9374.71,64821,542,477,62188,61816,58931,49341,48466
45185,2292,2550,31510,13675,3.62361e+13,782.198,7804.28,45185,466,419,42635,42633,42362,41946,41000
8665,689,729,6021,2644,3.66175e+13,319.499,1998.02,8665,189,201,7936,7936,7932,7928,7853
22386,1244,1282,15354,7032,3.40623e+13,516.008,4063.19,22386,269,389,21104,21104,21104,21104,21055
57777,1329,2964,40019,17758,3.58146e+13,781.003,9437.87,57777,647,426,54813,54117,46685,33537,31762
89982,991,3313,62265,27717,3.44579e+13,1102.15,11973.3,89982,541,603,85767,84088,72243,50938,44042
75597,836,2332,54060,21537,3.63486e+13,1100.48,9327.63,75597,601,432,72150,69800,59905,40782,41706
73975,703,2827,51302,22673,3.43681e+13,1103.75,9936.22,73975,620,542,69304,66917,48466,37776,27862
40964,2141,2343,28956,12008,3.70645e+13,834.652,7402.6,40964,514,506,38621,38449,38417,38264,37526
43467,92,1596,29686,13781,3.59143e+13,547.308,5193.62,43467,345,298,33012,27796,21090,8693,7138
12768,1244,1260,9137,3631,3.76141e+13,280.033,3066.98,12768,230,233,11508,11508,11508,11508,11501
26862,1117,1749,19048,7814,3.53341e+13,623.633,5114.76,26862,430,288,25113,25086,24009,22745,21978
45927,1776,2478,31173,14754,3.3926e+13,765.362,7874.41,45927,423,513,43449,43331,42398,39553,35165
50238,135,2536,34810,15428,3.37425e+13,928.469,8037.75,50238,520,501,42603,38395,26182,7596,4947
22768,969,1353,15674,7094,3.5208e+13,399.314,4036.8,22768,296,296,21415,21384,20467,20486,17715
79005,1614,2735,55343,23662,3.61323e+13,875.104,10049.3,79005,520,537,76270,75885,72179,66672,55307
50127,2322,2698,34349,15778,3.45006e+13,667.979,8670.33,50127,455,558,47429,47388,47265,47210,43599
96820,1468,2775,68065,28755,3.59964e+13,1242.27,11177.2,96820,655,525,93919,91550,88256,78833,71366
79707,45,3115,55732,23975,3.52255e+13,1063.74,10950.1,79707,602,547,56634,45501,34436,11904,6589
91529,2184,3469,64671,26858,3.68104e+13,1221.87,12369.4,91529,609,609,88060,87450,84094,76220,72125
89517,3073,3969,63023,26494,3.54976e+13,1153.25,13281.9,89517,703,650,85548,85429,83113,78009,76415
2803,334,547,2056,747,4.07228e+13,86.9843,986.099,2803,169,101,2256,2245,2174,2206,1723
48520,1744,2151,33354,15166,3.50048e+13,726.78,7086.03,48520,447,409,46369,46311,45576,44314,44160
12106,500,661,8175,3931,3.42793e+13,221.729,2126.33,12106,179,155,11445,11433,10928,10837,10173
28843,1468,1966,20003,8840,3.62688e+13,562.851,5416.54,28843,319,321,26877,26793,26563,26368,24082
58051,1463,2536,40274,17777,3.64999e+13,797.006,8234.52,58051,495,392,55515,55123,53322,47858,46685
51006,578,2376,35953,15053,3.64645e+13,894.48,7753.07,51006,489,438,47321,45444,34135,23756,23508
60670,874,3177,42847,17823,3.61042e+13,1008.55,10225.9,60670,737,505,56672,54497,40601,30594,26857
96403,103,3218,67916,28487,3.61384e+13,1214.66,11438.9,96403,698,525,75640,65234,47868,13643,12382
2353,372,582,1592,761,3.40972e+13,103.072,1012.63,2353,143,102,1771,1717,1624,1449,1253
31139,782,1985,21790,9349,3.64475e+13,603.573,5604.07,31139,390,301,29150,28258,25888,19497,19166
65539,1999,2624,44131,21408,3.25927e+13,690.261,8622.21,65539,467,412,62915,62910,61186,58361,59278
10148,204,1416,7210,2938,3.73959e+13,240.54,3011.21,10148,279,223,8482,7634,5806,4038,1831
28580,1551,1720,19473,9107,3.46334e+13,418.608,5078.33,28580,403,293,26860,26860,26606,26598,26140
42421,1834,1869,29502,12919,3.3088e+13,916.779,6317.11,42421,408,429,40552,40552,40550,40550,40471
51158,727,2682,35626,15532,3.60271e+13,780.122,8108.75,51158,608,454,47903,45956,34261,25820,26337
59136,612,2471,41001,18135,3.52792e+13,714.5,8389.01,59136,504,408,55801,53998,36531,28857,23106
23573,722,1268,16445,7128,2.95447e+13,435.615,3842.74,23573,313,219,22128,21866,21293,20376,16803
42842,1122,2036,29642,13200,3.60998e+13,643.306,6731.15,42842,345,437,40806,40504,39595,37520,31620
68824,468,2265,48216,20608,3.55984e+13,913.622,8573.37,68824,526,479,63622,59416,45672,33222,23488
81455,2381,2805,56616,24839,3.43059e+13,827.38,10467,81455,672,559,78650,78568,78190,77440,72970
45382,1667,2040,31337,14045,3.35937e+13,644.991,6987.2,45382,326,471,43342,43321,43238,42783,38889
87409,2464,3181,61028,26381,3.60038e+13,1333.91,11873.8,87409,655,635,84228,83974,82647,80031,78050
29804,1990,2204,21372,8432,3.64405e+13,701.554,6248.56,29804,396,385,27600,27598,27551,27591,26806
3585,528,700,2430,1155,3.61348e+13,154.819,1354.91,3585,102,196,2885,2864,2837,2834,2431
22274,1140,1704,15676,6598,3.48906e+13,517.934,4664.35,22274,351,330,20570,20339,19349,16920,16918
85700,301,3496,58900,26800,3.60581e+13,1164.02,11903,85700,550,564,76392,68603,45755,18930,16539
16703,973,1640,11445,5258,3.54954e+13,408.296,4110.48,16703,326,277,15063,14846,14544,14183,10910
63330,2399,3409,43860,19470,3.3693e+13,869.978,10517.8,63330,524,539,59921,59786,59207,59049,51437
88742,3153,3314,62334,26408,3.64138e+13,1190.01,12084,88742,680,700,85428,85428,85325,85206,84660
79947,1117,3135,56049,23898,3.51219e+13,1204.16,11110.4,79947,685,607,75978,74397,68082,50670,40177
58554,2311,3125,41055,17499,3.50558e+13,704.86,9706.24,58554,547,472,55429,55369,54371,53643,46483
4447,394,710,3179,1268,3.72264e+13,173.293,1449.64,4447,171,123,3737,3720,3530,2886,2847
1990,245,426,1408,582,3.62849e+13,139.622,762.312,1990,94,113,1564,1398,1437,1304,1259
65933,2284,3210,46045,19888,3.58067e+13,1002.32,10542.1,65933,699,607,62723,62304,60249,55018,52948
49678,1003,2130,34258,15420,3.33782e+13,584.563,6848.3,49678,350,374,47548,47215,44527,40611,36122
40570,1052,2075,28825,11745,3.67361e+13,880.103,6767.77,40570,549,387,38313,37359,35075,28601,26227
66303,2380,3085,46095,20208,3.54436e+13,851.588,9674.95,66303,403,508,63218,63206,62940,63049,57559
12082,220,1076,8321,3761,3.11734e+13,242.401,2650.98,12082,194,211,10772,10152,6433,5241,2048
1722,182,399,1242,480,4.17649e+13,72.0639,671.03,1722,92,64,1323,1268,1245,1267,917
32780,1606,2021,22537,10243,3.51251e+13,556.961,6246.81,32780,331,475,30759,30753,30579,30646,28418
64753,744,2488,45237,19516,3.57865e+13,828.679,8302.62,64753,550,440,61703,59985,42408,32816,36085
20801,223,1704,14496,6305,3.62305e+13,534.212,4580.18,20801,324,381,17698,15883,12188,8017,4862
44552,957,1586,31759,12793,3.74216e+13,838.986,5908.82,44552,435,356,42751,41652,40559,37953,31929
73675,1454,3252,50973,22702,3.51213e+13,941.045,11226.6,73675,717,460,70423,69416,59435,42917,39352
42171,824,2069,30457,11714,3.56071e+13,770.807,6814.82,42171,522,535,39794,38947,36206,31525,26883
42391,1576,1917,29710,12681,3.59564e+13,736.801,6780.84,42391,477,433,40474,40437,39977,39782,36847
30225,325,1164,20717,9508,2.94876e+13,619.882,4068.64,30225,336,312,28004,26809,21097,14252,11139
39112,186,2367,26307,12805,3.26995e+13,649.725,7062.63,39112,478,454,33823,31033,18846,7556,7128
3101,254,454,2085,1016,3.65394e+13,221.49,998.667,3101,117,128,2561,2268,2273,1979,1978
8021,178,1235,5875,2146,3.77966e+13,264.008,2488.04,8021,229,182,6505,5876,4523,2754,1895
53242,490,2446,37526,15716,3.75371e+13,746.728,7976.77,53242,422,414,49447,46477,32451,22889,17434
3392,176,602,2325,1067,3.199e+13,79.2173,1189.41,3392,146,97,2790,2714,1775,1552,975
27643,2233,2324,19320,8323,3.68973e+13,467.006,5997.72,27643,316,375,25319,25319,25300,25319,25190
28642,984,1911,20234,8408,3.49563e+13,540.653,5554.75,28642,410,418,26731,26185,24463,18977,18029
72604,1834,2598,50460,22144,3.60011e+13,777.57,8721.78,72604,502,415,70006,69869,68020,65983,61764
94470,165,3078,64631,29839,3.27535e+13,1104.16,11291.9,94470,580,586,81324,73355,45357,14068,11409
71172,2086,3683,49298,21874,3.27486e+13,986.321,11525.6,71172,648,930,67489,66737,63119,51749,51679
62887,1957,2821,44051,18836,3.62898e+13,693.05,9703.51,62887,601,382,60066,59973,57501,51994,46981
90441,947,3289,63295,27146,3.47935e+13,1278.82,11805.3,90441,727,666,85149,82097,65037,47716,41827
60733,1439,2992,42401,18332,3.49308e+13,754.247,9628.89,60733,653,397,57741,57399,51471,39488,39396
27183,587,1971,19814,7369,3.7546e+13,500.585,5479.72,27183,420,278,25028,24199,22273,14644,11903
40626,790,1688,29033,11593,3.65222e+13,675.94,5828.6,40626,427,299,38800,37569,32137,19791,17593
69308,822,2141,48003,21305,3.26367e+13,923.762,8542.2,69308,561,360,66421,64073,53696,34659,30091
11776,985,1368,7998,3778,3.52736e+13,327.988,3197.81,11776,218,279,10408,10352,10297,10226,8961
33854,783,2512,23546,10308,3.63905e+13,648.178,6844.68,33854,337,453,31133,30204,28185,23360,17517
77791,377,3291,54279,23512,3.53417e+13,1046.98,11147.8,77791,548,601,70751,67218,43458,18029,12778
28236,648,1404,20080,8156,3.66354e+13,698.254,4772.52,28236,343,338,26326,25500,22112,15056,13738
44316,389,2649,30718,13598,3.5047e+13,633.825,8077.97,44316,451,537,40588,38635,29791,22443,9521
23220,649,1045,16163,7057,3.64623e+13,436.09,3450.2,23220,265,256,22175,22089,20191,18262,18891
73507,2419,3622,51157,22350,3.63092e+13,1292.91,11662,73507,700,545,69885,69393,66912,59189,55704
10581,898,1078,7195,3386,3.4495e+13,366.165,2748.64,10581,254,313,9503,9499,9420,9384,8852
24060,1052,1625,16984,7076,3.7169e+13,568.64,4547.25,24060,411,321,22435,22139,21294,20431,19030
24495,91,1613,17049,7446,3.49201e+13,490.882,4747.24,24495,339,315,19026,16519,11828,3715,3094
83032,1227,3096,57707,25325,3.36124e+13,949.447,11161.1,83032,615,643,79639,78606,73524,64519,40019
21029,789,1655,14217,6812,3.51202e+13,554.5,4615.89,21029,373,402,19332,18901,17276,14357,12966
78965,717,2407,55987,22978,3.66478e+13,973,9990.94,78965,697,390,74945,71945,63187,47921,38516
27703,748,1715,20014,7689,3.6942e+13,646.053,5122.62,27703,500,365,25792,25106,22970,19446,14202
1765,255,419,1200,565,3.21379e+13,60.0482,743.69,1765,131,64,1346,1343,1314,1250,1156
8386,970,1234,5791,2595,3.426e+13,243.537,2673.14,8386,230,237,7152,7152,7026,6980,6401
48984,2012,2275,34390,14594,3.49041e+13,817.106,7613.39,48984,436,407,46709,46626,46630,46705,45755
10567,182,1121,7570,2997,3.70494e+13,336.123,2675.87,10567,298,241,8702,7635,6614,5323,2566
60595,2077,2246,42792,17803,3.73318e+13,901.327,8191.04,60595,617,453,58349,58349,58197,58150,57415
32813,1360,1647,22648,10165,3.42334e+13,639.947,5250.28,32813,413,298,31166,31080,30682,29991,29382
81459,1491,2147,55945,25514,3.058e+13,999.824,9032.49,81459,441,529,79312,78726,78349,77191,73410
49753,619,2176,35243,14510,3.73851e+13,761.695,7081.85,49753,445,405,46424,42367,33315,24024,16736
31330,2010,2147,21664,9666,3.44942e+13,630.212,5980.11,31330,422,372,29183,29183,29137,29155,28773
10989,689,861,7583,3406,3.64532e+13,389.881,2435.7,10989,207,257,10128,9940,9919,9556,9210
73686,1201,2894,53281,20405,3.64055e+13,957.223,10645.1,73686,573,563,70759,69180,66544,58872,44325
66737,1856,2581,48369,18368,3.69199e+13,1156.12,9681.45,66737,736,459,64156,63777,62913,58406,57925
34667,2403,2704,24002,10665,3.6142e+13,604.652,7405.74,34667,388,585,31963,31962,31881,31912,30993
78363,2818,3066,55662,22701,3.69978e+13,909.86,11035,78363,764,473,75297,75274,75228,75297,73946
72079,1113,2984,49816,22263,3.52905e+13,1020.69,10331.9,72079,579,554,68679,67043,57778,42976,35586
56212,1935,2536,39716,16496,3.6649e+13,1154.77,8318.76,56212,543,513,53676,53060,51779,50829,47537
8533,802,874,5753,2780,3.44259e+13,270.389,2155.28,8533,225,192,7659,7656,7644,7635,7514
5044,769,892,3778,1266,3.65553e+13,138.992,1706.75,5044,186,113,4152,4152,4151,4150,3837
20201,150,1495,14197,6004,3.5077e+13,408.363,4075.25,20201,284,290,17289,15920,13167,7552,5417
73132,2148,2367,52333,20799,3.70583e+13,1077.35,9148.75,73132,598,432,70765,70755,70721,70679,69613
68443,1805,3259,47045,21398,3.38163e+13,771.832,10793.3,68443,672,475,65184,64943,60545,49213,45743
74275,839,1981,52459,21816,3.36368e+13,889.75,8113.86,74275,525,431,71658,69726,63564,48538,45526
27293,1227,1884,18549,8744,3.33481e+13,337.203,5242.78,27293,425,303,25409,25400,23084,18259,17081
59830,587,2665,40918,18912,3.48017e+13,499.311,8579.69,59830,439,489,56798,55896,42021,31705,25842
4645,446,776,3142,1503,3.36682e+13,181.282,1583.25,4645,172,136,3869,3792,3421,2708,2694
62777,1981,2489,44358,18419,3.67139e+13,732.048,8993.99,62777,466,486,60288,60241,60030,59997,54833
4159,550,610,2839,1320,3.0226e+13,112.338,1324.44,4159,160,147,3549,3549,3508,3444,3162
62029,2171,2677,44302,17727,3.65889e+13,1059.52,9257.48,62029,577,599,59352,59229,58756,57620,55186
4077,468,621,2827,1250,3.81489e+13,210.464,1322.69,4077,127,154,3456,3424,3313,2996,3055
46148,481,2340,31528,14620,3.5134e+13,680.191,7127.73,46148,400,388,43062,41670,25345,17223,10430
81187,1014,2891,57482,23705,3.59862e+13,1136.45,10541.9,81187,703,483,77384,75346,66090,44436,41931
37776,911,1490,26538,11238,3.37185e+13,811.728,5499.95,37776,386,346,36040,34937,33552,31335,26828
88097,1913,2892,62671,25426,3.7415e+13,852.54,10805.6,88097,621,455,85205,85123,82206,75268,71572
52560,2031,2230,38070,14490,3.70413e+13,808.896,7838.95,52560,503,395,50330,50328,50291,49740,47920
59987,605,2621,41507,18480,3.44395e+13,922.322,9229.46,59987,533,483,55575,52917,43436,29537,22189
44079,270,2480,30482,13597,3.36591e+13,647.948,7692.13,44079,487,475,39071,36263,24112,12186,9841
54677,2743,2750,38420,16257,3.57132e+13,747.366,8830.18,54677,605,379,51927,51927,51927,51927,51913
55531,2394,2909,39240,16291,3.57282e+13,801.854,9316.09,55531,454,606,52622,52561,52370,52469,48907
88826,1172,3897,61502,27324,3.44387e+13,1009.38,13213.8,88826,606,796,84633,82775,75717,60391,40022
72454,2451,3389,50578,21876,3.62408e+13,994.651,11256.8,72454,581,652,69065,69044,68524,68316,60645
2583,203,506,1787,796,3.62984e+13,144.185,965.456,2583,121,115,2058,1875,1784,1407,1325
71156,910,2208,49508,21648,3.30802e+13,1102.59,8735.32,71156,525,504,68027,65988,63103,49866,41307
43501,1149,1883,30896,12605,3.68662e+13,709.634,6406.16,43501,447,368,41618,41334,38997,34282,34474
72765,1656,2804,51943,20822,3.69039e+13,1006.39,9735.02,72765,521,505,69961,69265,67166,60827,58662
66751,1037,3626,46352,20399,3.55599e+13,922.903,11360.6,66751,498,809,62730,61198,55177,43420,29249
43448,2306,2325,30529,12919,3.64394e+13,750.327,7262.25,43448,420,393,41123,41123,41123,41123,41033
39990,481,2213,28651,11339,3.71537e+13,900.018,7084.82,39990,470,403,36467,34768,23921,16588,11192
91804,1238,3415,64294,27510,3.47008e+13,1221.26,12230.9,91804,594,712,87927,85304,71892,48003,38294
1834,355,437,1230,604,3.80672e+13,101.279,763.394,1834,76,113,1397,1382,1385,1384,1315
38099,1808,2140,26928,11171,3.56964e+13,776.999,6578.09,38099,399,383,35959,35932,35786,35621,33818
69765,38,2761,49629,20136,3.64562e+13,856.572,9927.47,69765,595,575,47355,37487,29627,10022,5083
70618,2395,2712,50067,20551,3.53866e+13,885.031,9419.28,70618,542,445,67906,67847,67787,67871,66036
93262,2021,3514,65259,28003,3.57195e+13,1301.37,13002.9,93262,835,725,89748,88650,81023,64455,67833
23171,276,1153,16524,6647,3.78526e+13,617.398,3818.56,23171,342,275,20139,18165,15318,11045,8653
6199,632,984,4467,1732,3.98947e+13,190.035,1979.73,6199,195,152,5215,5152,5139,5025,3805
43444,458,2131,29980,13464,3.55719e+13,747.85,6894.45,43444,476,385,39636,37578,26642,19433,14629
90561,980,3442,64390,26171,3.68596e+13,1235.64,12802.7,90561,632,639,85983,83823,71643,43853,35415
93645,2114,3825,64393,29252,3.42506e+13,955.123,12776.3,93645,682,637,89820,89454,82509,69375,67441
75095,1372,2888,53641,21454,3.70425e+13,1061.7,10755.7,75095,629,587,72052,70381,67247,58031,45152
27516,815,1936,19905,7611,3.71735e+13,549.111,5400.21,27516,400,385,25504,24922,23251,21340,11213
10538,213,1074,7339,3199,3.83342e+13,351.422,2686.39,10538,227,237,9004,8017,7029,6025,3311
44204,908,2266,31985,12219,3.7205e+13,768.684,7240.93,44204,428,435,41607,40131,39649,37536,28773
83443,503,2922,57144,26299,3.45056e+13,854.151,11044.5,83443,591,541,77542,74289,48045,28316,23842
54596,411,2602,38182,16414,3.36868e+13,971.045,8264.8,54596,530,425,49705,47194,29634,19354,11471
99708,736,3670,68676,31032,3.53586e+13,1094.01,12694.4,99708,586,538,94537,92230,58462,39478,36202
31541,587,1638,21904,9637,3.20801e+13,620.744,4970.6,31541,403,371,29528,28630,27124,24535,18428
29251,7652,29251,0,29251,15.9995,0,29251,29251,29251,1,0,0,0,0,0
5581,580,832,3908,1673,3.76091e+13,225.652,1753.51,5581,157,169,4749,4682,4523,4401,3916
25940,738,1578,17738,8202,3.52142e+13,620.166,4823.5,25940,355,329,24283,23503,21807,16518,16868
89757,2537,3123,63212,26545,3.54228e+13,1213.19,11970.9,89757,611,746,86634,86609,86053,85662,79879
90620,2814,4038,62801,27819,3.59528e+13,1057.21,13434.4,90620,562,665,86582,86395,85368,84735,73009
13481,518,1422,9406,4075,3.76397e+13,330.685,3505.07,13481,214,371,12040,11446,10892,10530,5633
5209,206,715,3812,1397,3.53164e+13,193.212,1557.24,5209,144,162,4397,4018,3803,3760,1107
34623,22706,34623,0,34623,15.9995,0,34623,34623,34623,1,0,0,0,0,0
91397,3286,3378,64108,27289,3.64889e+13,1246.22,12307.8,91397,685,659,88019,88019,88006,88011,87435
65618,1633,2232,46134,19484,3.40895e+13,789.804,8353.7,65618,460,456,63386,63385,63017,62297,56317
93055,690,3870,63697,29358,3.40225e+13,1060.48,12906.6,93055,729,554,87225,83584,56890,40329,29850
9371,583,1009,6632,2739,3.70925e+13,279.955,2433.35,9371,196,213,8362,8293,8249,8137,6854
98169,3116,3440,69064,29105,3.52747e+13,1186.56,12755.6,98169,647,689,94729,94720,94567,94668,92995
4802,235,520,3522,1280,3.46461e+13,217.196,1225.88,4802,159,114,4128,3647,3772,3558,3116
97834,2945,3752,68681,29153,3.64255e+13,930.385,13282.8,97834,833,540,94082,94050,91245,83302,83473
14471,475,1181,9871,4600,3.49392e+13,431.345,3260.2,14471,251,280,12985,12042,11209,9255,7530
76064,2194,3562,52983,23081,3.4789e+13,1086.97,11721.8,76064,683,695,72502,72019,69999,63397,56428
5864,703,833,4109,1755,3.59116e+13,170.539,1762.64,5864,135,172,5031,5030,5023,5022,4591
68756,1948,3139,47776,20980,3.63687e+13,867.584,10270.5,68756,485,446,65617,65289,62748,58211,53622
42082,44,1983,29473,12609,3.56844e+13,707.15,6470.51,42082,477,391,28865,23386,18188,6518,3810
48813,225,2308,34401,14412,3.45933e+13,742.053,7692.03,48813,524,390,42622,38435,26122,10873,9551
57120,2226,2271,39756,17364,3.31737e+13,829.464,7632.71,57120,486,378,54849,54849,54836,54847,54759
50114,1765,2518,34222,15892,3.31547e+13,830.474,8262.55,50114,439,372,47596,47379,46140,41381,38064
45061,1355,3007,31233,13828,3.47016e+13,742.984,8648.97,45061,551,514,42054,41559,39954,35190,29542
35629,671,1725,25338,10291,3.74519e+13,791.01,5823.85,35629,423,346,33034,31527,29112,21953,19837
56271,2679,3301,40120,16151,3.67213e+13,687.301,9896.85,56271,536,594,52970,52963,52748,52802,49791
20708,593,1671,15002,5706,3.72817e+13,424.587,4472.69,20708,276,322,19027,18499,17587,16625,11887
31770,1601,1685,22200,9570,3.43194e+13,489.184,5184.93,31770,388,320,30085,30080,30085,30082,29085
62439,192,1713,45153,17286,3.70986e+13,777.612,6941.42,62439,462,400,53422,46680,36596,21515,13792
5628,638,649,3864,1764,3.63653e+13,282.531,1571.11,5628,158,170,4979,4979,4979,4979,4975
25563,294,1610,17891,7672,3.2188e+13,466.942,4600.4,25563,336,265,23210,21830,14810,11472,6319
2085,366,409,1440,645,3.55088e+13,139.613,766.087,2085,125,83,1676,1674,1676,1655,1654
69395,2341,2618,48440,20955,3.60523e+13,807.368,9388.45,69395,621,418,66777,66777,66279,64949,65576
99755,2126,4190,68913,30842,3.53901e+13,1105.72,13993.9,99755,613,606,95565,94914,88243,72716,67255
25679,1212,1616,17679,8000,3.56338e+13,586.299,4809.55,25679,327,353,24063,24021,23590,23096,21203
27506,725,1838,19017,8489,3.60975e+13,636.067,5095.18,27506,444,333,25553,24792,20684,15961,16932
4870,212,791,3590,1280,3.77152e+13,174.534,1576.77,4870,147,156,4015,3661,3618,3557,1397
20156,282,1841,14448,5708,3.78979e+13,347.007,4673.25,20156,283,422,17839,16027,13778,11968,4120
11612,293,1176,7951,3661,3.56265e+13,315.618,2879.05,11612,219,207,10294,9533,7462,6040,4782
38943,670,1997,26658,12285,3.06755e+13,608.607,6321.67,38943,435,481,36716,35713,32329,22579,17509
45031,1294,2151,31902,13129,3.68528e+13,1077.26,7382.29,45031,581,473,42621,41474,39879,34459,34579
42851,2125,2386,28926,13925,3.50173e+13,498.2,6925.77,42851,404,324,40465,40422,40307,40250,38797
30464,837,1370,21186,9278,3.69832e+13,429.914,4368.64,30464,254,272,29094,28985,28095,27367,26044
4113,173,333,2875,1238,3.78153e+13,199.619,934.911,4113,114,109,3574,3090,3155,3360,2410
88672,207,3553,61717,26955,3.47822e+13,1043.39,12453.8,88672,640,584,76822,69635,48617,15258,12850
45287,1135,3279,31161,14126,3.5625e+13,657.343,9254.05,45287,523,736,42008,41458,33466,29787,18479
13945,892,929,9438,4507,3.37857e+13,303.736,2663.24,13945,219,206,13016,13016,13014,12987,12987
83135,2910,3255,58240,24895,3.60713e+13,1074.14,11108.8,83135,677,526,79880,79831,79757,79376,78114
73150,1066,1809,50556,22594,3.46463e+13,943.333,7789.81,73150,494,453,71003,69686,65263,51829,54987
30240,311,1664,20801,9439,3.49867e+13,705.551,5273.69,30240,390,323,26878,24966,18130,12985,9453
18717,769,1340,12699,6018,3.23176e+13,287.484,3679.13,18717,354,209,17377,17336,16223,13331,12990
60227,1844,2647,41267,18960,3.54994e+13,557.051,8291.92,60227,442,413,57580,57548,53853,45686,48415
49886,1631,2044,35522,14364,3.7064e+13,761.767,7033.97,49886,538,351,47842,47836,47433,46853,45775
72467,2599,2828,50730,21737,3.3032e+13,1016.85,9739.07,72467,550,448,69639,69623,69582,69436,68750
52413,1193,2514,36185,16228,3.49885e+13,743.551,7934.95,52413,455,465,49899,49183,45375,36820,35348
22071,1162,1240,15238,6833,3.67212e+13,598.124,4025.49,22071,314,314,20831,20831,20757,20714,20708
36477,1468,1872,25863,10614,3.61406e+13,653.708,6117.86,36477,405,353,34605,34575,34298,34114,30243
24247,618,2066,17586,6661,3.7168e+13,584.658,5489.14,24247,339,341,21992,21203,19352,16306,8719
83790,420,3403,58721,25069,3.58565e+13,1092.9,11656.4,83790,634,567,76419,72014,49101,23236,19653
33580,1364,2008,22981,10599,3.33787e+13,505.948,5998.74,33580,391,389,31572,31446,30003,26730,27045
95047,1993,2902,68328,26719,3.66914e+13,1110.82,11287.6,95047,772,524,92145,91968,88219,78570,77227
40947,1280,2501,28272,12675,3.43549e+13,646.772,7144.6,40947,418,471,38446,37920,36469,33944,27853
89111,1058,2874,61874,27237,3.35312e+13,1252.13,11002.8,89111,682,623,85140,82259,74599,58605,40932
46803,1458,2789,32786,14017,3.64141e+13,732.041,8267.03,46803,457,564,44014,43685,40799,35267,31354
95969,847,3684,65665,30304,3.51344e+13,973.295,12700.6,95969,678,613,91257,88708,65738,48134,32895
49416,1610,2539,34606,14810,3.47838e+13,633.172,7571.74,49416,505,426,46877,46771,45685,41948,37999
1816,384,452,1319,497,3.74348e+13,74.967,752.438,1816,91,89,1364,1364,1360,1359,1295
93071,1624,3523,64650,28421,3.47444e+13,1085.96,12838,93071,758,675,89548,88503,83081,70109,54995
61425,1846,2227,42600,18825,3.38311e+13,857.669,8226.49,61425,458,489,59198,59139,58840,58638,55681
86254,1357,3355,60547,25707,3.63202e+13,1031.51,11703.8,86254,717,520,82899,81478,74318,54587,53934
6394,570,826,4428,1966,3.42194e+13,208.917,1832.51,6394,185,155,5568,5486,5495,5480,4670
34221,258,1777,23898,10323,3.67771e+13,669.172,5461.95,34221,420,309,30224,26459,19783,13257,10113
80744,1937,2075,56383,24361,3.24683e+13,892.848,8597.39,80744,574,393,78669,78669,78440,78388,76089
15376,814,1673,10642,4734,3.6681e+13,398.429,4025.38,15376,317,291,13703,13420,12554,10430,9453
47494,1500,2232,32440,15054,3.42226e+13,715.389,7259.68,47494,411,428,45262,45152,44408,43606,37400
19863,878,1136,13453,6410,3.06736e+13,533.287,3488.48,19863,240,275,18727,18264,18274,17392,16391
16341,42,1216,11086,5255,3.47571e+13,408.353,3441.62,16341,249,309,11576,9448,6644,2191,1817
33377,995,2006,23943,9434,3.68133e+13,679.076,6011.59,33377,461,306,31371,30774,27450,23243,17659
62244,2263,2783,42504,19740,3.59146e+13,905.086,9515.04,62244,480,679,59461,59447,59194,59064,55616
27373,1002,1815,19820,7553,3.74399e+13,764.195,5385.27,27373,399,352,25551,24760,24284,21487,18317
29867,863,1809,20434,9433,3.25752e+13,395.046,5257.38,29867,252,341,28058,27840,26796,26448,19335
21534,1235,1696,14598,6936,3.4879e+13,586.921,4610.25,21534,294,383,19838,19596,19449,19005,17099
17214,98,1642,11887,5327,3.55857e+13,281.786,4012.95,17214,394,228,13521,11898,7828,2837,1983
89184,2185,3026,63560,25624,3.72474e+13,1060.5,11103.7,89184,669,499,86158,85827,84066,81538,73143
72753,2657,2767,50987,21766,3.69725e+13,1036.65,10036.2,72753,537,546,69986,69986,69888,69773,69559
4033,36,772,2838,1195,3.57453e+13,183.575,1468.18,4033,182,179,2687,2206,1587,661,406
29065,97,1830,20703,8362,3.73959e+13,579.536,5247.17,29065,439,278,22570,20095,14583,4455,4472
94683,2596,2913,67932,26751,3.69396e+13,1221.41,11010.4,94683,657,485,91770,91694,91019,89396,89404
92865,2378,2702,65531,27334,3.61105e+13,1037.96,10535.1,92865,573,474,90163,90155,90061,89976,88433
71473,2905,3150,49711,21762,3.49407e+13,855.218,10537.4,71473,622,518,68323,68323,68079,67949,65966
82726,300,3678,57441,25285,3.56785e+13,976.06,11974.4,82726,614,679,74802,67435,43991,16083,15314
1123,286,302,736,387,3.1459e+13,64.4426,512.706,1123,68,53,821,821,821,821,811
87571,1316,3278,62124,25447,3.58087e+13,1245.79,11543.9,87571,683,590,83793,81978,76572,62758,47123
66099,1405,2607,46524,19575,3.52311e+13,1089.42,9157.84,66099,548,483,63437,62302,58188,44483,44645
16659,1472,1529,11490,5169,3.58753e+13,446.006,4036.29,16659,273,278,15130,15130,15130,15130,14995
98105,1453,3314,68836,29269,3.5187e+13,1394.08,12249.5,98105,715,530,94392,92258,76623,53251,56951
90647,217,3725,62830,27817,3.5837e+13,1119.58,12444.4,90647,645,624,77936,69430,47262,17699,14378
53988,2097,3057,37457,16531,3.51571e+13,841.922,9599.02,53988,430,628,50931,50754,50082,48838,43716
23135,1041,1566,16285,6850,3.64908e+13,467.906,4623.07,23135,260,319,21569,21483,21266,21107,17753
8907,499,781,6410,2497,3.80521e+13,452.265,2104.49,8907,244,207,7928,7325,7501,6931,6006
16735,1162,1294,11535,5200,3.56372e+13,419.79,3576,16735,277,260,15441,15441,15284,15153,15127
78164,2556,3460,51862,26302,3.29852e+13,949.747,11222.4,78164,524,771,74704,74539,73911,72927,67585
96343,2997,3599,67015,29328,3.57051e+13,1187.18,13081.8,96343,617,812,92744,92675,92248,92033,88439
43369,502,2257,30202,13167,3.51215e+13,873.381,7318.17,43369,469,411,39965,38186,29950,20495,13581
50848,57,2490,36324,14524,3.66001e+13,771.57,8217.24,50848,614,425,36969,30795,23706,7979,4571
60539,1156,2812,41373,19166,3.44467e+13,635.603,8962.36,60539,468,461,57727,57130,48608,38731,34174
22406,1498,1625,15353,7053,3.60054e+13,483.507,4664.21,22406,339,434,20781,20781,20737,20720,20459
31257,1155,1237,21607,9650,3.61996e+13,630.293,4532.21,31257,350,329,30020,30020,29966,29975,29839
92888,232,3198,65332,27556,3.51122e+13,1345.64,11825.7,92888,621,624,81957,73597,51581,18416,13430
6239,185,996,4561,1678,3.98622e+13,203.104,1975.83,6239,185,171,5094,4662,4154,3686,1531
24508,1223,1496,17530,6978,3.74832e+13,484.681,4541.96,24508,313,279,23012,22992,22972,22815,21388
37116,1080,1968,25904,11212,3.48364e+13,676.063,6087.89,37116,466,401,35148,34586,33035,28979,26781
13037,343,1030,9048,3989,2.84131e+13,209.913,2545.78,13037,240,182,12007,11783,10738,10690,3351
59825,1586,2048,41527,18298,3.14128e+13,845.359,7341.58,59825,456,535,57777,57180,56715,54696,53196
38264,1411,2040,26707,11557,3.53783e+13,616.511,6180.26,38264,544,342,36224,36187,35067,33289,28133
9664,587,852,6494,3170,2.84579e+13,141.204,2087.47,9664,134,169,8812,8803,8760,8745,8009
44293,44,2660,30336,13957,3.55091e+13,588.218,7869.26,44293,410,622,30479,24310,18391,6710,3633
1829,324,429,1287,542,3.5556e+13,71.5604,762.412,1829,124,84,1400,1397,1311,1122,1149
54410,675,3088,37833,16577,3.65767e+13,718.824,9162.99,54410,604,409,50835,49140,32380,24132,22071
67810,1815,2982,46345,21465,3.46496e+13,930.43,9851.49,67810,558,517,64828,64418,60805,53433,53861
35434,82,2306,24209,11225,3.41736e+13,546.599,6470.83,35434,387,399,26943,23157,16622,6198,3420
11309,642,935,7797,3512,3.45766e+13,490.062,2598.64,11309,264,242,10331,9694,9644,8933,8648
40111,1022,2032,27254,12857,3.4969e+13,640.437,6646.48,40111,388,424,38079,37478,35250,29909,27241
77382,138,2590,52821,24561,3.49657e+13,643.823,9352.79,77382,536,484,62830,53930,40240,15122,8619
15245,586,1272,11189,4056,3.68199e+13,395.511,3253.96,15245,269,235,13973,13590,13210,13091,8857
5405,13,575,3625,1780,3.46369e+13,253.961,1426.32,5405,157,152,2590,1612,1521,1169,459
82570,1279,3549,57392,25178,3.43755e+13,961.673,12264.1,82570,616,672,78896,77752,70433,52544,41874
1422,311,473,998,424,3.40509e+13,45.2018,733.767,1422,132,71,949,944,916,786,757
3480,234,653,2507,973,3.51477e+13,96.0379,1225.18,3480,128,127,2827,2730,2693,2712,1376
93259,1535,3225,66508,26751,3.70049e+13,1082.46,12283.8,93259,663,640,89975,88895,85107,77275,58317
34994,524,1928,23744,11250,3.44638e+13,499.815,5762.13,34994,356,325,32782,31129,20913,17679,14122
86232,3405,3680,60242,25990,3.46414e+13,1052.75,12457.6,86232,585,570,82552,82542,82440,82423,81227
29434,258,1759,20302,9132,3.65586e+13,391.222,4799.2,29434,394,292,26555,22631,15438,10022,9834
39001,785,2360,27209,11792,3.43284e+13,776.944,7063.57,39001,408,372,36357,35232,31440,21383,19158
7740,172,908,5305,2435,3.63905e+13,295.559,2133,7740,208,249,6355,5585,4693,4317,2116
69818,642,2830,47923,21895,3.27228e+13,918.301,9937.67,69818,555,486,65828,63887,42328,31595,18179
99780,3144,3492,68393,31387,3.45971e+13,1312.53,12346.3,99780,663,669,96288,96165,95772,94979,93662
86308,1777,3330,59451,26857,3.49706e+13,782.807,11195,86308,558,547,82978,82575,81279,77083,68647
82831,2176,2795,58176,24655,3.49711e+13,1033.19,10460.2,82831,579,479,80036,79917,78590,75874,72075
75538,3078,3322,52190,23348,3.40565e+13,951.381,10982.6,75538,495,553,72216,72216,72175,72193,70813
81759,1031,3018,54914,26845,3.43989e+13,971.632,10517.2,81759,506,619,78372,76389,52643,42641,47824
48044,170,2073,32029,16015,3.39346e+13,854.877,7104.41,48044,462,494,40479,35608,20879,9618,9003
94927,194,3414,66712,28215,3.62275e+13,1081.69,12384.9,94927,615,637,80551,69503,50005,18299,14608
61959,640,2227,44664,17295,3.72357e+13,1117.04,8555.55,61959,600,419,57771,54677,47513,30085,26926
42648,1720,2151,29312,13336,3.22233e+13,926.84,6769.71,42648,378,490,40497,39652,39712,38899,37292
99871,1047,2632,70861,29010,3.58851e+13,1177.08,10930.5,99871,600,465,96556,94606,81873,51969,53602
57909,1233,2599,40273,17636,3.49322e+13,985.44,8564.13,57909,531,458,55052,54058,50309,40090,36783
58565,776,2423,42107,16458,3.67992e+13,1056.69,8477.65,58565,638,510,55174,53307,47084,33295,23981
31244,2144,2275,21933,9311,3.61253e+13,661.992,6380.8,31244,469,372,28969,28969,28950,28969,28642
47579,2435,2585,33060,14519,3.62096e+13,752.587,7660.46,47579,516,363,44994,44993,44944,44896,44498
52661,1028,2120,36805,15856,3.38934e+13,697.934,7013,52661,389,435,50541,49781,48767,45359,34426
10418,1098,1284,7094,3324,3.52096e+13,320.807,2982.92,10418,299,225,9134,9134,9075,8759,8780
93232,601,4023,65848,27384,3.5927e+13,1062.41,13858.7,93232,582,787,86767,83828,61647,37639,23851
16203,70,1339,11164,5039,3.59985e+13,381.569,3634.78,16203,211,309,12535,10853,7785,3135,2254
78960,1008,3247,55868,23092,3.6031e+13,1066.26,11026.1,78960,729,419,75232,73248,61058,41436,42648
90551,2259,3539,62079,28472,3.26865e+13,915.962,12029,90551,554,688,87012,86892,85624,83919,66263
83974,2116,4125,58597,25377,3.562e+13,846.365,13176.1,83974,587,833,79849,79625,76486,72368,50199
72075,2926,3133,49755,22320,3.48143e+13,809.306,10332.4,72075,528,485,68942,68941,68892,68927,67997
80566,75,3403,55827,24739,3.53417e+13,960.665,11569.8,80566,691,589,61158,51154,34916,11295,7438
98432,2955,3178,69544,28888,3.62821e+13,1241.06,12459.1,98432,644,549,95254,95254,95125,95218,94175
79715,1275,2951,55002,24713,3.38567e+13,960.426,10100.6,79715,542,441,76422,75456,69742,53394,55116
85746,2032,4369,58301,27445,3.47407e+13,915.003,13789.2,85746,554,753,81377,80832,78189,70558,50135
62425,1553,2766,43462,18963,3.52443e+13,826.464,9177.05,62425,596,453,59659,59328,55165,42663,43134
54752,1859,2414,38207,16545,3.59267e+13,1013.12,8302.68,54752,585,434,52338,52163,51061,49614,48319
9474,417,1112,6552,2922,3.5539e+13,339.195,2569.29,9474,255,226,8316,7982,7343,6462,4493
31997,1307,1995,22112,9885,3.44867e+13,553.362,5775.36,31997,371,346,30002,29697,29058,26590,24918
37053,916,1890,25784,11269,3.52681e+13,490.46,5750.95,37053,427,398,35163,35006,31563,24604,24002
87532,3176,3640,60531,27001,3.57525e+13,1252.32,12380.9,87532,690,743,83892,83680,83215,81536,81466
85763,426,2979,61095,24668,3.72762e+13,1251.09,11176.9,85763,792,649,78285,73409,54084,30621,21336
62857,868,3410,43540,19317,3.55292e+13,1013.75,10595.6,62857,497,630,58710,56803,42560,29788,24565
80913,2566,3261,56423,24490,3.58792e+13,1148.86,11636.2,80913,668,545,77652,77569,77263,77055,72768
85390,2852,3487,59189,26201,3.48267e+13,984.499,11914,85390,719,611,81903,81858,79299,68990,69120
65220,2002,2698,45552,19668,3.66846e+13,961.895,9142.98,65220,624,510,62522,62368,61018,59837,55944
59297,227,1974,41465,17832,3.3603e+13,879.951,7599.05,59297,464,454,52304,48439,33652,12732,12032
87804,1792,3078,61204,26600,3.3889e+13,857.446,11602.1,87804,501,643,84726,84634,82813,79777,60976
67062,2277,2426,47073,19989,3.26754e+13,817.707,8908.78,67062,581,391,64636,64636,64395,64335,60237
43547,2712,2717,30625,12922,3.62628e+13,756.493,8003.97,43547,434,438,40830,40830,40830,40830,40828
98532,97,3137,69176,29356,3.68403e+13,1242.01,11275.2,98532,647,521,76057,65715,49580,20437,10949
24585,573,2036,16974,7611,3.31409e+13,445.533,5264.92,24585,393,271,22456,21587,17632,12923,10242
73557,1266,3094,51534,22023,3.58801e+13,946.586,10743.7,73557,555,682,70463,68964,64778,59980,40477
57332,2546,2669,39294,18038,3.45044e+13,682.872,9128.43,57332,487,465,54663,54663,54639,54639,53702
97374,362,4102,67419,29955,3.53993e+13,1268.46,13835.5,97374,781,727,88043,81691,52830,22001,18745
8353,91,1066,6003,2350,3.64339e+13,229.482,2365.21,8353,186,224,6400,5460,4460,2213,1493
24361,1376,1615,17616,6745,3.60085e+13,631.4,4734.18,24361,381,326,22746,22732,22438,22237,21489
67409,2079,2253,47061,20348,3.45751e+13,893.844,8769.57,67409,576,382,65156,65154,65116,65073,64308
69763,1317,3021,48970,20793,3.69768e+13,880.43,9817.79,69763,612,509,66742,66194,59612,50672,51380
35770,850,2014,24953,10817,3.22528e+13,656.486,6345.21,35770,398,384,33740,32842,31375,26412,21234
34436,1126,2532,24410,10026,3.56093e+13,569.352,7047.57,34436,457,664,31904,31452,30052,26857,16991
56075,1352,2324,38852,17223,3.25488e+13,637.987,7809.25,56075,368,492,53751,53681,52758,52102,40645
62672,2366,2620,42038,20634,3.48856e+13,775.288,9052.02,62672,495,413,60052,59999,59962,59946,59414
42151,194,1963,29975,12176,3.64748e+13,898.413,6628.41,42151,503,396,36082,31839,21826,8318,7677
5102,249,678,3408,1694,3.44023e+13,165.864,1510.17,5102,115,160,4422,4256,4111,4120,2491
20999,968,1761,14685,6314,3.58066e+13,409.449,4544.02,20999,426,303,19238,19117,17629,15554,14130
1147,396,403,766,381,3.26417e+13,32.4438,587.098,1147,99,57,744,744,744,744,730
4890,893,931,3453,1437,3.8885e+13,212.89,1734.43,4890,157,162,3959,3959,3959,3959,3943
54299,205,2138,38380,15919,3.66938e+13,806.45,7601.71,54299,538,408,47192,41938,30794,17091,11282
44783,518,2469,31587,13196,3.64854e+13,921.777,7842.62,44783,488,345,41090,39103,29567,17886,14431
60165,2138,2790,41761,18404,3.5409e+13,801.563,9298.98,60165,442,462,57375,57320,57034,57108,52367
56138,1733,2305,37941,18197,3.43847e+13,829.632,8153.03,56138,399,596,53833,53762,53431,53014,47997
24419,1205,2182,16590,7829,3.46434e+13,428.286,5617.59,24419,444,347,22237,22195,19121,17376,15806
87332,1247,2522,60264,27068,3.59781e+13,1008.77,9159.61,87332,525,487,84505,83515,75862,57010,59977
80450,1677,2922,57006,23444,3.65964e+13,996.081,10969.9,80450,803,480,77528,76928,72736,60143,62093
78079,2252,3958,53001,25078,3.38617e+13,858.383,12369.4,78079,655,557,74121,74041,67432,54928,51116
93436,2214,3604,65754,27682,3.58074e+13,1027.6,12559,93436,597,717,89832,89326,87446,82250,70891
1522,321,467,1027,495,3.08881e+13,68.7976,736.303,1522,122,87,1055,1052,1036,1006,928
69318,1836,2573,48673,20645,3.35667e+13,956.465,9341.77,69318,556,439,66745,66484,65764,64644,55874
20888,1613,1964,14814,6074,3.80993e+13,430.275,5046.99,20888,276,551,18924,18922,18732,18848,16925
28320,613,1682,20288,8032,3.71085e+13,593.939,5008.28,28320,406,327,26339,25216,23954,18187,16514
75848,400,3916,51987,23861,3.49837e+13,851.123,12238.4,75848,528,619,69193,64414,42824,20623,17956
55207,187,2525,38635,16572,3.42796e+13,1058.86,8360.01,55207,512,578,48520,44987,28347,11164,7036
41263,372,1773,28405,12858,3.3161e+13,536.731,5843.49,41263,338,363,38883,37889,29766,21063,15309
68996,853,2595,48740,20256,3.54125e+13,915.535,9238.35,68996,623,447,65787,63528,49990,36745,27865
17121,494,1316,11878,5243,3.63222e+13,570.738,3721.09,17121,300,296,15334,14356,12811,10638,7710
58543,2044,2149,41869,16674,3.68714e+13,889.79,8129.2,58543,575,403,56394,56390,56356,56394,55777
50046,418,2482,35410,14636,3.56802e+13,822.3,8249.8,50046,521,432,45923,43128,34585,25143,13544
4717,669,845,3202,1515,3.40463e+13,162.628,1665.2,4717,195,173,3872,3871,3824,3614,3526
35457,1833,2228,24648,10809,3.57754e+13,809.41,6738.06,35457,460,421,33229,33057,32832,32472,31351
4368,88,810,3137,1231,3.59321e+13,158.671,1544.24,4368,192,145,3265,2868,2368,1744,710
80070,373,3082,54986,25084,3.57198e+13,974.434,10643.7,80070,566,696,73965,69715,48389,30130,17151
51431,2048,2334,35769,15662,3.60309e+13,782.541,7782.34,51431,421,521,49097,49085,49026,49062,47289
28608,425,1535,20340,8268,3.66897e+13,538.2,4905.84,28608,344,311,26445,25101,21773,17650,11747
95895,1555,4157,66009,29886,3.52339e+13,1055.6,14151,95895,699,636,91586,90566,77496,55227,49697
2408,283,605,1702,706,3.97499e+13,73.8119,1000.76,2408,131,121,1803,1764,1755,1752,920
24523,233,1306,17506,7017,3.71134e+13,680.796,4141.71,24523,336,282,21393,18928,15379,10772,7425
1039,63,329,727,312,3.50859e+13,55.5217,497.201,1039,88,61,686,594,539,500,237
14178,347,1489,9547,4631,3.38753e+13,358.744,3606.12,14178,386,269,12450,11744,8177,6991,5783
78627,1239,2705,56690,21937,3.76145e+13,1245.35,10210.7,78627,619,592,75490,74446,71857,67989,35806
59465,1391,2489,41827,17638,3.61169e+13,947.63,8499.31,59465,509,450,56904,55989,54439,51249,38383
57875,85,3035,40389,17486,3.67141e+13,793.36,9144.81,57875,600,566,44405,39059,27792,10188,6623
20425,1249,1562,14158,6267,3.62763e+13,529.804,4239.62,20425,352,292,18863,18643,17871,15999,17069
47699,2390,2605,33800,13899,3.69589e+13,901.906,8196.2,47699,524,470,45094,45067,45033,45061,44268
59180,633,2054,39812,19368,3.44143e+13,914.57,7864.25,59180,430,563,55577,53511,40889,32220,28069
28972,1298,1654,19702,9270,3.56127e+13,489.507,5211.8,28972,334,406,27318,27314,27157,27007,24588
78959,2986,2990,55485,23474,3.54441e+13,1082.78,10323,78959,675,520,75969,75969,75967,75969,75969
40370,1530,1901,28779,11591,3.71598e+13,822.173,6351.48,40370,453,424,38469,38075,37923,37549,35815
29450,557,1800,20555,8895,3.49135e+13,553.306,5432.13,29450,353,404,27117,26004,23247,17260,11375
29788,1385,1871,21119,8669,3.71453e+13,689.259,5616.86,29788,442,386,27917,27641,27229,26715,24113
6491,249,684,4210,2281,3.10294e+13,186.739,1601.5,6491,123,160,5771,5580,4977,3861,3379
55472,1482,2988,38667,16805,3.56493e+13,653.045,8948.27,55472,401,563,52484,52294,51106,50449,34906
65540,2153,2731,46732,18808,3.58997e+13,1083.35,9503.91,65540,491,491,62809,62658,62539,62419,58160
17159,436,1303,11896,5263,3.63738e+13,465.132,3460.63,17159,248,248,15686,15228,11487,8541,5723
68868,1156,2703,47966,20902,3.54678e+13,905.137,9517.94,68868,566,422,65969,65030,57577,41332,36224
66697,872,2238,46857,19840,3.6267e+13,1072.43,8339.74,66697,566,453,63698,61573,55073,37966,33723
20463,1499,1550,14094,6369,3.25888e+13,500.111,4163.39,20463,315,322,18913,18913,18907,18913,18838
34059,293,1788,23828,10231,3.68854e+13,630.773,5796.88,34059,396,406,30530,27337,21578,16676,9252
89572,1015,3238,62983,26589,3.71792e+13,971.672,10964.3,89572,567,508,85773,83961,69273,49665,45590
11137,514,1157,7621,3516,3.51013e+13,298.053,2826.15,11137,253,198,9980,9832,8762,6797,6481
69545,1234,2641,48863,20682,3.70001e+13,989.46,9296.58,69545,619,486,66611,65601,60551,48008,46670
73207,686,3338,51800,21407,3.69297e+13,953.531,10917.5,73207,653,561,68669,65922,49150,35529,22982
60837,1951,2301,42058,18779,3.40119e+13,967.317,8343.68,60837,431,421,58536,58464,57613,56880,54734
62622,745,2997,44250,18372,3.51704e+13,1081.99,10025.5,62622,654,565,58211,56076,46975,35263,23285
44160,1575,2278,30215,13945,3.51907e+13,596.279,7306.83,44160,359,437,41882,41727,41452,41155,29417
59055,1621,2425,41848,17207,3.71387e+13,861.047,8366.85,59055,526,512,56630,56507,55318,53386,50283
7376,258,1005,5049,2327,3.3975e+13,154.183,2155.16,7376,240,199,6354,6008,5149,3972,3198
98510,988,3402,67285,31225,3.51187e+13,1207.17,12144.9,98510,622,671,94210,92205,71161,58473,38748
4601,395,591,3120,1481,3.35585e+13,180.809,1331.68,4601,153,130,4010,4006,3944,3856,3527
21410,78,1287,14469,6941,3.60367e+13,564.067,4067.49,21410,328,351,15936,13696,9647,4237,3295
78412,1575,2154,54205,24207,3.35079e+13,1030.96,8953.14,78412,507,444,76258,75966,74318,70809,56920
83965,1747,4234,58248,25717,3.52786e+13,1070.98,13868.4,83965,671,788,79731,78762,69618,52133,42150
13574,290,1368,9548,4026,3.76298e+13,441.315,3442.79,13574,308,386,11697,10730,9440,8498,3508
5931,550,865,4018,1913,3.52435e+13,219.397,1873.41,5931,182,158,5066,4960,4714,4629,3537
13507,914,1318,9501,4006,3.64524e+13,312.541,3172.28,13507,270,252,12189,12167,11619,11710,9481
25572,45,1409,17634,7938,3.68891e+13,606.823,4588.21,25572,299,408,18218,14653,11336,5915,2248
56332,894,2129,40628,15704,3.69205e+13,960.368,8251.84,56332,503,431,53628,51997,49995,41352,31057
11243,630,1168,7545,3698,3.20858e+13,212.455,2767.74,11243,246,282,10075,9985,9821,9522,8346
38799,429,2247,26776,12023,3.61461e+13,600.845,7020.97,38799,354,438,35393,32701,25205,16487,11554
33330,1300,2204,23527,9803,3.33681e+13,586.859,6304.79,33330,391,350,31126,30715,30250,27998,24661
49764,1047,2212,34626,15138,3.40476e+13,815.181,7182.12,49764,445,390,47463,46521,43299,37195,35735
27908,577,2408,19950,7958,3.73717e+13,533.059,6278.17,27908,373,485,25305,24062,21974,18224,8836
95398,1343,3600,67235,28163,3.61631e+13,1027.95,12707.1,95398,670,638,91705,89918,79962,64751,45860
50445,1994,2705,36245,14200,3.67441e+13,920.545,8794.43,50445,536,517,47740,47619,46815,44497,41270
83977,1583,3066,58019,25958,3.22936e+13,1112.01,10846.1,83977,530,657,80911,79667,78026,71193,62725
72997,578,3324,50458,22539,3.46036e+13,967.562,10928.4,72997,650,497,68058,65338,42027,24131,20222
59642,2435,2877,41668,17974,3.58435e+13,763.355,9168.48,59642,481,491,56765,56747,56586,56547,52899
15663,575,1259,10747,4916,3.52866e+13,327.768,3306.04,15663,238,254,14404,14199,13318,12983,9714
55433,2091,2600,38636,16797,3.59618e+13,919.46,8606.44,55433,499,493,52833,52825,51733,49493,49019
33847,1713,1857,22767,11080,3.48502e+13,618.344,5755.88,33847,304,427,31990,31990,31954,31989,31576
15364,1318,1338,10417,4947,3.59406e+13,360.96,3559.35,15364,215,382,14026,14026,14024,14026,14011
85942,1656,2485,59308,26634,3.2566e+13,968.977,9969.72,85942,546,461,83457,83017,81353,76007,66380
38254,453,2719,25996,12258,3.48279e+13,556.215,7539.54,38254,609,424,34783,32970,21763,16761,12932
34248,858,1890,23865,10383,3.58478e+13,545.872,5976.68,34248,405,347,32358,32096,29375,26544,18900
86418,2423,3559,59609,26809,3.52663e+13,1158.73,11952.7,86418,530,581,82859,82420,80844,78119,71120
8181,760,1205,5733,2448,3.64906e+13,205.019,2475.49,8181,326,170,6976,6906,6755,5746,5561
66745,1581,2676,46398,20347,3.55552e+13,849.405,9358.64,66745,535,544,64069,63838,60738,54991,49087
17046,542,1104,11590,5456,3.4012e+13,385.95,3246.94,17046,265,234,15942,15671,12532,9387,9493
66577,2351,3372,47112,19465,3.64353e+13,753.965,10631.7,66577,664,444,63205,63148,60827,56502,50914
67364,1872,3558,47163,20201,3.63494e+13,851.416,11256.1,67364,552,600,63806,63322,60935,55649,43969
40429,455,2091,27855,12574,3.47192e+13,788.306,6975.12,40429,456,409,36737,34456,27384,20520,13144
10404,243,1170,7504,2900,3.60022e+13,272.002,2716.17,10404,252,181,8960,7951,7271,6035,3149
83678,2143,3812,57159,26519,3.52736e+13,1113.42,12327.3,83678,635,562,79866,79225,73804,63573,61874
72438,389,2309,51291,21147,3.67514e+13,1024.1,8763,72438,505,430,66148,61764,42251,25193,17097
58527,551,3051,40075,18452,3.56629e+13,804.501,9431.46,58527,691,530,53851,50768,30402,21638,19373
87587,760,3444,59783,27804,3.50781e+13,986.035,11910.8,87587,669,585,83053,81409,56124,38500,29892
46937,115,2039,32094,14843,3.35053e+13,752.911,6916.58,46937,381,462,38871,34314,24035,5772,5864
50078,2368,2846,35220,14858,3.67446e+13,668.649,8887.96,50078,385,625,47232,47227,47029,46966,43073
13766,1010,1648,9187,4579,3.28624e+13,248.677,3732.01,13766,300,253,12118,12096,11510,10095,8423
91245,300,3014,65239,26006,3.60234e+13,1146.95,11807.6,91245,771,487,82075,74152,50798,24515,19165
60872,1080,2886,41593,19279,3.52292e+13,985.038,9138.39,60872,544,660,57730,56653,42965,33844,35472
38509,531,1884,26656,11853,3.41381e+13,901.331,6143.65,38509,383,429,35404,33643,27891,18742,16629
88997,1609,2525,61635,27362,3.30696e+13,1185.57,10167.3,88997,524,568,86472,85515,82534,75761,69172
65746,948,2299,44930,20816,3.18581e+13,900.952,8578.18,65746,458,487,63125,61313,57035,46114,35757
62887,1882,3019,43481,19406,3.51509e+13,715.932,9961.76,62887,601,490,59868,59729,56243,48411,43535
49414,2344,2378,34373,15041,3.62573e+13,745.857,7895.36,49414,474,460,47036,47036,47033,47033,46934
82977,3304,3730,57603,25374,3.5924e+13,1146.3,12504.4,82977,614,668,79247,79115,79005,79074,76038
99866,505,3349,71356,28510,3.74616e+13,1188.18,11892.7,99866,655,511,92123,85233,60978,36895,32447
5286,26,826,3757,1529,3.50671e+13,122.212,1691.7,5286,129,153,3404,2625,1773,1196,435
43481,602,1877,29768,13713,3.5236e+13,599.452,6210.25,43481,402,417,41418,40886,29092,22039,21165
51600,70,1958,37339,14261,3.70963e+13,739.306,7326.25,51600,418,417,38654,32431,26782,7066,5083
10047,277,1093,7348,2699,3.82734e+13,292.766,2511.81,10047,268,210,8783,8252,7661,7493,3149
48084,1172,2477,33243,14841,3.33229e+13,700.638,7668.24,48084,377,427,45587,44706,43165,35533,30783
26008,1521,1807,18667,7341,3.70891e+13,603.659,5163.66,26008,347,348,24201,24081,24097,24051,22539
57557,1542,2244,40727,16830,3.69836e+13,946.449,7940.94,57557,561,458,55313,54928,53592,51278,46120
21287,766,1614,14784,6503,3.57571e+13,430.204,4488.59,21287,328,267,19673,19452,17900,13409,13090
71384,982,2415,50511,20873,3.49909e+13,916.058,9135.21,71384,532,476,68779,67492,61946,53352,34663
26288,528,1319,18612,7676,3.79741e+13,748.781,4465.3,26288,375,339,23854,22143,20754,14699,13813
3175,415,603,2314,861,4.03848e+13,100.227,1123.48,3175,137,98,2572,2564,2556,2529,2041
96751,236,2609,66726,30025,3.33312e+13,1396.12,11012,96751,619,572,86446,80270,50526,15344,15516
86718,3003,3449,60461,26257,3.50135e+13,1015.8,11608.5,86718,601,605,83269,83269,83063,82770,78556
42690,433,2594,29831,12859,3.37403e+13,667.489,7485.54,42690,451,496,39180,37085,28676,18410,11123
20892,1164,1658,14415,6477,3.1629e+13,352.824,4368.06,20892,322,252,19234,19210,18860,18370,16653
13075,329,980,9357,3718,3.74405e+13,558.878,2820.19,13075,278,228,11263,10326,9460,7104,5888
31649,56,1759,22841,8808,3.58524e+13,561.262,5554.63,31649,573,265,22507,18841,15574,4726,3430
8785,1073,1140,6097,2688,3.3105e+13,216.434,2528.1,8785,239,192,7645,7645,7645,7645,7411
17211,969,1546,12166,5045,3.75164e+13,423.561,3981.84,17211,292,344,15665,15574,15421,15517,13198
13809,940,1287,9607,4202,3.04025e+13,275.314,3042.24,13809,244,187,12522,12508,12442,12068,9571
41965,390,2098,29506,12459,3.5765e+13,603.89,6948.55,41965,470,442,38573,36537,30254,25364,12576
25551,1771,1789,17655,7896,3.43685e+13,679.157,5082.34,25551,385,309,23762,23762,23754,23755,23712
41605,1851,3059,28624,12981,3.51994e+13,584.628,8441.86,41605,564,581,38546,38470,35107,27406,25798
16170,812,1430,10823,5347,3.28166e+13,418.725,3784.45,16170,376,304,14740,14575,13702,11717,10855
33947,2435,2554,24107,9840,3.70371e+13,505.284,6936.52,33947,390,427,31393,31393,31384,31388,31160
59254,847,2801,41320,17934,3.5843e+13,1005.97,9374.79,59254,561,557,55819,54222,47031,36187,27257
36714,316,1394,24746,11968,3.48928e+13,566.674,5070,36714,331,333,32961,29966,21585,16331,10557
69567,2060,2557,48061,21506,3.37799e+13,933.577,9326.57,69567,434,463,67010,67004,66354,64961,60375
87122,1588,3431,59720,27402,3.38623e+13,1053.16,11868.5,87122,588,499,83551,82533,73873,56636,56699
45263,539,2338,31366,13897,3.58433e+13,767.227,7840.8,45263,417,599,41431,39341,33241,25472,17003
80304,361,2998,54849,25455,3.45338e+13,1030.34,10510.6,80304,566,541,72801,66938,43267,19640,18510
15915,404,1438,11245,4670,3.51461e+13,386.178,3628.04,15915,334,267,14199,13405,11909,9626,6681
95172,555,2905,66137,29035,3.35178e+13,1207.22,10846.5,95172,604,512,89343,86151,53396,36428,28884
85076,203,2417,61412,23664,3.66199e+13,900.798,9871.25,85076,741,403,73359,64805,45384,16232,17834
52318,2465,2615,36279,16039,3.58352e+13,784.179,8331.99,52318,450,496,49703,49703,49646,49539,49003
36636,354,2337,25447,11189,3.53624e+13,582.426,6778.84,36636,394,363,33007,30604,18677,13671,8554
11581,795,991,7931,3650,3.58786e+13,437.423,2694.71,11581,232,241,10590,10579,10240,9889,9758
9142,139,1239,6393,2749,3.56287e+13,207.067,2708.53,9142,187,253,7450,6644,5425,2544,1634
61206,1211,3144,42836,18370,3.62979e+13,719.223,10006.9,61206,487,612,58055,57210,54993,50827,31284
68319,1894,2990,47739,20580,3.57773e+13,911.632,10204.1,68319,550,654,65329,64929,63655,60251,53024
86219,1630,3802,60490,25729,3.68362e+13,1144,12801.7,86219,642,575,82343,81387,75690,60873,52761
62439,2059,2603,44306,18133,3.61664e+13,965.876,9038.91,62439,655,481,59836,59763,57882,52889,55350
53119,1777,2404,37152,15967,3.40891e+13,909.101,8134.36,53119,554,420,50715,50472,48911,45110,43314
36138,846,2179,25351,10787,3.56669e+13,571.143,6453.24,36138,435,371,33959,33218,29576,22377,20842
43519,997,2133,30066,13453,3.25207e+13,730.038,6690.21,43519,452,431,41334,40843,39145,36316,27309
83289,1995,3043,59666,23623,3.70021e+13,942.382,11067.4,83289,591,608,80246,80098,79072,76647,62382
66681,1016,2028,47310,19371,3.69923e+13,900.868,8089.77,66681,505,450,64407,63317,60025,51442,48150
45607,333,2446,30861,14746,3.37065e+13,813.905,6877.64,45607,520,416,41769,38669,21731,9962,11086
50832,618,2831,36216,14616,3.6592e+13,803.843,8859.85,50832,765,417,46825,44510,32979,24071,19757
29322,1209,2120,20715,8607,3.62644e+13,677.872,5972.59,29322,395,425,27202,26731,26022,24901,20715
70453,1417,2947,48791,21662,3.59677e+13,958.153,9907.77,70453,584,522,67506,66589,60796,46563,51274
51999,938,2498,35621,16378,3.35581e+13,686.161,8189.86,51999,455,531,49233,48584,44353,34680,24153
25442,699,1738,17714,7728,3.60848e+13,460.571,4787.29,25442,368,262,23704,23251,20710,15970,15815
91491,587,3571,65722,25769,3.71219e+13,1136.72,12943.1,91491,682,791,85158,81541,67718,50276,27060
67617,141,3904,45922,21695,3.51545e+13,652.154,11482.5,67617,585,631,56486,49499,30931,13050,9348
14821,971,14821,0,14821,15.9989,0,14821,14821,14821,1,0,0,0,0,0
27352,770,1650,19335,8017,3.57385e+13,618.98,5036,27352,332,315,25547,24554,24183,21898,18199
8467,227,1216,6055,2412,3.7704e+13,219.55,2556.94,8467,265,205,7099,6582,5187,3948,2261
86150,683,3448,59232,26918,3.51811e+13,1085.54,11676.8,86150,625,567,80986,77968,57405,39292,34528
93489,2250,2767,64785,28704,3.36115e+13,1004.15,10414.9,93489,520,532,90722,90694,90087,88921,83882
68766,757,2866,48144,20622,3.65846e+13,806.409,9844.63,68766,518,476,65073,63443,46990,32552,26453
23250,583,1582,16425,6825,3.69188e+13,536.985,4417.96,23250,336,254,21569,20982,19040,14153,14172
79143,53,3198,54842,24301,3.42354e+13,1108.62,11165.7,79143,544,588,57419,45666,33472,11674,5128
51935,2404,3080,36295,15640,3.55478e+13,765.964,9243.47,51935,596,543,48855,48783,47760,45124,43516
59230,1454,2406,42262,16968,3.69407e+13,1158.19,8505.13,59230,591,510,56721,55238,53816,48645,45009
72835,829,2559,50784,22051,3.54955e+13,1002.3,9752.65,72835,525,596,69242,66910,61236,43406,35217
94632,5362,5378,64492,30140,3.60252e+13,1148.7,15780.2,94632,719,820,89254,89254,89254,89251,89242
36121,1628,2597,24801,11320,3.48409e+13,584.676,7177.13,36121,424,492,33524,33440,32853,32414,24896
95069,469,3689,65679,29390,3.52429e+13,1213.01,12919.6,95069,632,752,87046,82617,53314,28507,23969
82268,2530,3397,59008,23260,3.75858e+13,1017.94,11707,82268,600,571,78871,78785,78349,77225,69327
1534,113,187,1020,514,2.81658e+13,84.1838,456.458,1534,71,68,1347,1248,1159,1209,1065
88313,145,2627,61639,26674,3.57685e+13,1133.48,10239.7,88313,600,532,72669,62469,46184,15722,12634
61854,3012,3338,43452,18402,3.55995e+13,702.98,10668.2,61854,548,779,58516,58497,58363,58221,56665
52636,1580,2067,37295,15341,3.69185e+13,848.551,7141.62,52636,517,404,50569,50420,49871,49366,47088
75307,1579,2965,53258,22049,3.54132e+13,1012.52,10263.8,75307,566,469,72342,71623,66865,56072,49048
15979,153,1272,11113,4866,3.60915e+13,555.576,3484.46,15979,295,291,13569,12302,9192,6366,2817
11439,594,1376,7866,3573,3.47125e+13,286.733,3219.59,11439,326,271,10063,9839,8906,7685,6800
13580,1276,1326,9559,4021,3.68406e+13,287.895,3330.98,13580,211,326,12254,12254,12246,12231,12053
57558,2690,2775,40443,17115,3.70043e+13,796.539,8906.99,57558,668,403,54783,54783,54762,54745,54524
81437,2588,3300,55975,25462,3.42192e+13,1065.37,11205.7,81437,595,527,78137,77861,76763,73565,72254
90905,1292,2857,64844,26061,3.65395e+13,1131.45,11230.5,90905,639,515,87932,84200,75192,52040,53150
46091,793,1872,33109,12982,3.68521e+13,887.279,6549.18,46091,493,415,43521,42526,38979,28377,27028
13050,410,1324,9091,3959,3.62971e+13,407.178,3292.05,13050,311,263,11395,10552,9256,7669,5739
15644,985,1418,11028,4616,3.38788e+13,305.641,3586.33,15644,263,256,14226,14190,13818,12184,11823
2857,138,561,2099,758,3.95611e+13,108.45,1018.95,2857,138,120,2279,2066,1994,1910,784
7191,268,911,5220,1971,3.55263e+13,193.572,2035.91,7191,181,178,6229,5905,5444,5211,2160
55845,2479,2846,38047,17798,3.43937e+13,673.289,8827.04,55845,515,515,52999,52999,52783,52632,51093
96785,1505,2826,68046,28739,3.62341e+13,1278.83,11713.1,96785,607,511,93752,92770,89019,78608,68632
69444,1070,2342,48166,21278,3.33193e+13,947.409,8616.31,69444,520,518,66916,65081,60410,43804,44597
39382,1335,2264,27593,11789,3.63734e+13,594.389,6759.56,39382,468,398,37118,36863,35166,31392,28393
62417,27,2172,44112,18305,3.78614e+13,1064.85,7985.22,62417,584,422,39775,30894,23210,10516,4442
65607,1788,2472,44844,20763,3.47384e+13,528.104,8836.5,65607,549,327,63135,63041,58976,49569,45515
42505,207,1850,28983,13522,3.09039e+13,556.85,6255.6,42505,315,404,38218,35237,23551,10953,9260
37615,1828,1908,26284,11331,3.51051e+13,701.012,6060.51,37615,430,382,35707,35705,35607,35614,35443
94282,506,3211,66189,28093,3.55308e+13,1111.22,12016.2,94282,718,592,87771,84413,62646,42304,26447
86926,505,3013,59921,27005,3.48784e+13,1239.46,10566.3,86926,516,549,81873,79127,50137,30165,27822
73291,745,2677,52058,21233,3.72681e+13,1019.61,9822.93,73291,620,500,69071,65711,49676,34529,31054
46084,867,2145,31829,14255,3.42778e+13,562.147,6996.48,46084,459,363,43939,43462,40071,32310,28454
37992,1309,2498,26567,11425,3.70378e+13,643.176,7375.92,37992,545,374,35494,35223,32625,25084,25112
69903,816,2298,50080,19823,3.58453e+13,1044.1,8983.33,69903,659,466,66326,64160,55458,39256,36633
15864,232,1207,10961,4903,3.31603e+13,505.474,3327.55,15864,241,256,13801,13003,10703,7077,4597
99165,3264,4034,66820,32345,3.47527e+13,810.682,12840.2,99165,636,485,95131,95126,93051,89712,89320
89138,2229,3331,61427,27711,3.46776e+13,1230.34,12109.4,89138,554,532,85807,85144,82870,73961,68608
80441,2882,3006,56207,24234,3.51103e+13,961.277,10357.5,80441,551,558,77435,77435,77400,77418,77252
94785,668,3421,65890,28895,3.5214e+13,975.347,11987.5,94785,641,541,89113,85583,60114,40894,34722
62677,115,2642,42608,20069,3.49855e+13,663.615,8830.86,62677,511,406,51168,44972,29167,11320,9362
96197,2680,3422,66498,29699,3.55006e+13,1139.2,11857.1,96197,626,605,92775,92742,91787,89005,87346
56733,949,2551,40442,16291,3.74993e+13,911.26,8450.97,56733,508,402,53898,52370,48630,35547,33845
46075,1300,2654,31929,14146,3.65346e+13,746.117,8194.67,46075,418,641,43421,42861,42058,40418,28875
29835,277,2084,20256,9579,3.4062e+13,505.901,5879.05,29835,490,358,26526,24266,16834,11138,7395
73166,1165,2152,49761,23405,3.37932e+13,608.957,7983.71,73166,443,445,71014,70591,66314,58163,46904
10392,618,1084,7113,3279,3.51492e+13,394.456,2620.6,10392,256,255,9308,8949,8787,8153,6800
57459,919,2819,39883,17576,3.56587e+13,1000.06,9216.42,57459,548,542,53789,52077,47522,41051,24483
70402,975,3238,49931,20471,3.64144e+13,838.454,10703.7,70402,615,469,66887,65458,50441,34683,26006
17177,1035,1127,11902,5275,3.07041e+13,270.221,3199.25,17177,267,202,16050,16049,16042,15973,15784
13960,1492,1726,9935,4025,3.80352e+13,279.348,3908.64,13960,267,405,12234,12234,12171,12215,10958
94105,639,3457,65140,28965,3.49669e+13,1206.36,12288.6,94105,601,596,88616,85434,54755,38959,30910
54888,2228,2569,37458,17430,3.49798e+13,806.036,8509.07,54888,510,510,52319,52311,51950,51857,49163
3216,161,739,2302,914,3.9344e+13,82.1035,1265.43,3216,146,121,2477,2300,1448,642,492
46750,1548,1851,32986,13764,3.69058e+13,643.232,6583.39,46750,469,311,44899,44866,43900,42474,42994
82549,407,2811,57656,24893,3.54257e+13,1055.87,10679.9,82549,665,536,76056,72527,47455,22719,21691
72100,857,3104,50411,21689,3.65116e+13,1181.82,10246.1,72100,627,560,67874,65678,52246,39007,32988
11589,616,1041,8015,3574,3.52343e+13,299.646,2722.65,11589,191,231,10548,10454,9806,8929,6878
60885,1840,2893,42642,18243,3.57442e+13,757.776,9332.27,60885,588,432,57992,57805,56182,50038,49412
51831,689,2611,36141,15690,3.55947e+13,973.376,8400,51831,475,540,47976,45602,38705,30628,20867
93568,638,3016,67851,25717,3.69084e+13,1055.64,11544.2,93568,775,602,87474,82952,60319,42480,25427
10689,84,1191,7681,3008,3.56626e+13,263.581,2788.57,10689,258,189,8093,6995,5294,2054,1217
48543,2081,2802,33891,14652,3.56257e+13,817.411,8349.12,48543,478,508,45741,45727,45053,44576,39684
89479,1114,2852,62456,27023,3.5948e+13,1237.83,11389.5,89479,657,555,85886,83871,75098,54630,47889
49228,2143,2453,34212,15016,3.58887e+13,856.504,7836.98,49228,451,403,46775,46611,46639,46550,45064
4444,79,767,3022,1422,3.55168e+13,167.727,1572.18,4444,134,237,3291,2865,2098,1991,445
66476,1166,2955,46705,19771,3.8054e+13,961.725,9787.13,66476,532,625,63450,61881,54007,38862,37909
71113,415,2227,50370,20743,3.63386e+13,875.956,8439.44,71113,585,399,65810,62037,50596,41994,22117
47530,511,1852,33818,13712,3.57795e+13,808.303,6699.7,47530,442,402,44120,41246,35619,23790,17414
11400,415,1352,7671,3729,3.42634e+13,218.14,3167.89,11400,166,343,10048,9694,9163,9225,4322
38819,244,2491,26764,12055,3.53386e+13,732.421,7149.54,38819,428,529,33762,30194,21338,10107,7305
89306,1986,2162,63905,25401,3.74e+13,976.574,9569.11,89306,574,466,87144,87142,86889,86499,85591
93223,487,3510,64355,28868,3.39333e+13,988.563,12081.4,93223,527,577,86877,83623,53845,30408,20038
23021,172,1470,16242,6779,3.73519e+13,525.167,4348.15,23021,388,329,19467,17003,12663,7201,5497
68591,1265,2160,47261,21330,3.38989e+13,763.961,7875.76,68591,405,329,66431,65953,62370,52341,53837
75975,1260,3112,51926,24049,3.38382e+13,926.488,10069.2,75975,594,556,72548,71447,65232,50953,42831
89092,1345,2772,61472,27620,3.52996e+13,871.47,10584.9,89092,641,537,86320,85783,78645,63784,58263
43822,109,2553,30682,13140,3.59646e+13,684.624,7446.17,43822,581,451,34137,30217,20744,7030,6263
69285,511,2258,48892,20393,3.57345e+13,1310.97,9199.59,69285,517,476,64329,60849,49429,31107,22406
14136,804,1365,10125,4011,3.73214e+13,397.562,3390.6,14136,261,257,12771,12492,12193,11811,9701
18504,304,2016,12812,5692,3.39384e+13,296.853,4747.67,18504,403,277,16290,15260,9654,5835,3048
24192,283,1551,16716,7476,3.50119e+13,494.7,4537.11,24192,401,268,21599,19461,14179,10688,6583
18504,731,1439,12629,5875,3.51139e+13,538.057,3982.65,18504,276,350,17063,16586,15307,12722,12200
3050,88,517,2132,918,3.91838e+13,155.554,1042.83,3050,102,115,2282,2042,1683,1391,965
95247,2243,2936,64024,31223,3.41749e+13,995.348,11227.5,95247,509,580,92311,92299,91856,91326,87197
25740,41,1963,17622,8118,3.3397e+13,540.982,5414.96,25740,399,385,17633,13595,10579,3038,2094
48157,2485,2539,33646,14511,3.62475e+13,957.952,8197.91,48157,582,547,45618,45618,45618,45617,45491
3165,318,420,2184,981,3.42434e+13,216.252,950.261,3165,133,123,2745,2409,2590,2613,2514
56787,2150,3092,39562,17225,3.62654e+13,1085.56,9364.41,56787,595,545,53695,53058,51656,48683,46375
80435,2345,2662,56465,23970,3.6892e+13,1122.54,9845.7,80435,561,473,77773,77772,77652,77675,76162
79414,2007,2785,55728,23686,3.65031e+13,952.538,9894.25,79414,595,398,76629,76527,74349,70403,69361
11954,786,1039,8037,3917,3.47954e+13,452.477,2817.41,11954,228,287,10915,10721,10519,9997,9701
30251,705,1567,21432,8819,3.61166e+13,642.899,4902.91,30251,328,366,28471,28112,25348,20540,17904
77522,1184,2656,53820,23702,3.23357e+13,1125.27,9955.63,77522,623,558,74439,72453,68323,52587,52250
86968,813,2144,62915,24053,3.6885e+13,1082.04,9297.54,86968,603,511,83188,79892,73867,57211,47353
98864,2159,3288,71577,27287,3.72227e+13,1139.75,12523.4,98864,798,551,95576,95362,92909,82930,81142
39746,1343,1705,27190,12556,3.50669e+13,572.866,6143.76,39746,402,350,38041,38035,36789,35770,33366
42066,1353,2270,30122,11944,3.61467e+13,700.521,7266.67,42066,421,513,39796,39683,38844,38434,26644
99773,1604,2663,71150,28623,3.7058e+13,1159.31,11505.5,99773,647,496,97110,96320,90619,77234,74594
4088,730,747,2957,1131,4.00425e+13,151.957,1394.39,4088,178,144,3341,3341,3339,3338,3306
17594,235,1403,12345,5249,3.4118e+13,432.728,3758.19,17594,272,272,15469,14459,10493,7141,3763
83588,695,3583,57792,25796,3.45485e+13,1120.64,11993.1,83588,571,772,78398,75907,57551,44409,26824
60038,1136,2406,42797,17241,3.65177e+13,877.316,8407.74,60038,581,454,57516,56479,51870,37821,41929
72137,1234,3206,51784,20353,3.56183e+13,927.158,11301.2,72137,611,658,68838,66984,63921,57030,35110
99903,862,2974,68802,31101,3.36269e+13,1289.47,11490.3,99903,634,641,95224,92576,74259,51682,43674
25890,196,1640,17566,8324,3.36248e+13,471.176,4697.74,25890,317,259,22736,20790,15448,10443,6714
39610,452,2062,28277,11333,3.60395e+13,547.54,6614.24,39610,367,427,36826,35402,31346,24880,12970
52253,1722,2863,36565,15688,3.49944e+13,788.385,8872.68,52253,551,407,49390,49050,46827,40214,39258
99572,1588,3901,68327,31245,3.51689e+13,1104.51,13275,99572,591,590,95535,94229,82342,62135,55485
45975,1497,2477,31623,14352,3.54582e+13,1025.62,7909.63,45975,497,525,43498,42670,41124,37330,35552
76116,827,2894,54318,21798,3.73001e+13,980.945,10504.4,76116,593,484,72243,69491,54498,38363,29498
44369,675,2497,31079,13290,3.59865e+13,583.997,7712.12,44369,385,396,41619,40185,36267,26454,18548
70814,2607,3708,48687,22127,3.44919e+13,979.914,11351.6,70814,478,543,67106,66742,64813,60913,53123
56470,1118,2403,40137,16333,3.68443e+13,818.642,8184.74,56470,518,443,54067,53365,50167,42984,43088
33228,486,2675,23571,9657,3.57812e+13,639.403,7052,33228,589,493,30037,29069,22665,20027,10919
41536,481,2562,28420,13116,3.41509e+13,599.437,7569.9,41536,354,472,38196,36373,26153,20048,11021
6489,315,568,4377,2112,3.5189e+13,304.015,1556.54,6489,185,156,5770,5067,5202,4659,4669
27458,324,1883,19640,7818,3.59146e+13,610.085,5433.88,27458,408,326,24601,22627,18998,14750,6541
98993,1217,3862,68279,30714,3.45992e+13,1247.68,13863.9,98993,785,487,94382,91507,67785,51292,45193
10965,418,905,7615,3350,3.5482e+13,325.564,2418.04,10965,210,197,10051,9450,7486,4972,4776
21487,564,1720,14909,6578,3.67084e+13,537.106,4678.35,21487,335,371,19505,18909,17583,14181,8462
23081,105,1694,16050,7031,3.49766e+13,578.581,4636.57,23081,399,286,18043,15256,10958,3078,3360
31609,499,1847,21728,9881,3.49958e+13,701.444,5613.77,31609,405,345,28998,27197,20898,16154,13225
72733,1416,2875,50024,22709,3.60164e+13,765.059,9962.82,72733,536,483,69858,69471,65588,57585,55277
29162,1260,2107,20343,8819,3.4732e+13,458.005,5691.48,29162,416,276,27055,26949,25929,23587,21437
47163,2307,2429,33055,14108,3.62035e+13,804.127,7697.68,47163,457,458,44734,44734,44707,44732,44359
65004,1710,2529,45008,19996,3.32954e+13,987.639,9001.79,65004,566,432,62475,61811,59777,52487,51267
58125,1953,2272,40307,17818,3.48968e+13,995.452,8550.57,58125,508,567,55853,55592,55497,55256,49981
35551,34909,35551,0,35551,15.9995,0,35551,35551,35551,1,0,0,0,0,0
62508,1805,2116,43286,19222,3.20174e+13,933.127,7817.62,62508,442,389,60392,60391,60173,59899,59579
86474,495,3678,60799,25675,3.6403e+13,1050.99,12793.4,86474,635,738,79602,75839,49683,28998,14751
28936,1611,1960,19981,8955,3.65652e+13,487.681,5547.85,28936,315,334,26976,26976,26903,26937,25694
33662,458,2058,23895,9767,3.62256e+13,703.145,5964.43,33662,370,394,30894,29438,24599,16080,12478
90124,2000,2907,62834,27290,3.63345e+13,1288.42,11052.4,90124,596,491,87217,86319,82856,75402,76365
21054,1181,1653,14845,6209,3.56499e+13,511.535,4424.6,21054,421,258,19401,19309,18534,17774,17250
36350,2122,2742,25059,11291,3.47323e+13,761.895,7718.57,36350,456,627,33608,33505,33324,33330,29940
64926,78,2180,44328,20598,3.50977e+13,787.599,8093.21,64926,510,381,48158,41076,30556,9824,7436
41179,1568,1983,28213,12966,3.4943e+13,764.248,6467.99,41179,417,386,39196,39010,38807,38691,35435
44240,1782,2181,31053,13187,3.45311e+13,748.125,6996.32,44240,441,372,42059,42024,41901,41673,38051
68643,2803,3574,48597,20046,3.65458e+13,852.647,11746.3,68643,476,769,65069,65059,64760,64727,57672
77508,1349,3281,54355,23153,3.50939e+13,900.582,11198.6,77508,774,431,74227,73128,65261,46225,39543
52164,469,2422,37312,14852,3.74335e+13,1103.37,8394.88,52164,645,440,47245,44726,32174,22234,17206
21900,517,1115,15233,6667,3.52323e+13,621.627,3745.04,21900,324,272,20149,18894,18075,14001,12997
7709,284,867,5422,2287,3.7539e+13,217.157,2057.29,7709,167,200,6825,6092,5883,6021,2980
97320,2765,2995,69493,27827,3.71029e+13,1128.12,12018.9,97320,667,652,94325,94319,94218,94088,92634
40232,112,2217,28534,11698,3.67166e+13,829.786,6981.95,40232,521,425,32082,28014,21002,7699,5208
17487,739,1255,11964,5523,3.49767e+13,626.327,3754.11,17487,284,403,16057,15444,14718,12580,12912
94055,2552,3238,65868,28187,3.43752e+13,1106.33,12123.4,94055,817,521,90817,90769,89162,76803,79761
17469,740,1714,12428,5041,3.82248e+13,371.148,4147.92,17469,253,310,15755,15515,14854,14756,9377
14276,384,1223,10204,4072,3.39026e+13,311.24,3243.81,14276,355,166,13001,12627,10875,7870,7026
1846,458,461,1250,596,3.71337e+13,103.598,796.641,1846,86,112,1385,1385,1385,1385,1384
91813,1889,4004,62004,29809,3.4026e+13,1193.8,13308.4,91813,644,758,87809,86808,81681,66913,59401
80631,2620,2719,55747,24884,3.2842e+13,766.421,9658.3,80631,609,495,77912,77912,77792,77693,75649
46228,1550,2196,31789,14439,3.6078e+13,576.285,7319.02,46228,449,405,44032,43978,42815,40394,39912
52717,2093,2298,37885,14832,3.7139e+13,951.961,8006.64,52717,466,433,50419,50406,50342,50163,47777
95944,2579,3293,67315,28629,3.53323e+13,1161.8,12192.2,95944,693,591,92651,92452,91792,89111,86245
92358,2584,2870,65245,27113,3.50902e+13,1126.57,11067.6,92358,651,441,89488,89481,89357,89374,87859
97159,1311,2985,68814,28345,3.55157e+13,1181.8,11617.5,97159,677,503,93762,92134,82496,62317,47076
46650,1005,2884,31409,15241,3.39615e+13,679.38,8533.59,46650,546,660,43629,43079,41021,37641,24190
24857,1404,1598,17274,7583,3.54903e+13,483.948,4783.52,24857,300,394,23259,23257,23208,23213,22584
75675,1887,3336,51999,23676,3.40907e+13,723.976,11369.9,75675,695,472,72339,72221,65363,51973,42693
23928,270,1369,16126,7802,3.39532e+13,498.743,4045.45,23928,250,286,21137,18728,12593,7516,7236
2606,125,499,1761,845,3.5431e+13,98.5875,964.508,2606,95,123,2084,1877,1613,1607,707
50138,1973,2678,34873,15265,3.6344e+13,818.821,8174.9,50138,472,478,47460,47163,46674,45734,41931
83132,2809,2832,58072,25060,3.60754e+13,1021.8,9687.65,83132,592,464,80300,80297,80297,80299,80228
14869,703,1316,10119,4750,3.06306e+13,253.505,3220.19,14869,235,230,13553,13388,13006,11418,11159
99117,2286,3168,70137,28980,3.65138e+13,996.946,11596.8,99117,643,614,95949,95861,91632,81898,82783
11741,5832,11741,0,11741,15.9986,0,11741,11741,11741,1,0,0,0,0,0
36759,732,1639,24714,12045,3.37038e+13,669.35,5732.41,36759,340,379,34789,33601,28963,20659,19996
20466,1263,1265,14032,6434,3.45009e+13,330.914,3806.56,20466,249,299,19201,19201,19201,19201,19200
26530,528,1981,18575,7955,3.43694e+13,802.145,5471.2,26530,374,454,23931,22764,20246,17870,8473
49248,40,1801,33955,15293,3.07588e+13,776.083,6536.19,49248,361,359,34095,24737,20989,5316,3110
30353,1610,2068,21978,8375,3.64398e+13,548.369,5963.63,30353,552,275,28285,28277,27782,26382,25914
90360,383,3278,64511,25849,3.74075e+13,1161.27,11800.7,90360,571,563,82655,77067,53658,25806,19327
89316,2938,3133,62986,26330,3.67817e+13,1124.27,10954,89316,586,508,86183,86181,86115,86163,85545
15295,723,1052,10906,4389,3.60362e+13,481.458,3015.27,15295,306,237,14243,13848,13314,12716,11987
62065,757,2305,44039,18026,3.65035e+13,698.913,8004.01,62065,540,367,59572,58231,51101,35059,38494
53754,2568,2728,38573,15181,3.68441e+13,975.122,9161.86,53754,585,541,51026,50845,50802,50318,50228
60968,2421,3281,42679,18289,3.62544e+13,761.547,9971.13,60968,657,439,57687,57614,56420,51861,51987
19279,253,1075,13108,6171,3.55036e+13,404.873,3364.47,19279,276,300,16756,14532,11748,9065,8383
94280,3018,3512,66322,27958,3.63095e+13,1303.32,12558.5,94280,690,586,90768,90742,89605,85234,86190
46943,1172,2242,32558,14385,3.19334e+13,819.216,7283.27,46943,485,399,44444,43366,40638,28867,26360
46201,2123,2582,31900,14301,3.60887e+13,683.695,8014.64,46201,463,427,43619,43598,42640,41642,39499
4120,564,684,2746,1374,3.73709e+13,101.239,1289.24,4120,193,137,3436,3436,3429,3429,3268
37980,2300,2448,26239,11741,3.36426e+13,781.88,7090.05,37980,532,512,35532,35530,35390,35366,35093
33758,339,1580,23600,10158,3.12837e+13,685.199,5108.25,33758,369,355,30920,29414,25072,20992,8294
34283,965,1672,23688,10595,3.50624e+13,711.884,5551.71,34283,405,346,32611,32018,30205,27356,26261
52742,445,2155,35642,17100,3.41307e+13,738.445,7141.75,52742,425,418,48691,46062,28817,20972,19247
85678,537,3159,59911,25767,3.59342e+13,878.09,11159.7,85678,659,476,79558,74249,48720,27067,24032
68392,1263,2597,47707,20685,3.51642e+13,902.084,8775.78,68392,572,464,65787,64814,59203,43567,39822
52390,641,2339,36174,16216,3.60842e+13,712.624,7898.56,52390,470,623,49277,47618,39199,32430,18538
64929,2035,2644,44613,20316,3.46555e+13,655.501,8741.81,64929,445,552,62285,62220,61079,58451,57515
14504,683,1291,10354,4150,3.73192e+13,411.262,3419.27,14504,295,266,13213,12866,11814,9300,8949
49450,1223,2289,34588,14862,3.43303e+13,832.769,7475.57,49450,446,445,47161,46591,44291,36290,32942
95648,3830,4022,65889,29759,3.34386e+13,1024.29,13242.3,95648,729,570,91626,91626,91570,91610,90782
55404,26,2486,38231,17173,3.4588e+13,881.795,8726.55,55404,568,491,33422,24304,19655,8173,3785
97751,1779,3343,68572,29179,3.63555e+13,1206.59,12489.3,97751,662,663,94408,93607,89430,76579,76949
92680,1056,4059,63391,29289,3.26904e+13,1051.26,13497.2,92680,632,603,87985,85591,68470,50842,38828
53037,46,2150,36820,16217,3.44292e+13,661.345,6991,53037,385,405,36889,29440,22498,6982,5584
49570,1318,2703,33956,15614,3.50689e+13,873.45,8303.45,49570,521,478,46867,46231,41593,33972,35074
53656,3062,3141,36979,16677,3.58661e+13,776.374,9562.82,53656,480,625,50515,50515,50503,50514,50362
66714,1328,2537,45288,21426,3.42394e+13,667.647,8000.59,66714,498,436,64177,63853,59772,50956,46914
30672,1595,1686,21722,8950,3.40222e+13,663.816,5109.4,30672,395,271,28986,28958,28893,28865,28629
94104,2103,2887,65988,28116,3.56051e+13,1413.28,11230.8,94104,689,572,91217,90525,87752,81711,78550
94012,2842,3002,64502,29510,3.40073e+13,1288.72,11586.6,94012,578,487,91010,90875,90933,90935,90052
97683,90205,97683,0,97683,15.9998,0,97683,97683,97683,1,0,0,0,0,0
91077,344,3672,64256,26821,3.58884e+13,1148.11,12553.5,91077,712,558,81732,75675,52324,21734,18322
19793,1182,1415,13775,6018,3.58639e+13,444.325,4022.98,19793,308,367,18378,18368,18286,18221,17570
8626,253,969,6080,2546,3.56697e+13,322.931,2282.69,8626,239,211,7236,6335,5336,4215,2693
53232,2384,2656,36533,16699,3.53723e+13,607.794,7933.77,53232,520,393,50576,50572,50470,50420,49626
98661,395,2635,70445,28216,3.73335e+13,1048.85,11104.9,98661,622,553,89585,83039,63312,37113,24378
34551,772,2100,24209,10342,3.55894e+13,693.591,6142.29,34551,415,382,32138,31280,23985,16536,12683
34483,408,2634,23752,10731,3.51387e+13,579.352,7166.43,34483,451,345,30851,28841,19379,12246,7074
8561,988,1258,5912,2649,3.53645e+13,226.255,2641.13,8561,258,277,7303,7279,7253,7240,6319
45956,2128,2418,31656,14300,3.51613e+13,860.151,7707.75,45956,491,446,43538,43477,42989,42427,41182
39926,1685,2305,27656,12270,3.48011e+13,484.324,6944.73,39926,359,476,37621,37604,37317,37243,31642
92196,1611,3818,63225,28971,3.41943e+13,1124.23,12076.5,92196,758,677,88069,87027,75091,63713,52574
51304,732,2512,35664,15640,3.36899e+13,784.629,7808.87,51304,469,375,48108,47038,29596,22448,15495
35541,1475,2048,24675,10866,3.51461e+13,544.361,6049.45,35541,404,341,33493,33425,32209,28358,28859
28490,71,2287,20488,8002,3.68766e+13,537.238,6048.58,28490,378,370,21332,18335,14389,5763,3478
91774,2675,4059,62486,29288,3.5029e+13,1068.19,13775.3,91774,678,660,87715,87543,82620,70855,64871
79662,1892,2294,57490,22172,3.74793e+13,1095.2,9261.88,79662,627,447,77368,77346,75961,74165,74256
35577,128,1974,24135,11442,3.41956e+13,580.321,6199.16,35577,375,363,29075,25510,16799,6879,5473
52122,238,2344,35600,16522,3.45983e+13,972.074,7864.59,52122,512,482,45417,41533,26644,10773,9652
96192,3110,3287,67500,28692,3.62747e+13,1282.05,12357,96192,629,657,92905,92904,92844,92809,91684
65554,2133,2569,45628,19926,3.49658e+13,784.137,8434.78,65554,477,379,62985,62972,62776,62457,56703
53357,1816,2261,37698,15659,3.66033e+13,969.143,7837.82,53357,463,420,51096,50934,50367,50010,46553
47706,1580,2176,33710,13996,3.55814e+13,773.049,7281.04,47706,518,451,45530,45502,44576,43526,40818
60740,2551,2706,42634,18106,3.68051e+13,859.818,8812.18,60740,501,378,58034,58034,58015,58014,57582
77753,867,3088,53519,24234,3.54044e+13,937.729,10034.6,77753,593,547,74301,72953,57217,46416,35985
99619,487,2558,69600,30019,3.38902e+13,1266.99,11045.3,99619,664,576,92495,88652,66346,45116,26987
78458,1624,2622,53593,24865,3.36013e+13,732.454,9392.35,78458,504,482,75836,75572,71100,65151,59457
35576,1362,2272,24498,11078,3.54271e+13,533.417,6665.65,35576,402,419,33304,33125,32107,28363,25406
65717,2138,2571,44588,21129,3.54952e+13,858.341,8891.65,65717,516,518,63146,63141,62958,62869,61630
69301,2219,2371,47457,21844,3.54957e+13,738.834,8530.88,69301,479,414,66930,66930,66851,66684,66478
41122,1452,2070,29000,12122,3.57948e+13,758.12,6613.99,41122,496,394,39052,38885,37148,34059,34213
97222,2247,3445,66970,30252,3.32112e+13,801.063,11748.2,97222,618,498,93777,93664,91287,88318,78055
82460,1585,2504,58351,24109,3.6423e+13,848.775,9482.2,82460,537,460,79956,79865,78217,75781,70800
75625,1063,3116,52389,23236,3.43309e+13,1044.92,10593.8,75625,609,517,72083,70965,56822,36200,35048
33806,723,1795,23740,10066,3.61828e+13,709.259,5856.58,33806,389,386,31665,30462,27468,21560,16803
57388,1279,2006,41385,16003,3.77685e+13,874.517,7761.39,57388,460,412,55379,54675,53848,51438,40195
37105,1020,2400,26027,11078,3.51716e+13,707.058,6968.43,37105,440,420,34673,33843,32732,28433,22912
97827,711,3051,68193,29634,3.49747e+13,1076.76,12071.1,97827,684,611,92625,89225,63450,48359,36460
63992,567,2286,44629,19363,3.36413e+13,766.378,8302.7,63992,459,404,60779,59102,50476,32285,25987
76368,2201,2461,53377,22991,3.20686e+13,944.216,9297.7,76368,544,517,73907,73886,73790,73798,73050
42703,771,2604,29477,13226,3.50165e+13,623.401,7380.58,42703,388,358,39963,39329,32992,22200,19084
89762,473,4395,63015,26747,3.49554e+13,1172.55,14309.6,89762,643,787,82027,77750,54027,31003,15498
14639,1373,1541,10529,4110,3.75457e+13,374.518,3654.65,14639,260,219,13098,13088,13085,13088,12726
48390,512,1634,34225,14165,3.61336e+13,772.639,6405.47,48390,428,378,45283,43361,36179,22495,19868
18305,534,1412,13005,5300,3.7096e+13,559.239,3947.03,18305,303,317,16341,15410,14993,12051,9647
40105,2253,2484,28514,11591,3.70772e+13,769.214,7310.72,40105,485,431,37621,37621,37539,37599,37018
9925,139,1039,6946,2979,3.5534e+13,362.583,2566.16,9925,250,227,7791,6791,5237,3334,2148
63697,2972,3002,44867,18830,3.68049e+13,634.206,9446.64,63697,397,618,60695,60695,60695,60695,60654
48714,1006,2604,33798,14916,3.37312e+13,806.015,8189.03,48714,483,449,45817,44812,39171,28204,24360
18961,1322,1467,13016,5945,3.34554e+13,413.965,4035.63,18961,319,243,17494,17494,17347,17253,17165
64849,446,2743,45266,19583,3.53654e+13,733.795,9602.04,64849,571,456,59435,56397,38902,21318,20084
55215,2359,2600,38548,16667,3.60763e+13,707.146,8538.53,55215,622,414,52615,52610,52296,51833,50901
14085,325,1205,10130,3955,3.73137e+13,402.99,3125.54,14085,328,213,12640,12083,10783,9475,5654
72396,1739,3519,50903,21493,3.57502e+13,1161.25,11352.3,72396,636,609,68877,67914,64497,57582,40864
73089,1627,2906,51209,21880,3.5884e+13,1012.27,9982.05,73089,652,449,70183,69464,65582,55384,53784
88822,1149,3215,62269,26553,3.51396e+13,1306.93,12098.4,88822,675,584,84860,82849,76201,59220,39222
9063,236,1067,6354,2709,3.65743e+13,428.157,2487.16,9063,243,241,7451,6717,5562,4129,2132
5988,218,759,4298,1690,3.65541e+13,271.178,1737.11,5988,186,191,5017,4568,4460,4018,2163
36151,1970,2091,25656,10495,3.67561e+13,654.669,6540.04,36151,469,448,34060,34042,34018,34038,33668
53737,1658,2091,38293,15444,3.78782e+13,845.573,7543.43,53737,558,376,51646,51590,51199,50659,48395
36171,632,2157,25072,11099,3.56081e+13,490.722,6199.77,36171,425,491,33722,33206,26903,23816,15446
12337,774,909,8491,3846,3.38195e+13,262.148,2456.2,12337,202,171,11428,11428,11362,11337,10951
93532,592,2897,64764,28768,3.59328e+13,964.669,10798.6,93532,570,589,88446,84802,59862,36209,38104
11547,209,1368,8074,3473,3.68292e+13,269.869,3170.85,11547,262,251,9634,8549,6288,4509,2926
48429,1688,2403,33020,15409,3.28812e+13,556.019,7490.51,48429,572,387,46026,46003,44623,40763,39835
20115,1183,1607,13899,6216,3.21481e+13,363.524,4171.48,20115,236,325,18508,18415,18365,18173,14772
64077,801,2716,43789,20288,3.45687e+13,806.636,8779.27,64077,514,494,60833,59227,46700,35455,30804
19378,904,1305,13644,5734,3.62306e+13,325.593,3517.62,19378,254,247,18073,18063,17725,17362,14839
56633,716,2273,39091,17542,3.31438e+13,897.168,8134.37,56633,435,403,53479,52087,46053,29935,27479
43024,180,1934,30585,12439,3.61706e+13,776.171,6635.09,43024,513,387,36033,31472,25580,10754,6887
31492,727,2164,21365,10127,3.45854e+13,493.262,6076.18,31492,391,357,29328,28626,23039,18742,15310
36339,2060,2594,25063,11276,3.62136e+13,588.094,7326.94,36339,407,452,33745,33728,33493,33674,30162
35657,950,1723,24449,11208,3.50525e+13,555.448,5345.15,35657,378,386,33934,33555,31804,29097,25673
66490,2042,2765,46061,20429,3.40566e+13,830.244,9309.96,66490,524,590,63725,63664,62625,60719,56457
98362,3956,4448,70292,28070,3.68764e+13,991.51,15548.1,98362,529,962,93914,93913,93750,93823,90805
37520,289,2041,25649,11871,3.42374e+13,474.798,6094.47,37520,402,318,33974,30528,22016,13871,6610
64811,447,3225,45511,19300,3.61534e+13,1132.23,10373.3,64811,576,570,59001,55303,39335,25206,14931
26137,1725,1981,19118,7019,3.72398e+13,716.24,5563.02,26137,463,414,24156,23901,24050,24106,22990
75889,493,2368,52361,23528,3.38665e+13,1041.04,9122.09,75889,544,513,70508,66881,53862,37126,25117
4335,86,591,3136,1199,3.57155e+13,206.338,1279.95,4335,161,107,3272,2727,2496,1815,1212
41483,60,2652,28942,12541,3.49204e+13,725.131,7869.65,41483,436,593,30714,24724,18336,5796,3678
87131,775,2831,60885,26246,3.55951e+13,1327.69,10661.7,87131,702,525,82190,79003,57096,38331,37663
54052,2528,2732,38125,15927,3.57174e+13,892.644,8629.96,54052,636,369,51320,51266,51250,51159,50190
42398,1051,2126,29319,13079,3.60464e+13,705.274,7078.17,42398,442,413,40272,39469,36971,33152,25510
31092,1113,1934,21463,9629,3.58853e+13,435.823,5335.02,31092,378,307,29158,29097,25954,20208,20341
41869,516,2221,29051,12818,3.6112e+13,778.533,7027.36,41869,442,501,38787,37076,28928,22710,15614
56189,459,2444,38794,17395,3.5199e+13,683.991,8418.33,56189,465,373,52524,50346,30881,21535,11893
51097,921,2378,35410,15687,3.6471e+13,600.904,7355.83,51097,398,402,48719,47961,41633,30827,28597
65575,535,2853,45038,20537,3.47845e+13,592.104,9248.39,65575,458,460,61939,58886,40272,27149,20227
50972,28,2384,36742,14230,3.66627e+13,960.016,8215.52,50972,550,490,32929,25909,20573,7705,4096
6203,128,672,4254,1949,3.59666e+13,294.022,1668.74,6203,182,205,4825,4124,3213,2490,2068
59798,580,2609,41954,17844,3.61645e+13,935.236,8547.16,59798,479,499,55697,53184,40133,28288,15133
5028,386,690,3417,1611,3.54231e+13,238.617,1563.16,5028,180,158,4338,4112,3982,3221,3256
14455,678,1082,9864,4591,3.62658e+13,445.397,3084.52,14455,250,283,13373,13086,12379,11358,11381
76021,1549,3041,53890,22131,3.68129e+13,1013.58,10371.7,76021,715,453,72980,72487,66878,52124,54200
87069,841,3342,60118,26951,3.28095e+13,1139.22,11958.2,87069,599,577,82623,80153,60472,43804,30093
45486,1795,2080,31326,14160,3.5062e+13,423.023,6681.51,45486,525,342,43406,43404,42948,41325,41354
74054,2168,2439,52090,21964,3.42924e+13,1109.55,9637.09,74054,525,570,71615,71560,71330,71169,68629
87895,2351,3401,62314,25581,3.68475e+13,972.162,11476,87895,596,525,84494,84392,80848,76331,72362
75145,2697,3194,51286,23859,3.55309e+13,837.966,10691.8,75145,440,683,71951,71949,71743,71689,68229
10614,138,1051,7572,3042,3.62868e+13,326.198,2658.75,10614,277,282,8777,7676,6028,4202,2680
48603,278,2240,33931,14672,3.63997e+13,828.539,7387.7,48603,499,434,42887,37759,25927,11213,9226
69735,638,2638,47465,22270,3.4617e+13,1016.88,9265.68,69735,619,524,65361,61938,39538,29382,28118
42446,2297,2566,30120,12326,3.61443e+13,973.285,7703.87,42446,482,437,39880,39576,39783,39562,38727
41417,789,2428,29585,11832,3.73902e+13,938.307,7393.2,41417,528,465,38346,37282,33115,22858,16588
34448,1762,1842,24156,10292,3.25402e+13,703.368,5686.2,34448,383,409,32606,32603,32553,32562,32092
82645,2000,2940,58228,24417,3.50579e+13,906.904,10570.3,82645,629,453,79705,79668,77110,72965,65609
78018,2065,3484,54449,23569,3.55464e+13,1163.64,11777,78018,691,668,74534,73893,69767,55690,57541
44642,1816,2818,30811,13831,3.47811e+13,593.264,8244.27,44642,483,375,41824,41767,40317,36726,33293
4993,290,775,3645,1348,3.80592e+13,125.446,1577.43,4993,164,172,4218,4105,3930,3994,2116
17636,710,1509,12050,5586,3.46071e+13,405.66,4059.53,17636,304,263,16127,15872,14830,12915,9070
99217,224,2392,69147,30070,3.61439e+13,974.536,10189.8,99217,610,535,85496,74464,52558,20504,14679
70078,2147,3166,48665,21413,3.5098e+13,1058.4,10545.6,70078,543,472,66912,66486,65163,60160,60323
54325,2436,2456,38021,16304,3.44647e+13,696.479,8098.19,54325,509,370,51869,51865,51866,51869,51816
23435,1935,1937,16220,7215,3.40659e+13,591.451,4949.87,23435,358,348,21498,21498,21498,21498,21497
52180,1699,1934,35602,16578,3.25716e+13,685.854,7416.38,52180,447,474,50246,50239,49365,48106,46236
52364,803,2589,36318,16046,3.28549e+13,829.9,8293.81,52364,428,440,49239,47822,43064,32455,24972
10615,481,951,7555,3060,3.52618e+13,339.745,2450.21,10615,267,195,9584,9213,8224,6381,6245
99374,2525,3121,69527,29847,3.38749e+13,1209.15,11623.2,99374,715,578,96253,96243,94294,86972,88262
14633,704,1478,10104,4529,3.61867e+13,376.292,3622.99,14633,279,243,13155,12847,11838,9092,8927
80929,1605,2748,57724,23205,3.67854e+13,1112.38,10244,80929,614,493,78181,77452,73935,65067,60451
71291,3332,3412,50436,20855,3.65851e+13,1008.86,11239.5,71291,562,562,67879,67878,67860,67867,67731
24431,197,1986,16829,7602,3.51955e+13,588.157,5216.04,24431,358,441,20877,18695,12803,5990,4511
20427,1262,1517,13925,6502,3.12709e+13,328.439,3916.16,20427,310,268,18910,18908,18865,18878,18229
13975,461,1123,9743,4232,3.30542e+13,407.027,3044.64,13975,231,250,12598,12013,11425,8791,6246
28161,1179,1863,19589,8572,3.63336e+13,536.464,5174.18,28161,351,280,26298,26120,25257,22892,22431
54048,849,2698,37330,16718,3.50377e+13,875.339,8728.39,54048,500,479,50890,49038,41239,30205,28957
82050,387,3104,57275,24775,3.64248e+13,1052.1,11620.6,82050,585,617,74543,69948,50573,26158,15789
47389,987,2751,32735,14654,3.62704e+13,860.101,8282.27,47389,491,567,44366,43014,40030,32388,22617
88634,1304,2726,63198,25436,3.67409e+13,1033.68,10281.9,88634,673,465,85868,84717,75775,60904,62795
84772,1878,2865,59703,25069,3.67017e+13,976.886,10352.4,84772,597,522,81907,81583,76207,60808,65756
61292,854,2642,42025,19267,3.08691e+13,790.68,9102.22,61292,509,447,58211,57150,40705,31469,23453
84206,1323,3641,58038,26168,3.49982e+13,1198.92,12497.1,84206,759,576,80151,78546,62165,49381,46401
85141,1914,4235,57849,27292,3.4357e+13,982.381,13374.9,85141,507,694,80906,80380,76463,69565,49480
86829,3165,3763,60806,26023,3.53906e+13,1062.84,13045.3,86829,669,587,83066,83016,82723,82874,78830
23048,752,1162,16318,6730,3.72041e+13,590.261,3896.82,23048,320,280,21872,21398,20919,19496,19310
50014,1040,2593,35687,14327,3.61844e+13,734.378,8282.71,50014,600,351,47421,46406,41503,30790,28346
81057,1104,2865,55420,25637,3.5075e+13,879.178,9868.78,81057,601,494,77995,76687,63048,49085,50602
91861,995,2861,65014,26847,3.68132e+13,1320.23,11017.6,91861,702,557,87349,84862,70947,50665,48779
27645,112,1577,19652,7993,3.6547e+13,659.292,4877.18,27645,442,312,22039,19243,14036,5271,4236
80682,1393,3433,56554,24128,3.66161e+13,977.023,11569.1,80682,770,547,77249,76165,65092,49398,48973
58828,209,3027,40718,18110,3.63713e+13,614.772,8800.86,58828,531,430,50708,44137,30173,12663,10967
57764,151,2655,39718,18046,3.46432e+13,841.113,8620.05,57764,542,569,47981,42454,28972,9308,8858
77354,58,3119,54116,23238,3.5062e+13,926.824,11041.4,77354,539,584,56870,46465,35082,9991,5600
18542,1485,1630,12897,5645,3.64975e+13,444.907,4140.99,18542,371,251,16912,16912,16738,16649,16315
10703,621,1211,7506,3197,3.42166e+13,246.973,2812.91,10703,185,248,9492,9417,9301,9090,5207
58222,1945,3102,40810,17412,3.5707e+13,761.776,9666.88,58222,442,561,55120,54992,54345,54256,42981
83610,277,3652,57607,26003,3.55278e+13,832.713,11990.3,83610,628,578,74076,66455,40591,16417,12836
57204,849,2757,40175,17029,3.49291e+13,796.729,9205.21,57204,530,477,54126,52638,47904,36549,23969
31797,1665,1961,22523,9274,3.53559e+13,684.347,5800.28,31797,460,392,29836,29833,29548,29570,27276
42056,358,1817,29403,12653,3.42902e+13,678.955,6006,42056,410,361,38957,37029,25724,19659,13538
73735,559,1878,53081,20654,3.72273e+13,979.101,7937.46,73735,538,394,69045,65744,55942,42068,35103
4642,609,850,3356,1286,3.59642e+13,218.382,1634.57,4642,196,147,3792,3718,3693,3660,3109
12545,229,1263,8817,3728,3.58716e+13,356.34,3093.86,12545,284,225,10700,9662,7657,5699,3482
20735,1197,1521,14688,6047,3.63916e+13,471.9,4307.11,20735,313,273,19214,19178,19155,19168,17516
99778,2554,2998,70291,29487,3.50665e+13,1290.67,11708.4,99778,744,584,96780,96767,96133,95098,91576
41733,1885,2579,28532,13201,3.56741e+13,850.146,7734.11,41733,476,633,39154,38954,38154,35943,35374
42862,1963,2089,30364,12498,3.72155e+13,680.9,6627.08,42862,523,360,40773,40768,40644,40279,40263
16623,780,1213,12254,4369,3.54095e+13,422.73,3427.62,16623,352,192,15410,15201,14389,11603,11166
33347,1369,2403,22700,10647,3.5448e+13,604.63,6896.94,33347,492,363,30944,30829,28345,22570,22106
91385,2546,3374,63001,28384,3.42605e+13,1040.84,12046.8,91385,681,624,88011,87828,86188,81603,78180
3460,422,656,2379,1081,3.52399e+13,151.557,1280.06,3460,151,141,2804,2720,2613,2189,2100
26778,1000,1857,18552,8226,3.48048e+13,494.012,5368.94,26778,363,336,24921,24626,23749,21206,18205
20642,168,1613,14655,5987,3.69425e+13,610.947,4427.56,20642,362,366,16776,14725,11560,5707,4259
83739,1527,2955,59471,24268,3.60631e+13,893.518,11046.3,83739,529,523,80784,80377,77251,74374,49116
53012,475,2237,36665,16347,3.69096e+13,491.591,6970.52,53012,510,347,50366,48974,32884,23813,22878
84611,1916,2669,58727,25884,3.45796e+13,1187.12,10480,84611,572,568,81942,81353,78300,71260,70857
7869,147,828,5652,2217,3.69225e+13,286.628,1958.13,7869,222,148,6391,5520,4867,3796,2839
24612,550,1670,17671,6941,3.70401e+13,730.081,4952.46,24612,431,362,22258,21177,19265,14608,10039
87086,1604,2459,62797,24289,3.70913e+13,988.587,10294.9,87086,728,430,84627,84377,82281,75935,73132
41379,1235,1245,27961,13418,3.23894e+13,519.816,5329.08,41379,351,334,40134,40134,40134,40134,40094
68921,1313,3435,47516,21405,3.56673e+13,1006.71,11008.3,68921,492,666,65426,64249,60039,48769,37260
73443,1635,3091,52092,21351,3.60185e+13,1033.92,10385.1,73443,643,489,70352,69721,66282,56675,49801
83873,668,3265,57512,26361,3.50251e+13,1243.62,11478.3,83873,555,553,78521,75730,50830,38564,28481
32414,1604,1742,23468,8946,3.71183e+13,720.973,5475.77,32414,434,332,30672,30672,30657,30648,30356
73385,415,2275,51675,21710,3.40644e+13,1105.41,9169.99,73385,577,470,67784,64452,47160,28788,20427
22667,718,1835,15849,6818,3.6836e+13,584.638,5062.44,22667,406,331,20649,20122,17674,14305,11346
52335,1425,2064,36636,15699,3.53811e+13,938.125,7553.88,52335,501,464,50271,49427,48310,44382,43183
71681,182,3121,49912,21769,3.5449e+13,868.772,10516.8,71681,671,541,60737,53093,37542,12387,11950
30265,1248,2060,22065,8200,3.72709e+13,636.474,5841.62,30265,421,333,28205,27996,27316,24570,22622
97773,966,3746,65784,31989,3.30902e+13,1401.53,13036.4,97773,654,625,92687,90658,65595,52809,38721
8587,601,1026,6093,2494,3.95847e+13,267.163,2396.75,8587,205,190,7561,7416,7400,7157,5712
25795,345,2104,17803,7992,3.28916e+13,558.848,5425.96,25795,317,333,23077,21990,14015,8546,4871
15512,1281,1574,10948,4564,3.63708e+13,368.509,3899.55,15512,267,286,13938,13935,13866,13892,12858
75025,1881,2298,52157,22868,3.50556e+13,896.888,8829.99,75025,446,463,72727,72711,72501,72453,69145
25340,728,1513,17609,7731,3.56833e+13,445.457,4322.05,25340,319,326,23827,23487,20938,14440,15165
76713,2558,2737,52981,23732,3.42649e+13,963.973,9720.31,76713,528,515,73976,73964,73900,73881,73297
50867,222,2839,34848,16019,3.32075e+13,787.656,8831.64,50867,520,383,44370,40454,26338,8990,6500
17188,1022,1364,12060,5128,3.70738e+13,537.888,3696.58,17188,298,280,15824,15734,15311,14829,14128
12339,1547,1596,8525,3814,3.68007e+13,248.796,3553.01,12339,234,293,10743,10743,10743,10743,10643
11269,296,1204,7968,3301,3.66769e+13,333.492,2918.9,11269,227,237,9803,8808,8319,7491,3666
4585,462,619,3154,1431,3.52223e+13,216.813,1397.53,4585,146,167,3966,3936,3889,3799,3503
30318,64,2013,20880,9438,3.39408e+13,542.161,5613.79,30318,417,371,22498,18096,13143,4041,3254
65934,1589,2590,46748,19186,3.7732e+13,862.083,8938.82,65934,508,481,63344,63201,61042,57385,52978
11900,685,1225,8313,3587,3.1567e+13,187.372,2873.06,11900,226,159,10675,10639,10154,9919,5785
75061,2383,3377,50652,24409,3.4176e+13,1059.58,11055.7,75061,671,642,71684,71570,69655,64279,64743
99385,1590,3705,69816,29569,3.54291e+13,1049.53,13051.1,99385,773,485,95680,94817,71093,47918,39062
22415,487,1149,15276,7139,3.54998e+13,377.236,3677.59,22415,306,321,21110,20721,17682,14617,14021
28692,63,2531,19523,9169,3.37864e+13,420.491,6450.83,28692,478,400,21905,17805,12037,4208,2037
52857,2102,2183,36946,15911,3.52252e+13,894.977,7447.79,52857,450,392,50674,50674,50660,50653,50486
84795,600,3278,58164,26631,3.43115e+13,1063.94,11406.4,84795,599,492,79249,76152,44151,28054,17592
26477,1748,1883,18902,7575,3.87534e+13,503.402,5418.69,26477,314,430,24594,24594,24547,24594,24171
91745,2267,3008,64573,27172,3.63637e+13,1300.82,11218.5,91745,632,592,88737,88348,86779,81372,81727
76976,300,2005,52893,24083,3.14087e+13,1125.3,8276.09,76976,451,465,69894,66042,42704,23621,16997
83759,544,2622,59909,23850,3.70035e+13,1274.39,10588.8,83759,641,607,77542,72717,54120,40666,20443
25180,154,1769,17745,7435,3.65662e+13,652.397,5022.23,25180,356,352,20353,17737,13679,5198,4499
39082,2056,2734,27498,11584,3.49543e+13,524.929,7495.46,39082,384,586,36348,36308,36157,35453,27622
25444,225,1682,17717,7727,3.60602e+13,585.443,4958.84,25444,350,358,21606,19070,14713,9459,5802
90558,1193,2327,63349,27209,3.4338e+13,1074,9855.92,90558,632,480,88013,86663,80621,64648,59770
3189,547,675,2172,1017,3.41623e+13,104.564,1248.58,3189,165,95,2514,2504,2461,2470,2310
26338,375,1905,17463,8875,3.34969e+13,378.113,5176.59,26338,362,256,24143,23076,13459,10493,7863
9168,225,1346,6464,2704,3.64655e+13,234.096,2877.62,9168,217,277,7670,7087,5474,3737,1753
5629,863,939,3808,1821,3.23113e+13,215.305,1942.37,5629,214,241,4690,4688,4676,4681,4618
61008,2385,2406,41550,19458,3.53432e+13,693.273,8519.08,61008,445,551,58602,58602,58598,58601,58593
1345,117,172,897,448,2.69958e+13,77.4974,416.392,1345,73,62,1173,1130,1099,1113,1041
15353,938,1309,10669,4684,3.61672e+13,314.439,3370.4,15353,216,241,14044,14016,13939,13991,12915
66181,1233,3789,45145,21036,3.39795e+13,886.558,11389.6,66181,631,620,62105,60959,50082,41008,32688
54279,484,2737,38107,16172,3.65065e+13,979.921,8586.04,54279,563,402,49471,46513,34146,23366,18983
18083,1280,1739,12550,5533,3.60631e+13,354.508,4378.62,18083,320,373,16344,16317,16185,16186,14169
39936,1810,2545,27249,12687,3.52962e+13,652.463,7181.78,39936,512,550,37391,37242,35766,33822,32371
79535,2324,3435,55345,24190,3.50843e+13,872.992,11675.7,79535,476,696,76100,76057,75504,75758,66794
95848,2482,3259,66419,29429,3.55087e+13,1028.31,11548.5,95848,680,603,92589,92441,89820,86136,77894
47090,704,1782,32847,14243,3.26572e+13,855.264,6453.55,47090,416,354,44530,43153,39580,28397,21509
48590,1847,2717,33445,15145,3.59378e+13,610.624,8342.88,48590,490,623,45873,45660,45108,44124,38587
12317,353,1109,8311,4006,3.37805e+13,383.256,2974.25,12317,245,318,10981,10491,9657,9172,4812
17680,1093,1526,12496,5184,3.72769e+13,479.283,3969.86,17680,332,295,16154,16011,15656,15508,13808
11073,34,1076,8017,3056,3.39408e+13,333.42,2743.35,11073,280,157,7221,5407,4668,1450,768
52541,1486,1916,36520,16021,3.21411e+13,862.174,6832.59,52541,413,407,50625,50590,50374,49994,45445
11058,157,1082,7522,3536,3.56939e+13,336.667,2715.22,11058,257,277,9089,8086,5515,3657,2004
47936,891,2362,33824,14112,3.41662e+13,897.686,7775.11,47936,530,450,45091,44165,41005,31151,21393
27151,1932,1945,19097,8054,3.68392e+13,467.424,5513.19,27151,399,293,25206,25206,25204,25202,25183
60974,2583,2691,43077,17897,3.51941e+13,847.818,8996.54,60974,513,420,58283,58283,58266,58277,57878
47447,1412,2604,33065,14382,3.49594e+13,802.75,8054.85,47447,438,438,44843,44163,43049,40372,31279
24449,710,1481,17102,7347,3.5385e+13,428.526,4623.25,24449,323,314,22968,22614,21738,20209,15243
84122,1280,3570,59195,24927,3.64259e+13,1102.97,11919.9,84122,758,541,80274,78130,63106,44208,39277
88116,2437,3293,61482,26634,3.59409e+13,1041.9,11448.7,88116,546,548,84823,84582,84226,83175,78167
87774,1450,3254,62381,25393,3.67763e+13,1019.84,11970.8,87774,596,605,84520,83334,79142,68953,55892
35783,820,1626,24138,11645,3.42288e+13,715.6,5731.76,35783,336,445,33948,32900,31476,26015,22798
75441,103,2577,53401,22040,3.62579e+13,1169.05,9802.17,75441,625,496,59289,51126,38475,11193,7811
47849,2004,2132,33355,14494,3.70604e+13,729.553,7179.38,47849,492,389,45717,45717,45665,45669,45099
63920,2341,2424,44854,19066,3.47759e+13,875.138,8610.09,63920,663,395,61496,61495,61485,61476,60839
64743,2175,2699,44655,20088,3.58291e+13,1148.04,9264.05,64743,512,461,62044,61816,61074,59384,56981
99303,3213,3370,69280,30023,3.52821e+13,1249.19,12313,99303,705,680,95933,95931,95895,95885,94944
24501,618,1770,16862,7639,3.61987e+13,554.004,5084.46,24501,318,362,22398,21841,20079,15357,12448
24615,1585,2062,17004,7611,3.4492e+13,451.367,5505,24615,333,430,22553,22460,22222,22196,19224
43156,1714,2235,29887,13269,3.56178e+13,669.579,6854.12,43156,440,418,40921,40692,40133,39248,38227
65266,2120,2766,45410,19856,3.4968e+13,1011.74,9493.9,65266,694,414,62500,62483,61517,58888,58263
51558,559,2439,36496,15062,3.63862e+13,897.58,8133.47,51558,544,413,47777,45658,33774,24855,19621
48557,742,2394,33918,14639,3.63888e+13,761.776,8091.11,48557,540,450,45560,43960,39079,27196,22967
19440,784,1543,13554,5886,3.70783e+13,471.028,4164.53,19440,364,329,17897,17624,16589,14432,13261
50645,1938,2420,36187,14458,3.73313e+13,880.46,8034.46,50645,557,403,48225,48055,47669,47290,43894
74357,1972,3653,50795,23562,3.4425e+13,1293.36,12059.8,74357,703,757,70698,69723,66096,57741,45213
3643,177,727,2658,985,3.86754e+13,124.562,1301.96,3643,172,126,2914,2670,2524,2412,918
1583,382,415,1102,481,3.74366e+13,64.2217,702.327,1583,83,83,1168,1161,1166,1168,1135
52340,1386,2287,37906,14434,3.68239e+13,924.818,8025.59,52340,611,358,50053,49436,48176,43206,41862
99470,2706,3285,70343,29127,3.58379e+13,1142.29,12324.8,99470,701,557,96185,96168,95718,95398,89493
85660,1244,3540,58980,26680,3.43875e+13,1153,11861.1,85660,699,548,81462,79457,61547,42742,35985
64146,52,2696,44497,19649,3.49333e+13,866.669,8765.06,64146,475,434,45756,37198,28157,10465,4388
14898,87,1002,10278,4620,2.95246e+13,399.543,2779.79,14898,214,199,12288,9959,7393,1505,1497
1514,270,379,1150,364,3.20729e+13,83.0165,633.106,1514,92,54,1135,1101,1115,1115,986
46413,2220,2804,33477,12936,3.71949e+13,749.976,8445.38,46413,458,505,43609,43524,43296,43292,38451
68832,1422,2705,47778,21054,3.51149e+13,949.7,9632.65,68832,553,430,66127,65145,64116,57765,53779
98352,1938,2788,69899,28453,3.72134e+13,1123.84,11006.8,98352,651,502,95564,95207,91268,80103,81485
52887,1120,2574,36628,16259,3.51757e+13,622.82,8321.24,52887,374,435,50313,50035,45437,36122,32868
2140,114,193,1415,725,2.49234e+13,86.5271,536.766,2140,67,70,1946,1780,1772,1782,1305
75193,970,3205,51849,23344,3.52121e+13,817.378,10523,75193,616,480,71708,70779,52214,39053,28775
24283,927,1511,16618,7665,3.58686e+13,485.59,4529.19,24283,289,296,22772,22666,20961,18722,17216
20256,29,1279,14233,6023,3.27466e+13,691.059,3742.95,20256,305,255,12989,9819,7190,2074,1172
25868,1221,1670,17629,8239,3.45249e+13,716.907,5035.46,25868,316,384,24198,23624,23498,20897,20454
5838,356,992,3948,1890,3.41663e+13,231.304,2013.45,5838,169,215,4846,4583,3817,3382,2427
43512,987,2409,30691,12821,3.72296e+13,785.827,7378.15,43512,463,426,40963,39864,35879,26492,23202
39326,1023,1935,28371,10955,3.72237e+13,864.14,6361.27,39326,471,332,37328,35981,34272,28641,28252
79803,993,3614,54317,25486,3.46893e+13,1162.63,11951.8,79803,679,707,75281,72782,58573,48517,30672
35152,1406,2280,24809,10343,3.61342e+13,553.772,6755.82,35152,362,440,32872,32610,32472,32159,25673
60005,1465,2432,41075,18930,3.49049e+13,821.799,8373.37,60005,523,486,57573,57339,54542,47846,45992
32511,550,2307,22508,10003,3.45359e+13,594.73,6371.66,32511,487,486,29916,29175,23755,18466,10435
49993,1234,2406,34308,15685,3.38048e+13,823.7,7771.4,49993,424,443,47545,46813,44787,38499,35523
65062,1010,3305,45333,19729,3.5505e+13,760.608,10165.3,65062,727,529,61716,60278,41811,32913,29192
15404,451,1318,10404,5000,3.43942e+13,570.718,3546.55,15404,332,361,13668,13191,11958,10708,5558
37163,1211,1837,26702,10461,3.75596e+13,846.425,6214.52,37163,476,421,35305,34552,33959,31813,28368
43819,830,2112,31268,12551,3.65174e+13,718.438,7090.14,43819,430,402,41487,40074,37422,31179,26831
38690,1827,2250,27554,11136,3.67305e+13,741.443,7066.73,38690,405,435,36440,36395,36202,36341,34504
94213,309,3732,65668,28545,3.53732e+13,1246.33,12877.3,94213,632,602,84998,77518,50937,17375,16372
54087,1521,2433,36290,17797,3.4451e+13,807.751,7757.96,54087,548,446,51654,51464,49000,45286,46898
10264,231,854,7017,3247,3.3379e+13,299.772,2347.11,10264,235,190,8712,7338,5729,4721,3749
96032,1660,3012,68995,27037,3.74968e+13,1252.8,11406.5,96032,848,541,93020,92320,86743,76471,68555
50613,289,1803,34937,15676,3.58869e+13,901.878,7020.36,50613,446,459,43941,40129,25191,11086,9102
19837,497,1307,13814,6023,3.53714e+13,395.833,3775.76,19837,289,285,18330,17532,15091,11597,10084
45457,314,2256,32918,12539,3.77412e+13,755.293,7546.62,45457,454,439,40780,37491,31399,25109,10961
61509,1067,2649,43879,17630,3.81912e+13,812.555,8520.95,61509,631,418,58860,57929,52219,43799,44147
88605,2328,3109,60606,27999,3.24294e+13,1128.83,11845.7,88605,568,616,85496,85350,83338,77787,71097
35297,550,2134,25358,9939,3.73163e+13,766.419,6543.17,35297,454,440,32328,31009,27348,20700,13709
46653,180,2300,31853,14800,3.38434e+13,588.873,7352.47,46653,403,390,40342,36411,23599,10021,6599
20454,1111,1696,14280,6174,3.68301e+13,426.63,4279.47,20454,346,305,18758,18664,18276,17026,16446
54775,1781,2493,37736,17039,3.47393e+13,760.218,8446.27,54775,559,484,52282,52244,49578,44883,45601
7903,142,758,5256,2647,3.23538e+13,314.57,1940.48,7903,172,219,6650,6134,4310,3010,2661
78534,622,3941,54662,23872,3.6523e+13,958.771,13249,78534,547,876,72894,70416,50726,37841,17415
7721,795,827,5416,2305,3.72816e+13,322.258,1996.5,7721,263,203,6894,6887,6886,6887,6874
40856,789,1874,28551,12305,3.10216e+13,785.646,6149.73,40856,472,393,38644,37540,35082,29640,22646
18419,1384,1719,13044,5375,3.52964e+13,372.78,4291.68,18419,334,293,16700,16694,16346,15825,15449
31866,1097,2296,22065,9801,3.59917e+13,544.416,6372.56,31866,322,491,29570,29134,28149,26308,14935
63305,967,2815,43318,19987,3.52496e+13,776.347,9348.03,63305,512,515,60352,59170,49573,40197,31366
38950,920,2006,26007,12943,3.22173e+13,628.475,6594.21,38950,444,375,36944,36089,32934,28419,24758
43771,342,2670,31601,12170,3.69821e+13,671.089,8164.37,43771,437,494,39122,36219,28990,18956,10486
75824,2584,2801,52091,23733,3.26643e+13,812.493,9775.02,75824,524,475,73023,73023,72958,72980,71768
94014,1960,3557,64684,29330,3.40686e+13,909.494,12231.3,94014,605,547,90457,90168,86456,73390,66495
90926,868,3835,63379,27547,3.5055e+13,1056.16,12613.4,90926,702,600,86315,84487,57844,40373,29010
23514,1537,1741,16508,7006,3.63905e+13,418.803,4560.98,23514,369,272,21773,21772,21737,21747,21104
36327,636,2211,25838,10489,3.60966e+13,565.862,6783.17,36327,571,316,33931,31876,25546,19064,16522
9576,450,850,6873,2703,3.58058e+13,265.469,2185.03,9576,205,183,8726,8630,7539,7322,5780
2651,505,544,1835,816,3.62109e+13,103.811,1006.12,2651,102,89,2107,2091,2104,2101,2050
28801,48,1816,19737,9064,3.34286e+13,481.433,5321.15,28801,294,340,20562,16244,12707,3846,2247
5372,702,879,3902,1470,3.88292e+13,183.745,1751.31,5372,185,148,4493,4487,4477,4474,4043
32418,1077,2006,23061,9357,3.54893e+13,711.369,6045.95,32418,339,399,30356,29689,29068,28028,19644
88215,2689,3198,61642,26573,3.46861e+13,1109.09,11602.4,88215,683,629,85017,84981,84520,84081,79209
35981,2335,2624,25126,10855,3.55125e+13,508.206,7283.54,35981,557,308,33357,33356,33263,33296,32038
97459,3722,3742,67647,29812,3.56998e+13,1205.08,13508.6,97459,611,722,93717,93717,93716,93714,93677
74544,2204,2584,51038,23506,3.34424e+13,998.26,9787.45,74544,580,477,71960,71728,71659,71158,67368
13081,875,1386,9294,3787,3.7436e+13,356.216,3311.07,13081,242,240,11695,11534,11319,11290,8627
87481,2821,3103,61655,25826,3.6551e+13,1254.77,11619,87481,663,565,84378,84320,83974,83556,81560
69377,656,2634,48541,20836,3.57995e+13,904.995,9313.23,69377,541,529,64891,61757,50012,37243,33469
96845,599,3215,67800,29045,3.59148e+13,1301.56,11619.8,96845,741,524,90401,85233,61873,42195,34589
98663,2145,3306,68514,30149,3.66565e+13,1027.3,12516,98663,844,536,95357,95278,91639,82211,83823
31883,1325,1843,22414,9469,3.76899e+13,571.39,5495.7,31883,422,322,30040,29853,29366,28561,26848
10400,108,1099,7266,3134,3.60844e+13,372.033,2673.2,10400,272,228,8209,7184,5924,2799,1862
17509,272,1343,12071,5438,3.52991e+13,432.904,3783.12,17509,277,312,15303,13468,10114,7239,4319
1104,99,281,762,342,3.41795e+13,77.9384,483.852,1104,89,69,793,718,644,658,376
20613,99,1349,14292,6321,3.59648e+13,404.205,3861.07,20613,284,246,15632,13824,10213,4518,3664
79335,513,3923,53912,25423,3.39047e+13,812.997,12190.9,79335,612,802,73466,69609,43674,27457,13491
5219,597,678,3528,1691,3.63828e+13,198.257,1572.76,5219,134,185,4541,4538,4535,4531,4317
31222,1551,1583,22523,8699,3.65545e+13,635.885,5242.72,31222,498,295,29639,29639,29634,29625,29594
59733,2523,3213,41457,18276,3.59292e+13,627.87,9667.26,59733,430,573,56520,56444,56178,56300,50846
32915,1638,2236,22826,10089,3.52498e+13,411.781,5904.23,32915,433,256,30679,30662,30320,29715,27149
19874,1075,1475,13629,6245,3.30226e+13,398.79,3903.24,19874,265,196,18399,18260,18034,17639,13913
12944,300,1186,9267,3677,3.67487e+13,434.257,3015.17,12944,272,236,11388,10865,9331,7828,4261
1547,120,356,1172,375,3.50265e+13,56.5352,599.532,1547,120,61,1191,1134,1113,1137,567
74844,935,2510,51557,23287,3.43447e+13,949.352,9109.2,74844,471,430,71897,69119,60954,46286,42771
52771,1090,2018,36585,16186,3.41319e+13,725.833,7171.63,52771,472,439,50753,50193,46569,40405,37533
40967,496,1785,28510,12457,3.2469e+13,851.908,5874.41,40967,346,389,37984,36464,31447,26230,11845
92298,257,3235,65259,27039,3.62229e+13,1036.29,11910.5,92298,657,452,81649,74154,50512,20250,14724
27288,269,1933,18824,8464,3.56704e+13,600.166,5369.88,27288,410,333,23777,21092,14695,7658,6808
80756,2823,2875,56530,24226,3.62846e+13,881.399,9771.27,80756,597,483,77881,77881,77854,77860,77810
93230,2328,3655,65402,27828,3.63802e+13,1130.25,12259.6,93230,674,537,89575,89346,86673,78707,77646
1243,117,324,942,301,3.40816e+13,51.749,529.615,1243,100,59,919,855,864,863,524
31961,859,1735,21725,10236,3.31042e+13,561.643,5465.45,31961,358,463,30165,29555,27945,23866,17914
33758,1538,2099,24305,9453,3.66453e+13,668.242,6240.04,33758,526,410,31659,31467,31376,30659,27823
28215,260,2308,19462,8753,3.49362e+13,511.817,6112.84,28215,439,320,24502,22416,16401,9169,7229
7774,811,1025,5558,2216,3.83299e+13,240.69,2223.22,7774,225,166,6749,6748,6702,6656,6221
50180,1643,3150,34975,15205,3.60194e+13,639.413,9195.68,50180,646,546,47030,46948,43682,35589,34043
49786,299,2575,34537,15249,3.28558e+13,696.739,8004.03,49786,548,477,45343,43254,30221,16723,13031
42213,1070,2156,29822,12391,3.64217e+13,715.288,7151.34,42213,523,367,39995,39362,34819,26250,23715
80805,550,3428,56085,24720,3.53941e+13,1028.74,11540.8,80805,674,531,74770,71476,52411,29654,23525
46636,1426,2347,32360,14276,3.51978e+13,821.058,7652.23,46636,493,457,44289,43918,42014,38682,32395
14513,708,1251,10171,4342,3.2857e+13,364.017,3234.58,14513,223,256,13262,12876,12297,10197,9393
45136,264,1832,29755,15381,3.21636e+13,721.104,6558.75,45136,386,467,40919,38344,22993,12722,13090
2959,157,374,2152,807,3.52002e+13,191.376,859.826,2959,144,96,2370,2042,2115,1852,1560
53039,1590,2053,36412,16627,3.51396e+13,837.663,7484.62,53039,498,432,50986,50979,50322,49559,48234
67873,1287,2411,47537,20336,3.40239e+13,838.582,8953.08,67873,434,478,65462,64474,61543,56314,45306
4251,44,577,2947,1304,3.88703e+13,227.332,1273.14,4251,142,156,2974,2522,1797,691,675
8265,683,1213,5858,2407,3.60877e+13,254.511,2593.48,8265,249,308,7052,6922,6715,6347,5186
57400,785,2554,40698,16702,3.64945e+13,719.51,8595.9,57400,464,541,54504,52713,48646,41814,21533
59519,1490,2608,40979,18540,3.43327e+13,849.506,8870.98,59519,517,454,56911,56184,51120,41453,41230
88968,3169,3758,62639,26329,3.65582e+13,939.329,12646.1,88968,532,700,85210,85201,84994,84090,78136
35694,1687,1997,25070,10624,3.43768e+13,591.83,6075.41,35694,347,390,33697,33691,33607,33581,32505
95377,1813,4606,66331,29046,3.58868e+13,1201.84,14572.2,95377,718,602,90771,89673,70264,53078,48333
89381,909,3036,62851,26530,3.53772e+13,1261,11158.3,89381,608,588,85163,82348,67591,50873,40382
87754,1160,2772,61732,26022,3.69599e+13,1068.42,10574.2,87754,594,512,84499,82506,72670,49227,51714
38188,953,1852,26135,12053,3.61968e+13,395.222,5586.14,38188,403,371,36336,36264,30005,23234,25111
67397,1574,1916,46797,20600,3.23334e+13,1045.23,7682.16,67397,471,455,65481,65375,64687,63815,62147
7252,386,980,5190,2062,3.73617e+13,273.898,2175.69,7252,181,244,6233,5853,5768,5339,2636
51062,2210,2657,35721,15341,3.63196e+13,816.95,8341.18,51062,485,495,48405,48403,48182,48027,44264
78734,3100,3857,53438,25296,3.45994e+13,973.4,12178.3,78734,592,855,74877,74736,74336,73906,68999
45162,178,1698,32694,12468,3.64335e+13,829.391,6335.34,45162,447,340,37397,32558,25836,10755,7011
69278,2295,3149,47587,21691,3.335e+13,1061.29,10297.1,69278,591,580,66129,65664,64706,61318,60936
75979,1449,2082,54303,21676,3.72728e+13,948.638,8600.27,75979,598,520,73897,73440,71580,67162,66439
20876,1396,1453,14878,5998,3.59794e+13,421.776,3992.57,20876,297,313,19423,19407,19417,19394,19074
9755,939,1078,7169,2586,3.71236e+13,271.303,2457.7,9755,273,161,8677,8674,8671,8670,8395
85019,2014,2823,60820,24199,3.70764e+13,1089.04,11080.8,85019,681,589,82196,82149,81371,80133,69711
34859,1990,2541,23915,10944,3.47585e+13,665.53,6911.41,34859,412,417,32318,32239,32090,32113,30012
94283,2830,2875,66520,27763,3.5675e+13,1010.36,11058.6,94283,641,454,91408,91408,91408,91408,91287
83317,1807,3440,59570,23747,3.70689e+13,922.494,12026.8,83317,754,511,79877,79583,75896,65154,60519
22573,1180,1754,15753,6820,3.61365e+13,396.149,4657.57,22573,386,290,20819,20796,20607,19507,18874
28028,1068,1753,19617,8411,3.35648e+13,824.41,5063.6,28028,369,371,26146,25390,25005,23961,18686
50482,2313,2491,35674,14808,3.70786e+13,734.614,7930.89,50482,471,467,47991,47985,47919,47895,47426
98192,2193,3073,69729,28463,3.63626e+13,1062.55,11487.3,98192,689,506,95119,94842,93099,90287,85044
61225,1742,2618,43376,17849,3.75314e+13,757.098,8958.84,61225,590,500,58607,58558,53923,42596,43381
34548,1300,2166,24447,10101,3.56323e+13,801.174,6524.84,34548,545,422,32382,31516,29848,24898,23800
39926,737,1865,28145,11781,3.59498e+13,701.342,6202.44,39926,452,342,37794,36843,33829,27145,21259
5449,831,912,3871,1578,3.70948e+13,215.513,1782.28,5449,193,163,4537,4518,4537,4537,4347
87731,1473,3295,63443,24288,3.72406e+13,1194.03,12423.2,87731,702,594,84217,82911,77813,58919,46146
16142,274,839,11000,5142,3.48932e+13,518.878,2943.56,16142,265,274,14041,12460,11523,8451,7412
15593,953,1580,10938,4655,3.69369e+13,403.426,3906.1,15593,323,334,14013,13926,13526,12087,11467
85342,40,3129,60300,25042,3.6234e+13,971.572,11297.3,85342,745,415,58692,46795,35850,13738,6663
11664,754,1175,8069,3595,3.65362e+13,301.17,2942.2,11664,238,327,10489,10466,10271,10226,7459
91623,52,2657,61354,30269,3.36448e+13,885.417,10555.2,91623,598,527,67507,54198,38339,12076,8262
52525,275,2601,36138,16387,3.54473e+13,1033.69,8440.19,52525,523,518,46491,42630,28854,10482,10527
21404,1221,1423,14815,6589,3.69053e+13,514.843,4169.12,21404,311,347,19981,19980,19881,19944,18853
27684,1755,1846,19850,7834,3.67337e+13,728.719,5393.97,27684,426,371,25838,25838,25809,25753,25582
17112,1227,1460,11906,5206,3.52635e+13,403.002,3793.46,17112,305,285,15652,15633,15378,15159,14627
17603,751,1546,12139,5464,3.2278e+13,424.806,3853.41,17603,290,320,16057,15666,14773,12865,11782
60170,76,2300,41451,18719,3.40102e+13,963.524,8246.34,60170,497,551,47224,38770,27837,8381,4717
15054,652,1248,10630,4424,3.56072e+13,459.17,3443.04,15054,361,224,13728,13220,12235,10584,8707
37360,853,2280,25856,11504,3.43793e+13,762.785,6771.16,37360,481,454,34891,34152,31574,25772,17966
76332,1816,3513,52827,23505,3.51573e+13,918.954,10825.7,76332,516,540,72819,72209,66409,52851,51986
15440,106,880,10684,4756,3.04561e+13,516.115,2680.45,15440,243,220,13291,11861,7359,2850,2424
61044,1450,2254,42335,18709,3.46109e+13,1019.6,8609.51,61044,514,542,58790,58098,55844,50018,45732
75637,1627,2932,52237,23400,3.13406e+13,862.564,10151,75637,646,415,72705,72243,66869,55218,39706
78992,2240,3153,55086,23906,3.48973e+13,902.882,11423.7,78992,511,524,75839,75799,75451,75050,65891
42427,1834,2457,30030,12397,3.55785e+13,737.32,7490.66,42427,463,466,39970,39825,38661,36567,34329
98999,690,3845,68960,30039,3.50738e+13,1267,12851.2,98999,642,691,93548,91059,66337,49537,32077
64638,149,3031,44779,19859,3.55882e+13,651.931,9863.31,64638,771,372,52601,45171,33318,13070,9167
64998,2860,2967,46288,18710,3.74506e+13,858.293,9845.58,64998,603,636,62031,62031,61973,61969,61742
9890,303,934,7127,2763,3.81263e+13,234.099,2336.21,9890,215,167,8939,8161,7722,7907,4177
94721,430,3091,63420,31301,3.46631e+13,930.146,11106,94721,639,580,86339,81323,50184,25281,25291
70391,230,3203,49958,20433,3.57363e+13,983.836,10542.4,70391,728,500,61502,55220,39193,14533,11475
14683,486,1369,10037,4646,3.46664e+13,405.243,3492.4,14683,292,338,13200,12880,11815,11265,5876
64134,96,2313,44986,19148,3.6877e+13,1129.66,8241.9,64134,530,422,49837,42471,31656,10710,9423
46868,896,1380,33384,13484,3.59961e+13,768.572,5677.75,46868,410,332,45394,43875,42919,37583,37306
77912,647,3555,53599,24313,3.44135e+13,1381.11,11950.7,77912,639,641,72004,69289,49841,33522,22957
97040,381,3074,68561,28479,3.6235e+13,1238.97,12094.8,97040,699,606,88259,82920,57247,29750,21794
41296,184,2282,27787,13509,3.40907e+13,783.952,6995.28,41296,393,555,35830,32227,18508,7382,5311
55601,2442,3109,40350,15251,3.76986e+13,772.619,9822.36,55601,493,598,52492,52489,52079,52059,44335
37314,1154,1214,25547,11767,3.02722e+13,559.734,4862.25,37314,339,303,36100,36100,36076,36065,35974
44878,1402,2401,31201,13677,3.62037e+13,680.109,7399.43,44878,489,412,42477,42150,40068,33345,33962
80198,1983,3129,56552,23646,3.6518e+13,1044.15,11351.6,80198,641,523,77069,76826,76056,75416,66376
82140,2913,3193,58585,23555,3.5547e+13,1233.82,11391.6,82140,748,557,78947,78936,78648,78259,76103
25722,737,999,17485,8237,3.48024e+13,397.774,3577.88,25722,273,257,24723,24715,23901,23872,21759
54328,1331,1759,38120,16208,3.24033e+13,997.819,6840.41,54328,440,444,52569,51834,51165,48898,47754
39720,77,2586,27422,12298,3.5769e+13,496.289,7126.49,39720,385,482,29351,25019,18200,7232,4284
8378,777,991,5785,2593,3.6911e+13,230.255,2286.57,8378,158,214,7387,7384,7337,7373,6712
47140,1025,2763,32055,15085,3.44965e+13,611.005,8482.57,47140,453,420,44377,43931,39799,32815,26375
44003,1089,2365,30966,13037,3.64937e+13,815.702,7287.96,44003,458,432,41553,40693,37684,35398,25746
86432,2105,3291,58520,27912,3.44658e+13,877.123,11790.8,86432,454,631,83141,82940,81645,79918,67705
15136,412,1349,10373,4763,3.48852e+13,378.902,3452.28,15136,300,256,13688,12902,11486,8771,7286
6866,278,840,4653,2213,3.66142e+13,244.161,1966.24,6866,162,222,5921,5422,5064,4875,2745
63502,1663,3569,44625,18877,3.6914e+13,859.689,10779.8,63502,641,497,59933,59370,53839,38128,36029
67721,597,2949,47751,19970,3.60425e+13,945.482,9940.88,67721,553,533,63348,61165,44358,28970,21291
78526,2241,2600,53825,24701,3.18393e+13,858.105,9160,78526,544,570,75926,75921,75233,73812,71619
41225,1343,2250,28783,12442,3.68038e+13,692.673,7022.39,41225,349,369,38975,38671,37199,36636,31129
15511,249,1334,10842,4669,3.41769e+13,409.28,3451.92,15511,262,275,13654,12893,11103,9099,3108
66049,501,2450,46439,19610,3.67051e+13,989.87,8606.38,66049,544,491,61537,58342,44026,29996,21543
71228,2511,2757,50224,21004,3.60152e+13,1026.21,9435.76,71228,589,454,68471,68469,68307,68311,67610
2938,345,677,2006,932,3.1969e+13,134.249,1201.31,2938,161,113,2261,2140,1961,1728,1203
69382,1802,2782,47982,21400,3.48898e+13,956.349,9518.34,69382,489,417,66600,66127,63437,54985,57458
62763,1431,2587,43664,19099,3.59544e+13,1018.87,9206.82,62763,553,487,60176,59493,55663,47921,40651
2984,110,616,2059,925,3.60843e+13,134.752,1142.06,2984,141,132,2266,2047,1731,1719,703
93416,3439,3730,66069,27347,3.54735e+13,1013.13,13136,93416,743,822,89686,89684,89601,89229,86551
96838,1001,3217,68253,28585,3.53926e+13,1134.85,12084.7,96838,596,571,92772,91264,79867,56070,47298
86845,1361,3509,60542,26303,3.53213e+13,1062.96,12180.1,86845,586,593,83262,81269,74806,60633,42718
62306,824,2808,43621,18685,3.5037e+13,915.715,9256.57,62306,514,481,59082,57523,46882,32394,27617
62840,2207,2706,42410,20430,3.40088e+13,944.425,8787.93,62840,554,556,60134,59991,59711,58558,58284
81872,1525,3549,56554,25318,3.61509e+13,978.227,12301.9,81872,544,729,78323,77805,73790,66490,52993
26529,1504,2049,17783,8746,3.41928e+13,527.746,5779.03,26529,381,407,24480,24392,23791,22996,20330
93079,79,2850,64278,28801,3.57611e+13,978.462,10886.1,93079,607,529,69627,59395,42798,17862,7466
22008,21,1527,15400,6608,3.61738e+13,512.541,4297.93,22008,306,322,13400,10073,8133,3732,1667
22935,1031,1831,16345,6590,3.67615e+13,491.676,4978.12,22935,317,458,21104,20943,20180,19201,13749
74563,990,2996,51766,22797,3.4625e+13,995.091,10019.4,74563,546,522,71083,69581,56682,42029,38241
72913,1751,3458,50856,22057,3.5393e+13,1041.02,11240.8,72913,617,600,69455,68624,64099,54866,46584
26679,1066,1610,18152,8527,3.58829e+13,517.51,4926.22,26679,310,395,25069,25027,24494,24040,18513
82576,305,3193,57050,25526,3.50801e+13,1124.36,11379.6,82576,659,573,73552,67423,43769,17443,13389
62457,1103,2642,44116,18341,3.47098e+13,988.573,9236.25,62457,528,472,59556,58467,53815,42716,34812
87369,1708,3417,59899,27470,3.48717e+13,796.002,12144.3,87369,508,609,83952,83562,79975,73083,60997
91718,587,3188,63693,28025,3.49917e+13,1171.59,11591,91718,579,541,85914,82200,57969,41256,28329
72943,1193,2758,52152,20791,3.6891e+13,1008.79,10332.2,72943,602,504,70016,68273,62094,49570,40119
4272,224,586,2865,1407,3.61483e+13,200.078,1329.2,4272,133,172,3559,3117,3100,2684,2463
54288,2318,2736,37003,17285,3.57552e+13,859.369,8994.96,54288,513,660,51552,51480,51416,51404,48117
22290,1000,1366,15454,6836,3.63158e+13,445.141,3958.2,22290,320,260,20924,20821,19948,18723,18483
47453,1805,2320,33400,14053,3.59281e+13,731.301,7686.5,47453,461,417,45133,45101,44353,42403,37986
14255,816,1415,9942,4313,3.61015e+13,364.925,3509.37,14255,259,305,12840,12676,12438,12104,9249
76210,841,2236,54300,21910,3.63778e+13,934.609,8717.39,76210,568,550,73322,72000,61851,41123,46202
12894,1015,1275,9388,3506,3.64596e+13,373.691,3140.45,12894,263,232,11619,11542,11538,11450,10709
82805,128,3274,55687,27118,3.3984e+13,1008.56,11425,82805,617,632,69537,62359,35476,14153,10240
99069,975,3098,67666,31403,3.49717e+13,1107.66,11892.8,99069,611,602,94852,91998,62576,46683,44186
14781,1090,1361,10469,4312,3.40756e+13,301.817,3496.45,14781,224,255,13420,13413,13352,13412,10906
88984,638,3221,61957,27027,3.64913e+13,1060.44,11438.4,88984,603,596,83843,79779,57129,40465,27829
82704,1067,2746,56835,25869,3.30079e+13,1019.87,10200.9,82704,457,577,79515,77758,71246,53104,40043
98802,2553,3838,68362,30440,3.49339e+13,979.924,13047.6,98802,480,578,94964,94787,94120,93273,82518
99559,2275,3147,69137,30422,3.70861e+13,1056.7,11528.7,99559,545,603,96412,96294,93235,88803,86529
56725,802,1825,38938,17787,3.12457e+13,727.398,6718.99,56725,459,345,54629,53564,48945,36909,37011
55636,995,1861,38212,17424,3.01452e+13,856.279,7007,55636,460,391,53522,52155,48680,35545,37737
77455,815,2916,54004,23451,3.58275e+13,884.602,10188.7,77455,539,481,73615,71364,58336,39704,35941
12719,937,1146,8736,3983,3.48425e+13,354.456,3068.1,12719,294,248,11573,11564,11333,11051,10627
34512,1316,2464,23864,10648,3.40633e+13,623.038,7037.03,34512,338,440,32048,31723,30582,29098,20706
47939,1298,2325,33662,14277,3.6003e+13,858.515,7866.79,47939,646,415,45614,44900,41355,34517,32573
72087,1908,2715,50460,21627,3.59545e+13,927.202,9406.36,72087,609,482,69372,69285,66532,59387,63274
94061,681,3524,62794,31267,3.28762e+13,866.436,11534.6,94061,661,545,89268,85871,50867,39535,38402
53130,631,2729,36608,16522,3.47135e+13,632.151,8799.49,53130,407,555,49809,48166,39999,28681,23284
38183,1461,1901,26032,12151,3.589e+13,756.861,6171,38183,376,470,36282,36263,36030,35755,32472
24373,310,1765,16777,7596,3.57706e+13,402.068,4775.03,24373,401,310,21973,20285,13634,10792,6822
55343,136,2356,38195,17148,3.40006e+13,841.241,8205.08,55343,577,444,46573,41500,28449,10163,8375
71573,773,3207,51426,20147,3.72797e+13,965.036,11041.3,71573,726,474,67350,65482,57502,44623,25113
34714,1531,2064,23832,10882,3.22697e+13,613.541,5974.63,34714,373,377,32650,32511,32239,31277,26651
96544,2511,3499,66600,29944,3.46818e+13,1016.08,12453.9,96544,649,568,93045,92755,91038,87031,82309
24049,1625,1750,16799,7250,3.38049e+13,392.973,4752.03,24049,248,352,22299,22299,22295,22299,21905
85653,2383,3357,59646,26007,3.64384e+13,1155.88,11366.4,85653,583,553,82296,82014,79512,70218,73248
15002,791,1454,10449,4553,3.71924e+13,270.22,3402.72,15002,335,256,13548,13523,13135,11985,11381
80311,1180,3002,56336,23975,3.65458e+13,1012.95,10939,80311,776,583,76749,75007,64622,49831,49344
43522,2173,2379,31323,12199,3.71053e+13,1007.62,7540.7,43522,563,492,41143,40889,40842,40663,40195
56102,238,2827,37786,18316,3.40097e+13,878.762,8714.32,56102,601,575,48835,43613,23860,11595,9842
75238,2893,3192,53002,22236,3.68576e+13,1112.72,10922.5,75238,614,626,72046,72046,71978,72001,71191
66078,461,2781,46531,19547,3.67542e+13,1174.54,9931.03,66078,558,505,60659,57822,41534,29021,18289
48170,450,2889,33322,14848,3.43451e+13,657.874,8551.39,48170,529,368,44288,41893,27348,18905,10415
15125,468,1428,10500,4625,3.64242e+13,371.4,3523.87,15125,354,264,13543,12796,11227,8993,7717
13201,129,1172,9228,3973,3.64935e+13,368.707,3025.67,13201,244,222,10469,9214,6900,2720,2377
16759,1305,1334,11458,5301,3.44943e+13,361.854,3574.04,16759,265,246,15425,15425,15425,15425,15404
19693,1046,1479,14179,5514,3.73814e+13,580.033,4065.62,19693,352,245,18214,17901,17396,16182,15531
40481,29,1287,29112,11369,3.76381e+13,844.568,5143.43,40481,413,325,26495,20666,17585,5373,3732
40121,461,2025,27380,12741,3.58683e+13,554.23,6180.72,40121,455,324,37704,36715,21994,17121,10819
53201,1231,1741,37636,15565,3.79107e+13,700.024,6512.4,53201,440,366,51460,51409,48831,46172,44787
57954,1913,2179,40755,17199,3.51286e+13,865.893,7884.22,57954,503,337,55775,55754,55679,55617,52837
71891,2809,3428,49967,21924,3.6045e+13,878.37,11133.5,71891,642,503,68463,68441,68032,67503,63470
4591,78,718,3180,1411,3.68827e+13,164.934,1521.66,4591,115,187,3549,3106,2422,2145,818
98756,3229,3613,68647,30109,3.32689e+13,1180.61,12932.4,98756,700,492,95143,95128,94864,94283,93120
44697,2031,2348,30548,14149,3.47358e+13,671.687,7208.84,44697,481,369,42349,42340,41984,41299,39463
71724,1441,2773,50613,21111,3.63253e+13,971.851,10014.2,71724,689,510,68951,67872,62184,46890,47887
21119,950,1556,14734,6385,3.31801e+13,415.844,4245.84,21119,309,290,19563,19381,18919,18691,14224
90330,805,3028,62574,27756,3.35701e+13,1069.98,11096.5,90330,649,589,85990,83792,66826,46976,35656
71357,1076,2473,49905,21452,3.68123e+13,914.334,8749.76,71357,595,390,68815,67604,61301,47727,46266
81117,1515,4154,56550,24567,3.59762e+13,1043.35,13078.9,81117,839,596,76956,75474,54561,42780,33781
80320,1280,2480,55948,24372,3.39493e+13,1203.31,9672.56,80320,508,512,77320,75335,71719,57928,48987
38872,31,2287,26263,12609,3.43495e+13,710.068,6891.27,38872,380,436,24911,18601,14464,8079,2994
88934,1567,3525,61748,27186,3.57184e+13,1218.57,12054.1,88934,709,578,85409,84019,69865,53887,57006
43675,191,2172,30309,13366,3.39066e+13,634.882,7075.1,43675,434,429,37331,33516,24533,12077,6985
4706,474,683,3177,1529,3.35009e+13,167.793,1504.74,4706,161,156,4023,4014,3829,3686,3291
99326,2691,3739,70026,29300,3.51209e+13,1171.42,13644.5,99326,708,644,95587,95567,93482,88251,82127
14953,708,1410,10531,4422,3.40963e+13,323.844,3557.65,14953,193,298,13543,13387,13243,12981,8159
51662,1095,2176,36841,14821,3.637e+13,934.174,7361.57,51662,481,415,49287,48416,44959,35380,32635
45650,264,1764,30928,14722,3.49544e+13,838.871,6436.47,45650,453,419,39320,35527,22854,10640,13995
41572,1274,2265,29427,12145,3.52395e+13,605.821,7003.09,41572,476,326,39307,38981,37232,31137,28949
21785,1471,1653,14954,6831,3.36353e+13,462.543,4451.08,21785,316,340,20132,20103,20116,20111,19304
13739,693,1082,9477,4262,3.06101e+13,352.567,2780.13,13739,233,221,12657,12397,12268,11913,10858
22953,315,1808,15757,7196,3.51059e+13,667.565,5025.02,22953,349,348,20239,18697,13021,9625,5320
15327,742,1249,11018,4309,3.80764e+13,416.757,3365.53,15327,365,257,14078,13594,13602,12394,11974
6220,247,870,4195,2025,3.29476e+13,252.369,1866.91,6220,174,183,5213,4926,3331,2613,1796
42116,249,1978,29611,12505,3.36543e+13,884.721,6586.65,42116,378,500,37634,35478,27665,19682,6528
72784,2166,2223,51652,21132,3.68174e+13,964.894,8840.3,72784,528,524,70561,70561,70544,70560,70448
54277,259,2465,37361,16916,3.46608e+13,795.076,7955.66,54277,492,425,48569,43770,29494,13936,12712
92194,3133,3728,64360,27834,3.55433e+13,1046.46,12332.3,92194,555,606,88466,88448,88154,87981,83502
12125,397,1252,8608,3517,3.69874e+13,312.148,2962.61,12125,253,233,10873,10310,9709,8724,6080
51961,2461,2820,35621,16340,3.47353e+13,853.513,8733.52,51961,480,434,49141,49094,49050,48984,47805
75223,2937,3363,53608,21615,3.71066e+13,1104.33,11317.5,75223,800,483,71860,71859,71578,70981,69689
32314,1436,2232,23173,9141,3.67419e+13,801.124,6398.52,32314,423,373,30082,29557,28751,26821,23145
76704,2155,2892,54087,22617,3.61473e+13,980.944,10385,76704,617,538,73812,73773,72726,71842,62978
53370,1376,2259,37016,16354,3.33483e+13,723.705,7553.25,53370,518,393,51111,50773,48708,43557,43349
27013,226,1763,18626,8387,3.5912e+13,560.614,5272.93,27013,366,375,22725,20170,15400,8524,6165
93464,1171,3547,65883,27581,3.60887e+13,1079.99,12865.5,93464,653,632,89482,88260,76856,60875,40218
15772,321,1295,10899,4873,3.51979e+13,418.561,3513.07,15772,262,266,14109,12548,9525,6930,4972
77664,2264,2718,53912,23752,3.58659e+13,765.372,9310.81,77664,419,421,74946,74861,74733,74874,71077
23589,341,2044,16675,6914,3.52185e+13,480.899,5324.46,23589,278,421,20928,19341,15384,9994,7044
36407,1385,2321,24924,11483,3.52236e+13,550.129,6987.78,36407,407,433,34086,33941,32677,31033,23927
21981,656,1936,15365,6616,3.48333e+13,476.367,4993.85,21981,416,303,19968,19361,16654,12669,11624
29950,1231,2356,21331,8619,3.72059e+13,602.195,6275.55,29950,510,328,27594,27262,25769,21147,20630
1511,349,480,1095,416,2.9063e+13,52.6294,766.68,1511,124,70,1031,1024,1021,1019,842
66536,2829,3007,45110,21426,3.44188e+13,907.463,9775.57,66536,609,525,63529,63495,63249,63061,62951
97706,2389,3272,66888,30818,3.42169e+13,1104.64,12084.7,97706,652,524,94434,94351,91860,86340,83544
6272,401,722,4306,1966,3.50326e+13,299.206,1738.11,6272,158,172,5499,5087,5007,4762,4014
26400,414,817,18075,8325,2.78033e+13,536.031,3219.73,26400,256,214,25058,24313,23208,22445,13612
50804,683,2408,35799,15005,3.72802e+13,772.31,7747.12,50804,466,520,47793,46391,37394,26173,23313
92689,730,3301,64446,28243,3.63991e+13,1060.68,11952.1,92689,611,552,87405,84033,62415,45657,36194
62809,645,2075,44868,17941,3.62119e+13,905.089,8028.83,62809,497,472,59203,56550,46599,31557,27680
19191,1403,1578,13174,6017,3.54996e+13,514.028,4320.81,19191,294,325,17613,17613,17562,17610,16622
36545,1643,1710,25703,10842,3.48511e+13,820.236,5742.9,36545,368,344,34835,34809,34810,34794,34590
74108,594,3722,50986,23122,3.45146e+13,955.247,11859.2,74108,613,621,68196,64761,42929,28912,19344
86282,1717,3406,59160,27122,3.5634e+13,1160.19,11142.6,86282,542,508,82876,81741,74209,59964,60075
10104,677,750,6810,3294,3.44343e+13,284.737,2130.54,10104,193,198,9354,9351,9346,9346,9198
36853,1138,2428,25525,11328,3.57642e+13,635.09,7081.84,36853,366,441,34425,33668,32572,30387,18543
60324,1058,1852,43631,16693,3.73619e+13,858.468,7336.08,60324,532,374,58306,57042,55388,51712,48467
31047,411,2178,21473,9574,3.40231e+13,620.335,6102.07,31047,373,373,27996,26486,19087,14415,8141
50485,906,2418,35191,15294,3.58567e+13,930.771,7826.74,50485,533,466,47619,46410,40949,31857,27624
59433,1716,2907,40743,18690,3.51839e+13,593.312,9093.45,59433,632,409,56526,56470,49247,38256,38791
54158,2647,2714,38139,16019,3.55387e+13,733.784,8432.59,54158,445,419,51444,51444,51428,51438,51347
23511,812,1600,16953,6558,3.73704e+13,584.528,4691.9,23511,368,384,21911,21439,20566,19214,14483
77650,1665,2572,53978,23672,3.43177e+13,959.688,9826.03,77650,594,526,75078,74759,73490,72116,62713
9945,511,1174,6867,3078,3.52165e+13,256.69,2727.5,9945,197,238,8771,8661,8492,8474,5621
92221,985,3192,65526,26695,3.67303e+13,1003.8,11404,92221,541,510,88636,86772,74525,52367,37301
72288,2169,3015,51227,21061,3.56843e+13,942.686,10175,72288,575,480,69273,69211,68310,66760,60942
28273,523,2086,20270,8003,3.65311e+13,488.578,5780.24,28273,380,342,25990,24384,22823,16636,11348
69882,1422,3050,49537,20345,3.66913e+13,849.671,10635.6,69882,525,582,66832,66395,62110,53512,40463
56046,972,2385,39917,16129,3.65952e+13,1218.52,8445.16,56046,552,457,52691,51139,45978,32782,27551
40232,1427,2021,27960,12272,3.64383e+13,775.582,6431.76,40232,427,425,38211,38181,37120,35621,34084
67441,2109,2880,48164,19277,3.68596e+13,941.068,9721.4,67441,490,589,64561,64484,63877,62112,53998
36933,935,2493,25660,11273,3.57646e+13,581.11,7131.62,36933,360,517,34440,33894,31738,29762,18052
12277,897,1262,8537,3740,3.65849e+13,336.051,3026.91,12277,232,225,11015,11005,10342,9439,9522
76672,393,2787,54960,21712,3.65346e+13,1180.7,10300.8,76672,651,607,69802,65759,44118,28262,18520
87723,2888,3682,61748,25975,3.6166e+13,936.703,12457.2,87723,707,477,84041,83996,83068,81865,77104
20505,1182,1390,14094,6411,3.43535e+13,446.876,4074.83,20505,306,274,19115,19108,19069,18984,17214
8414,327,805,5921,2493,3.69257e+13,380.771,2099.6,8414,218,184,7265,6592,6509,5727,4645
71239,1806,3679,48531,22708,3.50616e+13,680.768,11465.6,71239,505,672,67560,67320,64698,59666,47159
49637,1489,2414,34078,15559,3.48911e+13,848.94,7836.47,49637,434,453,47223,46909,44832,39924,35898
25389,751,1592,17263,8126,3.4427e+13,408.995,4708.56,25389,297,287,23797,23555,19727,14747,13637
99939,3047,3912,68097,31842,3.4639e+13,1079.73,12723,99939,581,598,96027,95691,95094,94074,88253
35712,2018,2225,25313,10399,3.67657e+13,693.453,6706.56,35712,629,407,33487,33453,33161,32470,32244
24464,844,1543,16938,7526,3.55935e+13,632.106,4529.01,24464,367,282,22920,22478,21626,19685,15278
84198,2135,3195,59774,24424,3.61918e+13,1005.14,11138.8,84198,559,577,81003,80908,79264,77518,65668
81225,3348,3374,57892,23333,3.6399e+13,1041.26,11582.6,81225,768,465,77851,77851,77851,77851,77818
97436,359,3975,65954,31482,3.41947e+13,1077.67,13466.7,97436,747,751,89122,83897,49742,24880,18913
78316,2580,3303,54744,23572,3.61028e+13,1085.68,11118.1,78316,593,669,75013,74796,74115,72652,68178
33006,1856,1894,22882,10124,3.49639e+13,589.795,5863.93,33006,361,374,31112,31112,31104,31109,31074
52097,1295,2610,36255,15842,3.56268e+13,780.422,8131.9,52097,627,462,49487,48757,45934,41150,35552
74231,1329,2673,50523,23708,3.10239e+13,865.651,9647.42,74231,477,527,71555,70672,68040,59574,54515
62392,2273,2861,43787,18605,3.63754e+13,786.043,9570.91,62392,479,501,59531,59460,59207,58915,49734
55754,1656,2373,38474,17280,3.1601e+13,770.57,8195.54,55754,558,501,53381,53225,51432,44676,44546
49087,223,2371,32527,16560,3.32856e+13,863.178,7802.72,49087,406,613,43818,40193,24192,13393,5800
53873,1609,2919,38045,15828,3.61092e+13,885.666,9018.02,53873,665,431,50954,50574,47642,42292,37682
49202,1993,2764,34152,15050,3.56263e+13,713.428,8543.86,49202,580,472,46438,46419,45753,44085,42899
75039,1120,2643,52427,22612,3.42631e+13,946.842,10261,75039,551,534,72079,71085,65952,51981,41428
10928,221,935,7551,3377,3.6508e+13,268.239,2444.68,10928,206,204,9456,8167,5988,4755,2502
68575,1489,2175,47051,21524,3.25791e+13,851,8114.45,68575,534,442,66400,65925,64931,60897,59944
20153,328,1988,14321,5832,3.61808e+13,436.644,4942.25,20153,373,404,17568,16257,14310,12205,5072
63530,1989,2863,45048,18482,3.65726e+13,848.495,9232.53,63530,580,446,60667,60439,59444,55805,53342
46906,2253,2269,32471,14435,3.52096e+13,883.539,7368.53,46906,523,400,44637,44637,44636,44637,44606
37946,2169,2349,26069,11877,3.31425e+13,592.884,6990.03,37946,318,484,35597,35584,35554,35591,34689
2141,70,485,1440,701,3.5633e+13,109.466,862.666,2141,119,114,1515,1297,1111,965,439
91131,2473,2477,61379,29752,3.54666e+13,670.785,9987.89,91131,579,444,88654,88654,88651,88652,88651
31468,1592,1885,21521,9947,3.3015e+13,736.38,5673.64,31468,321,389,29583,29263,29259,28926,27142
39151,1769,2394,27563,11588,3.56486e+13,752.975,7269.18,39151,477,477,36757,36701,35888,34898,31598
15889,1002,1593,11513,4376,3.74091e+13,402.822,3882.13,15889,386,216,14296,14071,13677,12105,11890
48832,1490,2813,34124,14708,3.62211e+13,707.648,8445.46,48832,459,563,46019,45778,44412,43728,33711
37278,461,2315,26068,11210,3.61741e+13,662.007,6530.8,37278,502,382,34308,32664,24115,16336,14888
23401,404,1368,15712,7689,3.45506e+13,582.186,4335.63,23401,313,369,21065,19936,15133,12140,8943
14680,554,1060,10335,4345,3.38791e+13,387.286,2996.94,14680,245,255,13555,13312,12303,11010,9382
63004,1987,2270,45220,17784,3.68038e+13,902.975,8582.47,63004,500,481,60734,60571,60605,60435,57326
1065,139,329,728,337,3.78077e+13,59.9455,506.053,1065,75,81,736,675,683,700,502
16174,109,1701,11381,4793,3.66486e+13,316.339,4073.86,16174,301,274,12830,11054,8735,5711,2450
85459,2946,3201,60724,24735,3.71066e+13,988.496,11547.6,85459,564,517,82258,82253,82187,82161,80983
71786,942,2508,49965,21821,3.39115e+13,1148.92,9610.59,71786,563,505,68450,67035,60959,46563,33661
19890,1543,1741,13705,6185,3.54513e+13,448.809,4496.43,19890,437,271,18149,18136,17966,17820,17322
2579,443,488,1730,849,3.66218e+13,89.0566,947.15,2579,99,114,2091,2090,2083,2088,2032
78076,1900,3213,54529,23547,3.57139e+13,1111.11,10933.4,78076,608,608,74863,74252,72031,67173,57118
50526,154,2174,33731,16795,3.35008e+13,924.644,7475.41,50526,502,558,42239,37425,21193,9556,7887
93405,1100,3720,66479,26926,3.67565e+13,1172.26,13298.1,93405,758,497,88960,86120,74058,50600,45288
74887,2717,2719,52574,22313,3.59958e+13,1184.74,9454.54,74887,605,453,72168,72168,72168,72168,72168
71048,2999,3105,50565,20483,3.61985e+13,922.76,10644.1,71048,727,505,67943,67943,67827,67808,67117
73333,2351,2440,52093,21240,3.75607e+13,969.976,9493.45,73333,578,527,70893,70893,70855,70876,70687
92052,2008,3302,65109,26943,3.51971e+13,1190.66,12062.4,92052,668,571,88750,87991,85397,79355,71719
4049,337,342,2563,1486,2.8227e+13,100.699,893.215,4049,95,94,3707,3707,3707,3707,3707
40037,835,2039,28350,11687,3.60607e+13,725.159,6566.88,40037,442,467,37828,36845,34356,29881,21087
50481,1634,2251,35259,15222,3.36004e+13,1009.73,7682.19,50481,469,399,48230,47835,46602,43023,41836
50958,371,2564,36046,14912,3.67431e+13,692.43,8005.62,50958,558,361,47002,44555,31015,23354,14113
58653,1437,2422,40309,18344,3.63593e+13,520.047,7353.9,58653,445,470,56231,56197,53553,49720,45381
61102,1844,3521,42501,18601,3.60407e+13,855.448,10251.7,61102,575,516,57581,57041,55049,47795,45154
32332,406,1825,22386,9946,3.47226e+13,676.005,5714.35,32332,432,401,29654,28101,23365,18345,10024
42203,1934,2341,29351,12852,3.48314e+13,904.5,7273.64,42203,471,450,39862,39799,39284,38606,37712
83937,2762,3484,57985,25952,3.3964e+13,966.11,11892.1,83937,559,597,80453,80401,80051,79912,72709
9589,495,957,6526,3063,3.32896e+13,170.792,2277.07,9589,198,166,8632,8501,8327,8331,6804
16402,227,1233,11367,5035,3.56819e+13,565.611,3602.08,16402,317,341,13999,12765,8673,5163,4158
92390,1691,3249,64907,27483,3.60652e+13,1125.66,11493.3,92390,646,545,89141,88085,81892,64454,66477
35493,816,2137,25104,10389,3.75809e+13,427.631,6318.34,35493,359,449,33356,33081,31392,30919,19135
5699,408,861,3863,1836,3.57137e+13,235.545,1847.75,5699,195,157,4838,4619,3827,3107,2980
18506,123,1229,12543,5963,3.46763e+13,367.294,3565.68,18506,275,265,14609,12753,9603,3904,4460
72613,2649,2703,51529,21084,3.4641e+13,957.497,9684.56,72613,653,406,69910,69910,69889,69888,69721
92454,1247,3510,64277,28177,3.49489e+13,1132.96,12369.9,92454,654,576,88488,87513,65321,48839,46325
41038,857,2389,29367,11671,3.73755e+13,740.071,7349.94,41038,514,353,38383,37557,34900,27215,21612
61746,2189,2618,44142,17604,3.68832e+13,1056.87,9144.72,61746,575,460,59128,59058,58817,58724,56192
72472,1654,2524,50750,21722,3.56956e+13,1034.51,9464.98,72472,578,542,69948,69120,67424,64200,56815
20321,224,1724,13733,6588,3.1834e+13,382.466,4510.25,20321,393,346,17835,16593,10924,6925,4278
35866,2003,2171,24838,11028,3.55654e+13,571.03,6642.39,35866,438,507,33695,33695,33671,33605,32928
49138,2663,3019,33022,16116,3.35685e+13,618.87,8434.67,49138,668,473,46119,46105,45970,45903,44919
28238,1255,1684,19610,8628,3.5703e+13,584.194,5194.5,28238,315,357,26554,26478,26434,26228,23674
6479,792,1011,4718,1761,3.95432e+13,197.422,2018.19,6479,163,163,5468,5460,5435,5445,4942
9351,121,895,6331,3020,3.4426e+13,287.913,2273.37,9351,185,199,7344,6381,4723,2792,2018
94402,2445,3001,68122,26280,3.72234e+13,1158.97,11655,94402,690,615,91401,91045,90542,88889,83918
8247,608,984,5783,2464,3.73986e+13,288.45,2294.01,8247,205,214,7263,7158,6773,6449,4994
5104,221,777,3521,1583,3.55739e+13,128.603,1590.54,5104,191,131,4327,4177,3563,3222,1394
42160,241,1707,28291,13869,3.48593e+13,456.978,5526.02,42160,343,352,36831,31579,23557,12479,9243
75457,1476,3152,52594,22863,3.586e+13,813.087,10740.6,75457,672,414,72305,71861,64649,48112,48730
3980,334,759,2907,1073,3.90761e+13,156.203,1382.74,3980,188,113,3221,3091,2887,1935,1677
44078,1785,2044,30241,13837,3.58554e+13,721.725,6902.78,44078,475,551,42034,42022,41298,40338,40058
57470,1930,2558,39012,18458,3.42252e+13,893.048,8809.13,57470,466,583,54912,54690,54350,53771,47804
44845,2094,2556,30561,14284,3.26535e+13,583.939,7945.75,44845,390,643,42289,42283,42115,42236,39432
85284,313,2595,59491,25793,3.58469e+13,1052.54,10082.8,85284,677,498,77377,68976,45903,17605,19774
80426,2043,2646,56705,23721,3.68519e+13,1108,9934.26,80426,538,473,77780,77759,76006,73583,71328
3401,473,544,2371,1030,3.36122e+13,91.5857,1069.56,3401,189,86,2857,2856,2856,2857,2704
86376,411,3731,59290,27086,3.42093e+13,1009.92,12486.6,86376,648,560,79028,74753,49939,23600,17095
96358,864,3173,69094,27264,3.71193e+13,1391.48,11878.7,96358,684,571,91961,89710,69740,50550,34169
80684,2152,3354,56766,23918,3.62344e+13,913.989,11186.9,80684,696,684,77330,77103,72832,56055,63116
15805,26,1212,10985,4820,3.61916e+13,613.582,3359.92,15805,304,276,9731,7249,5604,2961,1288
50400,121,2523,35031,15369,3.57161e+13,731.066,7842.77,50400,531,417,40412,35100,24534,9880,5544
21604,720,1355,15421,6183,3.51165e+13,626.71,4238.17,21604,365,296,19981,19150,17541,12997,12719
83968,1583,3315,59246,24722,3.59952e+13,1117.79,11651.5,83968,538,602,80645,79669,74371,62819,57148
94317,640,4276,65175,29142,3.41415e+13,993.329,14405.7,94317,744,655,88265,84705,54983,26888,21916
32068,1173,1834,21981,10087,3.27897e+13,465.171,5784.65,32068,398,310,30234,30156,28472,24438,24416
66065,336,2637,46383,19682,3.62308e+13,1026.95,9329.16,66065,498,473,59547,53484,38348,24246,17650
56701,968,2902,40149,16552,3.64384e+13,996.106,9448.32,56701,556,491,53198,51766,47609,33971,28031
84849,987,2790,59980,24869,3.5752e+13,1209.22,10923.4,84849,706,558,80950,79164,70833,52584,37131
38653,2197,2315,26751,11902,3.42825e+13,528.148,6755.64,38653,415,407,36338,36338,36327,36337,35992
73621,681,3042,52261,21360,3.60615e+13,1258.43,10382.1,73621,704,531,68725,66372,49493,37381,25276
60698,2371,2412,42869,17829,3.57531e+13,1078.65,8279.73,60698,449,410,58286,58282,58273,58281,58232
69735,3063,3430,48033,21702,3.50607e+13,880.47,11127.7,69735,663,430,66305,66298,66009,65883,63553
43447,1350,1890,31458,11989,3.74611e+13,906.354,6678.95,43447,509,414,41557,40942,40567,39381,33213
85446,1326,3351,59264,26182,3.46225e+13,1225.22,11957.1,85446,667,562,81536,79752,71176,49901,46977
14247,560,1324,10162,4085,3.64358e+13,372.547,3354.26,14247,270,317,12891,12401,11770,10209,6313
38900,1288,2327,26489,12411,3.46159e+13,655.751,6923.73,38900,448,416,36573,36385,34379,29519,27373
84764,1628,2524,59765,24999,3.61805e+13,1333.35,10157.4,84764,629,591,82070,80780,78214,69866,65348
17322,1145,1385,12446,4876,3.6666e+13,514.918,3731.13,17322,360,289,15937,15701,15555,14361,14236
3716,248,753,2709,1007,4.01488e+13,84.8402,1367.68,3716,214,120,2963,2887,2421,2119,1485
22977,1068,1525,16519,6458,3.65909e+13,704.681,4528.06,22977,436,320,21452,21124,20210,19263,18276
48832,907,2037,33284,15548,3.58329e+13,444.109,6400.33,48832,411,336,46795,46670,41396,34809,33569
63090,1423,2633,42930,20160,3.38793e+13,842.455,8750.05,63090,490,478,60457,59794,55699,47196,43424
97788,2140,3231,70075,27713,3.67411e+13,1189.23,12400.1,97788,698,526,94557,94263,89402,77742,81342
80369,939,4050,56271,24098,3.69551e+13,842.511,12332.3,80369,531,624,75887,74387,55494,39963,29735
83132,1670,3467,58350,24782,3.59217e+13,957.539,11752.1,83132,589,655,79665,79196,76088,66263,61337
66962,916,2070,46670,20292,3.63283e+13,861.323,7492.22,66962,483,454,64619,63542,56144,44099,42910
52683,1175,2643,37115,15568,3.60306e+13,788.394,8395.56,52683,505,475,50030,49452,44328,30988,30308
33361,2128,2180,23468,9893,3.64848e+13,588.605,6222.48,33361,385,436,31181,31181,31175,31173,31128
98989,1819,3413,69201,29788,3.29773e+13,1252.2,13151.4,98989,665,687,95563,94374,92165,82262,64941
85240,1606,3250,59986,25254,3.50297e+13,1100.19,11580.9,85240,592,598,81990,80902,77216,62884,61407
78100,899,3210,54800,23300,3.54666e+13,961.282,11203.7,78100,555,632,74036,71689,63424,49535,32663
82514,359,3339,57341,25173,3.58919e+13,990.451,11927.1,82514,690,555,75619,69863,49104,24557,16645
53272,2916,3070,37193,16079,3.61815e+13,852.697,9172.44,53272,614,520,50202,50185,50155,50181,49639
22016,919,1189,14974,7042,3.5538e+13,555.018,3839.74,22016,287,293,20827,20800,20171,19457,19451
54651,808,2756,37790,16861,3.2962e+13,663.966,8799.82,54651,496,382,51843,50870,38086,27137,17952
81504,3481,3562,57236,24268,3.60878e+13,1322.09,12313.9,81504,681,846,77942,77942,77899,77934,77761
95419,2711,3860,65752,29667,3.37914e+13,1169.3,13340.9,95419,680,582,91559,91329,89816,82599,79570
5298,444,844,3633,1665,3.63713e+13,195.322,1768.22,5298,175,154,4454,4297,4016,3252,3108
27688,169,1893,19118,8570,3.59715e+13,469.97,5357.32,27688,406,392,23216,19831,14619,9136,5020
52636,1387,2279,36313,16323,3.59327e+13,802.591,7614.04,52636,512,439,50357,50265,45087,35684,39229
84140,3144,3189,58058,26082,3.42825e+13,1160.68,11833.6,84140,584,522,80951,80951,80943,80947,80748
57172,968,2220,40884,16288,3.77977e+13,798.169,7991.19,57172,502,427,54786,53849,51877,46416,39043
93555,409,3164,66635,26920,3.6601e+13,1231.89,12085.1,93555,664,613,85574,80593,51283,28256,23894
10125,255,777,6918,3207,2.79702e+13,161.198,2011.95,10125,147,167,9294,8963,8408,8248,2770
37591,2029,2450,26131,11460,3.54514e+13,694.378,7084.01,37591,386,373,35141,35135,35019,35121,33699
35510,299,2036,24770,10740,3.40039e+13,793.756,6188.32,35510,413,438,31845,30140,21673,16115,6979
6688,81,995,4596,2092,3.46321e+13,264.968,2147.76,6688,248,199,5092,4448,2678,1189,964
96127,3363,3751,66299,29828,3.50542e+13,870.503,12585.5,96127,620,474,92376,92374,92232,92132,88268
6627,225,996,4802,1825,3.90803e+13,238.368,2051.84,6627,168,196,5490,5039,4592,4508,1465
31602,1054,1910,22461,9141,3.65319e+13,685.385,5936.75,31602,347,410,29692,28723,28114,27043,20903
97326,1655,3686,66015,31311,3.4504e+13,939.262,12292.7,97326,675,483,93640,93079,81363,59546,63329
81982,447,2857,57167,24815,3.66045e+13,1275.45,10498.7,81982,709,563,75436,71088,47692,24235,21582
36863,1298,1299,24919,11944,3.45777e+13,573.941,4954.89,36863,337,333,35564,35564,35564,35564,35564
91058,1435,3712,62957,28101,3.66966e+13,913.712,12756.7,91058,812,529,87346,86547,70876,54983,51281
82954,1072,3006,56960,25994,3.43776e+13,1052.33,11052,82954,533,537,79425,76859,65684,46589,46833
89308,671,3216,62607,26701,3.27704e+13,1232.7,11503.7,89308,625,623,83675,80675,61110,45125,32465
72128,2802,3561,49220,22908,3.48981e+13,884.4,11297.8,72128,510,650,68567,68560,68020,67093,60742
3155,356,655,2302,853,3.83294e+13,142.886,1158.11,3155,129,102,2500,2410,2428,2448,1667
82219,2389,3156,56206,26013,3.34315e+13,1025.32,11353.5,82219,633,443,79063,78964,76681,71218,69503
64821,2514,3103,44799,20022,3.62446e+13,705.362,9904.03,64821,587,385,61718,61704,60797,59617,57552
97765,3519,3743,67700,30065,3.45381e+13,1044.71,13666.4,97765,777,577,94022,94017,93960,93744,91307
67971,480,2102,47511,20460,3.54506e+13,873.589,8561.73,67971,530,457,63009,59357,49295,32530,22957
85893,950,3008,60775,25118,3.72515e+13,1046.79,11036,85893,606,503,82115,80724,66877,45149,32059
13854,168,1257,10010,3844,3.67676e+13,433.93,3175.41,13854,271,258,11464,9913,8326,5927,3121
68590,1869,3554,48815,19775,3.71634e+13,1012.26,11157,68590,625,603,65036,64292,61260,51029,51315
26654,1201,1453,18181,8473,3.34577e+13,446.533,4552.96,26654,308,284,25201,25193,24763,24047,24323
69339,914,2810,48811,20528,3.65879e+13,835.283,9533.13,69339,687,482,66251,65275,52766,41160,35312
17253,35,1317,12310,4943,3.69399e+13,545.673,3657.78,17253,310,314,11629,9201,7621,3030,1472
57179,303,2491,40405,16774,3.54552e+13,726.999,8322.1,57179,519,499,51863,47656,36560,21018,11400
46620,2226,2737,32257,14363,3.41245e+13,727.391,8195.91,46620,375,573,43883,43863,43726,43815,39798
49410,847,1914,34425,14985,3.41304e+13,917.792,7083.04,49410,453,413,47030,45882,42811,37834,27608
71146,1984,3750,49003,22143,3.46281e+13,1133.84,12001.1,71146,764,657,67396,66609,61087,49378,45188
86845,1333,3019,60498,26347,3.53458e+13,1083.67,10381.2,86845,609,467,83674,82383,73091,51551,50577
83664,2352,3400,57417,26247,3.53086e+13,870.314,11765,83664,483,590,80264,80243,79554,79406,65180
66348,1937,2868,47195,19153,3.72213e+13,1204.08,10006.6,66348,622,615,63480,62735,61007,56686,50958
28663,217,1679,19597,9066,3.46859e+13,420.959,5050.71,28663,302,382,24435,21432,17021,11779,4523
64714,1419,3172,44994,19720,3.58016e+13,785.12,9972.7,64714,531,629,61542,61122,54824,41083,40940
18414,538,1496,12850,5564,3.67079e+13,339.595,3899.64,18414,334,267,16918,16567,15412,14290,9251
89746,3056,3487,62555,27191,3.45732e+13,1353.77,12105,89746,654,638,86259,86202,85922,85579,83752
66557,2108,3033,46140,20417,3.59328e+13,926.66,9146.11,66557,556,495,63524,63108,61733,57658,57671
31230,1484,2132,21842,9388,3.62591e+13,552.564,5875.96,31230,340,345,29098,29025,28845,28421,25587
92059,1480,3529,63125,28934,3.50793e+13,1012.88,12597.3,92059,637,601,88530,87303,79925,62380,58357
92280,671,3129,63373,28907,3.49555e+13,1046.35,11598.4,92280,639,531,87303,83153,63107,44750,37471
63909,615,3023,44638,19271,3.67493e+13,918.392,9770.81,63909,630,565,59560,57347,42140,33538,21298
7463,533,891,5156,2307,3.48928e+13,298.511,2129.01,7463,178,188,6572,6380,6160,5559,4980
6841,555,779,4847,1994,3.06949e+13,129.594,1761.02,6841,167,154,6062,6047,6030,5891,4082
52238,745,1995,37475,14763,3.75635e+13,910.78,7330.39,52238,542,365,49414,47392,43829,36129,25961
94745,1939,3425,65008,29737,3.28946e+13,1061.27,12506,94745,693,534,91320,90778,86845,79848,72651
46955,45,2875,33020,13935,3.49203e+13,650.259,8434.63,46955,590,342,33098,26578,20407,6411,3761
51383,2165,2608,36658,14725,3.71172e+13,747.645,8357.93,51383,461,464,48775,48727,48608,48424,44973
43866,1638,2430,30497,13369,3.5207e+13,752.023,7224.49,43866,449,415,41436,41014,40109,36611,34628
7524,296,648,4994,2530,2.89941e+13,112.25,1639.2,7524,116,137,6876,6831,6678,6702,5249
75357,899,3160,52839,22518,3.56164e+13,889.633,10779.6,75357,584,543,71739,69671,60717,39843,32606
72474,2820,4032,50209,22265,3.55847e+13,831.465,11964,72474,671,505,68442,68408,65222,60474,55754
96621,1705,3128,66756,29865,3.59577e+13,1105.45,11682.4,96621,660,586,93493,92947,85792,67589,67928
79637,2278,3331,54586,25051,3.48623e+13,664.654,11315,79637,571,469,76306,76284,71718,62074,56960
53634,88,2785,36740,16894,3.42583e+13,701.682,8684.82,53634,460,435,41584,35751,26131,10031,6198
39781,995,1997,26899,12882,3.45952e+13,615.81,6370.52,39781,457,445,37784,37185,30365,25218,27329
29920,264,1669,20659,9261,3.60376e+13,959.817,5508.97,29920,422,479,25549,22818,16521,7491,7858
1031,82,225,707,324,3.80895e+13,45.6673,413.885,1031,63,60,806,776,641,500,249
53940,854,1825,38484,15456,3.70254e+13,800.618,6818.99,53940,505,355,51648,50111,48092,43966,37120
69495,1565,2863,48069,21426,3.45991e+13,1167.63,9922.6,69495,599,562,66632,65528,59974,46926,48998
60877,339,3280,42035,18842,3.5633e+13,589.421,9784.91,60877,402,741,56049,51098,34826,17622,13807
52281,11621,52281,0,52281,15.9997,0,52281,52281,52281,1,0,0,0,0,0
34866,784,1694,24695,10171,3.43258e+13,578.963,5402.35,34866,407,298,33097,32201,30549,27211,22589
53642,1689,2567,37387,16255,3.45241e+13,733.094,8388.76,53642,656,388,51075,50985,49673,46421,42660
17457,1441,1747,11870,5587,3.49847e+13,429.073,4283.17,17457,397,402,15710,15695,15516,14800,14814
73646,1653,3309,52444,21202,3.53527e+13,891.765,11333.8,73646,557,578,70337,69843,67192,63720,44373
58047,2293,2660,40734,17313,3.51018e+13,1030.58,8802.95,58047,505,506,55387,55290,55257,55360,54118
15196,814,1239,10449,4747,3.42173e+13,347.107,3237.76,15196,203,300,13957,13928,13624,13558,10465
61814,1222,2799,44183,17631,3.72261e+13,945.855,9465.87,61814,521,503,58988,57559,55731,47846,36438
47210,547,1571,33510,13700,3.62221e+13,854.018,6197.28,47210,476,351,44192,42321,35661,23012,23460
80777,1817,2711,56056,24721,3.54535e+13,1106.93,10442.8,80777,658,489,78066,77515,73161,60856,61054
85308,958,1954,61206,24102,3.71661e+13,1030.87,8503.89,85308,540,427,82608,80070,74883,66732,53054
9877,224,1285,7155,2722,3.71516e+13,271.499,2834.29,9877,245,272,8239,7368,6371,5692,1646
59750,1054,2323,41327,18423,3.39617e+13,1040.1,8230.02,59750,473,457,56939,55422,52807,45638,35756
46303,601,2233,32514,13789,3.59792e+13,891.962,7409.74,46303,535,376,43002,41102,33058,22587,18109
91402,1932,3091,64395,27007,3.63598e+13,1058.29,10970.9,91402,628,517,88311,88091,82691,72099,72552
36553,1940,2399,25300,11253,3.47366e+13,730.237,6991.23,36553,496,374,34154,34145,33303,31820,30222
5760,51,766,4078,1682,3.70206e+13,235.713,1681.05,5760,210,184,4025,3293,2787,1665,890
82459,2005,2956,58172,24287,3.54297e+13,957.223,10924.2,82459,558,403,79503,79352,76998,71754,63279
28006,554,1937,19838,8168,3.7003e+13,532.999,5412.15,28006,328,319,25896,25031,22378,18186,14355
95746,848,3598,66799,28947,3.64101e+13,1300.73,12799,95746,748,588,90424,87106,65729,44228,35033
59638,2370,2479,42205,17433,3.63904e+13,844.293,8517.86,59638,477,428,57159,57158,57140,57052,56926
48739,1348,1911,35395,13344,3.68722e+13,855.143,7028.7,48739,416,381,46828,46465,45979,45525,42317
53080,1640,2590,37917,15163,3.75475e+13,863.334,8386.74,53080,558,512,50490,50273,49077,46843,37595
78699,3578,3761,54985,23714,3.56122e+13,959.562,12319.1,78699,634,633,74938,74936,74882,74917,74286
7371,539,970,4895,2476,3.32465e+13,152.715,2186.07,7371,126,245,6401,6377,6280,6256,4502
55466,325,2609,37609,17857,3.42368e+13,885.323,8595,55466,530,426,49635,45761,30496,18025,10943
91965,1872,3623,63785,28180,3.55873e+13,927.971,12682,91965,572,556,88342,87992,82718,70237,58403
68846,608,2231,49441,19405,3.65789e+13,1031.16,8858.84,68846,633,461,64219,61157,51024,37371,27856
14491,364,1424,9865,4626,3.27391e+13,309.595,3351.86,14491,311,208,12902,12359,8092,6001,5140
69719,2032,3870,48155,21564,3.58392e+13,1171.21,12021.9,69719,608,710,65849,64970,62901,58571,46890
54442,569,3399,38007,16435,3.62362e+13,737.387,10057.9,54442,418,783,50025,48077,39958,29399,17561
75576,161,3014,52102,23474,3.57336e+13,1146.91,10467,75576,614,602,62700,54453,35362,12321,12265
7466,465,634,5058,2408,3.30979e+13,302.938,1764.28,7466,166,178,6832,6654,6519,6163,5852
37528,974,1791,25997,11531,3.54491e+13,543.968,5922.87,37528,391,360,35737,35651,32470,28610,26142
23122,374,1518,16262,6860,3.62865e+13,577.158,4389.42,23122,402,309,20429,18883,14233,10274,6937
59055,2554,3152,40413,18642,3.48245e+13,863.527,9933.04,59055,567,495,55903,55866,54281,51105,50482
49651,2132,2623,34823,14828,3.59801e+13,848.266,8202.04,49651,504,555,47028,46754,46500,45990,42944
94788,1162,3038,66447,28341,3.6035e+13,1242.38,11544.6,94788,639,551,91134,89655,80918,58675,50629
52554,2057,3225,36163,16391,3.60777e+13,551.492,9539.62,52554,359,675,49329,49322,48842,48045,32151
67799,1874,1954,47068,20731,3.42729e+13,847.233,7906.78,67799,563,381,65845,65845,65819,65785,65365
54771,232,2960,37959,16812,3.35221e+13,603.521,9021.23,54771,382,576,48445,44640,30462,14976,7481
76238,3085,3712,52174,24064,3.49731e+13,783.193,11502.2,76238,807,540,72526,72523,71895,69212,68815
14747,370,1539,10324,4423,3.52679e+13,297.88,3601.16,14747,287,198,13087,12381,9646,7420,5149
4228,350,474,2920,1308,3.54211e+13,231.687,1138.02,4228,135,135,3754,3745,3616,3605,3434
12003,108,1090,8108,3895,3.381e+13,447.959,2761.76,12003,264,229,9715,8290,6018,2775,1998
12025,873,972,8099,3926,3.44026e+13,300.441,2738.87,12025,206,245,11053,11053,11004,10963,10010
82167,3355,3743,57624,24543,3.62194e+13,830.702,12422.4,82167,483,701,78424,78421,78300,78290,75761
35764,830,1688,25762,10002,3.54595e+13,684.765,5589.55,35764,468,370,33763,32839,32103,29968,20097
10932,791,974,7493,3439,2.89165e+13,142.938,2236.44,10932,219,141,9958,9958,9952,9951,9516
65465,1983,2692,46126,19339,3.53886e+13,822.094,9270.08,65465,555,506,62773,62660,62055,60973,51276
89313,518,2977,62767,26546,3.61633e+13,817.847,10454.9,89313,769,405,84935,82330,54909,39716,25582
95270,2566,3056,65690,29580,3.44118e+13,1199.45,11426.7,95270,613,555,92214,92108,91467,90353,86167
61308,438,2406,42883,18425,3.60468e+13,845.477,8278.17,61308,488,432,56018,52065,37225,24049,16723
7323,759,1122,5095,2228,3.72929e+13,175.147,2365.86,7323,143,267,6201,6199,6114,6124,4970
74165,1059,2261,53081,21084,3.69663e+13,939.146,8884.23,74165,623,405,71777,70787,64675,55821,51994
87780,1389,2800,61417,26363,3.52932e+13,1122.86,11059,87780,536,552,84923,83810,78098,70489,56644
69536,2661,2869,48065,21471,3.4836e+13,997.538,9677.33,69536,512,506,66667,66666,66478,66272,65677
4164,442,524,2996,1168,3.85357e+13,188.27,1164.22,4164,152,108,3640,3639,3586,3606,3394
4847,115,681,3347,1500,3.72342e+13,223.692,1534.38,4847,161,164,3778,3371,2833,2098,1427
12390,872,1507,8928,3462,3.92945e+13,314.796,3395.65,12390,301,314,10883,10775,10625,10561,7511
82356,2258,2350,57091,25265,3.61447e+13,948.851,9334.76,82356,528,510,80006,80006,79964,79991,79826
19814,1296,1696,13337,6477,3.40425e+13,436.025,4464.53,19814,320,390,18118,18111,17950,17746,15376
9725,457,969,6672,3053,3.47111e+13,320.062,2409.12,9725,220,249,8714,8287,8095,7372,5812
59685,162,1628,41053,18632,3.04809e+13,870.813,6605.05,59685,429,417,53405,50115,29105,6912,8688
33409,402,1454,23898,9511,3.6929e+13,593.064,5153.08,33409,378,331,30998,29744,26613,22379,15316
56946,2141,2264,41096,15850,3.73032e+13,803.462,7940.48,56946,488,528,54682,54682,54664,54575,53857
17173,827,1575,11838,5335,3.40883e+13,440.498,4015.28,17173,355,272,15598,15170,13769,10655,10593
70728,39,3017,50043,20685,3.48989e+13,1142.74,10601.9,70728,735,673,48042,37515,30702,7801,5094
43720,1451,2367,30440,13280,3.53479e+13,755.746,7434.06,43720,583,373,41353,40815,39452,37323,31387
38577,700,2037,27505,11072,3.63325e+13,652.544,6592.42,38577,395,417,36127,35015,31957,27240,21225
86384,2498,3156,59987,26397,3.43734e+13,993.436,11399.6,86384,568,571,83228,83207,82311,81739,78916
65703,940,2025,46333,19370,3.64057e+13,905.6,7561.08,65703,478,462,63261,62525,55250,38632,39384
75823,996,1784,54646,21177,3.75684e+13,904.872,7875.69,75823,526,408,73892,70553,68459,62579,51066
91174,2120,3374,64445,26729,3.68155e+13,1177.42,12434.8,91174,791,627,87800,87184,82425,69217,68112
58798,2498,3031,41250,17548,3.65793e+13,670.54,9672.73,58798,441,550,55767,55758,55510,55381,50870
46825,1116,2254,33543,13282,3.70603e+13,714.912,7427.85,46825,508,396,44571,43737,40431,34465,30117
21159,316,1545,14336,6823,3.40666e+13,291.75,4023.6,21159,326,241,19515,17936,12288,8233,6248
82895,2383,3622,57457,25438,3.5437e+13,1073.36,12431.8,82895,472,663,79273,79019,78502,78734,70479
56052,740,3060,38397,17655,3.45176e+13,612.585,9309.53,56052,605,426,52827,51421,35966,28858,19631
98281,1346,3644,67727,30554,3.46122e+13,1223.26,13474.9,98281,638,672,94132,92363,78255,54062,40512
43599,164,2895,29944,13655,3.38985e+13,691.251,8514.98,43599,447,666,36907,33976,22290,9567,5308
31837,1627,2135,22005,9832,3.39961e+13,667.265,6154.7,31837,357,412,29702,29466,29183,28621,25275
55970,1923,2297,39677,16293,3.67332e+13,801.188,7902.74,55970,505,385,53673,53639,53076,52430,51131
50342,627,2720,35500,14842,3.55457e+13,852.722,8566.45,50342,522,451,46668,45063,38579,28213,20407
7903,482,892,5319,2584,3.08822e+13,163.454,2126.3,7903,194,237,7011,6921,6426,5531,3741
66326,2614,2763,46276,20050,3.56013e+13,1108.74,9291.9,66326,515,570,63563,63554,63499,63445,63046
56049,1189,2699,38060,17989,3.47647e+13,849.2,8574.25,56049,519,513,53350,52186,47058,37922,36734
67451,1799,2367,46719,20732,3.43421e+13,1116.18,9254.66,67451,535,545,65084,64425,63998,63007,55632
75776,1670,3276,50832,24944,3.4067e+13,868.783,11233.7,75776,520,643,72500,72317,68104,60628,45027
52486,538,2674,36169,16317,3.57939e+13,797.883,8145.93,52486,486,457,48943,47476,32169,23840,17690
31312,1911,2044,21862,9450,3.67953e+13,602.572,5809.28,31312,391,438,29268,29267,29262,29214,28743
43617,516,2077,30233,13384,3.5073e+13,992.769,6912.67,43617,464,443,40000,37615,30981,19328,13848
1297,177,356,998,299,2.86578e+13,90.8443,599.827,1297,91,59,941,869,827,607,478
99218,3653,4141,67876,31342,3.52896e+13,1279.21,14604.3,99218,755,931,95077,95044,94559,94177,92911
42635,1160,2979,30731,11904,3.62386e+13,682.681,8681.93,42635,685,497,39656,38949,36477,28309,21187
37756,1473,2558,26372,11384,3.59362e+13,526.766,7383.87,37756,357,513,35198,35163,34635,34227,22849
8664,730,1311,5856,2808,3.48015e+13,225.325,2769.2,8664,224,198,7353,7292,6847,5591,5261
56662,798,2421,40169,16493,3.74196e+13,865.696,8032.84,56662,494,411,53843,52313,43501,32436,32712
91939,2208,2833,65021,26918,3.63923e+13,1372.71,11374.9,91939,758,542,89106,87949,87547,85051,77969
12390,20,1108,9056,3334,3.7216e+13,469.988,2792.04,12390,277,214,7377,5563,4603,2394,1220
9438,69,680,6418,3020,3.60747e+13,386.765,2051.33,9438,201,242,6911,5932,4298,2304,1539
16672,1310,1417,12157,4515,3.72836e+13,352.857,3710.92,16672,257,234,15255,15222,15227,15247,14815
1472,6,341,1080,392,3.51869e+13,57.3777,586.758,1472,102,64,509,208,244,157,109
36121,842,2085,25347,10774,3.69818e+13,639.245,6103.2,36121,387,370,33961,33402,30763,24095,22749
87099,1786,2986,62839,24260,3.68146e+13,1350.59,11582.6,87099,746,538,83845,82675,80418,69860,65250
76298,2481,3152,53165,23133,3.51888e+13,1032.44,10763.7,76298,569,530,73146,73004,71956,69423,65775
55674,994,2729,38751,16923,3.52039e+13,866.951,8909.16,55674,606,463,52734,51330,42980,31911,32250
83066,1143,2736,59693,23373,3.70875e+13,1003.86,10876,83066,659,505,80086,78050,74041,59918,48035
96208,3071,3795,66373,29835,3.58109e+13,1101.05,12895.1,96208,598,607,92413,92337,91643,90717,85598
47591,1782,2417,33356,14235,3.64693e+13,801.703,7581.51,47591,414,454,45174,44962,44628,43854,41223
62648,696,2867,42997,19651,3.45232e+13,939.114,9731.16,62648,530,511,58487,56062,41377,31885,21630
24023,561,1439,16715,7308,3.63502e+13,505.508,4256.39,24023,318,341,22430,21618,19386,16113,14101
42163,59,2537,30120,12043,3.53445e+13,614.204,7600.28,42163,415,437,31575,25904,19902,5428,3803
86396,3375,3570,60326,26070,3.51006e+13,1160.64,11901.5,86396,764,553,82826,82808,82744,82793,82275
61949,2519,2873,44227,17722,3.64258e+13,807.658,9437.13,61949,454,495,59076,59059,58945,58435,56227
48065,2398,2544,33742,14323,3.56052e+13,709.385,7929.7,48065,378,464,45521,45520,45490,45503,44683
91711,1688,3340,63972,27739,3.55303e+13,1332.24,11822.1,91711,672,561,88239,86703,80620,62280,65537
48259,1027,2307,33794,14465,3.61266e+13,784.648,7788.53,48259,531,400,45869,44758,41030,28389,25531
58183,127,2826,40443,17740,3.56078e+13,709.271,9466.34,58183,404,611,47298,41549,29501,9774,7959
13169,704,1124,9423,3746,3.55748e+13,333.227,2812.27,13169,264,221,12045,11895,11349,11488,8876
21066,1606,1806,15364,5702,3.77381e+13,340.226,4657.7,21066,357,243,19260,19260,19206,19226,18673
17514,1014,1629,12681,4833,3.5843e+13,362.843,4162.11,17514,335,229,15885,15806,15301,13169,12404
32076,1776,1942,23108,8968,3.69926e+13,504.844,5782.96,32076,506,286,30134,30134,30079,30116,29618
5758,342,715,4101,1657,3.68379e+13,131.113,1609.7,5758,141,143,5043,4997,4831,4703,2460
8093,550,1113,5705,2388,3.70964e+13,356.019,2402.25,8093,254,202,6962,6560,6169,5430,3705
17291,531,1513,12367,4924,3.75665e+13,415.541,3970.31,17291,256,331,15563,14871,14179,13803,8221
62820,1678,2863,43944,18876,3.61494e+13,637.871,8987.96,62820,503,469,59957,59922,57166,52392,43740
39645,619,2042,28985,10660,3.72226e+13,823.462,6703.98,39645,475,403,36341,34631,32214,22980,12088
18439,726,1601,12884,5555,3.70212e+13,350.11,4217.05,18439,332,370,16838,16584,16020,15008,10618
40651,2009,2567,28593,12058,3.70035e+13,700.349,7275.38,40651,459,439,38084,38012,37765,37663,34723
64663,1501,2313,45716,18947,3.73222e+13,940.625,8961.77,64663,531,492,62350,61997,58453,51206,48049
37941,1275,2126,27254,10687,3.74573e+13,840.051,6855.48,37941,501,395,35815,35148,33775,30310,25740
34974,949,1916,24098,10876,3.54392e+13,525.593,5912.82,34974,324,390,33058,32919,31432,29696,18855
53872,431,2817,38395,15477,3.67623e+13,925.961,9077.43,53872,578,440,48921,45543,32916,21584,16526
97029,2792,3906,67629,29400,3.55691e+13,1074.11,13775.6,97029,698,711,93123,93077,91174,88197,77513
2647,315,551,1936,711,3.65373e+13,88.1466,995.381,2647,114,114,2096,2083,2072,2035,1589
18200,924,1324,12777,5423,3.59677e+13,512.209,3822.64,18200,281,331,16876,16773,16629,16539,14633
52052,1680,2069,36584,15468,3.58902e+13,850.999,7738.82,52052,482,452,49983,49969,49615,48335,44168
29651,51,1299,21007,8644,3.70977e+13,628.71,4557.79,29651,368,281,21105,17707,13622,4249,3439
57467,2262,2907,41348,16119,3.7151e+13,914.079,9340.2,57467,535,450,54560,54418,54216,54370,50904
4280,183,770,2961,1319,3.63082e+13,148.384,1530.07,4280,129,164,3459,3176,3049,3028,1148
13236,1744,1756,9597,3639,3.79002e+13,336.451,3746.16,13236,267,232,11480,11480,11480,11480,11470
47766,1524,2880,33018,14748,3.58177e+13,781.235,8715.05,47766,416,524,44886,44325,43319,41572,31400
94073,2299,3406,66467,27606,3.61755e+13,1193.52,12043.7,94073,682,602,90667,90090,85314,72366,75633
8249,117,876,5912,2337,3.64148e+13,266.971,2104.63,8249,185,188,6596,5720,4147,2514,1888
39091,540,2205,26791,12300,3.37572e+13,798.591,6961.27,39091,431,548,36086,35140,29116,24337,15443
83477,729,2816,59279,24198,3.70591e+13,1078.42,10191.8,83477,608,501,79357,76599,58520,43998,33524
23955,1120,2112,16239,7716,3.50263e+13,527.644,5527.06,23955,440,437,21843,21571,19828,17284,17078
72900,3320,3599,49921,22979,3.44067e+13,995.402,11854.3,72900,486,701,69301,69300,69197,69288,67661
78292,2121,3396,53073,25219,3.24942e+13,853.92,11364,78292,603,626,74896,74522,71581,63203,60178
45934,2004,2616,32194,13740,3.6387e+13,698.212,7982.68,45934,615,353,43318,43258,42810,40271,40368
48205,667,2063,32863,15342,3.41218e+13,509.571,6932.05,48205,348,425,46023,45340,39463,31609,25398
90123,438,3754,64043,26080,3.64117e+13,1209.53,13259.5,90123,608,608,82948,78618,55767,37647,20280
22096,780,1838,15548,6548,3.76482e+13,496.813,4824.4,22096,358,335,20258,19776,18053,13596,14016
44235,750,2310,31316,12919,3.68564e+13,945.113,7485.4,44235,496,565,41240,40317,36236,29977,17646
89710,2797,2915,64573,25137,3.76416e+13,1029.87,11595.4,89710,728,587,86795,86794,86757,86779,86427
63899,1748,2323,45282,18617,3.56275e+13,840.399,8863.57,63899,582,406,61576,61549,59892,56917,51620
6592,682,881,4769,1823,3.60035e+13,273.351,1939.8,6592,167,168,5711,5639,5680,5654,5034
96730,1419,3559,67050,29680,3.4663e+13,1158.01,12275.3,96730,690,564,92889,90843,82343,67269,59403
25223,857,1378,18164,7059,3.68969e+13,578.19,4388.71,25223,389,326,23845,23378,21416,18291,17478
30895,1718,1839,21422,9473,3.56586e+13,587.525,5349.73,30895,394,331,29056,29047,29029,29035,28701
77011,1028,2736,53849,23162,3.62404e+13,1182.1,9837.89,77011,516,574,73329,71514,61303,42465,43843
93699,2351,3380,66554,27145,3.64799e+13,933.547,12251.3,93699,630,673,90319,90270,87573,84107,76547
18305,1315,1388,12825,5480,3.66688e+13,516.117,4008.73,18305,271,369,16917,16916,16902,16906,16681
29600,1664,2100,20287,9313,3.60412e+13,391.757,5844.02,29600,420,362,27500,27496,26996,25591,25831
41288,591,1987,29764,11524,3.67561e+13,701.131,6583.09,41288,455,368,38512,37335,33728,28344,19997
66046,39,2920,45304,20742,3.40076e+13,828.174,9634.15,66046,479,539,44812,34216,27168,14056,4289
80198,789,2542,54978,25220,3.31752e+13,973.172,10182,80198,507,486,77015,75536,58974,42085,38745
50120,998,2102,35012,15108,3.58554e+13,746.54,7451.51,50120,454,416,47987,46941,44812,39957,30969
20062,489,1660,14378,5684,3.71382e+13,481.112,4393.48,20062,336,259,18201,17630,15843,10624,9589
42640,970,2037,30645,11995,3.61903e+13,849.834,6914.73,42640,440,381,40353,39443,37129,29970,25277
11112,529,1247,7632,3480,3.08991e+13,215.688,2810.48,11112,284,238,9865,9658,9507,8718,6584
10829,306,1068,7664,3165,3.63204e+13,448.496,2689.5,10829,234,236,9366,8862,8314,7543,3391
76744,1061,2338,53589,23155,3.35905e+13,957.552,9416.9,76744,501,498,74053,72918,69475,62084,50747
32440,722,2583,22407,10033,3.27895e+13,469.836,6691.74,32440,363,520,29848,28827,26849,23474,14941
70766,1877,2224,49751,21015,3.46988e+13,1058.7,8706.95,70766,559,417,68542,68498,67482,66225,65492
51944,666,2698,36418,15526,3.54406e+13,830.818,8474.57,51944,540,407,48349,46691,37389,28420,21036
49839,1411,1854,34234,15605,3.24493e+13,722.653,6841.66,49839,441,395,47985,47831,46111,44795,39108
26098,236,1651,18134,7964,3.49593e+13,508.247,4902.46,26098,313,313,22608,19932,14540,7640,6797
14832,789,1429,10354,4478,3.16861e+13,285.818,3412.17,14832,249,221,13403,13336,12568,12690,7410
56943,1333,2855,39722,17221,3.40601e+13,862.85,9034.19,56943,514,495,54088,53294,50110,40760,35466
63564,2076,2763,43623,19941,3.33631e+13,977.663,9248.65,63564,535,447,60801,60558,59538,57727,53099
70635,1407,3492,48820,21815,3.5022e+13,853.871,11265.3,70635,708,571,67143,66273,53760,42289,41377
64248,1429,2466,45118,19130,3.64646e+13,948.634,8430.93,64248,574,383,61782,61148,56340,44719,48105
64191,1217,2679,44090,20101,3.60931e+13,871.042,9268.39,64191,694,510,61512,61068,57252,49620,47424
73356,285,3069,52779,20577,3.72098e+13,1205.44,10922.1,73356,713,528,64927,57982,45053,25322,15484
74912,2220,3629,52005,22907,3.63415e+13,802.491,11763.4,74912,585,553,71283,71091,67312,61307,49140
95190,2584,3632,67399,27791,3.67846e+13,1037.62,12252.2,95190,649,502,91558,91388,89170,86335,79453
2288,289,507,1625,663,4.06033e+13,76.2548,887.162,2288,105,112,1781,1757,1744,1741,1139
18655,198,1954,12971,5684,3.61721e+13,373.174,4712.94,18655,336,382,15737,14140,10642,5705,3539
11550,1048,1310,8167,3383,3.52762e+13,363.87,3094.3,11550,241,237,10240,10228,10183,10185,9522
70813,1815,2337,50293,20520,3.60381e+13,908.383,9061.3,70813,653,451,68476,68404,67275,65983,62069
67973,2043,2811,48225,19748,3.6572e+13,1025.48,9721.81,67973,523,520,65162,64990,63255,60537,57313
44906,383,2689,31125,13781,3.40515e+13,746.515,8088.22,44906,434,426,40869,38351,26012,14729,8891
39275,106,1772,27188,12087,3.16334e+13,672.941,5814.69,39275,365,312,33613,29973,20052,5718,7650
14232,963,1017,9719,4513,3.60318e+13,313.905,2858.52,14232,209,229,13215,13215,13215,13215,13034
63195,2760,2902,43744,19451,3.53726e+13,972.456,9166.61,63195,545,535,60293,60290,60246,60258,59923
88388,2354,3189,62434,25954,3.57017e+13,1218.16,11777.5,88388,737,558,85199,84865,83137,77374,76945
90956,2726,2995,63778,27178,3.44672e+13,1127.79,11124.6,90956,700,577,87961,87869,87600,87521,85620
61749,1096,1468,42720,19029,3.02736e+13,788.768,6426.18,61749,432,387,60281,59844,58856,57562,48251
34967,883,1774,24215,10752,3.73031e+13,694.005,5841.19,34967,405,361,33193,32995,28691,22716,23582
19197,1102,1460,13911,5286,3.67888e+13,601.136,4071.99,19197,369,299,17737,17716,17268,17029,14830
74643,2866,2884,52572,22071,3.55345e+13,1205.39,10204,74643,562,539,71759,71759,71756,71758,71745
31041,250,1588,22481,8560,3.67033e+13,624.068,5142.14,31041,366,305,27184,24013,20150,11933,7685
88010,1492,3362,59728,28282,3.52243e+13,897.878,11794,88010,666,529,84648,84277,75635,62344,61230
51708,1978,2195,35898,15810,3.56919e+13,850.146,7440.14,51708,438,410,49513,49513,49404,49424,48780
34150,873,2375,24034,10116,3.49689e+13,659.334,6767.2,34150,430,401,31720,30815,27089,19233,16680
5079,780,1035,3571,1508,3.66373e+13,130.028,1856.92,5079,266,124,4044,4043,3941,3853,3405
68374,129,2650,48441,19933,3.69703e+13,849.342,9104.97,68374,620,563,54933,48455,34693,12969,10285
79797,3166,3653,55350,24447,3.55017e+13,780.244,11599.7,79797,692,569,76144,76144,75507,73314,72023
56384,1264,2504,38782,17602,3.54543e+13,602.19,7719.29,56384,462,347,53880,53455,47904,39695,40465
76551,1065,2995,53481,23070,3.62272e+13,950.803,10259.6,76551,511,499,73392,72079,63712,48453,48409
90078,2424,2626,64082,25996,3.68515e+13,988.581,10687.8,90078,704,471,87452,87452,87361,87264,86720
33503,70,2129,23969,9534,3.67402e+13,570.601,6023.87,33503,502,310,24920,21119,16563,3706,2888
52212,707,2250,36780,15432,3.60715e+13,965.013,7684.08,52212,497,398,48792,46612,39321,28226,20512
44855,2515,2999,30456,14399,3.38367e+13,584.027,8462.91,44855,489,545,41856,41843,41661,41498,37813
7521,455,1011,5460,2061,3.59159e+13,218.751,2192.02,7521,209,146,6510,6390,6069,4805,4236
90285,3101,3751,62278,28007,3.53804e+13,1267.48,12800.6,90285,669,546,86534,86296,85141,82983,82888
44226,2108,2288,30948,13278,3.4832e+13,688.347,7343.52,44226,519,369,41938,41932,41568,41146,41003
41788,2040,2176,29242,12546,3.53785e+13,674.569,6842.41,41788,420,434,39612,39593,39569,39582,39340
9031,1127,1195,6309,2722,3.62101e+13,323.462,2604.61,9031,288,224,7836,7836,7826,7826,7660
97659,1037,3772,67146,30513,3.44025e+13,1133.67,12836.9,97659,577,570,93273,91245,62296,48646,42368
85398,2201,3212,57961,27437,3.57364e+13,752.859,10608.6,85398,543,517,82186,82088,81605,80700,72827
24172,1222,2004,17098,7074,3.57227e+13,492.655,5331.15,24172,403,416,22168,22012,21380,20384,15869
49757,1617,1936,34766,14991,3.52768e+13,790.652,6774.39,49757,453,407,47821,47772,47348,46856,44198
40093,241,1775,27948,12145,3.25028e+13,726.712,6084.31,40093,409,315,36007,33970,26896,17828,7373
87864,394,1940,63773,24091,3.7081e+13,1001.48,8830.07,87864,566,447,80112,75028,53941,35454,28205
77884,2971,3560,55047,22837,3.77538e+13,1049.5,11479.5,77884,564,540,74324,74266,74096,74055,70868
84683,636,2555,59339,25344,3.40888e+13,1214.35,10324,84683,528,554,79162,76056,67855,47309,29213
78333,1492,2329,55923,22410,3.7352e+13,1115.89,9576.54,78333,620,503,76004,75124,71253,64811,58669
25555,1059,1919,17733,7822,3.58292e+13,574.169,5360.5,25555,364,390,23636,23111,22657,21232,16124
52687,1172,2762,37201,15486,3.64158e+13,801.421,8824.44,52687,427,530,49852,49156,45463,35690,29760
64785,2533,2961,44543,20242,3.35453e+13,863.066,9782.47,64785,697,393,61824,61819,61067,59998,57601
55711,1803,2464,39368,16343,3.6287e+13,904.857,8534.39,55711,536,393,53247,53013,51612,47523,46556
16552,727,1368,11724,4828,3.6355e+13,328.29,3641.49,16552,265,253,15184,15069,14441,14339,10674
54177,529,2801,37311,16866,3.48618e+13,681.366,8705.67,54177,508,524,49999,48317,37256,28183,18349
50780,645,2549,35267,15513,3.64218e+13,1047,8330.17,50780,512,598,47014,45124,35734,29257,16725
65643,1295,2567,46632,19011,3.58494e+13,1099.42,9369.94,65643,564,512,62710,61587,58106,47171,44252
46678,9445,46678,0,46678,15.9997,0,46678,46678,46678,1,0,0,0,0,0
22153,1369,1707,15743,6410,3.75387e+13,488.623,4685.47,22153,401,370,20446,20425,20189,20076,18802
84118,1895,2824,60710,23408,3.69819e+13,1041.94,10444.3,84118,749,489,81294,81171,79025,73873,73665
1492,119,370,1020,472,3.64149e+13,82.4062,633.801,1492,95,93,1109,1038,919,969,505
61934,339,2511,43343,18591,3.52713e+13,860.173,8811.08,61934,556,408,56567,52798,34088,19103,13892
21297,821,1664,14967,6330,3.67871e+13,484.097,4737.3,21297,353,434,19633,19169,18598,17483,11646
78191,1182,3720,54092,24099,3.48771e+13,829.101,11930.6,78191,571,668,74428,73660,59676,36904,28739
94713,638,3250,65533,29180,3.53803e+13,1266.71,11946.5,94713,587,680,89215,86368,55526,38930,30991
26629,245,1712,19284,7345,3.72319e+13,686.875,5252.32,26629,372,314,23148,20941,16099,10321,6016
77741,3522,3663,52833,24908,3.40469e+13,964.21,12102.9,77741,693,681,74078,74078,73871,73472,73511
11137,602,1026,7687,3450,3.51835e+13,261.396,2644.43,11137,220,215,10111,10012,9673,8481,6889
40372,2270,2331,28235,12137,3.58453e+13,795.867,7159.1,40372,469,477,38041,38041,38038,38041,37930
86965,1161,3011,59552,27413,3.56941e+13,916.509,10596.1,86965,505,547,83844,82672,71626,54476,53074
72018,542,3308,49415,22603,3.4541e+13,888.601,11219.4,72018,541,622,66976,64589,47569,35042,20859
47862,501,2684,33645,14217,3.57739e+13,758.093,8196.51,47862,595,516,44263,42550,32431,23319,14488
77607,1870,2857,55814,21793,3.68968e+13,1222.46,10802.2,77607,721,613,74750,74198,72680,69013,57075
14570,457,1215,10362,4208,3.60916e+13,444.603,3219.46,14570,353,307,13223,12497,10746,7977,8256
2658,378,636,1876,782,3.73306e+13,79.6415,1081.12,2658,113,111,2022,2015,1859,1845,1267
69712,244,3470,48043,21669,3.34835e+13,962.371,10945.2,69712,680,616,61626,57148,36300,14905,11262
71281,321,3210,49703,21578,3.42292e+13,988.403,10910.7,71281,538,682,64637,60938,41052,15575,10790
6799,1024,1065,4778,2021,3.74121e+13,202.307,2186.96,6799,161,226,5734,5734,5728,5732,5676
51139,1471,1804,35089,16050,3.18613e+13,843.355,6744.92,51139,441,441,49335,49266,48671,48250,46556
95310,340,3043,68290,27020,3.62619e+13,992.961,11294.8,95310,646,473,87009,81339,57633,33139,30701
6795,86,544,4535,2260,2.54363e+13,136.353,1391.54,6795,138,114,5846,4558,2692,1150,1468
31066,695,1505,21496,9570,3.13576e+13,630.659,4742.47,31066,331,386,29205,28473,27571,22467,19666
29471,561,1906,20479,8992,3.60556e+13,547.725,5709.44,29471,414,348,27185,25869,21547,15970,13390
70370,2529,2597,49657,20713,3.54732e+13,878.299,9584.07,70370,717,377,67773,67767,67768,67770,66972
92986,2186,3797,64213,28773,3.55387e+13,1036.66,12958,92986,534,594,89189,88807,86700,82145,67932
66322,947,2154,47283,19039,3.68385e+13,1007.86,8556.99,66322,569,473,63398,61198,56734,43680,41271
17597,911,1571,12303,5294,3.521e+13,431.236,4043.83,17597,308,398,16026,15548,15167,14478,11613
11079,579,979,7726,3353,3.43564e+13,297.368,2473.76,11079,235,200,10100,10065,8774,6333,6859
10923,463,1183,7560,3363,3.59581e+13,397.916,2880.86,10923,300,285,9613,8970,7985,6351,5498
68866,2303,3424,47780,21086,3.55621e+13,782.697,11390.8,68866,433,708,65442,65363,64917,64929,56569
98269,655,3844,69596,28673,3.65357e+13,1189.77,13642,98269,908,490,92061,88620,63136,45142,20527
38495,1195,2372,26331,12164,3.50874e+13,804.968,6897.07,38495,427,431,36102,35339,32775,26250,25078
4441,549,582,2993,1448,3.43284e+13,218.169,1328.92,4441,122,130,3859,3856,3858,3859,3835
63504,1356,2515,45332,18172,3.70715e+13,815.543,8865.18,63504,470,418,60989,60461,59541,56717,48298
89700,1059,3479,62478,27222,3.49176e+13,1111.99,12205.1,89700,592,521,85553,83778,60101,43627,40687
48545,1987,2896,33566,14979,3.57041e+13,835.847,8724.96,48545,533,492,45649,45388,44549,43307,36012
61234,1625,3144,42862,18372,3.67861e+13,959.382,10197.3,61234,595,579,58090,57404,54219,45244,39577
41382,1080,2296,28708,12674,3.48612e+13,736.306,7050.21,41382,449,403,38964,38412,36140,30937,29204
42588,493,2007,29843,12745,3.74526e+13,607.86,6585.3,42588,477,337,39459,36454,25355,19866,13796
28242,767,1780,19624,8618,3.47509e+13,402.756,5087.66,28242,310,374,26462,26158,24553,23486,16344
6326,283,865,4258,2068,3.48769e+13,221.945,1965.53,6326,198,175,5439,5032,3888,2965,2292
28191,873,996,19085,9106,3.53456e+13,407.38,3736.68,28191,275,270,27195,27195,27127,27120,26700
58197,2052,2579,40688,17509,3.67898e+13,866.036,8884.5,58197,573,547,55618,55577,55129,54161,52122
47594,72,2717,32818,14776,3.36197e+13,1060.71,8335.23,47594,403,600,36367,30142,20746,7095,3557
81778,1782,1987,56649,25129,3.20981e+13,1161.4,8606.54,81778,506,478,79791,79786,79598,79301,77877
3308,353,391,2275,1033,3.80018e+13,197.182,922.357,3308,114,111,2917,2917,2907,2896,2881
46172,910,1744,31567,14605,3.45049e+13,473.141,6034.04,46172,350,374,44428,44252,39604,32973,31044
83916,1953,2715,60295,23621,3.69414e+13,1210.82,11000.9,83916,647,515,81201,80853,78912,74054,68879
77957,2415,2478,54568,23389,3.66066e+13,1112,9686.7,77957,579,515,75479,75478,75467,75444,75170
37409,2076,2430,25894,11515,3.61437e+13,568.283,6796.53,37409,375,477,34979,34979,34828,34855,33352
2223,226,456,1619,604,4.04649e+13,67.5776,806.551,2223,128,68,1767,1728,1621,1535,903
68037,1942,2258,46561,21476,3.40787e+13,857.008,8798.4,68037,507,409,65779,65769,65107,63355,61886
98694,2455,3711,68499,30195,3.62492e+13,1352.56,12915.1,98694,631,576,94983,94347,92312,85491,83314
15508,310,1473,10816,4692,3.73133e+13,476.38,3820.33,15508,342,326,13358,12219,9241,7044,4750
8502,265,873,6041,2461,3.49374e+13,267.102,2136.13,8502,229,172,7480,6539,6261,5644,4174
80348,952,2251,55943,24405,3.27314e+13,1076.88,8977.91,80348,520,495,77438,75390,69867,55564,47650
70724,1804,2411,50606,20118,3.71463e+13,896.08,8907.69,70724,501,412,68313,68262,68014,67918,63884
43631,288,2440,29760,13871,3.54927e+13,618.684,7318.45,43631,367,479,38332,34528,21755,13373,10135
9241,208,905,6340,2901,3.53906e+13,237.303,2201.89,9241,250,176,7943,6860,4981,4008,2905
85579,2605,3261,58775,26804,3.40574e+13,950.607,11594.8,85579,621,551,82318,82284,79996,74667,74394
5689,140,622,3898,1791,3.4861e+13,329.779,1543.78,5689,182,173,4348,3744,3163,2239,1456
16453,459,1550,11942,4511,3.55799e+13,397.986,3886.45,16453,308,230,14795,14183,12401,7435,5954
19549,189,1818,14127,5422,3.64339e+13,548.742,4697.27,19549,340,332,16351,14570,12004,8384,3343
78852,3190,3315,54460,24392,3.53309e+13,958.002,11418.3,78852,672,596,75537,75536,75522,75524,75222
64598,989,3211,44410,20188,3.50309e+13,806.783,9876.5,64598,415,533,61070,60015,49693,30753,24394
40841,31,1887,27899,12942,3.52568e+13,676.246,6770.26,40841,409,419,26416,20405,16051,6677,3454
15345,197,1326,11268,4077,3.69595e+13,409.207,3520.8,15345,268,254,12846,11346,10560,9444,3355
17145,541,1314,12180,4965,3.72758e+13,568.511,3672.94,17145,305,277,15629,14960,13368,10120,8930
33582,1296,2465,24000,9582,3.68553e+13,658.531,6943.76,33582,387,396,31117,30799,29985,29194,20353
27386,716,1919,19404,7982,3.66111e+13,619.77,5389.48,27386,413,321,25283,24631,22096,15292,13271
23859,1787,1901,16267,7592,3.54166e+13,491.895,5231.67,23859,286,357,21958,21957,21928,21934,21648
68155,2666,3233,46575,21580,3.40953e+13,817.338,10545.9,68155,635,538,64922,64909,63823,62362,59134
53355,1941,2243,38115,15240,3.6599e+13,753.549,7863.32,53355,473,448,51112,51111,51028,51040,49930
90673,806,3204,61925,28748,3.36044e+13,860.637,11880.2,90673,537,637,86800,84142,60151,43253,30843
18591,606,1091,12958,5633,3.56375e+13,566.929,3461.07,18591,298,270,17240,16146,16355,15373,12479
45902,169,2336,31677,14225,3.54863e+13,886.912,7427.62,45902,482,510,38218,32962,23824,7816,7478
83199,222,3215,58559,24640,3.62168e+13,961.715,11238.5,83199,573,482,72110,63714,45297,15202,11361
23894,1481,1851,16832,7062,3.66436e+13,538.469,5138.71,23894,306,376,22043,21990,21908,21817,19688
99292,1936,1962,68279,31013,3.18899e+13,1186.34,9142.27,99292,501,461,97330,97330,97327,97327,97313
69432,321,3273,47859,21573,3.56198e+13,991.197,10748.2,69432,511,632,62710,58766,40056,20265,12736
49049,209,1676,35328,13721,3.75299e+13,1035.06,6678.2,49049,462,389,42853,37403,30619,21339,11133
36973,2128,2281,25113,11860,3.1888e+13,484.94,6744.04,36973,431,382,34692,34692,34649,34676,33881
96698,181,2104,69527,27171,3.78646e+13,1069.94,9535.49,96698,562,468,81683,72216,55213,18707,17154
48813,1645,2478,34393,14420,3.69273e+13,726.214,8108.02,48813,397,503,46335,46212,45809,44923,35522
46292,779,2308,32655,13637,3.58372e+13,698.109,7530.76,46292,458,451,43756,41999,39246,30860,19802
88140,618,2827,61112,27028,3.43189e+13,1125.56,10861.2,88140,513,570,82706,79671,54543,38168,30847
43971,1115,2105,29351,14620,3.39028e+13,810.842,6997.12,43971,430,457,41866,41241,35591,29553,31193
69893,212,2275,50198,19695,3.65398e+13,908.002,8507.91,69893,501,478,60937,53867,39946,15456,10106
37364,833,2365,25430,11934,3.48495e+13,804.26,6898.11,37364,438,443,34740,33985,27613,21140,16827
35239,1276,1393,24104,11135,3.5561e+13,421.916,4335.63,35239,284,277,33846,33846,33798,33805,33533
33051,489,1995,22948,10103,3.38095e+13,506.549,5774.16,33051,401,416,30757,29835,26168,20340,13747
18551,376,1533,13275,5276,3.53623e+13,426.335,4160.82,18551,352,219,16708,15399,12541,9061,6837
75797,53,2693,52611,23186,3.59257e+13,1070.41,9715.28,75797,510,506,55135,46420,32364,11130,6093
6233,540,942,4227,2006,3.56826e+13,252.811,2042.24,6233,202,206,5291,5142,4822,4048,4016
46205,39,2414,32516,13689,3.64276e+13,762.127,7804.02,46205,525,476,31597,25332,20019,8160,4043
18179,255,1331,12556,5623,3.45749e+13,366.246,3736.08,18179,267,227,15734,14055,11045,7885,4501
95213,2536,2843,66115,29098,3.2452e+13,1096.43,11269.6,95213,651,450,92370,92370,92004,91452,89562
89144,125,3304,62138,27006,3.66595e+13,1087.9,11555.5,89144,709,595,71422,62539,45400,14501,9229
19719,950,1622,13745,5974,3.57979e+13,538.563,4124.49,19719,337,304,18097,17873,16476,15400,12357
58022,90,2058,38883,19139,3.40718e+13,981.557,7852.4,58022,456,535,46523,41872,24587,8142,7073
22534,676,1539,15507,7027,3.19603e+13,405.841,4246.43,22534,288,276,20995,20493,19704,19128,13994
91300,2894,3728,63825,27475,3.60307e+13,1129.68,12587.7,91300,711,534,87572,87474,86018,84034,78602
40917,782,1967,29380,11537,3.71637e+13,701.036,6498.93,40917,515,342,38803,37904,34432,26935,25862
69532,555,3294,47785,21747,3.33455e+13,805.269,10345.4,69532,621,481,65229,63144,43960,34965,22593
81874,2088,3408,57955,23919,3.71403e+13,1140.25,11895.7,81874,680,608,78466,77875,75312,68955,64590
66295,963,2535,46205,20090,3.54198e+13,1000.96,8956.74,66295,623,509,63312,62374,50584,39968,39784
79456,1504,2654,54917,24539,3.18552e+13,1065.58,10010.6,79456,459,544,76802,76173,73625,68440,50617
89844,1126,2272,62289,27555,3.45932e+13,891.757,9483.13,89844,603,446,87513,86670,81356,65577,65528
70431,1212,3430,50500,19931,3.74756e+13,975.337,11361.9,70431,620,649,66777,65292,61281,53224,36753
58731,540,3079,40877,17854,3.39774e+13,985.712,9406.36,58731,583,484,54011,51650,31034,11432,7492
7598,548,908,5285,2313,3.62312e+13,237.424,2133.08,7598,218,211,6690,6683,6621,6608,5619
5124,429,725,3421,1703,3.43439e+13,216.595,1588.5,5124,163,205,4399,4350,4193,4169,3122
52369,2356,2917,35953,16416,3.51413e+13,650.868,8572.32,52369,468,425,49452,49440,48897,48653,45170
57801,1576,2544,40896,16905,3.53774e+13,908.271,8565.07,57801,531,460,55257,54984,53461,50747,42972
37073,1739,1852,26147,10926,3.58699e+13,611.252,5881.83,37073,417,306,35221,35205,35153,35113,34542
1044,177,270,715,329,4.17925e+13,50.3927,443.634,1044,50,64,774,759,760,759,629
50340,1727,2631,34806,15534,3.47931e+13,766.393,8220.03,50340,512,439,47709,47640,46590,43932,39648
66385,491,2295,46177,20208,3.35539e+13,1068.77,8543.89,66385,494,475,61718,58844,42568,30770,20522
3340,90,226,2248,1092,2.19098e+13,95.3189,703.762,3340,85,78,2954,2302,2460,2166,1479
76112,2385,2737,53889,22223,3.72697e+13,1130.96,10502.6,76112,596,559,73375,73340,73216,73139,70446
90746,1651,4047,63337,27409,3.4937e+13,991.444,13165.1,90746,609,680,86699,85607,80963,74100,54952
59218,128,2510,40341,18877,3.25615e+13,789.117,8370.14,59218,505,450,49996,44981,27794,7495,7197
73945,784,2578,51852,22093,3.59246e+13,890.932,9207.5,73945,535,481,70769,69240,54784,40843,36962
97738,1155,2885,69656,28082,3.66071e+13,1488.15,11260.6,97738,664,545,93915,90833,81527,57181,58613
18210,572,1198,12579,5631,3.41512e+13,566.471,3533.85,18210,295,323,16778,16216,15585,13602,10328
70369,1580,2270,49487,20882,3.60167e+13,946.747,8449.34,70369,559,465,68099,68016,65026,58021,60165
89586,774,3447,61926,27660,3.52728e+13,1012.71,11801.7,89586,621,505,85089,82766,55690,40532,28240
98403,43,3284,68619,29784,3.59678e+13,896.946,11879,98403,723,515,68937,55933,40222,15545,7982
40909,409,1707,28066,12843,3.49535e+13,840.047,6319.4,40909,415,478,37114,34533,23958,16673,12502
63577,1994,2873,44247,19330,3.43023e+13,813.099,9373.21,63577,556,431,60704,60586,58794,53116,52819
79728,2360,2892,55137,24591,3.55494e+13,919.381,10320.7,79728,507,536,76836,76770,76351,75863,72104
87413,2590,3503,62663,24750,3.72094e+13,987.53,12487.4,87413,545,597,83910,83879,83386,82965,73227
98259,3238,3323,68630,29629,3.60918e+13,1102.68,12300.5,98259,600,587,94936,94936,94901,94837,94801
65037,1986,2861,45611,19426,3.70151e+13,1053.95,9933.36,65037,668,501,62176,61711,58014,49154,52472
83179,3450,3509,56381,26798,3.43984e+13,862.542,11369.1,83179,631,640,79670,79670,79658,79642,79451
62555,1493,2837,42618,19937,3.42425e+13,856.074,9208.08,62555,672,556,59718,59099,55702,49234,43678
31207,966,1737,21955,9252,3.44836e+13,626.791,5508.69,31207,311,348,29372,28617,28633,27628,20449
63431,1865,2217,42863,20568,3.39269e+13,860.259,8236.11,63431,467,547,61214,61206,61019,60881,60024
99440,202,3293,68932,30508,3.60559e+13,1069.4,12369.5,99440,657,571,84787,75506,50653,18514,14774
1956,39,487,1388,568,3.46856e+13,85.43,835.346,1956,84,116,1304,1076,917,834,305
43948,1618,2117,30482,13466,3.62788e+13,700.088,6480.52,43948,432,381,41831,41766,41066,39259,38705
65693,1001,2573,46248,19445,3.63794e+13,1178.86,9333.22,65693,561,459,62517,61019,54694,39873,33779
35323,402,2603,24233,11090,3.52328e+13,495.285,7324.22,35323,361,642,32192,30370,24973,16380,9309
75097,583,2986,52226,22871,3.50854e+13,966.078,10591.1,75097,498,637,69810,66930,47120,28967,25051
85959,3533,3559,60788,25171,3.65931e+13,1002.93,12325.7,85959,656,588,82400,82400,82400,82400,82386
2677,6,567,1831,846,3.50175e+13,132.019,1043.87,2677,119,123,936,526,447,362,163
99529,1436,3920,69076,30453,3.37452e+13,1008.36,13258.4,99529,668,512,95580,94300,72448,50279,42867
79804,608,3625,55174,24630,3.58033e+13,1026.25,12250.3,79804,729,537,73697,70892,45567,28492,23233
77424,2314,3650,53338,24086,3.46374e+13,933.884,11535,77424,584,593,73774,73381,71055,63713,59383
46464,239,1911,33015,13449,3.72737e+13,878.358,6551.5,46464,436,359,39935,35988,27605,13482,12097
30167,659,1621,21159,9008,3.37318e+13,674.023,5081.15,30167,331,332,28198,27172,25201,19704,15762
98070,1920,4095,67894,30176,3.52412e+13,1176.15,13893.8,98070,655,628,93975,92908,81051,64979,58541
71747,366,3167,50693,21054,3.68311e+13,953.638,10532.9,71747,581,493,65575,60856,38602,24053,14748
37946,618,2003,26094,11852,3.57988e+13,783.13,6358.2,37946,439,401,35155,33394,26216,19134,18675
76007,1330,2755,52140,23867,3.4155e+13,965.933,9952.37,76007,613,475,73247,72403,62346,46050,47053
12855,648,797,8834,4021,2.57612e+13,223.335,2170.97,12855,177,154,12058,11955,12050,11911,10609
41549,870,2425,29007,12542,3.31646e+13,627.773,7074.54,41549,393,371,39002,38149,35061,25600,19013
63404,2154,3138,42819,20585,3.35739e+13,618.813,9766.4,63404,460,644,60266,60247,59733,59570,48645
38640,1732,2315,26973,11667,3.71553e+13,980.211,7267.27,38640,561,578,36325,35935,35570,33913,32255
30061,1184,1837,21423,8638,3.7982e+13,575.976,5504.3,30061,501,316,28224,28175,27419,24759,24859
57739,480,2691,40440,17299,3.70292e+13,725.639,8907.19,57739,469,503,53307,50322,38388,27573,15404
40504,1215,2477,28699,11805,3.71033e+13,699.049,7425.24,40504,366,465,38027,37481,36198,34019,27732
47491,1554,2207,33001,14490,3.6174e+13,883.438,7568.5,47491,469,479,45284,45032,44745,43844,38335
82531,679,3273,56538,25993,3.45167e+13,1018.75,12057.4,82531,656,571,77255,74115,53959,39000,29547
54145,2235,2818,37737,16408,3.64335e+13,868.764,9141.85,54145,666,641,51327,51064,49545,44880,45588
40932,926,1815,29602,11330,3.711e+13,877.636,6169.43,40932,413,447,38669,37301,36625,35338,27523
92633,739,2716,63346,29287,3.34733e+13,867.426,10042.5,92633,553,491,89346,87322,57093,45756,41722
86112,1402,2320,61344,24768,3.67007e+13,1031.49,9693.55,86112,648,473,83792,82994,80051,71995,65260
9533,238,829,6646,2887,3.05771e+13,162.21,2100.17,9533,191,147,8672,8179,5711,4415,2590
29020,846,2160,20630,8390,3.66483e+13,479.433,5873.91,29020,455,235,26860,26394,23463,17698,14092
59678,2105,2432,41299,18379,3.41355e+13,955.357,8159.74,59678,548,427,57246,57162,56648,55643,55618
48322,468,3180,33878,14444,3.59982e+13,708.826,9171.09,48322,596,653,43845,41472,32883,26243,8177
51928,2422,2504,36807,15121,3.66927e+13,801.339,8049.71,51928,616,374,49424,49424,49399,49399,49233
21710,548,1772,14988,6722,3.60545e+13,375.903,4760.91,21710,266,389,19902,19179,17329,13290,8131
34868,2160,2541,23819,11049,3.46654e+13,678.216,7034.67,34868,505,567,32327,32323,31805,30261,30195
7457,304,986,4956,2501,3.34845e+13,225.596,2171,7457,222,235,6453,6013,5652,4803,3312
25207,919,1741,17288,7919,3.49533e+13,535.371,4848.48,25207,298,309,23466,22965,22858,22277,18632
83462,1652,3527,57736,25726,3.54377e+13,1014.49,11846.6,83462,688,482,79935,79139,65385,49782,48532
10626,804,903,7631,2995,3.78469e+13,310.268,2381.94,10626,197,206,9723,9723,9713,9650,9240
41069,1753,2060,29262,11807,3.51649e+13,740.661,6671.84,41069,412,400,39009,38962,38871,38773,37105
21096,679,1497,14775,6321,3.57965e+13,383.266,4056.9,21096,316,272,19599,19351,17068,12760,12042
68235,2432,2872,48104,20131,3.56223e+13,1147.58,9838.27,68235,550,582,65363,65153,65038,64459,62284
72249,1988,3052,50380,21869,3.65987e+13,1168.48,10764.1,72249,586,602,69197,68709,66673,60706,56891
37948,684,2218,25849,12099,3.52094e+13,813.536,7011.65,37948,399,583,34979,33336,28128,22876,17881
98478,1699,2665,69746,28732,3.51205e+13,1022.45,10962.8,98478,590,542,95813,95350,92316,84755,75434
41648,1189,1627,29739,11909,3.85573e+13,667.087,5766.81,41648,420,414,40021,39907,38638,36353,35807
90936,726,2553,63653,27283,3.31564e+13,981.662,10172.7,90936,572,531,86487,83403,71063,53597,46010
12890,188,923,8662,4228,3.44429e+13,411.269,2633.89,12890,229,247,10885,9690,6400,3765,3734
94197,2900,3383,64892,29305,3.34673e+13,1057.08,11678.7,94197,665,506,90814,90814,89988,88537,87924
33401,208,2172,22756,10645,3.46023e+13,741.863,6480.09,33401,415,493,28843,26115,15972,7059,4972
71252,607,2260,50110,21142,3.6508e+13,1067.18,8937.96,71252,598,469,66906,63745,47067,33590,28557
3827,322,616,2633,1194,3.13408e+13,136.954,1276.45,3827,159,109,3211,3130,2971,2323,2078
80118,2914,3001,57769,22349,3.68234e+13,1181.42,11049.5,80118,681,521,77117,77115,77089,77069,76435
55688,444,1641,39427,16261,3.40877e+13,900.201,6669.84,55688,450,362,51552,49148,43815,32079,19565
50310,1868,2272,35155,15155,3.62498e+13,865.093,7591.57,50310,483,400,48038,47850,47474,46972,45819
13884,475,1154,9559,4325,3.40451e+13,490.322,3076.61,13884,257,272,12443,11869,11168,9918,6695
40708,689,2248,29280,11428,3.72225e+13,546.471,7304,40708,404,469,38207,37188,33807,27119,14712
58388,1236,2622,40011,18377,3.53318e+13,720.72,8664.8,58388,424,446,55766,55392,50886,42682,36302
32449,1403,1884,22541,9908,3.36899e+13,611.072,5753.31,32449,384,353,30565,30285,30229,29772,25599
77689,1336,2635,55509,22180,3.71594e+13,1004.78,10003.3,77689,691,527,74996,73741,68840,57782,49509
21594,1354,1904,15518,6076,3.68365e+13,420.176,4961.46,21594,351,272,19690,19566,19474,19331,16195
40616,1190,1660,28472,12144,3.59825e+13,833.777,5714.91,40616,405,395,38956,38262,37740,36703,35190
11603,959,1202,8198,3405,3.61416e+13,300.759,2919.16,11603,289,215,10401,10398,10061,9146,9256
53121,2379,2645,36597,16524,3.58555e+13,750.776,8538.17,53121,421,476,50476,50473,50404,50357,48962
45915,1456,1996,31532,14383,3.43371e+13,651.057,6908.41,45915,459,324,43919,43854,41802,37421,36691
81499,2720,3582,58619,22880,3.77309e+13,1002.96,12697,81499,648,709,77917,77910,77398,77324,70523
1847,164,259,1373,474,2.39253e+13,83.5333,593.603,1847,97,59,1588,1582,1417,1447,1090
44441,2175,2384,31543,12898,3.66694e+13,730.967,7665.75,44441,592,360,42057,42055,41817,41352,40840
98496,2125,4099,68620,29876,3.57315e+13,1185.78,14365,98496,703,787,94397,93576,87780,75138,63329
25066,742,1584,17795,7271,3.71212e+13,535.537,4685.05,25066,401,322,23482,22882,20985,17036,16100
35284,1680,1904,24429,10855,3.5303e+13,510.554,5951.59,35284,392,318,33380,33331,33275,33213,32290
47729,524,2492,33805,13924,3.71784e+13,852.678,7920.27,47729,605,510,43653,40807,32223,22087,18173
61406,150,3334,41519,19887,3.3626e+13,862.9,10207.4,61406,438,628,51475,45555,28991,11253,6732
7693,585,897,5158,2535,3.37026e+13,220.239,2101.69,7693,234,166,6796,6775,6107,5066,4931
35719,776,1917,24226,11493,3.4424e+13,802.035,5990.81,35719,415,336,33315,32515,29634,20456,19446
68135,60,2490,46948,21187,3.32045e+13,1105.03,9173.35,68135,530,578,50517,40057,30000,10249,3776
83632,688,3086,58840,24792,3.55603e+13,997.782,10883,83632,507,570,79063,76934,64221,45413,33058
70067,2159,3107,47264,22803,3.34765e+13,775.115,10331.1,70067,485,505,66960,66787,65042,59568,55222
75409,1760,2822,54138,21271,3.74274e+13,996.519,10114.8,75409,673,462,72587,72151,70018,65598,61438
36256,1908,2226,25040,11216,3.6182e+13,781.506,6683.41,36256,451,467,34030,33886,33696,33387,32480
88267,836,3928,59662,28605,3.38741e+13,1115.94,12732.6,88267,605,690,83015,80882,47956,36808,32182
42744,2077,2248,29537,13207,3.55179e+13,910.234,7277.07,42744,467,524,40496,40496,40436,40393,39635
28328,540,1677,19563,8765,3.51699e+13,453.065,5156.78,28328,366,306,26455,25294,21783,17361,14297
28063,1467,2019,19498,8565,3.56988e+13,520.055,5734.28,28063,323,368,26044,25969,25734,25616,22130
94043,1691,4450,64191,29852,3.41548e+13,894.271,14515.7,94043,877,636,89593,88831,71722,59539,50450
91522,1372,3691,63528,27994,3.49836e+13,1015.88,12268.8,91522,565,638,87831,86340,79670,62338,57886
62813,787,2511,44976,17837,3.69116e+13,959.723,8694.75,62813,646,370,59434,57101,49855,31696,31712
2685,94,465,2054,631,3.71649e+13,95.0778,870.285,2685,141,89,2174,1962,1911,1847,719
85403,387,3695,60725,24678,3.66645e+13,1077.9,12758.6,85403,613,701,77639,72853,54718,35944,13223
27480,139,2004,18805,8675,3.44229e+13,461.121,5665.56,27480,458,351,23416,21569,13543,6693,4442
23209,849,1708,16440,6769,3.721e+13,454.241,4664.87,23209,361,321,21501,21237,20879,19532,16177
35805,560,1530,25623,10182,3.70199e+13,772.17,5303.1,35805,368,299,33441,32421,28347,23950,16578
97583,378,3531,68895,28688,3.53069e+13,1311.8,13102.7,97583,826,741,89725,84578,57665,29327,17747
22081,218,1642,15704,6377,3.59423e+13,516.763,4546.74,22081,368,275,18939,16670,13960,10579,5708
48145,976,1739,32945,15200,3.54625e+13,804.782,5968.61,48145,406,342,46306,45467,42597,35723,34317
67440,1080,2760,47056,20384,3.55234e+13,1033.83,9241.33,67440,543,519,64108,62879,58259,43940,40944
70811,3053,3131,48987,21824,3.49069e+13,946.397,10300.4,70811,622,470,67680,67680,67649,67644,67068
22894,248,1237,15239,7655,3.36547e+13,588.057,3921.55,22894,261,328,20193,18467,11500,7159,7823
3138,508,578,2213,925,3.4539e+13,222.007,1130.5,3138,156,134,2560,2560,2484,2498,2426
44015,1650,2378,31061,12954,3.673e+13,746.429,7680.26,44015,504,489,41637,41456,40480,40231,32586
90455,2142,3628,62964,27491,3.53199e+13,1245.79,12717.9,90455,662,729,86827,85913,83267,76866,66513
96633,760,2755,67164,29469,3.51892e+13,865.441,11242.3,96633,520,709,92843,88679,79693,57118,30501
90845,707,3215,63967,26878,3.69554e+13,1044.74,11355.2,90845,658,630,85760,81550,60864,43824,31401
32227,1061,2026,23335,8892,3.51329e+13,777.931,6018.7,32227,498,395,30179,29323,28687,25898,22429
9397,115,851,6298,3099,2.51017e+13,112.619,1970.07,9397,215,150,8410,7593,4570,1258,1059
85764,1296,3849,59921,25843,3.56435e+13,1031.37,12615.3,85764,697,660,81797,80121,71933,50900,40286
55533,1000,2184,40264,15269,3.69693e+13,937.103,8029.57,55533,561,437,52944,51166,48672,41426,29819
42766,1662,2644,28893,13873,3.48185e+13,698.576,7626.11,42766,510,458,40122,39944,38379,35177,32323
47612,79,2159,33564,14048,3.60253e+13,805.219,7593.65,47612,439,395,35892,30918,22967,10010,5200
11342,352,1291,8112,3230,3.72317e+13,276.659,2955.81,11342,281,196,10001,9318,7774,5673,5125
61029,1467,2725,42257,18772,3.6127e+13,722.101,9155.16,61029,442,494,58304,58172,55048,52175,36876
47416,2168,2534,33276,14140,3.55419e+13,776.921,7930.24,47416,566,541,44882,44751,44447,43513,42286
73874,923,2574,52553,21321,3.67429e+13,899.465,9640.07,73874,617,462,70974,69678,60350,39194,31786
85158,2906,3893,59326,25832,3.55344e+13,952.652,13088,85158,540,636,81265,81123,80733,80609,72611
1228,91,358,850,378,3.74844e+13,55.307,577.816,1228,77,76,863,763,726,664,320
42103,1215,1446,29676,12427,3.38949e+13,848.744,5570.23,42103,400,333,40657,40584,40331,39939,39193
53940,453,2107,36715,17225,3.23346e+13,667.302,7825.67,53940,483,431,50328,48443,34195,23803,15799
34472,1892,2428,23872,10600,3.5124e+13,606.661,6935.99,34472,486,415,32044,32028,31323,30607,27940
56452,475,2413,39574,16878,3.4587e+13,891.404,8102.25,56452,488,372,52411,49943,39004,25857,19634
20110,1072,1700,13771,6339,3.39813e+13,445.518,4517.47,20110,305,278,18410,18080,17855,17347,14729
5196,724,791,3844,1352,3.27784e+13,214.206,1590.14,5196,239,145,4405,4405,4393,4400,4252
61392,1283,2335,43822,17570,3.7895e+13,847.362,8106.37,61392,548,412,59057,58710,56283,50390,50660
14060,737,1507,10109,3951,3.7821e+13,340.833,3563.2,14060,232,248,12553,12371,11919,11846,7938
97803,1611,3083,69557,28246,3.66825e+13,1086.18,11697.7,97803,576,565,94720,93982,88424,76601,71343
29765,1200,1957,21216,8549,3.69315e+13,582.553,5565.49,29765,499,275,27808,27589,26517,22752,22893
62102,432,2965,44069,18033,3.69444e+13,882.942,10015.1,62102,683,469,56993,54313,41619,28439,15339
83294,1858,3248,58226,25068,3.41637e+13,1028.27,11241.9,83294,753,417,80046,79629,74499,60272,61406
5611,544,767,3972,1639,3.58533e+13,252.272,1680.31,5611,205,167,4844,4806,4590,4343,4029
3642,482,671,2634,1008,3.92266e+13,151.975,1260.64,3642,135,119,2971,2946,2959,2939,2648
60992,2113,2135,42799,18193,3.70708e+13,726.578,7933.54,60992,477,388,58857,58857,58857,58857,58824
80110,210,3148,57292,22818,3.68412e+13,1013.91,10744.9,80110,661,547,68878,59758,44109,16550,12419
62392,500,2925,43981,18411,3.64718e+13,1031.25,9671.1,62392,635,402,57139,53877,37999,25261,18862
40523,1050,2551,28521,12002,3.60681e+13,676.765,7465.78,40523,568,389,37972,37142,33178,27074,24857
75844,974,2462,52294,23550,3.56837e+13,859.983,8237.36,75844,478,380,73162,72164,56110,42040,48884
38904,1197,2436,27658,11246,3.61305e+13,639.112,7151.66,38904,579,402,36468,36004,34130,28256,25214
83722,2291,2741,58710,25012,3.61357e+13,1208.26,10085.6,83722,629,459,80981,80838,80113,79298,77655
17317,1240,1577,12018,5299,3.49923e+13,418.823,4085.6,17317,286,285,15740,15693,15653,15597,13987
1681,403,444,1131,550,3.72608e+13,77.392,737.462,1681,115,106,1237,1237,1236,1235,1188
76631,2305,2396,54112,22519,3.6137e+13,906.414,9411.62,76631,578,494,74235,74235,74203,74184,73893
1335,211,420,901,434,3.22758e+13,49.3491,656.564,1335,96,62,915,886,812,611,540
76449,903,3960,52571,23878,3.61224e+13,934.034,12396.6,76449,631,563,71773,70163,48544,37142,23747
42889,482,1663,31075,11814,3.66456e+13,668.998,6103.92,42889,513,318,39838,37922,34947,28705,21971
69402,2126,2425,48707,20695,3.52818e+13,1101.66,9151.88,69402,613,535,66977,66664,66647,66233,63023
1023,150,277,722,301,3.50858e+13,51.8436,459.505,1023,67,62,746,719,726,729,481
98554,987,4162,67352,31202,3.61308e+13,1358.98,14020.6,98554,632,763,92616,90357,56768,46272,36946
80207,2710,2745,56378,23829,3.67323e+13,1102.48,9861.94,80207,566,520,77462,77462,77450,77443,77332
7429,148,898,5006,2423,3.55331e+13,208.317,2108.39,7429,136,233,6093,5318,4175,3445,1599
32822,1528,1744,22737,10085,3.58682e+13,473.785,5206.84,32822,406,337,31078,31075,30814,30400,30173
34753,1426,2166,23603,11150,3.27937e+13,729.863,6228.73,34753,364,367,32587,31983,31401,29879,28182
68763,2388,3410,47628,21135,3.49051e+13,783.135,10964.8,68763,533,555,65353,65269,64919,64796,53551
61783,1642,2216,43288,18495,3.74882e+13,918.658,8260.32,61783,483,537,59567,59055,57643,54669,52567
72443,874,2900,50740,21703,3.5214e+13,834.67,10124.8,72443,659,440,69156,66982,51442,34446,26976
1111,272,308,774,337,3.7248e+13,60.5446,497.658,1111,75,65,803,803,797,792,763
3672,136,705,2641,1031,3.96718e+13,101.639,1301.75,3672,191,142,2944,2642,2064,1712,968
26219,37,1407,18594,7625,3.60513e+13,513.298,4537.22,26219,383,256,17544,14040,11088,3978,2760
64481,617,2921,44919,19562,3.54477e+13,999.238,10051.9,64481,628,463,59811,56801,44786,31392,23448
59904,1577,2258,42010,17894,3.47782e+13,797.512,8073.68,59904,538,342,57646,57613,55753,52065,43784
1732,23,184,1152,580,2.9739e+13,81.4134,476.45,1732,79,63,940,526,443,286,272
54683,1537,2778,37844,16839,3.60625e+13,798.519,8751.53,54683,662,474,51905,51647,47985,40037,38522
89060,2469,2823,62133,26927,3.32426e+13,900.032,10811.4,89060,579,520,86237,86231,86121,86229,83682
56227,992,2836,39049,17178,3.54189e+13,808.865,9453.53,56227,573,597,53058,52303,46198,35431,22314
45645,533,2046,31411,14234,3.364e+13,866.804,7008.51,45645,434,424,42484,40850,34236,26658,18135
92522,223,2918,64744,27778,3.6137e+13,988.991,10857.3,92522,691,529,81098,70429,50910,21634,18325
83143,1355,2709,60153,22990,3.65617e+13,766.161,10498.5,83143,608,584,80434,80324,76496,72059,33272
27955,191,1937,19857,8098,3.64557e+13,595.889,5478.45,27955,388,296,23711,20822,15325,8193,5956
21621,1153,1569,14991,6630,3.27154e+13,392.738,4361.29,21621,310,280,20052,19962,19555,18753,17319
5369,205,896,3919,1450,3.79146e+13,158.316,1770.1,5369,236,177,4410,4040,3424,2859,1285
84860,37207,84860,0,84860,15.9998,0,84860,84860,84860,1,0,0,0,0,0
69473,1220,3319,47276,22197,3.48992e+13,1094.58,10691.9,69473,620,649,65738,64273,53956,44242,38456
50789,1448,2268,35674,15115,3.57924e+13,830,7693.8,50789,399,517,48521,48246,47013,44106,41450
55694,122,2618,39076,16618,3.65908e+13,884.664,8404.99,55694,505,461,44392,38852,28235,9366,7812
19828,1612,1793,13987,5841,3.61416e+13,388.728,4559.68,19828,330,258,18035,18024,17995,18007,17463
95609,324,2876,66510,29099,3.30989e+13,1161.28,10649.8,95609,683,505,87554,81039,54859,25499,16582
90297,1474,3775,62332,27965,3.52884e+13,1130.43,12651.3,90297,607,689,86522,85262,76342,59457,44790
37197,1304,1715,25479,11718,3.55487e+13,432.28,5192.89,37197,402,348,35482,35375,34370,34645,30521
50802,601,2174,34990,15812,3.6503e+13,511.842,6941.78,50802,393,451,48519,47926,35956,28296,20350
65715,573,3445,45197,20518,3.33375e+13,943.408,10896.1,65715,625,597,60634,57896,39715,25258,16448
95167,163,2477,65973,29194,3.61863e+13,1223.28,10690,95167,642,532,80764,70910,50560,16047,11246
60172,819,2134,42332,17840,3.71746e+13,902.181,7699.99,60172,544,401,57608,55974,49660,39598,39031
77490,1189,2514,52923,24567,3.41994e+13,950.174,9435.55,77490,594,477,74934,73876,65750,49206,50989
43592,162,2006,30644,12948,3.53212e+13,858.057,6803.81,43592,495,444,36742,32069,22615,10987,5641
50374,1979,2224,34799,15575,3.10423e+13,911.175,7428.87,50374,405,488,48150,48150,48009,47959,46026
8868,442,849,6170,2698,3.605e+13,276.903,2102.52,8868,214,163,8019,7833,7720,7349,6529
31514,166,1723,22575,8939,3.62601e+13,606.512,5340.71,31514,429,375,26334,22508,18173,10535,7086
80518,553,3206,57177,23341,3.68528e+13,816.06,11477.5,80518,497,668,75006,71226,55488,37193,19984
82184,1798,3414,57045,25139,3.53365e+13,1214.84,11759.4,82184,585,569,78770,77604,76089,69313,59414
23166,113,1584,16045,7121,3.42556e+13,369.163,4540.13,23166,312,354,18967,16328,11422,4800,4216
39582,2195,2225,27269,12313,3.54439e+13,790.253,7012.07,39582,439,478,37357,37354,37355,37351,37283
72141,914,3732,50336,21805,3.59657e+13,911.018,11762.4,72141,652,590,68109,66060,53956,41869,29854
7245,370,693,4900,2345,3.47955e+13,271.162,1767,7245,165,159,6548,6205,5745,4780,4924
23349,1301,1411,16165,7184,3.26851e+13,528.347,4147.93,23349,314,303,21938,21883,21903,21892,21431
16612,872,1357,11926,4686,3.85614e+13,569.794,3655.31,16612,345,310,15248,14680,14185,13207,12376
97689,936,3388,66234,31455,3.20982e+13,1046.08,12416.9,97689,575,552,93496,91186,67204,54230,43387
59037,1123,2507,41449,17588,3.53433e+13,808.221,8437.98,59037,632,386,56530,55787,48545,37156,30958
56299,862,2351,38943,17356,3.61528e+13,505.838,7313.64,56299,477,337,53912,53038,39690,27105,20218
74393,2806,3130,51158,23235,3.54196e+13,937.116,10281.4,74393,494,467,71263,71225,71121,71153,69630
37002,1967,2107,26420,10582,3.67215e+13,950.967,6786.02,37002,546,528,34895,34611,34776,34609,34028
54969,378,2192,38362,16607,3.54563e+13,758.409,7870.77,54969,556,365,50553,47344,33133,21561,14272
87930,2647,3119,60705,27225,3.40732e+13,1121.08,11420.8,87930,597,593,84811,84686,84371,83813,80377
8638,566,1069,6183,2455,3.32746e+13,292.454,2342.8,8638,193,161,7569,7299,7181,6840,5276
11928,733,1094,8546,3382,3.7064e+13,307.201,2738.41,11928,286,232,10834,10770,10376,10194,9391
89262,871,2979,63306,25956,3.67246e+13,1153.4,11456.6,89262,596,552,85126,82642,69939,52288,40360
11149,3514,11149,0,11149,15.9986,0,11149,11149,11149,1,0,0,0,0,0
48588,37133,48588,0,48588,15.9997,0,48588,48588,48588,1,0,0,0,0,0
76428,1977,2102,55169,21259,3.66915e+13,1046.18,8586.45,76428,563,423,74326,74326,74262,74259,73842
60477,1253,3338,41946,18531,3.64473e+13,917.893,9991.3,60477,670,512,57139,55851,47212,36622,35583
98257,952,3550,68214,30043,3.52493e+13,1336.44,12744,98257,696,732,93163,90697,69088,58209,47812
85204,1121,3327,59389,25815,3.47769e+13,1001.98,11565.8,85204,624,546,81480,79917,58049,41824,34329
80631,2097,3732,55505,25126,3.44649e+13,1103.59,11917.2,80631,550,682,76899,76153,73914,69662,61326
67355,948,2584,46553,20802,3.40603e+13,822.133,9366,67355,476,507,64487,63048,56613,42935,32411
49574,857,2184,35424,14150,3.68091e+13,841.285,7518.02,49574,466,392,46898,45616,42923,39768,25006
65431,1233,2633,46693,18738,3.69857e+13,1094.7,8927.3,65431,605,458,62555,61258,56337,44556,39340
50520,587,2142,35314,15206,3.49425e+13,909.17,7643.73,50520,579,396,46714,43999,35907,27037,21938
92777,399,3550,64330,28447,3.54491e+13,1261.29,12295.4,92777,690,742,84834,78907,51538,23121,18936
93980,1559,3135,65341,28639,3.22813e+13,1019.14,11481.1,93980,642,492,90845,89799,85353,69061,67078
30669,1332,2013,20598,10071,3.06195e+13,514.373,5710.17,30669,416,366,28656,28520,27550,26268,20990
52934,158,2081,36124,16810,3.31251e+13,886.376,7168.83,52934,415,425,46033,41378,27697,9228,7806
26839,328,1510,19138,7701,3.66539e+13,544.831,4623.9,26839,386,300,24574,22630,18527,13172,9577
13858,654,1207,10028,3830,3.53169e+13,310.684,3156.07,13858,316,167,12651,12491,11567,8834,8866
63639,127,2620,43916,19723,3.36874e+13,873.578,8597.87,63639,505,445,53500,47052,33674,13500,10265
7242,59,704,4968,2274,3.50717e+13,287.378,1803.93,7242,187,173,5095,4192,2935,1083,785
47097,864,1953,32912,14185,3.22256e+13,680.906,6849.21,47097,489,380,45144,44047,41267,31798,30241
23417,507,1687,16247,7170,3.51619e+13,642.13,4756.73,23417,398,354,21357,20310,18098,13687,8980
51094,1886,2034,35324,15770,3.37461e+13,850.887,7020.57,51094,365,428,49060,49059,49029,48964,47802
97364,2708,3141,68794,28570,3.59467e+13,1221.95,12249.8,97364,671,564,94223,94211,93771,93557,90574
73806,663,2481,51154,22652,3.44028e+13,972.633,9602.42,73806,596,491,69605,66935,58613,42524,31331
70730,1944,2353,48899,21831,3.52916e+13,904.939,8853.09,70730,542,436,68377,68307,67519,66694,64791
67116,2969,3401,46866,20250,3.65102e+13,801.537,10939.7,67116,460,648,63715,63715,63537,63641,61886
83570,2405,2710,59616,23954,3.70339e+13,880.476,10346.6,83570,650,471,80860,80832,80686,80069,78627
33348,120,1856,23638,9710,3.65708e+13,612.037,5479.88,33348,414,364,26446,22595,17113,6074,5780
66005,2090,2409,45206,20799,3.18027e+13,1110.14,8971.96,66005,506,551,63596,63410,63367,63167,60665
94498,1042,2405,67526,26972,3.71301e+13,1049.79,9859.79,94498,622,542,91468,88661,82897,72275,50026
88884,3028,3175,63793,25091,3.6503e+13,1185.21,12054.3,88884,633,624,85709,85706,85648,85705,85060
16247,870,1070,11577,4670,3.87677e+13,562.569,3185.74,16247,329,257,15177,15171,14927,14747,14463
66602,1050,2513,46337,20265,3.42948e+13,902.66,8948.25,66602,518,508,63878,62373,59394,51946,29070
87290,2065,3469,61083,26207,3.49301e+13,976.525,12019.7,87290,695,597,83821,83225,78518,65155,63389
38327,1396,1898,27172,11155,3.63277e+13,685.317,6000.72,38327,354,368,36429,36341,35740,35114,29472
97210,1364,3711,67859,29351,3.59853e+13,1075.29,12952.6,97210,732,535,93450,92246,75441,51079,45989
46868,1994,2104,33631,13237,3.68623e+13,875.053,7421.17,46868,481,375,44764,44761,44736,44730,43981
66806,1723,3005,46565,20241,3.66301e+13,781.973,9754.32,66806,510,511,63801,63670,60963,56042,47287
85399,2537,2950,60568,24831,3.48357e+13,1092.12,11004.3,85399,714,531,82449,82396,82028,81538,79214
39320,906,2635,27193,12127,3.39312e+13,501.668,7382.61,39320,600,313,36685,36132,27283,20419,14081
51540,1670,2252,36050,15490,3.41603e+13,848.808,7551.2,51540,475,410,49288,49093,48244,46075,45689
35794,38,2212,24745,11049,3.53119e+13,505.271,6338.26,35794,388,435,23781,18793,14850,6456,2752
37854,1052,2174,26742,11112,3.5595e+13,729.891,6662.14,37854,382,390,35680,34696,33577,30906,24406
61214,1842,2882,42703,18511,3.54751e+13,971.384,9410.64,61214,641,423,58332,57840,55732,49912,47211
46210,311,3120,32268,13942,3.56196e+13,783.703,8864.34,46210,518,577,40668,37462,27460,13712,10122
57361,719,1992,40271,17090,3.5586e+13,944.057,7676.36,57361,547,414,54298,52020,47438,35277,27164
33236,119,2041,22741,10495,3.34819e+13,582.111,6022.78,33236,436,373,27554,24041,16147,5465,4712
12687,302,891,8680,4007,3.53468e+13,277.669,2370.77,12687,198,194,11768,10397,9093,7492,7177
80593,160,3033,57211,23382,3.64333e+13,850.41,10616.6,80593,542,609,68377,62092,43108,13336,9468
63346,1382,2696,44619,18727,3.47673e+13,1064.33,9241.56,63346,537,444,60524,59770,54854,45639,37694
90846,551,2492,63663,27183,3.28999e+13,1276.15,10283.8,90846,569,572,84876,81528,60974,41941,30682
89822,2376,3150,62130,27692,3.57344e+13,1075.93,10514.7,89822,665,490,86672,86550,84924,80646,82026
15320,117,1433,10865,4455,3.8678e+13,486.709,3652.06,15320,338,316,12500,11145,8544,5766,2042
24715,1520,1936,17820,6895,3.91782e+13,512.883,5288.05,24715,306,373,22779,22746,22641,22236,19668
68498,1515,3140,46773,21725,3.40156e+13,839.252,10385.1,68498,634,628,65358,64917,57429,45209,41253
17199,1807,1836,12230,4969,3.50851e+13,300.629,4347.25,17199,219,378,15363,15363,15363,15363,15349
6880,285,871,4968,1912,3.69518e+13,297.417,1922.58,6880,249,186,5856,5235,5083,4505,2681
60364,395,2257,42095,18269,3.59842e+13,881.904,7732.35,60364,482,375,55872,52559,34254,22554,19270
97238,642,3749,66670,30568,3.42585e+13,979.563,12996.1,97238,549,535,91567,88200,55433,35025,32843
68273,693,2877,47327,20946,3.61329e+13,916.587,9714.47,68273,626,648,64621,63315,48906,39154,24716
1949,430,488,1314,635,3.53944e+13,105.366,827.205,1949,79,118,1461,1461,1461,1461,1409
25619,634,1729,17725,7894,3.54015e+13,530.322,5005.48,25619,391,290,23738,22840,19680,14062,11120
77132,1262,2754,55732,21400,3.70073e+13,1150.29,10410.3,77132,583,505,74145,72609,66859,56234,51681
96219,884,4752,65938,30281,3.57e+13,994.859,14867.4,96219,800,726,90632,88487,54577,39266,26568
24740,186,2175,17277,7463,3.60949e+13,453.99,5606.83,24740,405,516,20876,18425,14704,9784,5469
92717,2423,2910,63816,28901,3.33048e+13,1134.06,10948.9,92717,558,434,89807,89537,89045,86555,84237
30606,1819,1854,20993,9613,3.29523e+13,490.456,5542.39,30606,361,360,28752,28752,28752,28752,28699
87844,2341,2921,59938,27906,3.4133e+13,878.078,10390.7,87844,532,500,84923,84900,82492,76800,78602
70521,2357,2560,51130,19391,3.65296e+13,1118.51,9814.39,70521,638,468,67961,67839,67802,67788,67216
63149,1396,2542,43070,20079,3.48539e+13,759.269,8861.07,63149,442,485,60607,60004,57448,49001,44590
43036,109,2136,30652,12384,3.70961e+13,783.834,6952.12,43036,442,369,34137,29822,22848,6906,6062
33502,1799,2205,23660,9842,3.65977e+13,738.44,6244.24,33502,439,411,31297,31247,31116,30595,30321
97142,942,3815,67925,29217,3.46492e+13,1042.74,13462.2,97142,813,498,92359,89943,64326,48282,38564
10590,510,1013,7479,3111,3.65503e+13,442.36,2617.79,10590,235,236,9419,8734,8594,7733,6427
69437,782,2751,47817,21620,3.61285e+13,922.713,9107.14,69437,534,488,65960,64829,49079,37387,30343
43193,1429,2134,29739,13454,3.17038e+13,542.698,6851.56,43193,405,357,41059,40908,39482,37848,27129
24543,605,1450,16794,7749,3.29754e+13,416.339,4487.98,24543,314,287,23045,22439,21115,17176,15642
69344,2020,2941,47392,21952,3.59214e+13,715.896,9698.33,69344,461,568,66403,66338,65793,65119,57084
24796,118,892,17669,7127,3.6712e+13,536.429,3419.28,24796,299,248,19895,16741,14059,9089,5244
79917,1009,2897,56565,23352,3.57621e+13,1117.16,10810.5,79917,577,591,76073,74170,69647,60330,43367
43154,2393,2478,29714,13440,3.41983e+13,646.887,7664.93,43154,447,431,40676,40667,40653,40646,39818
16784,1051,1325,11755,5029,3.29658e+13,432.419,3438.04,16784,231,230,15459,15453,15420,15443,14699
89976,2492,3712,62934,27042,3.58203e+13,1331.09,12378.1,89976,855,590,86264,85570,80719,68446,71721
28399,1944,2033,19797,8602,3.60959e+13,503.609,5782.06,28399,498,312,26366,26366,26210,25994,26025
46551,1945,2826,32508,14043,3.55417e+13,697.158,8459.8,46551,375,551,43725,43641,43203,42714,34086
65838,2090,2224,44550,21288,3.53962e+13,1067.85,8633.67,65838,500,538,63614,63614,63448,63062,63239
1675,207,470,1156,519,3.31077e+13,59.0836,764.911,1675,114,75,1205,1167,1047,759,690
98269,3186,4148,68286,29983,3.54883e+13,1082.46,13915,98269,964,569,94121,94059,92676,87488,85447
12631,1033,1464,8853,3778,3.7776e+13,261.248,3433.81,12631,179,369,11167,11157,11028,10973,8771
35905,1867,2002,24997,10908,3.37685e+13,718.369,6215.9,35905,385,427,33903,33900,33888,33881,33427
42342,556,1925,29978,12364,3.7391e+13,752.941,6306.44,42342,498,331,39309,36665,29875,21656,20418
18592,1389,1975,13269,5323,3.58327e+13,446.04,4690.32,18592,405,285,16617,16526,16185,14237,14207
93476,584,3597,64774,28702,3.38545e+13,848.656,12712.3,93476,449,716,88368,85491,60754,37481,27129
70908,1652,3305,48497,22411,3.40601e+13,874.368,10498.3,70908,586,489,67603,67182,58005,43054,44902
84595,807,2892,59224,25371,3.58261e+13,1038.04,10672.7,84595,688,550,80650,78211,60035,43282,40512
51874,715,2563,36227,15647,3.60643e+13,731.201,8248.16,51874,428,507,48753,46891,40970,34555,22069
32213,1365,2116,22143,10070,3.40653e+13,519.144,6094.44,32213,360,358,30097,29982,29779,29535,23982
61600,2465,3204,42957,18643,3.49464e+13,816.42,9733.92,61600,603,689,58396,58319,56396,53130,48558
41889,2376,2518,28919,12970,3.63188e+13,612.847,7149.15,41889,463,391,39371,39371,39340,39346,38996
7094,410,844,4709,2385,3.37294e+13,237.489,1956.09,7094,127,202,6250,6025,5954,5900,3509
87778,1265,3512,59723,28055,3.4844e+13,1071.47,11983.7,87778,607,572,84158,82594,66570,50077,50881
65659,2774,2904,45908,19751,3.59568e+13,1051.62,9993.08,65659,591,578,62755,62755,62690,62730,62498
51348,619,2336,35958,15390,3.70556e+13,492.538,7016.92,51348,381,386,48880,48159,38201,30373,18014
66351,478,2434,47684,18667,3.70463e+13,1055.87,8743.61,66351,565,442,61617,58799,45349,28962,24120
24207,431,2010,17026,7181,3.50285e+13,467.363,5170.69,24207,422,330,21855,20800,14997,11678,7110
73794,2865,3089,51606,22188,3.52422e+13,990.145,10298,73794,552,643,70705,70701,70564,70598,68042
81527,51766,81527,0,81527,15.9998,0,81527,81527,81527,1,0,0,0,0,0
53156,2326,2722,36935,16221,3.48835e+13,594.84,8385.29,53156,453,410,50434,50434,50003,49585,48244
1157,37,368,805,352,3.56516e+13,62.4797,551.668,1157,70,76,715,577,498,487,84
48951,1439,2573,34102,14849,3.57512e+13,593.927,7747.23,48951,459,563,46378,46250,44632,42204,33288
81179,830,3171,57992,23187,3.68969e+13,919.561,11007.1,81179,779,497,77230,75238,58008,40248,28493
79467,2023,3078,56052,23415,3.59321e+13,939.063,10506.6,79467,628,512,76389,76015,72948,63868,63441
15155,508,1284,10757,4398,3.77675e+13,427.842,3432.43,15155,277,256,13679,12897,12650,11903,8855
21696,419,1653,15260,6436,3.58953e+13,350.406,4359.64,21696,343,286,19975,19305,14954,12070,8299
52763,196,2499,37317,15446,3.69044e+13,733.934,7935.18,52763,541,380,44998,38551,28469,11934,9397
7167,444,825,4896,2271,3.53417e+13,284.937,1997.34,7167,187,211,6291,6086,5639,4837,3994
5873,1115,1129,3947,1926,3.34633e+13,177.07,2140.68,5873,246,138,4744,4744,4742,4744,4733
44531,2327,2500,31504,13027,3.67944e+13,924.399,7718.31,44531,462,464,42031,42029,41956,41991,41240
44948,799,1909,31042,13906,3.53321e+13,972.474,6487.46,44948,415,428,42557,41543,36876,26535,25455
27843,1826,2160,19282,8561,3.51038e+13,673.821,5975.27,27843,437,485,25683,25632,25496,25166,24372
7398,401,930,4950,2448,3.17023e+13,302.912,2137.59,7398,195,172,6428,6045,4248,3721,3147
79931,1043,3197,55506,24425,3.38414e+13,937.826,11288.7,79931,648,464,76149,74695,61832,45203,37029
96397,1484,2760,68848,27549,3.64694e+13,1049.68,11320.9,96397,659,443,93637,92808,87453,71816,72949
94002,1127,3344,64647,29355,3.55515e+13,1247.42,11927.4,94002,730,550,89792,87492,63743,51637,51801
77489,1650,1727,54390,23099,3.37173e+13,1038.41,8006.2,77489,585,392,75762,75762,75703,75697,75261
60744,1818,2457,42716,18028,3.5231e+13,850.391,8694.55,60744,509,484,58287,58169,57166,55816,52385
36219,490,1942,24993,11226,3.25557e+13,797.148,6004.14,36219,335,403,33317,31742,28474,21225,12320
28894,1867,2073,19527,9367,3.42118e+13,551.751,5626.49,28894,430,336,26821,26810,26803,26810,26187
6669,380,889,4974,1695,3.59238e+13,196.503,1931.34,6669,176,186,5780,5629,5334,5323,2947
16779,717,1126,11588,5191,3.55261e+13,417.365,3324.8,16779,291,284,15653,15618,14910,14776,11659
36567,392,2163,25397,11170,3.32245e+13,648.361,6506.38,36567,416,368,33328,30880,20819,14689,7534
81934,602,2229,59310,22624,3.6641e+13,1079.01,9385.55,81934,608,456,76608,73604,58339,39324,34823
31508,824,1824,22510,8998,3.70875e+13,644.944,5446.78,31508,384,311,29553,28801,27467,24062,18912
57716,230,2796,39503,18213,3.36957e+13,769.159,9269.01,57716,423,520,50473,45824,31383,11154,9312
8340,620,1013,5877,2463,3.7399e+13,353.712,2327.46,8340,218,190,7327,7134,6719,6357,5005
48565,2129,2393,34067,14498,3.61811e+13,915.79,7912.29,48565,485,494,46172,46162,45978,45647,44407
84314,507,2664,60130,24184,3.67759e+13,1126.99,10952.4,84314,626,559,78407,74455,63964,44417,27482
90581,66,3423,62994,27587,3.54183e+13,1011.95,11969.4,90581,722,744,66628,55770,41209,13660,7452
86032,2325,3656,60915,25117,3.64261e+13,1103.28,12448.3,86032,818,610,82376,82066,77855,66184,68413
37358,774,2075,26057,11301,3.35008e+13,510.395,6344.17,37358,329,473,35251,34608,32812,30497,21788
40373,1575,2173,28141,12232,3.57085e+13,545.434,6255.88,40373,454,438,38200,38107,36647,34146,33345
24099,967,1866,16770,7329,3.63019e+13,506.857,5036.38,24099,352,303,22233,21843,20786,19385,15582
40013,1566,2088,27884,12129,3.6607e+13,614.566,6434.01,40013,352,437,37925,37905,37533,37146,33829
16125,1329,1485,11417,4708,3.60339e+13,469.861,3844.3,16125,430,269,14640,14639,14535,14564,14168
61902,360,2379,42953,18949,3.55535e+13,811.563,7883.37,61902,562,397,55971,52448,35641,20144,21551
84214,37,3085,58006,26208,3.65691e+13,1071.11,10374.9,84214,644,624,56865,45671,34866,13232,7866
70157,1946,2966,48340,21817,3.52493e+13,963.94,9693.47,70157,537,479,67191,66908,65486,59825,57109
6791,792,797,4588,2203,2.93258e+13,108.461,1802.58,6791,178,153,5994,5994,5994,5994,5980
69030,2304,2794,49428,19602,3.69488e+13,779.157,9763.45,69030,600,431,66236,66230,65790,65566,57909
79687,3279,3300,56456,23231,3.59317e+13,1071.71,11404.8,79687,689,439,76387,76387,76387,76376,76290
79430,672,3298,56025,23405,3.6157e+13,1047.11,11361.7,79430,708,514,74695,72293,48717,33793,19330
22296,82,1389,15154,7142,3.50839e+13,402.706,4119.65,22296,291,300,17109,15319,10592,3128,3561
88400,1618,3382,62330,26070,3.59699e+13,1193.63,12118.9,88400,658,567,85018,83615,79380,69360,60465
78224,2538,3830,55872,22352,3.62741e+13,1054.92,12657.8,78224,712,524,74394,74080,71756,65957,58836
84027,636,2730,59418,24609,3.62012e+13,1248.13,10916.7,84027,617,510,78801,76025,66390,44598,27989
66122,370,2745,46098,20024,3.47849e+13,1019.06,9239.32,66122,528,444,60109,55509,35386,19778,11897
46348,1472,1946,31562,14786,3.42719e+13,517.704,6591.08,46348,349,330,44402,44366,44244,44249,41447
89284,2630,3803,60566,28718,3.35471e+13,885.27,12876.1,89284,871,547,85481,85474,82519,75643,71006
35732,1446,1525,24644,11088,3.46478e+13,711.013,5240.64,35732,385,348,34207,34142,34194,34195,33523
64103,1060,1735,44054,20049,3.22944e+13,979.947,7523.46,64103,443,425,62129,60526,57693,45333,44870
54085,381,2545,38373,15712,3.57261e+13,860.545,8623.74,54085,473,449,49479,46749,36162,26416,14514
50828,1147,2688,35030,15798,3.42531e+13,737.873,8404.8,50828,471,461,48140,47492,45576,38722,33233
97422,1508,2696,67056,30366,3.20006e+13,1193.07,10639.6,97422,598,539,94716,93037,88685,72537,77998
14963,993,1195,10524,4439,3.66773e+13,552.179,3316.03,14963,309,273,13768,13503,13462,13030,13146
31899,448,2052,22558,9341,3.74837e+13,445.83,5857.05,31899,425,267,29538,28432,20861,14906,14337
37584,1370,2188,26642,10942,3.72446e+13,746.232,6602.05,37584,413,442,35396,35276,33876,32023,26645
85057,409,3059,58498,26559,3.21374e+13,862.873,11027.7,85057,498,582,79508,74249,46899,22336,15865
30156,1289,1903,20195,9961,3.38931e+13,775.991,5729.11,30156,408,502,28253,27971,27115,25880,23998
89690,1562,3608,62313,27377,3.56149e+13,1155.06,12012.2,89690,613,631,86082,84620,76583,60893,57230
36568,485,2047,26188,10380,3.73106e+13,616.386,6487,36568,476,445,33687,31923,28493,24064,11419
62793,569,1710,43571,19222,3.341e+13,880.777,7081.73,62793,477,378,59418,56763,50721,38061,26416
88795,1668,2512,62234,26561,3.59285e+13,935.592,9716.77,88795,561,436,86283,86057,82090,72982,73095
53730,1262,2719,37131,16599,3.52922e+13,890.576,8793.48,53730,579,675,51011,50204,47259,40662,32804
17468,407,1880,12490,4978,3.71022e+13,431.147,4430.32,17468,392,263,15339,14073,10494,7354,4888
33094,505,2024,23068,10026,3.67136e+13,573.611,5993.82,33094,455,345,30409,28994,22838,15716,12992
46995,592,2307,33151,13844,3.61059e+13,830.401,7681.71,46995,587,398,43537,41676,32529,23311,20722
22859,987,1634,16109,6750,3.68394e+13,476.79,4608.68,22859,342,269,21225,21051,20515,19733,16297
64478,305,2428,44976,19502,3.60486e+13,1000.11,8662.63,64478,531,494,56206,50629,35878,18342,15362
63901,2695,2814,44655,19246,3.53e+13,918.548,9623.68,63901,461,451,61087,61081,61055,61000,60409
89828,1991,2895,63380,26448,3.65611e+13,1038.52,11473.6,89828,628,617,86933,86675,85552,82847,66922
45008,644,2902,31544,13464,3.66867e+13,862.327,8638.95,45008,444,567,41063,39484,31339,21980,16720
86172,102,2995,60283,25889,3.52786e+13,1065.17,11127,86172,626,505,69468,60869,42618,12212,9219
50780,2804,3149,35310,15470,3.64308e+13,638.689,9220.64,50780,470,672,47631,47629,47492,47515,45760
38647,1250,1811,27579,11068,3.73423e+13,765.173,6040.61,38647,411,376,36836,36216,35242,33179,30637
9502,401,957,6547,2955,2.84379e+13,125.891,2226.9,9502,194,158,8545,8498,7861,6551,5053
55705,247,3253,38065,17640,3.51782e+13,775.802,9863.65,55705,627,559,48463,43626,26473,13919,10140
84823,1431,2936,60345,24478,3.67346e+13,966.422,10872.1,84823,692,413,81887,81302,76106,62331,59237
27409,234,1491,18854,8555,3.55563e+13,462.497,4623.51,27409,303,347,23860,20695,16478,11839,9515
46146,2170,2382,32574,13572,3.70672e+13,931.467,7526.44,46146,578,511,43764,43747,43382,42972,42700
97494,2799,3008,70039,27455,3.61247e+13,1044.4,12197.1,97494,607,624,94486,94486,94443,94472,93795
83180,501,2800,59606,23574,3.76332e+13,1038.53,10681.9,83180,699,470,77483,73442,61638,44439,26240
10843,1124,1160,7392,3451,3.46372e+13,281.263,2780.77,10843,267,180,9683,9683,9676,9679,9647
60718,2525,2937,41079,19639,3.39423e+13,712.999,9212.54,60718,475,578,57781,57778,57545,57774,56394
84712,1053,3044,58506,26206,3.60583e+13,1250.86,10524.9,84712,650,570,80739,79089,59395,46223,45597
71547,2536,3303,49503,22044,3.58675e+13,765.24,10810.3,71547,546,585,68244,68235,67806,67919,60274
67068,1186,3207,45984,21084,3.48553e+13,803.116,10573.7,67068,653,500,63829,63274,48301,36129,28777
20052,998,1849,14082,5970,3.56649e+13,399.511,4730.6,20052,276,326,18203,18020,17621,17202,11722
83766,2102,3336,58197,25569,3.5377e+13,1027.34,11830.1,83766,568,612,80430,80287,78500,75808,64069
17360,647,1352,12304,5056,3.53207e+13,419.751,3783.64,17360,237,306,15948,15217,15112,14728,10124
27185,39,1544,18658,8527,3.6495e+13,447.299,4444.73,27185,343,299,18200,14530,11218,4945,3098
6837,291,821,4820,2017,3.79829e+13,250.424,1865.05,6837,148,181,5946,5282,5111,4721,3207
77745,262,2831,53738,24007,3.27142e+13,1139.31,10383.7,77745,562,542,69977,65283,40355,14776,13334
87720,1209,2971,61575,26145,3.64825e+13,1230.33,10948.3,87720,554,716,84250,82741,74815,57437,52226
17378,94,1341,12297,5081,3.33619e+13,538.219,3582.43,17378,286,275,14403,12868,8743,3036,1348
49090,1025,2821,34541,14549,3.64751e+13,699.006,8573.89,49090,454,448,46269,45480,42205,32485,29045
88602,1484,3626,61417,27185,3.53928e+13,893.934,11874,88602,469,674,84976,83864,80184,76164,45366
3531,522,680,2372,1159,3.32503e+13,170.86,1311.4,3531,108,145,2851,2801,2833,2824,2513
15201,1134,1391,10777,4424,3.6449e+13,342.885,3608.22,15201,304,310,13810,13769,13737,13747,12183
12819,310,1430,9216,3603,3.5948e+13,311.71,3273.12,12819,354,251,11171,10398,8893,7372,4990
97776,95,3422,68333,29443,3.52457e+13,1166.07,12777.5,97776,588,689,78133,68044,47793,12805,8737
72136,565,3237,49115,23021,3.41378e+13,994.363,10440.1,72136,604,552,67035,64007,35850,23737,18593
38959,377,1780,26827,12132,3.62514e+13,635.84,5812.85,38959,379,348,35961,34378,24408,17342,14298
59021,1558,2201,42421,16600,3.69537e+13,1128.77,8231.68,59021,558,459,56791,55774,54387,51718,48182
83415,1579,3446,58724,24691,3.54991e+13,1052.48,11987.8,83415,631,615,79969,79192,74844,67555,48322
82748,813,3040,57128,25620,3.37526e+13,1028.15,10887.3,82748,547,567,78937,77366,64310,49490,26910
21319,1600,1700,14920,6399,3.59258e+13,497.018,4646.78,21319,281,340,19619,19611,19611,19609,19486
86264,161,3535,60472,25792,3.54186e+13,972.321,12348.2,86264,732,509,72408,62935,44932,15547,12082
24628,89,1399,17105,7523,3.64937e+13,553.754,4291.9,24628,316,359,18357,16238,11644,5148,3077
61826,2512,2695,43562,18264,3.64925e+13,880.641,8745.44,61826,540,419,59131,59128,59091,59117,58383
89450,2820,3330,62294,27156,3.39366e+13,996.429,11927,89450,639,513,86120,86081,85853,85727,78880
93995,965,3260,64346,29649,3.45674e+13,966.808,12002.4,93995,636,630,90308,88971,70591,52790,41793
78925,2057,3669,54258,24667,3.54965e+13,1093.05,11926.7,78925,598,573,75256,74582,70239,60768,56392
36480,403,1634,25076,11404,3.48343e+13,666.481,5426.78,36480,393,331,33531,31106,25158,20321,14408
50722,1312,2681,35251,15471,3.46475e+13,789.6,8388.63,50722,554,366,48041,47460,43151,30922,29818
54820,1496,2756,37421,17399,3.52748e+13,584.944,8556.02,54820,510,551,52064,51956,47558,38991,36247
54794,1764,3000,37922,16872,3.48347e+13,685.165,9240.91,54794,417,509,51794,51504,49986,46940,36584
21173,563,1472,15104,6069,3.68279e+13,488.342,4172.23,21173,289,274,19441,18274,17675,15718,11050
6862,944,1129,4928,1934,3.82768e+13,189.459,2261,6862,217,190,5733,5731,5718,5718,5301
19795,954,1604,13780,6015,3.19053e+13,342.994,4146.56,19795,223,326,18191,18029,17954,17687,12649
37552,1621,2315,25712,11840,3.30619e+13,615.178,6802.11,37552,361,458,35237,35049,34627,34246,29362
65474,1297,2227,45205,20269,3.33249e+13,1123.28,8680.72,65474,473,507,63080,61756,58734,49979,45145
32988,1803,2223,23075,9913,3.54374e+13,516.631,6466.79,32988,457,321,30765,30747,30609,30624,27525
85118,3412,3617,59011,26107,3.50556e+13,1120.61,12546.9,85118,661,668,81501,81499,81386,81359,80752
14170,1118,1485,9867,4303,3.63346e+13,332.103,3581.59,14170,227,265,12685,12650,12558,12458,10580
38845,1882,2018,26939,11906,3.34692e+13,693.923,6546.66,38845,446,356,36827,36827,36688,36604,36169
14329,1170,1280,9986,4343,3.22493e+13,255.37,3201.57,14329,242,231,13049,13039,13034,13044,12636
53882,1286,2304,37971,15911,3.63937e+13,750.499,7840.63,53882,422,417,51578,51135,48201,41571,36354
61234,893,2215,43894,17340,3.63312e+13,952.926,8420.19,61234,668,496,58307,56769,51432,38841,33796
51107,939,1723,35375,15732,3.17696e+13,1026.15,6577.48,51107,412,412,48581,46751,44952,38862,33206
81320,3395,3623,56732,24588,3.56121e+13,933.872,11930.6,81320,560,719,77697,77697,77636,77658,76927
45396,1440,2326,31335,14061,3.3097e+13,681.507,7174.16,45396,475,372,43070,42696,41635,37870,34477
84183,1866,3014,59744,24439,3.6105e+13,1067.92,11259.9,84183,587,529,81169,80942,78613,76647,69021
78920,77,3291,54605,24315,3.5614e+13,1210.53,11514.8,78920,610,576,60093,51520,36982,14305,7164
72090,908,2771,49277,22813,3.35129e+13,1039.89,9740.82,72090,549,519,68617,66528,54003,36651,34355
95374,3425,3520,67324,28050,3.6401e+13,1097.64,12891.8,95374,733,633,91854,91854,91815,91819,91405
49712,1508,2695,34236,15476,3.52499e+13,754.952,7941.82,49712,451,474,47017,46470,42992,37728,31948
56611,1685,2298,38877,17734,3.55412e+13,572.705,7589.74,56611,436,330,54313,54196,52629,49900,48491
14299,965,1447,10278,4021,3.73487e+13,312.67,3520.11,14299,288,312,12852,12746,12687,12721,9558
36114,534,2273,24571,11543,3.56036e+13,719.665,6844.16,36114,386,477,33054,31414,24394,17069,14826
29776,458,2245,20369,9407,3.55989e+13,506.276,6288.91,29776,455,474,27253,26190,21905,18756,10091
65715,2372,3181,45526,20189,3.56645e+13,742.596,10133.5,65715,699,507,62534,62440,59754,53498,54493
17286,1274,1552,11779,5507,3.58645e+13,358.46,3914.23,17286,340,296,15734,15732,15527,15339,14753
44385,664,2228,31041,13344,3.63863e+13,755.962,6968.5,44385,469,349,41758,40511,35472,24838,21654
3187,352,439,2188,999,3.43201e+13,182.72,972.277,3187,108,124,2748,2629,2643,2637,2455
63849,1861,2255,45680,18169,3.69685e+13,1091.94,8278.75,63849,495,432,61594,61416,61258,60793,58599
25418,72,1843,17684,7734,3.6022e+13,545.847,5142.5,25418,326,391,18827,15955,11977,3681,2610
91139,2546,3330,63994,27145,3.51316e+13,1332.73,12114.9,91139,679,592,87809,87520,85812,79755,79752
17837,572,1465,12915,4922,3.69218e+13,622.896,3828.28,17837,370,305,16039,15570,14068,10740,9081
72039,1918,2658,49340,22699,3.46118e+13,1038.39,9548.87,72039,575,484,69381,68860,66442,60470,60260
43198,1317,2576,29636,13562,3.32425e+13,683.943,7602.93,43198,458,439,40622,39989,37016,29349,28649
93390,408,3826,64536,28854,3.51823e+13,1038.17,13089.4,93390,694,523,85514,80703,49750,21002,18062
70929,171,2294,48860,22069,3.48016e+13,1051.6,8815.64,70929,466,521,61660,56321,37510,13653,12513
13755,591,815,9326,4429,3.473e+13,401.152,2625.92,13755,226,250,12940,12928,11878,10812,11180
25602,1679,1796,18305,7297,3.6798e+13,629.328,5081.77,25602,397,254,23806,23806,23795,23806,23419
41306,734,2728,29277,12029,3.72704e+13,558.447,7894.92,41306,524,374,38460,37708,29521,21724,18559
85159,203,3037,59331,25828,3.33539e+13,1224.22,10964.2,85159,652,552,74976,69356,45492,16179,10522
59560,509,2923,42164,17396,3.70035e+13,946.92,9387.68,59560,595,435,54638,51547,38370,25724,19240
87005,1533,2835,61976,25029,3.74127e+13,1226.14,10798.9,87005,758,479,83998,82411,77469,66027,62323
86159,640,3061,59606,26553,3.36401e+13,1132.63,11246,86159,679,583,80871,78058,58074,40685,31989
97891,1095,3904,66928,30963,3.49956e+13,1441.25,13496.5,97891,731,680,92770,90923,65562,49564,37799
30507,1953,2133,20982,9525,3.55629e+13,524.011,6125.36,30507,336,481,28374,28374,28314,28332,27801
10143,733,1147,6890,3253,3.46547e+13,313.561,2805.58,10143,307,247,8996,8972,7977,7367,6409
58331,331,2267,41536,16795,3.69996e+13,1046.25,8233.29,58331,492,496,52327,48138,34844,21074,10088
83940,318,3218,58967,24973,3.57649e+13,1335.67,11978.8,83940,690,604,75470,69566,49105,27805,18552
76151,726,3388,51883,24268,3.40206e+13,1035.09,11109.4,76151,542,538,71295,68728,45494,31967,24648
43382,408,1999,30274,13108,3.39461e+13,720.176,6691.25,43382,443,464,39908,37856,28760,19684,13969
66941,525,2053,45560,21381,3.50185e+13,629.25,7909.48,66941,502,550,63918,60553,46189,39323,31389
30685,1147,1704,21454,9231,3.65349e+13,602.585,5408.47,30685,335,330,28981,28879,28608,28359,26116
98212,64,3038,70765,27447,3.65739e+13,1121.82,11918.4,98212,706,588,71869,60802,48668,14199,9395
35334,1348,1819,24445,10889,3.2952e+13,491.462,5666.87,35334,360,343,33515,33461,32173,31159,27463
78069,1078,2660,55414,22655,3.66601e+13,1112.9,9877.75,78069,602,511,74913,72453,66480,52235,44129
99681,2848,4003,68178,31503,3.55214e+13,927.471,12695.5,99681,682,589,95678,95553,92464,85824,83522
16261,1143,1530,11162,5099,3.18971e+13,449.669,3894.23,16261,282,346,14731,14699,14269,13176,13194
79459,53,2948,55851,23608,3.67035e+13,1068.9,10423.8,79459,665,452,57017,47461,35874,14638,7002
23915,464,1564,16865,7050,3.66785e+13,697.762,4555.15,23915,382,307,21749,20889,18257,12038,9177
72900,1674,3113,50631,22269,3.56459e+13,1044.02,10538.1,72900,562,505,69787,68875,65391,55190,48988
54937,2387,2568,38932,16005,3.53934e+13,1074.58,8698.57,54937,599,410,52369,52235,52306,52308,51463
94514,917,3912,65197,29317,3.55028e+13,1039.75,13044.9,94514,535,631,89554,85684,65782,45264,32976
27273,474,2309,18879,8394,3.41866e+13,476.589,5955.52,27273,408,331,24746,23564,17694,13769,9336
13967,525,1381,9712,4255,3.23973e+13,281.952,3270.56,13967,194,255,12586,12294,11768,11747,5903
7322,442,988,5213,2109,3.60841e+13,173.42,2071.77,7322,229,178,6334,6173,6039,5430,4047
73834,347,3161,51832,22002,3.64392e+13,879.149,10996.3,73834,505,620,66692,61171,44494,28110,18539
34904,101,2237,24239,10665,3.60318e+13,725.725,6442.6,34904,441,407,28100,24917,15633,4154,4530
77852,1749,3371,53708,24144,3.51686e+13,931.502,11058.6,77852,573,618,74481,73712,69076,55002,54719
74560,706,2823,54119,20441,3.76569e+13,1068.79,10575,74560,562,516,69870,67039,62247,47931,32315
4751,313,710,3173,1578,3.3064e+13,241.968,1517.54,4751,159,142,4003,3689,2958,2653,2293
38232,1277,1809,27211,11021,3.6645e+13,750.421,6084.8,38232,459,347,36423,36195,34608,31895,31499
5946,1030,1037,4358,1588,3.56484e+13,191.682,2009.34,5946,207,130,4909,4909,4909,4909,4908
56784,1275,2151,39759,17025,3.58704e+13,829.224,7487.31,56784,480,385,54633,54235,52079,48023,44633
6363,798,801,4539,1824,3.83583e+13,219.814,1770.18,6363,217,146,5562,5562,5562,5562,5560
30673,938,946,20888,9785,2.74181e+13,559.901,3642.32,30673,310,254,29727,29727,29725,29727,29725
60037,688,2159,41614,18423,3.55429e+13,883.032,8084.94,60037,546,432,56514,53331,43349,34897,30265
24975,1620,1675,17269,7706,3.44526e+13,454.85,4570.68,24975,406,333,23300,23300,23296,23300,23180
91691,2829,3620,62241,29450,3.51341e+13,919.09,12399.8,91691,570,732,88071,88054,87614,87450,81305
33601,1760,2624,23671,9930,3.62268e+13,388.845,7253.68,33601,286,588,30977,30972,30549,30754,25895
48757,1495,2439,34598,14159,3.65902e+13,811.676,7646.89,48757,626,459,46318,45951,44370,41994,39595
48857,1265,2501,33768,15089,3.556e+13,770.852,7759.72,48857,495,387,46356,45944,43891,38061,37950
56841,91,2958,38862,17979,3.38871e+13,931.579,9576.3,56841,441,624,45999,40527,25362,7746,4237
13911,677,1254,9686,4225,3.82166e+13,288.442,3137.26,13911,239,207,12657,12594,12402,12416,10404
62795,2217,2506,43928,18867,3.5118e+13,726.257,8155,62795,509,385,60289,60288,60186,60240,59110
96994,2726,3352,67077,29917,3.60836e+13,822.753,12161,96994,586,692,93642,93638,92984,92664,89561
32354,930,2037,22359,9995,3.43756e+13,864.629,6000.2,32354,387,384,29976,29145,27178,23171,18173
29246,1499,1986,19813,9433,3.5193e+13,496.827,5480.93,29246,384,493,27260,27221,26159,25669,23990
90229,3269,3349,62628,27601,3.57418e+13,1133.68,11810.4,90229,651,606,86880,86880,86835,86846,86734
2606,10,510,1928,678,3.55919e+13,106.401,935.095,2606,126,94,1166,588,589,468,168
17685,176,1371,12222,5463,3.51313e+13,297.627,3820.6,17685,228,314,15040,13089,10235,6408,5226
53464,113,2852,37305,16159,3.58154e+13,696.959,8659.33,53464,532,423,42305,36486,27337,10635,6396
59536,1205,2609,42396,17140,3.63483e+13,856.329,9020.55,59536,617,441,56916,56190,52260,43911,34131
21875,1525,1634,15193,6682,3.66854e+13,513.347,4678.02,21875,435,304,20241,20231,20136,20082,19915
96250,2056,3860,66044,30206,3.40883e+13,949.964,12988.5,96250,674,599,92390,92107,83551,66029,63401
2160,274,497,1465,695,3.55815e+13,75.1486,906.856,2160,91,98,1663,1644,1628,1606,1076
38874,1050,2514,27447,11427,3.62514e+13,824.384,7530.7,38874,572,542,36089,35658,33550,29409,20426
3436,385,661,2357,1079,3.50269e+13,162.841,1264.26,3436,143,147,2775,2656,2629,2621,1993
89106,1198,3372,61127,27979,3.46735e+13,931.835,11885.9,89106,505,631,85603,84698,76768,61217,42209
6617,561,893,4714,1903,3.60757e+13,279.879,1928.21,6617,196,166,5724,5482,5435,5086,4564
37340,322,2132,25600,11740,3.43461e+13,543.668,6585.6,37340,444,396,33677,31421,21446,14292,11647
17687,634,1438,12309,5378,3.55199e+13,509.865,3883.05,17687,265,297,16108,15693,15385,14588,9082
97640,1416,3296,67345,30295,3.38914e+13,1200.54,12046.3,97640,660,518,94149,92427,82384,58917,61502
15388,9272,15388,0,15388,15.999,0,15388,15388,15388,1,0,0,0,0,0
91500,944,3857,63934,27566,3.63454e+13,997.801,12977.8,91500,728,497,87205,85523,63433,46738,36727
60161,112,3174,41661,18500,3.55659e+13,811.277,9615.7,60161,573,463,49176,42584,28800,10422,7570
7957,125,562,5352,2605,3.4785e+13,313.927,1706.43,7957,178,186,6153,5391,4157,2437,2496
62585,1890,2842,43640,18945,3.56756e+13,1038.37,9593.71,62585,449,471,59743,59206,58352,57130,49670
88757,1903,3104,61047,27710,3.40849e+13,1001.74,11251.1,88757,633,538,85653,85369,80324,69854,60565
6248,510,717,4552,1696,3.43097e+13,216.848,1637.68,6248,212,135,5531,5522,5432,5141,5177
59028,579,2281,41689,17339,3.6628e+13,861.105,8338.37,59028,597,483,54868,51418,41680,30564,25031
47088,463,2532,32983,14105,3.4883e+13,745.545,7794.66,47088,449,467,43414,41558,32527,21589,12330
12991,1128,1241,9183,3808,3.80225e+13,358.22,3197.03,12991,288,301,11750,11750,11726,11729,11500
89802,2520,2790,63208,26594,3.66661e+13,1247.48,10271.5,89802,586,490,87012,87012,86611,86209,85965
59371,2385,2435,42500,16871,3.65416e+13,1023.05,8363.82,59371,575,469,56936,56887,56929,56908,56717
40894,2345,2365,28676,12218,3.66422e+13,636.536,7053.38,40894,447,455,38529,38529,38526,38524,38495
29870,2095,2366,21634,8236,3.69485e+13,599.414,6503.75,29870,432,437,27504,27495,27406,27429,26425
98562,833,3287,69518,29044,3.66987e+13,1168.54,12014.5,98562,700,641,93871,91056,69943,47608,43118
5749,477,568,4043,1706,3.15323e+13,177.358,1445.29,5749,162,133,5181,5166,5074,5027,4766
83028,1803,3268,57975,25053,3.58381e+13,818.005,11558.5,83028,555,482,79760,79510,74961,63315,55181
82877,1623,3128,57665,25212,3.58923e+13,908.444,11021.6,82877,692,554,79749,79536,75266,66033,63117
43540,37,2609,30786,12754,3.76424e+13,697.545,7708.75,43540,578,347,29705,23723,18189,6347,3788
94533,1264,3832,66823,27710,3.67665e+13,1221.88,13243.2,94533,533,702,90256,88323,76353,53822,47951
22634,655,1932,16385,6249,3.58646e+13,538.977,5139.05,22634,429,285,20555,19819,18605,13488,10502
24716,747,2037,17062,7654,3.57459e+13,531.058,5288.43,24716,302,327,22679,21880,20678,16217,12028
49584,633,2954,34089,15495,3.54733e+13,927.385,8941.8,49584,523,581,45577,44113,35425,28641,14002
22964,249,1394,15836,7128,3.58718e+13,352.857,3887.59,22964,311,250,20571,17441,13212,9095,11480
15528,131,936,10598,4930,2.84165e+13,348.09,2581.68,15528,212,187,13956,13338,9331,6291,5400
66692,3438,3519,45864,20828,3.4355e+13,855.724,10847.1,66692,438,555,63173,63173,63157,63128,63026
54105,139,1983,38826,15279,3.71869e+13,886.001,7405.08,54105,460,421,44367,38226,30137,11829,7263
98489,1501,2723,70097,28392,3.71074e+13,1300.68,11515.7,98489,731,581,95559,94326,86577,67556,68574
81033,2134,2251,55612,25421,3.21177e+13,890.64,9322,81033,465,473,78782,78782,78775,78782,78230
24233,506,1718,17062,7171,3.65291e+13,554.348,4841.9,24233,346,291,22002,20987,15406,11168,9082
95346,3514,3546,66630,28716,3.59478e+13,1247.64,12335.9,95346,702,564,91800,91800,91800,91800,91782
16284,285,1251,11518,4766,3.66138e+13,667.755,3613.71,16284,341,313,13971,12756,10465,7289,5326
87355,112,2634,60006,27349,3.43688e+13,1075.89,9911.61,87355,595,464,70877,61352,42196,14780,12697
21988,818,1677,15622,6366,3.54442e+13,409.222,4482.21,21988,273,280,20311,20130,18576,17512,11400
20935,855,1500,14895,6040,3.73692e+13,597.607,4045.62,20935,314,286,19435,19059,18351,16879,15801
59502,694,2286,40101,19401,3.53701e+13,853.634,8006.38,59502,479,524,55767,52717,42487,31501,28571
99293,301,3895,68148,31145,3.44215e+13,1071.3,13617.5,99293,803,618,89505,82052,52921,17903,15356
33930,1593,1821,24058,9872,3.72445e+13,554.995,5795.93,33930,407,319,32109,32109,31783,31679,29367
97467,706,3144,67282,30185,3.37551e+13,1153.52,12180.2,97467,700,621,92704,90530,69525,51584,31061
41495,397,2821,28102,13393,3.45392e+13,771.869,8169.01,41495,454,658,37260,34869,24882,18528,8332
64602,272,3102,45304,19298,3.54539e+13,841.638,10094,64602,465,521,57401,52900,35298,17205,10239
96398,1103,3320,66305,30093,3.46533e+13,878.348,11782.1,96398,601,431,92800,91841,67439,49939,44198
52280,221,2385,36141,16139,3.5612e+13,568.743,7477.2,52280,471,309,45792,39176,27651,13614,12383
62936,313,2239,43217,19719,3.52721e+13,1108.87,8194.08,62936,472,468,56496,50131,35503,16702,15696
89647,33,2760,61770,27877,3.5644e+13,950.721,10248.1,89647,557,489,59744,46599,35903,15193,6954
11885,155,1353,7955,3930,3.43447e+13,309.513,3170.95,11885,327,246,9696,8492,5557,4025,2363
29856,127,1848,20843,9013,3.56477e+13,604.728,5474.34,29856,441,391,24015,20704,15180,6371,3358
92935,3211,4512,64399,28536,3.48504e+13,1019.96,14596.3,92935,626,893,88423,88410,87376,86730,73792
80341,1917,3572,54193,26148,3.32943e+13,1112.08,11660.2,80341,611,622,76769,76247,72007,61926,57005
9660,479,928,6698,2962,3.22291e+13,298.642,2282.08,9660,215,210,8732,8461,8019,7670,5733
94206,875,2637,66308,27898,3.66892e+13,896.603,9925.8,94206,550,438,91314,89645,70299,49919,52317
16879,377,1091,11371,5508,3.28049e+13,494.3,3331.37,16879,263,253,15348,14563,11737,10261,8342
26136,1420,1713,18407,7729,3.6785e+13,655.988,5172.48,26136,378,401,24423,24422,24348,24308,23245
5425,12,462,3654,1771,3.58135e+13,229.776,1254.27,5425,153,165,2711,1822,1754,622,438
22241,1133,1582,15481,6760,3.24495e+13,538.563,4359.32,22241,294,267,20659,20344,20427,20156,17853
59385,236,2502,42465,16920,3.72878e+13,937.751,8876.29,59385,530,527,51222,45441,32822,12353,11114
76929,3055,3249,53065,23864,3.51976e+13,1105.23,10731.7,76929,592,571,73680,73680,73646,73677,73211
91430,2361,3358,62934,28496,3.51782e+13,976.274,11911.9,91430,623,454,88072,87950,84505,79525,76654
56518,2346,2823,39125,17393,3.44945e+13,945.024,8955.31,56518,525,455,53695,53613,52556,50074,51187
92810,900,4057,64108,28702,3.42112e+13,1016.99,13816.3,92810,568,850,87465,84971,66994,50872,28205
73157,1211,3008,50510,22647,3.4619e+13,1043.46,10481.1,73157,450,602,69963,68574,63484,50625,40767
68989,3143,3171,48573,20416,3.56515e+13,896.215,10485.8,68989,558,601,65818,65818,65805,65802,65695
12461,546,1029,8913,3548,3.63826e+13,417.814,2687.66,12461,256,242,11414,11026,10495,10326,7780
52175,2039,2080,36799,15376,3.45526e+13,921.662,7368.87,52175,482,393,50095,50095,50089,50092,49961
40657,176,1868,28100,12557,3.56139e+13,907.074,6350.36,40657,434,388,34180,30523,19868,5463,5778
2173,371,427,1588,585,4.06752e+13,100.378,770.382,2173,133,70,1746,1738,1744,1742,1698
12949,572,1092,9173,3776,3.76108e+13,477.838,2907.73,12949,249,241,11703,10938,10415,9569,6918
48297,1489,2036,34761,13536,3.62281e+13,987.043,7171.98,48297,530,371,46261,45563,44491,42481,41934
18332,1376,1514,13057,5275,3.54957e+13,454.007,4026.54,18332,334,229,16818,16818,16793,16500,16526
94261,3165,3307,65228,29033,3.40093e+13,1101.42,12345.2,94261,709,551,90954,90954,90939,90948,90322
69688,2980,3127,48277,21411,3.58476e+13,746.851,9974.35,69688,476,512,66561,66561,66553,66553,65632
24539,806,1682,16640,7899,3.53277e+13,456.096,4594.4,24539,375,291,22857,22641,20510,16176,16585
91328,3449,3690,62949,28379,3.43707e+13,1329.11,12580.7,91328,636,572,87638,87638,87496,87531,86422
41077,734,2420,28207,12870,3.54174e+13,558.736,6855.17,41077,400,369,38560,37968,26959,20959,17774
80812,630,3198,56943,23869,3.6222e+13,1132.09,11122.1,80812,545,611,75137,71858,57046,40429,28569
83247,2012,2762,59606,23641,3.69179e+13,1105.44,10750.6,83247,648,535,80485,80379,78163,74137,65527
69829,2016,2813,48058,21771,3.24772e+13,872.478,9641.08,69829,560,407,67016,66997,64820,61558,58371
95792,551,3378,65825,29967,3.53312e+13,1154.67,12382.9,95792,721,667,88458,84104,54342,32204,29702
80794,2487,3139,56383,24411,3.5811e+13,1095,11229.1,80794,712,585,77655,77604,75307,69212,71170
82299,2160,2637,58805,23494,3.71903e+13,1360.48,10288.5,82299,659,501,79662,79058,78764,76917,73960
34535,210,1866,24626,9909,3.54643e+13,654.589,5832.6,34535,464,337,29080,25785,18328,9471,6670
67932,1861,2629,47300,20632,3.60209e+13,755.882,9607.49,67932,607,521,65303,65223,63312,62669,50713
70029,903,3138,49413,20616,3.58946e+13,1050.25,10882.2,70029,586,574,66046,64401,58417,44258,30660
45081,2150,2446,30973,14108,3.58016e+13,688.732,7548.55,45081,434,513,42635,42593,42524,42478,41543
94738,1911,3241,66560,28178,3.57531e+13,1138.22,12262.5,94738,654,636,91497,91151,87655,81940,63579
93828,244,3121,65490,28338,3.62167e+13,1233.89,11751,93828,768,582,83353,73592,48659,18574,16594
21289,549,1665,14550,6739,3.39116e+13,509.304,4594.16,21289,257,400,19445,18781,15581,10291,8958
8472,777,1229,5598,2874,3.23645e+13,243.292,2598.14,8472,287,215,7243,7229,6943,6310,5864
15302,35,1632,10525,4777,3.59393e+13,436.21,4029.73,15302,302,303,10098,7880,5989,2444,1439
75563,393,2806,53441,22122,3.64715e+13,887.427,10572.1,75563,642,512,69356,65793,44247,24634,19696
12381,420,992,8511,3870,3.54804e+13,303.344,2603.13,12381,254,199,11389,11243,10391,9029,8530
68916,1299,2193,46761,22155,3.51951e+13,685.317,8050.59,68916,432,402,66723,66663,61900,51612,53870
55366,2386,2756,39076,16290,3.58024e+13,692.043,8638.97,55366,423,542,52610,52515,52459,52147,48828
26210,970,1743,18334,7876,3.62575e+13,471.202,5063.81,26210,390,292,24467,24360,22892,20353,18821
75068,1672,2644,53253,21815,3.64872e+13,1175.08,9775.54,75068,601,525,72424,71423,67509,57747,60375
40349,363,2034,28229,12120,3.37103e+13,612.944,6351.77,40349,359,408,36919,34785,29789,19551,9804
13506,985,1169,9585,3921,3.56549e+13,419.728,3045.92,13506,282,217,12337,12256,12291,12222,11586
46277,581,2355,31824,14453,3.34187e+13,699.158,7336.4,46277,531,356,43199,41808,26245,20449,12505
60461,447,2766,41120,19341,3.48305e+13,669.884,8749.2,60461,441,639,56235,54075,33988,23559,11486
58550,250,2524,41267,17283,3.64399e+13,925.634,8747.7,58550,623,422,51450,46059,34640,21824,13545
75218,1474,3446,52372,22846,3.48614e+13,1119.76,11201.2,75218,771,574,71497,70259,61575,49268,49898
96846,309,3415,66822,30024,3.54944e+13,1064.65,12527.6,96846,644,684,87040,79630,54823,26299,15714
56654,1936,2321,40049,16605,3.70034e+13,948.219,8070.29,56654,525,384,54333,54131,54022,53328,51921
90384,33,2786,62679,27705,3.43778e+13,932.074,10330.5,90384,523,490,59512,45565,36578,14822,6645
51639,2376,2467,36407,15232,3.63993e+13,911.819,7915.84,51639,495,450,49172,49172,49135,49137,49045
56559,2976,3004,38974,17585,3.55658e+13,740.624,9164.1,56559,661,525,53555,53555,53554,53555,53529
5711,328,660,3997,1714,3.54466e+13,310.922,1587.35,5711,217,187,4877,4348,4234,3999,3017
32585,1661,1869,22514,10071,3.34929e+13,669.221,5669.87,32585,349,294,30716,30703,30481,30264,28237
48435,1521,2441,35019,13416,3.81573e+13,802.434,8036.31,48435,654,417,45994,45571,43807,37631,36239
40841,1249,2012,28904,11937,3.68233e+13,693.209,6530.3,40841,421,418,38829,38391,36249,32651,32150
60189,1014,2259,41196,18993,3.15181e+13,673.593,8078.09,60189,452,473,57723,56926,52388,42091,37051
45944,72,2286,32386,13558,3.72892e+13,806.621,7106.9,45944,458,384,34331,29364,21859,7248,5021
11493,401,1059,7873,3620,3.49282e+13,315.971,2697.63,11493,191,230,10374,10106,9276,8854,5667
25005,135,1419,16947,8058,3.44137e+13,377.077,4296.03,25005,283,274,20285,17688,13636,6156,3756
71028,583,2683,50031,20997,3.49423e+13,1165.01,9925.32,71028,619,455,65926,63068,52916,35720,24058
89493,1145,3372,62612,26881,3.50477e+13,1093.25,12249.8,89493,698,556,85820,83807,75644,53825,39992
79691,540,3502,54989,24702,3.56072e+13,1078.41,12003.1,79691,641,579,73450,69926,45741,28486,21365
52362,314,2360,36493,15869,3.42395e+13,1011.1,7823.76,52362,446,399,47607,44685,31260,20162,12735
40937,595,1973,28008,12929,3.2514e+13,819.122,6407.08,40937,388,358,38254,36981,32317,23071,19795
73733,673,3417,52196,21537,3.70213e+13,940.898,11378.9,73733,586,590,68914,65934,50167,35964,21205
98812,829,3713,68416,30396,3.56375e+13,1042.8,13234.1,98812,687,667,93997,91950,66327,52392,38383
60395,904,1989,43663,16732,3.72113e+13,900.766,7983.47,60395,582,360,57800,55750,54651,47485,41105
74042,1702,2959,51825,22217,3.62718e+13,903.867,10143.6,74042,736,446,71083,70704,67168,56930,58473
52756,2383,2472,36385,16371,3.59349e+13,933.104,8201.16,52756,501,514,50284,50284,50271,50274,49944
9824,687,1492,6978,2846,3.69981e+13,241.254,3055.04,9824,320,175,8332,8266,6748,5131,4311
67851,1743,2722,46889,20962,3.61051e+13,652.555,9328.44,67851,573,415,65129,65064,61821,51849,46306
53365,1988,2614,38610,14755,3.66219e+13,832.736,8684.87,53365,738,401,50751,50661,50023,48123,46443
46277,711,2752,32701,13576,3.5793e+13,796.006,8165.67,46277,577,394,43074,41698,33721,23680,17457
75623,2209,2431,52886,22737,3.39236e+13,1101.86,9240.21,75623,549,463,73192,73187,72929,72670,72246
60926,979,3685,41853,19073,3.54965e+13,792.555,10997.8,60926,554,696,56971,55731,45524,37529,19487
39182,23,2008,27369,11813,3.62213e+13,652.74,6181.79,39182,402,381,23939,17679,14453,7224,2701
18550,496,1631,12908,5642,3.67177e+13,458.708,4248.25,18550,295,318,16793,15593,13527,9604,7974
95786,936,2627,65898,29888,3.28335e+13,1263.5,10476.3,95786,591,540,91240,88075,72301,49774,52715
12639,1165,1187,8656,3983,3.57482e+13,272.687,3064.38,12639,197,294,11452,11452,11451,11450,11433
34940,591,1940,24469,10471,3.60858e+13,671.421,5769.65,34940,369,331,32671,31814,22768,16002,12679
35810,1307,2035,24977,10833,3.6614e+13,647.383,6087.19,35810,419,384,33775,33422,32402,29968,28380
78095,1237,3230,53827,24268,3.41354e+13,924.23,10989.3,78095,481,521,74667,73493,65094,43473,42071
71481,1066,2950,48329,23152,3.34788e+13,928.092,10407.6,71481,484,554,68250,66469,63140,54619,41928
36633,2248,2386,25884,10749,3.65604e+13,543.524,6911.34,36633,368,566,34247,34247,34230,34220,33876
13251,1355,1446,8909,4342,3.35126e+13,279.663,3406.17,13251,260,268,11805,11805,11805,11805,11512
67152,2130,3110,46857,20295,3.48996e+13,955.398,9942.13,67152,473,559,64042,63715,62873,60831,53484
47765,1700,1987,32797,14968,3.4581e+13,684.824,6669.2,47765,365,351,45778,45744,45687,45752,44796
39411,1789,2137,27484,11927,3.45103e+13,643.805,6545.26,39411,468,414,37274,37183,36891,36361,34986
80378,773,2662,55520,24858,3.24581e+13,965.632,10092.5,80378,533,490,76644,74369,68165,46824,32496
5519,132,799,3918,1601,3.83314e+13,221.547,1728.7,5519,219,167,4499,3994,3124,2534,1397
77854,1909,2862,54450,23404,3.70661e+13,925.353,10257.4,77854,546,464,74992,74749,71451,65663,60418
35842,1750,1831,25721,10121,3.69876e+13,701.609,6047.95,35842,565,290,34011,34011,33997,33965,33716
13628,129,1057,9322,4306,3.39395e+13,438.538,3009.48,13628,236,264,10767,9314,6659,3480,3478
46537,1215,2168,32514,14023,3.28389e+13,794.891,7228.38,46537,486,416,44369,43832,41083,34825,31185
55713,2411,2791,38105,17608,3.46724e+13,979.504,8997.49,55713,482,546,52922,52913,52742,52662,51067
87280,1911,2464,62213,25067,3.63852e+13,1172.86,10132.4,87280,639,578,84816,84583,82867,79993,78328
59192,1733,1918,41564,17628,3.49943e+13,818.442,7506.56,59192,494,417,57274,57274,56844,56594,56155
39194,1543,1657,27605,11589,3.58142e+13,694.048,5767.57,39194,450,335,37537,37537,37479,37472,37079
9747,363,1247,7004,2743,3.70839e+13,331.617,2798.97,9747,245,220,8391,7839,7512,6489,3848
67989,2848,3051,47202,20787,3.37724e+13,1034.4,10239,67989,593,596,64938,64846,64841,64775,63196
6021,775,780,4162,1859,3.24033e+13,201.981,1661.85,6021,174,152,5241,5241,5241,5241,5237
13087,398,900,8907,4180,2.83056e+13,265.172,2453.4,13087,190,176,12143,11783,11560,11027,9058
32615,864,1647,23007,9608,3.62657e+13,691.448,5046.16,32615,344,294,30908,30396,27951,21719,22306
83573,922,2586,58470,25103,3.53686e+13,917.027,10559.1,83573,558,548,80446,78438,73153,59835,47539
72516,1475,3107,51008,21508,3.59998e+13,1062.3,10576.6,72516,716,441,69361,68083,61415,44393,47198
24104,54,1796,16555,7549,3.28859e+13,474.481,4865.42,24104,362,278,17694,13843,10423,3099,1993
57322,1898,2680,39758,17564,3.58538e+13,675.117,8182.81,57322,418,454,54642,54522,53516,50996,48399
89643,745,2051,63692,25951,3.67996e+13,892.095,8784.21,89643,528,450,86792,84534,74216,54007,52399
20404,630,1410,13963,6441,3.48256e+13,468.967,4025.5,20404,306,311,18858,18200,16171,12929,12343
12152,241,1259,8696,3456,3.5921e+13,290.095,3059.62,12152,243,264,10607,9515,7823,5425,3226
29208,42,2170,20071,9137,3.2657e+13,383.578,5783.03,29208,355,331,20233,15603,11878,4964,2148
37662,691,1858,26388,11274,3.5275e+13,764.05,6196.78,37662,418,370,35148,33576,29206,22329,17257
8546,120,1264,6082,2464,3.65671e+13,198.824,2659.17,8546,179,290,6806,5959,4834,4394,1245
15119,624,1374,10426,4693,3.43876e+13,320.975,3580.58,15119,275,253,13745,13615,11941,8516,7450
66992,2151,2489,48029,18963,3.65254e+13,1163.55,9477.59,66992,687,537,64503,64300,64027,63449,61022
88058,592,3952,61449,26609,3.53347e+13,915.377,12942.5,88058,780,511,82665,79865,53857,33091,25234
95660,1261,3568,69148,26512,3.72771e+13,1165.77,13429.2,95660,614,759,91616,89228,84953,70540,49879
67813,1276,2916,47552,20261,3.56651e+13,982.737,10117,67813,516,565,64843,63670,60785,52256,43743
68564,74,2696,47912,20652,3.53256e+13,1109.76,9323.7,68564,638,437,51982,43680,32551,11145,6567
93234,948,2209,65980,27254,3.78323e+13,1044.93,9375.23,93234,498,542,90247,89226,81363,71761,41248
60176,1496,3137,42003,18173,3.65237e+13,830.416,9896.07,60176,469,571,57039,56321,52333,44799,33269
55967,1739,2492,38691,17276,3.48583e+13,968.426,8327.62,55967,460,551,53475,52783,51062,47276,45107
19219,79,1511,13026,6193,3.41503e+13,557.882,4171.81,19219,280,378,14971,12995,8497,3059,2679
9623,1121,1382,6876,2747,3.95942e+13,247.287,2899.19,9623,197,291,8241,8241,8184,8234,7600
64195,896,2346,44308,19887,3.48607e+13,885.586,8942.64,64195,532,451,61433,60533,50572,35897,32621
25878,693,1952,18351,7527,3.46936e+13,406.391,5282.67,25878,334,322,23926,23571,21537,14715,12122
50789,1336,1983,35189,15600,3.46189e+13,1037.85,7105.5,50789,488,497,48726,47313,47023,43685,37722
81708,241,2289,56260,25448,3.20711e+13,1073.26,9380.64,81708,529,473,73285,68439,42286,17473,14336
39726,1123,2272,27495,12231,3.43219e+13,402.301,6816.68,39726,438,275,37454,37331,34411,26320,20950
70021,419,3127,48874,21147,3.51955e+13,963.62,10461.7,70021,632,564,64246,60976,40759,21522,15311
81305,2287,2919,57685,23620,3.66906e+13,962.179,10891.1,81305,550,539,78386,78276,77728,77513,71735
44770,36,2066,32006,12764,3.77001e+13,765.84,7032.43,44770,420,374,30419,24541,18776,5567,3482
45249,967,2580,30594,14655,3.36602e+13,651.189,7644.24,45249,451,379,42669,41891,32573,23106,18893
58844,1330,3099,39099,19745,3.28588e+13,734.888,9215.17,58844,590,443,55745,55257,47942,42699,41549
72572,289,2967,51500,21072,3.61438e+13,1220.11,10773.1,72572,715,567,64151,58587,45037,23918,14644
26695,386,1750,18418,8277,3.20491e+13,350.709,5017.03,26695,231,315,24682,23855,21813,20077,8107
46799,2351,2760,31745,15054,3.41178e+13,716.137,8478.66,46799,477,528,44039,44023,43817,43811,41669
65105,1488,3601,44233,20872,3.3852e+13,694.153,10754.9,65105,672,446,61504,61124,47465,41747,37992
17555,545,1501,12640,4915,3.74268e+13,539.624,3839.91,17555,290,275,15839,15204,14257,13574,8329
88442,3045,3632,60056,28386,3.44581e+13,996.27,12260.2,88442,655,633,84810,84714,83973,82257,80402
65709,1434,3245,44596,21113,3.45263e+13,839.503,10410.8,65709,534,560,62464,61760,57985,49717,41226
40966,1686,1940,29287,11679,3.71788e+13,770.845,6551.96,40966,457,326,39026,38941,38922,38883,37987
7079,3300,7079,0,7079,15.9977,0,7079,7079,7079,1,0,0,0,0,0
29837,694,2089,20634,9203,3.31346e+13,896.817,5807.6,29837,384,454,27143,26421,21204,14310,9882
98204,355,3047,69259,28945,3.68117e+13,1186.26,11531.5,98204,665,556,89551,83415,52465,18033,19492
5344,692,833,3795,1549,3.86373e+13,192.328,1698.61,5344,162,193,4511,4511,4489,4496,4180
82645,2733,2941,57764,24881,3.53818e+13,1064.21,11123.1,82645,534,542,79704,79704,79638,79555,78164
78977,1883,3625,53636,25341,3.47207e+13,944.924,11695,78977,660,531,75352,74818,65166,55673,52259
95360,394,3329,67736,27624,3.63897e+13,1118.79,12442.1,95360,763,676,86393,80015,58437,28598,24155
4875,534,820,3470,1405,3.76286e+13,155.779,1628.7,4875,150,157,4055,4020,4015,4006,2886
43442,160,2319,29929,13513,3.57025e+13,598.267,6852.55,43442,394,388,36517,31883,22858,8172,6203
26207,1919,1960,18208,7999,3.42914e+13,425.282,5357.02,26207,281,411,24247,24247,24245,24240,24178
83868,2685,2982,59883,23985,3.7132e+13,1164.02,11359.8,83868,625,618,80886,80885,80475,80135,78711
50508,1056,2180,33857,16651,3.23615e+13,628.278,6632.54,50508,382,350,48328,47985,40323,32619,37296
73168,2003,3130,48660,24508,3.24032e+13,802.885,10342.8,73168,427,662,70038,70020,68884,67427,56903
48860,1584,2407,33469,15391,3.55231e+13,702.699,7770.14,48860,475,419,46453,46369,44637,41886,37492
21913,1201,1751,14870,7043,3.50395e+13,488.777,4826.96,21913,298,441,20162,19959,19638,19019,17095
69404,746,2287,50223,19181,3.73116e+13,1245.57,9241.28,69404,677,459,65107,62990,57894,42692,32252
81971,2908,2947,56294,25677,3.45221e+13,831.24,10409.7,81971,466,425,79024,79024,79014,79024,78986
3174,543,557,2142,1032,3.67197e+13,153.324,1119.18,3174,130,141,2617,2617,2615,2616,2598
45510,1063,2421,31183,14327,3.44823e+13,813.396,7604.55,45510,489,487,43004,42185,33487,28371,27778
95186,1977,3500,65864,29322,3.49184e+13,1368.08,12290.5,95186,618,549,91686,90554,85457,71648,68384
75128,1872,3419,51196,23932,3.42506e+13,649.523,10698.2,75128,669,474,71709,71574,66139,49651,48760
78727,1675,2959,55289,23438,3.66792e+13,1273.89,10990.4,78727,559,605,75477,73999,71363,62725,53979
58582,955,2062,40763,17819,3.33099e+13,770.713,7542.15,58582,503,348,56288,55659,53080,46657,39308
29005,1509,1804,20070,8935,3.45621e+13,455.425,5416.99,29005,404,317,27201,27200,27095,27111,25398
66159,2407,3288,45095,21064,3.50871e+13,741.744,10558.4,66159,525,706,62871,62832,62175,61877,57117
59240,1366,2262,41570,17670,3.63759e+13,734.047,8055.75,59240,605,340,56978,56786,53575,46636,45988
6525,512,1012,4718,1807,3.91766e+13,201.419,2043.95,6525,169,178,5513,5377,5381,5332,3616
42803,1837,2150,29750,13053,3.59422e+13,872.683,7012.86,42803,444,379,40653,40594,40403,40102,39123
62477,1077,2560,43664,18813,3.66458e+13,695.862,8883.93,62477,558,463,59917,59387,52996,42320,30286
81206,2139,2953,58413,22793,3.65271e+13,949.879,11020,81206,830,408,78253,78229,74317,62016,63398
15989,342,1427,11146,4843,3.48127e+13,520.404,3740.2,15989,380,273,13844,12815,9952,7363,5282
61772,1862,2931,42097,19675,3.39166e+13,921.428,8964.03,61772,415,390,58841,58463,57564,55269,50057
2100,421,469,1457,643,3.85408e+13,129.516,834.676,2100,112,99,1631,1631,1626,1630,1587
96564,772,3099,66444,30120,3.49752e+13,1160.29,11440.2,96564,618,542,91431,88901,58488,44016,39501
72314,447,2945,51397,20917,3.62688e+13,1106.3,10660.5,72314,615,530,65904,62218,43669,29013,16615
46300,1381,2184,31930,14370,3.29811e+13,770.267,6960.86,46300,419,404,44116,43602,43017,42073,36145
37766,683,2421,26594,11172,3.66527e+13,769.171,7340.71,37766,481,469,34686,33086,30356,24565,12176
25084,1962,2254,17592,7492,3.68465e+13,432.067,5749.42,25084,384,319,22830,22830,22748,22777,21762
85069,1568,3815,61086,23983,3.66426e+13,1149.06,12794.1,85069,928,636,81160,79681,69220,50359,49726
35951,1377,1756,25492,10459,3.66541e+13,590.772,5899.97,35951,361,388,34195,34165,34002,33863,30500
98180,1501,3338,67949,30231,3.16509e+13,1179.3,12042.7,98180,686,549,94618,92333,83754,57414,50038
84592,1334,2439,60268,24324,3.7049e+13,935.891,9566.94,84592,554,502,82153,81766,77537,70605,67654
20193,162,1695,14303,5890,3.2997e+13,319.004,4276.37,20193,273,271,17680,16283,13531,10033,3626
86332,1668,2677,60522,25810,3.64016e+13,994.148,10552.9,86332,619,481,83655,83275,79423,73025,66298
72461,1797,2923,50731,21730,3.60738e+13,992.871,10078.1,72461,590,559,69538,69064,65380,55527,56225
85189,787,2155,61034,24155,3.71863e+13,949.43,9205.52,85189,598,420,82251,80437,69338,44024,45276
48284,1375,2249,32939,15345,3.57948e+13,652.914,6981.51,48284,484,439,46035,45740,43654,38588,38343
21660,1535,1568,14938,6722,3.38083e+13,401.708,4359.81,21660,261,382,20092,20092,20092,20092,19839
94568,894,2497,66713,27855,3.51472e+13,1223.15,10329.9,94568,579,452,90517,87657,77139,55339,44985
7949,461,750,5323,2626,3.07203e+13,140.257,1835.07,7949,125,171,7199,7190,7118,7101,6028
37807,953,1410,25499,12308,3.46017e+13,651.024,5191.33,37807,361,332,36397,36379,34687,32149,33154
19193,112,1722,13643,5550,3.79064e+13,512.215,4497.13,19193,293,433,15217,13685,10514,4800,3083
55395,935,2570,38136,17259,3.3586e+13,685.957,8695.8,55395,387,560,52709,51830,49502,43005,30455
14147,226,1697,9798,4349,3.48433e+13,320.144,3844.16,14147,316,272,12015,10790,7607,3597,3117
4972,117,845,3675,1297,3.32348e+13,190.739,1703.41,4972,194,149,3809,3452,2858,1827,1083
93330,1080,3046,66149,27181,3.70426e+13,1170.53,10945.5,93330,540,517,89657,87880,70532,46005,44341
87425,2746,3429,59462,27963,3.44997e+13,1093,11620.4,87425,660,536,83996,83978,82423,79763,79431
13150,914,1139,8789,4361,3.377e+13,421.538,3027.51,13150,229,285,12011,11948,11901,11866,11088
76348,399,2289,53458,22890,3.27538e+13,1168,9108.41,76348,603,474,69933,66399,45808,29438,18047
56049,2225,2584,40196,15853,3.66568e+13,760.642,8599.57,56049,446,587,53465,53460,53291,52622,50042
32115,1185,2181,22852,9263,3.73886e+13,592.735,6104.46,32115,440,472,29934,29494,27034,21550,20649
61430,206,2713,43389,18041,3.65944e+13,533.383,8624.4,61430,436,600,53082,46164,35045,17671,7960
49168,1106,2325,34439,14729,3.41479e+13,878.036,7490.44,49168,479,413,46651,45556,43785,38697,33891
81270,1651,2483,57978,23292,3.71898e+13,827.406,9280.28,81270,615,409,78787,78638,77739,73729,72953
21870,505,1748,15169,6701,3.55214e+13,375.305,4724.34,21870,283,415,20061,19496,17136,15238,10031
40164,1170,2286,28841,11323,3.7662e+13,662.674,6796.17,40164,502,442,37878,37336,36174,34683,29291
16018,801,1434,10902,5116,3.50282e+13,455.839,3781.92,16018,290,403,14584,14295,13689,12385,9440
70026,2373,3157,48436,21590,3.53907e+13,902.483,10429.3,70026,557,552,66869,66769,66341,65591,58601
33336,848,1957,22949,10387,3.60171e+13,527.704,6178.01,33336,359,421,31379,30949,28100,24509,15160
31555,888,2289,22695,8860,3.68075e+13,561.266,6393.82,31555,417,468,29189,28377,27617,25446,14025
84089,961,3681,58087,26002,3.42908e+13,957.105,12291.6,84089,627,520,79973,78952,57895,43667,36822
52501,1687,2612,37025,15476,3.46979e+13,809.583,8611.83,52501,456,553,49889,49735,49341,48433,40286
32629,1643,1685,22803,9826,3.5349e+13,547.381,5443.44,32629,420,330,30944,30944,30933,30928,30887
96164,2893,3296,66196,29968,3.47382e+13,1088.45,11980.8,96164,623,599,92868,92863,92574,92432,88413
59441,168,2710,41478,17963,3.40159e+13,848.694,9079.53,59441,563,441,50913,45500,29702,8411,8586
97696,51,3503,69330,28366,3.64839e+13,1322.2,12745.8,97696,806,593,69880,57837,44879,15088,8300
7049,186,893,4762,2287,3.5684e+13,302.323,2019.9,7049,210,220,5712,5026,3699,2678,1730
18667,1491,1993,13475,5192,3.71883e+13,394.848,4696.02,18667,305,344,16674,16658,16471,16596,14460
10171,487,857,7364,2807,3.6395e+13,376.786,2266.83,10171,249,177,9252,8800,8578,7778,7090
8501,262,1069,5711,2790,3.39585e+13,236.449,2420.08,8501,191,313,7311,6840,6301,5084,1976
55165,1281,2864,38544,16621,3.60519e+13,793.031,9005.09,55165,591,481,52301,51563,44334,34330,31685
50074,721,2170,34726,15348,3.57794e+13,946.273,7563.42,50074,489,402,46881,45148,35242,23640,22056
81921,1246,2775,56430,25491,3.38693e+13,1207.15,10858,81921,628,597,78732,77518,71643,56334,45772
60122,2520,3045,43150,16972,3.74229e+13,840.111,9748.98,60122,509,518,57077,57063,56829,56774,52711
87801,2758,3299,61691,26110,3.57829e+13,1013.4,11827.8,87801,690,641,84502,84417,83638,82025,81099
27385,269,1831,19237,8148,3.58869e+13,576.342,5280.79,27385,407,343,24162,21801,16690,10173,7105
43572,263,2025,30365,13207,3.6634e+13,687.698,6678.58,43572,484,400,38786,34764,24010,12885,9804
59292,509,2033,41832,17460,3.60936e+13,675.011,7162.06,59292,519,324,56159,54531,39669,27191,28362
12535,2261,12535,0,12535,15.9987,0,12535,12535,12535,1,0,0,0,0,0
39232,2029,2141,27296,11936,3.61192e+13,750.71,6679.41,39232,452,469,37091,37091,37067,37031,36820
40349,1720,2025,28507,11842,3.70219e+13,706.554,6589.47,40349,443,338,38324,38290,38227,38104,36972
36913,702,2066,26122,10791,3.58179e+13,823.96,6434.03,36913,551,356,34340,32807,30235,21073,18584
49937,912,1843,35847,14090,3.7554e+13,894.796,7023.38,49937,476,349,47804,46708,42230,34513,27895
98621,2847,3479,69771,28850,3.69928e+13,1117.27,12381.3,98621,642,567,95142,95119,94482,92784,89960
88685,255,3296,62015,26670,3.62864e+13,1388.02,11798,88685,647,600,77424,69740,49810,20450,13201
79162,385,2547,55289,23873,3.27422e+13,1215.15,9787.08,79162,582,547,73037,69427,48137,28760,17642
23976,465,1348,17710,6266,3.66195e+13,724.712,4335.97,23976,402,264,21554,20228,18901,12981,10463
66348,1151,3270,46797,19551,3.59852e+13,952.109,10648,66348,598,577,62650,61168,56325,42866,32770
81386,804,2223,58532,22854,3.67106e+13,1188.94,9516.17,81386,635,573,77477,75105,69487,55147,42374
37062,2087,2160,26178,10884,3.65148e+13,619.879,6393.68,37062,445,328,34902,34871,34893,34878,34548
34830,914,1968,24262,10568,3.65931e+13,850.863,6156.81,34830,488,446,32596,31110,28425,22840,22561
45832,1823,2277,31525,14307,3.56771e+13,920.817,7600.59,45832,473,432,43555,43514,42672,41093,41087
8103,509,931,5488,2615,3.47262e+13,307.591,2278.09,8103,222,225,7172,6911,6640,5975,5401
92350,3755,3798,63941,28409,3.44939e+13,1153.02,12674,92350,866,581,88552,88552,88544,88550,88426
2731,486,491,1959,772,4.05597e+13,138.5,934.721,2731,141,98,2240,2240,2238,2237,2235
75719,1932,2703,54086,21633,3.74231e+13,1138.96,10083.9,75719,625,503,73016,72669,72051,68287,65566
6441,598,823,4592,1849,3.73447e+13,389.665,1852.94,6441,214,169,5597,5152,5333,5168,4640
44046,161,2178,30186,13860,3.36922e+13,718.513,6991.78,44046,415,433,39036,36532,24065,8994,4499
78171,1696,3086,54094,24077,3.36262e+13,1159.47,10992.2,78171,550,678,75076,73974,71128,67790,54040
38658,2125,2283,26298,12360,3.62443e+13,620.431,6985.1,38658,443,478,36375,36375,36200,35887,35733
51288,1184,2577,34902,16386,3.51637e+13,643.072,8368.79,51288,545,494,48711,48399,43144,38884,34719
99397,1406,2438,70813,28584,3.72485e+13,1054.65,10133,99397,575,501,96959,96220,90356,79553,71869
48689,764,2277,32580,16109,3.45874e+13,750.057,7324.74,48689,402,428,46115,44856,30907,26490,27529
77950,2651,2742,54716,23234,3.50148e+13,955.403,10347.2,77950,523,570,75208,75208,75181,75208,75070
59757,1668,3048,41207,18550,3.45283e+13,988.102,9569.71,59757,607,592,56709,56136,53533,49852,40536
9206,264,1186,6255,2951,3.36668e+13,294.78,2759.34,9206,235,345,7795,7204,6426,5879,2548
93853,2214,3144,65628,28225,3.49037e+13,1115.64,12005.3,93853,582,523,90709,90334,88802,86179,73307
4058,640,782,2695,1363,3.62863e+13,130.154,1486.46,4058,198,152,3276,3276,3215,2996,3049
12349,140,1351,8742,3607,3.35565e+13,204.29,3153.09,12349,244,221,10644,9810,6732,3594,1941
78667,535,2831,54959,23708,3.71395e+13,1207.13,10017,78667,526,467,73506,70258,48281,32128,27800
10010,527,844,6894,3116,3.3213e+13,312.913,2251.65,10010,218,175,9166,9056,8555,8428,7335
5306,117,855,3767,1539,3.66607e+13,151.448,1716.93,5306,138,166,4289,3902,3114,3045,739
11653,265,1230,8451,3202,3.7036e+13,380.143,2931.97,11653,289,216,10008,9130,8105,5589,3306
26149,672,1514,18061,8088,2.94113e+13,485.881,4340.38,26149,312,305,24574,23828,21546,13827,12937
63444,1363,3069,44235,19209,3.37114e+13,708.209,10130,63444,634,515,60375,59947,53906,39336,33702
60920,523,2594,40753,20167,3.33782e+13,855.801,8724.98,60920,458,625,57117,54533,29169,21308,18830
29943,1636,1870,20360,9583,3.52122e+13,467.626,5222.31,29943,369,336,28073,28059,28019,27970,26416
88220,1701,3112,62496,25724,3.65546e+13,881.538,11024.5,88220,701,417,85108,84845,80347,69863,68941
13685,1333,1455,9513,4172,3.6369e+13,383.317,3553.92,13685,303,389,12230,12160,12033,11355,11767
70416,2545,2988,50219,20197,3.71535e+13,895.671,10131.8,70416,625,527,67428,67420,67203,67013,63866
99360,2769,4039,68021,31339,3.52157e+13,959.888,13538.3,99360,660,718,95321,95273,93969,92432,82557
24929,733,1760,17632,7297,3.71471e+13,608.247,4922.25,24929,385,312,23028,22206,19360,13175,12075
83151,2851,3389,58042,25109,3.57322e+13,976.813,11633.7,83151,757,500,79762,79696,79109,78305,76791
91647,2854,3473,62508,29139,3.43588e+13,1095.72,12184.8,91647,581,610,88174,88163,87856,87617,83159
16594,664,1264,11631,4963,3.67865e+13,475.017,3411.3,16594,274,240,15330,14856,12899,9555,11060
57267,984,2389,40103,17164,3.55412e+13,730.299,7966.62,57267,480,411,54719,53937,49442,37503,31622
40580,1537,2067,28982,11598,3.69359e+13,922.479,6848.46,40580,469,421,38513,37916,37363,35816,33898
59138,196,2924,41087,18051,3.53465e+13,811.152,9563.98,59138,619,387,50886,44596,31311,11928,9847
78401,2621,3615,54459,23942,3.51936e+13,1066.11,11930.6,78401,701,612,74786,74634,73000,70536,66761
77198,1637,3366,53485,23713,3.4957e+13,966.512,11265.6,77198,718,503,73832,73024,64460,53321,49538
26280,2081,2117,18032,8248,3.45885e+13,428.098,5485.31,26280,358,281,24163,24163,24163,24163,24104
19704,663,1435,13466,6238,3.57251e+13,409.34,4026.46,19704,265,304,18269,17619,16882,15018,14268
46509,1360,2255,32582,13927,3.52863e+13,813.891,7289.27,46509,441,417,44254,44010,42200,39299,36326
13627,556,1400,9874,3753,3.8176e+13,351.063,3446.57,13627,315,235,12227,11681,10943,8995,7642
7801,3583,7801,0,7801,15.9979,0,7801,7801,7801,1,0,0,0,0,0
98134,1043,3154,69402,28732,3.66123e+13,1097.15,12130.8,98134,658,648,94382,92268,79753,58957,39705
5051,251,724,3576,1475,3.70315e+13,136.609,1510.86,5051,231,127,4310,4066,3423,2677,2350
83045,1882,3578,58352,24693,3.62302e+13,790.086,12394.9,83045,799,453,79467,79290,71726,52563,47685
39024,139,2003,27864,11160,3.71418e+13,736.468,6548.89,39024,499,418,31731,27562,21495,10024,6227
94922,1494,2830,67746,27176,3.71973e+13,975.838,10470.8,94922,593,523,92092,91551,84191,66812,69202
44411,1595,1690,32081,12330,3.66687e+13,930.492,6278.84,44411,501,404,42721,42600,42575,42323,42212
30595,1550,1639,21113,9482,2.88394e+13,447.879,4911.93,30595,318,240,28956,28956,28946,28955,28382
6970,588,679,4855,2115,2.8856e+13,167.944,1633.66,6970,128,127,6291,6290,6285,6284,6172
98736,3376,3770,68178,30558,3.55632e+13,1187.55,12887.2,98736,536,628,94966,94963,94750,94777,92745
59050,1511,2420,41405,17645,3.60786e+13,942.41,8683.4,59050,485,444,56630,55864,53860,47408,44384
76032,3022,3412,52531,23501,3.44797e+13,965.502,11219.4,76032,555,577,72620,72616,72534,72590,69342
32652,1039,1681,22736,9916,3.513e+13,596.971,5311.6,32652,357,323,30971,30901,28384,24700,22099
66333,1517,3232,45751,20582,3.43863e+13,748.289,10358.7,66333,589,550,63101,62587,56434,46141,42589
85934,1511,2174,59944,25990,3.58649e+13,944.497,8950.04,85934,588,445,83760,83379,80532,78756,68922
8777,388,954,5964,2813,3.53286e+13,283.758,2288.64,8777,239,213,7781,7394,6727,5620,5171
84523,2831,2906,57656,26867,3.40943e+13,1226.96,10593.6,84523,595,529,81617,81617,81607,81602,81247
56247,53,2737,40223,16024,3.76244e+13,836.275,9167.77,56247,520,548,40643,33963,25969,7765,3778
16843,177,1305,11670,5173,3.65198e+13,460.288,3513.92,16843,252,220,14180,12507,9343,5959,3781
24013,963,1800,16974,7039,3.69862e+13,449.706,5006.35,24013,278,311,22213,22042,21432,20783,15473
71245,2362,2910,48819,22426,3.56482e+13,900.384,8984.46,71245,506,456,68335,68264,67445,66229,64182
12390,1122,1381,8808,3582,3.63075e+13,317.966,3283.96,12390,257,229,11009,11001,10867,10838,9751
31832,146,2250,22417,9415,3.73468e+13,428.891,6335.78,31832,312,543,26190,22472,16556,8354,5666
71894,1813,2506,50536,21358,3.567e+13,804.495,8974.96,71894,596,456,69388,69331,67250,64243,62319
33785,865,1792,23510,10275,3.43644e+13,588.637,5589.44,33785,333,406,31886,31314,29114,28108,17596
92420,999,2944,64565,27855,3.3755e+13,887.284,11350.5,92420,662,481,88898,87070,79082,53275,50291
70616,443,2488,48831,21785,3.17917e+13,1104.86,9295.8,70616,527,504,65284,62236,46569,33870,17954
81614,1935,3072,57033,24581,3.531e+13,1185.37,11073.5,81614,629,714,78542,77860,75502,72127,60335
42797,894,2132,30160,12637,3.68252e+13,806.322,6618.55,42797,500,347,40389,39941,34346,27359,23510
53917,1128,2591,37470,16447,3.5078e+13,855.595,8412.16,53917,529,525,51302,50109,47697,42820,33771
56729,444,1917,40608,16121,3.71757e+13,942.109,7213.99,56729,485,374,52390,49597,38426,27658,20907
57179,2028,2473,39482,17697,3.49401e+13,896.198,8337.14,57179,434,384,54706,54496,54482,54412,52232
2640,332,495,1802,838,3.42833e+13,170.764,963.946,2640,143,105,2145,2051,1942,1868,1700
2066,420,485,1477,589,4.31946e+13,72.7827,816.252,2066,119,95,1581,1581,1581,1581,1477
15930,620,1606,10958,4972,3.21895e+13,364.176,3861.75,15930,311,341,14324,13966,13020,11443,8567
71187,2328,2876,49918,21269,3.62487e+13,995.583,10190.5,71187,547,566,68311,68212,68073,67982,63209
30846,752,1677,21529,9317,3.39465e+13,546.855,5147.3,30846,370,331,29169,28503,26226,22732,17608
15114,767,1387,10495,4619,3.62377e+13,317.507,3557.07,15114,241,262,13727,13692,13333,13252,10182
77990,652,2802,55194,22796,3.4676e+13,998.567,10236.2,77990,578,416,73699,71367,57163,34375,30851
47575,757,1691,34064,13511,3.76181e+13,868.863,6391.08,47575,484,419,45186,43614,41946,38976,23702
36663,1365,2100,25710,10953,3.71482e+13,818.442,6559.83,36663,374,504,34563,34034,33918,33100,28778
46609,1560,1644,32328,14281,3.37806e+13,771.184,6478.35,46609,397,421,44965,44965,44946,44941,44753
7093,474,806,4962,2131,3.61608e+13,231.431,1922.85,7093,182,150,6287,6242,6024,6035,4941
23322,1670,1860,16389,6933,3.65136e+13,421.253,4933.21,23322,288,353,21462,21462,21409,21432,21036
32405,4616,32405,0,32405,15.9995,0,32405,32405,32405,1,0,0,0,0,0
78666,992,3404,54424,24242,3.50674e+13,880.613,11313.4,78666,490,455,74925,73715,55370,39099,33596
35611,769,1923,25317,10294,3.58614e+13,766.66,6190.73,35611,499,350,33207,31872,29311,21165,19982
61095,1518,2433,42671,18424,3.67437e+13,871.236,8626.22,61095,557,502,58662,58438,54682,46535,47540
57844,798,2423,39980,17864,3.28715e+13,709.027,7880.29,57844,427,395,55111,54302,41033,25344,24489
1680,318,380,1126,554,3.02617e+13,134.454,700.804,1680,114,109,1300,1217,1265,1239,1233
19822,806,1375,13639,6183,3.55788e+13,581.206,4147.12,19822,316,474,18347,17934,16756,14112,14444
84943,779,4481,58786,26157,3.62693e+13,1012.62,13422.5,84943,674,811,79608,77094,53651,34925,25387
3921,279,704,2766,1155,3.85526e+13,144.531,1359.79,3921,166,118,3217,3070,2855,2910,1844
89225,3320,3898,62092,27133,3.59546e+13,1221.35,13020.5,89225,678,586,85327,85288,84923,84609,81153
45842,304,1727,32441,13401,3.59581e+13,755.934,6184.68,45842,434,340,40633,37570,27107,17475,13959
33299,311,2195,23313,9986,3.61778e+13,651.688,6060.33,33299,427,497,30054,26848,20703,14369,6417
41510,1815,2200,28316,13194,3.25847e+13,698.183,6902.41,41510,371,415,39310,39310,39236,39269,36778
51015,456,3023,34836,16179,3.47898e+13,649.016,9075.7,51015,450,421,46945,44853,27452,13837,11145
58820,403,2563,42756,16064,3.73725e+13,890.734,9156.78,58820,598,533,53549,50514,42689,31744,18213
74689,2635,2988,52232,22457,3.46272e+13,1327.13,10634.7,74689,670,543,71701,71609,71247,70696,69094
16524,1175,1294,11661,4863,3.67645e+13,341.308,3479.65,16524,310,313,15230,15230,15119,15148,14716
96121,2323,2768,65655,30466,3.5679e+13,1163.35,10375.9,96121,524,606,93353,92926,91949,89786,88846
96740,270,3874,66790,29950,3.45271e+13,1016.09,12881.7,96740,633,621,86180,79572,48877,13929,11123
99965,2223,3549,68169,31796,3.47153e+13,1278.3,12288.4,99965,656,577,96416,95923,91655,78440,82224
59156,2333,2542,40662,18494,3.30396e+13,841.497,8878.67,59156,482,503,56614,56614,56499,56512,55578
94881,2773,3280,66164,28717,3.52979e+13,936.569,12332.7,94881,565,717,91601,91595,91371,91376,84661
21939,1642,1660,15882,6057,3.859e+13,463.015,4436.43,21939,358,369,20279,20279,20279,20279,20247
27020,727,1695,18819,8201,3.66685e+13,574.529,5046.67,27020,411,286,25177,24359,22644,18287,16395
37607,2140,2380,26444,11163,3.58065e+13,645.784,7009.03,37607,428,374,35227,35218,35190,35224,33390
71013,1897,2347,51278,19735,3.69409e+13,1011.35,9030.49,71013,629,461,68666,68648,67440,65983,64895
18547,872,1458,13333,5214,3.70647e+13,516.461,3907.26,18547,336,276,17089,16745,16494,15038,13902
15555,415,1465,11206,4349,3.77417e+13,462.14,3748.34,15555,318,269,13864,13197,11499,8825,6977
79959,561,3217,55521,24438,3.62637e+13,805.589,10925.2,79959,523,554,74936,71156,51144,34651,21361
32871,1296,1814,23078,9793,3.60222e+13,549.103,5512.75,32871,417,340,31057,30991,29619,28725,24862
93908,996,3438,66279,27629,3.64192e+13,1276.48,12612.2,93908,738,547,89297,86973,66261,45838,41457
49949,2169,2494,34027,15922,3.37192e+13,656.097,8046.7,49949,442,423,47455,47447,47362,47338,45531
27948,196,2071,19041,8907,3.3575e+13,585.271,5569.34,27948,381,381,23653,21012,13854,6069,4937
83353,1779,1846,56886,26467,2.93784e+13,643.049,7370.42,83353,441,333,81507,81507,81415,81428,80845
45141,2210,3020,31588,13553,3.59818e+13,592.013,8493.94,45141,547,409,42121,42071,40968,37603,35028
73819,2332,2551,51487,22332,3.46222e+13,1009.26,9748.7,73819,491,539,71268,71266,71146,71009,69529
53751,2178,2608,36883,16868,3.38731e+13,770.439,8562.43,53751,473,435,51143,51036,50818,50487,48185
64688,377,2030,46652,18036,3.67485e+13,1053.72,8555.73,64688,483,491,59106,55781,44847,29047,18610
72398,2227,3653,50153,22245,3.5998e+13,871.331,11783,72398,570,716,68745,68604,67292,65802,53138
68491,792,3126,47349,21142,3.52759e+13,941.139,10849.7,68491,483,545,64131,62035,51138,36883,26212
85441,1953,2691,59383,26058,3.51671e+13,1169.91,10199.3,85441,571,520,82750,82410,80602,75600,73808
96107,2758,3149,69383,26724,3.65008e+13,1158.61,11881.6,96107,793,627,92958,92958,92726,92803,90169
11293,258,970,7653,3640,3.05101e+13,223.892,2487.36,11293,159,187,10223,9877,8179,6125,4669
59677,1411,2059,40479,19198,3.47396e+13,624.729,7876.89,59677,537,394,57618,57599,56915,56398,52470
66993,111,2407,47960,19033,3.64024e+13,1012.03,8911.58,66993,569,505,53354,46078,33634,10279,9253
3838,390,666,2617,1221,3.65274e+13,154.762,1354.68,3838,111,190,3172,3055,3083,3057,2110
90162,2368,3293,64089,26073,3.68092e+13,1157.99,12250,90162,686,616,86869,86690,85553,83726,76393
86804,2554,2994,61434,25370,3.66679e+13,1101.54,10754.2,86804,639,559,83810,83785,83408,82585,80877
19660,789,1538,13574,6086,3.27349e+13,286.564,4031.58,19660,313,216,18122,18071,17014,15608,14623
1828,33,488,1180,648,2.96422e+13,58.5651,817.144,1828,137,86,1175,816,618,402,261
46370,1901,2285,31943,14427,3.60593e+13,609.892,7043.92,46370,472,363,44085,44061,43511,43195,40201
34338,2281,2660,23584,10754,3.3294e+13,547.27,7141.33,34338,491,405,31678,31671,31224,30490,29414
37686,682,2407,26456,11230,3.47801e+13,817.288,7022.4,37686,492,531,34752,33765,29710,21186,13584
65103,2064,2909,45125,19978,3.53341e+13,1047.81,9266.01,65103,599,511,62194,61730,60312,57279,54951
56334,219,3629,39472,16862,3.53759e+13,773.329,10632.4,56334,542,753,48255,43406,29742,9646,6962
34809,1434,2321,23946,10863,3.59671e+13,699.267,6728.74,34809,453,495,32488,32237,31073,28396,26295
66834,2114,2445,47718,19116,3.67645e+13,988.929,8883.94,66834,561,394,64389,64384,64024,63501,61701
10214,493,1034,6880,3334,3.44524e+13,273.283,2616.1,10214,183,263,9180,8889,8513,7601,6114
13289,859,1283,9288,4001,3.59008e+13,273.387,3174.54,13289,308,215,12006,11993,11830,11771,10331
97202,3544,4024,67141,30061,3.54434e+13,1188.26,13583.6,97202,528,668,93178,93154,92975,93027,91243
92689,180,3175,65345,27344,3.6741e+13,1167.21,12002.5,92689,624,670,77684,68940,49213,17426,14364
34255,1181,2054,23775,10480,3.49179e+13,574.507,5914.95,34255,443,299,32201,31954,30213,25178,23218
66331,2196,2425,45162,21169,3.41986e+13,564.663,8155.36,66331,378,431,63906,63906,63801,63899,63205
81330,827,3427,55071,26259,3.46725e+13,800.249,11292.3,81330,550,556,77599,75826,52930,37677,31158
19943,1290,2002,13663,6280,3.49478e+13,396.559,4883.08,19943,413,295,17941,17902,17165,15794,15018
43226,424,1376,29567,13659,2.95065e+13,748.06,5327.57,43226,357,336,40559,39050,34462,26502,19707
88680,371,3154,61861,26819,3.63379e+13,1060.92,10808.1,88680,603,542,81707,76633,50096,24120,20192
33622,1552,2258,23524,10098,3.51453e+13,666.212,6378.03,33622,370,433,31364,31153,30915,30854,27311
57064,1207,2798,39798,17266,3.55497e+13,693.809,9159.23,57064,578,425,54266,53772,45970,35401,30236
6865,524,744,4909,1956,3.45339e+13,248.01,1804.46,6865,226,140,6121,6104,5829,5051,5253
46715,1559,1956,33151,13564,3.66127e+13,661.432,6953.11,46715,423,449,44759,44727,44553,44117,39128
65518,1967,2666,45882,19636,3.63391e+13,862.305,9338.55,65518,565,486,62852,62787,61429,58952,55381
14117,982,1389,9717,4400,3.57547e+13,420.298,3451.13,14117,329,255,12728,12650,12278,11192,11109
81557,1032,2968,57185,24372,3.55264e+13,1180,10765.9,81557,607,581,77822,75896,69025,50705,35253
30818,123,2010,21941,8877,3.67312e+13,588.101,5784.19,30818,431,443,24608,21291,16541,7279,3372
64584,2379,2905,44674,19910,3.60488e+13,877.48,9664.52,64584,644,578,61679,61647,59723,57958,57207
16301,658,1330,11187,5114,3.33664e+13,382.325,3529.2,16301,307,278,14971,14481,13662,10911,10600
49304,547,2080,33524,15780,3.4152e+13,482.565,7257.47,49304,331,504,47129,46546,38127,29456,18716
93217,755,4509,63904,29313,3.4683e+13,889.337,14553.3,93217,849,576,87585,83369,51770,35926,24322
25618,42,1704,17582,8036,3.35412e+13,532.918,4899.8,25618,327,334,18133,13771,10961,3486,1901
29815,1200,1901,20539,9276,3.53608e+13,575.938,5292.83,29815,395,358,27914,27830,26258,23815,23163
30977,989,1881,21129,9848,3.27807e+13,521.452,5751.36,30977,339,455,29096,28846,27759,26322,20160
81252,110,3244,56524,24728,3.62624e+13,953.154,11129,81252,547,594,64699,55727,40256,14539,8283
37879,1783,2856,26546,11333,3.44368e+13,719.98,7765.83,37879,350,579,35023,34900,34503,33885,25986
55990,414,2358,38540,17450,3.53057e+13,941.679,7912.84,55990,503,425,51301,48363,31583,19580,17483
6549,11,880,4432,2117,3.36358e+13,209.329,1988.6,6549,176,239,3008,1626,1588,571,393
56864,2629,3255,39027,17837,3.14336e+13,625.59,9569.11,56864,668,447,53609,53593,52496,49781,46600
69890,2720,2911,49958,19932,3.7144e+13,1105.11,10061.8,69890,632,487,66979,66979,66709,66315,65949
82620,928,4031,57157,25463,3.56765e+13,1046.44,12479.2,82620,576,648,78062,75580,56258,44820,35222
22731,695,1515,15818,6913,3.43235e+13,579.723,4545.21,22731,333,395,20941,20253,19003,15350,12219
74212,1452,3010,53044,21168,3.62705e+13,1130.96,10755.1,74212,545,530,71099,69451,66179,58364,45608
51319,821,2198,34835,16484,3.38001e+13,819.495,7481.16,51319,440,394,48705,48159,43168,33756,24140
2335,35,525,1748,587,4.02122e+13,92.9006,891.266,2335,136,84,1548,1322,804,328,153
78310,835,2454,54659,23651,3.39813e+13,979.275,9325.59,78310,502,528,75180,73416,65119,49059,42044
86856,1229,3233,60252,26604,3.46763e+13,1113.57,11410,86856,632,546,83211,81546,66186,50246,47976
29643,1256,1987,20887,8756,3.60678e+13,607.84,5641.76,29643,365,339,27656,27331,27014,25428,22962
21445,989,1701,14794,6651,3.48145e+13,391.366,4605.53,21445,326,294,19744,19652,18242,15978,14579
81515,1091,3030,56449,25066,3.41456e+13,863.36,10739.8,81515,567,622,78393,76724,70364,59272,46924
59478,761,2795,42412,17066,3.71286e+13,768.431,9037.76,59478,520,527,56333,53955,48112,40602,34124
16374,761,879,11142,5232,2.65514e+13,254.521,2715.87,16374,233,153,15495,15495,15352,13080,14134
4550,182,937,3288,1262,3.30393e+13,205.685,1732.15,4550,222,160,3471,3094,2834,2048,1391
91502,1464,3167,63590,27912,3.46399e+13,1067.98,11087.5,91502,650,500,88335,87362,75932,60068,59602
79883,1047,3325,56424,23459,3.72065e+13,976.475,11655.2,79883,642,752,76143,74685,57687,45080,36189
83705,499,3224,58472,25233,3.49061e+13,1128.55,11345.5,83705,578,675,77444,72970,52572,29903,22529
57929,697,2816,40143,17786,3.60924e+13,891.259,9279.1,57929,577,585,54080,51889,39100,30994,25016
90764,148,3034,63986,26778,3.56889e+13,998.079,11280.3,90764,572,559,75130,65719,47496,12906,12959
62138,389,2373,43449,18689,3.53316e+13,954.737,8915.6,62138,452,518,56520,53471,42777,27682,14776
37421,996,2130,25574,11847,3.27815e+13,497.603,6427.91,37421,464,321,35291,35028,30986,24123,21088
64154,595,2454,44360,19794,3.56558e+13,705.724,8827.47,64154,428,570,60990,59461,48410,34679,26358
64116,1081,3253,44867,19249,3.62835e+13,794.481,10208.4,64116,541,584,60863,59318,52669,38169,32460
38853,610,2473,27067,11786,3.67363e+13,822.974,7320.8,38853,431,493,35561,33659,27576,20540,16883
65824,1942,2640,46552,19272,3.66847e+13,876.464,9670.31,65824,647,502,63184,63048,60659,54981,50937
32878,1153,2334,23167,9711,3.71545e+13,582.037,6595.05,32878,386,477,30544,30124,28914,27127,18838
49232,1465,1706,34156,15076,3.16032e+13,780.86,6300.92,49232,409,313,47526,47517,47072,46533,43737
9672,119,938,6796,2876,3.63523e+13,403.996,2368.36,9672,238,196,7574,6651,5343,3290,2448
86650,950,2617,61892,24758,3.64361e+13,957.988,9647.7,86650,566,451,83764,82218,70540,41559,33460
20664,1498,1655,14888,5776,3.6618e+13,454.973,4477.35,20664,412,314,19009,19008,19007,19009,18415
77831,139,3276,54318,23513,3.56389e+13,978.922,11001.7,77831,643,659,64483,56266,41622,13615,10631
11677,1265,1393,8417,3260,3.69087e+13,326.839,3193.66,11677,344,250,10284,10274,10228,10212,9881
85413,386,3648,60337,25076,3.68456e+13,899.249,12497.1,85413,538,666,77901,72488,53978,28936,19901
52744,2325,2669,36554,16190,3.41978e+13,1069.55,8497.47,52744,520,548,50075,50066,49662,49140,47937
63873,1218,1814,44905,18968,3.27348e+13,957.027,7437.9,63873,463,371,62059,61222,60654,58561,54395
45037,1906,2591,31075,13962,3.55209e+13,839.978,7902.91,45037,389,506,42446,42147,41872,41225,37480
25080,1426,1605,17442,7638,3.30563e+13,458.629,4651.7,25080,292,281,23475,23471,23430,23452,22725
80147,1413,3392,55327,24820,3.55345e+13,897.69,11642,80147,479,608,76755,75753,71250,58401,45595
62357,1078,2423,42717,19640,3.32044e+13,1034.89,8761.39,62357,534,480,59505,58229,52764,41100,35932
30503,622,1832,21238,9265,3.56857e+13,636.646,5527.66,30503,466,416,28350,27126,23146,16897,16473
26607,400,1811,18387,8220,3.55659e+13,415.928,5078.06,26607,299,342,24546,23458,18283,12779,11151
34912,817,2852,24126,10786,3.55552e+13,662.189,7576.56,34912,482,588,31861,31117,24248,16772,10060
86487,2674,2801,60475,26012,3.53871e+13,1042.79,10759.8,86487,697,639,83686,83686,83626,83618,82998
73855,1388,2729,50649,23206,3.35289e+13,882.43,9718.34,73855,481,525,71126,70517,66271,58832,45002
42143,1386,1816,30147,11996,3.68777e+13,914.849,6346.57,42143,474,359,40327,39652,39182,38010,36679
64179,664,3137,45102,19077,3.54078e+13,863.41,9838.4,64179,585,487,60030,58057,42398,28072,19563
76739,3234,3656,53393,23346,3.64571e+13,1068.02,11528.8,76739,671,627,73083,73079,72913,73030,71324
71976,3074,3325,51636,20340,3.70429e+13,808.168,11072,71976,497,695,68651,68651,68601,68571,67446
5132,209,964,3614,1518,3.71893e+13,178.398,1811.74,5132,185,149,4106,3793,2975,2069,1398
41277,397,1783,28368,12909,3.17743e+13,660.722,6215.87,41277,341,420,38266,36691,31448,24380,12355
98868,2161,2935,69887,28981,3.66599e+13,1129.31,10493.9,98868,619,477,95933,95329,93836,90242,82429
21788,1115,1718,15418,6370,3.55381e+13,554.16,4623.17,21788,360,288,20070,19799,19529,17923,17438
86436,2789,3648,61466,24970,3.5524e+13,867.863,12241,86436,836,396,82788,82755,82057,80106,74140
32254,1892,2152,23322,8932,3.795e+13,695.784,6337.68,32254,506,443,30102,30090,29894,29852,28676
94766,1965,2954,65369,29397,3.46774e+13,989.977,11224.7,94766,476,606,91812,91573,90565,89491,78450
25852,284,1093,17718,8134,3.5537e+13,311.085,3696.64,25852,313,226,24359,20340,17191,12101,12706
68606,445,2468,48097,20509,3.6343e+13,724.773,8865.56,68606,554,375,64075,60984,40101,26828,18350
57581,2687,2891,40093,17488,3.56529e+13,785.653,9287.55,57581,661,628,54690,54613,54610,54530,52079
15681,697,1435,11315,4366,3.80992e+13,402.628,3584.12,15681,261,284,14246,13940,13404,13416,9743
91286,1297,3809,63843,27443,3.64932e+13,1180.36,13098.2,91286,583,583,86999,85813,73613,52516,43783
21129,819,1734,15104,6025,3.5779e+13,439.045,4540.42,21129,355,246,19395,19089,18370,16785,13817
53627,3049,3433,37464,16163,3.59768e+13,595.383,9932.47,53627,447,631,50194,50183,50033,50019,48116
97192,3571,3608,69022,28170,3.59322e+13,1162.96,13033.6,97192,770,534,93584,93584,93567,93581,93550
27523,1518,1815,18922,8601,3.24591e+13,497.049,5189.25,27523,373,291,25708,25619,25573,25616,24037
70336,1347,3039,48805,21531,3.64474e+13,921.074,10065.5,70336,456,544,67244,66299,58858,45679,35834
1467,356,362,1005,462,4.00102e+13,72.8214,610.227,1467,70,85,1105,1105,1105,1105,1099
33885,558,1631,23516,10369,3.59864e+13,505.373,5373.12,33885,351,320,32141,31048,24227,15368,13827
5439,712,913,3782,1657,3.62571e+13,233.018,1888.56,5439,178,226,4526,4471,4454,4320,4079
79259,2132,3105,55987,23272,3.65293e+13,955.357,10805.9,79259,653,542,76154,76016,74337,71986,63843
54781,790,2081,37944,16837,3.54499e+13,878.404,7378.22,54781,429,396,52220,51132,46339,36845,30706
10122,265,933,6918,3204,3.17875e+13,147.676,2294.34,10122,174,173,9189,8972,8352,6926,4459
3040,435,534,2028,1012,3.19463e+13,99.2151,1037.99,3040,134,103,2506,2504,2462,2494,2366
47236,1103,2114,33093,14143,3.62994e+13,737.98,7493.25,47236,494,387,45122,44537,42023,35853,31391
21211,1326,1437,14636,6575,3.54903e+13,374.182,3958.41,21211,297,309,19774,19774,19749,19743,19436
81590,2303,3022,55543,26047,3.51188e+13,918.473,10913.6,81590,504,607,78568,78508,78127,77314,66180
39670,848,2102,28386,11284,3.7004e+13,650.293,6706.37,39670,343,411,37436,36755,34567,31087,23056
5358,613,927,3651,1707,3.1977e+13,131.289,1751.96,5358,244,121,4431,4419,4271,4245,3598
87547,516,3670,62350,25197,3.74547e+13,983.664,12576.8,87547,688,603,80266,74896,56163,32223,27299
29186,1213,1874,19806,9380,3.48645e+13,596.343,5517.46,29186,355,344,27312,27136,26545,25706,23925
54718,571,1565,39784,14934,3.82908e+13,1031.58,6688.98,54718,445,414,50877,48369,45195,38339,24650
87441,2484,3776,61459,25982,3.57349e+13,1236.4,12449.3,87441,664,627,83665,83235,80203,72851,66926
52703,297,2569,36828,15875,3.38959e+13,612.141,8341.99,52703,354,487,47386,43927,27521,10745,10770
93003,943,3413,64898,28105,3.59963e+13,935.275,12227.3,93003,628,593,89137,87468,70957,50586,40596
87090,1892,2985,61834,25256,3.53397e+13,1144.19,11096.3,87090,661,499,84105,83406,82223,78272,74092
53988,511,2430,38275,15713,3.5673e+13,799.552,8285.38,53988,470,428,50038,47466,39189,30352,20214
9513,308,1142,6685,2828,3.862e+13,339.378,2651.41,9513,293,200,8130,7553,5579,4332,3158
5801,485,947,4077,1724,3.65178e+13,223.033,1932.99,5801,187,185,4854,4670,4507,3836,3468
43350,2474,2573,30599,12751,3.63304e+13,789.298,7839.11,43350,499,449,40777,40777,40773,40777,40660
48867,739,2453,33377,15490,3.52398e+13,880.603,7911.43,48867,561,520,45653,44168,35274,27005,22893
91844,1163,2470,66160,25684,3.68606e+13,1119.84,10019.3,91844,664,433,89249,87355,79408,61695,57286
23935,1307,1956,16662,7273,3.58554e+13,452.989,5298.88,23935,292,448,21979,21961,21692,21520,17715
85816,1840,3196,62142,23674,3.67998e+13,987.571,11834.6,85816,544,613,82620,82349,81727,81823,67889
79197,2941,3687,54807,24390,3.52313e+13,1140.09,12006.6,79197,665,666,75510,75431,73806,69190,67279
43204,52,1842,30598,12606,3.70848e+13,785.701,6416.13,43204,501,439,31080,26004,18443,6025,4620
30953,398,1931,21182,9771,3.54579e+13,514.144,5639.45,30953,402,322,28464,26444,17904,12736,8689
46586,2496,2986,32783,13803,3.60124e+13,793.077,8773.2,46586,490,620,43600,43599,43338,43452,41214
51637,1614,2359,36165,15472,3.68672e+13,599.457,7699.87,51637,376,428,49278,49242,48942,48831,41719
76922,2156,2735,53290,23632,3.37382e+13,960.17,10248.3,76922,482,592,74187,74093,73635,72829,65864
47557,2307,2462,33294,14263,3.61126e+13,844.312,7661.46,47557,575,452,45095,45086,45088,45052,44474
4155,591,620,2777,1378,3.76359e+13,203.6,1317.7,4155,152,148,3535,3535,3529,3529,3502
69020,172,1921,48010,21010,3.59129e+13,916.14,7959.75,69020,478,454,58380,52294,38483,13394,11508
88323,3405,3710,61362,26961,3.55935e+13,831.235,12424.7,88323,508,592,84613,84613,84545,84590,83463
75689,1243,2450,51995,23694,3.21732e+13,911.312,9312.9,75689,607,527,73206,72092,67303,52174,50355
92530,2386,2986,63985,28545,3.33418e+13,1042.72,11141.6,92530,606,481,89544,89523,88890,88228,78124
36587,1837,2424,25063,11524,3.40415e+13,532.411,6969.02,36587,510,318,34163,34158,33466,32876,29342
54042,2239,2557,37575,16467,3.45562e+13,1041.26,8749.48,54042,440,511,51485,51478,51384,51297,49803
29968,1503,2703,20879,9089,3.64655e+13,441.935,6882.29,29968,342,521,27265,27233,26697,26439,17374
74007,646,3167,52196,21811,3.64504e+13,1174.73,11133.5,74007,622,626,68515,65067,48024,34734,21370
10616,85,1061,7615,3001,3.70459e+13,321.283,2582.96,10616,277,177,7987,6930,5783,3545,2100
45917,1495,2748,31726,14191,3.59462e+13,806.117,7888.42,45917,450,554,43169,42819,40881,38789,28232
52634,1045,2831,36123,16511,3.53335e+13,614.817,9065.51,52634,570,440,49803,49415,36433,31065,26478
71505,2087,2858,49668,21837,3.34811e+13,1034.15,10001.8,71505,458,591,68647,68414,68044,67822,63073
85538,2499,3114,60447,25091,3.53365e+13,914.135,11822.3,85538,522,714,82424,82417,82152,82094,77556
1049,174,250,785,264,4.53483e+13,37.0143,404.462,1049,67,49,799,784,791,797,631
52614,1585,2751,36919,15695,3.6311e+13,825.532,8503.61,52614,467,467,49863,49421,48309,47110,39633
4546,574,704,3229,1317,3.82437e+13,189.432,1449.46,4546,165,133,3842,3799,3828,3836,3605
72618,1154,2284,48885,23733,3.51365e+13,1083.26,9023.62,72618,567,560,70020,68056,60851,48281,52373
1859,28,443,1247,612,3.52162e+13,93.1834,778.813,1859,94,110,1159,891,709,615,170
3568,643,677,2521,1047,3.62549e+13,87.0905,1258.1,3568,155,114,2891,2891,2891,2891,2810
64047,2286,2800,44006,20041,3.27501e+13,927.251,9308.89,64047,640,422,61247,61239,59884,56807,52631
31046,1928,2101,21888,9158,3.63275e+13,649.198,6167.34,31046,432,396,28945,28937,28560,27802,28141
20087,699,1744,13790,6297,3.313e+13,452.065,4471.54,20087,286,243,18343,17726,14784,10169,7950
16951,338,1604,11988,4963,3.72536e+13,558.019,3976.87,16951,319,340,14736,13488,12225,10490,4616
98410,790,3408,67585,30825,3.48963e+13,867.801,12231.8,98410,607,618,93954,91136,70512,50671,37979
83865,3465,3953,57562,26303,3.53256e+13,1015.21,13034.9,83865,618,654,79912,79912,78906,76863,76120
11752,213,1168,8523,3229,3.61252e+13,238.549,2749.01,11752,274,159,10200,9063,8342,7762,3068
93612,2668,2957,65647,27965,3.56092e+13,828.514,11195.3,93612,579,527,90655,90655,90575,90499,87911
82359,1276,3048,56555,25804,3.42725e+13,955.116,10760.2,82359,581,552,79229,77615,68322,49043,45020
32812,1099,1586,22387,10425,3.43688e+13,601.434,5297.59,32812,391,343,31226,31224,30048,27963,28172
63739,2410,2569,44520,19219,3.62359e+13,1033.78,9120.94,63739,630,480,61170,61169,61054,60970,60395
68405,2166,2701,47544,20861,3.54729e+13,825.655,9536.95,68405,532,517,65704,65550,63604,60612,57398
70611,369,2365,50668,19943,3.75847e+13,971.707,9285.05,70611,648,420,64838,60373,43410,28606,16327
60227,415,3145,42185,18042,3.6655e+13,994.41,10140.9,60227,529,544,54037,50660,34622,22214,14716
89282,1631,2576,61780,27502,3.61399e+13,887.267,10220.1,89282,545,583,86706,86554,82920,77402,71359
71697,2239,3416,48768,22929,3.30682e+13,886.775,10795,71697,634,515,68281,68011,64986,57600,54803
49462,912,2154,34971,14491,3.66529e+13,942.807,7180.75,49462,588,414,46751,45774,41293,30708,26879
71080,2519,3034,50610,20470,3.6563e+13,1112.06,10800.6,71080,622,590,68046,67939,67726,67133,63825
15431,944,1220,10925,4506,3.62955e+13,462.074,3251.76,15431,319,241,14211,14110,13985,13730,13274
97570,1541,3273,67995,29575,3.58563e+13,1127.83,11323.1,97570,566,473,94173,92788,84985,63899,65333
63517,1939,2260,43062,20455,3.187e+13,656.945,7865.15,63517,403,411,61257,61251,60501,58911,59306
80590,2821,4678,55126,25464,3.47761e+13,727.038,14187.9,80590,593,862,75912,75801,74795,74230,51327
3598,311,589,2430,1168,3.30176e+13,111.339,1213.43,3598,110,142,3009,2978,2943,2930,2013
74746,2119,2898,51309,23437,3.45619e+13,733.532,9852.11,74746,475,555,71848,71802,70552,67909,62286
53037,1350,2262,38190,14847,3.72234e+13,885.667,7800.61,53037,494,409,50775,50124,48691,47547,38031
9043,237,1125,6607,2436,3.62495e+13,279.669,2547.78,9043,275,158,7595,6808,5734,4700,2589
83491,451,2295,57516,25975,3.0444e+13,1047.7,9092.75,83491,535,400,78392,75492,54499,40861,26773
63631,578,2227,43528,20103,3.5348e+13,646.445,7914.21,63631,422,431,60923,59746,48704,36524,32197
72536,2829,2834,50585,21951,3.36176e+13,1051.4,9985.82,72536,540,532,69702,69702,69702,69702,69684
48757,2118,2228,34524,14233,3.58732e+13,590.661,7498.22,48757,415,483,46529,46529,46508,46527,46252
30307,798,1754,21090,9217,3.66252e+13,692.914,5387.19,30307,413,389,28473,27831,26849,22719,18777
59609,1642,2545,42429,17180,3.66855e+13,897.012,8697.68,59609,586,530,57064,56718,54204,51137,45597
35150,2010,2044,24697,10453,3.60482e+13,816.061,6319.53,35150,461,378,33106,33106,33101,33106,33063
96238,1962,4017,67433,28805,3.65621e+13,1307.64,13548.1,96238,709,699,92221,90922,82855,66257,66671
91847,742,2023,66666,25181,3.7106e+13,1304.83,9672.25,91847,675,452,87090,83892,76976,51344,45653
40850,1701,2195,29280,11570,3.74332e+13,716.685,7120.64,40850,361,466,38655,38643,38429,38536,36279
9341,208,996,6278,3063,2.96986e+13,199.686,2277.51,9341,265,199,8193,7772,5744,5189,3760
66016,1358,2229,46147,19869,3.47394e+13,1039.28,8605.15,66016,447,437,63787,62923,61522,56874,52206
40585,792,2043,28317,12268,3.43194e+13,605.332,6236.64,40585,423,350,38445,37533,34742,30369,21066
41949,2620,2641,28879,13070,3.6382e+13,570.487,7522.04,41949,472,439,39308,39308,39308,39308,39286
4993,253,499,3661,1332,3.62802e+13,222.938,1257.92,4993,158,123,4417,3900,3866,3920,2573
35886,1522,2115,25038,10848,3.70895e+13,644.444,6371.17,35886,480,346,33771,33755,33102,30681,29988
42476,1648,2429,29348,13128,3.54463e+13,860.338,7499.38,42476,404,434,40047,39683,38559,36809,33538
9220,235,1119,6494,2726,3.70071e+13,273.99,2582.04,9220,206,275,7751,6923,6362,5895,2894
86139,757,3029,60537,25602,3.57026e+13,942.909,11422.2,86139,617,577,81611,77227,69457,47172,28889
3103,339,512,2289,814,3.01657e+13,122.478,1030.52,3103,132,103,2591,2513,2417,2346,2131
80909,2412,3115,56129,24780,3.5453e+13,1125.67,11202.4,80909,687,636,77794,77469,77037,75793,70272
45421,1325,1963,31059,14362,3.4647e+13,717.763,6357.88,45421,389,340,43458,43173,41801,39596,37271
2760,398,469,2060,700,3.33011e+13,177.913,925.573,2760,110,101,2291,2174,2277,2247,2100
76936,1102,3337,52596,24340,3.40844e+13,796.345,10680.6,76936,527,642,73599,72650,59422,49441,34116
65617,688,2919,45758,19859,3.62215e+13,1048.61,9855.69,65617,515,512,61280,58526,42053,31597,26708
67413,1899,2872,46584,20829,3.55624e+13,1049.57,9428.85,67413,610,482,64541,64045,62379,56738,55884
39325,1707,2423,26926,12399,3.32882e+13,578.378,7109,39325,351,438,36902,36839,36605,36381,31566
24742,1411,2100,17483,7259,3.6506e+13,495.183,5717.43,24742,395,424,22642,22531,22236,22005,17867
53563,1750,2239,37550,16013,3.63402e+13,890.85,7940.64,53563,525,415,51324,51130,50142,49322,46433
80582,1310,2866,56761,23821,3.53793e+13,1000.45,10089.5,80582,613,503,77669,76511,72532,59694,58096
33262,547,1904,23683,9579,3.70347e+13,632.528,5647.51,33262,361,315,30733,29375,24648,16915,15975
21995,953,1716,15412,6583,3.5589e+13,378.703,4449.8,21995,318,264,20279,20072,19647,19470,15452
55790,2102,2705,37985,17805,3.4482e+13,915.751,8840.9,55790,483,490,53085,52996,52430,51270,49396
23309,604,1508,16250,7059,3.68434e+13,497.105,4548.54,23309,346,265,21714,20609,17555,13445,11507
48088,2204,2320,33721,14367,3.69436e+13,836.275,7438.62,48088,573,487,45768,45747,45756,45717,45318
69582,385,3287,48824,20758,3.59047e+13,1025.97,10925.8,69582,667,462,62406,57668,38232,19495,15558
39362,1147,2238,27687,11675,3.63762e+13,771.972,7062.62,39362,480,438,37039,36312,34932,32261,23080
39026,970,1429,27194,11832,3.16536e+13,759.992,5198.82,39026,366,279,37486,36438,36203,34340,31739
25579,1108,1554,18268,7311,3.64147e+13,472.497,4613.42,25579,342,351,24025,23844,23561,23423,19866
65783,584,2942,46183,19600,3.58279e+13,1118.27,9957.54,65783,645,570,60657,57503,43247,32413,23350
16564,847,1457,11140,5424,3.38456e+13,350.289,3743.2,16564,307,339,15107,15031,14692,14223,11344
63442,606,1803,44701,18741,3.74918e+13,739.265,7192.84,63442,509,435,60350,55567,47601,38101,33764
35270,1464,1944,24479,10791,3.42363e+13,522.122,5803.62,35270,432,341,33326,33260,32711,31505,30278
69129,1887,3314,47486,21643,3.43195e+13,959.78,10381.7,69129,613,554,65815,65330,59158,46454,51279
59778,1795,1984,41634,18144,3.5476e+13,1161.91,7671.77,59778,485,455,57794,57788,57568,57372,56747
84606,1147,2767,58302,26304,3.3024e+13,955.961,9821.06,84606,523,459,81568,79725,72659,54721,47186
36816,393,1572,25521,11295,3.48091e+13,771.184,5521.56,36816,447,329,33251,31251,26104,19598,13143
60714,279,1825,43370,17344,3.70045e+13,922.558,7331.34,60714,528,384,54074,48432,36590,19728,15394
60167,3450,3525,42021,18146,3.55895e+13,922.922,10553.5,60167,483,517,56642,56641,56640,56640,56541
2776,119,516,1936,840,3.34783e+13,184.09,1029.41,2776,154,132,2029,1786,1664,1384,913
25941,709,1784,17948,7993,3.53954e+13,688.054,5155.94,25941,397,345,23851,22880,20721,15417,15260
38660,581,2017,26886,11774,3.45867e+13,514.165,6391.71,38660,349,440,36568,35667,32623,31222,16415
95112,943,3855,65720,29392,3.50839e+13,1049.01,13067.2,95112,741,778,90411,88864,73400,51675,43233
64621,3185,3559,44361,20260,3.49972e+13,918.866,10936.6,64621,563,648,61062,61060,60854,60756,58373
86773,1073,3872,60113,26660,3.59066e+13,830.239,12564.8,86773,723,483,82842,81432,57095,41937,35612
69217,2338,2354,49639,19578,3.69238e+13,1192.64,9441.28,69217,635,490,66863,66863,66856,66850,66799
45630,2438,2649,32251,13379,3.73518e+13,801.11,8264.49,45630,492,422,42981,42981,42891,42955,41880
82445,2303,2366,56099,26346,3.59636e+13,706.85,8835.23,82445,540,566,80079,80079,80055,80047,79905
68944,926,2825,47944,21000,3.48151e+13,1037.23,9575.37,68944,613,539,65585,64213,53045,43366,30397
85256,1174,2525,59360,25896,3.38247e+13,1039.9,10049.2,85256,557,498,82244,80113,74987,54091,48543
73470,2218,3051,51755,21715,3.56525e+13,1063.17,10838.2,73470,662,451,70419,70181,68613,66727,60165
77519,850,3430,55418,22101,3.68629e+13,821.907,11652.8,77519,509,660,73570,71272,62807,41513,34880
16635,1179,1305,11726,4909,3.57823e+13,400.16,3465.51,16635,309,268,15330,15324,15201,15192,14964
34074,121,1643,23610,10464,3.37629e+13,640.37,5707.79,34074,404,375,27159,23443,16815,5349,4484
78452,2806,3180,53488,24964,3.56901e+13,803.789,11075.4,78452,613,438,75272,75272,74783,73957,72479
54074,967,2036,38585,15489,3.55832e+13,964.062,7568.66,54074,463,393,51634,50586,48251,38987,32782
86397,469,3751,60744,25653,3.64953e+13,935.626,12227.6,86397,789,564,80138,76241,52493,36460,24273
47160,631,1673,32793,14367,3.60654e+13,702.109,6355.18,47160,424,389,44517,42568,40499,31554,23791
5623,480,805,3861,1762,3.42754e+13,183.811,1736.2,5623,158,159,4818,4803,4621,4532,3855
9896,645,912,7114,2782,3.65394e+13,301.223,2317.13,9896,259,193,8984,8848,8460,8238,7733
53302,1559,2306,37953,15349,3.65889e+13,815.967,7821.55,53302,534,410,50996,50715,49106,44689,44553
64607,2172,2611,44983,19624,3.61197e+13,1020.67,9602.77,64607,597,596,61996,61975,60710,57520,59491
52087,2200,2636,36765,15322,3.63228e+13,810.353,8620.27,52087,569,514,49451,49418,48938,48656,45959
2627,252,417,1800,827,3.43989e+13,201.393,874.652,2627,113,113,2159,1869,1956,2055,1603
60986,2623,3151,41410,19576,3.43367e+13,910.571,10026.3,60986,591,654,57835,57790,57218,56831,53752
38119,1769,2560,26609,11510,3.60669e+13,487.023,7230.97,38119,520,354,35559,35539,34814,34302,28509
16199,255,1272,11073,5126,3.46138e+13,331.242,3601.59,16199,278,231,14072,12451,11024,8151,5717
44914,813,1462,31438,13476,3.62023e+13,785.376,5520.98,44914,360,352,43295,42595,39799,39083,30995
4692,591,665,3203,1489,3.732e+13,191.015,1484.8,4692,121,172,4027,4027,4020,4022,3944
13184,748,1258,9182,4002,3.49159e+13,374.383,3246.33,13184,268,241,11926,11790,11202,10847,8924
64192,2034,2312,45872,18320,3.7407e+13,959.577,8506.84,64192,564,407,61880,61849,61341,60402,59337
35184,24,1833,24592,10592,3.5016e+13,707.301,5713.57,35184,487,366,21240,15268,11423,4830,2832
81608,1207,3042,58010,23598,3.6905e+13,955.034,10885.1,81608,654,518,78566,77314,70923,57962,51640
55395,1849,2342,38088,17307,3.42928e+13,743.731,7974.35,55395,435,435,53053,52830,52860,52745,48165
42403,56,1819,29071,13332,3.5876e+13,563.124,6358.35,42403,446,343,30160,25154,18087,7805,5248
77633,940,3609,53225,24408,3.48519e+13,914.127,11510,77633,489,552,73536,71676,58986,41125,37034
28251,1445,1627,19870,8381,3.70093e+13,703.91,4996.66,28251,409,367,26624,26419,26497,26425,25845
28662,1401,1462,20493,8169,3.79543e+13,642.122,4647.51,28662,463,292,27200,27200,27193,27196,27097
85747,1037,3482,60761,24986,3.65045e+13,901.821,12039,85747,619,673,81753,79465,71457,57589,37169
7210,455,514,4808,2402,2.3834e+13,123.388,1415.74,7210,163,114,6696,6696,6579,6193,6401
63726,1595,3369,43925,19801,3.60698e+13,950.643,10553.1,63726,680,673,60357,59650,57067,51718,43049
7434,58,766,5246,2188,3.78297e+13,236.642,1867.66,7434,187,211,5346,4493,3528,2348,952
3822,395,486,2820,1002,3.38816e+13,216.783,1081.67,3822,133,119,3336,3290,3314,3279,3187
15161,127,1292,10443,4718,3.49803e+13,371.446,3367.58,15161,254,331,11981,10272,8245,4361,1833
63599,916,2825,44355,19244,3.44513e+13,804.691,9391.96,63599,425,530,60556,59470,52820,39963,28755
6321,494,764,4503,1818,3.57235e+13,289.432,1748.41,6321,228,180,5557,5330,4910,4366,4593
30640,708,1765,21084,9556,3.56667e+13,468.713,5145.52,30640,330,359,28875,28469,25291,20611,15688
51013,2160,2454,36175,14838,3.64199e+13,765.564,8101.91,51013,542,483,48559,48554,48444,48252,46569
94869,1407,2950,66287,28582,3.49791e+13,1083.04,11304.6,94869,646,569,91919,90947,85503,74957,54762
36643,924,1520,25550,11093,3.19035e+13,774.675,5212.58,36643,395,305,34913,33964,34057,31880,24296
46535,1789,1876,32277,14258,3.19956e+13,835.902,6771.82,46535,370,480,44659,44648,44640,44564,44312
57357,1798,3263,39426,17931,3.14472e+13,817.486,9677.83,57357,531,579,54094,53738,50889,39591,36319
83587,1593,3071,57313,26274,3.38603e+13,818.485,10831.8,83587,505,604,80516,80037,75167,67109,56229
67533,2556,2770,47607,19926,3.58665e+13,1060.87,9801.36,67533,664,610,64763,64759,64594,64272,62625
2431,350,485,1844,587,3.89055e+13,100.798,852.457,2431,136,84,1946,1924,1943,1929,1719
30854,1187,1984,21774,9080,3.42603e+13,534.303,5899.61,30854,407,341,28870,28599,28198,27552,21325
20175,1157,1568,14388,5787,3.65107e+13,471.806,4370.03,20175,260,294,18607,18338,18409,18351,15494
30459,2058,2154,21585,8874,3.5814e+13,609.737,6259.58,30459,345,402,28305,28294,28300,28296,27457
96338,326,3306,65995,30343,3.42821e+13,827.591,11773.1,96338,594,455,87804,80795,48400,22135,19685
41772,2053,2371,30267,11505,3.74119e+13,740.456,7463.43,41772,500,462,39401,39400,39219,39043,37664
24711,1247,1763,17549,7162,3.6444e+13,628.963,4875.93,24711,427,304,22948,22557,22039,21257,20103
33129,422,1901,23654,9475,3.63947e+13,642.05,5712.99,33129,457,328,30211,28847,24380,16994,12153
65364,552,2663,44407,20957,3.51602e+13,1040.28,8661.69,65364,461,553,61137,59288,38372,24323,23531
20873,922,1682,14083,6790,3.44196e+13,459.458,4645.57,20873,301,471,19191,18985,18458,17493,11790
56572,240,2556,39438,17134,3.67044e+13,842.993,8203.93,56572,566,485,48361,43069,30278,12175,11913
18505,1277,1332,13380,5125,3.67532e+13,512.248,3727.06,18505,353,266,17173,17115,17102,17059,17031
95822,184,3213,68079,27743,3.68566e+13,1211.03,12323.7,95822,793,583,81506,72074,52139,16561,11722
78618,707,3004,54678,23940,3.62229e+13,936.603,9639.55,78618,549,494,74837,73181,52785,40312,36023
63786,906,3266,45697,18089,3.76421e+13,864.496,10776.4,63786,549,585,60097,58369,51887,32735,27202
65402,1902,3270,45756,19646,3.61031e+13,810.434,10106.2,65402,547,496,62132,61712,58232,50737,46142
58678,1667,3238,41300,17378,3.53222e+13,819.473,9851.94,58678,512,577,55440,55044,51517,44504,34691
24665,1493,1812,17171,7494,3.58361e+13,507.33,5049.94,24665,335,317,22853,22851,22336,21553,20992
72550,69769,72550,0,72550,15.9998,0,72550,72550,72550,1,0,0,0,0,0
19535,435,1383,13495,6040,3.26466e+13,362.349,3733.29,19535,300,218,18114,17293,14238,10322,8751
85979,2386,3269,60412,25567,3.6282e+13,1057.13,11519.1,85979,662,593,82710,82585,81568,79854,71301
78029,319,3235,55668,22361,3.64145e+13,1023.71,11442,78029,616,645,70335,64197,48319,26054,15060
84799,2982,3022,58844,25955,3.40312e+13,1112.46,11034.4,84799,569,601,81777,81777,81765,81774,81676
90609,2526,2790,64403,26206,3.73412e+13,990.77,10112,90609,615,466,87819,87756,87649,87405,85589
98632,494,2753,69756,28876,3.56638e+13,1279.21,11415.5,98632,615,497,91942,87111,63003,37710,27242
94026,1459,2569,66419,27607,3.54934e+13,916.447,10306.8,94026,675,477,91457,90964,87120,78732,75191
56969,1828,3054,39091,17878,3.41921e+13,992.82,9306.08,56969,563,476,53915,53288,50932,42028,39217
13478,901,1390,9763,3715,3.77028e+13,371.335,3355.28,13478,344,208,12088,11943,11632,10794,9340
82938,1840,3386,57096,25842,3.55958e+13,908.243,11365.1,82938,545,596,79552,79216,74651,68393,58463
61813,1376,2192,44773,17040,3.6605e+13,908.706,8257.92,61813,596,418,59621,59136,56131,51967,46073
89444,1107,3967,60998,28446,3.36812e+13,993.495,12562.4,89444,712,694,85048,83231,67392,56733,47752
39698,726,1812,27852,11846,3.37567e+13,807.974,6072.86,39698,425,362,37438,36333,33549,25851,22047
29029,718,1688,21016,8013,3.73649e+13,624.866,5127.7,29029,412,312,27140,26101,24885,20941,19381
5262,225,627,3546,1716,3.58207e+13,244.268,1494.29,5262,155,183,4433,4115,3851,3175,2147
28346,1370,1805,20383,7963,3.87057e+13,613.545,5144.62,28346,442,294,26541,26525,26396,26318,24629
37637,1324,1975,26298,11339,3.56648e+13,784.311,6300.89,37637,429,389,35662,35111,34400,32105,28186
89171,41,2475,61834,27337,3.28109e+13,1394.34,10606.2,89171,544,623,61601,46140,35954,11747,5911
63557,857,2594,43761,19796,3.56087e+13,883.014,8770.49,63557,506,411,60324,57528,44544,32537,34326
43633,1011,2214,31222,12411,3.68307e+13,847.786,7255.78,43633,519,361,41262,40372,36683,26832,22711
85504,3805,3827,58811,26693,3.56367e+13,885.795,12527.7,85504,618,650,81677,81677,81676,81675,81653
40320,1530,2247,28437,11883,3.43667e+13,798.409,6863.03,40320,438,371,38073,37778,37054,35488,28582
77271,1154,2867,55201,22070,3.7062e+13,1084.54,10186.3,77271,630,479,74020,72234,66091,52606,47402
33817,662,1377,23075,10742,3.4946e+13,844.675,5372.5,33817,389,424,31582,29572,27570,20696,20107
6169,511,593,4246,1923,3.52907e+13,275.076,1558.04,6169,170,173,5576,5576,5433,5385,5310
14956,1097,1447,10898,4058,3.61755e+13,493.858,3645.08,14956,328,253,13509,13451,13025,12566,11442
36169,495,1619,25126,11043,3.55356e+13,785.381,5615.66,36169,380,382,33645,32097,28796,21110,16057
11853,160,1368,8239,3614,3.44992e+13,341.603,3167.37,11853,331,232,9735,8624,6099,3824,2491
66251,904,2688,45636,20615,3.58961e+13,1014.7,9162.71,66251,522,532,62844,60162,49475,37045,39853
33752,2167,2276,22917,10835,3.3758e+13,529.458,6327.46,33752,359,428,31476,31475,31413,31220,31202
2738,361,456,1793,945,3.29478e+13,79.3565,902.777,2738,110,83,2282,2279,2240,2268,2176
14236,1223,1317,10405,3831,3.77677e+13,539.063,3348.7,14236,316,273,12919,12913,12850,12865,12749
19968,536,1676,14178,5790,3.70673e+13,370.658,4452.16,19968,350,278,18164,17400,13461,9511,7503
75197,1414,2756,53090,22107,3.4864e+13,1158.03,10016.4,75197,603,620,72358,71089,68706,62979,54291
94482,679,3324,66370,28112,3.58326e+13,1103.34,12735.6,94482,744,577,88900,85767,70826,47068,34643
68130,462,3170,47459,20671,3.52489e+13,866.527,10408,68130,520,598,63051,60294,48764,39084,20505
58799,1965,2638,40604,18195,3.44861e+13,920.053,8691.1,58799,576,516,56161,55890,54266,47106,48434
9096,627,1279,6541,2555,3.89205e+13,275.242,2703.28,9096,210,210,7817,7653,7490,7482,4852
72351,3269,3738,50267,22084,3.53667e+13,946.082,11914.4,72351,676,721,68613,68612,68397,68369,65250
54767,1601,3000,38794,15973,3.66638e+13,749.249,9230.2,54767,721,499,51767,51233,47468,38251,36285
10737,322,912,7569,3168,3.63911e+13,384.003,2416.03,10737,230,190,9417,8630,8104,6550,5080
28098,21774,28098,0,28098,15.9994,0,28098,28098,28098,1,0,0,0,0,0
5035,767,851,3654,1381,3.91915e+13,173.422,1662.98,5035,151,163,4184,4184,4180,4179,3964
14799,531,1474,10400,4399,3.83479e+13,526.686,3730.41,14799,362,345,13004,12547,10984,9020,6497
21755,174,1527,15354,6401,3.62747e+13,499.429,4236.69,21755,351,339,17901,15850,11730,5973,5657
80072,2113,4465,54499,25573,3.41784e+13,737.655,13310.2,80072,479,786,75607,75344,72912,68965,43860
81131,1937,2753,58628,22503,3.65148e+13,1036.1,10430.7,81131,726,488,78378,78366,77011,73931,73031
22111,1472,1815,15128,6983,3.55531e+13,414.77,4676.28,22111,337,268,20296,20271,20172,20169,19035
98765,1568,3661,69375,29390,3.52751e+13,1226.28,13048.3,98765,753,525,95008,93530,83323,58556,52285
24992,1236,1828,17350,7642,3.53209e+13,647.102,5193.62,24992,423,352,23164,22576,21842,19827,18745
68909,919,1582,47943,20966,3.28879e+13,1020.81,7289.72,68909,468,407,66513,64079,61323,49768,46657
16915,1688,1768,12145,4770,3.67826e+13,412.136,4222.89,16915,441,273,15147,15147,15147,15147,14959
20587,57,1329,14523,6064,3.36619e+13,596.701,3960.07,20587,304,275,15345,12125,9330,2879,2126
7601,519,804,5200,2401,3.56185e+13,209.928,1958.37,7601,158,241,6797,6792,6707,6560,4255
76686,2658,3253,53930,22756,3.53147e+13,1062.01,11566.4,76686,601,543,73433,73384,72831,70755,69296
83614,1318,2740,59636,23978,3.79059e+13,1123.14,10755.1,83614,608,531,80663,79667,74812,62431,53190
86544,1691,3684,59548,26996,3.44376e+13,1033.3,12875.1,86544,522,720,82860,81616,77674,68524,51430
50208,1736,1990,35503,14705,3.62211e+13,752.283,6930.3,50208,468,446,48218,48216,47641,46332,46245
40808,281,1970,29463,11345,3.75021e+13,796.78,6535.58,40808,440,409,36860,32288,26569,20240,8918
71330,1008,3233,49369,21961,3.52121e+13,728.414,10774.8,71330,665,473,67935,66972,50086,40079,32931
2925,90,404,2103,822,3.6331e+13,190.896,866.023,2925,119,106,2182,1813,1740,1516,992
28529,1161,1667,19242,9287,3.3557e+13,364.143,4771.29,28529,248,310,26862,26812,26695,26544,22877
66243,137,3142,47110,19133,3.65953e+13,974.908,10525.1,66243,562,472,53591,46722,34936,9944,8264
87203,2935,3491,60764,26439,3.57426e+13,934.338,11862.5,87203,771,427,83712,83711,82189,78712,78846
47913,1791,2798,33020,14893,3.54292e+13,897.964,8368.25,47913,436,480,45115,44560,43934,42342,33842
72093,965,2813,49280,22813,3.52234e+13,918.351,9508.17,72093,552,449,69023,67786,56887,42214,40410
23133,56,1446,15997,7136,3.5336e+13,557.955,4353.82,23133,338,316,16887,14240,10098,4284,2658
47419,1021,2680,33577,13842,3.66648e+13,828.578,8282.28,47419,476,430,44473,43781,40549,33123,23494
46639,458,2205,32532,14107,3.62798e+13,883.049,6729.25,46639,496,412,43233,41317,27719,19282,18336
19702,1242,1400,13792,5910,3.70699e+13,586.873,4088.94,19702,368,308,18302,18301,18182,18015,17622
66591,529,2755,46290,20301,3.67945e+13,918.937,9329.18,66591,528,483,62662,60882,38430,27510,15378
35931,1855,2019,25328,10603,3.62327e+13,693.903,6083.58,35931,381,438,33912,33718,33820,33631,32796
24502,1522,1706,17491,7011,3.74449e+13,561.91,4896.13,24502,432,310,22796,22727,22749,22736,21986
22111,993,1681,15300,6811,3.48523e+13,342.497,4503.56,22111,381,258,20430,20303,19539,17452,16531
39886,851,2156,27103,12783,3.45055e+13,659.362,6477.48,39886,369,364,37666,36965,32455,23741,21913
79653,2643,2876,54066,25587,3.50377e+13,997.644,10460.2,79653,501,582,76777,76776,76627,76705,75870
54696,2133,2729,37518,17178,3.53158e+13,679.355,8780.64,54696,431,509,51967,51927,51527,51165,47150
32607,320,2205,22892,9715,3.34457e+13,484.342,6290.2,32607,504,276,29296,27017,17773,12640,7371
61496,1731,3231,42562,18934,3.37203e+13,1133.34,9950.35,61496,652,773,58148,57125,53102,42081,45965
52671,1678,2135,37943,14728,3.66624e+13,1074.93,7846.95,52671,590,458,50536,49952,49804,48264,47868
1459,349,397,997,462,3.73461e+13,71.721,652.28,1459,81,96,1062,1062,1060,1062,1024
79964,60,2843,56606,23358,3.54648e+13,947.787,9857.61,79964,552,542,58259,48017,38193,13857,6815
95613,257,2966,66612,29001,3.59043e+13,1085.61,11209.5,95613,640,554,83807,75277,50191,18754,18338
14315,840,1048,9874,4441,2.88472e+13,248.638,2829.48,14315,202,227,13267,13176,13206,13087,10942
77660,1232,3072,55116,22544,3.72018e+13,1029.61,10744.3,77660,692,476,74461,72821,65981,48281,48421
43530,1615,2526,29858,13672,3.35015e+13,524.379,7495.94,43530,529,467,41004,40875,40127,39221,33227
58662,821,1713,41598,17064,3.55113e+13,856.745,7003.23,58662,461,398,56391,54294,49286,44720,28458
40359,1780,2101,28407,11952,3.49803e+13,784.26,6539.11,40359,421,405,38258,38234,38082,37998,35707
71538,2300,3632,50046,21492,3.55089e+13,765.13,11570.1,71538,500,691,67906,67860,66914,66070,50770
72797,2427,3391,50233,22564,3.51797e+13,856.613,10991,72797,487,515,69406,69332,68126,66551,61472
61221,605,2820,42277,18944,3.56537e+13,728.879,9029.94,61221,508,454,57492,53968,37368,25994,20261
98743,2989,3333,69832,28911,3.60084e+13,1222.27,12537.5,98743,651,652,95410,95404,95149,94878,93633
22812,335,1311,16423,6389,3.78912e+13,598.193,4074.59,22812,318,280,20304,19027,17488,16281,8194
1437,211,372,984,453,3.14479e+13,129.706,628.826,1437,101,91,1065,940,945,997,789
42722,1417,1930,29345,13377,3.56696e+13,532.502,6081.46,42722,432,399,40792,40667,40079,39093,34289
1015,54,218,790,225,3.88271e+13,35.0818,385.49,1015,74,56,777,684,632,594,181
87191,875,2762,60732,26459,3.44418e+13,1068.29,10914.2,87191,496,522,83366,81137,74909,54082,41836
61317,1461,2296,43518,17799,3.62434e+13,987.392,8315.27,61317,544,397,59021,58320,54342,46337,45818
55484,962,2549,38898,16586,3.63383e+13,716.163,8209.15,55484,467,422,52897,52099,44386,33015,34457
60356,77,2565,41996,18360,3.64808e+13,1125.12,8889.61,60356,483,571,46361,39949,28344,10210,5031
57804,1453,2800,40824,16980,3.62518e+13,861.014,8754.54,57804,600,393,55004,54512,51079,42415,39739
73298,2083,3297,50157,23141,3.46691e+13,990.839,10867.8,73298,568,516,70001,69627,67361,62936,55602
12328,934,1273,8512,3816,3.70048e+13,287.124,3197.25,12328,195,343,11055,11049,10931,10944,9489
31685,170,1956,22322,9363,3.67395e+13,366.761,5403.65,31685,283,339,26603,22187,18517,12173,6482
31667,1954,2084,21479,10188,3.48579e+13,450.292,5970.24,31667,433,334,29583,29583,29402,29059,29142
28095,2070,2133,19859,8236,3.60555e+13,605.286,5955.95,28095,347,448,25962,25962,25939,25920,25684
18979,1336,1338,13067,5912,3.64741e+13,398.895,3850.94,18979,252,341,17641,17641,17641,17641,17641
28055,1025,1898,19897,8158,3.72992e+13,527.62,5261.51,28055,356,332,26157,25737,24930,23943,18369
1750,93,446,1282,468,4.17525e+13,52.564,736.044,1750,102,90,1304,1226,1083,1007,319
2846,34,683,2052,794,3.89737e+13,83.5295,1148.61,2846,128,109,1908,1617,1139,399,315
46297,909,2158,32412,13885,3.52132e+13,800.093,7096.4,46297,423,392,43930,43336,38264,28549,25998
68527,2406,2998,47435,21092,3.56887e+13,929.624,10125.3,68527,599,628,65529,65493,64676,62794,62076
36059,1859,2192,25082,10977,3.24342e+13,633.251,6545.33,36059,347,426,33867,33769,33753,33705,31245
26403,203,1854,18591,7812,3.62454e+13,578.038,5176.78,26403,315,394,22657,20019,15682,9297,5783
91192,2824,2993,63801,27391,3.66751e+13,935.418,11312.4,91192,546,522,88199,88199,88168,88101,87207
78132,821,2804,55705,22427,3.68617e+13,1298.77,10468.2,78132,578,528,73943,71650,59612,39934,34154
51304,2195,2744,35720,15584,3.60294e+13,856.608,8810.71,51304,495,589,48560,48444,48049,47846,44617
37915,287,2185,26298,11617,3.54415e+13,508.804,6671.24,37915,486,370,33749,30003,22424,10660,8199
64635,15172,64635,0,64635,15.9998,0,64635,64635,64635,1,0,0,0,0,0
69374,1153,2552,47851,21523,3.55412e+13,848.054,8836.82,69374,525,402,66773,65870,58547,44749,46254
80219,2134,3006,54464,25755,3.41758e+13,584.769,10046.7,80219,520,441,77213,77151,75645,71087,70430
28087,793,2263,19510,8577,3.61091e+13,407.614,5970.03,28087,291,406,25824,25488,23928,21558,15877
49079,868,2209,34661,14418,3.6652e+13,1055.2,7577.91,49079,560,442,46254,45356,41035,31717,24623
67431,3069,3180,47067,20364,3.68985e+13,1110.25,10562.8,67431,616,697,64251,64250,64219,64228,63970
57963,453,2391,41165,16798,3.56606e+13,978.188,8303.69,57963,565,437,52810,49677,33872,17790,17694
84413,2518,2814,59601,24812,3.58803e+13,1148.56,10849.6,84413,553,569,81599,81576,81240,80605,79956
81910,1125,2664,58795,23115,3.66448e+13,1042.42,10465.3,81910,598,486,78873,76723,69483,47991,46447
87225,3073,3208,60970,26255,3.45683e+13,1158.96,11464.5,87225,668,593,84017,84017,83978,83983,83681
94547,2675,3208,66056,28491,3.60776e+13,1145.92,12183.9,94547,756,630,91339,91284,89999,87933,85041
41303,1433,2159,28451,12852,3.37512e+13,718.349,6843.15,41303,496,399,39144,38971,37748,35217,34603
54471,985,2045,40072,14399,3.65076e+13,943.507,7779.93,54471,572,373,51957,49358,45720,28649,29234
78110,1714,3692,53199,24911,3.46466e+13,1053.23,12237.8,78110,779,690,74418,73629,67062,58938,52536
27543,1666,1741,18556,8987,3.3893e+13,475.362,5247.86,27543,315,394,25802,25781,25791,25802,25645
49919,1969,2240,34727,15192,3.69458e+13,789.381,7657.39,49919,470,400,47679,47677,47274,46844,46075
30318,223,1968,21448,8870,3.70494e+13,624.039,5679.48,30318,484,348,26196,23248,17747,12360,7329
53645,1052,2462,36746,16899,3.3401e+13,597.16,7900.93,53645,392,440,51183,50720,46508,39138,30275
11452,833,1074,8188,3264,3.57539e+13,489.837,2728.3,11452,284,247,10378,10154,10085,9701,8971
17384,666,1837,12598,4786,3.74815e+13,428.348,4452.76,17384,372,333,15537,15136,14170,12114,7803
37077,335,1015,25714,11363,3.06729e+13,597.704,4179.43,37077,314,299,34779,33338,28584,17654,13250
29298,231,1859,20420,8878,3.65453e+13,686.255,5597.11,29298,398,314,24723,22439,15032,8083,5391
21826,1490,1847,14951,6875,3.42007e+13,450.738,4800.59,21826,394,299,19979,19969,19844,19710,18772
71900,808,3367,50895,21005,3.66444e+13,1057.5,10971.5,71900,616,443,67327,65344,48844,33590,26709
50235,121,2340,34025,16210,3.28246e+13,585.293,7462.18,50235,382,352,42310,38199,23966,7663,6200
7981,494,957,5587,2394,3.78565e+13,365.341,2252.74,7981,240,224,6991,6662,6387,5886,4683
96737,1745,3521,68890,27847,3.59503e+13,1224.42,12970.8,96737,870,608,92998,91913,85636,67952,62468
7584,1020,1076,5200,2384,3.3222e+13,215.077,2259.56,7584,237,226,6508,6508,6499,6504,6463
72883,3344,3411,50990,21893,3.62365e+13,860.204,11259.7,72883,792,455,69472,69472,69472,69472,69172
53541,206,2718,37038,16503,3.43111e+13,660.965,8479.54,53541,544,362,46249,41355,28023,13147,10454
66941,1755,2781,46898,20043,3.52576e+13,932.755,9711.27,66941,629,411,64160,63574,61331,54588,54073
92455,1591,3780,64507,27948,3.62331e+13,1265.37,13353.7,92455,751,663,88513,86970,77671,59584,51717
39625,1858,2268,27084,12541,3.31342e+13,638.089,6801.09,39625,375,379,37357,37336,37223,36993,33628
84783,102,2859,58584,26199,3.43901e+13,1031.25,10580.9,84783,690,533,69872,61905,41625,12352,8476
35797,672,2220,24619,11178,3.37869e+13,451.923,6185.8,35797,402,359,33562,32778,24741,18268,11173
8017,77,818,5425,2592,3.55189e+13,304.807,2096.64,8017,199,191,5908,4965,3810,2053,1624
47336,1720,2062,32241,15095,3.54051e+13,958.186,7226.48,47336,427,446,45274,44997,44551,43137,43410
57118,2866,2884,38779,18339,3.30563e+13,737.306,9320.96,57118,484,466,54234,54234,54234,54234,54136
13145,863,1032,9142,4003,3.30322e+13,327.372,2824.44,13145,299,202,12113,12074,12021,12008,11535
60266,1952,2242,42346,17920,3.66031e+13,989.702,8176.76,60266,503,422,58024,57986,57915,57986,57027
88619,1979,3330,62058,26561,3.61416e+13,1007.65,11694.7,88619,665,467,85289,84947,81166,72790,68930
15269,459,1323,10456,4813,3.5306e+13,315.458,3365.61,15269,256,256,13946,13641,10057,7129,5161
74030,462,2414,50696,23334,3.46596e+13,619.605,8415.25,74030,461,371,71052,69331,47871,31685,23062
84557,553,3376,59627,24930,3.6341e+13,1282.34,11925.7,84557,641,708,78434,74584,54995,38481,26054
17520,762,1469,11921,5599,3.41711e+13,424.85,4070.21,17520,314,374,16051,15687,15121,14570,10082
36552,2365,2491,25479,11073,3.57662e+13,700.42,7384.85,36552,393,525,34061,34061,34009,34047,33699
1545,235,274,1164,381,2.87842e+13,78.0893,569.921,1545,106,54,1271,1270,1208,1238,1164
64262,446,2633,46141,18121,3.7513e+13,968.23,9662.95,64262,743,495,58867,55986,43158,27766,17995
31819,794,1861,22803,9016,3.65432e+13,784.929,5656.7,31819,505,343,29479,28562,27286,22560,19382
52936,2043,2661,37479,15457,3.58613e+13,782.272,8709.33,52936,543,542,50275,50266,49793,48953,42910
72451,1682,2509,51216,21235,3.72326e+13,1208.01,9375.89,72451,533,525,69942,68559,68205,64410,59625
28530,681,1778,20282,8248,3.70073e+13,509.668,5357.5,28530,390,337,26641,25831,21893,15322,12835
1093,87,227,806,287,4.40378e+13,44.3843,410.685,1093,66,55,866,836,812,763,325
46480,233,2807,32068,14412,3.57869e+13,847.736,8683.26,46480,473,629,40230,35516,26105,13346,8063
56780,1437,2332,39153,17627,3.56067e+13,877.894,7641.68,56780,475,388,54448,53917,50618,45609,43679
59197,986,2515,41723,17474,3.67088e+13,967.486,8521.96,59197,679,449,56260,54533,49205,38734,38047
24669,540,2015,17087,7582,3.52492e+13,533.116,5324.67,24669,365,392,22481,21246,18970,14990,11533
23637,742,1738,16238,7399,3.38719e+13,372.05,4687.25,23637,333,275,21899,21686,17687,12624,10414
42858,1506,2257,30287,12571,3.58365e+13,861.636,7168.46,42858,533,411,40601,40088,39115,35138,35412
65103,3041,3094,46262,18841,3.61066e+13,1036.79,10243.6,65103,495,516,62009,62009,62003,62007,61844
70535,2453,3428,49859,20676,3.64644e+13,969.741,11196.7,70535,711,493,67107,67016,65427,62506,57938
72967,652,2889,50299,22668,3.25682e+13,997.204,9860.84,72967,468,504,68905,67038,53412,37027,26647
38581,481,2257,27547,11034,3.63161e+13,740.865,7035.37,38581,557,342,35052,33337,22663,16743,11525
19137,1413,1455,13759,5378,3.69822e+13,567.572,4031.02,19137,312,314,17682,17666,17649,17668,17596
54707,100,2056,39034,15673,3.65373e+13,879.743,7486.26,54707,528,388,42561,36973,28600,8945,6535
73247,2983,3112,51266,21981,3.62145e+13,870.523,10579.4,73247,577,496,70135,70135,70115,70127,69656
86497,2888,3266,61157,25340,3.62375e+13,920.245,11674.4,86497,712,415,83231,83230,83037,82907,81263
98649,81399,98649,0,98649,15.9998,0,98649,98649,98649,1,0,0,0,0,0
86899,2409,3232,61735,25164,3.67946e+13,1252.85,11591.5,86899,626,554,83667,83153,82674,80531,76467
16372,1156,1237,11254,5118,3.63586e+13,415.373,3463.82,16372,239,343,15135,15135,15105,15085,14930
83179,1059,2585,57935,25244,3.56955e+13,1044.05,9856.62,83179,561,526,80234,79149,68478,50794,52585
68685,1720,2545,48368,20317,3.68043e+13,1039.06,9386.01,68685,585,453,66140,65804,62393,53466,55166
99385,845,3444,67855,31530,3.52384e+13,848.546,11765.3,99385,606,530,95440,93836,61239,45627,35377
56207,3506,3660,38681,17526,3.40609e+13,699.706,10567.4,56207,691,503,52547,52547,52394,52054,52083
57028,1095,2033,39744,17284,3.35666e+13,955.353,7528.67,57028,579,389,54796,52999,51550,45946,37885
70273,2087,2684,49141,21132,3.53008e+13,1065.8,9641.47,70273,536,473,67589,67414,66847,65554,61816
70596,2136,2621,50477,20119,3.66169e+13,1041.04,9389.76,70596,689,571,67975,67856,67149,65859,63164
14736,406,1530,10394,4342,3.35437e+13,355.807,3557.59,14736,267,257,13081,12460,11204,9252,4511
73220,455,2692,51384,21836,3.49213e+13,929.024,9851.48,73220,582,505,67128,63398,46351,29742,18784
43601,1132,1797,29857,13744,3.2755e+13,760.758,6579.81,43601,419,357,41751,41183,39254,35319,31402
95543,1409,4045,65757,29786,3.53271e+13,968.762,13537.9,95543,727,515,91498,90317,72163,57891,54979
71854,428,2435,50832,21022,3.63523e+13,853.144,9215.1,71854,546,383,65710,61241,45049,30539,17836
64361,2103,2538,45001,19360,3.33251e+13,995.104,8878.21,64361,460,454,61823,61817,61158,59649,55162
28095,1375,1380,19935,8160,3.62745e+13,677.337,4541.36,28095,340,299,26715,26715,26715,26715,26711
58551,78,2858,39765,18786,3.45533e+13,1032.92,9082.51,58551,581,478,44666,38301,25140,11030,5842
69192,1391,2011,48136,21056,3.5778e+13,916.643,8029.38,69192,437,466,67181,66730,65485,61577,61364
31203,1457,1620,21519,9684,3.61919e+13,466.981,4828.03,31203,309,351,29583,29583,29530,29546,29099
99973,2502,3088,68694,31279,3.54919e+13,1043.45,11126.3,99973,567,520,96885,96877,96012,94076,90867
5536,525,867,4006,1530,3.75276e+13,264.194,1752.24,5536,244,145,4669,4419,4401,4166,3389
91715,785,3006,62716,28999,3.48519e+13,1089.77,10627.7,91715,552,553,87479,84869,55347,44130,42399
68945,1624,3187,47574,21371,3.61063e+13,972.16,10338.9,68945,536,511,65758,64868,62923,56646,49313
62508,2028,2297,43430,19078,3.33199e+13,811.197,8374.91,62508,611,434,60211,60198,59904,59912,57533
25210,1048,1662,17390,7820,3.51925e+13,631.521,4792.18,25210,360,379,23548,22912,21986,19273,20608
37349,1263,1454,25717,11632,3.01064e+13,550.849,4968.18,37349,370,300,35895,35872,35841,35790,34914
81587,2335,3243,56497,25090,3.42556e+13,1089.16,11381.5,81587,729,655,78344,78265,76234,72588,70388
29363,1251,1690,20315,9048,3.19339e+13,424.801,5094.58,29363,349,325,27673,27529,26650,25009,23059
26408,736,1761,18419,7989,3.56328e+13,599.201,5118.18,26408,385,305,24469,23861,19855,14783,12477
16616,1009,1578,12113,4503,3.86866e+13,384.188,3793.73,16616,330,194,15038,14883,14686,14204,12569
87203,978,3273,62569,24634,3.62866e+13,1049.36,12018.5,87203,565,566,83117,80744,70489,50105,30821
28286,1066,1824,19655,8631,3.64668e+13,646.648,5415.68,28286,363,457,26462,25687,25411,24586,15381
44663,2034,2058,30841,13822,3.36719e+13,607.996,6742.3,44663,500,408,42605,42605,42599,42590,42457
67338,2800,3313,47465,19873,3.55982e+13,905.066,10518.5,67338,625,524,64025,63857,63566,62329,59306
45512,1370,2983,31278,14234,3.50384e+13,578.692,8575.78,45512,507,543,42529,42338,37245,26207,22058
79166,1679,2979,56424,22742,3.69905e+13,1002.16,10544.9,79166,648,421,76187,75574,71739,61507,55615
97097,2408,3321,67101,29996,3.28454e+13,1075.9,12375.5,97097,538,526,93776,93538,93292,93076,82003
88093,2487,3097,63211,24882,3.70028e+13,1018.09,11405.2,88093,615,663,84996,84963,84558,84009,79803
13678,629,1116,9565,4113,3.77625e+13,360.082,2964.94,13678,236,229,12562,12427,12207,12088,10824
15355,456,1089,10422,4933,3.52259e+13,353.832,3126.88,15355,259,276,14219,13912,11363,8640,9514
94143,1407,2970,67777,26366,3.71135e+13,1174.94,11649.9,94143,659,577,90943,88594,85001,70584,62662
4833,515,743,3406,1427,3.711e+13,173.026,1562.03,4833,151,154,4090,4087,4028,4027,3232
85615,2036,2939,59177,26438,3.4232e+13,1113.15,10841.2,85615,596,527,82676,82543,79936,72254,70882
21925,1415,1951,15684,6241,3.87158e+13,334.368,4856.32,21925,312,344,19974,19970,19787,19883,17482
11645,1319,1322,8175,3470,3.62894e+13,378.252,3107.96,11645,303,222,10323,10323,10323,10323,10323
21339,466,1374,14916,6423,3.60049e+13,417.827,3832.02,21339,324,240,19875,19432,16156,12825,12424
72685,1868,2642,51357,21328,3.62534e+13,1124.46,9712.98,72685,663,512,70043,69646,68601,65884,59114
37076,241,2440,25796,11280,3.64501e+13,798.76,7017.71,37076,458,437,31960,29097,22091,10929,7707
34194,223,2181,24639,9555,3.68903e+13,665.235,6541.8,34194,467,290,29448,26128,19177,10174,7137
26973,1625,1799,18478,8495,3.47669e+13,487.656,5145.07,26973,381,370,25174,25174,25154,25156,24801
86462,1022,3964,58443,28019,3.3786e+13,958.894,12638.9,86462,632,608,82063,80398,58602,49322,36196
95697,2073,3118,65870,29827,3.35154e+13,1098.64,11580,95697,565,546,92579,92128,89718,81389,79027
8392,654,1012,5835,2557,3.57955e+13,236.618,2301.18,8392,165,205,7380,7312,7285,7270,5973
78828,2855,3165,54134,24694,3.51007e+13,929.117,10789.5,78828,575,569,75663,75649,75284,74845,71446
94076,1949,3822,65646,28430,3.53556e+13,1115.32,13638.2,94076,617,769,90254,89317,86475,77765,49988
31844,1589,1946,22561,9283,3.57764e+13,599.042,5796.41,31844,504,340,29898,29894,29022,26270,26841
20831,441,1333,15282,5549,3.65209e+13,576.313,3950.5,20831,267,279,19139,18394,16579,14492,9402
49827,414,2766,34797,15030,3.66986e+13,700.262,8689.76,49827,402,536,45358,42431,36464,24897,14494
39482,2578,2760,28259,11223,3.73854e+13,664.104,7928.14,39482,389,542,36722,36714,36682,36697,35629
57571,2612,2706,40713,16858,3.64568e+13,1003.39,9199.84,57571,671,589,54865,54865,54791,54628,54541
68187,1098,2706,47128,21059,3.38821e+13,930.342,9594.13,68187,483,559,65223,63798,58426,47316,40271
93500,1644,2410,66093,27407,3.60885e+13,1025.18,9853.3,93500,610,454,91090,90635,87338,74606,79585
68171,1712,2967,48497,19674,3.5673e+13,965.513,10174.3,68171,642,516,65204,64766,62057,54446,50166
6894,518,881,4709,2185,3.68315e+13,258.13,2018.17,6894,181,237,6013,5906,5690,5174,4290
88990,793,3180,62134,26856,3.49272e+13,944.823,11494.5,88990,661,495,84685,82674,68404,44120,34556
76947,1422,2510,53269,23678,3.27693e+13,1121.72,9790.02,76947,537,484,74372,72691,69906,61266,58688
96446,2910,4145,67220,29226,3.53304e+13,978.02,13940.8,96446,607,770,92301,92266,90681,89175,81834
97087,2519,3229,67129,29958,3.45924e+13,828.761,11066.3,97087,630,461,93858,93845,92455,91206,81156
66201,2729,3756,45402,20799,3.56797e+13,881.679,10863.3,66201,659,546,62445,62396,61555,60170,56721
18478,389,1818,12893,5585,3.78195e+13,433.13,4462.54,18478,316,359,16308,15189,12869,10568,6787
90266,2124,3167,62541,27725,3.45484e+13,1051.65,11624.4,90266,557,591,87099,86769,85119,80433,74223
95986,31,2736,68420,27566,3.63888e+13,1104.07,10877.8,95986,578,581,63021,48802,39836,11117,7273
94845,127,4486,65068,29777,3.47595e+13,881.779,14006.5,94845,744,548,77667,69195,45040,15543,8713
27859,1985,2229,19438,8421,3.54953e+13,560.561,5827,27859,401,527,25630,25630,25490,25539,24924
33262,1882,1915,22963,10299,3.64162e+13,669.113,6109.8,33262,502,434,31347,31347,31341,31346,31276
95374,2316,3278,66634,28740,3.6838e+13,1176.53,11760.5,95374,637,526,92096,91800,88843,80735,81498
13426,416,1302,9175,4251,3.44297e+13,359.176,3283,13426,243,267,12019,11512,9199,7495,5681
12161,357,1023,8167,3994,3.47855e+13,286.964,2691.32,12161,265,189,11108,10663,8870,7421,7283
27877,1135,2410,19551,8326,3.65767e+13,457.046,6328.68,27877,372,435,25467,25206,23362,21697,14937
96204,2832,3577,66329,29875,3.53371e+13,1025.16,12625.7,96204,603,688,92627,92622,92020,91257,85113
92723,2463,3171,64075,28648,3.50883e+13,1303,11973.5,92723,707,631,89552,89283,86306,78971,77412
75794,1477,2968,53291,22503,3.61083e+13,1075.82,10580.9,75794,580,534,72826,71713,67524,58920,50154
14616,541,1385,10168,4448,3.61606e+13,437.553,3537.65,14616,254,283,13029,12516,11546,8444,7250
26521,1859,2202,18198,8323,3.64131e+13,677.45,5775.33,26521,427,619,24319,24118,24066,23884,22789
37337,1190,1669,26903,10434,3.62952e+13,755.204,5781.29,37337,476,352,35668,34853,34194,33373,31136
93454,1978,2121,64416,29038,3.06986e+13,781.715,8888.57,93454,479,361,91333,91332,91299,91289,90481
87554,797,2735,62261,25293,3.66282e+13,1164.28,10595.8,87554,683,460,83257,80535,59964,38699,32317
92535,3096,3208,63676,28859,3.41135e+13,1002.9,11971.8,92535,614,444,89327,89325,89311,89310,88301
60986,1479,2341,43098,17888,3.66115e+13,825.724,8153.67,60986,521,413,58645,58499,56603,52454,51915
70946,898,3041,48405,22541,3.37072e+13,745.71,10008.4,70946,527,428,67725,66624,50219,37025,29068
16308,1238,1329,11594,4714,3.69634e+13,638.49,3716.7,16308,401,250,14979,14979,14766,14667,14402
62011,2366,2579,43493,18518,3.55483e+13,970.519,9016.21,62011,579,520,59432,59432,59112,58482,58578
93603,1037,2359,67572,26031,3.70116e+13,1158,10653.5,93603,629,511,90110,86805,77421,52264,52057
8555,744,1283,6343,2212,3.43857e+13,225.805,2683.41,8555,280,152,7272,7262,6772,5573,4636
30471,1172,1827,20804,9667,3.4801e+13,477.448,5475.35,30471,371,334,28644,28598,27255,24626,23684
3162,167,465,2181,981,3.56178e+13,173.82,1006.22,3162,120,118,2561,2240,2239,2213,992
76139,2213,3030,54161,21978,3.68234e+13,1082.58,10552.3,76139,686,503,73109,72968,72163,68118,68539
12459,213,1004,8725,3734,3.74173e+13,288.293,2576.63,12459,205,210,10701,9259,7240,5805,5674
4584,89,366,2950,1634,2.82224e+13,134.969,989.323,4584,105,95,3947,3491,1964,1606,1554
30814,353,2233,21362,9452,3.5673e+13,587.21,6294.58,30814,439,366,27296,25056,20189,13281,9991
98692,2549,3807,69344,29348,3.59858e+13,1266.25,13488.7,98692,643,643,94885,94073,92409,85852,80391
24153,579,1680,17188,6965,3.75147e+13,589.457,4781.08,24153,301,290,22089,21166,19142,13668,13042
52247,884,2885,35824,16423,3.46802e+13,917.836,8732.26,52247,560,459,48983,47933,35499,27572,23476
36360,1601,2360,25553,10807,3.53502e+13,567.187,6945.83,36360,377,508,34000,33979,33566,33480,26408
60938,1087,2543,42137,18801,3.46766e+13,845.329,8687.25,60938,538,456,58301,57242,51858,40374,36615
23288,454,1443,16717,6571,3.77871e+13,641.321,4382.01,23288,366,335,20844,19343,18508,14992,7092
72211,628,2800,49374,22837,3.24647e+13,936.94,9509.29,72211,578,492,68003,65792,44909,33790,25650
43453,651,2022,29338,14115,3.55401e+13,574.772,6581.27,43453,420,344,41262,38675,33664,25283,24627
27734,716,2264,19629,8105,3.66222e+13,477.189,6118.39,27734,395,447,25470,24837,22963,21696,10612
93738,1392,3560,64877,28861,3.49425e+13,1038.55,12300.9,93738,748,620,89895,88478,69983,54416,52281
51508,2089,2448,35554,15954,3.55211e+13,611.852,7808.07,51508,433,491,49060,49034,48955,48814,46713
81502,803,3354,55707,25795,3.46695e+13,901.947,10881.5,81502,667,450,77675,75707,47273,36866,34551
87342,872,3311,61963,25379,3.67102e+13,1218.92,11771.5,87342,721,638,82376,78806,60234,44209,39397
61811,853,2505,43582,18229,3.62643e+13,884.806,8757.99,61811,446,499,58832,57417,50089,31096,31003
43753,735,1845,30426,13327,3.51484e+13,664.193,6317.67,43753,465,345,41565,39826,34112,25527,22483
45137,1029,1750,31280,13857,3.11788e+13,840.071,6184.93,45137,477,393,43190,41932,40914,37410,30733
71481,943,2873,48316,23165,3.42737e+13,990.979,10144.9,71481,610,687,67981,66591,53977,47370,36535
70125,155,3314,48567,21558,3.55126e+13,739.373,10451.6,70125,510,620,58608,51487,35052,13172,10448
27969,1385,1738,19767,8202,3.72003e+13,572.456,5236.35,27969,404,379,26231,26217,25724,25717,22468
10742,296,1123,7609,3133,3.44765e+13,237.127,2672.59,10742,198,239,9536,8982,8206,7107,3669
37589,1794,2204,26972,10617,3.71465e+13,803.843,6856.19,37589,435,479,35385,35384,35195,34495,31373
74555,2074,2565,51295,23260,3.33895e+13,960.841,9021.27,74555,536,479,71990,71977,70692,68150,67782
12256,262,988,8735,3521,3.7438e+13,484.619,2735.98,12256,258,222,10525,9583,8070,5923,3978
47395,1474,2024,32589,14806,3.27559e+13,762.15,6968.25,47395,453,358,45371,45162,44431,43231,40717
52393,2161,2510,37323,15070,3.71452e+13,843.608,8194.56,52393,538,380,49883,49873,49776,49625,48065
91452,2147,3797,63368,28084,3.58253e+13,1117.71,12756.3,91452,784,633,87655,87020,80523,68100,67521
3733,566,718,2643,1090,3.55579e+13,88.2071,1314.54,3733,148,120,3015,3015,3006,3006,2546
3348,351,647,2449,899,3.99815e+13,134.792,1180.38,3348,175,106,2701,2634,2536,2166,1643
18171,391,1661,12301,5870,3.61693e+13,344.973,4057.7,18171,338,301,16379,15840,12610,10434,8576
63222,768,2812,44762,18460,3.70867e+13,1060.83,9519.81,63222,591,454,59101,56213,44060,31003,25683
32373,36,2329,23151,9222,3.69695e+13,428.575,6424.82,32373,365,548,21682,17191,12946,3586,2220
16703,546,1517,11623,5080,3.48048e+13,431.681,3818.92,16703,272,280,15186,14515,12866,10362,7544
61664,1752,2981,43016,18648,3.54692e+13,1040.32,9321.27,61664,554,505,58683,57781,54209,44203,46503
55965,913,2288,40077,15888,3.82863e+13,951.665,8301.94,55965,579,406,53088,51742,48575,38995,31558
64187,2106,3116,45459,18728,3.61528e+13,997.756,10202.8,64187,540,586,61071,61004,60289,59614,52492
64295,2357,2863,44481,19814,3.32561e+13,1044.87,9746.07,64295,533,586,61432,61114,60769,60016,56560
32916,895,1577,23140,9776,3.6195e+13,541.945,5292.32,32916,459,299,31339,31210,29385,25450,24195
50735,1071,3015,35903,14832,3.59958e+13,895.421,9135.88,50735,504,560,47467,45738,43028,34407,21576
21330,1388,1775,15354,5976,3.59725e+13,534.898,4762.19,21330,344,307,19555,19444,19455,19289,17958
31136,465,1867,20527,10609,3.28335e+13,660.989,5644.98,31136,366,366,28667,27861,19405,17650,12340
24537,1448,1637,17222,7315,3.65116e+13,458.564,4729.84,24537,286,384,22900,22898,22860,22880,21966
54872,1743,1901,38249,16623,3.37063e+13,910.646,7278.82,54872,413,457,52971,52971,52853,52578,50591
84384,1830,2475,58148,26236,3.12318e+13,1115.3,9956.09,84384,547,568,81909,81640,79483,72300,68960
81521,1234,3849,55920,25601,3.49276e+13,815.397,12807.7,81521,547,708,77672,76447,67779,55497,35612
75216,1070,3149,51315,23901,3.42411e+13,770.161,10429.3,75216,647,553,72040,71060,51773,44726,43513
48181,806,2196,33963,14218,3.6423e+13,736.67,7366.18,48181,483,438,45625,43748,38558,29987,24761
97470,2860,3357,68119,29351,3.57628e+13,1200.21,12439.4,97470,646,563,94113,93989,92797,90883,89867
89503,549,3662,61530,27973,3.33477e+13,994.384,11883.6,89503,583,712,83940,81308,54226,31858,29162
6653,366,766,4584,2069,3.47679e+13,327.623,1810.06,6653,224,177,5782,5376,5329,4866,4212
23779,341,1299,16532,7247,3.60192e+13,569.868,4132.36,23779,345,260,21252,19529,15017,10160,8256
68953,2193,2693,48128,20825,3.59545e+13,1057.25,9253.28,68953,539,487,66260,66201,65576,65303,62583
66785,100,2478,48426,18359,3.57946e+13,755.834,9054.46,66785,516,473,51395,44800,35207,9853,8847
28145,38,1809,19337,8808,3.49134e+13,503.841,5266.06,28145,303,325,18887,14515,11286,5278,2909
56343,3522,3586,39012,17331,3.53348e+13,853.472,10464.4,56343,461,682,52757,52757,52757,52757,52626
41747,2883,3172,28213,13534,3.40231e+13,580.239,8615.02,41747,568,433,38575,38574,38352,38024,37518
94537,2842,3052,65760,28777,3.55445e+13,1034.17,11040.4,94537,581,503,91485,91485,91439,91479,90616
9635,95,1254,6601,3034,3.53819e+13,284.421,2778.58,9635,217,258,7569,6803,4328,1685,1316
6586,799,807,4561,2025,3.69947e+13,282.827,1837.38,6586,185,183,5779,5779,5779,5779,5765
61191,281,2667,42315,18876,3.45996e+13,879.687,8680.59,61191,542,395,54366,49177,32309,12143,13270
32882,1251,2057,23470,9412,3.71168e+13,771.338,6165.87,32882,412,400,30825,30046,29574,28566,24340
75171,836,3215,53360,21811,3.60303e+13,1063.39,10976.9,75171,612,558,70883,68547,58876,38948,28221
73713,797,2640,52611,21102,3.68329e+13,808.307,9908.95,73713,617,416,70389,68638,63259,52106,36162
73165,1254,2597,49726,23439,3.4587e+13,753.119,9404.04,73165,554,459,70568,69635,62902,53685,51740
83626,777,3458,57123,26503,3.49477e+13,972.328,11552.9,83626,587,507,79001,76770,54393,40845,32127
16164,800,1449,11055,5109,3.04563e+13,284.587,3613.97,16164,299,217,14715,14509,14128,12625,11840
75551,1537,2521,52828,22723,3.73857e+13,723.232,9398.46,75551,489,495,73030,72919,71011,67327,60131
96124,808,3017,68842,27282,3.75942e+13,1201.1,12031.3,96124,814,542,91305,88331,63349,43533,36032
35964,1566,1990,25179,10785,3.73058e+13,526.232,5948.99,35964,405,358,33974,33969,32120,30422,29898
78959,1492,3531,55265,23694,3.63701e+13,1079.79,11442.7,78959,592,535,75391,74080,68939,54611,44730
82450,1791,2900,57217,25233,3.30361e+13,1255.3,10599.8,82450,544,572,79550,78502,75774,69849,59024
50110,1765,2274,35998,14112,3.66237e+13,786.259,7615.81,50110,601,366,47836,47773,47026,44679,44320
78107,113,3192,54319,23788,3.54156e+13,1117.01,10699.6,78107,564,627,61847,53706,38210,13367,8786
23838,1343,1701,16282,7556,3.27184e+13,419.169,4777.5,23838,280,347,22137,22111,22041,22058,19463
31628,346,2593,22060,9568,3.63993e+13,526.157,6817.89,31628,382,490,28016,25781,19141,11825,6990
10845,355,1054,7300,3545,3.2887e+13,221.44,2629.41,10845,203,290,9779,9396,8914,8175,5342
41825,1569,1653,28485,13340,3.55648e+13,400.234,5322.39,41825,387,337,40172,40170,40153,40136,39793
98359,3354,3439,69990,28369,3.75094e+13,1236.94,12588.6,98359,782,463,94920,94920,94896,94783,94605
57052,1212,2484,39378,17674,3.31991e+13,825.559,8350.25,57052,532,433,54565,53265,48602,33308,35499
11157,283,1124,7706,3451,3.53295e+13,343.821,2743.14,11157,223,254,9813,8849,7334,5873,3317
66904,1071,3015,46497,20407,3.53268e+13,894.659,10280.4,66904,514,484,63601,62698,54649,38222,28696
71713,1914,2582,50658,21055,3.52873e+13,904.812,9273.38,71713,535,464,69131,68883,67549,64920,60285
59258,1903,2058,41937,17321,3.36775e+13,920.391,7669.47,59258,523,392,57200,57198,56962,56808,55799
73852,75,3218,51641,22211,3.5916e+13,1238.55,10974.4,73852,671,656,56441,48422,33982,11400,5942
16668,3041,16668,0,16668,15.999,0,16668,16668,16668,1,0,0,0,0,0
95214,444,3716,66236,28978,3.5085e+13,1121.01,13233.5,95214,636,635,87487,82544,52712,27023,23994
17582,1341,1379,11968,5614,3.55295e+13,404.785,3896.33,17582,331,363,16203,16178,16187,16190,16107
37146,400,1869,25714,11432,3.27031e+13,756.188,6034.22,37146,347,382,34187,32575,24350,18853,12330
38234,1771,2159,26046,12188,3.53458e+13,730.325,6749.81,38234,415,395,36075,36062,35718,35291,33908
29038,1460,1794,20603,8435,3.6861e+13,763.775,5409.05,29038,443,391,27244,26905,26651,25818,25377
57928,1840,3097,40911,17017,3.60784e+13,689.653,9582.59,57928,555,432,54831,54529,52553,43530,42047
72010,2333,2530,50553,21457,3.60626e+13,981.52,9194.33,72010,519,525,69480,69468,69348,69258,68326
67228,1804,2611,47595,19633,3.63835e+13,1014.56,9408.85,67228,507,517,64617,64335,62917,61199,56969
75646,2937,3954,51803,23843,3.48708e+13,1081.68,12804.1,75646,565,824,71692,71533,70924,70212,63176
94005,2606,3123,64766,29239,3.5645e+13,774.262,12091.8,94005,637,571,90882,90860,90641,90545,84119
93017,3035,3738,64094,28923,3.51269e+13,1080.54,12511.4,93017,584,647,89279,88911,88030,86250,80596
19923,1254,1481,13780,6143,3.54629e+13,437.51,4100.42,19923,318,282,18442,18441,18313,18327,17585
6030,483,822,4098,1932,3.16039e+13,189.032,1799.5,6030,191,181,5208,5126,4866,4264,3679
27868,674,1810,20493,7375,3.6441e+13,586.194,5260.56,27868,474,299,25898,24840,24088,20518,16169
10558,1017,1181,7365,3193,3.67953e+13,332.092,2773.09,10558,261,282,9377,9377,9343,9321,8795
94825,570,3283,65904,28921,3.61766e+13,1209.55,12379.1,94825,689,742,88168,84308,62216,41938,27257
18242,1037,1521,13313,4929,3.64042e+13,518.879,4018.16,18242,282,281,16721,16362,16549,16150,13551
57222,2291,2815,40118,17104,3.61874e+13,734.286,9106.7,57222,666,433,54407,54382,53606,52803,49465
27027,464,1666,18530,8497,3.50964e+13,426.432,4949.77,27027,321,302,25268,24509,17614,13122,9257
59732,1873,2417,42060,17672,3.63814e+13,912.359,8520.8,59732,496,452,57315,57193,55815,52728,52235
17948,751,1688,12409,5539,3.56994e+13,511.481,4276.02,17948,367,321,16252,15746,14598,12070,9953
92467,1538,3344,63825,28642,3.47375e+13,1113.76,11618.9,92467,615,499,89123,88374,82779,67874,67867
41574,1736,2295,28605,12969,3.45182e+13,651.553,6907.99,41574,495,460,39279,39167,38184,34797,36090
89233,917,2755,64093,25140,3.75682e+13,1034.33,10982,89233,623,507,85509,82658,77988,63591,49161
33554,1175,1907,22975,10579,3.12823e+13,582.158,5825.86,33554,341,428,31647,31333,30392,27165,20994
54722,874,2591,37210,17512,3.48377e+13,855.408,8578.41,54722,461,511,51720,50320,39944,30888,26851
86778,965,2916,61240,25538,3.65282e+13,1053.55,11022.3,86778,675,503,83182,81265,70241,50217,45831
46434,1006,2300,31769,14665,3.36592e+13,532.552,7010.76,46434,503,357,44134,43810,41255,36646,33394
53355,1286,1958,37724,15631,3.60399e+13,707.651,6943.74,53355,489,442,51397,51001,49205,46820,43766
28132,40,1564,19722,8410,3.2258e+13,486.95,4864.4,28132,353,272,19395,14529,12211,3336,1995
57958,579,3054,39661,18297,3.49929e+13,854.416,9612.6,57958,499,520,53230,50307,37120,25396,18609
10614,984,1008,7353,3261,3.60096e+13,274.095,2533.7,10614,294,178,9606,9606,9606,9606,9578
94692,2728,3265,66339,28353,3.50328e+13,1223.8,11956.9,94692,632,605,91427,91343,90238,88608,86319
36524,1119,2631,24404,12120,3.56407e+13,462.881,6885.47,36524,494,338,33893,33602,31836,26217,25129
43884,483,2167,31560,12324,3.78561e+13,676.703,7029.78,43884,388,425,40178,37497,30818,21003,17592
80912,80,2456,56615,24297,3.40292e+13,882.024,9655.19,80912,706,379,63378,52915,38254,9636,8570
40434,639,2281,28305,12129,3.59249e+13,649.307,6783.48,40434,499,328,37766,36327,28548,20913,18006
26285,1495,1601,18150,8135,3.69236e+13,679.966,4896.22,26285,385,298,24684,24683,24610,24612,24317
87339,578,3443,61864,25475,3.69986e+13,1094.46,12268.5,87339,615,656,80941,76988,57920,39264,27993
91522,1966,3528,64017,27505,3.58184e+13,1137.39,12029.9,91522,687,553,87994,87347,82966,68107,74098
20407,324,1877,14825,5582,3.67003e+13,367.085,4735.78,20407,374,221,18323,17024,12748,7658,4925
12711,643,808,8674,4037,3.55137e+13,304.793,2366.3,12711,205,199,11903,11899,11654,11712,11071
35336,1108,1985,24631,10705,3.5492e+13,768.342,6361.07,35336,451,417,33290,32302,30876,25526,22624
3482,375,633,2527,955,3.86898e+13,139.946,1201.28,3482,145,114,2849,2755,2730,2749,1937
45504,1250,2509,31892,13612,3.42887e+13,833.612,7636.99,45504,560,403,42872,41794,41306,36496,32541
13108,1055,1217,8967,4141,3.57498e+13,544.997,3226.72,13108,272,330,11891,11656,11696,11562,11578
20909,133,1470,14411,6498,3.25731e+13,362.193,4053.13,20909,307,271,17825,16436,12673,7297,4845
94210,1174,3314,64405,29805,3.36669e+13,1170.96,12058.8,94210,567,586,90387,88170,68575,48243,45733
3841,68,473,2640,1201,2.77752e+13,111.54,1101.35,3841,97,119,2793,1971,1944,1858,1060
10782,173,1076,7763,3019,3.57436e+13,357.448,2618.93,10782,242,184,8930,7705,5900,3584,2528
69754,3241,3365,48623,21131,3.59773e+13,768.967,10836.6,69754,511,598,66389,66388,66352,66369,66091
32753,1172,2098,23039,9714,3.44421e+13,685.092,6028.18,32753,421,373,30655,30150,28776,22018,23563
84907,629,3480,60048,24859,3.56407e+13,980.213,12068.6,84907,606,532,79749,76095,54517,38673,27389
57103,667,2911,40354,16749,3.58789e+13,804.875,9331.47,57103,543,538,53287,51829,38957,29036,23669
95987,1058,3316,66656,29331,3.59319e+13,967.423,12157,95987,548,533,92313,90944,75537,51696,41258
38645,1355,2102,26712,11933,3.52124e+13,803.791,6544.23,38645,456,408,36543,35770,35182,32842,29940
31361,369,1736,21894,9467,3.67833e+13,635.262,5508.87,31361,443,336,28187,25952,19147,13567,9407
10754,1001,1060,7372,3382,2.88047e+13,135.555,2426.05,10754,210,158,9694,9694,9694,9694,9575
99997,1227,3188,69705,30292,3.56019e+13,974.166,11909,99997,576,533,96471,95169,85205,65245,56560
29859,1330,2194,21229,8630,3.7186e+13,571.559,6270.35,29859,423,493,27665,27562,27061,26940,18854
60241,1355,2715,42317,17924,3.55944e+13,912.478,9304.32,60241,555,635,57526,56628,54507,50591,38975
79965,35,2786,54405,25560,3.25416e+13,1025.01,9778.45,79965,545,479,53532,39637,31065,13121,4836
68693,501,3952,47943,20750,3.57225e+13,810.713,12205.6,68693,523,712,63265,60332,42038,28550,16770
10359,376,1110,7199,3160,3.59434e+13,268.664,2651.39,10359,261,270,9225,8925,8274,7514,3933
9719,788,1289,7052,2667,3.66256e+13,272.241,2817.2,9719,309,206,8430,8394,8150,7200,7017
56053,310,3178,38514,17539,3.57756e+13,999.133,9724.51,56053,550,574,50039,46433,32333,18211,8695
87109,109,3816,60940,26169,3.54995e+13,1138.62,12944.3,87109,593,633,70020,60815,43387,14270,9070
59339,41288,59339,0,59339,15.9997,0,59339,59339,59339,1,0,0,0,0,0
49090,1674,2287,33803,15287,3.25878e+13,763.367,7453.05,49090,582,313,46803,46704,45113,41802,35756
52966,883,2643,36690,16276,3.46857e+13,697.855,8349.13,52966,561,440,50064,48929,37113,28612,25407
53369,1474,1931,37014,16355,3.24606e+13,874.217,7139.04,53369,459,412,51438,51376,50717,50303,45422
22025,548,1707,14921,7104,3.35581e+13,542.632,4732.59,22025,322,345,20067,19342,16807,15216,8158
94508,2336,2590,65582,28926,3.5817e+13,1101.69,10058.5,94508,592,440,91918,91908,91759,91724,90467
35734,1918,2480,25469,10265,3.71967e+13,599.939,6951.98,35734,380,438,33254,33226,33067,33112,30637
75115,1424,3905,52743,22372,3.67206e+13,1071.53,11836.2,75115,620,540,71055,69702,59454,44695,43739
50820,243,2722,35003,15817,3.56457e+13,759.123,8522.36,50820,685,484,44611,39976,24506,8043,8559
78403,624,2453,54753,23650,3.58919e+13,973.832,9638.24,78403,592,545,73890,71071,60742,40245,28930
41368,704,2319,29810,11558,3.76076e+13,751.24,7467.35,41368,623,359,38405,36771,33499,24338,17020
71013,2182,3304,49490,21523,3.62618e+13,837.288,10862.3,71013,487,603,67709,67613,66764,66395,55298
3149,22,571,2246,903,3.87993e+13,144.962,1094.85,3149,132,116,1908,1477,1110,447,382
11032,814,1311,7779,3253,3.58381e+13,241.867,2916.53,11032,204,232,9721,9660,9564,9546,7811
71348,1195,2864,49052,22296,3.38078e+13,941.793,9742.54,71348,536,449,68322,66690,56027,42043,38946
5950,216,720,4187,1763,3.435e+13,221.913,1675.07,5950,206,138,4967,4250,3779,3062,1612
64229,1108,2489,45060,19169,3.51077e+13,922.621,9040.52,64229,592,557,61553,60679,56325,44981,40655
73080,45,2394,51365,21715,3.60677e+13,913.648,8944.06,73080,546,412,51670,41833,31152,11810,6417
69012,1220,3073,48734,20278,3.67183e+13,931.084,10368.2,69012,483,602,65736,64062,59557,51178,33805
84167,2161,2830,58763,25404,3.51686e+13,953.842,10534.4,84167,594,474,81337,81266,79904,77080,74212
73727,706,1392,50863,22864,3.55331e+13,614.324,6873.94,73727,399,394,72333,72077,65180,55102,50422
80654,3529,3545,56812,23842,3.61331e+13,1154.71,11859.7,80654,742,675,77109,77109,77106,77109,77102
27121,1724,2352,18877,8244,3.65274e+13,433.717,6142.49,27121,388,471,24769,24764,24464,24581,20257
38556,1226,2227,27204,11352,3.70626e+13,611.342,6603.07,38556,463,385,36329,36141,34781,31291,25321
11699,1145,1160,7808,3891,3.31227e+13,384.178,2947.67,11699,221,308,10539,10539,10539,10539,10534
11996,890,1377,8036,3960,3.00396e+13,245.83,3177.88,11996,278,262,10619,10596,10028,9686,7751
38870,1641,2185,27755,11115,3.65853e+13,628.517,6689.88,38870,435,344,36685,36597,36173,36155,31514
35041,1874,2327,24741,10300,3.60702e+13,597.708,6741.53,35041,422,479,32714,32703,32560,32085,29788
80687,126,2751,56862,23825,3.68651e+13,1132.09,10381.5,80687,613,573,65097,56757,41936,14692,7979
43908,419,2420,30554,13354,3.59903e+13,867.144,7676.64,43908,354,492,39801,37437,29481,20162,13338
86705,2178,3336,61283,25422,3.6426e+13,986.307,11667.4,86705,723,459,83369,83328,75746,61318,63177
16969,712,1587,11888,5081,3.53122e+13,408.817,4022.7,16969,280,276,15382,15148,14268,13069,10054
43681,2322,2455,30546,13135,3.40019e+13,784.409,7435.24,43681,507,395,41226,41225,41168,41199,40529
23202,1310,1539,15947,7255,3.09141e+13,510.368,4449.64,23202,242,319,21663,21663,21618,21647,20829
17922,1274,1679,13012,4910,3.74145e+13,437.912,4203.28,17922,374,270,16243,16217,15876,15472,14452
98047,86,2924,69919,28128,3.54113e+13,1436.31,11738.1,98047,854,520,76744,65745,49327,12340,10059
88983,226,3495,61221,27762,3.5306e+13,1073.1,12106.5,88983,602,593,77503,70042,45830,20674,15310
96841,1608,3707,67173,29668,3.61601e+13,1042.49,13001.1,96841,681,676,93134,92216,83626,67435,50516
22526,719,2099,15605,6921,3.43575e+13,388.484,5413.38,22526,251,439,20427,20070,18762,17266,10126
8055,405,849,5520,2535,3.60841e+13,262.528,2106.59,8055,200,223,7206,7026,6891,6781,4952
89361,214,3446,61508,27853,3.39792e+13,929.156,11397.2,89361,587,532,77897,69147,43444,15713,13843
52902,83,1856,36967,15935,3.42133e+13,733.503,6819.41,52902,450,428,41339,34560,26536,7368,6101
14064,904,1602,9743,4321,3.61364e+13,381.828,3853.95,14064,333,345,12462,12312,11882,10440,9218
6397,19,962,4516,1881,3.69207e+13,234.536,2019.82,6397,187,214,3765,2804,1941,590,489
82778,1553,2953,59020,23758,3.63504e+13,1013,10780,82778,716,487,79825,79497,72805,61246,52916
74404,1264,2638,53390,21014,3.7474e+13,1007.29,9967.08,74404,583,566,71554,70557,67634,57743,52326
35477,233,2078,25069,10408,3.51617e+13,712.528,6299.67,35477,440,342,31310,28332,20013,11128,7304
56845,356,2809,39299,17546,3.63128e+13,877.805,9195.29,56845,487,543,51905,48740,33757,22591,12086
49892,766,2480,34596,15296,3.61048e+13,671.809,7963.18,49892,432,435,47232,46177,38827,28783,22281
67737,2078,2530,47971,19766,3.68544e+13,896.308,8972.53,67737,463,475,65207,65198,65032,64352,60724
65023,1721,2930,45238,19785,3.50352e+13,873.066,9874.41,65023,503,575,62093,61570,60524,58232,44910
19752,1024,1157,13557,6195,3.54594e+13,337.409,3551.23,19752,268,231,18595,18594,18292,18050,17949
97786,3280,3559,68402,29384,3.53012e+13,1359.75,13081.8,97786,746,708,94227,94226,94022,93890,92396
48107,2184,2423,33336,14771,3.58107e+13,845.145,7755.89,48107,521,455,45684,45679,45425,45158,44672
67468,2357,2624,46617,20851,3.39431e+13,804.028,8890.69,67468,574,502,64844,64759,64362,64069,61317
76541,33195,76541,0,76541,15.9998,0,76541,76541,76541,1,0,0,0,0,0
56234,2216,2495,39096,17138,3.38323e+13,733.918,8733.79,56234,410,551,53739,53714,53654,53571,51866
85122,1711,2431,59789,25333,3.49382e+13,1136.41,9907.66,85122,622,478,82691,82101,79717,73765,72418
39898,345,2321,27807,12091,3.58401e+13,633.123,7150.86,39898,533,371,35953,33427,23164,16068,9939
56494,365,2619,38990,17504,3.57853e+13,989.246,8581.65,56494,595,490,51412,48115,32391,19008,14328
23192,823,1366,16913,6279,3.64728e+13,666.897,4276.26,23192,392,287,21746,20756,20394,18521,17051
15570,780,1432,10948,4622,3.51586e+13,361.816,3526.11,15570,302,275,14138,14038,12111,9219,10309
69411,1849,2001,47586,21825,3.46902e+13,1062.17,8313.87,69411,464,434,67410,67198,67333,67390,66375
89656,3005,4225,62664,26992,3.60406e+13,1067.53,13356.9,89656,701,615,85431,85356,84110,82709,71347
35193,1003,1250,24382,10811,3.08702e+13,665.582,4473.43,35193,318,257,33920,33077,33553,32891,29707
18861,1221,1483,13038,5823,3.53677e+13,339.446,4054.77,18861,233,274,17378,17374,17323,17325,15995
49088,270,2421,34630,14458,3.62814e+13,778.324,7936.03,49088,540,449,42830,38620,28817,17220,9093
67779,94,2930,47657,20122,3.70502e+13,1075.5,9869.66,67779,611,526,51531,45222,32585,14741,6772
14741,10549,14741,0,14741,15.9989,0,14741,14741,14741,1,0,0,0,0,0
88554,1672,3035,60336,28218,3.38049e+13,1207.83,10903.4,88554,667,502,85519,84276,79508,64745,65119
17252,1420,1475,11952,5300,3.57059e+13,555.116,3996.55,17252,309,313,15777,15777,15774,15776,15690
5670,270,468,3854,1816,3.59969e+13,245.631,1273.4,5670,148,145,5160,4407,4551,4006,4325
31813,1070,1534,21861,9952,3.65831e+13,559.504,5038.31,31813,356,310,30279,30228,28703,26164,27058
32793,1192,1695,22746,10047,3.4915e+13,716.89,5502.81,32793,446,423,31098,30699,29467,26718,26557
2950,213,642,2142,808,3.14917e+13,122.051,1176.93,2950,171,90,2308,2148,1682,1277,873
81580,1318,2641,58599,22981,3.6896e+13,859.823,10139.6,81580,691,384,78939,78580,73261,61996,62096
14232,825,1407,9895,4337,3.61847e+13,341.544,3530.08,14232,268,246,12825,12746,12293,12265,9741
68323,1308,2789,48727,19596,3.74081e+13,1062.57,10035.4,68323,545,573,65329,63286,61402,53401,45487
56842,49,2687,39796,17046,3.5381e+13,813.403,8652.84,56842,506,396,39977,32661,25030,9503,5064
65877,1189,2535,45386,20491,3.57053e+13,940.476,9106.71,65877,469,475,63236,62013,58484,51973,43945
58479,411,2399,40773,17706,3.58082e+13,870.716,8437.51,58479,534,500,52941,48997,37302,25410,17937
74205,1287,3160,50861,23344,3.4845e+13,1039.31,10655.7,74205,564,602,70880,69408,63070,52120,44851
88234,938,3360,62319,25915,3.60332e+13,1082.86,12043.2,88234,640,636,84004,82013,63453,45125,34883
40298,992,1666,28893,11405,3.69639e+13,818.173,6080.78,40298,449,365,38406,37264,36419,34184,28499
37354,1750,1791,26751,10603,3.71601e+13,723.869,5952.84,37354,424,318,35563,35563,35558,35560,35531
3207,467,622,2194,1013,3.47314e+13,164.47,1198.57,3207,144,136,2585,2509,2549,2545,2235
90618,3461,3637,62373,28245,3.48259e+13,1232.56,12943.6,90618,784,611,86981,86981,86763,86553,86274
87795,454,1818,60279,27516,2.95489e+13,965.045,8689.47,87795,562,482,83085,79811,59463,44189,29524
44810,1292,1882,31098,13712,3.65236e+13,633.68,6143.77,44810,431,388,42928,42774,41975,40796,36197
11844,929,1211,8384,3460,3.70214e+13,434.084,2979.19,11844,241,251,10633,10469,10201,9746,9236
85775,348,3715,60434,25341,3.64144e+13,1072.91,12423.6,85775,663,513,77995,72235,47409,23138,16893
76273,2727,2863,53034,23239,3.47495e+13,945.886,10550,76273,571,646,73410,73407,73346,73347,72821
93761,475,3347,65419,28342,3.53974e+13,935.655,12279.2,93761,506,631,87044,83144,61150,38702,21301
54288,2091,2438,37025,17263,3.29121e+13,761.655,8584.95,54288,536,509,51850,51840,51448,51062,47440
65303,2722,3060,45083,20220,3.48225e+13,948.156,10075.8,65303,596,547,62243,62211,61927,61414,59812
32482,564,2395,22740,9742,3.66565e+13,593.124,6624.81,32482,544,342,29613,28300,19611,14195,8973
77854,2184,3490,55484,22370,3.71505e+13,1006.76,11726,77854,660,589,74364,74137,73290,72244,59739
1369,8,366,955,414,3.81467e+13,77.1468,598.45,1369,90,89,575,349,315,140,103
70600,1542,2923,50607,19993,3.65216e+13,1159.98,10487.6,70600,655,466,67677,66325,61845,47087,45624
7588,399,691,5135,2453,3.48727e+13,311.925,1827.91,7588,162,200,6854,6476,6326,5659,5244
41666,815,2674,28641,13025,3.42342e+13,844.292,7700.78,41666,459,480,38593,37340,31198,24903,19184
50668,187,2762,35954,14714,3.63169e+13,774.082,8458.12,50668,613,371,42856,37405,27701,10951,8951
73164,2434,3048,50216,22948,3.40198e+13,1008,10400.1,73164,600,568,70116,70039,68565,66144,64924
43391,1012,2171,30589,12802,3.56423e+13,807.14,6781.54,43391,476,439,41220,40107,37173,30372,29114
29022,195,2309,20071,8951,3.73108e+13,423.237,6131.25,29022,346,528,24635,21661,16011,8155,5141
43292,2168,2623,31035,12257,3.68818e+13,866.462,7966.64,43292,599,440,40669,40631,40295,39529,37914
98743,192,3640,68353,30390,3.3871e+13,1201.96,12829,98743,725,648,84733,75111,51367,15907,12789
81778,2165,2202,57645,24133,3.43014e+13,1050.48,8985.43,81778,529,495,79576,79576,79567,79576,79522
29936,123,2161,20524,9412,3.51383e+13,666.415,6171.02,29936,420,320,24153,21080,14047,6354,3141
73623,798,2969,51203,22420,3.56615e+13,896.625,10161.2,73623,569,437,69792,67468,53539,38871,32477
72492,2798,3038,50189,22303,3.29857e+13,987.356,10102.7,72492,545,537,69454,69454,69343,69327,68640
80023,2826,2870,54168,25855,3.45938e+13,586.988,9301.03,80023,509,408,77153,77153,77138,77152,77066
74068,1288,3026,51809,22259,3.68631e+13,1087.17,10320,74068,646,534,70924,69271,59384,43637,49422
78849,1736,2873,54841,24008,3.63787e+13,1098.86,10180.2,78849,578,517,75976,75211,72120,65059,63586
53121,272,2117,37189,15932,3.4769e+13,548.859,7089.64,53121,421,384,47898,42498,30673,15454,17002
54396,1313,2892,37704,16692,3.59156e+13,753.044,8749.93,54396,502,468,51504,51061,46864,40127,30075
97013,2277,3242,66122,30891,3.504e+13,1084.2,12536.5,97013,672,578,93771,93568,89882,82837,81794
6773,193,916,4743,2030,3.65802e+13,276.385,2000.22,6773,187,198,5537,4878,4237,3491,2144
32390,235,1916,22614,9776,3.31474e+13,575.398,5656.61,32390,391,343,29032,26653,19002,11911,4366
7073,844,972,4835,2238,3.42089e+13,313.317,2169.06,7073,254,254,6101,6021,6022,5919,5944
55975,2358,2913,39658,16317,3.68656e+13,875.738,9153.96,55975,563,418,53062,52996,52828,52765,49525
58731,1942,3282,40011,18720,3.36583e+13,584.841,9786.1,58731,394,705,55449,55390,54712,54292,43005
95948,2547,3396,66566,29382,3.47905e+13,1196.71,12256,95948,657,676,92552,92292,90049,86702,82129
45527,846,2479,31913,13614,3.65462e+13,746.382,7453.16,45527,484,468,42795,41622,34583,25210,24975
99451,876,4074,69955,29496,3.62864e+13,1022.99,14982.7,99451,564,790,94171,91154,83533,63872,35021
73683,2236,3112,52209,21474,3.67368e+13,932.397,10566,73683,762,627,70571,70373,68162,64530,60373
4055,75,750,2991,1064,3.78335e+13,137.048,1390.66,4055,153,141,3094,2684,2255,1897,577
89225,3870,3909,62570,26655,3.6547e+13,1025.67,12747.4,89225,642,483,85316,85316,85314,85312,85251
4682,443,573,3534,1148,3.32184e+13,221.261,1289.24,4682,140,118,4109,4065,4004,3980,3748
19729,261,1436,13936,5793,3.68783e+13,439.887,3919.06,19729,318,287,17106,15017,12359,9677,5525
99144,938,3948,67498,31646,3.45703e+13,1194.43,13237.1,99144,649,657,94101,92044,60570,43157,34187
66733,650,2939,45875,20858,3.52452e+13,921.822,9936.67,66733,505,536,62571,60294,37326,28095,23328
42475,1385,2062,29713,12762,3.59103e+13,692.146,6807.11,42475,477,415,40413,40326,38806,36433,32780
61372,1697,2344,42255,19117,3.32478e+13,1010.21,8470.21,61372,444,466,59028,58103,57726,55652,51997
66935,424,3236,46641,20294,3.42182e+13,640.693,10466.6,66935,594,480,62389,60426,37824,26198,15663
25269,647,1830,18288,6981,3.58883e+13,670.761,5157.38,25269,404,323,23025,22233,19527,14470,12740
16458,621,1371,11786,4672,3.69232e+13,516.476,3622.4,16458,350,234,14986,14581,13570,11843,9569
27713,1393,1990,19020,8693,3.32816e+13,474.035,5452.51,27713,391,364,25723,25705,24174,21390,19730
78200,4217,4288,55242,22958,3.61682e+13,1058.28,13731.3,78200,510,878,73912,73912,73891,73912,73828
58122,2190,2233,40524,17598,3.38508e+13,953.413,7953.96,58122,525,535,55889,55889,55876,55878,55784
56855,2435,2550,39867,16988,3.64486e+13,791.392,8481.94,56855,595,413,54305,54300,54278,54298,53994
94638,643,2554,66732,27906,3.6808e+13,1213.31,10332.6,94638,620,558,89236,86152,66559,51737,38748
86871,2762,3559,59686,27185,3.48894e+13,1028.74,11881.8,86871,571,551,83312,83239,82644,81898,78631
15619,204,1551,11210,4409,3.72011e+13,312.578,3818.33,15619,382,252,13400,11861,9280,6514,3265
82420,2000,3490,55988,26432,3.48556e+13,887.104,11879.6,82420,756,756,78930,78651,67675,57505,56124
44395,408,1487,30319,14076,3.58234e+13,638.669,5258.71,44395,363,320,42313,41429,27058,19042,19640
7768,828,955,5535,2233,3.81436e+13,226.434,2110.07,7768,271,139,6813,6797,6799,6793,6511
39368,400,2456,27255,12113,3.56441e+13,525.498,7258.51,39368,377,447,36424,34695,25739,17423,13922
78652,1046,2767,55071,23581,3.51719e+13,990.121,10345.1,78652,540,472,75575,74241,68415,54858,42570
91470,1049,2432,63260,28210,3.39031e+13,1039.33,10463.8,91470,594,557,88263,85703,81352,67964,47099
77094,2780,3316,53452,23642,3.62144e+13,987.483,11052.6,77094,637,545,73778,73659,73405,72983,70654
16660,833,1133,11624,5036,3.49104e+13,465.232,3302.59,16660,322,235,15527,15458,14759,13773,13495
20804,134,2102,14441,6363,3.53119e+13,412.915,5202.89,20804,350,425,17172,15344,11410,6835,3279
86687,3330,4126,59894,26793,3.50952e+13,1177.94,13061.8,86687,626,655,82561,82513,81822,79997,73992
66939,2570,3376,47032,19907,3.48861e+13,993.712,10920,66939,525,637,63563,63531,62666,61815,53790
91123,3520,3710,63677,27446,3.63154e+13,1255.98,12927.4,91123,639,719,87413,87411,87261,87099,86932
33694,81,1802,23063,10631,3.50914e+13,719.072,5630.77,33694,400,324,26126,22466,15368,5076,3797
80584,757,3876,54136,26448,3.27988e+13,757.308,11822.8,80584,635,476,76337,74083,43710,27748,24067
21784,1372,1663,14804,6980,3.27658e+13,417.123,4505.73,21784,334,288,20121,20083,20032,19939,18372
18258,157,1195,12674,5584,2.97928e+13,425.814,3242.7,18258,234,197,16359,15508,9461,4639,2695
54846,748,2448,38452,16394,3.6436e+13,623.053,7852.79,54846,434,422,52114,50907,45470,37200,26500
59551,1041,2893,41063,18488,3.63026e+13,936.704,8959.5,59551,543,537,56399,55354,47740,37528,31519
27493,742,2007,18748,8745,3.47586e+13,570.158,5689.92,27493,393,437,25358,24543,23370,21469,16113
63490,175,1876,43900,19590,3.1232e+13,960.762,7393.67,63490,448,405,56780,53146,33739,11844,13480
46376,1977,2143,33310,13066,3.74324e+13,888.684,7115.33,46376,472,400,44233,44233,44198,44153,43697
17158,930,1557,12413,4745,3.93121e+13,512.837,4017.33,17158,290,307,15601,15181,15220,15218,12573
54103,1364,2754,37829,16274,3.56888e+13,769.821,8918.73,54103,561,460,51349,50513,45756,32670,30171
65984,2224,2812,45681,20303,3.54692e+13,982.31,9594.06,65984,566,504,63172,62937,61837,59396,58847
95321,2904,3090,67364,27957,3.56478e+13,1059,11499.2,95321,629,549,92231,92231,92105,92071,91302
14054,366,1030,9877,4177,3.79142e+13,499.893,2975.59,14054,286,241,12429,11552,11056,8006,6663
70610,1602,2677,48944,21666,3.52538e+13,1018.12,9404.66,70610,506,520,67933,67245,62594,53160,49097
79994,1397,3581,55217,24777,3.34296e+13,898.402,12150.8,79994,500,793,76338,75202,70664,59478,46206
44703,1255,2006,32061,12642,3.67287e+13,705.445,6746.12,44703,438,454,42697,42657,41281,40439,31821
34957,1191,1287,24104,10853,3.56623e+13,397.779,4779.04,34957,294,259,33670,33667,33484,33491,33047
20398,1403,1586,13914,6484,3.48841e+13,463.676,4509.22,20398,360,304,18812,18811,18767,18755,18289
81048,2209,3103,58085,22963,3.73163e+13,1147.33,11263.7,81048,730,517,77945,77843,75200,70917,68057
67425,1275,3154,47168,20257,3.57063e+13,828.981,10135.2,67425,685,429,64271,63222,55284,43208,40642
4716,23,377,3325,1391,2.51273e+13,121.02,1055.6,4716,117,91,2600,1666,1215,544,303
67279,1124,3056,45625,21654,3.3601e+13,746.564,9904.9,67279,509,650,64223,63533,58629,54109,36766
38857,289,2086,26795,12062,3.60011e+13,710.3,6725.24,38857,402,440,34328,31520,21368,14492,10555
7727,13,1052,5347,2380,3.55928e+13,181.171,2245.77,7727,155,215,3791,2130,2063,584,324
96822,1458,3027,67404,29418,3.60108e+13,1113.52,11088.2,96822,707,552,93680,92823,83252,65549,66287
46933,1257,2200,33037,13896,3.40925e+13,812.717,7265.61,46933,430,498,44733,44170,43274,40627,32650
66685,1182,3191,46218,20467,3.57798e+13,969.56,10542.3,66685,530,658,63294,62265,56325,47276,31296
21723,320,1216,15146,6577,3.58645e+13,403.938,3590.46,21723,255,241,19694,16902,11951,9311,6271
70815,1728,2985,49285,21530,3.56515e+13,1128.12,10059.8,70815,551,603,67830,66936,63247,53323,51840
3812,59,460,2588,1224,2.41486e+13,91.7731,1045.69,3812,126,84,2779,1923,1581,417,285
64747,553,2337,44223,20524,3.50188e+13,1066.08,8105.2,64747,527,462,60986,58860,37986,27547,28792
70917,688,2925,50074,20843,3.64118e+13,1045.99,9645.38,70917,631,441,66638,63770,45733,32645,27232
49047,2083,2764,34880,14167,3.53022e+13,608.554,8624.67,49047,540,404,46283,46283,45239,42642,38393
3689,316,398,2600,1089,3.70868e+13,200.465,973.641,3689,133,104,3291,3285,3168,3187,3000
2343,63,248,1532,811,2.47497e+13,76.4319,600.315,2343,88,65,1910,1417,1493,1615,1074
38205,1757,2402,25769,12436,3.40169e+13,676.405,7156.09,38205,431,462,35803,35699,35166,34234,31632
87572,879,2556,60639,26933,3.29186e+13,1066.34,10166.6,87572,506,492,83857,81163,70455,44908,36777
29852,1240,1689,20778,9074,3.38496e+13,586.131,5169.22,29852,393,295,28163,28065,28024,27508,25299
56210,160,2217,39198,17012,3.4284e+13,755.676,8018.44,56210,611,414,46695,40567,26741,10374,10671
52218,1883,2415,37412,14806,3.69867e+13,973.71,8350.44,52218,723,487,49803,49524,48944,46888,43169
35966,213,1670,25418,10548,3.51645e+13,783.27,5577.56,35966,426,401,31380,27933,22164,15284,7006
92832,1044,3486,64629,28203,3.53901e+13,1078.47,12793,92832,594,642,88751,86378,75021,56464,44006
51629,1620,2389,35365,16264,3.48523e+13,862.904,8068.67,51629,574,590,49240,48862,46179,39944,38647
43721,2051,2424,30511,13210,3.5166e+13,803.931,7745.57,43721,467,518,41297,41218,40978,40728,38297
39657,1688,2036,28025,11632,3.62986e+13,814.318,6469.74,39657,418,399,37621,37534,37428,37214,35918
81246,723,3173,54855,26391,3.48543e+13,1129.75,11382.3,81246,622,621,76266,74014,53360,38010,33203
94325,1475,2911,67583,26742,3.7379e+13,1087.52,12154.6,94325,707,651,91367,90312,86833,78431,58734
24674,93,1737,16877,7797,3.51652e+13,529.794,4972.08,24674,314,364,19169,16714,11043,4255,3185
67418,1092,2878,46037,21381,3.34555e+13,903.161,9937.72,67418,471,501,64275,62985,57467,47546,36334
51114,142,2017,36103,15011,3.62748e+13,751.142,7105.81,51114,475,433,42524,36306,26936,13538,8236
42484,1197,1675,30095,12389,3.61808e+13,843.384,6046.53,42484,435,351,40809,40219,38875,34950,34111
67564,193,2708,47528,20036,3.6157e+13,913.097,9851.74,67564,521,468,57687,51483,37775,12101,10457
36531,142,2030,25019,11512,3.29315e+13,576.688,6229.99,36531,323,346,31195,28025,16843,5427,5963
45298,1855,2456,31472,13826,3.66144e+13,581.532,7728.45,45298,377,469,42842,42788,42537,42188,36434
18828,1095,1554,13046,5782,3.31958e+13,300.828,4059.83,18828,259,267,17274,17243,17136,17143,15478
88081,1902,2626,62469,25612,3.74115e+13,904.727,9811.32,88081,564,476,85455,85373,83029,80047,77422
38306,819,1823,26904,11402,3.62457e+13,719.748,5995.06,38306,492,384,36203,35224,32194,24467,24891
52446,1855,2058,36538,15908,3.69833e+13,700.606,7654.92,52446,405,457,50388,50379,50321,50260,48127
58551,25,2138,41395,17156,3.53974e+13,630.788,7480.22,58551,543,331,36537,26689,22997,6360,4060
87593,1987,3304,61114,26479,3.51982e+13,1007.07,11514.7,87593,695,484,84289,83896,79386,69904,63723
3056,408,574,2123,933,3.75371e+13,166.139,1109.97,3056,122,133,2482,2420,2447,2420,1969
42964,109,2094,30052,12912,3.43649e+13,631.536,6698.57,42964,379,423,34927,29900,21652,6682,5920
89560,94,2355,62040,27520,3.18673e+13,1105.71,9810.23,89560,534,515,74554,66071,43954,15725,10691
45453,934,2691,32337,13116,3.67641e+13,792.265,8281.83,45453,439,473,42454,40683,37833,29093,19401
46899,1031,1975,32844,14055,3.52348e+13,753.074,6863.74,46899,397,427,44885,44349,42843,40037,35232
82332,1164,3696,56322,26010,3.33184e+13,962.182,11993,82332,645,455,78287,77094,56241,44315,37917
98980,578,2922,68528,30452,3.26504e+13,984.841,11505.5,98980,572,513,93731,89503,69130,46720,29871
92657,2647,3907,64287,28370,3.59932e+13,1119.72,13047.2,92657,745,602,88750,88477,84072,72604,71660
25059,1290,1484,17476,7583,3.59575e+13,529.703,4427.42,25059,333,290,23575,23575,23557,23546,22805
63824,2467,3185,44804,19020,3.49024e+13,864.504,10230.9,63824,613,560,60639,60620,59587,57432,54123
72990,2800,3354,49899,23091,3.54908e+13,1027.23,11364,72990,539,534,69636,69512,68911,67413,66071
11670,908,1505,8162,3508,3.72221e+13,300.491,3373.49,11670,223,281,10165,10110,9949,9920,7558
87595,2388,3591,60810,26785,3.47437e+13,1055.2,12065.6,87595,701,569,84004,83822,80728,69434,70383
77130,1290,2400,54427,22703,3.62412e+13,1159.96,9396.73,77130,550,473,74534,73301,68276,55023,50853
69671,2098,2551,48005,21666,3.5213e+13,832.666,8842.4,69671,471,394,67120,67095,66741,66534,63441
55623,546,2313,39572,16051,3.72006e+13,800.622,7661.83,55623,481,388,51786,48297,35043,25684,22556
92570,973,3554,65295,27275,3.63632e+13,1119.12,12554.6,92570,621,677,88194,85957,72808,50117,47908
64138,2005,3003,44523,19615,3.42169e+13,750.412,9346.78,64138,566,426,61135,60956,58185,48990,49403
98548,1323,3343,69524,29024,3.66771e+13,1412.07,12616.9,98548,701,611,94557,92627,83397,62446,51367
72571,1911,2859,51083,21488,3.6401e+13,1059.88,9719.07,72571,592,554,69712,69458,67873,65455,59939
48270,812,2024,34352,13918,3.66346e+13,704.283,7028.32,48270,481,417,46020,44723,41408,32920,30661
75817,1495,3334,53190,22627,3.6024e+13,903.541,11163.2,75817,778,457,72483,71886,66149,50294,50080
49367,149,2327,34347,15020,3.65751e+13,748.678,7328.75,49367,389,546,40053,34718,26138,9330,8128
79047,2891,2970,55054,23993,3.5479e+13,1113.37,10543.1,79047,525,507,76077,76075,76062,76064,75852
54682,2196,2296,38621,16061,3.67101e+13,1021.41,7873.82,54682,582,475,52386,52386,52264,52210,51888
37593,1581,1833,26931,10662,3.74189e+13,697.605,5904.68,37593,460,345,35760,35572,35441,35382,34036
89828,1445,2138,61866,27962,3.08278e+13,673.249,8688.85,89828,515,455,87690,87585,81558,53479,54585
88757,1701,3346,61761,26996,3.5723e+13,908.915,11592.5,88757,744,479,85411,84816,79268,63748,60737
98617,2249,2919,70651,27966,3.71066e+13,1412.32,12043.2,98617,774,554,95698,95270,92841,87096,85968
78729,82,2804,54112,24617,3.44917e+13,1366.73,10573.3,78729,706,685,62456,54010,36222,10555,7610
34431,1423,1746,24261,10170,3.6129e+13,702.861,5788.16,34431,449,423,32685,32662,32629,32557,31259
43891,151,2135,30537,13354,3.50654e+13,802.58,7030.37,43891,529,425,36098,31339,21943,7244,7061
15268,385,1423,10775,4493,3.49599e+13,354.866,3578.25,15268,240,251,13638,12410,11132,8391,4544
31742,731,1847,22013,9729,3.56556e+13,530.012,5534.88,31742,426,308,29761,28887,23517,15213,13734
75709,1318,2950,53724,21985,3.73435e+13,1012.47,10329.3,75709,590,604,72629,71163,67222,55719,51594
50503,923,2911,35555,14948,3.67376e+13,720.6,8566.43,50503,543,450,47464,45922,38042,29004,24237
80489,1104,3339,54047,26442,3.37657e+13,886.588,11146.7,80489,506,702,77068,75842,60471,47585,42660
56051,689,2456,39820,16231,3.65991e+13,827.995,8153.31,56051,522,407,52715,51106,37068,26581,21502
39879,1535,2136,26500,13379,3.30582e+13,692.421,6441.82,39879,332,476,37743,37599,36947,36001,33786
55770,635,3046,38574,17196,3.50532e+13,1035.08,9251.36,55770,597,509,51383,49321,33662,25521,18870
96768,2036,2806,66202,30566,3.54038e+13,1129,11200.8,96768,635,532,93962,93907,89780,79808,81656
69051,2914,3274,47097,21954,3.36916e+13,916.012,10370.2,69051,496,535,65777,65754,65639,65536,61811
41110,1370,2421,28556,12554,3.32468e+13,598.308,7220.31,41110,478,365,38689,38491,35810,32703,23773
95375,2363,3341,67276,28099,3.60356e+13,1147.24,12423,95375,682,538,92034,91865,89868,85827,77904
74437,2337,2422,52172,22265,3.56845e+13,865.723,9029.76,74437,627,498,72015,72015,71977,71983,71739
40739,971,1529,27557,13182,3.49579e+13,698.962,5418.37,40739,369,364,39210,38630,37480,33946,31629
12063,106,1064,8654,3409,3.69916e+13,476.833,2839.44,12063,281,280,9567,8379,6742,3915,2104
81963,70,2963,56878,25085,3.64464e+13,1101.17,10085.9,81963,536,450,60159,50985,38116,15778,8131
48111,1732,1950,33440,14671,3.36747e+13,766.43,6850.28,48111,457,397,46161,46161,46020,46049,44511
4541,266,654,3210,1331,3.60802e+13,204.564,1411.34,4541,165,156,3767,3488,3442,3378,1990
33847,766,2280,23428,10419,3.59749e+13,579.832,6426.07,33847,491,486,31396,30675,25536,21602,17209
10549,428,998,7403,3146,3.35967e+13,284.083,2471.54,10549,190,198,9551,9246,8612,7852,6149
64853,2447,3177,44568,20285,3.39072e+13,782.751,9892.33,64853,501,500,61676,61604,61054,60343,56269
50282,292,2142,36104,14178,3.68172e+13,859.215,7548.34,50282,465,422,45329,41134,33048,23923,12256
7249,778,1049,5115,2134,3.44239e+13,151.14,2175.21,7249,186,132,6200,6191,6171,6157,5021
76916,1125,2905,53420,23496,3.39092e+13,1101.29,10452.4,76916,671,554,73397,71940,63313,47725,39395
9368,476,1054,6449,2919,3.75626e+13,314.217,2545.24,9368,208,251,8298,7981,7317,6417,5776
92706,2970,3176,64661,28045,3.60115e+13,1308.48,11637.9,92706,634,564,89530,89524,89379,89277,88212
93279,1133,4044,63667,29612,3.54349e+13,976.214,13323.6,93279,785,624,88980,87439,65833,54653,46387
20008,1491,1892,14043,5965,3.69592e+13,461.28,4733.2,20008,347,330,18116,18085,17983,17903,16431
11462,301,996,8216,3246,3.63611e+13,304.434,2569.1,11462,195,181,10315,9202,8896,8983,4939
44572,1473,2762,31608,12964,3.60666e+13,907.12,8413.16,44572,506,479,41810,40873,39412,35617,31514
44264,563,2165,31330,12934,3.65374e+13,569.029,6927.81,44264,421,391,41583,39876,33726,26926,18113
97530,1495,3996,66687,30843,3.53713e+13,1297.68,13243.8,97530,590,669,93332,91536,76511,56707,48268
78360,2089,2624,54986,23374,3.62236e+13,1204.38,9910.09,78360,568,647,75736,75161,74029,72694,68789
4310,163,246,2848,1462,2.60886e+13,92.5005,770.607,4310,80,85,4064,4062,3923,3810,3268
48259,346,2197,33678,14581,3.32119e+13,844.01,7304.4,48259,439,388,43981,41482,29243,21961,11667
63683,1658,2562,45668,18015,3.7032e+13,924.549,9299.52,63683,614,430,61121,60792,58645,54226,49143
23195,494,1871,15991,7204,3.47541e+13,510.634,4890.67,23195,359,385,21048,19566,14992,11012,9114
28095,599,1706,19708,8387,3.68297e+13,552.743,5230.14,28095,377,278,26067,25128,22913,16868,13694
39293,1982,2552,27180,12113,3.60795e+13,619.622,7104.08,39293,515,376,36741,36725,36171,34414,34194
36178,1511,1799,25305,10873,3.58993e+13,695.748,5872.41,36178,428,399,34379,34367,33552,32862,31926
83468,862,2861,58771,24697,3.65776e+13,1037.85,10358.9,83468,621,524,79603,77356,57723,41441,43686
23598,1085,1921,15764,7834,3.04807e+13,389.124,4931.65,23598,397,321,21677,21564,20457,16261,14243
54332,1317,2176,38668,15664,3.69881e+13,787.501,7432.94,54332,497,427,52156,51994,48548,44132,43166
86183,98,3280,60503,25680,3.66245e+13,1011.44,12200.1,86183,597,638,67013,57847,43793,17761,7951
32194,1579,1832,21718,10476,3.29263e+13,703.164,5825.95,32194,360,417,30362,30337,30048,29831,27863
29670,1278,1803,20602,9068,3.53237e+13,547.357,5411.48,29670,364,331,27867,27821,26990,25908,25194
38122,1763,2300,26407,11715,3.44127e+13,543.07,6503.04,38122,355,348,35822,35690,35652,35623,32292
91225,1755,3411,64718,26507,3.66528e+13,1206.55,12188.3,91225,634,608,87814,87136,81923,73401,57649
18187,543,1272,12256,5931,3.32814e+13,428.221,3695.07,18187,281,290,16904,16166,13093,10356,10830
30869,1519,1666,21916,8953,3.80386e+13,631.163,5117.08,30869,361,297,29203,29203,29033,28667,28802
90552,2863,2887,62424,28128,3.41341e+13,1171.71,10950.8,90552,690,568,87665,87665,87664,87665,87631
68331,1336,2819,47524,20807,3.61421e+13,881.738,9813.18,68331,541,481,65512,64940,59096,47075,47078
7387,343,1081,5172,2215,3.70795e+13,278.98,2299.52,7387,250,193,6278,5819,4524,3809,3135
34479,1836,2252,24431,10048,3.72446e+13,637.308,6704.78,34479,438,430,32227,32099,32061,32172,30135
20912,1236,1690,14670,6242,3.309e+13,457.184,4379.02,20912,303,309,19222,19185,18790,18551,13396
91787,2981,3372,63670,28117,3.55015e+13,898.486,12082.2,91787,799,405,88415,88391,88121,87830,82768
62107,2082,3050,42817,19290,3.47532e+13,1012.32,9958.92,62107,481,577,59057,58513,57532,55384,52966
53167,128,2766,37052,16115,3.5725e+13,809.433,8372.72,53167,601,468,42601,36396,26110,8745,4922
73412,877,3301,51142,22270,3.58392e+13,855.922,11247.7,73412,572,603,69643,67802,59712,40096,30049
59265,651,2439,41434,17831,3.62007e+13,738.298,8126.87,59265,523,475,56277,54911,41404,29540,23799
75001,1765,3313,52127,22874,3.54604e+13,925.276,11057.4,75001,519,530,71688,71361,66799,60195,48612
73316,1489,3086,51569,21747,3.62248e+13,996.527,10386.7,73316,608,488,70230,69148,66743,56181,48340
82728,1627,2228,56746,25982,3.38577e+13,914.492,9370.05,82728,479,464,80500,80129,78431,74960,70145
3168,145,645,2278,890,3.74987e+13,109.889,1176.02,3168,169,114,2492,2274,1668,1222,600
40154,740,1952,28219,11935,3.66417e+13,790.852,6474.42,40154,450,383,37656,36573,33442,25725,18950
94695,1483,3391,66522,28173,3.6786e+13,1030.02,11842.5,94695,667,605,91304,90242,80834,62532,66226
10220,623,1236,7353,2867,3.5409e+13,368.559,2816.69,10220,279,257,8984,8610,8094,6296,6174
26899,568,1423,18476,8423,3.51043e+13,740.702,4660.72,26899,363,345,24790,23994,21724,16246,12693
21805,1079,1234,15139,6666,3.14088e+13,508.165,3626.2,21805,223,208,20571,20550,20549,20568,19939
11915,411,794,8130,3785,3.45703e+13,340.753,2438.84,11915,234,242,11044,10801,10256,9818,8177
90229,3676,4413,63117,27112,3.59475e+13,1040.59,14036.3,90229,850,496,85816,85814,85283,84272,81442
65764,1645,3155,45807,19957,3.43979e+13,730.908,10149,65764,774,396,62609,62349,56553,40113,36764
60795,2279,2756,41979,18816,3.49367e+13,973.586,9070.34,60795,452,469,58039,57862,57882,57723,54222
11273,792,1028,7835,3438,3.4886e+13,332.879,2602.24,11273,249,210,10245,10241,9625,9123,9141
31636,1515,2092,21977,9659,3.64527e+13,525.586,6008.6,31636,377,426,29544,29513,28692,28379,26151
51659,857,2568,35784,15875,3.4781e+13,836.257,8230.31,51659,527,416,48820,47531,34088,26088,21052
33472,948,2307,23713,9759,3.72531e+13,599.6,6520.1,33472,385,451,31165,30553,28926,26355,17170
83019,378,3092,57408,25611,3.54191e+13,1087.72,10663.2,83019,538,466,76519,71786,47399,21708,21654
66350,1873,3287,45751,20599,3.53702e+13,910.22,10437.2,66350,582,609,63063,62738,58595,47255,47623
67435,925,2917,46323,21112,3.40983e+13,798.597,9656.36,67435,536,446,64404,62892,50541,37433,31215
93643,2681,2987,64688,28955,3.3686e+13,1178.08,11191.7,93643,643,617,90656,90582,90564,90200,86913
46230,1152,2787,31274,14956,3.33022e+13,673.176,8101.7,46230,523,505,43443,42881,39258,33505,25443
64488,1518,2285,44048,20440,3.41749e+13,984.221,8541.11,64488,495,460,62203,61824,59961,55834,50145
87163,873,2698,61312,25851,3.63702e+13,1031.5,10444,87163,600,544,83743,81920,67706,48310,39255
46415,1665,2476,32298,14117,3.57959e+13,825.224,7658.05,46415,565,459,43939,43579,42066,41043,35578
57352,1527,3206,39867,17485,3.4871e+13,747.857,9561.77,57352,575,507,54146,53577,49566,39818,33809
86338,3808,4091,60165,26173,3.55298e+13,1034.93,13307.1,86338,674,574,82247,82236,82102,82038,80946
99984,185,2816,71406,28578,3.63605e+13,1356.43,11465.4,99984,704,505,85963,77982,53038,16992,13064
19022,519,1581,13676,5346,3.79144e+13,463.423,4251.41,19022,382,350,17291,16512,15278,14216,8359
4464,228,593,3147,1317,3.18146e+13,166.176,1310.68,4464,192,101,3850,3519,3304,2870,2204
4815,236,596,3175,1640,3.23338e+13,129.144,1342.96,4815,118,137,4219,4108,3694,3691,1862
87987,2016,3677,59411,28576,3.33224e+13,1215.09,12356.5,87987,765,679,84310,83684,77412,64822,71772
38618,642,2157,27555,11063,3.77396e+13,551.951,6711.15,38618,372,518,36255,34198,32894,30947,21062
41080,755,2063,28369,12711,3.59994e+13,646.035,6321.2,41080,429,392,38867,37953,34030,27124,22219
10982,823,1002,7735,3247,3.57089e+13,403.68,2603.1,10982,253,195,9980,9957,9738,9309,9330
11901,423,1098,8318,3583,3.0006e+13,191.568,2655.26,11901,240,154,10803,10600,10237,8848,7896
15627,1015,1162,11268,4359,3.66044e+13,566.937,3336.18,15627,320,300,14465,14062,14249,14138,13733
65572,1870,2751,45376,20196,3.33669e+13,897.398,9196.95,65572,535,403,62821,62502,61605,58718,56399
97446,1210,2721,68613,28833,3.6116e+13,1158.65,11389.3,97446,632,527,94326,92656,85137,66484,57705
95143,896,3172,65772,29371,3.36778e+13,1078.5,11210.1,95143,633,476,90948,88572,58172,45694,41790
10667,877,1324,7726,2941,3.71964e+13,249.985,2964.99,10667,204,228,9343,9330,9219,9193,7581
77477,311,3170,53969,23508,3.52416e+13,915.614,10600.6,77477,572,430,69784,63861,42708,19393,14667
83307,556,2670,58903,24404,3.67863e+13,1132.55,10193.5,83307,723,591,78193,75436,55306,39821,29621
19414,250,1493,13653,5761,3.3707e+13,476.847,4083.15,19414,321,240,16953,15968,12308,8304,5123
53313,1267,2452,36888,16425,3.48235e+13,662.808,7955.82,53313,355,493,50861,50089,48792,47340,37078
51983,496,2820,35709,16274,3.59703e+13,647.626,8644.24,51983,616,443,48153,45667,30838,22455,19716
5029,648,772,3603,1426,3.70572e+13,138.985,1579.03,5029,159,135,4257,4257,4245,4245,3894
30900,782,2114,21442,9458,3.55305e+13,551.469,6031.18,30900,453,366,28782,28259,24851,20695,19026
54066,1881,2583,38523,15543,3.67347e+13,869.897,8145.39,54066,596,372,51483,51438,48906,42732,44835
21855,1077,1481,15781,6074,3.62076e+13,580.571,4234.76,21855,403,273,20374,20065,20000,19826,18651
37450,518,2444,26332,11118,3.57338e+13,630.571,7077.06,37450,519,413,34450,33065,24478,17766,13723
22350,206,1653,15737,6613,3.64395e+13,404.652,4477.48,22350,321,389,19122,16753,13385,10086,4224
70351,2426,2847,50193,20158,3.65223e+13,796.093,9801.25,70351,693,454,67504,67491,67097,65852,65550
25944,85,1577,17687,8257,3.57643e+13,634.153,4894.01,25944,295,396,19989,17688,11299,5263,2530
69000,383,2425,47183,21817,3.19718e+13,786.035,8990.49,69000,549,404,63939,60475,39860,25328,17978
11425,419,1325,7943,3482,3.53762e+13,245.095,3067.8,11425,202,294,10100,9684,9283,9369,3873
84874,2564,2745,58595,26279,3.52692e+13,932.257,9698.37,84874,517,489,82129,82068,82034,82063,81558
9669,242,697,6787,2882,3.62102e+13,345.276,2034.96,9669,227,170,8257,7096,6445,4297,5314
24114,37,1425,16573,7541,3.39539e+13,406.224,4416.62,24114,295,349,16351,12474,10195,3910,2984
33829,1227,2055,23436,10393,3.44428e+13,524.893,6158.54,33829,305,427,31774,31715,30953,30623,22166
87788,1443,2844,60293,27495,3.47585e+13,821.309,10313,87788,516,420,84944,84374,77293,59726,56932
97859,155,3298,68161,29698,3.48017e+13,1349.77,11870.3,97859,591,572,82548,72515,51269,14309,12570
89972,1209,3788,62965,27007,3.53219e+13,1123.17,12766.4,89972,656,576,85924,83927,62857,45712,46499
69581,1699,3016,49271,20310,3.64274e+13,888.586,10298.3,69581,520,608,66565,66430,64899,63086,46601
72565,107,2591,50444,22121,3.61759e+13,699.464,9563.28,72565,576,411,56712,49440,36244,13083,8484
45907,414,2364,31147,14760,3.39367e+13,657.765,7389.73,45907,488,398,42231,39989,27739,19914,17332
52108,2681,2941,36544,15564,3.53189e+13,662.537,8535.96,52108,430,541,49167,49163,49109,49148,48501
78139,329,2988,53969,24170,3.58625e+13,937.591,10310.4,78139,540,495,71012,65384,43627,21164,18623
49614,1410,2044,33943,15671,3.14068e+13,793.157,7091.45,49614,465,373,47570,47277,46318,43447,42018
63368,1471,2268,43983,19385,3.39478e+13,956.252,8216.32,63368,461,454,61100,60994,58608,53566,48371
97172,1251,3786,67410,29762,3.54898e+13,1464.47,13606.6,97172,682,702,92142,88895,78514,58020,44983
57776,2023,3056,40307,17469,3.62023e+13,815.809,9457.12,57776,466,612,54720,54675,53642,52734,45566
40881,1353,2363,29759,11122,3.78386e+13,829.422,7426.88,40881,451,469,38518,37875,37367,36113,27363
23277,1041,1381,16016,7261,3.11265e+13,570.117,3939.83,23277,306,294,21896,21423,21444,20939,18588
71225,2374,3259,48615,22610,3.56703e+13,922.71,11115.4,71225,633,781,67966,67868,66578,64504,60833
65390,28,2811,44622,20768,3.53655e+13,892.048,9717.25,65390,564,605,41983,31557,24828,11320,4773
54693,2094,2497,39041,15652,3.6707e+13,958.785,8337.34,54693,461,476,52196,52191,51929,51878,49917
95429,667,3303,65732,29697,3.3363e+13,970.944,12302.6,95429,654,570,90745,88730,70532,51040,34139
50848,756,2904,35680,15168,3.61496e+13,838.966,8985.76,50848,443,556,47069,45938,39230,29226,19119
15704,407,800,10651,5053,3.07888e+13,253.204,2601.4,15704,210,166,14904,14805,13095,10296,9669
43932,138,3199,30493,13439,3.50403e+13,981.581,8759.92,43932,524,642,36401,32579,21644,6753,5170
92859,2139,2625,64496,28363,3.22636e+13,1010.79,9914.94,92859,534,531,90234,90220,90060,90073,88294
49903,2622,3237,34913,14990,3.70989e+13,662.221,9465.72,49903,439,658,46666,46660,46388,46464,41314
64806,1495,3039,46087,18719,3.61496e+13,793.475,10185.6,64806,679,392,61767,61497,55327,42963,41537
36207,1646,2027,24965,11242,3.34226e+13,646.028,6005.19,36207,454,345,34180,34151,33444,32215,27893
73832,2552,3410,53112,20720,3.59347e+13,863.286,11396.9,73832,615,606,70422,70399,69818,69288,62450
65104,1614,3111,45448,19656,3.63437e+13,923.53,10316.6,65104,674,545,61993,61530,56112,45340,41803
78546,2352,3704,54013,24533,3.46463e+13,990.211,12362.2,78546,514,693,74842,74704,73831,73399,61509
1981,318,526,1442,539,3.89336e+13,83.4538,841.828,1981,147,90,1455,1421,1388,1220,1167
37560,1042,2112,25766,11794,3.52312e+13,491.443,6573.97,37560,475,355,35448,35285,29654,24259,22991
80689,1643,3169,55603,25086,3.52868e+13,996.817,10584.7,80689,543,526,77520,76630,72636,60731,57694
85143,3039,3318,60587,24556,3.66125e+13,859.603,11767.9,85143,568,525,81825,81812,81719,81513,79731
19469,280,1489,13275,6194,3.57014e+13,612.653,4274.56,19469,330,345,16725,15420,10663,6897,5953
9089,471,861,6403,2686,3.74143e+13,437.674,2240.64,9089,216,209,8008,7447,7448,7094,5498
9447,400,1387,6696,2751,3.80844e+13,275.475,2867.45,9447,245,191,8060,7464,6035,4512,3376
94050,2671,3108,65845,28205,3.56989e+13,1323.86,11548.3,94050,645,597,90942,90780,90448,89889,88041
21272,1649,1795,14393,6879,3.32012e+13,329.807,4770.14,21272,271,426,19477,19477,19455,19472,19175
20700,651,1642,14569,6131,3.35362e+13,330.025,4257.54,20700,247,278,19058,18695,17911,16782,10604
88362,1425,2987,60444,27918,3.26745e+13,827.171,10451.5,88362,591,523,85375,84674,76868,63334,61393
95501,30,2708,66045,29456,3.38525e+13,1244.84,10721.4,95501,610,587,60474,44138,33888,12073,7246
53251,803,2680,37911,15340,3.69843e+13,822.1,8460.12,53251,512,419,50190,49060,42305,26343,26228
1270,102,378,917,353,3.50214e+13,51.4134,588.895,1270,74,76,892,814,783,758,382
79046,1977,2344,55186,23860,3.47473e+13,994.437,9450.35,79046,699,399,76702,76659,75404,74037,70182
40381,995,1675,28154,12227,3.50617e+13,837.498,5762.93,40381,379,363,38549,37515,35032,28947,31447
58495,1023,2096,42102,16393,3.74291e+13,809.047,7995.25,58495,507,431,56199,55170,52835,48710,37177
98713,1443,4507,69348,29365,3.65075e+13,1335.15,15039.3,98713,765,829,93733,91198,76166,57268,51232
89356,1486,3007,61252,28104,3.3755e+13,1031.75,10624.9,89356,670,438,86349,85455,77903,59466,65543
25813,1651,2039,18577,7236,3.76618e+13,537.563,5422.73,25813,296,389,23774,23684,23650,23627,21834
29559,318,1897,20945,8614,3.70503e+13,618.813,5528.08,29559,361,428,26317,24365,18086,13269,9167
15272,782,1396,10934,4338,3.6002e+13,442.147,3552.96,15272,260,259,13876,13549,12880,11919,9476
40537,1333,1771,27775,12762,2.99304e+13,702.493,5992.59,40537,306,400,38766,38416,38615,38472,35946
61554,1757,2570,43162,18392,3.69056e+13,981.796,8523.11,61554,569,489,58984,58224,55730,50926,51516
92983,1569,3195,63965,29018,3.58536e+13,1318.01,11774.6,92983,680,617,89514,88052,79883,64558,64714
10162,268,1062,7442,2720,3.903e+13,395.125,2590.52,10162,238,217,8623,8041,7586,6338,2842
55281,505,3010,38963,16318,3.68121e+13,575.338,9103.15,55281,422,601,51548,48788,37696,31692,12956
95053,553,2871,67944,27109,3.66758e+13,1163.11,11852.9,95053,589,584,89074,85536,58511,39442,27324
66780,207,2325,47512,19268,3.7729e+13,1149.63,8581.86,66780,633,499,57068,49809,38821,12993,12472
47470,143,2442,34191,13279,3.68207e+13,880.223,7952.58,47470,526,476,38766,33463,24659,7321,6535
45959,677,2556,31273,14686,3.52592e+13,711.524,7885.54,45959,392,547,42900,41689,31906,22759,21872
88401,2000,3233,62669,25732,3.71798e+13,1294.1,11722.8,88401,703,627,85168,84145,81656,73253,67840
93704,1863,2650,65901,27803,3.44337e+13,1041.53,10538.1,93704,682,440,91054,90914,87629,82253,68016
96983,416,4311,66150,30833,3.47702e+13,969.296,13729.9,96983,692,530,89847,84858,48590,20520,14332
71964,1260,2785,50646,21318,3.55784e+13,1018.81,10294.7,71964,539,511,68856,68083,64096,53391,42782
5322,256,613,3665,1657,3.55822e+13,302.756,1478.67,5322,169,187,4453,3979,3922,3091,2951
12725,1363,1409,9002,3723,3.48755e+13,273.599,3305.17,12725,185,304,11316,11315,11311,11316,11280
10841,494,1459,7641,3200,3.45485e+13,236.835,3155.55,10841,312,214,9382,9176,7799,5546,4710
82544,1087,3594,57545,24999,3.59707e+13,907.615,11545.6,82544,750,560,78729,77482,60102,47028,44952
67706,679,2456,46848,20858,3.52825e+13,914.146,8664.54,67706,571,490,63564,60170,43688,34028,31865
68038,2664,3012,48194,19844,3.54958e+13,822.009,9914.21,68038,514,452,65026,65025,64868,64802,63073
17395,1015,1135,11927,5468,3.46972e+13,452.789,3472.34,17395,312,277,16260,16260,16185,16181,15944
77806,1959,2702,54857,22949,3.5003e+13,963.238,10244.7,77806,523,540,75104,75075,73856,72595,64686
96628,3710,3777,66019,30609,3.44655e+13,1007.14,13362.2,96628,618,693,92851,92851,92845,92846,92742
7231,108,1121,4977,2254,3.54746e+13,219.162,2361.23,7231,261,193,5494,4820,3509,1968,1169
30627,342,2020,21400,9227,3.36717e+13,403.065,5662.09,30627,316,416,28143,26949,21829,18641,7537
48596,1398,2967,33304,15292,3.5123e+13,809.171,8817.9,48596,540,574,45629,44956,40999,35121,33475
91040,2272,3493,62862,28178,3.29475e+13,931.233,12158,91040,572,521,87547,87347,85333,78027,66963
76677,762,3058,53383,23294,3.60058e+13,727.389,10410.2,76677,626,450,73127,71244,48051,34192,25452
34664,1438,1793,23601,11063,3.50907e+13,520.158,5684.83,34664,351,359,32871,32870,32197,31238,30903
86792,836,2929,59887,26905,3.36182e+13,1030.83,10566.4,86792,606,524,82868,80840,70995,51560,44705
82669,1326,2967,56409,26260,3.47848e+13,1104.63,10907.1,82669,558,574,79597,76673,72383,58360,59948
28497,659,1648,20417,8080,3.66689e+13,508.264,5100.32,28497,322,267,26834,26399,23945,17224,15338
7174,954,1044,4941,2233,3.38646e+13,261.964,2218.15,7174,206,199,6130,6130,6122,6125,5950
41838,642,1835,28643,13195,3.36066e+13,529.199,5929.63,41838,367,399,39849,39089,31316,26610,22521
4203,397,714,2999,1204,3.80161e+13,179.913,1384.18,4203,152,129,3489,3317,3310,3186,2552
82978,2718,3668,57586,25392,3.558e+13,774.987,11849.3,82978,733,420,79310,79297,75811,66860,70511
31644,1332,2379,21918,9726,3.50291e+13,521.403,6452.9,31644,397,460,29265,29139,27556,26158,18941
19415,165,1376,13575,5840,3.65671e+13,400.961,3922,19415,356,235,16296,14376,11118,6540,4323
48377,1203,2643,33224,15153,3.38063e+13,619.716,8054.18,48377,586,383,45734,45481,42387,34358,29177
34017,435,1715,23893,10124,3.66526e+13,754.461,5780.82,34017,431,354,30715,28935,24573,18199,12402
26843,1473,1483,19172,7671,3.72925e+13,590.199,4635.41,26843,314,327,25360,25360,25360,25360,25356
10717,521,984,7243,3474,3.53565e+13,303.031,2591.4,10717,235,253,9733,9624,9247,8823,7948
89598,766,2907,62803,26795,3.56535e+13,1004,10851.5,89598,653,548,85067,80139,62109,46494,41194
61146,1926,2853,43041,18105,3.71086e+13,834.922,9596.95,61146,492,619,58293,58228,57767,57020,46579
88967,1951,2454,61208,27759,3.23933e+13,1086.88,10504.1,88967,603,500,86513,86298,85929,85357,80252
64778,1687,2423,45739,19039,3.63974e+13,592.027,8328.56,64778,404,456,62355,62285,62027,61198,50761
7362,527,986,5201,2161,3.39732e+13,273.948,2170.42,7362,242,155,6376,6082,5737,4481,4379
7896,840,894,5550,2346,3.64445e+13,224.849,2068.39,7896,185,151,7002,7002,7001,7001,6948
31387,1116,2300,21937,9450,3.6137e+13,546.305,6237.68,31387,580,402,29087,28676,27051,23250,22584
26347,746,2007,19053,7294,3.78494e+13,568.33,5343.26,26347,390,340,24194,23338,22471,17458,14435
28705,153,1760,20317,8388,3.69428e+13,680.527,5360.01,28705,421,420,23699,20855,15028,6818,5388
46808,2587,2865,32646,14162,3.58719e+13,798.614,8121.57,46808,588,414,43943,43939,43813,43405,42909
11442,712,1150,8328,3114,3.81333e+13,300.539,2823.51,11442,284,212,10292,10202,9984,8631,8687
45679,2256,2384,31514,14165,3.43988e+13,712.843,7257.14,45679,438,437,43295,43290,43279,43271,42844
8312,404,978,5548,2764,3.29687e+13,184.48,2246.69,8312,179,239,7334,7183,6870,6782,3899
60962,1879,2718,42621,18341,3.60415e+13,863.556,9036.74,60962,490,482,58244,57850,55992,49403,46508
48962,103,2281,33576,15386,3.5058e+13,560.082,7314.87,48962,409,448,38366,33054,23727,7862,5540
97788,1744,3381,69016,28772,3.57589e+13,1230.69,12832.5,97788,719,651,94352,93438,87763,75697,55771
62778,195,2895,43896,18882,3.59864e+13,835.459,9538.9,62778,429,559,54475,49288,35499,12129,11071
76981,1079,2724,52719,24262,3.5102e+13,933.641,9090,76981,538,457,74049,73105,55459,41380,39655
43792,1613,2362,30295,13497,3.42868e+13,887.154,7429.69,43792,439,403,41430,40758,39489,33291,34053
70944,2785,3163,49118,21826,3.60543e+13,1135.67,10486,70944,594,599,67781,67726,67290,66590,65496
1272,164,320,917,355,3.43025e+13,79.3608,541.329,1272,103,55,952,870,902,704,644
42289,445,2421,29506,12783,3.49529e+13,655.851,7340.02,42289,554,401,38687,36868,27714,22921,16369
28670,1438,2030,20422,8248,3.69289e+13,709.911,5699.87,28670,473,368,26640,26429,25448,23478,21687
57842,2349,3220,39942,17900,3.50415e+13,1150.39,10006.3,57842,658,637,54622,54068,53485,51623,48609
6359,447,915,4394,1965,3.54162e+13,208.021,1982.06,6359,210,176,5444,5297,5054,4205,3667
65785,895,2202,46242,19543,3.65744e+13,940.607,8181.79,65785,547,437,63144,61198,55149,44948,43061
83276,2693,2938,57218,26058,3.53422e+13,757.897,10378.7,83276,519,507,80338,80321,80223,80271,79389
85837,1186,2553,61386,24451,3.57681e+13,1172.39,10369.3,85837,647,528,82700,80960,74209,58535,50982
42312,935,2380,28944,13368,3.32383e+13,559.04,7493.04,42312,439,598,39932,39428,37837,34256,22392
69682,667,2721,50715,18967,3.7124e+13,1027.72,9969.61,69682,728,485,65339,63194,50882,35911,26992
18878,1758,1852,13017,5861,3.59231e+13,360.077,4618.2,18878,293,328,17026,17026,17006,17026,16781
37507,801,2113,25783,11724,3.39094e+13,636.548,6300.2,37507,413,381,35226,34616,30508,22241,19514
58822,1455,3208,41061,17761,3.59825e+13,980.365,9865.71,58822,653,595,55614,54420,51451,44140,36349
20310,1331,1516,13972,6338,3.58633e+13,427.473,4196.15,20310,299,404,18794,18791,18595,18637,18137
86033,2046,2841,60192,25841,3.56525e+13,1264.9,10745.6,86033,657,563,83192,82521,80616,78942,71591
78843,272,2582,55535,23308,3.69187e+13,983.038,10579,78843,567,510,69667,63408,47079,20651,16036
55538,2117,2590,38819,16719,3.59375e+13,681.41,8537.38,55538,602,518,52948,52936,52108,51765,48814
27247,92,1657,18722,8525,3.43224e+13,515.062,5228.93,27247,331,325,21314,18194,12821,4387,3615
14738,607,1587,10468,4270,3.65605e+13,388.43,3817.45,14738,325,271,13123,12654,10789,7400,6699
11043,575,1435,7934,3109,3.61386e+13,255.638,3128.03,11043,273,216,9608,9330,8670,6097,4940
72157,2748,3333,48912,23245,3.3676e+13,935.821,11182.1,72157,682,598,68824,68716,67372,62620,62478
45963,1586,2749,31593,14370,3.51652e+13,837.916,8146.56,45963,492,539,43214,42810,41333,38867,26168
28874,612,1734,20242,8632,3.39134e+13,666.624,5129.25,28874,370,296,26822,26055,23507,16778,14076
87860,2565,3003,61548,26312,3.63182e+13,1060.55,11301.3,87860,609,483,84857,84828,83932,81853,80775
84526,3120,3244,59594,24932,3.60273e+13,1215.8,11584.7,84526,586,556,81282,81258,81251,81156,80799
75655,1685,3301,52373,23282,3.44117e+13,1117.19,10966.3,75655,645,510,72354,71617,65834,52862,45400
83723,1130,2422,60582,23141,3.67921e+13,1202.01,10052.5,83723,685,482,80528,78586,75163,57807,52059
49360,1711,2973,34087,15273,3.55431e+13,726.972,8989.69,49360,424,652,46387,46316,45036,42414,31573
56215,860,2380,39661,16554,3.47741e+13,1154.38,8213.49,56215,632,426,52786,50617,45618,30567,27328
36001,1748,2055,25352,10649,3.52904e+13,790.523,6595.61,36001,478,483,33946,33671,33274,32518,32022
1037,208,262,777,260,4.60088e+13,34.46,416.464,1037,72,52,775,765,775,773,678
31798,318,2006,23002,8796,3.76204e+13,547.999,6000.54,31798,395,372,28596,25917,22716,16283,8216
63479,2263,2541,45745,17734,3.73629e+13,1173.5,9255.96,63479,550,469,60938,60932,60722,60474,59305
76103,3189,3857,52568,23535,3.46113e+13,937.412,12460.2,76103,730,657,72246,72154,71395,69244,67545
99452,673,4034,68067,31385,3.42088e+13,1146.69,13717.9,99452,674,601,93371,91385,59831,41677,33753
46296,307,2413,31787,14509,3.4227e+13,678.6,7539.11,46296,484,390,41860,37877,24384,13457,13277
50738,2029,2721,35217,15521,3.50256e+13,859.792,8163.89,50738,462,435,48017,47778,47465,45607,43262
38538,1818,1917,26346,12192,3.37731e+13,596.093,6526.17,38538,522,493,36621,36621,36523,36429,36279
76660,1012,3668,53638,23022,3.61112e+13,853.058,12117.9,76660,494,555,72869,71191,61122,40970,36429
90396,668,3158,62442,27954,3.58872e+13,1052.99,11711.3,90396,622,541,85375,82160,51736,39021,23121
53413,664,2112,36679,16734,3.36698e+13,577.219,7364.87,53413,417,415,51006,49492,41448,30792,19127
68763,591,2889,46801,21962,3.53283e+13,877.524,9593.46,68763,548,549,65179,64116,40771,29592,25667
90789,1528,3140,63277,27512,3.43615e+13,894.313,11799.3,90789,546,522,87649,87091,82782,71310,57078
38918,1562,1681,26252,12666,3.34311e+13,919.318,6284.46,38918,375,489,37237,37236,37161,37042,36176
10200,899,990,7278,2922,3.76328e+13,506.795,2571.54,10200,288,261,9210,8817,9092,8987,8972
95126,1985,3071,67300,27826,3.69006e+13,1174.75,12045.6,95126,781,549,92055,91541,87822,79528,72839
60490,2245,2348,43324,17166,3.71304e+13,1172.02,8610.15,60490,564,528,58142,58142,58097,57988,57669
71186,95,2990,49711,21475,3.46719e+13,955.118,10058.8,71186,604,512,56702,49483,35169,11325,7303
94848,2261,3950,65432,29416,3.51966e+13,982.026,13901.5,94848,568,785,90898,90764,89658,89870,68700
90887,1886,2715,62812,28075,3.30358e+13,1194.96,10982.7,90887,606,677,88172,87817,86004,81197,72356
50916,1461,2205,34723,16193,3.34952e+13,547.393,7115.47,50916,428,410,48711,48650,45806,40466,41785
14333,756,1314,10285,4048,3.70921e+13,420.722,3329.39,14333,273,298,13019,12761,12448,11857,10013
6345,520,814,4584,1761,3.34077e+13,235.665,1834.79,6345,208,131,5531,5499,5088,4079,4117
97785,2040,3484,68344,29441,3.61752e+13,996.358,12227.6,97785,617,440,94301,93956,84752,64257,66978
58081,410,2346,40273,17808,3.44357e+13,780.885,8008.16,58081,505,452,52751,49100,37077,23021,18875
30707,1172,1798,22109,8598,3.67389e+13,623.14,5544.53,30707,456,350,28909,28680,27663,25329,23501
11312,199,1292,7967,3345,3.6595e+13,282.736,2952.47,11312,312,297,9545,8425,7061,6634,3514
18901,104,1503,13448,5453,3.68241e+13,520.422,4067.25,18901,329,273,15087,13262,10162,3723,2256
6840,11,698,4687,2153,3.03296e+13,220.157,1698.84,6840,132,147,3081,1657,1541,581,410
68489,2109,2523,46631,21858,3.45039e+13,612.988,8819.55,68489,489,374,65966,65885,64871,61972,60813
38452,298,1679,26257,12195,3.49279e+13,442.579,5616.42,38452,337,302,34870,30515,21991,12609,8693
53410,308,2650,37616,15794,3.65944e+13,683.126,8392.06,53410,444,469,47937,43286,32120,20960,10476
34182,275,2084,23539,10643,3.56678e+13,536.051,6361.18,34182,303,495,30512,27782,20108,13679,7926
32612,218,1962,22726,9886,3.63934e+13,480.57,5710.02,32612,348,388,28315,24879,17923,9793,5620
74816,1514,2452,52295,22521,3.62263e+13,1157.32,8916.64,74816,520,484,72364,71002,66393,52878,58846
33924,1208,2024,23940,9984,3.68848e+13,628.524,6067.4,33924,381,320,31900,31572,30950,30090,24856
21281,1198,1946,15132,6149,3.78007e+13,449.819,4923.34,21281,304,407,19335,19301,18873,18893,14327
68420,933,2234,48640,19780,3.74049e+13,1105.55,8591.63,68420,588,456,65273,63133,57015,46634,42836
1275,78,252,999,276,4.05121e+13,42.9467,452.469,1275,82,56,1017,979,897,839,380
91808,876,2850,63069,28739,3.51329e+13,1405.55,11082.4,91808,633,547,87690,85648,71452,51006,31906
46160,295,2359,32868,13292,3.6226e+13,957.397,7714.98,46160,588,403,41113,38054,30157,17118,10093
75255,3256,3451,52105,23150,3.57384e+13,916.415,11375.5,75255,541,611,71804,71804,71717,71697,70891
39791,1180,2101,27648,12143,3.57606e+13,730.833,6665.9,39791,430,469,37690,37068,35827,32706,30457
77027,2593,2713,53523,23504,3.66518e+13,869.976,9576.29,77027,554,486,74314,74314,74311,74272,73862
86909,2455,3037,60869,26040,3.5047e+13,933.983,11572.8,86909,700,555,83872,83866,82279,78629,75541
96570,505,3616,66400,30170,3.47192e+13,1075.42,12436.1,96570,779,505,90468,87516,52528,30135,18120
30454,102,1914,21031,9423,3.50188e+13,432.073,5745.24,30454,430,367,24062,20603,15185,6690,3401
61462,2391,2476,41922,19540,3.46152e+13,610.245,8219.97,61462,471,381,58986,58986,58970,58968,58793
81097,1305,3082,54821,26276,3.43028e+13,1113,10742.7,81097,568,567,77782,76357,66636,51857,49017
16890,1493,1568,12188,4702,3.80011e+13,355.746,4002.44,16890,390,307,15322,15321,15317,15318,15165
28302,1427,1894,19718,8584,3.68927e+13,666.236,5552.73,28302,323,466,26408,26399,26072,25740,21970
99103,967,4293,68789,30314,3.47871e+13,1080.23,14249.7,99103,720,692,93880,91545,65597,49601,41583
12643,842,876,8648,3995,3.52896e+13,449.92,2698.13,12643,271,228,11767,11767,11761,11760,11679
89987,1152,2107,63676,26311,3.50215e+13,965.506,9025.52,89987,610,421,87540,86360,82192,70044,60852
14316,878,1306,9830,4486,3.36847e+13,385.41,3357.78,14316,244,282,13010,12902,12781,12684,10652
13737,833,1167,9690,4047,3.7922e+13,592.275,3179.24,13737,281,285,12512,11971,11870,11092,10930
60288,454,3212,41623,18665,3.51555e+13,942.102,10149.5,60288,567,587,54896,51883,36432,19566,15164
13845,1223,1277,9484,4361,3.57051e+13,348.641,3241.34,13845,279,273,12568,12568,12561,12563,12491
68230,1087,2230,46202,22028,3.05415e+13,986.692,8425.91,68230,498,508,65606,64157,61421,49816,46733
6391,64,885,4500,1891,3.67807e+13,307.115,1924.74,6391,184,204,4737,4036,2908,1067,940
97215,2490,3562,67843,29372,3.54953e+13,1127.78,11929.3,97215,632,624,93653,93340,89459,80886,82907
79082,2929,3375,54172,24910,3.42866e+13,959.002,11362.8,79082,486,589,75707,75707,75545,75627,71892
50089,994,2732,35427,14662,3.67008e+13,722.815,8370.33,50089,466,421,47299,46410,40553,28345,22443
51998,588,2439,37498,14500,3.69768e+13,724.036,8101.35,51998,541,458,48558,45430,42701,32774,24073
54805,2582,2593,38322,16483,3.59277e+13,859.338,8630.26,54805,460,457,52212,52212,52212,52212,52210
65774,367,3228,45297,20477,3.4187e+13,742.482,9722.14,65774,578,421,60735,56840,37131,23777,12662
45410,1168,2430,31787,13623,3.62588e+13,959.992,7422.68,45410,480,522,42724,41993,38138,28478,25910
85280,2284,2990,57808,27472,3.46886e+13,886.41,10581.2,85280,498,601,82290,82062,80621,77956,77371
12161,267,1122,8408,3753,3.17024e+13,232.686,2676.54,12161,204,170,10868,10375,9694,8025,5935
52471,2192,2953,36815,15656,3.55867e+13,729.098,9206.63,52471,471,641,49518,49500,49082,48779,42435
23502,1121,1342,16176,7326,3.23867e+13,473.207,4126.91,23502,289,288,22160,22140,22073,22047,20688
95114,2897,3354,66801,28313,3.53032e+13,1021.51,12530.6,95114,541,588,91760,91753,91562,91516,88482
72494,3498,3640,50748,21746,3.70778e+13,968.762,11611.5,72494,591,577,68854,68854,68799,68779,68500
66616,2485,2558,46064,20552,3.47803e+13,974.119,9158,66616,591,435,64058,64058,64041,64041,63870
96429,1880,3760,67241,29188,3.47162e+13,1283.08,13213.5,96429,749,620,92465,91118,86720,74315,62369
25751,687,1863,18835,6916,3.8067e+13,607.263,5264.62,25751,374,344,23695,22647,21943,18461,13504
73614,134,2703,50786,22828,3.46865e+13,1038.87,9705.38,73614,524,476,61178,54025,36449,13321,9087
25672,1129,1694,17761,7911,3.41384e+13,516.111,5004.41,25672,280,316,23978,23872,23757,23509,19779
25593,250,1561,17989,7604,3.71675e+13,584.548,4558.21,25593,318,368,22730,20113,15553,12815,8369
2605,449,517,1799,806,3.93375e+13,120.422,973.741,2605,91,122,2088,2088,2077,2075,1967
52024,1604,2401,35902,16122,3.37161e+13,834.774,8164.31,52024,483,512,49623,49237,47765,41982,42043
29015,1129,1690,19927,9088,3.5409e+13,558.661,5042.24,29015,353,368,27325,27218,26548,25281,23494
9467,237,956,6405,3062,3.31964e+13,336.239,2417.28,9467,231,221,8168,7582,6602,5830,3281
75801,104,2476,54309,21492,3.60597e+13,975.975,9312.51,75801,631,452,59362,50737,39562,13946,10405
60089,1765,2883,41312,18777,3.41691e+13,814.968,9165.34,60089,460,549,57206,56869,55233,53988,46069
42688,2191,2194,29741,12947,3.45693e+13,841.829,7023.26,42688,394,484,40494,40494,40494,40494,40494
61385,674,2561,43797,17588,3.60782e+13,1156.48,8937.66,61385,551,532,57414,55113,47091,33746,23386
43086,484,2527,29777,13309,3.44394e+13,660.085,7688.51,43086,412,446,39856,38167,29904,21395,14762
34096,661,1951,24229,9867,3.74425e+13,559.184,5923.71,34096,445,295,31948,30864,28248,21822,16249
38169,546,2250,27406,10763,3.80126e+13,539.484,6836.99,38169,442,397,35345,33465,30853,25502,15252
11950,512,836,8138,3812,3.47724e+13,387.339,2506.84,11950,244,215,11114,10960,10019,8988,9355
16859,827,1176,11548,5311,3.5902e+13,311.68,3187.46,16859,301,210,15683,15659,15227,14283,14261
54963,2119,2892,38789,16174,3.60614e+13,735.388,9246.42,54963,532,514,52071,52049,51656,51054,44133
7865,198,1135,5497,2368,3.78149e+13,257.28,2418,7865,251,154,6517,5934,3946,2809,1659
94364,3076,3386,65607,28757,3.53069e+13,991.607,11676.7,94364,628,523,90978,90977,90818,90836,89455
99350,1124,3794,67661,31689,3.42538e+13,1209.79,13820.3,99350,655,641,94822,92935,70901,57868,45218
55199,1241,3048,38314,16885,3.48382e+13,788.74,9228.77,55199,516,417,52151,51122,44086,31998,27817
21053,579,1371,14498,6555,3.53322e+13,372.055,3807.05,21053,316,270,19675,19299,16964,13993,12800
62324,548,3198,44497,17827,3.62329e+13,1084.13,10292.6,62324,540,660,57026,54488,37733,24166,16159
26110,2058,2096,17833,8277,3.35108e+13,505.402,5643.81,26110,281,475,24014,24013,24014,24014,23880
10744,430,809,7212,3532,2.92698e+13,227.413,2174.44,10744,221,162,9935,9662,9279,8149,7667
30024,1228,1967,20995,9029,3.55605e+13,562.18,5788.44,30024,423,347,28057,27749,26829,23447,20073
88893,2028,3437,61844,27049,3.55882e+13,1153.55,12111.8,88893,658,659,85456,84845,77857,61680,62174
10469,161,964,7145,3324,3.56004e+13,273.68,2478.34,10469,196,218,8600,7315,5890,3903,2796
38345,215,1909,26880,11465,3.42437e+13,841.512,6178.18,38345,367,408,33600,31155,21756,10349,8863
60741,1388,2664,42335,18406,3.56045e+13,1027.01,9132.72,60741,564,545,57966,57317,54071,46683,38169
14662,251,828,9919,4743,3.53095e+13,485.663,2812.61,14662,275,272,12553,11038,9311,6802,6708
72755,1015,3649,49274,23481,3.42113e+13,878.389,11507.2,72755,591,820,68820,67306,55043,45786,28444
6921,532,591,4602,2319,2.73506e+13,107.213,1491.49,6921,111,129,6330,6330,6330,6328,6234
93525,961,3399,63840,29685,3.34745e+13,1231.98,11699,93525,577,558,89114,86711,61705,47475,46590
67968,1542,3203,48094,19874,3.68276e+13,1241.54,10849.7,67968,621,597,64586,63388,58953,46675,44391
86690,1357,3013,60952,25738,3.36539e+13,935.435,11258.8,86690,534,637,83677,82919,81074,78170,59107
3033,357,587,2014,1019,3.2905e+13,121.106,1102.68,3033,98,133,2446,2390,2413,2396,1628
12216,371,1067,8372,3844,3.63874e+13,471.864,2941.82,12216,234,304,10802,10113,8047,6033,5230
11986,245,1127,8535,3451,3.6981e+13,323.186,2772.19,11986,270,233,10284,8957,8174,6639,3737
83744,682,3646,58914,24830,3.58369e+13,894.561,11995.4,83744,576,564,79199,77219,51889,36644,24082
75982,1598,2975,52616,23366,3.54064e+13,1058.75,10565.4,75982,636,556,73007,72043,67008,54872,55495
6276,190,856,4210,2066,3.50982e+13,188.472,1838.33,6276,199,186,5326,4978,4210,3625,1676
5289,326,1069,3611,1678,3.2392e+13,166.342,1986.97,5289,256,177,4220,3998,3414,3023,2177
66441,2839,2983,46774,19667,3.65908e+13,810.462,9781.3,66441,471,549,63458,63458,63409,63435,62978
82812,218,3788,56858,25954,3.56585e+13,1132.55,12439.2,82812,698,672,71001,63216,39907,13488,10595
59853,2049,2315,42378,17475,3.64725e+13,916.642,8141.11,59853,561,437,57538,57533,57159,56168,56153
81078,1532,2520,57210,23868,3.66948e+13,626.061,8945.77,81078,427,467,78558,78442,76935,76710,62945
54796,993,2439,37915,16881,3.43915e+13,909.483,8383.45,54796,444,506,51820,50841,47529,38656,25802
6144,238,751,4075,2069,3.32892e+13,216.703,1732.28,6144,206,185,5283,4731,4463,4265,2589
3153,252,581,2219,934,3.22314e+13,91.83,1084.58,3153,151,94,2572,2537,2422,2040,1763
89546,1095,2405,63462,26084,3.52143e+13,1129.92,10188.6,89546,625,473,86540,85021,76872,58228,49016
16228,930,1052,11062,5166,3.55968e+13,271.287,2908.85,16228,211,214,15176,15176,15015,15005,14751
48497,1254,2066,33848,14649,3.62553e+13,756.997,7107.45,48497,487,462,46431,46344,43699,39330,34895
38479,1647,2038,26961,11518,3.60002e+13,455.07,5992.01,38479,419,316,36441,36440,36166,36050,34557
81656,2417,3724,56668,24988,3.53985e+13,876.674,12278.7,81656,741,502,77932,77794,74429,66049,64326
27461,1104,1768,19061,8400,3.67267e+13,446.418,4953.46,27461,338,247,25693,25540,24557,22030,21609
31123,23798,31123,0,31123,15.9995,0,31123,31123,31123,1,0,0,0,0,0
99719,1031,3310,68531,31188,3.50252e+13,1188.92,12508.3,99719,758,581,95655,94228,76602,53479,38779
17657,1279,1458,12140,5517,3.28585e+13,402.229,3832.45,17657,325,283,16199,16085,15881,15848,15077
39435,443,2273,27397,12038,3.6107e+13,704.224,6877.3,39435,520,396,35777,33193,24490,18374,15191
70195,560,2347,48706,21489,3.55036e+13,916.045,8796.62,70195,564,442,65664,62417,42887,32228,26453
84490,2012,2464,58353,26137,3.46422e+13,841.718,9077.53,84490,587,463,82026,81777,80844,78415,76771
3433,272,625,2304,1129,3.4973e+13,140.515,1218.14,3433,123,120,2808,2648,2430,1931,1830
17320,787,1288,12004,5316,3.34794e+13,312.703,3459.74,17320,196,226,16032,15964,15814,15369,10383
33247,75,2058,22953,10294,3.25893e+13,678.993,6052.79,33247,392,412,26301,21628,15667,7978,3384
63721,716,2511,43796,19925,3.27071e+13,944.099,8854.74,63721,452,486,60252,58468,52361,36412,25216
35955,208,1598,25034,10921,3.64145e+13,475.022,5097.26,35955,309,342,31661,26745,21653,13275,12257
6419,263,1084,4706,1713,3.82911e+13,191.205,2115.1,6419,233,159,5261,4923,3831,2476,1805
87595,1906,3011,60304,27291,3.29821e+13,1184.35,11149.3,87595,669,542,84584,84341,79000,66955,56006
8132,1038,1111,5602,2530,3.3495e+13,251.205,2501.62,8132,170,235,7021,7021,7010,7018,6866
92363,2142,2988,65554,26809,3.68069e+13,1070.77,11301.3,92363,593,487,89375,89301,87351,83913,80140
8185,111,598,5629,2556,3.62601e+13,247.287,1678.88,8185,156,152,6414,5422,3891,2873,2193
18649,213,1690,12919,5730,3.44699e+13,392.033,4354.77,18649,219,317,16262,15165,10800,7535,3769
52151,410,2283,36762,15389,3.68681e+13,811.66,7650.46,52151,535,375,47465,44227,34590,24679,18030
24110,924,1308,16729,7381,3.42302e+13,468.661,4195.78,24110,344,292,22802,22728,22262,22254,18949
37122,650,1647,25778,11344,3.65969e+13,661.709,5637.25,37122,432,348,35149,33646,30291,22505,21643
31124,898,1310,21105,10019,3.44247e+13,423.772,4234.05,31124,274,259,29814,29681,28698,27523,24764
3367,380,556,2358,1009,3.77145e+13,154.233,1124.77,3367,117,117,2811,2804,2788,2777,2325
43758,1690,2664,30860,12898,3.63796e+13,811.268,7846.87,43758,439,525,41094,40895,40315,39570,32761
69165,536,2872,48594,20571,3.48246e+13,877.63,9975.68,69165,676,446,64507,61254,42528,31438,20970
52331,2101,2415,36018,16313,3.40161e+13,727.798,7656.81,52331,493,395,49916,49868,49816,49858,47907
40369,700,2079,29087,11282,3.60702e+13,849.926,6964.24,40369,536,464,37584,35808,32858,24434,13532
19104,761,1355,13514,5590,3.59101e+13,565.936,3876.44,19104,346,369,17731,17454,15901,13627,13236
30130,1140,1516,21282,8848,3.64728e+13,592.148,4961.61,30130,358,311,28614,28389,27810,27147,25531
69007,1662,2547,47700,21307,3.45648e+13,1092.39,9057.68,69007,510,448,66460,65776,62860,56126,52526
55298,2107,2769,39248,16050,3.49565e+13,828.142,9120.02,55298,534,491,52529,52484,51846,50900,43637
90531,958,1783,64886,25645,3.8265e+13,593.34,8028.78,90531,553,357,88748,88701,83024,74738,72277
59328,1416,2422,40809,18519,3.18606e+13,975.526,8234.23,59328,426,547,56906,55952,53234,45173,40929
32459,1516,1804,23006,9453,3.80904e+13,730.038,5564.39,32459,478,339,30655,30651,30134,29143,29117
20422,756,1333,14614,5808,3.71636e+13,536.447,3928.84,20422,365,311,19056,18262,17614,16296,13174
6118,572,877,4363,1755,3.59835e+13,219.012,1875.48,6118,237,161,5241,5167,4786,4424,3910
4106,615,714,2755,1351,3.59618e+13,133.921,1463.85,4106,108,183,3392,3392,3375,3389,3226
90892,760,2643,63412,27480,3.59963e+13,835.791,9998.04,90892,558,493,87482,85984,65582,49367,47839
10590,987,1263,7189,3401,3.41184e+13,294.084,2972.25,10590,279,244,9327,9307,8952,8265,8161
54434,1327,1539,38796,15638,3.66978e+13,710.828,6119.12,54434,470,327,52895,52613,52421,51744,48920
50275,739,2874,35743,14532,3.7006e+13,945.303,8829.78,50275,635,497,46554,44224,38297,28929,20774
43867,1288,2236,31899,11968,3.68621e+13,889.434,7419.4,43867,558,458,41599,40949,39937,35627,29367
37445,886,1789,25547,11898,3.57423e+13,435.862,5414.5,37445,369,467,35656,35438,32733,25861,24835
49448,285,2225,34102,15346,3.56863e+13,444.388,7179.08,49448,373,429,44381,39248,31590,20325,17916
68807,2112,2272,49023,19784,3.70724e+13,1120.11,9236.39,68807,678,478,66535,66437,66299,66115,65246
84555,917,3026,58468,26087,3.26866e+13,1204.59,10820.4,84555,564,639,80508,78151,69200,52900,28720
84370,1688,3289,59045,25325,3.60298e+13,1021.21,11673.7,84370,613,503,81081,80220,73291,58104,55725
77477,2067,2712,53328,24149,3.52134e+13,928.351,9967.04,77477,547,461,74765,74668,73887,71953,67901
63186,1931,3319,44237,18949,3.72177e+13,760.275,10629,63186,466,661,59867,59798,58963,58617,48401
66949,1882,2781,46571,20378,3.6589e+13,737.774,9274.08,66949,412,689,64168,64111,63705,63474,55899
80994,1772,3517,56118,24876,3.51326e+13,919.953,11682.3,80994,629,494,77477,77037,65997,46690,45196
76461,1478,3293,52942,23519,3.48563e+13,817.829,10890.1,76461,582,501,73168,72819,64953,52374,51177
40007,1068,2124,27537,12470,3.5322e+13,575.528,6659.39,40007,400,452,37883,37415,34999,31021,24325
63664,878,2637,44214,19450,3.69956e+13,1010.21,8899.18,63664,614,463,60607,59561,40391,29830,28521
61077,2141,2206,42862,18215,3.52832e+13,813.015,8065.44,61077,543,421,58871,58871,58844,58851,58696
46573,2163,2532,32059,14514,3.37401e+13,787.878,7834.11,46573,512,423,44041,44039,43878,43566,41424
2823,339,570,1974,849,4.09373e+13,126.163,1019.36,2823,149,108,2253,2223,2224,2228,1741
41448,123,2238,29025,12423,3.61136e+13,873.861,7229.63,41448,465,488,33335,29191,21574,5228,4708
27084,686,1781,19030,8054,3.73574e+13,518.206,5084.71,27084,448,384,25234,24766,22861,18614,17625
96684,467,3468,66938,29746,3.38961e+13,1247.72,12407.5,96684,693,593,89068,84447,55495,28500,24508
31514,2062,2195,21608,9906,3.52401e+13,624.747,6237.51,31514,424,424,29319,29317,29293,29301,28960
22564,528,1307,15436,7128,3.51051e+13,506.791,4136.73,22564,287,298,21009,20242,17879,12916,11273
19059,689,1466,13516,5543,3.5847e+13,372.561,3972.55,19059,253,288,17593,17317,16108,16210,9559
76565,1097,2483,53490,23075,3.59899e+13,1187.78,9534.13,76565,613,567,73417,72173,67234,53996,37737
98816,574,3346,68552,30264,3.48978e+13,1046.78,11679.9,98816,568,613,93423,91141,60842,39048,34466
39286,1359,1823,27321,11965,3.20912e+13,621.265,5871.45,39286,407,332,37463,37452,37069,36560,33822
75780,881,3175,53585,22195,3.52973e+13,1445.45,11161.5,75780,545,607,70964,68848,63677,48060,30103
27921,1249,1706,19448,8473,3.68479e+13,448.429,4804.94,27921,360,292,26215,26188,25598,24929,24151
40965,1676,2425,28528,12437,3.65114e+13,604.366,7329.61,40965,442,465,38540,38406,37125,35615,30297
18927,1532,1553,13512,5415,3.58617e+13,430.366,4085.9,18927,324,277,17374,17374,17372,17374,17337
77802,732,2234,54482,23320,3.65234e+13,1005.78,9201.78,77802,606,468,74218,72637,63146,46702,39041
21985,340,1257,15457,6528,3.51041e+13,357.488,3771.06,21985,338,205,20405,18729,16264,13656,10122
38767,640,1985,26914,11853,3.2265e+13,694.669,6136.83,38767,362,392,36242,35231,31842,24053,14000
79020,2152,3113,55064,23956,3.6096e+13,911.558,10699.5,79020,579,564,75907,75801,73517,68628,67097
19520,1535,1710,13637,5883,3.51752e+13,324.526,4363.43,19520,299,356,17810,17803,17806,17797,16632
99523,2898,3808,69964,29559,3.3903e+13,871.405,13891.4,99523,552,909,95715,95665,95182,94995,86003
27473,1012,1704,19087,8386,3.3808e+13,745.507,5004.51,27473,311,401,25638,24948,24711,22895,18985
25931,517,1718,18200,7731,3.32808e+13,499.8,4946.57,25931,338,293,24035,23122,20131,12054,9010
35659,159,1606,24825,10834,3.5747e+13,496.411,5061.86,35659,296,318,29689,24605,18410,6668,6981
49759,825,2232,34717,15042,3.29006e+13,724.284,7342.42,49759,372,440,47173,45669,44897,42265,30784
82842,1679,2409,57444,25398,3.61421e+13,1154.57,9911.74,82842,560,506,80433,79689,78103,74573,66273
82928,2805,3352,56397,26531,3.48439e+13,1313.33,11602.1,82928,603,619,79576,79548,79041,78386,76350
91663,591,1942,63093,28570,3.03756e+13,864.762,8573.88,91663,533,434,88165,85149,73913,55384,42873
44027,819,2683,30055,13972,3.49152e+13,672.157,7969.67,44027,477,533,41154,40148,33681,27007,19364
20563,1495,1639,14483,6080,3.67575e+13,533.657,4433.76,20563,326,338,18924,18841,18838,18812,18500
95636,3601,3746,66214,29422,3.39012e+13,1133.17,12628,95636,541,694,91890,91888,91847,91848,91402
16029,768,1346,11259,4770,3.46906e+13,292.851,3509.61,16029,217,259,14683,14628,14340,14381,10794
10876,5985,10876,0,10876,15.9985,0,10876,10876,10876,1,0,0,0,0,0
31072,430,1991,21258,9814,3.38835e+13,534.38,5956.58,31072,494,321,28302,26914,21368,15671,9999
87850,152,3723,60477,27373,3.49895e+13,1043.85,12672.8,87850,595,791,72507,63521,43719,17395,9751
6136,358,856,4234,1902,3.67481e+13,192.959,1858.37,6136,151,192,5280,5121,4864,4915,2750
88337,780,3010,61905,26432,3.38192e+13,1071.86,11090.8,88337,645,520,83677,81345,59385,40828,33206
3107,152,583,2072,1035,3.47477e+13,132.201,1140.05,3107,121,149,2475,2162,1937,1956,882
61087,467,2110,42030,19057,3.47143e+13,1026.92,7586.93,61087,478,450,56645,53995,34755,26026,24195
71736,2280,3176,50246,21490,3.64254e+13,870.709,10966.1,71736,460,504,68560,68411,68109,67940,59175
35131,230,2040,24772,10359,3.39918e+13,502.657,6088.26,35131,358,376,31158,27899,22761,14080,8930
88528,2001,2876,62037,26491,3.51429e+13,1229.12,10624.2,88528,692,547,85652,85189,81465,71601,73910
71273,1507,3037,48759,22514,3.3794e+13,917.962,10065.7,71273,540,562,68236,67232,63281,54779,47674
5157,117,405,3627,1530,2.49698e+13,112.888,1092.14,5157,112,89,4680,3949,3786,3831,1904
19240,1105,1825,13384,5856,3.60396e+13,425.943,4748.96,19240,347,330,17415,17299,17140,17161,14210
76376,2636,3515,52874,23502,3.58648e+13,934.816,11847,76376,780,621,72861,72856,71187,66371,66024
88370,2151,3801,61695,26675,3.59573e+13,983.302,12770.5,88370,590,673,84569,84302,79860,72292,58880
54524,299,2268,37702,16822,3.48448e+13,965.93,8041.65,54524,474,450,48970,44776,31438,18427,11938
99344,2956,3269,68577,30767,3.52416e+13,1043.14,12737.5,99344,646,654,96075,96067,95343,93937,92636
26957,217,1512,18739,8218,3.71879e+13,593.426,4641.77,26957,370,328,23207,20233,14238,9403,8809
67617,2884,3349,47067,20550,3.3675e+13,917.568,10552.9,67617,528,517,64268,64263,64084,63966,58898
4883,397,607,3180,1703,3.14205e+13,156.574,1362.21,4883,149,159,4276,4231,4205,4158,3029
84787,134,2979,58539,26248,3.54797e+13,1051.82,10756.3,84787,552,456,70659,61970,41734,15701,9509
99774,757,4115,68749,31025,3.37786e+13,979.814,13957.5,99774,804,520,94344,91982,53748,29329,19140
20513,1064,1534,14456,6057,3.68695e+13,522.979,4216.88,20513,322,262,18979,18730,18351,16404,15788
60628,1034,2563,42226,18402,3.3005e+13,951.562,8786.23,60628,595,417,57691,56539,50382,33079,27635
63149,1347,2117,43520,19629,3.04649e+13,952.229,7954.52,63149,486,417,61032,60164,59392,56320,50411
16304,226,1187,10905,5399,3.36685e+13,449.784,3351.19,16304,261,335,14317,13140,8858,7615,3336
85201,2244,3343,58987,26214,3.49697e+13,1024.39,12168.3,85201,541,678,81858,81632,81091,80301,67571
8855,217,816,6015,2840,3.53564e+13,333.677,2148.31,8855,198,222,7685,6892,6144,5168,3088
21535,1300,1505,14890,6645,3.33981e+13,514.605,4204.9,21535,335,273,20030,19949,19966,19956,19205
31591,75,2240,21704,9887,3.47979e+13,551.451,6430.94,31591,359,423,23864,20686,14216,4922,3244
87181,410,2907,60397,26784,3.63883e+13,1371.85,10650.4,87181,599,599,80471,76593,48933,24993,23803
27811,181,1879,19093,8718,3.58801e+13,541.156,5494.51,27811,383,380,23423,20679,14142,7513,5377
82694,1690,3312,58928,23766,3.65053e+13,1128.36,11608.3,82694,603,602,79242,77969,75029,66339,51149
13454,420,1288,9338,4116,3.61986e+13,352.349,3302.85,13454,236,299,11971,11313,10617,9011,4667
11237,124,1314,8063,3174,3.54227e+13,239.581,3036.19,11237,290,159,9141,7937,6290,3780,2502
53994,1236,2811,38076,15918,3.61906e+13,1106.41,9028.71,53994,624,447,50842,48904,44938,35673,33838
96185,1030,2944,68752,27433,3.67608e+13,938.84,11621.9,96185,759,438,92855,90303,81676,59261,55472
54896,237,2754,38845,16051,3.63978e+13,837.598,8842.01,54896,585,425,47806,42499,30015,12027,10293
52881,923,2401,36285,16596,3.52356e+13,906.285,8126.27,52881,500,524,50116,48703,45586,38637,25897
87812,1406,2221,63247,24565,3.74979e+13,967.136,9400.94,87812,600,531,85591,85188,80991,69372,71164
96012,928,3155,66562,29450,3.53259e+13,877.721,10911.4,96012,562,646,92449,90943,67019,46972,45615
10703,94,698,7150,3553,3.55923e+13,317.547,2083.48,10703,198,199,7942,6970,5291,2125,2624
28525,455,1573,19537,8988,3.34111e+13,489.368,4938.26,28525,385,399,26317,25231,21919,17065,11816
66654,1422,2675,47274,19380,3.60323e+13,1075.89,9502.62,66654,568,483,63907,63076,57952,45659,43922
33189,745,1904,23536,9653,3.70031e+13,689.621,5869.89,33189,518,338,31088,30072,27305,21996,19912
80730,445,2942,55965,24765,3.54427e+13,976.015,10145.9,80730,466,486,75345,71905,48657,31188,24328
96834,173,3275,66614,30220,3.3306e+13,919.726,11918.5,96834,611,496,82592,72782,48964,16335,9678
12824,871,1119,9051,3773,3.82395e+13,478.681,2954.48,12824,289,236,11705,11383,11484,11123,10658
11140,190,1339,7771,3369,3.58066e+13,354.06,3094.93,11140,297,220,9276,8486,6618,4723,2348
51348,377,2482,35695,15653,3.5615e+13,736.05,8189.16,51348,521,383,46653,43716,30260,20759,13013
11603,612,1180,8236,3367,3.77059e+13,414.071,2962,11603,269,203,10321,9858,9466,7989,6885
90988,262,3551,63727,27261,3.63386e+13,1081.18,12899.1,90988,646,607,80654,73352,52014,14841,14840
40431,1071,2193,28310,12121,3.46814e+13,766.795,7102.66,40431,487,352,38138,37199,35462,30100,25431
69598,2004,2066,49029,20569,3.65335e+13,960.827,7661.13,69598,521,394,67532,67532,67499,67527,67414
74496,1033,2131,51501,22995,3.30777e+13,1030.43,8573.95,74496,532,435,71803,69018,64954,51569,50017
22208,651,1871,15916,6292,3.74649e+13,568.4,5027.38,22208,424,374,20055,19470,18247,15870,10712
51380,1755,1985,35526,15854,3.28315e+13,925.059,7094.2,51380,437,395,49395,49286,49011,48263,46767
90161,97,3174,62946,27215,3.49406e+13,1206.15,11725,90161,661,517,72097,62566,42274,17002,8379
10835,235,1453,7793,3042,3.75102e+13,254.878,3118.34,10835,207,301,9122,8132,7760,7199,2535
9566,521,1226,6575,2991,3.66956e+13,266.584,2708.16,9566,207,250,8340,8130,7730,7562,4972
90804,2091,3537,63908,26896,3.56601e+13,1013.34,12649.2,90804,615,596,87267,86983,85067,82864,57522
57848,2110,3002,40403,17445,3.61491e+13,767.445,9300.35,57848,503,545,54846,54778,54123,53284,44001
56393,1101,2250,40191,16202,3.71699e+13,722.985,7688.12,56393,488,450,54143,53817,48215,41675,31107
80732,639,2152,59363,21369,3.6963e+13,1167.13,9458.25,80732,688,434,75217,71954,65902,50461,38108
12053,50,1176,8430,3623,3.69134e+13,479.959,2948.61,12053,250,274,8615,7052,5169,2331,1132
86170,2718,2999,58628,27542,3.34906e+13,809.729,10976.6,86170,506,493,83171,83163,83071,83010,78906
10576,855,863,7071,3505,3.35793e+13,365.672,2432.65,10576,222,238,9713,9712,9709,9709,9705
96180,2382,2843,66240,29940,3.60616e+13,1216.9,11642.2,96180,681,607,93337,93337,92086,90410,90033
53222,1493,2170,37222,16000,3.64235e+13,679.87,7449.47,53222,531,483,51052,51005,50362,48851,47385
37533,110,2447,25711,11822,3.57254e+13,542.891,7026.28,37533,481,606,29817,25769,16187,7573,4906
15196,582,1480,10517,4679,3.25285e+13,283.123,3530.35,15196,222,267,13716,13366,13010,11913,9227
90657,3297,3511,62938,27719,3.6448e+13,1209.78,12133.2,90657,643,642,87146,87131,87053,86996,86017
65138,2228,2877,44795,20343,3.58548e+13,913.753,9550.14,65138,563,490,62261,62140,61553,60812,58738
24972,742,1984,17636,7336,3.63417e+13,593.403,5419.1,24972,355,409,22860,22132,20640,16757,11226
68080,2078,2807,46683,21397,3.37188e+13,834.231,9674.87,68080,436,562,65273,65200,64739,64496,57666
76059,302,3320,53156,22903,3.57621e+13,1039.31,11230.5,76059,603,705,67476,61976,45681,21265,13325
3380,177,453,2327,1053,3.71477e+13,224.462,1007.5,3380,142,137,2662,2231,2286,2217,1855
14624,1195,1505,10583,4041,3.73775e+13,367.944,3590.87,14624,272,201,13119,13103,13012,13026,11559
17910,1086,1416,12611,5299,3.59861e+13,347.13,3753.6,17910,385,186,16494,16474,16238,15237,15690
3307,602,649,2385,922,3.66064e+13,134.627,1197.36,3307,152,113,2658,2656,2655,2657,2582
27788,497,1267,19166,8622,3.6729e+13,368.755,3821.59,27788,248,250,26521,26315,20781,15667,14065
42980,703,1912,30165,12815,3.64593e+13,781.146,6530.91,42980,421,437,40506,37669,34942,27343,25607
69267,326,2433,48500,20767,3.41225e+13,982.515,8919.78,69267,582,432,62949,57981,39898,24451,15822
42401,1430,2305,30292,12109,3.6041e+13,972.449,7442.83,42401,477,409,40085,39273,38226,36315,28048
37905,397,2258,26404,11501,3.59223e+13,687.087,6958.17,37905,375,474,34273,32207,22918,16037,11841
38166,693,2032,27485,10681,3.76515e+13,700.946,6551.85,38166,440,413,35731,34388,31917,25712,18322
46768,166,2375,33175,13593,3.66897e+13,896.607,7638.74,46768,457,453,38722,33876,25423,7980,7243
92806,2091,2813,65295,27511,3.52245e+13,1220.04,11468.2,92806,642,569,89993,89895,86973,77083,74934
39192,393,2104,27542,11650,3.74253e+13,913.447,6781.81,39192,522,460,35050,32264,24496,18221,10629
73276,2917,3589,51599,21677,3.67116e+13,901.52,11529.8,73276,650,467,69687,69684,68819,67441,64386
67161,654,2681,46195,20966,3.31907e+13,949.773,9418.74,67161,493,558,63080,60998,51536,36761,26788
31335,1593,2097,21953,9382,3.6169e+13,693.063,6049.66,31335,366,409,29238,29218,29118,29178,27310
54788,2110,2228,37349,17439,3.45938e+13,667.178,7669.7,54788,458,375,52560,52557,52521,52482,52033
47331,1264,2339,32813,14518,3.53773e+13,699.067,7743.95,47331,458,476,44992,44596,41972,35592,34356
98357,1665,2836,68942,29415,3.60238e+13,1053.15,10805.4,98357,707,522,95521,94824,87841,71289,77866
90013,1291,3458,61575,28438,3.49648e+13,1093.85,12167.4,90013,696,607,86366,85080,66741,51954,52097
84514,1658,2599,59571,24943,3.70191e+13,999.154,10147,84514,557,445,81915,81633,75815,63839,63365
19845,389,1564,13882,5963,3.20504e+13,336.449,4055.16,19845,289,217,18119,17383,13416,9893,6728
17668,1160,1528,12312,5356,3.60265e+13,481.755,4079.03,17668,246,337,16140,16135,16017,16003,14366
30306,1616,2019,20587,9719,3.48379e+13,604.313,5734.28,30306,391,481,28287,28281,27752,26939,26606
75784,2276,2799,53183,22601,3.50963e+13,1037.78,10206.2,75784,560,449,72985,72788,72673,72468,67117
65328,43,2642,45771,19557,3.68514e+13,828.604,8803.13,65328,510,423,45292,37130,28577,11243,6008
36447,682,1892,25022,11425,3.5213e+13,602.074,6097.88,36447,352,421,34304,33128,29050,22568,18419
8824,402,1026,6105,2719,3.64064e+13,235.059,2389.52,8824,175,189,7798,7533,7087,7192,4203
85333,1589,4158,59320,26013,3.58643e+13,891.501,13620.6,85333,755,610,81175,80396,64937,47922,37993
68570,1597,2276,48371,20199,3.59246e+13,991.516,8709.35,68570,538,477,66294,65989,64558,61651,58511
83964,1698,2864,59386,24578,3.6824e+13,1184.59,10919.3,83964,715,534,81079,80273,76392,70145,56832
98569,2077,2536,71061,27508,3.72332e+13,1364.77,11235.5,98569,668,535,96033,95873,95469,94774,91504
43647,1582,2209,31381,12266,3.66258e+13,831.034,7058.22,43647,512,446,41438,40852,40308,38475,37342
81982,1412,3265,56667,25315,3.39186e+13,1026.2,11168.9,81982,550,479,78693,77616,69011,46044,38096
32111,2116,2284,22164,9947,3.46186e+13,585.112,6412.82,32111,412,481,29827,29827,29823,29827,29112
37965,1185,1771,26176,11789,3.47878e+13,532.594,5963.22,37965,320,327,36194,36090,35991,35860,32097
64472,1124,2629,44758,19714,3.55028e+13,894.642,8936.4,64472,526,480,61600,60850,52538,41338,41122
95758,1368,3152,67871,27887,3.5738e+13,1320.07,12342.6,95758,708,543,92191,90448,82032,64655,50935
57699,2465,3010,39198,18501,3.44572e+13,800.625,9299.54,57699,503,526,54689,54665,54376,54267,51300
1205,250,322,825,380,3.43412e+13,58.0979,533.959,1205,72,69,883,883,873,877,819
58834,772,2930,41079,17755,3.53357e+13,949.802,9104.73,58834,540,460,55178,53674,39918,30814,27144
6272,394,860,4292,1980,3.62445e+13,203.62,1859.69,6272,181,159,5412,5276,5035,4213,3997
50146,1621,2386,34614,15532,3.40561e+13,405.281,7539.82,50146,404,466,47760,47699,47044,46227,37197
79820,2415,3498,55680,24140,3.58114e+13,943.23,11289,79820,511,594,76322,76198,75103,73494,66777
35964,482,2570,25501,10463,3.61668e+13,624.67,7012.5,35964,576,319,32799,31347,18378,14393,8565
86236,2753,2810,60072,26164,3.65056e+13,936.243,10526.5,86236,609,526,83426,83426,83418,83388,83254
96187,1069,3115,66051,30136,3.39442e+13,1283.65,11365.8,96187,602,587,92180,90125,73301,53341,52876
38938,2081,2083,27507,11431,3.54497e+13,730.261,6294.79,38938,459,345,36855,36855,36855,36855,36853
45369,1523,2439,32266,13103,3.64141e+13,755.408,7773.33,45369,433,499,42930,42690,41696,40243,31941
68432,398,2678,47175,21257,3.49941e+13,1122.95,9636.12,68432,559,621,62777,59201,46587,28099,10895
43569,322,2476,30470,13099,3.67669e+13,873.046,7591.26,43569,430,513,38450,35439,25003,14826,10126
97432,2788,2990,69390,28042,3.64343e+13,1096.3,11986.4,97432,639,533,94442,94442,94333,94416,92573
31853,1616,2191,21844,10009,3.41643e+13,736.74,6314.82,31853,364,428,29662,29446,29159,28556,24217
66759,1756,2661,45205,21554,3.34422e+13,727.811,8966.93,66759,450,451,64098,64002,61238,53050,53644
88834,1251,3937,62612,26222,3.54483e+13,975.341,13309.8,88834,686,576,84706,83246,72029,49764,39742
54764,1156,2293,38059,16705,3.45736e+13,659.457,7858.16,54764,417,477,52471,51963,47838,38160,31682
31506,1639,2219,22182,9324,3.49084e+13,687.166,6156.66,31506,337,367,29287,29088,29028,29114,26716
4165,546,774,3060,1105,3.72398e+13,123.22,1457.58,4165,168,135,3391,3373,3365,3356,2625
82225,428,2925,55642,26583,3.52689e+13,809.981,10315.6,82225,495,568,76124,71416,45613,26283,22691
36888,1131,1742,25510,11378,3.47448e+13,725.083,5901.5,36888,437,328,35146,34390,32940,29387,28605
52358,1631,2521,35633,16725,3.45949e+13,668.941,8257.67,52358,450,397,49837,49736,46418,41296,35496
53123,319,1954,37040,16083,3.30817e+13,905.34,7179.01,53123,503,404,48031,45246,32463,20213,12047
46230,1290,1973,31986,14244,3.55534e+13,717.539,7023.21,46230,514,446,44257,44165,42758,41105,38894
53030,1798,2578,37049,15981,3.63909e+13,793.895,8083.58,53030,576,475,50452,50157,48090,42452,44304
3163,172,503,2162,1001,3.5603e+13,217.938,1057.88,3163,153,135,2463,2113,2074,1879,1513
34099,439,2234,24146,9953,3.62994e+13,762.017,6427.73,34099,455,375,30842,29342,23098,17690,10480
41113,1522,2229,27642,13471,3.34381e+13,577.544,6712.04,41113,456,358,38884,38766,38117,36798,33049
26082,821,1780,18739,7343,3.6492e+13,734.992,5204.58,26082,379,378,24089,23306,22686,20331,14985
10065,964,1077,6953,3112,3.58721e+13,255.335,2581,10065,181,272,8988,8988,8978,8986,8552
83148,1648,3115,56224,26924,3.44059e+13,1125.97,10980.8,83148,590,633,80033,79262,74316,61921,55859
46731,1423,2339,31740,14991,3.29209e+13,766.709,7495.05,46731,398,425,44392,43996,42426,38659,30290
38820,1319,2116,27810,11010,3.69706e+13,764.662,6820.74,38820,435,408,36704,36268,35490,34189,29701
28602,727,1913,20181,8421,3.708e+13,509.201,5558.35,28602,304,362,26615,25795,24365,23927,14884
97239,57,2637,67964,29275,3.63736e+13,1285.43,10495.6,97239,590,519,69952,59022,44941,16417,8567
80840,1025,2937,57100,23740,3.62922e+13,1117.03,10852.2,80840,632,556,77246,74906,66663,49705,41413
80183,600,3546,56022,24161,3.4719e+13,965.103,11556.7,80183,575,642,74749,71200,51211,34566,23794
23952,178,2029,16565,7387,3.57494e+13,479.312,5540.29,23952,453,328,19743,17429,12056,6598,4063
53076,1602,2313,36548,16528,3.36179e+13,814.127,7906.71,53076,371,470,50763,50571,49856,48941,42176
34468,1786,2214,24803,9665,3.65075e+13,538.953,6503.76,34468,336,439,32254,32239,32072,32098,28717
8304,264,1026,5647,2657,3.57996e+13,226.982,2416.79,8304,141,255,7218,6566,6014,5469,3032
81048,1986,3174,57460,23588,3.6745e+13,1052.16,11348.6,81048,625,558,77874,77508,75972,71241,67061
70485,2183,3444,49038,21447,3.61091e+13,1166.74,11277.1,70485,606,626,67041,66237,64136,57122,51995
26491,1634,1994,19233,7258,3.60772e+13,566.987,5539.29,26491,384,317,24497,24386,24320,24429,22473
55254,190,1798,37519,17735,3.46899e+13,472.114,6357.34,55254,372,382,47582,40211,29351,13127,12749
49517,2178,2540,35434,14083,3.70288e+13,817.263,8232.66,49517,638,423,46977,46969,46123,44417,44077
8425,914,1029,6095,2330,3.47533e+13,213.542,2317.71,8425,184,212,7396,7395,7394,7395,6885
66324,777,2794,47263,19061,3.61317e+13,916.028,9589.77,66324,472,489,63056,61209,52376,32696,24402
44362,2128,2476,30467,13895,3.50678e+13,950.041,7885.44,44362,478,566,41886,41865,41722,41419,39751
29389,1594,1834,20144,9245,3.3669e+13,748.143,5503.37,29389,352,380,27555,27489,27430,27344,26317
58919,297,2455,41465,17454,3.33351e+13,1145.92,8424.12,58919,625,529,53021,49190,36166,18630,12535
43811,1813,2474,29991,13820,3.58161e+13,680.758,7631.34,43811,417,481,41337,41320,40896,40830,37683
66438,1107,2609,45328,21110,3.47925e+13,852.467,8821.27,66438,464,511,63829,63082,53628,41575,36494
85056,1943,2790,59468,25588,3.37183e+13,1025.97,10664.6,85056,548,584,82266,82235,81110,79800,74431
49442,2167,2541,34192,15250,3.49452e+13,799.081,8116.51,49442,465,470,46901,46708,46536,45997,44533
73160,420,3335,51470,21690,3.53079e+13,881.491,11068.4,73160,699,451,67546,64041,43256,27450,15888
89739,422,3464,61752,27987,3.55993e+13,1002.86,11368.8,89739,582,544,83755,77976,48418,22892,23181
64839,1921,2737,44848,19991,3.50038e+13,786.909,8942.93,64839,577,399,62102,62023,61182,59406,55674
49315,1863,1938,34522,14793,3.62472e+13,942.441,7010.11,49315,468,429,47377,47377,47351,47362,47235
52725,1377,2088,36742,15983,3.41238e+13,658.811,7032.18,52725,441,365,50637,50491,49717,48831,43682
32644,1340,1964,22407,10237,3.59475e+13,540.059,6017.41,32644,364,445,30680,30628,30179,29575,25242
78644,1952,3834,54930,23714,3.54353e+13,1225.04,12812.9,78644,687,622,74810,73755,69343,54980,50950
71743,1972,3519,49894,21849,3.44355e+13,1057.8,11553.3,71743,679,560,68224,67576,62980,50684,48271
69740,573,3378,48955,20785,3.65398e+13,840.492,10830.2,69740,608,458,64676,61375,44124,31811,25244
4650,358,636,3242,1408,3.52112e+13,223.742,1407.56,4650,175,169,4014,3764,3545,3043,3081
57578,1972,2421,40142,17436,3.51105e+13,795.225,8082.74,57578,521,399,55157,55046,54041,52898,49297
18932,354,1524,13210,5722,3.59789e+13,493.867,4126.62,18932,313,287,16769,15378,12709,9938,6645
92286,1356,3191,65921,26365,3.70297e+13,1137.83,11684.3,92286,689,561,88987,87294,80376,59996,64589
60462,1184,2720,42163,18299,3.57896e+13,822.515,9286.29,60462,545,445,57742,56880,49463,35136,31861
10757,235,942,7461,3296,3.78017e+13,248.332,2308.39,10757,193,201,9443,8165,6556,5095,5068
91017,652,3286,64057,26960,3.67458e+13,1126.41,11689.4,91017,615,581,85623,82930,60015,43107,32120
41147,1008,1876,28273,12874,3.27863e+13,860.99,6308.15,41147,391,373,38881,37902,36815,32836,28323
69843,722,2606,48729,21114,3.41859e+13,774.247,9303.43,69843,520,418,66489,63997,49340,30811,23393
39433,617,1294,28489,10944,3.78476e+13,622.946,4919.79,39433,404,299,37799,34885,33939,30102,25330
66282,356,2685,46436,19846,3.53543e+13,1048.84,9343.05,66282,537,558,60401,57172,40893,23578,15529
64926,453,2571,44517,20409,3.47222e+13,685.717,8314.61,64926,494,524,61369,59508,43291,30211,21911
52941,1149,2581,36444,16497,3.39808e+13,840.878,8600.28,52941,494,520,50230,49283,46188,35495,32233
17281,879,1594,11778,5503,3.38322e+13,357.074,4190.46,17281,380,277,15687,15588,13719,11779,10600
78120,1882,3137,51891,26229,3.28938e+13,935.865,10156,78120,605,506,74983,74796,68606,59160,64163
52418,1226,2219,35802,16616,3.54189e+13,517.707,7005.5,52418,383,381,50199,50078,48293,47408,39297
50655,2352,2999,35321,15334,3.64333e+13,843.402,9152.57,50655,504,449,47656,47547,47362,47384,44497
5951,222,744,4211,1740,3.07689e+13,154.633,1649.03,5951,163,148,5207,4977,4305,4142,1506
33254,1336,1730,23845,9409,3.72531e+13,822.575,5630.58,33254,454,351,31524,31384,30673,29782,29237
28029,956,1281,19961,8068,3.65081e+13,715.015,4338.82,28029,342,289,26705,25961,25558,23961,23565
92093,1088,3784,64071,28022,3.62933e+13,904.195,12932.9,92093,824,455,88155,86546,62696,45021,39433
53205,22,2067,37042,16163,3.63588e+13,762.735,7113.31,53205,491,470,32450,24092,19368,7415,4234
66971,960,2417,47181,19790,3.6943e+13,871.614,8749.39,66971,602,487,64260,62857,58371,50070,42527
78042,424,3316,54601,23441,3.66393e+13,1009.17,11433.6,78042,629,524,70289,65614,42656,22214,16243
69938,2011,3037,49426,20512,3.59308e+13,1133.63,10454.8,69938,667,536,66901,66526,64576,60533,58736
10120,220,813,6537,3583,2.9477e+13,245.633,2193.22,10120,167,200,9092,8692,6044,5236,4303
13838,940,1759,9567,4271,3.60601e+13,278.361,3923.86,13838,355,215,12079,12034,11375,8993,8314
67963,365,2595,46907,21056,3.18046e+13,834.718,9077.56,67963,421,474,62720,59795,41182,28268,22841
32559,45,1974,23527,9032,3.68574e+13,689.334,6012.33,32559,478,381,23440,19012,15198,5180,3550
95123,715,3772,64722,30401,3.42764e+13,1022.69,13155.1,95123,545,615,90334,88462,57995,42159,29059
11493,823,931,7926,3567,3.60341e+13,442.141,2588.61,11493,282,262,10562,10476,10407,10361,10345
27150,277,2258,18824,8326,3.60691e+13,411.992,5911.95,27150,447,312,23859,21418,16312,10455,5278
1444,290,365,1067,377,3.43089e+13,106.243,610.474,1444,102,67,1079,1039,1078,1067,1020
17931,600,1369,12240,5691,3.5024e+13,387.645,3876.57,17931,330,291,16562,16172,14450,11390,9333
55208,1199,1846,37664,17544,3.31429e+13,461.126,6428.88,55208,362,312,53362,53220,52512,51850,44682
49945,945,1900,34685,15260,3.2648e+13,942.037,6918.84,49945,434,420,47445,46165,43938,35853,30100
99019,1373,3633,70026,28993,3.67458e+13,1173.12,12787.6,99019,671,634,95250,93438,85129,64882,59208
4031,467,678,2874,1157,3.88991e+13,129.219,1327.42,4031,146,95,3353,3329,3324,3312,2796
53587,1185,2041,37682,15905,3.60942e+13,877.653,7336.12,53587,452,445,51401,50018,48388,44452,39363
42709,779,2174,29923,12786,3.62355e+13,1020.08,7088.38,42709,512,483,39770,38618,34865,28222,17562
65603,779,2576,45943,19660,3.66381e+13,1048.2,9530.11,65603,538,526,61373,58730,48535,34680,31374
15750,445,1217,10510,5240,3.41233e+13,349.427,3218.68,15750,284,293,14470,14114,11783,10359,10239
73854,492,3183,50585,23269,3.36841e+13,994.009,11094.9,73854,606,624,68513,65190,47619,36506,23806
37514,816,1658,25973,11541,3.55724e+13,727.276,5724.2,37514,402,311,35555,33976,32348,25518,21025
19168,45,1722,13710,5458,3.54295e+13,532.919,4349.36,19168,373,283,13342,10306,8005,2518,1741
90766,825,4493,62457,28309,3.48528e+13,1114.77,14493.3,90766,616,703,85126,82991,61817,45175,29483
12790,424,1326,8882,3908,3.69108e+13,361.069,3227.64,12790,314,243,11373,10686,9544,7380,6337
46942,2599,3153,32594,14348,3.63656e+13,696.843,9351.76,46942,424,682,43789,43788,43580,43588,40672
72740,200,3042,49953,22787,3.51924e+13,722.299,10321.5,72740,440,633,63052,56424,39028,14197,12343
45729,840,2581,31034,14695,3.39494e+13,820.549,7863.92,45729,407,434,42768,41546,35931,22707,19308
11547,459,799,7937,3610,3.54707e+13,347.056,2342.73,11547,232,228,10739,10427,9658,8523,8042
32452,1425,2107,22251,10201,3.40127e+13,516.577,6113.09,32452,344,321,30345,30196,29021,24699,24788
82088,918,2065,58975,23113,3.69879e+13,983.876,8865.6,82088,591,392,79289,76691,69502,50317,44296
22628,1913,1948,15971,6657,3.62671e+13,425.595,5055.29,22628,313,386,20680,20680,20680,20680,20556
2913,265,492,1941,972,2.89877e+13,74.7933,937.846,2913,128,86,2421,2407,2363,2115,2061
91575,3669,3853,62737,28838,3.48325e+13,1298.49,12970,91575,575,568,87722,87720,87640,87605,86943
27550,1754,1940,18961,8589,3.6224e+13,611.651,5677.97,27550,329,499,25610,25610,25518,25572,24769
96436,2035,3701,66066,30370,3.4491e+13,1218.01,13073,96436,615,776,92735,92016,88108,76917,63781
35122,1439,2164,24188,10934,3.52149e+13,671.872,6397.19,35122,429,366,32958,32760,31650,29517,23672
55883,1794,2467,39558,16325,3.61144e+13,951.364,8713.64,55883,554,623,53416,52781,52430,50659,47299
28311,422,1554,19554,8757,3.28248e+13,512.198,4838.73,28311,372,380,26017,23969,21513,18323,12965
24999,1233,1767,17216,7783,3.56634e+13,482.931,5057.74,24999,298,362,23232,23144,23022,23003,19448
32882,1035,1400,23227,9655,3.79209e+13,815.381,5182.14,32882,422,374,31482,30325,30233,28785,29019
52214,471,1856,36814,15400,3.62121e+13,687.277,6743.7,52214,491,336,48784,46131,34742,24687,21573
55084,1242,1877,38278,16806,3.37137e+13,959.404,7097.98,55084,491,425,53207,52031,50410,46402,38164
46294,396,2140,32860,13434,3.61748e+13,836.249,7098.26,46294,620,421,42297,40408,31210,22889,17129
64320,2275,2400,46676,17644,3.61752e+13,762.905,8305.2,64320,573,507,61920,61917,61868,61815,61434
14046,1123,1228,9675,4371,3.32387e+13,334.755,3184.71,14046,275,248,12818,12816,12796,12809,12631
75643,1969,2902,53065,22578,3.5735e+13,1009.43,10521.4,75643,682,480,72741,72580,68951,59885,59301
88526,3742,3768,62596,25930,3.62743e+13,990.71,13075,88526,951,461,84758,84757,84754,84757,84664
10868,626,1292,7706,3162,3.61255e+13,364.311,2947.07,10868,283,223,9572,9072,8543,7420,4985
45377,2233,2476,31998,13379,3.62238e+13,787.831,7587.73,45377,435,484,42901,42730,42773,42890,41806
19649,1476,1625,13604,6045,3.49728e+13,548.759,4437.16,19649,398,375,18024,18018,17911,17817,17496
26695,71,2159,19033,7662,3.57187e+13,421.367,5814.22,26695,377,374,19760,16633,12720,5692,2143
95194,1209,3447,68364,26830,3.71741e+13,1279.85,12458.2,95194,771,550,90992,88985,75077,54752,48706
43301,736,2322,30071,13230,3.51935e+13,697.658,7183.54,43301,491,400,40642,39783,34075,22240,20455
47493,1997,2852,33004,14489,3.40694e+13,980.55,8590.21,47493,554,616,44641,44169,43061,39475,36788
83881,2537,3299,58028,25853,3.50194e+13,922.253,11687.3,83881,518,636,80582,80437,80208,80202,72049
43284,1707,2645,31061,12223,3.71425e+13,694.258,7756.45,43284,529,496,40639,40568,39162,36298,31750
24523,1246,1454,16797,7726,2.97116e+13,499.23,4136.88,24523,275,322,23069,22964,23001,22982,21935
49490,1422,2061,34721,14769,3.44244e+13,991.799,7315.91,49490,444,484,47429,46593,46136,43630,40828
90279,1268,3145,62772,27507,3.56717e+13,1072.42,11765.6,90279,662,546,86834,84394,77330,57977,53623
43055,1538,1774,29596,13459,3.51383e+13,737.846,6207.05,43055,500,422,41281,41280,41094,41131,39965
2888,55,464,1978,910,3.74801e+13,200.201,968.987,2888,136,121,2039,1716,1397,872,729
5812,586,677,4139,1673,3.55518e+13,224.861,1552.85,5812,190,132,5135,5135,5124,5122,4945
84475,365,2859,58063,26412,3.32844e+13,882.393,10316.8,84475,553,476,78846,74151,51933,29092,23039
34091,1037,2225,23949,10142,3.59297e+13,677.468,6560.11,34091,346,377,31830,31313,29385,25799,20235
79449,1417,3055,53699,25750,3.42286e+13,832.143,10913.6,79449,472,653,76394,75391,72232,66128,48872
41043,390,2022,28227,12816,3.18173e+13,885.583,6488.25,41043,410,361,37322,35546,24774,17256,9778
71467,336,3241,49345,22122,3.56929e+13,935.323,10595.6,71467,559,562,64214,58463,39117,17642,15871
42919,509,2198,29356,13563,3.54484e+13,603.383,7152.88,42919,339,450,40079,38449,34397,22025,13018
81757,59,2563,56917,24840,3.36168e+13,1317.04,10089.4,81757,604,488,61852,48506,36593,10130,5956
72747,2520,2641,50975,21772,3.55103e+13,1001.83,9649.09,72747,616,519,70106,70104,70039,70049,69449
9943,1285,1353,7253,2690,3.56037e+13,285.719,2884.65,9943,283,293,8590,8590,8586,8588,8503
6411,333,724,4447,1964,3.72818e+13,305.215,1740.68,6411,198,152,5598,5090,4895,3870,3667
86724,2830,2930,59867,26857,3.48927e+13,1041.85,10827.5,86724,629,554,83794,83793,83778,83772,83367
53209,695,2426,37586,15623,3.55236e+13,875.959,8110.83,53209,524,462,49769,48446,36479,25335,21211
23135,1031,1744,15807,7328,3.57079e+13,517.764,4763.09,23135,359,329,21391,21353,20886,19835,18588
63504,1514,2564,43003,20501,3.53164e+13,681.822,8848.35,63504,464,452,60940,60824,55071,46244,49011
42005,2402,2546,28806,13199,3.48405e+13,730.299,7440.15,42005,435,528,39459,39459,39408,39421,39144
34163,1441,2288,23934,10229,3.59927e+13,635.631,6610.46,34163,482,398,31875,31694,30270,25489,25313
36238,1208,1624,26305,9933,3.6671e+13,837.183,5718.28,36238,526,332,34614,34008,33394,31941,29923
1207,121,199,767,440,2.77539e+13,78.1052,423.982,1207,69,74,1004,875,855,663,842
16728,947,1715,12069,4659,3.69705e+13,495.581,4134.58,16728,389,338,15013,14651,14295,12569,11029
33956,162,1798,24628,9328,3.72401e+13,858.294,5865.3,33956,528,380,28196,24346,18109,9670,4250
40328,1917,2351,28620,11708,3.61901e+13,623.904,7459.31,40328,394,457,37977,37974,37829,37834,35034
5302,461,817,3656,1646,3.56821e+13,179.521,1707.56,5302,146,186,4485,4375,4394,4369,3038
52319,1211,2423,37245,15074,3.68766e+13,905.774,7967.82,52319,514,411,49885,48671,45366,40757,36241
93678,873,3771,65173,28505,3.55829e+13,1165.67,13047.6,93678,609,647,88518,85055,64468,44468,30562
95667,1382,2418,66369,29298,3.45082e+13,1231.75,10204.2,95667,630,511,92859,90910,87564,74783,74561
73188,1597,3203,50424,22764,3.49119e+13,866.256,10431.6,73188,653,530,69985,69141,64642,52002,45963
50144,1590,2942,34672,15472,3.57254e+13,748.005,8740.27,50144,499,461,47202,46679,44589,38893,32922
49671,939,2522,34038,15633,3.50039e+13,623.334,7788.04,49671,471,393,47149,46542,35778,25438,20449
46508,1348,2371,31345,15163,3.26174e+13,744.569,7445.13,46508,431,434,44137,43570,42183,39947,33284
43114,2280,2708,29336,13778,3.50092e+13,541.193,7780.63,43114,438,435,40406,40404,40199,40245,37883
1428,17,375,1045,383,3.74536e+13,54.1681,602.158,1428,99,83,906,473,541,155,111
71632,2619,3174,50779,20853,3.71573e+13,1068.55,10471.4,71632,663,555,68458,68196,68136,67801,62795
37111,123,2317,26772,10339,3.65439e+13,764.487,6889.79,37111,504,399,29756,26227,20177,5528,3778
67926,1100,3586,47668,20258,3.56249e+13,846.179,10852.5,67926,511,586,64311,63002,55754,38993,32601
91071,3177,3809,62917,28154,3.64828e+13,1101.13,11851.1,91071,647,538,87262,87022,86312,85436,83465
19200,94,1707,13454,5746,3.61361e+13,522.037,4358.13,19200,321,357,14678,12654,9600,3644,1625
20913,477,1919,14723,6190,3.51184e+13,388.357,4996.29,20913,370,370,18877,17973,14853,11332,7766
22604,315,1745,15921,6683,3.68542e+13,527.374,4854.95,22604,377,351,20029,18076,15904,12165,6421
48735,322,2278,33342,15393,3.35464e+13,845.361,7542.39,48735,450,448,44154,41009,26256,14843,11764
44773,1299,1625,31029,13744,3.09164e+13,866.171,5956.09,44773,388,411,43140,42517,42615,42215,39958
69827,732,1900,49309,20518,3.42108e+13,891.375,7659.79,69827,522,359,66874,63124,58356,40976,39992
94405,2868,3176,65945,28460,3.44128e+13,1138.16,11659.2,94405,601,469,91229,91197,91072,91063,89113
71896,85,3382,50207,21689,3.6442e+13,1090.22,11063.6,71896,691,454,54757,46958,32691,12525,6918
11269,935,969,7858,3411,3.72486e+13,312.772,2560.07,11269,246,237,10300,10300,10296,10288,10250
23259,559,2140,15902,7357,3.49757e+13,412.284,5531.06,23259,439,371,21043,20270,15083,13378,8312
79816,773,3869,55517,24299,3.56591e+13,893.321,12102.7,79816,689,615,75257,73409,51152,35850,27278
47032,787,2274,32673,14359,3.58551e+13,577.399,7442.51,47032,430,488,44747,44140,37324,30537,20333
49456,745,2994,34200,15256,3.63249e+13,776.802,8859.44,49456,478,599,45973,44705,38623,28590,16735
12710,17,731,8603,4107,3.54945e+13,355.785,2374.67,12710,217,206,7174,5083,4495,3196,1200
42163,516,2106,30456,11707,3.64056e+13,782.146,6896.46,42163,464,385,38928,37174,33126,22449,14372
37090,1541,2148,25281,11809,3.44235e+13,545.551,6385.03,37090,341,385,34942,34932,34587,34133,29346
43713,60,2744,30535,13178,3.55422e+13,558.686,7864.72,43713,375,518,31951,26483,19157,7001,4941
23618,472,2029,16390,7228,3.47143e+13,420.172,5346.42,23618,443,370,21355,20263,15993,13919,7202
87118,282,3250,60796,26322,3.49163e+13,1257.4,11723.1,87118,668,613,78512,71642,45389,13757,10802
77430,3086,3321,53948,23482,3.55373e+13,1085.69,11444.2,77430,690,509,74109,74108,74051,74091,73261
28342,702,2098,19487,8855,3.60097e+13,491.777,5825.92,28342,416,354,26244,25608,19661,15071,12379
65674,227,2599,45665,20009,3.56007e+13,1007.73,9067.85,65674,654,486,56968,50729,36824,13751,11754
37863,2310,2716,26437,11426,3.60721e+13,646.439,7659.98,37863,570,382,35147,35138,34658,34145,33172
24930,1064,1680,17947,6983,3.70366e+13,546.4,4629.08,24930,355,249,23250,22847,22171,21313,17199
39681,1693,2039,27487,12194,3.32307e+13,777.483,6554.32,39681,384,450,37642,37427,37489,37120,34404
99032,2226,2803,69006,30026,3.59206e+13,902.583,10822.7,99032,697,433,96229,96184,94531,91727,90376
10819,1072,1125,7602,3217,3.73117e+13,375.621,2746.31,10819,267,275,9694,9694,9666,9673,9643
6169,547,761,4401,1768,3.68565e+13,264.604,1733.59,6169,216,168,5408,5361,5188,5166,4643
91133,31862,91133,0,91133,15.9998,0,91133,91133,91133,1,0,0,0,0,0
2400,151,208,1586,814,2.50385e+13,82.5387,569.283,2400,77,77,2192,2188,2069,2107,1828
97303,273,3343,67961,29342,3.44033e+13,1153.26,12534.2,97303,662,619,86903,80937,54965,18820,16338
73663,1940,4036,51537,22126,3.53938e+13,894.833,12487.6,73663,585,738,69627,68916,65161,58161,41203
54722,68,2378,37900,16822,3.61191e+13,790.051,7678.03,54722,567,520,39997,33874,25128,9190,6711
53742,2242,2651,36857,16885,3.44093e+13,803.527,8376.09,53742,556,403,51091,51078,50869,50352,49404
77372,872,2282,52766,24606,3.55345e+13,538.506,8463.85,77372,428,358,75090,74793,60509,44768,35385
31557,465,1918,22101,9456,3.57965e+13,565.25,5808.99,31557,396,401,29110,28053,22285,16260,13332
82951,1596,2639,57095,25856,3.34237e+13,1275.42,10201.5,82951,538,508,80160,79084,75272,66860,62285
34167,1583,2006,23511,10656,3.64805e+13,718.696,6231.73,34167,431,376,32161,32091,31335,30566,28739
33038,1444,2073,22941,10097,3.68827e+13,609.933,6287.17,33038,447,401,30965,30759,30020,29022,26014
16541,555,1750,11533,5008,3.72138e+13,345.93,4247.37,16541,296,378,14791,14291,13464,12803,6216
96852,142,3733,66167,30685,3.50967e+13,1098.71,12928.6,96852,653,700,81013,71424,48211,19982,10917
71688,740,3279,49219,22469,3.45303e+13,905.856,10821.1,71688,520,579,67475,65187,48453,33034,27544
95345,801,3073,65769,29576,3.33773e+13,1038.26,11450.4,95345,635,485,91236,88539,72317,48935,37554
68228,2093,3497,46794,21434,3.32994e+13,960.377,11057.5,68228,490,561,64731,64175,61502,52634,51189
84487,3743,3962,58099,26388,3.41094e+13,876.25,12330.5,84487,768,636,80525,80515,80437,80355,79701
36979,2682,2776,25939,11040,3.54784e+13,609.526,7681.25,36979,555,520,34203,34203,34190,34203,34021
68239,2504,2706,46256,21983,3.46878e+13,809.599,9532.42,68239,505,502,65533,65533,65300,65028,64391
20510,1269,1635,14205,6305,3.38884e+13,504.071,4488.38,20510,338,418,18875,18830,18550,18288,17393
69578,2717,3443,47839,21739,3.48224e+13,898.471,10905.4,69578,657,515,66135,66082,65454,63903,59948
65140,1889,2875,44720,20420,3.47868e+13,961.048,9079.14,65140,480,439,62265,61799,59882,55711,54497
42126,2332,2813,29609,12517,3.62427e+13,672.171,8086.27,42126,616,375,39313,39216,38950,37762,36172
48115,2492,2598,33787,14328,3.66821e+13,680.004,8338.3,48115,557,421,45517,45517,45493,45437,45157
47691,2434,2737,33567,14124,3.50389e+13,835.52,8579.51,47691,474,477,44954,44954,44849,44838,42966
47733,1516,1994,33825,13908,3.49033e+13,896.397,7072.5,47733,468,440,45739,45685,44841,43951,40321
9187,1043,1084,6496,2691,3.81178e+13,258.074,2476.6,9187,253,194,8103,8103,8095,8078,8082
28460,1248,1798,19912,8548,3.73463e+13,610.67,5353.18,28460,396,353,26662,26656,25940,24873,23089
17862,178,1194,12151,5711,3.24995e+13,338.075,3504.31,17862,249,216,15091,13401,10022,4706,3653
18761,1122,1743,13164,5597,3.56691e+13,386.952,4384.41,18761,332,286,17018,16957,16396,15785,13280
76339,1300,2299,54089,22250,3.70325e+13,1000.67,9469.65,76339,642,502,73972,73255,68522,60767,52330
91228,241,3274,62605,28623,3.44677e+13,1129.84,11500.5,91228,631,652,80361,72973,48432,17787,16932
46758,2008,2156,32357,14401,3.35585e+13,563.598,6882.16,46758,400,362,44602,44602,44561,44571,44200
82837,1875,2936,57711,25126,3.68934e+13,1069.33,10217.7,82837,577,505,79901,79433,75436,69446,65914
67318,153,2789,47171,20147,3.4339e+13,784.757,9388.16,67318,590,413,56697,49719,33219,11022,9137
11151,720,1357,7699,3452,3.67313e+13,377.786,3108.74,11151,256,309,9794,9542,9231,8672,6493
83577,393,3397,57457,26120,3.37448e+13,913.209,11619.7,83577,502,685,77348,73587,46920,25172,19563
35777,1718,2261,24842,10935,3.55962e+13,534.168,6568.26,35777,477,413,33516,33505,32903,31210,31111
16718,964,1636,11533,5185,3.40419e+13,321.967,4038.13,16718,320,243,15082,15041,13919,12248,10312
70731,3078,3154,50514,20217,3.57105e+13,870.488,10856.5,70731,658,511,67577,67570,67577,67577,67012
13896,836,1197,9362,4534,3.52797e+13,299.931,3247.05,13896,212,343,12699,12697,12531,12408,9579
64369,1023,2967,45253,19116,3.64178e+13,1019,9628.05,64369,673,522,60984,59227,48203,36534,34338
14488,449,809,10230,4258,3.57876e+13,344.201,2464.11,14488,205,192,13679,13600,12312,12382,10372
86747,1092,2939,59845,26902,3.27422e+13,964.862,11238.1,86747,683,478,83548,81757,70490,51655,45752
51401,1588,2513,35453,15948,3.55113e+13,866.23,7692.64,51401,522,426,48888,48447,46260,41696,42075
28040,982,2409,19299,8741,3.53514e+13,496.182,6367.16,28040,469,463,25631,25291,22278,18912,16872
31185,127,1576,21878,9307,3.63798e+13,735.588,5115.87,31185,390,346,25256,22050,16007,6285,5020
56873,1171,2823,39699,17174,3.36801e+13,889.561,8780.87,56873,438,520,53912,52664,48350,32885,30843
69797,295,3017,48822,20975,3.61039e+13,785.785,9911.47,69797,628,584,62978,54271,41582,19539,16515
98754,1845,3885,68535,30219,3.54618e+13,1275.68,13681.4,98754,686,618,94843,93290,84541,60837,57737
1838,252,424,1271,567,3.73726e+13,103.04,752.641,1838,101,88,1414,1359,1385,1380,1049
19321,1751,1816,13472,5849,3.32996e+13,271.404,4381.56,19321,353,294,17505,17505,17505,17505,16904
91198,3480,3563,63218,27980,3.48031e+13,1014.09,11702.3,91198,677,550,87635,87635,87623,87615,87383
48523,1471,2280,34870,13653,3.70341e+13,732.636,7734.54,48523,628,411,46243,46122,42736,30837,32482
19504,1121,1721,13742,5762,3.54727e+13,411.126,4447.52,19504,318,268,17783,17679,17390,16888,14294
10322,412,798,7496,2826,3.4554e+13,295.63,2246.76,10322,236,159,9524,9306,8769,6908,6416
69252,1270,2945,47488,21764,3.3696e+13,804.611,10070.8,69252,479,586,66307,65176,62046,54392,37626
64843,1059,2842,44697,20146,3.26033e+13,1093.65,9652.99,64843,625,558,61405,60089,55236,41941,29812
52183,2483,2780,35946,16237,3.54835e+13,676.015,8323.95,52183,494,422,49403,49369,49251,49225,47294
36495,724,1797,25558,10937,3.54497e+13,638.388,5986.34,36495,370,430,34373,33700,31068,29084,18586
40553,1400,2030,28205,12348,3.46202e+13,838.782,6642.37,40553,390,386,38523,38067,37724,36463,31917
25859,517,2139,17956,7903,3.61314e+13,485.01,5727.74,25859,396,370,23518,22667,17561,13274,8379
34738,1854,2411,24286,10452,3.53159e+13,719.827,6862.31,34738,494,446,32327,32056,31320,29172,30119
99168,1118,3048,67438,31730,3.4288e+13,754.201,10798.9,99168,552,447,96120,95146,73193,56225,54459
26358,661,2004,18287,8071,3.6863e+13,556.83,5527.96,26358,295,422,24152,23145,21565,17021,12161
80791,249,3013,56101,24690,3.55582e+13,1039.03,10921.2,80791,611,532,70906,62626,43690,16264,15023
37605,185,1823,26672,10933,3.67912e+13,915.373,6086.78,37605,490,364,31656,27866,20174,7184,6630
67106,1065,2579,46417,20689,3.46175e+13,1056.59,9085.6,67106,530,472,63910,61629,55330,39126,34304
27246,1433,2136,18464,8782,3.34795e+13,540.905,5871.26,27246,396,408,25110,25006,24242,22798,18817
69802,2255,3411,47990,21812,3.45345e+13,831.452,11190.1,69802,794,598,66391,66360,64069,55607,53152
45091,2164,2340,32130,12961,3.69522e+13,847.792,7405.62,45091,558,419,42751,42748,42654,42649,42172
94649,2506,4052,65357,29292,3.53745e+13,1072.08,13529.7,94649,645,606,90597,90439,88309,82056,73911
78657,889,2136,53571,25086,3.0447e+13,1059.28,8516.01,78657,453,476,75812,74678,65325,43396,43922
68135,2314,2703,47248,20887,3.6058e+13,1134.7,9632.76,68135,563,549,65432,65427,65063,64760,62611
65739,33777,65739,0,65739,15.9998,0,65739,65739,65739,1,0,0,0,0,0
63376,2275,3199,44068,19308,3.45893e+13,919.953,10144.1,63376,494,568,60177,60100,59443,58895,49188
90510,623,2864,65234,25276,3.67265e+13,1139.29,11518.2,90510,810,472,85181,82002,64521,46822,29063
40266,657,1640,28989,11277,3.70948e+13,905.428,6027.43,40266,507,369,37560,36040,33159,24090,22152
46943,1941,2479,33460,13483,3.72615e+13,744.659,7589.64,46943,495,435,44464,44445,44150,43974,40045
60591,2941,3189,41347,19244,3.43885e+13,701.985,9704.07,60591,655,461,57402,57397,57318,57315,55723
35100,914,1742,24330,10770,3.54024e+13,612.846,5790.72,35100,396,393,33358,32709,30027,24164,23920
89610,1880,3459,63510,26100,3.59805e+13,1315.54,12329.5,89610,804,646,86151,85003,78893,60983,60250
59864,696,2355,42989,16875,3.70972e+13,886.815,8621.24,59864,510,549,56323,54310,49559,37900,27551
11820,355,1268,8248,3572,3.64626e+13,408.596,3127.95,11820,257,338,10203,9516,8526,7659,4033
67110,2184,2635,47569,19541,3.5411e+13,895.626,9762.56,67110,671,444,64475,64427,64267,64333,59736
87883,2635,3605,62342,25541,3.68655e+13,1126.39,12461.1,87883,861,776,84278,84227,82391,79590,72128
14565,614,1053,9849,4716,3.27374e+13,417.794,2971.91,14565,241,231,13512,13025,12767,12028,9707
6375,682,959,4244,2131,3.35839e+13,199.268,2061.63,6375,169,226,5416,5413,5305,5287,4417
54053,629,3018,37496,16557,3.58727e+13,678.648,9305.08,54053,475,464,50442,48774,33679,23766,16036
29552,807,2433,20638,8914,3.60569e+13,595.1,6410.82,29552,361,371,26924,25997,22255,17043,13977
57553,2330,2735,39352,18201,3.53838e+13,754.841,9425.06,57553,433,811,54818,54811,54626,54449,50487
49278,1926,2554,33754,15524,3.57799e+13,575.202,7644.61,49278,514,464,46724,46694,45050,41783,41409
9868,417,786,6760,3108,2.86544e+13,152.666,1966.79,9868,179,147,9082,8987,8680,8602,7138
90974,2649,3545,63098,27876,3.49691e+13,1059.9,12145.1,90974,717,558,87429,87394,85637,81503,82374
26502,1525,1739,18253,8249,3.31813e+13,549.612,5238.19,26502,305,347,24763,24745,24744,24751,24099
46777,1812,2908,33031,13746,3.61335e+13,748.704,8806.52,46777,560,438,43869,43559,42532,40620,33186
66396,800,3046,45771,20625,3.58452e+13,1088.48,10041.1,66396,581,603,62116,60033,39204,29186,24197
85271,460,3232,57650,27621,3.44654e+13,878.202,11762.3,85271,538,614,78205,73387,44078,20273,21400
23313,868,1404,15656,7657,3.23794e+13,424.246,4045.64,23313,290,313,21909,21657,20801,16974,16605
24250,291,1633,17507,6743,3.72277e+13,596.532,4753.65,24250,367,390,21139,19152,16345,13497,4995
52423,652,2426,35672,16751,3.36553e+13,864.335,8182.46,52423,447,448,49083,47827,36465,25091,19769
55392,2609,3011,37448,17944,3.38959e+13,680.72,9423.43,55392,608,498,52381,52374,52238,52297,49694
27913,1614,1905,19703,8210,3.54409e+13,581.3,5377.18,27913,352,302,26008,25895,25903,25895,24078
70856,2216,3413,48750,22106,3.55955e+13,878.15,10607.2,70856,604,547,67443,67163,63333,54617,56531
57605,1945,2623,39640,17965,3.57099e+13,606.223,8693.42,57605,409,445,54982,54947,54699,54686,50446
84913,2664,3052,59428,25485,3.57228e+13,1124.41,11119.8,84913,579,628,81861,81861,81708,81086,78687
34789,1732,2198,23852,10937,3.54159e+13,567.358,6286.63,34789,405,460,32591,32590,32394,32289,29886
21405,1322,1608,14795,6610,3.56015e+13,391.789,4301.35,21405,347,250,19797,19787,19353,18711,18245
74333,2705,3199,51326,23007,3.45238e+13,969.592,10321.3,74333,606,541,71134,71099,70151,67032,67099
60956,407,1929,43466,17490,3.62078e+13,833.813,7680.97,60956,485,421,56657,53945,43573,33460,21662
46527,2139,2370,31987,14540,3.2022e+13,721.86,7505.67,46527,320,512,44157,44157,44127,44152,43374
63330,2136,2347,43950,19380,3.57234e+13,1024.86,8442.15,63330,514,438,60983,60842,60735,60590,59063
97860,2222,3203,68379,29481,3.51468e+13,1349.43,12151.5,97860,659,566,94657,94083,90143,76342,76951
50220,1128,2412,35286,14934,3.64565e+13,812.181,7527.17,50220,460,390,47808,46840,41586,30367,33277
43106,1572,2342,30181,12925,3.54904e+13,568.284,7182.2,43106,483,296,40764,40740,39844,36994,36383
63688,57,2713,44208,19480,3.47981e+13,908.691,9522.32,63688,481,655,47063,38333,28626,7997,5797
5595,175,780,3794,1801,3.52221e+13,244.438,1761.38,5595,162,228,4515,3954,3445,3289,1455
27658,465,1670,19049,8609,3.47108e+13,603.091,5007.54,27658,427,303,25285,24123,20486,15232,12967
53600,1810,2578,36667,16933,3.46715e+13,720.388,8181.43,53600,469,479,51022,50687,48108,42376,44663
35943,1533,1722,24985,10958,3.18497e+13,649.783,5572.58,35943,411,345,34221,34102,33942,33578,32231
37798,539,1964,26137,11661,3.52209e+13,728.992,6322.68,37798,443,451,34616,32315,26474,19437,15481
15142,659,1577,10133,5009,3.35221e+13,385.56,3791.47,15142,266,361,13565,13169,12398,10170,8955
55342,2091,2505,38917,16425,3.61039e+13,772.37,8275.63,55342,546,411,52837,52811,52704,52657,50231
95437,312,2361,64690,30747,3.35379e+13,672.735,9725.95,95437,476,490,88813,79285,54090,31013,26806
60306,2166,2725,41470,18836,3.42282e+13,1008.72,9281.51,60306,489,745,57581,56897,56508,53644,53621
67840,1651,2560,47914,19926,3.50871e+13,874.376,9043.25,67840,559,489,65280,65166,63347,61078,54015
44299,575,2198,31542,12757,3.70408e+13,970.027,7362.39,44299,580,433,40965,38997,31705,23677,15463
14938,1008,1022,10424,4514,3.59793e+13,352.015,2824.93,14938,267,200,13916,13916,13916,13912,13898
54251,1315,2683,38587,15664,3.71244e+13,810.221,8731.33,54251,503,525,51568,51131,49623,46478,40332
43147,894,1930,30398,12749,3.60613e+13,817.918,6412.04,43147,430,408,40904,40017,36624,26257,25097
38931,849,2472,27953,10978,3.67354e+13,836.851,7442.11,38931,513,471,36052,35043,31814,24022,18651
45452,409,1732,31707,13745,3.69056e+13,501.996,6045.36,45452,376,395,42935,39798,31242,22735,12762
61045,1906,2820,41676,19369,3.4229e+13,645.555,8956.41,61045,565,456,58225,58185,56519,51836,50119
93277,1874,3106,65343,27934,3.48968e+13,1081.15,11781.5,93277,492,595,90171,89465,87487,84814,70372
18200,1672,1819,12601,5599,3.57029e+13,500.803,4553.16,18200,358,406,16381,16381,16353,16367,15957
67819,35,2089,48483,19336,3.71094e+13,900.494,8352.38,67819,601,429,45882,37105,29048,14061,5623
33414,414,1757,23886,9528,3.70933e+13,634.92,5613.65,33414,489,280,30472,28754,23689,16508,10914
19266,594,1556,13763,5503,3.66036e+13,516.635,4144.18,19266,317,348,17573,16853,15641,13677,10119
49142,795,2188,35107,14035,3.5904e+13,835.808,7339.75,49142,519,534,46315,44490,40480,36594,27897
75723,1957,3346,53373,22350,3.51174e+13,990.342,11162.6,75723,652,481,72377,71873,68664,60994,56918
61015,1152,3213,42988,18027,3.63578e+13,947.063,10432.1,61015,480,646,57496,56054,52214,41717,31360
37084,1347,1815,25922,11162,3.61931e+13,583.507,5500.21,37084,340,343,35269,35055,34451,33813,31994
89290,2894,3258,62291,26999,3.54015e+13,1137.68,11288.2,89290,572,550,86032,86009,85889,85977,84551
45660,1769,2070,31725,13935,3.59237e+13,925.366,7159.52,45660,439,488,43590,43588,43435,43329,42266
81835,1610,2575,57860,23975,3.46486e+13,1018.67,9982.76,81835,626,496,79260,78854,76244,68937,64263
43562,2174,2221,31584,11978,3.68076e+13,866.428,7158.35,43562,521,444,41341,41341,41324,41302,41257
40330,1980,2526,28285,12045,3.6458e+13,819.095,7585.83,40330,458,553,37804,37787,37495,37146,32971
97437,3511,3689,67127,30310,3.46312e+13,1046.82,12814.7,97437,673,707,93748,93746,93606,93088,92947
87372,440,2825,62210,25162,3.52974e+13,919.572,11005.5,87372,793,431,81082,77445,50748,35169,22990
13169,473,1676,9242,3927,3.72179e+13,252.875,3745.43,13169,196,354,11493,11134,10615,10531,5005
98454,264,3300,67718,30736,3.46088e+13,1389.71,12068,98454,620,627,86318,78397,50053,19968,14811
71785,937,3232,50194,21591,3.54085e+13,1120.73,10497.5,71785,572,474,67893,66547,51889,31808,25606
78536,2381,2751,56054,22482,3.6523e+13,1130.87,10513.2,78536,666,532,75785,75741,74864,73684,72361
68551,1759,1813,47058,21493,3.48783e+13,945.323,7866.87,68551,477,459,66738,66738,66725,66702,66428
85204,885,2811,58251,26953,3.34026e+13,1042.68,10794.8,85204,571,572,81285,78274,66808,49806,45392
9310,739,874,6507,2803,2.88774e+13,149.829,2136.02,9310,171,154,8436,8436,8418,8288,6703
16844,827,1365,11775,5069,3.26296e+13,345.409,3495.08,16844,271,254,15479,15243,15169,14611,11490
61946,1404,2743,43428,18518,3.49181e+13,948.693,9279.84,61946,524,491,59203,58302,56079,50486,42683
90763,2317,3200,62651,28112,3.31337e+13,1317.28,11810.2,90763,646,574,87563,86975,85394,80053,77750
41197,1176,2162,28689,12508,3.5767e+13,695.349,6853.49,41197,394,373,39035,38643,37131,34929,26934
10635,867,978,7433,3202,3.75665e+13,397.993,2532.76,10635,244,236,9657,9630,9585,9393,9368
79194,497,3085,55666,23528,3.50053e+13,1056.57,10975.4,79194,558,617,73022,69629,52816,37094,21323
98816,1729,2814,69576,29240,3.42883e+13,1175.01,11377.2,98816,649,504,96002,95598,91213,82169,72036
77800,2232,2904,53902,23898,3.31656e+13,911.842,10281.3,77800,470,629,74896,74818,74485,73815,67226
78030,2258,2774,53914,24116,3.56611e+13,954.446,10124.6,78030,653,496,75256,75247,74959,74289,71606
1340,155,305,1066,274,3.3926e+13,55.3209,520.706,1340,120,57,1035,997,1008,994,662
92887,973,3797,65147,27740,3.62598e+13,1175.33,12745.6,92887,757,574,88237,85670,66354,48456,37959
8526,294,775,5873,2653,3.54655e+13,320.394,2014.45,8526,198,212,7541,6868,6539,5540,4540
41482,19525,41482,0,41482,15.9996,0,41482,41482,41482,1,0,0,0,0,0
94155,2724,3183,66420,27735,3.56492e+13,1394.43,12185.3,94155,752,602,90972,90923,90140,88982,87892
3797,209,704,2771,1026,3.69989e+13,143.64,1321.17,3797,171,114,3093,2795,2690,2373,1489
62798,2128,2698,44848,17950,3.63049e+13,785.526,9226.67,62798,543,402,60100,60085,59820,59437,56024
47251,2023,2478,32595,14656,3.62794e+13,871.064,7949.24,47251,450,507,44773,44715,44470,44205,42062
57459,1477,2381,40051,17408,3.67638e+13,828.409,8141.27,57459,574,398,55078,54839,53220,48078,48391
29869,422,1720,21426,8443,3.75344e+13,606.761,5362.11,29869,473,338,26870,24870,20395,16778,9144
43122,128,1950,30464,12658,3.59109e+13,734.394,6810.87,43122,448,345,36163,31704,23202,7058,6512
95044,891,4248,65078,29966,3.46646e+13,1255.71,14249.1,95044,709,807,89442,87843,65821,55093,35886
75500,1641,3057,53230,22270,3.53625e+13,1026.68,10891,75500,704,469,72443,71653,65001,50046,52543
16416,194,1240,11437,4979,3.45448e+13,374.546,3454.17,16416,268,260,13678,11764,9395,5295,2332
61032,1746,2817,42466,18566,3.54954e+13,1166.14,9370.07,61032,610,513,58201,56979,54332,46773,47843
94771,2153,3429,65278,29493,3.30779e+13,1064.17,12187,94771,566,626,91342,91243,88325,83629,71180
88643,2173,3012,60855,27788,3.50007e+13,1126.51,11522,88643,575,681,85631,85290,84347,81739,71900
70915,710,2638,50071,20844,3.54885e+13,1006.81,9329.72,70915,534,474,66697,63577,49296,35268,30223
56733,1031,2134,38930,17803,3.23426e+13,844.909,7705.12,56733,429,556,54422,53050,49145,35282,33250
73151,2656,3471,51187,21964,3.67724e+13,964.42,11117.8,73151,636,571,69680,69636,68604,67612,64608
46040,1286,2208,33299,12741,3.75317e+13,867.928,7234.33,46040,583,357,43832,43089,42412,38302,36676
11948,52,895,8418,3530,3.72459e+13,511.364,2630.89,11948,286,230,8540,7177,5139,2056,1701
96247,3335,3425,67938,28309,3.63636e+13,1144.09,12517.4,96247,676,604,92822,92822,92807,92798,92429
23585,1305,1701,16784,6801,3.46559e+13,412.92,4706.69,23585,348,261,21884,21825,21744,21698,18776
75774,2113,2200,52027,23747,3.38918e+13,897.592,8627.57,75774,482,461,73574,73574,73550,73542,73304
86303,1869,3279,61062,25241,3.63385e+13,1024.84,11767.1,86303,715,498,83024,82652,78276,66146,65413
92787,2566,3267,63468,29319,3.5104e+13,1105.8,11551.2,92787,613,620,89520,89377,88066,86427,84748
39294,1832,2195,27429,11865,3.66311e+13,795.232,6923.15,39294,411,400,37099,37045,36948,36909,34687
99201,2211,2954,69583,29618,3.37991e+13,1128.51,11733.2,99201,599,651,96247,96192,95538,94747,86760
30350,585,1413,21624,8726,3.7635e+13,737.705,4870.29,30350,397,325,28017,25821,25187,18484,17170
68093,2692,3133,47515,20578,3.64015e+13,1040.5,10259.3,68093,605,764,64960,64898,64352,63217,61409
25336,752,2034,17606,7730,3.61462e+13,472.338,5369.49,25336,393,305,23302,22957,20042,16663,15479
34124,263,2206,23836,10288,3.39519e+13,806.26,6319.72,34124,426,420,29770,27414,20150,10792,9081
66361,2005,2549,47662,18699,3.65969e+13,1143.11,9469.14,66361,549,498,63812,63661,62853,61775,59048
26489,1333,2048,18810,7679,3.70309e+13,615.419,5599.84,26489,362,363,24441,24153,23791,23383,19630
15343,905,1408,10691,4652,3.647e+13,353.291,3508.11,15343,326,254,13935,13781,13330,13070,11368
83655,809,3176,56932,26723,3.44871e+13,924.769,10826.4,83655,538,523,79893,78812,51071,37763,34920
52070,90,2961,35581,16489,3.42602e+13,809.123,9158.33,52070,448,593,41735,36615,24404,8706,5252
67055,1833,2992,47177,19878,3.66059e+13,901.336,9559.08,67055,680,448,64063,63677,60859,54772,54186
54404,741,2680,38735,15669,3.67066e+13,1076.31,8793.24,54404,553,484,50582,48558,38638,25200,21102
41669,1114,1821,29106,12563,3.67601e+13,708.629,6222.27,41669,461,368,39848,39534,37735,34062,33822
66302,1612,2891,46978,19324,3.69541e+13,780.691,9580.43,66302,601,520,63411,62993,60918,55736,53821
31538,303,2136,21685,9853,3.50037e+13,673.068,6117.9,31538,401,323,28025,25760,16733,9579,6211
90925,102,3036,64003,26922,3.54003e+13,990.782,11443.5,90925,743,440,72107,61594,45610,13324,10154
41958,310,2047,29286,12672,3.62579e+13,849.107,6795.87,41958,517,464,37519,34505,27004,17354,10311
47889,1559,2692,33739,14150,3.63545e+13,777.47,8207.71,47889,486,432,45197,44725,43607,41493,34758
9817,356,1218,6935,2882,3.80678e+13,376.003,2768.58,9817,247,214,8379,7832,6161,4525,3533
30716,1181,2037,21235,9481,3.34749e+13,432.059,5692.7,30716,380,256,28679,28557,26688,22164,22356
31620,1682,2578,21563,10057,3.46948e+13,463.267,6831.67,31620,333,503,29042,28993,28582,28706,21171
70165,2759,3653,49578,20587,3.73566e+13,887.609,11446.4,70165,505,619,66512,66432,66080,65890,59608
71965,2014,2647,49585,22380,3.5523e+13,826.381,8397.56,71965,433,435,69318,69281,69104,69113,66522
53511,1851,2535,37914,15597,3.62739e+13,823.841,8558.63,53511,629,416,50976,50937,49231,46944,41197
78511,2257,2512,56977,21534,3.66308e+13,1059.42,10272.8,78511,665,493,75999,75992,75479,74592,72898
27541,1483,2072,19125,8416,3.59125e+13,395.609,5623.62,27541,306,443,25469,25461,25199,25270,22674
22178,596,1240,15171,7007,3.50908e+13,375.971,3779.13,22178,314,342,20938,20639,19050,16961,13881
63637,93,2151,45142,18495,3.61363e+13,838.442,8090.31,63637,521,413,48886,42185,32984,9021,6690
64329,1566,2816,44456,19873,3.4635e+13,709.488,9319.65,64329,470,487,61513,61233,58996,54051,46368
70315,2115,3043,48403,21912,3.42478e+13,1207.21,10179.8,70315,513,588,67272,66468,65575,61291,58846
7831,432,900,5761,2070,3.65599e+13,223.975,2048.81,7831,180,188,6931,6805,6459,6542,3688
90708,936,2240,62874,27834,3.2762e+13,1094.33,9609.98,90708,560,527,87163,84535,79498,57534,49130
5350,470,797,3592,1758,3.38903e+13,188.397,1693.71,5350,119,178,4553,4504,4453,4399,3293
96016,682,2713,66936,29080,3.42245e+13,1207.2,10855.7,96016,694,583,91790,89362,70231,54796,38074
53017,224,2743,36525,16492,3.53197e+13,786.291,8722.35,53017,536,507,46057,41154,26747,10575,7330
61594,700,2584,43627,17967,3.66283e+13,790.871,8676.9,61594,601,413,58076,54758,42709,31060,33769
50912,626,2336,36326,14586,3.70714e+13,817.106,7898.82,50912,530,514,47443,45353,36549,23932,20820
69241,542,4035,48047,21194,3.43062e+13,834.725,11765.9,69241,771,407,63646,60687,36840,13977,11393
52761,2070,2581,37041,15720,3.62819e+13,765.713,8014.53,52761,586,390,50180,50170,49724,48631,48085
1021,56,302,707,314,3.21222e+13,63.7169,500.66,1021,92,64,673,562,361,272,212
20343,383,1317,14189,6154,3.31712e+13,505.514,3932.71,20343,349,262,18412,17260,16057,13369,7607
83299,53,3009,59250,24049,3.70453e+13,936.877,11135.1,83299,607,642,59983,49328,38953,14905,6521
40049,1448,1685,27735,12314,3.12159e+13,617.664,5705.09,40049,337,313,38364,38133,38264,38152,34153
71662,1239,2913,49570,22092,3.4717e+13,1129.03,9771.08,71662,543,450,68402,66880,57195,42609,37856
65803,1682,2368,46601,19202,3.59556e+13,983.71,8876.58,65803,538,458,63435,63200,62092,59543,55376
63425,2246,3055,44291,19134,3.60084e+13,864.9,9643.19,63425,524,544,60370,60301,59178,57384,56301
42498,1865,2186,29022,13476,3.54459e+13,770.05,6937.69,42498,455,413,40312,40310,39785,39456,39081
82816,899,3052,59151,23665,3.68748e+13,1162.49,11110,82816,628,596,78521,75854,66027,50359,41215
20277,541,1079,13850,6427,3.47955e+13,430.296,3609.51,20277,258,266,19198,18453,17750,17292,13980
64194,2886,3171,44848,19346,3.6496e+13,606.214,9639.24,64194,430,621,61023,61020,60917,60834,59119
65803,1366,2140,46586,19217,3.70976e+13,765.526,7721.75,65803,541,345,63663,63568,59563,54352,49689
54960,358,2615,38623,16337,3.50553e+13,915.676,8351.78,54960,500,512,49729,46796,34327,19132,8388
65780,1690,2455,47130,18650,3.71998e+13,1048.04,8943.34,65780,568,441,63325,62627,61687,58274,55279
51862,481,1840,35328,16534,3.39594e+13,777.965,6854.55,51862,428,391,48840,45997,36341,27541,21072
38643,731,2062,27366,11277,3.59893e+13,552.598,6756.35,38643,449,341,36469,35565,32933,24603,20546
34973,743,2020,23774,11199,3.37231e+13,496.822,6165.07,34973,378,435,32941,32563,28118,23438,19031
49454,2142,2701,33950,15504,3.50024e+13,813.593,8292.39,49454,490,459,46753,46553,45950,45087,42993
90602,2633,2764,62681,27921,3.45821e+13,982.932,10904.5,90602,612,553,87838,87816,87797,87811,87203
66640,2564,3059,46057,20583,3.43016e+13,1156.43,9962.45,66640,611,520,63581,63514,63011,60611,61397
28545,1484,1496,19828,8717,3.21577e+13,511.793,4577.1,28545,330,261,27049,27047,27046,27043,27045
69716,1213,3461,49455,20261,3.70372e+13,1122.06,11257.2,69716,567,546,65800,63619,55260,39376,29994
71110,2873,3409,48842,22268,3.50648e+13,991.92,11051.3,71110,479,626,67701,67680,67466,67245,63644
18235,359,1329,12790,5445,3.69297e+13,442.532,3829.42,18235,284,283,16319,14915,13382,9683,7560
27634,1290,2061,19230,8404,3.59267e+13,544.288,5692.59,27634,431,441,25573,25446,24553,22923,18735
53023,140,2614,36980,16043,3.68067e+13,987.645,8455.73,53023,460,532,43410,37941,27871,10737,7886
16113,609,1148,11363,4750,3.849e+13,475.025,3309.93,16113,333,250,14856,14048,13591,11638,10248
99760,414,3566,69675,30085,3.61525e+13,1121.6,12738.8,99760,699,597,90818,84698,56105,23788,20841
30022,1743,2331,20505,9517,3.39147e+13,607.388,6385.08,30022,371,603,27691,27666,27148,26086,23636
5270,337,889,3765,1505,3.86223e+13,176.471,1766.44,5270,138,184,4381,4133,4150,4111,2266
67739,2581,2769,48404,19335,3.68578e+13,1005.07,9764.55,67739,542,527,64970,64968,64894,64843,64338
85099,2833,3253,59699,25400,3.6479e+13,1005.28,11025.7,85099,695,514,81846,81813,80639,77754,76708
59559,1850,2588,41756,17803,3.58582e+13,820.519,8348.85,59559,537,506,56971,56912,54993,53264,48859
96900,1580,4116,69802,27098,3.67853e+13,1069.08,14695.4,96900,763,784,92704,91584,87896,81444,46143
96540,3076,3917,67958,28582,3.62542e+13,1040,13335.7,96540,773,587,92623,92570,90854,84145,84426
53852,1515,2797,37840,16012,3.57411e+13,689.623,8914.28,53852,549,468,51055,50847,46361,34907,31224
10647,807,1109,7382,3265,3.22197e+13,275.329,2654.19,10647,267,204,9538,9518,8755,7311,7734
18546,574,1745,13081,5465,3.5659e+13,378.152,4283.61,18546,274,340,16801,16291,15340,13789,8695
81070,194,2579,57272,23798,3.43607e+13,1029.45,10027.4,81070,570,470,69894,62986,43991,14439,11886
32862,1340,1962,22912,9950,3.53587e+13,583.013,5887.25,32862,397,346,30900,30768,28987,26918,25734
88664,184,4003,61561,27103,3.58624e+13,840.155,13387.3,88664,546,903,75161,66967,46348,13913,11428
43193,484,2223,29746,13447,3.40648e+13,567.926,7135.06,43193,403,361,40217,37913,27899,19207,16026
3675,526,623,2508,1167,3.22186e+13,167.862,1291.76,3675,144,124,3052,3022,3036,3028,2794
93123,1465,3679,63804,29319,3.52227e+13,1062.74,12073.4,93123,664,562,89209,87881,70926,57778,52772
20952,1188,1583,14814,6138,3.3172e+13,392.753,4169.69,20952,279,250,19369,19261,19255,19165,16919
73422,2324,2615,50670,22752,3.61492e+13,1037.61,8943.73,73422,494,464,70807,70776,70604,70619,69082
88990,1545,2999,63110,25880,3.6325e+13,1307.45,11704.3,88990,661,606,85783,83954,80036,68020,55762
38378,1346,1928,26872,11506,3.52299e+13,792.687,6467,38378,453,434,36450,36170,35011,34236,30522
98239,816,3000,67956,30283,3.27531e+13,1390.23,11623.7,98239,531,576,93138,90269,61934,43170,35298
16160,1408,1830,11658,4502,3.88653e+13,337.812,4246.38,16160,234,320,14330,14328,14177,14258,12698
53018,570,3043,37466,15552,3.64322e+13,736.695,9136.04,53018,511,536,49029,46443,37594,26750,21352
55618,2392,2609,37607,18011,3.48126e+13,928.942,8591.69,55618,514,528,53009,53009,52813,52427,52113
21452,355,1304,14607,6845,3.57198e+13,437.315,3954.4,21452,372,272,19772,18884,14141,12278,8907
26375,1322,1446,18182,8193,3.19863e+13,496.281,4379.58,26375,250,285,24929,24929,24919,24928,24565
26907,1701,26907,0,26907,15.9994,0,26907,26907,26907,1,0,0,0,0,0
16037,655,1400,11282,4755,3.67663e+13,399.194,3681.76,16037,367,306,14582,14415,13216,11008,10046
30938,771,1651,21956,8982,3.70063e+13,564.324,5491.71,30938,355,304,29211,28260,27083,24288,16852
38347,106,2102,26814,11533,3.48936e+13,632.042,6807.12,38347,469,332,29832,25482,18984,7026,4519
54154,1363,2502,37565,16589,3.56794e+13,723.392,7806.65,54154,558,391,51652,51514,47713,41418,43600
26917,503,1389,18525,8392,3.49783e+13,436.634,4363.95,26917,336,320,25466,25130,19509,13689,15530
29681,1119,1812,20983,8698,3.40012e+13,798.965,5412.37,29681,434,351,27856,27206,26535,24489,21218
49184,1985,2417,34521,14663,3.57232e+13,826.445,7696.33,49184,535,395,46767,46676,46256,44598,44580
58704,1253,2798,40222,18482,3.50488e+13,887.987,9002.08,58704,609,527,55906,55010,49317,41193,38810
53632,891,2371,38614,15018,3.6873e+13,928.624,8255.67,53632,552,488,50762,49007,45236,33923,25355
52098,1491,2397,35595,16503,3.55827e+13,670.213,7414.78,52098,425,410,49701,49507,47931,45125,41911
98576,2608,3379,67857,30719,3.39617e+13,795.569,11993,98576,649,445,95197,95158,91001,85039,81658
80825,2207,3154,57086,23739,3.63654e+13,1293.51,11637.5,80825,670,694,77671,77154,75159,72322,67649
32941,1197,1874,23052,9889,3.43527e+13,640.132,5685.12,32941,379,403,31067,30813,29565,28155,23392
23384,121,1946,16381,7003,3.73073e+13,554.394,5196.14,23384,382,361,18479,16160,11856,4103,3640
65490,618,2387,45331,20159,3.14288e+13,994.39,8591.79,65490,581,391,61336,59116,41762,30212,21309
17466,1355,1662,12076,5390,3.49553e+13,334.538,4185.5,17466,324,264,15804,15798,15669,15621,13242
18043,166,1440,12950,5093,3.58983e+13,473.116,3932.66,18043,324,291,14762,12867,10476,4917,3096
5582,292,683,3920,1662,3.06358e+13,139.558,1500.56,5582,131,151,4899,4811,4430,4480,1596
82041,989,2546,58611,23430,3.65678e+13,1040.9,10154.5,82041,628,490,78797,76882,72081,59955,48807
1169,185,287,920,249,3.49136e+13,46.834,489.982,1169,99,51,882,867,861,865,778
59471,2256,2846,40797,18674,3.47356e+13,737.703,8812.27,59471,540,432,56625,56588,55746,53343,52278
69019,1969,3197,47815,21204,3.50595e+13,984.94,10602,69019,511,549,65822,65185,63085,57429,50925
96736,2946,3123,66537,30199,3.54079e+13,1147.17,11178.8,96736,591,626,93613,93613,93547,93487,91827
42396,934,2673,29216,13180,3.596e+13,570.51,7422.34,42396,541,462,39723,39143,30518,23807,22297
81650,251,2232,56505,25145,3.37252e+13,944.817,9160.72,81650,519,420,72219,64887,42700,17502,18149
31509,204,2115,21789,9720,3.36637e+13,668.664,6095.15,31509,385,458,27123,24554,15763,5113,5061
50930,952,2090,35812,15118,3.34697e+13,773.403,7229.31,50930,457,359,48672,47566,44163,35824,26531
96133,2183,4088,67181,28952,3.54262e+13,1087.47,14132.6,96133,622,745,92045,91554,86901,70981,58204
80109,1035,2618,57139,22970,3.73703e+13,1196.46,9859.83,80109,628,540,76691,74506,67544,54914,42974
13680,1083,1420,9340,4340,3.60352e+13,316.517,3385.35,13680,293,236,12260,12251,12085,11358,11320
5679,354,730,4130,1549,3.9877e+13,324.093,1620.26,5679,190,142,4790,4538,4410,4131,3381
44174,904,2293,30497,13677,3.30613e+13,801.568,7090.99,44174,380,437,41651,40582,35885,25534,18308
80126,1011,3547,54990,25136,3.56516e+13,856.81,11129.2,80126,571,559,76343,75038,48652,37044,34971
90998,78,3167,63389,27609,3.42876e+13,1304.11,11513.2,90998,581,631,71685,60778,43164,13576,7667
47837,276,2181,33258,14579,3.59519e+13,891.425,7502.81,47837,471,511,41817,37180,26357,14440,12355
26716,1677,1865,18859,7857,3.68695e+13,688.011,5230.57,26716,356,375,24851,24820,24779,24826,24247
16883,22,1606,11647,5236,3.65439e+13,286.678,4041.77,16883,199,395,10287,7523,6413,2577,1244
25910,1476,1850,18454,7456,3.61251e+13,612.109,5055.11,25910,356,302,24060,23888,23760,23343,22343
85295,1191,1868,61311,23984,3.74474e+13,1201.88,8892.94,85295,610,446,83098,81098,79322,74087,65634
79005,655,3050,54995,24010,3.62059e+13,944.402,10812.6,79005,535,609,74632,71541,52424,39112,27875
51898,1445,2667,37230,14668,3.79199e+13,807.469,8463.8,51898,554,458,49231,48799,47658,45990,38100
63306,844,2481,44715,18591,3.63988e+13,911.407,8812.61,63306,550,412,60026,57654,51475,38943,28152
3283,324,615,2363,920,4.1071e+13,134.052,1132.97,3283,158,115,2668,2569,2570,2564,1931
62679,581,3459,42898,19781,3.39918e+13,672.765,10616.1,62679,626,554,58395,56204,39644,26731,18323
46629,1962,2498,31807,14822,3.54478e+13,613.245,7802.9,46629,411,391,44131,44122,42872,40186,38753
93624,126,3462,64563,29061,3.53852e+13,1132.81,11940.9,93624,763,544,76074,66385,45975,15206,11364
27484,329,1770,19522,7962,3.66841e+13,717.559,5231.3,27484,457,357,24296,22713,18147,13159,8589
87778,1669,3294,62856,24922,3.66002e+13,1272.8,12211.4,87778,710,784,84227,83213,79642,73354,45725
46153,551,1643,32251,13902,3.24012e+13,846.806,5869.11,46153,439,323,43290,41805,39045,33632,13109
96668,64,3134,66631,30037,3.4795e+13,1029.77,11962.2,96668,498,687,71170,58559,44986,13598,8055
77612,110,2741,55156,22456,3.72413e+13,1139.41,10365.9,77612,638,537,61468,52286,40143,10818,9209
49332,745,2664,34153,15179,3.54425e+13,686.174,8168.62,49332,409,458,46378,45000,39907,30861,22504
92376,1122,4064,64097,28279,3.52786e+13,1040.65,13976.9,92376,574,784,87521,85335,78003,57843,38711
18894,456,1389,12775,6119,3.14367e+13,334.217,3787.53,18894,322,238,17321,16825,14946,12609,10411
15248,684,1904,10445,4803,3.45227e+13,263.043,4155.23,15248,353,215,13344,13178,10581,7524,5566
23515,219,1832,16329,7186,3.53693e+13,499.555,4929.48,23515,293,321,20280,18598,14968,8928,5122
69966,3356,3645,48796,21170,3.58624e+13,899.609,11131.2,69966,618,566,66321,66311,66200,66056,64241
40204,629,2105,27554,12650,3.04546e+13,669.32,6673.12,40204,463,467,37589,36664,32716,26217,18259
59049,55,3054,40304,18745,3.42492e+13,872.677,9588.56,59049,511,586,42346,34330,24830,10443,4554
80708,1085,2974,55135,25573,3.34601e+13,1189.77,10778.2,80708,627,488,76886,75014,62679,44895,41339
83518,1458,2391,59806,23712,3.71516e+13,1031.17,9584.06,83518,593,594,81050,80247,78227,70507,68147
40173,105,2389,28062,12111,3.62538e+13,692.664,7116.48,40173,552,375,31421,27029,19667,6941,5716
98148,2799,3493,70328,27820,3.70265e+13,1192.26,12935.8,98148,740,701,94655,94479,93862,92739,84876
40643,2229,2311,28505,12138,3.65757e+13,728.272,7038.64,40643,457,322,38332,38332,38323,38327,38151
17827,695,1585,12520,5307,3.62576e+13,377.495,4012.76,17827,366,326,16242,15918,14220,11122,11681
10567,1080,1234,7885,2682,3.65515e+13,309.942,2800.05,10567,245,244,9333,9322,9314,9267,8868
34883,1004,1795,23874,11009,3.55085e+13,568.035,5671.69,34883,374,327,33088,32854,31418,26377,25706
5669,103,744,3884,1785,3.39644e+13,151.276,1583.98,5669,215,122,4702,4181,2747,2267,797
1598,90,419,1085,513,2.98819e+13,116.595,716.488,1598,131,85,1086,955,786,413,409
64610,1899,3172,44310,20300,3.51835e+13,877.23,9742.21,64610,495,505,61438,61167,59041,54279,49203
42874,1112,1667,29254,13620,3.51913e+13,848.526,6257.13,42874,405,418,41207,40819,39017,35536,37112
52611,1383,2794,35558,17053,3.3504e+13,885.545,8678.64,52611,552,672,49817,49229,46619,42095,27297
28294,1110,1800,20005,8289,3.63159e+13,544.52,5322.24,28294,341,400,26494,26328,26157,25960,21762
99265,2335,3246,68024,31241,3.54178e+13,758.914,11480.8,99265,728,508,96019,95968,93286,88231,80809
44899,2393,2460,32149,12750,3.62598e+13,749.162,7795.22,44899,608,428,42439,42439,42404,42398,42180
82642,2629,3426,57440,25202,3.56958e+13,1329.74,11635.4,82642,585,598,79216,78729,78185,75939,72618
7090,576,779,5049,2041,3.63766e+13,246.811,1857.34,7090,176,163,6311,6302,6252,6215,5474
58828,856,2578,40860,17968,3.61526e+13,870.35,8373.76,58828,573,492,55996,54342,44115,33427,32166
47030,1775,2778,33061,13969,3.66144e+13,811.034,8282.96,47030,454,459,44252,44053,42320,39366,34901
55325,39,2226,38358,16967,3.60182e+13,856.654,7763.58,55325,469,431,37382,29253,22324,8984,5145
84039,1639,3137,58667,25372,3.58398e+13,1106.12,11093.1,84039,648,578,80902,79976,73883,56260,60590
41045,1122,2017,28292,12753,3.37857e+13,775.899,6321.46,41045,454,421,39028,38402,36535,31092,30426
74429,1331,3087,51219,23210,3.38446e+13,1310.19,10828.6,74429,503,593,70718,69162,62692,51166,40146
29752,616,2424,20792,8960,3.65188e+13,457.887,6370.27,29752,467,338,27328,26670,21201,15178,12269
49185,1858,2292,33422,15763,3.54393e+13,632.82,7420.85,49185,467,364,46893,46876,46220,45661,42926
41753,1957,2531,28878,12875,3.65006e+13,900.345,7979.15,41753,449,618,39222,38767,38536,38014,35334
90114,1957,2897,64096,26018,3.64427e+13,1034.01,11179.1,90114,628,497,87217,86959,84966,80859,74242
39901,1748,2038,27858,12043,3.61985e+13,646.253,6628.99,39901,412,401,37863,37851,37258,36281,35530
99598,2912,3232,69600,29998,3.49754e+13,1119.69,12128.3,99598,690,512,96366,96365,96092,95983,94027
20050,886,1270,14248,5802,3.76123e+13,600.266,3827.11,20050,317,301,18780,18347,18175,17121,16308
10100,131,886,7188,2912,3.67262e+13,365.215,2399.61,10100,241,213,8212,7115,6113,5148,2521
52182,2685,2714,36313,15869,3.60293e+13,597.754,8620.76,52182,400,674,49468,49468,49456,49465,49452
26209,20751,26209,0,26209,15.9994,0,26209,26209,26209,1,0,0,0,0,0
67134,957,2648,48356,18778,3.76055e+13,1200.14,9718.57,67134,573,536,63328,61360,57300,44552,27606
33820,2054,2161,24189,9631,3.62782e+13,584.411,6318.28,33820,456,358,31659,31659,31618,31597,31327
98526,651,2955,68394,30132,3.35833e+13,1027.68,11664.9,98526,545,619,93899,91597,75096,56762,33242
65613,2454,2946,46654,18959,3.67693e+13,923.304,10088.3,65613,748,480,62667,62531,61768,60213,57595
73181,2904,2926,50307,22874,3.33743e+13,785.404,10289.9,73181,612,456,70255,70255,70252,70249,70192
44793,866,2184,30149,14644,3.42087e+13,767.414,7161.84,44793,419,512,42475,41330,36561,30351,28142
73785,2361,2998,52778,21007,3.67083e+13,918.13,10570.3,73785,634,466,70787,70739,70229,69607,66728
54130,2360,2591,37002,17128,3.37522e+13,738.157,8420.12,54130,472,383,51539,51478,51411,51326,50758
21259,1630,1634,14610,6649,3.60947e+13,538.724,4509.67,21259,344,342,19625,19625,19625,19625,19623
20712,281,1148,14110,6602,3.56706e+13,419.338,3582.99,20712,274,291,18422,16304,12670,10360,7859
52388,1222,2040,36184,16204,3.61034e+13,1023.22,7791.73,52388,575,464,50167,49143,48072,42973,39460
43709,885,1496,30910,12799,3.57392e+13,765.223,5567.69,43709,412,354,42200,40891,38985,36492,33013
79642,2298,3051,55452,24190,3.44257e+13,1246.61,10910.8,79642,629,597,76591,76246,75011,70495,68482
93781,242,3640,65403,28378,3.57732e+13,1167.07,12493.8,93781,761,546,81459,72899,47728,20345,14736
6490,652,759,4463,2027,3.56546e+13,247.86,1795.26,6490,134,178,5731,5709,5712,5692,5234
30055,1606,2027,21060,8995,3.65704e+13,638.374,5815.24,30055,445,365,28028,27919,27345,27288,25174
20745,963,1751,14294,6451,3.46777e+13,438.946,4690.19,20745,290,316,18994,18740,17948,16116,13721
22467,246,1477,15368,7099,3.41227e+13,463.717,4285.72,22467,385,291,19352,16992,12383,6594,4334
67421,2320,2906,47059,20362,3.4931e+13,927.245,9585.43,67421,537,446,64515,64493,63784,62100,58888
89445,141,3235,63261,26184,3.4341e+13,1230.78,11833.1,89445,562,603,75879,67673,47455,11440,12546
69285,2892,3037,47459,21826,3.39214e+13,1074.98,10142.9,69285,575,549,66248,66248,66221,66204,65813
62488,74,2282,44255,18233,3.41514e+13,794.912,7810.75,62488,552,372,47595,38850,33246,9442,5855
18274,192,1517,12886,5388,3.68952e+13,451.676,4051.75,18274,268,355,15411,13636,10297,6429,3055
45022,449,2521,31732,13290,3.54733e+13,710.677,7875.66,45022,430,541,41474,39530,33050,28567,8815
6818,100,878,4677,2141,3.49513e+13,206.325,1998.98,6818,154,226,5431,4771,3703,2668,1229
57684,594,2477,40003,17681,3.54538e+13,818.293,8309.46,57684,488,489,54094,51642,40269,30998,23091
15843,1225,1545,11076,4767,3.68702e+13,437.764,3803.96,15843,245,314,14298,14287,14199,14211,13024
14043,250,1173,9618,4425,3.58338e+13,310.172,3135.68,14043,192,315,12431,11015,9083,6337,5795
2633,96,544,1959,674,3.81137e+13,101.02,943.192,2633,132,88,2031,1829,1791,1774,647
25832,1312,1330,17517,8315,3.25168e+13,523.074,4380.37,25832,272,305,24502,24480,24497,24498,24429
26456,945,1766,18761,7695,3.71949e+13,517.794,5115.34,26456,510,280,24690,24517,23752,21818,19633
50597,876,1757,34646,15951,3.23872e+13,566.642,6651.64,50597,378,364,48840,48689,45804,42782,30277
92092,824,3015,63286,28806,3.42315e+13,992.822,11620.2,92092,678,490,88193,86582,72600,46791,38672
77325,535,2683,55600,21725,3.74394e+13,1128.38,10018.7,77325,575,522,72087,69022,60057,50375,20812
11408,503,1065,7805,3603,3.04472e+13,277.655,2482.66,11408,223,191,10343,10167,9951,9143,6035
94282,2571,3311,67217,27065,3.661e+13,1021.03,12553.3,94282,512,671,90971,90889,90592,90664,83514
23682,1703,1727,16979,6703,3.72253e+13,558.764,4929.7,23682,355,362,21955,21955,21949,21953,21941
17027,1000,1221,11908,5119,3.71751e+13,401.785,3371.9,17027,292,233,15806,15767,15714,15677,14853
10525,255,1042,7340,3185,3.84744e+13,365.275,2667.32,10525,260,327,9074,8162,6945,6341,3876
8915,855,1045,6346,2569,3.83018e+13,252.537,2393.4,8915,194,212,7870,7862,7839,7803,7127
33534,658,1233,23283,10251,2.92129e+13,661.741,4438.97,33534,316,266,31881,31033,30451,28290,23234
58966,923,3585,41536,17430,3.58743e+13,958.288,10714.1,58966,586,587,54881,52826,47059,37935,21313
24897,1007,1149,16953,7944,3.58261e+13,373.469,3556.82,24897,255,268,23748,23718,23693,23591,22299
4282,175,777,3032,1250,3.91818e+13,145.82,1482.84,4282,172,132,3432,3142,2441,1823,1499
29451,254,1945,20483,8968,3.56749e+13,618.858,5691.03,29451,402,430,26052,23983,18329,10091,6751
38969,637,1981,27583,11386,3.59788e+13,671.808,6417.91,38969,437,405,36537,35440,32650,25152,17506
49497,951,2769,34294,15203,3.47541e+13,730.994,8357.13,49497,526,453,46680,45804,38172,30004,26537
31273,469,2246,21259,10014,3.24449e+13,458.941,6063.29,31273,350,360,28706,27443,20221,16274,10695
55102,548,1983,39313,15789,3.69439e+13,784.683,7257.68,55102,538,413,51427,47822,39816,27838,24300
51322,953,2553,35303,16019,3.47055e+13,804.658,7990.08,51322,440,403,48564,47484,40429,30980,24461
41850,434,2535,28968,12882,3.53253e+13,714.769,7505.27,41850,421,435,38090,35975,27119,17576,12448
76232,386,2980,53166,23066,3.52034e+13,996.698,10570,76232,590,487,70414,67138,44927,21308,16265
64752,87,3527,43936,20816,3.30079e+13,682.486,10828.8,64752,640,381,51961,44899,30193,10463,5774
24428,476,1674,16936,7492,3.64614e+13,709.978,4860.6,24428,430,420,21944,20600,16923,13928,9538
12318,577,1049,8772,3546,3.61202e+13,313.569,2717.66,12318,252,201,11269,11086,10536,10122,8013
2576,14,393,1776,800,3.44877e+13,205.61,857.445,2576,121,121,1309,854,764,609,210
70212,639,3553,49440,20772,3.67766e+13,1045.97,11099.5,70212,602,622,64735,62614,45921,34978,24706
99757,2378,3822,68926,30831,3.52364e+13,971.335,13552.1,99757,645,669,95935,95705,93541,90784,73697
99471,2289,3503,67779,31692,3.57945e+13,1086.33,12010.9,99471,646,694,95968,95714,91703,81263,84838
11273,1090,1204,8047,3226,3.48597e+13,239.467,2816.16,11273,200,198,10069,10069,10069,10059,9692
48681,1270,2109,34020,14661,3.52041e+13,826.679,7365.44,48681,476,392,46572,46065,43465,40947,34975
33714,445,2065,22834,10880,3.47289e+13,596.443,5986.43,33714,431,447,30832,29271,20905,15812,13802
14080,579,1243,9738,4342,3.69927e+13,422.081,3340.96,14080,286,253,12753,12142,11636,9644,9560
4287,493,922,3002,1285,3.63126e+13,130.24,1651.42,4287,236,141,3365,3340,3117,2631,1940
40568,175,2136,27761,12807,3.34485e+13,790.892,6443.37,40568,365,360,34307,30305,19320,7283,5023
86473,1777,2637,59946,26527,3.41125e+13,1008.43,10168.6,86473,585,576,83836,83219,80827,73497,68340
67691,2872,3078,47672,20019,3.66539e+13,949.472,9961.73,67691,555,448,64613,64607,64552,64583,63992
60383,620,2414,42660,17723,3.6879e+13,950.654,8346.69,60383,502,487,56662,54613,41050,30080,22481
2914,342,594,2108,806,3.91296e+13,117.34,1065.55,2914,131,97,2320,2256,2249,2263,1543
93389,1966,3289,64021,29368,3.35919e+13,1140.49,12015.2,93389,587,599,90100,89379,85564,77044,74350
74461,765,2963,51120,23341,3.39484e+13,797.216,10303.5,74461,440,600,70679,68825,58666,39324,31380
33384,1395,1935,24044,9340,3.64798e+13,903.678,6126.6,33384,475,421,31449,30790,30273,29276,26362
27235,1656,1775,18500,8735,3.54478e+13,640.828,5176.94,27235,348,392,25460,25453,25409,25289,24903
47594,121,2419,32609,14985,3.55309e+13,709.486,7343.86,47594,459,339,37871,32993,24426,9448,5428
99356,349,3888,69264,30092,3.59716e+13,1096.5,13460.2,99356,728,564,89824,83063,53633,19062,20125
5963,370,547,4360,1603,3.51715e+13,287.638,1431.29,5963,177,134,5405,4795,5159,5198,4713
10742,1047,1249,7690,3052,3.56715e+13,288.071,2884.34,10742,257,197,9493,9488,9417,9398,8485
64648,150,3065,46098,18550,3.67944e+13,968.467,10375.9,64648,706,422,53269,46095,34210,12040,8085
70244,182,2773,48857,21387,3.49345e+13,976.614,9435.86,70244,479,485,60681,54643,37509,12232,11006
67232,2049,2359,45090,22142,3.33141e+13,820.844,8597.29,67232,516,608,64873,64867,64265,62899,61533
