"data_size","cache_size","unique_size","reads","writes","data","ins","avg_step","avg_reuse_dist","sum_sqrt_count","sum_count","lis","lds","belady","lru","pivot","ld","mru"
46555,27,56,46555,0,0,46555,5.69468e+15,34.9364,885.286,46555,40,32,46485,46439,46456,18966,41568
22764,21,40,0,22764,22764,0,2.21336e+13,27.257,557.935,22764,29,29,22706,22667,22676,22643,22044
40557,9,44,40557,0,40557,0,83982100000,33.483,844.966,40557,37,38,38163,33244,34311,33313,16188
36399,1,40,36399,0,36399,0,1.46684e+18,28.1083,777.6,36399,32,31,3638,3638,3638,3638,3638
34733,1,2,34733,0,34733,0,4.41828e+13,1.99954,249.29,34733,2,2,29280,29280,29280,29280,29280
771,1,2,0,771,771,0,8.03755e+15,1.97536,36.443,771,2,2,684,684,684,684,684
3275,32,36,0,3275,0,3275,1218750,21.7606,236.286,3275,28,32,3239,3231,3207,3207,3203
33600,20,23,0,33600,5608,27992,5011.11,16.4519,581.143,33600,20,21,33575,33574,33507,33509,33404
34152,9,19,6552,27600,0,34152,19.5642,18.5552,665.782,34152,19,19,33329,33321,32879,32873,31052
42038,19,30,0,42038,8083,33955,4837.22,15.9512,764.961,42038,21,26,42002,42002,41834,41834,38229
28643,22,38,0,28643,28643,0,2.20609e+13,35.4767,738.732,28643,35,33,28519,28405,28411,28421,27365
44587,35,40,0,44587,0,44587,1205130,32.6492,965.778,44587,40,37,44531,44377,44300,44301,41134
15875,55,60,0,15875,15875,0,2.12672e+13,32.6159,696.109,15875,38,50,15815,15809,15812,15815,15580
30737,8,21,0,30737,6001,24736,4694.54,17.6663,602.366,30737,21,20,29838,29729,29544,29664,26901
27784,29,56,0,27784,27784,0,2.2228e+13,21.4536,682.537,27784,30,32,27728,27704,27716,27714,26070
16578,1,2,0,16578,16578,0,8.97134e+15,1.99928,169.653,16578,2,2,14513,14513,14513,14513,14513
17859,21,40,0,17859,0,17859,1302160,23.91,528.929,17859,32,37,17768,17681,17711,17708,14936
12404,2,40,12404,0,0,12404,338147000,18.2874,418.021,12404,25,29,7072,7067,4906,2363,2003
23762,21,40,23762,0,0,23762,5.53497e+15,33.7742,615.035,23762,37,37,23607,23440,23496,4357,15296
36378,20,44,36378,0,0,36378,273841000,37.1392,968.795,36378,38,39,35595,33691,33893,20250,22213
24620,2,21,0,24620,4017,20603,5183.72,12.1978,455.126,24620,21,20,16638,16638,16542,11348,11345
31768,13,44,0,31768,31768,0,2.10023e+13,35.6242,775.895,31768,37,37,30795,29092,29910,29128,16447
32425,36,44,32425,0,0,32425,278395000,36.1166,909.772,32425,38,39,32375,32337,32031,30070,29322
34786,23,25,0,34786,7949,26837,4577.92,18.4961,714.493,34786,21,23,34761,34761,34626,34626,34757
560,8,16,0,560,560,0,2.16761e+13,8.79286,74.8851,560,10,13,527,476,479,487,463
33875,25,40,33875,0,0,33875,334819000,34.1337,712.228,33875,37,37,33777,33665,33703,19066,28854
36296,15,40,0,36296,36296,0,2.23191e+13,33.1889,778.18,36296,32,31,35882,35189,34103,33854,26365
6525,6,21,1024,5501,0,6525,19.9093,9.98222,240.052,6525,18,20,6367,6367,6201,6203,3707
9713,23,24,9713,0,9713,0,1.45994e+18,17.7044,355.46,9713,21,21,9689,9679,9681,9489,9689
2163,35,40,2163,0,2163,0,83643700000,15.9954,202.952,2163,20,29,2123,2115,2123,2114,2123
16522,23,36,0,16522,16522,0,2.08858e+13,28.7617,523.416,16522,35,33,16392,16105,16292,16133,11675
12081,6,24,0,12081,12081,0,2.24224e+13,20.1827,406.898,12081,21,21,10339,9281,7291,8973,5276
31789,7,21,0,31789,7095,24694,4453.27,18.8574,634.706,31789,21,20,29821,29821,29627,29800,11572
6656,12,23,1368,5288,0,6656,18.1575,13.4494,302.272,6656,18,21,6582,6578,6526,6540,5807
40444,1,2,0,40444,40444,0,8.6375e+15,1.99965,264.851,40444,2,2,35595,35595,35595,35595,35595
49234,29,32,0,49234,11544,37690,4451.64,19.4146,881.76,49234,23,27,49202,49202,49202,49202,48957
17581,56,60,0,17581,17581,0,2.07942e+13,30.5448,638.681,17581,34,40,17521,17511,17519,17521,15650
43096,2,40,43096,0,0,43096,5.6644e+15,37.0998,902.462,43096,37,35,22670,22670,14436,4211,5879
957,1,2,957,0,957,0,3.88241e+13,1.98642,40.9452,957,2,2,824,824,824,824,824
19415,10,13,3341,16074,0,19415,20.3974,11.1656,406.769,19415,13,12,19379,19379,19339,19338,19379
8758,38,40,8758,0,8758,0,1.27328e+18,33.935,454.553,8758,32,37,8718,8701,8706,8715,8718
39586,1,2,39586,0,39586,0,3.28077e+13,1.99957,262.806,39586,2,2,34971,34971,34971,34971,34971
46379,7,21,0,46379,7512,38867,5039.15,18.0552,659.108,46379,21,21,45541,45541,44769,44849,9488
35402,36,40,35402,0,35402,0,85793100000,33.6502,726.689,35402,37,37,35354,35304,35314,35297,35303
23977,40,56,0,23977,0,23977,1302170,29.6781,738.097,23977,38,42,23921,23909,23921,23921,23919
44274,1,44,44274,0,44274,0,83998800000,37.3524,875.392,44274,38,38,5365,5365,5365,5365,5365
39003,17,56,0,39003,39003,0,2.20579e+13,28.3971,827.266,39003,37,40,38749,38105,38440,38246,28141
31380,18,40,31380,0,0,31380,4.66983e+15,35.4704,872.885,31380,37,37,30424,28458,28997,9387,18590
19956,19,24,19956,0,19956,0,1.46975e+18,21.2033,539.537,19956,24,22,19909,19825,19853,16586,18169
9771,15,36,9771,0,0,9771,327694000,27.0105,385.379,9771,32,33,9635,9462,9551,9545,6545
3415,19,22,3415,0,0,3415,343975000,17.3435,223.655,3415,19,19,3392,3381,3388,3386,3392
10990,35,40,0,10990,0,10990,1318310,18.8435,397.583,10990,27,29,10950,10938,10950,10949,10950
36963,4,23,0,36963,6141,30822,4984.56,17.0045,607.341,36963,20,21,33607,33607,30888,30656,30814
23041,1,44,23041,0,23041,0,83071200000,33.0243,653.338,23041,34,37,2750,2750,2750,2750,2750
9616,6,20,9616,0,0,9616,5.71509e+15,17.3837,350.624,9616,20,19,8352,7562,5972,2142,3392
48530,14,28,0,48530,8096,40434,5190.26,12.5372,667.246,48530,21,21,48489,48489,48489,48489,48485
21551,14,19,3939,17612,0,21551,20.0332,16.0536,482.759,21551,19,19,21497,21497,21497,21497,21497
8844,4,5,8844,0,8844,0,5.08272e+13,1.99898,130.998,8844,3,4,8839,8838,8839,8839,8839
1596,9,24,1596,0,0,1596,339623000,17.2299,162,1596,17,21,1446,1161,1125,1140,855
48896,1,40,48896,0,0,48896,5.71253e+15,35.2971,906.57,48896,33,31,4988,4988,4988,4988,4988
35813,5,21,0,35813,5737,30076,5167.15,14.3541,542.687,35813,21,20,33806,33806,30206,30158,30592
43346,11,23,8104,35242,0,43346,18.9353,15.7827,722.745,43346,21,22,43031,43031,42890,42949,40033
7669,26,36,7669,0,7669,0,1.42345e+18,24.5411,316.647,7669,25,25,7623,7587,7615,4859,7589
21743,1,2,21743,0,21743,0,3.24674e+13,1.99913,196.07,21743,2,2,19234,19234,19234,19234,19234
37355,22,40,37355,0,0,37355,340686000,23.5341,761.629,37355,32,28,37305,37247,37263,37260,34437
40215,20,56,40215,0,0,40215,5.70389e+15,22.96,805.166,40215,32,32,40127,39985,39972,26327,34705
42079,5,21,6834,35245,0,42079,20.1041,15.1925,610.883,42079,21,21,39628,39628,35624,35589,35718
31853,43,60,31853,0,0,31853,329938000,25.2503,831.089,31853,33,40,31793,31782,31762,31331,28536
28397,13,20,0,28397,5025,23372,5194.93,15.6861,529.982,28397,20,19,28358,28358,28358,28358,28358
42793,3,56,42793,0,42793,0,86789400000,35.8909,834.308,42793,40,32,28102,23804,21248,23037,8640
8803,6,20,8803,0,0,8803,340812000,17.7201,322.584,8803,20,19,7711,7023,5444,6108,3257
35852,29,40,0,35852,0,35852,1202940,33.5319,850.201,35852,40,37,35731,35437,35399,35404,30768
19150,1,2,19150,0,19150,0,3.47177e+13,1.99916,182.159,19150,2,2,16787,16787,16787,16787,16787
1532,14,32,1532,0,1532,0,1.28669e+18,15.686,161.958,1532,26,27,1448,1363,1414,485,974
22537,11,21,3584,18953,0,22537,19.8642,16.5255,447.143,22537,20,20,22450,22450,22413,22436,22330
14051,9,19,0,14051,2499,11552,5204.61,11.2882,371.229,14051,19,18,13940,13940,13795,13793,13692
9908,5,21,0,9908,1678,8230,5113.28,10.6023,314.655,9908,15,20,9258,9258,8316,8305,8190
7182,12,19,1275,5907,0,7182,20.1855,11.3764,274.33,7182,19,18,7156,7156,7156,7156,7154
11484,10,19,4508,6976,0,11484,14.5528,15.1971,385.478,11484,18,17,11157,11132,10517,10535,10121
39500,1,2,39500,0,39500,0,3.25798e+13,1.99922,262.614,39500,2,2,34927,34927,34927,34927,34927
11785,1,2,11785,0,11785,0,5.42887e+13,1.99915,147.679,11785,2,2,9511,9511,9511,9511,9511
29802,4,40,29802,0,29802,0,1.45648e+18,20.6176,636.877,29802,29,29,22104,16959,16406,3673,8024
6461,1,2,6461,0,6461,0,6.49993e+13,1.99876,110.813,6461,2,2,4968,4968,4968,4968,4968
7396,27,38,7396,0,7396,0,1.44302e+18,30.0097,377.697,7396,29,30,7347,7316,7330,6381,7347
30642,9,40,30642,0,0,30642,339957000,35.0924,719.234,30642,32,31,28427,23409,23127,23364,12670
26279,6,44,0,26279,0,26279,1269120,30.9798,684.932,26279,34,37,23028,21055,17771,19328,8309
18885,24,40,0,18885,0,18885,1323100,21.6837,518.347,18885,29,29,18844,18825,18836,18834,18843
48320,29,30,0,48320,8315,40005,5081.73,19.391,743.149,48320,28,25,48290,48290,48290,48290,48287
23159,17,44,23159,0,23159,0,1.39312e+18,32.5244,654.456,23159,37,37,22844,22028,22649,4516,15290
1191,14,18,0,1191,0,1191,1351000,14.9463,127.103,1191,15,18,1159,1135,1131,1131,1086
2904,2,40,2904,0,2904,0,85029700000,15.3499,234.376,2904,18,32,1622,1617,1150,1329,431
34602,25,56,34602,0,0,34602,339681000,22.2367,751.807,34602,32,32,34546,34524,34529,34528,34373
15448,1,38,0,15448,0,15448,1307800,36.8261,553.461,15448,34,32,1440,1440,1440,1440,1440
26317,13,20,0,26317,4537,21780,5188.56,12.1574,501.515,26317,19,19,26291,26291,26291,26291,26278
24550,1,20,4318,20232,0,24550,20.3435,11.843,483.01,24550,19,19,3870,3870,3870,3870,3870
10016,1,2,10016,0,10016,0,3.2627e+13,1.9994,131.76,10016,2,2,8854,8854,8854,8854,8854
18535,17,19,3465,15070,0,18535,19.8796,18.3145,480.028,18535,19,19,18496,18496,18458,18460,16778
34309,31,44,34309,0,0,34309,5.28312e+15,37.8418,830.048,34309,38,37,34224,33978,34009,27416,30430
7923,15,20,7923,0,7923,0,1.46425e+18,17.7047,307.596,7923,19,19,7883,7822,7812,6549,7160
22683,4,20,0,22683,3978,18705,5121.76,14.242,523.388,22683,19,20,19971,19971,17743,14526,10056
975,2,4,0,975,975,0,8.12957e+15,1.99487,46.4616,975,3,3,970,969,970,970,954
16730,1,2,16730,0,16730,0,3.25724e+13,1.99916,171.603,16730,2,2,14793,14793,14793,14793,14793
8112,5,40,8112,0,0,8112,5.66309e+15,18.3947,375.056,8112,20,34,6450,4819,4831,1540,2939
9648,1,2,0,9648,9648,0,8.32008e+15,1.99565,128.93,9648,2,2,8533,8533,8533,8533,8533
5260,13,32,5260,0,0,5260,294820000,23.8814,306.559,5260,31,28,4968,4596,4808,4810,2238
49799,25,44,0,49799,49799,0,2.01694e+13,35.8238,1049.11,49799,41,41,49506,48873,48874,47846,36308
2742,19,32,2742,0,0,2742,5.07805e+15,27.6379,208.786,2742,27,28,2664,2577,2627,950,2454
46699,15,44,0,46699,0,46699,1267570,34.0625,919.155,46699,37,37,45862,44305,45223,45192,25313
21129,21,24,21129,0,0,21129,5.71929e+15,20.4654,525.978,21129,22,22,21100,21073,21076,19149,21096
12308,17,21,2836,9472,0,12308,17.2746,14.8593,400.496,12308,19,20,12281,12281,12186,12186,11313
5391,32,36,5391,0,5391,0,1.42565e+18,15.1833,258.158,5391,22,25,5355,5346,5355,4988,5355
28102,21,40,0,28102,0,28102,1308310,31.947,773.796,28102,38,35,27882,27426,27631,27656,22657
7383,1,2,0,7383,7383,0,8.32522e+15,1.99634,113.792,7383,2,2,6529,6529,6529,6529,6529
45457,15,48,45457,0,0,45457,295550000,34.6868,1083.3,45457,38,41,43005,36312,40983,40804,23345
30467,12,44,30467,0,0,30467,274623000,33.8043,879.98,30467,38,37,26652,21450,24383,24285,10103
13232,1398,4609,13112,120,0,13232,1.55551e+18,150.346,5782.26,13232,1715,162,8623,8623,6397,6244,240
46538,1,2,46538,0,46538,0,3.89267e+13,1.99979,285.355,46538,2,2,40101,40101,40101,40101,40101
37280,15,23,0,37280,11287,25993,3995.44,19.5933,737.324,37280,22,21,37169,37169,36795,36806,36393
31973,1,2,31973,0,31973,0,3.4052e+13,1.99972,235.435,31973,2,2,28104,28104,28104,28104,28104
21293,1,2,21293,0,21293,0,3.26513e+13,1.99972,192.424,21293,2,2,18822,18822,18822,18822,18822
35313,1,2,35313,0,35313,0,3.23298e+13,1.99943,249.922,35313,2,2,31256,31256,31256,31256,31256
13215,17,36,0,13215,0,13215,1103330,28.5795,541.981,13215,36,33,12679,10367,12139,12119,7447
36008,18,25,8227,27781,0,36008,17.8002,18.3376,724.756,36008,21,23,35970,35968,35793,35795,34831
29644,39,40,29644,0,29644,0,1.45784e+18,22.1602,643.197,29644,29,29,29604,29590,29604,27910,29604
17065,11,21,5907,11158,0,17065,14.6953,17.5413,490.627,17065,20,19,16780,16780,16570,16616,14564
3963,1,2,3963,0,3963,0,4.07688e+13,1.99596,82.9326,3963,2,2,3388,3388,3388,3388,3388
44371,1,2,44371,0,44371,0,3.25938e+13,1.99928,278.713,44371,2,2,39232,39232,39232,39232,39232
11471,53,56,11471,0,11471,0,1.42957e+18,21.309,507.14,11471,35,39,11415,11407,11415,11115,11388
10887,1,2,10887,0,10887,0,3.27573e+13,1.99963,138.407,10887,2,2,9619,9619,9619,9619,9619
44392,51,56,44392,0,44392,0,1.45621e+18,30.9614,966.973,44392,38,38,44336,44328,44336,43743,44336
3061,5,20,0,3061,3061,0,2.23394e+13,13.3551,184.248,3061,15,17,2496,1863,1786,2209,1297
37897,1,2,37897,0,37897,0,3.25319e+13,1.99945,258.513,37897,2,2,33516,33516,33516,33516,33516
42506,8,56,42506,0,42506,0,1.46251e+18,36.7078,890.396,42506,46,36,38711,32765,29330,4819,12471
34519,1,21,5767,28752,0,34519,20.2985,12.3832,549.075,34519,21,20,5814,5814,5814,5814,5814
6727,1,11,0,6727,1115,5612,5231.43,9.34458,222.869,6727,11,10,1126,1126,1126,1126,1126
46297,39,40,0,46297,0,46297,1306550,33.4394,846.614,46297,38,37,46255,46197,46245,46245,46255
13981,3,14,2466,11515,0,13981,20.3199,11.1626,362.49,13981,14,12,10657,10657,10493,7632,5171
21726,6,48,21722,4,0,21726,1.69151e+15,32.5857,782.628,21726,36,41,15470,12919,12385,12526,5099
13408,7,40,13408,0,0,13408,339764000,19.2506,476.536,13408,29,25,11765,10119,8953,8870,5436
35059,22,44,0,35059,0,35059,1031180,37.4942,965.392,35059,38,37,34537,33137,33402,33364,24160
8252,12,38,8252,0,0,8252,342237000,21.4125,376.022,8252,23,28,7959,7404,6928,6901,4087
4957,6,36,4957,0,4957,0,1.40882e+18,26.6568,257.078,4957,25,25,4467,4143,3555,698,2258
37974,605,2497,37647,327,37647,327,7.026e+17,88.9636,4626.91,37974,507,180,35477,35144,32765,33722,6630
27013,2,40,27013,0,27013,0,77760700000,35.2283,757.11,27013,39,37,15535,15422,12310,12228,4249
24275,24,40,0,24275,24275,0,2.12704e+13,27.1773,644.303,24275,36,35,24145,23963,23983,23653,19289
2586,5,22,2586,0,2586,0,86909200000,19.3732,202.236,2586,20,19,1956,1439,1478,1709,794
49699,34,40,49699,0,0,49699,5.65152e+15,31.4576,862.855,49699,39,37,49643,49552,49596,41184,48684
40759,24,44,0,40759,40759,0,2.14971e+13,30.7054,832.499,40759,37,37,40577,40323,40334,39841,29651
48517,30,48,48517,0,48517,0,74665900000,36.654,1111.74,48517,40,41,48373,47947,47613,46806,30579
37215,37,56,37215,0,0,37215,338947000,38.576,796.175,37215,40,31,37155,37115,37144,37145,32844
37689,3,20,6365,31324,0,37689,20.3276,11.9876,581.104,37689,20,17,29322,29322,29106,22319,17839
44179,5,40,0,44179,0,44179,1313540,32.2154,811.765,44179,38,37,35966,27193,27831,28223,9623
40369,2,4,0,40369,40369,0,1.28518e+16,2.53551,294.251,40369,4,4,40322,40307,40318,40319,39357
49714,40,56,49714,0,49714,0,87078100000,23.1882,883.463,49714,32,32,49658,49645,49658,49657,48370
43393,21,60,43393,0,0,43393,5.53409e+15,31.0169,940.047,43393,37,43,43131,42701,42913,18871,32419
34858,23,40,34858,0,0,34858,5.63816e+15,30.2757,732.135,34858,38,37,34756,34629,34677,8964,26844
25505,19,38,25505,0,25505,0,85884500000,31.5932,715.489,25505,38,33,25263,24915,24922,24897,21960
32180,44,65,32179,1,32179,1,2.66787e+12,35.308,1072.15,32180,39,48,32115,32107,31746,31386,14949
3890,1,8,3890,0,3890,0,1.6259e+14,2.00103,96.4045,3890,5,7,3166,3166,3166,3166,3166
14615,28,40,14615,0,14615,0,1.4249e+18,24.7238,484.572,14615,34,37,14555,14503,14504,7449,11791
10667,1,4,0,10667,10667,0,8.32239e+15,1.99925,142.492,10667,3,3,9432,9432,9432,9432,9432
47831,16,44,47831,0,0,47831,4.4834e+15,37.9418,1130.17,47831,39,37,44426,31160,40337,13817,22695
32081,1,4,0,32081,32081,0,8.39598e+15,1.99975,242.048,32081,3,3,28340,28340,28340,28340,28340
5957,3,20,0,5957,0,5957,1321850,16.7242,257.912,5957,17,19,4058,3454,3118,2387,1163
2325,1,18,2325,0,2325,0,87532400000,13.1798,161.167,2325,15,15,264,264,264,264,264
33040,5,21,5328,27712,0,33040,20.2412,11.8555,518.15,33040,21,20,31141,31141,27796,27746,27992
34953,3,4,0,34953,34953,0,9.4007e+15,1.99997,253.194,34953,3,3,34949,34947,34948,34948,34949
36281,1,2,36281,0,36281,0,5.73253e+13,1.99953,260.355,36281,2,2,28891,28891,28891,28891,28891
11350,17,21,0,11350,2088,9262,4734.85,16.1642,351.369,11350,19,19,11323,11323,11265,11265,11000
13268,1,2,13268,0,13268,0,5.39274e+13,1.99857,156.36,13268,2,2,10725,10725,10725,10725,10725
19306,22,23,0,19306,3516,15790,4966.98,17.7862,482.989,19306,20,22,19283,19283,19269,19269,19254
29325,3,4,0,29325,29325,0,8.33976e+15,1.99942,231.878,29325,3,3,29321,29319,29320,29320,29321
6290,5,20,6290,0,0,6290,340089000,18.1434,274.158,6290,18,19,5111,3832,3849,3941,2165
8529,21,40,8529,0,0,8529,5.68811e+15,19.3568,359.323,8529,20,29,8489,8479,8483,8365,8448
47973,1,2,47973,0,47973,0,3.28748e+13,1.99962,289.049,47973,2,2,42369,42369,42369,42369,42369
15781,1,36,15781,0,15781,0,1.15643e+18,30.3492,611.18,15781,36,33,1402,1402,1402,1402,1402
25180,1,2,25180,0,25180,0,3.26189e+13,1.99932,209.554,25180,2,2,22261,22261,22261,22261,22261
46740,9,20,7849,38891,0,46740,20.3199,12.3724,642.763,46740,20,19,46531,46531,46092,46090,46187
18624,6,44,18624,0,18624,0,68968600000,33.1778,707.445,18624,35,37,13378,11204,10750,10294,4072
33602,19,56,0,33602,0,33602,1326030,22.7816,741.744,33602,31,32,33502,33343,33206,33377,26647
1218,11,12,222,996,0,1218,20.197,9.25616,105.751,1218,11,11,1205,1205,1205,1204,1205
9524,9,36,9524,0,9524,0,86153700000,18.2649,349.486,9524,26,25,9091,7931,8142,8041,5713
44002,17,64,0,44002,44002,0,1.98337e+13,30.9817,1163.85,44002,36,44,42658,35489,40685,39547,24836
25181,21,40,25181,0,25181,0,1.07592e+18,36.1747,826.984,25181,37,37,24661,21883,22557,13055,13947
10934,1,2,10934,0,10934,0,3.29512e+13,1.99808,137.946,10934,2,2,9653,9653,9653,9653,9653
45365,14,56,45365,0,45365,0,1.45846e+18,35.0137,854.76,45365,32,36,44890,44339,41090,11937,28361
49366,1,5,1,49365,49366,0,1.46054e+16,2.27347,328.256,49366,4,4,39330,39330,39330,39330,39330
36114,9,21,0,36114,6037,30077,5198.83,12.2494,560.346,36114,21,20,35957,35957,35698,35701,35784
2270,23,38,0,2270,2270,0,2.14691e+13,19.9709,208.079,2270,24,26,2232,2212,2219,2220,2232
23300,15,40,0,23300,0,23300,1326400,21.4083,570.449,23300,29,29,23158,22905,22683,22668,16379
20556,3,4,0,20556,20556,0,8.81615e+15,2.00015,194.6,20556,3,3,20552,20550,20551,20551,20552
39359,3,56,39359,0,39359,0,1.45003e+18,23.5764,831.771,39359,41,40,25898,21960,19647,4881,8139
22639,2,38,22639,0,22639,0,1.45623e+18,36.4385,650.873,22639,32,32,11839,11839,7511,2189,3382
9173,4,40,0,9173,9173,0,2.21096e+13,19.7922,409.097,9173,30,24,6512,4943,4766,5709,2384
21374,36,40,0,21374,0,21374,1302650,30.8815,571.293,21374,33,37,21332,21307,21294,21294,21331
44190,37,1433,44185,5,44190,0,2.74498e+18,230.134,3971.94,44190,262,181,33777,26961,23805,22398,2500
18643,17,24,18643,0,0,18643,341973000,20.9744,527.123,18643,23,22,18539,18132,18275,18272,15790
5196,1,12,936,4260,0,5196,20.3172,11.3187,217.186,5196,12,12,795,795,795,795,795
48206,3,20,0,48206,8374,39832,5194.75,18.0829,685.078,48206,20,20,37047,37047,36545,20301,17145
27611,31,40,27611,0,27611,0,1.43957e+18,28.9949,646.011,27611,36,37,27555,27469,27513,22175,27499
21373,1,2,21373,0,21373,0,4.94125e+13,1.99958,197.358,21373,2,2,17620,17620,17620,17620,17620
28006,1,40,0,28006,28006,0,2.19485e+13,31.0647,656.4,28006,37,37,3357,3357,3357,3357,3357
13188,1,24,0,13188,13188,0,2.23481e+13,21.3468,424.544,13188,21,22,1461,1461,1461,1461,1461
19045,9,23,4205,14840,0,19045,17.9673,17.1409,518.827,19045,20,22,18633,18633,18430,18505,15740
41842,6,28,7002,34840,0,41842,20.1417,12.8038,649.247,41842,20,25,40590,40590,39265,39279,38193
27351,18,21,6184,21167,0,27351,17.2257,18.7845,586.748,27351,21,20,27316,27314,27146,27148,27243
40771,44,48,40767,4,0,40771,9.01369e+14,38.6924,1074.09,40771,40,41,40723,40700,40719,40497,40722
15662,13,30,0,15662,3395,12267,4864.49,12.4534,512.502,15662,19,23,15608,15608,15538,15548,13859
25715,26,40,25715,0,25715,0,1.45961e+18,22.2869,605.518,25715,30,29,25675,25655,25668,8790,25673
33573,33,38,33573,0,0,33573,340226000,28.9781,764.526,33573,32,31,33525,33455,33513,33512,33525
38563,10,40,38563,0,0,38563,5.57534e+15,35.9162,772.567,38563,38,37,37311,36149,33528,5516,14601
2592,7,18,2592,0,2592,0,1.48519e+18,16.3573,184.142,2592,17,18,2249,1910,1738,1500,1235
6284,1,2,0,6284,6284,0,8.39372e+15,1.99841,105.295,6284,2,2,5551,5551,5551,5551,5551
31874,15,21,0,31874,6199,25675,4716.59,17.5235,614.411,31874,21,20,31787,31787,31623,31623,29881
15002,1,40,15002,0,0,15002,340492000,20.329,503.628,15002,30,24,1514,1514,1514,1514,1514
47714,6,56,47714,0,0,47714,5.65834e+15,26.2735,980.615,47714,38,42,40179,35729,28406,8645,10131
29367,1,65,0,29367,0,29367,6.28126e+14,31.3509,1043.46,29367,37,48,2023,2023,2023,2023,2023
2546,1,2,0,2546,2546,0,8.43408e+15,1.9945,66.7364,2546,2,2,2247,2247,2247,2247,2247
43385,2,4,43385,0,43385,0,3.81485e+13,1.99977,280.616,43385,3,3,43380,43379,43379,43379,42484
37757,36,40,0,37757,0,37757,1329950,32.9325,790.283,37757,32,31,37713,37671,37708,37709,35035
17965,35,40,0,17965,17965,0,2.16663e+13,34.2365,548.674,17965,36,35,17922,17863,17890,17886,17907
10314,4,24,0,10314,10314,0,2.2441e+13,19.4722,378.831,10314,20,21,7418,5618,5416,6458,3229
1113,12,14,1113,0,1113,0,1.47067e+18,12.1581,104.464,1113,13,13,1093,1067,1066,992,1050
35507,8,21,0,35507,5761,29746,5182.96,12.0536,541.478,35507,21,20,35305,35305,34555,34558,35134
43615,27,65,0,43615,0,43615,4.22932e+14,36.2723,1037.99,43615,40,48,43535,43487,43506,43514,41240
5571,3,11,0,5571,937,4634,5237.45,9.72913,205.785,5571,11,10,4341,4341,4334,3095,1998
7654,23,36,7654,0,7654,0,71392800000,28.9219,397.517,7654,32,29,7533,7165,7398,7083,6020
3419,14,21,0,3419,779,2640,4514.11,10.4308,213.396,3419,16,19,3391,3389,3359,3361,3020
4618,39,40,4618,0,4618,0,85486400000,15.9121,274.053,4618,23,29,4578,4570,4578,4577,4578
17859,24,38,0,17859,17859,0,2.23843e+13,20.8128,544.421,17859,30,26,17821,17801,17809,17810,17821
11819,1,40,0,11819,0,11819,1291330,24.6092,443.934,11819,32,37,1428,1428,1428,1428,1428
13728,24,52,13712,16,13712,16,1.83542e+13,33.2997,606.294,13728,44,33,13594,13343,12422,9654,10209
29710,1,2,29710,0,29710,0,4.10228e+13,1.9995,228.69,29710,2,2,25379,25379,25379,25379,25379
24608,1,4,0,24608,24608,0,8.81979e+15,1.99972,212.188,24608,3,3,21593,21593,21593,21593,21593
759,27,28,759,0,0,759,264810000,20.585,117.315,759,22,19,729,703,726,693,642
47604,16,40,47604,0,0,47604,5.60902e+15,32.9837,855.562,47604,39,37,47260,46695,46837,8317,24606
45178,3,4,0,45178,45178,0,8.60327e+15,1.99962,285.879,45178,3,3,45174,45172,45173,45173,45174
31570,31,40,0,31570,0,31570,1328070,34.764,744.91,31570,32,31,31515,31450,31496,31496,30089
3935,1,4,0,3935,3935,0,8.93624e+15,2.00178,89.8167,3935,3,3,3444,3444,3444,3444,3444
34246,20,44,34246,0,34246,0,1.39894e+18,32.99,773.545,34246,37,37,33968,33635,33769,6300,22810
46189,12,30,7807,38382,0,46189,19.631,16.946,723.815,46189,21,27,46001,45995,45863,45913,44744
38511,1,4,0,38511,38511,0,1.07382e+16,1.99987,268.095,38511,3,3,32769,32769,32769,32769,32769
36858,6,38,0,36858,36858,0,2.20853e+13,33.243,844.289,36858,38,34,30273,26457,21376,25726,12424
12366,28,38,12366,0,0,12366,327214000,35.392,523.313,12366,36,37,12252,12032,12101,12105,10058
31553,20,23,6169,25384,0,31553,18.6396,18.7543,629.503,31553,20,22,31527,31526,31401,31403,31001
792,1,2,0,792,792,0,8.46131e+15,1.98737,37.2744,792,2,2,698,698,698,698,698
25559,7,40,0,25559,25559,0,2.18923e+13,32.3964,629.076,25559,37,37,23155,20582,18824,20036,8350
27680,1,44,0,27680,0,27680,1263740,37.1924,719.948,27680,37,37,3335,3335,3335,3335,3335
41546,9,40,41546,0,41546,0,1.4626e+18,22.3194,779.328,41546,32,29,39025,32800,33000,7783,17531
29548,5,40,29548,0,29548,0,85883700000,30.4443,790.239,29548,38,35,22480,16600,16262,19537,8126
30532,20,25,6508,24024,0,30532,18.3971,19.5684,659.468,30532,21,23,30503,30502,30402,30404,30340
45641,18,32,10028,35613,0,45641,18.6541,14.294,864.627,45641,21,25,45601,45601,45439,45439,38932
42754,26,60,42754,0,0,42754,5.50612e+15,32.9443,922.984,42754,37,44,42588,42293,42390,13473,28605
47816,1,49,47816,0,47816,0,1.10868e+18,38.3093,1163.78,47816,40,41,2964,2964,2964,2964,2964
46901,2,20,0,46901,8123,38778,5202.05,15.8801,666.55,46901,20,20,30662,30662,30043,16657,16657
29706,8,56,0,29706,29706,0,2.19082e+13,31.2144,734.254,29706,37,40,27314,23604,22528,23874,11119
4882,8,32,4882,0,0,4882,5.21807e+15,22.9742,268.609,4882,31,28,4551,4206,4166,752,1661
48469,1,2,48469,0,48469,0,3.35779e+13,1.99944,290.518,48469,2,2,42686,42686,42686,42686,42686
41627,7,44,41627,0,0,41627,313369000,38.4578,937.674,41627,40,40,36487,32182,30641,31475,11678
25341,38,40,25341,0,25341,0,1.15623e+18,33.8155,795.342,25341,37,37,25301,25280,25199,24980,25301
35874,1,40,0,35874,0,35874,1157280,34.7907,889.808,35874,39,37,3903,3903,3903,3903,3903
11142,20,24,0,11142,11142,0,2.2456e+13,19.2987,392.783,11142,20,21,11115,11090,11096,11093,10710
8402,1,2,8402,0,8402,0,3.24289e+13,1.99691,120.855,8402,2,2,7433,7433,7433,7433,7433
18847,1,40,18847,0,0,18847,5.70429e+15,19.6187,557.069,18847,30,24,1986,1986,1986,1986,1986
25405,19,25,0,25405,6478,18927,4432.12,18.6774,635.774,25405,21,23,25376,25376,25233,25235,24276
10388,12,13,0,10388,1671,8717,5183.88,10.2669,283.971,10388,12,12,10374,10374,10364,10365,10374
40504,1,2,40504,0,40504,0,5.61643e+13,1.99975,274.927,40504,2,2,32421,32421,32421,32421,32421
29760,10,21,0,29760,4766,24994,5166.21,14.3209,494.246,29760,21,20,29703,29703,29659,29667,5411
17307,1,2,17307,0,17307,0,5.32635e+13,1.99936,177.837,17307,2,2,14031,14031,14031,14031,14031
24230,9,21,3946,20284,0,24230,19.9681,17.4612,473.156,24230,20,21,24079,24079,24043,24066,23889
46730,55,60,46730,0,46730,0,1.40133e+18,32.861,1182.72,46730,50,46,46670,46662,46670,45634,44869
44352,34,56,44352,0,0,44352,338504000,35.558,874.597,44352,40,38,44290,44253,44249,44092,44240
4305,1,40,0,4305,4305,0,1.90102e+13,24.8892,313.091,4305,29,33,453,453,453,453,453
29651,7,60,29651,0,29651,0,82893400000,36.1537,787.632,29651,37,43,26523,23515,21854,22808,7572
46301,1,2,46301,0,46301,0,3.33994e+13,1.99981,284.742,46301,2,2,40806,40806,40806,40806,40806
29334,25,56,0,29334,29334,0,2.22406e+13,23.2709,702.68,29334,31,32,29277,29248,29257,29260,28453
6670,4,22,6670,0,0,6670,5.75475e+15,18.839,314.552,6670,20,20,4665,3514,3452,999,1968
42864,3,4,0,42864,42864,0,1.06362e+16,2.80461,297.944,42864,4,4,42837,42798,42829,42829,42238
31809,9,21,7138,24671,0,31809,17.396,19.3633,638.143,31809,21,20,30996,30996,30588,30759,26110
22145,9,24,22145,0,22145,0,1.46895e+18,21.454,555.062,22145,23,22,20749,17293,17183,8043,10369
46505,7,40,46505,0,46505,0,1.4487e+18,28.297,836.386,46505,39,37,41903,36980,33162,7442,14206
25951,36,56,25951,0,0,25951,338818000,21.5742,658.593,25951,30,32,25895,25879,25894,25893,23501
855,1,2,0,855,855,0,8.25923e+15,1.96959,38.843,855,2,2,756,756,756,756,756
24643,3,40,24643,0,24643,0,86808400000,21.383,583.792,24643,29,29,16461,13976,12578,13417,6256
1488,14,28,0,1488,1488,0,1.69626e+13,20.6573,164.273,1488,27,23,1350,1154,1284,1108,724
35226,38,54,0,35226,0,35226,5.23652e+14,35.4327,1047.12,35226,46,45,35168,35137,34746,28568,21448
25268,1,40,0,25268,25268,0,2.16715e+13,32.5557,630.818,25268,37,37,3116,3116,3116,3116,3116
48533,6,40,48533,0,48533,0,1.25835e+18,33.8524,1066.13,48533,40,37,39082,34578,31510,7830,10012
36688,5,56,36688,0,0,36688,5.70417e+15,21.9264,770.326,36688,32,32,29091,21672,21823,5368,11202
4934,26,40,4934,0,4934,0,1.29009e+18,23.199,330.578,4934,28,33,4882,4808,4796,3644,3977
48711,17,28,0,48711,8122,40589,5190.09,12.5119,668.207,48711,21,21,48676,48676,48676,48676,48669
24628,41,55,0,24628,24622,6,8.90999e+14,34.1452,814.819,24628,36,45,24573,24552,24566,24566,23163
3949,1,2,0,3949,3949,0,8.43014e+15,1.9962,83.1891,3949,2,2,3486,3486,3486,3486,3486
8192,2,40,8192,0,8192,0,79192700000,22.4822,397.412,8192,32,33,4807,4779,3761,3782,1179
32721,2,28,0,32721,5490,27231,5180.24,12.3222,559.843,32721,21,21,21801,21801,21487,13945,9856
8373,5,23,0,8373,1609,6764,4925.18,10.9103,327.733,8373,16,21,7636,7636,6991,6986,6471
43981,39,56,43981,0,0,43981,333275000,34.3897,994.736,43981,38,51,43924,43884,43883,43859,37859
46559,10,60,0,46559,46559,0,2.15214e+13,37.1081,943.868,46559,38,44,44656,42960,39824,39682,15263
37963,14,32,0,37963,8821,29142,4647.75,14.8224,806.913,37963,21,25,37846,37836,37639,37653,31077
19484,21,40,19484,0,0,19484,4.68904e+15,33.7534,674.883,19484,37,37,19121,18250,18633,6217,12647
40477,3,5,40477,0,40477,0,6.37816e+13,1.99973,283.67,40477,3,4,40472,40470,40471,40472,40472
29695,30,44,29695,0,29695,0,1.20039e+18,32.7382,862.364,29695,38,37,29603,29329,29191,20433,25828
6223,1,2,6223,0,6223,0,3.36522e+13,1.99823,103.512,6223,2,2,5478,5478,5478,5478,5478
9237,7,36,9237,0,9237,0,74464700000,26.737,429.537,9237,34,29,7914,6988,6944,6645,3504
3904,2,38,3904,0,3904,0,82915800000,29.4001,278.057,3904,29,30,2003,2003,1187,1766,601
22468,1,4,0,22468,22468,0,8.78751e+15,1.99973,203.251,22468,3,3,19725,19725,19725,19725,19725
27261,20,24,27261,0,27261,0,1.465e+18,20.8588,605.046,27261,23,22,27226,27189,27165,24373,26779
2786,31,32,2786,0,2786,0,1.4097e+18,14.3453,182.11,2786,23,21,2754,2745,2754,2498,2754
43599,23,40,43599,0,0,43599,5.65886e+15,28.6147,814.075,43599,39,37,43495,43355,43416,11299,33896
41585,7,40,41585,0,41585,0,1.44729e+18,29.6114,798.817,41585,38,37,37416,32995,29733,5954,15219
1498,3,28,1498,0,0,1498,218485000,21.8057,178.367,1498,25,22,698,597,609,564,171
44707,34,44,44707,0,44707,0,1.36041e+18,34.2862,954.186,44707,40,41,44640,44487,44380,39025,41039
16760,4,24,16760,0,16760,0,87583500000,20.3916,480.616,16760,22,21,12111,9182,8834,10528,4303
2266,17,18,2266,0,0,2266,5.76415e+15,15.2048,165.183,2266,15,17,2247,2227,2246,2112,2247
45565,37,40,45565,0,45565,0,87012400000,26.0352,818.742,45565,33,29,45522,45494,45518,45515,44400
7534,1,2,0,7534,7534,0,1.34666e+16,1.99801,116.651,7534,2,2,6125,6125,6125,6125,6125
6975,1,2,6975,0,6975,0,3.753e+13,1.99713,110.744,6975,2,2,6044,6044,6044,6044,6044
26885,20,56,0,26885,0,26885,1325860,22.7971,674.473,26885,32,32,26801,26679,26684,26698,22020
21722,1,2,21722,0,21722,0,3.43777e+13,1.99954,194.952,21722,2,2,19068,19068,19068,19068,19068
43452,8,40,43452,0,43452,0,8.7365e+10,28.031,842.474,43452,33,30,39110,32340,29485,32768,17731
49930,11,40,49930,0,49930,0,1.46121e+18,33.8452,984.748,49930,39,38,47659,44823,40051,6197,16470
4738,23,24,0,4738,4738,0,2.23523e+13,17.5095,256.281,4738,18,20,4714,4704,4713,4713,4714
7844,23,38,7844,0,0,7844,335159000,29.3821,388.554,7844,30,29,7791,7754,7767,7762,7791
13827,31,40,13827,0,13827,0,86468400000,18.5978,438.938,13827,24,29,13787,13772,13784,13775,13785
11881,18,19,0,11881,2180,9701,5151.46,18.0386,360.625,11881,19,19,11858,11858,11857,11858,10817
27261,1,2,27261,0,27261,0,3.2545e+13,1.99934,218.544,27261,2,2,24108,24108,24108,24108,24108
41988,5,44,0,41988,41988,0,2.15408e+13,32.8301,856.459,41988,37,38,34166,26140,27200,29558,9836
2220,1,10,0,2220,360,1860,5222.86,7.87477,122.725,2220,9,9,380,380,380,380,380
45208,1,4,0,45208,45208,0,8.36804e+15,3.54032,288.602,45208,4,4,39953,39953,39953,39953,39953
17618,34,40,0,17618,0,17618,1329330,19.3464,541.643,17618,30,24,17578,17568,17578,17578,17443
24629,8,19,0,24629,4468,20161,5149.89,17.7417,512.631,24629,19,19,24223,24219,22968,22963,22951
3849,23,36,3849,0,0,3849,4.29504e+15,28.2832,311.838,3849,29,33,3781,3632,3706,3315,2929
40845,28,40,40845,0,0,40845,340613000,31.6829,836.898,40845,32,31,40784,40719,40756,40756,39323
9944,17,19,1809,8135,0,9944,20.2357,11.5536,318.494,9944,19,19,9923,9923,9923,9923,9923
38012,12,40,38012,0,0,38012,311811000,32.4662,876.561,38012,40,37,36118,33594,34121,34116,15981
30874,2,4,0,30874,30874,0,8.39746e+15,1.99981,237.492,30874,3,3,30869,30868,30869,30869,29791
3380,2,18,3380,0,3380,0,88120500000,15.9769,213.382,3380,17,18,1802,1802,1173,1478,615
23139,1,2,0,23139,23139,0,8.85967e+15,1.99957,200.353,23139,2,2,20293,20293,20293,20293,20293
20395,25,40,20395,0,20395,0,8.5869e+10,26.9276,662.128,20395,36,35,20273,20059,20131,20082,16829
19457,26,30,3624,15833,0,19457,19.4486,14.3574,518.665,19457,19,25,19427,19427,19427,19427,19119
11158,8,19,0,11158,2031,9127,5159.92,11.6317,337.474,11158,19,19,10974,10973,10439,10437,10504
25870,7,24,0,25870,0,25870,1333390,21.9272,619.461,25870,24,22,22710,19518,16767,17300,9948
13114,1,2,13114,0,13114,0,5.1749e+13,1.99878,156.046,13114,2,2,10702,10702,10702,10702,10702
8798,13,19,0,8798,1589,7209,5180.29,11.254,300.909,8798,19,15,8773,8773,8773,8773,8773
36035,39,48,0,36035,36035,0,1.95074e+13,37.2944,979.947,36035,37,41,35986,35941,35734,35783,33352
25086,1,2,25086,0,25086,0,3.96305e+13,1.99944,209.408,25086,2,2,21553,21553,21553,21553,21553
25908,47,56,25908,0,0,25908,331167000,31.9946,806.869,25908,38,50,25852,25844,25843,25794,25771
12167,21,24,0,12167,0,12167,1338710,20.6718,417.276,12167,21,21,12140,12100,12137,12136,11537
11962,1,36,11962,0,0,11962,5.61576e+15,22.7223,393.586,11962,27,25,1506,1506,1506,1506,1506
33114,26,40,33114,0,33114,0,1.33268e+18,30.4202,828.156,33114,40,35,32953,32512,32678,10575,21091
45495,51,56,0,45495,45495,0,2.22294e+13,34.9447,855.255,45495,40,32,45439,45412,45435,45434,45439
41695,1,44,41695,0,0,41695,324447000,32.507,849.973,41695,37,37,5145,5145,5145,5145,5145
31219,9,40,0,31219,31219,0,2.02143e+13,33.3791,806.8,31219,40,37,28397,24653,25783,24888,8886
26325,12,65,26324,1,0,26325,1.396e+15,33.3634,1067.15,26325,38,58,22561,17052,18373,18088,7977
8129,30,40,0,8129,0,8129,1138450,27.8742,443.981,8129,32,37,8083,8033,7997,7999,7193
32956,41,65,32955,1,32955,1,2.60536e+12,36.5645,1096.1,32956,40,52,32891,32885,32474,31756,11992
1720,19,22,1720,0,0,1720,5.65634e+15,19.2581,165.103,1720,18,20,1693,1670,1685,1556,1691
20538,13,24,20538,0,0,20538,342168000,20.7118,540.445,20538,24,22,20171,18961,18226,18572,14098
35747,2,4,0,35747,35747,0,9.38138e+15,1.99989,255.78,35747,3,3,35742,35741,35742,35742,32790
42672,3,40,0,42672,42672,0,2.23074e+13,31.3031,855.792,42672,32,31,26867,22592,19732,22566,8863
31420,15,40,31420,0,0,31420,5.69042e+15,35.8425,774.813,31420,32,38,30986,30331,28018,24413,15197
14277,19,44,14277,0,0,14277,5.05902e+15,26.2317,612.29,14277,33,41,14016,13385,13629,9368,9622
9011,2,22,9011,0,0,9011,5.71509e+15,20.0535,377.141,9011,22,22,4727,4727,3042,947,1371
28287,23,28,0,28287,4731,23556,5179.59,11.6546,521.053,28287,20,21,28259,28259,28259,28259,28251
27711,43,56,0,27711,27711,0,2.19701e+13,26.8656,767.737,27711,36,41,27655,27643,27655,27655,27653
40264,8,40,0,40264,40264,0,2.20159e+13,33.6013,781.328,40264,37,37,37290,32434,31442,32707,12646
38651,13,23,11892,26759,0,38651,15.5259,19.132,751.727,38651,22,21,38388,38388,38016,38047,35350
21648,2,56,0,21648,21648,0,2.15035e+13,32.5081,748.735,21648,38,50,11868,11850,7915,9862,3260
33585,5,28,5705,27880,0,33585,20.118,13.2661,594.613,33585,20,25,31262,31262,28096,27852,25821
21316,1,4,0,21316,21316,0,8.72831e+15,2.00023,198.72,21316,3,3,18731,18731,18731,18731,18731
7324,26,40,7324,0,0,7324,4.44334e+15,28.5998,460.255,7324,29,37,7266,7175,7228,7108,5313
42873,34,44,0,42873,42873,0,2.06438e+13,33.9517,941.354,42873,38,41,42808,42673,42536,42528,41005
12520,25,40,12520,0,12520,0,84310400000,25.6052,445.31,12520,34,36,12448,12377,12388,12286,9034
25778,31,40,25778,0,0,25778,337854000,28.1453,602.002,25778,30,29,25729,25689,25722,23078,25693
47519,14,64,0,47519,0,47519,1186080,30.9526,1196.99,47519,36,44,44671,38751,39977,40856,21456
23837,15,21,3834,20003,0,23837,19.7355,16.2269,468.17,23837,20,20,23788,23788,23754,23755,23627
1929,22,32,1929,0,1929,0,1.27769e+18,23.7045,178.067,1929,25,27,1877,1812,1849,807,1714
39667,18,20,6712,32955,0,39667,20.3199,12.5964,597.783,39667,20,19,39645,39645,39645,39645,39645
2238,2,17,0,2238,623,1615,3861.28,12.7377,161.451,2238,16,15,1465,1465,1464,1439,804
5560,1,2,0,5560,5560,0,8.41104e+15,1.9982,98.4855,5560,2,2,4910,4910,4910,4910,4910
26615,10,40,0,26615,0,26615,1330590,22.9989,653.155,26615,31,28,25393,24327,21273,21447,12706
28718,37,40,28718,0,28718,0,1.24053e+18,34.7996,804.964,28718,38,37,28673,28632,28510,26776,28665
15052,48,56,0,15052,0,15052,1306420,23.9929,570.89,15052,31,36,14996,14986,14996,14996,14183
19282,1,4,0,19282,19282,0,8.32239e+15,1.9999,188.935,19282,3,3,17052,17052,17052,17052,17052
49318,21,33,0,49318,14878,34440,1.46104e+12,21.1949,1031.63,49318,23,32,49281,49281,48972,47846,29486
37276,54,60,0,37276,37276,0,2.06271e+13,29.6064,976.52,37276,38,44,37216,37206,37210,37216,33660
29799,1,2,29799,0,29799,0,3.71219e+13,1.99963,229.389,29799,2,2,25868,25868,25868,25868,25868
26441,34,40,26441,0,26441,0,77728200000,32.659,735.096,26441,39,35,26389,26289,26234,26260,24493
18928,18,19,3434,15494,0,18928,20.1858,14.0254,441.554,18928,19,19,18906,18906,18906,18906,18906
24182,36,38,24182,0,0,24182,340376000,28.2317,647.441,24182,31,30,24142,24100,24139,24140,24142
6627,29,36,6627,0,6627,0,1.44033e+18,17.1891,292.529,6627,25,25,6591,6577,6591,5449,6591
39753,2,28,0,39753,6630,33123,5139.35,15.7319,637.992,39753,20,27,26761,26761,26444,17598,15751
17819,31,44,0,17819,17819,0,1.91629e+13,35.0835,666.585,17819,37,41,17749,17572,17448,17242,12501
11285,14,24,0,11285,0,11285,1329750,21.5537,391.179,11285,21,21,11195,11099,9752,10008,7309
45398,1,2,45398,0,45398,0,5.34206e+13,1.99969,290.146,45398,2,2,36781,36781,36781,36781,36781
45215,25,48,45215,0,0,45215,295322000,34.8216,1081.38,45215,38,41,44946,44331,44340,32972,31247
4496,14,18,4496,0,0,4496,5.76823e+15,16.7186,243.957,4496,18,18,4444,4394,4290,3880,4127
25490,15,21,7256,18234,0,25490,15.9179,17.5499,598.845,25490,20,20,25413,25413,25198,25203,24739
22252,11,48,22252,0,0,22252,4.85986e+15,26.8497,807.604,22252,33,41,19338,15878,16903,10447,9065
34154,2,60,0,34154,34154,0,2.2246e+13,22.3758,791.367,34154,32,40,18707,18700,12514,15399,5377
28167,1,2,28167,0,28167,0,3.76739e+13,1.9995,221.834,28167,2,2,24396,24396,24396,24396,24396
31130,16,64,0,31130,0,31130,1087300,35.4048,1002.24,31130,37,44,29221,22202,26940,26873,11186
2863,1,2,0,2863,2863,0,8.35596e+15,1.99511,70.4021,2863,2,2,2530,2530,2530,2530,2530
20086,1,2,20086,0,20086,0,3.25393e+13,1.99876,187.842,20086,2,2,17763,17763,17763,17763,17763
3364,10,17,1242,2122,0,3364,13.7848,15.0086,206.799,3364,16,16,3246,3235,3129,3141,2762
42249,34,40,0,42249,0,42249,1332690,22.5144,801.299,42249,32,28,42209,42193,42205,42205,42209
28343,32,54,28337,6,28337,6,3.01712e+12,37.0551,927.115,28343,44,45,28265,28206,27761,23664,10635
39735,19,60,39735,0,0,39735,315809000,30.6899,998.863,39735,38,44,39202,38131,38615,32689,26029
31157,49,65,31157,0,0,31157,5.74315e+15,28.4782,1067.56,31157,37,48,31092,31085,31045,24951,22809
8031,25,38,8031,0,8031,0,85182700000,34.7459,400.095,8031,32,30,7967,7907,7935,7938,7967
33623,25,30,0,33623,6569,27054,4919.97,13.9417,699.28,33623,20,24,33593,33593,33593,33593,32380
31468,1,2,31468,0,31468,0,3.25591e+13,1.9994,235.464,31468,2,2,27827,27827,27827,27827,27827
27553,1,40,27553,0,27553,0,86509800000,27.8572,620.084,27553,30,29,3272,3272,3272,3272,3272
1597,11,18,1597,0,0,1597,5.75781e+15,13.0344,136.312,1597,15,15,1552,1497,1416,1295,1454
39206,11,40,39206,0,0,39206,329939000,36.7495,802.636,39206,37,37,38039,36531,35335,35324,14500
24865,35,38,24865,0,0,24865,340235000,28.2767,656.78,24865,31,30,24824,24783,24821,24820,24824
31493,25,64,0,31493,31493,0,1.80934e+13,35.9652,969.005,31493,37,44,31219,30619,30568,29784,11697
49158,5,40,49158,0,49158,0,1.08457e+18,35.6655,1156.22,49158,40,37,28840,21816,23231,10607,7886
21086,22,44,21086,0,21086,0,1.33359e+18,30.5745,709.787,21086,36,41,20889,20489,20700,14348,14371
15186,25,40,15186,0,15186,0,87121200000,20.0718,509.721,15186,30,24,15146,15132,15137,15141,15061
43346,25,44,0,43346,43346,0,2.15676e+13,32.3912,868.378,43346,37,38,43178,42906,42920,42442,30850
14489,1,2,14489,0,14489,0,5.48224e+13,1.99827,163.739,14489,2,2,11666,11666,11666,11666,11666
35965,32,44,35965,0,0,35965,5.52309e+15,29.9437,785.24,35965,37,37,35903,35819,35779,21995,34297
26033,10,44,26033,0,26033,0,1.39953e+18,26.9784,685.358,26033,34,37,24905,23903,22485,8082,10888
48698,41,64,48698,0,48698,0,7.452e+10,36.8448,1171.53,48698,40,44,48634,48622,48155,48224,23798
27958,12,40,27958,0,0,27958,5.70807e+15,22.0339,630.484,27958,30,29,27380,26117,24192,5966,16420
7669,29,40,0,7669,0,7669,1285490,19.5972,373.928,7669,29,36,7623,7592,7584,7586,6981
17093,24,40,0,17093,17093,0,2.21866e+13,21.5675,495.911,17093,29,29,17052,17033,17044,17036,17051
42667,1,2,0,42667,42667,0,8.43912e+15,1.99981,272.473,42667,2,2,37669,37669,37669,37669,37669
37353,8,49,37353,0,37353,0,1.12138e+18,36.1747,1033.46,37353,40,41,26799,20101,21519,7489,9572
30783,9,40,0,30783,0,30783,1317890,25.8852,789.479,30783,36,36,28323,23169,22617,22650,12881
45231,6,40,0,45231,45231,0,2.23379e+13,31.3293,856.209,45231,32,31,38241,34039,27086,33020,15138
3073,18,32,0,3073,3073,0,2.14621e+13,14.1992,188.61,3073,23,21,3041,3026,3033,3005,3039
3216,14,22,0,3216,0,3216,1342920,17.1962,217.701,3216,18,19,3158,3102,2874,2997,2851
34669,38,44,34669,0,0,34669,326305000,35.1979,791.219,34669,37,38,34623,34582,34463,29691,30300
27396,1,2,0,27396,27396,0,1.08655e+16,1.99927,221.098,27396,2,2,23264,23264,23264,23264,23264
39729,1,38,0,39729,0,39729,1321550,31.3226,855.602,39729,35,33,3822,3822,3822,3822,3822
29098,43,48,29098,0,29098,0,74739400000,34.5976,893.787,29098,37,41,29050,29033,28810,28857,28351
1203,1,2,1203,0,1203,0,3.29908e+13,1.99086,45.8318,1203,2,2,1061,1061,1061,1061,1061
47586,46,56,47586,0,0,47586,334990000,31.9794,1037.71,47586,38,52,47530,47520,47521,47456,46541
5808,9,65,0,5808,0,5808,3.176e+15,23.1734,493.529,5808,29,47,4276,2890,3043,2735,1274
9057,1,21,0,9057,1454,7603,5146.46,9.74484,279.189,9057,18,20,1627,1627,1627,1627,1627
38847,25,40,0,38847,0,38847,1331620,22.5524,772.179,38847,32,28,38807,38785,38793,38792,38807
43670,35,44,0,43670,43670,0,2.07673e+13,33.7987,949.854,43670,40,41,43612,43471,43352,43355,40543
16370,6,20,2837,13533,0,16370,20.2744,10.9221,400.006,16370,19,15,15776,15776,15109,14918,14150
39540,1,2,0,39540,39540,0,8.64181e+15,1.99954,261.882,39540,2,2,34797,34797,34797,34797,34797
24911,22,60,24911,0,24911,0,8.4638e+10,23.4451,750.67,24911,32,40,24784,24578,24660,24559,21469
21213,1,2,0,21213,21213,0,8.35967e+15,1.99953,192.373,21213,2,2,18751,18751,18751,18751,18751
36680,33,60,36680,0,0,36680,335495000,34.5573,858.019,36680,40,40,36616,36595,36551,36406,34480
38072,10,19,0,38072,6855,31217,5164.76,16.2161,634.541,38072,19,19,37879,37879,37755,37754,37649
7798,4,36,7798,0,0,7798,319761000,27.4178,342.409,7798,30,32,6043,4855,4881,5206,2143
34029,22,23,0,34029,6216,27813,4825.19,20.012,623.201,34029,22,21,34005,34005,33979,33980,34005
37319,59,60,37319,0,0,37319,5.5786e+15,25.5594,886.318,37319,32,40,37259,37248,37258,37259,36759
40658,1,2,40658,0,40658,0,3.2815e+13,1.9997,266.13,40658,2,2,35917,35917,35917,35917,35917
33142,1,2,33142,0,33142,0,5.37097e+13,1.99964,249.059,33142,2,2,26817,26817,26817,26817,26817
13155,16,64,13155,0,13155,0,73366100000,26.4542,704.696,13155,30,44,12322,8966,11032,10775,5200
42333,32,44,42333,0,0,42333,4.73238e+15,38.303,1025.59,42333,39,39,42245,42107,41709,25732,35430
46503,20,40,46503,0,0,46503,5.72027e+15,30.8719,871.587,46503,32,31,46395,46147,46216,38442,39335
31274,17,40,31274,0,0,31274,5.63098e+15,29.7988,687.775,31274,37,37,31097,30735,30988,9417,22790
31902,19,40,31902,0,31902,0,1.46737e+18,21.7617,710.761,31902,31,29,31819,31679,31566,13730,28830
19118,4,40,0,19118,19118,0,2.18706e+13,23.2571,542.992,19118,33,37,14344,11145,10877,12248,5207
49631,37,56,49631,0,49631,0,86871700000,34.6798,892.17,49631,40,32,49571,49527,49557,49555,49570
31333,11,13,5216,26117,0,31333,20.3343,11.6966,507.455,31333,13,13,31305,31305,31294,31295,31298
4633,27,40,4633,0,4633,0,63583700000,29.7019,356.563,4633,28,33,4585,4526,4505,4406,2796
2665,3,13,0,2665,412,2253,5130.76,8.11332,146.023,2665,10,10,2146,2146,2133,1611,814
8427,1,2,8427,0,8427,0,3.74098e+13,1.99893,120.837,8427,2,2,7306,7306,7306,7306,7306
18071,1,2,0,18071,18071,0,1.4949e+16,1.99928,184.608,18071,2,2,14321,14321,14321,14321,14321
48900,1,2,0,48900,48900,0,1.56081e+16,1.99957,304.776,48900,2,2,38307,38307,38307,38307,38307
44368,6,40,44368,0,44368,0,87095500000,35.3556,866.75,44368,33,31,37282,33046,26492,32105,15382
18382,25,40,0,18382,18382,0,2.21943e+13,21.6478,511.67,18382,29,29,18342,18322,18334,18325,18340
40177,7,40,40177,0,0,40177,341193000,22.5033,784.416,40177,32,28,35484,30670,26575,27653,12642
1893,1,2,1893,0,1893,0,3.2415e+13,1.98996,57.9046,1893,2,2,1674,1674,1674,1674,1674
39113,26,44,0,39113,0,39113,1075200,37.0344,996.88,39113,39,39,38851,38035,38178,38204,28526
16547,18,24,16547,0,0,16547,340659000,18.9115,459.574,16547,21,21,16513,16465,16413,16410,15150
10345,29,36,0,10345,10345,0,2.1455e+13,24.9993,387.575,10345,32,33,10294,10240,10255,10251,10237
26905,4,24,26905,0,26905,0,1.46717e+18,21.5847,608.066,26905,24,22,19531,14849,14331,3128,7074
42210,6,40,42210,0,42210,0,1.45738e+18,36.4681,880.464,42210,34,35,34884,30588,24674,5045,13189
2453,13,18,0,2453,0,2453,1348760,14.6731,174.413,2453,16,17,2410,2271,2326,2325,2251
23451,2,60,23451,0,23451,0,1.3644e+18,26.6277,817.651,23451,41,44,12368,12308,8840,2265,3077
44856,20,40,44856,0,0,44856,5.61331e+15,32.7127,830.852,44856,38,37,44666,44486,44531,7425,29356
40367,7,40,40367,0,40367,0,76514200000,35.0491,936.475,40367,40,37,34484,30193,29451,28987,12235
40290,1,2,0,40290,40290,0,1.14713e+16,1.99958,268.857,40290,2,2,33875,33875,33875,33875,33875
38400,14,40,0,38400,0,38400,1330200,32.3963,796.33,38400,32,31,37872,37278,33870,33930,24800
36557,17,31,11445,25112,6,36551,7699380000,18.0243,796.413,36557,27,24,36504,36502,36294,36190,20064
42490,3,60,0,42490,42490,0,2.16538e+13,32.4264,938.777,42490,36,42,28053,23904,21615,22324,8510
6052,5,44,0,6052,6052,0,1.96706e+13,25.4554,384.154,6052,30,37,4721,3732,4058,3961,1291
6316,43,56,6316,0,0,6316,5.5557e+15,17.6484,342.88,6316,25,27,6260,6252,6260,6260,5967
38782,23,40,38782,0,0,38782,5.72687e+15,22.7267,775.163,38782,32,28,38738,38688,38716,34950,38494
33748,1,40,33748,0,0,33748,5.04049e+15,36.392,842.217,33748,38,37,3848,3848,3848,3848,3848
15846,22,40,0,15846,15846,0,2.22656e+13,21.3352,509.635,15846,27,28,15803,15772,15782,15783,14809
23219,7,40,0,23219,0,23219,963698,33.889,784.303,23219,36,34,14774,10590,11381,10966,5780
15613,34,40,0,15613,15613,0,1.60671e+13,29.5656,633.646,15613,34,33,15573,15552,15453,15490,15300
32021,5,20,0,32021,5667,26354,5138,14.3252,611.962,32021,19,20,29363,29361,26002,24900,19787
11336,1,2,11336,0,11336,0,3.27758e+13,1.99841,141.199,11336,2,2,10015,10015,10015,10015,10015
44986,36,40,0,44986,44986,0,2.22509e+13,25.9838,806.678,44986,33,29,44942,44915,44938,44933,42955
15829,728,2527,5369,10460,845,14984,3.19265e+12,119.638,3997.05,15829,660,172,13302,13160,11565,11725,6310
4228,6,20,4228,0,0,4228,339830000,15.8581,218.924,4228,16,17,3734,3424,2670,3003,2023
833,4,16,0,833,0,833,1298450,10.6819,86.725,833,12,13,653,513,516,573,328
24277,5,44,0,24277,0,24277,1268620,27.2267,665.63,24277,34,37,19731,15182,15947,16112,7262
5627,5,21,0,5627,1036,4591,4758.41,15.1057,250.214,5627,18,19,5204,5204,4912,4924,4706
26769,9,21,0,26769,4373,22396,5182.58,12.529,476.341,26769,21,19,26663,26663,26495,26497,19021
30760,632,1358,30755,5,30760,0,3.2218e+18,234.434,3524.27,30760,244,172,29402,29241,28291,28089,19320
11505,3,40,0,11505,11505,0,1.61919e+13,29.9105,543.255,11505,34,33,6006,5167,5135,4358,1504
15263,20,36,0,15263,15263,0,2.17891e+13,24.4258,476.62,15263,36,28,15171,15095,15124,14988,10565
12199,15,19,0,12199,1919,10280,5025.31,13.8785,324.922,12199,19,19,12164,12164,12150,12150,12083
46495,3,56,46495,0,0,46495,5.65638e+15,28.0938,892.644,46495,38,40,30777,26130,23437,5848,9307
28017,25,38,28017,0,28017,0,1.45385e+18,33.4184,718.529,28017,33,32,27939,27851,27889,20070,27930
32583,25,30,5498,27085,0,32583,19.3349,19.2607,610.988,32583,21,27,32553,32553,32553,32553,32045
11416,11,24,11416,0,11416,0,1.46448e+18,21.5413,398.463,11416,20,22,11064,10565,9707,6343,7714
7732,2,36,7732,0,7732,0,1.35348e+18,30.3991,354.907,7732,33,32,4703,4679,3686,1072,1326
38653,41,54,0,38653,0,38653,4.77225e+14,34.284,1093.84,38653,46,45,38599,38591,38169,31541,27314
19551,1,2,0,19551,19551,0,9.13297e+15,1.9979,184.385,19551,2,2,17072,17072,17072,17072,17072
25430,1,2,25430,0,25430,0,3.26746e+13,1.9998,210.873,25430,2,2,22477,22477,22477,22477,22477
20289,35,56,20289,0,20289,0,86163500000,23.2101,637.598,20289,31,39,20233,20221,20192,20176,19497
34922,37,40,0,34922,0,34922,1308360,34.3504,723.761,34922,37,37,34877,34824,34845,34846,34873
3838,17,21,674,3164,0,3838,20.4283,9.821,190.919,3838,11,20,3817,3817,3817,3817,3811
822,4,22,822,0,822,0,1.45833e+18,15.7543,115.886,822,16,16,571,431,417,162,187
18399,19,40,18399,0,18399,0,1.26321e+18,33.097,643.662,18399,37,37,18002,17121,17525,7240,9658
40567,5,40,0,40567,40567,0,2.22915e+13,22.472,787.202,40567,32,29,32159,23952,24125,28173,8456
43694,3,20,0,43694,7718,35976,5153.07,17.7176,703.54,43694,20,20,33342,33340,32344,19201,18384
5211,6,22,5211,0,5211,0,1.47489e+18,19.1625,278.817,5211,20,20,4315,3787,3117,1464,2035
15096,8,24,15096,0,0,15096,340994000,22.3609,456.786,15096,22,21,13835,11736,10653,11651,6135
9234,15,36,0,9234,9234,0,1.97364e+13,24.3537,420.874,9234,33,29,8867,8159,8645,8271,4345
47475,7,56,0,47475,47475,0,2.21592e+13,23.1054,899.213,47475,36,40,42276,36896,32623,36167,17479
13200,2,12,2330,10870,0,13200,20.3558,11.3464,343.331,13200,12,12,8538,8538,8368,4414,4414
832,1,2,832,0,832,0,3.38311e+13,1.98438,38.0912,832,2,2,731,731,731,731,731
32609,1,2,32609,0,32609,0,3.24297e+13,1.99972,239.441,32609,2,2,28851,28851,28851,28851,28851
515,8,15,84,431,0,515,18.0194,6.62524,62.9151,515,15,14,493,493,489,493,490
16468,34,40,0,16468,0,16468,1324630,18.7599,476.193,16468,28,29,16428,16415,16428,16425,16428
3981,1,2,0,3981,3981,0,8.72438e+15,1.99372,82.6766,3981,2,2,3498,3498,3498,3498,3498
8719,17,19,0,8719,1333,7386,5112.13,10.2811,256.28,8719,19,18,8698,8698,8698,8698,8695
27618,18,24,27618,0,0,27618,341950000,21.4761,622.3,27618,24,22,27561,27484,27270,27268,23734
23985,3,40,23985,0,0,23985,338174000,20.8806,574.001,23985,29,29,16133,13719,12372,8689,5120
27570,18,40,0,27570,27570,0,2.1862e+13,30.5908,638.578,27570,35,37,27417,27254,27317,27122,20549
41475,1,2,41475,0,41475,0,3.68581e+13,1.99983,269.882,41475,2,2,36043,36043,36043,36043,36043
10578,1,2,10578,0,10578,0,3.24636e+13,1.99905,136.04,10578,2,2,9357,9357,9357,9357,9357
44540,30,40,44540,0,0,44540,5.68787e+15,27.0666,803.435,44540,34,29,44484,44424,44471,35334,36979
31975,1,2,31975,0,31975,0,4.36451e+13,1.99978,240.284,31975,2,2,27016,27016,27016,27016,27016
35608,1,2,35608,0,35608,0,4.38876e+13,1.99963,252.325,35608,2,2,30055,30055,30055,30055,30055
42827,27,65,42826,1,42826,1,2.0245e+12,40.4884,1216.69,42827,41,48,42611,41939,42005,31993,18269
28823,1,2,0,28823,28823,0,9.86501e+15,1.99944,224.224,28823,2,2,24876,24876,24876,24876,24876
25829,5,40,25829,0,0,25829,296210000,34.5274,743.786,25829,37,37,20151,15922,17354,17345,5983
47620,39,40,0,47620,0,47620,1181720,33.339,1019.8,47620,40,37,47578,47532,47510,47510,46853
27845,25,40,0,27845,27845,0,1.99854e+13,32.3514,757.178,27845,39,35,27657,27245,27353,26940,18921
23258,5,40,23258,0,0,23258,340579000,22.0304,613.536,23258,32,24,18228,13515,13639,11668,7538
22315,16,24,22315,0,22315,0,1.4699e+18,21.4823,558.815,22315,23,22,22190,21851,21313,18148,17863
27095,36,56,27095,0,0,27095,5.69453e+15,21.4651,675.323,27095,31,32,27039,27025,27037,25727,26387
36182,35,40,36182,0,0,36182,4.80186e+15,36.3004,920.081,36182,38,37,36127,35983,35887,32920,35159
24421,1,40,24421,0,0,24421,4.5669e+15,33.81,771.693,24421,37,37,2188,2188,2188,2188,2188
37075,18,40,37075,0,37075,0,1.44573e+18,29.551,753.104,37075,38,37,36922,36747,36744,6964,26913
13061,4,21,2338,10723,0,13061,18.616,14.6653,367.736,13061,18,19,11759,11759,10933,10939,11011
42093,14,40,42093,0,42093,0,1.46707e+18,27.6771,828.785,42093,32,31,41511,40849,37351,18670,28208
6553,21,36,0,6553,6553,0,1.71989e+13,29.3594,395.801,6553,32,33,6405,6014,6199,5919,4809
18678,34,40,18678,0,0,18678,294247000,35.8256,648.317,18678,36,37,18628,18557,18441,17006,17439
5480,14,22,5480,0,5480,0,87871300000,19.2496,286.111,5480,20,20,5380,5272,4834,5079,4608
25695,1,2,0,25695,25695,0,8.81405e+15,1.99938,211.159,25695,2,2,22551,22551,22551,22551,22551
10170,1,2,0,10170,10170,0,8.8283e+15,1.99666,132.104,10170,2,2,8923,8923,8923,8923,8923
3671,1,11,0,3671,583,3088,5202.57,8.81803,159.245,3671,10,10,639,639,639,639,639
13869,23,24,0,13869,0,13869,1332550,21.9742,435.482,13869,20,22,13844,13822,13833,13832,13844
32697,9,44,0,32697,0,32697,1276330,34.469,775.859,32697,37,37,30635,26578,27562,27426,14349
14840,20,40,0,14840,14840,0,1.85853e+13,33.7452,585.562,14840,34,37,14518,13926,14079,13287,10498
18503,2,21,0,18503,2920,15583,5155.97,10.5502,384.011,18503,19,20,12723,12723,12683,9413,7474
45212,1,8,45212,0,45212,0,7.45026e+13,2.00013,307.843,45212,5,7,34768,34768,34768,34768,34768
7064,1,2,0,7064,7064,0,8.38496e+15,1.99915,111.452,7064,2,2,6241,6241,6241,6241,6241
35211,6,20,6360,28851,0,35211,20.0154,17.1951,646.37,35211,19,20,33529,33529,31183,29587,12300
29807,35,56,29807,0,29807,0,85578300000,31.1335,733.919,29807,37,40,29742,29676,29690,29662,23239
10036,3,21,0,10036,1647,8389,5015.01,13.9428,316.722,10036,18,20,8056,8056,8016,7333,6103
37605,1,40,37605,0,37605,0,1.43038e+18,34.6567,755.543,37605,37,37,4607,4607,4607,4607,4607
36078,9,48,0,36078,0,36078,1114430,33.3731,989.039,36078,37,41,30258,24591,26611,26318,9111
12322,4,40,12322,0,12322,0,1.22848e+18,32.805,537.299,12322,34,37,8591,7013,7092,1914,2393
30501,9,21,0,30501,5291,25210,4898.92,15.2006,564.853,30501,20,19,30122,30122,29996,30087,7583
20266,17,40,0,20266,20266,0,2.22281e+13,21.3153,535.655,20266,29,29,20186,19969,20094,20057,17273
46528,1,2,46528,0,46528,0,3.25952e+13,1.99944,285.859,46528,2,2,41139,41139,41139,41139,41139
11615,1,4,0,11615,11615,0,8.35037e+15,2.0006,148.361,11615,3,3,10266,10266,10266,10266,10266
16510,1,2,16510,0,16510,0,3.4984e+13,1.99903,168.797,16510,2,2,14457,14457,14457,14457,14457
37920,1,2,37920,0,37920,0,4.40918e+13,1.9996,260.36,37920,2,2,31979,31979,31979,31979,31979
7672,2,12,0,7672,1328,6344,5239.19,9.73162,250.929,7672,11,11,5009,5009,4962,3163,1760
46979,31,66,46979,0,46979,0,1.2923e+18,37.7886,1385.31,46979,50,50,46837,46539,46527,29736,21402
1761,15,18,0,1761,1761,0,2.24498e+13,16.2981,147.93,1761,15,17,1739,1721,1724,1726,1738
43344,17,40,43344,0,0,43344,340621000,31.8829,858.536,43344,33,30,43041,41974,41738,41423,31970
12132,1,2,0,12132,12132,0,9.61599e+15,1.99876,144.729,12132,2,2,10512,10512,10512,10512,10512
2153,13,16,0,2153,2153,0,2.16368e+13,13.294,142.709,2153,14,14,2130,2103,2114,2115,2106
4901,20,36,4901,0,4901,0,64302700000,29.1157,341.052,4901,31,29,4759,4495,4520,4200,3350
14603,7,23,0,14603,2593,12010,4798.28,17.2866,405.886,14603,20,21,14125,14125,14025,14081,13246
9132,16,20,0,9132,0,9132,1331450,17.8122,330.601,9132,20,19,9094,9030,9019,9018,8426
5182,18,22,0,5182,0,5182,1339550,16.3686,267.217,5182,19,19,5158,5148,5142,5140,5157
35566,23,40,35566,0,35566,0,87097300000,32.9902,786.194,35566,32,30,35495,35434,35444,35459,34100
6230,32,40,6230,0,0,6230,5.05245e+15,25.1223,359.458,6230,30,33,6190,6180,6107,5601,5129
28478,5,23,0,28478,5085,23393,4865.38,19.9597,565.297,28478,21,21,26440,26440,24649,24691,24046
2393,14,36,2393,0,0,2393,5.57022e+15,12.3293,184.878,2393,20,25,2357,2344,2346,1659,2172
7344,18,40,7344,0,0,7344,5.67473e+15,21.4598,364.198,7344,26,26,7288,7246,7197,6060,5902
16215,15,24,16215,0,0,16215,341136000,21.2271,466.214,16215,21,22,16110,15924,15513,15511,12801
17271,6,24,17271,0,0,17271,5.731e+15,20.1339,487.204,17271,22,21,14822,13325,10499,2611,6675
42258,8,40,42258,0,0,42258,5.7117e+15,32.203,849.176,42258,33,30,37882,31190,28257,8446,16226
22357,13,24,22357,0,22357,0,1.46576e+18,20.5583,545.26,22357,22,22,22041,20936,19955,17109,17280
21689,1,24,0,21689,0,21689,1335910,21.6321,550.272,21689,23,22,2325,2325,2325,2325,2325
38208,27,44,38208,0,38208,0,1.11185e+18,36.2832,1033.19,38208,40,37,38029,37341,37448,27890,29050
7366,9,20,7366,0,0,7366,340911000,18.5061,302.307,7366,20,18,6964,5924,5813,6020,3400
33314,10,40,33314,0,0,33314,5.63521e+15,29.2233,707.482,33314,37,37,32242,31245,28603,7943,16957
7841,5,12,1404,6437,0,7841,20.4122,11.0272,264.184,7841,12,12,7177,7177,6415,6327,5254
14787,11,19,0,14787,2422,12365,4906.85,15.4304,368.382,14787,19,19,14662,14662,14602,14630,14338
5376,1,4,0,5376,5376,0,8.31021e+15,1.99758,102.094,5376,3,3,4753,4753,4753,4753,4753
28838,34,40,28838,0,0,28838,334646000,30.5106,663.876,28838,37,37,28788,28727,28735,25430,28732
41632,7,60,0,41632,0,41632,1277730,38.4802,1001.85,41632,40,44,35998,30987,27654,28350,13406
44651,3,4,0,44651,44651,0,8.37237e+15,3.55961,286.625,44651,4,4,44645,44641,44644,44644,43757
22368,10,40,22368,0,0,22368,340426000,21.941,603.251,22368,30,28,21326,20422,17991,17993,11145
20977,3,4,0,20977,20977,0,9.92394e+15,1.99924,198.32,20977,3,3,20973,20971,20972,20972,20973
12849,36,40,12849,0,0,12849,5.66841e+15,19.0598,426.44,12849,24,29,12809,12798,12809,12102,12809
44496,1,2,44496,0,44496,0,3.36282e+13,1.99957,278.639,44496,2,2,39179,39179,39179,39179,39179
4287,3,24,4287,0,4287,0,1.46542e+18,16.8876,251.002,4287,18,21,2768,2338,2087,792,1017
34340,36,40,0,34340,34340,0,1.6143e+13,36.215,957.252,34340,36,37,34292,34254,34066,34160,34255
6977,25,36,6977,0,6977,0,63139800000,29.3643,411.33,6977,31,33,6899,6743,6732,6492,5912
22918,38,40,22918,0,0,22918,339292000,21.2626,564.803,22918,29,29,22878,22863,22878,22878,22878
2758,1,2,0,2758,2758,0,1.94906e+16,1.99529,73.8085,2758,2,2,2011,2011,2011,2011,2011
24792,4,24,24792,0,0,24792,5.73413e+15,22.0631,601.385,24792,24,22,17758,13457,13057,2941,6081
1356,15,16,1356,0,0,1356,5.55809e+15,12.8348,113.565,1356,13,14,1339,1323,1333,1250,1265
23535,6,40,23535,0,0,23535,256137000,33.238,775.951,23535,38,34,16242,13318,13385,13200,5849
5330,6,11,875,4455,0,5330,20.4263,9.2758,195.197,5330,11,10,5206,5206,5072,5072,5118
1339,16,24,1339,0,1339,0,1.40628e+18,15.1307,144.69,1339,17,19,1313,1293,1277,1150,1020
7412,15,36,7412,0,0,7412,5.21921e+15,29.1758,357.157,7412,32,31,7185,6867,7064,1401,4087
5967,27,40,0,5967,0,5967,1322450,19.1565,310.252,5967,19,29,5927,5918,5922,5922,5925
22512,42,44,22512,0,22512,0,82850600000,27.9947,643.501,22512,36,37,22468,22458,22396,22435,21345
23346,12,40,23346,0,0,23346,334075000,22.3029,588.957,23346,34,37,22910,22125,21155,21155,12723
48226,252,410,48226,0,17113,31113,2.3275e+16,24.0242,1439.4,48226,159,68,47816,47804,47801,47799,47788
16186,24,28,0,16186,2680,13506,5029.72,13.636,462.723,16186,19,26,16158,16158,16158,16158,16061
47260,21,30,0,47260,8427,38833,5028.91,15.8641,822.689,47260,20,29,47230,47230,47188,47188,46449
46325,8,56,46325,0,0,46325,5.65939e+15,28.1024,891.268,46325,37,40,42487,36355,34303,8456,17761
49132,16,56,0,49132,49132,0,2.22995e+13,23.016,879.081,49132,32,32,48834,48121,47030,47266,36262
4621,4,11,0,4621,722,3899,5188.25,8.84224,176.369,4621,11,10,4241,4241,3860,3833,3921
14685,24,40,14685,0,14685,0,8.6028e+10,31.3237,476.858,14685,28,33,14633,14609,14610,14595,14524
4894,1,2,0,4894,4894,0,8.30414e+15,1.99632,91.8746,4894,2,2,4329,4329,4329,4329,4329
31790,14,24,0,31790,31790,0,2.2343e+13,21.0858,662.988,31790,24,22,31508,31146,28412,30308,22886
48520,8,44,48520,0,48520,0,1.35787e+18,41.3465,1018.39,48520,40,41,43538,37906,37365,6873,16658
17534,1,2,0,17534,17534,0,1.04384e+16,1.99914,175.374,17534,2,2,14993,14993,14993,14993,14993
49940,3,30,8464,41476,0,49940,19.6851,17.0056,752.619,49940,21,27,39564,39563,39284,33879,21854
4727,7,36,0,4727,0,4727,1257700,27.8587,276.55,4727,24,31,4291,3864,3644,3784,2084
25658,21,24,0,25658,0,25658,1328670,20.7106,585.242,25658,23,22,25627,25588,25603,25603,25595
6333,1,2,6333,0,6333,0,3.2801e+13,1.99511,105.324,6333,2,2,5594,5594,5594,5594,5594
46961,375,378,0,46961,0,46961,3.77915e+15,17.478,1298.19,46961,129,71,46583,46583,46583,46583,46583
13519,6,20,0,13519,2307,11212,5140.75,12.5328,400.7,13519,17,19,13033,13033,12444,12113,5554
10350,28,40,0,10350,10350,0,2.17795e+13,19.9134,420.771,10350,31,36,10302,10272,10260,10208,9025
23771,1,4,0,23771,23771,0,8.83328e+15,1.99975,208.891,23771,3,3,20854,20854,20854,20854,20854
3545,22,32,0,3545,3545,0,2.17793e+13,14.5726,207.987,3545,24,21,3513,3499,3510,3454,3511
3810,7,22,0,3810,0,3810,1316220,20.737,248.798,3810,21,22,3231,2696,2306,2047,1331
34374,5,40,34374,0,0,34374,336070000,29.118,718.302,34374,37,37,27980,21159,21641,21995,9248
2756,16,22,2756,0,2756,0,87831800000,17.0994,202.409,2756,18,19,2719,2654,2633,2637,2639
3927,5,11,642,3285,0,3927,20.4003,9.40234,167.678,3927,11,10,3695,3695,3280,3281,3376
5428,1,2,0,5428,5428,0,8.32353e+15,1.99705,97.9643,5428,2,2,4800,4800,4800,4800,4800
27187,15,40,27187,0,0,27187,5.71523e+15,35.0024,685.474,27187,32,30,26824,26259,25573,20852,2730
27258,23,44,27258,0,27258,0,1.40245e+18,26.389,697.68,27258,35,37,27107,26813,26914,13334,20884
21402,27,38,21402,0,21402,0,86549600000,37.1188,634.234,21402,33,31,21331,21252,21292,21296,17113
48434,6,44,48434,0,0,48434,5.52873e+15,34.8365,908.121,48434,38,38,42474,38795,32198,6521,9505
37149,2,64,0,37149,0,37149,1117590,33.9016,1078.61,37149,37,44,19282,19044,15578,10008,4039
47814,1,2,47814,0,47814,0,3.87651e+13,1.99977,289.253,47814,2,2,41228,41228,41228,41228,41228
14306,4,24,14306,0,14306,0,1.46698e+18,20.6144,440.219,14306,21,22,10417,7921,7636,1994,3782
40606,19,40,40606,0,0,40606,341291000,22.7432,801.177,40606,31,29,40505,40315,40187,40116,34999
9168,1,2,9168,0,9168,0,3.33423e+13,1.99695,126.203,9168,2,2,8081,8081,8081,8081,8081
35168,1,2,35168,0,35168,0,3.49042e+13,1.99966,246.96,35168,2,2,30806,30806,30806,30806,30806
7278,4,24,0,7278,0,7278,1334420,20.1682,321.924,7278,20,21,5243,3974,3826,3161,2086
10883,1,2,0,10883,10883,0,1.3805e+16,1.9989,141.164,10883,2,2,8797,8797,8797,8797,8797
33396,12,40,33396,0,33396,0,1.4655e+18,22.3021,719.29,33396,29,29,32543,30720,28209,15793,21488
11475,7,21,2113,9362,0,11475,18.5426,17.9534,353.91,11475,19,19,11052,11052,10990,11038,6297
48723,27,56,48723,0,0,48723,5.70546e+15,23.0186,875.713,48723,32,32,48667,48639,48649,33700,47362
49312,28,54,0,49312,0,49312,3.74071e+14,37.8402,1134.95,49312,40,45,49130,48818,48687,48680,35237
31136,18,44,0,31136,31136,0,2.15378e+13,25.801,742.216,31136,36,37,30869,30505,30686,30319,23071
39068,10,44,39068,0,39068,0,1.4144e+18,30.3005,817.305,39068,37,37,37554,36170,33750,5582,18251
9850,11,24,9850,0,0,9850,339741000,22.1539,369.435,9850,21,22,9570,9177,8328,8377,5700
19826,20,60,0,19826,0,19826,1256910,32.2883,781.366,19826,38,50,19504,18962,19173,19195,15104
15772,1,2,15772,0,15772,0,4.07614e+13,1.99816,167.667,15772,2,2,13487,13487,13487,13487,13487
10573,18,19,0,10573,1930,8643,5146.63,15.8229,337.343,10573,19,19,10551,10551,10551,10551,10551
33283,38,40,33283,0,33283,0,1.455e+18,30.3507,831.394,33283,36,38,33243,33231,33241,32319,32462
39457,1,2,39457,0,39457,0,6.4289e+13,1.99975,275.484,39457,2,2,30444,30444,30444,30444,30444
11920,17,24,0,11920,0,11920,1332450,21.7721,407.054,11920,20,22,11867,11692,11746,11743,10616
13683,22,40,13683,0,13683,0,1.45248e+18,18.1578,435.619,13683,25,29,13643,13623,13632,8603,13002
48207,24,30,0,48207,8262,39945,5116.96,18.4008,733.408,48207,28,23,48173,48173,48173,48173,48038
9914,3,4,0,9914,9914,0,8.3149e+15,1.99889,137.471,9914,3,3,9910,9908,9909,9909,9910
6361,1,2,6361,0,6361,0,3.69046e+13,1.99638,105.829,6361,2,2,5526,5526,5526,5526,5526
14584,12,21,0,14584,3040,11544,4504.01,17.3659,413.195,14584,20,19,14418,14407,14308,14330,13519
28373,13,25,0,28373,7407,20966,4368.99,17.9881,669.963,28373,22,23,28218,28218,28027,28044,20458
22051,1,2,0,22051,22051,0,9.90134e+15,1.9995,196.143,22051,2,2,19020,19020,19020,19020,19020
30433,49,60,30433,0,30433,0,83013600000,35.92,803.323,30433,37,43,30373,30361,30369,30373,26481
5026,14,17,1839,3187,0,5026,13.8806,14.8524,253.064,5026,17,16,4992,4989,4942,4945,4904
19619,5,48,19619,0,19619,0,70904300000,30.5884,773.336,19619,34,41,13075,9984,10405,10350,3430
18827,9,21,0,18827,2943,15884,5131.91,15.2808,390.922,18827,20,20,18750,18750,18721,18730,18702
48923,23,28,0,48923,8274,40649,5103.51,16.5555,773.18,48923,21,28,48895,48895,48895,48895,48768
9725,1,2,9725,0,9725,0,3.25035e+13,1.99835,131.066,9725,2,2,8601,8601,8601,8601,8601
30809,34,44,30809,0,0,30809,270762000,34.93,886.077,30809,37,37,30751,30640,30402,28074,29100
45577,4,23,7526,38051,0,45577,19.5915,18.761,672.852,45577,21,21,41441,41441,38033,37649,37687
18035,14,24,18035,0,18035,0,87649300000,20.757,514.567,18035,23,22,17808,17546,15790,16939,13061
28489,26,30,0,28489,4989,23500,4960.81,19.4007,596.234,28489,21,27,28459,28459,28459,28459,28079
34915,1,2,34915,0,34915,0,3.2521e+13,1.9994,248.181,34915,2,2,30880,30880,30880,30880,30880
47858,1,2,47858,0,47858,0,3.35596e+13,1.9999,288.793,47858,2,2,42151,42151,42151,42151,42151
28922,25,44,28922,0,0,28922,5.47437e+15,32.7145,715.822,28922,35,37,28790,28574,28585,10050,24473
23826,3,4,0,23826,23826,0,1.25328e+16,2.22056,225.792,23826,4,4,23806,23777,23800,23800,19909
38217,1,4,0,38217,38217,0,8.37344e+15,1.9999,263.366,38217,3,3,33773,33773,33773,33773,33773
46156,32,44,46156,0,46156,0,79732200000,37.3035,983.35,46156,38,41,46070,45934,45718,45458,41104
33123,1,2,0,33123,33123,0,8.40378e+15,1.99946,239.995,33123,2,2,29259,29259,29259,29259,29259
22174,1,2,0,22174,22174,0,9.19974e+15,1.99959,196.212,22174,2,2,19342,19342,19342,19342,19342
10112,1,23,0,10112,1932,8180,4721.42,16.29,354.847,10112,19,21,2268,2268,2268,2268,2268
31800,40,44,31800,0,31800,0,1.33312e+18,37.8124,840.983,31800,37,41,31756,31735,31636,31204,31755
8422,9,36,8422,0,0,8422,5.63645e+15,18.8974,331.026,8422,26,25,8036,7025,7175,1285,4165
19516,1,2,19516,0,19516,0,3.36339e+13,1.99892,183.593,19516,2,2,17183,17183,17183,17183,17183
19038,18,24,0,19038,19038,0,2.23994e+13,20.8924,507.112,19038,21,22,18999,18952,18824,18808,17243
38284,17,40,38284,0,38284,0,86758300000,26.0858,729.747,38284,31,29,38153,37786,37921,37849,30826
36387,5,44,36387,0,36387,0,1.34522e+18,35.4372,881.96,36387,37,41,28821,22308,23520,5577,9179
24650,1,2,0,24650,24650,0,8.36628e+15,1.99927,207.709,24650,2,2,21787,21787,21787,21787,21787
32594,17,24,0,32594,32594,0,2.23416e+13,21.1772,675.147,32594,24,22,32476,32002,32111,32096,27391
14199,18,21,0,14199,2643,11556,4708.78,17.6411,393.102,14199,19,19,14173,14171,14129,14130,14029
5247,13,38,0,5247,5247,0,2.22895e+13,20.6831,312.277,5247,22,27,5076,4669,4543,4541,2611
5882,40,44,5882,0,0,5882,311585000,19.5896,417.95,5882,26,41,5838,5834,5812,5513,5463
24894,1,2,0,24894,24894,0,8.82267e+15,1.9998,207.722,24894,2,2,21845,21845,21845,21845,21845
32074,10,21,8256,23818,0,32074,16.5449,18.6386,661.552,32074,21,20,31347,31295,30729,30853,16142
17601,16,24,17601,0,17601,0,87762700000,20.2337,500.458,17601,22,22,17486,17169,16859,17051,14530
25813,1,2,25813,0,25813,0,3.28658e+13,1.99942,211.881,25813,2,2,22798,22798,22798,22798,22798
25126,30,40,0,25126,0,25126,981293,34.9005,809.024,25126,37,34,25043,24830,24678,24677,22583
3324,2,19,980,2344,0,3324,15.6895,14.321,214.459,3324,16,18,2014,2014,2005,1916,979
11566,2,36,11566,0,0,11566,5.68051e+15,18.7833,395.823,11566,28,25,6590,6585,4569,1401,1730
22182,1,2,0,22182,22182,0,8.35507e+15,1.99941,196.63,22182,2,2,19609,19609,19609,19609,19609
46847,1,2,46847,0,46847,0,3.35809e+13,1.99974,285.764,46847,2,2,41257,41257,41257,41257,41257
33899,21,40,33899,0,33899,0,75420300000,35.0483,861.201,33899,39,37,33389,32258,32752,31342,22330
8218,1,2,8218,0,8218,0,3.3292e+13,1.99659,119.048,8218,2,2,7245,7245,7245,7245,7245
34066,3,4,0,34066,34066,0,8.34037e+15,2,249.85,34066,3,3,34062,34060,34061,34061,34062
41091,1,2,0,41091,41091,0,1.20719e+16,1.99956,272.844,41091,2,2,34206,34206,34206,34206,34206
36728,16,40,36728,0,0,36728,5.64483e+15,28.4119,740.503,36728,37,37,36501,36105,36180,11751,24209
33763,1,2,0,33763,33763,0,8.34052e+15,1.99932,242.722,33763,2,2,29854,29854,29854,29854,29854
23482,7,13,3874,19608,0,23482,20.339,11.7175,432.33,23482,13,13,23113,23113,21975,22322,22511
34476,24,44,34476,0,34476,0,1.11869e+18,35.786,961.52,34476,38,37,34158,33538,33167,17252,24601
3236,6,18,3236,0,0,3236,344752000,16.3402,200.767,3236,17,18,2750,2454,1913,1895,1274
40405,23,44,40405,0,0,40405,257562000,36.3215,1051.49,40405,39,37,39948,38295,38298,27348,26968
7335,8,21,0,7335,2745,4590,3667.97,16.2481,321.567,7335,19,19,6588,6413,6302,6334,2766
43596,1,40,43596,0,0,43596,5.71679e+15,30.8759,862.057,43596,32,31,4294,4294,4294,4294,4294
47442,25,28,7853,39589,0,47442,20.2512,12.3077,657.782,47442,20,21,47414,47414,47414,47414,47408
44364,1,56,44364,0,0,44364,336776000,28.566,873.18,44364,38,40,5060,5060,5060,5060,5060
22766,18,44,22766,0,22766,0,1.31848e+18,30.1016,739.347,22766,36,41,22336,21541,21814,12501,14469
7588,21,24,7588,0,0,7588,341868000,18.0377,318.293,7588,20,21,7564,7552,7559,7559,7563
38803,5,40,38803,0,38803,0,86707400000,34.1122,866.806,38803,35,38,30108,22284,21995,26321,9311
36369,6,28,6051,30318,0,36369,20.2354,12.1694,584.432,36369,20,21,35314,35314,34107,34111,28550
1828,11,18,1828,0,1828,0,87741400000,16.0897,150.257,1828,15,17,1767,1692,1540,1508,1360
44928,18,23,8541,36387,0,44928,18.567,19.8171,733.073,44928,21,22,44883,44879,44678,44681,44338
46714,3,4,0,46714,46714,0,8.37592e+15,2.00015,290.55,46714,3,3,46710,46708,46709,46709,46710
23123,39,44,23123,0,0,23123,5.43892e+15,27.6886,651.505,23123,36,37,23079,23067,22987,19430,20895
41699,22,96,237,41462,41687,12,5.18067e+15,3.00005,550.367,41699,28,22,41593,41574,41499,41489,41410
17712,25,40,17712,0,17712,0,81662600000,30.4789,561.061,17712,34,35,17595,17400,17435,17202,13403
10910,1,2,0,10910,10910,0,9.25323e+15,1.99945,137.2,10910,2,2,9508,9508,9508,9508,9508
49918,5,40,49918,0,0,49918,337952000,32.3251,990.812,49918,38,37,38002,27998,27750,20137,11882
7652,13,36,7652,0,7652,0,8.3286e+10,28.2206,344.573,7652,31,33,7485,7225,7395,7237,5146
19930,27,44,0,19930,0,19930,1259200,29.1257,617.956,19930,34,37,19835,19622,19650,19652,16046
24257,34,55,24257,0,24257,0,1.30925e+18,34.4538,868.617,24257,34,45,24196,24131,24063,22112,20721
31464,31,40,31464,0,31464,0,1.46589e+18,28.9556,726.661,31464,31,31,31416,31378,31398,27804,30557
44489,25,56,44489,0,44489,0,87066300000,22.6912,839.819,44489,32,32,44432,44403,44412,44415,43268
12980,35,40,12980,0,12980,0,1.341e+18,34.5626,492.888,12980,33,35,12938,12875,12848,10936,11228
35302,1,2,35302,0,35302,0,3.4094e+13,1.99935,247.176,35302,2,2,31025,31025,31025,31025,31025
7108,16,38,7108,0,0,7108,5.48124e+15,33.3717,381.95,7108,32,31,6914,6630,6528,5981,4711
9118,30,36,9118,0,9118,0,86198900000,18.6668,343.736,9118,27,24,9082,9068,9082,9071,9082
17053,1,2,0,17053,17053,0,8.95808e+15,1.99959,172.03,17053,2,2,14932,14932,14932,14932,14932
49300,1,40,49300,0,49300,0,85705900000,32.6466,869.999,49300,39,37,5913,5913,5913,5913,5913
2851,1,2,2851,0,2851,0,3.24817e+13,1.99334,71.0375,2851,2,2,2521,2521,2521,2521,2521
14928,14,40,14928,0,14928,0,85302100000,19.3136,484.959,14928,30,36,14749,14528,14356,14239,10812
49044,19,56,0,49044,0,49044,1321070,37.7362,913.811,49044,41,38,48876,48619,48700,48697,39145
37473,10,23,0,37473,6489,30984,4897.07,18.7844,632.108,37473,21,21,37110,37098,36921,37009,35674
13047,19,44,0,13047,0,13047,1257900,21.925,518.2,13047,32,37,12894,12640,12812,12783,10465
2429,1,2,2429,0,2429,0,3.2099e+13,1.99094,65.587,2429,2,2,2151,2151,2151,2151,2151
4950,27,36,0,4950,0,4950,1256010,19.5745,281.18,4950,27,32,4905,4852,4872,4874,4743
37075,1,49,37075,0,37075,0,1.12248e+18,36.4608,1027.7,37075,38,41,2437,2437,2437,2437,2437
44135,32,44,0,44135,0,44135,1216970,37.0613,951.553,44135,41,37,44053,43915,43782,43784,35008
14390,5,36,0,14390,14390,0,1.64751e+13,30.3128,601.416,14390,34,33,9102,7109,7628,6854,2862
20687,19,33,0,20687,6022,14665,3.48312e+12,14.4935,659.612,20687,19,25,20653,20653,20582,20310,12479
25767,30,40,0,25767,0,25767,1306710,32.3254,634.971,25767,37,37,25703,25623,25652,25652,22192
28847,1,4,0,28847,28847,0,8.35306e+15,2,230.318,28847,3,3,25500,25500,25500,25500,25500
21645,5,24,21645,0,0,21645,5.72609e+15,20.9375,570.74,21645,24,22,16880,12479,12471,3052,6878
49059,26,48,0,49059,49059,0,1.92658e+13,37.2511,1121.89,49059,39,41,48792,48013,48024,46680,34121
26687,56,60,26687,0,26687,0,1.39226e+18,37.9669,760.467,26687,44,39,26627,26615,26627,22878,24163
11540,6,40,0,11540,0,11540,1318740,22.6759,411.881,11540,28,21,10094,9185,7366,7876,4440
11580,6,24,11580,0,0,11580,340812000,21.5749,400.835,11580,21,22,9960,8970,7079,6857,4402
41274,1,2,41274,0,41274,0,3.70785e+13,1.99969,268.405,41274,2,2,35836,35836,35836,35836,35836
41473,51,60,0,41473,0,41473,1274840,24.2499,1001.83,41473,34,44,41413,41404,41407,41412,39098
37754,10,20,0,37754,6510,31244,5194.91,16.7832,601.669,37754,20,20,37648,37648,37542,37541,37564
2724,25,40,2724,0,0,2724,4.88965e+15,18.6645,263.363,2724,25,33,2680,2653,2619,2297,2135
25275,2,4,0,25275,25275,0,8.34756e+15,1.99968,215.652,25275,3,3,25270,25269,25270,25270,23504
6329,1,2,6329,0,6329,0,5.41247e+13,1.99921,109.311,6329,2,2,5111,5111,5111,5111,5111
8212,1,2,0,8212,8212,0,8.34471e+15,1.99854,119.519,8212,2,2,7260,7260,7260,7260,7260
20715,4,40,20715,0,0,20715,340203000,21.9111,584.202,20715,30,28,14809,11234,10854,8404,5588
23013,20,38,0,23013,23013,0,2.21445e+13,36.0409,655.203,23013,33,32,22879,22615,22713,22718,14413
28672,2,56,0,28672,0,28672,1325300,21.8606,691.8,28672,30,32,15829,15823,10646,4894,4655
25846,1,2,25846,0,25846,0,3.3107e+13,1.99899,211.554,25846,2,2,22805,22805,22805,22805,22805
26018,37,40,26018,0,26018,0,8.5725e+10,32.3586,638.384,26018,37,37,25974,25936,25942,25932,25945
37235,7,40,0,37235,37235,0,2.22315e+13,26.4808,722.46,37235,31,29,33510,29500,26234,28813,14661
40954,2,48,40950,4,0,40954,8.97341e+14,36.2325,1074.79,40954,39,41,18520,18084,16087,10989,3500
44000,8,44,0,44000,44000,0,2.00326e+13,36.6476,985.799,44000,41,41,38917,34003,33826,33431,12660
9413,1,2,0,9413,9413,0,1.21334e+16,1.99809,129.649,9413,2,2,7827,7827,7827,7827,7827
24346,35,40,24346,0,0,24346,340776000,21.6996,622.679,24346,32,24,24306,24294,24304,24304,24306
32054,31,44,32054,0,32054,0,6.749e+10,37.5656,929.049,32054,38,37,31968,31676,31512,31325,27448
42560,2,5,42560,0,42560,0,5.34974e+13,1.99977,287.477,42560,3,4,42554,42553,40922,42553,42554
41597,41,44,41597,0,41597,0,7.976e+10,38.3103,942.134,41597,38,41,41552,41530,41402,41418,41552
14268,17,40,14268,0,0,14268,5.27653e+15,32.8213,511.932,14268,34,35,13974,13253,13800,3060,8868
44557,21,40,0,44557,44557,0,2.19825e+13,33.1116,815.439,44557,38,37,44412,44256,44298,44092,29985
26935,4,40,26935,0,26935,0,1.46081e+18,22.0644,618.662,26935,30,29,19768,15106,14596,3434,6390
17275,36,40,17275,0,0,17275,4.07703e+15,32.2019,672.266,17275,35,33,17235,17216,17193,17223,17234
38587,8,44,0,38587,0,38587,1268660,33.0976,816.49,38587,37,37,35663,31652,30951,31643,12036
19139,19,56,0,19139,19139,0,2.2203e+13,19.8953,583.153,19139,30,32,19056,18951,18965,18975,18101
16006,17,40,16006,0,16006,0,71409300000,34.4679,626.132,16006,36,37,15299,11944,14461,13605,8002
39649,25,40,39649,0,0,39649,289383000,34.9528,953.693,39649,39,37,39347,38617,38681,18491,31971
1172,1,2,1172,0,1172,0,3.3143e+13,1.98464,45.2802,1172,2,2,1033,1033,1033,1033,1033
8429,17,40,8429,0,0,8429,330258000,19.119,387.143,8429,31,36,8329,8134,8287,7975,6526
11604,32,38,11604,0,0,11604,5.71809e+15,20.1942,447.528,11604,29,26,11566,11550,11562,11566,11566
32590,1,40,32590,0,0,32590,308633000,34.0064,814.749,32590,40,37,3807,3807,3807,3807,3807
4990,15,22,4990,0,4990,0,87799800000,16.7727,263.112,4990,18,19,4942,4872,4877,4878,4649
5593,15,20,5593,0,0,5593,341880000,15.6419,255.317,5593,17,18,5564,5533,5525,5525,5305
30493,3,13,5127,25366,0,30493,20.3542,11.7921,503.791,30493,13,13,23767,23767,23659,19807,14764
1093,7,20,1093,0,0,1093,5.62229e+15,11.3211,117.084,1093,14,17,989,882,861,521,604
29998,1,4,0,29998,29998,0,8.72916e+15,1.99983,233.677,29998,3,3,26361,26361,26361,26361,26361
18710,3,4,0,18710,18710,0,8.21865e+15,3.15484,201.535,18710,4,4,18685,18648,18677,18677,18319
8889,16,19,1603,7286,0,8889,20.2385,11.2794,302.216,8889,19,16,8867,8867,8867,8867,8867
39129,52,60,39129,0,0,39129,328681000,32.6991,905.704,39129,37,43,39069,39057,39065,38738,35426
46664,18,40,0,46664,0,46664,1315150,31.6504,835.115,46664,38,37,46487,46276,46274,46265,33198
27761,1,4,0,27761,27761,0,8.34239e+15,1.99989,225.759,27761,3,3,24544,24544,24544,24544,24544
34500,6,21,5570,28930,0,34500,20.0285,16.1541,556.717,34500,21,21,33644,33644,32766,32783,32616
46431,2,48,46431,0,46431,0,1.27006e+18,37.2135,1097.28,46431,38,41,24890,24641,19732,6390,5307
15318,20,36,15318,0,15318,0,1.44586e+18,21.6483,455.537,15318,29,25,15266,15232,15249,2605,13999
13563,1,2,0,13563,13563,0,8.47924e+15,1.99786,153.436,13563,2,2,11966,11966,11966,11966,11966
1505,10,32,1505,0,1505,0,1.33524e+18,21.3548,140.957,1505,21,21,1444,1405,1404,326,1093
19737,30,40,19737,0,0,19737,340043000,22.5578,569.93,19737,31,24,19697,19681,19690,19691,19697
8398,14,19,1525,6873,0,8398,20.1405,11.6355,295.058,8398,19,19,8374,8374,8374,8374,8374
18630,1,40,18630,0,18630,0,87388600000,20.0173,553.052,18630,30,25,1886,1886,1886,1886,1886
2498,1,2,2498,0,2498,0,3.24519e+13,1.98639,65.5153,2498,2,2,2209,2209,2209,2209,2209
13660,22,40,0,13660,0,13660,1323210,22.4266,483.567,13660,29,28,13618,13588,13596,13593,12915
33234,17,56,33234,0,33234,0,86945100000,22.5856,735.631,33234,31,32,33066,32533,32103,32485,24313
46859,34,56,0,46859,0,46859,1316670,28.621,895.068,46859,39,40,46789,46723,46737,46731,36843
32260,3,13,0,32260,5375,26885,5205.64,11.6572,515.544,32260,13,13,25242,25242,25135,21360,16147
40827,12,28,0,40827,6802,34025,5149.82,12.885,641.867,40827,20,25,40748,40747,40696,40715,40588
39070,1,2,39070,0,39070,0,3.99843e+13,1.99951,261.913,39070,2,2,33519,33519,33519,33519,33519
44970,38,44,44970,0,0,44970,5.49227e+15,36.2995,887.048,44970,38,37,44922,44868,44780,40255,44351
1061,5,32,1061,0,1061,0,1.31537e+18,11.6145,136.555,1061,16,25,860,677,765,411,478
18243,12,44,18243,0,18243,0,70265800000,33.7045,697.219,18243,36,37,15798,12396,14311,13620,6458
45219,1,2,45219,0,45219,0,3.40678e+13,1.99971,279.831,45219,2,2,39745,39745,39745,39745,39745
47445,11,40,47445,0,47445,0,8.7342e+10,22.4172,847.942,47445,32,28,45892,43679,40171,39734,27255
47902,51,56,47902,0,47902,0,1.44909e+18,28.6201,908.002,47902,45,40,47846,47833,47846,43527,47791
44316,25,28,7352,36964,0,44316,20.1289,12.7253,663.401,44316,20,25,44288,44288,44288,44288,44208
38257,24,56,38257,0,38257,0,1.45336e+18,32.6231,909.424,38257,38,38,38064,37797,37890,25793,36273
21340,3,20,3675,17665,0,21340,20.301,11.8682,450.434,21340,20,13,16461,16461,16275,12666,9173
22119,55,400,829,21290,21859,260,1.51093e+16,28.0497,1388.44,22119,85,69,21640,21487,20584,20506,15675
10455,21,23,0,10455,2552,7903,4278.76,15.9161,384.855,10455,19,20,10432,10432,10356,10356,10009
5394,1,2,0,5394,5394,0,1.221e+16,1.99407,99.9114,5394,2,2,4479,4479,4479,4479,4479
43561,8,60,43561,0,0,43561,5.47248e+15,24.3319,1018.92,43561,36,44,38880,32877,30895,9147,16210
31910,37,40,0,31910,0,31910,1329020,23.0138,687.133,31910,32,29,31870,31856,31870,31870,31870
10599,11,21,2322,8277,0,10599,17.4356,17.8319,361.348,10599,20,19,10444,10444,10380,10402,9516
49501,41,44,49501,0,49501,0,84402500000,35.8865,926.436,49501,38,38,49457,49443,49359,49351,44457
29647,23,32,0,29647,7406,22241,4541.6,15.5406,735.558,29647,21,25,29615,29615,29469,29469,24863
18059,41,55,0,18059,18053,6,1.20358e+15,30.9795,780.111,18059,42,45,18004,17998,17822,17897,11063
24946,1,4,0,24946,24946,0,8.40566e+15,1.99992,213.529,24946,3,3,22033,22033,22033,22033,22033
32402,9,28,5218,27184,0,32402,19.9499,16.6785,565.615,32402,21,27,32209,32209,32122,32144,21725
48765,2,56,48765,0,0,48765,5.66455e+15,28.4368,915.509,48765,36,40,27265,27244,18662,5549,6478
39092,1,4,0,39092,39092,0,8.33532e+15,3.30674,271.48,39092,4,4,34563,34563,34563,34563,34563
45304,9,38,45304,0,45304,0,1.45333e+18,34.0243,982.152,45304,38,38,40849,32497,29712,8598,18391
21779,1,40,21779,0,0,21779,5.65251e+15,27.7071,545.671,21779,29,29,2643,2643,2643,2643,2643
47287,1,4,0,47287,47287,0,8.28814e+15,3.15465,309.787,47287,4,4,41813,41813,41813,41813,41813
17541,47,56,17541,0,0,17541,5.49201e+15,31.5644,687.947,17541,38,49,17485,17477,17476,17485,17404
31128,1,2,31128,0,31128,0,3.28333e+13,1.99949,232.979,31128,2,2,27496,27496,27496,27496,27496
766,17,18,766,0,0,766,345444000,14.7598,101.602,766,15,17,747,725,746,745,747
41850,35,44,0,41850,41850,0,2.04495e+13,34.2114,936.214,41850,37,41,41794,41666,41563,41578,39691
4579,22,36,4579,0,4579,0,65665500000,34.5032,341.824,4579,32,29,4474,4268,4379,4135,2701
44712,1,2,44712,0,44712,0,4.46588e+13,1.99944,282.878,44712,2,2,37617,37617,37617,37617,37617
4757,3,11,734,4023,0,4757,20.1774,9.32268,180.282,4757,10,11,3835,3835,3830,3595,2988
25452,39,40,25452,0,0,25452,5.60636e+15,32.3214,628.05,25452,37,37,25411,25372,25400,23254,25401
24018,5,24,0,24018,0,24018,1333560,21.2271,568.475,24018,23,22,19178,14279,14273,13918,7824
21151,1,20,3705,17446,0,21151,20.3119,16.891,457.681,21151,20,19,3357,3357,3357,3357,3357
19331,1,40,19331,0,0,19331,332712000,36.3176,562.271,19331,37,37,2321,2321,2321,2321,2321
48493,12,21,0,48493,7862,40631,5151.74,15.0072,653.236,48493,21,21,48409,48408,48353,48376,48281
42840,34,40,42840,0,42840,0,1.44113e+18,32.4778,800.526,42840,37,37,42784,42692,42737,36168,42290
37988,1,2,0,37988,37988,0,8.39926e+15,1.99955,256.886,37988,2,2,33559,33559,33559,33559,33559
48250,17,21,0,48250,7954,40296,5179.42,13.8554,651.955,48250,21,20,48219,48219,48217,48219,48175
35114,12,28,0,35114,5873,29241,5181.5,12.9382,577.424,35114,21,21,35065,35065,35050,35054,35007
45009,4,40,45009,0,45009,0,87352500000,22.7894,827.487,45009,32,28,32449,24621,23740,28279,12445
47189,1,4,0,47189,47189,0,1.05119e+16,1.99985,295.211,47189,3,3,40302,40302,40302,40302,40302
12013,30,40,12013,0,12013,0,85084200000,20.2451,445.934,12013,30,36,11969,11935,11932,11926,11277
15758,31,40,15758,0,0,15758,5.69388e+15,18.017,468.5,15758,28,29,15718,15704,15716,13607,15716
23511,15,23,4023,19488,0,23511,19.3394,17.17,499.614,23511,20,21,23454,23454,23382,23385,22972
39782,1,4,0,39782,39782,0,8.198e+15,3.61382,293.722,39782,4,4,35193,35193,35193,35193,35193
44733,1,2,44733,0,44733,0,3.2588e+13,1.99984,280.378,44733,2,2,39553,39553,39553,39553,39553
23581,3,44,23581,0,23581,0,69163200000,37.3818,802.591,23581,36,37,13234,11353,10989,9779,3221
26127,1,2,26127,0,26127,0,3.21261e+13,1.99939,215.392,26127,2,2,23144,23144,23144,23144,23144
46735,1,2,46735,0,46735,0,3.22942e+13,1.9997,287.641,46735,2,2,41372,41372,41372,41372,41372
16996,2,56,16996,0,0,16996,5.5767e+15,24.0298,559.99,16996,36,37,9797,9781,6947,2107,2124
41754,1,2,41754,0,41754,0,3.95308e+13,1.9994,270.618,41754,2,2,35889,35889,35889,35889,35889
29523,15,38,29523,0,0,29523,5.69757e+15,30.1001,723.182,29523,32,31,29064,28331,27629,23977,21981
29229,23,55,29229,0,0,29229,5.71573e+15,32.8406,965.266,29229,42,45,29017,28355,27709,16766,18298
36071,11,60,36071,0,36071,0,7.9933e+10,31.8635,947.324,36071,40,44,33787,31142,31083,30105,11996
22361,21,40,22361,0,22361,0,1.4672e+18,22.0208,601.505,22361,27,29,22309,22193,22285,16312,21029
47734,25,28,0,47734,7918,39816,5133.11,15.6908,731.784,47734,21,28,47706,47706,47706,47706,47617
24624,9403,10600,24252,372,0,24624,1.61617e+18,213.089,12654.1,24624,2960,255,14024,14024,12729,12629,9242
17994,8,40,0,17994,17994,0,1.98733e+13,34.5234,591.789,17994,34,34,16161,14463,14398,14056,5209
31926,30,40,31926,0,0,31926,5.70063e+15,21.8701,665.792,31926,30,29,31886,31867,31882,27058,31884
8709,17,19,0,8709,2226,6483,4152.09,15.3628,330.029,8709,19,17,8686,8686,8656,8658,8680
20209,5,24,20209,0,20209,0,8.7484e+10,20.3126,546.029,20209,23,22,15770,11658,11714,13849,6218
7054,29,36,7054,0,7054,0,67321500000,29.4607,400.106,7054,33,29,7006,6941,6913,6905,6466
14822,8,24,0,14822,14822,0,2.22202e+13,18.3753,432.092,14822,21,21,13771,11943,11164,12113,7553
31838,40,44,31838,0,0,31838,308891000,33.1665,832.045,31838,40,41,31794,31784,31594,30854,28527
44564,21,23,0,44564,8462,36102,4759.7,19.1075,730.297,44564,21,22,44539,44539,44429,44431,44539
47396,21,44,47396,0,0,47396,329804000,36.5357,912.567,47396,37,38,47120,46743,46874,43193,33165
46317,1,2,46317,0,46317,0,3.68092e+13,1.9997,289.691,46317,2,2,40259,40259,40259,40259,40259
2502,17,22,2502,0,0,2502,5.7231e+15,16.7898,190.66,2502,17,18,2474,2434,2451,2063,2278
37035,2,44,0,37035,0,37035,1216810,36.8669,891.686,37035,37,41,21250,21126,16364,9760,4926
35620,1,2,35620,0,35620,0,4.04196e+13,1.99983,250.114,35620,2,2,30504,30504,30504,30504,30504
44020,43,56,44020,0,0,44020,5.65257e+15,28.3015,868.282,44020,38,40,43964,43952,43955,43964,35330
4184,10,19,759,3425,0,4184,20.0163,11.6891,215.832,4184,19,18,4146,4146,4132,4131,3558
29314,3,40,29314,0,29314,0,1.43997e+18,28.1451,659.034,29314,36,37,19858,16933,15361,3609,4513
23530,1,2,0,23530,23530,0,8.50114e+15,1.99911,201.851,23530,2,2,20753,20753,20753,20753,20753
11302,8,24,11302,0,11302,0,1.47198e+18,18.5954,389.853,11302,20,21,10305,8659,8119,2757,5854
38848,6,44,38848,0,0,38848,275285000,37.4329,995.967,38848,39,39,29202,25044,23941,24577,7671
15976,10,36,15976,0,0,15976,5.47784e+15,28.54,493.83,15976,34,33,15428,14947,14075,2299,6576
44949,19,40,44949,0,44949,0,1.44544e+18,27.7021,815.137,44949,38,37,44808,44599,44672,15311,34805
16624,10,24,0,16624,16624,0,2.23432e+13,20.9012,469.968,16624,22,22,16044,15519,13649,13752,9118
23536,25,40,0,23536,0,23536,1334400,21.1591,618.345,23536,30,27,23496,23476,23485,23485,22864
42309,1,2,42309,0,42309,0,4.47803e+13,1.99983,275.815,42309,2,2,35577,35577,35577,35577,35577
48517,1,2,48517,0,48517,0,5.12743e+13,1.99967,299.638,48517,2,2,39678,39678,39678,39678,39678
3322,31,40,3322,0,3322,0,1.37981e+18,15.5719,263.961,3322,20,33,3282,3278,3273,3281,3076
47865,19,20,0,47865,8460,39405,5191.75,16.9597,692.081,47865,20,19,47843,47843,47843,47843,47838
44904,1,4,0,44904,44904,0,8.37655e+15,1.99971,285.612,44904,3,3,39681,39681,39681,39681,39681
2637,21,22,2637,0,2637,0,87462900000,16.0626,197.364,2637,19,19,2615,2605,2615,2615,2615
20156,14,20,0,20156,3508,16648,5205.25,11.3988,437.469,20156,19,18,20131,20131,20131,20131,20130
6769,2,20,6769,0,6769,0,1.46891e+18,16.8158,284.755,6769,19,18,3783,3783,2546,788,1238
21732,1,2,0,21732,21732,0,9.5858e+15,1.99982,194.352,21732,2,2,18840,18840,18840,18840,18840
2780,32,36,2780,0,0,2780,5.54607e+15,13.9608,196.751,2780,21,25,2744,2736,2744,2527,2744
8047,27,38,8047,0,0,8047,339139000,20.7085,380.312,8047,27,26,8009,7991,8000,8001,8009
4124,8,32,4124,0,4124,0,1.41473e+18,14.049,219.227,4124,24,21,3907,3547,3453,1201,2097
7458,1,12,1288,6170,0,7458,20.4983,9.77501,245.745,7458,11,11,1194,1194,1194,1194,1194
29863,50,56,29863,0,29863,0,86870400000,23.1796,693.711,29863,31,30,29807,29795,29807,29807,29807
32628,54,56,0,32628,32628,0,2.19536e+13,35.0573,848.869,32628,38,44,32572,32566,32572,32572,32572
29845,8,40,29845,0,0,29845,5.26885e+15,30.6931,747.967,29845,38,35,27154,24133,23774,4337,8851
43693,35,40,43693,0,0,43693,336048000,32.1317,806.334,43693,38,37,43640,43547,43600,38534,43108
47522,62,67,47522,0,47522,0,1.06671e+18,36.9728,1158.02,47522,45,37,47455,47455,47454,47399,46637
38116,2,44,38116,0,38116,0,81744100000,37.0581,843.649,38116,38,37,22404,22311,16973,17742,5371
14743,31,44,0,14743,0,14743,1227860,32.4319,532.226,14743,34,36,14681,14547,14553,14552,12099
49832,12,40,49832,0,49832,0,1.46591e+18,30.4429,894.502,49832,33,32,48438,45516,41712,16071,28296
21813,1,2,21813,0,21813,0,3.38214e+13,1.99913,195.975,21813,2,2,19191,19191,19191,19191,19191
22582,22,40,22582,0,0,22582,340769000,22.1256,606.45,22582,31,24,22539,22508,22522,22517,21655
17449,1,2,17449,0,17449,0,5.32171e+13,1.99943,178.909,17449,2,2,14149,14149,14149,14149,14149
5329,17,20,854,4475,0,5329,19.9842,10.2059,232.56,5329,17,17,5309,5309,5308,5309,3313
16448,15,66,0,16448,16447,1,1.31921e+15,31.9438,780.551,16448,37,48,14134,7317,12031,11192,1576
17126,2,19,4767,12359,0,17126,15.9591,15.9909,480.817,17126,19,18,10711,10711,10690,10125,5177
34905,12,40,34905,0,0,34905,340316000,22.4703,734.863,34905,32,24,34038,32213,29622,30349,21186
2363,16,22,2363,0,2363,0,87913200000,16.0089,188.208,2363,18,19,2328,2273,2273,2276,2250
6982,9,40,0,6982,0,6982,1189640,23.8937,373.182,6982,32,33,6361,5600,5875,5855,3313
34861,20,40,34861,0,34861,0,1.46077e+18,22.2578,701.361,34861,31,29,34804,34747,34731,11579,31925
20033,16,23,0,20033,3835,16198,4839.58,17.5687,504.178,20033,20,22,19994,19993,19925,19929,19352
29206,3,21,0,29206,5879,23327,4601.02,18.3059,587.258,29206,21,20,22927,22918,22791,22360,19148
29679,1,2,29679,0,29679,0,3.27766e+13,1.99902,226.976,29679,2,2,26222,26222,26222,26222,26222
23140,8,30,0,23140,4088,19052,4931.44,15.4149,547.892,23140,20,26,22687,22662,22236,22291,21534
35233,12,20,6079,29154,0,35233,20.2897,16.9302,582.663,35233,20,20,35188,35187,35177,35177,35147
46009,9,44,46009,0,0,46009,313788000,34.7917,968.902,46009,38,41,42352,36946,38449,38289,14012
33658,32,56,0,33658,0,33658,1328310,22.2506,743.096,33658,32,32,33602,33590,33599,33596,33495
10756,1,2,10756,0,10756,0,3.32871e+13,1.99907,136.428,10756,2,2,9483,9483,9483,9483,9483
27912,24,40,0,27912,27912,0,2.23977e+13,21.1171,670.75,27912,30,29,27872,27852,27859,27861,27091
12935,1,2,12935,0,12935,0,3.26628e+13,1.99876,150.705,12935,2,2,11433,11433,11433,11433,11433
26849,23,44,26849,0,26849,0,1.40303e+18,26.8042,695.928,26849,36,37,26698,26404,26505,10398,19977
34698,1,2,0,34698,34698,0,8.40236e+15,1.99914,245.882,34698,2,2,30651,30651,30651,30651,30651
25072,3,40,25072,0,0,25072,337734000,28.5564,595.016,25072,30,29,16863,14343,12945,9103,5466
39947,16,20,7029,32918,0,39947,20.1344,18.5356,674.361,39947,20,20,39891,39891,39844,39847,22722
39600,12,40,39600,0,0,39600,5.68184e+15,37.4088,854.041,39600,35,33,38100,35298,32560,23720,18698
37369,1,2,37369,0,37369,0,4.7205e+13,1.99968,262.583,37369,2,2,31101,31101,31101,31101,31101
22246,1,4,0,22246,22246,0,8.35694e+15,1.99955,203.076,22246,3,3,19663,19663,19663,19663,19663
44145,41,56,44145,0,44145,0,1.46185e+18,23.1734,841.733,44145,39,32,44089,44076,44081,23319,44087
25858,36,44,0,25858,0,25858,1273100,30.7211,682.29,25858,37,37,25814,25789,25738,25740,25431
10295,11,36,10295,0,0,10295,5.48973e+15,26.5237,389.559,10295,33,25,10029,9698,9532,1454,4062
40332,17,44,40332,0,40332,0,1.31818e+18,38.0248,961.797,40332,40,41,39325,35153,38292,9123,20617
34379,5,40,34379,0,34379,0,84991900000,30.6103,720.43,34379,37,37,28304,21629,22536,24579,7887
40864,25,40,0,40864,0,40864,1224290,31.8126,910.379,40864,40,37,40634,40138,40220,40223,31955
24722,1,2,24722,0,24722,0,3.44756e+13,1.99947,206.893,24722,2,2,21693,21693,21693,21693,21693
12118,3,36,12118,0,12118,0,1.42931e+18,23.1569,397.305,12118,28,25,8404,7200,6574,1624,2330
49717,26,60,49717,0,49717,0,1.44446e+18,37.5929,969.293,49717,36,40,49623,49520,49553,17643,46016
33408,34,60,33408,0,0,33408,5.4102e+15,25.955,929.97,33408,35,44,33344,33311,33189,32411,28132
42317,29,40,42317,0,0,42317,5.73058e+15,22.5409,809.708,42317,32,29,42277,42257,42268,42277,42277
26735,1,2,26735,0,26735,0,6.11907e+13,1.99895,226.392,26735,2,2,20922,20922,20922,20922,20922
29218,33,40,0,29218,29218,0,2.1946e+13,32.4341,676.417,29218,37,37,29161,29100,29111,29103,29101
46202,13,32,0,46202,10615,35587,4677.75,18.3616,959.715,46202,22,31,45954,45954,45747,45762,38281
39290,4,25,0,39290,9619,29671,4418.24,17.1681,763.971,39290,22,23,32271,32271,30518,30408,22350
24807,17,32,6575,18232,0,24807,17.3388,17.8996,745.389,24807,20,31,24751,24751,24572,24574,18360
14477,15,21,0,14477,3397,11080,4365.07,17.3767,433.23,14477,19,20,14424,14424,14297,14298,13263
25951,1,2,25951,0,25951,0,3.5663e+13,1.99931,212.09,25951,2,2,22662,22662,22662,22662,22662
26726,771,965,26725,1,26726,0,1.54912e+18,66.3724,2219.09,26726,122,99,25761,25755,25724,25719,17723
47799,1,2,47799,0,47799,0,3.36128e+13,1.99979,288.466,47799,2,2,42090,42090,42090,42090,42090
1253,1,4,0,1253,1253,0,8.16614e+15,2.0008,52.2256,1253,3,3,1108,1108,1108,1108,1108
6623,31,40,0,6623,0,6623,1304900,17.8682,314.594,6623,25,29,6583,6569,6581,6578,6581
38653,23,40,38653,0,38653,0,1.32202e+18,33.7902,889.003,38653,40,37,38313,37406,37838,12213,26851
2788,1,19,0,2788,760,2028,4135.3,13.5721,194.706,2788,16,18,714,714,714,714,714
13682,37,38,13682,0,0,13682,5.6732e+15,29.1174,501.789,13682,31,29,13643,13606,13642,13643,13643
10538,13,32,0,10538,3238,7300,4193.46,17.4786,505.166,10538,19,31,10426,10426,10330,10337,5433
1936,26,32,1936,0,1936,0,1.00628e+18,24.8595,215.668,1936,26,29,1900,1862,1876,1847,1621
32412,39,40,32412,0,32412,0,1.4545e+18,27.6532,677.746,32412,30,29,32371,32342,32370,30692,32370
21470,19,60,21470,0,0,21470,311420000,25.6347,788.936,21470,36,44,21141,20407,20690,17597,14878
37399,4,30,6551,30848,0,37399,19.7338,14.7982,671.268,37399,20,26,33308,33308,30465,29175,26997
5552,1,2,0,5552,5552,0,8.38422e+15,1.99748,98.8526,5552,2,2,4905,4905,4905,4905,4905
9390,1,2,0,9390,9390,0,1.67751e+16,1.99947,135.414,9390,2,2,7203,7203,7203,7203,7203
41667,31,44,0,41667,0,41667,1110410,37.4978,1014.82,41667,39,39,41562,41148,41040,41063,36858
44838,1,40,44838,0,0,44838,336345000,32.1052,817.615,44838,38,37,5333,5333,5333,5333,5333
34807,17,44,0,34807,34807,0,2.0826e+13,36.7755,814.357,34807,38,37,34190,32546,33801,32769,16391
7052,1,2,0,7052,7052,0,8.33792e+15,1.99801,110.794,7052,2,2,6235,6235,6235,6235,6235
28309,22,44,28309,0,0,28309,326821000,36.2093,731.815,28309,36,37,28123,27837,27921,25111,20648
24440,2,64,24440,0,0,24440,4.86053e+15,34.6912,1002.97,24440,38,54,11623,11486,8493,3272,2162
43054,51,60,43054,0,43054,0,8.4053e+10,32.6783,922.777,43054,37,44,42994,42982,42990,42994,37191
49710,23,33,9373,40337,1,49709,5662170000,18.4149,859.232,49710,28,25,49671,49671,49655,49655,48706
19845,8,21,3201,16644,0,19845,19.9399,12.2254,422.98,19845,19,20,19681,19678,19564,19584,19470
21983,14,20,3771,18212,0,21983,20.299,11.9773,456.252,21983,20,17,21957,21957,21957,21957,21957
44282,21,23,9127,35155,0,44282,18.1322,20.1775,756.141,44282,22,22,44257,44257,44179,44181,44257
3924,26,36,3924,0,0,3924,316116000,21.3874,254.27,3924,29,31,3874,3822,3836,3109,3567
13291,5,28,0,13291,2202,11089,5125.62,10.9432,375.068,13291,19,21,12405,12405,11112,10935,8379
41548,44,56,0,41548,0,41548,1327380,22.7602,829.379,41548,32,32,41492,41480,41492,41492,41490
27184,25,40,27184,0,0,27184,5.61968e+15,29.0528,638.019,27184,36,37,27101,27008,27036,9455,24178
25453,5,24,0,25453,0,25453,1333110,21.763,591.639,25453,23,22,20261,15080,15109,14452,7887
16796,4,19,0,16796,2631,14165,5065.5,12.5973,374.54,16796,19,19,15452,15452,14141,14081,14475
46746,12,23,0,46746,7731,39015,5020.99,18.7951,681.862,46746,21,21,46556,46550,46414,46467,45764
20362,6,24,0,20362,0,20362,1332300,20.9656,519.427,20362,22,22,17626,15934,12450,12672,6721
34784,20,21,5598,29186,0,34784,20.2009,14.4747,536.102,34784,21,20,34761,34760,34760,34761,34758
8592,8,20,8592,0,0,8592,5.70406e+15,17.3877,315.291,8592,20,19,7997,6935,6699,2628,4292
29495,19,44,0,29495,0,29495,1278620,25.982,719.674,29495,36,37,29259,28875,29110,29079,22372
45902,6,64,45902,0,0,45902,306680000,30.8917,1177.42,45902,36,44,35998,31204,26988,25728,10816
9800,29,36,9800,0,0,9800,4.26429e+15,31.7704,484.417,9800,33,33,9743,9660,9604,9096,9145
9352,1,2,0,9352,9352,0,9.63901e+15,1.99775,127.195,9352,2,2,8100,8100,8100,8100,8100
25837,63,64,25837,0,25837,0,73853400000,29.7647,937.445,25837,34,44,25773,25765,25772,25773,25307
32065,6,40,0,32065,32065,0,2.23294e+13,29.2699,735.587,32065,31,30,26768,23621,19144,23046,8763
47633,1,20,8196,39437,0,47633,20.32,16.0786,668.712,47633,20,20,7700,7700,7700,7700,7700
18408,14,32,3688,14720,0,18408,19.6741,12.8479,545.192,18408,20,24,18368,18368,18355,18355,16809
1322,37,40,0,1322,1322,0,1.77352e+13,17.7254,197.608,1322,24,33,1282,1278,1264,1269,1177
1063,1,2,1063,0,1063,0,3.204e+13,1.99059,42.9215,1063,2,2,941,941,941,941,941
33408,9,30,0,33408,6489,26919,4916.54,13.3385,693.844,33408,20,24,32963,32963,32599,32662,30383
39613,10,40,39613,0,39613,0,1.46684e+18,28.6891,809.232,39613,32,31,37557,35793,30567,9222,20660
9178,50,56,9178,0,9178,0,1.43374e+18,19.3699,413.873,9178,34,31,9122,9112,9122,7792,9122
37718,2,4,0,37718,37718,0,8.39061e+15,2.00016,261.994,37718,3,3,37713,37712,37713,37713,34263
1690,1,19,0,1690,313,1377,5103.64,9.20296,143.893,1690,17,16,255,255,255,255,255
40198,1,2,40198,0,40198,0,3.70557e+13,1.99965,265.834,40198,2,2,34905,34905,34905,34905,34905
34444,1,2,0,34444,34444,0,1.61316e+16,1.99959,258.353,34444,2,2,26732,26732,26732,26732,26732
4144,21,24,4144,0,0,4144,5.71617e+15,17.1433,238.25,4144,18,20,4120,4108,4118,3475,3965
42011,1971,2182,15330,26681,845,41166,1.03694e+12,57.356,3962.53,42011,478,175,39829,39829,39704,39739,24079
32392,132,410,32392,0,24921,7471,3.06461e+16,8.63497,1010.93,32392,159,64,31982,31952,31932,31956,31889
17638,38,44,17638,0,0,17638,321436000,26.5613,587.952,17638,33,37,17594,17581,17480,16160,16129
6169,553,4611,6169,0,4808,1361,2.67311e+18,107.287,5145.47,6169,1263,105,1558,1174,783,846,273
20786,4,40,20786,0,20786,0,1.22922e+18,32.0654,682.355,20786,36,37,14697,12027,12209,3164,4482
43356,52,64,43356,0,43356,0,77191300000,30.9774,1158.28,43356,36,44,43292,43281,43288,43292,36810
19449,26,44,19449,0,19449,0,69756500000,33.67,716.941,19449,36,37,19312,18933,19015,18564,15826
35821,1,4,0,35821,35821,0,8.63782e+15,1.9998,255.424,35821,3,3,31524,31524,31524,31524,31524
48035,18,60,48035,0,0,48035,330082000,31.3818,976.68,48035,37,44,47632,47126,47248,43539,33810
21325,36,38,21325,0,0,21325,5.66841e+15,29.0915,625.62,21325,32,31,21283,21213,21278,21281,21283
42005,43,44,42005,0,42005,0,1.20872e+18,38.476,1024.87,42005,39,39,41961,41939,41848,40322,41959
43991,10,40,43991,0,0,43991,5.65814e+15,28.0388,811.023,43991,38,37,42532,41176,37336,9142,21967
32079,14,20,0,32079,5559,26520,5200.35,11.9787,549.449,32079,19,19,32054,32054,32054,32054,32041
43914,18,40,43914,0,0,43914,5.60148e+15,32.9342,816.055,43914,38,37,43680,43418,43526,8576,26660
33879,20,28,5677,28202,0,33879,20.244,12.109,567.69,33879,20,21,33851,33851,33850,33850,33840
37085,18,28,6197,30888,0,37085,20.0576,15.9272,619.892,37085,20,27,37047,37046,37022,37022,36871
17243,1,2,0,17243,17243,0,8.34954e+15,1.99849,173.309,17243,2,2,15244,15244,15244,15244,15244
19179,23,24,0,19179,19179,0,2.2259e+13,18.4276,499.21,19179,21,21,19155,19143,19145,19145,19155
24435,37,44,0,24435,0,24435,1270780,27.3167,669.978,24435,36,37,24391,24379,24269,24270,21864
34657,20,40,34657,0,34657,0,1.46797e+18,22.0329,736.407,34657,30,29,34585,34433,34469,21572,31931
36448,1,44,36448,0,0,36448,320496000,36.1148,824.56,36448,37,37,4412,4412,4412,4412,4412
22297,19,40,22297,0,22297,0,86646700000,21.396,557.789,22297,28,29,22244,22169,22191,22166,20480
8544,34,40,8544,0,0,8544,330565000,18.8462,389.469,8544,29,36,8504,8496,8463,7923,8450
27588,38,64,27588,0,27588,0,1.27804e+18,33.0828,1051.64,27588,47,46,27524,27514,27369,21395,18473
650,4,9,94,556,0,650,19.7169,6.37077,62.3127,650,8,8,607,607,558,557,590
21862,16,48,21862,0,0,21862,279007000,30.3622,803.176,21862,35,41,20506,15323,18890,18824,9608
47118,53,65,47117,1,0,47118,7.79951e+14,35.1271,1392.03,47118,38,59,47053,47045,47046,41890,39389
32313,36,44,32313,0,32313,0,79566100000,36.1932,845.583,32313,37,41,32261,32215,32010,32033,30850
12490,14,24,12490,0,12490,0,1.45451e+18,18.0163,399.129,12490,21,21,12400,12284,11894,10251,10700
43935,18,21,7194,36741,0,43935,20.2468,14.0717,611.906,43935,21,20,43907,43907,43905,43907,43886
41150,34,44,41150,0,0,41150,311472000,41.118,958.683,41150,40,41,41077,40941,40754,34828,32323
7494,17,38,7494,0,0,7494,337792000,20.7375,370.429,7494,30,22,7405,7186,7252,7240,5755
2311,23,38,2311,0,0,2311,331827000,20.0329,216.11,2311,22,27,2273,2257,2262,2264,1840
19647,1,2,19647,0,19647,0,3.2636e+13,1.99857,185.349,19647,2,2,17368,17368,17368,17368,17368
47216,16,28,7815,39401,0,47216,20.2249,18.1118,662.53,47216,28,21,47170,47170,47168,47168,47160
739,15,24,0,739,739,0,1.39797e+13,18.3992,119.974,739,23,20,636,363,584,518,502
21704,2,24,0,21704,0,21704,1335600,21.594,550.274,21704,22,22,11894,11893,7914,3524,3191
35631,20,40,35631,0,35631,0,1.44424e+18,30.0339,738.649,35631,37,37,35509,35399,35413,11656,28040
7699,1,13,0,7699,1254,6445,5192.49,9.85557,247.418,7699,11,12,1320,1320,1320,1320,1320
46247,18,38,46247,0,0,46247,5.51021e+15,37.0013,1068.16,46247,38,38,44976,43387,43179,38851,22164
30113,1,2,0,30113,30113,0,8.35124e+15,1.99957,229.581,30113,2,2,26622,26622,26622,26622,26622
14881,22,38,14881,0,0,14881,340487000,21.455,503.004,14881,30,26,14842,14823,14828,14829,14841
46079,18,44,46079,0,0,46079,5.53022e+15,31.6343,890.013,46079,37,38,45717,45242,45471,13395,31498
31786,18,19,5904,25882,0,31786,19.9025,17.386,614.221,31786,19,19,31750,31750,31730,31730,31730
47767,1,4,0,47767,47767,0,8.34515e+15,2.00004,294.271,47767,3,3,42232,42232,42232,42232,42232
15432,20,36,0,15432,15432,0,2.16445e+13,23.4538,466.719,15432,34,33,15340,15261,15293,15144,11919
26729,5,60,0,26729,0,26729,1188370,33.6407,853.215,26729,38,44,20575,16014,17071,16002,5372
49236,38,56,0,49236,0,49236,1329530,22.733,879.485,49236,32,32,49180,49164,49179,49179,47450
34214,43,44,34214,0,0,34214,320308000,36.8582,805.609,34214,37,37,34170,34147,34144,34085,34170
4403,16,17,1693,2710,0,4403,13.7652,14.9128,236.418,4403,17,16,4383,4383,4356,4357,4383
49942,24,32,10740,39202,0,49942,18.6616,14.2693,893.126,49942,21,25,49910,49910,49771,49771,45698
1180,26,36,0,1180,1180,0,2.12933e+13,12.4229,140.849,1180,18,25,1144,1136,1141,1112,1142
25309,23,40,0,25309,0,25309,1182060,33.3881,737.644,25309,38,37,25052,24368,24684,24693,15748
8138,22,36,8138,0,8138,0,1.3558e+18,29.4379,361.092,8138,33,32,8032,7872,7953,2433,6271
41778,1,2,0,41778,41778,0,8.3824e+15,1.99926,269.699,41778,2,2,36917,36917,36917,36917,36917
39200,37,40,39200,0,39200,0,84731800000,36.1588,790.629,39200,37,37,39156,39106,39123,39110,39155
8872,1,13,1473,7399,0,8872,20.3859,10.4574,264.344,8872,12,12,1483,1483,1483,1483,1483
13799,5,49,0,13799,13795,4,1.57152e+15,32.6253,644.373,13799,34,41,9108,6863,7303,7235,2983
37953,26,40,37953,0,0,37953,335619000,32.9132,750.163,37953,37,37,37859,37740,37791,23677,32740
13077,2,38,13077,0,0,13077,5.46833e+15,35.0571,551.613,13077,37,38,6597,6593,3777,1609,1625
20283,19,40,20283,0,20283,0,62087400000,32.6898,726.002,20283,36,33,19563,16959,17411,16320,12099
16237,42,60,0,16237,0,16237,1308060,20.0012,615.86,16237,30,40,16177,16173,16168,16159,15661
11899,4,24,11899,0,0,11899,5.68694e+15,18.153,390.407,11899,21,21,8857,6795,6571,1561,3376
46199,1,20,0,46199,8130,38069,5201.01,15.9369,671.486,46199,20,19,7279,7279,7279,7279,7279
28399,35,40,28399,0,0,28399,297766000,36.5729,779.8,28399,37,37,28346,28226,28124,25160,27801
42641,1,2,42641,0,42641,0,3.34079e+13,1.99984,272.045,42641,2,2,37579,37579,37579,37579,37579
47710,1,2,47710,0,47710,0,4.95457e+13,1.99973,295.682,47710,2,2,39311,39311,39311,39311,39311
12741,42,60,12741,0,12741,0,81979600000,23.1288,627.768,12741,30,44,12681,12675,12638,12645,11001
41539,32,48,41535,4,41535,4,2.08282e+12,40.9695,1098.23,41539,44,41,41447,41347,40916,31226,24551
21033,1,33,5800,15233,1,21032,13382100000,14.4894,663.025,21033,19,25,3783,3783,3783,3783,3783
40347,13,40,40347,0,0,40347,339500000,26.773,763.721,40347,32,29,39766,37878,36714,37181,24676
34361,18,44,34361,0,0,34361,5.39066e+15,35.7689,799.581,34361,38,37,33938,33351,33660,5703,22174
9877,3,20,0,9877,9877,0,2.2224e+13,17.3543,339.481,9877,20,19,6673,5675,5122,5415,1770
26338,46,48,26338,0,26338,0,80966100000,33.3277,791.377,26338,36,41,26290,26277,26251,26280,26106
33166,4,5,6,33160,33166,0,1.38897e+16,1.99958,256.139,33166,4,3,33161,33159,33161,33161,33161
15980,29,40,15980,0,0,15980,5.31273e+15,30.9385,534.147,15980,33,35,15910,15788,15794,9104,14048
39546,4349,8892,39546,0,13460,26086,1.84666e+18,288.495,11627.5,39546,2635,235,30654,30481,29106,29809,1681
40391,1,40,40391,0,0,40391,5.18729e+15,33.1143,907.471,40391,40,37,4695,4695,4695,4695,4695
35589,22,40,0,35589,0,35589,1323890,26.7669,706.343,35589,31,29,35527,35462,35486,35482,34889
41596,41,44,41596,0,0,41596,5.29451e+15,34.6062,930.137,41596,40,41,41552,41533,41364,37536,40492
44626,35,38,44626,0,44626,0,1.45005e+18,37.043,1016.15,44626,38,38,44528,44108,44473,41891,42890
3176,9,21,0,3176,747,2429,4713.43,9.41971,218.106,3176,13,20,3125,3125,3075,3075,2442
3164,17,20,0,3164,0,3164,1324140,13.8679,189.052,3164,16,17,3144,3134,3128,3127,3031
24603,369,378,24584,19,24584,19,4.60449e+16,31.9248,1185.62,24603,154,56,24225,24225,24225,24225,24225
27903,1,2,0,27903,27903,0,9.68154e+15,1.99914,221.077,27903,2,2,24153,24153,24153,24153,24153
23093,32,40,23093,0,0,23093,5.63355e+15,29.0451,563.251,23093,30,29,23043,22995,23030,19633,20654
17177,13,25,4138,13039,0,17177,18.1037,12.6115,527.16,17177,19,23,17122,17122,17066,17070,13137
28514,14,56,28514,0,0,28514,338804000,22.8655,727.351,28514,32,38,28100,27623,24782,26474,18448
7582,1,2,0,7582,7582,0,8.35381e+15,1.99763,114.755,7582,2,2,6702,6702,6702,6702,6702
42236,14,56,0,42236,42236,0,2.22864e+13,23.3427,824.679,42236,31,32,41770,41225,37429,40093,27591
37750,5,44,37750,0,0,37750,314059000,30.8594,895.469,37750,40,41,29948,23163,24378,24688,8986
18290,16,40,0,18290,18290,0,2.21872e+13,21.7443,510.269,18290,29,29,18192,18009,17864,17936,14034
14582,30,40,14582,0,0,14582,5.70841e+15,20.5218,497.645,14582,30,24,14542,14528,14537,14542,14388
2056,13,22,0,2056,2056,0,2.24715e+13,16.2913,175.393,2056,18,17,2004,1865,1749,1709,1338
27519,4,44,27519,0,0,27519,326502000,26.7325,701.33,27519,36,37,20597,16166,15894,16199,4995
45488,14,56,45488,0,0,45488,5.65366e+15,28.2901,884.409,45488,38,40,44959,44332,42150,14510,27133
18494,314,410,18494,0,7519,10975,5.4701e+16,20.3816,1026.44,18494,159,66,18084,18081,18082,18070,18064
47298,25,44,47298,0,0,47298,4.33128e+15,36.7038,1130.74,47298,40,37,46944,46026,45651,23493,34827
32001,4,40,32001,0,32001,0,1.45508e+18,26.508,665.888,32001,30,29,23749,18236,17630,3881,9048
32328,36,40,32328,0,0,32328,340003000,21.6591,672.727,32328,30,29,32288,32273,32288,32286,32288
21992,28,40,21992,0,0,21992,5.70783e+15,21.725,608.634,21992,30,29,21952,21934,21944,21952,21126
48608,32,40,0,48608,0,48608,1330610,30.1602,894.57,48608,32,31,48560,48518,48549,48548,45252
39646,1,2,39646,0,39646,0,3.29497e+13,1.99985,262.384,39646,2,2,35004,35004,35004,35004,35004
39535,24,40,0,39535,0,39535,1301360,34.3995,779.582,39535,38,37,39393,39234,39275,39266,28766
29237,24,38,29237,0,0,29237,340360000,26.8449,708.57,29237,31,30,29185,29143,29160,29161,29185
44363,16,21,0,44363,7272,37091,5185.18,14.0158,614.616,44363,21,20,44329,44329,44327,44329,44305
48789,38,44,48789,0,0,48789,5.52612e+15,34.4912,908.918,48789,38,38,48741,48685,48591,42498,47579
26049,1,2,0,26049,26049,0,1.07828e+16,1.99954,214.329,26049,2,2,22150,22150,22150,22150,22150
1206,16,18,0,1206,0,1206,1344190,12.4312,120.428,1206,14,15,1188,1184,1188,1187,1188
31263,8,20,0,31263,5312,25951,5204.8,12.0774,533.331,31263,20,19,31011,31010,29747,29745,30575
6760,1,36,0,6760,0,6760,970747,29.5386,403.509,6760,31,33,467,467,467,467,467
25777,36,40,25777,0,0,25777,335058000,31.835,634.709,25777,37,37,25733,25697,25689,22498,25693
14853,14,19,2337,12516,0,14853,20.0692,11.9008,342.965,14853,19,18,14821,14821,14820,14821,14789
2528,1,2,0,2528,2528,0,8.43712e+15,1.99723,66.773,2528,2,2,2231,2231,2231,2231,2231
9185,8,40,9185,0,9185,0,8.6741e+10,20.8363,402.214,9185,27,26,8283,6896,6339,6935,3129
28142,1,2,28142,0,28142,0,4.53889e+13,1.99876,229.021,28142,2,2,23603,23603,23603,23603,23603
16053,4,36,16053,0,0,16053,332476000,23.5127,480.488,16053,35,33,12157,9479,9222,9734,4154
5516,1,2,0,5516,5516,0,8.38669e+15,1.99619,98.482,5516,2,2,4873,4873,4873,4873,4873
14042,8,13,2403,11639,0,14042,20.429,11.181,341.032,14042,13,12,13936,13936,13416,13415,13846
25367,1,2,0,25367,25367,0,8.4792e+15,1.99953,209.625,25367,2,2,22381,22381,22381,22381,22381
11691,12,22,0,11691,0,11691,1339470,20.311,414.396,11691,21,22,11332,10577,9804,10168,8067
19941,12,19,0,19941,3601,16340,5162.36,17.6494,459.239,19941,19,19,19887,19887,19887,19887,19831
26857,37,40,26857,0,26857,0,1.30249e+18,34.5531,749.776,26857,38,37,26811,26771,26633,24018,25759
25438,10,56,0,25438,25438,0,2.22249e+13,21.8957,657.579,25438,31,32,24330,23365,20510,20460,12965
49358,23,30,8289,41069,0,49358,19.6289,19.1251,743.025,49358,22,28,49328,49328,49328,49328,48593
32440,34,60,0,32440,0,32440,1270520,34.9486,829.021,32440,37,43,32368,32277,32193,32196,22605
17690,349,410,17690,0,9549,8141,5.63232e+16,16.0765,968.161,17690,159,66,17280,17278,17280,17278,17266
4812,1,2,4812,0,4812,0,3.42192e+13,1.99626,91.9128,4812,2,2,4226,4226,4226,4226,4226
33151,24,48,0,33151,0,33151,5.56429e+14,35.9957,969.983,33151,38,41,32851,32233,31356,30134,23362
10770,11,36,0,10770,0,10770,1116070,26.3053,482.851,10770,36,29,9698,8506,9108,9079,4239
1538,1,2,1538,0,1538,0,3.22104e+13,1.9909,51.4455,1538,2,2,1361,1361,1361,1361,1361
38477,4,19,0,38477,6916,31561,5170.41,15.909,633.432,38477,19,19,33528,33528,30195,23371,18374
35795,13,40,35795,0,0,35795,5.6194e+15,33.5323,729.066,35795,37,37,35294,33960,34265,6308,19800
6608,8,38,6608,0,0,6608,331492000,27.3369,355.681,6608,30,29,5768,4624,4179,3647,2604
12917,1,2,12917,0,12917,0,4.11197e+13,1.99907,152.823,12917,2,2,11029,11029,11029,11029,11029
30529,13,24,30529,0,30529,0,87404100000,21.475,654.058,30529,24,22,30037,28379,26973,28518,22562
18160,15,36,18160,0,0,18160,333704000,23.2121,526.603,18160,36,33,17987,17719,17825,17819,11817
43690,35,40,43690,0,0,43690,5.65494e+15,28.9165,814.366,43690,38,37,43639,43572,43596,36546,43595
32676,42,44,0,32676,32676,0,2.08945e+13,36.7135,790.364,32676,37,37,32632,32613,32600,32613,32632
26374,8,56,26358,16,26358,16,9.58482e+12,34.7508,857.437,26374,47,37,16802,11060,12433,6931,6559
2674,1,2,0,2674,2674,0,8.24593e+15,1.98953,68.3073,2674,2,2,2367,2367,2367,2367,2367
32462,3,60,32462,0,32462,0,79510500000,31.6444,928.092,32462,38,44,21039,18070,16693,16048,5131
42368,20,44,0,42368,42368,0,1.84986e+13,38.2974,1026.18,42368,38,39,41501,39566,39899,37993,23607
46965,31,60,46965,0,46965,0,84324200000,34.7165,1105.7,46965,38,52,46834,46505,46557,46538,41579
35506,5,40,0,35506,35506,0,2.20226e+13,33.5575,858.913,35506,38,36,26949,19877,19545,23425,9380
23149,1,56,23149,0,23149,0,86251100000,23.5379,670.887,23149,31,39,2455,2455,2455,2455,2455
3744,35,36,3744,0,3744,0,85105500000,14.5785,222.496,3744,24,25,3708,3700,3708,3707,3708
1540,22,36,1540,0,0,1540,319334000,13.8195,148.49,1540,21,20,1504,1492,1499,1499,1329
8434,15,36,8434,0,8434,0,1.16399e+18,29.1641,432.509,8434,34,29,7816,6285,7391,2201,4809
7814,20,60,0,7814,7814,0,2.16734e+13,21.3835,474.951,7814,30,44,7729,7565,7612,7606,6904
49365,19,44,0,49365,49365,0,2.05097e+13,36.4652,1001.71,49365,41,37,48688,47381,48048,46696,23769
12604,1,2,12604,0,12604,0,3.26273e+13,1.99913,148.351,12604,2,2,11142,11142,11142,11142,11142
10721,36,56,10721,0,0,10721,5.57426e+15,21.9909,494.683,10721,30,39,10665,10655,10626,10441,9972
29884,20,65,29883,1,29883,1,2.87209e+12,32.4741,1056.96,29884,37,48,29247,26811,27045,19447,13606
11584,11,44,11584,0,11584,0,1.44424e+18,18.3975,449.942,11584,20,37,11220,10701,10090,8724,7120
31779,36,64,31779,0,0,31779,300179000,34.9215,1113.82,31779,38,55,31703,31553,31448,30467,22761
47068,16,21,7605,39463,0,47068,20.1074,15.0486,643.319,47068,21,21,47024,47023,47006,47006,46920
25560,2,4,0,25560,25560,0,8.28268e+15,3.60845,222.985,25560,4,4,25546,25542,25546,25546,23379
47505,23,56,0,47505,47505,0,2.23089e+13,22.4699,863.912,47505,32,32,47444,47375,47385,47407,45606
19184,17,44,19184,0,0,19184,4.51962e+15,31.1177,715.964,19184,35,37,18180,12749,16822,7987,8667
24525,34,40,24525,0,24525,0,87165900000,22.1783,627.451,24525,32,24,24485,24471,24482,24482,24485
4374,1,2,4374,0,4374,0,3.29481e+13,1.99794,87.3636,4374,2,2,3861,3861,3861,3861,3861
18429,15,56,0,18429,0,18429,1327050,22.5427,577.434,18429,31,32,18191,17830,17274,17266,13845
2949,20,22,2949,0,0,2949,5.72762e+15,17.374,208.405,2949,19,19,2927,2915,2925,2786,2927
22332,13,24,0,22332,22332,0,2.24075e+13,21.4993,552.938,22332,22,22,21976,20768,19551,20936,15155
7366,9,19,1161,6205,0,7366,19.4146,10.1772,251.722,7366,17,18,7297,7297,7279,7295,7199
21657,10,40,21657,0,21657,0,1.45031e+18,27.5586,545.5,21657,29,29,21011,20401,18522,3510,11004
1168,1,2,0,1168,1168,0,8.26688e+15,1.98373,45.4795,1168,2,2,1033,1033,1033,1033,1033
2021,17,44,2021,0,2021,0,64851700000,23.6358,262.244,2021,26,39,1869,1001,1644,1592,550
21932,4,40,0,21932,0,21932,1324230,22.9337,562.075,21932,30,29,16177,12397,11992,11228,5526
32723,12,44,32723,0,0,32723,5.24941e+15,33.1615,845.055,32723,37,41,31003,28575,28941,7016,15251
9279,1,4,0,9279,9279,0,8.34032e+15,1.9986,132.691,9279,3,3,8202,8202,8202,8202,8202
8316,18,54,8310,6,8310,6,1.01485e+13,20.9982,517.15,8316,33,45,8102,7657,7842,7428,6044
46368,9,21,7454,38914,0,46368,19.9323,17.6478,647.398,46368,21,21,46104,46104,46018,46062,45594
17971,1,21,0,17971,2838,15133,5160.06,10.3678,377.769,17971,19,20,3226,3226,3226,3226,3226
581,7,12,581,0,581,0,1.43371e+18,9.28055,68.5311,581,11,10,542,497,491,443,398
18578,1,4,0,18578,18578,0,8.34686e+15,2.45409,198.183,18578,4,4,16399,16399,16399,16399,16399
10220,14,24,10220,0,10220,0,1.46783e+18,18.0073,370.001,10220,20,21,10130,10028,9072,8288,8098
37094,25,38,0,37094,37094,0,2.19582e+13,36.4844,875.792,37094,38,38,36909,36582,36707,36663,29113
46779,1,2,46779,0,46779,0,3.66804e+13,1.99976,285.636,46779,2,2,40682,40682,40682,40682,40682
30177,27,40,30177,0,30177,0,1.45232e+18,26.8682,644.971,30177,30,29,30124,30083,30112,18056,30034
34771,1,2,0,34771,34771,0,1.2144e+16,1.9994,252.601,34771,2,2,28910,28910,28910,28910,28910
3770,5,13,626,3144,0,3770,20.1931,9.13687,180.594,3770,11,12,3517,3517,3132,3110,2911
31189,1,2,0,31189,31189,0,8.41199e+15,1.99971,233.164,31189,2,2,27547,27547,27547,27547,27547
16066,1,4,0,16066,16066,0,8.33331e+15,2.00012,172.7,16066,3,3,14205,14205,14205,14205,14205
45916,3,4,0,45916,45916,0,8.38653e+15,1.99989,288.314,45916,3,3,45912,45910,45911,45911,45912
32307,1,2,0,32307,32307,0,8.71195e+15,1.99941,236.679,32307,2,2,28400,28400,28400,28400,28400
19749,26,40,19749,0,0,19749,340679000,22.4808,573.242,19749,31,24,19709,19695,19699,19701,19709
9037,8,19,1377,7660,0,9037,19.9659,10.1482,259.92,9037,19,18,8986,8986,8945,8950,8946
25091,32,40,25091,0,0,25091,340714000,21.5344,633.144,25091,31,24,25051,25035,25046,25046,25051
21294,44,56,21294,0,0,21294,5.68317e+15,20.1328,608.247,21294,30,32,21238,21228,21238,21238,21236
47130,46,66,47130,0,47130,0,1.25297e+18,35.0684,1394.24,47130,51,50,47064,47056,47057,43360,32392
2834,11,12,494,2340,0,2834,20.4023,8.91426,155.899,2834,11,11,2821,2821,2821,2820,2821
41199,1,2,0,41199,41199,0,8.88848e+15,1.99973,267.21,41199,2,2,36116,36116,36116,36116,36116
41212,3,40,41212,0,41212,0,1.4656e+18,22.9884,796.622,41212,30,29,26662,22502,19973,4653,7454
37805,39,40,37805,0,37805,0,85296300000,35.2573,766.914,37805,38,37,37764,37708,37753,37753,37764
36634,1,2,36634,0,36634,0,3.54514e+13,1.99956,253.9,36634,2,2,32019,32019,32019,32019,32019
33516,22,65,33515,1,0,33516,1.09648e+15,32.0637,1108.79,33516,38,48,33144,32179,31341,28400,15002
40953,16,40,0,40953,0,40953,1215800,31.9579,911.594,40953,40,37,39879,36991,38956,38935,22843
4498,9,12,818,3680,0,4498,20.3619,10.8077,201.977,4498,12,12,4453,4453,4416,4415,4399
14582,8,32,2781,11801,0,14582,20.0326,11.1885,468.738,14582,19,24,14300,14268,13717,13716,13265
30234,11,40,30234,0,0,30234,340827000,22.7639,689.712,30234,32,28,29181,27721,25497,25316,15614
27002,9,28,0,27002,4667,22335,5163.8,12.5867,539.644,27002,20,21,26811,26811,26527,26535,20836
5133,7,12,0,5133,920,4213,5234.91,10.7035,212.039,5133,12,12,4995,4995,4671,4800,4028
35629,18,40,0,35629,35629,0,2.20345e+13,29.9116,738.657,35629,38,37,35476,35305,35348,35153,26518
6459,13,17,1098,5361,0,6459,18.7082,12.0108,244.287,6459,17,17,6414,6414,6396,6400,6030
27750,3,20,0,27750,4745,23005,5209.3,11.7747,503.509,27750,20,17,21469,21469,21279,16001,12483
38051,41,56,0,38051,0,38051,1324330,38.092,806.46,38051,40,31,37995,37967,37987,37983,37993
2380,1,2,2380,0,2380,0,3.24051e+13,1.99664,64.9714,2380,2,2,2105,2105,2105,2105,2105
16927,50,56,16927,0,16927,0,86481900000,20.1618,553.744,16927,30,32,16871,16861,16871,16871,16871
15141,31,36,15141,0,0,15141,331338000,23.8358,465.57,15141,34,33,15094,15033,15060,12967,15055
48452,2,40,48452,0,0,48452,5.71153e+15,35.5222,902.859,48452,33,31,26031,26030,17002,5029,7245
1791,16,22,1791,0,0,1791,338579000,19.5556,170.667,1791,17,19,1756,1709,1683,1682,1347
13284,10,40,13284,0,13284,0,1.24023e+18,31.297,550.83,13284,34,37,11792,10468,10781,3099,5415
30466,5,40,0,30466,30466,0,2.23377e+13,23.1254,694.428,30466,31,28,23929,17738,17760,21003,8300
32846,3,40,32846,0,32846,0,8.6436e+10,27.7885,676.57,32846,31,29,22136,18834,17011,17859,7681
47063,12,60,0,47063,47063,0,2.20899e+13,34.5824,942.569,47063,40,40,45789,43265,40258,42185,25170
2730,1,2,0,2730,2730,0,1.9189e+16,1.99304,73.1815,2730,2,2,2002,2002,2002,2002,2002
8602,11,19,1594,7008,0,8602,19.721,14.7524,309.467,8602,19,19,8530,8527,8530,8529,8443
11485,4,22,11485,0,11485,0,1.46823e+18,20.7763,419.052,11485,22,22,8045,6065,5925,1571,2799
17369,13,40,17369,0,17369,0,85286100000,23.4592,520.489,17369,33,37,17085,16423,16650,16487,10824
30336,39,44,30336,0,0,30336,5.3736e+15,37.4898,760.044,30336,37,37,30291,30245,30225,28163,30288
38595,33,44,38595,0,0,38595,309151000,35.3727,915.121,38595,37,41,38526,38408,38285,34866,35764
595,15,16,0,595,595,0,2.17981e+13,11.2151,75.4451,595,11,13,579,573,577,577,579
34814,1,2,0,34814,34814,0,1.12928e+16,1.99957,249.554,34814,2,2,29357,29357,29357,29357,29357
11342,1,38,0,11342,11342,0,2.22085e+13,21.6568,448.983,11342,25,29,1096,1096,1096,1096,1096
17268,13,36,17268,0,17268,0,1.43402e+18,23.4042,507.425,17268,36,33,16996,16331,16533,3368,10127
26610,21,40,0,26610,26610,0,2.06867e+13,31.4498,693.659,26610,37,35,26328,25850,26086,25369,18128
11877,29,36,11877,0,11877,0,1.39698e+18,29.2284,413.739,11877,33,33,11823,11734,11781,9958,11601
1161,19,22,1161,0,0,1161,5.64114e+15,14.2584,134.925,1161,17,18,1139,1129,1138,1016,1138
36431,33,40,36431,0,0,36431,5.73059e+15,22.1966,758.511,36431,32,29,36391,36373,36386,36391,36391
1084,19,32,0,1084,0,1084,1124510,17.6799,143.867,1084,22,27,1028,974,1000,1002,772
19338,18,40,0,19338,19338,0,2.16339e+13,33.8155,566.274,19338,37,36,19163,18986,19067,18812,13720
29611,3,38,29611,0,0,29611,334883000,37.0068,809.305,29611,38,38,18235,15313,12609,5797,3595
9837,14,44,9837,0,0,9837,5.3508e+15,24.2037,470.398,9837,29,37,9486,8962,9114,5655,6829
43392,8,54,0,43392,0,43392,4.25106e+14,36.3298,1158.26,43392,44,45,33066,25659,26652,18718,12493
26887,1,48,0,26887,0,26887,1132360,28.0286,869.536,26887,35,41,2385,2385,2385,2385,2385
29909,22,40,29909,0,29909,0,8.7128e+10,22.759,686.201,29909,32,25,29863,29819,29827,29836,27795
15766,5,24,15766,0,0,15766,342602000,21.0528,481.428,15766,23,22,12239,9036,9103,7608,4513
3904,5,22,0,3904,3904,0,2.21716e+13,20.7608,249.638,3904,21,22,2942,2167,2212,2567,1033
10513,38,44,10513,0,0,10513,287618000,27.9782,544.586,10513,33,41,10469,10461,10330,9732,9079
10636,28,36,10636,0,0,10636,5.63458e+15,17.7127,362.505,10636,26,25,10600,10585,10598,9075,10598
26718,16,24,0,26718,0,26718,1336220,21.6243,611.388,26718,24,22,26571,26176,25604,25601,20312
49583,1,2,49583,0,49583,0,3.26021e+13,1.9999,295.015,49583,2,2,43839,43839,43839,43839,43839
33628,10,20,0,33628,5795,27833,5193.26,17.166,569.795,33628,20,20,33530,33530,33436,33435,33446
11430,10,19,1999,9431,0,11430,18.638,14.2674,335.817,11430,18,18,11273,11268,11207,11249,3452
6053,28,44,6053,0,0,6053,4.82316e+15,21.6729,429.507,6053,26,37,6009,6002,5957,5945,4370
28071,1,2,0,28071,28071,0,8.77906e+15,1.99957,220.686,28071,2,2,24650,24650,24650,24650,24650
40708,1,2,0,40708,40708,0,8.39209e+15,1.99961,266.418,40708,2,2,35966,35966,35966,35966,35966
36595,1,2,36595,0,36595,0,3.25279e+13,1.99964,253.383,36595,2,2,32365,32365,32365,32365,32365
14669,4,33,0,14669,4282,10387,4.91209e+12,13.8202,562.755,14669,19,25,10844,10844,10180,8342,4998
38706,19,65,0,38706,38705,1,5.72868e+14,30.2787,1181.1,38706,37,48,37879,35030,35628,34624,21908
34714,1,40,34714,0,0,34714,336911000,27.7344,705.655,34714,33,29,4136,4136,4136,4136,4136
26727,56,60,0,26727,26727,0,2.11994e+13,37.761,759.965,26727,36,42,26667,26655,26665,26667,24117
6826,17,32,6826,0,6826,0,1.0105e+18,27.3654,404.672,6826,31,29,6316,3100,5508,3375,4133
10572,1,2,10572,0,10572,0,3.31742e+13,1.99792,135.32,10572,2,2,9325,9325,9325,9325,9325
26865,52,56,26865,0,0,26865,5.70435e+15,22.8635,637.82,26865,31,29,26809,26805,26809,26809,20917
6483,29,36,6483,0,0,6483,5.44628e+15,18.4976,311.534,6483,30,32,6441,6409,6406,5791,6382
26038,18,21,4607,21431,0,26038,18.7409,16.9848,521.456,26038,21,19,26006,26003,25917,25918,25996
20937,27,40,20937,0,20937,0,1.15201e+18,32.7259,741.058,20937,36,37,20821,20394,20545,15569,17465
25774,365,406,25774,0,20876,4898,3.79768e+16,7.27846,909.765,25774,159,62,25368,25366,25368,25368,25360
17824,41,44,17824,0,0,17824,327879000,32.4453,573.338,17824,29,37,17780,17765,17748,17599,17778
21920,32,38,21920,0,0,21920,5.69797e+15,29.1615,621.471,21920,31,30,21876,21834,21867,21875,21876
49490,26,56,0,49490,49490,0,2.21126e+13,28.1548,919.314,49490,37,40,49390,49286,49329,49305,43268
22486,1,2,22486,0,22486,0,3.21206e+13,1.99924,199.255,22486,2,2,19919,19919,19919,19919,19919
27225,4,44,27225,0,0,27225,4.45997e+15,37.1938,859.31,27225,37,37,16662,13456,13634,4939,4519
9768,26,36,9768,0,0,9768,5.49476e+15,25.6171,379.602,9768,32,33,9706,9632,9664,5285,8128
9974,33,36,9974,0,0,9974,327827000,25.2795,382.759,9974,32,33,9934,9900,9908,9890,9908
3366,9,12,0,3366,608,2758,5213.7,10.5954,174.091,3366,12,12,3331,3331,3308,3307,3295
21132,20,40,0,21132,21132,0,1.91835e+13,35.7927,685.2,21132,36,37,20728,19996,20228,19263,12434
25723,23,40,0,25723,0,25723,1102190,32.546,772.991,25723,37,37,25411,24407,24950,24951,18306
45974,37,40,45974,0,45974,0,1.26418e+18,34.4685,1022.76,45974,40,37,45927,45884,45744,42135,45246
17892,29,40,0,17892,17892,0,2.21726e+13,21.8882,505.209,17892,29,29,17852,17834,17848,17835,17850
25919,4,20,4458,21461,0,25919,20.3528,11.9469,488.727,25919,20,17,23007,23007,20893,15664,15847
48508,2,4,0,48508,48508,0,9.09856e+15,1.99977,296.923,48508,3,3,48503,48502,48503,48503,45250
36349,3,4,0,36349,36349,0,8.39142e+15,2,257.241,36349,3,3,36345,36343,36344,36344,36345
37209,11,44,0,37209,0,37209,1273270,33.1309,798.38,37209,37,37,35991,34456,33878,33873,16698
43584,96,374,43565,19,0,43584,2.11325e+16,6.22963,1000.61,43584,129,67,43210,43166,43130,43124,43089
33476,1,28,5638,27838,0,33476,20.2684,11.609,564.459,33476,20,21,5584,5584,5584,5584,5584
40513,11,60,40513,0,0,40513,5.55999e+15,26.685,913.943,40513,34,40,38892,36819,34958,16716,17494
30131,1,4,0,30131,30131,0,8.39169e+15,1.99967,234.651,30131,3,3,26619,26619,26619,26619,26619
36289,14,40,36289,0,36289,0,75529100000,35.1416,893.939,36289,39,37,34195,30251,32942,31040,15628
39746,12,40,39746,0,0,39746,340311000,32.4562,812.842,39746,32,31,38564,36154,33444,33171,21010
9550,5,13,0,9550,1566,7984,5211.36,9.91696,271.091,9550,12,12,8975,8975,8008,7989,7985
32688,15,28,0,32688,5464,27224,5177.45,12.2903,558.815,32688,20,21,32651,32651,32650,32650,32644
35829,1,2,0,35829,35829,0,1.08743e+16,1.99939,251.834,35829,2,2,30421,30421,30421,30421,30421
43266,1,4,0,43266,43266,0,9.39983e+15,1.99998,280.742,43266,3,3,37619,37619,37619,37619,37619
2088,11,22,0,2088,0,2088,1327420,18.3051,181.124,2088,18,20,1965,1822,1707,1725,1308
9667,7,40,9667,0,9667,0,74477500000,30.0761,475.494,9667,32,37,8008,6899,6800,6623,3029
11529,34,44,11529,0,0,11529,326993000,19.515,487.751,11529,28,37,11485,11478,11434,11276,11027
3308,3,28,717,2591,0,3308,18.6977,16.9537,240.936,3308,18,27,2355,2353,1932,1511,1407
35053,19,23,0,35053,6140,28913,4883.55,19.4116,616.653,35053,21,21,35022,35022,34918,34920,34690
14673,10,38,14673,0,0,14673,5.68375e+15,32.269,516.804,14673,31,29,13773,13041,11264,9074,7288
48718,14,23,0,48718,11352,37366,4449.98,19.4005,816.908,48718,23,21,48500,48480,48126,48150,41516
46787,16,40,46787,0,46787,0,86754900000,26.7397,826.702,46787,34,29,46542,46009,45446,45734,32948
33298,13,48,0,33298,33298,0,2.08238e+13,37.5797,848.574,33298,37,41,31966,29635,30866,30049,16200
34466,4,20,5976,28490,0,34466,20.2818,17.3332,578.943,34466,20,20,30476,30476,27622,23379,22082
5652,9,20,5652,0,0,5652,5.73249e+15,15.5635,257.106,5652,17,18,5361,4559,4751,3199,3910
14512,1,2,0,14512,14512,0,8.38156e+15,1.99828,159.485,14512,2,2,12823,12823,12823,12823,12823
41021,42,60,41021,0,0,41021,5.50132e+15,32.1817,1041.48,41021,38,51,40961,40951,40928,38799,36607
11418,22,24,11418,0,0,11418,339570000,18.4384,384.106,11418,21,21,11394,11384,11376,11375,11394
26712,1,13,4371,22341,0,26712,20.3196,11.3937,458.354,26712,13,13,4559,4559,4559,4559,4559
47943,26,44,47943,0,47943,0,1.41603e+18,36.3983,916.27,47943,38,38,47779,47470,47527,13750,35127
25496,4,19,4589,20907,0,25496,20.2264,16.292,512.937,25496,19,19,22207,22207,20030,15299,16130
16230,13,44,16230,0,16230,0,1.41064e+18,30.8298,553.634,16230,28,37,15822,14925,15265,4422,10675
24229,32,40,24229,0,24229,0,1.46459e+18,21.4707,624.4,24229,29,29,24189,24173,24182,21754,23241
16532,10,40,16532,0,0,16532,317497000,30.6055,541.58,16532,34,35,15720,15012,14458,14439,7084
8689,31,36,8689,0,0,8689,326160000,26.7018,362.237,8689,32,33,8644,8586,8608,7472,8603
16153,26,38,16153,0,16153,0,1.45932e+18,31.266,539.916,16153,30,30,16103,16069,16083,13456,16103
14183,24,36,0,14183,14183,0,2.12711e+13,29.2021,465.475,14183,33,33,14083,13960,14004,13852,11528
6932,3,24,6932,0,6932,0,87398800000,20.8585,312.349,6932,20,19,4506,3806,3388,3780,1707
44263,16,21,0,44263,7159,37104,5142.19,15.5014,627.053,44263,21,21,44219,44218,44201,44201,44115
12289,15,36,0,12289,0,12289,1259480,29.7455,433.918,12289,33,33,12081,11789,11958,11954,5291
34159,4,5,6,34153,34159,0,1.24164e+16,1.9998,257.344,34159,4,3,34154,34152,34154,34154,34154
23115,16,20,0,23115,3951,19164,5197.97,12.2769,465.602,23115,18,19,23092,23092,23092,23092,23079
36661,11,21,6111,30550,0,36661,20.3163,12.1281,561.073,36661,21,20,36616,36616,36601,36605,36563
9124,16,40,9124,0,9124,0,8.621e+10,17.9908,366.061,9124,25,29,9062,8969,8980,8910,7574
35487,1,2,35487,0,35487,0,5.91869e+13,1.99977,258.485,35487,2,2,28024,28024,28024,28024,28024
39200,39,40,39200,0,0,39200,5.64791e+15,30.0966,778.15,39200,39,37,39158,39117,39148,35910,39149
15652,1,28,2628,13024,0,15652,20.0956,10.9758,404.602,15652,19,21,2657,2657,2657,2657,2657
45147,1,40,45147,0,0,45147,337526000,28.9852,836.113,45147,40,37,5201,5201,5201,5201,5201
45196,15,44,45196,0,0,45196,5.52455e+15,37.2716,895.465,45196,37,38,44554,43432,44013,9589,26325
48856,1,4,48856,0,48856,0,5.22379e+13,1.99982,306.331,48856,3,3,40296,40296,40296,40296,40296
3440,13,25,825,2615,0,3440,19.0651,10.0119,252.138,3440,13,23,3415,3415,3415,3415,2601
17551,21,40,0,17551,0,17551,953702,33.2047,678.434,17551,35,33,17196,15314,15744,15737,11846
29666,25,40,29666,0,0,29666,335492000,30.3988,674.533,29666,37,37,29577,29486,29510,9992,23073
17361,18,36,17361,0,0,17361,327682000,26.8821,506.595,17361,35,33,17207,17029,17115,15342,8574
49653,2,31,0,49653,10566,39087,1.45118e+12,20.0151,845.811,49653,22,24,32793,32793,32559,26735,25650
23606,38,40,23606,0,0,23606,5.71893e+15,32.2995,635.467,23606,31,30,23566,23540,23566,23563,22227
33275,1,2,33275,0,33275,0,3.398e+13,1.99964,240.336,33275,2,2,29257,29257,29257,29257,29257
5549,4,40,0,5549,5549,0,1.86685e+13,22.0249,387.077,5549,29,37,3570,2826,2784,2830,1220
28422,13,20,0,28422,4829,23593,5196.34,12.2669,513.056,28422,20,15,28395,28395,28395,28395,28395
40431,25,60,40431,0,40431,0,1.41831e+18,33.9465,1095.42,40431,46,46,40217,39844,39930,28153,36450
7182,15,40,0,7182,0,7182,1327690,18.2665,334.166,7182,19,29,7110,7025,7040,7037,6508
28202,1,2,0,28202,28202,0,9.90338e+15,1.99929,222.545,28202,2,2,24325,24325,24325,24325,24325
22134,25,28,4143,17991,0,22134,19.6729,17.6456,566.16,22134,19,28,22106,22106,22106,22106,22035
24213,20,24,24213,0,0,24213,342074000,21.7652,585.951,24213,24,22,24175,24111,24101,24100,22034
27282,1,4,0,27282,27282,0,1.20413e+16,1.99938,227.546,27282,3,3,22720,22720,22720,22720,22720
49539,20,44,0,49539,0,49539,1200020,37.0751,1046.67,49539,41,41,48885,47728,48010,48017,31482
9543,16,38,0,9543,0,9543,1326210,20.9364,412.527,9543,29,27,9407,9117,9015,8955,7918
47160,32,44,47160,0,0,47160,314245000,38.2199,1007.08,47160,41,41,47072,46951,46698,40128,36864
9470,23,36,9470,0,0,9470,5.59288e+15,22.9173,348.874,9470,26,25,9421,9385,9410,2743,9248
37512,1,2,0,37512,37512,0,8.39635e+15,1.99955,255.358,37512,2,2,33140,33140,33140,33140,33140
32891,4,40,32891,0,0,32891,332853000,29.7341,708.191,32891,37,37,24768,19283,18807,19196,7433
14844,1,2,14844,0,14844,0,3.25771e+13,1.99879,160.938,14844,2,2,13125,13125,13125,13125,13125
1423,3,13,0,1423,229,1194,5085.46,8.34153,114.576,1423,11,12,1124,1124,1111,893,568
13654,16,40,0,13654,13654,0,1.87975e+13,34.3709,570.582,13654,36,37,12958,10685,12255,11589,7071
30572,1,2,30572,0,30572,0,3.43419e+13,1.99915,230.253,30572,2,2,26841,26841,26841,26841,26841
34380,6,30,6024,28356,0,34380,19.6631,14.5935,646.592,34380,20,26,33049,33049,32025,32065,30512
30889,7,40,30889,0,0,30889,340700000,22.7053,697.33,30889,32,24,27230,23507,20288,20940,11950
33366,30,56,0,33366,33366,0,2.22467e+13,22.39,739.694,33366,32,32,33310,33290,33300,33301,32657
35221,19,38,35221,0,35221,0,86934400000,30.7431,792.73,35221,33,31,35046,34755,34696,34635,32400
38312,14,21,6357,31955,0,38312,20.3109,12.1498,570.859,38312,21,20,38284,38284,38284,38284,38281
17542,35,40,17542,0,0,17542,333624000,23.4158,525.074,17542,35,37,17500,17462,17457,15163,17452
1439,4,38,0,1439,1439,0,2.17977e+13,19.836,176.608,1439,20,26,976,736,666,863,335
17219,1,2,17219,0,17219,0,3.26445e+13,1.99866,174.001,17219,2,2,15221,15221,15221,15221,15221
45113,48,325,0,45113,6215,38898,1.5367e+13,12.55,1137.18,45113,127,48,44785,44728,44648,44638,44631
35620,13,56,35620,0,35620,0,87011600000,22.0226,760.607,35620,32,32,34993,33049,31581,33209,22543
13536,52,56,13536,0,13536,0,1.41398e+18,25.9746,529.519,13536,41,40,13480,13470,13480,11967,13440
31664,35,40,31664,0,0,31664,5.70143e+15,21.7968,662.712,31664,30,29,31624,31607,31624,27085,31624
2265,9,17,456,1809,0,2265,17.0649,12.8826,151.012,2265,16,16,2186,2186,2164,2185,865
19499,32,44,19499,0,0,19499,5.39744e+15,28.6678,610.242,19499,34,37,19443,19387,19314,11138,17111
49379,19,48,0,49379,49379,0,1.92952e+13,37.1359,1125.28,49379,39,41,48391,45816,46748,44938,26685
32420,17,44,32420,0,0,32420,4.39077e+15,37.3886,943.189,32420,38,37,30496,19439,27695,10520,17820
40191,39,44,40191,0,40191,0,80565100000,35.0125,916.933,40191,40,41,40145,40094,39923,39904,38727
40770,34,40,40770,0,0,40770,5.71713e+15,31.3384,834.323,40770,32,30,40721,40658,40712,40716,39409
11110,1,2,0,11110,11110,0,8.4705e+15,1.99784,138.34,11110,2,2,9803,9803,9803,9803,9803
13995,10,38,13995,0,13995,0,87271800000,20.5561,487.48,13995,30,24,13223,12573,10935,10811,7965
32049,1,2,32049,0,32049,0,3.4305e+13,1.99934,235.722,32049,2,2,28142,28142,28142,28142,28142
28324,1,2,28324,0,28324,0,3.41658e+13,1.9988,221.796,28324,2,2,24885,24885,24885,24885,24885
1881,25,36,1881,0,1881,0,1.41893e+18,12.1233,168.242,1881,20,25,1845,1837,1841,1358,1843
49203,1,2,49203,0,49203,0,3.35576e+13,1.99949,292.453,49203,2,2,43336,43336,43336,43336,43336
49670,9,23,13083,36587,0,49670,16.4688,19.869,835.566,49670,23,21,48113,48113,47143,47429,24540
30721,15,23,0,30721,5371,25350,4889.11,16.8952,575.559,30721,20,21,30652,30652,30567,30573,29865
29750,1,2,0,29750,29750,0,1.30527e+16,1.99976,234.976,29750,2,2,24360,24360,24360,24360,24360
8838,8,40,0,8838,0,8838,1210880,22.4389,407.219,8838,31,33,8015,7168,7107,7184,3732
24605,37,40,24605,0,24605,0,87226700000,21.7299,630.455,24605,30,28,24565,24551,24564,24564,23239
38639,1,4,0,38639,38639,0,8.33794e+15,3.21152,267.798,38639,4,4,34163,34163,34163,34163,34163
42123,1,2,0,42123,42123,0,9.5112e+15,1.99967,271.163,42123,2,2,36562,36562,36562,36562,36562
14608,6,24,0,14608,14608,0,2.24843e+13,20.0411,454.625,14608,21,21,12352,10990,8745,10714,5490
14710,23,40,14710,0,14710,0,1.42779e+18,24.6411,489.041,14710,32,37,14631,14539,14569,9844,12769
37411,411,2051,0,37411,0,37411,5.80894e+16,78.9314,3907.63,37411,352,173,35360,34831,33786,7623,4442
32641,36,44,0,32641,32641,0,2.11097e+13,33.9559,763.935,32641,37,37,32595,32568,32488,32492,32202
37047,38,40,37047,0,37047,0,1.46298e+18,28.3786,793.309,37047,32,31,37006,36979,37001,35244,35826
37789,14,40,37777,12,37789,0,2.36255e+14,1.77065,425.085,37789,17,16,37737,37723,37626,37625,37558
7352,17,24,0,7352,7352,0,2.22768e+13,18.34,314.894,7352,19,21,7316,7229,7243,7236,6378
35326,1,2,35326,0,35326,0,3.25251e+13,1.99904,249.041,35326,2,2,31243,31243,31243,31243,31243
14817,1,2,14817,0,14817,0,3.34723e+13,1.99831,160.127,14817,2,2,13054,13054,13054,13054,13054
29874,6,38,29874,0,0,29874,335380000,34.244,787.201,29874,36,38,24362,21218,17098,12403,8740
29054,33,40,29054,0,29054,0,1.43828e+18,30.3597,665.593,29054,37,37,29001,28943,28949,25564,28751
17581,17,24,17581,0,17581,0,1.47127e+18,21.133,499.522,17581,23,22,17502,17190,17296,14120,13753
39983,32,40,39983,0,39983,0,87167800000,22.2652,758.783,39983,32,29,39943,39926,39941,39929,39941
29903,19,40,29903,0,29903,0,1.45901e+18,22.0324,646.407,29903,30,29,29842,29742,29766,10708,27649
10446,45,65,10445,1,0,10446,3.51806e+15,32.7728,669.433,10446,36,57,10381,10379,10372,8982,8323
49202,25,66,49202,0,0,49202,4.90783e+15,41.4166,1335.4,49202,41,55,48792,47742,47240,17881,9695
42407,24,44,0,42407,42407,0,2.07188e+13,33.8774,935.833,42407,40,41,42159,41752,41735,40941,32574
5334,1,13,0,5334,888,4446,5198.52,9.31984,210.881,5334,11,12,897,897,897,897,897
38982,16,40,38982,0,0,38982,5.71745e+15,21.9733,770.833,38982,32,25,38746,38164,37324,31314,30294
1731,12,18,1731,0,0,1731,345702000,15.1277,147.402,1731,15,17,1682,1589,1529,1527,1493
21462,1,20,0,21462,3728,17734,5208.89,11.3064,449.439,21462,19,18,3429,3429,3429,3429,3429
16802,43,44,16802,0,0,16802,279012000,33.801,659.311,16802,36,37,16758,16743,16755,16597,16756
44181,249,1523,43936,245,0,44181,1.81161e+17,56.2884,3152.12,44181,236,144,42606,42180,41332,38989,3855
23343,17,20,4012,19331,0,23343,20.3347,11.9779,466.406,23343,20,15,23320,23320,23320,23320,23320
44028,37,40,44028,0,0,44028,5.69095e+15,34.9864,889.531,44028,34,33,43983,43854,43977,43973,42077
42866,11,40,42866,0,42866,0,1.30228e+18,33.35,957.946,42866,40,37,39763,36195,37344,7275,14729
25840,5,44,25840,0,25840,0,1.20334e+18,31.863,806.441,25840,37,37,18532,14513,15640,4351,5477
21423,17,30,0,21423,3935,17488,4954.04,14.3258,539.448,21423,19,25,21385,21385,21320,21320,20341
22730,22,25,4846,17884,0,22730,18.6465,17.7992,578.385,22730,20,23,22705,22705,22658,22658,22544
13051,1,13,0,13051,2251,10800,5230.87,11.285,331.548,13051,13,12,2094,2094,2094,2094,2094
30025,21,44,30025,0,30025,0,1.39706e+18,35.8429,749.774,30025,37,37,29787,29447,29571,7902,20824
42083,23,65,0,42083,0,42083,4.38329e+14,32.18,1303.23,42083,38,59,41747,40884,40250,34909,27842
49345,24,64,0,49345,49345,0,1.91141e+13,36.5842,1175.29,49345,40,44,48923,48179,48099,46759,19998
26201,16,24,26201,0,0,26201,341899000,21.9011,607.938,26201,24,22,26049,25631,25059,25057,20593
29445,17,40,29445,0,0,29445,4.59353e+15,32.325,853.512,29445,37,37,28079,21054,26322,9201,15937
28809,15,40,28809,0,28809,0,87198200000,30.0899,699.722,28809,31,29,28448,27855,26933,26368,21309
1314,19,20,1314,0,1314,0,8.7586e+10,13.5381,127.201,1314,14,17,1294,1290,1293,1293,1294
16471,17,21,0,16471,2853,13618,4838.43,16.2807,410.69,16471,20,19,16440,16440,16382,16382,16114
8279,38,64,8279,0,8279,0,79516300000,22.2488,555.11,8279,29,44,8215,8211,8197,8193,5957
17759,36,44,17759,0,0,17759,4.63078e+15,34.445,687.436,17759,34,37,17713,17692,17586,17405,17395
34857,1,2,34857,0,34857,0,4.89353e+13,1.99989,253.275,34857,2,2,28796,28796,28796,28796,28796
8553,22,36,8553,0,8553,0,63053100000,28.677,469.073,8553,32,33,8413,8063,8272,7884,6576
45761,37,40,45761,0,45761,0,8.6149e+10,31.8385,825.581,45761,38,37,45714,45659,45684,45671,45551
21270,1,2,21270,0,21270,0,4.61582e+13,1.99948,199.039,21270,2,2,17781,17781,17781,17781,17781
30795,6,65,30795,0,30795,0,1.25815e+18,26.6472,1060.32,30795,44,48,21674,17756,15765,4540,7119
23264,1,2,23264,0,23264,0,3.32243e+13,1.99927,200.718,23264,2,2,20517,20517,20517,20517,20517
1807,1,22,1807,0,1807,0,1.45981e+18,15.5861,165.686,1807,18,19,188,188,188,188,188
6255,23,24,0,6255,6255,0,2.23931e+13,15.985,290.703,6255,19,21,6231,6223,6230,6230,6231
35932,25,28,6024,29908,0,35932,20.2575,12.2528,582.542,35932,21,21,35904,35904,35904,35904,35898
19004,25,40,19004,0,19004,0,86799800000,21.2245,519.284,19004,29,29,18964,18944,18956,18947,18962
7420,16,19,1349,6071,0,7420,20.117,11.5849,278.844,7420,19,19,7398,7398,7398,7398,7398
2690,1,2,0,2690,2690,0,1.334e+16,1.99331,69.3192,2690,2,2,2191,2191,2191,2191,2191
41384,23,38,41384,0,41384,0,84282400000,35.1066,983.362,41384,38,38,40856,39986,40160,39976,32233
32207,48,60,32207,0,32207,0,79392200000,31.1553,918.487,32207,38,44,32147,32137,32140,32147,25465
41103,1,4,0,41103,41103,0,9.44569e+15,1.99964,273.978,41103,3,3,35712,35712,35712,35712,35712
26501,8,24,26501,0,0,26501,340525000,20.7283,594.229,26501,23,22,24405,20859,19255,20669,12192
42856,39,40,0,42856,0,42856,1149370,35.1637,985.084,42856,40,37,42814,42768,42746,42746,42607
21639,5,48,21639,0,0,21639,4.83717e+15,27.0772,799.771,21639,33,41,14979,11384,11819,4206,4568
28727,12,40,28727,0,28727,0,8.7175e+10,36.0111,719.367,28727,32,38,27870,26207,24193,25043,12367
37370,18,20,0,37370,6397,30973,5209.82,12.3341,582.307,37370,20,19,37348,37348,37348,37348,37348
47058,1,2,47058,0,47058,0,3.25391e+13,1.99943,288.084,47058,2,2,41617,41617,41617,41617,41617
47737,1,2,0,47737,47737,0,1.63415e+16,1.99956,304.075,47737,2,2,36910,36910,36910,36910,36910
48822,17,21,8024,40798,0,48822,20.1474,15.2258,666.153,48822,21,21,48785,48785,48763,48763,48693
16643,33,40,16643,0,16643,0,87060600000,20.1507,529.516,16643,30,24,16603,16589,16601,16600,16390
2396,16,22,2396,0,2396,0,1.47219e+18,16.7462,189.564,2396,18,19,2361,2306,2292,2066,2283
46664,4,44,46664,0,46664,0,1.34773e+18,36.1828,976.91,46664,38,41,34528,27528,27404,6391,9934
9551,10,13,1582,7969,0,9551,20.2907,12.2774,281.563,9551,12,13,9528,9528,9505,9504,9519
10328,19,56,10328,0,10328,0,85608300000,19.5523,441.279,10328,27,32,10256,10175,10186,10194,8400
49444,1,2,49444,0,49444,0,4.15119e+13,1.99964,296.028,49444,2,2,42151,42151,42151,42151,42151
20165,12,40,20165,0,20165,0,1.46624e+18,20.8164,574.771,20165,28,29,19549,18299,16766,11416,12924
45240,46,66,0,45240,45239,1,4.9167e+14,36.7669,1354.93,45240,41,58,45174,45166,44747,44875,27230
12012,16,23,2896,9116,0,12012,17.5911,14.3804,428.923,12012,19,22,11977,11975,11872,11872,10324
43410,12,27,0,43410,14072,29338,1.65988e+12,20.0309,819.049,43410,24,22,42958,42910,42196,38295,36733
23191,1,2,23191,0,23191,0,3.28434e+13,1.99897,200.576,23191,2,2,20484,20484,20484,20484,20484
15949,12,27,4455,11494,4,15945,17647900000,17.0537,509.157,15949,21,22,15798,15786,15484,15499,12745
28416,32,38,0,28416,0,28416,1311260,37.1411,780.919,28416,38,38,28332,28128,28211,28211,21092
25923,7,20,0,25923,4389,21534,5195.05,11.9091,489.459,25923,20,17,25405,25405,24159,24260,23936
1048,3,18,0,1048,0,1048,1342490,12.9027,113.6,1048,14,15,675,571,510,309,293
10114,21,40,10114,0,10114,0,1.45192e+18,19.7533,421.261,10114,26,29,10069,9998,10038,4897,9370
43971,21,40,0,43971,43971,0,1.99337e+13,33.0214,970.167,43971,40,37,43442,42291,42798,41380,28484
38568,1,21,6443,32125,0,38568,20.3064,12.1152,579.476,38568,21,20,6483,6483,6483,6483,6483
5588,1,2,5588,0,5588,0,4.99684e+13,1.99553,100.537,5588,2,2,4595,4595,4595,4595,4595
32417,1,2,32417,0,32417,0,3.28042e+13,1.99938,237.977,32417,2,2,28638,28638,28638,28638,28638
43628,26,65,0,43628,0,43628,4.22806e+14,41.7181,1308.61,43628,41,56,43317,42537,42633,25894,17943
20765,20,40,0,20765,20765,0,2.10952e+13,28.7007,599.686,20765,35,35,20563,20311,20425,19985,14233
25975,2,20,4513,21462,0,25975,20.1854,19.3747,540.823,25975,20,20,17007,17007,16343,9884,7931
47192,8,30,0,47192,8084,39108,4996.47,17.9131,799.468,47192,21,29,46406,46365,45769,45841,28227
28461,1,2,0,28461,28461,0,1.24413e+16,1.99866,226.54,28461,2,2,23546,23546,23546,23546,23546
35373,36,40,0,35373,35373,0,2.23268e+13,23.1843,740.479,35373,32,28,35333,35317,35330,35330,35333
30241,760,1206,0,30241,0,30241,3.68939e+16,49.9023,2330.5,30241,192,125,29035,28952,28742,1796,6230
17209,19,38,17209,0,0,17209,339378000,27.1589,555.685,17209,31,30,17109,16953,16955,16926,15953
24849,1,38,0,24849,0,24849,1329540,27.6732,656.48,24849,31,30,2400,2400,2400,2400,2400
17559,34,36,0,17559,0,17559,1304540,23.2811,512.888,17559,36,33,17519,17482,17501,17501,17503
41443,1,40,41443,0,0,41443,339233000,34.0712,858.513,41443,33,32,4032,4032,4032,4032,4032
38213,20,21,6417,31796,0,38213,20.2695,12.1871,587.835,38213,21,20,38191,38191,38191,38191,38188
49507,43,56,49507,0,49507,0,86350800000,28.3417,919.589,49507,39,40,49451,49439,49442,49446,40018
47756,16,28,8062,39694,0,47756,20.2418,17.5244,681.606,47756,28,21,47709,47709,47709,47709,47641
15349,1,2,15349,0,15349,0,6.52478e+13,1.99818,173.79,15349,2,2,11790,11790,11790,11790,11790
22619,1,4,0,22619,22619,0,1.12456e+16,1.9996,207.757,22619,3,3,19086,19086,19086,19086,19086
2327,9,20,2327,0,2327,0,87028900000,16.2892,166.919,2327,15,17,2207,1893,1935,1885,1744
38916,36,40,0,38916,0,38916,1293090,36.3372,788.693,38916,37,37,38870,38822,38828,38828,38834
24606,17,65,0,24606,0,24606,7.49662e+14,23.6488,744.364,24606,32,44,24366,23610,23890,23839,19130
47937,9,44,0,47937,47937,0,2.06559e+13,36.8179,965.81,47937,40,37,44419,38984,40468,39048,15425
24496,18,38,24496,0,24496,0,1.45747e+18,32.3976,665.494,24496,32,31,24322,24118,23799,6920,20497
16005,7,44,16005,0,16005,0,1.23553e+18,35.9448,632.605,16005,37,41,13223,11385,11317,3194,3453
24041,2,4,0,24041,24041,0,8.32644e+15,3.28713,213.101,24041,4,4,24033,24031,24033,24033,21735
37285,6,25,0,37285,7953,29332,4677.2,19.8002,723.496,37285,21,23,34552,34552,33934,34015,30105
37108,15,40,37108,0,37108,0,1.45676e+18,27.117,728.676,37108,31,29,36871,36439,35947,4691,27164
21960,12,13,3730,18230,0,21960,20.3783,12.0985,429.5,21960,13,13,21944,21944,21934,21934,21934
20616,7,30,0,20616,3806,16810,4843.04,18.1091,587.198,20616,20,29,19782,19780,19091,19027,9491
12437,3,12,0,12437,2202,10235,5221.44,11.2758,331.74,12437,12,12,9472,9472,9385,7015,5690
14457,23,36,14457,0,0,14457,5.49298e+15,28.2334,454.975,14457,34,33,14362,14230,14302,4565,12254
6086,38,44,6086,0,6086,0,81058200000,19.3176,388.788,6086,27,37,6042,6036,5992,6010,5760
26821,7,44,0,26821,26821,0,1.7808e+13,37.0212,845.661,26821,36,39,20308,16584,16843,15848,5316
21590,1,2,21590,0,21590,0,3.26454e+13,1.99926,194.768,21590,2,2,19085,19085,19085,19085,19085
24037,3,13,3971,20066,0,24037,20.3458,11.6842,437.392,24037,13,13,18883,18883,18823,16386,11809
37160,58,64,37160,0,0,37160,5.54645e+15,33.8882,1066.48,37160,38,56,37096,37092,37092,37096,36448
29658,15,24,0,29658,0,29658,1334130,21.7972,647.204,29658,24,22,29433,29006,28181,28173,22494
2954,33,40,0,2954,2954,0,2.15644e+13,16.0684,227.793,2954,21,29,2914,2906,2914,2905,2914
49122,21,44,49122,0,0,49122,305270000,38.0555,1040.03,49122,40,41,48513,47224,47803,25797,29064
34776,1,2,34776,0,34776,0,3.25862e+13,1.99925,247.335,34776,2,2,30749,30749,30749,30749,30749
34719,8,44,34719,0,34719,0,1.38995e+18,34.6736,783.704,34719,37,37,32004,28378,27807,4851,11002
24952,10,23,4229,20723,0,24952,19.3729,14.4605,510.645,24952,20,21,24753,24747,24651,24697,24018
17808,1,28,3110,14698,0,17808,20.2314,12.4418,432.205,17808,20,21,2877,2877,2877,2877,2877
44187,3,40,44187,0,44187,0,86026100000,32.2516,811.145,44187,38,37,29836,25422,23014,23869,9272
34188,29,40,34188,0,0,34188,333010000,36.8659,736.178,34188,37,37,34096,33960,34007,27620,30834
3053,6,19,1157,1896,0,3053,14.8745,14.0816,204.087,3053,16,17,2338,2338,2330,2337,1751
43447,3,4,0,43447,43447,0,8.6077e+15,2.00002,280.294,43447,3,3,43443,43441,43442,43442,43443
34591,6,21,0,34591,5617,28974,5133.17,16.2528,558.588,34591,21,21,33716,33716,32831,32848,32669
37714,21,28,6383,31331,0,37714,20.1347,20.3783,625.455,37714,28,23,37679,37679,37679,37679,37679
28565,12,60,28565,0,0,28565,5.42391e+15,30.6627,874.452,28565,36,49,27400,25823,25126,8613,10438
38118,14,56,38118,0,38118,0,1.45789e+18,22.8003,798.45,38118,40,32,37648,37103,33848,6709,21311
23297,26,31,0,23297,4886,18411,3.0929e+12,17.4929,606.529,23297,22,24,23266,23264,23263,23263,22301
1716,10,16,0,1716,0,1716,1311480,12.595,127.044,1716,14,13,1683,1656,1550,1549,1454
18338,6,19,2915,15423,0,18338,19.8748,12.5026,395.739,18338,19,19,17916,17916,17508,17522,17597
1948,1,2,1948,0,1948,0,3.28002e+13,1.99127,58.6261,1948,2,2,1720,1720,1720,1720,1720
1921,1,2,0,1921,1921,0,8.32732e+15,1.99011,57.6313,1921,2,2,1698,1698,1698,1698,1698
1623,10,22,0,1623,0,1623,1299410,18.9692,160.32,1623,17,21,1495,1402,1167,1214,918
3211,10,22,3211,0,3211,0,1.46997e+18,17.2333,216.48,3211,19,19,3041,2901,2516,2099,1907
45447,1,2,45447,0,45447,0,4.37321e+13,1.99965,284.977,45447,2,2,38385,38385,38385,38385,38385
23450,1,2,23450,0,23450,0,3.44972e+13,1.99966,202.138,23450,2,2,20575,20575,20575,20575,20575
4716,21,32,4716,0,0,4716,320176000,19.8119,264.185,4716,31,28,4652,4589,4615,1387,3914
35170,31,40,35170,0,35170,0,87210400000,23.1371,740.3,35170,32,28,35130,35112,35123,35118,35130
38238,11,60,38238,0,38238,0,1.35069e+18,43.2896,1033.44,38238,54,44,35766,32975,33181,4472,10155
19635,24,40,0,19635,0,19635,1321450,19.0779,514.535,19635,27,29,19595,19578,19587,19585,18941
32431,36,44,32431,0,32431,0,1.35286e+18,37.3243,831.067,32431,37,41,32381,32339,32232,28534,31507
19830,3,4,0,19830,19830,0,8.0815e+15,3.78598,218.21,19830,4,4,19769,19672,19749,19749,19101
2567,19,36,2567,0,0,2567,275625000,30.1967,240.144,2567,28,28,2464,2287,2409,1354,1785
842,9,14,0,842,842,0,2.26588e+13,12.7791,94.1578,842,13,14,790,660,707,686,645
33304,1,4,0,33304,33304,0,8.39706e+15,1.99988,246.481,33304,3,3,29420,29420,29420,29420,29420
15375,11,44,15375,0,0,15375,5.32648e+15,32.0261,557.931,15375,33,37,14614,13747,13831,4154,7491
18091,17,44,18091,0,18091,0,1.28185e+18,32.4638,677.364,18091,36,41,17511,15017,16928,7980,9349
5734,1,2,5734,0,5734,0,3.23986e+13,1.99704,99.3161,5734,2,2,5073,5073,5073,5073,5073
43279,55,56,43279,0,43279,0,86278400000,28.5867,867.264,43279,37,40,43223,43210,43222,43223,43212
34812,29,60,34812,0,0,34812,5.17512e+15,35.6544,1043.07,34812,39,53,34636,34232,34173,18149,20682
37409,5,28,0,37409,6289,31120,5184.68,12.7745,595.665,37409,20,21,34879,34879,31065,30569,14272
21858,24,40,21858,0,0,21858,5.68765e+15,21.5119,552.523,21858,29,29,21816,21797,21808,9530,20802
6488,6,44,6488,0,0,6488,5.05301e+15,25.1322,391.855,6488,31,37,5450,4908,4613,1429,1894
3083,4,44,3083,0,0,3083,305941000,17.1255,311.215,3083,24,37,1840,1375,1322,1342,719
42374,24,64,42374,0,42374,0,1.2719e+18,32.5465,1152.65,42374,45,44,42092,41614,41320,21560,26874
12733,7,56,12733,0,12733,0,1.41324e+18,26.6254,518.79,12733,40,40,11349,9980,9039,3128,4243
40608,35,40,0,40608,0,40608,1314290,28.8339,780.083,40608,38,37,40557,40490,40514,40514,40513
2114,12,22,0,2114,0,2114,1334780,16.5615,179.388,2114,18,19,2029,1883,1786,1827,1569
16574,3,40,16574,0,0,16574,333074000,23.4554,511.295,16574,31,37,11248,9608,8740,6465,3753
37971,22,40,37971,0,0,37971,5.72148e+15,28.684,790.163,37971,33,29,37910,37859,37870,34246,36347
18652,1,2,18652,0,18652,0,5.19579e+13,1.99952,184.696,18652,2,2,15208,15208,15208,15208,15208
27889,23,24,27889,0,27889,0,1.46842e+18,21.6774,627.722,27889,24,22,27863,27835,27853,26308,27670
20827,9,40,20827,0,20827,0,1.46594e+18,22.0098,583.183,20827,23,29,19314,15853,15564,9066,10384
27667,36,40,0,27667,27667,0,2.23018e+13,30.7335,689.707,27667,31,30,27624,27583,27620,27622,26518
48718,7,23,0,48718,8921,39797,4875.99,17.0291,754.672,48718,21,22,47146,47146,46450,46575,44112
39648,10,44,0,39648,39648,0,1.85752e+13,35.3057,993.102,39648,38,39,34265,29361,30752,29535,13502
31080,43,55,31080,0,0,31080,5.95762e+15,33.0315,936.849,31080,38,45,31025,31004,30988,30498,28685
21665,6,56,0,21665,21665,0,2.18873e+13,23.8939,649.681,21665,33,40,18617,16765,13834,16049,6889
38355,401,410,38355,0,1990,36365,3.00199e+16,35.1255,1414.1,38355,159,68,37945,37945,37945,37945,37945
49396,15,32,0,49396,10631,38765,4770.15,14.2542,889.067,49396,21,25,49317,49317,49073,49087,42511
49624,29,54,0,49624,0,49624,3.71719e+14,40.1173,1229.28,49624,46,45,49459,49134,48591,25891,19426
8914,11,22,0,8914,0,8914,1335310,19.9063,370.333,8914,22,22,8504,7960,7407,7471,6055
26488,1,2,26488,0,26488,0,3.65233e+13,1.99985,216.385,26488,2,2,23050,23050,23050,23050,23050
15001,20,60,15001,0,0,15001,5.26969e+15,32.4076,585.168,15001,34,40,14779,14510,14624,3586,8350
49132,33,44,49132,0,0,49132,313369000,39.5482,1024.36,49132,41,41,49047,48894,48674,41446,38512
17892,1,2,0,17892,17892,0,8.36081e+15,1.99888,177.363,17892,2,2,15815,15815,15815,15815,15815
31936,38,56,31936,0,31936,0,86215700000,23.8972,761.957,31936,33,40,31880,31868,31834,31811,28674
36822,16,44,0,36822,36822,0,2.10045e+13,37.9595,831.072,36822,37,37,36132,34688,35651,34699,20484
14908,2,13,2575,12333,0,14908,20.4296,11.3448,354.769,14908,13,12,9759,9759,9646,5480,3373
6471,23,36,6471,0,0,6471,5.48578e+15,26.0512,292.132,6471,26,25,6415,6363,6399,2663,5408
9043,26,40,0,9043,0,9043,1322720,20.1046,406.918,9043,30,24,9003,8991,8995,8997,8939
3952,5,20,0,3952,781,3171,4903.13,16.2146,235.395,3952,19,19,3472,3470,2934,2654,2451
3823,1,10,650,3173,0,3823,20.543,9.20298,167.439,3823,10,10,624,624,624,624,624
1299,6,17,260,1039,0,1299,17.5273,9.40647,115.804,1299,15,16,1208,1208,1193,1201,1114
24359,24,30,0,24359,5178,19181,4638.88,16.7153,621.248,24359,20,26,24329,24329,24329,24329,22458
14768,1,2,14768,0,14768,0,3.2516e+13,1.99898,161.204,14768,2,2,13061,13061,13061,13061,13061
31905,30,59,31905,0,0,31905,6.50199e+15,34.3164,937.912,31905,48,37,31804,31604,31381,26641,25592
46195,30,56,46195,0,0,46195,5.69852e+15,22.85,852.224,46195,32,32,46139,46115,46127,42358,45068
15234,37,56,0,15234,0,15234,1303230,21.3309,566.869,15234,30,39,15178,15168,15141,15143,13756
31536,37,40,0,31536,0,31536,1310470,30.0575,691.07,31536,37,37,31492,31454,31460,31460,31463
12031,11,22,12031,0,0,12031,5.75387e+15,20.2507,420.198,12031,22,22,11543,10877,10031,9075,7370
5301,22,24,5301,0,0,5301,341874000,17.5393,270.92,5301,19,21,5277,5267,5275,5275,5062
28605,36,40,28605,0,28605,0,1.42433e+18,31.5174,666.435,28605,37,37,28563,28538,28525,26743,28558
1031,10,20,1031,0,0,1031,5.69393e+15,11.8487,112.966,1031,14,17,987,957,872,623,650
30699,18,40,0,30699,0,30699,1321940,26.8566,651.502,30699,30,29,30615,30511,30493,30484,25826
37904,2,5,1,37903,37904,0,1.14177e+16,2.90943,288.3,37904,4,4,37853,37836,37849,37850,32964
46942,16,56,0,46942,0,46942,1316490,36.4165,899.838,46942,40,40,46582,45849,45316,45312,31650
36150,7,44,0,36150,0,36150,1280360,33.0846,806.336,36150,36,37,32448,28767,26677,27617,13240
24383,37,40,24383,0,0,24383,299357000,33.4666,717.115,24383,37,37,24339,24301,24177,22775,23305
25284,26,40,0,25284,0,25284,1328090,23.3032,639.85,25284,32,24,25244,25228,25233,25235,25244
10878,17,19,0,10878,1725,9153,5159.35,10.3313,290.913,10878,19,18,10857,10857,10857,10857,10854
19251,18,19,3116,16135,0,19251,19.3972,14.7399,419.223,19251,19,19,19228,19226,19220,19220,19223
45019,9,44,45019,0,45019,0,1.33976e+18,37.2388,971.094,45019,38,41,41227,35837,37394,7186,15324
4859,12,22,4859,0,4859,0,1.47336e+18,19.2922,270.161,4859,20,20,4680,4327,4076,3795,3507
46487,1,4,0,46487,46487,0,9.35616e+15,1.99987,290.415,46487,3,3,40448,40448,40448,40448,40448
18257,12,23,0,18257,3147,15110,4973.39,11.3526,444.236,18257,18,21,18180,18176,18124,18139,17536
27888,2,40,27888,0,27888,0,84774500000,31.59,657.586,27888,37,37,16354,16321,11867,13123,4676
37597,7,56,0,37597,0,37597,1326230,21.9881,777.737,37597,32,32,33412,29079,25439,26289,15792
46278,20,56,46278,0,0,46278,339289000,34.7442,861.816,46278,40,32,46171,46020,46011,46006,38224
25786,35,40,0,25786,25786,0,2.04658e+13,32.3894,689.106,25786,37,35,25739,25637,25633,25618,25063
6260,2,40,0,6260,6260,0,1.99092e+13,30.4474,385.822,6260,31,37,3420,3390,2671,2746,798
31189,45,60,31189,0,31189,0,1.40625e+18,33.8061,939.491,31189,47,42,31129,31119,31122,23237,28031
17005,6,28,2716,14289,0,17005,20.1759,11.9895,387.177,17005,20,19,16617,16617,16175,16178,3509
42203,42,56,42203,0,42203,0,86175400000,29.8381,840.609,42203,39,37,42147,42135,42138,42138,31948
38950,11,40,38950,0,38950,0,86330700000,29.195,886.751,38950,38,35,37083,34809,31588,31387,14704
46312,11,59,46312,0,46312,0,1.06417e+18,36.465,1135.45,46312,41,37,34566,20907,28314,20263,14545
36973,1,2,0,36973,36973,0,9.17944e+15,1.99959,253.197,36973,2,2,32262,32262,32262,32262,32262
42658,22,40,0,42658,42658,0,2.21671e+13,27.3343,785.56,42658,34,29,42571,42472,42522,42413,26342
22180,28,40,22180,0,22180,0,1.43079e+18,31.1677,580.075,22180,34,37,22112,22039,22062,13652,20916
12096,9,21,0,12096,1947,10149,5165.21,10.2005,318.287,12096,19,20,12043,12043,12028,12032,11986
14926,38,48,14926,0,0,14926,253652000,33.6558,649.53,14926,34,36,14878,14870,14649,13420,9696
13345,21,40,13345,0,13345,0,1.44735e+18,22.5009,438.98,13345,29,25,13302,13273,13267,2010,11557
46045,42,44,46045,0,0,46045,5.27326e+15,38.7828,1000.87,46045,41,41,45999,45965,45773,42691,43387
26650,34,38,0,26650,0,26650,1308610,32.2304,747.756,26650,38,35,26588,26448,26499,26498,26458
40985,234,383,28386,12599,40966,19,2.12702e+16,11.4421,1133.1,40985,128,69,40602,40587,40582,40588,40573
5873,27,30,1788,4085,0,5873,15.464,16.835,335.965,5873,18,24,5843,5843,5843,5843,5230
7537,15,19,1402,6135,0,7537,19.5569,16.0048,292.751,7537,19,19,7492,7492,7490,7490,7490
48498,19,28,0,48498,8003,40495,5144.18,15.3505,692.553,48498,21,27,48464,48464,48446,48446,48119
24028,8,44,0,24028,24028,0,2.12696e+13,27.4001,663.187,24028,34,37,22066,19442,19006,19366,9426
30303,18,20,5203,25100,0,30303,20.3639,11.9442,525.241,30303,20,18,30281,30281,30281,30281,30281
18827,2,24,0,18827,0,18827,1331810,20.5946,497.922,18827,22,22,10515,10514,7102,3215,3445
35947,14,21,5752,30195,0,35947,20.1793,14.321,543.449,35947,21,20,35907,35907,35905,35906,35895
19285,37,44,19285,0,0,19285,330895000,32.9765,603.52,19285,36,41,19241,19222,19233,19181,19121
44505,1,21,7099,37406,0,44505,20.0265,17.0496,622.661,44505,21,21,8153,8153,8153,8153,8153
18648,1,2,0,18648,18648,0,1.2311e+16,1.99903,182.585,18648,2,2,15461,15461,15461,15461,15461
40815,9,40,40815,0,0,40815,5.65612e+15,28.71,785.022,40815,38,37,38615,33133,33947,7543,17078
31628,20,21,0,31628,5039,26589,5070.01,16.0984,531.406,31628,20,20,31606,31605,31594,31595,31606
17959,26,40,0,17959,17959,0,2.22072e+13,19.2811,495.97,17959,28,29,17919,17902,17912,17907,17917
18401,17,21,6852,11549,0,18401,14.4575,17.4605,507.541,18401,20,19,18370,18370,18236,18240,18306
834,1,2,0,834,834,0,8.1216e+15,1.95923,38.4008,834,2,2,739,739,739,739,739
2655,7,18,2655,0,2655,0,1.47795e+18,16.7571,182.007,2655,16,18,2342,2027,1824,1369,1228
21817,1,2,0,21817,21817,0,8.42219e+15,1.99917,194.511,21817,2,2,19266,19266,19266,19266,19266
45302,14,23,8329,36973,0,45302,18.934,17.4866,726.647,45302,21,22,45160,45150,44919,44938,42963
26999,22,40,26999,0,0,26999,5.70869e+15,37.0185,668.99,26999,32,31,26937,26889,26893,22695,20147
2593,7,18,2593,0,0,2593,343981000,16.919,180.095,2593,16,18,2290,1983,1774,1861,1138
18101,4,24,18101,0,0,18101,5.73269e+15,21.6559,502.985,18101,22,22,13084,9938,9611,2225,4408
31679,17,40,31679,0,31679,0,8.3883e+10,32.6989,713.074,31679,37,37,31352,30778,31160,30611,14641
38633,11,44,0,38633,38633,0,2.14787e+13,37.0747,828.778,38633,38,37,37307,35610,34561,33900,15525
25633,1,2,0,25633,25633,0,1.47528e+16,1.99977,218.337,25633,2,2,20384,20384,20384,20384,20384
22357,52,56,0,22357,0,22357,1320440,22.3313,615.637,22357,30,32,22301,22289,22301,22301,22301
29201,1,2,29201,0,29201,0,4.30488e+13,1.99945,227.185,29201,2,2,24734,24734,24734,24734,24734
8843,28,36,8843,0,0,8843,4.99137e+15,24.9795,409.391,8843,33,29,8791,8724,8723,5332,7612
13398,1,2,13398,0,13398,0,3.24585e+13,1.99896,153.603,13398,2,2,11852,11852,11852,11852,11852
26449,5,20,0,26449,4546,21903,5201.23,12.2298,497.865,26449,19,19,24514,24514,21843,21307,10868
17264,5,24,17264,0,0,17264,342666000,20.7951,500.511,17264,22,22,13453,9937,9977,8628,5044
4876,6,19,0,4876,1501,3375,3836.43,15.5482,252.841,4876,18,17,4127,4127,4087,4118,2383
3721,1,2,0,3721,3721,0,8.40446e+15,1.99382,80.8479,3721,2,2,3286,3286,3286,3286,3286
40142,12,40,40142,0,40142,0,87267200000,22.749,783.248,40142,32,28,39153,37030,34173,35468,24652
30708,5819,10400,0,30708,10216,20492,8.18075e+14,315.722,12703.3,30708,3133,207,20308,20076,14923,4909,5802
28192,29,40,28192,0,28192,0,1.43779e+18,30.7793,657.989,28192,36,37,28124,28052,28074,24049,24821
26208,16,40,0,26208,26208,0,2.23275e+13,22.3328,652.37,26208,29,29,25992,25468,24727,24627,18343
30266,14,23,6015,24251,0,30266,18.3966,16.9099,619.83,30266,21,22,30148,30138,29910,29928,27301
22434,8,40,0,22434,22434,0,2.2311e+13,22.3648,604.552,22434,32,24,20297,16938,15494,17126,9393
27454,5,13,0,27454,4653,22801,5217.8,11.9463,479.108,27454,13,13,25557,25557,22716,22598,21335
47042,1,4,0,47042,47042,0,1.32345e+16,2.45916,315.462,47042,4,4,38371,38371,38371,38371,38371
19570,16,23,0,19570,3376,16194,4894.53,15.8693,460.456,19570,20,21,19524,19521,19455,19455,18944
38185,1,2,38185,0,38185,0,3.37976e+13,1.99958,257.509,38185,2,2,33599,33599,33599,33599,33599
7153,15,40,7153,0,7153,0,83977900000,19.2753,361.595,7153,31,36,7024,6843,6936,6831,4930
23460,6,21,0,23460,5572,17888,4365.79,19.2684,554.965,23460,21,20,21248,21248,20966,21068,8582
30133,1,2,30133,0,30133,0,3.85133e+13,1.99963,229.644,30133,2,2,26009,26009,26009,26009,26009
24572,6,24,0,24572,0,24572,1330890,22.1737,610.01,24572,24,22,20801,18525,14783,13335,8600
3766,6,32,0,3766,3766,0,2.16644e+13,14.1237,209.532,3766,24,21,3416,3183,2668,2984,1392
36593,9,40,0,36593,0,36593,1313950,29.6971,747.567,36593,38,37,34631,29797,30441,30467,15513
37605,16,40,37605,0,0,37605,5.71794e+15,22.3109,745.626,37605,32,29,37391,36846,36277,8011,27608
45011,26,44,45011,0,0,45011,5.22818e+15,41.3113,991.104,45011,41,41,44776,44167,44171,14186,29677
28541,36,40,0,28541,28541,0,2.19865e+13,28.5365,657.229,28541,36,37,28499,28474,28461,28449,28480
1492,1,2,1492,0,1492,0,3.24489e+13,1.99397,50.8208,1492,2,2,1319,1319,1319,1319,1319
31359,10,30,6333,25026,0,31359,18.4401,16.7534,682.299,31359,21,26,30913,30892,30616,30701,27532
22529,1,2,0,22529,22529,0,9.97912e+15,1.99929,198.803,22529,2,2,19408,19408,19408,19408,19408
25910,1,2,25910,0,25910,0,3.84353e+13,1.99942,212.854,25910,2,2,22371,22371,22371,22371,22371
29761,16,20,5270,24491,0,29761,20.2632,17.9121,549.486,29761,20,19,29725,29725,29725,29725,29725
39155,20,40,39155,0,39155,0,1.4573e+18,26.5277,745.072,39155,32,29,39081,39008,39001,6434,34482
22299,13,40,0,22299,0,22299,956304,34.0954,762.029,22299,36,34,18349,11143,16014,15851,9218
37763,30,56,37763,0,0,37763,5.69098e+15,38.0425,796.342,37763,40,31,37697,37659,37679,28080,28194
49184,1,64,49184,0,0,49184,291691000,36.4628,1135.45,49184,40,44,4993,4993,4993,4993,4993
37201,15,30,0,37201,7385,29816,4982.73,17.2998,790.39,37201,19,30,37105,37105,36980,36986,35227
13704,26,40,0,13704,0,13704,982428,33.712,599.461,13704,34,34,13598,13310,13375,13398,11475
43190,21,38,43190,0,43190,0,84270500000,37.5731,1005.63,43190,38,38,42493,41084,41712,41549,24665
12119,12,13,2007,10112,0,12119,20.4056,10.1692,305.685,12119,12,12,12105,12105,12103,12104,12105
10467,4,22,0,10467,10467,0,2.22478e+13,21.2695,409.91,10467,22,22,7326,5524,5363,6448,2398
21117,22,40,21117,0,21117,0,87179100000,21.9914,589.229,21117,31,24,21074,21045,21061,21061,20195
20310,1,2,0,20310,20310,0,8.35882e+15,1.99867,188.759,20310,2,2,17953,17953,17953,17953,17953
36832,9,44,36832,0,36832,0,8.0311e+10,31.0456,888.671,36832,40,41,33656,29014,30315,29153,11615
8133,7,22,0,8133,0,8133,1332930,20.4178,355.39,8133,22,22,6982,5877,5056,4822,3187
49784,373,1458,49779,5,49784,0,2.61745e+18,222.208,4175.81,49784,262,182,48136,47431,38898,37953,11158
11068,8,12,1930,9138,0,11068,20.4601,10.8509,305.308,11068,12,12,10972,10972,10602,10601,10882
47291,140,151,450,46841,47256,35,1.56698e+16,3.38986,635.702,47291,31,32,47140,47139,47122,47129,47108
11712,1,2,0,11712,11712,0,8.3858e+15,1.99949,143.578,11712,2,2,10348,10348,10348,10348,10348
13589,1,2,13589,0,13589,0,3.55028e+13,1.99882,153.437,13589,2,2,11874,11874,11874,11874,11874
13704,14,24,13704,0,0,13704,5.74534e+15,20.2652,433.084,13704,21,21,13572,13422,12236,10698,9916
21677,26,38,0,21677,21677,0,2.21221e+13,31.0191,637.922,21677,33,31,21603,21527,21562,21571,21603
2258,11,17,0,2258,411,1847,4521.84,12.667,145.12,2258,16,16,2209,2209,2188,2198,2112
10747,28,40,0,10747,10747,0,2.16784e+13,25.119,430.066,10747,31,37,10691,10643,10638,10584,9553
36774,38,40,36774,0,0,36774,5.68975e+15,27.2321,726.005,36774,31,29,36732,36703,36730,34278,36528
31573,10,19,0,31573,5712,25861,5161.64,16.2987,575.054,31573,19,19,31413,31413,31305,31304,31247
40595,1,4,0,40595,40595,0,8.33557e+15,1.99993,271.523,40595,3,3,35896,35896,35896,35896,35896
18381,13,40,18381,0,18381,0,1.4324e+18,23.4533,534.715,18381,32,37,18086,17367,17571,8988,12310
4674,12,24,4674,0,0,4674,341331000,16.7967,257.058,4674,19,21,4546,4296,3988,4065,3508
18526,1,2,18526,0,18526,0,3.32738e+13,1.99881,178.929,18526,2,2,16335,16335,16335,16335,16335
47968,25,44,47968,0,47968,0,8.1002e+10,35.0928,983.626,47968,39,41,47711,47197,47218,46440,38033
33581,20,56,33581,0,0,33581,5.69961e+15,22.9066,738.177,33581,32,31,33499,33383,33362,5943,27256
22265,1,2,0,22265,22265,0,1.24988e+16,1.99933,201.181,22265,2,2,18402,18402,18402,18402,18402
33392,39,40,33392,0,33392,0,1.44174e+18,30.7602,717.079,33392,38,37,33350,33309,33340,30546,33341
28931,1,2,0,28931,28931,0,9.85807e+15,1.99945,224.628,28931,2,2,24972,24972,24972,24972,24972
24714,38,65,24714,0,0,24714,6.26812e+15,27.348,937.657,24714,33,48,24649,24639,24574,17353,17955
5515,26,56,5515,0,5515,0,1.37953e+18,19.546,355.619,5515,39,34,5445,5391,5404,1544,3295
1208,1,2,1208,0,1208,0,3.23883e+13,1.9851,46.2291,1208,2,2,1068,1068,1068,1068,1068
38435,19,48,38435,0,0,38435,311079000,38.2291,947.559,38435,40,41,37849,36554,37099,31154,21947
49314,20,23,9271,40043,0,49314,18.8732,21.4474,774.112,49314,22,22,49282,49280,49087,49089,48691
32890,11,23,0,32890,5741,27149,4901.78,18.469,596.295,32890,21,21,32653,32653,32547,32594,31288
16648,64,65,16647,1,16647,1,5.10026e+12,34.9939,868.199,16648,36,57,16583,16577,16583,16583,16348
18697,36,40,0,18697,0,18697,1314900,29.2667,509.491,18697,29,29,18655,18630,18649,18649,18652
7265,24,40,7265,0,0,7265,5.58936e+15,21.9489,369.275,7265,26,36,7209,7170,7163,6272,6740
25181,9,20,0,25181,4263,20918,5188.52,12.6608,485.342,25181,20,15,25040,25040,24751,24748,11887
31238,1,2,31238,0,31238,0,3.25825e+13,1.99949,233.981,31238,2,2,27621,27621,27621,27621,27621
42845,11,60,42845,0,0,42845,326386000,34.5744,1009.12,42845,37,51,41117,39076,37626,37516,12616
5605,13,22,5605,0,5605,0,87808900000,17.2792,277.996,5605,19,19,5499,5173,5068,5204,4654
35473,20,44,0,35473,0,35473,1220760,31.6085,874.707,35473,40,41,35049,34352,34546,34551,19647
2064,21,40,0,2064,2064,0,2.11464e+13,15.0766,184.48,2064,21,24,2024,2012,2018,1990,1611
47349,19,44,47349,0,0,47349,325130000,37.0252,919.406,47349,37,37,46900,46209,46613,40899,22615
35772,1,2,35772,0,35772,0,4.0476e+13,1.99941,250.853,35772,2,2,30627,30627,30627,30627,30627
37273,20,56,37273,0,0,37273,332946000,35.0641,942.079,37273,38,52,36927,36325,36547,35663,28584
14581,8,60,14581,0,0,14581,318092000,27.8851,613.491,14581,32,40,12974,11109,10695,10791,5732
46670,2,4,0,46670,46670,0,8.25103e+15,3.72811,310.342,46670,4,4,46608,46588,46604,46605,42846
7607,10,22,0,7607,0,7607,1329540,20.4038,345.496,7607,22,22,7137,6741,5882,6033,4373
21610,26,42,20945,665,21575,35,7.51021e+14,22.1845,589.056,21610,25,29,21562,21546,21456,21445,15225
10959,3,19,1681,9278,0,10959,20.0299,10.0608,285.755,10959,19,18,8883,8883,8868,8390,7074
2343,1,2,2343,0,2343,0,7.26813e+13,1.99616,68.209,2343,2,2,1737,1737,1737,1737,1737
8795,10,40,8795,0,8795,0,84082700000,27.0111,396.466,8795,31,37,8410,8079,7646,7534,4609
18175,24,38,18175,0,0,18175,5.64108e+15,33.15,588.794,18175,33,31,18094,18015,18046,18092,18069
8269,1,4,0,8269,8269,0,8.2959e+15,2.00036,126.162,8269,3,3,7314,7314,7314,7314,7314
8305,17,40,8305,0,8305,0,85855900000,19.0645,336.167,8305,26,20,8255,8208,8208,8181,5144
38108,11851,12447,37461,647,37461,647,2.01937e+18,348,15565.2,38108,3204,275,25661,25660,25641,25606,20995
24458,13,21,3869,20589,0,24458,19.8252,17.0485,464.001,24458,20,20,24383,24383,24345,24357,24240
1241,4,18,0,1241,1241,0,2.2373e+13,15.0757,132.426,1241,15,18,858,647,657,770,384
35817,15,23,5981,29836,0,35817,19.6341,15.9919,598.452,35817,20,21,35750,35750,35673,35676,35267
15416,1,2,0,15416,15416,0,1.19893e+16,1.99961,169.662,15416,2,2,12850,12850,12850,12850,12850
35582,1,2,35582,0,35582,0,4.38405e+13,1.99989,252.821,35582,2,2,30039,30039,30039,30039,30039
46228,1,2,46228,0,46228,0,3.34643e+13,1.99933,284.139,46228,2,2,40731,40731,40731,40731,40731
3239,16,20,3239,0,3239,0,86355500000,14.5341,189.813,3239,16,17,3217,3207,3198,3195,3216
8820,1,2,0,8820,8820,0,9.51781e+15,1.99864,123.404,8820,2,2,7654,7654,7654,7654,7654
6592,4,20,6592,0,6592,0,87747100000,16.9847,290.312,6592,19,18,4775,3623,3477,4151,1879
2260,17,18,0,2260,0,2260,1349690,15.158,168.045,2260,16,17,2241,2219,2240,2239,2241
36883,38,40,0,36883,0,36883,1313560,29.8896,749.728,36883,38,37,36839,36797,36817,36817,36821
27080,17,21,0,27080,4347,22733,5123.06,11.9777,487.481,27080,19,20,27053,27053,27029,27029,26962
11256,1,2,11256,0,11256,0,3.62597e+13,1.99751,140.061,11256,2,2,9805,9805,9805,9805,9805
49812,10,44,49812,0,49812,0,79405700000,37.0439,1023.59,49812,38,41,46369,43310,42277,41386,17110
48579,1,5,48579,0,48579,0,6.59261e+13,1.99951,310.745,48579,3,4,37706,37706,37706,37706,37706
20212,30,56,20212,0,0,20212,334269000,23.7553,634.086,20212,32,40,20144,20084,20086,19376,17294
32563,1,2,32563,0,32563,0,3.21644e+13,1.99985,240.455,32563,2,2,28841,28841,28841,28841,28841
9658,1,2,9658,0,9658,0,4.56399e+13,1.99855,133.274,9658,2,2,8091,8091,8091,8091,8091
37475,1,2,0,37475,37475,0,1.04486e+16,1.99875,256.797,37475,2,2,32040,32040,32040,32040,32040
44166,3,21,0,44166,9615,34551,4514.45,18.308,747.758,44166,21,20,33912,33891,33711,33051,11936
45140,11,44,45140,0,0,45140,308707000,35.8897,984.937,45140,40,41,42266,38969,39594,39549,15215
7400,26,40,7400,0,7400,0,1.41171e+18,19.1505,367.2,7400,31,36,7346,7294,7297,3758,5990
4175,26,40,0,4175,0,4175,1249690,29.7238,288.606,4175,24,33,4129,4100,4105,4104,3931
22586,1,2,22586,0,22586,0,3.22028e+13,1.99867,200.196,22586,2,2,20001,20001,20001,20001,20001
29154,23,24,29154,0,0,29154,5.73377e+15,21.633,645.96,29154,24,22,29128,29100,29118,27548,28844
30734,1,2,0,30734,30734,0,1.15704e+16,1.99967,234.202,30734,2,2,25798,25798,25798,25798,25798
12263,1,2,12263,0,12263,0,3.26853e+13,1.99821,146.703,12263,2,2,10838,10838,10838,10838,10838
40007,19,40,40007,0,0,40007,5.03054e+15,35.119,934.612,40007,40,37,39252,37593,38308,9863,20976
30367,72,96,237,30130,30355,12,2.3112e+15,1.92037,462.721,30367,28,22,30271,30271,30269,30266,30227
25292,1,2,0,25292,25292,0,9.89467e+15,1.99972,210.54,25292,2,2,21818,21818,21818,21818,21818
26868,16,38,0,26868,26868,0,2.23225e+13,27.5207,679.428,26868,31,30,26574,25860,25297,25093,22008
3840,15,22,3840,0,0,3840,343863000,17.037,235.261,3840,19,19,3793,3724,3699,3695,3488
6661,1,24,6661,0,6661,0,87284400000,20.5777,308.435,6661,20,20,717,717,717,717,717
36596,19,56,0,36596,0,36596,1301160,30.412,925.308,36596,38,51,36239,35719,35780,35764,23373
47463,12,40,0,47463,0,47463,1317780,28.1344,843.97,47463,39,37,46525,44613,41864,42325,26573
35964,1,40,35964,0,0,35964,5.71277e+15,33.136,770.696,35964,32,31,3729,3729,3729,3729,3729
48313,41,48,0,48313,0,48313,1140750,35.5628,1113.42,48313,39,41,48265,48252,47826,47826,39525
19297,1,40,19297,0,19297,0,85833500000,31.1642,521.11,19297,30,29,2373,2373,2373,2373,2373
26295,1,2,26295,0,26295,0,3.28414e+13,1.99901,213.805,26295,2,2,23226,23226,23226,23226,23226
8210,1,2,8210,0,8210,0,3.27073e+13,1.99732,119.71,8210,2,2,7255,7255,7255,7255,7255
6913,3,24,6913,0,6913,0,1.46108e+18,17.9203,307.918,6913,19,21,4558,3862,3462,1095,1761
37197,30,44,37197,0,0,37197,313633000,31.1334,890.904,37197,39,41,37096,36848,36748,31633,29076
19869,8,21,0,19869,3201,16668,5170.61,11.7588,406.392,19869,20,20,19750,19750,19595,19598,19650
39085,22,44,39085,0,0,39085,5.49636e+15,33.7691,828.911,39085,37,38,38853,38481,38607,7407,24261
17012,17,40,17012,0,17012,0,63164200000,33.1309,664.645,17012,34,34,15861,8921,14105,13173,9108
8857,1,2,0,8857,8857,0,8.50991e+15,1.99774,123.748,8857,2,2,7810,7810,7810,7810,7810
15962,17,23,2878,13084,0,15962,19.1482,14.272,429.058,15962,19,21,15933,15933,15874,15874,15447
13099,19,44,0,13099,13099,0,2.12073e+13,20.5344,554.084,13099,28,41,12986,12706,12766,12626,11357
40839,2,38,40839,0,0,40839,5.65161e+15,32.5989,906.581,40839,38,36,21291,21289,13380,4233,4582
16096,1,2,16096,0,16096,0,3.26662e+13,1.99901,167.575,16096,2,2,14227,14227,14227,14227,14227
2001,12,16,2001,0,2001,0,1.43309e+18,13.1054,138.081,2001,14,14,1976,1951,1929,1704,1824
32035,12,48,0,32035,32035,0,1.85488e+13,34.5824,950.902,32035,36,41,28247,22854,25391,24519,12104
9972,18,40,0,9972,0,9972,1316290,18.9421,381.56,9972,22,29,9926,9890,9901,9897,8489
6824,8,11,1075,5749,0,6824,20.2726,9.48139,216.761,6824,11,11,6798,6798,6759,6759,6792
42121,16,40,0,42121,42121,0,1.66943e+13,35.0872,1067.55,42121,40,37,38340,22941,33513,31464,20025
1279,7,18,1279,0,1279,0,1.47834e+18,15.4418,133.707,1279,15,18,1082,902,829,849,527
11719,5969,6823,0,11719,0,11719,1.02449e+17,110.486,7715.24,11719,2883,153,4896,4892,4045,3538,2123
1250,16,18,1250,0,1250,0,87672300000,12.332,122.04,1250,14,15,1232,1224,1232,1232,1232
7040,8,40,7040,0,7040,0,86106800000,18.8082,351.623,7040,26,24,6457,5522,5255,5570,3596
46290,11,21,0,46290,7562,38728,5153.16,15.2952,645.225,46290,21,21,46189,46189,46141,46164,45909
9171,12,21,1697,7474,0,9171,18.664,12.0481,316.357,9171,18,19,9097,9093,9042,9056,8524
1195,4,14,0,1195,0,1195,1339020,12.7364,109.252,1195,14,14,881,667,619,704,437
41742,12,60,41742,0,0,41742,315824000,35.851,1148.73,41742,38,55,39080,35268,34797,34714,16906
23802,23,24,0,23802,23802,0,2.2389e+13,21.989,588.697,23802,24,22,23776,23750,23767,23767,23342
11327,12,19,0,11327,1795,9532,5017.12,14.3288,315.698,11327,19,19,11269,11268,11243,11253,11160
47271,1,2,47271,0,47271,0,6.10395e+13,1.99987,299.597,47271,2,2,37019,37019,37019,37019,37019
35039,3,21,5821,29218,0,35039,20.3129,12.0937,546.684,35039,21,20,27480,27480,27377,23542,17948
23502,12,56,23502,0,23502,0,86255300000,22.3709,674.24,23502,31,39,22775,21416,19980,20454,14068
32851,10,40,32851,0,0,32851,5.62936e+15,30.9105,710.474,32851,38,37,31764,30762,27938,4584,15405
48683,1,2,48683,0,48683,0,3.24012e+13,1.99975,293.513,48683,2,2,43078,43078,43078,43078,43078
19259,1,2,0,19259,19259,0,1.4951e+16,1.99969,189.167,19259,2,2,15262,15262,15262,15262,15262
30485,27,56,30485,0,30485,0,1.45831e+18,23.0232,713.455,30485,37,32,30429,30401,30406,19143,29560
2504,8,16,0,2504,2504,0,2.2129e+13,14.2939,162.468,2504,16,14,2343,2062,1986,2121,1632
22977,3,4,0,22977,22977,0,8.35137e+15,2,205.906,22977,3,3,22973,22971,22972,22972,22973
41741,14,44,41741,0,41741,0,78856800000,37.3618,973.45,41741,40,41,39913,36420,38519,37036,20695
24002,8,21,3928,20074,0,24002,19.5087,18.1208,481.193,24002,20,20,23682,23673,23533,23587,22884
8291,45,60,8291,0,8291,0,1.34743e+18,24.1891,498.093,8291,36,40,8231,8223,8225,6900,7169
48929,36,40,48929,0,0,48929,337392000,27.787,854.36,48929,39,37,48881,48843,48841,42496,48845
18517,1,2,18517,0,18517,0,4.0404e+13,1.99903,180.234,18517,2,2,15858,15858,15858,15858,15858
4848,1,2,0,4848,4848,0,8.3978e+15,1.99814,91.7795,4848,2,2,4282,4282,4282,4282,4282
24353,1,2,0,24353,24353,0,1.10337e+16,1.99951,207.386,24353,2,2,20623,20623,20623,20623,20623
28382,22,30,5055,23327,0,28382,19.7903,12.5187,594.239,28382,20,24,28352,28352,28323,28323,27797
20943,3,30,0,20943,4643,16300,4573.16,17.2865,585.666,20943,20,26,15767,15758,15553,13720,8651
42905,1,2,0,42905,42905,0,8.66942e+15,1.99977,272.752,42905,2,2,37742,37742,37742,37742,37742
37813,7,30,6587,31226,0,37813,19.954,20.5536,665.04,37813,28,23,36909,36909,35174,35748,24539
10393,1,40,0,10393,0,10393,1204710,31.5764,448.626,10393,33,34,1244,1244,1244,1244,1244
23517,1,2,23517,0,23517,0,3.87317e+13,1.99983,203.057,23517,2,2,20280,20280,20280,20280,20280
2342,28,32,2342,0,0,2342,304769000,23.4599,195.203,2342,27,28,2304,2277,2278,2059,2274
34822,16,23,0,34822,5894,28928,4982.82,18.6048,603.921,34822,21,21,34760,34756,34672,34672,34077
38161,19,23,6354,31807,0,38161,19.509,18.0917,619.807,38161,21,20,38132,38132,38048,38048,37737
23969,28,40,23969,0,0,23969,5.68897e+15,21.3356,576.039,23969,29,29,23929,23910,23923,15605,23927
42788,3,4,0,42788,42788,0,9.44421e+15,1.99965,279.169,42788,3,3,42784,42782,42783,42783,42784
10371,16,40,10371,0,0,10371,287026000,33.2599,500.173,10371,32,37,9851,8113,9348,9347,5970
47909,19,21,7678,40231,0,47909,19.9297,17.4329,655.85,47909,21,21,47880,47880,47860,47862,47878
18973,13,40,18973,0,0,18973,339152000,22.9511,610.431,18973,31,35,18517,17382,16224,16438,8276
12768,37,56,0,12768,0,12768,1323260,20.5971,494.864,12768,30,32,12712,12704,12712,12711,12547
29864,22,40,29864,0,29864,0,1.37191e+18,30.0387,738.396,29864,37,35,29622,29150,29363,6860,20999
14234,29,36,14234,0,0,14234,315535000,29.9001,489.403,14234,34,33,14173,14059,14116,12411,12747
30767,23,40,30767,0,30767,0,87445500000,22.5482,702.46,30767,31,29,30725,30690,30709,30711,29963
34624,4,40,34624,0,34624,0,1.42802e+18,36.7296,739.016,34624,38,37,26021,20281,19881,4386,8104
15114,3,40,15114,0,0,15114,5.64708e+15,30.7762,464.324,15114,29,29,10216,8703,7875,1949,2631
902,4,20,902,0,902,0,85404100000,12.153,101.992,902,13,12,690,536,509,601,320
19918,11,21,3168,16750,0,19918,19.7556,16.8917,424.089,19918,20,20,19829,19829,19786,19813,11180
46439,14,30,8908,37531,0,46439,18.6598,20.5164,794.718,46439,22,28,46263,46250,45959,45981,41766
11666,1,19,0,11666,2099,9567,5193.82,11.4111,342.149,11666,19,18,1795,1795,1795,1795,1795
24322,105,406,24322,0,19440,4882,4.02413e+16,7.63502,903.921,24322,159,62,23916,23879,23863,23873,23811
31502,1,4,0,31502,31502,0,8.30783e+15,3.0945,255.728,31502,4,4,27837,27837,27837,27837,27837
13463,23,24,13463,0,0,13463,5.74993e+15,20.3803,440.041,13463,21,21,13439,13426,13438,12629,13439
2940,11,20,0,2940,2940,0,2.21623e+13,18.9007,189.019,2940,16,19,2863,2761,2506,2498,2156
42241,8,64,42241,0,42241,0,1.22301e+18,37.8864,1078.05,42241,47,39,34981,29584,30073,4501,8583
41205,1,2,0,41205,41205,0,1.39411e+16,1.99937,277.139,41205,2,2,33232,33232,33232,33232,33232
34199,31,56,34199,0,0,34199,339836000,22.3122,747.998,34199,31,32,34143,34119,34133,34131,33208
13073,43,44,13073,0,13073,0,1.40532e+18,19.2701,508.933,13073,28,37,13029,13022,13017,12949,12995
45017,31,60,45017,0,0,45017,319318000,29.014,1050.63,45017,38,44,44922,44688,44656,41559,34040
31879,46,60,31879,0,31879,0,86306800000,22.8914,836.075,31879,32,44,31819,31814,31813,31814,31137
15136,36,44,15136,0,0,15136,4.45064e+15,29.8656,648.569,15136,33,37,15092,15081,14902,14647,11619
15168,20,24,15168,0,15168,0,87163400000,18.8714,440.577,15168,21,21,15142,15130,15114,15110,15137
34245,20,24,34245,0,34245,0,87121900000,21.2002,702.841,34245,24,22,34195,34089,34107,34098,32644
27708,4,40,27708,0,27708,0,1.46653e+18,22.4689,662.623,27708,28,29,19796,14985,14440,2958,7080
3316,46,56,3316,0,0,3316,5.43325e+15,17.3878,277.018,3316,24,30,3260,3252,3260,3260,3258
34184,1,44,0,34184,0,34184,1280570,33.4591,789.149,34184,36,37,4034,4034,4034,4034,4034
21523,12,13,3596,17927,0,21523,20.3864,11.383,415.523,21523,13,13,21507,21507,21497,21497,21497
8759,14,36,8759,0,0,8759,5.57448e+15,23.6343,335.541,8759,26,25,8680,8595,8572,1239,6787
12810,571,736,12777,33,12810,0,4.26955e+18,178.148,2042.47,12810,180,120,12074,12064,11411,11380,10675
25736,55,56,25736,0,0,25736,334939000,32.8112,699.457,25736,36,40,25680,25668,25679,25680,25669
9306,4,19,1484,7822,0,9306,19.5117,13.9567,285.608,9306,18,19,8546,8546,7856,7835,8053
34017,12,64,0,34017,34017,0,1.96553e+13,28.8282,1040.28,34017,36,44,30771,25944,26869,26520,13198
5011,1,22,5011,0,5011,0,1.47538e+18,17.4424,265.175,5011,19,19,510,510,510,510,510
17295,1,2,17295,0,17295,0,3.23057e+13,1.99977,175.114,17295,2,2,15309,15309,15309,15309,15309
28358,9,31,9077,19281,6,28352,9925470000,17.3398,714.526,28358,26,24,27406,27403,26522,26588,14305
40652,44,56,40652,0,40652,0,1.46145e+18,22.7,816.107,40652,40,32,40596,40584,40591,32182,40594
2101,19,32,2101,0,0,2101,3.93556e+15,24.6406,224.91,2101,27,27,2012,1751,1801,1183,1632
10119,3,4,0,10119,10119,0,8.5025e+15,2.0002,138.393,10119,3,3,10115,10113,10114,10114,10115
6769,5,12,1224,5545,0,6769,20.2257,11.4686,250.686,6769,12,12,6166,6166,5541,5382,3969
35357,54,65,0,35357,35356,1,6.2483e+14,30.7295,1139.48,35357,37,48,35292,35284,35285,35292,28587
21102,7,21,0,21102,4541,16561,4508.33,18.8037,511.69,21102,20,20,19890,19890,19764,19876,17286
40644,21,28,6727,33917,0,40644,20.2395,11.9207,612.4,40644,20,21,40616,40616,40616,40616,40606
2025,8,9,307,1718,0,2025,20.1817,7.27358,109.619,2025,9,8,2015,2015,2015,2015,2015
10916,2,21,1762,9154,0,10916,20.1561,10.3276,304.546,10916,14,20,7438,7438,7404,5270,5267
49129,7,33,15688,33441,1,49128,5729130000,21.3931,938.041,49129,23,28,42980,42980,42475,42683,14278
44268,52,56,0,44268,0,44268,1312780,32.1155,966.536,44268,38,44,44212,44200,44212,44212,44212
44911,1,4,44911,0,44911,0,5.91767e+13,1.99942,295.106,44911,3,3,35976,35976,35976,35976,35976
10412,1,2,0,10412,10412,0,1.44918e+16,1.99779,138.573,10412,2,2,8317,8317,8317,8317,8317
34804,36,44,34804,0,34804,0,79925600000,34.9697,868.187,34804,37,41,34754,34710,34526,34549,33370
3872,29,40,3872,0,0,3872,5.70772e+15,16.9241,255.419,3872,20,24,3832,3824,3830,3832,1919
38509,25,56,0,38509,38509,0,2.2278e+13,23.2395,791.014,38509,32,32,38452,38423,38432,38435,37703
42944,1,2,0,42944,42944,0,1.24218e+16,1.99951,280.526,42944,2,2,35540,35540,35540,35540,35540
9543,1,22,0,9543,0,9543,1340440,19.9516,372.728,9543,21,21,954,954,954,954,954
38646,2,21,0,38646,8755,29891,4433.62,18.4513,702.841,38646,21,20,25737,25737,25714,23263,10431
26443,18,44,26443,0,0,26443,5.16246e+15,29.8167,780.42,26443,37,41,25953,25081,25395,13711,15869
48675,1,2,0,48675,48675,0,1.1997e+16,1.99938,295.892,48675,2,2,40570,40570,40570,40570,40570
23622,35,40,23622,0,0,23622,340792000,21.9879,615.246,23622,32,24,23582,23570,23580,23580,23582
41778,1,2,41778,0,41778,0,3.35253e+13,1.9995,270.065,41778,2,2,36801,36801,36801,36801,36801
10408,4,40,0,10408,0,10408,1321220,18.9732,390.013,10408,24,29,7693,5916,5728,5416,2628
34727,21,44,34727,0,0,34727,325588000,32.262,774.63,34727,37,37,34476,34119,34257,27151,24678
49645,39,60,49645,0,0,49645,330286000,31.2502,988.627,49645,37,44,49584,49542,49423,49233,34988
17220,10,21,2708,14512,0,17220,20.0657,15.4285,375.595,17220,20,20,17167,17167,17149,17157,17130
8991,17,40,0,8991,8991,0,2.20553e+13,17.9601,363.429,8991,25,29,8938,8844,8904,8875,7889
25914,20,40,25914,0,0,25914,335920000,22.0841,628.563,25914,36,37,25818,25736,25752,24888,21894
7547,2,22,7547,0,0,7547,343796000,17.2939,320.903,7547,19,19,4067,4067,2658,1166,1057
1702,1,38,0,1702,0,1702,1282840,18.8455,184.257,1702,22,26,155,155,155,155,155
8713,1,2,8713,0,8713,0,7.24928e+13,1.99748,131.131,8713,2,2,6468,6468,6468,6468,6468
17645,20,21,2758,14887,0,17645,20.0852,10.3959,374.979,17645,19,20,17624,17624,17623,17623,17620
39974,10,40,39974,0,39974,0,78106700000,33.8373,910.963,39974,40,37,36939,34245,33767,33145,15357
29946,1,13,5035,24911,0,29946,20.3584,11.8717,498.88,29946,13,13,4963,4963,4963,4963,4963
46111,34,44,46111,0,0,46111,328691000,37.0656,895.923,46111,38,38,46043,45900,45870,37522,39512
7667,4,21,2623,5044,0,7667,14.9832,15.6221,333.413,7667,18,19,5398,5398,5290,5301,2820
37798,37,44,37798,0,37798,0,82278700000,35.3162,836.294,37798,37,37,37749,37708,37573,37573,35071
29613,24,40,29613,0,29613,0,1.06506e+18,37.041,893.247,29613,36,37,29365,28835,27324,18303,20657
10361,7,36,10361,0,10361,0,1.45019e+18,18.9072,369.872,10361,28,25,9399,8351,7586,1477,5120
28062,1,21,0,28062,7469,20593,4171.21,17.4566,618.841,28062,20,20,7211,7211,7211,7211,7211
12927,8,19,0,12927,4355,8572,3794.67,16.4963,424.059,12927,19,18,11810,11565,11386,11458,7822
18386,1,2,18386,0,18386,0,3.26698e+13,1.9988,179.125,18386,2,2,16251,16251,16251,16251,16251
35259,24,44,35259,0,0,35259,327379000,33.2452,797.146,35259,37,37,35089,34856,34845,23329,25799
13583,2,4,0,13583,13583,0,1.02598e+16,1.99934,160.742,13583,3,3,13578,13577,13578,13578,12478
5868,17,38,5868,0,5868,0,85466100000,32.326,341.368,5868,30,29,5763,5539,5552,5535,4772
30690,41,49,30690,0,0,30690,5.22454e+15,33.9506,939.469,30690,37,41,30641,30621,30538,29996,28715
22360,25,28,0,22360,3707,18653,5154.35,12.0784,470.758,22360,20,21,22332,22332,22332,22332,22326
11865,1,2,11865,0,11865,0,4.42199e+13,1.99899,144.956,11865,2,2,10000,10000,10000,10000,10000
34128,11,19,0,34128,6158,27970,5163.78,16.649,599.723,34128,19,19,33997,33993,33997,33996,33875
47777,24,40,0,47777,47777,0,2.23067e+13,35.8116,897.179,47777,33,31,47705,47643,47661,47670,43890
28255,19,23,4805,23450,0,28255,19.2873,19.4099,549.183,28255,21,21,28226,28226,28146,28146,27838
38268,1,40,0,38268,0,38268,1329610,32.3379,812.157,38268,32,30,3782,3782,3782,3782,3782
25471,39,60,0,25471,0,25471,1235330,24.1716,836.658,25471,36,44,25411,25403,25254,25257,19214
46710,1,2,46710,0,46710,0,3.67346e+13,1.99981,285.546,46710,2,2,40613,40613,40613,40613,40613
15849,1,2,0,15849,15849,0,8.47469e+15,1.99867,166.045,15849,2,2,13984,13984,13984,13984,13984
33591,26,56,33591,0,33591,0,1.4602e+18,22.1495,740.28,33591,38,32,33535,33509,33512,11890,30146
33140,14,44,33140,0,33140,0,70248800000,37.0374,927.22,33140,38,39,30029,23299,28080,25962,14139
43402,7,21,0,43402,9987,33415,4428.45,18.7038,753.254,43402,21,20,40545,40545,40287,40510,15563
659,1,2,659,0,659,0,3.33157e+13,1.96662,33.971,659,2,2,580,580,580,580,580
17144,36,40,0,17144,0,17144,1323920,21.2491,496.766,17144,29,29,17104,17090,17104,17104,17104
33579,14,44,33579,0,0,33579,321115000,33.6476,778.329,33579,37,37,32806,31736,32055,32071,13930
38436,37,60,38436,0,0,38436,324976000,25.1131,977.179,38436,35,44,38376,38364,38217,37288,32968
27581,1,2,27581,0,27581,0,3.23307e+13,1.99906,220.988,27581,2,2,24412,24412,24412,24412,24412
34728,1,2,34728,0,34728,0,3.25826e+13,1.99948,246.356,34728,2,2,30707,30707,30707,30707,30707
27475,1,4,0,27475,27475,0,8.33481e+15,1.99989,224.554,27475,3,3,24294,24294,24294,24294,24294
42021,35,40,42021,0,42021,0,1.43265e+18,33.57,800.096,42021,38,37,41968,41851,41918,36044,40243
8561,2,13,1418,7143,0,8561,20.3808,10.2369,258.908,8561,12,12,5724,5724,5687,3827,2147
22929,1,2,0,22929,22929,0,1.60589e+16,1.99961,208.28,22929,2,2,17818,17818,17818,17818,17818
37771,50,60,0,37771,37771,0,2.13924e+13,34.5406,871.353,37771,37,44,37711,37699,37707,37711,32507
37989,6,40,37989,0,0,37989,5.58982e+15,35.1401,768.245,37989,38,37,33451,30582,25094,5425,10263
38868,14,56,38868,0,38868,0,86130500000,28.468,825.96,38868,37,40,38393,37836,36290,36704,23240
5736,19,36,5736,0,0,5736,5.59652e+15,15.1647,267.289,5736,24,25,5700,5684,5691,3000,5358
11034,22,40,11034,0,11034,0,6.256e+10,30.5679,536.498,11034,33,33,10857,10389,10374,9694,8286
33683,30,40,0,33683,33683,0,2.19802e+13,29.1948,708.93,33683,37,37,33617,33535,33568,33548,28930
35314,8,40,0,35314,35314,0,2.23332e+13,22.1296,716.462,35314,32,29,32335,27417,25553,27680,15180
12978,1,40,12978,0,0,12978,4.83674e+15,33.4521,531.891,12978,34,33,1379,1379,1379,1379,1379
4906,19,22,0,4906,0,4906,1343310,17.4138,266.233,4906,19,19,4883,4872,4874,4872,4883
20047,1,4,0,20047,20047,0,9.99971e+15,1.9997,193.936,20047,3,3,17262,17262,17262,17262,17262
46950,1,28,0,46950,7820,39130,5189.77,12.3779,655.605,46950,20,21,7918,7918,7918,7918,7918
14408,6,65,14408,0,0,14408,7.46675e+15,20.6941,605.989,14408,30,44,11812,10361,8360,3349,4434
40002,49,54,39996,6,0,40002,9.18697e+14,35.9037,1077.44,40002,40,45,39948,39929,39947,39948,37995
36974,15,23,0,36974,6451,30523,4892.01,19.9241,631.433,36974,21,21,36879,36879,36742,36745,35915
27384,11,21,0,27384,4449,22935,5183.94,12.0778,476.361,27384,21,20,27345,27345,27328,27334,27342
42205,19,28,0,42205,7014,35191,5139.65,15.4986,653.714,42205,21,27,42171,42171,42153,42153,41832
48058,4,23,7979,40079,0,48058,19.5281,19.2518,694.069,48058,21,21,43668,43668,40116,39724,24338
33429,1,2,33429,0,33429,0,4.46096e+13,1.99952,244.714,33429,2,2,28130,28130,28130,28130,28130
35961,1,40,35961,0,0,35961,335865000,33.5515,864.119,35961,38,36,3527,3527,3527,3527,3527
3067,1,2,3067,0,3067,0,3.2672e+13,1.99348,72.8874,3067,2,2,2710,2710,2710,2710,2710
24583,14,23,7051,17532,0,24583,15.9666,18.2466,597.233,24583,20,21,24458,24445,24215,24231,22627
18633,5,55,18633,0,18633,0,1.04674e+18,32.7927,703.783,18633,37,34,9560,6910,7182,4998,3415
5145,1,2,5145,0,5145,0,3.26062e+13,1.99903,95.3841,5145,2,2,4548,4548,4548,4548,4548
11935,27,40,0,11935,0,11935,1216630,27.4228,467.389,11935,33,33,11859,11669,11738,11739,11221
43569,38,56,43569,0,0,43569,5.65604e+15,28.4499,869.892,43569,37,40,43511,43470,43459,39425,37318
46901,32,60,46901,0,46901,0,1.37493e+18,29.5344,1071.47,46901,46,44,46817,46738,46503,30024,36140
1969,21,22,1969,0,1969,0,87722900000,16.6729,173.251,1969,18,19,1947,1935,1947,1947,1947
30970,5,21,4966,26004,0,30970,19.8184,16.2273,527.651,30970,20,20,29283,29283,26670,26679,27209
36498,36,44,0,36498,36498,0,2.09961e+13,35.9597,824.541,36498,37,37,36448,36408,36271,36262,33625
1097,16,18,1097,0,1097,0,88718300000,14.0009,120.673,1097,15,17,1076,1055,1068,1067,1071
12153,27,40,12153,0,12153,0,86999200000,21.0702,460.935,12153,30,24,12113,12099,12106,12106,12048
1433,15,18,1433,0,0,1433,5.7945e+15,16.7251,139.961,1433,16,18,1402,1363,1381,1228,1339
41703,1,4,0,41703,41703,0,8.33527e+15,3.22468,280.094,41703,4,4,36872,36872,36872,36872,36872
49573,30,40,0,49573,0,49573,1321550,33.851,981.592,49573,38,38,49475,49303,49332,49335,39544
18974,33,56,18974,0,18974,0,86562100000,20.2978,579.918,18974,30,32,18918,18902,18916,18914,17821
21429,1,2,21429,0,21429,0,3.28118e+13,1.99944,193.252,21429,2,2,18930,18930,18930,18930,18930
27248,11,40,0,27248,0,27248,1183590,34.8458,753.58,27248,38,37,25336,23183,24125,24103,12706
23233,1,24,0,23233,23233,0,2.24302e+13,21.4144,569.575,23233,23,22,2474,2474,2474,2474,2474
27786,2,5,1,27785,27786,0,1.17995e+16,1.99989,235.51,27786,4,3,27780,27779,27780,27778,24972
18990,6,21,0,18990,6982,12008,3701.39,16.9046,514.255,18990,20,19,15002,15002,14917,14990,11363
47280,25,33,0,47280,13721,33559,1.52401e+12,18.8151,1020.39,47280,22,32,47247,47247,47246,46294,36511
20684,19,21,3274,17410,0,20684,20.1091,15.0855,410.211,20684,20,20,20661,20661,20657,20659,20661
47940,1,2,0,47940,47940,0,1.29911e+16,1.99981,297.092,47940,2,2,39296,39296,39296,39296,39296
15641,1,2,0,15641,15641,0,8.44457e+15,1.99898,164.555,15641,2,2,13807,13807,13807,13807,13807
31174,42,44,31174,0,0,31174,309634000,31.2628,832.493,31174,38,41,31130,31119,30952,30796,29249
20241,1,2,20241,0,20241,0,3.25961e+13,1.99916,187.422,20241,2,2,17896,17896,17896,17896,17896
23639,15,40,0,23639,23639,0,2.23155e+13,32.2023,637.663,23639,31,30,23339,22857,22162,21566,16158
9935,32,40,9935,0,0,9935,5.73965e+15,21.2336,401.087,9935,22,27,9895,9887,9894,9895,6427
35023,38,40,35023,0,35023,0,75675200000,34.4348,876.859,35023,39,37,34979,34933,34805,34893,34637
40804,21,56,40804,0,0,40804,5.63218e+15,32.2055,935.166,40804,38,44,40542,39956,40229,32109,34550
49757,5,28,0,49757,8290,41467,5191.33,12.1268,671.324,49757,28,19,46512,46512,41447,41104,8378
42778,12,40,0,42778,42778,0,2.21221e+13,35.7496,921.701,42778,38,38,41218,38426,35304,36499,17017
21270,1,2,21270,0,21270,0,3.47642e+13,1.99944,191.891,21270,2,2,18642,18642,18642,18642,18642
42394,28,44,0,42394,42394,0,2.15636e+13,32.53,863.085,42394,37,38,42276,42098,42067,41742,31378
9158,1,2,0,9158,9158,0,1.32344e+16,1.99847,128.839,9158,2,2,7475,7475,7475,7475,7475
40225,1,2,0,40225,40225,0,8.43374e+15,1.9998,264.172,40225,2,2,35516,35516,35516,35516,35516
35589,16,33,0,35589,11540,24049,2.02465e+12,18.9672,805.411,35589,22,26,35504,35499,35093,28241,17835
3460,9,32,0,3460,3460,0,2.16928e+13,14.2191,202.671,3460,24,21,3327,2980,3051,3031,2067
5388,31,40,5388,0,0,5388,5.51561e+15,22.9404,369.351,5388,31,31,5339,5282,5291,5305,4194
35374,17,40,0,35374,35374,0,2.20349e+13,29.8921,735.532,35374,38,37,35182,34750,35026,34824,23837
24768,1,2,24768,0,24768,0,3.25478e+13,1.99883,208.437,24768,2,2,21903,21903,21903,21903,21903
31603,19,28,5385,26218,0,31603,20.1419,12.354,577.556,31603,20,23,31574,31574,31558,31558,31428
35287,2,21,8697,26590,0,35287,16.8026,18.316,686.21,35287,21,20,22939,22939,22905,21068,9914
3606,31,36,3606,0,3606,0,80820700000,21.0424,247.975,3606,28,32,3568,3534,3534,3531,3525
13267,4,13,2297,10970,0,13267,20.4073,11.6517,336.823,13267,13,12,11753,11753,10698,7592,5279
45026,22,60,45026,0,0,45026,5.50642e+15,37.5758,938.514,45026,38,44,44760,44362,44507,10602,28943
22867,2448,3552,22867,0,6133,16734,1.4556e+18,162.131,5615.34,22867,895,210,19315,19313,19237,19218,11768
37966,25,40,37966,0,37966,0,1.46614e+18,29.1672,793.769,37966,32,31,37911,37868,37884,23361,37907
14668,36,40,14668,0,0,14668,5.57515e+15,23.8257,485.273,14668,32,37,14628,14617,14588,13522,14588
3176,19,36,3176,0,3176,0,1.42055e+18,15.1996,207.625,3176,21,25,3140,3124,3131,2093,2979
21955,1,2,21955,0,21955,0,6.89489e+13,1.99968,207.339,21955,2,2,16576,16576,16576,16576,16576
24881,7,19,0,24881,4487,20394,5175.44,16.4347,507.296,24881,19,19,24138,24138,22452,22430,21062
41045,56,60,41045,0,0,41045,327734000,33.3908,906.344,41045,37,44,40985,40973,40983,40879,36134
46279,39,56,46279,0,0,46279,5.65614e+15,28.1897,891.737,46279,38,40,46221,46179,46181,40382,37252
23367,1,2,0,23367,23367,0,8.42168e+15,1.99961,201.635,23367,2,2,20635,20635,20635,20635,20635
2866,18,36,2866,0,0,2866,5.5745e+15,14.2701,198.731,2866,18,25,2830,2818,2821,2492,2750
37956,1,2,0,37956,37956,0,1.10566e+16,1.99955,260.272,37956,2,2,32131,32131,32131,32131,32131
10243,28,36,10243,0,0,10243,5.66314e+15,18.952,367.097,10243,28,19,10207,10195,10207,8086,9663
23412,1,2,23412,0,23412,0,3.26536e+13,1.99953,202.237,23412,2,2,20695,20695,20695,20695,20695
23841,8,44,23841,0,23841,0,1.39503e+18,27.2869,661.364,23841,34,37,21884,19247,18846,5308,10255
9337,1,2,0,9337,9337,0,1.62606e+16,1.99861,135.908,9337,2,2,7229,7229,7229,7229,7229
37611,8,40,37611,0,37611,0,1.46346e+18,22.5436,741.088,37611,32,29,34418,29175,27139,5259,13242
26407,1,20,4515,21892,0,26407,20.3145,12.0153,495.769,26407,19,19,4299,4299,4299,4299,4299
11552,10,40,11552,0,11552,0,1.45505e+18,22.4774,439.582,11552,29,27,11076,10672,9089,2407,6290
5391,25,40,0,5391,0,5391,1302990,19.1211,318.178,5391,26,24,5351,5333,5340,5342,5136
17133,35,40,17133,0,17133,0,86658400000,19.1723,484.04,17133,27,29,17093,17080,17093,17084,17093
22585,1,2,22585,0,22585,0,3.24036e+13,1.99889,199.904,22585,2,2,19984,19984,19984,19984,19984
19286,1,2,19286,0,19286,0,5.13444e+13,1.99901,187.81,19286,2,2,15767,15767,15767,15767,15767
45624,3,4,0,45624,45624,0,9.14934e+15,1.99993,288.019,45624,3,3,45620,45618,45619,45619,45620
17927,35,40,17927,0,17927,0,86741700000,19.3044,495.647,17927,28,29,17887,17874,17887,17878,17887
39658,30,60,0,39658,0,39658,1272490,34.9487,961.7,39658,37,51,39524,39254,39235,39236,25620
30798,8,40,30798,0,30798,0,87105400000,34.9639,716.865,30798,32,31,27860,23240,21456,23449,9901
17854,29,38,0,17854,0,17854,1327460,30.4272,564.118,17854,31,29,17807,17766,17793,17793,17807
34749,38,40,0,34749,0,34749,1323370,26.9152,698.278,34749,31,29,34707,34678,34705,34705,34668
17419,18,30,0,17419,3930,13489,4552.54,19.5557,594.753,17419,20,30,17376,17375,17258,17258,14518
47703,3,44,47703,0,0,47703,311952000,38.2765,998.313,47703,38,41,31946,27541,25680,20844,8487
1530,21,24,0,1530,1530,0,2.20104e+13,15.5647,159.125,1530,17,21,1506,1498,1494,1501,1472
3981,12,40,3981,0,3981,0,1.29208e+18,19.0241,299.959,3981,28,33,3690,3308,3499,2162,2536
41102,26,60,41102,0,41102,0,1.40112e+18,24.7839,1000.06,41102,42,44,40989,40760,40768,34735,35948
8673,1,2,8673,0,8673,0,6.24418e+13,1.99758,127.806,8673,2,2,6748,6748,6748,6748,6748
49013,1,2,0,49013,49013,0,1.44283e+16,1.99947,302.457,49013,2,2,39198,39198,39198,39198,39198
32354,6,40,32354,0,0,32354,308260000,34.1039,812.137,32354,39,37,27557,24977,22185,24107,9761
13289,11,36,13289,0,0,13289,248382000,31.0757,577.353,13289,34,33,10595,7487,9225,9124,5330
26756,36,40,26756,0,26756,0,87125800000,31.002,678.205,26756,31,30,26713,26672,26709,26711,25638
43786,18,20,0,43786,7634,36152,5206.53,14.4295,644.062,43786,20,19,43761,43761,43761,43761,43760
2354,2,18,0,2354,2354,0,2.26572e+13,16.6529,175.931,2354,17,18,1248,1248,803,1020,381
17884,6,60,17884,0,17884,0,81371900000,30.3333,618.033,17884,35,40,15634,14311,12357,13377,4792
26720,19,60,26720,0,0,26720,5.46045e+15,27.1514,757.294,26720,36,40,26454,26037,26286,7865,17631
24580,18,21,3941,20639,0,24580,20.2033,11.7184,447.288,24580,20,20,24556,24556,24556,24556,24553
25705,7,23,0,25705,5286,20419,4623.4,17.7449,577.574,25705,21,22,24415,24415,24189,24303,13739
7054,1,2,7054,0,7054,0,3.26007e+13,1.99688,110.38,7054,2,2,6236,6236,6236,6236,6236
41945,24,40,41945,0,41945,0,1.4661e+18,37.5853,834.797,41945,33,31,41873,41825,41827,13323,16972
48323,1,4,0,48323,48323,0,9.10207e+15,1.99954,296.158,48323,3,3,42216,42216,42216,42216,42216
17703,18,24,17703,0,17703,0,1.46722e+18,21.7545,497.213,17703,22,22,17661,17615,17435,14179,15879
6065,17,22,6065,0,0,6065,341221000,20.6401,307.417,6065,21,22,6007,5827,5906,5903,5536
26572,1,40,26572,0,26572,0,84094900000,31.8742,653.916,26572,37,36,3301,3301,3301,3301,3301
46567,28,56,46567,0,0,46567,337045000,28.8584,886.923,46567,40,40,46475,46394,46414,43305,35354
38316,1,2,38316,0,38316,0,3.24847e+13,1.99987,259.895,38316,2,2,33893,33893,33893,33893,33893
44814,15,40,44814,0,0,44814,5.72356e+15,22.6504,825.115,44814,32,28,44456,43808,42501,35469,30035
29575,11,40,29575,0,0,29575,340609000,36.0649,717.084,29575,32,36,28467,26990,24811,24582,9633
26810,20,23,4539,22271,0,26810,19.4512,14.3106,526.963,26810,20,21,26786,26786,26720,26720,26614
15242,12,40,15242,0,0,15242,5.66363e+15,22.4888,468.951,15242,29,29,14943,14351,13393,2433,10045
37361,17,48,37361,0,0,37361,297664000,38.0622,989.974,37361,37,41,36153,30127,34651,32147,20270
22962,2,40,0,22962,0,22962,1329830,32.5646,629.242,22962,31,30,12240,12240,7915,3429,3184
13414,1,2,0,13414,13414,0,8.46599e+15,1.99858,152.573,13414,2,2,11837,11837,11837,11837,11837
21371,21,27,6122,15249,4,21367,13170500000,17.3428,576.85,21371,20,22,21344,21340,21342,21342,21302
16237,16,40,0,16237,16237,0,1.85248e+13,32.4571,612.275,16237,34,37,15405,12718,14650,13725,8350
9154,3,36,9154,0,9154,0,85730400000,18.0756,338.579,9154,25,25,6320,5406,4918,4990,2242
36038,37,44,36038,0,36038,0,1.3427e+18,35.5966,877.874,36038,37,41,35988,35940,35738,33388,34579
45882,23,44,45882,0,45882,0,78882100000,38.5252,1008.35,45882,40,41,45490,44444,44974,43884,28152
20133,1,2,0,20133,20133,0,1.56442e+16,1.9997,194.878,20133,2,2,15761,15761,15761,15761,15761
38215,10,40,38215,0,38215,0,1.45146e+18,27.5121,734.327,38215,32,29,37013,35881,32327,5176,21385
34258,19,40,34258,0,34258,0,85857200000,28.9057,713.462,34258,37,37,34126,33944,34014,33857,27242
27529,14,40,0,27529,27529,0,2.2346e+13,21.6391,662.627,27529,30,28,27187,26799,24553,25806,18104
40647,1,2,0,40647,40647,0,1.42282e+16,1.99956,275.272,40647,2,2,32620,32620,32620,32620,32620
30280,14,20,0,30280,5357,24923,5196.97,15.4798,546.033,30280,20,19,30244,30244,30244,30244,30244
37293,19,40,37293,0,37293,0,86170200000,29.5473,758,37293,38,37,37155,36971,37035,36856,27434
15357,1,2,15357,0,15357,0,5.77906e+13,1.99824,170.561,15357,2,2,12203,12203,12203,12203,12203
8869,18,56,8869,0,8869,0,8.1661e+10,29.3811,520.278,8869,35,47,8624,8357,8382,8261,5488
35395,21,40,35395,0,0,35395,337861000,28.2922,709.215,35395,32,29,35316,35234,35257,35252,30301
11979,1,2,11979,0,11979,0,3.26378e+13,1.99833,145.242,11979,2,2,10589,10589,10589,10589,10589
47540,19,40,47540,0,0,47540,5.64748e+15,37.6801,982.797,47540,37,38,47128,46518,46362,38592,26758
15948,1,2,0,15948,15948,0,8.36786e+15,1.99893,167.104,15948,2,2,14095,14095,14095,14095,14095
6708,7,11,1097,5611,0,6708,20.4013,9.46661,219.143,6708,11,10,6615,6615,6450,6450,6545
42952,39,40,0,42952,42952,0,2.23627e+13,28.0305,841.498,42952,32,30,42911,42882,42910,42910,42911
19867,33,40,19867,0,0,19867,335399000,30.8622,527.512,19867,30,29,19819,19769,19808,17761,18582
47836,16,23,0,47836,8141,39695,4955.96,17.8015,703.544,47836,21,21,47760,47754,47635,47637,46956
16039,19,56,16039,0,0,16039,332578000,25.5806,579.581,16039,31,40,15901,15736,15803,14925,12121
31952,16,40,0,31952,0,31952,1299410,30.0764,698.556,31952,37,37,31685,31296,31429,31428,17783
47026,2,20,0,47026,8027,38999,5207.17,12.5268,651.479,47026,20,19,30988,30988,30536,18304,18838
44257,30,44,44257,0,44257,0,1.33162e+18,35.8306,968.981,44257,39,41,44142,43809,43754,24669,37097
41752,19,40,0,41752,0,41752,1331360,31.748,827.909,41752,32,31,41626,41405,41228,41105,34394
28098,12,65,28098,0,0,28098,5.74366e+15,27.6029,1023.52,28098,37,48,24007,17882,20054,11635,11079
46184,25,44,46184,0,46184,0,83872800000,35.7752,895.864,46184,38,37,45988,45661,45691,45167,34085
41055,5,48,0,41055,0,41055,1115770,35.9668,1039.4,41055,38,41,29857,23312,25016,24718,6034
15502,3,8,15502,0,15502,0,1.26829e+14,6.72526,189.969,15502,6,8,15479,15469,15471,15474,13824
32981,1,21,5373,27608,0,32981,20.2644,12.085,523.557,32981,21,20,5692,5692,5692,5692,5692
11618,3,4,0,11618,11618,0,8.29859e+15,1.99879,147.535,11618,3,3,11614,11612,11613,11613,11614
46003,1,2,46003,0,46003,0,3.23492e+13,1.99965,285.101,46003,2,2,40715,40715,40715,40715,40715
15230,19,40,0,15230,0,15230,1298160,32.3086,494.914,15230,30,36,15128,15013,15072,15070,13271
4130,13,20,4130,0,0,4130,342726000,16.8814,223.308,4130,17,18,4071,3875,3887,3888,3369
13653,10,22,0,13653,13653,0,2.24438e+13,19.9108,448.365,13653,22,22,12973,12385,10930,10628,8478
48235,18,40,0,48235,48235,0,2.23674e+13,22.9325,862.992,48235,32,29,48105,47927,47438,47369,38085
666,11,18,0,666,0,666,1341820,11.8498,92.4937,666,14,15,634,602,574,572,525
27292,26,40,27292,0,27292,0,1.42231e+18,31.9279,652.144,27292,37,37,27186,27028,27087,11910,20994
8811,2,20,0,8811,8811,0,2.23816e+13,17.8062,329.116,8811,20,19,4936,4935,3339,4021,1145
14195,5,19,0,14195,2218,11977,5131.61,11.957,332.094,14195,19,18,13481,13481,12194,12202,12688
35290,26,65,35289,1,35289,1,2.45692e+12,23.8879,987.925,35290,32,48,35215,35175,35181,34521,31817
37514,20,40,37514,0,37514,0,87123500000,32.6251,805.072,37514,32,30,37389,37102,37215,37202,33900
7350,38,40,7350,0,0,7350,338220000,18.7306,364.711,7350,27,24,7310,7300,7310,7310,7156
34159,9,40,0,34159,34159,0,2.22758e+13,33.8541,773.431,34159,32,31,31388,25426,25086,25564,12986
15493,9,21,0,15493,5716,9777,3754.23,17.1747,469.45,15493,20,19,14844,14844,14202,14257,11520
23470,3,44,23470,0,23470,0,1.18895e+18,33.2148,775.336,23470,37,37,14067,12153,11717,3801,3288
36829,19,23,0,36829,6152,30677,5028.25,15.8677,609.818,36829,20,21,36802,36802,36734,36736,36632
23279,31,48,0,23279,0,23279,1099030,29.6011,817.862,23279,36,41,23209,23039,22806,22851,15537
22018,5,20,0,22018,3749,18269,5199.76,12.1486,452.402,22018,18,19,20463,20463,18236,18002,9879
48539,10,27,16036,32503,4,48535,5798770000,19.6626,863.866,48539,24,22,47258,47154,45435,45577,33788
15519,1,2,15519,0,15519,0,5.87109e+13,1.99839,170.262,15519,2,2,12281,12281,12281,12281,12281
34799,25,40,34799,0,34799,0,1.31739e+18,34.1339,840.505,34799,39,37,34563,34045,34137,14530,24753
36213,11,56,36213,0,36213,0,87038900000,22.3349,766.357,36213,31,32,35035,33381,30687,30603,17441
41291,19,28,6889,34402,0,41291,20.0866,15.6627,648.176,41291,20,27,41258,41258,41238,41238,41078
19670,19,27,0,19670,6332,13338,3.66321e+12,17.3128,569.239,19670,23,22,19643,19637,19546,18932,17706
6828,2,19,1057,5771,0,6828,19.9982,9.56356,227.962,6828,18,18,4760,4760,4757,3755,3752
25643,17,28,4271,21372,0,25643,20.1923,11.8286,499.403,25643,20,21,25609,25609,25609,25609,25549
42177,4,56,42177,0,0,42177,340251000,22.7355,820.72,42177,31,32,30565,23266,22474,19080,9439
46368,28,48,0,46368,46368,0,1.91495e+13,38.1707,1100.64,46368,38,41,46196,45887,45424,44621,35205
3928,3,12,0,3928,710,3218,5228.19,10.3831,186.807,3928,12,12,2956,2956,2924,2027,1750
18507,16,36,0,18507,0,18507,1282890,26.4675,527.084,18507,36,33,18312,18041,18166,18165,8260
8937,10,36,8937,0,8937,0,81631800000,26.8968,373.306,8937,32,32,8582,8281,8047,8045,3937
5665,25,36,5665,0,0,5665,268305000,30.0816,350.725,5665,30,29,5592,5446,5473,4166,4716
10893,18,24,0,10893,0,10893,1336780,21.2381,395.61,10893,21,21,10855,10823,10711,10709,9930
9791,10,40,9791,0,0,9791,332193000,19.8787,412.478,9791,28,36,9384,9028,8414,8387,6048
35910,22,23,0,35910,6053,29857,4987.17,18.2758,610.612,35910,21,21,35886,35886,35834,35834,35884
2274,16,32,2274,0,2274,0,9.76485e+17,24.2568,226.321,2274,27,25,2046,1162,1793,917,1429
35978,18,21,0,35978,5760,30218,5166.62,14.3149,543.649,35978,21,20,35950,35950,35948,35950,35941
49280,1,44,0,49280,49280,0,2.04369e+13,37.7185,1011.83,49280,38,41,5736,5736,5736,5736,5736
41793,1,2,41793,0,41793,0,3.37288e+13,1.99988,269.441,41793,2,2,36784,36784,36784,36784,36784
15185,15,40,0,15185,0,15185,1301120,23.3558,492.816,15185,32,37,15020,14782,14887,14877,10726
27590,6,20,0,27590,4770,22820,5213.23,12.0351,504.38,27590,20,18,26646,26646,25630,25426,24458
25502,16,32,7229,18273,0,25502,16.2403,19.4231,674.89,25502,22,27,25430,25426,25146,25150,16449
21035,43,64,21035,0,21035,0,1.1883e+18,31.1219,857.056,21035,42,44,20971,20963,20861,16601,12031
26303,3,40,26303,0,0,26303,4.20962e+15,34.464,827.845,26303,38,34,13872,11926,11799,4657,3599
13334,26,40,13334,0,0,13334,294043000,26.6903,553.448,13334,36,37,13237,13011,13022,8142,9127
24947,21,40,24947,0,24947,0,85990900000,22.3723,614.592,24947,36,37,24856,24769,24799,24648,21040
9383,10,13,0,9383,1550,7833,5193.01,12.3568,279.385,9383,12,13,9360,9360,9337,9336,9351
26930,1,2,0,26930,26930,0,1.21559e+16,1.99929,220.304,26930,2,2,22386,22386,22386,22386,22386
2700,13,44,2700,0,0,2700,4.68541e+15,20.7933,277.367,2700,28,36,2444,2062,2301,946,1262
34600,1,2,34600,0,34600,0,3.41593e+13,1.99962,244.875,34600,2,2,30400,30400,30400,30400,30400
34225,6,25,0,34225,6629,27596,4800.34,19.7883,666.875,34225,22,23,32286,32286,31682,31750,29358
20239,29,40,20239,0,20239,0,1.45643e+18,21.2617,534.048,20239,29,29,20199,20180,20194,16774,20197
3452,17,20,0,3452,0,3452,1337000,15.799,203.241,3452,16,17,3430,3408,3428,3427,3279
20271,13,24,20271,0,0,20271,340239000,20.4413,515.554,20271,22,22,20010,19103,18350,18703,15389
41600,1,2,41600,0,41600,0,4.95423e+13,1.99911,274.709,41600,2,2,34277,34277,34277,34277,34277
49525,39,40,0,49525,49525,0,2.23592e+13,22.8146,877.725,49525,32,29,49485,49471,49484,49484,49485
1383,2,22,1383,0,0,1383,335302000,19.9262,149.825,1383,17,20,715,715,464,193,218
47497,39,64,47497,0,47497,0,74292600000,36.9967,1122.07,47497,40,44,47430,47373,46877,46938,19945
32312,22,44,0,32312,0,32312,1285080,25.481,752.137,32312,36,37,32144,31862,31957,31972,25186
35757,32,33,9156,26601,1,35756,7871640000,17.3048,895.354,35757,20,32,35724,35724,35724,35724,35687
19770,1,2,19770,0,19770,0,3.46967e+13,1.99919,185.298,19770,2,2,17332,17332,17332,17332,17332
3058,1,4,0,3058,3058,0,8.78924e+15,2.00065,77.7052,3058,3,3,2682,2682,2682,2682,2682
4079,6,11,657,3422,0,4079,20.3972,8.62883,167.653,4079,10,10,3995,3995,3894,3894,3951
30606,28,40,30606,0,30606,0,87366700000,21.5226,695.474,30606,30,28,30566,30548,30558,30552,29242
8176,2,15,0,8176,1474,6702,5176.74,11.1409,284.084,8176,15,12,5217,5217,4999,2933,2933
32908,32,40,32908,0,0,32908,290397000,34.4283,863.734,32908,38,37,32836,32733,32505,28953,30375
30286,22,40,30286,0,30286,0,1.46114e+18,22.8816,665.429,30286,32,29,30239,30192,30209,4749,26382
48226,1,20,8274,39952,0,48226,20.328,15.722,670.343,48226,20,20,7820,7820,7820,7820,7820
47555,58,60,47555,0,0,47555,330039000,32.6315,978.9,47555,37,44,47495,47482,47493,47390,44876
9931,22,24,9931,0,0,9931,342674000,19.9536,373.99,9931,20,21,9906,9893,9905,9905,9461
27487,14,44,0,27487,0,27487,1266780,33.2015,707.289,27487,37,37,26906,26074,26280,26271,15588
6273,5,24,6273,0,0,6273,342659000,16.1113,291.922,6273,19,21,4962,3677,3659,3479,2061
3242,1,2,0,3242,3242,0,1.86701e+16,1.99352,80.0331,3242,2,2,2401,2401,2401,2401,2401
42496,23,56,42496,0,42496,0,86460500000,23.7949,858.283,42496,34,40,42396,42267,42328,42315,38274
587,1,8,0,587,100,487,5292.7,6.91823,61.2562,587,8,8,95,95,95,95,95
18069,1,2,18069,0,18069,0,5.67031e+13,1.99945,185.453,18069,2,2,14428,14428,14428,14428,14428
5476,8,22,0,5476,0,5476,1339680,17.3616,275.323,5476,19,19,4963,4140,3822,4131,2730
23348,1,2,0,23348,23348,0,8.35755e+15,1.99961,201.463,23348,2,2,20639,20639,20639,20639,20639
19624,2,4,0,19624,19624,0,8.33524e+15,1.99995,190.803,19624,3,3,19619,19618,19619,19619,18739
4891,14,20,4891,0,0,4891,5.74253e+15,16.2002,239.732,4891,17,18,4857,4831,4716,4128,4527
26961,1,2,26961,0,26961,0,3.4327e+13,1.99952,216.256,26961,2,2,23672,23672,23672,23672,23672
38872,1,2,0,38872,38872,0,1.12076e+16,1.99951,263.364,38872,2,2,32825,32825,32825,32825,32825
39566,50,56,39566,0,0,39566,5.67164e+15,24.4832,883.456,39566,35,40,39510,39498,39510,39510,39510
36150,1,2,36150,0,36150,0,3.27336e+13,1.99961,251.215,36150,2,2,31945,31945,31945,31945,31945
6864,1,22,6864,0,6864,0,1.47563e+18,16.756,307.382,6864,19,19,704,704,704,704,704
12902,12,36,0,12902,0,12902,1219800,31.1657,478.475,12902,33,33,12374,11757,11970,11987,4357
37685,16,38,0,37685,37685,0,2.2008e+13,35.1457,878.245,37685,38,38,36988,35635,34973,34846,22653
35107,15,21,5696,29411,0,35107,20.2527,11.7871,536.586,35107,21,20,35080,35080,35080,35080,35077
36397,52,56,0,36397,36397,0,2.20168e+13,30.4928,806.238,36397,37,40,36341,36328,36337,36341,36297
7331,34,40,7331,0,7331,0,1.41052e+18,19.6052,365.655,7331,29,36,7291,7283,7250,6702,7237
38254,16,40,38254,0,0,38254,333081000,35.0339,770.057,38254,38,37,37942,37469,37620,37616,21127
33305,2,4,0,33305,33305,0,8.6521e+15,1.99964,246.502,33305,3,3,33300,33299,33300,33300,31434
34580,39,64,34580,0,34580,0,1.30561e+18,27.4172,1048.96,34580,42,44,34516,34504,34332,27564,25158
8317,36,44,8317,0,0,8317,5.05592e+15,29.1076,450.436,8317,32,37,8273,8262,8269,8272,8050
22466,19,21,3555,18911,0,22466,20.1232,14.7154,425.987,22466,20,20,22443,22443,22439,22441,22443
44990,1,2,44990,0,44990,0,3.36156e+13,1.99984,280.136,44990,2,2,39616,39616,39616,39616,39616
46421,1,2,0,46421,46421,0,1.26246e+16,1.99966,292.227,46421,2,2,38287,38287,38287,38287,38287
39915,2,56,39915,0,39915,0,85980300000,28.9636,918.871,39915,38,43,21484,21476,13965,17931,6007
11035,1,2,11035,0,11035,0,3.32107e+13,1.99855,138.333,11035,2,2,9732,9732,9732,9732,9732
3558,7,20,0,3558,634,2924,5044.02,10.796,204.384,3558,19,13,3428,3428,3118,3248,2685
26485,1,2,26485,0,26485,0,4.95039e+13,1.99924,221.784,26485,2,2,21826,21826,21826,21826,21826
28452,1,13,4666,23786,0,28452,20.3009,11.5562,477.57,28452,13,13,4853,4853,4853,4853,4853
7038,18,21,2644,4394,0,7038,14.3893,15.9757,316.261,7038,19,19,7016,7016,6944,6944,6852
27752,20,40,0,27752,27752,0,2.23054e+13,30.7535,690.424,27752,31,30,27658,27448,27533,27516,24308
25402,29,56,0,25402,25402,0,2.22262e+13,23.3375,634.99,25402,30,29,25346,25326,25338,25336,18591
18159,20,40,0,18159,18159,0,2.09287e+13,29.9284,564.982,18159,35,33,17959,17710,17814,17374,10472
14173,13,24,0,14173,0,14173,1339070,20.3186,446.969,14173,21,21,13915,13054,12428,12743,9981
16521,10,44,0,16521,0,16521,1269400,21.2359,564.63,16521,32,37,15714,15001,14072,14015,8168
38733,2,40,0,38733,0,38733,1301290,34.7517,773.691,38733,38,37,22517,22480,16131,8322,5492
32795,5,40,0,32795,32795,0,2.19402e+13,35.1673,704.915,32795,37,37,26780,20329,20951,23311,8303
13656,14,24,0,13656,0,13656,1324350,18.7058,417.303,13656,21,21,13560,13436,12862,13097,11456
24147,1,4,0,24147,24147,0,1.40851e+16,2.21899,231.107,24147,4,4,19402,19402,19402,19402,19402
22623,42,44,22623,0,22623,0,82836700000,28.1031,645.19,22623,36,37,22579,22569,22507,22546,21455
3010,14,18,3010,0,3010,0,88113900000,16.2937,203.257,3010,17,18,2964,2922,2862,2868,2716
19443,28,56,19443,0,0,19443,331578000,36.0869,591.979,19443,37,36,19355,19282,19297,19117,11647
41546,19,23,0,41546,8108,33438,4746.3,21.6158,723.32,41546,22,22,41511,41511,41300,41300,39934
7125,10,11,1127,5998,0,7125,20.2863,9.40547,222.382,7125,11,11,7111,7111,7103,7103,7103
44910,27,40,0,44910,44910,0,2.23387e+13,31.4428,853.758,44910,32,31,44857,44816,44835,44837,44857
5345,18,36,0,5345,5345,0,2.07206e+13,30.7035,305.54,5345,31,30,5235,5129,5180,5028,3768
25460,17,40,25460,0,0,25460,5.71003e+15,31.0628,662.093,25460,31,29,25267,24623,24498,20561,21296
30321,1,40,30321,0,30321,0,1.44717e+18,28.5032,651.028,30321,31,29,3655,3655,3655,3655,3655
16772,5,31,0,16772,3894,12878,4.29617e+12,17.8902,541.511,16772,22,24,14424,14418,13273,12251,4619
28961,39,40,28961,0,28961,0,1.4675e+18,22.1204,675.134,28961,28,29,28921,28907,28921,28338,28921
5478,12,40,5478,0,5478,0,75945200000,25.9775,341.551,5478,30,33,5089,4635,4869,4578,3317
35293,37,44,35293,0,0,35293,259443000,35.6009,975.385,35293,38,37,35245,35205,34904,33865,34972
16888,1,2,16888,0,16888,0,4.16346e+13,1.99769,172.288,16888,2,2,14389,14389,14389,14389,14389
2830,9,20,2830,0,2830,0,87198500000,16.212,181.36,2830,16,16,2688,2305,2068,2277,1780
34875,41,60,34875,0,34875,0,1.39839e+18,35.4778,844.44,34875,45,41,34815,34801,34760,9921,24423
16006,27,40,16006,0,16006,0,64883400000,34.5769,643.506,16006,35,34,15903,15533,15594,15176,13587
30817,22,38,0,30817,0,30817,1312210,36.0474,801.064,30817,38,38,30615,30383,30388,30410,18192
24778,20,40,0,24778,0,24778,1326790,22.506,595.137,24778,30,29,24725,24682,24664,24662,21473
43381,10,48,0,43381,43381,0,2.03455e+13,37.9195,985.45,43381,40,41,40149,37271,36322,35599,13692
39111,1,2,39111,0,39111,0,3.37459e+13,1.99951,260.876,39111,2,2,34421,34421,34421,34421,34421
34875,8,40,0,34875,0,34875,1319330,27.197,699.664,34875,31,29,32339,28066,26857,28012,15832
46074,28,60,46074,0,0,46074,5.23758e+15,40.9645,1052.27,46074,41,44,45890,45588,45433,15926,26795
34429,20,40,34429,0,0,34429,5.63676e+15,30.3442,727.399,34429,38,37,34305,34193,34200,6950,25559
36583,6,21,0,36583,6984,29599,4714.02,17.7248,649.265,36583,21,20,34599,34599,34021,34130,10005
27836,37,38,0,27836,0,27836,1327760,27.4116,694.654,27836,31,30,27797,27754,27795,27796,27797
46046,37,40,46046,0,46046,0,1.46538e+18,31.2535,882.853,46046,33,32,46002,45930,45992,42069,46000
26971,7,24,26971,0,26971,0,1.46857e+18,21.9456,618.998,26971,24,22,23804,20557,17783,5074,8713
26982,12,40,26982,0,26982,0,1.33616e+18,31.73,712.519,26982,37,35,25762,24256,24676,4350,10741
37634,5,60,0,37634,0,37634,1293290,27.4785,890.123,37634,33,40,29813,22541,23201,21276,9026
28311,29,64,0,28311,28311,0,1.89569e+13,34.3742,967.382,28311,36,44,28194,28018,27859,27923,14834
15458,16,21,3890,11568,0,15458,16.7566,18.0939,458.852,15458,20,20,15413,15409,15296,15299,15292
34163,20,40,34163,0,34163,0,1.46692e+18,21.6663,734.176,34163,31,29,34092,33953,33970,16370,31355
31120,36,56,31120,0,31120,0,86751700000,23.5835,766.774,31120,32,36,31064,31052,31064,31063,25268
7153,17,20,0,7153,7153,0,2.22645e+13,17.4757,286.414,7153,18,19,7126,7091,7107,7109,7046
41244,3,4,0,41244,41244,0,9.24743e+15,2.00019,274.475,41244,3,3,41240,41238,41239,41239,41240
44466,1,4,44466,0,44466,0,6.27061e+13,1.99984,294.914,44466,3,3,35067,35067,35067,35067,35067
46351,18,20,8309,38042,0,46351,20.1977,17.7399,696.018,46351,20,19,46319,46319,46319,46319,46319
30272,4,21,4799,25473,0,30272,20.139,14.4346,495.93,30272,21,20,27634,27634,25183,24787,24708
18455,9,40,18455,0,0,18455,5.58972e+15,33.5751,539.199,18455,32,37,17469,15168,15615,3528,7835
19131,17,40,19131,0,19131,0,8.5841e+10,31.3457,519.46,19131,30,29,19034,18876,18965,18874,16863
10094,30,36,0,10094,10094,0,2.12975e+13,30.4639,385.461,10094,32,33,10046,9966,10006,9991,9998
21772,6,24,21772,0,0,21772,5.73531e+15,20.7007,559.894,21772,24,22,18494,16512,13121,3013,7567
49854,21,23,9377,40477,0,49854,18.6653,19.9104,767.667,49854,21,22,49829,49829,49707,49709,49829
3630,11,38,0,3630,0,3630,1297000,24.5427,264.843,3630,27,26,3389,3134,2750,2761,795
38602,27,56,0,38602,38602,0,2.21666e+13,38.346,860.761,38602,40,38,38506,38380,38406,38404,28289
39951,12,40,39951,0,39951,0,1.31696e+18,33.7958,903.723,39951,40,37,37731,34893,35807,6774,16206
24184,5,13,4088,20096,0,24184,20.3842,11.7916,447.721,24184,13,13,22543,22543,20060,19961,19021
28341,21,23,0,28341,4813,23528,4950.11,18.2656,543.346,28341,20,21,28318,28318,28281,28282,28158
49033,54,66,49033,0,0,49033,5.69944e+15,34.2385,1383.21,49033,38,60,48967,48961,48960,44858,43370
30784,1780,2158,2717,28067,30502,282,5.07618e+17,83.2509,3902.59,30784,365,160,28626,28626,28622,28623,10024
18648,19,28,3047,15601,0,18648,20.0845,12.093,429.923,18648,20,21,18618,18618,18618,18618,18556
18041,26,40,18041,0,0,18041,332401000,22.9318,528.102,18041,32,37,17975,17901,17920,14077,15940
34264,4,56,34264,0,34264,0,1.43948e+18,30.777,777.259,34264,46,40,25360,19586,19062,4375,7334
26294,35,40,26294,0,0,26294,339546000,37.8596,671.591,26294,32,31,26249,26216,26246,26245,24341
22250,31,56,22250,0,0,22250,338506000,21.8193,619.293,22250,30,32,22194,22172,22186,22184,20542
13904,23,60,0,13904,13904,0,2.1549e+13,33.5105,626.205,13904,38,50,13733,13524,13567,13518,12761
19035,5,40,19035,0,0,19035,318428000,31.4316,570.749,19035,35,35,15672,12228,13148,13388,4562
38707,1,2,38707,0,38707,0,3.26946e+13,1.99951,260.041,38707,2,2,34210,34210,34210,34210,34210
29387,6,28,4866,24521,0,29387,20.2095,12.4103,528.063,29387,21,21,28553,28553,27561,27564,26770
31450,10,20,0,31450,5578,25872,5185.28,17.5819,564.729,31450,20,19,31324,31324,31226,31225,31210
41984,1,2,0,41984,41984,0,1.32362e+16,1.99931,278.889,41984,2,2,34271,34271,34271,34271,34271
34435,26,40,0,34435,34435,0,2.0428e+13,32.0793,847.356,34435,40,36,34260,33817,33901,33229,24812
40293,1,4,0,40293,40293,0,8.28896e+15,3.3205,281.904,40293,4,4,35640,35640,35640,35640,35640
15560,28,44,15560,0,15560,0,81199200000,31.7501,559.051,15560,33,37,15478,15365,15315,15061,11971
40388,23,40,0,40388,0,40388,1333890,22.4199,788.705,40388,32,28,40344,40294,40322,40315,40093
1508,18,22,1508,0,1508,0,1.4616e+18,16.6877,153.117,1508,17,18,1484,1474,1472,1320,1483
35623,30,44,35623,0,35623,0,82520600000,34.6384,797.582,35623,37,37,35531,35268,35335,35216,29093
34768,2,4,34768,0,34768,0,6.65313e+13,1.99917,261.774,34768,3,3,34763,34762,34762,34762,27365
39754,12,28,6833,32921,0,39754,19.8297,18.4726,719.756,39754,20,28,39556,39555,39475,39497,39040
45810,31,48,45810,0,0,45810,296713000,37.0837,1080.92,45810,41,41,45707,45359,45275,37999,36638
20687,23,24,20687,0,20687,0,87454800000,21.2195,555.039,20687,24,22,20662,20648,20661,20661,20489
31057,14,21,0,31057,8172,22885,4224.36,18.8848,657.616,31057,21,20,30902,30886,30633,30649,26865
17208,30,40,17208,0,0,17208,338777000,21.402,498.451,17208,29,29,17168,17150,17165,17161,17166
14422,4,19,2262,12160,0,14422,19.6295,14.6896,349.842,14422,19,19,13276,13276,12172,12132,7098
34483,17,30,6715,27768,0,34483,19.2508,13.8218,705.877,34483,20,24,34444,34444,34346,34346,32042
1396,14,18,1396,0,1396,0,1.48843e+18,14.8202,134.342,1396,15,17,1370,1354,1336,1254,1349
842,14,28,842,0,842,0,7.5922e+10,10.253,99.033,842,18,17,813,801,803,774,812
20903,11,21,0,20903,4441,16462,4537.68,18.3405,508.053,20903,20,20,20636,20636,20526,20568,18368
45143,15,44,45143,0,45143,0,1.41635e+18,31.9341,887.644,45143,37,38,44527,43426,43988,10018,26743
43376,49,65,43376,0,43376,0,1.4578e+18,35.7195,929.288,43376,33,44,43311,43294,43307,43307,43126
46408,31,40,46408,0,46408,0,85893800000,32.6082,829.958,46408,38,37,46334,46200,46283,46260,38728
9770,17,36,9770,0,9770,0,86247500000,18.2598,353.682,9770,27,25,9723,9671,9695,9663,8530
4313,10,24,4313,0,4313,0,87552400000,15.9942,247.208,4313,19,21,4123,3961,3438,3526,2512
15888,8,21,3493,12395,0,15888,17.3877,16.5867,444.276,15888,19,20,15199,15108,14983,15074,13357
19296,1,2,19296,0,19296,0,3.60304e+13,1.99896,183.261,19296,2,2,16825,16825,16825,16825,16825
8323,21,22,8323,0,0,8323,5.7668e+15,19.1395,344.423,8323,20,20,8300,8274,8299,7927,8300
5840,1,2,5840,0,5840,0,3.24853e+13,1.9976,100.266,5840,2,2,5165,5165,5165,5165,5165
47349,1,2,47349,0,47349,0,3.45743e+13,1.99943,289.907,47349,2,2,41532,41532,41532,41532,41532
40658,41,44,40658,0,40658,0,84063800000,33.0374,844.963,40658,37,38,40614,40600,40520,40514,36180
9019,1,2,0,9019,9019,0,8.50086e+15,1.99789,124.802,9019,2,2,7954,7954,7954,7954,7954
37031,6,20,0,37031,6517,30514,5207.69,14.5822,596.397,37031,20,19,35623,35623,34115,33534,27257
16398,1,2,16398,0,16398,0,5.90483e+13,1.99829,175.432,16398,2,2,12957,12957,12957,12957,12957
24910,3,28,4297,20613,0,24910,20.14,12.7707,521.119,24910,20,21,19314,19314,19111,13425,9167
11876,16,24,11876,0,0,11876,5.75246e+15,19.507,404.971,11876,20,21,11805,11624,11418,9897,10315
2186,1,2,2186,0,2186,0,3.24482e+13,1.99085,61.3731,2186,2,2,1933,1933,1933,1933,1933
35406,14,23,0,35406,5883,29523,4956.01,17.9943,595.449,35406,20,21,35290,35285,35183,35191,34210
29007,8,21,4619,24388,0,29007,20.1535,14.6289,487.13,29007,21,20,28845,28845,28516,28524,28713
11388,1,2,0,11388,11388,0,1.42179e+16,1.99912,147.685,11388,2,2,9140,9140,9140,9140,9140
6489,8,19,987,5502,0,6489,19.9094,9.83819,221.673,6489,18,18,6446,6446,6423,6428,6412
30321,48,60,30321,0,0,30321,310410000,34.3339,1013.27,30321,38,54,30261,30251,30254,29070,26006
5932,1,4,0,5932,5932,0,8.27229e+15,2.00051,107.527,5932,3,3,5248,5248,5248,5248,5248
24892,33,44,24892,0,24892,0,78590400000,30.0193,764.993,24892,37,41,24833,24779,24615,24596,20588
33998,37,48,33998,0,33998,0,1.31665e+18,37.5272,927.16,33998,36,41,33947,33906,33750,29924,30771
20514,5,40,20514,0,20514,0,1.46307e+18,25.3747,652.325,20514,37,37,16003,11872,11518,2515,4921
16860,39,40,16860,0,0,16860,338243000,21.9371,492.342,16860,29,29,16820,16807,16820,16820,16820
42303,12,30,0,42303,8056,34247,4832.19,16.0383,761.496,42303,21,26,42047,42032,41836,41894,38475
27066,5,20,0,27066,4696,22370,5209.67,12.3541,502.37,27066,20,19,25026,25026,22284,21963,17690
26534,16,24,0,26534,0,26534,1336050,21.486,615.283,26534,24,22,26374,25932,25360,25357,20631
21521,31,38,0,21521,21521,0,2.22034e+13,33.7117,626.528,21521,32,30,21469,21405,21452,21452,21469
33013,34,40,33013,0,33013,0,1.46217e+18,34.1829,743.651,33013,32,32,32967,32929,32956,27662,31049
46290,1,2,46290,0,46290,0,3.21425e+13,1.99976,286.796,46290,2,2,41003,41003,41003,41003,41003
30197,34,44,30197,0,30197,0,71219900000,37.2678,884.885,30197,37,39,30139,30028,29813,29856,27165
25045,14,40,0,25045,0,25045,1272620,33.6048,650.297,25045,37,36,24585,24042,24035,24038,11383
35509,10,23,0,35509,6010,29499,4999.08,17.5059,607.982,35509,21,21,35255,35248,35134,35193,34133
18200,13,56,0,18200,18200,0,2.21526e+13,19.9294,566.404,18200,30,32,17833,16824,16590,16828,11360
8243,1,2,8243,0,8243,0,5.38159e+13,1.99879,122.354,8243,2,2,6666,6666,6666,6666,6666
40969,6,21,6558,34411,0,40969,20.0454,15.2206,598.353,40969,21,21,40011,40011,38977,38994,38931
31147,23,40,31147,0,0,31147,4.23264e+15,34.2659,911.258,31147,39,34,30781,29444,29119,15526,21978
8549,17,30,0,8549,2065,6484,4694.78,12.5529,402.536,8549,19,23,8517,8517,8484,8484,6976
19522,23,44,19522,0,0,19522,272867000,34.6851,719.318,19522,34,37,19284,18546,18850,11700,13219
11807,15,19,0,11807,1866,9941,5026.42,13.5076,318.687,11807,19,19,11772,11772,11758,11758,11691
46521,12,60,46521,0,46521,0,1.41075e+18,37.092,942.262,46521,46,40,45250,43287,41971,6905,18805
26059,30,40,0,26059,0,26059,1330880,23.1205,647.648,26059,31,28,26019,26001,26011,26012,26019
45639,16,56,45639,0,0,45639,339962000,22.817,848.119,45639,32,32,45360,44704,43852,43934,32091
11512,4,24,11512,0,11512,0,87663300000,21.0446,406.699,11512,21,21,8222,6221,6014,7179,2872
3005,4,20,3005,0,3005,0,1.44815e+18,13.7424,181.037,3005,16,17,2285,1766,1706,479,682
24516,1,21,4097,20419,0,24516,19.2322,15.7621,489.223,24516,20,19,5122,5122,5122,5122,5122
3631,15,17,0,3631,586,3045,4789.76,10.5428,177.315,3631,17,16,3610,3610,3608,3610,3604
12737,5,40,0,12737,0,12737,1314590,33.4603,433.273,12737,28,29,10353,7831,8030,8063,3874
34471,1,2,34471,0,34471,0,3.26051e+13,1.99983,246.053,34471,2,2,30477,30477,30477,30477,30477
34827,4,64,34827,0,34827,0,1.24587e+18,32.735,1060.36,34827,44,44,22723,18028,18013,3400,5518
5432,18,32,0,5432,0,5432,900662,27.8321,357.788,5432,30,29,5194,4574,4602,4593,3643
29086,10,38,0,29086,0,29086,1308990,36.8301,781.684,29086,35,38,27037,25444,21562,21278,12900
26725,1,4,0,26725,26725,0,8.33414e+15,2.75312,224.549,26725,4,4,23629,23629,23629,23629,23629
40102,41,44,40102,0,40102,0,69211300000,36.84,1020.29,40102,38,39,40057,40035,39782,39839,40056
33504,30,40,33504,0,0,33504,5.70699e+15,21.7622,685.145,33504,30,29,33464,33445,33460,28120,33462
18241,24,44,18241,0,0,18241,5.41711e+15,33.9359,626.168,18241,33,41,18145,18052,18067,7233,10547
5702,29,36,5702,0,5702,0,1.43266e+18,17.5875,272.17,5702,25,25,5666,5652,5666,4727,5666
36685,41,44,36685,0,0,36685,262862000,37.4164,985.359,36685,39,37,36640,36618,36446,35614,36640
36613,4,40,36613,0,0,36613,341465000,22.5931,756.12,36613,31,28,26209,19848,19149,15138,8152
39586,1,2,39586,0,39586,0,3.82828e+13,1.99967,262.759,39586,2,2,34201,34201,34201,34201,34201
30689,1,2,0,30689,30689,0,8.35416e+15,1.99928,231.291,30689,2,2,27130,27130,27130,27130,27130
34787,12,20,5813,28974,0,34787,20.2745,12.077,559.825,34787,20,15,34755,34755,34735,34736,34721
14158,7,44,0,14158,14158,0,2.11329e+13,21.4177,531.609,14158,32,37,12559,11088,10393,10747,5499
37564,310,323,0,37564,1324,36240,1.84553e+13,3.03825,788.489,37564,127,46,37241,37241,37239,37241,37240
24625,8,20,0,24625,4205,20420,5193.19,12.7599,481.417,24625,20,19,24394,24393,23269,23267,23957
21967,3,21,6157,15810,0,21967,16.0572,16.9194,554.594,21967,21,19,15518,15482,15360,15347,7029
39361,39,65,39361,0,0,39361,5.13999e+15,34.3838,1169.26,39361,41,48,39294,39262,38861,16020,16145
21732,1,2,21732,0,21732,0,3.28724e+13,1.99936,194.966,21732,2,2,19193,19193,19193,19193,19193
5795,15,19,1025,4770,0,5795,20.1263,11.4523,249.015,5795,19,18,5772,5772,5772,5772,5772
41158,1,4,0,41158,41158,0,8.26357e+15,3.32657,291.015,41158,4,4,36403,36403,36403,36403,36403
18644,34,40,18644,0,0,18644,335195000,29.5652,510.492,18644,29,29,18600,18557,18592,16980,18595
29053,32,40,0,29053,0,29053,1321800,26.835,635.711,29053,30,29,29005,28980,28998,28997,24657
15660,1,2,15660,0,15660,0,3.24613e+13,1.99815,165.449,15660,2,2,13853,13853,13853,13853,13853
40251,2,23,12837,27414,0,40251,15.3948,19.5617,773.683,40251,22,21,23233,23233,23062,21891,11864
25654,16,44,25654,0,0,25654,4.47999e+15,34.6844,820.495,25654,37,37,23847,17019,21776,7484,12479
10322,27,40,10322,0,0,10322,339315000,18.6817,386.707,10322,20,29,10282,10279,10281,10281,10280
7495,1,2,0,7495,7495,0,8.31619e+15,1.99853,113.576,7495,2,2,6629,6629,6629,6629,6629
28064,1,4,0,28064,28064,0,9.64397e+15,1.99925,227.22,28064,3,3,24305,24305,24305,24305,24305
24092,6,40,0,24092,24092,0,2.1876e+13,29.9387,600.256,24092,34,37,21278,19488,15835,18476,7185
39488,1,5,4,39484,39488,0,1.55308e+16,1.99967,279.654,39488,4,3,30973,30973,30973,30973,30973
27683,3,40,27683,0,0,27683,5.71096e+15,22.801,665.65,27683,32,24,17879,15094,13368,3216,4212
44019,25,44,44019,0,0,44019,256758000,36.5699,1099.18,44019,40,37,43704,42913,42653,30772,31817
40523,22,28,6798,33725,0,40523,20.2703,12.5621,615.713,40523,21,21,40495,40495,40495,40495,40486
27042,16,40,0,27042,27042,0,2.22735e+13,21.888,618.074,27042,30,29,26911,26625,26330,26563,21421
25906,29,38,25906,0,25906,0,1.45203e+18,37.5538,710.085,25906,33,34,25814,25664,25758,20946,14970
27497,16,21,5579,21918,0,27497,17.9158,18.7531,572.243,27497,21,20,27433,27425,27280,27282,26766
13162,43,56,13162,0,13162,0,86357500000,20.4857,501.177,13162,30,32,13106,13098,13106,13106,13104
40575,11,28,0,40575,6668,33907,5129.69,15.6171,638.456,40575,21,27,40457,40457,40408,40431,40154
15770,1,2,0,15770,15770,0,8.48059e+15,1.99899,165.537,15770,2,2,13913,13913,13913,13913,13913
19032,20,24,0,19032,0,19032,1334470,22.2205,518.786,19032,22,22,18997,18952,18936,18935,17484
6138,16,36,6138,0,6138,0,8.0948e+10,27.6197,314.527,6138,28,31,6006,5839,5946,5718,2801
8260,1,19,0,8260,1524,6736,5083.43,15.1275,300.005,8260,19,19,1236,1236,1236,1236,1236
32317,6,44,32317,0,0,32317,319559000,38.1251,789.705,32317,37,37,27989,25470,21906,23628,9655
39834,34,40,0,39834,0,39834,1307580,33.3806,766.574,39834,37,37,39778,39674,39727,39724,36813
34305,32,40,0,34305,0,34305,1312490,30.3926,726.469,34305,38,37,34245,34187,34194,34193,33146
45677,20,21,0,45677,7270,38407,5110.27,17.4817,632.799,45677,21,21,45652,45650,45641,45642,45651
48073,11,21,10694,37379,0,48073,17.5779,17.9827,789.793,48073,21,20,47504,47504,47243,47345,19821
17909,11,13,3123,14786,0,17909,20.3962,11.4818,395.376,17909,13,12,17882,17882,17882,17881,17882
11442,33,40,0,11442,11442,0,2.21467e+13,18.6709,404.483,11442,25,29,11402,11389,11401,11391,11400
4752,1,2,0,4752,4752,0,8.27934e+15,1.99432,91.7297,4752,2,2,4205,4205,4205,4205,4205
28005,12,24,28005,0,28005,0,1.46657e+18,21.2377,618.059,28005,24,22,27397,26029,23908,17303,19925
35832,1,2,35832,0,35832,0,3.25292e+13,1.99958,250.897,35832,2,2,31690,31690,31690,31690,31690
21911,25,56,0,21911,0,21911,1319920,21.8618,608.643,21911,29,32,21855,21827,21836,21825,19487
48852,1,2,48852,0,48852,0,4.92921e+13,1.99967,299.657,48852,2,2,40296,40296,40296,40296,40296
49515,2,48,49515,0,0,49515,4.99214e+15,35.1818,1120.64,49515,38,41,26841,26587,21229,6788,6673
24157,30,40,0,24157,0,24157,1326320,22.5065,587.791,24157,30,29,24117,24099,24114,24111,24115
20525,20,24,20525,0,0,20525,341155000,20.9126,521.352,20525,22,22,20493,20469,20449,20449,20381
21643,1,2,0,21643,21643,0,8.35006e+15,1.99908,194.653,21643,2,2,19134,19134,19134,19134,19134
17194,31,40,0,17194,0,17194,1092290,34.404,647.77,17194,36,37,17129,16960,16923,16927,14752
31745,13,23,5335,26410,0,31745,19.3608,17.8918,570.023,31745,20,21,31616,31616,31487,31512,30891
44520,23,44,0,44520,44520,0,2.15719e+13,32.0929,876.758,44520,37,38,44311,43920,44055,43513,31739
13551,1,2,13551,0,13551,0,3.26528e+13,1.99911,153.723,13551,2,2,11978,11978,11978,11978,11978
23893,9,40,0,23893,23893,0,2.23241e+13,21.5463,620.577,23893,30,28,22247,18408,18069,18388,11509
3450,6,24,3450,0,0,3450,336459000,18.6072,222.267,3450,17,21,3014,2743,2210,2140,1418
20591,1,2,0,20591,20591,0,8.81867e+15,1.99849,188.744,20591,2,2,18070,18070,18070,18070,18070
23508,8,40,23508,0,0,23508,338405000,21.0556,569.661,23508,29,29,21792,18872,18165,18848,10928
46070,1,4,0,46070,46070,0,8.2756e+15,3.85739,307.039,46070,4,4,40742,40742,40742,40742,40742
47143,42,60,0,47143,47143,0,2.09345e+13,29.0312,1061.06,47143,40,44,47083,47073,46880,46872,34931
44501,1,21,0,44501,7228,37273,5172.33,14.5337,615.296,44501,21,20,7796,7796,7796,7796,7796
18461,20,24,0,18461,18461,0,2.23335e+13,20.5193,492.599,18461,22,22,18429,18405,18389,18384,18390
42089,1,2,42089,0,42089,0,3.71564e+13,1.99983,271.063,42089,2,2,36532,36532,36532,36532,36532
14547,1,4,0,14547,14547,0,8.31681e+15,1.99938,165.274,14547,3,3,12865,12865,12865,12865,12865
15730,21,24,0,15730,15730,0,2.23529e+13,20.9277,458.8,15730,21,22,15702,15676,15677,15684,15701
30550,1,2,30550,0,30550,0,4.5469e+13,1.99987,233.634,30550,2,2,25614,25614,25614,25614,25614
25022,29,40,0,25022,25022,0,2.23316e+13,21.1053,632.398,25022,30,28,24982,24964,24975,24968,24139
22289,1,36,22289,0,0,22289,325840000,26.3537,603.822,22289,36,33,2740,2740,2740,2740,2740
49326,24,40,49326,0,0,49326,5.68157e+15,34.697,951.466,49326,36,34,49197,49050,49105,46887,46446
23776,39,40,23776,0,0,23776,300040000,34.4432,716.823,23776,38,37,23734,23701,23668,23411,22867
34496,1,4,0,34496,34496,0,8.68134e+15,1.99957,250.359,34496,3,3,30337,30337,30337,30337,30337
48927,1,23,15764,33163,0,48927,15.342,19.2692,853.619,48927,22,21,12298,12298,12298,12298,12298
34102,38,40,34102,0,34102,0,87075200000,33.6348,771.599,34102,32,31,34061,34034,34060,34057,32637
43345,52,60,43345,0,43345,0,1.42689e+18,25.6895,932.326,43345,44,40,43285,43274,43283,39282,40788
11199,1,2,11199,0,11199,0,4.20742e+13,1.99839,142.685,11199,2,2,9524,9524,9524,9524,9524
42448,34,44,42448,0,42448,0,1.40336e+18,37.4971,867.959,42448,38,37,42384,42245,42221,36052,39429
6360,10,20,0,6360,0,6360,1328980,18.0734,275.638,6360,18,19,6168,5994,5389,5368,4618
40866,25,28,6716,34150,0,40866,20.0448,15.5423,639.932,40866,21,27,40838,40838,40838,40838,40749
35831,14,40,35831,0,35831,0,8.676e+10,26.6343,707.448,35831,31,29,35564,35233,33416,34445,23095
22535,1,2,22535,0,22535,0,3.26129e+13,1.9992,198.68,22535,2,2,19923,19923,19923,19923,19923
1997,1,2,1997,0,1997,0,3.24182e+13,1.99099,58.2231,1997,2,2,1766,1766,1766,1766,1766
11897,1,2,11897,0,11897,0,7.08833e+13,1.99891,151.81,11897,2,2,8900,8900,8900,8900,8900
31735,26,28,5392,26343,0,31735,20.0746,14.0631,610.528,31735,21,28,31707,31707,31707,31707,31702
41978,1,2,41978,0,41978,0,3.27889e+13,1.99986,270.448,41978,2,2,37087,37087,37087,37087,37087
32713,7,40,32713,0,0,32713,5.70222e+15,22.2566,680.649,32713,30,29,29316,25703,22765,5606,12024
4272,10,24,0,4272,4272,0,2.21828e+13,18.7334,248.247,4272,19,21,4092,3942,3398,3625,2721
40580,1,2,0,40580,40580,0,8.63697e+15,1.99963,265.328,40580,2,2,35715,35715,35715,35715,35715
37410,1,2,37410,0,37410,0,3.61531e+13,1.99976,257.32,37410,2,2,32604,32604,32604,32604,32604
28683,9,40,0,28683,28683,0,2.19567e+13,30.7124,662.238,28683,37,37,27192,23540,24240,23610,13181
29485,27,40,29485,0,0,29485,255150000,33.44,880.146,29485,39,34,29334,28714,28864,26671,24373
21217,3,48,21217,0,21217,0,1.18741e+18,30.9446,791.05,21217,36,41,12201,10475,10066,3702,2536
19075,1,2,19075,0,19075,0,3.29654e+13,1.99927,181.949,19075,2,2,16840,16840,16840,16840,16840
32339,1,4,0,32339,32339,0,8.35573e+15,2.00019,243.385,32339,3,3,28586,28586,28586,28586,28586
26506,1,2,26506,0,26506,0,4.62045e+13,1.99928,218.713,26506,2,2,22154,22154,22154,22154,22154
15523,12,24,15523,0,0,15523,5.72444e+15,22.1679,466.185,15523,21,22,15157,14371,13149,8393,10019
45290,1,2,0,45290,45290,0,8.84293e+15,1.99969,280.308,45290,2,2,39731,39731,39731,39731,39731
4992,10,19,818,4174,0,4992,19.1659,10.857,215.3,4992,17,18,4933,4932,4906,4922,4826
3161,22,38,3161,0,3161,0,1.46586e+18,28.9339,270.825,3161,25,36,3061,2923,2970,2359,2775
42080,5,25,9217,32863,0,42080,18.0055,19.796,769.294,42080,22,23,37332,37331,35251,35335,31581
45403,3,4,0,45403,45403,0,1.06032e+16,1.99985,290.071,45403,3,3,45399,45397,45398,45398,45399
34367,37,40,0,34367,0,34367,1307650,34.2591,717.381,34367,37,37,34322,34269,34290,34291,34320
46257,21,64,46257,0,0,46257,5.21304e+15,26.857,1163.16,46257,36,44,45850,44481,45149,30318,32095
47891,14,60,47891,0,0,47891,316327000,35.2555,1196.35,47891,40,55,46017,43129,43247,42877,20352
32254,12,40,32254,0,0,32254,5.65198e+15,26.8733,811.933,32254,38,36,30888,28506,26485,21267,15684
18578,2,30,0,18578,3207,15371,4866.95,15.8972,471.918,18578,20,26,12958,12958,12859,10952,4232
31114,13,40,31114,0,31114,0,1.31964e+18,34.4087,797.124,31114,39,37,29616,27197,28757,6041,16389
21475,3,21,0,21475,3467,18008,5088.48,18.0807,447.346,21475,20,21,17201,17201,17134,15623,12830
31829,19,40,0,31829,0,31829,1333960,22.5541,715.627,31829,31,29,31737,31571,31500,31448,27909
15938,1,24,15938,0,15938,0,1.4651e+18,20.1311,461.153,15938,21,22,1779,1779,1779,1779,1779
34050,26,60,0,34050,0,34050,1271270,24.575,932.155,34050,33,44,33953,33787,33772,33757,29993
1635,17,36,1635,0,0,1635,324134000,14.4789,158.309,1635,21,25,1599,1582,1590,1589,1340
30487,1,20,0,30487,5404,25083,5186.3,17.6667,556.228,30487,20,19,4770,4770,4770,4770,4770
3256,1,2,3256,0,3256,0,4.79787e+13,1.99631,80.1497,3256,2,2,2700,2700,2700,2700,2700
4255,15,19,787,3468,0,4255,19.6418,11.1913,214.098,4255,19,19,4232,4232,4232,4232,4232
7964,3,36,7964,0,0,7964,5.45434e+15,27.5992,348.852,7964,32,33,5545,4777,4409,1267,1548
5182,221,887,5116,66,5116,66,2.7187e+18,163.32,1600.6,5182,392,124,4295,4246,1923,3193,2576
27309,19,40,27309,0,0,27309,337906000,28.1394,618.302,27309,30,29,27236,27132,27167,27166,22890
13233,13,64,13233,0,0,13233,253749000,32.2387,669.966,13233,33,41,11135,7403,9810,9749,3167
33427,1,5,33427,0,33427,0,4.85026e+13,1.99976,253.017,33427,3,4,28172,28172,28172,28172,28172
45602,1,2,45602,0,45602,0,3.31953e+13,1.99974,283.475,45602,2,2,40223,40223,40223,40223,40223
16883,14,36,0,16883,16883,0,2.17467e+13,23.1019,489.13,16883,35,33,16708,16496,16408,16221,11129
4084,16,22,0,4084,4084,0,2.24576e+13,17.1724,241.13,4084,19,19,4046,3968,3955,3958,3640
32642,8,40,0,32642,0,32642,1310330,31.0284,708.056,32642,38,37,30248,26348,25157,26206,12327
23812,7,21,3995,19817,0,23812,19.2533,15.847,484.827,23812,20,19,23251,23251,23020,23081,22406
25708,5,40,25708,0,0,25708,5.70855e+15,31.4113,665.316,25708,31,30,19820,14624,14670,3057,7102
44623,53,56,44623,0,0,44623,339608000,35.6123,871.373,44623,40,32,44567,44539,44567,44564,44567
31808,43,44,31808,0,0,31808,326164000,34.553,766.066,31808,37,37,31764,31751,31726,31661,31380
45273,1,4,0,45273,45273,0,8.50882e+15,3.20619,303.757,45273,4,4,39892,39892,39892,39892,39892
27391,22,40,27391,0,0,27391,5.55551e+15,31.8291,652.9,27391,37,37,27245,27064,27133,6757,19756
47726,1,2,47726,0,47726,0,4.24224e+13,1.99981,290.97,47726,2,2,40532,40532,40532,40532,40532
1397,19,38,1397,0,1397,0,1.47231e+18,19.685,171.797,1397,26,19,1355,1331,1325,267,811
33995,32,40,0,33995,0,33995,1323470,27.4029,693.139,33995,31,29,33947,33912,33941,33939,31140
48663,14,21,7835,40828,0,48663,20.0714,16.9221,654.782,48663,21,21,48591,48590,48567,48568,48488
20527,19,40,0,20527,20527,0,2.23206e+13,21.4707,586.992,20527,29,29,20446,20307,20242,20193,17336
47694,25,40,47694,0,47694,0,1.45621e+18,26.5813,837.99,47694,34,29,47628,47572,47610,16939,39308
30111,40,56,30111,0,30111,0,84780500000,32.5812,855.951,30111,38,51,30055,30045,30026,30014,26578
43228,4,56,43228,0,43228,0,1.4442e+18,32.9755,994.924,43228,50,42,30756,23476,22355,4825,8694
47918,1,25,0,47918,9738,38180,4675.85,20.2357,789.028,47918,22,23,10682,10682,10682,10682,10682
49266,24,28,0,49266,8209,41057,5155.54,18.7638,699.367,49266,28,25,49234,49234,49234,49234,49234
25011,16,38,0,25011,0,25011,1316810,34.849,683.304,25011,33,32,24646,23861,23301,23088,18168
43723,60,64,0,43723,43723,0,1.96202e+13,31.8879,1165.49,43723,36,44,43659,43648,43655,43659,40371
25300,10,56,25300,0,25300,0,1.45711e+18,22.044,655.112,25300,36,32,24216,23271,20392,6970,11389
26289,37,40,26289,0,26289,0,86554800000,27.883,607.329,26289,30,29,26246,26218,26242,26239,26244
39760,14,65,39759,1,0,39760,9.24289e+14,32.7069,1078.05,39760,38,59,38451,36753,34042,34102,24854
41179,8,40,41179,0,41179,0,1.24278e+18,34.486,977.61,41179,39,37,34953,30056,30398,7100,12348
24359,1,2,24359,0,24359,0,3.81786e+13,1.99938,206.093,24359,2,2,21054,21054,21054,21054,21054
5676,20,36,5676,0,0,5676,5.46526e+15,27.5347,277.428,5676,25,25,5614,5567,5593,1221,4801
12752,1,2,12752,0,12752,0,3.24915e+13,1.99851,149.125,12752,2,2,11279,11279,11279,11279,11279
6552,18,22,0,6552,0,6552,1338610,19.8552,309.799,6552,20,20,6522,6502,6433,6431,6422
28470,1,2,28470,0,28470,0,4.38377e+13,1.99912,227.045,28470,2,2,24035,24035,24035,24035,24035
44824,1,2,44824,0,44824,0,5.05065e+13,1.99984,288.231,44824,2,2,36780,36780,36780,36780,36780
25264,29,40,25264,0,0,25264,335837000,28.5819,731.016,25264,38,34,25167,24958,25030,25030,23816
8858,1,2,0,8858,8858,0,8.37066e+15,1.99898,124.558,8858,2,2,7828,7828,7828,7828,7828
27300,1,2,27300,0,27300,0,3.25397e+13,1.99934,219.348,27300,2,2,24143,24143,24143,24143,24143
18707,7,40,0,18707,0,18707,1181100,33.8136,603.833,18707,35,34,16439,14637,14307,14572,4376
41376,61,66,41376,0,0,41376,5.02337e+15,41.9436,1226.06,41376,41,52,41310,41302,41306,39148,37063
12284,1,2,0,12284,12284,0,8.34728e+15,1.99862,146.225,12284,2,2,10860,10860,10860,10860,10860
36443,4,65,36443,0,0,36443,5.95538e+15,26.269,1110.91,36443,34,48,23212,17574,17110,3392,6272
38323,18,30,0,38323,6526,31797,4965.24,18.7046,715.122,38323,21,28,38275,38272,38171,38171,36866
30361,1,4,0,30361,30361,0,8.33999e+15,1.99997,236.315,30361,3,3,26844,26844,26844,26844,26844
40204,27,28,6835,33369,0,40204,19.8705,17.1132,714.073,40204,20,28,40176,40176,40176,40176,40140
11779,10,13,0,11779,1962,9817,5211.63,10.0846,307.708,11779,11,12,11761,11761,11738,11737,11753
30699,6,40,0,30699,0,30699,1292130,31.8918,684.055,30699,37,37,27241,25032,20779,23010,8506
1719,14,18,1719,0,0,1719,5.80503e+15,16.1454,152.539,1719,16,18,1681,1649,1627,1494,1552
2145,5,12,0,2145,362,1783,5194.95,8.94592,134.551,2145,11,10,2004,2004,1795,1795,1284
6074,4,12,1090,4984,0,6074,20.4215,10.988,232.206,6074,12,12,5294,5294,4820,4443,3574
35823,1,2,35823,0,35823,0,4.99572e+13,1.99969,258.282,35823,2,2,29464,29464,29464,29464,29464
16419,10,23,0,16419,3509,12910,4707.01,12.9618,480.493,16419,18,22,16214,16200,16044,16071,14105
32406,27,44,0,32406,0,32406,1220180,33.6095,831.509,32406,37,41,32265,31820,31946,31942,23487
14595,2504,5929,14595,0,8389,6206,3.16938e+18,168.626,7124.59,14595,2217,160,8666,8637,8004,8289,436
32403,3,44,32403,0,32403,0,83651300000,34.6896,773.653,32403,37,37,21843,18705,17137,17034,7197
21920,1,2,0,21920,21920,0,1.24917e+16,1.99891,199.792,21920,2,2,18119,18119,18119,18119,18119
28843,1,2,0,28843,28843,0,8.75644e+15,1.99945,223.699,28843,2,2,25337,25337,25337,25337,25337
18201,38,40,0,18201,0,18201,1323600,18.9245,497.061,18201,27,29,18161,18150,18161,18161,18161
45855,6,65,45855,0,0,45855,5.877e+15,24.9883,1204.24,45855,34,48,35586,30654,25280,5187,13341
1967,2,16,1967,0,1967,0,1.43705e+18,13.911,139.535,1967,15,13,1176,1175,849,283,452
14544,20,21,0,14544,2308,12236,5156.05,10.3134,344.233,14544,18,20,14523,14523,14522,14522,14519
26065,16,40,26065,0,26065,0,1.44096e+18,22.0674,622.529,26065,36,37,25895,25617,25681,11511,18724
49444,22,56,49444,0,49444,0,1.46e+18,34.0731,908.434,49444,40,39,49363,49290,49265,11833,44034
1354,10,14,1354,0,1354,0,88094400000,13.1625,120.977,1354,14,14,1306,1268,1154,1199,1119
27359,1,2,27359,0,27359,0,3.75828e+13,1.99927,219.722,27359,2,2,23705,23705,23705,23705,23705
30053,10,19,0,30053,5399,24654,5181.88,15.6695,553.115,30053,19,19,29925,29925,29822,29821,29811
37154,3,40,37154,0,0,37154,336314000,29.7647,751.854,37154,38,37,24981,21266,19229,13579,6586
48485,2,4,0,48485,48485,0,8.37613e+15,1.99988,295.981,48485,3,3,48480,48479,48480,48480,46514
3180,1,2,3180,0,3180,0,3.22191e+13,1.99277,73.9622,3180,2,2,2815,2815,2815,2815,2815
10969,4,24,10969,0,0,10969,341240000,17.6874,379.055,10969,19,21,8034,6119,5876,5398,2638
3448,4,11,558,2890,0,3448,20.3469,9.57947,157.56,3448,11,10,3129,3129,2849,2091,1941
32993,1,2,32993,0,32993,0,5.83374e+13,1.99933,249.091,32993,2,2,26154,26154,26154,26154,26154
29795,1,24,0,29795,29795,0,2.23792e+13,21.5862,653.214,29795,24,22,3175,3175,3175,3175,3175
17525,31,40,17525,0,0,17525,333170000,24.0189,523.949,17525,34,37,17474,17413,17431,15230,15978
14778,3,56,14778,0,0,14778,336684000,22.8308,495.825,14778,29,28,9906,8428,7536,5302,3441
46160,1,2,0,46160,46160,0,8.42805e+15,1.99989,283.395,46160,2,2,40760,40760,40760,40760,40760
7533,18,20,7533,0,7533,0,87509500000,16.7933,306.039,7533,20,18,7511,7499,7509,7507,7269
45180,8,44,0,45180,0,45180,1206500,38.5553,998.777,45180,40,41,40063,34933,34684,35281,14234
16554,39,40,16554,0,16554,0,87314900000,20.869,525.58,16554,29,27,16514,16502,16514,16514,16514
28667,1,56,28667,0,0,28667,334039000,31.4477,724.533,28667,37,40,3331,3331,3331,3331,3331
17113,1,2,17113,0,17113,0,3.25342e+13,1.99942,173.262,17113,2,2,15134,15134,15134,15134,15134
2201,3,18,0,2201,0,2201,1342880,15.9364,164.033,2201,16,17,1430,1206,1078,575,490
47289,9,30,8063,39226,0,47289,19.661,17.3309,738.002,47289,21,27,46843,46843,46538,46613,45451
15971,17,24,0,15971,0,15971,1332370,20.8639,461.794,15971,21,22,15914,15725,15787,15784,14023
3898,17,30,1088,2810,0,3898,17.2273,12.2894,285.396,3898,19,23,3866,3866,3849,3849,2735
12185,1,2,12185,0,12185,0,3.23864e+13,1.99811,145.834,12185,2,2,10782,10782,10782,10782,10782
22370,35,40,22370,0,0,22370,330669000,31.4931,597.825,22370,37,36,22327,22265,22285,21655,21961
44920,1,2,44920,0,44920,0,3.25839e+13,1.99955,282.225,44920,2,2,39719,39719,39719,39719,39719
45980,37,40,0,45980,0,45980,1327250,26.0766,827.609,45980,33,29,45937,45909,45933,45934,44733
39903,1,2,39903,0,39903,0,3.3972e+13,1.99975,263.098,39903,2,2,35086,35086,35086,35086,35086
4652,16,20,0,4652,4652,0,2.22058e+13,16.4759,230.536,4652,17,19,4626,4606,4592,4589,4413
4958,18,22,4958,0,0,4958,5.75599e+15,19.72,273.086,4958,20,20,4928,4908,4870,4386,4877
971,2,20,0,971,0,971,1326380,12.4521,113.57,971,14,17,542,541,375,199,170
45606,1,2,45606,0,45606,0,3.2569e+13,1.99967,283.426,45606,2,2,40328,40328,40328,40328,40328
11219,14,21,0,11219,1793,9426,5155.23,10.2705,306.274,11219,19,20,11193,11193,11192,11192,11188
46991,19,23,11121,35870,0,46991,17.1984,19.6631,799.313,46991,23,21,46956,46956,46687,46688,45373
24605,39,40,0,24605,24605,0,2.21709e+13,26.5593,583.348,24605,29,29,24565,24538,24563,24563,24565
20014,17,24,20014,0,0,20014,341738000,22.0069,530.687,20014,23,22,19933,19618,19672,19670,17265
12597,2,21,2887,9710,0,12597,17.3098,18.0569,405.992,12597,20,20,8339,8339,8328,7539,6910
15906,1,2,0,15906,15906,0,8.37637e+15,1.99956,167.114,15906,2,2,14056,14056,14056,14056,14056
20388,20,40,20388,0,0,20388,291651000,35.3447,675.171,20388,36,37,19998,19292,19514,8983,12542
45213,1,2,0,45213,45213,0,9.6947e+15,1.99956,280.881,45213,2,2,39129,39129,39129,39129,39129
18710,3,56,0,18710,18710,0,2.21618e+13,19.4061,571.723,18710,30,32,12237,10361,9196,10036,3762
27346,72,75,27232,114,27345,1,9.10568e+14,9.7773,543.302,27346,31,31,27271,27271,27240,27242,27256
22179,17,24,22179,0,0,22179,341874000,22.0867,562.446,22179,23,22,22086,21711,21783,21780,18931
9149,39,40,0,9149,9149,0,1.98962e+13,33.6091,428.969,9149,33,32,9109,9096,9108,9108,9109
3955,23,40,3955,0,3955,0,1.31726e+18,18.5709,299.589,3955,25,33,3905,3820,3843,3669,3279
18147,10,24,18147,0,0,18147,5.73497e+15,20.9766,522.891,18147,23,22,17233,16437,14339,7627,9944
31201,1,2,31201,0,31201,0,4.08306e+13,1.99946,236.771,31201,2,2,26674,26674,26674,26674,26674
48599,49,56,48599,0,0,48599,5.66112e+15,27.5208,907.808,48599,37,40,48543,48530,48536,48543,47813
25590,2,44,0,25590,25590,0,2.08288e+13,33.9684,739.539,25590,36,41,14553,14485,10912,11654,4059
36043,1,2,36043,0,36043,0,3.77039e+13,1.99925,250.782,36043,2,2,31214,31214,31214,31214,31214
4774,6,32,0,4774,4774,0,1.57561e+13,26.106,329.832,4774,28,27,2472,1641,1706,1541,1172
3589,24,32,0,3589,0,3589,905781,26.4636,290.801,3589,29,29,3539,3481,3489,3491,3009
7710,12,22,7710,0,7710,0,1.47338e+18,19.0266,338.444,7710,21,21,7459,6940,6554,6107,5747
31798,1,2,0,31798,31798,0,8.71091e+15,1.9994,234.876,31798,2,2,27953,27953,27953,27953,27953
19164,1,2,19164,0,19164,0,4.0024e+13,1.99958,183.823,19164,2,2,16438,16438,16438,16438,16438
36010,1,2,0,36010,36010,0,1.45556e+16,1.99931,259.962,36010,2,2,28735,28735,28735,28735,28735
16980,20,23,0,16980,3057,13923,4923.76,14.2822,441.052,16980,19,21,16956,16956,16898,16898,16791
41400,9,20,0,41400,7015,34385,5202.39,12.6707,611.059,41400,20,19,41195,41195,40733,40731,40841
42405,4,56,42405,0,0,42405,336359000,29.4915,850.143,42405,39,40,31319,24113,23371,21868,7566
36127,1,2,36127,0,36127,0,4.36311e+13,1.9995,254.308,36127,2,2,30526,30526,30526,30526,30526
21142,3,21,0,21142,3350,17792,5151.68,14.9186,414.241,21142,20,20,16934,16934,16893,15521,12664
7616,3,19,1142,6474,0,7616,19.8761,9.526,236.95,7616,18,18,6231,6231,6218,5954,5136
24205,24,40,24205,0,24205,0,85493400000,32.7976,616.667,24205,37,37,24111,24025,24042,23907,18561
24997,1,2,24997,0,24997,0,3.26325e+13,1.99896,209.306,24997,2,2,22098,22098,22098,22098,22098
19577,11,40,0,19577,0,19577,1135210,31.9457,654.113,19577,36,37,17784,15821,16779,16746,7520
19474,20,21,0,19474,3591,15883,4700.6,17.2882,457.415,19474,20,19,19451,19451,19413,19413,19450
31385,2,5,1,31384,31385,0,1.10732e+16,1.99959,248.556,31385,4,3,31379,31378,31379,31377,28860
18183,36,40,18183,0,18183,0,1.42979e+18,33.6431,536.216,18183,32,37,18141,18116,18103,17330,18140
27231,1,2,27231,0,27231,0,3.36145e+13,1.99956,217.086,27231,2,2,23978,23978,23978,23978,23978
29159,1,2,29159,0,29159,0,3.53497e+13,1.99942,224.811,29159,2,2,25496,25496,25496,25496,25496
22724,1,4,0,22724,22724,0,8.85658e+15,2.00018,203.573,22724,3,3,19928,19928,19928,19928,19928
41325,1,4,0,41325,41325,0,8.28074e+15,2.83458,290.335,41325,4,4,36543,36543,36543,36543,36543
37092,13,21,0,37092,5898,31194,5115.09,17.6131,567.507,37092,21,21,37011,37011,36972,36985,36904
31923,3,4,0,31923,31923,0,8.34273e+15,2.96933,244.393,31923,4,4,31917,31913,31916,31916,31607
16088,14,33,4645,11443,1,16087,17495400000,18.2104,626.028,16088,19,32,15981,15980,15891,15887,9918
16540,1,2,16540,0,16540,0,3.50227e+13,1.99927,170.262,16540,2,2,14481,14481,14481,14481,14481
11181,3,21,0,11181,4010,7171,3728.38,17.7154,397.596,11181,20,17,6912,6877,6816,6861,4042
16409,31,38,0,16409,16409,0,2.18718e+13,36.5566,574.864,16409,35,33,16336,16207,16298,16310,10972
44557,1,2,44557,0,44557,0,3.93814e+13,1.99957,279.329,44557,2,2,38322,38322,38322,38322,38322
30654,25,56,30654,0,0,30654,5.69525e+15,22.1921,708.247,30654,30,32,30598,30570,30579,9713,27198
2847,1,2,0,2847,2847,0,8.3523e+15,1.99122,70.6603,2847,2,2,2516,2516,2516,2516,2516
19619,38,44,19619,0,19619,0,69330700000,33.3075,723.078,19619,35,37,19575,19556,19356,19412,18661
25126,7,13,4229,20897,0,25126,20.3717,12.0322,455.67,25126,13,13,24673,24673,23383,23784,23791
28231,3,5,1,28230,28231,0,8.72165e+15,1.99972,231.267,28231,4,3,28226,28224,28225,28225,28226
6641,1,19,0,6641,1138,5503,4802.36,16.0705,254.03,6641,18,18,1498,1498,1498,1498,1498
38685,8,44,38685,0,0,38685,4.54068e+15,32.6738,999.984,38685,38,37,30335,24681,25642,7269,11160
35085,1,4,0,35085,35085,0,8.33432e+15,2.88226,256.02,35085,4,4,31022,31022,31022,31022,31022
5222,23,32,0,5222,5222,0,1.58362e+13,27.0425,349.753,5222,32,29,5136,4856,5021,4717,4187
14844,16,60,0,14844,0,14844,1160490,26.7709,672.124,14844,36,44,14208,12225,13529,13519,6587
31694,13,21,5082,26612,0,31694,19.9933,16.0185,529.799,31694,20,21,31627,31627,31590,31602,31489
25414,9,38,25414,0,0,25414,337707000,34.7302,686.237,25414,33,32,23153,18546,18074,17854,11076
11663,6,38,11663,0,11663,0,87282500000,19.5571,448.478,11663,30,24,9671,8495,6919,8313,4198
48297,1,48,48293,4,48293,4,1.79892e+12,37.0118,1167.28,48297,40,41,2955,2955,2955,2955,2955
39557,3,40,39557,0,0,39557,335904000,32.3655,764.677,39557,37,37,26736,22781,20637,14918,9006
34650,3,21,7619,27031,0,34650,17.4675,19.0497,659.99,34650,21,20,26622,26605,26446,26028,21901
8151,520,689,8119,32,8151,0,3.8496e+18,170.714,1602.66,8151,125,95,7462,7454,7150,7143,6899
39543,9,20,0,39543,7047,32496,5183.13,17.5618,635.4,39543,20,19,39201,39201,38691,38685,33556
34088,64,65,0,34088,0,34088,5.41134e+14,26.0062,1086.37,34088,34,48,34023,34016,34023,34023,33958
5809,11,36,0,5809,0,5809,1272540,27.1358,279.719,5809,25,25,5674,5511,5526,5534,3375
30359,2,44,30359,0,30359,0,79569300000,34.5835,821.61,30359,37,41,17219,17116,13217,13691,4283
46032,20,21,0,46032,7367,38665,5101.74,17.1091,638.643,46032,21,21,46008,46006,45996,45997,46008
13855,1,22,13855,0,0,13855,5.74164e+15,20.1654,455.363,13855,22,22,1380,1380,1380,1380,1380
32372,8,60,32372,0,32372,0,85158500000,35.3319,943.477,32372,38,56,28157,22623,20635,22970,11016
35314,1,56,35314,0,0,35314,5.62574e+15,30.3602,774.34,35314,38,38,4169,4169,4169,4169,4169
3382,4,11,0,3382,530,2852,5191.15,8.40627,149.886,3382,10,10,3098,3098,2821,2807,2882
39591,10,65,0,39591,39590,1,5.59834e+14,31.6555,1195.5,39591,38,48,31926,24851,25900,24914,12026
48612,53,64,48612,0,48612,0,1.35282e+18,38.5089,1183.22,48612,41,44,48548,48523,48541,47967,46917
2849,5,19,0,2849,525,2324,5093.04,10.7511,180.603,2849,19,17,2574,2574,2280,2065,1708
5737,14,44,5737,0,0,5737,298849000,26.745,380.553,5737,29,37,5406,4902,5185,5183,2948
21999,30,44,21999,0,0,21999,5.41977e+15,28.3086,636.66,21999,36,37,21929,21796,21799,7047,17875
7698,6,12,1334,6364,0,7698,20.4349,10.7563,254.123,7698,12,12,7436,7436,7192,7192,6958
4959,1,2,4959,0,4959,0,4.94951e+13,1.99536,95.3151,4959,2,2,4086,4086,4086,4086,4086
36892,15,28,6200,30692,0,36892,20.0698,16.0713,619.811,36892,20,27,36833,36833,36813,36813,36675
3277,31,321,0,3277,482,2795,2.11551e+14,7.15868,503.57,3277,127,42,2936,2862,2812,2797,2788
27204,19,23,0,27204,7679,19525,4134.32,19.6308,632.441,27204,22,21,27175,27175,26953,26953,25755
27121,33,40,27121,0,27121,0,1.42182e+18,32.0619,650.318,27121,37,37,27066,26982,26998,22479,25330
41356,1,2,41356,0,41356,0,3.70663e+13,1.99983,268.66,41356,2,2,35909,35909,35909,35909,35909
11846,10,40,11846,0,0,11846,334797000,18.7126,441,11846,21,35,11404,11009,10051,10015,6498
31705,31,55,0,31705,31699,6,6.95653e+14,34.1196,976.024,31705,39,45,31623,31482,31421,31281,25464
42577,22,40,0,42577,0,42577,1317380,29.0152,806.798,42577,39,37,42465,42331,42375,42370,32346
26979,9,19,4870,22109,0,26979,20.2344,16.0556,526.295,26979,19,19,26719,26719,26370,26366,26028
47418,1,4,0,47418,47418,0,8.33666e+15,3.63993,297.637,47418,4,4,41925,41925,41925,41925,41925
15293,1,40,15293,0,0,15293,244046000,32.987,632.538,15293,34,33,710,710,710,710,710
6509,7,19,970,5539,0,6509,19.6282,12.9467,221.961,6509,18,18,6427,6427,6403,6414,6386
40469,3,40,40469,0,40469,0,86241100000,29.6044,789.336,40469,39,37,27082,23034,20799,21851,7434
33064,1,2,33064,0,33064,0,4.87797e+13,1.9993,248.074,33064,2,2,27333,27333,27333,27333,27333
16693,19,36,16693,0,0,16693,5.57075e+15,23.2783,487.165,16693,35,33,16593,16476,16537,5277,12786
16830,7,24,16830,0,16830,0,87091600000,21.4021,474.226,16830,22,22,15093,13246,11494,12924,5845
40223,3225,11535,13918,26305,3012,37211,3.18466e+12,272.157,14296.2,40223,3146,249,28688,28388,23061,23608,8712
17171,11,40,0,17171,17171,0,1.90375e+13,31.1365,610.787,17171,37,33,15610,13881,14734,13839,7592
32809,14,21,0,32809,5340,27469,5189.73,11.9281,518.649,32809,21,20,32781,32781,32781,32781,32778
18239,33,38,0,18239,0,18239,1333130,20.6966,549.147,18239,30,26,18201,18185,18198,18198,18201
9727,16,38,0,9727,9727,0,2.22452e+13,21.4054,416.42,9727,30,26,9596,9319,9145,9109,7143
11431,14,40,11431,0,11431,0,1.4176e+18,24.9918,438.835,11431,32,37,11246,11042,11007,4334,7222
40308,20,40,40308,0,0,40308,298617000,35.071,935.463,40308,40,37,39648,38461,38758,21499,22631
41086,10,23,7816,33270,0,41086,18.5626,18.2861,701.416,41086,20,22,40561,40537,40239,40355,12790
28074,10,23,5613,22461,0,28074,18.4314,15.5448,599.649,28074,20,22,27707,27687,27454,27523,24897
5878,31,56,0,5878,5878,0,2.13527e+13,20.666,387.798,5878,29,38,5822,5812,5789,5774,5366
21785,31,40,21785,0,21785,0,1.43054e+18,31.49,576.638,21785,34,37,21729,21643,21687,17688,21685
3713,18,40,3713,0,3713,0,85464400000,18.2211,257.077,3713,20,24,3671,3645,3651,3625,2488
49792,1,30,8527,41265,0,49792,19.7505,16.3361,754.304,49792,21,27,9241,9241,9241,9241,9241
48734,8,56,0,48734,0,48734,1317820,28.5281,914.446,48734,38,40,44664,38187,35825,37622,17311
18584,37,38,0,18584,18584,0,2.18818e+13,30.9197,636.038,18584,38,33,18541,18412,18517,18517,18532
37806,1,4,37806,0,37806,0,4.3443e+13,1.9996,266.839,37806,3,3,32478,32478,32478,32478,32478
4572,1,17,0,4572,1839,2733,3732.27,13.432,233.288,4572,16,15,954,954,954,954,954
8738,1,2,8738,0,8738,0,3.33724e+13,1.99851,123.124,8738,2,2,7701,7701,7701,7701,7701
33759,31,40,33759,0,0,33759,5.6367e+15,30.3891,721.812,33759,38,37,33695,33609,33646,27856,31628
44482,34,48,44482,0,44482,0,75176300000,38.1367,1082.01,44482,38,41,44410,44262,43963,43887,39045
11853,8,36,11853,0,11853,0,84352800000,24.9226,416.7,11853,33,33,11070,9865,9549,9909,5046
21365,37,40,0,21365,0,21365,1155580,33.2784,677.817,21365,38,34,21322,21300,21255,21255,21316
4334,13,36,4334,0,0,4334,5.34945e+15,20.0639,265.657,4334,29,32,4206,4050,4136,1359,2732
19552,8,40,19552,0,19552,0,1.42149e+18,32.8774,566.18,19552,36,35,18089,15876,15425,3299,6185
24847,16,20,0,24847,4257,20590,5202.84,11.8122,481.204,24847,19,19,24824,24824,24824,24824,24811
31718,46,64,31718,0,31718,0,1.27541e+18,27.7419,1008.92,31718,44,44,31654,31646,31648,23691,23371
1951,1,2,0,1951,1951,0,8.38394e+15,1.99231,58.2115,1951,2,2,1723,1723,1723,1723,1723
27279,1,2,27279,0,27279,0,3.43499e+13,1.9996,217.421,27279,2,2,23949,23949,23949,23949,23949
33389,37,40,0,33389,0,33389,1330870,22.4666,698.109,33389,32,29,33349,33335,33349,33349,33349
42045,33,44,42045,0,0,42045,323328000,32.469,860.559,42045,37,37,41980,41854,41845,37029,38756
16221,32,40,16221,0,16221,0,1.44359e+18,29.8352,477.363,16221,29,29,16177,16143,16167,13856,16176
48076,112,378,48057,19,0,48076,1.9158e+16,28.1801,1453.76,48076,129,71,47698,47658,47628,47621,47581
8340,7,19,2902,5438,0,8340,14.6614,15.6077,338.939,8340,19,17,7143,7143,7099,7143,4684
4696,6,36,4696,0,4696,0,84915200000,15.3122,243.883,4696,22,25,4220,3909,3293,3678,2165
9468,5,12,0,9468,1644,7824,5242.54,10.5412,279.614,9468,12,12,8770,8770,7802,7763,6627
16965,3,38,16965,0,0,16965,5.6005e+15,36.2407,582.326,16965,35,32,10460,8787,7280,1973,3302
1530,1,2,0,1530,1530,0,8.38317e+15,1.98366,50.9258,1530,2,2,1351,1351,1351,1351,1351
21544,23,38,21544,0,0,21544,341457000,21.169,595.648,21544,30,28,21506,21486,21493,21489,21506
22274,1,2,0,22274,22274,0,1.72234e+16,1.99982,208.915,22274,2,2,16949,16949,16949,16949,16949
23744,16,23,4994,18750,0,23744,18.2106,16.3696,565.445,23744,20,22,23695,23691,23532,23532,21552
46458,4,56,46458,0,0,46458,5.65289e+15,29.047,895.147,46458,38,40,34099,26198,25459,5756,9192
40757,35,40,40757,0,0,40757,5.6884e+15,36.0167,858.727,40757,34,32,40704,40587,40693,40694,38863
31409,6,25,7061,24348,0,31409,18.0697,18.3814,679.793,31409,20,23,28812,28812,28290,28356,24443
30146,1,2,0,30146,30146,0,8.3421e+15,1.9994,229.681,30146,2,2,26655,26655,26655,26655,26655
33364,31,40,33364,0,0,33364,297494000,34.9835,842.684,33364,38,37,33277,32939,32965,28666,29814
35166,1,2,35166,0,35166,0,3.2601e+13,1.99977,248.045,35166,2,2,31092,31092,31092,31092,31092
44979,1,2,0,44979,44979,0,1.08425e+16,1.9996,283.324,44979,2,2,38210,38210,38210,38210,38210
13685,26,48,0,13685,13685,0,1.93103e+13,24.4479,654.695,13685,29,41,13615,13515,13473,13269,9273
17931,32,40,0,17931,0,17931,1327230,18.8079,499.454,17931,28,29,17891,17878,17889,17886,17889
11974,19,40,0,11974,11974,0,2.21934e+13,21.7738,447.897,11974,26,28,11917,11851,11859,11799,10409
13169,1,2,13169,0,13169,0,3.25741e+13,1.99871,152.224,13169,2,2,11644,11644,11644,11644,11644
14824,16,20,2596,12228,0,14824,20.2965,11.3882,381.127,14824,19,18,14801,14801,14801,14801,14800
48696,2,4,0,48696,48696,0,8.28508e+15,3.73916,310.332,48696,4,4,48661,48650,48661,48661,44757
23675,1,2,23675,0,23675,0,3.25049e+13,1.99966,204.273,23675,2,2,20940,20940,20940,20940,20940
46506,35,48,46506,0,46506,0,1.30479e+18,37.9233,1069.14,46506,40,41,46440,46285,46127,40410,42863
3419,21,22,3419,0,0,3419,5.64234e+15,19.3349,234.78,3419,19,22,3394,3352,3392,3355,3357
33099,38,40,33099,0,0,33099,5.71396e+15,34.38,738.504,33099,32,31,33057,33017,33055,33056,30542
48086,21,38,48086,0,48086,0,1.45419e+18,36.6738,1012.22,48086,38,38,47674,46738,47201,14760,31071
31060,1,2,31060,0,31060,0,5.84699e+13,1.99942,241.984,31060,2,2,24607,24607,24607,24607,24607
36406,25,40,36406,0,0,36406,284517000,33.9631,927.792,36406,38,37,36126,35438,35484,17405,27604
10950,26,38,10950,0,10950,0,1.46474e+18,20.846,436.629,10950,29,29,10912,10894,10901,9043,10912
37224,1,2,37224,0,37224,0,3.26437e+13,1.99987,255.448,37224,2,2,32906,32906,32906,32906,32906
37181,3,4,0,37181,37181,0,8.38388e+15,1.99981,260.174,37181,3,3,37177,37175,37176,37176,37177
48858,296,378,48839,19,0,48858,1.88513e+16,6.57143,1052.77,48858,129,69,48480,48477,48473,48474,48460
16362,10,30,3685,12677,0,16362,18.0144,14.6434,531.77,16362,19,24,16082,16067,15873,15916,13616
23184,38,49,0,23184,23180,4,9.42017e+14,34.9403,816.285,23184,36,41,23135,23107,23064,23100,21841
32109,19,21,0,32109,5301,26808,5198.07,12.0631,519.815,32109,21,20,32086,32086,32086,32086,32083
43211,15,21,0,43211,10408,32803,4372.84,18.0354,762.973,43211,21,20,43092,43092,42804,42809,41081
42700,19,21,6947,35753,0,42700,20.2381,14.0603,599.116,42700,21,20,42675,42675,42673,42675,42661
44787,24,44,44787,0,0,44787,5.30855e+15,36.0934,926.156,44787,39,37,44495,43982,44046,11950,27140
49392,3,23,10168,39224,0,49392,18.1328,19.862,794.718,49392,22,22,38262,38245,38052,36632,12463
40670,1,4,0,40670,40670,0,8.34323e+15,1.99998,271.877,40670,3,3,35958,35958,35958,35958,35958
1838,10,54,1832,6,0,1838,1.99944e+16,20.9543,265.918,1838,31,42,1321,925,971,963,367
48960,16,56,0,48960,0,48960,1330580,22.9459,882.673,48960,32,32,48645,47863,46744,46965,33875
39302,22,56,39302,0,39302,0,86909500000,37.3485,806.653,39302,40,32,39221,39156,39176,39175,34911
14445,9,24,0,14445,14445,0,2.23215e+13,18.4218,430.109,14445,21,21,13673,11635,11768,11619,7379
18899,6,21,3063,15836,0,18899,20.2271,10.3979,396.233,18899,19,20,18445,18445,17941,17944,17860
48302,13,40,48302,0,48302,0,87292200000,30.9775,883.207,48302,32,31,47316,44265,41701,43272,26400
4270,7,36,4270,0,0,4270,5.52403e+15,28.03,242.074,4270,24,25,3922,3540,3298,957,1841
34313,8,28,0,34313,5544,28769,5112.42,16.359,582.411,34313,21,27,34027,34023,33578,33600,20308
10849,31,40,10849,0,0,10849,340561000,21.9004,404.397,10849,21,28,10809,10801,10805,10807,5509
16160,1,36,16160,0,0,16160,331940000,23.6601,481.263,16160,35,33,2025,2025,2025,2025,2025
7819,1,36,7819,0,7819,0,61301800000,28.7275,438.57,7819,30,29,277,277,277,277,277
22029,3,4,0,22029,22029,0,8.4131e+15,1.99927,201.493,22029,3,3,22025,22023,22024,22024,22025
44278,8,40,44278,0,44278,0,1.45335e+18,27.0169,803.257,44278,34,29,40877,35223,33220,5231,17676
15814,13,24,15814,0,15814,0,1.47296e+18,19.7653,469.809,15814,21,21,15538,14592,13935,12045,11920
39615,42,378,0,39615,0,39615,4.47994e+15,35.3548,1398.82,39615,129,71,39221,39151,39093,39141,39097
37020,1,28,0,37020,6559,30461,5129.32,14.6398,671.955,37020,19,28,5916,5916,5916,5916,5916
49418,1,2,49418,0,49418,0,5.19001e+13,1.99919,301.806,49418,2,2,40305,40305,40305,40305,40305
35734,13,23,0,35734,5976,29758,5026.47,16.0281,599.221,35734,20,21,35625,35625,35514,35539,35002
37032,16,40,0,37032,0,37032,1328500,21.9336,719.927,37032,31,29,36862,36467,35995,35989,28414
32209,7,44,32209,0,0,32209,5.50887e+15,25.2215,747.164,32209,36,37,29019,25800,23886,6359,12299
39499,7,23,0,39499,7624,31875,4765.4,19.8116,696.164,39499,21,22,37924,37924,37488,37617,34921
24815,31,40,24815,0,24815,0,7.7136e+10,33.8283,717.742,24815,39,35,24742,24497,24572,24535,21266
21342,1,38,21342,0,0,21342,331280000,36.7337,685.236,21342,36,38,1968,1968,1968,1968,1968
10471,1,12,0,10471,1856,8615,5231.39,11.249,302.248,10471,12,12,1631,1631,1631,1631,1631
13647,45,56,0,13647,13647,0,2.2104e+13,19.7663,505.513,13647,30,32,13591,13581,13591,13591,13589
12214,5,40,0,12214,0,12214,1326190,20.6899,461.448,12214,30,24,9430,6966,7003,5386,3396
47873,23,40,47873,0,47873,0,1.45608e+18,26.5591,838.679,47873,34,29,47801,47713,47768,9883,39494
32413,39,40,32413,0,32413,0,87244600000,22.3199,711.57,32413,32,25,32373,32361,32372,32372,32373
23840,1,2,0,23840,23840,0,9.90792e+15,1.99908,204.312,23840,2,2,20561,20561,20561,20561,20561
40542,1,2,40542,0,40542,0,3.24159e+13,1.99961,267.62,40542,2,2,35872,35872,35872,35872,35872
24841,1,4,24841,0,24841,0,5.56015e+13,1.99952,219.918,24841,3,3,20441,20441,20441,20441,20441
14855,26,36,14855,0,0,14855,5.44328e+15,28.3612,473.256,14855,33,33,14771,14632,14702,8818,12134
46429,21,30,7941,38488,0,46429,19.8144,13.9372,727.399,46429,20,26,46399,46399,46357,46357,45618
33949,31,40,33949,0,33949,0,1.45081e+18,27.5144,688.617,33949,31,29,33895,33833,33883,27492,29274
26838,14,21,4250,22588,0,26838,20.052,15.117,471.648,26838,20,20,26788,26788,26782,26786,25872
39635,23,25,9651,29984,0,39635,17.3838,19.182,770.142,39635,22,23,39610,39610,39384,39384,39606
16883,1,2,0,16883,16883,0,8.35685e+15,1.9987,171.248,16883,2,2,14924,14924,14924,14924,14924
12746,11,22,12746,0,0,12746,342968000,19.9862,431.517,12746,22,22,12236,11533,10673,10747,8484
33555,23,44,0,33555,33555,0,2.0984e+13,36.6302,792.379,33555,38,37,33316,32787,33010,32338,22835
48575,1,2,48575,0,48575,0,3.35858e+13,1.99965,290.653,48575,2,2,42778,42778,42778,42778,42778
40285,18,21,7983,32302,0,40285,18.1954,18.0514,690.811,40285,21,20,40244,40240,40058,40060,40033
4547,1,4,0,4547,4547,0,1.61484e+16,1.99846,99.799,4547,3,3,3525,3525,3525,3525,3525
32870,13,31,7990,24880,6,32864,8563020000,18.1108,740.142,32870,25,24,32741,32735,32642,32654,27023
45361,14,40,0,45361,0,45361,1333130,22.8646,834.123,45361,32,28,44861,44269,39813,41180,27471
22772,10,40,22772,0,22772,0,86887700000,21.3344,563.566,22772,29,29,22028,21339,19110,18970,12862
16187,19,20,0,16187,2793,13394,5183.77,12.2079,398.561,16187,19,19,16167,16167,16167,16167,16154
43516,49,60,43516,0,0,43516,315177000,39.7117,1040.36,43516,40,44,43456,43444,43449,42161,35073
33058,1,2,0,33058,33058,0,9.10692e+15,1.99949,239.183,33058,2,2,28879,28879,28879,28879,28879
33622,30,44,33622,0,0,33622,326818000,34.068,783.385,33622,37,37,33538,33360,33368,28603,26876
10618,13,20,0,10618,10618,0,2.22135e+13,17.308,355.94,10618,20,19,10503,10101,10139,10135,8003
13463,13,20,0,13463,2363,11100,5199.33,10.8223,363.753,13463,19,17,13437,13437,13437,13437,13436
23724,1,2,23724,0,23724,0,3.28648e+13,1.99852,203.082,23724,2,2,20953,20953,20953,20953,20953
35042,1,2,35042,0,35042,0,3.89737e+13,1.99937,250.445,35042,2,2,30189,30189,30189,30189,30189
35514,1,2,0,35514,35514,0,1.47751e+16,1.99952,257.644,35514,2,2,28231,28231,28231,28231,28231
14668,33,40,14668,0,0,14668,247852000,33.2066,616.943,14668,35,34,14622,14584,14456,13736,14217
16588,1,2,16588,0,16588,0,3.26136e+13,1.99879,170.16,16588,2,2,14665,14665,14665,14665,14665
37731,25,28,6352,31379,0,37731,20.2661,12.3224,597.48,37731,21,21,37703,37703,37703,37703,37697
5518,19,24,5518,0,5518,0,87599300000,16.9003,276.215,5518,19,21,5493,5480,5489,5488,5349
2787,10,32,0,2787,2787,0,2.14663e+13,14.3366,181.682,2787,22,21,2723,2668,2552,2630,1984
34536,10,54,34530,6,34530,6,2.49193e+12,33.7471,1052.28,34536,44,45,26725,19458,21929,11836,9821
31511,23,40,0,31511,0,31511,1307130,35.4499,692.019,31511,37,37,31400,31266,31323,31316,26698
35480,10,38,35480,0,35480,0,85790400000,35.3767,879.066,35480,38,38,32912,30940,26480,26703,11229
33661,31,44,33661,0,0,33661,326806000,34.0492,783.654,33661,37,37,33586,33403,33422,28619,27874
5905,1,2,5905,0,5905,0,3.2509e+13,1.99898,102.213,5905,2,2,5222,5222,5222,5222,5222
15990,14,40,15990,0,15990,0,1.45972e+18,21.7715,516.538,15990,29,29,15770,15532,14677,6258,11268
37962,23,44,37962,0,37962,0,80431600000,30.8493,897.168,37962,40,41,37684,36976,37299,36544,24657
34145,3,21,0,34145,5671,28474,5198.9,12.1244,540.131,34145,21,20,26784,26784,26681,22950,16632
24017,6,13,0,24017,4084,19933,5217.47,11.8134,449.431,24017,13,13,23273,23273,22526,22526,21912
15653,11,24,15653,0,15653,0,87252600000,19.2624,453.053,15653,21,21,15230,14607,13292,13475,9050
28456,8,20,5021,23435,0,28456,20.3045,15.5464,529.238,28456,20,19,28126,28124,26823,26820,27386
43605,16,20,7258,36347,0,43605,20.2866,12.1762,620.432,43605,20,19,43581,43581,43581,43581,43581
29754,21,40,29754,0,29754,0,1.4537e+18,27.1139,643.176,29754,30,29,29693,29640,29643,5087,29533
46016,13,56,0,46016,46016,0,2.2244e+13,35.6499,872.957,46016,40,32,45198,42720,40534,42235,26634
23649,43,44,23649,0,23649,0,77150700000,34.3787,748.508,23649,37,41,23605,23595,23539,23540,22910
13962,2,40,13962,0,13962,0,1.24774e+18,35.862,579.321,13962,36,37,7617,7540,6172,1964,1746
40160,1,40,0,40160,40160,0,2.22461e+13,26.331,754.314,40160,32,29,4610,4610,4610,4610,4610
39748,29,40,39748,0,39748,0,85965900000,32.2439,765.537,39748,37,37,39671,39569,39621,39580,37577
30942,11,30,0,30942,6120,24822,4942.25,13.7266,675.808,30942,20,24,30774,30774,30714,30729,28424
40524,35,40,40524,0,40524,0,1.44756e+18,28.8143,782.477,40524,38,37,40473,40406,40430,33688,40429
38182,31,44,0,38182,38182,0,2.15278e+13,30.9501,804.972,38182,37,37,38107,37908,37966,37943,31340
42980,17,44,0,42980,0,42980,1216070,39.0429,961.661,42980,40,39,42014,38570,41176,41104,21875
6110,1,36,6110,0,6110,0,1.43426e+18,17.1514,280.297,6110,25,25,780,780,780,780,780
5944,5,24,5944,0,0,5944,5.70811e+15,16.5311,286.71,5944,19,21,4750,3547,3627,1428,1713
2894,4,17,0,2894,430,2464,5019.51,8.34831,144.284,2894,17,16,2698,2698,2472,2472,2615
30770,13,21,6910,23860,0,30770,17.4054,18.2053,625.725,30770,21,20,30565,30565,30289,30316,27414
12082,6,60,12082,0,12082,0,81354800000,22.7587,564.68,12082,32,40,10137,9051,7887,8562,3472
9190,4,22,9190,0,9190,0,1.46402e+18,19.9131,380.39,9190,22,22,6407,4826,4729,1411,2389
31214,45,60,31214,0,0,31214,328247000,26.1515,813.441,31214,36,40,31154,31144,31150,30730,26088
5780,9,60,5780,0,5780,0,79422700000,32.4375,470.624,5780,35,52,4813,3640,3474,3772,1920
44946,10,21,7174,37772,0,44946,20.032,16.966,625.113,44946,21,21,44804,44803,44731,44756,44599
4612,22,32,0,4612,4612,0,2.08831e+13,19.6886,258.245,4612,30,28,4552,4484,4519,4428,3874
31650,21,32,7857,23793,0,31650,17.444,17.3262,819.141,31650,21,31,31618,31618,31459,31459,25429
47763,36,60,47763,0,47763,0,82365800000,28.8897,1080.02,47763,37,44,47695,47662,47450,47457,37560
15498,2,4,0,15498,15498,0,8.32256e+15,2.00006,170.67,15498,3,3,15493,15492,15493,15493,14505
2646,7,18,2646,0,0,2646,5.77162e+15,16.9562,181.74,2646,16,18,2337,2020,1805,1304,1385
33304,1,2,33304,0,33304,0,3.49731e+13,1.99916,240.133,33304,2,2,29165,29165,29165,29165,29165
17271,2,4,0,17271,17271,0,8.336e+15,1.99867,179.522,17271,3,3,17266,17265,17266,17266,16698
28168,31,56,0,28168,28168,0,2.22432e+13,21.4214,683.409,28168,30,32,28112,28090,28104,28102,25569
6492,8,12,0,6492,1154,5338,5246.34,10.378,235.804,6492,12,12,6424,6424,6224,6223,6364
44443,1,2,44443,0,44443,0,4.25351e+13,1.99946,281.034,44443,2,2,37726,37726,37726,37726,37726
24395,12,20,0,24395,4253,20142,5150.43,13.3229,532.588,24395,19,20,24301,24300,24255,24255,24101
8938,6,40,8938,0,8938,0,1.45112e+18,19.9679,405.013,8938,23,29,7470,6604,5359,2276,3034
32649,1,2,32649,0,32649,0,3.76921e+13,1.99945,241.654,32649,2,2,28276,28276,28276,28276,28276
43241,29,38,43241,0,0,43241,336890000,35.5974,933.605,43241,38,36,43119,42837,42956,42956,40721
23676,34,60,0,23676,23676,0,2.11891e+13,28.4249,729.127,23676,35,40,23610,23542,23474,23462,17206
6835,30,36,0,6835,0,6835,1279770,25.5301,299.418,6835,26,25,6793,6745,6783,6783,6127
1135,14,38,0,1135,1135,0,2.11765e+13,19.5295,152.528,1135,24,19,1075,1043,940,993,833
39263,7,20,0,39263,6526,32737,5191.3,11.9105,589.918,39263,20,17,38576,38576,36785,36993,36870
41065,7,56,0,41065,41065,0,2.22133e+13,36.9133,834.528,41065,40,32,36351,31536,27484,30947,13549
38995,1,2,38995,0,38995,0,3.37813e+13,1.99926,260.031,38995,2,2,34314,34314,34314,34314,34314
9683,30,40,0,9683,0,9683,1320490,17.9525,375.821,9683,22,29,9643,9632,9639,9637,9641
36024,1,2,0,36024,36024,0,8.38912e+15,1.999,250.866,36024,2,2,31829,31829,31829,31829,31829
49572,12,40,49572,0,49572,0,1.46647e+18,22.8958,871.027,49572,32,29,48282,45524,41650,19542,25948
45997,12,40,45997,0,45997,0,87112500000,36.0947,880.921,45997,33,31,44589,41741,38692,38917,23484
31176,8,44,0,31176,31176,0,2.11444e+13,34.2575,749.614,31176,37,37,28686,25430,24951,25309,9058
25949,34,44,0,25949,25949,0,1.74237e+13,34.6486,826.679,25949,37,37,25895,25807,25618,25602,24570
49067,1,4,0,49067,49067,0,8.58811e+15,1.99982,297.822,49067,3,3,43216,43216,43216,43216,43216
40421,343,378,40402,19,0,40421,2.27861e+16,33.5246,1409.73,40421,129,71,40043,40042,40038,40043,40038
33634,1,2,0,33634,33634,0,8.75386e+15,1.9992,241.399,33634,2,2,29547,29547,29547,29547,29547
10525,1,2,10525,0,10525,0,3.2734e+13,1.99791,135.711,10525,2,2,9300,9300,9300,9300,9300
40189,49,56,40189,0,0,40189,340252000,21.9431,801.113,40189,32,32,40133,40122,40133,40132,40131
12590,16,36,0,12590,12590,0,2.16238e+13,25.3863,430.342,12590,34,33,12460,12308,12363,12196,8168
47023,27,64,0,47023,0,47023,1191140,30.9671,1194.36,47023,36,44,46862,46396,46373,46381,33427
22915,12,24,0,22915,22915,0,2.24132e+13,21.1733,563.113,22915,23,22,22389,21205,19521,20617,14471
38842,1,2,0,38842,38842,0,1.12125e+16,1.99946,263.279,38842,2,2,32797,32797,32797,32797,32797
4135,16,38,4135,0,0,4135,5.60282e+15,20.4111,278.661,4135,26,27,4044,3887,3886,3542,3344
27396,36,40,27396,0,27396,0,87488400000,20.9083,662.531,27396,30,28,27356,27342,27355,27355,26636
33379,7,40,33379,0,0,33379,4.91198e+15,36.683,864.614,33379,39,37,28086,24427,24147,5614,7561
32654,49,60,0,32654,0,32654,1283980,26.2526,829.252,32654,36,40,32594,32584,32590,32592,29965
45834,42,44,0,45834,45834,0,2.01434e+13,37.5115,1009.83,45834,40,41,45790,45771,45730,45758,45790
6539,23,49,6539,0,0,6539,8.88228e+15,20.6743,461.899,6539,32,41,6468,6350,5959,4177,3417
16245,20,40,0,16245,0,16245,1301250,33.5568,507.688,16245,29,35,16155,16079,16103,16103,14605
35224,8,40,0,35224,35224,0,2.22744e+13,33.4636,784.911,35224,32,31,31420,25714,23549,26134,14133
29383,1,2,29383,0,29383,0,3.28673e+13,1.99956,226.216,29383,2,2,25951,25951,25951,25951,25951
3431,1,2,3431,0,3431,0,3.19951e+13,1.99388,77.9293,3431,2,2,3040,3040,3040,3040,3040
18110,3,13,0,18110,3024,15086,5213.07,11.7429,383.652,18110,13,13,14159,14159,14105,12056,9105
4627,1,2,4627,0,4627,0,3.25457e+13,1.99762,89.1124,4627,2,2,4091,4091,4091,4091,4091
22771,2,40,22771,0,0,22771,339349000,21.5911,564.791,22771,29,29,12864,12858,8827,4151,3907
20575,1,2,0,20575,20575,0,9.17924e+15,1.99937,189.138,20575,2,2,17953,17953,17953,17953,17953
15152,1,2,15152,0,15152,0,3.25836e+13,1.99855,163.452,15152,2,2,13397,13397,13397,13397,13397
29004,3,32,7420,21584,0,29004,17.2156,18.0746,790.063,29004,21,31,20539,20502,19724,16304,6557
33879,30,56,33879,0,33879,0,1.4449e+18,31.1404,787.739,33879,44,40,33799,33718,33749,18943,29486
26833,35,40,26833,0,26833,0,86452500000,27.6846,611.44,26833,30,29,26788,26748,26783,26778,26752
13238,9,19,0,13238,2054,11184,5139.65,10.051,316.075,13238,19,18,13194,13194,13180,13185,13186
41176,1,4,0,41176,41176,0,8.3842e+15,1.99976,273.567,41176,3,3,36382,36382,36382,36382,36382
18951,8,40,18951,0,18951,0,1.45632e+18,21.2824,519.281,18951,29,29,17493,15049,14204,3983,8329
35631,1,2,35631,0,35631,0,3.50748e+13,1.99933,248.657,35631,2,2,31190,31190,31190,31190,31190
27695,1,2,27695,0,27695,0,3.26448e+13,1.99949,220.479,27695,2,2,24482,24482,24482,24482,24482
27386,1,4,0,27386,27386,0,8.34348e+15,1.99974,224.596,27386,3,3,24212,24212,24212,24212,24212
39022,10,60,0,39022,0,39022,1277430,33.9384,867.351,39022,37,44,37419,35990,33550,33455,14793
16043,34,40,16043,0,0,16043,5.24976e+15,31.1656,535.605,16043,34,34,15999,15947,15897,14401,15603
37186,50,60,37186,0,0,37186,324814000,25.5479,966.501,37186,34,44,37126,37117,37120,36273,34696
43423,1,4,0,43423,43423,0,9.37912e+15,2.49752,295.994,43423,4,4,37740,37740,37740,37740,37740
26412,1,2,26412,0,26412,0,3.406e+13,1.99924,215.048,26412,2,2,23215,23215,23215,23215,23215
16790,41,56,0,16790,0,16790,3.29592e+15,35.4635,693.832,16790,47,35,16734,16715,16726,14508,11469
48856,31,40,0,48856,48856,0,1.66205e+13,35.5341,1153.26,48856,40,37,48757,48386,48176,47932,42358
29381,29,40,29381,0,29381,0,83024800000,33.8963,712.702,29381,37,37,29292,29113,29192,29153,23865
10253,8,19,0,10253,1831,8422,5186.82,11.4126,322.118,10253,19,18,10113,10112,9620,9617,8217
1417,2,18,1417,0,1417,0,88627300000,14.5984,134.947,1417,15,17,753,753,486,612,276
48357,22,44,48357,0,48357,0,81097500000,33.7701,985.803,48357,40,41,47976,47205,47582,46582,32542
21931,1,2,21931,0,21931,0,3.59881e+13,1.99977,195.121,21931,2,2,19126,19126,19126,19126,19126
49238,1,2,0,49238,49238,0,9.2022e+15,1.99978,292.473,49238,2,2,42949,42949,42949,42949,42949
9167,1,2,0,9167,9167,0,1.1445e+16,1.99891,127.496,9167,2,2,7710,7710,7710,7710,7710
37796,42,48,0,37796,37796,0,1.89741e+13,32.0318,1010.83,37796,37,41,37748,37735,37400,37465,32792
13007,2,19,0,13007,2046,10961,5040.33,12.685,332.013,13007,19,18,9135,9135,9125,7415,2584
45634,22,23,14939,30695,0,45634,15.2914,19.2705,827.233,45634,22,21,45610,45610,45514,45514,45610
9475,1,2,9475,0,9475,0,3.27075e+13,1.99831,128.823,9475,2,2,8373,8373,8373,8373,8373
19060,15,38,0,19060,19060,0,2.17092e+13,36.3377,643.743,19060,38,37,18483,17758,17064,17010,10991
45978,28,40,45978,0,0,45978,5.68883e+15,26.7386,816.521,45978,34,29,45918,45861,45903,27915,38117
28437,6,40,0,28437,28437,0,2.23212e+13,30.0807,695.924,28437,31,29,23740,20956,16963,20434,8305
20884,53,56,20884,0,0,20884,5.63602e+15,22.9454,643.435,20884,31,39,20828,20819,20825,20828,20801
15315,2,21,2453,12862,0,15315,19.8096,13.2003,371.297,15315,19,18,10635,10635,10610,8349,4013
28916,1,2,28916,0,28916,0,3.53547e+13,1.99927,223.859,28916,2,2,25283,25283,25283,25283,25283
14282,1,2,14282,0,14282,0,3.19473e+13,1.99965,158.964,14282,2,2,12660,12660,12660,12660,12660
32521,56,64,32521,0,0,32521,317045000,25.1255,989.475,32521,32,44,32457,32450,32453,31962,30180
14481,11,40,14481,0,14481,0,79629400000,31.2796,513.907,14481,33,33,13764,12976,13269,12759,6465
3203,13,20,3203,0,3203,0,1.4668e+18,15.9557,194.309,3203,16,17,3158,3022,3045,2604,2769
29015,1,2,0,29015,29015,0,1.27451e+16,1.99976,229.252,29015,2,2,23882,23882,23882,23882,23882
5096,7,20,5096,0,0,5096,337678000,17.2115,239.919,5096,17,19,4663,4181,3811,3971,2662
37648,1,4,0,37648,37648,0,8.33348e+15,3.24323,264.411,37648,4,4,33289,33289,33289,33289,33289
19335,1,2,0,19335,19335,0,1.31332e+16,1.99938,188.053,19335,2,2,15810,15810,15810,15810,15810
25244,33,60,25244,0,0,25244,5.38754e+15,24.9907,836.685,25244,33,44,25180,25149,25064,23721,21597
44620,54,56,44620,0,0,44620,5.64976e+15,28.9212,871.527,44620,39,40,44564,44552,44562,44564,44542
34939,31,40,34939,0,0,34939,5.63072e+15,28.6198,719.691,34939,37,37,34877,34792,34828,30201,31757
45547,17,44,0,45547,0,45547,1277560,37.2918,892.38,45547,38,37,45033,43838,44714,44669,26851
43229,17,28,7153,36076,0,43229,19.9608,16.3212,710.749,43229,21,28,43177,43177,43117,43119,27432
25515,2,21,0,25515,4074,21441,5156.08,15.1787,460.328,25515,21,20,17467,17467,17398,12659,6967
42889,3,40,42889,0,0,42889,290748000,35.4543,994.053,42889,40,37,27527,23840,22700,19496,6619
2080,16,32,2080,0,0,2080,3.95743e+15,25.2332,223.497,2080,26,29,1854,932,1576,992,1134
14053,1,2,14053,0,14053,0,4.28632e+13,1.99907,157.613,14053,2,2,11912,11912,11912,11912,11912
24023,5,23,4242,19781,0,24023,19.2897,18.0371,525.354,24023,20,22,22315,22315,20605,20618,20164
49142,7,21,8096,41046,0,49142,20.1413,15.3523,672.772,49142,21,20,48295,48295,46513,46966,16962
48590,8,44,48590,0,0,48590,5.53262e+15,36.1109,920.606,48590,38,38,44791,39211,38223,7423,16269
7997,15,24,7997,0,7997,0,1.46299e+18,18.0381,327.74,7997,19,21,7938,7846,7599,6492,7200
5575,8,12,0,5575,1002,4573,5216.8,11.261,223.561,5575,12,12,5501,5501,5283,5281,4495
36100,12,20,6172,29928,0,36100,20.3562,12.2003,571.607,36100,20,19,36068,36067,36058,36058,36054
2795,12,20,0,2795,2795,0,2.19493e+13,14.0111,177.743,2795,16,17,2751,2677,2671,2676,2372
45122,53,65,45121,1,0,45122,8.14452e+14,38.8102,1133.75,45122,39,60,45057,45056,45051,44373,44237
1844,1,10,0,1844,320,1524,5273.27,9.24187,119.127,1844,10,10,291,291,291,291,291
11404,1,2,11404,0,11404,0,3.90965e+13,1.99947,140.75,11404,2,2,9819,9819,9819,9819,9819
4319,20,24,0,4319,0,4319,1331840,16.8789,246.655,4319,19,21,4295,4283,4291,4290,4185
22727,42,65,22726,1,22726,1,3.76401e+12,35.672,961.842,22727,38,59,22662,22658,22637,22658,18313
12737,1,21,2043,10694,0,12737,20.1774,10.1143,325,12737,18,20,2263,2263,2263,2263,2263
38529,16,23,6446,32083,0,38529,19.5193,17.972,628.287,38529,21,21,38465,38461,38378,38378,37784
34701,6,65,34700,1,0,34701,1.05904e+15,31.7028,1132.23,34701,38,48,23234,18532,17046,15122,5174
1033,1,2,0,1033,1033,0,1.2835e+16,1.99419,42.3724,1033,2,2,848,848,848,848,848
1016,9,14,1016,0,0,1016,342216000,12.6319,100.88,1016,13,14,965,830,851,844,780
48094,48,60,48094,0,48094,0,1.40889e+18,32.4555,1194.34,48094,47,46,48034,48026,48029,47354,45517
24592,1,2,0,24592,24592,0,9.83642e+15,1.99976,207.507,24592,2,2,21234,21234,21234,21234,21234
5931,1,2,5931,0,5931,0,3.24615e+13,1.99697,102.432,5931,2,2,5246,5246,5246,5246,5246
29911,31,40,0,29911,0,29911,1248240,30.0357,739.269,29911,37,35,29841,29630,29680,29682,24194
12071,9,13,1943,10128,0,12071,20.2648,10.5189,304.507,12071,12,12,12031,12031,11997,11996,11996
34386,18,56,0,34386,34386,0,2.22622e+13,22.62,749.868,34386,31,32,34268,34128,33942,33833,28849
25465,32,40,25465,0,0,25465,316122000,30.454,675.545,25465,36,35,25409,25336,25308,22210,24042
9111,33,40,9111,0,0,9111,331250000,18.5228,398.885,9111,30,36,9071,9063,9028,8387,9008
10407,7,13,1676,8731,0,10407,20.251,10.3272,284.206,10407,12,12,10259,10259,9929,9973,10040
40691,10,20,0,40691,7026,33665,5191.67,19.0996,630.838,40691,20,20,40569,40569,40454,40454,29857
7447,14,40,7447,0,0,7447,5.10034e+15,30.0255,384.605,7447,32,33,7121,6618,6941,1389,3466
3686,5,21,0,3686,658,3028,4843.3,11.6354,211.953,3686,16,20,3401,3401,3256,3242,2861
44648,37,48,0,44648,44648,0,1.88796e+13,36.7837,1075.56,44648,39,41,44590,44536,44052,44149,32839
9542,21,36,0,9542,0,9542,1193740,28.5172,417.814,9542,33,32,9399,9163,9291,9286,5976
37395,30,40,37395,0,37395,0,86815400000,26.3562,722.486,37395,31,29,37345,37305,37338,37319,36540
41629,2,4,0,41629,41629,0,8.3397e+15,3.1245,277.693,41629,4,4,41621,41619,41621,41621,38109
10369,16,44,10369,0,10369,0,1.39651e+18,20.0575,504.315,10369,25,41,10151,9284,9821,8282,8011
16271,14,24,0,16271,16271,0,2.23746e+13,21.9935,473.869,16271,22,21,16129,15967,14003,15393,10945
32008,31,40,32008,0,32008,0,1.3738e+18,29.6815,769.022,32008,38,35,31936,31710,31779,25542,28422
32798,54,56,0,32798,0,32798,1316570,23.8022,771.357,32798,36,40,32742,32731,32740,32742,32722
2633,1,11,425,2208,0,2633,20.3449,9.10254,137.423,2633,10,10,453,453,453,453,453
42521,13,44,42521,0,42521,0,1.3526e+18,35.1627,933.84,42521,39,41,40862,37976,39577,6995,21337
20850,4,21,3334,17516,0,20850,19.8179,18.6824,439.301,20850,20,21,19040,19040,17415,17206,10883
7432,9,36,7432,0,7432,0,1.39818e+18,28.7527,341.352,7432,31,33,7032,6234,6423,2321,3712
30645,2,40,0,30645,30645,0,2.22843e+13,22.7361,662.503,30645,30,29,17142,17136,11653,13994,4455
16382,39,56,16382,0,16382,0,1.44708e+18,22.7211,530.465,16382,37,31,16326,16312,16317,4453,15373
49521,14,19,0,49521,9501,40020,5018.35,18.8051,808.267,49521,19,19,49218,49218,48938,48942,29149
42976,40,65,42975,1,42975,1,2.03416e+12,39.5506,983.237,42976,39,52,42911,42909,42903,42910,42792
4693,2,20,4693,0,4693,0,1.45835e+18,17.0279,234.855,4693,17,19,2688,2687,1858,609,944
1736,1,9,0,1736,271,1465,5204.94,7.72926,103.824,1736,9,8,306,306,306,306,306
42113,20,28,0,42113,6869,35244,5132.26,15.7362,643.242,42113,21,27,42082,42080,42072,42072,41901
24661,22,49,24661,0,24661,0,1.14649e+18,36.197,853.597,24661,38,41,24337,23508,22670,14677,13701
1546,5,18,0,1546,0,1546,1352260,16.0524,143.606,1546,16,18,1181,866,892,751,518
27874,7,24,27874,0,0,27874,5.73791e+15,21.7254,628.553,27874,24,22,24602,21243,18402,5555,11589
26345,1,2,0,26345,26345,0,8.80993e+15,1.9997,213.654,26345,2,2,23123,23123,23123,23123,23123
34326,1,2,34326,0,34326,0,4.84705e+13,1.99942,252.072,34326,2,2,28414,28414,28414,28414,28414
1178,9,18,1178,0,1178,0,88830700000,15.3548,124.485,1178,15,17,1078,865,948,895,754
10898,1,2,10898,0,10898,0,3.24918e+13,1.99853,138.759,10898,2,2,9639,9639,9639,9639,9639
10878,3,24,0,10878,0,10878,1330700,18.177,375.338,10878,20,21,7210,6107,5476,3688,2571
15828,15,56,0,15828,15828,0,2.17813e+13,24.1325,527.425,15828,36,32,15651,15412,15501,15348,6642
42698,29,40,42698,0,42698,0,74789500000,35.3901,986.12,42698,40,37,42548,42158,42044,41801,36420
34879,2,4,0,34879,34879,0,8.33603e+15,3.34204,254.674,34879,4,4,34871,34869,34871,34871,31062
22588,37,40,22588,0,22588,0,1.43083e+18,30.2169,582.501,22588,33,37,22547,22521,22517,21253,22547
32456,19,44,32456,0,0,32456,5.30074e+15,37.7567,831.782,32456,37,41,32052,31248,31590,6815,22496
23639,5,60,23639,0,23639,0,1.40688e+18,34.7997,839.29,23639,44,42,17848,13388,13285,2878,5137
36634,11,44,0,36634,0,36634,1220500,35.5349,883.363,36634,37,41,34482,31958,32229,32188,16187
11833,8,13,2003,9830,0,11833,20.4283,10.5732,309.113,11833,12,12,11755,11755,11395,11394,11695
26479,15,25,0,26479,6733,19746,4404.45,15.4723,644.165,26479,21,23,26412,26412,26168,26182,20924
1980,1,2,0,1980,1980,0,8.40672e+15,1.9899,59.0093,1980,2,2,1748,1748,1748,1748,1748
14773,12,38,14773,0,14773,0,87301800000,20.3516,499.013,14773,30,22,14279,13297,12359,12548,10038
35053,31,44,0,35053,35053,0,2.15239e+13,33.0123,794.721,35053,36,37,34980,34827,34837,34744,30614
25792,19,40,25792,0,0,25792,302669000,33.2281,739.247,25792,38,37,25320,24344,24793,18871,14496
34723,15,44,34723,0,34723,0,80323800000,37.9908,856.184,34723,39,41,33687,31429,32922,32012,13749
11139,3,24,0,11139,11139,0,2.23764e+13,17.6409,381.735,11139,19,21,7335,6204,5556,6087,2366
44904,25,44,0,44904,0,44904,1196690,36.2423,992.8,44904,41,41,44628,44001,44078,44089,29874
36039,14,44,36039,0,0,36039,320422000,37.3452,821.134,36039,38,37,35140,33800,34327,34332,19089
44644,16,23,0,44644,7449,37195,5029.19,16.9955,669.843,44644,21,21,44580,44576,44493,44493,43899
649,1,14,0,649,649,0,2.22139e+13,11.9076,79.7196,649,11,12,79,79,79,79,79
20615,1,2,0,20615,20615,0,1.55685e+16,1.99971,198.098,20615,2,2,16160,16160,16160,16160,16160
11411,1,2,11411,0,11411,0,3.09324e+13,1.99921,143.975,11411,2,2,10156,10156,10156,10156,10156
39469,1,2,39469,0,39469,0,3.71054e+13,1.99952,262.999,39469,2,2,34265,34265,34265,34265,34265
45300,2,4,0,45300,45300,0,8.30173e+15,3.59075,294.401,45300,4,4,45283,45278,45283,45283,41654
31305,12,56,31305,0,0,31305,339605000,22.3876,721.608,31305,32,32,30490,28836,26672,27677,18782
40928,37,56,40928,0,0,40928,5.70826e+15,22.0857,810.332,40928,31,32,40872,40856,40871,35571,37362
25683,9,24,25683,0,25683,0,1.46885e+18,21.4095,595.307,25683,23,22,24078,20091,20025,8803,12191
46219,28,40,46219,0,46219,0,85006500000,33.6059,846.618,46219,38,37,46105,45928,45987,45898,33080
1008,1,2,0,1008,1008,0,8.43531e+15,1.98512,42.07,1008,2,2,889,889,889,889,889
37927,2774,6610,11187,26740,37478,449,1.74384e+18,171.09,9289.75,37927,1668,222,31317,31311,27503,30018,4452
29108,1,2,0,29108,29108,0,8.98368e+15,1.99955,224.445,29108,2,2,25478,25478,25478,25478,25478
19183,11,38,0,19183,0,19183,1315090,32.2897,638.232,19183,32,37,18102,16849,15390,15345,7892
7002,3,20,7002,0,7002,0,1.46355e+18,17.7889,288.124,7002,19,19,4673,3963,3563,957,1917
37505,29,44,37505,0,37505,0,1.33059e+18,36.7755,903.493,37505,38,41,37390,37148,37073,21898,30243
15054,1,2,15054,0,15054,0,4.98106e+13,1.99867,165.927,15054,2,2,12389,12389,12389,12389,12389
18603,1,2,18603,0,18603,0,3.26821e+13,1.9993,180.62,18603,2,2,16442,16442,16442,16442,16442
12192,45,64,12192,0,0,12192,275756000,26.8346,679.133,12192,32,44,12128,12122,12095,9761,7928
15047,24,44,15047,0,0,15047,300052000,27.0938,621.508,15047,36,41,14917,14720,14690,11004,9353
27166,20,40,27166,0,27166,0,83365900000,28.1478,682.334,27166,37,35,26952,26682,26804,26346,20113
24395,5,24,0,24395,24395,0,2.2355e+13,21.0686,571.056,24395,23,22,19531,14555,14546,17147,6964
8411,6,40,0,8411,0,8411,1272010,27.6779,382.844,8411,32,37,7415,6798,5917,6172,2124
39363,1,28,0,39363,6579,32784,5148.15,13.0391,633.011,39363,20,25,6840,6840,6840,6840,6840
6080,2,11,0,6080,966,5114,5186.69,10.149,208.478,6080,11,11,4154,4154,4146,3022,3022
1655,2,18,0,1655,1655,0,2.25855e+13,13.4381,140.08,1655,15,16,903,903,592,734,308
13484,33,36,13484,0,0,13484,5.67192e+15,18.4155,420.044,13484,28,25,13448,13435,13448,11594,13448
32471,2,4,0,32471,32471,0,8.26407e+15,3.61637,254.236,32471,4,4,32445,32437,32445,32445,29981
23154,1,2,23154,0,23154,0,3.461e+13,1.99922,200.347,23154,2,2,20306,20306,20306,20306,20306
1708,4,16,0,1708,0,1708,1284010,13.0234,126.396,1708,14,14,1350,1073,1092,1185,625
3600,11,40,3600,0,3600,0,86099800000,15.8392,251.809,3600,19,29,3445,3255,3108,2983,2429
26339,24,30,5603,20736,0,26339,18.4223,16.3101,647.206,26339,20,26,26309,26309,26309,26309,24449
14463,1,2,14463,0,14463,0,3.29876e+13,1.99965,159.118,14463,2,2,12767,12767,12767,12767,12767
13581,3,30,0,13581,2611,10970,4907.9,12.6651,448.784,13581,19,24,10386,10385,10210,7637,4863
1398,15,18,1398,0,1398,0,88160500000,13.1409,129.147,1398,15,15,1379,1370,1375,1377,1379
38978,1,2,38978,0,38978,0,3.26262e+13,1.99982,261.388,38978,2,2,34459,34459,34459,34459,34459
37475,1,20,6521,30954,0,37475,20.3296,14.8617,597.78,37475,20,19,5980,5980,5980,5980,5980
33717,16,21,12377,21340,0,33717,14.6466,19.1041,694.725,33717,21,20,33655,33653,33380,33385,33545
9937,1,2,0,9937,9937,0,1.34079e+16,1.9993,134.284,9937,2,2,8087,8087,8087,8087,8087
38275,42,48,38275,0,0,38275,307601000,38.8541,964.15,38275,40,41,38227,38210,38205,37965,38139
20502,1,2,20502,0,20502,0,3.49544e+13,1.99893,188.826,20502,2,2,17955,17955,17955,17955,17955
30645,28,38,30645,0,0,30645,339701000,30.1822,735.323,30645,32,31,30587,30521,30560,30560,30587
29520,28,40,0,29520,0,29520,1291170,32.5621,673.901,29520,37,37,29428,29291,29341,29336,25526
14709,10,24,14709,0,14709,0,1.47221e+18,19.8459,453.057,14709,21,21,14083,13525,11864,6696,8929
3464,5,24,0,3464,3464,0,2.21477e+13,15.5722,225.254,3464,19,21,2771,2082,2119,2417,1130
16347,35,36,0,16347,0,16347,1291060,26.5298,482.239,16347,35,33,16309,16255,16301,16301,16203
44191,52,56,44191,0,0,44191,5.66168e+15,29.0224,879.937,44191,36,40,44135,44122,44131,44135,44091
27860,51,56,0,27860,27860,0,2.22109e+13,22.9796,672.636,27860,31,31,27804,27792,27804,27804,27804
35747,25,44,0,35747,0,35747,1239810,36.2948,825.917,35747,38,37,35543,35114,35204,35215,23167
11494,31,36,0,11494,11494,0,2.21804e+13,18.6335,390.383,11494,28,25,11458,11444,11458,11449,11458
46600,33,40,46600,0,46600,0,74809500000,34.5137,1041.3,46600,40,37,46525,46363,46166,46187,42848
27957,12,20,4896,23061,0,27957,20.368,11.5675,511.124,27957,19,19,27929,27928,27929,27929,27921
22209,1,2,22209,0,22209,0,3.26353e+13,1.99973,197.808,22209,2,2,19633,19633,19633,19633,19633
44733,3,20,0,44733,7766,36967,5189.86,18.483,662.495,44733,20,20,34380,34380,33893,19503,20088
41561,1,2,41561,0,41561,0,3.72153e+13,1.99976,269.374,41561,2,2,36065,36065,36065,36065,36065
12688,10,12,0,12688,2230,10458,5229.03,11.0128,330.774,12688,12,12,12662,12662,12633,12632,12662
8969,18,44,8969,0,0,8969,317071000,21.4956,492.322,8969,28,41,8838,8585,8594,8431,6984
40325,1,2,40325,0,40325,0,5.57575e+13,1.99973,274.325,40325,2,2,32336,32336,32336,32336,32336
12581,12,19,0,12581,3100,9481,4241.53,16.2728,398.618,12581,19,18,12425,12412,12319,12337,11054
22534,1,2,22534,0,22534,0,4.43435e+13,1.99929,201.399,22534,2,2,18983,18983,18983,18983,18983
18765,1,23,5258,13507,0,18765,16.3008,18.1483,526.374,18765,21,21,4578,4578,4578,4578,4578
37295,19,23,0,37295,7102,30193,4788.68,16.3907,672.928,37295,21,22,37266,37266,37098,37098,35958
34230,1,2,34230,0,34230,0,3.38954e+13,1.99936,243.88,34230,2,2,30107,30107,30107,30107,30107
33141,4,40,33141,0,33141,0,1.42558e+18,31.2399,710.019,33141,37,37,25043,19552,19133,4281,6527
48848,20,44,48848,0,48848,0,1.24936e+18,37.856,1086.63,48848,40,39,47975,46082,46389,12425,30161
13309,6,13,0,13309,2140,11169,5190.71,10.6059,317.97,13309,12,12,13011,13011,12361,12373,4199
36250,1,2,36250,0,36250,0,3.35906e+13,1.99972,251.989,36250,2,2,31923,31923,31923,31923,31923
19199,4,13,0,19199,3123,16076,5198.03,11.4489,387.085,19199,13,13,17376,17376,15815,15456,15016
43186,2,40,0,43186,0,43186,1333730,22.3282,815.862,43186,32,29,23465,23464,15481,6821,6633
35703,1,28,5790,29913,0,35703,19.9817,16.146,596.456,35703,21,27,6470,6470,6470,6470,6470
38786,6,40,38786,0,38786,0,87322100000,28.4972,797.408,38786,33,29,32640,28965,23084,28163,12823
47539,20,28,0,47539,8001,39538,5105.4,17.0118,759.686,47539,21,28,47508,47506,47498,47498,47327
49135,20,60,49098,37,0,49135,5.23553e+15,37.52,1175.28,49135,52,37,47666,41570,42158,38064,27206
16898,1,2,16898,0,16898,0,5.90668e+13,1.99899,179.297,16898,2,2,13351,13351,13351,13351,13351
18589,33,56,0,18589,18589,0,2.15457e+13,31.1055,702.837,18589,38,49,18506,18337,18365,18356,17568
36136,19,23,6939,29197,0,36136,18.6627,16.7331,666.736,36136,21,22,36107,36107,35939,35939,34799
2348,1,2,2348,0,2348,0,3.66829e+13,1.99489,65.2514,2348,2,2,2041,2041,2041,2041,2041
11461,32,38,0,11461,0,11461,1317810,30.4809,462.658,11461,31,30,11417,11375,11408,11407,11417
18802,38,40,18802,0,18802,0,85917600000,30.7359,514.4,18802,30,29,18762,18737,18758,18754,18762
36805,15,40,36805,0,0,36805,340637000,22.4946,741.996,36805,32,29,36516,35982,35193,35170,26569
20261,18,19,0,20261,3695,16566,5142.89,15.3784,463.842,20261,19,19,20237,20237,20237,20237,20237
7426,18,24,0,7426,7426,0,2.23977e+13,20.091,324.984,7426,20,21,7396,7374,7314,7306,7010
39956,7,44,39956,0,39956,0,1.34599e+18,35.3126,917.417,39956,38,41,35012,30855,29365,6588,12843
12435,1,2,12435,0,12435,0,3.31839e+13,1.99815,146.715,12435,2,2,10968,10968,10968,10968,10968
15238,1,2,15238,0,15238,0,4.2079e+13,1.99842,163.842,15238,2,2,12959,12959,12959,12959,12959
26467,8,13,0,26467,4339,22128,5203.34,11.45,456.799,26467,13,13,26325,26325,25533,25532,26217
49548,4,40,49548,0,49548,0,8.7166e+10,35.3562,911.893,49548,33,31,35206,26637,25687,30832,11965
23227,18,32,0,23227,5734,17493,4605.73,16.5767,711.249,23227,19,31,23185,23185,23080,23080,18571
39369,2,44,0,39369,39369,0,1.69518e+13,37.3446,1033.79,39369,39,37,18448,18051,16098,14840,3498
5682,5,11,933,4749,0,5682,20.4337,9.26382,201.16,5682,11,10,5346,5346,4754,4757,4889
49174,1,2,49174,0,49174,0,3.25184e+13,1.9999,293.997,49174,2,2,43492,43492,43492,43492,43492
5766,10,19,888,4878,0,5766,19.9202,9.88085,211.246,5766,18,18,5737,5737,5722,5727,5697
27447,22,40,27447,0,27447,0,1.43879e+18,31.2687,651.616,27447,37,37,27341,27233,27273,8406,21008
42692,3,23,0,42692,7098,35594,5014.39,17.2806,655.686,42692,21,21,34203,34202,34077,31768,26468
8925,6,12,0,8925,1576,7349,5238.52,11.1355,276.959,8925,12,12,8589,8589,8288,8287,6587
49054,26,56,49054,0,49054,0,86545500000,36.1733,970.863,49054,40,40,48924,48760,48784,48747,34507
18166,8,60,18166,0,0,18166,319061000,30.6705,660.636,18166,33,40,16384,14266,13743,13882,6774
12824,1,2,0,12824,12824,0,8.46216e+15,1.99945,148.956,12824,2,2,11317,11317,11317,11317,11317
15562,6,21,0,15562,2517,13045,5073.74,13.1047,381.17,15562,18,20,15146,15146,14784,14798,14691
28862,41,44,0,28862,28862,0,2.12398e+13,36.3863,732.693,28862,37,37,28818,28804,28728,28724,25782
5161,13,20,5161,0,5161,0,86681600000,16.4881,241.701,5161,17,19,5108,4946,4959,4958,4750
11338,12,40,11338,0,11338,0,1.45496e+18,22.9217,443.63,11338,28,29,10996,10362,9488,3504,6138
48673,1,2,48673,0,48673,0,3.63865e+13,1.99938,291.279,48673,2,2,42380,42380,42380,42380,42380
3387,2,18,3387,0,0,3387,5.75748e+15,14.9224,198.015,3387,16,17,1875,1875,1249,435,642
17069,9,23,3674,13395,0,17069,18.2703,13.511,489.668,17069,19,22,16745,16745,16574,16629,14395
34357,27,64,0,34357,0,34357,1102010,37.3855,1145.02,34357,37,53,34118,33410,33362,33416,16945
23125,23,36,23125,0,0,23125,325994000,26.0514,622.726,23125,36,33,22995,22708,22895,7963,14444
1916,1,2,0,1916,1916,0,8.49949e+15,1.99113,57.9905,1916,2,2,1689,1689,1689,1689,1689
1768,10,20,0,1768,0,1768,1330290,12.6352,143.547,1768,14,17,1710,1664,1535,1533,1468
35985,1,2,35985,0,35985,0,3.76943e+13,1.99969,250.707,35985,2,2,31165,31165,31165,31165,31165
46192,1,2,0,46192,46192,0,1.28088e+16,1.99961,291.604,46192,2,2,37980,37980,37980,37980,37980
48044,11,20,8371,39673,0,48044,20.3079,14.2527,678.227,48044,20,19,47959,47958,47958,47959,47825
47719,15,56,0,47719,0,47719,1320280,34.5259,903.521,47719,40,39,47281,46528,45751,45729,32398
33636,3,4,0,33636,33636,0,8.38487e+15,1.99949,247.656,33636,3,3,33632,33630,33631,33631,33632
27024,22,40,0,27024,0,27024,1327860,21.9017,618.022,27024,30,29,26978,26934,26947,26945,23954
36226,18,20,6431,29795,0,36226,20.0977,14.2711,646.14,36226,19,20,36197,36197,36177,36177,36164
24309,11,21,0,24309,3943,20366,5184.75,11.6247,446.584,24309,20,20,24274,24274,24257,24263,24271
43351,6,21,7226,36125,0,43351,20.2664,12.1378,622.049,43351,21,20,42109,42109,40700,40703,39615
19243,1,2,0,19243,19243,0,1.12226e+16,1.99979,184.275,19243,2,2,16245,16245,16245,16245,16245
49179,1,2,0,49179,49179,0,1.32807e+16,1.99963,301.286,49179,2,2,40114,40114,40114,40114,40114
37405,21,56,37405,0,0,37405,3.39e+08,38.2714,794.033,37405,40,31,37312,37159,37147,37153,27925
13746,2,44,13746,0,13746,0,1.15435e+18,33.2202,623.704,13746,33,37,6462,6337,5436,2100,1129
22540,34,40,22540,0,0,22540,5.7303e+15,20.6747,604.066,22540,30,26,22500,22486,22498,22500,22006
9513,1,2,0,9513,9513,0,1.43161e+16,1.99748,133.116,9513,2,2,7622,7622,7622,7622,7622
23221,11,23,3978,19243,0,23221,19.3847,17.9297,496.572,23221,20,21,23080,23080,23010,23041,22447
976,1,2,976,0,976,0,6.05633e+13,1.98053,42.217,976,2,2,765,765,765,765,765
44925,16,44,44925,0,44925,0,83796500000,37.1521,886.704,44925,37,37,44347,43243,43879,43115,26066
15278,1,2,15278,0,15278,0,3.26834e+13,1.99902,163.544,15278,2,2,13503,13503,13503,13503,13503
16825,37,52,16809,16,16809,16,1.49867e+13,32.0991,664.436,16825,45,33,16773,16746,16760,16115,14311
34306,2,21,0,34306,5573,28733,5189.37,11.8218,529.303,34306,21,20,23214,23214,23104,16008,16005
21442,35,65,21442,0,0,21442,6.31291e+15,26.4203,896.042,21442,33,48,21376,21352,21295,13481,13943
42378,16,40,42378,0,42378,0,86896600000,25.9002,775.633,42378,32,29,42176,41724,41225,41529,31454
44891,11,44,44891,0,0,44891,5.49151e+15,36.2997,886.495,44891,38,37,43390,41480,40456,7221,20314
47432,17,20,8526,38906,0,47432,20.1093,19.0812,735.703,47432,20,20,47380,47380,47344,47344,47339
21255,20,40,21255,0,0,21255,340400000,21.9478,586.904,21255,29,28,21194,21097,21131,21115,17923
32122,23,38,32122,0,32122,0,83600100000,37.0102,871.84,32122,38,38,31611,30764,30907,30738,22537
14128,1,4,0,14128,14128,0,1.06852e+16,2.00035,163.912,14128,3,3,12030,12030,12030,12030,12030
10290,1,2,0,10290,10290,0,8.31919e+15,1.99864,133.648,10290,2,2,9101,9101,9101,9101,9101
22603,30,40,22603,0,22603,0,1.45596e+18,22.9319,568.76,22603,30,28,22563,22545,22560,17851,22561
28021,1,2,28021,0,28021,0,3.27873e+13,1.99911,221.457,28021,2,2,24756,24756,24756,24756,24756
12367,18,20,0,12367,2174,10193,5181.85,11.8698,352.434,12367,19,18,12346,12346,12346,12346,12345
16910,7,24,16910,0,16910,0,87382700000,21.222,475.211,16910,21,22,15100,13193,11232,12874,6405
39554,18,40,39554,0,0,39554,336720000,29.84,780.783,39554,39,37,39395,39210,39191,38300,28663
2336,1,2,2336,0,2336,0,4.16911e+13,1.99187,63.456,2336,2,2,1989,1989,1989,1989,1989
49340,14,21,0,49340,10906,38434,4519.51,17.7451,799.471,49340,21,20,49135,49115,48827,48843,39564
7206,5,22,7206,0,0,7206,5.75746e+15,16.4525,309.866,7206,19,19,5692,4207,4193,2153,2756
49176,16,23,0,49176,12484,36692,4270.25,19.692,824.302,49176,23,21,49072,49060,48677,48682,46955
17743,12,19,2816,14927,0,17743,19.8708,12.5526,388.747,17743,19,19,17685,17684,17659,17669,17576
4936,32,40,4936,0,4936,0,62141300000,29.8063,361.557,4936,28,32,4896,4888,4840,4743,3294
8017,1,2,0,8017,8017,0,1.76436e+16,1.99875,123.961,8017,2,2,6053,6053,6053,6053,6053
33224,4,44,0,33224,0,33224,1283660,25.0525,757.097,33224,36,37,24881,19462,19083,19426,7321
34351,3,56,34351,0,34351,0,1.44629e+18,24.7023,787.985,34351,41,40,22617,19197,17179,4036,5256
41646,1,4,0,41646,41646,0,1.17829e+16,2.82803,297.998,41646,4,4,34803,34803,34803,34803,34803
3563,18,20,3563,0,3563,0,1.45507e+18,13.9164,199.13,3563,16,17,3543,3535,3527,3298,3438
5504,2,12,937,4567,0,5504,20.444,9.18187,210.322,5504,11,11,3630,3630,3600,2226,1328
20568,11,40,20568,0,0,20568,270135000,32.6884,735.838,20568,36,37,17261,13447,15484,15383,8016
3188,10,18,3188,0,0,3188,5.78348e+15,17.0332,200.748,3188,17,18,3048,2928,2657,2492,2093
15508,3,4,0,15508,15508,0,8.32184e+15,1.99974,169.749,15508,3,3,15504,15502,15503,15503,15504
11616,17,27,4415,7201,4,11612,24230900000,17.2469,428.856,11616,22,22,11585,11585,11555,11496,4851
2981,17,32,0,2981,2981,0,2.02124e+13,21.1983,212.468,2981,27,28,2898,2779,2864,2736,2306
14170,20,21,2305,11865,0,14170,20.2298,10.1917,343.913,14170,19,20,14149,14149,14148,14148,14145
28469,35,40,0,28469,0,28469,1329990,30.4173,698.219,28469,31,30,28425,28385,28421,28420,27373
14243,15,24,14243,0,0,14243,5.74159e+15,21.604,460.195,14243,23,22,14086,13824,13285,11175,7486
25335,5,40,25335,0,25335,0,1.39867e+18,26.7866,661.298,25335,36,35,20650,15870,16620,3645,4447
25675,17,44,0,25675,0,25675,1228790,35.6164,759.799,25675,36,41,25152,22980,24610,24582,16980
38217,19,48,38217,0,38217,0,1.27775e+18,34.1533,993.157,38217,37,41,37510,35608,36280,9938,20590
40095,7,44,40095,0,0,40095,5.5044e+15,33.3724,840.508,40095,37,38,36082,32047,29705,6036,10704
13856,1,2,13856,0,13856,0,3.24826e+13,1.99877,155.9,13856,2,2,12256,12256,12256,12256,12256
19552,16,21,0,19552,3127,16425,5091.93,12.4817,418.555,19552,19,20,19520,19519,19501,19501,19417
15924,18,40,0,15924,15924,0,2.23219e+13,21.5956,517.683,15924,24,29,15846,15766,15566,15534,13331
33539,8,40,0,33539,0,33539,1327380,34.0559,767.221,33539,32,31,29927,24503,22456,22450,12374
24443,43,291,24295,148,24295,148,1.65262e+16,43.0331,1080.89,24443,79,56,24142,24038,23988,23709,4009
39893,1,2,39893,0,39893,0,3.23859e+13,1.9994,265.637,39893,2,2,35302,35302,35302,35302,35302
4023,22,36,4023,0,0,4023,330340000,28.9789,247.385,4023,24,27,3977,3956,3963,3960,3942
8486,1,21,1799,6687,0,8486,17.7884,18.1887,322.141,8486,19,19,2014,2014,2014,2014,2014
7554,6,24,7554,0,0,7554,341408000,20.5944,328.152,7554,20,21,6442,5772,4536,4269,2596
20477,13,24,0,20477,0,20477,1330330,20.6298,517.399,20477,22,22,20212,19288,18464,18816,14218
14856,12,44,14856,0,14856,0,1.38941e+18,21.8891,543.763,14856,32,37,14301,13481,13069,7746,9475
35588,4,40,35588,0,0,35588,330340000,30.741,743.232,35588,37,37,26949,21108,20719,21336,5135
19470,21,23,0,19470,4221,15249,4645.6,16.7129,521.279,19470,20,22,19447,19447,19357,19357,18942
28801,18,20,0,28801,4908,23893,5205.01,11.8528,513.621,28801,20,17,28779,28779,28779,28779,28779
16678,1,2,0,16678,16678,0,8.97804e+15,1.99922,169.989,16678,2,2,14599,14599,14599,14599,14599
40271,32,40,40271,0,40271,0,85172800000,35.5031,787.727,40271,38,37,40199,40082,40118,40089,34558
5525,21,22,0,5525,0,5525,1335630,19.1562,289.5,5525,20,20,5502,5476,5501,5500,5502
36864,15,28,6180,30684,0,36864,20.2549,12.3279,590.676,36864,21,21,36826,36826,36826,36826,36766
17768,18,40,0,17768,17768,0,2.18986e+13,26.3375,628.35,17768,36,33,17525,17252,17149,17192,12181
28125,39,40,28125,0,28125,0,86914600000,20.9002,619.747,28125,29,29,28085,28071,28085,28084,28085
36380,19,40,36380,0,0,36380,287742000,35.9809,920.526,36380,38,37,35530,33505,34318,24136,21280
10311,11,22,0,10311,0,10311,1340140,19.7961,386.065,10311,20,21,9918,9369,8651,8691,6628
9645,26,36,0,9645,9645,0,1.79515e+13,32.2735,468.354,9645,34,33,9552,9301,9379,9099,7981
17110,2,4,0,17110,17110,0,1.48748e+16,2.49305,199.215,17110,4,4,17069,17056,17065,17066,13717
31932,33,65,31931,1,31931,1,2.69961e+12,26.9847,1067.44,31932,34,48,31861,31830,31697,31266,22109
32837,38,44,32837,0,32837,0,1.19146e+18,39.1444,925.412,32837,37,39,32789,32737,32413,29787,26980
12537,3,19,0,12537,2320,10217,5074.75,16.1968,373.636,12537,19,19,9339,9339,8870,5058,4599
49153,1,2,49153,0,49153,0,3.23204e+13,1.99955,294.785,49153,2,2,43508,43508,43508,43508,43508
40686,1,4,0,40686,40686,0,8.34172e+15,2.76046,274.901,40686,4,4,35971,35971,35971,35971,35971
39221,14,40,39221,0,39221,0,87333500000,28.5897,803.531,39221,32,30,38663,38031,34483,35928,25388
21418,1,2,0,21418,21418,0,1.01469e+16,1.99944,193.502,21418,2,2,18401,18401,18401,18401,18401
10150,22,40,10150,0,10150,0,1.27017e+18,33.1793,481.215,10150,33,37,10002,9721,9870,4153,7798
47594,8,40,47594,0,0,47594,5.66011e+15,36.2747,994.537,47594,39,38,42115,34337,31493,11565,14775
21324,19,44,0,21324,0,21324,1262840,28.9072,634.817,21324,34,37,21092,20742,20958,20928,15279
16905,6,38,0,16905,0,16905,1331050,21.3656,535.941,16905,30,29,13970,12244,10042,8007,5622
14505,1,38,14505,0,0,14505,5.56833e+15,32.5493,549.53,14505,37,32,1336,1336,1336,1336,1336
5194,5,56,0,5194,5194,0,2.15821e+13,19.5106,328.318,5194,24,30,4205,3208,3302,3626,1202
13196,37,60,0,13196,13196,0,1.96252e+13,26.6106,659.028,13196,33,44,13136,13126,13012,13014,8981
17426,25,28,0,17426,2965,14461,5158.67,11.0634,426.211,17426,19,21,17398,17398,17398,17398,17392
47879,26,56,47879,0,0,47879,5.65186e+15,30.4012,998.078,47879,38,44,47714,47485,47544,42424,45470
27667,20,44,27667,0,27667,0,1.32695e+18,29.2824,792.912,27667,37,41,27315,26699,26861,14668,18117
34808,40,64,34808,0,0,34808,315688000,36.2778,1122.99,34808,38,56,34744,34738,34632,33014,29471
29353,6,28,4838,24515,0,29353,20.2475,12.5422,519.569,29353,21,20,28567,28567,27659,27711,10400
26137,1,4,0,26137,26137,0,8.23767e+15,3.31947,235.506,26137,4,4,23116,23116,23116,23116,23116
37845,50,64,0,37845,0,37845,1318280,38.3258,909.046,37845,40,44,37781,37762,37774,37776,37566
42919,1,4,0,42919,42919,0,8.35095e+15,1.99972,279.228,42919,3,3,37942,37942,37942,37942,37942
911,9,18,911,0,0,911,346299000,14.9177,110.589,911,15,17,824,656,725,715,559
13424,1,2,0,13424,13424,0,9.10382e+15,1.99881,152.382,13424,2,2,11727,11727,11727,11727,11727
46762,14,49,46762,0,0,46762,4.85772e+15,37.4852,1149.08,46762,40,41,40407,25882,36227,16170,19055
38075,1,2,38075,0,38075,0,3.74364e+13,1.99947,257.851,38075,2,2,33010,33010,33010,33010,33010
1594,18,32,1594,0,0,1594,297190000,23.404,155.071,1594,22,21,1536,1480,1512,663,862
28063,23,28,0,28063,4732,23331,5131.06,12.4473,547.46,28063,19,25,28035,28035,28035,28035,27921
44340,1,2,44340,0,44340,0,3.19691e+13,1.99986,280.998,44340,2,2,39303,39303,39303,39303,39303
46066,24,56,46066,0,46066,0,1.46258e+18,23.2661,859.295,46066,40,32,46008,45980,45970,19368,44032
39770,40,60,39770,0,0,39770,5.55544e+15,26.8222,907.115,39770,34,40,39710,39699,39588,37418,34262
1992,9,16,1992,0,0,1992,5.59107e+15,13.0713,137.54,1992,14,14,1927,1734,1748,1563,1508
17650,29,44,17650,0,17650,0,1.32305e+18,25.0524,660.414,17650,33,41,17587,17516,17363,14888,14489
17720,7,44,17720,0,0,17720,325209000,20.8637,578.252,17720,32,37,15838,14035,13061,13491,6997
16764,1,4,0,16764,16764,0,8.23994e+15,3.55393,182.641,16764,4,4,14838,14838,14838,14838,14838
45907,35,56,45907,0,0,45907,337163000,29.1824,892.787,45907,37,40,45840,45770,45788,42663,38606
36163,16,23,6124,30039,0,36163,19.2216,18.2149,609.783,36163,20,21,36096,36090,36000,36004,35475
1888,6,28,0,1888,0,1888,887097,23.8104,202.167,1888,25,25,1004,679,713,671,531
22420,4,19,0,22420,4030,18390,5190.15,14.9004,475.349,22420,19,19,19540,19540,17664,13753,14344
40971,50,56,0,40971,40971,0,2.22995e+13,22.2863,811.718,40971,31,32,40915,40903,40915,40915,40915
47581,29,44,47581,0,0,47581,5.11521e+15,38.4366,1040.41,47581,40,41,47428,47079,46909,27042,37185
37060,24,40,0,37060,37060,0,1.68815e+13,35.9748,1001.75,37060,40,37,36724,35998,34863,33533,24516
8946,1,2,0,8946,8946,0,1.1921e+16,1.99821,126.577,8946,2,2,7465,7465,7465,7465,7465
16980,3,5,37,16943,16980,0,1.40635e+16,3.37432,191.966,16980,5,5,16970,16963,16969,16963,15314
6950,13,40,6950,0,6950,0,86776900000,18.1885,329.515,6950,19,29,6821,6468,6531,6480,5317
21534,6,40,0,21534,0,21534,1313570,26.3516,677.334,21534,36,34,17743,15584,12340,9905,5202
30006,1,44,30006,0,0,30006,327468000,25.779,724.171,30006,36,37,3628,3628,3628,3628,3628
30707,22,56,30707,0,30707,0,1.44402e+18,30.8744,754.831,30707,44,40,30587,30477,30508,16071,26014
35739,8,21,6770,28969,0,35739,18.564,17.349,641.904,35739,21,20,34812,34703,34485,34611,32172
27235,15,40,27235,0,0,27235,5.70127e+15,22.8611,628.409,27235,31,29,27046,26702,26210,4539,19728
12086,1,2,12086,0,12086,0,3.25119e+13,1.99942,145.856,12086,2,2,10689,10689,10689,10689,10689
13732,8,13,2351,11381,0,13732,20.4221,11.2512,337.595,13732,13,12,13628,13628,13119,13117,9576
12712,26,38,0,12712,12712,0,2.23618e+13,19.57,465.409,12712,30,25,12674,12658,12665,12665,12674
37320,2,65,0,37320,37319,1,5.93965e+14,26.9438,1142.28,37320,37,48,17735,17526,12978,14693,4059
6508,11,13,0,6508,1061,5447,5187.34,9.77243,229.089,6508,11,12,6494,6494,6483,6482,6483
41410,15,28,0,41410,6957,34453,5190.72,12.491,622.338,41410,21,21,41371,41371,41371,41371,41366
38462,1,2,0,38462,38462,0,9.5772e+15,1.99971,259.234,38462,2,2,33349,33349,33349,33349,33349
19007,22,40,0,19007,19007,0,2.18949e+13,23.1978,541.807,19007,34,37,18921,18831,18860,18734,15469
23690,9,40,23690,0,0,23690,339085000,21.1279,572.186,23690,29,29,22450,19212,19531,19611,11496
37774,37,48,37770,4,0,37774,9.72884e+14,36.3524,1041.05,37774,40,41,37720,37674,37494,35859,37119
26117,17,21,4277,21840,0,26117,20.261,12.1386,469.714,26117,21,20,26092,26092,26092,26092,26089
8827,16,24,8827,0,8827,0,1.46241e+18,18.0208,342.545,8827,19,21,8778,8683,8532,7435,7783
8445,17,23,0,8445,2233,6212,4382.16,15.3779,362.596,8445,18,21,8420,8420,8380,8381,7910
47928,7,44,0,47928,0,47928,1247080,36.141,945.172,47928,38,37,42918,38255,36130,37269,10650
39117,28,60,39117,0,0,39117,330967000,26.2081,896.293,39117,35,40,39015,38890,38882,35393,32756
34354,23,40,0,34354,0,34354,1331660,29.5557,756.874,34354,32,29,34296,34243,34269,34259,33403
28108,3,40,28108,0,0,28108,340475000,30.3416,693.046,28108,31,30,17758,14937,13061,6302,4761
11993,36,40,11993,0,0,11993,5.70836e+15,21.1757,451.627,11993,26,27,11953,11939,11952,11953,11419
1955,15,32,1955,0,1955,0,9.73054e+17,25.3673,211.859,1955,27,25,1698,937,1498,775,1163
35255,8,30,7024,28231,0,35255,18.669,16.212,718.489,35255,21,26,34240,34130,33434,33548,30972
39409,37,40,39409,0,0,39409,5.64324e+15,29.2159,770.766,39409,38,37,39363,39323,39333,34232,39336
22783,1,2,0,22783,22783,0,8.47941e+15,1.99908,198.356,22783,2,2,20101,20101,20101,20101,20101
37883,52,60,37883,0,37883,0,1.41984e+18,26.5275,884.931,37883,44,40,37823,37812,37821,34067,35416
42613,1,40,42613,0,42613,0,1.45813e+18,26.1492,780.854,42613,33,29,4868,4868,4868,4868,4868
39650,3,40,39650,0,0,39650,338357000,27.1845,748.484,39650,32,29,26558,22570,20351,14007,8787
47318,1,2,47318,0,47318,0,3.25625e+13,1.99987,288.761,47318,2,2,41843,41843,41843,41843,41843
35108,9,23,9847,25261,0,35108,16.0206,17.9218,704.605,35108,21,21,33919,33919,33135,33343,18832
23401,1,2,23401,0,23401,0,3.78652e+13,1.9985,203.692,23401,2,2,20252,20252,20252,20252,20252
11876,5,38,0,11876,0,11876,1331200,34.6938,462.551,11876,31,29,9097,6702,6690,5131,2982
18967,8,40,18967,0,0,18967,5.59727e+15,22.5875,539.387,18967,32,37,17617,15445,14995,4551,8389
20571,34,40,20571,0,20571,0,1.36464e+18,31.4867,597.597,20571,35,35,20524,20446,20417,17983,19893
15798,10,56,15798,0,0,15798,5.65102e+15,22.2228,507.809,15798,29,28,15281,14824,13170,2374,7555
21152,8,23,3640,17512,0,21152,19.2222,15.2154,477.295,21152,20,21,20784,20760,20637,20691,10974
39088,1,2,0,39088,39088,0,1.35163e+16,1.99964,267.69,39088,2,2,31755,31755,31755,31755,31755
8995,13,38,8995,0,8995,0,1.43753e+18,31.5936,442.776,8995,29,38,8550,7739,7644,2613,5359
37917,19,23,0,37917,6384,31533,5008.84,19.4538,625.155,37917,21,21,37886,37886,37808,37810,37693
43982,22,44,0,43982,43982,0,2.10376e+13,36.1335,892.029,43982,38,37,43636,42999,43252,42341,29718
2209,17,40,2209,0,2209,0,83970600000,16.4477,215.839,2209,23,21,2162,2122,2125,2110,1635
23126,55,56,23126,0,23126,0,86789300000,22.0071,633.692,23126,31,32,23070,23059,23070,23070,23070
35670,48,54,0,35670,0,35670,5.17134e+14,35.8685,1059.13,35670,42,45,35616,35599,35611,35254,31513
31425,4,19,0,31425,5725,25700,5133,17.4987,587.386,31425,19,19,27203,27203,24308,17329,14802
1650,15,32,0,1650,0,1650,921476,25.2158,191.004,1650,25,25,1457,985,1337,1325,971
5143,1,2,5143,0,5143,0,3.40419e+13,1.99669,94.1351,5143,2,2,4520,4520,4520,4520,4520
2639,8,32,2639,0,0,2639,5.35432e+15,18.7658,179.966,2639,22,21,2504,2337,2303,489,1517
43596,44,56,0,43596,43596,0,2.22911e+13,22.8593,831.816,43596,32,32,43540,43527,43540,43540,43538
12543,28,30,0,12543,3080,9463,4513.01,18.0718,526.795,12543,19,30,12513,12513,12513,12513,12146
44467,1,2,44467,0,44467,0,3.28779e+13,1.99939,278.367,44467,2,2,39272,39272,39272,39272,39272
48250,3,48,48250,0,48250,0,75706400000,36.7477,1110.31,48250,38,41,30258,26038,24584,22757,6685
44954,1,40,44954,0,44954,0,86302200000,31.5311,948,44954,38,36,4334,4334,4334,4334,4334
1328,1,4,0,1328,1328,0,8.13904e+15,2.00075,53.626,1328,3,3,1175,1175,1175,1175,1175
20000,32,40,0,20000,20000,0,2.23295e+13,22.289,564.049,20000,24,28,19960,19944,19956,19951,18498
34975,12,21,5637,29338,0,34975,20.028,16.1398,559.679,34975,21,21,34894,34893,34839,34861,34605
28169,10,21,4509,23660,0,28169,19.7599,16.6862,504.938,28169,20,20,28014,28012,27938,27977,27587
1655,1,16,0,1655,1655,0,2.19025e+13,12.6073,124.986,1655,14,13,226,226,226,226,226
1165,1,2,0,1165,1165,0,8.22632e+15,1.98884,44.582,1165,2,2,1031,1031,1031,1031,1031
26697,39,64,26697,0,0,26697,5.55755e+15,31.9622,901.546,26697,38,55,26633,26631,26627,26632,25383
38337,31,44,38337,0,0,38337,327732000,32.0744,822.923,38337,37,37,38262,38079,38098,33403,32670
22630,1,40,0,22630,0,22630,1333530,21.9923,604.901,22630,31,25,2313,2313,2313,2313,2313
24020,6,30,0,24020,5167,18853,4712.62,16.3516,623.89,24020,20,26,22222,22222,21528,21589,18656
25921,7,38,25921,0,0,25921,5.64709e+15,37.5361,710.712,25921,36,33,22089,18523,15696,6851,8747
36054,8,40,36054,0,36054,0,1.46449e+18,33.4127,770.006,36054,33,30,32607,27164,24201,4719,13693
39224,11,44,39224,0,39224,0,82280200000,36.5679,850.117,39224,37,37,37648,35761,35555,34603,16563
43287,6,44,43287,0,0,43287,308234000,37.8016,985.264,43287,40,41,36245,32557,28593,30583,11963
29195,1,2,29195,0,29195,0,3.53254e+13,1.99928,224.934,29195,2,2,25530,25530,25530,25530,25530
43657,38,48,0,43657,0,43657,1136700,34.3398,1073.94,43657,37,41,43605,43550,43184,43204,35253
38087,1,2,38087,0,38087,0,3.74689e+13,1.99953,258.057,38087,2,2,33016,33016,33016,33016,33016
23105,16,40,23105,0,0,23105,5.7195e+15,22.0176,609.369,23105,32,24,22921,22483,22142,18867,17705
43608,3,4,0,43608,43608,0,8.36607e+15,3.59682,283.506,43608,4,4,43602,43598,43601,43601,43299
33805,30,40,0,33805,0,33805,1308200,34.2201,712.69,33805,37,37,33735,33630,33684,33679,33291
30105,23,40,30105,0,30105,0,87429300000,22.6819,695.806,30105,31,29,30063,30028,30047,30049,29298
43510,1,2,0,43510,43510,0,1.56669e+16,1.99929,287.841,43510,2,2,34049,34049,34049,34049,34049
33259,37,40,33259,0,0,33259,335524000,30.9506,715.296,33259,38,37,33213,33174,33183,33165,33186
24737,13,23,4404,20333,0,24737,19.1528,20.673,528.453,24737,21,21,24626,24626,24532,24541,23668
23247,52,56,0,23247,0,23247,1309980,23.5818,670.18,23247,32,40,23191,23181,23187,23191,23151
28632,1,2,0,28632,28632,0,8.41326e+15,1.99941,223.272,28632,2,2,25288,25288,25288,25288,25288
5185,1,22,5185,0,0,5185,342171000,20.35,276.316,5185,20,20,525,525,525,525,525
26731,15,40,26731,0,26731,0,1.43552e+18,29.0925,628.953,26731,35,37,26511,26166,26285,5358,17958
17554,1,2,17554,0,17554,0,3.24224e+13,1.99915,176.217,17554,2,2,15531,15531,15531,15531,15531
25625,38,40,25625,0,0,25625,5.13788e+15,32.7838,708.244,25625,37,35,25583,25560,25513,24127,25367
35681,39,54,0,35681,0,35681,5.16975e+14,37.3028,930.723,35681,38,45,35625,35580,35586,35590,34611
39062,13,25,8248,30814,0,39062,18.2003,19.6137,732.564,39062,22,23,38873,38873,38701,38717,34310
3974,15,32,3974,0,0,3974,315753000,21.0078,243.983,3974,30,26,3873,3746,3822,3827,2756
17675,4,5,1,17674,17675,0,8.50015e+15,3.22274,199.526,17675,4,4,17670,17668,17669,17669,17670
4903,1,11,783,4120,0,4903,20.3304,8.93555,184.612,4903,11,10,851,851,851,851,851
40567,13,21,0,40567,9145,31422,4453.68,19.1287,723.679,40567,21,20,40298,40298,39959,39988,37267
12209,5,36,12209,0,12209,0,1.02013e+18,30.2962,547.444,12209,33,30,6397,4710,4901,2741,1745
39165,39,40,0,39165,39165,0,2.03713e+13,32.4359,887.08,39165,40,37,39123,39081,39055,39056,38462
14210,32,36,0,14210,14210,0,2.16981e+13,24.3162,452.7,14210,34,33,14166,14132,14134,14127,14134
42558,37,40,0,42558,0,42558,1311740,32.6156,797.787,42558,38,37,42511,42456,42481,42482,42475
40267,15,40,0,40267,40267,0,1.86249e+13,35.3094,983.511,40267,39,37,37723,31034,35765,33851,19740
39088,3,4,0,39088,39088,0,9.55655e+15,1.99957,267.112,39088,3,3,39084,39082,39083,39083,39084
17551,32,56,17551,0,0,17551,332906000,24.9511,601.221,17551,32,40,17489,17454,17432,17006,15117
37578,17,21,0,37578,6075,31503,5136.43,15.6515,578.269,37578,21,21,37541,37541,37519,37519,37449
4589,1,2,0,4589,4589,0,9.13871e+15,1.99869,88.8628,4589,2,2,4006,4006,4006,4006,4006
30421,8,28,4910,25511,0,30421,19.9315,16.9976,551.627,30421,21,27,30154,30150,29875,29897,17895
43608,43,56,43608,0,43608,0,87080400000,22.8501,831.915,43608,32,32,43552,43539,43552,43552,43550
9044,6,19,0,9044,1645,7399,5148.99,11.6086,305.732,9044,19,19,8606,8606,8081,7806,7380
23990,36,44,23990,0,0,23990,312626000,37.0507,744.777,23990,36,41,23942,23904,23782,22320,22884
5040,14,24,5040,0,5040,0,1.45579e+18,17.922,246.19,5040,18,17,5000,4970,4775,3966,2333
15470,7,19,0,15470,2404,13066,5019.85,14.5917,360.603,15470,19,19,15235,15235,15104,15131,15019
6370,8,20,6370,0,6370,0,86627500000,16.6149,266.083,6370,18,19,5968,5240,5039,5348,3293
21541,29,44,21541,0,0,21541,5.04002e+15,31.7872,718.07,21541,37,41,21450,21286,21109,10630,14499
44140,29,60,44140,0,0,44140,5.51505e+15,32.4456,938.058,44140,37,44,44018,43822,43843,15936,30294
47484,43,48,47484,0,0,47484,5.12756e+15,38.1632,1063.5,47484,40,41,47436,47417,47383,47394,47301
46521,2,4,0,46521,46521,0,9.06896e+15,3.17364,307.587,46521,4,4,46468,46451,46464,46465,41296
42210,46,56,42210,0,0,42210,5.64153e+15,31.3733,946.572,42210,38,44,42154,42144,42154,42154,42152
13424,1,40,0,13424,13424,0,2.20974e+13,22.624,443.904,13424,29,29,1587,1587,1587,1587,1587
8366,41,56,8366,0,0,8366,5.58415e+15,19.1371,391.532,8366,26,30,8310,8300,8310,7644,8308
44422,1,40,0,44422,0,44422,1331830,36.8296,859.738,44422,33,31,4572,4572,4572,4572,4572
21895,15,19,0,21895,3961,17934,5162.61,17.1641,479.4,21895,19,19,21856,21856,21856,21856,21856
25108,1,2,25108,0,25108,0,3.47416e+13,1.99968,208.334,25108,2,2,22008,22008,22008,22008,22008
26213,16,40,26213,0,0,26213,5.71364e+15,30.6651,670.429,26213,31,29,25947,25319,24671,21000,21696
21247,18,44,0,21247,0,21247,1287760,33.9712,610.375,21247,36,37,21084,20898,20973,20940,15021
24418,1,40,24418,0,24418,0,1.434e+18,30.4676,607.067,24418,35,37,2977,2977,2977,2977,2977
24035,1,2,24035,0,24035,0,3.28846e+13,1.99863,204.406,24035,2,2,21226,21226,21226,21226,21226
40668,1,4,0,40668,40668,0,8.38262e+15,1.99995,271.691,40668,3,3,35934,35934,35934,35934,35934
40441,10,21,6495,33946,0,40441,20.0542,15.4589,596.148,40441,21,21,40317,40316,40250,40270,40115
11335,17,40,0,11335,11335,0,2.23581e+13,20.8167,434.03,11335,22,27,11262,11058,11121,10778,8370
11629,35,36,11629,0,11629,0,1.41248e+18,25.4622,412.759,11629,33,33,11591,11553,11583,10691,11583
16225,1,2,16225,0,16225,0,3.24932e+13,1.99877,168.402,16225,2,2,14351,14351,14351,14351,14351
7645,26,56,7645,0,7645,0,1.42686e+18,19.4292,388.989,7645,33,31,7589,7567,7568,3310,6824
20592,11,44,20592,0,20592,0,69929200000,31.1559,738.126,20592,36,37,17465,13880,15778,14710,6999
27726,37,40,27726,0,27726,0,1.43889e+18,31.2291,653.934,27726,37,37,27682,27644,27650,24219,27653
38869,3,4,0,38869,38869,0,8.37944e+15,1.9999,265.614,38869,3,3,38865,38863,38864,38864,38865
5962,1,2,5962,0,5962,0,3.9516e+13,1.99849,101.985,5962,2,2,5124,5124,5124,5124,5124
10727,2,4,0,10727,10727,0,8.47736e+15,2.00028,141.555,10727,3,3,10722,10721,10722,10722,9696
16902,12,40,16902,0,16902,0,1.46083e+18,21.2893,526.941,16902,29,29,16437,15500,14190,4273,10278
47827,27,28,7885,39942,0,47827,20.0968,15.3052,686.724,47827,21,27,47799,47799,47799,47799,47763
5815,1,36,5815,0,5815,0,1.38836e+18,19.188,298.582,5815,29,32,755,755,755,755,755
1681,3,12,307,1374,0,1681,20.3688,9.63355,123.233,1681,11,11,1263,1263,1246,736,673
35441,35,40,0,35441,0,35441,1328730,33.2103,785.805,35441,32,31,35394,35327,35387,35386,33900
36113,1,2,36113,0,36113,0,3.28295e+13,1.99978,251.08,36113,2,2,31900,31900,31900,31900,31900
36749,1,2,36749,0,36749,0,3.38851e+13,1.9997,252.56,36749,2,2,32324,32324,32324,32324,32324
1485,28,36,1485,0,0,1485,5.49833e+15,11.9663,153.204,1485,19,25,1449,1443,1448,1349,1447
27323,10,44,27323,0,27323,0,83357900000,33.2511,698.715,27323,35,37,26157,25112,23642,23508,12020
31326,27,30,5436,25890,0,31326,19.5683,14.0664,615.703,31326,20,26,31296,31296,31296,31296,31123
5505,11,22,0,5505,0,5505,1343010,17.5437,277.673,5505,19,19,5294,5005,4603,4623,3823
29540,17,60,29540,0,29540,0,79568900000,29.5321,897.734,29540,37,44,28814,25935,27993,27129,17093
4124,1,20,707,3417,0,4124,19.9098,10.4183,215.381,4124,19,16,672,672,672,672,672
9242,1,56,9242,0,0,9242,5.50195e+15,21.0619,462.766,9242,29,39,1010,1010,1010,1010,1010
43736,13,20,7749,35987,0,43736,20.31,15.8255,656.045,43736,20,19,43685,43685,43685,43685,43685
6208,6,24,0,6208,0,6208,1329640,17.621,292.864,6208,19,21,5356,4831,3864,3849,2549
19917,11,40,0,19917,19917,0,1.97001e+13,33.8731,632.232,19917,36,34,18541,17069,17718,16769,8026
49294,1,2,0,49294,49294,0,8.79414e+15,1.99955,292.407,49294,2,2,43277,43277,43277,43277,43277
39317,54,56,39317,0,39317,0,1.44381e+18,29.3591,822.941,39317,46,40,39261,39249,39261,35804,39239
41868,45,54,41862,6,0,41868,8.77752e+14,40.6217,1141.17,41868,46,45,41814,41802,41423,40095,34087
13585,21,44,13585,0,13585,0,75606600000,26.8826,593.221,13585,36,41,13375,12902,13113,12602,7061
45386,56,60,45386,0,45386,0,83767900000,37.2948,1040.21,45386,40,44,45326,45309,45324,45325,44621
42293,33,44,42293,0,42293,0,84104700000,32.6707,858.251,42293,37,38,42226,42114,42063,42030,38080
26340,23,44,26340,0,0,26340,302436000,35.7457,758.138,26340,39,35,26065,25362,25682,11565,13045
3631,1,2,3631,0,3631,0,5.24035e+13,1.99477,80.4198,3631,2,2,2954,2954,2954,2954,2954
48089,36,40,0,48089,48089,0,2.23365e+13,30.6082,897.58,48089,34,30,48043,47977,48037,48038,48041
33579,1,2,33579,0,33579,0,4.10154e+13,1.99985,243.311,33579,2,2,28685,28685,28685,28685,28685
4555,2,28,0,4555,766,3789,5006.47,9.83798,240.923,4555,19,21,3074,3074,2932,1806,987
7783,1,22,7783,0,0,7783,5.76418e+15,19.3344,333.825,7783,20,20,781,781,781,781,781
40787,1,44,40787,0,40787,0,1.41059e+18,33.1261,847.55,40787,37,38,4884,4884,4884,4884,4884
20190,31,40,0,20190,0,20190,1299770,35.3347,569.746,20190,37,37,20130,20048,20077,20078,18846
30984,9,40,30984,0,30984,0,87176900000,22.4584,697.905,30984,32,24,28937,24076,23814,24071,13636
46232,38,56,0,46232,46232,0,2.20701e+13,28.5928,972.764,46232,38,43,46176,46162,46176,46175,42629
28182,55,60,0,28182,0,28182,1183690,36.5951,922.044,28182,38,51,28122,28112,28117,28121,24687
35205,14,20,5952,29253,0,35205,20.3268,11.9761,562.992,35205,20,17,35179,35179,35179,35179,35179
36888,17,28,6034,30854,0,36888,20.0003,16.0177,610.252,36888,21,27,36842,36842,36820,36820,36509
30152,19,21,4798,25354,0,30152,20.1601,14.443,495.072,30152,21,20,30127,30127,30125,30127,30125
19982,3,4,0,19982,19982,0,1.20517e+16,1.99875,198.308,19982,3,3,19978,19976,19977,19977,19978
13639,6,19,0,13639,3397,10242,4227.61,15.9118,416.083,13639,19,18,12195,12195,12053,12130,5189
23578,6,40,23578,0,23578,0,85852700000,29.3483,574.129,23578,31,29,20870,19130,15529,18139,7617
43662,6,21,0,43662,6953,36709,5091.01,17.432,622.069,43662,21,21,42632,42632,41613,41644,41621
32327,17,20,5760,26567,0,32327,20.0417,15.6167,618.826,32327,19,20,32285,32285,32249,32249,32232
33220,36,40,33220,0,0,33220,5.70322e+15,34.1304,762.854,33220,32,30,33175,33108,33170,33170,31931
46637,7,40,0,46637,46637,0,2.2289e+13,32.7362,902.363,46637,33,32,40208,34002,29267,33826,18357
21650,2,60,21650,0,21650,0,80082800000,25.5748,793.04,21650,34,44,11501,11433,8414,9318,2666
42450,13,40,42450,0,42450,0,1.33627e+18,32.4624,934.644,42450,40,37,40560,37367,39199,7620,18078
34767,34,56,0,34767,34767,0,2.20145e+13,30.7088,792.985,34767,37,40,34701,34637,34643,34620,29804
48019,1,2,0,48019,48019,0,1.15967e+16,1.99915,293.216,48019,2,2,40290,40290,40290,40290,40290
49519,11,40,49519,0,49519,0,86493300000,28.6085,885.444,49519,40,37,48051,45968,42948,42680,23251
32691,1,2,32691,0,32691,0,4.95085e+13,1.99957,245.705,32691,2,2,26940,26940,26940,26940,26940
10951,1,2,10951,0,10951,0,4.51347e+13,1.9969,139.296,10951,2,2,9194,9194,9194,9194,9194
37373,37,40,37373,0,37373,0,1.42997e+18,35.5688,763.176,37373,38,37,37328,37275,37296,33972,37326
16607,1,2,0,16607,16607,0,8.36557e+15,1.99952,170.371,16607,2,2,14678,14678,14678,14678,14678
5593,1,2,5593,0,5593,0,3.21082e+13,1.99696,99.6925,5593,2,2,4954,4954,4954,4954,4954
30602,1,2,0,30602,30602,0,9.07961e+15,1.99974,230.209,30602,2,2,26745,26745,26745,26745,26745
33961,11,23,0,33961,8993,24968,4226.89,20.3639,698.492,33961,23,21,33458,33458,33158,33234,24119
10229,8,13,0,10229,1651,8578,5191.58,10.3808,281.282,10229,12,12,10172,10172,10026,10025,10135
35897,35,56,0,35897,35897,0,2.19592e+13,33.4366,885.614,35897,38,44,35820,35647,35750,35760,34705
29248,43,60,29248,0,29248,0,81942100000,25.2402,884.366,29248,35,44,29188,29179,29069,29075,24711
16566,9,13,2656,13910,0,16566,20.2835,10.3111,352.502,16566,12,12,16520,16520,16454,16453,16475
19593,63,65,19592,1,19592,1,4.34672e+12,32.9507,932.87,19593,36,57,19528,19522,19527,19528,19228
29081,36,49,29081,0,0,29081,5.33408e+15,36.442,904.94,29081,38,41,29026,28984,28781,27499,28055
32978,3,40,32978,0,0,32978,331086000,31.5716,708.483,32978,37,37,22654,19408,17735,13740,6610
19252,20,38,19252,0,19252,0,84140500000,33.9507,663.705,19252,38,38,18894,18308,18513,18497,14725
5028,3,32,0,5028,1959,3069,3737.56,15.8884,305.634,5028,18,24,2827,2800,2713,2745,1141
1707,7,20,0,1707,1707,0,2.23278e+13,12.4277,140.865,1707,15,17,1542,1362,1269,1330,929
12103,29,56,12103,0,12103,0,1.44322e+18,19.5531,465.614,12103,36,31,12047,12027,12031,3792,10780
33377,1481,12327,33377,0,17820,15557,2.54857e+18,606.779,15421.6,33377,3085,279,21050,19798,17737,5079,2356
7690,22,40,7690,0,7690,0,85490500000,18.6377,374.224,7690,26,35,7636,7588,7596,7502,7219
36231,6,60,36231,0,36231,0,1.34132e+18,31.7376,946.079,36231,48,44,30549,27480,24034,5347,9178
25822,1,4,0,25822,25822,0,8.327e+15,1.99985,217.925,25822,3,3,22835,22835,22835,22835,22835
7123,3,13,1177,5946,0,7123,20.3605,10.1968,237.886,7123,12,12,5587,5587,5568,4820,3679
37879,15,21,6296,31583,0,37879,19.504,16.3348,610.885,37879,20,20,37808,37808,37760,37764,36912
37801,9,21,0,37801,6034,31767,5125.44,14.963,572.264,37801,20,21,37629,37629,37575,37599,37436
40951,33,60,40951,0,0,40951,5.31335e+15,34.134,1141.7,40951,38,55,40844,40603,40521,34698,31864
20041,22,40,0,20041,0,20041,1303130,35.4823,572.158,20041,36,37,19937,19835,19871,19866,15083
13081,3,30,0,13081,2379,10702,4765.7,15.5461,419.877,13081,19,25,10423,10422,10288,10016,3920
11709,9,40,0,11709,11709,0,2.16511e+13,24.7402,442.859,11709,32,37,11055,9633,9942,9610,4918
20031,2,4,0,20031,20031,0,8.18027e+15,3.82672,213.397,20031,4,4,19954,19929,19946,19948,18174
47052,5,44,47052,0,0,47052,5.47681e+15,36.8911,905.78,47052,38,37,38458,29592,31089,6049,6289
46569,14,40,46569,0,0,46569,5.71794e+15,30.8202,886.33,46569,33,30,45853,45049,40880,35239,29018
22083,9,40,0,22083,0,22083,1245300,31.0708,617.267,22083,36,35,20720,18402,18996,18947,9126
27908,37,40,27908,0,27908,0,74469700000,35.1239,785.23,27908,37,37,27863,27822,27700,27713,27855
3543,12,36,0,3543,3543,0,2.17333e+13,14.1942,216.657,3543,22,25,3478,3392,3390,3350,2892
27497,31,64,27497,0,0,27497,5.20161e+15,26.8247,944.948,27497,32,44,27425,27350,27290,25723,21071
37943,19,40,37943,0,37943,0,74137900000,35.3142,929.393,37943,39,37,37100,35122,35954,34285,23036
32364,1,2,32364,0,32364,0,3.40407e+13,1.99969,236.864,32364,2,2,28449,28449,28449,28449,28449
32266,23,48,0,32266,32266,0,1.83337e+13,34.9439,948.793,32266,37,41,31905,30745,31336,30245,14876
7814,10,19,1252,6562,0,7814,19.3509,15.0544,265.081,7814,18,19,7738,7737,7705,7726,7531
41151,28,60,41151,0,41151,0,1.41007e+18,36.7115,1036.73,41151,50,42,40967,40626,40650,17356,31277
21957,2,19,3922,18035,0,21957,20.2986,14.5527,469.183,21957,19,19,14115,14115,13667,5714,6571
13595,35,44,13595,0,0,13595,282050000,32.506,596.982,13595,34,37,13549,13504,13507,13207,13130
29495,31,40,29495,0,29495,0,78453700000,34.0776,785.574,29495,40,37,29411,29157,29165,29131,22991
21423,8,25,5939,15484,0,21423,16.4942,16.3778,588.757,21423,21,23,20077,19817,19576,19679,14083
5789,1,2,5789,0,5789,0,4.60454e+13,1.99758,101.835,5789,2,2,4841,4841,4841,4841,4841
44925,8,28,0,44925,7904,37021,5101.2,16.6406,761.937,44925,19,28,44189,44169,42645,42659,33526
3655,7,17,0,3655,1370,2285,3521.38,15.333,215.669,3655,16,16,3089,3089,3067,3089,2363
46764,43,65,46764,0,46764,0,1.2099e+18,32.7202,1284.4,46764,47,48,46699,46690,46498,41112,27829
6477,22,24,6477,0,0,6477,5.7444e+15,17.6321,301.848,6477,19,21,6453,6443,6451,5950,6220
48799,24,48,48799,0,0,48799,4.97907e+15,35.4404,1113.73,48799,38,41,48449,47828,47782,17852,31122
12007,20,24,0,12007,12007,0,2.24283e+13,20.0855,405.751,12007,20,21,11979,11957,11961,11958,11947
9638,9,19,2118,7520,0,9638,17.1849,14.2564,334.889,9638,19,17,9373,9373,9271,9333,3896
21548,14,40,21548,0,21548,0,1.44195e+18,30.0938,547.225,21548,30,29,21375,21169,20885,3086,14857
16846,22,24,16846,0,0,16846,342528000,20.3972,482.556,16846,22,21,16820,16806,16818,16817,16785
32162,44,56,32162,0,0,32162,5.69356e+15,22.5996,728.446,32162,30,32,32106,32094,32106,32106,32104
38362,1,2,0,38362,38362,0,8.66299e+15,1.99924,258.131,38362,2,2,33749,33749,33749,33749,33749
4344,3,11,701,3643,0,4344,20.3923,8.67472,172.641,4344,10,10,3444,3444,3442,3186,2223
44865,21,44,0,44865,0,44865,1222180,39.4911,989.145,44865,41,41,44393,43458,43861,43878,26208
6245,8,13,1034,5211,0,6245,20.3106,9.23459,225.408,6245,11,12,6201,6201,6075,6074,6165
9061,1,19,0,9061,1409,7652,5136.16,10.2879,263.634,9061,19,18,1673,1673,1673,1673,1673
41347,1,56,41347,0,0,41347,338575000,37.193,882.171,41347,40,38,4528,4528,4528,4528,4528
18573,21,40,18573,0,18573,0,1.45869e+18,18.9134,509.286,18573,28,29,18532,18511,18521,8758,17810
1869,9,18,0,1869,0,1869,1338350,12.9759,146.194,1869,15,15,1769,1504,1573,1559,1399
27365,36,56,27365,0,0,27365,338960000,22.465,668.148,27365,30,32,27309,27293,27308,27307,24061
35374,1,40,35374,0,0,35374,341097000,22.044,753.932,35374,30,29,3623,3623,3623,3623,3623
16387,38,40,0,16387,16387,0,2.22645e+13,20.5147,523.921,16387,30,25,16347,16337,16347,16347,15946
40502,8,60,40502,0,0,40502,317981000,33.5766,1133.36,40502,38,55,35027,28879,27328,26495,12623
10906,34,36,10906,0,0,10906,270355000,31.39,498.859,10906,35,33,10866,10828,10761,10199,10493
44887,15,28,0,44887,7457,37430,5184.29,12.4168,642.936,44887,20,21,44848,44848,44848,44848,44843
4249,1,2,0,4249,4249,0,1.01074e+16,1.99765,86.7795,4249,2,2,3652,3652,3652,3652,3652
8590,10,40,8590,0,8590,0,86175400000,17.386,355.671,8590,25,29,8304,8045,7390,7414,4697
5794,4,44,0,5794,0,5794,1119790,23.9323,429.642,5794,29,41,3572,2798,2796,2318,912
24754,6,25,6451,18303,0,24754,16.9941,15.6795,625.692,24754,21,23,21912,21912,21580,21666,16394
2294,3,32,0,2294,2294,0,1.99427e+13,23.6953,193.736,2294,27,28,1617,1412,1338,1148,541
20807,1,2,20807,0,20807,0,3.91633e+13,1.99962,194.671,20807,2,2,17911,17911,17911,17911,17911
11329,1,2,0,11329,11329,0,8.37036e+15,1.99894,140.559,11329,2,2,10012,10012,10012,10012,10012
12907,8,23,0,12907,2914,9993,4655.8,13.2106,437.828,12907,18,22,12437,12358,12250,12284,10558
18700,31,40,0,18700,0,18700,1247120,28.6643,566.883,18700,34,35,18642,18507,18530,18534,16465
16127,3,19,0,16127,3103,13024,5007.23,18.3028,460.147,16127,19,19,11847,11843,10641,6069,6578
4956,18,22,0,4956,4956,0,2.25555e+13,16.7433,264.104,4956,19,19,4932,4922,4910,4906,4929
21425,8,32,0,21425,5962,15463,4184.85,20.3171,614.296,21425,22,27,20028,19759,19488,19591,8405
8414,32,36,8414,0,0,8414,243399000,29.9451,456.163,8414,33,33,8376,8359,8323,8181,8375
27009,29,40,0,27009,27009,0,2.19303e+13,29.0082,632.508,27009,36,37,26945,26865,26901,26866,26230
5317,18,22,0,5317,5317,0,2.2173e+13,20.0961,292.914,5317,21,22,5273,5231,5213,5211,5005
31711,6,64,31711,0,0,31711,325524000,36.2162,1031.5,31711,38,56,24867,21311,17330,12863,7735
41550,2,23,7728,33822,0,41550,18.8064,17.9806,700.083,41550,21,22,28426,28426,28379,23578,22761
41090,6,23,7416,33674,0,41090,18.8008,19.7263,677.102,41090,22,21,39248,39248,38504,38617,10274
34186,1,2,0,34186,34186,0,1.46198e+16,1.99903,253.191,34186,2,2,27249,27249,27249,27249,27249
3540,24,32,3540,0,3540,0,1.2871e+18,25.5565,238.006,3540,29,28,3482,3404,3448,2173,2735
38634,17,21,0,38634,9557,29077,4315.04,18.8452,724.104,38634,21,20,38583,38583,38362,38365,38395
40820,1,2,40820,0,40820,0,3.37191e+13,1.99963,266.709,40820,2,2,35929,35929,35929,35929,35929
7279,1,2,0,7279,7279,0,1.59182e+16,1.9989,117.531,7279,2,2,5670,5670,5670,5670,5670
6165,30,36,6165,0,0,6165,248668000,29.7359,391.796,6165,31,33,6123,6066,6055,5810,5839
35182,15,21,5665,29517,0,35182,20.0465,15.4406,556.13,35182,20,21,35133,35133,35114,35114,35015
23473,16,30,0,23473,4250,19223,5030.92,12.9278,553.786,23473,20,24,23432,23430,23382,23382,22742
44917,13,56,0,44917,0,44917,1315570,37.0419,882.329,44917,40,40,44118,41890,40543,41124,25321
25677,13,60,0,25677,0,25677,1227130,35.0784,941.98,25677,38,55,24029,20937,21267,20450,12254
22254,1,2,22254,0,22254,0,3.26326e+13,1.99955,196.881,22254,2,2,19673,19673,19673,19673,19673
49416,60,65,0,49416,0,49416,3.73284e+14,41.4703,1409.08,49416,41,58,49351,49341,49347,49351,45896
46033,8,44,0,46033,0,46033,1201440,38.5379,1012.29,46033,40,41,40702,35452,35236,35831,11707
23713,28,44,23713,0,23713,0,8.3113e+10,27.4621,659.982,23713,36,37,23627,23510,23466,23210,18699
26674,31,56,0,26674,26674,0,2.22489e+13,21.6052,671.162,26674,31,32,26618,26598,26610,26609,25965
21434,6,38,21434,0,21434,0,1.4619e+18,29.1878,614.211,21434,31,30,17688,15492,12652,3356,6537
41917,26,40,41917,0,41917,0,1.44765e+18,29.2384,801.376,41917,39,37,41831,41733,41767,13444,32347
42377,1,2,42377,0,42377,0,3.23407e+13,1.99974,273.828,42377,2,2,37507,37507,37507,37507,37507
48572,16,38,48572,0,48572,0,8.6224e+10,36.3923,986.536,48572,38,38,47761,46142,45082,44731,26057
12922,12,21,2847,10075,0,12922,17.267,17.7191,396.045,12922,20,19,12770,12758,12664,12684,11851
43755,38,40,43755,0,43755,0,87055300000,33.4653,875.658,43755,33,31,43714,43687,43713,43710,42042
13658,24,44,13658,0,13658,0,82213800000,28.0527,535.322,13658,32,37,13560,13443,13414,13109,10936
37404,27,44,37404,0,37404,0,81071100000,36.5798,851.919,37404,38,37,37245,36762,36913,36549,29981
15756,1,2,0,15756,15756,0,8.99577e+15,1.99886,165.42,15756,2,2,13788,13788,13788,13788,13788
45901,4,56,45901,0,0,45901,339390000,35.2593,880.818,45901,40,32,33124,25220,24390,20015,10078
42017,26,64,42017,0,0,42017,5.61238e+15,31.9264,1081.63,42017,38,56,41848,41629,41678,41737,39911
4491,6,36,4491,0,0,4491,5.58061e+15,14.9679,239.203,4491,22,25,4033,3736,3079,1015,2108
37092,9,23,0,37092,6189,30903,4986.13,18.2596,615.881,37092,21,21,36740,36740,36618,36693,35588
44760,11,64,0,44760,44760,0,2.02975e+13,27.2189,1150.62,44760,36,44,40712,35855,35656,34483,18339
37925,20,32,8940,28985,0,37925,18.3532,16.8798,881.005,37925,20,31,37892,37892,37768,37768,31771
26504,1,2,26504,0,26504,0,3.80412e+13,1.9994,215.452,26504,2,2,22921,22921,22921,22921,22921
15041,1,2,15041,0,15041,0,4.73835e+13,1.99894,165.887,15041,2,2,12508,12508,12508,12508,12508
42569,13,44,42569,0,42569,0,1.40242e+18,31.8449,853.267,42569,37,37,41616,39793,40519,6028,19291
18810,27,48,18810,0,18810,0,6.8261e+10,32.2603,713.433,18810,36,33,18687,18291,18217,17974,8959
17596,23,40,17596,0,0,17596,5.66584e+15,18.9578,487.392,17596,26,29,17556,17536,17547,11657,16904
30985,31,40,30985,0,30985,0,85602700000,29.2042,676.082,30985,36,37,30924,30816,30877,30859,26748
18683,1,2,18683,0,18683,0,3.2949e+13,1.99957,180.05,18683,2,2,16495,16495,16495,16495,16495
46043,38,44,46043,0,46043,0,1.19925e+18,38.2671,1074.95,46043,39,39,45992,45926,45584,42747,45244
42742,36,40,42742,0,42742,0,1.46406e+18,32.1385,835.146,42742,32,32,42698,42656,42691,38404,42698
24944,9,21,5077,19867,0,24944,17.9402,17.8848,545.131,24944,21,19,24423,24423,24184,24305,8470
3049,3,10,504,2545,0,3049,20.4434,8.43424,145.799,3049,10,10,2401,2401,2399,2184,1555
19262,8,21,3040,16222,0,19262,20.0862,15.446,396.808,19262,20,20,19146,19146,19023,19032,19050
48156,25,40,0,48156,0,48156,1332330,22.5867,852.95,48156,32,28,48116,48094,48102,48101,48116
20928,37,40,0,20928,20928,0,1.61089e+13,32.2377,746.34,20928,35,37,20888,20869,20832,20861,20887
29632,13,40,0,29632,0,29632,1332840,21.4011,681.01,29632,32,25,29080,27328,26060,26168,18774
34219,1,2,0,34219,34219,0,9.42757e+15,1.99936,244.436,34219,2,2,29741,29741,29741,29741,29741
33060,1,2,33060,0,33060,0,3.30005e+13,1.99952,239.515,33060,2,2,29183,29183,29183,29183,29183
43575,54,60,43575,0,0,43575,5.6087e+15,36.5451,933.547,43575,40,40,43515,43490,43512,43515,43146
43195,30,40,0,43195,0,43195,1317190,29.0308,811.036,43195,39,37,43127,43043,43079,43077,36215
2794,1,2,2794,0,2794,0,3.50584e+13,1.99177,69.8747,2794,2,2,2445,2445,2445,2445,2445
25108,1,4,0,25108,25108,0,8.30551e+15,2.86032,229.543,25108,4,4,22183,22183,22183,22183,22183
13830,12,24,13830,0,13830,0,87729100000,20.1756,441.273,13830,20,21,13475,12696,11731,12241,8967
2299,1,2,2299,0,2299,0,3.25674e+13,1.99304,63.7111,2299,2,2,2032,2032,2032,2032,2032
43732,35,40,43732,0,0,43732,5.7097e+15,22.2207,802.697,43732,32,29,43692,43675,43692,36804,43692
11604,10,36,11604,0,0,11604,259703000,32.5564,529.89,11604,34,33,9467,7544,8411,8267,3957
6047,14,60,0,6047,0,6047,1184400,24.74,440.178,6047,28,40,5690,5153,5211,5328,3102
39607,13,40,0,39607,0,39607,1327700,32.0046,830.16,39607,32,31,38564,35624,34017,33146,25904
21554,17,38,0,21554,21554,0,2.23661e+13,20.4889,592.586,21554,30,27,21418,20924,21016,20922,19616
45727,13,44,45727,0,45727,0,83721800000,37.588,893.799,45727,38,38,44698,42687,43447,42661,22524
41477,514,1764,41440,37,41477,0,3.40977e+18,481.521,4898.67,41477,268,202,39427,38551,26797,24577,11922
19077,1,2,19077,0,19077,0,3.62375e+13,1.99916,184.211,19077,2,2,16620,16620,16620,16620,16620
15384,1,2,0,15384,15384,0,1.58083e+16,1.99857,171.798,15384,2,2,12008,12008,12008,12008,12008
27725,1,38,27725,0,0,27725,337946000,33.5823,714.038,27725,33,32,2631,2631,2631,2631,2631
6676,18,21,1644,5032,0,6676,17.3235,15.6609,308.376,6676,18,20,6654,6653,6615,6616,6397
30277,38,56,30277,0,0,30277,336874000,24.6924,784.517,30277,35,40,30221,30207,30221,30219,26821
13991,11,20,0,13991,2458,11533,5192.17,11.1819,371.912,13991,19,15,13951,13951,13950,13949,13928
21437,33,40,21437,0,0,21437,5.54147e+15,32.0085,587.935,21437,37,36,21388,21331,21325,18128,20676
45339,12,44,45339,0,45339,0,1.32313e+18,35.8422,989.63,45339,40,41,42785,39382,40198,7529,15555
44887,35,60,0,44887,44887,0,2.15684e+13,36.9262,1030.64,44887,40,44,44821,44762,44693,44692,43391
21311,18,44,21311,0,0,21311,4.98596e+15,36.2337,716.025,21311,37,41,20781,19878,20212,6428,10108
23986,3,40,23986,0,0,23986,333740000,30.4561,600.276,23986,35,37,16338,13956,12692,9563,5550
32899,1,2,32899,0,32899,0,3.40176e+13,1.9996,238.811,32899,2,2,28922,28922,28922,28922,28922
14355,1,24,0,14355,14355,0,2.24146e+13,21.4672,461.384,14355,23,22,1458,1458,1458,1458,1458
10557,14,24,0,10557,10557,0,2.23781e+13,17.7941,373.106,10557,19,21,10471,10377,9495,10144,8286
23218,34,40,0,23218,0,23218,1331250,21.4411,621.915,23218,30,29,23178,23164,23176,23176,22369
25792,16,44,25792,0,0,25792,5.46187e+15,26.5549,680.697,25792,34,37,25422,24653,25133,11683,17206
46436,10,27,15185,31251,4,46432,6061380000,21.8565,848.427,46436,26,21,45198,45100,43497,43634,14436
46018,28,60,46018,0,0,46018,327322000,36.9541,1044.87,46018,40,44,45922,45827,45731,43745,42208
31850,16,32,0,31850,6588,25262,4958.51,13.1652,716.527,31850,20,24,31810,31810,31750,31754,28337
47675,9,44,0,47675,47675,0,1.81441e+13,35.4766,1093.83,47675,39,39,39544,32293,34986,32954,14496
18307,12,21,2959,15348,0,18307,20.241,10.4584,386.123,18307,19,20,18278,18278,18272,18277,18274
42179,27,40,0,42179,0,42179,1333180,28.027,829.27,42179,33,30,42126,42085,42105,42106,42126
871,17,18,871,0,0,871,347718000,12.3927,106.31,871,15,16,853,843,853,852,853
46279,6,40,46279,0,46279,0,76960300000,33.7216,1006.96,46279,40,37,38476,34523,31044,32048,10788
27792,1,2,27792,0,27792,0,3.83747e+13,1.99978,220.141,27792,2,2,24002,24002,24002,24002,24002
20358,37,40,20358,0,0,20358,340384000,21.4223,576.362,20358,30,28,20318,20304,20317,20318,19429
43347,28,44,43347,0,43347,0,1.33928e+18,38.8328,962.388,43347,37,41,43183,42891,42702,14865,35366
40969,1,2,40969,0,40969,0,3.37476e+13,1.99971,266.808,40969,2,2,36056,36056,36056,36056,36056
5413,9,12,912,4501,0,5413,20.4057,9.11768,208.659,5413,11,11,5386,5386,5385,5384,5368
47774,32,44,47774,0,47774,0,81430500000,33.3808,980.579,47774,40,41,47690,47554,47394,47126,41907
26088,15,23,7676,18412,0,26088,15.9197,19.6307,622.338,26088,22,21,26005,26005,25798,25807,25337
1349,9,16,0,1349,0,1349,1299640,14.6079,115.991,1349,13,14,1295,1164,1154,1152,1052
21379,1,2,0,21379,21379,0,1.00609e+16,1.99906,193.588,21379,2,2,18393,18393,18393,18393,18393
32689,10,21,0,32689,5216,27473,5074.8,15.8888,539.135,32689,20,20,32530,32528,32455,32494,32281
27375,8,23,0,27375,7506,19869,4203.39,19.2919,633.885,27375,22,21,25677,25345,25063,25197,18059
18753,28,36,18753,0,18753,0,1.42506e+18,25.5539,517.444,18753,36,33,18693,18617,18656,15263,17208
13099,18,40,13099,0,13099,0,1.46208e+18,20.5181,475.728,13099,23,29,13021,12945,12848,10688,12199
34882,3,23,0,34882,6111,28771,4889.94,19.2254,615.147,34882,21,21,27874,27872,27753,26333,16593
6807,20,22,6807,0,0,6807,5.73619e+15,20.4772,324.195,6807,21,22,6777,6727,6755,6469,6686
18585,48,56,18585,0,18585,0,86391100000,21.9615,554.164,18585,29,30,18529,18517,18529,18529,18527
40345,35,40,40345,0,0,40345,5.0866e+15,33.9148,921.509,40345,40,37,40289,40135,40058,35287,38154
32751,14,28,0,32751,5459,27292,5181.13,12.2572,556.483,32751,21,21,32711,32711,32711,32711,32652
711,14,18,711,0,0,711,344134000,15.82,98.8323,711,14,15,689,677,661,661,510
5814,1,2,0,5814,5814,0,1.86527e+16,1.99553,106.31,5814,2,2,4308,4308,4308,4308,4308
31764,24,60,0,31764,31764,0,2.12428e+13,37.0315,801.369,31764,37,44,31564,31305,31333,31086,20570
4306,10,22,0,4306,4306,0,2.2457e+13,16.9647,246.96,4306,18,19,4100,3924,3548,3371,2794
880,13,15,0,880,127,753,4762.76,6.29318,78.7539,880,15,14,863,863,863,863,860
44996,13,23,7519,37477,0,44996,19.6065,19.7182,679.421,44996,22,21,44847,44847,44701,44737,43911
12429,1,2,12429,0,12429,0,4.36854e+13,1.99871,148.297,12429,2,2,10499,10499,10499,10499,10499
15111,1,2,15111,0,15111,0,3.26348e+13,1.99854,162.03,15111,2,2,13358,13358,13358,13358,13358
5952,26,36,5952,0,5952,0,1.39922e+18,18.6312,306.08,5952,31,32,5902,5850,5864,3202,5473
22876,12,60,22876,0,22876,0,84298200000,24.0143,727.556,22876,32,40,21956,20441,19372,19571,11864
23581,39,40,0,23581,23581,0,2.18684e+13,32.798,718.356,23581,38,35,23541,23531,23541,23541,23396
30327,21,24,30327,0,0,30327,341008000,21.5253,669.331,30327,24,22,30288,30177,30261,30261,29374
17360,5,13,0,17360,2860,14500,5209.78,11.5122,369.862,17360,13,13,16287,16287,14467,14431,14343
10445,1,2,10445,0,10445,0,3.26074e+13,1.99732,135.334,10445,2,2,9234,9234,9234,9234,9234
9759,15,19,0,9759,2848,6911,3932.21,16.6962,357.354,9759,19,18,9718,9718,9625,9629,9596
12269,1,2,12269,0,12269,0,5.10459e+13,1.99902,150.633,12269,2,2,10043,10043,10043,10043,10043
9620,18,22,0,9620,0,9620,1330610,19.6138,388.991,9620,22,22,9570,9518,9471,9469,9169
11470,3,40,11470,0,0,11470,5.66965e+15,18.2729,404.928,11470,20,29,7693,6541,5900,1422,2408
12053,7,12,2116,9937,0,12053,20.4444,11.0441,321.416,12053,12,12,11779,11779,11121,11347,11146
5639,27,36,5639,0,0,5639,266674000,30.3486,351.608,5639,30,29,5583,5424,5482,4977,4965
11116,13,24,11116,0,11116,0,87240900000,21.9655,383.692,11116,21,21,10959,10450,9570,10281,4824
16084,3,21,3090,12994,0,16084,18.1912,16.7381,424.845,16084,19,19,12775,12773,12702,12420,10734
46131,1,2,0,46131,46131,0,8.42554e+15,1.99983,283.391,46131,2,2,40736,40736,40736,40736,40736
13269,13,40,13269,0,0,13269,4.18549e+15,33.1556,601.79,13269,34,36,10763,6279,9248,4000,4818
18071,3,4,0,18071,18071,0,8.38166e+15,2.18411,194.024,18071,4,4,18052,18025,18046,18046,16109
46611,3,4,0,46611,46611,0,8.60468e+15,1.99979,290.424,46611,3,3,46607,46605,46606,46606,46607
6983,3,40,6983,0,6983,0,85926400000,19.4008,359.67,6983,27,24,4528,3834,3345,3717,1292
15908,2155,2837,15581,327,15581,327,2.08493e+18,172.696,4583.81,15908,676,187,13071,13071,12888,12904,9584
44208,1,2,44208,0,44208,0,3.38155e+13,1.99982,276.789,44208,2,2,38896,38896,38896,38896,38896
26894,30,40,0,26894,26894,0,2.19575e+13,31.1295,645.728,26894,37,37,26828,26747,26777,26761,23753
32041,1,2,0,32041,32041,0,8.40196e+15,1.99925,236.063,32041,2,2,28304,28304,28304,28304,28304
29280,58,60,0,29280,29280,0,2.00445e+13,34.082,842.467,29280,40,47,29220,29216,29220,29220,27864
46121,1,44,46121,0,0,46121,5.48413e+15,36.8309,896.469,46121,37,37,5607,5607,5607,5607,5607
34164,36,40,34164,0,0,34164,336175000,28.9069,716.327,34164,37,37,34118,34082,34076,29720,34080
19344,1,2,0,19344,19344,0,8.35904e+15,1.99979,184.224,19344,2,2,17099,17099,17099,17099,17099
11555,35,40,11555,0,0,11555,338338000,22.4725,439.638,11555,26,28,11515,11501,11514,11514,10691
9549,1,2,9549,0,9549,0,3.3191e+13,1.99843,128.111,9549,2,2,8422,8422,8422,8422,8422
40676,11,60,40676,0,0,40676,327473000,33.5657,902.873,40676,37,44,39183,37311,36136,36177,16250
8966,30,56,8966,0,0,8966,5.56458e+15,20.6033,457.727,8966,30,38,8910,8899,8873,8667,8341
16401,23,40,16401,0,0,16401,335999000,29.5281,479.291,16401,29,29,16346,16320,16328,16130,7803
2935,4,18,0,2935,2935,0,2.25986e+13,16.539,191.041,2935,17,18,2104,1590,1542,1831,975
13244,1,2,0,13244,13244,0,8.34615e+15,1.99841,151.912,13244,2,2,11709,11709,11709,11709,11709
741,2,14,741,0,741,0,1.46177e+18,13.2335,86.5563,741,12,13,423,423,288,109,194
29372,1,2,0,29372,29372,0,9.61193e+15,1.99949,226.857,29372,2,2,25453,25453,25453,25453,25453
25124,36,40,25124,0,0,25124,314664000,31.891,676.019,25124,36,35,25080,25059,25007,23330,24349
6054,9,24,6054,0,0,6054,340067000,17.5988,289.572,6054,19,21,5691,4810,4734,4901,3566
25616,1,19,4621,20995,0,25616,20.2349,16.2352,513.75,25616,19,19,3928,3928,3928,3928,3928
26822,4,40,0,26822,26822,0,1.90719e+13,35.6184,767.54,26822,37,37,19244,15728,15943,15259,5733
8284,15,36,8284,0,0,8284,333981000,16.9266,318.908,8284,25,25,8232,8158,8189,8178,7174
16401,13,40,16401,0,0,16401,5.58721e+15,30.9824,509.399,16401,29,36,16122,15473,15634,3981,11142
48937,1,4,0,48937,48937,0,1.32963e+16,2.00004,305.684,48937,3,3,39904,39904,39904,39904,39904
49929,2,23,8264,41665,0,49929,19.5017,19.5941,705.653,49929,21,21,34701,34701,34627,27549,27271
7002,1,2,0,7002,7002,0,8.32542e+15,1.99814,111.137,7002,2,2,6192,6192,6192,6192,6192
38869,17,40,38869,0,0,38869,340323000,22.5226,749.531,38869,32,29,38724,38203,38368,38367,32209
621,11,16,621,0,0,621,333275000,8.64895,75.5626,621,11,13,604,595,600,599,565
37754,14,21,7124,30630,0,37754,18.703,16.3139,663.614,37754,21,20,37626,37616,37458,37468,35432
9912,1,2,0,9912,9912,0,8.31657e+15,1.99788,131.205,9912,2,2,8767,8767,8767,8767,8767
45118,30,60,45118,0,45118,0,84239900000,32.1419,946.639,45118,37,44,45008,44802,44829,44780,31260
27402,27,56,27402,0,0,27402,339365000,21.6855,678.372,27402,32,32,27346,27322,27330,27329,26868
48118,1,2,48118,0,48118,0,3.2571e+13,1.99963,290.334,48118,2,2,42549,42549,42549,42549,42549
41097,1,4,0,41097,41097,0,8.33194e+15,3.89211,277.601,41097,4,4,36338,36338,36338,36338,36338
25710,13,21,0,25710,4149,21561,5107.73,16.9922,484.094,25710,20,21,25645,25645,25607,25619,25505
41845,20,56,41845,0,0,41845,336564000,28.6614,849.339,41845,38,40,41691,41505,41565,40676,31029
27980,2,4,0,27980,27980,0,8.75611e+15,2.00021,225.895,27980,3,3,27975,27974,27975,27975,25332
20285,17,28,0,20285,3407,16878,5088.5,13.1918,477.559,20285,19,25,20249,20249,20225,20225,19981
44167,1,2,44167,0,44167,0,3.65107e+13,1.99989,278.654,44167,2,2,38437,38437,38437,38437,38437
8990,1,2,8990,0,8990,0,3.6382e+13,1.99689,125.48,8990,2,2,7827,7827,7827,7827,7827
10521,1,2,10521,0,10521,0,4.78087e+13,1.99857,139.345,10521,2,2,8733,8733,8733,8733,8733
41652,2,44,0,41652,41652,0,1.78381e+13,39.4245,1048.56,41652,38,38,21065,20718,17872,16730,5154
12857,27,38,0,12857,0,12857,1329290,21.0889,472.217,12857,30,27,12819,12801,12810,12811,12819
41726,132,383,6809,34917,41707,19,2.0904e+16,30.7014,1413.48,41726,128,69,41343,41310,41288,41293,41245
29559,1,2,0,29559,29559,0,8.45901e+15,1.99942,226.179,29559,2,2,26088,26088,26088,26088,26088
40648,24,40,40648,0,0,40648,5.72116e+15,22.9312,791.496,40648,32,28,40607,40586,40590,39282,40604
18051,5,19,3203,14848,0,18051,20.3351,11.6944,417.757,18051,19,19,16577,16577,14777,14353,12212
504,1,16,504,0,504,0,1.48462e+18,11.1171,79.4082,504,12,15,49,49,49,49,49
22798,19,44,0,22798,22798,0,1.82433e+13,36.9091,780.861,22798,36,38,22197,20495,21007,20008,10709
28597,36,40,0,28597,0,28597,1328520,22.6239,642.453,28597,31,29,28557,28543,28557,28557,28557
47485,10,23,7939,39546,0,47485,19.4408,19.4361,694.788,47485,21,21,47115,47106,46932,47026,46098
10795,1,2,10795,0,10795,0,3.19153e+13,1.99805,138.602,10795,2,2,9570,9570,9570,9570,9570
7859,1,13,0,7859,1291,6568,5207.56,10.1196,248.425,7859,12,12,1330,1330,1330,1330,1330
44226,7,40,44226,0,44226,0,1.42547e+18,34.4803,831.695,44226,38,37,40145,35793,32976,5970,11853
12658,1,2,0,12658,12658,0,9.30179e+15,1.99818,149.951,12658,2,2,11023,11023,11023,11023,11023
21477,18,40,0,21477,21477,0,2.18776e+13,34.3262,587.977,21477,37,37,21342,21215,21270,21102,16234
45968,5,21,0,45968,7422,38546,5144.24,15.2516,636.765,45968,21,21,43336,43336,38936,38879,39133
1473,11,19,254,1219,0,1473,19.7909,7.24847,117.862,1473,14,18,1450,1450,1444,1448,1443
48231,33,40,48231,0,0,48231,5.61435e+15,32.8968,861.401,48231,39,37,48165,48055,48095,39548,43843
19647,1,2,0,19647,19647,0,1.29944e+16,1.99959,188.404,19647,2,2,16103,16103,16103,16103,16103
33323,24,40,33323,0,0,33323,5.66244e+15,27.5959,680.878,33323,31,29,33255,33200,33234,7720,28823
30194,13,21,0,30194,4845,25349,5168.12,14.541,497.861,30194,21,20,30151,30151,30147,30150,30143
4306,4,20,0,4306,4306,0,2.24029e+13,16.2996,226.136,4306,16,18,3168,2410,2301,2745,1327
19557,41,60,19557,0,0,19557,5.32392e+15,32.113,735.978,19557,34,47,19497,19487,19423,16847,14038
8760,11,19,0,8760,1325,7435,5016.66,13.3574,261.912,8760,19,18,8709,8709,8700,8708,8588
49575,5,30,0,49575,9299,40276,4889.55,15.7651,817.156,49575,21,26,45449,45449,41949,41794,28986
43725,14,20,0,43725,7890,35835,5151.38,16.106,706.05,43725,19,20,43624,43624,43580,43580,43539
3457,17,20,3457,0,0,3457,5.72818e+15,15.5013,200.591,3457,16,17,3435,3413,3433,3012,3331
16903,19,23,0,16903,3017,13886,4894.52,14.4335,438.501,16903,19,21,16878,16878,16816,16816,16551
21149,14,21,0,21149,3938,17211,4712.03,18.6101,480.625,21149,21,19,21044,21036,20945,20950,20454
16920,1,2,16920,0,16920,0,4.7711e+13,1.99947,177.688,16920,2,2,14051,14051,14051,14051,14051
5653,3,12,0,5653,1004,4649,5241.91,10.4635,220.848,5653,12,12,4299,4299,4268,3289,2722
48513,14,56,48513,0,48513,0,86479100000,34.267,909.615,48513,40,39,47965,47304,44107,45976,30191
26247,36,40,0,26247,0,26247,1181580,35.808,746.751,26247,39,36,26199,26170,26007,26007,23067
9506,37,40,9506,0,0,9506,5.66029e+15,17.6113,373.076,9506,25,29,9466,9456,9466,8608,9466
806,5,9,115,691,0,806,19.7667,6.05583,68.8815,806,7,8,773,773,698,696,759
48296,26,60,48296,0,48296,0,83670800000,39.1249,1067.3,48296,40,44,48151,47885,47918,47684,42168
27876,29,38,27876,0,27876,0,86941500000,31.1874,704.276,27876,32,30,27820,27754,27797,27795,27820
17291,14,24,17291,0,17291,0,1.46716e+18,21.8999,490.333,17291,22,22,17123,16927,14896,13539,12848
1858,7,16,0,1858,1858,0,2.18719e+13,13.2449,133.622,1858,14,14,1730,1577,1421,1530,1052
29323,30,40,29323,0,0,29323,287081000,36.1195,816.972,29323,38,37,29223,28918,28854,25637,25726
28514,19,23,7916,20598,0,28514,16.1762,19.5954,642.933,28514,22,21,28485,28485,28255,28255,27065
1117,16,18,0,1117,1117,0,2.24509e+13,12.5658,115.786,1117,15,15,1099,1089,1097,1097,1099
33580,12,25,8778,24802,0,33580,16.7905,18.3459,717.202,33580,22,23,33246,33216,32908,32960,23638
5975,3,36,0,5975,0,5975,932224,29.6239,385.417,5975,30,29,2666,2245,2250,1960,652
16020,10,20,2876,13144,0,16020,20.0801,13.4291,444.628,16020,19,20,15880,15880,15808,15808,12394
37510,23,56,37510,0,37510,0,85121700000,33.7229,925.205,37510,38,50,37280,36961,37063,37005,27091
41580,53,56,41580,0,0,41580,333445000,32.4942,961.294,41580,38,50,41524,41512,41521,41507,41491
35031,8,28,0,35031,5785,29246,5124.74,15.6063,598.622,35031,20,27,34701,34697,34181,34205,34117
34597,4,44,34597,0,34597,0,79770200000,31.955,864.133,34597,39,41,25296,20137,20035,20826,7288
41937,38,40,0,41937,41937,0,2.1727e+13,35.3385,813.562,41937,38,37,41894,41839,41871,41859,41893
40503,1,2,0,40503,40503,0,8.43634e+15,1.99985,265.402,40503,2,2,35760,35760,35760,35760,35760
37653,1,2,0,37653,37653,0,1.62437e+16,1.99979,269.982,37653,2,2,29164,29164,29164,29164,29164
18737,19,40,18737,0,18737,0,1.43235e+18,23.4261,538.449,18737,33,37,18632,18506,18554,9545,15128
561,7,9,78,483,0,561,19.4367,6.13012,58.1017,561,7,8,551,551,544,544,544
25605,35,54,0,25605,0,25605,7.20413e+14,35.1292,908.099,25605,43,45,25542,25492,25199,22794,12567
27888,1,2,0,27888,27888,0,9.67641e+15,1.99928,220.964,27888,2,2,24142,24142,24142,24142,24142
48587,1,2,0,48587,48587,0,1.19565e+16,1.99988,296.957,48587,2,2,40524,40524,40524,40524,40524
49094,1,4,0,49094,49094,0,8.37497e+15,1.99957,297.971,49094,3,3,43385,43385,43385,43385,43385
11175,13,21,0,11175,1792,9383,5163.8,9.64054,305.993,11175,17,20,11150,11150,11146,11148,11143
16822,13,21,0,16822,2745,14077,5069.9,20.6544,402.119,16822,20,21,16761,16761,16721,16733,16617
38391,41,60,38391,0,0,38391,5.44747e+15,24.6778,975.8,38391,36,44,38331,38322,38196,37405,32744
18734,1,2,18734,0,18734,0,3.9966e+13,1.99883,181.651,18734,2,2,16073,16073,16073,16073,16073
20818,32,40,0,20818,0,20818,1206050,31.7769,625.697,20818,35,34,20764,20699,20613,20616,19504
10688,7,21,0,10688,2594,8094,4341.84,14.8438,379.132,10688,19,20,9889,9889,9823,9882,8212
6270,22,36,6270,0,0,6270,5.38331e+15,31.3183,315.501,6270,32,29,6190,6106,6141,1426,4593
47419,9,56,47419,0,47419,0,1.46278e+18,22.6124,865.921,47419,39,32,44429,37161,36879,12313,22073
36787,40,48,36787,0,0,36787,5.15563e+15,36.7717,949.455,36787,37,41,36739,36720,36623,36620,36469
40216,9,44,40216,0,40216,0,1.33719e+18,41.5344,948.468,40216,40,41,36516,31358,32872,7414,12407
40001,18,40,40001,0,40001,0,1.45731e+18,36.2587,853.004,40001,34,33,39739,39427,38864,5607,30804
31476,26,40,31476,0,31476,0,76336200000,35.5183,815.238,31476,38,37,31271,30660,30832,30049,24749
31475,2,4,0,31475,31475,0,8.35845e+15,2.00013,240.337,31475,3,3,31470,31469,31470,31470,31402
9241,1,4,0,9241,9241,0,8.32004e+15,2,133.003,9241,3,3,8171,8171,8171,8171,8171
28541,6,40,0,28541,0,28541,1192330,34.7502,775.009,28541,40,36,24109,21779,19507,21023,7196
45549,38,40,45549,0,45549,0,86416500000,28.6187,831.692,45549,39,37,45505,45463,45483,45475,45487
22239,35,40,22239,0,0,22239,5.71238e+15,32.7852,619.879,22239,31,30,22195,22155,22191,22194,21287
27379,17,40,0,27379,27379,0,2.23689e+13,22.9693,664.333,27379,31,28,27219,26629,26539,26395,21507
31627,14,30,5622,26005,0,31627,19.3294,16.7217,694.023,31627,20,29,31485,31481,31350,31355,20732
25885,30,38,25885,0,0,25885,5.47631e+15,37.0334,791.017,25885,38,38,25703,25257,25205,25363,18095
34484,8,44,34484,0,34484,0,1.40884e+18,33.3925,791.652,34484,36,37,31658,27656,26994,6498,11455
32663,34,56,32663,0,32663,0,1.45974e+18,22.512,733.775,32663,37,32,32607,32587,32593,20706,31675
4676,2,36,4676,0,4676,0,1.41329e+18,27.5693,252.162,4676,24,25,2808,2801,2086,647,842
44733,36,44,44733,0,44733,0,84143100000,36.2128,879.463,44733,38,38,44681,44629,44531,44520,43547
47661,3,44,47661,0,0,47661,5.49402e+15,36.7658,909.017,47661,38,38,32473,27845,25531,6200,6969
34515,23,40,34515,0,34515,0,1.46547e+18,29.602,758.561,34515,31,31,34457,34404,34414,18595,33560
12921,18,40,12921,0,0,12921,339533000,19.2834,468.888,12921,29,25,12851,12781,12720,12691,10977
45248,32,48,0,45248,0,45248,1154310,35.9197,1083.97,45248,38,41,45160,45029,44658,44680,38425
32562,15,60,0,32562,32562,0,2.16016e+13,27.3757,839.742,32562,33,40,31972,30926,30815,30300,21313
33581,1,2,0,33581,33581,0,1.16538e+16,1.99976,245.075,33581,2,2,28149,28149,28149,28149,28149
20440,3,4,0,20440,20440,0,8.32681e+15,1.9998,194.488,20440,3,3,20436,20434,20435,20435,20436
7890,1,4,0,7890,7890,0,8.74007e+15,3.71128,137.057,7890,4,4,6904,6904,6904,6904,6904
13648,12,36,13648,0,0,13648,328415000,28.0243,442.566,13648,34,33,13376,13014,12854,12863,7527
42485,6,60,42485,0,42485,0,81805100000,29.3708,1029.87,42485,37,44,35438,31599,26849,29986,11674
37511,7,23,0,37511,6267,31244,4988.53,18.2626,620.249,37511,21,21,36683,36683,36124,36200,23173
5637,33,36,5637,0,5637,0,82568200000,19.25,295.383,5637,28,32,5601,5592,5577,5573,5574
6364,1,2,6364,0,6364,0,3.27296e+13,1.99764,106.01,6364,2,2,5623,5623,5623,5623,5623
49666,21,44,0,49666,0,49666,1274190,36.2546,929.134,49666,38,37,49312,48797,49007,49010,27393
1050,3,9,150,900,0,1050,19.7714,7.90667,79.5952,1050,8,9,867,867,865,844,747
7645,2,19,1571,6074,0,7645,17.3865,14.2857,288.91,7645,18,17,5332,5332,5331,4951,2176
15078,32,40,0,15078,0,15078,1308290,30.8786,485.796,15078,28,34,15034,15003,15017,15018,15005
42474,9,40,0,42474,0,42474,1334190,22.4648,810.068,42474,32,29,39585,32727,32521,33385,19197
28173,22,28,4749,23424,0,28173,20.2449,11.7643,522.718,28173,20,21,28145,28145,28145,28145,28136
16536,4,40,0,16536,16536,0,2.22644e+13,22.2276,517.882,16536,26,28,11961,9092,8710,10407,3302
29920,18,40,29920,0,0,29920,5.6187e+15,32.1181,683.772,29920,38,37,29771,29610,29661,5050,21574
17546,43,60,0,17546,17546,0,2.15177e+13,22.0899,658.694,17546,30,40,17486,17478,17482,17462,16224
20080,14,40,20080,0,20080,0,1.26874e+18,37.0495,674.388,20080,37,37,18902,16714,18211,4776,8610
38802,1,2,0,38802,38802,0,1.13875e+16,1.99905,263.328,38802,2,2,32669,32669,32669,32669,32669
2119,1,2,2119,0,2119,0,4.86172e+13,1.9967,61.3164,2119,2,2,1752,1752,1752,1752,1752
46798,10,60,46798,0,0,46798,328483000,37.0855,951.367,46798,38,44,44855,43125,39953,39961,15056
33278,4,20,0,33278,5908,27370,5190.25,17.1302,578.9,33278,20,19,29154,29154,26364,20754,20888
37510,1,2,37510,0,37510,0,3.3843e+13,1.99968,255.166,37510,2,2,32999,32999,32999,32999,32999
30076,2,4,0,30076,30076,0,8.18662e+15,3.59539,257.994,30076,4,4,29987,29958,29979,29981,27816
30690,32,44,30690,0,0,30690,5.5e+15,25.7318,732.355,30690,36,37,30632,30573,30508,19640,27896
3542,12,19,641,2901,0,3542,20.0305,10.4452,199.949,3542,19,17,3516,3516,3516,3516,3516
9236,1,2,9236,0,9236,0,3.98015e+13,1.99751,126.756,9236,2,2,7929,7929,7929,7929,7929
4309,23,38,4309,0,4309,0,1.44356e+18,20.1102,286.497,4309,28,27,4271,4251,4255,2856,4271
14644,1,13,0,14644,2417,12227,5207.34,11.7311,342.124,14644,13,13,2472,2472,2472,2472,2472
47077,31,40,0,47077,47077,0,2.22151e+13,26.7156,829.673,47077,34,29,47023,46961,47011,47001,38938
27882,59,60,27882,0,27882,0,83692900000,26.9663,785.925,27882,34,40,27822,27812,27821,27822,27682
7630,3,21,0,7630,1255,6375,5157.58,10.0866,261.646,7630,16,20,6029,6029,6004,5260,4124
13636,19,24,0,13636,13636,0,2.23553e+13,21.3451,433.063,13636,21,22,13603,13565,13554,13554,12535
4365,21,56,0,4365,0,4365,1227780,29.9624,376.409,4365,33,44,4220,3995,4075,4091,3521
1798,6,9,257,1541,0,1798,19.8509,7.75195,102.771,1798,9,9,1774,1774,1742,1742,1770
40850,1,2,40850,0,40850,0,3.27228e+13,1.99971,266.786,40850,2,2,36100,36100,36100,36100,36100
46607,1,28,0,46607,7885,38722,5182.16,17.6222,674.695,46607,28,21,7741,7741,7741,7741,7741
26282,27,40,26282,0,26282,0,87096900000,31.2509,672.907,26282,31,30,26230,26190,26210,26212,25107
9087,4,13,0,9087,1505,7582,5207.45,10.0979,270.253,9087,11,12,8167,8167,7439,7230,6828
11573,13,44,0,11573,11573,0,1.67915e+13,32.7439,576.854,11573,32,37,9699,6290,8597,7898,3653
32329,1,2,32329,0,32329,0,3.42256e+13,1.99985,236.636,32329,2,2,28397,28397,28397,28397,28397
11718,1,2,11718,0,11718,0,3.25241e+13,1.99872,143.561,11718,2,2,10363,10363,10363,10363,10363
9879,13,38,9879,0,0,9879,338282000,21.6294,420.894,9879,29,29,9560,8748,8417,8261,6284
37237,1,2,37237,0,37237,0,4.22851e+13,1.99946,258.628,37237,2,2,31642,31642,31642,31642,31642
15896,20,38,15896,0,0,15896,5.69495e+15,31.5132,534.911,15896,31,30,15816,15670,15737,13856,14754
46906,25,60,46906,0,46906,0,1.41603e+18,31.5902,960.833,46906,45,41,46722,46443,46480,14886,32440
24387,4,40,24387,0,24387,0,76252400000,33.7298,719.096,24387,37,37,17756,14420,14569,14252,4663
24774,7,13,4091,20683,0,24774,20.3533,11.5702,443.193,24774,13,13,24389,24389,23214,23563,23773
49729,1,44,49729,0,0,49729,330136000,30.5934,918.385,49729,37,38,5986,5986,5986,5986,5986
10823,16,24,0,10823,0,10823,1332370,17.6602,376.678,10823,19,21,10771,10661,10501,10498,9306
22022,23,325,2434,19588,237,21785,1.22969e+11,8.2374,841.286,22022,127,47,21669,21585,21545,21555,21533
35517,26,44,35517,0,0,35517,258705000,36.2851,987.721,35517,39,37,35306,34655,34745,30522,27717
28100,6,44,0,28100,28100,0,2.13681e+13,33.2067,708.331,28100,35,37,24568,22426,18903,21181,7591
39525,1,2,0,39525,39525,0,1.43167e+16,1.99987,271.603,39525,2,2,31671,31671,31671,31671,31671
47342,1,2,47342,0,47342,0,3.3533e+13,1.99939,287.273,47342,2,2,41701,41701,41701,41701,41701
37162,1,40,37162,0,37162,0,1.46067e+18,35.7441,866.344,37162,39,38,3611,3611,3611,3611,3611
47380,1,2,47380,0,47380,0,4.92373e+13,1.99941,294.613,47380,2,2,39091,39091,39091,39091,39091
18430,27,36,0,18430,0,18430,1277720,27.3716,525.152,18430,36,33,18352,18188,18293,18290,14439
25507,36,40,25507,0,25507,0,1.45772e+18,23.2599,608.377,25507,30,27,25467,25453,25467,21178,25467
17588,47,60,17588,0,17588,0,1.31018e+18,26.6215,731.061,17588,44,44,17528,17520,17522,13970,14206
31566,1,2,0,31566,31566,0,1.13316e+16,1.99927,237.927,31566,2,2,26601,26601,26601,26601,26601
1242,1,22,0,1242,0,1242,1326550,15.934,140.495,1242,17,19,116,116,116,116,116
21824,15,21,0,21824,3477,18347,5075.99,18.2533,447.077,21824,20,21,21775,21775,21756,21756,21657
2145,14,16,2145,0,2145,0,85506900000,13.4965,144.241,2145,14,14,2125,2107,2113,2117,2029
767,31,48,0,767,767,0,2.06141e+13,15.7549,167.028,767,22,36,719,719,715,715,520
36158,8,21,5841,30317,0,36158,20.0488,15.8982,568.365,36158,21,21,35892,35889,35446,35469,35582
38208,1,4,0,38208,38208,0,1.3028e+16,2.00008,272.025,38208,3,3,31297,31297,31297,31297,31297
22017,36,48,22017,0,22017,0,1.19693e+18,30.2884,802.41,22017,36,41,21969,21959,21685,17516,16342
18978,6,24,18978,0,18978,0,1.46146e+18,20.6797,499.135,18978,22,22,16522,14992,11696,3007,6243
34170,20,44,34170,0,34170,0,1.37197e+18,37.4411,805.01,34170,37,37,33802,33315,33514,5976,22891
39994,7,40,0,39994,0,39994,1312710,28.7331,773.788,39994,38,37,36183,32071,29169,30378,12130
47850,9,48,47850,0,47850,0,76463900000,38.5288,1106.64,47850,37,41,41582,34541,36733,35193,16113
28625,11,23,7777,20848,0,28625,16.4604,19.8916,646.115,28625,22,21,28220,28220,27964,28026,21387
9812,18,23,1831,7981,0,9812,19.4872,11.0772,347.068,9812,15,21,9789,9789,9766,9766,9530
24971,14,40,24971,0,0,24971,341742000,20.8081,633.346,24971,30,27,24637,24261,22184,22557,18331
14894,21,24,0,14894,0,14894,1333940,18.3792,442.214,14894,20,21,14869,14856,14847,14847,14869
23475,3,40,23475,0,0,23475,267729000,32.1523,775.015,23475,36,37,13675,11816,11485,10043,2857
16694,51,56,0,16694,0,16694,1302350,23.8214,621.025,16694,35,40,16638,16628,16638,16638,16638
25004,8,24,25004,0,25004,0,87180800000,20.9057,577.305,25004,23,22,23034,19690,18217,19880,11964
16413,4,19,2617,13796,0,16413,19.4675,15.0183,381.456,16413,19,19,15075,15075,13859,13817,14184
43245,22,44,0,43245,43245,0,2.15069e+13,38.1613,875.457,43245,38,38,42995,42605,42740,42184,26992
20029,46,56,20029,0,0,20029,338242000,21.7703,570.832,20029,29,29,19973,19961,19973,19971,19971
19748,14,38,0,19748,0,19748,1328520,29.2637,590.389,19748,31,30,19370,18962,17466,17384,14277
3265,8,22,3265,0,0,3265,343149000,16.6132,218.282,3265,19,19,2927,2411,2165,2304,1448
34746,188,351,34746,0,34746,0,7.1793e+17,16.2462,1133.6,34746,55,58,34395,34365,34347,34345,34330
34046,1,2,0,34046,34046,0,8.41088e+15,1.99979,243.478,34046,2,2,30071,30071,30071,30071,30071
7555,1,4,0,7555,7555,0,8.33598e+15,1.99854,119.759,7555,3,3,6678,6678,6678,6678,6678
36313,1,2,0,36313,36313,0,1.62379e+16,1.99961,263.852,36313,2,2,28129,28129,28129,28129,28129
3773,34,36,3773,0,3773,0,8.1519e+10,19.81,253.529,3773,27,32,3737,3729,3719,3717,3719
1507,1,18,1507,0,0,1507,346455000,14.6782,138.986,1507,15,17,148,148,148,148,148
25752,6,21,4112,21640,0,25752,19.9323,15.9035,476.159,25752,20,20,25140,25140,24532,24549,24550
14500,37,44,14500,0,14500,0,81157700000,27.6377,542.297,14500,33,37,14456,14444,14342,14358,12772
27517,29,40,27517,0,27517,0,77925300000,34.8569,762.457,27517,39,37,27408,27177,27092,26873,20627
20326,13,23,0,20326,4156,16170,4731.53,13.2477,520.514,20326,19,22,20237,20237,20085,20111,17895
5703,2,32,5703,0,0,5703,252150000,27.2183,364.293,5703,29,27,1900,1813,1611,917,248
22634,43,44,0,22634,0,22634,1063240,38.2374,774.949,22634,37,37,22590,22575,22589,22589,22590
38143,3,40,38143,0,0,38143,5.65297e+15,37.3484,879.526,38143,38,38,24067,20270,17293,4456,5028
16826,18,19,3052,13774,0,16826,20.2285,14.2621,416.832,16826,19,19,16804,16804,16804,16804,16804
17809,5,40,17809,0,17809,0,8.5253e+10,30.5257,629.521,17809,38,34,13442,9915,9495,11643,4800
27581,27,40,27581,0,0,27581,5.1007e+15,34.0569,757.571,27581,38,37,27439,26980,27097,12676,22976
23413,31,56,23413,0,0,23413,338247000,23.0422,616.969,23413,30,30,23357,23335,23349,23347,20381
39289,1,64,39289,0,39289,0,74028800000,32.8346,1101.88,39289,37,44,3537,3537,3537,3537,3537
15201,1,4,0,15201,15201,0,1.04571e+16,1.99934,171.564,15201,3,3,12992,12992,12992,12992,12992
15475,1,38,0,15475,0,15475,1328590,20.7116,515.788,15475,30,29,1482,1482,1482,1482,1482
36842,1,2,0,36842,36842,0,1.44166e+16,1.99967,262.653,36842,2,2,29470,29470,29470,29470,29470
36662,13,44,36662,0,36662,0,80153400000,34.0774,883.516,36662,37,41,35085,32329,33856,32744,18020
3293,7,22,0,3293,0,3293,1337630,17.1667,217.377,3293,18,19,2881,2473,2096,2120,1649
24922,11,64,24922,0,0,24922,5.0047e+15,26.7814,923.137,24922,33,44,21748,17957,18509,13265,10195
17935,1,2,0,17935,17935,0,8.35683e+15,1.99916,177.031,17935,2,2,15854,15854,15854,15854,15854
41022,12,23,7723,33299,0,41022,18.6838,19.0768,699.38,41022,21,22,40738,40722,40502,40567,38497
16951,18,40,0,16951,16951,0,2.23063e+13,23.215,536.841,16951,31,24,16865,16781,16633,16620,14860
28420,14,23,5564,22856,0,28420,18.6241,18.1095,599.037,28420,20,22,28321,28314,28194,28211,25757
6077,27,38,6077,0,0,6077,5.53779e+15,27.7546,389.737,6077,32,33,5999,5879,5889,5904,5112
1307,16,18,1307,0,1307,0,1.49055e+18,12.8439,127.16,1307,15,16,1289,1279,1282,1239,1289
6938,1,2,6938,0,6938,0,6.38978e+13,1.99726,117.135,6938,2,2,5362,5362,5362,5362,5362
22233,12,40,22233,0,22233,0,1.45891e+18,21.1139,559.833,22233,29,29,21792,20840,19381,5519,13345
12035,5,13,0,12035,2071,9964,5226.95,11.7553,319.749,12035,13,12,11163,11163,9926,9722,4712
41815,16,44,0,41815,41815,0,2.11259e+13,35.6277,872.373,41815,37,37,41117,39661,40605,39652,23346
37345,35,40,37345,0,0,37345,5.71075e+15,28.2578,795.541,37345,31,30,37301,37261,37297,37300,36121
16756,19,38,0,16756,16756,0,2.18422e+13,27.8181,603.793,16756,36,36,16524,16190,16213,16267,12751
18045,14,44,18045,0,0,18045,291675000,34.616,649.685,18045,37,36,16921,14806,16258,16225,6832
15085,5,21,0,15085,2433,12652,5095.56,10.5914,372.586,15085,17,20,14233,14233,12935,12925,13044
7999,10,20,0,7999,0,7999,1319180,17.0519,300.197,7999,19,19,7808,7621,6903,6889,5064
36327,1,2,0,36327,36327,0,8.39849e+15,1.99975,251.321,36327,2,2,32092,32092,32092,32092,32092
29942,5,65,0,29942,29941,1,7.34923e+14,26.6016,1049.19,29942,36,48,19432,14259,14488,15632,5817
14923,18,21,2344,12579,0,14923,20.0981,10.3479,347.752,14923,18,20,14901,14901,14899,14899,14896
47056,2186,2566,47056,0,3382,43674,3.81114e+17,76.6758,4710.45,47056,422,177,44490,44490,44482,44479,14965
728,12,14,0,728,0,728,1316120,9.75549,80.7167,728,11,11,714,706,706,705,714
22773,10,40,0,22773,0,22773,1330320,21.5431,607.714,22773,30,28,21719,20803,18220,18313,12012
46216,39,60,0,46216,0,46216,1299470,37.6924,965.049,46216,40,40,46155,46113,46025,46031,45197
4327,6,36,4327,0,4327,0,65503500000,25.8502,327.741,4327,30,33,3028,2505,2517,2279,987
39827,3,4,0,39827,39827,0,8.29005e+15,3.8624,284.416,39827,4,4,39803,39769,39796,39796,38369
7693,1,4,0,7693,7693,0,8.49555e+15,2.00039,121.24,7693,3,3,6783,6783,6783,6783,6783
28305,20,48,28305,0,0,28305,291571000,28.1089,885.037,28305,36,41,27848,26677,26798,21154,16979
12888,11,19,0,12888,2506,10382,4967.45,17.7526,408.224,12888,19,19,12674,12668,12626,12625,12084
37391,12,48,37391,0,0,37391,5.03371e+15,33.0185,981.336,37391,37,41,34283,29829,31404,8080,16060
43232,53,56,43232,0,0,43232,5.65455e+15,28.5447,866.927,43232,37,40,43176,43163,43173,43176,43143
49481,23,40,49481,0,49481,0,87360700000,30.0353,895.454,49481,32,31,49421,49364,49381,49392,46325
30523,14,23,0,30523,8208,22315,4206.71,18.9024,662.795,30523,22,21,30376,30360,30058,30080,23944
2597,6,18,0,2597,2597,0,2.26456e+13,15.5784,180.533,2597,16,18,2195,1953,1553,1912,1245
20881,39,40,20881,0,20881,0,1.4659e+18,22.1602,583.797,20881,25,29,20841,20829,20841,20598,20841
47228,15,44,47228,0,0,47228,5.52995e+15,31.2983,897.639,47228,37,38,46616,45508,46077,13900,26271
48173,34,40,48173,0,0,48173,337888000,28.5793,865.658,48173,40,37,48119,48055,48070,38931,48067
45497,16,25,10199,35298,0,45497,17.8927,20.516,806.007,45497,22,23,45408,45401,45120,45126,41144
21700,8,20,0,21700,3710,17990,5200.36,10.8744,451.046,21700,19,17,21508,21507,20678,20676,21132
36734,12,40,0,36734,36734,0,1.8315e+13,34.3504,949.169,36734,38,37,32635,27070,30164,28493,15577
27148,33,38,0,27148,27148,0,2.22488e+13,31.5229,696.212,27148,32,30,27100,27034,27090,27090,27100
19391,31,40,19391,0,19391,0,1.43258e+18,23.8174,547.487,19391,33,37,19340,19279,19297,17274,17848
3973,9,22,3973,0,3973,0,85985800000,20.5958,255.11,3973,21,22,3602,2868,2717,2903,1974
6420,14,20,0,6420,0,6420,1332320,16.6308,274.601,6420,19,18,6378,6334,6210,6209,5612
27996,43,44,27996,0,0,27996,5.26803e+15,34.6166,783.045,27996,37,41,27952,27935,27919,27665,27780
23211,3,4,0,23211,23211,0,8.28891e+15,3.48533,222.901,23211,4,4,23184,23145,23176,23176,22585
21544,174,831,1415,20129,20900,644,2.25732e+16,73.0522,3097.41,21544,191,86,20713,20625,17589,16779,9923
17373,1,40,17373,0,17373,0,87074100000,21.7923,543.304,17373,27,29,1736,1736,1736,1736,1736
14959,21,44,14959,0,14959,0,82844400000,21.8507,545.204,14959,32,37,14838,14653,14725,14443,12603
34594,17,44,0,34594,0,34594,1226450,38.0418,843.401,34594,38,37,33894,31607,33387,33309,16989
24735,8,24,0,24735,24735,0,2.24022e+13,21.6361,594.534,24735,24,22,22476,18815,17094,18988,10551
7960,1,2,0,7960,7960,0,1.07181e+16,1.99636,117.886,7960,2,2,6775,6775,6775,6775,6775
31879,10,21,0,31879,9984,21895,3975.42,17.0508,682.823,31879,21,19,31074,31009,30036,30140,20556
9846,14,19,0,9846,1594,8252,4855.63,14.6058,297.914,9846,18,18,9796,9794,9770,9773,9685
30264,4,21,6990,23274,0,30264,17.1129,18.8011,622.413,30264,21,20,25530,25530,24188,24245,9491
42580,3,56,0,42580,0,42580,1318590,23.6755,857.965,42580,33,40,28084,23823,21329,13694,7107
41478,3,4,0,41478,41478,0,8.38049e+15,1.99971,274.654,41478,3,3,41474,41472,41473,41473,41474
41951,37,44,41951,0,0,41951,5.50172e+15,36.8024,855.272,41951,38,37,41902,41849,41758,37174,41307
46547,18,44,46547,0,46547,0,1.33969e+18,37.7375,989.261,46547,38,41,45760,44498,45014,10365,26350
42061,9,40,42061,0,0,42061,5.72766e+15,22.2501,803.012,42061,32,28,39267,32568,32389,12535,18537
15585,1,2,15585,0,15585,0,5.26648e+13,1.99917,168.187,15585,2,2,12668,12668,12668,12668,12668
40677,36,44,40677,0,40677,0,1.38109e+18,35.803,860.636,40677,37,37,40627,40587,40442,34745,37796
47382,1,2,0,47382,47382,0,9.17943e+15,1.99985,286.777,47382,2,2,41345,41345,41345,41345,41345
48395,7,40,48395,0,48395,0,1.45655e+18,26.601,845.457,48395,34,29,43321,37957,33650,5927,14696
11297,39,40,0,11297,0,11297,950235,30.3251,541.717,11297,33,33,11257,11240,11242,11243,11255
41796,9,30,8124,33672,0,41796,19.0337,15.7612,769.246,41796,21,26,41188,41188,40767,40865,37769
8617,1,40,8617,0,0,8617,308162000,29.2313,405.027,8617,31,33,1043,1043,1043,1043,1043
44346,1,2,44346,0,44346,0,3.38054e+13,1.99966,277.294,44346,2,2,39019,39019,39019,39019,39019
9359,1,2,9359,0,9359,0,5.01656e+13,1.99722,129.73,9359,2,2,7690,7690,7690,7690,7690
24928,2,4,0,24928,24928,0,9.76454e+15,1.99956,215.218,24928,3,3,24923,24922,24923,24923,23309
30350,1,2,30350,0,30350,0,3.84883e+13,1.99898,230.748,30350,2,2,26199,26199,26199,26199,26199
7314,18,56,0,7314,7314,0,2.16691e+13,21.7179,422.713,7314,30,38,7204,7097,7074,6988,5411
32292,3,20,5581,26711,0,32292,20.3619,12.0013,544.224,32292,20,19,24875,24875,24643,17188,13927
14964,28,60,14964,0,14964,0,82768500000,22.6566,618.083,14964,31,40,14890,14832,14800,14784,12661
15168,9,24,15168,0,15168,0,87405800000,18.6057,446.201,15168,21,21,14300,12061,12254,12027,7808
37560,5,23,0,37560,6310,31250,4994.56,18.0703,622.418,37560,21,21,35230,35230,32388,32399,22369
45207,32,44,45207,0,0,45207,5.13558e+15,37.4317,1014.18,45207,41,41,45115,44978,44719,37303,37158
32243,1,2,32243,0,32243,0,3.25098e+13,1.99978,238.645,32243,2,2,28518,28518,28518,28518,28518
42528,1,4,42528,0,42528,0,4.38547e+13,1.99965,282.876,42528,3,3,36409,36409,36409,36409,36409
11267,18,19,0,11267,1766,9501,4953.86,16.3041,311.1,11267,19,19,11245,11243,11236,11236,11245
40740,14,28,0,40740,6866,33874,5192.24,12.1629,618.536,40740,21,21,40700,40700,40700,40700,40641
23858,11,23,0,23858,4073,19785,4954.24,14.654,502.242,23858,20,21,23707,23707,23635,23668,22963
36893,1,2,0,36893,36893,0,1.30529e+16,1.99967,259.332,36893,2,2,30209,30209,30209,30209,30209
25548,17,40,25548,0,25548,0,1.382e+18,29.608,661.606,25548,37,35,25181,24301,24947,3955,15280
46359,3,40,0,46359,0,46359,1139650,34.6283,1040.59,46359,40,37,29621,25619,24353,20811,7817
34114,1,2,34114,0,34114,0,4.00834e+13,1.99968,244.81,34114,2,2,29255,29255,29255,29255,29255
10414,1,2,10414,0,10414,0,3.27045e+13,1.99779,134.986,10414,2,2,9203,9203,9203,9203,9203
37790,17,23,6975,30815,0,37790,18.681,19.486,657.858,37790,22,21,37741,37741,37609,37613,37407
21363,1,2,0,21363,21363,0,1.00887e+16,1.9992,193.69,21363,2,2,18371,18371,18371,18371,18371
31809,2,4,0,31809,31809,0,8.33185e+15,3.0371,245.898,31809,4,4,31798,31795,31798,31798,29901
1235,4,20,1235,0,0,1235,5.67782e+15,12.7352,121.221,1235,15,17,921,709,675,249,335
8052,1,4,0,8052,8052,0,9.51282e+15,2.00075,125.621,8052,3,3,6986,6986,6986,6986,6986
13712,16,24,13712,0,0,13712,343023000,20.2679,440.753,13712,21,21,13622,13386,13110,13107,11222
13058,8,40,0,13058,0,13058,1335050,21.3412,463.137,13058,23,28,11777,9772,8985,9359,5040
26464,18,40,0,26464,26464,0,2.23783e+13,21.8088,647.964,26464,32,25,26375,26272,26084,26046,22280
39271,41,56,0,39271,0,39271,1315220,28.3949,831.024,39271,37,40,39215,39203,39195,39201,32344
26367,6,40,26367,0,0,26367,337962000,27.8423,607.682,26367,30,29,23129,21081,16816,18145,9861
42942,20,44,42942,0,0,42942,285784000,37.4947,1030.58,42942,39,39,42109,40261,40564,22614,18979
20334,1,24,0,20334,0,20334,1334450,21.5678,526.759,20334,22,22,2224,2224,2224,2224,2224
18901,41,64,0,18901,0,18901,1233630,23.107,792.986,18901,30,44,18837,18831,18783,18782,15143
30002,19,40,30002,0,0,30002,340110000,22.9842,661.773,30002,32,27,29935,29831,29852,29837,25370
17181,3,40,17181,0,17181,0,7.578e+10,30.3705,594.681,17181,35,33,11474,9973,9471,8318,2716
26159,11,40,26159,0,0,26159,334446000,32.0871,637.375,26159,37,37,25461,24483,23328,23300,11430
40003,12,40,40003,0,40003,0,86064700000,28.7625,774.127,40003,38,37,39228,37715,35707,37138,21341
29365,34,40,29365,0,0,29365,333033000,30.2478,658.866,29365,36,37,29317,29238,29269,25796,27308
2128,8,9,325,1803,0,2128,20.2387,7.33553,113.435,2128,9,8,2118,2118,2118,2118,2118
21586,19,23,0,21586,5885,15701,4216.49,16.1879,561.623,21586,21,21,21561,21561,21404,21404,20422
31597,1,2,31597,0,31597,0,3.26221e+13,1.99908,235.443,31597,2,2,27934,27934,27934,27934,27934
44442,14,56,0,44442,44442,0,2.20695e+13,28.5788,874.971,44442,38,40,43927,43316,41062,42095,26250
867,13,16,867,0,867,0,85522900000,12.0704,90.5471,867,12,11,850,835,848,844,759
20825,23,40,20825,0,20825,0,1.46777e+18,20.7722,583.037,20825,28,29,20785,20763,20767,14149,20362
9866,24,36,9866,0,9866,0,8.2354e+10,30.7398,397.802,9866,32,33,9784,9679,9727,9618,6617
11983,1,2,11983,0,11983,0,3.31672e+13,1.9985,143.925,11983,2,2,10570,10570,10570,10570,10570
40975,4,5,40975,0,40975,0,6.44902e+13,1.99978,285.81,40975,3,4,40970,40969,40970,40970,40970
47056,29,56,0,47056,0,47056,1316060,32.002,985.191,47056,38,44,46925,46668,46765,46769,30996
2127,8,11,339,1788,0,2127,20.3366,7.60978,120.587,2127,9,10,2113,2113,2106,2106,2113
12630,1,2,0,12630,12630,0,8.47804e+15,1.99778,148.006,12630,2,2,11143,11143,11143,11143,11143
3399,8,12,620,2779,0,3399,19.9565,10.637,178.517,3399,12,12,3333,3333,3205,3204,3167
22642,1,2,22642,0,22642,0,6.04049e+13,1.99898,207.184,22642,2,2,17782,17782,17782,17782,17782
6290,8,36,6290,0,0,6290,285314000,28.4831,350.665,6290,31,29,5494,4945,5002,5011,1879
19614,15,44,19614,0,0,19614,5.44593e+15,33.3071,646.144,19614,36,41,19184,18117,18799,4458,12764
13893,35,40,13893,0,13893,0,1.45024e+18,22.2496,443.588,13893,29,21,13853,13841,13851,11079,11583
22344,5,21,0,22344,3641,18703,5103.27,17.7431,457.038,22344,20,21,21035,21035,19113,19090,18985
12150,6,13,0,12150,2017,10133,5222.99,10.2492,306.98,12150,12,12,11830,11830,11490,11490,11448
33790,37,48,33790,0,0,33790,297585000,32.2479,942.845,33790,37,41,33742,33715,33495,31566,31324
5286,1,2,5286,0,5286,0,6.39522e+13,1.99773,99.508,5286,2,2,4084,4084,4084,4084,4084
39147,13,40,39147,0,0,39147,340821000,22.7598,774.637,39147,32,28,38463,36271,34227,34508,22855
20285,1,2,20285,0,20285,0,3.80342e+13,1.99916,188.519,20285,2,2,17543,17543,17543,17543,17543
25262,14,32,0,25262,7017,18245,4214.4,19.9464,726.138,25262,22,30,25108,25098,24830,24849,16778
42625,1,2,0,42625,42625,0,1.09409e+16,1.99904,275.331,42625,2,2,36152,36152,36152,36152,36152
36022,3,4,0,36022,36022,0,8.66163e+15,1.99978,255.46,36022,3,3,36018,36016,36017,36017,36018
15099,26,40,0,15099,0,15099,1101160,34.58,597.39,15099,33,37,14978,14648,14695,14701,11432
38319,11,38,38319,0,0,38319,336716000,33.3012,881.419,38319,38,37,36187,33663,30600,30415,19458
32461,37,56,32461,0,0,32461,5.65926e+15,24.7411,772.588,32461,32,40,32405,32391,32355,31438,30705
35600,6,40,35600,0,0,35600,5.71179e+15,33.4826,771.702,35600,32,31,29943,26562,21335,5846,11587
7033,18,22,7033,0,0,7033,341966000,20.393,329.141,7033,21,22,6991,6951,6904,6902,6729
19749,37,40,0,19749,0,19749,1155240,37.3133,663.58,19749,36,37,19705,19671,19590,19590,19704
5041,9,19,0,5041,1627,3414,3837.61,15.1551,263.1,5041,18,18,4844,4844,4708,4739,3182
45955,1,2,0,45955,45955,0,8.60991e+15,1.99967,282.309,45955,2,2,40463,40463,40463,40463,40463
42813,1,2,0,42813,42813,0,1.20475e+16,1.99907,279.593,42813,2,2,35654,35654,35654,35654,35654
44145,48,64,0,44145,0,44145,1216180,34.9657,1261.83,44145,38,56,44081,44073,44077,43920,38994
3963,9,24,3963,0,0,3963,341556000,15.8012,238.285,3963,19,21,3693,3069,3148,3195,2337
43500,39,40,43500,0,0,43500,340882000,31.1237,842.184,43500,32,31,43459,43418,43458,43458,42818
1994,2,36,0,1994,0,1994,1304670,15.1143,173.711,1994,15,25,1143,1141,807,418,428
47694,13,48,47694,0,47694,0,1.31161e+18,38.1046,1054.5,47694,40,41,45000,40389,43140,8647,18625
12758,2,4,0,12758,12758,0,1.56281e+16,2.00063,162.263,12758,3,3,12753,12752,12753,12753,10295
6814,20,22,6814,0,6814,0,87881100000,19.7815,314.998,6814,20,20,6789,6764,6772,6771,6784
12568,8,40,12568,0,0,12568,5.70493e+15,20.6486,464.193,12568,29,26,11296,9342,8566,4051,5270
5782,17,36,0,5782,0,5782,1251100,27.8423,300.037,5782,28,31,5682,5546,5638,5635,4594
14704,4,38,14704,0,0,14704,335572000,33.0227,528.395,14704,32,31,10129,7632,7348,4110,3202
36187,35,38,36187,0,0,36187,5.67259e+15,32.6615,819.954,36187,35,33,36134,35989,36121,36130,36134
35123,1,2,35123,0,35123,0,5.98163e+13,1.9998,257.662,35123,2,2,27658,27658,27658,27658,27658
15069,24,32,4671,10398,0,15069,15.9968,16.2417,549.076,15069,20,25,15037,15037,14936,14936,11323
1098,13,32,0,1098,0,1098,1167950,13.255,141.966,1098,19,26,1027,957,1001,999,881
41829,14,23,0,41829,6953,34876,5002.44,19.393,650.002,41829,21,21,41713,41708,41600,41606,41141
46957,12,44,46957,0,46957,0,8.4325e+10,36.4941,907.716,46957,38,38,45703,43701,42484,42949,22079
13147,1,2,13147,0,13147,0,3.25858e+13,1.99924,152.028,13147,2,2,11624,11624,11624,11624,11624
34487,6,40,34487,0,0,34487,5.71912e+15,29.5489,758.342,34487,32,29,28911,25593,20539,4730,12110
45710,31,40,0,45710,0,45710,1320310,35.8705,920.822,45710,36,34,45627,45462,45580,45580,43602
11598,1,2,0,11598,11598,0,1.7682e+16,1.99853,150.757,11598,2,2,8751,8751,8751,8751,8751
18477,12,56,18477,0,0,18477,5.6983e+15,22.5321,578.041,18477,31,32,17883,16724,15438,11014,11273
16368,1,2,0,16368,16368,0,8.97198e+15,1.99866,168.564,16368,2,2,14329,14329,14329,14329,14329
22934,237,351,22934,0,22934,0,1.47979e+18,34.3836,1145.95,22934,55,58,22583,22567,22553,22555,22538
12925,9,60,0,12925,0,12925,1300400,21.0222,566.637,12925,30,40,11687,9375,9222,9579,6530
49741,319,2834,0,49741,0,49741,7.22289e+16,85.9033,5283.41,49741,709,212,46884,46121,43920,12217,6440
20418,10,21,0,20418,3324,17094,5035.74,17.4508,440.628,20418,20,20,20284,20282,20224,20258,19897
33643,15,40,0,33643,33643,0,2.22861e+13,33.8604,767.021,33643,32,31,33171,32409,31451,30643,21999
46465,4,20,8392,38073,0,46465,20.092,18.3433,729.021,46465,20,20,40415,40415,36104,26903,27909
15106,2,40,15106,0,15106,0,1.44953e+18,22.592,467.2,15106,29,29,8628,8622,6005,1830,2698
20147,14,30,3756,16391,0,20147,19.6524,13.1249,523.064,20147,20,23,20096,20093,20033,20037,19433
1942,30,38,1942,0,1942,0,1.46609e+18,14.1524,175.303,1942,15,29,1904,1904,1904,1904,1883
24397,8,19,0,24397,4426,19971,5148.5,17.8161,510.972,24397,19,19,23995,23991,22733,22727,14383
47220,11,32,0,47220,10009,37211,4821.06,13.5028,867.154,47220,20,25,46967,46967,46782,46813,40968
25019,26,40,25019,0,0,25019,5.45768e+15,26.8515,655.368,25019,36,35,24915,24707,24775,7297,20078
19132,37,40,19132,0,19132,0,8.7284e+10,20.9834,564.453,19132,29,28,19092,19078,19091,19091,18338
20346,28,40,0,20346,0,20346,1302620,22.9555,556.001,20346,33,37,20286,20233,20237,20235,17314
7131,11,19,0,7131,1170,5961,4968.36,15.7031,256.829,7131,18,19,7070,7070,7038,7054,6947
26569,3,4,0,26569,26569,0,8.33426e+15,1.99989,221.149,26569,3,3,26565,26563,26564,26564,26565
16522,23,24,16522,0,0,16522,5.74249e+15,20.19,477.177,16522,22,21,16497,16483,16496,15778,16496
10095,11,20,10095,0,10095,0,1.46102e+18,17.774,351.773,10095,20,19,9851,9481,8829,7604,6059
20405,1,2,20405,0,20405,0,3.28859e+13,1.99941,188.158,20405,2,2,18020,18020,18020,18020,18020
6219,21,24,0,6219,0,6219,1331500,18.9793,291.712,6219,20,21,6195,6183,6190,6190,6194
22046,19,20,3896,18150,0,22046,20.2996,11.8449,462.246,22046,19,19,22026,22026,22026,22026,22025
23038,32,38,0,23038,23038,0,2.20607e+13,31.6783,662.503,23038,34,32,22976,22858,22950,22955,22976
21627,19,40,21627,0,0,21627,5.41684e+15,28.3327,613.362,21627,36,35,21398,21038,21259,4719,14683
33202,4,44,33202,0,33202,0,1.33798e+18,35.7538,854.04,33202,37,41,24143,19196,19074,4578,6157
15019,30,40,0,15019,15019,0,2.21159e+13,22.4635,460.916,15019,29,23,14979,14963,14978,14963,13967
1961,9,19,333,1628,0,1961,20.4651,8.98317,138.409,1961,13,16,1936,1936,1920,1919,426
49885,28,38,49885,0,49885,0,85716100000,36.1038,1028.85,49885,38,38,49685,49235,49382,49343,43488
4529,1,2,0,4529,4529,0,1.62126e+16,1.99735,94.504,4529,2,2,3509,3509,3509,3509,3509
24790,1,4,0,24790,24790,0,8.33066e+15,3.24849,216.301,24790,4,4,21919,21919,21919,21919,21919
40921,1,2,40921,0,40921,0,3.96614e+13,1.99924,271.977,40921,2,2,35154,35154,35154,35154,35154
44262,19,44,44262,0,44262,0,78782400000,37.8913,995.865,44262,40,41,43568,42067,42692,41382,24885
32271,2,38,32271,0,0,32271,5.64768e+15,34.1392,786.681,32271,36,34,16823,16823,10600,3320,4693
24937,10,13,4249,20688,0,24937,20.3863,11.8794,458.649,24937,13,13,24897,24897,24835,24834,24889
36714,25,56,36714,0,0,36714,336844000,25.6144,864.767,36714,36,41,36576,36354,36417,36420,28321
44323,16,19,0,44323,8343,35980,5065.27,18.0997,744.766,44323,19,19,44211,44211,44079,44079,44043
23454,19,24,23454,0,23454,0,87419300000,20.9913,561.124,23454,23,22,23414,23352,23358,23349,22083
43385,31,44,43385,0,43385,0,1.19966e+18,35.9897,1038.79,43385,39,39,43279,42852,42713,28759,36790
44741,43,56,44741,0,44741,0,87134600000,22.53,852.817,44741,32,32,44685,44673,44685,44685,44683
46992,4,21,7582,39410,0,46992,20.1016,15.1058,642.482,46992,21,21,42718,42718,38972,38262,37741
24946,1,2,24946,0,24946,0,3.26879e+13,1.99956,208.778,24946,2,2,22048,22048,22048,22048,22048
39295,47,56,0,39295,39295,0,2.18188e+13,33.0766,938.927,39295,38,50,39239,39227,39230,39239,37428
49807,1,4,0,49807,49807,0,8.58204e+15,1.99952,299.947,49807,3,3,43872,43872,43872,43872,43872
18067,29,40,18067,0,0,18067,341097000,21.1517,548.561,18067,30,27,18027,18009,18020,18021,17481
35027,1,2,35027,0,35027,0,4.40611e+13,1.99989,250.291,35027,2,2,29543,29543,29543,29543,29543
35768,1,21,5965,29803,0,35768,20.3071,12.1556,556.015,35768,21,20,6028,6028,6028,6028,6028
15447,4,20,2702,12745,0,15447,20.3032,11.337,388.027,15447,19,18,13617,13617,12338,10522,9555
38770,47,54,38764,6,38764,6,2.23432e+12,33.846,1067.85,38770,42,45,38716,38701,38711,38467,34802
9569,6,40,9569,0,0,9569,337242000,17.7143,374.222,9569,25,29,8371,7620,6147,6537,3372
35427,7,40,35427,0,35427,0,87076300000,21.9761,705.311,35427,31,29,31753,27833,24572,27220,13995
20772,1,2,20772,0,20772,0,3.94325e+13,1.99899,190.667,20772,2,2,17861,17861,17861,17861,17861
20219,12,38,20219,0,0,20219,338462000,34.911,609.946,20219,32,31,19409,17917,16615,16450,11496
10499,22,24,10499,0,0,10499,340581000,19.1575,371.788,10499,20,21,10475,10463,10453,10452,10475
32866,13,40,32866,0,0,32866,341744000,22.1233,718.537,32866,32,27,32204,30103,28651,28752,21918
18992,31,40,18992,0,18992,0,79057100000,30.0717,596.281,18992,34,34,18936,18762,18828,18802,17288
32795,33,40,32795,0,0,32795,332960000,29.8164,707.837,32795,37,37,32740,32655,32672,29894,30756
34992,10,40,0,34992,34992,0,2.04752e+13,29.6863,853.632,34992,40,35,32622,30485,29535,28909,11693
41862,14,25,9083,32779,0,41862,18.0583,19.8629,765.326,41862,22,23,41703,41691,41494,41508,39139
32813,18,40,32813,0,0,32813,336326000,29.0601,710.003,32813,37,37,32670,32519,32580,31691,24834
25256,26,44,25256,0,25256,0,1.20745e+18,37.7696,813.67,25256,37,39,25088,24644,24751,15891,19645
20441,1,2,0,20441,20441,0,8.35461e+15,1.99956,189.447,20441,2,2,18070,18070,18070,18070,18070
18897,23,40,18897,0,18897,0,1.26414e+18,33.7837,650.314,18897,37,37,18677,18070,18354,8922,11013
6762,3,4,0,6762,6762,0,8.55697e+15,2.00044,113.246,6762,3,3,6758,6756,6757,6757,6758
4556,18,36,0,4556,4556,0,1.67881e+13,28.8558,319.694,4556,30,29,4350,3951,4149,3789,2835
19181,33,40,19181,0,0,19181,4.63133e+15,34.3454,680.593,19181,36,37,19127,19049,18914,17614,17865
49254,37,48,0,49254,0,49254,1179470,35.7012,1093.6,49254,38,41,49202,49154,48886,48887,47467
36686,27,40,36686,0,0,36686,340712000,22.1808,724.844,36686,32,29,36646,36625,36639,36638,36644
34862,1,2,34862,0,34862,0,3.78992e+13,1.99945,246.702,34862,2,2,30167,30167,30167,30167,30167
13322,31,60,13322,0,13322,0,79254100000,33.1382,650.961,13322,33,47,13231,13052,12997,12973,9452
28539,14,38,28539,0,0,28539,5.62903e+15,37.0691,775.202,28539,36,38,27742,26957,24667,22494,14190
23232,1,2,23232,0,23232,0,4.32535e+13,1.9994,202.616,23232,2,2,19661,19661,19661,19661,19661
9353,22,38,0,9353,0,9353,1301390,32.5242,427.099,9353,32,30,9281,9225,9233,9237,9129
22598,11,378,22579,19,22579,19,5.01302e+16,14.617,989.862,22598,151,54,20910,19771,19377,19580,16662
8044,1,2,8044,0,8044,0,3.68465e+13,1.99814,118.693,8044,2,2,6990,6990,6990,6990,6990
17656,9,24,17656,0,0,17656,342401000,20.2642,492.659,17656,23,21,16542,13774,13726,14164,9298
28417,1,2,0,28417,28417,0,8.7736e+15,1.99947,222.076,28417,2,2,24956,24956,24956,24956,24956
9555,8,19,0,9555,2019,7536,4879.19,16.5532,357.666,9555,19,19,8995,8944,8775,8776,8158
33045,51,60,33045,0,33045,0,84255500000,27.6029,842.615,33045,34,40,32985,32974,32981,32985,30741
31821,47,56,31821,0,31821,0,1.45929e+18,22.7468,726.232,31821,37,32,31765,31752,31762,29092,31763
37998,25,40,0,37998,37998,0,2.19501e+13,32.815,748.254,37998,37,37,37898,37784,37825,37704,31890
19044,19,36,19044,0,19044,0,85011700000,25.5708,523.638,19044,36,33,18931,18796,18864,18693,13733
30012,16,40,30012,0,0,30012,292093000,33.8577,817.815,30012,38,37,28734,24747,27577,27525,15658
13185,1,4,0,13185,13185,0,8.34524e+15,2.00053,157.668,13185,3,3,11655,11655,11655,11655,11655
19612,19,44,0,19612,0,19612,1206640,24.7905,683.706,19612,36,41,19320,18643,18912,18914,13238
33147,2,4,0,33147,33147,0,8.38465e+15,1.99988,245.861,33147,3,3,33142,33141,33142,33142,30797
48319,18,23,8057,40262,0,48319,19.4485,19.2509,699.18,48319,21,21,48277,48273,48186,48188,48011
37411,30,40,37411,0,37411,0,1.46628e+18,29.0746,787.523,37411,32,31,37361,37321,37342,32989,37361
48723,15,44,0,48723,0,48723,1280250,36.2566,916.501,48723,38,38,48016,46803,47459,47423,27059
23498,8,38,23498,0,23498,0,1.4627e+18,28.3845,640.614,23498,31,30,20858,16957,15288,5573,9844
27020,1,2,0,27020,27020,0,8.79519e+15,1.99896,216.55,27020,2,2,23721,23721,23721,23721,23721
14678,3,24,14678,0,14678,0,1.45749e+18,18.5061,430.841,14678,21,21,9842,8359,7523,1867,3150
27506,16,40,0,27506,27506,0,2.19655e+13,29.0017,643.076,27506,36,37,27313,27009,27077,26873,19281
38019,31,44,38019,0,38019,0,1.2092e+18,38.429,980.466,38019,38,39,37919,37558,37428,23116,32652
48566,2,4,0,48566,48566,0,1.33296e+16,2.028,315.111,48566,4,4,48537,48528,48533,48534,48492
29919,1,2,0,29919,29919,0,9.86972e+15,1.99903,228.712,29919,2,2,25820,25820,25820,25820,25820
31397,1,4,0,31397,31397,0,8.31725e+15,3.49078,242.205,31397,4,4,27768,27768,27768,27768,27768
19814,27,30,0,19814,4201,15613,4893.43,18.5647,611.531,19814,19,30,19784,19784,19784,19784,19341
6557,6,36,6557,0,0,6557,5.59121e+15,17.6177,289.078,6557,24,25,5871,5422,4432,1123,2942
32712,1,2,32712,0,32712,0,3.39797e+13,1.99954,238.707,32712,2,2,28762,28762,28762,28762,28762
36806,42,64,0,36806,0,36806,1238610,35.3879,1144.39,36806,38,56,36742,36736,36639,36638,32075
45467,1,2,45467,0,45467,0,3.74169e+13,1.99967,281.687,45467,2,2,39422,39422,39422,39422,39422
18119,22,44,0,18119,18119,0,2.07681e+13,33.3157,654.567,18119,32,41,17990,17759,17879,17609,15427
30388,32,44,30388,0,30388,0,70262900000,33.8618,879.069,30388,38,37,30318,30232,29922,29862,26700
26878,20,32,0,26878,6108,20770,4806.45,13.2443,686.548,26878,20,24,26846,26846,26773,26773,22551
36465,34,48,36465,0,0,36465,5.21332e+15,37.7229,925.752,36465,38,41,36400,36276,36175,31249,33852
2480,23,36,2480,0,0,2480,4.61256e+15,20.6367,231.876,2480,26,29,2424,2313,2356,1857,1883
45393,22,56,0,45393,45393,0,2.22595e+13,35.2043,877.156,45393,40,32,45312,45243,45232,45244,41005
42311,15,20,0,42311,7488,34823,5200.2,15.9615,645.44,42311,20,19,42270,42270,42270,42270,42270
44004,35,56,44004,0,0,44004,5.69083e+15,35.7223,861.767,44004,40,32,43942,43900,43930,36001,39018
29499,1,2,0,29499,29499,0,8.7498e+15,1.99929,226.189,29499,2,2,25916,25916,25916,25916,25916
36609,36,38,0,36609,36609,0,2.2035e+13,36.5561,867.615,36609,38,38,36555,36351,36503,36503,33988
32096,1,2,32096,0,32096,0,3.32901e+13,1.99944,238.619,32096,2,2,28299,28299,28299,28299,28299
20533,15,21,3237,17296,0,20533,20.1486,10.3782,402.832,20533,19,20,20508,20508,20507,20507,20503
16314,21,24,0,16314,16314,0,2.2355e+13,19.0329,462.771,16314,21,21,16289,16276,16267,16273,16289
13460,24,40,0,13460,13460,0,2.16903e+13,25.0127,466.945,13460,33,37,13384,13317,13323,13196,10080
24575,29,38,24575,0,0,24575,335288000,31.9906,698.832,24575,37,33,24482,24299,24407,24407,24474
29802,18,19,0,29802,5347,24455,5188.93,15.5916,550.021,29802,19,19,29778,29778,29778,29778,29778
36038,5,19,0,36038,6611,29427,5126.22,17.2304,647.263,36038,19,19,32669,32667,29003,27107,21397
10850,11,40,0,10850,10850,0,2.0199e+13,28.607,448.046,10850,33,33,10259,9627,9870,9439,5927
22588,1,2,22588,0,22588,0,3.21999e+13,1.99907,200.244,22588,2,2,20003,20003,20003,20003,20003
14266,12,24,14266,0,0,14266,5.74173e+15,21.4443,459.392,14266,22,22,13843,12956,11965,8376,8728
24440,12,21,3906,20534,0,24440,20.1324,15.4724,451.983,24440,21,20,24393,24393,24376,24383,24386
2116,1,2,0,2116,2116,0,8.44531e+15,1.99386,60.7911,2116,2,2,1867,1867,1867,1867,1867
46417,3,44,46417,0,46417,0,1.40204e+18,36.9639,904.758,46417,37,37,31600,27104,24880,5977,6857
26976,28,38,26976,0,0,26976,335514000,33.7325,752.753,26976,38,36,26862,26656,26720,26720,25425
731,16,22,0,731,0,731,1316820,14.8659,109.63,731,16,16,707,689,684,683,598
33413,36,44,33413,0,33413,0,83479200000,35.976,782.257,33413,37,38,33363,33326,33206,33209,29034
47898,49,60,47898,0,0,47898,332655000,25.6034,971.829,47898,34,40,47838,47827,47834,47547,45755
12637,3,28,0,12637,2072,10565,5126.08,10.6169,363.035,12637,19,21,9975,9975,9844,8852,5445
36138,1,56,0,36138,36138,0,2.21504e+13,22.5605,801.447,36138,32,39,3966,3966,3966,3966,3966
1917,5,22,1917,0,0,1917,5.57253e+15,18.4095,174.119,1917,18,21,1436,1058,1061,749,578
45392,20,40,45392,0,45392,0,1.46472e+18,31.5025,857.659,45392,32,32,45284,45062,45096,21891,40272
3646,10,22,3646,0,0,3646,5.75827e+15,16.3527,228.697,3646,18,19,3464,3308,2961,2708,2434
42650,52,60,0,42650,42650,0,2.18007e+13,24.7437,930.027,42650,33,40,42590,42579,42586,42590,40820
29199,8,13,4931,24268,0,29199,20.364,11.8649,494.545,29199,13,13,28987,28987,27912,27911,28771
15548,17,24,15548,0,15548,0,1.47167e+18,19.6309,464.586,15548,21,21,15484,15237,15326,13109,13939
5926,8,13,986,4940,0,5926,20.3307,9.18934,220.479,5926,11,12,5883,5883,5823,5822,5846
8844,1,2,8844,0,8844,0,3.26223e+13,1.99729,124.455,8844,2,2,7818,7818,7818,7818,7818
33356,3,56,0,33356,33356,0,2.22684e+13,22.1461,737.055,33356,30,32,21776,18420,16396,17952,5874
14081,12,40,0,14081,14081,0,2.22976e+13,20.5404,490.664,14081,30,24,13609,12687,11801,11944,8955
9923,34,44,9923,0,9923,0,81091500000,21.9282,468.157,9923,30,37,9879,9869,9791,9812,8833
21879,40,64,21879,0,21879,0,1.19425e+18,30.6301,868.804,21879,43,44,21815,21807,21618,16571,11539
12529,25,40,0,12529,0,12529,1330870,21.1669,459.463,12529,26,27,12489,12469,12478,12478,11865
2670,5,16,2670,0,2670,0,1.45238e+18,13.9491,166.757,2670,16,14,2205,1668,1722,659,1094
19388,11,44,19388,0,0,19388,5.17828e+15,25.0154,681.33,19388,35,41,17943,16240,16263,9953,9879
21953,10,60,0,21953,0,21953,1247010,31.0518,808.683,21953,36,49,20394,19172,17365,17174,7783
25164,1,2,25164,0,25164,0,4.821e+13,1.99909,213.2,25164,2,2,20853,20853,20853,20853,20853
16857,15,36,0,16857,16857,0,2.17719e+13,23.1967,489.603,16857,35,33,16704,16477,16574,16419,11173
14782,5,40,14782,0,14782,0,85210200000,32.5845,489.968,14782,29,36,12025,9152,9483,10468,4242
1121,10,11,0,1121,189,932,5242.4,7.37021,91.3581,1121,9,10,1110,1110,1109,1109,1109
37069,38,40,0,37069,37069,0,2.22827e+13,22.0655,753.771,37069,32,24,37029,37017,37028,37028,37029
33820,7,21,5438,28382,0,33820,20.0069,16.3372,550.982,33820,21,21,33292,33292,32223,32533,22441
25328,27,60,0,25328,0,25328,1209960,30.0682,850.845,25328,36,44,25208,24903,24935,24907,17236
46881,2,44,0,46881,46881,0,2.15999e+13,31.292,894.402,46881,37,38,27214,27152,19733,21849,7535
32065,32,40,0,32065,32065,0,2.2357e+13,21.8157,717.637,32065,30,29,32025,32009,32021,32016,30269
40327,7,21,0,40327,6554,33773,5140.97,15.8226,602.806,40327,21,21,39677,39677,38358,38698,38672
3455,1,11,0,3455,557,2898,5213.95,8.93169,155.411,3455,10,10,595,595,595,595,595
6159,1,2,0,6159,6159,0,8.34179e+15,1.99773,103.189,6159,2,2,5445,5445,5445,5445,5445
43142,4,44,43142,0,43142,0,82381900000,35.9302,880.322,43142,38,37,32520,25765,25536,27170,8741
26100,4,40,26100,0,26100,0,1.4497e+18,28.0805,605.217,26100,29,29,19469,15008,14569,3226,7263
10434,18,40,10434,0,0,10434,5.15687e+15,28.6226,440.939,10434,32,33,10210,9912,10075,2785,7064
32005,4,21,0,32005,5236,26769,5190.04,12.1673,517.158,32005,21,20,28925,28925,26347,25683,24780
26961,5,21,4391,22570,0,26961,20.259,11.9667,473.412,26961,21,20,25360,25360,22615,22562,22563
7187,1,2,0,7187,7187,0,1.20915e+16,1.99722,113.455,7187,2,2,5980,5980,5980,5980,5980
46045,45,56,46045,0,0,46045,5.69381e+15,35.2419,879.258,46045,40,32,45989,45961,45985,45978,45987
749,11,14,749,0,0,749,340293000,11.749,85.3144,749,12,12,730,715,709,708,720
8887,10,40,8887,0,8887,0,7.8594e+10,30.077,409.114,8887,31,33,8315,7827,7758,7591,4638
19049,1,2,19049,0,19049,0,3.26558e+13,1.99937,182.471,19049,2,2,16838,16838,16838,16838,16838
13094,6,56,0,13094,13094,0,2.21646e+13,20.9195,525.926,13094,30,37,10801,9476,7725,9245,4349
7365,22,44,7365,0,7365,0,73011500000,28.4129,474.362,7365,32,41,7250,7042,7148,6883,3983
26446,15,19,4865,21581,0,26446,20.0313,18.1107,559.601,26446,19,19,26383,26383,26335,26335,26311
38445,1,2,0,38445,38445,0,9.58519e+15,1.99904,259.255,38445,2,2,33330,33330,33330,33330,33330
48973,1,4,0,48973,48973,0,8.33092e+15,3.04296,302.759,48973,4,4,43304,43304,43304,43304,43304
27158,4,5,1,27157,27158,0,1.46779e+16,1.99952,235.835,27158,4,3,27153,27151,27152,27152,27153
28125,17,21,4444,23681,0,28125,20.0724,15.574,483.358,28125,21,20,28092,28092,28089,28092,27964
6230,21,22,6230,0,0,6230,5.73938e+15,20.2475,308.556,6230,21,21,6205,6166,6204,5968,6200
32804,5,40,0,32804,0,32804,1329020,34.0891,740.111,32804,32,31,25627,18983,18977,16223,9150
7857,1,2,7857,0,7857,0,6.09737e+13,1.99733,121.913,7857,2,2,6154,6154,6154,6154,6154
47764,28,56,47764,0,0,47764,5.65663e+15,28.6126,906.095,47764,37,40,47674,47593,47610,34740,41724
11181,15,56,11181,0,11181,0,1.42007e+18,21.2292,500.143,11181,38,39,10953,10627,10493,6358,7988
46170,10,28,7623,38547,0,46170,20.0904,15.0314,676.992,46170,21,27,46012,46011,45918,45938,45714
28729,6,56,28729,0,28729,0,1.44573e+18,24.3572,731.55,28729,40,40,24611,22116,17910,3791,8453
42446,1,20,0,42446,7100,35346,5198.26,12.2296,612.944,42446,20,19,7080,7080,7080,7080,7080
5955,15,36,0,5955,5955,0,1.63212e+13,30.1548,385.526,5955,32,30,5316,3487,4814,4416,2887
18120,42,44,0,18120,0,18120,1256090,30.5854,597.718,18120,33,37,18076,18065,18005,18005,16737
44154,24,40,44154,0,44154,0,75135200000,34.7304,1003.36,44154,40,37,43786,43089,43134,41780,34092
14030,1,2,0,14030,14030,0,1.17203e+16,1.99922,157.886,14030,2,2,11747,11747,11747,11747,11747
23617,38,40,0,23617,23617,0,2.23122e+13,22.362,619.571,23617,32,22,23577,23577,23577,23577,23577
26507,45,65,26506,1,0,26507,1.38642e+15,36.8904,1075.6,26507,37,57,26442,26434,26249,20154,15372
5895,3,20,5895,0,0,5895,5.65414e+15,17.1299,257.291,5895,18,19,4044,3452,3127,822,1608
22204,16,40,0,22204,22204,0,2.19373e+13,30.2939,559.402,22204,31,29,22070,21898,21897,21729,16528
30204,48,56,0,30204,30204,0,2.19122e+13,32.0695,721.985,30204,38,37,30148,30136,30139,30148,29223
20403,1,2,20403,0,20403,0,3.49309e+13,1.99941,188.033,20403,2,2,17870,17870,17870,17870,17870
45354,7,23,7732,37622,0,45354,19.2997,18.1951,686.458,45354,21,21,44239,44239,43674,43786,42453
47798,5,30,0,47798,9230,38568,4796.87,20.378,813.117,47798,22,28,43597,43597,40676,40566,17356
47027,33,40,0,47027,0,47027,1306480,33.1008,851.537,47027,39,37,46961,46851,46891,46887,42776
22473,18,24,22473,0,0,22473,341738000,22.2655,570.441,22473,24,22,22415,22339,22118,22116,19524
3891,1,2,0,3891,3891,0,1.44634e+16,1.99897,87.7516,3891,2,2,3109,3109,3109,3109,3109
6229,5,12,0,6229,1090,5139,5235.4,10.8486,230.507,6229,12,12,5747,5747,5124,5081,4568
33435,26,40,33435,0,33435,0,86195800000,34.3561,828.721,33435,38,37,33299,33095,33144,33113,27430
11750,1,2,11750,0,11750,0,3.18606e+13,1.99906,144.567,11750,2,2,10419,10419,10419,10419,10419
42766,1,2,0,42766,42766,0,8.38757e+15,1.99958,272.835,42766,2,2,37787,37787,37787,37787,37787
1836,3,18,1836,0,1836,0,1.48213e+18,12.9428,146.638,1836,15,16,1191,1001,893,434,497
33751,18,48,33751,0,0,33751,285406000,33.9899,971.769,33751,36,41,32817,30752,31192,25311,16911
5526,17,38,5526,0,0,5526,339309000,20.5541,318.665,5526,24,26,5466,5343,5330,5226,4439
4305,1,2,0,4305,4305,0,1.45956e+16,1.99443,88.8348,4305,2,2,3432,3432,3432,3432,3432
43346,19,33,0,43346,12956,30390,1.66233e+12,18.6884,968.741,43346,22,32,43306,43306,43012,34629,25585
36000,1,2,36000,0,36000,0,3.22445e+13,1.99978,252.734,36000,2,2,31875,31875,31875,31875,31875
15205,4,13,2651,12554,0,15205,20.3349,11.8207,367.839,15205,13,12,13421,13421,12207,11345,9708
21464,1,4,0,21464,21464,0,8.21156e+15,3.60674,215.308,21464,4,4,18985,18985,18985,18985,18985
30558,29,40,30558,0,30558,0,87491500000,22.4633,698.311,30558,31,28,30518,30498,30509,30508,30518
46901,17,40,46901,0,0,46901,5.62969e+15,32.4463,833.371,46901,38,37,46661,46159,46472,6458,28750
23348,35,64,23348,0,0,23348,4.65251e+15,33.3733,956.402,23348,36,52,23272,23170,22933,16706,9565
10354,1,2,0,10354,10354,0,8.30952e+15,1.99691,133.769,10354,2,2,9159,9159,9159,9159,9159
19925,11,24,19925,0,0,19925,340674000,20.5716,511.26,19925,22,22,19417,18657,17052,17100,13258
33134,8,20,0,33134,5888,27246,5187.13,17.2979,578.6,33134,20,19,32710,32707,31076,31072,31660
5603,1,2,5603,0,5603,0,3.22016e+13,1.99857,98.0968,5603,2,2,4961,4961,4961,4961,4961
31516,1,2,31516,0,31516,0,3.28131e+13,1.99902,234.194,31516,2,2,27841,27841,27841,27841,27841
8935,32,36,8935,0,8935,0,85457100000,16.6973,329.768,8935,25,25,8899,8886,8899,8891,8899
47055,31,56,47055,0,0,47055,338062000,34.7518,898.789,47055,40,39,46988,46922,46930,46749,46488
7501,2,64,0,7501,7501,0,1.94333e+13,23.8568,542.567,7501,29,44,3329,3282,2373,2869,731
34957,27,44,34957,0,0,34957,312260000,35.1356,869.422,34957,38,41,34809,34352,34370,23136,29225
18373,32,36,18373,0,0,18373,333492000,22.9699,516.79,18373,36,33,18329,18295,18297,15750,18297
20512,28,56,20512,0,20512,0,1.45983e+18,22.1335,603.819,20512,29,32,20456,20438,20438,18990,20255
37924,1,31,0,37924,9854,28070,1.89999e+12,19.3329,801.244,37924,26,24,7924,7924,7924,7924,7924
5192,1,2,0,5192,5192,0,8.35491e+15,1.99441,95.2843,5192,2,2,4589,4589,4589,4589,4589
43715,13,40,43715,0,43715,0,86302200000,28.0986,807.728,43715,38,37,43098,41261,40927,41361,25220
5932,20,24,0,5932,0,5932,1337190,17.5039,286.406,5932,19,21,5908,5896,5900,5899,5694
36866,5,40,36866,0,0,36866,5.57816e+15,30.2291,751.031,36866,37,37,30241,23081,24023,4724,8994
29992,6,60,29992,0,0,29992,5.19802e+15,35.3338,1010.76,29992,38,54,23998,20941,18081,7707,6838
6949,5,19,2339,4610,0,6949,14.6726,15.9505,308.502,6949,18,18,5368,5368,5327,5363,3159
30666,2,28,5232,25434,0,30666,20.1289,12.5074,570.886,30666,20,23,20388,20388,20076,12460,12428
48585,8,40,0,48585,0,48585,1324800,26.5821,848.068,48585,34,29,44681,38242,35866,37934,17449
34486,1,2,34486,0,34486,0,5.83094e+13,1.99939,253.99,34486,2,2,27341,27341,27341,27341,27341
33200,28,40,0,33200,33200,0,2.22931e+13,21.7989,680.423,33200,30,29,33160,33141,33154,33145,33158
25889,20,40,0,25889,0,25889,1268100,28.5536,661.388,25889,37,35,25675,25405,25527,25529,19277
30318,17,40,30318,0,30318,0,87330200000,22.5296,691.138,30318,31,28,30162,29598,29567,29475,24083
49063,39,40,49063,0,49063,0,1.44633e+18,31.655,858.334,49063,38,37,49021,48963,49011,45915,48988
1571,13,22,1571,0,1571,0,1.46904e+18,16.2164,155.993,1571,18,19,1514,1381,1423,1296,1257
3773,20,24,3773,0,3773,0,1.46262e+18,17.0413,224.498,3773,18,17,3749,3741,3743,3101,3291
16930,23,40,16930,0,0,16930,337669000,19.0986,479.682,16930,25,29,16890,16870,16881,16879,16238
34877,31,60,0,34877,34877,0,2.03447e+13,32.5903,977.791,34877,40,49,34764,34463,34474,34446,17471
31707,50,60,31707,0,31707,0,83989400000,26.4573,821.614,31707,36,40,31647,31637,31643,31647,29147
35149,33,40,35149,0,35149,0,87306500000,29.2155,764.373,35149,32,29,35102,35063,35095,35096,35102
30645,1,2,30645,0,30645,0,3.25701e+13,1.99918,232.177,30645,2,2,27098,27098,27098,27098,27098
28823,22,40,0,28823,28823,0,2.19741e+13,31.6125,781.331,28823,38,35,28633,28401,28422,28405,23331
31390,3,21,5134,26256,0,31390,20.2872,11.8919,509.478,31390,21,20,24778,24778,24706,21795,16987
25002,4,44,25002,0,25002,0,83407100000,27.0439,676.582,25002,36,37,18643,14643,14426,15687,6944
17931,27,60,0,17931,17931,0,2.07496e+13,32.615,793.125,17931,38,54,17790,17562,17564,17568,15364
31789,1,2,0,31789,31789,0,9.61327e+15,1.99975,235.457,31789,2,2,27547,27547,27547,27547,27547
12540,29,36,12540,0,12540,0,1.09999e+18,32.4215,551.668,12540,34,33,12476,12354,12296,11597,11716
21517,17,21,5472,16045,0,21517,16.5027,18.3385,535.011,21517,20,20,21478,21478,21316,21319,21414
33036,1,2,0,33036,33036,0,1.14054e+16,1.99967,243.282,33036,2,2,27806,27806,27806,27806,27806
9063,29,38,9063,0,9063,0,84921200000,28.5174,466.155,9063,35,33,8986,8831,8867,8843,7641
41192,3,4,0,41192,41192,0,8.56113e+15,2.83713,289.387,41192,4,4,41165,41126,41157,41157,40566
33068,1,65,33068,0,0,33068,6.09146e+15,26.516,1050.33,33068,33,48,2854,2854,2854,2854,2854
13295,1,38,13295,0,0,13295,5.64297e+15,34.2305,504.029,13295,32,31,1243,1243,1243,1243,1243
21576,23,40,0,21576,21576,0,2.15469e+13,34.7544,601.847,21576,36,34,21450,21252,21341,21152,11465
23914,1,4,0,23914,23914,0,8.33752e+15,1.99992,209.97,23914,3,3,21144,21144,21144,21144,21144
16658,21,40,0,16658,16658,0,2.07454e+13,29.9317,539.658,16658,34,34,16472,16186,16315,15851,12060
19435,25,40,0,19435,0,19435,1302740,36.2457,565.834,19435,36,37,19348,19263,19281,19279,15243
48355,20,44,0,48355,0,48355,1011150,36.8288,1142.37,48355,40,37,47175,43657,43845,43887,28615
34014,10,44,0,34014,34014,0,2.03888e+13,32.1569,855.801,34014,40,41,31623,29486,28640,28150,10940
3192,1,2,3192,0,3192,0,3.43907e+13,1.99812,74.7825,3192,2,2,2801,2801,2801,2801,2801
3929,23,38,3929,0,3929,0,86515900000,18.4709,273.895,3929,24,25,3891,3873,3879,3882,3891
32344,48,56,32344,0,32344,0,8.5714e+10,31.1187,747.766,32344,38,39,32288,32276,32279,32288,31265
14537,1,2,0,14537,14537,0,9.05615e+15,1.99938,158.668,14537,2,2,12709,12709,12709,12709,12709
47521,9,44,0,47521,47521,0,2.14404e+13,36.3598,905.93,47521,38,37,44808,39243,40503,39403,16579
1326,22,32,1326,0,1326,0,75728800000,25.0015,154.357,1326,20,26,1284,1238,1263,1194,1247
996,7,17,0,996,347,649,3635.41,11.1376,112.16,996,14,15,853,853,845,853,631
13258,1,2,0,13258,13258,0,8.35364e+15,1.99917,152.079,13258,2,2,11720,11720,11720,11720,11720
6851,33,56,0,6851,6851,0,2.19562e+13,19.2626,380.527,6851,29,32,6795,6785,6794,6793,6625
9610,1,2,0,9610,9610,0,8.36798e+15,1.99761,129.752,9610,2,2,8493,8493,8493,8493,8493
4747,15,19,721,4026,0,4747,19.8719,8.59406,189.356,4747,17,18,4726,4726,4725,4725,4721
815,14,18,815,0,815,0,87269500000,12.3411,101.094,815,14,15,797,789,789,791,796
29422,1,2,29422,0,29422,0,3.25655e+13,1.99976,227.102,29422,2,2,26017,26017,26017,26017,26017
41771,15,44,0,41771,0,41771,1283100,30.4439,844.276,41771,37,37,41189,40148,40709,40684,23316
14855,18,36,14855,0,0,14855,332106000,24.4606,468.66,14855,36,33,14746,14637,14684,13798,10592
32142,7,30,0,32142,6316,25826,4906.42,14.1663,686.741,32142,20,24,30852,30852,29371,29436,19718
37546,8,56,37546,0,0,37546,5.70663e+15,22.1636,778.539,37546,31,32,34251,28924,26738,8338,14625
43773,43,44,43773,0,0,43773,4.39909e+15,35.9149,1075.38,43773,39,37,43729,43706,43661,43149,43729
39012,47,56,39012,0,39012,0,1.46123e+18,21.9683,790.16,39012,37,32,38956,38943,38953,35243,38954
979,25,36,979,0,979,0,1.36902e+18,11.3892,128.818,979,19,25,943,935,939,552,941
7939,2,21,1485,6454,0,7939,18.3121,14.5088,295.613,7939,18,19,5533,5533,5531,4889,4722
30071,5,38,0,30071,0,30071,1321570,32.6883,740.792,30071,33,32,22831,16809,16823,11480,8321
48278,25,44,48278,0,0,48278,267397000,38.2933,1127.95,48278,39,39,47901,46939,46854,31240,34866
30940,36,60,30940,0,0,30940,310154000,31.8289,914.627,30940,37,44,30872,30841,30620,28009,19645
28458,1,40,28458,0,28458,0,85759300000,30.6071,660.298,28458,37,37,3410,3410,3410,3410,3410
17915,1,40,0,17915,0,17915,1303640,23.7017,529.414,17915,33,37,2154,2154,2154,2154,2154
11400,17,36,11400,0,11400,0,86616700000,18.3772,385.959,11400,28,25,11350,11275,11321,11289,9817
10450,35,40,10450,0,10450,0,1.45108e+18,18.674,390.307,10450,25,29,10410,10398,10410,9231,10410
37285,19,56,37285,0,0,37285,339556000,22.0926,775.335,37285,32,32,37184,37016,37031,37037,33614
30995,1,4,0,30995,30995,0,8.18334e+15,3.97567,263.306,30995,4,4,27409,27409,27409,27409,27409
46662,2,4,0,46662,46662,0,1.27493e+16,2.00002,299.069,46662,3,3,46657,46656,46657,46657,40383
9620,6,49,0,9620,9616,4,2.24656e+15,28.6214,550.844,9620,33,41,6679,5507,4936,5212,1985
38971,4,40,38971,0,38971,0,78933700000,33.6898,894.339,38971,40,37,28634,22942,22892,23408,6997
19650,8,40,0,19650,0,19650,1324830,21.2301,527.722,19650,29,29,18145,15613,14770,15545,8304
11184,11,21,1791,9393,0,11184,20.1416,9.95538,305.879,11184,19,20,11154,11154,11150,11153,11110
31555,22,56,0,31555,31555,0,2.19494e+13,30.7067,758.426,31555,37,40,31433,31317,31364,31257,25511
43958,20,40,0,43958,0,43958,1316620,28.0213,808.539,43958,38,37,43834,43720,43721,43716,34512
17714,18,38,0,17714,17714,0,2.1192e+13,35.5523,666.22,17714,38,38,16983,16067,16114,16129,8800
16101,24,40,16101,0,16101,0,87060300000,23.5939,522.441,16101,31,24,16061,16045,16051,16055,16061
16398,17,40,16398,0,0,16398,5.67434e+15,19.4393,475.284,16398,26,29,16330,16185,16278,8065,13874
31025,30,40,31025,0,31025,0,1.46726e+18,21.3826,698.575,31025,30,29,30985,30969,30976,27500,29675
23141,1,2,23141,0,23141,0,3.32063e+13,1.99931,200.296,23141,2,2,20410,20410,20410,20410,20410
2122,2,10,0,2122,366,1756,5286,8.45712,124.774,2122,10,10,1384,1384,1380,842,842
45346,18,44,0,45346,45346,0,2.07559e+13,33.9553,958.054,45346,40,41,44732,43727,44088,43075,30474
22514,3,13,0,22514,3830,18684,5212.78,12.177,437.507,22514,13,13,17464,17464,17367,12198,10515
688,16,22,0,688,0,688,1269950,15.3227,101.269,688,16,17,662,640,638,637,623
37243,1,21,0,37243,6035,31208,5136.74,15.7691,577.181,37243,21,21,6734,6734,6734,6734,6734
20779,17,56,20763,16,20763,16,1.21487e+13,33.7826,767.387,20779,47,37,19076,9114,16503,9345,10423
43405,18,28,0,43405,7105,36300,5138.43,15.584,651.867,43405,21,27,43365,43364,43343,43343,43025
16116,22,44,16116,0,16116,0,82979500000,26.8508,568.503,16116,32,37,15994,15798,15854,15564,13433
16252,6,21,2573,13679,0,16252,20.077,15.7618,366.799,16252,20,20,15898,15898,15500,15506,15536
9051,29,40,0,9051,9051,0,2.21569e+13,17.629,365.729,9051,22,29,9011,9000,9006,9002,9009
19971,11,21,3234,16737,0,19971,20.2229,11.6722,408.139,19971,20,20,19937,19937,19921,19925,19883
10559,1,2,10559,0,10559,0,5.33414e+13,1.99811,142.046,10559,2,2,8557,8557,8557,8557,8557
8477,26,40,8477,0,8477,0,1.45373e+18,15.9589,355.439,8477,24,29,8437,8425,8431,5761,8435
30142,19,24,30142,0,0,30142,341148000,21.5667,664.98,30142,24,22,30081,29958,29985,29985,27138
1476,1,18,0,1476,1476,0,2.27024e+13,15.6856,140.516,1476,16,18,140,140,140,140,140
44472,42,44,44472,0,44472,0,1.3526e+18,36.6341,933.736,44472,39,37,44428,44405,44360,43416,44428
30599,22,28,0,30599,5145,25454,5178.3,12.2666,544.18,30599,20,21,30571,30571,30571,30571,30562
36669,20,38,36669,0,0,36669,336712000,33.5034,864.517,36669,38,36,36383,35827,36040,36039,28946
43343,8,56,43343,0,0,43343,339847000,22.8678,830.305,43343,32,32,39615,33556,30809,32822,16386
42810,28,56,42810,0,42810,0,86830800000,36.3075,852.69,42810,40,32,42741,42696,42715,42721,38099
31067,6,40,31067,0,31067,0,86716100000,26.8016,657.865,31067,30,29,27163,24711,19684,23600,9804
25912,21,40,25912,0,0,25912,5.70411e+15,22.3547,608.954,25912,30,29,25863,25816,25830,4780,22516
32575,2,21,0,32575,5354,27221,5195.66,11.958,522.041,32575,21,20,21914,21914,21781,14683,14680
31994,33,56,31994,0,0,31994,5.69478e+15,22.9964,727.731,31994,31,32,31938,31916,31932,29047,30934
10772,5,24,0,10772,0,10772,1330140,21.8784,387.307,10772,21,22,8589,6409,6380,6163,3367
18484,8,23,3199,15285,0,18484,19.3811,16.7539,448.846,18484,20,21,18189,18168,18046,18085,17494
16848,39,56,16818,30,16818,30,2.9872e+13,34.6464,667.078,16848,46,33,16789,16740,16782,16243,14029
39752,1,2,39752,0,39752,0,4.98062e+13,1.99935,268.674,39752,2,2,32717,32717,32717,32717,32717
33468,35,40,33468,0,33468,0,1.4421e+18,30.7099,717.984,33468,38,37,33417,33351,33374,27294,33373
34244,1,2,0,34244,34244,0,1.13461e+16,1.99936,247.628,34244,2,2,28851,28851,28851,28851,28851
43181,36,44,43181,0,43181,0,79751700000,40.2766,970.341,43181,41,41,43121,43067,42782,42811,34904
39665,9,60,39665,0,39665,0,1.34687e+18,41.3897,990.194,39665,48,44,36022,30768,31921,6763,10036
26426,29,40,26426,0,0,26426,5.41174e+15,29.3126,674.02,26426,37,35,26342,26173,26203,13712,22465
10785,16,21,0,10785,1748,9037,5172.89,10.3423,302.132,10785,12,20,10764,10764,10763,10763,10756
44303,16,56,0,44303,44303,0,2.21026e+13,28.3894,876.68,44303,37,40,43958,43256,42988,42959,29648
36861,521,1316,0,36861,0,36861,3.49099e+16,53.9713,2736.63,36861,204,125,35545,35406,35030,7427,3534
45240,17,27,13887,31353,4,45236,6221630000,21.4697,844.455,45240,26,22,45179,45175,44823,44819,41351
13076,1,2,13076,0,13076,0,4.31383e+13,1.99954,152.01,13076,2,2,11071,11071,11071,11071,11071
18371,28,48,18371,0,0,18371,280023000,28.5783,751.633,18371,33,41,18293,18216,17952,15591,11660
16241,4,19,3045,13196,0,16241,19.8296,17.4702,450.576,16241,19,19,13903,13903,12153,8373,9164
36586,21,44,36586,0,0,36586,5.37894e+15,37.5414,826.833,36586,38,37,36245,35713,35931,7165,24011
14296,4,56,14296,0,0,14296,329165000,25.4373,532.314,14296,33,39,10705,8364,8165,7995,2707
4467,1,2,4467,0,4467,0,3.32704e+13,1.99664,88.6201,4467,2,2,3938,3938,3938,3938,3938
39515,4,56,39515,0,0,39515,340159000,22.4522,801.429,39515,32,32,28543,21722,21030,17424,8006
2213,8,11,0,2213,355,1858,5215.32,7.75734,123.399,2213,9,10,2199,2199,2190,2190,2199
24633,24,40,24633,0,24633,0,1.46581e+18,21.094,637.222,24633,31,29,24593,24573,24578,14667,23793
22260,6,60,0,22260,22260,0,2.11166e+13,28.6,708.014,22260,35,40,19200,17403,14998,16420,6917
8256,20,24,8256,0,8256,0,1.46828e+18,20.2959,342.805,8256,19,21,8229,8206,8214,7229,7936
34116,9,44,0,34116,0,34116,1250550,33.4255,791.712,34116,37,37,31913,28084,29053,28954,9555
2750,24,36,0,2750,2750,0,2.03238e+13,22.2,222.224,2750,27,32,2696,2652,2653,2563,2245
13701,29,40,13701,0,13701,0,1.43129e+18,19.6787,469.552,13701,29,36,13655,13623,13618,12982,12982
24590,10,20,0,24590,4217,20373,5196.12,11.9708,480.917,24590,19,19,24528,24528,24459,24458,24482
13917,26,27,5117,8800,4,13913,20224600000,16.9704,476.517,13917,23,22,13890,13890,13889,13890,13853
38135,11,49,0,38135,38131,4,5.79031e+14,36.9867,1040.04,38135,43,41,30594,21930,26561,24637,12926
20719,18,40,20719,0,0,20719,338375000,18.7504,526.173,20719,28,29,20665,20601,20620,20616,18589
18597,13,40,18597,0,0,18597,300960000,34.0359,607.961,18597,35,34,17617,16208,17084,17089,7145
32763,4,40,32763,0,0,32763,5.71452e+15,22.5001,692.18,32763,32,29,23855,18188,17614,3943,6652
6148,23,36,0,6148,6148,0,2.13664e+13,18.65,310.917,6148,31,32,6088,6018,6043,5953,4787
8683,8,23,2311,6372,0,8683,16.2147,16.2918,364.372,8683,19,22,8133,8048,7963,8019,3513
19533,3,56,0,19533,19533,0,2.21021e+13,22.0643,573.772,19533,29,32,12963,11003,9809,10561,4437
6673,14,20,6673,0,0,6673,339788000,17.0075,277.045,6673,18,19,6635,6597,6441,6441,6090
9053,15,36,9053,0,0,9053,5.5162e+15,24.6698,345.596,9053,26,25,8968,8867,8908,1423,7456
33976,1888,1986,33976,0,1834,32142,2.74096e+17,62.8433,3517.64,33976,302,159,31990,31990,31990,31990,10649
31041,4,28,0,31041,5211,25830,5134.71,13.014,571.986,31041,20,25,27847,27847,25356,24191,22550
43940,31,40,43940,0,43940,0,1.4435e+18,32.0579,808.457,43940,38,37,43871,43758,43825,35621,43293
21642,1,2,21642,0,21642,0,3.25929e+13,1.99972,193.858,21642,2,2,19135,19135,19135,19135,19135
17865,1,2,17865,0,17865,0,3.22046e+13,1.99849,178.03,17865,2,2,15820,15820,15820,15820,15820
9290,1,2,9290,0,9290,0,4.41755e+13,1.9986,127.733,9290,2,2,7831,7831,7831,7831,7831
11994,22,56,11994,0,11994,0,1.44536e+18,19.259,459.226,11994,36,30,11938,11912,11901,2980,10602
47549,17,60,47549,0,0,47549,329909000,32.5918,977.788,47549,37,44,47037,45674,46505,45090,32138
43108,1,4,0,43108,43108,0,8.37786e+15,1.9997,279.5,43108,3,3,38093,38093,38093,38093,38093
44683,15,55,44683,0,0,44683,5.03571e+15,40.3032,1178.1,44683,46,45,40052,26308,35917,17671,14879
11496,63,64,11496,0,11496,0,1.4594e+18,21.0897,512.455,11496,27,38,11432,11432,11432,11432,11428
30842,2,4,0,30842,30842,0,1.27985e+16,2.7007,259.567,30842,4,4,30795,30780,30791,30792,29830
10870,8,21,2029,8841,0,10870,18.4898,16.6532,346.9,10870,19,19,10568,10544,10490,10538,9799
48833,15,40,48833,0,0,48833,340937000,22.4152,856.812,48833,32,28,48460,47773,46424,45588,35469
26016,31,40,0,26016,0,26016,1292350,32.6907,640.227,26016,37,37,25949,25817,25873,25870,23636
43721,40,54,43715,6,0,43721,8.40551e+14,36.1864,1157.49,43721,43,45,43667,43642,43376,41464,37001
45180,37,40,45180,0,45180,0,1.44935e+18,28.6527,827.895,45180,39,37,45134,45094,45104,38722,45107
34600,3,4,0,34600,34600,0,8.38867e+15,1.99954,251.035,34600,3,3,34596,34594,34595,34595,34596
22529,32,38,0,22529,22529,0,2.22141e+13,33.126,639.848,22529,32,30,22479,22415,22466,22467,22479
17539,18,19,2829,14710,0,17539,19.3112,15.0953,398.314,17539,19,19,17516,17514,17508,17508,17513
31837,10,44,31837,0,0,31837,5.49632e+15,31.4374,744.267,31837,37,37,30557,29400,27467,4675,12011
34198,1,2,0,34198,34198,0,8.44725e+15,1.9998,243.612,34198,2,2,30188,30188,30188,30188,30188
1259,4,19,0,1259,196,1063,4861.36,8.40508,107.648,1259,16,17,1157,1157,1071,1070,588
49690,1,44,0,49690,0,49690,1218590,37.9483,1015.54,49690,38,41,5778,5778,5778,5778,5778
9062,6,22,9062,0,0,9062,343054000,20.3914,365.663,9062,21,21,7546,6646,5452,4673,3344
38727,39,40,38727,0,0,38727,5.69331e+15,26.5485,741.616,38727,32,29,38686,38657,38685,36513,38654
33109,1,4,0,33109,33109,0,1.4486e+16,1.99973,254.88,33109,3,3,26450,26450,26450,26450,26450
40868,10,40,0,40868,40868,0,2.20858e+13,29.5115,792.62,40868,39,37,39449,38145,34461,34385,18424
25676,26,40,25676,0,25676,0,1.45084e+18,28.2226,601.045,25676,30,29,25622,25583,25610,9859,25582
6623,1,38,0,6623,0,6623,1319150,21.1178,350.396,6623,23,29,626,626,626,626,626
19166,3,38,0,19166,19166,0,2.22009e+13,35.365,594.222,19166,32,31,11959,10048,8635,10048,3072
31858,21,23,0,31858,6277,25581,4724.55,17.5249,632.226,31858,21,22,31835,31835,31715,31715,31244
23623,7,38,0,23623,0,23623,1329920,27.9656,639.403,23623,31,29,20377,17237,14849,13908,9207
41785,1,2,41785,0,41785,0,3.71842e+13,1.99957,270.127,41785,2,2,36264,36264,36264,36264,36264
1092,1,14,1092,0,1092,0,1.48444e+18,12.2555,109.555,1092,14,14,115,115,115,115,115
6633,8,36,6633,0,6633,0,8.2408e+10,26.5578,317.181,6633,32,25,6193,5610,5500,5599,2834
36124,34,40,36124,0,0,36124,337573000,27.9599,714.979,36124,32,29,36076,36022,36069,31583,33152
11506,13,22,11506,0,0,11506,342713000,20.4082,411.488,11506,21,22,11250,10462,10102,10292,8699
49422,33,40,49422,0,0,49422,337750000,30.6942,988.589,49422,38,36,49345,49118,49236,49235,48353
21540,13,48,21540,0,0,21540,283998000,29.417,802.495,21540,33,41,19225,14918,17560,17479,9510
45327,2,40,0,45327,45327,0,2.18049e+13,33.894,830.602,45327,38,37,26458,26412,19027,21267,7335
16158,27,44,16158,0,16158,0,1.36393e+18,32.7019,621.059,16158,30,41,16093,15992,15966,12542,14642
47184,32,44,47184,0,0,47184,5.45218e+15,37.037,920.245,47184,37,37,47104,46968,46934,31881,40874
35808,1,44,0,35808,35808,0,2.13715e+13,32.2135,785.892,35808,37,37,4400,4400,4400,4400,4400
14207,18,24,0,14207,14207,0,2.23812e+13,20.9949,439.889,14207,21,22,14171,14135,14023,14009,13093
30184,1,40,30184,0,0,30184,251881000,33.6601,892.542,30184,39,34,1814,1814,1814,1814,1814
37315,14,28,6314,31001,0,37315,20.1562,20.2362,620.143,37315,28,21,37263,37262,37244,37244,37149
46494,10,21,7405,39089,0,46494,20.0325,16.69,634.055,46494,21,21,46352,46351,46279,46304,46147
46201,8,28,0,46201,7648,38553,5177.8,18.1976,656.442,46201,28,21,45856,45855,44607,44616,43559
35672,16,40,35672,0,0,35672,5.70809e+15,22.1934,709.251,35672,31,29,35504,35109,34638,10454,26574
20616,23,60,20616,0,20616,0,81961900000,29.733,710.828,20616,36,47,20413,20021,20169,20020,7641
48720,1,2,48720,0,48720,0,3.43986e+13,1.99977,290.544,48720,2,2,42765,42765,42765,42765,42765
20799,7,27,6606,14193,4,20795,13532700000,17.4493,582.335,20799,23,22,18174,18173,18096,18166,11886
6976,1,22,6976,0,6976,0,1.47437e+18,17.0228,307.116,6976,19,19,730,730,730,730,730
34305,46,56,34305,0,0,34305,335670000,29.6282,785.822,34305,37,40,34249,34237,34240,34167,31236
26419,18,56,26419,0,26419,0,1.46004e+18,21.2693,667.519,26419,32,32,26313,26207,26056,19905,22478
8107,374,1377,0,8107,2938,5169,8.27012e+14,76.9714,2181.37,8107,231,138,6730,6567,5817,1791,1927
7809,14,40,7809,0,7809,0,1.17581e+18,28.2195,448.936,7809,33,37,7082,5583,6655,3543,3647
26811,15,40,26811,0,0,26811,4.14753e+15,34.4607,841.627,26811,37,34,23536,13497,20614,8711,12829
39407,18,40,39407,0,0,39407,5.71307e+15,33.2917,805.993,39407,32,31,39251,39069,38614,31388,29756
42911,3,55,42911,0,0,42911,5.65995e+15,37.452,1085.33,42911,39,45,26563,22741,21266,4846,6616
2379,15,16,2379,0,2379,0,84310600000,13.0963,150.038,2379,15,14,2361,2341,2355,2355,2357
49305,1,4,0,49305,49305,0,8.3362e+15,3.5772,303.377,49305,4,4,43594,43594,43594,43594,43594
1585,14,22,1585,0,1585,0,1.43006e+18,18.5167,157.382,1585,17,21,1533,1487,1388,1349,1136
10538,5,40,10538,0,0,10538,5.68346e+15,18.5343,390.463,10538,20,29,8508,6389,6430,1868,2810
28556,29,40,0,28556,28556,0,2.23166e+13,23.0371,674.92,28556,32,24,28516,28498,28508,28507,28516
24038,35,40,24038,0,24038,0,1.46395e+18,31.3593,644.148,24038,31,31,23994,23956,23984,20361,23133
40969,29,40,40969,0,40969,0,80268500000,31.8009,913.477,40969,40,37,40848,40554,40516,40281,33973
27384,24,40,27384,0,27384,0,85720600000,31.4479,649.066,27384,37,37,27290,27204,27221,27086,20626
8525,8,30,2315,6210,0,8525,16.6025,15.6977,409.21,8525,19,24,7991,7908,7707,7746,4607
43067,42,44,0,43067,0,43067,1283850,32.4305,864.021,43067,37,38,43023,43008,42929,42929,40273
33960,11,40,0,33960,33960,0,2.03965e+13,32.224,840.846,33960,40,36,31900,29497,29834,28822,13631
43375,2,4,0,43375,43375,0,9.19015e+15,2.00014,283.347,43375,3,3,43370,43369,43370,43370,42405
12864,23,36,12864,0,12864,0,83813300000,28.6952,431.727,12864,33,33,12778,12663,12722,12588,10755
11071,8,24,11071,0,11071,0,87593900000,21.0831,399.425,11071,21,21,10028,8359,7384,8460,4832
28830,32,40,28830,0,28830,0,1.45972e+18,23.2359,649.853,28830,31,27,28790,28774,28789,22926,28788
3889,13,32,3889,0,0,3889,310385000,24.1821,240.431,3889,29,28,3759,3642,3686,3691,2463
16091,30,36,16091,0,0,16091,325589000,27.4302,488.996,16091,34,33,16035,15928,15984,14118,13946
9010,31,40,9010,0,9010,0,1.29784e+18,30.9622,423.547,9010,32,33,8965,8868,8904,8229,8498
8295,48,56,0,8295,0,8295,1261040,28.4412,424.458,8295,32,38,8239,8229,8230,8238,8157
4531,7,38,0,4531,4531,0,2.22018e+13,18.497,291.681,4531,24,25,3921,3339,2969,3306,1721
8136,1,19,0,8136,1230,6906,5060.34,13.119,250.118,8136,19,18,1600,1600,1600,1600,1600
18489,15,23,3202,15287,0,18489,19.3843,16.7166,448.926,18489,20,21,18446,18446,18387,18390,18040
42171,22,30,7731,34440,0,42171,19.5839,17.8384,795.148,42171,19,29,42141,42141,42102,42102,41464
38002,31,44,38002,0,38002,0,69771500000,37.1579,993.569,38002,38,39,37905,37538,37449,37308,34359
8511,28,40,8511,0,0,8511,256553000,33.674,490.676,8511,32,37,8455,8429,8346,8101,4930
43522,37,60,43522,0,0,43522,328376000,37.867,890.927,43522,38,44,43455,43396,43277,36188,24252
23517,22,24,23517,0,23517,0,1.4684e+18,22.0974,583.489,23517,24,22,23489,23463,23469,21597,21800
28048,6,28,4731,23317,0,28048,20.2461,11.7621,521.815,28048,20,21,27174,27174,26192,26195,25211
4682,31,36,4682,0,4682,0,1.42428e+18,15.3078,243.482,4682,22,25,4646,4635,4646,4302,4646
6782,1,2,6782,0,6782,0,3.26215e+13,1.99808,108.902,6782,2,2,5995,5995,5995,5995,5995
21124,38,40,21124,0,21124,0,82475400000,28.5624,604.149,21124,36,35,21084,21071,21012,21051,19259
17145,29,40,17145,0,17145,0,75547300000,29.9889,609.17,17145,36,37,17070,16914,16856,16641,15110
7711,12,21,0,7711,2634,5077,3835.72,16.0639,334.228,7711,19,19,7619,7611,7493,7505,6428
49499,25,44,49499,0,49499,0,82666700000,34.3056,938.048,49499,38,37,49262,48808,48872,48255,35980
3149,2,22,3149,0,3149,0,1.47383e+18,16.7764,214.647,3149,19,19,1674,1674,1084,371,492
44504,2,19,8389,36115,0,44504,19.7332,18.7019,746.858,44504,19,19,27918,27918,24842,13918,12999
17026,12,40,17026,0,0,17026,332947000,23.6313,516.425,17026,32,37,16661,16042,15623,15625,9934
14898,1,28,0,14898,2385,12513,5136.84,12.3691,378.424,14898,20,19,2662,2662,2662,2662,2662
9535,3,33,0,9535,3194,6341,7.55694e+12,16.4359,476.436,9535,18,31,5652,5601,5018,4019,2574
32065,8,23,0,32065,5603,26462,4887.67,18.7167,590.29,32065,21,21,31467,31422,31229,31320,30010
46683,20,28,7768,38915,0,46683,20.1124,15.2415,683.898,46683,20,27,46653,46651,46642,46642,46471
29001,22,40,29001,0,0,29001,5.70761e+15,22.6192,647.168,29001,31,29,28954,28907,28924,5312,25320
32896,3,40,32896,0,32896,0,1.45451e+18,27.4604,681.733,32896,31,29,21992,18680,16822,4044,6309
43909,1,2,43909,0,43909,0,3.38214e+13,1.99968,275.8,43909,2,2,38632,38632,38632,38632,38632
38264,3,4,0,38264,38264,0,8.30101e+15,3.88284,271.441,38264,4,4,38254,38242,38251,38251,36870
38922,37,60,38922,0,0,38922,5.60257e+15,38.4806,892.004,38922,40,40,38859,38820,38766,33118,38138
18977,12,23,5298,13679,0,18977,16.278,18.1092,528.079,18977,20,21,18775,18758,18575,18597,15543
10432,4,21,0,10432,2561,7871,4333.84,15.0379,376.085,10432,19,20,8612,8612,8180,8195,6347
5974,5,11,0,5974,961,5013,5217.7,9.15718,204.125,5974,11,10,5640,5640,5032,5033,5218
1096,30,36,0,1096,0,1096,1229880,15.0283,161.009,1096,17,30,1060,1056,1045,1048,1022
49980,32,44,49980,0,49980,0,1.33281e+18,38.735,1029.26,49980,38,41,49886,49727,49479,36066,41207
44132,3,4,0,44132,44132,0,1.14066e+16,3.23729,306.186,44132,4,4,44104,44062,44095,44095,39360
38412,5,60,0,38412,0,38412,1278110,34.3065,891.594,38412,37,44,30898,23631,24763,23544,9111
44286,20,44,0,44286,44286,0,2.14535e+13,36.5854,882.237,44286,38,37,43954,43559,43711,43018,31467
13074,2,13,2104,10970,0,13074,20.272,10.5991,316.514,13074,12,12,8875,8875,8837,6219,6219
27077,1,2,27077,0,27077,0,3.23711e+13,1.999,218.927,27077,2,2,23962,23962,23962,23962,23962
7636,18,21,0,7636,1257,6379,5152.18,10.273,262.241,7636,18,20,7614,7614,7612,7612,7609
6476,1,36,6476,0,0,6476,316218000,28.0749,328.31,6476,31,31,824,824,824,824,824
46861,1,2,46861,0,46861,0,3.25497e+13,1.99989,286.992,46861,2,2,41441,41441,41441,41441,41441
30895,13,20,0,30895,5302,25593,5189.74,17.67,547.124,30895,20,20,30855,30855,30855,30855,30842
13530,1,2,0,13530,13530,0,1.28031e+16,1.99882,156.038,13530,2,2,11125,11125,11125,11125,11125
36387,18,44,36387,0,36387,0,1.34978e+18,37.2727,851.748,36387,39,37,35794,34907,35366,6601,16787
42464,1,2,42464,0,42464,0,3.67885e+13,1.99962,273.012,42464,2,2,36913,36913,36913,36913,36913
40445,1,2,0,40445,40445,0,1.20099e+16,1.9999,271.744,40445,2,2,33703,33703,33703,33703,33703
11721,22,25,2478,9243,0,11721,19.2243,11.281,425.284,11721,16,23,11696,11696,11684,11684,11573
5680,8,24,5680,0,0,5680,342421000,17.5542,280.142,5680,19,21,5168,4342,3873,4252,3070
43683,14,60,0,43683,43683,0,2.07174e+13,39.5734,1039.79,43683,40,44,42109,39363,40113,39293,18057
27391,5,60,27391,0,0,27391,334902000,23.3767,769.214,27391,32,40,21321,15910,16078,14025,6961
14635,17,40,14635,0,0,14635,331546000,24.4489,479.875,14635,35,37,14509,14307,14439,14120,9571
41931,1,40,41931,0,0,41931,5.65189e+15,32.3709,922.395,41931,38,36,4119,4119,4119,4119,4119
14380,8,40,14380,0,14380,0,1.45458e+18,22.4871,462.507,14380,28,29,13222,11335,11002,3147,6196
27579,17,21,0,27579,4442,23137,5111.65,16.5988,499.046,27579,20,21,27544,27544,27520,27520,27450
15697,1,2,15697,0,15697,0,3.26358e+13,1.99904,165.465,15697,2,2,13876,13876,13876,13876,13876
24292,58,60,24292,0,0,24292,5.51938e+15,23.374,797.994,24292,32,44,24232,24225,24230,24232,23970
31790,9,21,5208,26582,0,31790,20.2798,12.2113,515.826,31790,21,20,31671,31671,31514,31517,31552
14302,41,60,14302,0,0,14302,5.46465e+15,23.2619,611.808,14302,30,40,14242,14234,14195,13982,12902
13535,17,60,13535,0,13535,0,79358700000,33.0876,653.48,13535,33,47,13112,12148,12764,12333,6054
36478,15,48,0,36478,36478,0,1.91177e+13,37.7025,997.102,36478,37,41,34261,28094,32390,31030,17602
42176,1,2,42176,0,42176,0,3.23347e+13,1.99974,273.188,42176,2,2,37330,37330,37330,37330,37330
8024,5,28,0,8024,1388,6636,4889.78,16.633,353.366,8024,18,26,7425,7423,6819,6786,2175
43948,13,44,43948,0,43948,0,83961200000,37.5645,877.514,43948,37,37,42972,41001,41756,41084,23202
20018,6,38,20018,0,20018,0,1.4551e+18,29.8435,606.821,20018,31,31,16384,14270,11684,3346,6781
49332,25,56,49332,0,0,49332,339806000,34.1531,910.733,49332,40,32,49260,49214,49229,49218,44944
49530,11,23,0,49530,8255,41275,5038.25,18.9655,707.19,49530,22,21,49299,49299,49189,49246,48435
20697,1,2,20697,0,20697,0,3.25035e+13,1.99841,191.226,20697,2,2,18306,18306,18306,18306,18306
33199,3,40,33199,0,33199,0,85857400000,29.3975,704.984,33199,37,37,22473,19163,17372,17914,6973
37878,22,40,0,37878,37878,0,2.1829e+13,34.8352,765.436,37878,38,37,37714,37515,37593,37316,27484
30910,20,21,4952,25958,0,30910,19.9925,16.0128,523.172,30910,20,21,30887,30886,30876,30876,30853
43076,21,30,7437,35639,0,43076,20.0615,19.0868,694.687,43076,28,22,43039,43039,43019,43019,42932
15013,37,56,0,15013,0,15013,1293800,24.4342,518.06,15013,36,34,14957,14949,14909,14913,10359
5502,28,36,5502,0,5502,0,1.3829e+18,19.5729,292.796,5502,28,32,5458,5428,5425,5039,5394
31043,4,40,31043,0,31043,0,1.44311e+18,29.7657,688.876,31043,37,37,23108,17853,17370,4112,6776
36813,1,21,0,36813,5999,30814,5190.76,11.9551,550.686,36813,21,20,6350,6350,6350,6350,6350
31199,19,28,0,31199,5186,26013,5179.47,12.3476,542.536,31199,21,21,31169,31169,31169,31169,31105
24070,15,32,6480,17590,0,24070,17.1098,15.4231,674.999,24070,21,25,24002,24002,23778,23792,16999
10008,24,38,0,10008,10008,0,2.22746e+13,20.1105,419.885,10008,30,22,9970,9952,9959,9962,9970
13430,1,2,13430,0,13430,0,3.30309e+13,1.99873,152.551,13430,2,2,11853,11853,11853,11853,11853
36170,39,40,36170,0,36170,0,87222200000,22.2912,720.488,36170,32,29,36130,36116,36130,36129,36130
42207,21,40,0,42207,0,42207,1329170,37.5391,843.999,42207,33,31,42106,41852,41954,41930,36846
48039,22,56,48039,0,48039,0,8.6915e+10,34.8374,899.835,48039,40,32,47958,47885,47872,47883,43284
1778,8,18,1778,0,0,1778,5.76628e+15,13.0652,143.431,1778,15,16,1636,1390,1365,1065,1115
42083,22,44,42083,0,42083,0,78651500000,37.2642,959.143,42083,39,41,41650,40666,41169,39938,24582
44535,58,60,0,44535,44535,0,2.15429e+13,31.2061,1069.26,44535,38,51,44475,44465,44473,44475,43345
25671,9,13,0,25671,4327,21344,5218.29,11.9369,460.049,25671,13,13,25566,25566,25345,25344,25468
10261,18,19,1611,8650,0,10261,19.386,16.2628,297.783,10261,19,19,10239,10237,10230,10230,10239
43385,1,21,0,43385,6952,36433,5128.9,17.2623,616.609,43385,21,21,7928,7928,7928,7928,7928
25808,38,44,0,25808,25808,0,1.7183e+13,32.8167,833.825,25808,36,37,25764,25745,25659,25698,25500
13544,1,2,13544,0,13544,0,3.30438e+13,1.99852,153.147,13544,2,2,11953,11953,11953,11953,11953
4655,36,64,0,4655,0,4655,1134680,23.3575,434.935,4655,26,43,4591,4585,4573,4571,2498
30922,39,40,30922,0,30922,0,87071100000,22.6496,665.211,30922,30,29,30882,30868,30882,30881,30882
34997,29,56,0,34997,0,34997,1327050,22.6237,755.81,34997,31,32,34941,34917,34929,34928,31150
49910,28,44,49910,0,49910,0,78094900000,38.7558,1062.83,49910,41,41,49724,49388,49085,48153,36229
11935,1,2,0,11935,11935,0,8.38005e+15,1.99899,144.476,11935,2,2,10546,10546,10546,10546,10546
25553,23,24,25553,0,0,25553,5.7356e+15,21.7919,606.638,25553,24,22,25527,25501,25518,23959,25100
11028,45,60,11028,0,0,11028,5.36987e+15,23.5361,554.981,11028,30,40,10968,10960,10964,10812,9872
21048,12,56,21048,0,21048,0,86024200000,22.806,644.796,21048,31,39,20386,19178,17950,18290,11469
24081,3713,7057,0,24081,7460,16621,7.56165e+14,179.906,8736.75,24081,2274,175,17024,17024,12039,2962,582
38531,36,44,0,38531,38531,0,2.03065e+13,42.6226,929.033,38531,40,40,38471,38417,38157,38188,30914
27725,5,20,4903,22822,0,27725,20.2972,15.7356,523.5,27725,20,19,25477,25477,22724,21983,12870
35540,21,23,6008,29532,0,35540,19.5245,17.4842,607.95,35540,21,21,35515,35515,35465,35465,35317
8883,1,2,8883,0,8883,0,3.27643e+13,1.99831,125.2,8883,2,2,7848,7848,7848,7848,7848
7673,1,2,0,7673,7673,0,9.6634e+15,1.99713,115.186,7673,2,2,6643,6643,6643,6643,6643
12257,1,2,12257,0,12257,0,3.24947e+13,1.99886,147.16,12257,2,2,10841,10841,10841,10841,10841
44553,27,48,0,44553,44553,0,1.97284e+13,35.6412,1055.57,44553,37,41,44364,43742,43841,43205,33784
49370,1,32,0,49370,11604,37766,4564.24,17.9674,908.947,49370,23,27,10674,10674,10674,10674,10674
37365,21,40,37365,0,37365,0,87272300000,22.9867,760.694,37365,32,28,37304,37161,37247,37250,33350
16213,1,2,16213,0,16213,0,3.21701e+13,1.99938,169.639,16213,2,2,14359,14359,14359,14359,14359
46847,5,20,0,46847,8205,38642,5200.53,15.7885,674.693,46847,20,19,43198,43198,38508,37566,32464
12239,12,48,0,12239,12239,0,1.84187e+13,25.0355,629.602,12239,31,41,10470,7812,9010,8875,5295
49886,37,44,0,49886,0,49886,1288440,34.3396,919.223,49886,38,38,49836,49782,49685,49688,48523
13026,19,24,0,13026,13026,0,2.23404e+13,21.1479,422.226,13026,21,22,12995,12959,12957,12957,12207
43971,3,30,7586,36385,0,43971,19.8359,13.3601,712.341,43971,20,25,34478,34477,34225,26521,19615
25150,1,2,25150,0,25150,0,3.83545e+13,1.99944,209.961,25150,2,2,21722,21722,21722,21722,21722
41200,1,2,41200,0,41200,0,3.25746e+13,1.99981,268.997,41200,2,2,36431,36431,36431,36431,36431
17443,27,40,17443,0,0,17443,339888000,21.4933,535.61,17443,29,28,17403,17385,17394,17395,16408
29453,1,2,29453,0,29453,0,3.72904e+13,1.99898,228.195,29453,2,2,25550,25550,25550,25550,25550
16953,13,25,0,16953,5077,11876,4142.93,16.6805,537.399,16953,21,23,16846,16846,16707,16719,10504
45973,12,40,0,45973,45973,0,2.23612e+13,27.3243,863.276,45973,33,30,44614,41789,38802,39388,26049
12067,19,36,12067,0,0,12067,5.61653e+15,22.6333,394.969,12067,28,25,12012,11955,11987,1899,11453
28056,43,56,28056,0,28056,0,85781800000,28.2462,779.599,28056,38,42,28000,27988,28000,28000,27998
49745,1,2,0,49745,49745,0,1.01731e+16,1.9995,295.278,49745,2,2,42721,42721,42721,42721,42721
29810,16,44,29810,0,0,29810,324144000,32.4278,728.7,29810,37,37,29360,28474,29031,29037,18468
26176,50,54,26170,6,26170,6,3.27483e+12,33.8853,898.126,26176,38,45,26122,26107,26119,26078,24531
39744,1,40,39744,0,39744,0,86662300000,36.6809,854.333,39744,34,33,3867,3867,3867,3867,3867
4590,44,56,4590,0,4590,0,8.3197e+10,20.2643,350.652,4590,27,38,4534,4528,4525,4530,4363
13873,11,23,2519,11354,0,13873,19.3083,12.2459,402.447,13873,18,21,13782,13782,13745,13758,13151
16498,1,2,16498,0,16498,0,5.92363e+13,1.9983,175.975,16498,2,2,13025,13025,13025,13025,13025
41216,1,60,0,41216,41216,0,2.11148e+13,34.6889,1130.6,41216,38,56,3846,3846,3846,3846,3846
40414,3,4,0,40414,40414,0,8.33724e+15,3.15811,273.702,40414,4,4,40408,40404,40407,40407,39650
4864,9,20,4864,0,4864,0,86517500000,14.5594,230.987,4864,17,17,4654,4066,4168,4143,3080
3926,19,40,0,3926,0,3926,1173840,19.0214,298.728,3926,27,33,3832,3670,3786,3759,2930
43847,13,19,8028,35819,0,43847,20.0834,17.2729,708.189,43847,19,19,43714,43714,43678,43678,43618
48462,7,40,48462,0,0,48462,5.66742e+15,28.4032,860.822,48462,40,37,43518,38278,34133,6628,14236
42922,44,56,42922,0,42922,0,87020500000,22.952,826.986,42922,32,32,42866,42853,42866,42866,42864
40502,64,66,40502,0,40502,0,1.41044e+18,33.5006,1191.95,40502,43,50,40436,40432,40436,40433,40182
38964,32,40,0,38964,38964,0,2.19993e+13,32.4898,758.323,38964,37,37,38902,38820,38852,38826,38607
18397,1,2,18397,0,18397,0,3.65977e+13,1.99848,178.933,18397,2,2,16004,16004,16004,16004,16004
24386,10,44,24386,0,0,24386,5.45313e+15,26.9716,666.62,24386,36,37,23308,22350,21062,6917,11521
39782,26,60,0,39782,39782,0,2.14879e+13,32.6168,1030.66,39782,38,51,39566,39171,39254,39185,32997
36195,41,60,0,36195,0,36195,1280780,36.7309,999.224,36195,38,52,36135,36125,36069,36057,33626
42363,46,96,237,42126,42351,12,2.70962e+15,2.07743,527.101,42363,28,22,42267,42259,42236,42240,42178
29259,38,65,29258,1,0,29259,1.25601e+15,33.6153,1123.45,29259,38,58,29194,29186,29027,27783,17377
47615,13,56,47615,0,47615,0,86281100000,36.0803,903.583,47615,40,40,46782,44443,43068,44496,26458
45568,6,40,0,45568,0,45568,1200840,32.5011,985.748,45568,40,37,38389,34599,30592,32760,12304
13383,24,36,13383,0,0,13383,337966000,18.4302,418.512,13383,28,25,13347,13330,13341,13340,13345
31469,4,44,0,31469,0,31469,1217710,33.9651,832.188,31469,37,41,22864,18156,18019,18378,6395
42043,35,40,0,42043,42043,0,2.22995e+13,21.9742,775.129,42043,32,29,42003,41986,42003,41994,42003
37141,1,2,0,37141,37141,0,1.41434e+16,1.99935,262.09,37141,2,2,29850,29850,29850,29850,29850
36185,31,40,0,36185,0,36185,1313880,29.688,743.343,36185,38,37,36121,36035,36072,36071,33766
49018,23,40,49018,0,49018,0,1.46571e+18,22.9373,874.402,49018,32,29,48973,48911,48924,28501,47563
30775,1,2,30775,0,30775,0,4.06824e+13,1.99925,232.886,30775,2,2,26326,26326,26326,26326,26326
2452,1,2,2452,0,2452,0,3.30607e+13,1.9947,65.2146,2452,2,2,2163,2163,2163,2163,2163
35978,15,20,6247,29731,0,35978,20.3392,12.2075,577.718,35978,20,19,35953,35953,35953,35953,35953
21509,1,28,0,21509,3656,17853,5100.43,13.0477,492.545,21509,19,25,3803,3803,3803,3803,3803
23808,1,2,23808,0,23808,0,3.25834e+13,1.99945,204.77,23808,2,2,21051,21051,21051,21051,21051
42454,1,5,42454,0,42454,0,6.61553e+13,1.99981,290.717,42454,3,4,32981,32981,32981,32981,32981
25467,12,56,25467,0,0,25467,5.68609e+15,21.3538,651.938,25467,29,32,24832,23552,21858,7095,13712
43503,5,56,43503,0,0,43503,339518000,35.8605,841.009,43503,40,32,34578,25811,26007,24196,10744
39631,25,44,39631,0,39631,0,80079700000,34.6516,911.203,39631,37,41,39400,38929,38942,38275,29418
3305,14,20,3305,0,3305,0,1.43932e+18,14.5652,191.644,3305,16,17,3279,3253,3254,2990,3043
17274,21,40,17274,0,17274,0,85344400000,24.1183,522.394,17274,32,37,17183,17096,17126,16975,14555
36405,5,21,0,36405,5847,30558,5079.55,18.8542,576.225,36405,21,21,34390,34390,31293,31284,22268
21292,12,38,21292,0,0,21292,5.63796e+15,32.1883,639.501,21292,34,32,20342,18678,17188,16084,12716
1343,17,28,0,1343,1343,0,1.58336e+13,22.6955,162.899,1343,26,23,1242,917,1194,1011,849
9491,1,2,0,9491,9491,0,1.79783e+16,1.99673,136.25,9491,2,2,7122,7122,7122,7122,7122
12393,4,13,2127,10266,0,12393,20.4267,11.23,321.937,12393,13,12,11013,11013,10029,9595,8701
24366,1,23,4290,20076,0,24366,19.2388,20.6997,521.455,24366,21,21,4953,4953,4953,4953,4953
10066,10,22,10066,0,10066,0,87933800000,20.0225,382.956,10066,21,21,9544,9086,8006,7785,6136
11341,5,22,11341,0,0,11341,5.74893e+15,20.4948,408.823,11341,21,22,8778,6471,6577,2392,3610
11472,7,23,2116,9356,0,11472,18.4738,16.3475,368.599,11472,19,21,11032,11032,10944,10995,10194
2321,2,18,0,2321,2321,0,2.26307e+13,17.0892,176.562,2321,17,18,1227,1227,791,1001,319
43816,8,40,43816,0,43816,0,86293400000,28.1778,814.206,43816,38,37,40491,35022,33605,35313,13706
46297,42,44,46297,0,46297,0,1.39292e+18,34.19,914.433,46297,37,37,46253,46230,46181,44017,46253
9232,6,56,9232,0,9232,0,85376400000,20.7028,462.558,9232,30,38,7572,6623,5525,6444,3057
40390,1,4,0,40390,40390,0,8.41891e+15,2.00007,270.621,40390,3,3,35668,35668,35668,35668,35668
18637,1,2,18637,0,18637,0,3.25319e+13,1.99882,181.077,18637,2,2,16482,16482,16482,16482,16482
21529,1,2,0,21529,21529,0,1.58045e+16,1.99981,202.619,21529,2,2,16806,16806,16806,16806,16806
38699,43,44,38699,0,38699,0,82199600000,36.8855,845.814,38699,37,37,38655,38632,38625,38625,38655
29027,1,5,1,29026,29027,0,1.26604e+16,2.74417,255.854,29027,4,4,23895,23895,23895,23895,23895
32278,3,44,0,32278,32278,0,1.7057e+13,36.4741,932.953,32278,38,37,17726,15244,14915,13043,4383
49560,1,2,49560,0,49560,0,3.20891e+13,1.99978,296.893,49560,2,2,43909,43909,43909,43909,43909
23949,1,2,23949,0,23949,0,5.5745e+13,1.99958,210.235,23949,2,2,19205,19205,19205,19205,19205
18523,1,19,0,18523,2974,15549,5094.07,12.4842,405.76,18523,19,19,3477,3477,3477,3477,3477
12841,1,2,0,12841,12841,0,8.34995e+15,1.99938,149.61,12841,2,2,11352,11352,11352,11352,11352
29380,6,23,4972,24408,0,29380,19.5483,13.9629,550.143,29380,20,21,28428,28428,27794,27834,27378
8361,7,11,0,8361,1359,7002,5213.57,9.88159,246.636,8361,11,11,8247,8247,7995,7995,8152
35286,16,40,35286,0,35286,0,1.45778e+18,29.8424,849.913,35286,37,38,34758,33774,33311,5372,20713
19060,14,21,0,19060,3061,15999,5092.44,12.6578,414.697,19060,19,20,19016,19015,18993,18993,18891
29170,24,40,29170,0,29170,0,1.461e+18,22.3631,647.576,29170,31,29,29129,29110,29121,7412,29128
24683,6,27,8816,15867,4,24679,11403200000,18.9238,623.603,24683,24,22,19623,19623,19499,19574,9622
15008,12,21,3744,11264,0,15008,16.7862,17.8801,451.251,15008,20,20,14840,14826,14730,14751,12235
1096,8,9,0,1096,161,935,5129.34,7.55839,80.51,1096,9,8,1086,1086,1086,1086,1086
31934,21,65,0,31934,0,31934,5.77635e+14,25.0525,1022.71,31934,33,48,31712,30415,30731,28863,23214
12942,55,56,0,12942,12942,0,2.19114e+13,22.4352,533.747,12942,30,39,12886,12878,12885,12886,12877
43119,43,44,0,43119,43119,0,2.15254e+13,38.2619,876.746,43119,37,38,43075,43062,43033,43034,41661
26655,16,38,26655,0,0,26655,340288000,27.5343,677.889,26655,31,30,26357,25635,25052,24914,21011
34183,1,4,0,34183,34183,0,8.39404e+15,2.00003,249.526,34183,3,3,30198,30198,30198,30198,30198
14093,1,2,0,14093,14093,0,8.3751e+15,1.99886,157.001,14093,2,2,12454,12454,12454,12454,12454
24792,45,56,0,24792,24792,0,2.19195e+13,33.3773,688.877,24792,36,40,24736,24724,24727,24734,21610
22408,21,38,0,22408,0,22408,1320580,36.4406,647.45,22408,33,31,22299,22043,22175,22172,20796
27998,5,23,4774,23224,0,27998,19.3041,17.8351,541.833,27998,20,21,26210,26210,24270,24298,14173
11391,5,24,11391,0,11391,0,1.45881e+18,19.4505,385.983,11391,21,21,9200,6899,6975,1801,3528
13145,32,40,0,13145,13145,0,2.1849e+13,19.722,462.863,13145,29,36,13105,13096,13064,13066,13033
31665,14,40,31665,0,0,31665,339844000,34.7253,746.165,31665,32,31,31107,30503,27877,27481,17334
38126,1,64,38126,0,0,38126,5.17233e+15,27.8482,1086.76,38126,33,44,3383,3383,3383,3383,3383
11560,1,28,2037,9523,0,11560,19.7232,11.6745,383.298,11560,19,23,2040,2040,2040,2040,2040
17460,9,24,17460,0,0,17460,341437000,21.7641,492.162,17460,21,22,16378,13710,13677,14044,7852
48175,24,44,48175,0,48175,0,78279600000,37.563,1037.81,48175,41,41,47829,47212,47229,46084,33366
21201,2,23,3662,17539,0,21201,19.4495,17.5537,478.101,21201,20,21,14541,14541,14504,11341,11147
27922,22,40,0,27922,27922,0,1.95173e+13,37.2073,776.633,27922,37,37,27549,26708,27118,26065,18022
42925,13,23,0,42925,7936,34989,4809.21,18.4958,708.614,42925,21,22,42726,42726,42459,42513,40755
40872,6,21,0,40872,6634,34238,5141.25,15.7621,605.961,40872,21,21,39838,39838,38770,38787,38538
34615,4,5,1,34614,34615,0,1.17574e+16,2.99613,276.987,34615,4,4,34610,34608,34609,34609,34610
29941,8,21,4792,25149,0,29941,20.1797,14.5239,495.003,29941,21,20,29775,29775,29373,29381,29643
19477,19,21,3099,16378,0,19477,19.7437,17.108,420.306,19477,20,20,19454,19454,19436,19438,19454
45880,21,40,45868,12,45880,0,2.04487e+14,1.94558,454.572,45880,17,16,45835,45828,45763,45781,45739
15108,123,351,15108,0,15108,0,1.2431e+18,25.7333,962.602,15108,55,58,14757,14713,14691,14683,14642
20296,37,56,20296,0,0,20296,5.67177e+15,22.3478,596.903,20296,30,32,20240,20224,20239,17870,18652
34523,11,40,34523,0,0,34523,5.17895e+15,33.7321,836.359,34523,40,37,32419,30014,30773,5861,13585
4867,7,19,782,4085,0,4867,19.2283,16.134,206.69,4867,18,18,4760,4760,4737,4753,3021
14058,11,13,0,14058,2421,11637,5235.38,11.1174,341.97,14058,13,12,14039,14039,14039,14038,14039
16937,25,36,16937,0,0,16937,330968000,26.5661,492.939,16937,36,33,16862,16769,16816,9347,15615
36266,6,40,36266,0,0,36266,5.64179e+15,28.4981,735.022,36266,37,37,31828,29032,23341,5030,11165
48946,18,23,0,48946,10019,38927,4647.16,19.8143,789.988,48946,22,22,48899,48895,48659,48662,48762
27105,1,2,27105,0,27105,0,6.80296e+13,1.99963,229.581,27105,2,2,20553,20553,20553,20553,20553
11797,13,19,0,11797,1839,9958,4987.11,15.318,315.519,11797,19,19,11740,11740,11722,11723,11664
49360,11,40,0,49360,49360,0,2.20321e+13,31.8687,855.017,49360,38,37,48137,46350,43767,43671,19019
48954,19,40,48954,0,48954,0,86329600000,37.396,990.161,48954,39,37,48584,48013,47862,47758,37670
33190,19,40,0,33190,33190,0,1.9818e+13,36.3539,831.627,33190,38,37,32567,31315,31917,30682,20608
35909,19,44,35909,0,0,35909,326535000,34.9683,802.77,35909,37,38,35593,35127,35382,31714,23265
3394,33,36,3394,0,0,3394,5.57377e+15,14.7658,213.365,3394,16,25,3358,3351,3358,3329,3358
42146,1,2,42146,0,42146,0,3.36733e+13,1.9996,271.165,42146,2,2,37103,37103,37103,37103,37103
41651,18,38,41651,0,0,41651,334172000,36.316,949.386,41651,38,38,41067,40397,39949,39888,26095
42348,4,28,0,42348,7069,35279,5186.5,12.5026,627.184,42348,20,21,37990,37990,34528,33026,24761
4929,1,20,4929,0,4929,0,1.47343e+18,16.1647,242.468,4929,17,18,545,545,545,545,545
18272,15,21,2940,15332,0,18272,19.8781,12.7715,407.807,18272,19,20,18235,18235,18216,18216,18120
1586,1,2,1586,0,1586,0,3.21229e+13,1.99496,53.0602,1586,2,2,1404,1404,1404,1404,1404
13608,3,4,13608,0,13608,0,6.15778e+13,1.99934,164.514,13608,3,3,13604,13602,13603,13604,13604
21725,10,40,0,21725,21725,0,2.22002e+13,24.2364,658.046,21725,32,35,20624,19728,17328,17323,4971
19493,18,40,0,19493,19493,0,2.22181e+13,21.3205,525.958,19493,29,29,19435,19375,19368,19313,17243
45687,18,40,45687,0,45687,0,8.7355e+10,22.7156,836.008,45687,32,28,45569,45413,44994,44929,37017
19391,3,36,0,19391,19391,0,2.18045e+13,25.4838,531.324,19391,36,33,13270,11350,10352,10426,4563
37129,53,54,0,37129,0,37129,4.96813e+14,36.3486,991.418,37129,37,45,37075,37060,37075,37072,36770
40804,1,4,0,40804,40804,0,1.15104e+16,2.00017,275.684,40804,3,3,34283,34283,34283,34283,34283
11305,10,13,1942,9363,0,11305,20.4048,11.4447,308.79,11305,13,12,11281,11281,11259,11258,11281
44529,15,25,10720,33809,0,44529,17.2837,18.3973,805.681,44529,23,23,44410,44410,43976,44000,36473
47376,13,23,7879,39497,0,47376,19.6315,19.2697,692.975,47376,22,21,47225,47225,47080,47116,46291
20260,1,21,3535,16725,0,20260,18.7173,17.3027,454.707,20260,20,19,4538,4538,4538,4538,4538
46112,10,49,0,46112,46108,4,4.81459e+14,36.3618,1140.84,46112,40,41,35114,24873,29146,27574,12978
49516,1,4,0,49516,49516,0,8.48986e+15,3.72754,317.194,49516,4,4,43645,43645,43645,43645,43645
21865,3,23,3750,18115,0,21865,19.3132,13.4788,483.408,21865,19,21,17478,17477,17407,16353,6717
13981,23,40,13981,0,13981,0,70985400000,32.7431,584.149,13981,36,37,13805,13256,13560,12970,9484
30556,17,48,0,30556,0,30556,6.03684e+14,36.3432,938.875,30556,42,41,28446,15925,25251,12173,9327
5207,8,22,0,5207,5207,0,2.25409e+13,16.4899,269.738,5207,19,19,4699,3885,3697,3975,2722
21098,39,40,0,21098,0,21098,1322090,21.692,543.945,21098,29,29,21058,21044,21058,21058,21058
23827,22,31,0,23827,6581,17246,3.02411e+12,18.4202,657.358,23827,25,24,23796,23791,23759,23737,22012
27136,9,56,0,27136,27136,0,2.168e+13,34.659,788.872,27136,37,48,25350,21694,21750,21762,9251
9897,4,21,0,9897,1657,8240,5067.85,11.093,315.406,9897,17,20,8933,8933,8194,6582,5371
12994,1,2,12994,0,12994,0,3.61537e+13,1.99923,149.727,12994,2,2,11324,11324,11324,11324,11324
48293,4,40,48293,0,0,48293,5.71215e+15,35.5079,900.796,48293,33,31,34299,25949,25054,5453,9855
1623,19,40,1623,0,0,1623,331534000,13.9538,181.756,1623,20,19,1583,1569,1574,1569,1225
41555,38,40,0,41555,0,41555,1300240,34.8955,797.327,41555,38,37,41512,41457,41489,41489,41511
40145,48,56,0,40145,40145,0,2.22115e+13,37.2122,822.195,40145,40,31,40089,40061,40088,40080,40087
14553,10,40,14553,0,14553,0,1.46129e+18,20.2335,500.712,14553,23,29,13783,13127,11334,8644,8145
35607,9,28,5976,29631,0,35607,20.2451,12.4782,582.171,35607,21,21,35417,35417,35129,35131,26769
33299,18,60,33299,0,0,33299,5.40489e+15,24.7163,923.335,33299,36,44,32897,32186,32232,22159,23270
33636,16,60,33636,0,0,33636,322015000,28.5436,933.462,33636,36,44,32866,30470,31515,31472,20689
21083,1,2,21083,0,21083,0,3.26427e+13,1.99929,192.575,21083,2,2,18637,18637,18637,18637,18637
44969,51,56,44969,0,44969,0,86357400000,28.1271,880.86,44969,37,40,44913,44900,44907,44913,44858
43097,25,60,43097,0,0,43097,337872000,35.9354,902.63,43097,40,40,43021,42984,42973,42938,42436
19192,1,2,19192,0,19192,0,4.01562e+13,1.99932,183.772,19192,2,2,16453,16453,16453,16453,16453
16604,7,60,16604,0,0,16604,5.30158e+15,31.1756,618.025,16604,34,40,14795,13162,12376,3330,3810
1126,13,28,0,1126,1126,0,1.90725e+13,14.5515,124.647,1126,22,17,1071,1035,1045,949,520
49261,1,2,49261,0,49261,0,3.65007e+13,1.99933,293.161,49261,2,2,42872,42872,42872,42872,42872
22514,1,2,22514,0,22514,0,3.21182e+13,1.99924,199.991,22514,2,2,19944,19944,19944,19944,19944
44386,14,56,0,44386,0,44386,1325550,36.3554,858.888,44386,40,32,43882,43311,39843,40951,26830
11070,21,40,11070,0,11070,0,84473100000,24.9113,432.032,11070,32,37,10981,10898,10927,10777,8092
19549,30,40,19549,0,0,19549,341027000,21.4897,570.297,19549,30,28,19509,19493,19503,19504,18790
47191,12,28,0,47191,7801,39390,5176.09,18.1453,662.294,47191,28,21,47126,47126,47106,47115,47085
29648,3,44,29648,0,0,29648,5.43438e+15,35.1066,730.749,29648,37,37,20232,17386,16016,3927,5346
35928,1,4,0,35928,35928,0,8.62212e+15,2.00006,255.591,35928,3,3,31626,31626,31626,31626,31626
44780,1,2,0,44780,44780,0,1.37292e+16,1.99982,288.258,44780,2,2,36247,36247,36247,36247,36247
3748,1,2,3748,0,3748,0,3.25934e+13,1.9928,81.3641,3748,2,2,3313,3313,3313,3313,3313
45630,36,40,45630,0,0,45630,337106000,27.7057,823.849,45630,38,37,45582,45544,45542,39759,45546
13875,15,36,0,13875,0,13875,1268170,29.2032,461.612,13875,33,33,13654,13362,13533,13526,8411
11083,16,38,0,11083,0,11083,1330610,20.1539,439.045,11083,30,25,10947,10633,10514,10467,9469
22038,43,44,22038,0,0,22038,5.06711e+15,32.1823,730.508,22038,37,41,21994,21983,21934,20994,21028
19118,3,28,3163,15955,0,19118,19.8307,12.9007,460.6,19118,19,25,15155,15155,14995,13656,8260
33189,22,44,0,33189,33189,0,2.03747e+13,32.2695,852.243,33189,39,41,32870,32192,32527,31649,20632
42214,11701,11954,41586,628,0,42214,1.2921e+18,302.616,15121.8,42214,3152,264,30260,30260,30223,30230,22264
16712,1,13,2712,14000,0,16712,20.3229,10.3405,356.288,16712,12,12,2875,2875,2875,2875,2875
34429,4,48,34429,0,34429,0,1.20623e+18,38.0354,970.295,34429,37,41,22674,18290,18466,5903,4667
15640,10,13,2648,12992,0,15640,20.4115,11.2935,357.668,15640,13,12,15614,15614,15592,15591,15614
8583,5,40,8583,0,0,8583,338312000,21.4981,392.237,8583,27,26,6662,4934,4870,4025,2183
24950,1,2,24950,0,24950,0,4.19336e+13,1.9996,211.229,24950,2,2,21232,21232,21232,21232,21232
35502,4,38,35502,0,35502,0,1.45426e+18,34.1569,852.396,35502,38,38,24453,18425,17466,3744,7009
16815,1,2,0,16815,16815,0,8.3478e+15,1.99905,171.342,16815,2,2,14866,14866,14866,14866,14866
26656,9,40,26656,0,0,26656,339683000,22.7153,615.293,26656,30,29,25168,21384,21295,21722,12969
7795,21,22,7795,0,0,7795,342793000,19.5117,333.183,7795,20,20,7772,7748,7771,7770,7772
15485,36,40,0,15485,0,15485,1297460,24.4407,494.345,15485,36,36,15445,15435,15405,15405,15405
17914,15,40,17914,0,17914,0,86778800000,21.21,506.909,17914,29,29,17793,17583,17542,17502,14078
26605,1,2,26605,0,26605,0,3.26386e+13,1.9997,215.943,26605,2,2,23519,23519,23519,23519,23519
5584,6,23,2107,3477,0,5584,14.808,15.7083,297.99,5584,18,21,4343,4343,4319,4332,1897
11093,71,2382,3512,7581,10821,272,1.97135e+18,181.578,3793.79,11093,445,169,5799,3646,4109,4032,974
19324,25,44,0,19324,0,19324,1292370,32.917,603.698,19324,36,41,19237,19157,19180,19177,15772
4654,24,38,4654,0,0,4654,5.54676e+15,28.4792,349.488,4654,32,30,4556,4407,4438,4457,2409
38140,2,5,38140,0,38140,0,4.76456e+13,1.99963,269.219,38140,3,4,38134,38133,36502,38133,38134
47799,20,60,47799,0,47799,0,85732200000,35.109,966.327,47799,40,40,47597,47295,47387,47123,39422
29385,10,44,0,29385,29385,0,2.14556e+13,26.0845,719.163,29385,36,37,28181,27099,25295,25102,12101
29130,23,40,0,29130,0,29130,1284100,33.1792,681.661,29130,37,37,28964,28699,28814,28808,20219
5322,11,12,946,4376,0,5322,20.457,10.5787,215.052,5322,12,12,5307,5307,5307,5306,5307
15947,18,28,0,15947,2708,13239,4986.05,15.4502,481.11,15947,19,28,15912,15911,15867,15868,11387
40851,19,28,0,40851,6724,34127,5132.23,15.5172,640.356,40851,21,27,40817,40817,40799,40799,40474
22682,7,40,0,22682,22682,0,1.98895e+13,35.0566,674.613,22682,36,35,19822,17575,17046,16833,6222
18780,2,13,0,18780,3033,15747,5187.5,11.4482,383.076,18780,13,13,12731,12731,12665,8814,8814
2888,15,18,2888,0,2888,0,1.48027e+18,16.6704,189.821,2888,17,18,2861,2832,2830,2415,2803
5464,1,2,0,5464,5464,0,8.33463e+15,1.99671,97.1689,5464,2,2,4831,4831,4831,4831,4831
46302,18,56,46302,0,46302,0,86882200000,35.0434,883.371,46302,40,32,46128,45906,45500,45378,35243
9210,15,36,9210,0,9210,0,61103300000,28.3801,473.635,9210,31,30,7873,3584,6601,6102,5317
14483,19,60,0,14483,14483,0,2.10871e+13,22.7219,608.842,14483,32,40,14294,13985,14176,13897,11220
48662,36,56,48662,0,48662,0,87073600000,22.3907,871.335,48662,32,32,48606,48588,48603,48602,47441
26150,24,40,26150,0,26150,0,1.4104e+18,32.1633,649.676,26150,37,36,26014,25840,25881,7907,19855
33065,12,40,33065,0,0,33065,340564000,22.4195,718.244,33065,32,24,32227,30453,27916,28918,22759
36010,51,56,0,36010,36010,0,2.22696e+13,21.984,763.685,36010,32,32,35954,35943,35954,35954,35954
30351,14,19,5449,24902,0,30351,20.2604,15.6001,555.213,30351,19,19,30307,30307,30307,30307,30307
23656,13,30,4092,19564,0,23656,20.2732,12.955,512.045,23656,20,23,23619,23619,23619,23619,23468
11095,15,39,0,11095,4272,6823,3.89664e+13,22.9945,408.485,11095,30,18,11036,11012,10957,10667,10817
22862,1,2,22862,0,22862,0,4.29686e+13,1.99934,202.652,22862,2,2,19371,19371,19371,19371,19371
27270,1,2,27270,0,27270,0,3.36284e+13,1.99956,219.589,27270,2,2,24011,24011,24011,24011,24011
22157,1,4,0,22157,22157,0,8.86532e+15,1.99928,201.696,22157,3,3,19428,19428,19428,19428,19428
28408,1,2,0,28408,28408,0,8.82711e+15,1.99947,221.687,28408,2,2,24927,24927,24927,24927,24927
43155,13,44,43155,0,43155,0,1.34257e+18,39.913,976.113,43155,41,41,41207,37778,39631,9920,17452
1264,14,24,1264,0,0,1264,333580000,13.5918,138.435,1264,16,19,1236,1224,1110,1192,958
44444,36,48,44444,0,0,44444,5.01664e+15,36.6512,1064.68,44444,37,41,44392,44348,44122,38141,41683
45791,4,44,45791,0,0,45791,5.48817e+15,37.6003,895.491,45791,38,38,34380,27008,26628,5934,8805
8506,10,12,1504,7002,0,8506,20.3917,11.6532,274.218,8506,12,12,8482,8482,8453,8452,6602
40256,14,21,6465,33791,0,40256,19.7368,18.8486,610.005,40256,21,21,40154,40151,40105,40107,39841
46243,28,40,46243,0,46243,0,1.44576e+18,31.6393,829.21,46243,38,37,46159,46061,46102,25686,42979
3440,14,24,3440,0,0,3440,337476000,15.2826,222.554,3440,18,21,3392,3348,3105,3269,3081
25820,62,64,25820,0,25820,0,1.23276e+18,29.5329,931.27,25820,44,44,25756,25748,25756,25033,24504
4388,1,2,0,4388,4388,0,1.06083e+16,1.99157,87.2396,4388,2,2,3741,3741,3741,3741,3741
9352,20,21,0,9352,1695,7657,4751.66,12.0174,315.668,9352,18,19,9331,9331,9302,9302,9328
49811,1,2,49811,0,49811,0,3.6448e+13,1.99966,294.823,49811,2,2,43360,43360,43360,43360,43360
25802,11,44,25802,0,0,25802,5.42245e+15,35.1186,692.827,25802,37,37,24769,23533,23145,4003,12344
8955,1,2,8955,0,8955,0,6.8805e+13,1.99911,132.348,8955,2,2,6765,6765,6765,6765,6765
12236,1,2,12236,0,12236,0,3.5932e+13,1.99869,145.851,12236,2,2,10673,10673,10673,10673,10673
22920,19,28,3898,19022,0,22920,20.2131,12.0164,480.285,22920,20,21,22891,22891,22889,22889,22880
7462,21,36,0,7462,0,7462,1311390,16.6923,307.126,7462,25,25,7426,7408,7418,7416,7424
9623,12,19,0,9623,3002,6621,3875.51,17.3252,361.851,9623,19,18,9491,9477,9394,9415,8460
18136,5,24,18136,0,0,18136,5.72964e+15,21.0162,525.483,18136,23,22,14050,10372,10462,2859,5690
18603,12,30,0,18603,3470,15133,4994.55,12.4371,506.487,18603,19,24,18513,18509,18458,18472,17736
18175,48,65,18175,0,18175,0,1.34451e+18,23.9724,818.568,18175,38,48,18110,18106,18107,18042,14411
1170,6,14,1170,0,1170,0,8.7867e+10,13.2863,109.944,1170,14,14,1015,919,689,886,650
33511,26,56,33511,0,0,33511,5.70758e+15,22.4239,741.241,33511,32,32,33455,33443,33444,33358,33420
23771,9,20,4054,19717,0,23771,20.2896,12.2198,472.131,23771,20,17,23632,23632,23415,23412,18492
2326,17,32,0,2326,0,2326,1202640,21.4561,182.697,2326,23,21,2261,2203,2237,2232,1154
12522,1,2,12522,0,12522,0,3.26387e+13,1.99888,147.548,12522,2,2,11069,11069,11069,11069,11069
3141,1,2,0,3141,3141,0,8.25875e+15,1.99618,74.6458,3141,2,2,2780,2780,2780,2780,2780
13924,1,2,13924,0,13924,0,3.31528e+13,1.99835,155.486,13924,2,2,12283,12283,12283,12283,12283
42460,18,23,10304,32156,0,42460,17.0467,19.4051,763.521,42460,23,21,42415,42412,42122,42123,40867
40011,15,40,0,40011,0,40011,1330860,31.7338,810.303,40011,32,31,39589,38870,37706,36631,28754
21316,31,40,21316,0,21316,0,1.27018e+18,35.2407,681.385,21316,37,37,21247,21027,21031,18466,19396
46943,5,44,46943,0,46943,0,80569300000,35.6996,977.264,46943,39,41,37614,29204,31092,31985,9239
15301,17,24,15301,0,0,15301,5.74481e+15,20.8015,462.134,15301,22,21,15237,14992,15082,12334,13440
27599,37,44,27599,0,27599,0,69084300000,34.887,846.141,27599,37,37,27554,27532,27318,27370,27061
38712,1,4,0,38712,38712,0,8.30546e+15,3.86164,272.967,38712,4,4,34239,34239,34239,34239,34239
11951,13,24,0,11951,11951,0,2.24565e+13,19.1361,404.689,11951,20,21,11755,11086,10612,11248,9016
11762,15,22,11762,0,0,11762,5.73652e+15,20.9092,423.481,11762,22,22,11609,11348,11032,9494,9503
10680,15,40,10680,0,10680,0,1.33692e+18,29.8935,454.564,10680,32,33,10339,9698,10136,3958,7382
42440,22,56,42440,0,42440,0,1.4396e+18,34.9409,980.079,42440,51,42,42176,41854,41919,13951,29714
32781,34,66,32781,0,0,32781,6.10509e+15,31.6943,1125.98,32781,38,59,32691,32557,32527,25996,26398
5536,2,22,0,5536,0,5536,1342540,18.6875,286.384,5536,20,20,2914,2914,1872,804,940
21599,37,49,0,21599,21595,4,1.00962e+15,33.5869,802.469,21599,38,41,21550,21522,21400,21470,19565
30738,29,40,30738,0,0,30738,340083000,34.9987,734.261,30738,32,31,30679,30612,30654,30654,29215
35933,4,56,35933,0,35933,0,1.44414e+18,29.0719,800.461,35933,45,40,26377,20301,19765,4576,8967
35848,55,60,35848,0,0,35848,331398000,25.9258,873.986,35848,33,40,35788,35777,35785,35557,34529
42341,1,5,6,42335,42341,0,1.40861e+16,1.99965,288.278,42341,4,3,34060,34060,34060,34060,34060
43685,3,4,0,43685,43685,0,8.34308e+15,3.07108,284.276,43685,4,4,43679,43675,43678,43678,42865
29622,1,4,0,29622,29622,0,8.32912e+15,3.72416,237.461,29622,4,4,26191,26191,26191,26191,26191
36302,18,44,36302,0,36302,0,83590800000,32.2731,792.594,36302,37,37,35951,35503,35721,35209,23541
31691,32,40,31691,0,0,31691,4.6331e+15,35.7088,885.703,31691,37,37,31621,31520,31323,28977,29727
14738,1,36,0,14738,0,14738,1295690,23.9268,460.943,14738,34,33,1842,1842,1842,1842,1842
14912,1,2,0,14912,14912,0,9.01686e+15,1.99819,160.581,14912,2,2,13045,13045,13045,13045,13045
31354,29,56,0,31354,31354,0,2.1948e+13,30.3244,745.542,31354,37,40,31268,31185,31202,31178,23983
6054,1,11,0,6054,947,5107,5176.33,9.63016,204.84,6054,11,11,1081,1081,1081,1081,1081
42580,35,40,42580,0,0,42580,5.65438e+15,29.5696,811.77,42580,40,36,42529,42463,42486,34171,42485
22987,1,2,22987,0,22987,0,3.25471e+13,1.9993,200.767,22987,2,2,20328,20328,20328,20328,20328
33739,22,23,5668,28071,0,33739,19.3952,19.0549,593.179,33739,21,21,33715,33715,33663,33663,33713
46813,14,23,0,46813,7803,39010,4997.53,19.5438,687.489,46813,21,21,46679,46673,46552,46557,45943
8395,15,64,8395,0,0,8395,265558000,26.555,572.117,8395,29,43,7483,4758,6594,6508,2767
3170,4,18,3170,0,3170,0,88218900000,16.2852,205.995,3170,17,18,2239,1688,1648,1963,921
7813,5,21,0,7813,1231,6582,5115.54,10.4043,260.146,7813,19,20,7388,7388,6679,6659,6671
15022,33,40,0,15022,0,15022,1330770,20.1789,504.015,15022,30,24,14982,14968,14980,14980,14831
20941,17,23,3554,17387,0,20941,19.4476,15.8063,469.709,20941,20,21,20910,20910,20864,20866,20638
38448,14,60,38448,0,38448,0,86129500000,38.1484,876.336,38448,40,40,37845,37000,34177,36030,24632
15708,9,56,15708,0,15708,0,1.46071e+18,19.7351,536.858,15708,24,32,14519,11894,11788,10056,8955
48872,8,48,48872,0,48872,0,7.6045e+10,37.3848,1106.51,48872,40,41,41627,35465,35668,34924,13258
30987,43,44,0,30987,30987,0,1.79212e+13,34.2288,884.793,30987,38,37,30943,30924,30873,30874,30941
11385,14,38,0,11385,11385,0,2.22784e+13,20.6738,445.263,11385,27,27,11171,10945,10088,10287,8112
9269,576,1892,3238,6031,808,8461,3.55225e+12,128.52,2970.8,9269,363,167,7377,7194,6220,6308,3448
11425,6,40,0,11425,0,11425,1319710,18.6795,404.269,11425,28,29,9995,9100,7291,7826,3708
27722,14,40,27722,0,0,27722,5.7033e+15,22.897,631.937,27722,31,24,27488,27207,24973,3347,18842
15633,6,19,0,15633,2751,12882,5203.91,11.183,388.812,15633,19,16,15037,15037,14379,14067,11475
9365,17,22,0,9365,0,9365,1340420,20.2783,370.338,9365,21,21,9308,9097,9187,9184,8615
4541,1,4,0,4541,4541,0,8.60058e+15,1.99912,94.1517,4541,3,3,3996,3996,3996,3996,3996
29761,5,60,29761,0,0,29761,5.44125e+15,36.5466,800.46,29761,37,43,23946,18387,19243,4468,5687
29164,20,24,29164,0,29164,0,1.4674e+18,21.5845,637.073,29164,24,22,29124,29060,29048,25724,28013
24719,41,44,0,24719,0,24719,1260660,39.0233,685.676,24719,36,35,24675,24663,24589,24589,22284
33001,2,21,0,33001,5339,27662,5124.75,16.5309,547.019,33001,21,21,22599,22599,22500,16389,16351
11356,1,13,1887,9469,0,11356,20.3741,10.1284,299.822,11356,11,12,1907,1907,1907,1907,1907
27275,2,24,27275,0,0,27275,341801000,21.5092,615.453,27275,24,22,14984,14983,9987,4460,4844
22586,19,24,0,22586,0,22586,1333780,20.6621,574.673,22586,24,22,22534,22437,22475,22474,20648
33852,9,30,5866,27986,0,33852,19.6244,13.9005,637.784,33852,20,26,33512,33512,33288,33343,32353
46291,6,23,0,46291,7662,38629,5028.95,16.7337,677.731,46291,21,21,44935,44935,43903,43957,43468
39867,1,5,1,39866,39867,0,1.47958e+16,2.33838,297.272,39867,4,4,31651,31651,31651,31651,31651
40684,33,40,0,40684,0,40684,1316040,32.2063,910.278,40684,38,36,40607,40384,40500,40499,40434
1409,12,18,0,1409,0,1409,1353140,16.0617,137.597,1409,16,18,1351,1245,1209,1206,1089
47129,32,64,47129,0,0,47129,296124000,33.5455,1194.61,47129,37,44,47027,46916,46581,42940,26016
7736,14,22,7736,0,7736,0,1.47323e+18,19.3479,340.015,7736,21,21,7610,7468,6916,6394,6299
36693,19,30,6309,30384,0,36693,19.3364,19.1854,713.738,36693,21,29,36657,36657,36573,36573,35269
25804,15,40,0,25804,0,25804,1331620,21.5512,641.104,25804,31,25,25558,25143,24420,23905,19421
5017,5,13,0,5017,843,4174,5213.07,9.57963,202.285,5017,11,12,4685,4685,4158,4035,1195
35801,31,44,35801,0,0,35801,260911000,36.8328,982.398,35801,38,37,35713,35404,35285,32466,32568
3076,1,32,3076,0,3076,0,59671600000,25.7048,269.827,3076,28,29,107,107,107,107,107
16113,1,2,0,16113,16113,0,8.9977e+15,1.99863,167.142,16113,2,2,14100,14100,14100,14100,14100
24932,29,44,24932,0,24932,0,82644200000,33.4457,679.862,24932,36,37,24854,24720,24731,24648,20348
27594,24,40,0,27594,27594,0,2.22687e+13,22.4026,624.415,27594,30,29,27552,27533,27544,27536,26184
19638,1,4,0,19638,19638,0,1.12464e+16,1.99919,194.462,19638,3,3,16570,16570,16570,16570,16570
3977,6,20,3977,0,0,3977,335207000,15.341,209.051,3977,17,17,3569,3303,2651,3104,1661
19985,433,2748,19653,332,19653,332,1.56611e+18,142.98,4607.21,19985,632,189,17237,16704,12676,14704,5013
21382,12,21,3408,17974,0,21382,19.9134,12.2742,434.74,21382,19,20,21321,21320,21279,21298,21195
9598,1,24,9598,0,9598,0,1.46401e+18,18.2359,357.901,9598,19,21,1077,1077,1077,1077,1077
763,3,8,130,633,0,763,20.6081,7.67235,70.7518,763,8,8,592,592,592,411,382
25382,53,60,0,25382,25382,0,2.1398e+13,23.4007,816.69,25382,32,44,25322,25315,25316,25322,24371
15086,7,21,0,15086,2395,12691,5129.64,16.9846,357.006,15086,20,20,14868,14868,14566,14576,8668
33161,25,40,33161,0,0,33161,5.70508e+15,34.1525,745.575,33161,32,31,33106,33065,33081,31265,31192
13860,18,21,2225,11635,0,13860,20.1146,12.2269,345.95,13860,20,20,13836,13836,13836,13836,13833
575,1,18,575,0,0,575,5.75873e+15,14.3565,88.1974,575,13,17,54,54,54,54,54
10772,32,40,10772,0,10772,0,85778100000,18.6475,426.008,10772,26,35,10732,10725,10703,10707,10668
24666,33,44,0,24666,0,24666,1051520,38.8916,812.915,24666,36,39,24602,24516,24250,24264,17072
26885,33,40,26885,0,26885,0,1.45912e+18,22.6413,617.707,26885,30,29,26845,26828,26844,22513,26843
2156,19,20,2156,0,0,2156,5.74282e+15,13.6058,158.824,2156,15,17,2136,2128,2135,1971,2136
47679,29,30,0,47679,9057,38622,4887.45,15.6602,810.288,47679,21,26,47649,47649,47649,47649,47608
41755,17,56,41755,0,0,41755,336923000,28.7324,855.015,41755,37,40,41491,40787,41104,40786,30207
12194,1,36,12194,0,0,12194,5.68462e+15,18.4756,404.753,12194,28,25,1429,1429,1429,1429,1429
17062,1,13,2813,14249,0,17062,20.3467,11.5905,367.116,17062,13,13,2885,2885,2885,2885,2885
32269,8,44,0,32269,0,32269,1207860,32.9539,831.282,32269,40,37,28805,25281,25056,25487,10590
47980,14,40,47980,0,0,47980,334508000,33.0198,859.024,47980,39,37,47482,46875,45844,46156,27097
29217,19,40,0,29217,29217,0,2.12538e+13,28.0825,713.53,29217,37,35,28934,28496,28757,28224,19245
33245,28,40,33245,0,33245,0,1.42496e+18,31.1966,710.637,33245,37,37,33153,33016,33066,22089,28003
46648,21,40,0,46648,0,46648,1329370,32.4613,900.02,46648,33,31,46526,46155,46365,46361,42581
848,15,24,0,848,0,848,940071,20.0825,131.372,848,22,22,706,258,573,558,571
29403,6,23,0,29403,8853,20550,4022.41,19.326,659.049,29403,22,21,24947,24947,24707,24838,17336
13937,30,36,13937,0,13937,0,1.4346e+18,22.7818,429.719,13937,29,25,13893,13843,13885,11655,11706
38468,6,20,6637,31831,0,38468,20.3023,16.5951,606.612,38468,20,20,37130,37130,35624,35140,33632
16359,24,40,16359,0,16359,0,62499300000,32.3526,654.086,16359,34,33,16217,15969,15455,14980,13290
10082,15,36,10082,0,0,10082,4.29801e+15,31.2554,489.698,10082,33,33,9140,6584,8431,3126,5396
32720,8,40,0,32720,32720,0,2.22022e+13,21.6169,672.657,32720,30,29,30283,26143,24677,26419,14000
2611,5,12,466,2145,0,2611,20.4397,9.68211,150.958,2611,11,11,2395,2395,2133,2012,1140
28554,1,2,28554,0,28554,0,3.59705e+13,1.99933,224.666,28554,2,2,24904,24904,24904,24904,24904
10146,1,2,0,10146,10146,0,8.37334e+15,1.99941,132.965,10146,2,2,8966,8966,8966,8966,8966
39237,52,60,39237,0,39237,0,1.40807e+18,36.9911,1003.17,39237,51,42,39177,39165,39176,34132,35041
31369,1,2,31369,0,31369,0,5.50944e+13,1.99959,240.468,31369,2,2,25228,25228,25228,25228,25228
17887,22,56,17887,0,0,17887,331920000,38.171,583.315,17887,36,38,17767,17665,17704,16806,13335
43310,42,44,0,43310,0,43310,1193220,37.7327,996.996,43310,41,41,43266,43245,43174,43174,43266
26096,11,40,26096,0,0,26096,5.69827e+15,22.6032,609.013,26096,30,29,25397,24372,22489,6677,14514
10706,28,64,10706,0,10706,0,1.29849e+18,33.5181,682.583,10706,42,46,10588,10424,10433,6927,4827
4035,1,2,4035,0,4035,0,5.37837e+13,1.99678,88.5395,4035,2,2,3263,3263,3263,3263,3263
42059,36,44,42059,0,42059,0,1.17552e+18,36.9934,1030.74,42059,39,39,42007,41967,41648,39785,41244
16619,18,60,16619,0,16619,0,1.45999e+18,23.2446,585.903,16619,25,39,16515,16424,16259,13347,14392
10165,2,36,10165,0,10165,0,64370900000,32.2005,499.517,10165,33,33,5007,4907,4495,3940,950
42293,14,40,42293,0,42293,0,87168800000,37.4075,842.887,42293,33,31,41713,41071,37468,38856,25624
33878,8,24,0,33878,33878,0,2.23178e+13,21.3433,702.511,33878,24,22,30906,26061,23968,26384,14414
14544,1,2,0,14544,14544,0,8.58607e+15,1.99869,158.575,14544,2,2,12810,12810,12810,12810,12810
28859,1,2,28859,0,28859,0,3.24302e+13,1.99955,225.614,28859,2,2,25533,25533,25533,25533,25533
38566,12,28,0,38566,6392,32174,5177.43,11.9769,599.645,38566,20,21,38519,38519,38503,38508,38481
27855,1,2,27855,0,27855,0,3.25785e+13,1.99889,221.085,27855,2,2,24630,24630,24630,24630,24630
5669,16,22,5669,0,5669,0,8.7854e+10,17.088,279.333,5669,19,19,5628,5539,5525,5527,5156
23362,5,19,0,23362,4206,19156,5186.54,14.8139,485.147,23362,19,19,21339,21339,19050,18129,11809
26429,40,56,0,26429,0,26429,1302110,31.5446,776.005,26429,38,43,26373,26363,26373,26373,26371
28998,10,44,0,28998,0,28998,1211540,31.6741,811.218,28998,37,41,26734,24717,24026,23878,11224
33297,43,44,0,33297,0,33297,1270680,33.0307,762.834,33297,37,37,33253,33234,33223,33224,33251
11682,1,2,11682,0,11682,0,3.55398e+13,1.99914,142.697,11682,2,2,10206,10206,10206,10206,10206
12514,15,19,0,12514,2244,10270,5159.11,17.3609,364.834,12514,19,19,12483,12483,12483,12483,12483
40616,1,4,0,40616,40616,0,8.33481e+15,3.15223,274.423,40616,4,4,35913,35913,35913,35913,35913
30776,17,40,30776,0,0,30776,334731000,29.4284,675.722,30776,36,37,30595,30253,30482,30156,22618
27536,14,20,4832,22704,0,27536,20.1007,13.9224,567.151,27536,19,20,27465,27465,27421,27421,27368
26833,3,4,0,26833,26833,0,8.77592e+15,2.00015,221.516,26833,3,3,26829,26827,26828,26828,26829
3905,9,11,639,3266,0,3905,20.4015,9.49424,167.285,3905,11,10,3888,3888,3887,3887,3888
38596,28,40,38596,0,0,38596,332823000,34.4492,770.564,38596,38,37,38496,38363,38401,30717,34428
37479,1,23,0,37479,7615,29864,4687.11,19.7045,693.288,37479,22,22,8312,8312,8312,8312,8312
13553,1,96,237,13316,13541,12,4.06198e+15,2.74198,382.771,13553,28,22,12532,12532,12532,12532,12532
44953,28,30,7690,37263,0,44953,19.6372,17.1183,721.786,44953,21,27,44923,44923,44923,44923,44721
9191,5,19,0,9191,1659,7532,5186.74,11.1586,306.592,9191,19,16,8385,8385,7488,7156,6298
36116,29,56,0,36116,36116,0,2.22668e+13,22.3099,764.387,36116,32,32,36060,36034,36046,36047,35137
34108,21,40,34108,0,34108,0,87202400000,22.6177,710.094,34108,32,29,34054,33966,34020,34011,29571
7693,34,36,7693,0,0,7693,335248000,18.4959,314.406,7693,26,25,7657,7645,7657,7657,7657
11319,17,24,11319,0,11319,0,1.46677e+18,17.7987,386.07,11319,19,21,11278,11151,11193,9692,10305
8277,1,2,8277,0,8277,0,5.06022e+13,1.99674,122.571,8277,2,2,6788,6788,6788,6788,6788
38949,13,56,0,38949,38949,0,2.18437e+13,32.5539,917.182,38949,38,49,38061,36084,35796,36006,16247
42807,36,60,0,42807,42807,0,2.17747e+13,26.4393,933.68,42807,33,40,42747,42731,42612,42602,37751
26807,21,40,26807,0,26807,0,1.437e+18,31.8362,644.634,26807,37,37,26695,26587,26619,8800,21186
27514,1,2,0,27514,27514,0,9.69009e+15,1.99927,219.456,27514,2,2,23813,23813,23813,23813,23813
29993,1,19,0,29993,5514,24479,5124.03,17.325,594.029,29993,19,19,4554,4554,4554,4554,4554
26253,1,21,0,26253,4261,21992,5016.75,17.0685,497.578,26253,20,20,5204,5204,5204,5204,5204
16349,32,36,0,16349,16349,0,2.15835e+13,26.4677,480.862,16349,35,33,16303,16255,16272,16261,15478
47430,15,20,0,47430,8099,39331,5207.87,12.5042,654.174,47430,20,19,47405,47405,47405,47405,47405
39588,11,44,0,39588,39588,0,2.15089e+13,30.5659,825.278,39588,37,37,38298,36630,35567,34918,14908
16803,5,40,16803,0,0,16803,5.67493e+15,22.1152,492.526,16803,29,29,13587,10220,10456,2546,5882
9331,19,20,9331,0,0,9331,5.69285e+15,17.14,328.205,9331,20,19,9309,9285,9301,8721,9244
17386,3,56,0,17386,0,17386,1310450,20.8774,597.323,17386,30,39,11215,9497,8434,4712,3319
5544,11,13,0,5544,929,4615,5216.97,9.56133,212.853,5544,11,12,5530,5530,5529,5528,5529
30216,35,40,30216,0,30216,0,1.45104e+18,26.6754,644.483,30216,30,29,30171,30131,30166,26031,30118
41526,9,28,0,41526,6976,34550,5173.88,18.5177,638.633,41526,28,21,41286,41286,40936,40938,40752
11148,5,40,0,11148,11148,0,1.90219e+13,33.3016,506.359,11148,34,37,8455,6671,7208,6955,2949
46916,5,40,46916,0,46916,0,1.45775e+18,25.9698,846.441,46916,33,29,37424,27962,28274,5608,13232
5124,7,17,1976,3148,0,5124,13.95,15.1282,256.548,5124,17,16,4289,4289,4267,4289,3166
32030,6,40,32030,0,32030,0,1.29499e+18,34.765,816.89,32030,38,37,26985,24361,22113,4994,8580
18044,9,13,3109,14935,0,18044,20.4192,11.241,390.497,18044,13,12,17955,17955,17798,17797,17865
26016,37,40,26016,0,0,26016,317449000,30.0473,675.496,26016,37,35,25975,25955,25904,24213,25974
6198,1,22,6198,0,0,6198,5.7632e+15,16.9187,290.464,6198,19,19,643,643,643,643,643
4037,2,44,0,4037,4037,0,2.24652e+13,17.0575,270.821,4037,18,32,2149,2149,1402,1771,677
8976,30,44,8976,0,0,8976,4.56745e+15,32.1942,490.858,8976,35,39,8914,8816,8702,5240,5423
42480,14,30,0,42480,7352,35128,5082.52,13.3092,702.118,42480,20,25,42412,42408,42328,42332,41612
21065,5,19,3800,17265,0,21065,20.2041,15.1788,464.058,21065,19,19,19215,19215,17181,16278,11024
35305,36,60,0,35305,35305,0,2.14089e+13,33.7202,860.871,35305,37,43,35241,35202,35069,35052,25105
7608,1,22,7608,0,0,7608,5.76284e+15,19.3804,330.353,7608,20,20,763,763,763,763,763
14240,7,21,2321,11919,0,14240,20.2323,10.2576,345.889,14240,19,20,14017,14017,13659,13664,13722
15587,3,36,15587,0,15587,0,67649300000,30.998,615.848,15587,36,33,9184,7970,7791,6548,2071
11547,19,33,0,11547,3355,8192,6.24018e+12,16.2093,530.969,11547,19,32,11513,11513,11493,11474,6989
35356,1,40,0,35356,35356,0,2.23572e+13,22.7173,741.203,35356,32,28,3739,3739,3739,3739,3739
40329,24,44,40329,0,40329,0,1.16541e+18,36.6033,1018.96,40329,38,39,39947,39204,39087,18322,30413
17814,2,64,17814,0,0,17814,266062000,33.1321,786.748,17814,34,43,8496,8338,7165,4852,1813
32312,15,23,10047,22265,0,32312,15.5222,19.2533,691.724,32312,22,21,32217,32217,31923,31934,31549
27438,1,2,27438,0,27438,0,3.28993e+13,1.99974,218.473,27438,2,2,24230,24230,24230,24230,24230
17559,1,2,17559,0,17559,0,3.73665e+13,1.99886,175.418,17559,2,2,15227,15227,15227,15227,15227
44347,33,56,0,44347,0,44347,1315220,29.0723,869.769,44347,39,40,44274,44209,44217,44216,34058
2092,14,36,2092,0,0,2092,5.60367e+15,14.7873,176.727,2092,16,25,2053,2035,2044,1721,1902
10540,14,38,10540,0,0,10540,339416000,21.1961,430.394,10540,26,28,10338,10128,9279,9195,7175
29334,52,60,0,29334,0,29334,1276270,31.8119,910.026,29334,38,51,29274,29266,29270,29273,28066
1820,4,18,1820,0,1820,0,87485200000,13.3962,144.439,1820,14,15,1342,1022,967,1154,642
17010,1,2,0,17010,17010,0,8.44696e+15,1.99953,171.662,17010,2,2,15015,15015,15015,15015,15015
12331,6,24,12331,0,12331,0,87771800000,20.58,419.622,12331,21,21,10419,9267,7363,9030,4809
14315,36,44,14315,0,0,14315,5.42304e+15,21.4154,534.714,14315,32,37,14271,14262,14187,13308,13100
16961,35,40,16961,0,0,16961,338365000,18.8303,480.209,16961,26,29,16921,16908,16921,16919,16921
7882,1,12,1391,6491,0,7882,20.4278,11.4109,261.604,7882,12,12,1239,1239,1239,1239,1239
18230,1,2,18230,0,18230,0,3.22392e+13,1.99852,179.785,18230,2,2,16141,16141,16141,16141,16141
21997,1,2,21997,0,21997,0,3.21693e+13,1.99895,197.631,21997,2,2,19482,19482,19482,19482,19482
38105,18,56,0,38105,0,38105,1315360,29.5003,824.708,38105,37,40,37910,37703,37611,37605,29431
4321,1,2,0,4321,4321,0,8.28804e+15,1.99676,87.4727,4321,2,2,3823,3823,3823,3823,3823
604,6,14,0,604,604,0,2.23762e+13,9.39238,75.1795,604,11,11,532,488,423,467,380
39077,2,65,39077,0,39077,0,1.23084e+18,31.5492,1192.26,39077,45,48,17701,17406,13587,5542,3515
14620,16,19,2625,11995,0,14620,20.2047,16.6393,391.163,14620,19,19,14592,14592,14592,14592,14592
42867,3,4,0,42867,42867,0,8.37285e+15,3.6243,280.917,42867,4,4,42861,42857,42860,42860,42169
18319,165,406,18319,0,16344,1975,5.25841e+16,4.08112,754.736,18319,159,58,17913,17893,17876,17887,17845
37648,26,40,37648,0,0,37648,340753000,22.4946,741.104,37648,32,29,37608,37587,37600,37599,37606
41763,1,2,0,41763,41763,0,1.63774e+16,1.99964,284.227,41763,2,2,32270,32270,32270,32270,32270
46285,14,44,46285,0,0,46285,5.12942e+15,37.4646,1021.31,46285,40,41,44188,40242,42638,8656,22268
7554,12,13,0,7554,1252,6302,5215.7,10.0487,244.054,7554,12,12,7540,7540,7538,7539,7540
29006,7,40,29006,0,0,29006,339098000,20.7438,627.899,29006,29,29,26179,23109,20653,21819,10694
26142,15,44,26142,0,26142,0,77509900000,35.876,769.58,26142,38,41,25060,22606,24307,23386,12351
3768,10,20,3768,0,0,3768,340282000,16.5085,208.874,3768,16,17,3656,3560,3207,3196,2759
37067,53,56,37067,0,37067,0,86318800000,24.0017,812.448,37067,33,40,37011,37000,37008,37011,36981
1920,1,2,1920,0,1920,0,6.94891e+13,1.98698,60.0976,1920,2,2,1445,1445,1445,1445,1445
25049,1,21,4003,21046,0,25049,20.1428,15.2201,456.444,25049,21,20,4481,4481,4481,4481,4481
19420,7,56,0,19420,19420,0,2.20912e+13,22.3064,578.063,19420,29,32,17329,15161,13270,14807,6589
5450,1,2,5450,0,5450,0,3.24342e+13,1.99615,96.8401,5450,2,2,4821,4821,4821,4821,4821
31573,14,23,0,31573,6209,25364,4718.58,17.3216,628.169,31573,21,22,31445,31435,31205,31223,28591
20086,19,44,0,20086,0,20086,1254120,29.2706,609.801,20086,36,37,19853,19494,19713,19682,13276
49788,1,2,49788,0,49788,0,3.25188e+13,1.99954,296.275,49788,2,2,44035,44035,44035,44035,44035
28994,43,65,28993,1,28993,1,2.96178e+12,27.2988,1037.11,28994,36,48,28929,28923,28753,28771,18630
42279,1,21,6843,35436,0,42279,20.2265,13.9327,592.652,42279,21,20,7392,7392,7392,7392,7392
11726,5,25,0,11726,3015,8711,4608,12.6283,450.994,11726,18,23,9854,9853,9136,9127,7050
38502,17,20,0,38502,6497,32005,5202.77,12.3305,587.479,38502,20,19,38479,38479,38479,38479,38479
4501,57,60,4501,0,0,4501,4.82454e+15,26.6872,385.585,4501,29,38,4441,4433,4439,4441,4021
31599,3,40,0,31599,31599,0,2.23002e+13,21.8328,665.127,31599,30,29,20902,17708,15893,17188,6506
15775,34,40,15775,0,15775,0,81078100000,31.2135,531.894,15775,34,35,15730,15666,15613,15628,13815
29054,42,56,29054,0,29054,0,1.43401e+18,33.4081,847.924,29054,46,42,28998,28988,28992,23641,26152
32439,10,44,32439,0,32439,0,1.12332e+18,37.2439,942.882,32439,38,37,25588,19227,21797,6848,10284
47638,8,23,0,47638,9015,38623,4765.6,19.996,752.836,47638,21,22,46409,46276,45978,46146,42933
39249,1,4,0,39249,39249,0,8.33503e+15,3.19231,269.856,39249,4,4,34704,34704,34704,34704,34704
18581,14,40,18581,0,0,18581,5.7033e+15,21.5839,553.734,18581,30,28,18331,18059,16647,14308,13130
29399,37,38,0,29399,29399,0,2.21929e+13,32.7885,732.25,29399,33,32,29358,29257,29354,29354,29358
13468,1,4,0,13468,13468,0,8.33574e+15,1.9997,158.427,13468,3,3,11907,11907,11907,11907,11907
18040,7,23,2977,15063,0,18040,19.8381,17.9402,423.243,18040,20,21,17698,17698,17390,17411,17166
9620,8,40,9620,0,9620,0,86656600000,19.0232,405.927,9620,26,25,8761,7401,7068,7443,4368
4698,3,24,4698,0,0,4698,5.66856e+15,17.3393,250.77,4698,17,20,3160,2687,2415,696,1090
19333,20,24,19333,0,0,19333,342358000,21.1341,528.416,19333,24,22,19296,19231,19246,19246,18440
26812,32,44,0,26812,26812,0,2.14306e+13,26.6073,700.64,26812,36,37,26754,26696,26627,26547,24051
3419,27,36,0,3419,0,3419,1296080,13.5408,212.09,3419,20,25,3383,3374,3380,3378,3381
32896,1,2,32896,0,32896,0,3.27971e+13,1.9996,238.84,32896,2,2,29062,29062,29062,29062,29062
9553,15,21,1607,7946,0,9553,19.7961,10.9905,311.038,9553,17,20,9526,9526,9508,9508,9416
5339,19,20,5339,0,5339,0,1.47554e+18,17.0558,257.749,5339,19,18,5319,5308,5318,4911,5319
43138,1,60,43138,0,0,43138,331314000,32.2178,1058.38,43138,38,52,4245,4245,4245,4245,4245
8991,1,2,8991,0,8991,0,6.54928e+13,1.99744,132.465,8991,2,2,6898,6898,6898,6898,6898
47788,34,48,47788,0,0,47788,296036000,35.7921,1105.53,47788,38,41,47718,47565,47262,44207,42456
10826,11,19,0,10826,1699,9127,4972.92,16.0352,304.865,10826,19,19,10747,10747,10711,10731,10655
15758,10,19,2474,13284,0,15758,19.5192,15.069,367.496,15758,19,19,15641,15640,15589,15620,13968
37674,32,60,0,37674,0,37674,1306590,22.816,876.581,37674,32,40,37614,37598,37528,37535,35915
45557,12,40,45557,0,45557,0,87249800000,31.4188,858.964,45557,33,31,44265,41581,38353,39365,25863
4048,20,36,4048,0,0,4048,273989000,24.2984,287.154,4048,29,29,3930,3746,3846,2317,2728
27006,2,21,9212,17794,0,27006,14.8728,18.2138,621.271,27006,21,19,15055,15055,14904,14446,7493
25443,47,48,25443,0,0,25443,319642000,37.1272,757.442,25443,36,41,25395,25382,25394,25268,25393
49565,1,2,49565,0,49565,0,3.64813e+13,1.99919,294.109,49565,2,2,43140,43140,43140,43140,43140
9332,30,40,9332,0,9332,0,1.40492e+18,26.2855,398.176,9332,32,37,9280,9224,9233,7878,8300
11763,1,19,1865,9898,0,11763,19.6232,14.0912,320.749,11763,19,19,2342,2342,2342,2342,2342
10661,18,19,1673,8988,0,10661,19.4143,16.0747,302.668,10661,19,19,10639,10637,10630,10630,10639
26795,34,65,26794,1,0,26795,1.37151e+15,33.7205,1077.24,26795,38,58,26706,26575,26459,25404,16355
4158,25,32,4158,0,0,4158,327071000,17.7532,226.232,4158,25,21,4119,4089,4113,3544,3547
2703,27,38,2703,0,2703,0,83191800000,24.845,230.044,2703,26,27,2654,2617,2636,2634,2654
7271,9,20,0,7271,0,7271,1337510,17.0003,300.372,7271,20,18,6855,5769,6027,5981,4089
9233,1,2,9233,0,9233,0,3.26502e+13,1.9987,126.903,9233,2,2,8161,8161,8161,8161,8161
13855,12,19,0,13855,2175,11680,5041.29,13.3177,343.094,13855,19,19,13797,13796,13771,13781,13688
32033,15,40,32021,12,32033,0,2.60764e+14,1.33653,345.069,32033,17,16,31982,31972,31871,31877,31804
6570,35,36,6570,0,6570,0,85431300000,17.6341,289.567,6570,24,25,6534,6522,6534,6533,6534
35839,22,40,35839,0,0,35839,340130000,21.9259,742.054,35839,32,24,35793,35749,35759,35755,34516
3632,1,2,3632,0,3632,0,5.6109e+13,1.99009,84.7611,3632,2,2,2907,2907,2907,2907,2907
21420,59,64,21420,0,0,21420,4.62712e+15,35.3981,942.155,21420,36,53,21356,21348,21352,21356,18869
11004,13,38,0,11004,0,11004,1318920,36.9088,460.386,11004,32,30,10613,9712,9358,9144,3640
35219,4,8,35219,0,35219,0,7.49343e+13,1.99997,273.073,35219,5,7,35211,35209,35210,35209,28970
16738,1,2,16738,0,16738,0,3.24559e+13,1.99922,172.04,16738,2,2,14807,14807,14807,14807,14807
884,9,10,0,884,152,732,5268.27,7.51584,80.8835,884,9,9,873,873,872,872,873
24143,1,2,24143,0,24143,0,3.25859e+13,1.99909,205.724,24143,2,2,21347,21347,21347,21347,21347
48734,26,44,48734,0,0,48734,320601000,34.9228,941.24,48734,38,37,48522,47977,48150,24361,33009
14576,1,2,14576,0,14576,0,3.29829e+13,1.99828,158.755,14576,2,2,12867,12867,12867,12867,12867
11203,3,19,0,11203,1757,9446,4981.16,15.7624,309.448,11203,19,19,9163,9163,9130,8821,7686
32283,26,30,6399,25884,0,32283,18.4179,17.4421,681.386,32283,21,26,32253,32253,32253,32253,30939
45050,49,56,45050,0,45050,0,1.45086e+18,23.5945,878.05,45050,43,40,44994,44983,44993,42416,44922
24048,12,30,0,24048,4533,19515,4890.53,17.3143,634.886,24048,19,29,23834,23829,23705,23733,22634
38304,41,60,38304,0,38304,0,1.34925e+18,31.0645,975.324,38304,48,44,38244,38234,38163,18103,25247
47657,3,40,0,47657,0,47657,1319140,28.5357,854.341,47657,39,37,31762,26984,24320,16361,10027
22433,22,40,0,22433,22433,0,2.2222e+13,23.0636,568.683,22433,30,29,22387,22343,22356,22356,19514
35384,26,44,0,35384,35384,0,2.04711e+13,31.6637,873.037,35384,39,41,35207,34765,34775,34030,24153
17989,1,2,17989,0,17989,0,3.48147e+13,1.99956,177.526,17989,2,2,15763,15763,15763,15763,15763
7863,1,2,0,7863,7863,0,8.37602e+15,1.99924,117.709,7863,2,2,6948,6948,6948,6948,6948
43410,1,4,0,43410,43410,0,8.33285e+15,3.07807,283.379,43410,4,4,38385,38385,38385,38385,38385
22120,3,4,0,22120,22120,0,8.31334e+15,2.90945,205.056,22120,4,4,22114,22110,22113,22113,21528
39745,41,44,39745,0,0,39745,258842000,37.4083,1037.77,39745,39,37,39700,39678,39551,38906,39700
6469,27,44,6469,0,0,6469,266112000,31.262,445.283,6469,32,41,6401,6264,6215,4720,3532
29168,21,40,0,29168,29168,0,1.72418e+13,32.7621,877.657,29168,39,34,28621,26514,27168,25717,18604
28543,35,40,28543,0,28543,0,1.43874e+18,30.6781,660.983,28543,37,37,28494,28429,28449,24403,28448
22060,38,40,22060,0,22060,0,74644400000,37.1375,703.661,22060,36,37,22017,21974,21865,21941,22016
35907,18,40,35907,0,35907,0,62964600000,35.5893,976.646,35907,37,37,34205,29776,30433,28028,19782
4468,27,38,0,4468,4468,0,2.19341e+13,19.69,291.105,4468,27,25,4430,4414,4422,4421,4430
20746,11,28,0,20746,3507,17239,5090.53,13.1426,484.854,20746,19,25,20650,20650,20618,20635,20402
7889,7,22,7889,0,7889,0,1.47418e+18,18.6205,334.403,7889,20,20,6905,5911,5132,3448,3458
27761,34,38,27761,0,27761,0,85866600000,36.9465,751.914,27761,38,34,27699,27547,27641,27642,22403
1240,9,15,0,1240,233,1007,4415.59,8.38145,106.009,1240,15,14,1201,1201,1191,1201,443
9764,5,60,0,9764,9764,0,1.97273e+13,24.8522,575.745,9764,32,44,6946,5263,5439,5746,2292
37295,17,60,37295,0,0,37295,330468000,26.5389,880.662,37295,35,40,36887,35716,36405,35310,26365
25092,19,40,0,25092,25092,0,2.09074e+13,30.3631,657.209,25092,36,35,24785,24290,24596,23971,11139
35328,1,23,5961,29367,0,35328,19.469,18.4504,606.929,35328,21,21,7036,7036,7036,7036,7036
38133,11,44,0,38133,38133,0,2.14377e+13,34.2392,818.414,38133,37,38,36866,35252,34281,33700,14484
3103,5,32,3103,0,3103,0,75656800000,28.3155,231.425,3103,28,28,2533,2057,2286,2133,1129
45445,43,56,45445,0,0,45445,5.7039e+15,22.8309,846.787,45445,32,32,45389,45376,45389,45389,45387
24917,1,2,24917,0,24917,0,3.45221e+13,1.99896,208.037,24917,2,2,21860,21860,21860,21860,21860
10287,17,40,0,10287,0,10287,1211770,29.7907,447.366,10287,32,33,10033,9347,9880,9857,6832
1240,19,36,1240,0,0,1240,294954000,17.871,167.494,1240,23,31,1180,1126,1152,792,851
6336,1,2,6336,0,6336,0,3.27854e+13,1.99858,105.244,6336,2,2,5597,5597,5597,5597,5597
15862,4,36,15862,0,0,15862,333052000,24.1859,487.698,15862,36,33,11921,9283,9071,9172,3993
44131,18,33,0,44131,9068,35063,1.63276e+12,19.603,852.891,44131,28,25,44084,44084,44033,43985,40900
42504,28,49,0,42504,42500,4,5.21194e+14,38.4333,1098.35,42504,40,41,42341,42064,41698,40949,32865
37386,11,23,7364,30022,0,37386,18.5142,20.4579,683.946,37386,21,22,37039,37039,36882,36945,33539
43953,1,2,43953,0,43953,0,5.40369e+13,1.99961,285.74,43953,2,2,35514,35514,35514,35514,35514
45236,4,20,7792,37444,0,45236,20.3205,16.1795,652.833,45236,20,20,40114,40114,36403,31439,27652
28047,12,40,28047,0,0,28047,340827000,21.5846,663.737,28047,32,25,27319,25783,23920,24370,18539
3341,1,20,3341,0,0,3341,335805000,14.5355,192.839,3341,16,17,428,428,428,428,428
47621,3,40,0,47621,0,47621,1319210,28.5276,854.022,47621,39,37,31733,26958,24296,16341,11175
34943,1,2,34943,0,34943,0,6.33385e+13,1.9998,259.75,34943,2,2,27079,27079,27079,27079,27079
22781,21,56,22781,0,0,22781,5.5827e+15,28.2188,724.937,22781,38,42,22570,22178,22342,14322,18063
21122,10,60,21122,0,21122,0,1.45959e+18,21.8963,672.376,21122,29,42,19944,18923,16546,9667,11719
21042,39,40,21042,0,21042,0,7.1088e+10,34.1631,705.202,21042,37,37,21002,20981,20964,20964,21002
9604,9,12,0,9604,1670,7934,5231.74,10.6508,284.288,9604,12,12,9553,9553,9476,9474,7683
47196,36,44,47196,0,47196,0,82705200000,35.0642,915.257,47196,38,37,47144,47098,46959,46950,45300
42303,5,44,42303,0,0,42303,5.17566e+15,38.2951,977.689,42303,40,41,32981,25540,27028,6165,10252
16817,6,40,16817,0,16817,0,1.36557e+18,30.2528,544.89,16817,34,35,14743,13520,11665,2678,4700
43877,29,60,43847,30,43847,30,1.15096e+13,37.6425,1109.66,43877,52,37,43729,43474,43205,28911,31004
17279,17,19,0,17279,3155,14124,5154.96,15.8542,429.327,17279,19,19,17250,17250,17250,17250,17250
12800,19,44,0,12800,12800,0,2.14577e+13,19.3816,505.331,12800,27,37,12699,12512,12644,12476,11661
30183,2,40,0,30183,0,30183,1248430,29.8444,741.395,30183,37,35,17683,17611,13359,7680,4143
15362,6,13,0,15362,2526,12836,5205.92,11.6014,349.128,15362,13,13,14968,14968,14527,14527,14420
15515,7,24,0,15515,0,15515,1332630,22.0846,465.037,15515,22,22,13786,11988,10223,11021,5902
30890,33,40,30890,0,30890,0,87392700000,21.8572,700.421,30890,30,28,30850,30834,30847,30844,29378
24823,3,4,0,24823,24823,0,8.75211e+15,2.00004,213.829,24823,3,3,24819,24817,24818,24818,24819
39196,1,23,10979,28217,0,39196,16.1696,19.4134,753.176,39196,22,21,9823,9823,9823,9823,9823
527,6,15,0,527,115,412,4024.11,9.86528,68.3385,527,14,14,477,477,469,476,416
15795,1,2,15795,0,15795,0,3.30749e+13,1.99873,165.75,15795,2,2,13938,13938,13938,13938,13938
39169,36,60,39139,30,39139,30,1.28854e+13,36.0002,1041.62,39169,52,37,39100,39020,38961,36242,33148
27188,60,67,0,27188,27158,30,4.74521e+15,35.8838,886.272,27188,52,36,27121,27121,27120,27120,26952
49060,3,4,0,49060,49060,0,8.38224e+15,1.99998,297.866,49060,3,3,49056,49054,49055,49055,49056
5216,12,22,5216,0,0,5216,5.73225e+15,20.7373,283.997,5216,21,21,5010,4628,4308,4001,3174
3145,1,19,596,2549,0,3145,19.1822,14.0878,190.302,3145,18,18,466,466,466,466,466
34921,1,2,34921,0,34921,0,3.26121e+13,1.99954,247.929,34921,2,2,30874,30874,30874,30874,30874
47777,35,44,0,47777,47777,0,2.07282e+13,36.4709,956.224,47777,39,37,47717,47536,47500,47475,44291
19594,2,40,0,19594,19594,0,2.18686e+13,23.7063,549.99,19594,33,37,11361,11344,8106,9163,2491
4533,3,4,0,4533,4533,0,8.66344e+15,1.99978,93.7992,4533,3,3,4529,4527,4528,4528,4529
24915,30,56,0,24915,0,24915,1300560,32.8828,674.903,24915,37,40,24833,24748,24769,24775,18831
5201,20,36,5201,0,0,5201,4.05116e+15,25.0563,357.253,5201,28,29,5046,4425,4440,3308,3960
41307,27,44,0,41307,0,41307,1283520,32.965,852.686,41307,37,38,41173,40873,40945,40932,30266
13291,19,21,2163,11128,0,13291,19.842,10.9661,354.686,13291,17,20,13270,13270,13254,13254,13214
11686,1,2,11686,0,11686,0,5.61457e+13,1.99786,146.734,11686,2,2,9354,9354,9354,9354,9354
7593,18,38,0,7593,7593,0,2.18495e+13,35.0477,390.029,7593,32,30,7481,7379,7339,7282,5886
14687,1,2,0,14687,14687,0,1.10095e+16,1.99857,162.897,14687,2,2,12442,12442,12442,12442,12442
42222,28,30,7784,34438,0,42222,19.5823,17.736,796.495,42222,19,29,42192,42192,42192,42192,42025
22844,26,40,22844,0,0,22844,298412000,32.0505,694.285,22844,38,34,22697,22281,22427,14730,16785
32049,13,40,0,32049,32049,0,2.15175e+13,32.5179,712.332,32049,37,37,31450,30313,30727,30197,11901
24770,18,23,0,24770,5126,19644,4600.35,18.0103,565.205,24770,21,22,24735,24733,24577,24577,23113
591,3,12,591,0,591,0,84852900000,8.96277,67.4467,591,11,10,424,364,334,339,244
42909,27,60,0,42909,42909,0,2.11323e+13,33.9608,1146.85,42909,38,56,42711,42251,42327,42290,35761
18814,2,36,0,18814,18814,0,2.149e+13,26.5711,530.02,18814,35,33,11207,11179,8302,8945,2634
28817,1,2,28817,0,28817,0,3.27608e+13,1.99955,224.328,28817,2,2,25462,25462,25462,25462,25462
9584,6,36,9584,0,0,9584,5.38292e+15,26.1474,386.169,9584,32,32,8532,7876,6869,1531,3384
7031,34,38,7031,0,7031,0,1.45652e+18,30.2361,415.097,7031,33,38,6981,6921,6966,6544,6945
5440,5,24,5440,0,5440,0,1.45376e+18,17.764,273.693,5440,19,21,4388,3295,3308,1162,1951
26688,3,21,4754,21934,0,26688,18.7149,16.8193,529.373,26688,21,19,21441,21439,21339,20760,17991
38137,2,38,38137,0,0,38137,336109000,34.7902,882.649,38137,38,38,19796,19794,12357,5304,4471
29343,8,19,0,29343,5310,24033,5167.32,16.765,554.352,29343,19,19,28887,28883,27422,27417,27587
6012,21,22,6012,0,0,6012,342811000,19.9165,296.551,6012,20,20,5989,5963,5988,5987,5989
26209,49,60,26209,0,0,26209,326882000,27.8149,770.984,26209,33,40,26149,26139,26145,25861,24154
36331,26,28,0,36331,6100,30231,5183.98,12.4142,587.426,36331,21,21,36303,36303,36303,36303,36298
1473,1,36,0,1473,1473,0,1.96792e+13,16.7984,177.229,1473,24,31,169,169,169,169,169
46362,38,40,0,46362,0,46362,1308400,32.7655,834.944,46362,38,37,46318,46260,46296,46296,46284
36517,1,27,11702,24815,4,36513,7707820000,19.4379,754.156,36517,25,22,8859,8859,8859,8859,8859
48566,34,60,48566,0,0,48566,5.5785e+15,34.6521,1034.85,48566,40,44,48500,48463,48408,41160,47299
43086,3,40,43086,0,0,43086,5.56456e+15,34.7428,821.804,43086,38,37,29424,25176,22965,5495,6522
28384,28,40,28384,0,28384,0,85786200000,30.9345,661.28,28384,37,37,28310,28237,28252,28190,23387
31858,1,2,31858,0,31858,0,3.71083e+13,1.99943,236.707,31858,2,2,27657,27657,27657,27657,27657
35312,35,44,35312,0,35312,0,1.41305e+18,30.1646,778.301,35312,37,37,35262,35169,35152,30385,33928
12356,37,49,12356,0,12356,0,1.24429e+18,34.9843,568.839,12356,36,38,12307,12286,12301,12253,12236
44636,38,44,44636,0,0,44636,326599000,31.4995,872.667,44636,37,37,44592,44563,44478,41058,44199
22840,1,2,22840,0,22840,0,3.26334e+13,1.99847,199.706,22840,2,2,20191,20191,20191,20191,20191
8281,1,2,0,8281,8281,0,8.3709e+15,1.99867,120.39,8281,2,2,7318,7318,7318,7318,7318
10338,12,38,10338,0,0,10338,5.65411e+15,31.1439,441.584,10338,31,29,9878,9080,8370,7783,6441
1558,4,10,0,1558,274,1284,5287.6,8.37997,109.539,1558,10,10,1366,1366,1250,1212,1057
22911,32,48,22911,0,0,22911,5.23189e+15,33.4793,778.194,22911,36,41,22851,22797,22716,19817,21024
14905,1,2,14905,0,14905,0,3.5352e+13,1.99899,160.66,14905,2,2,13032,13032,13032,13032,13032
34789,37,40,34789,0,0,34789,340062000,22.1176,699.736,34789,31,29,34749,34734,34749,34749,34749
14841,9,40,0,14841,14841,0,2.1752e+13,24.2732,487.41,14841,34,37,14051,12248,12624,12344,6254
30121,19,23,0,30121,5243,24878,4913.57,19.9601,571.858,30121,21,21,30092,30092,30042,30045,29849
37642,37,44,0,37642,0,37642,1227080,30.9579,895.156,37642,40,41,37592,37560,37326,37329,31954
13110,8,40,0,13110,13110,0,2.21164e+13,18.2612,426.743,13110,25,29,12181,10609,10270,10724,6048
4224,1,2,0,4224,4224,0,8.39307e+15,1.99455,86.1085,4224,2,2,3731,3731,3731,3731,3731
30944,27,40,0,30944,0,30944,1329750,21.9035,660.547,30944,30,29,30904,30883,30897,30895,30902
1244,10,23,0,1244,271,973,5008.87,9.62379,144.382,1244,11,22,1214,1214,1206,1205,1054
6521,4,11,1093,5428,0,6521,20.4226,9.42095,224.104,6521,11,10,5845,5845,5328,5183,4876
30537,16,23,6032,24505,0,30537,18.4934,19.0885,621.024,30537,20,22,30475,30470,30315,30319,29543
27644,42,56,0,27644,0,27644,1324020,21.9513,680.431,27644,30,32,27588,27576,27588,27588,27586
15256,8,13,2507,12749,0,15256,20.3291,11.2115,347.783,15256,12,13,15168,15168,14711,14710,15102
5473,15,20,5473,0,5473,0,86665300000,16.076,247.662,5473,17,19,5444,5412,5406,5406,5227
4131,23,36,0,4131,0,4131,1291110,14.0668,229.729,4131,20,25,4095,4084,4090,4090,4093
26859,1,32,5919,20940,0,26859,18.9743,13.1901,679.565,26859,20,24,4820,4820,4820,4820,4820
1468,1,2,1468,0,1468,0,8.26401e+13,1.99046,53.7111,1468,2,2,1036,1036,1036,1036,1036
4178,14,32,4178,0,0,4178,5.2851e+15,20.2429,246.167,4178,29,28,4068,3950,4005,1409,2969
33195,34,38,33195,0,0,33195,5.69354e+15,31.5185,772.477,33195,33,31,33145,33055,33133,33142,33145
34276,2,21,5522,28754,0,34276,20.2006,14.5778,532.912,34276,21,20,23334,23334,23231,16552,13914
10631,22,38,0,10631,10631,0,2.20999e+13,37.5283,454.272,10631,32,30,10560,10521,10512,10521,4212
12136,6,24,12136,0,0,12136,5.74834e+15,20.6828,416.629,12136,20,21,10266,9140,7238,2218,4936
36219,12,44,36219,0,36219,0,1.40969e+18,31.2261,784.028,36219,37,37,35289,33853,32957,5195,18024
37594,148,325,4253,33341,237,37357,72033300000,9.85633,1023.23,37594,127,48,37269,37255,37215,37212,37206
8777,28,40,8777,0,0,8777,5.5737e+15,20.2397,396.33,8777,27,36,8731,8703,8688,7480,8114
32571,1,2,0,32571,32571,0,8.40904e+15,1.99988,238.359,32571,2,2,28769,28769,28769,28769,28769
4271,1,12,730,3541,0,4271,20.4261,8.90611,187.351,4271,11,11,693,693,693,693,693
24459,1,40,0,24459,0,24459,1227920,32.4341,670.037,24459,36,35,3000,3000,3000,3000,3000
27778,36,44,0,27778,27778,0,2.02844e+13,35.5775,797.368,27778,37,41,27728,27684,27509,27533,26347
44738,11,40,44738,0,0,44738,5.72601e+15,27.809,854.819,44738,33,30,42955,40538,37261,21233,24491
43694,35,56,0,43694,0,43694,1325160,35.4324,841.594,43694,40,32,43633,43590,43620,43617,43633
39766,2,4,0,39766,39766,0,8.33901e+15,1.99977,268.619,39766,3,3,39761,39760,39761,39761,39081
33567,11,21,0,33567,5341,28226,5108.56,18.1126,542.512,33567,21,21,33468,33468,33423,33453,17848
44315,12,28,7374,36941,0,44315,20.255,12.4352,639.582,44315,20,21,44265,44265,44243,44248,44228
10284,20,24,10284,0,10284,0,1.46324e+18,22.1706,380.088,10284,20,22,10256,10234,10218,8852,9598
40874,18,40,40874,0,0,40874,5.65404e+15,28.7212,785.2,40874,38,37,40718,40532,40549,10753,29208
30382,19,60,30382,0,30382,0,82884900000,38.0478,789.471,30382,37,44,30049,29578,29846,29280,19774
16859,11,40,16859,0,0,16859,5.58542e+15,24.3456,516.056,16859,33,37,16399,15776,15070,5642,8770
45150,1,2,0,45150,45150,0,1.36838e+16,1.99929,289.372,45150,2,2,36575,36575,36575,36575,36575
6807,17,20,6807,0,6807,0,8.7131e+10,17.6786,283.818,6807,18,19,6780,6736,6761,6764,6369
2601,8,10,457,2144,0,2601,20.6336,9.20646,141.533,2601,10,10,2577,2577,2555,2555,2577
27092,35,44,27092,0,27092,0,1.39364e+18,36.8268,713.297,27092,36,37,27040,26954,26944,22816,24616
31767,11,21,6981,24786,0,31767,17.4492,19.1138,629.881,31767,21,20,31332,31332,31127,31207,23188
965,5,10,164,801,0,965,20.5181,7.04145,83.936,965,9,9,898,898,820,819,802
37556,1,2,37556,0,37556,0,5.67432e+13,1.99963,265.1,37556,2,2,29984,29984,29984,29984,29984
39479,7,23,0,39479,6943,32536,4851.91,19.5349,653.127,39479,21,21,38304,38304,37860,37997,33569
20355,36,40,0,20355,0,20355,1306060,29.2945,666.447,20355,38,34,20305,20183,20259,20260,20058
27555,34,40,0,27555,0,27555,1327670,22.8343,630.672,27555,31,29,27515,27499,27515,27513,27515
21091,10,40,0,21091,21091,0,2.19525e+13,29.5017,677.117,21091,38,34,19684,18606,15827,16033,9592
23870,1,2,23870,0,23870,0,3.28761e+13,1.99916,204.328,23870,2,2,21081,21081,21081,21081,21081
48191,32,56,0,48191,0,48191,1320680,38.0831,907.765,48191,41,38,48119,48062,48071,48073,45296
23396,14,24,23396,0,0,23396,341901000,22.0908,581.525,23396,24,22,23132,22818,20204,21787,15918
22522,9,48,22522,0,0,22522,291337000,26.5103,810.852,22522,33,41,18701,14699,15926,15689,8103
16756,1,2,0,16756,16756,0,9.94254e+15,1.99869,171.818,16756,2,2,14443,14443,14443,14443,14443
43209,53,56,0,43209,43209,0,2.20999e+13,29.4013,837.753,43209,40,36,43153,43145,43152,43153,36282
14903,23,24,14903,0,0,14903,341596000,20.7352,449.152,14903,21,22,14878,14854,14868,14868,14518
32979,11,40,0,32979,0,32979,1307530,34.639,704.29,32979,37,37,32161,30990,29671,29649,15691
25501,33,40,25501,0,25501,0,71591400000,32.8002,772.701,25501,37,37,25445,25361,25186,25219,24304
19766,31,38,19766,0,0,19766,340063000,29.2474,590.636,19766,31,30,19721,19680,19710,19710,19721
48095,17,23,0,48095,11312,36783,4403.38,19.5817,806.117,48095,23,21,48034,48034,47703,47704,46463
38996,23,40,0,38996,0,38996,1329300,22.355,770.609,38996,32,29,38952,38904,38934,38932,36820
13773,17,20,2394,11379,0,13773,20.3622,11.7756,362.843,13773,16,19,13753,13753,13751,13753,10128
25990,11,28,4286,21704,0,25990,20.1696,12.4653,499.752,25990,21,21,25931,25931,25915,25919,18980
26911,1,4,0,26911,26911,0,8.34348e+15,1.99989,222.443,26911,3,3,23792,23792,23792,23792,23792
34705,8,44,34705,0,0,34705,271665000,33.7611,938.925,34705,38,37,27515,22677,23511,23510,10065
13508,16,40,13508,0,0,13508,293276000,32.8508,527.782,13508,34,33,12950,11528,12572,12538,6467
6063,1,24,6063,0,6063,0,87384100000,15.8438,286.658,6063,19,21,666,666,666,666,666
3350,1,11,504,2846,0,3350,19.9546,8.37254,150.162,3350,10,10,637,637,637,637,637
23454,14,38,23454,0,0,23454,5.61966e+15,32.5588,679.959,23454,36,33,22836,22226,20299,18693,15523
16926,1,2,16926,0,16926,0,3.24945e+13,1.99823,172.643,16926,2,2,14971,14971,14971,14971,14971
45431,1,2,0,45431,45431,0,8.61563e+15,1.99978,281.116,45431,2,2,39998,39998,39998,39998,39998
21482,21,40,21482,0,0,21482,340774000,22.4523,586.02,21482,24,29,21431,21343,21370,21354,19694
2900,1,18,0,2900,2900,0,2.25256e+13,14.9141,184.647,2900,16,17,314,314,314,314,314
20521,13,60,20521,0,20521,0,82014800000,29.3552,667.357,20521,35,40,19900,18863,19248,18797,10508
14856,3,24,14856,0,0,14856,342867000,20.6955,463.479,14856,22,22,9481,7980,7082,3659,2412
25057,20,24,0,25057,25057,0,2.23285e+13,22.112,616.752,25057,24,22,25009,24903,24923,24914,22235
29393,50,60,0,29393,29393,0,2.02161e+13,31.9469,892.17,29393,37,44,29333,29323,29326,29333,23904
14163,21,40,14163,0,14163,0,85030800000,24.3087,479.311,14163,32,37,14074,13989,14017,13867,11994
42016,3,40,42016,0,42016,0,1.46139e+18,22.1676,790.759,42016,32,29,27496,23256,20781,4664,8302
22543,1,4,0,22543,22543,0,1.10693e+16,2.95892,222.351,22543,4,4,19049,19049,19049,19049,19049
3946,52,60,3946,0,3946,0,67038900000,26.2157,392.414,3946,29,41,3886,3880,3879,3886,3121
44521,19,44,0,44521,44521,0,2.01535e+13,36.2212,981.339,44521,40,41,43812,42312,43058,41671,25202
30154,16,38,30154,0,0,30154,5.4642e+15,36.6425,854.564,30154,38,38,28951,27197,27084,24855,14273
27056,30,31,0,27056,5788,21268,2.66319e+12,17.5994,652.653,27056,23,24,27025,27025,27024,27020,26992
41517,27,30,7129,34388,0,41517,20.1327,19.3566,675.022,41517,28,22,41486,41485,41485,41486,41402
41852,34,40,41852,0,0,41852,5.71914e+15,22.5854,797.289,41852,32,28,41812,41796,41808,41812,41812
33747,62,65,0,33747,0,33747,5.46602e+14,33.102,1150.93,33747,38,59,33682,33676,33680,33682,33049
19699,38,40,19699,0,19699,0,1.4292e+18,32.2958,552.169,19699,33,37,19659,19632,19637,18874,19659
45494,8,23,0,45494,7567,37927,4996.47,16.4787,674.725,45494,20,21,44895,44865,44598,44691,43497
5077,13,36,0,5077,0,5077,933536,24.9831,352.18,5077,28,29,3988,1947,3323,3279,2314
12069,1,28,0,12069,1963,10106,5121.78,10.8011,353.325,12069,19,21,2132,2132,2132,2132,2132
39774,1,2,39774,0,39774,0,4.51504e+13,1.99955,267.07,39774,2,2,33393,33393,33393,33393,33393
11551,1,2,0,11551,11551,0,8.37792e+15,1.99853,142.577,11551,2,2,10207,10207,10207,10207,10207
4994,12,19,0,4994,916,4078,5144.4,11.4017,232.884,4994,19,16,4968,4968,4968,4968,4968
18650,1,2,18650,0,18650,0,3.26903e+13,1.9992,180.476,18650,2,2,16483,16483,16483,16483,16483
37704,9,23,0,37704,7145,30559,4780.02,18.5271,673.721,37704,20,22,37119,37119,36853,36977,34296
15720,2,4,0,15720,15720,0,8.43422e+15,1.99981,170.804,15720,3,3,15715,15714,15715,15715,14573
19079,5,21,0,19079,4794,14285,4272.31,18.2681,506.045,19079,20,20,16376,16376,15991,16075,13583
43733,28,40,43733,0,0,43733,5.50752e+15,35.03,863.277,43733,38,37,43617,43426,43501,28707,32693
40290,14,25,8911,31379,0,40290,18.0045,19.5799,757.096,40290,21,23,40141,40130,39922,39938,36512
35296,28,44,35296,0,0,35296,312094000,37.7103,861.09,35296,40,37,35166,34939,34907,28118,24460
30357,1,2,30357,0,30357,0,4.06955e+13,1.99954,231.099,30357,2,2,25967,25967,25967,25967,25967
31081,1,4,31081,0,31081,0,4.86769e+13,1.99955,244.166,31081,3,3,26213,26213,26213,26213,26213
12197,9,40,12197,0,0,12197,5.7195e+15,21.0885,451.775,12197,24,27,11325,9317,9272,2751,5893
2749,1,2,2749,0,2749,0,6.38925e+13,1.99382,73.616,2749,2,2,2124,2124,2124,2124,2124
5739,12,36,5739,0,5739,0,61364400000,28.7904,378.269,5739,29,30,4374,2369,3551,3419,2506
16293,9,38,0,16293,16293,0,2.20769e+13,31.9981,552.871,16293,32,31,14781,11783,11376,11906,7858
15500,22,24,15500,0,15500,0,1.47206e+18,19.5846,458.053,15500,21,21,15474,15460,15472,14667,15466
48401,1,2,48401,0,48401,0,5.56367e+13,1.99948,300.007,48401,2,2,38833,38833,38833,38833,38833
10413,36,40,10413,0,10413,0,1.45469e+18,18.1564,389.204,10413,20,29,10373,10366,10373,10232,10373
45219,27,40,45219,0,45219,0,86406200000,28.933,835.914,45219,39,37,45138,45036,45078,45016,35007
43976,3,4,0,43976,43976,0,1.32691e+16,2,291.179,43976,3,3,43972,43970,43971,43971,43972
7793,1,2,7793,0,7793,0,7.19489e+13,1.99897,122.939,7793,2,2,5800,5800,5800,5800,5800
1569,1,2,1569,0,1569,0,3.26504e+13,1.99171,52.1115,1569,2,2,1386,1386,1386,1386,1386
6688,11,22,6688,0,6688,0,8.7474e+10,20.5461,321.581,6688,21,22,6360,5940,5496,5318,4132
25822,1,2,25822,0,25822,0,3.43696e+13,1.99946,211.344,25822,2,2,22668,22668,22668,22668,22668
6842,1,2,6842,0,6842,0,4.51709e+13,1.99942,111.622,6842,2,2,5743,5743,5743,5743,5743
48363,1,2,0,48363,48363,0,1.09838e+16,1.99967,293.759,48363,2,2,40990,40990,40990,40990,40990
5054,5,24,5054,0,5054,0,87612600000,16.3415,264.659,5054,19,21,3994,2961,2927,3516,1651
32889,24,44,0,32889,0,32889,1044520,34.2094,918.391,32889,37,37,32567,31932,31827,31724,25037
17718,6,40,17718,0,17718,0,1.45962e+18,21.9614,542.962,17718,29,29,15030,13416,10659,3265,6528
16359,13,21,2643,13716,0,16359,19.8479,16.5052,388.76,16359,20,20,16308,16308,16274,16283,16205
30154,245,497,865,29289,29644,510,1.58243e+16,56.0971,1894.95,30154,107,72,29657,29634,29319,29264,26556
15596,14,21,0,15596,2480,13116,5150.01,12.1554,361.72,15596,20,20,15568,15568,15568,15568,15565
9413,1,2,0,9413,9413,0,8.35939e+15,1.99734,128.425,9413,2,2,8320,8320,8320,8320,8320
31536,14,40,0,31536,31536,0,2.19717e+13,30.0903,690.416,31536,37,37,31227,30850,30354,30117,19377
18984,36,40,18984,0,18984,0,1.2758e+18,33.9739,630.267,18984,35,33,18940,18919,18875,17845,18904
5979,1,2,0,5979,5979,0,8.30368e+15,1.99732,102.88,5979,2,2,5289,5289,5289,5289,5289
2274,8,36,0,2274,0,2274,1252730,15.4208,209.616,2274,21,31,2045,1776,1739,1810,1375
4670,25,40,0,4670,4670,0,1.92553e+13,24.0664,323.173,4670,29,33,4607,4516,4505,4334,3420
43461,1,4,0,43461,43461,0,8.61654e+15,2.00009,280.553,43461,3,3,38261,38261,38261,38261,38261
22182,27,38,0,22182,22182,0,2.2292e+13,28.7284,622.256,22182,31,29,22133,22094,22115,22115,22133
45484,29,40,0,45484,45484,0,2.19916e+13,32.7445,822.385,45484,38,37,45398,45274,45344,45302,37920
41115,29,44,41115,0,0,41115,317655000,36.3375,879.201,41115,38,37,40992,40696,40711,30501,31541
34355,1,2,34355,0,34355,0,3.25595e+13,1.99913,245.079,34355,2,2,30380,30380,30380,30380,30380
28750,13,21,0,28750,4856,23894,4936.68,15.3724,535.487,28750,20,19,28631,28631,28548,28557,25355
47504,22,23,7902,39602,0,47504,19.5301,19.3672,691.173,47504,21,21,47480,47480,47428,47428,47478
12653,21,40,12653,0,12653,0,1.476e+18,21.8221,472.336,12653,35,24,12588,12485,12529,1795,6582
39972,34,60,0,39972,39972,0,2.13269e+13,24.37,989.349,39972,36,44,39908,39875,39753,39756,33434
1213,1,2,0,1213,1213,0,8.19781e+15,1.98186,45.685,1213,2,2,1074,1074,1074,1074,1074
2342,2,34,2342,0,2342,0,8.1564e+10,28.1964,230.981,2342,31,29,1142,1140,559,983,297
29179,1,2,29179,0,29179,0,3.44959e+13,1.9989,225.067,29179,2,2,25602,25602,25602,25602,25602
35723,16,44,35723,0,0,35723,5.24518e+15,34.7138,875.688,35723,38,41,34799,32183,33956,8955,21390
22984,20,21,0,22984,3656,19328,5103.34,12.2666,448.559,22984,19,20,22963,22963,22952,22952,22929
41041,28,44,41041,0,41041,0,82031500000,37.6657,870.917,41041,38,37,40893,40614,40581,40224,33439
47242,30,40,0,47242,47242,0,2.18369e+13,33.2908,848.471,47242,38,37,47152,46962,47064,47021,38508
5476,5,12,958,4518,0,5476,20.3988,11.2739,217.609,5476,12,12,5052,5052,4496,4385,1474
15627,47,60,15627,0,0,15627,290741000,37.7897,752.949,15627,36,51,15567,15557,15560,14418,11499
29376,22,23,0,29376,5828,23548,4747.36,20.3067,612.977,29376,21,22,29352,29352,29296,29297,29352
38151,32,40,38151,0,38151,0,1.445e+18,30.2398,766.575,38151,39,37,38091,38033,38040,30679,36673
5851,4,36,5851,0,0,5851,5.60371e+15,17.4346,275.818,5851,24,25,4452,3472,3383,1021,1823
18721,17,38,18721,0,0,18721,5.6396e+15,32.8574,596.692,18721,33,32,18468,17786,17816,15375,14775
13909,2,40,13909,0,13909,0,77783100000,30.5356,519.871,13909,33,33,8203,8147,6562,6413,2250
30306,12,40,30306,0,30306,0,1.43921e+18,31.8893,687.738,30306,38,37,29668,28490,27133,4778,15830
19009,52,56,19009,0,19009,0,1.43363e+18,24.215,618.245,19009,40,40,18953,18943,18953,17602,18913
28472,372,2482,28148,324,28148,324,9.1794e+17,106.092,4439.46,28472,478,179,25990,25408,22257,23797,5065
16067,36,40,16067,0,0,16067,5.11935e+15,34.1739,561.453,16067,33,33,16023,16002,15958,14893,15987
21182,5,21,3561,17621,0,21182,19.0981,16.2755,456.699,21182,20,19,19906,19906,18615,18653,18732
4535,18,22,0,4535,4535,0,2.24848e+13,16.8878,258.133,4535,19,19,4511,4501,4473,4469,4496
19851,6,23,0,19851,3995,15856,4800.8,17.1446,513.86,19851,20,22,18662,18662,18258,18292,16847
18744,19,20,3237,15507,0,18744,20.0982,13.1916,469.468,18744,19,20,18724,18724,18724,18724,18711
34893,1,28,5845,29048,0,34893,20.2499,12.0887,574.941,34893,20,21,5865,5865,5865,5865,5865
28519,13,28,4615,23904,0,28519,19.9255,16.5908,536.483,28519,20,27,28439,28439,28402,28414,28148
36302,36,64,36302,0,36302,0,80135700000,32.297,1153.04,36302,38,55,36226,36076,36039,36063,29237
18773,18,21,0,18773,3273,15500,4802.59,17.8473,437.984,18773,20,19,18745,18742,18683,18684,18575
29202,5,28,0,29202,4941,24261,5133.96,13.0872,559.124,29202,20,25,27200,27200,24487,24262,18913
12827,2,19,0,12827,3949,8878,3894.74,17.153,416.781,12827,19,18,7729,7729,7712,7423,4149
37771,1,2,37771,0,37771,0,3.36464e+13,1.99966,256.805,37771,2,2,33255,33255,33255,33255,33255
22593,40,54,22587,6,22587,6,3.77597e+12,28.6867,872.035,22593,41,45,22539,22532,22372,21577,15638
11886,9,22,11886,0,0,11886,5.74497e+15,20.4957,423.01,11886,22,22,10944,8856,8840,7296,6121
36528,1,2,0,36528,36528,0,9.59111e+15,1.99926,252.722,36528,2,2,31665,31665,31665,31665,31665
11905,14,21,2162,9743,0,11905,18.5593,15.9154,357.842,11905,19,19,11843,11839,11786,11788,11294
27513,7,40,27513,0,0,27513,5.72117e+15,21.8862,662.917,27513,30,28,24145,20758,17960,6572,9232
39429,20,44,0,39429,0,39429,1062810,36.5515,1005.77,39429,38,39,38566,36486,36663,36696,23851
7125,8,22,0,7125,0,7125,1340010,17.079,309.928,7125,19,19,6486,5437,5008,5428,3870
49950,20,64,49950,0,0,49950,307866000,30.0864,1219.95,49950,36,44,49381,47920,48004,40940,32475
29025,14,67,29025,0,0,29025,1.03136e+16,36.3751,918.399,29025,52,35,23832,12061,20251,13907,12445
9266,7,20,0,9266,0,9266,1326110,17.2185,327.404,9266,20,19,8425,7486,6768,7134,4531
44062,36,48,0,44062,0,44062,4.18642e+14,36.5175,1111.32,44062,42,41,44006,43958,43650,43097,40713
30970,1,2,0,30970,30970,0,8.73207e+15,1.99981,231.795,30970,2,2,27216,27216,27216,27216,27216
35003,17,44,35003,0,35003,0,1.34063e+18,31.7956,869.82,35003,39,41,34252,31465,33563,13803,20272
10951,1,19,1785,9166,0,10951,19.0821,14.1178,314.551,10951,18,18,2381,2381,2381,2381,2381
24297,3,4,0,24297,24297,0,8.41072e+15,1.99979,211.509,24297,3,3,24293,24291,24292,24292,24293
7583,19,21,1243,6340,0,7583,20.1229,10.319,260.94,7583,17,20,7562,7562,7560,7560,7557
30830,4,5,30830,0,30830,0,5.01232e+13,1.99951,244.216,30830,3,4,30825,30824,30825,30825,30825
47610,1,2,0,47610,47610,0,8.66326e+15,1.99916,287.106,47610,2,2,41885,41885,41885,41885,41885
32247,15,44,32247,0,32247,0,71300700000,35.2312,910.957,32247,37,39,29867,23322,27958,26378,11746
16716,3,24,0,16716,0,16716,1333820,21.7992,482.119,16716,22,22,10900,9210,8223,4850,3472
28436,37,60,0,28436,28436,0,2.16798e+13,25.5535,796.487,28436,32,40,28376,28360,28271,28271,25660
17700,30,40,17700,0,17700,0,1.44561e+18,29.5524,497.205,17700,29,29,17652,17614,17644,14523,17649
30001,13,21,0,30001,5252,24749,4854.35,16.2156,559.827,30001,21,19,29858,29858,29749,29760,26973
48462,50,64,48462,0,0,48462,5.11164e+15,30.7648,1209.22,48462,36,44,48398,48387,48394,48398,41112
3097,5,20,0,3097,0,3097,1322490,14.2351,187.826,3097,16,17,2543,1917,1899,2049,1283
16210,62,133,0,16210,0,16210,2.9597e+16,46.4986,763.702,16210,75,43,16077,16060,15971,11925,1953
40374,6,21,0,40374,6736,33638,5198.47,12.1746,591.604,40374,21,20,39226,39226,38020,38023,37297
18250,12,44,18250,0,18250,0,81987100000,29.6354,595.125,18250,34,37,17564,16642,16657,16324,10054
47617,23,56,0,47617,0,47617,1305530,31.9518,1013.04,47617,38,50,47385,47052,47158,47123,31982
12317,21,36,0,12317,12317,0,2.21534e+13,18.2949,397.992,12317,28,25,12280,12262,12272,12266,12279
3660,1,11,0,3660,596,3064,5215.69,9.48989,162.368,3660,11,10,625,625,625,625,625
2249,22,32,2249,0,2249,0,83370900000,14.3464,164.793,2249,22,17,2217,2205,2216,2160,2017
34089,36,48,34089,0,0,34089,312986000,36.6858,890.336,34089,37,41,34035,33995,33928,31149,33095
46238,13,60,0,46238,0,46238,1298240,25.9375,959.332,46238,34,40,45163,42607,41485,42066,24487
6591,2,40,6591,0,6591,0,86957600000,18.5398,323.081,6591,19,29,3641,3638,2464,2951,1083
19748,1,21,0,19748,3159,16589,5076.18,17.1587,422.655,19748,20,20,3762,3762,3762,3762,3762
28957,1,4,0,28957,28957,0,8.32132e+15,3.61667,232.738,28957,4,4,25608,25608,25608,25608,25608
3320,1,2,0,3320,3320,0,8.37778e+15,1.99849,76.5832,3320,2,2,2933,2933,2933,2933,2933
26221,18,19,4632,21589,0,26221,20.3071,14.0634,508.062,26221,19,19,26199,26199,26199,26199,26199
6712,18,24,6712,0,6712,0,1.46945e+18,17.4972,308.267,6712,19,21,6686,6674,6616,5565,6417
20933,14,24,20933,0,0,20933,5.70141e+15,20.5041,522.902,20933,22,22,20783,20589,19138,16845,16037
6212,18,36,0,6212,0,6212,1040520,32.6735,386.59,6212,32,33,5970,5504,5614,5609,3763
13293,1,40,13293,0,13293,0,1.44195e+18,17.8918,431.333,13293,22,29,1618,1618,1618,1618,1618
44857,38,44,0,44857,44857,0,2.15344e+13,37.6946,889.104,44857,38,38,44808,44739,44643,44657,38837
39266,2,20,6970,32296,0,39266,20.298,16.3086,624.765,39266,20,19,25334,25334,24591,11338,12215
45530,1,4,0,45530,45530,0,8.41648e+15,1.99991,286.95,45530,3,3,40209,40209,40209,40209,40209
30518,1,23,5312,25206,0,30518,19.1697,19.8655,575.38,30518,21,21,6320,6320,6320,6320,6320
35446,1,38,35446,0,35446,0,1.45493e+18,32.9884,812.929,35446,33,34,3388,3388,3388,3388,3388
29046,39,40,29046,0,0,29046,5.62907e+15,30.6767,669.543,29046,37,37,29005,28966,28994,26602,28995
7995,2,20,7995,0,7995,0,1.46664e+18,18.2021,315.014,7995,20,19,4471,4470,3025,949,1440
14966,320,351,14966,0,14966,0,1.20317e+18,25.0603,951.37,14966,55,58,14615,14613,14609,14611,14603
11729,14,38,11729,0,11729,0,8.5829e+10,32.0487,512.509,11729,31,37,11342,10965,10089,10532,5809
8017,25,30,0,8017,1639,6378,4859.18,11.4519,361.662,8017,19,22,7987,7987,7987,7987,7719
47018,45,60,0,47018,0,47018,1299150,25.8902,965.484,47018,36,40,46958,46947,46954,46927,41875
32715,32,40,0,32715,32715,0,2.23106e+13,22.8705,695.645,32715,32,29,32675,32659,32674,32661,32673
11508,26,36,11508,0,0,11508,5.67832e+15,18.7776,395.273,11508,28,25,11472,11456,11469,5558,11470
1882,32,36,1882,0,1882,0,85296900000,12.7487,169.908,1882,17,25,1846,1840,1846,1840,1846
21908,1,2,21908,0,21908,0,3.29038e+13,1.99973,194.927,21908,2,2,19346,19346,19346,19346,19346
650,13,28,650,0,0,650,221666000,20.8138,119.305,650,22,22,508,266,437,428,422
13534,2,13,0,13534,2342,11192,5227.14,11.5795,339.745,13534,13,12,8848,8848,8737,5130,3064
8671,23,24,8671,0,8671,0,1.46851e+18,18.4886,339.796,8671,20,21,8647,8635,8645,8367,8647
48887,36,40,48887,0,0,48887,5.66467e+15,27.8864,856.329,48887,39,37,48839,48801,48799,42058,48803
49398,33,56,49398,0,49398,0,1.44912e+18,28.2434,917.666,49398,45,40,49327,49262,49290,27965,42950
34391,46,64,0,34391,34391,0,1.89648e+13,33.0372,1056.63,34391,36,44,34327,34317,34323,34091,24276
29854,3,4,0,29854,29854,0,8.34646e+15,2.00013,233.786,29854,3,3,29850,29848,29849,29849,29850
17366,10,40,0,17366,0,17366,1176280,34.2841,588.109,17366,34,33,16047,14948,14882,14817,6371
47988,12,32,0,47988,11451,36537,4516.71,18.0223,975.499,47988,22,31,47544,47514,47172,47224,37691
5230,3,32,0,5230,5230,0,2.09828e+13,19.0899,273.967,5230,31,28,3698,3202,2976,2746,1220
28291,33,44,0,28291,0,28291,1271220,36.4057,733.322,28291,36,37,28230,28148,28074,28086,25163
31776,1,2,31776,0,31776,0,4.29706e+13,1.99972,238.009,31776,2,2,26924,26924,26924,26924,26924
16862,1,4,0,16862,16862,0,8.42282e+15,2.00024,176.827,16862,3,3,14888,14888,14888,14888,14888
37036,32,40,37036,0,37036,0,86134500000,29.5128,751.843,37036,38,37,36976,36918,36925,36915,35745
48733,37,40,48733,0,0,48733,5.65119e+15,30.8835,852.612,48733,38,37,48686,48631,48656,42838,48357
19926,24,40,0,19926,0,19926,1152020,31.1661,657.167,19926,36,37,19740,19399,19440,19437,15178
17638,14,24,0,17638,0,17638,1338160,20.9855,499.937,17638,23,22,17448,17228,15626,16496,12134
7615,1,2,7615,0,7615,0,7.08955e+13,1.99856,121.893,7615,2,2,5696,5696,5696,5696,5696
10157,1,2,0,10157,10157,0,8.35718e+15,1.99754,132.447,10157,2,2,8978,8978,8978,8978,8978
6735,10,22,0,6735,6735,0,2.24245e+13,21.1947,317.614,6735,21,21,6389,6097,5260,5189,3725
36952,1,4,0,36952,36952,0,8.39294e+15,2.00014,259.281,36952,3,3,32645,32645,32645,32645,32645
6412,21,36,6412,0,0,6412,240219000,26.0044,393.999,6412,29,29,6280,5502,5731,5372,5118
32154,1,2,32154,0,32154,0,3.27311e+13,1.99938,236.961,32154,2,2,28414,28414,28414,28414,28414
40187,9,44,40187,0,40187,0,66138700000,37.2272,1042.74,40187,39,37,30553,22803,25740,24066,11979
6855,2,23,1379,5476,0,6855,19.0483,10.3581,304.365,6855,16,21,4481,4481,4450,3222,2708
40149,1,2,40149,0,40149,0,3.72131e+13,1.9996,264.778,40149,2,2,34840,34840,34840,34840,34840
9259,13,25,2572,6687,0,9259,17.5604,12.7072,410.202,9259,18,23,9216,9216,9184,9188,6119
21276,12,21,3394,17882,0,21276,19.7932,17.9318,437.557,21276,20,20,21190,21189,21143,21164,21041
4957,6,40,4957,0,0,4957,339931000,17.4372,294.359,4957,22,25,4243,3819,2940,2956,1365
33213,13,56,33213,0,33213,0,1.44193e+18,30.8561,734.245,33213,46,30,32716,31398,31123,4139,15237
10350,11,36,10350,0,0,10350,327589000,26.4411,392.632,10350,33,33,10076,9733,9595,9598,5180
6593,9,21,0,6593,1101,5492,5159.76,10.5867,246.641,6593,16,20,6545,6545,6538,6542,6503
49130,1,2,0,49130,49130,0,8.6211e+15,1.99961,291.972,49130,2,2,43251,43251,43251,43251,43251
12222,25,40,12222,0,0,12222,5.69776e+15,20.7025,461.488,12222,30,24,12182,12166,12173,12024,12106
48669,3,23,0,48669,9252,39417,4779.38,20.8897,770.797,48669,22,22,38254,38244,38054,36073,30073
43147,14,21,0,43147,6992,36155,5172.26,14.5035,603.212,43147,21,20,43099,43099,43096,43098,42818
23848,27,56,0,23848,0,23848,1300270,33.3833,669.073,23848,37,40,23755,23651,23695,23691,18381
18035,28,38,18035,0,0,18035,341193000,21.1854,549.068,18035,30,27,17997,17979,17989,17990,17997
21612,2,4,0,21612,21612,0,8.30203e+15,3.52637,204.431,21612,4,4,21601,21598,21601,21601,19704
3492,18,980,3443,49,3443,49,2.77071e+18,151.767,1549.14,3492,246,122,711,222,176,237,207
42561,3,56,0,42561,0,42561,1317190,28.5248,861.295,42561,37,40,28091,23837,21359,13743,6237
14127,19,24,14127,0,0,14127,342651000,20.971,453.421,14127,22,22,14090,14041,14046,14044,13104
24379,40,44,24379,0,0,24379,312408000,34.4054,746.274,24379,37,41,24335,24318,24221,23761,23692
15615,17,19,2886,12729,0,15615,19.8791,15.8829,422.103,15615,19,19,15580,15580,15574,15574,15574
10847,13,22,0,10847,10847,0,2.24281e+13,20.8391,405.547,10847,22,22,10574,9769,9366,9749,7795
44432,18,40,0,44432,44432,0,2.22236e+13,37.751,919.434,44432,33,38,44139,43784,43270,43356,19683
41692,31,40,0,41692,0,41692,1323520,34.3912,899.08,41692,36,38,41609,41458,41485,41488,29569
7435,23,24,7435,0,7435,0,87246500000,17.2382,316.514,7435,19,21,7411,7401,7402,7402,7244
32117,37,56,0,32117,0,32117,1325020,22.9944,727.508,32117,30,32,32061,32045,32060,32060,28643
10713,38,40,10713,0,10713,0,77961300000,30.0715,447.239,10713,33,33,10673,10656,10624,10650,10671
12327,6,22,12327,0,12327,0,1.4694e+18,20.5275,432.328,12327,22,22,10261,9033,7411,3066,4455
2582,1,38,2582,0,2582,0,1.43356e+18,19.3377,227.067,2582,20,28,242,242,242,242,242
36850,40,60,36850,0,0,36850,5.36677e+15,36.2382,1084.46,36850,38,56,36790,36782,36633,36047,31496
21968,10,66,21968,0,0,21968,5.95346e+15,32.4139,985.401,21968,36,57,17332,13186,13136,8117,5787
21963,22,40,21963,0,21963,0,1.05425e+18,34.139,755.564,21963,36,34,21623,20646,20637,11321,15219
46194,47,56,0,46194,0,46194,1306560,31.3295,985.919,46194,39,49,46138,46126,46129,46137,43301
5744,11,20,5744,0,5744,0,87511500000,16.5543,260.129,5744,18,18,5609,5404,5044,4951,4181
2019,1,2,0,2019,2019,0,1.50611e+16,1.99108,60.6562,2019,2,2,1596,1596,1596,1596,1596
38179,29,40,0,38179,0,38179,1325450,26.7245,737.252,38179,32,29,38128,38090,38120,38115,37093
30077,11,40,30077,0,0,30077,340846000,29.5375,713.113,30077,31,29,28800,27110,24948,24799,16806
35900,1,2,0,35900,35900,0,1.44276e+16,1.99983,258.397,35900,2,2,28711,28711,28711,28711,28711
28875,13,40,0,28875,28875,0,2.22921e+13,22.8767,675.772,28875,32,24,28340,26702,24902,26479,16753
45843,34,40,45843,0,0,45843,337156000,38.5716,959.938,45843,39,37,45768,45579,45671,45670,43409
9966,17,38,9966,0,9966,0,86985400000,20.701,419.221,9966,29,26,9871,9593,9667,9571,8390
25334,1,2,0,25334,25334,0,1.24012e+16,1.99968,213.927,25334,2,2,20973,20973,20973,20973,20973
16306,1,24,16306,0,0,16306,342644000,20.3383,475.076,16306,22,21,1724,1724,1724,1724,1724
626,1,2,626,0,626,0,5.98022e+13,1.96965,35.2556,626,2,2,492,492,492,492,492
4241,9,20,4241,0,0,4241,334358000,14.6685,213.557,4241,17,17,4078,3635,3676,3664,2666
36648,7,23,0,36648,7006,29642,4782.89,18.6504,667.559,36648,21,22,35237,35237,34817,34937,32369
45000,2284,2504,44673,327,0,45000,4.53659e+17,83.8795,4762.37,45000,548,202,42496,42496,42455,42460,18759
11736,15,44,11736,0,0,11736,4.13425e+15,33.7807,569.192,11736,33,36,10312,6064,9094,3760,3097
43905,18,20,0,43905,7787,36118,5198.16,15.8686,657.97,43905,20,19,43879,43879,43879,43879,43879
2973,3,11,477,2496,0,2973,20.3256,9.11369,144.838,2973,10,10,2362,2362,2360,1772,1376
9747,14,24,9747,0,9747,0,87603800000,17.9768,357.008,9747,20,21,9671,9593,9032,9382,7870
8673,7,21,0,8673,1672,7001,4641.94,15.7662,311.434,8673,18,19,8291,8291,8239,8284,7602
39592,24,40,0,39592,0,39592,1101860,35.3886,987.688,39592,38,37,39236,38551,38573,38574,29289
34617,28,60,0,34617,0,34617,1302510,23.7117,851.476,34617,32,40,34543,34483,34451,34452,32321
3492,22,32,0,3492,3492,0,1.60884e+13,24.2405,280.092,3492,31,25,3415,3222,3332,3088,2711
5913,1,2,5913,0,5913,0,3.37979e+13,1.9956,101.802,5913,2,2,5202,5202,5202,5202,5202
5443,1,2,5443,0,5443,0,3.23208e+13,1.99871,98.2035,5443,2,2,4817,4817,4817,4817,4817
49332,606,7132,0,49332,17229,32103,4.51276e+14,112.922,9553.61,49332,2068,189,42200,41860,36144,7974,5470
29608,3,40,29608,0,0,29608,296804000,35.9993,796.515,29608,37,37,19622,17030,16158,13844,4403
35624,13,40,0,35624,0,35624,1326860,22.8016,744.864,35624,32,29,34996,33015,31576,32154,21464
6884,19,40,6884,0,0,6884,337826000,18.8422,354.248,6884,27,24,6830,6774,6798,6766,5876
39171,11,32,9951,29220,0,39171,17.1066,19.4678,897.275,39171,22,31,38591,38587,38284,38354,16171
21469,1,2,21469,0,21469,0,3.28687e+13,1.99963,193.086,21469,2,2,18961,18961,18961,18961,18961
30402,25,40,30402,0,30402,0,87135800000,22.05,655.7,30402,30,29,30361,30341,30353,30347,30360
31908,1,21,0,31908,5109,26799,5014.16,17.2474,541.949,31908,20,20,6362,6362,6362,6362,6362
40129,59,60,40129,0,40129,0,85399300000,25.0505,907.942,40129,32,40,40069,40058,40068,40069,39621
15444,33,40,0,15444,0,15444,1326470,21.4303,503.982,15444,27,28,15404,15388,15401,15401,14459
43107,4,44,43107,0,43107,0,1.40311e+18,31.7005,858.505,43107,37,37,32458,25519,25109,5655,10180
18778,26,60,0,18778,0,18778,1251010,30.2821,670.08,18778,33,40,18658,18449,18515,18484,13686
43283,32,44,0,43283,43283,0,2.15194e+13,36.592,867.071,43283,38,38,43207,43079,43038,42989,40254
33249,1,2,33249,0,33249,0,3.14669e+13,1.99943,244.405,33249,2,2,29531,29531,29531,29531,29531
24094,15,40,24094,0,0,24094,4.54683e+15,34.1998,770.727,24094,37,37,22214,17139,20786,6775,12652
26219,10,24,0,26219,26219,0,2.23658e+13,21.7902,623.972,26219,24,22,25025,23967,20955,20799,13223
35824,55,56,35824,0,0,35824,5.69e+15,39.2855,781.482,35824,40,31,35768,35742,35768,35767,34091
45504,23,30,0,45504,8795,36709,4745.16,21.6564,814.14,45504,22,28,45474,45474,45474,45474,42589
24821,1,2,24821,0,24821,0,3.28412e+13,1.99952,208.061,24821,2,2,21924,21924,21924,21924,21924
31187,15,44,31187,0,0,31187,5.50769e+15,25.691,739.379,31187,36,37,30732,29891,30347,11127,19612
702,1,2,702,0,702,0,4.17e+13,1.98006,34.6234,702,2,2,597,597,597,597,597
29075,14,20,5145,23930,0,29075,20.2592,17.9617,543.743,29075,20,19,29029,29029,29029,29029,29029
21947,31,40,21947,0,21947,0,1.42017e+18,31.6507,593.623,21947,37,36,21889,21783,21817,18076,20713
20661,23,38,0,20661,20661,0,2.23768e+13,21.2319,584.975,20661,30,28,20623,20603,20610,20611,20623
17365,38,40,17365,0,0,17365,5.70646e+15,22.9451,542.379,17365,31,24,17325,17317,17324,17325,17325
42949,3,4,0,42949,42949,0,8.33841e+15,3.81785,293.403,42949,4,4,42926,42891,42918,42918,42595
24239,18,56,24239,0,24239,0,1.44745e+18,32.6683,746.863,24239,35,38,23892,23511,23284,8505,18979
35891,19,23,6879,29012,0,35891,18.6063,18.9436,661.899,35891,20,22,35862,35862,35717,35719,35310
37022,1,4,0,37022,37022,0,8.27586e+15,3.42002,276.158,37022,4,4,32737,32737,32737,32737,32737
34478,29,48,34474,4,0,34478,1.06589e+15,36.5795,992.724,34478,43,41,34358,34139,33753,27108,23266
47830,23,44,47830,0,0,47830,5.44415e+15,33.5427,923.305,47830,37,37,47555,46965,47196,12052,36227
38443,1,2,38443,0,38443,0,3.73855e+13,1.99948,258.919,38443,2,2,33336,33336,33336,33336,33336
30203,1,4,0,30203,30203,0,8.39555e+15,1.99997,234.762,30203,3,3,26681,26681,26681,26681,26681
2876,8,22,2876,0,0,2876,5.75047e+15,17.4249,207.036,2876,18,19,2562,2096,1917,1271,1462
33321,38,44,0,33321,33321,0,2.1261e+13,35.1004,765.374,33321,37,37,33277,33248,33164,33168,32884
39029,1,2,0,39029,39029,0,9.90333e+15,1.99954,261.032,39029,2,2,33664,33664,33664,33664,33664
47867,43,48,47867,0,47867,0,76069200000,37.2925,1096.56,47867,39,41,47819,47798,47594,47646,47334
35430,3,32,0,35430,7123,28307,5017.14,17.4677,790.047,35430,19,31,25927,25906,24791,14028,12684
45747,22,40,45747,0,0,45747,5.7185e+15,31.0943,860.117,45747,32,31,45682,45617,45635,40498,42558
34518,33,44,34518,0,34518,0,1.11891e+18,36.5191,976.388,34518,39,37,34451,34351,34082,32026,32867
36753,10,30,0,36753,7300,29453,4731.97,18.1412,795.136,36753,21,30,36167,36146,35829,35919,32361
1196,7,20,0,1196,0,1196,1334390,12.5351,121.637,1196,14,17,1061,930,865,885,688
8917,8,22,8917,0,8917,0,87637200000,21.0514,366.638,8917,22,22,7972,6531,5826,6707,3794
46487,21,48,46487,0,0,46487,4.89979e+15,34.1313,1098.27,46487,38,41,45833,43918,44791,21160,25398
15162,17,44,14693,469,15129,33,1.06037e+15,22.0905,515.42,15162,25,30,15075,15006,14428,14339,7710
23839,33,44,23839,0,0,23839,5.0286e+15,34.7503,738.533,23839,38,41,23776,23698,23514,19869,17604
32654,41,44,32654,0,32654,0,1.12107e+18,35.9954,944.688,32654,38,37,32610,32589,32563,32567,32609
33150,35,54,33144,6,0,33150,1.10859e+15,37.8467,970.894,33150,38,45,33087,32982,32926,30018,28211
49183,38,60,49183,0,0,49183,336879000,37.8394,961.069,49183,41,40,49119,49068,49069,46456,47782
22632,33,38,22632,0,22632,0,85432500000,33.7698,696.627,22632,38,33,22562,22366,22460,22465,22499
33087,4,13,5566,27521,0,33087,20.3107,11.7452,532.556,33087,13,13,29595,29595,26923,25649,23566
3141,10,32,3141,0,0,3141,233482000,24.8093,268.324,3141,29,25,2364,1645,1987,1924,1293
12495,12,13,0,12495,2153,10342,5224.41,11.7389,326.417,12495,13,12,12481,12481,12481,12481,12481
45579,43,56,0,45579,0,45579,1310830,31.0617,1015.71,45579,38,51,45523,45515,45514,45521,44406
33643,17,44,0,33643,33643,0,2.03712e+13,32.2708,854.293,33643,40,41,32895,30120,32205,31178,17011
7230,11,22,7230,0,7230,0,87329800000,20.242,334.661,7230,21,22,6872,6408,5944,5755,4335
9494,15,22,0,9494,0,9494,1342250,19.0455,365.595,9494,20,20,9407,9258,9041,9037,8300
8241,1,2,8241,0,8241,0,4.57341e+13,1.99794,121.069,8241,2,2,6901,6901,6901,6901,6901
17776,29,44,0,17776,17776,0,1.76439e+13,32.7619,690.347,17776,36,37,17699,17555,17465,17233,15093
37864,7,44,37864,0,37864,0,81469600000,35.1393,846.91,37864,38,37,33816,30090,28445,29069,9408
36010,15,64,0,36010,0,36010,1224370,26.7239,1052.29,36010,32,44,34458,30069,32011,31882,21303
38855,5,40,38855,0,0,38855,5.64512e+15,30.1447,773.944,38855,39,37,31496,23771,24271,5019,9449
9177,3,19,0,9177,1729,7448,4644.32,15.611,312.479,9177,18,18,7352,7352,7307,7164,2352
41166,55,56,41166,0,41166,0,1.45035e+18,23.6157,846.6,41166,40,40,41110,41099,41110,40374,41100
28774,1,40,0,28774,28774,0,2.22528e+13,22.2715,635.523,28774,29,29,3304,3304,3304,3304,3304
36572,1,5,1,36571,36572,0,1.55574e+16,2.00014,272.227,36572,4,3,28672,28672,28672,28672,28672
14572,21,40,0,14572,14572,0,2.06399e+13,32.3744,515.659,14572,34,35,14391,14123,14235,13828,9851
7762,1,11,0,7762,1218,6544,5182.53,9.83381,232.278,7762,11,11,1378,1378,1378,1378,1378
48807,13,32,11195,37612,0,48807,18.1659,16.3273,903.474,48807,22,27,48618,48618,48373,48398,40209
10504,1,2,0,10504,10504,0,8.51328e+15,1.99867,134.8,10504,2,2,9262,9262,9262,9262,9262
10017,22,38,0,10017,0,10017,1327600,20.7157,420.011,10017,29,26,9978,9959,9964,9965,9977
5586,11,36,0,5586,0,5586,971942,27.782,370.016,5586,30,33,4529,3324,4002,3959,2105
10892,9,21,0,10892,1764,9128,5162.87,10.5717,304.26,10892,18,20,10839,10839,10830,10834,10794
17645,39,40,17645,0,17645,0,87244900000,21.3069,543.12,17645,30,27,17605,17593,17605,17605,17605
11753,9,36,0,11753,11753,0,1.70799e+13,31.5169,527.803,11753,35,33,9455,7626,8368,7686,3466
27428,18,40,27428,0,27428,0,1.4519e+18,27.4214,618.023,27428,30,29,27348,27258,27261,5312,23351
40740,29,31,0,40740,13261,27479,1.76866e+12,22.205,815.141,40740,28,23,40709,40709,40707,39288,40643
26189,15,48,26189,0,0,26189,5.18905e+15,32.1246,826.747,26189,36,41,25085,21886,24075,7463,14952
6506,1,2,6506,0,6506,0,6.30788e+13,1.99892,113.375,6506,2,2,5047,5047,5047,5047,5047
48618,1,40,0,48618,0,48618,1325140,25.6045,859.271,48618,33,29,5445,5445,5445,5445,5445
26707,11,40,0,26707,26707,0,2.23226e+13,30.6785,676.141,26707,31,30,25545,24019,22111,21599,15341
18818,35,40,18818,0,18818,0,1.42807e+18,33.0785,542.694,18818,33,37,18774,18713,18734,16665,18764
14538,10,22,14538,0,14538,0,1.46498e+18,20.1013,474.737,14538,22,22,13768,13098,11428,9757,8547
6834,4,36,6834,0,0,6834,4.41661e+15,30.1661,405.152,6834,33,33,4430,3659,3746,1270,1070
38366,1,4,0,38366,38366,0,9.71386e+15,3.42274,285.289,38366,4,4,33159,33159,33159,33159,33159
28228,6,44,28228,0,28228,0,83679100000,26.7063,710.003,28228,36,37,24662,22507,18826,21260,9121
38923,7,21,6286,32637,0,38923,20.0704,15.6217,587.363,38923,21,21,38322,38322,37074,37385,37468
30698,1,2,0,30698,30698,0,8.74137e+15,1.99971,230.706,30698,2,2,26973,26973,26973,26973,26973
11889,6,24,0,11889,0,11889,1334510,18.2163,392.399,11889,21,21,10289,9303,7204,7498,4485
9983,13,24,0,9983,9983,0,2.23237e+13,18.621,362.096,9983,20,21,9844,9388,9079,9490,7199
19228,21,40,19228,0,0,19228,339931000,34.188,579.847,19228,31,29,19160,19023,19086,19078,18027
3386,1,2,3386,0,3386,0,4.42247e+13,1.99144,79.3591,3386,2,2,2853,2853,2853,2853,2853
26510,3,5,6,26504,26510,0,1.37102e+16,1.99962,229.654,26510,4,3,26505,26503,26505,26505,26505
24469,13,40,24469,0,24469,0,1.36698e+18,30.2995,649.475,24469,36,35,23744,22636,23248,3868,12451
5515,13,20,0,5515,5515,0,2.24982e+13,17.0693,260.599,5515,18,18,5434,5158,5205,5200,4547
20747,4,40,20747,0,20747,0,86889700000,33.4897,604.69,20747,31,29,14619,11045,10639,12839,4148
45438,18,44,0,45438,45438,0,2.00797e+13,38.0311,1013.73,45438,41,41,44591,43067,43570,42095,27332
48748,22,40,0,48748,0,48748,1312800,37.1685,1016.75,48748,39,38,48431,48034,48056,48088,32767
22789,36,38,0,22789,0,22789,1305070,33.4846,700.099,22789,38,33,22739,22589,22691,22692,22719
19904,10,40,19904,0,19904,0,86817700000,21.2557,530.541,19904,29,29,19242,18631,16681,16644,10294
2191,1,18,0,2191,0,2191,1351280,16.0794,167.534,2191,16,18,219,219,219,219,219
32981,11,20,5979,27002,0,32981,20.0688,15.6205,621.803,32981,19,20,32791,32786,32767,32766,28694
20891,1,2,0,20891,20891,0,1.00441e+16,1.99904,191.738,20891,2,2,17978,17978,17978,17978,17978
44852,1,2,44852,0,44852,0,4.30383e+13,1.99969,282.419,44852,2,2,37993,37993,37993,37993,37993
6674,9,22,6674,0,0,6674,342603000,21.0878,315.148,6674,21,20,6170,5033,4873,5172,3528
4328,1,2,0,4328,4328,0,8.79076e+15,1.99746,86.2992,4328,2,2,3799,3799,3799,3799,3799
29133,33,44,29133,0,29133,0,1.13166e+18,36.66,888.906,29133,38,37,29070,28989,28804,26930,27827
5424,5,22,5424,0,5424,0,1.47458e+18,16.2622,272.587,5424,19,19,4260,3144,3169,1704,1907
34807,1,2,34807,0,34807,0,3.25087e+13,1.99989,247.849,34807,2,2,30786,30786,30786,30786,30786
22223,21,44,22223,0,0,22223,5.20301e+15,30.0059,726.919,22223,36,41,21991,21485,21702,13854,15332
20467,11,38,20467,0,0,20467,5.68126e+15,28.9197,612.907,20467,32,30,19432,18134,16585,14633,12032
45822,55,60,0,45822,45822,0,2.056e+13,41.3548,1162.83,45822,40,53,45762,45750,45757,45762,41790
4367,15,24,4367,0,4367,0,1.46782e+18,16.7861,249.96,4367,18,21,4317,4249,4258,3698,3972
29403,6,56,0,29403,29403,0,2.20245e+13,24.3582,737.105,29403,34,40,25265,22746,18502,21813,8174
30968,20,23,5283,25685,0,30968,19.3671,19.7446,575.292,30968,21,21,30941,30940,30856,30856,30742
44648,4,23,9124,35524,0,44648,18.2518,19.5798,757.78,44648,22,22,38790,38790,36200,36044,34148
15660,39,48,0,15660,0,15660,1079960,28.9353,704.352,15660,32,41,15612,15602,15451,15452,12151
24713,25,40,24713,0,24713,0,86798900000,21.0752,582.972,24713,29,29,24672,24652,24664,24658,24671
27700,38,40,27700,0,27700,0,82859100000,28.8325,692.725,27700,37,35,27660,27639,27589,27627,27658
30134,8,24,30134,0,0,30134,341259000,21.7117,661.839,30134,24,22,27396,22972,20983,22535,10756
34608,1,2,0,34608,34608,0,8.40339e+15,1.99942,245.559,34608,2,2,30571,30571,30571,30571,30571
32894,38,56,32894,0,0,32894,5.62601e+15,30.3578,767.667,32894,37,40,32836,32797,32785,28985,26370
26522,25,325,0,26522,5091,21431,2.61388e+13,16.4483,990.218,26522,127,48,26171,26096,26047,26033,26033
15222,1,2,0,15222,15222,0,1.07788e+16,1.99961,164.139,15222,2,2,12944,12944,12944,12944,12944
36082,1,2,0,36082,36082,0,8.40758e+15,1.99978,250.962,36082,2,2,31871,31871,31871,31871,31871
31238,11,40,0,31238,31238,0,2.19677e+13,30.2624,687.222,31238,37,37,30444,29317,27650,27559,13509
20275,18,38,20275,0,20275,0,86362800000,29.7935,611.284,20275,32,31,20105,19909,19700,19665,17584
17005,1,2,17005,0,17005,0,3.26415e+13,1.99941,172.329,17005,2,2,15032,15032,15032,15032,15032
2116,1,2,2116,0,2116,0,3.24574e+13,1.99669,61.2132,2116,2,2,1871,1871,1871,1871,1871
33945,24,40,0,33945,0,33945,1334890,22.1576,729.853,33945,32,28,33904,33883,33890,33890,33899
16734,1,40,16734,0,0,16734,5.589e+15,23.4202,513.431,16734,32,37,2020,2020,2020,2020,2020
38233,2,56,0,38233,38233,0,2.20078e+13,29.8193,814.763,38233,38,40,21684,21662,15071,17653,6239
6866,30,40,0,6866,0,6866,1030210,28.0052,445.335,6866,30,37,6822,6798,6764,6767,4667
35959,19,60,35959,0,35959,0,83933400000,36.7949,995.276,35959,38,52,35486,34745,34842,34470,20768
45627,1,2,45627,0,45627,0,4.35905e+13,1.99967,284.964,45627,2,2,38560,38560,38560,38560,38560
12977,1,2,0,12977,12977,0,8.37905e+15,1.99954,150.919,12977,2,2,11467,11467,11467,11467,11467
5439,1,22,0,5439,0,5439,1299730,14.5613,245.631,5439,19,17,712,712,712,712,712
5307,16,20,5307,0,5307,0,1.4745e+18,17.3512,258.538,5307,19,18,5274,5217,5227,4428,4860
27560,54,56,0,27560,27560,0,2.22044e+13,23.2726,671.297,27560,30,31,27504,27492,27504,27504,27504
13671,30,36,13671,0,13671,0,1.42108e+18,25.0264,448.786,13671,35,31,13621,13563,13583,11077,13575
45781,1,2,45781,0,45781,0,3.36558e+13,1.99969,282.213,45781,2,2,40306,40306,40306,40306,40306
20175,39,56,20175,0,20175,0,86673400000,20.1568,595.062,20175,30,32,20119,20109,20119,20119,19467
12058,1,2,12058,0,12058,0,3.25407e+13,1.99809,145.913,12058,2,2,10663,10663,10663,10663,10663
43626,1,2,43626,0,43626,0,3.59635e+13,1.99947,275.193,43626,2,2,38051,38051,38051,38051,38051
38892,1,2,38892,0,38892,0,3.25898e+13,1.99977,260.846,38892,2,2,34388,34388,34388,34388,34388
37108,21,40,37108,0,37108,0,1.4546e+18,33.1507,875.789,37108,35,38,36863,36299,36585,13207,31206
27041,32,40,27041,0,0,27041,5.72789e+15,22.6672,659.171,27041,31,27,27001,26983,26995,27001,27001
44142,22,23,0,44142,7550,36592,4934.35,18.4958,679.418,44142,21,21,44118,44118,44076,44077,44118
38335,8,38,0,38335,38335,0,2.22238e+13,30.9019,832.802,38335,34,32,34091,27801,25429,28229,17656
5593,1,2,0,5593,5593,0,1.60271e+16,1.99875,102.882,5593,2,2,4348,4348,4348,4348,4348
25479,25,44,25479,0,0,25479,5.10232e+15,33.5981,771.061,25479,37,41,25298,24926,24871,13209,15418
12026,26,44,12026,0,12026,0,79159400000,24.8222,564.481,12026,32,41,11953,11846,11819,11594,9197
16884,3,21,0,16884,2669,14215,5085.19,17.7146,384.002,16884,20,20,13616,13616,13566,12544,9092
35647,36,38,0,35647,0,35647,1316070,34.0934,853.797,35647,38,35,35595,35419,35545,35545,32385
47949,1,2,47949,0,47949,0,3.35311e+13,1.99952,289.114,47949,2,2,42236,42236,42236,42236,42236
34317,1,4,34317,0,34317,0,3.89851e+13,1.99945,250.314,34317,3,3,30071,30071,30071,30071,30071
49148,7,23,0,49148,8139,41009,5029.81,18.9835,702.49,49148,22,21,48155,48155,47324,47406,46587
30769,14,40,30769,0,0,30769,340330000,22.2116,663.99,30769,31,29,30510,30201,28042,29183,21175
7613,4,19,3014,4599,0,7613,14.1463,14.0138,311.5,7613,17,17,4824,4824,4799,4801,3459
27654,11,44,27654,0,0,27654,327116000,26.3764,703.788,27654,36,37,26676,25438,24720,24697,13785
44438,35,40,0,44438,44438,0,2.22942e+13,36.8333,868.761,44438,33,31,44388,44330,44382,44381,41063
43432,21,56,0,43432,0,43432,1329130,22.8045,842.343,43432,32,32,43353,43159,43221,43214,37075
1649,8,9,0,1649,245,1404,5149.19,7.02426,97.4893,1649,9,8,1639,1639,1639,1639,1639
5134,17,24,5134,0,0,5134,341871000,17.3101,267.73,5134,19,21,5100,5023,5064,5061,4901
32509,10,60,32509,0,32509,0,79215900000,33.2339,918.79,32509,39,44,29912,27639,26685,26189,10355
40237,19,40,40237,0,0,40237,340331000,21.961,754.629,40237,32,29,40166,40038,40061,40058,34265
29961,58,60,0,29961,29961,0,2.16112e+13,25.7681,814.059,29961,33,40,29901,29890,29899,29901,28904
24151,24,38,24151,0,24151,0,1.45343e+18,30.9926,677.303,24151,32,33,24055,23953,23990,19086,23938
30321,4,21,4871,25450,0,30321,19.9439,19.1661,521.688,30321,21,21,27639,27639,25259,24596,9242
3373,15,20,3373,0,0,3373,340996000,15.6045,198.393,3373,15,17,3349,3329,3330,3330,3244
908,2,10,154,754,0,908,20.5815,7.31718,81.8594,908,9,9,594,594,591,364,364
29452,8,20,5209,24243,0,29452,20.308,15.4495,538.394,29452,20,19,29106,29104,27715,27712,28336
38064,31,40,0,38064,0,38064,1331310,22.9942,765.959,38064,32,28,38024,38006,38017,38018,38024
39628,13,20,6706,32922,0,39628,20.3213,12.555,597.551,39628,20,19,39601,39601,39601,39601,39597
2568,4,23,0,2568,0,2568,1297960,19.3481,211.216,2568,20,21,1767,1334,1245,666,643
24807,11,44,0,24807,24807,0,2.12474e+13,34.2865,672.971,24807,37,37,23864,22725,22302,21776,10527
41762,1130,3876,8006,33756,41306,456,1.36173e+18,140.271,6594.09,41762,1097,222,37886,37789,35899,37084,10945
3918,4,13,642,3276,0,3918,20.2072,8.62302,182.201,3918,11,12,3528,3528,3213,3085,2895
37406,20,32,0,37406,8725,28681,4647.04,14.8426,803.032,37406,21,25,37373,37373,37217,37217,30545
45505,21,44,45505,0,0,45505,315671000,37.5078,939.097,45505,39,37,45034,44204,44599,27496,25604
40608,17,56,40608,0,40608,0,1.4501e+18,37.0787,846.516,40608,39,39,40352,39618,39885,5658,30069
9917,32,36,9917,0,0,9917,268659000,30.9028,474.888,9917,34,33,9873,9839,9763,9236,9143
31030,39,48,0,31030,0,31030,1113540,33.4192,935.507,31030,36,41,30981,30948,30662,30673,24442
38250,37,44,0,38250,0,38250,1217710,36.9629,900.716,38250,38,41,38202,38156,37977,37978,37730
36696,42,48,0,36696,0,36696,1203190,37.5617,947.1,36696,37,41,36648,36629,36573,36576,36441
39576,7,28,6478,33098,0,39576,20.034,15.6296,628.24,39576,21,27,38875,38875,37346,37874,37285
14718,47,56,14718,0,14718,0,8.4522e+10,25.2597,550.557,14718,32,40,14662,14652,14653,14662,14131
22374,13,40,22374,0,22374,0,87444300000,20.7003,601.827,22374,30,26,21887,20401,19467,19888,15148
45817,31,56,0,45817,0,45817,1325760,35.7313,871.163,45817,40,32,45751,45705,45730,45730,40289
2358,1,22,2358,0,2358,0,1.44433e+18,20.1052,193.716,2358,19,21,217,217,217,217,217
35714,12,56,0,35714,0,35714,1312020,27.5227,866.596,35714,38,42,34488,32379,29897,30270,16431
7803,16,21,0,7803,1312,6491,5027.48,10.3535,284.48,7803,17,20,7779,7778,7761,7761,7681
25172,1,40,0,25172,0,25172,1155220,35.1317,737.813,25172,37,37,2785,2785,2785,2785,2785
15514,1,2,15514,0,15514,0,3.26761e+13,1.99929,164.565,15514,2,2,13712,13712,13712,13712,13712
15375,27,28,0,15375,2785,12590,5030.82,16.4461,464.876,15375,19,28,15347,15347,15347,15347,15343
41601,1,4,0,41601,41601,0,8.33492e+15,3.12512,277.595,41601,4,4,36784,36784,36784,36784,36784
19639,36,40,19639,0,0,19639,4.12901e+15,32.4277,724.321,19639,33,37,19599,19582,19479,19515,17661
33145,1,2,33145,0,33145,0,3.77734e+13,1.99967,240.954,33145,2,2,28696,28696,28696,28696,28696
13619,19,24,0,13619,13619,0,2.22654e+13,18.7883,416.439,13619,21,21,13589,13543,13559,13553,13258
1534,1,2,0,1534,1534,0,8.31434e+15,1.99087,52.0815,1534,2,2,1356,1356,1356,1356,1356
45865,4,56,0,45865,0,45865,1318090,28.7152,893.205,45865,37,40,33518,25713,25017,21916,9841
6986,7,40,0,6986,0,6986,1312330,19.1563,363.076,6986,29,24,6059,5173,4474,4151,2915
37110,15,21,0,37110,5980,31130,5131.42,15.8921,574.77,37110,21,21,37059,37059,37041,37041,36943
11567,1,2,0,11567,11567,0,8.37879e+15,1.99965,142.683,11567,2,2,10221,10221,10221,10221,10221
15651,2,5,15651,0,15651,0,6.18486e+13,1.99955,176.443,15651,3,4,15645,15644,14013,15644,15645
37615,19,40,37615,0,37615,0,72501700000,35.9978,952.072,37615,38,37,36710,34412,35306,33518,22806
11537,1,2,11537,0,11537,0,5.88958e+13,1.99844,146.403,11537,2,2,9122,9122,9122,9122,9122
42910,21,44,42910,0,0,42910,5.49988e+15,31.2436,851.083,42910,37,37,42646,42267,42417,8004,26985
12445,6,60,12445,0,0,12445,327731000,21.969,601.682,12445,30,44,9861,8495,7035,5664,3976
30639,16,20,5417,25222,0,30639,20.0557,14.6667,600.535,30639,19,20,30588,30588,30544,30544,30519
10009,10,38,0,10009,10009,0,2.2104e+13,25.512,477.502,10009,32,34,9300,8771,7665,7680,3448
4711,1,28,873,3838,0,4711,19.0771,14.3331,279.954,4711,18,27,809,809,809,809,809
23396,2,4,0,23396,23396,0,8.34348e+15,2.0003,208.361,23396,3,3,23391,23390,23391,23391,22257
13299,1,2,13299,0,13299,0,3.56421e+13,1.99887,151.682,13299,2,2,11614,11614,11614,11614,11614
48247,8,20,8090,40157,0,48247,20.3238,12.2179,651.264,48247,20,19,47907,47906,46045,46043,47399
20543,15,40,20543,0,0,20543,4.94578e+15,35.8567,671.575,20543,37,37,19531,17199,18826,4374,8154
43476,10,40,0,43476,0,43476,1130240,35.4958,1008.43,43476,40,37,38503,34004,34918,34610,14234
40688,59,64,0,40688,0,40688,1177840,31.6309,1127.72,40688,36,44,40624,40613,40620,40624,37095
9240,50,56,9240,0,0,9240,5.38811e+15,29.7531,504.346,9240,32,44,9184,9176,9178,9184,8765
49545,29,40,0,49545,49545,0,2.21529e+13,27.86,873.551,49545,40,37,49473,49394,49423,49405,41501
4738,36,40,0,4738,4738,0,2.16626e+13,18.3632,265.958,4738,25,25,4698,4690,4698,4691,4425
1069,1,2,0,1069,1069,0,8.35841e+15,1.9841,43.1496,1069,2,2,944,944,944,944,944
38204,13,20,6607,31597,0,38204,20.3165,14.8698,602.696,38204,20,19,38170,38170,38170,38170,38138
31511,3,4,0,31511,31511,0,9.45797e+15,2.42829,254.592,31511,4,4,31487,31453,31480,31480,28029
13859,41,56,13859,0,13859,0,1.44573e+18,23.1757,496.969,13859,36,31,13803,13791,13795,5125,13801
13532,1,2,13532,0,13532,0,3.25739e+13,1.99911,153.563,13532,2,2,11965,11965,11965,11965,11965
11501,30,36,11501,0,0,11501,328910000,26.4226,414.64,11501,33,33,11451,11393,11413,9382,11405
12725,37,40,12725,0,12725,0,1.45642e+18,21.8457,458.534,12725,29,28,12685,12671,12683,10887,11815
30826,7,64,30826,0,0,30826,5.60138e+15,23.0138,888.988,30826,32,44,26285,22289,19329,7627,10876
20890,4,38,20890,0,20890,0,85451100000,30.0606,668.413,20890,38,36,14291,10765,10096,12627,4742
3555,12,18,0,3555,3555,0,2.26138e+13,16.818,211.547,3555,18,18,3461,3257,3067,3197,2753
40037,2,5,40037,0,40037,0,5.64469e+13,1.99933,280.257,40037,3,4,40031,40030,38399,40030,40031
16595,2,4,16595,0,16595,0,4.72376e+13,1.99928,178.37,16595,3,3,16590,16589,16589,16589,15557
15594,7,36,15594,0,0,15594,5.45701e+15,27.8935,482.862,15594,34,33,14288,12901,12102,2651,4570
48302,43,44,48302,0,48302,0,8.0078e+10,36.9171,990.107,48302,41,37,48258,48235,48228,48228,48258
33848,9,44,0,33848,33848,0,1.81327e+13,37.7197,929.83,33848,39,39,27961,22726,24682,23260,11271
37825,30,60,37825,0,37825,0,84883300000,25.4403,890.302,37825,33,40,37749,37635,37613,37595,33400
37462,2,5,16,37446,37462,0,1.63804e+16,2.00088,277.556,37462,5,4,37453,37449,35821,37450,28953
6409,32,40,6409,0,6409,0,6.4645e+10,28.6113,414.778,6409,29,33,6369,6352,6326,6273,6237
24343,6,54,24337,6,0,24343,1.50966e+15,31.9772,813.43,24343,36,45,19706,17437,14562,15592,8338
13413,12,40,0,13413,13413,0,1.91425e+13,30.8107,550.969,13413,36,37,12293,10838,11591,11014,5964
39905,1,23,0,39905,8198,31707,4680.81,20.1517,720.881,39905,22,22,8825,8825,8825,8825,8825
8942,19,36,8942,0,8942,0,63766500000,28.6426,470.235,8942,32,30,8551,7116,7424,7011,6189
23493,1,2,23493,0,23493,0,3.31161e+13,1.99877,201.543,23493,2,2,20728,20728,20728,20728,20728
3200,16,32,3200,0,0,3200,295636000,27.7025,233.631,3200,28,28,3060,2848,2991,2987,2136
34503,1,2,34503,0,34503,0,3.67925e+13,1.9991,245.436,34503,2,2,29992,29992,29992,29992,29992
18047,39,48,0,18047,0,18047,1157260,26.8878,734.232,18047,32,41,17999,17988,17874,17876,15226
31048,32,56,0,31048,31048,0,2.22486e+13,21.5768,714.953,31048,30,32,30992,30972,30986,30984,28604
17044,22,40,0,17044,0,17044,1330870,21.4793,535.29,17044,29,28,17003,16982,16983,16985,16244
4232,20,32,4232,0,4232,0,1.40764e+18,17.8552,229.872,4232,25,21,4188,4160,4180,768,3520
20299,11,24,20299,0,20299,0,1.46861e+18,21.9739,535.197,20299,23,22,19632,18676,17099,10456,11812
9904,18,44,9904,0,9904,0,86744100000,18.4446,415.14,9904,20,36,9854,9821,9821,9826,9058
46101,5,40,46101,0,0,46101,5.71732e+15,31.2325,883.304,46101,33,31,35579,26252,26366,5634,10897
2524,13,36,2524,0,2524,0,1.40724e+18,14.2702,186.135,2524,22,25,2476,2423,2446,583,1856
34863,42,44,34863,0,0,34863,260449000,36.8811,983.335,34863,40,37,34819,34802,34815,34715,34819
42097,42,44,0,42097,42097,0,2.07766e+13,29.6017,938.902,42097,40,41,42053,42042,41871,41965,39597
2865,26,36,2865,0,2865,0,84718100000,13.8059,199.041,2865,21,25,2829,2817,2826,2794,2827
36894,1,4,0,36894,36894,0,8.32996e+15,3.26866,261.938,36894,4,4,32624,32624,32624,32624,32624
1236,102,124,149,1087,1207,29,2.01132e+16,31.4773,308.569,1236,34,34,1112,1111,1095,1081,1040
18329,13,24,18329,0,0,18329,339297000,18.3415,483.604,18329,21,21,18115,17360,16804,17001,13281
20394,1,4,0,20394,20394,0,8.23253e+15,3.05982,209.591,20394,4,4,18033,18033,18033,18033,18033
5857,7,36,5857,0,5857,0,85550300000,17.7089,275.893,5857,24,25,5366,4819,4401,4704,2443
31238,43,351,31238,0,31238,0,1.08999e+18,25.5702,1211.33,31238,55,58,30859,30777,30760,30737,30726
12635,13,24,0,12635,0,12635,1335310,19.7624,414.387,12635,20,21,12437,11769,11449,11601,9574
18211,22,23,3208,15003,0,18211,19.1807,14.144,450.548,18211,19,21,18188,18188,18149,18149,18185
3488,53,56,3488,0,0,3488,311610000,21.9447,285.438,3488,28,30,3432,3428,3431,3432,2873
7066,11,21,0,7066,1567,5499,4578.15,15.5211,307.684,7066,18,20,6988,6988,6955,6967,6010
49627,52,64,49627,0,49627,0,1.36989e+18,37.0588,1183.93,49627,41,44,49563,49538,49555,49105,48135
21006,3,21,5714,15292,0,21006,16.1348,17.5324,538.292,21006,20,20,15101,15078,14981,14881,6908
5948,4,36,5948,0,5948,0,1.18529e+18,29.0049,353.549,5948,30,29,4231,3535,3660,937,1363
48686,27,40,0,48686,48686,0,2.21532e+13,32.5393,979.41,48686,38,37,48549,48312,48384,48356,41227
16210,1,44,16210,0,0,16210,303265000,26.075,638.699,16210,35,41,1637,1637,1637,1637,1637
16386,9,21,2883,13503,0,16386,18.6811,16.2235,410.023,16386,19,19,16125,16125,16033,16100,4500
23196,29,40,23196,0,23196,0,1.46727e+18,21.5302,616.396,23196,30,29,23156,23138,23146,20466,22501
47842,40,44,0,47842,47842,0,2.11751e+13,34.8493,920.978,47842,38,37,47796,47775,47722,47710,47789
45396,35,60,45396,0,45396,0,84046500000,37.2679,933.992,45396,38,44,45320,45174,45138,45100,28641
6395,8,20,0,6395,6395,0,2.23946e+13,16.6264,274.247,6395,18,18,5920,5080,4932,5124,3681
23678,3,56,23678,0,23678,0,1.45367e+18,21.9746,632.197,23678,37,32,15563,13187,11734,2960,4514
9748,14,40,0,9748,9748,0,2.14227e+13,27.4986,406.596,9748,32,37,9577,9391,9440,9245,5299
41097,24,56,41097,0,0,41097,336328000,29.033,843.211,41097,38,40,40985,40889,40921,38153,32110
23832,1,5,1,23831,23832,0,1.42773e+16,1.99966,221.143,23832,4,3,19106,19106,19106,19106,19106
37880,1,28,6360,31520,0,37880,20.2612,12.2945,597.954,37880,21,21,6345,6345,6345,6345,6345
18437,8,21,0,18437,2886,15551,5124.22,15.4242,388.405,18437,20,20,18325,18325,18220,18230,17979
21905,1,2,21905,0,21905,0,3.28313e+13,1.999,194.911,21905,2,2,19349,19349,19349,19349,19349
15953,1,40,15953,0,0,15953,4.67651e+15,33.9728,624.245,15953,36,37,1490,1490,1490,1490,1490
17285,11,24,17285,0,0,17285,342626000,20.4595,492.199,17285,22,21,16699,15859,14570,14628,10040
8983,29,40,0,8983,8983,0,2.21121e+13,19.7098,403.405,8983,29,24,8943,8927,8937,8932,8740
37532,3,4,0,37532,37532,0,1.0809e+16,1.99965,264.852,37532,3,3,37528,37526,37527,37527,37528
4520,1,2,0,4520,4520,0,8.25793e+15,1.99447,88.6332,4520,2,2,4001,4001,4001,4001,4001
12400,37,40,12400,0,12400,0,1.46261e+18,20.5403,461.667,12400,28,29,12360,12346,12358,11268,12004
19248,18,24,19248,0,19248,0,87650500000,21.1599,526.846,19248,24,22,19195,19132,18994,18975,16359
18727,1,2,18727,0,18727,0,3.2616e+13,1.99899,181.51,18727,2,2,16556,16556,16556,16556,16556
29063,9,40,29063,0,29063,0,86486300000,26.0931,767.057,29063,36,36,26765,21940,21497,22011,8461
40326,1,2,0,40326,40326,0,1.0891e+16,1.99963,267.959,40326,2,2,34230,34230,34230,34230,34230
15226,40,56,15226,0,15226,0,1.45431e+18,20.0089,531.743,15226,31,32,15170,15162,15164,13131,15168
47666,1,2,0,47666,47666,0,1.34407e+16,1.99977,296.765,47666,2,2,38774,38774,38774,38774,38774
9668,13,19,1727,7941,0,9668,20.2495,11.3371,313.831,9668,19,18,9643,9643,9643,9643,9643
12014,10,24,0,12014,0,12014,1321720,18.2737,393.762,12014,20,21,11646,11294,10220,10206,7161
8677,33,49,0,8677,8656,21,9.89492e+15,32.036,473.071,8677,40,30,8625,8578,8618,8559,7608
43877,10,23,0,43877,7679,36198,4860.58,19.3908,685.394,43877,21,21,43398,43382,43164,43283,11877
45435,2,56,0,45435,45435,0,2.23106e+13,22.7504,847.676,45435,32,32,25044,25038,16776,20543,7646
14794,39,40,0,14794,0,14794,1215670,32.3148,519.505,14794,34,34,14754,14734,14726,14727,14752
21005,1,2,21005,0,21005,0,3.25093e+13,1.99871,191.978,21005,2,2,18578,18578,18578,18578,18578
35121,18,56,0,35121,0,35121,1326490,22.5867,756.096,35121,32,32,35003,34863,34701,34726,29957
10324,25,60,10324,0,0,10324,5.1972e+15,31.5164,531.068,10324,32,39,10219,10084,10089,5083,7339
44298,10,28,0,44298,7883,36415,5134.24,15.867,729.507,44298,19,28,43997,43997,43835,43839,43411
22819,31,40,22819,0,0,22819,339929000,32.5115,629.85,22819,31,30,22771,22731,22759,22759,21885
25545,16,24,25545,0,25545,0,1.46868e+18,21.9073,598.686,25545,24,22,25402,25017,24464,20471,19354
8488,8,28,0,8488,1346,7142,5080.67,10.6475,299.905,8488,19,21,8402,8401,8306,8310,8149
29158,39,44,29158,0,0,29158,5.20961e+15,34.0584,808.767,29158,37,41,29114,29089,29011,28807,28525
36952,7,40,36952,0,36952,0,1.33673e+18,32.7775,862.797,36952,40,37,32467,28739,27427,5499,11045
2545,15,22,2545,0,0,2545,5.72771e+15,16.0161,194.3,2545,19,19,2505,2455,2444,2154,2297
41980,1,4,0,41980,41980,0,9.46464e+15,1.99981,276.571,41980,3,3,36463,36463,36463,36463,36463
4059,20,54,4053,6,0,4059,9.05388e+15,23.5028,393.822,4059,34,45,3898,3268,3463,3326,1147
14801,32,38,14801,0,0,14801,5.64525e+15,28.395,523.127,14801,31,30,14757,14715,14748,14756,14757
3553,1,11,545,3008,0,3553,20.1036,9.91556,157.642,3553,10,11,649,649,649,649,649
30282,12,44,30282,0,30282,0,83542100000,35.5123,753.155,30282,36,37,29315,27851,27129,27360,16327
46574,14,44,46574,0,0,46574,4.69037e+15,37.4683,1076.8,46574,40,39,42685,34594,40290,9932,21270
12260,26,40,12260,0,0,12260,295607000,32.8166,498.813,12260,34,33,12160,11871,11975,9224,9565
799,1,2,799,0,799,0,3.31147e+13,1.97622,37.3634,799,2,2,704,704,704,704,704
18836,8,56,0,18836,18836,0,2.18023e+13,24.5306,610.875,18836,33,40,17199,14788,13975,14970,7283
24812,31,40,24812,0,24812,0,87482200000,20.945,632.023,24812,30,27,24772,24756,24767,24764,24160
18350,1,2,18350,0,18350,0,4.00047e+13,1.99826,180.249,18350,2,2,15741,15741,15741,15741,15741
32228,12,44,0,32228,0,32228,1017540,36.495,933.485,32228,38,37,26960,19475,23820,23631,12798
30258,5,44,30258,0,0,30258,5.15552e+15,33.7514,816.31,30258,40,41,23870,18629,20010,4825,4843
912,11,18,912,0,0,912,5.79246e+15,15.9243,111.881,912,15,18,852,788,762,725,655
29421,3,40,0,29421,0,29421,1252250,28.7695,721.07,29421,37,35,20124,17330,16039,12853,4813
36404,37,40,36404,0,0,36404,296450000,36.614,898.672,36404,39,37,36357,36314,36174,34061,35970
25728,1,4,25728,0,25728,0,3.81602e+13,1.99876,215.084,25728,3,3,22747,22747,22747,22747,22747
43589,20,44,0,43589,0,43589,1217000,38.6433,963.913,43589,40,39,43037,42135,42432,42446,25936
5617,13,22,0,5617,0,5617,1341010,17.2994,278.47,5617,19,19,5511,5173,5138,5240,4550
40070,4,20,0,40070,7232,32838,5145.63,16.7191,679.802,40070,19,20,34871,34871,31123,23114,23892
35136,2,56,35136,0,0,35136,5.69968e+15,22.823,757.222,35136,32,32,19383,19377,13013,3908,4104
37457,57,60,37457,0,37457,0,1.40466e+18,34.8027,883.057,37457,45,41,37397,37385,37397,32848,34168
26757,32,56,26757,0,0,26757,338534000,23.0964,668.939,26757,30,32,26701,26681,26695,26692,23978
22756,10,40,22756,0,22756,0,8.6449e+10,27.2921,558.001,22756,29,29,22084,21452,19508,19355,11157
30706,2082,3294,30304,402,0,30706,1.06384e+18,148.663,5620.85,30706,906,228,27412,27411,26533,22127,13568
48033,22,40,0,48033,48033,0,2.22258e+13,26.6533,842.2,48033,34,29,47956,47872,47911,47805,39494
28785,36,44,0,28785,28785,0,2.01464e+13,32.2511,807.337,28785,38,41,28733,28703,28474,28503,24481
44655,13,44,44655,0,0,44655,4.30563e+15,36.6181,1106.41,44655,40,37,37710,25169,33588,11293,15854
24927,1,28,0,24927,4597,20330,5045.73,16.8374,596.098,24927,19,28,4002,4002,4002,4002,4002
30282,11,23,0,30282,5052,25230,4984.81,16.9702,553.582,30282,20,21,30111,30111,30037,30074,29368
40942,9,23,7637,33305,0,40942,18.7546,18.8301,696.252,40942,21,22,40337,40337,40065,40194,37511
12593,1,2,0,12593,12593,0,9.2182e+15,1.99952,148.17,12593,2,2,10981,10981,10981,10981,10981
33960,58,65,33959,1,0,33960,1.08215e+15,31.4088,1114.69,33960,37,48,33895,33886,33890,32524,30296
7094,24,40,7094,0,0,7094,292275000,28.287,420.67,7094,29,37,7028,6968,6934,6634,5899
43150,1,4,0,43150,43150,0,1.13221e+16,2.12253,295.905,43150,4,4,36345,36345,36345,36345,36345
24537,25,40,24537,0,24537,0,1.46758e+18,21.4333,625.215,24537,27,29,24497,24477,24484,21267,24497
6029,11,22,6029,0,6029,0,87723100000,20.0302,303.025,6029,21,21,5741,5365,4987,4843,3827
5164,6,11,0,5164,823,4341,5204.67,8.87064,189.04,5164,11,10,5060,5060,4938,4938,4994
20630,29,44,20630,0,0,20630,272024000,39.2282,748.442,20630,36,38,20533,20364,20146,18112,13844
42714,28,44,42714,0,0,42714,328850000,32.6675,863.176,42714,37,38,42596,42417,42386,22655,33223
15601,4,40,15601,0,15601,0,87214200000,21.2997,512.568,15601,29,27,11029,8337,8044,9668,3246
40767,18,56,40767,0,0,40767,5.6596e+15,23.738,843.727,40767,32,40,40585,40371,40190,29759,32978
24174,1,2,24174,0,24174,0,3.2649e+13,1.99979,206.049,24174,2,2,21369,21369,21369,21369,21369
29277,3,23,5007,24270,0,29277,19.3482,19.0779,561.221,29277,21,21,23391,23390,23283,21746,13959
3799,18,19,0,3799,869,2930,4302.47,14.0392,211.174,3799,17,17,3779,3779,3753,3753,3777
25504,2,4,0,25504,25504,0,8.28391e+15,3.61194,222.732,25504,4,4,25490,25486,25490,25490,23556
5236,9,11,825,4411,0,5236,20.2345,9.95034,192.136,5236,11,11,5217,5217,5208,5208,5209
38151,34,48,38151,0,0,38151,4.85001e+15,32.5627,1015.77,38151,37,41,38087,37986,37683,27616,29932
20054,13,65,20054,0,0,20054,5.73735e+15,36.1022,869.885,20054,37,48,16702,10616,14351,5425,5557
24251,1,4,0,24251,24251,0,8.26623e+15,2.55664,225.408,24251,4,4,21440,21440,21440,21440,21440
15258,35,36,15258,0,15258,0,1.42782e+18,24.4505,476.801,15258,36,32,15220,15183,15212,13842,15212
6857,4,22,6857,0,0,6857,343374000,19.5539,315.204,6857,20,20,4841,3652,3545,2523,1695
39838,1,48,0,39838,0,39838,1141520,36.1669,1033.9,39838,38,41,3720,3720,3720,3720,3720
20265,23,40,20265,0,20265,0,8.5222e+10,32.1648,560.544,20265,36,33,20166,20048,20107,19972,16474
35214,29,56,35214,0,35214,0,85836900000,30.3587,786.421,35214,38,40,35126,35041,35061,35037,27081
3866,26,40,3866,0,3866,0,1.44794e+18,15.6524,258.962,3866,19,29,3826,3818,3821,3326,3824
45115,1,2,45115,0,45115,0,3.25679e+13,1.99967,281.9,45115,2,2,39894,39894,39894,39894,39894
23132,3,4,0,23132,23132,0,8.36082e+15,2,206.877,23132,3,3,23128,23126,23127,23127,23128
35636,29,38,35636,0,35636,0,1.45527e+18,32.9173,814.732,35636,33,34,35553,35412,35500,30792,35553
20109,1,2,0,20109,20109,0,8.96554e+15,1.9998,186.747,20109,2,2,17606,17606,17606,17606,17606
29554,1,2,29554,0,29554,0,3.25914e+13,1.99956,227.516,29554,2,2,26131,26131,26131,26131,26131
1903,18,20,0,1903,0,1903,1328490,12.3594,147.767,1903,14,17,1883,1877,1881,1881,1831
7629,8,22,0,7629,7629,0,2.24485e+13,20.5955,336.834,7629,20,21,6841,5625,5080,5762,3981
22659,1,2,0,22659,22659,0,9.93777e+15,1.99974,199.322,22659,2,2,19533,19533,19533,19533,19533
3232,7,20,3232,0,3232,0,86872100000,14.4319,188.032,3232,16,17,2952,2639,2388,2544,1623
14761,1,2,14761,0,14761,0,3.24933e+13,1.99844,160.915,14761,2,2,13056,13056,13056,13056,13056
20895,1,2,20895,0,20895,0,3.25592e+13,1.99957,191.369,20895,2,2,18477,18477,18477,18477,18477
41340,50,60,0,41340,0,41340,1271440,35.9575,1015.78,41340,37,51,41280,41268,41276,41278,36494
9028,2,40,9028,0,9028,0,86976400000,22.5472,374.907,9028,21,28,5065,5064,3418,4143,1392
48155,40,65,48155,0,48155,0,1.13922e+18,39.724,1277.82,48155,48,48,48086,48057,47612,28057,19772
5148,11,18,0,5148,0,5148,1340870,16.0546,255.091,5148,18,18,4990,4764,4512,4498,4036
20303,16,60,0,20303,20303,0,2.02826e+13,25.2053,767.397,20303,36,44,19627,17518,18742,18198,11613
15325,47,64,15325,0,15325,0,1.46327e+18,20.0375,581.135,15325,29,41,15261,15261,15261,15261,15084
27746,1,40,27746,0,27746,0,83119200000,28.463,688.511,27746,37,35,3399,3399,3399,3399,3399
13132,55,60,0,13132,13132,0,1.88776e+13,33.9772,715.206,13132,35,52,13072,13064,13067,13072,11434
17704,1,2,17704,0,17704,0,4.07649e+13,1.9991,176.167,17704,2,2,15139,15139,15139,15139,15139
13437,7,24,13437,0,0,13437,5.72435e+15,21.2105,428.242,13437,21,22,11970,10435,8945,2860,5319
31816,6,40,0,31816,0,31816,1329380,23.0053,684.941,31816,32,24,27390,24670,19621,19512,10662
16310,19,36,0,16310,16310,0,2.11222e+13,28.5829,504.425,16310,35,33,16125,15884,16008,15672,10912
34120,1,2,0,34120,34120,0,9.74425e+15,1.99941,244.313,34120,2,2,29505,29505,29505,29505,29505
14993,1,2,0,14993,14993,0,8.90086e+15,1.99773,161.283,14993,2,2,13140,13140,13140,13140,13140
17064,29,38,17064,0,0,17064,5.61578e+15,35.0278,578.14,17064,34,32,16990,16890,16954,16987,16990
8247,5,20,0,8247,1448,6799,5161.97,10.7518,293.124,8247,19,16,7580,7580,6782,6561,5360
29433,36,40,0,29433,29433,0,2.23891e+13,22.5282,686.356,29433,31,28,29393,29377,29390,29390,29393
4288,1,2,0,4288,4288,0,8.40224e+15,1.99487,86.728,4288,2,2,3787,3787,3787,3787,3787
33014,6,56,33014,0,33014,0,1.46008e+18,22.6548,738.224,33014,32,32,28208,25283,20126,4383,10598
10249,4,40,10249,0,0,10249,5.67542e+15,18.5597,387.442,10249,20,29,7576,5823,5648,1502,2903
46373,43,48,0,46373,46373,0,1.99965e+13,37.3263,1052.94,46373,40,41,46325,46308,46278,46305,46192
10223,1,2,10223,0,10223,0,3.25171e+13,1.99902,134.361,10223,2,2,9041,9041,9041,9041,9041
5711,29,32,5711,0,0,5711,311796000,22.4138,298.381,5711,32,28,5672,5625,5654,5250,5296
1540,1,24,0,1540,0,1540,1315490,16.1688,156.73,1540,17,21,166,166,166,166,166
29425,14,23,5019,24406,0,29425,19.3426,19.0245,561.832,29425,21,21,29329,29324,29219,29223,28483
33183,3,40,33183,0,0,33183,5.6333e+15,30.7001,716.601,33183,38,37,22321,19012,17205,4215,7306
6136,13,24,6136,0,6136,0,1.46389e+18,20.9017,295.473,6136,20,19,6026,5696,5222,4544,4552
33951,1,2,33951,0,33951,0,3.17697e+13,1.99941,246.21,33951,2,2,30118,30118,30118,30118,30118
37229,5,28,6258,30971,0,37229,20.2619,12.3472,593.828,37229,21,21,34710,34710,30928,30654,28703
6160,1,2,6160,0,6160,0,3.92511e+13,1.9987,103.331,6160,2,2,5300,5300,5300,5300,5300
9413,29,40,9413,0,9413,0,1.34225e+18,22.0811,419.37,9413,32,33,9363,9306,9284,5812,8192
26923,1,2,26923,0,26923,0,3.27549e+13,1.99955,216.676,26923,2,2,23789,23789,23789,23789,23789
17443,4,40,17443,0,17443,0,1.42734e+18,34.4754,527.164,17443,32,37,13088,10206,10021,2309,4814
27013,7,40,27013,0,0,27013,339728000,22.9631,624.245,27013,31,28,24187,21190,18549,19642,9110
18129,11,21,0,18129,2927,15202,5076.11,17.8339,408.82,18129,20,20,18046,18046,18007,18030,17922
19639,1,2,19639,0,19639,0,3.50142e+13,1.99954,184.534,19639,2,2,17195,17195,17195,17195,17195
32287,1,19,5812,26475,0,32287,20.2121,16.324,578.627,32287,19,19,4963,4963,4963,4963,4963
34760,1,28,6025,28735,0,34760,20.0214,14.0517,648.086,34760,20,28,5702,5702,5702,5702,5702
20209,43,65,20208,1,20208,1,4.2119e+12,34.8917,945.468,20209,36,57,20144,20138,20003,20053,10598
20392,23,60,0,20392,0,20392,1201760,31.7033,777.223,20392,36,44,20205,19781,19982,19990,13169
12379,2,4,0,12379,12379,0,1.11471e+16,2.10986,163.387,12379,4,4,12350,12341,12346,12347,12305
27345,19,40,27345,0,27345,0,1.46556e+18,21.0686,660.137,27345,29,29,27270,27154,27106,14205,25404
47308,9,40,0,47308,47308,0,2.21946e+13,26.9732,836.884,47308,35,29,44643,38011,38340,38078,18783
32855,1,2,32855,0,32855,0,5.89508e+13,1.9997,248.356,32855,2,2,25973,25973,25973,25973,25973
13018,26,44,13018,0,13018,0,85587900000,33.297,487.543,13018,28,37,12964,12939,12944,12905,12701
26680,22,44,26680,0,26680,0,1.40025e+18,26.7519,691.31,26680,35,37,26512,26230,26325,13582,20425
1979,8,18,1979,0,0,1979,5.73361e+15,13.1915,149.677,1979,14,15,1831,1571,1528,1403,1307
46731,1,4,0,46731,46731,0,8.60263e+15,2.00009,290.785,46731,3,3,41149,41149,41149,41149,41149
13471,8,21,0,13471,2158,11313,5139.92,17.1613,339.507,13471,20,20,13375,13375,13291,13299,13289
20997,54,56,0,20997,20997,0,2.17579e+13,28.9999,701.237,20997,38,42,20941,20931,20941,20941,20941
7818,3,19,0,7818,2111,5707,4064.43,14.9742,315.142,7818,19,17,5704,5699,5656,5660,2581
21715,16,40,21715,0,21715,0,76664200000,32.6895,665.822,21715,37,34,20949,18901,20372,19348,10508
2755,29,38,0,2755,2755,0,2.10867e+13,30.1111,242.434,2755,29,29,2698,2575,2633,2631,2549
26444,1,2,0,26444,26444,0,1.62105e+16,1.99951,224.802,26444,2,2,20494,20494,20494,20494,20494
11181,37,40,11181,0,11181,0,84671700000,24.5019,435.833,11181,31,37,11141,11131,11111,11104,11111
38301,1,4,0,38301,38301,0,8.46984e+15,2.0001,264.717,38301,3,3,33796,33796,33796,33796,33796
19831,1,21,4956,14875,0,19831,16.6666,18.0121,513.902,19831,20,20,5045,5045,5045,5045,5045
46378,15,20,8364,38014,0,46378,20.1399,15.9451,724.305,46378,19,20,46298,46298,46250,46250,46225
48213,26,44,48213,0,0,48213,4.68061e+15,38.1365,1097.88,48213,39,39,47895,46884,47059,24592,33983
38253,55,60,38253,0,0,38253,328715000,33.0689,898.844,38253,36,43,38193,38181,38190,38089,35246
25077,1,40,25077,0,0,25077,334003000,32.4987,623.249,25077,37,37,3035,3035,3035,3035,3035
44409,7,40,0,44409,0,44409,1318060,29.0885,828.982,44409,39,37,39868,35070,31346,32956,13108
8482,23,40,8482,0,0,8482,5.49636e+15,27.5103,390.496,8482,31,37,8405,8317,8344,3949,6708
14982,6,40,0,14982,14982,0,2.21024e+13,18.8895,454.1,14982,25,29,13190,12055,9702,11473,5125
25085,25,38,25085,0,0,25085,335724000,36.4911,730.041,25085,36,37,24939,24685,24776,24784,19387
43546,11,40,0,43546,43546,0,2.21189e+13,28.8447,817.269,43546,39,37,42343,40609,38066,37937,22202
28686,23,40,28686,0,28686,0,1.31262e+18,34.0383,773.532,28686,39,37,28414,27709,28041,11073,18361
6711,18,20,6711,0,0,6711,339234000,17.6483,277.716,6711,17,19,6687,6663,6669,6668,6658
13045,18,22,13045,0,0,13045,341671000,20.6334,444.831,13045,22,22,12991,12931,12849,12847,12422
35774,27,40,35774,0,0,35774,5.53814e+15,31.0949,746.462,35774,37,37,35659,35406,35547,23007,24489
33557,52,56,33557,0,0,33557,5.63759e+15,29.5676,779.795,33557,37,40,33501,33489,33497,33501,33457
49242,27,44,0,49242,49242,0,2.09461e+13,31.8811,1000.6,49242,40,41,49079,48596,48634,47975,42002
41961,30,40,41961,0,0,41961,5.65596e+15,29.2181,801.915,41961,39,37,41893,41810,41843,34047,37383
18354,3,44,0,18354,18354,0,2.11312e+13,33.9611,631.545,18354,36,41,12037,10281,9430,9468,2738
38819,22,23,7416,31403,0,38819,18.5088,19.5895,679.209,38819,22,21,38795,38795,38765,38766,38795
33304,8,21,0,33304,5423,27881,5187.77,12.0649,525.756,33304,21,20,33111,33111,32364,32368,32055
40664,6,44,0,40664,0,40664,1053100,36.6567,1028.01,40664,38,39,29815,25243,24300,24804,8642
29603,13,21,0,29603,4882,24721,5192.54,12.3026,501.626,29603,21,20,29574,29574,29572,29574,29571
27160,1,2,27160,0,27160,0,3.40962e+13,1.99937,218.112,27160,2,2,23869,23869,23869,23869,23869
32093,1,2,32093,0,32093,0,3.25916e+13,1.99947,236.984,32093,2,2,28376,28376,28376,28376,28376
48287,37,40,48287,0,0,48287,5.69483e+15,25.7267,849.774,48287,33,29,48244,48216,48240,42883,47000
18391,24,40,0,18391,18391,0,2.22e+13,21.5527,510.782,18391,29,29,18350,18331,18342,18334,18349
12641,1,24,0,12641,12641,0,2.24439e+13,18.7942,414.312,12641,20,21,1352,1352,1352,1352,1352
2391,1,2,2391,0,2391,0,3.34332e+13,1.98996,64.981,2391,2,2,2106,2106,2106,2106,2106
34558,11,40,34558,0,0,34558,5.70906e+15,22.0642,698.324,34558,31,29,33625,32244,29820,8909,19656
47717,1,2,47717,0,47717,0,3.25911e+13,1.99966,289.376,47717,2,2,42191,42191,42191,42191,42191
31473,3,4,31473,0,31473,0,3.74191e+13,1.99921,239.824,31473,3,3,31469,31467,31468,31469,31469
22829,9,38,22829,0,22829,0,1.44488e+18,36.6209,702.693,22829,38,38,20516,16294,14654,2722,8098
31378,30,40,31378,0,31378,0,86923200000,21.9464,659.596,31378,30,29,31338,31319,31334,31322,31336
43437,14,21,8660,34777,0,43437,18.2267,17.508,721.178,43437,21,20,43265,43249,43038,43053,39961
36951,2,23,7151,29800,0,36951,18.518,19.5374,673.08,36951,22,22,25174,25174,25128,21070,8696
18374,25,60,0,18374,18374,0,2.02041e+13,26.2995,748.168,18374,34,44,18254,18057,18034,17853,13356
38258,16,56,0,38258,0,38258,1315220,29.5706,826.444,38258,37,40,37931,37271,37014,37010,26289
26369,8,30,0,26369,4557,21812,4921.09,20.162,560.832,26369,21,27,25895,25867,25706,25775,14057
8503,11,40,8503,0,0,8503,335213000,18.9672,344.394,8503,26,24,8320,8058,7593,7580,4515
40000,11,44,40000,0,0,40000,5.5036e+15,36.3359,839.316,40000,38,37,38660,36937,35866,7102,18961
4566,30,40,0,4566,0,4566,1188320,18.1064,313.194,4566,28,33,4526,4517,4475,4481,4058
41313,12,40,0,41313,0,41313,1329020,38.0041,835.885,41313,33,31,40082,37593,34785,34376,22009
21644,1,4,0,21644,21644,0,8.80911e+15,2.00032,199.896,21644,3,3,18995,18995,18995,18995,18995
23480,1,4,0,23480,23480,0,8.32591e+15,3.31857,210.691,23480,4,4,20762,20762,20762,20762,20762
42644,1,4,0,42644,42644,0,1.15562e+16,2.80858,300.714,42644,4,4,35772,35772,35772,35772,35772
46285,15,21,0,46285,7380,38905,5121.99,17.3503,634.98,46285,21,21,46218,46218,46197,46199,45962
48865,30,40,48865,0,0,48865,340895000,30.3838,884.045,48865,33,31,48815,48775,48799,48799,48815
36678,1,2,36678,0,36678,0,4.86008e+13,1.9997,259.642,36678,2,2,30344,30344,30344,30344,30344
47172,41,44,47172,0,47172,0,1.31566e+18,36.9606,1029.54,47172,41,41,47128,47107,47011,46117,47127
19990,1,2,19990,0,19990,0,3.2245e+13,1.99875,187.515,19990,2,2,17699,17699,17699,17699,17699
43333,1,4,43333,0,43333,0,5.62261e+13,1.99952,289.533,43333,3,3,35184,35184,35184,35184,35184
28055,11,13,4683,23372,0,28055,20.3579,11.6862,477.589,28055,13,13,28031,28031,28020,28021,28028
12806,25,38,12806,0,0,12806,5.7045e+15,21.7603,472.381,12806,29,29,12768,12748,12757,12768,12768
40779,30,44,0,40779,0,40779,1211230,38.189,938.152,40779,37,41,40662,40344,40240,40246,33956
46856,19,28,0,46856,7767,39089,5178.61,18.2105,660.683,46856,28,21,46817,46817,46815,46815,46809
17344,53,64,0,17344,17344,0,1.95452e+13,35.1504,852.111,17344,38,54,17280,17274,17276,17280,14897
41049,26,44,0,41049,0,41049,1211880,41.4718,952.127,41049,41,41,40828,40259,40262,40263,26585
14242,14,19,2205,12037,0,14242,19.8958,12.3225,334.521,14242,19,18,14206,14206,14203,14206,13918
38922,1,2,38922,0,38922,0,5.58944e+13,1.99954,269.623,38922,2,2,31192,31192,31192,31192,31192
19294,1,2,19294,0,19294,0,3.29705e+13,1.99953,183.004,19294,2,2,17033,17033,17033,17033,17033
29579,13,20,5062,24517,0,29579,20.336,11.8126,521.457,29579,19,19,29553,29553,29553,29553,29540
14762,1,2,0,14762,14762,0,9.05967e+15,1.99919,159.81,14762,2,2,12905,12905,12905,12905,12905
35348,1,2,35348,0,35348,0,5.9133e+13,1.99955,258.07,35348,2,2,27921,27921,27921,27921,27921
40726,13,64,40726,0,40726,0,1.31932e+18,28.3002,1113.73,40726,43,44,37867,32278,33456,19101,18909
36803,28,40,36803,0,36803,0,87186800000,32.9185,782.587,36803,32,31,36751,36715,36735,36734,34843
8055,22,36,0,8055,0,8055,1048610,29.9523,426.294,8055,33,29,7904,7519,7731,7735,5576
33303,33,40,33303,0,33303,0,1.42887e+18,29.5668,711.393,33303,37,37,33248,33163,33180,27944,31264
34884,19,40,0,34884,34884,0,2.23243e+13,22.076,708.905,34884,32,29,34817,34713,34734,34718,30230
15848,25,38,15848,0,15848,0,86120500000,32.1626,545.665,15848,32,31,15784,15718,15748,15748,15784
38918,25,44,38918,0,0,38918,327795000,33.9644,831.073,38918,37,38,38750,38478,38492,14930,28058
773,6,10,0,773,137,636,5294.86,7.40103,77.0311,773,9,9,737,737,717,717,704
661,1,2,661,0,661,0,3.23632e+13,1.98487,34.2617,661,2,2,584,584,584,584,584
28774,27,28,0,28774,4777,23997,5170.39,12.3726,525.518,28774,21,21,28746,28746,28746,28746,28742
30031,4,56,30031,0,0,30031,5.69931e+15,23.0067,690.882,30031,32,29,21937,16746,16131,3516,8280
43695,17,32,0,43695,10079,33616,4663.95,16.9682,935.992,43695,21,31,43629,43629,43397,43399,36336
14685,32,40,14685,0,0,14685,5.69996e+15,19.9294,498.731,14685,30,25,14645,14631,14642,14645,14154
4072,1,2,0,4072,4072,0,8.38784e+15,1.99656,84.6892,4072,2,2,3597,3597,3597,3597,3597
39412,1,2,39412,0,39412,0,4.2794e+13,1.9997,265.779,39412,2,2,33419,33419,33419,33419,33419
27648,1,2,27648,0,27648,0,3.28428e+13,1.99949,219.218,27648,2,2,24421,24421,24421,24421,24421
40157,23,44,40157,0,40157,0,83842800000,30.782,824.824,40157,37,37,39952,39562,39712,39198,29194
24328,34,40,24328,0,0,24328,314149000,32.4473,668.183,24328,35,35,24277,24185,24121,21588,21673
12368,12,20,2166,10202,0,12368,20.2303,11.781,352.28,12368,19,18,12340,12339,12340,12340,12338
9455,37,40,9455,0,9455,0,77168600000,30.5351,431.129,9455,33,33,9415,9398,9369,9374,9413
16100,4,24,16100,0,16100,0,87083800000,18.7069,451.469,16100,21,21,11917,9108,8743,10304,4162
18893,3,21,0,18893,3538,15355,4668.3,17.639,452.841,18893,20,19,15124,15122,15035,14740,4777
27571,1,2,27571,0,27571,0,3.25772e+13,1.99967,220.369,27571,2,2,24379,24379,24379,24379,24379
3043,1,2,0,3043,3043,0,8.24057e+15,1.99803,72.2977,3043,2,2,2694,2694,2694,2694,2694
9999,8,44,9999,0,9999,0,1.35684e+18,21.996,465.865,9999,32,37,8973,7817,7734,3172,4100
23576,20,40,23576,0,0,23576,4.9219e+15,36.4158,720.246,23576,37,37,23126,22344,22585,6497,14501
39579,38,44,0,39579,39579,0,2.06696e+13,30.4026,913.543,39579,40,41,39531,39497,39263,39295,34894
7738,1,19,2663,5075,0,7738,14.6508,15.7926,327.051,7738,18,18,2044,2044,2044,2044,2044
25699,27,44,25699,0,0,25699,5.41465e+15,35.1886,690.864,25699,37,37,25584,25310,25366,15417,22547
23801,21,48,23801,0,0,23801,5.02835e+15,33.2421,820.477,23801,33,41,23555,22618,23034,8978,17208
31160,104,351,31160,0,31160,0,8.92968e+17,20.1297,1153.97,31160,55,58,30809,30755,30736,30727,30681
17878,22,24,0,17878,17878,0,2.24011e+13,21.6298,497.967,17878,22,22,17850,17824,17830,17838,16578
44502,11,56,44502,0,0,44502,5.69166e+15,35.4972,848.68,44502,40,32,43107,41137,38055,8601,20851
3534,1,2,3534,0,3534,0,3.45671e+13,1.99179,77.8556,3534,2,2,3099,3099,3099,3099,3099
10141,14,38,10141,0,0,10141,5.7101e+15,20.3205,422.346,10141,30,25,9937,9725,8933,8229,7862
40320,1,4,0,40320,40320,0,8.3406e+15,3.26597,275.195,40320,4,4,35647,35647,35647,35647,35647
46023,1,2,46023,0,46023,0,3.28794e+13,1.99967,283.269,46023,2,2,40646,40646,40646,40646,40646
46992,29,40,46992,0,46992,0,85624800000,33.1609,851.284,46992,38,37,46896,46751,46811,46777,42676
35403,1,21,6745,28658,0,35403,18.6011,16.7391,642.111,35403,21,20,7737,7737,7737,7737,7737
21275,9,24,21275,0,21275,0,1.46452e+18,20.4427,527.84,21275,22,22,20096,17017,17044,7870,12169
7556,34,40,7556,0,0,7556,337463000,16.0839,338.327,7556,23,29,7516,7508,7516,7514,7516
10891,1,2,0,10891,10891,0,8.36956e+15,1.9989,137.806,10891,2,2,9625,9625,9625,9625,9625
36983,44,60,36983,0,0,36983,310432000,36.4768,1070.13,36983,39,54,36923,36913,36736,35109,27995
23297,11,20,3988,19309,0,23297,20.3049,11.7683,467.832,23297,19,19,23253,23253,23242,23241,23220
28901,7,64,28901,0,28901,0,1.32679e+18,35.3968,1060.43,28901,46,46,22540,18150,16132,3670,7081
7480,3,22,0,7480,7480,0,2.24547e+13,20.5802,333.402,7480,21,21,4730,3977,3516,3977,1542
1944,1,2,1944,0,1944,0,3.1999e+13,1.99126,58.7869,1944,2,2,1722,1722,1722,1722,1722
37764,19,40,37764,0,0,37764,340991000,22.9125,764.156,37764,32,28,37675,37520,37487,37416,32305
38555,2,4,0,38555,38555,0,1.09988e+16,1.99974,268.047,38555,3,3,38550,38549,38550,38550,34057
14576,1,21,0,14576,2313,12263,5132.15,16.6944,350.816,14576,20,20,2665,2665,2665,2665,2665
39680,2,40,39680,0,39680,0,84780200000,36.0444,794.675,39680,38,37,23175,23128,16781,18589,5926
15484,37,40,0,15484,0,15484,1302020,31.9095,498.329,15484,28,36,15444,15419,15420,15421,15443
2871,15,44,0,2871,0,2871,1293190,17.4671,271.206,2871,20,37,2773,2568,2694,2688,2393
46931,38,44,46931,0,0,46931,5.19892e+15,37.4498,994.952,46931,38,41,46881,46812,46584,42670,46494
43373,5,40,0,43373,43373,0,2.20952e+13,28.9886,812.363,43373,39,37,35111,26459,26902,30684,13039
39776,11,44,39776,0,0,39776,5.2547e+15,36.3768,915.887,39776,37,41,37491,34816,35109,6189,16879
28626,4,40,0,28626,0,28626,973951,32.8593,876.457,28626,38,34,15335,12230,12406,12346,4121
18394,22,24,18394,0,0,18394,342199000,20.1144,502.585,18394,23,21,18368,18354,18366,18365,18309
11667,9,19,0,11667,3673,7994,3836.64,16.9709,395.927,11667,19,18,11184,11184,10872,10956,8645
34549,4,40,0,34549,34549,0,2.21525e+13,35.5714,833.422,34549,35,38,24110,18189,17247,21162,6399
14995,1,2,14995,0,14995,0,3.48207e+13,1.99913,161.338,14995,2,2,13139,13139,13139,13139,13139
27196,16,23,0,27196,5369,21827,4768.48,18.6987,589.93,27196,20,22,27143,27140,27012,27014,25750
11021,15,38,11021,0,11021,0,87107400000,19.7984,437.733,11021,30,22,10860,10615,10374,10299,9102
16369,4,36,0,16369,16369,0,1.68794e+13,31.4251,642.762,16369,35,33,9995,8181,8344,7483,2739
49177,2,40,49177,0,49177,0,1.45201e+18,28.2975,875.315,49177,40,37,27676,27654,19056,5700,7400
39205,6,21,7363,31842,0,39205,18.6862,16.9789,673.764,39205,21,20,37226,37226,36547,36646,10252
49154,4,60,49154,0,49154,0,85296400000,25.5084,983.862,49154,36,40,35925,27739,27076,30787,11479
42629,1,48,42625,4,0,42629,8.62082e+14,35.6476,1093.66,42629,40,41,2765,2765,2765,2765,2765
33189,10,40,33189,0,0,33189,336179000,30.599,829.161,33189,38,35,31186,29599,25388,25056,12906
31083,25,40,31083,0,0,31083,5.61497e+15,35.8036,688.669,31083,36,37,30985,30877,30912,12235,26936
10812,12,36,10812,0,0,10812,338108000,18.6881,377.208,10812,28,25,10625,10241,9665,9662,6932
36693,131,246,584,36109,36605,88,1.50525e+16,6.7152,907.847,36693,61,48,36447,36434,36339,36332,35621
29929,49,56,29929,0,0,29929,5.68965e+15,22.5587,701.405,29929,30,32,29873,29861,29873,29873,29873
4599,1,2,0,4599,4599,0,8.36677e+15,1.99587,89.3547,4599,2,2,4064,4064,4064,4064,4064
36767,17,28,0,36767,6068,30699,5092.26,16.8223,664.503,36767,21,28,36715,36715,36655,36657,23060
32427,5,20,5483,26944,0,32427,20.3184,12.1822,541.853,32427,20,19,30193,30193,26919,26608,24766
47297,48,56,0,47297,0,47297,1.17002e+15,36.6626,1143.58,47297,49,37,47241,47224,47237,46319,44780
39172,25,44,0,39172,0,39172,1280710,31.3221,822.018,39172,37,37,39008,38737,38761,38762,28585
14121,20,24,0,14121,0,14121,1332550,21.0342,437.366,14121,21,22,14091,14067,14053,14052,13224
19905,18,44,19905,0,19905,0,76608200000,32.2276,702.631,19905,37,41,19439,18608,18908,18114,11012
26222,4,40,26222,0,26222,0,1.46701e+18,22.8282,649.506,26222,29,29,18642,14094,13595,2813,6106
45205,11,28,0,45205,7541,37664,5179.94,18.1943,657.963,45205,28,20,45118,45118,45092,45096,33677
40545,26,54,0,40545,0,40545,4.54956e+14,41.3469,1121.37,40545,46,45,40299,39651,39733,20301,14759
49732,1,2,0,49732,49732,0,8.45589e+15,1.99984,294.182,49732,2,2,43895,43895,43895,43895,43895
40531,25,40,40531,0,40531,0,1.46645e+18,28.6037,819.069,40531,32,31,40476,40433,40449,25413,40470
23699,11,21,7073,16626,0,23699,15.5856,17.3206,576.934,23699,21,19,23310,23310,23052,23116,19436
33620,6,40,33620,0,0,33620,5.6287e+15,34.5462,839.768,33620,38,36,27709,24314,19452,8700,9518
28280,4,21,0,28280,5674,22606,4623.32,18.2452,579.048,28280,21,20,24774,24774,23178,23192,22453
2632,1,2,2632,0,2632,0,3.25108e+13,1.99772,67.5396,2632,2,2,2327,2327,2327,2327,2327
47764,1,2,0,47764,47764,0,1.33482e+16,1.99931,297.207,47764,2,2,38915,38915,38915,38915,38915
11745,1,4,0,11745,11745,0,8.41746e+15,1.9994,148.222,11745,3,3,10370,10370,10370,10370,10370
16288,8,21,0,16288,5079,11209,3930.91,17.9762,481.447,16288,21,19,14992,14732,14532,14631,9051
6874,2,11,0,6874,1070,5804,5176.01,9.73203,216.95,6874,11,11,4738,4738,4732,3604,3604
7866,13,36,7866,0,7866,0,68477100000,31.3684,432.096,7866,33,33,6968,5511,6480,5912,3385
33417,1,2,33417,0,33417,0,4.10374e+13,1.99916,242.627,33417,2,2,28544,28544,28544,28544,28544
7024,1,2,7024,0,7024,0,3.26998e+13,1.99715,111.22,7024,2,2,6207,6207,6207,6207,6207
2302,20,24,0,2302,2302,0,2.22252e+13,14.7893,186.227,2302,18,21,2278,2268,2276,2274,2213
42909,22,40,42909,0,42909,0,87060100000,37.3553,854.038,42909,33,31,42830,42761,42761,42770,39051
47798,5,44,47798,0,0,47798,5.47196e+15,36.6971,915.158,47798,38,37,39053,30055,31625,6409,9145
2332,1,2,0,2332,2332,0,8.21926e+15,1.99099,63.3809,2332,2,2,2065,2065,2065,2065,2065
39326,5,44,0,39326,0,39326,1212120,36.8737,907.907,39326,41,37,31295,24396,25976,26114,7857
21815,27,40,0,21815,21815,0,2.22896e+13,32.5164,616.017,21815,31,29,21763,21725,21744,21748,20900
1033,1,16,0,1033,1033,0,2.1986e+13,11.6225,98.8277,1033,11,13,137,137,137,137,137
36020,1,2,0,36020,36020,0,1.49356e+16,1.99864,260.123,36020,2,2,28553,28553,28553,28553,28553
613,6,22,613,0,0,613,338281000,12.5938,100.989,613,15,14,507,449,349,346,208
8488,14,22,0,8488,8488,0,2.22949e+13,20.317,365.843,8488,22,22,8328,8150,7446,7827,5933
7749,7,19,0,7749,1195,6554,5120.13,10.1953,243.375,7749,19,18,7654,7654,7547,7552,7579
42369,29,44,42369,0,0,42369,5.39988e+15,36.3335,874.406,42369,38,37,42244,41963,41973,18526,34719
4323,18,32,0,4323,0,4323,925357,25.1469,320.663,4323,28,29,4119,3600,3592,3588,3021
12309,15,36,0,12309,0,12309,1322280,18.1926,401.252,12309,28,25,12238,12131,12132,12130,10286
32834,13,44,32834,0,0,32834,312839000,34.8035,846.934,32834,37,41,31363,28725,30203,30186,16023
13549,3,22,13549,0,0,13549,5.74758e+15,20.0399,447.817,13549,22,22,8584,7219,6387,1862,2885
49997,12,23,0,49997,9444,40553,4760.04,19.9426,768.747,49997,21,22,49629,49608,49330,49409,46884
23583,35,40,23583,0,23583,0,86056700000,28.9624,569.868,23583,30,29,23539,23486,23531,23527,22932
36754,2,28,6172,30582,0,36754,20.2696,12.1912,588.485,36754,21,21,24464,24464,24141,16041,14692
35359,8,64,35359,0,0,35359,319410000,24.5606,1019.19,35359,32,44,30191,24505,22941,24252,12441
34341,8,48,0,34341,0,34341,5.37148e+14,35.8362,988.28,34341,41,41,24973,19019,20220,13450,8548
20816,1,2,20816,0,20816,0,3.29127e+13,1.99971,190.844,20816,2,2,18381,18381,18381,18381,18381
29409,1,2,29409,0,29409,0,3.52597e+13,1.99891,225.599,29409,2,2,25724,25724,25724,25724,25724
22541,4,24,22541,0,22541,0,87345200000,20.4801,548.33,22541,22,22,16469,12542,12086,14304,5774
42308,13,44,0,42308,0,42308,1283710,32.7329,858.7,42308,37,38,41397,39497,40211,40210,21205
47716,1,23,9130,38586,0,47716,18.6796,20.9749,766.849,47716,22,22,10279,10279,10279,10279,10279
12387,1,2,0,12387,12387,0,8.60945e+15,1.99766,146.531,12387,2,2,10906,10906,10906,10906,10906
11684,1,2,11684,0,11684,0,3.54132e+13,1.99897,143.793,11684,2,2,10213,10213,10213,10213,10213
13847,23,24,13847,0,13847,0,87367100000,20.8521,433.684,13847,21,22,13822,13798,13812,13812,13462
12948,17,24,0,12948,12948,0,2.24335e+13,20.1719,420.412,12948,21,21,12895,12710,12787,12777,11502
40150,1,2,0,40150,40150,0,1.31696e+16,1.99898,272.904,40150,2,2,32811,32811,32811,32811,32811
7622,1,2,7622,0,7622,0,3.27193e+13,1.99948,115.909,7622,2,2,6735,6735,6735,6735,6735
21536,25,40,21536,0,21536,0,7.5702e+10,34.8783,683.857,21536,37,37,21360,20966,20995,20404,17602
24226,1,2,24226,0,24226,0,3.85509e+13,1.99942,206.021,24226,2,2,20907,20907,20907,20907,20907
42635,36,40,0,42635,0,42635,1329410,22.5409,804.565,42635,32,28,42595,42579,42592,42593,42595
33660,8,48,0,33660,33660,0,2.07721e+13,37.8918,857.787,33660,38,41,30193,26363,26013,26275,10323
5548,1,2,5548,0,5548,0,3.98773e+13,1.9973,98.2506,5548,2,2,4761,4761,4761,4761,4761
12610,17,36,0,12610,12610,0,2.14754e+13,29.0089,428.632,12610,33,33,12482,12313,12408,12216,9538
22558,9,40,22558,0,0,22558,5.23949e+15,33.0932,644.358,22558,35,35,20929,18558,19278,3695,9221
41199,11,23,0,41199,12140,29059,4038.91,19.4463,771.846,41199,22,21,40544,40544,40084,40188,31611
34498,23,28,0,34498,5614,28884,5113.14,16.3534,589.57,34498,21,27,34470,34470,34470,34470,34343
30646,9,56,30646,0,30646,0,1.46084e+18,22.698,715.731,30646,29,32,28599,23809,23535,10434,13273
40028,8,44,40028,0,40028,0,1.40896e+18,36.3206,839.533,40028,38,37,36889,32398,31608,6153,16812
40545,31,60,40545,0,0,40545,327366000,33.5799,900.636,40545,37,44,40445,40233,40266,33928,26723
12147,11,33,0,12147,4706,7441,5.93195e+12,18.0718,424.762,12147,20,24,11971,11971,11527,9086,2681
49959,40,44,49959,0,49959,0,81225700000,34.5809,1000.35,49959,40,41,49915,49896,49717,49717,48495
11185,10,13,0,11185,1816,9369,5197.82,10.3955,293.799,11185,12,12,11165,11165,11153,11152,11157
28441,28,40,28441,0,28441,0,1.35165e+18,31.1705,720.796,28441,38,35,28335,28138,28143,10775,22345
42225,22,40,42225,0,42225,0,87192800000,22.1579,783.166,42225,32,29,42177,42129,42146,42143,38957
33367,6,38,0,33367,33367,0,2.22714e+13,29.2957,764.222,33367,32,31,27615,24227,19757,23685,11367
38869,17,44,0,38869,0,38869,1281170,33.7316,830.775,38869,37,38,38443,37390,38174,38137,26650
14053,26,56,0,14053,0,14053,1312450,23.0649,497.564,14053,28,30,13997,13971,13980,13979,12366
35514,24,40,35514,0,0,35514,340646000,22.5353,715.563,35514,32,29,35472,35453,35464,35463,33503
15065,32,36,15065,0,15065,0,8.4995e+10,23.9211,467.796,15065,35,33,15021,14988,14989,14982,14989
18273,31,40,0,18273,0,18273,1322740,21.7592,510.583,18273,29,29,18233,18215,18231,18228,18231
8952,2,21,1879,7073,0,8952,17.9844,17.2597,336.559,8952,19,20,6002,6002,5995,5302,4943
839,1,2,839,0,839,0,3.22069e+13,1.97378,38.6033,839,2,2,742,742,742,742,742
27069,39,40,27069,0,27069,0,79788100000,31.6282,710.303,27069,37,35,27028,27005,26999,26999,26918
43653,23,40,43653,0,0,43653,5.66525e+15,28.5682,931.72,43653,38,36,43476,43228,43264,39851,35090
15318,1,2,15318,0,15318,0,3.52808e+13,1.99928,163.082,15318,2,2,13397,13397,13397,13397,13397
36272,12,60,36272,0,36272,0,85459800000,23.252,866.084,36272,32,40,35101,32983,30886,31920,19922
32805,31,40,32805,0,32805,0,72042900000,35.637,880.935,32805,38,37,32717,32367,32364,32338,29595
48631,22,40,0,48631,0,48631,1307220,32.5384,862.924,48631,39,37,48463,48250,48324,48316,34637
22846,22,40,22846,0,22846,0,1.23947e+18,36.8654,721.001,22846,36,37,22521,21701,22147,9439,16207
23993,4,21,3912,20081,0,23993,20.2667,11.3707,445.431,23993,20,20,21711,21711,19787,19374,18822
6621,25,32,6621,0,0,6621,236782000,27.7608,398.478,6621,32,29,6556,6424,6441,5692,5879
21913,1,2,21913,0,21913,0,3.64287e+13,1.99936,195.078,21913,2,2,19076,19076,19076,19076,19076
22447,1,2,22447,0,22447,0,3.87221e+13,1.99906,199.536,22447,2,2,19358,19358,19358,19358,19358
2762,6,18,2762,0,0,2762,5.74649e+15,13.2118,175.728,2762,15,16,2408,2189,1686,1149,1304
4207,11,36,4207,0,4207,0,84976500000,14.8146,232.151,4207,22,25,4121,4009,4009,3960,3160
41332,28,44,0,41332,0,41332,1044860,36.1426,1036.34,41332,39,37,41162,40831,40488,40532,34531
35206,6,48,0,35206,35206,0,1.82928e+13,38.0026,977.104,35206,37,41,26673,22929,21714,21163,5158
29565,18,60,0,29565,0,29565,1214980,29.5877,899.327,29565,37,44,29027,28109,28330,28294,18227
25804,1,2,25804,0,25804,0,3.28555e+13,1.99915,211.889,25804,2,2,22791,22791,22791,22791,22791
8448,9,36,0,8448,8448,0,2.18596e+13,16.9933,321.871,8448,25,25,8108,7194,7308,7301,5190
2819,1,2,2819,0,2819,0,3.25508e+13,1.9961,70.6352,2819,2,2,2492,2492,2492,2492,2492
8802,18,44,8802,0,8802,0,1.39557e+18,20.1491,443.021,8802,25,37,8690,8528,8624,7328,7593
48248,16,23,8657,39591,0,48248,18.8531,19.2798,730.736,48248,22,21,48158,48149,47973,47978,47336
42853,1,2,42853,0,42853,0,3.80375e+13,1.99974,277.849,42853,2,2,37061,37061,37061,37061,37061
793,13,20,0,793,793,0,2.21067e+13,11.9887,100.099,793,13,16,768,743,749,747,689
26035,15,24,0,26035,0,26035,1332520,21.9221,625.106,26035,24,22,25790,25340,24502,24490,18720
27571,1,56,27571,0,27571,0,1.45773e+18,21.6144,680.599,27571,37,32,3002,3002,3002,3002,3002
33830,29,56,33830,0,33830,0,1.43785e+18,31.4263,898.66,33830,48,42,33691,33414,33544,20110,29228
13860,32,40,0,13860,0,13860,1297670,24.1984,475.413,13860,32,37,13814,13782,13766,13767,13537
30284,5,28,4961,25323,0,30284,19.9481,16.3546,559.919,30284,20,27,28425,28425,25653,25471,11827
17830,21,56,17830,0,0,17830,5.63259e+15,20.7744,602.984,17830,30,39,17734,17579,17685,15356,16623
18082,6,21,0,18082,2912,15170,5091.74,12.8398,405.871,18082,19,20,17628,17628,17202,17216,17151
26044,15,21,5568,20476,0,26044,17.5759,18.6403,563.811,26044,20,20,25959,25959,25771,25774,25302
14039,2,36,0,14039,14039,0,2.21625e+13,18.1905,430.08,14039,28,25,8050,8044,5607,6531,2266
15274,5,38,0,15274,15274,0,2.19537e+13,37.0036,549.677,15274,34,32,11488,8457,8314,9971,2956
2322,8,19,378,1944,0,2322,19.8553,8.35573,141.092,2322,14,18,2292,2292,2287,2291,2271
19857,15,60,0,19857,0,19857,1262340,27.4667,696.049,19857,33,40,19345,18450,18527,18513,13498
41673,575,1458,41668,5,41673,0,2.9826e+18,258.427,4090.96,41673,262,182,40215,39883,36154,35901,18596
5866,26,36,5866,0,0,5866,333920000,17.6527,276.022,5866,25,25,5830,5814,5827,5823,5828
36964,26,40,36964,0,0,36964,337966000,27.8408,722.913,36964,32,29,36900,36841,36883,36878,31603
36180,1,2,0,36180,36180,0,1.51205e+16,1.99947,260.93,36180,2,2,28587,28587,28587,28587,28587
3555,1,4,0,3555,3555,0,1.33778e+16,1.99916,86.0213,3555,3,3,2892,2892,2892,2892,2892
22233,4,60,22233,0,0,22233,322834000,28.6332,716.474,22233,34,40,16324,12835,12721,11676,5508
39659,32,64,0,39659,0,39659,1122290,35.8319,1209.07,39659,37,53,39537,39323,38986,38981,20382
9436,17,24,9436,0,0,9436,5.76027e+15,17.413,356.912,9436,19,21,9396,9256,9323,8087,8840
5763,11,20,0,5763,5763,0,2.23207e+13,16.4296,257.77,5763,19,18,5640,5456,5129,5060,4009
35461,16,21,0,35461,5738,29723,5131.81,16.0621,563.996,35461,21,21,35417,35416,35399,35399,35313
35734,6,38,35734,0,0,35734,5.64979e+15,33.2901,836.581,35734,38,34,29286,25556,20674,9805,12363
12512,20,24,12512,0,12512,0,87034900000,18.9168,403.071,12512,21,21,12486,12474,12462,12458,12485
26701,8,44,0,26701,0,26701,1252430,37.6063,723.043,26701,36,37,24294,21316,20941,21433,10382
27974,34,40,27974,0,0,27974,335153000,30.9676,771.517,27974,38,35,27910,27774,27823,27822,27760
29589,36,56,29589,0,0,29589,5.66808e+15,23.1039,741.864,29589,32,39,29533,29521,29492,29132,28702
40632,26,28,0,40632,6828,33804,5184.57,19.5289,622.769,40632,28,21,40602,40602,40602,40602,40602
14643,14,56,14643,0,0,14643,338092000,20.0501,523.351,14643,30,32,14391,14124,12975,13607,10686
47209,4,44,47209,0,47209,0,81475300000,32.3858,976.282,47209,40,41,34841,27527,27197,29017,11353
42380,17,23,0,42380,7034,35346,4979.5,16.9501,647.923,42380,20,21,42333,42333,42251,42254,42091
6136,10,19,0,6136,1114,5022,5155.21,11.0761,255.578,6136,19,16,6092,6092,6074,6073,6054
29254,1,2,29254,0,29254,0,6.00879e+13,1.99928,235.31,29254,2,2,23008,23008,23008,23008,23008
2385,15,20,0,2385,0,2385,1314570,13.7577,165.269,2385,15,17,2363,2345,2344,2344,2266
2683,16,19,0,2683,496,2187,5074.2,10.8818,174.716,2683,19,16,2661,2661,2661,2661,2661
36484,20,21,5851,30633,0,36484,19.8329,18.7758,576.599,36484,21,21,36460,36458,36448,36449,36460
41795,1,64,41795,0,0,41795,4.81369e+15,35.9671,1123.82,41795,38,44,3826,3826,3826,3826,3826
33229,24,40,33229,0,0,33229,5.70967e+15,22.9772,704.124,33229,32,22,33189,33173,33182,5274,28017
28498,23,44,0,28498,28498,0,2.12201e+13,36.6671,727.341,28498,37,37,28306,27939,28060,27526,18602
30926,1,2,30926,0,30926,0,4.06385e+13,1.99958,233.433,30926,2,2,26460,26460,26460,26460,26460
28012,22,23,5689,22323,0,28012,18.2844,17.2488,601.696,28012,21,22,27989,27989,27880,27880,27948
10960,13,40,0,10960,10960,0,2.16078e+13,24.8201,429.602,10960,32,37,10733,10290,10492,10337,6671
8599,19,20,8599,0,0,8599,5.6913e+15,17.5753,315.885,8599,19,19,8577,8553,8569,8029,8551
47194,12,32,11274,35920,0,47194,17.245,19.357,915.716,47194,23,30,46698,46663,46247,46321,20933
20007,33,40,20007,0,0,20007,5.69118e+15,21.5048,533.211,20007,29,29,19967,19951,19967,16512,19967
30156,54,56,0,30156,30156,0,2.22495e+13,21.4347,704.746,30156,32,32,30100,30089,30100,30100,30100
33608,1,2,33608,0,33608,0,6.39366e+13,1.9994,254.659,33608,2,2,25973,25973,25973,25973,25973
8090,1,2,0,8090,8090,0,8.56853e+15,1.99926,117.864,8090,2,2,7127,7127,7127,7127,7127
15052,11,40,15052,0,15052,0,76202300000,34.2772,587.477,15052,36,37,13713,12189,12910,12307,6669
9574,13,40,0,9574,0,9574,1141620,28.4779,473.701,9574,32,37,8843,7625,8433,8411,4716
20849,14,21,0,20849,3373,17476,5083.75,18.4526,442.991,20849,20,21,20793,20792,20769,20769,20663
47281,44,56,0,47281,0,47281,1327250,22.6639,860.613,47281,32,32,47225,47212,47225,47225,47223
13077,1,2,13077,0,13077,0,3.26741e+13,1.99916,151.782,13077,2,2,11558,11558,11558,11558,11558
38677,14,21,7315,31362,0,38677,18.6187,17.1386,668.358,38677,21,20,38533,38522,38354,38365,36909
45733,5,30,7811,37922,0,45733,19.6485,16.9642,726.261,45733,21,27,42654,42654,39006,38817,36929
6545,28,40,0,6545,6545,0,2.1923e+13,17.9731,316.248,6545,25,29,6505,6491,6500,6491,6503
19826,1,2,0,19826,19826,0,8.37025e+15,1.99955,186.105,19826,2,2,17522,17522,17522,17522,17522
27558,9,13,4603,22955,0,27558,20.3473,11.9492,475.738,27558,13,13,27449,27449,27224,27223,27343
5018,31,32,0,5018,5018,0,2.07501e+13,22.2409,269.709,5018,31,28,4984,4934,4978,4978,4851
25051,1,2,25051,0,25051,0,3.23262e+13,1.99924,210.608,25051,2,2,22173,22173,22173,22173,22173
35048,27,44,35048,0,35048,0,1.11238e+18,36.9936,979.759,35048,39,37,34871,34182,34299,24760,28735
9856,33,40,9856,0,9856,0,63099800000,28.9018,509.997,9856,32,33,9816,9799,9792,9802,9727
35812,41,44,35812,0,0,35812,327635000,33.2295,803.473,35812,36,37,35768,35753,35678,35664,33191
47013,42,60,47013,0,47013,0,79839800000,40.4593,1020.37,47013,41,44,46951,46920,46680,46674,28205
1711,2,9,269,1442,0,1711,20.3133,7.84746,103.98,1711,9,8,1173,1173,1173,897,428
34822,53,67,34822,0,0,34822,8.52935e+15,35.6779,991.68,34822,52,37,34755,34736,34747,34497,33487
31762,10,23,0,31762,6270,25492,4749.5,19.0995,633.478,31762,20,22,31358,31337,31086,31164,28044
45816,3,5,45816,0,45816,0,6.24496e+13,1.99972,300.634,45816,3,4,45811,45809,45810,45811,45811
12019,25,40,0,12019,12019,0,2.21736e+13,18.6961,414.942,12019,28,29,11979,11963,11972,11965,11977
29750,32,40,29750,0,0,29750,340139000,22.3625,653.836,29750,30,29,29710,29694,29709,29705,29708
8677,18,20,8677,0,8677,0,1.46673e+18,17.6505,324.355,8677,20,19,8653,8631,8637,7892,8096
12283,31,40,12283,0,0,12283,339527000,20.6476,462.535,12283,30,24,12243,12231,12240,12241,12173
42562,40,64,0,42562,0,42562,1153060,33.0639,1151.98,42562,37,44,42498,42485,42130,42145,26410
39836,35,40,39836,0,39836,0,76757800000,35.2112,933.744,39836,40,37,39779,39617,39529,39512,37791
13499,21,24,0,13499,0,13499,1325440,18.7063,414.364,13499,21,21,13474,13461,13452,13452,13474
10448,4,36,0,10448,0,10448,1283620,24.8022,391.609,10448,32,33,7971,6269,6162,6599,2492
14962,1,2,0,14962,14962,0,8.33657e+15,1.99866,161.411,14962,2,2,13230,13230,13230,13230,13230
40941,1,21,0,40941,6606,34335,5167.35,14.7149,587.12,40941,21,20,7230,7230,7230,7230,7230
43751,1,2,0,43751,43751,0,1.14417e+16,1.99982,281.139,43751,2,2,36803,36803,36803,36803,36803
35028,15,27,0,35028,11156,23872,2.05708e+12,19.2184,740.1,35028,24,22,34931,34927,34686,32669,31906
15512,8,24,15512,0,0,15512,5.71348e+15,21.5694,494.894,15512,23,22,13943,11506,10212,2996,6784
34572,12,40,34572,0,34572,0,1.46556e+18,29.5587,759.115,34572,31,31,33488,31290,28603,11883,19011
46131,19,56,46131,0,0,46131,336276000,31.4493,980.902,46131,38,44,45781,45252,45157,45117,33623
32018,2,13,0,32018,5297,26721,5199.54,11.5125,511.477,32018,13,13,21447,21447,21289,13875,5463
30637,1,44,30637,0,0,30637,4.3989e+15,36.7461,906.845,30637,38,37,2231,2231,2231,2231,2231
25848,1,2,25848,0,25848,0,3.33876e+13,1.99938,211.53,25848,2,2,22781,22781,22781,22781,22781
17577,1130,1276,17573,4,17577,0,3.29962e+18,196.062,2830.08,17577,223,148,16301,16301,16290,16288,14444
17590,33,40,17590,0,17590,0,63232500000,33.0116,687.958,17590,35,37,17544,17506,17376,17426,15486
40382,9,40,0,40382,0,40382,1317820,27.4028,769.561,40382,35,29,38237,32830,33294,33564,15295
4989,18,22,4989,0,4989,0,86818800000,20.0094,281.121,4989,21,22,4947,4907,4895,4892,4718
542,1,8,82,460,0,542,20.0959,5.63838,55.1683,542,7,7,100,100,100,100,100
47924,9,40,0,47924,0,47924,1331800,30.7273,877.213,47924,33,31,44612,36846,36537,37097,21461
37733,16,40,37733,0,37733,0,1.46314e+18,22.0583,737.306,37733,32,29,37542,37060,36519,9514,25734
49013,10,56,49013,0,49013,0,1.44887e+18,35.6122,915.539,49013,42,40,47094,45374,40522,6406,23087
27937,1,2,27937,0,27937,0,3.28859e+13,1.99986,220.253,27937,2,2,24672,24672,24672,24672,24672
38016,6,40,0,38016,38016,0,1.97519e+13,35.0506,896.124,38016,39,37,31950,28812,26044,26733,10677
49483,4,20,8834,40649,0,49483,20.2387,17.007,711.234,49483,20,19,43243,43243,39044,30317,27856
30645,17,23,0,30645,6050,24595,4753.27,19.0838,623.387,30645,20,22,30600,30600,30459,30461,29364
48922,2,4,0,48922,48922,0,8.33371e+15,2.95685,300.153,48922,4,4,48914,48912,48914,48914,46060
9061,4,40,9061,0,0,9061,259148000,30.8542,505.844,9061,32,37,4873,3852,3900,3829,1161
49201,1,4,0,49201,49201,0,1.32615e+16,2.06772,318.595,49201,4,4,40123,40123,40123,40123,40123
2144,3,32,2144,0,2144,0,1.03341e+18,29.8904,230.235,2144,28,29,1028,876,877,457,251
28413,6,30,5861,22552,0,28413,18.439,16.0166,661.918,28413,20,26,26479,26479,25736,25811,15564
3297,31,36,3297,0,3297,0,85357400000,14.7749,225.192,3297,16,28,3261,3260,3255,3261,3242
779,35,36,0,779,0,779,1335620,12.0732,125.552,779,13,26,743,743,742,742,742
40672,1,2,40672,0,40672,0,5.48873e+13,1.99951,275.207,40672,2,2,32740,32740,32740,32740,32740
35516,57,65,0,35516,35515,1,6.22231e+14,31.403,1138.82,35516,37,48,35451,35442,35446,35451,30869
47660,12,44,47660,0,47660,0,1.37092e+18,32.4141,992.635,47660,40,41,45605,42587,42370,7969,21684
34441,7,40,0,34441,34441,0,2.23272e+13,22.5793,712.023,34441,32,29,30606,26619,23309,26160,14145
25427,15,25,5782,19645,0,25427,18.1163,18.7111,620.893,25427,20,23,25362,25362,25236,25243,22278
43163,1,2,43163,0,43163,0,3.94729e+13,1.99972,275.061,43163,2,2,37109,37109,37109,37109,37109
10466,10,36,10466,0,0,10466,327747000,26.2951,394.845,10466,33,33,10131,9832,9219,9221,4775
28740,3,4,0,28740,28740,0,9.61269e+15,2,229.921,28740,3,3,28736,28734,28735,28735,28736
19878,1,40,19878,0,19878,0,87219100000,34.2451,610.218,19878,31,36,2002,2002,2002,2002,2002
5166,1,2,5166,0,5166,0,5.26335e+13,1.99613,96.9242,5166,2,2,4199,4199,4199,4199,4199
16047,15,40,16047,0,0,16047,5.00161e+15,29.0801,590.826,16047,36,37,15314,13518,14779,3548,9723
11439,6,40,11439,0,11439,0,62788600000,30.9933,545.362,11439,33,33,7144,5504,5634,5001,2213
29015,33,40,0,29015,29015,0,2.23058e+13,22.7509,678.482,29015,32,24,28975,28959,28971,28970,28975
37691,16,56,37691,0,37691,0,87014300000,22.6731,784.67,37691,32,32,37426,36806,35924,35705,25750
18337,36,40,0,18337,18337,0,2.18156e+13,33.4829,537.789,18337,32,37,18295,18270,18257,18247,18294
13236,4,36,0,13236,0,13236,1315410,17.7739,408.857,13236,28,25,9995,7731,7504,7744,4465
8722,21,40,8722,0,8722,0,1.41214e+18,27.2429,395.957,8722,31,37,8635,8554,8581,4520,6839
26283,7,44,0,26283,0,26283,1261110,33.6879,694.496,26283,37,37,23585,20987,19734,20344,6945
44305,1,2,44305,0,44305,0,5.0736e+13,1.99946,286.675,44305,2,2,36318,36318,36318,36318,36318
34879,32,40,34879,0,0,34879,332581000,36.556,741.458,34879,38,37,34811,34711,34727,28672,31331
20842,45,64,0,20842,0,20842,1127890,27.9762,860.519,20842,33,44,20778,20770,20730,20601,14855
26770,8,24,26770,0,26770,0,1.46607e+18,21.3762,604.435,26770,23,22,24537,20802,19138,5893,13835
40527,39,40,40527,0,40527,0,1.46536e+18,31.6051,815.406,40527,32,32,40486,40447,40484,38489,39903
20963,1,2,0,20963,20963,0,9.2534e+15,1.99895,190.724,20963,2,2,18270,18270,18270,18270,18270
33574,33,56,0,33574,0,33574,1324890,23.515,794.989,33574,32,36,33515,33450,33496,33495,24914
30846,26,64,30846,0,0,30846,337265000,22.9915,851.67,30846,32,44,30782,30772,30768,30623,29501
3442,11,36,3442,0,3442,0,8.4966e+10,14.3021,214.368,3442,22,25,3362,3260,3267,3220,2725
43691,2,56,43691,0,0,43691,5.69645e+15,21.6069,827.774,43691,32,32,24332,24324,16469,4925,7225
32210,19,21,0,32210,5195,27015,5127.44,15.8427,534.592,32210,20,21,32185,32185,32165,32165,32119
32537,1,2,32537,0,32537,0,3.28562e+13,1.99978,238.173,32537,2,2,28738,28738,28738,28738,28738
20027,21,24,0,20027,0,20027,1331660,20.8732,514.239,20027,22,22,19998,19971,19974,19974,19994
32674,31,60,32674,0,0,32674,5.14667e+15,36.5342,1012.77,32674,38,53,32538,32168,32131,17097,16450
4132,11,19,0,4132,1262,2870,3854.87,15.175,233.022,4132,18,17,4049,4049,4015,4027,3406
17465,1,2,17465,0,17465,0,3.25554e+13,1.9996,174.257,17465,2,2,15444,15444,15444,15444,15444
33533,36,40,0,33533,0,33533,1213890,32.2793,832.628,33533,40,37,33485,33456,33293,33293,30175
32680,9,44,0,32680,32680,0,2.08466e+13,36.7662,793.745,32680,37,37,30383,26609,27585,26584,8698
15402,32,40,0,15402,15402,0,2.17784e+13,23.8946,494.766,15402,34,37,15354,15321,15306,15304,15280
19035,2,40,19035,0,19035,0,86513100000,18.8327,505.277,19035,26,29,10935,10928,7625,8894,3610
37461,3,60,0,37461,37461,0,2.05342e+13,31.2095,951.706,37461,40,44,24766,21289,19683,18902,4849
27307,1,2,27307,0,27307,0,4.72922e+13,1.99905,221.773,27307,2,2,22718,22718,22718,22718,22718
19343,21,38,0,19343,0,19343,1302780,34.806,622.015,19343,36,33,19187,18860,19045,19050,17416
2401,7,20,2401,0,2401,0,86750800000,14.3186,164.213,2401,15,17,2187,1953,1780,1898,1454
39741,14,30,0,39741,6841,32900,5051.28,13.99,681.874,39741,20,26,39652,39648,39563,39567,38835
21351,26,40,21351,0,21351,0,1.44835e+18,27.8716,541.034,21351,29,29,21299,21261,21286,9025,21290
33796,2,59,0,33796,33795,1,6.56394e+14,21.8182,758.92,33796,32,38,18546,18544,12345,15275,4257
12008,1,4,0,12008,12008,0,8.37111e+15,3.79972,165.953,12008,4,4,10582,10582,10582,10582,10582
47131,15,21,7679,39452,0,47131,20.1206,15.3534,649.987,47131,21,21,47080,47080,47062,47062,46964
22094,1,2,22094,0,22094,0,3.28689e+13,1.99955,195.988,22094,2,2,19513,19513,19513,19513,19513
24321,3,38,24321,0,24321,0,1.44352e+18,34.8312,722.193,24321,38,38,14872,12488,10110,2567,3112
26224,18,20,0,26224,4519,21705,5207.98,12.0078,492.791,26224,20,18,26202,26202,26202,26202,26202
42457,19,60,0,42457,42457,0,2.19527e+13,36.7733,924,42457,40,40,42241,41857,42049,41783,34717
12198,4,40,0,12198,0,12198,1321870,18.6297,417.625,12198,27,29,9036,6945,6727,6435,3475
21033,12,30,4295,16738,0,21033,19.2988,13.0829,572.656,21033,20,23,20951,20945,20897,20907,19190
16175,32,40,16175,0,0,16175,5.66932e+15,22.288,483.601,16175,29,29,16135,16119,16134,13207,16133
2240,682,2240,2240,0,2240,0,8.21366e+15,0,2240,2240,1120,3,0,0,0,0,0
1082,2,9,153,929,0,1082,19.7301,7.81701,80.5377,1082,8,9,781,781,781,682,421
45526,24,40,0,45526,0,45526,1316830,36.8649,956.473,45526,36,38,45337,45048,45134,45143,31398
7630,5,28,0,7630,1338,6292,4953.58,11.9211,323.132,7630,19,23,7035,7035,6486,6183,3409
31503,2,48,0,31503,31503,0,1.93697e+13,32.0772,924.416,31503,36,41,16567,16392,13058,13296,3672
28557,19,23,0,28557,8624,19933,4029.59,19.5997,651.36,28557,22,21,28528,28528,28322,28325,28522
24161,2,40,24161,0,24161,0,1.30502e+18,34.0997,696.267,24161,37,35,14151,14053,11289,3292,3125
31015,33,40,31015,0,0,31015,337453000,27.8755,795.561,31015,38,36,30948,30779,30848,30851,25639
23910,8,24,23910,0,23910,0,87503800000,21.1539,569.263,23910,23,22,21885,18509,17011,18656,9885
9447,19,30,0,9447,2329,7118,4536.62,14.8896,425.803,9447,19,24,9417,9417,9361,9361,7437
6747,1,2,6747,0,6747,0,3.25405e+13,1.99704,108.186,6747,2,2,5966,5966,5966,5966,5966
16276,1,2,16276,0,16276,0,3.5072e+13,1.99908,168.094,16276,2,2,14247,14247,14247,14247,14247
19071,3,4,0,19071,19071,0,9.60088e+15,3.13287,204.293,19071,4,4,19046,19009,19038,19038,18680
12292,1,2,0,12292,12292,0,1.25157e+16,1.99878,150.572,12292,2,2,10156,10156,10156,10156,10156
38472,3,4,0,38472,38472,0,1.32682e+16,2.00018,273.235,38472,3,3,38468,38466,38467,38467,38468
13777,16,24,0,13777,13777,0,2.24684e+13,20.4852,443.909,13777,21,21,13680,13417,13135,13320,11064
737,15,20,0,737,737,0,2.26825e+13,12.5495,99.2364,737,13,17,717,713,714,716,716
47578,33,40,0,47578,0,47578,1319730,28.0844,849.301,47578,39,37,47521,47459,47473,47472,45847
29744,7,24,29744,0,0,29744,341395000,21.618,657.207,29744,24,22,26230,22634,19565,20284,12170
17303,4,40,0,17303,17303,0,2.18207e+13,23.4628,519.381,17303,33,37,13007,10122,9908,11097,4594
12112,1,2,12112,0,12112,0,3.26745e+13,1.99851,145.785,12112,2,2,10705,10705,10705,10705,10705
1011,1,2,0,1011,1011,0,1.511e+16,1.97923,42.973,1011,2,2,798,798,798,798,798
9090,10,12,1623,7467,0,9090,20.3644,10.8659,285.688,9090,12,12,9060,9060,9039,9038,9060
13965,24,40,13965,0,13965,0,1.05088e+18,33.2092,605.685,13965,33,33,13837,13615,13086,8458,11216
41264,35,40,41264,0,0,41264,300196000,34.9466,945.311,41264,40,37,41207,41036,40957,36442,37882
44300,3,21,7229,37071,0,44300,20.114,15.5266,632.598,44300,21,21,35148,35148,35022,31213,24838
48768,8,40,0,48768,0,48768,1330170,35.469,904.748,48768,33,31,43914,36376,33379,34421,18043
45120,15,60,45120,0,45120,0,1.41545e+18,32.1669,954.321,45120,45,41,44402,43148,43373,15160,28406
38038,161,1981,38038,0,1828,36210,2.4416e+17,63.2183,3577.02,38038,302,159,35675,34363,34703,34238,1751
23812,1,4,0,23812,23812,0,8.21285e+15,3.44814,225.763,23812,4,4,21065,21065,21065,21065,21065
23499,16,40,0,23499,23499,0,1.87621e+13,36.3779,737.228,23499,36,37,22373,18742,21347,20108,12515
39148,3,64,39148,0,39148,0,77446300000,31.8068,1106.55,39148,36,44,23483,19991,18497,18459,5669
9131,11,21,2119,7012,0,9131,17.436,17.353,350.721,9131,18,20,9010,9010,8971,8987,7889
31608,19,24,31608,0,0,31608,341099000,21.1386,662.603,31608,24,22,31559,31461,31471,31470,28994
1056,14,22,1056,0,0,1056,340946000,15.518,130.109,1056,16,16,1028,1012,914,917,763
46286,1,2,46286,0,46286,0,3.51616e+13,1.99946,283.242,46286,2,2,40503,40503,40503,40503,40503
49729,1,64,49729,0,49729,0,75510700000,33.6303,1212.71,49729,38,44,4720,4720,4720,4720,4720
48358,41,48,0,48358,48358,0,1.97018e+13,37.1445,1104.32,48358,40,41,48310,48289,48169,48212,47973
5202,25,32,0,5202,0,5202,1251660,19.2043,273.759,5202,31,28,5153,5103,5127,5128,5105
23087,10,21,0,23087,3719,19368,5178.06,11.5933,434.698,23087,20,20,23041,23041,23016,23018,22994
14167,12,24,0,14167,0,14167,1335400,19.4313,435.602,14167,22,21,13866,13185,12252,12580,9695
35322,1,20,6276,29046,0,35322,20.2866,16.8257,594.931,35322,20,19,5509,5509,5509,5509,5509
15118,8,23,0,15118,2762,12356,4870.6,15.2031,421.664,15118,19,21,14782,14758,14656,14705,13979
16076,8,23,2840,13236,0,16076,19.2837,17.8841,426.434,16076,20,21,15786,15765,15652,15690,15096
12323,29,40,12323,0,12323,0,1.28753e+18,32.3739,495.88,12323,33,33,12257,12133,12095,8939,9982
14396,7,44,14396,0,14396,0,71159900000,32.5056,624.24,14396,32,37,10950,8959,9013,8662,4060
4002,29,40,4002,0,4002,0,85062300000,19.3456,276.971,4002,24,24,3962,3946,3956,3951,3772
1188,12,20,0,1188,0,1188,1333010,11.7609,120.451,1188,14,17,1156,1110,1084,1083,972
4308,3,36,4308,0,4308,0,6.1298e+10,27.2447,326.524,4308,28,29,1882,1579,1582,1451,473
38542,6,19,0,38542,7035,31507,5136.76,16.891,666.948,38542,19,19,36650,36650,34184,32619,29778
45837,14,28,7624,38213,0,45837,20.2632,12.7861,649.22,45837,21,21,45796,45796,45796,45796,45792
49015,12,64,49015,0,0,49015,5.46781e+15,35.4829,1138,49015,40,44,46422,41959,40401,11640,25399
882,1,2,0,882,882,0,8.25149e+15,1.98866,38.9503,882,2,2,780,780,780,780,780
35437,295,351,35437,0,35437,0,1.4122e+18,34.0341,1332.17,35437,55,58,35086,35082,35077,35076,35063
29296,1,2,29296,0,29296,0,3.44542e+13,1.99983,225.461,29296,2,2,25709,25709,25709,25709,25709
49215,1,2,0,49215,49215,0,9.00592e+15,1.99937,292.159,49215,2,2,43063,43063,43063,43063,43063
16113,1,2,16113,0,16113,0,3.58809e+13,1.99919,166.737,16113,2,2,14058,14058,14058,14058,14058
25989,7,60,25989,0,0,25989,5.19125e+15,30.6031,860.483,25989,36,44,21756,18518,17245,7324,7803
29285,20,40,0,29285,29285,0,2.231e+13,22.6562,681.039,29285,32,24,29217,29093,29109,29101,25742
23556,18,24,23556,0,0,23556,5.73967e+15,21.8054,579.851,23556,24,22,23502,23436,23212,19244,20747
48190,1,2,48190,0,48190,0,5.16164e+13,1.99963,297.408,48190,2,2,39352,39352,39352,39352,39352
26572,37,44,26572,0,26572,0,1.145e+18,37.0814,847.688,26572,38,37,26524,26486,26284,25010,26445
49485,33,60,49485,0,49485,0,84631500000,31.912,993.398,49485,37,44,49403,49289,49220,49183,38307
40883,5,40,0,40883,0,40883,1314710,28.8644,783.272,40883,38,37,33231,25092,25579,25956,10546
37461,10,23,0,37461,11015,26446,4042.81,19.6256,736.874,37461,22,21,36490,36418,35449,35591,29297
35700,26,40,35700,0,0,35700,5.21538e+15,33.1381,847.574,35700,40,37,35513,35030,35148,13298,26368
11917,18,20,2032,9885,0,11917,20.1947,10.8239,344.568,11917,19,17,11896,11896,11896,11896,11885
44217,12,44,0,44217,44217,0,1.76683e+13,38.6489,1081.1,44217,38,39,38034,29426,34332,32413,14183
34291,4,44,0,34291,34291,0,2.14537e+13,31.9638,765.242,34291,37,37,25821,20272,19927,21800,8503
10059,1,2,0,10059,10059,0,1.44989e+16,1.99891,136.951,10059,2,2,8034,8034,8034,8034,8034
10729,10,36,10729,0,10729,0,74442400000,25.9651,477.76,10729,35,29,9641,8690,8854,8476,3452
21533,15,21,3442,18091,0,21533,19.8599,16.8002,439.274,21533,20,20,21486,21486,21465,21466,21402
31481,33,40,31481,0,0,31481,5.71544e+15,22.7212,717.709,31481,31,29,31441,31423,31436,31441,31441
22233,3,21,3593,18640,0,22233,19.9867,12.3876,445.697,22233,19,20,17778,17778,17728,16297,13315
35757,1,2,35757,0,35757,0,3.2747e+13,1.99961,249.912,35757,2,2,31596,31596,31596,31596,31596
28845,36,40,28845,0,0,28845,5.46029e+15,34.0329,696.556,28845,37,37,28803,28778,28765,27922,28802
2155,7,10,360,1795,0,2155,20.4455,8.92715,126.007,2155,10,9,2119,2119,2041,2040,1388
24835,5,24,24835,0,0,24835,341905000,21.465,584.526,24835,23,22,19693,14623,14617,13860,7644
1873,9,16,1873,0,0,1873,335903000,12.1965,132.489,1873,14,13,1809,1612,1650,1647,1443
1958,8,12,0,1958,360,1598,5123.66,11.022,135.287,1958,12,12,1914,1914,1825,1823,1798
34078,9,30,0,34078,6845,27233,4855.39,15.1694,711.763,34078,20,26,33552,33552,33151,33232,30388
48649,1,2,0,48649,48649,0,1.1011e+16,1.99986,294.629,48649,2,2,41214,41214,41214,41214,41214
27828,13,40,0,27828,27828,0,2.21431e+13,27.6689,622.361,27828,30,29,27476,26374,26306,26522,18258
16247,1,2,16247,0,16247,0,3.25532e+13,1.99945,167.8,16247,2,2,14367,14367,14367,14367,14367
6139,3,20,6139,0,0,6139,5.73881e+15,16.9057,269.766,6139,18,18,4061,3435,3080,771,1534
25818,21,56,25818,0,0,25818,5.65929e+15,22.3451,698.792,25818,32,39,25716,25547,25664,20063,23638
35314,17,20,6054,29260,0,35314,20.3423,12.486,568.319,35314,20,19,35291,35291,35291,35291,35291
30908,21,44,30908,0,0,30908,316151000,35.5101,814.868,30908,37,41,30613,30038,30289,20194,20439
29161,11,24,29161,0,29161,0,1.46549e+18,21.1614,629.927,29161,24,22,28329,27096,24892,17117,17993
30040,26,40,30040,0,30040,0,6.4361e+10,33.77,889.893,30040,39,34,29855,29261,29344,28378,23084
37989,44,64,37989,0,0,37989,280683000,37.6729,1052.81,37989,38,44,37925,37915,37553,32272,20974
36665,36,44,0,36665,36665,0,1.84454e+13,38.4679,966.759,36665,38,39,36611,36554,36222,36291,33254
33419,12,21,0,33419,5357,28062,5123.68,15.6882,542.203,33419,20,21,33340,33339,33294,33317,33211
22395,16,21,4046,18349,0,22395,18.6122,17.6506,488.158,22395,21,19,22341,22336,22246,22247,22050
43961,19,40,43961,0,0,43961,286841000,35.5501,1030.83,43961,39,37,42962,40420,41310,30965,25372
1519,7,16,1519,0,1519,0,86204700000,12.1843,119.853,1519,13,13,1408,1281,1159,1226,1035
36631,23,28,6163,30468,0,36631,20.1471,12.2233,612.252,36631,20,23,36603,36603,36603,36603,36502
6757,4,19,0,6757,1556,5201,4284.52,16.1021,281.496,6757,19,17,5729,5729,5473,5495,5099
37028,12,20,6259,30769,0,37028,20.3181,12.4208,577.724,37028,20,19,36995,36994,36974,36974,36972
4672,9,11,0,4672,721,3951,5166.68,9.19135,178.495,4672,10,11,4656,4656,4646,4646,4647
3060,27,44,3060,0,3060,0,69140600000,26.5448,324.447,3060,28,41,3009,2967,2940,2849,1661
44455,27,44,0,44455,0,44455,1212470,38.7165,980.437,44455,40,40,44254,43609,43823,43824,35055
34867,22,30,6191,28676,0,34867,19.8221,13.8889,651.956,34867,20,25,34837,34837,34802,34802,34190
43343,9,40,43343,0,43343,0,86784800000,35.0603,883.72,43343,34,33,39702,32021,31467,32201,19157
11962,1,2,11962,0,11962,0,3.55315e+13,1.99866,144.432,11962,2,2,10451,10451,10451,10451,10451
39093,1,56,39093,0,0,39093,336046000,29.3234,821.02,39093,38,40,4520,4520,4520,4520,4520
40895,14,60,0,40895,0,40895,1272160,24.578,997.342,40895,36,44,39737,37715,35897,37543,22597
15905,21,40,15905,0,0,15905,332511000,24.1748,502.611,15905,33,37,15814,15727,15757,14877,12665
15333,14,25,4057,11276,0,15333,17.3558,13.0514,508.34,15333,19,23,15281,15277,15190,15194,11297
24556,13,21,0,24556,4444,20112,4756.41,17.2768,510.33,24556,21,19,24411,24411,24295,24306,22536
18804,21,24,18804,0,0,18804,341262000,20.7325,498.268,18804,22,22,18775,18748,18751,18751,18771
28069,37,40,28069,0,28069,0,81296100000,30.5007,712.253,28069,37,35,28026,28004,27955,27951,27141
7274,7,13,0,7274,1225,6049,5206.72,11.336,246.534,7274,12,12,7139,7139,6648,6885,4870
39859,24,25,8912,30947,0,39859,17.9602,19.2661,756.498,39859,21,23,39834,39834,39721,39722,39831
30245,14,40,30245,0,30245,0,1.32031e+18,33.5719,793.744,30245,40,37,28982,26693,28161,6307,13786
31281,13,60,31281,0,31281,0,1.33571e+18,34.6435,1019.51,31281,51,46,29390,26170,27346,4568,11942
24164,1,40,24164,0,0,24164,5.45836e+15,27.3953,655.436,24164,36,35,2889,2889,2889,2889,2889
36125,15,40,0,36125,36125,0,2.22452e+13,35.9754,803.526,36125,33,32,35588,34739,33809,32837,23929
36015,17,23,5948,30067,0,36015,19.5592,16.6659,595.737,36015,20,21,35972,35972,35904,35907,35730
11383,19,23,0,11383,2106,9277,4868.84,11.7091,370.648,11383,18,21,11360,11360,11315,11315,11089
43684,33,40,0,43684,43684,0,2.18316e+13,34.1456,814.26,43684,38,37,43619,43495,43548,43519,39729
11199,8,21,2289,8910,0,11199,17.7637,17.2536,361.046,11199,19,19,10778,10736,10666,10731,9752
20232,23,40,20232,0,0,20232,4.34928e+15,33.8816,715.965,20232,38,34,19954,18990,19272,9134,14731
9950,7,36,9950,0,0,9950,328449000,24.0695,368.408,9950,29,25,9169,8295,7699,8028,4176
48817,26,60,0,48817,0,48817,1308050,34.9082,974.222,48817,40,40,48717,48565,48614,48591,47184
8412,10,24,8412,0,0,8412,5.71529e+15,18.2162,336.52,8412,19,21,8106,7834,6871,3275,4417
7670,1,2,7670,0,7670,0,7.19284e+13,1.9987,122.135,7670,2,2,5709,5709,5709,5709,5709
48103,7,30,0,48103,9066,39037,4879.56,15.9235,808.546,48103,21,26,46361,46361,45002,45563,30290
1399,6,18,1399,0,0,1399,346433000,16.1122,137.11,1399,16,18,1146,1004,845,765,574
26406,27,40,0,26406,26406,0,1.98453e+13,32.8182,740.83,26406,39,35,26271,25820,26026,25836,19297
34427,17,19,0,34427,6319,28108,5127.79,17.4986,634.255,34427,19,19,34382,34382,34346,34346,34342
38335,24,40,38335,0,0,38335,5.63235e+15,32.7106,753.856,38335,37,37,38229,38122,38153,8562,31637
22285,1,2,0,22285,22285,0,8.41992e+15,1.99933,196.828,22285,2,2,19680,19680,19680,19680,19680
37123,19,21,8009,29114,0,37123,17.6314,18.3849,680.05,37123,21,20,37094,37094,36981,36982,37092
45896,11,28,7713,38183,0,45896,20.2929,12.4427,651.968,45896,21,21,45825,45825,45810,45814,45750
49110,230,1446,18492,30618,733,48377,5.68127e+11,37.0969,2858.11,49110,231,144,47664,47267,46039,46266,10660
19379,9,40,19379,0,19379,0,1.46592e+18,36.4624,639.69,19379,37,36,17748,14453,13399,2315,4877
16127,3,13,2631,13496,0,16127,20.3267,10.4856,351.964,16127,12,12,12738,12738,12707,11304,8832
4410,18,19,676,3734,0,4410,19.5728,14.7717,188.417,4410,18,18,4390,4389,4389,4389,4390
28471,17,20,0,28471,4987,23484,5152.8,19.4853,574.026,28471,20,20,28437,28437,28399,28401,21530
9047,18,36,9047,0,9047,0,1.24758e+18,26.944,424.541,9047,34,29,8791,8360,8559,2178,4933
14492,10,24,14492,0,14492,0,1.46669e+18,21.0829,445.768,14492,21,22,13930,13424,11786,4624,8129
7769,1,2,0,7769,7769,0,8.32896e+15,1.99627,116.261,7769,2,2,6870,6870,6870,6870,6870
21770,19,40,21770,0,0,21770,338867000,21.3337,551.918,21770,28,29,21717,21642,21665,21663,20503
9538,20,21,0,9538,3301,6237,3953.1,16.213,381.887,9538,18,20,9517,9517,9502,9503,9484
26368,36,40,0,26368,0,26368,1323580,20.8277,599.483,26368,29,29,26328,26313,26328,26327,26328
28723,14,24,28723,0,28723,0,1.46798e+18,21.4975,637.721,28723,24,22,28431,28081,25302,22637,19313
40367,24,40,0,40367,0,40367,1222710,32.0003,903.228,40367,40,37,40103,39641,39696,39692,30213
43956,18,44,0,43956,0,43956,1091900,35.8091,1045.03,43956,39,39,42606,39770,40494,40466,25080
15833,23,40,15833,0,15833,0,1.42925e+18,23.9414,502.685,15833,32,37,15754,15662,15692,10328,13659
29718,20,23,5914,23804,0,29718,18.3131,17.8247,611.774,29718,21,22,29692,29692,29524,29524,28688
39021,1,4,0,39021,39021,0,8.33572e+15,3.19923,269.077,39021,4,4,34502,34502,34502,34502,34502
39031,4,40,39031,0,39031,0,1.32419e+18,33.4411,896.209,39031,40,37,28691,22989,22940,5481,7151
5395,6,36,0,5395,0,5395,1066070,29.7835,340.895,5395,29,29,4279,3773,3741,3765,1598
15261,22,40,15261,0,15261,0,1.43441e+18,34.2811,492.367,15261,29,34,15189,15137,15142,3037,7563
11803,10,19,2754,9049,0,11803,17.1519,14.9857,386.844,11803,19,18,11561,11546,11377,11421,9615
15018,1,2,15018,0,15018,0,4.45322e+13,1.99893,162.984,15018,2,2,12641,12641,12641,12641,12641
7385,1,13,0,7385,1247,6138,5206.66,11.3762,248.995,7385,12,12,1217,1217,1217,1217,1217
43011,1,2,0,43011,43011,0,8.87087e+15,1.99988,273.116,43011,2,2,37715,37715,37715,37715,37715
6650,18,20,6650,0,6650,0,8.708e+10,17.1785,277.449,6650,18,19,6626,6604,6610,6616,6288
36265,18,38,36265,0,0,36265,5.68917e+15,30.4531,806.103,36265,33,32,36037,35763,35361,30541,31504
44424,9,20,7669,36755,0,44424,20.3263,15.9079,647.301,44424,20,20,44163,44163,43674,43671,43623
38760,17,44,0,38760,0,38760,1281080,33.928,830.202,38760,37,38,38333,37279,38063,38026,25051
21334,28,38,0,21334,21334,0,2.23992e+13,20.7416,590.666,21334,30,27,21296,21278,21288,21284,21296
33306,1,60,0,33306,33306,0,2.03463e+13,32.4686,865.956,33306,40,42,3820,3820,3820,3820,3820
42696,18,44,0,42696,42696,0,2.07672e+13,29.5187,939.888,42696,40,41,42113,41126,41488,40530,25868
33303,29,44,33303,0,33303,0,7.9451e+10,32.4819,844.456,33303,40,40,33188,32955,32804,32439,23671
21535,1,2,21535,0,21535,0,5.54715e+13,1.99967,201.809,21535,2,2,17290,17290,17290,17290,17290
23739,32,38,0,23739,0,23739,1330400,27.9235,640.705,23739,31,29,23695,23657,23688,23687,23695
18539,15,40,18539,0,0,18539,5.68665e+15,21.8749,515.35,18539,29,29,18413,18193,18203,6542,13456
30363,1,2,30363,0,30363,0,3.51902e+13,1.99974,229.305,30363,2,2,26566,26566,26566,26566,26566
1772,1,10,0,1772,297,1475,5233.26,9.05643,114.023,1772,10,10,295,295,295,295,295
5062,2,12,910,4152,0,5062,20.3848,11.2548,213.393,5062,12,12,3238,3238,3166,1999,1999
31730,18,25,0,31730,8198,23532,4358.28,17.5499,701.821,31730,22,23,31693,31692,31456,31456,27281
3021,12,19,0,3021,785,2236,4146.17,15.808,199.149,3021,17,18,2967,2963,2946,2953,2532
5381,3,11,0,5381,845,4536,5177.85,9.92566,194.311,5381,11,11,4312,4312,4307,3275,2456
36498,14,30,0,36498,6398,30100,5107.66,12.5379,655.415,36498,20,23,36448,36445,36385,36389,35784
46582,17,40,46582,0,46582,0,86437800000,28.9326,851.911,46582,40,37,46347,45702,45974,45766,30861
42512,30,85,41648,864,42475,37,1.22065e+15,28.512,914.917,42512,36,41,42388,42325,41870,41850,30212
44511,30,48,44511,0,0,44511,290053000,34.7937,1079.12,44511,38,41,44385,44029,43666,38175,29066
32507,2,4,0,32507,32507,0,1.14913e+16,1.99972,246.512,32507,3,3,32502,32501,32502,32502,27390
6832,24,30,0,6832,1452,5380,4852.61,11.6456,338.82,6832,19,22,6802,6802,6802,6802,6490
27644,31,48,0,27644,0,27644,6.67276e+14,37.0232,895.93,27644,40,41,27562,27354,27273,25484,23046
3917,5,23,0,3917,923,2994,4332.33,14.4491,244.008,3917,17,21,3416,3416,3317,3314,1472
7193,1,2,7193,0,7193,0,3.25968e+13,1.99791,111.967,7193,2,2,6359,6359,6359,6359,6359
30893,1,28,0,30893,5185,25708,5133.26,13.086,570.863,30893,20,25,5400,5400,5400,5400,5400
7724,6,11,0,7724,1178,6546,5144.39,9.5927,229.429,7724,11,11,7592,7592,7412,7412,7514
17560,26,40,0,17560,17560,0,1.62274e+13,32.1901,687.677,17560,34,37,17456,17196,17241,16905,14868
26584,21,38,26584,0,26584,0,1.46376e+18,27.6769,677.359,26584,31,30,26509,26277,26421,14089,25712
26247,8,23,0,26247,6945,19302,4203.02,18.0677,606.73,26247,21,21,24649,24365,24103,24258,19906
776,1,2,0,776,776,0,1.05858e+16,1.97552,36.2091,776,2,2,661,661,661,661,661
21624,6,40,21624,0,0,21624,302930000,32.4124,653.005,21624,36,34,18468,16780,15222,16320,6215
13102,9,13,0,13102,2255,10847,5231.76,11.2384,330.512,13102,13,12,13039,13039,12924,12923,12985
42201,14,21,6717,35484,0,42201,19.9608,17.5216,605.754,42201,21,21,42119,42118,42091,42095,40694
32871,25,40,32871,0,32871,0,1.46494e+18,29.2001,746.348,32871,32,31,32817,32775,32789,17401,31711
1870,10,12,344,1526,0,1870,20.1711,10.5321,131.36,1870,12,12,1852,1852,1848,1847,1852
16031,4,13,2654,13377,0,16031,20.3603,11.2581,356.516,16031,12,13,14438,14438,13148,12801,8817
16967,3,24,16967,0,16967,0,1.46614e+18,21.225,476.826,16967,21,22,11139,9419,8427,2042,3411
39457,21,40,39457,0,39457,0,87224700000,32.3696,805.944,39457,32,31,39376,39156,39251,39245,33974
42513,40,56,0,42513,0,42513,1320150,36.2143,863.641,42513,40,39,42457,42432,42419,42425,42457
41602,2,4,41602,0,41602,0,5.92422e+13,1.99962,284.446,41602,3,3,41597,41596,41596,41596,34777
4986,8,12,908,4078,0,4986,20.1195,11.0263,216.213,4986,12,12,4900,4900,4694,4693,4713
22622,2,24,0,22622,22622,0,2.23536e+13,21.4595,552.79,22622,23,22,12576,12574,8472,10288,3438
45182,20,25,0,45182,9910,35272,4590.89,19.3398,794.378,45182,21,23,45152,45151,44952,44954,44948
1364,1,18,0,1364,0,1364,1347240,15.7375,132.694,1364,15,17,138,138,138,138,138
22974,2,4,0,22974,22974,0,8.71943e+15,2.00022,206.283,22974,3,3,22969,22968,22969,22969,22673
9602,20,40,0,9602,9602,0,2.03651e+13,27.7586,421.201,9602,33,33,9460,9273,9364,9050,7902
12518,8,20,2156,10362,0,12518,20.192,11.0063,354.934,12518,19,17,12370,12369,11883,11881,12024
36043,15,44,36043,0,0,36043,313066000,31.4322,881.675,36043,40,41,34925,32378,34082,34031,17677
13306,1,2,13306,0,13306,0,3.31271e+13,1.99797,152.056,13306,2,2,11739,11739,11739,11739,11739
32463,25,44,32463,0,0,32463,325223000,33.9301,758.356,32463,37,37,32299,32028,32052,13319,23573
25959,9,24,0,25959,25959,0,2.23945e+13,21.2649,595.578,25959,24,22,24385,20424,20352,20401,12763
41550,1,2,41550,0,41550,0,3.24695e+13,1.99966,270.864,41550,2,2,36756,36756,36756,36756,36756
48922,10,40,0,48922,48922,0,2.21271e+13,30.8973,984.602,48922,38,36,46003,43640,37509,37686,20932
45335,23,44,45335,0,0,45335,309066000,38.472,987.737,45335,39,41,44949,43910,44403,18335,28432
23277,2,21,3722,19555,0,23277,20.1651,14.5206,435.479,23277,20,20,15927,15927,15880,11597,11591
9914,15,24,0,9914,9914,0,2.23642e+13,18.0333,369.451,9914,20,21,9837,9703,9369,9373,8647
32825,36,56,32825,0,0,32825,5.6543e+15,23.6432,770.3,32825,33,40,32769,32755,32719,30755,29463
17602,1,2,17602,0,17602,0,3.51484e+13,1.99909,175.145,17602,2,2,15403,15403,15403,15403,15403
40649,4,30,0,40649,7800,32849,4952.33,14.7771,755.441,40649,20,26,35443,35443,32580,31286,28111
40720,31,40,0,40720,0,40720,1124170,34.7838,974.211,40720,39,37,40623,40218,40241,40244,36926
27010,30,40,0,27010,0,27010,1328350,23.1791,655.621,27010,32,24,26970,26954,26963,26964,26970
35820,11,21,5939,29881,0,35820,20.3102,11.9985,551.591,35820,21,20,35777,35777,35762,35766,35724
47308,11,56,0,47308,0,47308,1317080,36.0708,903.447,47308,40,40,45814,43747,40852,41010,23274
46299,1,4,0,46299,46299,0,8.33894e+15,3.67952,294.178,46299,4,4,40934,40934,40934,40934,40934
7168,9,38,7168,0,0,7168,5.66987e+15,21.0089,363.214,7168,30,22,6540,5257,5033,4330,3239
8586,1,2,0,8586,8586,0,1.11452e+16,1.99918,122.74,8586,2,2,7257,7257,7257,7257,7257
1355,2,40,1355,0,1355,0,82856400000,13.4878,175.351,1355,22,18,766,765,507,642,208
35839,19,44,35839,0,0,35839,313891000,37.2486,853.694,35839,38,37,35339,34402,34968,28171,18328
4674,13,17,0,4674,807,3867,4663.21,12.7739,207.088,4674,17,17,4631,4631,4615,4617,4540
24396,1,2,24396,0,24396,0,3.84669e+13,1.9991,207.498,24396,2,2,21061,21061,21061,21061,21061
41087,11,32,0,41087,8352,32735,4933.18,12.8366,798.534,41087,20,24,40932,40932,40789,40806,36681
36884,1,2,0,36884,36884,0,1.61956e+16,1.99973,265.738,36884,2,2,28593,28593,28593,28593,28593
17808,34,40,0,17808,0,17808,1325100,18.7793,493.741,17808,28,29,17768,17755,17768,17765,17768
46931,12,20,8263,38668,0,46931,20.1572,17.4903,724.519,46931,20,20,46793,46791,46747,46747,46520
22153,7,40,22153,0,22153,0,87191400000,21.6819,608.883,22153,30,29,19170,16265,13993,16160,8989
29319,10,44,29319,0,29319,0,1.13018e+18,36.8037,891.499,29319,38,37,23400,17903,20114,6153,9947
1840,19,44,0,1840,1840,0,1.68106e+13,23.4674,236.806,1840,26,33,1745,1588,1701,1541,623
28563,41,44,28563,0,28563,0,1.39463e+18,36.6634,734.963,28563,37,37,28519,28505,28429,24640,25860
40949,29,48,40945,4,40945,4,2.11184e+12,36.5855,1071.58,40949,44,41,40807,40492,40102,33105,30848
25973,11,60,25973,0,25973,0,83315700000,27.5197,759.306,25973,34,40,24816,23413,22865,22242,13224
29818,18,40,0,29818,29818,0,2.22354e+13,22.0981,644.617,29818,29,29,29748,29654,29596,29540,25382
21258,3,4,0,21258,21258,0,8.34198e+15,3.45606,200.724,21258,4,4,21252,21248,21251,21251,20603
14593,13,36,0,14593,14593,0,2.17473e+13,24.6327,465.032,14593,35,33,14358,13846,13995,13831,7975
22502,16,54,0,22502,0,22502,8.19757e+14,34.2889,859.336,22502,39,45,21146,15663,19274,16324,11495
6544,26,36,6544,0,6544,0,1.28074e+18,26.8697,349.197,6544,32,29,6478,6343,6403,3018,5080
39362,39,44,0,39362,0,39362,1223070,35.5651,912.649,39362,38,41,39316,39265,39100,39102,37901
20314,2,24,0,20314,0,20314,1337190,20.4092,534.542,20314,24,22,11052,11052,7300,3211,2468
23825,11,21,3888,19937,0,23825,19.5294,17.7478,478.373,23825,20,20,23682,23682,23604,23643,22875
43632,2,4,0,43632,43632,0,8.62075e+15,2,281.291,43632,3,3,43627,43626,43627,43627,42819
27874,13,48,27874,0,0,27874,307797000,33.6204,852.57,27874,36,41,26063,22622,24659,24613,13604
25979,1,56,25979,0,0,25979,5.63682e+15,24.5847,703.789,25979,32,40,2840,2840,2840,2840,2840
33268,9,20,0,33268,5611,27657,5194.03,12.7272,551.08,33268,20,19,33096,33096,32734,32732,32777
6541,8,21,0,6541,1789,4752,4246.29,15.649,311.728,6541,18,20,6148,6072,6013,6042,4420
45019,55,56,45019,0,0,45019,5.65186e+15,37.0399,884.664,45019,40,40,44963,44936,44962,44963,44963
44679,29,30,0,44679,7726,36953,5072.35,20.2386,720.728,44679,28,25,44649,44649,44649,44649,44646
8654,31,40,0,8654,0,8654,1318170,17.7689,359.892,8654,24,29,8614,8600,8612,8609,8612
10810,5,40,0,10810,0,10810,1319940,18.108,393.832,10810,26,29,8764,6605,6760,6795,3424
12406,41,44,12406,0,0,12406,4.93214e+15,26.5014,579.44,12406,34,41,12362,12354,12250,11754,11205
6629,12,21,1064,5565,0,6629,19.9837,10.0822,245.172,6629,18,20,6601,6601,6596,6600,6560
25026,34,44,25026,0,25026,0,83303100000,27.0511,673.407,25026,35,37,24976,24909,24852,24860,22730
38482,3,28,0,38482,6468,32014,5144.56,15.9331,630.274,38482,20,27,30185,30185,29950,23668,17390
28870,1,4,0,28870,28870,0,8.40381e+15,1.99983,229.894,28870,3,3,25500,25500,25500,25500,25500
37370,46,48,37370,0,37370,0,77555400000,36.431,980.313,37370,36,41,37322,37303,37190,37263,37320
30780,1,64,30780,0,30780,0,75571900000,28.0975,997.06,30780,36,44,2683,2683,2683,2683,2683
11496,1,13,1963,9533,0,11496,20.4492,10.7207,306.288,11496,12,12,1868,1868,1868,1868,1868
27821,5,44,27821,0,0,27821,313832000,32.8746,780.974,27821,37,41,21925,16926,17815,17931,6569
9226,1,24,9226,0,9226,0,87346200000,18.1268,355.382,9226,20,21,1016,1016,1016,1016,1016
26940,10,40,0,26940,26940,0,2.23243e+13,21.3908,651.952,26940,32,24,25772,24746,21784,21611,15237
49341,24,28,0,49341,8136,41205,5153.5,12.4659,693.483,49341,20,25,49313,49313,49313,49313,49216
29276,3,23,4973,24303,0,29276,19.3118,18.3605,551.6,29276,20,21,23485,23484,23387,22086,14056
23512,1,2,23512,0,23512,0,3.25985e+13,1.99974,203.218,23512,2,2,20788,20788,20788,20788,20788
28218,2,23,5089,23129,0,28218,19.1678,19.2367,574.66,28218,21,22,19239,19239,19195,15427,10941
20513,22,40,20513,0,20513,0,1.46195e+18,22.3542,581.007,20513,25,29,20470,20439,20443,15666,19492
44705,1,2,44705,0,44705,0,5.93865e+13,1.99991,290.071,44705,2,2,35272,35272,35272,35272,35272
1851,13,34,1851,0,1851,0,1.51839e+18,28.6591,207.963,1851,30,27,1664,1457,1479,382,761
49162,2,56,0,49162,0,49162,1315180,37.1215,1014.82,49162,39,45,26022,26016,16647,7338,6947
10574,35,40,10574,0,0,10574,248260000,33.6484,535.531,10574,34,35,10533,10499,10499,10055,10509
21844,17,38,0,21844,0,21844,1308370,29.6201,683.865,21844,38,34,21476,20626,20704,20642,15012
43225,18,44,43225,0,0,43225,5.52242e+15,32.1346,867.637,43225,37,38,42869,42416,42639,10595,27980
25664,1,2,25664,0,25664,0,3.84527e+13,1.99899,211.68,25664,2,2,22157,22157,22157,22157,22157
3603,2,24,0,3603,0,3603,1324760,16.6583,231.627,3603,19,21,1996,1995,1361,636,602
42203,31,40,0,42203,0,42203,1331760,37.4692,835.863,42203,33,31,42145,42095,42128,42130,26344
48681,1,38,0,48681,0,48681,1298470,36.7791,1036.03,48681,38,38,4485,4485,4485,4485,4485
20966,12,24,20966,0,20966,0,8.7312e+10,20.6996,525.753,20966,22,22,20552,19612,17969,19328,14741
24598,1,2,0,24598,24598,0,9.83695e+15,1.9987,207.553,24598,2,2,21239,21239,21239,21239,21239
40042,7,23,0,40042,6691,33351,5005.79,19.1578,638.758,40042,21,21,39180,39180,38525,38601,37822
36043,27,40,36043,0,36043,0,86095300000,29.7915,742.056,36043,38,37,35962,35860,35902,35840,27671
10841,18,24,0,10841,10841,0,2.24324e+13,20.8601,395.055,10841,20,21,10805,10773,10680,10668,10077
45750,3,40,45750,0,45750,0,86491200000,36.8323,955.942,45750,38,38,28564,24011,20453,23985,5316
10970,1,2,10970,0,10970,0,3.68971e+13,1.99954,137.657,10970,2,2,9531,9531,9531,9531,9531
48668,22,44,0,48668,0,48668,1248570,35.8846,951.129,48668,38,37,48280,47524,47832,47859,33028
18589,49,56,18589,0,18589,0,85920600000,20.5887,612.027,18589,30,39,18533,18525,18524,18533,18470
23161,13,21,5980,17181,0,23161,16.3912,17.844,555.733,23161,20,20,22986,22986,22730,22758,21525
13129,11,40,0,13129,0,13129,985082,29.3408,600.855,13129,32,37,9787,5951,7998,7872,5269
41340,6,28,0,41340,6861,34479,5184.55,11.915,617.172,41340,20,21,40182,40182,38830,38833,37895
27918,27,44,0,27918,0,27918,1034320,37.3519,867.952,27918,38,37,27765,27189,27311,27353,22210
2397,8,22,2397,0,2397,0,1.4373e+18,19.5344,194.581,2397,19,21,2099,1685,1512,1339,1021
22629,13,40,22629,0,0,22629,341078000,21.7032,603.726,22629,31,24,22166,20741,19877,20059,15958
45260,20,40,45260,0,45260,0,1.45633e+18,36.9954,955.344,45260,39,38,44944,44330,44502,8294,26981
37130,1,2,0,37130,37130,0,1.16033e+16,1.99978,258.195,37130,2,2,31150,31150,31150,31150,31150
41246,59,60,41246,0,41246,0,1.41611e+18,38.502,990.632,41246,40,44,41186,41169,41186,41029,41039
19470,34,36,19470,0,19470,0,8.4132e+10,26.2174,538.877,19470,36,33,19430,19376,19412,19403,18834
35981,3,4,0,35981,35981,0,8.35108e+15,1.99992,256.397,35981,3,3,35977,35975,35976,35976,35977
3585,24,28,693,2892,0,3585,18.9188,11.4524,239.798,3585,19,21,3557,3557,3557,3557,3482
2770,10,18,2770,0,0,2770,345768000,16.4448,191.118,2770,17,18,2626,2506,2312,2298,2030
46288,3,4,0,46288,46288,0,8.31913e+15,3.17966,306.671,46288,4,4,46260,46218,46251,46251,44182
1594,11,36,1594,0,1594,0,75089200000,29.3833,177.131,1594,26,25,1467,1373,1413,1305,577
31572,6,40,31572,0,31572,0,87352800000,22.1159,710.156,31572,30,29,26646,23684,18978,23021,10889
28540,30,44,0,28540,0,28540,1280520,26.4331,718.48,28540,36,37,28470,28336,28335,28334,23524
2057,1,2,2057,0,2057,0,4.59774e+13,1.98687,60.0678,2057,2,2,1720,1720,1720,1720,1720
22370,20,48,0,22370,22370,0,1.98345e+13,33.751,793.311,22370,33,41,22082,21261,21308,20941,15579
32214,12,40,32214,0,0,32214,5.71744e+15,29.2436,738.777,32214,31,30,31115,28916,26901,19766,19677
39421,13,28,6456,32965,0,39421,20.0359,15.6032,627.105,39421,21,27,39339,39339,39303,39315,39038
522,12,14,0,522,0,522,1343860,11.7989,73.0613,522,12,12,505,488,492,491,502
10877,18,21,1737,9140,0,10877,20.142,9.71656,301.591,10877,17,20,10856,10856,10853,10853,10850
43088,37,65,43087,1,0,43088,8.52899e+14,31.8484,1241.06,43088,38,48,43017,42984,42683,40552,25270
13716,16,40,0,13716,13716,0,2.17513e+13,24.252,473.622,13716,32,37,13575,13362,13463,13296,9409
7231,8,19,2832,4399,0,7231,14.6386,15.4089,307.616,7231,18,17,6435,6219,6094,6108,5407
25311,41,44,0,25311,0,25311,1222580,33.7938,756.484,25311,37,41,25267,25250,25158,25159,24852
47811,2,4,0,47811,47811,0,8.37665e+15,1.99987,294.132,47811,3,3,47806,47805,47806,47806,45466
47950,2,48,0,47950,47950,0,1.94094e+13,35.7651,1107.14,47950,38,41,25939,25685,20607,20660,5835
36111,2,44,36111,0,0,36111,327144000,34.9314,807.236,36111,37,38,20934,20875,15315,8325,5340
29776,21,40,29776,0,29776,0,87160600000,22.6512,686.259,29776,32,24,29719,29590,29678,29682,27212
44521,22,40,0,44521,0,44521,1318330,28.5484,823.261,44521,39,37,44409,44275,44319,44314,34048
12840,8,24,12840,0,0,12840,5.74393e+15,21.3136,432.498,12840,22,21,11602,9636,8595,2250,5520
24934,25,44,24934,0,0,24934,303564000,33.3109,765.057,24934,37,41,24753,24382,24325,15102,14740
9158,14,21,1697,7461,0,9158,18.6635,12.0768,317.232,9158,18,19,9114,9111,9069,9071,8653
13073,8,24,13073,0,0,13073,5.70348e+15,18.6329,409.118,13073,21,21,12103,10427,9697,3755,7111
43592,27,30,0,43592,7700,35892,4983.1,18.5198,794.623,43592,21,29,43562,43562,43562,43562,43361
4850,32,40,4850,0,0,4850,267854000,28.3577,369.558,4850,30,36,4810,4797,4800,4609,4620
44345,1,40,0,44345,0,44345,1294090,34.4614,832.7,44345,38,37,5466,5466,5466,5466,5466
24068,4,44,0,24068,0,24068,1262690,34.0114,670.793,24068,36,37,17970,14170,13988,14177,5160
37765,55,56,0,37765,37765,0,2.22369e+13,38.0296,792.882,37765,40,32,37709,37686,37708,37708,37709
23832,33,44,0,23832,23832,0,1.98423e+13,33.9872,752.849,23832,37,41,23770,23695,23526,23507,18486
39030,1,2,0,39030,39030,0,8.69934e+15,1.99987,259.956,39030,2,2,34317,34317,34317,34317,34317
30600,5,44,0,30600,0,30600,1073120,33.6175,880.318,30600,38,37,21574,16929,18364,18153,6305
29402,12,40,0,29402,29402,0,1.82737e+13,36.3058,846.739,29402,37,37,26172,21819,24248,22821,12213
9288,6,20,0,9288,0,9288,1327200,17.7228,331.218,9288,20,19,8169,7461,5826,6520,3752
18188,30,40,0,18188,0,18188,1329050,20.4184,549.964,18188,30,25,18148,18134,18143,18144,17579
29422,14,21,0,29422,5364,24058,4774.33,16.6066,564.924,29422,21,19,29306,29297,29193,29198,28638
23733,24,60,0,23733,0,23733,1167480,34.9666,780.971,23733,38,41,23497,23124,23082,23085,11338
13068,1,2,13068,0,13068,0,5.2125e+13,1.99847,155.458,13068,2,2,10647,10647,10647,10647,10647
44651,14,20,7949,36702,0,44651,20.2636,16.9498,671.514,44651,20,19,44595,44595,44595,44595,44595
625,1,7,0,625,83,542,4964.35,6.0944,56.4676,625,7,7,133,133,133,133,133
20940,9,40,20940,0,20940,0,1.05237e+18,34.3297,738.314,20940,36,34,14999,10434,12184,4275,5975
27181,1,2,27181,0,27181,0,3.28272e+13,1.99912,216.972,27181,2,2,24010,24010,24010,24010,24010
18613,27,36,0,18613,0,18613,1269070,27.4195,536.529,18613,36,33,18534,18352,18474,18471,14239
20829,9,40,20829,0,20829,0,75447400000,33.7143,675.08,20829,38,34,18470,15959,16855,16026,5545
17373,30,38,0,17373,0,17373,1323440,30.9013,558.77,17373,31,30,17327,17287,17314,17314,17327
41196,37,44,41196,0,0,41196,328427000,33.1489,850.13,41196,37,38,41148,41108,40989,35446,36831
34717,33,44,0,34717,34717,0,1.7001e+13,35.8274,966.63,34717,38,37,34654,34569,34284,34239,32808
7246,1,2,0,7246,7246,0,9.02957e+15,1.99683,111.431,7246,2,2,6337,6337,6337,6337,6337
35735,2,20,0,35735,6137,29598,5212.13,11.9606,569.645,35735,20,19,23459,23459,23088,13349,13349
24209,53,55,24209,0,24209,0,1.06604e+18,36.5462,853.734,24209,39,43,24154,24145,24154,24154,23491
31215,2,21,5167,26048,0,31215,20.2865,12.4078,517.418,31215,21,20,20935,20935,20783,13921,12681
7204,1,22,7204,0,7204,0,1.47344e+18,19.1027,321.569,7204,19,20,730,730,730,730,730
33891,16,30,6010,27881,0,33891,19.9056,12.9283,639.201,33891,20,24,33851,33849,33800,33800,33160
48553,9,40,48553,0,48553,0,1.45817e+18,35.0041,944.404,48553,34,36,44439,35817,33339,9423,20906
20100,2,5,1,20099,20100,0,1.59638e+16,1.99975,204.9,20100,4,3,20094,20093,20094,20092,15711
20525,25,38,0,20525,20525,0,2.20957e+13,29.6742,616.131,20525,32,31,20461,20395,20425,20425,20461
20977,7,44,0,20977,20977,0,2.1161e+13,28.4717,628.479,20977,34,37,18766,16661,15603,16153,6379
31856,18,40,0,31856,0,31856,1331940,28.8817,730.583,31856,31,29,31720,31562,31239,31199,27727
43558,16,28,0,43558,7174,36384,5176.87,11.7581,631.365,43558,20,21,43523,43523,43522,43522,43515
33389,26,40,0,33389,33389,0,2.20212e+13,30.425,718.13,33389,38,37,33303,33205,33239,33126,25734
40651,1,2,0,40651,40651,0,8.62897e+15,1.99926,265.401,40651,2,2,35782,35782,35782,35782,35782
11041,7,44,0,11041,11041,0,2.14011e+13,19.7678,480.623,11041,28,37,9661,8405,7794,8188,4506
41528,14,60,41528,0,0,41528,5.30622e+15,30.3692,1011.62,41528,40,44,40059,37534,37845,15280,18955
29074,14,28,0,29074,4824,24250,5175.3,12.2005,525.952,29074,21,21,29034,29034,29034,29034,28975
38718,6,21,0,38718,6185,32533,5073.74,18.9683,591.806,38718,21,21,37764,37764,36881,36915,36790
36688,25,40,36688,0,0,36688,5.7096e+15,33.0159,781.004,36688,32,31,36633,36592,36608,34844,34723
16737,6,28,0,16737,2921,13816,5105.68,11.5383,444.852,16737,19,23,16081,16081,15339,15349,11421
46129,1,2,0,46129,46129,0,1.01723e+16,1.9997,284.321,46129,2,2,39616,39616,39616,39616,39616
20541,34,38,20541,0,0,20541,5.72054e+15,21.4202,585.939,20541,30,29,20503,20489,20501,20503,20503
43968,30,44,43968,0,43968,0,1.1044e+18,36.8708,1097.65,43968,40,37,43850,43493,43235,32710,37300
5650,1,2,5650,0,5650,0,3.25814e+13,1.99558,98.797,5650,2,2,4995,4995,4995,4995,4995
10285,19,40,0,10285,0,10285,1207190,31.9685,449.202,10285,32,34,10083,9770,9961,9935,6805
38766,22,40,38766,0,0,38766,5.01302e+15,35.3507,920.32,38766,40,37,38302,37228,37779,13773,24685
3004,11,22,3004,0,3004,0,1.47397e+18,17.2726,204.131,3004,18,18,2898,2765,2402,2204,1984
24740,6,24,0,24740,0,24740,1334340,21.4847,582.346,24740,23,22,21260,19126,15012,14824,8462
45227,9,56,45227,0,0,45227,339405000,35.3382,872.261,45227,40,32,42260,35284,35066,35671,18639
23039,12,30,4201,18838,0,23039,19.4319,13.9268,553.954,23039,19,25,22919,22914,22825,22853,21952
32012,18,24,32012,0,0,32012,5.7265e+15,21.539,673.481,32012,24,22,31940,31830,31609,26652,27952
31552,28,40,31552,0,0,31552,5.70743e+15,22.4553,670.757,31552,30,29,31512,31493,31506,18796,31510
11625,1,2,11625,0,11625,0,6.69002e+13,1.99966,149.126,11625,2,2,8861,8861,8861,8861,8861
37780,30,44,0,37780,37780,0,2.03799e+13,42.4469,922.559,37780,40,41,37665,37399,37272,36833,27421
11654,29,40,11654,0,0,11654,310535000,27.6418,461.517,11654,33,33,11594,11494,11489,10577,11064
37990,21,56,37990,0,37990,0,86035900000,30.5142,835.967,37990,39,43,37823,37570,37676,37556,15269
33273,34,56,33273,0,33273,0,85829600000,29.257,853.539,33273,38,43,33193,33053,33105,33103,32146
23748,5,28,0,23748,3999,19749,5177.56,10.8741,483.586,23748,19,21,22130,22130,19774,19559,18128
36752,1,2,0,36752,36752,0,8.40136e+15,1.99962,252.93,36752,2,2,32466,32466,32466,32466,32466
11165,33,60,11165,0,0,11165,5.26818e+15,31.8498,638.248,11165,36,53,11083,10945,10964,10969,9613
43199,5,60,43199,0,43199,0,1.34442e+18,41.9951,1117.59,43199,54,46,33691,26004,27035,5235,9191
25928,2,24,25928,0,25928,0,1.46652e+18,20.8831,589.513,25928,23,22,14384,14382,9663,2954,4117
5981,22,36,5981,0,5981,0,72353100000,29.2709,344.57,5981,30,29,5859,5580,5745,5476,4549
12664,13,21,2026,10638,0,12664,20.1333,10.6053,325.249,12664,18,20,12637,12637,12634,12636,12632
46867,1,4,0,46867,46867,0,8.59458e+15,1.99989,290.915,46867,3,3,41274,41274,41274,41274,41274
40218,26,44,40218,0,40218,0,66175700000,37.1481,1046.29,40218,39,37,39970,39179,39316,38232,31704
2743,7,17,0,2743,478,2265,4708.98,12.7878,160.151,2743,17,17,2645,2645,2624,2640,2510
36301,13,40,0,36301,0,36301,1113770,36.3569,928.262,36301,38,37,33213,28079,31476,31382,16577
14761,19,21,0,14761,2383,12378,5088.16,10.7393,369.318,14761,17,20,14740,14740,14724,14724,14684
44157,17,21,7097,37060,0,44157,20.0845,14.9645,619.644,44157,21,21,44120,44120,44098,44098,44028
26046,1,2,26046,0,26046,0,3.28312e+13,1.99919,212.741,26046,2,2,23007,23007,23007,23007,23007
49342,13,23,0,49342,9955,39387,4670.59,19.8263,788.968,49342,22,22,49075,49075,48713,48759,45717
2176,8,18,2176,0,0,2176,343902000,15.659,162.514,2176,16,17,1989,1679,1647,1717,1342
8611,15,40,8611,0,0,8611,5.65212e+15,18.0483,358.711,8611,25,29,8534,8420,8453,4124,6913
43878,1,2,43878,0,43878,0,3.67897e+13,1.99982,276.639,43878,2,2,38142,38142,38142,38142,38142
22245,3,4,0,22245,22245,0,8.33141e+15,1.99978,202.872,22245,3,3,22241,22239,22240,22240,22241
25152,4,40,25152,0,0,25152,5.60358e+15,32.5001,625.025,25152,37,37,18859,14644,14298,3287,5518
24443,3,24,0,24443,24443,0,2.23866e+13,22.0626,598.58,24443,24,22,15726,13262,11793,13119,4123
10810,18,21,1725,9085,0,10810,20.1177,10.0244,301.339,10810,19,20,10788,10788,10786,10786,10783
8351,36,38,8351,0,0,8351,339072000,20.7736,388.202,8351,30,22,8313,8301,8313,8313,8313
43209,33,40,43209,0,43209,0,1.45908e+18,35.2742,930.125,43209,39,38,43132,42905,43079,35534,39980
14771,1,2,14771,0,14771,0,4.09321e+13,1.99736,161.825,14771,2,2,12622,12622,12622,12622,12622
31362,1,2,0,31362,31362,0,8.3541e+15,1.99936,233.885,31362,2,2,27725,27725,27725,27725,27725
34459,46,56,34459,0,34459,0,1.45972e+18,22.6103,750.525,34459,37,32,34403,34390,34399,31388,34401
39015,7,21,6264,32751,0,39015,20.0219,17.1343,585.757,39015,21,21,38426,38426,37554,37588,7448
7284,1,2,7284,0,7284,0,3.246e+13,1.99725,111.986,7284,2,2,6443,6443,6443,6443,6443
28491,19,64,28491,0,28491,0,75533900000,34.0876,1067.06,28491,38,54,27807,26056,26451,25711,15493
22774,21,40,22774,0,0,22774,5.20265e+15,33.8583,651.559,22774,36,35,22477,21969,22212,4841,16416
34211,35,44,34211,0,34211,0,1.39759e+18,32.5288,770.128,34211,37,37,34160,34043,34041,30353,33062
28461,18,44,28461,0,28461,0,1.40642e+18,26.1969,711.56,28461,36,37,28196,27842,28027,10116,20768
34522,1,2,0,34522,34522,0,8.40762e+15,1.99933,245.434,34522,2,2,30493,30493,30493,30493,30493
2074,1,2,0,2074,2074,0,1.24728e+16,1.99373,63.9847,2074,2,2,1714,1714,1714,1714,1714
28113,5,40,0,28113,0,28113,1308160,38.0004,661.951,28113,36,37,22868,17335,17822,17964,8584
41043,29,60,41043,0,41043,0,1.37322e+18,28.7651,1020.06,41043,45,44,40938,40768,40614,28578,31967
18468,30,48,0,18468,18468,0,2.07574e+13,31.5191,694.705,18468,29,41,18412,18372,18320,18201,16803
12992,26,36,12992,0,0,12992,5.62985e+15,22.4666,412.089,12992,28,25,12946,12911,12938,7069,12149
29746,9,20,0,29746,5053,24693,5198.7,12.1946,523.292,29746,20,15,29590,29590,29291,29289,29289
11411,15,23,2697,8714,0,11411,17.9455,13.7946,419.512,11411,18,22,11376,11376,11278,11286,9687
770,6,9,105,665,0,770,19.7299,6.02208,65.3822,770,8,8,757,757,754,755,734
28061,27,40,0,28061,28061,0,2.21584e+13,27.7561,626.111,28061,30,29,28008,27968,27997,27975,27927
22919,36,38,22919,0,0,22919,5.66659e+15,30.3145,653.88,22919,33,31,22875,22779,22869,22872,22875
24138,235,403,845,23293,23870,268,1.53829e+16,27.9707,1418.93,24138,87,69,23735,23723,23526,23512,22072
12400,1,19,1983,10417,0,12400,20.1981,10.1915,312.352,12400,19,18,2212,2212,2212,2212,2212
23975,14,40,23975,0,23975,0,1.28431e+18,33.8008,712.126,23975,37,37,22742,20492,22005,4838,11945
36140,1,2,36140,0,36140,0,3.27972e+13,1.99975,250.646,36140,2,2,31928,31928,31928,31928,31928
27656,6,44,27656,0,27656,0,71018500000,33.2989,831.817,27656,38,37,21091,18225,17482,16752,6736
9792,1,36,9792,0,9792,0,1.44042e+18,17.7565,348.945,9792,26,25,1240,1240,1240,1240,1240
27455,8,44,27455,0,27455,0,1.33534e+18,34.9771,790.533,27455,36,41,24253,20935,20726,4874,9427
28721,4,31,0,28721,6233,22488,2.50881e+12,17.6073,672.227,28721,23,24,24179,24179,22477,21386,19644
23417,10,13,3921,19496,0,23417,20.3743,11.8882,436.598,23417,13,13,23383,23383,23339,23338,23375
32648,10,21,0,32648,6294,26354,4723.11,17.1399,617.213,32648,21,20,32218,32197,31931,32022,29330
13694,8,24,0,13694,13694,0,2.23702e+13,20.7868,431.753,13694,21,22,12552,10646,9734,10713,6155
4478,2,18,0,4478,0,4478,1344440,16.4314,236.062,4478,18,18,2436,2436,1600,708,814
6035,4,48,6035,0,6035,0,1.18172e+18,22.7488,459.548,6035,28,41,3328,2556,2556,1429,745
33705,5,21,0,33705,5421,28284,5129.39,15.5278,544.427,33705,20,21,31822,31822,28700,28682,21164
4508,3,19,748,3760,0,4508,19.0657,10.9769,206.516,4508,17,18,3668,3668,3651,3527,2155
30114,25,28,5052,25062,0,30114,19.9899,16.4872,567.733,30114,20,27,30086,30086,30086,30086,29997
47201,1,2,47201,0,47201,0,3.44561e+13,1.99968,286.062,47201,2,2,41422,41422,41422,41422,41422
11731,14,24,11731,0,11731,0,1.47371e+18,19.5624,405.338,11731,20,21,11599,11449,10299,9338,8916
24720,8,40,0,24720,0,24720,1321220,26.5285,587.602,24720,29,29,22901,19826,19216,19902,10005
38902,3,4,0,38902,38902,0,8.3927e+15,2.0001,265.966,38902,3,3,38898,38896,38897,38897,38898
9829,40,44,9829,0,9829,0,1.29649e+18,24.9984,525.633,9829,32,41,9785,9777,9711,9534,9064
3913,15,32,3913,0,0,3913,286701000,26.8387,267.666,3913,30,28,3700,3343,3585,3587,1693
48918,20,44,0,48918,48918,0,1.99405e+13,39.2637,1054.01,48918,41,41,48216,46973,47294,45645,27610
19424,19,44,19424,0,19424,0,1.38092e+18,28.5917,608.933,19424,34,37,19195,18859,19063,7821,13814
45296,1,2,0,45296,45296,0,8.62063e+15,1.99978,280.627,45296,2,2,39876,39876,39876,39876,39876
16207,9,21,0,16207,2641,13566,5184,10.1411,367.058,16207,19,20,16142,16142,16127,16131,16085
32955,2,21,0,32955,5307,27648,5120.59,16.4747,545.424,32955,21,21,22617,22617,22519,16781,13231
33459,18,38,33459,0,0,33459,338743000,31.6248,777.451,33459,33,32,33231,32957,32563,32497,28795
38194,1,2,0,38194,38194,0,1.18933e+16,1.99958,262.304,38194,2,2,31889,31889,31889,31889,31889
4925,1,2,4925,0,4925,0,3.94351e+13,1.99695,92.6088,4925,2,2,4234,4234,4234,4234,4234
4956,30,44,4956,0,4956,0,1.33961e+18,19.3896,360.7,4956,26,37,4912,4904,4862,4381,4328
42796,6,23,7987,34809,0,42796,18.7359,18.9117,711.575,42796,21,22,40666,40666,39902,40006,37867
1105,28,36,0,1105,1105,0,2.0641e+13,12.6787,159.287,1105,20,29,1069,1068,1063,1069,979
17778,24,40,0,17778,17778,0,2.20741e+13,29.3346,499.235,17778,29,29,17724,17689,17709,17669,17719
31394,35,44,0,31394,31394,0,2.11473e+13,34.2253,751.779,31394,37,37,31344,31238,31232,31225,30146
29389,35,40,29389,0,0,29389,260361000,32.8527,878.477,29389,39,34,29342,29258,29075,27239,28673
5353,13,21,0,5353,1073,4280,4704.32,12.2918,253.57,5353,17,19,5314,5314,5276,5280,4854
39442,19,40,39442,0,0,39442,5.59148e+15,34.7538,780.719,39442,38,37,39232,38961,39073,6353,24877
7713,3,4,0,7713,7713,0,8.30535e+15,2.00052,121.954,7713,3,3,7709,7707,7708,7708,7709
16324,6,56,0,16324,16324,0,2.20455e+13,22.6768,528.463,16324,29,31,14198,12881,10285,12253,5452
33363,22,23,0,33363,5680,27683,4996.19,17.9774,593.941,33363,21,21,33339,33339,33291,33291,33337
1753,18,20,1753,0,1753,0,87134200000,13.2635,143.03,1753,15,17,1733,1725,1731,1732,1667
32726,31,44,32726,0,32726,0,1.33089e+18,32.7051,843.355,32726,40,41,32638,32384,32297,17182,24511
44742,2,4,0,44742,44742,0,8.39078e+15,2.00007,284.842,44742,3,3,44737,44736,44737,44737,41737
34361,4,38,34361,0,34361,0,86728300000,31.2511,786.784,34361,33,32,23907,18023,17449,21109,8893
2635,3,38,2635,0,0,2635,5.40688e+15,27.1503,264.51,2635,31,26,1543,1294,857,500,485
48607,24,33,13779,34828,1,48606,5790660000,16.8937,958.484,48607,22,26,48574,48574,48332,48323,36255
11397,3,13,1858,9539,0,11397,20.2955,11.9725,300.259,11397,12,12,9003,9003,8972,5612,2492
16916,35,60,0,16916,0,16916,1275080,21.741,693.193,16916,30,44,16856,16848,16811,16814,14929
13087,1,2,13087,0,13087,0,6.64597e+13,1.99916,160.104,13087,2,2,9996,9996,9996,9996,9996
7588,5,36,7588,0,0,7588,5.62624e+15,17.2939,308.855,7588,25,25,6287,4784,4913,1200,2124
17245,42,55,17245,0,17245,0,1.11287e+18,31.0898,762.556,17245,37,45,17190,17184,17018,15801,10991
38276,38,40,38276,0,0,38276,5.7216e+15,29.0804,796.927,38276,32,30,38234,38206,38233,38233,38234
9689,14,20,9689,0,0,9689,5.69678e+15,17.382,336.666,9689,20,19,9633,9561,9352,7998,8631
28323,1,25,0,28323,7014,21309,4464.56,18.1039,662.813,28323,21,23,6341,6341,6341,6341,6341
17009,32,40,17009,0,0,17009,5.61957e+15,32.5396,493.1,17009,30,29,16961,16915,16946,14670,15508
16712,1,4,0,16712,16712,0,8.19659e+15,3.57797,191.624,16712,4,4,14780,14780,14780,14780,14780
35853,3,4,0,35853,35853,0,8.39295e+15,1.99989,255.47,35853,3,3,35849,35847,35848,35848,35849
5003,27,36,0,5003,5003,0,2.17142e+13,15.0384,249.511,5003,21,25,4967,4954,4964,4952,4965
25636,16,24,25636,0,0,25636,3.41e+08,22.0341,619.769,25636,24,22,25453,24966,24384,24381,20213
17229,4,19,3153,14076,0,17229,20.0836,16.048,428.97,17229,19,19,14879,14879,13342,9883,10908
37957,1,2,37957,0,37957,0,3.22876e+13,1.99929,259.369,37957,2,2,33602,33602,33602,33602,33602
14255,7,13,2361,11894,0,14255,20.3474,11.4933,338.09,14255,12,13,14022,14022,13227,13545,13632
48368,24,60,48368,0,0,48368,5.3653e+15,29.8681,1075.49,48368,40,44,48116,47720,47692,26577,34829
20003,12,44,20003,0,20003,0,79144400000,24.6204,687.87,20003,35,41,18754,16959,17111,17080,10398
40617,18,23,0,40617,6853,33764,4989.41,20.059,648.563,40617,21,21,40576,40573,40493,40495,40167
7961,36,38,0,7961,7961,0,2.22554e+13,19.742,378.063,7961,29,25,7923,7911,7923,7923,7923
11113,1,21,0,11113,1783,9330,5153.36,10.2419,306.569,11113,19,20,1987,1987,1987,1987,1987
26201,1,2,26201,0,26201,0,3.86208e+13,1.9992,214.871,26201,2,2,22605,22605,22605,22605,22605
41583,11,65,0,41583,0,41583,4.43599e+14,37.378,1310.07,41583,40,58,33707,24711,28105,15962,9311
8584,6,20,8584,0,8584,0,86699900000,17.4394,314.905,8584,19,19,7598,6970,5493,6620,3954
29444,10,28,0,29444,4931,24513,5177.91,11.835,532.441,29444,20,21,29362,29362,29303,29305,29277
41598,12,44,41598,0,41598,0,72073400000,38.3178,1018.4,41598,39,39,37076,30976,34329,32453,16922
37317,54,60,37287,30,0,37317,5.90879e+15,35.9318,1017.94,37317,52,37,37257,37257,37255,37208,36872
32252,2,29,46,32206,32249,3,8.11687e+15,3.96934,326.995,32252,11,10,31863,31738,31786,31819,29971
27920,1,2,0,27920,27920,0,9.96728e+15,1.99864,221.483,27920,2,2,24057,24057,24057,24057,24057
920,1,18,0,920,0,920,1344910,12.0848,106.803,920,14,15,96,96,96,96,96
36744,39,64,36744,0,36744,0,7.6472e+10,34.9681,1180.35,36744,38,55,36680,36670,36396,36439,24896
44770,1,5,1,44769,44770,0,8.7026e+15,3.21977,305.733,44770,4,4,39327,39327,39327,39327,39327
29670,1,2,29670,0,29670,0,5.15705e+13,1.9997,232.432,29670,2,2,24233,24233,24233,24233,24233
40179,8,20,0,40179,7190,32989,5170.97,18.2365,647.268,40179,20,19,39609,39604,37581,37574,32577
584,17,28,0,584,0,584,1066080,16.2021,92.8754,584,18,17,540,508,527,526,216
24373,1,23,0,24373,5050,19323,4588.86,18.1407,559.653,24373,21,22,5682,5682,5682,5682,5682
10017,3,19,1787,8230,0,10017,20.2588,11.1911,318.81,10017,19,17,7599,7599,7449,4816,4440
29055,1,2,29055,0,29055,0,3.2783e+13,1.99955,224.617,29055,2,2,25670,25670,25670,25670,25670
48325,1,2,48325,0,48325,0,3.45458e+13,1.99965,289.412,48325,2,2,42393,42393,42393,42393,42393
2607,18,22,2607,0,2607,0,1.46349e+18,19.8427,202.475,2607,20,20,2577,2557,2536,2258,2522
13318,10,32,0,13318,3764,9554,4409.7,14.1913,523.111,13318,19,24,13077,13059,12737,12752,8875
13709,35,36,13709,0,0,13709,330463000,23.7731,443.469,13709,33,33,13671,13633,13663,13658,13663
11104,2,46,11090,14,11090,14,2.26784e+13,28.7612,526.186,11104,43,29,3740,3574,3161,1284,864
46079,15,32,9466,36613,0,46079,19.1626,19.9502,849.025,46079,28,25,46010,46010,45893,45899,41871
10523,22,36,10523,0,10523,0,80993400000,26.8157,410.43,10523,33,32,10407,10213,10321,10077,6226
23271,1,2,23271,0,23271,0,3.87299e+13,1.99948,202.048,23271,2,2,20068,20068,20068,20068,20068
29913,4,21,4837,25076,0,29913,20.2392,11.9975,495.4,29913,21,20,27138,27138,24713,24189,23674
24318,7,30,0,24318,4517,19801,4893.75,17.0459,634.947,24318,19,29,23332,23330,22135,21997,9462
31030,23,56,31030,0,0,31030,334415000,31.8075,735.709,31030,38,39,30912,30779,30837,30090,23142
29556,34,38,0,29556,0,29556,1311240,35.8105,760.46,29556,37,34,29494,29338,29461,29460,29490
22147,5,21,3533,18614,0,22147,19.8658,16.5808,444.089,22147,20,20,20949,20949,19045,19042,19376
34965,27,60,34965,0,34965,0,1.41544e+18,27.1501,857.745,34965,43,40,34852,34630,34683,18982,28412
17712,1,40,17712,0,17712,0,85439600000,23.3332,527.905,17712,35,37,2122,2122,2122,2122,2122
34512,1,44,0,34512,34512,0,1.70691e+13,36.9898,977.567,34512,39,37,2300,2300,2300,2300,2300
37288,8,44,0,37288,0,37288,1224670,35.0607,889.063,37288,37,41,33426,29230,28858,29429,11886
12579,1,2,0,12579,12579,0,8.37493e+15,1.9996,148.526,12579,2,2,11116,11116,11116,11116,11116
19056,25,40,19056,0,0,19056,340175000,22.3577,563.688,19056,31,24,19016,18998,19004,19006,19016
40598,15,40,0,40598,0,40598,1311250,31.9124,771.904,40598,37,37,40303,39808,39947,39910,24870
5966,18,24,5966,0,5966,0,87218200000,21.0003,293.309,5966,19,19,5938,5920,5866,5858,4467
8229,1,2,0,8229,8229,0,8.40628e+15,1.99818,120.025,8229,2,2,7268,7268,7268,7268,7268
45207,15,40,45207,0,45207,0,86410500000,28.9735,836.367,45207,40,37,44848,44220,43688,43539,27368
26260,16,19,0,26260,4771,21489,5143.4,18.0388,532.618,26260,19,19,26214,26214,26214,26214,26214
24659,4585,6732,0,24659,0,24659,2.23638e+17,243.019,8913.07,24659,1765,226,17927,17927,16168,13128,13549
19501,12,23,0,19501,3797,15704,4840.96,18.4932,502.443,19501,20,22,19394,19387,19316,19337,17806
9917,35,40,0,9917,0,9917,1319280,18.7904,382.23,9917,21,29,9877,9868,9877,9875,9877
2255,8,11,358,1897,0,2255,20.3157,7.80576,124.184,2255,9,10,2241,2241,2234,2234,2241
30605,32,44,30605,0,30605,0,80118100000,33.8014,811.428,30605,37,41,30539,30453,30346,30106,27801
37737,22,40,37737,0,37737,0,1.45989e+18,21.7252,725.341,37737,31,29,37689,37641,37658,14165,35626
45079,25,66,45079,0,45079,0,1.253e+18,35.7604,1369.42,45079,51,50,44782,44094,43629,22544,26869
33589,16,21,0,33589,6415,27174,4718.31,17.7268,622.634,33589,21,20,33519,33513,33376,33377,32647
37805,18,40,0,37805,0,37805,1313940,27.9965,748.975,37805,37,37,37656,37481,37548,37540,28037
33915,15,40,33915,0,33915,0,76866400000,36.2775,844.316,33915,38,37,32486,29320,31522,30196,18156
6954,1,2,6954,0,6954,0,3.25433e+13,1.99784,110.096,6954,2,2,6149,6149,6149,6149,6149
21235,29,52,21219,16,0,21235,5.19186e+15,32.2531,750.349,21235,47,33,21153,21041,20926,18800,18686
4076,13,22,4076,0,0,4076,5.77065e+15,16.9924,241.55,4076,19,19,3984,3707,3696,3285,3221
18365,17,20,3126,15239,0,18365,20.2779,11.6696,417.624,18365,19,19,18343,18343,18343,18343,18330
28886,16,23,4866,24020,0,28886,19.507,14.2148,544.843,28886,20,21,28840,28837,28771,28771,28260
23463,16,32,0,23463,6374,17089,4293.4,16.4613,664.126,23463,21,25,23402,23398,23174,23178,16179
6516,3096,5400,0,6516,1833,4683,1.72117e+14,35.2531,5673.35,6516,2556,88,1116,1104,560,236,121
18802,18,36,18802,0,0,18802,332150000,25.7185,521.303,18802,36,33,18679,18552,18605,17719,13483
30507,39,44,30507,0,30507,0,1.40327e+18,35.3784,756.093,30507,36,37,30462,30423,30353,26167,27952
5777,383,564,5775,2,5777,0,4.48533e+18,181.807,1305.11,5777,166,104,5213,5179,4966,4953,4925
37391,7,28,6084,31307,0,37391,20.0205,15.8617,606.816,37391,21,27,36758,36758,35388,35835,22351
19281,1,2,19281,0,19281,0,3.79563e+13,1.99943,185.001,19281,2,2,16680,16680,16680,16680,16680
575,1,12,575,0,575,0,1.35393e+18,9.28696,66.5139,575,11,10,96,96,96,96,96
13700,1,2,13700,0,13700,0,4.23651e+13,1.99876,155.03,13700,2,2,11637,11637,11637,11637,11637
31922,40,44,31922,0,0,31922,311356000,35.4223,836.138,31922,37,41,31878,31859,31702,30384,30491
16856,22,24,16856,0,16856,0,87674800000,20.3422,482.517,16856,22,21,16830,16816,16828,16826,16797
22363,21,40,22363,0,0,22363,5.22194e+15,33.9179,642.527,22363,36,35,22083,21608,21842,4596,14712
985,16,36,0,985,0,985,1124420,14.4772,168.841,985,21,31,895,594,794,786,468
20008,22,40,20008,0,20008,0,1.45273e+18,18.8954,518.26,20008,27,29,19968,19948,19957,12104,19314
22636,9,21,3599,19037,0,22636,19.8715,16.088,447.607,22636,20,20,22503,22503,22465,22490,22357
3732,8,36,0,3732,3732,0,2.06868e+13,21.5434,250.557,3732,28,32,3445,3125,3104,3106,1485
18719,1,2,18719,0,18719,0,6.15158e+13,1.99947,188.508,18719,2,2,14627,14627,14627,14627,14627
24406,576,1244,24403,3,24406,0,2.40988e+18,131.809,2872.06,24406,206,143,23162,23016,22109,21635,11156
39575,24,44,0,39575,39575,0,1.69454e+13,37.2512,1036.72,39575,39,37,39217,38524,37875,36349,28387
33509,8,44,33509,0,0,33509,5.4953e+15,30.6107,757.257,33509,36,37,30982,27350,26676,5744,15346
46250,1,2,46250,0,46250,0,4.13844e+13,1.99959,286.375,46250,2,2,39449,39449,39449,39449,39449
43015,28,40,43015,0,43015,0,1.46414e+18,22.5395,807.44,43015,29,29,42975,42955,42964,40140,42975
39081,6,44,39081,0,0,39081,327614000,33.78,831.524,39081,37,38,34197,31220,26156,28146,12012
35118,24,44,35118,0,0,35118,312200000,37.3266,870.723,35118,38,41,34886,34504,34496,18863,27305
28838,3,5,1,28837,28838,0,1.27159e+16,2.74977,255.348,28838,4,4,28812,28775,28804,28804,28446
25935,25,60,0,25935,0,25935,1294140,23.1011,762.498,25935,31,40,25841,25718,25736,25716,23837
16744,16,24,0,16744,16744,0,2.24042e+13,20.3914,477.98,16744,21,22,16656,16428,16051,16448,14168
33313,7,40,33313,0,33313,0,1.25923e+18,36.2107,863.932,33313,39,37,28037,24385,24093,5823,8467
21544,6,40,21544,0,21544,0,76007200000,36.615,692.568,21544,37,37,17769,15890,14559,14726,4102
30834,16,40,30834,0,0,30834,5.70326e+15,34.7372,736.231,30834,32,30,30499,29726,28931,24607,21948
40278,1,5,6,40272,40278,0,1.43908e+16,1.99963,281.755,40278,4,3,32230,32230,32230,32230,32230
29102,21,23,0,29102,5569,23533,4808.74,19.4607,600.402,29102,21,22,29077,29077,29031,29033,29077
13864,48,60,13864,0,0,13864,4.92841e+15,27.451,650.429,13864,36,43,13804,13796,13797,13804,10422
33376,12,56,33376,0,33376,0,1.44443e+18,31.3716,782.69,33376,44,40,32472,30788,28932,11882,17000
45739,23,44,45739,0,45739,0,78900700000,38.4212,1006.52,45739,40,41,45351,44305,44846,43871,31799
12318,7,60,12318,0,0,12318,4.77287e+15,38.2856,577.242,12318,36,40,9973,8495,8450,2223,1557
21732,14,40,21732,0,21732,0,78461200000,34.9137,648.315,21732,35,35,20870,19529,20378,19394,9866
7260,1,40,7260,0,0,7260,5.72534e+15,18.7237,337.88,7260,20,30,793,793,793,793,793
37286,1,2,37286,0,37286,0,3.27555e+13,1.99979,255.094,37286,2,2,32946,32946,32946,32946,32946
32892,4,19,0,32892,5953,26939,5165.58,16.6466,589.407,32892,19,19,28576,28576,25697,19261,17060
23060,49,56,0,23060,23060,0,2.21091e+13,23.7802,672.672,23060,31,36,23004,22994,23004,23004,21477
43058,31,40,43058,0,0,43058,5.65622e+15,29.44,816.446,43058,40,37,42994,42908,42945,34494,39409
9736,1,2,0,9736,9736,0,8.33369e+15,1.99815,130.074,9736,2,2,8609,8609,8609,8609,8609
49518,33,64,49518,0,49518,0,74943300000,35.4661,1200.8,49518,39,44,49418,49270,48894,48947,22772
17610,5,40,17610,0,17610,0,1.28712e+18,34.8426,600.886,17610,35,33,13952,11052,11948,2513,3863
29917,19,28,0,29917,5019,24898,5150.15,13.1227,581.483,29917,21,27,29887,29887,29887,29887,29823
20749,21,56,20749,0,20749,0,1.45975e+18,21.7979,606.278,20749,29,32,20681,20561,20651,17111,19318
46084,35,40,46084,0,0,46084,337420000,31.5202,959.03,46084,38,36,46023,45850,45952,45951,44651
38447,1,56,38447,0,0,38447,5.6606e+15,38.3351,829.286,38447,40,39,4239,4239,4239,4239,4239
7147,1,2,0,7147,7147,0,8.61021e+15,1.9972,111.79,7147,2,2,6292,6292,6292,6292,6292
27584,10,24,27584,0,27584,0,1.46571e+18,21.6514,641.051,27584,24,22,26336,25229,22052,10894,14061
39566,28,31,9826,29740,6,39560,7113850000,19.3212,806.534,39566,25,24,39535,39534,39534,39534,39481
46252,39,44,46252,0,46252,0,68698700000,38.5505,1103.12,46252,39,39,46203,46138,45827,45895,46161
45181,19,60,0,45181,0,45181,1293950,31.4059,960.703,45181,36,42,44858,44348,44622,44595,35779
15585,4,40,0,15585,0,15585,1199350,31.8423,541.043,15585,33,33,11728,9507,9570,10091,3886
25946,1,4,0,25946,25946,0,8.34831e+15,1.99965,218.492,25946,3,3,22937,22937,22937,22937,22937
27644,2021,9173,0,27644,8906,18738,7.79559e+14,256.924,11145.2,27644,3110,203,18471,18312,13043,3483,1331
21988,21,40,21988,0,0,21988,4.76649e+15,33.1223,715.361,21988,37,37,21601,20653,21073,7194,13175
13301,1,2,0,13301,13301,0,9.10133e+15,1.99895,151.778,13301,2,2,11620,11620,11620,11620,11620
11669,1,2,0,11669,11669,0,8.3673e+15,1.99871,143.095,11669,2,2,10313,10313,10313,10313,10313
25206,5,21,4038,21168,0,25206,19.9949,12.1541,469.786,25206,19,20,23821,23821,21523,21521,21962
22713,12,44,22713,0,22713,0,1.31609e+18,30.075,737.818,22713,36,41,21195,19046,19397,9835,10929
16486,1,2,16486,0,16486,0,3.26276e+13,1.99958,169.678,16486,2,2,14574,14574,14574,14574,14574
44897,1,2,44897,0,44897,0,3.33404e+13,1.99978,280.113,44897,2,2,39578,39578,39578,39578,39578
10868,6,38,10868,0,0,10868,5.7072e+15,20.5267,436.673,10868,29,27,8924,7786,6438,2971,3941
18370,10,36,0,18370,0,18370,1281780,26.9056,525.603,18370,35,33,17776,17245,16165,16146,7665
41920,5,32,0,41920,9649,32271,4727.96,18.2336,918.798,41920,20,31,36203,36200,33010,31328,15531
32835,27,40,32835,0,0,32835,314334000,30.135,796.714,32835,39,35,32701,32267,32463,19179,24665
37670,1,2,0,37670,37670,0,8.47781e+15,1.9995,255.504,37670,2,2,33237,33237,33237,33237,33237
16672,13,40,16672,0,16672,0,87281200000,20.7152,527.413,16672,30,26,16287,15155,14511,14726,10895
26886,40,44,0,26886,26886,0,2.13611e+13,26.6237,693.14,26886,34,37,26842,26831,26770,26759,24912
23681,4,21,0,23681,3833,19848,5101.06,17.3248,467.556,23681,20,21,21545,21545,19698,18445,12707
37008,26,31,10097,26911,6,37002,7605560000,19.103,799.639,37008,26,24,36977,36974,36973,36976,34575
6155,1,2,6155,0,6155,0,3.77282e+13,1.99756,104.424,6155,2,2,5329,5329,5329,5329,5329
12239,15,19,2270,9969,0,12239,19.865,15.5015,399.845,12239,19,19,12186,12186,12136,12138,10546
6191,14,19,1144,5047,0,6191,19.936,16.0512,263.605,6191,19,19,6159,6159,6157,6158,5639
40403,27,30,7860,32543,0,40403,19.0102,15.4997,760.054,40403,20,26,40373,40373,40373,40373,39431
19755,2,21,5571,14184,0,19755,16.1215,17.5442,532.018,19755,20,20,12138,12138,12106,11260,5381
9716,55,56,0,9716,0,9716,1313120,19.9331,441.446,9716,30,32,9660,9652,9660,9660,9660
32250,21,44,32250,0,0,32250,5.48381e+15,34.7796,772.358,32250,36,37,32016,31678,31797,10903,24001
18612,4,24,18612,0,0,18612,5.73397e+15,20.9862,500.09,18612,21,22,13538,10293,9929,2237,4319
32842,55,60,0,32842,0,32842,1287360,35.8748,949.84,32842,38,52,32782,32774,32779,32781,32346
42160,18,23,0,42160,7046,35114,5018.45,17.2514,653.526,42160,21,21,42122,42119,42038,42038,41629
11655,14,40,0,11655,0,11655,1291400,26.0867,443.603,11655,32,37,11468,11272,11161,11161,6749
14083,3,40,14083,0,0,14083,5.55611e+15,24.6141,474.75,14083,34,37,9624,8239,7517,2023,2803
40554,19,23,6766,33788,0,40554,19.5601,17.5594,641.747,40554,21,21,40525,40525,40441,40441,40130
25046,31,56,0,25046,0,25046,1324750,22.55,630.356,25046,30,29,24990,24972,24986,24984,18346
36372,1,2,36372,0,36372,0,5.66324e+13,1.99953,261.234,36372,2,2,29053,29053,29053,29053,29053
43094,15,28,7208,35886,0,43094,20.1478,12.7309,657.141,43094,20,25,43045,43045,43026,43026,42896
14986,18,24,14986,0,14986,0,1.46071e+18,18.836,436.155,14986,21,21,14952,14904,14876,13099,13753
4589,32,36,4589,0,4589,0,85101900000,14.7265,240.527,4589,22,25,4553,4544,4553,4545,4553
25760,29,40,0,25760,25760,0,1.75712e+13,32.8668,807.459,25760,37,37,25663,25454,25305,25093,23326
37293,23,25,0,37293,9335,27958,4379.78,17.7595,750.437,37293,22,23,37268,37268,37032,37032,37264
41523,1,20,7180,34343,0,41523,20.2765,19.0317,637.674,41523,20,20,6687,6687,6687,6687,6687
5412,1,2,5412,0,5412,0,3.25579e+13,1.99834,97.8443,5412,2,2,4785,4785,4785,4785,4785
41216,29,40,41216,0,0,41216,5.69094e+15,26.0116,762.226,41216,32,29,41165,41126,41156,31886,39942
32338,13,21,0,32338,5367,26971,5195.74,12.3146,527.195,32338,21,20,32309,32309,32307,32309,32306
48678,34,40,0,48678,0,48678,1331800,30.845,885.931,48678,32,31,48632,48590,48623,48622,48632
31744,1,2,31744,0,31744,0,3.80928e+13,1.99975,235.23,31744,2,2,27447,27447,27447,27447,27447
42247,7,44,0,42247,42247,0,2.03839e+13,40.8193,964.012,42247,41,41,36779,32313,30883,31214,10681
42228,39,40,0,42228,42228,0,2.18842e+13,33.0354,801.392,42228,37,37,42187,42131,42176,42176,42187
17494,12,56,17494,0,0,17494,332272000,23.9517,572.911,17494,36,38,17068,16361,15567,15615,8549
15049,6,38,15049,0,15049,0,1.43868e+18,32.0008,557.989,15049,31,36,12176,10552,8330,2473,4750
7614,12,24,7614,0,7614,0,87343400000,18.4396,319.095,7614,20,21,7446,7088,6716,7006,5760
19785,1,40,0,19785,19785,0,2.22245e+13,21.5739,530.516,19785,29,29,2281,2281,2281,2281,2281
38571,40,44,0,38571,38571,0,2.14271e+13,31.2832,810.356,38571,37,37,38527,38508,38453,38443,38134
6323,31,36,0,6323,0,6323,1260850,30.7123,319.642,6323,31,33,6280,6224,6242,6243,6237
8985,10,36,8985,0,0,8985,325865000,26.0716,365.522,8985,31,33,8692,8431,8021,8022,4988
45669,3,44,45669,0,0,45669,5.29784e+15,34.5023,963.979,45669,39,41,30666,26390,24496,6294,7320
4452,2,4,0,4452,4452,0,8.23839e+15,2.00067,93.8592,4452,3,3,4447,4446,4447,4447,4395
25786,3,44,25786,0,25786,0,1.39484e+18,37.7997,707.396,25786,36,39,17327,14843,13631,3625,5020
20107,16,23,3670,16437,0,20107,19.3268,17.5172,492.653,20107,20,22,20068,20067,20019,20021,19406
33321,15,21,6912,26409,0,33321,17.8279,18.425,633.567,33321,21,20,33220,33220,33000,33003,32354
21633,11,21,0,21633,5471,16162,4233.46,18.197,535.857,21633,20,20,21278,21278,21120,21176,18302
13837,1,2,13837,0,13837,0,6.75564e+13,1.99935,164.175,13837,2,2,10515,10515,10515,10515,10515
6038,13,19,927,5111,0,6038,19.9238,9.66595,215.098,6038,18,18,6013,6013,6013,6013,6010
43069,39,56,43069,0,43069,0,1.45725e+18,35.6461,836.192,43069,33,36,43012,42972,42995,35418,43012
16366,1,2,0,16366,16366,0,8.35667e+15,1.99908,168.794,16366,2,2,14467,14467,14467,14467,14467
1142,9,14,1142,0,0,1142,342655000,12.8722,107.036,1142,13,14,1085,931,962,956,856
13591,1,2,13591,0,13591,0,3.31366e+13,1.9975,153.507,13591,2,2,11990,11990,11990,11990,11990
11399,1,2,11399,0,11399,0,3.55825e+13,1.99868,140.988,11399,2,2,9957,9957,9957,9957,9957
11282,30,40,11282,0,11282,0,86767300000,19.4389,446.87,11282,30,24,11242,11230,11238,11235,11113
27403,15,56,27403,0,0,27403,5.66064e+15,24.7122,718.544,27403,32,40,27065,26546,26062,18742,19189
8351,28,36,8351,0,0,8351,325596000,27.2812,355.658,8351,32,31,8297,8247,8256,6829,8233
11806,5,36,11806,0,11806,0,1.42675e+18,23.3519,391.809,11806,28,25,9849,7558,7902,1639,3279
6106,18,40,0,6106,6106,0,2.1942e+13,18.0906,308.713,6106,24,29,6063,6038,6039,6008,5434
23961,25,40,0,23961,23961,0,1.96755e+13,34.4458,720.92,23961,38,34,23773,23382,23392,22771,15942
48517,1,2,0,48517,48517,0,8.62903e+15,1.99965,290.118,48517,2,2,42706,42706,42706,42706,42706
17926,1,40,0,17926,17926,0,2.18933e+13,23.5577,533.162,17926,36,37,2131,2131,2131,2131,2131
31797,13,44,0,31797,31797,0,2.15573e+13,25.593,749.292,31797,36,37,31085,29557,30068,29590,17573
19729,24,56,19729,0,0,19729,337575000,21.8884,572.087,19729,29,31,19672,19645,19642,19621,17259
2839,5,11,434,2405,0,2839,20.1846,8.17788,137.076,2839,10,10,2702,2702,2437,2436,2566
27941,20,56,27941,0,0,27941,5.69397e+15,21.3824,683.306,27941,32,32,27861,27741,27758,21069,25341
39486,23,40,39486,0,0,39486,5.71307e+15,22.0339,749.074,39486,32,29,39441,39392,39423,13983,37196
31085,27,60,31085,0,31085,0,1.43074e+18,24.0732,819.552,31085,38,40,31005,30873,30898,27130,29059
23073,8,40,0,23073,23073,0,1.64872e+13,32.0943,772.68,23073,36,34,16545,12511,13484,12192,6316
1220,12,24,0,1220,0,1220,1311150,12.8393,124.928,1220,15,12,1191,1168,965,1013,470
986,7,28,0,986,986,0,2.05941e+13,10.211,106.198,986,20,17,923,860,852,837,611
15735,1,2,15735,0,15735,0,3.34514e+13,1.99892,164.924,15735,2,2,13864,13864,13864,13864,13864
32875,11,40,0,32875,32875,0,2.22902e+13,21.8749,677.651,32875,30,29,32003,30702,28290,28420,17547
27200,824,2741,0,27200,0,27200,1.2582e+17,119.886,4770.48,27200,665,208,24459,24278,22864,9633,7360
13941,13,64,13941,0,13941,0,1.33441e+18,23.5615,701.547,13941,36,44,12751,10327,11227,7886,7320
26332,1,24,0,26332,0,26332,1335980,21.7699,607.263,26332,24,22,2816,2816,2816,2816,2816
42183,265,351,42183,0,42183,0,7.90357e+17,18.9689,1252.11,42183,55,58,41832,41823,41813,41812,41800
3427,14,18,0,3427,3427,0,2.25267e+13,15.0552,200.017,3427,16,17,3401,3385,3313,3310,3336
43369,40,56,0,43369,43369,0,2.21636e+13,36.1265,870.575,43369,40,39,43313,43288,43275,43277,43313
12282,13,24,12282,0,12282,0,87505200000,18.2596,399.677,12282,21,21,12111,11513,11223,11667,9118
48204,1,4,0,48204,48204,0,9.32485e+15,1.99992,295.746,48204,3,3,41963,41963,41963,41963,41963
48109,9,40,48109,0,48109,0,86476100000,28.4133,857.71,48109,40,37,45426,38783,39397,38750,20639
24746,16,44,0,24746,24746,0,1.72671e+13,33.1942,814.491,24746,36,37,22913,15676,20704,19433,12285
13095,3,19,2369,10726,0,13095,20.2679,11.6685,362.152,13095,19,19,9867,9867,9676,6299,5844
49821,10,40,49821,0,0,49821,5.67646e+15,33.6291,983.586,49821,38,38,47030,44737,38740,21685,18508
11266,7,19,2017,9249,0,11266,20.2336,11.6489,337.478,11266,19,19,10946,10946,10219,10102,8875
25492,16,20,4336,21156,0,25492,20.3077,11.9428,486.017,25492,20,17,25468,25468,25468,25468,25468
9943,26,40,9943,0,0,9943,337083000,18.888,379.971,9943,26,29,9903,9887,9897,9896,9901
45730,21,40,45730,0,45730,0,1.25421e+18,34.8457,1031.94,45730,40,37,45060,43357,44093,13062,28995
45361,21,44,0,45361,45361,0,2.04658e+13,37.1754,974.59,45361,38,41,44882,43929,44352,43107,30052
36648,37,60,0,36648,36648,0,2.16354e+13,26.6488,874.05,36648,36,40,36588,36572,36453,36441,30031
614,12,20,0,614,614,0,2.23197e+13,11.8893,90.9396,614,14,17,585,548,566,568,491
25549,31,40,25549,0,0,25549,4.22311e+15,34.559,815.02,25549,38,34,25477,25258,25122,21232,23405
6652,14,19,0,6652,1237,5415,5009.93,15.8697,273.377,6652,19,19,6608,6608,6608,6608,6608
24498,2,24,0,24498,24498,0,2.24141e+13,21.7099,582.169,24498,23,22,13438,13437,8940,11011,3985
20459,27,28,0,20459,3457,17002,5173.35,10.8199,452.884,20459,19,21,20431,20431,20431,20431,20427
48151,1,2,0,48151,48151,0,1.06909e+16,1.99954,292.23,48151,2,2,41006,41006,41006,41006,41006
7086,1,2,7086,0,7086,0,3.26521e+13,1.99633,111.719,7086,2,2,6263,6263,6263,6263,6263
3013,31,36,3013,0,0,3013,324764000,15.6289,229.15,3013,21,30,2977,2972,2960,2938,2944
3915,6,11,0,3915,613,3302,5173.62,9.79923,165.998,3915,10,11,3834,3834,3735,3735,3785
18184,36,40,0,18184,18184,0,2.22004e+13,21.5069,509.507,18184,29,29,18144,18130,18144,18136,18144
43766,8,44,43766,0,0,43766,262192000,36.3572,1074.64,43766,39,37,33086,26190,27626,27549,11365
30236,1,2,30236,0,30236,0,3.99926e+13,1.99947,232.305,30236,2,2,25939,25939,25939,25939,25939
31155,26,65,31155,0,31155,0,1.13245e+18,34.9749,1062.51,31155,45,48,30971,30538,30567,12672,11524
22543,29,40,22543,0,0,22543,328227000,34.0517,612.323,22543,36,34,22470,22349,22400,19244,19285
21415,7,40,21415,0,21415,0,87087500000,32.6158,609.82,21415,31,29,18579,15808,13736,15666,7718
717,4,20,717,0,717,0,8.8535e+10,12.6346,98.0059,717,14,17,503,382,369,444,241
16400,3,40,0,16400,0,16400,1298700,34.1152,505.342,16400,33,29,11157,9538,8685,6421,2002
13375,12,24,13375,0,0,13375,5.72336e+15,20.7947,427.205,13375,20,22,13080,12439,11524,8259,9201
39783,18,23,7453,32330,0,39783,18.7717,16.0827,688.511,39783,21,22,39745,39742,39586,39586,38117
20658,7,24,0,20658,20658,0,2.24094e+13,21.934,538.632,20658,23,22,18261,15801,13553,15558,8418
38185,1,2,38185,0,38185,0,4.18398e+13,1.9995,259.72,38185,2,2,32508,32508,32508,32508,32508
45816,14,44,45816,0,45816,0,78248400000,37.6059,1019.42,45816,41,41,43701,39744,42155,40300,21343
12698,30,38,12698,0,12698,0,86044100000,34.8625,494.539,12698,32,30,12644,12582,12624,12625,12644
19246,11,40,19246,0,0,19246,338979000,21.0887,521.999,19246,29,29,18752,18020,16764,16784,11148
8392,1,2,0,8392,8392,0,1.37555e+16,1.99833,125.046,8392,2,2,6789,6789,6789,6789,6789
17389,20,40,17389,0,0,17389,279639000,32.8073,644.765,17389,36,37,17015,16259,16356,9085,10536
2580,2,36,0,2580,2580,0,2.02447e+13,23.2267,219.054,2580,27,32,1557,1547,1240,1196,565
10789,8,36,10789,0,0,10789,5.67229e+15,18.3679,374.275,10789,28,25,10036,8743,8473,1985,5067
5970,7,11,0,5970,925,5045,5174.2,9.45662,200.636,5970,11,11,5907,5907,5779,5779,5873
18702,11,23,4152,14550,0,18702,17.861,16.9116,513.295,18702,20,22,18484,18484,18397,18426,15400
40328,22,44,40328,0,0,40328,260089000,36.6775,1039.11,40328,39,37,39734,38097,38498,27544,26482
46933,8,44,46933,0,46933,0,83869200000,36.9779,904.083,46933,38,38,43307,38129,37206,38144,17073
14095,4,19,2492,11603,0,14095,20.3042,11.3453,371.839,14095,19,16,12375,12375,11205,9005,8826
46915,1,4,0,46915,46915,0,8.60114e+15,1.99979,291.348,46915,3,3,41312,41312,41312,41312,41312
10243,14,24,0,10243,0,10243,1338970,19.7181,378.26,10243,20,21,10133,10015,8978,9599,7816
42346,2,4,0,42346,42346,0,9.06293e+15,3.28926,295.211,42346,4,4,42293,42276,42289,42290,38346
1363,18,32,1363,0,0,1363,309351000,22.2135,135.933,1363,20,21,1321,1297,1308,1305,1316
10563,24,38,10563,0,10563,0,86902900000,21.6914,431.733,10563,24,29,10525,10505,10513,10513,10525
36403,36,44,0,36403,36403,0,2.04108e+13,36.4583,885.114,36403,37,41,36351,36305,36100,36123,34940
45328,41,60,45328,0,45328,0,81396700000,36.7557,1187.8,45328,38,56,45268,45258,45070,45050,36167
28542,6,21,0,28542,4555,23987,5160.18,14.7447,483.965,28542,21,20,27904,27904,27166,27172,27196
11816,3,24,0,11816,11816,0,2.24823e+13,19.2316,404.184,11816,20,21,7607,6409,5704,6384,2569
25413,1,2,0,25413,25413,0,1.23343e+16,1.99957,214.49,25413,2,2,21062,21062,21062,21062,21062
35645,1,28,0,35645,5764,29881,5122.04,16.1003,588.621,35645,21,27,6479,6479,6479,6479,6479
702,9,10,0,702,130,572,5270.25,9.23932,75.6249,702,10,10,688,688,687,687,621
14390,3,21,0,14390,2352,12038,5098.79,16.9986,367.61,14390,20,20,11479,11479,11441,10436,8493
31889,3,28,0,31889,5372,26517,5185.15,12.0702,553.15,31889,20,21,24866,24866,24658,20297,14977
12194,12,24,0,12194,12194,0,2.24422e+13,18.1358,400.939,12194,20,21,11927,11322,10556,11165,9218
28464,4,65,0,28464,0,28464,6.48053e+14,27.5647,1029.18,28464,37,48,16774,12889,12752,7478,4468
5987,1,2,5987,0,5987,0,3.33332e+13,1.99766,102.466,5987,2,2,5277,5277,5277,5277,5277
550,1,2,550,0,550,0,3.27535e+13,1.98727,30.6238,550,2,2,485,485,485,485,485
23885,4,40,23885,0,0,23885,5.53763e+15,32.828,614.875,23885,37,36,18063,14155,13933,3187,5234
47100,1,2,47100,0,47100,0,3.21156e+13,1.99943,289.283,47100,2,2,41725,41725,41725,41725,41725
48819,15,60,0,48819,48819,0,2.17032e+13,30.6132,988.308,48819,37,43,48091,46800,46782,46145,30962
19117,1,28,3176,15941,0,19117,20.122,11.9949,439.01,19117,20,21,3272,3272,3272,3272,3272
12792,1,4,0,12792,12792,0,8.31434e+15,2,154.997,12792,3,3,11313,11313,11313,11313,11313
20699,1,2,0,20699,20699,0,1.01234e+16,1.99928,190.467,20699,2,2,17790,17790,17790,17790,17790
39765,1,2,0,39765,39765,0,1.03724e+16,1.99922,264.337,39765,2,2,34040,34040,34040,34040,34040
7369,7,44,7369,0,7369,0,78138200000,23.8807,401.001,7369,32,35,6462,5735,5542,5498,1692
37147,16,40,37147,0,0,37147,338634000,36.7439,858.672,37147,33,38,36605,35501,34632,34439,18414
36145,1,2,36145,0,36145,0,4.04477e+13,1.99956,252.147,36145,2,2,30950,30950,30950,30950,30950
29915,3,48,29915,0,0,29915,299815000,33.8237,900.924,29915,37,41,18252,15588,14589,11458,4461
34676,61,65,34675,1,34675,1,2.49386e+12,26.7424,1089.61,34676,34,48,34611,34604,34608,34611,33175
38851,2,30,7680,31171,0,38851,18.4837,22.4098,761.587,38851,22,28,26236,26236,25948,21840,8748
23610,6,40,23610,0,23610,0,87019900000,20.8154,576.521,23610,29,29,20500,18565,14750,17808,9094
47601,35,56,0,47601,0,47601,1317120,28.3845,900.459,47601,39,40,47534,47466,47484,47478,37461
49158,51,56,0,49158,0,49158,1326080,33.5356,883.458,49158,40,32,49102,49075,49098,49098,49102
43381,19,44,0,43381,0,43381,1219690,37.4483,939.52,43381,41,37,42739,41529,42203,42148,21450
3218,27,30,3115,103,3218,0,1.84297e+15,12.7063,219.64,3218,18,24,3188,3180,3184,3185,3020
49206,49,64,0,49206,49206,0,1.91892e+13,35.6055,1200.72,49206,39,44,49142,49132,49138,49003,36946
10177,7,20,0,10177,1752,8425,5196.07,11.1862,315.737,10177,18,18,9952,9952,9365,9326,7148
9315,21,40,0,9315,9315,0,1.61588e+13,29.2057,495.796,9315,32,33,9114,8266,8480,8030,6847
32279,9,21,5701,26578,0,32279,19.0006,15.8557,586.799,32279,21,19,31839,31839,31679,31785,27772
6528,26,40,0,6528,6528,0,1.99657e+13,21.8053,363.904,6528,29,33,6472,6373,6377,6243,5374
10558,5,19,0,10558,1936,8622,5143.47,14.124,336.081,10558,19,19,9566,9566,8531,8005,7326
35292,3,40,35292,0,0,35292,5.71401e+15,22.4022,712.175,35292,32,29,23204,19637,17586,4131,7385
25092,20,44,0,25092,25092,0,2.12057e+13,38.6255,705.797,25092,36,39,24857,24534,24632,24192,17866
26222,21,40,26222,0,0,26222,340118000,23.0596,650.002,26222,32,24,26165,26038,26128,26124,23804
20281,1,2,0,20281,20281,0,9.74222e+15,1.99911,188.647,20281,2,2,17538,17538,17538,17538,17538
27234,1,2,27234,0,27234,0,3.26599e+13,1.99963,218.314,27234,2,2,24073,24073,24073,24073,24073
13835,32,38,13835,0,0,13835,335801000,28.6179,512.86,13835,32,31,13785,13717,13770,13769,13785
2776,7,18,0,2776,2776,0,2.2643e+13,16.3588,189.319,2776,17,18,2419,2066,1865,2059,1382
6678,12,21,0,6678,1311,5367,4617.2,13.2869,277.316,6678,18,19,6604,6600,6549,6563,6031
30766,21,40,30766,0,0,30766,335226000,30.0051,682.555,30766,37,37,30654,30546,30578,29706,25192
45663,23,40,45663,0,45663,0,87292200000,30.8824,865.101,45663,32,31,45603,45546,45561,45574,42383
44287,13,40,0,44287,0,44287,1210830,32.3346,960.16,44287,40,37,42257,38867,40801,40770,18517
30670,20,40,30670,0,30670,0,1.44785e+18,28.3994,654.466,30670,31,29,30590,30524,30529,4544,26708
1365,24,36,1365,0,0,1365,334020000,11.9245,150.014,1365,14,25,1329,1325,1326,1326,1327
31452,1,2,31452,0,31452,0,3.93234e+13,1.99924,234.667,31452,2,2,27057,27057,27057,27057,27057
2510,1,20,2510,0,2510,0,1.46044e+18,13.041,167.732,2510,15,17,299,299,299,299,299
41994,57,64,41994,0,41994,0,74889600000,32.2736,1136.84,41994,37,44,41930,41920,41926,41930,35587
3892,31,36,3892,0,3892,0,84835500000,15.2888,225.159,3892,22,25,3856,3845,3856,3847,3856
40363,20,23,6744,33619,0,40363,19.562,17.5714,640.796,40363,21,21,40336,40335,40251,40251,40137
31906,1,5,6,31900,31906,0,1.01449e+16,1.99947,243.052,31906,4,3,27410,27410,27410,27410,27410
10691,9,30,2017,8674,0,10691,18.2931,16.9386,390.018,10691,19,25,10456,10456,10370,10418,3873
28426,1,2,28426,0,28426,0,5.29956e+13,1.9994,228.035,28426,2,2,23073,23073,23073,23073,23073
21860,1,2,21860,0,21860,0,3.3195e+13,1.99913,194.304,21860,2,2,19281,19281,19281,19281,19281
5498,8,32,0,5498,5498,0,1.54252e+13,28.0313,360.982,5498,31,29,3749,2711,2987,2587,1622
20669,9,40,20669,0,0,20669,5.73066e+15,20.7219,581.904,20669,30,27,19110,15587,15614,8095,9989
15466,9,28,0,15466,2685,12781,5165.88,10.9559,406.033,15466,19,21,15340,15340,15199,15203,15060
44521,11,20,7659,36862,0,44521,20.3153,16.2774,648.019,44521,20,20,44443,44443,44432,44431,44394
27115,31,55,27115,0,27115,0,1.22803e+18,31.3564,938.843,27115,38,45,27038,26933,26747,19503,14706
3370,1,2,0,3370,3370,0,1.62504e+16,1.99644,81.7088,3370,2,2,2609,2609,2609,2609,2609
1733,19,40,1733,0,1733,0,1.37496e+18,14.966,180.141,1733,21,27,1693,1677,1685,724,1420
39480,15,40,39480,0,39480,0,73195900000,35.411,964.189,39480,39,37,37105,30953,35309,33457,19317
21409,17,21,4756,16653,0,21409,17.4224,19.1841,520.43,21409,20,20,21370,21370,21220,21221,20851
39280,7,23,6593,32687,0,39280,19.2877,17.6618,630.798,39280,20,21,38351,38351,37910,38014,37071
24537,1,2,0,24537,24537,0,8.41068e+15,1.99886,206.349,24537,2,2,21672,21672,21672,21672,21672
18233,21,40,18233,0,0,18233,5.67797e+15,21.907,509.531,18233,29,29,18188,18155,18157,3281,15802
34504,3,4,0,34504,34504,0,8.38904e+15,1.99986,250.708,34504,3,3,34500,34498,34499,34499,34500
26928,41,56,26928,0,0,26928,5.63226e+15,24.7393,712.998,26928,33,40,26872,26861,26856,25978,23861
49781,886,1846,18635,31146,845,48936,6.66295e+11,44.6622,3497.75,49781,346,168,47935,47900,47115,47241,12816
44821,7,65,44821,0,0,44821,6.21914e+15,35.5868,1029.2,44821,40,48,38981,33569,29520,6446,16009
8112,2,24,0,8112,0,8112,1331050,17.8235,330.202,8112,19,21,4529,4528,3065,1403,1577
3862,20,22,3862,0,0,3862,343850000,17.006,235.798,3862,19,19,3840,3828,3838,3837,3840
46361,1,28,7718,38643,0,46361,20.1562,12.6464,676.82,46361,20,25,8030,8030,8030,8030,8030
19261,16,44,19261,0,19261,0,84709500000,32.9862,584.486,19261,36,37,19043,18571,18844,18659,13042
14756,1,2,14756,0,14756,0,3.24471e+13,1.99939,161.531,14756,2,2,13054,13054,13054,13054,13054
46109,13,23,7868,38241,0,46109,19.3244,18.0916,692.425,46109,21,21,45932,45932,45751,45780,44692
18525,37,44,0,18525,0,18525,1251650,29.4243,597.992,18525,34,37,18481,18469,18359,18360,16320
38827,2,56,0,38827,38827,0,2.22572e+13,23.2161,793.168,38827,32,32,21458,21451,14439,17615,6327
2050,19,32,2050,0,0,2050,307915000,14.7059,181.701,2050,26,27,1994,1939,1968,1092,1585
47949,31,40,47937,12,47949,0,1.76379e+14,1.29521,412.606,47949,17,16,47909,47907,47902,47904,47881
9777,1,24,0,9777,0,9777,1331120,17.6376,358.882,9777,19,21,1106,1106,1106,1106,1106
14798,1,2,0,14798,14798,0,1.72377e+16,1.99797,169.169,14798,2,2,11257,11257,11257,11257,11257
39378,21,44,39378,0,0,39378,4.55527e+15,36.6451,1007,39378,38,39,38662,36413,37261,13622,24561
12062,11,36,12062,0,12062,0,86712600000,18.4193,400.511,12062,28,25,11777,11349,10715,10688,7180
928,1,2,0,928,928,0,8.54131e+15,1.98922,39.7792,928,2,2,817,817,817,817,817
31892,49,60,31892,0,0,31892,323975000,32.0905,931.39,31892,38,50,31832,31822,31828,31544,29373
1680,5,18,1680,0,1680,0,88455900000,15.2048,145.45,1680,15,17,1311,965,958,1153,590
45898,3,4,0,45898,45898,0,8.6206e+15,2,288.703,45898,3,3,45894,45892,45893,45893,45894
41654,33,56,41654,0,0,41654,336437000,28.9147,848.388,41654,38,40,41581,41516,41524,37419,32713
37795,1,2,37795,0,37795,0,3.28133e+13,1.9996,256.546,37795,2,2,33388,33388,33388,33388,33388
39308,38,44,39308,0,39308,0,1.40858e+18,33.5812,834.189,39308,37,38,39262,39220,39102,33998,35605
26911,1,2,0,26911,26911,0,1.0665e+16,1.9997,218.998,26911,2,2,22927,22927,22927,22927,22927
22895,1,2,0,22895,22895,0,8.49458e+15,1.99939,199.039,22895,2,2,20195,20195,20195,20195,20195
31996,23,38,31996,0,0,31996,333516000,34.3107,819.147,31996,38,38,31776,31482,31557,31547,26409
35172,11,32,7520,27652,0,35172,19.0389,13.3185,759.757,35172,20,24,34998,34998,34847,34864,30491
15250,37,40,0,15250,0,15250,1190860,35.0352,551.339,15250,33,33,15207,15185,15148,15148,15205
4101,14,18,0,4101,0,4101,1345170,16.9829,231.996,4101,18,18,4049,3999,3900,3900,3754
32565,21,60,0,32565,0,32565,1312520,22.8256,819.813,32565,32,40,32453,32225,32355,32370,30386
21017,11,13,3606,17411,0,21017,20.3974,11.3797,421.929,21017,13,12,20991,20991,20990,20991,20982
4748,12,21,1039,3709,0,4748,17.3741,14.9895,243.972,4748,18,19,4678,4674,4621,4635,4101
19921,16,63,19921,0,19921,0,1.06739e+18,36.2516,739.79,19921,42,34,17523,7651,14193,10330,8788
32691,8,23,0,32691,6155,26536,4805.35,19.5618,628.692,32691,21,22,31901,31810,31595,31694,29422
42219,1,4,0,42219,42219,0,1.2473e+16,2.81681,300.676,42219,4,4,34878,34878,34878,34878,34878
5632,3,44,5632,0,0,5632,4.62015e+15,23.7907,417.047,5632,32,41,3247,2791,2676,1087,647
49571,10,56,49571,0,0,49571,5.66489e+15,28.6288,921.529,49571,37,40,47593,45827,41120,12503,23417
28113,1,2,28113,0,28113,0,3.27902e+13,1.99957,221.606,28113,2,2,24837,24837,24837,24837,24837
44148,4,40,44148,0,44148,0,87131800000,31.2568,856.82,44148,32,31,31353,23723,22944,27473,11127
12304,8,13,0,12304,2034,10270,5222.28,10.1127,307.824,12304,12,12,12238,12238,11973,11972,12208
30813,16,21,4998,25815,0,30813,20.2507,12.0967,503.431,30813,21,20,30787,30787,30787,30787,30784
28428,1239,2137,28140,288,0,28428,5.00051e+17,90.0193,3882.31,28428,372,179,26291,26269,25690,24853,6367
14534,14,60,14534,0,0,14534,314443000,23.2068,668.989,14534,32,44,13821,12483,12162,12765,8642
35543,33,44,35543,0,0,35543,5.24348e+15,31.5193,874.457,35543,40,41,35474,35369,35209,29195,27818
43765,1,56,43765,0,0,43765,5.68954e+15,35.9498,859.467,43765,40,32,4758,4758,4758,4758,4758
11613,1,2,11613,0,11613,0,3.59448e+13,1.99871,141.681,11613,2,2,10129,10129,10129,10129,10129
23950,12,24,23950,0,23950,0,1.46488e+18,21.0022,566.179,23950,23,22,23466,22372,20523,14936,17182
47532,22,40,0,47532,0,47532,1328570,31.1054,902.084,47532,33,31,47455,47384,47384,47390,46081
24402,30,40,0,24402,0,24402,1326400,22.6259,590.25,24402,30,28,24362,24344,24359,24356,24360
22250,1,2,22250,0,22250,0,3.91661e+13,1.9996,197.682,22250,2,2,19153,19153,19153,19153,19153
16932,19,40,0,16932,16932,0,2.20552e+13,29.9981,488.348,16932,29,29,16868,16800,16823,16775,15368
19616,35,40,19616,0,19616,0,63332400000,31.963,710.501,19616,35,34,19573,19532,19387,19439,19161
37752,1,2,0,37752,37752,0,1.15668e+16,1.99966,260.324,37752,2,2,31691,31691,31691,31691,31691
36462,1,2,0,36462,36462,0,8.71521e+15,1.9994,251.278,36462,2,2,32051,32051,32051,32051,32051
5779,27,40,0,5779,5779,0,2.22003e+13,15.7972,304.547,5779,18,29,5739,5731,5734,5731,5737
43566,17,32,7958,35608,0,43566,19.9187,19.155,767.703,43566,28,24,43519,43519,43497,43499,42154
951,16,18,951,0,0,951,5.71356e+15,13.5857,107.648,951,14,15,933,923,929,848,933
12302,1,30,2262,10040,0,12302,20.174,11.5036,395.203,12302,19,22,1912,1912,1912,1912,1912
33383,21,40,33383,0,0,33383,340470000,22.7578,703.299,33383,32,29,33329,33241,33295,33294,28844
1255,7,8,200,1055,0,1255,20.4207,7.25976,86.9143,1255,8,8,1240,1240,1240,1240,1240
30986,1,2,30986,0,30986,0,3.83706e+13,1.99919,233.07,30986,2,2,26761,26761,26761,26761,26761
25597,2,28,0,25597,4351,21246,5186.61,11.7113,501.787,25597,20,21,16940,16940,16658,10070,5758
9026,9,36,0,9026,9026,0,2.13656e+13,26.4186,367.3,9026,31,33,8585,7652,7882,7748,4324
49822,1,48,49822,0,0,49822,4.94459e+15,36.9733,1128.82,49822,39,41,4943,4943,4943,4943,4943
30626,37,40,30626,0,30626,0,1.46833e+18,21.8533,692.28,30626,28,29,30586,30570,30584,29188,30586
9308,31,38,9308,0,0,9308,331550000,32.5236,427.222,9308,32,31,9256,9190,9238,9238,9256
14931,27,40,14931,0,14931,0,80597300000,30.7141,514.084,14931,34,34,14846,14631,14720,14609,13327
49963,38,44,49963,0,49963,0,1.32057e+18,38.5096,1057.84,49963,41,41,49911,49833,49573,45475,47108
9515,31,56,9515,0,0,9515,333330000,19.6752,430.601,9515,29,32,9459,9441,9453,9451,8639
35509,1,2,35509,0,35509,0,3.77002e+13,1.99949,249.252,35509,2,2,30752,30752,30752,30752,30752
25442,37,44,0,25442,0,25442,1272620,31.0742,678.652,25442,37,37,25398,25373,25322,25325,25015
40563,50,65,40562,1,0,40563,9.05991e+14,35.3613,1252.59,40563,38,60,40498,40492,40491,37311,35498
9111,1,19,0,9111,1421,7690,5134.61,10.6139,264.816,9111,19,12,1684,1684,1684,1684,1684
9223,33,48,9223,0,9223,0,65869500000,27.8735,545.649,9223,32,41,9175,9167,9048,8931,6010
11518,3,4,0,11518,11518,0,8.30808e+15,1.99896,147.56,11518,3,3,11514,11512,11513,11513,11514
49041,25,40,49041,0,49041,0,1.43288e+18,33.8457,869.814,49041,38,37,48893,48682,48773,17738,35003
12444,2,19,0,12444,1963,10481,5031.46,13.7588,328.231,12444,19,19,8740,8740,8734,7160,4953
3970,10,13,681,3289,0,3970,20.3778,9.67985,183.934,3970,11,12,3955,3955,3954,3953,3954
18069,26,38,0,18069,18069,0,2.21745e+13,27.037,570.869,18069,31,30,18019,17979,17998,17999,18019
19702,22,36,19702,0,0,19702,5.41543e+15,27.4696,566.825,19702,36,33,19556,19280,19446,4786,12237
35797,1,4,0,35797,35797,0,8.32556e+15,3.42691,260.254,35797,4,4,31654,31654,31654,31654,31654
42168,10,40,0,42168,42168,0,2.20923e+13,29.1542,803.218,42168,39,37,40723,39393,35438,35372,20392
24600,37,40,24600,0,0,24600,5.69701e+15,22.3767,593.272,24600,30,29,24560,24546,24560,21167,24560
31545,13,24,31545,0,0,31545,5.72262e+15,21.1216,659.997,31545,24,22,31057,29409,28019,23999,22705
48460,13,60,48460,0,0,48460,327865000,33.6955,1073.94,48460,37,51,47120,44497,44909,44589,18954
36978,25,44,36978,0,36978,0,1.40317e+18,31.6344,797.098,36978,37,37,36814,36542,36569,13783,27428
39400,18,40,39400,0,39400,0,87278500000,23.2439,779.592,39400,32,28,39286,39142,38748,38687,28802
29484,1,2,0,29484,29484,0,1.71468e+16,1.99929,239.979,29484,2,2,22467,22467,22467,22467,22467
8301,6,44,8301,0,8301,0,81253100000,20.1819,473.075,8301,28,41,6569,5701,4710,5465,2963
21019,19,44,21019,0,21019,0,84140400000,34.2757,613.35,21019,36,37,20860,20629,20769,20513,14663
47971,14,60,47971,0,0,47971,319629000,29.9219,1071.17,47971,40,44,46458,43879,43452,44483,24777
38535,1,2,0,38535,38535,0,9.10841e+15,1.99925,258.62,38535,2,2,33663,33663,33663,33663,33663
28387,16,40,28387,0,0,28387,331121000,31.2836,661.699,28387,37,37,28131,27763,27912,27910,17169
4799,20,22,4799,0,0,4799,342746000,16.8481,258.459,4799,19,19,4777,4767,4777,4776,4777
41588,1,2,41588,0,41588,0,3.76514e+13,1.99937,269.216,41588,2,2,36024,36024,36024,36024,36024
4429,3,12,808,3621,0,4429,20.317,10.9939,200.726,4429,12,12,3324,3324,3281,1538,1144
24427,3,44,24427,0,24427,0,67445800000,32.8101,810.722,24427,36,37,13608,11701,11407,10037,3293
34357,1,2,0,34357,34357,0,8.73953e+15,1.99971,243.898,34357,2,2,30189,30189,30189,30189,30189
30749,6,48,30749,0,0,30749,283357000,35.0073,933.978,30749,36,41,22995,19596,18083,18267,6311
18992,17,23,0,18992,5237,13755,4166.79,17.5814,525.057,18992,20,21,18957,18957,18880,18883,18891
44855,6,20,0,44855,7643,37212,5204.42,12.6396,637.291,44855,20,19,43421,43421,41596,41316,30765
47186,3,4,0,47186,47186,0,9.12593e+15,1.99987,292.841,47186,3,3,47182,47180,47181,47181,47182
32110,1,2,32110,0,32110,0,3.40821e+13,1.99978,236.049,32110,2,2,28221,28221,28221,28221,28221
22395,11,40,0,22395,0,22395,1128650,36.5141,712.926,22395,36,37,20211,17802,18994,18944,8431
37559,36,60,37559,0,37559,0,81734600000,28.2147,983.672,37559,36,44,37493,37462,37287,37295,29474
38842,33,48,38842,0,0,38842,4.73503e+15,37.0032,1003.82,38842,38,40,38762,38643,38257,20419,27360
7912,1,2,7912,0,7912,0,3.33344e+13,1.99735,117.104,7912,2,2,6974,6974,6974,6974,6974
2852,1,2,2852,0,2852,0,3.52337e+13,1.99719,70.6371,2852,2,2,2494,2494,2494,2494,2494
6329,1,2,0,6329,6329,0,9.72305e+15,1.99652,105.371,6329,2,2,5474,5474,5474,5474,5474
48792,41,56,48792,0,0,48792,338866000,37.6962,887.885,48792,41,32,48736,48711,48722,48735,48736
8305,6,36,8305,0,0,8305,242853000,28.3711,449.843,8305,30,30,4427,3021,3125,2869,1560
22518,13,25,0,22518,5060,17458,4683.58,17.7436,584.292,22518,20,23,22431,22431,22363,22371,20039
21615,1,2,21615,0,21615,0,3.92489e+13,1.9987,194.607,21615,2,2,18600,18600,18600,18600,18600
28198,11,64,28198,0,28198,0,7.8807e+10,33.8307,1038.04,28198,38,55,25025,21403,20826,20299,10331
12226,31,40,12226,0,12226,0,1.4602e+18,20.6161,464.93,12226,22,29,12186,12176,12178,12061,12092
49444,1,2,49444,0,49444,0,3.2227e+13,1.99992,296.186,49444,2,2,43782,43782,43782,43782,43782
49863,4,21,0,49863,7984,41879,5105.95,17.1818,667.332,49863,21,21,45499,45499,41568,40991,26466
15608,1,2,15608,0,15608,0,3.25334e+13,1.99833,165.731,15608,2,2,13803,13803,13803,13803,13803
8357,37,40,8357,0,0,8357,4.17177e+15,28.8257,470.506,8357,32,33,8317,8310,8211,8146,7391
24606,34,40,24606,0,24606,0,1.46319e+18,38.6404,641.267,24606,32,29,24560,24530,24550,19677,18573
37119,273,427,0,37119,0,37119,1.89205e+16,41.5836,1429.89,37119,93,59,36692,36691,36533,20274,6342
36316,23,56,36316,0,0,36316,5.62876e+15,30.3533,801.695,36316,38,40,36198,36065,36123,11440,28372
19077,2,21,0,19077,7072,12005,3810.01,16.8175,525.405,19077,20,20,9660,9660,9345,9044,5464
47407,29,60,47407,0,47407,0,85132200000,26.0177,969.107,47407,34,40,47313,47180,47178,47159,41319
44966,6,56,0,44966,0,44966,1327560,22.7137,861.951,44966,32,32,38248,34175,27403,25481,13641
23231,26,40,0,23231,23231,0,1.76183e+13,33.9935,769.749,23231,36,37,23064,22563,22673,22027,18846
4649,26,32,4649,0,4649,0,1.37494e+18,20.1282,264.079,4649,31,23,4603,4553,4579,3823,4355
4694,8,40,4694,0,4694,0,1.43323e+18,15.7684,274.598,4694,24,29,4338,3786,3625,1460,2045
33024,14,40,33024,0,33024,0,8.7126e+10,23.0319,701.705,33024,32,23,32694,32301,29476,31357,21899
39901,20,56,39901,0,0,39901,5.65461e+15,29.3055,840.575,39901,37,40,39745,39547,39624,22423,33050
23018,1,2,0,23018,23018,0,8.49615e+15,1.99952,199.551,23018,2,2,20303,20303,20303,20303,20303
8470,19,40,8470,0,8470,0,84591100000,18.702,387.921,8470,29,36,8389,8315,8353,8231,7112
21612,7,60,21612,0,21612,0,1.30608e+18,31.3163,797.293,21612,44,44,17966,15286,14422,5016,5406
25943,11,40,0,25943,0,25943,1328590,31.0174,668.499,25943,31,30,24814,23336,21472,21298,12915
46206,13,48,46206,0,46206,0,7.7363e+10,36.6291,1070.84,46206,40,41,43175,37746,41082,39425,20054
18769,12,13,0,18769,3150,15619,5215.31,12.1684,393.095,18769,13,12,18753,18753,18743,18743,18743
31491,1,44,0,31491,31491,0,2.04485e+13,37.0652,835.146,31491,37,41,3503,3503,3503,3503,3503
19547,27,40,19547,0,19547,0,81431900000,31.785,577.968,19547,35,35,19446,19190,19309,19198,15453
47721,5,25,10349,37372,0,47721,17.9771,19.0288,811.285,47721,21,23,42464,42463,40183,40290,36252
27118,27,60,27118,0,0,27118,321869000,25.0659,858.066,27118,33,44,27032,26863,26862,25348,23366
25849,27,40,25849,0,0,25849,339929000,22.2763,607.008,25849,30,29,25809,25789,25803,25802,25807
26547,17,40,26547,0,26547,0,83304900000,28.5011,675.139,26547,37,35,26224,25414,26016,25525,18145
2496,1,2,0,2496,2496,0,8.37208e+15,1.9976,65.5524,2496,2,2,2205,2205,2205,2205,2205
39471,1,44,39471,0,39471,0,81084200000,37.8084,876.457,39471,38,37,4704,4704,4704,4704,4704
49141,6,40,0,49141,0,49141,1330680,30.4372,899.329,49141,32,31,41316,36636,29453,25909,14074
11286,3,36,0,11286,0,11286,1282820,24.1349,405.108,11286,33,25,7842,6739,6187,5034,1466
848,12,16,848,0,0,848,5.58569e+15,10.1462,91.1713,848,12,13,832,824,805,713,736
49657,40,44,0,49657,49657,0,2.06161e+13,36.2348,990.369,49657,41,37,49611,49590,49537,49525,49608
24807,1,2,0,24807,24807,0,9.82089e+15,1.99948,208.401,24807,2,2,21425,21425,21425,21425,21425
7339,1,2,7339,0,7339,0,3.17182e+13,1.99864,114.392,7339,2,2,6511,6511,6511,6511,6511
7093,35,56,0,7093,7093,0,2.17639e+13,19.087,384.949,7093,29,32,7037,7027,7037,7036,6564
21135,1,62,20560,575,21091,44,3.99861e+15,25.8134,754.063,21135,31,37,8324,8324,8324,8324,8324
22462,1,2,22462,0,22462,0,3.44106e+13,1.9996,198.544,22462,2,2,19715,19715,19715,19715,19715
49835,15,44,49835,0,0,49835,282559000,36.9899,1106.96,49835,40,39,46518,37698,43937,43725,19689
39653,3,23,0,39653,10001,29652,4311.71,20.3844,745.942,39653,23,21,29029,28984,28797,28425,22649
38695,18,40,0,38695,0,38695,1330460,32.1544,799.022,38695,32,31,38545,38367,37977,37934,32424
34372,13,38,0,34372,34372,0,2.21554e+13,32.0705,796.232,34372,34,33,33335,30617,29501,30000,22280
7826,31,36,7826,0,7826,0,1.26555e+18,25.9838,383.315,7826,33,29,7785,7709,7730,6998,7246
30047,28,44,0,30047,0,30047,1083430,32.7976,868.651,30047,38,37,29917,29677,29468,29491,25059
13352,36,38,0,13352,13352,0,2.22673e+13,21.6383,481.723,13352,29,29,13314,13300,13313,13313,13314
47933,19,40,0,47933,0,47933,1326290,25.7819,843.993,47933,33,29,47828,47636,47690,47684,38709
35017,1,40,35017,0,35017,0,87210300000,22.5332,716.821,35017,32,29,3851,3851,3851,3851,3851
3655,28,36,3655,0,3655,0,1.42798e+18,14.5237,220.225,3655,24,25,3619,3609,3618,3031,3617
40483,26,40,40483,0,40483,0,1.44554e+18,29.0154,780.628,40483,38,37,40397,40298,40335,16297,32154
14372,20,56,14372,0,14372,0,1.43848e+18,21.6307,555.695,14372,35,39,14265,14119,14186,11941,13157
33041,28,44,0,33041,33041,0,2.15576e+13,25.2471,757.836,33041,36,37,32955,32837,32793,32537,27976
20185,1,2,0,20185,20185,0,8.84611e+15,1.99876,187.005,20185,2,2,17706,17706,17706,17706,17706
36958,23,40,36958,0,0,36958,5.64504e+15,29.5462,750.715,36958,38,37,36856,36729,36777,9349,28463
20228,14,40,0,20228,20228,0,2.16076e+13,33.1114,574.629,20228,37,36,19925,19573,19458,19141,11697
39509,1,2,39509,0,39509,0,6.44751e+13,1.9996,276.611,39509,2,2,30458,30458,30458,30458,30458
46766,43,48,46766,0,46766,0,7.5221e+10,37.3732,1103.55,46766,38,41,46718,46697,46318,46380,45733
19366,38,40,19366,0,0,19366,5.68636e+15,21.6092,524.391,19366,28,29,19326,19311,19326,18166,19326
2984,5,17,440,2544,0,2984,19.0201,10.5268,148.641,2984,17,16,2863,2863,2763,2768,2779
48061,4,28,0,48061,7957,40104,5144.99,18.9794,691.732,48061,28,25,43291,43291,39425,37929,35927
19050,343,1460,19017,33,19050,0,4.11285e+18,412.951,3680.69,19050,206,172,17143,15899,7708,5994,3504
14252,2,22,14252,0,0,14252,341849000,20.1173,464.207,14252,22,22,7587,7587,4929,2112,2011
13327,1,24,13327,0,13327,0,1.47054e+18,21.2439,441.177,13327,22,22,1362,1362,1362,1362,1362
29031,4,40,29031,0,0,29031,5.72669e+15,22.9203,684.477,29031,31,29,20583,15556,15035,3065,7485
9694,12,38,9694,0,9694,0,1.46422e+18,20.8898,412.215,9694,29,28,9339,8662,7957,2667,5925
7832,44,65,0,7832,0,7832,2.35523e+15,34.2718,528.812,7832,36,53,7767,7767,7760,7767,7308
40139,6,44,40139,0,0,40139,313975000,38.7246,922.099,40139,40,40,34189,30935,26905,28945,12262
35039,15,60,35039,0,35039,0,79670500000,32.3692,939.934,35039,40,44,33847,31207,32690,31693,16421
40335,9,56,40335,0,0,40335,333960000,29.6358,962.459,40335,38,51,37127,30685,30239,29929,15735
28072,18,24,0,28072,28072,0,2.2376e+13,21.3192,618.269,28072,24,22,28018,27938,27755,27739,24928
20318,25,40,20318,0,0,20318,5.53773e+15,32.9251,576.432,20318,37,36,20218,20092,20119,9240,15909
1234,18,32,1234,0,0,1234,300413000,12.5211,146.923,1234,21,26,1188,1153,1173,1062,1005
26739,38,44,26739,0,26739,0,1.37019e+18,38.5781,728.457,26739,36,37,26693,26654,26564,24149,25310
25140,15,24,25140,0,0,25140,340376000,20.8783,578.599,25140,23,22,24994,24706,24186,24179,20457
32864,34,56,32864,0,32864,0,1.4415e+18,29.6763,762.495,32864,45,40,32796,32732,32766,9415,25382
39497,2,23,7568,31929,0,39497,18.5057,19.4364,686.285,39497,22,21,27048,27048,27006,22764,9236
2259,19,22,2259,0,0,2259,342139000,16.4161,184.827,2259,18,19,2237,2227,2236,2234,2236
36330,1,2,0,36330,36330,0,8.39978e+15,1.99959,251.69,36330,2,2,32094,32094,32094,32094,32094
34527,16,23,6599,27928,0,34527,18.677,19.5928,649.801,34527,21,22,34460,34455,34319,34322,33608
45844,21,56,45844,0,0,45844,5.67177e+15,35.0601,889.115,45844,40,39,45717,45513,45634,12136,40640
31065,20,40,0,31065,0,31065,1329380,22.8291,674.049,31065,32,29,31006,30937,30921,30919,26351
37395,3,48,37395,0,0,37395,287151000,33.1698,1004.92,37395,37,41,22731,19558,18612,15316,5528
13510,11,21,3053,10457,0,13510,17.5568,19.3123,423.227,13510,20,20,13329,13329,13258,13284,11034
1101,20,40,0,1101,1101,0,2.06401e+13,15.0445,186.28,1101,21,35,1054,986,998,992,700
43194,1,44,43194,0,43194,0,83981500000,38.1685,872.211,43194,38,38,5225,5225,5225,5225,5225
16614,3,40,16614,0,0,16614,5.12463e+15,34.6971,569.449,16614,33,34,11297,9800,9231,2451,3470
38629,19,48,38629,0,38629,0,77093100000,32.437,992.275,38629,37,41,37975,36224,36780,35637,22833
14275,3908,5201,14275,0,7778,6497,3.04803e+18,179.55,6427.83,14275,1827,160,9074,9064,8522,8859,3716
27367,1,2,27367,0,27367,0,3.26452e+13,1.99942,218.662,27367,2,2,24192,24192,24192,24192,24192
14966,22,28,0,14966,2866,12100,5033.17,16.7379,465.261,14966,19,28,14938,14938,14938,14938,14867
7830,1,2,0,7830,7830,0,9.62608e+15,1.99617,116.425,7830,2,2,6783,6783,6783,6783,6783
21760,11,28,3716,18044,0,21760,20.2075,12.1924,470.169,21760,20,21,21700,21700,21696,21699,21636
1031,4,16,1031,0,1031,0,1.44786e+18,11.7662,99.2825,1031,12,13,787,609,584,200,364
19536,15,40,19536,0,0,19536,249851000,33.8826,711.796,19536,35,34,17339,10776,15465,15266,9897
46366,1,4,0,46366,46366,0,8.41703e+15,2.00004,289.543,46366,3,3,40947,40947,40947,40947,40947
46027,2,40,0,46027,46027,0,2.00211e+13,33.1092,1003.25,46027,40,37,26132,25948,20459,20673,6949
18928,14,44,18928,0,0,18928,5.18599e+15,34.5659,678.224,18928,33,41,18061,16374,17267,3733,11046
22954,1,2,22954,0,22954,0,3.28882e+13,1.99861,199.391,22954,2,2,20271,20271,20271,20271,20271
802,21,36,802,0,0,802,320148000,11.9239,122.3,802,17,25,766,756,761,761,764
27853,8,48,27853,0,27853,0,1.15932e+18,37.8674,876.698,27853,37,40,21802,17741,18442,5123,4673
45101,24,44,45101,0,0,45101,5.2168e+15,41.6228,986.826,45101,41,40,44773,44224,44171,13297,27086
13016,28,40,13016,0,13016,0,80309600000,28.599,488.31,13016,33,34,12946,12851,12831,12712,10970
40147,20,40,0,40147,0,40147,1331520,22.8951,783.848,40147,32,28,40071,39935,39953,39938,36280
32631,1,40,32631,0,32631,0,1.19133e+18,35.7578,894.322,32631,37,37,3002,3002,3002,3002,3002
37657,1,2,0,37657,37657,0,8.66444e+15,1.99963,255.645,37657,2,2,33128,33128,33128,33128,33128
48035,2,20,8240,39795,0,48035,20.3258,15.7516,669.231,48035,20,20,31568,31568,30998,17996,11053
6147,13,22,6147,0,0,6147,5.74453e+15,15.9357,287.043,6147,19,19,6048,5728,5728,5068,5295
28186,1,2,0,28186,28186,0,8.35465e+15,1.99922,221.695,28186,2,2,24917,24917,24917,24917,24917
10819,7,36,10819,0,0,10819,336816000,18.0787,368.885,10819,27,25,9892,8849,8043,8463,5185
7833,34,40,7833,0,0,7833,5.67277e+15,18.1029,345.831,7833,21,29,7793,7784,7793,7557,7793
8001,5,24,8001,0,8001,0,87509800000,20.4676,335.166,8001,20,20,6322,4686,4690,5559,2195
16359,30,40,16359,0,0,16359,5.32991e+15,30.5989,540.609,16359,34,35,16295,16164,16178,8006,13975
21183,1,2,21183,0,21183,0,3.96507e+13,1.99901,192.413,21183,2,2,18198,18198,18198,18198,18198
21907,34,40,21907,0,21907,0,1.41956e+18,31.6249,592.847,21907,37,36,21861,21801,21804,19589,21242
41464,11,60,0,41464,41464,0,2.20724e+13,36.4757,932.731,41464,40,44,39783,37489,34858,34617,23262
47150,18,28,0,47150,7859,39291,5149.38,15.3605,687.387,47150,20,27,47111,47110,47087,47087,46936
21892,10,40,0,21892,21892,0,1.77364e+13,34.3106,739.999,21892,36,37,18353,15121,16325,15339,7567
40716,24,60,40716,0,0,40716,5.4948e+15,33.5479,903.41,40716,37,44,40514,40253,40283,12460,27081
1369,14,18,0,1369,1369,0,2.25878e+13,13.2169,127.975,1369,14,15,1349,1341,1333,1334,1348
34962,41,60,0,34962,34962,0,2.16529e+13,26.9533,861.502,34962,33,40,34902,34891,34809,34861,30597
46838,7,23,0,46838,7781,39057,5033.71,16.7683,683.843,46838,21,21,45891,45891,45018,45095,44458
6825,1,12,0,6825,1192,5633,5234.33,10.7199,240.533,6825,12,12,1084,1084,1084,1084,1084
35592,8,40,35592,0,35592,0,1.24682e+18,36.2137,895.229,35592,39,37,30536,26566,26813,6033,11683
9454,7,36,0,9454,9454,0,2.19605e+13,18.1135,343.617,9454,26,25,8678,7797,7119,7585,4065
8157,1,2,8157,0,8157,0,3.74058e+13,1.99951,118.933,8157,2,2,7072,7072,7072,7072,7072
26971,4,40,0,26971,0,26971,1307560,29.0545,634.025,26971,36,37,20237,15695,15250,15385,6622
918,1,2,918,0,918,0,3.18882e+13,1.97277,40.3476,918,2,2,813,813,813,813,813
27930,38,44,27930,0,0,27930,5.43064e+15,37.0525,724.033,27930,37,37,27884,27845,27732,23182,24401
12230,19,23,0,12230,4012,8218,3954.08,16.8706,437.245,12230,20,21,12205,12205,12100,12100,11205
2382,1,2,2382,0,2382,0,7.64544e+13,1.98992,68.5573,2382,2,2,1734,1734,1734,1734,1734
36544,1,5,6,36538,36544,0,1.56206e+16,1.99995,269.786,36544,4,3,28618,28618,28618,28618,28618
12232,19,40,0,12232,0,12232,1219680,29.4475,477.241,12232,33,34,12026,11707,11903,11875,8388
2110,9,19,396,1714,0,2110,18.6654,8.91754,153.997,2110,15,18,2060,2060,2049,2059,1924
10775,1,2,0,10775,10775,0,1.16362e+16,1.99898,138.73,10775,2,2,9034,9034,9034,9034,9034
40049,13,40,0,40049,0,40049,1326190,26.4882,759.332,40049,32,29,39477,37596,36455,36901,24542
27877,1,2,27877,0,27877,0,3.42289e+13,1.99978,220.849,27877,2,2,24486,24486,24486,24486,24486
25606,27,38,0,25606,25606,0,2.20684e+13,30.0541,698.933,25606,34,32,25524,25414,25472,25476,25524
42389,21,40,42389,0,0,42389,5.70148e+15,26.3052,781.7,42389,33,29,42320,42226,42268,6298,40484
18340,29,36,18340,0,0,18340,5.48321e+15,27.3665,523.108,18340,36,33,18277,18161,18222,15226,15678
15449,3,64,0,15449,0,15449,1091570,29.3658,757.934,15449,32,44,8269,6995,6537,4656,1598
12718,1,2,0,12718,12718,0,9.43922e+15,1.9989,148.224,12718,2,2,11051,11051,11051,11051,11051
46822,28,44,0,46822,46822,0,1.79662e+13,36.0031,1086.59,46822,39,39,46626,46232,45874,44906,38779
1542,15,19,0,1542,251,1291,5006.44,7.28534,119.289,1542,15,18,1523,1523,1520,1520,1516
37685,19,64,37685,0,0,37685,3.05e+08,27.5903,1081.44,37685,35,44,37081,35361,35881,31821,24408
3285,6,20,0,3285,0,3285,1332740,15.7224,196.315,3285,15,17,2867,2609,1968,2248,1669
4646,7,24,4646,0,4646,0,86357900000,17.539,251.117,4646,17,21,4206,3733,3123,3602,1822
48528,6413,11916,47884,644,0,48528,1.12287e+18,271.513,15229.3,48528,3152,264,36612,36359,31682,30051,6548
17969,19,20,3112,14857,0,17969,20.2604,12.4435,418.756,17969,20,15,17948,17948,17948,17948,17948
29840,26,40,29840,0,29840,0,1.44093e+18,30.1033,674.75,29840,37,37,29756,29660,29692,11023,23516
8258,10,13,0,8258,1355,6903,5188.45,10.1486,258.995,8258,11,12,8240,8240,8217,8216,8232
27933,1,2,27933,0,27933,0,3.28302e+13,1.99936,220.948,27933,2,2,24674,24674,24674,24674,24674
45603,30,40,45603,0,45603,0,1.46222e+18,33.0824,893.592,45603,33,33,45538,45451,45494,38212,43760
44241,2,23,0,44241,8841,35400,4675.97,19.2736,742.496,44241,22,22,30046,30046,29997,25592,10728
28032,6,44,28032,0,0,28032,5.128e+15,34.8451,797.825,28032,38,41,23447,21053,18860,4879,6259
18570,29,40,18570,0,18570,0,7.0926e+10,34.6111,669.91,18570,37,37,18483,18310,18192,17970,16152
3860,26,32,0,3860,3860,0,2.11665e+13,17.9712,217.889,3860,24,21,3822,3790,3817,3806,3392
15044,27,40,15044,0,15044,0,87274300000,21.6311,503.236,15044,27,28,15004,14986,14995,14993,14283
5043,14,24,0,5043,0,5043,1335520,16.9709,263.839,5043,18,21,4987,4935,4445,4762,4335
8533,5,24,8533,0,0,8533,342151000,20.0214,347.117,8533,20,21,6716,4974,4980,4449,3119
15844,39,56,15844,0,15844,0,1.45682e+18,23.7581,563.493,15844,25,36,15788,15782,15785,15760,15645
16383,24,28,0,16383,3083,13300,4988.74,16.7352,500.234,16383,19,28,16355,16355,16355,16355,16269
39703,11,40,0,39703,0,39703,1331070,32.3072,808.316,39703,32,31,38175,36102,33253,32968,20126
4128,16,36,0,4128,0,4128,1295990,18.7609,238.036,4128,24,25,4087,4061,4054,4052,3495
9247,12,44,9247,0,9247,0,1.35933e+18,22.6379,457.897,9247,29,37,8759,8082,8090,5189,5910
25201,34,40,0,25201,0,25201,998750,34.9877,811.692,25201,38,34,25150,25078,24815,24815,23314
23252,2,4,0,23252,23252,0,8.22471e+15,3.48327,223.268,23252,4,4,23202,23186,23198,23199,21137
21320,48,60,0,21320,0,21320,1265360,26.7112,713.724,21320,33,40,21260,21250,21256,21258,19572
40624,30,40,0,40624,0,40624,1332150,23.1108,791.95,40624,32,28,40584,40566,40576,40577,40584
16340,1,2,16340,0,16340,0,3.30053e+13,1.99908,168.291,16340,2,2,14423,14423,14423,14423,14423
19307,20,40,19307,0,19307,0,85391300000,23.8738,546.708,19307,33,37,19211,19129,19145,19000,15910
35946,32,38,0,35946,35946,0,2.16655e+13,37.2672,903.233,35946,38,38,35806,35356,35478,35506,32219
49698,21,64,49698,0,49698,0,1.26586e+18,37.1692,1330.91,49698,52,46,48895,46619,47525,13680,23730
4203,4,11,656,3547,0,4203,20.2398,8.95598,169.012,4203,11,10,3853,3853,3507,3480,2251
23536,1,2,23536,0,23536,0,3.87243e+13,1.99911,203.133,23536,2,2,20297,20297,20297,20297,20297
44423,1,2,44423,0,44423,0,3.63891e+13,1.99953,281.915,44423,2,2,38679,38679,38679,38679,38679
7539,16,24,0,7539,0,7539,1334780,20.1547,328.146,7539,20,21,7482,7357,7203,7200,6695
3678,1,2,0,3678,3678,0,8.22844e+15,1.99511,79.4912,3678,2,2,3257,3257,3257,3257,3257
18340,36,40,0,18340,18340,0,2.22236e+13,21.9203,513.328,18340,28,29,18300,18285,18300,18292,18300
5557,1,2,0,5557,5557,0,8.32481e+15,1.99802,99.1619,5557,2,2,4914,4914,4914,4914,4914
38376,5,44,38376,0,38376,0,1.37225e+18,37.0959,846.269,38376,38,37,31214,24221,25748,5243,9527
42672,10,60,42672,0,0,42672,5.32019e+15,31.0655,1025.25,42672,39,44,39711,37104,34726,10114,16384
49379,24,44,49379,0,0,49379,5.29879e+15,35.0121,997.377,49379,39,41,49067,48554,48567,15593,34086
4628,8,13,0,4628,782,3846,5209.61,9.44425,196.341,4628,11,12,4586,4586,4531,4530,4556
22552,10,60,22552,0,22552,0,83503500000,26.4283,730.544,22552,32,40,21160,19995,18166,17841,10808
20490,1,2,0,20490,20490,0,1.75695e+16,1.99907,200.687,20490,2,2,15493,15493,15493,15493,15493
8110,1,2,8110,0,8110,0,4.54664e+13,1.99815,120.119,8110,2,2,6799,6799,6799,6799,6799
16104,39,40,0,16104,0,16104,1170260,30.0616,564.848,16104,34,33,16064,16043,16044,16044,16064
49799,14,20,8376,41423,0,49799,20.3263,12.3248,663.268,49799,20,19,49773,49773,49773,49773,49773
9520,33,60,9520,0,9520,0,1.18907e+18,30.1711,560.641,9520,42,42,9454,9423,9308,4360,4238
24591,1,2,0,24591,24591,0,8.83468e+15,1.99976,206.239,24591,2,2,21575,21575,21575,21575,21575
43815,29,56,43815,0,43815,0,1.46327e+18,22.2868,840.008,43815,40,32,43759,43735,43741,16707,39794
16212,1,2,0,16212,16212,0,8.55606e+15,1.99944,167.438,16212,2,2,14286,14286,14286,14286,14286
42333,36,40,42333,0,0,42333,5.70684e+15,37.4797,846.994,42333,33,31,42285,42221,42279,42283,38847
24070,9,13,0,24070,4068,20002,5218.87,11.8195,446.857,24070,13,13,23969,23969,23752,23751,23871
26078,1,4,0,26078,26078,0,8.64039e+15,1.99977,219.674,26078,3,3,22948,22948,22948,22948,22948
20758,19,21,0,20758,4502,16256,4529.22,19.1535,513.622,20758,21,20,20731,20731,20623,20623,20155
23794,1,2,23794,0,23794,0,3.26262e+13,1.99899,203.625,23794,2,2,21035,21035,21035,21035,21035
27934,23,40,27934,0,27934,0,1.46035e+18,22.7433,636.165,27934,30,29,27890,27842,27872,6595,26263
38956,12,21,0,38956,6387,32569,5192.79,12.059,570.025,38956,21,20,38921,38921,38906,38911,38915
38350,31,48,38350,0,0,38350,4.84771e+15,32.5788,1017.64,38350,37,41,38260,37996,37675,27071,27820
28828,18,28,0,28828,4746,24082,5188.24,12.5886,511.011,28828,21,20,28797,28797,28796,28797,20727
36934,54,56,36934,0,36934,0,1.46031e+18,22.7289,776.622,36934,40,32,36878,36866,36878,34079,36878
39798,13,23,6857,32941,0,39798,19.1697,18.8688,648.176,39798,21,21,39625,39625,39446,39474,38659
37749,55,64,0,37749,37749,0,2.00082e+13,27.5683,1082.33,37749,35,44,37685,37676,37681,37685,32871
27915,35,48,27915,0,0,27915,310809000,33.2858,838.389,27915,36,41,27864,27786,27759,27343,26526
24932,4,40,24932,0,0,24932,5.06077e+15,33.7841,729.9,24932,38,37,18116,14605,14655,3740,5530
5177,39,40,5177,0,0,5177,335194000,16.2851,289.314,5177,22,29,5137,5129,5137,5137,5137
40743,18,48,40743,0,40743,0,77468600000,37.1553,1012.89,40743,37,41,39914,38268,38638,37353,22593
49683,30,40,49683,0,0,49683,340304000,32.7114,926.749,49683,34,31,49617,49531,49587,49587,49613
45199,1,23,7480,37719,0,45199,19.5749,19.7582,675.827,45199,22,21,8885,8885,8885,8885,8885
46974,46,48,46974,0,0,46974,5.11415e+15,37.6747,1067.62,46974,40,41,46926,46909,46874,46897,46924
25253,5,56,0,25253,25253,0,2.16879e+13,35.6572,758.171,25253,37,48,20305,15410,15632,17553,5164
35413,1,56,35413,0,0,35413,5.63967e+15,27.4141,859.391,35413,38,42,3788,3788,3788,3788,3788
40286,20,60,0,40286,40286,0,2.06942e+13,30.5816,1002.4,40286,39,44,39833,39049,39286,38328,25649
2789,15,22,0,2789,2789,0,2.24838e+13,17.0143,203.397,2789,19,19,2745,2689,2649,2643,2202
35618,7,40,35618,0,0,35618,5.7169e+15,22.4198,722.562,35618,32,29,31662,27539,24156,5818,12931
43421,3,20,7610,35811,0,43421,20.337,14.6457,643.45,43421,20,19,33232,33232,32822,20466,17226
16580,1,2,16580,0,16580,0,4.25947e+13,1.99934,176.005,16580,2,2,14070,14070,14070,14070,14070
38661,15,21,0,38661,7274,31387,4771.99,17.0809,668.265,38661,21,20,38566,38566,38399,38402,37507
7136,1,2,0,7136,7136,0,8.32055e+15,1.99776,111.437,7136,2,2,6311,6311,6311,6311,6311
24246,20,40,24246,0,0,24246,4.11391e+15,34.1034,798.606,24246,36,34,23607,21394,21322,11504,15632
25988,31,40,0,25988,0,25988,1331840,21.9968,647.121,25988,29,29,25948,25932,25943,25944,24410
47058,22,49,47058,0,0,47058,4.8932e+15,37.6665,1161.95,47058,40,41,46408,44611,43477,24292,30025
10040,12,13,1647,8393,0,10040,20.3367,10.004,280.558,10040,11,12,10027,10027,10016,10016,10016
10363,21,40,10363,0,10363,0,1.44716e+18,18.7732,383.543,10363,28,29,10323,10303,10314,2143,9050
10858,13,36,10858,0,0,10858,5.65708e+15,18.1302,370.227,10858,27,25,10743,10395,10471,2837,7939
6460,18,20,6460,0,0,6460,5.66418e+15,16.7399,268.176,6460,18,19,6437,6416,6418,6019,6434
13045,48,56,13045,0,13045,0,1.41307e+18,25.0969,509.863,13045,41,39,12989,12979,12988,11000,12907
29014,6,40,0,29014,0,29014,1300240,30.4406,655.748,29014,35,37,25704,23584,19410,21370,7656
27191,3,4,0,27191,27191,0,8.40862e+15,1.99996,223.289,27191,3,3,27187,27185,27186,27186,27187
17887,1,2,0,17887,17887,0,1.35398e+16,1.99966,181.303,17887,2,2,14525,14525,14525,14525,14525
45884,1,4,0,45884,45884,0,9.22784e+15,1.99972,290.23,45884,3,3,40005,40005,40005,40005,40005
7365,22,36,7365,0,0,7365,310487000,29.327,356.687,7365,32,31,7257,7079,7167,3835,4914
28186,30,44,0,28186,0,28186,1093060,32.7868,838.512,28186,38,37,28097,27841,27715,27738,24391
11870,1,2,0,11870,11870,0,1.03078e+16,1.99941,146.435,11870,2,2,10171,10171,10171,10171,10171
29779,32,40,29779,0,0,29779,335666000,30.3479,792.737,29779,38,35,29699,29509,29581,29580,29412
21499,22,24,0,21499,21499,0,2.23329e+13,20.5122,529.739,21499,22,22,21472,21447,21449,21458,21469
40905,37,40,0,40905,0,40905,1330460,32.0557,820.167,40905,32,31,40862,40819,40858,40859,38523
30896,3,20,5314,25582,0,30896,20.3665,11.92,530.498,30896,20,18,23849,23849,23641,17048,13646
42580,4,40,42580,0,42580,0,8.7161e+10,22.169,785.625,42580,32,29,31066,23691,22897,26956,8406
48260,7,20,8686,39574,0,48260,20.1587,16.4449,736.595,48260,20,20,46797,46795,43622,43374,40053
45620,6,21,0,45620,7461,38159,5149.38,15.5819,644.405,45620,21,21,44426,44426,43190,43207,42758
49013,20,44,0,49013,0,49013,1201050,36.1543,1043.64,49013,41,41,48371,47232,47506,47514,29248
43741,1,2,43741,0,43741,0,3.46076e+13,1.99977,275.376,43741,2,2,38362,38362,38362,38362,38362
40039,5,23,6893,33146,0,40039,19.1733,19.0898,650.185,40039,21,21,37440,37440,34802,34856,34576
38045,22,48,38045,0,38045,0,1.31898e+18,37.3234,967.521,38045,37,41,37703,36996,37359,10930,26420
48756,38,44,48756,0,48756,0,78449700000,37.6777,1040.96,48756,41,41,48706,48637,48375,48488,47295
40197,3,40,40197,0,0,40197,340626000,32.2913,814.364,40197,32,31,25710,21666,19083,10110,7808
16332,28,60,16332,0,16332,0,1.25293e+18,34.4311,697.108,16332,44,43,16228,16113,15933,5566,7978
31721,1,2,31721,0,31721,0,3.38434e+13,1.99984,235.46,31721,2,2,27906,27906,27906,27906,27906
31882,32,40,31882,0,0,31882,5.64331e+15,30.5251,812.284,31882,38,35,31802,31610,31683,31733,30590
45719,64,76,45528,191,45717,2,6.24165e+14,7.83615,664.949,45719,34,34,45643,45643,45586,45583,45535
10907,21,36,0,10907,0,10907,1280410,24.4678,395.827,10907,32,33,10822,10740,10773,10770,8429
45930,21,30,0,45930,8307,37623,5070.73,18.8132,765.108,45930,28,23,45893,45893,45849,45849,45608
36453,20,40,0,36453,36453,0,2.18169e+13,35.6637,754.302,36453,38,37,36265,36086,36142,35821,25219
21697,10,44,0,21697,21697,0,1.80819e+13,30.2186,752.061,21697,36,37,18183,14942,16030,15380,7434
47913,1,2,47913,0,47913,0,3.27045e+13,1.99979,288.964,47913,2,2,42345,42345,42345,42345,42345
3366,9,10,0,3366,556,2810,5244.43,8.54843,152.967,3366,10,10,3353,3353,3352,3352,3353
47857,16,23,7877,39980,0,47857,19.5843,19.0276,687.415,47857,21,21,47781,47777,47691,47694,47468
6021,1538,1702,0,6021,2135,3886,1.20283e+15,152.688,2560.04,6021,318,159,4319,4319,4282,4286,3799
35051,38,64,35051,0,35051,0,1.42243e+18,34.6163,1057.72,35051,39,46,34987,34983,34979,34270,32419
6487,22,38,6487,0,6487,0,86593200000,21.066,345.848,6487,23,29,6449,6433,6429,6427,5048
29763,8,40,29763,0,29763,0,84663500000,32.4973,676.075,29763,37,37,27728,24568,23903,24733,10904
47058,27,60,47058,0,0,47058,5.54045e+15,32.7176,975.869,47058,37,44,46912,46608,46723,23644,36960
33633,24,30,6642,26991,0,33633,18.5061,17.374,693.73,33633,21,26,33603,33603,33603,33603,31631
47426,46,48,47426,0,47426,0,78329900000,37.9511,1056.03,47426,40,41,47378,47363,47364,47375,47376
41514,11,20,0,41514,7177,34337,5200.41,16.3253,628.672,41514,20,20,41437,41437,41427,41426,41385
18319,41,44,0,18319,18319,0,2.18366e+13,33.7477,552.58,18319,36,35,18275,18266,18274,18274,18273
35201,6,60,35201,0,0,35201,5.6011e+15,23.3758,857.009,35201,32,40,29883,26743,21755,5387,12826
15006,14,36,15006,0,0,15006,5.45551e+15,28.3351,475.553,15006,34,33,14754,14465,14569,2602,8736
35139,13,40,35139,0,0,35139,5.55561e+15,30.914,733.386,35139,37,37,34572,33321,33675,4684,14155
47425,29,44,47425,0,47425,0,82175800000,35.3553,924.819,47425,38,37,47291,46971,47004,46807,35582
43380,1,4,0,43380,43380,0,8.43496e+15,2.00016,280.389,43380,3,3,38299,38299,38299,38299,38299
41916,8,44,41916,0,0,41916,258166000,37.1173,1072.45,41916,40,37,30355,23007,24615,24484,9107
21636,1,4,0,21636,21636,0,8.33278e+15,2.93016,202.763,21636,4,4,19129,19129,19129,19129,19129
2430,12,32,2430,0,2430,0,1.40059e+18,14.0379,169.698,2430,22,21,2385,2357,2337,714,1960
40770,9,28,6772,33998,0,40770,20.2522,11.9698,613.808,40770,20,21,40579,40579,40282,40286,40240
2384,37,40,0,2384,2384,0,1.98189e+13,23.552,220.316,2384,27,30,2344,2338,2322,2317,2133
23056,42,56,23056,0,0,23056,335032000,25.6172,671.406,23056,32,40,23000,22989,22993,22932,20919
17298,24,44,17298,0,0,17298,321225000,26.5615,583.659,17298,33,37,17182,17023,16999,10893,13656
18503,23,40,0,18503,18503,0,2.09484e+13,29.6375,569.552,18503,34,35,18356,18063,18188,17822,13861
21471,19,23,0,21471,3687,17784,4923.6,15.3084,480.517,21471,20,21,21446,21446,21380,21380,21112
23356,1,2,23356,0,23356,0,4.6567e+13,1.99953,206.309,23356,2,2,19491,19491,19491,19491,19491
25813,16,40,25813,0,0,25813,5.7153e+15,22.395,647.568,25813,29,29,25598,25085,24325,20471,18044
40488,20,44,0,40488,40488,0,1.69039e+13,37.2569,1046.85,40488,40,37,39507,36597,36674,34880,24746
27030,1,2,27030,0,27030,0,3.40936e+13,1.99963,217.354,27030,2,2,23755,23755,23755,23755,23755
6963,15,38,0,6963,0,6963,1284030,30.1492,369.852,6963,30,30,6770,6537,6393,6150,4841
31396,3,20,0,31396,5567,25829,5187.97,17.5518,563.516,31396,20,19,23896,23896,23455,12258,11859
21752,4,40,21752,0,21752,0,86923700000,21.1398,553.497,21752,29,29,16038,12280,11871,13857,5619
28933,53,56,28933,0,0,28933,334294000,31.163,722.861,28933,37,40,28877,28865,28874,28860,28844
25906,15,65,25905,1,25905,1,3.29596e+12,36.1197,1001.85,25906,38,52,22551,12635,19515,10031,4750
23292,15,40,0,23292,23292,0,2.22372e+13,22.7887,578.763,23292,30,29,23134,22851,22470,22482,17046
4597,23,24,4597,0,4597,0,1.4656e+18,17.2036,254.719,4597,19,21,4573,4563,4572,4366,4573
10996,12,19,0,10996,3194,7802,3966,17.3159,381.103,10996,19,18,10839,10823,10715,10737,9562
38697,18,40,0,38697,0,38697,1330290,27.8244,810.242,38697,31,30,38529,38319,37869,37819,32841
18001,10,24,0,18001,18001,0,2.23658e+13,22.5883,505.164,18001,22,22,17257,16601,14478,14501,9017
7563,8,20,7563,0,0,7563,339821000,17.9031,297.311,7563,18,19,7036,6109,5884,6135,3361
28645,23,38,28645,0,0,28645,5.62211e+15,34.7138,774.649,28645,36,38,28473,28239,28268,27469,21471
33050,1,2,33050,0,33050,0,3.28572e+13,1.99958,240.035,33050,2,2,29191,29191,29191,29191,29191
28924,14,40,28924,0,28924,0,1.46121e+18,22.5276,645.678,28924,31,29,28674,28373,26195,5013,19734
42723,13,44,0,42723,42723,0,2.05966e+13,35.8608,941.15,42723,39,41,40997,38027,39681,38408,19601
6256,28,36,0,6256,6256,0,2.11888e+13,18.5715,306.472,6256,28,32,6212,6182,6179,6175,6148
21918,13,40,0,21918,0,21918,1333800,21.2019,598.823,21918,30,27,21426,19935,18938,18899,15132
23258,25,40,23258,0,23258,0,1.46384e+18,21.4345,613.54,23258,29,29,23218,23198,23202,16745,22485
4787,22,36,4787,0,0,4787,335096000,14.5024,250.528,4787,24,25,4751,4737,4745,4745,4749
33199,7,40,33199,0,0,33199,5.18655e+15,33.7184,820.646,33199,40,37,29083,25734,24646,5404,11484
12319,1,4,0,12319,12319,0,8.25922e+15,3.04375,155.025,12319,4,4,10902,10902,10902,10902,10902
13671,22,40,13671,0,13671,0,1.46424e+18,20.5284,481.459,13671,28,29,13630,13609,13609,7088,13225
23287,1,21,0,23287,3741,19546,5031.17,17.6672,464.935,23287,20,20,4578,4578,4578,4578,4578
25937,4,30,0,25937,4663,21274,4988.33,14.887,579.016,25937,20,26,22982,22982,21071,20087,18389
7459,1,12,1338,6121,0,7459,20.385,11.2109,258.375,7459,12,12,1150,1150,1150,1150,1150
10699,3,24,10699,0,10699,0,87744400000,18.5689,376.797,10699,20,21,6958,5871,5242,5819,2326
20370,7,44,20370,0,20370,0,82549400000,28.0032,620.023,20370,34,37,18217,16172,15136,15673,7253
3235,6,18,0,3235,0,3235,1346860,17.0791,202.308,3235,18,18,2737,2438,1921,1908,1140
773,1,14,773,0,0,773,338670000,11.4799,85.9136,773,11,12,95,95,95,95,95
2233,5,20,2233,0,0,2233,5.66379e+15,13.2983,161.03,2233,15,17,1836,1388,1458,699,958
23990,31,40,0,23990,0,23990,1251070,30.2895,641.259,23990,36,35,23925,23741,23817,23818,21552
23430,1,2,23430,0,23430,0,3.46227e+13,1.99898,201.738,23430,2,2,20547,20547,20547,20547,20547
18293,4,38,0,18293,0,18293,1302900,35.0415,602.219,18293,35,33,12571,9472,8969,5041,4033
25386,3,4,0,25386,25386,0,8.34512e+15,2.00004,216.239,25386,3,3,25382,25380,25381,25381,25382
45010,10,56,45010,0,45010,0,87153200000,23.0505,848.798,45010,31,32,43112,41423,36396,36211,22321
22295,5,40,22295,0,22295,0,1.43713e+18,30.198,560.239,22295,31,29,18352,13976,14512,2910,6010
29293,1,2,0,29293,29293,0,8.87283e+15,1.99945,225.08,29293,2,2,25685,25685,25685,25685,25685
4882,33,40,4882,0,4882,0,1.38075e+18,29.837,300.518,4882,25,33,4842,4823,4835,4839,4816
31163,4,40,0,31163,0,31163,1331620,29.4413,726.483,31163,31,30,21908,16534,16014,10947,7149
24601,10,56,24601,0,0,24601,338125000,23.1001,641.562,24601,30,32,23631,22780,20007,20368,11903
13373,7,13,0,13373,2295,11078,5232.41,11.1431,333.392,13373,13,12,13110,13110,12387,12654,12590
46945,47,48,0,46945,0,46945,3.92932e+14,35.8322,1143.89,46945,42,41,46897,46878,46897,46409,46363
31774,21,48,31770,4,31770,4,2.70199e+12,36.1392,950.05,31774,38,41,31158,28449,29220,26920,20041
18196,1,2,18196,0,18196,0,4.04052e+13,1.99868,179.183,18196,2,2,15583,15583,15583,15583,15583
46349,34,48,0,46349,0,46349,1192740,37.3114,1050.42,46349,40,41,46276,46129,45962,45966,42641
43075,2,44,43075,0,43075,0,66249100000,37.3168,1077.21,43075,40,37,20336,19906,17765,16319,3913
7250,31,36,7250,0,0,7250,274563000,30.0033,390.864,7250,32,29,7207,7116,7140,6582,7029
18021,24,40,0,18021,0,18021,1308170,31.4471,504.06,18021,30,29,17957,17906,17936,17930,16431
36838,1,44,0,36838,0,36838,1278320,34.5492,813.054,36838,37,38,4407,4407,4407,4407,4407
36465,35,56,36465,0,0,36465,5.69953e+15,22.2604,767.983,36465,32,32,36409,36393,36407,34981,35757
49402,55,56,49402,0,0,49402,5.66758e+15,28.6094,906.8,49402,40,36,49346,49338,49346,49346,47059
29882,1,2,29882,0,29882,0,3.4193e+13,1.9993,227.809,29882,2,2,26251,26251,26251,26251,26251
42712,30,60,42712,0,42712,0,1.43531e+18,37.0034,926.513,42712,39,40,42636,42546,42540,30603,41119
38089,10,65,38089,0,38089,0,1.3168e+18,27.1409,1148.07,38089,42,48,32637,27609,26348,8985,14856
18577,9,13,3139,15438,0,18577,20.4119,11.0961,388.328,18577,13,12,18501,18501,18371,18370,18366
8034,27,40,0,8034,8034,0,1.76623e+13,31.7309,453.826,8034,33,37,7960,7756,7749,7504,5209
25251,13,38,0,25251,25251,0,2.1796e+13,36.0895,753.589,25251,38,38,24125,21866,21147,21731,10542
10951,41,44,10951,0,10951,0,1.40659e+18,19.6059,510.061,10951,25,41,10907,10902,10892,10903,10702
15903,4,36,0,15903,0,15903,1307080,22.3504,471.827,15903,31,25,11980,9315,9108,9117,1958
17696,8,20,0,17696,3188,14508,5067.92,15.7114,476.805,17696,19,20,17310,17295,16522,16517,14195
14687,4,24,0,14687,14687,0,2.23696e+13,20.8303,446.028,14687,21,22,10703,8144,7851,9297,3911
37066,3,40,37066,0,0,37066,5.69687e+15,21.7369,718.842,37066,31,29,24647,20905,18784,4373,8086
25399,5,40,25399,0,25399,0,85708600000,32.4853,631.932,25399,36,37,20644,15651,16090,17993,8444
13059,7,22,13059,0,0,13059,5.73279e+15,20.6281,444.858,13059,22,22,11314,9605,8258,5267,4868
20978,7,21,3362,17616,0,20978,20.175,11.8514,416.204,20978,20,20,20680,20680,19902,20081,7813
39235,1,2,39235,0,39235,0,3.31371e+13,1.99962,260.877,39235,2,2,34615,34615,34615,34615,34615
15330,1,19,0,15330,2615,12715,4845.66,15.3795,385.684,15330,19,19,3362,3362,3362,3362,3362
11157,8,40,0,11157,0,11157,1163610,32.5803,477.931,11157,33,33,9862,8756,8786,8867,4578
16332,15,24,16332,0,16332,0,1.46897e+18,20.2261,474.682,16332,21,21,16212,16000,15658,13219,13080
4342,5,12,752,3590,0,4342,20.3409,11.3176,195.008,4342,12,12,4017,4017,3581,3534,2069
36796,11,44,36796,0,36796,0,1.14463e+18,33.6569,977.84,36796,38,37,30827,23970,27688,8396,12827
31249,35,40,31249,0,31249,0,86995100000,22.0785,660.154,31249,30,29,31209,31192,31209,31200,31209
7212,21,22,0,7212,7212,0,2.21866e+13,20.6317,342.905,7212,22,22,7184,7115,7181,7181,7066
49578,18,48,0,49578,0,49578,1162770,37.8715,1123.05,49578,37,41,48469,46204,46776,46725,26233
27722,10,24,27722,0,0,27722,341734000,22.0188,631.203,27722,24,22,26520,25450,22340,22767,13775
18549,10,40,18549,0,0,18549,5.58379e+15,33.1939,539.929,18549,32,37,17917,17346,16055,3620,10469
2108,1,22,0,2108,0,2108,1329500,20.176,183.778,2108,20,19,199,199,199,199,199
6784,33,36,6784,0,6784,0,80806700000,29.3262,327.976,6784,29,32,6747,6723,6724,6716,6747
29729,1,2,29729,0,29729,0,4.6043e+13,1.9995,231.292,29729,2,2,24865,24865,24865,24865,24865
32706,19,60,32706,0,0,32706,5.51559e+15,27.5782,837.485,32706,34,40,32428,31989,32224,15943,24918
10331,39,40,10331,0,0,10331,288241000,30.0257,490.336,10331,32,37,10291,10276,10271,10207,10164
35030,2,4,35030,0,35030,0,5.92761e+13,1.99986,261.525,35030,3,3,35025,35024,35024,35024,29335
18842,13,21,2975,15867,0,18842,20.0781,15.5468,393.035,18842,20,20,18801,18801,18796,18799,18795
2492,7,32,0,2492,0,2492,1269690,14.5241,171.805,2492,21,21,2323,2124,2060,2085,1484
45076,34,40,0,45076,0,45076,1318300,29.2693,836.199,45076,40,29,45022,44962,44980,44974,37753
10762,1,20,1852,8910,0,10762,20.346,11.6111,321.318,10762,17,19,1746,1746,1746,1746,1746
16127,10,21,0,16127,3671,12456,4455.39,18.0634,459.396,16127,20,20,15816,15797,15593,15647,13142
41529,17,28,0,41529,6854,34675,5132.5,15.6523,647.799,41529,21,27,41483,41483,41461,41461,41150
37398,16,20,6261,31137,0,37398,20.2957,12.1174,578.074,37398,20,17,37374,37374,37374,37374,37374
49442,4,23,8241,41201,0,49442,19.6826,18.9791,706.667,49442,22,21,44796,44796,41084,40535,40102
11553,1,2,0,11553,11553,0,1.32414e+16,1.99887,144.661,11553,2,2,9429,9429,9429,9429,9429
7677,1,2,7677,0,7677,0,4.70408e+13,1.99674,117.421,7677,2,2,6393,6393,6393,6393,6393
6591,1,2,6591,0,6591,0,6.93545e+13,1.99666,114.027,6591,2,2,4966,4966,4966,4966,4966
36163,1,2,36163,0,36163,0,6.15364e+13,1.9997,264.322,36163,2,2,28256,28256,28256,28256,28256
17416,43,60,0,17416,0,17416,1247800,27.0883,650.47,17416,33,40,17356,17346,17352,17288,14056
40643,20,21,6604,34039,0,40643,20.0851,15.7746,604.713,40643,21,21,40619,40618,40609,40609,40586
5636,1,2,0,5636,5636,0,8.3104e+15,1.99539,99.8287,5636,2,2,4985,4985,4985,4985,4985
2190,14,20,2190,0,2190,0,87083900000,13.1105,157.749,2190,15,17,2168,2158,2134,2142,2099
43480,4,21,7226,36254,0,43480,20.2807,12.1102,615.509,43480,21,20,39062,39062,35558,34236,25525
18127,6,24,0,18127,18127,0,2.23746e+13,20.7105,490.25,18127,21,22,15669,14151,10972,13590,7120
18461,6,36,18461,0,0,18461,5.50783e+15,26.8938,527.049,18461,36,33,16415,15118,12640,2638,5702
16492,7,38,16492,0,0,16492,5.69053e+15,21.6199,534.803,16492,30,29,14162,11930,10278,4856,6619
21701,2,44,21701,0,0,21701,5.48501e+15,31.5019,628.757,21701,36,37,12553,12519,9171,2741,3777
3926,3,40,3926,0,3926,0,76906800000,19.2132,298.755,3926,28,33,2540,2193,2067,1903,842
10603,16,36,10603,0,0,10603,333532000,23.058,368.822,10603,27,25,10536,10485,10473,10475,9615
4957,4,38,4957,0,0,4957,5.63109e+15,20.5905,307.442,4957,29,22,3426,2582,2477,817,1220
48330,21,44,0,48330,48330,0,1.74806e+13,38.375,1133.59,48330,39,39,47437,44277,45395,43238,29959
23848,27,40,0,23848,0,23848,1332630,22.6506,620.974,23848,31,26,23808,23788,23797,23798,23808
14534,1,40,0,14534,0,14534,1316820,31.4707,456.339,14534,28,29,1732,1732,1732,1732,1732
11958,1,40,11958,0,0,11958,337744000,18.3538,411.453,11958,25,29,1416,1416,1416,1416,1416
2458,1,2,2458,0,2458,0,3.24074e+13,1.9939,65.9363,2458,2,2,2174,2174,2174,2174,2174
13056,35,40,13056,0,0,13056,339204000,19.7122,474.891,13056,30,24,13016,13004,13016,13016,12799
39260,24,48,39260,0,39260,0,74131600000,32.6555,1025.93,39260,37,41,38958,38409,38342,37217,21808
34208,20,21,0,34208,6736,27472,4654.7,18.0726,632.147,34208,21,20,34184,34184,34076,34076,34146
36795,31,56,36795,0,36795,0,1.45196e+18,33.2968,895.031,36795,37,38,36684,36477,36603,29502,36080
5819,39,40,5819,0,5819,0,1.44353e+18,16.0533,302.59,5819,24,29,5779,5771,5779,5459,5779
4674,14,20,0,4674,4674,0,2.24137e+13,16.2349,234.566,4674,16,18,4642,4616,4514,4519,4359
49213,3,40,49213,0,0,49213,5.71058e+15,35.2038,909.985,49213,33,31,31374,26425,23209,5357,9024
30365,8,40,30365,0,0,30365,335376000,30.2481,678.924,30365,37,37,28162,24558,23834,24597,13509
46767,11,25,10621,36146,0,46767,17.7939,20.3367,818.874,46767,22,23,46290,46290,45993,46076,37854
43469,8,44,43469,0,43469,0,83746200000,36.9524,876.34,43469,38,37,40052,35236,34391,35206,16237
31737,6,24,0,31737,31737,0,2.23386e+13,21.6912,681.713,31737,24,22,27061,24211,19252,23393,11841
31917,43,44,31917,0,31917,0,1.19108e+18,37.3101,905.542,31917,38,39,31873,31853,31763,30554,30934
7822,25,36,0,7822,7822,0,2.06796e+13,28.0851,354.107,7822,32,32,7747,7640,7679,7622,7190
32188,10,40,0,32188,32188,0,2.18235e+13,29.3704,706.132,32188,37,37,31118,30124,27823,27610,11128
11244,5,40,0,11244,11244,0,1.88798e+13,33.2478,501.919,11244,34,33,8559,6780,7315,7019,2226
35696,14,44,35696,0,0,35696,5.24454e+15,34.6077,875.649,35696,37,41,34383,32028,33313,7648,18504
14916,10,56,0,14916,0,14916,1289450,24.9206,548.163,14916,33,40,14287,13751,12374,12571,5379
45717,1,2,45717,0,45717,0,3.45156e+13,1.99952,281.653,45717,2,2,40110,40110,40110,40110,40110
7314,20,22,0,7314,0,7314,1339140,19.5059,327.503,7314,20,20,7289,7264,7269,7268,7276
18111,15,60,18111,0,0,18111,335378000,23.1136,644.536,18111,31,40,17785,17134,16801,16799,13136
10478,1,40,10478,0,10478,0,1.34592e+18,26.758,437.337,10478,33,33,1282,1282,1282,1282,1282
47465,32,60,47465,0,47465,0,81565400000,38.1345,1077.38,47465,40,44,47361,47244,47093,47088,30923
7363,15,22,0,7363,7363,0,2.24657e+13,19.7539,332.97,7363,21,21,7260,7089,6932,6899,6316
33267,22,60,0,33267,0,33267,1286930,27.0022,844.464,33267,34,40,33082,32783,32899,32903,26353
22115,1,2,22115,0,22115,0,4.70419e+13,1.99955,198.86,22115,2,2,18418,18418,18418,18418,18418
11855,13,38,11855,0,11855,0,87126800000,21.1524,453.97,11855,27,28,11526,10625,10248,10397,7733
11902,7,40,11902,0,0,11902,339897000,21.239,455.172,11902,30,24,10325,8794,7621,6936,4311
31721,29,44,31721,0,31721,0,8.3733e+10,31.2024,740.228,31721,36,37,31636,31486,31487,31369,29999
21512,42,56,21512,0,0,21512,330054000,29.095,745.58,21512,38,49,21456,21448,21447,21395,20214
49779,12,474,875,48904,49326,453,1.57928e+16,26.2635,1882.3,49779,102,71,47528,46471,45163,45447,33796
18737,50,56,18737,0,18737,0,1.44992e+18,21.9999,558.073,18737,37,31,18681,18669,18681,15285,18681
1386,1,2,0,1386,1386,0,8.42232e+15,1.99134,49.1658,1386,2,2,1223,1223,1223,1223,1223
49035,39,44,49035,0,0,49035,5.29686e+15,37.5965,1024.82,49035,41,41,48984,48921,48710,43135,45394
6770,5,38,6770,0,6770,0,86437300000,21.0724,352.404,6770,29,26,5098,3754,3761,4440,2055
18190,6,25,5175,13015,0,18190,16.7059,15.2512,555.134,18190,20,23,15750,15750,15496,15551,11332
30357,3,56,0,30357,30357,0,2.22541e+13,23.1879,713.091,30357,31,32,19731,16685,14827,16255,6876
16413,29,40,16413,0,16413,0,86569300000,22.1672,476.77,16413,29,21,16373,16361,16369,16356,11783
16719,6,21,2620,14099,0,16719,20.0311,15.6597,370.699,16719,20,20,16365,16365,15962,15968,15999
25288,10,28,0,25288,4252,21036,5114.37,12.7629,524.327,25288,19,25,25164,25163,25095,25113,24913
20977,3,4,0,20977,20977,0,9.53234e+15,2.00024,198.391,20977,3,3,20973,20971,20972,20972,20973
28242,23,38,28242,0,28242,0,85870200000,36.5913,750.991,28242,38,34,28088,27912,27962,27969,26908
5260,1,11,810,4450,0,5260,20.1551,9.74373,188.951,5260,11,11,955,955,955,955,955
25854,38,44,25854,0,25854,0,68495600000,38.2849,830.148,25854,37,39,25808,25775,25466,25540,20981
28174,11,20,0,28174,5013,23161,5194.14,18.1535,548.682,28174,20,19,28089,28088,28072,28076,7810
38058,30,60,38058,0,0,38058,5.5459e+15,23.9435,949.926,38058,32,44,37988,37938,37901,36609,35072
22511,13,56,22511,0,0,22511,339181000,20.0716,622.386,22511,30,32,22069,20787,20354,20581,15015
28244,12,21,4550,23694,0,28244,19.9806,16.46,503.868,28244,20,21,28166,28165,28121,28143,27886
6756,16,24,6756,0,6756,0,1.46769e+18,18.4153,303.216,6756,19,21,6710,6622,6654,5779,6172
43178,28,33,11696,31482,1,43177,6518750000,18.2121,986.813,43178,21,32,43145,43145,43145,43145,39017
31399,16,40,31399,0,0,31399,5.57962e+15,30.2425,693.856,31399,37,37,31132,30745,30879,5389,17873
41070,18,40,41070,0,41070,0,8.6165e+10,28.5993,783.749,41070,38,37,40911,40718,40763,40574,30447
6567,11,24,6567,0,6567,0,87275400000,16.251,299.958,6567,19,21,6373,6099,5595,5628,4329
16524,1,2,0,16524,16524,0,8.97449e+15,1.998,169.315,16524,2,2,14465,14465,14465,14465,14465
25447,2,4,0,25447,25447,0,8.29963e+15,3.29611,221.091,25447,4,4,25436,25433,25436,25436,23539
31913,17,48,0,31913,0,31913,1089780,35.1609,944.032,31913,37,41,30462,22991,28609,28528,12402
38360,5,40,0,38360,0,38360,1299400,34.5487,768.883,38360,38,37,31478,24018,25055,25340,8659
22587,26,28,0,22587,3772,18815,5101.09,12.6867,497.276,22587,19,25,22559,22559,22559,22559,22496
14695,1,13,0,14695,2393,12302,5207.03,10.2706,334.906,14695,12,12,2512,2512,2512,2512,2512
12445,39,40,12445,0,0,12445,337782000,18.1891,418.128,12445,23,29,12405,12396,12405,12405,12405
49195,34,40,0,49195,0,49195,1333600,22.6158,864.234,49195,32,28,49155,49139,49151,49151,49155
28907,17,56,28907,0,0,28907,5.64547e+15,24.3044,733.405,28907,32,40,28685,28094,28348,18262,21394
22805,2,4,0,22805,22805,0,8.66713e+15,2.00026,205.561,22805,3,3,22800,22799,22800,22800,22614
45549,1,28,0,45549,7534,38015,5139.72,19.3791,675.933,45549,28,25,8008,8008,8008,8008,8008
26518,19,21,4284,22234,0,26518,19.9605,16.9571,491.371,26518,20,21,26493,26493,26473,26473,26427
9404,2,4,0,9404,9404,0,8.23712e+15,2.86251,136.417,9404,4,4,9396,9394,9396,9396,8867
23184,23,40,0,23184,0,23184,1328660,32.3255,633.888,23184,31,30,23128,23086,23099,23091,22237
1068,1,2,1068,0,1068,0,5.21836e+13,1.98876,46.0037,1068,2,2,869,869,869,869,869
35379,30,40,35379,0,35379,0,80035800000,31.6762,861.921,35379,40,37,35282,35035,35015,34764,27393
3108,1,17,451,2657,0,3108,19.1441,10.416,150.738,3108,17,16,685,685,685,685,685
22901,16,24,22901,0,0,22901,341349000,22.4372,580.044,22901,24,22,22740,22321,21731,21728,17436
45364,25,44,45364,0,0,45364,315726000,34.9792,964.167,45364,40,41,45114,44622,44621,21824,32701
30119,5,38,30119,0,0,30119,337855000,34.124,748.691,30119,34,32,22853,16827,16778,11459,7924
15136,5,13,0,15136,2490,12646,5204.63,11.6078,346.866,15136,13,13,14199,14199,12629,12591,12457
26860,30,44,26860,0,26860,0,83420900000,30.5055,691.073,26860,34,37,26794,26660,26658,26551,25257
33193,9,21,0,33193,7135,26058,4498.44,18.68,638.861,33193,21,20,32392,32392,32024,32203,12462
11381,10,23,2175,9206,0,11381,18.7263,15.7078,376.451,11381,19,21,11221,11215,11143,11178,10348
29918,22,40,29918,0,29918,0,8.5858e+10,30.4076,675.235,29918,37,37,29812,29702,29742,29586,23832
26678,28,44,26678,0,0,26678,322972000,33.0318,695.611,26678,37,37,26584,26435,26428,20600,21080
43871,29,60,43871,0,0,43871,328600000,32.7964,939.809,43871,37,44,43749,43553,43574,37013,30920
49611,5,20,0,49611,8428,41183,5209.44,12.4234,664.669,49611,20,19,46155,46155,41061,40672,33538
33417,1,2,33417,0,33417,0,3.30017e+13,1.99937,240.799,33417,2,2,29498,29498,29498,29498,29498
41768,53,56,41768,0,0,41768,335781000,32.7884,943.373,41768,38,44,41712,41700,41712,41712,41712
44698,26,28,0,44698,7485,37213,5158.35,18.7991,669.959,44698,28,23,44668,44668,44668,44668,44668
27512,1,2,27512,0,27512,0,3.28415e+13,1.99949,218.866,27512,2,2,24301,24301,24301,24301,24301
2497,13,16,2497,0,0,2497,5.63356e+15,13.5503,156.435,2497,16,14,2472,2425,2457,2117,2315
45212,21,60,0,45212,0,45212,1278080,36.9215,1072.12,45212,38,51,44793,44060,44364,44400,14713
7930,1,2,7930,0,7930,0,5.47332e+13,1.99849,120.294,7930,2,2,6387,6387,6387,6387,6387
18956,11,19,3377,15579,0,18956,20.3231,11.8158,428.491,18956,19,19,18911,18910,18911,18910,18889
22933,15,24,0,22933,22933,0,2.23997e+13,22.19,575.859,22933,24,22,22735,22374,21576,21578,17143
22381,38,40,22381,0,22381,0,1.46562e+18,22.2259,601.589,22381,24,29,22341,22333,22340,22309,22341
3183,7,12,0,3183,576,2607,5238.07,9.58498,166.23,3183,11,11,3088,3088,2905,2978,2878
38257,4,40,38257,0,38257,0,1.46031e+18,21.7827,731.175,38257,31,29,28139,21512,20777,4610,8216
43233,24,40,43233,0,43233,0,1.45827e+18,36.1661,931.645,43233,39,38,43058,42793,42894,19095,30813
4664,10,40,0,4664,4664,0,2.18875e+13,15.2965,272.424,4664,24,29,4494,4347,4034,4095,2797
27315,1,2,27315,0,27315,0,3.28001e+13,1.99912,218.595,27315,2,2,24131,24131,24131,24131,24131
4643,1,2,4643,0,4643,0,3.27367e+13,1.99785,89.9923,4643,2,2,4102,4102,4102,4102,4102
39901,19,21,0,39901,6455,33446,5140.86,15.4973,594.14,39901,21,21,39874,39874,39856,39856,39810
35071,48,56,35071,0,0,35071,5.66058e+15,23.3544,794.722,35071,36,40,35015,35004,35008,35015,34209
38562,1,4,0,38562,38562,0,9.29824e+15,1.99964,265.592,38562,3,3,33583,33583,33583,33583,33583
7495,3,24,7495,0,0,7495,342681000,20.3181,320.317,7495,20,19,4863,4103,3653,2063,1098
45693,22,28,7601,38092,0,45693,20.0961,19.3767,678.147,45693,28,25,45659,45659,45659,45659,45659
43766,17,40,43766,0,43766,0,84438300000,34.9737,841.148,43766,38,37,43369,42608,43125,42480,22045
11379,17,40,0,11379,0,11379,959052,33.2962,547.982,11379,34,33,10567,5574,9289,9222,7088
32376,2,40,32376,0,32376,0,86957400000,21.702,668.472,32376,30,29,18272,18265,12507,14905,3898
42632,2,60,0,42632,0,42632,1274370,24.4047,1011.78,42632,35,44,23338,23267,16498,8479,5135
2229,141,592,2208,21,2208,21,2.80875e+18,139.988,979.451,2229,160,88,1449,546,666,1078,542
1938,4,18,0,1938,0,1938,1350490,16.4267,158.663,1938,16,18,1367,1031,1001,733,698
31970,56,65,31969,1,31969,1,2.69108e+12,31.2831,1091.73,31970,37,48,31905,31897,31899,31905,26891
13256,1,4,0,13256,13256,0,8.25162e+15,3.58283,162.149,13256,4,4,11731,11731,11731,11731,11731
24527,5,44,24527,0,24527,0,1.39698e+18,27.1202,668.683,24527,35,37,19918,15301,16006,3919,6634
38534,3,40,0,38534,0,38534,1320550,27.4073,736.937,38534,32,29,25867,21992,19838,13778,9556
2712,8,11,422,2290,0,2712,20.1563,8.17625,136.739,2712,9,10,2696,2696,2677,2677,2690
30056,23,40,30056,0,0,30056,341010000,22.2267,687.451,30056,31,28,30014,29969,29991,29989,29552
20358,14,40,20358,0,0,20358,5.66075e+15,27.9989,529.788,20358,29,29,20208,20032,19678,3522,14775
12386,5,25,0,12386,2466,9920,4966.72,10.6743,424.21,12386,15,23,11153,11152,10116,10099,8695
41451,2,5,6,41445,41451,0,1.17497e+16,1.99976,279.403,41451,4,3,41445,41444,39813,41444,39805
13308,1,2,13308,0,13308,0,3.36086e+13,1.99947,151.387,13308,2,2,11718,11718,11718,11718,11718
49483,1,44,0,49483,0,49483,1266100,38.9166,955.676,49483,37,37,5927,5927,5927,5927,5927
29713,3,40,0,29713,0,29713,1189360,34.176,785.916,29713,38,37,19870,17195,16181,13683,4785
19196,3,4,0,19196,19196,0,1.3127e+16,2.07033,202.718,19196,4,4,19180,19158,19175,19175,19165
46916,19,60,46916,0,0,46916,5.5815e+15,25.7824,964.784,46916,33,40,46630,46162,46394,31441,37585
837,2,18,837,0,0,837,342680000,16.0884,109.365,837,15,18,431,431,277,115,86
34959,21,40,0,34959,34959,0,2.20195e+13,30.3423,732.325,34959,38,37,34843,34723,34748,34576,25857
34101,11,21,0,34101,5530,28571,5135.16,15.5111,551.726,34101,20,21,34010,34010,33972,33996,33890
45279,56,66,0,45279,45278,1,4.93975e+14,34.2114,1313.72,45279,38,60,45213,45207,45206,45213,41853
6090,19,40,6090,0,6090,0,1.30461e+18,22.4627,356.075,6090,29,33,5961,5739,5888,3941,4619
10024,13,20,0,10024,1759,8265,5175.88,10.7205,319.27,10024,19,17,9998,9998,9998,9998,9997
7642,3,12,1376,6266,0,7642,20.3523,11.2146,263.266,7642,12,12,5769,5769,5700,3341,3261
5638,7,12,0,5638,1014,4624,5220.8,11.2639,224.704,5638,12,12,5479,5479,5115,5265,4449
46738,3,54,0,46738,0,46738,3.94672e+14,40.0541,1193.77,46738,46,45,24586,20971,20385,7591,3597
14207,27,44,14207,0,14207,0,82697300000,22.0487,535.506,14207,31,37,14143,14018,14012,13835,12456
44134,38,44,44134,0,44134,0,1.40923e+18,37.4421,874.492,44134,38,38,44086,44030,43936,38965,43317
30980,4,21,0,30980,4908,26072,5156.79,14.3043,500.789,30980,21,20,28288,28288,25774,25378,25334
29281,6,30,5037,24244,0,29281,19.2963,19.2484,593.394,29281,21,27,28184,28184,27421,27472,26353
42795,50,56,42795,0,42795,0,8.685e+10,21.6154,820.606,42795,32,32,42739,42728,42739,42739,42739
34016,13,30,0,34016,5896,28120,5024.9,13.9743,639.307,34016,20,26,33908,33908,33799,33823,32859
38208,38,60,38208,0,0,38208,5.48537e+15,34.4501,883.034,38208,37,44,38146,38105,37985,32374,26055
4257,1,2,4257,0,4257,0,3.22668e+13,1.9946,86.8378,4257,2,2,3768,3768,3768,3768,3768
2209,12,17,562,1647,0,2209,15.8932,11.6768,160.201,2209,16,15,2169,2166,2153,2155,1924
12144,1,2,12144,0,12144,0,3.26811e+13,1.99909,145.673,12144,2,2,10733,10733,10733,10733,10733
37221,12,40,0,37221,37221,0,2.23741e+13,22.5238,758.226,37221,32,28,36253,34173,31529,32450,22291
17049,29,38,17049,0,0,17049,337406000,27.6395,557.929,17049,31,30,17002,16959,16987,16987,17002
23066,3,21,3929,19137,0,23066,19.331,14.9101,483.415,23066,20,19,18489,18488,18425,17534,14797
44193,19,23,7367,36826,0,44193,19.5834,19.8409,672.714,44193,22,21,44160,44160,44076,44076,43762
11546,25,36,11546,0,11546,0,82353600000,30.9858,423.656,11546,33,33,11456,11328,11381,11320,9538
36641,34,40,36641,0,36641,0,8.433e+10,30.8975,764.186,36641,37,37,36591,36485,36527,36511,34079
1788,15,16,0,1788,0,1788,1305440,14.0145,133.1,1788,14,14,1770,1752,1765,1765,1695
30737,34,40,30737,0,30737,0,1.46231e+18,22.4144,666.953,30737,31,29,30697,30681,30697,24922,30697
21685,38,40,21685,0,21685,0,1.42975e+18,30.925,573.266,21685,33,37,21645,21618,21623,20847,21645
45133,39,40,0,45133,45133,0,2.20941e+13,27.76,818.778,45133,38,37,45091,45049,45081,45082,45082
46417,5,56,46417,0,46417,0,86145900000,31.3049,982.163,46417,38,44,36018,26736,26441,31353,10228
20654,1,40,20654,0,0,20654,341445000,20.8258,581.04,20654,30,26,2085,2085,2085,2085,2085
46463,1,4,0,46463,46463,0,8.60107e+15,2.00004,289.847,46463,3,3,40914,40914,40914,40914,40914
47545,26,30,0,47545,8978,38567,4876.45,15.5033,804.23,47545,21,26,47515,47515,47515,47515,46201
23055,16,21,3863,19192,0,23055,19.145,16.2358,476.177,23055,20,19,23006,23002,22950,22952,22679
11802,1,2,11802,0,11802,0,3.27696e+13,1.99831,144.065,11802,2,2,10427,10427,10427,10427,10427
14742,28,44,0,14742,14742,0,2.14965e+13,32.195,535.628,14742,29,37,14690,14659,14615,14466,14148
29849,1,2,29849,0,29849,0,5.80697e+13,1.9993,236.001,29849,2,2,23690,23690,23690,23690,23690
36771,3,40,0,36771,36771,0,2.23142e+13,32.8602,781.905,36771,32,31,23515,19818,17444,19649,6405
39377,26,40,39377,0,39377,0,1.34294e+18,31.9387,890.474,39377,40,37,39182,38675,38795,14715,30053
46258,18,20,0,46258,7938,38320,5201.18,15.9645,658.355,46258,20,20,46232,46232,46232,46232,46232
7042,20,22,7042,0,7042,0,87699800000,16.358,306.109,7042,19,19,7020,7008,7018,7018,7020
45960,10,33,0,45960,12466,33494,1.56779e+12,18.1593,1015.16,45960,21,32,45117,45070,43976,38133,31254
17392,36,40,0,17392,17392,0,2.22411e+13,19.0522,499.442,17392,28,29,17352,17341,17352,17344,17352
46237,1,4,0,46237,46237,0,9.39428e+15,1.99989,289.228,46237,3,3,40206,40206,40206,40206,40206
44161,2,5,44161,0,44161,0,4.97988e+13,1.99984,289.664,44161,3,4,44155,44154,42523,44154,44155
23691,12,40,23691,0,23691,0,86736900000,20.9204,571.215,23691,29,29,23265,22352,20865,22055,14845
11573,18,19,1763,9810,0,11573,19.8044,12.8236,299.375,11573,19,18,11552,11551,11552,11552,11549
26737,4,13,4567,22170,0,26737,20.3653,11.9043,478.908,26737,13,13,23788,23788,21651,20593,18537
45186,1,2,45186,0,45186,0,3.36504e+13,1.99962,280.165,45186,2,2,39783,39783,39783,39783,39783
43290,32,38,0,43290,43290,0,2.14424e+13,35.4918,1039.21,43290,38,38,43120,42440,42183,42205,39797
2732,1,2,2732,0,2732,0,5.19266e+13,1.98939,69.858,2732,2,2,2227,2227,2227,2227,2227
18159,12,19,0,18159,3272,14887,5179.44,15.6678,431.706,18159,19,19,18119,18119,18119,18119,18089
25281,1,2,0,25281,25281,0,8.41399e+15,1.9996,209.66,25281,2,2,22328,22328,22328,22328,22328
3277,16,24,3277,0,3277,0,85962300000,18.2026,204.021,3277,17,17,3247,3233,3137,3202,1690
7414,1,4,0,7414,7414,0,8.26126e+15,1.99771,119.384,7414,3,3,6561,6561,6561,6561,6561
2048,1,2,0,2048,2048,0,8.40906e+15,1.99365,59.8119,2048,2,2,1808,1808,1808,1808,1808
24292,10,56,24292,0,0,24292,5.70041e+15,21.6928,645.993,24292,32,32,23186,22225,19553,9712,13694
15724,5,40,15724,0,15724,0,84943300000,32.0197,597.422,15724,38,34,11860,8754,8290,10259,3691
30798,15,40,0,30798,0,30798,1323520,26.956,656.916,30798,30,29,30611,30277,29979,29962,23392
25930,13,40,25930,0,25930,0,87467600000,20.5803,643.465,25930,30,27,25392,23714,22707,23224,18243
43747,42,64,43747,0,0,43747,5.57767e+15,31.8071,1134.82,43747,38,56,43683,43679,43665,43680,41739
17746,14,36,17746,0,17746,0,1.43373e+18,23.0679,514.436,17746,36,33,17550,17326,17159,3821,11503
26648,23,40,26648,0,0,26648,298346000,35.7909,754.033,26648,37,37,26352,25516,25942,13824,19300
6965,1,2,6965,0,6965,0,3.28152e+13,1.99914,110.168,6965,2,2,6152,6152,6152,6152,6152
8522,1,2,0,8522,8522,0,1.15164e+16,1.9966,123.814,8522,2,2,7159,7159,7159,7159,7159
31643,14,48,31643,0,31643,0,78449300000,37.1884,899.541,31643,36,41,29966,26477,28616,27571,16964
4400,1,2,4400,0,4400,0,3.25615e+13,1.99841,87.2423,4400,2,2,3890,3890,3890,3890,3890
43208,1186,2834,0,43208,0,43208,8.31509e+16,94.4172,5198.84,43208,709,212,40374,40336,39184,8623,9669
2866,6,15,0,2866,1087,1779,4052.05,12.6078,182.419,2866,15,14,2135,2135,2135,2135,1866
31628,50,56,0,31628,0,31628,1308600,30.1289,749.351,31628,37,40,31572,31560,31565,31571,31506
24309,21,30,0,24309,4301,20008,4952.64,14.8446,559.212,24309,20,26,24279,24279,24237,24237,23498
11967,26,40,11967,0,11967,0,84723600000,24.3714,447.416,11967,32,37,11901,11828,11844,11740,9875
21208,13,28,0,21208,3621,17587,5107.11,12.7225,489.619,21208,19,25,21146,21146,21110,21120,20910
40804,9,48,40804,0,40804,0,1.29832e+18,36.6124,1014.53,40804,37,41,35808,29957,31733,6163,10424
42245,14,60,42245,0,42245,0,1.4081e+18,38.6136,889.633,42245,46,37,41510,40515,40497,5401,16716
24734,8,38,24734,0,0,24734,5.65845e+15,35.0916,679.05,24734,33,32,21863,17716,16239,10785,9095
30661,15,40,0,30661,0,30661,1328410,21.9816,654.677,30661,30,29,30477,30137,29685,29670,22343
13339,27,49,0,13339,13335,4,1.62452e+15,32.4134,649.19,13339,36,41,13263,13148,13156,13036,8511
37586,1,2,37586,0,37586,0,3.25315e+13,1.99923,256.891,37586,2,2,33241,33241,33241,33241,33241
8228,21,24,0,8228,0,8228,1337900,16.9985,331.02,8228,19,21,8204,8192,8202,8201,8050
11738,1,2,11738,0,11738,0,3.26365e+13,1.99872,143.131,11738,2,2,10376,10376,10376,10376,10376
25240,9,13,0,25240,4185,21055,5206.21,11.9239,452.42,25240,13,13,25145,25145,24952,24951,25057
13203,4,19,3602,9601,0,13203,15.9436,16.4593,415.242,13203,19,18,10539,10539,10141,10190,4704
24300,10,21,0,24300,3934,20366,5102.13,17.4295,473.588,24300,20,21,24191,24190,24144,24165,23940
38187,20,56,0,38187,38187,0,2.22898e+13,21.9583,785.304,38187,32,32,38103,37971,37964,37942,32824
37461,7,28,6287,31174,0,37461,20.2171,20.1829,602.093,37461,28,21,36735,36735,34970,35530,24961
1410,16,22,0,1410,0,1410,1322990,16.1035,147.472,1410,17,19,1376,1330,1336,1333,1228
20355,5,13,0,20355,3285,17070,5191.49,11.3014,396.686,20355,13,13,19178,19178,17084,17048,17180
47220,18,32,0,47220,9388,37832,4964.08,19.1316,842.678,47220,28,24,47174,47174,47097,47097,44902
6042,1,19,1433,4609,0,6042,16.5124,14.0541,266.114,6042,17,17,1635,1635,1635,1635,1635
24718,3,4,0,24718,24718,0,8.09256e+15,3.89619,244.057,24718,4,4,24641,24516,24615,24615,23472
13879,7,24,13879,0,0,13879,5.74088e+15,21.5946,453.173,13879,23,22,12113,10356,8828,2311,4716
39045,38,56,0,39045,0,39045,1312260,29.5523,824.369,39045,38,40,38985,38944,38936,38941,30194
34854,1,2,34854,0,34854,0,3.80695e+13,1.99911,246.552,34854,2,2,30139,30139,30139,30139,30139
20347,2,40,0,20347,20347,0,2.07547e+13,31.5987,592.75,20347,35,35,12194,12139,9427,9602,2610
21886,12,30,4026,17860,0,21886,19.389,14.2809,544.172,21886,19,25,21766,21761,21672,21700,20801
4197,32,40,0,4197,4197,0,1.76215e+13,23.4413,348.17,4197,29,37,4157,4151,4097,4119,3389
6787,27,36,6787,0,6787,0,1.39002e+18,26.0383,307.162,6787,28,25,6738,6669,6723,5564,5275
2436,10,13,405,2031,0,2436,20.1773,9.86412,145.529,2436,11,12,2420,2420,2418,2417,2420
33221,16,44,33221,0,33221,0,80221700000,36.215,850.424,33221,37,41,32373,29877,31576,30697,18437
48016,4,23,9762,38254,0,48016,18.2242,19.9468,781.358,48016,22,22,41800,41800,39029,38882,21719
18787,10,21,0,18787,3034,15753,5081.85,17.5982,414.703,18787,20,20,18686,18685,18646,18668,18541
42503,1,2,42503,0,42503,0,3.26091e+13,1.99969,273.482,42503,2,2,37578,37578,37578,37578,37578
34439,12,60,34439,0,0,34439,5.42367e+15,25.7692,940.931,34439,34,44,32653,29757,28491,17149,15597
37288,54,60,37288,0,37288,0,80399600000,31.6749,976.581,37288,38,44,37228,37218,37222,37228,33440
9751,2,4,0,9751,9751,0,1.50603e+16,1.99887,140.303,9751,3,3,9746,9745,9746,9746,7832
18559,16,19,2921,15638,0,18559,19.7868,13.8349,395.332,18559,19,19,18525,18524,18508,18509,18484
19439,35,44,0,19439,19439,0,2.12334e+13,35.1861,612.641,19439,33,37,19392,19332,19304,19302,18546
14441,7,40,14441,0,0,14441,284296000,33.8925,588.639,14441,36,37,11701,9974,9982,10051,4465
9040,10,36,0,9040,9040,0,2.14225e+13,26.0566,367.849,9040,32,33,8745,8486,8024,8187,4761
28145,1,2,0,28145,28145,0,9.72374e+15,1.99936,221.839,28145,2,2,24346,24346,24346,24346,24346
23465,18,23,4658,18807,0,23465,18.7285,17.9694,551.623,23465,20,22,23434,23433,23348,23350,22742
25767,28,38,25767,0,25767,0,1.45458e+18,36.8344,757.127,25767,38,38,25627,25317,25482,20698,17436
27120,53,56,27120,0,27120,0,86672200000,23.0645,674.332,27120,30,32,27064,27052,27064,27064,27064
38401,43,64,38401,0,38401,0,81425500000,34.8041,1162.12,38401,38,56,38337,38331,38245,38263,33818
2635,1,2,0,2635,2635,0,1.36185e+16,1.99165,68.6809,2635,2,2,2136,2136,2136,2136,2136
11080,3,19,1762,9318,0,11080,20.1715,10.2912,294.136,11080,19,18,8860,8860,8845,8171,6623
34512,1,2,34512,0,34512,0,3.28436e+13,1.99971,245.426,34512,2,2,30484,30484,30484,30484,30484
11201,16,24,11201,0,11201,0,87370200000,21.772,395.558,11201,20,22,11131,10975,10759,10986,9757
37737,13,40,0,37737,0,37737,1314040,30.4937,765.393,37737,38,37,37147,35503,35104,35319,19003
5898,11,19,900,4998,0,5898,19.8942,9.72109,212.881,5898,18,18,5871,5871,5867,5871,5868
27304,1,2,27304,0,27304,0,5.25962e+13,1.99949,225.749,27304,2,2,22201,22201,22201,22201,22201
12457,1,2,12457,0,12457,0,3.31931e+13,1.9996,146.772,12457,2,2,10987,10987,10987,10987,10987
36083,48,56,36083,0,36083,0,85234200000,30.6529,922.902,36083,38,51,36027,36017,36018,36027,35945
15464,18,24,15464,0,15464,0,87561300000,21.3813,480.7,15464,23,22,15410,15348,15203,15185,13704
4773,1,2,0,4773,4773,0,8.40898e+15,1.99832,91.537,4773,2,2,4215,4215,4215,4215,4215
1651,10,16,0,1651,0,1651,1302300,13.7498,126.753,1651,14,14,1617,1587,1453,1452,1365
36640,4,40,36640,0,0,36640,340457000,33.0379,781.099,36640,32,31,26071,19742,19073,14263,8172
22024,8,13,0,22024,3677,18347,5216.76,11.7821,421.046,22024,13,13,21886,21886,21092,21091,21790
43259,59,64,0,43259,0,43259,1207430,27.6139,1138.72,43259,35,44,43195,43186,43191,43195,40420
27600,1,2,0,27600,27600,0,8.59731e+15,1.99949,218.563,27600,2,2,24306,24306,24306,24306,24306
9514,10,12,0,9514,1657,7857,5238.82,10.6789,281.583,9514,12,12,9496,9496,9478,9477,9496
42527,269,379,36094,6433,42508,19,2.04959e+16,6.07179,983.116,42527,128,65,42148,42141,42142,42144,42126
43644,48,56,43644,0,43644,0,1.46034e+18,23.0118,832.7,43644,37,32,43588,43575,43586,40710,43586
31081,20,40,31081,0,0,31081,340655000,22.5193,698.921,31081,32,24,31011,30889,30907,30904,29096
25015,58,60,25015,0,25015,0,79186100000,30.1578,846.408,25015,36,44,24955,24945,24953,24955,23941
20933,15,19,3854,17079,0,20933,19.9715,16.9496,483.075,20933,19,19,20872,20872,20870,20870,20870
35152,1,2,0,35152,35152,0,1.0973e+16,1.99966,249.65,35152,2,2,29798,29798,29798,29798,29798
28710,1,2,28710,0,28710,0,3.2824e+13,1.99951,223.263,28710,2,2,25361,25361,25361,25361,25361
36977,30,40,0,36977,0,36977,1118600,35.8255,929.239,36977,38,37,36863,36499,36416,36420,32477
42750,65,67,42750,0,0,42750,8.30016e+15,35.7116,1096.34,42750,53,37,42683,42683,42683,42682,42683
29436,15,23,0,29436,5015,24421,4951.32,19.0031,560.834,29436,21,21,29365,29365,29273,29275,28599
43746,24,56,43746,0,0,43746,5.71044e+15,22.1834,837.534,43746,32,32,43689,43662,43657,19239,39847
48532,34,56,48532,0,48532,0,87161300000,22.0754,884.294,48532,32,32,48476,48458,48474,48472,44376
11067,1,2,0,11067,11067,0,8.50341e+15,1.99901,138.486,11067,2,2,9760,9760,9760,9760,9760
45677,1,54,0,45677,0,45677,4.0384e+14,38.6102,1026.31,45677,40,43,5157,5157,5157,5157,5157
25329,10,23,0,25329,5004,20325,4774.7,17.8985,569.754,25329,20,22,25027,25011,24808,24866,22417
21368,7,40,21368,0,21368,0,84556700000,32.0301,587.246,21368,37,36,19369,17270,16004,16804,8133
1987,1,2,1987,0,1987,0,7.81954e+13,1.99446,62.6195,1987,2,2,1434,1434,1434,1434,1434
46089,35,44,0,46089,46089,0,2.13922e+13,31.1483,895.263,46089,37,37,46037,45902,45919,45909,43928
28082,46,60,28082,0,28082,0,82689400000,37.2741,768.891,28082,37,43,28022,28010,28018,28019,22320
39499,5,23,6580,32919,0,39499,19.5494,16.5483,627.463,39499,20,21,37123,37123,34060,34094,34301
22347,31,40,22347,0,22347,0,1.42414e+18,32.7653,582.395,22347,33,37,22288,22182,22239,18561,20289
41874,30,44,0,41874,0,41874,1284410,32.6805,857.351,41874,37,38,41780,41578,41609,41600,32319
37470,9,56,37470,0,0,37470,5.70131e+15,23.4194,781.117,37470,31,32,35063,29328,29151,9132,18970
37273,4,44,37273,0,37273,0,1.32906e+18,39.0116,921.301,37273,40,41,26818,21300,21168,5322,6444
13411,1,2,13411,0,13411,0,3.51345e+13,1.99821,152.733,13411,2,2,11736,11736,11736,11736,11736
14517,37,38,14517,0,14517,0,84911200000,33.5771,568.492,14517,38,35,14474,14349,14450,14451,13818
16386,23,36,16386,0,0,16386,5.57343e+15,23.5041,484.46,16386,35,33,16309,16216,16260,5783,12715
8656,14,40,8656,0,0,8656,330645000,18.7745,391.201,8656,29,36,8501,8330,8286,8290,6435
21587,7,56,21587,0,21587,0,85440900000,24.3358,646.812,21587,33,40,19193,16788,15049,16460,7879
6526,1,2,6526,0,6526,0,3.35562e+13,1.99877,105.914,6526,2,2,5747,5747,5747,5747,5747
48836,28,60,0,48836,48836,0,2.18819e+13,38.4744,1026.2,48836,41,44,48746,48680,48670,48535,42264
32113,18,24,32113,0,32113,0,1.46337e+18,21.0017,668.777,32113,24,22,32053,31963,31745,26997,28319
18959,17,28,0,18959,3512,15447,5011.71,15.9211,531.735,18959,19,28,18913,18913,18856,18856,18660
41713,48,60,0,41713,41713,0,2.05758e+13,35.7584,1140.32,41713,38,55,41653,41643,41646,41653,34889
10445,21,56,10445,0,10445,0,83285800000,28.3612,499.368,10445,33,43,10293,10071,10145,10054,2524
49688,34,64,49688,0,49688,0,1.34872e+18,38.1628,1192.4,49688,42,44,49613,49538,49372,33655,40772
31074,26,44,0,31074,0,31074,1078630,36.1478,894.61,31074,37,39,30873,30259,30399,30422,24287
29106,14,24,29106,0,29106,0,87439900000,21.4683,635.186,29106,24,22,28846,28528,25843,27702,22080
3520,1,2,3520,0,3520,0,6.90093e+13,1.99716,82.7247,3520,2,2,2656,2656,2656,2656,2656
18655,1,13,3141,15514,0,18655,20.4072,11.0292,388.484,18655,13,12,3075,3075,3075,3075,3075
22428,1,2,0,22428,22428,0,8.43049e+15,1.99933,197.182,22428,2,2,19803,19803,19803,19803,19803
21810,3,13,0,21810,3696,18114,5214.65,12.1165,427.75,21810,13,13,16949,16949,16864,11926,10210
42313,9,60,42313,0,0,42313,314171000,35.6151,1147.95,42313,38,55,37955,31679,31936,31350,12949
24856,1,4,0,24856,24856,0,8.25056e+15,3.78818,229.131,24856,4,4,21979,21979,21979,21979,21979
29525,35,44,29525,0,0,29525,324523000,35.9909,740.695,29525,37,37,29473,29382,29312,24452,25418
16619,12,36,16619,0,16619,0,1.42776e+18,23.3448,487.979,16619,35,33,16307,15786,15302,4106,9303
34616,18,21,0,34616,5526,29090,5111.24,18.2629,552.186,34616,21,21,34582,34581,34556,34558,34550
4306,3,32,0,4306,4306,0,1.97779e+13,24.6117,263.127,4306,29,28,3066,2687,2558,2100,950
40682,32,56,40682,0,40682,0,85310700000,33.8792,974.565,40682,38,52,40572,40333,40396,40387,36897
25680,11,24,0,25680,0,25680,1335590,21.7458,607.991,25680,24,22,24794,23535,21561,21697,13968
43440,19,40,0,43440,43440,0,2.23327e+13,22.5495,811.157,43440,32,28,43347,43170,43175,43104,39003
42733,17,23,0,42733,8192,34541,4746.44,19.0001,717.767,42733,22,22,42680,42680,42495,42498,42064
21750,26,44,21750,0,0,21750,271614000,33.3835,752.09,21750,35,37,21602,21157,21270,17068,16989
5125,6,12,898,4227,0,5125,20.5339,9.36273,205.522,5125,11,11,4945,4945,4788,4788,4667
31841,33,44,0,31841,0,31841,1080900,36.9678,905.776,31841,37,39,31777,31672,31436,31438,28808
3841,5,17,0,3841,582,3259,5074.15,8.15465,166.886,3841,17,16,3669,3669,3402,3402,3555
41965,1,2,0,41965,41965,0,8.63008e+15,1.99983,270.03,41965,2,2,36938,36938,36938,36938,36938
5613,6,38,5613,0,5613,0,86046300000,32.7417,333.875,5613,30,30,4549,3945,3236,3850,1443
29001,21,40,29001,0,29001,0,1.46715e+18,21.8804,674.851,29001,28,29,28946,28817,28918,21013,28037
3550,35,36,3550,0,3550,0,1.12231e+18,29.6946,287.941,3550,30,28,3514,3501,3513,3513,3514
24959,14,24,0,24959,24959,0,2.24212e+13,21.4192,592.765,24959,24,22,24711,24415,21845,23705,17020
49993,31,40,49993,0,0,49993,5.67236e+15,28.115,874.844,49993,40,37,49929,49842,49882,40931,44482
46985,59,60,46985,0,46985,0,85671200000,36.953,964.53,46985,40,40,46925,46906,46924,46925,46923
4967,9,32,4967,0,0,4967,4.10918e+15,26.8254,337.207,4967,27,27,3100,1686,2199,1357,1858
20055,1,4,0,20055,20055,0,8.73817e+15,3.07679,207.206,20055,4,4,17592,17592,17592,17592,17592
36599,2030,11420,12506,24093,2868,33731,3.47634e+12,294.966,14078.6,36599,3146,245,25179,24831,19107,19734,6384
5736,6,20,5736,0,0,5736,5.67052e+15,16.8138,253.195,5736,17,19,5107,4703,3686,1213,2378
43354,9,64,43354,0,0,43354,289415000,37.5128,1251.44,43354,37,53,36399,29262,30717,30185,11409
48067,57,60,0,48067,0,48067,1299560,25.5431,972.947,48067,35,40,48007,47996,48005,48007,46144
9935,38,40,9935,0,9935,0,83599500000,27.255,405.584,9935,32,36,9895,9885,9873,9868,9875
12823,26,40,12823,0,12823,0,86910900000,21.7113,454.175,12823,24,28,12783,12765,12772,12769,11832
35813,6,56,35813,0,35813,0,1.45091e+18,23.254,799.508,35813,44,40,30719,27615,22313,5441,9676
31791,3,4,0,31791,31791,0,8.39097e+15,1.99987,240.985,31791,3,3,31787,31785,31786,31786,31787
21249,31,40,21249,0,21249,0,1.45876e+18,21.1958,549.749,21249,29,29,21209,21191,21207,17308,21207
11398,29,40,11398,0,0,11398,5.66743e+15,18.6975,403.817,11398,24,29,11358,11343,11353,10456,11356
836,1,15,0,836,339,497,3628.1,11.6878,99.9298,836,13,14,190,190,190,190,190
45839,3,4,0,45839,45839,0,9.40825e+15,2.00009,287.924,45839,3,3,45835,45833,45834,45834,45835
30187,1,2,30187,0,30187,0,3.36797e+13,1.9993,229.983,30187,2,2,26574,26574,26574,26574,26574
24159,36,40,24159,0,0,24159,333069000,29.8498,599.602,24159,34,37,24117,24092,24079,23178,24114
41401,298,351,41401,0,41401,0,7.13423e+17,16.9792,1216.54,41401,55,58,41050,41047,41041,41042,41028
27023,7,40,0,27023,27023,0,2.19494e+13,29.2492,637.828,27023,36,37,24469,21724,19884,21183,10021
11198,21,44,0,11198,0,11198,1245310,21.5808,488.058,11198,32,37,11077,10894,10967,10982,8627
36413,16,20,0,36413,6405,30008,5207.4,14.6586,591.763,36413,20,19,36383,36383,36383,36383,36383
13892,1,2,0,13892,13892,0,1.71067e+16,1.99906,162.877,13892,2,2,10593,10593,10593,10593,10593
48532,1,31,13537,34995,6,48526,5799600000,18.5149,899.417,48532,27,24,10962,10962,10962,10962,10962
28011,19,23,0,28011,4698,23313,4967.63,17.3511,535.828,28011,20,21,27984,27984,27916,27918,27814
36928,12,44,36928,0,0,36928,327108000,34.4997,813.433,36928,37,38,35863,34249,33648,33654,19138
11748,15,33,4550,7198,1,11747,23958700000,17.4604,461.942,11748,19,27,11700,11700,11618,11612,2905
28485,1,2,0,28485,28485,0,1.06474e+16,1.99965,223.925,28485,2,2,24275,24275,24275,24275,24275
35735,1,2,35735,0,35735,0,3.2783e+13,1.99975,249.827,35735,2,2,31572,31572,31572,31572,31572
3847,21,32,3847,0,0,3847,4.1202e+15,27.6408,301.52,3847,32,29,3741,3460,3565,1988,2592
49877,23,40,0,49877,49877,0,2.19004e+13,33.2708,873.515,49877,39,37,49712,49468,49578,49311,32891
29951,18,24,0,29951,29951,0,2.23798e+13,21.526,652.867,29951,24,22,29881,29783,29566,29539,25676
43810,17,23,7280,36530,0,43810,19.5676,19.9254,668.304,43810,22,21,43757,43757,43668,43668,43161
44527,15,40,44527,0,44527,0,87047200000,21.9642,805.392,44527,32,29,44216,43619,42827,42749,31162
9651,1,2,0,9651,9651,0,9.46731e+15,1.99907,129.94,9651,2,2,8382,8382,8382,8382,8382
1157,1,16,1157,0,0,1157,332818000,10.3587,101.069,1157,12,13,163,163,163,163,163
19747,12,21,0,19747,3184,16563,5102.63,12.6204,422.148,19747,19,20,19686,19685,19644,19663,19560
39853,13,40,39853,0,0,39853,5.70849e+15,32.419,814.205,39853,32,31,38996,36423,34302,22961,23985
45365,26,56,45365,0,0,45365,5.6568e+15,28.3258,883.484,45365,37,40,45265,45161,45204,28218,39400
39862,42,60,39862,0,0,39862,333580000,38.438,901.81,39862,40,40,39802,39777,39738,39569,39538
6100,1,12,1104,4996,0,6100,20.2236,11.6669,238.971,6100,12,12,930,930,930,930,930
43078,1,2,43078,0,43078,0,3.27357e+13,1.99949,273.996,43078,2,2,38067,38067,38067,38067,38067
30516,12,28,5167,25349,0,30516,20.048,16.5076,571.37,30516,20,27,30431,30430,30389,30407,30178
45229,43,44,45229,0,45229,0,84156300000,35.644,881.115,45229,38,38,45185,45163,45145,45146,45183
8303,23,40,8303,0,0,8303,4.98607e+15,29.6059,436.908,8303,32,37,8203,7974,8131,5147,6014
18599,1,44,18599,0,18599,0,79494400000,34.8903,672.336,18599,33,41,1931,1931,1931,1931,1931
21364,1,40,0,21364,0,21364,1317710,27.6697,541.206,21364,29,29,2571,2571,2571,2571,2571
15194,34,36,15194,0,0,15194,5.45966e+15,28.3756,478.923,15194,34,33,15154,15100,15136,14078,15056
2327,17,24,2327,0,2327,0,1.43657e+18,15.1173,186.531,2327,17,21,2300,2265,2277,2033,2019
25428,71,96,237,25191,25416,12,4.81177e+15,2.89504,468.928,25428,28,22,25332,25332,25329,25327,25288
16438,1,2,16438,0,16438,0,3.25516e+13,1.99897,170.099,16438,2,2,14536,14536,14536,14536,14536
5430,7,24,0,5430,5430,0,2.2345e+13,15.9145,276.693,5430,18,21,4818,4187,3760,4108,2699
17667,12,24,0,17667,0,17667,1334180,21.6596,494.72,17667,21,22,17257,16359,15010,15505,10934
11467,4,21,0,11467,1839,9628,5152.68,10.4142,311.496,11467,19,16,10432,10432,9513,9349,3627
45579,4,40,45579,0,0,45579,340949000,30.917,864.664,45579,32,31,32376,24495,23689,17560,11200
14984,54,56,0,14984,0,14984,1320970,19.9228,528.025,14984,30,32,14928,14920,14928,14928,14928
10503,18,20,10503,0,10503,0,1.45682e+18,17.3444,353.178,10503,20,19,10479,10455,10461,9720,10128
44624,5,44,44624,0,0,44624,5.50423e+15,37.1718,877.654,44624,38,38,36436,27946,29260,5881,11542
29778,35,40,29778,0,0,29778,5.73057e+15,22.0913,686.369,29778,31,27,29738,29722,29735,29738,29738
7223,16,19,2456,4767,0,7223,14.7296,15.7813,316.384,7223,18,18,7197,7196,7158,7161,7167
11885,36,40,11885,0,11885,0,1.42034e+18,24.5891,446.107,11885,32,37,11845,11835,11805,10576,11805
38701,1,2,0,38701,38701,0,1.64201e+16,1.99956,273.264,38701,2,2,29881,29881,29881,29881,29881
20076,2,40,20076,0,0,20076,5.71867e+15,22.3486,573.992,20076,31,24,10799,10799,7059,2106,3288
22292,32,44,22292,0,0,22292,5.116e+15,31.6039,734.996,22292,36,41,22230,22179,22005,16491,17806
24119,15,21,3907,20212,0,24119,19.94,17.1434,470.988,24119,20,21,24072,24072,24052,24052,23952
20588,10,23,0,20588,4458,16130,4554.08,17.2692,529.406,20588,20,22,20226,20206,19981,20050,17057
847,8,18,0,847,0,847,1339500,12.1665,103.004,847,14,15,766,649,633,663,516
12189,22,40,12189,0,0,12189,5.71383e+15,21.5548,433.932,12189,21,28,12147,12119,12127,10084,8085
16114,34,40,0,16114,0,16114,1322420,21.5669,483.687,16114,29,29,16074,16058,16074,16072,16074
5056,1,2,5056,0,5056,0,3.92484e+13,1.99684,93.5722,5056,2,2,4350,4350,4350,4350,4350
34932,1,2,34932,0,34932,0,6.39789e+13,1.99908,259.148,34932,2,2,26991,26991,26991,26991,26991
46509,7,20,0,46509,7931,38578,5207.91,12.4509,647.106,46509,20,19,45576,45576,43126,43514,43204
16944,10,40,0,16944,16944,0,1.91065e+13,31.2192,601.814,16944,37,33,15282,13823,14103,13530,4803
46524,17,30,0,46524,8801,37723,4954.59,14.4405,797.787,46524,20,26,46479,46479,46364,46364,43568
46013,2,4,0,46013,46013,0,1.11626e+16,1.99978,295.207,46013,3,3,46008,46007,46008,46008,42598
49955,56,64,49955,0,0,49955,297152000,33.9206,1223.69,49955,37,44,49891,49880,49887,48820,42472
28467,22,38,0,28467,0,28467,1311870,31.4433,771.441,28467,38,33,28281,28061,28081,28096,25311
36093,365,374,36074,19,36074,19,3.13867e+16,4.37888,870.529,36093,146,50,35719,35719,35719,35719,35719
30166,26,40,30166,0,0,30166,5.55168e+15,32.234,679.711,30166,37,37,30054,29874,29954,13145,25026
44357,1,2,44357,0,44357,0,3.25787e+13,1.99959,279.455,44357,2,2,39222,39222,39222,39222,39222
15539,14,40,0,15539,0,15539,1330580,21.5915,511.581,15539,26,29,15299,15041,13716,13574,9475
14011,16,20,2444,11567,0,14011,20.2661,11.7521,371.659,14011,19,19,13988,13988,13988,13988,13987
17497,12,13,2926,14571,0,17497,20.337,12.2903,381.004,17497,13,12,17481,17481,17471,17471,17471
44619,27,60,44619,0,0,44619,329975000,31.9406,953.87,44619,37,43,44482,44198,44302,31648,35025
4777,16,20,4777,0,0,4777,342990000,16.2435,238.047,4777,17,18,4751,4719,4719,4718,4525
3430,32,36,0,3430,3430,0,2.17389e+13,14.3417,214.122,3430,22,25,3394,3386,3394,3386,3394
31007,3,4,0,31007,31007,0,9.6884e+15,2.00003,238.832,31007,3,3,31003,31001,31002,31002,31003
33178,1,2,33178,0,33178,0,3.25014e+13,1.99982,241.965,33178,2,2,29346,29346,29346,29346,29346
11444,37,44,0,11444,0,11444,999625,31.5605,573.22,11444,32,37,11400,11390,11249,11247,8851
43881,37,44,43881,0,43881,0,1.23235e+18,38.3752,1040.85,43881,39,39,43827,43764,43415,39749,40152
46043,20,56,46043,0,46043,0,1.46261e+18,22.4941,863.412,46043,40,32,45948,45769,45781,16632,39933
36872,2,4,0,36872,36872,0,8.28217e+15,3.63541,274.416,36872,4,4,36825,36810,36821,36822,33532
19886,35,44,19886,0,19886,0,1.3103e+18,31.2501,700.305,19886,36,41,19835,19780,19661,18480,16585
46616,33,48,0,46616,0,46616,3.95705e+14,36.1736,1144.68,46616,40,41,46539,46418,46005,44640,42507
35897,40,56,0,35897,0,35897,1327660,22.4815,765.19,35897,31,32,35841,35829,35841,35841,35839
4583,1,2,4583,0,4583,0,3.24283e+13,1.99542,88.9753,4583,2,2,4054,4054,4054,4054,4054
5711,23,32,5711,0,5711,0,59643700000,28.2073,367.526,5711,31,29,5624,5326,5493,5168,4676
33754,1,2,0,33754,33754,0,1.25355e+16,1.99959,249.489,33754,2,2,27881,27881,27881,27881,27881
23252,52,56,23252,0,0,23252,329157000,31.381,771.965,23252,38,50,23196,23186,23192,23156,23156
41839,55,60,0,41839,0,41839,1286780,31.5455,927.834,41839,37,43,41779,41767,41776,41778,38462
45130,1,2,45130,0,45130,0,3.37857e+13,1.99978,279.738,45130,2,2,39712,39712,39712,39712,39712
5802,39,40,5802,0,5802,0,79003100000,17.1693,340.371,5802,28,33,5762,5755,5750,5751,5728
9871,25,56,9871,0,9871,0,1.43584e+18,19.4653,436.691,9871,33,32,9815,9791,9793,5034,8916
15394,1,2,15394,0,15394,0,3.17423e+13,1.99838,165.876,15394,2,2,13657,13657,13657,13657,13657
48176,10,23,8193,39983,0,48176,19.3642,17.7187,705.296,48176,21,21,47789,47777,47587,47680,46346
35503,4,56,35503,0,35503,0,86000500000,29.0115,791.188,35503,37,40,26143,20137,19580,22511,7300
7944,1,17,2788,5156,0,7944,14.5896,13.9659,327.079,7944,17,16,2058,2058,2058,2058,2058
29343,52,56,0,29343,29343,0,2.22374e+13,21.0896,697.237,29343,30,32,29287,29275,29287,29287,29287
21608,1,21,4522,17086,0,21608,17.6988,17.448,508.228,21608,21,19,5221,5221,5221,5221,5221
30006,20,30,6137,23869,0,30006,18.5528,15.6569,676.143,30006,20,26,29974,29974,29827,29827,26861
15912,34,40,0,15912,15912,0,2.22614e+13,18.3324,474.261,15912,28,29,15872,15860,15872,15863,15872
14117,10,40,14117,0,14117,0,1.27195e+18,26.143,567.411,14117,36,37,12674,11377,11440,4164,5022
28722,34,40,0,28722,28722,0,1.99047e+13,34.2041,773.996,28722,38,37,28667,28568,28420,28438,26905
29360,38,40,29360,0,29360,0,77381400000,34.3732,779.749,29360,38,37,29316,29274,29143,29234,28601
30421,16,40,30421,0,30421,0,87281800000,21.9426,700.824,30421,30,29,30174,29553,28764,28653,23268
37043,1,2,0,37043,37043,0,9.62311e+15,1.9996,254.235,37043,2,2,32095,32095,32095,32095,32095
48915,1,2,0,48915,48915,0,8.59712e+15,1.99984,291.885,48915,2,2,43078,43078,43078,43078,43078
35229,10,64,35229,0,35229,0,1.24869e+18,32.6077,1066.73,35229,44,44,30216,25656,25756,9035,10320
35096,21,40,0,35096,35096,0,1.93418e+13,35.2383,880.881,35096,39,37,34566,33361,33890,32477,21254
5266,326,1423,5266,0,2132,3134,2.19256e+18,206.544,2223.71,5266,233,141,3831,3450,3189,3045,2355
9581,21,40,9581,0,0,9581,276694000,31.2154,483.153,9581,35,37,9375,8904,9113,5241,4349
7362,10,19,1108,6254,0,7362,19.9114,9.57131,233.481,7362,18,18,7332,7332,7317,7322,7329
45960,18,30,0,45960,8680,37280,4860.59,16.2751,792.371,45960,21,26,45913,45910,45754,45754,42640
44381,1,2,44381,0,44381,0,4.53343e+13,1.99986,283.427,44381,2,2,37232,37232,37232,37232,37232
10954,12,24,0,10954,10954,0,2.24339e+13,20.8968,396.938,10954,21,21,10656,10018,9208,9617,6907
34768,1,2,34768,0,34768,0,3.25613e+13,1.99948,247.546,34768,2,2,30745,30745,30745,30745,30745
1730,6,28,1730,0,0,1730,252841000,20.5197,184.778,1730,27,23,1325,1148,1174,1158,395
41922,7,20,7449,34473,0,41922,20.1254,14.8085,691.455,41922,19,20,40705,40703,37975,37810,35019
6940,20,36,6940,0,6940,0,85592400000,17.4326,296.012,6940,25,25,6902,6885,6894,6866,6397
37971,9,44,0,37971,0,37971,1224190,34.8688,894.498,37971,37,41,34794,30156,31456,31303,15008
32659,23,44,32659,0,0,32659,315935000,37.3799,828.27,32659,37,41,32417,31850,32138,13131,18188
44077,43,44,0,44077,44077,0,2.15332e+13,31.9592,871.003,44077,37,38,44033,44019,43993,43994,42702
17308,2,40,17308,0,0,17308,4.86665e+15,31.0831,616.488,17308,37,33,9819,9723,8096,2416,2937
19012,1,13,3188,15824,0,19012,20.3867,10.9978,393.036,19012,13,12,3148,3148,3148,3148,3148
6148,4,20,0,6148,1035,5113,5204.94,11.4346,242.323,6148,14,18,5506,5506,4975,4296,1396
2759,7,20,2759,0,2759,0,87393800000,15.8934,181.451,2759,15,17,2482,2187,1995,2126,1201
6061,10,40,6061,0,6061,0,81851700000,30.8208,324.316,6061,32,31,5772,5536,5367,5379,3256
12776,19,40,0,12776,12776,0,2.2161e+13,17.7921,423.006,12776,24,29,12733,12694,12716,12689,12045
42297,27,40,42297,0,0,42297,5.71194e+15,32.1804,849.479,42297,33,30,42233,42173,42203,42230,42231
15353,8,36,15353,0,15353,0,1.44538e+18,21.5576,458.784,15353,29,25,14283,12479,12126,2259,6810
5061,19,22,0,5061,0,5061,1340240,19.2302,275.6,5061,20,20,5034,5011,5018,5016,5028
7742,27,36,7742,0,0,7742,333057000,17.0504,309.068,7742,25,25,7706,7689,7703,7699,7704
6250,19,24,6250,0,6250,0,1.47067e+18,17.3264,292.786,6250,19,21,6225,6212,6219,5411,6046
26580,35,40,26580,0,0,26580,5.6833e+15,21.0357,602.46,26580,29,29,26540,26523,26540,23350,26540
45899,34,40,45899,0,45899,0,85615600000,33.5846,843.831,45899,38,37,45839,45723,45774,45754,41825
30366,1,2,0,30366,30366,0,9.02203e+15,1.99911,229.428,30366,2,2,26563,26563,26563,26563,26563
6185,28,36,6185,0,6185,0,81807900000,27.7143,309.074,6185,28,32,6139,6088,6105,6087,6106
14276,13,35,5510,8766,16,14260,59148200000,17.8261,456.403,14276,30,18,14179,14177,14058,14078,4116
30812,1,2,0,30812,30812,0,1.16814e+16,1.99932,235.017,30812,2,2,25816,25816,25816,25816,25816
30981,55,64,30981,0,30981,0,1.35515e+18,26.0059,977.532,30981,40,44,30917,30908,30915,30611,28160
6643,1,2,0,6643,6643,0,8.59094e+15,1.99684,106.834,6643,2,2,5850,5850,5850,5850,5850
28919,12,24,28919,0,28919,0,1.46724e+18,21.6759,635.601,28919,24,22,28236,26727,24485,17554,19112
46317,2,4,0,46317,46317,0,8.37615e+15,1.99974,289.617,46317,3,3,46312,46311,46312,46312,44032
40279,22,48,40279,0,0,40279,302227000,36.6353,1009.1,40279,38,41,39908,39059,39511,28226,28552
45985,34,56,0,45985,0,45985,1329880,22.6209,851.661,45985,32,32,45929,45909,45925,45923,44337
12298,1,2,12298,0,12298,0,5.17495e+13,1.99797,149.113,12298,2,2,10036,10036,10036,10036,10036
28780,29,40,0,28780,28780,0,1.67532e+13,33.6106,867.379,28780,39,34,28678,28453,28287,28047,25203
48550,10,44,0,48550,48550,0,2.13114e+13,33.3416,938.404,48550,37,37,46384,44444,41855,41412,18138
44441,8,40,0,44441,0,44441,1326080,33.1525,886.279,44441,33,32,39577,32316,29592,29590,16487
27329,36,38,0,27329,27329,0,2.1444e+13,36.5365,795.409,27329,38,38,27263,26961,27110,27110,26664
28459,12,23,0,28459,5088,23371,4879.71,19.5964,565.051,28459,21,21,28285,28276,28150,28187,27035
22231,36,54,0,22231,0,22231,8.2975e+14,33.3634,781.492,22231,36,45,22177,22156,22153,22139,20877
22321,1,2,22321,0,22321,0,3.27112e+13,1.99901,197.513,22321,2,2,19726,19726,19726,19726,19726
4282,7,12,0,4282,760,3522,5251.77,9.36899,189.669,4282,11,11,4179,4179,3942,4047,3987
21449,4,40,21449,0,21449,0,78690700000,31.5002,638.942,21449,35,34,16059,12983,13045,13046,3988
7065,11,24,7065,0,0,7065,5.74552e+15,16.8123,308.451,7065,19,21,6853,6553,6002,4632,4694
18975,1,4,0,18975,18975,0,8.56716e+15,3.8175,203.656,18975,4,4,16686,16686,16686,16686,16686
46962,5,38,0,46962,0,46962,1313160,35.4369,974.564,46962,38,38,35419,26066,25643,17165,10794
33224,11,60,0,33224,33224,0,2.16503e+13,25.3242,843.996,33224,33,40,31807,30027,28574,27791,16662
9718,15,40,0,9718,9718,0,2.15345e+13,26.0927,411.131,9718,32,37,9565,9361,9460,9322,6523
31827,1,2,0,31827,31827,0,8.44713e+15,1.9995,235,31827,2,2,28095,28095,28095,28095,28095
36761,1,2,36761,0,36761,0,3.22508e+13,1.99948,255.125,36761,2,2,32548,32548,32548,32548,32548
6827,19,20,0,6827,6827,0,2.22885e+13,16.99,280.37,6827,18,19,6805,6783,6798,6798,6627
40364,1,4,0,40364,40364,0,1.12146e+16,2.0001,277.308,40364,3,3,34079,34079,34079,34079,34079
31179,25,40,31179,0,0,31179,341801000,21.972,702.374,31179,31,27,31139,31117,31126,31126,31139
25322,6,40,25322,0,0,25322,5.28842e+15,31.7276,678.775,25322,36,35,22082,20209,17668,3815,8493
45710,17,30,8520,37190,0,45710,19.4729,19.7403,784.587,45710,28,24,45659,45659,45561,45561,44210
15702,19,56,15702,0,15702,0,1.44985e+18,19.9017,533.122,15702,34,32,15622,15515,15532,8539,13751
42915,26,44,0,42915,0,42915,1260470,35.1394,880.597,42915,37,37,42729,42307,42398,42395,33468
20165,19,56,0,20165,20165,0,2.22269e+13,21.9704,598.464,20165,31,32,20077,19969,19987,19988,17874
44550,1,2,0,44550,44550,0,1.55049e+16,1.99935,291.063,44550,2,2,34963,34963,34963,34963,34963
33422,12,32,8823,24599,0,33422,16.5911,19.208,806.611,33422,22,30,33020,32990,32648,32700,23217
35671,12,30,0,35671,6193,29478,5135.99,12.1966,639.332,35671,20,22,35615,35612,35578,35583,35071
31810,24,30,0,31810,5623,26187,4956.82,15.6643,689.627,31810,20,29,31780,31780,31780,31780,31266
17506,11,40,0,17506,17506,0,2.219e+13,19.4221,490.373,17506,27,29,17086,16461,15234,15269,10735
22334,34,40,0,22334,0,22334,1301870,31.0131,582.201,22334,34,37,22288,22224,22242,22240,22267
18959,2,4,0,18959,18959,0,8.34255e+15,2.00021,187.571,18959,3,3,18954,18953,18954,18954,18289
9059,10,21,1453,7606,0,9059,20.0768,10.4332,280.399,9059,19,20,9024,9024,9010,9013,8984
18280,26,36,18280,0,0,18280,332027000,25.6825,514.087,18280,36,33,18210,18124,18166,14535,13276
43364,20,44,0,43364,0,43364,1286390,32.1548,874.854,43364,37,38,43082,42747,42851,42876,28099
36104,33,56,36104,0,0,36104,5.6707e+15,22.5748,801.202,36104,32,39,36048,36034,36002,35422,34873
10316,18,40,10316,0,0,10316,5.54666e+15,25.5724,423.705,10316,31,37,10212,10128,10166,5929,8351
41860,13,44,0,41860,41860,0,2.12712e+13,32.4335,851.268,41860,37,37,40854,39057,39823,38960,17200
5477,3,20,977,4500,0,5477,19.9321,11.2582,247.874,5477,19,15,4154,4154,4020,2923,2255
15843,12,21,5774,10069,0,15843,14.9111,17.3884,481.325,15843,18,20,15682,15668,15276,15294,12419
33961,55,56,0,33961,33961,0,2.20949e+13,24.3222,785.091,33961,32,40,33905,33894,33904,33905,33895
36816,49,56,36816,0,36816,0,86764500000,38.765,792.582,36816,40,31,36760,36732,36760,36753,36760
5288,1,2,5288,0,5288,0,3.24697e+13,1.99679,95.4086,5288,2,2,4677,4677,4677,4677,4677
12418,29,40,12418,0,12418,0,1.24026e+18,31.5795,534.523,12418,34,37,12353,12245,12157,9053,10840
21395,1,2,21395,0,21395,0,3.44427e+13,1.9985,192.552,21395,2,2,18776,18776,18776,18776,18776
42929,1,2,42929,0,42929,0,3.27641e+13,1.99988,273.507,42929,2,2,37931,37931,37931,37931,37931
13589,10,13,2183,11406,0,13589,20.2711,10.4744,321.709,13589,12,12,13567,13567,13547,13546,13551
28496,6,40,28496,0,0,28496,5.71966e+15,22.6219,672.683,28496,31,28,24176,21570,17153,4659,9786
8094,17,20,0,8094,0,8094,1332190,18.2896,322.234,8094,20,19,8060,7966,8039,8038,7326
5394,1,4,0,5394,5394,0,8.17561e+15,3.52225,106.576,5394,4,4,4775,4775,4775,4775,4775
4760,13,36,4760,0,0,4760,253096000,29.0458,344.738,4760,30,33,4062,2854,3671,3646,2344
2957,16,18,0,2957,0,2957,1346270,16.485,192.512,2957,17,18,2933,2901,2906,2905,2863
19118,1,13,3075,16043,0,19118,20.2509,11.3712,385.842,19118,13,13,3324,3324,3324,3324,3324
10568,1,2,10568,0,10568,0,3.32933e+13,1.99754,135.36,10568,2,2,9317,9317,9317,9317,9317
43471,6,38,43471,0,43471,0,84756800000,37.0362,983.996,43471,38,38,34984,30287,23889,29118,9700
3029,6,40,3029,0,0,3029,328455000,18.5018,252.14,3029,26,23,2560,2290,1902,1525,1070
21901,3,30,0,21901,3951,17950,4944.76,14.164,541.152,21901,19,25,17115,17114,16908,14854,9266
4047,12,19,0,4047,711,3336,5170.86,10.1814,209.713,4047,18,17,4021,4021,4021,4021,4021
16082,1,2,0,16082,16082,0,8.45944e+15,1.9995,167.086,16082,2,2,14193,14193,14193,14193,14193
6166,4,22,6166,0,0,6166,342826000,16.7691,289.466,6166,19,19,4436,3356,3232,2643,1822
3278,8,22,0,3278,3278,0,2.24155e+13,19.1836,225.29,3278,20,20,2889,2330,2125,2415,1670
19376,39,40,0,19376,0,19376,1153040,30.7855,650.278,19376,36,37,19336,19315,19296,19296,19336
39405,16,44,39405,0,0,39405,312344000,41.462,941.069,39405,40,41,38339,35254,37380,37343,19552
36751,18,40,36751,0,36751,0,87224200000,33.2774,776.773,36751,32,31,36615,36453,36003,35932,28872
46318,16,23,9290,37028,0,46318,18.3234,20.09,765.129,46318,22,22,46228,46219,46010,46014,44922
9290,5,13,0,9290,1581,7709,5225.82,10.7794,276.934,9290,12,12,8645,8645,7704,7663,7255
31708,2,23,0,31708,5349,26359,4953.2,19.4922,577.142,31708,21,21,22014,22014,21954,17708,12460
17867,6,40,17867,0,17867,0,80651300000,33.8042,565.502,17867,34,35,15633,14328,12628,13379,5962
31085,1,2,31085,0,31085,0,3.34492e+13,1.99936,231.87,31085,2,2,27390,27390,27390,27390,27390
46063,22,30,0,46063,8878,37185,4817.2,17.5074,873.201,46063,21,30,46033,46033,45922,45922,43403
42512,37,40,42512,0,0,42512,5.72797e+15,27.9239,834.138,42512,32,30,42469,42426,42466,42469,42469
13919,94,379,11296,2623,13900,19,6.26158e+16,6.62993,747.539,13919,128,61,13540,13497,13475,13473,13421
44900,1,2,44900,0,44900,0,4.47664e+13,1.99971,286.671,44900,2,2,37758,37758,37758,37758,37758
14858,43,54,0,14858,0,14858,1.2415e+15,27.5711,725.161,14858,38,45,14804,14798,14732,14745,11289
20230,14,21,3196,17034,0,20230,20.0983,15.2453,406.242,20230,20,20,20192,20192,20189,20190,20186
45192,18,40,45192,0,0,45192,340819000,31.156,855.473,45192,32,31,45034,44844,44396,44355,36824
31090,12,24,31090,0,31090,0,87251500000,21.0907,654.436,31090,24,22,30418,28922,26692,28130,19510
23406,1,2,23406,0,23406,0,3.42494e+13,1.99893,201.336,23406,2,2,20557,20557,20557,20557,20557
12381,40,44,12381,0,0,12381,4.58499e+15,30.8872,588.275,12381,32,37,12337,12322,12226,12220,12009
27883,39,40,0,27883,27883,0,2.23507e+13,20.7898,662.654,27883,30,28,27843,27831,27843,27843,27482
40422,1,56,0,40422,40422,0,2.20675e+13,29.0973,843.914,40422,37,40,4553,4553,4553,4553,4553
22399,12,28,0,22399,3744,18655,5102.54,12.5155,494.82,22399,19,25,22325,22324,22284,22302,22088
12513,9,40,0,12513,0,12513,1307260,26.3651,533.761,12513,35,33,11422,9329,9137,8677,5227
27358,45,60,0,27358,27358,0,2.21454e+13,23.0668,775.679,27358,32,44,27298,27295,27292,27291,26731
30002,24,40,0,30002,0,30002,1320290,26.906,643.233,30002,30,29,29946,29908,29930,29926,29874
45483,9,25,10034,35449,0,45483,17.8914,19.5279,797.734,45483,21,23,44522,44522,43952,44125,37498
43850,15,28,0,43850,7641,36209,5134.85,14.9621,720.501,43850,21,28,43764,43764,43716,43716,43632
39663,27,30,0,39663,7413,32250,5078.3,16.807,757.556,39663,19,29,39633,39633,39633,39633,39525
13884,37,40,13884,0,13884,0,86680100000,22.1909,486.397,13884,29,28,13844,13830,13843,13843,13095
32548,22,23,8520,24028,0,32548,16.5844,19.4142,679.843,32548,22,21,32524,32524,32316,32316,32522
25914,11,40,25914,0,25914,0,85648100000,31.7755,635.342,25914,37,37,25217,24240,23135,22798,12874
38966,4,60,38966,0,38966,0,85516200000,23.1135,889.188,38966,32,40,28249,21723,21132,24285,9464
8610,4,19,0,8610,2505,6105,3935.2,17.2984,336.032,8610,18,18,6706,6706,6511,6549,3462
38195,55,60,38195,0,38195,0,83592800000,34.377,867.59,38195,37,44,38135,38123,38132,38135,33009
32946,41,96,237,32709,32934,12,2.11497e+15,1.84651,470.702,32946,28,22,32850,32835,32811,32815,32729
31887,26,28,5341,26546,0,31887,20.2444,11.7512,551.095,31887,20,21,31859,31859,31859,31859,31854
32619,1,20,5637,26982,0,32619,20.2722,17.4461,563.665,32619,20,20,5255,5255,5255,5255,5255
1606,10,21,500,1106,0,1606,14.7472,13.7217,154.014,1606,16,17,1534,1530,1495,1505,985
10000,2,38,10000,0,10000,0,1.43501e+18,34.4601,446.051,10000,31,32,5159,5159,3204,989,1403
10867,20,36,10867,0,10867,0,1.21599e+18,29.0189,496.195,10867,36,29,10637,10198,10277,3271,6111
37701,36,40,37701,0,0,37701,328948000,30.6621,779.32,37701,37,37,37659,37634,37621,36255,37650
36300,1,2,0,36300,36300,0,1.11719e+16,1.99956,254.642,36300,2,2,30671,30671,30671,30671,30671
11168,10,21,2305,8863,0,11168,17.6175,17.008,360.623,11168,19,19,10940,10930,10825,10873,7899
45786,1,2,45786,0,45786,0,3.27484e+13,1.99974,282.953,45786,2,2,40458,40458,40458,40458,40458
14318,3,24,14318,0,14318,0,87748400000,19.9807,441.683,14318,21,21,9269,7815,6966,7763,2843
2660,30,32,2660,0,2660,0,78446100000,24.044,206.121,2660,28,22,2624,2593,2612,2609,2403
34118,69,77,33788,330,34114,4,8.40811e+14,12.5458,670.092,34118,34,34,34041,34041,34004,34004,33962
43981,14,23,12496,31485,0,43981,16.1006,20.4621,801.51,43981,23,21,43768,43746,43342,43365,39417
24739,4,40,0,24739,24739,0,1.60327e+13,33.5618,808.052,24739,35,37,12347,9686,9775,9006,3103
48673,10,40,48673,0,0,48673,5.66566e+15,28.2993,861.297,48673,39,37,46986,45436,40999,9194,19590
43325,12,64,43325,0,0,43325,4.81028e+15,38.1225,1245.38,43325,37,53,38601,32180,34724,13302,12970
39693,16,44,39693,0,0,39693,5.50427e+15,33.501,837.255,39693,37,38,39189,38196,38762,13027,23912
1685,2,22,1685,0,0,1685,342594000,15.9039,161.012,1685,18,19,880,880,567,239,278
2017,10,16,2017,0,0,2017,334513000,13.8151,140.652,2017,15,14,1977,1941,1775,1774,1649
39652,19,40,39652,0,39652,0,1.44772e+18,28.8241,779.204,39652,38,37,39514,39330,39394,8947,29791
9464,26,38,9464,0,9464,0,86921400000,20.2719,409.869,9464,30,22,9426,9414,9419,9421,9426
46188,14,40,0,46188,0,46188,1306100,33.4297,845.602,46188,39,37,45698,45101,44449,44487,21063
23913,21,44,23913,0,0,23913,302915000,34.1746,754.363,23913,37,41,23582,22880,23180,12601,12800
7747,6,19,0,7747,1405,6342,5185.43,10.8133,283.145,7747,19,17,7389,7389,6985,6711,6199
24299,2,4,0,24299,24299,0,8.75402e+15,1.99988,211.528,24299,3,3,24294,24293,24294,24294,23314
28865,2,4,0,28865,28865,0,8.33037e+15,2.00021,229.89,28865,3,3,28860,28859,28860,28860,28316
17676,8,48,0,17676,17676,0,1.81485e+13,29.1794,737.564,17676,33,41,13567,10581,10668,10412,4157
43723,9,44,43723,0,0,43723,5.22223e+15,38.6099,969.932,43723,40,40,39863,34513,36082,7103,13040
24048,37,60,0,24048,0,24048,1272920,23.1572,801.697,24048,32,44,23988,23978,23906,23910,21227
39062,7,56,39062,0,0,39062,339089000,21.8299,790.495,39062,32,32,34790,30345,26609,27516,15716
5045,23,28,0,5045,937,4108,5085.09,11.3211,250.771,5045,19,21,5017,5017,5017,5017,5009
2996,5,40,2996,0,2996,0,85337400000,15.002,238.15,2996,22,21,2424,1830,1805,2122,861
25687,15,56,25687,0,0,25687,5.66873e+15,23.4441,704.082,25687,31,36,25389,24966,24530,4494,13619
2312,3,23,889,1423,0,2312,14.1107,15.8651,186.218,2312,16,16,1366,1359,1346,1358,609
12420,19,40,0,12420,12420,0,1.65164e+13,33.5546,571.276,12420,33,34,11990,10649,10963,10207,7972
9318,36,40,0,9318,9318,0,2.20941e+13,18.6263,370.259,9318,25,29,9278,9268,9278,9270,9278
15704,31,40,15704,0,0,15704,316605000,31.2363,531.035,15704,33,35,15648,15519,15537,13633,13828
30372,1,2,0,30372,30372,0,8.41289e+15,1.99964,230.055,30372,2,2,26825,26825,26825,26825,26825
44571,41,60,0,44571,44571,0,2.15763e+13,33.8027,1082.6,44571,38,52,44511,44501,44441,44431,40709
34403,3,4,0,34403,34403,0,8.43252e+15,3.58695,268.191,34403,4,4,34375,34333,34366,34366,33277
27986,22,64,27986,0,0,27986,4.58141e+15,37.1088,947.999,27986,36,44,27572,26551,27117,11945,11008
28338,7,24,28338,0,0,28338,5.72271e+15,21.4457,650.051,28338,24,22,24919,21444,18452,6933,10804
557,2,14,557,0,557,0,1.43598e+18,9.4614,71.0959,557,11,11,335,335,240,104,155
44562,1,2,44562,0,44562,0,3.29215e+13,1.99955,278.444,44562,2,2,39349,39349,39349,39349,39349
2283,13,18,0,2283,0,2283,1336100,13.2339,159.865,2283,15,15,2253,2166,2217,2216,2209
43447,1,4,43447,0,43447,0,4.72872e+13,1.99959,287.257,43447,3,3,36655,36655,36655,36655,36655
20617,13,40,20617,0,0,20617,334125000,23.2815,561.279,20617,34,37,20299,19506,19637,19644,12777
48936,1,5,4,48932,48936,0,1.56525e+16,1.99971,311.626,48936,4,3,38302,38302,38302,38302,38302
44079,7,44,44079,0,0,44079,329383000,32.2223,875.732,44079,37,38,39657,35181,32524,33744,13038
31997,1,4,0,31997,31997,0,8.04418e+15,3.92312,284.453,31997,4,4,28240,28240,28240,28240,28240
23424,1,2,23424,0,23424,0,3.75636e+13,1.99885,204.229,23424,2,2,20297,20297,20297,20297,20297
39344,2,60,0,39344,39344,0,2.06386e+13,30.6034,985.4,39344,40,44,22182,22068,16671,17755,4699
13941,9,23,0,13941,2508,11433,4788.58,17.7061,400.621,13941,20,21,13702,13702,13624,13677,7970
25910,24,40,25910,0,25910,0,87019900000,22.275,607.68,25910,30,29,25869,25850,25861,25853,25868
24363,8,23,0,24363,6988,17375,4099.74,19.732,599.803,24363,22,21,22701,22377,22111,22244,15244
24763,12,38,24763,0,0,24763,5.56498e+15,35.5257,748.967,24763,38,38,23373,21293,19646,18307,10377
49980,1,4,0,49980,49980,0,9.31212e+15,1.99998,300.641,49980,3,3,43518,43518,43518,43518,43518
17626,26,38,0,17626,0,17626,1332370,20.9708,544.449,17626,30,28,17588,17570,17578,17579,17588
15715,27,44,15715,0,0,15715,5.43993e+15,34.2869,559.113,15715,30,37,15646,15504,15512,10630,14470
38017,1,2,38017,0,38017,0,6.13489e+13,1.99974,269.185,38017,2,2,29730,29730,29730,29730,29730
6077,16,19,0,6077,988,5089,4868.93,16.2162,235.562,6077,18,18,6051,6049,6031,6033,6021
4013,9,19,0,4013,909,3104,4355.51,14.9586,217.886,4013,18,17,3878,3878,3828,3858,3314
3415,1,20,0,3415,0,3415,1337360,15.7204,200.42,3415,16,17,385,385,385,385,385
40221,3,21,0,40221,6473,33748,5135.53,15.468,594.948,40221,21,21,32114,32114,32016,29105,23612
7384,1,36,7384,0,0,7384,5.62813e+15,18.7329,310.226,7384,25,25,922,922,922,922,922
16369,44,56,0,16369,0,16369,1292060,24.5017,562.714,16369,35,40,16313,16303,16304,16311,13468
31909,55,56,31909,0,31909,0,1.45895e+18,22.8986,727.207,31909,37,32,31853,31840,31853,30725,31853
14925,5,24,14925,0,0,14925,5.71308e+15,18.8285,437.269,14925,21,21,12045,9002,9006,2546,4402
7559,29,36,0,7559,0,7559,1279160,18.376,337.409,7559,31,32,7517,7485,7482,7484,7458
23232,2,44,23232,0,0,23232,265660000,33.4615,785.865,23232,36,37,11505,11298,9901,6834,2479
47977,1,2,47977,0,47977,0,3.2878e+13,1.99962,289.121,47977,2,2,42372,42372,42372,42372,42372
6932,2,12,0,6932,1211,5721,5239.51,10.6861,242.192,6932,12,12,4505,4505,4449,2454,2454
1515,26,36,1515,0,1515,0,1.28077e+18,16.2191,174.261,1515,26,29,1475,1446,1443,774,1403
23241,2,4,0,23241,23241,0,8.34642e+15,2.00017,207.483,23241,3,3,23236,23235,23236,23236,21796
5554,27,36,5554,0,5554,0,1.07861e+18,30.5733,370.144,5554,30,33,5499,5355,5403,4984,4971
3917,34,40,3917,0,3917,0,1.1059e+18,29.4629,313.319,3917,31,30,3877,3864,3871,3876,3867
47090,9,28,0,47090,7805,39285,5149.12,15.01,683.204,47090,20,27,46821,46821,46582,46606,46293
4927,16,20,4927,0,0,4927,5.60642e+15,14.5622,229.322,4927,17,17,4905,4895,4884,4634,4902
49931,1,2,49931,0,49931,0,3.35756e+13,1.99982,294.752,49931,2,2,43974,43974,43974,43974,43974
48739,13,40,48739,0,0,48739,338067000,28.3838,870.78,48739,40,37,47967,45647,44551,45066,23825
15871,33,40,0,15871,15871,0,2.21299e+13,22.3409,477.331,15871,29,29,15831,15815,15831,15819,15831
15835,20,40,15835,0,0,15835,5.16762e+15,32.6811,539.931,15835,34,34,15575,15212,15385,3614,7794
14905,22,24,0,14905,14905,0,2.23204e+13,18.9126,437.266,14905,21,21,14881,14869,14859,14869,14881
4284,6,17,770,3514,0,4284,17.9468,13.7794,201.502,4284,17,17,4063,4063,4018,4040,3828
8528,23,36,8528,0,0,8528,335993000,18.9746,333.23,8528,26,25,8492,8474,8486,8485,8490
13586,1,2,13586,0,13586,0,5.99579e+13,1.9986,159.34,13586,2,2,10691,10691,10691,10691,10691
24703,6,32,6410,18293,0,24703,17.6155,14.6197,683.031,24703,20,25,21897,21897,21241,21297,16145
20608,1,2,20608,0,20608,0,6.88936e+13,1.99879,201.182,20608,2,2,15563,15563,15563,15563,15563
40525,20,21,0,40525,6520,34005,5055.36,18.8021,611.878,40525,21,21,40501,40499,40489,40490,40501
22681,8,40,22681,0,0,22681,246931000,34.1076,775.409,22681,36,33,15195,10637,11781,11626,6406
26445,34,38,0,26445,0,26445,1309760,31.9182,746.32,26445,38,33,26383,26247,26296,26295,26333
2102,1,4,0,2102,2102,0,8.0902e+15,1.99191,65.4498,2102,3,3,1863,1863,1863,1863,1863
26617,13,24,26617,0,0,26617,341512000,21.6596,604.956,26617,24,22,26205,24806,23424,23935,16697
9304,2,36,9304,0,9304,0,85668500000,18.1649,341.45,9304,25,25,5496,5489,3955,4441,1805
48235,1,2,48235,0,48235,0,3.37e+13,1.99992,289.3,48235,2,2,42459,42459,42459,42459,42459
3492,35,38,0,3492,0,3492,1301490,20.0853,259.856,3492,27,22,3454,3448,3454,3454,3454
28984,1,2,28984,0,28984,0,3.25137e+13,1.99948,226.287,28984,2,2,25635,25635,25635,25635,25635
6654,3,19,0,6654,2193,4461,3782.83,15.6988,301.333,6654,18,18,4405,4392,4360,4380,3136
44280,8,44,44280,0,0,44280,5.14975e+15,38.4517,1002.64,44280,40,41,38961,33752,33576,6954,14349
23817,11,40,23817,0,23817,0,85840200000,29.519,577.777,23817,31,29,23281,22491,21394,21355,11474
42854,16,40,0,42854,42854,0,2.22037e+13,27.0047,782.554,42854,33,29,42644,42214,41723,41992,30652
25728,1,2,25728,0,25728,0,4.18252e+13,1.9993,212.7,25728,2,2,21904,21904,21904,21904,21904
9163,13,36,9163,0,9163,0,84961900000,22.9473,340.428,9163,26,25,9056,8841,8934,8872,6458
21099,1,40,0,21099,0,21099,1045690,33.4547,734.318,21099,36,37,1713,1713,1713,1713,1713
26031,23,28,4629,21402,0,26031,19.6997,17.251,606.512,26031,19,28,26003,26003,26003,26003,25889
16017,13,40,16017,0,16017,0,86487100000,22.1006,477.074,16017,29,27,15805,15167,14835,15224,10387
26923,29,40,26923,0,0,26923,337950000,28.0761,614.207,26923,30,29,26872,26834,26864,26858,26827
18944,34,64,18944,0,18944,0,1.34855e+18,23.5166,797.593,18944,37,44,18880,18870,18819,16553,14560
39326,22,40,39326,0,0,39326,333094000,34.5489,778.348,39326,38,37,39160,38959,39039,34416,28629
3489,3,11,0,3489,548,2941,5186.33,8.00974,154.268,3489,9,10,2794,2794,2791,2622,2137
18745,1,2,0,18745,18745,0,9.04132e+15,1.99941,179.924,18745,2,2,16392,16392,16392,16392,16392
11703,6,13,2013,9690,0,11703,20.4166,11.4639,314.061,11703,13,12,11319,11319,10946,10946,10613
7676,4,24,0,7676,0,7676,1334760,20.3416,331.888,7676,19,21,5508,4176,4044,3163,1879
38860,33,40,0,38860,38860,0,2.2368e+13,22.2997,772.271,38860,32,28,38820,38802,38815,38812,38820
5351,22,36,0,5351,0,5351,1301850,17.9069,265.304,5351,25,25,5315,5297,5308,5306,5313
32936,5,40,32936,0,32936,0,87194500000,22.472,717.173,32936,32,24,25999,19319,19304,22803,10871
1596,5,10,270,1326,0,1596,20.589,7.72807,106.53,1596,9,9,1490,1490,1322,1322,1001
30977,9,40,30977,0,0,30977,5.63023e+15,30.1235,686.209,30977,37,37,29350,25353,26089,6728,12580
45097,11,23,7457,37640,0,45097,19.5907,18.848,670.059,45097,21,21,44868,44868,44760,44816,44006
39508,1,2,39508,0,39508,0,3.496e+13,1.99985,261.603,39508,2,2,34600,34600,34600,34600,34600
36789,6,28,6139,30650,0,36789,20.2438,12.0763,588.065,36789,20,21,35711,35711,34479,34482,33468
8884,30,38,0,8884,8884,0,2.22784e+13,21.1646,396.708,8884,26,27,8846,8830,8840,8835,8846
19265,26,36,0,19265,0,19265,1296010,25.4063,526.202,19265,36,33,19195,19096,19153,19148,17631
5878,26,36,0,5878,0,5878,1046570,30.3159,355.972,5878,31,29,5810,5634,5699,5703,5074
39014,20,30,7768,31246,0,39014,18.5624,18.6573,824.772,39014,21,30,38981,38981,38813,38813,35696
19875,14,38,19875,0,0,19875,332039000,35.5414,656.538,19875,35,38,19222,18597,17052,16849,10129
22448,15,40,22448,0,0,22448,5.5337e+15,33.7884,600.533,22448,37,36,22167,21767,21945,3315,13911
37713,8,19,0,37713,7150,30563,5037.1,18.6687,695.955,37713,19,19,36639,36592,34908,34902,27666
47951,7,44,47951,0,47951,0,7.9829e+10,36.7286,996.714,47951,38,41,42128,37244,35575,35955,14739
5114,3,32,0,5114,5114,0,1.9479e+13,23.9984,296.269,5114,31,28,3576,3131,2984,2503,733
11948,1,2,11948,0,11948,0,4.41248e+13,1.99941,145.484,11948,2,2,10074,10074,10074,10074,10074
18355,12,40,18355,0,18355,0,85306900000,29.4609,531.89,18355,32,36,17979,17334,16714,17035,11225
760,3,14,760,0,760,0,1.46656e+18,10.7816,85.5265,760,12,12,510,430,385,239,254
17291,3,13,2897,14394,0,17291,20.3907,11.0632,373.664,17291,13,12,13498,13498,13446,11466,8451
43321,40,56,0,43321,43321,0,2.21158e+13,37.746,924.682,43321,40,40,43264,43237,43256,43254,43263
5475,10,38,0,5475,5475,0,2.12046e+13,33.6506,358.177,5475,35,30,4934,4573,3766,3975,2668
46277,17,60,0,46277,0,46277,1298630,26.0404,960.183,46277,35,40,45846,44567,45251,45217,30928
13603,10,19,0,13603,2113,11490,5005.73,15.0018,338.377,13603,19,19,13508,13507,13462,13487,13409
10192,7,40,10192,0,10192,0,73196500000,31.0703,496.014,10192,33,37,8280,7057,6989,6753,3286
18940,14,30,4165,14775,0,18940,18.5016,13.9778,564.707,18940,19,24,18870,18865,18729,18743,16334
22765,1,2,22765,0,22765,0,3.70437e+13,1.9993,200.796,22765,2,2,19768,19768,19768,19768,19768
46717,43,65,0,46717,0,46717,3.94849e+14,41.2112,1305.04,46717,41,55,46651,46619,46096,44448,21500
25311,21,40,25311,0,0,25311,341613000,21.086,639.954,25311,30,28,25259,25117,25214,25205,23886
715,10,12,130,585,0,715,20.0615,8.51189,81.167,715,11,11,701,701,701,700,701
35320,15,21,0,35320,5730,29590,5184.68,11.7508,538.325,35320,21,20,35293,35293,35293,35293,35290
7429,17,22,7429,0,7429,0,1.46641e+18,20.5495,340.358,7429,22,22,7360,7133,7240,6237,6850
3097,1,2,0,3097,3097,0,8.32955e+15,1.99257,73.2584,3097,2,2,2738,2738,2738,2738,2738
48847,4,48,0,48847,48847,0,1.913e+13,36.5342,1114.12,48847,40,41,33692,27118,27303,26903,7700
25069,33,40,0,25069,25069,0,2.16655e+13,32.8813,629.019,25069,37,37,25015,24933,24946,24925,23756
21268,20,24,0,21268,21268,0,2.23345e+13,20.6727,527.632,21268,22,22,21236,21212,21194,21189,21158
31532,29,40,31532,0,31532,0,86335800000,28.1929,663.354,31532,31,29,31474,31415,31460,31442,27446
3781,8,12,0,3781,652,3129,5219.94,9.79794,178.031,3781,11,11,3743,3743,3707,3705,2672
9454,1,21,0,9454,1519,7935,4978,14.9034,304.453,9454,19,20,1915,1915,1915,1915,1915
17940,16,40,0,17940,0,17940,1089520,34.7517,659.087,17940,36,37,16924,13446,15879,15862,9025
1236,8,18,1236,0,1236,0,1.47497e+18,12.4822,121.597,1236,14,15,1130,960,937,934,821
27370,39,40,27370,0,27370,0,87344900000,21.3159,657.855,27370,31,25,27330,27318,27329,27329,27330
29022,1,2,0,29022,29022,0,9.6186e+15,1.99941,225.265,29022,2,2,25147,25147,25147,25147,25147
45355,8,40,0,45355,45355,0,2.23645e+13,22.7966,830.713,45355,32,28,41275,34657,31729,34976,19319
21643,6,13,0,21643,3648,17995,5220.78,11.776,421.701,21643,13,13,21013,21013,20359,20359,20008
26849,5,21,4724,22125,0,26849,18.8619,16.6271,529.953,26849,21,19,25030,25030,23501,23561,23311
652,3,8,108,544,0,652,20.5828,7.23926,64.0249,652,8,8,510,510,508,479,376
16380,21,24,0,16380,16380,0,2.23892e+13,21.4114,497.623,16380,23,22,16347,16253,16342,16341,15374
40023,36,40,40023,0,40023,0,86979300000,34.5603,841.724,40023,33,31,39976,39881,39969,39970,38303
40427,1,2,40427,0,40427,0,3.25778e+13,1.99985,266.389,40427,2,2,35747,35747,35747,35747,35747
32784,19,40,32784,0,32784,0,1.44162e+18,31.0242,712.154,32784,38,37,32647,32467,32539,6472,24338
20345,33,56,20345,0,20345,0,1.44843e+18,23.2269,638.565,20345,35,39,20289,20275,20266,18974,19686
29632,1,2,29632,0,29632,0,3.54693e+13,1.99987,226.455,29632,2,2,25897,25897,25897,25897,25897
11477,17,40,11477,0,11477,0,73683200000,30.9549,516.702,11477,32,37,11041,9183,10601,9994,5821
27936,16,40,27936,0,0,27936,5.70329e+15,22.8151,635.112,27936,31,29,27790,27459,26998,3959,20027
41040,1,2,0,41040,41040,0,1.01414e+16,1.99971,268.257,41040,2,2,35263,35263,35263,35263,35263
39867,7,40,39867,0,39867,0,1.46696e+18,22.4827,783.987,39867,31,29,35109,30265,25952,7197,15145
37232,27,28,6269,30963,0,37232,20.2644,12.3539,594.283,37232,21,21,37204,37204,37204,37204,37200
14614,1,4,0,14614,14614,0,1.28051e+16,1.99897,168.981,14614,3,3,12014,12014,12014,12014,12014
7599,7,36,7599,0,0,7599,299548000,25.5522,372.908,7599,33,29,6710,6019,5930,6005,1268
30936,33,44,30936,0,30936,0,70989700000,32.4742,884.097,30936,38,37,30875,30790,30565,30489,28896
32251,19,40,32251,0,32251,0,87479300000,22.3496,717.771,32251,31,29,32163,32009,31935,31884,28464
24986,12,60,0,24986,24986,0,1.99931e+13,30.4928,830.9,24986,37,44,23251,20867,21435,20773,9071
19044,24,56,19044,0,19044,0,84050900000,30.9129,710.712,19044,38,49,18865,18602,18663,18622,16985
43223,5,44,43223,0,0,43223,5.26896e+15,39.6312,975.668,43223,40,41,34061,26304,27651,6216,9130
43144,1,2,43144,0,43144,0,4.52249e+13,1.99984,281.144,43144,2,2,36211,36211,36211,36211,36211
46126,2,40,46126,0,0,46126,340926000,30.8267,870.372,46126,32,31,24775,24774,16193,7067,7452
1120,2,16,1120,0,1120,0,86114100000,12.9679,104.604,1120,13,12,664,664,471,545,248
41070,1,2,0,41070,41070,0,8.97255e+15,1.99971,266.721,41070,2,2,35955,35955,35955,35955,35955
17567,21,40,17567,0,17567,0,81208100000,32.8465,554.047,17567,34,35,17375,17086,17214,16772,14191
10391,1,2,10391,0,10391,0,3.33458e+13,1.99894,134.321,10391,2,2,9159,9159,9159,9159,9159
47970,1,2,47970,0,47970,0,3.35986e+13,1.9999,289.216,47970,2,2,42243,42243,42243,42243,42243
19874,12,13,0,19874,3353,16521,5209.19,12.3085,408.878,19874,13,13,19858,19858,19848,19848,19848
35725,6,20,6141,29584,0,35725,20.2974,17.1499,584.818,35725,20,20,34511,34511,33068,32457,15349
46936,36,44,0,46936,46936,0,2.15902e+13,36.4865,907.642,46936,38,38,46882,46820,46721,46717,40687
32932,1,2,32932,0,32932,0,3.19322e+13,1.99897,242.183,32932,2,2,29195,29195,29195,29195,29195
10391,22,36,10391,0,0,10391,5.66493e+15,18.8659,370.162,10391,28,23,10355,10337,10348,1648,10353
39368,17,56,39368,0,0,39368,337246000,29.6099,836.407,39368,36,40,39103,38402,38736,38415,29248
49004,232,374,0,49004,0,49004,3.6216e+15,4.44872,956.371,49004,129,67,48630,48615,48598,48605,48601
12094,35,40,0,12094,0,12094,1320890,18.6947,415.826,12094,28,29,12054,12042,12054,12053,12054
28985,25,40,28985,0,28985,0,85867300000,28.3248,662.958,28985,36,37,28902,28809,28837,28699,25776
18717,15,24,18717,0,0,18717,341715000,21.0219,530.325,18717,23,22,18519,18165,17625,17616,14268
39329,23,40,39329,0,39329,0,86834600000,26.4308,746.014,39329,32,29,39270,39200,39242,39227,38222
13191,15,36,13191,0,13191,0,82298200000,29.9903,447.317,13191,34,33,12962,12655,12829,12543,7368
48081,26,56,0,48081,0,48081,1325220,34.196,875.824,48081,40,32,48011,47964,47984,47982,48007
33135,10,20,5782,27353,0,33135,20.3034,15.5593,566.749,33135,20,19,33033,33033,32939,32938,32957
16924,1,2,0,16924,16924,0,8.94972e+15,1.99846,171.361,16924,2,2,14821,14821,14821,14821,14821
42075,7,21,0,42075,6803,35272,5176.76,13.9578,590.913,42075,21,20,41463,41463,39971,40333,39924
33800,6,38,0,33800,0,33800,1313150,32.7248,833.68,33800,38,36,27546,23979,19390,14035,9893
4702,1,2,0,4702,4702,0,8.41336e+15,1.99638,90.6725,4702,2,2,4152,4152,4152,4152,4152
23824,39,40,23824,0,23824,0,83002600000,27.273,638.592,23824,36,35,23784,23772,23754,23755,22801
48528,15,23,8854,39674,0,48528,18.8703,18.4549,747.103,48528,21,22,48411,48411,48185,48197,47029
15046,1,2,15046,0,15046,0,3.94731e+13,1.99781,163.936,15046,2,2,12935,12935,12935,12935,12935
26477,15,60,26477,0,26477,0,84822200000,23.6369,768.437,26477,32,40,25994,25092,24883,24507,17624
40603,6,40,40603,0,40603,0,1.46309e+18,22.2903,774.77,40603,32,29,34857,31330,24870,5353,12035
12314,14,30,2242,10072,0,12314,20.2407,11.5157,393.672,12314,19,23,12279,12279,12279,12279,12115
46501,3,23,0,46501,11334,35167,4334.75,19.5978,795.554,46501,23,21,34560,34515,34284,33889,14139
42485,37,64,42485,0,0,42485,315514000,25.8913,1118.85,42485,33,44,42421,42407,42233,41364,34769
27823,48,56,0,27823,27823,0,2.18752e+13,31.5797,704.053,27823,37,40,27767,27755,27758,27767,27026
33327,1,2,0,33327,33327,0,9.55665e+15,1.99913,241.632,33327,2,2,28906,28906,28906,28906,28906
26654,30,56,26654,0,0,26654,5.69476e+15,21.8284,671.162,26654,32,32,26598,26578,26588,25421,26068
29764,23,40,29764,0,0,29764,340859000,22.2133,694.758,29764,30,29,29722,29687,29702,29690,28004
4757,12,22,4757,0,4757,0,1.46702e+18,20.6466,267.09,4757,19,20,4600,4297,3987,3694,3397
28562,3,21,4605,23957,0,28562,19.5817,17.758,516.339,28562,20,20,23097,23097,23011,21650,12439
15586,17,28,0,15586,2522,13064,5047.93,13.2445,411.952,15586,19,25,15550,15550,15526,15526,15280
12456,18,21,2244,10212,0,12456,18.6281,15.4827,364.208,12456,19,19,12431,12430,12372,12372,12267
29868,11,24,0,29868,0,29868,1333860,21.4802,642.743,29868,24,22,28967,27652,25351,25470,15848
6688,14,19,0,6688,1470,5218,4325.36,14.9143,274.156,6688,18,17,6641,6636,6598,6601,6421
28855,44,64,0,28855,28855,0,2.1044e+13,23.6412,930.257,28855,32,44,28791,28784,28729,28746,25227
30932,1,2,0,30932,30932,0,8.39103e+15,1.99952,231.665,30932,2,2,27329,27329,27329,27329,27329
39413,37,60,0,39413,39413,0,2.09453e+13,33.7997,1117.42,39413,38,55,39344,39172,39148,39153,32028
27587,13,21,0,27587,4952,22635,4784.7,16.8542,541.963,27587,21,19,27440,27440,27325,27336,25109
42321,2,28,0,42321,6970,35351,5133.72,15.5783,651.517,42321,21,27,28665,28665,28356,19947,12171
49909,59,64,0,49909,0,49909,1138080,37.9177,1265.21,49909,40,52,49845,49835,49841,49844,42073
20374,3,48,20374,0,0,20374,5.57313e+15,34.7483,606.444,20374,36,40,13765,11759,10708,2649,2822
18921,7,21,0,18921,3044,15877,5175.91,10.6607,392.303,18921,19,20,18653,18653,18117,18122,18319
25071,1,2,0,25071,25071,0,1.00997e+16,1.99948,209.783,25071,2,2,21556,21556,21556,21556,21556
30167,11,28,5038,25129,0,30167,20.2314,11.7235,537.045,30167,20,21,30106,30106,30101,30106,30053
19556,8,38,0,19556,19556,0,2.22806e+13,29.2158,587.81,19556,31,29,17395,14178,13036,14489,9098
38394,3,5,38394,0,38394,0,6.62889e+13,1.99958,276.056,38394,3,4,38389,38387,38388,38389,38389
11335,1,2,0,11335,11335,0,8.32779e+15,1.99894,140.153,11335,2,2,10024,10024,10024,10024,10024
33243,4,5,1,33242,33243,0,1.38878e+16,2.00021,259.088,33243,4,3,33238,33236,33237,33237,33238
32576,14,40,32576,0,0,32576,4.25817e+15,33.7009,934.071,32576,40,34,28019,17633,25027,9319,13237
5385,7,11,0,5385,820,4565,5150.43,8.39016,188.47,5385,10,10,5333,5333,5248,5248,5306
19284,34,40,19284,0,0,19284,337483000,24.3543,627.771,19284,33,35,19236,19200,19163,19162,17990
21774,1,2,21774,0,21774,0,3.89882e+13,1.9994,195.838,21774,2,2,18757,18757,18757,18757,18757
8146,24,36,0,8146,0,8146,1181510,24.8321,385.583,8146,33,29,8060,7921,7973,7973,5554
21483,12,40,0,21483,21483,0,2.22132e+13,21.6156,548.599,21483,29,29,21071,20194,18903,19933,13475
46532,1,2,46532,0,46532,0,3.2677e+13,1.9997,285.29,46532,2,2,41129,41129,41129,41129,41129
1891,4,18,1891,0,0,1891,342074000,13.3813,146.878,1891,14,15,1393,1061,1002,944,683
17638,14,24,17638,0,17638,0,1.47137e+18,20.7953,506.92,17638,23,22,17414,17152,15416,13841,12720
46437,139,378,0,46437,0,46437,3.8218e+15,29.9863,1456.93,46437,129,71,46059,46027,46006,46005,45963
33048,30,48,0,33048,0,33048,1156350,34.7378,940.976,33048,37,41,32953,32745,32547,32570,27894
4398,30,38,0,4398,4398,0,2.19062e+13,20.3377,292.837,4398,22,29,4360,4348,4354,4355,3468
30960,21,44,30960,0,0,30960,315485000,32.9964,810.725,30960,37,41,30673,30094,30349,20665,20190
22195,22,60,0,22195,22195,0,1.94786e+13,35.7359,875.49,22195,37,52,21829,21087,21396,20628,11204
44642,37,40,44642,0,44642,0,1.46591e+18,31.0204,854.517,44642,33,32,44599,44556,44594,39173,41525
35100,1,4,0,35100,35100,0,1.125e+16,1.99994,255.962,35100,3,3,29617,29617,29617,29617,29617
6689,20,22,0,6689,6689,0,2.2482e+13,19.6421,311.652,6689,20,20,6664,6639,6651,6650,6663
7583,1,2,7583,0,7583,0,3.33331e+13,1.99802,114.328,7583,2,2,6684,6684,6684,6684,6684
6830,19,20,6830,0,6830,0,1.47204e+18,16.7558,294.643,6830,19,18,6810,6799,6809,6392,6810
6713,3,21,2485,4228,0,6713,14.6295,15.9161,311.546,6713,19,19,3997,3970,3930,3955,2296
43809,18,21,0,43809,7014,36795,5128.46,17.2613,619.577,43809,21,21,43773,43772,43749,43751,43739
12767,1,2,0,12767,12767,0,8.34755e+15,1.99867,149.143,12767,2,2,11287,11287,11287,11287,11287
46443,11,30,8384,38059,0,46443,19.8023,18.8351,768.513,46443,28,23,46300,46300,46251,46267,44610
37588,18,28,6310,31278,0,37588,20.2763,12.1251,593.853,37588,20,21,37555,37555,37555,37555,37547
1704,3,22,0,1704,1704,0,2.23748e+13,16.9748,162.398,1704,17,19,1058,889,782,889,396
9392,18,21,1710,7682,0,9392,18.4774,15.089,316.925,9392,18,19,9369,9368,9324,9325,9233
10003,13,22,10003,0,0,10003,343514000,19.8347,381.179,10003,21,21,9787,9100,8777,8969,7490
4930,8,38,4930,0,4930,0,86690400000,20.3878,304.697,4930,24,26,4361,3542,3302,3615,2438
27874,40,44,0,27874,0,27874,1263970,33.6733,711.288,27874,37,37,27830,27811,27760,27762,27438
12683,8,40,12683,0,0,12683,4.76752e+15,34.5181,550.266,12683,32,37,10588,9016,9189,2372,4421
10653,8,38,0,10653,0,10653,1327630,20.67,431.936,10653,29,26,9479,7737,7138,7085,4948
23496,1,2,0,23496,23496,0,1.10589e+16,1.99932,203.763,23496,2,2,19889,19889,19889,19889,19889
3710,17,20,3710,0,0,3710,337317000,15.0132,202.023,3710,16,17,3689,3678,3672,3671,3689
43348,11,60,43348,0,0,43348,5.50423e+15,35.6443,1070.16,43348,38,52,41008,38322,36129,21611,17303
20308,7,24,0,20308,0,20308,1334650,20.8791,525.671,20308,22,22,18068,15723,13555,14506,8491
32556,23,40,32556,0,0,32556,5.61667e+15,34.9235,701.025,32556,37,37,32445,32310,32367,8046,27584
47154,39,44,0,47154,0,47154,1280950,36.3036,896.543,47154,38,38,47107,47050,46990,46992,46162
17754,24,48,17754,0,0,17754,5.1339e+15,33.2585,715.022,17754,30,41,17664,17570,17548,7225,14022
21332,13,19,3836,17496,0,21332,20.2546,15.1787,465.12,21332,19,19,21295,21295,21295,21295,21295
6947,23,36,0,6947,6947,0,2.13249e+13,18.6704,321.773,6947,30,32,6887,6816,6844,6751,5720
3254,11,12,581,2673,0,3254,20.3675,11.0685,171.345,3254,12,12,3239,3239,3239,3238,3239
8342,858,5251,0,8342,3671,4671,1.70558e+15,160.218,6127.5,8342,841,195,3091,2742,1431,1307,699
36279,23,44,0,36279,0,36279,1216810,35.6563,882.546,36279,37,41,35990,35236,35615,35621,21398
2706,9,32,2706,0,2706,0,1.03352e+18,25.7051,243.579,2706,28,25,2095,1667,1821,545,1113
47650,2,44,47650,0,47650,0,81480500000,41.4967,1005.38,47650,40,41,27113,26989,20293,21677,7629
8316,25,64,8316,0,8316,0,74640300000,31.4092,605.044,8316,35,52,8180,7961,8013,7981,4556
6720,1,2,6720,0,6720,0,3.8619e+13,1.99702,107.903,6720,2,2,5797,5797,5797,5797,5797
11751,7,19,3243,8508,0,11751,15.7941,17.3848,391.271,11751,19,18,10606,10606,10518,10606,5306
4560,17,22,4560,0,4560,0,87967700000,16.9877,253.375,4560,19,19,4528,4447,4496,4495,4482
44851,17,40,44851,0,44851,0,1.44953e+18,28.9573,832.213,44851,40,37,44627,44030,44311,7351,30643
12819,13,36,12819,0,12819,0,63597300000,31.4939,568.124,12819,33,33,10812,7241,9666,8716,5650
43362,9,40,43362,0,0,43362,5.66505e+15,36.9661,904.405,43362,37,34,39663,31974,31134,11235,17421
602,8,13,0,602,186,416,3502.35,9.10631,79.3117,602,13,13,545,539,539,545,377
10891,31,44,10891,0,10891,0,1.32397e+18,31.2115,474.003,10891,33,36,10836,10726,10714,5319,8741
9945,9,44,9945,0,0,9945,5.45685e+15,21.7317,463.802,9945,28,37,9121,7679,8061,4708,4796
22627,2,40,22627,0,0,22627,5.51451e+15,34.3439,611.887,22627,36,33,13255,13222,9702,2879,3601
29898,10,24,29898,0,29898,0,1.46671e+18,21.4667,642.942,29898,24,22,28736,27682,24366,11182,15430
22662,1,2,22662,0,22662,0,3.24053e+13,1.99982,200.257,22662,2,2,20052,20052,20052,20052,20052
38792,1,2,0,38792,38792,0,1.42919e+16,1.99918,269.157,38792,2,2,31097,31097,31097,31097,31097
47270,46,54,47264,6,47264,6,1.84329e+12,35.4439,1198.49,47270,44,45,47216,47199,47032,46487,39905
26629,11,38,0,26629,26629,0,2.22469e+13,31.4391,690.102,26629,32,31,25300,23621,21700,21296,15449
7699,2,21,0,7699,1527,6172,4667.65,18.4385,305.095,7699,19,20,5249,5249,5244,4597,2887
23234,4,64,23234,0,23234,0,86757800000,22.0526,728.015,23234,32,44,16343,12348,11898,14246,5102
27007,35,60,27007,0,27007,0,1.40776e+18,26.7895,781.59,27007,41,40,26946,26904,26848,18414,22870
37886,3,4,0,37886,37886,0,8.55881e+15,1.99992,262.461,37886,3,3,37882,37880,37881,37881,37882
21728,2,4,0,21728,21728,0,8.32403e+15,3.42484,202.956,21728,4,4,21720,21718,21720,21720,19760
16371,29,38,16371,0,16371,0,1.46467e+18,21.1144,527.237,16371,30,29,16333,16315,16325,14566,16333
12697,11,21,0,12697,1998,10699,5140.57,9.98133,323.525,12697,16,20,12668,12668,12662,12667,12663
16094,14,40,0,16094,0,16094,1329030,19.8241,522.152,16094,30,24,15849,15582,14340,14910,12335
8626,1,2,0,8626,8626,0,9.5815e+15,1.99942,122.317,8626,2,2,7478,7478,7478,7478,7478
11146,9,12,0,11146,1952,9194,5229.51,10.9838,308.515,11146,12,12,11083,11083,10984,10982,9039
28410,15,40,28410,0,0,28410,5.69374e+15,22.427,632.068,28410,30,29,28233,27906,27565,9026,21362
33711,1,20,5788,27923,0,33711,20.2793,17.3655,569.672,33711,20,20,5467,5467,5467,5467,5467
30061,9,20,0,30061,5421,24640,5119.97,15.5735,600.471,30061,19,20,29662,29660,29293,29288,27970
41926,5,40,41926,0,0,41926,5.65888e+15,31.8486,921.451,41926,38,36,31874,23491,23236,7730,12528
30298,1,24,0,30298,30298,0,2.23447e+13,21.2757,646.227,30298,24,22,3350,3350,3350,3350,3350
29173,1,40,29173,0,29173,0,1.30297e+18,34.3483,775.908,29173,38,37,3374,3374,3374,3374,3374
37952,3,28,0,37952,6196,31756,5122.51,15.848,616.357,37952,21,27,30129,30129,29923,26994,16855
19126,30,56,19126,0,0,19126,332930000,23.9787,615.071,19126,33,40,19056,18994,19000,17838,15478
37569,22,40,0,37569,0,37569,1330700,22.4174,748.886,37569,32,29,37522,37475,37492,37490,33428
12404,27,40,12404,0,12404,0,86476900000,18.5491,417.698,12404,25,29,12364,12347,12358,12352,12362
45364,5,25,0,45364,10014,35350,4575.61,19.4946,796.731,45364,21,23,40195,40194,38086,38194,33577
6166,29,36,6166,0,6166,0,1.17714e+18,29.1048,359.001,6166,31,29,6120,6057,6028,5476,5821
40449,43,56,40449,0,0,40449,5.70869e+15,22.5219,811.504,40449,32,32,40393,40381,40393,40393,40391
14785,1,2,0,14785,14785,0,1.40801e+16,1.99973,165.433,14785,2,2,11895,11895,11895,11895,11895
46184,1,2,46184,0,46184,0,4.64473e+13,1.99974,288.106,46184,2,2,38562,38562,38562,38562,38562
25277,22,56,0,25277,25277,0,2.1684e+13,30.4277,785.994,25277,38,50,25051,24775,24821,24722,13948
21566,46,56,0,21566,21566,0,2.18826e+13,23.6135,643.552,21566,34,40,21510,21500,21501,21510,19919
47983,12,40,47983,0,47983,0,87239100000,30.3746,888.651,47983,32,31,46522,43525,40369,40698,25751
18922,1,4,0,18922,18922,0,8.43122e+15,3.82269,203.571,18922,4,4,16675,16675,16675,16675,16675
7036,10,20,0,7036,7036,0,2.23153e+13,17.4395,287.918,7036,18,19,6838,6656,5991,5880,4760
36404,36,40,36404,0,0,36404,5.71455e+15,32.7106,776.227,36404,32,31,36360,36320,36356,36359,34379
45182,9,20,7832,37350,0,45182,20.3361,14.4149,652.11,45182,20,19,44910,44910,44442,44439,43927
23539,1,2,0,23539,23539,0,8.78564e+15,1.99915,202.199,23539,2,2,20668,20668,20668,20668,20668
11131,1,2,0,11131,11131,0,8.37036e+15,1.99847,140.074,11131,2,2,9837,9837,9837,9837,9837
16501,8,38,0,16501,16501,0,2.15371e+13,34.496,618.8,16501,38,38,14212,11367,10229,11391,4146
3880,16,18,3880,0,0,3880,343864000,15.5008,217.389,3880,17,18,3856,3824,3829,3828,3780
37831,1,2,37831,0,37831,0,5.65837e+13,1.99987,266.098,37831,2,2,30225,30225,30225,30225,30225
1159,12,13,0,1159,479,680,3712.55,11.6739,111.243,1159,13,13,1143,1143,1143,1143,1143
46514,21,60,46514,0,0,46514,5.52926e+15,31.8784,963.805,46514,37,44,46233,45783,45996,16815,31975
34967,14,44,34967,0,0,34967,312222000,36.3317,869.703,34967,37,41,33658,31311,32592,32564,18499
23813,35,38,23813,0,23813,0,1.46377e+18,28.0858,643.338,23813,31,30,23772,23731,23767,21842,23772
41938,13,65,41937,1,41937,1,2.07038e+12,36.2852,1325.62,41938,38,59,36885,27406,31878,24470,15848
2881,1,2,0,2881,2881,0,9.00407e+15,1.99479,70.478,2881,2,2,2520,2520,2520,2520,2520
4391,1,24,4391,0,0,4391,342254000,16.8577,250.771,4391,18,21,460,460,460,460,460
2397,10,32,0,2397,2397,0,1.99646e+13,23.1439,196.325,2397,26,28,2258,2162,2195,2089,1457
5413,3,5,6,5407,5413,0,9.22518e+15,1.99963,104.332,5413,4,3,5408,5406,5408,5408,5408
5756,7,11,938,4818,0,5756,20.4072,9.164,201.861,5756,11,10,5679,5679,5536,5536,5623
40875,6,23,0,40875,6822,34053,5001.58,19.6417,644.576,40875,21,21,39597,39597,38709,38766,38163
29268,28,44,29268,0,29268,0,83468700000,31.9576,715.668,29268,35,37,29176,29037,29009,28740,26892
35130,50,56,0,35130,35130,0,2.19751e+13,30.4573,772.553,35130,38,38,35074,35062,35067,35074,35008
34042,4,44,34042,0,0,34042,325682000,33.0595,771.771,34042,37,37,25609,20166,19893,20443,8101
1349,13,22,1349,0,1349,0,1.4403e+18,18.9333,147.751,1349,17,20,1293,1180,1158,1076,1007
44525,1,4,0,44525,44525,0,8.34428e+15,2.69496,287.255,44525,4,4,39364,39364,39364,39364,39364
14374,1,13,2503,11871,0,14374,20.3682,11.8997,355.292,14374,13,12,2292,2292,2292,2292,2292
16607,23,40,16607,0,16607,0,7.6231e+10,30.7743,579.191,16607,35,33,16415,15866,16160,15583,10830
36388,1,21,6047,30341,0,36388,20.3119,12.0928,557.835,36388,21,20,6154,6154,6154,6154,6154
35199,8,40,35199,0,35199,0,84449300000,31.385,741.714,35199,37,37,32749,29015,28237,29151,11359
27602,37,38,0,27602,0,27602,1331390,26.8148,685.354,27602,31,30,27563,27520,27561,27562,27563
41363,10,40,0,41363,0,41363,1330980,31.4238,841.003,41363,32,31,39088,37159,32360,32552,20592
17744,19,21,2867,14877,0,17744,19.8999,12.572,402.425,17744,19,20,17723,17723,17703,17703,17660
14586,20,36,14586,0,0,14586,257389000,31.0884,596.711,14586,35,33,14216,13348,13409,9379,9840
42706,5,44,42706,0,0,42706,328874000,32.509,861.919,42706,37,38,34762,26585,27571,28048,10733
32058,29,40,32058,0,32058,0,70626800000,35.4994,898.333,32058,37,37,31940,31661,31517,31298,28620
17857,5,23,4034,13823,0,17857,17.7777,17.3722,505.213,17857,20,22,15747,15747,14931,14971,13111
26440,6,20,0,26440,4668,21772,5193.47,18.6137,517.506,26440,20,19,25398,25398,24239,23516,12657
31805,16,24,31805,0,0,31805,341313000,21.3719,668.745,31805,24,22,31630,31165,30560,30557,26017
37648,1,2,37648,0,37648,0,3.75021e+13,1.9995,256.252,37648,2,2,32631,32631,32631,32631,32631
16223,14,40,16223,0,16223,0,1.46599e+18,19.88,520.838,16223,25,29,15981,15721,14470,11104,11937
37368,36,44,37368,0,0,37368,327393000,34.2134,816.817,37368,37,38,37318,37280,37160,31748,33468
26427,1,2,0,26427,26427,0,8.86166e+15,1.99928,213.715,26427,2,2,23176,23176,23176,23176,23176
3155,3,24,0,3155,3155,0,2.23206e+13,15.3924,214.54,3155,19,21,2046,1729,1540,1703,725
45433,4,30,0,45433,8703,36730,4847.24,20.3287,792.405,45433,22,28,39856,39856,36820,35812,22291
33178,3,40,33178,0,0,33178,296078000,35.1629,845.127,33178,38,37,21917,19018,18047,15492,5110
8503,9,36,8503,0,8503,0,68085100000,30.043,442.98,8503,33,33,6984,5772,6268,5769,3260
23675,5,40,23675,0,0,23675,338178000,26.7721,570.897,23675,29,29,19261,14508,14717,15075,8426
43817,35,48,0,43817,0,43817,1136520,34.876,1076.42,43817,37,41,43751,43620,43306,43291,35320
23846,11,13,4054,19792,0,23846,20.3935,11.8584,446.208,23846,13,13,23821,23821,23811,23810,23811
5569,1,2,0,5569,5569,0,8.33275e+15,1.99515,99.1834,5569,2,2,4924,4924,4924,4924,4924
40618,1,2,0,40618,40618,0,8.64308e+15,1.99943,265.507,40618,2,2,35745,35745,35745,35745,35745
9607,18,36,9607,0,0,9607,320805000,26.1268,386.56,9607,32,32,9465,9325,9394,7621,6308
9462,12,36,0,9462,0,9462,950362,29.5829,485.398,9462,33,33,7666,5096,6632,6555,3894
40000,28,378,39981,19,0,40000,2.30259e+16,21.3662,1285,40000,129,71,39377,38540,38344,38380,32521
22808,1,21,0,22808,4726,18082,4590.22,17.5197,527.143,22808,20,20,5319,5319,5319,5319,5319
48178,25,40,48178,0,0,48178,5.65738e+15,27.9742,848.577,48178,39,37,48087,47993,48022,19614,38657
43672,19,40,0,43672,43672,0,2.19695e+13,33.452,809.501,43672,37,37,43501,43276,43363,43146,29837
11580,1,2,11580,0,11580,0,3.595e+13,1.99888,141.481,11580,2,2,10100,10100,10100,10100,10100
23908,58,60,0,23908,0,23908,1202500,30.7959,831.949,23908,36,44,23848,23838,23846,23848,22836
33556,31,44,33556,0,33556,0,82781400000,32.9316,769.785,33556,37,37,33481,33250,33311,33288,28027
13539,12,24,0,13539,13539,0,2.24531e+13,19.8855,428.911,13539,21,21,13226,12517,11529,12214,9035
2738,9,22,2738,0,0,2738,5.56494e+15,19.1359,211.95,2738,19,21,2476,1964,1846,1930,1169
39606,1,19,0,39606,7147,32459,5154.67,16.2072,652.631,39606,19,19,6081,6081,6081,6081,6081
35884,35,38,0,35884,0,35884,1318300,33.2246,823.82,35884,36,33,35828,35666,35812,35811,35828
22317,15,40,0,22317,22317,0,2.16708e+13,34.9084,602.425,22317,37,37,22032,21638,21814,21550,14036
11225,38,44,0,11225,11225,0,2.19013e+13,19.0904,482.214,11225,23,41,11181,11178,11173,11180,10998
39662,1,20,0,39662,7163,32499,5149.05,16.498,673.529,39662,20,20,6126,6126,6126,6126,6126
44935,30,56,44935,0,44935,0,1.45474e+18,35.2576,879.021,44935,34,38,44869,44832,44837,36078,44610
29231,1,2,0,29231,29231,0,8.76346e+15,1.99952,225.205,29231,2,2,25675,25675,25675,25675,25675
1979,6,22,0,1979,1979,0,2.23658e+13,17.1865,174.482,1979,17,19,1617,1409,1185,1389,643
7789,1053,6051,0,7789,0,7789,3.40849e+17,79.0501,6591.66,7789,1835,141,1738,1639,1031,901,877
35591,10,21,5754,29837,0,35591,20.2181,14.4537,543.204,35591,21,20,35519,35519,35464,35471,35433
22914,12,28,3864,19050,0,22914,20.2119,11,477.057,22914,19,21,22872,22872,22867,22871,22827
39206,20,44,39206,0,39206,0,81293500000,37.7999,871.609,39206,38,37,38768,38166,38429,37424,26240
47194,10,40,47194,0,47194,0,87027100000,32.6037,908.184,47194,33,32,44476,42194,36575,36066,20293
49334,29,30,0,49334,8393,40941,5131.08,19.903,733.201,49334,28,22,49304,49304,49304,49304,49301
17534,7,40,17534,0,17534,0,1.44515e+18,29.4835,494.957,17534,29,29,15924,14162,12887,3067,7555
10109,1,28,1769,8340,0,10109,19.6348,11.2653,361.146,10109,19,23,1823,1823,1823,1823,1823
10345,1,2,0,10345,10345,0,8.37247e+15,1.99903,134.666,10345,2,2,9142,9142,9142,9142,9142
25020,1,2,25020,0,25020,0,4.01175e+13,1.99888,210.119,25020,2,2,21453,21453,21453,21453,21453
37992,17,23,7381,30611,0,37992,18.4762,19.4702,682.341,37992,21,22,37943,37943,37790,37793,37377
16600,275,378,0,16600,0,16600,1.06911e+16,18.4477,949.321,16600,129,69,16222,16215,16207,16209,16201
44167,1,2,44167,0,44167,0,5.07288e+13,1.99989,283.766,44167,2,2,36206,36206,36206,36206,36206
28821,20,27,9687,19134,4,28817,9766020000,18.6289,676.805,28821,25,22,28791,28788,28628,28571,20501
31661,21,44,31661,0,31661,0,83515100000,35.1617,766.363,31661,37,37,31425,31085,31206,30661,23054
18516,10,24,18516,0,0,18516,342402000,20.5789,510.03,18516,22,22,17732,17034,15031,15268,10920
40975,54,60,0,40975,40975,0,2.1004e+13,28.4911,1021.33,40975,37,44,40915,40904,40909,40915,38419
12885,1,2,0,12885,12885,0,1.10729e+16,1.99876,151.171,12885,2,2,10904,10904,10904,10904,10904
36806,20,27,11755,25051,4,36802,7647300000,19.4872,756.926,36806,23,22,36775,36769,36601,36555,36732
47538,1,23,0,47538,7912,39626,5028.54,19.1061,693.963,47538,22,21,9220,9220,9220,9220,9220
49917,7,28,0,49917,8680,41237,5144.97,14.6983,760.399,49917,21,28,48610,48608,45545,45894,35548
32938,15,21,0,32938,5449,27489,5195.89,12.2209,529.772,32938,21,20,32911,32911,32911,32911,32908
39370,1,2,39370,0,39370,0,3.38027e+13,1.9997,261.457,39370,2,2,34641,34641,34641,34641,34641
22489,2,56,22473,16,22473,16,1.12301e+13,34.268,796.899,22489,47,37,8627,8324,7471,1075,1311
14578,8,40,14578,0,14578,0,73986100000,33.4596,560.694,14578,35,33,12607,11083,11184,10663,3980
1883,1,16,0,1883,0,1883,1298890,13.76,134.126,1883,13,14,260,260,260,260,260
13114,6,24,0,13114,0,13114,1339310,19.1537,423.604,13114,20,21,11174,9998,7806,7697,5499
1282,12,28,1282,0,1282,0,1.01937e+18,22.1014,168.029,1282,24,24,938,434,732,542,650
48271,3,4,0,48271,48271,0,9.04023e+15,3.13087,313.102,48271,4,4,48243,48201,48234,48234,44831
1080,11,18,1080,0,1080,0,87267400000,13.0037,112.811,1080,15,14,1050,1020,897,874,785
33740,12,60,33740,0,0,33740,5.65119e+15,22.7115,828.254,33740,32,40,32680,30617,28268,20650,21931
41788,5,56,41788,0,0,41788,340378000,22.1143,818.262,41788,31,32,33083,24620,24789,22761,11407
32510,13,30,6490,26020,0,32510,19.0857,15.2808,694.937,32510,20,26,32397,32397,32239,32265,29763
46533,43,44,46533,0,46533,0,68603600000,38.5984,1111.3,46533,39,37,46488,46463,46418,46418,46488
48232,1,2,48232,0,48232,0,3.35445e+13,1.9995,289.876,48232,2,2,42483,42483,42483,42483,42483
43248,6,40,43248,0,43248,0,1.44882e+18,28.8889,812.716,43248,39,37,37706,34248,27437,6066,15637
23340,4,13,0,23340,3803,19537,5200.02,11.2208,425.887,23340,13,13,21114,21114,19222,18811,18280
9774,27,56,0,9774,9774,0,2.12815e+13,27.5086,464.53,9774,32,40,9696,9614,9644,9626,7209
48652,16,56,48652,0,48652,0,1.45715e+18,34.0293,879.74,48652,33,36,48354,47692,47066,11437,33226
16614,19,44,16614,0,0,16614,5.37442e+15,26.1773,573.023,16614,33,37,16404,16085,16281,6932,11820
40670,24,40,0,40670,0,40670,1323130,35.9448,858.951,40670,34,33,40571,40466,40505,40509,38220
15011,20,40,15011,0,15011,0,1.44883e+18,27.7179,586.541,15011,35,38,14817,14511,14622,6638,12432
7755,1,2,7755,0,7755,0,3.27752e+13,1.99781,116.818,7755,2,2,6851,6851,6851,6851,6851
27811,7,28,4739,23072,0,27811,20.2534,12.4344,523.431,27811,20,21,27223,27223,25703,26259,25577
17311,29,38,17311,0,17311,0,85587700000,35.1101,581.889,17311,34,32,17237,17119,17195,17194,17237
44134,4,48,44134,0,0,44134,5.02384e+15,36.6177,1058.7,44134,37,41,30590,24353,24293,6635,8556
36920,1,2,36920,0,36920,0,3.38426e+13,1.99935,252.892,36920,2,2,32480,32480,32480,32480,32480
11498,20,24,11498,0,11498,0,1.47038e+18,20.9115,406.585,11498,21,21,11468,11430,11439,9705,10815
43049,1,2,43049,0,43049,0,3.24962e+13,1.99961,275.216,43049,2,2,38078,38078,38078,38078,38078
7473,1,2,7473,0,7473,0,3.3447e+13,1.99813,113.293,7473,2,2,6584,6584,6584,6584,6584
16256,7,40,16256,0,0,16256,5.6723e+15,19.4611,473.081,16256,26,29,14710,13027,11769,3117,7077
47679,8,23,0,47679,7870,39809,5023.72,18.5905,686.743,47679,21,21,47117,47090,46803,46883,25776
16416,16,19,0,16416,2651,13765,5081.89,12.9885,385.794,16416,19,18,16386,16385,16370,16370,16317
10501,14,56,10501,0,10501,0,1.40168e+18,27.0864,460.922,10501,40,37,10308,10106,10055,2298,5887
29389,25,44,29389,0,29389,0,1.38052e+18,37.6007,748.898,29389,37,37,29238,28967,28988,9379,24901
26268,44,56,0,26268,26268,0,2.16274e+13,34.7175,816.051,26268,38,51,26212,26202,26203,26208,24949
25489,3,38,25489,0,25489,0,1.46286e+18,27.5596,665.202,25489,31,30,15948,13399,11659,3015,5212
46627,14,23,13194,33433,0,46627,16.0854,20.4531,822.472,46627,23,21,46398,46373,45931,45961,43211
713,1,2,0,713,713,0,1.07126e+16,1.97055,35.5702,713,2,2,606,606,606,606,606
22800,18,40,22800,0,22800,0,1.43842e+18,22.6771,586.458,22800,35,37,22681,22548,22602,10682,17662
25194,15,21,0,25194,4115,21079,5184.5,12.2628,460.36,25194,21,20,25167,25167,25167,25167,25164
34754,10,20,6170,28584,0,34754,20.2773,16.9491,590.719,34754,20,19,34624,34624,34514,34513,34510
2282,4,10,0,2282,397,1885,5276.61,8.91893,131.07,2282,10,10,2022,2022,1846,1806,1682
3852,1,2,0,3852,3852,0,8.38053e+15,1.99585,82.2936,3852,2,2,3403,3403,3403,3403,3403
27826,18,44,0,27826,27826,0,2.09202e+13,37.7526,739.902,27826,37,37,27435,26883,27178,26601,18288
17350,54,56,17350,0,17350,0,1.45212e+18,20.6593,555.757,17350,34,32,17294,17284,17294,16494,17294
30202,44,60,0,30202,30202,0,2.17348e+13,25.5889,813.252,30202,32,40,30142,30131,30138,30135,28159
7476,5,21,0,7476,2528,4948,3858.77,15.7781,329.555,7476,18,19,5691,5690,5651,5681,3518
25828,28,56,0,25828,25828,0,2.19877e+13,25.8587,737.525,25828,35,40,25726,25568,25598,25572,22027
39795,31,40,0,39795,0,39795,1332190,27.3888,812.007,39795,31,30,39747,39707,39735,39735,38606
27601,17,23,0,27601,4636,22965,4969.56,16.9193,531.698,27601,20,21,27564,27564,27503,27506,27367
46609,4,48,46609,0,0,46609,5.11775e+15,37.6609,1061.74,46609,40,41,32979,26216,26120,6827,8694
32446,17,44,32446,0,0,32446,5.49545e+15,30.8157,747.876,32446,36,37,32106,31258,31880,7085,22948
40236,26,64,40236,0,40236,0,1.25323e+18,32.6942,1125.68,40236,45,44,40013,39406,39486,18448,21831
37681,9,38,37681,0,37681,0,86627500000,32.0819,834.652,37681,35,33,34413,27646,26922,27813,18193
13000,61,64,13000,0,0,13000,281718000,26.6235,700.34,13000,31,44,12936,12930,12933,12519,12079
16698,25,56,16698,0,16698,0,1.42786e+18,32.37,673.186,16698,41,41,16535,16260,16351,11975,15300
42980,1,2,0,42980,42980,0,1.27082e+16,1.99944,281.518,42980,2,2,35399,35399,35399,35399,35399
28820,36,40,28820,0,0,28820,5.64872e+15,27.6678,772.736,28820,38,36,28770,28646,28723,28734,27953
45097,31,56,45097,0,0,45097,339352000,35.1254,853.257,45097,40,32,45032,44990,45016,45009,45028
8187,1,2,8187,0,8187,0,3.32805e+13,1.99805,118.814,8187,2,2,7218,7218,7218,7218,7218
28113,8,40,28113,0,28113,0,86193900000,27.7882,764.357,28113,38,36,24856,20249,18439,20462,8681
22201,13,21,0,22201,6986,15215,3889.69,17.497,557.419,22201,21,19,22036,22036,21805,21825,20036
29953,20,40,29953,0,29953,0,1.46094e+18,22.51,660.606,29953,31,29,29897,29841,29816,4916,25638
17416,22,23,0,17416,3113,14303,4891.63,16.0958,444.515,17416,20,21,17393,17393,17352,17352,17390
24495,22,24,24495,0,24495,0,87573500000,21.4916,587.33,24495,24,22,24467,24441,24447,24455,22950
20729,35,40,20729,0,0,20729,334460000,35.1226,582.113,20729,36,37,20682,20624,20636,17927,20634
14511,31,560,374,14137,14067,444,2.38951e+16,47.7144,2157.2,14511,172,63,13682,13044,10721,9974,5294
27182,4,21,0,27182,4336,22846,5108.85,15.4535,486.777,27182,20,20,24836,24836,22699,22448,22574
1540,2,18,1540,0,0,1540,345654000,15.6851,140.17,1540,16,17,822,822,527,232,232
10006,4,19,0,10006,1976,8030,4932.11,18.1628,360.26,10006,19,19,8380,8380,6885,4760,5522
44405,2,4,0,44405,44405,0,1.26622e+16,1.99986,292.194,44405,3,3,44400,44399,44400,44400,38805
39118,346,378,39099,19,39099,19,2.89596e+16,25.6753,1338.8,39118,154,56,38740,38740,38740,38740,38737
45579,8,20,0,45579,7886,37693,5203.37,15.9531,656.516,45579,20,20,45141,45139,42976,42973,44305
1482,1,16,1482,0,1482,0,84751700000,12.5594,118.029,1482,13,14,208,208,208,208,208
37734,6,40,37734,0,0,37734,339258000,26.8875,733.713,37734,32,29,32840,29784,23639,24642,12464
16877,23,44,16877,0,16877,0,1.37163e+18,30.6812,579.417,16877,33,37,16730,16442,16538,7434,11808
12516,28,65,0,12516,0,12516,1.47381e+15,33.0761,661.592,12516,34,47,12429,12360,12217,11827,938
13039,14,24,13039,0,0,13039,339399000,18.7672,408.234,13039,21,21,12946,12831,12277,12498,10313
20883,1,2,20883,0,20883,0,5.90096e+13,1.99919,199.349,20883,2,2,16504,16504,16504,16504,16504
20631,20,38,20631,0,20631,0,8.6618e+10,29.5337,615.271,20631,32,31,20519,20285,20396,20390,19036
20579,1,2,0,20579,20579,0,8.85182e+15,1.99888,189.061,20579,2,2,18050,18050,18050,18050,18050
22836,18,40,0,22836,0,22836,1298230,32.5692,587.932,22836,33,37,22689,22548,22607,22601,18023
16256,33,60,16256,0,0,16256,318581000,27.8216,636.606,16256,33,40,16192,16153,16064,14630,12261
3080,3,20,3080,0,3080,0,87422100000,16.0945,190.687,3080,16,17,2044,1731,1554,1705,613
22567,1,2,22567,0,22567,0,3.43752e+13,1.99911,197.852,22567,2,2,19810,19810,19810,19810,19810
25655,16,24,0,25655,25655,0,2.24101e+13,21.3172,593.463,25655,23,22,25525,25175,24636,25045,19953
21940,1,2,0,21940,21940,0,8.33556e+15,1.99836,195.229,21940,2,2,19401,19401,19401,19401,19401
11911,10,36,0,11911,11911,0,2.17107e+13,23.5187,398.347,11911,29,25,11605,11325,10491,10621,2994
2327,12,20,0,2327,0,2327,1330210,12.9587,161.862,2327,15,17,2287,2213,2114,2113,2140
33237,1,2,33237,0,33237,0,3.27909e+13,1.99925,240.848,33237,2,2,29364,29364,29364,29364,29364
47235,1,2,47235,0,47235,0,3.30488e+13,1.9997,286.647,47235,2,2,41688,41688,41688,41688,41688
6851,1,2,0,6851,6851,0,8.33011e+15,1.99781,108.993,6851,2,2,6058,6058,6058,6058,6058
35976,2,40,35976,0,35976,0,1.4447e+18,28.5214,732.974,35976,37,37,20617,20595,14456,4357,6765
6482,16,24,6482,0,6482,0,1.45649e+18,18.4096,294.891,6482,18,21,6441,6376,6206,5276,5678
42780,22,40,42780,0,42780,0,86382500000,33.8434,926.284,42780,38,36,42576,42336,42351,42334,32515
20607,1,2,20607,0,20607,0,3.2946e+13,1.99908,189.168,20607,2,2,18194,18194,18194,18194,18194
17269,12,21,2698,14571,0,17269,20.0262,15.4472,375.653,17269,20,20,17227,17227,17217,17224,17219
21684,1,2,21684,0,21684,0,3.67615e+13,1.99949,194.356,21684,2,2,18851,18851,18851,18851,18851
16362,17,36,16362,0,16362,0,1.42385e+18,23.3992,482.32,16362,34,33,16242,16064,16173,4977,12189
36090,3,4,0,36090,36090,0,8.33784e+15,3.29659,258.959,36090,4,4,36084,36080,36083,36083,34860
25946,12,23,4433,21513,0,25946,19.4482,14.4521,523.226,25946,20,21,25822,25817,25724,25756,24802
32318,11,20,0,32318,5541,26777,5189.8,17.655,558.572,32318,20,20,32248,32248,32238,32237,25459
12817,3,36,12817,0,12817,0,1.45197e+18,18.359,407.567,12817,28,25,8663,7372,6664,1560,3128
40288,34,40,40288,0,0,40288,5.59381e+15,34.0883,785.98,40288,38,37,40230,40115,40163,34350,38574
17415,1,2,17415,0,17415,0,3.29559e+13,1.99925,173.818,17415,2,2,15375,15375,15375,15375,15375
11369,16,24,0,11369,0,11369,1334770,17.7847,392.66,11369,20,21,11307,11159,10940,10937,10009
36914,1,2,36914,0,36914,0,6.00557e+13,1.99919,264.156,36914,2,2,29037,29037,29037,29037,29037
33026,57,64,0,33026,0,33026,1308050,23.0078,901.549,33026,32,44,32962,32957,32958,32962,32279
15472,37,60,15472,0,0,15472,4.94415e+15,31.877,766.591,15472,35,52,15409,15342,15231,14569,9603
18626,16,25,3565,15061,0,18626,19.2488,17.582,504.39,18626,20,23,18587,18586,18564,18570,17788
20630,53,60,0,20630,0,20630,1282890,21.9482,697.55,20630,32,40,20570,20562,20566,20569,19484
7662,1,12,0,7662,1354,6308,5225.58,11.8797,260.01,7662,12,12,1203,1203,1203,1203,1203
15309,10,24,15309,0,0,15309,340870000,21.0583,453.52,15309,20,22,14759,14261,12702,12815,9460
5578,1,2,0,5578,5578,0,1.05154e+16,1.99695,98.3396,5578,2,2,4763,4763,4763,4763,4763
38894,9,25,9871,29023,0,38894,16.8822,19.5498,761.087,38894,23,23,37768,37768,37075,37275,28070
7193,10,40,7193,0,7193,0,78110700000,23.6968,377.652,7193,32,33,6676,6237,6180,6046,3413
24406,2,44,0,24406,0,24406,1267650,33.1002,666.313,24406,37,37,14250,14204,10555,5863,4059
41280,1,4,0,41280,41280,0,8.35435e+15,2,274.149,41280,3,3,36491,36491,36491,36491,36491
49557,367,378,0,49557,0,49557,3.58118e+15,36.0231,1524.9,49557,129,71,49179,49179,49179,49179,49179
17968,13,31,3490,14478,6,17962,15664900000,17.7154,520.884,17968,21,24,17907,17901,17900,17902,16179
21098,18,21,0,21098,3407,17691,5173.24,11.7911,418.255,21098,20,20,21074,21074,21074,21074,21071
38931,2,4,0,38931,38931,0,8.34018e+15,1.99956,266.629,38931,3,3,38926,38925,38926,38926,36394
46839,1,2,46839,0,46839,0,6.07432e+13,1.99959,298.357,46839,2,2,36730,36730,36730,36730,36730
19068,1,4,0,19068,19068,0,8.32887e+15,1.99932,188.186,19068,3,3,16861,16861,16861,16861,16861
19522,1,2,0,19522,19522,0,9.31633e+15,1.99964,183.988,19522,2,2,16997,16997,16997,16997,16997
18525,9,40,18525,0,18525,0,1.37336e+18,29.6386,570.426,18525,35,35,17355,15333,15842,3599,7068
25322,20,40,25322,0,0,25322,5.709e+15,31.3503,660.568,25322,31,30,25232,25046,25129,21036,22075
13999,34,36,13999,0,0,13999,320204000,29.5103,468.935,13999,34,33,13960,13909,13941,13236,13953
4688,26,36,4688,0,0,4688,285041000,27.025,302.42,4688,30,29,4632,4505,4558,4128,4219
35064,39,90,34957,107,0,35064,2.30576e+16,42.5731,1050.29,35064,65,37,34957,34861,34839,31055,16353
3057,1,2,3057,0,3057,0,3.22264e+13,1.99248,72.8269,3057,2,2,2706,2706,2706,2706,2706
42164,1,2,42164,0,42164,0,3.96004e+13,1.99981,271.846,42164,2,2,36231,36231,36231,36231,36231
48401,1,2,0,48401,48401,0,9.53404e+15,1.9995,290.523,48401,2,2,41996,41996,41996,41996,41996
49813,6,21,0,49813,8052,41761,5150.73,14.8516,660.134,49813,21,21,48609,48609,47317,47334,47195
31111,20,23,9321,21790,0,31111,15.7114,19.1403,675.645,31111,22,21,31084,31084,30863,30865,31079
3239,9,20,3239,0,0,3239,340579000,15.8598,194.965,3239,15,17,3069,2626,2697,2676,2316
46316,26,28,0,46316,7672,38644,5176.33,18.3146,657.512,46316,28,21,46286,46286,46286,46286,46286
10328,1,2,10328,0,10328,0,3.25408e+13,1.99855,134.05,10328,2,2,9133,9133,9133,9133,9133
10888,20,40,10888,0,10888,0,1.45992e+18,20.0869,437.074,10888,25,29,10834,10748,10784,7701,10251
697,8,22,0,697,697,0,2.1864e+13,12.6514,107.565,697,16,15,623,525,486,552,329
35535,25,40,35535,0,0,35535,5.62209e+15,34.022,728.925,35535,37,37,35435,35322,35363,10935,30435
41464,1,2,41464,0,41464,0,4.21018e+13,1.99945,272.551,41464,2,2,35261,35261,35261,35261,35261
15563,1,2,15563,0,15563,0,4.18695e+13,1.99916,165.496,15563,2,2,13247,13247,13247,13247,13247
39112,35,40,39112,0,0,39112,333080000,34.6686,776.791,39112,38,37,39059,38942,39009,35658,37632
36212,32,40,36212,0,36212,0,86086800000,29.8602,744.443,36212,38,37,36152,36094,36101,36091,34921
31020,1,2,0,31020,31020,0,8.58094e+15,1.99945,231.609,31020,2,2,27325,27325,27325,27325,27325
46319,5,33,11469,34850,1,46318,6076690000,17.9166,1003.05,46319,20,32,39037,39028,35798,34182,21887
36761,22,40,36761,0,36761,0,85769900000,33.4392,738.682,36761,37,37,36641,36510,36561,36401,30768
32928,8,60,0,32928,32928,0,2.18688e+13,35.0131,936.638,32928,38,56,28699,23086,21007,23421,12825
22208,24,44,0,22208,0,22208,1044140,33.3303,770.424,22208,36,37,21996,21610,21500,21393,15646
25007,13,40,25007,0,25007,0,1.23017e+18,36.7629,767.405,25007,37,37,22925,19499,21766,6058,9319
15877,4,40,0,15877,0,15877,1088050,33.0424,622.263,15877,36,37,10724,8750,8858,9179,2677
46284,17,20,8279,38005,0,46284,20.1042,16.2206,727.108,46284,19,20,46238,46238,46202,46202,46185
2816,11,17,472,2344,0,2816,18.3281,11.8537,158.98,2816,16,17,2771,2771,2752,2760,2683
36183,1,2,36183,0,36183,0,3.27738e+13,1.99961,251.452,36183,2,2,31969,31969,31969,31969,31969
29784,8,23,0,29784,5091,24693,4914.2,17.108,558.401,29784,20,21,29271,29241,29061,29150,7305
9284,18,24,0,9284,0,9284,1333680,18.4842,349.097,9284,21,21,9254,9230,9234,9231,8772
5679,1,20,5679,0,5679,0,86368300000,17.4069,253.538,5679,17,19,710,710,710,710,710
45742,27,30,8550,37192,0,45742,19.5132,19.5584,784.81,45742,28,24,45711,45710,45710,45711,45293
28489,1,2,0,28489,28489,0,9.9402e+15,1.99947,223.49,28489,2,2,24558,24558,24558,24558,24558
40510,49,56,0,40510,0,40510,1312860,29.8118,831.758,40510,39,40,40454,40442,40445,40453,40377
38645,1,44,0,38645,38645,0,2.02999e+13,42.5838,930.676,38645,40,41,4321,4321,4321,4321,4321
4323,7,20,4323,0,4323,0,87103500000,16.052,221.762,4323,17,17,3925,3490,3135,3378,1986
37519,15,40,37519,0,37519,0,86869200000,26.3558,729.166,37519,31,29,37289,36866,36382,36370,27777
15717,1,2,0,15717,15717,0,8.986e+15,1.99885,164.64,15717,2,2,13756,13756,13756,13756,13756
2838,12,19,527,2311,0,2838,19.828,11.4704,180.149,2838,19,14,2812,2812,2812,2812,2812
15007,7,40,15007,0,15007,0,1.45698e+18,21.9594,501.167,15007,29,29,13247,11469,9679,3440,6192
22561,18,44,22561,0,22561,0,1.29775e+18,31.8467,734.115,22561,37,41,22073,21213,21533,9304,12043
1848,19,20,1848,0,0,1848,340483000,13.6921,146.983,1848,15,16,1828,1820,1827,1827,1828
16223,1,2,0,16223,16223,0,1.29298e+16,1.9992,171.909,16223,2,2,13311,13311,13311,13311,13311
48626,42,44,0,48626,0,48626,1185470,38.1534,1059.08,48626,40,41,48582,48563,48552,48552,48582
30524,1,2,30524,0,30524,0,3.28652e+13,1.99967,230.418,30524,2,2,26959,26959,26959,26959,26959
38623,1,2,38623,0,38623,0,6.38553e+13,1.99974,272.956,38623,2,2,29860,29860,29860,29860,29860
4169,1,2,4169,0,4169,0,3.38931e+13,1.99424,84.5199,4169,2,2,3666,3666,3666,3666,3666
17960,1,2,0,17960,17960,0,1.34887e+16,1.99855,181.551,17960,2,2,14597,14597,14597,14597,14597
6390,35,44,6390,0,0,6390,301528000,22.0191,442.28,6390,28,41,6346,6340,6299,6149,5499
44371,35,40,0,44371,44371,0,2.00093e+13,32.8722,971.221,44371,40,37,44315,44161,44084,44066,41250
27376,5,20,4908,22468,0,27376,20.1327,16.9471,565.002,27376,20,20,25037,25035,22158,21181,9583
44043,34,40,44043,0,44043,0,8.7297e+10,30.9331,846.53,44043,32,31,43997,43957,43990,43990,41620
30114,10,31,0,30114,10407,19707,2.39275e+12,18.998,714.56,30114,27,24,29280,29211,28053,19291,13205
46949,16,65,46948,1,0,46949,7.82758e+14,37.3429,1180.66,46949,40,48,45643,40800,43050,42962,29550
7300,5,11,0,7300,1107,6193,5146.79,9.21452,220.507,7300,11,11,6964,6964,6251,6253,6359
43505,7,38,0,43505,43505,0,2.14831e+13,35.456,1030.61,43505,38,38,35892,29713,24482,29005,11390
18861,40,44,18861,0,0,18861,318220000,33.3554,654.403,18861,31,41,18817,18802,18749,18562,18375
47385,21,23,0,47385,9641,37744,4674.98,20.8692,778.994,47385,22,22,47360,47360,47280,47282,47360
8715,3,19,1388,7327,0,8715,19.4635,13.1784,275.176,8715,18,18,7100,7100,7075,6831,5905
25320,47,64,25320,0,0,25320,5.57779e+15,32.3311,856.389,25320,38,55,25256,25256,25252,25256,24749
41706,10,20,0,41706,7536,34170,5147.87,17.3295,691.642,41706,20,20,41424,41424,41264,41263,40878
45098,1,4,0,45098,45098,0,1.02755e+16,2.00013,289.168,45098,3,3,38664,38664,38664,38664,38664
7467,1,2,0,7467,7467,0,8.37632e+15,1.99799,114.808,7467,2,2,6598,6598,6598,6598,6598
48933,1,2,0,48933,48933,0,8.80306e+15,1.99986,291.255,48933,2,2,42954,42954,42954,42954,42954
42784,20,40,42784,0,0,42784,5.71045e+15,22.0912,786.438,42784,32,29,42720,42624,42620,13948,38251
11523,1,2,11523,0,11523,0,3.86439e+13,1.99766,143.816,11523,2,2,9940,9940,9940,9940,9940
5640,16,20,5640,0,5640,0,1.45454e+18,16.9778,251.774,5640,17,19,5612,5592,5575,4958,5536
19985,4,21,7441,12544,0,19985,14.673,17.2426,531.986,19985,20,19,13191,13191,13038,13008,9285
15790,24,30,0,15790,2879,12911,4832.9,15.0246,469.743,15790,19,25,15760,15760,15760,15760,15257
36924,18,60,36924,0,36924,0,1.42015e+18,25.2376,872.768,36924,44,40,36611,36201,36260,16037,28310
15922,1,2,15922,0,15922,0,3.22984e+13,1.999,167.758,15922,2,2,14094,14094,14094,14094,14094
36954,49,64,0,36954,0,36954,1090590,38.0312,1027.4,36954,38,44,36890,36882,36884,36757,25121
5091,5,40,0,5091,5091,0,1.95282e+13,24.0108,334.683,5091,29,33,3948,3115,3258,3292,1658
16537,5,21,0,16537,2628,13909,5139.26,16.1853,371.358,16537,20,20,15639,15639,14089,14076,14326
4353,31,38,0,4353,0,4353,1302590,21.337,286.882,4353,27,27,4315,4299,4310,4311,4315
28251,2,4,0,28251,28251,0,8.34308e+15,1.99979,227.651,28251,3,3,28246,28245,28246,28246,27684
6512,1,12,1170,5342,0,6512,20.4386,10.9274,239.842,6512,12,12,1001,1001,1001,1001,1001
32962,11,56,0,32962,0,32962,1310190,30.1778,773.593,32962,37,40,31871,30406,28714,28815,15763
4592,1,2,0,4592,4592,0,8.34814e+15,1.99891,89.005,4592,2,2,4059,4059,4059,4059,4059
5031,9,36,5031,0,5031,0,1.42843e+18,17.966,257.618,5031,25,25,4805,4261,4347,996,2970
22748,4,24,0,22748,22748,0,2.24189e+13,21.8635,568.897,22748,24,22,16358,12401,12003,14267,5691
38970,2,40,38970,0,38970,0,86063300000,29.1033,766.365,38970,37,37,22353,22329,15696,18114,4845
14008,22,24,14008,0,0,14008,342045000,21.6167,455.68,14008,23,22,13983,13970,13982,13982,13202
30947,23,40,30947,0,30947,0,85652900000,35.8574,687.283,30947,37,37,30836,30702,30759,30598,26139
13949,1,2,13949,0,13949,0,3.25687e+13,1.999,155.941,13949,2,2,12334,12334,12334,12334,12334
33702,38,40,33702,0,33702,0,87199700000,22.4677,699.809,33702,32,29,33662,33648,33662,33658,33662
10590,18,19,1923,8667,0,10590,20.2682,11.3753,327.293,10590,19,19,10570,10570,10570,10570,10570
26522,6,19,0,26522,4886,21636,5120.39,16.1064,562.65,26522,19,19,25138,25138,23278,22089,18968
35212,1,2,35212,0,35212,0,6.27587e+13,1.99983,259.639,35212,2,2,27360,27360,27360,27360,27360
12042,4,22,12042,0,12042,0,1.47294e+18,19.1922,413.403,12042,21,21,8580,6482,6252,1816,3239
13099,18,24,13099,0,0,13099,342865000,20.1622,430.489,13099,21,21,13063,13031,12933,12931,12277
37468,30,38,37468,0,37468,0,1.45143e+18,36.4859,903.952,37468,38,38,37318,36984,37151,31257,34152
20541,1,2,0,20541,20541,0,8.35252e+15,1.99917,189.581,20541,2,2,18159,18159,18159,18159,18159
21286,2,4,0,21286,21286,0,8.32762e+15,3.45438,200.918,21286,4,4,21278,21276,21278,21278,19206
35749,8,60,0,35749,0,35749,1248900,28.1627,964.766,35749,36,44,31404,26353,25033,26103,12174
8180,1,19,1479,6701,0,8180,20.2015,11.3627,291.417,8180,19,15,1251,1251,1251,1251,1251
31067,4,56,31067,0,0,31067,5.56401e+15,32.5599,871.636,31067,38,51,21900,16742,15985,4850,5813
31206,1,4,0,31206,31206,0,8.38201e+15,1.99981,238.632,31206,3,3,27573,27573,27573,27573,27573
16863,1,2,0,16863,16863,0,9.28121e+15,1.99899,170.625,16863,2,2,14690,14690,14690,14690,14690
39307,1,2,39307,0,39307,0,4.92816e+13,1.99967,266.918,39307,2,2,32424,32424,32424,32424,32424
45137,1,2,45137,0,45137,0,3.36184e+13,1.99984,280.538,45137,2,2,39745,39745,39745,39745,39745
40692,1,2,0,40692,40692,0,8.64153e+15,1.99953,265.881,40692,2,2,35811,35811,35811,35811,35811
20207,48,56,0,20207,20207,0,2.215e+13,22.3615,595.664,20207,30,32,20151,20139,20151,20151,20149
621,28,32,0,621,621,0,2.07933e+13,8.81159,96.4997,621,16,21,589,585,589,584,589
9328,8,36,0,9328,0,9328,1314990,18.4705,346.741,9328,26,25,8708,7645,7375,7657,4716
34103,44,56,0,34103,34103,0,2.22622e+13,22.57,746.904,34103,31,32,34047,34034,34047,34047,34045
41931,22,40,41931,0,0,41931,341087000,23.3085,804.499,41931,32,28,41881,41825,41841,41837,37862
2622,2,20,2622,0,2622,0,87445700000,13.3051,172.137,2622,15,17,1477,1477,998,1208,478
17908,13,20,0,17908,3129,14779,5198.85,11.6112,415.743,17908,19,18,17882,17882,17882,17882,17881
31840,2,44,31840,0,0,31840,326102000,34.5246,766.23,31840,37,37,18445,18390,13537,7403,4311
31851,23,56,31851,0,31851,0,1.44068e+18,29.8969,757.152,31851,45,40,31735,31614,31662,12648,25538
10290,2,19,0,10290,1565,8725,5118.51,9.85782,274.991,10290,19,18,7210,7210,7205,5765,5762
37517,12,21,0,37517,6235,31282,5199.78,12.2539,566.024,37517,21,20,37482,37482,37467,37472,37474
21170,18,21,5979,15191,0,21170,15.9737,17.5431,546.116,21170,20,20,21142,21141,21025,21027,21108
44388,1,4,0,44388,44388,0,1.10599e+16,2.00002,287.22,44388,3,3,37572,37572,37572,37572,37572
46849,34,38,46849,0,46849,0,1.45245e+18,35.0428,998.955,46849,38,38,46759,46467,46704,42959,45015
39766,54,66,0,39766,39765,1,5.60439e+14,33.6039,1153.05,39766,38,60,39700,39696,39693,39700,37877
4221,1,2,4221,0,4221,0,3.24086e+13,1.99763,86.475,4221,2,2,3734,3734,3734,3734,3734
42718,8,32,0,42718,10512,32206,4355.46,19.9629,826.025,42718,23,27,40496,40126,39677,39890,18107
42804,4084,11331,42257,547,0,42804,1.18562e+18,275.947,14402,42804,3149,255,31473,31185,26503,25063,4372
35729,35,44,35729,0,35729,0,66269100000,36.7764,990.454,35729,39,37,35673,35561,35350,35407,34644
10219,16,40,10219,0,10219,0,1.3219e+18,31.8736,445.394,10219,33,34,9905,9247,9722,2261,6317
25099,1,2,0,25099,25099,0,8.35155e+15,1.99968,209.764,25099,2,2,22189,22189,22189,22189,22189
5979,1,2,5979,0,5979,0,3.27658e+13,1.99599,102.544,5979,2,2,5282,5282,5282,5282,5282
28216,6,20,0,28216,4802,23414,5203.83,11.8902,508.468,28216,20,17,27316,27316,26315,26035,25308
23513,32,40,0,23513,0,23513,1309260,29.4134,572.7,23513,31,29,23463,23415,23450,23450,21070
21566,1,40,0,21566,21566,0,1.59205e+13,32.5359,749.349,21566,37,33,936,936,936,936,936
43894,31,44,43894,0,43894,0,79283600000,37.8893,968.896,43894,38,41,43794,43454,43420,43182,37499
47729,1,2,47729,0,47729,0,4.28856e+13,1.99975,292.535,47729,2,2,40456,40456,40456,40456,40456
27246,2,60,0,27246,27246,0,2.18989e+13,23.4761,808.737,27246,32,44,14451,14428,9672,11966,4164
37676,15,40,37676,0,37676,0,1.44621e+18,29.3349,758.046,37676,38,37,37382,36883,36733,7196,22174
32424,35,40,0,32424,0,32424,1200140,34.6578,813.731,32424,39,37,32371,32240,32160,32162,30720
44242,602,692,0,44242,0,44242,2.34001e+16,41.5294,1827.17,44242,133,95,43550,43548,43550,43550,11617
39722,18,38,39722,0,0,39722,337036000,32.6661,895.611,39722,38,34,39327,38864,38439,38376,32683
43548,17,21,0,43548,7084,36464,5148.5,15.3979,623.403,43548,21,21,43511,43511,43489,43489,43419
24111,34,56,0,24111,24111,0,2.22203e+13,22.247,644.597,24111,31,32,24055,24039,24052,24051,23403
31973,36,44,31973,0,31973,0,1.34817e+18,36.6777,836.109,31973,36,41,31925,31887,31747,27910,29047
3162,1,2,0,3162,3162,0,8.34063e+15,1.99146,74.6741,3162,2,2,2795,2795,2795,2795,2795
27142,18,28,0,27142,4569,22573,5124.26,12.549,540.28,27142,19,25,27110,27109,27086,27086,26837
47879,39,56,0,47879,47879,0,2.21049e+13,35.9095,908.325,47879,40,40,47822,47782,47773,47767,47812
14119,2,5,30,14089,14119,0,1.46218e+16,3.11247,175.075,14119,5,5,14104,14097,11732,14099,12451
16213,1,2,16213,0,16213,0,4.31075e+13,1.99883,169.054,16213,2,2,13729,13729,13729,13729,13729
46928,42,48,0,46928,46928,0,1.90643e+13,36.1292,1102.67,46928,39,41,46880,46867,46442,46499,39861
1998,9,11,0,1998,311,1687,5154.85,7.25275,118.845,1998,9,10,1986,1986,1978,1978,1979
31768,1,2,0,31768,31768,0,8.73501e+15,1.99959,234.836,31768,2,2,27916,27916,27916,27916,27916
48499,2,5,1,48498,48499,0,1.09842e+16,1.99986,305.59,48499,4,3,48493,48492,48493,48491,44903
13658,26,32,0,13658,3262,10396,4730.88,15.6335,546.557,13658,19,31,13626,13626,13626,13626,12579
15920,20,60,15920,0,15920,0,75296800000,34.7318,699.186,15920,36,44,15621,15079,15210,14603,7758
47716,31,60,0,47716,47716,0,2.16161e+13,31.5927,973.986,47716,37,44,47616,47404,47437,47393,34563
6437,8,22,0,6437,0,6437,1343950,17.3199,299.667,6437,19,19,5798,4786,4445,4823,3459
42777,20,28,7089,35688,0,42777,20.0706,15.4107,656.922,42777,21,27,42746,42744,42736,42736,42565
10292,6,24,0,10292,10292,0,2.228e+13,21.9702,377.609,10292,21,22,8903,8050,6301,7695,3933
42317,1,2,42317,0,42317,0,4.4672e+13,1.99929,274.714,42317,2,2,35600,35600,35600,35600,35600
26068,12,20,4489,21579,0,26068,20.2423,12.1669,502.947,26068,19,19,26038,26037,26028,26028,26002
28513,24,31,8696,19817,6,28507,9871510000,16.9235,718.008,28513,26,24,28482,28480,28477,28352,21582
6590,9,38,6590,0,6590,0,83826800000,33.163,365.496,6590,31,31,5901,4676,4309,4663,2708
43089,43,44,43089,0,0,43089,5.51994e+15,32.5258,866.481,43089,37,38,43045,43031,43005,39793,41714
25828,19,48,25824,4,25824,4,3.30824e+12,33.8166,864.678,25828,40,41,24977,22210,22985,17064,13086
16203,12,36,0,16203,0,16203,1301500,22.3873,493.799,16203,35,25,15869,15283,14682,14686,2785
33479,25,40,0,33479,0,33479,1213680,32.4707,834.743,33479,40,37,33276,32861,32888,32892,23830
8233,1,2,8233,0,8233,0,4.61546e+13,1.99951,121.054,8233,2,2,6882,6882,6882,6882,6882
2154,5,18,0,2154,2154,0,2.237e+13,12.8473,155.044,2154,15,15,1747,1299,1231,1547,844
47247,58,64,47247,0,47247,0,1.26131e+18,37.7117,1306.69,47247,51,46,47183,47173,47183,44077,41172
35158,1,2,35158,0,35158,0,3.27686e+13,1.99977,247.8,35158,2,2,31064,31064,31064,31064,31064
21022,37,40,21022,0,0,21022,4.98777e+15,35.9566,686.188,21022,37,37,20976,20945,20804,18768,18490
14918,10,24,14918,0,0,14918,5.7332e+15,19.5507,447.007,14918,22,21,14370,13875,12267,6648,8534
22040,21,40,22040,0,22040,0,85352900000,30.0093,568.547,22040,34,29,21947,21846,21901,21792,11386
7646,1,36,7646,0,7646,0,84400700000,22.1958,310.625,7646,25,25,1011,1011,1011,1011,1011
36139,14,20,6180,29959,0,36139,20.3478,12.2131,572.679,36139,20,19,36113,36113,36113,36113,36113
46046,31,60,0,46046,46046,0,2.09178e+13,30.0244,1058.1,46046,39,44,45944,45686,45674,45662,33489
7339,31,38,0,7339,0,7339,1309360,29.5542,376.573,7339,30,29,7294,7255,7284,7284,7294
41580,1,2,41580,0,41580,0,3.24529e+13,1.99969,270.858,41580,2,2,36785,36785,36785,36785,36785
46593,1,2,46593,0,46593,0,3.21268e+13,1.99953,287.722,46593,2,2,41274,41274,41274,41274,41274
18014,29,64,0,18014,18014,0,1.94824e+13,27.5376,799.012,18014,32,44,17933,17867,17795,17825,11712
18309,11,21,0,18309,6811,11498,3718.15,17.4202,507.064,18309,20,19,18046,18046,17680,17719,15559
4118,5,17,0,4118,1638,2480,3575.79,13.5032,227.54,4118,16,16,2894,2894,2883,2894,2232
32828,36,40,32828,0,0,32828,300273000,34.6256,829.472,32828,38,37,32778,32738,32591,30521,31860
13927,8,20,2434,11493,0,13927,20.3099,11.2329,368.987,13927,19,18,13775,13774,13172,13170,13435
8741,17,60,8741,0,8741,0,72107900000,28.9688,558.576,8741,32,44,8331,6395,7828,7466,4099
48584,20,40,48584,0,48584,0,86493800000,28.246,861.433,48584,40,37,48452,48314,48315,48136,36538
30185,32,44,0,30185,0,30185,1233730,36.2533,806.158,30185,36,41,30119,30041,29919,29926,26596
38068,29,30,0,38068,7200,30868,5013.59,13.0086,723.755,38068,20,24,38038,38038,38038,38038,38001
34953,15,40,0,34953,34953,0,1.99697e+13,35.5152,853.293,34953,39,37,33623,30642,32703,31520,15231
33550,2,44,33550,0,33550,0,1.41123e+18,33.7072,782.238,33550,36,37,19278,19231,13945,4203,5223
20653,1,2,0,20653,20653,0,1.35023e+16,1.99893,197.246,20653,2,2,16782,16782,16782,16782,16782
30506,25,40,30506,0,0,30506,5.72251e+15,21.7454,690.407,30506,32,26,30466,30444,30453,29884,30466
38590,13,41,0,38590,14637,23953,1.30704e+13,20.5323,764.989,38590,35,20,38372,38349,38075,26012,30305
42680,1,2,42680,0,42680,0,3.37005e+13,1.99955,272.32,42680,2,2,37569,37569,37569,37569,37569
13780,1,24,13780,0,0,13780,342966000,20.3058,441.75,13780,21,21,1423,1423,1423,1423,1423
25364,1,2,0,25364,25364,0,1.71309e+16,1.9987,223.057,25364,2,2,19333,19333,19333,19333,19333
44792,1,2,44792,0,44792,0,4.73063e+13,1.99955,284.657,44792,2,2,37263,37263,37263,37263,37263
28401,9,23,4857,23544,0,28401,19.3116,19.3823,553.402,28401,21,21,28075,28075,27968,28038,26962
23658,1,2,0,23658,23658,0,1.1105e+16,1.99882,204.439,23658,2,2,20011,20011,20011,20011,20011
15091,12,40,15091,0,15091,0,1.4354e+18,24.4069,493.03,15091,31,37,14741,14146,13574,8788,9676
44052,28,40,44052,0,0,44052,5.06131e+15,34.0784,974.878,44052,40,37,43886,43550,43420,19322,34849
47537,12,40,47537,0,0,47537,4.88296e+15,34.3464,1061.48,47537,40,37,43297,37520,40507,9772,17442
14100,29,40,0,14100,14100,0,1.96646e+13,31.6477,525.206,14100,34,33,14030,13890,13878,13792,12177
39236,3,40,39236,0,0,39236,5.72666e+15,28.5035,803.86,39236,32,30,24910,20962,18422,4277,5576
25178,44,56,25178,0,25178,0,84734600000,34.5298,749.887,25178,37,47,25122,25110,25113,25118,20621
9391,20,36,9391,0,0,9391,5.47328e+15,27.7149,376.629,9391,32,29,9299,9223,9252,1814,6030
2937,4,22,2937,0,2937,0,1.46755e+18,17.2806,206.3,2937,17,19,2098,1586,1526,459,987
44866,16,48,0,44866,0,44866,1125530,36.6054,1071.64,44866,39,41,42647,34982,40323,40238,16658
10690,1,2,10690,0,10690,0,3.24921e+13,1.99869,137.533,10690,2,2,9455,9455,9455,9455,9455
28863,16,24,28863,0,0,28863,5.73155e+15,21.8595,646.307,28863,24,22,28680,28191,27611,23225,21658
5701,1,2,5701,0,5701,0,3.25367e+13,1.99825,99.3081,5701,2,2,5041,5041,5041,5041,5041
13112,3,21,0,13112,2122,10990,5153.89,12.4385,338.647,13112,20,20,10408,10408,10364,9297,5944
42735,28,40,0,42735,0,42735,1200780,33.224,943.114,42735,40,37,42581,42275,42163,42165,32033
15578,47,56,15578,0,15578,0,1.42172e+18,24.8141,562.686,15578,41,40,15522,15512,15520,13759,14927
39937,28,44,0,39937,39937,0,2.00639e+13,37.4579,944.082,39937,40,41,39791,39526,39370,38827,30415
23511,1,2,0,23511,23511,0,8.37316e+15,1.99928,202.71,23511,2,2,20778,20778,20778,20778,20778
12938,18,21,0,12938,2043,10895,5144.69,10.0322,326.096,12938,17,20,12917,12917,12914,12914,12911
48072,42,64,48072,0,0,48072,4.8648e+15,37.4177,1217.69,48072,40,51,48008,47998,47566,42737,25107
20743,16,21,4499,16244,0,20743,17.6175,19.7677,512.083,20743,21,20,20686,20680,20544,20544,19094
13261,35,36,13261,0,13261,0,84458700000,24.1083,435.408,13261,33,33,13223,13185,13215,13216,13215
22929,4,40,22929,0,22929,0,1.46355e+18,22.2338,609.361,22929,31,29,16429,12459,12013,2848,5606
15708,18,24,15708,0,0,15708,5.7378e+15,21.3454,484.738,15708,23,22,15652,15590,15442,12735,13905
1376,7,10,246,1130,0,1376,20.4564,8.48837,106.389,1376,10,10,1333,1333,1300,1300,1250
27758,18,40,27758,0,0,27758,334986000,31.0686,654.212,27758,36,37,27617,27470,27529,26639,21628
5130,2,18,5130,0,0,5130,5.75811e+15,15.9425,253.432,5130,18,18,2812,2812,1862,634,932
49602,16,23,0,49602,14673,34929,4056.07,20.0062,853.914,49602,23,21,49502,49493,49092,49098,48696
26778,27,60,26778,0,0,26778,331111000,24.228,821.009,26778,32,44,26711,26659,26649,26477,24929
40194,11,40,0,40194,40194,0,1.62507e+13,35.0785,1037.31,40194,38,37,30096,18346,24714,22852,13224
1919,17,18,1919,0,0,1919,346210000,15.0026,158.155,1919,16,18,1898,1865,1897,1896,1895
6441,15,19,2526,3915,0,6441,14.5524,14.9896,290.115,6441,18,17,6416,6416,6380,6384,6410
38394,29,40,38394,0,38394,0,1.44535e+18,29.2168,761.855,38394,38,37,38322,38242,38274,30500,32150
18057,53,56,0,18057,0,18057,1294690,37.4813,578.507,18057,36,36,18001,17991,17998,17999,16993
45947,40,48,45947,0,45947,0,74317200000,36.1624,1094.27,45947,38,41,45899,45886,45463,45536,37305
48216,14,60,48216,0,48216,0,81852700000,29.9079,1074.42,48216,40,44,46691,44096,43681,43734,24655
33207,34,44,0,33207,0,33207,1215030,30.2175,850.311,33207,38,41,33148,33065,32893,32896,28060
3087,5,20,0,3087,3087,0,2.21213e+13,13.5497,185.421,3087,15,17,2554,1929,1899,2238,1184
12663,1,2,0,12663,12663,0,8.34213e+15,1.99818,148.333,12663,2,2,11196,11196,11196,11196,11196
34152,13,60,34152,0,34152,0,81845800000,32.0591,1049.99,34152,38,55,32260,28538,28762,28575,18835
23346,18,21,3801,19545,0,23346,19.552,17.6399,473.329,23346,20,20,23318,23316,23293,23295,23284
42208,9,40,42208,0,0,42208,329262000,35.3152,831.907,42208,38,37,39926,34962,35986,35839,12670
13000,7,60,13000,0,13000,0,80992500000,29.1438,588.063,13000,32,40,11211,9698,8950,9423,4437
10834,5,20,10834,0,10834,0,86955500000,17.497,369.601,10834,20,19,8766,6569,6649,7671,4023
20936,6,40,20936,0,20936,0,1.46274e+18,22.4703,587.336,20936,24,29,17688,15741,12571,3203,6751
45834,33,44,45834,0,0,45834,5.53299e+15,31.67,889.921,45834,37,38,45767,45655,45604,36761,41214
41715,51,56,41715,0,41715,0,1.44691e+18,29.1744,855.355,41715,45,40,41659,41647,41659,36189,41604
9696,5,36,0,9696,9696,0,1.9461e+13,25.644,439.019,9696,33,29,7666,6087,6608,6411,1755
5633,1,2,0,5633,5633,0,8.31483e+15,1.99822,98.3832,5633,2,2,4982,4982,4982,4982,4982
13880,6,24,13880,0,13880,0,1.47157e+18,19.9999,434.529,13880,21,21,11861,10633,8257,2084,4749
23282,1,4,0,23282,23282,0,8.406e+15,1.9994,206.972,23282,3,3,20563,20563,20563,20563,20563
4527,6,40,4527,0,0,4527,5.41288e+15,27.8571,293.741,4527,24,33,3908,3561,3013,837,1500
4817,6,21,0,4817,814,4003,4886.8,11.2346,232.406,4817,17,20,4627,4627,4527,4537,2581
7218,1,19,0,7218,1180,6038,4985.94,15.5863,257.59,7218,18,19,1462,1462,1462,1462,1462
12505,1,23,0,12505,2278,10227,4767.39,15.6918,383.011,12505,19,21,2776,2776,2776,2776,2776
14375,41,60,0,14375,14375,0,1.98911e+13,25.8924,680.749,14375,33,44,14315,14307,14204,14200,10669
1654,14,18,0,1654,0,1654,1337660,13.5405,138.963,1654,15,15,1634,1626,1606,1606,1631
24254,1,2,24254,0,24254,0,3.85528e+13,1.99897,206.205,24254,2,2,20931,20931,20931,20931,20931
27100,23,40,0,27100,27100,0,2.19542e+13,31.4871,648.449,27100,37,37,27000,26887,26931,26796,21151
14381,47,48,14377,4,14377,4,5.88666e+12,31.5617,665.657,14381,37,41,14333,14326,14333,14279,14268
12595,2,4,12595,0,12595,0,5.09091e+13,1.99833,155.832,12595,3,3,12590,12589,12589,12589,11700
36155,25,40,36155,0,0,36155,5.72526e+15,27.8432,773.448,36155,31,30,36101,36059,36077,34796,35166
22020,8,31,0,22020,7454,14566,3.27227e+12,18.3944,631.351,22020,26,24,20087,19605,19294,13243,9671
21226,2,21,4536,16690,0,21226,17.6186,18.5595,511.44,21226,20,20,14374,14374,14360,12918,5450
40322,46,56,40322,0,0,40322,5.65212e+15,28.0895,839.581,40322,37,40,40266,40254,40257,40266,36958
27073,1,2,27073,0,27073,0,3.25111e+13,1.99948,218.473,27073,2,2,23945,23945,23945,23945,23945
35064,3,4,0,35064,35064,0,1.12164e+16,1.9998,256.344,35064,3,3,35060,35058,35059,35059,35060
13171,10,13,0,13171,2247,10924,5235.3,10.6287,327.072,13171,12,12,13151,13151,13129,13128,13151
31832,19,44,0,31832,31832,0,2.02383e+13,33.0974,826.465,31832,40,39,31333,30317,30789,29855,16411
14556,51,60,14556,0,0,14556,5.09795e+15,25.6757,683.587,14556,33,44,14496,14488,14489,14496,12701
22835,43,56,22835,0,0,22835,334513000,23.402,658.299,22835,36,40,22779,22769,22770,22691,19065
36870,15,30,0,36870,6400,30470,5041.73,14.2149,663.372,36870,20,26,36801,36801,36726,36728,35965
34369,1,2,34369,0,34369,0,4.70667e+13,1.99988,248.431,34369,2,2,28621,28621,28621,28621,28621
15012,1,2,0,15012,15012,0,1.72608e+16,1.99933,169.81,15012,2,2,11415,11415,11415,11415,11415
8328,1,19,0,8328,1951,6377,4266.79,15.1216,314.438,8328,19,17,2217,2217,2217,2217,2217
7060,19,36,7060,0,7060,0,62567800000,28.1618,416.208,7060,30,30,6769,5697,5908,5587,4961
19820,26,40,0,19820,0,19820,1302020,29.3774,663.605,19820,38,34,19696,19516,19555,19556,18484
3400,13,32,0,3400,3400,0,1.64047e+13,25.2435,279.569,3400,27,27,2602,1145,2101,1987,1769
42382,23,40,42382,0,42382,0,1.44861e+18,29.1673,807.3,42382,39,37,42278,42138,42199,8160,32189
31350,19,44,31350,0,31350,0,83786800000,31.7172,738.905,31350,37,37,31097,30700,30941,30474,23327
26213,10,23,0,26213,4436,21777,4970.54,14.4575,522.105,26213,20,21,26011,26005,25905,25951,25277
3667,3,11,0,3667,585,3082,5203.22,8.81238,159.248,3667,10,10,2920,2920,2918,2109,1702
31293,1,24,31293,0,0,31293,5.72463e+15,21.237,658.5,31293,24,22,3430,3430,3430,3430,3430
4471,1,2,4471,0,4471,0,3.39331e+13,1.99866,87.6368,4471,2,2,3931,3931,3931,3931,3931
35606,18,21,0,35606,6821,28785,4772.1,16.7359,648.32,35606,21,20,35570,35567,35414,35414,34578
11565,32,40,11565,0,11565,0,6.3027e+10,33.0692,553.339,11565,34,33,11519,11489,11399,11436,11177
4204,1,32,0,4204,4204,0,2.07673e+13,20.1634,247.856,4204,29,28,563,563,563,563,563
25072,28,40,25072,0,0,25072,339787000,22.2682,598.479,25072,30,29,25032,25014,25027,25026,25030
7430,4,11,1203,6227,0,7430,20.3661,9.37524,231.801,7430,11,10,6734,6734,6143,6063,5944
9052,13,24,9052,0,0,9052,342684000,17.1586,346.718,9052,19,21,8915,8436,8179,8334,7398
39619,7,21,0,39619,6396,33223,5173.48,14.2065,574.135,39619,21,20,39046,39046,37638,37993,38172
14773,35,40,14773,0,14773,0,8.6382e+10,18.799,450.825,14773,25,29,14733,14720,14733,14724,14733
7830,31,36,7830,0,7830,0,62946800000,29.777,446.229,7830,32,33,7791,7729,7757,7765,7671
41126,9,21,0,41126,9957,31169,4348.95,18.4608,742.659,41126,21,20,40005,40005,39341,39561,18242
19733,10,19,3683,16050,0,19733,19.9061,15.6317,489.95,19733,19,19,19521,19521,19425,19424,19051
15391,1,2,0,15391,15391,0,9.00778e+15,1.99929,163.421,15391,2,2,13466,13466,13466,13466,13466
37503,4,64,37503,0,0,37503,5.24075e+15,26.4588,1072.91,37503,33,44,24931,19198,18784,5312,7055
6431,1,2,6431,0,6431,0,3.26513e+13,1.99767,105.638,6431,2,2,5684,5684,5684,5684,5684
31720,15,19,6011,25709,0,31720,19.7692,18.7604,637.703,31720,19,19,31605,31605,31505,31509,23153
40120,20,40,40120,0,0,40120,339206000,26.2955,753.026,40120,32,29,40045,39971,39964,39963,35312
34838,18,40,34838,0,0,34838,335005000,34.3696,723.204,34838,37,37,34672,34486,34554,33665,26029
14576,1,2,14576,0,14576,0,3.29829e+13,1.99959,159.994,14576,2,2,12867,12867,12867,12867,12867
36482,13,28,0,36482,6087,30395,5146.61,12.683,609.964,36482,20,25,36417,36417,36382,36392,36282
10096,25,40,0,10096,0,10096,981586,33.6486,520.892,10096,33,33,10003,9815,9604,9624,8323
30378,11,21,4866,25512,0,30378,19.9768,16.0966,519.609,30378,20,21,30287,30287,30249,30273,30167
33016,1,2,33016,0,33016,0,3.2533e+13,1.9997,240.72,33016,2,2,29199,29199,29199,29199,29199
41654,15,64,41654,0,0,41654,4.76476e+15,38.1509,1139.11,41654,38,51,38830,31517,36618,9812,10446
22052,1,56,0,22052,0,22052,1320990,21.6495,606.634,22052,29,31,2487,2487,2487,2487,2487
22784,216,378,0,22784,0,22784,7.78936e+15,23.3682,1090.21,22784,129,71,22406,22385,22368,22373,22373
29808,21,40,29808,0,0,29808,323002000,28.4539,724.511,29808,37,35,29565,29176,29366,16299,13822
24820,20,21,0,24820,4037,20783,5187.66,11.5871,451.526,24820,20,20,24798,24798,24798,24798,24795
35888,1,2,35888,0,35888,0,3.24863e+13,1.99969,251.583,35888,2,2,31745,31745,31745,31745,31745
1734,1,21,511,1223,0,1734,15.0334,13.0265,158.773,1734,16,17,509,509,509,509,509
38157,9,44,38157,0,0,38157,313511000,36.0638,896.192,38157,38,41,34971,30317,31601,31448,13740
43438,3,64,0,43438,43438,0,2.00548e+13,32.8698,1258.46,43438,38,55,25783,21867,19402,20565,6328
14717,2,36,14717,0,14717,0,83185300000,28.6999,472.252,14717,33,33,8839,8812,6647,7028,2864
31582,39,56,31582,0,31582,0,1.43643e+18,31.9764,875.238,31582,47,42,31526,31516,31519,22774,28245
4172,3,20,0,4172,4172,0,2.24119e+13,15.5736,219.566,4172,16,17,2765,2340,2098,2314,986
47743,10,56,0,47743,47743,0,2.21288e+13,28.1598,907.224,47743,37,40,45820,44098,39401,39250,20815
32872,50,79,32135,737,32867,5,1.08178e+15,22.8982,786.702,32872,34,37,32793,32779,32668,32661,31024
2969,20,32,0,2969,0,2969,969995,23.1256,260.134,2969,26,27,2867,2432,2484,2482,2509
11305,1,2,11305,0,11305,0,3.24673e+13,1.9985,141.333,11305,2,2,10000,10000,10000,10000,10000
9023,17,60,9023,0,0,9023,5.23968e+15,30.901,566.85,9023,35,48,8682,7844,8320,6299,5796
30643,27,44,0,30643,0,30643,1265980,33.8347,737.26,30643,37,37,30521,30220,30305,30308,26453
39199,12,40,39199,0,0,39199,5.6374e+15,29.002,768.214,39199,37,37,38431,36937,35085,12551,18495
36840,7,40,36840,0,0,36840,339390000,35.6116,810.78,36840,33,32,31739,26832,23124,21134,13636
15509,1,13,0,15509,2707,12802,5219.11,11.7634,368.235,15509,13,12,2466,2466,2466,2466,2466
25134,18,24,25134,0,0,25134,5.7238e+15,21.0445,579.244,25134,23,22,25086,25016,24876,21174,22677
12750,10,36,12750,0,0,12750,5.53987e+15,25.2347,432.971,12750,34,33,12353,11994,11163,2089,5836
33013,12,44,33013,0,0,33013,313761000,37.7289,847.368,33013,37,41,31310,28898,29234,29208,15512
9201,25,38,0,9201,9201,0,2.13143e+13,36.0522,461.473,9201,35,38,9049,8759,8863,8799,5757
5208,21,38,0,5208,5208,0,2.2149e+13,21.1705,311.994,5208,24,26,5167,5125,5151,5153,5129
34438,1,2,34438,0,34438,0,3.22522e+13,1.99956,247.173,34438,2,2,30491,30491,30491,30491,30491
32854,42,44,0,32854,32854,0,2.12935e+13,32.5501,757.43,32854,37,37,32810,32791,32743,32779,32808
6846,1,2,0,6846,6846,0,8.35725e+15,1.99489,109.22,6846,2,2,6051,6051,6051,6051,6051
39000,1,4,39000,0,39000,0,4.08067e+13,1.99979,268.074,39000,3,3,33853,33853,33853,33853,33853
21933,16,21,0,21933,4627,17306,4580.62,18.6288,523.384,21933,21,20,21878,21873,21752,21752,20323
37486,6,40,0,37486,0,37486,1313840,28.1571,746.565,37486,37,37,32885,29985,24145,26201,10558
34317,37,40,34317,0,34317,0,1.46435e+18,35.2208,813.538,34317,39,37,34272,34201,34267,29666,31909
46638,11,40,46638,0,46638,0,8.7347e+10,30.2537,868.076,46638,32,31,44889,42485,39152,38299,25039
34524,5,44,34524,0,34524,0,1.37668e+18,36.7017,808.464,34524,37,37,27966,21623,22813,5013,8377
9498,1,2,9498,0,9498,0,7.21024e+13,1.99905,135.676,9498,2,2,7064,7064,7064,7064,7064
1585,14,32,1585,0,1585,0,82452500000,13.6202,141.014,1585,21,21,1550,1530,1526,1503,1275
15696,17,23,2779,12917,0,15696,19.487,17.2966,420.239,15696,20,21,15665,15665,15632,15634,15414
6671,242,323,638,6033,237,6434,4.05939e+11,5.04032,564.093,6671,127,43,6348,6347,6335,6335,6323
16041,17,21,2789,13252,0,16041,18.7432,16.3485,403.118,16041,19,19,16012,16012,15953,15954,15847
49671,27,60,49671,0,49671,0,85637900000,36.206,988.818,49671,40,40,49569,49397,49452,49438,47856
2701,4,22,2701,0,0,2701,5.73455e+15,15.9545,199.435,2701,19,19,1915,1447,1392,472,808
11244,5,36,11244,0,11244,0,86333300000,18.3988,379.06,11244,27,25,9238,6983,7104,8075,3584
8019,1,2,8019,0,8019,0,3.76985e+13,1.99825,117.908,8019,2,2,6944,6944,6944,6944,6944
31477,1,2,31477,0,31477,0,6.30786e+13,1.99902,246.143,31477,2,2,24422,24422,24422,24422,24422
24780,1,2,24780,0,24780,0,3.26116e+13,1.99976,208.646,24780,2,2,21908,21908,21908,21908,21908
24914,29,40,24914,0,24914,0,87124700000,21.5871,630.917,24914,32,24,24874,24858,24867,24868,24874
11594,18,24,0,11594,0,11594,1337490,19.6087,406.086,11594,20,21,11562,11540,11440,11438,10897
2183,14,18,2183,0,2183,0,88102900000,15.6706,162.908,2183,16,17,2157,2141,2084,2083,2122
21500,34,40,21500,0,0,21500,340485000,33.1075,609.41,21500,31,30,21455,21416,21449,21448,20562
48492,3,4,0,48492,48492,0,9.10304e+15,1.99965,296.761,48492,3,3,48488,48486,48487,48487,48488
13578,79,591,5195,8383,362,13216,1.10147e+12,23.3598,1109.39,13578,135,90,12974,12895,12674,12729,3248
41149,18,31,0,41149,10208,30941,1.75109e+12,20.5669,820.917,41149,26,24,41098,41090,40888,39128,37532
41995,48,60,41995,0,41995,0,81331400000,29.7303,1025.55,41995,38,44,41935,41924,41929,41933,35943
38470,10,44,38470,0,0,38470,5.26644e+15,35.4568,901.821,38470,39,41,35935,33659,32523,6422,15080
34953,9,21,0,34953,5560,29393,5061.76,16.4604,557.731,34953,20,20,34717,34717,34641,34692,33696
47316,3,48,47316,0,0,47316,4.9639e+15,35.6526,1101.78,47316,38,41,29609,25467,24036,7032,7282
9091,1,2,0,9091,9091,0,1.27533e+16,1.9978,127.79,9091,2,2,7481,7481,7481,7481,7481
9859,7,12,0,9859,1696,8163,5239.65,10.337,283.839,9859,12,12,9668,9668,9174,9350,9312
22170,1,2,0,22170,22170,0,9.35741e+15,1.99923,196.178,22170,2,2,19290,19290,19290,19290,19290
22593,17,40,22593,0,22593,0,82905600000,27.7689,626.239,22593,36,35,22289,21532,22095,21635,15066
22611,1,19,0,22611,3811,18800,4954.47,14.1211,470.167,22611,19,19,4629,4629,4629,4629,4629
27311,11,40,27311,0,0,27311,5.70742e+15,30.6951,685.097,27311,31,30,26107,24531,22594,11106,14531
24378,1,4,0,24378,24378,0,8.32366e+15,2.8248,214.799,24378,4,4,21557,21557,21557,21557,21557
23187,17,21,0,23187,3765,19422,5123.58,12.2943,456.609,23187,19,20,23160,23160,23136,23136,23069
34169,16,23,5805,28364,0,34169,19.4587,18.8158,599.835,34169,21,21,34107,34103,34019,34019,33424
35221,55,56,0,35221,0,35221,1326690,22.3506,756.828,35221,31,32,35165,35152,35165,35165,35165
20101,33,44,20101,0,20101,0,1.39802e+18,33.9266,619.066,20101,36,37,20048,19989,19974,17108,19695
6036,7,21,1049,4987,0,6036,19.4824,10.9665,258.931,6036,17,20,5866,5866,5752,5768,5565
21518,41,44,21518,0,0,21518,322739000,28.3915,631.574,21518,36,37,21474,21464,21402,21386,19509
19846,3,40,19846,0,0,19846,338283000,18.6934,515.112,19846,27,29,13380,11379,10268,7349,4670
24086,34,40,0,24086,24086,0,2.18527e+13,33.1905,611.162,24086,37,36,24034,23972,23983,23975,23980
27715,3,4,0,27715,27715,0,9.62501e+15,1.99964,226.661,27715,3,3,27711,27709,27710,27710,27711
10365,5,24,10365,0,10365,0,87687800000,18.5042,369.836,10365,20,21,8234,6108,6020,7251,3412
21954,22,28,3641,18313,0,21954,20.1312,12.1268,467.357,21954,20,21,21926,21926,21926,21926,21917
44724,35,44,0,44724,0,44724,1057070,36.6437,1072.82,44724,39,39,44664,44502,44275,44276,42872
46084,1,4,0,46084,46084,0,8.38723e+15,1.99987,288.812,46084,3,3,40717,40717,40717,40717,40717
6414,21,22,6414,0,6414,0,1.47104e+18,19.9417,307.285,6414,20,20,6391,6365,6390,6000,6391
988,16,22,0,988,988,0,2.22128e+13,16.3148,126.007,988,16,19,958,928,951,950,896
5691,13,22,5691,0,0,5691,5.74464e+15,20.2177,289.322,5691,20,20,5561,5188,4902,4477,4068
8699,19,56,8699,0,0,8699,334526000,19.6452,412.1,8699,26,33,8602,8479,8502,8514,1542
29016,14,40,29016,0,0,29016,5.25455e+15,30.9236,737.057,29016,38,35,28098,26615,27433,4795,11805
35975,42,48,35975,0,35975,0,1.20492e+18,37.455,986.725,35975,37,41,35927,35915,35525,32775,29906
32668,5,20,0,32668,5872,26796,5157.21,18.1714,613.802,32668,20,20,29852,29850,26438,25331,15997
16098,11,24,0,16098,16098,0,2.24448e+13,21.1085,486.352,16098,23,22,15473,14614,13420,13115,8631
27448,18,40,0,27448,0,27448,1315870,29.4259,624,27448,30,29,27353,27250,27276,27267,23901
46838,18,40,0,46838,0,46838,1306440,33.1569,850.1,46838,39,37,46598,46328,46424,46414,28975
13701,44,48,0,13701,0,13701,1006140,34.546,646.622,13701,33,41,13653,13645,13461,13461,11659
39109,33,56,39109,0,0,39109,5.70504e+15,22.7256,799.531,39109,32,32,39053,39033,39049,32506,35016
37742,9,20,0,37742,6521,31221,5195.72,16.6883,601.981,37742,20,20,37503,37503,37092,37088,30085
20152,23,35,7840,12312,16,20136,41901500000,17.0789,533.266,20152,30,18,20117,20104,20096,20107,19977
10054,5,24,10054,0,0,10054,5.75179e+15,19.6898,375.154,10054,20,21,7889,5836,5856,1820,3265
37224,18,40,37224,0,0,37224,5.62312e+15,33.1667,742.074,37224,37,37,37057,36868,36938,7177,26228
24094,2,38,24094,0,0,24094,5.65623e+15,31.0417,676.519,24094,34,32,12547,12547,7921,2467,3656
6785,8,20,6785,0,6785,0,1.47123e+18,17.2268,288.383,6785,20,18,6236,5297,5161,2126,3432
881,10,32,881,0,881,0,1.36231e+18,9.59137,109.23,881,17,21,845,830,825,509,732
47904,1,2,0,47904,47904,0,9.92477e+15,1.99987,289.528,47904,2,2,41305,41305,41305,41305,41305
40002,57,60,40002,0,40002,0,1.33066e+18,41.8738,984.263,40002,49,42,39942,39930,39942,34809,36337
18308,44,60,18308,0,0,18308,5.16261e+15,26.1203,745.308,18308,34,44,18248,18240,18137,17842,14637
33215,22,28,5911,27304,0,33215,19.9781,15.1121,643.133,33215,19,28,33187,33187,33187,33187,33178
9037,9,24,0,9037,9037,0,2.24346e+13,20.2364,357.039,9037,20,20,8434,6991,6794,6970,4057
42386,35,40,0,42386,42386,0,2.20936e+13,28.292,797.568,42386,38,37,42335,42268,42292,42281,42291
4757,1,2,4757,0,4757,0,4.4378e+13,1.99685,93.6189,4757,2,2,4006,4006,4006,4006,4006
32562,18,40,0,32562,0,32562,997648,33.4183,932.29,32562,40,34,31220,27925,28472,28440,17509
8508,1,2,8508,0,8508,0,4.8699e+13,1.99788,126.392,8508,2,2,7035,7035,7035,7035,7035
31287,2,4,0,31287,31287,0,8.33267e+15,2.00003,239.18,31287,3,3,31282,31281,31282,31282,30342
43129,25,30,8541,34588,0,43129,19.2176,17.3032,858.064,43129,19,30,43099,43099,43099,43099,41886
19383,33,40,19383,0,19383,0,1.45587e+18,21.6535,524.799,19383,29,25,19343,19329,19343,15442,18057
6372,4,40,6372,0,6372,0,79164400000,26.2803,353.136,6372,29,33,4739,3809,3823,3900,1648
36462,1,2,0,36462,36462,0,1.61874e+16,1.99973,264.147,36462,2,2,28270,28270,28270,28270,28270
25321,20,56,25321,0,0,25321,333729000,32.9536,692.717,25321,37,40,25175,25003,25082,24194,18808
19376,36,38,19376,0,19376,0,1.46385e+18,35.9785,684.429,19376,38,38,19320,19128,19311,19235,18746
43936,19,28,0,43936,7323,36613,5187.54,12.363,636.965,43936,20,21,43905,43905,43905,43905,43896
47320,37,40,47320,0,0,47320,5.59007e+15,33.3263,849.944,47320,38,37,47275,47222,47243,42929,47265
37434,1,2,37434,0,37434,0,6.36954e+13,1.99979,267.727,37434,2,2,28962,28962,28962,28962,28962
21049,32,44,21049,0,21049,0,83064700000,33.7448,632.102,21049,33,37,20997,20939,20886,20862,19573
41654,1475,2924,41291,363,0,41654,6.32772e+17,95.4298,5283.83,41654,750,215,38730,38725,37675,36814,11097
19245,1,36,19245,0,0,19245,332472000,25.4131,526.827,19245,36,33,2390,2390,2390,2390,2390
38641,1,2,38641,0,38641,0,3.36246e+13,1.99977,259.758,38641,2,2,34024,34024,34024,34024,34024
43490,3,56,43490,0,0,43490,336592000,28.7037,947.556,43490,38,43,27878,23541,20300,11679,6284
2522,9,22,2522,0,2522,0,1.47315e+18,15.8739,193.655,2522,19,19,2321,1882,1945,1734,1403
45743,50,56,45743,0,0,45743,5.69086e+15,34.8255,857.072,45743,40,32,45687,45660,45682,45687,45687
44297,1,2,44297,0,44297,0,5.12662e+13,1.99977,286.899,44297,2,2,36228,36228,36228,36228,36228
21508,22,40,0,21508,21508,0,2.03431e+13,34.451,632.836,21508,35,35,21264,20774,21012,20366,14860
34304,57,60,34304,0,34304,0,1.41758e+18,26.8157,854.804,34304,42,40,34244,34233,34244,32186,32575
38681,4,30,0,38681,7754,30927,4896.59,17.5987,821.586,38681,20,30,33019,33019,29851,24391,20733
44661,5,96,237,44424,44649,12,6.53764e+15,3.44668,561.889,44661,28,22,44503,44449,44415,44396,44330
30381,52,60,30381,0,0,30381,330228000,36.3765,911.291,30381,38,52,30321,30315,30317,30146,29894
33178,2,4,33178,0,33178,0,4.09767e+13,1.99901,247.665,33178,3,3,33173,33172,33172,33172,31963
33569,1,2,0,33569,33569,0,8.4982e+15,1.99923,241.036,33569,2,2,29609,29609,29609,29609,29609
9155,1,2,9155,0,9155,0,3.33281e+13,1.99792,125.685,9155,2,2,8070,8070,8070,8070,8070
46615,1,20,0,46615,8379,38236,5152.97,18.1252,710.649,46615,20,19,7190,7190,7190,7190,7190
7454,9,11,0,7454,1142,6312,5153.52,9.69198,225.414,7454,11,11,7434,7434,7426,7426,7433
12740,1,40,12740,0,12740,0,86943100000,20.8309,468.887,12740,30,24,1293,1293,1293,1293,1293
38836,28,38,38836,0,0,38836,337096000,32.6265,886.433,38836,38,34,38712,38466,38552,38552,38145
47032,1,44,0,47032,0,47032,1240400,37.6745,1002.02,47032,40,41,5333,5333,5333,5333,5333
31282,1,2,31282,0,31282,0,3.25817e+13,1.99939,234.584,31282,2,2,27660,27660,27660,27660,27660
23201,2,28,0,23201,3920,19281,5178.52,10.9623,479.301,23201,19,21,15409,15409,15153,9320,9317
4834,23,32,4834,0,4834,0,81840700000,19.5933,264.641,4834,31,28,4778,4707,4746,4703,4436
33406,18,40,33406,0,0,33406,340773000,29.8513,748.101,33406,32,29,33262,33096,32736,32709,27507
25711,6,21,0,25711,4193,21518,5185.68,12.0173,463.454,25711,21,20,25075,25075,24365,24368,24230
15179,4,44,0,15179,0,15179,1231710,31.9632,543.593,15179,34,37,11433,9152,9176,9488,3430
755,5,9,107,648,0,755,19.8887,7.22781,67.1427,755,8,8,721,721,648,646,436
31522,13,40,31522,0,0,31522,5.36115e+15,29.7841,758.385,31522,38,35,30550,28897,29699,4724,10559
43086,7,40,43086,0,0,43086,5.71001e+15,22.2584,799.332,43086,32,29,38294,33304,29274,6489,16765
37948,3,4,0,37948,37948,0,8.33406e+15,3.23342,265.445,37948,4,4,37942,37938,37941,37941,37540
44491,39,44,44491,0,44491,0,1.15806e+18,36.3958,1071.82,44491,39,39,44444,44399,44098,42405,43788
12487,35,40,0,12487,0,12487,1303040,20.1007,454.404,12487,26,36,12447,12438,12411,12414,12402
15723,2,13,0,15723,2577,13146,5204.21,11.4633,352.49,15723,13,13,10569,10569,10505,7058,7058
42815,22,40,0,42815,42815,0,2.23413e+13,22.3819,804.77,42815,32,28,42766,42707,42723,42731,40507
13653,2,56,13653,0,13653,0,85456400000,21.8646,544.668,13653,30,39,7406,7396,5010,6090,1981
11208,7,21,0,11208,1848,9360,5068.84,11.2631,331.822,11208,17,20,10984,10984,10688,10704,10635
25340,6,40,0,25340,25340,0,2.05375e+13,32.456,680.041,25340,37,35,22105,20238,17917,18867,7163
34192,15,23,0,34192,6591,27601,4749.03,17.0877,646.596,34192,21,22,34103,34103,33894,33904,31539
38450,1,2,38450,0,38450,0,4.32132e+13,1.99984,265.568,38450,2,2,32546,32546,32546,32546,32546
27061,3,44,27061,0,27061,0,1.39542e+18,33.3937,702.228,27061,37,37,18353,15744,14469,3534,5531
14284,29,60,14284,0,0,14284,312899000,35.2123,723.853,14284,38,54,14165,13947,13976,13812,12031
3214,1,21,0,3214,624,2590,4965.79,8.92875,204.517,3214,11,20,577,577,577,577,577
22425,1,2,0,22425,22425,0,8.88148e+15,1.99938,197.068,22425,2,2,19660,19660,19660,19660,19660
39840,27,44,39840,0,0,39840,328005000,33.5218,838.181,39840,37,38,39706,39405,39469,21697,31326
16666,16,24,16666,0,16666,0,1.47078e+18,20.4497,480.268,16666,22,21,16572,16327,16065,13623,13473
47580,7,23,0,47580,11441,36139,4371.78,19.5714,805.933,47580,23,21,44105,44105,43828,44077,18664
43130,59,60,0,43130,0,43130,1303680,31.6129,1043.21,43130,38,52,43070,43064,43069,43070,43034
8001,21,60,8001,0,8001,0,1.33394e+18,26.0489,489.336,8001,37,40,7866,7637,7758,4660,5710
31951,43,56,31951,0,0,31951,335679000,30.6234,765.015,31951,37,40,31895,31883,31886,31797,26851
5411,17,19,0,5411,835,4576,5096.72,9.65626,205.427,5411,18,18,5390,5390,5390,5390,5387
48993,1,2,48993,0,48993,0,3.77345e+13,1.99955,292.371,48993,2,2,42424,42424,42424,42424,42424
11824,18,40,11824,0,0,11824,244978000,32.9224,558.432,11824,34,33,11298,9976,10116,8590,7503
19506,22,40,19506,0,19506,0,75062600000,33.995,655.969,19506,37,33,19241,18607,18923,18099,12890
22966,1,2,22966,0,22966,0,3.32265e+13,1.9993,199.444,22966,2,2,20254,20254,20254,20254,20254
39265,1,2,39265,0,39265,0,4.27965e+13,1.99957,265.198,39265,2,2,33294,33294,33294,33294,33294
5594,9,19,0,5594,1181,4413,4389.43,15.5075,248.373,5594,18,17,5415,5415,5349,5394,2112
4205,18,40,0,4205,0,4205,1264030,29.2609,300.022,4205,24,35,4135,4058,4054,4054,3745
5527,7,21,0,5527,934,4593,5162.43,9.13805,228.547,5527,15,20,5412,5412,5273,5276,4003
49218,9,60,49218,0,0,49218,321577000,28.9249,1091.84,49218,37,44,44908,37789,38398,39057,20618
10707,17,19,1981,8726,0,10707,19.9432,15.9349,343.373,10707,19,19,10678,10678,10678,10678,10678
3796,27,60,3796,0,3796,0,62736400000,27.0764,356.314,3796,31,34,3724,3634,3648,3572,523
8473,17,38,8473,0,8473,0,1.46007e+18,20.3829,390.5,8473,22,29,8379,8122,8216,6728,7599
43041,1,2,43041,0,43041,0,3.70081e+13,1.99956,274.355,43041,2,2,37381,37381,37381,37381,37381
16616,6,24,16616,0,0,16616,341518000,21.6513,480.003,16616,22,22,14258,12812,10105,9842,6401
3771,8,11,0,3771,589,3182,5170.51,9.65898,162.865,3771,10,11,3750,3750,3728,3728,3743
46829,3,20,0,46829,8363,38466,5145.69,19.1291,733.433,46829,20,20,35553,35551,34357,18120,12993
3388,1,2,0,3388,3388,0,8.33724e+15,1.9941,77.3183,3388,2,2,2995,2995,2995,2995,2995
46206,6,60,0,46206,46206,0,2.03831e+13,41.2188,1109.93,46206,41,51,39040,35202,30636,32907,7667
32058,14,19,0,32058,5935,26123,5111.76,18.1446,631.043,32058,19,19,31942,31942,31854,31854,31774
22067,26,40,0,22067,22067,0,2.19334e+13,22.9118,578.646,22067,34,37,21999,21923,21944,21836,18435
43662,26,30,0,43662,8613,35049,4796.02,18.9845,867.279,43662,21,30,43632,43632,43632,43632,42318
36269,15,23,0,36269,7078,29191,4731.17,19.7162,666.285,36269,22,21,36176,36176,36029,36037,32494
23656,1,2,23656,0,23656,0,3.34353e+13,1.99907,202.168,23656,2,2,20845,20845,20845,20845,20845
7746,9,11,0,7746,1189,6557,5157.54,9.57952,229.363,7746,11,11,7726,7726,7718,7718,7725
44088,1,56,44088,0,44088,0,86437100000,23.4131,869.96,44088,33,40,4955,4955,4955,4955,4955
3193,4,18,3193,0,3193,0,1.48114e+18,17.0658,200.878,3193,17,18,2282,1724,1671,534,1056
43635,14,40,43635,0,0,43635,5.70931e+15,36.9734,858.083,43635,33,31,43017,42331,38588,32401,24953
9695,30,38,9695,0,9695,0,1.46065e+18,20.5103,414.327,9695,25,29,9657,9643,9650,9195,9657
24391,17,38,0,24391,0,24391,1281860,36.0012,752.306,24391,38,38,23695,22392,22617,22583,13934
31963,34,65,0,31963,0,31963,5.7711e+14,35.7165,1167.71,31963,38,59,31870,31717,31584,31036,16999
19226,1,13,0,19226,3333,15893,5222.26,11.2526,406.74,19226,13,12,3073,3073,3073,3073,3073
21100,8,40,0,21100,0,21100,1257270,27.927,600.338,21100,35,35,19465,17336,16966,17334,7016
22653,27,40,22653,0,22653,0,1.40962e+18,33.9273,614.275,22653,36,35,22562,22380,22462,17132,16437
2180,2,4,0,2180,2180,0,1.656e+16,2.26514,76.9486,2180,4,4,2157,2150,2153,2154,1683
30902,10,40,0,30902,30902,0,2.23486e+13,35.2351,707.742,30902,32,31,29514,28310,24654,24593,12831
31148,1,2,31148,0,31148,0,4.54636e+13,1.99939,236.225,31148,2,2,26116,26116,26116,26116,26116
45888,39,44,45888,0,45888,0,73871800000,37.3119,1056.98,45888,40,39,45841,45773,45408,45462,44272
20406,21,24,20406,0,0,20406,341569000,20.33,550.783,20406,23,22,20373,20276,20367,20366,19383
18618,31,64,0,18618,0,18618,1037200,34.7006,859.81,18618,34,51,18516,18305,18141,18131,6482
15932,1,2,0,15932,15932,0,8.99589e+15,1.99944,166.372,15932,2,2,13942,13942,13942,13942,13942
10776,1,21,1755,9021,0,10776,19.5995,14.2164,325.333,10776,19,20,2120,2120,2120,2120,2120
32154,1,4,0,32154,32154,0,1.03916e+16,2.00025,245.357,32154,3,3,27514,27514,27514,27514,27514
21518,1,40,0,21518,0,21518,1139590,31.3106,689.492,21518,36,37,2303,2303,2303,2303,2303
21671,39,56,21671,0,21671,0,85512500000,23.4366,645.193,21671,34,40,21615,21605,21579,21562,18008
40557,15,32,0,40557,9018,31539,4777.71,13.9757,823.312,40557,20,25,40496,40496,40309,40321,34379
37906,1,2,37906,0,37906,0,4.02319e+13,1.99976,258.125,37906,2,2,32487,32487,32487,32487,32487
41427,1,2,41427,0,41427,0,4.24519e+13,1.99959,271.479,41427,2,2,35178,35178,35178,35178,35178
27380,19,21,0,27380,4410,22970,5110.5,16.6436,497.523,27380,20,21,27355,27355,27335,27335,27289
49123,1,2,49123,0,49123,0,3.34231e+13,1.99982,292.753,49123,2,2,43289,43289,43289,43289,43289
43197,2,40,43185,12,43197,0,2.01321e+14,1.50476,431.032,43197,17,16,42960,42913,42886,42907,42873
46571,1,44,46571,0,0,46571,5.21691e+15,37.3667,986.415,46571,38,41,5418,5418,5418,5418,5418
14782,36,40,14782,0,14782,0,85174100000,23.5959,487.206,14782,32,37,14742,14731,14702,14695,14702
9259,9,56,0,9259,9259,0,2.12834e+13,28.206,458.508,9259,31,40,8618,7434,7397,7475,3206
4999,1,2,0,4999,4999,0,1.00901e+16,1.997,94.0057,4999,2,2,4298,4298,4298,4298,4298
25799,37,44,25799,0,25799,0,77831200000,33.418,774.329,25799,38,41,25749,25718,25490,25517,21843
47992,10,44,0,47992,0,47992,1286650,36.3119,914.632,47992,38,38,46099,44387,41323,41214,18866
42180,1,4,0,42180,42180,0,8.37426e+15,1.99983,276.974,42180,3,3,37275,37275,37275,37275,37275
25183,4,21,0,25183,6018,19165,4351.44,19.4511,576.739,25183,21,20,20994,20994,19921,19963,17998
45750,21,44,45750,0,0,45750,5.4685e+15,31.3431,890.159,45750,37,37,45427,44927,45148,8580,24063
10448,27,36,10448,0,10448,0,83860400000,26.4164,394.294,10448,33,33,10388,10310,10350,10340,9747
3599,18,22,0,3599,0,3599,1337960,19.6271,234.502,3599,20,19,3571,3553,3518,3516,2640
29355,3,40,0,29355,29355,0,2.20897e+13,29.0115,643.027,29355,31,29,19826,16883,15263,15909,5072
38754,22,23,0,38754,7489,31265,4770.11,19.9455,690.33,38754,21,22,38730,38730,38651,38652,38730
27111,1,2,0,27111,27111,0,1.29943e+16,1.99952,221.871,27111,2,2,22221,22221,22221,22221,22221
22858,1,2,22858,0,22858,0,3.26446e+13,1.99965,199.591,22858,2,2,20206,20206,20206,20206,20206
4023,3,4,0,4023,4023,0,8.07804e+15,2.82724,99.8967,4023,4,4,4004,3977,3998,3998,3693
9000,3,21,1910,7090,0,9000,17.9076,17.238,338.271,9000,19,20,6916,6910,6877,6735,5607
5889,1,2,0,5889,5889,0,8.35716e+15,1.99847,101.378,5889,2,2,5205,5205,5205,5205,5205
32398,1,4,0,32398,32398,0,8.71862e+15,1.99994,243.132,32398,3,3,28475,28475,28475,28475,28475
34047,1,2,0,34047,34047,0,9.48577e+15,1.99971,243.827,34047,2,2,29564,29564,29564,29564,29564
33755,31,40,33755,0,33755,0,87347300000,22.3243,723.15,33755,32,28,33715,33697,33708,33703,33715
43946,43,60,43946,0,43946,0,86067100000,36.2781,931.121,43946,40,40,43886,43861,43860,43858,43727
9507,16,19,0,9507,1515,7992,4989.56,14.7091,291.302,9507,19,19,9477,9476,9461,9461,9408
9499,1,2,9499,0,9499,0,3.24767e+13,1.99884,128.807,9499,2,2,8402,8402,8402,8402,8402
1443,8,9,0,1443,211,1232,5132.06,7.12613,91.5407,1443,9,8,1433,1433,1433,1433,1433
44294,9,65,0,44294,0,44294,4.16449e+14,40.0443,1236.13,44294,41,48,33683,24616,27426,11964,10823
26122,16,30,5041,21081,0,26122,19.6227,16.6417,638.701,26122,19,29,26054,26054,25979,25979,25395
17116,28,36,0,17116,0,17116,1276570,27.477,506.399,17116,34,33,17048,16953,16987,16987,13736
19718,30,40,19718,0,19718,0,1.46289e+18,19.7909,568.09,19718,25,29,19678,19664,19669,18796,19375
4365,31,36,4365,0,0,4365,4.20104e+15,28.5276,320.753,4365,30,29,4327,4284,4296,4188,4230
17892,7,13,3107,14785,0,17892,20.4031,11.4939,392.874,17892,13,12,17499,17499,16504,16844,14027
957,1,2,957,0,957,0,3.20593e+13,1.97701,41.2129,957,2,2,847,847,847,847,847
49681,25,40,49681,0,49681,0,1.45447e+18,26.7196,865.754,49681,35,29,49608,49533,49584,17999,32562
8010,1,2,8010,0,8010,0,4.66665e+13,1.99938,119.08,8010,2,2,6681,6681,6681,6681,6681
47962,30,32,0,47962,11359,36603,4439.61,18.9092,875.744,47962,23,27,47930,47930,47930,47930,47926
36242,32,37,0,36242,13347,22895,5.96452e+12,19.3687,740.104,36242,32,20,36205,36204,36202,34354,35587
4709,23,24,4709,0,0,4709,3.42e+08,17.2858,258.241,4709,19,21,4685,4675,4684,4684,4685
13960,25,38,0,13960,0,13960,1311400,36.499,522.683,13960,33,31,13883,13800,13835,13841,11071
24486,3,40,24486,0,0,24486,247675000,34.5373,801.283,24486,36,34,12371,10578,10496,9241,2501
46015,5,33,9930,36085,1,46014,6116840000,16.6698,950.501,46015,19,32,40181,40173,36135,34417,22995
4519,1,2,4519,0,4519,0,3.23892e+13,1.99513,89.4458,4519,2,2,3998,3998,3998,3998,3998
6945,1,2,6945,0,6945,0,3.25854e+13,1.99712,109.987,6945,2,2,6140,6140,6140,6140,6140
31127,42,56,0,31127,31127,0,2.19077e+13,35.5011,834.613,31127,38,44,31071,31063,31071,31071,31069
32770,36,56,32770,0,0,32770,5.69643e+15,22.8153,730.306,32770,32,32,32714,32698,32713,26727,28836
26978,4,24,26978,0,26978,0,1.4672e+18,21.5584,608.708,26978,24,22,19585,14889,14364,3159,6121
37499,24,40,37499,0,0,37499,331625000,30.3095,768.69,37499,37,37,37347,37153,37203,23395,24981
13557,8,21,0,13557,3260,10297,4349.72,17.9197,423.428,13557,19,20,12874,12771,12666,12741,10553
11468,4,23,0,11468,2147,9321,4893.56,12.4588,374.322,11468,18,21,10128,10128,9374,9222,8739
31142,32,60,31142,0,31142,0,83517300000,35.6213,823.805,31142,36,42,31060,30979,30892,30869,23235
16972,5,40,16972,0,0,16972,340432000,21.4724,534.012,16972,30,26,13145,9714,9773,7880,4631
17270,24,40,0,17270,17270,0,2.18395e+13,23.0458,519.478,17270,34,37,17194,17127,17133,17006,13768
11264,3,22,11264,0,0,11264,343248000,19.6378,401.887,11264,21,21,7166,6026,5342,2638,2479
33314,26,30,0,33314,5871,27443,5039.53,14.3283,639.84,33314,20,25,33284,33284,33284,33284,32955
25317,1,2,0,25317,25317,0,8.41625e+15,1.99949,209.823,25317,2,2,22359,22359,22359,22359,22359
31327,10,60,31327,0,31327,0,1.40797e+18,34.2037,943.732,31327,47,42,29026,27216,23363,6163,14137
31574,16,56,31574,0,31574,0,86928300000,21.4389,723.15,31574,30,32,31348,30837,30262,30051,23159
13799,33,40,13799,0,13799,0,85263200000,33.9051,477.633,13799,28,36,13756,13722,13719,13708,13728
40366,5,28,6714,33652,0,40366,20.2605,12.0899,610.852,40366,20,21,37747,37747,33637,33387,31908
26076,25,40,0,26076,0,26076,1329910,22.2335,651.982,26076,27,29,26036,26016,26024,26023,24255
38455,17,60,0,38455,0,38455,1277270,34.0732,855.431,38455,37,44,38016,36985,37741,37701,17670
34343,44,56,0,34343,34343,0,2.1961e+13,30.7794,773.432,34343,38,40,34287,34275,34278,34283,28298
43627,5,23,8803,34824,0,43627,18.35,20.0859,745.906,43627,22,22,39529,39529,37169,37261,34850
23699,27,40,23699,0,0,23699,339364000,22.6783,582.781,23699,30,29,23659,23639,23653,23652,23657
44829,32,60,44829,0,0,44829,5.5428e+15,33.6581,1084.48,44829,38,52,44719,44480,44471,40432,41399
49931,15,40,49931,0,49931,0,1.46686e+18,38.5069,943.099,49931,40,32,49300,48269,45599,5221,17358
15585,34,40,15585,0,0,15585,338257000,21.7578,475.626,15585,29,29,15545,15529,15545,15543,15545
39921,13,40,0,39921,39921,0,2.23184e+13,22.0233,754.988,39921,32,29,39333,37345,36059,37500,26903
42491,1,4,0,42491,42491,0,8.15356e+15,3.83632,311.462,42491,4,4,37572,37572,37572,37572,37572
10002,8,38,0,10002,10002,0,2.22884e+13,20.3282,419.915,10002,30,22,8886,7234,6669,7373,4495
4484,1,2,4484,0,4484,0,3.25793e+13,1.99599,89.0085,4484,2,2,3964,3964,3964,3964,3964
11176,1,20,1939,9237,0,11176,20.2573,11.293,333.241,11176,19,18,1793,1793,1793,1793,1793
2992,4,18,0,2992,2992,0,2.25826e+13,15.0274,193.096,2992,17,18,2147,1623,1572,1874,946
13583,4,24,13583,0,13583,0,87701700000,21.074,444.458,13583,21,22,9665,7305,7083,8453,3338
9341,3,36,0,9341,0,9341,962112,29.7572,477.906,9341,33,33,5097,4416,4394,3922,1223
33685,1,2,0,33685,33685,0,1.11964e+16,1.99929,245.476,33685,2,2,28450,28450,28450,28450,28450
36324,1,4,0,36324,36324,0,8.66699e+15,2.00006,256.882,36324,3,3,31952,31952,31952,31952,31952
44994,15,40,44994,0,0,44994,5.71833e+15,31.2952,872.466,44994,33,30,44444,43520,42151,35090,31237
10372,33,56,10372,0,10372,0,83842100000,26.3183,419.401,10372,33,32,10310,10281,10258,10247,4525
46276,19,40,46276,0,46276,0,1.45981e+18,28.0953,955.6,46276,38,38,45958,45453,45310,11999,31586
16699,1,2,0,16699,16699,0,1.67339e+16,1.99826,179.032,16699,2,2,12820,12820,12820,12820,12820
37499,8,38,0,37499,37499,0,2.2176e+13,32.1558,832.898,37499,35,33,33232,27004,24579,27432,16787
29382,18,44,0,29382,0,29382,1249200,37.3451,755.67,29382,37,37,28977,28410,28709,28647,18434
29484,13,21,0,29484,4810,24674,5190.78,12.0222,493.366,29484,21,20,29455,29455,29453,29455,29452
46459,21,40,0,46459,46459,0,2.23592e+13,22.9798,842.24,46459,32,28,46394,46224,46318,46319,43107
27959,23,60,27959,0,27959,0,1.31405e+18,33.3547,872.927,27959,46,44,27684,26994,27307,10520,16307
12318,14,24,12318,0,0,12318,5.74183e+15,21.4782,423.896,12318,22,22,12170,12002,10534,9527,9356
20414,28,36,20414,0,20414,0,84503200000,25.8328,557.274,20414,36,33,20350,20262,20309,20286,16255
18689,32,36,18689,0,18689,0,1.43366e+18,23.0109,525.473,18689,36,33,18645,18611,18613,15948,18613
2513,1,22,2513,0,0,2513,343476000,15.9121,193.455,2513,18,19,243,243,243,243,243
4940,19,38,4940,0,4940,0,1.42085e+18,31.5304,321.45,4940,27,33,4815,4688,4694,2059,4059
29389,14,40,29389,0,29389,0,85777200000,30.3325,668.513,29389,37,37,29095,28739,28383,28136,17602
48575,24,40,0,48575,0,48575,1317460,37.3763,986.155,48575,39,37,48382,48099,48181,48193,38186
3319,25,36,3319,0,3319,0,1.42552e+18,13.3302,210.613,3319,21,25,3283,3271,3279,2258,3281
9480,14,19,1520,7960,0,9480,19.5489,13.8201,290.745,9480,18,19,9440,9439,9427,9427,9347
1651,6,20,1651,0,0,1651,339528000,11.7026,138.335,1651,14,17,1453,1335,1110,1222,940
42984,22,30,0,42984,8248,34736,4828.65,20.9528,773.754,42984,22,28,42952,42951,42842,42842,40174
45813,32,40,0,45813,0,45813,1332330,30.7002,864.516,45813,32,31,45765,45723,45754,45753,42669
34158,1,2,34158,0,34158,0,6.0608e+13,1.99959,254.312,34158,2,2,26802,26802,26802,26802,26802
18659,2,4,0,18659,18659,0,1.11645e+16,1.99995,191.444,18659,3,3,18654,18653,18654,18654,17271
9215,49,56,0,9215,9215,0,2.1313e+13,28.074,458.413,9215,31,40,9159,9149,9150,9159,9089
47207,1,4,0,47207,47207,0,8.55557e+15,2,292.232,47207,3,3,41599,41599,41599,41599,41599
31241,10,40,31241,0,31241,0,87012400000,35.0733,726.477,31241,32,31,29711,28405,24656,24614,14125
16782,8,21,3074,13708,0,16782,18.3747,16.9761,421.902,16782,19,19,16315,16282,16184,16268,14738
31550,22,44,0,31550,31550,0,2.13862e+13,33.1459,739.886,31550,35,37,31354,31037,31154,30639,23003
3471,14,36,3471,0,3471,0,84889600000,14.4359,214.999,3471,23,25,3427,3394,3403,3346,2979
3070,14,28,3070,0,3070,0,1.02355e+18,24.2524,260.059,3070,26,25,2482,1043,2082,1540,1789
15141,7,19,0,15141,2797,12344,5094.5,15.8066,412.735,15141,19,19,14575,14575,13242,13266,12666
29984,19,40,29984,0,29984,0,1.44079e+18,30.6742,677.564,29984,37,37,29853,29682,29749,8958,23079
29665,42,56,29665,0,0,29665,339103000,22.69,704.409,29665,32,32,29609,29598,29609,29607,29607
21164,22,44,21164,0,0,21164,322391000,28.5615,625.654,21164,36,37,20996,20716,20811,17999,14196
32605,20,21,0,32605,5257,27348,5120.22,16.5625,543.252,32605,21,21,32581,32580,32571,32571,32548
36889,2,28,6180,30709,0,36889,20.2631,12.0091,588.745,36889,20,21,24587,24587,24266,15124,10972
23761,3,21,0,23761,3761,20000,5085.78,16.08,456.496,23761,20,20,19164,19164,19106,17816,14892
37872,19,23,7227,30645,0,37872,18.7466,16.4132,679.826,37872,21,22,37843,37843,37675,37675,36535
30798,27,40,30798,0,30798,0,86785700000,21.8759,653.472,30798,29,29,30758,30737,30751,30743,30756
7751,1,2,7751,0,7751,0,6.4858e+13,1.99613,121.037,7751,2,2,5964,5964,5964,5964,5964
15964,18,21,0,15964,3942,12022,4270.02,18.0815,458.121,15964,20,20,15936,15935,15826,15828,15902
18163,18,40,18163,0,0,18163,4.65739e+15,34.2482,663.527,18163,37,37,17577,16414,16736,5641,8873
22514,40,44,22514,0,0,22514,5.45007e+15,32.2463,646.887,22514,37,37,22470,22453,22422,22139,22251
42681,1,65,0,42681,42680,1,5.19251e+14,41.4897,1188.54,42681,41,46,2706,2706,2706,2706,2706
9278,11,13,1557,7721,0,9278,20.4393,9.57318,269.35,9278,11,12,9264,9264,9263,9262,9263
6927,6,22,6927,0,6927,0,1.47573e+18,18.37,317.182,6927,20,20,5785,5105,4156,2079,2658
26820,23,44,0,26820,0,26820,1041100,37.2119,849.782,26820,38,37,26497,25424,25657,25531,18913
15459,37,40,0,15459,0,15459,1330930,21.6156,510.311,15459,23,29,15419,15411,15419,15419,12730
20871,5,38,0,20871,20871,0,2.23856e+13,20.159,581.999,20871,30,26,16176,11936,11990,14182,6564
46994,5,40,46994,0,0,46994,5.70317e+15,32.6806,906.461,46994,33,32,36029,26559,26706,6269,11894
17576,19,44,17576,0,17576,0,1.38015e+18,26.5339,587.243,17576,33,37,17365,17034,17240,8396,13357
979,5,9,143,836,0,979,20.0163,6.97957,75.5908,979,8,8,937,937,877,875,567
23302,25,38,23302,0,23302,0,1.46307e+18,21.057,626.761,23302,30,29,23264,23244,23252,19481,23264
1799,1,2,0,1799,1799,0,1.22165e+16,1.99111,56.7604,1799,2,2,1493,1493,1493,1493,1493
44631,7,23,0,44631,7474,37157,5031.35,16.8881,672.647,44631,21,21,43690,43690,42913,42990,42249
18197,42,44,18197,0,0,18197,5.37161e+15,29.4561,592.132,18197,34,37,18153,18143,18081,16665,17056
19615,1,13,3201,16414,0,19615,20.3218,11.3738,390.985,19615,13,13,3354,3354,3354,3354,3354
11242,1,23,0,11242,2110,9132,4737.07,16.4538,370.922,11242,19,21,2515,2515,2515,2515,2515
45124,43,56,45124,0,0,45124,337272000,28.7933,886.321,45124,37,40,45068,45055,45061,44966,40101
19386,1,4,19386,0,19386,0,5.81651e+13,1.99856,195.29,19386,3,3,15887,15887,15887,15887,15887
34110,37,40,0,34110,34110,0,1.9252e+13,35.7935,870.997,34110,39,37,34063,34020,33884,33895,33992
2883,24,32,2883,0,0,2883,327863000,14.0673,183.998,2883,23,21,2851,2839,2850,2846,2849
6074,4,19,1764,4310,0,6074,15.3783,14.5,281.679,6074,17,18,4732,4732,4595,4620,3524
23856,1,4,0,23856,23856,0,8.33664e+15,1.99996,209.734,23856,3,3,21093,21093,21093,21093,21093
3303,24,32,3303,0,3303,0,1.17605e+18,23.6264,255.601,3303,29,27,3249,3171,3210,2611,2864
18029,1,40,18029,0,18029,0,1.26005e+18,33.5719,639.305,18029,37,37,1911,1911,1911,1911,1911
27952,2,4,0,27952,27952,0,9.82182e+15,1.9995,229.052,27952,3,3,27947,27946,27947,27947,26833
31892,49,56,31892,0,0,31892,332714000,35.6223,880.731,31892,38,51,31836,31828,31827,31793,31773
42947,14,40,42947,0,0,42947,5.60556e+15,33.3674,810.937,42947,38,37,42495,41948,41423,6045,19715
47891,1,40,47891,0,47891,0,1.42798e+18,33.1802,861.182,47891,38,37,5857,5857,5857,5857,5857
12192,26,44,12192,0,12192,0,1.40943e+18,19.7467,497.185,12192,25,37,12144,12093,12064,11736,11357
35115,1,4,0,35115,35115,0,8.68631e+15,2.00006,252.095,35115,3,3,30879,30879,30879,30879,30879
19594,19,23,0,19594,3417,16177,4909.86,15.2585,463.332,19594,20,21,19569,19569,19503,19503,19235
20358,3,38,0,20358,20358,0,2.21922e+13,34.5491,610.897,20358,32,31,12696,10666,9176,10666,3153
47217,33,48,0,47217,47217,0,1.96477e+13,37.6922,1096.27,47217,40,41,47134,46988,46699,46603,38920
26370,1,2,0,26370,26370,0,1.40781e+16,1.99924,222.205,26370,2,2,21217,21217,21217,21217,21217
31562,44,60,31562,0,0,31562,5.53365e+15,25.3391,828.464,31562,33,40,31502,31491,31498,30482,28539
16833,12,40,0,16833,16833,0,2.23524e+13,19.9719,529.082,16833,30,24,16310,15253,14190,14311,11250
4365,16,20,4365,0,4365,0,1.46717e+18,15.1326,222.947,4365,16,17,4342,4321,4321,3838,4207
15886,1,2,0,15886,15886,0,1.76674e+16,1.99912,176.204,15886,2,2,11990,11990,11990,11990,11990
10517,11,19,1879,8638,0,10517,20.2799,11.1175,325.639,10517,19,17,10480,10480,10480,10479,10458
49220,24,64,0,49220,0,49220,1139260,36.6081,1168.7,49220,40,44,48798,48054,47974,48092,19693
12302,1,22,12302,0,12302,0,87766500000,19.2972,421.526,12302,21,21,1238,1238,1238,1238,1238
49171,9,28,0,49171,8133,41038,5179.89,17.7675,674.104,49171,28,21,48944,48944,48641,48649,48556
32109,30,40,32109,0,32109,0,87318800000,29.0049,735.241,32109,31,30,32060,32021,32046,32046,31033
13969,1,2,0,13969,13969,0,9.07361e+15,1.99857,155.9,13969,2,2,12209,12209,12209,12209,12209
2240,16,20,2240,0,0,2240,339948000,12.8562,158.991,2240,15,17,2220,2210,2214,2213,2154
37899,21,44,37899,0,37899,0,79831400000,37.2074,898.078,37899,38,41,37481,36655,37026,35979,23691
35891,35,40,0,35891,35891,0,2.23743e+13,22.8409,750.369,35891,31,28,35851,35835,35848,35847,35851
35509,34,40,35509,0,0,35509,5.71698e+15,23.1486,743.479,35509,32,28,35469,35453,35465,35469,35469
18341,1,44,0,18341,18341,0,2.0862e+13,30.7121,647.293,18341,32,41,1987,1987,1987,1987,1987
9083,14,19,1402,7681,0,9083,20.0462,9.87042,260.985,9083,19,18,9059,9059,9059,9059,9056
18347,29,31,6419,11928,6,18341,15341300000,19.6872,572.392,18347,26,24,18316,18316,18314,18316,18256
45291,22,48,0,45291,45291,0,1.96518e+13,38.4241,1074.96,45291,40,41,44830,43787,44336,43065,27889
19542,3,4,19542,0,19542,0,6.48882e+13,1.99944,197.063,19542,3,3,19538,19536,19537,19538,19538
28245,31,44,28245,0,0,28245,5.48448e+15,26.5478,708.586,28245,35,37,28181,28044,28054,18019,24565
48586,13,21,7988,40598,0,48586,20.1484,15.2244,664.513,48586,21,21,48517,48517,48481,48493,48381
41614,1,2,41614,0,41614,0,4.1233e+13,1.99964,270.541,41614,2,2,35517,35517,35517,35517,35517
20501,10,21,4329,16172,0,20501,17.6257,17.9164,496.676,20501,21,19,20114,20093,19874,19960,8041
8378,11,24,8378,0,0,8378,341856000,18.5908,334.023,8378,20,21,8136,7786,7131,7140,5359
40568,43,44,40568,0,0,40568,283074000,38.6923,1005.93,40568,39,39,40524,40502,40413,39613,40522
21004,20,28,3420,17584,0,21004,20.1388,12.7868,448.285,21004,21,21,20975,20974,20975,20975,20965
21047,16,38,21047,0,21047,0,86376100000,29.3831,622.767,21047,32,31,20733,20045,19698,19511,17194
4054,37,48,3935,119,4054,0,6.29063e+15,22.3922,335.549,4054,25,28,4006,4004,3975,3979,3345
49371,39,44,0,49371,49371,0,2.11077e+13,34.7488,939.104,49371,38,37,49324,49274,49205,49189,49315
44227,2,40,44227,0,44227,0,1.45423e+18,36.8839,921.41,44227,34,38,23252,23252,14756,4365,6288
3400,28,40,3400,0,0,3400,277949000,27.7818,284.226,3400,29,33,3354,3325,3279,3002,2519
15595,1,2,15595,0,15595,0,3.51596e+13,1.99853,164.562,15595,2,2,13646,13646,13646,13646,13646
25486,1,2,25486,0,25486,0,3.26249e+13,1.99906,211.746,25486,2,2,22531,22531,22531,22531,22531
49442,14,44,49442,0,0,49442,5.53682e+15,30.6073,914.856,49442,37,38,48716,47689,47480,14578,24925
11100,10,40,11100,0,11100,0,1.25193e+18,32.4355,485.109,11100,33,33,10040,9146,9267,1928,3482
49869,10,40,0,49869,49869,0,2.21551e+13,27.7574,873.884,49869,40,37,48094,46462,41891,41481,23946
42027,23,44,0,42027,0,42027,1271410,32.2049,846.599,42027,37,37,41784,41294,41509,41502,25863
35122,34,60,35122,0,0,35122,5.59703e+15,23.5696,856.412,35122,32,40,35062,35048,34972,34099,32840
31123,9,60,0,31123,31123,0,2.04644e+13,31.6113,916.266,31123,37,44,27867,23325,23958,23494,10448
37061,1,2,37061,0,37061,0,3.26429e+13,1.99938,254.788,37061,2,2,32762,32762,32762,32762,32762
24084,1,13,0,24084,3950,20134,5203.04,11.5886,436.17,24084,13,13,4098,4098,4098,4098,4098
24665,1,2,0,24665,24665,0,8.36704e+15,1.99943,207.31,24665,2,2,21800,21800,21800,21800,21800
16988,1,2,16988,0,16988,0,3.68496e+13,1.99847,175.642,16988,2,2,14763,14763,14763,14763,14763
12138,10,48,12138,0,12138,0,63407600000,33.3061,597.146,12138,33,37,9143,6377,7607,7014,1706
19734,21,38,19734,0,0,19734,341302000,21.3935,573.379,19734,30,28,19684,19542,19645,19637,19261
46970,54,56,46970,0,46970,0,1.45282e+18,34.8352,897.974,46970,35,39,46914,46889,46913,46732,46914
35255,12,40,0,35255,0,35255,1328880,22.2696,705.617,35255,31,29,34539,32960,30393,31009,20655
15361,1,2,15361,0,15361,0,3.24152e+13,1.99876,164.825,15361,2,2,13591,13591,13591,13591,13591
4083,5,22,0,4083,4083,0,2.24513e+13,17.4587,241.299,4083,19,19,3183,2351,2416,2795,1096
45875,27,56,0,45875,45875,0,2.20966e+13,28.909,892.665,45875,37,40,45780,45672,45719,45698,40531
25810,35,40,25810,0,0,25810,5.54662e+15,32.3849,636.009,25810,37,37,25764,25676,25716,23180,25196
1748,6,17,320,1428,0,1748,18.0915,8.59725,129.627,1748,15,16,1656,1656,1642,1650,1563
13772,1,40,0,13772,0,13772,1325190,18.6531,445.215,13772,28,29,1576,1576,1576,1576,1576
33325,1,2,33325,0,33325,0,3.29915e+13,1.99937,240.293,33325,2,2,29418,29418,29418,29418,29418
15632,1,2,15632,0,15632,0,3.25554e+13,1.99846,164.957,15632,2,2,13823,13823,13823,13823,13823
16111,18,24,16111,0,0,16111,5.74376e+15,20.4672,472.353,16111,21,21,16072,16029,15945,13632,14375
36805,4,44,36805,0,0,36805,5.25078e+15,36.2575,887.728,36805,38,41,26936,21416,21301,5196,7540
16459,22,40,16459,0,0,16459,339972000,21.3196,518.707,16459,27,28,16416,16385,16395,16392,15400
32719,15,40,32719,0,32719,0,1.31879e+18,34.204,815.533,32719,39,37,31562,28989,30766,6673,15939
46089,20,21,0,46089,7606,38483,5185.01,14.0253,632.718,46089,21,20,46066,46065,46065,46066,46053
39712,4,21,0,39712,8243,31469,4580.8,18.2515,696.354,39712,21,20,34487,34487,32312,32327,11267
32640,11,44,32640,0,0,32640,262432000,34.1202,931.727,32640,37,37,26875,20216,23844,23645,10697
24712,14,40,0,24712,24712,0,2.21189e+13,26.6565,713.2,24712,36,35,24215,23724,21341,22945,11496
17606,10,24,17606,0,17606,0,1.46261e+18,21.1176,483.844,17606,22,22,17002,16450,14498,6569,11004
2556,1,2,2556,0,2556,0,3.2156e+13,1.99022,66.7108,2556,2,2,2263,2263,2263,2263,2263
12004,11,40,12004,0,12004,0,86335900000,18.0203,412.326,12004,20,29,11709,11273,10609,10556,7350
47052,22,60,47052,0,0,47052,329675000,31.6995,963.88,47052,37,44,46804,46424,46560,40143,31897
49280,1,2,49280,0,49280,0,3.84572e+13,1.99949,293.86,49280,2,2,42546,42546,42546,42546,42546
11580,1,2,11580,0,11580,0,3.3179e+13,1.99896,141.679,11580,2,2,10214,10214,10214,10214,10214
46800,19,23,7727,39073,0,46800,19.6007,19.485,684.631,46800,22,21,46767,46767,46683,46683,46369
17085,16,40,0,17085,0,17085,1330380,21.29,534.751,17085,30,26,16924,16555,16158,16059,13529
46597,21,40,46597,0,0,46597,5.71288e+15,31.314,890.11,46597,33,31,46491,46142,46342,38307,43737
30996,3,23,5955,25041,0,30996,18.7708,19.5494,620.449,30996,21,22,24190,24181,24080,22803,18752
21937,1,2,21937,0,21937,0,3.26679e+13,1.99909,195.677,21937,2,2,19390,19390,19390,19390,19390
20521,19,44,20521,0,0,20521,5.01687e+15,32.6308,708.953,20521,37,41,20105,19208,19621,8717,10864
15880,21,40,15880,0,15880,0,1.19637e+18,33.9472,623.609,15880,36,37,15585,14832,15138,5792,10234
24880,12,21,0,24880,3921,20959,5074.07,16.8629,466.877,24880,20,20,24792,24791,24746,24767,24641
30194,9,21,4845,25349,0,30194,19.9903,16.1875,518.333,30194,20,21,30033,30033,29986,30010,29845
11748,1,2,11748,0,11748,0,3.30879e+13,1.99949,142.314,11748,2,2,10366,10366,10366,10366,10366
30587,43,60,30587,0,0,30587,328390000,26.5282,813.996,30587,34,40,30527,30517,30523,30059,26118
48816,1,2,48816,0,48816,0,3.39793e+13,1.99959,290.759,48816,2,2,42922,42922,42922,42922,42922
37655,3,25,0,37655,9411,28244,4392.58,17.6771,754.182,37655,22,23,27425,27382,27209,26238,20326
2183,5,17,0,2183,554,1629,4069.73,10.366,159.512,2183,15,15,1873,1873,1854,1869,825
47029,21,32,9995,37034,0,47029,18.8538,13.9828,866.408,47029,21,25,46997,46997,46868,46868,41424
1520,5,22,1520,0,1520,0,1.46979e+18,16.2026,153.803,1520,17,19,1141,840,856,649,519
9599,10,40,9599,0,0,9599,328868000,26.29,409.676,9599,32,37,9198,8849,8380,8366,4581
31863,29,44,0,31863,0,31863,1276690,35.0906,769.159,31863,36,37,31771,31609,31591,31590,25965
45041,26,40,45041,0,0,45041,4.18124e+15,35.9074,1099.84,45041,39,37,44790,43995,44066,36189,33564
31612,1,4,0,31612,31612,0,8.33363e+15,2.97858,243.317,31612,4,4,27951,27951,27951,27951,27951
31627,8,40,31627,0,31627,0,1.44143e+18,31.3529,702.568,31627,38,37,29233,25386,24584,5409,11498
47363,3,40,0,47363,47363,0,2.19133e+13,32.9957,853.568,47363,39,37,32099,27392,24867,25518,9367
42002,42,44,42002,0,0,42002,4.55847e+15,39.1959,1055.1,42002,38,39,41956,41931,41742,40955,41956
21900,9,21,0,21900,4670,17230,4546.56,18.6219,523.465,21900,21,20,21394,21394,21155,21264,18193
25425,9,40,25425,0,0,25425,339493000,20.9131,591.304,25425,29,29,24081,20564,20960,21029,13542
4247,19,20,0,4247,0,4247,1321340,14.6207,215.515,4247,16,17,4227,4217,4219,4218,4227
32719,15,20,5601,27118,0,32719,20.2808,17.5312,560.421,32719,20,20,32685,32685,32685,32685,32672
13679,29,44,0,13679,0,13679,1275460,33.5677,519.902,13679,29,37,13628,13598,13560,13557,12456
45915,1,4,45915,0,45915,0,5.96851e+13,1.99967,298.917,45915,3,3,36686,36686,36686,36686,36686
4525,18,21,1198,3327,0,4525,17.2756,12.1777,263.421,4525,16,20,4504,4504,4478,4478,4114
35567,25,44,35567,0,0,35567,5.37936e+15,35.9954,816.354,35567,37,37,35380,35029,35036,10998,27938
4244,12,19,1155,3089,0,4244,15.5203,15.6345,228.793,4244,17,17,4169,4162,4120,4131,3753
45754,22,48,45754,0,0,45754,4.95107e+15,35.7957,1084.38,45754,38,41,45276,44099,44759,13546,30358
5634,1,4,0,5634,5634,0,8.59473e+15,1.99982,104.752,5634,3,3,4959,4959,4959,4959,4959
2602,7,22,0,2602,2602,0,2.25446e+13,17.0238,187.568,2602,18,17,2293,1984,1762,1966,833
21073,45,56,21073,0,0,21073,332258000,35.1952,626.104,21073,37,41,21017,21011,21009,20954,15326
3039,14,32,3039,0,3039,0,9.94627e+17,25.2221,263.682,3039,29,25,2591,1585,2323,1052,1660
2038,10,11,326,1712,0,2038,20.2434,8.55397,120.267,2038,10,10,2026,2026,2023,2023,2026
26706,29,40,26706,0,26706,0,85688400000,31.2711,642.233,26706,37,37,26638,26562,26587,26567,22798
30464,25,40,30464,0,0,30464,340845000,23.1781,695.343,30464,31,28,30424,30402,30410,30409,30424
23652,9,40,0,23652,0,23652,1269510,27.6077,645.391,23652,36,35,22172,19350,20045,19955,9689
8737,17,28,0,8737,1563,7174,5129.38,11.1642,319.097,8737,19,21,8707,8707,8704,8704,8677
3939,6,19,0,3939,1173,2766,3915.32,15.7157,227.23,3939,18,17,3361,3361,3329,3353,2636
14718,15,38,14718,0,0,14718,337272000,28.5964,519.202,14718,31,30,14428,13994,13651,13194,10431
35010,46,60,0,35010,35010,0,2.13197e+13,34.1806,980.942,35010,38,51,34950,34940,34946,34947,31708
26791,24,38,26791,0,26791,0,1.44533e+18,37.1645,774.035,26791,38,38,26513,26041,26224,19001,20001
43150,1,2,43150,0,43150,0,3.26681e+13,1.99963,274.691,43150,2,2,38141,38141,38141,38141,38141
35896,10,21,7750,28146,0,35896,17.6625,18.3881,670.03,35896,21,20,35254,35218,34796,34926,30745
26959,1,2,26959,0,26959,0,5.10975e+13,1.99974,221.338,26959,2,2,22064,22064,22064,22064,22064
19379,15,24,19379,0,19379,0,87664400000,21.1183,528.489,19379,24,22,19202,18879,18368,18264,14152
34627,35,44,34627,0,0,34627,5.35273e+15,36.6856,807.284,34627,38,37,34573,34465,34414,29755,33168
2972,1,2,0,2972,2972,0,1.84751e+16,1.99664,76.6116,2972,2,2,2209,2209,2209,2209,2209
17522,3,13,2853,14669,0,17522,20.2977,11.5699,371.15,17522,13,13,13841,13841,13800,12174,9525
38335,13,44,0,38335,38335,0,2.1039e+13,37.0373,843,38335,37,37,37211,35267,36237,35295,19486
26994,38,40,26994,0,0,26994,341513000,21.4188,663.452,26994,30,29,26954,26942,26954,26954,26165
45648,1,2,0,45648,45648,0,1.0008e+16,1.99985,282.637,45648,2,2,39307,39307,39307,39307,39307
24178,7,44,24178,0,24178,0,1.1506e+18,34.7531,794.596,24178,36,37,18245,14907,15235,4330,6021
9757,1,2,9757,0,9757,0,3.24257e+13,1.99826,131.044,9757,2,2,8632,8632,8632,8632,8632
28436,34,44,0,28436,28436,0,2.12653e+13,34.9471,715.658,28436,37,37,28384,28283,28284,28273,26761
4971,29,32,4971,0,4971,0,81741800000,19.4295,267.395,4971,31,28,4933,4901,4915,4911,4912
46802,11,48,46802,0,46802,0,1.31679e+18,37.9038,1052.62,46802,40,41,43224,39033,40158,8557,16450
6186,2,11,992,5194,0,6186,20.3427,9.34497,208.456,6186,11,10,4200,4200,4192,3022,3022
47566,29,56,47566,0,0,47566,339485000,34.677,893.699,47566,40,32,47498,47452,47474,47473,42523
4269,12,40,4269,0,4269,0,1.44318e+18,18.9131,288.429,4269,24,28,4105,3842,3479,2068,2492
7164,17,24,0,7164,0,7164,1338710,17.4389,312.503,7164,19,21,7128,7027,7078,7075,6576
46558,37,49,0,46558,46554,4,4.77155e+14,38.5975,1147.3,46558,40,41,46500,46433,46151,46204,45392
14727,1,2,0,14727,14727,0,8.4647e+15,1.99905,159.798,14727,2,2,12996,12996,12996,12996,12996
37598,33,44,37598,0,0,37598,5.2576e+15,35.8841,894.564,37598,39,41,37528,37399,37263,31185,33884
36134,7,40,0,36134,0,36134,1300230,35.7747,751.718,36134,37,37,32743,29124,26726,27819,11903
13852,11,36,13852,0,0,13852,324251000,28.3533,457.082,13852,33,33,13454,12973,13050,13063,6487
24928,16,40,24928,0,0,24928,333657000,30.0388,610.246,24928,34,37,24746,24487,24549,24549,17357
15352,13,40,0,15352,15352,0,2.22188e+13,21.8422,506.493,15352,29,28,15039,14160,13330,13586,10074
19115,1,24,19115,0,0,19115,341899000,20.8523,506.962,19115,21,22,2092,2092,2092,2092,2092
30114,15,21,4765,25349,0,30114,19.9101,15.7698,509.446,30114,20,20,30061,30061,30039,30041,29926
25253,37,56,25253,0,0,25253,5.67979e+15,23.6133,692.692,25253,32,38,25197,25187,25167,25161,24909
5466,13,24,5466,0,0,5466,5.69191e+15,17.4383,274.831,5466,19,21,5374,5125,4851,4250,4371
24484,1,4,0,24484,24484,0,8.39357e+15,1.99984,212.106,24484,3,3,21629,21629,21629,21629,21629
12396,12,21,2867,9529,0,12396,17.2278,17.0186,401.711,12396,19,20,12258,12248,12145,12171,10669
37758,1,23,0,37758,6574,31184,4899.78,19.6634,636.509,37758,21,21,7884,7884,7884,7884,7884
38820,1,2,0,38820,38820,0,1.18054e+16,1.99954,264.144,38820,2,2,32459,32459,32459,32459,32459
37992,38,40,37992,0,37992,0,1.45257e+18,27.6244,732.654,37992,32,29,37950,37921,37948,35651,37885
47357,45,56,0,47357,47357,0,2.21058e+13,36.1118,904.45,47357,40,40,47301,47274,47288,47287,47301
19069,32,40,19069,0,19069,0,85392100000,23.4635,542.404,19069,32,37,19021,18987,18975,18971,18511
38905,1,2,38905,0,38905,0,3.27453e+13,1.99974,260.701,38905,2,2,34378,34378,34378,34378,34378
41374,1,2,41374,0,41374,0,3.29546e+13,1.99944,268.227,41374,2,2,36529,36529,36529,36529,36529
45740,2,21,7430,38310,0,45740,20.1816,14.5454,627.121,45740,21,20,31056,31056,30893,21617,21605
8429,1,2,8429,0,8429,0,3.23584e+13,1.99929,122.229,8429,2,2,7459,7459,7459,7459,7459
9118,1,2,9118,0,9118,0,3.25372e+13,1.99803,125.953,9118,2,2,8063,8063,8063,8063,8063
12677,20,36,12677,0,12677,0,84507600000,25.3119,431.986,12677,34,33,12585,12507,12536,12390,9121
17760,2,4,0,17760,17760,0,1.03136e+16,1.99955,182.901,17760,3,3,17755,17754,17755,17755,16195
32100,19,21,0,32100,6198,25902,4712.44,17.3085,612.411,32100,21,20,32073,32073,31959,31959,31488
18649,35,60,18649,0,0,18649,5.15847e+15,25.895,747.065,18649,35,44,18587,18555,18432,17795,12871
22276,12,40,22276,0,0,22276,5.50476e+15,33.931,608.253,22276,36,35,21714,20882,20340,3021,8211
6492,1,19,0,6492,1177,5315,5167.16,11.47,264.218,6492,13,19,989,989,989,989,989
42976,37,40,42976,0,0,42976,311503000,32.2785,946.882,42976,40,37,42929,42886,42746,39513,41592
48161,10,30,8587,39574,0,48161,19.6623,15.8601,828.555,48161,20,29,47733,47727,47519,47565,46279
9001,1,2,9001,0,9001,0,3.32729e+13,1.99611,124.577,9001,2,2,7936,7936,7936,7936,7936
21376,29,38,21376,0,0,21376,5.59748e+15,34.437,677.895,21376,36,37,21272,21042,21128,21185,19503
16238,22,23,2895,13343,0,16238,19.0383,14.7925,430.697,16238,19,21,16215,16215,16176,16176,16212
41894,29,65,41893,1,41893,1,2.07547e+12,32.4006,1300.76,41894,38,59,41741,41441,41324,40279,29141
40127,40,60,0,40127,0,40127,1231310,30.6352,992.044,40127,40,44,40067,40057,39794,39797,26079
40127,35,67,40127,0,40127,0,1.07479e+18,35.6362,1064,40127,44,37,40047,39900,39076,33179,33544
31746,29,56,0,31746,0,31746,1314150,24.9362,763.321,31746,32,40,31675,31614,31615,31624,29259
47085,1,40,0,47085,47085,0,2.20711e+13,31.5151,839.498,47085,38,37,5553,5553,5553,5553,5553
34055,30,40,34055,0,34055,0,1.46262e+18,22.0782,694.934,34055,31,29,34015,33996,34011,28032,34013
14629,43,44,0,14629,14629,0,2.17088e+13,31.7583,548.526,14629,28,41,14585,14574,14584,14585,14521
38714,23,60,38714,0,0,38714,5.48493e+15,33.9759,863.687,38714,37,44,38489,38092,38251,8199,24121
36183,9,40,36183,0,0,36183,340444000,33.1896,774.142,36183,32,31,33600,27679,27447,27650,16750
42724,15,44,42724,0,42724,0,1.34448e+18,35.7473,941.135,42724,38,41,41459,38717,40530,7349,19438
16368,1,2,16368,0,16368,0,3.29316e+13,1.99933,168.449,16368,2,2,14452,14452,14452,14452,14452
35073,19,40,35073,0,35073,0,1.46709e+18,28.2426,763.509,35073,32,31,34958,34763,34657,15251,31777
42019,4,30,0,42019,7775,34244,5016.04,17.7629,794.981,42019,19,29,36529,36529,32831,26083,23609
28047,7,40,28047,0,0,28047,335016000,30.894,656.87,28047,37,37,25355,22478,20533,21353,10963
44983,3,4,0,44983,44983,0,8.37786e+15,1.99993,285.306,44983,3,3,44979,44977,44978,44978,44979
2575,4,32,0,2575,2575,0,2.1278e+13,14.341,173.803,2575,21,21,2030,1626,1656,1730,880
19540,656,2417,19235,305,0,19540,9.87963e+17,127.12,4158.32,19540,497,199,17123,16869,15744,13829,5737
48914,37,66,48914,0,0,48914,5.20896e+15,35.6391,1406.36,48914,41,58,48837,48691,48381,25527,25496
15891,10,24,15891,0,0,15891,5.73727e+15,20.7586,465.564,15891,21,22,15265,14697,12944,5659,9325
3175,1,2,3175,0,3175,0,3.26245e+13,1.99622,74.2688,3175,2,2,2806,2806,2806,2806,2806
33744,15,60,33744,0,33744,0,79242600000,36.145,1053.61,33744,38,54,32302,29364,30818,29646,15093
16040,6,38,0,16040,16040,0,2.22455e+13,31.9243,537.886,16040,31,30,13236,11602,9463,11344,5641
3766,6,18,3766,0,0,3766,5.75985e+15,17.2722,225.178,3766,18,18,3172,2815,2254,1228,1602
13488,29,40,0,13488,0,13488,1321510,18.9648,434.712,13488,26,29,13448,13433,13443,13441,13446
13042,38,64,13042,0,0,13042,5.66567e+15,20.5915,580.001,13042,30,44,12978,12978,12974,12978,12413
12526,20,21,0,12526,2018,10508,5165.78,10.2271,323.669,12526,20,18,12505,12505,12504,12505,12504
17611,6,60,0,17611,17611,0,2.13075e+13,27.6437,660.57,17611,32,40,14747,13128,11167,12544,5916
3926,16,17,640,3286,0,3926,18.811,11.5777,186.019,3926,17,17,3906,3905,3900,3900,3880
35651,1,2,0,35651,35651,0,1.03687e+16,1.99989,250.288,35651,2,2,30520,30520,30520,30520,30520
10710,9,40,10710,0,0,10710,5.6665e+15,20.2561,436.706,10710,30,24,9914,8182,8032,5202,5070
38762,30,56,38762,0,0,38762,5.64417e+15,26.8207,896.253,38762,38,42,38658,38500,38520,33017,34600
29372,27,28,4911,24461,0,29372,20.0248,13.1964,557.883,29372,20,25,29344,29344,29344,29344,29310
1194,5,18,1194,0,1194,0,1.47447e+18,12.2781,119.777,1194,14,15,950,703,689,630,542
18793,22,24,18793,0,0,18793,342029000,21.4319,510.563,18793,22,22,18765,18739,18745,18745,17450
648,8,9,96,552,0,648,19.9815,7.40586,62.9487,648,8,8,638,638,638,638,638
23556,1,2,23556,0,23556,0,3.46287e+13,1.99962,202.39,23556,2,2,20657,20657,20657,20657,20657
15279,26,40,0,15279,15279,0,2.22625e+13,18.5055,466.646,15279,28,29,15239,15223,15233,15225,15237
38565,49,56,0,38565,38565,0,2.2107e+13,23.761,825.306,38565,33,40,38509,38498,38502,38509,38437
11874,21,36,11874,0,0,11874,334516000,22.6782,391.826,11874,27,25,11823,11789,11809,11805,11343
8719,6,38,8719,0,0,8719,339516000,20.1825,395.096,8719,30,22,7175,6269,5161,3967,3292
45146,20,27,14305,30841,4,45142,6234580000,21.0619,844.153,45146,26,22,45111,45108,44818,44762,33897
46448,13,79,45827,621,46443,5,6.72866e+14,15.6911,790.604,46448,34,36,46006,45469,44450,44323,34923
8674,18,36,0,8674,0,8674,1272610,27.1223,361.732,8674,32,33,8572,8486,8525,8523,6509
49719,26,40,49719,0,0,49719,5.70212e+15,33.2195,937.482,49719,34,32,49630,49527,49573,49619,47777
26378,18,40,26378,0,26378,0,87248800000,21.1466,646.385,26378,31,24,26288,26186,26018,25981,23288
25932,1,2,25932,0,25932,0,4.80848e+13,1.99892,216.443,25932,2,2,21501,21501,21501,21501,21501
2486,13,20,2486,0,0,2486,5.65577e+15,13.8407,168.753,2486,15,17,2453,2375,2396,2133,2320
20241,2,5,20241,0,20241,0,6.44134e+13,1.99946,202.28,20241,3,4,20235,20234,18603,20234,20235
24068,1,2,0,24068,24068,0,8.41291e+15,1.99938,204.576,24068,2,2,21257,21257,21257,21257,21257
29818,1,2,29818,0,29818,0,5.8149e+13,1.99913,237.218,29818,2,2,23657,23657,23657,23657,23657
21868,12,24,21868,0,0,21868,341547000,20.8723,570.499,21868,24,22,21255,19942,18433,19129,14266
22008,1,2,0,22008,22008,0,8.41785e+15,1.9995,195.606,22008,2,2,19436,19436,19436,19436,19436
21060,5,21,0,21060,3415,17645,5038.61,17.2434,445.891,21060,20,20,19867,19867,18201,18204,18332
8477,1,19,1564,6913,0,8477,19.9325,15.1633,303.823,8477,19,19,1270,1270,1270,1270,1270
27636,7,60,27636,0,27636,0,1.36687e+18,25.7002,864.149,27636,44,44,23469,20058,18201,4564,8219
2701,2,4,0,2701,2701,0,1.14449e+16,1.99963,74.1655,2701,3,3,2696,2695,2696,2696,2313
13684,1906,1939,13516,168,13516,168,2.76885e+18,190.621,3306.17,13684,776,173,11745,11745,11739,11745,11742
32407,1,2,32407,0,32407,0,3.25016e+13,1.99954,237.973,32407,2,2,28664,28664,28664,28664,28664
41952,3,4,0,41952,41952,0,8.33561e+15,3.11587,278.817,41952,4,4,41946,41942,41945,41945,40467
23176,4,44,23176,0,23176,0,1.39239e+18,27.795,652.001,23176,36,37,17351,13671,13488,3259,6631
5314,31,49,5314,0,5314,0,1.34667e+18,18.8871,399.032,5314,29,40,5265,5262,5256,4376,4019
48673,2,4,0,48673,48673,0,9.09288e+15,1.99971,297.2,48673,3,3,48668,48667,48668,48668,46134
14895,1,2,0,14895,14895,0,8.3402e+15,1.99846,160.563,14895,2,2,13170,13170,13170,13170,13170
9383,5,19,0,9383,1492,7891,4957.39,16.9613,287.553,9383,19,19,8894,8894,8319,8333,8460
28026,21,23,0,28026,5644,22382,4727.08,18.7834,601.965,28026,20,22,28003,28003,27896,27897,27447
22833,1,4,0,22833,22833,0,1.49146e+16,1.99991,213.513,22833,3,3,18104,18104,18104,18104,18104
23282,9,21,3743,19539,0,23282,19.7141,16.426,463.531,23282,20,20,23109,23109,23059,23095,22868
37486,18,19,0,37486,7158,30328,5025.65,18.0097,695.905,37486,19,19,37440,37440,37360,37360,37360
20028,17,40,20028,0,0,20028,5.72569e+15,20.8136,573.206,20028,30,26,19899,19454,19506,16357,17360
38066,30,68,0,38066,38025,41,4.5198e+15,34.9356,1043.72,38066,53,37,37947,37716,37635,37242,32950
36176,10,28,0,36176,6054,30122,5186.41,11.926,583.368,36176,20,21,36090,36090,36010,36013,36003
38763,20,44,38763,0,0,38763,321235000,36.7567,846.448,38763,37,37,38377,37873,38080,32456,25973
30324,2,60,30324,0,0,30324,328861000,28.1108,817.858,30324,33,40,16926,16884,11971,6227,4850
49006,14,44,0,49006,0,49006,1016480,36.8999,1149.09,49006,40,37,43003,29558,39145,38721,18617
10766,20,23,0,10766,1773,8993,5172.31,10.4002,322,10766,12,21,10743,10743,10743,10743,10716
30276,29,40,30276,0,0,30276,341358000,21.73,694.702,30276,30,29,30236,30218,30229,30230,28668
27642,1,2,27642,0,27642,0,3.28398e+13,1.99964,218.867,27642,2,2,24416,24416,24416,24416,24416
20152,1,21,0,20152,3246,16906,5179.76,10.5341,403.608,20152,19,20,3541,3541,3541,3541,3541
32479,7,21,0,32479,8633,23846,4201.75,18.7117,672.922,32479,21,20,29596,29596,29399,29582,14409
13449,7,19,0,13449,2388,11061,5201.01,11.0955,364.152,13449,19,12,13099,13099,12255,12606,11851
14532,5,19,0,14532,2615,11917,5167.63,11.7731,383.535,14532,19,19,13268,13268,11873,11291,5085
34433,36,40,0,34433,0,34433,1217610,32.0713,847.041,34433,40,37,34385,34356,34193,34193,30999
34115,3,21,0,34115,5606,28509,5196.42,12.0553,532.883,34115,21,20,26884,26884,26799,22647,15845
47191,16,44,47191,0,0,47191,311907000,40.458,1001.22,47191,41,39,45959,42671,44931,44890,23627
42123,4,5,1,42122,42123,0,1.47235e+16,2.20025,304.078,42123,4,4,42118,42116,42117,42117,42118
44189,25,40,44189,0,0,44189,337383000,29.1828,825.602,44189,40,36,44098,44005,44031,11711,33462
21418,1,2,0,21418,21418,0,1.01536e+16,1.99958,193.53,21418,2,2,18399,18399,18399,18399,18399
36847,26,40,36847,0,0,36847,341012000,29.1855,782.269,36847,32,30,36793,36753,36770,36771,36793
31298,14,44,0,31298,31298,0,1.81711e+13,36.6974,896.619,31298,38,39,28485,22479,26726,24742,14052
5488,5,40,0,5488,5488,0,2.11464e+13,29.7823,312.134,5488,31,32,4497,3489,3755,3868,1680
26023,59,60,26023,0,26023,0,83432300000,27.752,766.862,26023,34,40,25963,25953,25962,25963,25823
32099,1,2,32099,0,32099,0,3.72856e+13,1.99953,236.725,32099,2,2,27846,27846,27846,27846,27846
22195,1,40,22195,0,22195,0,1.38979e+18,27.9954,620.678,22195,36,35,2700,2700,2700,2700,2700
20900,4,5,1,20899,20900,0,8.17112e+15,3.64923,213.938,20900,4,4,20895,20893,20894,20894,20895
22158,1,2,22158,0,22158,0,3.28756e+13,1.9991,196.12,22158,2,2,19569,19569,19569,19569,19569
26915,36,44,0,26915,26915,0,2.14057e+13,26.9555,697.856,26915,36,37,26871,26858,26747,26764,24464
26202,1,40,26202,0,0,26202,331213000,31.5629,630.544,26202,34,37,3266,3266,3266,3266,3266
23588,7,21,3733,19855,0,23588,19.8665,16.1319,454.985,23588,20,20,23232,23232,22873,22900,22673
41353,45,60,41353,0,41353,0,81449500000,29.8065,1021.23,41353,37,44,41293,41282,41222,41221,34439
21456,5,60,0,21456,0,21456,1159530,36.2212,768.496,21456,37,43,16439,12888,13763,13309,3376
46555,8,44,46555,0,0,46555,325712000,31.12,904.005,46555,37,37,42898,37844,37011,37945,10864
1815,19,22,1815,0,1815,0,86940600000,20.1763,171.651,1815,19,19,1790,1773,1781,1778,1422
48899,21,28,0,48899,8121,40778,5150.11,15.0735,697.057,48899,20,27,48871,48871,48871,48871,48706
14511,7,38,0,14511,14511,0,2.22882e+13,32.8229,511.298,14511,31,30,12474,10532,9131,10506,4299
29164,14,40,29164,0,29164,0,84939200000,31.3792,671.702,29164,37,37,28811,28388,28219,27836,15294
2037,1,2,2037,0,2037,0,3.34398e+13,1.99705,59.4663,2037,2,2,1794,1794,1794,1794,1794
29113,21,40,29113,0,29113,0,1.43832e+18,30.9355,667.75,29113,37,37,29001,28893,28925,11427,23592
7970,4,36,7970,0,7970,0,84860400000,23.9647,321.216,7970,25,25,6129,4809,4731,5217,2740
5768,20,40,0,5768,5768,0,2.20116e+13,18.3795,315.283,5768,22,24,5728,5710,5710,5705,4561
9041,34,36,9041,0,0,9041,5.52701e+15,24.71,344.658,9041,27,25,9003,8976,9001,8531,9001
27834,37,44,27834,0,0,27834,264469000,36.871,868.389,27834,37,37,27787,27748,27489,25680,26824
44730,40,44,0,44730,0,44730,1202310,38.6127,1002.35,44730,40,41,44686,44665,44612,44612,44685
2969,1,2,0,2969,2969,0,8.85855e+15,1.99663,71.7603,2969,2,2,2603,2603,2603,2603,2603
44839,28,38,44839,0,0,44839,337873000,31.3241,943.022,44839,38,34,44715,44467,44554,44554,43597
31497,1,2,31497,0,31497,0,3.40841e+13,1.99959,233.705,31497,2,2,27682,27682,27682,27682,27682
14656,14,21,2346,12310,0,14656,19.762,13.2403,367.302,14656,19,20,14612,14611,14589,14589,14487
20893,29,40,0,20893,20893,0,1.94402e+13,34.7008,674.442,20893,37,37,20803,20614,20523,20303,18188
47354,1,40,47354,0,47354,0,1.4611e+18,34.0174,917.959,47354,33,34,4622,4622,4622,4622,4622
865,1,2,865,0,865,0,3.25405e+13,1.98728,39.2009,865,2,2,764,764,764,764,764
5497,12,21,0,5497,919,4578,4883.42,17.7626,241.264,5497,18,19,5441,5440,5398,5416,5230
40729,39,40,40729,0,0,40729,340586000,32.7112,817.414,40729,32,31,40688,40649,40686,40687,40688
23498,10,44,23498,0,23498,0,1.39751e+18,34.6852,653.995,23498,33,37,22465,21544,20282,3340,10101
21312,1,19,0,21312,3439,17873,5044.28,13.869,438.048,21312,19,19,4162,4162,4162,4162,4162
44220,7,48,44220,0,44220,0,1.24428e+18,34.9318,1076.04,44220,38,41,35757,30279,29869,8424,12038
48406,10,20,0,48406,8412,39994,5194.4,18.0058,686.601,48406,20,20,48262,48262,48120,48119,48140
25547,52,56,25547,0,25547,0,84627700000,37.077,778.185,25547,37,49,25491,25479,25487,25491,25447
48063,6,40,48063,0,0,48063,5.72084e+15,30.5632,886.121,48063,32,31,40441,35875,28840,7017,16122
48929,11,40,48929,0,48929,0,87165800000,35.3889,906.805,48929,33,31,46975,44354,40837,40037,27077
38474,2,40,0,38474,38474,0,2.23236e+13,32.7025,796.556,38474,32,31,20764,20763,13614,17170,5819
48374,1,2,48374,0,48374,0,3.34286e+13,1.99971,290.518,48374,2,2,42628,42628,42628,42628,42628
26103,9,25,0,26103,7503,18600,4083.72,20.1234,630.488,26103,22,21,25191,25191,24575,24722,9536
14770,32,36,0,14770,0,14770,1293680,23.8267,459.307,14770,34,33,14726,14692,14694,14695,14694
19662,31,40,0,19662,0,19662,1328000,21.7218,577.869,19662,29,29,19622,19606,19617,19618,18805
31744,1,20,0,31744,5506,26238,5197.03,12.0055,548.675,31744,19,19,5087,5087,5087,5087,5087
27856,1,21,4430,23426,0,27856,19.6841,17.5402,501.913,27856,20,20,5465,5465,5465,5465,5465
39437,29,54,0,39437,0,39437,4.67738e+14,33.2466,1114.62,39437,45,45,39314,39113,38713,26329,18968
27427,35,40,27427,0,27427,0,81301100000,29.5393,701.072,27427,37,35,27382,27300,27297,27280,26675
37375,32,40,37375,0,37375,0,86068500000,29.3594,752.199,37375,38,37,37315,37256,37266,37254,35257
23608,37,44,23608,0,0,23608,5.35279e+15,34.1184,715.069,23608,36,41,23564,23541,23486,23454,23121
27964,26,30,0,27964,4842,23122,4931.96,19.6939,583.822,27964,21,27,27934,27934,27934,27934,27540
24251,14,40,24251,0,24251,0,1.45358e+18,32.4969,722.758,24251,35,38,23572,22919,21226,4440,14547
33998,30,40,33998,0,33998,0,87069200000,33.6949,770.621,33998,32,31,33941,33878,33919,33922,32555
12714,13,24,12714,0,0,12714,342248000,18.252,408.877,12714,21,21,12525,11874,11565,11717,9556
22019,7,21,3509,18510,0,22019,20.1942,10.4009,418.944,22019,19,20,21725,21725,21178,21184,21117
12237,14,24,0,12237,12237,0,2.24661e+13,19.326,414.728,12237,20,21,12103,11951,10777,11613,9356
45615,8,56,45615,0,45615,0,1.45061e+18,36.4583,891.298,45615,39,40,41713,35534,33159,7895,19049
9432,1,2,9432,0,9432,0,3.223e+13,1.9982,129.43,9432,2,2,8351,8351,8351,8351,8351
30940,1,2,0,30940,30940,0,1.14468e+16,1.99958,235.629,30940,2,2,26024,26024,26024,26024,26024
33561,1,2,33561,0,33561,0,3.2424e+13,1.99926,243.347,33561,2,2,29694,29694,29694,29694,29694
20214,1,2,20214,0,20214,0,5.96258e+13,1.99891,195.84,20214,2,2,15931,15931,15931,15931,15931
5631,6,40,5631,0,5631,0,76258400000,25.5574,344.984,5631,30,33,4721,4249,4001,3956,2103
15525,15,24,15525,0,0,15525,5.74394e+15,19.6147,457.394,15525,22,21,15420,15237,14897,12468,12746
16982,39,44,16982,0,16982,0,1.32781e+18,23.6625,647.912,16982,33,41,16938,16929,16829,16540,15924
38921,2,4,38921,0,38921,0,3.82715e+13,1.99938,267.634,38921,3,3,38916,38915,38915,38915,38030
10767,10,36,0,10767,10767,0,2.04695e+13,27.1848,424.464,10767,33,32,10234,9796,9557,9440,3294
46078,1,2,46078,0,46078,0,3.37687e+13,1.99978,282.47,46078,2,2,40549,40549,40549,40549,40549
12086,22,40,0,12086,0,12086,1141340,33.0004,505.443,12086,33,33,11906,11480,11707,11722,7827
31219,23,44,31219,0,31219,0,1.35524e+18,32.8363,812.702,31219,37,41,31002,30476,30739,11062,21446
16434,3,21,2656,13778,0,16434,20.229,10.519,366.734,16434,19,20,13053,13053,13020,11742,9352
19518,36,60,0,19518,0,19518,1279600,22.1313,683.606,19518,32,40,19458,19448,19370,19376,17025
12234,1,2,0,12234,12234,0,1.37118e+16,1.99943,150.315,12234,2,2,9905,9905,9905,9905,9905
39678,7,44,39678,0,0,39678,5.22608e+15,36.3615,915.131,39678,38,41,34747,30661,29317,5877,12027
25131,10,21,0,25131,3996,21135,5158.18,14.1666,450.83,25131,20,20,25072,25072,25045,25053,25027
15972,22,40,15972,0,0,15972,340813000,20.8989,518.084,15972,30,26,15931,15910,15915,15917,15450
16925,5,19,0,16925,3003,13922,5207.73,11.5348,404.554,16925,19,18,15542,15542,13861,13459,11388
39143,1,40,39143,0,0,39143,340367000,22.3035,771.467,39143,32,29,4244,4244,4244,4244,4244
44619,21,40,0,44619,0,44619,1306540,32.7606,826.206,44619,38,37,44441,44249,44310,44303,30106
27703,17,325,3387,24316,237,27466,97751900000,10.1305,929.809,27703,127,48,27324,27240,26914,26916,27158
40074,43,44,40074,0,0,40074,309541000,38.5039,931.355,40074,37,41,40030,40007,39970,39719,40030
712,1,2,0,712,712,0,8.39997e+15,1.98455,35.4324,712,2,2,628,628,628,628,628
10357,22,36,10357,0,0,10357,245394000,28.623,501.81,10357,33,30,10238,9950,9097,8855,7739
13837,19,22,13837,0,0,13837,340913000,20.4144,463.553,13837,22,22,13792,13719,13747,13745,13477
15951,1,2,15951,0,15951,0,3.25749e+13,1.99837,167.719,15951,2,2,14104,14104,14104,14104,14104
11710,50,60,11710,0,11710,0,1.38181e+18,22.9927,566.845,11710,37,40,11650,11642,11647,11359,10796
9832,23,40,9832,0,0,9832,338520000,18.6147,380.639,9832,20,29,9792,9780,9786,9785,9699
29513,1,2,29513,0,29513,0,3.76247e+13,1.99956,226.55,29513,2,2,25567,25567,25567,25567,25567
10952,1,2,10952,0,10952,0,3.26914e+13,1.99936,138.255,10952,2,2,9679,9679,9679,9679,9679
33185,28,40,33185,0,33185,0,75575400000,35.3436,848,33185,38,37,33039,32747,32625,32172,27920
41420,29,44,41420,0,0,41420,315191000,33.9902,924.692,41420,39,41,41300,41044,40913,24469,36108
37748,21,60,37748,0,0,37748,326447000,34.6028,877.07,37748,37,44,37469,37047,37236,30830,24017
12262,12,24,12262,0,0,12262,340973000,21.4688,411.774,12262,20,22,11978,11380,10424,10736,7484
47775,2,4,0,47775,47775,0,8.22309e+15,3.86439,319.586,47775,4,4,47677,47645,47669,47671,44291
20610,3,13,3538,17072,0,20610,20.3994,11.4403,418.363,20610,13,12,15920,15920,15826,12807,9216
39785,1,40,39785,0,39785,0,87207300000,31.7875,825.818,39785,32,30,3930,3930,3930,3930,3930
19699,1,4,0,19699,19699,0,1.22687e+16,1.99985,197.392,19699,3,3,16342,16342,16342,16342,16342
28127,15,40,28127,0,28127,0,87102600000,22.0505,633.073,28127,30,29,27943,27600,27123,27134,21040
11143,4,20,11143,0,11143,0,86858300000,17.3652,370.402,11143,20,19,8290,6363,6174,7177,3186
41400,28,30,8043,33357,0,41400,19.1986,14.8591,766.861,41400,20,26,41370,41370,41370,41370,40837
21252,13,24,21252,0,0,21252,5.73387e+15,22.1631,551.274,21252,24,22,20877,19640,18260,15779,14030
3259,14,20,3259,0,3259,0,86384300000,14.5333,190.114,3259,16,17,3232,3207,3188,3196,3107
8236,19,20,0,8236,8236,0,2.22065e+13,17.8026,309.595,8236,19,19,8214,8190,8206,8206,8189
12168,17,40,0,12168,12168,0,1.88681e+13,32.6892,530.937,12168,33,37,11704,9724,11209,10585,7384
3781,1,2,3781,0,3781,0,3.26812e+13,1.99603,81.5142,3781,2,2,3341,3341,3341,3341,3341
43056,1,2,43056,0,43056,0,4.15845e+13,1.99991,275.519,43056,2,2,36694,36694,36694,36694,36694
20340,6,56,0,20340,0,20340,1302760,24.5232,634.832,20340,32,40,17440,15683,13080,12514,6529
33438,12,40,33438,0,0,33438,5.63324e+15,34.7371,833.749,33438,38,36,31940,29416,27233,24130,15950
4764,33,36,4764,0,4764,0,1.07832e+18,28.7666,333.379,4764,30,29,4727,4709,4702,4691,4727
48586,52,56,0,48586,48586,0,2.20937e+13,28.5425,911.071,48586,39,40,48530,48518,48526,48530,48486
45416,27,66,45416,0,45416,0,1.19047e+18,36.5814,1364.59,45416,54,50,45155,44342,44499,19409,22230
16102,32,40,16102,0,16102,0,85181300000,24.1357,505.536,16102,36,37,16054,16021,16006,16004,15980
39880,19,30,7563,32317,0,39880,19.3835,13.4237,743.369,39880,20,24,39849,39849,39748,39748,37441
46677,26,40,46677,0,46677,0,86202600000,31.5695,833.939,46677,38,37,46581,46460,46513,46361,39284
11742,1,2,11742,0,11742,0,3.32487e+13,1.99889,142.628,11742,2,2,10354,10354,10354,10354,10354
10311,10,19,1918,8393,0,10311,19.7257,17.9119,345.198,10311,19,19,10187,10187,10147,10146,9585
32265,33,44,0,32265,0,32265,1021440,35.3977,939.203,32265,38,37,32202,32121,31904,31909,30755
35447,8,60,0,35447,35447,0,2.07289e+13,29.1169,964.851,35447,37,44,31119,26315,25096,26096,12106
29968,1,2,29968,0,29968,0,3.25639e+13,1.99973,229.064,29968,2,2,26500,26500,26500,26500,26500
7300,37,60,0,7300,7300,0,1.8776e+13,24.1852,513.143,7300,32,44,7240,7232,7160,7158,4281
9303,10,36,9303,0,9303,0,86148700000,19.0175,348.33,9303,27,19,9049,8812,8003,7988,5697
6436,7,22,0,6436,6436,0,2.23668e+13,20.669,316.046,6436,21,22,5503,4618,3954,4627,2673
31318,17,23,0,31318,9337,21981,4019.1,18.3103,673.908,31318,21,21,31273,31273,31057,31060,31209
21016,1,40,0,21016,21016,0,1.80139e+13,33.871,709.652,21016,37,37,1955,1955,1955,1955,1955
49104,31,49,49104,0,0,49104,5.00156e+15,40.7906,1179.56,49104,44,41,48986,48600,48342,41932,38453
1031,4,10,180,851,0,1031,20.6751,7.36469,86.9021,1031,9,9,911,911,835,821,779
43386,8,44,43386,0,0,43386,328296000,36.5197,867.623,43386,38,38,40043,35221,34356,35265,11636
25044,3,40,25044,0,0,25044,5.69051e+15,20.9867,586.517,25044,29,29,16739,14210,12788,3183,5474
28922,15,40,28922,0,0,28922,5.71106e+15,35.9577,712.033,28922,32,31,28531,27908,27121,22174,18946
6956,10,22,6956,0,6956,0,87976400000,17.7522,309.847,6956,19,19,6634,6350,5629,5394,4504
35931,5,40,0,35931,0,35931,1331030,23.1283,745.989,35931,32,28,28374,21070,21057,19242,9396
6992,16,20,6992,0,6992,0,86511200000,16.5144,278.83,6992,18,19,6964,6944,6923,6919,6853
49900,27,28,0,49900,8420,41480,5184.91,17.2117,694.15,49900,28,21,49871,49871,49871,49871,49868
15604,35,40,0,15604,0,15604,1312990,30.346,470.096,15604,29,29,15563,15527,15554,15554,15562
8684,1,2,8684,0,8684,0,3.40661e+13,1.99827,122.042,8684,2,2,7632,7632,7632,7632,7632
45009,1,2,45009,0,45009,0,3.27446e+13,1.99964,280.307,45009,2,2,39772,39772,39772,39772,39772
22174,5,40,0,22174,22174,0,1.94727e+13,36.0555,697.686,22174,38,37,17236,13594,14744,14325,4484
29937,26,40,0,29937,0,29937,1330940,35.5233,720.246,29937,32,31,29873,29823,29845,29849,12683
38798,6,33,0,38798,10460,28338,1.85719e+12,16.0321,872.124,38798,21,26,33928,33928,33068,27017,19120
7434,35,60,7434,0,7434,0,71839300000,29.6511,520.9,7434,32,43,7373,7347,7282,7283,4008
23797,17,40,23797,0,23797,0,1.41951e+18,30.4376,611.494,23797,37,36,23594,23232,23484,6127,16817
24129,1,2,0,24129,24129,0,8.49317e+15,1.99905,204.507,24129,2,2,21284,21284,21284,21284,21284
37684,1,44,37684,0,0,37684,5.19891e+15,37.5204,907.157,37684,38,41,4248,4248,4248,4248,4248
46807,10,96,237,46570,46795,12,3.34679e+15,2.22819,554.867,46807,28,22,46680,46642,46580,46561,46490
9898,38,48,9898,0,0,9898,5.61119e+15,19.1743,482.014,9898,22,41,9850,9849,9846,9850,9467
4597,20,32,0,4597,0,4597,908067,28.3461,330.602,4597,29,29,4467,4117,4057,4067,3457
40098,46,60,0,40098,0,40098,1228430,41.2173,995.257,40098,40,44,40038,40026,40031,40036,30114
39046,1,2,39046,0,39046,0,4.28636e+13,1.99954,263.763,39046,2,2,33099,33099,33099,33099,33099
12833,2,4,0,12833,12833,0,8.299e+15,1.99977,155.242,12833,3,3,12828,12827,12828,12828,12322
38443,34,38,38443,0,38443,0,1.45515e+18,34.7554,886.046,38443,38,38,38373,38181,38338,34783,37231
31962,16,40,31962,0,0,31962,340485000,22.7415,707.372,31962,32,24,31742,31204,30534,30492,23300
45919,33,60,0,45919,0,45919,1235400,34.7622,1188.67,45919,38,55,45808,45542,45443,45448,33687
41287,1,4,0,41287,41287,0,8.34944e+15,2.00007,273.889,41287,3,3,36500,36500,36500,36500,36500
40842,14,28,0,40842,6784,34058,5170.37,19.4149,623.874,40842,28,21,40788,40788,40787,40787,40780
987,18,22,0,987,0,987,1304080,14.2492,124.709,987,17,17,965,955,961,959,964
46977,39,56,46977,0,46977,0,1.46097e+18,23.3438,862.602,46977,38,32,46921,46905,46912,28821,45550
38104,5,60,38104,0,0,38104,311067000,34.3164,1076.17,38104,39,53,29574,22809,23762,21876,8956
42268,10,20,0,42268,7581,34687,5155.49,18.575,673.177,42268,20,19,42040,42040,41897,41896,41768
44877,54,60,44877,0,0,44877,315551000,34.9475,1177.48,44877,38,55,44817,44807,44811,43882,41154
27958,20,40,27958,0,0,27958,4.153e+15,34.1875,859.284,27958,37,34,27222,24732,24782,12791,17662
20917,28,40,20917,0,20917,0,85972500000,30.0191,539.296,20917,30,29,20859,20805,20843,20822,18773
46108,22,23,0,46108,7855,38253,4910.62,18.7519,691.409,46108,21,21,46084,46084,46042,46043,46084
49202,30,60,0,49202,0,49202,1237870,34.8678,1209.91,49202,40,55,49029,48618,48580,48583,33770
10751,8,20,0,10751,0,10751,1323520,17.2038,359.26,10751,20,19,10002,8695,8437,8738,5080
8325,1,2,8325,0,8325,0,5.15277e+13,1.99688,123.911,8325,2,2,6800,6800,6800,6800,6800
48330,37,40,48330,0,48330,0,87175100000,31.3988,882.52,48330,33,31,48287,48246,48283,48283,48287
16487,13,20,2763,13724,0,16487,20.2472,12.2245,393.684,16487,19,19,16461,16461,16461,16461,16448
5037,8,19,750,4287,0,5037,19.7745,8.48084,193.223,5037,17,18,5000,5000,4980,4985,4966
36470,57,60,0,36470,0,36470,1217660,32.7063,1004.69,36470,40,51,36410,36400,36407,36410,33115
19237,43,44,19237,0,19237,0,1.36618e+18,32.1851,664.536,19237,32,41,19193,19176,19172,19038,19057
36344,1,2,36344,0,36344,0,4.36494e+13,1.99986,254.597,36344,2,2,30707,30707,30707,30707,30707
25559,4,60,0,25559,0,25559,1282360,26.6073,766.826,25559,32,40,18397,14262,14008,11762,5154
41186,1,2,41186,0,41186,0,3.2572e+13,1.99944,268.889,41186,2,2,36419,36419,36419,36419,36419
22780,6,56,22780,0,22780,0,86679200000,22.8649,601.16,22780,30,29,19825,17990,14129,17172,8678
2402,1,20,2402,0,2402,0,1.44859e+18,13.5479,165.698,2402,15,17,299,299,299,299,299
3093,1,2,3093,0,3093,0,3.27614e+13,1.9903,73.6003,3093,2,2,2732,2732,2732,2732,2732
9286,1,2,0,9286,9286,0,1.67146e+16,1.99806,134.601,9286,2,2,7131,7131,7131,7131,7131
29128,22,24,29128,0,0,29128,5.71632e+15,21.0433,629.057,29128,24,22,29100,29072,29078,27412,28839
8895,11,36,8895,0,8895,0,1.40062e+18,26.2583,364.367,8895,31,33,8652,8352,8393,3400,5173
8876,24,40,8876,0,0,8876,333745000,26.1653,458.597,8876,32,33,8774,8616,8651,8658,7220
34783,39,40,0,34783,0,34783,1317500,27.5957,702.166,34783,32,29,34742,34713,34741,34741,34742
42825,29,44,0,42825,42825,0,2.02113e+13,37.2396,981.709,42825,40,41,42689,42416,42246,41843,33802
35041,26,40,0,35041,35041,0,2.2018e+13,28.7691,722.059,35041,37,37,34957,34860,34895,34780,28638
31334,24,44,0,31334,0,31334,1247960,37.4702,776.566,31334,37,37,31140,30835,30866,30876,20153
9829,1,2,0,9829,9829,0,8.36481e+15,1.99847,131.607,9829,2,2,8687,8687,8687,8687,8687
2659,1,2,2659,0,2659,0,3.23924e+13,1.99361,67.8533,2659,2,2,2352,2352,2352,2352,2352
38036,24,40,38036,0,0,38036,5.65182e+15,37.2962,877.259,38036,38,38,37873,37628,37690,35645,28476
26073,51,60,0,26073,26073,0,2.14322e+13,23.144,824.161,26073,32,44,26013,26006,26007,26013,24760
43229,1,2,0,43229,43229,0,8.39108e+15,1.99988,274.433,43229,2,2,38194,38194,38194,38194,38194
17869,1,20,3134,14735,0,17869,20.3232,11.6499,415.364,17869,19,19,2827,2827,2827,2827,2827
27516,42,44,27516,0,27516,0,1.31195e+18,35.0316,791.826,27516,38,41,27472,27462,27290,25531,25251
13850,5,56,13850,0,13850,0,1.43285e+18,20.4651,543.341,13850,39,39,10867,8176,8435,2993,3376
16405,1,2,16405,0,16405,0,3.5105e+13,1.99939,168.634,16405,2,2,14358,14358,14358,14358,14358
21877,22,24,21877,0,0,21877,5.73799e+15,21.5673,552.327,21877,23,22,21849,21823,21829,20184,20466
13005,1,2,0,13005,13005,0,1.70378e+16,1.99892,158.88,13005,2,2,9929,9929,9929,9929,9929
1459,3,18,0,1459,1459,0,2.26082e+13,15.3756,136.491,1459,15,17,931,783,698,783,389
26481,1,2,26481,0,26481,0,3.26533e+13,1.99958,215.346,26481,2,2,23408,23408,23408,23408,23408
23877,3,60,0,23877,0,23877,1299650,23.6528,738.059,23877,32,40,15231,12889,11500,6570,4802
45219,18,40,45219,0,45219,0,1.46665e+18,22.9009,834.154,45219,31,29,45099,44941,44469,23515,35830
5749,3,22,5749,0,5749,0,1.47219e+18,20.2122,290.086,5749,20,20,3650,3071,2719,758,1246
40332,2916,12341,39704,628,0,40332,1.37863e+18,322.754,15510.3,40332,3152,285,27991,27661,22703,19740,5990
43951,1,2,43951,0,43951,0,3.2886e+13,1.99964,276.91,43951,2,2,38815,38815,38815,38815,38815
27914,30,44,27914,0,0,27914,323514000,32.528,709.191,27914,37,37,27838,27661,27687,23489,22649
3960,23,38,3960,0,0,3960,5.58771e+15,19.7326,272.981,3960,26,26,3922,3902,3909,3882,3922
32237,17,40,32237,0,32237,0,87082400000,34.7835,731.593,32237,32,31,32041,31400,30990,30827,23677
6179,6,24,6179,0,0,6179,5.70803e+15,18.8666,293.669,6179,19,21,5319,4795,3773,1036,2421
45696,19,40,45696,0,0,45696,5.64571e+15,31.8802,825.234,45696,38,37,45537,45312,45393,6376,34014
8093,26,48,8093,0,8093,0,72408900000,24.7425,527.265,8093,28,41,8033,7974,7942,7838,4487
41409,43,48,41409,0,0,41409,4.88891e+15,36.5491,1046.88,41409,38,41,41361,41340,40997,38760,40420
37790,15,27,11865,25925,4,37786,7448170000,20.6382,770.254,37790,22,22,37679,37675,37362,37371,34429
3861,17,32,0,3861,3861,0,2.017e+13,24.1412,239.712,3861,29,28,3765,3627,3723,3559,2933
16752,1,24,16752,0,16752,0,1.47266e+18,20.4349,489.632,16752,22,22,1717,1717,1717,1717,1717
19600,20,44,19600,0,19600,0,1.32701e+18,24.8098,683.658,19600,36,41,19358,18915,18995,12751,13605
30365,21,60,0,30365,30365,0,2.149e+13,26.4682,810.394,30365,35,40,30154,29792,29987,29749,23696
1430,8,17,0,1430,523,907,3530.29,13.1322,134.135,1430,15,15,1284,1257,1252,1262,914
9180,9,11,1491,7689,0,9180,20.3477,9.81699,259.441,9180,11,11,9151,9151,9142,9142,9143
39626,2,4,39626,0,39626,0,3.6795e+13,1.9997,268.79,39626,3,3,39621,39620,39620,39620,39154
49815,1,56,49815,0,49815,0,1.46128e+18,23.4985,887.422,49815,39,32,5445,5445,5445,5445,5445
5115,30,40,5115,0,0,5115,5.62136e+15,15.7228,285.596,5115,24,29,5075,5065,5072,4426,5073
25861,16,44,0,25861,25861,0,2.12809e+13,33.0154,681.96,25861,37,37,25474,24691,25178,24669,16994
31619,1,2,0,31619,31619,0,1.16545e+16,1.99968,237.97,31619,2,2,26504,26504,26504,26504,26504
6819,21,24,0,6819,0,6819,1332670,16.1999,304.89,6819,19,21,6795,6785,6779,6778,6666
43011,31,64,0,43011,0,43011,1159310,32.3351,1159.77,43011,37,44,42907,42663,42509,42439,27534
46716,1,2,46716,0,46716,0,4.14717e+13,1.99972,287.79,46716,2,2,39832,39832,39832,39832,39832
46054,9,60,46054,0,46054,0,1.44218e+18,35.6089,950.372,46054,36,40,42918,36021,36192,8208,18763
29763,1,5,6,29757,29763,0,9.88271e+15,1.99946,234.359,29763,4,3,25677,25677,25677,25677,25677
26315,39,65,26314,1,26314,1,3.25248e+12,36.986,1071.94,26315,37,57,26249,26225,26055,25794,13044
20526,1,2,20526,0,20526,0,3.24452e+13,1.99898,190.534,20526,2,2,18159,18159,18159,18159,18159
10278,33,40,10278,0,10278,0,1.26883e+18,33.955,479.759,10278,33,35,10232,10194,10177,9261,9574
32306,1,30,0,32306,5720,26586,5080.98,12.9152,627.446,32306,20,24,5733,5733,5733,5733,5733
16992,1,2,16992,0,16992,0,3.29646e+13,1.99841,171.532,16992,2,2,15001,15001,15001,15001,15001
32947,32,40,32947,0,0,32947,307126000,34.0621,817.737,32947,39,37,32877,32764,32630,28655,30117
29132,37,40,29132,0,0,29132,334989000,32.5924,677.339,29132,37,37,29086,29047,29056,29038,29059
29493,1,2,0,29493,29493,0,9.04476e+15,1.99983,226.129,29493,2,2,25790,25790,25790,25790,25790
37243,540,544,914,36329,36646,597,1.58615e+16,56.5295,2103.43,37243,115,76,36699,36699,36698,36697,36673
20410,6,40,0,20410,20410,0,1.84819e+13,32.9195,685.343,20410,37,37,16236,14307,13631,13146,4113
31981,1,2,0,31981,31981,0,1.16127e+16,1.99897,239.24,31981,2,2,26826,26826,26826,26826,26826
8673,8,36,8673,0,8673,0,86059800000,18.0158,332.072,8673,26,25,8114,7150,6900,7271,4413
28418,18,40,28418,0,28418,0,87053400000,22.7293,640.886,28418,31,29,28346,28260,28112,28044,23321
22532,29,44,22532,0,0,22532,306154000,30.2859,736.196,22532,36,41,22452,22334,22148,15319,17187
39140,12,23,7027,32113,0,39140,18.8446,19.0639,659.523,39140,22,21,38874,38860,38694,38739,37183
3435,23,38,3435,0,0,3435,5.62458e+15,20.3418,260.685,3435,27,22,3397,3379,3385,3337,3397
47980,1,44,0,47980,0,47980,1196730,38.7098,1038.08,47980,40,39,5329,5329,5329,5329,5329
11093,1,2,0,11093,11093,0,1.42907e+16,1.99802,143.428,11093,2,2,8892,8892,8892,8892,8892
27403,6,28,4727,22676,0,27403,20.3033,12.5302,528.861,27403,20,21,26462,26462,25452,25452,24270
22896,23,32,0,22896,6398,16498,4230.17,18.4206,714.666,22896,21,31,22864,22864,22708,22708,18006
35283,3,48,35283,0,0,35283,5.05166e+15,37.6586,962.01,35283,36,41,21908,18758,17570,5272,4635
18926,42,44,0,18926,0,18926,1271900,30.8958,596.555,18926,33,37,18882,18865,18833,18834,18880
31049,25,30,6357,24692,0,31049,18.494,16.8899,686.357,31049,21,26,31019,31019,31019,31019,29394
48967,1,2,48967,0,48967,0,3.35123e+13,1.99941,292.19,48967,2,2,43136,43136,43136,43136,43136
12332,1,2,0,12332,12332,0,1.26679e+16,1.99781,148.946,12332,2,2,10163,10163,10163,10163,10163
41868,1,2,41868,0,41868,0,3.22969e+13,1.99926,272.026,41868,2,2,37063,37063,37063,37063,37063
34253,26,40,0,34253,0,34253,1149110,35.6842,872.531,34253,39,37,34025,33368,33497,33507,25256
14886,7,40,14886,0,0,14886,337961000,19.4406,454.713,14886,25,29,13459,11910,10864,11255,5943
37410,41,44,37410,0,0,37410,5.31337e+15,36.5589,851.836,37410,38,37,37366,37345,37313,36665,37365
34429,1,2,34429,0,34429,0,3.27593e+13,1.99968,245.232,34429,2,2,30421,30421,30421,30421,30421
10463,54,55,0,10463,10457,6,2.0648e+15,32.138,587.958,10463,38,45,10408,10404,10408,10407,10173
38986,48,56,0,38986,38986,0,2.20161e+13,28.9999,910.513,38986,38,43,38930,38918,38930,38930,38928
4942,12,40,4942,0,0,4942,333535000,20.0051,312.744,4942,29,24,4725,4374,3961,4021,3112
36480,15,40,36480,0,0,36480,338837000,34.9847,841.372,36480,35,38,35953,35179,32458,33332,14697
24731,8,40,24731,0,24731,0,83316600000,27.1441,655.5,24731,36,35,22756,20055,19623,20065,8976
12544,23,24,12544,0,12544,0,1.46434e+18,20.9021,414.34,12544,21,22,12519,12497,12509,11752,12159
42761,25,56,42761,0,0,42761,336910000,28.791,862.494,42761,37,40,42656,42555,42593,40368,36028
3792,19,22,3792,0,0,3792,339296000,19.9478,243.958,3792,20,21,3761,3726,3744,3742,3704
15216,18,19,2778,12438,0,15216,20.0797,14.6727,400.036,15216,19,19,15194,15194,15194,15194,15194
25871,16,60,25871,0,25871,0,1.40024e+18,28.8927,812.56,25871,50,40,25350,24382,24914,4151,9924
9017,31,40,9017,0,9017,0,1.40557e+18,26.86,396.509,9017,32,37,8968,8910,8921,7811,8675
32419,23,38,32419,0,32419,0,1.45761e+18,36.4815,846.318,32419,38,38,32159,31775,31880,16694,23334
11400,14,24,0,11400,11400,0,2.23344e+13,18.623,385.037,11400,20,21,11312,11216,10459,10985,9011
16484,1,38,16484,0,0,16484,5.72833e+15,20.2137,524.161,16484,30,25,1623,1623,1623,1623,1623
31281,7,23,5350,25931,0,31281,19.4267,18.4836,578.407,31281,21,21,30511,30511,30004,30076,29228
27700,19,28,0,27700,4661,23039,5180.74,11.6745,518.691,27700,20,21,27671,27671,27669,27669,27660
7793,34,38,7793,0,7793,0,1.46349e+18,34.2265,383.534,7793,30,29,7751,7721,7743,6744,6120
40618,18,21,6618,34000,0,40618,20.2462,14.1464,583.092,40618,21,20,40590,40590,40588,40590,40577
25831,4,48,0,25831,0,25831,7.1411e+14,37.4264,835.167,25831,38,37,16236,13203,13362,13706,4895
